time,subj_course_id,sec_code,sec_id,prof,available,waitlist,total,enrolled_ct
1649935694062,COGS 9,A01,083615,Staff,16,0,60,44
1649935700095,COGS 11,A01,083617,Boyle; Mary E. T.,35,0,40,5
1649935706132,COGS 13,A01,083071,Staff,0,11,40,40
1649935712170,COGS 14A,A01,092681,Staff,65,0,100,35
1649935718202,COGS 14B,A01,083073,Cheng; Tzu-Han,24,0,50,26
1649935724233,COGS 17,A01,092677,Staff,63,0,75,12
1649935730267,COGS 100,A01,083619,Staff,0,5,60,60
1649935736301,COGS 101A,A01,083621,Davis; Joshua Daniel,0,8,60,60
1649935742330,COGS 101B,A01,091572,Staff,31,0,60,29
1649935748358,COGS 101C,A01,083625,Delgado; Tania,24,0,30,6
1649935754385,COGS 107A,A01,083627,Boyle; Mary E. T.,14,0,60,46
1649935760415,COGS 118A,A01,083075,Staff,21,0,60,39
1649935766453,CSE 3,A50,083646,Miranda; Gregory Joseph,24,0,38,14
1649935766453,CSE 3,A51,083647,Miranda; Gregory Joseph,37,0,37,0
1649935772481,CSE 8A,A50,083650,Miranda; Gregory Joseph,8,0,40,32
1649935778510,CSE 11,A01,083080,Cao; Yingjun,0,26,40,40
1649935784544,CSE 12,A01,083652,Staff,56,0,100,44
1649935790570,CSE 15L,A01,083654,Staff,19,0,50,31
1649935790570,CSE 15L,A02,083655,Staff,47,0,50,3
1649935796598,CSE 20,A01,083657,Staff,68,0,80,12
1649935802635,CSE 30,A01,083084,Eldon; John,0,24,40,40
1649935808664,CSE 100,A01,083659,Cao; Yingjun,1,27,50,49
1649935814693,CSE 134B,A01,083661,Powell; Thomas Allan,0,21,65,65
1649935820721,CSE 140,A01,083663,Staff,24,0,75,51
1649935826750,CSE 140L,A01,083088,Eldon; John,18,0,75,57
1649935832784,CSE 175,A01,083665,Kumar; Rakesh,12,0,25,13
1649935838815,CSE 190,A00,092507,Dubnov; Shlomo,14,0,15,1
1649935844839,ECE 45,A01,083139,Staff,6,0,40,34
1649935850866,ECE 65,A50,083695,Staff,7,0,30,23
1649935856892,ECE 109,A01,091882,Touri; Behrouz,55,0,70,15
1649935862931,ECE 180,A00,083140,Abi Samra; Nicholas Camill,26,0,30,4
1649935862931,ECE 180,B00,083141,Abi Samra; Nicholas Camill,13,0,30,17
1649935868965,MATH 10A,A01,083735,Patchell; Gregory David,20,0,30,10
1649935868965,MATH 10A,A02,083736,Patchell; Gregory David,28,0,30,2
1649935868965,MATH 10A,A03,083737,Patchell; Gregory David,28,0,30,2
1649935875001,MATH 10B,A01,083207,Staff,10,0,30,20
1649935875001,MATH 10B,A02,083208,Staff,25,0,30,5
1649935875001,MATH 10B,B01,083739,Staff,25,0,30,5
1649935875001,MATH 10B,B02,083740,Staff,30,0,30,0
1649935881028,MATH 18,A01,083743,Staff,22,0,30,8
1649935881028,MATH 18,A02,083744,Staff,29,0,30,1
1649935881028,MATH 18,A03,083745,Staff,29,0,30,1
1649935881028,MATH 18,A04,083746,Staff,28,0,30,2
1649935881028,MATH 18,B01,083748,Staff,5,0,30,25
1649935881028,MATH 18,B02,083749,Staff,26,0,30,4
1649935881028,MATH 18,B03,083750,Staff,28,0,30,2
1649935881028,MATH 18,B04,083751,Staff,26,0,30,4
1649935887058,MATH 20A,A01,083754,Staff,37,0,40,3
1649935893085,MATH 20B,A01,083756,Staff,19,0,30,11
1649935893085,MATH 20B,A02,083757,Staff,30,0,30,0
1649935899112,MATH 20C,A01,083760,Staff,22,0,30,8
1649935899112,MATH 20C,A02,083761,Staff,23,0,30,7
1649935899112,MATH 20C,B01,083762,Staff,28,0,30,2
1649935899112,MATH 20C,B02,083763,Staff,30,0,30,0
1649935905139,MATH 20D,A01,083765,Staff,20,0,30,10
1649935905139,MATH 20D,A02,083766,Staff,30,0,30,0
1649935905139,MATH 20D,A03,083767,Staff,30,0,30,0
1649935911169,MATH 20E,A01,083771,Staff,12,0,30,18
1649935911169,MATH 20E,A02,083772,Staff,24,0,30,6
1649935911169,MATH 20E,B01,083773,Staff,17,0,30,13
1649935911169,MATH 20E,B02,083774,Staff,29,0,30,1
1649935917196,MATH 103A,A01,083777,Staff,1,4,30,29
1649935917196,MATH 103A,A02,083778,Staff,0,3,30,30
1649935917196,MATH 103A,B01,083779,Staff,0,0,30,30
1649935917196,MATH 103A,B02,083780,Staff,16,0,30,14
1649935923221,MATH 105,A01,085443,Staff,0,5,30,30
1649935929252,MATH 109,A01,083213,Anzaldo; Leesa B,13,0,30,17
1649935929252,MATH 109,A02,083214,Anzaldo; Leesa B,9,0,30,21
1649935929252,MATH 109,B01,083215,Anzaldo; Leesa B,26,0,30,4
1649935929252,MATH 109,B02,083216,Anzaldo; Leesa B,22,0,30,8
1649935935284,MATH 142A,A01,083219,Chow; Bennett,0,1,30,30
1649935935284,MATH 142A,A02,083220,Chow; Bennett,9,0,30,21
1649935935284,MATH 142A,B01,083221,Chow; Bennett,0,0,30,30
1649935935284,MATH 142A,B02,083222,Chow; Bennett,1,0,30,29
1649935941313,MATH 193A,A01,083224,Staff,0,3,30,30
1649935941313,MATH 193A,A02,083225,Staff,0,3,30,30
1649935941313,MATH 193A,A03,083781,Staff,4,0,30,26
1649935941313,MATH 193A,A04,083782,Staff,16,0,30,14
1649935947341,MATH 197,001,091859,McAuley; Julian John,9999,0,9999,0
1649935953412,COGS 9,A01,083615,Staff,16,0,60,44
1649935959440,COGS 11,A01,083617,Boyle; Mary E. T.,35,0,40,5
1649935965471,COGS 13,A01,083071,Staff,0,11,40,40
1649935971501,COGS 14A,A01,092681,Staff,65,0,100,35
1649935977531,COGS 14B,A01,083073,Cheng; Tzu-Han,24,0,50,26
1649935983569,COGS 17,A01,092677,Staff,63,0,75,12
1649935997439,COGS 100,A01,083619,Staff,0,5,60,60
1649936003465,COGS 101A,A01,083621,Davis; Joshua Daniel,0,8,60,60
1649936013511,COGS 101B,A01,091572,Staff,31,0,60,29
1649936019541,COGS 101C,A01,083625,Delgado; Tania,24,0,30,6
1649936025564,COGS 107A,A01,083627,Boyle; Mary E. T.,14,0,60,46
1649936031590,COGS 118A,A01,083075,Staff,21,0,60,39
1649936037616,CSE 3,A50,083646,Miranda; Gregory Joseph,24,0,38,14
1649936037616,CSE 3,A51,083647,Miranda; Gregory Joseph,37,0,37,0
1649936043647,CSE 8A,A50,083650,Miranda; Gregory Joseph,8,0,40,32
1649936049675,CSE 11,A01,083080,Cao; Yingjun,0,26,40,40
1649936055702,CSE 12,A01,083652,Staff,56,0,100,44
1649936061729,CSE 15L,A01,083654,Staff,19,0,50,31
1649936061729,CSE 15L,A02,083655,Staff,47,0,50,3
1649936067757,CSE 20,A01,083657,Staff,68,0,80,12
1649936073785,CSE 30,A01,083084,Eldon; John,0,24,40,40
1649936079817,CSE 100,A01,083659,Cao; Yingjun,1,27,50,49
1649936085844,CSE 134B,A01,083661,Powell; Thomas Allan,0,21,65,65
1649936091872,CSE 140,A01,083663,Staff,24,0,75,51
1649936097904,CSE 140L,A01,083088,Eldon; John,18,0,75,57
1649936103936,CSE 175,A01,083665,Kumar; Rakesh,12,0,25,13
1649936109960,CSE 190,A00,092507,Dubnov; Shlomo,14,0,15,1
1649936115988,ECE 45,A01,083139,Staff,6,0,40,34
1649936122018,ECE 65,A50,083695,Staff,7,0,30,23
1649936128049,ECE 109,A01,091882,Touri; Behrouz,55,0,70,15
1649936134089,ECE 180,A00,083140,Abi Samra; Nicholas Camill,26,0,30,4
1649936134089,ECE 180,B00,083141,Abi Samra; Nicholas Camill,13,0,30,17
1649936140118,MATH 10A,A01,083735,Patchell; Gregory David,20,0,30,10
1649936140118,MATH 10A,A02,083736,Patchell; Gregory David,28,0,30,2
1649936140118,MATH 10A,A03,083737,Patchell; Gregory David,28,0,30,2
1649936146148,MATH 10B,A01,083207,Staff,10,0,30,20
1649936146148,MATH 10B,A02,083208,Staff,25,0,30,5
1649936146148,MATH 10B,B01,083739,Staff,25,0,30,5
1649936146148,MATH 10B,B02,083740,Staff,30,0,30,0
1649936152173,MATH 18,A01,083743,Staff,22,0,30,8
1649936152173,MATH 18,A02,083744,Staff,29,0,30,1
1649936152173,MATH 18,A03,083745,Staff,29,0,30,1
1649936152173,MATH 18,A04,083746,Staff,28,0,30,2
1649936152173,MATH 18,B01,083748,Staff,5,0,30,25
1649936152173,MATH 18,B02,083749,Staff,26,0,30,4
1649936152173,MATH 18,B03,083750,Staff,28,0,30,2
1649936152173,MATH 18,B04,083751,Staff,26,0,30,4
1649936158197,MATH 20A,A01,083754,Staff,37,0,40,3
1649936164224,MATH 20B,A01,083756,Staff,19,0,30,11
1649936164224,MATH 20B,A02,083757,Staff,30,0,30,0
1649936170251,MATH 20C,A01,083760,Staff,22,0,30,8
1649936170251,MATH 20C,A02,083761,Staff,23,0,30,7
1649936170251,MATH 20C,B01,083762,Staff,28,0,30,2
1649936170251,MATH 20C,B02,083763,Staff,30,0,30,0
1649936176276,MATH 20D,A01,083765,Staff,20,0,30,10
1649936176276,MATH 20D,A02,083766,Staff,30,0,30,0
1649936176276,MATH 20D,A03,083767,Staff,30,0,30,0
1649936182307,MATH 20E,A01,083771,Staff,12,0,30,18
1649936182307,MATH 20E,A02,083772,Staff,24,0,30,6
1649936182307,MATH 20E,B01,083773,Staff,17,0,30,13
1649936182307,MATH 20E,B02,083774,Staff,29,0,30,1
1649936188332,MATH 103A,A01,083777,Staff,1,4,30,29
1649936188332,MATH 103A,A02,083778,Staff,0,3,30,30
1649936188332,MATH 103A,B01,083779,Staff,0,0,30,30
1649936188332,MATH 103A,B02,083780,Staff,16,0,30,14
1649936194366,MATH 105,A01,085443,Staff,0,5,30,30
1649936200391,MATH 109,A01,083213,Anzaldo; Leesa B,13,0,30,17
1649936200391,MATH 109,A02,083214,Anzaldo; Leesa B,9,0,30,21
1649936200391,MATH 109,B01,083215,Anzaldo; Leesa B,26,0,30,4
1649936200391,MATH 109,B02,083216,Anzaldo; Leesa B,22,0,30,8
1649936206422,MATH 142A,A01,083219,Chow; Bennett,0,1,30,30
1649936206422,MATH 142A,A02,083220,Chow; Bennett,9,0,30,21
1649936206422,MATH 142A,B01,083221,Chow; Bennett,0,0,30,30
1649936206422,MATH 142A,B02,083222,Chow; Bennett,1,0,30,29
1649936212451,MATH 193A,A01,083224,Staff,0,3,30,30
1649936212451,MATH 193A,A02,083225,Staff,0,3,30,30
1649936212451,MATH 193A,A03,083781,Staff,4,0,30,26
1649936212451,MATH 193A,A04,083782,Staff,16,0,30,14
1649936218479,MATH 197,001,091859,McAuley; Julian John,9999,0,9999,0
1649936224548,COGS 9,A01,083615,Staff,16,0,60,44
1649936230574,COGS 11,A01,083617,Boyle; Mary E. T.,35,0,40,5
1649936236600,COGS 13,A01,083071,Staff,0,11,40,40
1649936242626,COGS 14A,A01,092681,Staff,65,0,100,35
1649936248654,COGS 14B,A01,083073,Cheng; Tzu-Han,24,0,50,26
1649936254678,COGS 17,A01,092677,Staff,63,0,75,12
1649936260708,COGS 100,A01,083619,Staff,0,5,60,60
1649936266735,COGS 101A,A01,083621,Davis; Joshua Daniel,0,8,60,60
1649936272767,COGS 101B,A01,091572,Staff,31,0,60,29
1649936278893,COGS 101C,A01,083625,Delgado; Tania,24,0,30,6
1649936284925,COGS 107A,A01,083627,Boyle; Mary E. T.,14,0,60,46
1649936290952,COGS 118A,A01,083075,Staff,21,0,60,39
1649936296986,CSE 3,A50,083646,Miranda; Gregory Joseph,24,0,38,14
1649936296986,CSE 3,A51,083647,Miranda; Gregory Joseph,37,0,37,0
1649936303017,CSE 8A,A50,083650,Miranda; Gregory Joseph,8,0,40,32
1649936309042,CSE 11,A01,083080,Cao; Yingjun,0,26,40,40
1649936315071,CSE 12,A01,083652,Staff,56,0,100,44
1649936321102,CSE 15L,A01,083654,Staff,19,0,50,31
1649936321102,CSE 15L,A02,083655,Staff,47,0,50,3
1649936327132,CSE 20,A01,083657,Staff,68,0,80,12
1649936333156,CSE 30,A01,083084,Eldon; John,0,24,40,40
1649936339181,CSE 100,A01,083659,Cao; Yingjun,1,27,50,49
1649936345224,CSE 134B,A01,083661,Powell; Thomas Allan,0,21,65,65
1649936351253,CSE 140,A01,083663,Staff,24,0,75,51
1649936357284,CSE 140L,A01,083088,Eldon; John,18,0,75,57
1649936363314,CSE 175,A01,083665,Kumar; Rakesh,12,0,25,13
1649936369339,CSE 190,A00,092507,Dubnov; Shlomo,14,0,15,1
1649936375368,ECE 45,A01,083139,Staff,6,0,40,34
1649936381396,ECE 65,A50,083695,Staff,7,0,30,23
1649936387423,ECE 109,A01,091882,Touri; Behrouz,55,0,70,15
1649936393451,ECE 180,A00,083140,Abi Samra; Nicholas Camill,26,0,30,4
1649936393451,ECE 180,B00,083141,Abi Samra; Nicholas Camill,13,0,30,17
1649936399486,MATH 10A,A01,083735,Patchell; Gregory David,20,0,30,10
1649936399486,MATH 10A,A02,083736,Patchell; Gregory David,28,0,30,2
1649936399486,MATH 10A,A03,083737,Patchell; Gregory David,28,0,30,2
1649936405515,MATH 10B,A01,083207,Staff,10,0,30,20
1649936405515,MATH 10B,A02,083208,Staff,25,0,30,5
1649936405515,MATH 10B,B01,083739,Staff,25,0,30,5
1649936405515,MATH 10B,B02,083740,Staff,30,0,30,0
1649936411544,MATH 18,A01,083743,Staff,22,0,30,8
1649936411544,MATH 18,A02,083744,Staff,29,0,30,1
1649936411544,MATH 18,A03,083745,Staff,29,0,30,1
1649936411544,MATH 18,A04,083746,Staff,28,0,30,2
1649936411544,MATH 18,B01,083748,Staff,5,0,30,25
1649936411544,MATH 18,B02,083749,Staff,26,0,30,4
1649936411544,MATH 18,B03,083750,Staff,28,0,30,2
1649936411544,MATH 18,B04,083751,Staff,26,0,30,4
1649936417574,MATH 20A,A01,083754,Staff,37,0,40,3
1649936423602,MATH 20B,A01,083756,Staff,19,0,30,11
1649936423602,MATH 20B,A02,083757,Staff,30,0,30,0
1649936429633,MATH 20C,A01,083760,Staff,22,0,30,8
1649936429633,MATH 20C,A02,083761,Staff,23,0,30,7
1649936429633,MATH 20C,B01,083762,Staff,28,0,30,2
1649936429633,MATH 20C,B02,083763,Staff,30,0,30,0
1649936435665,MATH 20D,A01,083765,Staff,20,0,30,10
1649936435665,MATH 20D,A02,083766,Staff,30,0,30,0
1649936435665,MATH 20D,A03,083767,Staff,30,0,30,0
1649936441705,MATH 20E,A01,083771,Staff,12,0,30,18
1649936441705,MATH 20E,A02,083772,Staff,24,0,30,6
1649936441705,MATH 20E,B01,083773,Staff,17,0,30,13
1649936441705,MATH 20E,B02,083774,Staff,29,0,30,1
1649936447733,MATH 103A,A01,083777,Staff,1,4,30,29
1649936447733,MATH 103A,A02,083778,Staff,0,3,30,30
1649936447733,MATH 103A,B01,083779,Staff,0,0,30,30
1649936447733,MATH 103A,B02,083780,Staff,16,0,30,14
1649936453766,MATH 105,A01,085443,Staff,0,5,30,30
1649936459800,MATH 109,A01,083213,Anzaldo; Leesa B,13,0,30,17
1649936459800,MATH 109,A02,083214,Anzaldo; Leesa B,9,0,30,21
1649936459800,MATH 109,B01,083215,Anzaldo; Leesa B,26,0,30,4
1649936459800,MATH 109,B02,083216,Anzaldo; Leesa B,22,0,30,8
1649936465834,MATH 142A,A01,083219,Chow; Bennett,0,1,30,30
1649936465834,MATH 142A,A02,083220,Chow; Bennett,9,0,30,21
1649936465834,MATH 142A,B01,083221,Chow; Bennett,0,0,30,30
1649936465834,MATH 142A,B02,083222,Chow; Bennett,1,0,30,29
1649936471860,MATH 193A,A01,083224,Staff,0,3,30,30
1649936471860,MATH 193A,A02,083225,Staff,0,3,30,30
1649936471860,MATH 193A,A03,083781,Staff,4,0,30,26
1649936471860,MATH 193A,A04,083782,Staff,16,0,30,14
1649936477886,MATH 197,001,091859,McAuley; Julian John,9999,0,9999,0
1649936483959,COGS 9,A01,083615,Staff,16,0,60,44
1649936489987,COGS 11,A01,083617,Boyle; Mary E. T.,35,0,40,5
1649936496018,COGS 13,A01,083071,Staff,0,11,40,40
1649936502049,COGS 14A,A01,092681,Staff,65,0,100,35
1649936508080,COGS 14B,A01,083073,Cheng; Tzu-Han,24,0,50,26
1649936514105,COGS 17,A01,092677,Staff,63,0,75,12
1649936520136,COGS 100,A01,083619,Staff,0,5,60,60
1649936526161,COGS 101A,A01,083621,Davis; Joshua Daniel,0,8,60,60
1649936532186,COGS 101B,A01,091572,Staff,31,0,60,29
1649936538220,COGS 101C,A01,083625,Delgado; Tania,24,0,30,6
1649936544255,COGS 107A,A01,083627,Boyle; Mary E. T.,14,0,60,46
1649936550282,COGS 118A,A01,083075,Staff,21,0,60,39
1649936556321,CSE 3,A50,083646,Miranda; Gregory Joseph,24,0,38,14
1649936556321,CSE 3,A51,083647,Miranda; Gregory Joseph,37,0,37,0
1649936562349,CSE 8A,A50,083650,Miranda; Gregory Joseph,8,0,40,32
1649936568376,CSE 11,A01,083080,Cao; Yingjun,0,26,40,40
1649936574404,CSE 12,A01,083652,Staff,56,0,100,44
1649936580428,CSE 15L,A01,083654,Staff,19,0,50,31
1649936580428,CSE 15L,A02,083655,Staff,47,0,50,3
1649936586458,CSE 20,A01,083657,Staff,68,0,80,12
1649936592486,CSE 30,A01,083084,Eldon; John,0,24,40,40
1649936598517,CSE 100,A01,083659,Cao; Yingjun,1,27,50,49
1649936604542,CSE 134B,A01,083661,Powell; Thomas Allan,0,21,65,65
1649936610573,CSE 140,A01,083663,Staff,24,0,75,51
1649936616599,CSE 140L,A01,083088,Eldon; John,18,0,75,57
1649936622625,CSE 175,A01,083665,Kumar; Rakesh,12,0,25,13
1649936628650,CSE 190,A00,092507,Dubnov; Shlomo,14,0,15,1
1649936634675,ECE 45,A01,083139,Staff,6,0,40,34
1649936640708,ECE 65,A50,083695,Staff,7,0,30,23
1649936646739,ECE 109,A01,091882,Touri; Behrouz,55,0,70,15
1649936652770,ECE 180,A00,083140,Abi Samra; Nicholas Camill,26,0,30,4
1649936652770,ECE 180,B00,083141,Abi Samra; Nicholas Camill,13,0,30,17
1649936658796,MATH 10A,A01,083735,Patchell; Gregory David,20,0,30,10
1649936658796,MATH 10A,A02,083736,Patchell; Gregory David,28,0,30,2
1649936658796,MATH 10A,A03,083737,Patchell; Gregory David,28,0,30,2
1649936664823,MATH 10B,A01,083207,Staff,10,0,30,20
1649936664823,MATH 10B,A02,083208,Staff,25,0,30,5
1649936664823,MATH 10B,B01,083739,Staff,25,0,30,5
1649936664823,MATH 10B,B02,083740,Staff,30,0,30,0
1649936670852,MATH 18,A01,083743,Staff,22,0,30,8
1649936670852,MATH 18,A02,083744,Staff,29,0,30,1
1649936670852,MATH 18,A03,083745,Staff,29,0,30,1
1649936670852,MATH 18,A04,083746,Staff,28,0,30,2
1649936670852,MATH 18,B01,083748,Staff,5,0,30,25
1649936670852,MATH 18,B02,083749,Staff,26,0,30,4
1649936670852,MATH 18,B03,083750,Staff,28,0,30,2
1649936670852,MATH 18,B04,083751,Staff,26,0,30,4
1649936676883,MATH 20A,A01,083754,Staff,37,0,40,3
1649936682914,MATH 20B,A01,083756,Staff,19,0,30,11
1649936682914,MATH 20B,A02,083757,Staff,30,0,30,0
1649936688949,MATH 20C,A01,083760,Staff,22,0,30,8
1649936688949,MATH 20C,A02,083761,Staff,23,0,30,7
1649936688949,MATH 20C,B01,083762,Staff,28,0,30,2
1649936688949,MATH 20C,B02,083763,Staff,30,0,30,0
1649936694978,MATH 20D,A01,083765,Staff,20,0,30,10
1649936694978,MATH 20D,A02,083766,Staff,30,0,30,0
1649936694978,MATH 20D,A03,083767,Staff,30,0,30,0
1649936701011,MATH 20E,A01,083771,Staff,12,0,30,18
1649936701011,MATH 20E,A02,083772,Staff,24,0,30,6
1649936701011,MATH 20E,B01,083773,Staff,17,0,30,13
1649936701011,MATH 20E,B02,083774,Staff,29,0,30,1
1649936707038,MATH 103A,A01,083777,Staff,1,4,30,29
1649936707038,MATH 103A,A02,083778,Staff,0,3,30,30
1649936707038,MATH 103A,B01,083779,Staff,0,0,30,30
1649936707038,MATH 103A,B02,083780,Staff,16,0,30,14
1649936713067,MATH 105,A01,085443,Staff,0,5,30,30
1649936719096,MATH 109,A01,083213,Anzaldo; Leesa B,13,0,30,17
1649936719096,MATH 109,A02,083214,Anzaldo; Leesa B,9,0,30,21
1649936719096,MATH 109,B01,083215,Anzaldo; Leesa B,26,0,30,4
1649936719096,MATH 109,B02,083216,Anzaldo; Leesa B,22,0,30,8
1649936725132,MATH 142A,A01,083219,Chow; Bennett,0,1,30,30
1649936725132,MATH 142A,A02,083220,Chow; Bennett,9,0,30,21
1649936725132,MATH 142A,B01,083221,Chow; Bennett,0,0,30,30
1649936725132,MATH 142A,B02,083222,Chow; Bennett,1,0,30,29
1649936731160,MATH 193A,A01,083224,Staff,0,3,30,30
1649936731160,MATH 193A,A02,083225,Staff,0,3,30,30
1649936731160,MATH 193A,A03,083781,Staff,4,0,30,26
1649936731160,MATH 193A,A04,083782,Staff,16,0,30,14
1649936737186,MATH 197,001,091859,McAuley; Julian John,9999,0,9999,0
1649936743258,COGS 9,A01,083615,Staff,16,0,60,44
1649936749285,COGS 11,A01,083617,Boyle; Mary E. T.,35,0,40,5
1649936755313,COGS 13,A01,083071,Staff,0,11,40,40
1649936761345,COGS 14A,A01,092681,Staff,65,0,100,35
1649936767377,COGS 14B,A01,083073,Cheng; Tzu-Han,24,0,50,26
1649936773403,COGS 17,A01,092677,Staff,63,0,75,12
1649936779432,COGS 100,A01,083619,Staff,0,5,60,60
1649936785465,COGS 101A,A01,083621,Davis; Joshua Daniel,0,8,60,60
1649936791493,COGS 101B,A01,091572,Staff,31,0,60,29
1649936797530,COGS 101C,A01,083625,Delgado; Tania,24,0,30,6
1649936803554,COGS 107A,A01,083627,Boyle; Mary E. T.,14,0,60,46
1649936809580,COGS 118A,A01,083075,Staff,21,0,60,39
1649936815611,CSE 3,A50,083646,Miranda; Gregory Joseph,24,0,38,14
1649936815611,CSE 3,A51,083647,Miranda; Gregory Joseph,37,0,37,0
1649936821644,CSE 8A,A50,083650,Miranda; Gregory Joseph,8,0,40,32
1649936827688,CSE 11,A01,083080,Cao; Yingjun,0,26,40,40
1649936833712,CSE 12,A01,083652,Staff,56,0,100,44
1649936839741,CSE 15L,A01,083654,Staff,19,0,50,31
1649936839741,CSE 15L,A02,083655,Staff,47,0,50,3
1649936845766,CSE 20,A01,083657,Staff,68,0,80,12
1649936851791,CSE 30,A01,083084,Eldon; John,0,24,40,40
1649936857819,CSE 100,A01,083659,Cao; Yingjun,1,27,50,49
1649936863847,CSE 134B,A01,083661,Powell; Thomas Allan,0,21,65,65
1649936869874,CSE 140,A01,083663,Staff,24,0,75,51
1649936875987,CSE 140L,A01,083088,Eldon; John,18,0,75,57
1649936882025,CSE 175,A01,083665,Kumar; Rakesh,12,0,25,13
1649936888060,CSE 190,A00,092507,Dubnov; Shlomo,14,0,15,1
1649936894090,ECE 45,A01,083139,Staff,6,0,40,34
1649936900120,ECE 65,A50,083695,Staff,7,0,30,23
1649936906144,ECE 109,A01,091882,Touri; Behrouz,55,0,70,15
1649936912178,ECE 180,A00,083140,Abi Samra; Nicholas Camill,26,0,30,4
1649936912178,ECE 180,B00,083141,Abi Samra; Nicholas Camill,13,0,30,17
1649936918206,MATH 10A,A01,083735,Patchell; Gregory David,20,0,30,10
1649936918206,MATH 10A,A02,083736,Patchell; Gregory David,28,0,30,2
1649936918206,MATH 10A,A03,083737,Patchell; Gregory David,28,0,30,2
1649936924236,MATH 10B,A01,083207,Staff,10,0,30,20
1649936924236,MATH 10B,A02,083208,Staff,25,0,30,5
1649936924236,MATH 10B,B01,083739,Staff,25,0,30,5
1649936924236,MATH 10B,B02,083740,Staff,30,0,30,0
1649936930274,MATH 18,A01,083743,Staff,22,0,30,8
1649936930274,MATH 18,A02,083744,Staff,29,0,30,1
1649936930274,MATH 18,A03,083745,Staff,29,0,30,1
1649936930274,MATH 18,A04,083746,Staff,28,0,30,2
1649936930274,MATH 18,B01,083748,Staff,5,0,30,25
1649936930274,MATH 18,B02,083749,Staff,26,0,30,4
1649936930274,MATH 18,B03,083750,Staff,28,0,30,2
1649936930274,MATH 18,B04,083751,Staff,26,0,30,4
1649936936298,MATH 20A,A01,083754,Staff,37,0,40,3
1649936942322,MATH 20B,A01,083756,Staff,19,0,30,11
1649936942322,MATH 20B,A02,083757,Staff,30,0,30,0
1649936948354,MATH 20C,A01,083760,Staff,22,0,30,8
1649936948354,MATH 20C,A02,083761,Staff,23,0,30,7
1649936948354,MATH 20C,B01,083762,Staff,28,0,30,2
1649936948354,MATH 20C,B02,083763,Staff,30,0,30,0
1649936954383,MATH 20D,A01,083765,Staff,20,0,30,10
1649936954383,MATH 20D,A02,083766,Staff,30,0,30,0
1649936954383,MATH 20D,A03,083767,Staff,30,0,30,0
1649936960416,MATH 20E,A01,083771,Staff,12,0,30,18
1649936960416,MATH 20E,A02,083772,Staff,24,0,30,6
1649936960416,MATH 20E,B01,083773,Staff,17,0,30,13
1649936960416,MATH 20E,B02,083774,Staff,29,0,30,1
1649936966447,MATH 103A,A01,083777,Staff,1,4,30,29
1649936966447,MATH 103A,A02,083778,Staff,0,3,30,30
1649936966447,MATH 103A,B01,083779,Staff,0,0,30,30
1649936966447,MATH 103A,B02,083780,Staff,16,0,30,14
1649936972475,MATH 105,A01,085443,Staff,0,5,30,30
1649936978503,MATH 109,A01,083213,Anzaldo; Leesa B,13,0,30,17
1649936978503,MATH 109,A02,083214,Anzaldo; Leesa B,9,0,30,21
1649936978503,MATH 109,B01,083215,Anzaldo; Leesa B,26,0,30,4
1649936978503,MATH 109,B02,083216,Anzaldo; Leesa B,22,0,30,8
1649936984531,MATH 142A,A01,083219,Chow; Bennett,0,1,30,30
1649936984531,MATH 142A,A02,083220,Chow; Bennett,9,0,30,21
1649936984531,MATH 142A,B01,083221,Chow; Bennett,0,0,30,30
1649936984531,MATH 142A,B02,083222,Chow; Bennett,1,0,30,29
1649936990558,MATH 193A,A01,083224,Staff,0,3,30,30
1649936990558,MATH 193A,A02,083225,Staff,0,3,30,30
1649936990558,MATH 193A,A03,083781,Staff,4,0,30,26
1649936990558,MATH 193A,A04,083782,Staff,16,0,30,14
1649936996586,MATH 197,001,091859,McAuley; Julian John,9999,0,9999,0
1649937002669,COGS 9,A01,083615,Staff,16,0,60,44
1649937008700,COGS 11,A01,083617,Boyle; Mary E. T.,35,0,40,5
1649937014726,COGS 13,A01,083071,Staff,0,11,40,40
1649937020756,COGS 14A,A01,092681,Staff,65,0,100,35
1649937026788,COGS 14B,A01,083073,Cheng; Tzu-Han,24,0,50,26
1649937032819,COGS 17,A01,092677,Staff,63,0,75,12
1649937038856,COGS 100,A01,083619,Staff,0,5,60,60
1649937044883,COGS 101A,A01,083621,Davis; Joshua Daniel,0,8,60,60
1649937050914,COGS 101B,A01,091572,Staff,31,0,60,29
1649937056941,COGS 101C,A01,083625,Delgado; Tania,24,0,30,6
1649937062967,COGS 107A,A01,083627,Boyle; Mary E. T.,14,0,60,46
1649937068997,COGS 118A,A01,083075,Staff,21,0,60,39
1649937075031,CSE 3,A50,083646,Miranda; Gregory Joseph,24,0,38,14
1649937075031,CSE 3,A51,083647,Miranda; Gregory Joseph,37,0,37,0
1649937081058,CSE 8A,A50,083650,Miranda; Gregory Joseph,8,0,40,32
1649937087086,CSE 11,A01,083080,Cao; Yingjun,0,26,40,40
1649937093114,CSE 12,A01,083652,Staff,56,0,100,44
1649937099139,CSE 15L,A01,083654,Staff,19,0,50,31
1649937099139,CSE 15L,A02,083655,Staff,47,0,50,3
1649937105169,CSE 20,A01,083657,Staff,68,0,80,12
1649937111198,CSE 30,A01,083084,Eldon; John,0,24,40,40
1649937117227,CSE 100,A01,083659,Cao; Yingjun,1,27,50,49
1649937123259,CSE 134B,A01,083661,Powell; Thomas Allan,0,21,65,65
1649937129290,CSE 140,A01,083663,Staff,24,0,75,51
1649937135324,CSE 140L,A01,083088,Eldon; John,18,0,75,57
1649937141354,CSE 175,A01,083665,Kumar; Rakesh,12,0,25,13
1649937147384,CSE 190,A00,092507,Dubnov; Shlomo,14,0,15,1
1649937153416,ECE 45,A01,083139,Staff,6,0,40,34
1649937159443,ECE 65,A50,083695,Staff,7,0,30,23
1649937165481,ECE 109,A01,091882,Touri; Behrouz,55,0,70,15
1649937171508,ECE 180,A00,083140,Abi Samra; Nicholas Camill,26,0,30,4
1649937171508,ECE 180,B00,083141,Abi Samra; Nicholas Camill,13,0,30,17
1649937177543,MATH 10A,A01,083735,Patchell; Gregory David,20,0,30,10
1649937177543,MATH 10A,A02,083736,Patchell; Gregory David,28,0,30,2
1649937177543,MATH 10A,A03,083737,Patchell; Gregory David,28,0,30,2
1649937183570,MATH 10B,A01,083207,Staff,10,0,30,20
1649937183570,MATH 10B,A02,083208,Staff,25,0,30,5
1649937183570,MATH 10B,B01,083739,Staff,25,0,30,5
1649937183570,MATH 10B,B02,083740,Staff,30,0,30,0
1649937189601,MATH 18,A01,083743,Staff,22,0,30,8
1649937189601,MATH 18,A02,083744,Staff,29,0,30,1
1649937189601,MATH 18,A03,083745,Staff,29,0,30,1
1649937189601,MATH 18,A04,083746,Staff,28,0,30,2
1649937189601,MATH 18,B01,083748,Staff,5,0,30,25
1649937189601,MATH 18,B02,083749,Staff,26,0,30,4
1649937189601,MATH 18,B03,083750,Staff,28,0,30,2
1649937189601,MATH 18,B04,083751,Staff,26,0,30,4
1649937195626,MATH 20A,A01,083754,Staff,37,0,40,3
1649937201653,MATH 20B,A01,083756,Staff,19,0,30,11
1649937201653,MATH 20B,A02,083757,Staff,30,0,30,0
1649937207681,MATH 20C,A01,083760,Staff,22,0,30,8
1649937207681,MATH 20C,A02,083761,Staff,23,0,30,7
1649937207681,MATH 20C,B01,083762,Staff,28,0,30,2
1649937207681,MATH 20C,B02,083763,Staff,30,0,30,0
1649937213707,MATH 20D,A01,083765,Staff,20,0,30,10
1649937213707,MATH 20D,A02,083766,Staff,30,0,30,0
1649937213707,MATH 20D,A03,083767,Staff,30,0,30,0
1649937219737,MATH 20E,A01,083771,Staff,12,0,30,18
1649937219737,MATH 20E,A02,083772,Staff,24,0,30,6
1649937219737,MATH 20E,B01,083773,Staff,17,0,30,13
1649937219737,MATH 20E,B02,083774,Staff,29,0,30,1
1649937225765,MATH 103A,A01,083777,Staff,1,4,30,29
1649937225765,MATH 103A,A02,083778,Staff,0,3,30,30
1649937225765,MATH 103A,B01,083779,Staff,0,0,30,30
1649937225765,MATH 103A,B02,083780,Staff,16,0,30,14
1649937231794,MATH 105,A01,085443,Staff,0,5,30,30
1649937237822,MATH 109,A01,083213,Anzaldo; Leesa B,13,0,30,17
1649937237822,MATH 109,A02,083214,Anzaldo; Leesa B,9,0,30,21
1649937237822,MATH 109,B01,083215,Anzaldo; Leesa B,26,0,30,4
1649937237822,MATH 109,B02,083216,Anzaldo; Leesa B,22,0,30,8
1649937243856,MATH 142A,A01,083219,Chow; Bennett,0,1,30,30
1649937243856,MATH 142A,A02,083220,Chow; Bennett,9,0,30,21
1649937243856,MATH 142A,B01,083221,Chow; Bennett,0,0,30,30
1649937243856,MATH 142A,B02,083222,Chow; Bennett,1,0,30,29
1649937250544,MATH 193A,A01,083224,Staff,0,3,30,30
1649937250544,MATH 193A,A02,083225,Staff,0,3,30,30
1649937250544,MATH 193A,A03,083781,Staff,4,0,30,26
1649937250544,MATH 193A,A04,083782,Staff,16,0,30,14
1649937256575,MATH 197,001,091859,McAuley; Julian John,9999,0,9999,0
1649937262642,COGS 9,A01,083615,Staff,16,0,60,44
1649937268670,COGS 11,A01,083617,Boyle; Mary E. T.,35,0,40,5
1649937274696,COGS 13,A01,083071,Staff,0,11,40,40
1649937280721,COGS 14A,A01,092681,Staff,65,0,100,35
1649937286751,COGS 14B,A01,083073,Cheng; Tzu-Han,24,0,50,26
1649937292779,COGS 17,A01,092677,Staff,63,0,75,12
1649937298808,COGS 100,A01,083619,Staff,0,5,60,60
1649937304839,COGS 101A,A01,083621,Davis; Joshua Daniel,0,8,60,60
1649937310866,COGS 101B,A01,091572,Staff,31,0,60,29
1649937316894,COGS 101C,A01,083625,Delgado; Tania,24,0,30,6
1649937322920,COGS 107A,A01,083627,Boyle; Mary E. T.,14,0,60,46
1649937328950,COGS 118A,A01,083075,Staff,21,0,60,39
1649937334978,CSE 3,A50,083646,Miranda; Gregory Joseph,24,0,38,14
1649937334978,CSE 3,A51,083647,Miranda; Gregory Joseph,37,0,37,0
1649937341005,CSE 8A,A50,083650,Miranda; Gregory Joseph,8,0,40,32
1649937347032,CSE 11,A01,083080,Cao; Yingjun,0,26,40,40
1649937353061,CSE 12,A01,083652,Staff,56,0,100,44
1649937359090,CSE 15L,A01,083654,Staff,19,0,50,31
1649937359090,CSE 15L,A02,083655,Staff,47,0,50,3
1649937365118,CSE 20,A01,083657,Staff,68,0,80,12
1649937371145,CSE 30,A01,083084,Eldon; John,0,24,40,40
1649937377175,CSE 100,A01,083659,Cao; Yingjun,1,27,50,49
1649937383202,CSE 134B,A01,083661,Powell; Thomas Allan,0,21,65,65
1649937389232,CSE 140,A01,083663,Staff,24,0,75,51
1649937395260,CSE 140L,A01,083088,Eldon; John,18,0,75,57
1649937401286,CSE 175,A01,083665,Kumar; Rakesh,12,0,25,13
1649937407312,CSE 190,A00,092507,Dubnov; Shlomo,14,0,15,1
1649937413342,ECE 45,A01,083139,Staff,6,0,40,34
1649937419366,ECE 65,A50,083695,Staff,7,0,30,23
1649937425392,ECE 109,A01,091882,Touri; Behrouz,55,0,70,15
1649937431418,ECE 180,A00,083140,Abi Samra; Nicholas Camill,26,0,30,4
1649937431418,ECE 180,B00,083141,Abi Samra; Nicholas Camill,13,0,30,17
1649937437447,MATH 10A,A01,083735,Patchell; Gregory David,20,0,30,10
1649937437447,MATH 10A,A02,083736,Patchell; Gregory David,28,0,30,2
1649937437447,MATH 10A,A03,083737,Patchell; Gregory David,28,0,30,2
1649937443484,MATH 10B,A01,083207,Staff,10,0,30,20
1649937443484,MATH 10B,A02,083208,Staff,25,0,30,5
1649937443484,MATH 10B,B01,083739,Staff,25,0,30,5
1649937443484,MATH 10B,B02,083740,Staff,30,0,30,0
1649937449517,MATH 18,A01,083743,Staff,22,0,30,8
1649937449517,MATH 18,A02,083744,Staff,29,0,30,1
1649937449517,MATH 18,A03,083745,Staff,29,0,30,1
1649937449517,MATH 18,A04,083746,Staff,28,0,30,2
1649937449517,MATH 18,B01,083748,Staff,5,0,30,25
1649937449517,MATH 18,B02,083749,Staff,26,0,30,4
1649937449517,MATH 18,B03,083750,Staff,28,0,30,2
1649937449517,MATH 18,B04,083751,Staff,26,0,30,4
1649937455543,MATH 20A,A01,083754,Staff,37,0,40,3
1649937461573,MATH 20B,A01,083756,Staff,19,0,30,11
1649937461573,MATH 20B,A02,083757,Staff,30,0,30,0
1649937467603,MATH 20C,A01,083760,Staff,22,0,30,8
1649937467603,MATH 20C,A02,083761,Staff,23,0,30,7
1649937467603,MATH 20C,B01,083762,Staff,28,0,30,2
1649937467603,MATH 20C,B02,083763,Staff,30,0,30,0
1649937473719,MATH 20D,A01,083765,Staff,20,0,30,10
1649937473719,MATH 20D,A02,083766,Staff,30,0,30,0
1649937473719,MATH 20D,A03,083767,Staff,30,0,30,0
1649937479750,MATH 20E,A01,083771,Staff,12,0,30,18
1649937479750,MATH 20E,A02,083772,Staff,24,0,30,6
1649937479750,MATH 20E,B01,083773,Staff,17,0,30,13
1649937479750,MATH 20E,B02,083774,Staff,29,0,30,1
1649937485784,MATH 103A,A01,083777,Staff,1,4,30,29
1649937485784,MATH 103A,A02,083778,Staff,0,3,30,30
1649937485784,MATH 103A,B01,083779,Staff,0,0,30,30
1649937485784,MATH 103A,B02,083780,Staff,16,0,30,14
1649937491815,MATH 105,A01,085443,Staff,0,5,30,30
1649937497848,MATH 109,A01,083213,Anzaldo; Leesa B,13,0,30,17
1649937497848,MATH 109,A02,083214,Anzaldo; Leesa B,9,0,30,21
1649937497848,MATH 109,B01,083215,Anzaldo; Leesa B,26,0,30,4
1649937497848,MATH 109,B02,083216,Anzaldo; Leesa B,22,0,30,8
1649937503875,MATH 142A,A01,083219,Chow; Bennett,0,1,30,30
1649937503875,MATH 142A,A02,083220,Chow; Bennett,9,0,30,21
1649937503875,MATH 142A,B01,083221,Chow; Bennett,0,0,30,30
1649937503875,MATH 142A,B02,083222,Chow; Bennett,1,0,30,29
1649937509901,MATH 193A,A01,083224,Staff,0,3,30,30
1649937509901,MATH 193A,A02,083225,Staff,0,3,30,30
1649937509901,MATH 193A,A03,083781,Staff,4,0,30,26
1649937509901,MATH 193A,A04,083782,Staff,16,0,30,14
1649937515931,MATH 197,001,091859,McAuley; Julian John,9999,0,9999,0
1649937521996,COGS 9,A01,083615,Staff,16,0,60,44
1649937528022,COGS 11,A01,083617,Boyle; Mary E. T.,35,0,40,5
1649937534078,COGS 13,A01,083071,Staff,0,11,40,40
1649937540106,COGS 14A,A01,092681,Staff,65,0,100,35
1649937546137,COGS 14B,A01,083073,Cheng; Tzu-Han,24,0,50,26
1649937552162,COGS 17,A01,092677,Staff,63,0,75,12
1649937558188,COGS 100,A01,083619,Staff,0,5,60,60
1649937564213,COGS 101A,A01,083621,Davis; Joshua Daniel,0,8,60,60
1649937570252,COGS 101B,A01,091572,Staff,31,0,60,29
1649937576288,COGS 101C,A01,083625,Delgado; Tania,24,0,30,6
1649937582313,COGS 107A,A01,083627,Boyle; Mary E. T.,14,0,60,46
1649937588338,COGS 118A,A01,083075,Staff,21,0,60,39
1649937594374,CSE 3,A50,083646,Miranda; Gregory Joseph,24,0,38,14
1649937594374,CSE 3,A51,083647,Miranda; Gregory Joseph,37,0,37,0
1649937600399,CSE 8A,A50,083650,Miranda; Gregory Joseph,8,0,40,32
1649937606423,CSE 11,A01,083080,Cao; Yingjun,0,26,40,40
1649937612448,CSE 12,A01,083652,Staff,56,0,100,44
1649937618478,CSE 15L,A01,083654,Staff,19,0,50,31
1649937618478,CSE 15L,A02,083655,Staff,47,0,50,3
1649937624504,CSE 20,A01,083657,Staff,68,0,80,12
1649937630531,CSE 30,A01,083084,Eldon; John,0,24,40,40
1649937636556,CSE 100,A01,083659,Cao; Yingjun,1,27,50,49
1649937642596,CSE 134B,A01,083661,Powell; Thomas Allan,0,21,65,65
1649937648624,CSE 140,A01,083663,Staff,24,0,75,51
1649937654655,CSE 140L,A01,083088,Eldon; John,18,0,75,57
1649937660681,CSE 175,A01,083665,Kumar; Rakesh,12,0,25,13
1649937666712,CSE 190,A00,092507,Dubnov; Shlomo,14,0,15,1
1649937672742,ECE 45,A01,083139,Staff,6,0,40,34
1649937678769,ECE 65,A50,083695,Staff,7,0,30,23
1649937684795,ECE 109,A01,091882,Touri; Behrouz,55,0,70,15
1649937690820,ECE 180,A00,083140,Abi Samra; Nicholas Camill,26,0,30,4
1649937690820,ECE 180,B00,083141,Abi Samra; Nicholas Camill,13,0,30,17
1649937696853,MATH 10A,A01,083735,Patchell; Gregory David,20,0,30,10
1649937696853,MATH 10A,A02,083736,Patchell; Gregory David,28,0,30,2
1649937696853,MATH 10A,A03,083737,Patchell; Gregory David,28,0,30,2
1649937702882,MATH 10B,A01,083207,Staff,10,0,30,20
1649937702882,MATH 10B,A02,083208,Staff,25,0,30,5
1649937702882,MATH 10B,B01,083739,Staff,25,0,30,5
1649937702882,MATH 10B,B02,083740,Staff,30,0,30,0
1649937708910,MATH 18,A01,083743,Staff,22,0,30,8
1649937708910,MATH 18,A02,083744,Staff,29,0,30,1
1649937708910,MATH 18,A03,083745,Staff,29,0,30,1
1649937708910,MATH 18,A04,083746,Staff,28,0,30,2
1649937708910,MATH 18,B01,083748,Staff,5,0,30,25
1649937708910,MATH 18,B02,083749,Staff,26,0,30,4
1649937708910,MATH 18,B03,083750,Staff,28,0,30,2
1649937708910,MATH 18,B04,083751,Staff,26,0,30,4
1649937714934,MATH 20A,A01,083754,Staff,37,0,40,3
1649937720967,MATH 20B,A01,083756,Staff,19,0,30,11
1649937720967,MATH 20B,A02,083757,Staff,30,0,30,0
1649937727011,MATH 20C,A01,083760,Staff,22,0,30,8
1649937727011,MATH 20C,A02,083761,Staff,23,0,30,7
1649937727011,MATH 20C,B01,083762,Staff,28,0,30,2
1649937727011,MATH 20C,B02,083763,Staff,30,0,30,0
1649937733042,MATH 20D,A01,083765,Staff,20,0,30,10
1649937733042,MATH 20D,A02,083766,Staff,30,0,30,0
1649937733042,MATH 20D,A03,083767,Staff,30,0,30,0
1649937739073,MATH 20E,A01,083771,Staff,12,0,30,18
1649937739073,MATH 20E,A02,083772,Staff,24,0,30,6
1649937739073,MATH 20E,B01,083773,Staff,17,0,30,13
1649937739073,MATH 20E,B02,083774,Staff,29,0,30,1
1649937745098,MATH 103A,A01,083777,Staff,1,4,30,29
1649937745098,MATH 103A,A02,083778,Staff,0,3,30,30
1649937745098,MATH 103A,B01,083779,Staff,0,0,30,30
1649937745098,MATH 103A,B02,083780,Staff,16,0,30,14
1649937751130,MATH 105,A01,085443,Staff,0,5,30,30
1649937757169,MATH 109,A01,083213,Anzaldo; Leesa B,13,0,30,17
1649937757169,MATH 109,A02,083214,Anzaldo; Leesa B,9,0,30,21
1649937757169,MATH 109,B01,083215,Anzaldo; Leesa B,26,0,30,4
1649937757169,MATH 109,B02,083216,Anzaldo; Leesa B,22,0,30,8
1649937763194,MATH 142A,A01,083219,Chow; Bennett,0,1,30,30
1649937763194,MATH 142A,A02,083220,Chow; Bennett,9,0,30,21
1649937763194,MATH 142A,B01,083221,Chow; Bennett,0,0,30,30
1649937763194,MATH 142A,B02,083222,Chow; Bennett,1,0,30,29
1649937769228,MATH 193A,A01,083224,Staff,0,3,30,30
1649937769228,MATH 193A,A02,083225,Staff,0,3,30,30
1649937769228,MATH 193A,A03,083781,Staff,4,0,30,26
1649937769228,MATH 193A,A04,083782,Staff,16,0,30,14
1649937775253,MATH 197,001,091859,McAuley; Julian John,9999,0,9999,0
1649937781333,COGS 9,A01,083615,Staff,16,0,60,44
1649937787359,COGS 11,A01,083617,Boyle; Mary E. T.,35,0,40,5
1649937793386,COGS 13,A01,083071,Staff,0,11,40,40
1649937799414,COGS 14A,A01,092681,Staff,65,0,100,35
1649937805446,COGS 14B,A01,083073,Cheng; Tzu-Han,24,0,50,26
1649937811471,COGS 17,A01,092677,Staff,63,0,75,12
1649937817498,COGS 100,A01,083619,Staff,0,5,60,60
1649937823524,COGS 101A,A01,083621,Davis; Joshua Daniel,0,8,60,60
1649937829553,COGS 101B,A01,091572,Staff,31,0,60,29
1649937835578,COGS 101C,A01,083625,Delgado; Tania,24,0,30,6
1649937841604,COGS 107A,A01,083627,Boyle; Mary E. T.,14,0,60,46
1649937847634,COGS 118A,A01,083075,Staff,21,0,60,39
1649937853662,CSE 3,A50,083646,Miranda; Gregory Joseph,24,0,38,14
1649937853662,CSE 3,A51,083647,Miranda; Gregory Joseph,37,0,37,0
1649937859689,CSE 8A,A50,083650,Miranda; Gregory Joseph,8,0,40,32
1649937865725,CSE 11,A01,083080,Cao; Yingjun,0,26,40,40
1649937871752,CSE 12,A01,083652,Staff,56,0,100,44
1649937877787,CSE 15L,A01,083654,Staff,19,0,50,31
1649937877787,CSE 15L,A02,083655,Staff,47,0,50,3
1649937883819,CSE 20,A01,083657,Staff,68,0,80,12
1649937889853,CSE 30,A01,083084,Eldon; John,0,24,40,40
1649937895880,CSE 100,A01,083659,Cao; Yingjun,1,27,50,49
1649937901920,CSE 134B,A01,083661,Powell; Thomas Allan,0,21,65,65
1649937907950,CSE 140,A01,083663,Staff,24,0,75,51
1649937913979,CSE 140L,A01,083088,Eldon; John,18,0,75,57
1649937920006,CSE 175,A01,083665,Kumar; Rakesh,12,0,25,13
1649937926038,CSE 190,A00,092507,Dubnov; Shlomo,14,0,15,1
1649937932066,ECE 45,A01,083139,Staff,6,0,40,34
1649937938093,ECE 65,A50,083695,Staff,7,0,30,23
1649937944118,ECE 109,A01,091882,Touri; Behrouz,55,0,70,15
1649937950156,ECE 180,A00,083140,Abi Samra; Nicholas Camill,26,0,30,4
1649937950156,ECE 180,B00,083141,Abi Samra; Nicholas Camill,13,0,30,17
1649937956185,MATH 10A,A01,083735,Patchell; Gregory David,20,0,30,10
1649937956185,MATH 10A,A02,083736,Patchell; Gregory David,28,0,30,2
1649937956185,MATH 10A,A03,083737,Patchell; Gregory David,28,0,30,2
1649937962216,MATH 10B,A01,083207,Staff,10,0,30,20
1649937962216,MATH 10B,A02,083208,Staff,25,0,30,5
1649937962216,MATH 10B,B01,083739,Staff,25,0,30,5
1649937962216,MATH 10B,B02,083740,Staff,30,0,30,0
1649937968259,MATH 18,A01,083743,Staff,22,0,30,8
1649937968259,MATH 18,A02,083744,Staff,29,0,30,1
1649937968259,MATH 18,A03,083745,Staff,29,0,30,1
1649937968259,MATH 18,A04,083746,Staff,28,0,30,2
1649937968259,MATH 18,B01,083748,Staff,5,0,30,25
1649937968259,MATH 18,B02,083749,Staff,26,0,30,4
1649937968259,MATH 18,B03,083750,Staff,28,0,30,2
1649937968259,MATH 18,B04,083751,Staff,26,0,30,4
1649937974288,MATH 20A,A01,083754,Staff,37,0,40,3
1649937980321,MATH 20B,A01,083756,Staff,19,0,30,11
1649937980321,MATH 20B,A02,083757,Staff,30,0,30,0
1649937986346,MATH 20C,A01,083760,Staff,22,0,30,8
1649937986346,MATH 20C,A02,083761,Staff,23,0,30,7
1649937986346,MATH 20C,B01,083762,Staff,28,0,30,2
1649937986346,MATH 20C,B02,083763,Staff,30,0,30,0
1649937992381,MATH 20D,A01,083765,Staff,20,0,30,10
1649937992381,MATH 20D,A02,083766,Staff,30,0,30,0
1649937992381,MATH 20D,A03,083767,Staff,30,0,30,0
1649937998408,MATH 20E,A01,083771,Staff,12,0,30,18
1649937998408,MATH 20E,A02,083772,Staff,24,0,30,6
1649937998408,MATH 20E,B01,083773,Staff,17,0,30,13
1649937998408,MATH 20E,B02,083774,Staff,29,0,30,1
1649938004439,MATH 103A,A01,083777,Staff,1,4,30,29
1649938004439,MATH 103A,A02,083778,Staff,0,3,30,30
1649938004439,MATH 103A,B01,083779,Staff,0,0,30,30
1649938004439,MATH 103A,B02,083780,Staff,16,0,30,14
1649938010466,MATH 105,A01,085443,Staff,0,5,30,30
1649938016495,MATH 109,A01,083213,Anzaldo; Leesa B,13,0,30,17
1649938016495,MATH 109,A02,083214,Anzaldo; Leesa B,9,0,30,21
1649938016495,MATH 109,B01,083215,Anzaldo; Leesa B,26,0,30,4
1649938016495,MATH 109,B02,083216,Anzaldo; Leesa B,22,0,30,8
1649938022521,MATH 142A,A01,083219,Chow; Bennett,0,1,30,30
1649938022521,MATH 142A,A02,083220,Chow; Bennett,9,0,30,21
1649938022521,MATH 142A,B01,083221,Chow; Bennett,0,0,30,30
1649938022521,MATH 142A,B02,083222,Chow; Bennett,1,0,30,29
1649938028546,MATH 193A,A01,083224,Staff,0,3,30,30
1649938028546,MATH 193A,A02,083225,Staff,0,3,30,30
1649938028546,MATH 193A,A03,083781,Staff,4,0,30,26
1649938028546,MATH 193A,A04,083782,Staff,16,0,30,14
1649938034582,MATH 197,001,091859,McAuley; Julian John,9999,0,9999,0
1649938040662,COGS 9,A01,083615,Staff,16,0,60,44
1649938046691,COGS 11,A01,083617,Boyle; Mary E. T.,35,0,40,5
1649938052721,COGS 13,A01,083071,Staff,0,11,40,40
1649938058746,COGS 14A,A01,092681,Staff,65,0,100,35
1649938064867,COGS 14B,A01,083073,Cheng; Tzu-Han,24,0,50,26
1649938070894,COGS 17,A01,092677,Staff,63,0,75,12
1649938076921,COGS 100,A01,083619,Staff,0,5,60,60
1649938082952,COGS 101A,A01,083621,Davis; Joshua Daniel,0,8,60,60
1649938088977,COGS 101B,A01,091572,Staff,31,0,60,29
1649938095007,COGS 101C,A01,083625,Delgado; Tania,24,0,30,6
1649938101036,COGS 107A,A01,083627,Boyle; Mary E. T.,14,0,60,46
1649938107071,COGS 118A,A01,083075,Staff,21,0,60,39
1649938113102,CSE 3,A50,083646,Miranda; Gregory Joseph,24,0,38,14
1649938113102,CSE 3,A51,083647,Miranda; Gregory Joseph,37,0,37,0
1649938119129,CSE 8A,A50,083650,Miranda; Gregory Joseph,8,0,40,32
1649938125157,CSE 11,A01,083080,Cao; Yingjun,0,26,40,40
1649938131188,CSE 12,A01,083652,Staff,56,0,100,44
1649938137239,CSE 15L,A01,083654,Staff,19,0,50,31
1649938137239,CSE 15L,A02,083655,Staff,47,0,50,3
1649938143274,CSE 20,A01,083657,Staff,68,0,80,12
1649938149313,CSE 30,A01,083084,Eldon; John,0,24,40,40
1649938155340,CSE 100,A01,083659,Cao; Yingjun,1,27,50,49
1649938161373,CSE 134B,A01,083661,Powell; Thomas Allan,0,21,65,65
1649938167408,CSE 140,A01,083663,Staff,24,0,75,51
1649938173435,CSE 140L,A01,083088,Eldon; John,18,0,75,57
1649938179464,CSE 175,A01,083665,Kumar; Rakesh,12,0,25,13
1649938185496,CSE 190,A00,092507,Dubnov; Shlomo,14,0,15,1
1649938191524,ECE 45,A01,083139,Staff,6,0,40,34
1649938197550,ECE 65,A50,083695,Staff,7,0,30,23
1649938203598,ECE 109,A01,091882,Touri; Behrouz,55,0,70,15
1649938209625,ECE 180,A00,083140,Abi Samra; Nicholas Camill,26,0,30,4
1649938209625,ECE 180,B00,083141,Abi Samra; Nicholas Camill,13,0,30,17
1649938215652,MATH 10A,A01,083735,Patchell; Gregory David,20,0,30,10
1649938215652,MATH 10A,A02,083736,Patchell; Gregory David,28,0,30,2
1649938215652,MATH 10A,A03,083737,Patchell; Gregory David,28,0,30,2
1649938221689,MATH 10B,A01,083207,Staff,10,0,30,20
1649938221689,MATH 10B,A02,083208,Staff,25,0,30,5
1649938221689,MATH 10B,B01,083739,Staff,25,0,30,5
1649938221689,MATH 10B,B02,083740,Staff,30,0,30,0
1649938227718,MATH 18,A01,083743,Staff,22,0,30,8
1649938227718,MATH 18,A02,083744,Staff,29,0,30,1
1649938227718,MATH 18,A03,083745,Staff,29,0,30,1
1649938227718,MATH 18,A04,083746,Staff,28,0,30,2
1649938227718,MATH 18,B01,083748,Staff,5,0,30,25
1649938227718,MATH 18,B02,083749,Staff,26,0,30,4
1649938227718,MATH 18,B03,083750,Staff,28,0,30,2
1649938227718,MATH 18,B04,083751,Staff,26,0,30,4
1649938233746,MATH 20A,A01,083754,Staff,37,0,40,3
1649938239776,MATH 20B,A01,083756,Staff,19,0,30,11
1649938239776,MATH 20B,A02,083757,Staff,30,0,30,0
1649938245802,MATH 20C,A01,083760,Staff,22,0,30,8
1649938245802,MATH 20C,A02,083761,Staff,23,0,30,7
1649938245802,MATH 20C,B01,083762,Staff,28,0,30,2
1649938245802,MATH 20C,B02,083763,Staff,30,0,30,0
1649938251830,MATH 20D,A01,083765,Staff,20,0,30,10
1649938251830,MATH 20D,A02,083766,Staff,30,0,30,0
1649938251830,MATH 20D,A03,083767,Staff,30,0,30,0
1649938257856,MATH 20E,A01,083771,Staff,12,0,30,18
1649938257856,MATH 20E,A02,083772,Staff,24,0,30,6
1649938257856,MATH 20E,B01,083773,Staff,17,0,30,13
1649938257856,MATH 20E,B02,083774,Staff,29,0,30,1
1649938263886,MATH 103A,A01,083777,Staff,1,4,30,29
1649938263886,MATH 103A,A02,083778,Staff,0,3,30,30
1649938263886,MATH 103A,B01,083779,Staff,0,0,30,30
1649938263886,MATH 103A,B02,083780,Staff,16,0,30,14
1649938269929,MATH 105,A01,085443,Staff,0,5,30,30
1649938275958,MATH 109,A01,083213,Anzaldo; Leesa B,13,0,30,17
1649938275958,MATH 109,A02,083214,Anzaldo; Leesa B,9,0,30,21
1649938275958,MATH 109,B01,083215,Anzaldo; Leesa B,26,0,30,4
1649938275958,MATH 109,B02,083216,Anzaldo; Leesa B,22,0,30,8
1649938282018,MATH 142A,A01,083219,Chow; Bennett,0,1,30,30
1649938282018,MATH 142A,A02,083220,Chow; Bennett,9,0,30,21
1649938282018,MATH 142A,B01,083221,Chow; Bennett,0,0,30,30
1649938282018,MATH 142A,B02,083222,Chow; Bennett,1,0,30,29
1649938288051,MATH 193A,A01,083224,Staff,0,3,30,30
1649938288051,MATH 193A,A02,083225,Staff,0,3,30,30
1649938288051,MATH 193A,A03,083781,Staff,4,0,30,26
1649938288051,MATH 193A,A04,083782,Staff,16,0,30,14
1649938294079,MATH 197,001,091859,McAuley; Julian John,9999,0,9999,0
1649938300151,COGS 9,A01,083615,Staff,16,0,60,44
1649938306179,COGS 11,A01,083617,Boyle; Mary E. T.,35,0,40,5
1649938312203,COGS 13,A01,083071,Staff,0,11,40,40
1649938318232,COGS 14A,A01,092681,Staff,65,0,100,35
1649938324256,COGS 14B,A01,083073,Cheng; Tzu-Han,24,0,50,26
1649938330296,COGS 17,A01,092677,Staff,63,0,75,12
1649938336321,COGS 100,A01,083619,Staff,0,5,60,60
1649938342345,COGS 101A,A01,083621,Davis; Joshua Daniel,0,8,60,60
1649938348383,COGS 101B,A01,091572,Staff,31,0,60,29
1649938354417,COGS 101C,A01,083625,Delgado; Tania,24,0,30,6
1649938360443,COGS 107A,A01,083627,Boyle; Mary E. T.,14,0,60,46
1649938366474,COGS 118A,A01,083075,Staff,21,0,60,39
1649938372502,CSE 3,A50,083646,Miranda; Gregory Joseph,24,0,38,14
1649938372502,CSE 3,A51,083647,Miranda; Gregory Joseph,37,0,37,0
1649938378527,CSE 8A,A50,083650,Miranda; Gregory Joseph,8,0,40,32
1649938384564,CSE 11,A01,083080,Cao; Yingjun,0,26,40,40
1649938390591,CSE 12,A01,083652,Staff,56,0,100,44
1649938396622,CSE 15L,A01,083654,Staff,19,0,50,31
1649938396622,CSE 15L,A02,083655,Staff,47,0,50,3
1649938402654,CSE 20,A01,083657,Staff,68,0,80,12
1649938408685,CSE 30,A01,083084,Eldon; John,0,24,40,40
1649938414711,CSE 100,A01,083659,Cao; Yingjun,1,27,50,49
1649938420741,CSE 134B,A01,083661,Powell; Thomas Allan,0,21,65,65
1649938426772,CSE 140,A01,083663,Staff,24,0,75,51
1649938432803,CSE 140L,A01,083088,Eldon; John,18,0,75,57
1649938438833,CSE 175,A01,083665,Kumar; Rakesh,12,0,25,13
1649938444870,CSE 190,A00,092507,Dubnov; Shlomo,14,0,15,1
1649938450912,ECE 45,A01,083139,Staff,6,0,40,34
1649938456936,ECE 65,A50,083695,Staff,7,0,30,23
1649938462978,ECE 109,A01,091882,Touri; Behrouz,55,0,70,15
1649938469003,ECE 180,A00,083140,Abi Samra; Nicholas Camill,26,0,30,4
1649938469003,ECE 180,B00,083141,Abi Samra; Nicholas Camill,13,0,30,17
1649938475034,MATH 10A,A01,083735,Patchell; Gregory David,20,0,30,10
1649938475034,MATH 10A,A02,083736,Patchell; Gregory David,28,0,30,2
1649938475034,MATH 10A,A03,083737,Patchell; Gregory David,28,0,30,2
1649938481062,MATH 10B,A01,083207,Staff,10,0,30,20
1649938481062,MATH 10B,A02,083208,Staff,25,0,30,5
1649938481062,MATH 10B,B01,083739,Staff,25,0,30,5
1649938481062,MATH 10B,B02,083740,Staff,30,0,30,0
1649938487095,MATH 18,A01,083743,Staff,22,0,30,8
1649938487095,MATH 18,A02,083744,Staff,29,0,30,1
1649938487095,MATH 18,A03,083745,Staff,29,0,30,1
1649938487095,MATH 18,A04,083746,Staff,28,0,30,2
1649938487095,MATH 18,B01,083748,Staff,5,0,30,25
1649938487095,MATH 18,B02,083749,Staff,26,0,30,4
1649938487095,MATH 18,B03,083750,Staff,28,0,30,2
1649938487095,MATH 18,B04,083751,Staff,26,0,30,4
1649938493120,MATH 20A,A01,083754,Staff,37,0,40,3
1649938499146,MATH 20B,A01,083756,Staff,19,0,30,11
1649938499146,MATH 20B,A02,083757,Staff,30,0,30,0
1649938505175,MATH 20C,A01,083760,Staff,22,0,30,8
1649938505175,MATH 20C,A02,083761,Staff,23,0,30,7
1649938505175,MATH 20C,B01,083762,Staff,28,0,30,2
1649938505175,MATH 20C,B02,083763,Staff,30,0,30,0
1649938511207,MATH 20D,A01,083765,Staff,20,0,30,10
1649938511207,MATH 20D,A02,083766,Staff,30,0,30,0
1649938511207,MATH 20D,A03,083767,Staff,30,0,30,0
1649938517233,MATH 20E,A01,083771,Staff,12,0,30,18
1649938517233,MATH 20E,A02,083772,Staff,24,0,30,6
1649938517233,MATH 20E,B01,083773,Staff,17,0,30,13
1649938517233,MATH 20E,B02,083774,Staff,29,0,30,1
1649938523281,MATH 103A,A01,083777,Staff,1,4,30,29
1649938523281,MATH 103A,A02,083778,Staff,0,3,30,30
1649938523281,MATH 103A,B01,083779,Staff,0,0,30,30
1649938523281,MATH 103A,B02,083780,Staff,16,0,30,14
1649938529306,MATH 105,A01,085443,Staff,0,5,30,30
1649938535335,MATH 109,A01,083213,Anzaldo; Leesa B,13,0,30,17
1649938535335,MATH 109,A02,083214,Anzaldo; Leesa B,9,0,30,21
1649938535335,MATH 109,B01,083215,Anzaldo; Leesa B,26,0,30,4
1649938535335,MATH 109,B02,083216,Anzaldo; Leesa B,22,0,30,8
1649938541364,MATH 142A,A01,083219,Chow; Bennett,0,1,30,30
1649938541364,MATH 142A,A02,083220,Chow; Bennett,9,0,30,21
1649938541364,MATH 142A,B01,083221,Chow; Bennett,0,0,30,30
1649938541364,MATH 142A,B02,083222,Chow; Bennett,1,0,30,29
1649938547398,MATH 193A,A01,083224,Staff,0,3,30,30
1649938547398,MATH 193A,A02,083225,Staff,0,3,30,30
1649938547398,MATH 193A,A03,083781,Staff,4,0,30,26
1649938547398,MATH 193A,A04,083782,Staff,16,0,30,14
1649938553422,MATH 197,001,091859,McAuley; Julian John,9999,0,9999,0
1649938559489,COGS 9,A01,083615,Staff,16,0,60,44
1649938565525,COGS 11,A01,083617,Boyle; Mary E. T.,35,0,40,5
1649938571557,COGS 13,A01,083071,Staff,0,11,40,40
1649938577588,COGS 14A,A01,092681,Staff,65,0,100,35
1649938583615,COGS 14B,A01,083073,Cheng; Tzu-Han,24,0,50,26
1649938589651,COGS 17,A01,092677,Staff,63,0,75,12
1649938595676,COGS 100,A01,083619,Staff,0,5,60,60
1649938601709,COGS 101A,A01,083621,Davis; Joshua Daniel,0,8,60,60
1649938607735,COGS 101B,A01,091572,Staff,31,0,60,29
1649938613761,COGS 101C,A01,083625,Delgado; Tania,24,0,30,6
1649938619792,COGS 107A,A01,083627,Boyle; Mary E. T.,14,0,60,46
1649938625822,COGS 118A,A01,083075,Staff,21,0,60,39
1649938631853,CSE 3,A50,083646,Miranda; Gregory Joseph,24,0,38,14
1649938631853,CSE 3,A51,083647,Miranda; Gregory Joseph,37,0,37,0
1649938637878,CSE 8A,A50,083650,Miranda; Gregory Joseph,8,0,40,32
1649938643902,CSE 11,A01,083080,Cao; Yingjun,0,26,40,40
1649938649926,CSE 12,A01,083652,Staff,56,0,100,44
1649938655953,CSE 15L,A01,083654,Staff,19,0,50,31
1649938655953,CSE 15L,A02,083655,Staff,47,0,50,3
1649938662071,CSE 20,A01,083657,Staff,68,0,80,12
1649938668102,CSE 30,A01,083084,Eldon; John,0,24,40,40
1649938674153,CSE 100,A01,083659,Cao; Yingjun,1,27,50,49
1649938680178,CSE 134B,A01,083661,Powell; Thomas Allan,0,21,65,65
1649938686203,CSE 140,A01,083663,Staff,24,0,75,51
1649938692230,CSE 140L,A01,083088,Eldon; John,18,0,75,57
1649938698259,CSE 175,A01,083665,Kumar; Rakesh,12,0,25,13
1649938704297,CSE 190,A00,092507,Dubnov; Shlomo,14,0,15,1
1649938710323,ECE 45,A01,083139,Staff,6,0,40,34
1649938716354,ECE 65,A50,083695,Staff,7,0,30,23
1649938722391,ECE 109,A01,091882,Touri; Behrouz,55,0,70,15
1649938728421,ECE 180,A00,083140,Abi Samra; Nicholas Camill,26,0,30,4
1649938728421,ECE 180,B00,083141,Abi Samra; Nicholas Camill,13,0,30,17
1649938734448,MATH 10A,A01,083735,Patchell; Gregory David,20,0,30,10
1649938734448,MATH 10A,A02,083736,Patchell; Gregory David,28,0,30,2
1649938734448,MATH 10A,A03,083737,Patchell; Gregory David,28,0,30,2
1649938740482,MATH 10B,A01,083207,Staff,10,0,30,20
1649938740482,MATH 10B,A02,083208,Staff,25,0,30,5
1649938740482,MATH 10B,B01,083739,Staff,25,0,30,5
1649938740482,MATH 10B,B02,083740,Staff,30,0,30,0
1649938746511,MATH 18,A01,083743,Staff,22,0,30,8
1649938746511,MATH 18,A02,083744,Staff,29,0,30,1
1649938746511,MATH 18,A03,083745,Staff,29,0,30,1
1649938746511,MATH 18,A04,083746,Staff,28,0,30,2
1649938746511,MATH 18,B01,083748,Staff,5,0,30,25
1649938746511,MATH 18,B02,083749,Staff,26,0,30,4
1649938746511,MATH 18,B03,083750,Staff,28,0,30,2
1649938746511,MATH 18,B04,083751,Staff,26,0,30,4
1649938752542,MATH 20A,A01,083754,Staff,37,0,40,3
1649938758580,MATH 20B,A01,083756,Staff,19,0,30,11
1649938758580,MATH 20B,A02,083757,Staff,30,0,30,0
1649938764627,MATH 20C,A01,083760,Staff,22,0,30,8
1649938764627,MATH 20C,A02,083761,Staff,23,0,30,7
1649938764627,MATH 20C,B01,083762,Staff,28,0,30,2
1649938764627,MATH 20C,B02,083763,Staff,30,0,30,0
1649938770665,MATH 20D,A01,083765,Staff,20,0,30,10
1649938770665,MATH 20D,A02,083766,Staff,30,0,30,0
1649938770665,MATH 20D,A03,083767,Staff,30,0,30,0
1649938776696,MATH 20E,A01,083771,Staff,12,0,30,18
1649938776696,MATH 20E,A02,083772,Staff,24,0,30,6
1649938776696,MATH 20E,B01,083773,Staff,17,0,30,13
1649938776696,MATH 20E,B02,083774,Staff,29,0,30,1
1649938782724,MATH 103A,A01,083777,Staff,1,4,30,29
1649938782724,MATH 103A,A02,083778,Staff,0,3,30,30
1649938782724,MATH 103A,B01,083779,Staff,0,0,30,30
1649938782724,MATH 103A,B02,083780,Staff,16,0,30,14
1649938788754,MATH 105,A01,085443,Staff,0,5,30,30
1649938794786,MATH 109,A01,083213,Anzaldo; Leesa B,13,0,30,17
1649938794786,MATH 109,A02,083214,Anzaldo; Leesa B,9,0,30,21
1649938794786,MATH 109,B01,083215,Anzaldo; Leesa B,26,0,30,4
1649938794786,MATH 109,B02,083216,Anzaldo; Leesa B,22,0,30,8
1649938800819,MATH 142A,A01,083219,Chow; Bennett,0,1,30,30
1649938800819,MATH 142A,A02,083220,Chow; Bennett,9,0,30,21
1649938800819,MATH 142A,B01,083221,Chow; Bennett,0,0,30,30
1649938800819,MATH 142A,B02,083222,Chow; Bennett,1,0,30,29
1649938806848,MATH 193A,A01,083224,Staff,0,3,30,30
1649938806848,MATH 193A,A02,083225,Staff,0,3,30,30
1649938806848,MATH 193A,A03,083781,Staff,4,0,30,26
1649938806848,MATH 193A,A04,083782,Staff,16,0,30,14
1649938812873,MATH 197,001,091859,McAuley; Julian John,9999,0,9999,0
1649938818938,COGS 9,A01,083615,Staff,16,0,60,44
1649938824963,COGS 11,A01,083617,Boyle; Mary E. T.,35,0,40,5
1649938830998,COGS 13,A01,083071,Staff,0,11,40,40
1649938837023,COGS 14A,A01,092681,Staff,65,0,100,35
1649938843053,COGS 14B,A01,083073,Cheng; Tzu-Han,24,0,50,26
1649938849082,COGS 17,A01,092677,Staff,63,0,75,12
1649938855108,COGS 100,A01,083619,Staff,0,5,60,60
1649938861139,COGS 101A,A01,083621,Davis; Joshua Daniel,0,8,60,60
1649938867168,COGS 101B,A01,091572,Staff,31,0,60,29
1649938873194,COGS 101C,A01,083625,Delgado; Tania,24,0,30,6
1649938879232,COGS 107A,A01,083627,Boyle; Mary E. T.,14,0,60,46
1649938885255,COGS 118A,A01,083075,Staff,21,0,60,39
1649938891284,CSE 3,A50,083646,Miranda; Gregory Joseph,24,0,38,14
1649938891284,CSE 3,A51,083647,Miranda; Gregory Joseph,37,0,37,0
1649938897312,CSE 8A,A50,083650,Miranda; Gregory Joseph,8,0,40,32
1649938903343,CSE 11,A01,083080,Cao; Yingjun,0,26,40,40
1649938909371,CSE 12,A01,083652,Staff,56,0,100,44
1649938915396,CSE 15L,A01,083654,Staff,19,0,50,31
1649938915396,CSE 15L,A02,083655,Staff,47,0,50,3
1649938921424,CSE 20,A01,083657,Staff,68,0,80,12
1649938927451,CSE 30,A01,083084,Eldon; John,0,24,40,40
1649938933482,CSE 100,A01,083659,Cao; Yingjun,1,27,50,49
1649938939530,CSE 134B,A01,083661,Powell; Thomas Allan,0,21,65,65
1649938945554,CSE 140,A01,083663,Staff,24,0,75,51
1649938951579,CSE 140L,A01,083088,Eldon; John,18,0,75,57
1649938957611,CSE 175,A01,083665,Kumar; Rakesh,12,0,25,13
1649938963637,CSE 190,A00,092507,Dubnov; Shlomo,14,0,15,1
1649938969664,ECE 45,A01,083139,Staff,6,0,40,34
1649938975696,ECE 65,A50,083695,Staff,7,0,30,23
1649938981730,ECE 109,A01,091882,Touri; Behrouz,55,0,70,15
1649938987754,ECE 180,A00,083140,Abi Samra; Nicholas Camill,26,0,30,4
1649938987754,ECE 180,B00,083141,Abi Samra; Nicholas Camill,13,0,30,17
1649938993785,MATH 10A,A01,083735,Patchell; Gregory David,20,0,30,10
1649938993785,MATH 10A,A02,083736,Patchell; Gregory David,28,0,30,2
1649938993785,MATH 10A,A03,083737,Patchell; Gregory David,28,0,30,2
1649938999818,MATH 10B,A01,083207,Staff,10,0,30,20
1649938999818,MATH 10B,A02,083208,Staff,25,0,30,5
1649938999818,MATH 10B,B01,083739,Staff,25,0,30,5
1649938999818,MATH 10B,B02,083740,Staff,30,0,30,0
1649939005850,MATH 18,A01,083743,Staff,22,0,30,8
1649939005850,MATH 18,A02,083744,Staff,29,0,30,1
1649939005850,MATH 18,A03,083745,Staff,29,0,30,1
1649939005850,MATH 18,A04,083746,Staff,28,0,30,2
1649939005850,MATH 18,B01,083748,Staff,5,0,30,25
1649939005850,MATH 18,B02,083749,Staff,26,0,30,4
1649939005850,MATH 18,B03,083750,Staff,28,0,30,2
1649939005850,MATH 18,B04,083751,Staff,26,0,30,4
1649939011875,MATH 20A,A01,083754,Staff,37,0,40,3
1649939017899,MATH 20B,A01,083756,Staff,19,0,30,11
1649939017899,MATH 20B,A02,083757,Staff,30,0,30,0
1649939023926,MATH 20C,A01,083760,Staff,22,0,30,8
1649939023926,MATH 20C,A02,083761,Staff,23,0,30,7
1649939023926,MATH 20C,B01,083762,Staff,28,0,30,2
1649939023926,MATH 20C,B02,083763,Staff,30,0,30,0
1649939029961,MATH 20D,A01,083765,Staff,20,0,30,10
1649939029961,MATH 20D,A02,083766,Staff,30,0,30,0
1649939029961,MATH 20D,A03,083767,Staff,30,0,30,0
1649939035995,MATH 20E,A01,083771,Staff,12,0,30,18
1649939035995,MATH 20E,A02,083772,Staff,24,0,30,6
1649939035995,MATH 20E,B01,083773,Staff,17,0,30,13
1649939035995,MATH 20E,B02,083774,Staff,29,0,30,1
1649939042034,MATH 103A,A01,083777,Staff,1,4,30,29
1649939042034,MATH 103A,A02,083778,Staff,0,3,30,30
1649939042034,MATH 103A,B01,083779,Staff,0,0,30,30
1649939042034,MATH 103A,B02,083780,Staff,16,0,30,14
1649939048058,MATH 105,A01,085443,Staff,0,5,30,30
1649939054090,MATH 109,A01,083213,Anzaldo; Leesa B,13,0,30,17
1649939054090,MATH 109,A02,083214,Anzaldo; Leesa B,9,0,30,21
1649939054090,MATH 109,B01,083215,Anzaldo; Leesa B,26,0,30,4
1649939054090,MATH 109,B02,083216,Anzaldo; Leesa B,22,0,30,8
1649939060120,MATH 142A,A01,083219,Chow; Bennett,0,1,30,30
1649939060120,MATH 142A,A02,083220,Chow; Bennett,9,0,30,21
1649939060120,MATH 142A,B01,083221,Chow; Bennett,0,0,30,30
1649939060120,MATH 142A,B02,083222,Chow; Bennett,1,0,30,29
1649939066145,MATH 193A,A01,083224,Staff,0,3,30,30
1649939066145,MATH 193A,A02,083225,Staff,0,3,30,30
1649939066145,MATH 193A,A03,083781,Staff,4,0,30,26
1649939066145,MATH 193A,A04,083782,Staff,16,0,30,14
1649939072170,MATH 197,001,091859,McAuley; Julian John,9999,0,9999,0
1649939078233,COGS 9,A01,083615,Staff,16,0,60,44
1649939084262,COGS 11,A01,083617,Boyle; Mary E. T.,35,0,40,5
1649939090288,COGS 13,A01,083071,Staff,0,11,40,40
1649939096319,COGS 14A,A01,092681,Staff,65,0,100,35
1649939102346,COGS 14B,A01,083073,Cheng; Tzu-Han,24,0,50,26
1649939108374,COGS 17,A01,092677,Staff,63,0,75,12
1649939114409,COGS 100,A01,083619,Staff,0,5,60,60
1649939120439,COGS 101A,A01,083621,Davis; Joshua Daniel,0,8,60,60
1649939126475,COGS 101B,A01,091572,Staff,31,0,60,29
1649939132500,COGS 101C,A01,083625,Delgado; Tania,24,0,30,6
1649939138526,COGS 107A,A01,083627,Boyle; Mary E. T.,14,0,60,46
1649939144564,COGS 118A,A01,083075,Staff,21,0,60,39
1649939150600,CSE 3,A50,083646,Miranda; Gregory Joseph,24,0,38,14
1649939150600,CSE 3,A51,083647,Miranda; Gregory Joseph,37,0,37,0
1649939156631,CSE 8A,A50,083650,Miranda; Gregory Joseph,8,0,40,32
1649939162665,CSE 11,A01,083080,Cao; Yingjun,0,26,40,40
1649939168695,CSE 12,A01,083652,Staff,56,0,100,44
1649939174732,CSE 15L,A01,083654,Staff,19,0,50,31
1649939174732,CSE 15L,A02,083655,Staff,47,0,50,3
1649939180763,CSE 20,A01,083657,Staff,68,0,80,12
1649939186795,CSE 30,A01,083084,Eldon; John,0,24,40,40
1649939192822,CSE 100,A01,083659,Cao; Yingjun,1,27,50,49
1649939198854,CSE 134B,A01,083661,Powell; Thomas Allan,0,21,65,65
1649939204881,CSE 140,A01,083663,Staff,24,0,75,51
1649939210908,CSE 140L,A01,083088,Eldon; John,18,0,75,57
1649939216941,CSE 175,A01,083665,Kumar; Rakesh,12,0,25,13
1649939222975,CSE 190,A00,092507,Dubnov; Shlomo,14,0,15,1
1649939229001,ECE 45,A01,083139,Staff,6,0,40,34
1649939235036,ECE 65,A50,083695,Staff,7,0,30,23
1649939241077,ECE 109,A01,091882,Touri; Behrouz,55,0,70,15
1649939247108,ECE 180,A00,083140,Abi Samra; Nicholas Camill,26,0,30,4
1649939247108,ECE 180,B00,083141,Abi Samra; Nicholas Camill,13,0,30,17
1649939253137,MATH 10A,A01,083735,Patchell; Gregory David,20,0,30,10
1649939253137,MATH 10A,A02,083736,Patchell; Gregory David,28,0,30,2
1649939253137,MATH 10A,A03,083737,Patchell; Gregory David,28,0,30,2
1649939259246,MATH 10B,A01,083207,Staff,10,0,30,20
1649939259246,MATH 10B,A02,083208,Staff,25,0,30,5
1649939259246,MATH 10B,B01,083739,Staff,25,0,30,5
1649939259246,MATH 10B,B02,083740,Staff,30,0,30,0
1649939265286,MATH 18,A01,083743,Staff,22,0,30,8
1649939265286,MATH 18,A02,083744,Staff,29,0,30,1
1649939265286,MATH 18,A03,083745,Staff,29,0,30,1
1649939265286,MATH 18,A04,083746,Staff,28,0,30,2
1649939265286,MATH 18,B01,083748,Staff,5,0,30,25
1649939265286,MATH 18,B02,083749,Staff,26,0,30,4
1649939265286,MATH 18,B03,083750,Staff,28,0,30,2
1649939265286,MATH 18,B04,083751,Staff,26,0,30,4
1649939271311,MATH 20A,A01,083754,Staff,37,0,40,3
1649939277342,MATH 20B,A01,083756,Staff,19,0,30,11
1649939277342,MATH 20B,A02,083757,Staff,30,0,30,0
1649939283376,MATH 20C,A01,083760,Staff,22,0,30,8
1649939283376,MATH 20C,A02,083761,Staff,23,0,30,7
1649939283376,MATH 20C,B01,083762,Staff,28,0,30,2
1649939283376,MATH 20C,B02,083763,Staff,30,0,30,0
1649939289407,MATH 20D,A01,083765,Staff,20,0,30,10
1649939289407,MATH 20D,A02,083766,Staff,30,0,30,0
1649939289407,MATH 20D,A03,083767,Staff,30,0,30,0
1649939295432,MATH 20E,A01,083771,Staff,12,0,30,18
1649939295432,MATH 20E,A02,083772,Staff,24,0,30,6
1649939295432,MATH 20E,B01,083773,Staff,17,0,30,13
1649939295432,MATH 20E,B02,083774,Staff,29,0,30,1
1649939301460,MATH 103A,A01,083777,Staff,1,4,30,29
1649939301460,MATH 103A,A02,083778,Staff,0,3,30,30
1649939301460,MATH 103A,B01,083779,Staff,0,0,30,30
1649939301460,MATH 103A,B02,083780,Staff,16,0,30,14
1649939307488,MATH 105,A01,085443,Staff,0,5,30,30
1649939313524,MATH 109,A01,083213,Anzaldo; Leesa B,13,0,30,17
1649939313524,MATH 109,A02,083214,Anzaldo; Leesa B,9,0,30,21
1649939313524,MATH 109,B01,083215,Anzaldo; Leesa B,26,0,30,4
1649939313524,MATH 109,B02,083216,Anzaldo; Leesa B,22,0,30,8
1649939319549,MATH 142A,A01,083219,Chow; Bennett,0,1,30,30
1649939319549,MATH 142A,A02,083220,Chow; Bennett,9,0,30,21
1649939319549,MATH 142A,B01,083221,Chow; Bennett,0,0,30,30
1649939319549,MATH 142A,B02,083222,Chow; Bennett,1,0,30,29
1649939325579,MATH 193A,A01,083224,Staff,0,3,30,30
1649939325579,MATH 193A,A02,083225,Staff,0,3,30,30
1649939325579,MATH 193A,A03,083781,Staff,4,0,30,26
1649939325579,MATH 193A,A04,083782,Staff,16,0,30,14
1649939331604,MATH 197,001,091859,McAuley; Julian John,9999,0,9999,0
1649939337682,COGS 9,A01,083615,Staff,16,0,60,44
1649939343717,COGS 11,A01,083617,Boyle; Mary E. T.,35,0,40,5
1649939349763,COGS 13,A01,083071,Staff,0,11,40,40
1649939355796,COGS 14A,A01,092681,Staff,65,0,100,35
1649939361823,COGS 14B,A01,083073,Cheng; Tzu-Han,24,0,50,26
1649939367852,COGS 17,A01,092677,Staff,63,0,75,12
1649939373881,COGS 100,A01,083619,Staff,0,5,60,60
1649939379906,COGS 101A,A01,083621,Davis; Joshua Daniel,0,8,60,60
1649939385933,COGS 101B,A01,091572,Staff,31,0,60,29
1649939391959,COGS 101C,A01,083625,Delgado; Tania,24,0,30,6
1649939397987,COGS 107A,A01,083627,Boyle; Mary E. T.,14,0,60,46
1649939404014,COGS 118A,A01,083075,Staff,21,0,60,39
1649939410042,CSE 3,A50,083646,Miranda; Gregory Joseph,24,0,38,14
1649939410042,CSE 3,A51,083647,Miranda; Gregory Joseph,37,0,37,0
1649939416084,CSE 8A,A50,083650,Miranda; Gregory Joseph,8,0,40,32
1649939422114,CSE 11,A01,083080,Cao; Yingjun,0,26,40,40
1649939428144,CSE 12,A01,083652,Staff,56,0,100,44
1649939434174,CSE 15L,A01,083654,Staff,19,0,50,31
1649939434174,CSE 15L,A02,083655,Staff,47,0,50,3
1649939440199,CSE 20,A01,083657,Staff,68,0,80,12
1649939446224,CSE 30,A01,083084,Eldon; John,0,24,40,40
1649939452247,CSE 100,A01,083659,Cao; Yingjun,1,27,50,49
1649939458272,CSE 134B,A01,083661,Powell; Thomas Allan,0,21,65,65
1649939464301,CSE 140,A01,083663,Staff,24,0,75,51
1649939470325,CSE 140L,A01,083088,Eldon; John,18,0,75,57
1649939476354,CSE 175,A01,083665,Kumar; Rakesh,12,0,25,13
1649939482387,CSE 190,A00,092507,Dubnov; Shlomo,14,0,15,1
1649939488412,ECE 45,A01,083139,Staff,6,0,40,34
1649939494437,ECE 65,A50,083695,Staff,7,0,30,23
1649939500471,ECE 109,A01,091882,Touri; Behrouz,55,0,70,15
1649939506502,ECE 180,A00,083140,Abi Samra; Nicholas Camill,26,0,30,4
1649939506502,ECE 180,B00,083141,Abi Samra; Nicholas Camill,13,0,30,17
1649939512539,MATH 10A,A01,083735,Patchell; Gregory David,20,0,30,10
1649939512539,MATH 10A,A02,083736,Patchell; Gregory David,28,0,30,2
1649939512539,MATH 10A,A03,083737,Patchell; Gregory David,28,0,30,2
1649939518566,MATH 10B,A01,083207,Staff,10,0,30,20
1649939518566,MATH 10B,A02,083208,Staff,25,0,30,5
1649939518566,MATH 10B,B01,083739,Staff,25,0,30,5
1649939518566,MATH 10B,B02,083740,Staff,30,0,30,0
1649939524597,MATH 18,A01,083743,Staff,22,0,30,8
1649939524597,MATH 18,A02,083744,Staff,29,0,30,1
1649939524597,MATH 18,A03,083745,Staff,29,0,30,1
1649939524597,MATH 18,A04,083746,Staff,28,0,30,2
1649939524597,MATH 18,B01,083748,Staff,5,0,30,25
1649939524597,MATH 18,B02,083749,Staff,26,0,30,4
1649939524597,MATH 18,B03,083750,Staff,28,0,30,2
1649939524597,MATH 18,B04,083751,Staff,26,0,30,4
1649939530626,MATH 20A,A01,083754,Staff,37,0,40,3
1649939536654,MATH 20B,A01,083756,Staff,19,0,30,11
1649939536654,MATH 20B,A02,083757,Staff,30,0,30,0
1649939542682,MATH 20C,A01,083760,Staff,22,0,30,8
1649939542682,MATH 20C,A02,083761,Staff,23,0,30,7
1649939542682,MATH 20C,B01,083762,Staff,28,0,30,2
1649939542682,MATH 20C,B02,083763,Staff,30,0,30,0
1649939548715,MATH 20D,A01,083765,Staff,20,0,30,10
1649939548715,MATH 20D,A02,083766,Staff,30,0,30,0
1649939548715,MATH 20D,A03,083767,Staff,30,0,30,0
1649939554745,MATH 20E,A01,083771,Staff,12,0,30,18
1649939554745,MATH 20E,A02,083772,Staff,24,0,30,6
1649939554745,MATH 20E,B01,083773,Staff,17,0,30,13
1649939554745,MATH 20E,B02,083774,Staff,29,0,30,1
1649939560785,MATH 103A,A01,083777,Staff,1,4,30,29
1649939560785,MATH 103A,A02,083778,Staff,0,3,30,30
1649939560785,MATH 103A,B01,083779,Staff,0,0,30,30
1649939560785,MATH 103A,B02,083780,Staff,16,0,30,14
1649939566822,MATH 105,A01,085443,Staff,0,5,30,30
1649939572858,MATH 109,A01,083213,Anzaldo; Leesa B,13,0,30,17
1649939572858,MATH 109,A02,083214,Anzaldo; Leesa B,9,0,30,21
1649939572858,MATH 109,B01,083215,Anzaldo; Leesa B,26,0,30,4
1649939572858,MATH 109,B02,083216,Anzaldo; Leesa B,22,0,30,8
1649939578884,MATH 142A,A01,083219,Chow; Bennett,0,1,30,30
1649939578884,MATH 142A,A02,083220,Chow; Bennett,9,0,30,21
1649939578884,MATH 142A,B01,083221,Chow; Bennett,0,0,30,30
1649939578884,MATH 142A,B02,083222,Chow; Bennett,1,0,30,29
1649939584909,MATH 193A,A01,083224,Staff,0,3,30,30
1649939584909,MATH 193A,A02,083225,Staff,0,3,30,30
1649939584909,MATH 193A,A03,083781,Staff,4,0,30,26
1649939584909,MATH 193A,A04,083782,Staff,16,0,30,14
1649939590940,MATH 197,001,091859,McAuley; Julian John,9999,0,9999,0
1649939597009,COGS 9,A01,083615,Staff,16,0,60,44
1649939603036,COGS 11,A01,083617,Boyle; Mary E. T.,35,0,40,5
1649939609062,COGS 13,A01,083071,Staff,0,11,40,40
1649939615094,COGS 14A,A01,092681,Staff,65,0,100,35
1649939621126,COGS 14B,A01,083073,Cheng; Tzu-Han,24,0,50,26
1649939627151,COGS 17,A01,092677,Staff,63,0,75,12
1649939633178,COGS 100,A01,083619,Staff,0,5,60,60
1649939639217,COGS 101A,A01,083621,Davis; Joshua Daniel,0,8,60,60
1649939645245,COGS 101B,A01,091572,Staff,31,0,60,29
1649939651271,COGS 101C,A01,083625,Delgado; Tania,24,0,30,6
1649939657300,COGS 107A,A01,083627,Boyle; Mary E. T.,14,0,60,46
1649939663344,COGS 118A,A01,083075,Staff,21,0,60,39
1649939669376,CSE 3,A50,083646,Miranda; Gregory Joseph,24,0,38,14
1649939669376,CSE 3,A51,083647,Miranda; Gregory Joseph,37,0,37,0
1649939675400,CSE 8A,A50,083650,Miranda; Gregory Joseph,8,0,40,32
1649939681429,CSE 11,A01,083080,Cao; Yingjun,0,26,40,40
1649939687457,CSE 12,A01,083652,Staff,56,0,100,44
1649939693485,CSE 15L,A01,083654,Staff,19,0,50,31
1649939693485,CSE 15L,A02,083655,Staff,47,0,50,3
1649939699521,CSE 20,A01,083657,Staff,68,0,80,12
1649939705559,CSE 30,A01,083084,Eldon; John,0,24,40,40
1649939711584,CSE 100,A01,083659,Cao; Yingjun,1,27,50,49
1649939717610,CSE 134B,A01,083661,Powell; Thomas Allan,0,21,65,65
1649939723638,CSE 140,A01,083663,Staff,24,0,75,51
1649939729666,CSE 140L,A01,083088,Eldon; John,18,0,75,57
1649939735696,CSE 175,A01,083665,Kumar; Rakesh,12,0,25,13
1649939741742,CSE 190,A00,092507,Dubnov; Shlomo,14,0,15,1
1649939747767,ECE 45,A01,083139,Staff,6,0,40,34
1649939753797,ECE 65,A50,083695,Staff,7,0,30,23
1649939759828,ECE 109,A01,091882,Touri; Behrouz,55,0,70,15
1649939765864,ECE 180,A00,083140,Abi Samra; Nicholas Camill,26,0,30,4
1649939765864,ECE 180,B00,083141,Abi Samra; Nicholas Camill,13,0,30,17
1649939771890,MATH 10A,A01,083735,Patchell; Gregory David,20,0,30,10
1649939771890,MATH 10A,A02,083736,Patchell; Gregory David,28,0,30,2
1649939771890,MATH 10A,A03,083737,Patchell; Gregory David,28,0,30,2
1649939777922,MATH 10B,A01,083207,Staff,10,0,30,20
1649939777922,MATH 10B,A02,083208,Staff,25,0,30,5
1649939777922,MATH 10B,B01,083739,Staff,25,0,30,5
1649939777922,MATH 10B,B02,083740,Staff,30,0,30,0
1649939783949,MATH 18,A01,083743,Staff,22,0,30,8
1649939783949,MATH 18,A02,083744,Staff,29,0,30,1
1649939783949,MATH 18,A03,083745,Staff,29,0,30,1
1649939783949,MATH 18,A04,083746,Staff,28,0,30,2
1649939783949,MATH 18,B01,083748,Staff,5,0,30,25
1649939783949,MATH 18,B02,083749,Staff,26,0,30,4
1649939783949,MATH 18,B03,083750,Staff,28,0,30,2
1649939783949,MATH 18,B04,083751,Staff,26,0,30,4
1649939789973,MATH 20A,A01,083754,Staff,37,0,40,3
1649939795998,MATH 20B,A01,083756,Staff,19,0,30,11
1649939795998,MATH 20B,A02,083757,Staff,30,0,30,0
1649939802024,MATH 20C,A01,083760,Staff,22,0,30,8
1649939802024,MATH 20C,A02,083761,Staff,23,0,30,7
1649939802024,MATH 20C,B01,083762,Staff,28,0,30,2
1649939802024,MATH 20C,B02,083763,Staff,30,0,30,0
1649939808056,MATH 20D,A01,083765,Staff,20,0,30,10
1649939808056,MATH 20D,A02,083766,Staff,30,0,30,0
1649939808056,MATH 20D,A03,083767,Staff,30,0,30,0
1649939814081,MATH 20E,A01,083771,Staff,12,0,30,18
1649939814081,MATH 20E,A02,083772,Staff,24,0,30,6
1649939814081,MATH 20E,B01,083773,Staff,17,0,30,13
1649939814081,MATH 20E,B02,083774,Staff,29,0,30,1
1649939820105,MATH 103A,A01,083777,Staff,1,4,30,29
1649939820105,MATH 103A,A02,083778,Staff,0,3,30,30
1649939820105,MATH 103A,B01,083779,Staff,0,0,30,30
1649939820105,MATH 103A,B02,083780,Staff,16,0,30,14
1649939826140,MATH 105,A01,085443,Staff,0,5,30,30
1649939832170,MATH 109,A01,083213,Anzaldo; Leesa B,13,0,30,17
1649939832170,MATH 109,A02,083214,Anzaldo; Leesa B,9,0,30,21
1649939832170,MATH 109,B01,083215,Anzaldo; Leesa B,26,0,30,4
1649939832170,MATH 109,B02,083216,Anzaldo; Leesa B,22,0,30,8
1649939838203,MATH 142A,A01,083219,Chow; Bennett,0,1,30,30
1649939838203,MATH 142A,A02,083220,Chow; Bennett,9,0,30,21
1649939838203,MATH 142A,B01,083221,Chow; Bennett,0,0,30,30
1649939838203,MATH 142A,B02,083222,Chow; Bennett,1,0,30,29
1649939844235,MATH 193A,A01,083224,Staff,0,3,30,30
1649939844235,MATH 193A,A02,083225,Staff,0,3,30,30
1649939844235,MATH 193A,A03,083781,Staff,4,0,30,26
1649939844235,MATH 193A,A04,083782,Staff,16,0,30,14
1649939850271,MATH 197,001,091859,McAuley; Julian John,9999,0,9999,0
1649939856439,COGS 9,A01,083615,Staff,16,0,60,44
1649939862467,COGS 11,A01,083617,Boyle; Mary E. T.,35,0,40,5
1649939868518,COGS 13,A01,083071,Staff,0,11,40,40
1649939874545,COGS 14A,A01,092681,Staff,65,0,100,35
1649939880576,COGS 14B,A01,083073,Cheng; Tzu-Han,24,0,50,26
1649939886602,COGS 17,A01,092677,Staff,63,0,75,12
1649939892630,COGS 100,A01,083619,Staff,0,5,60,60
1649939898662,COGS 101A,A01,083621,Davis; Joshua Daniel,0,8,60,60
1649939904686,COGS 101B,A01,091572,Staff,31,0,60,29
1649939910711,COGS 101C,A01,083625,Delgado; Tania,24,0,30,6
1649939916737,COGS 107A,A01,083627,Boyle; Mary E. T.,14,0,60,46
1649939922768,COGS 118A,A01,083075,Staff,21,0,60,39
1649939928792,CSE 3,A50,083646,Miranda; Gregory Joseph,24,0,38,14
1649939928792,CSE 3,A51,083647,Miranda; Gregory Joseph,37,0,37,0
1649939934817,CSE 8A,A50,083650,Miranda; Gregory Joseph,8,0,40,32
1649939940847,CSE 11,A01,083080,Cao; Yingjun,0,26,40,40
1649939946879,CSE 12,A01,083652,Staff,56,0,100,44
1649939952902,CSE 15L,A01,083654,Staff,19,0,50,31
1649939952902,CSE 15L,A02,083655,Staff,47,0,50,3
1649939958932,CSE 20,A01,083657,Staff,68,0,80,12
1649939964958,CSE 30,A01,083084,Eldon; John,0,24,40,40
1649939970983,CSE 100,A01,083659,Cao; Yingjun,1,27,50,49
1649939977012,CSE 134B,A01,083661,Powell; Thomas Allan,0,21,65,65
1649939983040,CSE 140,A01,083663,Staff,24,0,75,51
1649939989071,CSE 140L,A01,083088,Eldon; John,18,0,75,57
1649939995095,CSE 175,A01,083665,Kumar; Rakesh,12,0,25,13
1649940001123,CSE 190,A00,092507,Dubnov; Shlomo,14,0,15,1
1649940007149,ECE 45,A01,083139,Staff,6,0,40,34
1649940013174,ECE 65,A50,083695,Staff,7,0,30,23
1649940019204,ECE 109,A01,091882,Touri; Behrouz,55,0,70,15
1649940025229,ECE 180,A00,083140,Abi Samra; Nicholas Camill,26,0,30,4
1649940025229,ECE 180,B00,083141,Abi Samra; Nicholas Camill,13,0,30,17
1649940031256,MATH 10A,A01,083735,Patchell; Gregory David,20,0,30,10
1649940031256,MATH 10A,A02,083736,Patchell; Gregory David,28,0,30,2
1649940031256,MATH 10A,A03,083737,Patchell; Gregory David,28,0,30,2
1649940037281,MATH 10B,A01,083207,Staff,10,0,30,20
1649940037281,MATH 10B,A02,083208,Staff,25,0,30,5
1649940037281,MATH 10B,B01,083739,Staff,25,0,30,5
1649940037281,MATH 10B,B02,083740,Staff,30,0,30,0
1649940043316,MATH 18,A01,083743,Staff,22,0,30,8
1649940043316,MATH 18,A02,083744,Staff,29,0,30,1
1649940043316,MATH 18,A03,083745,Staff,29,0,30,1
1649940043316,MATH 18,A04,083746,Staff,28,0,30,2
1649940043316,MATH 18,B01,083748,Staff,5,0,30,25
1649940043316,MATH 18,B02,083749,Staff,26,0,30,4
1649940043316,MATH 18,B03,083750,Staff,28,0,30,2
1649940043316,MATH 18,B04,083751,Staff,26,0,30,4
1649940049342,MATH 20A,A01,083754,Staff,37,0,40,3
1649940055371,MATH 20B,A01,083756,Staff,19,0,30,11
1649940055371,MATH 20B,A02,083757,Staff,30,0,30,0
1649940061400,MATH 20C,A01,083760,Staff,22,0,30,8
1649940061400,MATH 20C,A02,083761,Staff,23,0,30,7
1649940061400,MATH 20C,B01,083762,Staff,28,0,30,2
1649940061400,MATH 20C,B02,083763,Staff,30,0,30,0
1649940067425,MATH 20D,A01,083765,Staff,20,0,30,10
1649940067425,MATH 20D,A02,083766,Staff,30,0,30,0
1649940067425,MATH 20D,A03,083767,Staff,30,0,30,0
1649940073450,MATH 20E,A01,083771,Staff,12,0,30,18
1649940073450,MATH 20E,A02,083772,Staff,24,0,30,6
1649940073450,MATH 20E,B01,083773,Staff,17,0,30,13
1649940073450,MATH 20E,B02,083774,Staff,29,0,30,1
1649940079481,MATH 103A,A01,083777,Staff,1,4,30,29
1649940079481,MATH 103A,A02,083778,Staff,0,3,30,30
1649940079481,MATH 103A,B01,083779,Staff,0,0,30,30
1649940079481,MATH 103A,B02,083780,Staff,16,0,30,14
1649940085509,MATH 105,A01,085443,Staff,0,5,30,30
1649940091535,MATH 109,A01,083213,Anzaldo; Leesa B,13,0,30,17
1649940091535,MATH 109,A02,083214,Anzaldo; Leesa B,9,0,30,21
1649940091535,MATH 109,B01,083215,Anzaldo; Leesa B,26,0,30,4
1649940091535,MATH 109,B02,083216,Anzaldo; Leesa B,22,0,30,8
1649940097559,MATH 142A,A01,083219,Chow; Bennett,0,1,30,30
1649940097559,MATH 142A,A02,083220,Chow; Bennett,9,0,30,21
1649940097559,MATH 142A,B01,083221,Chow; Bennett,0,0,30,30
1649940097559,MATH 142A,B02,083222,Chow; Bennett,1,0,30,29
1649940103584,MATH 193A,A01,083224,Staff,0,3,30,30
1649940103584,MATH 193A,A02,083225,Staff,0,3,30,30
1649940103584,MATH 193A,A03,083781,Staff,4,0,30,26
1649940103584,MATH 193A,A04,083782,Staff,16,0,30,14
1649940109612,MATH 197,001,091859,McAuley; Julian John,9999,0,9999,0
1649940115681,COGS 9,A01,083615,Staff,16,0,60,44
1649940121707,COGS 11,A01,083617,Boyle; Mary E. T.,35,0,40,5
1649940127733,COGS 13,A01,083071,Staff,0,11,40,40
1649940133755,COGS 14A,A01,092681,Staff,65,0,100,35
1649940139785,COGS 14B,A01,083073,Cheng; Tzu-Han,24,0,50,26
1649940145809,COGS 17,A01,092677,Staff,63,0,75,12
1649940151833,COGS 100,A01,083619,Staff,0,5,60,60
1649940157858,COGS 101A,A01,083621,Davis; Joshua Daniel,0,8,60,60
1649940163887,COGS 101B,A01,091572,Staff,31,0,60,29
1649940169912,COGS 101C,A01,083625,Delgado; Tania,24,0,30,6
1649940175935,COGS 107A,A01,083627,Boyle; Mary E. T.,14,0,60,46
1649940181963,COGS 118A,A01,083075,Staff,21,0,60,39
1649940187986,CSE 3,A50,083646,Miranda; Gregory Joseph,24,0,38,14
1649940187986,CSE 3,A51,083647,Miranda; Gregory Joseph,37,0,37,0
1649940194008,CSE 8A,A50,083650,Miranda; Gregory Joseph,8,0,40,32
1649940200033,CSE 11,A01,083080,Cao; Yingjun,0,26,40,40
1649940206060,CSE 12,A01,083652,Staff,56,0,100,44
1649940212089,CSE 15L,A01,083654,Staff,19,0,50,31
1649940212089,CSE 15L,A02,083655,Staff,47,0,50,3
1649940218117,CSE 20,A01,083657,Staff,68,0,80,12
1649940224142,CSE 30,A01,083084,Eldon; John,0,24,40,40
1649940230165,CSE 100,A01,083659,Cao; Yingjun,1,27,50,49
1649940236194,CSE 134B,A01,083661,Powell; Thomas Allan,0,21,65,65
1649940242219,CSE 140,A01,083663,Staff,24,0,75,51
1649940248247,CSE 140L,A01,083088,Eldon; John,18,0,75,57
1649940254281,CSE 175,A01,083665,Kumar; Rakesh,12,0,25,13
1649940260307,CSE 190,A00,092507,Dubnov; Shlomo,14,0,15,1
1649940266336,ECE 45,A01,083139,Staff,6,0,40,34
1649940272361,ECE 65,A50,083695,Staff,7,0,30,23
1649940278394,ECE 109,A01,091882,Touri; Behrouz,55,0,70,15
1649940284419,ECE 180,A00,083140,Abi Samra; Nicholas Camill,26,0,30,4
1649940284419,ECE 180,B00,083141,Abi Samra; Nicholas Camill,13,0,30,17
1649940290458,MATH 10A,A01,083735,Patchell; Gregory David,20,0,30,10
1649940290458,MATH 10A,A02,083736,Patchell; Gregory David,28,0,30,2
1649940290458,MATH 10A,A03,083737,Patchell; Gregory David,28,0,30,2
1649940296486,MATH 10B,A01,083207,Staff,10,0,30,20
1649940296486,MATH 10B,A02,083208,Staff,25,0,30,5
1649940296486,MATH 10B,B01,083739,Staff,25,0,30,5
1649940296486,MATH 10B,B02,083740,Staff,30,0,30,0
1649940302511,MATH 18,A01,083743,Staff,22,0,30,8
1649940302511,MATH 18,A02,083744,Staff,29,0,30,1
1649940302511,MATH 18,A03,083745,Staff,29,0,30,1
1649940302511,MATH 18,A04,083746,Staff,28,0,30,2
1649940302511,MATH 18,B01,083748,Staff,5,0,30,25
1649940302511,MATH 18,B02,083749,Staff,26,0,30,4
1649940302511,MATH 18,B03,083750,Staff,28,0,30,2
1649940302511,MATH 18,B04,083751,Staff,26,0,30,4
1649940308540,MATH 20A,A01,083754,Staff,37,0,40,3
1649940314566,MATH 20B,A01,083756,Staff,19,0,30,11
1649940314566,MATH 20B,A02,083757,Staff,30,0,30,0
1649940320603,MATH 20C,A01,083760,Staff,22,0,30,8
1649940320603,MATH 20C,A02,083761,Staff,23,0,30,7
1649940320603,MATH 20C,B01,083762,Staff,28,0,30,2
1649940320603,MATH 20C,B02,083763,Staff,30,0,30,0
1649940326630,MATH 20D,A01,083765,Staff,20,0,30,10
1649940326630,MATH 20D,A02,083766,Staff,30,0,30,0
1649940326630,MATH 20D,A03,083767,Staff,30,0,30,0
1649940332660,MATH 20E,A01,083771,Staff,12,0,30,18
1649940332660,MATH 20E,A02,083772,Staff,24,0,30,6
1649940332660,MATH 20E,B01,083773,Staff,17,0,30,13
1649940332660,MATH 20E,B02,083774,Staff,29,0,30,1
1649940338689,MATH 103A,A01,083777,Staff,1,4,30,29
1649940338689,MATH 103A,A02,083778,Staff,0,3,30,30
1649940338689,MATH 103A,B01,083779,Staff,0,0,30,30
1649940338689,MATH 103A,B02,083780,Staff,16,0,30,14
1649940344714,MATH 105,A01,085443,Staff,0,5,30,30
1649940350741,MATH 109,A01,083213,Anzaldo; Leesa B,13,0,30,17
1649940350741,MATH 109,A02,083214,Anzaldo; Leesa B,9,0,30,21
1649940350741,MATH 109,B01,083215,Anzaldo; Leesa B,26,0,30,4
1649940350741,MATH 109,B02,083216,Anzaldo; Leesa B,22,0,30,8
1649940356772,MATH 142A,A01,083219,Chow; Bennett,0,1,30,30
1649940356772,MATH 142A,A02,083220,Chow; Bennett,9,0,30,21
1649940356772,MATH 142A,B01,083221,Chow; Bennett,0,0,30,30
1649940356772,MATH 142A,B02,083222,Chow; Bennett,1,0,30,29
1649940362797,MATH 193A,A01,083224,Staff,0,3,30,30
1649940362797,MATH 193A,A02,083225,Staff,0,3,30,30
1649940362797,MATH 193A,A03,083781,Staff,4,0,30,26
1649940362797,MATH 193A,A04,083782,Staff,16,0,30,14
1649940368826,MATH 197,001,091859,McAuley; Julian John,9999,0,9999,0
1649940374887,COGS 9,A01,083615,Staff,16,0,60,44
1649940380920,COGS 11,A01,083617,Boyle; Mary E. T.,35,0,40,5
1649940386945,COGS 13,A01,083071,Staff,0,11,40,40
1649940392978,COGS 14A,A01,092681,Staff,65,0,100,35
1649940399004,COGS 14B,A01,083073,Cheng; Tzu-Han,24,0,50,26
1649940405029,COGS 17,A01,092677,Staff,63,0,75,12
1649940411064,COGS 100,A01,083619,Staff,0,5,60,60
1649940417093,COGS 101A,A01,083621,Davis; Joshua Daniel,0,8,60,60
1649940423117,COGS 101B,A01,091572,Staff,31,0,60,29
1649940429156,COGS 101C,A01,083625,Delgado; Tania,24,0,30,6
1649940435187,COGS 107A,A01,083627,Boyle; Mary E. T.,14,0,60,46
1649940441213,COGS 118A,A01,083075,Staff,21,0,60,39
1649940447335,CSE 3,A50,083646,Miranda; Gregory Joseph,24,0,38,14
1649940447335,CSE 3,A51,083647,Miranda; Gregory Joseph,37,0,37,0
1649940453368,CSE 8A,A50,083650,Miranda; Gregory Joseph,8,0,40,32
1649940459401,CSE 11,A01,083080,Cao; Yingjun,0,26,40,40
1649940465433,CSE 12,A01,083652,Staff,56,0,100,44
1649940471461,CSE 15L,A01,083654,Staff,19,0,50,31
1649940471461,CSE 15L,A02,083655,Staff,47,0,50,3
1649940477487,CSE 20,A01,083657,Staff,68,0,80,12
1649940483518,CSE 30,A01,083084,Eldon; John,0,24,40,40
1649940489549,CSE 100,A01,083659,Cao; Yingjun,1,27,50,49
1649940495581,CSE 134B,A01,083661,Powell; Thomas Allan,0,21,65,65
1649940501616,CSE 140,A01,083663,Staff,24,0,75,51
1649940507646,CSE 140L,A01,083088,Eldon; John,18,0,75,57
1649940513673,CSE 175,A01,083665,Kumar; Rakesh,12,0,25,13
1649940519705,CSE 190,A00,092507,Dubnov; Shlomo,14,0,15,1
1649940525731,ECE 45,A01,083139,Staff,6,0,40,34
1649940531763,ECE 65,A50,083695,Staff,7,0,30,23
1649940537791,ECE 109,A01,091882,Touri; Behrouz,55,0,70,15
1649940543819,ECE 180,A00,083140,Abi Samra; Nicholas Camill,26,0,30,4
1649940543819,ECE 180,B00,083141,Abi Samra; Nicholas Camill,13,0,30,17
1649940549880,MATH 10A,A01,083735,Patchell; Gregory David,20,0,30,10
1649940549880,MATH 10A,A02,083736,Patchell; Gregory David,28,0,30,2
1649940549880,MATH 10A,A03,083737,Patchell; Gregory David,28,0,30,2
1649940555915,MATH 10B,A01,083207,Staff,10,0,30,20
1649940555915,MATH 10B,A02,083208,Staff,25,0,30,5
1649940555915,MATH 10B,B01,083739,Staff,25,0,30,5
1649940555915,MATH 10B,B02,083740,Staff,30,0,30,0
1649940561944,MATH 18,A01,083743,Staff,22,0,30,8
1649940561944,MATH 18,A02,083744,Staff,29,0,30,1
1649940561944,MATH 18,A03,083745,Staff,29,0,30,1
1649940561944,MATH 18,A04,083746,Staff,28,0,30,2
1649940561944,MATH 18,B01,083748,Staff,5,0,30,25
1649940561944,MATH 18,B02,083749,Staff,26,0,30,4
1649940561944,MATH 18,B03,083750,Staff,28,0,30,2
1649940561944,MATH 18,B04,083751,Staff,26,0,30,4
1649940567973,MATH 20A,A01,083754,Staff,37,0,40,3
1649940574004,MATH 20B,A01,083756,Staff,19,0,30,11
1649940574004,MATH 20B,A02,083757,Staff,30,0,30,0
1649940580031,MATH 20C,A01,083760,Staff,22,0,30,8
1649940580031,MATH 20C,A02,083761,Staff,23,0,30,7
1649940580031,MATH 20C,B01,083762,Staff,28,0,30,2
1649940580031,MATH 20C,B02,083763,Staff,30,0,30,0
1649940586057,MATH 20D,A01,083765,Staff,20,0,30,10
1649940586057,MATH 20D,A02,083766,Staff,30,0,30,0
1649940586057,MATH 20D,A03,083767,Staff,30,0,30,0
1649940592084,MATH 20E,A01,083771,Staff,12,0,30,18
1649940592084,MATH 20E,A02,083772,Staff,24,0,30,6
1649940592084,MATH 20E,B01,083773,Staff,17,0,30,13
1649940592084,MATH 20E,B02,083774,Staff,29,0,30,1
1649940598112,MATH 103A,A01,083777,Staff,1,4,30,29
1649940598112,MATH 103A,A02,083778,Staff,0,3,30,30
1649940598112,MATH 103A,B01,083779,Staff,0,0,30,30
1649940598112,MATH 103A,B02,083780,Staff,16,0,30,14
1649940604140,MATH 105,A01,085443,Staff,0,5,30,30
1649940610167,MATH 109,A01,083213,Anzaldo; Leesa B,13,0,30,17
1649940610167,MATH 109,A02,083214,Anzaldo; Leesa B,9,0,30,21
1649940610167,MATH 109,B01,083215,Anzaldo; Leesa B,26,0,30,4
1649940610167,MATH 109,B02,083216,Anzaldo; Leesa B,22,0,30,8
1649940616200,MATH 142A,A01,083219,Chow; Bennett,0,1,30,30
1649940616200,MATH 142A,A02,083220,Chow; Bennett,9,0,30,21
1649940616200,MATH 142A,B01,083221,Chow; Bennett,0,0,30,30
1649940616200,MATH 142A,B02,083222,Chow; Bennett,1,0,30,29
1649940622227,MATH 193A,A01,083224,Staff,0,3,30,30
1649940622227,MATH 193A,A02,083225,Staff,0,3,30,30
1649940622227,MATH 193A,A03,083781,Staff,4,0,30,26
1649940622227,MATH 193A,A04,083782,Staff,16,0,30,14
1649940628251,MATH 197,001,091859,McAuley; Julian John,9999,0,9999,0
1649940634323,COGS 9,A01,083615,Staff,16,0,60,44
1649940640352,COGS 11,A01,083617,Boyle; Mary E. T.,35,0,40,5
1649940646383,COGS 13,A01,083071,Staff,0,11,40,40
1649940652408,COGS 14A,A01,092681,Staff,65,0,100,35
1649940658438,COGS 14B,A01,083073,Cheng; Tzu-Han,24,0,50,26
1649940664467,COGS 17,A01,092677,Staff,63,0,75,12
1649940670493,COGS 100,A01,083619,Staff,0,5,60,60
1649940676530,COGS 101A,A01,083621,Davis; Joshua Daniel,0,8,60,60
1649940682557,COGS 101B,A01,091572,Staff,31,0,60,29
1649940688603,COGS 101C,A01,083625,Delgado; Tania,24,0,30,6
1649940694627,COGS 107A,A01,083627,Boyle; Mary E. T.,14,0,60,46
1649940700659,COGS 118A,A01,083075,Staff,21,0,60,39
1649940706687,CSE 3,A50,083646,Miranda; Gregory Joseph,24,0,38,14
1649940706687,CSE 3,A51,083647,Miranda; Gregory Joseph,37,0,37,0
1649940712712,CSE 8A,A50,083650,Miranda; Gregory Joseph,8,0,40,32
1649940718739,CSE 11,A01,083080,Cao; Yingjun,0,26,40,40
1649940724769,CSE 12,A01,083652,Staff,56,0,100,44
1649940730798,CSE 15L,A01,083654,Staff,19,0,50,31
1649940730798,CSE 15L,A02,083655,Staff,47,0,50,3
1649940736824,CSE 20,A01,083657,Staff,68,0,80,12
1649940742855,CSE 30,A01,083084,Eldon; John,0,24,40,40
1649940748888,CSE 100,A01,083659,Cao; Yingjun,1,27,50,49
1649940754920,CSE 134B,A01,083661,Powell; Thomas Allan,0,21,65,65
1649940760947,CSE 140,A01,083663,Staff,24,0,75,51
1649940766977,CSE 140L,A01,083088,Eldon; John,18,0,75,57
1649940773002,CSE 175,A01,083665,Kumar; Rakesh,12,0,25,13
1649940779029,CSE 190,A00,092507,Dubnov; Shlomo,14,0,15,1
1649940785057,ECE 45,A01,083139,Staff,6,0,40,34
1649940791083,ECE 65,A50,083695,Staff,7,0,30,23
1649940797108,ECE 109,A01,091882,Touri; Behrouz,55,0,70,15
1649940803143,ECE 180,A00,083140,Abi Samra; Nicholas Camill,26,0,30,4
1649940803143,ECE 180,B00,083141,Abi Samra; Nicholas Camill,13,0,30,17
1649940809172,MATH 10A,A01,083735,Patchell; Gregory David,20,0,30,10
1649940809172,MATH 10A,A02,083736,Patchell; Gregory David,28,0,30,2
1649940809172,MATH 10A,A03,083737,Patchell; Gregory David,28,0,30,2
1649940815198,MATH 10B,A01,083207,Staff,10,0,30,20
1649940815198,MATH 10B,A02,083208,Staff,25,0,30,5
1649940815198,MATH 10B,B01,083739,Staff,25,0,30,5
1649940815198,MATH 10B,B02,083740,Staff,30,0,30,0
1649940821234,MATH 18,A01,083743,Staff,22,0,30,8
1649940821234,MATH 18,A02,083744,Staff,29,0,30,1
1649940821234,MATH 18,A03,083745,Staff,29,0,30,1
1649940821234,MATH 18,A04,083746,Staff,28,0,30,2
1649940821234,MATH 18,B01,083748,Staff,5,0,30,25
1649940821234,MATH 18,B02,083749,Staff,26,0,30,4
1649940821234,MATH 18,B03,083750,Staff,28,0,30,2
1649940821234,MATH 18,B04,083751,Staff,26,0,30,4
1649940827261,MATH 20A,A01,083754,Staff,37,0,40,3
1649940833288,MATH 20B,A01,083756,Staff,19,0,30,11
1649940833288,MATH 20B,A02,083757,Staff,30,0,30,0
1649940839316,MATH 20C,A01,083760,Staff,22,0,30,8
1649940839316,MATH 20C,A02,083761,Staff,23,0,30,7
1649940839316,MATH 20C,B01,083762,Staff,28,0,30,2
1649940839316,MATH 20C,B02,083763,Staff,30,0,30,0
1649940845340,MATH 20D,A01,083765,Staff,20,0,30,10
1649940845340,MATH 20D,A02,083766,Staff,30,0,30,0
1649940845340,MATH 20D,A03,083767,Staff,30,0,30,0
1649940851367,MATH 20E,A01,083771,Staff,12,0,30,18
1649940851367,MATH 20E,A02,083772,Staff,24,0,30,6
1649940851367,MATH 20E,B01,083773,Staff,17,0,30,13
1649940851367,MATH 20E,B02,083774,Staff,29,0,30,1
1649940857400,MATH 103A,A01,083777,Staff,1,4,30,29
1649940857400,MATH 103A,A02,083778,Staff,0,3,30,30
1649940857400,MATH 103A,B01,083779,Staff,0,0,30,30
1649940857400,MATH 103A,B02,083780,Staff,16,0,30,14
1649940863427,MATH 105,A01,085443,Staff,0,5,30,30
1649940869454,MATH 109,A01,083213,Anzaldo; Leesa B,13,0,30,17
1649940869454,MATH 109,A02,083214,Anzaldo; Leesa B,9,0,30,21
1649940869454,MATH 109,B01,083215,Anzaldo; Leesa B,26,0,30,4
1649940869454,MATH 109,B02,083216,Anzaldo; Leesa B,22,0,30,8
1649940875486,MATH 142A,A01,083219,Chow; Bennett,0,1,30,30
1649940875486,MATH 142A,A02,083220,Chow; Bennett,9,0,30,21
1649940875486,MATH 142A,B01,083221,Chow; Bennett,0,0,30,30
1649940875486,MATH 142A,B02,083222,Chow; Bennett,1,0,30,29
1649940881519,MATH 193A,A01,083224,Staff,0,3,30,30
1649940881519,MATH 193A,A02,083225,Staff,0,3,30,30
1649940881519,MATH 193A,A03,083781,Staff,4,0,30,26
1649940881519,MATH 193A,A04,083782,Staff,16,0,30,14
1649940887543,MATH 197,001,091859,McAuley; Julian John,9999,0,9999,0
1649940893609,COGS 9,A01,083615,Staff,16,0,60,44
1649940899635,COGS 11,A01,083617,Boyle; Mary E. T.,35,0,40,5
1649940905666,COGS 13,A01,083071,Staff,0,11,40,40
1649940911696,COGS 14A,A01,092681,Staff,65,0,100,35
1649940917722,COGS 14B,A01,083073,Cheng; Tzu-Han,24,0,50,26
1649940923747,COGS 17,A01,092677,Staff,63,0,75,12
1649940929773,COGS 100,A01,083619,Staff,0,5,60,60
1649940935819,COGS 101A,A01,083621,Davis; Joshua Daniel,0,8,60,60
1649940941843,COGS 101B,A01,091572,Staff,31,0,60,29
1649940947870,COGS 101C,A01,083625,Delgado; Tania,24,0,30,6
1649940953905,COGS 107A,A01,083627,Boyle; Mary E. T.,14,0,60,46
1649940959932,COGS 118A,A01,083075,Staff,21,0,60,39
1649940965969,CSE 3,A50,083646,Miranda; Gregory Joseph,24,0,38,14
1649940965969,CSE 3,A51,083647,Miranda; Gregory Joseph,37,0,37,0
1649940971994,CSE 8A,A50,083650,Miranda; Gregory Joseph,8,0,40,32
1649940978020,CSE 11,A01,083080,Cao; Yingjun,0,26,40,40
1649940984045,CSE 12,A01,083652,Staff,56,0,100,44
1649940990070,CSE 15L,A01,083654,Staff,19,0,50,31
1649940990070,CSE 15L,A02,083655,Staff,47,0,50,3
1649940996095,CSE 20,A01,083657,Staff,68,0,80,12
1649941002121,CSE 30,A01,083084,Eldon; John,0,24,40,40
1649941008146,CSE 100,A01,083659,Cao; Yingjun,1,27,50,49
1649941014172,CSE 134B,A01,083661,Powell; Thomas Allan,0,21,65,65
1649941020205,CSE 140,A01,083663,Staff,24,0,75,51
1649941026241,CSE 140L,A01,083088,Eldon; John,18,0,75,57
1649941032267,CSE 175,A01,083665,Kumar; Rakesh,12,0,25,13
1649941038305,CSE 190,A00,092507,Dubnov; Shlomo,14,0,15,1
1649941044402,ECE 45,A01,083139,Staff,6,0,40,34
1649941050437,ECE 65,A50,083695,Staff,7,0,30,23
1649941056466,ECE 109,A01,091882,Touri; Behrouz,55,0,70,15
1649941062490,ECE 180,A00,083140,Abi Samra; Nicholas Camill,26,0,30,4
1649941062490,ECE 180,B00,083141,Abi Samra; Nicholas Camill,13,0,30,17
1649941068526,MATH 10A,A01,083735,Patchell; Gregory David,20,0,30,10
1649941068526,MATH 10A,A02,083736,Patchell; Gregory David,28,0,30,2
1649941068526,MATH 10A,A03,083737,Patchell; Gregory David,28,0,30,2
1649941074551,MATH 10B,A01,083207,Staff,10,0,30,20
1649941074551,MATH 10B,A02,083208,Staff,25,0,30,5
1649941074551,MATH 10B,B01,083739,Staff,25,0,30,5
1649941074551,MATH 10B,B02,083740,Staff,30,0,30,0
1649941080579,MATH 18,A01,083743,Staff,22,0,30,8
1649941080579,MATH 18,A02,083744,Staff,29,0,30,1
1649941080579,MATH 18,A03,083745,Staff,29,0,30,1
1649941080579,MATH 18,A04,083746,Staff,28,0,30,2
1649941080579,MATH 18,B01,083748,Staff,5,0,30,25
1649941080579,MATH 18,B02,083749,Staff,26,0,30,4
1649941080579,MATH 18,B03,083750,Staff,28,0,30,2
1649941080579,MATH 18,B04,083751,Staff,26,0,30,4
1649941086607,MATH 20A,A01,083754,Staff,37,0,40,3
1649941092639,MATH 20B,A01,083756,Staff,19,0,30,11
1649941092639,MATH 20B,A02,083757,Staff,30,0,30,0
1649941098668,MATH 20C,A01,083760,Staff,22,0,30,8
1649941098668,MATH 20C,A02,083761,Staff,23,0,30,7
1649941098668,MATH 20C,B01,083762,Staff,28,0,30,2
1649941098668,MATH 20C,B02,083763,Staff,30,0,30,0
1649941104694,MATH 20D,A01,083765,Staff,20,0,30,10
1649941104694,MATH 20D,A02,083766,Staff,30,0,30,0
1649941104694,MATH 20D,A03,083767,Staff,30,0,30,0
1649941110720,MATH 20E,A01,083771,Staff,12,0,30,18
1649941110720,MATH 20E,A02,083772,Staff,24,0,30,6
1649941110720,MATH 20E,B01,083773,Staff,17,0,30,13
1649941110720,MATH 20E,B02,083774,Staff,29,0,30,1
1649941116752,MATH 103A,A01,083777,Staff,1,4,30,29
1649941116752,MATH 103A,A02,083778,Staff,0,3,30,30
1649941116752,MATH 103A,B01,083779,Staff,0,0,30,30
1649941116752,MATH 103A,B02,083780,Staff,16,0,30,14
1649941122776,MATH 105,A01,085443,Staff,0,5,30,30
1649941128808,MATH 109,A01,083213,Anzaldo; Leesa B,13,0,30,17
1649941128808,MATH 109,A02,083214,Anzaldo; Leesa B,9,0,30,21
1649941128808,MATH 109,B01,083215,Anzaldo; Leesa B,26,0,30,4
1649941128808,MATH 109,B02,083216,Anzaldo; Leesa B,22,0,30,8
1649941134835,MATH 142A,A01,083219,Chow; Bennett,0,1,30,30
1649941134835,MATH 142A,A02,083220,Chow; Bennett,9,0,30,21
1649941134835,MATH 142A,B01,083221,Chow; Bennett,0,0,30,30
1649941134835,MATH 142A,B02,083222,Chow; Bennett,1,0,30,29
1649941140867,MATH 193A,A01,083224,Staff,0,3,30,30
1649941140867,MATH 193A,A02,083225,Staff,0,3,30,30
1649941140867,MATH 193A,A03,083781,Staff,4,0,30,26
1649941140867,MATH 193A,A04,083782,Staff,16,0,30,14
1649941146906,MATH 197,001,091859,McAuley; Julian John,9999,0,9999,0
1649941152964,COGS 9,A01,083615,Staff,16,0,60,44
1649941158995,COGS 11,A01,083617,Boyle; Mary E. T.,35,0,40,5
1649941165028,COGS 13,A01,083071,Staff,0,11,40,40
1649941171052,COGS 14A,A01,092681,Staff,65,0,100,35
1649941177082,COGS 14B,A01,083073,Cheng; Tzu-Han,24,0,50,26
1649941183109,COGS 17,A01,092677,Staff,63,0,75,12
1649941189142,COGS 100,A01,083619,Staff,0,5,60,60
1649941195172,COGS 101A,A01,083621,Davis; Joshua Daniel,0,8,60,60
1649941201203,COGS 101B,A01,091572,Staff,31,0,60,29
1649941207239,COGS 101C,A01,083625,Delgado; Tania,24,0,30,6
1649941213269,COGS 107A,A01,083627,Boyle; Mary E. T.,14,0,60,46
1649941219299,COGS 118A,A01,083075,Staff,21,0,60,39
1649941225325,CSE 3,A50,083646,Miranda; Gregory Joseph,24,0,38,14
1649941225325,CSE 3,A51,083647,Miranda; Gregory Joseph,37,0,37,0
1649941231351,CSE 8A,A50,083650,Miranda; Gregory Joseph,8,0,40,32
1649941237377,CSE 11,A01,083080,Cao; Yingjun,0,26,40,40
1649941243408,CSE 12,A01,083652,Staff,56,0,100,44
1649941249434,CSE 15L,A01,083654,Staff,19,0,50,31
1649941249434,CSE 15L,A02,083655,Staff,47,0,50,3
1649941255459,CSE 20,A01,083657,Staff,68,0,80,12
1649941261498,CSE 30,A01,083084,Eldon; John,0,24,40,40
1649941267524,CSE 100,A01,083659,Cao; Yingjun,1,27,50,49
1649941273555,CSE 134B,A01,083661,Powell; Thomas Allan,0,21,65,65
1649941279583,CSE 140,A01,083663,Staff,24,0,75,51
1649941285615,CSE 140L,A01,083088,Eldon; John,18,0,75,57
1649941291641,CSE 175,A01,083665,Kumar; Rakesh,12,0,25,13
1649941297667,CSE 190,A00,092507,Dubnov; Shlomo,14,0,15,1
1649941303696,ECE 45,A01,083139,Staff,6,0,40,34
1649941309721,ECE 65,A50,083695,Staff,7,0,30,23
1649941315746,ECE 109,A01,091882,Touri; Behrouz,55,0,70,15
1649941321777,ECE 180,A00,083140,Abi Samra; Nicholas Camill,26,0,30,4
1649941321777,ECE 180,B00,083141,Abi Samra; Nicholas Camill,13,0,30,17
1649941327811,MATH 10A,A01,083735,Patchell; Gregory David,20,0,30,10
1649941327811,MATH 10A,A02,083736,Patchell; Gregory David,28,0,30,2
1649941327811,MATH 10A,A03,083737,Patchell; Gregory David,28,0,30,2
1649941333840,MATH 10B,A01,083207,Staff,10,0,30,20
1649941333840,MATH 10B,A02,083208,Staff,25,0,30,5
1649941333840,MATH 10B,B01,083739,Staff,25,0,30,5
1649941333840,MATH 10B,B02,083740,Staff,30,0,30,0
1649941339868,MATH 18,A01,083743,Staff,22,0,30,8
1649941339868,MATH 18,A02,083744,Staff,29,0,30,1
1649941339868,MATH 18,A03,083745,Staff,29,0,30,1
1649941339868,MATH 18,A04,083746,Staff,28,0,30,2
1649941339868,MATH 18,B01,083748,Staff,5,0,30,25
1649941339868,MATH 18,B02,083749,Staff,26,0,30,4
1649941339868,MATH 18,B03,083750,Staff,28,0,30,2
1649941339868,MATH 18,B04,083751,Staff,26,0,30,4
1649941345895,MATH 20A,A01,083754,Staff,37,0,40,3
1649941351924,MATH 20B,A01,083756,Staff,19,0,30,11
1649941351924,MATH 20B,A02,083757,Staff,30,0,30,0
1649941357957,MATH 20C,A01,083760,Staff,22,0,30,8
1649941357957,MATH 20C,A02,083761,Staff,23,0,30,7
1649941357957,MATH 20C,B01,083762,Staff,28,0,30,2
1649941357957,MATH 20C,B02,083763,Staff,30,0,30,0
1649941363986,MATH 20D,A01,083765,Staff,20,0,30,10
1649941363986,MATH 20D,A02,083766,Staff,30,0,30,0
1649941363986,MATH 20D,A03,083767,Staff,30,0,30,0
1649941370011,MATH 20E,A01,083771,Staff,12,0,30,18
1649941370011,MATH 20E,A02,083772,Staff,24,0,30,6
1649941370011,MATH 20E,B01,083773,Staff,17,0,30,13
1649941370011,MATH 20E,B02,083774,Staff,29,0,30,1
1649941376043,MATH 103A,A01,083777,Staff,1,4,30,29
1649941376043,MATH 103A,A02,083778,Staff,0,3,30,30
1649941376043,MATH 103A,B01,083779,Staff,0,0,30,30
1649941376043,MATH 103A,B02,083780,Staff,16,0,30,14
1649941382071,MATH 105,A01,085443,Staff,0,5,30,30
1649941388103,MATH 109,A01,083213,Anzaldo; Leesa B,13,0,30,17
1649941388103,MATH 109,A02,083214,Anzaldo; Leesa B,9,0,30,21
1649941388103,MATH 109,B01,083215,Anzaldo; Leesa B,26,0,30,4
1649941388103,MATH 109,B02,083216,Anzaldo; Leesa B,22,0,30,8
1649941394131,MATH 142A,A01,083219,Chow; Bennett,0,1,30,30
1649941394131,MATH 142A,A02,083220,Chow; Bennett,9,0,30,21
1649941394131,MATH 142A,B01,083221,Chow; Bennett,0,0,30,30
1649941394131,MATH 142A,B02,083222,Chow; Bennett,1,0,30,29
1649941400161,MATH 193A,A01,083224,Staff,0,3,30,30
1649941400161,MATH 193A,A02,083225,Staff,0,3,30,30
1649941400161,MATH 193A,A03,083781,Staff,4,0,30,26
1649941400161,MATH 193A,A04,083782,Staff,16,0,30,14
1649941406185,MATH 197,001,091859,McAuley; Julian John,9999,0,9999,0
1649941412244,COGS 9,A01,083615,Staff,16,0,60,44
1649941418273,COGS 11,A01,083617,Boyle; Mary E. T.,35,0,40,5
1649941424296,COGS 13,A01,083071,Staff,0,11,40,40
1649941430320,COGS 14A,A01,092681,Staff,65,0,100,35
1649941436345,COGS 14B,A01,083073,Cheng; Tzu-Han,24,0,50,26
1649941442379,COGS 17,A01,092677,Staff,63,0,75,12
1649941448404,COGS 100,A01,083619,Staff,0,5,60,60
1649941454431,COGS 101A,A01,083621,Davis; Joshua Daniel,0,8,60,60
1649941460461,COGS 101B,A01,091572,Staff,31,0,60,29
1649941466491,COGS 101C,A01,083625,Delgado; Tania,24,0,30,6
1649941472520,COGS 107A,A01,083627,Boyle; Mary E. T.,14,0,60,46
1649941478549,COGS 118A,A01,083075,Staff,21,0,60,39
1649941484579,CSE 3,A50,083646,Miranda; Gregory Joseph,24,0,38,14
1649941484579,CSE 3,A51,083647,Miranda; Gregory Joseph,37,0,37,0
1649941490606,CSE 8A,A50,083650,Miranda; Gregory Joseph,8,0,40,32
1649941496631,CSE 11,A01,083080,Cao; Yingjun,0,26,40,40
1649941502660,CSE 12,A01,083652,Staff,56,0,100,44
1649941508693,CSE 15L,A01,083654,Staff,19,0,50,31
1649941508693,CSE 15L,A02,083655,Staff,47,0,50,3
1649941514728,CSE 20,A01,083657,Staff,68,0,80,12
1649941520770,CSE 30,A01,083084,Eldon; John,0,24,40,40
1649941526798,CSE 100,A01,083659,Cao; Yingjun,1,27,50,49
1649941532829,CSE 134B,A01,083661,Powell; Thomas Allan,0,21,65,65
1649941538854,CSE 140,A01,083663,Staff,24,0,75,51
1649941544883,CSE 140L,A01,083088,Eldon; John,18,0,75,57
1649941550911,CSE 175,A01,083665,Kumar; Rakesh,12,0,25,13
1649941556935,CSE 190,A00,092507,Dubnov; Shlomo,14,0,15,1
1649941562973,ECE 45,A01,083139,Staff,6,0,40,34
1649941569003,ECE 65,A50,083695,Staff,7,0,30,23
1649941575033,ECE 109,A01,091882,Touri; Behrouz,55,0,70,15
1649941581058,ECE 180,A00,083140,Abi Samra; Nicholas Camill,26,0,30,4
1649941581058,ECE 180,B00,083141,Abi Samra; Nicholas Camill,13,0,30,17
1649941587100,MATH 10A,A01,083735,Patchell; Gregory David,20,0,30,10
1649941587100,MATH 10A,A02,083736,Patchell; Gregory David,28,0,30,2
1649941587100,MATH 10A,A03,083737,Patchell; Gregory David,28,0,30,2
1649941593124,MATH 10B,A01,083207,Staff,10,0,30,20
1649941593124,MATH 10B,A02,083208,Staff,25,0,30,5
1649941593124,MATH 10B,B01,083739,Staff,25,0,30,5
1649941593124,MATH 10B,B02,083740,Staff,30,0,30,0
1649941599153,MATH 18,A01,083743,Staff,22,0,30,8
1649941599153,MATH 18,A02,083744,Staff,29,0,30,1
1649941599153,MATH 18,A03,083745,Staff,29,0,30,1
1649941599153,MATH 18,A04,083746,Staff,28,0,30,2
1649941599153,MATH 18,B01,083748,Staff,5,0,30,25
1649941599153,MATH 18,B02,083749,Staff,26,0,30,4
1649941599153,MATH 18,B03,083750,Staff,28,0,30,2
1649941599153,MATH 18,B04,083751,Staff,26,0,30,4
1649941605176,MATH 20A,A01,083754,Staff,37,0,40,3
1649941611203,MATH 20B,A01,083756,Staff,19,0,30,11
1649941611203,MATH 20B,A02,083757,Staff,30,0,30,0
1649941617233,MATH 20C,A01,083760,Staff,22,0,30,8
1649941617233,MATH 20C,A02,083761,Staff,23,0,30,7
1649941617233,MATH 20C,B01,083762,Staff,28,0,30,2
1649941617233,MATH 20C,B02,083763,Staff,30,0,30,0
1649941623265,MATH 20D,A01,083765,Staff,20,0,30,10
1649941623265,MATH 20D,A02,083766,Staff,30,0,30,0
1649941623265,MATH 20D,A03,083767,Staff,30,0,30,0
1649941629300,MATH 20E,A01,083771,Staff,12,0,30,18
1649941629300,MATH 20E,A02,083772,Staff,24,0,30,6
1649941629300,MATH 20E,B01,083773,Staff,17,0,30,13
1649941629300,MATH 20E,B02,083774,Staff,29,0,30,1
1649941635334,MATH 103A,A01,083777,Staff,1,4,30,29
1649941635334,MATH 103A,A02,083778,Staff,0,3,30,30
1649941635334,MATH 103A,B01,083779,Staff,0,0,30,30
1649941635334,MATH 103A,B02,083780,Staff,16,0,30,14
1649941641471,MATH 105,A01,085443,Staff,0,5,30,30
1649941647504,MATH 109,A01,083213,Anzaldo; Leesa B,13,0,30,17
1649941647504,MATH 109,A02,083214,Anzaldo; Leesa B,9,0,30,21
1649941647504,MATH 109,B01,083215,Anzaldo; Leesa B,26,0,30,4
1649941647504,MATH 109,B02,083216,Anzaldo; Leesa B,22,0,30,8
1649941653531,MATH 142A,A01,083219,Chow; Bennett,0,1,30,30
1649941653531,MATH 142A,A02,083220,Chow; Bennett,9,0,30,21
1649941653531,MATH 142A,B01,083221,Chow; Bennett,0,0,30,30
1649941653531,MATH 142A,B02,083222,Chow; Bennett,1,0,30,29
1649941659558,MATH 193A,A01,083224,Staff,0,3,30,30
1649941659558,MATH 193A,A02,083225,Staff,0,3,30,30
1649941659558,MATH 193A,A03,083781,Staff,4,0,30,26
1649941659558,MATH 193A,A04,083782,Staff,16,0,30,14
1649941665582,MATH 197,001,091859,McAuley; Julian John,9999,0,9999,0
1649941671643,COGS 9,A01,083615,Staff,16,0,60,44
1649941677672,COGS 11,A01,083617,Boyle; Mary E. T.,35,0,40,5
1649941683696,COGS 13,A01,083071,Staff,0,11,40,40
1649941689724,COGS 14A,A01,092681,Staff,65,0,100,35
1649941695750,COGS 14B,A01,083073,Cheng; Tzu-Han,24,0,50,26
1649941701774,COGS 17,A01,092677,Staff,63,0,75,12
1649941707802,COGS 100,A01,083619,Staff,0,5,60,60
1649941713829,COGS 101A,A01,083621,Davis; Joshua Daniel,0,8,60,60
1649941719856,COGS 101B,A01,091572,Staff,31,0,60,29
1649941725886,COGS 101C,A01,083625,Delgado; Tania,24,0,30,6
1649941731911,COGS 107A,A01,083627,Boyle; Mary E. T.,14,0,60,46
1649941737936,COGS 118A,A01,083075,Staff,21,0,60,39
1649941743962,CSE 3,A50,083646,Miranda; Gregory Joseph,24,0,38,14
1649941743962,CSE 3,A51,083647,Miranda; Gregory Joseph,37,0,37,0
1649941749992,CSE 8A,A50,083650,Miranda; Gregory Joseph,8,0,40,32
1649941756025,CSE 11,A01,083080,Cao; Yingjun,0,26,40,40
1649941762050,CSE 12,A01,083652,Staff,56,0,100,44
1649941768075,CSE 15L,A01,083654,Staff,19,0,50,31
1649941768075,CSE 15L,A02,083655,Staff,47,0,50,3
1649941774100,CSE 20,A01,083657,Staff,68,0,80,12
1649941780130,CSE 30,A01,083084,Eldon; John,0,24,40,40
1649941786154,CSE 100,A01,083659,Cao; Yingjun,1,27,50,49
1649941792182,CSE 134B,A01,083661,Powell; Thomas Allan,0,21,65,65
1649941798210,CSE 140,A01,083663,Staff,24,0,75,51
1649941804245,CSE 140L,A01,083088,Eldon; John,18,0,75,57
1649941810278,CSE 175,A01,083665,Kumar; Rakesh,12,0,25,13
1649941816304,CSE 190,A00,092507,Dubnov; Shlomo,14,0,15,1
1649941822332,ECE 45,A01,083139,Staff,6,0,40,34
1649941828363,ECE 65,A50,083695,Staff,7,0,30,23
1649941834411,ECE 109,A01,091882,Touri; Behrouz,55,0,70,15
1649941840435,ECE 180,A00,083140,Abi Samra; Nicholas Camill,26,0,30,4
1649941840435,ECE 180,B00,083141,Abi Samra; Nicholas Camill,13,0,30,17
1649941846468,MATH 10A,A01,083735,Patchell; Gregory David,20,0,30,10
1649941846468,MATH 10A,A02,083736,Patchell; Gregory David,28,0,30,2
1649941846468,MATH 10A,A03,083737,Patchell; Gregory David,28,0,30,2
1649941852494,MATH 10B,A01,083207,Staff,10,0,30,20
1649941852494,MATH 10B,A02,083208,Staff,25,0,30,5
1649941852494,MATH 10B,B01,083739,Staff,25,0,30,5
1649941852494,MATH 10B,B02,083740,Staff,30,0,30,0
1649941858527,MATH 18,A01,083743,Staff,22,0,30,8
1649941858527,MATH 18,A02,083744,Staff,29,0,30,1
1649941858527,MATH 18,A03,083745,Staff,29,0,30,1
1649941858527,MATH 18,A04,083746,Staff,28,0,30,2
1649941858527,MATH 18,B01,083748,Staff,5,0,30,25
1649941858527,MATH 18,B02,083749,Staff,26,0,30,4
1649941858527,MATH 18,B03,083750,Staff,28,0,30,2
1649941858527,MATH 18,B04,083751,Staff,26,0,30,4
1649941864558,MATH 20A,A01,083754,Staff,37,0,40,3
1649941870583,MATH 20B,A01,083756,Staff,19,0,30,11
1649941870583,MATH 20B,A02,083757,Staff,30,0,30,0
1649941876632,MATH 20C,A01,083760,Staff,22,0,30,8
1649941876632,MATH 20C,A02,083761,Staff,23,0,30,7
1649941876632,MATH 20C,B01,083762,Staff,28,0,30,2
1649941876632,MATH 20C,B02,083763,Staff,30,0,30,0
1649941882661,MATH 20D,A01,083765,Staff,20,0,30,10
1649941882661,MATH 20D,A02,083766,Staff,30,0,30,0
1649941882661,MATH 20D,A03,083767,Staff,30,0,30,0
1649941888694,MATH 20E,A01,083771,Staff,12,0,30,18
1649941888694,MATH 20E,A02,083772,Staff,24,0,30,6
1649941888694,MATH 20E,B01,083773,Staff,17,0,30,13
1649941888694,MATH 20E,B02,083774,Staff,29,0,30,1
1649941894723,MATH 103A,A01,083777,Staff,1,4,30,29
1649941894723,MATH 103A,A02,083778,Staff,0,3,30,30
1649941894723,MATH 103A,B01,083779,Staff,0,0,30,30
1649941894723,MATH 103A,B02,083780,Staff,16,0,30,14
1649941900748,MATH 105,A01,085443,Staff,0,5,30,30
1649941906776,MATH 109,A01,083213,Anzaldo; Leesa B,13,0,30,17
1649941906776,MATH 109,A02,083214,Anzaldo; Leesa B,9,0,30,21
1649941906776,MATH 109,B01,083215,Anzaldo; Leesa B,26,0,30,4
1649941906776,MATH 109,B02,083216,Anzaldo; Leesa B,22,0,30,8
1649941912803,MATH 142A,A01,083219,Chow; Bennett,0,1,30,30
1649941912803,MATH 142A,A02,083220,Chow; Bennett,9,0,30,21
1649941912803,MATH 142A,B01,083221,Chow; Bennett,0,0,30,30
1649941912803,MATH 142A,B02,083222,Chow; Bennett,1,0,30,29
1649941918827,MATH 193A,A01,083224,Staff,0,3,30,30
1649941918827,MATH 193A,A02,083225,Staff,0,3,30,30
1649941918827,MATH 193A,A03,083781,Staff,4,0,30,26
1649941918827,MATH 193A,A04,083782,Staff,16,0,30,14
1649941924855,MATH 197,001,091859,McAuley; Julian John,9999,0,9999,0
1649941930925,COGS 9,A01,083615,Staff,16,0,60,44
1649941936967,COGS 11,A01,083617,Boyle; Mary E. T.,35,0,40,5
1649941942992,COGS 13,A01,083071,Staff,0,11,40,40
1649941949029,COGS 14A,A01,092681,Staff,65,0,100,35
1649941955059,COGS 14B,A01,083073,Cheng; Tzu-Han,24,0,50,26
1649941961109,COGS 17,A01,092677,Staff,63,0,75,12
1649941967138,COGS 100,A01,083619,Staff,0,5,60,60
1649941973162,COGS 101A,A01,083621,Davis; Joshua Daniel,0,8,60,60
1649941979187,COGS 101B,A01,091572,Staff,31,0,60,29
1649941985215,COGS 101C,A01,083625,Delgado; Tania,24,0,30,6
1649941991243,COGS 107A,A01,083627,Boyle; Mary E. T.,14,0,60,46
1649941997266,COGS 118A,A01,083075,Staff,21,0,60,39
1649942003292,CSE 3,A50,083646,Miranda; Gregory Joseph,24,0,38,14
1649942003292,CSE 3,A51,083647,Miranda; Gregory Joseph,37,0,37,0
1649942009323,CSE 8A,A50,083650,Miranda; Gregory Joseph,8,0,40,32
1649942015353,CSE 11,A01,083080,Cao; Yingjun,0,26,40,40
1649942021380,CSE 12,A01,083652,Staff,56,0,100,44
1649942027409,CSE 15L,A01,083654,Staff,19,0,50,31
1649942027409,CSE 15L,A02,083655,Staff,47,0,50,3
1649942033438,CSE 20,A01,083657,Staff,68,0,80,12
1649942039464,CSE 30,A01,083084,Eldon; John,0,24,40,40
1649942045487,CSE 100,A01,083659,Cao; Yingjun,1,27,50,49
1649942051525,CSE 134B,A01,083661,Powell; Thomas Allan,0,21,65,65
1649942057549,CSE 140,A01,083663,Staff,24,0,75,51
1649942063574,CSE 140L,A01,083088,Eldon; John,18,0,75,57
1649942069598,CSE 175,A01,083665,Kumar; Rakesh,12,0,25,13
1649942075626,CSE 190,A00,092507,Dubnov; Shlomo,14,0,15,1
1649942081653,ECE 45,A01,083139,Staff,6,0,40,34
1649942087680,ECE 65,A50,083695,Staff,7,0,30,23
1649942093705,ECE 109,A01,091882,Touri; Behrouz,55,0,70,15
1649942099731,ECE 180,A00,083140,Abi Samra; Nicholas Camill,26,0,30,4
1649942099731,ECE 180,B00,083141,Abi Samra; Nicholas Camill,13,0,30,17
1649942105764,MATH 10A,A01,083735,Patchell; Gregory David,20,0,30,10
1649942105764,MATH 10A,A02,083736,Patchell; Gregory David,28,0,30,2
1649942105764,MATH 10A,A03,083737,Patchell; Gregory David,28,0,30,2
1649942111795,MATH 10B,A01,083207,Staff,10,0,30,20
1649942111795,MATH 10B,A02,083208,Staff,25,0,30,5
1649942111795,MATH 10B,B01,083739,Staff,25,0,30,5
1649942111795,MATH 10B,B02,083740,Staff,30,0,30,0
1649942117846,MATH 18,A01,083743,Staff,22,0,30,8
1649942117846,MATH 18,A02,083744,Staff,29,0,30,1
1649942117846,MATH 18,A03,083745,Staff,29,0,30,1
1649942117846,MATH 18,A04,083746,Staff,28,0,30,2
1649942117846,MATH 18,B01,083748,Staff,5,0,30,25
1649942117846,MATH 18,B02,083749,Staff,26,0,30,4
1649942117846,MATH 18,B03,083750,Staff,28,0,30,2
1649942117846,MATH 18,B04,083751,Staff,26,0,30,4
1649942123880,MATH 20A,A01,083754,Staff,37,0,40,3
1649942129908,MATH 20B,A01,083756,Staff,19,0,30,11
1649942129908,MATH 20B,A02,083757,Staff,30,0,30,0
1649942135937,MATH 20C,A01,083760,Staff,22,0,30,8
1649942135937,MATH 20C,A02,083761,Staff,23,0,30,7
1649942135937,MATH 20C,B01,083762,Staff,28,0,30,2
1649942135937,MATH 20C,B02,083763,Staff,30,0,30,0
1649942141974,MATH 20D,A01,083765,Staff,20,0,30,10
1649942141974,MATH 20D,A02,083766,Staff,30,0,30,0
1649942141974,MATH 20D,A03,083767,Staff,30,0,30,0
1649942147999,MATH 20E,A01,083771,Staff,12,0,30,18
1649942147999,MATH 20E,A02,083772,Staff,24,0,30,6
1649942147999,MATH 20E,B01,083773,Staff,17,0,30,13
1649942147999,MATH 20E,B02,083774,Staff,29,0,30,1
1649942154030,MATH 103A,A01,083777,Staff,1,4,30,29
1649942154030,MATH 103A,A02,083778,Staff,0,3,30,30
1649942154030,MATH 103A,B01,083779,Staff,0,0,30,30
1649942154030,MATH 103A,B02,083780,Staff,16,0,30,14
1649942160057,MATH 105,A01,085443,Staff,0,5,30,30
1649942166084,MATH 109,A01,083213,Anzaldo; Leesa B,13,0,30,17
1649942166084,MATH 109,A02,083214,Anzaldo; Leesa B,9,0,30,21
1649942166084,MATH 109,B01,083215,Anzaldo; Leesa B,26,0,30,4
1649942166084,MATH 109,B02,083216,Anzaldo; Leesa B,22,0,30,8
1649942172109,MATH 142A,A01,083219,Chow; Bennett,0,1,30,30
1649942172109,MATH 142A,A02,083220,Chow; Bennett,9,0,30,21
1649942172109,MATH 142A,B01,083221,Chow; Bennett,0,0,30,30
1649942172109,MATH 142A,B02,083222,Chow; Bennett,1,0,30,29
1649942178138,MATH 193A,A01,083224,Staff,0,3,30,30
1649942178138,MATH 193A,A02,083225,Staff,0,3,30,30
1649942178138,MATH 193A,A03,083781,Staff,4,0,30,26
1649942178138,MATH 193A,A04,083782,Staff,16,0,30,14
1649942184163,MATH 197,001,091859,McAuley; Julian John,9999,0,9999,0
1649942190233,COGS 9,A01,083615,Staff,16,0,60,44
1649942196266,COGS 11,A01,083617,Boyle; Mary E. T.,35,0,40,5
1649942202292,COGS 13,A01,083071,Staff,0,11,40,40
1649942208320,COGS 14A,A01,092681,Staff,65,0,100,35
1649942214346,COGS 14B,A01,083073,Cheng; Tzu-Han,24,0,50,26
1649942220370,COGS 17,A01,092677,Staff,63,0,75,12
1649942226403,COGS 100,A01,083619,Staff,0,5,60,60
1649942232504,COGS 101A,A01,083621,Davis; Joshua Daniel,0,8,60,60
1649942238534,COGS 101B,A01,091572,Staff,31,0,60,29
1649942244565,COGS 101C,A01,083625,Delgado; Tania,24,0,30,6
1649942250591,COGS 107A,A01,083627,Boyle; Mary E. T.,14,0,60,46
1649942256619,COGS 118A,A01,083075,Staff,21,0,60,39
1649942262650,CSE 3,A50,083646,Miranda; Gregory Joseph,24,0,38,14
1649942262650,CSE 3,A51,083647,Miranda; Gregory Joseph,37,0,37,0
1649942268676,CSE 8A,A50,083650,Miranda; Gregory Joseph,8,0,40,32
1649942274699,CSE 11,A01,083080,Cao; Yingjun,0,26,40,40
1649942280725,CSE 12,A01,083652,Staff,56,0,100,44
1649942286751,CSE 15L,A01,083654,Staff,19,0,50,31
1649942286751,CSE 15L,A02,083655,Staff,47,0,50,3
1649942292780,CSE 20,A01,083657,Staff,68,0,80,12
1649942298810,CSE 30,A01,083084,Eldon; John,0,24,40,40
1649942304848,CSE 100,A01,083659,Cao; Yingjun,1,27,50,49
1649942310873,CSE 134B,A01,083661,Powell; Thomas Allan,0,21,65,65
1649942316897,CSE 140,A01,083663,Staff,24,0,75,51
1649942322922,CSE 140L,A01,083088,Eldon; John,18,0,75,57
1649942328950,CSE 175,A01,083665,Kumar; Rakesh,12,0,25,13
1649942334976,CSE 190,A00,092507,Dubnov; Shlomo,14,0,15,1
1649942341006,ECE 45,A01,083139,Staff,6,0,40,34
1649942347034,ECE 65,A50,083695,Staff,7,0,30,23
1649942353067,ECE 109,A01,091882,Touri; Behrouz,55,0,70,15
1649942359092,ECE 180,A00,083140,Abi Samra; Nicholas Camill,26,0,30,4
1649942359092,ECE 180,B00,083141,Abi Samra; Nicholas Camill,13,0,30,17
1649942365134,MATH 10A,A01,083735,Patchell; Gregory David,20,0,30,10
1649942365134,MATH 10A,A02,083736,Patchell; Gregory David,28,0,30,2
1649942365134,MATH 10A,A03,083737,Patchell; Gregory David,28,0,30,2
1649942371164,MATH 10B,A01,083207,Staff,10,0,30,20
1649942371164,MATH 10B,A02,083208,Staff,25,0,30,5
1649942371164,MATH 10B,B01,083739,Staff,25,0,30,5
1649942371164,MATH 10B,B02,083740,Staff,30,0,30,0
1649942377198,MATH 18,A01,083743,Staff,22,0,30,8
1649942377198,MATH 18,A02,083744,Staff,29,0,30,1
1649942377198,MATH 18,A03,083745,Staff,29,0,30,1
1649942377198,MATH 18,A04,083746,Staff,28,0,30,2
1649942377198,MATH 18,B01,083748,Staff,5,0,30,25
1649942377198,MATH 18,B02,083749,Staff,26,0,30,4
1649942377198,MATH 18,B03,083750,Staff,28,0,30,2
1649942377198,MATH 18,B04,083751,Staff,26,0,30,4
1649942383224,MATH 20A,A01,083754,Staff,37,0,40,3
1649942389255,MATH 20B,A01,083756,Staff,19,0,30,11
1649942389255,MATH 20B,A02,083757,Staff,30,0,30,0
1649942395284,MATH 20C,A01,083760,Staff,22,0,30,8
1649942395284,MATH 20C,A02,083761,Staff,23,0,30,7
1649942395284,MATH 20C,B01,083762,Staff,28,0,30,2
1649942395284,MATH 20C,B02,083763,Staff,30,0,30,0
1649942401314,MATH 20D,A01,083765,Staff,20,0,30,10
1649942401314,MATH 20D,A02,083766,Staff,30,0,30,0
1649942401314,MATH 20D,A03,083767,Staff,30,0,30,0
1649942407353,MATH 20E,A01,083771,Staff,12,0,30,18
1649942407353,MATH 20E,A02,083772,Staff,24,0,30,6
1649942407353,MATH 20E,B01,083773,Staff,17,0,30,13
1649942407353,MATH 20E,B02,083774,Staff,29,0,30,1
1649942413387,MATH 103A,A01,083777,Staff,1,4,30,29
1649942413387,MATH 103A,A02,083778,Staff,0,3,30,30
1649942413387,MATH 103A,B01,083779,Staff,0,0,30,30
1649942413387,MATH 103A,B02,083780,Staff,16,0,30,14
1649942419413,MATH 105,A01,085443,Staff,0,5,30,30
1649942425439,MATH 109,A01,083213,Anzaldo; Leesa B,13,0,30,17
1649942425439,MATH 109,A02,083214,Anzaldo; Leesa B,9,0,30,21
1649942425439,MATH 109,B01,083215,Anzaldo; Leesa B,26,0,30,4
1649942425439,MATH 109,B02,083216,Anzaldo; Leesa B,22,0,30,8
1649942431478,MATH 142A,A01,083219,Chow; Bennett,0,1,30,30
1649942431478,MATH 142A,A02,083220,Chow; Bennett,9,0,30,21
1649942431478,MATH 142A,B01,083221,Chow; Bennett,0,0,30,30
1649942431478,MATH 142A,B02,083222,Chow; Bennett,1,0,30,29
1649942437503,MATH 193A,A01,083224,Staff,0,3,30,30
1649942437503,MATH 193A,A02,083225,Staff,0,3,30,30
1649942437503,MATH 193A,A03,083781,Staff,4,0,30,26
1649942437503,MATH 193A,A04,083782,Staff,16,0,30,14
1649942443527,MATH 197,001,091859,McAuley; Julian John,9999,0,9999,0
1649942449599,COGS 9,A01,083615,Staff,16,0,60,44
1649942455625,COGS 11,A01,083617,Boyle; Mary E. T.,35,0,40,5
1649942461670,COGS 13,A01,083071,Staff,0,11,40,40
1649942467813,COGS 14A,A01,092681,Staff,65,0,100,35
1649942473839,COGS 14B,A01,083073,Cheng; Tzu-Han,24,0,50,26
1649942479875,COGS 17,A01,092677,Staff,63,0,75,12
1649942485917,COGS 100,A01,083619,Staff,0,5,60,60
1649942491979,COGS 101A,A01,083621,Davis; Joshua Daniel,0,8,60,60
1649942498032,COGS 101B,A01,091572,Staff,31,0,60,29
1649942504081,COGS 101C,A01,083625,Delgado; Tania,24,0,30,6
1649942510112,COGS 107A,A01,083627,Boyle; Mary E. T.,14,0,60,46
1649942516156,COGS 118A,A01,083075,Staff,21,0,60,39
1649942522184,CSE 3,A50,083646,Miranda; Gregory Joseph,24,0,38,14
1649942522184,CSE 3,A51,083647,Miranda; Gregory Joseph,37,0,37,0
1649942528228,CSE 8A,A50,083650,Miranda; Gregory Joseph,8,0,40,32
1649942534265,CSE 11,A01,083080,Cao; Yingjun,0,26,40,40
1649942540300,CSE 12,A01,083652,Staff,56,0,100,44
1649942546324,CSE 15L,A01,083654,Staff,19,0,50,31
1649942546324,CSE 15L,A02,083655,Staff,47,0,50,3
1649942552348,CSE 20,A01,083657,Staff,68,0,80,12
1649942558375,CSE 30,A01,083084,Eldon; John,0,24,40,40
1649942564401,CSE 100,A01,083659,Cao; Yingjun,1,27,50,49
1649942570428,CSE 134B,A01,083661,Powell; Thomas Allan,0,21,65,65
1649942576452,CSE 140,A01,083663,Staff,24,0,75,51
1649942582477,CSE 140L,A01,083088,Eldon; John,18,0,75,57
1649942588508,CSE 175,A01,083665,Kumar; Rakesh,12,0,25,13
1649942594542,CSE 190,A00,092507,Dubnov; Shlomo,14,0,15,1
1649942600571,ECE 45,A01,083139,Staff,6,0,40,34
1649942606598,ECE 65,A50,083695,Staff,7,0,30,23
1649942612624,ECE 109,A01,091882,Touri; Behrouz,55,0,70,15
1649942618658,ECE 180,A00,083140,Abi Samra; Nicholas Camill,26,0,30,4
1649942618658,ECE 180,B00,083141,Abi Samra; Nicholas Camill,13,0,30,17
1649942624690,MATH 10A,A01,083735,Patchell; Gregory David,20,0,30,10
1649942624690,MATH 10A,A02,083736,Patchell; Gregory David,28,0,30,2
1649942624690,MATH 10A,A03,083737,Patchell; Gregory David,28,0,30,2
1649942630717,MATH 10B,A01,083207,Staff,10,0,30,20
1649942630717,MATH 10B,A02,083208,Staff,25,0,30,5
1649942630717,MATH 10B,B01,083739,Staff,25,0,30,5
1649942630717,MATH 10B,B02,083740,Staff,30,0,30,0
1649942636751,MATH 18,A01,083743,Staff,22,0,30,8
1649942636751,MATH 18,A02,083744,Staff,29,0,30,1
1649942636751,MATH 18,A03,083745,Staff,29,0,30,1
1649942636751,MATH 18,A04,083746,Staff,28,0,30,2
1649942636751,MATH 18,B01,083748,Staff,5,0,30,25
1649942636751,MATH 18,B02,083749,Staff,26,0,30,4
1649942636751,MATH 18,B03,083750,Staff,28,0,30,2
1649942636751,MATH 18,B04,083751,Staff,26,0,30,4
1649942642779,MATH 20A,A01,083754,Staff,37,0,40,3
1649942648820,MATH 20B,A01,083756,Staff,19,0,30,11
1649942648820,MATH 20B,A02,083757,Staff,30,0,30,0
1649942654847,MATH 20C,A01,083760,Staff,22,0,30,8
1649942654847,MATH 20C,A02,083761,Staff,23,0,30,7
1649942654847,MATH 20C,B01,083762,Staff,28,0,30,2
1649942654847,MATH 20C,B02,083763,Staff,30,0,30,0
1649942660884,MATH 20D,A01,083765,Staff,20,0,30,10
1649942660884,MATH 20D,A02,083766,Staff,30,0,30,0
1649942660884,MATH 20D,A03,083767,Staff,30,0,30,0
1649942666924,MATH 20E,A01,083771,Staff,12,0,30,18
1649942666924,MATH 20E,A02,083772,Staff,24,0,30,6
1649942666924,MATH 20E,B01,083773,Staff,17,0,30,13
1649942666924,MATH 20E,B02,083774,Staff,29,0,30,1
1649942672949,MATH 103A,A01,083777,Staff,1,4,30,29
1649942672949,MATH 103A,A02,083778,Staff,0,3,30,30
1649942672949,MATH 103A,B01,083779,Staff,0,0,30,30
1649942672949,MATH 103A,B02,083780,Staff,16,0,30,14
1649942679001,MATH 105,A01,085443,Staff,0,5,30,30
1649942685034,MATH 109,A01,083213,Anzaldo; Leesa B,13,0,30,17
1649942685034,MATH 109,A02,083214,Anzaldo; Leesa B,9,0,30,21
1649942685034,MATH 109,B01,083215,Anzaldo; Leesa B,26,0,30,4
1649942685034,MATH 109,B02,083216,Anzaldo; Leesa B,22,0,30,8
1649942691061,MATH 142A,A01,083219,Chow; Bennett,0,1,30,30
1649942691061,MATH 142A,A02,083220,Chow; Bennett,9,0,30,21
1649942691061,MATH 142A,B01,083221,Chow; Bennett,0,0,30,30
1649942691061,MATH 142A,B02,083222,Chow; Bennett,1,0,30,29
1649942697102,MATH 193A,A01,083224,Staff,0,3,30,30
1649942697102,MATH 193A,A02,083225,Staff,0,3,30,30
1649942697102,MATH 193A,A03,083781,Staff,4,0,30,26
1649942697102,MATH 193A,A04,083782,Staff,16,0,30,14
1649942703131,MATH 197,001,091859,McAuley; Julian John,9999,0,9999,0
1649942709211,COGS 9,A01,083615,Staff,16,0,60,44
1649942715237,COGS 11,A01,083617,Boyle; Mary E. T.,35,0,40,5
1649942721265,COGS 13,A01,083071,Staff,0,11,40,40
1649942727294,COGS 14A,A01,092681,Staff,65,0,100,35
1649942733321,COGS 14B,A01,083073,Cheng; Tzu-Han,24,0,50,26
1649942739345,COGS 17,A01,092677,Staff,63,0,75,12
1649942745374,COGS 100,A01,083619,Staff,0,5,60,60
1649942751404,COGS 101A,A01,083621,Davis; Joshua Daniel,0,8,60,60
1649942757438,COGS 101B,A01,091572,Staff,31,0,60,29
1649942763464,COGS 101C,A01,083625,Delgado; Tania,24,0,30,6
1649942769491,COGS 107A,A01,083627,Boyle; Mary E. T.,14,0,60,46
1649942775518,COGS 118A,A01,083075,Staff,21,0,60,39
1649942781548,CSE 3,A50,083646,Miranda; Gregory Joseph,24,0,38,14
1649942781548,CSE 3,A51,083647,Miranda; Gregory Joseph,37,0,37,0
1649942787574,CSE 8A,A50,083650,Miranda; Gregory Joseph,8,0,40,32
1649942793610,CSE 11,A01,083080,Cao; Yingjun,0,26,40,40
1649942799640,CSE 12,A01,083652,Staff,56,0,100,44
1649942805665,CSE 15L,A01,083654,Staff,19,0,50,31
1649942805665,CSE 15L,A02,083655,Staff,47,0,50,3
1649942811742,CSE 20,A01,083657,Staff,68,0,80,12
1649942817769,CSE 30,A01,083084,Eldon; John,0,24,40,40
1649942823800,CSE 100,A01,083659,Cao; Yingjun,1,27,50,49
1649942829906,CSE 134B,A01,083661,Powell; Thomas Allan,0,21,65,65
1649942835934,CSE 140,A01,083663,Staff,24,0,75,51
1649942841960,CSE 140L,A01,083088,Eldon; John,18,0,75,57
1649942847986,CSE 175,A01,083665,Kumar; Rakesh,12,0,25,13
1649942854013,CSE 190,A00,092507,Dubnov; Shlomo,14,0,15,1
1649942860045,ECE 45,A01,083139,Staff,6,0,40,34
1649942866090,ECE 65,A50,083695,Staff,7,0,30,23
1649942872117,ECE 109,A01,091882,Touri; Behrouz,55,0,70,15
1649942878145,ECE 180,A00,083140,Abi Samra; Nicholas Camill,26,0,30,4
1649942878145,ECE 180,B00,083141,Abi Samra; Nicholas Camill,13,0,30,17
1649942884171,MATH 10A,A01,083735,Patchell; Gregory David,20,0,30,10
1649942884171,MATH 10A,A02,083736,Patchell; Gregory David,28,0,30,2
1649942884171,MATH 10A,A03,083737,Patchell; Gregory David,28,0,30,2
1649942890197,MATH 10B,A01,083207,Staff,10,0,30,20
1649942890197,MATH 10B,A02,083208,Staff,25,0,30,5
1649942890197,MATH 10B,B01,083739,Staff,25,0,30,5
1649942890197,MATH 10B,B02,083740,Staff,30,0,30,0
1649942896226,MATH 18,A01,083743,Staff,22,0,30,8
1649942896226,MATH 18,A02,083744,Staff,29,0,30,1
1649942896226,MATH 18,A03,083745,Staff,29,0,30,1
1649942896226,MATH 18,A04,083746,Staff,28,0,30,2
1649942896226,MATH 18,B01,083748,Staff,5,0,30,25
1649942896226,MATH 18,B02,083749,Staff,26,0,30,4
1649942896226,MATH 18,B03,083750,Staff,28,0,30,2
1649942896226,MATH 18,B04,083751,Staff,26,0,30,4
1649942902249,MATH 20A,A01,083754,Staff,37,0,40,3
1649942908277,MATH 20B,A01,083756,Staff,19,0,30,11
1649942908277,MATH 20B,A02,083757,Staff,30,0,30,0
1649942914308,MATH 20C,A01,083760,Staff,22,0,30,8
1649942914308,MATH 20C,A02,083761,Staff,23,0,30,7
1649942914308,MATH 20C,B01,083762,Staff,28,0,30,2
1649942914308,MATH 20C,B02,083763,Staff,30,0,30,0
1649942920334,MATH 20D,A01,083765,Staff,20,0,30,10
1649942920334,MATH 20D,A02,083766,Staff,30,0,30,0
1649942920334,MATH 20D,A03,083767,Staff,30,0,30,0
1649942926366,MATH 20E,A01,083771,Staff,12,0,30,18
1649942926366,MATH 20E,A02,083772,Staff,24,0,30,6
1649942926366,MATH 20E,B01,083773,Staff,17,0,30,13
1649942926366,MATH 20E,B02,083774,Staff,29,0,30,1
1649942932399,MATH 103A,A01,083777,Staff,1,4,30,29
1649942932399,MATH 103A,A02,083778,Staff,0,3,30,30
1649942932399,MATH 103A,B01,083779,Staff,0,0,30,30
1649942932399,MATH 103A,B02,083780,Staff,16,0,30,14
1649942938430,MATH 105,A01,085443,Staff,0,5,30,30
1649942944465,MATH 109,A01,083213,Anzaldo; Leesa B,13,0,30,17
1649942944465,MATH 109,A02,083214,Anzaldo; Leesa B,9,0,30,21
1649942944465,MATH 109,B01,083215,Anzaldo; Leesa B,26,0,30,4
1649942944465,MATH 109,B02,083216,Anzaldo; Leesa B,22,0,30,8
1649942950497,MATH 142A,A01,083219,Chow; Bennett,0,1,30,30
1649942950497,MATH 142A,A02,083220,Chow; Bennett,9,0,30,21
1649942950497,MATH 142A,B01,083221,Chow; Bennett,0,0,30,30
1649942950497,MATH 142A,B02,083222,Chow; Bennett,1,0,30,29
1649942956525,MATH 193A,A01,083224,Staff,0,3,30,30
1649942956525,MATH 193A,A02,083225,Staff,0,3,30,30
1649942956525,MATH 193A,A03,083781,Staff,4,0,30,26
1649942956525,MATH 193A,A04,083782,Staff,16,0,30,14
1649942962553,MATH 197,001,091859,McAuley; Julian John,9999,0,9999,0
1649942968621,COGS 9,A01,083615,Staff,16,0,60,44
1649942974645,COGS 11,A01,083617,Boyle; Mary E. T.,35,0,40,5
1649942980674,COGS 13,A01,083071,Staff,0,11,40,40
1649942986703,COGS 14A,A01,092681,Staff,65,0,100,35
1649942992729,COGS 14B,A01,083073,Cheng; Tzu-Han,24,0,50,26
1649942998752,COGS 17,A01,092677,Staff,63,0,75,12
1649943004796,COGS 100,A01,083619,Staff,0,5,60,60
1649943010823,COGS 101A,A01,083621,Davis; Joshua Daniel,0,8,60,60
1649943016853,COGS 101B,A01,091572,Staff,31,0,60,29
1649943022882,COGS 101C,A01,083625,Delgado; Tania,24,0,30,6
1649943028913,COGS 107A,A01,083627,Boyle; Mary E. T.,14,0,60,46
1649943034946,COGS 118A,A01,083075,Staff,21,0,60,39
1649943040978,CSE 3,A50,083646,Miranda; Gregory Joseph,24,0,38,14
1649943040978,CSE 3,A51,083647,Miranda; Gregory Joseph,37,0,37,0
1649943047011,CSE 8A,A50,083650,Miranda; Gregory Joseph,8,0,40,32
1649943053042,CSE 11,A01,083080,Cao; Yingjun,0,26,40,40
1649943059071,CSE 12,A01,083652,Staff,56,0,100,44
1649943065097,CSE 15L,A01,083654,Staff,19,0,50,31
1649943065097,CSE 15L,A02,083655,Staff,47,0,50,3
1649943071123,CSE 20,A01,083657,Staff,68,0,80,12
1649943077150,CSE 30,A01,083084,Eldon; John,0,24,40,40
1649943083180,CSE 100,A01,083659,Cao; Yingjun,1,27,50,49
1649943089205,CSE 134B,A01,083661,Powell; Thomas Allan,0,21,65,65
1649943095231,CSE 140,A01,083663,Staff,24,0,75,51
1649943101262,CSE 140L,A01,083088,Eldon; John,18,0,75,57
1649943107295,CSE 175,A01,083665,Kumar; Rakesh,12,0,25,13
1649943113327,CSE 190,A00,092507,Dubnov; Shlomo,14,0,15,1
1649943119352,ECE 45,A01,083139,Staff,6,0,40,34
1649943125383,ECE 65,A50,083695,Staff,7,0,30,23
1649943131414,ECE 109,A01,091882,Touri; Behrouz,55,0,70,15
1649943137444,ECE 180,A00,083140,Abi Samra; Nicholas Camill,26,0,30,4
1649943137444,ECE 180,B00,083141,Abi Samra; Nicholas Camill,13,0,30,17
1649943143472,MATH 10A,A01,083735,Patchell; Gregory David,20,0,30,10
1649943143472,MATH 10A,A02,083736,Patchell; Gregory David,28,0,30,2
1649943143472,MATH 10A,A03,083737,Patchell; Gregory David,28,0,30,2
1649943149498,MATH 10B,A01,083207,Staff,10,0,30,20
1649943149498,MATH 10B,A02,083208,Staff,25,0,30,5
1649943149498,MATH 10B,B01,083739,Staff,25,0,30,5
1649943149498,MATH 10B,B02,083740,Staff,30,0,30,0
1649943155536,MATH 18,A01,083743,Staff,22,0,30,8
1649943155536,MATH 18,A02,083744,Staff,29,0,30,1
1649943155536,MATH 18,A03,083745,Staff,29,0,30,1
1649943155536,MATH 18,A04,083746,Staff,28,0,30,2
1649943155536,MATH 18,B01,083748,Staff,5,0,30,25
1649943155536,MATH 18,B02,083749,Staff,26,0,30,4
1649943155536,MATH 18,B03,083750,Staff,28,0,30,2
1649943155536,MATH 18,B04,083751,Staff,26,0,30,4
1649943161568,MATH 20A,A01,083754,Staff,37,0,40,3
1649943167600,MATH 20B,A01,083756,Staff,19,0,30,11
1649943167600,MATH 20B,A02,083757,Staff,30,0,30,0
1649943173627,MATH 20C,A01,083760,Staff,22,0,30,8
1649943173627,MATH 20C,A02,083761,Staff,23,0,30,7
1649943173627,MATH 20C,B01,083762,Staff,28,0,30,2
1649943173627,MATH 20C,B02,083763,Staff,30,0,30,0
1649943179652,MATH 20D,A01,083765,Staff,20,0,30,10
1649943179652,MATH 20D,A02,083766,Staff,30,0,30,0
1649943179652,MATH 20D,A03,083767,Staff,30,0,30,0
1649943185684,MATH 20E,A01,083771,Staff,12,0,30,18
1649943185684,MATH 20E,A02,083772,Staff,24,0,30,6
1649943185684,MATH 20E,B01,083773,Staff,17,0,30,13
1649943185684,MATH 20E,B02,083774,Staff,29,0,30,1
1649943191717,MATH 103A,A01,083777,Staff,1,4,30,29
1649943191717,MATH 103A,A02,083778,Staff,0,3,30,30
1649943191717,MATH 103A,B01,083779,Staff,0,0,30,30
1649943191717,MATH 103A,B02,083780,Staff,16,0,30,14
1649943197747,MATH 105,A01,085443,Staff,0,5,30,30
1649943203773,MATH 109,A01,083213,Anzaldo; Leesa B,13,0,30,17
1649943203773,MATH 109,A02,083214,Anzaldo; Leesa B,9,0,30,21
1649943203773,MATH 109,B01,083215,Anzaldo; Leesa B,26,0,30,4
1649943203773,MATH 109,B02,083216,Anzaldo; Leesa B,22,0,30,8
1649943209806,MATH 142A,A01,083219,Chow; Bennett,0,1,30,30
1649943209806,MATH 142A,A02,083220,Chow; Bennett,9,0,30,21
1649943209806,MATH 142A,B01,083221,Chow; Bennett,0,0,30,30
1649943209806,MATH 142A,B02,083222,Chow; Bennett,1,0,30,29
1649943215836,MATH 193A,A01,083224,Staff,0,3,30,30
1649943215836,MATH 193A,A02,083225,Staff,0,3,30,30
1649943215836,MATH 193A,A03,083781,Staff,4,0,30,26
1649943215836,MATH 193A,A04,083782,Staff,16,0,30,14
1649943221861,MATH 197,001,091859,McAuley; Julian John,9999,0,9999,0
1649943227942,COGS 9,A01,083615,Staff,16,0,60,44
1649943233973,COGS 11,A01,083617,Boyle; Mary E. T.,35,0,40,5
1649943240007,COGS 13,A01,083071,Staff,0,11,40,40
1649943246040,COGS 14A,A01,092681,Staff,65,0,100,35
1649943252063,COGS 14B,A01,083073,Cheng; Tzu-Han,24,0,50,26
1649943258086,COGS 17,A01,092677,Staff,63,0,75,12
1649943264112,COGS 100,A01,083619,Staff,0,5,60,60
1649943270136,COGS 101A,A01,083621,Davis; Joshua Daniel,0,8,60,60
1649943276166,COGS 101B,A01,091572,Staff,31,0,60,29
1649943282191,COGS 101C,A01,083625,Delgado; Tania,24,0,30,6
1649943288219,COGS 107A,A01,083627,Boyle; Mary E. T.,14,0,60,46
1649943294243,COGS 118A,A01,083075,Staff,21,0,60,39
1649943300269,CSE 3,A50,083646,Miranda; Gregory Joseph,24,0,38,14
1649943300269,CSE 3,A51,083647,Miranda; Gregory Joseph,37,0,37,0
1649943306298,CSE 8A,A50,083650,Miranda; Gregory Joseph,8,0,40,32
1649943312324,CSE 11,A01,083080,Cao; Yingjun,0,26,40,40
1649943318368,CSE 12,A01,083652,Staff,56,0,100,44
1649943324397,CSE 15L,A01,083654,Staff,19,0,50,31
1649943324397,CSE 15L,A02,083655,Staff,47,0,50,3
1649943330426,CSE 20,A01,083657,Staff,68,0,80,12
1649943336453,CSE 30,A01,083084,Eldon; John,0,24,40,40
1649943342488,CSE 100,A01,083659,Cao; Yingjun,1,27,50,49
1649943348514,CSE 134B,A01,083661,Powell; Thomas Allan,0,21,65,65
1649943354539,CSE 140,A01,083663,Staff,24,0,75,51
1649943360570,CSE 140L,A01,083088,Eldon; John,18,0,75,57
1649943366598,CSE 175,A01,083665,Kumar; Rakesh,12,0,25,13
1649943372630,CSE 190,A00,092507,Dubnov; Shlomo,14,0,15,1
1649943378660,ECE 45,A01,083139,Staff,6,0,40,34
1649943384686,ECE 65,A50,083695,Staff,7,0,30,23
1649943390710,ECE 109,A01,091882,Touri; Behrouz,55,0,70,15
1649943396742,ECE 180,A00,083140,Abi Samra; Nicholas Camill,26,0,30,4
1649943396742,ECE 180,B00,083141,Abi Samra; Nicholas Camill,13,0,30,17
1649943402770,MATH 10A,A01,083735,Patchell; Gregory David,20,0,30,10
1649943402770,MATH 10A,A02,083736,Patchell; Gregory David,28,0,30,2
1649943402770,MATH 10A,A03,083737,Patchell; Gregory David,28,0,30,2
1649943408801,MATH 10B,A01,083207,Staff,10,0,30,20
1649943408801,MATH 10B,A02,083208,Staff,25,0,30,5
1649943408801,MATH 10B,B01,083739,Staff,25,0,30,5
1649943408801,MATH 10B,B02,083740,Staff,30,0,30,0
1649943414834,MATH 18,A01,083743,Staff,22,0,30,8
1649943414834,MATH 18,A02,083744,Staff,29,0,30,1
1649943414834,MATH 18,A03,083745,Staff,29,0,30,1
1649943414834,MATH 18,A04,083746,Staff,28,0,30,2
1649943414834,MATH 18,B01,083748,Staff,5,0,30,25
1649943414834,MATH 18,B02,083749,Staff,26,0,30,4
1649943414834,MATH 18,B03,083750,Staff,28,0,30,2
1649943414834,MATH 18,B04,083751,Staff,26,0,30,4
1649943420859,MATH 20A,A01,083754,Staff,37,0,40,3
1649943426991,MATH 20B,A01,083756,Staff,19,0,30,11
1649943426991,MATH 20B,A02,083757,Staff,30,0,30,0
1649943433022,MATH 20C,A01,083760,Staff,22,0,30,8
1649943433022,MATH 20C,A02,083761,Staff,23,0,30,7
1649943433022,MATH 20C,B01,083762,Staff,28,0,30,2
1649943433022,MATH 20C,B02,083763,Staff,30,0,30,0
1649943439049,MATH 20D,A01,083765,Staff,20,0,30,10
1649943439049,MATH 20D,A02,083766,Staff,30,0,30,0
1649943439049,MATH 20D,A03,083767,Staff,30,0,30,0
1649943445075,MATH 20E,A01,083771,Staff,12,0,30,18
1649943445075,MATH 20E,A02,083772,Staff,24,0,30,6
1649943445075,MATH 20E,B01,083773,Staff,17,0,30,13
1649943445075,MATH 20E,B02,083774,Staff,29,0,30,1
1649943451103,MATH 103A,A01,083777,Staff,1,4,30,29
1649943451103,MATH 103A,A02,083778,Staff,0,3,30,30
1649943451103,MATH 103A,B01,083779,Staff,0,0,30,30
1649943451103,MATH 103A,B02,083780,Staff,16,0,30,14
1649943457133,MATH 105,A01,085443,Staff,0,5,30,30
1649943463163,MATH 109,A01,083213,Anzaldo; Leesa B,13,0,30,17
1649943463163,MATH 109,A02,083214,Anzaldo; Leesa B,9,0,30,21
1649943463163,MATH 109,B01,083215,Anzaldo; Leesa B,26,0,30,4
1649943463163,MATH 109,B02,083216,Anzaldo; Leesa B,22,0,30,8
1649943469186,MATH 142A,A01,083219,Chow; Bennett,0,1,30,30
1649943469186,MATH 142A,A02,083220,Chow; Bennett,9,0,30,21
1649943469186,MATH 142A,B01,083221,Chow; Bennett,0,0,30,30
1649943469186,MATH 142A,B02,083222,Chow; Bennett,1,0,30,29
1649943475215,MATH 193A,A01,083224,Staff,0,3,30,30
1649943475215,MATH 193A,A02,083225,Staff,0,3,30,30
1649943475215,MATH 193A,A03,083781,Staff,4,0,30,26
1649943475215,MATH 193A,A04,083782,Staff,16,0,30,14
1649943481239,MATH 197,001,091859,McAuley; Julian John,9999,0,9999,0
1649943487299,COGS 9,A01,083615,Staff,16,0,60,44
1649943493327,COGS 11,A01,083617,Boyle; Mary E. T.,35,0,40,5
1649943499358,COGS 13,A01,083071,Staff,0,11,40,40
1649943505398,COGS 14A,A01,092681,Staff,65,0,100,35
1649943511423,COGS 14B,A01,083073,Cheng; Tzu-Han,24,0,50,26
1649943517454,COGS 17,A01,092677,Staff,63,0,75,12
1649943523482,COGS 100,A01,083619,Staff,0,5,60,60
1649943529512,COGS 101A,A01,083621,Davis; Joshua Daniel,0,8,60,60
1649943535538,COGS 101B,A01,091572,Staff,31,0,60,29
1649943541565,COGS 101C,A01,083625,Delgado; Tania,24,0,30,6
1649943547610,COGS 107A,A01,083627,Boyle; Mary E. T.,14,0,60,46
1649943553637,COGS 118A,A01,083075,Staff,21,0,60,39
1649943559670,CSE 3,A50,083646,Miranda; Gregory Joseph,24,0,38,14
1649943559670,CSE 3,A51,083647,Miranda; Gregory Joseph,37,0,37,0
1649943565695,CSE 8A,A50,083650,Miranda; Gregory Joseph,8,0,40,32
1649943571724,CSE 11,A01,083080,Cao; Yingjun,0,26,40,40
1649943577749,CSE 12,A01,083652,Staff,56,0,100,44
1649943583775,CSE 15L,A01,083654,Staff,19,0,50,31
1649943583775,CSE 15L,A02,083655,Staff,47,0,50,3
1649943589800,CSE 20,A01,083657,Staff,68,0,80,12
1649943595825,CSE 30,A01,083084,Eldon; John,0,24,40,40
1649943601854,CSE 100,A01,083659,Cao; Yingjun,1,27,50,49
1649943607884,CSE 134B,A01,083661,Powell; Thomas Allan,0,21,65,65
1649943613909,CSE 140,A01,083663,Staff,24,0,75,51
1649943619934,CSE 140L,A01,083088,Eldon; John,18,0,75,57
1649943625961,CSE 175,A01,083665,Kumar; Rakesh,12,0,25,13
1649943631990,CSE 190,A00,092507,Dubnov; Shlomo,14,0,15,1
1649943638018,ECE 45,A01,083139,Staff,6,0,40,34
1649943644046,ECE 65,A50,083695,Staff,7,0,30,23
1649943650083,ECE 109,A01,091882,Touri; Behrouz,55,0,70,15
1649943656113,ECE 180,A00,083140,Abi Samra; Nicholas Camill,26,0,30,4
1649943656113,ECE 180,B00,083141,Abi Samra; Nicholas Camill,13,0,30,17
1649943662137,MATH 10A,A01,083735,Patchell; Gregory David,20,0,30,10
1649943662137,MATH 10A,A02,083736,Patchell; Gregory David,28,0,30,2
1649943662137,MATH 10A,A03,083737,Patchell; Gregory David,28,0,30,2
1649943668172,MATH 10B,A01,083207,Staff,10,0,30,20
1649943668172,MATH 10B,A02,083208,Staff,25,0,30,5
1649943668172,MATH 10B,B01,083739,Staff,25,0,30,5
1649943668172,MATH 10B,B02,083740,Staff,30,0,30,0
1649943674196,MATH 18,A01,083743,Staff,22,0,30,8
1649943674196,MATH 18,A02,083744,Staff,29,0,30,1
1649943674196,MATH 18,A03,083745,Staff,29,0,30,1
1649943674196,MATH 18,A04,083746,Staff,28,0,30,2
1649943674196,MATH 18,B01,083748,Staff,5,0,30,25
1649943674196,MATH 18,B02,083749,Staff,26,0,30,4
1649943674196,MATH 18,B03,083750,Staff,28,0,30,2
1649943674196,MATH 18,B04,083751,Staff,26,0,30,4
1649943680223,MATH 20A,A01,083754,Staff,37,0,40,3
1649943686251,MATH 20B,A01,083756,Staff,19,0,30,11
1649943686251,MATH 20B,A02,083757,Staff,30,0,30,0
1649943692277,MATH 20C,A01,083760,Staff,22,0,30,8
1649943692277,MATH 20C,A02,083761,Staff,23,0,30,7
1649943692277,MATH 20C,B01,083762,Staff,28,0,30,2
1649943692277,MATH 20C,B02,083763,Staff,30,0,30,0
1649943698306,MATH 20D,A01,083765,Staff,20,0,30,10
1649943698306,MATH 20D,A02,083766,Staff,30,0,30,0
1649943698306,MATH 20D,A03,083767,Staff,30,0,30,0
1649943704330,MATH 20E,A01,083771,Staff,12,0,30,18
1649943704330,MATH 20E,A02,083772,Staff,24,0,30,6
1649943704330,MATH 20E,B01,083773,Staff,17,0,30,13
1649943704330,MATH 20E,B02,083774,Staff,29,0,30,1
1649943710361,MATH 103A,A01,083777,Staff,1,4,30,29
1649943710361,MATH 103A,A02,083778,Staff,0,3,30,30
1649943710361,MATH 103A,B01,083779,Staff,0,0,30,30
1649943710361,MATH 103A,B02,083780,Staff,16,0,30,14
1649943716390,MATH 105,A01,085443,Staff,0,5,30,30
1649943722414,MATH 109,A01,083213,Anzaldo; Leesa B,13,0,30,17
1649943722414,MATH 109,A02,083214,Anzaldo; Leesa B,9,0,30,21
1649943722414,MATH 109,B01,083215,Anzaldo; Leesa B,26,0,30,4
1649943722414,MATH 109,B02,083216,Anzaldo; Leesa B,22,0,30,8
1649943728438,MATH 142A,A01,083219,Chow; Bennett,0,1,30,30
1649943728438,MATH 142A,A02,083220,Chow; Bennett,9,0,30,21
1649943728438,MATH 142A,B01,083221,Chow; Bennett,0,0,30,30
1649943728438,MATH 142A,B02,083222,Chow; Bennett,1,0,30,29
1649943734467,MATH 193A,A01,083224,Staff,0,3,30,30
1649943734467,MATH 193A,A02,083225,Staff,0,3,30,30
1649943734467,MATH 193A,A03,083781,Staff,4,0,30,26
1649943734467,MATH 193A,A04,083782,Staff,16,0,30,14
1649943740490,MATH 197,001,091859,McAuley; Julian John,9999,0,9999,0
1649943746548,COGS 9,A01,083615,Staff,16,0,60,44
1649943752573,COGS 11,A01,083617,Boyle; Mary E. T.,35,0,40,5
1649943758598,COGS 13,A01,083071,Staff,0,11,40,40
1649943764626,COGS 14A,A01,092681,Staff,65,0,100,35
1649943770651,COGS 14B,A01,083073,Cheng; Tzu-Han,24,0,50,26
1649943776674,COGS 17,A01,092677,Staff,63,0,75,12
1649943782703,COGS 100,A01,083619,Staff,0,5,60,60
1649943788730,COGS 101A,A01,083621,Davis; Joshua Daniel,0,8,60,60
1649943794760,COGS 101B,A01,091572,Staff,31,0,60,29
1649943800788,COGS 101C,A01,083625,Delgado; Tania,24,0,30,6
1649943806814,COGS 107A,A01,083627,Boyle; Mary E. T.,14,0,60,46
1649943812841,COGS 118A,A01,083075,Staff,21,0,60,39
1649943818873,CSE 3,A50,083646,Miranda; Gregory Joseph,24,0,38,14
1649943818873,CSE 3,A51,083647,Miranda; Gregory Joseph,37,0,37,0
1649943824899,CSE 8A,A50,083650,Miranda; Gregory Joseph,8,0,40,32
1649943830924,CSE 11,A01,083080,Cao; Yingjun,0,26,40,40
1649943836949,CSE 12,A01,083652,Staff,56,0,100,44
1649943842973,CSE 15L,A01,083654,Staff,19,0,50,31
1649943842973,CSE 15L,A02,083655,Staff,47,0,50,3
1649943849001,CSE 20,A01,083657,Staff,68,0,80,12
1649943855029,CSE 30,A01,083084,Eldon; John,0,24,40,40
1649943861055,CSE 100,A01,083659,Cao; Yingjun,1,27,50,49
1649943867080,CSE 134B,A01,083661,Powell; Thomas Allan,0,21,65,65
1649943873108,CSE 140,A01,083663,Staff,24,0,75,51
1649943879139,CSE 140L,A01,083088,Eldon; John,18,0,75,57
1649943885162,CSE 175,A01,083665,Kumar; Rakesh,12,0,25,13
1649943891189,CSE 190,A00,092507,Dubnov; Shlomo,14,0,15,1
1649943897216,ECE 45,A01,083139,Staff,6,0,40,34
1649943903241,ECE 65,A50,083695,Staff,7,0,30,23
1649943909266,ECE 109,A01,091882,Touri; Behrouz,55,0,70,15
1649943915291,ECE 180,A00,083140,Abi Samra; Nicholas Camill,26,0,30,4
1649943915291,ECE 180,B00,083141,Abi Samra; Nicholas Camill,13,0,30,17
1649943921321,MATH 10A,A01,083735,Patchell; Gregory David,20,0,30,10
1649943921321,MATH 10A,A02,083736,Patchell; Gregory David,28,0,30,2
1649943921321,MATH 10A,A03,083737,Patchell; Gregory David,28,0,30,2
1649943927348,MATH 10B,A01,083207,Staff,10,0,30,20
1649943927348,MATH 10B,A02,083208,Staff,25,0,30,5
1649943927348,MATH 10B,B01,083739,Staff,25,0,30,5
1649943927348,MATH 10B,B02,083740,Staff,30,0,30,0
1649943933393,MATH 18,A01,083743,Staff,22,0,30,8
1649943933393,MATH 18,A02,083744,Staff,29,0,30,1
1649943933393,MATH 18,A03,083745,Staff,29,0,30,1
1649943933393,MATH 18,A04,083746,Staff,28,0,30,2
1649943933393,MATH 18,B01,083748,Staff,5,0,30,25
1649943933393,MATH 18,B02,083749,Staff,26,0,30,4
1649943933393,MATH 18,B03,083750,Staff,28,0,30,2
1649943933393,MATH 18,B04,083751,Staff,26,0,30,4
1649943939419,MATH 20A,A01,083754,Staff,37,0,40,3
1649943945443,MATH 20B,A01,083756,Staff,19,0,30,11
1649943945443,MATH 20B,A02,083757,Staff,30,0,30,0
1649943951471,MATH 20C,A01,083760,Staff,22,0,30,8
1649943951471,MATH 20C,A02,083761,Staff,23,0,30,7
1649943951471,MATH 20C,B01,083762,Staff,28,0,30,2
1649943951471,MATH 20C,B02,083763,Staff,30,0,30,0
1649943957496,MATH 20D,A01,083765,Staff,20,0,30,10
1649943957496,MATH 20D,A02,083766,Staff,30,0,30,0
1649943957496,MATH 20D,A03,083767,Staff,30,0,30,0
1649943963536,MATH 20E,A01,083771,Staff,12,0,30,18
1649943963536,MATH 20E,A02,083772,Staff,24,0,30,6
1649943963536,MATH 20E,B01,083773,Staff,17,0,30,13
1649943963536,MATH 20E,B02,083774,Staff,29,0,30,1
1649943969568,MATH 103A,A01,083777,Staff,1,4,30,29
1649943969568,MATH 103A,A02,083778,Staff,0,3,30,30
1649943969568,MATH 103A,B01,083779,Staff,0,0,30,30
1649943969568,MATH 103A,B02,083780,Staff,16,0,30,14
1649943975596,MATH 105,A01,085443,Staff,0,5,30,30
1649943981621,MATH 109,A01,083213,Anzaldo; Leesa B,13,0,30,17
1649943981621,MATH 109,A02,083214,Anzaldo; Leesa B,9,0,30,21
1649943981621,MATH 109,B01,083215,Anzaldo; Leesa B,26,0,30,4
1649943981621,MATH 109,B02,083216,Anzaldo; Leesa B,22,0,30,8
1649943987647,MATH 142A,A01,083219,Chow; Bennett,0,1,30,30
1649943987647,MATH 142A,A02,083220,Chow; Bennett,9,0,30,21
1649943987647,MATH 142A,B01,083221,Chow; Bennett,0,0,30,30
1649943987647,MATH 142A,B02,083222,Chow; Bennett,1,0,30,29
1649943993669,MATH 193A,A01,083224,Staff,0,3,30,30
1649943993669,MATH 193A,A02,083225,Staff,0,3,30,30
1649943993669,MATH 193A,A03,083781,Staff,4,0,30,26
1649943993669,MATH 193A,A04,083782,Staff,16,0,30,14
1649943999694,MATH 197,001,091859,McAuley; Julian John,9999,0,9999,0
1649944005768,COGS 9,A01,083615,Staff,16,0,60,44
1649944011792,COGS 11,A01,083617,Boyle; Mary E. T.,35,0,40,5
1649944017901,COGS 13,A01,083071,Staff,0,11,40,40
1649944023928,COGS 14A,A01,092681,Staff,65,0,100,35
1649944029953,COGS 14B,A01,083073,Cheng; Tzu-Han,24,0,50,26
1649944035979,COGS 17,A01,092677,Staff,63,0,75,12
1649944042003,COGS 100,A01,083619,Staff,0,5,60,60
1649944048041,COGS 101A,A01,083621,Davis; Joshua Daniel,0,8,60,60
1649944054067,COGS 101B,A01,091572,Staff,31,0,60,29
1649944060092,COGS 101C,A01,083625,Delgado; Tania,24,0,30,6
1649944066117,COGS 107A,A01,083627,Boyle; Mary E. T.,14,0,60,46
1649944072142,COGS 118A,A01,083075,Staff,21,0,60,39
1649944078173,CSE 3,A50,083646,Miranda; Gregory Joseph,24,0,38,14
1649944078173,CSE 3,A51,083647,Miranda; Gregory Joseph,37,0,37,0
1649944084205,CSE 8A,A50,083650,Miranda; Gregory Joseph,8,0,40,32
1649944090228,CSE 11,A01,083080,Cao; Yingjun,0,26,40,40
1649944096256,CSE 12,A01,083652,Staff,56,0,100,44
1649944102279,CSE 15L,A01,083654,Staff,19,0,50,31
1649944102279,CSE 15L,A02,083655,Staff,47,0,50,3
1649944108303,CSE 20,A01,083657,Staff,68,0,80,12
1649944114327,CSE 30,A01,083084,Eldon; John,0,24,40,40
1649944120355,CSE 100,A01,083659,Cao; Yingjun,1,27,50,49
1649944126379,CSE 134B,A01,083661,Powell; Thomas Allan,0,21,65,65
1649944132409,CSE 140,A01,083663,Staff,24,0,75,51
1649944138433,CSE 140L,A01,083088,Eldon; John,18,0,75,57
1649944144465,CSE 175,A01,083665,Kumar; Rakesh,12,0,25,13
1649944150489,CSE 190,A00,092507,Dubnov; Shlomo,14,0,15,1
1649944156516,ECE 45,A01,083139,Staff,6,0,40,34
1649944162543,ECE 65,A50,083695,Staff,7,0,30,23
1649944168572,ECE 109,A01,091882,Touri; Behrouz,55,0,70,15
1649944174598,ECE 180,A00,083140,Abi Samra; Nicholas Camill,26,0,30,4
1649944174598,ECE 180,B00,083141,Abi Samra; Nicholas Camill,13,0,30,17
1649944180626,MATH 10A,A01,083735,Patchell; Gregory David,20,0,30,10
1649944180626,MATH 10A,A02,083736,Patchell; Gregory David,28,0,30,2
1649944180626,MATH 10A,A03,083737,Patchell; Gregory David,28,0,30,2
1649944186650,MATH 10B,A01,083207,Staff,10,0,30,20
1649944186650,MATH 10B,A02,083208,Staff,25,0,30,5
1649944186650,MATH 10B,B01,083739,Staff,25,0,30,5
1649944186650,MATH 10B,B02,083740,Staff,30,0,30,0
1649944192679,MATH 18,A01,083743,Staff,22,0,30,8
1649944192679,MATH 18,A02,083744,Staff,29,0,30,1
1649944192679,MATH 18,A03,083745,Staff,29,0,30,1
1649944192679,MATH 18,A04,083746,Staff,28,0,30,2
1649944192679,MATH 18,B01,083748,Staff,5,0,30,25
1649944192679,MATH 18,B02,083749,Staff,26,0,30,4
1649944192679,MATH 18,B03,083750,Staff,28,0,30,2
1649944192679,MATH 18,B04,083751,Staff,26,0,30,4
1649944198705,MATH 20A,A01,083754,Staff,37,0,40,3
1649944204734,MATH 20B,A01,083756,Staff,19,0,30,11
1649944204734,MATH 20B,A02,083757,Staff,30,0,30,0
1649944210757,MATH 20C,A01,083760,Staff,22,0,30,8
1649944210757,MATH 20C,A02,083761,Staff,23,0,30,7
1649944210757,MATH 20C,B01,083762,Staff,28,0,30,2
1649944210757,MATH 20C,B02,083763,Staff,30,0,30,0
1649944216784,MATH 20D,A01,083765,Staff,20,0,30,10
1649944216784,MATH 20D,A02,083766,Staff,30,0,30,0
1649944216784,MATH 20D,A03,083767,Staff,30,0,30,0
1649944222809,MATH 20E,A01,083771,Staff,12,0,30,18
1649944222809,MATH 20E,A02,083772,Staff,24,0,30,6
1649944222809,MATH 20E,B01,083773,Staff,17,0,30,13
1649944222809,MATH 20E,B02,083774,Staff,29,0,30,1
1649944228839,MATH 103A,A01,083777,Staff,1,4,30,29
1649944228839,MATH 103A,A02,083778,Staff,0,3,30,30
1649944228839,MATH 103A,B01,083779,Staff,0,0,30,30
1649944228839,MATH 103A,B02,083780,Staff,16,0,30,14
1649944234864,MATH 105,A01,085443,Staff,0,5,30,30
1649944240890,MATH 109,A01,083213,Anzaldo; Leesa B,13,0,30,17
1649944240890,MATH 109,A02,083214,Anzaldo; Leesa B,9,0,30,21
1649944240890,MATH 109,B01,083215,Anzaldo; Leesa B,26,0,30,4
1649944240890,MATH 109,B02,083216,Anzaldo; Leesa B,22,0,30,8
1649944246918,MATH 142A,A01,083219,Chow; Bennett,0,1,30,30
1649944246918,MATH 142A,A02,083220,Chow; Bennett,9,0,30,21
1649944246918,MATH 142A,B01,083221,Chow; Bennett,0,0,30,30
1649944246918,MATH 142A,B02,083222,Chow; Bennett,1,0,30,29
1649944252947,MATH 193A,A01,083224,Staff,0,3,30,30
1649944252947,MATH 193A,A02,083225,Staff,0,3,30,30
1649944252947,MATH 193A,A03,083781,Staff,4,0,30,26
1649944252947,MATH 193A,A04,083782,Staff,16,0,30,14
1649944258971,MATH 197,001,091859,McAuley; Julian John,9999,0,9999,0
1649944265026,COGS 9,A01,083615,Staff,16,0,60,44
1649944271049,COGS 11,A01,083617,Boyle; Mary E. T.,35,0,40,5
1649944277076,COGS 13,A01,083071,Staff,0,11,40,40
1649944283100,COGS 14A,A01,092681,Staff,65,0,100,35
1649944289124,COGS 14B,A01,083073,Cheng; Tzu-Han,24,0,50,26
1649944295158,COGS 17,A01,092677,Staff,63,0,75,12
1649944301191,COGS 100,A01,083619,Staff,0,5,60,60
1649944307217,COGS 101A,A01,083621,Davis; Joshua Daniel,0,8,60,60
1649944313244,COGS 101B,A01,091572,Staff,31,0,60,29
1649944319269,COGS 101C,A01,083625,Delgado; Tania,24,0,30,6
1649944325303,COGS 107A,A01,083627,Boyle; Mary E. T.,14,0,60,46
1649944331336,COGS 118A,A01,083075,Staff,21,0,60,39
1649944337361,CSE 3,A50,083646,Miranda; Gregory Joseph,24,0,38,14
1649944337361,CSE 3,A51,083647,Miranda; Gregory Joseph,37,0,37,0
1649944343398,CSE 8A,A50,083650,Miranda; Gregory Joseph,8,0,40,32
1649944349426,CSE 11,A01,083080,Cao; Yingjun,0,26,40,40
1649944355455,CSE 12,A01,083652,Staff,56,0,100,44
1649944361484,CSE 15L,A01,083654,Staff,19,0,50,31
1649944361484,CSE 15L,A02,083655,Staff,47,0,50,3
1649944367512,CSE 20,A01,083657,Staff,68,0,80,12
1649944373536,CSE 30,A01,083084,Eldon; John,0,24,40,40
1649944379560,CSE 100,A01,083659,Cao; Yingjun,1,27,50,49
1649944385584,CSE 134B,A01,083661,Powell; Thomas Allan,0,21,65,65
1649944391607,CSE 140,A01,083663,Staff,24,0,75,51
1649944397638,CSE 140L,A01,083088,Eldon; John,18,0,75,57
1649944403665,CSE 175,A01,083665,Kumar; Rakesh,12,0,25,13
1649944409688,CSE 190,A00,092507,Dubnov; Shlomo,14,0,15,1
1649944415714,ECE 45,A01,083139,Staff,6,0,40,34
1649944421743,ECE 65,A50,083695,Staff,7,0,30,23
1649944427771,ECE 109,A01,091882,Touri; Behrouz,55,0,70,15
1649944433802,ECE 180,A00,083140,Abi Samra; Nicholas Camill,26,0,30,4
1649944433802,ECE 180,B00,083141,Abi Samra; Nicholas Camill,13,0,30,17
1649944439834,MATH 10A,A01,083735,Patchell; Gregory David,20,0,30,10
1649944439834,MATH 10A,A02,083736,Patchell; Gregory David,28,0,30,2
1649944439834,MATH 10A,A03,083737,Patchell; Gregory David,28,0,30,2
1649944445867,MATH 10B,A01,083207,Staff,10,0,30,20
1649944445867,MATH 10B,A02,083208,Staff,25,0,30,5
1649944445867,MATH 10B,B01,083739,Staff,25,0,30,5
1649944445867,MATH 10B,B02,083740,Staff,30,0,30,0
1649944451898,MATH 18,A01,083743,Staff,22,0,30,8
1649944451898,MATH 18,A02,083744,Staff,29,0,30,1
1649944451898,MATH 18,A03,083745,Staff,29,0,30,1
1649944451898,MATH 18,A04,083746,Staff,28,0,30,2
1649944451898,MATH 18,B01,083748,Staff,5,0,30,25
1649944451898,MATH 18,B02,083749,Staff,26,0,30,4
1649944451898,MATH 18,B03,083750,Staff,28,0,30,2
1649944451898,MATH 18,B04,083751,Staff,26,0,30,4
1649944457938,MATH 20A,A01,083754,Staff,37,0,40,3
1649944463963,MATH 20B,A01,083756,Staff,19,0,30,11
1649944463963,MATH 20B,A02,083757,Staff,30,0,30,0
1649944469995,MATH 20C,A01,083760,Staff,22,0,30,8
1649944469995,MATH 20C,A02,083761,Staff,23,0,30,7
1649944469995,MATH 20C,B01,083762,Staff,28,0,30,2
1649944469995,MATH 20C,B02,083763,Staff,30,0,30,0
1649944476020,MATH 20D,A01,083765,Staff,20,0,30,10
1649944476020,MATH 20D,A02,083766,Staff,30,0,30,0
1649944476020,MATH 20D,A03,083767,Staff,30,0,30,0
1649944482048,MATH 20E,A01,083771,Staff,12,0,30,18
1649944482048,MATH 20E,A02,083772,Staff,24,0,30,6
1649944482048,MATH 20E,B01,083773,Staff,17,0,30,13
1649944482048,MATH 20E,B02,083774,Staff,29,0,30,1
1649944488077,MATH 103A,A01,083777,Staff,1,4,30,29
1649944488077,MATH 103A,A02,083778,Staff,0,3,30,30
1649944488077,MATH 103A,B01,083779,Staff,0,0,30,30
1649944488077,MATH 103A,B02,083780,Staff,16,0,30,14
1649944494105,MATH 105,A01,085443,Staff,0,5,30,30
1649944500130,MATH 109,A01,083213,Anzaldo; Leesa B,13,0,30,17
1649944500130,MATH 109,A02,083214,Anzaldo; Leesa B,9,0,30,21
1649944500130,MATH 109,B01,083215,Anzaldo; Leesa B,26,0,30,4
1649944500130,MATH 109,B02,083216,Anzaldo; Leesa B,22,0,30,8
1649944506159,MATH 142A,A01,083219,Chow; Bennett,0,1,30,30
1649944506159,MATH 142A,A02,083220,Chow; Bennett,9,0,30,21
1649944506159,MATH 142A,B01,083221,Chow; Bennett,0,0,30,30
1649944506159,MATH 142A,B02,083222,Chow; Bennett,1,0,30,29
1649944512187,MATH 193A,A01,083224,Staff,0,3,30,30
1649944512187,MATH 193A,A02,083225,Staff,0,3,30,30
1649944512187,MATH 193A,A03,083781,Staff,4,0,30,26
1649944512187,MATH 193A,A04,083782,Staff,16,0,30,14
1649944518213,MATH 197,001,091859,McAuley; Julian John,9999,0,9999,0
1649944524270,COGS 9,A01,083615,Staff,16,0,60,44
1649944530299,COGS 11,A01,083617,Boyle; Mary E. T.,35,0,40,5
1649944536324,COGS 13,A01,083071,Staff,0,11,40,40
1649944542350,COGS 14A,A01,092681,Staff,65,0,100,35
1649944548378,COGS 14B,A01,083073,Cheng; Tzu-Han,24,0,50,26
1649944554401,COGS 17,A01,092677,Staff,63,0,75,12
1649944560430,COGS 100,A01,083619,Staff,0,5,60,60
1649944566455,COGS 101A,A01,083621,Davis; Joshua Daniel,0,8,60,60
1649944572479,COGS 101B,A01,091572,Staff,31,0,60,29
1649944578502,COGS 101C,A01,083625,Delgado; Tania,24,0,30,6
1649944584528,COGS 107A,A01,083627,Boyle; Mary E. T.,14,0,60,46
1649944590560,COGS 118A,A01,083075,Staff,21,0,60,39
1649944596585,CSE 3,A50,083646,Miranda; Gregory Joseph,24,0,38,14
1649944596585,CSE 3,A51,083647,Miranda; Gregory Joseph,37,0,37,0
1649944602609,CSE 8A,A50,083650,Miranda; Gregory Joseph,8,0,40,32
1649944608637,CSE 11,A01,083080,Cao; Yingjun,0,26,40,40
1649944614760,CSE 12,A01,083652,Staff,56,0,100,44
1649944620785,CSE 15L,A01,083654,Staff,19,0,50,31
1649944620785,CSE 15L,A02,083655,Staff,47,0,50,3
1649944626819,CSE 20,A01,083657,Staff,68,0,80,12
1649944632847,CSE 30,A01,083084,Eldon; John,0,24,40,40
1649944638872,CSE 100,A01,083659,Cao; Yingjun,1,27,50,49
1649944644897,CSE 134B,A01,083661,Powell; Thomas Allan,0,21,65,65
1649944650923,CSE 140,A01,083663,Staff,24,0,75,51
1649944656951,CSE 140L,A01,083088,Eldon; John,18,0,75,57
1649944662977,CSE 175,A01,083665,Kumar; Rakesh,12,0,25,13
1649944669008,CSE 190,A00,092507,Dubnov; Shlomo,14,0,15,1
1649944675035,ECE 45,A01,083139,Staff,6,0,40,34
1649944681063,ECE 65,A50,083695,Staff,7,0,30,23
1649944687087,ECE 109,A01,091882,Touri; Behrouz,55,0,70,15
1649944693112,ECE 180,A00,083140,Abi Samra; Nicholas Camill,26,0,30,4
1649944693112,ECE 180,B00,083141,Abi Samra; Nicholas Camill,13,0,30,17
1649944699144,MATH 10A,A01,083735,Patchell; Gregory David,20,0,30,10
1649944699144,MATH 10A,A02,083736,Patchell; Gregory David,28,0,30,2
1649944699144,MATH 10A,A03,083737,Patchell; Gregory David,28,0,30,2
1649944705179,MATH 10B,A01,083207,Staff,10,0,30,20
1649944705179,MATH 10B,A02,083208,Staff,25,0,30,5
1649944705179,MATH 10B,B01,083739,Staff,25,0,30,5
1649944705179,MATH 10B,B02,083740,Staff,30,0,30,0
1649944711221,MATH 18,A01,083743,Staff,22,0,30,8
1649944711221,MATH 18,A02,083744,Staff,29,0,30,1
1649944711221,MATH 18,A03,083745,Staff,29,0,30,1
1649944711221,MATH 18,A04,083746,Staff,28,0,30,2
1649944711221,MATH 18,B01,083748,Staff,5,0,30,25
1649944711221,MATH 18,B02,083749,Staff,26,0,30,4
1649944711221,MATH 18,B03,083750,Staff,28,0,30,2
1649944711221,MATH 18,B04,083751,Staff,26,0,30,4
1649944717249,MATH 20A,A01,083754,Staff,37,0,40,3
1649944723276,MATH 20B,A01,083756,Staff,19,0,30,11
1649944723276,MATH 20B,A02,083757,Staff,30,0,30,0
1649944729308,MATH 20C,A01,083760,Staff,22,0,30,8
1649944729308,MATH 20C,A02,083761,Staff,23,0,30,7
1649944729308,MATH 20C,B01,083762,Staff,28,0,30,2
1649944729308,MATH 20C,B02,083763,Staff,30,0,30,0
1649944735333,MATH 20D,A01,083765,Staff,20,0,30,10
1649944735333,MATH 20D,A02,083766,Staff,30,0,30,0
1649944735333,MATH 20D,A03,083767,Staff,30,0,30,0
1649944741368,MATH 20E,A01,083771,Staff,12,0,30,18
1649944741368,MATH 20E,A02,083772,Staff,24,0,30,6
1649944741368,MATH 20E,B01,083773,Staff,17,0,30,13
1649944741368,MATH 20E,B02,083774,Staff,29,0,30,1
1649944747399,MATH 103A,A01,083777,Staff,1,4,30,29
1649944747399,MATH 103A,A02,083778,Staff,0,3,30,30
1649944747399,MATH 103A,B01,083779,Staff,0,0,30,30
1649944747399,MATH 103A,B02,083780,Staff,16,0,30,14
1649944753424,MATH 105,A01,085443,Staff,0,5,30,30
1649944759452,MATH 109,A01,083213,Anzaldo; Leesa B,13,0,30,17
1649944759452,MATH 109,A02,083214,Anzaldo; Leesa B,9,0,30,21
1649944759452,MATH 109,B01,083215,Anzaldo; Leesa B,26,0,30,4
1649944759452,MATH 109,B02,083216,Anzaldo; Leesa B,22,0,30,8
1649944765477,MATH 142A,A01,083219,Chow; Bennett,0,1,30,30
1649944765477,MATH 142A,A02,083220,Chow; Bennett,9,0,30,21
1649944765477,MATH 142A,B01,083221,Chow; Bennett,0,0,30,30
1649944765477,MATH 142A,B02,083222,Chow; Bennett,1,0,30,29
1649944771517,MATH 193A,A01,083224,Staff,0,3,30,30
1649944771517,MATH 193A,A02,083225,Staff,0,3,30,30
1649944771517,MATH 193A,A03,083781,Staff,4,0,30,26
1649944771517,MATH 193A,A04,083782,Staff,16,0,30,14
1649944777541,MATH 197,001,091859,McAuley; Julian John,9999,0,9999,0
1649944783627,COGS 9,A01,083615,Staff,16,0,60,44
1649944789655,COGS 11,A01,083617,Boyle; Mary E. T.,35,0,40,5
1649944795679,COGS 13,A01,083071,Staff,0,11,40,40
1649944801704,COGS 14A,A01,092681,Staff,65,0,100,35
1649944807728,COGS 14B,A01,083073,Cheng; Tzu-Han,24,0,50,26
1649944813754,COGS 17,A01,092677,Staff,63,0,75,12
1649944819778,COGS 100,A01,083619,Staff,0,5,60,60
1649944825805,COGS 101A,A01,083621,Davis; Joshua Daniel,0,8,60,60
1649944831830,COGS 101B,A01,091572,Staff,31,0,60,29
1649944837855,COGS 101C,A01,083625,Delgado; Tania,24,0,30,6
1649944843889,COGS 107A,A01,083627,Boyle; Mary E. T.,14,0,60,46
1649944849918,COGS 118A,A01,083075,Staff,21,0,60,39
1649944855951,CSE 3,A50,083646,Miranda; Gregory Joseph,24,0,38,14
1649944855951,CSE 3,A51,083647,Miranda; Gregory Joseph,37,0,37,0
1649944861979,CSE 8A,A50,083650,Miranda; Gregory Joseph,8,0,40,32
1649944868004,CSE 11,A01,083080,Cao; Yingjun,0,26,40,40
1649944874035,CSE 12,A01,083652,Staff,56,0,100,44
1649944880065,CSE 15L,A01,083654,Staff,19,0,50,31
1649944880065,CSE 15L,A02,083655,Staff,47,0,50,3
1649944886091,CSE 20,A01,083657,Staff,68,0,80,12
1649944892117,CSE 30,A01,083084,Eldon; John,0,24,40,40
1649944898142,CSE 100,A01,083659,Cao; Yingjun,1,27,50,49
1649944904181,CSE 134B,A01,083661,Powell; Thomas Allan,0,21,65,65
1649944910207,CSE 140,A01,083663,Staff,24,0,75,51
1649944916232,CSE 140L,A01,083088,Eldon; John,18,0,75,57
1649944922256,CSE 175,A01,083665,Kumar; Rakesh,12,0,25,13
1649944928286,CSE 190,A00,092507,Dubnov; Shlomo,14,0,15,1
1649944934314,ECE 45,A01,083139,Staff,5,0,40,35
1649944940343,ECE 65,A50,083695,Staff,7,0,30,23
1649944946374,ECE 109,A01,091882,Touri; Behrouz,55,0,70,15
1649944952403,ECE 180,A00,083140,Abi Samra; Nicholas Camill,26,0,30,4
1649944952403,ECE 180,B00,083141,Abi Samra; Nicholas Camill,13,0,30,17
1649944958432,MATH 10A,A01,083735,Patchell; Gregory David,20,0,30,10
1649944958432,MATH 10A,A02,083736,Patchell; Gregory David,28,0,30,2
1649944958432,MATH 10A,A03,083737,Patchell; Gregory David,28,0,30,2
1649944964459,MATH 10B,A01,083207,Staff,10,0,30,20
1649944964459,MATH 10B,A02,083208,Staff,25,0,30,5
1649944964459,MATH 10B,B01,083739,Staff,25,0,30,5
1649944964459,MATH 10B,B02,083740,Staff,30,0,30,0
1649944970491,MATH 18,A01,083743,Staff,22,0,30,8
1649944970491,MATH 18,A02,083744,Staff,29,0,30,1
1649944970491,MATH 18,A03,083745,Staff,29,0,30,1
1649944970491,MATH 18,A04,083746,Staff,28,0,30,2
1649944970491,MATH 18,B01,083748,Staff,5,0,30,25
1649944970491,MATH 18,B02,083749,Staff,26,0,30,4
1649944970491,MATH 18,B03,083750,Staff,28,0,30,2
1649944970491,MATH 18,B04,083751,Staff,26,0,30,4
1649944976515,MATH 20A,A01,083754,Staff,37,0,40,3
1649944982542,MATH 20B,A01,083756,Staff,19,0,30,11
1649944982542,MATH 20B,A02,083757,Staff,30,0,30,0
1649944988575,MATH 20C,A01,083760,Staff,22,0,30,8
1649944988575,MATH 20C,A02,083761,Staff,23,0,30,7
1649944988575,MATH 20C,B01,083762,Staff,28,0,30,2
1649944988575,MATH 20C,B02,083763,Staff,30,0,30,0
1649944994598,MATH 20D,A01,083765,Staff,20,0,30,10
1649944994598,MATH 20D,A02,083766,Staff,30,0,30,0
1649944994598,MATH 20D,A03,083767,Staff,30,0,30,0
1649945000629,MATH 20E,A01,083771,Staff,12,0,30,18
1649945000629,MATH 20E,A02,083772,Staff,24,0,30,6
1649945000629,MATH 20E,B01,083773,Staff,17,0,30,13
1649945000629,MATH 20E,B02,083774,Staff,29,0,30,1
1649945006652,MATH 103A,A01,083777,Staff,1,4,30,29
1649945006652,MATH 103A,A02,083778,Staff,0,3,30,30
1649945006652,MATH 103A,B01,083779,Staff,0,0,30,30
1649945006652,MATH 103A,B02,083780,Staff,16,0,30,14
1649945012674,MATH 105,A01,085443,Staff,0,5,30,30
1649945018702,MATH 109,A01,083213,Anzaldo; Leesa B,13,0,30,17
1649945018702,MATH 109,A02,083214,Anzaldo; Leesa B,9,0,30,21
1649945018702,MATH 109,B01,083215,Anzaldo; Leesa B,26,0,30,4
1649945018702,MATH 109,B02,083216,Anzaldo; Leesa B,22,0,30,8
1649945024727,MATH 142A,A01,083219,Chow; Bennett,0,1,30,30
1649945024727,MATH 142A,A02,083220,Chow; Bennett,9,0,30,21
1649945024727,MATH 142A,B01,083221,Chow; Bennett,0,0,30,30
1649945024727,MATH 142A,B02,083222,Chow; Bennett,1,0,30,29
1649945030755,MATH 193A,A01,083224,Staff,0,3,30,30
1649945030755,MATH 193A,A02,083225,Staff,0,3,30,30
1649945030755,MATH 193A,A03,083781,Staff,4,0,30,26
1649945030755,MATH 193A,A04,083782,Staff,16,0,30,14
1649945036782,MATH 197,001,091859,McAuley; Julian John,9999,0,9999,0
1649945042843,COGS 9,A01,083615,Staff,16,0,60,44
1649945048868,COGS 11,A01,083617,Boyle; Mary E. T.,35,0,40,5
1649945054895,COGS 13,A01,083071,Staff,0,11,40,40
1649945060918,COGS 14A,A01,092681,Staff,65,0,100,35
1649945066940,COGS 14B,A01,083073,Cheng; Tzu-Han,24,0,50,26
1649945072964,COGS 17,A01,092677,Staff,63,0,75,12
1649945078987,COGS 100,A01,083619,Staff,0,5,60,60
1649945085011,COGS 101A,A01,083621,Davis; Joshua Daniel,0,8,60,60
1649945091034,COGS 101B,A01,091572,Staff,31,0,60,29
1649945097072,COGS 101C,A01,083625,Delgado; Tania,24,0,30,6
1649945103105,COGS 107A,A01,083627,Boyle; Mary E. T.,14,0,60,46
1649945109131,COGS 118A,A01,083075,Staff,21,0,60,39
1649945115154,CSE 3,A50,083646,Miranda; Gregory Joseph,24,0,38,14
1649945115154,CSE 3,A51,083647,Miranda; Gregory Joseph,37,0,37,0
1649945121182,CSE 8A,A50,083650,Miranda; Gregory Joseph,8,0,40,32
1649945127209,CSE 11,A01,083080,Cao; Yingjun,0,26,40,40
1649945133232,CSE 12,A01,083652,Staff,56,0,100,44
1649945139257,CSE 15L,A01,083654,Staff,19,0,50,31
1649945139257,CSE 15L,A02,083655,Staff,47,0,50,3
1649945145285,CSE 20,A01,083657,Staff,68,0,80,12
1649945151308,CSE 30,A01,083084,Eldon; John,0,24,40,40
1649945157333,CSE 100,A01,083659,Cao; Yingjun,1,27,50,49
1649945163357,CSE 134B,A01,083661,Powell; Thomas Allan,0,21,65,65
1649945169382,CSE 140,A01,083663,Staff,24,0,75,51
1649945175413,CSE 140L,A01,083088,Eldon; John,18,0,75,57
1649945181440,CSE 175,A01,083665,Kumar; Rakesh,12,0,25,13
1649945187467,CSE 190,A00,092507,Dubnov; Shlomo,14,0,15,1
1649945193490,ECE 45,A01,083139,Staff,5,0,40,35
1649945199512,ECE 65,A50,083695,Staff,7,0,30,23
1649945205536,ECE 109,A01,091882,Touri; Behrouz,55,0,70,15
1649945211649,ECE 180,A00,083140,Abi Samra; Nicholas Camill,26,0,30,4
1649945211649,ECE 180,B00,083141,Abi Samra; Nicholas Camill,13,0,30,17
1649945217677,MATH 10A,A01,083735,Patchell; Gregory David,20,0,30,10
1649945217677,MATH 10A,A02,083736,Patchell; Gregory David,28,0,30,2
1649945217677,MATH 10A,A03,083737,Patchell; Gregory David,28,0,30,2
1649945223702,MATH 10B,A01,083207,Staff,10,0,30,20
1649945223702,MATH 10B,A02,083208,Staff,25,0,30,5
1649945223702,MATH 10B,B01,083739,Staff,25,0,30,5
1649945223702,MATH 10B,B02,083740,Staff,30,0,30,0
1649945229727,MATH 18,A01,083743,Staff,22,0,30,8
1649945229727,MATH 18,A02,083744,Staff,29,0,30,1
1649945229727,MATH 18,A03,083745,Staff,29,0,30,1
1649945229727,MATH 18,A04,083746,Staff,28,0,30,2
1649945229727,MATH 18,B01,083748,Staff,5,0,30,25
1649945229727,MATH 18,B02,083749,Staff,26,0,30,4
1649945229727,MATH 18,B03,083750,Staff,28,0,30,2
1649945229727,MATH 18,B04,083751,Staff,26,0,30,4
1649945235750,MATH 20A,A01,083754,Staff,37,0,40,3
1649945241777,MATH 20B,A01,083756,Staff,19,0,30,11
1649945241777,MATH 20B,A02,083757,Staff,30,0,30,0
1649945247802,MATH 20C,A01,083760,Staff,22,0,30,8
1649945247802,MATH 20C,A02,083761,Staff,23,0,30,7
1649945247802,MATH 20C,B01,083762,Staff,28,0,30,2
1649945247802,MATH 20C,B02,083763,Staff,30,0,30,0
1649945253825,MATH 20D,A01,083765,Staff,20,0,30,10
1649945253825,MATH 20D,A02,083766,Staff,30,0,30,0
1649945253825,MATH 20D,A03,083767,Staff,30,0,30,0
1649945259849,MATH 20E,A01,083771,Staff,12,0,30,18
1649945259849,MATH 20E,A02,083772,Staff,24,0,30,6
1649945259849,MATH 20E,B01,083773,Staff,17,0,30,13
1649945259849,MATH 20E,B02,083774,Staff,29,0,30,1
1649945265872,MATH 103A,A01,083777,Staff,1,4,30,29
1649945265872,MATH 103A,A02,083778,Staff,0,3,30,30
1649945265872,MATH 103A,B01,083779,Staff,0,0,30,30
1649945265872,MATH 103A,B02,083780,Staff,16,0,30,14
1649945271898,MATH 105,A01,085443,Staff,0,6,30,30
1649945277922,MATH 109,A01,083213,Anzaldo; Leesa B,13,0,30,17
1649945277922,MATH 109,A02,083214,Anzaldo; Leesa B,9,0,30,21
1649945277922,MATH 109,B01,083215,Anzaldo; Leesa B,26,0,30,4
1649945277922,MATH 109,B02,083216,Anzaldo; Leesa B,22,0,30,8
1649945283946,MATH 142A,A01,083219,Chow; Bennett,0,2,30,30
1649945283946,MATH 142A,A02,083220,Chow; Bennett,9,0,30,21
1649945283946,MATH 142A,B01,083221,Chow; Bennett,0,0,30,30
1649945283946,MATH 142A,B02,083222,Chow; Bennett,1,0,30,29
1649945289968,MATH 193A,A01,083224,Staff,0,3,30,30
1649945289968,MATH 193A,A02,083225,Staff,0,3,30,30
1649945289968,MATH 193A,A03,083781,Staff,4,0,30,26
1649945289968,MATH 193A,A04,083782,Staff,16,0,30,14
1649945295996,MATH 197,001,091859,McAuley; Julian John,9999,0,9999,0
1649945302059,COGS 9,A01,083615,Staff,16,0,60,44
1649945308080,COGS 11,A01,083617,Boyle; Mary E. T.,35,0,40,5
1649945314108,COGS 13,A01,083071,Staff,0,11,40,40
1649945320137,COGS 14A,A01,092681,Staff,65,0,100,35
1649945326164,COGS 14B,A01,083073,Cheng; Tzu-Han,24,0,50,26
1649945332187,COGS 17,A01,092677,Staff,63,0,75,12
1649945338220,COGS 100,A01,083619,Staff,0,5,60,60
1649945344248,COGS 101A,A01,083621,Davis; Joshua Daniel,0,8,60,60
1649945350279,COGS 101B,A01,091572,Staff,31,0,60,29
1649945356302,COGS 101C,A01,083625,Delgado; Tania,24,0,30,6
1649945362325,COGS 107A,A01,083627,Boyle; Mary E. T.,14,0,60,46
1649945368351,COGS 118A,A01,083075,Staff,21,0,60,39
1649945374374,CSE 3,A50,083646,Miranda; Gregory Joseph,24,0,38,14
1649945374374,CSE 3,A51,083647,Miranda; Gregory Joseph,37,0,37,0
1649945380402,CSE 8A,A50,083650,Miranda; Gregory Joseph,8,0,40,32
1649945386423,CSE 11,A01,083080,Cao; Yingjun,0,26,40,40
1649945392446,CSE 12,A01,083652,Staff,56,0,100,44
1649945398472,CSE 15L,A01,083654,Staff,19,0,50,31
1649945398472,CSE 15L,A02,083655,Staff,47,0,50,3
1649945404497,CSE 20,A01,083657,Staff,68,0,80,12
1649945410524,CSE 30,A01,083084,Eldon; John,0,24,40,40
1649945416549,CSE 100,A01,083659,Cao; Yingjun,1,27,50,49
1649945422574,CSE 134B,A01,083661,Powell; Thomas Allan,0,21,65,65
1649945428601,CSE 140,A01,083663,Staff,24,0,75,51
1649945434628,CSE 140L,A01,083088,Eldon; John,18,0,75,57
1649945440654,CSE 175,A01,083665,Kumar; Rakesh,12,0,25,13
1649945446681,CSE 190,A00,092507,Dubnov; Shlomo,14,0,15,1
1649945452704,ECE 45,A01,083139,Staff,5,0,40,35
1649945458728,ECE 65,A50,083695,Staff,7,0,30,23
1649945464759,ECE 109,A01,091882,Touri; Behrouz,55,0,70,15
1649945470785,ECE 180,A00,083140,Abi Samra; Nicholas Camill,26,0,30,4
1649945470785,ECE 180,B00,083141,Abi Samra; Nicholas Camill,13,0,30,17
1649945476808,MATH 10A,A01,083735,Patchell; Gregory David,20,0,30,10
1649945476808,MATH 10A,A02,083736,Patchell; Gregory David,28,0,30,2
1649945476808,MATH 10A,A03,083737,Patchell; Gregory David,28,0,30,2
1649945482846,MATH 10B,A01,083207,Staff,10,0,30,20
1649945482846,MATH 10B,A02,083208,Staff,25,0,30,5
1649945482846,MATH 10B,B01,083739,Staff,25,0,30,5
1649945482846,MATH 10B,B02,083740,Staff,30,0,30,0
1649945488873,MATH 18,A01,083743,Staff,22,0,30,8
1649945488873,MATH 18,A02,083744,Staff,29,0,30,1
1649945488873,MATH 18,A03,083745,Staff,29,0,30,1
1649945488873,MATH 18,A04,083746,Staff,28,0,30,2
1649945488873,MATH 18,B01,083748,Staff,5,0,30,25
1649945488873,MATH 18,B02,083749,Staff,26,0,30,4
1649945488873,MATH 18,B03,083750,Staff,28,0,30,2
1649945488873,MATH 18,B04,083751,Staff,26,0,30,4
1649945494897,MATH 20A,A01,083754,Staff,37,0,40,3
1649945500920,MATH 20B,A01,083756,Staff,19,0,30,11
1649945500920,MATH 20B,A02,083757,Staff,30,0,30,0
1649945506948,MATH 20C,A01,083760,Staff,22,0,30,8
1649945506948,MATH 20C,A02,083761,Staff,23,0,30,7
1649945506948,MATH 20C,B01,083762,Staff,28,0,30,2
1649945506948,MATH 20C,B02,083763,Staff,30,0,30,0
1649945512979,MATH 20D,A01,083765,Staff,20,0,30,10
1649945512979,MATH 20D,A02,083766,Staff,30,0,30,0
1649945512979,MATH 20D,A03,083767,Staff,30,0,30,0
1649945519007,MATH 20E,A01,083771,Staff,12,0,30,18
1649945519007,MATH 20E,A02,083772,Staff,24,0,30,6
1649945519007,MATH 20E,B01,083773,Staff,17,0,30,13
1649945519007,MATH 20E,B02,083774,Staff,29,0,30,1
1649945525031,MATH 103A,A01,083777,Staff,1,4,30,29
1649945525031,MATH 103A,A02,083778,Staff,0,3,30,30
1649945525031,MATH 103A,B01,083779,Staff,0,0,30,30
1649945525031,MATH 103A,B02,083780,Staff,16,0,30,14
1649945531054,MATH 105,A01,085443,Staff,0,6,30,30
1649945537078,MATH 109,A01,083213,Anzaldo; Leesa B,13,0,30,17
1649945537078,MATH 109,A02,083214,Anzaldo; Leesa B,9,0,30,21
1649945537078,MATH 109,B01,083215,Anzaldo; Leesa B,26,0,30,4
1649945537078,MATH 109,B02,083216,Anzaldo; Leesa B,22,0,30,8
1649945543105,MATH 142A,A01,083219,Chow; Bennett,0,2,30,30
1649945543105,MATH 142A,A02,083220,Chow; Bennett,9,0,30,21
1649945543105,MATH 142A,B01,083221,Chow; Bennett,0,0,30,30
1649945543105,MATH 142A,B02,083222,Chow; Bennett,1,0,30,29
1649945549136,MATH 193A,A01,083224,Staff,0,3,30,30
1649945549136,MATH 193A,A02,083225,Staff,0,3,30,30
1649945549136,MATH 193A,A03,083781,Staff,4,0,30,26
1649945549136,MATH 193A,A04,083782,Staff,16,0,30,14
1649945555166,MATH 197,001,091859,McAuley; Julian John,9999,0,9999,0
1649945561224,COGS 9,A01,083615,Staff,16,0,60,44
1649945567249,COGS 11,A01,083617,Boyle; Mary E. T.,35,0,40,5
1649945573273,COGS 13,A01,083071,Staff,0,11,40,40
1649945579297,COGS 14A,A01,092681,Staff,65,0,100,35
1649945585318,COGS 14B,A01,083073,Cheng; Tzu-Han,24,0,50,26
1649945591342,COGS 17,A01,092677,Staff,63,0,75,12
1649945597366,COGS 100,A01,083619,Staff,0,5,60,60
1649945603401,COGS 101A,A01,083621,Davis; Joshua Daniel,0,8,60,60
1649945609427,COGS 101B,A01,091572,Staff,31,0,60,29
1649945615449,COGS 101C,A01,083625,Delgado; Tania,24,0,30,6
1649945621485,COGS 107A,A01,083627,Boyle; Mary E. T.,14,0,60,46
1649945627516,COGS 118A,A01,083075,Staff,21,0,60,39
1649945633583,CSE 3,A50,083646,Miranda; Gregory Joseph,24,0,38,14
1649945633583,CSE 3,A51,083647,Miranda; Gregory Joseph,37,0,37,0
1649945639606,CSE 8A,A50,083650,Miranda; Gregory Joseph,8,0,40,32
1649945645633,CSE 11,A01,083080,Cao; Yingjun,0,26,40,40
1649945651656,CSE 12,A01,083652,Staff,56,0,100,44
1649945657680,CSE 15L,A01,083654,Staff,19,0,50,31
1649945657680,CSE 15L,A02,083655,Staff,47,0,50,3
1649945663702,CSE 20,A01,083657,Staff,68,0,80,12
1649945669731,CSE 30,A01,083084,Eldon; John,0,24,40,40
1649945675754,CSE 100,A01,083659,Cao; Yingjun,1,27,50,49
1649945681779,CSE 134B,A01,083661,Powell; Thomas Allan,0,21,65,65
1649945687807,CSE 140,A01,083663,Staff,24,0,75,51
1649945693833,CSE 140L,A01,083088,Eldon; John,18,0,75,57
1649945699862,CSE 175,A01,083665,Kumar; Rakesh,12,0,25,13
1649945705890,CSE 190,A00,092507,Dubnov; Shlomo,14,0,15,1
1649945711913,ECE 45,A01,083139,Staff,5,0,40,35
1649945717935,ECE 65,A50,083695,Staff,7,0,30,23
1649945723961,ECE 109,A01,091882,Touri; Behrouz,55,0,70,15
1649945729989,ECE 180,A00,083140,Abi Samra; Nicholas Camill,26,0,30,4
1649945729989,ECE 180,B00,083141,Abi Samra; Nicholas Camill,13,0,30,17
1649945736012,MATH 10A,A01,083735,Patchell; Gregory David,20,0,30,10
1649945736012,MATH 10A,A02,083736,Patchell; Gregory David,28,0,30,2
1649945736012,MATH 10A,A03,083737,Patchell; Gregory David,28,0,30,2
1649945742041,MATH 10B,A01,083207,Staff,10,0,30,20
1649945742041,MATH 10B,A02,083208,Staff,25,0,30,5
1649945742041,MATH 10B,B01,083739,Staff,25,0,30,5
1649945742041,MATH 10B,B02,083740,Staff,30,0,30,0
1649945748065,MATH 18,A01,083743,Staff,22,0,30,8
1649945748065,MATH 18,A02,083744,Staff,29,0,30,1
1649945748065,MATH 18,A03,083745,Staff,29,0,30,1
1649945748065,MATH 18,A04,083746,Staff,28,0,30,2
1649945748065,MATH 18,B01,083748,Staff,5,0,30,25
1649945748065,MATH 18,B02,083749,Staff,26,0,30,4
1649945748065,MATH 18,B03,083750,Staff,28,0,30,2
1649945748065,MATH 18,B04,083751,Staff,26,0,30,4
1649945754088,MATH 20A,A01,083754,Staff,37,0,40,3
1649945760117,MATH 20B,A01,083756,Staff,19,0,30,11
1649945760117,MATH 20B,A02,083757,Staff,30,0,30,0
1649945766142,MATH 20C,A01,083760,Staff,22,0,30,8
1649945766142,MATH 20C,A02,083761,Staff,23,0,30,7
1649945766142,MATH 20C,B01,083762,Staff,28,0,30,2
1649945766142,MATH 20C,B02,083763,Staff,30,0,30,0
1649945772170,MATH 20D,A01,083765,Staff,20,0,30,10
1649945772170,MATH 20D,A02,083766,Staff,30,0,30,0
1649945772170,MATH 20D,A03,083767,Staff,30,0,30,0
1649945778200,MATH 20E,A01,083771,Staff,12,0,30,18
1649945778200,MATH 20E,A02,083772,Staff,24,0,30,6
1649945778200,MATH 20E,B01,083773,Staff,17,0,30,13
1649945778200,MATH 20E,B02,083774,Staff,29,0,30,1
1649945784228,MATH 103A,A01,083777,Staff,1,4,30,29
1649945784228,MATH 103A,A02,083778,Staff,0,3,30,30
1649945784228,MATH 103A,B01,083779,Staff,0,0,30,30
1649945784228,MATH 103A,B02,083780,Staff,16,0,30,14
1649945790252,MATH 105,A01,085443,Staff,0,6,30,30
1649945796280,MATH 109,A01,083213,Anzaldo; Leesa B,13,0,30,17
1649945796280,MATH 109,A02,083214,Anzaldo; Leesa B,9,0,30,21
1649945796280,MATH 109,B01,083215,Anzaldo; Leesa B,26,0,30,4
1649945796280,MATH 109,B02,083216,Anzaldo; Leesa B,22,0,30,8
1649945802304,MATH 142A,A01,083219,Chow; Bennett,0,2,30,30
1649945802304,MATH 142A,A02,083220,Chow; Bennett,9,0,30,21
1649945802304,MATH 142A,B01,083221,Chow; Bennett,0,0,30,30
1649945802304,MATH 142A,B02,083222,Chow; Bennett,1,0,30,29
1649945808421,MATH 193A,A01,083224,Staff,0,3,30,30
1649945808421,MATH 193A,A02,083225,Staff,0,3,30,30
1649945808421,MATH 193A,A03,083781,Staff,4,0,30,26
1649945808421,MATH 193A,A04,083782,Staff,16,0,30,14
1649945814445,MATH 197,001,091859,McAuley; Julian John,9999,0,9999,0
1649945820510,COGS 9,A01,083615,Staff,16,0,60,44
1649945826539,COGS 11,A01,083617,Boyle; Mary E. T.,35,0,40,5
1649945832564,COGS 13,A01,083071,Staff,0,11,40,40
1649945838591,COGS 14A,A01,092681,Staff,65,0,100,35
1649945844617,COGS 14B,A01,083073,Cheng; Tzu-Han,24,0,50,26
1649945850641,COGS 17,A01,092677,Staff,63,0,75,12
1649945856668,COGS 100,A01,083619,Staff,0,5,60,60
1649945862695,COGS 101A,A01,083621,Davis; Joshua Daniel,0,8,60,60
1649945868719,COGS 101B,A01,091572,Staff,31,0,60,29
1649945874743,COGS 101C,A01,083625,Delgado; Tania,24,0,30,6
1649945880768,COGS 107A,A01,083627,Boyle; Mary E. T.,14,0,60,46
1649945886793,COGS 118A,A01,083075,Staff,21,0,60,39
1649945892824,CSE 3,A50,083646,Miranda; Gregory Joseph,24,0,38,14
1649945892824,CSE 3,A51,083647,Miranda; Gregory Joseph,37,0,37,0
1649945898854,CSE 8A,A50,083650,Miranda; Gregory Joseph,8,0,40,32
1649945904878,CSE 11,A01,083080,Cao; Yingjun,0,26,40,40
1649945910902,CSE 12,A01,083652,Staff,56,0,100,44
1649945916931,CSE 15L,A01,083654,Staff,19,0,50,31
1649945916931,CSE 15L,A02,083655,Staff,47,0,50,3
1649945922953,CSE 20,A01,083657,Staff,68,0,80,12
1649945928978,CSE 30,A01,083084,Eldon; John,0,24,40,40
1649945935003,CSE 100,A01,083659,Cao; Yingjun,1,27,50,49
1649945941030,CSE 134B,A01,083661,Powell; Thomas Allan,0,21,65,65
1649945947056,CSE 140,A01,083663,Staff,24,0,75,51
1649945953079,CSE 140L,A01,083088,Eldon; John,18,0,75,57
1649945959108,CSE 175,A01,083665,Kumar; Rakesh,12,0,25,13
1649945965144,CSE 190,A00,092507,Dubnov; Shlomo,14,0,15,1
1649945971170,ECE 45,A01,083139,Staff,5,0,40,35
1649945977195,ECE 65,A50,083695,Staff,7,0,30,23
1649945983221,ECE 109,A01,091882,Touri; Behrouz,55,0,70,15
1649945989244,ECE 180,A00,083140,Abi Samra; Nicholas Camill,26,0,30,4
1649945989244,ECE 180,B00,083141,Abi Samra; Nicholas Camill,13,0,30,17
1649945995266,MATH 10A,A01,083735,Patchell; Gregory David,20,0,30,10
1649945995266,MATH 10A,A02,083736,Patchell; Gregory David,28,0,30,2
1649945995266,MATH 10A,A03,083737,Patchell; Gregory David,28,0,30,2
1649946001298,MATH 10B,A01,083207,Staff,10,0,30,20
1649946001298,MATH 10B,A02,083208,Staff,25,0,30,5
1649946001298,MATH 10B,B01,083739,Staff,25,0,30,5
1649946001298,MATH 10B,B02,083740,Staff,30,0,30,0
1649946007323,MATH 18,A01,083743,Staff,22,0,30,8
1649946007323,MATH 18,A02,083744,Staff,29,0,30,1
1649946007323,MATH 18,A03,083745,Staff,29,0,30,1
1649946007323,MATH 18,A04,083746,Staff,28,0,30,2
1649946007323,MATH 18,B01,083748,Staff,5,0,30,25
1649946007323,MATH 18,B02,083749,Staff,26,0,30,4
1649946007323,MATH 18,B03,083750,Staff,28,0,30,2
1649946007323,MATH 18,B04,083751,Staff,26,0,30,4
1649946013348,MATH 20A,A01,083754,Staff,37,0,40,3
1649946019376,MATH 20B,A01,083756,Staff,19,0,30,11
1649946019376,MATH 20B,A02,083757,Staff,30,0,30,0
1649946025405,MATH 20C,A01,083760,Staff,22,0,30,8
1649946025405,MATH 20C,A02,083761,Staff,23,0,30,7
1649946025405,MATH 20C,B01,083762,Staff,28,0,30,2
1649946025405,MATH 20C,B02,083763,Staff,30,0,30,0
1649946031429,MATH 20D,A01,083765,Staff,20,0,30,10
1649946031429,MATH 20D,A02,083766,Staff,30,0,30,0
1649946031429,MATH 20D,A03,083767,Staff,30,0,30,0
1649946037456,MATH 20E,A01,083771,Staff,12,0,30,18
1649946037456,MATH 20E,A02,083772,Staff,24,0,30,6
1649946037456,MATH 20E,B01,083773,Staff,17,0,30,13
1649946037456,MATH 20E,B02,083774,Staff,29,0,30,1
1649946043484,MATH 103A,A01,083777,Staff,1,4,30,29
1649946043484,MATH 103A,A02,083778,Staff,0,3,30,30
1649946043484,MATH 103A,B01,083779,Staff,0,0,30,30
1649946043484,MATH 103A,B02,083780,Staff,16,0,30,14
1649946049508,MATH 105,A01,085443,Staff,0,6,30,30
1649946055532,MATH 109,A01,083213,Anzaldo; Leesa B,13,0,30,17
1649946055532,MATH 109,A02,083214,Anzaldo; Leesa B,9,0,30,21
1649946055532,MATH 109,B01,083215,Anzaldo; Leesa B,26,0,30,4
1649946055532,MATH 109,B02,083216,Anzaldo; Leesa B,22,0,30,8
1649946061557,MATH 142A,A01,083219,Chow; Bennett,0,2,30,30
1649946061557,MATH 142A,A02,083220,Chow; Bennett,9,0,30,21
1649946061557,MATH 142A,B01,083221,Chow; Bennett,0,0,30,30
1649946061557,MATH 142A,B02,083222,Chow; Bennett,1,0,30,29
1649946067586,MATH 193A,A01,083224,Staff,0,3,30,30
1649946067586,MATH 193A,A02,083225,Staff,0,3,30,30
1649946067586,MATH 193A,A03,083781,Staff,4,0,30,26
1649946067586,MATH 193A,A04,083782,Staff,16,0,30,14
1649946073609,MATH 197,001,091859,McAuley; Julian John,9999,0,9999,0
1649946079701,COGS 9,A01,083615,Staff,16,0,60,44
1649946085727,COGS 11,A01,083617,Boyle; Mary E. T.,35,0,40,5
1649946091760,COGS 13,A01,083071,Staff,0,11,40,40
1649946097783,COGS 14A,A01,092681,Staff,65,0,100,35
1649946103812,COGS 14B,A01,083073,Cheng; Tzu-Han,24,0,50,26
1649946109836,COGS 17,A01,092677,Staff,63,0,75,12
1649946115862,COGS 100,A01,083619,Staff,0,5,60,60
1649946121887,COGS 101A,A01,083621,Davis; Joshua Daniel,0,8,60,60
1649946127911,COGS 101B,A01,091572,Staff,31,0,60,29
1649946133934,COGS 101C,A01,083625,Delgado; Tania,24,0,30,6
1649946139960,COGS 107A,A01,083627,Boyle; Mary E. T.,14,0,60,46
1649946145987,COGS 118A,A01,083075,Staff,21,0,60,39
1649946152014,CSE 3,A50,083646,Miranda; Gregory Joseph,24,0,38,14
1649946152014,CSE 3,A51,083647,Miranda; Gregory Joseph,37,0,37,0
1649946158039,CSE 8A,A50,083650,Miranda; Gregory Joseph,8,0,40,32
1649946164063,CSE 11,A01,083080,Cao; Yingjun,0,26,40,40
1649946170087,CSE 12,A01,083652,Staff,56,0,100,44
1649946176109,CSE 15L,A01,083654,Staff,19,0,50,31
1649946176109,CSE 15L,A02,083655,Staff,47,0,50,3
1649946182132,CSE 20,A01,083657,Staff,68,0,80,12
1649946188165,CSE 30,A01,083084,Eldon; John,0,24,40,40
1649946194188,CSE 100,A01,083659,Cao; Yingjun,1,27,50,49
1649946200212,CSE 134B,A01,083661,Powell; Thomas Allan,0,21,65,65
1649946206236,CSE 140,A01,083663,Staff,24,0,75,51
1649946212259,CSE 140L,A01,083088,Eldon; John,18,0,75,57
1649946218283,CSE 175,A01,083665,Kumar; Rakesh,12,0,25,13
1649946224305,CSE 190,A00,092507,Dubnov; Shlomo,14,0,15,1
1649946230331,ECE 45,A01,083139,Staff,5,0,40,35
1649946236355,ECE 65,A50,083695,Staff,7,0,30,23
1649946242378,ECE 109,A01,091882,Touri; Behrouz,55,0,70,15
1649946248412,ECE 180,A00,083140,Abi Samra; Nicholas Camill,26,0,30,4
1649946248412,ECE 180,B00,083141,Abi Samra; Nicholas Camill,13,0,30,17
1649946254448,MATH 10A,A01,083735,Patchell; Gregory David,20,0,30,10
1649946254448,MATH 10A,A02,083736,Patchell; Gregory David,28,0,30,2
1649946254448,MATH 10A,A03,083737,Patchell; Gregory David,28,0,30,2
1649946260476,MATH 10B,A01,083207,Staff,10,0,30,20
1649946260476,MATH 10B,A02,083208,Staff,25,0,30,5
1649946260476,MATH 10B,B01,083739,Staff,25,0,30,5
1649946260476,MATH 10B,B02,083740,Staff,30,0,30,0
1649946266503,MATH 18,A01,083743,Staff,22,0,30,8
1649946266503,MATH 18,A02,083744,Staff,29,0,30,1
1649946266503,MATH 18,A03,083745,Staff,29,0,30,1
1649946266503,MATH 18,A04,083746,Staff,28,0,30,2
1649946266503,MATH 18,B01,083748,Staff,5,0,30,25
1649946266503,MATH 18,B02,083749,Staff,26,0,30,4
1649946266503,MATH 18,B03,083750,Staff,28,0,30,2
1649946266503,MATH 18,B04,083751,Staff,26,0,30,4
1649946272529,MATH 20A,A01,083754,Staff,37,0,40,3
1649946278555,MATH 20B,A01,083756,Staff,19,0,30,11
1649946278555,MATH 20B,A02,083757,Staff,30,0,30,0
1649946284585,MATH 20C,A01,083760,Staff,22,0,30,8
1649946284585,MATH 20C,A02,083761,Staff,23,0,30,7
1649946284585,MATH 20C,B01,083762,Staff,28,0,30,2
1649946284585,MATH 20C,B02,083763,Staff,30,0,30,0
1649946290611,MATH 20D,A01,083765,Staff,20,0,30,10
1649946290611,MATH 20D,A02,083766,Staff,30,0,30,0
1649946290611,MATH 20D,A03,083767,Staff,30,0,30,0
1649946296641,MATH 20E,A01,083771,Staff,12,0,30,18
1649946296641,MATH 20E,A02,083772,Staff,24,0,30,6
1649946296641,MATH 20E,B01,083773,Staff,17,0,30,13
1649946296641,MATH 20E,B02,083774,Staff,29,0,30,1
1649946302677,MATH 103A,A01,083777,Staff,1,4,30,29
1649946302677,MATH 103A,A02,083778,Staff,0,3,30,30
1649946302677,MATH 103A,B01,083779,Staff,0,0,30,30
1649946302677,MATH 103A,B02,083780,Staff,16,0,30,14
1649946308699,MATH 105,A01,085443,Staff,0,6,30,30
1649946314723,MATH 109,A01,083213,Anzaldo; Leesa B,13,0,30,17
1649946314723,MATH 109,A02,083214,Anzaldo; Leesa B,9,0,30,21
1649946314723,MATH 109,B01,083215,Anzaldo; Leesa B,26,0,30,4
1649946314723,MATH 109,B02,083216,Anzaldo; Leesa B,22,0,30,8
1649946320754,MATH 142A,A01,083219,Chow; Bennett,0,2,30,30
1649946320754,MATH 142A,A02,083220,Chow; Bennett,8,0,30,22
1649946320754,MATH 142A,B01,083221,Chow; Bennett,0,0,30,30
1649946320754,MATH 142A,B02,083222,Chow; Bennett,1,0,30,29
1649946326784,MATH 193A,A01,083224,Staff,0,3,30,30
1649946326784,MATH 193A,A02,083225,Staff,0,3,30,30
1649946326784,MATH 193A,A03,083781,Staff,4,0,30,26
1649946326784,MATH 193A,A04,083782,Staff,16,0,30,14
1649946332822,MATH 197,001,091859,McAuley; Julian John,9999,0,9999,0
1649946338883,COGS 9,A01,083615,Staff,16,0,60,44
1649946344912,COGS 11,A01,083617,Boyle; Mary E. T.,35,0,40,5
1649946350937,COGS 13,A01,083071,Staff,0,11,40,40
1649946356967,COGS 14A,A01,092681,Staff,65,0,100,35
1649946362991,COGS 14B,A01,083073,Cheng; Tzu-Han,24,0,50,26
1649946369020,COGS 17,A01,092677,Staff,63,0,75,12
1649946375041,COGS 100,A01,083619,Staff,0,5,60,60
1649946381069,COGS 101A,A01,083621,Davis; Joshua Daniel,0,8,60,60
1649946387112,COGS 101B,A01,091572,Staff,31,0,60,29
1649946393136,COGS 101C,A01,083625,Delgado; Tania,24,0,30,6
1649946399247,COGS 107A,A01,083627,Boyle; Mary E. T.,14,0,60,46
1649946405273,COGS 118A,A01,083075,Staff,21,0,60,39
1649946411298,CSE 3,A50,083646,Miranda; Gregory Joseph,24,0,38,14
1649946411298,CSE 3,A51,083647,Miranda; Gregory Joseph,37,0,37,0
1649946417321,CSE 8A,A50,083650,Miranda; Gregory Joseph,8,0,40,32
1649946423348,CSE 11,A01,083080,Cao; Yingjun,0,26,40,40
1649946429376,CSE 12,A01,083652,Staff,56,0,100,44
1649946435404,CSE 15L,A01,083654,Staff,19,0,50,31
1649946435404,CSE 15L,A02,083655,Staff,47,0,50,3
1649946441434,CSE 20,A01,083657,Staff,68,0,80,12
1649946447459,CSE 30,A01,083084,Eldon; John,0,24,40,40
1649946453483,CSE 100,A01,083659,Cao; Yingjun,1,27,50,49
1649946459506,CSE 134B,A01,083661,Powell; Thomas Allan,0,21,65,65
1649946465543,CSE 140,A01,083663,Staff,24,0,75,51
1649946471565,CSE 140L,A01,083088,Eldon; John,18,0,75,57
1649946477589,CSE 175,A01,083665,Kumar; Rakesh,12,0,25,13
1649946483613,CSE 190,A00,092507,Dubnov; Shlomo,14,0,15,1
1649946489639,ECE 45,A01,083139,Staff,5,0,40,35
1649946495662,ECE 65,A50,083695,Staff,7,0,30,23
1649946501688,ECE 109,A01,091882,Touri; Behrouz,55,0,70,15
1649946507713,ECE 180,A00,083140,Abi Samra; Nicholas Camill,26,0,30,4
1649946507713,ECE 180,B00,083141,Abi Samra; Nicholas Camill,13,0,30,17
1649946513740,MATH 10A,A01,083735,Patchell; Gregory David,20,0,30,10
1649946513740,MATH 10A,A02,083736,Patchell; Gregory David,28,0,30,2
1649946513740,MATH 10A,A03,083737,Patchell; Gregory David,28,0,30,2
1649946519765,MATH 10B,A01,083207,Staff,10,0,30,20
1649946519765,MATH 10B,A02,083208,Staff,25,0,30,5
1649946519765,MATH 10B,B01,083739,Staff,25,0,30,5
1649946519765,MATH 10B,B02,083740,Staff,30,0,30,0
1649946525797,MATH 18,A01,083743,Staff,22,0,30,8
1649946525797,MATH 18,A02,083744,Staff,29,0,30,1
1649946525797,MATH 18,A03,083745,Staff,29,0,30,1
1649946525797,MATH 18,A04,083746,Staff,28,0,30,2
1649946525797,MATH 18,B01,083748,Staff,5,0,30,25
1649946525797,MATH 18,B02,083749,Staff,26,0,30,4
1649946525797,MATH 18,B03,083750,Staff,28,0,30,2
1649946525797,MATH 18,B04,083751,Staff,26,0,30,4
1649946531836,MATH 20A,A01,083754,Staff,37,0,40,3
1649946537864,MATH 20B,A01,083756,Staff,19,0,30,11
1649946537864,MATH 20B,A02,083757,Staff,30,0,30,0
1649946543888,MATH 20C,A01,083760,Staff,22,0,30,8
1649946543888,MATH 20C,A02,083761,Staff,23,0,30,7
1649946543888,MATH 20C,B01,083762,Staff,28,0,30,2
1649946543888,MATH 20C,B02,083763,Staff,30,0,30,0
1649946549917,MATH 20D,A01,083765,Staff,20,0,30,10
1649946549917,MATH 20D,A02,083766,Staff,30,0,30,0
1649946549917,MATH 20D,A03,083767,Staff,30,0,30,0
1649946555941,MATH 20E,A01,083771,Staff,12,0,30,18
1649946555941,MATH 20E,A02,083772,Staff,24,0,30,6
1649946555941,MATH 20E,B01,083773,Staff,17,0,30,13
1649946555941,MATH 20E,B02,083774,Staff,29,0,30,1
1649946561966,MATH 103A,A01,083777,Staff,1,4,30,29
1649946561966,MATH 103A,A02,083778,Staff,0,3,30,30
1649946561966,MATH 103A,B01,083779,Staff,0,0,30,30
1649946561966,MATH 103A,B02,083780,Staff,16,0,30,14
1649946567994,MATH 105,A01,085443,Staff,0,6,30,30
1649946574024,MATH 109,A01,083213,Anzaldo; Leesa B,13,0,30,17
1649946574024,MATH 109,A02,083214,Anzaldo; Leesa B,9,0,30,21
1649946574024,MATH 109,B01,083215,Anzaldo; Leesa B,26,0,30,4
1649946574024,MATH 109,B02,083216,Anzaldo; Leesa B,22,0,30,8
1649946580051,MATH 142A,A01,083219,Chow; Bennett,0,2,30,30
1649946580051,MATH 142A,A02,083220,Chow; Bennett,8,0,30,22
1649946580051,MATH 142A,B01,083221,Chow; Bennett,0,0,30,30
1649946580051,MATH 142A,B02,083222,Chow; Bennett,1,0,30,29
1649946586079,MATH 193A,A01,083224,Staff,0,3,30,30
1649946586079,MATH 193A,A02,083225,Staff,0,3,30,30
1649946586079,MATH 193A,A03,083781,Staff,4,0,30,26
1649946586079,MATH 193A,A04,083782,Staff,16,0,30,14
1649946592103,MATH 197,001,091859,McAuley; Julian John,9999,0,9999,0
1649946598173,COGS 9,A01,083615,Staff,16,0,60,44
1649946604199,COGS 11,A01,083617,Boyle; Mary E. T.,35,0,40,5
1649946610223,COGS 13,A01,083071,Staff,0,11,40,40
1649946616248,COGS 14A,A01,092681,Staff,65,0,100,35
1649946622279,COGS 14B,A01,083073,Cheng; Tzu-Han,24,0,50,26
1649946628303,COGS 17,A01,092677,Staff,63,0,75,12
1649946634330,COGS 100,A01,083619,Staff,0,5,60,60
1649946640353,COGS 101A,A01,083621,Davis; Joshua Daniel,0,8,60,60
1649946646375,COGS 101B,A01,091572,Staff,31,0,60,29
1649946652401,COGS 101C,A01,083625,Delgado; Tania,24,0,30,6
1649946658427,COGS 107A,A01,083627,Boyle; Mary E. T.,14,0,60,46
1649946664463,COGS 118A,A01,083075,Staff,21,0,60,39
1649946670491,CSE 3,A50,083646,Miranda; Gregory Joseph,24,0,38,14
1649946670491,CSE 3,A51,083647,Miranda; Gregory Joseph,37,0,37,0
1649946676520,CSE 8A,A50,083650,Miranda; Gregory Joseph,8,0,40,32
1649946682543,CSE 11,A01,083080,Cao; Yingjun,0,26,40,40
1649946688567,CSE 12,A01,083652,Staff,56,0,100,44
1649946694599,CSE 15L,A01,083654,Staff,19,0,50,31
1649946694599,CSE 15L,A02,083655,Staff,47,0,50,3
1649946700633,CSE 20,A01,083657,Staff,68,0,80,12
1649946706656,CSE 30,A01,083084,Eldon; John,0,24,40,40
1649946712679,CSE 100,A01,083659,Cao; Yingjun,1,27,50,49
1649946718705,CSE 134B,A01,083661,Powell; Thomas Allan,0,21,65,65
1649946724728,CSE 140,A01,083663,Staff,24,0,75,51
1649946730754,CSE 140L,A01,083088,Eldon; John,18,0,75,57
1649946736783,CSE 175,A01,083665,Kumar; Rakesh,12,0,25,13
1649946742809,CSE 190,A00,092507,Dubnov; Shlomo,14,0,15,1
1649946748838,ECE 45,A01,083139,Staff,5,0,40,35
1649946754862,ECE 65,A50,083695,Staff,7,0,30,23
1649946760886,ECE 109,A01,091882,Touri; Behrouz,55,0,70,15
1649946766910,ECE 180,A00,083140,Abi Samra; Nicholas Camill,26,0,30,4
1649946766910,ECE 180,B00,083141,Abi Samra; Nicholas Camill,13,0,30,17
1649946772938,MATH 10A,A01,083735,Patchell; Gregory David,20,0,30,10
1649946772938,MATH 10A,A02,083736,Patchell; Gregory David,28,0,30,2
1649946772938,MATH 10A,A03,083737,Patchell; Gregory David,28,0,30,2
1649946778965,MATH 10B,A01,083207,Staff,10,0,30,20
1649946778965,MATH 10B,A02,083208,Staff,25,0,30,5
1649946778965,MATH 10B,B01,083739,Staff,25,0,30,5
1649946778965,MATH 10B,B02,083740,Staff,30,0,30,0
1649946784992,MATH 18,A01,083743,Staff,22,0,30,8
1649946784992,MATH 18,A02,083744,Staff,29,0,30,1
1649946784992,MATH 18,A03,083745,Staff,29,0,30,1
1649946784992,MATH 18,A04,083746,Staff,28,0,30,2
1649946784992,MATH 18,B01,083748,Staff,5,0,30,25
1649946784992,MATH 18,B02,083749,Staff,26,0,30,4
1649946784992,MATH 18,B03,083750,Staff,28,0,30,2
1649946784992,MATH 18,B04,083751,Staff,26,0,30,4
1649946791020,MATH 20A,A01,083754,Staff,37,0,40,3
1649946797043,MATH 20B,A01,083756,Staff,19,0,30,11
1649946797043,MATH 20B,A02,083757,Staff,30,0,30,0
1649946808066,MATH 20C,A01,083760,Staff,22,0,30,8
1649946808066,MATH 20C,A02,083761,Staff,23,0,30,7
1649946808066,MATH 20C,B01,083762,Staff,28,0,30,2
1649946808066,MATH 20C,B02,083763,Staff,30,0,30,0
1649946814094,MATH 20D,A01,083765,Staff,20,0,30,10
1649946814094,MATH 20D,A02,083766,Staff,30,0,30,0
1649946814094,MATH 20D,A03,083767,Staff,30,0,30,0
1649946820128,MATH 20E,A01,083771,Staff,12,0,30,18
1649946820128,MATH 20E,A02,083772,Staff,24,0,30,6
1649946820128,MATH 20E,B01,083773,Staff,17,0,30,13
1649946820128,MATH 20E,B02,083774,Staff,29,0,30,1
1649946826151,MATH 103A,A01,083777,Staff,1,4,30,29
1649946826151,MATH 103A,A02,083778,Staff,0,3,30,30
1649946826151,MATH 103A,B01,083779,Staff,0,0,30,30
1649946826151,MATH 103A,B02,083780,Staff,16,0,30,14
1649946832185,MATH 105,A01,085443,Staff,0,6,30,30
1649946838210,MATH 109,A01,083213,Anzaldo; Leesa B,13,0,30,17
1649946838210,MATH 109,A02,083214,Anzaldo; Leesa B,9,0,30,21
1649946838210,MATH 109,B01,083215,Anzaldo; Leesa B,26,0,30,4
1649946838210,MATH 109,B02,083216,Anzaldo; Leesa B,22,0,30,8
1649946844239,MATH 142A,A01,083219,Chow; Bennett,0,2,30,30
1649946844239,MATH 142A,A02,083220,Chow; Bennett,8,0,30,22
1649946844239,MATH 142A,B01,083221,Chow; Bennett,0,0,30,30
1649946844239,MATH 142A,B02,083222,Chow; Bennett,1,0,30,29
1649946850263,MATH 193A,A01,083224,Staff,0,3,30,30
1649946850263,MATH 193A,A02,083225,Staff,0,3,30,30
1649946850263,MATH 193A,A03,083781,Staff,4,0,30,26
1649946850263,MATH 193A,A04,083782,Staff,16,0,30,14
1649946856285,MATH 197,001,091859,McAuley; Julian John,9999,0,9999,0
1649946862339,COGS 9,A01,083615,Staff,16,0,60,44
1649946868367,COGS 11,A01,083617,Boyle; Mary E. T.,35,0,40,5
1649946874390,COGS 13,A01,083071,Staff,0,11,40,40
1649946880416,COGS 14A,A01,092681,Staff,65,0,100,35
1649946886438,COGS 14B,A01,083073,Cheng; Tzu-Han,24,0,50,26
1649946892464,COGS 17,A01,092677,Staff,63,0,75,12
1649946898489,COGS 100,A01,083619,Staff,0,5,60,60
1649946904516,COGS 101A,A01,083621,Davis; Joshua Daniel,0,8,60,60
1649946910541,COGS 101B,A01,091572,Staff,31,0,60,29
1649946916569,COGS 101C,A01,083625,Delgado; Tania,24,0,30,6
1649946922592,COGS 107A,A01,083627,Boyle; Mary E. T.,14,0,60,46
1649946928672,COGS 118A,A01,083075,Staff,21,0,60,39
1649946934695,CSE 3,A50,083646,Miranda; Gregory Joseph,24,0,38,14
1649946934695,CSE 3,A51,083647,Miranda; Gregory Joseph,37,0,37,0
1649946940728,CSE 8A,A50,083650,Miranda; Gregory Joseph,8,0,40,32
1649946946752,CSE 11,A01,083080,Cao; Yingjun,0,26,40,40
1649946952777,CSE 12,A01,083652,Staff,56,0,100,44
1649946958801,CSE 15L,A01,083654,Staff,19,0,50,31
1649946958801,CSE 15L,A02,083655,Staff,47,0,50,3
1649946964826,CSE 20,A01,083657,Staff,68,0,80,12
1649946970856,CSE 30,A01,083084,Eldon; John,0,24,40,40
1649946976881,CSE 100,A01,083659,Cao; Yingjun,1,27,50,49
1649946982902,CSE 134B,A01,083661,Powell; Thomas Allan,0,21,65,65
1649946988930,CSE 140,A01,083663,Staff,24,0,75,51
1649946994956,CSE 140L,A01,083088,Eldon; John,18,0,75,57
1649947001072,CSE 175,A01,083665,Kumar; Rakesh,12,0,25,13
1649947007094,CSE 190,A00,092507,Dubnov; Shlomo,14,0,15,1
1649947013117,ECE 45,A01,083139,Staff,5,0,40,35
1649947019139,ECE 65,A50,083695,Staff,7,0,30,23
1649947025161,ECE 109,A01,091882,Touri; Behrouz,55,0,70,15
1649947031185,ECE 180,A00,083140,Abi Samra; Nicholas Camill,26,0,30,4
1649947031185,ECE 180,B00,083141,Abi Samra; Nicholas Camill,13,0,30,17
1649947037208,MATH 10A,A01,083735,Patchell; Gregory David,20,0,30,10
1649947037208,MATH 10A,A02,083736,Patchell; Gregory David,28,0,30,2
1649947037208,MATH 10A,A03,083737,Patchell; Gregory David,28,0,30,2
1649947043231,MATH 10B,A01,083207,Staff,10,0,30,20
1649947043231,MATH 10B,A02,083208,Staff,25,0,30,5
1649947043231,MATH 10B,B01,083739,Staff,25,0,30,5
1649947043231,MATH 10B,B02,083740,Staff,30,0,30,0
1649947049259,MATH 18,A01,083743,Staff,22,0,30,8
1649947049259,MATH 18,A02,083744,Staff,29,0,30,1
1649947049259,MATH 18,A03,083745,Staff,29,0,30,1
1649947049259,MATH 18,A04,083746,Staff,28,0,30,2
1649947049259,MATH 18,B01,083748,Staff,5,0,30,25
1649947049259,MATH 18,B02,083749,Staff,26,0,30,4
1649947049259,MATH 18,B03,083750,Staff,28,0,30,2
1649947049259,MATH 18,B04,083751,Staff,26,0,30,4
1649947055294,MATH 20A,A01,083754,Staff,37,0,40,3
1649947061317,MATH 20B,A01,083756,Staff,19,0,30,11
1649947061317,MATH 20B,A02,083757,Staff,30,0,30,0
1649947067351,MATH 20C,A01,083760,Staff,22,0,30,8
1649947067351,MATH 20C,A02,083761,Staff,23,0,30,7
1649947067351,MATH 20C,B01,083762,Staff,28,0,30,2
1649947067351,MATH 20C,B02,083763,Staff,30,0,30,0
1649947073378,MATH 20D,A01,083765,Staff,20,0,30,10
1649947073378,MATH 20D,A02,083766,Staff,30,0,30,0
1649947073378,MATH 20D,A03,083767,Staff,30,0,30,0
1649947079401,MATH 20E,A01,083771,Staff,12,0,30,18
1649947079401,MATH 20E,A02,083772,Staff,24,0,30,6
1649947079401,MATH 20E,B01,083773,Staff,17,0,30,13
1649947079401,MATH 20E,B02,083774,Staff,29,0,30,1
1649947085425,MATH 103A,A01,083777,Staff,1,4,30,29
1649947085425,MATH 103A,A02,083778,Staff,0,3,30,30
1649947085425,MATH 103A,B01,083779,Staff,0,0,30,30
1649947085425,MATH 103A,B02,083780,Staff,16,0,30,14
1649947091451,MATH 105,A01,085443,Staff,0,6,30,30
1649947097486,MATH 109,A01,083213,Anzaldo; Leesa B,13,0,30,17
1649947097486,MATH 109,A02,083214,Anzaldo; Leesa B,9,0,30,21
1649947097486,MATH 109,B01,083215,Anzaldo; Leesa B,26,0,30,4
1649947097486,MATH 109,B02,083216,Anzaldo; Leesa B,22,0,30,8
1649947103511,MATH 142A,A01,083219,Chow; Bennett,0,2,30,30
1649947103511,MATH 142A,A02,083220,Chow; Bennett,8,0,30,22
1649947103511,MATH 142A,B01,083221,Chow; Bennett,0,0,30,30
1649947103511,MATH 142A,B02,083222,Chow; Bennett,1,0,30,29
1649947109539,MATH 193A,A01,083224,Staff,0,3,30,30
1649947109539,MATH 193A,A02,083225,Staff,0,3,30,30
1649947109539,MATH 193A,A03,083781,Staff,4,0,30,26
1649947109539,MATH 193A,A04,083782,Staff,16,0,30,14
1649947115563,MATH 197,001,091859,McAuley; Julian John,9999,0,9999,0
1649947121622,COGS 9,A01,083615,Staff,16,0,60,44
1649947127646,COGS 11,A01,083617,Boyle; Mary E. T.,35,0,40,5
1649947133670,COGS 13,A01,083071,Staff,0,11,40,40
1649947139704,COGS 14A,A01,092681,Staff,65,0,100,35
1649947145733,COGS 14B,A01,083073,Cheng; Tzu-Han,24,0,50,26
1649947151760,COGS 17,A01,092677,Staff,63,0,75,12
1649947157784,COGS 100,A01,083619,Staff,0,5,60,60
1649947163806,COGS 101A,A01,083621,Davis; Joshua Daniel,0,8,60,60
1649947169834,COGS 101B,A01,091572,Staff,31,0,60,29
1649947175858,COGS 101C,A01,083625,Delgado; Tania,24,0,30,6
1649947181882,COGS 107A,A01,083627,Boyle; Mary E. T.,14,0,60,46
1649947187907,COGS 118A,A01,083075,Staff,21,0,60,39
1649947193934,CSE 3,A50,083646,Miranda; Gregory Joseph,24,0,38,14
1649947193934,CSE 3,A51,083647,Miranda; Gregory Joseph,37,0,37,0
1649947199969,CSE 8A,A50,083650,Miranda; Gregory Joseph,8,0,40,32
1649947206009,CSE 11,A01,083080,Cao; Yingjun,0,26,40,40
1649947212030,CSE 12,A01,083652,Staff,56,0,100,44
1649947218053,CSE 15L,A01,083654,Staff,19,0,50,31
1649947218053,CSE 15L,A02,083655,Staff,47,0,50,3
1649947224099,CSE 20,A01,083657,Staff,68,0,80,12
1649947230122,CSE 30,A01,083084,Eldon; John,0,24,40,40
1649947236145,CSE 100,A01,083659,Cao; Yingjun,1,27,50,49
1649947242169,CSE 134B,A01,083661,Powell; Thomas Allan,0,21,65,65
1649947248194,CSE 140,A01,083663,Staff,24,0,75,51
1649947254224,CSE 140L,A01,083088,Eldon; John,18,0,75,57
1649947260257,CSE 175,A01,083665,Kumar; Rakesh,12,0,25,13
1649947266286,CSE 190,A00,092507,Dubnov; Shlomo,14,0,15,1
1649947272314,ECE 45,A01,083139,Staff,5,0,40,35
1649947278345,ECE 65,A50,083695,Staff,7,0,30,23
1649947284371,ECE 109,A01,091882,Touri; Behrouz,55,0,70,15
1649947290396,ECE 180,A00,083140,Abi Samra; Nicholas Camill,26,0,30,4
1649947290396,ECE 180,B00,083141,Abi Samra; Nicholas Camill,13,0,30,17
1649947296430,MATH 10A,A01,083735,Patchell; Gregory David,20,0,30,10
1649947296430,MATH 10A,A02,083736,Patchell; Gregory David,28,0,30,2
1649947296430,MATH 10A,A03,083737,Patchell; Gregory David,28,0,30,2
1649947302457,MATH 10B,A01,083207,Staff,10,0,30,20
1649947302457,MATH 10B,A02,083208,Staff,25,0,30,5
1649947302457,MATH 10B,B01,083739,Staff,25,0,30,5
1649947302457,MATH 10B,B02,083740,Staff,30,0,30,0
1649947308487,MATH 18,A01,083743,Staff,22,0,30,8
1649947308487,MATH 18,A02,083744,Staff,29,0,30,1
1649947308487,MATH 18,A03,083745,Staff,29,0,30,1
1649947308487,MATH 18,A04,083746,Staff,28,0,30,2
1649947308487,MATH 18,B01,083748,Staff,5,0,30,25
1649947308487,MATH 18,B02,083749,Staff,26,0,30,4
1649947308487,MATH 18,B03,083750,Staff,28,0,30,2
1649947308487,MATH 18,B04,083751,Staff,26,0,30,4
1649947314521,MATH 20A,A01,083754,Staff,37,0,40,3
1649947320560,MATH 20B,A01,083756,Staff,19,0,30,11
1649947320560,MATH 20B,A02,083757,Staff,30,0,30,0
1649947326591,MATH 20C,A01,083760,Staff,22,0,30,8
1649947326591,MATH 20C,A02,083761,Staff,23,0,30,7
1649947326591,MATH 20C,B01,083762,Staff,28,0,30,2
1649947326591,MATH 20C,B02,083763,Staff,30,0,30,0
1649947332616,MATH 20D,A01,083765,Staff,20,0,30,10
1649947332616,MATH 20D,A02,083766,Staff,30,0,30,0
1649947332616,MATH 20D,A03,083767,Staff,30,0,30,0
1649947338638,MATH 20E,A01,083771,Staff,12,0,30,18
1649947338638,MATH 20E,A02,083772,Staff,24,0,30,6
1649947338638,MATH 20E,B01,083773,Staff,17,0,30,13
1649947338638,MATH 20E,B02,083774,Staff,29,0,30,1
1649947344662,MATH 103A,A01,083777,Staff,1,4,30,29
1649947344662,MATH 103A,A02,083778,Staff,0,3,30,30
1649947344662,MATH 103A,B01,083779,Staff,0,0,30,30
1649947344662,MATH 103A,B02,083780,Staff,16,0,30,14
1649947350697,MATH 105,A01,085443,Staff,0,6,30,30
1649947356723,MATH 109,A01,083213,Anzaldo; Leesa B,13,0,30,17
1649947356723,MATH 109,A02,083214,Anzaldo; Leesa B,9,0,30,21
1649947356723,MATH 109,B01,083215,Anzaldo; Leesa B,26,0,30,4
1649947356723,MATH 109,B02,083216,Anzaldo; Leesa B,22,0,30,8
1649947362755,MATH 142A,A01,083219,Chow; Bennett,0,2,30,30
1649947362755,MATH 142A,A02,083220,Chow; Bennett,8,0,30,22
1649947362755,MATH 142A,B01,083221,Chow; Bennett,0,0,30,30
1649947362755,MATH 142A,B02,083222,Chow; Bennett,1,0,30,29
1649947368782,MATH 193A,A01,083224,Staff,0,3,30,30
1649947368782,MATH 193A,A02,083225,Staff,0,3,30,30
1649947368782,MATH 193A,A03,083781,Staff,4,0,30,26
1649947368782,MATH 193A,A04,083782,Staff,16,0,30,14
1649947374805,MATH 197,001,091859,McAuley; Julian John,9999,0,9999,0
1649947380870,COGS 9,A01,083615,Staff,16,0,60,44
1649947386897,COGS 11,A01,083617,Boyle; Mary E. T.,35,0,40,5
1649947392919,COGS 13,A01,083071,Staff,0,11,40,40
1649947398943,COGS 14A,A01,092681,Staff,65,0,100,35
1649947404966,COGS 14B,A01,083073,Cheng; Tzu-Han,24,0,50,26
1649947411003,COGS 17,A01,092677,Staff,63,0,75,12
1649947417025,COGS 100,A01,083619,Staff,0,5,60,60
1649947423050,COGS 101A,A01,083621,Davis; Joshua Daniel,0,8,60,60
1649947429078,COGS 101B,A01,091572,Staff,31,0,60,29
1649947435105,COGS 101C,A01,083625,Delgado; Tania,24,0,30,6
1649947441134,COGS 107A,A01,083627,Boyle; Mary E. T.,14,0,60,46
1649947447161,COGS 118A,A01,083075,Staff,21,0,60,39
1649947453187,CSE 3,A50,083646,Miranda; Gregory Joseph,24,0,38,14
1649947453187,CSE 3,A51,083647,Miranda; Gregory Joseph,37,0,37,0
1649947459212,CSE 8A,A50,083650,Miranda; Gregory Joseph,8,0,40,32
1649947465242,CSE 11,A01,083080,Cao; Yingjun,0,26,40,40
1649947471268,CSE 12,A01,083652,Staff,56,0,100,44
1649947477294,CSE 15L,A01,083654,Staff,19,0,50,31
1649947477294,CSE 15L,A02,083655,Staff,47,0,50,3
1649947483318,CSE 20,A01,083657,Staff,68,0,80,12
1649947489365,CSE 30,A01,083084,Eldon; John,0,24,40,40
1649947495393,CSE 100,A01,083659,Cao; Yingjun,1,27,50,49
1649947501417,CSE 134B,A01,083661,Powell; Thomas Allan,0,21,65,65
1649947507458,CSE 140,A01,083663,Staff,24,0,75,51
1649947513493,CSE 140L,A01,083088,Eldon; John,18,0,75,57
1649947519520,CSE 175,A01,083665,Kumar; Rakesh,12,0,25,13
1649947525547,CSE 190,A00,092507,Dubnov; Shlomo,14,0,15,1
1649947531572,ECE 45,A01,083139,Staff,5,0,40,35
1649947537600,ECE 65,A50,083695,Staff,7,0,30,23
1649947543626,ECE 109,A01,091882,Touri; Behrouz,55,0,70,15
1649947549651,ECE 180,A00,083140,Abi Samra; Nicholas Camill,26,0,30,4
1649947549651,ECE 180,B00,083141,Abi Samra; Nicholas Camill,13,0,30,17
1649947555683,MATH 10A,A01,083735,Patchell; Gregory David,20,0,30,10
1649947555683,MATH 10A,A02,083736,Patchell; Gregory David,28,0,30,2
1649947555683,MATH 10A,A03,083737,Patchell; Gregory David,28,0,30,2
1649947561706,MATH 10B,A01,083207,Staff,10,0,30,20
1649947561706,MATH 10B,A02,083208,Staff,25,0,30,5
1649947561706,MATH 10B,B01,083739,Staff,25,0,30,5
1649947561706,MATH 10B,B02,083740,Staff,30,0,30,0
1649947567731,MATH 18,A01,083743,Staff,22,0,30,8
1649947567731,MATH 18,A02,083744,Staff,29,0,30,1
1649947567731,MATH 18,A03,083745,Staff,29,0,30,1
1649947567731,MATH 18,A04,083746,Staff,28,0,30,2
1649947567731,MATH 18,B01,083748,Staff,5,0,30,25
1649947567731,MATH 18,B02,083749,Staff,26,0,30,4
1649947567731,MATH 18,B03,083750,Staff,28,0,30,2
1649947567731,MATH 18,B04,083751,Staff,26,0,30,4
1649947573754,MATH 20A,A01,083754,Staff,37,0,40,3
1649947579780,MATH 20B,A01,083756,Staff,19,0,30,11
1649947579780,MATH 20B,A02,083757,Staff,30,0,30,0
1649947585809,MATH 20C,A01,083760,Staff,22,0,30,8
1649947585809,MATH 20C,A02,083761,Staff,23,0,30,7
1649947585809,MATH 20C,B01,083762,Staff,28,0,30,2
1649947585809,MATH 20C,B02,083763,Staff,30,0,30,0
1649947591835,MATH 20D,A01,083765,Staff,20,0,30,10
1649947591835,MATH 20D,A02,083766,Staff,30,0,30,0
1649947591835,MATH 20D,A03,083767,Staff,30,0,30,0
1649947597935,MATH 20E,A01,083771,Staff,12,0,30,18
1649947597935,MATH 20E,A02,083772,Staff,24,0,30,6
1649947597935,MATH 20E,B01,083773,Staff,17,0,30,13
1649947597935,MATH 20E,B02,083774,Staff,29,0,30,1
1649947603967,MATH 103A,A01,083777,Staff,1,4,30,29
1649947603967,MATH 103A,A02,083778,Staff,0,3,30,30
1649947603967,MATH 103A,B01,083779,Staff,0,0,30,30
1649947603967,MATH 103A,B02,083780,Staff,16,0,30,14
1649947609991,MATH 105,A01,085443,Staff,0,6,30,30
1649947616019,MATH 109,A01,083213,Anzaldo; Leesa B,13,0,30,17
1649947616019,MATH 109,A02,083214,Anzaldo; Leesa B,9,0,30,21
1649947616019,MATH 109,B01,083215,Anzaldo; Leesa B,26,0,30,4
1649947616019,MATH 109,B02,083216,Anzaldo; Leesa B,22,0,30,8
1649947622048,MATH 142A,A01,083219,Chow; Bennett,0,2,30,30
1649947622048,MATH 142A,A02,083220,Chow; Bennett,8,0,30,22
1649947622048,MATH 142A,B01,083221,Chow; Bennett,0,0,30,30
1649947622048,MATH 142A,B02,083222,Chow; Bennett,1,0,30,29
1649947628075,MATH 193A,A01,083224,Staff,0,3,30,30
1649947628075,MATH 193A,A02,083225,Staff,0,3,30,30
1649947628075,MATH 193A,A03,083781,Staff,4,0,30,26
1649947628075,MATH 193A,A04,083782,Staff,16,0,30,14
1649947634098,MATH 197,001,091859,McAuley; Julian John,9999,0,9999,0
1649947640165,COGS 9,A01,083615,Staff,16,0,60,44
1649947646191,COGS 11,A01,083617,Boyle; Mary E. T.,35,0,40,5
1649947652225,COGS 13,A01,083071,Staff,0,11,40,40
1649947658249,COGS 14A,A01,092681,Staff,65,0,100,35
1649947664271,COGS 14B,A01,083073,Cheng; Tzu-Han,24,0,50,26
1649947670294,COGS 17,A01,092677,Staff,63,0,75,12
1649947676320,COGS 100,A01,083619,Staff,0,5,60,60
1649947682350,COGS 101A,A01,083621,Davis; Joshua Daniel,0,8,60,60
1649947688376,COGS 101B,A01,091572,Staff,31,0,60,29
1649947694398,COGS 101C,A01,083625,Delgado; Tania,24,0,30,6
1649947700427,COGS 107A,A01,083627,Boyle; Mary E. T.,14,0,60,46
1649947706453,COGS 118A,A01,083075,Staff,21,0,60,39
1649947712476,CSE 3,A50,083646,Miranda; Gregory Joseph,24,0,38,14
1649947712476,CSE 3,A51,083647,Miranda; Gregory Joseph,37,0,37,0
1649947718499,CSE 8A,A50,083650,Miranda; Gregory Joseph,8,0,40,32
1649947724527,CSE 11,A01,083080,Cao; Yingjun,0,26,40,40
1649947730551,CSE 12,A01,083652,Staff,56,0,100,44
1649947736578,CSE 15L,A01,083654,Staff,19,0,50,31
1649947736578,CSE 15L,A02,083655,Staff,47,0,50,3
1649947742602,CSE 20,A01,083657,Staff,68,0,80,12
1649947748626,CSE 30,A01,083084,Eldon; John,0,24,40,40
1649947754660,CSE 100,A01,083659,Cao; Yingjun,1,27,50,49
1649947760691,CSE 134B,A01,083661,Powell; Thomas Allan,0,21,65,65
1649947766714,CSE 140,A01,083663,Staff,24,0,75,51
1649947772744,CSE 140L,A01,083088,Eldon; John,18,0,75,57
1649947778767,CSE 175,A01,083665,Kumar; Rakesh,12,0,25,13
1649947784791,CSE 190,A00,092507,Dubnov; Shlomo,14,0,15,1
1649947790814,ECE 45,A01,083139,Staff,5,0,40,35
1649947796839,ECE 65,A50,083695,Staff,7,0,30,23
1649947802863,ECE 109,A01,091882,Touri; Behrouz,55,0,70,15
1649947808889,ECE 180,A00,083140,Abi Samra; Nicholas Camill,26,0,30,4
1649947808889,ECE 180,B00,083141,Abi Samra; Nicholas Camill,13,0,30,17
1649947814918,MATH 10A,A01,083735,Patchell; Gregory David,20,0,30,10
1649947814918,MATH 10A,A02,083736,Patchell; Gregory David,28,0,30,2
1649947814918,MATH 10A,A03,083737,Patchell; Gregory David,28,0,30,2
1649947820951,MATH 10B,A01,083207,Staff,10,0,30,20
1649947820951,MATH 10B,A02,083208,Staff,25,0,30,5
1649947820951,MATH 10B,B01,083739,Staff,25,0,30,5
1649947820951,MATH 10B,B02,083740,Staff,30,0,30,0
1649947826974,MATH 18,A01,083743,Staff,22,0,30,8
1649947826974,MATH 18,A02,083744,Staff,29,0,30,1
1649947826974,MATH 18,A03,083745,Staff,29,0,30,1
1649947826974,MATH 18,A04,083746,Staff,28,0,30,2
1649947826974,MATH 18,B01,083748,Staff,5,0,30,25
1649947826974,MATH 18,B02,083749,Staff,26,0,30,4
1649947826974,MATH 18,B03,083750,Staff,28,0,30,2
1649947826974,MATH 18,B04,083751,Staff,26,0,30,4
1649947832999,MATH 20A,A01,083754,Staff,37,0,40,3
1649947839026,MATH 20B,A01,083756,Staff,19,0,30,11
1649947839026,MATH 20B,A02,083757,Staff,30,0,30,0
1649947845048,MATH 20C,A01,083760,Staff,22,0,30,8
1649947845048,MATH 20C,A02,083761,Staff,23,0,30,7
1649947845048,MATH 20C,B01,083762,Staff,28,0,30,2
1649947845048,MATH 20C,B02,083763,Staff,30,0,30,0
1649947851075,MATH 20D,A01,083765,Staff,20,0,30,10
1649947851075,MATH 20D,A02,083766,Staff,30,0,30,0
1649947851075,MATH 20D,A03,083767,Staff,30,0,30,0
1649947857099,MATH 20E,A01,083771,Staff,12,0,30,18
1649947857099,MATH 20E,A02,083772,Staff,24,0,30,6
1649947857099,MATH 20E,B01,083773,Staff,17,0,30,13
1649947857099,MATH 20E,B02,083774,Staff,29,0,30,1
1649947863126,MATH 103A,A01,083777,Staff,1,4,30,29
1649947863126,MATH 103A,A02,083778,Staff,0,3,30,30
1649947863126,MATH 103A,B01,083779,Staff,0,0,30,30
1649947863126,MATH 103A,B02,083780,Staff,16,0,30,14
1649947869149,MATH 105,A01,085443,Staff,0,6,30,30
1649947875172,MATH 109,A01,083213,Anzaldo; Leesa B,13,0,30,17
1649947875172,MATH 109,A02,083214,Anzaldo; Leesa B,9,0,30,21
1649947875172,MATH 109,B01,083215,Anzaldo; Leesa B,26,0,30,4
1649947875172,MATH 109,B02,083216,Anzaldo; Leesa B,22,0,30,8
1649947881200,MATH 142A,A01,083219,Chow; Bennett,0,2,30,30
1649947881200,MATH 142A,A02,083220,Chow; Bennett,8,0,30,22
1649947881200,MATH 142A,B01,083221,Chow; Bennett,0,0,30,30
1649947881200,MATH 142A,B02,083222,Chow; Bennett,1,0,30,29
1649947887222,MATH 193A,A01,083224,Staff,0,3,30,30
1649947887222,MATH 193A,A02,083225,Staff,0,3,30,30
1649947887222,MATH 193A,A03,083781,Staff,4,0,30,26
1649947887222,MATH 193A,A04,083782,Staff,16,0,30,14
1649947893248,MATH 197,001,091859,McAuley; Julian John,9999,0,9999,0
1649947899319,COGS 9,A01,083615,Staff,16,0,60,44
1649947905347,COGS 11,A01,083617,Boyle; Mary E. T.,35,0,40,5
1649947911369,COGS 13,A01,083071,Staff,0,11,40,40
1649947917392,COGS 14A,A01,092681,Staff,65,0,100,35
1649947923417,COGS 14B,A01,083073,Cheng; Tzu-Han,24,0,50,26
1649947929447,COGS 17,A01,092677,Staff,63,0,75,12
1649947935476,COGS 100,A01,083619,Staff,0,6,60,60
1649947941502,COGS 101A,A01,083621,Davis; Joshua Daniel,0,8,60,60
1649947947525,COGS 101B,A01,091572,Staff,31,0,60,29
1649947953552,COGS 101C,A01,083625,Delgado; Tania,24,0,30,6
1649947959577,COGS 107A,A01,083627,Boyle; Mary E. T.,14,0,60,46
1649947965604,COGS 118A,A01,083075,Staff,21,0,60,39
1649947971627,CSE 3,A50,083646,Miranda; Gregory Joseph,24,0,38,14
1649947971627,CSE 3,A51,083647,Miranda; Gregory Joseph,37,0,37,0
1649947977655,CSE 8A,A50,083650,Miranda; Gregory Joseph,8,0,40,32
1649947983681,CSE 11,A01,083080,Cao; Yingjun,0,26,40,40
1649947989715,CSE 12,A01,083652,Staff,56,0,100,44
1649947995737,CSE 15L,A01,083654,Staff,19,0,50,31
1649947995737,CSE 15L,A02,083655,Staff,47,0,50,3
1649948001763,CSE 20,A01,083657,Staff,68,0,80,12
1649948007786,CSE 30,A01,083084,Eldon; John,0,24,40,40
1649948013809,CSE 100,A01,083659,Cao; Yingjun,1,27,50,49
1649948019832,CSE 134B,A01,083661,Powell; Thomas Allan,0,21,65,65
1649948025855,CSE 140,A01,083663,Staff,24,0,75,51
1649948031877,CSE 140L,A01,083088,Eldon; John,18,0,75,57
1649948037912,CSE 175,A01,083665,Kumar; Rakesh,12,0,25,13
1649948043942,CSE 190,A00,092507,Dubnov; Shlomo,14,0,15,1
1649948049966,ECE 45,A01,083139,Staff,5,0,40,35
1649948055993,ECE 65,A50,083695,Staff,7,0,30,23
1649948062021,ECE 109,A01,091882,Touri; Behrouz,55,0,70,15
1649948068045,ECE 180,A00,083140,Abi Samra; Nicholas Camill,26,0,30,4
1649948068045,ECE 180,B00,083141,Abi Samra; Nicholas Camill,13,0,30,17
1649948074070,MATH 10A,A01,083735,Patchell; Gregory David,20,0,30,10
1649948074070,MATH 10A,A02,083736,Patchell; Gregory David,28,0,30,2
1649948074070,MATH 10A,A03,083737,Patchell; Gregory David,28,0,30,2
1649948080098,MATH 10B,A01,083207,Staff,10,0,30,20
1649948080098,MATH 10B,A02,083208,Staff,25,0,30,5
1649948080098,MATH 10B,B01,083739,Staff,25,0,30,5
1649948080098,MATH 10B,B02,083740,Staff,30,0,30,0
1649948086138,MATH 18,A01,083743,Staff,22,0,30,8
1649948086138,MATH 18,A02,083744,Staff,29,0,30,1
1649948086138,MATH 18,A03,083745,Staff,29,0,30,1
1649948086138,MATH 18,A04,083746,Staff,28,0,30,2
1649948086138,MATH 18,B01,083748,Staff,5,0,30,25
1649948086138,MATH 18,B02,083749,Staff,26,0,30,4
1649948086138,MATH 18,B03,083750,Staff,28,0,30,2
1649948086138,MATH 18,B04,083751,Staff,26,0,30,4
1649948092165,MATH 20A,A01,083754,Staff,37,0,40,3
1649948098200,MATH 20B,A01,083756,Staff,19,0,30,11
1649948098200,MATH 20B,A02,083757,Staff,30,0,30,0
1649948104229,MATH 20C,A01,083760,Staff,22,0,30,8
1649948104229,MATH 20C,A02,083761,Staff,23,0,30,7
1649948104229,MATH 20C,B01,083762,Staff,28,0,30,2
1649948104229,MATH 20C,B02,083763,Staff,30,0,30,0
1649948110253,MATH 20D,A01,083765,Staff,20,0,30,10
1649948110253,MATH 20D,A02,083766,Staff,30,0,30,0
1649948110253,MATH 20D,A03,083767,Staff,30,0,30,0
1649948116281,MATH 20E,A01,083771,Staff,12,0,30,18
1649948116281,MATH 20E,A02,083772,Staff,24,0,30,6
1649948116281,MATH 20E,B01,083773,Staff,17,0,30,13
1649948116281,MATH 20E,B02,083774,Staff,29,0,30,1
1649948122306,MATH 103A,A01,083777,Staff,1,4,30,29
1649948122306,MATH 103A,A02,083778,Staff,0,3,30,30
1649948122306,MATH 103A,B01,083779,Staff,0,0,30,30
1649948122306,MATH 103A,B02,083780,Staff,16,0,30,14
1649948128336,MATH 105,A01,085443,Staff,0,6,30,30
1649948134363,MATH 109,A01,083213,Anzaldo; Leesa B,13,0,30,17
1649948134363,MATH 109,A02,083214,Anzaldo; Leesa B,9,0,30,21
1649948134363,MATH 109,B01,083215,Anzaldo; Leesa B,26,0,30,4
1649948134363,MATH 109,B02,083216,Anzaldo; Leesa B,22,0,30,8
1649948140388,MATH 142A,A01,083219,Chow; Bennett,0,2,30,30
1649948140388,MATH 142A,A02,083220,Chow; Bennett,8,0,30,22
1649948140388,MATH 142A,B01,083221,Chow; Bennett,0,0,30,30
1649948140388,MATH 142A,B02,083222,Chow; Bennett,1,0,30,29
1649948146414,MATH 193A,A01,083224,Staff,0,3,30,30
1649948146414,MATH 193A,A02,083225,Staff,0,3,30,30
1649948146414,MATH 193A,A03,083781,Staff,4,0,30,26
1649948146414,MATH 193A,A04,083782,Staff,16,0,30,14
1649948152439,MATH 197,001,091859,McAuley; Julian John,9999,0,9999,0
1649948158499,COGS 9,A01,083615,Staff,16,0,60,44
1649948164533,COGS 11,A01,083617,Boyle; Mary E. T.,35,0,40,5
1649948170562,COGS 13,A01,083071,Staff,0,11,40,40
1649948176598,COGS 14A,A01,092681,Staff,65,0,100,35
1649948182625,COGS 14B,A01,083073,Cheng; Tzu-Han,24,0,50,26
1649948188738,COGS 17,A01,092677,Staff,63,0,75,12
1649948194770,COGS 100,A01,083619,Staff,0,6,60,60
1649948200793,COGS 101A,A01,083621,Davis; Joshua Daniel,0,9,60,60
1649948206820,COGS 101B,A01,091572,Staff,30,0,60,30
1649948212842,COGS 101C,A01,083625,Delgado; Tania,24,0,30,6
1649948218868,COGS 107A,A01,083627,Boyle; Mary E. T.,14,0,60,46
1649948224891,COGS 118A,A01,083075,Staff,21,0,60,39
1649948230923,CSE 3,A50,083646,Miranda; Gregory Joseph,24,0,38,14
1649948230923,CSE 3,A51,083647,Miranda; Gregory Joseph,37,0,37,0
1649948236958,CSE 8A,A50,083650,Miranda; Gregory Joseph,8,0,40,32
1649948242982,CSE 11,A01,083080,Cao; Yingjun,0,27,40,40
1649948249015,CSE 12,A01,083652,Staff,56,0,100,44
1649948255043,CSE 15L,A01,083654,Staff,19,0,50,31
1649948255043,CSE 15L,A02,083655,Staff,47,0,50,3
1649948261064,CSE 20,A01,083657,Staff,68,0,80,12
1649948267086,CSE 30,A01,083084,Eldon; John,0,24,40,40
1649948273129,CSE 100,A01,083659,Cao; Yingjun,1,27,50,49
1649948279158,CSE 134B,A01,083661,Powell; Thomas Allan,0,21,65,65
1649948285181,CSE 140,A01,083663,Staff,24,0,75,51
1649948291204,CSE 140L,A01,083088,Eldon; John,18,0,75,57
1649948297229,CSE 175,A01,083665,Kumar; Rakesh,12,0,25,13
1649948303254,CSE 190,A00,092507,Dubnov; Shlomo,14,0,15,1
1649948309278,ECE 45,A01,083139,Staff,5,0,40,35
1649948315299,ECE 65,A50,083695,Staff,7,0,30,23
1649948321324,ECE 109,A01,091882,Touri; Behrouz,55,0,70,15
1649948327366,ECE 180,A00,083140,Abi Samra; Nicholas Camill,26,0,30,4
1649948327366,ECE 180,B00,083141,Abi Samra; Nicholas Camill,13,0,30,17
1649948333397,MATH 10A,A01,083735,Patchell; Gregory David,20,0,30,10
1649948333397,MATH 10A,A02,083736,Patchell; Gregory David,28,0,30,2
1649948333397,MATH 10A,A03,083737,Patchell; Gregory David,28,0,30,2
1649948339423,MATH 10B,A01,083207,Staff,10,0,30,20
1649948339423,MATH 10B,A02,083208,Staff,25,0,30,5
1649948339423,MATH 10B,B01,083739,Staff,25,0,30,5
1649948339423,MATH 10B,B02,083740,Staff,30,0,30,0
1649948345449,MATH 18,A01,083743,Staff,22,0,30,8
1649948345449,MATH 18,A02,083744,Staff,29,0,30,1
1649948345449,MATH 18,A03,083745,Staff,29,0,30,1
1649948345449,MATH 18,A04,083746,Staff,28,0,30,2
1649948345449,MATH 18,B01,083748,Staff,5,0,30,25
1649948345449,MATH 18,B02,083749,Staff,26,0,30,4
1649948345449,MATH 18,B03,083750,Staff,28,0,30,2
1649948345449,MATH 18,B04,083751,Staff,26,0,30,4
1649948351472,MATH 20A,A01,083754,Staff,37,0,40,3
1649948357494,MATH 20B,A01,083756,Staff,19,0,30,11
1649948357494,MATH 20B,A02,083757,Staff,30,0,30,0
1649948363518,MATH 20C,A01,083760,Staff,22,0,30,8
1649948363518,MATH 20C,A02,083761,Staff,23,0,30,7
1649948363518,MATH 20C,B01,083762,Staff,28,0,30,2
1649948363518,MATH 20C,B02,083763,Staff,30,0,30,0
1649948369546,MATH 20D,A01,083765,Staff,20,0,30,10
1649948369546,MATH 20D,A02,083766,Staff,30,0,30,0
1649948369546,MATH 20D,A03,083767,Staff,30,0,30,0
1649948375580,MATH 20E,A01,083771,Staff,12,0,30,18
1649948375580,MATH 20E,A02,083772,Staff,24,0,30,6
1649948375580,MATH 20E,B01,083773,Staff,17,0,30,13
1649948375580,MATH 20E,B02,083774,Staff,29,0,30,1
1649948381608,MATH 103A,A01,083777,Staff,1,4,30,29
1649948381608,MATH 103A,A02,083778,Staff,0,3,30,30
1649948381608,MATH 103A,B01,083779,Staff,0,0,30,30
1649948381608,MATH 103A,B02,083780,Staff,16,0,30,14
1649948387630,MATH 105,A01,085443,Staff,0,6,30,30
1649948393654,MATH 109,A01,083213,Anzaldo; Leesa B,13,0,30,17
1649948393654,MATH 109,A02,083214,Anzaldo; Leesa B,9,0,30,21
1649948393654,MATH 109,B01,083215,Anzaldo; Leesa B,26,0,30,4
1649948393654,MATH 109,B02,083216,Anzaldo; Leesa B,22,0,30,8
1649948399682,MATH 142A,A01,083219,Chow; Bennett,0,2,30,30
1649948399682,MATH 142A,A02,083220,Chow; Bennett,8,0,30,22
1649948399682,MATH 142A,B01,083221,Chow; Bennett,0,0,30,30
1649948399682,MATH 142A,B02,083222,Chow; Bennett,1,0,30,29
1649948405716,MATH 193A,A01,083224,Staff,0,3,30,30
1649948405716,MATH 193A,A02,083225,Staff,0,3,30,30
1649948405716,MATH 193A,A03,083781,Staff,4,0,30,26
1649948405716,MATH 193A,A04,083782,Staff,16,0,30,14
1649948411742,MATH 197,001,091859,McAuley; Julian John,9999,0,9999,0
1649948417801,COGS 9,A01,083615,Staff,16,0,60,44
1649948423823,COGS 11,A01,083617,Boyle; Mary E. T.,35,0,40,5
1649948429858,COGS 13,A01,083071,Staff,0,11,40,40
1649948435887,COGS 14A,A01,092681,Staff,65,0,100,35
1649948441911,COGS 14B,A01,083073,Cheng; Tzu-Han,24,0,50,26
1649948447934,COGS 17,A01,092677,Staff,63,0,75,12
1649948453955,COGS 100,A01,083619,Staff,0,6,60,60
1649948459983,COGS 101A,A01,083621,Davis; Joshua Daniel,0,9,60,60
1649948466007,COGS 101B,A01,091572,Staff,29,0,60,31
1649948472034,COGS 101C,A01,083625,Delgado; Tania,24,0,30,6
1649948478058,COGS 107A,A01,083627,Boyle; Mary E. T.,14,0,60,46
1649948484084,COGS 118A,A01,083075,Staff,21,0,60,39
1649948490109,CSE 3,A50,083646,Miranda; Gregory Joseph,24,0,38,14
1649948490109,CSE 3,A51,083647,Miranda; Gregory Joseph,37,0,37,0
1649948496134,CSE 8A,A50,083650,Miranda; Gregory Joseph,8,0,40,32
1649948502167,CSE 11,A01,083080,Cao; Yingjun,0,28,40,40
1649948508192,CSE 12,A01,083652,Staff,55,0,100,45
1649948514216,CSE 15L,A01,083654,Staff,18,0,50,32
1649948514216,CSE 15L,A02,083655,Staff,47,0,50,3
1649948520242,CSE 20,A01,083657,Staff,68,0,80,12
1649948526265,CSE 30,A01,083084,Eldon; John,0,25,40,40
1649948532287,CSE 100,A01,083659,Cao; Yingjun,1,28,50,49
1649948538317,CSE 134B,A01,083661,Powell; Thomas Allan,0,21,65,65
1649948544341,CSE 140,A01,083663,Staff,23,0,75,52
1649948550364,CSE 140L,A01,083088,Eldon; John,17,0,75,58
1649948556390,CSE 175,A01,083665,Kumar; Rakesh,12,0,25,13
1649948562416,CSE 190,A00,092507,Dubnov; Shlomo,14,0,15,1
1649948568439,ECE 45,A01,083139,Staff,5,0,40,35
1649948574467,ECE 65,A50,083695,Staff,7,0,30,23
1649948580491,ECE 109,A01,091882,Touri; Behrouz,55,0,70,15
1649948586518,ECE 180,A00,083140,Abi Samra; Nicholas Camill,26,0,30,4
1649948586518,ECE 180,B00,083141,Abi Samra; Nicholas Camill,13,0,30,17
1649948592545,MATH 10A,A01,083735,Patchell; Gregory David,20,0,30,10
1649948592545,MATH 10A,A02,083736,Patchell; Gregory David,28,0,30,2
1649948592545,MATH 10A,A03,083737,Patchell; Gregory David,28,0,30,2
1649948598569,MATH 10B,A01,083207,Staff,10,0,30,20
1649948598569,MATH 10B,A02,083208,Staff,25,0,30,5
1649948598569,MATH 10B,B01,083739,Staff,25,0,30,5
1649948598569,MATH 10B,B02,083740,Staff,30,0,30,0
1649948604596,MATH 18,A01,083743,Staff,22,0,30,8
1649948604596,MATH 18,A02,083744,Staff,29,0,30,1
1649948604596,MATH 18,A03,083745,Staff,29,0,30,1
1649948604596,MATH 18,A04,083746,Staff,28,0,30,2
1649948604596,MATH 18,B01,083748,Staff,5,0,30,25
1649948604596,MATH 18,B02,083749,Staff,26,0,30,4
1649948604596,MATH 18,B03,083750,Staff,28,0,30,2
1649948604596,MATH 18,B04,083751,Staff,26,0,30,4
1649948610618,MATH 20A,A01,083754,Staff,37,0,40,3
1649948616645,MATH 20B,A01,083756,Staff,19,0,30,11
1649948616645,MATH 20B,A02,083757,Staff,30,0,30,0
1649948622670,MATH 20C,A01,083760,Staff,22,0,30,8
1649948622670,MATH 20C,A02,083761,Staff,23,0,30,7
1649948622670,MATH 20C,B01,083762,Staff,28,0,30,2
1649948622670,MATH 20C,B02,083763,Staff,30,0,30,0
1649948628695,MATH 20D,A01,083765,Staff,19,0,30,11
1649948628695,MATH 20D,A02,083766,Staff,30,0,30,0
1649948628695,MATH 20D,A03,083767,Staff,30,0,30,0
1649948634733,MATH 20E,A01,083771,Staff,12,0,30,18
1649948634733,MATH 20E,A02,083772,Staff,24,0,30,6
1649948634733,MATH 20E,B01,083773,Staff,16,0,30,14
1649948634733,MATH 20E,B02,083774,Staff,29,0,30,1
1649948640760,MATH 103A,A01,083777,Staff,1,4,30,29
1649948640760,MATH 103A,A02,083778,Staff,0,4,30,30
1649948640760,MATH 103A,B01,083779,Staff,0,0,30,30
1649948640760,MATH 103A,B02,083780,Staff,16,0,30,14
1649948646783,MATH 105,A01,085443,Staff,0,6,30,30
1649948652814,MATH 109,A01,083213,Anzaldo; Leesa B,13,0,30,17
1649948652814,MATH 109,A02,083214,Anzaldo; Leesa B,9,0,30,21
1649948652814,MATH 109,B01,083215,Anzaldo; Leesa B,26,0,30,4
1649948652814,MATH 109,B02,083216,Anzaldo; Leesa B,22,0,30,8
1649948658842,MATH 142A,A01,083219,Chow; Bennett,0,2,30,30
1649948658842,MATH 142A,A02,083220,Chow; Bennett,8,0,30,22
1649948658842,MATH 142A,B01,083221,Chow; Bennett,0,0,30,30
1649948658842,MATH 142A,B02,083222,Chow; Bennett,0,0,30,30
1649948664867,MATH 193A,A01,083224,Staff,0,4,30,30
1649948664867,MATH 193A,A02,083225,Staff,0,3,30,30
1649948664867,MATH 193A,A03,083781,Staff,4,0,30,26
1649948664867,MATH 193A,A04,083782,Staff,15,0,30,15
1649948670892,MATH 197,001,091859,McAuley; Julian John,9999,0,9999,0
1649948676953,COGS 9,A01,083615,Staff,16,0,60,44
1649948682977,COGS 11,A01,083617,Boyle; Mary E. T.,35,0,40,5
1649948689004,COGS 13,A01,083071,Staff,0,11,40,40
1649948695028,COGS 14A,A01,092681,Staff,65,0,100,35
1649948701052,COGS 14B,A01,083073,Cheng; Tzu-Han,24,0,50,26
1649948707087,COGS 17,A01,092677,Staff,63,0,75,12
1649948713115,COGS 100,A01,083619,Staff,0,6,60,60
1649948719153,COGS 101A,A01,083621,Davis; Joshua Daniel,0,9,60,60
1649948725177,COGS 101B,A01,091572,Staff,29,0,60,31
1649948731202,COGS 101C,A01,083625,Delgado; Tania,23,0,30,7
1649948737229,COGS 107A,A01,083627,Boyle; Mary E. T.,13,0,60,47
1649948743255,COGS 118A,A01,083075,Staff,21,0,60,39
1649948749280,CSE 3,A50,083646,Miranda; Gregory Joseph,24,0,38,14
1649948749280,CSE 3,A51,083647,Miranda; Gregory Joseph,37,0,37,0
1649948755307,CSE 8A,A50,083650,Miranda; Gregory Joseph,7,0,40,33
1649948761334,CSE 11,A01,083080,Cao; Yingjun,0,28,40,40
1649948767357,CSE 12,A01,083652,Staff,55,0,100,45
1649948773384,CSE 15L,A01,083654,Staff,18,0,50,32
1649948773384,CSE 15L,A02,083655,Staff,47,0,50,3
1649948779409,CSE 20,A01,083657,Staff,68,0,80,12
1649948785523,CSE 30,A01,083084,Eldon; John,0,25,40,40
1649948791544,CSE 100,A01,083659,Cao; Yingjun,1,29,50,49
1649948797568,CSE 134B,A01,083661,Powell; Thomas Allan,0,21,65,65
1649948803594,CSE 140,A01,083663,Staff,23,0,75,52
1649948809627,CSE 140L,A01,083088,Eldon; John,17,0,75,58
1649948815651,CSE 175,A01,083665,Kumar; Rakesh,12,0,25,13
1649948821674,CSE 190,A00,092507,Dubnov; Shlomo,14,0,15,1
1649948827698,ECE 45,A01,083139,Staff,5,0,40,35
1649948833722,ECE 65,A50,083695,Staff,7,0,30,23
1649948839750,ECE 109,A01,091882,Touri; Behrouz,55,0,70,15
1649948845778,ECE 180,A00,083140,Abi Samra; Nicholas Camill,26,0,30,4
1649948845778,ECE 180,B00,083141,Abi Samra; Nicholas Camill,13,0,30,17
1649948851801,MATH 10A,A01,083735,Patchell; Gregory David,20,0,30,10
1649948851801,MATH 10A,A02,083736,Patchell; Gregory David,28,0,30,2
1649948851801,MATH 10A,A03,083737,Patchell; Gregory David,28,0,30,2
1649948857828,MATH 10B,A01,083207,Staff,10,0,30,20
1649948857828,MATH 10B,A02,083208,Staff,25,0,30,5
1649948857828,MATH 10B,B01,083739,Staff,25,0,30,5
1649948857828,MATH 10B,B02,083740,Staff,30,0,30,0
1649948863860,MATH 18,A01,083743,Staff,22,0,30,8
1649948863860,MATH 18,A02,083744,Staff,29,0,30,1
1649948863860,MATH 18,A03,083745,Staff,29,0,30,1
1649948863860,MATH 18,A04,083746,Staff,28,0,30,2
1649948863860,MATH 18,B01,083748,Staff,5,0,30,25
1649948863860,MATH 18,B02,083749,Staff,26,0,30,4
1649948863860,MATH 18,B03,083750,Staff,28,0,30,2
1649948863860,MATH 18,B04,083751,Staff,26,0,30,4
1649948869889,MATH 20A,A01,083754,Staff,37,0,40,3
1649948875911,MATH 20B,A01,083756,Staff,19,0,30,11
1649948875911,MATH 20B,A02,083757,Staff,30,0,30,0
1649948881935,MATH 20C,A01,083760,Staff,22,0,30,8
1649948881935,MATH 20C,A02,083761,Staff,23,0,30,7
1649948881935,MATH 20C,B01,083762,Staff,28,0,30,2
1649948881935,MATH 20C,B02,083763,Staff,30,0,30,0
1649948887962,MATH 20D,A01,083765,Staff,19,0,30,11
1649948887962,MATH 20D,A02,083766,Staff,30,0,30,0
1649948887962,MATH 20D,A03,083767,Staff,30,0,30,0
1649948893989,MATH 20E,A01,083771,Staff,12,0,30,18
1649948893989,MATH 20E,A02,083772,Staff,24,0,30,6
1649948893989,MATH 20E,B01,083773,Staff,16,0,30,14
1649948893989,MATH 20E,B02,083774,Staff,29,0,30,1
1649948900016,MATH 103A,A01,083777,Staff,1,4,30,29
1649948900016,MATH 103A,A02,083778,Staff,0,4,30,30
1649948900016,MATH 103A,B01,083779,Staff,0,1,30,30
1649948900016,MATH 103A,B02,083780,Staff,16,0,30,14
1649948906040,MATH 105,A01,085443,Staff,0,6,30,30
1649948912067,MATH 109,A01,083213,Anzaldo; Leesa B,13,0,30,17
1649948912067,MATH 109,A02,083214,Anzaldo; Leesa B,9,0,30,21
1649948912067,MATH 109,B01,083215,Anzaldo; Leesa B,26,0,30,4
1649948912067,MATH 109,B02,083216,Anzaldo; Leesa B,22,0,30,8
1649948918109,MATH 142A,A01,083219,Chow; Bennett,0,2,30,30
1649948918109,MATH 142A,A02,083220,Chow; Bennett,8,0,30,22
1649948918109,MATH 142A,B01,083221,Chow; Bennett,0,0,30,30
1649948918109,MATH 142A,B02,083222,Chow; Bennett,0,0,30,30
1649948924133,MATH 193A,A01,083224,Staff,0,4,30,30
1649948924133,MATH 193A,A02,083225,Staff,0,3,30,30
1649948924133,MATH 193A,A03,083781,Staff,4,0,30,26
1649948924133,MATH 193A,A04,083782,Staff,15,0,30,15
1649948930170,MATH 197,001,091859,McAuley; Julian John,9999,0,9999,0
1649948936235,COGS 9,A01,083615,Staff,16,0,60,44
1649948942258,COGS 11,A01,083617,Boyle; Mary E. T.,35,0,40,5
1649948948280,COGS 13,A01,083071,Staff,0,11,40,40
1649948954310,COGS 14A,A01,092681,Staff,65,0,100,35
1649948960335,COGS 14B,A01,083073,Cheng; Tzu-Han,24,0,50,26
1649948966360,COGS 17,A01,092677,Staff,63,0,75,12
1649948972382,COGS 100,A01,083619,Staff,0,6,60,60
1649948978407,COGS 101A,A01,083621,Davis; Joshua Daniel,0,9,60,60
1649948984433,COGS 101B,A01,091572,Staff,29,0,60,31
1649948990456,COGS 101C,A01,083625,Delgado; Tania,23,0,30,7
1649948996479,COGS 107A,A01,083627,Boyle; Mary E. T.,13,0,60,47
1649949002503,COGS 118A,A01,083075,Staff,21,0,60,39
1649949008535,CSE 3,A50,083646,Miranda; Gregory Joseph,24,0,38,14
1649949008535,CSE 3,A51,083647,Miranda; Gregory Joseph,37,0,37,0
1649949014570,CSE 8A,A50,083650,Miranda; Gregory Joseph,7,0,40,33
1649949020593,CSE 11,A01,083080,Cao; Yingjun,0,28,40,40
1649949026616,CSE 12,A01,083652,Staff,55,0,100,45
1649949032640,CSE 15L,A01,083654,Staff,18,0,50,32
1649949032640,CSE 15L,A02,083655,Staff,47,0,50,3
1649949038662,CSE 20,A01,083657,Staff,68,0,80,12
1649949044689,CSE 30,A01,083084,Eldon; John,0,25,40,40
1649949050711,CSE 100,A01,083659,Cao; Yingjun,1,29,50,49
1649949056739,CSE 134B,A01,083661,Powell; Thomas Allan,0,21,65,65
1649949062762,CSE 140,A01,083663,Staff,23,0,75,52
1649949068791,CSE 140L,A01,083088,Eldon; John,17,0,75,58
1649949074814,CSE 175,A01,083665,Kumar; Rakesh,12,0,25,13
1649949080837,CSE 190,A00,092507,Dubnov; Shlomo,14,0,15,1
1649949086875,ECE 45,A01,083139,Staff,5,0,40,35
1649949092898,ECE 65,A50,083695,Staff,7,0,30,23
1649949098922,ECE 109,A01,091882,Touri; Behrouz,55,0,70,15
1649949104945,ECE 180,A00,083140,Abi Samra; Nicholas Camill,26,0,30,4
1649949104945,ECE 180,B00,083141,Abi Samra; Nicholas Camill,13,0,30,17
1649949110971,MATH 10A,A01,083735,Patchell; Gregory David,20,0,30,10
1649949110971,MATH 10A,A02,083736,Patchell; Gregory David,28,0,30,2
1649949110971,MATH 10A,A03,083737,Patchell; Gregory David,28,0,30,2
1649949117002,MATH 10B,A01,083207,Staff,10,0,30,20
1649949117002,MATH 10B,A02,083208,Staff,25,0,30,5
1649949117002,MATH 10B,B01,083739,Staff,25,0,30,5
1649949117002,MATH 10B,B02,083740,Staff,30,0,30,0
1649949123034,MATH 18,A01,083743,Staff,22,0,30,8
1649949123034,MATH 18,A02,083744,Staff,29,0,30,1
1649949123034,MATH 18,A03,083745,Staff,29,0,30,1
1649949123034,MATH 18,A04,083746,Staff,28,0,30,2
1649949123034,MATH 18,B01,083748,Staff,4,0,30,26
1649949123034,MATH 18,B02,083749,Staff,26,0,30,4
1649949123034,MATH 18,B03,083750,Staff,28,0,30,2
1649949123034,MATH 18,B04,083751,Staff,26,0,30,4
1649949129059,MATH 20A,A01,083754,Staff,37,0,40,3
1649949135085,MATH 20B,A01,083756,Staff,19,0,30,11
1649949135085,MATH 20B,A02,083757,Staff,30,0,30,0
1649949141116,MATH 20C,A01,083760,Staff,22,0,30,8
1649949141116,MATH 20C,A02,083761,Staff,23,0,30,7
1649949141116,MATH 20C,B01,083762,Staff,28,0,30,2
1649949141116,MATH 20C,B02,083763,Staff,30,0,30,0
1649949147139,MATH 20D,A01,083765,Staff,19,0,30,11
1649949147139,MATH 20D,A02,083766,Staff,30,0,30,0
1649949147139,MATH 20D,A03,083767,Staff,30,0,30,0
1649949153166,MATH 20E,A01,083771,Staff,12,0,30,18
1649949153166,MATH 20E,A02,083772,Staff,24,0,30,6
1649949153166,MATH 20E,B01,083773,Staff,16,0,30,14
1649949153166,MATH 20E,B02,083774,Staff,29,0,30,1
1649949159192,MATH 103A,A01,083777,Staff,1,4,30,29
1649949159192,MATH 103A,A02,083778,Staff,0,4,30,30
1649949159192,MATH 103A,B01,083779,Staff,0,1,30,30
1649949159192,MATH 103A,B02,083780,Staff,16,0,30,14
1649949165217,MATH 105,A01,085443,Staff,0,6,30,30
1649949171248,MATH 109,A01,083213,Anzaldo; Leesa B,13,0,30,17
1649949171248,MATH 109,A02,083214,Anzaldo; Leesa B,9,0,30,21
1649949171248,MATH 109,B01,083215,Anzaldo; Leesa B,26,0,30,4
1649949171248,MATH 109,B02,083216,Anzaldo; Leesa B,22,0,30,8
1649949177276,MATH 142A,A01,083219,Chow; Bennett,0,2,30,30
1649949177276,MATH 142A,A02,083220,Chow; Bennett,8,0,30,22
1649949177276,MATH 142A,B01,083221,Chow; Bennett,0,0,30,30
1649949177276,MATH 142A,B02,083222,Chow; Bennett,0,0,30,30
1649949183300,MATH 193A,A01,083224,Staff,0,4,30,30
1649949183300,MATH 193A,A02,083225,Staff,0,3,30,30
1649949183300,MATH 193A,A03,083781,Staff,4,0,30,26
1649949183300,MATH 193A,A04,083782,Staff,15,0,30,15
1649949189325,MATH 197,001,091859,McAuley; Julian John,9999,0,9999,0
1649949195384,COGS 9,A01,083615,Staff,16,0,60,44
1649949201415,COGS 11,A01,083617,Boyle; Mary E. T.,35,0,40,5
1649949207441,COGS 13,A01,083071,Staff,0,11,40,40
1649949213465,COGS 14A,A01,092681,Staff,65,0,100,35
1649949219489,COGS 14B,A01,083073,Cheng; Tzu-Han,24,0,50,26
1649949225511,COGS 17,A01,092677,Staff,63,0,75,12
1649949231534,COGS 100,A01,083619,Staff,0,6,60,60
1649949237558,COGS 101A,A01,083621,Davis; Joshua Daniel,0,9,60,60
1649949243581,COGS 101B,A01,091572,Staff,29,0,60,31
1649949249617,COGS 101C,A01,083625,Delgado; Tania,23,0,30,7
1649949255647,COGS 107A,A01,083627,Boyle; Mary E. T.,13,0,60,47
1649949261673,COGS 118A,A01,083075,Staff,21,0,60,39
1649949267701,CSE 3,A50,083646,Miranda; Gregory Joseph,24,0,38,14
1649949267701,CSE 3,A51,083647,Miranda; Gregory Joseph,37,0,37,0
1649949273725,CSE 8A,A50,083650,Miranda; Gregory Joseph,7,0,40,33
1649949279758,CSE 11,A01,083080,Cao; Yingjun,0,28,40,40
1649949285788,CSE 12,A01,083652,Staff,54,0,100,46
1649949291822,CSE 15L,A01,083654,Staff,18,0,50,32
1649949291822,CSE 15L,A02,083655,Staff,46,0,50,4
1649949297861,CSE 20,A01,083657,Staff,68,0,80,12
1649949303886,CSE 30,A01,083084,Eldon; John,0,25,40,40
1649949309912,CSE 100,A01,083659,Cao; Yingjun,1,29,50,49
1649949315940,CSE 134B,A01,083661,Powell; Thomas Allan,0,21,65,65
1649949321963,CSE 140,A01,083663,Staff,23,0,75,52
1649949327987,CSE 140L,A01,083088,Eldon; John,17,0,75,58
1649949334014,CSE 175,A01,083665,Kumar; Rakesh,12,0,25,13
1649949340040,CSE 190,A00,092507,Dubnov; Shlomo,14,0,15,1
1649949346065,ECE 45,A01,083139,Staff,5,0,40,35
1649949352087,ECE 65,A50,083695,Staff,7,0,30,23
1649949358122,ECE 109,A01,091882,Touri; Behrouz,55,0,70,15
1649949364154,ECE 180,A00,083140,Abi Samra; Nicholas Camill,26,0,30,4
1649949364154,ECE 180,B00,083141,Abi Samra; Nicholas Camill,13,0,30,17
1649949370182,MATH 10A,A01,083735,Patchell; Gregory David,20,0,30,10
1649949370182,MATH 10A,A02,083736,Patchell; Gregory David,28,0,30,2
1649949370182,MATH 10A,A03,083737,Patchell; Gregory David,28,0,30,2
1649949376206,MATH 10B,A01,083207,Staff,10,0,30,20
1649949376206,MATH 10B,A02,083208,Staff,25,0,30,5
1649949376206,MATH 10B,B01,083739,Staff,25,0,30,5
1649949376206,MATH 10B,B02,083740,Staff,30,0,30,0
1649949382326,MATH 18,A01,083743,Staff,22,0,30,8
1649949382326,MATH 18,A02,083744,Staff,29,0,30,1
1649949382326,MATH 18,A03,083745,Staff,29,0,30,1
1649949382326,MATH 18,A04,083746,Staff,28,0,30,2
1649949382326,MATH 18,B01,083748,Staff,4,0,30,26
1649949382326,MATH 18,B02,083749,Staff,26,0,30,4
1649949382326,MATH 18,B03,083750,Staff,28,0,30,2
1649949382326,MATH 18,B04,083751,Staff,26,0,30,4
1649949388350,MATH 20A,A01,083754,Staff,37,0,40,3
1649949394373,MATH 20B,A01,083756,Staff,19,0,30,11
1649949394373,MATH 20B,A02,083757,Staff,30,0,30,0
1649949400397,MATH 20C,A01,083760,Staff,22,0,30,8
1649949400397,MATH 20C,A02,083761,Staff,23,0,30,7
1649949400397,MATH 20C,B01,083762,Staff,28,0,30,2
1649949400397,MATH 20C,B02,083763,Staff,30,0,30,0
1649949406421,MATH 20D,A01,083765,Staff,19,0,30,11
1649949406421,MATH 20D,A02,083766,Staff,30,0,30,0
1649949406421,MATH 20D,A03,083767,Staff,30,0,30,0
1649949412443,MATH 20E,A01,083771,Staff,11,0,30,19
1649949412443,MATH 20E,A02,083772,Staff,24,0,30,6
1649949412443,MATH 20E,B01,083773,Staff,16,0,30,14
1649949412443,MATH 20E,B02,083774,Staff,29,0,30,1
1649949418469,MATH 103A,A01,083777,Staff,1,4,30,29
1649949418469,MATH 103A,A02,083778,Staff,0,4,30,30
1649949418469,MATH 103A,B01,083779,Staff,0,1,30,30
1649949418469,MATH 103A,B02,083780,Staff,16,0,30,14
1649949424495,MATH 105,A01,085443,Staff,0,6,30,30
1649949430532,MATH 109,A01,083213,Anzaldo; Leesa B,13,0,30,17
1649949430532,MATH 109,A02,083214,Anzaldo; Leesa B,8,0,30,22
1649949430532,MATH 109,B01,083215,Anzaldo; Leesa B,26,0,30,4
1649949430532,MATH 109,B02,083216,Anzaldo; Leesa B,22,0,30,8
1649949436556,MATH 142A,A01,083219,Chow; Bennett,0,2,30,30
1649949436556,MATH 142A,A02,083220,Chow; Bennett,8,0,30,22
1649949436556,MATH 142A,B01,083221,Chow; Bennett,0,0,30,30
1649949436556,MATH 142A,B02,083222,Chow; Bennett,0,0,30,30
1649949442580,MATH 193A,A01,083224,Staff,0,4,30,30
1649949442580,MATH 193A,A02,083225,Staff,0,3,30,30
1649949442580,MATH 193A,A03,083781,Staff,4,0,30,26
1649949442580,MATH 193A,A04,083782,Staff,15,0,30,15
1649949448602,MATH 197,001,091859,McAuley; Julian John,9999,0,9999,0
1649949454654,COGS 9,A01,083615,Staff,16,0,60,44
1649949460677,COGS 11,A01,083617,Boyle; Mary E. T.,35,0,40,5
1649949466699,COGS 13,A01,083071,Staff,0,11,40,40
1649949472725,COGS 14A,A01,092681,Staff,65,0,100,35
1649949478752,COGS 14B,A01,083073,Cheng; Tzu-Han,24,0,50,26
1649949484782,COGS 17,A01,092677,Staff,63,0,75,12
1649949490805,COGS 100,A01,083619,Staff,0,6,60,60
1649949496846,COGS 101A,A01,083621,Davis; Joshua Daniel,0,9,60,60
1649949502878,COGS 101B,A01,091572,Staff,29,0,60,31
1649949508914,COGS 101C,A01,083625,Delgado; Tania,23,0,30,7
1649949514950,COGS 107A,A01,083627,Boyle; Mary E. T.,12,0,60,48
1649949520976,COGS 118A,A01,083075,Staff,21,0,60,39
1649949526999,CSE 3,A50,083646,Miranda; Gregory Joseph,24,0,38,14
1649949526999,CSE 3,A51,083647,Miranda; Gregory Joseph,37,0,37,0
1649949533026,CSE 8A,A50,083650,Miranda; Gregory Joseph,7,0,40,33
1649949539057,CSE 11,A01,083080,Cao; Yingjun,0,28,40,40
1649949545082,CSE 12,A01,083652,Staff,54,0,100,46
1649949551107,CSE 15L,A01,083654,Staff,18,0,50,32
1649949551107,CSE 15L,A02,083655,Staff,46,0,50,4
1649949557138,CSE 20,A01,083657,Staff,68,0,80,12
1649949563159,CSE 30,A01,083084,Eldon; John,0,25,40,40
1649949569191,CSE 100,A01,083659,Cao; Yingjun,1,29,50,49
1649949575214,CSE 134B,A01,083661,Powell; Thomas Allan,0,21,65,65
1649949581235,CSE 140,A01,083663,Staff,23,0,75,52
1649949587262,CSE 140L,A01,083088,Eldon; John,17,0,75,58
1649949593284,CSE 175,A01,083665,Kumar; Rakesh,12,0,25,13
1649949599306,CSE 190,A00,092507,Dubnov; Shlomo,14,0,15,1
1649949605328,ECE 45,A01,083139,Staff,5,0,40,35
1649949611354,ECE 65,A50,083695,Staff,6,0,30,24
1649949617375,ECE 109,A01,091882,Touri; Behrouz,55,0,70,15
1649949623402,ECE 180,A00,083140,Abi Samra; Nicholas Camill,26,0,30,4
1649949623402,ECE 180,B00,083141,Abi Samra; Nicholas Camill,13,0,30,17
1649949629425,MATH 10A,A01,083735,Patchell; Gregory David,20,0,30,10
1649949629425,MATH 10A,A02,083736,Patchell; Gregory David,28,0,30,2
1649949629425,MATH 10A,A03,083737,Patchell; Gregory David,28,0,30,2
1649949635452,MATH 10B,A01,083207,Staff,10,0,30,20
1649949635452,MATH 10B,A02,083208,Staff,25,0,30,5
1649949635452,MATH 10B,B01,083739,Staff,25,0,30,5
1649949635452,MATH 10B,B02,083740,Staff,30,0,30,0
1649949641482,MATH 18,A01,083743,Staff,22,0,30,8
1649949641482,MATH 18,A02,083744,Staff,29,0,30,1
1649949641482,MATH 18,A03,083745,Staff,29,0,30,1
1649949641482,MATH 18,A04,083746,Staff,28,0,30,2
1649949641482,MATH 18,B01,083748,Staff,4,0,30,26
1649949641482,MATH 18,B02,083749,Staff,26,0,30,4
1649949641482,MATH 18,B03,083750,Staff,28,0,30,2
1649949641482,MATH 18,B04,083751,Staff,26,0,30,4
1649949647506,MATH 20A,A01,083754,Staff,37,0,40,3
1649949653528,MATH 20B,A01,083756,Staff,19,0,30,11
1649949653528,MATH 20B,A02,083757,Staff,30,0,30,0
1649949659551,MATH 20C,A01,083760,Staff,22,0,30,8
1649949659551,MATH 20C,A02,083761,Staff,23,0,30,7
1649949659551,MATH 20C,B01,083762,Staff,28,0,30,2
1649949659551,MATH 20C,B02,083763,Staff,30,0,30,0
1649949665588,MATH 20D,A01,083765,Staff,19,0,30,11
1649949665588,MATH 20D,A02,083766,Staff,30,0,30,0
1649949665588,MATH 20D,A03,083767,Staff,30,0,30,0
1649949671617,MATH 20E,A01,083771,Staff,11,0,30,19
1649949671617,MATH 20E,A02,083772,Staff,24,0,30,6
1649949671617,MATH 20E,B01,083773,Staff,16,0,30,14
1649949671617,MATH 20E,B02,083774,Staff,29,0,30,1
1649949677640,MATH 103A,A01,083777,Staff,1,4,30,29
1649949677640,MATH 103A,A02,083778,Staff,0,4,30,30
1649949677640,MATH 103A,B01,083779,Staff,0,1,30,30
1649949677640,MATH 103A,B02,083780,Staff,16,0,30,14
1649949683667,MATH 105,A01,085443,Staff,0,6,30,30
1649949689693,MATH 109,A01,083213,Anzaldo; Leesa B,13,0,30,17
1649949689693,MATH 109,A02,083214,Anzaldo; Leesa B,8,0,30,22
1649949689693,MATH 109,B01,083215,Anzaldo; Leesa B,26,0,30,4
1649949689693,MATH 109,B02,083216,Anzaldo; Leesa B,22,0,30,8
1649949695722,MATH 142A,A01,083219,Chow; Bennett,0,2,30,30
1649949695722,MATH 142A,A02,083220,Chow; Bennett,8,0,30,22
1649949695722,MATH 142A,B01,083221,Chow; Bennett,0,0,30,30
1649949695722,MATH 142A,B02,083222,Chow; Bennett,0,0,30,30
1649949701751,MATH 193A,A01,083224,Staff,0,4,30,30
1649949701751,MATH 193A,A02,083225,Staff,0,3,30,30
1649949701751,MATH 193A,A03,083781,Staff,4,0,30,26
1649949701751,MATH 193A,A04,083782,Staff,15,0,30,15
1649949707775,MATH 197,001,091859,McAuley; Julian John,9999,0,9999,0
1649949713825,COGS 9,A01,083615,Staff,16,0,60,44
1649949719849,COGS 11,A01,083617,Boyle; Mary E. T.,35,0,40,5
1649949725873,COGS 13,A01,083071,Staff,0,11,40,40
1649949731900,COGS 14A,A01,092681,Staff,65,0,100,35
1649949737922,COGS 14B,A01,083073,Cheng; Tzu-Han,23,0,50,27
1649949743945,COGS 17,A01,092677,Staff,63,0,75,12
1649949749979,COGS 100,A01,083619,Staff,0,6,60,60
1649949756005,COGS 101A,A01,083621,Davis; Joshua Daniel,0,10,60,60
1649949762032,COGS 101B,A01,091572,Staff,30,0,60,30
1649949768074,COGS 101C,A01,083625,Delgado; Tania,23,0,30,7
1649949774101,COGS 107A,A01,083627,Boyle; Mary E. T.,12,0,60,48
1649949780135,COGS 118A,A01,083075,Staff,21,0,60,39
1649949786164,CSE 3,A50,083646,Miranda; Gregory Joseph,24,0,38,14
1649949786164,CSE 3,A51,083647,Miranda; Gregory Joseph,37,0,37,0
1649949792187,CSE 8A,A50,083650,Miranda; Gregory Joseph,7,0,40,33
1649949798214,CSE 11,A01,083080,Cao; Yingjun,0,28,40,40
1649949804237,CSE 12,A01,083652,Staff,54,0,100,46
1649949810267,CSE 15L,A01,083654,Staff,18,0,50,32
1649949810267,CSE 15L,A02,083655,Staff,46,0,50,4
1649949816295,CSE 20,A01,083657,Staff,67,0,80,13
1649949822318,CSE 30,A01,083084,Eldon; John,0,25,40,40
1649949828346,CSE 100,A01,083659,Cao; Yingjun,1,29,50,49
1649949834372,CSE 134B,A01,083661,Powell; Thomas Allan,0,22,65,65
1649949840395,CSE 140,A01,083663,Staff,23,0,75,52
1649949846428,CSE 140L,A01,083088,Eldon; John,17,0,75,58
1649949852456,CSE 175,A01,083665,Kumar; Rakesh,11,0,25,14
1649949858482,CSE 190,A00,092507,Dubnov; Shlomo,14,0,15,1
1649949864506,ECE 45,A01,083139,Staff,5,0,40,35
1649949870530,ECE 65,A50,083695,Staff,6,0,30,24
1649949876555,ECE 109,A01,091882,Touri; Behrouz,55,0,70,15
1649949882579,ECE 180,A00,083140,Abi Samra; Nicholas Camill,26,0,30,4
1649949882579,ECE 180,B00,083141,Abi Samra; Nicholas Camill,13,0,30,17
1649949888608,MATH 10A,A01,083735,Patchell; Gregory David,20,0,30,10
1649949888608,MATH 10A,A02,083736,Patchell; Gregory David,28,0,30,2
1649949888608,MATH 10A,A03,083737,Patchell; Gregory David,28,0,30,2
1649949894637,MATH 10B,A01,083207,Staff,10,0,30,20
1649949894637,MATH 10B,A02,083208,Staff,25,0,30,5
1649949894637,MATH 10B,B01,083739,Staff,25,0,30,5
1649949894637,MATH 10B,B02,083740,Staff,30,0,30,0
1649949900671,MATH 18,A01,083743,Staff,22,0,30,8
1649949900671,MATH 18,A02,083744,Staff,29,0,30,1
1649949900671,MATH 18,A03,083745,Staff,29,0,30,1
1649949900671,MATH 18,A04,083746,Staff,28,0,30,2
1649949900671,MATH 18,B01,083748,Staff,4,0,30,26
1649949900671,MATH 18,B02,083749,Staff,26,0,30,4
1649949900671,MATH 18,B03,083750,Staff,28,0,30,2
1649949900671,MATH 18,B04,083751,Staff,26,0,30,4
1649949906699,MATH 20A,A01,083754,Staff,37,0,40,3
1649949912726,MATH 20B,A01,083756,Staff,19,0,30,11
1649949912726,MATH 20B,A02,083757,Staff,30,0,30,0
1649949918755,MATH 20C,A01,083760,Staff,22,0,30,8
1649949918755,MATH 20C,A02,083761,Staff,23,0,30,7
1649949918755,MATH 20C,B01,083762,Staff,27,0,30,3
1649949918755,MATH 20C,B02,083763,Staff,30,0,30,0
1649949924791,MATH 20D,A01,083765,Staff,19,0,30,11
1649949924791,MATH 20D,A02,083766,Staff,30,0,30,0
1649949924791,MATH 20D,A03,083767,Staff,30,0,30,0
1649949930828,MATH 20E,A01,083771,Staff,11,0,30,19
1649949930828,MATH 20E,A02,083772,Staff,24,0,30,6
1649949930828,MATH 20E,B01,083773,Staff,16,0,30,14
1649949930828,MATH 20E,B02,083774,Staff,29,0,30,1
1649949936856,MATH 103A,A01,083777,Staff,1,4,30,29
1649949936856,MATH 103A,A02,083778,Staff,0,4,30,30
1649949936856,MATH 103A,B01,083779,Staff,0,1,30,30
1649949936856,MATH 103A,B02,083780,Staff,16,0,30,14
1649949942882,MATH 105,A01,085443,Staff,0,6,30,30
1649949948909,MATH 109,A01,083213,Anzaldo; Leesa B,13,0,30,17
1649949948909,MATH 109,A02,083214,Anzaldo; Leesa B,8,0,30,22
1649949948909,MATH 109,B01,083215,Anzaldo; Leesa B,26,0,30,4
1649949948909,MATH 109,B02,083216,Anzaldo; Leesa B,22,0,30,8
1649949954934,MATH 142A,A01,083219,Chow; Bennett,0,2,30,30
1649949954934,MATH 142A,A02,083220,Chow; Bennett,8,0,30,22
1649949954934,MATH 142A,B01,083221,Chow; Bennett,0,0,30,30
1649949954934,MATH 142A,B02,083222,Chow; Bennett,0,0,30,30
1649949960961,MATH 193A,A01,083224,Staff,0,4,30,30
1649949960961,MATH 193A,A02,083225,Staff,0,3,30,30
1649949960961,MATH 193A,A03,083781,Staff,4,0,30,26
1649949960961,MATH 193A,A04,083782,Staff,15,0,30,15
1649949966985,MATH 197,001,091859,McAuley; Julian John,9999,0,9999,0
1649949973136,COGS 9,A01,083615,Staff,16,0,60,44
1649949979162,COGS 11,A01,083617,Boyle; Mary E. T.,35,0,40,5
1649949985188,COGS 13,A01,083071,Staff,0,11,40,40
1649949991212,COGS 14A,A01,092681,Staff,65,0,100,35
1649949997236,COGS 14B,A01,083073,Cheng; Tzu-Han,23,0,50,27
1649950003261,COGS 17,A01,092677,Staff,63,0,75,12
1649950009285,COGS 100,A01,083619,Staff,0,7,60,60
1649950015308,COGS 101A,A01,083621,Davis; Joshua Daniel,0,10,60,60
1649950021333,COGS 101B,A01,091572,Staff,30,0,60,30
1649950027361,COGS 101C,A01,083625,Delgado; Tania,23,0,30,7
1649950033395,COGS 107A,A01,083627,Boyle; Mary E. T.,11,0,60,49
1649950039427,COGS 118A,A01,083075,Staff,21,0,60,39
1649950045451,CSE 3,A50,083646,Miranda; Gregory Joseph,24,0,38,14
1649950045451,CSE 3,A51,083647,Miranda; Gregory Joseph,37,0,37,0
1649950051475,CSE 8A,A50,083650,Miranda; Gregory Joseph,7,0,40,33
1649950057499,CSE 11,A01,083080,Cao; Yingjun,0,28,40,40
1649950063533,CSE 12,A01,083652,Staff,54,0,100,46
1649950069561,CSE 15L,A01,083654,Staff,18,0,50,32
1649950069561,CSE 15L,A02,083655,Staff,46,0,50,4
1649950075585,CSE 20,A01,083657,Staff,67,0,80,13
1649950081623,CSE 30,A01,083084,Eldon; John,0,25,40,40
1649950087646,CSE 100,A01,083659,Cao; Yingjun,1,30,50,49
1649950093671,CSE 134B,A01,083661,Powell; Thomas Allan,0,22,65,65
1649950099708,CSE 140,A01,083663,Staff,23,0,75,52
1649950105733,CSE 140L,A01,083088,Eldon; John,17,0,75,58
1649950111756,CSE 175,A01,083665,Kumar; Rakesh,11,0,25,14
1649950117780,CSE 190,A00,092507,Dubnov; Shlomo,14,0,15,1
1649950123803,ECE 45,A01,083139,Staff,5,0,40,35
1649950129827,ECE 65,A50,083695,Staff,6,0,30,24
1649950135852,ECE 109,A01,091882,Touri; Behrouz,55,0,70,15
1649950141878,ECE 180,A00,083140,Abi Samra; Nicholas Camill,26,0,30,4
1649950141878,ECE 180,B00,083141,Abi Samra; Nicholas Camill,13,0,30,17
1649950147904,MATH 10A,A01,083735,Patchell; Gregory David,20,0,30,10
1649950147904,MATH 10A,A02,083736,Patchell; Gregory David,28,0,30,2
1649950147904,MATH 10A,A03,083737,Patchell; Gregory David,28,0,30,2
1649950153933,MATH 10B,A01,083207,Staff,10,0,30,20
1649950153933,MATH 10B,A02,083208,Staff,25,0,30,5
1649950153933,MATH 10B,B01,083739,Staff,25,0,30,5
1649950153933,MATH 10B,B02,083740,Staff,30,0,30,0
1649950159962,MATH 18,A01,083743,Staff,22,0,30,8
1649950159962,MATH 18,A02,083744,Staff,29,0,30,1
1649950159962,MATH 18,A03,083745,Staff,29,0,30,1
1649950159962,MATH 18,A04,083746,Staff,28,0,30,2
1649950159962,MATH 18,B01,083748,Staff,4,0,30,26
1649950159962,MATH 18,B02,083749,Staff,26,0,30,4
1649950159962,MATH 18,B03,083750,Staff,28,0,30,2
1649950159962,MATH 18,B04,083751,Staff,26,0,30,4
1649950165990,MATH 20A,A01,083754,Staff,37,0,40,3
1649950172029,MATH 20B,A01,083756,Staff,19,0,30,11
1649950172029,MATH 20B,A02,083757,Staff,30,0,30,0
1649950178063,MATH 20C,A01,083760,Staff,22,0,30,8
1649950178063,MATH 20C,A02,083761,Staff,23,0,30,7
1649950178063,MATH 20C,B01,083762,Staff,27,0,30,3
1649950178063,MATH 20C,B02,083763,Staff,30,0,30,0
1649950184091,MATH 20D,A01,083765,Staff,19,0,30,11
1649950184091,MATH 20D,A02,083766,Staff,30,0,30,0
1649950184091,MATH 20D,A03,083767,Staff,30,0,30,0
1649950190115,MATH 20E,A01,083771,Staff,11,0,30,19
1649950190115,MATH 20E,A02,083772,Staff,24,0,30,6
1649950190115,MATH 20E,B01,083773,Staff,16,0,30,14
1649950190115,MATH 20E,B02,083774,Staff,29,0,30,1
1649950196144,MATH 103A,A01,083777,Staff,1,4,30,29
1649950196144,MATH 103A,A02,083778,Staff,0,4,30,30
1649950196144,MATH 103A,B01,083779,Staff,0,1,30,30
1649950196144,MATH 103A,B02,083780,Staff,16,0,30,14
1649950202169,MATH 105,A01,085443,Staff,0,6,30,30
1649950208199,MATH 109,A01,083213,Anzaldo; Leesa B,13,0,30,17
1649950208199,MATH 109,A02,083214,Anzaldo; Leesa B,8,0,30,22
1649950208199,MATH 109,B01,083215,Anzaldo; Leesa B,26,0,30,4
1649950208199,MATH 109,B02,083216,Anzaldo; Leesa B,22,0,30,8
1649950214233,MATH 142A,A01,083219,Chow; Bennett,0,2,30,30
1649950214233,MATH 142A,A02,083220,Chow; Bennett,8,0,30,22
1649950214233,MATH 142A,B01,083221,Chow; Bennett,0,0,30,30
1649950214233,MATH 142A,B02,083222,Chow; Bennett,0,0,30,30
1649950220260,MATH 193A,A01,083224,Staff,0,4,30,30
1649950220260,MATH 193A,A02,083225,Staff,0,3,30,30
1649950220260,MATH 193A,A03,083781,Staff,4,0,30,26
1649950220260,MATH 193A,A04,083782,Staff,15,0,30,15
1649950226282,MATH 197,001,091859,McAuley; Julian John,9999,0,9999,0
1649950232354,COGS 9,A01,083615,Staff,16,0,60,44
1649950238380,COGS 11,A01,083617,Boyle; Mary E. T.,35,0,40,5
1649950244406,COGS 13,A01,083071,Staff,0,11,40,40
1649950250440,COGS 14A,A01,092681,Staff,65,0,100,35
1649950256462,COGS 14B,A01,083073,Cheng; Tzu-Han,23,0,50,27
1649950262487,COGS 17,A01,092677,Staff,63,0,75,12
1649950268514,COGS 100,A01,083619,Staff,0,7,60,60
1649950274543,COGS 101A,A01,083621,Davis; Joshua Daniel,0,10,60,60
1649950280571,COGS 101B,A01,091572,Staff,30,0,60,30
1649950286597,COGS 101C,A01,083625,Delgado; Tania,23,0,30,7
1649950292621,COGS 107A,A01,083627,Boyle; Mary E. T.,11,0,60,49
1649950298649,COGS 118A,A01,083075,Staff,21,0,60,39
1649950304676,CSE 3,A50,083646,Miranda; Gregory Joseph,24,0,38,14
1649950304676,CSE 3,A51,083647,Miranda; Gregory Joseph,37,0,37,0
1649950310711,CSE 8A,A50,083650,Miranda; Gregory Joseph,7,0,40,33
1649950316738,CSE 11,A01,083080,Cao; Yingjun,0,28,40,40
1649950322760,CSE 12,A01,083652,Staff,52,0,100,48
1649950328791,CSE 15L,A01,083654,Staff,16,0,50,34
1649950328791,CSE 15L,A02,083655,Staff,46,0,50,4
1649950334817,CSE 20,A01,083657,Staff,67,0,80,13
1649950340844,CSE 30,A01,083084,Eldon; John,0,25,40,40
1649950346866,CSE 100,A01,083659,Cao; Yingjun,1,30,50,49
1649950352888,CSE 134B,A01,083661,Powell; Thomas Allan,0,22,65,65
1649950358911,CSE 140,A01,083663,Staff,23,0,75,52
1649950364941,CSE 140L,A01,083088,Eldon; John,17,0,75,58
1649950370970,CSE 175,A01,083665,Kumar; Rakesh,11,0,25,14
1649950376996,CSE 190,A00,092507,Dubnov; Shlomo,14,0,15,1
1649950383022,ECE 45,A01,083139,Staff,5,0,40,35
1649950389049,ECE 65,A50,083695,Staff,6,0,30,24
1649950395076,ECE 109,A01,091882,Touri; Behrouz,55,0,70,15
1649950401102,ECE 180,A00,083140,Abi Samra; Nicholas Camill,26,0,30,4
1649950401102,ECE 180,B00,083141,Abi Samra; Nicholas Camill,13,0,30,17
1649950407131,MATH 10A,A01,083735,Patchell; Gregory David,20,0,30,10
1649950407131,MATH 10A,A02,083736,Patchell; Gregory David,28,0,30,2
1649950407131,MATH 10A,A03,083737,Patchell; Gregory David,28,0,30,2
1649950413167,MATH 10B,A01,083207,Staff,10,0,30,20
1649950413167,MATH 10B,A02,083208,Staff,25,0,30,5
1649950413167,MATH 10B,B01,083739,Staff,25,0,30,5
1649950413167,MATH 10B,B02,083740,Staff,30,0,30,0
1649950419200,MATH 18,A01,083743,Staff,22,0,30,8
1649950419200,MATH 18,A02,083744,Staff,29,0,30,1
1649950419200,MATH 18,A03,083745,Staff,29,0,30,1
1649950419200,MATH 18,A04,083746,Staff,28,0,30,2
1649950419200,MATH 18,B01,083748,Staff,4,0,30,26
1649950419200,MATH 18,B02,083749,Staff,26,0,30,4
1649950419200,MATH 18,B03,083750,Staff,28,0,30,2
1649950419200,MATH 18,B04,083751,Staff,26,0,30,4
1649950425222,MATH 20A,A01,083754,Staff,37,0,40,3
1649950431245,MATH 20B,A01,083756,Staff,19,0,30,11
1649950431245,MATH 20B,A02,083757,Staff,30,0,30,0
1649950437268,MATH 20C,A01,083760,Staff,22,0,30,8
1649950437268,MATH 20C,A02,083761,Staff,22,0,30,8
1649950437268,MATH 20C,B01,083762,Staff,27,0,30,3
1649950437268,MATH 20C,B02,083763,Staff,30,0,30,0
1649950443292,MATH 20D,A01,083765,Staff,19,0,30,11
1649950443292,MATH 20D,A02,083766,Staff,30,0,30,0
1649950443292,MATH 20D,A03,083767,Staff,30,0,30,0
1649950449319,MATH 20E,A01,083771,Staff,11,0,30,19
1649950449319,MATH 20E,A02,083772,Staff,24,0,30,6
1649950449319,MATH 20E,B01,083773,Staff,16,0,30,14
1649950449319,MATH 20E,B02,083774,Staff,29,0,30,1
1649950455350,MATH 103A,A01,083777,Staff,1,4,30,29
1649950455350,MATH 103A,A02,083778,Staff,0,4,30,30
1649950455350,MATH 103A,B01,083779,Staff,0,1,30,30
1649950455350,MATH 103A,B02,083780,Staff,16,0,30,14
1649950461376,MATH 105,A01,085443,Staff,0,6,30,30
1649950467407,MATH 109,A01,083213,Anzaldo; Leesa B,13,0,30,17
1649950467407,MATH 109,A02,083214,Anzaldo; Leesa B,8,0,30,22
1649950467407,MATH 109,B01,083215,Anzaldo; Leesa B,26,0,30,4
1649950467407,MATH 109,B02,083216,Anzaldo; Leesa B,20,0,30,10
1649950473438,MATH 142A,A01,083219,Chow; Bennett,0,2,30,30
1649950473438,MATH 142A,A02,083220,Chow; Bennett,7,0,30,23
1649950473438,MATH 142A,B01,083221,Chow; Bennett,0,0,30,30
1649950473438,MATH 142A,B02,083222,Chow; Bennett,0,0,30,30
1649950479466,MATH 193A,A01,083224,Staff,0,4,30,30
1649950479466,MATH 193A,A02,083225,Staff,0,3,30,30
1649950479466,MATH 193A,A03,083781,Staff,4,0,30,26
1649950479466,MATH 193A,A04,083782,Staff,15,0,30,15
1649950485489,MATH 197,001,091859,McAuley; Julian John,9999,0,9999,0
1649950491540,COGS 9,A01,083615,Staff,16,0,60,44
1649950497567,COGS 11,A01,083617,Boyle; Mary E. T.,35,0,40,5
1649950503590,COGS 13,A01,083071,Staff,0,11,40,40
1649950509612,COGS 14A,A01,092681,Staff,65,0,100,35
1649950515641,COGS 14B,A01,083073,Cheng; Tzu-Han,23,0,50,27
1649950521665,COGS 17,A01,092677,Staff,63,0,75,12
1649950527689,COGS 100,A01,083619,Staff,0,7,60,60
1649950533728,COGS 101A,A01,083621,Davis; Joshua Daniel,0,10,60,60
1649950539752,COGS 101B,A01,091572,Staff,30,0,60,30
1649950545776,COGS 101C,A01,083625,Delgado; Tania,23,0,30,7
1649950551813,COGS 107A,A01,083627,Boyle; Mary E. T.,11,0,60,49
1649950557840,COGS 118A,A01,083075,Staff,21,0,60,39
1649950563868,CSE 3,A50,083646,Miranda; Gregory Joseph,24,0,38,14
1649950563868,CSE 3,A51,083647,Miranda; Gregory Joseph,37,0,37,0
1649950569980,CSE 8A,A50,083650,Miranda; Gregory Joseph,7,0,40,33
1649950576010,CSE 11,A01,083080,Cao; Yingjun,0,28,40,40
1649950582035,CSE 12,A01,083652,Staff,52,0,100,48
1649950588066,CSE 15L,A01,083654,Staff,16,0,50,34
1649950588066,CSE 15L,A02,083655,Staff,46,0,50,4
1649950594099,CSE 20,A01,083657,Staff,67,0,80,13
1649950600135,CSE 30,A01,083084,Eldon; John,0,25,40,40
1649950606163,CSE 100,A01,083659,Cao; Yingjun,1,30,50,49
1649950612185,CSE 134B,A01,083661,Powell; Thomas Allan,0,22,65,65
1649950618212,CSE 140,A01,083663,Staff,23,0,75,52
1649950624239,CSE 140L,A01,083088,Eldon; John,17,0,75,58
1649950630266,CSE 175,A01,083665,Kumar; Rakesh,11,0,25,14
1649950636289,CSE 190,A00,092507,Dubnov; Shlomo,14,0,15,1
1649950642325,ECE 45,A01,083139,Staff,5,0,40,35
1649950648354,ECE 65,A50,083695,Staff,6,0,30,24
1649950654379,ECE 109,A01,091882,Touri; Behrouz,55,0,70,15
1649950660403,ECE 180,A00,083140,Abi Samra; Nicholas Camill,26,0,30,4
1649950660403,ECE 180,B00,083141,Abi Samra; Nicholas Camill,13,0,30,17
1649950666434,MATH 10A,A01,083735,Patchell; Gregory David,20,0,30,10
1649950666434,MATH 10A,A02,083736,Patchell; Gregory David,28,0,30,2
1649950666434,MATH 10A,A03,083737,Patchell; Gregory David,28,0,30,2
1649950672463,MATH 10B,A01,083207,Staff,10,0,30,20
1649950672463,MATH 10B,A02,083208,Staff,25,0,30,5
1649950672463,MATH 10B,B01,083739,Staff,25,0,30,5
1649950672463,MATH 10B,B02,083740,Staff,30,0,30,0
1649950678489,MATH 18,A01,083743,Staff,22,0,30,8
1649950678489,MATH 18,A02,083744,Staff,29,0,30,1
1649950678489,MATH 18,A03,083745,Staff,29,0,30,1
1649950678489,MATH 18,A04,083746,Staff,28,0,30,2
1649950678489,MATH 18,B01,083748,Staff,4,0,30,26
1649950678489,MATH 18,B02,083749,Staff,26,0,30,4
1649950678489,MATH 18,B03,083750,Staff,28,0,30,2
1649950678489,MATH 18,B04,083751,Staff,26,0,30,4
1649950684512,MATH 20A,A01,083754,Staff,37,0,40,3
1649950690539,MATH 20B,A01,083756,Staff,19,0,30,11
1649950690539,MATH 20B,A02,083757,Staff,30,0,30,0
1649950696570,MATH 20C,A01,083760,Staff,22,0,30,8
1649950696570,MATH 20C,A02,083761,Staff,21,0,30,9
1649950696570,MATH 20C,B01,083762,Staff,27,0,30,3
1649950696570,MATH 20C,B02,083763,Staff,30,0,30,0
1649950702606,MATH 20D,A01,083765,Staff,19,0,30,11
1649950702606,MATH 20D,A02,083766,Staff,30,0,30,0
1649950702606,MATH 20D,A03,083767,Staff,30,0,30,0
1649950708636,MATH 20E,A01,083771,Staff,11,0,30,19
1649950708636,MATH 20E,A02,083772,Staff,24,0,30,6
1649950708636,MATH 20E,B01,083773,Staff,16,0,30,14
1649950708636,MATH 20E,B02,083774,Staff,29,0,30,1
1649950714672,MATH 103A,A01,083777,Staff,1,4,30,29
1649950714672,MATH 103A,A02,083778,Staff,0,4,30,30
1649950714672,MATH 103A,B01,083779,Staff,0,1,30,30
1649950714672,MATH 103A,B02,083780,Staff,16,0,30,14
1649950720700,MATH 105,A01,085443,Staff,0,6,30,30
1649950726741,MATH 109,A01,083213,Anzaldo; Leesa B,13,0,30,17
1649950726741,MATH 109,A02,083214,Anzaldo; Leesa B,8,0,30,22
1649950726741,MATH 109,B01,083215,Anzaldo; Leesa B,26,0,30,4
1649950726741,MATH 109,B02,083216,Anzaldo; Leesa B,20,0,30,10
1649950732766,MATH 142A,A01,083219,Chow; Bennett,0,2,30,30
1649950732766,MATH 142A,A02,083220,Chow; Bennett,7,0,30,23
1649950732766,MATH 142A,B01,083221,Chow; Bennett,0,0,30,30
1649950732766,MATH 142A,B02,083222,Chow; Bennett,0,0,30,30
1649950738809,MATH 193A,A01,083224,Staff,0,4,30,30
1649950738809,MATH 193A,A02,083225,Staff,0,3,30,30
1649950738809,MATH 193A,A03,083781,Staff,4,0,30,26
1649950738809,MATH 193A,A04,083782,Staff,15,0,30,15
1649950744834,MATH 197,001,091859,McAuley; Julian John,9999,0,9999,0
1649950750895,COGS 9,A01,083615,Staff,16,0,60,44
1649950756921,COGS 11,A01,083617,Boyle; Mary E. T.,35,0,40,5
1649950762966,COGS 13,A01,083071,Staff,0,11,40,40
1649950768997,COGS 14A,A01,092681,Staff,65,0,100,35
1649950775021,COGS 14B,A01,083073,Cheng; Tzu-Han,23,0,50,27
1649950781045,COGS 17,A01,092677,Staff,63,0,75,12
1649950787071,COGS 100,A01,083619,Staff,0,7,60,60
1649950793093,COGS 101A,A01,083621,Davis; Joshua Daniel,0,10,60,60
1649950799116,COGS 101B,A01,091572,Staff,30,0,60,30
1649950805140,COGS 101C,A01,083625,Delgado; Tania,23,0,30,7
1649950811168,COGS 107A,A01,083627,Boyle; Mary E. T.,11,0,60,49
1649950817196,COGS 118A,A01,083075,Staff,21,0,60,39
1649950823225,CSE 3,A50,083646,Miranda; Gregory Joseph,24,0,38,14
1649950823225,CSE 3,A51,083647,Miranda; Gregory Joseph,37,0,37,0
1649950829260,CSE 8A,A50,083650,Miranda; Gregory Joseph,7,0,40,33
1649950835285,CSE 11,A01,083080,Cao; Yingjun,0,28,40,40
1649950841308,CSE 12,A01,083652,Staff,52,0,100,48
1649950847339,CSE 15L,A01,083654,Staff,16,0,50,34
1649950847339,CSE 15L,A02,083655,Staff,46,0,50,4
1649950853362,CSE 20,A01,083657,Staff,67,0,80,13
1649950859387,CSE 30,A01,083084,Eldon; John,0,25,40,40
1649950865410,CSE 100,A01,083659,Cao; Yingjun,1,30,50,49
1649950871436,CSE 134B,A01,083661,Powell; Thomas Allan,0,22,65,65
1649950877462,CSE 140,A01,083663,Staff,23,0,75,52
1649950883491,CSE 140L,A01,083088,Eldon; John,17,0,75,58
1649950889519,CSE 175,A01,083665,Kumar; Rakesh,11,0,25,14
1649950895543,CSE 190,A00,092507,Dubnov; Shlomo,14,0,15,1
1649950901570,ECE 45,A01,083139,Staff,5,0,40,35
1649950907593,ECE 65,A50,083695,Staff,6,0,30,24
1649950913615,ECE 109,A01,091882,Touri; Behrouz,55,0,70,15
1649950919643,ECE 180,A00,083140,Abi Samra; Nicholas Camill,26,0,30,4
1649950919643,ECE 180,B00,083141,Abi Samra; Nicholas Camill,13,0,30,17
1649950925664,MATH 10A,A01,083735,Patchell; Gregory David,20,0,30,10
1649950925664,MATH 10A,A02,083736,Patchell; Gregory David,28,0,30,2
1649950925664,MATH 10A,A03,083737,Patchell; Gregory David,28,0,30,2
1649950931687,MATH 10B,A01,083207,Staff,10,0,30,20
1649950931687,MATH 10B,A02,083208,Staff,25,0,30,5
1649950931687,MATH 10B,B01,083739,Staff,25,0,30,5
1649950931687,MATH 10B,B02,083740,Staff,30,0,30,0
1649950937712,MATH 18,A01,083743,Staff,22,0,30,8
1649950937712,MATH 18,A02,083744,Staff,29,0,30,1
1649950937712,MATH 18,A03,083745,Staff,29,0,30,1
1649950937712,MATH 18,A04,083746,Staff,28,0,30,2
1649950937712,MATH 18,B01,083748,Staff,4,0,30,26
1649950937712,MATH 18,B02,083749,Staff,26,0,30,4
1649950937712,MATH 18,B03,083750,Staff,28,0,30,2
1649950937712,MATH 18,B04,083751,Staff,26,0,30,4
1649950943740,MATH 20A,A01,083754,Staff,37,0,40,3
1649950949763,MATH 20B,A01,083756,Staff,19,0,30,11
1649950949763,MATH 20B,A02,083757,Staff,30,0,30,0
1649950955786,MATH 20C,A01,083760,Staff,22,0,30,8
1649950955786,MATH 20C,A02,083761,Staff,21,0,30,9
1649950955786,MATH 20C,B01,083762,Staff,27,0,30,3
1649950955786,MATH 20C,B02,083763,Staff,30,0,30,0
1649950961824,MATH 20D,A01,083765,Staff,19,0,30,11
1649950961824,MATH 20D,A02,083766,Staff,30,0,30,0
1649950961824,MATH 20D,A03,083767,Staff,30,0,30,0
1649950967855,MATH 20E,A01,083771,Staff,11,0,30,19
1649950967855,MATH 20E,A02,083772,Staff,24,0,30,6
1649950967855,MATH 20E,B01,083773,Staff,16,0,30,14
1649950967855,MATH 20E,B02,083774,Staff,29,0,30,1
1649950973888,MATH 103A,A01,083777,Staff,1,4,30,29
1649950973888,MATH 103A,A02,083778,Staff,0,4,30,30
1649950973888,MATH 103A,B01,083779,Staff,0,1,30,30
1649950973888,MATH 103A,B02,083780,Staff,15,0,30,15
1649950979914,MATH 105,A01,085443,Staff,0,6,30,30
1649950985945,MATH 109,A01,083213,Anzaldo; Leesa B,12,0,30,18
1649950985945,MATH 109,A02,083214,Anzaldo; Leesa B,8,0,30,22
1649950985945,MATH 109,B01,083215,Anzaldo; Leesa B,26,0,30,4
1649950985945,MATH 109,B02,083216,Anzaldo; Leesa B,20,0,30,10
1649950991976,MATH 142A,A01,083219,Chow; Bennett,0,2,30,30
1649950991976,MATH 142A,A02,083220,Chow; Bennett,6,0,30,24
1649950991976,MATH 142A,B01,083221,Chow; Bennett,0,0,30,30
1649950991976,MATH 142A,B02,083222,Chow; Bennett,0,0,30,30
1649950998003,MATH 193A,A01,083224,Staff,0,4,30,30
1649950998003,MATH 193A,A02,083225,Staff,0,3,30,30
1649950998003,MATH 193A,A03,083781,Staff,4,0,30,26
1649950998003,MATH 193A,A04,083782,Staff,15,0,30,15
1649951004026,MATH 197,001,091859,McAuley; Julian John,9999,0,9999,0
1649951010079,COGS 9,A01,083615,Staff,16,0,60,44
1649951016103,COGS 11,A01,083617,Boyle; Mary E. T.,35,0,40,5
1649951022126,COGS 13,A01,083071,Staff,0,11,40,40
1649951028153,COGS 14A,A01,092681,Staff,63,0,100,37
1649951034179,COGS 14B,A01,083073,Cheng; Tzu-Han,23,0,50,27
1649951040210,COGS 17,A01,092677,Staff,63,0,75,12
1649951046246,COGS 100,A01,083619,Staff,0,7,60,60
1649951052278,COGS 101A,A01,083621,Davis; Joshua Daniel,0,10,60,60
1649951058305,COGS 101B,A01,091572,Staff,30,0,60,30
1649951064328,COGS 101C,A01,083625,Delgado; Tania,23,0,30,7
1649951070367,COGS 107A,A01,083627,Boyle; Mary E. T.,11,0,60,49
1649951076394,COGS 118A,A01,083075,Staff,21,0,60,39
1649951082421,CSE 3,A50,083646,Miranda; Gregory Joseph,24,0,38,14
1649951082421,CSE 3,A51,083647,Miranda; Gregory Joseph,37,0,37,0
1649951088450,CSE 8A,A50,083650,Miranda; Gregory Joseph,7,0,40,33
1649951094472,CSE 11,A01,083080,Cao; Yingjun,0,29,40,40
1649951100498,CSE 12,A01,083652,Staff,51,0,100,49
1649951106524,CSE 15L,A01,083654,Staff,15,0,50,35
1649951106524,CSE 15L,A02,083655,Staff,46,0,50,4
1649951112551,CSE 20,A01,083657,Staff,67,0,80,13
1649951118576,CSE 30,A01,083084,Eldon; John,0,26,40,40
1649951124598,CSE 100,A01,083659,Cao; Yingjun,1,30,50,49
1649951130627,CSE 134B,A01,083661,Powell; Thomas Allan,0,22,65,65
1649951136649,CSE 140,A01,083663,Staff,23,0,75,52
1649951142675,CSE 140L,A01,083088,Eldon; John,17,0,75,58
1649951148699,CSE 175,A01,083665,Kumar; Rakesh,11,0,25,14
1649951154722,CSE 190,A00,092507,Dubnov; Shlomo,14,0,15,1
1649951160753,ECE 45,A01,083139,Staff,5,0,40,35
1649951166878,ECE 65,A50,083695,Staff,6,0,30,24
1649951172908,ECE 109,A01,091882,Touri; Behrouz,55,0,70,15
1649951178932,ECE 180,A00,083140,Abi Samra; Nicholas Camill,26,0,30,4
1649951178932,ECE 180,B00,083141,Abi Samra; Nicholas Camill,13,0,30,17
1649951184955,MATH 10A,A01,083735,Patchell; Gregory David,20,0,30,10
1649951184955,MATH 10A,A02,083736,Patchell; Gregory David,28,0,30,2
1649951184955,MATH 10A,A03,083737,Patchell; Gregory David,28,0,30,2
1649951190985,MATH 10B,A01,083207,Staff,10,0,30,20
1649951190985,MATH 10B,A02,083208,Staff,25,0,30,5
1649951190985,MATH 10B,B01,083739,Staff,25,0,30,5
1649951190985,MATH 10B,B02,083740,Staff,30,0,30,0
1649951197013,MATH 18,A01,083743,Staff,22,0,30,8
1649951197013,MATH 18,A02,083744,Staff,29,0,30,1
1649951197013,MATH 18,A03,083745,Staff,29,0,30,1
1649951197013,MATH 18,A04,083746,Staff,28,0,30,2
1649951197013,MATH 18,B01,083748,Staff,4,0,30,26
1649951197013,MATH 18,B02,083749,Staff,26,0,30,4
1649951197013,MATH 18,B03,083750,Staff,28,0,30,2
1649951197013,MATH 18,B04,083751,Staff,26,0,30,4
1649951203039,MATH 20A,A01,083754,Staff,37,0,40,3
1649951209062,MATH 20B,A01,083756,Staff,19,0,30,11
1649951209062,MATH 20B,A02,083757,Staff,30,0,30,0
1649951215086,MATH 20C,A01,083760,Staff,22,0,30,8
1649951215086,MATH 20C,A02,083761,Staff,21,0,30,9
1649951215086,MATH 20C,B01,083762,Staff,27,0,30,3
1649951215086,MATH 20C,B02,083763,Staff,30,0,30,0
1649951221110,MATH 20D,A01,083765,Staff,19,0,30,11
1649951221110,MATH 20D,A02,083766,Staff,30,0,30,0
1649951221110,MATH 20D,A03,083767,Staff,30,0,30,0
1649951227134,MATH 20E,A01,083771,Staff,11,0,30,19
1649951227134,MATH 20E,A02,083772,Staff,24,0,30,6
1649951227134,MATH 20E,B01,083773,Staff,16,0,30,14
1649951227134,MATH 20E,B02,083774,Staff,29,0,30,1
1649951233158,MATH 103A,A01,083777,Staff,1,4,30,29
1649951233158,MATH 103A,A02,083778,Staff,0,4,30,30
1649951233158,MATH 103A,B01,083779,Staff,0,1,30,30
1649951233158,MATH 103A,B02,083780,Staff,15,0,30,15
1649951239181,MATH 105,A01,085443,Staff,0,6,30,30
1649951245208,MATH 109,A01,083213,Anzaldo; Leesa B,12,0,30,18
1649951245208,MATH 109,A02,083214,Anzaldo; Leesa B,8,0,30,22
1649951245208,MATH 109,B01,083215,Anzaldo; Leesa B,26,0,30,4
1649951245208,MATH 109,B02,083216,Anzaldo; Leesa B,20,0,30,10
1649951251232,MATH 142A,A01,083219,Chow; Bennett,0,2,30,30
1649951251232,MATH 142A,A02,083220,Chow; Bennett,6,0,30,24
1649951251232,MATH 142A,B01,083221,Chow; Bennett,0,1,30,30
1649951251232,MATH 142A,B02,083222,Chow; Bennett,0,0,30,30
1649951257265,MATH 193A,A01,083224,Staff,0,5,30,30
1649951257265,MATH 193A,A02,083225,Staff,0,3,30,30
1649951257265,MATH 193A,A03,083781,Staff,4,0,30,26
1649951257265,MATH 193A,A04,083782,Staff,15,0,30,15
1649951263296,MATH 197,001,091859,McAuley; Julian John,9999,0,9999,0
1649951269357,COGS 9,A01,083615,Staff,16,0,60,44
1649951275388,COGS 11,A01,083617,Boyle; Mary E. T.,35,0,40,5
1649951281413,COGS 13,A01,083071,Staff,0,11,40,40
1649951287443,COGS 14A,A01,092681,Staff,63,0,100,37
1649951293481,COGS 14B,A01,083073,Cheng; Tzu-Han,23,0,50,27
1649951299508,COGS 17,A01,092677,Staff,63,0,75,12
1649951305541,COGS 100,A01,083619,Staff,0,7,60,60
1649951311563,COGS 101A,A01,083621,Davis; Joshua Daniel,0,10,60,60
1649951317585,COGS 101B,A01,091572,Staff,30,0,60,30
1649951323607,COGS 101C,A01,083625,Delgado; Tania,23,0,30,7
1649951329631,COGS 107A,A01,083627,Boyle; Mary E. T.,11,0,60,49
1649951335660,COGS 118A,A01,083075,Staff,21,0,60,39
1649951341683,CSE 3,A50,083646,Miranda; Gregory Joseph,24,0,38,14
1649951341683,CSE 3,A51,083647,Miranda; Gregory Joseph,37,0,37,0
1649951347706,CSE 8A,A50,083650,Miranda; Gregory Joseph,7,0,40,33
1649951353733,CSE 11,A01,083080,Cao; Yingjun,0,29,40,40
1649951359762,CSE 12,A01,083652,Staff,51,0,100,49
1649951365792,CSE 15L,A01,083654,Staff,15,0,50,35
1649951365792,CSE 15L,A02,083655,Staff,46,0,50,4
1649951371816,CSE 20,A01,083657,Staff,67,0,80,13
1649951377844,CSE 30,A01,083084,Eldon; John,0,26,40,40
1649951383867,CSE 100,A01,083659,Cao; Yingjun,1,30,50,49
1649951389889,CSE 134B,A01,083661,Powell; Thomas Allan,0,22,65,65
1649951395923,CSE 140,A01,083663,Staff,23,0,75,52
1649951401947,CSE 140L,A01,083088,Eldon; John,17,0,75,58
1649951407970,CSE 175,A01,083665,Kumar; Rakesh,11,0,25,14
1649951413996,CSE 190,A00,092507,Dubnov; Shlomo,14,0,15,1
1649951420039,ECE 45,A01,083139,Staff,5,0,40,35
1649951426071,ECE 65,A50,083695,Staff,6,0,30,24
1649951432094,ECE 109,A01,091882,Touri; Behrouz,55,0,70,15
1649951438125,ECE 180,A00,083140,Abi Samra; Nicholas Camill,26,0,30,4
1649951438125,ECE 180,B00,083141,Abi Samra; Nicholas Camill,13,0,30,17
1649951444147,MATH 10A,A01,083735,Patchell; Gregory David,20,0,30,10
1649951444147,MATH 10A,A02,083736,Patchell; Gregory David,28,0,30,2
1649951444147,MATH 10A,A03,083737,Patchell; Gregory David,28,0,30,2
1649951450171,MATH 10B,A01,083207,Staff,10,0,30,20
1649951450171,MATH 10B,A02,083208,Staff,25,0,30,5
1649951450171,MATH 10B,B01,083739,Staff,25,0,30,5
1649951450171,MATH 10B,B02,083740,Staff,30,0,30,0
1649951456197,MATH 18,A01,083743,Staff,22,0,30,8
1649951456197,MATH 18,A02,083744,Staff,29,0,30,1
1649951456197,MATH 18,A03,083745,Staff,29,0,30,1
1649951456197,MATH 18,A04,083746,Staff,28,0,30,2
1649951456197,MATH 18,B01,083748,Staff,4,0,30,26
1649951456197,MATH 18,B02,083749,Staff,26,0,30,4
1649951456197,MATH 18,B03,083750,Staff,28,0,30,2
1649951456197,MATH 18,B04,083751,Staff,26,0,30,4
1649951462226,MATH 20A,A01,083754,Staff,37,0,40,3
1649951468248,MATH 20B,A01,083756,Staff,19,0,30,11
1649951468248,MATH 20B,A02,083757,Staff,30,0,30,0
1649951474272,MATH 20C,A01,083760,Staff,22,0,30,8
1649951474272,MATH 20C,A02,083761,Staff,21,0,30,9
1649951474272,MATH 20C,B01,083762,Staff,27,0,30,3
1649951474272,MATH 20C,B02,083763,Staff,30,0,30,0
1649951480299,MATH 20D,A01,083765,Staff,19,0,30,11
1649951480299,MATH 20D,A02,083766,Staff,30,0,30,0
1649951480299,MATH 20D,A03,083767,Staff,30,0,30,0
1649951486326,MATH 20E,A01,083771,Staff,11,0,30,19
1649951486326,MATH 20E,A02,083772,Staff,24,0,30,6
1649951486326,MATH 20E,B01,083773,Staff,16,0,30,14
1649951486326,MATH 20E,B02,083774,Staff,29,0,30,1
1649951492352,MATH 103A,A01,083777,Staff,1,4,30,29
1649951492352,MATH 103A,A02,083778,Staff,0,4,30,30
1649951492352,MATH 103A,B01,083779,Staff,0,1,30,30
1649951492352,MATH 103A,B02,083780,Staff,15,0,30,15
1649951498388,MATH 105,A01,085443,Staff,0,6,30,30
1649951504422,MATH 109,A01,083213,Anzaldo; Leesa B,12,0,30,18
1649951504422,MATH 109,A02,083214,Anzaldo; Leesa B,8,0,30,22
1649951504422,MATH 109,B01,083215,Anzaldo; Leesa B,26,0,30,4
1649951504422,MATH 109,B02,083216,Anzaldo; Leesa B,20,0,30,10
1649951510449,MATH 142A,A01,083219,Chow; Bennett,0,2,30,30
1649951510449,MATH 142A,A02,083220,Chow; Bennett,5,0,30,25
1649951510449,MATH 142A,B01,083221,Chow; Bennett,0,1,30,30
1649951510449,MATH 142A,B02,083222,Chow; Bennett,0,0,30,30
1649951516475,MATH 193A,A01,083224,Staff,0,5,30,30
1649951516475,MATH 193A,A02,083225,Staff,0,3,30,30
1649951516475,MATH 193A,A03,083781,Staff,4,0,30,26
1649951516475,MATH 193A,A04,083782,Staff,15,0,30,15
1649951522513,MATH 197,001,091859,McAuley; Julian John,9999,0,9999,0
1649951528570,COGS 9,A01,083615,Staff,16,0,60,44
1649951534593,COGS 11,A01,083617,Boyle; Mary E. T.,35,0,40,5
1649951540621,COGS 13,A01,083071,Staff,0,12,40,40
1649951546645,COGS 14A,A01,092681,Staff,62,0,100,38
1649951552673,COGS 14B,A01,083073,Cheng; Tzu-Han,23,0,50,27
1649951558699,COGS 17,A01,092677,Staff,63,0,75,12
1649951564724,COGS 100,A01,083619,Staff,0,8,60,60
1649951570750,COGS 101A,A01,083621,Davis; Joshua Daniel,0,10,60,60
1649951576776,COGS 101B,A01,091572,Staff,30,0,60,30
1649951582801,COGS 101C,A01,083625,Delgado; Tania,23,0,30,7
1649951588825,COGS 107A,A01,083627,Boyle; Mary E. T.,11,0,60,49
1649951594851,COGS 118A,A01,083075,Staff,21,0,60,39
1649951600879,CSE 3,A50,083646,Miranda; Gregory Joseph,24,0,38,14
1649951600879,CSE 3,A51,083647,Miranda; Gregory Joseph,37,0,37,0
1649951606902,CSE 8A,A50,083650,Miranda; Gregory Joseph,7,0,40,33
1649951612931,CSE 11,A01,083080,Cao; Yingjun,0,30,40,40
1649951618954,CSE 12,A01,083652,Staff,51,0,100,49
1649951624978,CSE 15L,A01,083654,Staff,15,0,50,35
1649951624978,CSE 15L,A02,083655,Staff,46,0,50,4
1649951631004,CSE 20,A01,083657,Staff,67,0,80,13
1649951637028,CSE 30,A01,083084,Eldon; John,0,26,40,40
1649951643055,CSE 100,A01,083659,Cao; Yingjun,1,30,50,49
1649951649079,CSE 134B,A01,083661,Powell; Thomas Allan,0,22,65,65
1649951655104,CSE 140,A01,083663,Staff,23,0,75,52
1649951661128,CSE 140L,A01,083088,Eldon; John,17,0,75,58
1649951667161,CSE 175,A01,083665,Kumar; Rakesh,11,0,25,14
1649951673185,CSE 190,A00,092507,Dubnov; Shlomo,14,0,15,1
1649951679217,ECE 45,A01,083139,Staff,5,0,40,35
1649951685251,ECE 65,A50,083695,Staff,6,0,30,24
1649951691286,ECE 109,A01,091882,Touri; Behrouz,55,0,70,15
1649951697313,ECE 180,A00,083140,Abi Samra; Nicholas Camill,26,0,30,4
1649951697313,ECE 180,B00,083141,Abi Samra; Nicholas Camill,13,0,30,17
1649951703336,MATH 10A,A01,083735,Patchell; Gregory David,20,0,30,10
1649951703336,MATH 10A,A02,083736,Patchell; Gregory David,28,0,30,2
1649951703336,MATH 10A,A03,083737,Patchell; Gregory David,28,0,30,2
1649951709361,MATH 10B,A01,083207,Staff,10,0,30,20
1649951709361,MATH 10B,A02,083208,Staff,25,0,30,5
1649951709361,MATH 10B,B01,083739,Staff,25,0,30,5
1649951709361,MATH 10B,B02,083740,Staff,30,0,30,0
1649951715385,MATH 18,A01,083743,Staff,22,0,30,8
1649951715385,MATH 18,A02,083744,Staff,29,0,30,1
1649951715385,MATH 18,A03,083745,Staff,29,0,30,1
1649951715385,MATH 18,A04,083746,Staff,28,0,30,2
1649951715385,MATH 18,B01,083748,Staff,3,0,30,27
1649951715385,MATH 18,B02,083749,Staff,26,0,30,4
1649951715385,MATH 18,B03,083750,Staff,28,0,30,2
1649951715385,MATH 18,B04,083751,Staff,26,0,30,4
1649951721409,MATH 20A,A01,083754,Staff,36,0,40,4
1649951727440,MATH 20B,A01,083756,Staff,19,0,30,11
1649951727440,MATH 20B,A02,083757,Staff,30,0,30,0
1649951733468,MATH 20C,A01,083760,Staff,22,0,30,8
1649951733468,MATH 20C,A02,083761,Staff,19,0,30,11
1649951733468,MATH 20C,B01,083762,Staff,27,0,30,3
1649951733468,MATH 20C,B02,083763,Staff,30,0,30,0
1649951739494,MATH 20D,A01,083765,Staff,19,0,30,11
1649951739494,MATH 20D,A02,083766,Staff,30,0,30,0
1649951739494,MATH 20D,A03,083767,Staff,30,0,30,0
1649951745526,MATH 20E,A01,083771,Staff,11,0,30,19
1649951745526,MATH 20E,A02,083772,Staff,24,0,30,6
1649951745526,MATH 20E,B01,083773,Staff,16,0,30,14
1649951745526,MATH 20E,B02,083774,Staff,29,0,30,1
1649951751550,MATH 103A,A01,083777,Staff,1,4,30,29
1649951751550,MATH 103A,A02,083778,Staff,0,4,30,30
1649951751550,MATH 103A,B01,083779,Staff,0,1,30,30
1649951751550,MATH 103A,B02,083780,Staff,15,0,30,15
1649951757578,MATH 105,A01,085443,Staff,0,6,30,30
1649951763697,MATH 109,A01,083213,Anzaldo; Leesa B,12,0,30,18
1649951763697,MATH 109,A02,083214,Anzaldo; Leesa B,8,0,30,22
1649951763697,MATH 109,B01,083215,Anzaldo; Leesa B,26,0,30,4
1649951763697,MATH 109,B02,083216,Anzaldo; Leesa B,20,0,30,10
1649951769723,MATH 142A,A01,083219,Chow; Bennett,0,2,30,30
1649951769723,MATH 142A,A02,083220,Chow; Bennett,5,0,30,25
1649951769723,MATH 142A,B01,083221,Chow; Bennett,0,1,30,30
1649951769723,MATH 142A,B02,083222,Chow; Bennett,0,0,30,30
1649951775749,MATH 193A,A01,083224,Staff,0,5,30,30
1649951775749,MATH 193A,A02,083225,Staff,0,3,30,30
1649951775749,MATH 193A,A03,083781,Staff,4,0,30,26
1649951775749,MATH 193A,A04,083782,Staff,15,0,30,15
1649951781774,MATH 197,001,091859,McAuley; Julian John,9999,0,9999,0
1649951787833,COGS 9,A01,083615,Staff,15,0,60,45
1649951793855,COGS 11,A01,083617,Boyle; Mary E. T.,35,0,40,5
1649951799892,COGS 13,A01,083071,Staff,0,12,40,40
1649951805920,COGS 14A,A01,092681,Staff,62,0,100,38
1649951811945,COGS 14B,A01,083073,Cheng; Tzu-Han,23,0,50,27
1649951817971,COGS 17,A01,092677,Staff,63,0,75,12
1649951823994,COGS 100,A01,083619,Staff,0,8,60,60
1649951830017,COGS 101A,A01,083621,Davis; Joshua Daniel,0,10,60,60
1649951836041,COGS 101B,A01,091572,Staff,30,0,60,30
1649951842068,COGS 101C,A01,083625,Delgado; Tania,23,0,30,7
1649951848093,COGS 107A,A01,083627,Boyle; Mary E. T.,11,0,60,49
1649951854127,COGS 118A,A01,083075,Staff,21,0,60,39
1649951860151,CSE 3,A50,083646,Miranda; Gregory Joseph,24,0,38,14
1649951860151,CSE 3,A51,083647,Miranda; Gregory Joseph,37,0,37,0
1649951866177,CSE 8A,A50,083650,Miranda; Gregory Joseph,7,0,40,33
1649951872199,CSE 11,A01,083080,Cao; Yingjun,0,30,40,40
1649951878226,CSE 12,A01,083652,Staff,51,0,100,49
1649951884249,CSE 15L,A01,083654,Staff,15,0,50,35
1649951884249,CSE 15L,A02,083655,Staff,46,0,50,4
1649951890275,CSE 20,A01,083657,Staff,67,0,80,13
1649951896306,CSE 30,A01,083084,Eldon; John,0,26,40,40
1649951902329,CSE 100,A01,083659,Cao; Yingjun,1,31,50,49
1649951908357,CSE 134B,A01,083661,Powell; Thomas Allan,0,22,65,65
1649951914383,CSE 140,A01,083663,Staff,23,0,75,52
1649951920407,CSE 140L,A01,083088,Eldon; John,17,0,75,58
1649951926434,CSE 175,A01,083665,Kumar; Rakesh,11,0,25,14
1649951932461,CSE 190,A00,092507,Dubnov; Shlomo,14,0,15,1
1649951938488,ECE 45,A01,083139,Staff,5,0,40,35
1649951944510,ECE 65,A50,083695,Staff,6,0,30,24
1649951950532,ECE 109,A01,091882,Touri; Behrouz,55,0,70,15
1649951956559,ECE 180,A00,083140,Abi Samra; Nicholas Camill,26,0,30,4
1649951956559,ECE 180,B00,083141,Abi Samra; Nicholas Camill,13,0,30,17
1649951962582,MATH 10A,A01,083735,Patchell; Gregory David,20,0,30,10
1649951962582,MATH 10A,A02,083736,Patchell; Gregory David,28,0,30,2
1649951962582,MATH 10A,A03,083737,Patchell; Gregory David,28,0,30,2
1649951968605,MATH 10B,A01,083207,Staff,10,0,30,20
1649951968605,MATH 10B,A02,083208,Staff,25,0,30,5
1649951968605,MATH 10B,B01,083739,Staff,25,0,30,5
1649951968605,MATH 10B,B02,083740,Staff,30,0,30,0
1649951974637,MATH 18,A01,083743,Staff,22,0,30,8
1649951974637,MATH 18,A02,083744,Staff,29,0,30,1
1649951974637,MATH 18,A03,083745,Staff,29,0,30,1
1649951974637,MATH 18,A04,083746,Staff,28,0,30,2
1649951974637,MATH 18,B01,083748,Staff,3,0,30,27
1649951974637,MATH 18,B02,083749,Staff,26,0,30,4
1649951974637,MATH 18,B03,083750,Staff,28,0,30,2
1649951974637,MATH 18,B04,083751,Staff,26,0,30,4
1649951980670,MATH 20A,A01,083754,Staff,36,0,40,4
1649951986701,MATH 20B,A01,083756,Staff,19,0,30,11
1649951986701,MATH 20B,A02,083757,Staff,30,0,30,0
1649951992731,MATH 20C,A01,083760,Staff,22,0,30,8
1649951992731,MATH 20C,A02,083761,Staff,19,0,30,11
1649951992731,MATH 20C,B01,083762,Staff,27,0,30,3
1649951992731,MATH 20C,B02,083763,Staff,30,0,30,0
1649951998764,MATH 20D,A01,083765,Staff,19,0,30,11
1649951998764,MATH 20D,A02,083766,Staff,30,0,30,0
1649951998764,MATH 20D,A03,083767,Staff,30,0,30,0
1649952004791,MATH 20E,A01,083771,Staff,11,0,30,19
1649952004791,MATH 20E,A02,083772,Staff,24,0,30,6
1649952004791,MATH 20E,B01,083773,Staff,16,0,30,14
1649952004791,MATH 20E,B02,083774,Staff,29,0,30,1
1649952010826,MATH 103A,A01,083777,Staff,1,4,30,29
1649952010826,MATH 103A,A02,083778,Staff,0,4,30,30
1649952010826,MATH 103A,B01,083779,Staff,0,1,30,30
1649952010826,MATH 103A,B02,083780,Staff,14,0,30,16
1649952016856,MATH 105,A01,085443,Staff,0,6,30,30
1649952022883,MATH 109,A01,083213,Anzaldo; Leesa B,12,0,30,18
1649952022883,MATH 109,A02,083214,Anzaldo; Leesa B,8,0,30,22
1649952022883,MATH 109,B01,083215,Anzaldo; Leesa B,26,0,30,4
1649952022883,MATH 109,B02,083216,Anzaldo; Leesa B,20,0,30,10
1649952028913,MATH 142A,A01,083219,Chow; Bennett,0,2,30,30
1649952028913,MATH 142A,A02,083220,Chow; Bennett,5,0,30,25
1649952028913,MATH 142A,B01,083221,Chow; Bennett,0,1,30,30
1649952028913,MATH 142A,B02,083222,Chow; Bennett,0,0,30,30
1649952034937,MATH 193A,A01,083224,Staff,0,5,30,30
1649952034937,MATH 193A,A02,083225,Staff,0,3,30,30
1649952034937,MATH 193A,A03,083781,Staff,4,0,30,26
1649952034937,MATH 193A,A04,083782,Staff,15,0,30,15
1649952040960,MATH 197,001,091859,McAuley; Julian John,9999,0,9999,0
1649952047030,COGS 9,A01,083615,Staff,15,0,60,45
1649952053058,COGS 11,A01,083617,Boyle; Mary E. T.,35,0,40,5
1649952059083,COGS 13,A01,083071,Staff,0,12,40,40
1649952065118,COGS 14A,A01,092681,Staff,62,0,100,38
1649952071141,COGS 14B,A01,083073,Cheng; Tzu-Han,23,0,50,27
1649952077166,COGS 17,A01,092677,Staff,61,0,75,14
1649952083200,COGS 100,A01,083619,Staff,0,8,60,60
1649952089223,COGS 101A,A01,083621,Davis; Joshua Daniel,0,10,60,60
1649952095248,COGS 101B,A01,091572,Staff,30,0,60,30
1649952101278,COGS 101C,A01,083625,Delgado; Tania,23,0,30,7
1649952107308,COGS 107A,A01,083627,Boyle; Mary E. T.,11,0,60,49
1649952113331,COGS 118A,A01,083075,Staff,21,0,60,39
1649952119361,CSE 3,A50,083646,Miranda; Gregory Joseph,24,0,38,14
1649952119361,CSE 3,A51,083647,Miranda; Gregory Joseph,37,0,37,0
1649952125386,CSE 8A,A50,083650,Miranda; Gregory Joseph,7,0,40,33
1649952131414,CSE 11,A01,083080,Cao; Yingjun,0,30,40,40
1649952137438,CSE 12,A01,083652,Staff,50,0,100,50
1649952143474,CSE 15L,A01,083654,Staff,14,0,50,36
1649952143474,CSE 15L,A02,083655,Staff,46,0,50,4
1649952149500,CSE 20,A01,083657,Staff,67,0,80,13
1649952155522,CSE 30,A01,083084,Eldon; John,0,26,40,40
1649952161550,CSE 100,A01,083659,Cao; Yingjun,1,30,50,49
1649952167580,CSE 134B,A01,083661,Powell; Thomas Allan,0,22,65,65
1649952173605,CSE 140,A01,083663,Staff,22,0,75,53
1649952179641,CSE 140L,A01,083088,Eldon; John,16,0,75,59
1649952185667,CSE 175,A01,083665,Kumar; Rakesh,11,0,25,14
1649952191700,CSE 190,A00,092507,Dubnov; Shlomo,14,0,15,1
1649952197723,ECE 45,A01,083139,Staff,5,0,40,35
1649952203749,ECE 65,A50,083695,Staff,5,0,30,25
1649952209781,ECE 109,A01,091882,Touri; Behrouz,55,0,70,15
1649952215804,ECE 180,A00,083140,Abi Samra; Nicholas Camill,26,0,30,4
1649952215804,ECE 180,B00,083141,Abi Samra; Nicholas Camill,13,0,30,17
1649952221830,MATH 10A,A01,083735,Patchell; Gregory David,20,0,30,10
1649952221830,MATH 10A,A02,083736,Patchell; Gregory David,28,0,30,2
1649952221830,MATH 10A,A03,083737,Patchell; Gregory David,28,0,30,2
1649952227861,MATH 10B,A01,083207,Staff,10,0,30,20
1649952227861,MATH 10B,A02,083208,Staff,25,0,30,5
1649952227861,MATH 10B,B01,083739,Staff,25,0,30,5
1649952227861,MATH 10B,B02,083740,Staff,30,0,30,0
1649952233885,MATH 18,A01,083743,Staff,22,0,30,8
1649952233885,MATH 18,A02,083744,Staff,29,0,30,1
1649952233885,MATH 18,A03,083745,Staff,29,0,30,1
1649952233885,MATH 18,A04,083746,Staff,28,0,30,2
1649952233885,MATH 18,B01,083748,Staff,3,0,30,27
1649952233885,MATH 18,B02,083749,Staff,26,0,30,4
1649952233885,MATH 18,B03,083750,Staff,28,0,30,2
1649952233885,MATH 18,B04,083751,Staff,26,0,30,4
1649952239908,MATH 20A,A01,083754,Staff,36,0,40,4
1649952245939,MATH 20B,A01,083756,Staff,19,0,30,11
1649952245939,MATH 20B,A02,083757,Staff,30,0,30,0
1649952251962,MATH 20C,A01,083760,Staff,22,0,30,8
1649952251962,MATH 20C,A02,083761,Staff,18,0,30,12
1649952251962,MATH 20C,B01,083762,Staff,27,0,30,3
1649952251962,MATH 20C,B02,083763,Staff,30,0,30,0
1649952257995,MATH 20D,A01,083765,Staff,19,0,30,11
1649952257995,MATH 20D,A02,083766,Staff,30,0,30,0
1649952257995,MATH 20D,A03,083767,Staff,30,0,30,0
1649952264021,MATH 20E,A01,083771,Staff,11,0,30,19
1649952264021,MATH 20E,A02,083772,Staff,24,0,30,6
1649952264021,MATH 20E,B01,083773,Staff,16,0,30,14
1649952264021,MATH 20E,B02,083774,Staff,29,0,30,1
1649952270048,MATH 103A,A01,083777,Staff,1,4,30,29
1649952270048,MATH 103A,A02,083778,Staff,0,4,30,30
1649952270048,MATH 103A,B01,083779,Staff,0,1,30,30
1649952270048,MATH 103A,B02,083780,Staff,14,0,30,16
1649952276082,MATH 105,A01,085443,Staff,0,6,30,30
1649952282113,MATH 109,A01,083213,Anzaldo; Leesa B,12,0,30,18
1649952282113,MATH 109,A02,083214,Anzaldo; Leesa B,7,0,30,23
1649952282113,MATH 109,B01,083215,Anzaldo; Leesa B,26,0,30,4
1649952282113,MATH 109,B02,083216,Anzaldo; Leesa B,19,0,30,11
1649952288141,MATH 142A,A01,083219,Chow; Bennett,0,2,30,30
1649952288141,MATH 142A,A02,083220,Chow; Bennett,5,0,30,25
1649952288141,MATH 142A,B01,083221,Chow; Bennett,0,1,30,30
1649952288141,MATH 142A,B02,083222,Chow; Bennett,0,0,30,30
1649952294166,MATH 193A,A01,083224,Staff,0,5,30,30
1649952294166,MATH 193A,A02,083225,Staff,0,3,30,30
1649952294166,MATH 193A,A03,083781,Staff,4,0,30,26
1649952294166,MATH 193A,A04,083782,Staff,15,0,30,15
1649952300192,MATH 197,001,091859,McAuley; Julian John,9999,0,9999,0
1649952306252,COGS 9,A01,083615,Staff,15,0,60,45
1649952312280,COGS 11,A01,083617,Boyle; Mary E. T.,35,0,40,5
1649952318303,COGS 13,A01,083071,Staff,0,12,40,40
1649952324327,COGS 14A,A01,092681,Staff,62,0,100,38
1649952330350,COGS 14B,A01,083073,Cheng; Tzu-Han,22,0,50,28
1649952336377,COGS 17,A01,092677,Staff,61,0,75,14
1649952342400,COGS 100,A01,083619,Staff,0,8,60,60
1649952348426,COGS 101A,A01,083621,Davis; Joshua Daniel,0,10,60,60
1649952354549,COGS 101B,A01,091572,Staff,30,0,60,30
1649952360587,COGS 101C,A01,083625,Delgado; Tania,23,0,30,7
1649952366613,COGS 107A,A01,083627,Boyle; Mary E. T.,11,0,60,49
1649952372636,COGS 118A,A01,083075,Staff,21,0,60,39
1649952378662,CSE 3,A50,083646,Miranda; Gregory Joseph,24,0,38,14
1649952378662,CSE 3,A51,083647,Miranda; Gregory Joseph,37,0,37,0
1649952384695,CSE 8A,A50,083650,Miranda; Gregory Joseph,7,0,40,33
1649952390720,CSE 11,A01,083080,Cao; Yingjun,0,30,40,40
1649952396758,CSE 12,A01,083652,Staff,50,0,100,50
1649952402786,CSE 15L,A01,083654,Staff,14,0,50,36
1649952402786,CSE 15L,A02,083655,Staff,46,0,50,4
1649952408815,CSE 20,A01,083657,Staff,67,0,80,13
1649952414842,CSE 30,A01,083084,Eldon; John,0,27,40,40
1649952420865,CSE 100,A01,083659,Cao; Yingjun,1,30,50,49
1649952426892,CSE 134B,A01,083661,Powell; Thomas Allan,0,22,65,65
1649952432919,CSE 140,A01,083663,Staff,22,0,75,53
1649952438943,CSE 140L,A01,083088,Eldon; John,16,0,75,59
1649952444972,CSE 175,A01,083665,Kumar; Rakesh,11,0,25,14
1649952450999,CSE 190,A00,092507,Dubnov; Shlomo,14,0,15,1
1649952457025,ECE 45,A01,083139,Staff,5,0,40,35
1649952463048,ECE 65,A50,083695,Staff,5,0,30,25
1649952469074,ECE 109,A01,091882,Touri; Behrouz,55,0,70,15
1649952475101,ECE 180,A00,083140,Abi Samra; Nicholas Camill,26,0,30,4
1649952475101,ECE 180,B00,083141,Abi Samra; Nicholas Camill,13,0,30,17
1649952481127,MATH 10A,A01,083735,Patchell; Gregory David,20,0,30,10
1649952481127,MATH 10A,A02,083736,Patchell; Gregory David,28,0,30,2
1649952481127,MATH 10A,A03,083737,Patchell; Gregory David,28,0,30,2
1649952487151,MATH 10B,A01,083207,Staff,10,0,30,20
1649952487151,MATH 10B,A02,083208,Staff,25,0,30,5
1649952487151,MATH 10B,B01,083739,Staff,25,0,30,5
1649952487151,MATH 10B,B02,083740,Staff,30,0,30,0
1649952493184,MATH 18,A01,083743,Staff,22,0,30,8
1649952493184,MATH 18,A02,083744,Staff,29,0,30,1
1649952493184,MATH 18,A03,083745,Staff,29,0,30,1
1649952493184,MATH 18,A04,083746,Staff,28,0,30,2
1649952493184,MATH 18,B01,083748,Staff,3,0,30,27
1649952493184,MATH 18,B02,083749,Staff,26,0,30,4
1649952493184,MATH 18,B03,083750,Staff,28,0,30,2
1649952493184,MATH 18,B04,083751,Staff,26,0,30,4
1649952499209,MATH 20A,A01,083754,Staff,36,0,40,4
1649952505239,MATH 20B,A01,083756,Staff,19,0,30,11
1649952505239,MATH 20B,A02,083757,Staff,30,0,30,0
1649952511265,MATH 20C,A01,083760,Staff,22,0,30,8
1649952511265,MATH 20C,A02,083761,Staff,18,0,30,12
1649952511265,MATH 20C,B01,083762,Staff,27,0,30,3
1649952511265,MATH 20C,B02,083763,Staff,30,0,30,0
1649952517288,MATH 20D,A01,083765,Staff,18,0,30,12
1649952517288,MATH 20D,A02,083766,Staff,30,0,30,0
1649952517288,MATH 20D,A03,083767,Staff,30,0,30,0
1649952523314,MATH 20E,A01,083771,Staff,11,0,30,19
1649952523314,MATH 20E,A02,083772,Staff,24,0,30,6
1649952523314,MATH 20E,B01,083773,Staff,16,0,30,14
1649952523314,MATH 20E,B02,083774,Staff,29,0,30,1
1649952529339,MATH 103A,A01,083777,Staff,1,4,30,29
1649952529339,MATH 103A,A02,083778,Staff,0,4,30,30
1649952529339,MATH 103A,B01,083779,Staff,0,1,30,30
1649952529339,MATH 103A,B02,083780,Staff,14,0,30,16
1649952535365,MATH 105,A01,085443,Staff,0,6,30,30
1649952541387,MATH 109,A01,083213,Anzaldo; Leesa B,12,0,30,18
1649952541387,MATH 109,A02,083214,Anzaldo; Leesa B,7,0,30,23
1649952541387,MATH 109,B01,083215,Anzaldo; Leesa B,26,0,30,4
1649952541387,MATH 109,B02,083216,Anzaldo; Leesa B,19,0,30,11
1649952547417,MATH 142A,A01,083219,Chow; Bennett,0,2,30,30
1649952547417,MATH 142A,A02,083220,Chow; Bennett,5,0,30,25
1649952547417,MATH 142A,B01,083221,Chow; Bennett,0,1,30,30
1649952547417,MATH 142A,B02,083222,Chow; Bennett,0,0,30,30
1649952553446,MATH 193A,A01,083224,Staff,0,5,30,30
1649952553446,MATH 193A,A02,083225,Staff,0,3,30,30
1649952553446,MATH 193A,A03,083781,Staff,4,0,30,26
1649952553446,MATH 193A,A04,083782,Staff,15,0,30,15
1649952559475,MATH 197,001,091859,McAuley; Julian John,9999,0,9999,0
1649952565536,COGS 9,A01,083615,Staff,15,0,60,45
1649952571559,COGS 11,A01,083617,Boyle; Mary E. T.,35,0,40,5
1649952577583,COGS 13,A01,083071,Staff,0,12,40,40
1649952583611,COGS 14A,A01,092681,Staff,62,0,100,38
1649952589635,COGS 14B,A01,083073,Cheng; Tzu-Han,22,0,50,28
1649952595661,COGS 17,A01,092677,Staff,61,0,75,14
1649952601687,COGS 100,A01,083619,Staff,0,8,60,60
1649952607719,COGS 101A,A01,083621,Davis; Joshua Daniel,0,10,60,60
1649952613753,COGS 101B,A01,091572,Staff,30,0,60,30
1649952619780,COGS 101C,A01,083625,Delgado; Tania,23,0,30,7
1649952625813,COGS 107A,A01,083627,Boyle; Mary E. T.,11,0,60,49
1649952631838,COGS 118A,A01,083075,Staff,21,0,60,39
1649952637871,CSE 3,A50,083646,Miranda; Gregory Joseph,24,0,38,14
1649952637871,CSE 3,A51,083647,Miranda; Gregory Joseph,37,0,37,0
1649952643895,CSE 8A,A50,083650,Miranda; Gregory Joseph,7,0,40,33
1649952649919,CSE 11,A01,083080,Cao; Yingjun,0,30,40,40
1649952655950,CSE 12,A01,083652,Staff,50,0,100,50
1649952661976,CSE 15L,A01,083654,Staff,14,0,50,36
1649952661976,CSE 15L,A02,083655,Staff,46,0,50,4
1649952667998,CSE 20,A01,083657,Staff,67,0,80,13
1649952674026,CSE 30,A01,083084,Eldon; John,0,27,40,40
1649952680055,CSE 100,A01,083659,Cao; Yingjun,1,30,50,49
1649952686080,CSE 134B,A01,083661,Powell; Thomas Allan,0,22,65,65
1649952692105,CSE 140,A01,083663,Staff,22,0,75,53
1649952698130,CSE 140L,A01,083088,Eldon; John,16,0,75,59
1649952704156,CSE 175,A01,083665,Kumar; Rakesh,11,0,25,14
1649952710179,CSE 190,A00,092507,Dubnov; Shlomo,14,0,15,1
1649952716214,ECE 45,A01,083139,Staff,5,0,40,35
1649952722238,ECE 65,A50,083695,Staff,5,0,30,25
1649952728260,ECE 109,A01,091882,Touri; Behrouz,55,0,70,15
1649952734290,ECE 180,A00,083140,Abi Samra; Nicholas Camill,26,0,30,4
1649952734290,ECE 180,B00,083141,Abi Samra; Nicholas Camill,13,0,30,17
1649952740315,MATH 10A,A01,083735,Patchell; Gregory David,20,0,30,10
1649952740315,MATH 10A,A02,083736,Patchell; Gregory David,28,0,30,2
1649952740315,MATH 10A,A03,083737,Patchell; Gregory David,28,0,30,2
1649952746337,MATH 10B,A01,083207,Staff,10,0,30,20
1649952746337,MATH 10B,A02,083208,Staff,25,0,30,5
1649952746337,MATH 10B,B01,083739,Staff,25,0,30,5
1649952746337,MATH 10B,B02,083740,Staff,30,0,30,0
1649952752364,MATH 18,A01,083743,Staff,22,0,30,8
1649952752364,MATH 18,A02,083744,Staff,29,0,30,1
1649952752364,MATH 18,A03,083745,Staff,29,0,30,1
1649952752364,MATH 18,A04,083746,Staff,28,0,30,2
1649952752364,MATH 18,B01,083748,Staff,3,0,30,27
1649952752364,MATH 18,B02,083749,Staff,26,0,30,4
1649952752364,MATH 18,B03,083750,Staff,28,0,30,2
1649952752364,MATH 18,B04,083751,Staff,26,0,30,4
1649952758387,MATH 20A,A01,083754,Staff,36,0,40,4
1649952764410,MATH 20B,A01,083756,Staff,19,0,30,11
1649952764410,MATH 20B,A02,083757,Staff,30,0,30,0
1649952770435,MATH 20C,A01,083760,Staff,22,0,30,8
1649952770435,MATH 20C,A02,083761,Staff,18,0,30,12
1649952770435,MATH 20C,B01,083762,Staff,27,0,30,3
1649952770435,MATH 20C,B02,083763,Staff,30,0,30,0
1649952776459,MATH 20D,A01,083765,Staff,18,0,30,12
1649952776459,MATH 20D,A02,083766,Staff,30,0,30,0
1649952776459,MATH 20D,A03,083767,Staff,30,0,30,0
1649952782483,MATH 20E,A01,083771,Staff,11,0,30,19
1649952782483,MATH 20E,A02,083772,Staff,24,0,30,6
1649952782483,MATH 20E,B01,083773,Staff,16,0,30,14
1649952782483,MATH 20E,B02,083774,Staff,29,0,30,1
1649952788505,MATH 103A,A01,083777,Staff,1,4,30,29
1649952788505,MATH 103A,A02,083778,Staff,0,4,30,30
1649952788505,MATH 103A,B01,083779,Staff,0,1,30,30
1649952788505,MATH 103A,B02,083780,Staff,14,0,30,16
1649952794532,MATH 105,A01,085443,Staff,0,6,30,30
1649952800555,MATH 109,A01,083213,Anzaldo; Leesa B,12,0,30,18
1649952800555,MATH 109,A02,083214,Anzaldo; Leesa B,7,0,30,23
1649952800555,MATH 109,B01,083215,Anzaldo; Leesa B,26,0,30,4
1649952800555,MATH 109,B02,083216,Anzaldo; Leesa B,19,0,30,11
1649952806578,MATH 142A,A01,083219,Chow; Bennett,0,2,30,30
1649952806578,MATH 142A,A02,083220,Chow; Bennett,4,0,30,26
1649952806578,MATH 142A,B01,083221,Chow; Bennett,0,1,30,30
1649952806578,MATH 142A,B02,083222,Chow; Bennett,0,0,30,30
1649952812604,MATH 193A,A01,083224,Staff,0,5,30,30
1649952812604,MATH 193A,A02,083225,Staff,0,3,30,30
1649952812604,MATH 193A,A03,083781,Staff,4,0,30,26
1649952812604,MATH 193A,A04,083782,Staff,14,0,30,16
1649952818630,MATH 197,001,091859,McAuley; Julian John,9999,0,9999,0
1649952824689,COGS 9,A01,083615,Staff,15,0,60,45
1649952830716,COGS 11,A01,083617,Boyle; Mary E. T.,35,0,40,5
1649952836740,COGS 13,A01,083071,Staff,0,12,40,40
1649952842763,COGS 14A,A01,092681,Staff,60,0,100,40
1649952848786,COGS 14B,A01,083073,Cheng; Tzu-Han,21,0,50,29
1649952854810,COGS 17,A01,092677,Staff,61,0,75,14
1649952860833,COGS 100,A01,083619,Staff,0,8,60,60
1649952866867,COGS 101A,A01,083621,Davis; Joshua Daniel,0,10,60,60
1649952872894,COGS 101B,A01,091572,Staff,30,0,60,30
1649952878918,COGS 101C,A01,083625,Delgado; Tania,23,0,30,7
1649952884946,COGS 107A,A01,083627,Boyle; Mary E. T.,11,0,60,49
1649952890967,COGS 118A,A01,083075,Staff,21,0,60,39
1649952896998,CSE 3,A50,083646,Miranda; Gregory Joseph,24,0,38,14
1649952896998,CSE 3,A51,083647,Miranda; Gregory Joseph,37,0,37,0
1649952903022,CSE 8A,A50,083650,Miranda; Gregory Joseph,7,0,40,33
1649952909054,CSE 11,A01,083080,Cao; Yingjun,0,30,40,40
1649952915080,CSE 12,A01,083652,Staff,49,0,100,51
1649952921112,CSE 15L,A01,083654,Staff,14,0,50,36
1649952921112,CSE 15L,A02,083655,Staff,46,0,50,4
1649952927154,CSE 20,A01,083657,Staff,67,0,80,13
1649952939651,CSE 30,A01,083084,Eldon; John,0,27,40,40
1649952945675,CSE 100,A01,083659,Cao; Yingjun,1,30,50,49
1649952951709,CSE 134B,A01,083661,Powell; Thomas Allan,0,22,65,65
1649952957807,CSE 140,A01,083663,Staff,21,0,75,54
1649952963837,CSE 140L,A01,083088,Eldon; John,15,0,75,60
1649952969860,CSE 175,A01,083665,Kumar; Rakesh,11,0,25,14
1649952975882,CSE 190,A00,092507,Dubnov; Shlomo,14,0,15,1
1649952981923,ECE 45,A01,083139,Staff,5,0,40,35
1649952987955,ECE 65,A50,083695,Staff,5,0,30,25
1649952993977,ECE 109,A01,091882,Touri; Behrouz,55,0,70,15
1649953000001,ECE 180,A00,083140,Abi Samra; Nicholas Camill,26,0,30,4
1649953000001,ECE 180,B00,083141,Abi Samra; Nicholas Camill,13,0,30,17
1649953006025,MATH 10A,A01,083735,Patchell; Gregory David,20,0,30,10
1649953006025,MATH 10A,A02,083736,Patchell; Gregory David,28,0,30,2
1649953006025,MATH 10A,A03,083737,Patchell; Gregory David,28,0,30,2
1649953012048,MATH 10B,A01,083207,Staff,10,0,30,20
1649953012048,MATH 10B,A02,083208,Staff,25,0,30,5
1649953012048,MATH 10B,B01,083739,Staff,25,0,30,5
1649953012048,MATH 10B,B02,083740,Staff,30,0,30,0
1649953018078,MATH 18,A01,083743,Staff,22,0,30,8
1649953018078,MATH 18,A02,083744,Staff,29,0,30,1
1649953018078,MATH 18,A03,083745,Staff,29,0,30,1
1649953018078,MATH 18,A04,083746,Staff,28,0,30,2
1649953018078,MATH 18,B01,083748,Staff,3,0,30,27
1649953018078,MATH 18,B02,083749,Staff,26,0,30,4
1649953018078,MATH 18,B03,083750,Staff,28,0,30,2
1649953018078,MATH 18,B04,083751,Staff,26,0,30,4
1649953024101,MATH 20A,A01,083754,Staff,36,0,40,4
1649953030132,MATH 20B,A01,083756,Staff,19,0,30,11
1649953030132,MATH 20B,A02,083757,Staff,30,0,30,0
1649953036154,MATH 20C,A01,083760,Staff,22,0,30,8
1649953036154,MATH 20C,A02,083761,Staff,18,0,30,12
1649953036154,MATH 20C,B01,083762,Staff,27,0,30,3
1649953036154,MATH 20C,B02,083763,Staff,30,0,30,0
1649953042188,MATH 20D,A01,083765,Staff,18,0,30,12
1649953042188,MATH 20D,A02,083766,Staff,30,0,30,0
1649953042188,MATH 20D,A03,083767,Staff,30,0,30,0
1649953048214,MATH 20E,A01,083771,Staff,11,0,30,19
1649953048214,MATH 20E,A02,083772,Staff,24,0,30,6
1649953048214,MATH 20E,B01,083773,Staff,16,0,30,14
1649953048214,MATH 20E,B02,083774,Staff,29,0,30,1
1649953054250,MATH 103A,A01,083777,Staff,1,4,30,29
1649953054250,MATH 103A,A02,083778,Staff,0,4,30,30
1649953054250,MATH 103A,B01,083779,Staff,0,1,30,30
1649953054250,MATH 103A,B02,083780,Staff,14,0,30,16
1649953060280,MATH 105,A01,085443,Staff,0,6,30,30
1649953066304,MATH 109,A01,083213,Anzaldo; Leesa B,12,0,30,18
1649953066304,MATH 109,A02,083214,Anzaldo; Leesa B,7,0,30,23
1649953066304,MATH 109,B01,083215,Anzaldo; Leesa B,26,0,30,4
1649953066304,MATH 109,B02,083216,Anzaldo; Leesa B,19,0,30,11
1649953072328,MATH 142A,A01,083219,Chow; Bennett,0,2,30,30
1649953072328,MATH 142A,A02,083220,Chow; Bennett,4,0,30,26
1649953072328,MATH 142A,B01,083221,Chow; Bennett,0,1,30,30
1649953072328,MATH 142A,B02,083222,Chow; Bennett,0,0,30,30
1649953078355,MATH 193A,A01,083224,Staff,0,5,30,30
1649953078355,MATH 193A,A02,083225,Staff,0,3,30,30
1649953078355,MATH 193A,A03,083781,Staff,4,0,30,26
1649953078355,MATH 193A,A04,083782,Staff,14,0,30,16
1649953084378,MATH 197,001,091859,McAuley; Julian John,9999,0,9999,0
1649953090437,COGS 9,A01,083615,Staff,15,0,60,45
1649953096464,COGS 11,A01,083617,Boyle; Mary E. T.,35,0,40,5
1649953102493,COGS 13,A01,083071,Staff,0,12,40,40
1649953108515,COGS 14A,A01,092681,Staff,60,0,100,40
1649953114549,COGS 14B,A01,083073,Cheng; Tzu-Han,21,0,50,29
1649953120571,COGS 17,A01,092677,Staff,61,0,75,14
1649953126595,COGS 100,A01,083619,Staff,0,8,60,60
1649953132623,COGS 101A,A01,083621,Davis; Joshua Daniel,0,10,60,60
1649953138646,COGS 101B,A01,091572,Staff,30,0,60,30
1649953144671,COGS 101C,A01,083625,Delgado; Tania,23,0,30,7
1649953150693,COGS 107A,A01,083627,Boyle; Mary E. T.,11,0,60,49
1649953156722,COGS 118A,A01,083075,Staff,21,0,60,39
1649953162747,CSE 3,A50,083646,Miranda; Gregory Joseph,24,0,38,14
1649953162747,CSE 3,A51,083647,Miranda; Gregory Joseph,37,0,37,0
1649953168779,CSE 8A,A50,083650,Miranda; Gregory Joseph,7,0,40,33
1649953174804,CSE 11,A01,083080,Cao; Yingjun,0,30,40,40
1649953180841,CSE 12,A01,083652,Staff,49,0,100,51
1649953186863,CSE 15L,A01,083654,Staff,14,0,50,36
1649953186863,CSE 15L,A02,083655,Staff,46,0,50,4
1649953192889,CSE 20,A01,083657,Staff,67,0,80,13
1649953198917,CSE 30,A01,083084,Eldon; John,0,27,40,40
1649953204945,CSE 100,A01,083659,Cao; Yingjun,1,32,50,49
1649953210978,CSE 134B,A01,083661,Powell; Thomas Allan,0,22,65,65
1649953217004,CSE 140,A01,083663,Staff,21,0,75,54
1649953223031,CSE 140L,A01,083088,Eldon; John,15,0,75,60
1649953229054,CSE 175,A01,083665,Kumar; Rakesh,11,0,25,14
1649953235080,CSE 190,A00,092507,Dubnov; Shlomo,14,0,15,1
1649953241104,ECE 45,A01,083139,Staff,5,0,40,35
1649953247133,ECE 65,A50,083695,Staff,5,0,30,25
1649953253160,ECE 109,A01,091882,Touri; Behrouz,55,0,70,15
1649953259196,ECE 180,A00,083140,Abi Samra; Nicholas Camill,26,0,30,4
1649953259196,ECE 180,B00,083141,Abi Samra; Nicholas Camill,13,0,30,17
1649953265225,MATH 10A,A01,083735,Patchell; Gregory David,20,0,30,10
1649953265225,MATH 10A,A02,083736,Patchell; Gregory David,28,0,30,2
1649953265225,MATH 10A,A03,083737,Patchell; Gregory David,28,0,30,2
1649953271255,MATH 10B,A01,083207,Staff,10,0,30,20
1649953271255,MATH 10B,A02,083208,Staff,25,0,30,5
1649953271255,MATH 10B,B01,083739,Staff,25,0,30,5
1649953271255,MATH 10B,B02,083740,Staff,30,0,30,0
1649953277282,MATH 18,A01,083743,Staff,22,0,30,8
1649953277282,MATH 18,A02,083744,Staff,29,0,30,1
1649953277282,MATH 18,A03,083745,Staff,29,0,30,1
1649953277282,MATH 18,A04,083746,Staff,28,0,30,2
1649953277282,MATH 18,B01,083748,Staff,3,0,30,27
1649953277282,MATH 18,B02,083749,Staff,26,0,30,4
1649953277282,MATH 18,B03,083750,Staff,28,0,30,2
1649953277282,MATH 18,B04,083751,Staff,26,0,30,4
1649953283305,MATH 20A,A01,083754,Staff,36,0,40,4
1649953289328,MATH 20B,A01,083756,Staff,19,0,30,11
1649953289328,MATH 20B,A02,083757,Staff,30,0,30,0
1649953295350,MATH 20C,A01,083760,Staff,22,0,30,8
1649953295350,MATH 20C,A02,083761,Staff,18,0,30,12
1649953295350,MATH 20C,B01,083762,Staff,27,0,30,3
1649953295350,MATH 20C,B02,083763,Staff,30,0,30,0
1649953301376,MATH 20D,A01,083765,Staff,18,0,30,12
1649953301376,MATH 20D,A02,083766,Staff,30,0,30,0
1649953301376,MATH 20D,A03,083767,Staff,30,0,30,0
1649953307415,MATH 20E,A01,083771,Staff,11,0,30,19
1649953307415,MATH 20E,A02,083772,Staff,24,0,30,6
1649953307415,MATH 20E,B01,083773,Staff,16,0,30,14
1649953307415,MATH 20E,B02,083774,Staff,29,0,30,1
1649953313438,MATH 103A,A01,083777,Staff,1,4,30,29
1649953313438,MATH 103A,A02,083778,Staff,0,4,30,30
1649953313438,MATH 103A,B01,083779,Staff,0,1,30,30
1649953313438,MATH 103A,B02,083780,Staff,14,0,30,16
1649953319470,MATH 105,A01,085443,Staff,0,6,30,30
1649953325506,MATH 109,A01,083213,Anzaldo; Leesa B,12,0,30,18
1649953325506,MATH 109,A02,083214,Anzaldo; Leesa B,7,0,30,23
1649953325506,MATH 109,B01,083215,Anzaldo; Leesa B,26,0,30,4
1649953325506,MATH 109,B02,083216,Anzaldo; Leesa B,19,0,30,11
1649953331543,MATH 142A,A01,083219,Chow; Bennett,0,2,30,30
1649953331543,MATH 142A,A02,083220,Chow; Bennett,4,0,30,26
1649953331543,MATH 142A,B01,083221,Chow; Bennett,0,1,30,30
1649953331543,MATH 142A,B02,083222,Chow; Bennett,0,0,30,30
1649953337567,MATH 193A,A01,083224,Staff,0,5,30,30
1649953337567,MATH 193A,A02,083225,Staff,0,3,30,30
1649953337567,MATH 193A,A03,083781,Staff,3,0,30,27
1649953337567,MATH 193A,A04,083782,Staff,14,0,30,16
1649953343594,MATH 197,001,091859,McAuley; Julian John,9999,0,9999,0
1649953349652,COGS 9,A01,083615,Staff,14,0,60,46
1649953355678,COGS 11,A01,083617,Boyle; Mary E. T.,35,0,40,5
1649953361704,COGS 13,A01,083071,Staff,0,13,40,40
1649953367729,COGS 14A,A01,092681,Staff,60,0,100,40
1649953373751,COGS 14B,A01,083073,Cheng; Tzu-Han,20,0,50,30
1649953379775,COGS 17,A01,092677,Staff,61,0,75,14
1649953385807,COGS 100,A01,083619,Staff,0,8,60,60
1649953391829,COGS 101A,A01,083621,Davis; Joshua Daniel,0,10,60,60
1649953397855,COGS 101B,A01,091572,Staff,29,0,60,31
1649953403889,COGS 101C,A01,083625,Delgado; Tania,23,0,30,7
1649953409914,COGS 107A,A01,083627,Boyle; Mary E. T.,11,0,60,49
1649953415938,COGS 118A,A01,083075,Staff,21,0,60,39
1649953421977,CSE 3,A50,083646,Miranda; Gregory Joseph,24,0,38,14
1649953421977,CSE 3,A51,083647,Miranda; Gregory Joseph,37,0,37,0
1649953428004,CSE 8A,A50,083650,Miranda; Gregory Joseph,7,0,40,33
1649953434027,CSE 11,A01,083080,Cao; Yingjun,0,30,40,40
1649953440056,CSE 12,A01,083652,Staff,49,0,100,51
1649953446083,CSE 15L,A01,083654,Staff,14,0,50,36
1649953446083,CSE 15L,A02,083655,Staff,46,0,50,4
1649953452117,CSE 20,A01,083657,Staff,67,0,80,13
1649953458169,CSE 30,A01,083084,Eldon; John,0,27,40,40
1649953464202,CSE 100,A01,083659,Cao; Yingjun,1,32,50,49
1649953470230,CSE 134B,A01,083661,Powell; Thomas Allan,0,22,65,65
1649953476251,CSE 140,A01,083663,Staff,21,0,75,54
1649953482276,CSE 140L,A01,083088,Eldon; John,15,0,75,60
1649953488299,CSE 175,A01,083665,Kumar; Rakesh,11,0,25,14
1649953494322,CSE 190,A00,092507,Dubnov; Shlomo,14,0,15,1
1649953500358,ECE 45,A01,083139,Staff,5,0,40,35
1649953506382,ECE 65,A50,083695,Staff,5,0,30,25
1649953512405,ECE 109,A01,091882,Touri; Behrouz,55,0,70,15
1649953518431,ECE 180,A00,083140,Abi Samra; Nicholas Camill,26,0,30,4
1649953518431,ECE 180,B00,083141,Abi Samra; Nicholas Camill,13,0,30,17
1649953524454,MATH 10A,A01,083735,Patchell; Gregory David,20,0,30,10
1649953524454,MATH 10A,A02,083736,Patchell; Gregory David,28,0,30,2
1649953524454,MATH 10A,A03,083737,Patchell; Gregory David,28,0,30,2
1649953530478,MATH 10B,A01,083207,Staff,10,0,30,20
1649953530478,MATH 10B,A02,083208,Staff,25,0,30,5
1649953530478,MATH 10B,B01,083739,Staff,25,0,30,5
1649953530478,MATH 10B,B02,083740,Staff,30,0,30,0
1649953536507,MATH 18,A01,083743,Staff,22,0,30,8
1649953536507,MATH 18,A02,083744,Staff,29,0,30,1
1649953536507,MATH 18,A03,083745,Staff,29,0,30,1
1649953536507,MATH 18,A04,083746,Staff,28,0,30,2
1649953536507,MATH 18,B01,083748,Staff,3,0,30,27
1649953536507,MATH 18,B02,083749,Staff,26,0,30,4
1649953536507,MATH 18,B03,083750,Staff,28,0,30,2
1649953536507,MATH 18,B04,083751,Staff,26,0,30,4
1649953542534,MATH 20A,A01,083754,Staff,36,0,40,4
1649953548566,MATH 20B,A01,083756,Staff,19,0,30,11
1649953548566,MATH 20B,A02,083757,Staff,30,0,30,0
1649953554680,MATH 20C,A01,083760,Staff,22,0,30,8
1649953554680,MATH 20C,A02,083761,Staff,18,0,30,12
1649953554680,MATH 20C,B01,083762,Staff,27,0,30,3
1649953554680,MATH 20C,B02,083763,Staff,30,0,30,0
1649953560708,MATH 20D,A01,083765,Staff,18,0,30,12
1649953560708,MATH 20D,A02,083766,Staff,30,0,30,0
1649953560708,MATH 20D,A03,083767,Staff,30,0,30,0
1649953566732,MATH 20E,A01,083771,Staff,11,0,30,19
1649953566732,MATH 20E,A02,083772,Staff,24,0,30,6
1649953566732,MATH 20E,B01,083773,Staff,16,0,30,14
1649953566732,MATH 20E,B02,083774,Staff,29,0,30,1
1649953572761,MATH 103A,A01,083777,Staff,1,4,30,29
1649953572761,MATH 103A,A02,083778,Staff,0,4,30,30
1649953572761,MATH 103A,B01,083779,Staff,0,1,30,30
1649953572761,MATH 103A,B02,083780,Staff,14,0,30,16
1649953578785,MATH 105,A01,085443,Staff,0,6,30,30
1649953584820,MATH 109,A01,083213,Anzaldo; Leesa B,11,0,30,19
1649953584820,MATH 109,A02,083214,Anzaldo; Leesa B,7,0,30,23
1649953584820,MATH 109,B01,083215,Anzaldo; Leesa B,26,0,30,4
1649953584820,MATH 109,B02,083216,Anzaldo; Leesa B,19,0,30,11
1649953590844,MATH 142A,A01,083219,Chow; Bennett,0,3,30,30
1649953590844,MATH 142A,A02,083220,Chow; Bennett,3,0,30,27
1649953590844,MATH 142A,B01,083221,Chow; Bennett,0,1,30,30
1649953590844,MATH 142A,B02,083222,Chow; Bennett,0,0,30,30
1649953596875,MATH 193A,A01,083224,Staff,0,5,30,30
1649953596875,MATH 193A,A02,083225,Staff,0,3,30,30
1649953596875,MATH 193A,A03,083781,Staff,3,0,30,27
1649953596875,MATH 193A,A04,083782,Staff,14,0,30,16
1649953602899,MATH 197,001,091859,McAuley; Julian John,9999,0,9999,0
1649953608949,COGS 9,A01,083615,Staff,14,0,60,46
1649953614971,COGS 11,A01,083617,Boyle; Mary E. T.,35,0,40,5
1649953620993,COGS 13,A01,083071,Staff,0,13,40,40
1649953627040,COGS 14A,A01,092681,Staff,60,0,100,40
1649953633067,COGS 14B,A01,083073,Cheng; Tzu-Han,20,0,50,30
1649953639108,COGS 17,A01,092677,Staff,61,0,75,14
1649953645145,COGS 100,A01,083619,Staff,0,8,60,60
1649953651168,COGS 101A,A01,083621,Davis; Joshua Daniel,0,10,60,60
1649953657192,COGS 101B,A01,091572,Staff,29,0,60,31
1649953663215,COGS 101C,A01,083625,Delgado; Tania,22,0,30,8
1649953669248,COGS 107A,A01,083627,Boyle; Mary E. T.,11,0,60,49
1649953675273,COGS 118A,A01,083075,Staff,21,0,60,39
1649953681297,CSE 3,A50,083646,Miranda; Gregory Joseph,24,0,38,14
1649953681297,CSE 3,A51,083647,Miranda; Gregory Joseph,37,0,37,0
1649953687319,CSE 8A,A50,083650,Miranda; Gregory Joseph,6,0,40,34
1649953693358,CSE 11,A01,083080,Cao; Yingjun,0,30,40,40
1649953699385,CSE 12,A01,083652,Staff,49,0,100,51
1649953705413,CSE 15L,A01,083654,Staff,14,0,50,36
1649953705413,CSE 15L,A02,083655,Staff,46,0,50,4
1649953711437,CSE 20,A01,083657,Staff,67,0,80,13
1649953717459,CSE 30,A01,083084,Eldon; John,0,27,40,40
1649953723482,CSE 100,A01,083659,Cao; Yingjun,1,32,50,49
1649953729509,CSE 134B,A01,083661,Powell; Thomas Allan,0,22,65,65
1649953735531,CSE 140,A01,083663,Staff,21,0,75,54
1649953741569,CSE 140L,A01,083088,Eldon; John,15,0,75,60
1649953747602,CSE 175,A01,083665,Kumar; Rakesh,11,0,25,14
1649953753625,CSE 190,A00,092507,Dubnov; Shlomo,14,0,15,1
1649953759648,ECE 45,A01,083139,Staff,5,0,40,35
1649953765672,ECE 65,A50,083695,Staff,5,0,30,25
1649953771707,ECE 109,A01,091882,Touri; Behrouz,55,0,70,15
1649953777737,ECE 180,A00,083140,Abi Samra; Nicholas Camill,26,0,30,4
1649953777737,ECE 180,B00,083141,Abi Samra; Nicholas Camill,13,0,30,17
1649953783765,MATH 10A,A01,083735,Patchell; Gregory David,20,0,30,10
1649953783765,MATH 10A,A02,083736,Patchell; Gregory David,28,0,30,2
1649953783765,MATH 10A,A03,083737,Patchell; Gregory David,28,0,30,2
1649953789804,MATH 10B,A01,083207,Staff,10,0,30,20
1649953789804,MATH 10B,A02,083208,Staff,25,0,30,5
1649953789804,MATH 10B,B01,083739,Staff,25,0,30,5
1649953789804,MATH 10B,B02,083740,Staff,30,0,30,0
1649953795836,MATH 18,A01,083743,Staff,22,0,30,8
1649953795836,MATH 18,A02,083744,Staff,29,0,30,1
1649953795836,MATH 18,A03,083745,Staff,29,0,30,1
1649953795836,MATH 18,A04,083746,Staff,28,0,30,2
1649953795836,MATH 18,B01,083748,Staff,3,0,30,27
1649953795836,MATH 18,B02,083749,Staff,26,0,30,4
1649953795836,MATH 18,B03,083750,Staff,28,0,30,2
1649953795836,MATH 18,B04,083751,Staff,26,0,30,4
1649953801861,MATH 20A,A01,083754,Staff,36,0,40,4
1649953807894,MATH 20B,A01,083756,Staff,19,0,30,11
1649953807894,MATH 20B,A02,083757,Staff,30,0,30,0
1649953813930,MATH 20C,A01,083760,Staff,22,0,30,8
1649953813930,MATH 20C,A02,083761,Staff,18,0,30,12
1649953813930,MATH 20C,B01,083762,Staff,27,0,30,3
1649953813930,MATH 20C,B02,083763,Staff,30,0,30,0
1649953819952,MATH 20D,A01,083765,Staff,18,0,30,12
1649953819952,MATH 20D,A02,083766,Staff,30,0,30,0
1649953819952,MATH 20D,A03,083767,Staff,30,0,30,0
1649953825981,MATH 20E,A01,083771,Staff,11,0,30,19
1649953825981,MATH 20E,A02,083772,Staff,24,0,30,6
1649953825981,MATH 20E,B01,083773,Staff,16,0,30,14
1649953825981,MATH 20E,B02,083774,Staff,29,0,30,1
1649953832010,MATH 103A,A01,083777,Staff,1,4,30,29
1649953832010,MATH 103A,A02,083778,Staff,0,4,30,30
1649953832010,MATH 103A,B01,083779,Staff,0,1,30,30
1649953832010,MATH 103A,B02,083780,Staff,14,0,30,16
1649953838035,MATH 105,A01,085443,Staff,0,6,30,30
1649953844060,MATH 109,A01,083213,Anzaldo; Leesa B,10,0,30,20
1649953844060,MATH 109,A02,083214,Anzaldo; Leesa B,7,0,30,23
1649953844060,MATH 109,B01,083215,Anzaldo; Leesa B,26,0,30,4
1649953844060,MATH 109,B02,083216,Anzaldo; Leesa B,19,0,30,11
1649953850085,MATH 142A,A01,083219,Chow; Bennett,0,3,30,30
1649953850085,MATH 142A,A02,083220,Chow; Bennett,3,0,30,27
1649953850085,MATH 142A,B01,083221,Chow; Bennett,0,1,30,30
1649953850085,MATH 142A,B02,083222,Chow; Bennett,0,0,30,30
1649953856121,MATH 193A,A01,083224,Staff,0,5,30,30
1649953856121,MATH 193A,A02,083225,Staff,0,3,30,30
1649953856121,MATH 193A,A03,083781,Staff,3,0,30,27
1649953856121,MATH 193A,A04,083782,Staff,14,0,30,16
1649953862153,MATH 197,001,091859,McAuley; Julian John,9999,0,9999,0
1649953868224,COGS 9,A01,083615,Staff,14,0,60,46
1649953874255,COGS 11,A01,083617,Boyle; Mary E. T.,35,0,40,5
1649953880279,COGS 13,A01,083071,Staff,0,13,40,40
1649953886302,COGS 14A,A01,092681,Staff,60,0,100,40
1649953892329,COGS 14B,A01,083073,Cheng; Tzu-Han,20,0,50,30
1649953898351,COGS 17,A01,092677,Staff,61,0,75,14
1649953904378,COGS 100,A01,083619,Staff,0,9,60,60
1649953910401,COGS 101A,A01,083621,Davis; Joshua Daniel,0,10,60,60
1649953916426,COGS 101B,A01,091572,Staff,28,0,60,32
1649953922449,COGS 101C,A01,083625,Delgado; Tania,22,0,30,8
1649953928483,COGS 107A,A01,083627,Boyle; Mary E. T.,11,0,60,49
1649953934506,COGS 118A,A01,083075,Staff,21,0,60,39
1649953940547,CSE 3,A50,083646,Miranda; Gregory Joseph,24,0,38,14
1649953940547,CSE 3,A51,083647,Miranda; Gregory Joseph,37,0,37,0
1649953946570,CSE 8A,A50,083650,Miranda; Gregory Joseph,6,0,40,34
1649953952607,CSE 11,A01,083080,Cao; Yingjun,0,30,40,40
1649953958634,CSE 12,A01,083652,Staff,49,0,100,51
1649953964669,CSE 15L,A01,083654,Staff,14,0,50,36
1649953964669,CSE 15L,A02,083655,Staff,46,0,50,4
1649953970693,CSE 20,A01,083657,Staff,67,0,80,13
1649953976725,CSE 30,A01,083084,Eldon; John,0,27,40,40
1649953982761,CSE 100,A01,083659,Cao; Yingjun,1,33,50,49
1649953988793,CSE 134B,A01,083661,Powell; Thomas Allan,0,22,65,65
1649953994820,CSE 140,A01,083663,Staff,21,0,75,54
1649954000853,CSE 140L,A01,083088,Eldon; John,15,0,75,60
1649954006884,CSE 175,A01,083665,Kumar; Rakesh,11,0,25,14
1649954012907,CSE 190,A00,092507,Dubnov; Shlomo,14,0,15,1
1649954018932,ECE 45,A01,083139,Staff,5,0,40,35
1649954024960,ECE 65,A50,083695,Staff,5,0,30,25
1649954030988,ECE 109,A01,091882,Touri; Behrouz,55,0,70,15
1649954037011,ECE 180,A00,083140,Abi Samra; Nicholas Camill,26,0,30,4
1649954037011,ECE 180,B00,083141,Abi Samra; Nicholas Camill,13,0,30,17
1649954043036,MATH 10A,A01,083735,Patchell; Gregory David,20,0,30,10
1649954043036,MATH 10A,A02,083736,Patchell; Gregory David,28,0,30,2
1649954043036,MATH 10A,A03,083737,Patchell; Gregory David,28,0,30,2
1649954049074,MATH 10B,A01,083207,Staff,10,0,30,20
1649954049074,MATH 10B,A02,083208,Staff,25,0,30,5
1649954049074,MATH 10B,B01,083739,Staff,25,0,30,5
1649954049074,MATH 10B,B02,083740,Staff,30,0,30,0
1649954055098,MATH 18,A01,083743,Staff,22,0,30,8
1649954055098,MATH 18,A02,083744,Staff,29,0,30,1
1649954055098,MATH 18,A03,083745,Staff,29,0,30,1
1649954055098,MATH 18,A04,083746,Staff,27,0,30,3
1649954055098,MATH 18,B01,083748,Staff,2,0,30,28
1649954055098,MATH 18,B02,083749,Staff,26,0,30,4
1649954055098,MATH 18,B03,083750,Staff,28,0,30,2
1649954055098,MATH 18,B04,083751,Staff,26,0,30,4
1649954061123,MATH 20A,A01,083754,Staff,36,0,40,4
1649954067149,MATH 20B,A01,083756,Staff,18,0,30,12
1649954067149,MATH 20B,A02,083757,Staff,30,0,30,0
1649954073178,MATH 20C,A01,083760,Staff,22,0,30,8
1649954073178,MATH 20C,A02,083761,Staff,18,0,30,12
1649954073178,MATH 20C,B01,083762,Staff,27,0,30,3
1649954073178,MATH 20C,B02,083763,Staff,30,0,30,0
1649954079204,MATH 20D,A01,083765,Staff,17,0,30,13
1649954079204,MATH 20D,A02,083766,Staff,30,0,30,0
1649954079204,MATH 20D,A03,083767,Staff,30,0,30,0
1649954085238,MATH 20E,A01,083771,Staff,11,0,30,19
1649954085238,MATH 20E,A02,083772,Staff,24,0,30,6
1649954085238,MATH 20E,B01,083773,Staff,16,0,30,14
1649954085238,MATH 20E,B02,083774,Staff,29,0,30,1
1649954091273,MATH 103A,A01,083777,Staff,1,4,30,29
1649954091273,MATH 103A,A02,083778,Staff,0,4,30,30
1649954091273,MATH 103A,B01,083779,Staff,0,1,30,30
1649954091273,MATH 103A,B02,083780,Staff,14,0,30,16
1649954097302,MATH 105,A01,085443,Staff,0,6,30,30
1649954103326,MATH 109,A01,083213,Anzaldo; Leesa B,10,0,30,20
1649954103326,MATH 109,A02,083214,Anzaldo; Leesa B,7,0,30,23
1649954103326,MATH 109,B01,083215,Anzaldo; Leesa B,26,0,30,4
1649954103326,MATH 109,B02,083216,Anzaldo; Leesa B,19,0,30,11
1649954109356,MATH 142A,A01,083219,Chow; Bennett,0,3,30,30
1649954109356,MATH 142A,A02,083220,Chow; Bennett,3,0,30,27
1649954109356,MATH 142A,B01,083221,Chow; Bennett,0,1,30,30
1649954109356,MATH 142A,B02,083222,Chow; Bennett,0,1,30,30
1649954115403,MATH 193A,A01,083224,Staff,0,5,30,30
1649954115403,MATH 193A,A02,083225,Staff,0,3,30,30
1649954115403,MATH 193A,A03,083781,Staff,3,0,30,27
1649954115403,MATH 193A,A04,083782,Staff,13,0,30,17
1649954121426,MATH 197,001,091859,McAuley; Julian John,9999,0,9999,0
1649954127477,COGS 9,A01,083615,Staff,14,0,60,46
1649954133504,COGS 11,A01,083617,Boyle; Mary E. T.,34,0,40,6
1649954139530,COGS 13,A01,083071,Staff,0,13,40,40
1649954145676,COGS 14A,A01,092681,Staff,60,0,100,40
1649954151701,COGS 14B,A01,083073,Cheng; Tzu-Han,20,0,50,30
1649954157734,COGS 17,A01,092677,Staff,61,0,75,14
1649954163772,COGS 100,A01,083619,Staff,0,9,60,60
1649954169796,COGS 101A,A01,083621,Davis; Joshua Daniel,0,10,60,60
1649954175830,COGS 101B,A01,091572,Staff,28,0,60,32
1649954181856,COGS 101C,A01,083625,Delgado; Tania,22,0,30,8
1649954187892,COGS 107A,A01,083627,Boyle; Mary E. T.,11,0,60,49
1649954193916,COGS 118A,A01,083075,Staff,21,0,60,39
1649954199942,CSE 3,A50,083646,Miranda; Gregory Joseph,24,0,38,14
1649954199942,CSE 3,A51,083647,Miranda; Gregory Joseph,37,0,37,0
1649954205968,CSE 8A,A50,083650,Miranda; Gregory Joseph,5,0,40,35
1649954211995,CSE 11,A01,083080,Cao; Yingjun,0,30,40,40
1649954218021,CSE 12,A01,083652,Staff,49,0,100,51
1649954224045,CSE 15L,A01,083654,Staff,14,0,50,36
1649954224045,CSE 15L,A02,083655,Staff,46,0,50,4
1649954230068,CSE 20,A01,083657,Staff,66,0,80,14
1649954236099,CSE 30,A01,083084,Eldon; John,0,28,40,40
1649954242124,CSE 100,A01,083659,Cao; Yingjun,1,33,50,49
1649954248150,CSE 134B,A01,083661,Powell; Thomas Allan,0,22,65,65
1649954254186,CSE 140,A01,083663,Staff,21,0,75,54
1649954260212,CSE 140L,A01,083088,Eldon; John,15,0,75,60
1649954266240,CSE 175,A01,083665,Kumar; Rakesh,11,0,25,14
1649954272267,CSE 190,A00,092507,Dubnov; Shlomo,14,0,15,1
1649954278296,ECE 45,A01,083139,Staff,4,0,40,36
1649954284325,ECE 65,A50,083695,Staff,5,0,30,25
1649954290353,ECE 109,A01,091882,Touri; Behrouz,54,0,70,16
1649954296400,ECE 180,A00,083140,Abi Samra; Nicholas Camill,26,0,30,4
1649954296400,ECE 180,B00,083141,Abi Samra; Nicholas Camill,13,0,30,17
1649954302431,MATH 10A,A01,083735,Patchell; Gregory David,20,0,30,10
1649954302431,MATH 10A,A02,083736,Patchell; Gregory David,28,0,30,2
1649954302431,MATH 10A,A03,083737,Patchell; Gregory David,28,0,30,2
1649954308462,MATH 10B,A01,083207,Staff,10,0,30,20
1649954308462,MATH 10B,A02,083208,Staff,25,0,30,5
1649954308462,MATH 10B,B01,083739,Staff,25,0,30,5
1649954308462,MATH 10B,B02,083740,Staff,30,0,30,0
1649954314496,MATH 18,A01,083743,Staff,22,0,30,8
1649954314496,MATH 18,A02,083744,Staff,29,0,30,1
1649954314496,MATH 18,A03,083745,Staff,29,0,30,1
1649954314496,MATH 18,A04,083746,Staff,27,0,30,3
1649954314496,MATH 18,B01,083748,Staff,2,0,30,28
1649954314496,MATH 18,B02,083749,Staff,26,0,30,4
1649954314496,MATH 18,B03,083750,Staff,28,0,30,2
1649954314496,MATH 18,B04,083751,Staff,26,0,30,4
1649954320518,MATH 20A,A01,083754,Staff,36,0,40,4
1649954326548,MATH 20B,A01,083756,Staff,18,0,30,12
1649954326548,MATH 20B,A02,083757,Staff,30,0,30,0
1649954332583,MATH 20C,A01,083760,Staff,22,0,30,8
1649954332583,MATH 20C,A02,083761,Staff,18,0,30,12
1649954332583,MATH 20C,B01,083762,Staff,27,0,30,3
1649954332583,MATH 20C,B02,083763,Staff,30,0,30,0
1649954338606,MATH 20D,A01,083765,Staff,17,0,30,13
1649954338606,MATH 20D,A02,083766,Staff,30,0,30,0
1649954338606,MATH 20D,A03,083767,Staff,30,0,30,0
1649954344633,MATH 20E,A01,083771,Staff,11,0,30,19
1649954344633,MATH 20E,A02,083772,Staff,24,0,30,6
1649954344633,MATH 20E,B01,083773,Staff,16,0,30,14
1649954344633,MATH 20E,B02,083774,Staff,29,0,30,1
1649954350657,MATH 103A,A01,083777,Staff,1,4,30,29
1649954350657,MATH 103A,A02,083778,Staff,0,4,30,30
1649954350657,MATH 103A,B01,083779,Staff,0,1,30,30
1649954350657,MATH 103A,B02,083780,Staff,14,0,30,16
1649954356683,MATH 105,A01,085443,Staff,0,6,30,30
1649954362722,MATH 109,A01,083213,Anzaldo; Leesa B,10,0,30,20
1649954362722,MATH 109,A02,083214,Anzaldo; Leesa B,7,0,30,23
1649954362722,MATH 109,B01,083215,Anzaldo; Leesa B,26,0,30,4
1649954362722,MATH 109,B02,083216,Anzaldo; Leesa B,19,0,30,11
1649954368745,MATH 142A,A01,083219,Chow; Bennett,0,3,30,30
1649954368745,MATH 142A,A02,083220,Chow; Bennett,3,0,30,27
1649954368745,MATH 142A,B01,083221,Chow; Bennett,0,1,30,30
1649954368745,MATH 142A,B02,083222,Chow; Bennett,0,1,30,30
1649954374769,MATH 193A,A01,083224,Staff,0,5,30,30
1649954374769,MATH 193A,A02,083225,Staff,0,3,30,30
1649954374769,MATH 193A,A03,083781,Staff,3,0,30,27
1649954374769,MATH 193A,A04,083782,Staff,13,0,30,17
1649954380803,MATH 197,001,091859,McAuley; Julian John,9999,0,9999,0
1649954386855,COGS 9,A01,083615,Staff,14,0,60,46
1649954392877,COGS 11,A01,083617,Boyle; Mary E. T.,34,0,40,6
1649954398900,COGS 13,A01,083071,Staff,0,13,40,40
1649954404934,COGS 14A,A01,092681,Staff,60,0,100,40
1649954410960,COGS 14B,A01,083073,Cheng; Tzu-Han,20,0,50,30
1649954416986,COGS 17,A01,092677,Staff,61,0,75,14
1649954423010,COGS 100,A01,083619,Staff,0,9,60,60
1649954429037,COGS 101A,A01,083621,Davis; Joshua Daniel,0,10,60,60
1649954435063,COGS 101B,A01,091572,Staff,28,0,60,32
1649954441098,COGS 101C,A01,083625,Delgado; Tania,22,0,30,8
1649954447128,COGS 107A,A01,083627,Boyle; Mary E. T.,11,0,60,49
1649954453151,COGS 118A,A01,083075,Staff,21,0,60,39
1649954459177,CSE 3,A50,083646,Miranda; Gregory Joseph,24,0,38,14
1649954459177,CSE 3,A51,083647,Miranda; Gregory Joseph,37,0,37,0
1649954465205,CSE 8A,A50,083650,Miranda; Gregory Joseph,5,0,40,35
1649954471235,CSE 11,A01,083080,Cao; Yingjun,0,30,40,40
1649954477263,CSE 12,A01,083652,Staff,49,0,100,51
1649954483294,CSE 15L,A01,083654,Staff,14,0,50,36
1649954483294,CSE 15L,A02,083655,Staff,46,0,50,4
1649954489316,CSE 20,A01,083657,Staff,66,0,80,14
1649954495338,CSE 30,A01,083084,Eldon; John,0,28,40,40
1649954501366,CSE 100,A01,083659,Cao; Yingjun,1,33,50,49
1649954507392,CSE 134B,A01,083661,Powell; Thomas Allan,0,22,65,65
1649954513433,CSE 140,A01,083663,Staff,21,0,75,54
1649954519456,CSE 140L,A01,083088,Eldon; John,15,0,75,60
1649954525482,CSE 175,A01,083665,Kumar; Rakesh,11,0,25,14
1649954531508,CSE 190,A00,092507,Dubnov; Shlomo,14,0,15,1
1649954537534,ECE 45,A01,083139,Staff,4,0,40,36
1649954543563,ECE 65,A50,083695,Staff,5,0,30,25
1649954549587,ECE 109,A01,091882,Touri; Behrouz,54,0,70,16
1649954555611,ECE 180,A00,083140,Abi Samra; Nicholas Camill,26,0,30,4
1649954555611,ECE 180,B00,083141,Abi Samra; Nicholas Camill,13,0,30,17
1649954561635,MATH 10A,A01,083735,Patchell; Gregory David,20,0,30,10
1649954561635,MATH 10A,A02,083736,Patchell; Gregory David,28,0,30,2
1649954561635,MATH 10A,A03,083737,Patchell; Gregory David,28,0,30,2
1649954567659,MATH 10B,A01,083207,Staff,10,0,30,20
1649954567659,MATH 10B,A02,083208,Staff,25,0,30,5
1649954567659,MATH 10B,B01,083739,Staff,25,0,30,5
1649954567659,MATH 10B,B02,083740,Staff,30,0,30,0
1649954573683,MATH 18,A01,083743,Staff,22,0,30,8
1649954573683,MATH 18,A02,083744,Staff,29,0,30,1
1649954573683,MATH 18,A03,083745,Staff,29,0,30,1
1649954573683,MATH 18,A04,083746,Staff,27,0,30,3
1649954573683,MATH 18,B01,083748,Staff,1,0,30,29
1649954573683,MATH 18,B02,083749,Staff,26,0,30,4
1649954573683,MATH 18,B03,083750,Staff,28,0,30,2
1649954573683,MATH 18,B04,083751,Staff,26,0,30,4
1649954579708,MATH 20A,A01,083754,Staff,36,0,40,4
1649954585735,MATH 20B,A01,083756,Staff,17,0,30,13
1649954585735,MATH 20B,A02,083757,Staff,30,0,30,0
1649954591774,MATH 20C,A01,083760,Staff,22,0,30,8
1649954591774,MATH 20C,A02,083761,Staff,18,0,30,12
1649954591774,MATH 20C,B01,083762,Staff,27,0,30,3
1649954591774,MATH 20C,B02,083763,Staff,30,0,30,0
1649954597798,MATH 20D,A01,083765,Staff,17,0,30,13
1649954597798,MATH 20D,A02,083766,Staff,30,0,30,0
1649954597798,MATH 20D,A03,083767,Staff,30,0,30,0
1649954603822,MATH 20E,A01,083771,Staff,11,0,30,19
1649954603822,MATH 20E,A02,083772,Staff,24,0,30,6
1649954603822,MATH 20E,B01,083773,Staff,16,0,30,14
1649954603822,MATH 20E,B02,083774,Staff,29,0,30,1
1649954609847,MATH 103A,A01,083777,Staff,1,4,30,29
1649954609847,MATH 103A,A02,083778,Staff,0,4,30,30
1649954609847,MATH 103A,B01,083779,Staff,0,1,30,30
1649954609847,MATH 103A,B02,083780,Staff,14,0,30,16
1649954615873,MATH 105,A01,085443,Staff,0,6,30,30
1649954621902,MATH 109,A01,083213,Anzaldo; Leesa B,9,0,30,21
1649954621902,MATH 109,A02,083214,Anzaldo; Leesa B,6,0,30,24
1649954621902,MATH 109,B01,083215,Anzaldo; Leesa B,26,0,30,4
1649954621902,MATH 109,B02,083216,Anzaldo; Leesa B,19,0,30,11
1649954627932,MATH 142A,A01,083219,Chow; Bennett,0,3,30,30
1649954627932,MATH 142A,A02,083220,Chow; Bennett,3,0,30,27
1649954627932,MATH 142A,B01,083221,Chow; Bennett,0,1,30,30
1649954627932,MATH 142A,B02,083222,Chow; Bennett,0,1,30,30
1649954633971,MATH 193A,A01,083224,Staff,0,5,30,30
1649954633971,MATH 193A,A02,083225,Staff,0,3,30,30
1649954633971,MATH 193A,A03,083781,Staff,3,0,30,27
1649954633971,MATH 193A,A04,083782,Staff,13,0,30,17
1649954639995,MATH 197,001,091859,McAuley; Julian John,9999,0,9999,0
1649954646061,COGS 9,A01,083615,Staff,13,0,60,47
1649954652087,COGS 11,A01,083617,Boyle; Mary E. T.,34,0,40,6
1649954658112,COGS 13,A01,083071,Staff,0,13,40,40
1649954664138,COGS 14A,A01,092681,Staff,60,0,100,40
1649954670175,COGS 14B,A01,083073,Cheng; Tzu-Han,20,0,50,30
1649954676205,COGS 17,A01,092677,Staff,61,0,75,14
1649954682236,COGS 100,A01,083619,Staff,0,9,60,60
1649954688260,COGS 101A,A01,083621,Davis; Joshua Daniel,0,10,60,60
1649954694285,COGS 101B,A01,091572,Staff,28,0,60,32
1649954700318,COGS 101C,A01,083625,Delgado; Tania,22,0,30,8
1649954706341,COGS 107A,A01,083627,Boyle; Mary E. T.,11,0,60,49
1649954712364,COGS 118A,A01,083075,Staff,21,0,60,39
1649954718399,CSE 3,A50,083646,Miranda; Gregory Joseph,24,0,38,14
1649954718399,CSE 3,A51,083647,Miranda; Gregory Joseph,37,0,37,0
1649954724435,CSE 8A,A50,083650,Miranda; Gregory Joseph,5,0,40,35
1649954730470,CSE 11,A01,083080,Cao; Yingjun,0,30,40,40
1649954736495,CSE 12,A01,083652,Staff,49,0,100,51
1649954742618,CSE 15L,A01,083654,Staff,14,0,50,36
1649954742618,CSE 15L,A02,083655,Staff,46,0,50,4
1649954748647,CSE 20,A01,083657,Staff,66,0,80,14
1649954754669,CSE 30,A01,083084,Eldon; John,0,29,40,40
1649954760706,CSE 100,A01,083659,Cao; Yingjun,1,34,50,49
1649954766729,CSE 134B,A01,083661,Powell; Thomas Allan,0,22,65,65
1649954772752,CSE 140,A01,083663,Staff,21,0,75,54
1649954778789,CSE 140L,A01,083088,Eldon; John,15,0,75,60
1649954784813,CSE 175,A01,083665,Kumar; Rakesh,11,0,25,14
1649954790857,CSE 190,A00,092507,Dubnov; Shlomo,14,0,15,1
1649954796894,ECE 45,A01,083139,Staff,4,0,40,36
1649954802926,ECE 65,A50,083695,Staff,5,0,30,25
1649954808953,ECE 109,A01,091882,Touri; Behrouz,53,0,70,17
1649954814989,ECE 180,A00,083140,Abi Samra; Nicholas Camill,26,0,30,4
1649954814989,ECE 180,B00,083141,Abi Samra; Nicholas Camill,13,0,30,17
1649954821020,MATH 10A,A01,083735,Patchell; Gregory David,20,0,30,10
1649954821020,MATH 10A,A02,083736,Patchell; Gregory David,28,0,30,2
1649954821020,MATH 10A,A03,083737,Patchell; Gregory David,28,0,30,2
1649954827042,MATH 10B,A01,083207,Staff,10,0,30,20
1649954827042,MATH 10B,A02,083208,Staff,25,0,30,5
1649954827042,MATH 10B,B01,083739,Staff,25,0,30,5
1649954827042,MATH 10B,B02,083740,Staff,30,0,30,0
1649954833068,MATH 18,A01,083743,Staff,22,0,30,8
1649954833068,MATH 18,A02,083744,Staff,29,0,30,1
1649954833068,MATH 18,A03,083745,Staff,29,0,30,1
1649954833068,MATH 18,A04,083746,Staff,27,0,30,3
1649954833068,MATH 18,B01,083748,Staff,1,0,30,29
1649954833068,MATH 18,B02,083749,Staff,26,0,30,4
1649954833068,MATH 18,B03,083750,Staff,28,0,30,2
1649954833068,MATH 18,B04,083751,Staff,26,0,30,4
1649954839094,MATH 20A,A01,083754,Staff,36,0,40,4
1649954845126,MATH 20B,A01,083756,Staff,17,0,30,13
1649954845126,MATH 20B,A02,083757,Staff,30,0,30,0
1649954851150,MATH 20C,A01,083760,Staff,22,0,30,8
1649954851150,MATH 20C,A02,083761,Staff,18,0,30,12
1649954851150,MATH 20C,B01,083762,Staff,27,0,30,3
1649954851150,MATH 20C,B02,083763,Staff,30,0,30,0
1649954857170,MATH 20D,A01,083765,Staff,17,0,30,13
1649954857170,MATH 20D,A02,083766,Staff,30,0,30,0
1649954857170,MATH 20D,A03,083767,Staff,30,0,30,0
1649954863193,MATH 20E,A01,083771,Staff,11,0,30,19
1649954863193,MATH 20E,A02,083772,Staff,24,0,30,6
1649954863193,MATH 20E,B01,083773,Staff,16,0,30,14
1649954863193,MATH 20E,B02,083774,Staff,29,0,30,1
1649954869217,MATH 103A,A01,083777,Staff,1,4,30,29
1649954869217,MATH 103A,A02,083778,Staff,0,4,30,30
1649954869217,MATH 103A,B01,083779,Staff,0,1,30,30
1649954869217,MATH 103A,B02,083780,Staff,14,0,30,16
1649954875244,MATH 105,A01,085443,Staff,0,6,30,30
1649954881267,MATH 109,A01,083213,Anzaldo; Leesa B,9,0,30,21
1649954881267,MATH 109,A02,083214,Anzaldo; Leesa B,6,0,30,24
1649954881267,MATH 109,B01,083215,Anzaldo; Leesa B,26,0,30,4
1649954881267,MATH 109,B02,083216,Anzaldo; Leesa B,19,0,30,11
1649954887297,MATH 142A,A01,083219,Chow; Bennett,0,3,30,30
1649954887297,MATH 142A,A02,083220,Chow; Bennett,2,0,30,28
1649954887297,MATH 142A,B01,083221,Chow; Bennett,0,1,30,30
1649954887297,MATH 142A,B02,083222,Chow; Bennett,0,1,30,30
1649954893319,MATH 193A,A01,083224,Staff,0,5,30,30
1649954893319,MATH 193A,A02,083225,Staff,0,3,30,30
1649954893319,MATH 193A,A03,083781,Staff,3,0,30,27
1649954893319,MATH 193A,A04,083782,Staff,13,0,30,17
1649954899347,MATH 197,001,091859,McAuley; Julian John,9999,0,9999,0
1649954905408,COGS 9,A01,083615,Staff,13,0,60,47
1649954911438,COGS 11,A01,083617,Boyle; Mary E. T.,34,0,40,6
1649954917460,COGS 13,A01,083071,Staff,0,13,40,40
1649954923483,COGS 14A,A01,092681,Staff,60,0,100,40
1649954929519,COGS 14B,A01,083073,Cheng; Tzu-Han,20,0,50,30
1649954935546,COGS 17,A01,092677,Staff,61,0,75,14
1649954941570,COGS 100,A01,083619,Staff,0,9,60,60
1649954947602,COGS 101A,A01,083621,Davis; Joshua Daniel,0,10,60,60
1649954953626,COGS 101B,A01,091572,Staff,28,0,60,32
1649954959648,COGS 101C,A01,083625,Delgado; Tania,22,0,30,8
1649954965676,COGS 107A,A01,083627,Boyle; Mary E. T.,11,0,60,49
1649954971705,COGS 118A,A01,083075,Staff,21,0,60,39
1649954977737,CSE 3,A50,083646,Miranda; Gregory Joseph,24,0,38,14
1649954977737,CSE 3,A51,083647,Miranda; Gregory Joseph,37,0,37,0
1649954983766,CSE 8A,A50,083650,Miranda; Gregory Joseph,5,0,40,35
1649954989806,CSE 11,A01,083080,Cao; Yingjun,0,30,40,40
1649954995832,CSE 12,A01,083652,Staff,49,0,100,51
1649955001856,CSE 15L,A01,083654,Staff,14,0,50,36
1649955001856,CSE 15L,A02,083655,Staff,46,0,50,4
1649955007897,CSE 20,A01,083657,Staff,66,0,80,14
1649955013927,CSE 30,A01,083084,Eldon; John,0,30,40,40
1649955019951,CSE 100,A01,083659,Cao; Yingjun,1,34,50,49
1649955025978,CSE 134B,A01,083661,Powell; Thomas Allan,0,22,65,65
1649955032110,CSE 140,A01,083663,Staff,21,0,75,54
1649955038143,CSE 140L,A01,083088,Eldon; John,15,0,75,60
1649955044175,CSE 175,A01,083665,Kumar; Rakesh,11,0,25,14
1649955050209,CSE 190,A00,092507,Dubnov; Shlomo,14,0,15,1
1649955056239,ECE 45,A01,083139,Staff,4,0,40,36
1649955062263,ECE 65,A50,083695,Staff,5,0,30,25
1649955068286,ECE 109,A01,091882,Touri; Behrouz,53,0,70,17
1649955074312,ECE 180,A00,083140,Abi Samra; Nicholas Camill,26,0,30,4
1649955074312,ECE 180,B00,083141,Abi Samra; Nicholas Camill,13,0,30,17
1649955080338,MATH 10A,A01,083735,Patchell; Gregory David,20,0,30,10
1649955080338,MATH 10A,A02,083736,Patchell; Gregory David,28,0,30,2
1649955080338,MATH 10A,A03,083737,Patchell; Gregory David,28,0,30,2
1649955086364,MATH 10B,A01,083207,Staff,10,0,30,20
1649955086364,MATH 10B,A02,083208,Staff,25,0,30,5
1649955086364,MATH 10B,B01,083739,Staff,25,0,30,5
1649955086364,MATH 10B,B02,083740,Staff,30,0,30,0
1649955092399,MATH 18,A01,083743,Staff,22,0,30,8
1649955092399,MATH 18,A02,083744,Staff,29,0,30,1
1649955092399,MATH 18,A03,083745,Staff,29,0,30,1
1649955092399,MATH 18,A04,083746,Staff,27,0,30,3
1649955092399,MATH 18,B01,083748,Staff,1,0,30,29
1649955092399,MATH 18,B02,083749,Staff,26,0,30,4
1649955092399,MATH 18,B03,083750,Staff,28,0,30,2
1649955092399,MATH 18,B04,083751,Staff,26,0,30,4
1649955098423,MATH 20A,A01,083754,Staff,36,0,40,4
1649955104456,MATH 20B,A01,083756,Staff,17,0,30,13
1649955104456,MATH 20B,A02,083757,Staff,30,0,30,0
1649955110481,MATH 20C,A01,083760,Staff,22,0,30,8
1649955110481,MATH 20C,A02,083761,Staff,18,0,30,12
1649955110481,MATH 20C,B01,083762,Staff,27,0,30,3
1649955110481,MATH 20C,B02,083763,Staff,30,0,30,0
1649955116514,MATH 20D,A01,083765,Staff,17,0,30,13
1649955116514,MATH 20D,A02,083766,Staff,30,0,30,0
1649955116514,MATH 20D,A03,083767,Staff,30,0,30,0
1649955122540,MATH 20E,A01,083771,Staff,11,0,30,19
1649955122540,MATH 20E,A02,083772,Staff,24,0,30,6
1649955122540,MATH 20E,B01,083773,Staff,15,0,30,15
1649955122540,MATH 20E,B02,083774,Staff,29,0,30,1
1649955128567,MATH 103A,A01,083777,Staff,1,4,30,29
1649955128567,MATH 103A,A02,083778,Staff,0,4,30,30
1649955128567,MATH 103A,B01,083779,Staff,0,1,30,30
1649955128567,MATH 103A,B02,083780,Staff,14,0,30,16
1649955134591,MATH 105,A01,085443,Staff,0,6,30,30
1649955140619,MATH 109,A01,083213,Anzaldo; Leesa B,9,0,30,21
1649955140619,MATH 109,A02,083214,Anzaldo; Leesa B,6,0,30,24
1649955140619,MATH 109,B01,083215,Anzaldo; Leesa B,26,0,30,4
1649955140619,MATH 109,B02,083216,Anzaldo; Leesa B,19,0,30,11
1649955146649,MATH 142A,A01,083219,Chow; Bennett,0,3,30,30
1649955146649,MATH 142A,A02,083220,Chow; Bennett,2,0,30,28
1649955146649,MATH 142A,B01,083221,Chow; Bennett,0,1,30,30
1649955146649,MATH 142A,B02,083222,Chow; Bennett,0,1,30,30
1649955152676,MATH 193A,A01,083224,Staff,0,5,30,30
1649955152676,MATH 193A,A02,083225,Staff,0,3,30,30
1649955152676,MATH 193A,A03,083781,Staff,3,0,30,27
1649955152676,MATH 193A,A04,083782,Staff,13,0,30,17
1649955158714,MATH 197,001,091859,McAuley; Julian John,9999,0,9999,0
1649955164776,COGS 9,A01,083615,Staff,13,0,60,47
1649955170809,COGS 11,A01,083617,Boyle; Mary E. T.,34,0,40,6
1649955176843,COGS 13,A01,083071,Staff,0,13,40,40
1649955182885,COGS 14A,A01,092681,Staff,61,0,100,39
1649955188912,COGS 14B,A01,083073,Cheng; Tzu-Han,20,0,50,30
1649955194942,COGS 17,A01,092677,Staff,61,0,75,14
1649955200966,COGS 100,A01,083619,Staff,0,9,60,60
1649955207006,COGS 101A,A01,083621,Davis; Joshua Daniel,0,10,60,60
1649955213029,COGS 101B,A01,091572,Staff,28,0,60,32
1649955219063,COGS 101C,A01,083625,Delgado; Tania,22,0,30,8
1649955225086,COGS 107A,A01,083627,Boyle; Mary E. T.,11,0,60,49
1649955231109,COGS 118A,A01,083075,Staff,21,0,60,39
1649955237131,CSE 3,A50,083646,Miranda; Gregory Joseph,24,0,38,14
1649955237131,CSE 3,A51,083647,Miranda; Gregory Joseph,37,0,37,0
1649955243154,CSE 8A,A50,083650,Miranda; Gregory Joseph,4,0,40,36
1649955249178,CSE 11,A01,083080,Cao; Yingjun,0,31,40,40
1649955255201,CSE 12,A01,083652,Staff,49,0,100,51
1649955261224,CSE 15L,A01,083654,Staff,14,0,50,36
1649955261224,CSE 15L,A02,083655,Staff,46,0,50,4
1649955267258,CSE 20,A01,083657,Staff,66,0,80,14
1649955273283,CSE 30,A01,083084,Eldon; John,0,31,40,40
1649955279307,CSE 100,A01,083659,Cao; Yingjun,1,34,50,49
1649955285330,CSE 134B,A01,083661,Powell; Thomas Allan,0,23,65,65
1649955291360,CSE 140,A01,083663,Staff,19,0,75,56
1649955297383,CSE 140L,A01,083088,Eldon; John,15,0,75,60
1649955303410,CSE 175,A01,083665,Kumar; Rakesh,11,0,25,14
1649955309433,CSE 190,A00,092507,Dubnov; Shlomo,13,0,15,2
1649955315456,ECE 45,A01,083139,Staff,4,0,40,36
1649955321482,ECE 65,A50,083695,Staff,4,0,30,26
1649955327507,ECE 109,A01,091882,Touri; Behrouz,53,0,70,17
1649955333531,ECE 180,A00,083140,Abi Samra; Nicholas Camill,26,0,30,4
1649955333531,ECE 180,B00,083141,Abi Samra; Nicholas Camill,13,0,30,17
1649955339652,MATH 10A,A01,083735,Patchell; Gregory David,20,0,30,10
1649955339652,MATH 10A,A02,083736,Patchell; Gregory David,28,0,30,2
1649955339652,MATH 10A,A03,083737,Patchell; Gregory David,28,0,30,2
1649955345676,MATH 10B,A01,083207,Staff,10,0,30,20
1649955345676,MATH 10B,A02,083208,Staff,25,0,30,5
1649955345676,MATH 10B,B01,083739,Staff,25,0,30,5
1649955345676,MATH 10B,B02,083740,Staff,30,0,30,0
1649955351699,MATH 18,A01,083743,Staff,22,0,30,8
1649955351699,MATH 18,A02,083744,Staff,29,0,30,1
1649955351699,MATH 18,A03,083745,Staff,29,0,30,1
1649955351699,MATH 18,A04,083746,Staff,27,0,30,3
1649955351699,MATH 18,B01,083748,Staff,0,0,30,30
1649955351699,MATH 18,B02,083749,Staff,26,0,30,4
1649955351699,MATH 18,B03,083750,Staff,28,0,30,2
1649955351699,MATH 18,B04,083751,Staff,26,0,30,4
1649955357725,MATH 20A,A01,083754,Staff,36,0,40,4
1649955363748,MATH 20B,A01,083756,Staff,17,0,30,13
1649955363748,MATH 20B,A02,083757,Staff,30,0,30,0
1649955369778,MATH 20C,A01,083760,Staff,21,0,30,9
1649955369778,MATH 20C,A02,083761,Staff,17,0,30,13
1649955369778,MATH 20C,B01,083762,Staff,27,0,30,3
1649955369778,MATH 20C,B02,083763,Staff,30,0,30,0
1649955375806,MATH 20D,A01,083765,Staff,17,0,30,13
1649955375806,MATH 20D,A02,083766,Staff,30,0,30,0
1649955375806,MATH 20D,A03,083767,Staff,30,0,30,0
1649955381830,MATH 20E,A01,083771,Staff,11,0,30,19
1649955381830,MATH 20E,A02,083772,Staff,24,0,30,6
1649955381830,MATH 20E,B01,083773,Staff,14,0,30,16
1649955381830,MATH 20E,B02,083774,Staff,29,0,30,1
1649955387868,MATH 103A,A01,083777,Staff,1,4,30,29
1649955387868,MATH 103A,A02,083778,Staff,0,4,30,30
1649955387868,MATH 103A,B01,083779,Staff,0,1,30,30
1649955387868,MATH 103A,B02,083780,Staff,14,0,30,16
1649955393890,MATH 105,A01,085443,Staff,0,6,30,30
1649955399914,MATH 109,A01,083213,Anzaldo; Leesa B,9,0,30,21
1649955399914,MATH 109,A02,083214,Anzaldo; Leesa B,6,0,30,24
1649955399914,MATH 109,B01,083215,Anzaldo; Leesa B,26,0,30,4
1649955399914,MATH 109,B02,083216,Anzaldo; Leesa B,19,0,30,11
1649955405944,MATH 142A,A01,083219,Chow; Bennett,0,3,30,30
1649955405944,MATH 142A,A02,083220,Chow; Bennett,3,0,30,27
1649955405944,MATH 142A,B01,083221,Chow; Bennett,0,1,30,30
1649955405944,MATH 142A,B02,083222,Chow; Bennett,0,1,30,30
1649955411967,MATH 193A,A01,083224,Staff,0,5,30,30
1649955411967,MATH 193A,A02,083225,Staff,0,3,30,30
1649955411967,MATH 193A,A03,083781,Staff,3,0,30,27
1649955411967,MATH 193A,A04,083782,Staff,13,0,30,17
1649955417992,MATH 197,001,091859,McAuley; Julian John,9999,0,9999,0
1649955424056,COGS 9,A01,083615,Staff,13,0,60,47
1649955430081,COGS 11,A01,083617,Boyle; Mary E. T.,34,0,40,6
1649955436113,COGS 13,A01,083071,Staff,0,13,40,40
1649955442134,COGS 14A,A01,092681,Staff,61,0,100,39
1649955448157,COGS 14B,A01,083073,Cheng; Tzu-Han,20,0,50,30
1649955454182,COGS 17,A01,092677,Staff,61,0,75,14
1649955460205,COGS 100,A01,083619,Staff,0,9,60,60
1649955466231,COGS 101A,A01,083621,Davis; Joshua Daniel,0,10,60,60
1649955472258,COGS 101B,A01,091572,Staff,28,0,60,32
1649955478284,COGS 101C,A01,083625,Delgado; Tania,22,0,30,8
1649955484306,COGS 107A,A01,083627,Boyle; Mary E. T.,11,0,60,49
1649955490333,COGS 118A,A01,083075,Staff,21,0,60,39
1649955496366,CSE 3,A50,083646,Miranda; Gregory Joseph,24,0,38,14
1649955496366,CSE 3,A51,083647,Miranda; Gregory Joseph,37,0,37,0
1649955502404,CSE 8A,A50,083650,Miranda; Gregory Joseph,4,0,40,36
1649955508428,CSE 11,A01,083080,Cao; Yingjun,0,31,40,40
1649955514479,CSE 12,A01,083652,Staff,49,0,100,51
1649955520504,CSE 15L,A01,083654,Staff,14,0,50,36
1649955520504,CSE 15L,A02,083655,Staff,46,0,50,4
1649955526535,CSE 20,A01,083657,Staff,66,0,80,14
1649955532562,CSE 30,A01,083084,Eldon; John,0,31,40,40
1649955538584,CSE 100,A01,083659,Cao; Yingjun,1,34,50,49
1649955544624,CSE 134B,A01,083661,Powell; Thomas Allan,0,23,65,65
1649955550652,CSE 140,A01,083663,Staff,19,0,75,56
1649955556688,CSE 140L,A01,083088,Eldon; John,14,0,75,61
1649955562710,CSE 175,A01,083665,Kumar; Rakesh,11,0,25,14
1649955568737,CSE 190,A00,092507,Dubnov; Shlomo,13,0,15,2
1649955574765,ECE 45,A01,083139,Staff,4,0,40,36
1649955580804,ECE 65,A50,083695,Staff,4,0,30,26
1649955586845,ECE 109,A01,091882,Touri; Behrouz,53,0,70,17
1649955592870,ECE 180,A00,083140,Abi Samra; Nicholas Camill,26,0,30,4
1649955592870,ECE 180,B00,083141,Abi Samra; Nicholas Camill,13,0,30,17
1649955598892,MATH 10A,A01,083735,Patchell; Gregory David,20,0,30,10
1649955598892,MATH 10A,A02,083736,Patchell; Gregory David,28,0,30,2
1649955598892,MATH 10A,A03,083737,Patchell; Gregory David,28,0,30,2
1649955604916,MATH 10B,A01,083207,Staff,10,0,30,20
1649955604916,MATH 10B,A02,083208,Staff,25,0,30,5
1649955604916,MATH 10B,B01,083739,Staff,25,0,30,5
1649955604916,MATH 10B,B02,083740,Staff,30,0,30,0
1649955610941,MATH 18,A01,083743,Staff,22,0,30,8
1649955610941,MATH 18,A02,083744,Staff,29,0,30,1
1649955610941,MATH 18,A03,083745,Staff,29,0,30,1
1649955610941,MATH 18,A04,083746,Staff,27,0,30,3
1649955610941,MATH 18,B01,083748,Staff,0,0,30,30
1649955610941,MATH 18,B02,083749,Staff,26,0,30,4
1649955610941,MATH 18,B03,083750,Staff,28,0,30,2
1649955610941,MATH 18,B04,083751,Staff,26,0,30,4
1649955616971,MATH 20A,A01,083754,Staff,36,0,40,4
1649955622998,MATH 20B,A01,083756,Staff,17,0,30,13
1649955622998,MATH 20B,A02,083757,Staff,30,0,30,0
1649955629025,MATH 20C,A01,083760,Staff,21,0,30,9
1649955629025,MATH 20C,A02,083761,Staff,17,0,30,13
1649955629025,MATH 20C,B01,083762,Staff,27,0,30,3
1649955629025,MATH 20C,B02,083763,Staff,30,0,30,0
1649955635059,MATH 20D,A01,083765,Staff,17,0,30,13
1649955635059,MATH 20D,A02,083766,Staff,30,0,30,0
1649955635059,MATH 20D,A03,083767,Staff,30,0,30,0
1649955641092,MATH 20E,A01,083771,Staff,11,0,30,19
1649955641092,MATH 20E,A02,083772,Staff,24,0,30,6
1649955641092,MATH 20E,B01,083773,Staff,14,0,30,16
1649955641092,MATH 20E,B02,083774,Staff,29,0,30,1
1649955647115,MATH 103A,A01,083777,Staff,1,4,30,29
1649955647115,MATH 103A,A02,083778,Staff,0,4,30,30
1649955647115,MATH 103A,B01,083779,Staff,0,1,30,30
1649955647115,MATH 103A,B02,083780,Staff,14,0,30,16
1649955653139,MATH 105,A01,085443,Staff,0,6,30,30
1649955659165,MATH 109,A01,083213,Anzaldo; Leesa B,9,0,30,21
1649955659165,MATH 109,A02,083214,Anzaldo; Leesa B,6,0,30,24
1649955659165,MATH 109,B01,083215,Anzaldo; Leesa B,26,0,30,4
1649955659165,MATH 109,B02,083216,Anzaldo; Leesa B,19,0,30,11
1649955665194,MATH 142A,A01,083219,Chow; Bennett,0,3,30,30
1649955665194,MATH 142A,A02,083220,Chow; Bennett,3,0,30,27
1649955665194,MATH 142A,B01,083221,Chow; Bennett,0,1,30,30
1649955665194,MATH 142A,B02,083222,Chow; Bennett,0,1,30,30
1649955671223,MATH 193A,A01,083224,Staff,0,5,30,30
1649955671223,MATH 193A,A02,083225,Staff,0,3,30,30
1649955671223,MATH 193A,A03,083781,Staff,3,0,30,27
1649955671223,MATH 193A,A04,083782,Staff,13,0,30,17
1649955677246,MATH 197,001,091859,McAuley; Julian John,9999,0,9999,0
1649955683314,COGS 9,A01,083615,Staff,13,0,60,47
1649955689350,COGS 11,A01,083617,Boyle; Mary E. T.,34,0,40,6
1649955695371,COGS 13,A01,083071,Staff,0,13,40,40
1649955701394,COGS 14A,A01,092681,Staff,61,0,100,39
1649955707418,COGS 14B,A01,083073,Cheng; Tzu-Han,20,0,50,30
1649955713448,COGS 17,A01,092677,Staff,61,0,75,14
1649955719475,COGS 100,A01,083619,Staff,0,9,60,60
1649955725504,COGS 101A,A01,083621,Davis; Joshua Daniel,0,10,60,60
1649955731533,COGS 101B,A01,091572,Staff,28,0,60,32
1649955737556,COGS 101C,A01,083625,Delgado; Tania,22,0,30,8
1649955743583,COGS 107A,A01,083627,Boyle; Mary E. T.,11,0,60,49
1649955749610,COGS 118A,A01,083075,Staff,21,0,60,39
1649955755648,CSE 3,A50,083646,Miranda; Gregory Joseph,24,0,38,14
1649955755648,CSE 3,A51,083647,Miranda; Gregory Joseph,37,0,37,0
1649955761671,CSE 8A,A50,083650,Miranda; Gregory Joseph,4,0,40,36
1649955767713,CSE 11,A01,083080,Cao; Yingjun,0,31,40,40
1649955773745,CSE 12,A01,083652,Staff,49,0,100,51
1649955779769,CSE 15L,A01,083654,Staff,14,0,50,36
1649955779769,CSE 15L,A02,083655,Staff,46,0,50,4
1649955785795,CSE 20,A01,083657,Staff,66,0,80,14
1649955791819,CSE 30,A01,083084,Eldon; John,0,31,40,40
1649955797850,CSE 100,A01,083659,Cao; Yingjun,1,33,50,49
1649955803872,CSE 134B,A01,083661,Powell; Thomas Allan,0,23,65,65
1649955809901,CSE 140,A01,083663,Staff,18,0,75,57
1649955815928,CSE 140L,A01,083088,Eldon; John,13,0,75,62
1649955821951,CSE 175,A01,083665,Kumar; Rakesh,11,0,25,14
1649955827980,CSE 190,A00,092507,Dubnov; Shlomo,13,0,15,2
1649955834012,ECE 45,A01,083139,Staff,4,0,40,36
1649955840045,ECE 65,A50,083695,Staff,4,0,30,26
1649955846069,ECE 109,A01,091882,Touri; Behrouz,53,0,70,17
1649955852094,ECE 180,A00,083140,Abi Samra; Nicholas Camill,26,0,30,4
1649955852094,ECE 180,B00,083141,Abi Samra; Nicholas Camill,13,0,30,17
1649955858123,MATH 10A,A01,083735,Patchell; Gregory David,20,0,30,10
1649955858123,MATH 10A,A02,083736,Patchell; Gregory David,28,0,30,2
1649955858123,MATH 10A,A03,083737,Patchell; Gregory David,28,0,30,2
1649955864165,MATH 10B,A01,083207,Staff,10,0,30,20
1649955864165,MATH 10B,A02,083208,Staff,25,0,30,5
1649955864165,MATH 10B,B01,083739,Staff,25,0,30,5
1649955864165,MATH 10B,B02,083740,Staff,30,0,30,0
1649955870190,MATH 18,A01,083743,Staff,22,0,30,8
1649955870190,MATH 18,A02,083744,Staff,29,0,30,1
1649955870190,MATH 18,A03,083745,Staff,29,0,30,1
1649955870190,MATH 18,A04,083746,Staff,27,0,30,3
1649955870190,MATH 18,B01,083748,Staff,0,0,30,30
1649955870190,MATH 18,B02,083749,Staff,26,0,30,4
1649955870190,MATH 18,B03,083750,Staff,28,0,30,2
1649955870190,MATH 18,B04,083751,Staff,26,0,30,4
1649955876213,MATH 20A,A01,083754,Staff,36,0,40,4
1649955882244,MATH 20B,A01,083756,Staff,17,0,30,13
1649955882244,MATH 20B,A02,083757,Staff,30,0,30,0
1649955888268,MATH 20C,A01,083760,Staff,19,0,30,11
1649955888268,MATH 20C,A02,083761,Staff,17,0,30,13
1649955888268,MATH 20C,B01,083762,Staff,27,0,30,3
1649955888268,MATH 20C,B02,083763,Staff,30,0,30,0
1649955894291,MATH 20D,A01,083765,Staff,17,0,30,13
1649955894291,MATH 20D,A02,083766,Staff,30,0,30,0
1649955894291,MATH 20D,A03,083767,Staff,30,0,30,0
1649955900318,MATH 20E,A01,083771,Staff,11,0,30,19
1649955900318,MATH 20E,A02,083772,Staff,24,0,30,6
1649955900318,MATH 20E,B01,083773,Staff,14,0,30,16
1649955900318,MATH 20E,B02,083774,Staff,29,0,30,1
1649955906349,MATH 103A,A01,083777,Staff,1,4,30,29
1649955906349,MATH 103A,A02,083778,Staff,0,4,30,30
1649955906349,MATH 103A,B01,083779,Staff,0,1,30,30
1649955906349,MATH 103A,B02,083780,Staff,13,0,30,17
1649955912378,MATH 105,A01,085443,Staff,0,6,30,30
1649955918409,MATH 109,A01,083213,Anzaldo; Leesa B,9,0,30,21
1649955918409,MATH 109,A02,083214,Anzaldo; Leesa B,6,0,30,24
1649955918409,MATH 109,B01,083215,Anzaldo; Leesa B,26,0,30,4
1649955918409,MATH 109,B02,083216,Anzaldo; Leesa B,19,0,30,11
1649955924441,MATH 142A,A01,083219,Chow; Bennett,0,3,30,30
1649955924441,MATH 142A,A02,083220,Chow; Bennett,3,0,30,27
1649955924441,MATH 142A,B01,083221,Chow; Bennett,0,1,30,30
1649955924441,MATH 142A,B02,083222,Chow; Bennett,0,1,30,30
1649955930473,MATH 193A,A01,083224,Staff,0,5,30,30
1649955930473,MATH 193A,A02,083225,Staff,0,3,30,30
1649955930473,MATH 193A,A03,083781,Staff,3,0,30,27
1649955930473,MATH 193A,A04,083782,Staff,13,0,30,17
1649955936596,MATH 197,001,091859,McAuley; Julian John,9999,0,9999,0
1649955942673,COGS 9,A01,083615,Staff,12,0,60,48
1649955948700,COGS 11,A01,083617,Boyle; Mary E. T.,34,0,40,6
1649955954727,COGS 13,A01,083071,Staff,0,14,40,40
1649955960757,COGS 14A,A01,092681,Staff,61,0,100,39
1649955966787,COGS 14B,A01,083073,Cheng; Tzu-Han,20,0,50,30
1649955972809,COGS 17,A01,092677,Staff,61,0,75,14
1649955978832,COGS 100,A01,083619,Staff,1,10,60,59
1649955984854,COGS 101A,A01,083621,Davis; Joshua Daniel,0,10,60,60
1649955990880,COGS 101B,A01,091572,Staff,28,0,60,32
1649955996909,COGS 101C,A01,083625,Delgado; Tania,22,0,30,8
1649956002933,COGS 107A,A01,083627,Boyle; Mary E. T.,11,0,60,49
1649956008984,COGS 118A,A01,083075,Staff,21,0,60,39
1649956015007,CSE 3,A50,083646,Miranda; Gregory Joseph,24,0,38,14
1649956015007,CSE 3,A51,083647,Miranda; Gregory Joseph,37,0,37,0
1649956021030,CSE 8A,A50,083650,Miranda; Gregory Joseph,4,0,40,36
1649956027056,CSE 11,A01,083080,Cao; Yingjun,0,31,40,40
1649956033082,CSE 12,A01,083652,Staff,49,0,100,51
1649956039110,CSE 15L,A01,083654,Staff,14,0,50,36
1649956039110,CSE 15L,A02,083655,Staff,46,0,50,4
1649956045136,CSE 20,A01,083657,Staff,66,0,80,14
1649956051161,CSE 30,A01,083084,Eldon; John,0,31,40,40
1649956057184,CSE 100,A01,083659,Cao; Yingjun,1,33,50,49
1649956063229,CSE 134B,A01,083661,Powell; Thomas Allan,0,23,65,65
1649956069250,CSE 140,A01,083663,Staff,18,0,75,57
1649956075305,CSE 140L,A01,083088,Eldon; John,13,0,75,62
1649956081329,CSE 175,A01,083665,Kumar; Rakesh,11,0,25,14
1649956087367,CSE 190,A00,092507,Dubnov; Shlomo,13,0,15,2
1649956093398,ECE 45,A01,083139,Staff,4,0,40,36
1649956099435,ECE 65,A50,083695,Staff,4,0,30,26
1649956105462,ECE 109,A01,091882,Touri; Behrouz,53,0,70,17
1649956111488,ECE 180,A00,083140,Abi Samra; Nicholas Camill,26,0,30,4
1649956111488,ECE 180,B00,083141,Abi Samra; Nicholas Camill,13,0,30,17
1649956117512,MATH 10A,A01,083735,Patchell; Gregory David,20,0,30,10
1649956117512,MATH 10A,A02,083736,Patchell; Gregory David,28,0,30,2
1649956117512,MATH 10A,A03,083737,Patchell; Gregory David,28,0,30,2
1649956123535,MATH 10B,A01,083207,Staff,10,0,30,20
1649956123535,MATH 10B,A02,083208,Staff,25,0,30,5
1649956123535,MATH 10B,B01,083739,Staff,25,0,30,5
1649956123535,MATH 10B,B02,083740,Staff,30,0,30,0
1649956129564,MATH 18,A01,083743,Staff,21,0,30,9
1649956129564,MATH 18,A02,083744,Staff,29,0,30,1
1649956129564,MATH 18,A03,083745,Staff,29,0,30,1
1649956129564,MATH 18,A04,083746,Staff,27,0,30,3
1649956129564,MATH 18,B01,083748,Staff,0,0,30,30
1649956129564,MATH 18,B02,083749,Staff,26,0,30,4
1649956129564,MATH 18,B03,083750,Staff,28,0,30,2
1649956129564,MATH 18,B04,083751,Staff,26,0,30,4
1649956135596,MATH 20A,A01,083754,Staff,36,0,40,4
1649956141629,MATH 20B,A01,083756,Staff,17,0,30,13
1649956141629,MATH 20B,A02,083757,Staff,30,0,30,0
1649956147652,MATH 20C,A01,083760,Staff,19,0,30,11
1649956147652,MATH 20C,A02,083761,Staff,17,0,30,13
1649956147652,MATH 20C,B01,083762,Staff,27,0,30,3
1649956147652,MATH 20C,B02,083763,Staff,30,0,30,0
1649956153683,MATH 20D,A01,083765,Staff,17,0,30,13
1649956153683,MATH 20D,A02,083766,Staff,30,0,30,0
1649956153683,MATH 20D,A03,083767,Staff,30,0,30,0
1649956159713,MATH 20E,A01,083771,Staff,11,0,30,19
1649956159713,MATH 20E,A02,083772,Staff,24,0,30,6
1649956159713,MATH 20E,B01,083773,Staff,14,0,30,16
1649956159713,MATH 20E,B02,083774,Staff,29,0,30,1
1649956165739,MATH 103A,A01,083777,Staff,1,4,30,29
1649956165739,MATH 103A,A02,083778,Staff,0,4,30,30
1649956165739,MATH 103A,B01,083779,Staff,0,1,30,30
1649956165739,MATH 103A,B02,083780,Staff,13,0,30,17
1649956171768,MATH 105,A01,085443,Staff,0,6,30,30
1649956177794,MATH 109,A01,083213,Anzaldo; Leesa B,9,0,30,21
1649956177794,MATH 109,A02,083214,Anzaldo; Leesa B,6,0,30,24
1649956177794,MATH 109,B01,083215,Anzaldo; Leesa B,26,0,30,4
1649956177794,MATH 109,B02,083216,Anzaldo; Leesa B,19,0,30,11
1649956183818,MATH 142A,A01,083219,Chow; Bennett,0,3,30,30
1649956183818,MATH 142A,A02,083220,Chow; Bennett,3,0,30,27
1649956183818,MATH 142A,B01,083221,Chow; Bennett,0,1,30,30
1649956183818,MATH 142A,B02,083222,Chow; Bennett,0,1,30,30
1649956189840,MATH 193A,A01,083224,Staff,0,5,30,30
1649956189840,MATH 193A,A02,083225,Staff,0,3,30,30
1649956189840,MATH 193A,A03,083781,Staff,3,0,30,27
1649956189840,MATH 193A,A04,083782,Staff,13,0,30,17
1649956195869,MATH 197,001,091859,McAuley; Julian John,9999,0,9999,0
1649956201947,COGS 9,A01,083615,Staff,12,0,60,48
1649956207979,COGS 11,A01,083617,Boyle; Mary E. T.,34,0,40,6
1649956214002,COGS 13,A01,083071,Staff,0,14,40,40
1649956220029,COGS 14A,A01,092681,Staff,61,0,100,39
1649956226062,COGS 14B,A01,083073,Cheng; Tzu-Han,20,0,50,30
1649956232084,COGS 17,A01,092677,Staff,61,0,75,14
1649956238106,COGS 100,A01,083619,Staff,1,10,60,59
1649956244140,COGS 101A,A01,083621,Davis; Joshua Daniel,0,10,60,60
1649956250163,COGS 101B,A01,091572,Staff,28,0,60,32
1649956256186,COGS 101C,A01,083625,Delgado; Tania,22,0,30,8
1649956262222,COGS 107A,A01,083627,Boyle; Mary E. T.,11,0,60,49
1649956268247,COGS 118A,A01,083075,Staff,21,0,60,39
1649956274269,CSE 3,A50,083646,Miranda; Gregory Joseph,24,0,38,14
1649956274269,CSE 3,A51,083647,Miranda; Gregory Joseph,37,0,37,0
1649956280294,CSE 8A,A50,083650,Miranda; Gregory Joseph,4,0,40,36
1649956286325,CSE 11,A01,083080,Cao; Yingjun,0,31,40,40
1649956292347,CSE 12,A01,083652,Staff,48,0,100,52
1649956298370,CSE 15L,A01,083654,Staff,13,0,50,37
1649956298370,CSE 15L,A02,083655,Staff,46,0,50,4
1649956304393,CSE 20,A01,083657,Staff,66,0,80,14
1649956310418,CSE 30,A01,083084,Eldon; John,0,31,40,40
1649956316447,CSE 100,A01,083659,Cao; Yingjun,1,33,50,49
1649956322472,CSE 134B,A01,083661,Powell; Thomas Allan,0,23,65,65
1649956328494,CSE 140,A01,083663,Staff,18,0,75,57
1649956334522,CSE 140L,A01,083088,Eldon; John,13,0,75,62
1649956340546,CSE 175,A01,083665,Kumar; Rakesh,11,0,25,14
1649956346571,CSE 190,A00,092507,Dubnov; Shlomo,13,0,15,2
1649956352621,ECE 45,A01,083139,Staff,4,0,40,36
1649956358643,ECE 65,A50,083695,Staff,4,0,30,26
1649956364675,ECE 109,A01,091882,Touri; Behrouz,53,0,70,17
1649956370700,ECE 180,A00,083140,Abi Samra; Nicholas Camill,26,0,30,4
1649956370700,ECE 180,B00,083141,Abi Samra; Nicholas Camill,13,0,30,17
1649956376727,MATH 10A,A01,083735,Patchell; Gregory David,20,0,30,10
1649956376727,MATH 10A,A02,083736,Patchell; Gregory David,28,0,30,2
1649956376727,MATH 10A,A03,083737,Patchell; Gregory David,28,0,30,2
1649956382755,MATH 10B,A01,083207,Staff,10,0,30,20
1649956382755,MATH 10B,A02,083208,Staff,25,0,30,5
1649956382755,MATH 10B,B01,083739,Staff,25,0,30,5
1649956382755,MATH 10B,B02,083740,Staff,30,0,30,0
1649956388791,MATH 18,A01,083743,Staff,21,0,30,9
1649956388791,MATH 18,A02,083744,Staff,29,0,30,1
1649956388791,MATH 18,A03,083745,Staff,29,0,30,1
1649956388791,MATH 18,A04,083746,Staff,27,0,30,3
1649956388791,MATH 18,B01,083748,Staff,0,0,30,30
1649956388791,MATH 18,B02,083749,Staff,26,0,30,4
1649956388791,MATH 18,B03,083750,Staff,27,0,30,3
1649956388791,MATH 18,B04,083751,Staff,26,0,30,4
1649956394817,MATH 20A,A01,083754,Staff,36,0,40,4
1649956400840,MATH 20B,A01,083756,Staff,17,0,30,13
1649956400840,MATH 20B,A02,083757,Staff,30,0,30,0
1649956406874,MATH 20C,A01,083760,Staff,19,0,30,11
1649956406874,MATH 20C,A02,083761,Staff,17,0,30,13
1649956406874,MATH 20C,B01,083762,Staff,27,0,30,3
1649956406874,MATH 20C,B02,083763,Staff,30,0,30,0
1649956412898,MATH 20D,A01,083765,Staff,17,0,30,13
1649956412898,MATH 20D,A02,083766,Staff,30,0,30,0
1649956412898,MATH 20D,A03,083767,Staff,30,0,30,0
1649956418921,MATH 20E,A01,083771,Staff,11,0,30,19
1649956418921,MATH 20E,A02,083772,Staff,24,0,30,6
1649956418921,MATH 20E,B01,083773,Staff,13,0,30,17
1649956418921,MATH 20E,B02,083774,Staff,29,0,30,1
1649956424943,MATH 103A,A01,083777,Staff,1,4,30,29
1649956424943,MATH 103A,A02,083778,Staff,0,4,30,30
1649956424943,MATH 103A,B01,083779,Staff,0,1,30,30
1649956424943,MATH 103A,B02,083780,Staff,12,0,30,18
1649956430968,MATH 105,A01,085443,Staff,0,7,30,30
1649956436999,MATH 109,A01,083213,Anzaldo; Leesa B,9,0,30,21
1649956436999,MATH 109,A02,083214,Anzaldo; Leesa B,6,0,30,24
1649956436999,MATH 109,B01,083215,Anzaldo; Leesa B,26,0,30,4
1649956436999,MATH 109,B02,083216,Anzaldo; Leesa B,19,0,30,11
1649956443022,MATH 142A,A01,083219,Chow; Bennett,0,3,30,30
1649956443022,MATH 142A,A02,083220,Chow; Bennett,3,0,30,27
1649956443022,MATH 142A,B01,083221,Chow; Bennett,0,1,30,30
1649956443022,MATH 142A,B02,083222,Chow; Bennett,0,1,30,30
1649956449057,MATH 193A,A01,083224,Staff,0,5,30,30
1649956449057,MATH 193A,A02,083225,Staff,0,3,30,30
1649956449057,MATH 193A,A03,083781,Staff,3,0,30,27
1649956449057,MATH 193A,A04,083782,Staff,13,0,30,17
1649956455082,MATH 197,001,091859,McAuley; Julian John,9999,0,9999,0
1649956461144,COGS 9,A01,083615,Staff,11,0,60,49
1649956467168,COGS 11,A01,083617,Boyle; Mary E. T.,34,0,40,6
1649956473194,COGS 13,A01,083071,Staff,0,14,40,40
1649956479226,COGS 14A,A01,092681,Staff,61,0,100,39
1649956485252,COGS 14B,A01,083073,Cheng; Tzu-Han,20,0,50,30
1649956491276,COGS 17,A01,092677,Staff,60,0,75,15
1649956497310,COGS 100,A01,083619,Staff,1,10,60,59
1649956503335,COGS 101A,A01,083621,Davis; Joshua Daniel,0,10,60,60
1649956509357,COGS 101B,A01,091572,Staff,28,0,60,32
1649956515386,COGS 101C,A01,083625,Delgado; Tania,22,0,30,8
1649956521413,COGS 107A,A01,083627,Boyle; Mary E. T.,10,0,60,50
1649956527529,COGS 118A,A01,083075,Staff,21,0,60,39
1649956533573,CSE 3,A50,083646,Miranda; Gregory Joseph,24,0,38,14
1649956533573,CSE 3,A51,083647,Miranda; Gregory Joseph,37,0,37,0
1649956539597,CSE 8A,A50,083650,Miranda; Gregory Joseph,4,0,40,36
1649956545620,CSE 11,A01,083080,Cao; Yingjun,0,32,40,40
1649956551645,CSE 12,A01,083652,Staff,48,0,100,52
1649956557679,CSE 15L,A01,083654,Staff,13,0,50,37
1649956557679,CSE 15L,A02,083655,Staff,46,0,50,4
1649956563706,CSE 20,A01,083657,Staff,66,0,80,14
1649956569728,CSE 30,A01,083084,Eldon; John,0,31,40,40
1649956575752,CSE 100,A01,083659,Cao; Yingjun,1,33,50,49
1649956581786,CSE 134B,A01,083661,Powell; Thomas Allan,0,23,65,65
1649956587809,CSE 140,A01,083663,Staff,18,0,75,57
1649956593844,CSE 140L,A01,083088,Eldon; John,13,0,75,62
1649956599875,CSE 175,A01,083665,Kumar; Rakesh,11,0,25,14
1649956605910,CSE 190,A00,092507,Dubnov; Shlomo,13,0,15,2
1649956611943,ECE 45,A01,083139,Staff,4,0,40,36
1649956617965,ECE 65,A50,083695,Staff,4,0,30,26
1649956623991,ECE 109,A01,091882,Touri; Behrouz,53,0,70,17
1649956630019,ECE 180,A00,083140,Abi Samra; Nicholas Camill,26,0,30,4
1649956630019,ECE 180,B00,083141,Abi Samra; Nicholas Camill,13,0,30,17
1649956636051,MATH 10A,A01,083735,Patchell; Gregory David,20,0,30,10
1649956636051,MATH 10A,A02,083736,Patchell; Gregory David,28,0,30,2
1649956636051,MATH 10A,A03,083737,Patchell; Gregory David,28,0,30,2
1649956642083,MATH 10B,A01,083207,Staff,10,0,30,20
1649956642083,MATH 10B,A02,083208,Staff,25,0,30,5
1649956642083,MATH 10B,B01,083739,Staff,25,0,30,5
1649956642083,MATH 10B,B02,083740,Staff,30,0,30,0
1649956648113,MATH 18,A01,083743,Staff,21,0,30,9
1649956648113,MATH 18,A02,083744,Staff,29,0,30,1
1649956648113,MATH 18,A03,083745,Staff,29,0,30,1
1649956648113,MATH 18,A04,083746,Staff,27,0,30,3
1649956648113,MATH 18,B01,083748,Staff,0,0,30,30
1649956648113,MATH 18,B02,083749,Staff,26,0,30,4
1649956648113,MATH 18,B03,083750,Staff,27,0,30,3
1649956648113,MATH 18,B04,083751,Staff,26,0,30,4
1649956654139,MATH 20A,A01,083754,Staff,36,0,40,4
1649956660162,MATH 20B,A01,083756,Staff,17,0,30,13
1649956660162,MATH 20B,A02,083757,Staff,30,0,30,0
1649956666194,MATH 20C,A01,083760,Staff,19,0,30,11
1649956666194,MATH 20C,A02,083761,Staff,16,0,30,14
1649956666194,MATH 20C,B01,083762,Staff,27,0,30,3
1649956666194,MATH 20C,B02,083763,Staff,30,0,30,0
1649956672218,MATH 20D,A01,083765,Staff,17,0,30,13
1649956672218,MATH 20D,A02,083766,Staff,30,0,30,0
1649956672218,MATH 20D,A03,083767,Staff,30,0,30,0
1649956678243,MATH 20E,A01,083771,Staff,11,0,30,19
1649956678243,MATH 20E,A02,083772,Staff,24,0,30,6
1649956678243,MATH 20E,B01,083773,Staff,13,0,30,17
1649956678243,MATH 20E,B02,083774,Staff,29,0,30,1
1649956684267,MATH 103A,A01,083777,Staff,1,4,30,29
1649956684267,MATH 103A,A02,083778,Staff,0,4,30,30
1649956684267,MATH 103A,B01,083779,Staff,0,1,30,30
1649956684267,MATH 103A,B02,083780,Staff,12,0,30,18
1649956690296,MATH 105,A01,085443,Staff,0,7,30,30
1649956696321,MATH 109,A01,083213,Anzaldo; Leesa B,9,0,30,21
1649956696321,MATH 109,A02,083214,Anzaldo; Leesa B,6,0,30,24
1649956696321,MATH 109,B01,083215,Anzaldo; Leesa B,26,0,30,4
1649956696321,MATH 109,B02,083216,Anzaldo; Leesa B,19,0,30,11
1649956702345,MATH 142A,A01,083219,Chow; Bennett,0,3,30,30
1649956702345,MATH 142A,A02,083220,Chow; Bennett,3,0,30,27
1649956702345,MATH 142A,B01,083221,Chow; Bennett,0,1,30,30
1649956702345,MATH 142A,B02,083222,Chow; Bennett,0,1,30,30
1649956708372,MATH 193A,A01,083224,Staff,0,5,30,30
1649956708372,MATH 193A,A02,083225,Staff,0,3,30,30
1649956708372,MATH 193A,A03,083781,Staff,3,0,30,27
1649956708372,MATH 193A,A04,083782,Staff,13,0,30,17
1649956714403,MATH 197,001,091859,McAuley; Julian John,9999,0,9999,0
1649956720453,COGS 9,A01,083615,Staff,11,0,60,49
1649956726477,COGS 11,A01,083617,Boyle; Mary E. T.,34,0,40,6
1649956732503,COGS 13,A01,083071,Staff,0,14,40,40
1649956738530,COGS 14A,A01,092681,Staff,61,0,100,39
1649956744556,COGS 14B,A01,083073,Cheng; Tzu-Han,19,0,50,31
1649956750582,COGS 17,A01,092677,Staff,60,0,75,15
1649956756605,COGS 100,A01,083619,Staff,1,10,60,59
1649956762631,COGS 101A,A01,083621,Davis; Joshua Daniel,0,11,60,60
1649956768660,COGS 101B,A01,091572,Staff,28,0,60,32
1649956774686,COGS 101C,A01,083625,Delgado; Tania,22,0,30,8
1649956780717,COGS 107A,A01,083627,Boyle; Mary E. T.,9,0,60,51
1649956786740,COGS 118A,A01,083075,Staff,21,0,60,39
1649956792768,CSE 3,A50,083646,Miranda; Gregory Joseph,24,0,38,14
1649956792768,CSE 3,A51,083647,Miranda; Gregory Joseph,37,0,37,0
1649956798798,CSE 8A,A50,083650,Miranda; Gregory Joseph,3,0,40,37
1649956804824,CSE 11,A01,083080,Cao; Yingjun,0,32,40,40
1649956810850,CSE 12,A01,083652,Staff,48,0,100,52
1649956816873,CSE 15L,A01,083654,Staff,13,0,50,37
1649956816873,CSE 15L,A02,083655,Staff,46,0,50,4
1649956822900,CSE 20,A01,083657,Staff,66,0,80,14
1649956828934,CSE 30,A01,083084,Eldon; John,0,32,40,40
1649956834958,CSE 100,A01,083659,Cao; Yingjun,1,33,50,49
1649956840989,CSE 134B,A01,083661,Powell; Thomas Allan,0,23,65,65
1649956847012,CSE 140,A01,083663,Staff,18,0,75,57
1649956853039,CSE 140L,A01,083088,Eldon; John,13,0,75,62
1649956859067,CSE 175,A01,083665,Kumar; Rakesh,11,0,25,14
1649956865092,CSE 190,A00,092507,Dubnov; Shlomo,13,0,15,2
1649956871123,ECE 45,A01,083139,Staff,4,0,40,36
1649956877144,ECE 65,A50,083695,Staff,4,0,30,26
1649956883173,ECE 109,A01,091882,Touri; Behrouz,53,0,70,17
1649956889199,ECE 180,A00,083140,Abi Samra; Nicholas Camill,26,0,30,4
1649956889199,ECE 180,B00,083141,Abi Samra; Nicholas Camill,13,0,30,17
1649956895227,MATH 10A,A01,083735,Patchell; Gregory David,20,0,30,10
1649956895227,MATH 10A,A02,083736,Patchell; Gregory David,28,0,30,2
1649956895227,MATH 10A,A03,083737,Patchell; Gregory David,28,0,30,2
1649956901256,MATH 10B,A01,083207,Staff,10,0,30,20
1649956901256,MATH 10B,A02,083208,Staff,25,0,30,5
1649956901256,MATH 10B,B01,083739,Staff,25,0,30,5
1649956901256,MATH 10B,B02,083740,Staff,30,0,30,0
1649956907293,MATH 18,A01,083743,Staff,21,0,30,9
1649956907293,MATH 18,A02,083744,Staff,29,0,30,1
1649956907293,MATH 18,A03,083745,Staff,29,0,30,1
1649956907293,MATH 18,A04,083746,Staff,27,0,30,3
1649956907293,MATH 18,B01,083748,Staff,0,0,30,30
1649956907293,MATH 18,B02,083749,Staff,26,0,30,4
1649956907293,MATH 18,B03,083750,Staff,27,0,30,3
1649956907293,MATH 18,B04,083751,Staff,26,0,30,4
1649956913328,MATH 20A,A01,083754,Staff,36,0,40,4
1649956919350,MATH 20B,A01,083756,Staff,17,0,30,13
1649956919350,MATH 20B,A02,083757,Staff,30,0,30,0
1649956925377,MATH 20C,A01,083760,Staff,19,0,30,11
1649956925377,MATH 20C,A02,083761,Staff,16,0,30,14
1649956925377,MATH 20C,B01,083762,Staff,27,0,30,3
1649956925377,MATH 20C,B02,083763,Staff,30,0,30,0
1649956931407,MATH 20D,A01,083765,Staff,16,0,30,14
1649956931407,MATH 20D,A02,083766,Staff,30,0,30,0
1649956931407,MATH 20D,A03,083767,Staff,30,0,30,0
1649956937434,MATH 20E,A01,083771,Staff,11,0,30,19
1649956937434,MATH 20E,A02,083772,Staff,24,0,30,6
1649956937434,MATH 20E,B01,083773,Staff,13,0,30,17
1649956937434,MATH 20E,B02,083774,Staff,29,0,30,1
1649956943465,MATH 103A,A01,083777,Staff,1,5,30,29
1649956943465,MATH 103A,A02,083778,Staff,0,4,30,30
1649956943465,MATH 103A,B01,083779,Staff,0,1,30,30
1649956943465,MATH 103A,B02,083780,Staff,12,0,30,18
1649956949493,MATH 105,A01,085443,Staff,0,7,30,30
1649956955516,MATH 109,A01,083213,Anzaldo; Leesa B,9,0,30,21
1649956955516,MATH 109,A02,083214,Anzaldo; Leesa B,6,0,30,24
1649956955516,MATH 109,B01,083215,Anzaldo; Leesa B,26,0,30,4
1649956955516,MATH 109,B02,083216,Anzaldo; Leesa B,19,0,30,11
1649956961555,MATH 142A,A01,083219,Chow; Bennett,0,3,30,30
1649956961555,MATH 142A,A02,083220,Chow; Bennett,2,0,30,28
1649956961555,MATH 142A,B01,083221,Chow; Bennett,0,2,30,30
1649956961555,MATH 142A,B02,083222,Chow; Bennett,0,1,30,30
1649956967586,MATH 193A,A01,083224,Staff,0,6,30,30
1649956967586,MATH 193A,A02,083225,Staff,0,3,30,30
1649956967586,MATH 193A,A03,083781,Staff,3,0,30,27
1649956967586,MATH 193A,A04,083782,Staff,13,0,30,17
1649956973610,MATH 197,001,091859,McAuley; Julian John,9999,0,9999,0
1649956979682,COGS 9,A01,083615,Staff,11,0,60,49
1649956985707,COGS 11,A01,083617,Boyle; Mary E. T.,34,0,40,6
1649956991730,COGS 13,A01,083071,Staff,0,15,40,40
1649956997761,COGS 14A,A01,092681,Staff,61,0,100,39
1649957003785,COGS 14B,A01,083073,Cheng; Tzu-Han,19,0,50,31
1649957009808,COGS 17,A01,092677,Staff,60,0,75,15
1649957015841,COGS 100,A01,083619,Staff,1,10,60,59
1649957021867,COGS 101A,A01,083621,Davis; Joshua Daniel,0,11,60,60
1649957027909,COGS 101B,A01,091572,Staff,28,0,60,32
1649957033934,COGS 101C,A01,083625,Delgado; Tania,22,0,30,8
1649957039966,COGS 107A,A01,083627,Boyle; Mary E. T.,9,0,60,51
1649957046003,COGS 118A,A01,083075,Staff,21,0,60,39
1649957052027,CSE 3,A50,083646,Miranda; Gregory Joseph,24,0,38,14
1649957052027,CSE 3,A51,083647,Miranda; Gregory Joseph,37,0,37,0
1649957058054,CSE 8A,A50,083650,Miranda; Gregory Joseph,3,0,40,37
1649957064082,CSE 11,A01,083080,Cao; Yingjun,0,33,40,40
1649957070114,CSE 12,A01,083652,Staff,48,0,100,52
1649957076141,CSE 15L,A01,083654,Staff,13,0,50,37
1649957076141,CSE 15L,A02,083655,Staff,46,0,50,4
1649957082168,CSE 20,A01,083657,Staff,66,0,80,14
1649957088202,CSE 30,A01,083084,Eldon; John,0,32,40,40
1649957094225,CSE 100,A01,083659,Cao; Yingjun,1,34,50,49
1649957100260,CSE 134B,A01,083661,Powell; Thomas Allan,0,23,65,65
1649957106284,CSE 140,A01,083663,Staff,18,0,75,57
1649957112308,CSE 140L,A01,083088,Eldon; John,13,0,75,62
1649957118341,CSE 175,A01,083665,Kumar; Rakesh,11,0,25,14
1649957124467,CSE 190,A00,092507,Dubnov; Shlomo,13,0,15,2
1649957130488,ECE 45,A01,083139,Staff,4,0,40,36
1649957136514,ECE 65,A50,083695,Staff,4,0,30,26
1649957142541,ECE 109,A01,091882,Touri; Behrouz,52,0,70,18
1649957148567,ECE 180,A00,083140,Abi Samra; Nicholas Camill,26,0,30,4
1649957148567,ECE 180,B00,083141,Abi Samra; Nicholas Camill,13,0,30,17
1649957154590,MATH 10A,A01,083735,Patchell; Gregory David,20,0,30,10
1649957154590,MATH 10A,A02,083736,Patchell; Gregory David,28,0,30,2
1649957154590,MATH 10A,A03,083737,Patchell; Gregory David,28,0,30,2
1649957160621,MATH 10B,A01,083207,Staff,10,0,30,20
1649957160621,MATH 10B,A02,083208,Staff,25,0,30,5
1649957160621,MATH 10B,B01,083739,Staff,25,0,30,5
1649957160621,MATH 10B,B02,083740,Staff,30,0,30,0
1649957166650,MATH 18,A01,083743,Staff,21,0,30,9
1649957166650,MATH 18,A02,083744,Staff,29,0,30,1
1649957166650,MATH 18,A03,083745,Staff,29,0,30,1
1649957166650,MATH 18,A04,083746,Staff,27,0,30,3
1649957166650,MATH 18,B01,083748,Staff,0,0,30,30
1649957166650,MATH 18,B02,083749,Staff,26,0,30,4
1649957166650,MATH 18,B03,083750,Staff,27,0,30,3
1649957166650,MATH 18,B04,083751,Staff,26,0,30,4
1649957172686,MATH 20A,A01,083754,Staff,36,0,40,4
1649957178711,MATH 20B,A01,083756,Staff,17,0,30,13
1649957178711,MATH 20B,A02,083757,Staff,30,0,30,0
1649957184735,MATH 20C,A01,083760,Staff,19,0,30,11
1649957184735,MATH 20C,A02,083761,Staff,16,0,30,14
1649957184735,MATH 20C,B01,083762,Staff,27,0,30,3
1649957184735,MATH 20C,B02,083763,Staff,30,0,30,0
1649957190758,MATH 20D,A01,083765,Staff,16,0,30,14
1649957190758,MATH 20D,A02,083766,Staff,30,0,30,0
1649957190758,MATH 20D,A03,083767,Staff,30,0,30,0
1649957196781,MATH 20E,A01,083771,Staff,11,0,30,19
1649957196781,MATH 20E,A02,083772,Staff,24,0,30,6
1649957196781,MATH 20E,B01,083773,Staff,13,0,30,17
1649957196781,MATH 20E,B02,083774,Staff,29,0,30,1
1649957202816,MATH 103A,A01,083777,Staff,1,5,30,29
1649957202816,MATH 103A,A02,083778,Staff,0,4,30,30
1649957202816,MATH 103A,B01,083779,Staff,0,1,30,30
1649957202816,MATH 103A,B02,083780,Staff,12,0,30,18
1649957208851,MATH 105,A01,085443,Staff,0,7,30,30
1649957214883,MATH 109,A01,083213,Anzaldo; Leesa B,9,0,30,21
1649957214883,MATH 109,A02,083214,Anzaldo; Leesa B,6,0,30,24
1649957214883,MATH 109,B01,083215,Anzaldo; Leesa B,26,0,30,4
1649957214883,MATH 109,B02,083216,Anzaldo; Leesa B,19,0,30,11
1649957220912,MATH 142A,A01,083219,Chow; Bennett,0,3,30,30
1649957220912,MATH 142A,A02,083220,Chow; Bennett,1,0,30,29
1649957220912,MATH 142A,B01,083221,Chow; Bennett,0,2,30,30
1649957220912,MATH 142A,B02,083222,Chow; Bennett,0,1,30,30
1649957226935,MATH 193A,A01,083224,Staff,0,5,30,30
1649957226935,MATH 193A,A02,083225,Staff,0,3,30,30
1649957226935,MATH 193A,A03,083781,Staff,2,0,30,28
1649957226935,MATH 193A,A04,083782,Staff,13,0,30,17
1649957232959,MATH 197,001,091859,McAuley; Julian John,9999,0,9999,0
1649957239009,COGS 9,A01,083615,Staff,11,0,60,49
1649957245045,COGS 11,A01,083617,Boyle; Mary E. T.,34,0,40,6
1649957251073,COGS 13,A01,083071,Staff,0,15,40,40
1649957257095,COGS 14A,A01,092681,Staff,61,0,100,39
1649957263128,COGS 14B,A01,083073,Cheng; Tzu-Han,19,0,50,31
1649957269165,COGS 17,A01,092677,Staff,60,0,75,15
1649957275192,COGS 100,A01,083619,Staff,1,11,60,59
1649957281225,COGS 101A,A01,083621,Davis; Joshua Daniel,0,11,60,60
1649957287247,COGS 101B,A01,091572,Staff,27,0,60,33
1649957293271,COGS 101C,A01,083625,Delgado; Tania,22,0,30,8
1649957299294,COGS 107A,A01,083627,Boyle; Mary E. T.,8,0,60,52
1649957305322,COGS 118A,A01,083075,Staff,21,0,60,39
1649957311363,CSE 3,A50,083646,Miranda; Gregory Joseph,24,0,38,14
1649957311363,CSE 3,A51,083647,Miranda; Gregory Joseph,37,0,37,0
1649957317386,CSE 8A,A50,083650,Miranda; Gregory Joseph,3,0,40,37
1649957323412,CSE 11,A01,083080,Cao; Yingjun,0,33,40,40
1649957329455,CSE 12,A01,083652,Staff,48,0,100,52
1649957335477,CSE 15L,A01,083654,Staff,13,0,50,37
1649957335477,CSE 15L,A02,083655,Staff,46,0,50,4
1649957341503,CSE 20,A01,083657,Staff,66,0,80,14
1649957347526,CSE 30,A01,083084,Eldon; John,0,32,40,40
1649957353553,CSE 100,A01,083659,Cao; Yingjun,1,34,50,49
1649957359576,CSE 134B,A01,083661,Powell; Thomas Allan,0,23,65,65
1649957365597,CSE 140,A01,083663,Staff,18,0,75,57
1649957371622,CSE 140L,A01,083088,Eldon; John,13,0,75,62
1649957377647,CSE 175,A01,083665,Kumar; Rakesh,11,0,25,14
1649957383677,CSE 190,A00,092507,Dubnov; Shlomo,13,0,15,2
1649957389706,ECE 45,A01,083139,Staff,4,0,40,36
1649957395754,ECE 65,A50,083695,Staff,4,0,30,26
1649957401778,ECE 109,A01,091882,Touri; Behrouz,52,0,70,18
1649957407800,ECE 180,A00,083140,Abi Samra; Nicholas Camill,26,0,30,4
1649957407800,ECE 180,B00,083141,Abi Samra; Nicholas Camill,13,0,30,17
1649957413848,MATH 10A,A01,083735,Patchell; Gregory David,20,0,30,10
1649957413848,MATH 10A,A02,083736,Patchell; Gregory David,28,0,30,2
1649957413848,MATH 10A,A03,083737,Patchell; Gregory David,28,0,30,2
1649957419886,MATH 10B,A01,083207,Staff,10,0,30,20
1649957419886,MATH 10B,A02,083208,Staff,25,0,30,5
1649957419886,MATH 10B,B01,083739,Staff,25,0,30,5
1649957419886,MATH 10B,B02,083740,Staff,30,0,30,0
1649957425923,MATH 18,A01,083743,Staff,21,0,30,9
1649957425923,MATH 18,A02,083744,Staff,29,0,30,1
1649957425923,MATH 18,A03,083745,Staff,29,0,30,1
1649957425923,MATH 18,A04,083746,Staff,27,0,30,3
1649957425923,MATH 18,B01,083748,Staff,0,0,30,30
1649957425923,MATH 18,B02,083749,Staff,26,0,30,4
1649957425923,MATH 18,B03,083750,Staff,27,0,30,3
1649957425923,MATH 18,B04,083751,Staff,26,0,30,4
1649957431955,MATH 20A,A01,083754,Staff,36,0,40,4
1649957437980,MATH 20B,A01,083756,Staff,17,0,30,13
1649957437980,MATH 20B,A02,083757,Staff,30,0,30,0
1649957444015,MATH 20C,A01,083760,Staff,19,0,30,11
1649957444015,MATH 20C,A02,083761,Staff,16,0,30,14
1649957444015,MATH 20C,B01,083762,Staff,27,0,30,3
1649957444015,MATH 20C,B02,083763,Staff,30,0,30,0
1649957450061,MATH 20D,A01,083765,Staff,16,0,30,14
1649957450061,MATH 20D,A02,083766,Staff,30,0,30,0
1649957450061,MATH 20D,A03,083767,Staff,30,0,30,0
1649957456085,MATH 20E,A01,083771,Staff,11,0,30,19
1649957456085,MATH 20E,A02,083772,Staff,24,0,30,6
1649957456085,MATH 20E,B01,083773,Staff,13,0,30,17
1649957456085,MATH 20E,B02,083774,Staff,29,0,30,1
1649957462130,MATH 103A,A01,083777,Staff,1,5,30,29
1649957462130,MATH 103A,A02,083778,Staff,0,4,30,30
1649957462130,MATH 103A,B01,083779,Staff,0,1,30,30
1649957462130,MATH 103A,B02,083780,Staff,11,0,30,19
1649957468171,MATH 105,A01,085443,Staff,0,7,30,30
1649957474219,MATH 109,A01,083213,Anzaldo; Leesa B,9,0,30,21
1649957474219,MATH 109,A02,083214,Anzaldo; Leesa B,6,0,30,24
1649957474219,MATH 109,B01,083215,Anzaldo; Leesa B,26,0,30,4
1649957474219,MATH 109,B02,083216,Anzaldo; Leesa B,19,0,30,11
1649957480243,MATH 142A,A01,083219,Chow; Bennett,0,3,30,30
1649957480243,MATH 142A,A02,083220,Chow; Bennett,1,0,30,29
1649957480243,MATH 142A,B01,083221,Chow; Bennett,0,2,30,30
1649957480243,MATH 142A,B02,083222,Chow; Bennett,0,1,30,30
1649957486271,MATH 193A,A01,083224,Staff,0,5,30,30
1649957486271,MATH 193A,A02,083225,Staff,0,3,30,30
1649957486271,MATH 193A,A03,083781,Staff,2,0,30,28
1649957486271,MATH 193A,A04,083782,Staff,13,0,30,17
1649957492292,MATH 197,001,091859,McAuley; Julian John,9999,0,9999,0
1649957498348,COGS 9,A01,083615,Staff,11,0,60,49
1649957504373,COGS 11,A01,083617,Boyle; Mary E. T.,34,0,40,6
1649957510399,COGS 13,A01,083071,Staff,0,15,40,40
1649957516422,COGS 14A,A01,092681,Staff,59,0,100,41
1649957522445,COGS 14B,A01,083073,Cheng; Tzu-Han,18,0,50,32
1649957528468,COGS 17,A01,092677,Staff,60,0,75,15
1649957534491,COGS 100,A01,083619,Staff,1,12,60,59
1649957540513,COGS 101A,A01,083621,Davis; Joshua Daniel,0,11,60,60
1649957546536,COGS 101B,A01,091572,Staff,28,0,60,32
1649957552568,COGS 101C,A01,083625,Delgado; Tania,22,0,30,8
1649957558602,COGS 107A,A01,083627,Boyle; Mary E. T.,8,0,60,52
1649957564627,COGS 118A,A01,083075,Staff,21,0,60,39
1649957570657,CSE 3,A50,083646,Miranda; Gregory Joseph,24,0,38,14
1649957570657,CSE 3,A51,083647,Miranda; Gregory Joseph,37,0,37,0
1649957576681,CSE 8A,A50,083650,Miranda; Gregory Joseph,3,0,40,37
1649957582714,CSE 11,A01,083080,Cao; Yingjun,0,34,40,40
1649957588739,CSE 12,A01,083652,Staff,47,0,100,53
1649957594762,CSE 15L,A01,083654,Staff,12,0,50,38
1649957594762,CSE 15L,A02,083655,Staff,46,0,50,4
1649957600788,CSE 20,A01,083657,Staff,66,0,80,14
1649957606810,CSE 30,A01,083084,Eldon; John,0,32,40,40
1649957612837,CSE 100,A01,083659,Cao; Yingjun,1,35,50,49
1649957618859,CSE 134B,A01,083661,Powell; Thomas Allan,0,23,65,65
1649957624883,CSE 140,A01,083663,Staff,18,0,75,57
1649957630905,CSE 140L,A01,083088,Eldon; John,13,0,75,62
1649957636934,CSE 175,A01,083665,Kumar; Rakesh,11,0,25,14
1649957642959,CSE 190,A00,092507,Dubnov; Shlomo,13,0,15,2
1649957648983,ECE 45,A01,083139,Staff,4,0,40,36
1649957655016,ECE 65,A50,083695,Staff,4,0,30,26
1649957661046,ECE 109,A01,091882,Touri; Behrouz,52,0,70,18
1649957667071,ECE 180,A00,083140,Abi Samra; Nicholas Camill,26,0,30,4
1649957667071,ECE 180,B00,083141,Abi Samra; Nicholas Camill,13,0,30,17
1649957673103,MATH 10A,A01,083735,Patchell; Gregory David,20,0,30,10
1649957673103,MATH 10A,A02,083736,Patchell; Gregory David,28,0,30,2
1649957673103,MATH 10A,A03,083737,Patchell; Gregory David,28,0,30,2
1649957679130,MATH 10B,A01,083207,Staff,10,0,30,20
1649957679130,MATH 10B,A02,083208,Staff,25,0,30,5
1649957679130,MATH 10B,B01,083739,Staff,25,0,30,5
1649957679130,MATH 10B,B02,083740,Staff,30,0,30,0
1649957685167,MATH 18,A01,083743,Staff,21,0,30,9
1649957685167,MATH 18,A02,083744,Staff,29,0,30,1
1649957685167,MATH 18,A03,083745,Staff,29,0,30,1
1649957685167,MATH 18,A04,083746,Staff,27,0,30,3
1649957685167,MATH 18,B01,083748,Staff,0,0,30,30
1649957685167,MATH 18,B02,083749,Staff,26,0,30,4
1649957685167,MATH 18,B03,083750,Staff,27,0,30,3
1649957685167,MATH 18,B04,083751,Staff,25,0,30,5
1649957691200,MATH 20A,A01,083754,Staff,36,0,40,4
1649957697223,MATH 20B,A01,083756,Staff,17,0,30,13
1649957697223,MATH 20B,A02,083757,Staff,30,0,30,0
1649957703248,MATH 20C,A01,083760,Staff,18,0,30,12
1649957703248,MATH 20C,A02,083761,Staff,16,0,30,14
1649957703248,MATH 20C,B01,083762,Staff,27,0,30,3
1649957703248,MATH 20C,B02,083763,Staff,30,0,30,0
1649957709274,MATH 20D,A01,083765,Staff,16,0,30,14
1649957709274,MATH 20D,A02,083766,Staff,30,0,30,0
1649957709274,MATH 20D,A03,083767,Staff,30,0,30,0
1649957715297,MATH 20E,A01,083771,Staff,11,0,30,19
1649957715297,MATH 20E,A02,083772,Staff,24,0,30,6
1649957715297,MATH 20E,B01,083773,Staff,13,0,30,17
1649957715297,MATH 20E,B02,083774,Staff,29,0,30,1
1649957721425,MATH 103A,A01,083777,Staff,1,5,30,29
1649957721425,MATH 103A,A02,083778,Staff,0,4,30,30
1649957721425,MATH 103A,B01,083779,Staff,0,1,30,30
1649957721425,MATH 103A,B02,083780,Staff,10,0,30,20
1649957727448,MATH 105,A01,085443,Staff,0,7,30,30
1649957733473,MATH 109,A01,083213,Anzaldo; Leesa B,9,0,30,21
1649957733473,MATH 109,A02,083214,Anzaldo; Leesa B,6,0,30,24
1649957733473,MATH 109,B01,083215,Anzaldo; Leesa B,26,0,30,4
1649957733473,MATH 109,B02,083216,Anzaldo; Leesa B,18,0,30,12
1649957739497,MATH 142A,A01,083219,Chow; Bennett,0,3,30,30
1649957739497,MATH 142A,A02,083220,Chow; Bennett,1,0,30,29
1649957739497,MATH 142A,B01,083221,Chow; Bennett,0,2,30,30
1649957739497,MATH 142A,B02,083222,Chow; Bennett,0,1,30,30
1649957745530,MATH 193A,A01,083224,Staff,0,5,30,30
1649957745530,MATH 193A,A02,083225,Staff,0,3,30,30
1649957745530,MATH 193A,A03,083781,Staff,2,0,30,28
1649957745530,MATH 193A,A04,083782,Staff,13,0,30,17
1649957751555,MATH 197,001,091859,McAuley; Julian John,9999,0,9999,0
1649957757610,COGS 9,A01,083615,Staff,11,0,60,49
1649957763637,COGS 11,A01,083617,Boyle; Mary E. T.,34,0,40,6
1649957769664,COGS 13,A01,083071,Staff,0,15,40,40
1649957775687,COGS 14A,A01,092681,Staff,58,0,100,42
1649957781718,COGS 14B,A01,083073,Cheng; Tzu-Han,18,0,50,32
1649957787744,COGS 17,A01,092677,Staff,60,0,75,15
1649957793768,COGS 100,A01,083619,Staff,1,12,60,59
1649957799791,COGS 101A,A01,083621,Davis; Joshua Daniel,0,11,60,60
1649957805823,COGS 101B,A01,091572,Staff,28,0,60,32
1649957811851,COGS 101C,A01,083625,Delgado; Tania,22,0,30,8
1649957817887,COGS 107A,A01,083627,Boyle; Mary E. T.,8,0,60,52
1649957823915,COGS 118A,A01,083075,Staff,21,0,60,39
1649957829939,CSE 3,A50,083646,Miranda; Gregory Joseph,24,0,38,14
1649957829939,CSE 3,A51,083647,Miranda; Gregory Joseph,37,0,37,0
1649957835968,CSE 8A,A50,083650,Miranda; Gregory Joseph,3,0,40,37
1649957841991,CSE 11,A01,083080,Cao; Yingjun,0,34,40,40
1649957848016,CSE 12,A01,083652,Staff,47,0,100,53
1649957854044,CSE 15L,A01,083654,Staff,12,0,50,38
1649957854044,CSE 15L,A02,083655,Staff,46,0,50,4
1649957860071,CSE 20,A01,083657,Staff,66,0,80,14
1649957866095,CSE 30,A01,083084,Eldon; John,0,32,40,40
1649957872120,CSE 100,A01,083659,Cao; Yingjun,1,35,50,49
1649957878146,CSE 134B,A01,083661,Powell; Thomas Allan,0,23,65,65
1649957884186,CSE 140,A01,083663,Staff,18,0,75,57
1649957890212,CSE 140L,A01,083088,Eldon; John,13,0,75,62
1649957896243,CSE 175,A01,083665,Kumar; Rakesh,11,0,25,14
1649957902271,CSE 190,A00,092507,Dubnov; Shlomo,13,0,15,2
1649957908294,ECE 45,A01,083139,Staff,4,0,40,36
1649957914337,ECE 65,A50,083695,Staff,4,0,30,26
1649957920363,ECE 109,A01,091882,Touri; Behrouz,52,0,70,18
1649957926392,ECE 180,A00,083140,Abi Samra; Nicholas Camill,26,0,30,4
1649957926392,ECE 180,B00,083141,Abi Samra; Nicholas Camill,13,0,30,17
1649957932419,MATH 10A,A01,083735,Patchell; Gregory David,20,0,30,10
1649957932419,MATH 10A,A02,083736,Patchell; Gregory David,28,0,30,2
1649957932419,MATH 10A,A03,083737,Patchell; Gregory David,28,0,30,2
1649957938445,MATH 10B,A01,083207,Staff,10,0,30,20
1649957938445,MATH 10B,A02,083208,Staff,25,0,30,5
1649957938445,MATH 10B,B01,083739,Staff,25,0,30,5
1649957938445,MATH 10B,B02,083740,Staff,30,0,30,0
1649957944480,MATH 18,A01,083743,Staff,21,0,30,9
1649957944480,MATH 18,A02,083744,Staff,29,0,30,1
1649957944480,MATH 18,A03,083745,Staff,29,0,30,1
1649957944480,MATH 18,A04,083746,Staff,27,0,30,3
1649957944480,MATH 18,B01,083748,Staff,0,0,30,30
1649957944480,MATH 18,B02,083749,Staff,26,0,30,4
1649957944480,MATH 18,B03,083750,Staff,27,0,30,3
1649957944480,MATH 18,B04,083751,Staff,25,0,30,5
1649957950507,MATH 20A,A01,083754,Staff,36,0,40,4
1649957956536,MATH 20B,A01,083756,Staff,17,0,30,13
1649957956536,MATH 20B,A02,083757,Staff,30,0,30,0
1649957962563,MATH 20C,A01,083760,Staff,18,0,30,12
1649957962563,MATH 20C,A02,083761,Staff,16,0,30,14
1649957962563,MATH 20C,B01,083762,Staff,27,0,30,3
1649957962563,MATH 20C,B02,083763,Staff,30,0,30,0
1649957968608,MATH 20D,A01,083765,Staff,16,0,30,14
1649957968608,MATH 20D,A02,083766,Staff,30,0,30,0
1649957968608,MATH 20D,A03,083767,Staff,30,0,30,0
1649957974637,MATH 20E,A01,083771,Staff,11,0,30,19
1649957974637,MATH 20E,A02,083772,Staff,24,0,30,6
1649957974637,MATH 20E,B01,083773,Staff,13,0,30,17
1649957974637,MATH 20E,B02,083774,Staff,29,0,30,1
1649957980661,MATH 103A,A01,083777,Staff,1,5,30,29
1649957980661,MATH 103A,A02,083778,Staff,0,4,30,30
1649957980661,MATH 103A,B01,083779,Staff,0,1,30,30
1649957980661,MATH 103A,B02,083780,Staff,10,0,30,20
1649957986691,MATH 105,A01,085443,Staff,0,7,30,30
1649957992718,MATH 109,A01,083213,Anzaldo; Leesa B,9,0,30,21
1649957992718,MATH 109,A02,083214,Anzaldo; Leesa B,6,0,30,24
1649957992718,MATH 109,B01,083215,Anzaldo; Leesa B,26,0,30,4
1649957992718,MATH 109,B02,083216,Anzaldo; Leesa B,18,0,30,12
1649957998752,MATH 142A,A01,083219,Chow; Bennett,0,3,30,30
1649957998752,MATH 142A,A02,083220,Chow; Bennett,1,0,30,29
1649957998752,MATH 142A,B01,083221,Chow; Bennett,0,2,30,30
1649957998752,MATH 142A,B02,083222,Chow; Bennett,0,1,30,30
1649958004781,MATH 193A,A01,083224,Staff,0,5,30,30
1649958004781,MATH 193A,A02,083225,Staff,0,3,30,30
1649958004781,MATH 193A,A03,083781,Staff,2,0,30,28
1649958004781,MATH 193A,A04,083782,Staff,13,0,30,17
1649958010806,MATH 197,001,091859,McAuley; Julian John,9999,0,9999,0
1649958016876,COGS 9,A01,083615,Staff,11,0,60,49
1649958022898,COGS 11,A01,083617,Boyle; Mary E. T.,34,0,40,6
1649958028921,COGS 13,A01,083071,Staff,0,15,40,40
1649958034947,COGS 14A,A01,092681,Staff,57,0,100,43
1649958040985,COGS 14B,A01,083073,Cheng; Tzu-Han,18,0,50,32
1649958047016,COGS 17,A01,092677,Staff,60,0,75,15
1649958053042,COGS 100,A01,083619,Staff,1,12,60,59
1649958059076,COGS 101A,A01,083621,Davis; Joshua Daniel,0,11,60,60
1649958065102,COGS 101B,A01,091572,Staff,28,0,60,32
1649958071132,COGS 101C,A01,083625,Delgado; Tania,22,0,30,8
1649958077155,COGS 107A,A01,083627,Boyle; Mary E. T.,8,0,60,52
1649958083182,COGS 118A,A01,083075,Staff,21,0,60,39
1649958089267,CSE 3,A50,083646,Miranda; Gregory Joseph,24,0,38,14
1649958089267,CSE 3,A51,083647,Miranda; Gregory Joseph,37,0,37,0
1649958095290,CSE 8A,A50,083650,Miranda; Gregory Joseph,3,0,40,37
1649958101317,CSE 11,A01,083080,Cao; Yingjun,0,34,40,40
1649958107340,CSE 12,A01,083652,Staff,46,0,100,54
1649958113370,CSE 15L,A01,083654,Staff,12,0,50,38
1649958113370,CSE 15L,A02,083655,Staff,45,0,50,5
1649958119407,CSE 20,A01,083657,Staff,66,0,80,14
1649958125430,CSE 30,A01,083084,Eldon; John,0,32,40,40
1649958131453,CSE 100,A01,083659,Cao; Yingjun,1,35,50,49
1649958137493,CSE 134B,A01,083661,Powell; Thomas Allan,0,23,65,65
1649958143515,CSE 140,A01,083663,Staff,17,0,75,58
1649958149540,CSE 140L,A01,083088,Eldon; John,13,0,75,62
1649958155566,CSE 175,A01,083665,Kumar; Rakesh,11,0,25,14
1649958161589,CSE 190,A00,092507,Dubnov; Shlomo,13,0,15,2
1649958167613,ECE 45,A01,083139,Staff,4,0,40,36
1649958173635,ECE 65,A50,083695,Staff,4,0,30,26
1649958179661,ECE 109,A01,091882,Touri; Behrouz,52,0,70,18
1649958185692,ECE 180,A00,083140,Abi Samra; Nicholas Camill,26,0,30,4
1649958185692,ECE 180,B00,083141,Abi Samra; Nicholas Camill,13,0,30,17
1649958191743,MATH 10A,A01,083735,Patchell; Gregory David,20,0,30,10
1649958191743,MATH 10A,A02,083736,Patchell; Gregory David,28,0,30,2
1649958191743,MATH 10A,A03,083737,Patchell; Gregory David,28,0,30,2
1649958197777,MATH 10B,A01,083207,Staff,10,0,30,20
1649958197777,MATH 10B,A02,083208,Staff,25,0,30,5
1649958197777,MATH 10B,B01,083739,Staff,25,0,30,5
1649958197777,MATH 10B,B02,083740,Staff,30,0,30,0
1649958203802,MATH 18,A01,083743,Staff,21,0,30,9
1649958203802,MATH 18,A02,083744,Staff,29,0,30,1
1649958203802,MATH 18,A03,083745,Staff,29,0,30,1
1649958203802,MATH 18,A04,083746,Staff,27,0,30,3
1649958203802,MATH 18,B01,083748,Staff,0,0,30,30
1649958203802,MATH 18,B02,083749,Staff,26,0,30,4
1649958203802,MATH 18,B03,083750,Staff,27,0,30,3
1649958203802,MATH 18,B04,083751,Staff,25,0,30,5
1649958209833,MATH 20A,A01,083754,Staff,36,0,40,4
1649958215860,MATH 20B,A01,083756,Staff,17,0,30,13
1649958215860,MATH 20B,A02,083757,Staff,30,0,30,0
1649958221899,MATH 20C,A01,083760,Staff,18,0,30,12
1649958221899,MATH 20C,A02,083761,Staff,16,0,30,14
1649958221899,MATH 20C,B01,083762,Staff,27,0,30,3
1649958221899,MATH 20C,B02,083763,Staff,30,0,30,0
1649958227923,MATH 20D,A01,083765,Staff,15,0,30,15
1649958227923,MATH 20D,A02,083766,Staff,30,0,30,0
1649958227923,MATH 20D,A03,083767,Staff,30,0,30,0
1649958233947,MATH 20E,A01,083771,Staff,11,0,30,19
1649958233947,MATH 20E,A02,083772,Staff,24,0,30,6
1649958233947,MATH 20E,B01,083773,Staff,13,0,30,17
1649958233947,MATH 20E,B02,083774,Staff,29,0,30,1
1649958239973,MATH 103A,A01,083777,Staff,1,5,30,29
1649958239973,MATH 103A,A02,083778,Staff,0,4,30,30
1649958239973,MATH 103A,B01,083779,Staff,0,1,30,30
1649958239973,MATH 103A,B02,083780,Staff,10,0,30,20
1649958246018,MATH 105,A01,085443,Staff,0,7,30,30
1649958252048,MATH 109,A01,083213,Anzaldo; Leesa B,9,0,30,21
1649958252048,MATH 109,A02,083214,Anzaldo; Leesa B,6,0,30,24
1649958252048,MATH 109,B01,083215,Anzaldo; Leesa B,25,0,30,5
1649958252048,MATH 109,B02,083216,Anzaldo; Leesa B,18,0,30,12
1649958258078,MATH 142A,A01,083219,Chow; Bennett,0,3,30,30
1649958258078,MATH 142A,A02,083220,Chow; Bennett,1,0,30,29
1649958258078,MATH 142A,B01,083221,Chow; Bennett,0,2,30,30
1649958258078,MATH 142A,B02,083222,Chow; Bennett,0,1,30,30
1649958264115,MATH 193A,A01,083224,Staff,0,5,30,30
1649958264115,MATH 193A,A02,083225,Staff,0,3,30,30
1649958264115,MATH 193A,A03,083781,Staff,2,0,30,28
1649958264115,MATH 193A,A04,083782,Staff,13,0,30,17
1649958270151,MATH 197,001,091859,McAuley; Julian John,9999,0,9999,0
1649958276210,COGS 9,A01,083615,Staff,11,0,60,49
1649958282234,COGS 11,A01,083617,Boyle; Mary E. T.,34,0,40,6
1649958288283,COGS 13,A01,083071,Staff,0,15,40,40
1649958294309,COGS 14A,A01,092681,Staff,57,0,100,43
1649958300333,COGS 14B,A01,083073,Cheng; Tzu-Han,18,0,50,32
1649958306356,COGS 17,A01,092677,Staff,59,0,75,16
1649958312462,COGS 100,A01,083619,Staff,1,12,60,59
1649958318486,COGS 101A,A01,083621,Davis; Joshua Daniel,0,11,60,60
1649958324520,COGS 101B,A01,091572,Staff,27,0,60,33
1649958330549,COGS 101C,A01,083625,Delgado; Tania,22,0,30,8
1649958336572,COGS 107A,A01,083627,Boyle; Mary E. T.,7,0,60,53
1649958342599,COGS 118A,A01,083075,Staff,21,0,60,39
1649958348638,CSE 3,A50,083646,Miranda; Gregory Joseph,24,0,38,14
1649958348638,CSE 3,A51,083647,Miranda; Gregory Joseph,37,0,37,0
1649958354663,CSE 8A,A50,083650,Miranda; Gregory Joseph,2,0,40,38
1649958360686,CSE 11,A01,083080,Cao; Yingjun,0,34,40,40
1649958366715,CSE 12,A01,083652,Staff,45,0,100,55
1649958372739,CSE 15L,A01,083654,Staff,11,0,50,39
1649958372739,CSE 15L,A02,083655,Staff,45,0,50,5
1649958378770,CSE 20,A01,083657,Staff,66,0,80,14
1649958384794,CSE 30,A01,083084,Eldon; John,0,33,40,40
1649958390820,CSE 100,A01,083659,Cao; Yingjun,1,35,50,49
1649958396860,CSE 134B,A01,083661,Powell; Thomas Allan,0,23,65,65
1649958402884,CSE 140,A01,083663,Staff,17,0,75,58
1649958408926,CSE 140L,A01,083088,Eldon; John,13,0,75,62
1649958414951,CSE 175,A01,083665,Kumar; Rakesh,11,0,25,14
1649958420978,CSE 190,A00,092507,Dubnov; Shlomo,13,0,15,2
1649958427004,ECE 45,A01,083139,Staff,4,0,40,36
1649958433028,ECE 65,A50,083695,Staff,4,0,30,26
1649958439055,ECE 109,A01,091882,Touri; Behrouz,52,0,70,18
1649958445088,ECE 180,A00,083140,Abi Samra; Nicholas Camill,26,0,30,4
1649958445088,ECE 180,B00,083141,Abi Samra; Nicholas Camill,13,0,30,17
1649958451116,MATH 10A,A01,083735,Patchell; Gregory David,20,0,30,10
1649958451116,MATH 10A,A02,083736,Patchell; Gregory David,28,0,30,2
1649958451116,MATH 10A,A03,083737,Patchell; Gregory David,28,0,30,2
1649958457151,MATH 10B,A01,083207,Staff,10,0,30,20
1649958457151,MATH 10B,A02,083208,Staff,25,0,30,5
1649958457151,MATH 10B,B01,083739,Staff,25,0,30,5
1649958457151,MATH 10B,B02,083740,Staff,30,0,30,0
1649958463176,MATH 18,A01,083743,Staff,21,0,30,9
1649958463176,MATH 18,A02,083744,Staff,29,0,30,1
1649958463176,MATH 18,A03,083745,Staff,29,0,30,1
1649958463176,MATH 18,A04,083746,Staff,27,0,30,3
1649958463176,MATH 18,B01,083748,Staff,0,0,30,30
1649958463176,MATH 18,B02,083749,Staff,26,0,30,4
1649958463176,MATH 18,B03,083750,Staff,27,0,30,3
1649958463176,MATH 18,B04,083751,Staff,25,0,30,5
1649958469205,MATH 20A,A01,083754,Staff,36,0,40,4
1649958475229,MATH 20B,A01,083756,Staff,17,0,30,13
1649958475229,MATH 20B,A02,083757,Staff,30,0,30,0
1649958481251,MATH 20C,A01,083760,Staff,17,0,30,13
1649958481251,MATH 20C,A02,083761,Staff,16,0,30,14
1649958481251,MATH 20C,B01,083762,Staff,27,0,30,3
1649958481251,MATH 20C,B02,083763,Staff,30,0,30,0
1649958487277,MATH 20D,A01,083765,Staff,15,0,30,15
1649958487277,MATH 20D,A02,083766,Staff,30,0,30,0
1649958487277,MATH 20D,A03,083767,Staff,30,0,30,0
1649958493309,MATH 20E,A01,083771,Staff,11,0,30,19
1649958493309,MATH 20E,A02,083772,Staff,24,0,30,6
1649958493309,MATH 20E,B01,083773,Staff,13,0,30,17
1649958493309,MATH 20E,B02,083774,Staff,29,0,30,1
1649958499337,MATH 103A,A01,083777,Staff,1,5,30,29
1649958499337,MATH 103A,A02,083778,Staff,0,4,30,30
1649958499337,MATH 103A,B01,083779,Staff,0,1,30,30
1649958499337,MATH 103A,B02,083780,Staff,10,0,30,20
1649958505363,MATH 105,A01,085443,Staff,0,7,30,30
1649958511390,MATH 109,A01,083213,Anzaldo; Leesa B,9,0,30,21
1649958511390,MATH 109,A02,083214,Anzaldo; Leesa B,6,0,30,24
1649958511390,MATH 109,B01,083215,Anzaldo; Leesa B,25,0,30,5
1649958511390,MATH 109,B02,083216,Anzaldo; Leesa B,18,0,30,12
1649958517420,MATH 142A,A01,083219,Chow; Bennett,0,3,30,30
1649958517420,MATH 142A,A02,083220,Chow; Bennett,1,0,30,29
1649958517420,MATH 142A,B01,083221,Chow; Bennett,0,2,30,30
1649958517420,MATH 142A,B02,083222,Chow; Bennett,0,1,30,30
1649958523450,MATH 193A,A01,083224,Staff,0,5,30,30
1649958523450,MATH 193A,A02,083225,Staff,0,3,30,30
1649958523450,MATH 193A,A03,083781,Staff,2,0,30,28
1649958523450,MATH 193A,A04,083782,Staff,13,0,30,17
1649958529475,MATH 197,001,091859,McAuley; Julian John,9999,0,9999,0
1649958535536,COGS 9,A01,083615,Staff,11,0,60,49
1649958541565,COGS 11,A01,083617,Boyle; Mary E. T.,34,0,40,6
1649958547593,COGS 13,A01,083071,Staff,0,15,40,40
1649958553615,COGS 14A,A01,092681,Staff,57,0,100,43
1649958559640,COGS 14B,A01,083073,Cheng; Tzu-Han,18,0,50,32
1649958565670,COGS 17,A01,092677,Staff,59,0,75,16
1649958571696,COGS 100,A01,083619,Staff,1,12,60,59
1649958577722,COGS 101A,A01,083621,Davis; Joshua Daniel,0,11,60,60
1649958583757,COGS 101B,A01,091572,Staff,27,0,60,33
1649958589785,COGS 101C,A01,083625,Delgado; Tania,22,0,30,8
1649958595820,COGS 107A,A01,083627,Boyle; Mary E. T.,7,0,60,53
1649958601851,COGS 118A,A01,083075,Staff,21,0,60,39
1649958607883,CSE 3,A50,083646,Miranda; Gregory Joseph,24,0,38,14
1649958607883,CSE 3,A51,083647,Miranda; Gregory Joseph,37,0,37,0
1649958613917,CSE 8A,A50,083650,Miranda; Gregory Joseph,2,0,40,38
1649958619960,CSE 11,A01,083080,Cao; Yingjun,0,34,40,40
1649958625987,CSE 12,A01,083652,Staff,45,0,100,55
1649958632016,CSE 15L,A01,083654,Staff,11,0,50,39
1649958632016,CSE 15L,A02,083655,Staff,45,0,50,5
1649958638056,CSE 20,A01,083657,Staff,66,0,80,14
1649958644085,CSE 30,A01,083084,Eldon; John,0,33,40,40
1649958650112,CSE 100,A01,083659,Cao; Yingjun,1,36,50,49
1649958656140,CSE 134B,A01,083661,Powell; Thomas Allan,0,23,65,65
1649958662164,CSE 140,A01,083663,Staff,16,0,75,59
1649958668198,CSE 140L,A01,083088,Eldon; John,12,0,75,63
1649958674221,CSE 175,A01,083665,Kumar; Rakesh,11,0,25,14
1649958680246,CSE 190,A00,092507,Dubnov; Shlomo,13,0,15,2
1649958686270,ECE 45,A01,083139,Staff,4,0,40,36
1649958692296,ECE 65,A50,083695,Staff,4,0,30,26
1649958698321,ECE 109,A01,091882,Touri; Behrouz,52,0,70,18
1649958704360,ECE 180,A00,083140,Abi Samra; Nicholas Camill,26,0,30,4
1649958704360,ECE 180,B00,083141,Abi Samra; Nicholas Camill,13,0,30,17
1649958710396,MATH 10A,A01,083735,Patchell; Gregory David,20,0,30,10
1649958710396,MATH 10A,A02,083736,Patchell; Gregory David,28,0,30,2
1649958710396,MATH 10A,A03,083737,Patchell; Gregory David,28,0,30,2
1649958716431,MATH 10B,A01,083207,Staff,10,0,30,20
1649958716431,MATH 10B,A02,083208,Staff,25,0,30,5
1649958716431,MATH 10B,B01,083739,Staff,25,0,30,5
1649958716431,MATH 10B,B02,083740,Staff,30,0,30,0
1649958722479,MATH 18,A01,083743,Staff,21,0,30,9
1649958722479,MATH 18,A02,083744,Staff,29,0,30,1
1649958722479,MATH 18,A03,083745,Staff,29,0,30,1
1649958722479,MATH 18,A04,083746,Staff,27,0,30,3
1649958722479,MATH 18,B01,083748,Staff,0,0,30,30
1649958722479,MATH 18,B02,083749,Staff,26,0,30,4
1649958722479,MATH 18,B03,083750,Staff,27,0,30,3
1649958722479,MATH 18,B04,083751,Staff,25,0,30,5
1649958728501,MATH 20A,A01,083754,Staff,36,0,40,4
1649958734525,MATH 20B,A01,083756,Staff,17,0,30,13
1649958734525,MATH 20B,A02,083757,Staff,30,0,30,0
1649958740554,MATH 20C,A01,083760,Staff,17,0,30,13
1649958740554,MATH 20C,A02,083761,Staff,15,0,30,15
1649958740554,MATH 20C,B01,083762,Staff,27,0,30,3
1649958740554,MATH 20C,B02,083763,Staff,30,0,30,0
1649958746580,MATH 20D,A01,083765,Staff,15,0,30,15
1649958746580,MATH 20D,A02,083766,Staff,30,0,30,0
1649958746580,MATH 20D,A03,083767,Staff,30,0,30,0
1649958752607,MATH 20E,A01,083771,Staff,11,0,30,19
1649958752607,MATH 20E,A02,083772,Staff,24,0,30,6
1649958752607,MATH 20E,B01,083773,Staff,13,0,30,17
1649958752607,MATH 20E,B02,083774,Staff,29,0,30,1
1649958758631,MATH 103A,A01,083777,Staff,1,5,30,29
1649958758631,MATH 103A,A02,083778,Staff,0,4,30,30
1649958758631,MATH 103A,B01,083779,Staff,0,1,30,30
1649958758631,MATH 103A,B02,083780,Staff,10,0,30,20
1649958764680,MATH 105,A01,085443,Staff,0,7,30,30
1649958770706,MATH 109,A01,083213,Anzaldo; Leesa B,9,0,30,21
1649958770706,MATH 109,A02,083214,Anzaldo; Leesa B,6,0,30,24
1649958770706,MATH 109,B01,083215,Anzaldo; Leesa B,25,0,30,5
1649958770706,MATH 109,B02,083216,Anzaldo; Leesa B,18,0,30,12
1649958776741,MATH 142A,A01,083219,Chow; Bennett,0,3,30,30
1649958776741,MATH 142A,A02,083220,Chow; Bennett,1,0,30,29
1649958776741,MATH 142A,B01,083221,Chow; Bennett,0,2,30,30
1649958776741,MATH 142A,B02,083222,Chow; Bennett,0,1,30,30
1649958782765,MATH 193A,A01,083224,Staff,0,5,30,30
1649958782765,MATH 193A,A02,083225,Staff,0,3,30,30
1649958782765,MATH 193A,A03,083781,Staff,2,0,30,28
1649958782765,MATH 193A,A04,083782,Staff,13,0,30,17
1649958788800,MATH 197,001,091859,McAuley; Julian John,9999,0,9999,0
1649958794879,COGS 9,A01,083615,Staff,11,0,60,49
1649958800905,COGS 11,A01,083617,Boyle; Mary E. T.,34,0,40,6
1649958806927,COGS 13,A01,083071,Staff,0,15,40,40
1649958812964,COGS 14A,A01,092681,Staff,57,0,100,43
1649958818987,COGS 14B,A01,083073,Cheng; Tzu-Han,17,0,50,33
1649958825010,COGS 17,A01,092677,Staff,59,0,75,16
1649958831046,COGS 100,A01,083619,Staff,1,12,60,59
1649958837073,COGS 101A,A01,083621,Davis; Joshua Daniel,0,11,60,60
1649958843116,COGS 101B,A01,091572,Staff,26,0,60,34
1649958849140,COGS 101C,A01,083625,Delgado; Tania,22,0,30,8
1649958855172,COGS 107A,A01,083627,Boyle; Mary E. T.,7,0,60,53
1649958861196,COGS 118A,A01,083075,Staff,21,0,60,39
1649958867219,CSE 3,A50,083646,Miranda; Gregory Joseph,24,0,38,14
1649958867219,CSE 3,A51,083647,Miranda; Gregory Joseph,37,0,37,0
1649958873250,CSE 8A,A50,083650,Miranda; Gregory Joseph,1,0,40,39
1649958879299,CSE 11,A01,083080,Cao; Yingjun,0,34,40,40
1649958892427,CSE 12,A01,083652,Staff,43,0,100,57
1649958898450,CSE 15L,A01,083654,Staff,9,0,50,41
1649958898450,CSE 15L,A02,083655,Staff,45,0,50,5
1649958904485,CSE 20,A01,083657,Staff,66,0,80,14
1649958910512,CSE 30,A01,083084,Eldon; John,0,33,40,40
1649958916650,CSE 100,A01,083659,Cao; Yingjun,1,36,50,49
1649958922685,CSE 134B,A01,083661,Powell; Thomas Allan,0,23,65,65
1649958928709,CSE 140,A01,083663,Staff,16,0,75,59
1649958934733,CSE 140L,A01,083088,Eldon; John,12,0,75,63
1649958940763,CSE 175,A01,083665,Kumar; Rakesh,11,0,25,14
1649958946794,CSE 190,A00,092507,Dubnov; Shlomo,13,0,15,2
1649958952839,ECE 45,A01,083139,Staff,4,0,40,36
1649958958866,ECE 65,A50,083695,Staff,4,0,30,26
1649958964889,ECE 109,A01,091882,Touri; Behrouz,52,0,70,18
1649958970923,ECE 180,A00,083140,Abi Samra; Nicholas Camill,26,0,30,4
1649958970923,ECE 180,B00,083141,Abi Samra; Nicholas Camill,13,0,30,17
1649958976959,MATH 10A,A01,083735,Patchell; Gregory David,19,0,30,11
1649958976959,MATH 10A,A02,083736,Patchell; Gregory David,28,0,30,2
1649958976959,MATH 10A,A03,083737,Patchell; Gregory David,28,0,30,2
1649958982998,MATH 10B,A01,083207,Staff,10,0,30,20
1649958982998,MATH 10B,A02,083208,Staff,25,0,30,5
1649958982998,MATH 10B,B01,083739,Staff,25,0,30,5
1649958982998,MATH 10B,B02,083740,Staff,30,0,30,0
1649958989023,MATH 18,A01,083743,Staff,21,0,30,9
1649958989023,MATH 18,A02,083744,Staff,29,0,30,1
1649958989023,MATH 18,A03,083745,Staff,29,0,30,1
1649958989023,MATH 18,A04,083746,Staff,27,0,30,3
1649958989023,MATH 18,B01,083748,Staff,0,0,30,30
1649958989023,MATH 18,B02,083749,Staff,26,0,30,4
1649958989023,MATH 18,B03,083750,Staff,27,0,30,3
1649958989023,MATH 18,B04,083751,Staff,25,0,30,5
1649958995046,MATH 20A,A01,083754,Staff,36,0,40,4
1649959001093,MATH 20B,A01,083756,Staff,17,0,30,13
1649959001093,MATH 20B,A02,083757,Staff,30,0,30,0
1649959007129,MATH 20C,A01,083760,Staff,17,0,30,13
1649959007129,MATH 20C,A02,083761,Staff,15,0,30,15
1649959007129,MATH 20C,B01,083762,Staff,27,0,30,3
1649959007129,MATH 20C,B02,083763,Staff,30,0,30,0
1649959013159,MATH 20D,A01,083765,Staff,14,0,30,16
1649959013159,MATH 20D,A02,083766,Staff,30,0,30,0
1649959013159,MATH 20D,A03,083767,Staff,30,0,30,0
1649959019186,MATH 20E,A01,083771,Staff,11,0,30,19
1649959019186,MATH 20E,A02,083772,Staff,24,0,30,6
1649959019186,MATH 20E,B01,083773,Staff,13,0,30,17
1649959019186,MATH 20E,B02,083774,Staff,29,0,30,1
1649959025228,MATH 103A,A01,083777,Staff,1,5,30,29
1649959025228,MATH 103A,A02,083778,Staff,0,4,30,30
1649959025228,MATH 103A,B01,083779,Staff,0,1,30,30
1649959025228,MATH 103A,B02,083780,Staff,10,0,30,20
1649959031253,MATH 105,A01,085443,Staff,0,7,30,30
1649959037277,MATH 109,A01,083213,Anzaldo; Leesa B,9,0,30,21
1649959037277,MATH 109,A02,083214,Anzaldo; Leesa B,5,0,30,25
1649959037277,MATH 109,B01,083215,Anzaldo; Leesa B,25,0,30,5
1649959037277,MATH 109,B02,083216,Anzaldo; Leesa B,18,0,30,12
1649959043299,MATH 142A,A01,083219,Chow; Bennett,0,3,30,30
1649959043299,MATH 142A,A02,083220,Chow; Bennett,1,0,30,29
1649959043299,MATH 142A,B01,083221,Chow; Bennett,0,2,30,30
1649959043299,MATH 142A,B02,083222,Chow; Bennett,0,1,30,30
1649959049339,MATH 193A,A01,083224,Staff,0,5,30,30
1649959049339,MATH 193A,A02,083225,Staff,0,3,30,30
1649959049339,MATH 193A,A03,083781,Staff,2,0,30,28
1649959049339,MATH 193A,A04,083782,Staff,13,0,30,17
1649959055362,MATH 197,001,091859,McAuley; Julian John,9999,0,9999,0
1649959061421,COGS 9,A01,083615,Staff,11,0,60,49
1649959067444,COGS 11,A01,083617,Boyle; Mary E. T.,34,0,40,6
1649959073476,COGS 13,A01,083071,Staff,0,16,40,40
1649959079498,COGS 14A,A01,092681,Staff,57,0,100,43
1649959085547,COGS 14B,A01,083073,Cheng; Tzu-Han,17,0,50,33
1649959091580,COGS 17,A01,092677,Staff,59,0,75,16
1649959097624,COGS 100,A01,083619,Staff,1,12,60,59
1649959103648,COGS 101A,A01,083621,Davis; Joshua Daniel,0,11,60,60
1649959109672,COGS 101B,A01,091572,Staff,26,0,60,34
1649959115702,COGS 101C,A01,083625,Delgado; Tania,22,0,30,8
1649959121725,COGS 107A,A01,083627,Boyle; Mary E. T.,7,0,60,53
1649959127752,COGS 118A,A01,083075,Staff,21,0,60,39
1649959133791,CSE 3,A50,083646,Miranda; Gregory Joseph,24,0,38,14
1649959133791,CSE 3,A51,083647,Miranda; Gregory Joseph,37,0,37,0
1649959139823,CSE 8A,A50,083650,Miranda; Gregory Joseph,0,0,40,40
1649959145847,CSE 11,A01,083080,Cao; Yingjun,0,34,40,40
1649959151872,CSE 12,A01,083652,Staff,43,0,100,57
1649959157908,CSE 15L,A01,083654,Staff,9,0,50,41
1649959157908,CSE 15L,A02,083655,Staff,45,0,50,5
1649959163936,CSE 20,A01,083657,Staff,66,0,80,14
1649959169974,CSE 30,A01,083084,Eldon; John,0,34,40,40
1649959176005,CSE 100,A01,083659,Cao; Yingjun,1,36,50,49
1649959182029,CSE 134B,A01,083661,Powell; Thomas Allan,0,23,65,65
1649959188051,CSE 140,A01,083663,Staff,16,0,75,59
1649959194073,CSE 140L,A01,083088,Eldon; John,12,0,75,63
1649959200096,CSE 175,A01,083665,Kumar; Rakesh,11,0,25,14
1649959206120,CSE 190,A00,092507,Dubnov; Shlomo,13,0,15,2
1649959212142,ECE 45,A01,083139,Staff,4,0,40,36
1649959218179,ECE 65,A50,083695,Staff,4,0,30,26
1649959224202,ECE 109,A01,091882,Touri; Behrouz,52,0,70,18
1649959230226,ECE 180,A00,083140,Abi Samra; Nicholas Camill,26,0,30,4
1649959230226,ECE 180,B00,083141,Abi Samra; Nicholas Camill,13,0,30,17
1649959236259,MATH 10A,A01,083735,Patchell; Gregory David,19,0,30,11
1649959236259,MATH 10A,A02,083736,Patchell; Gregory David,28,0,30,2
1649959236259,MATH 10A,A03,083737,Patchell; Gregory David,28,0,30,2
1649959242285,MATH 10B,A01,083207,Staff,9,0,30,21
1649959242285,MATH 10B,A02,083208,Staff,25,0,30,5
1649959242285,MATH 10B,B01,083739,Staff,25,0,30,5
1649959242285,MATH 10B,B02,083740,Staff,30,0,30,0
1649959248309,MATH 18,A01,083743,Staff,21,0,30,9
1649959248309,MATH 18,A02,083744,Staff,29,0,30,1
1649959248309,MATH 18,A03,083745,Staff,29,0,30,1
1649959248309,MATH 18,A04,083746,Staff,27,0,30,3
1649959248309,MATH 18,B01,083748,Staff,0,0,30,30
1649959248309,MATH 18,B02,083749,Staff,26,0,30,4
1649959248309,MATH 18,B03,083750,Staff,27,0,30,3
1649959248309,MATH 18,B04,083751,Staff,24,0,30,6
1649959254345,MATH 20A,A01,083754,Staff,36,0,40,4
1649959260368,MATH 20B,A01,083756,Staff,17,0,30,13
1649959260368,MATH 20B,A02,083757,Staff,30,0,30,0
1649959266394,MATH 20C,A01,083760,Staff,17,0,30,13
1649959266394,MATH 20C,A02,083761,Staff,15,0,30,15
1649959266394,MATH 20C,B01,083762,Staff,27,0,30,3
1649959266394,MATH 20C,B02,083763,Staff,30,0,30,0
1649959272422,MATH 20D,A01,083765,Staff,14,0,30,16
1649959272422,MATH 20D,A02,083766,Staff,30,0,30,0
1649959272422,MATH 20D,A03,083767,Staff,30,0,30,0
1649959278446,MATH 20E,A01,083771,Staff,11,0,30,19
1649959278446,MATH 20E,A02,083772,Staff,24,0,30,6
1649959278446,MATH 20E,B01,083773,Staff,13,0,30,17
1649959278446,MATH 20E,B02,083774,Staff,29,0,30,1
1649959284471,MATH 103A,A01,083777,Staff,1,5,30,29
1649959284471,MATH 103A,A02,083778,Staff,0,4,30,30
1649959284471,MATH 103A,B01,083779,Staff,0,1,30,30
1649959284471,MATH 103A,B02,083780,Staff,10,0,30,20
1649959290498,MATH 105,A01,085443,Staff,0,7,30,30
1649959296533,MATH 109,A01,083213,Anzaldo; Leesa B,9,0,30,21
1649959296533,MATH 109,A02,083214,Anzaldo; Leesa B,5,0,30,25
1649959296533,MATH 109,B01,083215,Anzaldo; Leesa B,25,0,30,5
1649959296533,MATH 109,B02,083216,Anzaldo; Leesa B,18,0,30,12
1649959302559,MATH 142A,A01,083219,Chow; Bennett,0,3,30,30
1649959302559,MATH 142A,A02,083220,Chow; Bennett,1,0,30,29
1649959302559,MATH 142A,B01,083221,Chow; Bennett,0,2,30,30
1649959302559,MATH 142A,B02,083222,Chow; Bennett,0,1,30,30
1649959308591,MATH 193A,A01,083224,Staff,0,5,30,30
1649959308591,MATH 193A,A02,083225,Staff,0,3,30,30
1649959308591,MATH 193A,A03,083781,Staff,2,0,30,28
1649959308591,MATH 193A,A04,083782,Staff,13,0,30,17
1649959314623,MATH 197,001,091859,McAuley; Julian John,9999,0,9999,0
1649959320694,COGS 9,A01,083615,Staff,11,0,60,49
1649959326721,COGS 11,A01,083617,Boyle; Mary E. T.,34,0,40,6
1649959332744,COGS 13,A01,083071,Staff,0,17,40,40
1649959338781,COGS 14A,A01,092681,Staff,56,0,100,44
1649959344807,COGS 14B,A01,083073,Cheng; Tzu-Han,17,0,50,33
1649959350842,COGS 17,A01,092677,Staff,59,0,75,16
1649959356879,COGS 100,A01,083619,Staff,1,12,60,59
1649959362915,COGS 101A,A01,083621,Davis; Joshua Daniel,0,12,60,60
1649959368941,COGS 101B,A01,091572,Staff,26,0,60,34
1649959374967,COGS 101C,A01,083625,Delgado; Tania,22,0,30,8
1649959380990,COGS 107A,A01,083627,Boyle; Mary E. T.,6,0,60,54
1649959387030,COGS 118A,A01,083075,Staff,21,0,60,39
1649959393054,CSE 3,A50,083646,Miranda; Gregory Joseph,24,0,38,14
1649959393054,CSE 3,A51,083647,Miranda; Gregory Joseph,37,0,37,0
1649959399082,CSE 8A,A50,083650,Miranda; Gregory Joseph,1,0,40,39
1649959405121,CSE 11,A01,083080,Cao; Yingjun,0,34,40,40
1649959411145,CSE 12,A01,083652,Staff,43,0,100,57
1649959417168,CSE 15L,A01,083654,Staff,9,0,50,41
1649959417168,CSE 15L,A02,083655,Staff,45,0,50,5
1649959423203,CSE 20,A01,083657,Staff,66,0,80,14
1649959429239,CSE 30,A01,083084,Eldon; John,0,34,40,40
1649959435265,CSE 100,A01,083659,Cao; Yingjun,1,36,50,49
1649959441289,CSE 134B,A01,083661,Powell; Thomas Allan,0,23,65,65
1649959447315,CSE 140,A01,083663,Staff,16,0,75,59
1649959453349,CSE 140L,A01,083088,Eldon; John,12,0,75,63
1649959459378,CSE 175,A01,083665,Kumar; Rakesh,11,0,25,14
1649959465404,CSE 190,A00,092507,Dubnov; Shlomo,13,0,15,2
1649959471438,ECE 45,A01,083139,Staff,4,0,40,36
1649959477466,ECE 65,A50,083695,Staff,4,0,30,26
1649959483505,ECE 109,A01,091882,Touri; Behrouz,52,0,70,18
1649959489539,ECE 180,A00,083140,Abi Samra; Nicholas Camill,26,0,30,4
1649959489539,ECE 180,B00,083141,Abi Samra; Nicholas Camill,13,0,30,17
1649959495563,MATH 10A,A01,083735,Patchell; Gregory David,19,0,30,11
1649959495563,MATH 10A,A02,083736,Patchell; Gregory David,28,0,30,2
1649959495563,MATH 10A,A03,083737,Patchell; Gregory David,28,0,30,2
1649959501588,MATH 10B,A01,083207,Staff,9,0,30,21
1649959501588,MATH 10B,A02,083208,Staff,25,0,30,5
1649959501588,MATH 10B,B01,083739,Staff,25,0,30,5
1649959501588,MATH 10B,B02,083740,Staff,30,0,30,0
1649959507618,MATH 18,A01,083743,Staff,20,0,30,10
1649959507618,MATH 18,A02,083744,Staff,29,0,30,1
1649959507618,MATH 18,A03,083745,Staff,29,0,30,1
1649959507618,MATH 18,A04,083746,Staff,27,0,30,3
1649959507618,MATH 18,B01,083748,Staff,0,0,30,30
1649959507618,MATH 18,B02,083749,Staff,25,0,30,5
1649959507618,MATH 18,B03,083750,Staff,27,0,30,3
1649959507618,MATH 18,B04,083751,Staff,24,0,30,6
1649959513778,MATH 20A,A01,083754,Staff,36,0,40,4
1649959519825,MATH 20B,A01,083756,Staff,17,0,30,13
1649959519825,MATH 20B,A02,083757,Staff,30,0,30,0
1649959525847,MATH 20C,A01,083760,Staff,17,0,30,13
1649959525847,MATH 20C,A02,083761,Staff,15,0,30,15
1649959525847,MATH 20C,B01,083762,Staff,27,0,30,3
1649959525847,MATH 20C,B02,083763,Staff,30,0,30,0
1649959531894,MATH 20D,A01,083765,Staff,14,0,30,16
1649959531894,MATH 20D,A02,083766,Staff,30,0,30,0
1649959531894,MATH 20D,A03,083767,Staff,30,0,30,0
1649959537922,MATH 20E,A01,083771,Staff,11,0,30,19
1649959537922,MATH 20E,A02,083772,Staff,24,0,30,6
1649959537922,MATH 20E,B01,083773,Staff,13,0,30,17
1649959537922,MATH 20E,B02,083774,Staff,29,0,30,1
1649959543947,MATH 103A,A01,083777,Staff,1,5,30,29
1649959543947,MATH 103A,A02,083778,Staff,0,4,30,30
1649959543947,MATH 103A,B01,083779,Staff,0,1,30,30
1649959543947,MATH 103A,B02,083780,Staff,10,0,30,20
1649959549971,MATH 105,A01,085443,Staff,0,7,30,30
1649959555998,MATH 109,A01,083213,Anzaldo; Leesa B,9,0,30,21
1649959555998,MATH 109,A02,083214,Anzaldo; Leesa B,5,0,30,25
1649959555998,MATH 109,B01,083215,Anzaldo; Leesa B,25,0,30,5
1649959555998,MATH 109,B02,083216,Anzaldo; Leesa B,18,0,30,12
1649959562027,MATH 142A,A01,083219,Chow; Bennett,0,3,30,30
1649959562027,MATH 142A,A02,083220,Chow; Bennett,1,0,30,29
1649959562027,MATH 142A,B01,083221,Chow; Bennett,0,2,30,30
1649959562027,MATH 142A,B02,083222,Chow; Bennett,0,1,30,30
1649959568050,MATH 193A,A01,083224,Staff,0,5,30,30
1649959568050,MATH 193A,A02,083225,Staff,0,3,30,30
1649959568050,MATH 193A,A03,083781,Staff,2,0,30,28
1649959568050,MATH 193A,A04,083782,Staff,13,0,30,17
1649959574073,MATH 197,001,091859,McAuley; Julian John,9999,0,9999,0
1649959580156,COGS 9,A01,083615,Staff,11,0,60,49
1649959586179,COGS 11,A01,083617,Boyle; Mary E. T.,34,0,40,6
1649959592205,COGS 13,A01,083071,Staff,0,17,40,40
1649959598242,COGS 14A,A01,092681,Staff,56,0,100,44
1649959604265,COGS 14B,A01,083073,Cheng; Tzu-Han,17,0,50,33
1649959610295,COGS 17,A01,092677,Staff,59,0,75,16
1649959616323,COGS 100,A01,083619,Staff,1,12,60,59
1649959622345,COGS 101A,A01,083621,Davis; Joshua Daniel,0,12,60,60
1649959628378,COGS 101B,A01,091572,Staff,26,0,60,34
1649959634403,COGS 101C,A01,083625,Delgado; Tania,22,0,30,8
1649959640426,COGS 107A,A01,083627,Boyle; Mary E. T.,7,0,60,53
1649959646449,COGS 118A,A01,083075,Staff,21,0,60,39
1649959652479,CSE 3,A50,083646,Miranda; Gregory Joseph,24,0,38,14
1649959652479,CSE 3,A51,083647,Miranda; Gregory Joseph,37,0,37,0
1649959658515,CSE 8A,A50,083650,Miranda; Gregory Joseph,1,0,40,39
1649959664546,CSE 11,A01,083080,Cao; Yingjun,0,34,40,40
1649959670578,CSE 12,A01,083652,Staff,42,0,100,58
1649959676608,CSE 15L,A01,083654,Staff,8,0,50,42
1649959676608,CSE 15L,A02,083655,Staff,45,0,50,5
1649959682630,CSE 20,A01,083657,Staff,66,0,80,14
1649959688656,CSE 30,A01,083084,Eldon; John,0,33,40,40
1649959694685,CSE 100,A01,083659,Cao; Yingjun,1,37,50,49
1649959700725,CSE 134B,A01,083661,Powell; Thomas Allan,0,23,65,65
1649959706753,CSE 140,A01,083663,Staff,16,0,75,59
1649959712776,CSE 140L,A01,083088,Eldon; John,12,0,75,63
1649959718797,CSE 175,A01,083665,Kumar; Rakesh,11,0,25,14
1649959724832,CSE 190,A00,092507,Dubnov; Shlomo,13,0,15,2
1649959730855,ECE 45,A01,083139,Staff,3,0,40,37
1649959736890,ECE 65,A50,083695,Staff,4,0,30,26
1649959742913,ECE 109,A01,091882,Touri; Behrouz,52,0,70,18
1649959748947,ECE 180,A00,083140,Abi Samra; Nicholas Camill,26,0,30,4
1649959748947,ECE 180,B00,083141,Abi Samra; Nicholas Camill,13,0,30,17
1649959754975,MATH 10A,A01,083735,Patchell; Gregory David,19,0,30,11
1649959754975,MATH 10A,A02,083736,Patchell; Gregory David,28,0,30,2
1649959754975,MATH 10A,A03,083737,Patchell; Gregory David,28,0,30,2
1649959761003,MATH 10B,A01,083207,Staff,9,0,30,21
1649959761003,MATH 10B,A02,083208,Staff,25,0,30,5
1649959761003,MATH 10B,B01,083739,Staff,25,0,30,5
1649959761003,MATH 10B,B02,083740,Staff,30,0,30,0
1649959767035,MATH 18,A01,083743,Staff,20,0,30,10
1649959767035,MATH 18,A02,083744,Staff,29,0,30,1
1649959767035,MATH 18,A03,083745,Staff,29,0,30,1
1649959767035,MATH 18,A04,083746,Staff,27,0,30,3
1649959767035,MATH 18,B01,083748,Staff,0,0,30,30
1649959767035,MATH 18,B02,083749,Staff,25,0,30,5
1649959767035,MATH 18,B03,083750,Staff,27,0,30,3
1649959767035,MATH 18,B04,083751,Staff,24,0,30,6
1649959773060,MATH 20A,A01,083754,Staff,36,0,40,4
1649959779106,MATH 20B,A01,083756,Staff,17,0,30,13
1649959779106,MATH 20B,A02,083757,Staff,30,0,30,0
1649959785132,MATH 20C,A01,083760,Staff,17,0,30,13
1649959785132,MATH 20C,A02,083761,Staff,15,0,30,15
1649959785132,MATH 20C,B01,083762,Staff,27,0,30,3
1649959785132,MATH 20C,B02,083763,Staff,30,0,30,0
1649959791159,MATH 20D,A01,083765,Staff,14,0,30,16
1649959791159,MATH 20D,A02,083766,Staff,30,0,30,0
1649959791159,MATH 20D,A03,083767,Staff,30,0,30,0
1649959797186,MATH 20E,A01,083771,Staff,11,0,30,19
1649959797186,MATH 20E,A02,083772,Staff,24,0,30,6
1649959797186,MATH 20E,B01,083773,Staff,13,0,30,17
1649959797186,MATH 20E,B02,083774,Staff,29,0,30,1
1649959803212,MATH 103A,A01,083777,Staff,1,5,30,29
1649959803212,MATH 103A,A02,083778,Staff,0,4,30,30
1649959803212,MATH 103A,B01,083779,Staff,0,1,30,30
1649959803212,MATH 103A,B02,083780,Staff,10,0,30,20
1649959809244,MATH 105,A01,085443,Staff,0,7,30,30
1649959815296,MATH 109,A01,083213,Anzaldo; Leesa B,8,0,30,22
1649959815296,MATH 109,A02,083214,Anzaldo; Leesa B,5,0,30,25
1649959815296,MATH 109,B01,083215,Anzaldo; Leesa B,25,0,30,5
1649959815296,MATH 109,B02,083216,Anzaldo; Leesa B,18,0,30,12
1649959821320,MATH 142A,A01,083219,Chow; Bennett,0,3,30,30
1649959821320,MATH 142A,A02,083220,Chow; Bennett,1,0,30,29
1649959821320,MATH 142A,B01,083221,Chow; Bennett,0,2,30,30
1649959821320,MATH 142A,B02,083222,Chow; Bennett,0,1,30,30
1649959827350,MATH 193A,A01,083224,Staff,0,5,30,30
1649959827350,MATH 193A,A02,083225,Staff,0,3,30,30
1649959827350,MATH 193A,A03,083781,Staff,2,0,30,28
1649959827350,MATH 193A,A04,083782,Staff,13,0,30,17
1649959833376,MATH 197,001,091859,McAuley; Julian John,9999,0,9999,0
1649959839441,COGS 9,A01,083615,Staff,11,0,60,49
1649959845499,COGS 11,A01,083617,Boyle; Mary E. T.,34,0,40,6
1649959851528,COGS 13,A01,083071,Staff,0,17,40,40
1649959857554,COGS 14A,A01,092681,Staff,56,0,100,44
1649959863578,COGS 14B,A01,083073,Cheng; Tzu-Han,17,0,50,33
1649959869601,COGS 17,A01,092677,Staff,59,0,75,16
1649959875629,COGS 100,A01,083619,Staff,1,12,60,59
1649959881653,COGS 101A,A01,083621,Davis; Joshua Daniel,0,12,60,60
1649959887680,COGS 101B,A01,091572,Staff,26,0,60,34
1649959893704,COGS 101C,A01,083625,Delgado; Tania,22,0,30,8
1649959899729,COGS 107A,A01,083627,Boyle; Mary E. T.,7,0,60,53
1649959905755,COGS 118A,A01,083075,Staff,21,0,60,39
1649959911783,CSE 3,A50,083646,Miranda; Gregory Joseph,24,0,38,14
1649959911783,CSE 3,A51,083647,Miranda; Gregory Joseph,37,0,37,0
1649959917819,CSE 8A,A50,083650,Miranda; Gregory Joseph,1,0,40,39
1649959923860,CSE 11,A01,083080,Cao; Yingjun,0,34,40,40
1649959929891,CSE 12,A01,083652,Staff,42,0,100,58
1649959935919,CSE 15L,A01,083654,Staff,8,0,50,42
1649959935919,CSE 15L,A02,083655,Staff,45,0,50,5
1649959941950,CSE 20,A01,083657,Staff,66,0,80,14
1649959947986,CSE 30,A01,083084,Eldon; John,0,33,40,40
1649959954021,CSE 100,A01,083659,Cao; Yingjun,1,37,50,49
1649959960048,CSE 134B,A01,083661,Powell; Thomas Allan,0,23,65,65
1649959966087,CSE 140,A01,083663,Staff,16,0,75,59
1649959972119,CSE 140L,A01,083088,Eldon; John,12,0,75,63
1649959978141,CSE 175,A01,083665,Kumar; Rakesh,11,0,25,14
1649959984164,CSE 190,A00,092507,Dubnov; Shlomo,13,0,15,2
1649959990198,ECE 45,A01,083139,Staff,2,0,40,38
1649959996222,ECE 65,A50,083695,Staff,4,0,30,26
1649960002244,ECE 109,A01,091882,Touri; Behrouz,52,0,70,18
1649960008270,ECE 180,A00,083140,Abi Samra; Nicholas Camill,26,0,30,4
1649960008270,ECE 180,B00,083141,Abi Samra; Nicholas Camill,13,0,30,17
1649960014310,MATH 10A,A01,083735,Patchell; Gregory David,19,0,30,11
1649960014310,MATH 10A,A02,083736,Patchell; Gregory David,28,0,30,2
1649960014310,MATH 10A,A03,083737,Patchell; Gregory David,28,0,30,2
1649960020344,MATH 10B,A01,083207,Staff,9,0,30,21
1649960020344,MATH 10B,A02,083208,Staff,25,0,30,5
1649960020344,MATH 10B,B01,083739,Staff,25,0,30,5
1649960020344,MATH 10B,B02,083740,Staff,30,0,30,0
1649960026382,MATH 18,A01,083743,Staff,20,0,30,10
1649960026382,MATH 18,A02,083744,Staff,29,0,30,1
1649960026382,MATH 18,A03,083745,Staff,29,0,30,1
1649960026382,MATH 18,A04,083746,Staff,27,0,30,3
1649960026382,MATH 18,B01,083748,Staff,0,0,30,30
1649960026382,MATH 18,B02,083749,Staff,23,0,30,7
1649960026382,MATH 18,B03,083750,Staff,26,0,30,4
1649960026382,MATH 18,B04,083751,Staff,23,0,30,7
1649960032421,MATH 20A,A01,083754,Staff,36,0,40,4
1649960038443,MATH 20B,A01,083756,Staff,17,0,30,13
1649960038443,MATH 20B,A02,083757,Staff,30,0,30,0
1649960044485,MATH 20C,A01,083760,Staff,16,0,30,14
1649960044485,MATH 20C,A02,083761,Staff,14,0,30,16
1649960044485,MATH 20C,B01,083762,Staff,27,0,30,3
1649960044485,MATH 20C,B02,083763,Staff,30,0,30,0
1649960050508,MATH 20D,A01,083765,Staff,14,0,30,16
1649960050508,MATH 20D,A02,083766,Staff,30,0,30,0
1649960050508,MATH 20D,A03,083767,Staff,29,0,30,1
1649960056535,MATH 20E,A01,083771,Staff,11,0,30,19
1649960056535,MATH 20E,A02,083772,Staff,24,0,30,6
1649960056535,MATH 20E,B01,083773,Staff,12,0,30,18
1649960056535,MATH 20E,B02,083774,Staff,29,0,30,1
1649960062557,MATH 103A,A01,083777,Staff,1,5,30,29
1649960062557,MATH 103A,A02,083778,Staff,0,4,30,30
1649960062557,MATH 103A,B01,083779,Staff,0,1,30,30
1649960062557,MATH 103A,B02,083780,Staff,10,0,30,20
1649960068596,MATH 105,A01,085443,Staff,0,7,30,30
1649960074626,MATH 109,A01,083213,Anzaldo; Leesa B,8,0,30,22
1649960074626,MATH 109,A02,083214,Anzaldo; Leesa B,5,0,30,25
1649960074626,MATH 109,B01,083215,Anzaldo; Leesa B,25,0,30,5
1649960074626,MATH 109,B02,083216,Anzaldo; Leesa B,18,0,30,12
1649960080649,MATH 142A,A01,083219,Chow; Bennett,0,3,30,30
1649960080649,MATH 142A,A02,083220,Chow; Bennett,1,0,30,29
1649960080649,MATH 142A,B01,083221,Chow; Bennett,0,2,30,30
1649960080649,MATH 142A,B02,083222,Chow; Bennett,0,1,30,30
1649960086673,MATH 193A,A01,083224,Staff,0,5,30,30
1649960086673,MATH 193A,A02,083225,Staff,0,3,30,30
1649960086673,MATH 193A,A03,083781,Staff,2,0,30,28
1649960086673,MATH 193A,A04,083782,Staff,13,0,30,17
1649960092702,MATH 197,001,091859,McAuley; Julian John,9999,0,9999,0
1649960098778,COGS 9,A01,083615,Staff,11,0,60,49
1649960104905,COGS 11,A01,083617,Boyle; Mary E. T.,34,0,40,6
1649960110930,COGS 13,A01,083071,Staff,0,17,40,40
1649960116973,COGS 14A,A01,092681,Staff,55,0,100,45
1649960122998,COGS 14B,A01,083073,Cheng; Tzu-Han,16,0,50,34
1649960129028,COGS 17,A01,092677,Staff,59,0,75,16
1649960135062,COGS 100,A01,083619,Staff,1,12,60,59
1649960141092,COGS 101A,A01,083621,Davis; Joshua Daniel,0,13,60,60
1649960147116,COGS 101B,A01,091572,Staff,26,0,60,34
1649960153146,COGS 101C,A01,083625,Delgado; Tania,22,0,30,8
1649960159184,COGS 107A,A01,083627,Boyle; Mary E. T.,6,0,60,54
1649960165219,COGS 118A,A01,083075,Staff,21,0,60,39
1649960171261,CSE 3,A50,083646,Miranda; Gregory Joseph,24,0,38,14
1649960171261,CSE 3,A51,083647,Miranda; Gregory Joseph,37,0,37,0
1649960177289,CSE 8A,A50,083650,Miranda; Gregory Joseph,1,0,40,39
1649960183321,CSE 11,A01,083080,Cao; Yingjun,0,34,40,40
1649960189356,CSE 12,A01,083652,Staff,42,0,100,58
1649960195379,CSE 15L,A01,083654,Staff,8,0,50,42
1649960195379,CSE 15L,A02,083655,Staff,45,0,50,5
1649960201411,CSE 20,A01,083657,Staff,65,0,80,15
1649960207438,CSE 30,A01,083084,Eldon; John,0,33,40,40
1649960213465,CSE 100,A01,083659,Cao; Yingjun,1,38,50,49
1649960219490,CSE 134B,A01,083661,Powell; Thomas Allan,0,23,65,65
1649960225528,CSE 140,A01,083663,Staff,15,0,75,60
1649960231566,CSE 140L,A01,083088,Eldon; John,12,0,75,63
1649960237618,CSE 175,A01,083665,Kumar; Rakesh,11,0,25,14
1649960243648,CSE 190,A00,092507,Dubnov; Shlomo,13,0,15,2
1649960249675,ECE 45,A01,083139,Staff,2,0,40,38
1649960255697,ECE 65,A50,083695,Staff,4,0,30,26
1649960261724,ECE 109,A01,091882,Touri; Behrouz,52,0,70,18
1649960267749,ECE 180,A00,083140,Abi Samra; Nicholas Camill,26,0,30,4
1649960267749,ECE 180,B00,083141,Abi Samra; Nicholas Camill,13,0,30,17
1649960273778,MATH 10A,A01,083735,Patchell; Gregory David,19,0,30,11
1649960273778,MATH 10A,A02,083736,Patchell; Gregory David,28,0,30,2
1649960273778,MATH 10A,A03,083737,Patchell; Gregory David,28,0,30,2
1649960279823,MATH 10B,A01,083207,Staff,9,0,30,21
1649960279823,MATH 10B,A02,083208,Staff,25,0,30,5
1649960279823,MATH 10B,B01,083739,Staff,25,0,30,5
1649960279823,MATH 10B,B02,083740,Staff,30,0,30,0
1649960285879,MATH 18,A01,083743,Staff,20,0,30,10
1649960285879,MATH 18,A02,083744,Staff,29,0,30,1
1649960285879,MATH 18,A03,083745,Staff,29,0,30,1
1649960285879,MATH 18,A04,083746,Staff,27,0,30,3
1649960285879,MATH 18,B01,083748,Staff,0,0,30,30
1649960285879,MATH 18,B02,083749,Staff,23,0,30,7
1649960285879,MATH 18,B03,083750,Staff,26,0,30,4
1649960285879,MATH 18,B04,083751,Staff,23,0,30,7
1649960291909,MATH 20A,A01,083754,Staff,36,0,40,4
1649960297958,MATH 20B,A01,083756,Staff,17,0,30,13
1649960297958,MATH 20B,A02,083757,Staff,30,0,30,0
1649960303981,MATH 20C,A01,083760,Staff,16,0,30,14
1649960303981,MATH 20C,A02,083761,Staff,14,0,30,16
1649960303981,MATH 20C,B01,083762,Staff,27,0,30,3
1649960303981,MATH 20C,B02,083763,Staff,30,0,30,0
1649960310009,MATH 20D,A01,083765,Staff,14,0,30,16
1649960310009,MATH 20D,A02,083766,Staff,30,0,30,0
1649960310009,MATH 20D,A03,083767,Staff,29,0,30,1
1649960316037,MATH 20E,A01,083771,Staff,11,0,30,19
1649960316037,MATH 20E,A02,083772,Staff,24,0,30,6
1649960316037,MATH 20E,B01,083773,Staff,11,0,30,19
1649960316037,MATH 20E,B02,083774,Staff,29,0,30,1
1649960322063,MATH 103A,A01,083777,Staff,1,5,30,29
1649960322063,MATH 103A,A02,083778,Staff,0,4,30,30
1649960322063,MATH 103A,B01,083779,Staff,0,1,30,30
1649960322063,MATH 103A,B02,083780,Staff,10,0,30,20
1649960328085,MATH 105,A01,085443,Staff,0,7,30,30
1649960334114,MATH 109,A01,083213,Anzaldo; Leesa B,8,0,30,22
1649960334114,MATH 109,A02,083214,Anzaldo; Leesa B,5,0,30,25
1649960334114,MATH 109,B01,083215,Anzaldo; Leesa B,25,0,30,5
1649960334114,MATH 109,B02,083216,Anzaldo; Leesa B,18,0,30,12
1649960340138,MATH 142A,A01,083219,Chow; Bennett,0,3,30,30
1649960340138,MATH 142A,A02,083220,Chow; Bennett,1,0,30,29
1649960340138,MATH 142A,B01,083221,Chow; Bennett,0,2,30,30
1649960340138,MATH 142A,B02,083222,Chow; Bennett,0,1,30,30
1649960346180,MATH 193A,A01,083224,Staff,0,5,30,30
1649960346180,MATH 193A,A02,083225,Staff,0,3,30,30
1649960346180,MATH 193A,A03,083781,Staff,2,0,30,28
1649960346180,MATH 193A,A04,083782,Staff,13,0,30,17
1649960352205,MATH 197,001,091859,McAuley; Julian John,9999,0,9999,0
1649960358272,COGS 9,A01,083615,Staff,11,0,60,49
1649960364296,COGS 11,A01,083617,Boyle; Mary E. T.,34,0,40,6
1649960370319,COGS 13,A01,083071,Staff,0,17,40,40
1649960376359,COGS 14A,A01,092681,Staff,54,0,100,46
1649960382409,COGS 14B,A01,083073,Cheng; Tzu-Han,16,0,50,34
1649960388437,COGS 17,A01,092677,Staff,59,0,75,16
1649960394461,COGS 100,A01,083619,Staff,1,12,60,59
1649960400500,COGS 101A,A01,083621,Davis; Joshua Daniel,0,13,60,60
1649960406526,COGS 101B,A01,091572,Staff,26,0,60,34
1649960412560,COGS 101C,A01,083625,Delgado; Tania,22,0,30,8
1649960418612,COGS 107A,A01,083627,Boyle; Mary E. T.,6,0,60,54
1649960424652,COGS 118A,A01,083075,Staff,21,0,60,39
1649960430687,CSE 3,A50,083646,Miranda; Gregory Joseph,24,0,38,14
1649960430687,CSE 3,A51,083647,Miranda; Gregory Joseph,37,0,37,0
1649960436710,CSE 8A,A50,083650,Miranda; Gregory Joseph,1,0,40,39
1649960442733,CSE 11,A01,083080,Cao; Yingjun,0,34,40,40
1649960448761,CSE 12,A01,083652,Staff,42,0,100,58
1649960454796,CSE 15L,A01,083654,Staff,8,0,50,42
1649960454796,CSE 15L,A02,083655,Staff,45,0,50,5
1649960460843,CSE 20,A01,083657,Staff,65,0,80,15
1649960466866,CSE 30,A01,083084,Eldon; John,0,33,40,40
1649960472889,CSE 100,A01,083659,Cao; Yingjun,1,38,50,49
1649960478910,CSE 134B,A01,083661,Powell; Thomas Allan,0,23,65,65
1649960484935,CSE 140,A01,083663,Staff,15,0,75,60
1649960490966,CSE 140L,A01,083088,Eldon; John,12,0,75,63
1649960497006,CSE 175,A01,083665,Kumar; Rakesh,11,0,25,14
1649960503051,CSE 190,A00,092507,Dubnov; Shlomo,12,0,15,3
1649960509074,ECE 45,A01,083139,Staff,2,0,40,38
1649960515101,ECE 65,A50,083695,Staff,4,0,30,26
1649960521126,ECE 109,A01,091882,Touri; Behrouz,52,0,70,18
1649960527153,ECE 180,A00,083140,Abi Samra; Nicholas Camill,26,0,30,4
1649960527153,ECE 180,B00,083141,Abi Samra; Nicholas Camill,12,0,30,18
1649960533176,MATH 10A,A01,083735,Patchell; Gregory David,19,0,30,11
1649960533176,MATH 10A,A02,083736,Patchell; Gregory David,28,0,30,2
1649960533176,MATH 10A,A03,083737,Patchell; Gregory David,28,0,30,2
1649960539199,MATH 10B,A01,083207,Staff,9,0,30,21
1649960539199,MATH 10B,A02,083208,Staff,25,0,30,5
1649960539199,MATH 10B,B01,083739,Staff,25,0,30,5
1649960539199,MATH 10B,B02,083740,Staff,30,0,30,0
1649960545234,MATH 18,A01,083743,Staff,20,0,30,10
1649960545234,MATH 18,A02,083744,Staff,29,0,30,1
1649960545234,MATH 18,A03,083745,Staff,29,0,30,1
1649960545234,MATH 18,A04,083746,Staff,27,0,30,3
1649960545234,MATH 18,B01,083748,Staff,0,0,30,30
1649960545234,MATH 18,B02,083749,Staff,23,0,30,7
1649960545234,MATH 18,B03,083750,Staff,26,0,30,4
1649960545234,MATH 18,B04,083751,Staff,23,0,30,7
1649960551258,MATH 20A,A01,083754,Staff,36,0,40,4
1649960557283,MATH 20B,A01,083756,Staff,17,0,30,13
1649960557283,MATH 20B,A02,083757,Staff,30,0,30,0
1649960563324,MATH 20C,A01,083760,Staff,16,0,30,14
1649960563324,MATH 20C,A02,083761,Staff,14,0,30,16
1649960563324,MATH 20C,B01,083762,Staff,27,0,30,3
1649960563324,MATH 20C,B02,083763,Staff,30,0,30,0
1649960569352,MATH 20D,A01,083765,Staff,14,0,30,16
1649960569352,MATH 20D,A02,083766,Staff,30,0,30,0
1649960569352,MATH 20D,A03,083767,Staff,29,0,30,1
1649960575376,MATH 20E,A01,083771,Staff,11,0,30,19
1649960575376,MATH 20E,A02,083772,Staff,24,0,30,6
1649960575376,MATH 20E,B01,083773,Staff,11,0,30,19
1649960575376,MATH 20E,B02,083774,Staff,29,0,30,1
1649960581399,MATH 103A,A01,083777,Staff,1,5,30,29
1649960581399,MATH 103A,A02,083778,Staff,0,4,30,30
1649960581399,MATH 103A,B01,083779,Staff,0,1,30,30
1649960581399,MATH 103A,B02,083780,Staff,10,0,30,20
1649960587421,MATH 105,A01,085443,Staff,0,7,30,30
1649960593444,MATH 109,A01,083213,Anzaldo; Leesa B,7,0,30,23
1649960593444,MATH 109,A02,083214,Anzaldo; Leesa B,5,0,30,25
1649960593444,MATH 109,B01,083215,Anzaldo; Leesa B,24,0,30,6
1649960593444,MATH 109,B02,083216,Anzaldo; Leesa B,18,0,30,12
1649960599490,MATH 142A,A01,083219,Chow; Bennett,0,3,30,30
1649960599490,MATH 142A,A02,083220,Chow; Bennett,1,0,30,29
1649960599490,MATH 142A,B01,083221,Chow; Bennett,0,2,30,30
1649960599490,MATH 142A,B02,083222,Chow; Bennett,0,1,30,30
1649960605522,MATH 193A,A01,083224,Staff,0,5,30,30
1649960605522,MATH 193A,A02,083225,Staff,0,3,30,30
1649960605522,MATH 193A,A03,083781,Staff,2,0,30,28
1649960605522,MATH 193A,A04,083782,Staff,13,0,30,17
1649960611564,MATH 197,001,091859,McAuley; Julian John,9999,0,9999,0
1649960617614,COGS 9,A01,083615,Staff,10,0,60,50
1649960623668,COGS 11,A01,083617,Boyle; Mary E. T.,34,0,40,6
1649960629691,COGS 13,A01,083071,Staff,0,18,40,40
1649960635724,COGS 14A,A01,092681,Staff,53,0,100,47
1649960641761,COGS 14B,A01,083073,Cheng; Tzu-Han,16,0,50,34
1649960647792,COGS 17,A01,092677,Staff,59,0,75,16
1649960653824,COGS 100,A01,083619,Staff,1,12,60,59
1649960659847,COGS 101A,A01,083621,Davis; Joshua Daniel,0,12,60,60
1649960665872,COGS 101B,A01,091572,Staff,26,0,60,34
1649960671921,COGS 101C,A01,083625,Delgado; Tania,22,0,30,8
1649960677948,COGS 107A,A01,083627,Boyle; Mary E. T.,6,0,60,54
1649960683972,COGS 118A,A01,083075,Staff,21,0,60,39
1649960689999,CSE 3,A50,083646,Miranda; Gregory Joseph,24,0,38,14
1649960689999,CSE 3,A51,083647,Miranda; Gregory Joseph,37,0,37,0
1649960696028,CSE 8A,A50,083650,Miranda; Gregory Joseph,1,0,40,39
1649960702145,CSE 11,A01,083080,Cao; Yingjun,0,33,40,40
1649960708185,CSE 12,A01,083652,Staff,41,0,100,59
1649960714211,CSE 15L,A01,083654,Staff,7,0,50,43
1649960714211,CSE 15L,A02,083655,Staff,45,0,50,5
1649960720239,CSE 20,A01,083657,Staff,65,0,80,15
1649960726276,CSE 30,A01,083084,Eldon; John,0,34,40,40
1649960732307,CSE 100,A01,083659,Cao; Yingjun,1,40,50,49
1649960738330,CSE 134B,A01,083661,Powell; Thomas Allan,0,23,65,65
1649960744355,CSE 140,A01,083663,Staff,15,0,75,60
1649960750381,CSE 140L,A01,083088,Eldon; John,12,0,75,63
1649960756410,CSE 175,A01,083665,Kumar; Rakesh,11,0,25,14
1649960762434,CSE 190,A00,092507,Dubnov; Shlomo,12,0,15,3
1649960768462,ECE 45,A01,083139,Staff,2,0,40,38
1649960774485,ECE 65,A50,083695,Staff,4,0,30,26
1649960780531,ECE 109,A01,091882,Touri; Behrouz,52,0,70,18
1649960786554,ECE 180,A00,083140,Abi Samra; Nicholas Camill,26,0,30,4
1649960786554,ECE 180,B00,083141,Abi Samra; Nicholas Camill,12,0,30,18
1649960792587,MATH 10A,A01,083735,Patchell; Gregory David,19,0,30,11
1649960792587,MATH 10A,A02,083736,Patchell; Gregory David,28,0,30,2
1649960792587,MATH 10A,A03,083737,Patchell; Gregory David,28,0,30,2
1649960798613,MATH 10B,A01,083207,Staff,8,0,30,22
1649960798613,MATH 10B,A02,083208,Staff,25,0,30,5
1649960798613,MATH 10B,B01,083739,Staff,25,0,30,5
1649960798613,MATH 10B,B02,083740,Staff,30,0,30,0
1649960804656,MATH 18,A01,083743,Staff,20,0,30,10
1649960804656,MATH 18,A02,083744,Staff,29,0,30,1
1649960804656,MATH 18,A03,083745,Staff,29,0,30,1
1649960804656,MATH 18,A04,083746,Staff,27,0,30,3
1649960804656,MATH 18,B01,083748,Staff,0,0,30,30
1649960804656,MATH 18,B02,083749,Staff,22,0,30,8
1649960804656,MATH 18,B03,083750,Staff,26,0,30,4
1649960804656,MATH 18,B04,083751,Staff,23,0,30,7
1649960810688,MATH 20A,A01,083754,Staff,36,0,40,4
1649960816716,MATH 20B,A01,083756,Staff,17,0,30,13
1649960816716,MATH 20B,A02,083757,Staff,30,0,30,0
1649960822744,MATH 20C,A01,083760,Staff,16,0,30,14
1649960822744,MATH 20C,A02,083761,Staff,14,0,30,16
1649960822744,MATH 20C,B01,083762,Staff,27,0,30,3
1649960822744,MATH 20C,B02,083763,Staff,30,0,30,0
1649960828775,MATH 20D,A01,083765,Staff,14,0,30,16
1649960828775,MATH 20D,A02,083766,Staff,30,0,30,0
1649960828775,MATH 20D,A03,083767,Staff,29,0,30,1
1649960834813,MATH 20E,A01,083771,Staff,11,0,30,19
1649960834813,MATH 20E,A02,083772,Staff,24,0,30,6
1649960834813,MATH 20E,B01,083773,Staff,11,0,30,19
1649960834813,MATH 20E,B02,083774,Staff,29,0,30,1
1649960840845,MATH 103A,A01,083777,Staff,1,5,30,29
1649960840845,MATH 103A,A02,083778,Staff,0,4,30,30
1649960840845,MATH 103A,B01,083779,Staff,0,1,30,30
1649960840845,MATH 103A,B02,083780,Staff,9,0,30,21
1649960846902,MATH 105,A01,085443,Staff,0,7,30,30
1649960852959,MATH 109,A01,083213,Anzaldo; Leesa B,7,0,30,23
1649960852959,MATH 109,A02,083214,Anzaldo; Leesa B,5,0,30,25
1649960852959,MATH 109,B01,083215,Anzaldo; Leesa B,23,0,30,7
1649960852959,MATH 109,B02,083216,Anzaldo; Leesa B,18,0,30,12
1649960858985,MATH 142A,A01,083219,Chow; Bennett,0,3,30,30
1649960858985,MATH 142A,A02,083220,Chow; Bennett,0,0,30,30
1649960858985,MATH 142A,B01,083221,Chow; Bennett,0,2,30,30
1649960858985,MATH 142A,B02,083222,Chow; Bennett,0,1,30,30
1649960865007,MATH 193A,A01,083224,Staff,0,5,30,30
1649960865007,MATH 193A,A02,083225,Staff,0,3,30,30
1649960865007,MATH 193A,A03,083781,Staff,2,0,30,28
1649960865007,MATH 193A,A04,083782,Staff,13,0,30,17
1649960871049,MATH 197,001,091859,McAuley; Julian John,9999,0,9999,0
1649960877113,COGS 9,A01,083615,Staff,10,0,60,50
1649960883137,COGS 11,A01,083617,Boyle; Mary E. T.,34,0,40,6
1649960889161,COGS 13,A01,083071,Staff,0,18,40,40
1649960895186,COGS 14A,A01,092681,Staff,52,0,100,48
1649960901239,COGS 14B,A01,083073,Cheng; Tzu-Han,16,0,50,34
1649960907261,COGS 17,A01,092677,Staff,59,0,75,16
1649960913285,COGS 100,A01,083619,Staff,1,12,60,59
1649960919311,COGS 101A,A01,083621,Davis; Joshua Daniel,0,12,60,60
1649960925335,COGS 101B,A01,091572,Staff,26,0,60,34
1649960931364,COGS 101C,A01,083625,Delgado; Tania,22,0,30,8
1649960937389,COGS 107A,A01,083627,Boyle; Mary E. T.,6,0,60,54
1649960943413,COGS 118A,A01,083075,Staff,21,0,60,39
1649960949446,CSE 3,A50,083646,Miranda; Gregory Joseph,24,0,38,14
1649960949446,CSE 3,A51,083647,Miranda; Gregory Joseph,37,0,37,0
1649960955480,CSE 8A,A50,083650,Miranda; Gregory Joseph,1,0,40,39
1649960961503,CSE 11,A01,083080,Cao; Yingjun,0,34,40,40
1649960967544,CSE 12,A01,083652,Staff,41,0,100,59
1649960973593,CSE 15L,A01,083654,Staff,7,0,50,43
1649960973593,CSE 15L,A02,083655,Staff,45,0,50,5
1649960979618,CSE 20,A01,083657,Staff,65,0,80,15
1649960985645,CSE 30,A01,083084,Eldon; John,0,34,40,40
1649960991673,CSE 100,A01,083659,Cao; Yingjun,1,41,50,49
1649960997697,CSE 134B,A01,083661,Powell; Thomas Allan,0,23,65,65
1649961003726,CSE 140,A01,083663,Staff,15,0,75,60
1649961009753,CSE 140L,A01,083088,Eldon; John,12,0,75,63
1649961015781,CSE 175,A01,083665,Kumar; Rakesh,11,0,25,14
1649961021805,CSE 190,A00,092507,Dubnov; Shlomo,12,0,15,3
1649961027832,ECE 45,A01,083139,Staff,1,0,40,39
1649961033861,ECE 65,A50,083695,Staff,4,0,30,26
1649961039913,ECE 109,A01,091882,Touri; Behrouz,52,0,70,18
1649961045956,ECE 180,A00,083140,Abi Samra; Nicholas Camill,26,0,30,4
1649961045956,ECE 180,B00,083141,Abi Samra; Nicholas Camill,12,0,30,18
1649961051982,MATH 10A,A01,083735,Patchell; Gregory David,19,0,30,11
1649961051982,MATH 10A,A02,083736,Patchell; Gregory David,28,0,30,2
1649961051982,MATH 10A,A03,083737,Patchell; Gregory David,28,0,30,2
1649961058006,MATH 10B,A01,083207,Staff,7,0,30,23
1649961058006,MATH 10B,A02,083208,Staff,25,0,30,5
1649961058006,MATH 10B,B01,083739,Staff,25,0,30,5
1649961058006,MATH 10B,B02,083740,Staff,30,0,30,0
1649961064038,MATH 18,A01,083743,Staff,20,0,30,10
1649961064038,MATH 18,A02,083744,Staff,29,0,30,1
1649961064038,MATH 18,A03,083745,Staff,29,0,30,1
1649961064038,MATH 18,A04,083746,Staff,27,0,30,3
1649961064038,MATH 18,B01,083748,Staff,0,0,30,30
1649961064038,MATH 18,B02,083749,Staff,22,0,30,8
1649961064038,MATH 18,B03,083750,Staff,26,0,30,4
1649961064038,MATH 18,B04,083751,Staff,23,0,30,7
1649961070071,MATH 20A,A01,083754,Staff,36,0,40,4
1649961076098,MATH 20B,A01,083756,Staff,17,0,30,13
1649961076098,MATH 20B,A02,083757,Staff,30,0,30,0
1649961082128,MATH 20C,A01,083760,Staff,16,0,30,14
1649961082128,MATH 20C,A02,083761,Staff,14,0,30,16
1649961082128,MATH 20C,B01,083762,Staff,27,0,30,3
1649961082128,MATH 20C,B02,083763,Staff,30,0,30,0
1649961088155,MATH 20D,A01,083765,Staff,14,0,30,16
1649961088155,MATH 20D,A02,083766,Staff,30,0,30,0
1649961088155,MATH 20D,A03,083767,Staff,29,0,30,1
1649961094182,MATH 20E,A01,083771,Staff,11,0,30,19
1649961094182,MATH 20E,A02,083772,Staff,24,0,30,6
1649961094182,MATH 20E,B01,083773,Staff,11,0,30,19
1649961094182,MATH 20E,B02,083774,Staff,29,0,30,1
1649961100223,MATH 103A,A01,083777,Staff,1,5,30,29
1649961100223,MATH 103A,A02,083778,Staff,0,4,30,30
1649961100223,MATH 103A,B01,083779,Staff,0,1,30,30
1649961100223,MATH 103A,B02,083780,Staff,8,0,30,22
1649961106253,MATH 105,A01,085443,Staff,0,7,30,30
1649961112279,MATH 109,A01,083213,Anzaldo; Leesa B,7,0,30,23
1649961112279,MATH 109,A02,083214,Anzaldo; Leesa B,5,0,30,25
1649961112279,MATH 109,B01,083215,Anzaldo; Leesa B,23,0,30,7
1649961112279,MATH 109,B02,083216,Anzaldo; Leesa B,18,0,30,12
1649961118303,MATH 142A,A01,083219,Chow; Bennett,0,3,30,30
1649961118303,MATH 142A,A02,083220,Chow; Bennett,0,2,30,30
1649961118303,MATH 142A,B01,083221,Chow; Bennett,0,2,30,30
1649961118303,MATH 142A,B02,083222,Chow; Bennett,0,1,30,30
1649961124329,MATH 193A,A01,083224,Staff,0,5,30,30
1649961124329,MATH 193A,A02,083225,Staff,0,3,30,30
1649961124329,MATH 193A,A03,083781,Staff,2,0,30,28
1649961124329,MATH 193A,A04,083782,Staff,13,0,30,17
1649961130355,MATH 197,001,091859,McAuley; Julian John,9999,0,9999,0
1649961136418,COGS 9,A01,083615,Staff,10,0,60,50
1649961142458,COGS 11,A01,083617,Boyle; Mary E. T.,34,0,40,6
1649961148486,COGS 13,A01,083071,Staff,0,18,40,40
1649961154538,COGS 14A,A01,092681,Staff,52,0,100,48
1649961160586,COGS 14B,A01,083073,Cheng; Tzu-Han,16,0,50,34
1649961166611,COGS 17,A01,092677,Staff,59,0,75,16
1649961172637,COGS 100,A01,083619,Staff,1,12,60,59
1649961178663,COGS 101A,A01,083621,Davis; Joshua Daniel,0,12,60,60
1649961184703,COGS 101B,A01,091572,Staff,26,0,60,34
1649961190739,COGS 101C,A01,083625,Delgado; Tania,22,0,30,8
1649961196766,COGS 107A,A01,083627,Boyle; Mary E. T.,6,0,60,54
1649961202807,COGS 118A,A01,083075,Staff,21,0,60,39
1649961208831,CSE 3,A50,083646,Miranda; Gregory Joseph,24,0,38,14
1649961208831,CSE 3,A51,083647,Miranda; Gregory Joseph,37,0,37,0
1649961214859,CSE 8A,A50,083650,Miranda; Gregory Joseph,1,0,40,39
1649961220883,CSE 11,A01,083080,Cao; Yingjun,0,34,40,40
1649961226934,CSE 12,A01,083652,Staff,41,0,100,59
1649961232992,CSE 15L,A01,083654,Staff,7,0,50,43
1649961232992,CSE 15L,A02,083655,Staff,45,0,50,5
1649961239016,CSE 20,A01,083657,Staff,65,0,80,15
1649961245038,CSE 30,A01,083084,Eldon; John,0,35,40,40
1649961251068,CSE 100,A01,083659,Cao; Yingjun,1,41,50,49
1649961257105,CSE 134B,A01,083661,Powell; Thomas Allan,0,23,65,65
1649961263128,CSE 140,A01,083663,Staff,15,0,75,60
1649961269160,CSE 140L,A01,083088,Eldon; John,12,0,75,63
1649961275199,CSE 175,A01,083665,Kumar; Rakesh,11,0,25,14
1649961281239,CSE 190,A00,092507,Dubnov; Shlomo,12,0,15,3
1649961287267,ECE 45,A01,083139,Staff,0,0,40,40
1649961293291,ECE 65,A50,083695,Staff,4,0,30,26
1649961299396,ECE 109,A01,091882,Touri; Behrouz,52,0,70,18
1649961305421,ECE 180,A00,083140,Abi Samra; Nicholas Camill,26,0,30,4
1649961305421,ECE 180,B00,083141,Abi Samra; Nicholas Camill,12,0,30,18
1649961311444,MATH 10A,A01,083735,Patchell; Gregory David,19,0,30,11
1649961311444,MATH 10A,A02,083736,Patchell; Gregory David,28,0,30,2
1649961311444,MATH 10A,A03,083737,Patchell; Gregory David,28,0,30,2
1649961317473,MATH 10B,A01,083207,Staff,7,0,30,23
1649961317473,MATH 10B,A02,083208,Staff,25,0,30,5
1649961317473,MATH 10B,B01,083739,Staff,25,0,30,5
1649961317473,MATH 10B,B02,083740,Staff,30,0,30,0
1649961323507,MATH 18,A01,083743,Staff,20,0,30,10
1649961323507,MATH 18,A02,083744,Staff,29,0,30,1
1649961323507,MATH 18,A03,083745,Staff,29,0,30,1
1649961323507,MATH 18,A04,083746,Staff,27,0,30,3
1649961323507,MATH 18,B01,083748,Staff,0,0,30,30
1649961323507,MATH 18,B02,083749,Staff,21,0,30,9
1649961323507,MATH 18,B03,083750,Staff,26,0,30,4
1649961323507,MATH 18,B04,083751,Staff,23,0,30,7
1649961329529,MATH 20A,A01,083754,Staff,36,0,40,4
1649961335554,MATH 20B,A01,083756,Staff,17,0,30,13
1649961335554,MATH 20B,A02,083757,Staff,30,0,30,0
1649961341603,MATH 20C,A01,083760,Staff,16,0,30,14
1649961341603,MATH 20C,A02,083761,Staff,13,0,30,17
1649961341603,MATH 20C,B01,083762,Staff,27,0,30,3
1649961341603,MATH 20C,B02,083763,Staff,30,0,30,0
1649961347638,MATH 20D,A01,083765,Staff,14,0,30,16
1649961347638,MATH 20D,A02,083766,Staff,30,0,30,0
1649961347638,MATH 20D,A03,083767,Staff,29,0,30,1
1649961353666,MATH 20E,A01,083771,Staff,11,0,30,19
1649961353666,MATH 20E,A02,083772,Staff,24,0,30,6
1649961353666,MATH 20E,B01,083773,Staff,11,0,30,19
1649961353666,MATH 20E,B02,083774,Staff,29,0,30,1
1649961359694,MATH 103A,A01,083777,Staff,1,5,30,29
1649961359694,MATH 103A,A02,083778,Staff,0,4,30,30
1649961359694,MATH 103A,B01,083779,Staff,0,1,30,30
1649961359694,MATH 103A,B02,083780,Staff,8,0,30,22
1649961365723,MATH 105,A01,085443,Staff,0,7,30,30
1649961371747,MATH 109,A01,083213,Anzaldo; Leesa B,7,0,30,23
1649961371747,MATH 109,A02,083214,Anzaldo; Leesa B,4,0,30,26
1649961371747,MATH 109,B01,083215,Anzaldo; Leesa B,23,0,30,7
1649961371747,MATH 109,B02,083216,Anzaldo; Leesa B,18,0,30,12
1649961377777,MATH 142A,A01,083219,Chow; Bennett,0,3,30,30
1649961377777,MATH 142A,A02,083220,Chow; Bennett,0,2,30,30
1649961377777,MATH 142A,B01,083221,Chow; Bennett,0,2,30,30
1649961377777,MATH 142A,B02,083222,Chow; Bennett,0,1,30,30
1649961383816,MATH 193A,A01,083224,Staff,0,5,30,30
1649961383816,MATH 193A,A02,083225,Staff,0,3,30,30
1649961383816,MATH 193A,A03,083781,Staff,2,0,30,28
1649961383816,MATH 193A,A04,083782,Staff,13,0,30,17
1649961389842,MATH 197,001,091859,McAuley; Julian John,9999,0,9999,0
1649961395893,COGS 9,A01,083615,Staff,10,0,60,50
1649961401926,COGS 11,A01,083617,Boyle; Mary E. T.,34,0,40,6
1649961407953,COGS 13,A01,083071,Staff,0,18,40,40
1649961413979,COGS 14A,A01,092681,Staff,52,0,100,48
1649961420027,COGS 14B,A01,083073,Cheng; Tzu-Han,16,0,50,34
1649961426060,COGS 17,A01,092677,Staff,59,0,75,16
1649961432086,COGS 100,A01,083619,Staff,1,12,60,59
1649961438114,COGS 101A,A01,083621,Davis; Joshua Daniel,0,12,60,60
1649961444157,COGS 101B,A01,091572,Staff,26,0,60,34
1649961450180,COGS 101C,A01,083625,Delgado; Tania,22,0,30,8
1649961456203,COGS 107A,A01,083627,Boyle; Mary E. T.,5,0,60,55
1649961462235,COGS 118A,A01,083075,Staff,21,0,60,39
1649961468261,CSE 3,A50,083646,Miranda; Gregory Joseph,24,0,38,14
1649961468261,CSE 3,A51,083647,Miranda; Gregory Joseph,37,0,37,0
1649961474296,CSE 8A,A50,083650,Miranda; Gregory Joseph,1,0,40,39
1649961480341,CSE 11,A01,083080,Cao; Yingjun,0,34,40,40
1649961486369,CSE 12,A01,083652,Staff,41,0,100,59
1649961492390,CSE 15L,A01,083654,Staff,7,0,50,43
1649961492390,CSE 15L,A02,083655,Staff,45,0,50,5
1649961498414,CSE 20,A01,083657,Staff,65,0,80,15
1649961504441,CSE 30,A01,083084,Eldon; John,0,35,40,40
1649961510468,CSE 100,A01,083659,Cao; Yingjun,1,41,50,49
1649961516495,CSE 134B,A01,083661,Powell; Thomas Allan,0,23,65,65
1649961522518,CSE 140,A01,083663,Staff,15,0,75,60
1649961528558,CSE 140L,A01,083088,Eldon; John,12,0,75,63
1649961534590,CSE 175,A01,083665,Kumar; Rakesh,11,0,25,14
1649961540617,CSE 190,A00,092507,Dubnov; Shlomo,12,0,15,3
1649961546643,ECE 45,A01,083139,Staff,0,0,40,40
1649961552683,ECE 65,A50,083695,Staff,4,0,30,26
1649961558708,ECE 109,A01,091882,Touri; Behrouz,52,0,70,18
1649961564735,ECE 180,A00,083140,Abi Samra; Nicholas Camill,26,0,30,4
1649961564735,ECE 180,B00,083141,Abi Samra; Nicholas Camill,12,0,30,18
1649961570758,MATH 10A,A01,083735,Patchell; Gregory David,19,0,30,11
1649961570758,MATH 10A,A02,083736,Patchell; Gregory David,28,0,30,2
1649961570758,MATH 10A,A03,083737,Patchell; Gregory David,28,0,30,2
1649961576783,MATH 10B,A01,083207,Staff,7,0,30,23
1649961576783,MATH 10B,A02,083208,Staff,25,0,30,5
1649961576783,MATH 10B,B01,083739,Staff,25,0,30,5
1649961576783,MATH 10B,B02,083740,Staff,30,0,30,0
1649961582816,MATH 18,A01,083743,Staff,20,0,30,10
1649961582816,MATH 18,A02,083744,Staff,29,0,30,1
1649961582816,MATH 18,A03,083745,Staff,29,0,30,1
1649961582816,MATH 18,A04,083746,Staff,27,0,30,3
1649961582816,MATH 18,B01,083748,Staff,0,0,30,30
1649961582816,MATH 18,B02,083749,Staff,21,0,30,9
1649961582816,MATH 18,B03,083750,Staff,26,0,30,4
1649961582816,MATH 18,B04,083751,Staff,23,0,30,7
1649961588850,MATH 20A,A01,083754,Staff,36,0,40,4
1649961594889,MATH 20B,A01,083756,Staff,17,0,30,13
1649961594889,MATH 20B,A02,083757,Staff,30,0,30,0
1649961600920,MATH 20C,A01,083760,Staff,16,0,30,14
1649961600920,MATH 20C,A02,083761,Staff,13,0,30,17
1649961600920,MATH 20C,B01,083762,Staff,27,0,30,3
1649961600920,MATH 20C,B02,083763,Staff,30,0,30,0
1649961606943,MATH 20D,A01,083765,Staff,14,0,30,16
1649961606943,MATH 20D,A02,083766,Staff,30,0,30,0
1649961606943,MATH 20D,A03,083767,Staff,29,0,30,1
1649961612990,MATH 20E,A01,083771,Staff,11,0,30,19
1649961612990,MATH 20E,A02,083772,Staff,24,0,30,6
1649961612990,MATH 20E,B01,083773,Staff,11,0,30,19
1649961612990,MATH 20E,B02,083774,Staff,29,0,30,1
1649961619019,MATH 103A,A01,083777,Staff,1,5,30,29
1649961619019,MATH 103A,A02,083778,Staff,0,4,30,30
1649961619019,MATH 103A,B01,083779,Staff,0,1,30,30
1649961619019,MATH 103A,B02,083780,Staff,8,0,30,22
1649961625071,MATH 105,A01,085443,Staff,0,8,30,30
1649961631095,MATH 109,A01,083213,Anzaldo; Leesa B,7,0,30,23
1649961631095,MATH 109,A02,083214,Anzaldo; Leesa B,4,0,30,26
1649961631095,MATH 109,B01,083215,Anzaldo; Leesa B,23,0,30,7
1649961631095,MATH 109,B02,083216,Anzaldo; Leesa B,18,0,30,12
1649961637119,MATH 142A,A01,083219,Chow; Bennett,0,3,30,30
1649961637119,MATH 142A,A02,083220,Chow; Bennett,0,2,30,30
1649961637119,MATH 142A,B01,083221,Chow; Bennett,0,2,30,30
1649961637119,MATH 142A,B02,083222,Chow; Bennett,0,1,30,30
1649961643146,MATH 193A,A01,083224,Staff,0,5,30,30
1649961643146,MATH 193A,A02,083225,Staff,0,3,30,30
1649961643146,MATH 193A,A03,083781,Staff,2,0,30,28
1649961643146,MATH 193A,A04,083782,Staff,13,0,30,17
1649961649178,MATH 197,001,091859,McAuley; Julian John,9999,0,9999,0
1649961655233,COGS 9,A01,083615,Staff,10,0,60,50
1649961661258,COGS 11,A01,083617,Boyle; Mary E. T.,34,0,40,6
1649961667328,COGS 13,A01,083071,Staff,0,18,40,40
1649961673351,COGS 14A,A01,092681,Staff,52,0,100,48
1649961679392,COGS 14B,A01,083073,Cheng; Tzu-Han,16,0,50,34
1649961685429,COGS 17,A01,092677,Staff,59,0,75,16
1649961691452,COGS 100,A01,083619,Staff,1,12,60,59
1649961697477,COGS 101A,A01,083621,Davis; Joshua Daniel,0,12,60,60
1649961703503,COGS 101B,A01,091572,Staff,26,0,60,34
1649961709526,COGS 101C,A01,083625,Delgado; Tania,22,0,30,8
1649961715553,COGS 107A,A01,083627,Boyle; Mary E. T.,6,0,60,54
1649961721580,COGS 118A,A01,083075,Staff,21,0,60,39
1649961727610,CSE 3,A50,083646,Miranda; Gregory Joseph,24,0,38,14
1649961727610,CSE 3,A51,083647,Miranda; Gregory Joseph,37,0,37,0
1649961733643,CSE 8A,A50,083650,Miranda; Gregory Joseph,1,0,40,39
1649961739670,CSE 11,A01,083080,Cao; Yingjun,0,34,40,40
1649961745693,CSE 12,A01,083652,Staff,41,0,100,59
1649961751729,CSE 15L,A01,083654,Staff,7,0,50,43
1649961751729,CSE 15L,A02,083655,Staff,45,0,50,5
1649961757765,CSE 20,A01,083657,Staff,65,0,80,15
1649961763807,CSE 30,A01,083084,Eldon; John,0,35,40,40
1649961769844,CSE 100,A01,083659,Cao; Yingjun,1,42,50,49
1649961775869,CSE 134B,A01,083661,Powell; Thomas Allan,0,23,65,65
1649961781900,CSE 140,A01,083663,Staff,15,0,75,60
1649961787927,CSE 140L,A01,083088,Eldon; John,12,0,75,63
1649961793949,CSE 175,A01,083665,Kumar; Rakesh,11,0,25,14
1649961799972,CSE 190,A00,092507,Dubnov; Shlomo,12,0,15,3
1649961806009,ECE 45,A01,083139,Staff,0,1,40,40
1649961812050,ECE 65,A50,083695,Staff,4,0,30,26
1649961818073,ECE 109,A01,091882,Touri; Behrouz,52,0,70,18
1649961824110,ECE 180,A00,083140,Abi Samra; Nicholas Camill,26,0,30,4
1649961824110,ECE 180,B00,083141,Abi Samra; Nicholas Camill,12,0,30,18
1649961830143,MATH 10A,A01,083735,Patchell; Gregory David,19,0,30,11
1649961830143,MATH 10A,A02,083736,Patchell; Gregory David,28,0,30,2
1649961830143,MATH 10A,A03,083737,Patchell; Gregory David,28,0,30,2
1649961836169,MATH 10B,A01,083207,Staff,7,0,30,23
1649961836169,MATH 10B,A02,083208,Staff,25,0,30,5
1649961836169,MATH 10B,B01,083739,Staff,25,0,30,5
1649961836169,MATH 10B,B02,083740,Staff,30,0,30,0
1649961842196,MATH 18,A01,083743,Staff,20,0,30,10
1649961842196,MATH 18,A02,083744,Staff,29,0,30,1
1649961842196,MATH 18,A03,083745,Staff,29,0,30,1
1649961842196,MATH 18,A04,083746,Staff,27,0,30,3
1649961842196,MATH 18,B01,083748,Staff,0,0,30,30
1649961842196,MATH 18,B02,083749,Staff,21,0,30,9
1649961842196,MATH 18,B03,083750,Staff,26,0,30,4
1649961842196,MATH 18,B04,083751,Staff,23,0,30,7
1649961848219,MATH 20A,A01,083754,Staff,36,0,40,4
1649961854253,MATH 20B,A01,083756,Staff,17,0,30,13
1649961854253,MATH 20B,A02,083757,Staff,30,0,30,0
1649961860280,MATH 20C,A01,083760,Staff,16,0,30,14
1649961860280,MATH 20C,A02,083761,Staff,13,0,30,17
1649961860280,MATH 20C,B01,083762,Staff,27,0,30,3
1649961860280,MATH 20C,B02,083763,Staff,30,0,30,0
1649961866324,MATH 20D,A01,083765,Staff,14,0,30,16
1649961866324,MATH 20D,A02,083766,Staff,30,0,30,0
1649961866324,MATH 20D,A03,083767,Staff,29,0,30,1
1649961872360,MATH 20E,A01,083771,Staff,11,0,30,19
1649961872360,MATH 20E,A02,083772,Staff,24,0,30,6
1649961872360,MATH 20E,B01,083773,Staff,11,0,30,19
1649961872360,MATH 20E,B02,083774,Staff,29,0,30,1
1649961878389,MATH 103A,A01,083777,Staff,1,5,30,29
1649961878389,MATH 103A,A02,083778,Staff,0,4,30,30
1649961878389,MATH 103A,B01,083779,Staff,0,1,30,30
1649961878389,MATH 103A,B02,083780,Staff,8,0,30,22
1649961884418,MATH 105,A01,085443,Staff,0,8,30,30
1649961890458,MATH 109,A01,083213,Anzaldo; Leesa B,7,0,30,23
1649961890458,MATH 109,A02,083214,Anzaldo; Leesa B,4,0,30,26
1649961890458,MATH 109,B01,083215,Anzaldo; Leesa B,23,0,30,7
1649961890458,MATH 109,B02,083216,Anzaldo; Leesa B,18,0,30,12
1649961896585,MATH 142A,A01,083219,Chow; Bennett,0,3,30,30
1649961896585,MATH 142A,A02,083220,Chow; Bennett,0,2,30,30
1649961896585,MATH 142A,B01,083221,Chow; Bennett,0,2,30,30
1649961896585,MATH 142A,B02,083222,Chow; Bennett,0,1,30,30
1649961902618,MATH 193A,A01,083224,Staff,0,5,30,30
1649961902618,MATH 193A,A02,083225,Staff,0,3,30,30
1649961902618,MATH 193A,A03,083781,Staff,2,0,30,28
1649961902618,MATH 193A,A04,083782,Staff,13,0,30,17
1649961908672,MATH 197,001,091859,McAuley; Julian John,9999,0,9999,0
1649961914738,COGS 9,A01,083615,Staff,9,0,60,51
1649961920777,COGS 11,A01,083617,Boyle; Mary E. T.,34,0,40,6
1649961926810,COGS 13,A01,083071,Staff,0,18,40,40
1649961932844,COGS 14A,A01,092681,Staff,52,0,100,48
1649961938868,COGS 14B,A01,083073,Cheng; Tzu-Han,16,0,50,34
1649961944893,COGS 17,A01,092677,Staff,59,0,75,16
1649961950917,COGS 100,A01,083619,Staff,1,12,60,59
1649961956941,COGS 101A,A01,083621,Davis; Joshua Daniel,0,12,60,60
1649961962964,COGS 101B,A01,091572,Staff,26,0,60,34
1649961968989,COGS 101C,A01,083625,Delgado; Tania,22,0,30,8
1649961975013,COGS 107A,A01,083627,Boyle; Mary E. T.,6,0,60,54
1649961981034,COGS 118A,A01,083075,Staff,21,0,60,39
1649961987084,CSE 3,A50,083646,Miranda; Gregory Joseph,24,0,38,14
1649961987084,CSE 3,A51,083647,Miranda; Gregory Joseph,37,0,37,0
1649961993113,CSE 8A,A50,083650,Miranda; Gregory Joseph,1,0,40,39
1649961999137,CSE 11,A01,083080,Cao; Yingjun,0,34,40,40
1649962005161,CSE 12,A01,083652,Staff,41,0,100,59
1649962011193,CSE 15L,A01,083654,Staff,7,0,50,43
1649962011193,CSE 15L,A02,083655,Staff,45,0,50,5
1649962017218,CSE 20,A01,083657,Staff,65,0,80,15
1649962023241,CSE 30,A01,083084,Eldon; John,0,35,40,40
1649962029269,CSE 100,A01,083659,Cao; Yingjun,1,42,50,49
1649962035300,CSE 134B,A01,083661,Powell; Thomas Allan,0,23,65,65
1649962041332,CSE 140,A01,083663,Staff,15,0,75,60
1649962047373,CSE 140L,A01,083088,Eldon; John,11,0,75,64
1649962053405,CSE 175,A01,083665,Kumar; Rakesh,11,0,25,14
1649962059427,CSE 190,A00,092507,Dubnov; Shlomo,12,0,15,3
1649962065450,ECE 45,A01,083139,Staff,0,1,40,40
1649962071474,ECE 65,A50,083695,Staff,4,0,30,26
1649962077503,ECE 109,A01,091882,Touri; Behrouz,52,0,70,18
1649962083526,ECE 180,A00,083140,Abi Samra; Nicholas Camill,26,0,30,4
1649962083526,ECE 180,B00,083141,Abi Samra; Nicholas Camill,12,0,30,18
1649962089559,MATH 10A,A01,083735,Patchell; Gregory David,19,0,30,11
1649962089559,MATH 10A,A02,083736,Patchell; Gregory David,28,0,30,2
1649962089559,MATH 10A,A03,083737,Patchell; Gregory David,28,0,30,2
1649962095587,MATH 10B,A01,083207,Staff,7,0,30,23
1649962095587,MATH 10B,A02,083208,Staff,25,0,30,5
1649962095587,MATH 10B,B01,083739,Staff,25,0,30,5
1649962095587,MATH 10B,B02,083740,Staff,30,0,30,0
1649962101622,MATH 18,A01,083743,Staff,20,0,30,10
1649962101622,MATH 18,A02,083744,Staff,29,0,30,1
1649962101622,MATH 18,A03,083745,Staff,29,0,30,1
1649962101622,MATH 18,A04,083746,Staff,27,0,30,3
1649962101622,MATH 18,B01,083748,Staff,0,0,30,30
1649962101622,MATH 18,B02,083749,Staff,21,0,30,9
1649962101622,MATH 18,B03,083750,Staff,26,0,30,4
1649962101622,MATH 18,B04,083751,Staff,22,0,30,8
1649962107647,MATH 20A,A01,083754,Staff,36,0,40,4
1649962113674,MATH 20B,A01,083756,Staff,17,0,30,13
1649962113674,MATH 20B,A02,083757,Staff,30,0,30,0
1649962119706,MATH 20C,A01,083760,Staff,16,0,30,14
1649962119706,MATH 20C,A02,083761,Staff,13,0,30,17
1649962119706,MATH 20C,B01,083762,Staff,27,0,30,3
1649962119706,MATH 20C,B02,083763,Staff,30,0,30,0
1649962125733,MATH 20D,A01,083765,Staff,14,0,30,16
1649962125733,MATH 20D,A02,083766,Staff,30,0,30,0
1649962125733,MATH 20D,A03,083767,Staff,29,0,30,1
1649962131756,MATH 20E,A01,083771,Staff,11,0,30,19
1649962131756,MATH 20E,A02,083772,Staff,24,0,30,6
1649962131756,MATH 20E,B01,083773,Staff,11,0,30,19
1649962131756,MATH 20E,B02,083774,Staff,29,0,30,1
1649962137787,MATH 103A,A01,083777,Staff,1,5,30,29
1649962137787,MATH 103A,A02,083778,Staff,0,4,30,30
1649962137787,MATH 103A,B01,083779,Staff,0,1,30,30
1649962137787,MATH 103A,B02,083780,Staff,8,0,30,22
1649962143814,MATH 105,A01,085443,Staff,0,10,30,30
1649962149840,MATH 109,A01,083213,Anzaldo; Leesa B,7,0,30,23
1649962149840,MATH 109,A02,083214,Anzaldo; Leesa B,4,0,30,26
1649962149840,MATH 109,B01,083215,Anzaldo; Leesa B,23,0,30,7
1649962149840,MATH 109,B02,083216,Anzaldo; Leesa B,18,0,30,12
1649962155869,MATH 142A,A01,083219,Chow; Bennett,0,3,30,30
1649962155869,MATH 142A,A02,083220,Chow; Bennett,0,2,30,30
1649962155869,MATH 142A,B01,083221,Chow; Bennett,0,2,30,30
1649962155869,MATH 142A,B02,083222,Chow; Bennett,0,1,30,30
1649962161895,MATH 193A,A01,083224,Staff,0,5,30,30
1649962161895,MATH 193A,A02,083225,Staff,0,3,30,30
1649962161895,MATH 193A,A03,083781,Staff,2,0,30,28
1649962161895,MATH 193A,A04,083782,Staff,13,0,30,17
1649962167933,MATH 197,001,091859,McAuley; Julian John,9999,0,9999,0
1649962174001,COGS 9,A01,083615,Staff,9,0,60,51
1649962180025,COGS 11,A01,083617,Boyle; Mary E. T.,34,0,40,6
1649962186057,COGS 13,A01,083071,Staff,0,18,40,40
1649962192082,COGS 14A,A01,092681,Staff,51,0,100,49
1649962198104,COGS 14B,A01,083073,Cheng; Tzu-Han,15,0,50,35
1649962204135,COGS 17,A01,092677,Staff,59,0,75,16
1649962210161,COGS 100,A01,083619,Staff,1,12,60,59
1649962216184,COGS 101A,A01,083621,Davis; Joshua Daniel,0,12,60,60
1649962222215,COGS 101B,A01,091572,Staff,26,0,60,34
1649962228238,COGS 101C,A01,083625,Delgado; Tania,22,0,30,8
1649962234265,COGS 107A,A01,083627,Boyle; Mary E. T.,6,0,60,54
1649962240296,COGS 118A,A01,083075,Staff,21,0,60,39
1649962246322,CSE 3,A50,083646,Miranda; Gregory Joseph,24,0,38,14
1649962246322,CSE 3,A51,083647,Miranda; Gregory Joseph,37,0,37,0
1649962252364,CSE 8A,A50,083650,Miranda; Gregory Joseph,1,0,40,39
1649962258395,CSE 11,A01,083080,Cao; Yingjun,0,34,40,40
1649962264416,CSE 12,A01,083652,Staff,41,0,100,59
1649962270442,CSE 15L,A01,083654,Staff,7,0,50,43
1649962270442,CSE 15L,A02,083655,Staff,45,0,50,5
1649962276488,CSE 20,A01,083657,Staff,65,0,80,15
1649962282522,CSE 30,A01,083084,Eldon; John,0,35,40,40
1649962288545,CSE 100,A01,083659,Cao; Yingjun,1,41,50,49
1649962294575,CSE 134B,A01,083661,Powell; Thomas Allan,0,24,65,65
1649962300625,CSE 140,A01,083663,Staff,15,0,75,60
1649962306656,CSE 140L,A01,083088,Eldon; John,11,0,75,64
1649962312679,CSE 175,A01,083665,Kumar; Rakesh,11,0,25,14
1649962318711,CSE 190,A00,092507,Dubnov; Shlomo,12,0,15,3
1649962324732,ECE 45,A01,083139,Staff,0,1,40,40
1649962330764,ECE 65,A50,083695,Staff,4,0,30,26
1649962336791,ECE 109,A01,091882,Touri; Behrouz,52,0,70,18
1649962342835,ECE 180,A00,083140,Abi Samra; Nicholas Camill,26,0,30,4
1649962342835,ECE 180,B00,083141,Abi Samra; Nicholas Camill,12,0,30,18
1649962348863,MATH 10A,A01,083735,Patchell; Gregory David,19,0,30,11
1649962348863,MATH 10A,A02,083736,Patchell; Gregory David,28,0,30,2
1649962348863,MATH 10A,A03,083737,Patchell; Gregory David,28,0,30,2
1649962354891,MATH 10B,A01,083207,Staff,7,0,30,23
1649962354891,MATH 10B,A02,083208,Staff,25,0,30,5
1649962354891,MATH 10B,B01,083739,Staff,25,0,30,5
1649962354891,MATH 10B,B02,083740,Staff,30,0,30,0
1649962360945,MATH 18,A01,083743,Staff,20,0,30,10
1649962360945,MATH 18,A02,083744,Staff,29,0,30,1
1649962360945,MATH 18,A03,083745,Staff,29,0,30,1
1649962360945,MATH 18,A04,083746,Staff,27,0,30,3
1649962360945,MATH 18,B01,083748,Staff,0,0,30,30
1649962360945,MATH 18,B02,083749,Staff,21,0,30,9
1649962360945,MATH 18,B03,083750,Staff,26,0,30,4
1649962360945,MATH 18,B04,083751,Staff,22,0,30,8
1649962366969,MATH 20A,A01,083754,Staff,36,0,40,4
1649962372992,MATH 20B,A01,083756,Staff,17,0,30,13
1649962372992,MATH 20B,A02,083757,Staff,30,0,30,0
1649962379016,MATH 20C,A01,083760,Staff,16,0,30,14
1649962379016,MATH 20C,A02,083761,Staff,13,0,30,17
1649962379016,MATH 20C,B01,083762,Staff,27,0,30,3
1649962379016,MATH 20C,B02,083763,Staff,30,0,30,0
1649962385038,MATH 20D,A01,083765,Staff,14,0,30,16
1649962385038,MATH 20D,A02,083766,Staff,30,0,30,0
1649962385038,MATH 20D,A03,083767,Staff,29,0,30,1
1649962391075,MATH 20E,A01,083771,Staff,11,0,30,19
1649962391075,MATH 20E,A02,083772,Staff,24,0,30,6
1649962391075,MATH 20E,B01,083773,Staff,10,0,30,20
1649962391075,MATH 20E,B02,083774,Staff,29,0,30,1
1649962397100,MATH 103A,A01,083777,Staff,1,5,30,29
1649962397100,MATH 103A,A02,083778,Staff,0,4,30,30
1649962397100,MATH 103A,B01,083779,Staff,0,1,30,30
1649962397100,MATH 103A,B02,083780,Staff,7,0,30,23
1649962403144,MATH 105,A01,085443,Staff,0,10,30,30
1649962409183,MATH 109,A01,083213,Anzaldo; Leesa B,6,0,30,24
1649962409183,MATH 109,A02,083214,Anzaldo; Leesa B,4,0,30,26
1649962409183,MATH 109,B01,083215,Anzaldo; Leesa B,23,0,30,7
1649962409183,MATH 109,B02,083216,Anzaldo; Leesa B,18,0,30,12
1649962415223,MATH 142A,A01,083219,Chow; Bennett,0,3,30,30
1649962415223,MATH 142A,A02,083220,Chow; Bennett,0,2,30,30
1649962415223,MATH 142A,B01,083221,Chow; Bennett,0,2,30,30
1649962415223,MATH 142A,B02,083222,Chow; Bennett,0,2,30,30
1649962421246,MATH 193A,A01,083224,Staff,0,5,30,30
1649962421246,MATH 193A,A02,083225,Staff,0,3,30,30
1649962421246,MATH 193A,A03,083781,Staff,2,0,30,28
1649962421246,MATH 193A,A04,083782,Staff,13,0,30,17
1649962427268,MATH 197,001,091859,McAuley; Julian John,9999,0,9999,0
1649962433351,COGS 9,A01,083615,Staff,9,0,60,51
1649962445867,COGS 11,A01,083617,Boyle; Mary E. T.,34,0,40,6
1649962451902,COGS 13,A01,083071,Staff,0,18,40,40
1649962457945,COGS 14A,A01,092681,Staff,50,0,100,50
1649962463969,COGS 14B,A01,083073,Cheng; Tzu-Han,14,0,50,36
1649962469996,COGS 17,A01,092677,Staff,59,0,75,16
1649962476027,COGS 100,A01,083619,Staff,1,12,60,59
1649962482053,COGS 101A,A01,083621,Davis; Joshua Daniel,0,13,60,60
1649962488081,COGS 101B,A01,091572,Staff,26,0,60,34
1649962494203,COGS 101C,A01,083625,Delgado; Tania,22,0,30,8
1649962500233,COGS 107A,A01,083627,Boyle; Mary E. T.,6,0,60,54
1649962506256,COGS 118A,A01,083075,Staff,21,0,60,39
1649962512280,CSE 3,A50,083646,Miranda; Gregory Joseph,24,0,38,14
1649962512280,CSE 3,A51,083647,Miranda; Gregory Joseph,37,0,37,0
1649962518309,CSE 8A,A50,083650,Miranda; Gregory Joseph,0,0,40,40
1649962524344,CSE 11,A01,083080,Cao; Yingjun,0,34,40,40
1649962530386,CSE 12,A01,083652,Staff,41,0,100,59
1649962536414,CSE 15L,A01,083654,Staff,7,0,50,43
1649962536414,CSE 15L,A02,083655,Staff,45,0,50,5
1649962542437,CSE 20,A01,083657,Staff,64,0,80,16
1649962548462,CSE 30,A01,083084,Eldon; John,0,35,40,40
1649962554499,CSE 100,A01,083659,Cao; Yingjun,1,42,50,49
1649962560529,CSE 134B,A01,083661,Powell; Thomas Allan,0,24,65,65
1649962566564,CSE 140,A01,083663,Staff,15,0,75,60
1649962572592,CSE 140L,A01,083088,Eldon; John,11,0,75,64
1649962578617,CSE 175,A01,083665,Kumar; Rakesh,11,0,25,14
1649962584638,CSE 190,A00,092507,Dubnov; Shlomo,12,0,15,3
1649962590665,ECE 45,A01,083139,Staff,0,1,40,40
1649962596692,ECE 65,A50,083695,Staff,4,0,30,26
1649962602715,ECE 109,A01,091882,Touri; Behrouz,52,0,70,18
1649962608738,ECE 180,A00,083140,Abi Samra; Nicholas Camill,26,0,30,4
1649962608738,ECE 180,B00,083141,Abi Samra; Nicholas Camill,12,0,30,18
1649962614772,MATH 10A,A01,083735,Patchell; Gregory David,19,0,30,11
1649962614772,MATH 10A,A02,083736,Patchell; Gregory David,28,0,30,2
1649962614772,MATH 10A,A03,083737,Patchell; Gregory David,28,0,30,2
1649962620806,MATH 10B,A01,083207,Staff,7,0,30,23
1649962620806,MATH 10B,A02,083208,Staff,25,0,30,5
1649962620806,MATH 10B,B01,083739,Staff,25,0,30,5
1649962620806,MATH 10B,B02,083740,Staff,30,0,30,0
1649962626847,MATH 18,A01,083743,Staff,20,0,30,10
1649962626847,MATH 18,A02,083744,Staff,29,0,30,1
1649962626847,MATH 18,A03,083745,Staff,29,0,30,1
1649962626847,MATH 18,A04,083746,Staff,27,0,30,3
1649962626847,MATH 18,B01,083748,Staff,0,1,30,30
1649962626847,MATH 18,B02,083749,Staff,21,0,30,9
1649962626847,MATH 18,B03,083750,Staff,26,0,30,4
1649962626847,MATH 18,B04,083751,Staff,22,0,30,8
1649962632872,MATH 20A,A01,083754,Staff,36,0,40,4
1649962638897,MATH 20B,A01,083756,Staff,17,0,30,13
1649962638897,MATH 20B,A02,083757,Staff,30,0,30,0
1649962644921,MATH 20C,A01,083760,Staff,16,0,30,14
1649962644921,MATH 20C,A02,083761,Staff,13,0,30,17
1649962644921,MATH 20C,B01,083762,Staff,27,0,30,3
1649962644921,MATH 20C,B02,083763,Staff,30,0,30,0
1649962650947,MATH 20D,A01,083765,Staff,14,0,30,16
1649962650947,MATH 20D,A02,083766,Staff,30,0,30,0
1649962650947,MATH 20D,A03,083767,Staff,29,0,30,1
1649962656976,MATH 20E,A01,083771,Staff,11,0,30,19
1649962656976,MATH 20E,A02,083772,Staff,24,0,30,6
1649962656976,MATH 20E,B01,083773,Staff,10,0,30,20
1649962656976,MATH 20E,B02,083774,Staff,29,0,30,1
1649962663000,MATH 103A,A01,083777,Staff,1,5,30,29
1649962663000,MATH 103A,A02,083778,Staff,0,4,30,30
1649962663000,MATH 103A,B01,083779,Staff,0,1,30,30
1649962663000,MATH 103A,B02,083780,Staff,6,0,30,24
1649962669030,MATH 105,A01,085443,Staff,0,10,30,30
1649962675056,MATH 109,A01,083213,Anzaldo; Leesa B,6,0,30,24
1649962675056,MATH 109,A02,083214,Anzaldo; Leesa B,4,0,30,26
1649962675056,MATH 109,B01,083215,Anzaldo; Leesa B,23,0,30,7
1649962675056,MATH 109,B02,083216,Anzaldo; Leesa B,18,0,30,12
1649962681087,MATH 142A,A01,083219,Chow; Bennett,0,3,30,30
1649962681087,MATH 142A,A02,083220,Chow; Bennett,0,2,30,30
1649962681087,MATH 142A,B01,083221,Chow; Bennett,0,2,30,30
1649962681087,MATH 142A,B02,083222,Chow; Bennett,0,2,30,30
1649962687111,MATH 193A,A01,083224,Staff,0,5,30,30
1649962687111,MATH 193A,A02,083225,Staff,0,3,30,30
1649962687111,MATH 193A,A03,083781,Staff,2,0,30,28
1649962687111,MATH 193A,A04,083782,Staff,13,0,30,17
1649962693139,MATH 197,001,091859,McAuley; Julian John,9999,0,9999,0
1649962699199,COGS 9,A01,083615,Staff,9,0,60,51
1649962705241,COGS 11,A01,083617,Boyle; Mary E. T.,34,0,40,6
1649962711264,COGS 13,A01,083071,Staff,0,18,40,40
1649962717299,COGS 14A,A01,092681,Staff,50,0,100,50
1649962723332,COGS 14B,A01,083073,Cheng; Tzu-Han,14,0,50,36
1649962729357,COGS 17,A01,092677,Staff,59,0,75,16
1649962735389,COGS 100,A01,083619,Staff,1,12,60,59
1649962741411,COGS 101A,A01,083621,Davis; Joshua Daniel,0,13,60,60
1649962747432,COGS 101B,A01,091572,Staff,26,0,60,34
1649962753468,COGS 101C,A01,083625,Delgado; Tania,22,0,30,8
1649962759508,COGS 107A,A01,083627,Boyle; Mary E. T.,6,0,60,54
1649962765532,COGS 118A,A01,083075,Staff,21,0,60,39
1649962771573,CSE 3,A50,083646,Miranda; Gregory Joseph,24,0,38,14
1649962771573,CSE 3,A51,083647,Miranda; Gregory Joseph,37,0,37,0
1649962777595,CSE 8A,A50,083650,Miranda; Gregory Joseph,0,1,40,40
1649962783626,CSE 11,A01,083080,Cao; Yingjun,0,34,40,40
1649962789663,CSE 12,A01,083652,Staff,41,0,100,59
1649962795691,CSE 15L,A01,083654,Staff,7,0,50,43
1649962795691,CSE 15L,A02,083655,Staff,45,0,50,5
1649962801732,CSE 20,A01,083657,Staff,64,0,80,16
1649962807755,CSE 30,A01,083084,Eldon; John,0,35,40,40
1649962813797,CSE 100,A01,083659,Cao; Yingjun,1,43,50,49
1649962819839,CSE 134B,A01,083661,Powell; Thomas Allan,0,24,65,65
1649962825862,CSE 140,A01,083663,Staff,15,0,75,60
1649962831890,CSE 140L,A01,083088,Eldon; John,11,0,75,64
1649962837927,CSE 175,A01,083665,Kumar; Rakesh,11,0,25,14
1649962843983,CSE 190,A00,092507,Dubnov; Shlomo,12,0,15,3
1649962850036,ECE 45,A01,083139,Staff,0,1,40,40
1649962856059,ECE 65,A50,083695,Staff,4,0,30,26
1649962862095,ECE 109,A01,091882,Touri; Behrouz,52,0,70,18
1649962868129,ECE 180,A00,083140,Abi Samra; Nicholas Camill,26,0,30,4
1649962868129,ECE 180,B00,083141,Abi Samra; Nicholas Camill,12,0,30,18
1649962874153,MATH 10A,A01,083735,Patchell; Gregory David,19,0,30,11
1649962874153,MATH 10A,A02,083736,Patchell; Gregory David,28,0,30,2
1649962874153,MATH 10A,A03,083737,Patchell; Gregory David,28,0,30,2
1649962880175,MATH 10B,A01,083207,Staff,7,0,30,23
1649962880175,MATH 10B,A02,083208,Staff,25,0,30,5
1649962880175,MATH 10B,B01,083739,Staff,25,0,30,5
1649962880175,MATH 10B,B02,083740,Staff,30,0,30,0
1649962886201,MATH 18,A01,083743,Staff,20,0,30,10
1649962886201,MATH 18,A02,083744,Staff,29,0,30,1
1649962886201,MATH 18,A03,083745,Staff,29,0,30,1
1649962886201,MATH 18,A04,083746,Staff,27,0,30,3
1649962886201,MATH 18,B01,083748,Staff,0,1,30,30
1649962886201,MATH 18,B02,083749,Staff,21,0,30,9
1649962886201,MATH 18,B03,083750,Staff,26,0,30,4
1649962886201,MATH 18,B04,083751,Staff,22,0,30,8
1649962892223,MATH 20A,A01,083754,Staff,36,0,40,4
1649962898244,MATH 20B,A01,083756,Staff,17,0,30,13
1649962898244,MATH 20B,A02,083757,Staff,30,0,30,0
1649962904282,MATH 20C,A01,083760,Staff,16,0,30,14
1649962904282,MATH 20C,A02,083761,Staff,13,0,30,17
1649962904282,MATH 20C,B01,083762,Staff,27,0,30,3
1649962904282,MATH 20C,B02,083763,Staff,30,0,30,0
1649962910309,MATH 20D,A01,083765,Staff,13,0,30,17
1649962910309,MATH 20D,A02,083766,Staff,30,0,30,0
1649962910309,MATH 20D,A03,083767,Staff,29,0,30,1
1649962916343,MATH 20E,A01,083771,Staff,11,0,30,19
1649962916343,MATH 20E,A02,083772,Staff,24,0,30,6
1649962916343,MATH 20E,B01,083773,Staff,10,0,30,20
1649962916343,MATH 20E,B02,083774,Staff,28,0,30,2
1649962922367,MATH 103A,A01,083777,Staff,1,5,30,29
1649962922367,MATH 103A,A02,083778,Staff,0,4,30,30
1649962922367,MATH 103A,B01,083779,Staff,0,1,30,30
1649962922367,MATH 103A,B02,083780,Staff,6,0,30,24
1649962928397,MATH 105,A01,085443,Staff,0,10,30,30
1649962934425,MATH 109,A01,083213,Anzaldo; Leesa B,4,0,30,26
1649962934425,MATH 109,A02,083214,Anzaldo; Leesa B,4,0,30,26
1649962934425,MATH 109,B01,083215,Anzaldo; Leesa B,23,0,30,7
1649962934425,MATH 109,B02,083216,Anzaldo; Leesa B,17,0,30,13
1649962940459,MATH 142A,A01,083219,Chow; Bennett,0,3,30,30
1649962940459,MATH 142A,A02,083220,Chow; Bennett,0,2,30,30
1649962940459,MATH 142A,B01,083221,Chow; Bennett,0,2,30,30
1649962940459,MATH 142A,B02,083222,Chow; Bennett,0,2,30,30
1649962946483,MATH 193A,A01,083224,Staff,0,5,30,30
1649962946483,MATH 193A,A02,083225,Staff,0,3,30,30
1649962946483,MATH 193A,A03,083781,Staff,2,0,30,28
1649962946483,MATH 193A,A04,083782,Staff,13,0,30,17
1649962952506,MATH 197,001,091859,McAuley; Julian John,9999,0,9999,0
1649962958569,COGS 9,A01,083615,Staff,9,0,60,51
1649962964601,COGS 11,A01,083617,Boyle; Mary E. T.,34,0,40,6
1649962970624,COGS 13,A01,083071,Staff,0,18,40,40
1649962976650,COGS 14A,A01,092681,Staff,49,0,100,51
1649962982694,COGS 14B,A01,083073,Cheng; Tzu-Han,14,0,50,36
1649962988720,COGS 17,A01,092677,Staff,59,0,75,16
1649962994746,COGS 100,A01,083619,Staff,1,12,60,59
1649963000790,COGS 101A,A01,083621,Davis; Joshua Daniel,0,13,60,60
1649963006829,COGS 101B,A01,091572,Staff,25,0,60,35
1649963012860,COGS 101C,A01,083625,Delgado; Tania,22,0,30,8
1649963018895,COGS 107A,A01,083627,Boyle; Mary E. T.,5,0,60,55
1649963024920,COGS 118A,A01,083075,Staff,21,0,60,39
1649963030948,CSE 3,A50,083646,Miranda; Gregory Joseph,24,0,38,14
1649963030948,CSE 3,A51,083647,Miranda; Gregory Joseph,37,0,37,0
1649963036976,CSE 8A,A50,083650,Miranda; Gregory Joseph,0,1,40,40
1649963042998,CSE 11,A01,083080,Cao; Yingjun,0,34,40,40
1649963049022,CSE 12,A01,083652,Staff,41,0,100,59
1649963055059,CSE 15L,A01,083654,Staff,7,0,50,43
1649963055059,CSE 15L,A02,083655,Staff,45,0,50,5
1649963061087,CSE 20,A01,083657,Staff,64,0,80,16
1649963067115,CSE 30,A01,083084,Eldon; John,0,35,40,40
1649963073141,CSE 100,A01,083659,Cao; Yingjun,1,44,50,49
1649963079168,CSE 134B,A01,083661,Powell; Thomas Allan,0,24,65,65
1649963085194,CSE 140,A01,083663,Staff,15,0,75,60
1649963091311,CSE 140L,A01,083088,Eldon; John,11,0,75,64
1649963097338,CSE 175,A01,083665,Kumar; Rakesh,11,0,25,14
1649963103363,CSE 190,A00,092507,Dubnov; Shlomo,12,0,15,3
1649963109390,ECE 45,A01,083139,Staff,0,1,40,40
1649963115412,ECE 65,A50,083695,Staff,4,0,30,26
1649963121436,ECE 109,A01,091882,Touri; Behrouz,52,0,70,18
1649963127467,ECE 180,A00,083140,Abi Samra; Nicholas Camill,26,0,30,4
1649963127467,ECE 180,B00,083141,Abi Samra; Nicholas Camill,12,0,30,18
1649963133489,MATH 10A,A01,083735,Patchell; Gregory David,19,0,30,11
1649963133489,MATH 10A,A02,083736,Patchell; Gregory David,28,0,30,2
1649963133489,MATH 10A,A03,083737,Patchell; Gregory David,28,0,30,2
1649963139527,MATH 10B,A01,083207,Staff,7,0,30,23
1649963139527,MATH 10B,A02,083208,Staff,25,0,30,5
1649963139527,MATH 10B,B01,083739,Staff,25,0,30,5
1649963139527,MATH 10B,B02,083740,Staff,30,0,30,0
1649963145564,MATH 18,A01,083743,Staff,20,0,30,10
1649963145564,MATH 18,A02,083744,Staff,29,0,30,1
1649963145564,MATH 18,A03,083745,Staff,29,0,30,1
1649963145564,MATH 18,A04,083746,Staff,27,0,30,3
1649963145564,MATH 18,B01,083748,Staff,0,1,30,30
1649963145564,MATH 18,B02,083749,Staff,20,0,30,10
1649963145564,MATH 18,B03,083750,Staff,26,0,30,4
1649963145564,MATH 18,B04,083751,Staff,22,0,30,8
1649963151587,MATH 20A,A01,083754,Staff,36,0,40,4
1649963157621,MATH 20B,A01,083756,Staff,17,0,30,13
1649963157621,MATH 20B,A02,083757,Staff,30,0,30,0
1649963163653,MATH 20C,A01,083760,Staff,16,0,30,14
1649963163653,MATH 20C,A02,083761,Staff,13,0,30,17
1649963163653,MATH 20C,B01,083762,Staff,27,0,30,3
1649963163653,MATH 20C,B02,083763,Staff,30,0,30,0
1649963169680,MATH 20D,A01,083765,Staff,13,0,30,17
1649963169680,MATH 20D,A02,083766,Staff,30,0,30,0
1649963169680,MATH 20D,A03,083767,Staff,29,0,30,1
1649963175710,MATH 20E,A01,083771,Staff,11,0,30,19
1649963175710,MATH 20E,A02,083772,Staff,24,0,30,6
1649963175710,MATH 20E,B01,083773,Staff,10,0,30,20
1649963175710,MATH 20E,B02,083774,Staff,28,0,30,2
1649963181744,MATH 103A,A01,083777,Staff,1,5,30,29
1649963181744,MATH 103A,A02,083778,Staff,0,4,30,30
1649963181744,MATH 103A,B01,083779,Staff,0,1,30,30
1649963181744,MATH 103A,B02,083780,Staff,5,0,30,25
1649963187768,MATH 105,A01,085443,Staff,0,9,30,30
1649963193802,MATH 109,A01,083213,Anzaldo; Leesa B,4,0,30,26
1649963193802,MATH 109,A02,083214,Anzaldo; Leesa B,4,0,30,26
1649963193802,MATH 109,B01,083215,Anzaldo; Leesa B,23,0,30,7
1649963193802,MATH 109,B02,083216,Anzaldo; Leesa B,17,0,30,13
1649963199829,MATH 142A,A01,083219,Chow; Bennett,0,3,30,30
1649963199829,MATH 142A,A02,083220,Chow; Bennett,0,2,30,30
1649963199829,MATH 142A,B01,083221,Chow; Bennett,0,2,30,30
1649963199829,MATH 142A,B02,083222,Chow; Bennett,0,3,30,30
1649963205856,MATH 193A,A01,083224,Staff,0,5,30,30
1649963205856,MATH 193A,A02,083225,Staff,0,3,30,30
1649963205856,MATH 193A,A03,083781,Staff,2,0,30,28
1649963205856,MATH 193A,A04,083782,Staff,13,0,30,17
1649963211912,MATH 197,001,091859,McAuley; Julian John,9999,0,9999,0
1649963217974,COGS 9,A01,083615,Staff,9,0,60,51
1649963224001,COGS 11,A01,083617,Boyle; Mary E. T.,34,0,40,6
1649963230025,COGS 13,A01,083071,Staff,0,18,40,40
1649963236058,COGS 14A,A01,092681,Staff,49,0,100,51
1649963242083,COGS 14B,A01,083073,Cheng; Tzu-Han,14,0,50,36
1649963248114,COGS 17,A01,092677,Staff,59,0,75,16
1649963254147,COGS 100,A01,083619,Staff,1,12,60,59
1649963260187,COGS 101A,A01,083621,Davis; Joshua Daniel,0,13,60,60
1649963266226,COGS 101B,A01,091572,Staff,25,0,60,35
1649963272254,COGS 101C,A01,083625,Delgado; Tania,22,0,30,8
1649963278281,COGS 107A,A01,083627,Boyle; Mary E. T.,5,0,60,55
1649963284307,COGS 118A,A01,083075,Staff,21,0,60,39
1649963290335,CSE 3,A50,083646,Miranda; Gregory Joseph,24,0,38,14
1649963290335,CSE 3,A51,083647,Miranda; Gregory Joseph,37,0,37,0
1649963296371,CSE 8A,A50,083650,Miranda; Gregory Joseph,0,2,40,40
1649963302394,CSE 11,A01,083080,Cao; Yingjun,0,34,40,40
1649963308422,CSE 12,A01,083652,Staff,41,0,100,59
1649963314449,CSE 15L,A01,083654,Staff,7,0,50,43
1649963314449,CSE 15L,A02,083655,Staff,45,0,50,5
1649963320475,CSE 20,A01,083657,Staff,64,0,80,16
1649963326499,CSE 30,A01,083084,Eldon; John,0,34,40,40
1649963332535,CSE 100,A01,083659,Cao; Yingjun,1,44,50,49
1649963338562,CSE 134B,A01,083661,Powell; Thomas Allan,0,24,65,65
1649963344587,CSE 140,A01,083663,Staff,15,0,75,60
1649963350612,CSE 140L,A01,083088,Eldon; John,11,0,75,64
1649963356633,CSE 175,A01,083665,Kumar; Rakesh,11,0,25,14
1649963362688,CSE 190,A00,092507,Dubnov; Shlomo,12,0,15,3
1649963368711,ECE 45,A01,083139,Staff,0,1,40,40
1649963374735,ECE 65,A50,083695,Staff,3,0,30,27
1649963380758,ECE 109,A01,091882,Touri; Behrouz,51,0,70,19
1649963386790,ECE 180,A00,083140,Abi Samra; Nicholas Camill,26,0,30,4
1649963386790,ECE 180,B00,083141,Abi Samra; Nicholas Camill,12,0,30,18
1649963392821,MATH 10A,A01,083735,Patchell; Gregory David,19,0,30,11
1649963392821,MATH 10A,A02,083736,Patchell; Gregory David,28,0,30,2
1649963392821,MATH 10A,A03,083737,Patchell; Gregory David,28,0,30,2
1649963398845,MATH 10B,A01,083207,Staff,7,0,30,23
1649963398845,MATH 10B,A02,083208,Staff,25,0,30,5
1649963398845,MATH 10B,B01,083739,Staff,25,0,30,5
1649963398845,MATH 10B,B02,083740,Staff,30,0,30,0
1649963404882,MATH 18,A01,083743,Staff,20,0,30,10
1649963404882,MATH 18,A02,083744,Staff,29,0,30,1
1649963404882,MATH 18,A03,083745,Staff,29,0,30,1
1649963404882,MATH 18,A04,083746,Staff,27,0,30,3
1649963404882,MATH 18,B01,083748,Staff,0,1,30,30
1649963404882,MATH 18,B02,083749,Staff,20,0,30,10
1649963404882,MATH 18,B03,083750,Staff,26,0,30,4
1649963404882,MATH 18,B04,083751,Staff,22,0,30,8
1649963410906,MATH 20A,A01,083754,Staff,36,0,40,4
1649963416937,MATH 20B,A01,083756,Staff,17,0,30,13
1649963416937,MATH 20B,A02,083757,Staff,30,0,30,0
1649963422970,MATH 20C,A01,083760,Staff,15,0,30,15
1649963422970,MATH 20C,A02,083761,Staff,13,0,30,17
1649963422970,MATH 20C,B01,083762,Staff,27,0,30,3
1649963422970,MATH 20C,B02,083763,Staff,30,0,30,0
1649963429000,MATH 20D,A01,083765,Staff,13,0,30,17
1649963429000,MATH 20D,A02,083766,Staff,30,0,30,0
1649963429000,MATH 20D,A03,083767,Staff,29,0,30,1
1649963435028,MATH 20E,A01,083771,Staff,11,0,30,19
1649963435028,MATH 20E,A02,083772,Staff,24,0,30,6
1649963435028,MATH 20E,B01,083773,Staff,11,0,30,19
1649963435028,MATH 20E,B02,083774,Staff,28,0,30,2
1649963441065,MATH 103A,A01,083777,Staff,1,4,30,29
1649963441065,MATH 103A,A02,083778,Staff,0,4,30,30
1649963441065,MATH 103A,B01,083779,Staff,0,1,30,30
1649963441065,MATH 103A,B02,083780,Staff,3,0,30,27
1649963447088,MATH 105,A01,085443,Staff,0,9,30,30
1649963453116,MATH 109,A01,083213,Anzaldo; Leesa B,4,0,30,26
1649963453116,MATH 109,A02,083214,Anzaldo; Leesa B,4,0,30,26
1649963453116,MATH 109,B01,083215,Anzaldo; Leesa B,23,0,30,7
1649963453116,MATH 109,B02,083216,Anzaldo; Leesa B,18,0,30,12
1649963459150,MATH 142A,A01,083219,Chow; Bennett,0,3,30,30
1649963459150,MATH 142A,A02,083220,Chow; Bennett,0,2,30,30
1649963459150,MATH 142A,B01,083221,Chow; Bennett,0,2,30,30
1649963459150,MATH 142A,B02,083222,Chow; Bennett,0,3,30,30
1649963465173,MATH 193A,A01,083224,Staff,0,5,30,30
1649963465173,MATH 193A,A02,083225,Staff,0,3,30,30
1649963465173,MATH 193A,A03,083781,Staff,2,0,30,28
1649963465173,MATH 193A,A04,083782,Staff,13,0,30,17
1649963471199,MATH 197,001,091859,McAuley; Julian John,9999,0,9999,0
1649963477251,COGS 9,A01,083615,Staff,9,0,60,51
1649963483276,COGS 11,A01,083617,Boyle; Mary E. T.,34,0,40,6
1649963489302,COGS 13,A01,083071,Staff,0,18,40,40
1649963495323,COGS 14A,A01,092681,Staff,48,0,100,52
1649963501351,COGS 14B,A01,083073,Cheng; Tzu-Han,14,0,50,36
1649963507375,COGS 17,A01,092677,Staff,59,0,75,16
1649963513422,COGS 100,A01,083619,Staff,1,12,60,59
1649963519455,COGS 101A,A01,083621,Davis; Joshua Daniel,0,13,60,60
1649963525486,COGS 101B,A01,091572,Staff,25,0,60,35
1649963531515,COGS 101C,A01,083625,Delgado; Tania,21,0,30,9
1649963537567,COGS 107A,A01,083627,Boyle; Mary E. T.,5,0,60,55
1649963543591,COGS 118A,A01,083075,Staff,21,0,60,39
1649963549615,CSE 3,A50,083646,Miranda; Gregory Joseph,24,0,38,14
1649963549615,CSE 3,A51,083647,Miranda; Gregory Joseph,37,0,37,0
1649963555663,CSE 8A,A50,083650,Miranda; Gregory Joseph,0,3,40,40
1649963561686,CSE 11,A01,083080,Cao; Yingjun,0,35,40,40
1649963567712,CSE 12,A01,083652,Staff,41,0,100,59
1649963573744,CSE 15L,A01,083654,Staff,7,0,50,43
1649963573744,CSE 15L,A02,083655,Staff,45,0,50,5
1649963579779,CSE 20,A01,083657,Staff,64,0,80,16
1649963585805,CSE 30,A01,083084,Eldon; John,0,34,40,40
1649963591828,CSE 100,A01,083659,Cao; Yingjun,1,44,50,49
1649963597854,CSE 134B,A01,083661,Powell; Thomas Allan,0,24,65,65
1649963603882,CSE 140,A01,083663,Staff,15,0,75,60
1649963609917,CSE 140L,A01,083088,Eldon; John,11,0,75,64
1649963615942,CSE 175,A01,083665,Kumar; Rakesh,11,0,25,14
1649963621967,CSE 190,A00,092507,Dubnov; Shlomo,12,0,15,3
1649963627998,ECE 45,A01,083139,Staff,0,1,40,40
1649963634038,ECE 65,A50,083695,Staff,3,0,30,27
1649963640065,ECE 109,A01,091882,Touri; Behrouz,51,0,70,19
1649963646103,ECE 180,A00,083140,Abi Samra; Nicholas Camill,26,0,30,4
1649963646103,ECE 180,B00,083141,Abi Samra; Nicholas Camill,12,0,30,18
1649963652140,MATH 10A,A01,083735,Patchell; Gregory David,19,0,30,11
1649963652140,MATH 10A,A02,083736,Patchell; Gregory David,28,0,30,2
1649963652140,MATH 10A,A03,083737,Patchell; Gregory David,28,0,30,2
1649963658163,MATH 10B,A01,083207,Staff,6,0,30,24
1649963658163,MATH 10B,A02,083208,Staff,25,0,30,5
1649963658163,MATH 10B,B01,083739,Staff,25,0,30,5
1649963658163,MATH 10B,B02,083740,Staff,30,0,30,0
1649963664202,MATH 18,A01,083743,Staff,20,0,30,10
1649963664202,MATH 18,A02,083744,Staff,29,0,30,1
1649963664202,MATH 18,A03,083745,Staff,29,0,30,1
1649963664202,MATH 18,A04,083746,Staff,27,0,30,3
1649963664202,MATH 18,B01,083748,Staff,0,1,30,30
1649963664202,MATH 18,B02,083749,Staff,18,0,30,12
1649963664202,MATH 18,B03,083750,Staff,25,0,30,5
1649963664202,MATH 18,B04,083751,Staff,22,0,30,8
1649963670226,MATH 20A,A01,083754,Staff,36,0,40,4
1649963676253,MATH 20B,A01,083756,Staff,17,0,30,13
1649963676253,MATH 20B,A02,083757,Staff,30,0,30,0
1649963682277,MATH 20C,A01,083760,Staff,15,0,30,15
1649963682277,MATH 20C,A02,083761,Staff,13,0,30,17
1649963682277,MATH 20C,B01,083762,Staff,27,0,30,3
1649963682277,MATH 20C,B02,083763,Staff,30,0,30,0
1649963688386,MATH 20D,A01,083765,Staff,13,0,30,17
1649963688386,MATH 20D,A02,083766,Staff,30,0,30,0
1649963688386,MATH 20D,A03,083767,Staff,29,0,30,1
1649963694416,MATH 20E,A01,083771,Staff,11,0,30,19
1649963694416,MATH 20E,A02,083772,Staff,24,0,30,6
1649963694416,MATH 20E,B01,083773,Staff,11,0,30,19
1649963694416,MATH 20E,B02,083774,Staff,28,0,30,2
1649963700453,MATH 103A,A01,083777,Staff,1,4,30,29
1649963700453,MATH 103A,A02,083778,Staff,0,4,30,30
1649963700453,MATH 103A,B01,083779,Staff,0,1,30,30
1649963700453,MATH 103A,B02,083780,Staff,2,0,30,28
1649963706478,MATH 105,A01,085443,Staff,0,9,30,30
1649963712509,MATH 109,A01,083213,Anzaldo; Leesa B,4,0,30,26
1649963712509,MATH 109,A02,083214,Anzaldo; Leesa B,3,0,30,27
1649963712509,MATH 109,B01,083215,Anzaldo; Leesa B,23,0,30,7
1649963712509,MATH 109,B02,083216,Anzaldo; Leesa B,18,0,30,12
1649963718537,MATH 142A,A01,083219,Chow; Bennett,0,3,30,30
1649963718537,MATH 142A,A02,083220,Chow; Bennett,0,2,30,30
1649963718537,MATH 142A,B01,083221,Chow; Bennett,0,2,30,30
1649963718537,MATH 142A,B02,083222,Chow; Bennett,0,3,30,30
1649963724568,MATH 193A,A01,083224,Staff,0,5,30,30
1649963724568,MATH 193A,A02,083225,Staff,0,3,30,30
1649963724568,MATH 193A,A03,083781,Staff,2,0,30,28
1649963724568,MATH 193A,A04,083782,Staff,13,0,30,17
1649963730593,MATH 197,001,091859,McAuley; Julian John,9999,0,9999,0
1649963736657,COGS 9,A01,083615,Staff,9,0,60,51
1649963742685,COGS 11,A01,083617,Boyle; Mary E. T.,34,0,40,6
1649963748718,COGS 13,A01,083071,Staff,0,18,40,40
1649963754744,COGS 14A,A01,092681,Staff,46,0,100,54
1649963760767,COGS 14B,A01,083073,Cheng; Tzu-Han,14,0,50,36
1649963766807,COGS 17,A01,092677,Staff,59,0,75,16
1649963772830,COGS 100,A01,083619,Staff,1,13,60,59
1649963778854,COGS 101A,A01,083621,Davis; Joshua Daniel,0,13,60,60
1649963784885,COGS 101B,A01,091572,Staff,25,0,60,35
1649963790909,COGS 101C,A01,083625,Delgado; Tania,22,0,30,8
1649963796935,COGS 107A,A01,083627,Boyle; Mary E. T.,4,0,60,56
1649963802969,COGS 118A,A01,083075,Staff,21,0,60,39
1649963808997,CSE 3,A50,083646,Miranda; Gregory Joseph,24,0,38,14
1649963808997,CSE 3,A51,083647,Miranda; Gregory Joseph,37,0,37,0
1649963815020,CSE 8A,A50,083650,Miranda; Gregory Joseph,0,3,40,40
1649963821057,CSE 11,A01,083080,Cao; Yingjun,0,35,40,40
1649963827088,CSE 12,A01,083652,Staff,41,0,100,59
1649963833115,CSE 15L,A01,083654,Staff,7,0,50,43
1649963833115,CSE 15L,A02,083655,Staff,45,0,50,5
1649963839138,CSE 20,A01,083657,Staff,64,0,80,16
1649963845171,CSE 30,A01,083084,Eldon; John,0,34,40,40
1649963851198,CSE 100,A01,083659,Cao; Yingjun,1,45,50,49
1649963857228,CSE 134B,A01,083661,Powell; Thomas Allan,0,24,65,65
1649963863255,CSE 140,A01,083663,Staff,15,0,75,60
1649963869292,CSE 140L,A01,083088,Eldon; John,11,0,75,64
1649963875323,CSE 175,A01,083665,Kumar; Rakesh,11,0,25,14
1649963881349,CSE 190,A00,092507,Dubnov; Shlomo,12,0,15,3
1649963887376,ECE 45,A01,083139,Staff,0,1,40,40
1649963893400,ECE 65,A50,083695,Staff,3,0,30,27
1649963899426,ECE 109,A01,091882,Touri; Behrouz,51,0,70,19
1649963905453,ECE 180,A00,083140,Abi Samra; Nicholas Camill,26,0,30,4
1649963905453,ECE 180,B00,083141,Abi Samra; Nicholas Camill,12,0,30,18
1649963911490,MATH 10A,A01,083735,Patchell; Gregory David,19,0,30,11
1649963911490,MATH 10A,A02,083736,Patchell; Gregory David,28,0,30,2
1649963911490,MATH 10A,A03,083737,Patchell; Gregory David,28,0,30,2
1649963917539,MATH 10B,A01,083207,Staff,6,0,30,24
1649963917539,MATH 10B,A02,083208,Staff,25,0,30,5
1649963917539,MATH 10B,B01,083739,Staff,25,0,30,5
1649963917539,MATH 10B,B02,083740,Staff,30,0,30,0
1649963923564,MATH 18,A01,083743,Staff,20,0,30,10
1649963923564,MATH 18,A02,083744,Staff,29,0,30,1
1649963923564,MATH 18,A03,083745,Staff,28,0,30,2
1649963923564,MATH 18,A04,083746,Staff,27,0,30,3
1649963923564,MATH 18,B01,083748,Staff,0,1,30,30
1649963923564,MATH 18,B02,083749,Staff,18,0,30,12
1649963923564,MATH 18,B03,083750,Staff,25,0,30,5
1649963923564,MATH 18,B04,083751,Staff,22,0,30,8
1649963929587,MATH 20A,A01,083754,Staff,36,0,40,4
1649963935610,MATH 20B,A01,083756,Staff,16,0,30,14
1649963935610,MATH 20B,A02,083757,Staff,29,0,30,1
1649963941636,MATH 20C,A01,083760,Staff,15,0,30,15
1649963941636,MATH 20C,A02,083761,Staff,13,0,30,17
1649963941636,MATH 20C,B01,083762,Staff,27,0,30,3
1649963941636,MATH 20C,B02,083763,Staff,30,0,30,0
1649963947670,MATH 20D,A01,083765,Staff,13,0,30,17
1649963947670,MATH 20D,A02,083766,Staff,30,0,30,0
1649963947670,MATH 20D,A03,083767,Staff,29,0,30,1
1649963953706,MATH 20E,A01,083771,Staff,11,0,30,19
1649963953706,MATH 20E,A02,083772,Staff,24,0,30,6
1649963953706,MATH 20E,B01,083773,Staff,11,0,30,19
1649963953706,MATH 20E,B02,083774,Staff,28,0,30,2
1649963959741,MATH 103A,A01,083777,Staff,1,4,30,29
1649963959741,MATH 103A,A02,083778,Staff,0,4,30,30
1649963959741,MATH 103A,B01,083779,Staff,0,1,30,30
1649963959741,MATH 103A,B02,083780,Staff,2,0,30,28
1649963965764,MATH 105,A01,085443,Staff,0,9,30,30
1649963971787,MATH 109,A01,083213,Anzaldo; Leesa B,4,0,30,26
1649963971787,MATH 109,A02,083214,Anzaldo; Leesa B,1,0,30,29
1649963971787,MATH 109,B01,083215,Anzaldo; Leesa B,23,0,30,7
1649963971787,MATH 109,B02,083216,Anzaldo; Leesa B,18,0,30,12
1649963977816,MATH 142A,A01,083219,Chow; Bennett,0,3,30,30
1649963977816,MATH 142A,A02,083220,Chow; Bennett,0,2,30,30
1649963977816,MATH 142A,B01,083221,Chow; Bennett,0,2,30,30
1649963977816,MATH 142A,B02,083222,Chow; Bennett,0,3,30,30
1649963983842,MATH 193A,A01,083224,Staff,0,5,30,30
1649963983842,MATH 193A,A02,083225,Staff,0,3,30,30
1649963983842,MATH 193A,A03,083781,Staff,2,0,30,28
1649963983842,MATH 193A,A04,083782,Staff,13,0,30,17
1649963989865,MATH 197,001,091859,McAuley; Julian John,9999,0,9999,0
1649963995926,COGS 9,A01,083615,Staff,9,0,60,51
1649964001953,COGS 11,A01,083617,Boyle; Mary E. T.,34,0,40,6
1649964007979,COGS 13,A01,083071,Staff,0,18,40,40
1649964014006,COGS 14A,A01,092681,Staff,46,0,100,54
1649964020029,COGS 14B,A01,083073,Cheng; Tzu-Han,14,0,50,36
1649964026052,COGS 17,A01,092677,Staff,59,0,75,16
1649964032076,COGS 100,A01,083619,Staff,1,13,60,59
1649964038098,COGS 101A,A01,083621,Davis; Joshua Daniel,0,13,60,60
1649964044124,COGS 101B,A01,091572,Staff,25,0,60,35
1649964050148,COGS 101C,A01,083625,Delgado; Tania,22,0,30,8
1649964056168,COGS 107A,A01,083627,Boyle; Mary E. T.,4,0,60,56
1649964062202,COGS 118A,A01,083075,Staff,21,0,60,39
1649964068240,CSE 3,A50,083646,Miranda; Gregory Joseph,24,0,38,14
1649964068240,CSE 3,A51,083647,Miranda; Gregory Joseph,37,0,37,0
1649964074267,CSE 8A,A50,083650,Miranda; Gregory Joseph,0,3,40,40
1649964080289,CSE 11,A01,083080,Cao; Yingjun,0,34,40,40
1649964086322,CSE 12,A01,083652,Staff,41,0,100,59
1649964092356,CSE 15L,A01,083654,Staff,7,0,50,43
1649964092356,CSE 15L,A02,083655,Staff,45,0,50,5
1649964098389,CSE 20,A01,083657,Staff,64,0,80,16
1649964104412,CSE 30,A01,083084,Eldon; John,0,35,40,40
1649964110443,CSE 100,A01,083659,Cao; Yingjun,1,45,50,49
1649964116477,CSE 134B,A01,083661,Powell; Thomas Allan,0,24,65,65
1649964122500,CSE 140,A01,083663,Staff,15,0,75,60
1649964128536,CSE 140L,A01,083088,Eldon; John,11,0,75,64
1649964134580,CSE 175,A01,083665,Kumar; Rakesh,11,0,25,14
1649964140618,CSE 190,A00,092507,Dubnov; Shlomo,12,0,15,3
1649964146656,ECE 45,A01,083139,Staff,0,1,40,40
1649964152687,ECE 65,A50,083695,Staff,3,0,30,27
1649964158709,ECE 109,A01,091882,Touri; Behrouz,51,0,70,19
1649964164736,ECE 180,A00,083140,Abi Samra; Nicholas Camill,26,0,30,4
1649964164736,ECE 180,B00,083141,Abi Samra; Nicholas Camill,12,0,30,18
1649964170762,MATH 10A,A01,083735,Patchell; Gregory David,19,0,30,11
1649964170762,MATH 10A,A02,083736,Patchell; Gregory David,28,0,30,2
1649964170762,MATH 10A,A03,083737,Patchell; Gregory David,28,0,30,2
1649964176788,MATH 10B,A01,083207,Staff,6,0,30,24
1649964176788,MATH 10B,A02,083208,Staff,25,0,30,5
1649964176788,MATH 10B,B01,083739,Staff,25,0,30,5
1649964176788,MATH 10B,B02,083740,Staff,30,0,30,0
1649964182827,MATH 18,A01,083743,Staff,20,0,30,10
1649964182827,MATH 18,A02,083744,Staff,29,0,30,1
1649964182827,MATH 18,A03,083745,Staff,28,0,30,2
1649964182827,MATH 18,A04,083746,Staff,27,0,30,3
1649964182827,MATH 18,B01,083748,Staff,0,1,30,30
1649964182827,MATH 18,B02,083749,Staff,18,0,30,12
1649964182827,MATH 18,B03,083750,Staff,24,0,30,6
1649964182827,MATH 18,B04,083751,Staff,22,0,30,8
1649964188849,MATH 20A,A01,083754,Staff,36,0,40,4
1649964194879,MATH 20B,A01,083756,Staff,16,0,30,14
1649964194879,MATH 20B,A02,083757,Staff,29,0,30,1
1649964200913,MATH 20C,A01,083760,Staff,15,0,30,15
1649964200913,MATH 20C,A02,083761,Staff,12,0,30,18
1649964200913,MATH 20C,B01,083762,Staff,27,0,30,3
1649964200913,MATH 20C,B02,083763,Staff,30,0,30,0
1649964206943,MATH 20D,A01,083765,Staff,13,0,30,17
1649964206943,MATH 20D,A02,083766,Staff,30,0,30,0
1649964206943,MATH 20D,A03,083767,Staff,29,0,30,1
1649964212981,MATH 20E,A01,083771,Staff,11,0,30,19
1649964212981,MATH 20E,A02,083772,Staff,24,0,30,6
1649964212981,MATH 20E,B01,083773,Staff,11,0,30,19
1649964212981,MATH 20E,B02,083774,Staff,28,0,30,2
1649964219011,MATH 103A,A01,083777,Staff,1,4,30,29
1649964219011,MATH 103A,A02,083778,Staff,0,4,30,30
1649964219011,MATH 103A,B01,083779,Staff,0,1,30,30
1649964219011,MATH 103A,B02,083780,Staff,2,0,30,28
1649964225045,MATH 105,A01,085443,Staff,0,9,30,30
1649964231072,MATH 109,A01,083213,Anzaldo; Leesa B,4,0,30,26
1649964231072,MATH 109,A02,083214,Anzaldo; Leesa B,1,0,30,29
1649964231072,MATH 109,B01,083215,Anzaldo; Leesa B,23,0,30,7
1649964231072,MATH 109,B02,083216,Anzaldo; Leesa B,18,0,30,12
1649964237126,MATH 142A,A01,083219,Chow; Bennett,0,3,30,30
1649964237126,MATH 142A,A02,083220,Chow; Bennett,0,2,30,30
1649964237126,MATH 142A,B01,083221,Chow; Bennett,0,2,30,30
1649964237126,MATH 142A,B02,083222,Chow; Bennett,0,3,30,30
1649964243150,MATH 193A,A01,083224,Staff,0,5,30,30
1649964243150,MATH 193A,A02,083225,Staff,0,3,30,30
1649964243150,MATH 193A,A03,083781,Staff,2,0,30,28
1649964243150,MATH 193A,A04,083782,Staff,13,0,30,17
1649964249174,MATH 197,001,091859,McAuley; Julian John,9999,0,9999,0
1649964255232,COGS 9,A01,083615,Staff,8,0,60,52
1649964261255,COGS 11,A01,083617,Boyle; Mary E. T.,34,0,40,6
1649964267282,COGS 13,A01,083071,Staff,0,18,40,40
1649964273304,COGS 14A,A01,092681,Staff,46,0,100,54
1649964279428,COGS 14B,A01,083073,Cheng; Tzu-Han,14,0,50,36
1649964285465,COGS 17,A01,092677,Staff,59,0,75,16
1649964291492,COGS 100,A01,083619,Staff,1,13,60,59
1649964297521,COGS 101A,A01,083621,Davis; Joshua Daniel,0,13,60,60
1649964303560,COGS 101B,A01,091572,Staff,25,0,60,35
1649964309588,COGS 101C,A01,083625,Delgado; Tania,22,0,30,8
1649964315615,COGS 107A,A01,083627,Boyle; Mary E. T.,4,0,60,56
1649964321646,COGS 118A,A01,083075,Staff,21,0,60,39
1649964327669,CSE 3,A50,083646,Miranda; Gregory Joseph,24,0,38,14
1649964327669,CSE 3,A51,083647,Miranda; Gregory Joseph,37,0,37,0
1649964333699,CSE 8A,A50,083650,Miranda; Gregory Joseph,0,3,40,40
1649964339743,CSE 11,A01,083080,Cao; Yingjun,0,36,40,40
1649964345769,CSE 12,A01,083652,Staff,41,0,100,59
1649964351793,CSE 15L,A01,083654,Staff,6,0,50,44
1649964351793,CSE 15L,A02,083655,Staff,45,0,50,5
1649964357825,CSE 20,A01,083657,Staff,64,0,80,16
1649964363863,CSE 30,A01,083084,Eldon; John,0,35,40,40
1649964385235,CSE 100,A01,083659,Cao; Yingjun,1,45,50,49
1649964391259,CSE 134B,A01,083661,Powell; Thomas Allan,0,24,65,65
1649964397308,CSE 140,A01,083663,Staff,15,0,75,60
1649964403337,CSE 140L,A01,083088,Eldon; John,11,0,75,64
1649964409364,CSE 175,A01,083665,Kumar; Rakesh,11,0,25,14
1649964415388,CSE 190,A00,092507,Dubnov; Shlomo,12,0,15,3
1649964421423,ECE 45,A01,083139,Staff,0,1,40,40
1649964427449,ECE 65,A50,083695,Staff,3,0,30,27
1649964433471,ECE 109,A01,091882,Touri; Behrouz,51,0,70,19
1649964439508,ECE 180,A00,083140,Abi Samra; Nicholas Camill,26,0,30,4
1649964439508,ECE 180,B00,083141,Abi Samra; Nicholas Camill,12,0,30,18
1649964445539,MATH 10A,A01,083735,Patchell; Gregory David,19,0,30,11
1649964445539,MATH 10A,A02,083736,Patchell; Gregory David,28,0,30,2
1649964445539,MATH 10A,A03,083737,Patchell; Gregory David,28,0,30,2
1649964451565,MATH 10B,A01,083207,Staff,6,0,30,24
1649964451565,MATH 10B,A02,083208,Staff,25,0,30,5
1649964451565,MATH 10B,B01,083739,Staff,25,0,30,5
1649964451565,MATH 10B,B02,083740,Staff,30,0,30,0
1649964457588,MATH 18,A01,083743,Staff,20,0,30,10
1649964457588,MATH 18,A02,083744,Staff,29,0,30,1
1649964457588,MATH 18,A03,083745,Staff,28,0,30,2
1649964457588,MATH 18,A04,083746,Staff,27,0,30,3
1649964457588,MATH 18,B01,083748,Staff,0,1,30,30
1649964457588,MATH 18,B02,083749,Staff,18,0,30,12
1649964457588,MATH 18,B03,083750,Staff,24,0,30,6
1649964457588,MATH 18,B04,083751,Staff,22,0,30,8
1649964463611,MATH 20A,A01,083754,Staff,36,0,40,4
1649964469649,MATH 20B,A01,083756,Staff,16,0,30,14
1649964469649,MATH 20B,A02,083757,Staff,28,0,30,2
1649964475677,MATH 20C,A01,083760,Staff,15,0,30,15
1649964475677,MATH 20C,A02,083761,Staff,12,0,30,18
1649964475677,MATH 20C,B01,083762,Staff,27,0,30,3
1649964475677,MATH 20C,B02,083763,Staff,30,0,30,0
1649964481705,MATH 20D,A01,083765,Staff,13,0,30,17
1649964481705,MATH 20D,A02,083766,Staff,30,0,30,0
1649964481705,MATH 20D,A03,083767,Staff,29,0,30,1
1649964487731,MATH 20E,A01,083771,Staff,11,0,30,19
1649964487731,MATH 20E,A02,083772,Staff,24,0,30,6
1649964487731,MATH 20E,B01,083773,Staff,11,0,30,19
1649964487731,MATH 20E,B02,083774,Staff,28,0,30,2
1649964493757,MATH 103A,A01,083777,Staff,1,4,30,29
1649964493757,MATH 103A,A02,083778,Staff,0,4,30,30
1649964493757,MATH 103A,B01,083779,Staff,0,1,30,30
1649964493757,MATH 103A,B02,083780,Staff,2,0,30,28
1649964499781,MATH 105,A01,085443,Staff,0,9,30,30
1649964505807,MATH 109,A01,083213,Anzaldo; Leesa B,4,0,30,26
1649964505807,MATH 109,A02,083214,Anzaldo; Leesa B,1,0,30,29
1649964505807,MATH 109,B01,083215,Anzaldo; Leesa B,23,0,30,7
1649964505807,MATH 109,B02,083216,Anzaldo; Leesa B,18,0,30,12
1649964511840,MATH 142A,A01,083219,Chow; Bennett,0,3,30,30
1649964511840,MATH 142A,A02,083220,Chow; Bennett,0,2,30,30
1649964511840,MATH 142A,B01,083221,Chow; Bennett,0,2,30,30
1649964511840,MATH 142A,B02,083222,Chow; Bennett,0,3,30,30
1649964517872,MATH 193A,A01,083224,Staff,0,5,30,30
1649964517872,MATH 193A,A02,083225,Staff,0,3,30,30
1649964517872,MATH 193A,A03,083781,Staff,2,0,30,28
1649964517872,MATH 193A,A04,083782,Staff,13,0,30,17
1649964523902,MATH 197,001,091859,McAuley; Julian John,9999,0,9999,0
1649964529976,COGS 9,A01,083615,Staff,8,0,60,52
1649964536005,COGS 11,A01,083617,Boyle; Mary E. T.,34,0,40,6
1649964542032,COGS 13,A01,083071,Staff,0,18,40,40
1649964548057,COGS 14A,A01,092681,Staff,46,0,100,54
1649964554083,COGS 14B,A01,083073,Cheng; Tzu-Han,14,0,50,36
1649964560111,COGS 17,A01,092677,Staff,59,0,75,16
1649964566143,COGS 100,A01,083619,Staff,1,13,60,59
1649964572184,COGS 101A,A01,083621,Davis; Joshua Daniel,0,13,60,60
1649964578208,COGS 101B,A01,091572,Staff,25,0,60,35
1649964584239,COGS 101C,A01,083625,Delgado; Tania,22,0,30,8
1649964590267,COGS 107A,A01,083627,Boyle; Mary E. T.,4,0,60,56
1649964596289,COGS 118A,A01,083075,Staff,21,0,60,39
1649964602312,CSE 3,A50,083646,Miranda; Gregory Joseph,24,0,38,14
1649964602312,CSE 3,A51,083647,Miranda; Gregory Joseph,37,0,37,0
1649964608349,CSE 8A,A50,083650,Miranda; Gregory Joseph,0,3,40,40
1649964614376,CSE 11,A01,083080,Cao; Yingjun,0,36,40,40
1649964620401,CSE 12,A01,083652,Staff,41,0,100,59
1649964626430,CSE 15L,A01,083654,Staff,6,0,50,44
1649964626430,CSE 15L,A02,083655,Staff,45,0,50,5
1649964632465,CSE 20,A01,083657,Staff,64,0,80,16
1649964638493,CSE 30,A01,083084,Eldon; John,0,35,40,40
1649964644520,CSE 100,A01,083659,Cao; Yingjun,1,45,50,49
1649964650544,CSE 134B,A01,083661,Powell; Thomas Allan,0,24,65,65
1649964656566,CSE 140,A01,083663,Staff,15,0,75,60
1649964662600,CSE 140L,A01,083088,Eldon; John,11,0,75,64
1649964668634,CSE 175,A01,083665,Kumar; Rakesh,11,0,25,14
1649964674660,CSE 190,A00,092507,Dubnov; Shlomo,12,0,15,3
1649964680685,ECE 45,A01,083139,Staff,0,1,40,40
1649964686708,ECE 65,A50,083695,Staff,3,0,30,27
1649964692750,ECE 109,A01,091882,Touri; Behrouz,51,0,70,19
1649964698780,ECE 180,A00,083140,Abi Samra; Nicholas Camill,26,0,30,4
1649964698780,ECE 180,B00,083141,Abi Samra; Nicholas Camill,12,0,30,18
1649964704807,MATH 10A,A01,083735,Patchell; Gregory David,19,0,30,11
1649964704807,MATH 10A,A02,083736,Patchell; Gregory David,28,0,30,2
1649964704807,MATH 10A,A03,083737,Patchell; Gregory David,28,0,30,2
1649964710857,MATH 10B,A01,083207,Staff,6,0,30,24
1649964710857,MATH 10B,A02,083208,Staff,25,0,30,5
1649964710857,MATH 10B,B01,083739,Staff,25,0,30,5
1649964710857,MATH 10B,B02,083740,Staff,30,0,30,0
1649964716889,MATH 18,A01,083743,Staff,20,0,30,10
1649964716889,MATH 18,A02,083744,Staff,29,0,30,1
1649964716889,MATH 18,A03,083745,Staff,28,0,30,2
1649964716889,MATH 18,A04,083746,Staff,27,0,30,3
1649964716889,MATH 18,B01,083748,Staff,0,1,30,30
1649964716889,MATH 18,B02,083749,Staff,18,0,30,12
1649964716889,MATH 18,B03,083750,Staff,24,0,30,6
1649964716889,MATH 18,B04,083751,Staff,22,0,30,8
1649964722925,MATH 20A,A01,083754,Staff,34,0,40,6
1649964728953,MATH 20B,A01,083756,Staff,16,0,30,14
1649964728953,MATH 20B,A02,083757,Staff,28,0,30,2
1649964734978,MATH 20C,A01,083760,Staff,15,0,30,15
1649964734978,MATH 20C,A02,083761,Staff,12,0,30,18
1649964734978,MATH 20C,B01,083762,Staff,27,0,30,3
1649964734978,MATH 20C,B02,083763,Staff,30,0,30,0
1649964741006,MATH 20D,A01,083765,Staff,13,0,30,17
1649964741006,MATH 20D,A02,083766,Staff,30,0,30,0
1649964741006,MATH 20D,A03,083767,Staff,29,0,30,1
1649964747036,MATH 20E,A01,083771,Staff,11,0,30,19
1649964747036,MATH 20E,A02,083772,Staff,24,0,30,6
1649964747036,MATH 20E,B01,083773,Staff,11,0,30,19
1649964747036,MATH 20E,B02,083774,Staff,28,0,30,2
1649964753062,MATH 103A,A01,083777,Staff,1,4,30,29
1649964753062,MATH 103A,A02,083778,Staff,0,4,30,30
1649964753062,MATH 103A,B01,083779,Staff,0,1,30,30
1649964753062,MATH 103A,B02,083780,Staff,1,0,30,29
1649964759096,MATH 105,A01,085443,Staff,0,9,30,30
1649964765118,MATH 109,A01,083213,Anzaldo; Leesa B,4,0,30,26
1649964765118,MATH 109,A02,083214,Anzaldo; Leesa B,0,0,30,30
1649964765118,MATH 109,B01,083215,Anzaldo; Leesa B,23,0,30,7
1649964765118,MATH 109,B02,083216,Anzaldo; Leesa B,18,0,30,12
1649964771155,MATH 142A,A01,083219,Chow; Bennett,0,3,30,30
1649964771155,MATH 142A,A02,083220,Chow; Bennett,0,2,30,30
1649964771155,MATH 142A,B01,083221,Chow; Bennett,0,2,30,30
1649964771155,MATH 142A,B02,083222,Chow; Bennett,0,3,30,30
1649964777179,MATH 193A,A01,083224,Staff,0,5,30,30
1649964777179,MATH 193A,A02,083225,Staff,0,3,30,30
1649964777179,MATH 193A,A03,083781,Staff,2,0,30,28
1649964777179,MATH 193A,A04,083782,Staff,13,0,30,17
1649964783211,MATH 197,001,091859,McAuley; Julian John,9999,0,9999,0
1649964789278,COGS 9,A01,083615,Staff,8,0,60,52
1649964795306,COGS 11,A01,083617,Boyle; Mary E. T.,34,0,40,6
1649964801344,COGS 13,A01,083071,Staff,0,18,40,40
1649964807387,COGS 14A,A01,092681,Staff,46,0,100,54
1649964813441,COGS 14B,A01,083073,Cheng; Tzu-Han,14,0,50,36
1649964819464,COGS 17,A01,092677,Staff,59,0,75,16
1649964825486,COGS 100,A01,083619,Staff,1,13,60,59
1649964831519,COGS 101A,A01,083621,Davis; Joshua Daniel,0,14,60,60
1649964837542,COGS 101B,A01,091572,Staff,25,0,60,35
1649964843565,COGS 101C,A01,083625,Delgado; Tania,22,0,30,8
1649964849597,COGS 107A,A01,083627,Boyle; Mary E. T.,4,0,60,56
1649964855621,COGS 118A,A01,083075,Staff,21,0,60,39
1649964861652,CSE 3,A50,083646,Miranda; Gregory Joseph,24,0,38,14
1649964861652,CSE 3,A51,083647,Miranda; Gregory Joseph,37,0,37,0
1649964867678,CSE 8A,A50,083650,Miranda; Gregory Joseph,0,3,40,40
1649964873715,CSE 11,A01,083080,Cao; Yingjun,0,37,40,40
1649964879744,CSE 12,A01,083652,Staff,41,0,100,59
1649964885772,CSE 15L,A01,083654,Staff,6,0,50,44
1649964885772,CSE 15L,A02,083655,Staff,45,0,50,5
1649964891902,CSE 20,A01,083657,Staff,64,0,80,16
1649964897926,CSE 30,A01,083084,Eldon; John,0,36,40,40
1649964903962,CSE 100,A01,083659,Cao; Yingjun,1,46,50,49
1649964909985,CSE 134B,A01,083661,Powell; Thomas Allan,0,24,65,65
1649964916014,CSE 140,A01,083663,Staff,15,0,75,60
1649964922037,CSE 140L,A01,083088,Eldon; John,11,0,75,64
1649964928059,CSE 175,A01,083665,Kumar; Rakesh,11,0,25,14
1649964934109,CSE 190,A00,092507,Dubnov; Shlomo,12,0,15,3
1649964940136,ECE 45,A01,083139,Staff,0,2,40,40
1649964946159,ECE 65,A50,083695,Staff,3,0,30,27
1649964952182,ECE 109,A01,091882,Touri; Behrouz,51,0,70,19
1649964958205,ECE 180,A00,083140,Abi Samra; Nicholas Camill,26,0,30,4
1649964958205,ECE 180,B00,083141,Abi Samra; Nicholas Camill,12,0,30,18
1649964964229,MATH 10A,A01,083735,Patchell; Gregory David,19,0,30,11
1649964964229,MATH 10A,A02,083736,Patchell; Gregory David,28,0,30,2
1649964964229,MATH 10A,A03,083737,Patchell; Gregory David,28,0,30,2
1649964970258,MATH 10B,A01,083207,Staff,6,0,30,24
1649964970258,MATH 10B,A02,083208,Staff,25,0,30,5
1649964970258,MATH 10B,B01,083739,Staff,25,0,30,5
1649964970258,MATH 10B,B02,083740,Staff,30,0,30,0
1649964976282,MATH 18,A01,083743,Staff,20,0,30,10
1649964976282,MATH 18,A02,083744,Staff,29,0,30,1
1649964976282,MATH 18,A03,083745,Staff,28,0,30,2
1649964976282,MATH 18,A04,083746,Staff,27,0,30,3
1649964976282,MATH 18,B01,083748,Staff,0,1,30,30
1649964976282,MATH 18,B02,083749,Staff,18,0,30,12
1649964976282,MATH 18,B03,083750,Staff,24,0,30,6
1649964976282,MATH 18,B04,083751,Staff,22,0,30,8
1649964982319,MATH 20A,A01,083754,Staff,34,0,40,6
1649964988347,MATH 20B,A01,083756,Staff,16,0,30,14
1649964988347,MATH 20B,A02,083757,Staff,28,0,30,2
1649964994387,MATH 20C,A01,083760,Staff,15,0,30,15
1649964994387,MATH 20C,A02,083761,Staff,12,0,30,18
1649964994387,MATH 20C,B01,083762,Staff,27,0,30,3
1649964994387,MATH 20C,B02,083763,Staff,30,0,30,0
1649965000416,MATH 20D,A01,083765,Staff,13,0,30,17
1649965000416,MATH 20D,A02,083766,Staff,30,0,30,0
1649965000416,MATH 20D,A03,083767,Staff,29,0,30,1
1649965006443,MATH 20E,A01,083771,Staff,11,0,30,19
1649965006443,MATH 20E,A02,083772,Staff,24,0,30,6
1649965006443,MATH 20E,B01,083773,Staff,11,0,30,19
1649965006443,MATH 20E,B02,083774,Staff,28,0,30,2
1649965012479,MATH 103A,A01,083777,Staff,1,4,30,29
1649965012479,MATH 103A,A02,083778,Staff,0,4,30,30
1649965012479,MATH 103A,B01,083779,Staff,0,1,30,30
1649965012479,MATH 103A,B02,083780,Staff,1,0,30,29
1649965018514,MATH 105,A01,085443,Staff,0,9,30,30
1649965024557,MATH 109,A01,083213,Anzaldo; Leesa B,2,0,30,28
1649965024557,MATH 109,A02,083214,Anzaldo; Leesa B,0,0,30,30
1649965024557,MATH 109,B01,083215,Anzaldo; Leesa B,23,0,30,7
1649965024557,MATH 109,B02,083216,Anzaldo; Leesa B,18,0,30,12
1649965030581,MATH 142A,A01,083219,Chow; Bennett,0,3,30,30
1649965030581,MATH 142A,A02,083220,Chow; Bennett,0,2,30,30
1649965030581,MATH 142A,B01,083221,Chow; Bennett,0,2,30,30
1649965030581,MATH 142A,B02,083222,Chow; Bennett,0,3,30,30
1649965036609,MATH 193A,A01,083224,Staff,0,5,30,30
1649965036609,MATH 193A,A02,083225,Staff,0,3,30,30
1649965036609,MATH 193A,A03,083781,Staff,2,0,30,28
1649965036609,MATH 193A,A04,083782,Staff,13,0,30,17
1649965042632,MATH 197,001,091859,McAuley; Julian John,9999,0,9999,0
1649965048693,COGS 9,A01,083615,Staff,8,0,60,52
1649965054720,COGS 11,A01,083617,Boyle; Mary E. T.,34,0,40,6
1649965060763,COGS 13,A01,083071,Staff,0,18,40,40
1649965066786,COGS 14A,A01,092681,Staff,46,0,100,54
1649965072828,COGS 14B,A01,083073,Cheng; Tzu-Han,14,0,50,36
1649965078861,COGS 17,A01,092677,Staff,59,0,75,16
1649965084892,COGS 100,A01,083619,Staff,1,13,60,59
1649965090923,COGS 101A,A01,083621,Davis; Joshua Daniel,0,14,60,60
1649965096948,COGS 101B,A01,091572,Staff,25,0,60,35
1649965102974,COGS 101C,A01,083625,Delgado; Tania,22,0,30,8
1649965108999,COGS 107A,A01,083627,Boyle; Mary E. T.,4,0,60,56
1649965115051,COGS 118A,A01,083075,Staff,21,0,60,39
1649965121083,CSE 3,A50,083646,Miranda; Gregory Joseph,24,0,38,14
1649965121083,CSE 3,A51,083647,Miranda; Gregory Joseph,37,0,37,0
1649965127107,CSE 8A,A50,083650,Miranda; Gregory Joseph,0,3,40,40
1649965133131,CSE 11,A01,083080,Cao; Yingjun,0,37,40,40
1649965139157,CSE 12,A01,083652,Staff,41,0,100,59
1649965145182,CSE 15L,A01,083654,Staff,6,0,50,44
1649965145182,CSE 15L,A02,083655,Staff,45,0,50,5
1649965151207,CSE 20,A01,083657,Staff,64,0,80,16
1649965157240,CSE 30,A01,083084,Eldon; John,0,36,40,40
1649965163271,CSE 100,A01,083659,Cao; Yingjun,1,46,50,49
1649965169297,CSE 134B,A01,083661,Powell; Thomas Allan,0,24,65,65
1649965175325,CSE 140,A01,083663,Staff,15,0,75,60
1649965181361,CSE 140L,A01,083088,Eldon; John,11,0,75,64
1649965187385,CSE 175,A01,083665,Kumar; Rakesh,11,0,25,14
1649965193419,CSE 190,A00,092507,Dubnov; Shlomo,12,0,15,3
1649965199443,ECE 45,A01,083139,Staff,0,2,40,40
1649965205470,ECE 65,A50,083695,Staff,3,0,30,27
1649965211495,ECE 109,A01,091882,Touri; Behrouz,51,0,70,19
1649965217519,ECE 180,A00,083140,Abi Samra; Nicholas Camill,26,0,30,4
1649965217519,ECE 180,B00,083141,Abi Samra; Nicholas Camill,12,0,30,18
1649965223548,MATH 10A,A01,083735,Patchell; Gregory David,19,0,30,11
1649965223548,MATH 10A,A02,083736,Patchell; Gregory David,28,0,30,2
1649965223548,MATH 10A,A03,083737,Patchell; Gregory David,28,0,30,2
1649965229580,MATH 10B,A01,083207,Staff,6,0,30,24
1649965229580,MATH 10B,A02,083208,Staff,25,0,30,5
1649965229580,MATH 10B,B01,083739,Staff,25,0,30,5
1649965229580,MATH 10B,B02,083740,Staff,30,0,30,0
1649965235624,MATH 18,A01,083743,Staff,20,0,30,10
1649965235624,MATH 18,A02,083744,Staff,29,0,30,1
1649965235624,MATH 18,A03,083745,Staff,28,0,30,2
1649965235624,MATH 18,A04,083746,Staff,27,0,30,3
1649965235624,MATH 18,B01,083748,Staff,0,1,30,30
1649965235624,MATH 18,B02,083749,Staff,18,0,30,12
1649965235624,MATH 18,B03,083750,Staff,24,0,30,6
1649965235624,MATH 18,B04,083751,Staff,22,0,30,8
1649965241652,MATH 20A,A01,083754,Staff,34,0,40,6
1649965247681,MATH 20B,A01,083756,Staff,16,0,30,14
1649965247681,MATH 20B,A02,083757,Staff,28,0,30,2
1649965253708,MATH 20C,A01,083760,Staff,15,0,30,15
1649965253708,MATH 20C,A02,083761,Staff,12,0,30,18
1649965253708,MATH 20C,B01,083762,Staff,27,0,30,3
1649965253708,MATH 20C,B02,083763,Staff,30,0,30,0
1649965259745,MATH 20D,A01,083765,Staff,13,0,30,17
1649965259745,MATH 20D,A02,083766,Staff,30,0,30,0
1649965259745,MATH 20D,A03,083767,Staff,29,0,30,1
1649965265770,MATH 20E,A01,083771,Staff,11,0,30,19
1649965265770,MATH 20E,A02,083772,Staff,24,0,30,6
1649965265770,MATH 20E,B01,083773,Staff,11,0,30,19
1649965265770,MATH 20E,B02,083774,Staff,28,0,30,2
1649965271806,MATH 103A,A01,083777,Staff,1,4,30,29
1649965271806,MATH 103A,A02,083778,Staff,0,4,30,30
1649965271806,MATH 103A,B01,083779,Staff,0,1,30,30
1649965271806,MATH 103A,B02,083780,Staff,1,0,30,29
1649965277851,MATH 105,A01,085443,Staff,0,9,30,30
1649965283874,MATH 109,A01,083213,Anzaldo; Leesa B,2,0,30,28
1649965283874,MATH 109,A02,083214,Anzaldo; Leesa B,0,0,30,30
1649965283874,MATH 109,B01,083215,Anzaldo; Leesa B,23,0,30,7
1649965283874,MATH 109,B02,083216,Anzaldo; Leesa B,18,0,30,12
1649965289906,MATH 142A,A01,083219,Chow; Bennett,0,3,30,30
1649965289906,MATH 142A,A02,083220,Chow; Bennett,0,2,30,30
1649965289906,MATH 142A,B01,083221,Chow; Bennett,0,2,30,30
1649965289906,MATH 142A,B02,083222,Chow; Bennett,0,3,30,30
1649965295928,MATH 193A,A01,083224,Staff,0,5,30,30
1649965295928,MATH 193A,A02,083225,Staff,0,3,30,30
1649965295928,MATH 193A,A03,083781,Staff,2,0,30,28
1649965295928,MATH 193A,A04,083782,Staff,13,0,30,17
1649965301955,MATH 197,001,091859,McAuley; Julian John,9999,0,9999,0
1649965308006,COGS 9,A01,083615,Staff,8,0,60,52
1649965314044,COGS 11,A01,083617,Boyle; Mary E. T.,34,0,40,6
1649965320067,COGS 13,A01,083071,Staff,0,17,40,40
1649965326100,COGS 14A,A01,092681,Staff,45,0,100,55
1649965332124,COGS 14B,A01,083073,Cheng; Tzu-Han,14,0,50,36
1649965338147,COGS 17,A01,092677,Staff,59,0,75,16
1649965344173,COGS 100,A01,083619,Staff,1,14,60,59
1649965350196,COGS 101A,A01,083621,Davis; Joshua Daniel,0,14,60,60
1649965356229,COGS 101B,A01,091572,Staff,25,0,60,35
1649965362258,COGS 101C,A01,083625,Delgado; Tania,22,0,30,8
1649965368289,COGS 107A,A01,083627,Boyle; Mary E. T.,4,0,60,56
1649965374333,COGS 118A,A01,083075,Staff,21,0,60,39
1649965380358,CSE 3,A50,083646,Miranda; Gregory Joseph,23,0,38,15
1649965380358,CSE 3,A51,083647,Miranda; Gregory Joseph,37,0,37,0
1649965386382,CSE 8A,A50,083650,Miranda; Gregory Joseph,1,3,40,39
1649965392426,CSE 11,A01,083080,Cao; Yingjun,0,38,40,40
1649965398456,CSE 12,A01,083652,Staff,41,0,100,59
1649965404480,CSE 15L,A01,083654,Staff,6,0,50,44
1649965404480,CSE 15L,A02,083655,Staff,45,0,50,5
1649965410518,CSE 20,A01,083657,Staff,64,0,80,16
1649965416556,CSE 30,A01,083084,Eldon; John,0,38,40,40
1649965422583,CSE 100,A01,083659,Cao; Yingjun,1,46,50,49
1649965428615,CSE 134B,A01,083661,Powell; Thomas Allan,0,24,65,65
1649965434644,CSE 140,A01,083663,Staff,15,0,75,60
1649965440667,CSE 140L,A01,083088,Eldon; John,11,0,75,64
1649965446692,CSE 175,A01,083665,Kumar; Rakesh,11,0,25,14
1649965452728,CSE 190,A00,092507,Dubnov; Shlomo,12,0,15,3
1649965458750,ECE 45,A01,083139,Staff,0,2,40,40
1649965464773,ECE 65,A50,083695,Staff,3,0,30,27
1649965470796,ECE 109,A01,091882,Touri; Behrouz,51,0,70,19
1649965476820,ECE 180,A00,083140,Abi Samra; Nicholas Camill,26,0,30,4
1649965476820,ECE 180,B00,083141,Abi Samra; Nicholas Camill,12,0,30,18
1649965482844,MATH 10A,A01,083735,Patchell; Gregory David,19,0,30,11
1649965482844,MATH 10A,A02,083736,Patchell; Gregory David,28,0,30,2
1649965482844,MATH 10A,A03,083737,Patchell; Gregory David,28,0,30,2
1649965488960,MATH 10B,A01,083207,Staff,6,0,30,24
1649965488960,MATH 10B,A02,083208,Staff,25,0,30,5
1649965488960,MATH 10B,B01,083739,Staff,25,0,30,5
1649965488960,MATH 10B,B02,083740,Staff,30,0,30,0
1649965494996,MATH 18,A01,083743,Staff,20,0,30,10
1649965494996,MATH 18,A02,083744,Staff,29,0,30,1
1649965494996,MATH 18,A03,083745,Staff,28,0,30,2
1649965494996,MATH 18,A04,083746,Staff,27,0,30,3
1649965494996,MATH 18,B01,083748,Staff,0,1,30,30
1649965494996,MATH 18,B02,083749,Staff,18,0,30,12
1649965494996,MATH 18,B03,083750,Staff,24,0,30,6
1649965494996,MATH 18,B04,083751,Staff,22,0,30,8
1649965501025,MATH 20A,A01,083754,Staff,33,0,40,7
1649965507057,MATH 20B,A01,083756,Staff,16,0,30,14
1649965507057,MATH 20B,A02,083757,Staff,28,0,30,2
1649965513085,MATH 20C,A01,083760,Staff,15,0,30,15
1649965513085,MATH 20C,A02,083761,Staff,10,0,30,20
1649965513085,MATH 20C,B01,083762,Staff,27,0,30,3
1649965513085,MATH 20C,B02,083763,Staff,30,0,30,0
1649965519113,MATH 20D,A01,083765,Staff,13,0,30,17
1649965519113,MATH 20D,A02,083766,Staff,30,0,30,0
1649965519113,MATH 20D,A03,083767,Staff,29,0,30,1
1649965525157,MATH 20E,A01,083771,Staff,11,0,30,19
1649965525157,MATH 20E,A02,083772,Staff,24,0,30,6
1649965525157,MATH 20E,B01,083773,Staff,11,0,30,19
1649965525157,MATH 20E,B02,083774,Staff,28,0,30,2
1649965531181,MATH 103A,A01,083777,Staff,1,4,30,29
1649965531181,MATH 103A,A02,083778,Staff,0,4,30,30
1649965531181,MATH 103A,B01,083779,Staff,0,1,30,30
1649965531181,MATH 103A,B02,083780,Staff,0,0,30,30
1649965537208,MATH 105,A01,085443,Staff,0,9,30,30
1649965543232,MATH 109,A01,083213,Anzaldo; Leesa B,1,0,30,29
1649965543232,MATH 109,A02,083214,Anzaldo; Leesa B,0,0,30,30
1649965543232,MATH 109,B01,083215,Anzaldo; Leesa B,23,0,30,7
1649965543232,MATH 109,B02,083216,Anzaldo; Leesa B,17,0,30,13
1649965549256,MATH 142A,A01,083219,Chow; Bennett,0,3,30,30
1649965549256,MATH 142A,A02,083220,Chow; Bennett,0,2,30,30
1649965549256,MATH 142A,B01,083221,Chow; Bennett,0,2,30,30
1649965549256,MATH 142A,B02,083222,Chow; Bennett,0,3,30,30
1649965555288,MATH 193A,A01,083224,Staff,0,5,30,30
1649965555288,MATH 193A,A02,083225,Staff,0,3,30,30
1649965555288,MATH 193A,A03,083781,Staff,2,0,30,28
1649965555288,MATH 193A,A04,083782,Staff,13,0,30,17
1649965561313,MATH 197,001,091859,McAuley; Julian John,9999,0,9999,0
1649965567408,COGS 9,A01,083615,Staff,7,0,60,53
1649965573442,COGS 11,A01,083617,Boyle; Mary E. T.,34,0,40,6
1649965579479,COGS 13,A01,083071,Staff,0,18,40,40
1649965585517,COGS 14A,A01,092681,Staff,45,0,100,55
1649965591540,COGS 14B,A01,083073,Cheng; Tzu-Han,14,0,50,36
1649965597564,COGS 17,A01,092677,Staff,59,0,75,16
1649965603588,COGS 100,A01,083619,Staff,1,14,60,59
1649965609636,COGS 101A,A01,083621,Davis; Joshua Daniel,0,15,60,60
1649965615664,COGS 101B,A01,091572,Staff,25,0,60,35
1649965621689,COGS 101C,A01,083625,Delgado; Tania,22,0,30,8
1649965627717,COGS 107A,A01,083627,Boyle; Mary E. T.,5,0,60,55
1649965633749,COGS 118A,A01,083075,Staff,21,0,60,39
1649965639772,CSE 3,A50,083646,Miranda; Gregory Joseph,23,0,38,15
1649965639772,CSE 3,A51,083647,Miranda; Gregory Joseph,37,0,37,0
1649965645807,CSE 8A,A50,083650,Miranda; Gregory Joseph,1,3,40,39
1649965651833,CSE 11,A01,083080,Cao; Yingjun,0,38,40,40
1649965657860,CSE 12,A01,083652,Staff,41,0,100,59
1649965663889,CSE 15L,A01,083654,Staff,6,0,50,44
1649965663889,CSE 15L,A02,083655,Staff,45,0,50,5
1649965669921,CSE 20,A01,083657,Staff,64,0,80,16
1649965675944,CSE 30,A01,083084,Eldon; John,0,38,40,40
1649965681978,CSE 100,A01,083659,Cao; Yingjun,1,46,50,49
1649965688008,CSE 134B,A01,083661,Powell; Thomas Allan,0,24,65,65
1649965694034,CSE 140,A01,083663,Staff,15,0,75,60
1649965700063,CSE 140L,A01,083088,Eldon; John,11,0,75,64
1649965706099,CSE 175,A01,083665,Kumar; Rakesh,11,0,25,14
1649965712121,CSE 190,A00,092507,Dubnov; Shlomo,12,0,15,3
1649965718146,ECE 45,A01,083139,Staff,0,2,40,40
1649965724184,ECE 65,A50,083695,Staff,3,0,30,27
1649965730209,ECE 109,A01,091882,Touri; Behrouz,51,0,70,19
1649965736232,ECE 180,A00,083140,Abi Samra; Nicholas Camill,26,0,30,4
1649965736232,ECE 180,B00,083141,Abi Samra; Nicholas Camill,12,0,30,18
1649965742259,MATH 10A,A01,083735,Patchell; Gregory David,19,0,30,11
1649965742259,MATH 10A,A02,083736,Patchell; Gregory David,28,0,30,2
1649965742259,MATH 10A,A03,083737,Patchell; Gregory David,28,0,30,2
1649965748283,MATH 10B,A01,083207,Staff,6,0,30,24
1649965748283,MATH 10B,A02,083208,Staff,25,0,30,5
1649965748283,MATH 10B,B01,083739,Staff,25,0,30,5
1649965748283,MATH 10B,B02,083740,Staff,30,0,30,0
1649965754315,MATH 18,A01,083743,Staff,20,0,30,10
1649965754315,MATH 18,A02,083744,Staff,29,0,30,1
1649965754315,MATH 18,A03,083745,Staff,28,0,30,2
1649965754315,MATH 18,A04,083746,Staff,27,0,30,3
1649965754315,MATH 18,B01,083748,Staff,0,1,30,30
1649965754315,MATH 18,B02,083749,Staff,18,0,30,12
1649965754315,MATH 18,B03,083750,Staff,24,0,30,6
1649965754315,MATH 18,B04,083751,Staff,21,0,30,9
1649965760346,MATH 20A,A01,083754,Staff,33,0,40,7
1649965766377,MATH 20B,A01,083756,Staff,16,0,30,14
1649965766377,MATH 20B,A02,083757,Staff,28,0,30,2
1649965772399,MATH 20C,A01,083760,Staff,15,0,30,15
1649965772399,MATH 20C,A02,083761,Staff,10,0,30,20
1649965772399,MATH 20C,B01,083762,Staff,27,0,30,3
1649965772399,MATH 20C,B02,083763,Staff,30,0,30,0
1649965778422,MATH 20D,A01,083765,Staff,13,0,30,17
1649965778422,MATH 20D,A02,083766,Staff,30,0,30,0
1649965778422,MATH 20D,A03,083767,Staff,29,0,30,1
1649965784469,MATH 20E,A01,083771,Staff,11,0,30,19
1649965784469,MATH 20E,A02,083772,Staff,24,0,30,6
1649965784469,MATH 20E,B01,083773,Staff,11,0,30,19
1649965784469,MATH 20E,B02,083774,Staff,28,0,30,2
1649965790494,MATH 103A,A01,083777,Staff,1,4,30,29
1649965790494,MATH 103A,A02,083778,Staff,0,4,30,30
1649965790494,MATH 103A,B01,083779,Staff,0,1,30,30
1649965790494,MATH 103A,B02,083780,Staff,0,0,30,30
1649965796525,MATH 105,A01,085443,Staff,0,9,30,30
1649965802552,MATH 109,A01,083213,Anzaldo; Leesa B,1,0,30,29
1649965802552,MATH 109,A02,083214,Anzaldo; Leesa B,0,0,30,30
1649965802552,MATH 109,B01,083215,Anzaldo; Leesa B,23,0,30,7
1649965802552,MATH 109,B02,083216,Anzaldo; Leesa B,17,0,30,13
1649965808575,MATH 142A,A01,083219,Chow; Bennett,0,3,30,30
1649965808575,MATH 142A,A02,083220,Chow; Bennett,0,2,30,30
1649965808575,MATH 142A,B01,083221,Chow; Bennett,0,2,30,30
1649965808575,MATH 142A,B02,083222,Chow; Bennett,0,3,30,30
1649965814598,MATH 193A,A01,083224,Staff,0,5,30,30
1649965814598,MATH 193A,A02,083225,Staff,0,3,30,30
1649965814598,MATH 193A,A03,083781,Staff,2,0,30,28
1649965814598,MATH 193A,A04,083782,Staff,13,0,30,17
1649965820623,MATH 197,001,091859,McAuley; Julian John,9999,0,9999,0
1649965826687,COGS 9,A01,083615,Staff,7,0,60,53
1649965832717,COGS 11,A01,083617,Boyle; Mary E. T.,34,0,40,6
1649965838742,COGS 13,A01,083071,Staff,0,18,40,40
1649965844773,COGS 14A,A01,092681,Staff,43,0,100,57
1649965850800,COGS 14B,A01,083073,Cheng; Tzu-Han,14,0,50,36
1649965856826,COGS 17,A01,092677,Staff,57,0,75,18
1649965862870,COGS 100,A01,083619,Staff,1,14,60,59
1649965868894,COGS 101A,A01,083621,Davis; Joshua Daniel,0,15,60,60
1649965874919,COGS 101B,A01,091572,Staff,25,0,60,35
1649965880953,COGS 101C,A01,083625,Delgado; Tania,22,0,30,8
1649965886976,COGS 107A,A01,083627,Boyle; Mary E. T.,5,0,60,55
1649965893006,COGS 118A,A01,083075,Staff,21,0,60,39
1649965899041,CSE 3,A50,083646,Miranda; Gregory Joseph,23,0,38,15
1649965899041,CSE 3,A51,083647,Miranda; Gregory Joseph,37,0,37,0
1649965905065,CSE 8A,A50,083650,Miranda; Gregory Joseph,1,3,40,39
1649965911088,CSE 11,A01,083080,Cao; Yingjun,0,38,40,40
1649965917135,CSE 12,A01,083652,Staff,39,0,100,61
1649965923161,CSE 15L,A01,083654,Staff,5,0,50,45
1649965923161,CSE 15L,A02,083655,Staff,44,0,50,6
1649965929190,CSE 20,A01,083657,Staff,64,0,80,16
1649965935214,CSE 30,A01,083084,Eldon; John,0,39,40,40
1649965941240,CSE 100,A01,083659,Cao; Yingjun,1,46,50,49
1649965947269,CSE 134B,A01,083661,Powell; Thomas Allan,0,24,65,65
1649965953300,CSE 140,A01,083663,Staff,15,0,75,60
1649965959327,CSE 140L,A01,083088,Eldon; John,11,0,75,64
1649965965366,CSE 175,A01,083665,Kumar; Rakesh,11,0,25,14
1649965971389,CSE 190,A00,092507,Dubnov; Shlomo,12,0,15,3
1649965977413,ECE 45,A01,083139,Staff,0,2,40,40
1649965983436,ECE 65,A50,083695,Staff,3,0,30,27
1649965989463,ECE 109,A01,091882,Touri; Behrouz,51,0,70,19
1649965995486,ECE 180,A00,083140,Abi Samra; Nicholas Camill,26,0,30,4
1649965995486,ECE 180,B00,083141,Abi Samra; Nicholas Camill,12,0,30,18
1649966001512,MATH 10A,A01,083735,Patchell; Gregory David,19,0,30,11
1649966001512,MATH 10A,A02,083736,Patchell; Gregory David,28,0,30,2
1649966001512,MATH 10A,A03,083737,Patchell; Gregory David,28,0,30,2
1649966007537,MATH 10B,A01,083207,Staff,6,0,30,24
1649966007537,MATH 10B,A02,083208,Staff,25,0,30,5
1649966007537,MATH 10B,B01,083739,Staff,25,0,30,5
1649966007537,MATH 10B,B02,083740,Staff,30,0,30,0
1649966013569,MATH 18,A01,083743,Staff,20,0,30,10
1649966013569,MATH 18,A02,083744,Staff,29,0,30,1
1649966013569,MATH 18,A03,083745,Staff,28,0,30,2
1649966013569,MATH 18,A04,083746,Staff,27,0,30,3
1649966013569,MATH 18,B01,083748,Staff,0,1,30,30
1649966013569,MATH 18,B02,083749,Staff,17,0,30,13
1649966013569,MATH 18,B03,083750,Staff,24,0,30,6
1649966013569,MATH 18,B04,083751,Staff,20,0,30,10
1649966019598,MATH 20A,A01,083754,Staff,33,0,40,7
1649966025636,MATH 20B,A01,083756,Staff,15,0,30,15
1649966025636,MATH 20B,A02,083757,Staff,28,0,30,2
1649966031665,MATH 20C,A01,083760,Staff,15,0,30,15
1649966031665,MATH 20C,A02,083761,Staff,10,0,30,20
1649966031665,MATH 20C,B01,083762,Staff,27,0,30,3
1649966031665,MATH 20C,B02,083763,Staff,30,0,30,0
1649966037689,MATH 20D,A01,083765,Staff,12,0,30,18
1649966037689,MATH 20D,A02,083766,Staff,30,0,30,0
1649966037689,MATH 20D,A03,083767,Staff,28,0,30,2
1649966043714,MATH 20E,A01,083771,Staff,11,0,30,19
1649966043714,MATH 20E,A02,083772,Staff,24,0,30,6
1649966043714,MATH 20E,B01,083773,Staff,10,0,30,20
1649966043714,MATH 20E,B02,083774,Staff,28,0,30,2
1649966049737,MATH 103A,A01,083777,Staff,1,4,30,29
1649966049737,MATH 103A,A02,083778,Staff,0,4,30,30
1649966049737,MATH 103A,B01,083779,Staff,0,1,30,30
1649966049737,MATH 103A,B02,083780,Staff,0,1,30,30
1649966055760,MATH 105,A01,085443,Staff,0,9,30,30
1649966061790,MATH 109,A01,083213,Anzaldo; Leesa B,1,0,30,29
1649966061790,MATH 109,A02,083214,Anzaldo; Leesa B,0,0,30,30
1649966061790,MATH 109,B01,083215,Anzaldo; Leesa B,22,0,30,8
1649966061790,MATH 109,B02,083216,Anzaldo; Leesa B,17,0,30,13
1649966067823,MATH 142A,A01,083219,Chow; Bennett,0,3,30,30
1649966067823,MATH 142A,A02,083220,Chow; Bennett,0,2,30,30
1649966067823,MATH 142A,B01,083221,Chow; Bennett,0,2,30,30
1649966067823,MATH 142A,B02,083222,Chow; Bennett,0,3,30,30
1649966073852,MATH 193A,A01,083224,Staff,0,5,30,30
1649966073852,MATH 193A,A02,083225,Staff,0,3,30,30
1649966073852,MATH 193A,A03,083781,Staff,2,0,30,28
1649966073852,MATH 193A,A04,083782,Staff,13,0,30,17
1649966079874,MATH 197,001,091859,McAuley; Julian John,9999,0,9999,0
1649966086016,COGS 9,A01,083615,Staff,6,0,60,54
1649966092040,COGS 11,A01,083617,Boyle; Mary E. T.,34,0,40,6
1649966098063,COGS 13,A01,083071,Staff,0,18,40,40
1649966104087,COGS 14A,A01,092681,Staff,42,0,100,58
1649966110113,COGS 14B,A01,083073,Cheng; Tzu-Han,14,0,50,36
1649966116195,COGS 17,A01,092677,Staff,57,0,75,18
1649966122232,COGS 100,A01,083619,Staff,1,14,60,59
1649966128281,COGS 101A,A01,083621,Davis; Joshua Daniel,0,15,60,60
1649966134306,COGS 101B,A01,091572,Staff,25,0,60,35
1649966140337,COGS 101C,A01,083625,Delgado; Tania,22,0,30,8
1649966146370,COGS 107A,A01,083627,Boyle; Mary E. T.,4,0,60,56
1649966152392,COGS 118A,A01,083075,Staff,21,0,60,39
1649966158425,CSE 3,A50,083646,Miranda; Gregory Joseph,23,0,38,15
1649966158425,CSE 3,A51,083647,Miranda; Gregory Joseph,37,0,37,0
1649966164468,CSE 8A,A50,083650,Miranda; Gregory Joseph,1,3,40,39
1649966170491,CSE 11,A01,083080,Cao; Yingjun,0,38,40,40
1649966176514,CSE 12,A01,083652,Staff,39,0,100,61
1649966182540,CSE 15L,A01,083654,Staff,5,0,50,45
1649966182540,CSE 15L,A02,083655,Staff,44,0,50,6
1649966188572,CSE 20,A01,083657,Staff,64,0,80,16
1649966194599,CSE 30,A01,083084,Eldon; John,0,40,40,40
1649966200622,CSE 100,A01,083659,Cao; Yingjun,1,46,50,49
1649966206651,CSE 134B,A01,083661,Powell; Thomas Allan,0,24,65,65
1649966212704,CSE 140,A01,083663,Staff,15,0,75,60
1649966218727,CSE 140L,A01,083088,Eldon; John,11,0,75,64
1649966224752,CSE 175,A01,083665,Kumar; Rakesh,11,0,25,14
1649966230783,CSE 190,A00,092507,Dubnov; Shlomo,12,0,15,3
1649966236811,ECE 45,A01,083139,Staff,0,2,40,40
1649966242836,ECE 65,A50,083695,Staff,3,0,30,27
1649966248867,ECE 109,A01,091882,Touri; Behrouz,51,0,70,19
1649966254898,ECE 180,A00,083140,Abi Samra; Nicholas Camill,26,0,30,4
1649966254898,ECE 180,B00,083141,Abi Samra; Nicholas Camill,12,0,30,18
1649966260922,MATH 10A,A01,083735,Patchell; Gregory David,19,0,30,11
1649966260922,MATH 10A,A02,083736,Patchell; Gregory David,28,0,30,2
1649966260922,MATH 10A,A03,083737,Patchell; Gregory David,28,0,30,2
1649966266949,MATH 10B,A01,083207,Staff,6,0,30,24
1649966266949,MATH 10B,A02,083208,Staff,25,0,30,5
1649966266949,MATH 10B,B01,083739,Staff,25,0,30,5
1649966266949,MATH 10B,B02,083740,Staff,30,0,30,0
1649966272977,MATH 18,A01,083743,Staff,20,0,30,10
1649966272977,MATH 18,A02,083744,Staff,29,0,30,1
1649966272977,MATH 18,A03,083745,Staff,28,0,30,2
1649966272977,MATH 18,A04,083746,Staff,27,0,30,3
1649966272977,MATH 18,B01,083748,Staff,0,1,30,30
1649966272977,MATH 18,B02,083749,Staff,17,0,30,13
1649966272977,MATH 18,B03,083750,Staff,24,0,30,6
1649966272977,MATH 18,B04,083751,Staff,20,0,30,10
1649966278999,MATH 20A,A01,083754,Staff,33,0,40,7
1649966285035,MATH 20B,A01,083756,Staff,15,0,30,15
1649966285035,MATH 20B,A02,083757,Staff,28,0,30,2
1649966291066,MATH 20C,A01,083760,Staff,15,0,30,15
1649966291066,MATH 20C,A02,083761,Staff,10,0,30,20
1649966291066,MATH 20C,B01,083762,Staff,27,0,30,3
1649966291066,MATH 20C,B02,083763,Staff,30,0,30,0
1649966297095,MATH 20D,A01,083765,Staff,12,0,30,18
1649966297095,MATH 20D,A02,083766,Staff,30,0,30,0
1649966297095,MATH 20D,A03,083767,Staff,28,0,30,2
1649966303122,MATH 20E,A01,083771,Staff,11,0,30,19
1649966303122,MATH 20E,A02,083772,Staff,24,0,30,6
1649966303122,MATH 20E,B01,083773,Staff,10,0,30,20
1649966303122,MATH 20E,B02,083774,Staff,28,0,30,2
1649966309145,MATH 103A,A01,083777,Staff,1,4,30,29
1649966309145,MATH 103A,A02,083778,Staff,0,4,30,30
1649966309145,MATH 103A,B01,083779,Staff,0,1,30,30
1649966309145,MATH 103A,B02,083780,Staff,0,1,30,30
1649966315169,MATH 105,A01,085443,Staff,0,10,30,30
1649966321200,MATH 109,A01,083213,Anzaldo; Leesa B,1,0,30,29
1649966321200,MATH 109,A02,083214,Anzaldo; Leesa B,0,0,30,30
1649966321200,MATH 109,B01,083215,Anzaldo; Leesa B,22,0,30,8
1649966321200,MATH 109,B02,083216,Anzaldo; Leesa B,17,0,30,13
1649966327229,MATH 142A,A01,083219,Chow; Bennett,0,3,30,30
1649966327229,MATH 142A,A02,083220,Chow; Bennett,0,2,30,30
1649966327229,MATH 142A,B01,083221,Chow; Bennett,0,2,30,30
1649966327229,MATH 142A,B02,083222,Chow; Bennett,0,3,30,30
1649966333268,MATH 193A,A01,083224,Staff,0,5,30,30
1649966333268,MATH 193A,A02,083225,Staff,0,3,30,30
1649966333268,MATH 193A,A03,083781,Staff,2,0,30,28
1649966333268,MATH 193A,A04,083782,Staff,13,0,30,17
1649966339291,MATH 197,001,091859,McAuley; Julian John,9999,0,9999,0
1649966345339,COGS 9,A01,083615,Staff,5,0,60,55
1649966351361,COGS 11,A01,083617,Boyle; Mary E. T.,34,0,40,6
1649966357387,COGS 13,A01,083071,Staff,0,18,40,40
1649966363413,COGS 14A,A01,092681,Staff,42,0,100,58
1649966369448,COGS 14B,A01,083073,Cheng; Tzu-Han,14,0,50,36
1649966375479,COGS 17,A01,092677,Staff,57,0,75,18
1649966381503,COGS 100,A01,083619,Staff,1,15,60,59
1649966387527,COGS 101A,A01,083621,Davis; Joshua Daniel,0,15,60,60
1649966393564,COGS 101B,A01,091572,Staff,25,0,60,35
1649966399591,COGS 101C,A01,083625,Delgado; Tania,22,0,30,8
1649966405617,COGS 107A,A01,083627,Boyle; Mary E. T.,4,0,60,56
1649966411642,COGS 118A,A01,083075,Staff,21,0,60,39
1649966417688,CSE 3,A50,083646,Miranda; Gregory Joseph,23,0,38,15
1649966417688,CSE 3,A51,083647,Miranda; Gregory Joseph,37,0,37,0
1649966423736,CSE 8A,A50,083650,Miranda; Gregory Joseph,1,3,40,39
1649966429760,CSE 11,A01,083080,Cao; Yingjun,0,39,40,40
1649966435810,CSE 12,A01,083652,Staff,39,0,100,61
1649966441841,CSE 15L,A01,083654,Staff,5,0,50,45
1649966441841,CSE 15L,A02,083655,Staff,44,0,50,6
1649966447864,CSE 20,A01,083657,Staff,64,0,80,16
1649966453901,CSE 30,A01,083084,Eldon; John,0,40,40,40
1649966459928,CSE 100,A01,083659,Cao; Yingjun,1,46,50,49
1649966465953,CSE 134B,A01,083661,Powell; Thomas Allan,0,24,65,65
1649966471979,CSE 140,A01,083663,Staff,15,0,75,60
1649966478002,CSE 140L,A01,083088,Eldon; John,11,0,75,64
1649966484031,CSE 175,A01,083665,Kumar; Rakesh,11,0,25,14
1649966490055,CSE 190,A00,092507,Dubnov; Shlomo,12,0,15,3
1649966496085,ECE 45,A01,083139,Staff,0,2,40,40
1649966502108,ECE 65,A50,083695,Staff,3,0,30,27
1649966508131,ECE 109,A01,091882,Touri; Behrouz,51,0,70,19
1649966514158,ECE 180,A00,083140,Abi Samra; Nicholas Camill,26,0,30,4
1649966514158,ECE 180,B00,083141,Abi Samra; Nicholas Camill,12,0,30,18
1649966520182,MATH 10A,A01,083735,Patchell; Gregory David,19,0,30,11
1649966520182,MATH 10A,A02,083736,Patchell; Gregory David,28,0,30,2
1649966520182,MATH 10A,A03,083737,Patchell; Gregory David,27,0,30,3
1649966526210,MATH 10B,A01,083207,Staff,6,0,30,24
1649966526210,MATH 10B,A02,083208,Staff,25,0,30,5
1649966526210,MATH 10B,B01,083739,Staff,25,0,30,5
1649966526210,MATH 10B,B02,083740,Staff,30,0,30,0
1649966532250,MATH 18,A01,083743,Staff,20,0,30,10
1649966532250,MATH 18,A02,083744,Staff,29,0,30,1
1649966532250,MATH 18,A03,083745,Staff,28,0,30,2
1649966532250,MATH 18,A04,083746,Staff,27,0,30,3
1649966532250,MATH 18,B01,083748,Staff,0,1,30,30
1649966532250,MATH 18,B02,083749,Staff,17,0,30,13
1649966532250,MATH 18,B03,083750,Staff,24,0,30,6
1649966532250,MATH 18,B04,083751,Staff,20,0,30,10
1649966538272,MATH 20A,A01,083754,Staff,33,0,40,7
1649966544299,MATH 20B,A01,083756,Staff,16,0,30,14
1649966544299,MATH 20B,A02,083757,Staff,28,0,30,2
1649966550322,MATH 20C,A01,083760,Staff,13,0,30,17
1649966550322,MATH 20C,A02,083761,Staff,10,0,30,20
1649966550322,MATH 20C,B01,083762,Staff,27,0,30,3
1649966550322,MATH 20C,B02,083763,Staff,30,0,30,0
1649966556354,MATH 20D,A01,083765,Staff,12,0,30,18
1649966556354,MATH 20D,A02,083766,Staff,30,0,30,0
1649966556354,MATH 20D,A03,083767,Staff,28,0,30,2
1649966562380,MATH 20E,A01,083771,Staff,11,0,30,19
1649966562380,MATH 20E,A02,083772,Staff,24,0,30,6
1649966562380,MATH 20E,B01,083773,Staff,9,0,30,21
1649966562380,MATH 20E,B02,083774,Staff,28,0,30,2
1649966568404,MATH 103A,A01,083777,Staff,1,4,30,29
1649966568404,MATH 103A,A02,083778,Staff,0,4,30,30
1649966568404,MATH 103A,B01,083779,Staff,0,2,30,30
1649966568404,MATH 103A,B02,083780,Staff,0,1,30,30
1649966574429,MATH 105,A01,085443,Staff,0,10,30,30
1649966580457,MATH 109,A01,083213,Anzaldo; Leesa B,0,0,30,30
1649966580457,MATH 109,A02,083214,Anzaldo; Leesa B,0,0,30,30
1649966580457,MATH 109,B01,083215,Anzaldo; Leesa B,22,0,30,8
1649966580457,MATH 109,B02,083216,Anzaldo; Leesa B,17,0,30,13
1649966586484,MATH 142A,A01,083219,Chow; Bennett,0,3,30,30
1649966586484,MATH 142A,A02,083220,Chow; Bennett,0,2,30,30
1649966586484,MATH 142A,B01,083221,Chow; Bennett,0,3,30,30
1649966586484,MATH 142A,B02,083222,Chow; Bennett,0,3,30,30
1649966592515,MATH 193A,A01,083224,Staff,0,5,30,30
1649966592515,MATH 193A,A02,083225,Staff,0,3,30,30
1649966592515,MATH 193A,A03,083781,Staff,2,0,30,28
1649966592515,MATH 193A,A04,083782,Staff,13,0,30,17
1649966598538,MATH 197,001,091859,McAuley; Julian John,9999,0,9999,0
1649966604616,COGS 9,A01,083615,Staff,5,0,60,55
1649966610639,COGS 11,A01,083617,Boyle; Mary E. T.,34,0,40,6
1649966616663,COGS 13,A01,083071,Staff,0,18,40,40
1649966622684,COGS 14A,A01,092681,Staff,40,0,100,60
1649966628717,COGS 14B,A01,083073,Cheng; Tzu-Han,14,0,50,36
1649966634740,COGS 17,A01,092677,Staff,57,0,75,18
1649966640778,COGS 100,A01,083619,Staff,1,15,60,59
1649966646818,COGS 101A,A01,083621,Davis; Joshua Daniel,0,15,60,60
1649966652843,COGS 101B,A01,091572,Staff,25,0,60,35
1649966658871,COGS 101C,A01,083625,Delgado; Tania,22,0,30,8
1649966664896,COGS 107A,A01,083627,Boyle; Mary E. T.,4,0,60,56
1649966670919,COGS 118A,A01,083075,Staff,21,0,60,39
1649966677036,CSE 3,A50,083646,Miranda; Gregory Joseph,23,0,38,15
1649966677036,CSE 3,A51,083647,Miranda; Gregory Joseph,37,0,37,0
1649966683078,CSE 8A,A50,083650,Miranda; Gregory Joseph,1,3,40,39
1649966689109,CSE 11,A01,083080,Cao; Yingjun,0,40,40,40
1649966695144,CSE 12,A01,083652,Staff,39,0,100,61
1649966701168,CSE 15L,A01,083654,Staff,5,0,50,45
1649966701168,CSE 15L,A02,083655,Staff,44,0,50,6
1649966707192,CSE 20,A01,083657,Staff,64,0,80,16
1649966713218,CSE 30,A01,083084,Eldon; John,0,41,40,40
1649966719245,CSE 100,A01,083659,Cao; Yingjun,1,46,50,49
1649966725269,CSE 134B,A01,083661,Powell; Thomas Allan,0,24,65,65
1649966731298,CSE 140,A01,083663,Staff,15,0,75,60
1649966737321,CSE 140L,A01,083088,Eldon; John,11,0,75,64
1649966743354,CSE 175,A01,083665,Kumar; Rakesh,11,0,25,14
1649966749383,CSE 190,A00,092507,Dubnov; Shlomo,12,0,15,3
1649966755409,ECE 45,A01,083139,Staff,0,3,40,40
1649966761438,ECE 65,A50,083695,Staff,2,0,30,28
1649966767478,ECE 109,A01,091882,Touri; Behrouz,51,0,70,19
1649966773502,ECE 180,A00,083140,Abi Samra; Nicholas Camill,26,0,30,4
1649966773502,ECE 180,B00,083141,Abi Samra; Nicholas Camill,12,0,30,18
1649966779525,MATH 10A,A01,083735,Patchell; Gregory David,19,0,30,11
1649966779525,MATH 10A,A02,083736,Patchell; Gregory David,28,0,30,2
1649966779525,MATH 10A,A03,083737,Patchell; Gregory David,27,0,30,3
1649966785552,MATH 10B,A01,083207,Staff,6,0,30,24
1649966785552,MATH 10B,A02,083208,Staff,25,0,30,5
1649966785552,MATH 10B,B01,083739,Staff,25,0,30,5
1649966785552,MATH 10B,B02,083740,Staff,30,0,30,0
1649966791578,MATH 18,A01,083743,Staff,20,0,30,10
1649966791578,MATH 18,A02,083744,Staff,29,0,30,1
1649966791578,MATH 18,A03,083745,Staff,28,0,30,2
1649966791578,MATH 18,A04,083746,Staff,27,0,30,3
1649966791578,MATH 18,B01,083748,Staff,0,1,30,30
1649966791578,MATH 18,B02,083749,Staff,17,0,30,13
1649966791578,MATH 18,B03,083750,Staff,24,0,30,6
1649966791578,MATH 18,B04,083751,Staff,20,0,30,10
1649966797615,MATH 20A,A01,083754,Staff,33,0,40,7
1649966803654,MATH 20B,A01,083756,Staff,15,0,30,15
1649966803654,MATH 20B,A02,083757,Staff,28,0,30,2
1649966809678,MATH 20C,A01,083760,Staff,13,0,30,17
1649966809678,MATH 20C,A02,083761,Staff,10,0,30,20
1649966809678,MATH 20C,B01,083762,Staff,27,0,30,3
1649966809678,MATH 20C,B02,083763,Staff,30,0,30,0
1649966815702,MATH 20D,A01,083765,Staff,12,0,30,18
1649966815702,MATH 20D,A02,083766,Staff,30,0,30,0
1649966815702,MATH 20D,A03,083767,Staff,28,0,30,2
1649966821741,MATH 20E,A01,083771,Staff,11,0,30,19
1649966821741,MATH 20E,A02,083772,Staff,24,0,30,6
1649966821741,MATH 20E,B01,083773,Staff,8,0,30,22
1649966821741,MATH 20E,B02,083774,Staff,28,0,30,2
1649966827787,MATH 103A,A01,083777,Staff,1,4,30,29
1649966827787,MATH 103A,A02,083778,Staff,0,4,30,30
1649966827787,MATH 103A,B01,083779,Staff,0,2,30,30
1649966827787,MATH 103A,B02,083780,Staff,0,1,30,30
1649966833816,MATH 105,A01,085443,Staff,0,10,30,30
1649966839851,MATH 109,A01,083213,Anzaldo; Leesa B,0,0,30,30
1649966839851,MATH 109,A02,083214,Anzaldo; Leesa B,0,0,30,30
1649966839851,MATH 109,B01,083215,Anzaldo; Leesa B,22,0,30,8
1649966839851,MATH 109,B02,083216,Anzaldo; Leesa B,17,0,30,13
1649966845878,MATH 142A,A01,083219,Chow; Bennett,0,3,30,30
1649966845878,MATH 142A,A02,083220,Chow; Bennett,0,2,30,30
1649966845878,MATH 142A,B01,083221,Chow; Bennett,0,3,30,30
1649966845878,MATH 142A,B02,083222,Chow; Bennett,0,3,30,30
1649966851906,MATH 193A,A01,083224,Staff,0,5,30,30
1649966851906,MATH 193A,A02,083225,Staff,0,3,30,30
1649966851906,MATH 193A,A03,083781,Staff,2,0,30,28
1649966851906,MATH 193A,A04,083782,Staff,13,0,30,17
1649966857933,MATH 197,001,091859,McAuley; Julian John,9999,0,9999,0
1649966863993,COGS 9,A01,083615,Staff,5,0,60,55
1649966870027,COGS 11,A01,083617,Boyle; Mary E. T.,33,0,40,7
1649966876060,COGS 13,A01,083071,Staff,0,18,40,40
1649966882096,COGS 14A,A01,092681,Staff,40,0,100,60
1649966888132,COGS 14B,A01,083073,Cheng; Tzu-Han,14,0,50,36
1649966894160,COGS 17,A01,092677,Staff,56,0,75,19
1649966900188,COGS 100,A01,083619,Staff,1,15,60,59
1649966906215,COGS 101A,A01,083621,Davis; Joshua Daniel,0,15,60,60
1649966912244,COGS 101B,A01,091572,Staff,25,0,60,35
1649966918284,COGS 101C,A01,083625,Delgado; Tania,22,0,30,8
1649966924311,COGS 107A,A01,083627,Boyle; Mary E. T.,4,0,60,56
1649966930336,COGS 118A,A01,083075,Staff,21,0,60,39
1649966936366,CSE 3,A50,083646,Miranda; Gregory Joseph,23,0,38,15
1649966936366,CSE 3,A51,083647,Miranda; Gregory Joseph,37,0,37,0
1649966942394,CSE 8A,A50,083650,Miranda; Gregory Joseph,1,3,40,39
1649966948420,CSE 11,A01,083080,Cao; Yingjun,0,40,40,40
1649966954443,CSE 12,A01,083652,Staff,39,0,100,61
1649966960465,CSE 15L,A01,083654,Staff,5,0,50,45
1649966960465,CSE 15L,A02,083655,Staff,44,0,50,6
1649966966487,CSE 20,A01,083657,Staff,64,0,80,16
1649966972517,CSE 30,A01,083084,Eldon; John,0,41,40,40
1649966978541,CSE 100,A01,083659,Cao; Yingjun,1,46,50,49
1649966984567,CSE 134B,A01,083661,Powell; Thomas Allan,0,24,65,65
1649966990590,CSE 140,A01,083663,Staff,15,0,75,60
1649966996637,CSE 140L,A01,083088,Eldon; John,11,0,75,64
1649967002660,CSE 175,A01,083665,Kumar; Rakesh,11,0,25,14
1649967008683,CSE 190,A00,092507,Dubnov; Shlomo,12,0,15,3
1649967014713,ECE 45,A01,083139,Staff,0,3,40,40
1649967020748,ECE 65,A50,083695,Staff,2,0,30,28
1649967026786,ECE 109,A01,091882,Touri; Behrouz,51,0,70,19
1649967032809,ECE 180,A00,083140,Abi Samra; Nicholas Camill,26,0,30,4
1649967032809,ECE 180,B00,083141,Abi Samra; Nicholas Camill,12,0,30,18
1649967038848,MATH 10A,A01,083735,Patchell; Gregory David,19,0,30,11
1649967038848,MATH 10A,A02,083736,Patchell; Gregory David,28,0,30,2
1649967038848,MATH 10A,A03,083737,Patchell; Gregory David,27,0,30,3
1649967044941,MATH 10B,A01,083207,Staff,6,0,30,24
1649967044941,MATH 10B,A02,083208,Staff,25,0,30,5
1649967044941,MATH 10B,B01,083739,Staff,25,0,30,5
1649967044941,MATH 10B,B02,083740,Staff,30,0,30,0
1649967050976,MATH 18,A01,083743,Staff,20,0,30,10
1649967050976,MATH 18,A02,083744,Staff,29,0,30,1
1649967050976,MATH 18,A03,083745,Staff,28,0,30,2
1649967050976,MATH 18,A04,083746,Staff,27,0,30,3
1649967050976,MATH 18,B01,083748,Staff,0,1,30,30
1649967050976,MATH 18,B02,083749,Staff,17,0,30,13
1649967050976,MATH 18,B03,083750,Staff,24,0,30,6
1649967050976,MATH 18,B04,083751,Staff,20,0,30,10
1649967057004,MATH 20A,A01,083754,Staff,33,0,40,7
1649967063031,MATH 20B,A01,083756,Staff,15,0,30,15
1649967063031,MATH 20B,A02,083757,Staff,28,0,30,2
1649967069062,MATH 20C,A01,083760,Staff,13,0,30,17
1649967069062,MATH 20C,A02,083761,Staff,10,0,30,20
1649967069062,MATH 20C,B01,083762,Staff,27,0,30,3
1649967069062,MATH 20C,B02,083763,Staff,30,0,30,0
1649967075085,MATH 20D,A01,083765,Staff,12,0,30,18
1649967075085,MATH 20D,A02,083766,Staff,30,0,30,0
1649967075085,MATH 20D,A03,083767,Staff,28,0,30,2
1649967081110,MATH 20E,A01,083771,Staff,11,0,30,19
1649967081110,MATH 20E,A02,083772,Staff,24,0,30,6
1649967081110,MATH 20E,B01,083773,Staff,8,0,30,22
1649967081110,MATH 20E,B02,083774,Staff,28,0,30,2
1649967087138,MATH 103A,A01,083777,Staff,1,4,30,29
1649967087138,MATH 103A,A02,083778,Staff,0,4,30,30
1649967087138,MATH 103A,B01,083779,Staff,0,2,30,30
1649967087138,MATH 103A,B02,083780,Staff,0,1,30,30
1649967093169,MATH 105,A01,085443,Staff,0,10,30,30
1649967099192,MATH 109,A01,083213,Anzaldo; Leesa B,0,0,30,30
1649967099192,MATH 109,A02,083214,Anzaldo; Leesa B,0,0,30,30
1649967099192,MATH 109,B01,083215,Anzaldo; Leesa B,22,0,30,8
1649967099192,MATH 109,B02,083216,Anzaldo; Leesa B,16,0,30,14
1649967105223,MATH 142A,A01,083219,Chow; Bennett,0,3,30,30
1649967105223,MATH 142A,A02,083220,Chow; Bennett,0,2,30,30
1649967105223,MATH 142A,B01,083221,Chow; Bennett,0,3,30,30
1649967105223,MATH 142A,B02,083222,Chow; Bennett,0,3,30,30
1649967111258,MATH 193A,A01,083224,Staff,0,5,30,30
1649967111258,MATH 193A,A02,083225,Staff,0,3,30,30
1649967111258,MATH 193A,A03,083781,Staff,2,0,30,28
1649967111258,MATH 193A,A04,083782,Staff,13,0,30,17
1649967117281,MATH 197,001,091859,McAuley; Julian John,9999,0,9999,0
1649967123367,COGS 9,A01,083615,Staff,4,0,60,56
1649967129393,COGS 11,A01,083617,Boyle; Mary E. T.,33,0,40,7
1649967135431,COGS 13,A01,083071,Staff,0,18,40,40
1649967141471,COGS 14A,A01,092681,Staff,40,0,100,60
1649967147503,COGS 14B,A01,083073,Cheng; Tzu-Han,14,0,50,36
1649967153527,COGS 17,A01,092677,Staff,56,0,75,19
1649967159553,COGS 100,A01,083619,Staff,1,15,60,59
1649967165587,COGS 101A,A01,083621,Davis; Joshua Daniel,0,15,60,60
1649967171612,COGS 101B,A01,091572,Staff,25,0,60,35
1649967177636,COGS 101C,A01,083625,Delgado; Tania,22,0,30,8
1649967183668,COGS 107A,A01,083627,Boyle; Mary E. T.,3,0,60,57
1649967189697,COGS 118A,A01,083075,Staff,21,0,60,39
1649967195727,CSE 3,A50,083646,Miranda; Gregory Joseph,23,0,38,15
1649967195727,CSE 3,A51,083647,Miranda; Gregory Joseph,37,0,37,0
1649967201755,CSE 8A,A50,083650,Miranda; Gregory Joseph,1,3,40,39
1649967207782,CSE 11,A01,083080,Cao; Yingjun,0,40,40,40
1649967213819,CSE 12,A01,083652,Staff,38,0,100,62
1649967219849,CSE 15L,A01,083654,Staff,4,0,50,46
1649967219849,CSE 15L,A02,083655,Staff,44,0,50,6
1649967225872,CSE 20,A01,083657,Staff,64,0,80,16
1649967231899,CSE 30,A01,083084,Eldon; John,0,42,40,40
1649967237923,CSE 100,A01,083659,Cao; Yingjun,1,46,50,49
1649967243945,CSE 134B,A01,083661,Powell; Thomas Allan,0,24,65,65
1649967249969,CSE 140,A01,083663,Staff,15,0,75,60
1649967256001,CSE 140L,A01,083088,Eldon; John,11,0,75,64
1649967262044,CSE 175,A01,083665,Kumar; Rakesh,11,0,25,14
1649967268083,CSE 190,A00,092507,Dubnov; Shlomo,12,0,15,3
1649967274204,ECE 45,A01,083139,Staff,0,4,40,40
1649967280246,ECE 65,A50,083695,Staff,2,0,30,28
1649967286274,ECE 109,A01,091882,Touri; Behrouz,51,0,70,19
1649967292297,ECE 180,A00,083140,Abi Samra; Nicholas Camill,26,0,30,4
1649967292297,ECE 180,B00,083141,Abi Samra; Nicholas Camill,12,0,30,18
1649967298326,MATH 10A,A01,083735,Patchell; Gregory David,19,0,30,11
1649967298326,MATH 10A,A02,083736,Patchell; Gregory David,28,0,30,2
1649967298326,MATH 10A,A03,083737,Patchell; Gregory David,27,0,30,3
1649967304353,MATH 10B,A01,083207,Staff,6,0,30,24
1649967304353,MATH 10B,A02,083208,Staff,25,0,30,5
1649967304353,MATH 10B,B01,083739,Staff,25,0,30,5
1649967304353,MATH 10B,B02,083740,Staff,30,0,30,0
1649967310387,MATH 18,A01,083743,Staff,20,0,30,10
1649967310387,MATH 18,A02,083744,Staff,29,0,30,1
1649967310387,MATH 18,A03,083745,Staff,28,0,30,2
1649967310387,MATH 18,A04,083746,Staff,27,0,30,3
1649967310387,MATH 18,B01,083748,Staff,0,1,30,30
1649967310387,MATH 18,B02,083749,Staff,17,0,30,13
1649967310387,MATH 18,B03,083750,Staff,23,0,30,7
1649967310387,MATH 18,B04,083751,Staff,20,0,30,10
1649967316436,MATH 20A,A01,083754,Staff,33,0,40,7
1649967322464,MATH 20B,A01,083756,Staff,15,0,30,15
1649967322464,MATH 20B,A02,083757,Staff,28,0,30,2
1649967328488,MATH 20C,A01,083760,Staff,13,0,30,17
1649967328488,MATH 20C,A02,083761,Staff,10,0,30,20
1649967328488,MATH 20C,B01,083762,Staff,27,0,30,3
1649967328488,MATH 20C,B02,083763,Staff,30,0,30,0
1649967334512,MATH 20D,A01,083765,Staff,12,0,30,18
1649967334512,MATH 20D,A02,083766,Staff,30,0,30,0
1649967334512,MATH 20D,A03,083767,Staff,28,0,30,2
1649967340540,MATH 20E,A01,083771,Staff,11,0,30,19
1649967340540,MATH 20E,A02,083772,Staff,24,0,30,6
1649967340540,MATH 20E,B01,083773,Staff,8,0,30,22
1649967340540,MATH 20E,B02,083774,Staff,28,0,30,2
1649967346563,MATH 103A,A01,083777,Staff,1,4,30,29
1649967346563,MATH 103A,A02,083778,Staff,0,4,30,30
1649967346563,MATH 103A,B01,083779,Staff,0,2,30,30
1649967346563,MATH 103A,B02,083780,Staff,0,1,30,30
1649967352588,MATH 105,A01,085443,Staff,0,9,30,30
1649967358613,MATH 109,A01,083213,Anzaldo; Leesa B,0,0,30,30
1649967358613,MATH 109,A02,083214,Anzaldo; Leesa B,0,0,30,30
1649967358613,MATH 109,B01,083215,Anzaldo; Leesa B,22,0,30,8
1649967358613,MATH 109,B02,083216,Anzaldo; Leesa B,15,0,30,15
1649967364637,MATH 142A,A01,083219,Chow; Bennett,0,3,30,30
1649967364637,MATH 142A,A02,083220,Chow; Bennett,0,3,30,30
1649967364637,MATH 142A,B01,083221,Chow; Bennett,0,3,30,30
1649967364637,MATH 142A,B02,083222,Chow; Bennett,0,3,30,30
1649967370660,MATH 193A,A01,083224,Staff,0,5,30,30
1649967370660,MATH 193A,A02,083225,Staff,0,3,30,30
1649967370660,MATH 193A,A03,083781,Staff,2,0,30,28
1649967370660,MATH 193A,A04,083782,Staff,13,0,30,17
1649967376697,MATH 197,001,091859,McAuley; Julian John,9999,0,9999,0
1649967382764,COGS 9,A01,083615,Staff,3,0,60,57
1649967388794,COGS 11,A01,083617,Boyle; Mary E. T.,33,0,40,7
1649967394821,COGS 13,A01,083071,Staff,0,18,40,40
1649967400849,COGS 14A,A01,092681,Staff,40,0,100,60
1649967406884,COGS 14B,A01,083073,Cheng; Tzu-Han,14,0,50,36
1649967412923,COGS 17,A01,092677,Staff,56,0,75,19
1649967418949,COGS 100,A01,083619,Staff,1,16,60,59
1649967424985,COGS 101A,A01,083621,Davis; Joshua Daniel,0,15,60,60
1649967431018,COGS 101B,A01,091572,Staff,25,0,60,35
1649967437041,COGS 101C,A01,083625,Delgado; Tania,22,0,30,8
1649967443070,COGS 107A,A01,083627,Boyle; Mary E. T.,2,0,60,58
1649967449095,COGS 118A,A01,083075,Staff,21,0,60,39
1649967455117,CSE 3,A50,083646,Miranda; Gregory Joseph,23,0,38,15
1649967455117,CSE 3,A51,083647,Miranda; Gregory Joseph,37,0,37,0
1649967461162,CSE 8A,A50,083650,Miranda; Gregory Joseph,1,3,40,39
1649967467186,CSE 11,A01,083080,Cao; Yingjun,0,40,40,40
1649967473208,CSE 12,A01,083652,Staff,38,0,100,62
1649967479243,CSE 15L,A01,083654,Staff,4,0,50,46
1649967479243,CSE 15L,A02,083655,Staff,44,0,50,6
1649967485265,CSE 20,A01,083657,Staff,64,0,80,16
1649967491294,CSE 30,A01,083084,Eldon; John,0,42,40,40
1649967497324,CSE 100,A01,083659,Cao; Yingjun,1,46,50,49
1649967503358,CSE 134B,A01,083661,Powell; Thomas Allan,0,24,65,65
1649967509384,CSE 140,A01,083663,Staff,15,0,75,60
1649967515410,CSE 140L,A01,083088,Eldon; John,11,0,75,64
1649967521437,CSE 175,A01,083665,Kumar; Rakesh,11,0,25,14
1649967527463,CSE 190,A00,092507,Dubnov; Shlomo,12,0,15,3
1649967533485,ECE 45,A01,083139,Staff,0,4,40,40
1649967539509,ECE 65,A50,083695,Staff,2,0,30,28
1649967545535,ECE 109,A01,091882,Touri; Behrouz,51,0,70,19
1649967551563,ECE 180,A00,083140,Abi Samra; Nicholas Camill,26,0,30,4
1649967551563,ECE 180,B00,083141,Abi Samra; Nicholas Camill,12,0,30,18
1649967557599,MATH 10A,A01,083735,Patchell; Gregory David,19,0,30,11
1649967557599,MATH 10A,A02,083736,Patchell; Gregory David,28,0,30,2
1649967557599,MATH 10A,A03,083737,Patchell; Gregory David,27,0,30,3
1649967563627,MATH 10B,A01,083207,Staff,6,0,30,24
1649967563627,MATH 10B,A02,083208,Staff,25,0,30,5
1649967563627,MATH 10B,B01,083739,Staff,25,0,30,5
1649967563627,MATH 10B,B02,083740,Staff,30,0,30,0
1649967569653,MATH 18,A01,083743,Staff,20,0,30,10
1649967569653,MATH 18,A02,083744,Staff,29,0,30,1
1649967569653,MATH 18,A03,083745,Staff,28,0,30,2
1649967569653,MATH 18,A04,083746,Staff,27,0,30,3
1649967569653,MATH 18,B01,083748,Staff,0,1,30,30
1649967569653,MATH 18,B02,083749,Staff,17,0,30,13
1649967569653,MATH 18,B03,083750,Staff,23,0,30,7
1649967569653,MATH 18,B04,083751,Staff,20,0,30,10
1649967575687,MATH 20A,A01,083754,Staff,33,0,40,7
1649967581714,MATH 20B,A01,083756,Staff,15,0,30,15
1649967581714,MATH 20B,A02,083757,Staff,28,0,30,2
1649967587739,MATH 20C,A01,083760,Staff,13,0,30,17
1649967587739,MATH 20C,A02,083761,Staff,9,0,30,21
1649967587739,MATH 20C,B01,083762,Staff,27,0,30,3
1649967587739,MATH 20C,B02,083763,Staff,30,0,30,0
1649967593768,MATH 20D,A01,083765,Staff,12,0,30,18
1649967593768,MATH 20D,A02,083766,Staff,30,0,30,0
1649967593768,MATH 20D,A03,083767,Staff,28,0,30,2
1649967599805,MATH 20E,A01,083771,Staff,11,0,30,19
1649967599805,MATH 20E,A02,083772,Staff,24,0,30,6
1649967599805,MATH 20E,B01,083773,Staff,8,0,30,22
1649967599805,MATH 20E,B02,083774,Staff,28,0,30,2
1649967605844,MATH 103A,A01,083777,Staff,1,4,30,29
1649967605844,MATH 103A,A02,083778,Staff,0,4,30,30
1649967605844,MATH 103A,B01,083779,Staff,0,2,30,30
1649967605844,MATH 103A,B02,083780,Staff,0,1,30,30
1649967611872,MATH 105,A01,085443,Staff,0,9,30,30
1649967617903,MATH 109,A01,083213,Anzaldo; Leesa B,0,0,30,30
1649967617903,MATH 109,A02,083214,Anzaldo; Leesa B,0,1,30,30
1649967617903,MATH 109,B01,083215,Anzaldo; Leesa B,21,0,30,9
1649967617903,MATH 109,B02,083216,Anzaldo; Leesa B,15,0,30,15
1649967623937,MATH 142A,A01,083219,Chow; Bennett,0,3,30,30
1649967623937,MATH 142A,A02,083220,Chow; Bennett,0,3,30,30
1649967623937,MATH 142A,B01,083221,Chow; Bennett,0,3,30,30
1649967623937,MATH 142A,B02,083222,Chow; Bennett,0,3,30,30
1649967629967,MATH 193A,A01,083224,Staff,0,5,30,30
1649967629967,MATH 193A,A02,083225,Staff,0,3,30,30
1649967629967,MATH 193A,A03,083781,Staff,2,0,30,28
1649967629967,MATH 193A,A04,083782,Staff,13,0,30,17
1649967635988,MATH 197,001,091859,McAuley; Julian John,9999,0,9999,0
1649967642052,COGS 9,A01,083615,Staff,3,0,60,57
1649967648084,COGS 11,A01,083617,Boyle; Mary E. T.,33,0,40,7
1649967654123,COGS 13,A01,083071,Staff,0,18,40,40
1649967660232,COGS 14A,A01,092681,Staff,39,0,100,61
1649967666260,COGS 14B,A01,083073,Cheng; Tzu-Han,14,0,50,36
1649967672294,COGS 17,A01,092677,Staff,56,0,75,19
1649967678318,COGS 100,A01,083619,Staff,1,16,60,59
1649967684349,COGS 101A,A01,083621,Davis; Joshua Daniel,0,15,60,60
1649967690378,COGS 101B,A01,091572,Staff,24,0,60,36
1649967696402,COGS 101C,A01,083625,Delgado; Tania,22,0,30,8
1649967702426,COGS 107A,A01,083627,Boyle; Mary E. T.,2,0,60,58
1649967708451,COGS 118A,A01,083075,Staff,21,0,60,39
1649967714480,CSE 3,A50,083646,Miranda; Gregory Joseph,23,0,38,15
1649967714480,CSE 3,A51,083647,Miranda; Gregory Joseph,37,0,37,0
1649967720513,CSE 8A,A50,083650,Miranda; Gregory Joseph,1,3,40,39
1649967726542,CSE 11,A01,083080,Cao; Yingjun,0,40,40,40
1649967732577,CSE 12,A01,083652,Staff,38,0,100,62
1649967738601,CSE 15L,A01,083654,Staff,4,0,50,46
1649967738601,CSE 15L,A02,083655,Staff,44,0,50,6
1649967744626,CSE 20,A01,083657,Staff,63,0,80,17
1649967750655,CSE 30,A01,083084,Eldon; John,0,43,40,40
1649967756699,CSE 100,A01,083659,Cao; Yingjun,1,47,50,49
1649967762722,CSE 134B,A01,083661,Powell; Thomas Allan,0,24,65,65
1649967768749,CSE 140,A01,083663,Staff,15,0,75,60
1649967774780,CSE 140L,A01,083088,Eldon; John,11,0,75,64
1649967780832,CSE 175,A01,083665,Kumar; Rakesh,11,0,25,14
1649967786865,CSE 190,A00,092507,Dubnov; Shlomo,12,0,15,3
1649967792904,ECE 45,A01,083139,Staff,0,4,40,40
1649967798930,ECE 65,A50,083695,Staff,2,0,30,28
1649967804966,ECE 109,A01,091882,Touri; Behrouz,51,0,70,19
1649967810994,ECE 180,A00,083140,Abi Samra; Nicholas Camill,26,0,30,4
1649967810994,ECE 180,B00,083141,Abi Samra; Nicholas Camill,12,0,30,18
1649967817023,MATH 10A,A01,083735,Patchell; Gregory David,19,0,30,11
1649967817023,MATH 10A,A02,083736,Patchell; Gregory David,28,0,30,2
1649967817023,MATH 10A,A03,083737,Patchell; Gregory David,27,0,30,3
1649967823051,MATH 10B,A01,083207,Staff,6,0,30,24
1649967823051,MATH 10B,A02,083208,Staff,25,0,30,5
1649967823051,MATH 10B,B01,083739,Staff,25,0,30,5
1649967823051,MATH 10B,B02,083740,Staff,30,0,30,0
1649967829084,MATH 18,A01,083743,Staff,20,0,30,10
1649967829084,MATH 18,A02,083744,Staff,29,0,30,1
1649967829084,MATH 18,A03,083745,Staff,28,0,30,2
1649967829084,MATH 18,A04,083746,Staff,27,0,30,3
1649967829084,MATH 18,B01,083748,Staff,0,1,30,30
1649967829084,MATH 18,B02,083749,Staff,15,0,30,15
1649967829084,MATH 18,B03,083750,Staff,23,0,30,7
1649967829084,MATH 18,B04,083751,Staff,19,0,30,11
1649967835115,MATH 20A,A01,083754,Staff,33,0,40,7
1649967841149,MATH 20B,A01,083756,Staff,14,0,30,16
1649967841149,MATH 20B,A02,083757,Staff,28,0,30,2
1649967847188,MATH 20C,A01,083760,Staff,13,0,30,17
1649967847188,MATH 20C,A02,083761,Staff,9,0,30,21
1649967847188,MATH 20C,B01,083762,Staff,27,0,30,3
1649967847188,MATH 20C,B02,083763,Staff,30,0,30,0
1649967853214,MATH 20D,A01,083765,Staff,13,0,30,17
1649967853214,MATH 20D,A02,083766,Staff,29,0,30,1
1649967853214,MATH 20D,A03,083767,Staff,28,0,30,2
1649967859249,MATH 20E,A01,083771,Staff,11,0,30,19
1649967859249,MATH 20E,A02,083772,Staff,24,0,30,6
1649967859249,MATH 20E,B01,083773,Staff,7,0,30,23
1649967859249,MATH 20E,B02,083774,Staff,28,0,30,2
1649967865276,MATH 103A,A01,083777,Staff,1,4,30,29
1649967865276,MATH 103A,A02,083778,Staff,0,4,30,30
1649967865276,MATH 103A,B01,083779,Staff,0,2,30,30
1649967865276,MATH 103A,B02,083780,Staff,0,2,30,30
1649967871389,MATH 105,A01,085443,Staff,0,9,30,30
1649967877416,MATH 109,A01,083213,Anzaldo; Leesa B,0,0,30,30
1649967877416,MATH 109,A02,083214,Anzaldo; Leesa B,0,1,30,30
1649967877416,MATH 109,B01,083215,Anzaldo; Leesa B,21,0,30,9
1649967877416,MATH 109,B02,083216,Anzaldo; Leesa B,14,0,30,16
1649967883461,MATH 142A,A01,083219,Chow; Bennett,0,3,30,30
1649967883461,MATH 142A,A02,083220,Chow; Bennett,0,3,30,30
1649967883461,MATH 142A,B01,083221,Chow; Bennett,0,3,30,30
1649967883461,MATH 142A,B02,083222,Chow; Bennett,0,3,30,30
1649967889491,MATH 193A,A01,083224,Staff,0,5,30,30
1649967889491,MATH 193A,A02,083225,Staff,0,3,30,30
1649967889491,MATH 193A,A03,083781,Staff,2,0,30,28
1649967889491,MATH 193A,A04,083782,Staff,13,0,30,17
1649967895517,MATH 197,001,091859,McAuley; Julian John,9999,0,9999,0
1649967901605,COGS 9,A01,083615,Staff,0,0,60,60
1649967907632,COGS 11,A01,083617,Boyle; Mary E. T.,33,0,40,7
1649967913655,COGS 13,A01,083071,Staff,0,19,40,40
1649967919687,COGS 14A,A01,092681,Staff,38,0,100,62
1649967925713,COGS 14B,A01,083073,Cheng; Tzu-Han,14,0,50,36
1649967931738,COGS 17,A01,092677,Staff,56,0,75,19
1649967937760,COGS 100,A01,083619,Staff,1,16,60,59
1649967943785,COGS 101A,A01,083621,Davis; Joshua Daniel,0,15,60,60
1649967949824,COGS 101B,A01,091572,Staff,24,0,60,36
1649967955846,COGS 101C,A01,083625,Delgado; Tania,22,0,30,8
1649967961869,COGS 107A,A01,083627,Boyle; Mary E. T.,2,0,60,58
1649967967892,COGS 118A,A01,083075,Staff,21,0,60,39
1649967973923,CSE 3,A50,083646,Miranda; Gregory Joseph,23,0,38,15
1649967973923,CSE 3,A51,083647,Miranda; Gregory Joseph,37,0,37,0
1649967979958,CSE 8A,A50,083650,Miranda; Gregory Joseph,1,3,40,39
1649967985993,CSE 11,A01,083080,Cao; Yingjun,0,40,40,40
1649967992019,CSE 12,A01,083652,Staff,38,0,100,62
1649967998042,CSE 15L,A01,083654,Staff,4,0,50,46
1649967998042,CSE 15L,A02,083655,Staff,44,0,50,6
1649968004066,CSE 20,A01,083657,Staff,63,0,80,17
1649968010088,CSE 30,A01,083084,Eldon; John,0,43,40,40
1649968016116,CSE 100,A01,083659,Cao; Yingjun,1,47,50,49
1649968022139,CSE 134B,A01,083661,Powell; Thomas Allan,0,24,65,65
1649968028169,CSE 140,A01,083663,Staff,15,0,75,60
1649968034192,CSE 140L,A01,083088,Eldon; John,11,0,75,64
1649968040223,CSE 175,A01,083665,Kumar; Rakesh,11,0,25,14
1649968046257,CSE 190,A00,092507,Dubnov; Shlomo,12,0,15,3
1649968052301,ECE 45,A01,083139,Staff,0,4,40,40
1649968058336,ECE 65,A50,083695,Staff,2,0,30,28
1649968064369,ECE 109,A01,091882,Touri; Behrouz,51,0,70,19
1649968070400,ECE 180,A00,083140,Abi Samra; Nicholas Camill,26,0,30,4
1649968070400,ECE 180,B00,083141,Abi Samra; Nicholas Camill,12,0,30,18
1649968076438,MATH 10A,A01,083735,Patchell; Gregory David,19,0,30,11
1649968076438,MATH 10A,A02,083736,Patchell; Gregory David,28,0,30,2
1649968076438,MATH 10A,A03,083737,Patchell; Gregory David,27,0,30,3
1649968082467,MATH 10B,A01,083207,Staff,6,0,30,24
1649968082467,MATH 10B,A02,083208,Staff,25,0,30,5
1649968082467,MATH 10B,B01,083739,Staff,25,0,30,5
1649968082467,MATH 10B,B02,083740,Staff,30,0,30,0
1649968088491,MATH 18,A01,083743,Staff,20,0,30,10
1649968088491,MATH 18,A02,083744,Staff,29,0,30,1
1649968088491,MATH 18,A03,083745,Staff,28,0,30,2
1649968088491,MATH 18,A04,083746,Staff,27,0,30,3
1649968088491,MATH 18,B01,083748,Staff,0,1,30,30
1649968088491,MATH 18,B02,083749,Staff,15,0,30,15
1649968088491,MATH 18,B03,083750,Staff,23,0,30,7
1649968088491,MATH 18,B04,083751,Staff,19,0,30,11
1649968094522,MATH 20A,A01,083754,Staff,33,0,40,7
1649968100555,MATH 20B,A01,083756,Staff,14,0,30,16
1649968100555,MATH 20B,A02,083757,Staff,28,0,30,2
1649968106589,MATH 20C,A01,083760,Staff,13,0,30,17
1649968106589,MATH 20C,A02,083761,Staff,9,0,30,21
1649968106589,MATH 20C,B01,083762,Staff,27,0,30,3
1649968106589,MATH 20C,B02,083763,Staff,30,0,30,0
1649968112647,MATH 20D,A01,083765,Staff,13,0,30,17
1649968112647,MATH 20D,A02,083766,Staff,29,0,30,1
1649968112647,MATH 20D,A03,083767,Staff,28,0,30,2
1649968118670,MATH 20E,A01,083771,Staff,11,0,30,19
1649968118670,MATH 20E,A02,083772,Staff,24,0,30,6
1649968118670,MATH 20E,B01,083773,Staff,7,0,30,23
1649968118670,MATH 20E,B02,083774,Staff,28,0,30,2
1649968124692,MATH 103A,A01,083777,Staff,1,5,30,29
1649968124692,MATH 103A,A02,083778,Staff,0,4,30,30
1649968124692,MATH 103A,B01,083779,Staff,0,2,30,30
1649968124692,MATH 103A,B02,083780,Staff,0,2,30,30
1649968130714,MATH 105,A01,085443,Staff,0,10,30,30
1649968136746,MATH 109,A01,083213,Anzaldo; Leesa B,0,1,30,30
1649968136746,MATH 109,A02,083214,Anzaldo; Leesa B,0,1,30,30
1649968136746,MATH 109,B01,083215,Anzaldo; Leesa B,21,0,30,9
1649968136746,MATH 109,B02,083216,Anzaldo; Leesa B,13,0,30,17
1649968142778,MATH 142A,A01,083219,Chow; Bennett,0,3,30,30
1649968142778,MATH 142A,A02,083220,Chow; Bennett,0,3,30,30
1649968142778,MATH 142A,B01,083221,Chow; Bennett,0,3,30,30
1649968142778,MATH 142A,B02,083222,Chow; Bennett,0,3,30,30
1649968148802,MATH 193A,A01,083224,Staff,0,5,30,30
1649968148802,MATH 193A,A02,083225,Staff,0,3,30,30
1649968148802,MATH 193A,A03,083781,Staff,2,0,30,28
1649968148802,MATH 193A,A04,083782,Staff,13,0,30,17
1649968154839,MATH 197,001,091859,McAuley; Julian John,9999,0,9999,0
1649968160892,COGS 9,A01,083615,Staff,0,0,60,60
1649968166915,COGS 11,A01,083617,Boyle; Mary E. T.,33,0,40,7
1649968172963,COGS 13,A01,083071,Staff,0,19,40,40
1649968178986,COGS 14A,A01,092681,Staff,38,0,100,62
1649968185021,COGS 14B,A01,083073,Cheng; Tzu-Han,13,0,50,37
1649968191044,COGS 17,A01,092677,Staff,56,0,75,19
1649968197067,COGS 100,A01,083619,Staff,1,16,60,59
1649968203089,COGS 101A,A01,083621,Davis; Joshua Daniel,0,15,60,60
1649968209118,COGS 101B,A01,091572,Staff,24,0,60,36
1649968215153,COGS 101C,A01,083625,Delgado; Tania,22,0,30,8
1649968221181,COGS 107A,A01,083627,Boyle; Mary E. T.,2,0,60,58
1649968227217,COGS 118A,A01,083075,Staff,21,0,60,39
1649968233241,CSE 3,A50,083646,Miranda; Gregory Joseph,23,0,38,15
1649968233241,CSE 3,A51,083647,Miranda; Gregory Joseph,37,0,37,0
1649968239282,CSE 8A,A50,083650,Miranda; Gregory Joseph,1,3,40,39
1649968245316,CSE 11,A01,083080,Cao; Yingjun,0,41,40,40
1649968251348,CSE 12,A01,083652,Staff,37,0,100,63
1649968257369,CSE 15L,A01,083654,Staff,3,0,50,47
1649968257369,CSE 15L,A02,083655,Staff,44,0,50,6
1649968263401,CSE 20,A01,083657,Staff,62,0,80,18
1649968269427,CSE 30,A01,083084,Eldon; John,0,43,40,40
1649968275461,CSE 100,A01,083659,Cao; Yingjun,1,47,50,49
1649968281486,CSE 134B,A01,083661,Powell; Thomas Allan,0,24,65,65
1649968287510,CSE 140,A01,083663,Staff,15,0,75,60
1649968293533,CSE 140L,A01,083088,Eldon; John,11,0,75,64
1649968299569,CSE 175,A01,083665,Kumar; Rakesh,11,0,25,14
1649968305593,CSE 190,A00,092507,Dubnov; Shlomo,12,0,15,3
1649968311617,ECE 45,A01,083139,Staff,0,4,40,40
1649968317640,ECE 65,A50,083695,Staff,2,0,30,28
1649968323665,ECE 109,A01,091882,Touri; Behrouz,51,0,70,19
1649968329690,ECE 180,A00,083140,Abi Samra; Nicholas Camill,26,0,30,4
1649968329690,ECE 180,B00,083141,Abi Samra; Nicholas Camill,12,0,30,18
1649968335721,MATH 10A,A01,083735,Patchell; Gregory David,19,0,30,11
1649968335721,MATH 10A,A02,083736,Patchell; Gregory David,28,0,30,2
1649968335721,MATH 10A,A03,083737,Patchell; Gregory David,27,0,30,3
1649968341743,MATH 10B,A01,083207,Staff,4,0,30,26
1649968341743,MATH 10B,A02,083208,Staff,25,0,30,5
1649968341743,MATH 10B,B01,083739,Staff,25,0,30,5
1649968341743,MATH 10B,B02,083740,Staff,30,0,30,0
1649968347767,MATH 18,A01,083743,Staff,20,0,30,10
1649968347767,MATH 18,A02,083744,Staff,29,0,30,1
1649968347767,MATH 18,A03,083745,Staff,28,0,30,2
1649968347767,MATH 18,A04,083746,Staff,27,0,30,3
1649968347767,MATH 18,B01,083748,Staff,0,1,30,30
1649968347767,MATH 18,B02,083749,Staff,15,0,30,15
1649968347767,MATH 18,B03,083750,Staff,23,0,30,7
1649968347767,MATH 18,B04,083751,Staff,19,0,30,11
1649968353791,MATH 20A,A01,083754,Staff,33,0,40,7
1649968359814,MATH 20B,A01,083756,Staff,13,0,30,17
1649968359814,MATH 20B,A02,083757,Staff,28,0,30,2
1649968365843,MATH 20C,A01,083760,Staff,12,0,30,18
1649968365843,MATH 20C,A02,083761,Staff,9,0,30,21
1649968365843,MATH 20C,B01,083762,Staff,27,0,30,3
1649968365843,MATH 20C,B02,083763,Staff,30,0,30,0
1649968371877,MATH 20D,A01,083765,Staff,13,0,30,17
1649968371877,MATH 20D,A02,083766,Staff,29,0,30,1
1649968371877,MATH 20D,A03,083767,Staff,28,0,30,2
1649968377912,MATH 20E,A01,083771,Staff,11,0,30,19
1649968377912,MATH 20E,A02,083772,Staff,24,0,30,6
1649968377912,MATH 20E,B01,083773,Staff,7,0,30,23
1649968377912,MATH 20E,B02,083774,Staff,28,0,30,2
1649968383941,MATH 103A,A01,083777,Staff,1,5,30,29
1649968383941,MATH 103A,A02,083778,Staff,0,4,30,30
1649968383941,MATH 103A,B01,083779,Staff,0,3,30,30
1649968383941,MATH 103A,B02,083780,Staff,0,2,30,30
1649968389970,MATH 105,A01,085443,Staff,0,10,30,30
1649968395997,MATH 109,A01,083213,Anzaldo; Leesa B,0,1,30,30
1649968395997,MATH 109,A02,083214,Anzaldo; Leesa B,0,1,30,30
1649968395997,MATH 109,B01,083215,Anzaldo; Leesa B,21,0,30,9
1649968395997,MATH 109,B02,083216,Anzaldo; Leesa B,12,0,30,18
1649968402018,MATH 142A,A01,083219,Chow; Bennett,0,3,30,30
1649968402018,MATH 142A,A02,083220,Chow; Bennett,0,3,30,30
1649968402018,MATH 142A,B01,083221,Chow; Bennett,0,3,30,30
1649968402018,MATH 142A,B02,083222,Chow; Bennett,0,3,30,30
1649968408050,MATH 193A,A01,083224,Staff,0,5,30,30
1649968408050,MATH 193A,A02,083225,Staff,0,3,30,30
1649968408050,MATH 193A,A03,083781,Staff,2,0,30,28
1649968408050,MATH 193A,A04,083782,Staff,13,0,30,17
1649968414073,MATH 197,001,091859,McAuley; Julian John,9999,0,9999,0
1649968420146,COGS 9,A01,083615,Staff,0,0,60,60
1649968426182,COGS 11,A01,083617,Boyle; Mary E. T.,32,0,40,8
1649968432209,COGS 13,A01,083071,Staff,0,19,40,40
1649968438240,COGS 14A,A01,092681,Staff,38,0,100,62
1649968444285,COGS 14B,A01,083073,Cheng; Tzu-Han,13,0,50,37
1649968450309,COGS 17,A01,092677,Staff,56,0,75,19
1649968456333,COGS 100,A01,083619,Staff,1,16,60,59
1649968462456,COGS 101A,A01,083621,Davis; Joshua Daniel,0,15,60,60
1649968468478,COGS 101B,A01,091572,Staff,24,0,60,36
1649968474501,COGS 101C,A01,083625,Delgado; Tania,22,0,30,8
1649968480527,COGS 107A,A01,083627,Boyle; Mary E. T.,2,0,60,58
1649968486551,COGS 118A,A01,083075,Staff,21,0,60,39
1649968492583,CSE 3,A50,083646,Miranda; Gregory Joseph,23,0,38,15
1649968492583,CSE 3,A51,083647,Miranda; Gregory Joseph,37,0,37,0
1649968498618,CSE 8A,A50,083650,Miranda; Gregory Joseph,1,4,40,39
1649968504645,CSE 11,A01,083080,Cao; Yingjun,0,41,40,40
1649968510668,CSE 12,A01,083652,Staff,37,0,100,63
1649968516716,CSE 15L,A01,083654,Staff,3,0,50,47
1649968516716,CSE 15L,A02,083655,Staff,44,0,50,6
1649968522742,CSE 20,A01,083657,Staff,61,0,80,19
1649968528770,CSE 30,A01,083084,Eldon; John,0,44,40,40
1649968534793,CSE 100,A01,083659,Cao; Yingjun,1,47,50,49
1649968540816,CSE 134B,A01,083661,Powell; Thomas Allan,0,24,65,65
1649968546840,CSE 140,A01,083663,Staff,15,0,75,60
1649968552862,CSE 140L,A01,083088,Eldon; John,11,0,75,64
1649968558889,CSE 175,A01,083665,Kumar; Rakesh,11,0,25,14
1649968564911,CSE 190,A00,092507,Dubnov; Shlomo,12,0,15,3
1649968570945,ECE 45,A01,083139,Staff,0,4,40,40
1649968576969,ECE 65,A50,083695,Staff,2,0,30,28
1649968582991,ECE 109,A01,091882,Touri; Behrouz,51,0,70,19
1649968589014,ECE 180,A00,083140,Abi Samra; Nicholas Camill,26,0,30,4
1649968589014,ECE 180,B00,083141,Abi Samra; Nicholas Camill,12,0,30,18
1649968595041,MATH 10A,A01,083735,Patchell; Gregory David,19,0,30,11
1649968595041,MATH 10A,A02,083736,Patchell; Gregory David,28,0,30,2
1649968595041,MATH 10A,A03,083737,Patchell; Gregory David,27,0,30,3
1649968601067,MATH 10B,A01,083207,Staff,4,0,30,26
1649968601067,MATH 10B,A02,083208,Staff,25,0,30,5
1649968601067,MATH 10B,B01,083739,Staff,25,0,30,5
1649968601067,MATH 10B,B02,083740,Staff,30,0,30,0
1649968607101,MATH 18,A01,083743,Staff,20,0,30,10
1649968607101,MATH 18,A02,083744,Staff,29,0,30,1
1649968607101,MATH 18,A03,083745,Staff,28,0,30,2
1649968607101,MATH 18,A04,083746,Staff,27,0,30,3
1649968607101,MATH 18,B01,083748,Staff,0,1,30,30
1649968607101,MATH 18,B02,083749,Staff,15,0,30,15
1649968607101,MATH 18,B03,083750,Staff,23,0,30,7
1649968607101,MATH 18,B04,083751,Staff,19,0,30,11
1649968613130,MATH 20A,A01,083754,Staff,33,0,40,7
1649968619152,MATH 20B,A01,083756,Staff,13,0,30,17
1649968619152,MATH 20B,A02,083757,Staff,28,0,30,2
1649968625178,MATH 20C,A01,083760,Staff,12,0,30,18
1649968625178,MATH 20C,A02,083761,Staff,9,0,30,21
1649968625178,MATH 20C,B01,083762,Staff,27,0,30,3
1649968625178,MATH 20C,B02,083763,Staff,30,0,30,0
1649968631209,MATH 20D,A01,083765,Staff,12,0,30,18
1649968631209,MATH 20D,A02,083766,Staff,29,0,30,1
1649968631209,MATH 20D,A03,083767,Staff,28,0,30,2
1649968637239,MATH 20E,A01,083771,Staff,11,0,30,19
1649968637239,MATH 20E,A02,083772,Staff,24,0,30,6
1649968637239,MATH 20E,B01,083773,Staff,7,0,30,23
1649968637239,MATH 20E,B02,083774,Staff,28,0,30,2
1649968643268,MATH 103A,A01,083777,Staff,1,5,30,29
1649968643268,MATH 103A,A02,083778,Staff,0,4,30,30
1649968643268,MATH 103A,B01,083779,Staff,0,3,30,30
1649968643268,MATH 103A,B02,083780,Staff,0,3,30,30
1649968649293,MATH 105,A01,085443,Staff,0,10,30,30
1649968655316,MATH 109,A01,083213,Anzaldo; Leesa B,0,1,30,30
1649968655316,MATH 109,A02,083214,Anzaldo; Leesa B,0,1,30,30
1649968655316,MATH 109,B01,083215,Anzaldo; Leesa B,21,0,30,9
1649968655316,MATH 109,B02,083216,Anzaldo; Leesa B,12,0,30,18
1649968661343,MATH 142A,A01,083219,Chow; Bennett,0,3,30,30
1649968661343,MATH 142A,A02,083220,Chow; Bennett,0,3,30,30
1649968661343,MATH 142A,B01,083221,Chow; Bennett,0,3,30,30
1649968661343,MATH 142A,B02,083222,Chow; Bennett,0,3,30,30
1649968667365,MATH 193A,A01,083224,Staff,0,5,30,30
1649968667365,MATH 193A,A02,083225,Staff,0,3,30,30
1649968667365,MATH 193A,A03,083781,Staff,2,0,30,28
1649968667365,MATH 193A,A04,083782,Staff,13,0,30,17
1649968673389,MATH 197,001,091859,McAuley; Julian John,9999,0,9999,0
1649968679442,COGS 9,A01,083615,Staff,0,0,60,60
1649968685476,COGS 11,A01,083617,Boyle; Mary E. T.,32,0,40,8
1649968691503,COGS 13,A01,083071,Staff,0,19,40,40
1649968697525,COGS 14A,A01,092681,Staff,38,0,100,62
1649968703554,COGS 14B,A01,083073,Cheng; Tzu-Han,13,0,50,37
1649968709592,COGS 17,A01,092677,Staff,56,0,75,19
1649968715616,COGS 100,A01,083619,Staff,1,15,60,59
1649968721646,COGS 101A,A01,083621,Davis; Joshua Daniel,0,15,60,60
1649968727676,COGS 101B,A01,091572,Staff,24,0,60,36
1649968733705,COGS 101C,A01,083625,Delgado; Tania,22,0,30,8
1649968739728,COGS 107A,A01,083627,Boyle; Mary E. T.,2,0,60,58
1649968745766,COGS 118A,A01,083075,Staff,21,0,60,39
1649968751801,CSE 3,A50,083646,Miranda; Gregory Joseph,23,0,38,15
1649968751801,CSE 3,A51,083647,Miranda; Gregory Joseph,37,0,37,0
1649968757838,CSE 8A,A50,083650,Miranda; Gregory Joseph,1,4,40,39
1649968763864,CSE 11,A01,083080,Cao; Yingjun,0,41,40,40
1649968769887,CSE 12,A01,083652,Staff,37,0,100,63
1649968775919,CSE 15L,A01,083654,Staff,3,0,50,47
1649968775919,CSE 15L,A02,083655,Staff,44,0,50,6
1649968781954,CSE 20,A01,083657,Staff,61,0,80,19
1649968787981,CSE 30,A01,083084,Eldon; John,0,44,40,40
1649968794005,CSE 100,A01,083659,Cao; Yingjun,1,47,50,49
1649968800038,CSE 134B,A01,083661,Powell; Thomas Allan,0,24,65,65
1649968806073,CSE 140,A01,083663,Staff,15,0,75,60
1649968812099,CSE 140L,A01,083088,Eldon; John,11,0,75,64
1649968818127,CSE 175,A01,083665,Kumar; Rakesh,11,0,25,14
1649968824158,CSE 190,A00,092507,Dubnov; Shlomo,12,0,15,3
1649968830181,ECE 45,A01,083139,Staff,0,4,40,40
1649968836213,ECE 65,A50,083695,Staff,2,0,30,28
1649968842242,ECE 109,A01,091882,Touri; Behrouz,51,0,70,19
1649968848264,ECE 180,A00,083140,Abi Samra; Nicholas Camill,26,0,30,4
1649968848264,ECE 180,B00,083141,Abi Samra; Nicholas Camill,12,0,30,18
1649968854291,MATH 10A,A01,083735,Patchell; Gregory David,19,0,30,11
1649968854291,MATH 10A,A02,083736,Patchell; Gregory David,28,0,30,2
1649968854291,MATH 10A,A03,083737,Patchell; Gregory David,27,0,30,3
1649968860325,MATH 10B,A01,083207,Staff,4,0,30,26
1649968860325,MATH 10B,A02,083208,Staff,25,0,30,5
1649968860325,MATH 10B,B01,083739,Staff,25,0,30,5
1649968860325,MATH 10B,B02,083740,Staff,30,0,30,0
1649968866356,MATH 18,A01,083743,Staff,20,0,30,10
1649968866356,MATH 18,A02,083744,Staff,29,0,30,1
1649968866356,MATH 18,A03,083745,Staff,28,0,30,2
1649968866356,MATH 18,A04,083746,Staff,27,0,30,3
1649968866356,MATH 18,B01,083748,Staff,0,1,30,30
1649968866356,MATH 18,B02,083749,Staff,14,0,30,16
1649968866356,MATH 18,B03,083750,Staff,23,0,30,7
1649968866356,MATH 18,B04,083751,Staff,19,0,30,11
1649968872389,MATH 20A,A01,083754,Staff,33,0,40,7
1649968878418,MATH 20B,A01,083756,Staff,13,0,30,17
1649968878418,MATH 20B,A02,083757,Staff,28,0,30,2
1649968884442,MATH 20C,A01,083760,Staff,12,0,30,18
1649968884442,MATH 20C,A02,083761,Staff,8,0,30,22
1649968884442,MATH 20C,B01,083762,Staff,27,0,30,3
1649968884442,MATH 20C,B02,083763,Staff,30,0,30,0
1649968890472,MATH 20D,A01,083765,Staff,12,0,30,18
1649968890472,MATH 20D,A02,083766,Staff,29,0,30,1
1649968890472,MATH 20D,A03,083767,Staff,28,0,30,2
1649968896496,MATH 20E,A01,083771,Staff,11,0,30,19
1649968896496,MATH 20E,A02,083772,Staff,24,0,30,6
1649968896496,MATH 20E,B01,083773,Staff,7,0,30,23
1649968896496,MATH 20E,B02,083774,Staff,28,0,30,2
1649968902525,MATH 103A,A01,083777,Staff,1,5,30,29
1649968902525,MATH 103A,A02,083778,Staff,0,4,30,30
1649968902525,MATH 103A,B01,083779,Staff,0,3,30,30
1649968902525,MATH 103A,B02,083780,Staff,0,3,30,30
1649968908557,MATH 105,A01,085443,Staff,0,10,30,30
1649968914580,MATH 109,A01,083213,Anzaldo; Leesa B,0,1,30,30
1649968914580,MATH 109,A02,083214,Anzaldo; Leesa B,0,1,30,30
1649968914580,MATH 109,B01,083215,Anzaldo; Leesa B,21,0,30,9
1649968914580,MATH 109,B02,083216,Anzaldo; Leesa B,10,0,30,20
1649968920607,MATH 142A,A01,083219,Chow; Bennett,0,3,30,30
1649968920607,MATH 142A,A02,083220,Chow; Bennett,0,3,30,30
1649968920607,MATH 142A,B01,083221,Chow; Bennett,0,3,30,30
1649968920607,MATH 142A,B02,083222,Chow; Bennett,0,3,30,30
1649968926632,MATH 193A,A01,083224,Staff,0,5,30,30
1649968926632,MATH 193A,A02,083225,Staff,0,3,30,30
1649968926632,MATH 193A,A03,083781,Staff,2,0,30,28
1649968926632,MATH 193A,A04,083782,Staff,13,0,30,17
1649968932658,MATH 197,001,091859,McAuley; Julian John,9999,0,9999,0
1649968938728,COGS 9,A01,083615,Staff,0,0,60,60
1649968944762,COGS 11,A01,083617,Boyle; Mary E. T.,32,0,40,8
1649968950803,COGS 13,A01,083071,Staff,0,20,40,40
1649968956828,COGS 14A,A01,092681,Staff,36,0,100,64
1649968962850,COGS 14B,A01,083073,Cheng; Tzu-Han,12,0,50,38
1649968968881,COGS 17,A01,092677,Staff,56,0,75,19
1649968974910,COGS 100,A01,083619,Staff,1,15,60,59
1649968980962,COGS 101A,A01,083621,Davis; Joshua Daniel,0,15,60,60
1649968986988,COGS 101B,A01,091572,Staff,24,0,60,36
1649968993010,COGS 101C,A01,083625,Delgado; Tania,22,0,30,8
1649968999034,COGS 107A,A01,083627,Boyle; Mary E. T.,2,0,60,58
1649969005062,COGS 118A,A01,083075,Staff,21,0,60,39
1649969011085,CSE 3,A50,083646,Miranda; Gregory Joseph,23,0,38,15
1649969011085,CSE 3,A51,083647,Miranda; Gregory Joseph,37,0,37,0
1649969017146,CSE 8A,A50,083650,Miranda; Gregory Joseph,1,4,40,39
1649969023169,CSE 11,A01,083080,Cao; Yingjun,0,41,40,40
1649969029194,CSE 12,A01,083652,Staff,37,0,100,63
1649969035230,CSE 15L,A01,083654,Staff,3,0,50,47
1649969035230,CSE 15L,A02,083655,Staff,44,0,50,6
1649969041254,CSE 20,A01,083657,Staff,61,0,80,19
1649969047302,CSE 30,A01,083084,Eldon; John,0,44,40,40
1649969053325,CSE 100,A01,083659,Cao; Yingjun,1,49,50,49
1649969069912,CSE 134B,A01,083661,Powell; Thomas Allan,0,24,65,65
1649969075939,CSE 140,A01,083663,Staff,14,0,75,61
1649969081977,CSE 140L,A01,083088,Eldon; John,10,0,75,65
1649969088012,CSE 175,A01,083665,Kumar; Rakesh,11,0,25,14
1649969094047,CSE 190,A00,092507,Dubnov; Shlomo,12,0,15,3
1649969100075,ECE 45,A01,083139,Staff,0,4,40,40
1649969106099,ECE 65,A50,083695,Staff,2,0,30,28
1649969112137,ECE 109,A01,091882,Touri; Behrouz,51,0,70,19
1649969118161,ECE 180,A00,083140,Abi Samra; Nicholas Camill,26,0,30,4
1649969118161,ECE 180,B00,083141,Abi Samra; Nicholas Camill,12,0,30,18
1649969124184,MATH 10A,A01,083735,Patchell; Gregory David,19,0,30,11
1649969124184,MATH 10A,A02,083736,Patchell; Gregory David,28,0,30,2
1649969124184,MATH 10A,A03,083737,Patchell; Gregory David,27,0,30,3
1649969130212,MATH 10B,A01,083207,Staff,2,0,30,28
1649969130212,MATH 10B,A02,083208,Staff,25,0,30,5
1649969130212,MATH 10B,B01,083739,Staff,24,0,30,6
1649969130212,MATH 10B,B02,083740,Staff,30,0,30,0
1649969136242,MATH 18,A01,083743,Staff,20,0,30,10
1649969136242,MATH 18,A02,083744,Staff,29,0,30,1
1649969136242,MATH 18,A03,083745,Staff,27,0,30,3
1649969136242,MATH 18,A04,083746,Staff,27,0,30,3
1649969136242,MATH 18,B01,083748,Staff,0,1,30,30
1649969136242,MATH 18,B02,083749,Staff,12,0,30,18
1649969136242,MATH 18,B03,083750,Staff,23,0,30,7
1649969136242,MATH 18,B04,083751,Staff,18,0,30,12
1649969142267,MATH 20A,A01,083754,Staff,33,0,40,7
1649969148310,MATH 20B,A01,083756,Staff,13,0,30,17
1649969148310,MATH 20B,A02,083757,Staff,27,0,30,3
1649969154334,MATH 20C,A01,083760,Staff,11,0,30,19
1649969154334,MATH 20C,A02,083761,Staff,7,0,30,23
1649969154334,MATH 20C,B01,083762,Staff,26,0,30,4
1649969154334,MATH 20C,B02,083763,Staff,30,0,30,0
1649969160368,MATH 20D,A01,083765,Staff,12,0,30,18
1649969160368,MATH 20D,A02,083766,Staff,29,0,30,1
1649969160368,MATH 20D,A03,083767,Staff,28,0,30,2
1649969166401,MATH 20E,A01,083771,Staff,11,0,30,19
1649969166401,MATH 20E,A02,083772,Staff,24,0,30,6
1649969166401,MATH 20E,B01,083773,Staff,7,0,30,23
1649969166401,MATH 20E,B02,083774,Staff,28,0,30,2
1649969172435,MATH 103A,A01,083777,Staff,1,5,30,29
1649969172435,MATH 103A,A02,083778,Staff,0,4,30,30
1649969172435,MATH 103A,B01,083779,Staff,0,3,30,30
1649969172435,MATH 103A,B02,083780,Staff,0,3,30,30
1649969178458,MATH 105,A01,085443,Staff,0,10,30,30
1649969184493,MATH 109,A01,083213,Anzaldo; Leesa B,0,1,30,30
1649969184493,MATH 109,A02,083214,Anzaldo; Leesa B,0,1,30,30
1649969184493,MATH 109,B01,083215,Anzaldo; Leesa B,21,0,30,9
1649969184493,MATH 109,B02,083216,Anzaldo; Leesa B,10,0,30,20
1649969190524,MATH 142A,A01,083219,Chow; Bennett,0,3,30,30
1649969190524,MATH 142A,A02,083220,Chow; Bennett,0,3,30,30
1649969190524,MATH 142A,B01,083221,Chow; Bennett,0,3,30,30
1649969190524,MATH 142A,B02,083222,Chow; Bennett,0,3,30,30
1649969196549,MATH 193A,A01,083224,Staff,0,5,30,30
1649969196549,MATH 193A,A02,083225,Staff,0,3,30,30
1649969196549,MATH 193A,A03,083781,Staff,2,0,30,28
1649969196549,MATH 193A,A04,083782,Staff,13,0,30,17
1649969202570,MATH 197,001,091859,McAuley; Julian John,9999,0,9999,0
1649969208635,COGS 9,A01,083615,Staff,0,0,60,60
1649969214657,COGS 11,A01,083617,Boyle; Mary E. T.,32,0,40,8
1649969220679,COGS 13,A01,083071,Staff,0,21,40,40
1649969226701,COGS 14A,A01,092681,Staff,36,0,100,64
1649969232728,COGS 14B,A01,083073,Cheng; Tzu-Han,11,0,50,39
1649969238751,COGS 17,A01,092677,Staff,55,0,75,20
1649969244787,COGS 100,A01,083619,Staff,1,15,60,59
1649969250812,COGS 101A,A01,083621,Davis; Joshua Daniel,0,15,60,60
1649969256837,COGS 101B,A01,091572,Staff,24,0,60,36
1649969262861,COGS 101C,A01,083625,Delgado; Tania,22,0,30,8
1649969268887,COGS 107A,A01,083627,Boyle; Mary E. T.,2,0,60,58
1649969274929,COGS 118A,A01,083075,Staff,21,0,60,39
1649969280952,CSE 3,A50,083646,Miranda; Gregory Joseph,23,0,38,15
1649969280952,CSE 3,A51,083647,Miranda; Gregory Joseph,37,0,37,0
1649969286978,CSE 8A,A50,083650,Miranda; Gregory Joseph,1,4,40,39
1649969293000,CSE 11,A01,083080,Cao; Yingjun,0,41,40,40
1649969299027,CSE 12,A01,083652,Staff,37,0,100,63
1649969305073,CSE 15L,A01,083654,Staff,3,0,50,47
1649969305073,CSE 15L,A02,083655,Staff,44,0,50,6
1649969311103,CSE 20,A01,083657,Staff,61,0,80,19
1649969317131,CSE 30,A01,083084,Eldon; John,0,44,40,40
1649969323168,CSE 100,A01,083659,Cao; Yingjun,1,49,50,49
1649969329194,CSE 134B,A01,083661,Powell; Thomas Allan,0,24,65,65
1649969335220,CSE 140,A01,083663,Staff,13,0,75,62
1649969341247,CSE 140L,A01,083088,Eldon; John,9,0,75,66
1649969347276,CSE 175,A01,083665,Kumar; Rakesh,11,0,25,14
1649969353310,CSE 190,A00,092507,Dubnov; Shlomo,12,0,15,3
1649969359345,ECE 45,A01,083139,Staff,0,4,40,40
1649969365373,ECE 65,A50,083695,Staff,2,0,30,28
1649969371399,ECE 109,A01,091882,Touri; Behrouz,51,0,70,19
1649969377434,ECE 180,A00,083140,Abi Samra; Nicholas Camill,26,0,30,4
1649969377434,ECE 180,B00,083141,Abi Samra; Nicholas Camill,11,0,30,19
1649969383484,MATH 10A,A01,083735,Patchell; Gregory David,19,0,30,11
1649969383484,MATH 10A,A02,083736,Patchell; Gregory David,28,0,30,2
1649969383484,MATH 10A,A03,083737,Patchell; Gregory David,27,0,30,3
1649969389508,MATH 10B,A01,083207,Staff,1,0,30,29
1649969389508,MATH 10B,A02,083208,Staff,25,0,30,5
1649969389508,MATH 10B,B01,083739,Staff,24,0,30,6
1649969389508,MATH 10B,B02,083740,Staff,30,0,30,0
1649969395541,MATH 18,A01,083743,Staff,20,0,30,10
1649969395541,MATH 18,A02,083744,Staff,29,0,30,1
1649969395541,MATH 18,A03,083745,Staff,27,0,30,3
1649969395541,MATH 18,A04,083746,Staff,27,0,30,3
1649969395541,MATH 18,B01,083748,Staff,0,1,30,30
1649969395541,MATH 18,B02,083749,Staff,12,0,30,18
1649969395541,MATH 18,B03,083750,Staff,23,0,30,7
1649969395541,MATH 18,B04,083751,Staff,19,0,30,11
1649969401570,MATH 20A,A01,083754,Staff,33,0,40,7
1649969407597,MATH 20B,A01,083756,Staff,13,0,30,17
1649969407597,MATH 20B,A02,083757,Staff,27,0,30,3
1649969413624,MATH 20C,A01,083760,Staff,11,0,30,19
1649969413624,MATH 20C,A02,083761,Staff,7,0,30,23
1649969413624,MATH 20C,B01,083762,Staff,26,0,30,4
1649969413624,MATH 20C,B02,083763,Staff,30,0,30,0
1649969419650,MATH 20D,A01,083765,Staff,12,0,30,18
1649969419650,MATH 20D,A02,083766,Staff,29,0,30,1
1649969419650,MATH 20D,A03,083767,Staff,28,0,30,2
1649969425679,MATH 20E,A01,083771,Staff,11,0,30,19
1649969425679,MATH 20E,A02,083772,Staff,24,0,30,6
1649969425679,MATH 20E,B01,083773,Staff,7,0,30,23
1649969425679,MATH 20E,B02,083774,Staff,28,0,30,2
1649969431703,MATH 103A,A01,083777,Staff,1,5,30,29
1649969431703,MATH 103A,A02,083778,Staff,0,4,30,30
1649969431703,MATH 103A,B01,083779,Staff,0,3,30,30
1649969431703,MATH 103A,B02,083780,Staff,0,3,30,30
1649969437733,MATH 105,A01,085443,Staff,0,10,30,30
1649969443771,MATH 109,A01,083213,Anzaldo; Leesa B,0,1,30,30
1649969443771,MATH 109,A02,083214,Anzaldo; Leesa B,0,1,30,30
1649969443771,MATH 109,B01,083215,Anzaldo; Leesa B,21,0,30,9
1649969443771,MATH 109,B02,083216,Anzaldo; Leesa B,10,0,30,20
1649969449803,MATH 142A,A01,083219,Chow; Bennett,0,3,30,30
1649969449803,MATH 142A,A02,083220,Chow; Bennett,0,3,30,30
1649969449803,MATH 142A,B01,083221,Chow; Bennett,0,3,30,30
1649969449803,MATH 142A,B02,083222,Chow; Bennett,0,3,30,30
1649969455838,MATH 193A,A01,083224,Staff,0,5,30,30
1649969455838,MATH 193A,A02,083225,Staff,0,3,30,30
1649969455838,MATH 193A,A03,083781,Staff,2,0,30,28
1649969455838,MATH 193A,A04,083782,Staff,13,0,30,17
1649969461870,MATH 197,001,091859,McAuley; Julian John,9999,0,9999,0
1649969467929,COGS 9,A01,083615,Staff,0,1,60,60
1649969473954,COGS 11,A01,083617,Boyle; Mary E. T.,32,0,40,8
1649969479979,COGS 13,A01,083071,Staff,0,21,40,40
1649969486006,COGS 14A,A01,092681,Staff,35,0,100,65
1649969492033,COGS 14B,A01,083073,Cheng; Tzu-Han,11,0,50,39
1649969498063,COGS 17,A01,092677,Staff,55,0,75,20
1649969504086,COGS 100,A01,083619,Staff,1,15,60,59
1649969510118,COGS 101A,A01,083621,Davis; Joshua Daniel,0,15,60,60
1649969516142,COGS 101B,A01,091572,Staff,24,0,60,36
1649969522168,COGS 101C,A01,083625,Delgado; Tania,22,0,30,8
1649969528202,COGS 107A,A01,083627,Boyle; Mary E. T.,2,0,60,58
1649969534224,COGS 118A,A01,083075,Staff,21,0,60,39
1649969540247,CSE 3,A50,083646,Miranda; Gregory Joseph,23,0,38,15
1649969540247,CSE 3,A51,083647,Miranda; Gregory Joseph,37,0,37,0
1649969546269,CSE 8A,A50,083650,Miranda; Gregory Joseph,1,5,40,39
1649969552294,CSE 11,A01,083080,Cao; Yingjun,0,41,40,40
1649969558325,CSE 12,A01,083652,Staff,36,0,100,64
1649969564360,CSE 15L,A01,083654,Staff,2,0,50,48
1649969564360,CSE 15L,A02,083655,Staff,44,0,50,6
1649969570382,CSE 20,A01,083657,Staff,61,0,80,19
1649969576408,CSE 30,A01,083084,Eldon; John,0,44,40,40
1649969582437,CSE 100,A01,083659,Cao; Yingjun,1,49,50,49
1649969588460,CSE 134B,A01,083661,Powell; Thomas Allan,0,24,65,65
1649969594486,CSE 140,A01,083663,Staff,13,0,75,62
1649969600508,CSE 140L,A01,083088,Eldon; John,9,0,75,66
1649969606532,CSE 175,A01,083665,Kumar; Rakesh,11,0,25,14
1649969612583,CSE 190,A00,092507,Dubnov; Shlomo,12,0,15,3
1649969618607,ECE 45,A01,083139,Staff,0,4,40,40
1649969624633,ECE 65,A50,083695,Staff,2,0,30,28
1649969630661,ECE 109,A01,091882,Touri; Behrouz,51,0,70,19
1649969636688,ECE 180,A00,083140,Abi Samra; Nicholas Camill,26,0,30,4
1649969636688,ECE 180,B00,083141,Abi Samra; Nicholas Camill,11,0,30,19
1649969642717,MATH 10A,A01,083735,Patchell; Gregory David,19,0,30,11
1649969642717,MATH 10A,A02,083736,Patchell; Gregory David,28,0,30,2
1649969642717,MATH 10A,A03,083737,Patchell; Gregory David,27,0,30,3
1649969648746,MATH 10B,A01,083207,Staff,0,0,30,30
1649969648746,MATH 10B,A02,083208,Staff,25,0,30,5
1649969648746,MATH 10B,B01,083739,Staff,24,0,30,6
1649969648746,MATH 10B,B02,083740,Staff,30,0,30,0
1649969654786,MATH 18,A01,083743,Staff,20,0,30,10
1649969654786,MATH 18,A02,083744,Staff,29,0,30,1
1649969654786,MATH 18,A03,083745,Staff,27,0,30,3
1649969654786,MATH 18,A04,083746,Staff,27,0,30,3
1649969654786,MATH 18,B01,083748,Staff,0,1,30,30
1649969654786,MATH 18,B02,083749,Staff,10,0,30,20
1649969654786,MATH 18,B03,083750,Staff,23,0,30,7
1649969654786,MATH 18,B04,083751,Staff,19,0,30,11
1649969660818,MATH 20A,A01,083754,Staff,33,0,40,7
1649969666934,MATH 20B,A01,083756,Staff,13,0,30,17
1649969666934,MATH 20B,A02,083757,Staff,27,0,30,3
1649969672961,MATH 20C,A01,083760,Staff,10,0,30,20
1649969672961,MATH 20C,A02,083761,Staff,6,0,30,24
1649969672961,MATH 20C,B01,083762,Staff,26,0,30,4
1649969672961,MATH 20C,B02,083763,Staff,30,0,30,0
1649969678984,MATH 20D,A01,083765,Staff,11,0,30,19
1649969678984,MATH 20D,A02,083766,Staff,29,0,30,1
1649969678984,MATH 20D,A03,083767,Staff,28,0,30,2
1649969685013,MATH 20E,A01,083771,Staff,11,0,30,19
1649969685013,MATH 20E,A02,083772,Staff,24,0,30,6
1649969685013,MATH 20E,B01,083773,Staff,7,0,30,23
1649969685013,MATH 20E,B02,083774,Staff,28,0,30,2
1649969691046,MATH 103A,A01,083777,Staff,1,5,30,29
1649969691046,MATH 103A,A02,083778,Staff,0,4,30,30
1649969691046,MATH 103A,B01,083779,Staff,0,4,30,30
1649969691046,MATH 103A,B02,083780,Staff,0,3,30,30
1649969697073,MATH 105,A01,085443,Staff,0,10,30,30
1649969703096,MATH 109,A01,083213,Anzaldo; Leesa B,0,1,30,30
1649969703096,MATH 109,A02,083214,Anzaldo; Leesa B,0,1,30,30
1649969703096,MATH 109,B01,083215,Anzaldo; Leesa B,21,0,30,9
1649969703096,MATH 109,B02,083216,Anzaldo; Leesa B,10,0,30,20
1649969709120,MATH 142A,A01,083219,Chow; Bennett,0,3,30,30
1649969709120,MATH 142A,A02,083220,Chow; Bennett,0,3,30,30
1649969709120,MATH 142A,B01,083221,Chow; Bennett,0,3,30,30
1649969709120,MATH 142A,B02,083222,Chow; Bennett,0,3,30,30
1649969715143,MATH 193A,A01,083224,Staff,0,5,30,30
1649969715143,MATH 193A,A02,083225,Staff,0,3,30,30
1649969715143,MATH 193A,A03,083781,Staff,2,0,30,28
1649969715143,MATH 193A,A04,083782,Staff,13,0,30,17
1649969721167,MATH 197,001,091859,McAuley; Julian John,9999,0,9999,0
1649969727232,COGS 9,A01,083615,Staff,0,2,60,60
1649969733257,COGS 11,A01,083617,Boyle; Mary E. T.,32,0,40,8
1649969739288,COGS 13,A01,083071,Staff,0,21,40,40
1649969745318,COGS 14A,A01,092681,Staff,35,0,100,65
1649969751349,COGS 14B,A01,083073,Cheng; Tzu-Han,11,0,50,39
1649969757375,COGS 17,A01,092677,Staff,55,0,75,20
1649969763403,COGS 100,A01,083619,Staff,1,15,60,59
1649969769432,COGS 101A,A01,083621,Davis; Joshua Daniel,0,15,60,60
1649969775455,COGS 101B,A01,091572,Staff,24,0,60,36
1649969781478,COGS 101C,A01,083625,Delgado; Tania,22,0,30,8
1649969787503,COGS 107A,A01,083627,Boyle; Mary E. T.,2,0,60,58
1649969793526,COGS 118A,A01,083075,Staff,21,0,60,39
1649969799556,CSE 3,A50,083646,Miranda; Gregory Joseph,23,0,38,15
1649969799556,CSE 3,A51,083647,Miranda; Gregory Joseph,37,0,37,0
1649969805583,CSE 8A,A50,083650,Miranda; Gregory Joseph,1,5,40,39
1649969811606,CSE 11,A01,083080,Cao; Yingjun,0,41,40,40
1649969817640,CSE 12,A01,083652,Staff,35,0,100,65
1649969823667,CSE 15L,A01,083654,Staff,1,0,50,49
1649969823667,CSE 15L,A02,083655,Staff,44,0,50,6
1649969829691,CSE 20,A01,083657,Staff,61,0,80,19
1649969835725,CSE 30,A01,083084,Eldon; John,0,44,40,40
1649969841747,CSE 100,A01,083659,Cao; Yingjun,1,50,50,49
1649969847786,CSE 134B,A01,083661,Powell; Thomas Allan,0,24,65,65
1649969853818,CSE 140,A01,083663,Staff,13,0,75,62
1649969859842,CSE 140L,A01,083088,Eldon; John,9,0,75,66
1649969865865,CSE 175,A01,083665,Kumar; Rakesh,11,0,25,14
1649969871892,CSE 190,A00,092507,Dubnov; Shlomo,12,0,15,3
1649969877918,ECE 45,A01,083139,Staff,0,4,40,40
1649969883945,ECE 65,A50,083695,Staff,2,0,30,28
1649969889973,ECE 109,A01,091882,Touri; Behrouz,51,0,70,19
1649969895997,ECE 180,A00,083140,Abi Samra; Nicholas Camill,26,0,30,4
1649969895997,ECE 180,B00,083141,Abi Samra; Nicholas Camill,11,0,30,19
1649969902032,MATH 10A,A01,083735,Patchell; Gregory David,19,0,30,11
1649969902032,MATH 10A,A02,083736,Patchell; Gregory David,28,0,30,2
1649969902032,MATH 10A,A03,083737,Patchell; Gregory David,27,0,30,3
1649969908065,MATH 10B,A01,083207,Staff,1,0,30,29
1649969908065,MATH 10B,A02,083208,Staff,25,0,30,5
1649969908065,MATH 10B,B01,083739,Staff,24,0,30,6
1649969908065,MATH 10B,B02,083740,Staff,30,0,30,0
1649969914108,MATH 18,A01,083743,Staff,20,0,30,10
1649969914108,MATH 18,A02,083744,Staff,29,0,30,1
1649969914108,MATH 18,A03,083745,Staff,27,0,30,3
1649969914108,MATH 18,A04,083746,Staff,27,0,30,3
1649969914108,MATH 18,B01,083748,Staff,0,1,30,30
1649969914108,MATH 18,B02,083749,Staff,10,0,30,20
1649969914108,MATH 18,B03,083750,Staff,23,0,30,7
1649969914108,MATH 18,B04,083751,Staff,19,0,30,11
1649969920132,MATH 20A,A01,083754,Staff,33,0,40,7
1649969926168,MATH 20B,A01,083756,Staff,13,0,30,17
1649969926168,MATH 20B,A02,083757,Staff,27,0,30,3
1649969932196,MATH 20C,A01,083760,Staff,11,0,30,19
1649969932196,MATH 20C,A02,083761,Staff,6,0,30,24
1649969932196,MATH 20C,B01,083762,Staff,26,0,30,4
1649969932196,MATH 20C,B02,083763,Staff,30,0,30,0
1649969938219,MATH 20D,A01,083765,Staff,11,0,30,19
1649969938219,MATH 20D,A02,083766,Staff,29,0,30,1
1649969938219,MATH 20D,A03,083767,Staff,28,0,30,2
1649969944255,MATH 20E,A01,083771,Staff,11,0,30,19
1649969944255,MATH 20E,A02,083772,Staff,24,0,30,6
1649969944255,MATH 20E,B01,083773,Staff,7,0,30,23
1649969944255,MATH 20E,B02,083774,Staff,28,0,30,2
1649969950288,MATH 103A,A01,083777,Staff,1,5,30,29
1649969950288,MATH 103A,A02,083778,Staff,0,4,30,30
1649969950288,MATH 103A,B01,083779,Staff,0,4,30,30
1649969950288,MATH 103A,B02,083780,Staff,0,3,30,30
1649969956312,MATH 105,A01,085443,Staff,0,10,30,30
1649969962336,MATH 109,A01,083213,Anzaldo; Leesa B,0,2,30,30
1649969962336,MATH 109,A02,083214,Anzaldo; Leesa B,0,1,30,30
1649969962336,MATH 109,B01,083215,Anzaldo; Leesa B,21,0,30,9
1649969962336,MATH 109,B02,083216,Anzaldo; Leesa B,10,0,30,20
1649969968366,MATH 142A,A01,083219,Chow; Bennett,0,3,30,30
1649969968366,MATH 142A,A02,083220,Chow; Bennett,0,3,30,30
1649969968366,MATH 142A,B01,083221,Chow; Bennett,0,3,30,30
1649969968366,MATH 142A,B02,083222,Chow; Bennett,0,3,30,30
1649969974389,MATH 193A,A01,083224,Staff,0,5,30,30
1649969974389,MATH 193A,A02,083225,Staff,0,3,30,30
1649969974389,MATH 193A,A03,083781,Staff,2,0,30,28
1649969974389,MATH 193A,A04,083782,Staff,13,0,30,17
1649969980415,MATH 197,001,091859,McAuley; Julian John,9999,0,9999,0
1649969986483,COGS 9,A01,083615,Staff,0,2,60,60
1649969992507,COGS 11,A01,083617,Boyle; Mary E. T.,32,0,40,8
1649969998529,COGS 13,A01,083071,Staff,0,22,40,40
1649970004558,COGS 14A,A01,092681,Staff,34,0,100,66
1649970010581,COGS 14B,A01,083073,Cheng; Tzu-Han,11,0,50,39
1649970016604,COGS 17,A01,092677,Staff,55,0,75,20
1649970022627,COGS 100,A01,083619,Staff,1,15,60,59
1649970028657,COGS 101A,A01,083621,Davis; Joshua Daniel,0,15,60,60
1649970034687,COGS 101B,A01,091572,Staff,23,0,60,37
1649970040720,COGS 101C,A01,083625,Delgado; Tania,22,0,30,8
1649970046758,COGS 107A,A01,083627,Boyle; Mary E. T.,2,0,60,58
1649970052786,COGS 118A,A01,083075,Staff,21,0,60,39
1649970058816,CSE 3,A50,083646,Miranda; Gregory Joseph,22,0,38,16
1649970058816,CSE 3,A51,083647,Miranda; Gregory Joseph,37,0,37,0
1649970064853,CSE 8A,A50,083650,Miranda; Gregory Joseph,1,5,40,39
1649970070879,CSE 11,A01,083080,Cao; Yingjun,0,41,40,40
1649970076912,CSE 12,A01,083652,Staff,35,0,100,65
1649970082947,CSE 15L,A01,083654,Staff,1,0,50,49
1649970082947,CSE 15L,A02,083655,Staff,44,0,50,6
1649970088974,CSE 20,A01,083657,Staff,61,0,80,19
1649970095003,CSE 30,A01,083084,Eldon; John,0,44,40,40
1649970101039,CSE 100,A01,083659,Cao; Yingjun,1,50,50,49
1649970107063,CSE 134B,A01,083661,Powell; Thomas Allan,0,24,65,65
1649970113090,CSE 140,A01,083663,Staff,13,0,75,62
1649970119119,CSE 140L,A01,083088,Eldon; John,9,0,75,66
1649970125144,CSE 175,A01,083665,Kumar; Rakesh,10,0,25,15
1649970131174,CSE 190,A00,092507,Dubnov; Shlomo,12,0,15,3
1649970137197,ECE 45,A01,083139,Staff,0,4,40,40
1649970143243,ECE 65,A50,083695,Staff,2,0,30,28
1649970149266,ECE 109,A01,091882,Touri; Behrouz,51,0,70,19
1649970155296,ECE 180,A00,083140,Abi Samra; Nicholas Camill,26,0,30,4
1649970155296,ECE 180,B00,083141,Abi Samra; Nicholas Camill,11,0,30,19
1649970161321,MATH 10A,A01,083735,Patchell; Gregory David,19,0,30,11
1649970161321,MATH 10A,A02,083736,Patchell; Gregory David,28,0,30,2
1649970161321,MATH 10A,A03,083737,Patchell; Gregory David,27,0,30,3
1649970167350,MATH 10B,A01,083207,Staff,1,0,30,29
1649970167350,MATH 10B,A02,083208,Staff,25,0,30,5
1649970167350,MATH 10B,B01,083739,Staff,24,0,30,6
1649970167350,MATH 10B,B02,083740,Staff,30,0,30,0
1649970173374,MATH 18,A01,083743,Staff,20,0,30,10
1649970173374,MATH 18,A02,083744,Staff,29,0,30,1
1649970173374,MATH 18,A03,083745,Staff,27,0,30,3
1649970173374,MATH 18,A04,083746,Staff,27,0,30,3
1649970173374,MATH 18,B01,083748,Staff,0,1,30,30
1649970173374,MATH 18,B02,083749,Staff,9,0,30,21
1649970173374,MATH 18,B03,083750,Staff,23,0,30,7
1649970173374,MATH 18,B04,083751,Staff,19,0,30,11
1649970179401,MATH 20A,A01,083754,Staff,33,0,40,7
1649970185425,MATH 20B,A01,083756,Staff,13,0,30,17
1649970185425,MATH 20B,A02,083757,Staff,27,0,30,3
1649970191453,MATH 20C,A01,083760,Staff,11,0,30,19
1649970191453,MATH 20C,A02,083761,Staff,5,0,30,25
1649970191453,MATH 20C,B01,083762,Staff,26,0,30,4
1649970191453,MATH 20C,B02,083763,Staff,30,0,30,0
1649970197489,MATH 20D,A01,083765,Staff,11,0,30,19
1649970197489,MATH 20D,A02,083766,Staff,29,0,30,1
1649970197489,MATH 20D,A03,083767,Staff,28,0,30,2
1649970203529,MATH 20E,A01,083771,Staff,11,0,30,19
1649970203529,MATH 20E,A02,083772,Staff,24,0,30,6
1649970203529,MATH 20E,B01,083773,Staff,7,0,30,23
1649970203529,MATH 20E,B02,083774,Staff,28,0,30,2
1649970209563,MATH 103A,A01,083777,Staff,1,5,30,29
1649970209563,MATH 103A,A02,083778,Staff,0,4,30,30
1649970209563,MATH 103A,B01,083779,Staff,0,4,30,30
1649970209563,MATH 103A,B02,083780,Staff,0,4,30,30
1649970215595,MATH 105,A01,085443,Staff,0,10,30,30
1649970221619,MATH 109,A01,083213,Anzaldo; Leesa B,0,2,30,30
1649970221619,MATH 109,A02,083214,Anzaldo; Leesa B,0,1,30,30
1649970221619,MATH 109,B01,083215,Anzaldo; Leesa B,21,0,30,9
1649970221619,MATH 109,B02,083216,Anzaldo; Leesa B,9,0,30,21
1649970227648,MATH 142A,A01,083219,Chow; Bennett,0,3,30,30
1649970227648,MATH 142A,A02,083220,Chow; Bennett,0,3,30,30
1649970227648,MATH 142A,B01,083221,Chow; Bennett,0,3,30,30
1649970227648,MATH 142A,B02,083222,Chow; Bennett,0,3,30,30
1649970233677,MATH 193A,A01,083224,Staff,0,5,30,30
1649970233677,MATH 193A,A02,083225,Staff,0,3,30,30
1649970233677,MATH 193A,A03,083781,Staff,1,0,30,29
1649970233677,MATH 193A,A04,083782,Staff,13,0,30,17
1649970239710,MATH 197,001,091859,McAuley; Julian John,9999,0,9999,0
1649970245776,COGS 9,A01,083615,Staff,0,2,60,60
1649970251798,COGS 11,A01,083617,Boyle; Mary E. T.,32,0,40,8
1649970257921,COGS 13,A01,083071,Staff,0,22,40,40
1649970263950,COGS 14A,A01,092681,Staff,33,0,100,67
1649970269981,COGS 14B,A01,083073,Cheng; Tzu-Han,11,0,50,39
1649970276004,COGS 17,A01,092677,Staff,55,0,75,20
1649970282031,COGS 100,A01,083619,Staff,1,15,60,59
1649970288061,COGS 101A,A01,083621,Davis; Joshua Daniel,0,15,60,60
1649970294092,COGS 101B,A01,091572,Staff,23,0,60,37
1649970300118,COGS 101C,A01,083625,Delgado; Tania,22,0,30,8
1649970306141,COGS 107A,A01,083627,Boyle; Mary E. T.,2,0,60,58
1649970312169,COGS 118A,A01,083075,Staff,21,0,60,39
1649970318198,CSE 3,A50,083646,Miranda; Gregory Joseph,22,0,38,16
1649970318198,CSE 3,A51,083647,Miranda; Gregory Joseph,37,0,37,0
1649970324222,CSE 8A,A50,083650,Miranda; Gregory Joseph,1,5,40,39
1649970330261,CSE 11,A01,083080,Cao; Yingjun,0,41,40,40
1649970336297,CSE 12,A01,083652,Staff,34,0,100,66
1649970342323,CSE 15L,A01,083654,Staff,0,0,50,50
1649970342323,CSE 15L,A02,083655,Staff,44,0,50,6
1649970348383,CSE 20,A01,083657,Staff,61,0,80,19
1649970354406,CSE 30,A01,083084,Eldon; John,0,44,40,40
1649970360436,CSE 100,A01,083659,Cao; Yingjun,1,50,50,49
1649970366463,CSE 134B,A01,083661,Powell; Thomas Allan,0,24,65,65
1649970372486,CSE 140,A01,083663,Staff,13,0,75,62
1649970378520,CSE 140L,A01,083088,Eldon; John,9,0,75,66
1649970384547,CSE 175,A01,083665,Kumar; Rakesh,10,0,25,15
1649970390569,CSE 190,A00,092507,Dubnov; Shlomo,12,0,15,3
1649970396599,ECE 45,A01,083139,Staff,0,4,40,40
1649970402625,ECE 65,A50,083695,Staff,2,0,30,28
1649970408648,ECE 109,A01,091882,Touri; Behrouz,51,0,70,19
1649970414684,ECE 180,A00,083140,Abi Samra; Nicholas Camill,26,0,30,4
1649970414684,ECE 180,B00,083141,Abi Samra; Nicholas Camill,11,0,30,19
1649970420732,MATH 10A,A01,083735,Patchell; Gregory David,19,0,30,11
1649970420732,MATH 10A,A02,083736,Patchell; Gregory David,28,0,30,2
1649970420732,MATH 10A,A03,083737,Patchell; Gregory David,27,0,30,3
1649970426762,MATH 10B,A01,083207,Staff,1,0,30,29
1649970426762,MATH 10B,A02,083208,Staff,25,0,30,5
1649970426762,MATH 10B,B01,083739,Staff,24,0,30,6
1649970426762,MATH 10B,B02,083740,Staff,30,0,30,0
1649970432790,MATH 18,A01,083743,Staff,20,0,30,10
1649970432790,MATH 18,A02,083744,Staff,29,0,30,1
1649970432790,MATH 18,A03,083745,Staff,27,0,30,3
1649970432790,MATH 18,A04,083746,Staff,27,0,30,3
1649970432790,MATH 18,B01,083748,Staff,0,1,30,30
1649970432790,MATH 18,B02,083749,Staff,9,0,30,21
1649970432790,MATH 18,B03,083750,Staff,23,0,30,7
1649970432790,MATH 18,B04,083751,Staff,19,0,30,11
1649970438814,MATH 20A,A01,083754,Staff,33,0,40,7
1649970444836,MATH 20B,A01,083756,Staff,12,0,30,18
1649970444836,MATH 20B,A02,083757,Staff,27,0,30,3
1649970450870,MATH 20C,A01,083760,Staff,11,0,30,19
1649970450870,MATH 20C,A02,083761,Staff,5,0,30,25
1649970450870,MATH 20C,B01,083762,Staff,26,0,30,4
1649970450870,MATH 20C,B02,083763,Staff,30,0,30,0
1649970456911,MATH 20D,A01,083765,Staff,11,0,30,19
1649970456911,MATH 20D,A02,083766,Staff,29,0,30,1
1649970456911,MATH 20D,A03,083767,Staff,28,0,30,2
1649970462940,MATH 20E,A01,083771,Staff,11,0,30,19
1649970462940,MATH 20E,A02,083772,Staff,24,0,30,6
1649970462940,MATH 20E,B01,083773,Staff,7,0,30,23
1649970462940,MATH 20E,B02,083774,Staff,28,0,30,2
1649970468969,MATH 103A,A01,083777,Staff,1,5,30,29
1649970468969,MATH 103A,A02,083778,Staff,0,4,30,30
1649970468969,MATH 103A,B01,083779,Staff,0,4,30,30
1649970468969,MATH 103A,B02,083780,Staff,0,4,30,30
1649970475004,MATH 105,A01,085443,Staff,0,10,30,30
1649970481031,MATH 109,A01,083213,Anzaldo; Leesa B,0,2,30,30
1649970481031,MATH 109,A02,083214,Anzaldo; Leesa B,0,1,30,30
1649970481031,MATH 109,B01,083215,Anzaldo; Leesa B,21,0,30,9
1649970481031,MATH 109,B02,083216,Anzaldo; Leesa B,9,0,30,21
1649970487060,MATH 142A,A01,083219,Chow; Bennett,0,3,30,30
1649970487060,MATH 142A,A02,083220,Chow; Bennett,0,3,30,30
1649970487060,MATH 142A,B01,083221,Chow; Bennett,0,3,30,30
1649970487060,MATH 142A,B02,083222,Chow; Bennett,0,3,30,30
1649970493087,MATH 193A,A01,083224,Staff,0,5,30,30
1649970493087,MATH 193A,A02,083225,Staff,0,3,30,30
1649970493087,MATH 193A,A03,083781,Staff,1,0,30,29
1649970493087,MATH 193A,A04,083782,Staff,13,0,30,17
1649970499112,MATH 197,001,091859,McAuley; Julian John,9999,0,9999,0
1649970505166,COGS 9,A01,083615,Staff,0,3,60,60
1649970511189,COGS 11,A01,083617,Boyle; Mary E. T.,32,0,40,8
1649970517216,COGS 13,A01,083071,Staff,0,22,40,40
1649970523242,COGS 14A,A01,092681,Staff,33,0,100,67
1649970529268,COGS 14B,A01,083073,Cheng; Tzu-Han,11,0,50,39
1649970535301,COGS 17,A01,092677,Staff,55,0,75,20
1649970541331,COGS 100,A01,083619,Staff,1,15,60,59
1649970547365,COGS 101A,A01,083621,Davis; Joshua Daniel,0,15,60,60
1649970553391,COGS 101B,A01,091572,Staff,23,0,60,37
1649970559417,COGS 101C,A01,083625,Delgado; Tania,22,0,30,8
1649970565442,COGS 107A,A01,083627,Boyle; Mary E. T.,2,0,60,58
1649970571470,COGS 118A,A01,083075,Staff,21,0,60,39
1649970577499,CSE 3,A50,083646,Miranda; Gregory Joseph,22,0,38,16
1649970577499,CSE 3,A51,083647,Miranda; Gregory Joseph,37,0,37,0
1649970583523,CSE 8A,A50,083650,Miranda; Gregory Joseph,1,5,40,39
1649970589549,CSE 11,A01,083080,Cao; Yingjun,0,41,40,40
1649970595571,CSE 12,A01,083652,Staff,34,0,100,66
1649970601596,CSE 15L,A01,083654,Staff,0,0,50,50
1649970601596,CSE 15L,A02,083655,Staff,44,0,50,6
1649970607619,CSE 20,A01,083657,Staff,61,0,80,19
1649970613645,CSE 30,A01,083084,Eldon; John,0,44,40,40
1649970619676,CSE 100,A01,083659,Cao; Yingjun,1,50,50,49
1649970625703,CSE 134B,A01,083661,Powell; Thomas Allan,0,24,65,65
1649970631736,CSE 140,A01,083663,Staff,13,0,75,62
1649970637766,CSE 140L,A01,083088,Eldon; John,9,0,75,66
1649970643799,CSE 175,A01,083665,Kumar; Rakesh,10,0,25,15
1649970649823,CSE 190,A00,092507,Dubnov; Shlomo,12,0,15,3
1649970655861,ECE 45,A01,083139,Staff,0,4,40,40
1649970661891,ECE 65,A50,083695,Staff,2,0,30,28
1649970667914,ECE 109,A01,091882,Touri; Behrouz,51,0,70,19
1649970673943,ECE 180,A00,083140,Abi Samra; Nicholas Camill,26,0,30,4
1649970673943,ECE 180,B00,083141,Abi Samra; Nicholas Camill,11,0,30,19
1649970679982,MATH 10A,A01,083735,Patchell; Gregory David,19,0,30,11
1649970679982,MATH 10A,A02,083736,Patchell; Gregory David,28,0,30,2
1649970679982,MATH 10A,A03,083737,Patchell; Gregory David,27,0,30,3
1649970686020,MATH 10B,A01,083207,Staff,1,0,30,29
1649970686020,MATH 10B,A02,083208,Staff,25,0,30,5
1649970686020,MATH 10B,B01,083739,Staff,24,0,30,6
1649970686020,MATH 10B,B02,083740,Staff,30,0,30,0
1649970692045,MATH 18,A01,083743,Staff,20,0,30,10
1649970692045,MATH 18,A02,083744,Staff,29,0,30,1
1649970692045,MATH 18,A03,083745,Staff,27,0,30,3
1649970692045,MATH 18,A04,083746,Staff,27,0,30,3
1649970692045,MATH 18,B01,083748,Staff,0,1,30,30
1649970692045,MATH 18,B02,083749,Staff,8,0,30,22
1649970692045,MATH 18,B03,083750,Staff,23,0,30,7
1649970692045,MATH 18,B04,083751,Staff,19,0,30,11
1649970698079,MATH 20A,A01,083754,Staff,33,0,40,7
1649970704107,MATH 20B,A01,083756,Staff,12,0,30,18
1649970704107,MATH 20B,A02,083757,Staff,27,0,30,3
1649970710149,MATH 20C,A01,083760,Staff,11,0,30,19
1649970710149,MATH 20C,A02,083761,Staff,5,0,30,25
1649970710149,MATH 20C,B01,083762,Staff,26,0,30,4
1649970710149,MATH 20C,B02,083763,Staff,30,0,30,0
1649970716178,MATH 20D,A01,083765,Staff,11,0,30,19
1649970716178,MATH 20D,A02,083766,Staff,29,0,30,1
1649970716178,MATH 20D,A03,083767,Staff,28,0,30,2
1649970722213,MATH 20E,A01,083771,Staff,11,0,30,19
1649970722213,MATH 20E,A02,083772,Staff,24,0,30,6
1649970722213,MATH 20E,B01,083773,Staff,6,0,30,24
1649970722213,MATH 20E,B02,083774,Staff,28,0,30,2
1649970728238,MATH 103A,A01,083777,Staff,1,5,30,29
1649970728238,MATH 103A,A02,083778,Staff,0,4,30,30
1649970728238,MATH 103A,B01,083779,Staff,0,4,30,30
1649970728238,MATH 103A,B02,083780,Staff,0,4,30,30
1649970734293,MATH 105,A01,085443,Staff,0,10,30,30
1649970740315,MATH 109,A01,083213,Anzaldo; Leesa B,0,2,30,30
1649970740315,MATH 109,A02,083214,Anzaldo; Leesa B,0,1,30,30
1649970740315,MATH 109,B01,083215,Anzaldo; Leesa B,20,0,30,10
1649970740315,MATH 109,B02,083216,Anzaldo; Leesa B,9,0,30,21
1649970746344,MATH 142A,A01,083219,Chow; Bennett,0,3,30,30
1649970746344,MATH 142A,A02,083220,Chow; Bennett,0,3,30,30
1649970746344,MATH 142A,B01,083221,Chow; Bennett,0,3,30,30
1649970746344,MATH 142A,B02,083222,Chow; Bennett,0,3,30,30
1649970752370,MATH 193A,A01,083224,Staff,0,5,30,30
1649970752370,MATH 193A,A02,083225,Staff,0,3,30,30
1649970752370,MATH 193A,A03,083781,Staff,1,0,30,29
1649970752370,MATH 193A,A04,083782,Staff,13,0,30,17
1649970758400,MATH 197,001,091859,McAuley; Julian John,9999,0,9999,0
1649970764452,COGS 9,A01,083615,Staff,0,3,60,60
1649970770475,COGS 11,A01,083617,Boyle; Mary E. T.,30,0,40,10
1649970776510,COGS 13,A01,083071,Staff,0,22,40,40
1649970782532,COGS 14A,A01,092681,Staff,33,0,100,67
1649970788556,COGS 14B,A01,083073,Cheng; Tzu-Han,11,0,50,39
1649970794584,COGS 17,A01,092677,Staff,55,0,75,20
1649970800617,COGS 100,A01,083619,Staff,1,15,60,59
1649970806639,COGS 101A,A01,083621,Davis; Joshua Daniel,0,15,60,60
1649970812668,COGS 101B,A01,091572,Staff,23,0,60,37
1649970818694,COGS 101C,A01,083625,Delgado; Tania,22,0,30,8
1649970824721,COGS 107A,A01,083627,Boyle; Mary E. T.,2,0,60,58
1649970830754,COGS 118A,A01,083075,Staff,21,0,60,39
1649970836780,CSE 3,A50,083646,Miranda; Gregory Joseph,22,0,38,16
1649970836780,CSE 3,A51,083647,Miranda; Gregory Joseph,37,0,37,0
1649970842806,CSE 8A,A50,083650,Miranda; Gregory Joseph,1,5,40,39
1649970848844,CSE 11,A01,083080,Cao; Yingjun,0,41,40,40
1649970854974,CSE 12,A01,083652,Staff,34,0,100,66
1649970861002,CSE 15L,A01,083654,Staff,0,0,50,50
1649970861002,CSE 15L,A02,083655,Staff,44,0,50,6
1649970867037,CSE 20,A01,083657,Staff,61,0,80,19
1649970873065,CSE 30,A01,083084,Eldon; John,0,44,40,40
1649970879098,CSE 100,A01,083659,Cao; Yingjun,1,50,50,49
1649970885125,CSE 134B,A01,083661,Powell; Thomas Allan,0,24,65,65
1649970891151,CSE 140,A01,083663,Staff,13,0,75,62
1649970897177,CSE 140L,A01,083088,Eldon; John,9,0,75,66
1649970903200,CSE 175,A01,083665,Kumar; Rakesh,10,0,25,15
1649970909227,CSE 190,A00,092507,Dubnov; Shlomo,12,0,15,3
1649970915264,ECE 45,A01,083139,Staff,0,5,40,40
1649970921294,ECE 65,A50,083695,Staff,2,0,30,28
1649970927330,ECE 109,A01,091882,Touri; Behrouz,51,0,70,19
1649970933363,ECE 180,A00,083140,Abi Samra; Nicholas Camill,26,0,30,4
1649970933363,ECE 180,B00,083141,Abi Samra; Nicholas Camill,11,0,30,19
1649970939387,MATH 10A,A01,083735,Patchell; Gregory David,19,0,30,11
1649970939387,MATH 10A,A02,083736,Patchell; Gregory David,28,0,30,2
1649970939387,MATH 10A,A03,083737,Patchell; Gregory David,27,0,30,3
1649970945418,MATH 10B,A01,083207,Staff,1,0,30,29
1649970945418,MATH 10B,A02,083208,Staff,25,0,30,5
1649970945418,MATH 10B,B01,083739,Staff,24,0,30,6
1649970945418,MATH 10B,B02,083740,Staff,30,0,30,0
1649970951452,MATH 18,A01,083743,Staff,20,0,30,10
1649970951452,MATH 18,A02,083744,Staff,29,0,30,1
1649970951452,MATH 18,A03,083745,Staff,27,0,30,3
1649970951452,MATH 18,A04,083746,Staff,27,0,30,3
1649970951452,MATH 18,B01,083748,Staff,0,1,30,30
1649970951452,MATH 18,B02,083749,Staff,7,0,30,23
1649970951452,MATH 18,B03,083750,Staff,23,0,30,7
1649970951452,MATH 18,B04,083751,Staff,18,0,30,12
1649970957483,MATH 20A,A01,083754,Staff,32,0,40,8
1649970963510,MATH 20B,A01,083756,Staff,12,0,30,18
1649970963510,MATH 20B,A02,083757,Staff,27,0,30,3
1649970969546,MATH 20C,A01,083760,Staff,10,0,30,20
1649970969546,MATH 20C,A02,083761,Staff,5,0,30,25
1649970969546,MATH 20C,B01,083762,Staff,26,0,30,4
1649970969546,MATH 20C,B02,083763,Staff,30,0,30,0
1649970975573,MATH 20D,A01,083765,Staff,11,0,30,19
1649970975573,MATH 20D,A02,083766,Staff,29,0,30,1
1649970975573,MATH 20D,A03,083767,Staff,28,0,30,2
1649970981600,MATH 20E,A01,083771,Staff,11,0,30,19
1649970981600,MATH 20E,A02,083772,Staff,24,0,30,6
1649970981600,MATH 20E,B01,083773,Staff,6,0,30,24
1649970981600,MATH 20E,B02,083774,Staff,28,0,30,2
1649970987635,MATH 103A,A01,083777,Staff,1,5,30,29
1649970987635,MATH 103A,A02,083778,Staff,0,4,30,30
1649970987635,MATH 103A,B01,083779,Staff,0,4,30,30
1649970987635,MATH 103A,B02,083780,Staff,0,4,30,30
1649970993661,MATH 105,A01,085443,Staff,0,10,30,30
1649970999690,MATH 109,A01,083213,Anzaldo; Leesa B,0,3,30,30
1649970999690,MATH 109,A02,083214,Anzaldo; Leesa B,0,1,30,30
1649970999690,MATH 109,B01,083215,Anzaldo; Leesa B,20,0,30,10
1649970999690,MATH 109,B02,083216,Anzaldo; Leesa B,9,0,30,21
1649971005714,MATH 142A,A01,083219,Chow; Bennett,0,3,30,30
1649971005714,MATH 142A,A02,083220,Chow; Bennett,0,3,30,30
1649971005714,MATH 142A,B01,083221,Chow; Bennett,0,3,30,30
1649971005714,MATH 142A,B02,083222,Chow; Bennett,0,3,30,30
1649971011742,MATH 193A,A01,083224,Staff,0,5,30,30
1649971011742,MATH 193A,A02,083225,Staff,0,3,30,30
1649971011742,MATH 193A,A03,083781,Staff,1,0,30,29
1649971011742,MATH 193A,A04,083782,Staff,13,0,30,17
1649971017774,MATH 197,001,091859,McAuley; Julian John,9999,0,9999,0
1649971023833,COGS 9,A01,083615,Staff,0,3,60,60
1649971029859,COGS 11,A01,083617,Boyle; Mary E. T.,30,0,40,10
1649971035881,COGS 13,A01,083071,Staff,0,22,40,40
1649971041904,COGS 14A,A01,092681,Staff,32,0,100,68
1649971047937,COGS 14B,A01,083073,Cheng; Tzu-Han,10,0,50,40
1649971053962,COGS 17,A01,092677,Staff,55,0,75,20
1649971059984,COGS 100,A01,083619,Staff,1,15,60,59
1649971066008,COGS 101A,A01,083621,Davis; Joshua Daniel,0,15,60,60
1649971072038,COGS 101B,A01,091572,Staff,23,0,60,37
1649971078072,COGS 101C,A01,083625,Delgado; Tania,22,0,30,8
1649971084125,COGS 107A,A01,083627,Boyle; Mary E. T.,2,0,60,58
1649971090159,COGS 118A,A01,083075,Staff,21,0,60,39
1649971096182,CSE 3,A50,083646,Miranda; Gregory Joseph,22,0,38,16
1649971096182,CSE 3,A51,083647,Miranda; Gregory Joseph,37,0,37,0
1649971102217,CSE 8A,A50,083650,Miranda; Gregory Joseph,1,5,40,39
1649971108241,CSE 11,A01,083080,Cao; Yingjun,0,41,40,40
1649971114269,CSE 12,A01,083652,Staff,34,0,100,66
1649971120296,CSE 15L,A01,083654,Staff,0,0,50,50
1649971120296,CSE 15L,A02,083655,Staff,44,0,50,6
1649971126318,CSE 20,A01,083657,Staff,61,0,80,19
1649971132341,CSE 30,A01,083084,Eldon; John,0,44,40,40
1649971138369,CSE 100,A01,083659,Cao; Yingjun,1,50,50,49
1649971144392,CSE 134B,A01,083661,Powell; Thomas Allan,0,24,65,65
1649971150435,CSE 140,A01,083663,Staff,13,0,75,62
1649971156470,CSE 140L,A01,083088,Eldon; John,9,0,75,66
1649971162500,CSE 175,A01,083665,Kumar; Rakesh,10,0,25,15
1649971168527,CSE 190,A00,092507,Dubnov; Shlomo,12,0,15,3
1649971174554,ECE 45,A01,083139,Staff,0,5,40,40
1649971180578,ECE 65,A50,083695,Staff,2,0,30,28
1649971186608,ECE 109,A01,091882,Touri; Behrouz,51,0,70,19
1649971192631,ECE 180,A00,083140,Abi Samra; Nicholas Camill,26,0,30,4
1649971192631,ECE 180,B00,083141,Abi Samra; Nicholas Camill,11,0,30,19
1649971198669,MATH 10A,A01,083735,Patchell; Gregory David,19,0,30,11
1649971198669,MATH 10A,A02,083736,Patchell; Gregory David,28,0,30,2
1649971198669,MATH 10A,A03,083737,Patchell; Gregory David,27,0,30,3
1649971204697,MATH 10B,A01,083207,Staff,1,0,30,29
1649971204697,MATH 10B,A02,083208,Staff,25,0,30,5
1649971204697,MATH 10B,B01,083739,Staff,24,0,30,6
1649971204697,MATH 10B,B02,083740,Staff,30,0,30,0
1649971210721,MATH 18,A01,083743,Staff,20,0,30,10
1649971210721,MATH 18,A02,083744,Staff,29,0,30,1
1649971210721,MATH 18,A03,083745,Staff,27,0,30,3
1649971210721,MATH 18,A04,083746,Staff,27,0,30,3
1649971210721,MATH 18,B01,083748,Staff,0,1,30,30
1649971210721,MATH 18,B02,083749,Staff,7,0,30,23
1649971210721,MATH 18,B03,083750,Staff,23,0,30,7
1649971210721,MATH 18,B04,083751,Staff,18,0,30,12
1649971216760,MATH 20A,A01,083754,Staff,32,0,40,8
1649971222796,MATH 20B,A01,083756,Staff,12,0,30,18
1649971222796,MATH 20B,A02,083757,Staff,27,0,30,3
1649971228831,MATH 20C,A01,083760,Staff,9,0,30,21
1649971228831,MATH 20C,A02,083761,Staff,5,0,30,25
1649971228831,MATH 20C,B01,083762,Staff,26,0,30,4
1649971228831,MATH 20C,B02,083763,Staff,30,0,30,0
1649971234856,MATH 20D,A01,083765,Staff,11,0,30,19
1649971234856,MATH 20D,A02,083766,Staff,29,0,30,1
1649971234856,MATH 20D,A03,083767,Staff,28,0,30,2
1649971240891,MATH 20E,A01,083771,Staff,11,0,30,19
1649971240891,MATH 20E,A02,083772,Staff,24,0,30,6
1649971240891,MATH 20E,B01,083773,Staff,6,0,30,24
1649971240891,MATH 20E,B02,083774,Staff,28,0,30,2
1649971246922,MATH 103A,A01,083777,Staff,1,5,30,29
1649971246922,MATH 103A,A02,083778,Staff,0,4,30,30
1649971246922,MATH 103A,B01,083779,Staff,0,4,30,30
1649971246922,MATH 103A,B02,083780,Staff,0,4,30,30
1649971252950,MATH 105,A01,085443,Staff,0,10,30,30
1649971258984,MATH 109,A01,083213,Anzaldo; Leesa B,0,3,30,30
1649971258984,MATH 109,A02,083214,Anzaldo; Leesa B,0,1,30,30
1649971258984,MATH 109,B01,083215,Anzaldo; Leesa B,20,0,30,10
1649971258984,MATH 109,B02,083216,Anzaldo; Leesa B,8,0,30,22
1649971265008,MATH 142A,A01,083219,Chow; Bennett,0,3,30,30
1649971265008,MATH 142A,A02,083220,Chow; Bennett,0,3,30,30
1649971265008,MATH 142A,B01,083221,Chow; Bennett,0,3,30,30
1649971265008,MATH 142A,B02,083222,Chow; Bennett,0,3,30,30
1649971271031,MATH 193A,A01,083224,Staff,0,5,30,30
1649971271031,MATH 193A,A02,083225,Staff,0,3,30,30
1649971271031,MATH 193A,A03,083781,Staff,1,0,30,29
1649971271031,MATH 193A,A04,083782,Staff,13,0,30,17
1649971277061,MATH 197,001,091859,McAuley; Julian John,9999,0,9999,0
1649971283131,COGS 9,A01,083615,Staff,0,3,60,60
1649971289175,COGS 11,A01,083617,Boyle; Mary E. T.,30,0,40,10
1649971295199,COGS 13,A01,083071,Staff,0,22,40,40
1649971301222,COGS 14A,A01,092681,Staff,32,0,100,68
1649971307249,COGS 14B,A01,083073,Cheng; Tzu-Han,10,0,50,40
1649971313271,COGS 17,A01,092677,Staff,55,0,75,20
1649971319302,COGS 100,A01,083619,Staff,1,15,60,59
1649971325324,COGS 101A,A01,083621,Davis; Joshua Daniel,0,15,60,60
1649971331348,COGS 101B,A01,091572,Staff,23,0,60,37
1649971337377,COGS 101C,A01,083625,Delgado; Tania,22,0,30,8
1649971343409,COGS 107A,A01,083627,Boyle; Mary E. T.,2,0,60,58
1649971349433,COGS 118A,A01,083075,Staff,21,0,60,39
1649971355470,CSE 3,A50,083646,Miranda; Gregory Joseph,22,0,38,16
1649971355470,CSE 3,A51,083647,Miranda; Gregory Joseph,37,0,37,0
1649971361501,CSE 8A,A50,083650,Miranda; Gregory Joseph,1,5,40,39
1649971367525,CSE 11,A01,083080,Cao; Yingjun,0,42,40,40
1649971373564,CSE 12,A01,083652,Staff,34,0,100,66
1649971379604,CSE 15L,A01,083654,Staff,0,0,50,50
1649971379604,CSE 15L,A02,083655,Staff,44,0,50,6
1649971385640,CSE 20,A01,083657,Staff,61,0,80,19
1649971391663,CSE 30,A01,083084,Eldon; John,0,44,40,40
1649971397690,CSE 100,A01,083659,Cao; Yingjun,1,50,50,49
1649971403717,CSE 134B,A01,083661,Powell; Thomas Allan,0,24,65,65
1649971409741,CSE 140,A01,083663,Staff,12,0,75,63
1649971415763,CSE 140L,A01,083088,Eldon; John,8,0,75,67
1649971421795,CSE 175,A01,083665,Kumar; Rakesh,10,0,25,15
1649971427836,CSE 190,A00,092507,Dubnov; Shlomo,12,0,15,3
1649971433872,ECE 45,A01,083139,Staff,0,6,40,40
1649971439903,ECE 65,A50,083695,Staff,2,0,30,28
1649971445927,ECE 109,A01,091882,Touri; Behrouz,51,0,70,19
1649971452059,ECE 180,A00,083140,Abi Samra; Nicholas Camill,26,0,30,4
1649971452059,ECE 180,B00,083141,Abi Samra; Nicholas Camill,11,0,30,19
1649971458082,MATH 10A,A01,083735,Patchell; Gregory David,19,0,30,11
1649971458082,MATH 10A,A02,083736,Patchell; Gregory David,28,0,30,2
1649971458082,MATH 10A,A03,083737,Patchell; Gregory David,27,0,30,3
1649971464119,MATH 10B,A01,083207,Staff,0,0,30,30
1649971464119,MATH 10B,A02,083208,Staff,24,0,30,6
1649971464119,MATH 10B,B01,083739,Staff,24,0,30,6
1649971464119,MATH 10B,B02,083740,Staff,30,0,30,0
1649971470154,MATH 18,A01,083743,Staff,20,0,30,10
1649971470154,MATH 18,A02,083744,Staff,29,0,30,1
1649971470154,MATH 18,A03,083745,Staff,27,0,30,3
1649971470154,MATH 18,A04,083746,Staff,27,0,30,3
1649971470154,MATH 18,B01,083748,Staff,0,1,30,30
1649971470154,MATH 18,B02,083749,Staff,7,0,30,23
1649971470154,MATH 18,B03,083750,Staff,23,0,30,7
1649971470154,MATH 18,B04,083751,Staff,16,0,30,14
1649971476189,MATH 20A,A01,083754,Staff,32,0,40,8
1649971482215,MATH 20B,A01,083756,Staff,12,0,30,18
1649971482215,MATH 20B,A02,083757,Staff,26,0,30,4
1649971488239,MATH 20C,A01,083760,Staff,8,0,30,22
1649971488239,MATH 20C,A02,083761,Staff,5,0,30,25
1649971488239,MATH 20C,B01,083762,Staff,26,0,30,4
1649971488239,MATH 20C,B02,083763,Staff,30,0,30,0
1649971494279,MATH 20D,A01,083765,Staff,11,0,30,19
1649971494279,MATH 20D,A02,083766,Staff,29,0,30,1
1649971494279,MATH 20D,A03,083767,Staff,28,0,30,2
1649971500313,MATH 20E,A01,083771,Staff,11,0,30,19
1649971500313,MATH 20E,A02,083772,Staff,24,0,30,6
1649971500313,MATH 20E,B01,083773,Staff,6,0,30,24
1649971500313,MATH 20E,B02,083774,Staff,28,0,30,2
1649971506345,MATH 103A,A01,083777,Staff,1,5,30,29
1649971506345,MATH 103A,A02,083778,Staff,0,4,30,30
1649971506345,MATH 103A,B01,083779,Staff,0,4,30,30
1649971506345,MATH 103A,B02,083780,Staff,0,4,30,30
1649971512368,MATH 105,A01,085443,Staff,0,10,30,30
1649971518408,MATH 109,A01,083213,Anzaldo; Leesa B,0,3,30,30
1649971518408,MATH 109,A02,083214,Anzaldo; Leesa B,0,1,30,30
1649971518408,MATH 109,B01,083215,Anzaldo; Leesa B,19,0,30,11
1649971518408,MATH 109,B02,083216,Anzaldo; Leesa B,8,0,30,22
1649971524436,MATH 142A,A01,083219,Chow; Bennett,0,3,30,30
1649971524436,MATH 142A,A02,083220,Chow; Bennett,0,3,30,30
1649971524436,MATH 142A,B01,083221,Chow; Bennett,0,3,30,30
1649971524436,MATH 142A,B02,083222,Chow; Bennett,0,3,30,30
1649971530475,MATH 193A,A01,083224,Staff,0,5,30,30
1649971530475,MATH 193A,A02,083225,Staff,0,3,30,30
1649971530475,MATH 193A,A03,083781,Staff,1,0,30,29
1649971530475,MATH 193A,A04,083782,Staff,13,0,30,17
1649971536497,MATH 197,001,091859,McAuley; Julian John,9999,0,9999,0
1649971542550,COGS 9,A01,083615,Staff,0,3,60,60
1649971548572,COGS 11,A01,083617,Boyle; Mary E. T.,30,0,40,10
1649971554613,COGS 13,A01,083071,Staff,0,22,40,40
1649971560640,COGS 14A,A01,092681,Staff,32,0,100,68
1649971566666,COGS 14B,A01,083073,Cheng; Tzu-Han,10,0,50,40
1649971572692,COGS 17,A01,092677,Staff,55,0,75,20
1649971578718,COGS 100,A01,083619,Staff,1,15,60,59
1649971584745,COGS 101A,A01,083621,Davis; Joshua Daniel,0,15,60,60
1649971590785,COGS 101B,A01,091572,Staff,23,0,60,37
1649971596810,COGS 101C,A01,083625,Delgado; Tania,22,0,30,8
1649971602837,COGS 107A,A01,083627,Boyle; Mary E. T.,1,0,60,59
1649971608861,COGS 118A,A01,083075,Staff,21,0,60,39
1649971614887,CSE 3,A50,083646,Miranda; Gregory Joseph,22,0,38,16
1649971614887,CSE 3,A51,083647,Miranda; Gregory Joseph,37,0,37,0
1649971620910,CSE 8A,A50,083650,Miranda; Gregory Joseph,1,5,40,39
1649971626939,CSE 11,A01,083080,Cao; Yingjun,0,42,40,40
1649971632965,CSE 12,A01,083652,Staff,34,0,100,66
1649971638995,CSE 15L,A01,083654,Staff,0,0,50,50
1649971638995,CSE 15L,A02,083655,Staff,44,0,50,6
1649971645026,CSE 20,A01,083657,Staff,61,0,80,19
1649971651067,CSE 30,A01,083084,Eldon; John,0,44,40,40
1649971657098,CSE 100,A01,083659,Cao; Yingjun,1,49,50,49
1649971663130,CSE 134B,A01,083661,Powell; Thomas Allan,0,24,65,65
1649971669154,CSE 140,A01,083663,Staff,12,0,75,63
1649971675188,CSE 140L,A01,083088,Eldon; John,8,0,75,67
1649971681221,CSE 175,A01,083665,Kumar; Rakesh,10,0,25,15
1649971687247,CSE 190,A00,092507,Dubnov; Shlomo,12,0,15,3
1649971693273,ECE 45,A01,083139,Staff,0,6,40,40
1649971699304,ECE 65,A50,083695,Staff,2,0,30,28
1649971705328,ECE 109,A01,091882,Touri; Behrouz,51,0,70,19
1649971711354,ECE 180,A00,083140,Abi Samra; Nicholas Camill,26,0,30,4
1649971711354,ECE 180,B00,083141,Abi Samra; Nicholas Camill,10,0,30,20
1649971717404,MATH 10A,A01,083735,Patchell; Gregory David,19,0,30,11
1649971717404,MATH 10A,A02,083736,Patchell; Gregory David,28,0,30,2
1649971717404,MATH 10A,A03,083737,Patchell; Gregory David,27,0,30,3
1649971723430,MATH 10B,A01,083207,Staff,0,0,30,30
1649971723430,MATH 10B,A02,083208,Staff,24,0,30,6
1649971723430,MATH 10B,B01,083739,Staff,24,0,30,6
1649971723430,MATH 10B,B02,083740,Staff,30,0,30,0
1649971729469,MATH 18,A01,083743,Staff,21,0,30,9
1649971729469,MATH 18,A02,083744,Staff,29,0,30,1
1649971729469,MATH 18,A03,083745,Staff,27,0,30,3
1649971729469,MATH 18,A04,083746,Staff,27,0,30,3
1649971729469,MATH 18,B01,083748,Staff,0,1,30,30
1649971729469,MATH 18,B02,083749,Staff,7,0,30,23
1649971729469,MATH 18,B03,083750,Staff,23,0,30,7
1649971729469,MATH 18,B04,083751,Staff,16,0,30,14
1649971735495,MATH 20A,A01,083754,Staff,32,0,40,8
1649971741538,MATH 20B,A01,083756,Staff,12,0,30,18
1649971741538,MATH 20B,A02,083757,Staff,26,0,30,4
1649971747562,MATH 20C,A01,083760,Staff,8,0,30,22
1649971747562,MATH 20C,A02,083761,Staff,5,0,30,25
1649971747562,MATH 20C,B01,083762,Staff,26,0,30,4
1649971747562,MATH 20C,B02,083763,Staff,30,0,30,0
1649971753591,MATH 20D,A01,083765,Staff,11,0,30,19
1649971753591,MATH 20D,A02,083766,Staff,29,0,30,1
1649971753591,MATH 20D,A03,083767,Staff,28,0,30,2
1649971759621,MATH 20E,A01,083771,Staff,11,0,30,19
1649971759621,MATH 20E,A02,083772,Staff,24,0,30,6
1649971759621,MATH 20E,B01,083773,Staff,6,0,30,24
1649971759621,MATH 20E,B02,083774,Staff,28,0,30,2
1649971765649,MATH 103A,A01,083777,Staff,1,5,30,29
1649971765649,MATH 103A,A02,083778,Staff,0,4,30,30
1649971765649,MATH 103A,B01,083779,Staff,0,4,30,30
1649971765649,MATH 103A,B02,083780,Staff,0,4,30,30
1649971771683,MATH 105,A01,085443,Staff,0,10,30,30
1649971777707,MATH 109,A01,083213,Anzaldo; Leesa B,0,3,30,30
1649971777707,MATH 109,A02,083214,Anzaldo; Leesa B,0,1,30,30
1649971777707,MATH 109,B01,083215,Anzaldo; Leesa B,19,0,30,11
1649971777707,MATH 109,B02,083216,Anzaldo; Leesa B,8,0,30,22
1649971783744,MATH 142A,A01,083219,Chow; Bennett,0,4,30,30
1649971783744,MATH 142A,A02,083220,Chow; Bennett,0,3,30,30
1649971783744,MATH 142A,B01,083221,Chow; Bennett,0,3,30,30
1649971783744,MATH 142A,B02,083222,Chow; Bennett,0,3,30,30
1649971789770,MATH 193A,A01,083224,Staff,0,5,30,30
1649971789770,MATH 193A,A02,083225,Staff,0,3,30,30
1649971789770,MATH 193A,A03,083781,Staff,1,0,30,29
1649971789770,MATH 193A,A04,083782,Staff,13,0,30,17
1649971795794,MATH 197,001,091859,McAuley; Julian John,9999,0,9999,0
1649971801850,COGS 9,A01,083615,Staff,0,3,60,60
1649971807872,COGS 11,A01,083617,Boyle; Mary E. T.,30,0,40,10
1649971813896,COGS 13,A01,083071,Staff,0,22,40,40
1649971819931,COGS 14A,A01,092681,Staff,32,0,100,68
1649971825959,COGS 14B,A01,083073,Cheng; Tzu-Han,10,0,50,40
1649971832001,COGS 17,A01,092677,Staff,55,0,75,20
1649971838043,COGS 100,A01,083619,Staff,1,15,60,59
1649971844069,COGS 101A,A01,083621,Davis; Joshua Daniel,0,15,60,60
1649971850092,COGS 101B,A01,091572,Staff,23,0,60,37
1649971856117,COGS 101C,A01,083625,Delgado; Tania,22,0,30,8
1649971862140,COGS 107A,A01,083627,Boyle; Mary E. T.,1,0,60,59
1649971868164,COGS 118A,A01,083075,Staff,21,0,60,39
1649971874201,CSE 3,A50,083646,Miranda; Gregory Joseph,22,0,38,16
1649971874201,CSE 3,A51,083647,Miranda; Gregory Joseph,37,0,37,0
1649971880225,CSE 8A,A50,083650,Miranda; Gregory Joseph,1,5,40,39
1649971886250,CSE 11,A01,083080,Cao; Yingjun,0,42,40,40
1649971892274,CSE 12,A01,083652,Staff,34,0,100,66
1649971898297,CSE 15L,A01,083654,Staff,0,0,50,50
1649971898297,CSE 15L,A02,083655,Staff,44,0,50,6
1649971904319,CSE 20,A01,083657,Staff,61,0,80,19
1649971910341,CSE 30,A01,083084,Eldon; John,0,45,40,40
1649971916372,CSE 100,A01,083659,Cao; Yingjun,1,49,50,49
1649971922402,CSE 134B,A01,083661,Powell; Thomas Allan,0,24,65,65
1649971928424,CSE 140,A01,083663,Staff,12,0,75,63
1649971934450,CSE 140L,A01,083088,Eldon; John,8,0,75,67
1649971940474,CSE 175,A01,083665,Kumar; Rakesh,10,0,25,15
1649971946499,CSE 190,A00,092507,Dubnov; Shlomo,12,0,15,3
1649971952523,ECE 45,A01,083139,Staff,0,6,40,40
1649971958548,ECE 65,A50,083695,Staff,2,0,30,28
1649971964575,ECE 109,A01,091882,Touri; Behrouz,51,0,70,19
1649971970611,ECE 180,A00,083140,Abi Samra; Nicholas Camill,26,0,30,4
1649971970611,ECE 180,B00,083141,Abi Samra; Nicholas Camill,10,0,30,20
1649971976651,MATH 10A,A01,083735,Patchell; Gregory David,19,0,30,11
1649971976651,MATH 10A,A02,083736,Patchell; Gregory David,28,0,30,2
1649971976651,MATH 10A,A03,083737,Patchell; Gregory David,27,0,30,3
1649971982686,MATH 10B,A01,083207,Staff,0,0,30,30
1649971982686,MATH 10B,A02,083208,Staff,23,0,30,7
1649971982686,MATH 10B,B01,083739,Staff,24,0,30,6
1649971982686,MATH 10B,B02,083740,Staff,30,0,30,0
1649971988719,MATH 18,A01,083743,Staff,21,0,30,9
1649971988719,MATH 18,A02,083744,Staff,29,0,30,1
1649971988719,MATH 18,A03,083745,Staff,27,0,30,3
1649971988719,MATH 18,A04,083746,Staff,27,0,30,3
1649971988719,MATH 18,B01,083748,Staff,0,1,30,30
1649971988719,MATH 18,B02,083749,Staff,7,0,30,23
1649971988719,MATH 18,B03,083750,Staff,23,0,30,7
1649971988719,MATH 18,B04,083751,Staff,16,0,30,14
1649971994743,MATH 20A,A01,083754,Staff,32,0,40,8
1649972000774,MATH 20B,A01,083756,Staff,12,0,30,18
1649972000774,MATH 20B,A02,083757,Staff,26,0,30,4
1649972006808,MATH 20C,A01,083760,Staff,9,0,30,21
1649972006808,MATH 20C,A02,083761,Staff,3,0,30,27
1649972006808,MATH 20C,B01,083762,Staff,26,0,30,4
1649972006808,MATH 20C,B02,083763,Staff,30,0,30,0
1649972012836,MATH 20D,A01,083765,Staff,11,0,30,19
1649972012836,MATH 20D,A02,083766,Staff,29,0,30,1
1649972012836,MATH 20D,A03,083767,Staff,28,0,30,2
1649972018859,MATH 20E,A01,083771,Staff,11,0,30,19
1649972018859,MATH 20E,A02,083772,Staff,24,0,30,6
1649972018859,MATH 20E,B01,083773,Staff,6,0,30,24
1649972018859,MATH 20E,B02,083774,Staff,28,0,30,2
1649972024888,MATH 103A,A01,083777,Staff,1,5,30,29
1649972024888,MATH 103A,A02,083778,Staff,0,4,30,30
1649972024888,MATH 103A,B01,083779,Staff,0,4,30,30
1649972024888,MATH 103A,B02,083780,Staff,0,4,30,30
1649972030916,MATH 105,A01,085443,Staff,0,10,30,30
1649972036945,MATH 109,A01,083213,Anzaldo; Leesa B,0,3,30,30
1649972036945,MATH 109,A02,083214,Anzaldo; Leesa B,0,1,30,30
1649972036945,MATH 109,B01,083215,Anzaldo; Leesa B,19,0,30,11
1649972036945,MATH 109,B02,083216,Anzaldo; Leesa B,8,0,30,22
1649972042971,MATH 142A,A01,083219,Chow; Bennett,0,4,30,30
1649972042971,MATH 142A,A02,083220,Chow; Bennett,0,3,30,30
1649972042971,MATH 142A,B01,083221,Chow; Bennett,0,3,30,30
1649972042971,MATH 142A,B02,083222,Chow; Bennett,0,3,30,30
1649972049091,MATH 193A,A01,083224,Staff,0,5,30,30
1649972049091,MATH 193A,A02,083225,Staff,0,3,30,30
1649972049091,MATH 193A,A03,083781,Staff,1,0,30,29
1649972049091,MATH 193A,A04,083782,Staff,13,0,30,17
1649972055112,MATH 197,001,091859,McAuley; Julian John,9999,0,9999,0
1649972061180,COGS 9,A01,083615,Staff,0,4,60,60
1649972067206,COGS 11,A01,083617,Boyle; Mary E. T.,30,0,40,10
1649972073228,COGS 13,A01,083071,Staff,0,22,40,40
1649972079254,COGS 14A,A01,092681,Staff,30,0,100,70
1649972085277,COGS 14B,A01,083073,Cheng; Tzu-Han,10,0,50,40
1649972091301,COGS 17,A01,092677,Staff,54,0,75,21
1649972097324,COGS 100,A01,083619,Staff,1,15,60,59
1649972103350,COGS 101A,A01,083621,Davis; Joshua Daniel,0,15,60,60
1649972109376,COGS 101B,A01,091572,Staff,23,0,60,37
1649972115400,COGS 101C,A01,083625,Delgado; Tania,22,0,30,8
1649972121434,COGS 107A,A01,083627,Boyle; Mary E. T.,1,0,60,59
1649972127460,COGS 118A,A01,083075,Staff,21,0,60,39
1649972133486,CSE 3,A50,083646,Miranda; Gregory Joseph,22,0,38,16
1649972133486,CSE 3,A51,083647,Miranda; Gregory Joseph,37,0,37,0
1649972139509,CSE 8A,A50,083650,Miranda; Gregory Joseph,1,6,40,39
1649972145533,CSE 11,A01,083080,Cao; Yingjun,0,43,40,40
1649972151556,CSE 12,A01,083652,Staff,34,0,100,66
1649972157583,CSE 15L,A01,083654,Staff,0,0,50,50
1649972157583,CSE 15L,A02,083655,Staff,44,0,50,6
1649972163607,CSE 20,A01,083657,Staff,61,0,80,19
1649972169629,CSE 30,A01,083084,Eldon; John,0,45,40,40
1649972175656,CSE 100,A01,083659,Cao; Yingjun,1,49,50,49
1649972181690,CSE 134B,A01,083661,Powell; Thomas Allan,0,24,65,65
1649972187719,CSE 140,A01,083663,Staff,12,0,75,63
1649972193744,CSE 140L,A01,083088,Eldon; John,8,0,75,67
1649972199789,CSE 175,A01,083665,Kumar; Rakesh,10,0,25,15
1649972205834,CSE 190,A00,092507,Dubnov; Shlomo,12,0,15,3
1649972211855,ECE 45,A01,083139,Staff,0,6,40,40
1649972217879,ECE 65,A50,083695,Staff,2,0,30,28
1649972223908,ECE 109,A01,091882,Touri; Behrouz,51,0,70,19
1649972229948,ECE 180,A00,083140,Abi Samra; Nicholas Camill,26,0,30,4
1649972229948,ECE 180,B00,083141,Abi Samra; Nicholas Camill,10,0,30,20
1649972235981,MATH 10A,A01,083735,Patchell; Gregory David,19,0,30,11
1649972235981,MATH 10A,A02,083736,Patchell; Gregory David,28,0,30,2
1649972235981,MATH 10A,A03,083737,Patchell; Gregory David,27,0,30,3
1649972242017,MATH 10B,A01,083207,Staff,0,0,30,30
1649972242017,MATH 10B,A02,083208,Staff,23,0,30,7
1649972242017,MATH 10B,B01,083739,Staff,24,0,30,6
1649972242017,MATH 10B,B02,083740,Staff,30,0,30,0
1649972248046,MATH 18,A01,083743,Staff,21,0,30,9
1649972248046,MATH 18,A02,083744,Staff,29,0,30,1
1649972248046,MATH 18,A03,083745,Staff,27,0,30,3
1649972248046,MATH 18,A04,083746,Staff,27,0,30,3
1649972248046,MATH 18,B01,083748,Staff,0,1,30,30
1649972248046,MATH 18,B02,083749,Staff,7,0,30,23
1649972248046,MATH 18,B03,083750,Staff,23,0,30,7
1649972248046,MATH 18,B04,083751,Staff,16,0,30,14
1649972254076,MATH 20A,A01,083754,Staff,32,0,40,8
1649972260103,MATH 20B,A01,083756,Staff,12,0,30,18
1649972260103,MATH 20B,A02,083757,Staff,26,0,30,4
1649972266125,MATH 20C,A01,083760,Staff,9,0,30,21
1649972266125,MATH 20C,A02,083761,Staff,3,0,30,27
1649972266125,MATH 20C,B01,083762,Staff,26,0,30,4
1649972266125,MATH 20C,B02,083763,Staff,30,0,30,0
1649972272170,MATH 20D,A01,083765,Staff,10,0,30,20
1649972272170,MATH 20D,A02,083766,Staff,29,0,30,1
1649972272170,MATH 20D,A03,083767,Staff,28,0,30,2
1649972278199,MATH 20E,A01,083771,Staff,11,0,30,19
1649972278199,MATH 20E,A02,083772,Staff,24,0,30,6
1649972278199,MATH 20E,B01,083773,Staff,6,0,30,24
1649972278199,MATH 20E,B02,083774,Staff,28,0,30,2
1649972284223,MATH 103A,A01,083777,Staff,1,5,30,29
1649972284223,MATH 103A,A02,083778,Staff,0,4,30,30
1649972284223,MATH 103A,B01,083779,Staff,0,4,30,30
1649972284223,MATH 103A,B02,083780,Staff,0,4,30,30
1649972290249,MATH 105,A01,085443,Staff,0,10,30,30
1649972296276,MATH 109,A01,083213,Anzaldo; Leesa B,0,3,30,30
1649972296276,MATH 109,A02,083214,Anzaldo; Leesa B,0,1,30,30
1649972296276,MATH 109,B01,083215,Anzaldo; Leesa B,19,0,30,11
1649972296276,MATH 109,B02,083216,Anzaldo; Leesa B,7,0,30,23
1649972302301,MATH 142A,A01,083219,Chow; Bennett,0,4,30,30
1649972302301,MATH 142A,A02,083220,Chow; Bennett,0,3,30,30
1649972302301,MATH 142A,B01,083221,Chow; Bennett,0,3,30,30
1649972302301,MATH 142A,B02,083222,Chow; Bennett,0,3,30,30
1649972308334,MATH 193A,A01,083224,Staff,0,5,30,30
1649972308334,MATH 193A,A02,083225,Staff,0,3,30,30
1649972308334,MATH 193A,A03,083781,Staff,1,0,30,29
1649972308334,MATH 193A,A04,083782,Staff,13,0,30,17
1649972314359,MATH 197,001,091859,McAuley; Julian John,9999,0,9999,0
1649972320420,COGS 9,A01,083615,Staff,0,4,60,60
1649972326445,COGS 11,A01,083617,Boyle; Mary E. T.,30,0,40,10
1649972332472,COGS 13,A01,083071,Staff,0,22,40,40
1649972338497,COGS 14A,A01,092681,Staff,30,0,100,70
1649972344524,COGS 14B,A01,083073,Cheng; Tzu-Han,10,0,50,40
1649972350557,COGS 17,A01,092677,Staff,53,0,75,22
1649972356580,COGS 100,A01,083619,Staff,1,15,60,59
1649972362658,COGS 101A,A01,083621,Davis; Joshua Daniel,0,15,60,60
1649972368680,COGS 101B,A01,091572,Staff,23,0,60,37
1649972374705,COGS 101C,A01,083625,Delgado; Tania,22,0,30,8
1649972380735,COGS 107A,A01,083627,Boyle; Mary E. T.,1,0,60,59
1649972386766,COGS 118A,A01,083075,Staff,21,0,60,39
1649972392790,CSE 3,A50,083646,Miranda; Gregory Joseph,22,0,38,16
1649972392790,CSE 3,A51,083647,Miranda; Gregory Joseph,37,0,37,0
1649972398825,CSE 8A,A50,083650,Miranda; Gregory Joseph,1,6,40,39
1649972404863,CSE 11,A01,083080,Cao; Yingjun,0,43,40,40
1649972410886,CSE 12,A01,083652,Staff,34,0,100,66
1649972416919,CSE 15L,A01,083654,Staff,0,0,50,50
1649972416919,CSE 15L,A02,083655,Staff,44,0,50,6
1649972422948,CSE 20,A01,083657,Staff,61,0,80,19
1649972428986,CSE 30,A01,083084,Eldon; John,0,45,40,40
1649972435016,CSE 100,A01,083659,Cao; Yingjun,1,49,50,49
1649972441055,CSE 134B,A01,083661,Powell; Thomas Allan,0,24,65,65
1649972447085,CSE 140,A01,083663,Staff,11,0,75,64
1649972453113,CSE 140L,A01,083088,Eldon; John,7,0,75,68
1649972459138,CSE 175,A01,083665,Kumar; Rakesh,10,0,25,15
1649972465174,CSE 190,A00,092507,Dubnov; Shlomo,12,0,15,3
1649972471197,ECE 45,A01,083139,Staff,0,6,40,40
1649972477228,ECE 65,A50,083695,Staff,2,0,30,28
1649972483265,ECE 109,A01,091882,Touri; Behrouz,51,0,70,19
1649972489292,ECE 180,A00,083140,Abi Samra; Nicholas Camill,26,0,30,4
1649972489292,ECE 180,B00,083141,Abi Samra; Nicholas Camill,10,0,30,20
1649972495314,MATH 10A,A01,083735,Patchell; Gregory David,19,0,30,11
1649972495314,MATH 10A,A02,083736,Patchell; Gregory David,28,0,30,2
1649972495314,MATH 10A,A03,083737,Patchell; Gregory David,27,0,30,3
1649972501334,MATH 10B,A01,083207,Staff,0,0,30,30
1649972501334,MATH 10B,A02,083208,Staff,22,0,30,8
1649972501334,MATH 10B,B01,083739,Staff,24,0,30,6
1649972501334,MATH 10B,B02,083740,Staff,30,0,30,0
1649972507360,MATH 18,A01,083743,Staff,21,0,30,9
1649972507360,MATH 18,A02,083744,Staff,29,0,30,1
1649972507360,MATH 18,A03,083745,Staff,27,0,30,3
1649972507360,MATH 18,A04,083746,Staff,27,0,30,3
1649972507360,MATH 18,B01,083748,Staff,0,1,30,30
1649972507360,MATH 18,B02,083749,Staff,7,0,30,23
1649972507360,MATH 18,B03,083750,Staff,23,0,30,7
1649972507360,MATH 18,B04,083751,Staff,16,0,30,14
1649972513390,MATH 20A,A01,083754,Staff,32,0,40,8
1649972519420,MATH 20B,A01,083756,Staff,11,0,30,19
1649972519420,MATH 20B,A02,083757,Staff,26,0,30,4
1649972525454,MATH 20C,A01,083760,Staff,9,0,30,21
1649972525454,MATH 20C,A02,083761,Staff,3,0,30,27
1649972525454,MATH 20C,B01,083762,Staff,26,0,30,4
1649972525454,MATH 20C,B02,083763,Staff,30,0,30,0
1649972531477,MATH 20D,A01,083765,Staff,10,0,30,20
1649972531477,MATH 20D,A02,083766,Staff,29,0,30,1
1649972531477,MATH 20D,A03,083767,Staff,28,0,30,2
1649972537500,MATH 20E,A01,083771,Staff,11,0,30,19
1649972537500,MATH 20E,A02,083772,Staff,24,0,30,6
1649972537500,MATH 20E,B01,083773,Staff,6,0,30,24
1649972537500,MATH 20E,B02,083774,Staff,27,0,30,3
1649972543525,MATH 103A,A01,083777,Staff,1,6,30,29
1649972543525,MATH 103A,A02,083778,Staff,0,5,30,30
1649972543525,MATH 103A,B01,083779,Staff,0,4,30,30
1649972543525,MATH 103A,B02,083780,Staff,0,4,30,30
1649972549547,MATH 105,A01,085443,Staff,0,10,30,30
1649972555570,MATH 109,A01,083213,Anzaldo; Leesa B,0,3,30,30
1649972555570,MATH 109,A02,083214,Anzaldo; Leesa B,0,1,30,30
1649972555570,MATH 109,B01,083215,Anzaldo; Leesa B,19,0,30,11
1649972555570,MATH 109,B02,083216,Anzaldo; Leesa B,7,0,30,23
1649972561598,MATH 142A,A01,083219,Chow; Bennett,0,4,30,30
1649972561598,MATH 142A,A02,083220,Chow; Bennett,0,3,30,30
1649972561598,MATH 142A,B01,083221,Chow; Bennett,0,3,30,30
1649972561598,MATH 142A,B02,083222,Chow; Bennett,0,3,30,30
1649972567621,MATH 193A,A01,083224,Staff,0,5,30,30
1649972567621,MATH 193A,A02,083225,Staff,0,3,30,30
1649972567621,MATH 193A,A03,083781,Staff,1,0,30,29
1649972567621,MATH 193A,A04,083782,Staff,13,0,30,17
1649972573644,MATH 197,001,091859,McAuley; Julian John,9999,0,9999,0
1649972579711,COGS 9,A01,083615,Staff,0,4,60,60
1649972585734,COGS 11,A01,083617,Boyle; Mary E. T.,30,0,40,10
1649972591756,COGS 13,A01,083071,Staff,0,23,40,40
1649972597782,COGS 14A,A01,092681,Staff,29,0,100,71
1649972603809,COGS 14B,A01,083073,Cheng; Tzu-Han,10,0,50,40
1649972609833,COGS 17,A01,092677,Staff,53,0,75,22
1649972615860,COGS 100,A01,083619,Staff,1,15,60,59
1649972621883,COGS 101A,A01,083621,Davis; Joshua Daniel,0,15,60,60
1649972627907,COGS 101B,A01,091572,Staff,23,0,60,37
1649972633930,COGS 101C,A01,083625,Delgado; Tania,22,0,30,8
1649972640067,COGS 107A,A01,083627,Boyle; Mary E. T.,0,0,60,60
1649972646091,COGS 118A,A01,083075,Staff,21,0,60,39
1649972652119,CSE 3,A50,083646,Miranda; Gregory Joseph,22,0,38,16
1649972652119,CSE 3,A51,083647,Miranda; Gregory Joseph,37,0,37,0
1649972658147,CSE 8A,A50,083650,Miranda; Gregory Joseph,1,6,40,39
1649972664170,CSE 11,A01,083080,Cao; Yingjun,0,43,40,40
1649972670197,CSE 12,A01,083652,Staff,34,0,100,66
1649972676225,CSE 15L,A01,083654,Staff,0,0,50,50
1649972676225,CSE 15L,A02,083655,Staff,44,0,50,6
1649972682246,CSE 20,A01,083657,Staff,61,0,80,19
1649972688276,CSE 30,A01,083084,Eldon; John,0,46,40,40
1649972694299,CSE 100,A01,083659,Cao; Yingjun,1,49,50,49
1649972700328,CSE 134B,A01,083661,Powell; Thomas Allan,0,24,65,65
1649972706350,CSE 140,A01,083663,Staff,11,0,75,64
1649972712380,CSE 140L,A01,083088,Eldon; John,7,0,75,68
1649972718403,CSE 175,A01,083665,Kumar; Rakesh,10,0,25,15
1649972724425,CSE 190,A00,092507,Dubnov; Shlomo,12,0,15,3
1649972730463,ECE 45,A01,083139,Staff,0,6,40,40
1649972736493,ECE 65,A50,083695,Staff,2,0,30,28
1649972742521,ECE 109,A01,091882,Touri; Behrouz,51,0,70,19
1649972748551,ECE 180,A00,083140,Abi Samra; Nicholas Camill,26,0,30,4
1649972748551,ECE 180,B00,083141,Abi Samra; Nicholas Camill,10,0,30,20
1649972754579,MATH 10A,A01,083735,Patchell; Gregory David,19,0,30,11
1649972754579,MATH 10A,A02,083736,Patchell; Gregory David,28,0,30,2
1649972754579,MATH 10A,A03,083737,Patchell; Gregory David,27,0,30,3
1649972760606,MATH 10B,A01,083207,Staff,0,0,30,30
1649972760606,MATH 10B,A02,083208,Staff,22,0,30,8
1649972760606,MATH 10B,B01,083739,Staff,24,0,30,6
1649972760606,MATH 10B,B02,083740,Staff,30,0,30,0
1649972766638,MATH 18,A01,083743,Staff,21,0,30,9
1649972766638,MATH 18,A02,083744,Staff,29,0,30,1
1649972766638,MATH 18,A03,083745,Staff,27,0,30,3
1649972766638,MATH 18,A04,083746,Staff,27,0,30,3
1649972766638,MATH 18,B01,083748,Staff,0,1,30,30
1649972766638,MATH 18,B02,083749,Staff,7,0,30,23
1649972766638,MATH 18,B03,083750,Staff,23,0,30,7
1649972766638,MATH 18,B04,083751,Staff,16,0,30,14
1649972772663,MATH 20A,A01,083754,Staff,32,0,40,8
1649972778690,MATH 20B,A01,083756,Staff,11,0,30,19
1649972778690,MATH 20B,A02,083757,Staff,26,0,30,4
1649972784714,MATH 20C,A01,083760,Staff,9,0,30,21
1649972784714,MATH 20C,A02,083761,Staff,3,0,30,27
1649972784714,MATH 20C,B01,083762,Staff,26,0,30,4
1649972784714,MATH 20C,B02,083763,Staff,30,0,30,0
1649972790739,MATH 20D,A01,083765,Staff,10,0,30,20
1649972790739,MATH 20D,A02,083766,Staff,29,0,30,1
1649972790739,MATH 20D,A03,083767,Staff,28,0,30,2
1649972796761,MATH 20E,A01,083771,Staff,11,0,30,19
1649972796761,MATH 20E,A02,083772,Staff,24,0,30,6
1649972796761,MATH 20E,B01,083773,Staff,6,0,30,24
1649972796761,MATH 20E,B02,083774,Staff,27,0,30,3
1649972802785,MATH 103A,A01,083777,Staff,1,5,30,29
1649972802785,MATH 103A,A02,083778,Staff,0,5,30,30
1649972802785,MATH 103A,B01,083779,Staff,0,5,30,30
1649972802785,MATH 103A,B02,083780,Staff,0,4,30,30
1649972808814,MATH 105,A01,085443,Staff,0,10,30,30
1649972814838,MATH 109,A01,083213,Anzaldo; Leesa B,0,3,30,30
1649972814838,MATH 109,A02,083214,Anzaldo; Leesa B,0,1,30,30
1649972814838,MATH 109,B01,083215,Anzaldo; Leesa B,19,0,30,11
1649972814838,MATH 109,B02,083216,Anzaldo; Leesa B,7,0,30,23
1649972820862,MATH 142A,A01,083219,Chow; Bennett,0,4,30,30
1649972820862,MATH 142A,A02,083220,Chow; Bennett,0,3,30,30
1649972820862,MATH 142A,B01,083221,Chow; Bennett,0,3,30,30
1649972820862,MATH 142A,B02,083222,Chow; Bennett,0,3,30,30
1649972826891,MATH 193A,A01,083224,Staff,0,5,30,30
1649972826891,MATH 193A,A02,083225,Staff,0,3,30,30
1649972826891,MATH 193A,A03,083781,Staff,1,0,30,29
1649972826891,MATH 193A,A04,083782,Staff,13,0,30,17
1649972832925,MATH 197,001,091859,McAuley; Julian John,9999,0,9999,0
1649972838993,COGS 9,A01,083615,Staff,0,4,60,60
1649972845021,COGS 11,A01,083617,Boyle; Mary E. T.,30,0,40,10
1649972851053,COGS 13,A01,083071,Staff,0,23,40,40
1649972857078,COGS 14A,A01,092681,Staff,29,0,100,71
1649972863102,COGS 14B,A01,083073,Cheng; Tzu-Han,10,0,50,40
1649972869126,COGS 17,A01,092677,Staff,53,0,75,22
1649972875157,COGS 100,A01,083619,Staff,1,15,60,59
1649972881194,COGS 101A,A01,083621,Davis; Joshua Daniel,0,15,60,60
1649972887226,COGS 101B,A01,091572,Staff,23,0,60,37
1649972893249,COGS 101C,A01,083625,Delgado; Tania,22,0,30,8
1649972899278,COGS 107A,A01,083627,Boyle; Mary E. T.,0,0,60,60
1649972905305,COGS 118A,A01,083075,Staff,21,0,60,39
1649972911342,CSE 3,A50,083646,Miranda; Gregory Joseph,22,0,38,16
1649972911342,CSE 3,A51,083647,Miranda; Gregory Joseph,37,0,37,0
1649972917365,CSE 8A,A50,083650,Miranda; Gregory Joseph,1,6,40,39
1649972923395,CSE 11,A01,083080,Cao; Yingjun,0,43,40,40
1649972929422,CSE 12,A01,083652,Staff,33,0,100,67
1649972935457,CSE 15L,A01,083654,Staff,0,0,50,50
1649972935457,CSE 15L,A02,083655,Staff,43,0,50,7
1649972941483,CSE 20,A01,083657,Staff,61,0,80,19
1649972947515,CSE 30,A01,083084,Eldon; John,0,46,40,40
1649972953542,CSE 100,A01,083659,Cao; Yingjun,1,49,50,49
1649972959573,CSE 134B,A01,083661,Powell; Thomas Allan,0,24,65,65
1649972965604,CSE 140,A01,083663,Staff,11,0,75,64
1649972971638,CSE 140L,A01,083088,Eldon; John,7,0,75,68
1649972977661,CSE 175,A01,083665,Kumar; Rakesh,10,0,25,15
1649972983697,CSE 190,A00,092507,Dubnov; Shlomo,12,0,15,3
1649972989721,ECE 45,A01,083139,Staff,0,6,40,40
1649972995747,ECE 65,A50,083695,Staff,2,0,30,28
1649973001773,ECE 109,A01,091882,Touri; Behrouz,51,0,70,19
1649973007797,ECE 180,A00,083140,Abi Samra; Nicholas Camill,26,0,30,4
1649973007797,ECE 180,B00,083141,Abi Samra; Nicholas Camill,10,0,30,20
1649973013822,MATH 10A,A01,083735,Patchell; Gregory David,19,0,30,11
1649973013822,MATH 10A,A02,083736,Patchell; Gregory David,28,0,30,2
1649973013822,MATH 10A,A03,083737,Patchell; Gregory David,27,0,30,3
1649973019852,MATH 10B,A01,083207,Staff,0,0,30,30
1649973019852,MATH 10B,A02,083208,Staff,22,0,30,8
1649973019852,MATH 10B,B01,083739,Staff,24,0,30,6
1649973019852,MATH 10B,B02,083740,Staff,30,0,30,0
1649973025877,MATH 18,A01,083743,Staff,21,0,30,9
1649973025877,MATH 18,A02,083744,Staff,29,0,30,1
1649973025877,MATH 18,A03,083745,Staff,27,0,30,3
1649973025877,MATH 18,A04,083746,Staff,27,0,30,3
1649973025877,MATH 18,B01,083748,Staff,0,1,30,30
1649973025877,MATH 18,B02,083749,Staff,7,0,30,23
1649973025877,MATH 18,B03,083750,Staff,23,0,30,7
1649973025877,MATH 18,B04,083751,Staff,16,0,30,14
1649973031902,MATH 20A,A01,083754,Staff,32,0,40,8
1649973037930,MATH 20B,A01,083756,Staff,11,0,30,19
1649973037930,MATH 20B,A02,083757,Staff,26,0,30,4
1649973043954,MATH 20C,A01,083760,Staff,9,0,30,21
1649973043954,MATH 20C,A02,083761,Staff,3,0,30,27
1649973043954,MATH 20C,B01,083762,Staff,26,0,30,4
1649973043954,MATH 20C,B02,083763,Staff,30,0,30,0
1649973049987,MATH 20D,A01,083765,Staff,10,0,30,20
1649973049987,MATH 20D,A02,083766,Staff,29,0,30,1
1649973049987,MATH 20D,A03,083767,Staff,28,0,30,2
1649973056022,MATH 20E,A01,083771,Staff,11,0,30,19
1649973056022,MATH 20E,A02,083772,Staff,24,0,30,6
1649973056022,MATH 20E,B01,083773,Staff,6,0,30,24
1649973056022,MATH 20E,B02,083774,Staff,27,0,30,3
1649973062046,MATH 103A,A01,083777,Staff,1,5,30,29
1649973062046,MATH 103A,A02,083778,Staff,0,5,30,30
1649973062046,MATH 103A,B01,083779,Staff,0,5,30,30
1649973062046,MATH 103A,B02,083780,Staff,0,4,30,30
1649973068081,MATH 105,A01,085443,Staff,0,10,30,30
1649973074119,MATH 109,A01,083213,Anzaldo; Leesa B,0,3,30,30
1649973074119,MATH 109,A02,083214,Anzaldo; Leesa B,0,1,30,30
1649973074119,MATH 109,B01,083215,Anzaldo; Leesa B,18,0,30,12
1649973074119,MATH 109,B02,083216,Anzaldo; Leesa B,7,0,30,23
1649973080146,MATH 142A,A01,083219,Chow; Bennett,0,4,30,30
1649973080146,MATH 142A,A02,083220,Chow; Bennett,0,3,30,30
1649973080146,MATH 142A,B01,083221,Chow; Bennett,0,3,30,30
1649973080146,MATH 142A,B02,083222,Chow; Bennett,0,3,30,30
1649973086168,MATH 193A,A01,083224,Staff,0,5,30,30
1649973086168,MATH 193A,A02,083225,Staff,0,3,30,30
1649973086168,MATH 193A,A03,083781,Staff,1,0,30,29
1649973086168,MATH 193A,A04,083782,Staff,13,0,30,17
1649973092191,MATH 197,001,091859,McAuley; Julian John,9999,0,9999,0
1649973098260,COGS 9,A01,083615,Staff,0,4,60,60
1649973104282,COGS 11,A01,083617,Boyle; Mary E. T.,30,0,40,10
1649973110350,COGS 13,A01,083071,Staff,0,23,40,40
1649973116374,COGS 14A,A01,092681,Staff,29,0,100,71
1649973122400,COGS 14B,A01,083073,Cheng; Tzu-Han,10,0,50,40
1649973128426,COGS 17,A01,092677,Staff,53,0,75,22
1649973134454,COGS 100,A01,083619,Staff,1,15,60,59
1649973140488,COGS 101A,A01,083621,Davis; Joshua Daniel,0,15,60,60
1649973146520,COGS 101B,A01,091572,Staff,23,0,60,37
1649973152543,COGS 101C,A01,083625,Delgado; Tania,22,0,30,8
1649973158570,COGS 107A,A01,083627,Boyle; Mary E. T.,0,0,60,60
1649973164596,COGS 118A,A01,083075,Staff,21,0,60,39
1649973170624,CSE 3,A50,083646,Miranda; Gregory Joseph,22,0,38,16
1649973170624,CSE 3,A51,083647,Miranda; Gregory Joseph,37,0,37,0
1649973176654,CSE 8A,A50,083650,Miranda; Gregory Joseph,1,6,40,39
1649973182688,CSE 11,A01,083080,Cao; Yingjun,0,43,40,40
1649973188712,CSE 12,A01,083652,Staff,31,0,100,69
1649973194739,CSE 15L,A01,083654,Staff,0,0,50,50
1649973194739,CSE 15L,A02,083655,Staff,41,0,50,9
1649973200776,CSE 20,A01,083657,Staff,61,0,80,19
1649973206818,CSE 30,A01,083084,Eldon; John,0,46,40,40
1649973212842,CSE 100,A01,083659,Cao; Yingjun,1,49,50,49
1649973218867,CSE 134B,A01,083661,Powell; Thomas Allan,0,24,65,65
1649973224908,CSE 140,A01,083663,Staff,11,0,75,64
1649973230933,CSE 140L,A01,083088,Eldon; John,7,0,75,68
1649973237050,CSE 175,A01,083665,Kumar; Rakesh,10,0,25,15
1649973243080,CSE 190,A00,092507,Dubnov; Shlomo,12,0,15,3
1649973249117,ECE 45,A01,083139,Staff,0,6,40,40
1649973255146,ECE 65,A50,083695,Staff,2,0,30,28
1649973261175,ECE 109,A01,091882,Touri; Behrouz,51,0,70,19
1649973267199,ECE 180,A00,083140,Abi Samra; Nicholas Camill,26,0,30,4
1649973267199,ECE 180,B00,083141,Abi Samra; Nicholas Camill,10,0,30,20
1649973273227,MATH 10A,A01,083735,Patchell; Gregory David,18,0,30,12
1649973273227,MATH 10A,A02,083736,Patchell; Gregory David,28,0,30,2
1649973273227,MATH 10A,A03,083737,Patchell; Gregory David,27,0,30,3
1649973279258,MATH 10B,A01,083207,Staff,0,0,30,30
1649973279258,MATH 10B,A02,083208,Staff,22,0,30,8
1649973279258,MATH 10B,B01,083739,Staff,24,0,30,6
1649973279258,MATH 10B,B02,083740,Staff,30,0,30,0
1649973285287,MATH 18,A01,083743,Staff,21,0,30,9
1649973285287,MATH 18,A02,083744,Staff,29,0,30,1
1649973285287,MATH 18,A03,083745,Staff,27,0,30,3
1649973285287,MATH 18,A04,083746,Staff,27,0,30,3
1649973285287,MATH 18,B01,083748,Staff,0,1,30,30
1649973285287,MATH 18,B02,083749,Staff,6,0,30,24
1649973285287,MATH 18,B03,083750,Staff,23,0,30,7
1649973285287,MATH 18,B04,083751,Staff,16,0,30,14
1649973291315,MATH 20A,A01,083754,Staff,32,0,40,8
1649973297341,MATH 20B,A01,083756,Staff,10,0,30,20
1649973297341,MATH 20B,A02,083757,Staff,26,0,30,4
1649973303369,MATH 20C,A01,083760,Staff,9,0,30,21
1649973303369,MATH 20C,A02,083761,Staff,3,0,30,27
1649973303369,MATH 20C,B01,083762,Staff,26,0,30,4
1649973303369,MATH 20C,B02,083763,Staff,30,0,30,0
1649973309398,MATH 20D,A01,083765,Staff,9,0,30,21
1649973309398,MATH 20D,A02,083766,Staff,29,0,30,1
1649973309398,MATH 20D,A03,083767,Staff,28,0,30,2
1649973315430,MATH 20E,A01,083771,Staff,11,0,30,19
1649973315430,MATH 20E,A02,083772,Staff,24,0,30,6
1649973315430,MATH 20E,B01,083773,Staff,6,0,30,24
1649973315430,MATH 20E,B02,083774,Staff,27,0,30,3
1649973321457,MATH 103A,A01,083777,Staff,1,5,30,29
1649973321457,MATH 103A,A02,083778,Staff,0,5,30,30
1649973321457,MATH 103A,B01,083779,Staff,0,5,30,30
1649973321457,MATH 103A,B02,083780,Staff,0,4,30,30
1649973327481,MATH 105,A01,085443,Staff,0,10,30,30
1649973333514,MATH 109,A01,083213,Anzaldo; Leesa B,0,3,30,30
1649973333514,MATH 109,A02,083214,Anzaldo; Leesa B,0,1,30,30
1649973333514,MATH 109,B01,083215,Anzaldo; Leesa B,18,0,30,12
1649973333514,MATH 109,B02,083216,Anzaldo; Leesa B,6,0,30,24
1649973339538,MATH 142A,A01,083219,Chow; Bennett,0,4,30,30
1649973339538,MATH 142A,A02,083220,Chow; Bennett,0,3,30,30
1649973339538,MATH 142A,B01,083221,Chow; Bennett,0,4,30,30
1649973339538,MATH 142A,B02,083222,Chow; Bennett,0,3,30,30
1649973345565,MATH 193A,A01,083224,Staff,0,5,30,30
1649973345565,MATH 193A,A02,083225,Staff,0,3,30,30
1649973345565,MATH 193A,A03,083781,Staff,1,0,30,29
1649973345565,MATH 193A,A04,083782,Staff,13,0,30,17
1649973351589,MATH 197,001,091859,McAuley; Julian John,9999,0,9999,0
1649973357641,COGS 9,A01,083615,Staff,0,4,60,60
1649973363667,COGS 11,A01,083617,Boyle; Mary E. T.,30,0,40,10
1649973369697,COGS 13,A01,083071,Staff,0,23,40,40
1649973375719,COGS 14A,A01,092681,Staff,29,0,100,71
1649973381747,COGS 14B,A01,083073,Cheng; Tzu-Han,10,0,50,40
1649973387785,COGS 17,A01,092677,Staff,53,0,75,22
1649973393817,COGS 100,A01,083619,Staff,1,15,60,59
1649973399841,COGS 101A,A01,083621,Davis; Joshua Daniel,0,15,60,60
1649973405867,COGS 101B,A01,091572,Staff,23,0,60,37
1649973411891,COGS 101C,A01,083625,Delgado; Tania,22,0,30,8
1649973417916,COGS 107A,A01,083627,Boyle; Mary E. T.,0,0,60,60
1649973423939,COGS 118A,A01,083075,Staff,21,0,60,39
1649973429978,CSE 3,A50,083646,Miranda; Gregory Joseph,22,0,38,16
1649973429978,CSE 3,A51,083647,Miranda; Gregory Joseph,37,0,37,0
1649973436015,CSE 8A,A50,083650,Miranda; Gregory Joseph,1,6,40,39
1649973442043,CSE 11,A01,083080,Cao; Yingjun,0,43,40,40
1649973448071,CSE 12,A01,083652,Staff,31,0,100,69
1649973454092,CSE 15L,A01,083654,Staff,0,0,50,50
1649973454092,CSE 15L,A02,083655,Staff,41,0,50,9
1649973460121,CSE 20,A01,083657,Staff,61,0,80,19
1649973466156,CSE 30,A01,083084,Eldon; John,0,46,40,40
1649973472183,CSE 100,A01,083659,Cao; Yingjun,1,49,50,49
1649973478212,CSE 134B,A01,083661,Powell; Thomas Allan,0,24,65,65
1649973484236,CSE 140,A01,083663,Staff,11,0,75,64
1649973490271,CSE 140L,A01,083088,Eldon; John,7,0,75,68
1649973496298,CSE 175,A01,083665,Kumar; Rakesh,10,0,25,15
1649973502321,CSE 190,A00,092507,Dubnov; Shlomo,12,0,15,3
1649973508346,ECE 45,A01,083139,Staff,0,6,40,40
1649973514370,ECE 65,A50,083695,Staff,2,0,30,28
1649973520400,ECE 109,A01,091882,Touri; Behrouz,51,0,70,19
1649973526425,ECE 180,A00,083140,Abi Samra; Nicholas Camill,26,0,30,4
1649973526425,ECE 180,B00,083141,Abi Samra; Nicholas Camill,10,0,30,20
1649973532448,MATH 10A,A01,083735,Patchell; Gregory David,18,0,30,12
1649973532448,MATH 10A,A02,083736,Patchell; Gregory David,28,0,30,2
1649973532448,MATH 10A,A03,083737,Patchell; Gregory David,27,0,30,3
1649973538471,MATH 10B,A01,083207,Staff,0,0,30,30
1649973538471,MATH 10B,A02,083208,Staff,22,0,30,8
1649973538471,MATH 10B,B01,083739,Staff,24,0,30,6
1649973538471,MATH 10B,B02,083740,Staff,30,0,30,0
1649973544514,MATH 18,A01,083743,Staff,21,0,30,9
1649973544514,MATH 18,A02,083744,Staff,29,0,30,1
1649973544514,MATH 18,A03,083745,Staff,27,0,30,3
1649973544514,MATH 18,A04,083746,Staff,27,0,30,3
1649973544514,MATH 18,B01,083748,Staff,0,1,30,30
1649973544514,MATH 18,B02,083749,Staff,6,0,30,24
1649973544514,MATH 18,B03,083750,Staff,23,0,30,7
1649973544514,MATH 18,B04,083751,Staff,16,0,30,14
1649973550539,MATH 20A,A01,083754,Staff,32,0,40,8
1649973556596,MATH 20B,A01,083756,Staff,10,0,30,20
1649973556596,MATH 20B,A02,083757,Staff,26,0,30,4
1649973562621,MATH 20C,A01,083760,Staff,9,0,30,21
1649973562621,MATH 20C,A02,083761,Staff,3,0,30,27
1649973562621,MATH 20C,B01,083762,Staff,26,0,30,4
1649973562621,MATH 20C,B02,083763,Staff,30,0,30,0
1649973568644,MATH 20D,A01,083765,Staff,9,0,30,21
1649973568644,MATH 20D,A02,083766,Staff,29,0,30,1
1649973568644,MATH 20D,A03,083767,Staff,28,0,30,2
1649973574668,MATH 20E,A01,083771,Staff,11,0,30,19
1649973574668,MATH 20E,A02,083772,Staff,24,0,30,6
1649973574668,MATH 20E,B01,083773,Staff,6,0,30,24
1649973574668,MATH 20E,B02,083774,Staff,27,0,30,3
1649973580702,MATH 103A,A01,083777,Staff,1,5,30,29
1649973580702,MATH 103A,A02,083778,Staff,0,5,30,30
1649973580702,MATH 103A,B01,083779,Staff,0,5,30,30
1649973580702,MATH 103A,B02,083780,Staff,0,4,30,30
1649973586725,MATH 105,A01,085443,Staff,0,10,30,30
1649973592750,MATH 109,A01,083213,Anzaldo; Leesa B,0,3,30,30
1649973592750,MATH 109,A02,083214,Anzaldo; Leesa B,0,1,30,30
1649973592750,MATH 109,B01,083215,Anzaldo; Leesa B,18,0,30,12
1649973592750,MATH 109,B02,083216,Anzaldo; Leesa B,6,0,30,24
1649973598773,MATH 142A,A01,083219,Chow; Bennett,0,4,30,30
1649973598773,MATH 142A,A02,083220,Chow; Bennett,0,3,30,30
1649973598773,MATH 142A,B01,083221,Chow; Bennett,0,4,30,30
1649973598773,MATH 142A,B02,083222,Chow; Bennett,0,3,30,30
1649973604797,MATH 193A,A01,083224,Staff,0,5,30,30
1649973604797,MATH 193A,A02,083225,Staff,0,3,30,30
1649973604797,MATH 193A,A03,083781,Staff,1,0,30,29
1649973604797,MATH 193A,A04,083782,Staff,13,0,30,17
1649973610829,MATH 197,001,091859,McAuley; Julian John,9999,0,9999,0
1649973616889,COGS 9,A01,083615,Staff,0,5,60,60
1649973622916,COGS 11,A01,083617,Boyle; Mary E. T.,30,0,40,10
1649973628951,COGS 13,A01,083071,Staff,0,23,40,40
1649973634999,COGS 14A,A01,092681,Staff,29,0,100,71
1649973641025,COGS 14B,A01,083073,Cheng; Tzu-Han,10,0,50,40
1649973647049,COGS 17,A01,092677,Staff,53,0,75,22
1649973653076,COGS 100,A01,083619,Staff,1,15,60,59
1649973659102,COGS 101A,A01,083621,Davis; Joshua Daniel,0,15,60,60
1649973665150,COGS 101B,A01,091572,Staff,23,0,60,37
1649973671184,COGS 101C,A01,083625,Delgado; Tania,22,0,30,8
1649973677210,COGS 107A,A01,083627,Boyle; Mary E. T.,0,0,60,60
1649973683237,COGS 118A,A01,083075,Staff,21,0,60,39
1649973689261,CSE 3,A50,083646,Miranda; Gregory Joseph,22,0,38,16
1649973689261,CSE 3,A51,083647,Miranda; Gregory Joseph,37,0,37,0
1649973695282,CSE 8A,A50,083650,Miranda; Gregory Joseph,1,6,40,39
1649973701305,CSE 11,A01,083080,Cao; Yingjun,0,43,40,40
1649973707332,CSE 12,A01,083652,Staff,31,0,100,69
1649973713358,CSE 15L,A01,083654,Staff,0,0,50,50
1649973713358,CSE 15L,A02,083655,Staff,41,0,50,9
1649973719387,CSE 20,A01,083657,Staff,61,0,80,19
1649973725425,CSE 30,A01,083084,Eldon; John,0,47,40,40
1649973731452,CSE 100,A01,083659,Cao; Yingjun,1,49,50,49
1649973737476,CSE 134B,A01,083661,Powell; Thomas Allan,0,24,65,65
1649973743511,CSE 140,A01,083663,Staff,11,0,75,64
1649973749534,CSE 140L,A01,083088,Eldon; John,7,0,75,68
1649973761660,CSE 175,A01,083665,Kumar; Rakesh,10,0,25,15
1649973767684,CSE 190,A00,092507,Dubnov; Shlomo,17,0,20,3
1649973773711,ECE 45,A01,083139,Staff,0,6,40,40
1649973779738,ECE 65,A50,083695,Staff,2,0,30,28
1649973785767,ECE 109,A01,091882,Touri; Behrouz,51,0,70,19
1649973791791,ECE 180,A00,083140,Abi Samra; Nicholas Camill,26,0,30,4
1649973791791,ECE 180,B00,083141,Abi Samra; Nicholas Camill,10,0,30,20
1649973797814,MATH 10A,A01,083735,Patchell; Gregory David,18,0,30,12
1649973797814,MATH 10A,A02,083736,Patchell; Gregory David,28,0,30,2
1649973797814,MATH 10A,A03,083737,Patchell; Gregory David,27,0,30,3
1649973803838,MATH 10B,A01,083207,Staff,0,0,30,30
1649973803838,MATH 10B,A02,083208,Staff,22,0,30,8
1649973803838,MATH 10B,B01,083739,Staff,24,0,30,6
1649973803838,MATH 10B,B02,083740,Staff,30,0,30,0
1649973809868,MATH 18,A01,083743,Staff,21,0,30,9
1649973809868,MATH 18,A02,083744,Staff,29,0,30,1
1649973809868,MATH 18,A03,083745,Staff,27,0,30,3
1649973809868,MATH 18,A04,083746,Staff,27,0,30,3
1649973809868,MATH 18,B01,083748,Staff,0,1,30,30
1649973809868,MATH 18,B02,083749,Staff,5,0,30,25
1649973809868,MATH 18,B03,083750,Staff,23,0,30,7
1649973809868,MATH 18,B04,083751,Staff,16,0,30,14
1649973815891,MATH 20A,A01,083754,Staff,32,0,40,8
1649973821924,MATH 20B,A01,083756,Staff,10,0,30,20
1649973821924,MATH 20B,A02,083757,Staff,26,0,30,4
1649973827963,MATH 20C,A01,083760,Staff,9,0,30,21
1649973827963,MATH 20C,A02,083761,Staff,3,0,30,27
1649973827963,MATH 20C,B01,083762,Staff,25,0,30,5
1649973827963,MATH 20C,B02,083763,Staff,30,0,30,0
1649973833988,MATH 20D,A01,083765,Staff,9,0,30,21
1649973833988,MATH 20D,A02,083766,Staff,29,0,30,1
1649973833988,MATH 20D,A03,083767,Staff,28,0,30,2
1649973840111,MATH 20E,A01,083771,Staff,11,0,30,19
1649973840111,MATH 20E,A02,083772,Staff,24,0,30,6
1649973840111,MATH 20E,B01,083773,Staff,6,0,30,24
1649973840111,MATH 20E,B02,083774,Staff,27,0,30,3
1649973846139,MATH 103A,A01,083777,Staff,1,5,30,29
1649973846139,MATH 103A,A02,083778,Staff,0,5,30,30
1649973846139,MATH 103A,B01,083779,Staff,0,5,30,30
1649973846139,MATH 103A,B02,083780,Staff,0,4,30,30
1649973852163,MATH 105,A01,085443,Staff,0,10,30,30
1649973858186,MATH 109,A01,083213,Anzaldo; Leesa B,0,3,30,30
1649973858186,MATH 109,A02,083214,Anzaldo; Leesa B,0,1,30,30
1649973858186,MATH 109,B01,083215,Anzaldo; Leesa B,18,0,30,12
1649973858186,MATH 109,B02,083216,Anzaldo; Leesa B,3,0,30,27
1649973864223,MATH 142A,A01,083219,Chow; Bennett,0,4,30,30
1649973864223,MATH 142A,A02,083220,Chow; Bennett,0,3,30,30
1649973864223,MATH 142A,B01,083221,Chow; Bennett,0,4,30,30
1649973864223,MATH 142A,B02,083222,Chow; Bennett,0,3,30,30
1649973870254,MATH 193A,A01,083224,Staff,0,5,30,30
1649973870254,MATH 193A,A02,083225,Staff,0,3,30,30
1649973870254,MATH 193A,A03,083781,Staff,1,0,30,29
1649973870254,MATH 193A,A04,083782,Staff,13,0,30,17
1649973876277,MATH 197,001,091859,McAuley; Julian John,9999,0,9999,0
1649973882345,COGS 9,A01,083615,Staff,0,5,60,60
1649973888374,COGS 11,A01,083617,Boyle; Mary E. T.,30,0,40,10
1649973894397,COGS 13,A01,083071,Staff,0,23,40,40
1649973900422,COGS 14A,A01,092681,Staff,29,0,100,71
1649973906445,COGS 14B,A01,083073,Cheng; Tzu-Han,10,0,50,40
1649973912468,COGS 17,A01,092677,Staff,53,0,75,22
1649973918495,COGS 100,A01,083619,Staff,1,15,60,59
1649973924532,COGS 101A,A01,083621,Davis; Joshua Daniel,0,15,60,60
1649973930555,COGS 101B,A01,091572,Staff,23,0,60,37
1649973936581,COGS 101C,A01,083625,Delgado; Tania,22,0,30,8
1649973942619,COGS 107A,A01,083627,Boyle; Mary E. T.,0,0,60,60
1649973948657,COGS 118A,A01,083075,Staff,21,0,60,39
1649973954692,CSE 3,A50,083646,Miranda; Gregory Joseph,22,0,38,16
1649973954692,CSE 3,A51,083647,Miranda; Gregory Joseph,37,0,37,0
1649973960716,CSE 8A,A50,083650,Miranda; Gregory Joseph,1,6,40,39
1649973966759,CSE 11,A01,083080,Cao; Yingjun,0,43,40,40
1649973972800,CSE 12,A01,083652,Staff,29,0,100,71
1649973978832,CSE 15L,A01,083654,Staff,0,0,50,50
1649973978832,CSE 15L,A02,083655,Staff,39,0,50,11
1649973984856,CSE 20,A01,083657,Staff,61,0,80,19
1649973990889,CSE 30,A01,083084,Eldon; John,0,47,40,40
1649973996913,CSE 100,A01,083659,Cao; Yingjun,1,49,50,49
1649974002951,CSE 134B,A01,083661,Powell; Thomas Allan,0,24,65,65
1649974008980,CSE 140,A01,083663,Staff,11,0,75,64
1649974015005,CSE 140L,A01,083088,Eldon; John,7,0,75,68
1649974021028,CSE 175,A01,083665,Kumar; Rakesh,10,0,25,15
1649974027057,CSE 190,A00,092507,Dubnov; Shlomo,17,0,20,3
1649974033084,ECE 45,A01,083139,Staff,0,6,40,40
1649974039114,ECE 65,A50,083695,Staff,2,0,30,28
1649974045140,ECE 109,A01,091882,Touri; Behrouz,51,0,70,19
1649974051163,ECE 180,A00,083140,Abi Samra; Nicholas Camill,26,0,30,4
1649974051163,ECE 180,B00,083141,Abi Samra; Nicholas Camill,10,0,30,20
1649974057186,MATH 10A,A01,083735,Patchell; Gregory David,18,0,30,12
1649974057186,MATH 10A,A02,083736,Patchell; Gregory David,28,0,30,2
1649974057186,MATH 10A,A03,083737,Patchell; Gregory David,27,0,30,3
1649974063209,MATH 10B,A01,083207,Staff,0,0,30,30
1649974063209,MATH 10B,A02,083208,Staff,22,0,30,8
1649974063209,MATH 10B,B01,083739,Staff,24,0,30,6
1649974063209,MATH 10B,B02,083740,Staff,30,0,30,0
1649974069234,MATH 18,A01,083743,Staff,21,0,30,9
1649974069234,MATH 18,A02,083744,Staff,29,0,30,1
1649974069234,MATH 18,A03,083745,Staff,27,0,30,3
1649974069234,MATH 18,A04,083746,Staff,27,0,30,3
1649974069234,MATH 18,B01,083748,Staff,0,1,30,30
1649974069234,MATH 18,B02,083749,Staff,5,0,30,25
1649974069234,MATH 18,B03,083750,Staff,23,0,30,7
1649974069234,MATH 18,B04,083751,Staff,16,0,30,14
1649974075258,MATH 20A,A01,083754,Staff,32,0,40,8
1649974081290,MATH 20B,A01,083756,Staff,10,0,30,20
1649974081290,MATH 20B,A02,083757,Staff,26,0,30,4
1649974087315,MATH 20C,A01,083760,Staff,9,0,30,21
1649974087315,MATH 20C,A02,083761,Staff,3,0,30,27
1649974087315,MATH 20C,B01,083762,Staff,25,0,30,5
1649974087315,MATH 20C,B02,083763,Staff,30,0,30,0
1649974093347,MATH 20D,A01,083765,Staff,8,0,30,22
1649974093347,MATH 20D,A02,083766,Staff,28,0,30,2
1649974093347,MATH 20D,A03,083767,Staff,28,0,30,2
1649974099371,MATH 20E,A01,083771,Staff,10,0,30,20
1649974099371,MATH 20E,A02,083772,Staff,23,0,30,7
1649974099371,MATH 20E,B01,083773,Staff,6,0,30,24
1649974099371,MATH 20E,B02,083774,Staff,27,0,30,3
1649974105394,MATH 103A,A01,083777,Staff,1,5,30,29
1649974105394,MATH 103A,A02,083778,Staff,0,5,30,30
1649974105394,MATH 103A,B01,083779,Staff,0,5,30,30
1649974105394,MATH 103A,B02,083780,Staff,0,4,30,30
1649974111438,MATH 105,A01,085443,Staff,0,10,30,30
1649974117465,MATH 109,A01,083213,Anzaldo; Leesa B,0,3,30,30
1649974117465,MATH 109,A02,083214,Anzaldo; Leesa B,0,1,30,30
1649974117465,MATH 109,B01,083215,Anzaldo; Leesa B,18,0,30,12
1649974117465,MATH 109,B02,083216,Anzaldo; Leesa B,3,0,30,27
1649974123493,MATH 142A,A01,083219,Chow; Bennett,0,4,30,30
1649974123493,MATH 142A,A02,083220,Chow; Bennett,0,3,30,30
1649974123493,MATH 142A,B01,083221,Chow; Bennett,0,4,30,30
1649974123493,MATH 142A,B02,083222,Chow; Bennett,0,3,30,30
1649974129520,MATH 193A,A01,083224,Staff,0,5,30,30
1649974129520,MATH 193A,A02,083225,Staff,0,4,30,30
1649974129520,MATH 193A,A03,083781,Staff,1,0,30,29
1649974129520,MATH 193A,A04,083782,Staff,13,0,30,17
1649974135542,MATH 197,001,091859,McAuley; Julian John,9999,0,9999,0
1649974141596,COGS 9,A01,083615,Staff,0,5,60,60
1649974147625,COGS 11,A01,083617,Boyle; Mary E. T.,30,0,40,10
1649974153649,COGS 13,A01,083071,Staff,0,23,40,40
1649974159678,COGS 14A,A01,092681,Staff,29,0,100,71
1649974165704,COGS 14B,A01,083073,Cheng; Tzu-Han,10,0,50,40
1649974171735,COGS 17,A01,092677,Staff,53,0,75,22
1649974177773,COGS 100,A01,083619,Staff,1,15,60,59
1649974183800,COGS 101A,A01,083621,Davis; Joshua Daniel,0,15,60,60
1649974189838,COGS 101B,A01,091572,Staff,23,0,60,37
1649974195861,COGS 101C,A01,083625,Delgado; Tania,22,0,30,8
1649974201887,COGS 107A,A01,083627,Boyle; Mary E. T.,0,0,60,60
1649974207922,COGS 118A,A01,083075,Staff,21,0,60,39
1649974213945,CSE 3,A50,083646,Miranda; Gregory Joseph,22,0,38,16
1649974213945,CSE 3,A51,083647,Miranda; Gregory Joseph,37,0,37,0
1649974219977,CSE 8A,A50,083650,Miranda; Gregory Joseph,1,6,40,39
1649974226006,CSE 11,A01,083080,Cao; Yingjun,0,43,40,40
1649974232031,CSE 12,A01,083652,Staff,29,0,100,71
1649974238065,CSE 15L,A01,083654,Staff,0,0,50,50
1649974238065,CSE 15L,A02,083655,Staff,39,0,50,11
1649974244108,CSE 20,A01,083657,Staff,61,0,80,19
1649974250129,CSE 30,A01,083084,Eldon; John,0,47,40,40
1649974256154,CSE 100,A01,083659,Cao; Yingjun,1,49,50,49
1649974262175,CSE 134B,A01,083661,Powell; Thomas Allan,0,24,65,65
1649974268202,CSE 140,A01,083663,Staff,11,0,75,64
1649974274224,CSE 140L,A01,083088,Eldon; John,7,0,75,68
1649974280264,CSE 175,A01,083665,Kumar; Rakesh,10,0,25,15
1649974286286,CSE 190,A00,092507,Dubnov; Shlomo,17,0,20,3
1649974292311,ECE 45,A01,083139,Staff,0,6,40,40
1649974298345,ECE 65,A50,083695,Staff,2,0,30,28
1649974304367,ECE 109,A01,091882,Touri; Behrouz,51,0,70,19
1649974310393,ECE 180,A00,083140,Abi Samra; Nicholas Camill,26,0,30,4
1649974310393,ECE 180,B00,083141,Abi Samra; Nicholas Camill,10,0,30,20
1649974316417,MATH 10A,A01,083735,Patchell; Gregory David,18,0,30,12
1649974316417,MATH 10A,A02,083736,Patchell; Gregory David,28,0,30,2
1649974316417,MATH 10A,A03,083737,Patchell; Gregory David,27,0,30,3
1649974322442,MATH 10B,A01,083207,Staff,0,0,30,30
1649974322442,MATH 10B,A02,083208,Staff,22,0,30,8
1649974322442,MATH 10B,B01,083739,Staff,24,0,30,6
1649974322442,MATH 10B,B02,083740,Staff,30,0,30,0
1649974328483,MATH 18,A01,083743,Staff,21,0,30,9
1649974328483,MATH 18,A02,083744,Staff,29,0,30,1
1649974328483,MATH 18,A03,083745,Staff,27,0,30,3
1649974328483,MATH 18,A04,083746,Staff,27,0,30,3
1649974328483,MATH 18,B01,083748,Staff,0,1,30,30
1649974328483,MATH 18,B02,083749,Staff,4,0,30,26
1649974328483,MATH 18,B03,083750,Staff,23,0,30,7
1649974328483,MATH 18,B04,083751,Staff,16,0,30,14
1649974334508,MATH 20A,A01,083754,Staff,32,0,40,8
1649974340537,MATH 20B,A01,083756,Staff,10,0,30,20
1649974340537,MATH 20B,A02,083757,Staff,26,0,30,4
1649974346562,MATH 20C,A01,083760,Staff,8,0,30,22
1649974346562,MATH 20C,A02,083761,Staff,3,0,30,27
1649974346562,MATH 20C,B01,083762,Staff,25,0,30,5
1649974346562,MATH 20C,B02,083763,Staff,30,0,30,0
1649974352588,MATH 20D,A01,083765,Staff,8,0,30,22
1649974352588,MATH 20D,A02,083766,Staff,28,0,30,2
1649974352588,MATH 20D,A03,083767,Staff,28,0,30,2
1649974358622,MATH 20E,A01,083771,Staff,11,0,30,19
1649974358622,MATH 20E,A02,083772,Staff,22,0,30,8
1649974358622,MATH 20E,B01,083773,Staff,6,0,30,24
1649974358622,MATH 20E,B02,083774,Staff,27,0,30,3
1649974364645,MATH 103A,A01,083777,Staff,1,5,30,29
1649974364645,MATH 103A,A02,083778,Staff,0,4,30,30
1649974364645,MATH 103A,B01,083779,Staff,0,5,30,30
1649974364645,MATH 103A,B02,083780,Staff,0,4,30,30
1649974370677,MATH 105,A01,085443,Staff,0,10,30,30
1649974376708,MATH 109,A01,083213,Anzaldo; Leesa B,0,3,30,30
1649974376708,MATH 109,A02,083214,Anzaldo; Leesa B,0,1,30,30
1649974376708,MATH 109,B01,083215,Anzaldo; Leesa B,18,0,30,12
1649974376708,MATH 109,B02,083216,Anzaldo; Leesa B,3,0,30,27
1649974382730,MATH 142A,A01,083219,Chow; Bennett,0,4,30,30
1649974382730,MATH 142A,A02,083220,Chow; Bennett,0,4,30,30
1649974382730,MATH 142A,B01,083221,Chow; Bennett,0,4,30,30
1649974382730,MATH 142A,B02,083222,Chow; Bennett,0,3,30,30
1649974388757,MATH 193A,A01,083224,Staff,0,5,30,30
1649974388757,MATH 193A,A02,083225,Staff,0,4,30,30
1649974388757,MATH 193A,A03,083781,Staff,1,0,30,29
1649974388757,MATH 193A,A04,083782,Staff,13,0,30,17
1649974394782,MATH 197,001,091859,McAuley; Julian John,9999,0,9999,0
1649974400843,COGS 9,A01,083615,Staff,0,5,60,60
1649974406867,COGS 11,A01,083617,Boyle; Mary E. T.,30,0,40,10
1649974412889,COGS 13,A01,083071,Staff,0,24,40,40
1649974418913,COGS 14A,A01,092681,Staff,29,0,100,71
1649974424937,COGS 14B,A01,083073,Cheng; Tzu-Han,9,0,50,41
1649974431058,COGS 17,A01,092677,Staff,53,0,75,22
1649974437089,COGS 100,A01,083619,Staff,1,15,60,59
1649974443119,COGS 101A,A01,083621,Davis; Joshua Daniel,0,15,60,60
1649974449143,COGS 101B,A01,091572,Staff,23,0,60,37
1649974455169,COGS 101C,A01,083625,Delgado; Tania,22,0,30,8
1649974461197,COGS 107A,A01,083627,Boyle; Mary E. T.,0,0,60,60
1649974467221,COGS 118A,A01,083075,Staff,21,0,60,39
1649974473248,CSE 3,A50,083646,Miranda; Gregory Joseph,22,0,38,16
1649974473248,CSE 3,A51,083647,Miranda; Gregory Joseph,37,0,37,0
1649974479290,CSE 8A,A50,083650,Miranda; Gregory Joseph,1,8,40,39
1649974485313,CSE 11,A01,083080,Cao; Yingjun,0,43,40,40
1649974491337,CSE 12,A01,083652,Staff,29,0,100,71
1649974497361,CSE 15L,A01,083654,Staff,0,0,50,50
1649974497361,CSE 15L,A02,083655,Staff,38,0,50,12
1649974503393,CSE 20,A01,083657,Staff,61,0,80,19
1649974509415,CSE 30,A01,083084,Eldon; John,0,47,40,40
1649974515445,CSE 100,A01,083659,Cao; Yingjun,1,49,50,49
1649974521470,CSE 134B,A01,083661,Powell; Thomas Allan,0,25,65,65
1649974527495,CSE 140,A01,083663,Staff,11,0,75,64
1649974533518,CSE 140L,A01,083088,Eldon; John,7,0,75,68
1649974539542,CSE 175,A01,083665,Kumar; Rakesh,10,0,25,15
1649974545571,CSE 190,A00,092507,Dubnov; Shlomo,17,0,20,3
1649974551595,ECE 45,A01,083139,Staff,0,6,40,40
1649974557628,ECE 65,A50,083695,Staff,2,0,30,28
1649974563651,ECE 109,A01,091882,Touri; Behrouz,51,0,70,19
1649974569674,ECE 180,A00,083140,Abi Samra; Nicholas Camill,26,0,30,4
1649974569674,ECE 180,B00,083141,Abi Samra; Nicholas Camill,10,0,30,20
1649974575698,MATH 10A,A01,083735,Patchell; Gregory David,18,0,30,12
1649974575698,MATH 10A,A02,083736,Patchell; Gregory David,28,0,30,2
1649974575698,MATH 10A,A03,083737,Patchell; Gregory David,27,0,30,3
1649974581732,MATH 10B,A01,083207,Staff,0,0,30,30
1649974581732,MATH 10B,A02,083208,Staff,21,0,30,9
1649974581732,MATH 10B,B01,083739,Staff,24,0,30,6
1649974581732,MATH 10B,B02,083740,Staff,30,0,30,0
1649974587768,MATH 18,A01,083743,Staff,21,0,30,9
1649974587768,MATH 18,A02,083744,Staff,29,0,30,1
1649974587768,MATH 18,A03,083745,Staff,27,0,30,3
1649974587768,MATH 18,A04,083746,Staff,28,0,30,2
1649974587768,MATH 18,B01,083748,Staff,0,1,30,30
1649974587768,MATH 18,B02,083749,Staff,4,0,30,26
1649974587768,MATH 18,B03,083750,Staff,23,0,30,7
1649974587768,MATH 18,B04,083751,Staff,15,0,30,15
1649974593798,MATH 20A,A01,083754,Staff,32,0,40,8
1649974599828,MATH 20B,A01,083756,Staff,10,0,30,20
1649974599828,MATH 20B,A02,083757,Staff,26,0,30,4
1649974605857,MATH 20C,A01,083760,Staff,8,0,30,22
1649974605857,MATH 20C,A02,083761,Staff,3,0,30,27
1649974605857,MATH 20C,B01,083762,Staff,25,0,30,5
1649974605857,MATH 20C,B02,083763,Staff,30,0,30,0
1649974611891,MATH 20D,A01,083765,Staff,7,0,30,23
1649974611891,MATH 20D,A02,083766,Staff,28,0,30,2
1649974611891,MATH 20D,A03,083767,Staff,28,0,30,2
1649974617920,MATH 20E,A01,083771,Staff,11,0,30,19
1649974617920,MATH 20E,A02,083772,Staff,21,0,30,9
1649974617920,MATH 20E,B01,083773,Staff,6,0,30,24
1649974617920,MATH 20E,B02,083774,Staff,27,0,30,3
1649974623953,MATH 103A,A01,083777,Staff,1,5,30,29
1649974623953,MATH 103A,A02,083778,Staff,0,4,30,30
1649974623953,MATH 103A,B01,083779,Staff,0,5,30,30
1649974623953,MATH 103A,B02,083780,Staff,0,4,30,30
1649974629981,MATH 105,A01,085443,Staff,0,10,30,30
1649974636005,MATH 109,A01,083213,Anzaldo; Leesa B,0,3,30,30
1649974636005,MATH 109,A02,083214,Anzaldo; Leesa B,0,1,30,30
1649974636005,MATH 109,B01,083215,Anzaldo; Leesa B,18,0,30,12
1649974636005,MATH 109,B02,083216,Anzaldo; Leesa B,2,0,30,28
1649974642028,MATH 142A,A01,083219,Chow; Bennett,0,5,30,30
1649974642028,MATH 142A,A02,083220,Chow; Bennett,0,3,30,30
1649974642028,MATH 142A,B01,083221,Chow; Bennett,0,4,30,30
1649974642028,MATH 142A,B02,083222,Chow; Bennett,0,3,30,30
1649974648066,MATH 193A,A01,083224,Staff,0,5,30,30
1649974648066,MATH 193A,A02,083225,Staff,0,4,30,30
1649974648066,MATH 193A,A03,083781,Staff,1,0,30,29
1649974648066,MATH 193A,A04,083782,Staff,13,0,30,17
1649974654092,MATH 197,001,091859,McAuley; Julian John,9999,0,9999,0
1649974660189,COGS 9,A01,083615,Staff,0,5,60,60
1649974666222,COGS 11,A01,083617,Boyle; Mary E. T.,30,0,40,10
1649974672245,COGS 13,A01,083071,Staff,0,24,40,40
1649974678277,COGS 14A,A01,092681,Staff,29,0,100,71
1649974684320,COGS 14B,A01,083073,Cheng; Tzu-Han,9,0,50,41
1649974690346,COGS 17,A01,092677,Staff,53,0,75,22
1649974696368,COGS 100,A01,083619,Staff,1,15,60,59
1649974702399,COGS 101A,A01,083621,Davis; Joshua Daniel,0,15,60,60
1649974708422,COGS 101B,A01,091572,Staff,23,0,60,37
1649974714446,COGS 101C,A01,083625,Delgado; Tania,22,0,30,8
1649974720474,COGS 107A,A01,083627,Boyle; Mary E. T.,0,0,60,60
1649974726496,COGS 118A,A01,083075,Staff,21,0,60,39
1649974732518,CSE 3,A50,083646,Miranda; Gregory Joseph,22,0,38,16
1649974732518,CSE 3,A51,083647,Miranda; Gregory Joseph,37,0,37,0
1649974738546,CSE 8A,A50,083650,Miranda; Gregory Joseph,1,8,40,39
1649974744570,CSE 11,A01,083080,Cao; Yingjun,0,43,40,40
1649974750600,CSE 12,A01,083652,Staff,29,0,100,71
1649974756625,CSE 15L,A01,083654,Staff,0,0,50,50
1649974756625,CSE 15L,A02,083655,Staff,38,0,50,12
1649974762665,CSE 20,A01,083657,Staff,61,0,80,19
1649974768689,CSE 30,A01,083084,Eldon; John,0,47,40,40
1649974774715,CSE 100,A01,083659,Cao; Yingjun,1,49,50,49
1649974780751,CSE 134B,A01,083661,Powell; Thomas Allan,0,25,65,65
1649974786775,CSE 140,A01,083663,Staff,11,0,75,64
1649974792801,CSE 140L,A01,083088,Eldon; John,7,0,75,68
1649974798827,CSE 175,A01,083665,Kumar; Rakesh,10,0,25,15
1649974804858,CSE 190,A00,092507,Dubnov; Shlomo,17,0,20,3
1649974810893,ECE 45,A01,083139,Staff,0,6,40,40
1649974816922,ECE 65,A50,083695,Staff,2,0,30,28
1649974822945,ECE 109,A01,091882,Touri; Behrouz,51,0,70,19
1649974828967,ECE 180,A00,083140,Abi Samra; Nicholas Camill,26,0,30,4
1649974828967,ECE 180,B00,083141,Abi Samra; Nicholas Camill,10,0,30,20
1649974834990,MATH 10A,A01,083735,Patchell; Gregory David,18,0,30,12
1649974834990,MATH 10A,A02,083736,Patchell; Gregory David,28,0,30,2
1649974834990,MATH 10A,A03,083737,Patchell; Gregory David,27,0,30,3
1649974841012,MATH 10B,A01,083207,Staff,0,0,30,30
1649974841012,MATH 10B,A02,083208,Staff,21,0,30,9
1649974841012,MATH 10B,B01,083739,Staff,24,0,30,6
1649974841012,MATH 10B,B02,083740,Staff,30,0,30,0
1649974847042,MATH 18,A01,083743,Staff,21,0,30,9
1649974847042,MATH 18,A02,083744,Staff,29,0,30,1
1649974847042,MATH 18,A03,083745,Staff,27,0,30,3
1649974847042,MATH 18,A04,083746,Staff,28,0,30,2
1649974847042,MATH 18,B01,083748,Staff,0,1,30,30
1649974847042,MATH 18,B02,083749,Staff,4,0,30,26
1649974847042,MATH 18,B03,083750,Staff,23,0,30,7
1649974847042,MATH 18,B04,083751,Staff,15,0,30,15
1649974853074,MATH 20A,A01,083754,Staff,32,0,40,8
1649974859097,MATH 20B,A01,083756,Staff,10,0,30,20
1649974859097,MATH 20B,A02,083757,Staff,26,0,30,4
1649974865123,MATH 20C,A01,083760,Staff,7,0,30,23
1649974865123,MATH 20C,A02,083761,Staff,3,0,30,27
1649974865123,MATH 20C,B01,083762,Staff,25,0,30,5
1649974865123,MATH 20C,B02,083763,Staff,30,0,30,0
1649974871150,MATH 20D,A01,083765,Staff,6,0,30,24
1649974871150,MATH 20D,A02,083766,Staff,28,0,30,2
1649974871150,MATH 20D,A03,083767,Staff,28,0,30,2
1649974877178,MATH 20E,A01,083771,Staff,11,0,30,19
1649974877178,MATH 20E,A02,083772,Staff,21,0,30,9
1649974877178,MATH 20E,B01,083773,Staff,6,0,30,24
1649974877178,MATH 20E,B02,083774,Staff,27,0,30,3
1649974883208,MATH 103A,A01,083777,Staff,1,5,30,29
1649974883208,MATH 103A,A02,083778,Staff,0,4,30,30
1649974883208,MATH 103A,B01,083779,Staff,0,5,30,30
1649974883208,MATH 103A,B02,083780,Staff,0,4,30,30
1649974889239,MATH 105,A01,085443,Staff,0,10,30,30
1649974895261,MATH 109,A01,083213,Anzaldo; Leesa B,0,3,30,30
1649974895261,MATH 109,A02,083214,Anzaldo; Leesa B,0,1,30,30
1649974895261,MATH 109,B01,083215,Anzaldo; Leesa B,17,0,30,13
1649974895261,MATH 109,B02,083216,Anzaldo; Leesa B,2,0,30,28
1649974901290,MATH 142A,A01,083219,Chow; Bennett,0,5,30,30
1649974901290,MATH 142A,A02,083220,Chow; Bennett,0,3,30,30
1649974901290,MATH 142A,B01,083221,Chow; Bennett,0,4,30,30
1649974901290,MATH 142A,B02,083222,Chow; Bennett,0,3,30,30
1649974907313,MATH 193A,A01,083224,Staff,0,5,30,30
1649974907313,MATH 193A,A02,083225,Staff,0,4,30,30
1649974907313,MATH 193A,A03,083781,Staff,1,0,30,29
1649974907313,MATH 193A,A04,083782,Staff,13,0,30,17
1649974913336,MATH 197,001,091859,McAuley; Julian John,9999,0,9999,0
1649974919390,COGS 9,A01,083615,Staff,0,5,60,60
1649974925420,COGS 11,A01,083617,Boyle; Mary E. T.,30,0,40,10
1649974931453,COGS 13,A01,083071,Staff,0,25,40,40
1649974937482,COGS 14A,A01,092681,Staff,28,0,100,72
1649974943511,COGS 14B,A01,083073,Cheng; Tzu-Han,9,0,50,41
1649974949554,COGS 17,A01,092677,Staff,53,0,75,22
1649974955578,COGS 100,A01,083619,Staff,1,15,60,59
1649974961603,COGS 101A,A01,083621,Davis; Joshua Daniel,0,16,60,60
1649974967632,COGS 101B,A01,091572,Staff,22,0,60,38
1649974973680,COGS 101C,A01,083625,Delgado; Tania,22,0,30,8
1649974979708,COGS 107A,A01,083627,Boyle; Mary E. T.,0,0,60,60
1649974985763,COGS 118A,A01,083075,Staff,21,0,60,39
1649974991799,CSE 3,A50,083646,Miranda; Gregory Joseph,22,0,38,16
1649974991799,CSE 3,A51,083647,Miranda; Gregory Joseph,37,0,37,0
1649974997825,CSE 8A,A50,083650,Miranda; Gregory Joseph,1,8,40,39
1649975003864,CSE 11,A01,083080,Cao; Yingjun,0,43,40,40
1649975009893,CSE 12,A01,083652,Staff,29,0,100,71
1649975015915,CSE 15L,A01,083654,Staff,0,0,50,50
1649975015915,CSE 15L,A02,083655,Staff,38,0,50,12
1649975021939,CSE 20,A01,083657,Staff,61,0,80,19
1649975028041,CSE 30,A01,083084,Eldon; John,0,48,40,40
1649975034067,CSE 100,A01,083659,Cao; Yingjun,1,49,50,49
1649975040094,CSE 134B,A01,083661,Powell; Thomas Allan,0,25,65,65
1649975046129,CSE 140,A01,083663,Staff,11,0,75,64
1649975052158,CSE 140L,A01,083088,Eldon; John,7,0,75,68
1649975058189,CSE 175,A01,083665,Kumar; Rakesh,10,0,25,15
1649975064219,CSE 190,A00,092507,Dubnov; Shlomo,17,0,20,3
1649975070249,ECE 45,A01,083139,Staff,0,6,40,40
1649975076282,ECE 65,A50,083695,Staff,2,0,30,28
1649975082311,ECE 109,A01,091882,Touri; Behrouz,51,0,70,19
1649975088339,ECE 180,A00,083140,Abi Samra; Nicholas Camill,26,0,30,4
1649975088339,ECE 180,B00,083141,Abi Samra; Nicholas Camill,10,0,30,20
1649975094362,MATH 10A,A01,083735,Patchell; Gregory David,18,0,30,12
1649975094362,MATH 10A,A02,083736,Patchell; Gregory David,28,0,30,2
1649975094362,MATH 10A,A03,083737,Patchell; Gregory David,27,0,30,3
1649975100390,MATH 10B,A01,083207,Staff,0,0,30,30
1649975100390,MATH 10B,A02,083208,Staff,21,0,30,9
1649975100390,MATH 10B,B01,083739,Staff,24,0,30,6
1649975100390,MATH 10B,B02,083740,Staff,30,0,30,0
1649975106435,MATH 18,A01,083743,Staff,21,0,30,9
1649975106435,MATH 18,A02,083744,Staff,29,0,30,1
1649975106435,MATH 18,A03,083745,Staff,27,0,30,3
1649975106435,MATH 18,A04,083746,Staff,28,0,30,2
1649975106435,MATH 18,B01,083748,Staff,0,1,30,30
1649975106435,MATH 18,B02,083749,Staff,2,0,30,28
1649975106435,MATH 18,B03,083750,Staff,23,0,30,7
1649975106435,MATH 18,B04,083751,Staff,15,0,30,15
1649975112470,MATH 20A,A01,083754,Staff,32,0,40,8
1649975118493,MATH 20B,A01,083756,Staff,10,0,30,20
1649975118493,MATH 20B,A02,083757,Staff,26,0,30,4
1649975124517,MATH 20C,A01,083760,Staff,7,0,30,23
1649975124517,MATH 20C,A02,083761,Staff,3,0,30,27
1649975124517,MATH 20C,B01,083762,Staff,25,0,30,5
1649975124517,MATH 20C,B02,083763,Staff,30,0,30,0
1649975130550,MATH 20D,A01,083765,Staff,5,0,30,25
1649975130550,MATH 20D,A02,083766,Staff,27,0,30,3
1649975130550,MATH 20D,A03,083767,Staff,28,0,30,2
1649975136584,MATH 20E,A01,083771,Staff,11,0,30,19
1649975136584,MATH 20E,A02,083772,Staff,21,0,30,9
1649975136584,MATH 20E,B01,083773,Staff,5,0,30,25
1649975136584,MATH 20E,B02,083774,Staff,27,0,30,3
1649975142609,MATH 103A,A01,083777,Staff,1,5,30,29
1649975142609,MATH 103A,A02,083778,Staff,0,4,30,30
1649975142609,MATH 103A,B01,083779,Staff,0,5,30,30
1649975142609,MATH 103A,B02,083780,Staff,0,4,30,30
1649975148636,MATH 105,A01,085443,Staff,0,10,30,30
1649975154667,MATH 109,A01,083213,Anzaldo; Leesa B,0,3,30,30
1649975154667,MATH 109,A02,083214,Anzaldo; Leesa B,0,1,30,30
1649975154667,MATH 109,B01,083215,Anzaldo; Leesa B,17,0,30,13
1649975154667,MATH 109,B02,083216,Anzaldo; Leesa B,2,0,30,28
1649975160699,MATH 142A,A01,083219,Chow; Bennett,0,5,30,30
1649975160699,MATH 142A,A02,083220,Chow; Bennett,0,3,30,30
1649975160699,MATH 142A,B01,083221,Chow; Bennett,0,4,30,30
1649975160699,MATH 142A,B02,083222,Chow; Bennett,0,3,30,30
1649975166726,MATH 193A,A01,083224,Staff,0,5,30,30
1649975166726,MATH 193A,A02,083225,Staff,0,4,30,30
1649975166726,MATH 193A,A03,083781,Staff,1,0,30,29
1649975166726,MATH 193A,A04,083782,Staff,13,0,30,17
1649975172752,MATH 197,001,091859,McAuley; Julian John,9999,0,9999,0
1649975178807,COGS 9,A01,083615,Staff,0,5,60,60
1649975184838,COGS 11,A01,083617,Boyle; Mary E. T.,30,0,40,10
1649975190870,COGS 13,A01,083071,Staff,0,24,40,40
1649975196895,COGS 14A,A01,092681,Staff,27,0,100,73
1649975202940,COGS 14B,A01,083073,Cheng; Tzu-Han,9,0,50,41
1649975208972,COGS 17,A01,092677,Staff,52,0,75,23
1649975214996,COGS 100,A01,083619,Staff,1,15,60,59
1649975221022,COGS 101A,A01,083621,Davis; Joshua Daniel,0,15,60,60
1649975227058,COGS 101B,A01,091572,Staff,22,0,60,38
1649975233081,COGS 101C,A01,083625,Delgado; Tania,22,0,30,8
1649975239105,COGS 107A,A01,083627,Boyle; Mary E. T.,0,1,60,60
1649975245132,COGS 118A,A01,083075,Staff,21,0,60,39
1649975251161,CSE 3,A50,083646,Miranda; Gregory Joseph,22,0,38,16
1649975251161,CSE 3,A51,083647,Miranda; Gregory Joseph,37,0,37,0
1649975257185,CSE 8A,A50,083650,Miranda; Gregory Joseph,1,8,40,39
1649975263222,CSE 11,A01,083080,Cao; Yingjun,0,43,40,40
1649975269244,CSE 12,A01,083652,Staff,29,0,100,71
1649975275268,CSE 15L,A01,083654,Staff,0,0,50,50
1649975275268,CSE 15L,A02,083655,Staff,38,0,50,12
1649975281300,CSE 20,A01,083657,Staff,61,0,80,19
1649975287327,CSE 30,A01,083084,Eldon; John,0,49,40,40
1649975293356,CSE 100,A01,083659,Cao; Yingjun,1,49,50,49
1649975299384,CSE 134B,A01,083661,Powell; Thomas Allan,0,25,65,65
1649975305411,CSE 140,A01,083663,Staff,11,0,75,64
1649975311440,CSE 140L,A01,083088,Eldon; John,7,0,75,68
1649975317466,CSE 175,A01,083665,Kumar; Rakesh,10,0,25,15
1649975323488,CSE 190,A00,092507,Dubnov; Shlomo,17,0,20,3
1649975329512,ECE 45,A01,083139,Staff,0,6,40,40
1649975335534,ECE 65,A50,083695,Staff,2,0,30,28
1649975341556,ECE 109,A01,091882,Touri; Behrouz,51,0,70,19
1649975347584,ECE 180,A00,083140,Abi Samra; Nicholas Camill,26,0,30,4
1649975347584,ECE 180,B00,083141,Abi Samra; Nicholas Camill,10,0,30,20
1649975353615,MATH 10A,A01,083735,Patchell; Gregory David,18,0,30,12
1649975353615,MATH 10A,A02,083736,Patchell; Gregory David,28,0,30,2
1649975353615,MATH 10A,A03,083737,Patchell; Gregory David,27,0,30,3
1649975359639,MATH 10B,A01,083207,Staff,0,0,30,30
1649975359639,MATH 10B,A02,083208,Staff,21,0,30,9
1649975359639,MATH 10B,B01,083739,Staff,24,0,30,6
1649975359639,MATH 10B,B02,083740,Staff,30,0,30,0
1649975365664,MATH 18,A01,083743,Staff,21,0,30,9
1649975365664,MATH 18,A02,083744,Staff,29,0,30,1
1649975365664,MATH 18,A03,083745,Staff,27,0,30,3
1649975365664,MATH 18,A04,083746,Staff,28,0,30,2
1649975365664,MATH 18,B01,083748,Staff,0,1,30,30
1649975365664,MATH 18,B02,083749,Staff,2,0,30,28
1649975365664,MATH 18,B03,083750,Staff,23,0,30,7
1649975365664,MATH 18,B04,083751,Staff,15,0,30,15
1649975371685,MATH 20A,A01,083754,Staff,32,0,40,8
1649975377707,MATH 20B,A01,083756,Staff,10,0,30,20
1649975377707,MATH 20B,A02,083757,Staff,26,0,30,4
1649975383734,MATH 20C,A01,083760,Staff,7,0,30,23
1649975383734,MATH 20C,A02,083761,Staff,3,0,30,27
1649975383734,MATH 20C,B01,083762,Staff,25,0,30,5
1649975383734,MATH 20C,B02,083763,Staff,30,0,30,0
1649975389758,MATH 20D,A01,083765,Staff,5,0,30,25
1649975389758,MATH 20D,A02,083766,Staff,27,0,30,3
1649975389758,MATH 20D,A03,083767,Staff,28,0,30,2
1649975395781,MATH 20E,A01,083771,Staff,11,0,30,19
1649975395781,MATH 20E,A02,083772,Staff,21,0,30,9
1649975395781,MATH 20E,B01,083773,Staff,5,0,30,25
1649975395781,MATH 20E,B02,083774,Staff,27,0,30,3
1649975401804,MATH 103A,A01,083777,Staff,1,5,30,29
1649975401804,MATH 103A,A02,083778,Staff,0,4,30,30
1649975401804,MATH 103A,B01,083779,Staff,0,5,30,30
1649975401804,MATH 103A,B02,083780,Staff,0,4,30,30
1649975407825,MATH 105,A01,085443,Staff,0,10,30,30
1649975413848,MATH 109,A01,083213,Anzaldo; Leesa B,0,3,30,30
1649975413848,MATH 109,A02,083214,Anzaldo; Leesa B,0,1,30,30
1649975413848,MATH 109,B01,083215,Anzaldo; Leesa B,16,0,30,14
1649975413848,MATH 109,B02,083216,Anzaldo; Leesa B,2,0,30,28
1649975419881,MATH 142A,A01,083219,Chow; Bennett,0,5,30,30
1649975419881,MATH 142A,A02,083220,Chow; Bennett,0,3,30,30
1649975419881,MATH 142A,B01,083221,Chow; Bennett,0,4,30,30
1649975419881,MATH 142A,B02,083222,Chow; Bennett,0,3,30,30
1649975425910,MATH 193A,A01,083224,Staff,0,5,30,30
1649975425910,MATH 193A,A02,083225,Staff,0,4,30,30
1649975425910,MATH 193A,A03,083781,Staff,1,0,30,29
1649975425910,MATH 193A,A04,083782,Staff,13,0,30,17
1649975431938,MATH 197,001,091859,McAuley; Julian John,9999,0,9999,0
1649975437995,COGS 9,A01,083615,Staff,0,5,60,60
1649975444037,COGS 11,A01,083617,Boyle; Mary E. T.,30,0,40,10
1649975450060,COGS 13,A01,083071,Staff,0,24,40,40
1649975456084,COGS 14A,A01,092681,Staff,27,0,100,73
1649975462108,COGS 14B,A01,083073,Cheng; Tzu-Han,9,0,50,41
1649975468145,COGS 17,A01,092677,Staff,52,0,75,23
1649975474187,COGS 100,A01,083619,Staff,1,15,60,59
1649975480214,COGS 101A,A01,083621,Davis; Joshua Daniel,0,15,60,60
1649975486238,COGS 101B,A01,091572,Staff,22,0,60,38
1649975492267,COGS 101C,A01,083625,Delgado; Tania,22,0,30,8
1649975498296,COGS 107A,A01,083627,Boyle; Mary E. T.,0,1,60,60
1649975504320,COGS 118A,A01,083075,Staff,21,0,60,39
1649975510353,CSE 3,A50,083646,Miranda; Gregory Joseph,22,0,38,16
1649975510353,CSE 3,A51,083647,Miranda; Gregory Joseph,37,0,37,0
1649975516382,CSE 8A,A50,083650,Miranda; Gregory Joseph,1,8,40,39
1649975522407,CSE 11,A01,083080,Cao; Yingjun,0,43,40,40
1649975528433,CSE 12,A01,083652,Staff,28,0,100,72
1649975534459,CSE 15L,A01,083654,Staff,0,0,50,50
1649975534459,CSE 15L,A02,083655,Staff,37,0,50,13
1649975540495,CSE 20,A01,083657,Staff,61,0,80,19
1649975546529,CSE 30,A01,083084,Eldon; John,0,49,40,40
1649975552555,CSE 100,A01,083659,Cao; Yingjun,1,49,50,49
1649975558578,CSE 134B,A01,083661,Powell; Thomas Allan,0,25,65,65
1649975564601,CSE 140,A01,083663,Staff,11,0,75,64
1649975570639,CSE 140L,A01,083088,Eldon; John,7,0,75,68
1649975576661,CSE 175,A01,083665,Kumar; Rakesh,10,0,25,15
1649975582684,CSE 190,A00,092507,Dubnov; Shlomo,17,0,20,3
1649975588708,ECE 45,A01,083139,Staff,0,6,40,40
1649975594734,ECE 65,A50,083695,Staff,2,0,30,28
1649975600764,ECE 109,A01,091882,Touri; Behrouz,51,0,70,19
1649975606791,ECE 180,A00,083140,Abi Samra; Nicholas Camill,26,0,30,4
1649975606791,ECE 180,B00,083141,Abi Samra; Nicholas Camill,10,0,30,20
1649975612822,MATH 10A,A01,083735,Patchell; Gregory David,18,0,30,12
1649975612822,MATH 10A,A02,083736,Patchell; Gregory David,28,0,30,2
1649975612822,MATH 10A,A03,083737,Patchell; Gregory David,27,0,30,3
1649975618858,MATH 10B,A01,083207,Staff,0,0,30,30
1649975618858,MATH 10B,A02,083208,Staff,21,0,30,9
1649975618858,MATH 10B,B01,083739,Staff,24,0,30,6
1649975618858,MATH 10B,B02,083740,Staff,30,0,30,0
1649975624972,MATH 18,A01,083743,Staff,21,0,30,9
1649975624972,MATH 18,A02,083744,Staff,29,0,30,1
1649975624972,MATH 18,A03,083745,Staff,27,0,30,3
1649975624972,MATH 18,A04,083746,Staff,28,0,30,2
1649975624972,MATH 18,B01,083748,Staff,0,1,30,30
1649975624972,MATH 18,B02,083749,Staff,2,0,30,28
1649975624972,MATH 18,B03,083750,Staff,22,0,30,8
1649975624972,MATH 18,B04,083751,Staff,15,0,30,15
1649975630996,MATH 20A,A01,083754,Staff,32,0,40,8
1649975637023,MATH 20B,A01,083756,Staff,10,0,30,20
1649975637023,MATH 20B,A02,083757,Staff,26,0,30,4
1649975643055,MATH 20C,A01,083760,Staff,7,0,30,23
1649975643055,MATH 20C,A02,083761,Staff,3,0,30,27
1649975643055,MATH 20C,B01,083762,Staff,24,0,30,6
1649975643055,MATH 20C,B02,083763,Staff,30,0,30,0
1649975649081,MATH 20D,A01,083765,Staff,4,0,30,26
1649975649081,MATH 20D,A02,083766,Staff,27,0,30,3
1649975649081,MATH 20D,A03,083767,Staff,28,0,30,2
1649975655109,MATH 20E,A01,083771,Staff,11,0,30,19
1649975655109,MATH 20E,A02,083772,Staff,21,0,30,9
1649975655109,MATH 20E,B01,083773,Staff,5,0,30,25
1649975655109,MATH 20E,B02,083774,Staff,27,0,30,3
1649975661137,MATH 103A,A01,083777,Staff,1,5,30,29
1649975661137,MATH 103A,A02,083778,Staff,0,4,30,30
1649975661137,MATH 103A,B01,083779,Staff,0,5,30,30
1649975661137,MATH 103A,B02,083780,Staff,0,4,30,30
1649975667160,MATH 105,A01,085443,Staff,0,10,30,30
1649975673187,MATH 109,A01,083213,Anzaldo; Leesa B,0,3,30,30
1649975673187,MATH 109,A02,083214,Anzaldo; Leesa B,0,1,30,30
1649975673187,MATH 109,B01,083215,Anzaldo; Leesa B,15,0,30,15
1649975673187,MATH 109,B02,083216,Anzaldo; Leesa B,1,0,30,29
1649975679210,MATH 142A,A01,083219,Chow; Bennett,0,5,30,30
1649975679210,MATH 142A,A02,083220,Chow; Bennett,0,3,30,30
1649975679210,MATH 142A,B01,083221,Chow; Bennett,0,4,30,30
1649975679210,MATH 142A,B02,083222,Chow; Bennett,0,3,30,30
1649975685233,MATH 193A,A01,083224,Staff,0,5,30,30
1649975685233,MATH 193A,A02,083225,Staff,0,4,30,30
1649975685233,MATH 193A,A03,083781,Staff,1,0,30,29
1649975685233,MATH 193A,A04,083782,Staff,13,0,30,17
1649975691313,MATH 197,001,091859,McAuley; Julian John,9999,0,9999,0
1649975697388,COGS 9,A01,083615,Staff,0,5,60,60
1649975703417,COGS 11,A01,083617,Boyle; Mary E. T.,30,0,40,10
1649975709468,COGS 13,A01,083071,Staff,0,24,40,40
1649975715492,COGS 14A,A01,092681,Staff,27,0,100,73
1649975721525,COGS 14B,A01,083073,Cheng; Tzu-Han,9,0,50,41
1649975727553,COGS 17,A01,092677,Staff,52,0,75,23
1649975733580,COGS 100,A01,083619,Staff,1,15,60,59
1649975739621,COGS 101A,A01,083621,Davis; Joshua Daniel,0,16,60,60
1649975745645,COGS 101B,A01,091572,Staff,22,0,60,38
1649975751672,COGS 101C,A01,083625,Delgado; Tania,22,0,30,8
1649975757697,COGS 107A,A01,083627,Boyle; Mary E. T.,0,1,60,60
1649975763719,COGS 118A,A01,083075,Staff,21,0,60,39
1649975769749,CSE 3,A50,083646,Miranda; Gregory Joseph,22,0,38,16
1649975769749,CSE 3,A51,083647,Miranda; Gregory Joseph,37,0,37,0
1649975775789,CSE 8A,A50,083650,Miranda; Gregory Joseph,1,8,40,39
1649975781813,CSE 11,A01,083080,Cao; Yingjun,0,43,40,40
1649975787835,CSE 12,A01,083652,Staff,28,0,100,72
1649975793860,CSE 15L,A01,083654,Staff,0,0,50,50
1649975793860,CSE 15L,A02,083655,Staff,37,0,50,13
1649975799887,CSE 20,A01,083657,Staff,61,0,80,19
1649975805914,CSE 30,A01,083084,Eldon; John,0,49,40,40
1649975811936,CSE 100,A01,083659,Cao; Yingjun,1,49,50,49
1649975817959,CSE 134B,A01,083661,Powell; Thomas Allan,0,25,65,65
1649975823986,CSE 140,A01,083663,Staff,11,0,75,64
1649975830010,CSE 140L,A01,083088,Eldon; John,7,0,75,68
1649975836032,CSE 175,A01,083665,Kumar; Rakesh,10,0,25,15
1649975842076,CSE 190,A00,092507,Dubnov; Shlomo,17,0,20,3
1649975848103,ECE 45,A01,083139,Staff,0,6,40,40
1649975854127,ECE 65,A50,083695,Staff,2,0,30,28
1649975860153,ECE 109,A01,091882,Touri; Behrouz,51,0,70,19
1649975866185,ECE 180,A00,083140,Abi Samra; Nicholas Camill,26,0,30,4
1649975866185,ECE 180,B00,083141,Abi Samra; Nicholas Camill,10,0,30,20
1649975872219,MATH 10A,A01,083735,Patchell; Gregory David,18,0,30,12
1649975872219,MATH 10A,A02,083736,Patchell; Gregory David,28,0,30,2
1649975872219,MATH 10A,A03,083737,Patchell; Gregory David,27,0,30,3
1649975878241,MATH 10B,A01,083207,Staff,0,0,30,30
1649975878241,MATH 10B,A02,083208,Staff,21,0,30,9
1649975878241,MATH 10B,B01,083739,Staff,24,0,30,6
1649975878241,MATH 10B,B02,083740,Staff,30,0,30,0
1649975884266,MATH 18,A01,083743,Staff,21,0,30,9
1649975884266,MATH 18,A02,083744,Staff,29,0,30,1
1649975884266,MATH 18,A03,083745,Staff,27,0,30,3
1649975884266,MATH 18,A04,083746,Staff,28,0,30,2
1649975884266,MATH 18,B01,083748,Staff,0,1,30,30
1649975884266,MATH 18,B02,083749,Staff,2,0,30,28
1649975884266,MATH 18,B03,083750,Staff,22,0,30,8
1649975884266,MATH 18,B04,083751,Staff,15,0,30,15
1649975890295,MATH 20A,A01,083754,Staff,32,0,40,8
1649975896324,MATH 20B,A01,083756,Staff,10,0,30,20
1649975896324,MATH 20B,A02,083757,Staff,26,0,30,4
1649975902349,MATH 20C,A01,083760,Staff,6,0,30,24
1649975902349,MATH 20C,A02,083761,Staff,3,0,30,27
1649975902349,MATH 20C,B01,083762,Staff,24,0,30,6
1649975902349,MATH 20C,B02,083763,Staff,30,0,30,0
1649975908375,MATH 20D,A01,083765,Staff,4,0,30,26
1649975908375,MATH 20D,A02,083766,Staff,27,0,30,3
1649975908375,MATH 20D,A03,083767,Staff,28,0,30,2
1649975914403,MATH 20E,A01,083771,Staff,11,0,30,19
1649975914403,MATH 20E,A02,083772,Staff,21,0,30,9
1649975914403,MATH 20E,B01,083773,Staff,5,0,30,25
1649975914403,MATH 20E,B02,083774,Staff,27,0,30,3
1649975920426,MATH 103A,A01,083777,Staff,1,5,30,29
1649975920426,MATH 103A,A02,083778,Staff,0,4,30,30
1649975920426,MATH 103A,B01,083779,Staff,0,5,30,30
1649975920426,MATH 103A,B02,083780,Staff,0,4,30,30
1649975926453,MATH 105,A01,085443,Staff,0,10,30,30
1649975932476,MATH 109,A01,083213,Anzaldo; Leesa B,0,3,30,30
1649975932476,MATH 109,A02,083214,Anzaldo; Leesa B,0,1,30,30
1649975932476,MATH 109,B01,083215,Anzaldo; Leesa B,15,0,30,15
1649975932476,MATH 109,B02,083216,Anzaldo; Leesa B,1,0,30,29
1649975938504,MATH 142A,A01,083219,Chow; Bennett,0,5,30,30
1649975938504,MATH 142A,A02,083220,Chow; Bennett,0,3,30,30
1649975938504,MATH 142A,B01,083221,Chow; Bennett,0,4,30,30
1649975938504,MATH 142A,B02,083222,Chow; Bennett,0,3,30,30
1649975944527,MATH 193A,A01,083224,Staff,0,5,30,30
1649975944527,MATH 193A,A02,083225,Staff,0,4,30,30
1649975944527,MATH 193A,A03,083781,Staff,1,0,30,29
1649975944527,MATH 193A,A04,083782,Staff,13,0,30,17
1649975950553,MATH 197,001,091859,McAuley; Julian John,9999,0,9999,0
1649975956605,COGS 9,A01,083615,Staff,0,5,60,60
1649975962628,COGS 11,A01,083617,Boyle; Mary E. T.,30,0,40,10
1649975968651,COGS 13,A01,083071,Staff,0,24,40,40
1649975974676,COGS 14A,A01,092681,Staff,27,0,100,73
1649975980698,COGS 14B,A01,083073,Cheng; Tzu-Han,9,0,50,41
1649975986730,COGS 17,A01,092677,Staff,52,0,75,23
1649975992766,COGS 100,A01,083619,Staff,1,15,60,59
1649975998796,COGS 101A,A01,083621,Davis; Joshua Daniel,0,16,60,60
1649976004818,COGS 101B,A01,091572,Staff,22,0,60,38
1649976010858,COGS 101C,A01,083625,Delgado; Tania,22,0,30,8
1649976016881,COGS 107A,A01,083627,Boyle; Mary E. T.,0,1,60,60
1649976022909,COGS 118A,A01,083075,Staff,21,0,60,39
1649976028937,CSE 3,A50,083646,Miranda; Gregory Joseph,22,0,38,16
1649976028937,CSE 3,A51,083647,Miranda; Gregory Joseph,37,0,37,0
1649976034963,CSE 8A,A50,083650,Miranda; Gregory Joseph,2,8,40,38
1649976040994,CSE 11,A01,083080,Cao; Yingjun,0,43,40,40
1649976047019,CSE 12,A01,083652,Staff,28,0,100,72
1649976053050,CSE 15L,A01,083654,Staff,0,0,50,50
1649976053050,CSE 15L,A02,083655,Staff,37,0,50,13
1649976059084,CSE 20,A01,083657,Staff,61,0,80,19
1649976065111,CSE 30,A01,083084,Eldon; John,0,49,40,40
1649976071147,CSE 100,A01,083659,Cao; Yingjun,1,49,50,49
1649976077190,CSE 134B,A01,083661,Powell; Thomas Allan,0,25,65,65
1649976083215,CSE 140,A01,083663,Staff,11,0,75,64
1649976089237,CSE 140L,A01,083088,Eldon; John,7,0,75,68
1649976095263,CSE 175,A01,083665,Kumar; Rakesh,10,0,25,15
1649976101289,CSE 190,A00,092507,Dubnov; Shlomo,17,0,20,3
1649976107313,ECE 45,A01,083139,Staff,0,6,40,40
1649976113340,ECE 65,A50,083695,Staff,2,0,30,28
1649976119376,ECE 109,A01,091882,Touri; Behrouz,51,0,70,19
1649976125398,ECE 180,A00,083140,Abi Samra; Nicholas Camill,26,0,30,4
1649976125398,ECE 180,B00,083141,Abi Samra; Nicholas Camill,10,0,30,20
1649976131445,MATH 10A,A01,083735,Patchell; Gregory David,18,0,30,12
1649976131445,MATH 10A,A02,083736,Patchell; Gregory David,28,0,30,2
1649976131445,MATH 10A,A03,083737,Patchell; Gregory David,27,0,30,3
1649976137473,MATH 10B,A01,083207,Staff,0,0,30,30
1649976137473,MATH 10B,A02,083208,Staff,20,0,30,10
1649976137473,MATH 10B,B01,083739,Staff,24,0,30,6
1649976137473,MATH 10B,B02,083740,Staff,30,0,30,0
1649976143499,MATH 18,A01,083743,Staff,21,0,30,9
1649976143499,MATH 18,A02,083744,Staff,29,0,30,1
1649976143499,MATH 18,A03,083745,Staff,27,0,30,3
1649976143499,MATH 18,A04,083746,Staff,28,0,30,2
1649976143499,MATH 18,B01,083748,Staff,0,1,30,30
1649976143499,MATH 18,B02,083749,Staff,1,0,30,29
1649976143499,MATH 18,B03,083750,Staff,22,0,30,8
1649976143499,MATH 18,B04,083751,Staff,15,0,30,15
1649976149530,MATH 20A,A01,083754,Staff,31,0,40,9
1649976155562,MATH 20B,A01,083756,Staff,9,0,30,21
1649976155562,MATH 20B,A02,083757,Staff,26,0,30,4
1649976161598,MATH 20C,A01,083760,Staff,6,0,30,24
1649976161598,MATH 20C,A02,083761,Staff,3,0,30,27
1649976161598,MATH 20C,B01,083762,Staff,24,0,30,6
1649976161598,MATH 20C,B02,083763,Staff,30,0,30,0
1649976167648,MATH 20D,A01,083765,Staff,3,0,30,27
1649976167648,MATH 20D,A02,083766,Staff,27,0,30,3
1649976167648,MATH 20D,A03,083767,Staff,28,0,30,2
1649976173673,MATH 20E,A01,083771,Staff,11,0,30,19
1649976173673,MATH 20E,A02,083772,Staff,21,0,30,9
1649976173673,MATH 20E,B01,083773,Staff,5,0,30,25
1649976173673,MATH 20E,B02,083774,Staff,27,0,30,3
1649976179698,MATH 103A,A01,083777,Staff,1,5,30,29
1649976179698,MATH 103A,A02,083778,Staff,0,4,30,30
1649976179698,MATH 103A,B01,083779,Staff,0,5,30,30
1649976179698,MATH 103A,B02,083780,Staff,0,4,30,30
1649976185731,MATH 105,A01,085443,Staff,0,10,30,30
1649976191760,MATH 109,A01,083213,Anzaldo; Leesa B,0,3,30,30
1649976191760,MATH 109,A02,083214,Anzaldo; Leesa B,0,1,30,30
1649976191760,MATH 109,B01,083215,Anzaldo; Leesa B,14,0,30,16
1649976191760,MATH 109,B02,083216,Anzaldo; Leesa B,1,0,30,29
1649976197788,MATH 142A,A01,083219,Chow; Bennett,0,5,30,30
1649976197788,MATH 142A,A02,083220,Chow; Bennett,0,3,30,30
1649976197788,MATH 142A,B01,083221,Chow; Bennett,0,4,30,30
1649976197788,MATH 142A,B02,083222,Chow; Bennett,0,3,30,30
1649976203813,MATH 193A,A01,083224,Staff,0,5,30,30
1649976203813,MATH 193A,A02,083225,Staff,0,4,30,30
1649976203813,MATH 193A,A03,083781,Staff,1,0,30,29
1649976203813,MATH 193A,A04,083782,Staff,13,0,30,17
1649976209854,MATH 197,001,091859,McAuley; Julian John,9999,0,9999,0
1649976215999,COGS 9,A01,083615,Staff,0,5,60,60
1649976222023,COGS 11,A01,083617,Boyle; Mary E. T.,30,0,40,10
1649976228056,COGS 13,A01,083071,Staff,0,24,40,40
1649976234078,COGS 14A,A01,092681,Staff,27,0,100,73
1649976240107,COGS 14B,A01,083073,Cheng; Tzu-Han,9,0,50,41
1649976246132,COGS 17,A01,092677,Staff,50,0,75,25
1649976252162,COGS 100,A01,083619,Staff,1,15,60,59
1649976258183,COGS 101A,A01,083621,Davis; Joshua Daniel,0,16,60,60
1649976264213,COGS 101B,A01,091572,Staff,22,0,60,38
1649976270241,COGS 101C,A01,083625,Delgado; Tania,22,0,30,8
1649976276265,COGS 107A,A01,083627,Boyle; Mary E. T.,0,1,60,60
1649976282298,COGS 118A,A01,083075,Staff,21,0,60,39
1649976288329,CSE 3,A50,083646,Miranda; Gregory Joseph,22,0,38,16
1649976288329,CSE 3,A51,083647,Miranda; Gregory Joseph,37,0,37,0
1649976294373,CSE 8A,A50,083650,Miranda; Gregory Joseph,2,8,40,38
1649976300400,CSE 11,A01,083080,Cao; Yingjun,0,43,40,40
1649976306421,CSE 12,A01,083652,Staff,28,0,100,72
1649976312457,CSE 15L,A01,083654,Staff,0,0,50,50
1649976312457,CSE 15L,A02,083655,Staff,37,0,50,13
1649976318482,CSE 20,A01,083657,Staff,61,0,80,19
1649976324505,CSE 30,A01,083084,Eldon; John,0,49,40,40
1649976330529,CSE 100,A01,083659,Cao; Yingjun,1,49,50,49
1649976336557,CSE 134B,A01,083661,Powell; Thomas Allan,0,25,65,65
1649976342583,CSE 140,A01,083663,Staff,11,0,75,64
1649976348605,CSE 140L,A01,083088,Eldon; John,7,0,75,68
1649976354631,CSE 175,A01,083665,Kumar; Rakesh,10,0,25,15
1649976360661,CSE 190,A00,092507,Dubnov; Shlomo,17,0,20,3
1649976366687,ECE 45,A01,083139,Staff,0,6,40,40
1649976372712,ECE 65,A50,083695,Staff,2,0,30,28
1649976378747,ECE 109,A01,091882,Touri; Behrouz,51,0,70,19
1649976384775,ECE 180,A00,083140,Abi Samra; Nicholas Camill,26,0,30,4
1649976384775,ECE 180,B00,083141,Abi Samra; Nicholas Camill,10,0,30,20
1649976390799,MATH 10A,A01,083735,Patchell; Gregory David,18,0,30,12
1649976390799,MATH 10A,A02,083736,Patchell; Gregory David,28,0,30,2
1649976390799,MATH 10A,A03,083737,Patchell; Gregory David,27,0,30,3
1649976396829,MATH 10B,A01,083207,Staff,0,0,30,30
1649976396829,MATH 10B,A02,083208,Staff,20,0,30,10
1649976396829,MATH 10B,B01,083739,Staff,24,0,30,6
1649976396829,MATH 10B,B02,083740,Staff,30,0,30,0
1649976402862,MATH 18,A01,083743,Staff,21,0,30,9
1649976402862,MATH 18,A02,083744,Staff,29,0,30,1
1649976402862,MATH 18,A03,083745,Staff,27,0,30,3
1649976402862,MATH 18,A04,083746,Staff,28,0,30,2
1649976402862,MATH 18,B01,083748,Staff,0,1,30,30
1649976402862,MATH 18,B02,083749,Staff,0,0,30,30
1649976402862,MATH 18,B03,083750,Staff,22,0,30,8
1649976402862,MATH 18,B04,083751,Staff,14,0,30,16
1649976408894,MATH 20A,A01,083754,Staff,31,0,40,9
1649976414921,MATH 20B,A01,083756,Staff,9,0,30,21
1649976414921,MATH 20B,A02,083757,Staff,26,0,30,4
1649976420948,MATH 20C,A01,083760,Staff,6,0,30,24
1649976420948,MATH 20C,A02,083761,Staff,3,0,30,27
1649976420948,MATH 20C,B01,083762,Staff,24,0,30,6
1649976420948,MATH 20C,B02,083763,Staff,30,0,30,0
1649976426972,MATH 20D,A01,083765,Staff,3,0,30,27
1649976426972,MATH 20D,A02,083766,Staff,27,0,30,3
1649976426972,MATH 20D,A03,083767,Staff,28,0,30,2
1649976432997,MATH 20E,A01,083771,Staff,11,0,30,19
1649976432997,MATH 20E,A02,083772,Staff,21,0,30,9
1649976432997,MATH 20E,B01,083773,Staff,5,0,30,25
1649976432997,MATH 20E,B02,083774,Staff,27,0,30,3
1649976439020,MATH 103A,A01,083777,Staff,1,5,30,29
1649976439020,MATH 103A,A02,083778,Staff,0,4,30,30
1649976439020,MATH 103A,B01,083779,Staff,0,5,30,30
1649976439020,MATH 103A,B02,083780,Staff,0,4,30,30
1649976445049,MATH 105,A01,085443,Staff,0,10,30,30
1649976451072,MATH 109,A01,083213,Anzaldo; Leesa B,0,3,30,30
1649976451072,MATH 109,A02,083214,Anzaldo; Leesa B,0,1,30,30
1649976451072,MATH 109,B01,083215,Anzaldo; Leesa B,14,0,30,16
1649976451072,MATH 109,B02,083216,Anzaldo; Leesa B,1,0,30,29
1649976457099,MATH 142A,A01,083219,Chow; Bennett,0,5,30,30
1649976457099,MATH 142A,A02,083220,Chow; Bennett,0,3,30,30
1649976457099,MATH 142A,B01,083221,Chow; Bennett,0,4,30,30
1649976457099,MATH 142A,B02,083222,Chow; Bennett,0,3,30,30
1649976463124,MATH 193A,A01,083224,Staff,0,5,30,30
1649976463124,MATH 193A,A02,083225,Staff,0,4,30,30
1649976463124,MATH 193A,A03,083781,Staff,1,0,30,29
1649976463124,MATH 193A,A04,083782,Staff,13,0,30,17
1649976469153,MATH 197,001,091859,McAuley; Julian John,9999,0,9999,0
1649976475204,COGS 9,A01,083615,Staff,0,5,60,60
1649976481229,COGS 11,A01,083617,Boyle; Mary E. T.,30,0,40,10
1649976487267,COGS 13,A01,083071,Staff,0,24,40,40
1649976493294,COGS 14A,A01,092681,Staff,27,0,100,73
1649976499323,COGS 14B,A01,083073,Cheng; Tzu-Han,9,0,50,41
1649976505346,COGS 17,A01,092677,Staff,50,0,75,25
1649976511371,COGS 100,A01,083619,Staff,1,15,60,59
1649976517400,COGS 101A,A01,083621,Davis; Joshua Daniel,0,16,60,60
1649976523431,COGS 101B,A01,091572,Staff,22,0,60,38
1649976529466,COGS 101C,A01,083625,Delgado; Tania,22,0,30,8
1649976535498,COGS 107A,A01,083627,Boyle; Mary E. T.,0,1,60,60
1649976541523,COGS 118A,A01,083075,Staff,21,0,60,39
1649976547555,CSE 3,A50,083646,Miranda; Gregory Joseph,22,0,38,16
1649976547555,CSE 3,A51,083647,Miranda; Gregory Joseph,37,0,37,0
1649976553582,CSE 8A,A50,083650,Miranda; Gregory Joseph,2,8,40,38
1649976559607,CSE 11,A01,083080,Cao; Yingjun,0,43,40,40
1649976565652,CSE 12,A01,083652,Staff,28,0,100,72
1649976571675,CSE 15L,A01,083654,Staff,0,0,50,50
1649976571675,CSE 15L,A02,083655,Staff,37,0,50,13
1649976577698,CSE 20,A01,083657,Staff,61,0,80,19
1649976583722,CSE 30,A01,083084,Eldon; John,0,49,40,40
1649976589756,CSE 100,A01,083659,Cao; Yingjun,1,49,50,49
1649976595789,CSE 134B,A01,083661,Powell; Thomas Allan,0,25,65,65
1649976601818,CSE 140,A01,083663,Staff,11,0,75,64
1649976607840,CSE 140L,A01,083088,Eldon; John,7,0,75,68
1649976613865,CSE 175,A01,083665,Kumar; Rakesh,10,0,25,15
1649976619888,CSE 190,A00,092507,Dubnov; Shlomo,17,0,20,3
1649976625914,ECE 45,A01,083139,Staff,0,6,40,40
1649976631940,ECE 65,A50,083695,Staff,2,0,30,28
1649976637971,ECE 109,A01,091882,Touri; Behrouz,51,0,70,19
1649976644015,ECE 180,A00,083140,Abi Samra; Nicholas Camill,26,0,30,4
1649976644015,ECE 180,B00,083141,Abi Samra; Nicholas Camill,10,0,30,20
1649976650043,MATH 10A,A01,083735,Patchell; Gregory David,18,0,30,12
1649976650043,MATH 10A,A02,083736,Patchell; Gregory David,28,0,30,2
1649976650043,MATH 10A,A03,083737,Patchell; Gregory David,27,0,30,3
1649976656066,MATH 10B,A01,083207,Staff,0,0,30,30
1649976656066,MATH 10B,A02,083208,Staff,20,0,30,10
1649976656066,MATH 10B,B01,083739,Staff,24,0,30,6
1649976656066,MATH 10B,B02,083740,Staff,30,0,30,0
1649976662101,MATH 18,A01,083743,Staff,21,0,30,9
1649976662101,MATH 18,A02,083744,Staff,29,0,30,1
1649976662101,MATH 18,A03,083745,Staff,27,0,30,3
1649976662101,MATH 18,A04,083746,Staff,28,0,30,2
1649976662101,MATH 18,B01,083748,Staff,0,1,30,30
1649976662101,MATH 18,B02,083749,Staff,0,0,30,30
1649976662101,MATH 18,B03,083750,Staff,21,0,30,9
1649976662101,MATH 18,B04,083751,Staff,14,0,30,16
1649976668132,MATH 20A,A01,083754,Staff,31,0,40,9
1649976674160,MATH 20B,A01,083756,Staff,9,0,30,21
1649976674160,MATH 20B,A02,083757,Staff,26,0,30,4
1649976680186,MATH 20C,A01,083760,Staff,6,0,30,24
1649976680186,MATH 20C,A02,083761,Staff,3,0,30,27
1649976680186,MATH 20C,B01,083762,Staff,24,0,30,6
1649976680186,MATH 20C,B02,083763,Staff,30,0,30,0
1649976686210,MATH 20D,A01,083765,Staff,3,0,30,27
1649976686210,MATH 20D,A02,083766,Staff,27,0,30,3
1649976686210,MATH 20D,A03,083767,Staff,28,0,30,2
1649976692250,MATH 20E,A01,083771,Staff,11,0,30,19
1649976692250,MATH 20E,A02,083772,Staff,21,0,30,9
1649976692250,MATH 20E,B01,083773,Staff,4,0,30,26
1649976692250,MATH 20E,B02,083774,Staff,27,0,30,3
1649976698276,MATH 103A,A01,083777,Staff,1,5,30,29
1649976698276,MATH 103A,A02,083778,Staff,0,5,30,30
1649976698276,MATH 103A,B01,083779,Staff,0,5,30,30
1649976698276,MATH 103A,B02,083780,Staff,0,4,30,30
1649976704302,MATH 105,A01,085443,Staff,0,10,30,30
1649976710332,MATH 109,A01,083213,Anzaldo; Leesa B,0,3,30,30
1649976710332,MATH 109,A02,083214,Anzaldo; Leesa B,0,1,30,30
1649976710332,MATH 109,B01,083215,Anzaldo; Leesa B,13,0,30,17
1649976710332,MATH 109,B02,083216,Anzaldo; Leesa B,1,0,30,29
1649976716369,MATH 142A,A01,083219,Chow; Bennett,0,5,30,30
1649976716369,MATH 142A,A02,083220,Chow; Bennett,0,3,30,30
1649976716369,MATH 142A,B01,083221,Chow; Bennett,0,4,30,30
1649976716369,MATH 142A,B02,083222,Chow; Bennett,0,3,30,30
1649976722393,MATH 193A,A01,083224,Staff,0,5,30,30
1649976722393,MATH 193A,A02,083225,Staff,0,4,30,30
1649976722393,MATH 193A,A03,083781,Staff,1,0,30,29
1649976722393,MATH 193A,A04,083782,Staff,13,0,30,17
1649976728427,MATH 197,001,091859,McAuley; Julian John,9999,0,9999,0
1649976734491,COGS 9,A01,083615,Staff,0,5,60,60
1649976740514,COGS 11,A01,083617,Boyle; Mary E. T.,30,0,40,10
1649976746542,COGS 13,A01,083071,Staff,0,24,40,40
1649976752568,COGS 14A,A01,092681,Staff,26,0,100,74
1649976758592,COGS 14B,A01,083073,Cheng; Tzu-Han,9,0,50,41
1649976764625,COGS 17,A01,092677,Staff,50,0,75,25
1649976770652,COGS 100,A01,083619,Staff,1,15,60,59
1649976776679,COGS 101A,A01,083621,Davis; Joshua Daniel,0,16,60,60
1649976782703,COGS 101B,A01,091572,Staff,22,0,60,38
1649976788735,COGS 101C,A01,083625,Delgado; Tania,22,0,30,8
1649976794764,COGS 107A,A01,083627,Boyle; Mary E. T.,0,1,60,60
1649976800795,COGS 118A,A01,083075,Staff,21,0,60,39
1649976806822,CSE 3,A50,083646,Miranda; Gregory Joseph,22,0,38,16
1649976806822,CSE 3,A51,083647,Miranda; Gregory Joseph,37,0,37,0
1649976812922,CSE 8A,A50,083650,Miranda; Gregory Joseph,2,8,40,38
1649976818951,CSE 11,A01,083080,Cao; Yingjun,0,43,40,40
1649976824981,CSE 12,A01,083652,Staff,27,0,100,73
1649976831006,CSE 15L,A01,083654,Staff,0,0,50,50
1649976831006,CSE 15L,A02,083655,Staff,36,0,50,14
1649976837045,CSE 20,A01,083657,Staff,61,0,80,19
1649976843074,CSE 30,A01,083084,Eldon; John,0,50,40,40
1649976849099,CSE 100,A01,083659,Cao; Yingjun,1,49,50,49
1649976855123,CSE 134B,A01,083661,Powell; Thomas Allan,0,25,65,65
1649976861147,CSE 140,A01,083663,Staff,11,0,75,64
1649976867170,CSE 140L,A01,083088,Eldon; John,7,0,75,68
1649976873192,CSE 175,A01,083665,Kumar; Rakesh,10,0,25,15
1649976879223,CSE 190,A00,092507,Dubnov; Shlomo,17,0,20,3
1649976885247,ECE 45,A01,083139,Staff,0,6,40,40
1649976891270,ECE 65,A50,083695,Staff,2,0,30,28
1649976897305,ECE 109,A01,091882,Touri; Behrouz,51,0,70,19
1649976903332,ECE 180,A00,083140,Abi Samra; Nicholas Camill,26,0,30,4
1649976903332,ECE 180,B00,083141,Abi Samra; Nicholas Camill,10,0,30,20
1649976909358,MATH 10A,A01,083735,Patchell; Gregory David,18,0,30,12
1649976909358,MATH 10A,A02,083736,Patchell; Gregory David,28,0,30,2
1649976909358,MATH 10A,A03,083737,Patchell; Gregory David,27,0,30,3
1649976915382,MATH 10B,A01,083207,Staff,0,0,30,30
1649976915382,MATH 10B,A02,083208,Staff,20,0,30,10
1649976915382,MATH 10B,B01,083739,Staff,24,0,30,6
1649976915382,MATH 10B,B02,083740,Staff,30,0,30,0
1649976921424,MATH 18,A01,083743,Staff,21,0,30,9
1649976921424,MATH 18,A02,083744,Staff,29,0,30,1
1649976921424,MATH 18,A03,083745,Staff,27,0,30,3
1649976921424,MATH 18,A04,083746,Staff,27,0,30,3
1649976921424,MATH 18,B01,083748,Staff,0,1,30,30
1649976921424,MATH 18,B02,083749,Staff,0,0,30,30
1649976921424,MATH 18,B03,083750,Staff,21,0,30,9
1649976921424,MATH 18,B04,083751,Staff,14,0,30,16
1649976927451,MATH 20A,A01,083754,Staff,31,0,40,9
1649976933488,MATH 20B,A01,083756,Staff,9,0,30,21
1649976933488,MATH 20B,A02,083757,Staff,26,0,30,4
1649976939520,MATH 20C,A01,083760,Staff,5,0,30,25
1649976939520,MATH 20C,A02,083761,Staff,2,0,30,28
1649976939520,MATH 20C,B01,083762,Staff,24,0,30,6
1649976939520,MATH 20C,B02,083763,Staff,30,0,30,0
1649976945543,MATH 20D,A01,083765,Staff,3,0,30,27
1649976945543,MATH 20D,A02,083766,Staff,27,0,30,3
1649976945543,MATH 20D,A03,083767,Staff,28,0,30,2
1649976951567,MATH 20E,A01,083771,Staff,11,0,30,19
1649976951567,MATH 20E,A02,083772,Staff,21,0,30,9
1649976951567,MATH 20E,B01,083773,Staff,4,0,30,26
1649976951567,MATH 20E,B02,083774,Staff,27,0,30,3
1649976957591,MATH 103A,A01,083777,Staff,1,5,30,29
1649976957591,MATH 103A,A02,083778,Staff,0,5,30,30
1649976957591,MATH 103A,B01,083779,Staff,0,5,30,30
1649976957591,MATH 103A,B02,083780,Staff,0,4,30,30
1649976963618,MATH 105,A01,085443,Staff,0,10,30,30
1649976969646,MATH 109,A01,083213,Anzaldo; Leesa B,0,3,30,30
1649976969646,MATH 109,A02,083214,Anzaldo; Leesa B,0,1,30,30
1649976969646,MATH 109,B01,083215,Anzaldo; Leesa B,12,0,30,18
1649976969646,MATH 109,B02,083216,Anzaldo; Leesa B,1,0,30,29
1649976975676,MATH 142A,A01,083219,Chow; Bennett,0,5,30,30
1649976975676,MATH 142A,A02,083220,Chow; Bennett,0,3,30,30
1649976975676,MATH 142A,B01,083221,Chow; Bennett,0,4,30,30
1649976975676,MATH 142A,B02,083222,Chow; Bennett,0,4,30,30
1649976981698,MATH 193A,A01,083224,Staff,0,5,30,30
1649976981698,MATH 193A,A02,083225,Staff,0,4,30,30
1649976981698,MATH 193A,A03,083781,Staff,1,0,30,29
1649976981698,MATH 193A,A04,083782,Staff,13,0,30,17
1649976987721,MATH 197,001,091859,McAuley; Julian John,9999,0,9999,0
1649976993773,COGS 9,A01,083615,Staff,0,5,60,60
1649976999808,COGS 11,A01,083617,Boyle; Mary E. T.,30,0,40,10
1649977005837,COGS 13,A01,083071,Staff,0,24,40,40
1649977011869,COGS 14A,A01,092681,Staff,26,0,100,74
1649977017904,COGS 14B,A01,083073,Cheng; Tzu-Han,8,0,50,42
1649977023932,COGS 17,A01,092677,Staff,50,0,75,25
1649977029969,COGS 100,A01,083619,Staff,1,15,60,59
1649977036002,COGS 101A,A01,083621,Davis; Joshua Daniel,0,16,60,60
1649977042028,COGS 101B,A01,091572,Staff,22,0,60,38
1649977048052,COGS 101C,A01,083625,Delgado; Tania,22,0,30,8
1649977054082,COGS 107A,A01,083627,Boyle; Mary E. T.,0,1,60,60
1649977060105,COGS 118A,A01,083075,Staff,21,0,60,39
1649977066131,CSE 3,A50,083646,Miranda; Gregory Joseph,22,0,38,16
1649977066131,CSE 3,A51,083647,Miranda; Gregory Joseph,37,0,37,0
1649977072161,CSE 8A,A50,083650,Miranda; Gregory Joseph,2,8,40,38
1649977078193,CSE 11,A01,083080,Cao; Yingjun,0,43,40,40
1649977084224,CSE 12,A01,083652,Staff,27,0,100,73
1649977090248,CSE 15L,A01,083654,Staff,0,0,50,50
1649977090248,CSE 15L,A02,083655,Staff,36,0,50,14
1649977096272,CSE 20,A01,083657,Staff,61,0,80,19
1649977102325,CSE 30,A01,083084,Eldon; John,0,50,40,40
1649977108360,CSE 100,A01,083659,Cao; Yingjun,1,50,50,49
1649977114396,CSE 134B,A01,083661,Powell; Thomas Allan,0,25,65,65
1649977120427,CSE 140,A01,083663,Staff,11,0,75,64
1649977126451,CSE 140L,A01,083088,Eldon; John,7,0,75,68
1649977132476,CSE 175,A01,083665,Kumar; Rakesh,10,0,25,15
1649977138498,CSE 190,A00,092507,Dubnov; Shlomo,17,0,20,3
1649977144528,ECE 45,A01,083139,Staff,0,6,40,40
1649977150551,ECE 65,A50,083695,Staff,2,0,30,28
1649977156577,ECE 109,A01,091882,Touri; Behrouz,51,0,70,19
1649977162604,ECE 180,A00,083140,Abi Samra; Nicholas Camill,26,0,30,4
1649977162604,ECE 180,B00,083141,Abi Samra; Nicholas Camill,10,0,30,20
1649977168640,MATH 10A,A01,083735,Patchell; Gregory David,18,0,30,12
1649977168640,MATH 10A,A02,083736,Patchell; Gregory David,28,0,30,2
1649977168640,MATH 10A,A03,083737,Patchell; Gregory David,27,0,30,3
1649977174675,MATH 10B,A01,083207,Staff,0,0,30,30
1649977174675,MATH 10B,A02,083208,Staff,20,0,30,10
1649977174675,MATH 10B,B01,083739,Staff,24,0,30,6
1649977174675,MATH 10B,B02,083740,Staff,30,0,30,0
1649977180704,MATH 18,A01,083743,Staff,21,0,30,9
1649977180704,MATH 18,A02,083744,Staff,29,0,30,1
1649977180704,MATH 18,A03,083745,Staff,26,0,30,4
1649977180704,MATH 18,A04,083746,Staff,27,0,30,3
1649977180704,MATH 18,B01,083748,Staff,0,1,30,30
1649977180704,MATH 18,B02,083749,Staff,0,0,30,30
1649977180704,MATH 18,B03,083750,Staff,21,0,30,9
1649977180704,MATH 18,B04,083751,Staff,14,0,30,16
1649977186732,MATH 20A,A01,083754,Staff,31,0,40,9
1649977192756,MATH 20B,A01,083756,Staff,8,0,30,22
1649977192756,MATH 20B,A02,083757,Staff,26,0,30,4
1649977198778,MATH 20C,A01,083760,Staff,5,0,30,25
1649977198778,MATH 20C,A02,083761,Staff,2,0,30,28
1649977198778,MATH 20C,B01,083762,Staff,24,0,30,6
1649977198778,MATH 20C,B02,083763,Staff,30,0,30,0
1649977204802,MATH 20D,A01,083765,Staff,3,0,30,27
1649977204802,MATH 20D,A02,083766,Staff,27,0,30,3
1649977204802,MATH 20D,A03,083767,Staff,28,0,30,2
1649977210836,MATH 20E,A01,083771,Staff,11,0,30,19
1649977210836,MATH 20E,A02,083772,Staff,21,0,30,9
1649977210836,MATH 20E,B01,083773,Staff,4,0,30,26
1649977210836,MATH 20E,B02,083774,Staff,27,0,30,3
1649977216865,MATH 103A,A01,083777,Staff,1,5,30,29
1649977216865,MATH 103A,A02,083778,Staff,0,5,30,30
1649977216865,MATH 103A,B01,083779,Staff,0,5,30,30
1649977216865,MATH 103A,B02,083780,Staff,0,4,30,30
1649977222890,MATH 105,A01,085443,Staff,0,10,30,30
1649977228913,MATH 109,A01,083213,Anzaldo; Leesa B,0,3,30,30
1649977228913,MATH 109,A02,083214,Anzaldo; Leesa B,0,1,30,30
1649977228913,MATH 109,B01,083215,Anzaldo; Leesa B,13,0,30,17
1649977228913,MATH 109,B02,083216,Anzaldo; Leesa B,0,0,30,30
1649977234941,MATH 142A,A01,083219,Chow; Bennett,0,5,30,30
1649977234941,MATH 142A,A02,083220,Chow; Bennett,0,3,30,30
1649977234941,MATH 142A,B01,083221,Chow; Bennett,0,4,30,30
1649977234941,MATH 142A,B02,083222,Chow; Bennett,0,4,30,30
1649977240963,MATH 193A,A01,083224,Staff,0,5,30,30
1649977240963,MATH 193A,A02,083225,Staff,0,4,30,30
1649977240963,MATH 193A,A03,083781,Staff,1,0,30,29
1649977240963,MATH 193A,A04,083782,Staff,13,0,30,17
1649977246991,MATH 197,001,091859,McAuley; Julian John,9999,0,9999,0
1649977253041,COGS 9,A01,083615,Staff,0,5,60,60
1649977259080,COGS 11,A01,083617,Boyle; Mary E. T.,29,0,40,11
1649977265105,COGS 13,A01,083071,Staff,0,24,40,40
1649977271133,COGS 14A,A01,092681,Staff,26,0,100,74
1649977277160,COGS 14B,A01,083073,Cheng; Tzu-Han,8,0,50,42
1649977283192,COGS 17,A01,092677,Staff,50,0,75,25
1649977289233,COGS 100,A01,083619,Staff,1,15,60,59
1649977295266,COGS 101A,A01,083621,Davis; Joshua Daniel,0,16,60,60
1649977301312,COGS 101B,A01,091572,Staff,22,0,60,38
1649977307334,COGS 101C,A01,083625,Delgado; Tania,22,0,30,8
1649977313369,COGS 107A,A01,083627,Boyle; Mary E. T.,0,1,60,60
1649977319404,COGS 118A,A01,083075,Staff,21,0,60,39
1649977325430,CSE 3,A50,083646,Miranda; Gregory Joseph,22,0,38,16
1649977325430,CSE 3,A51,083647,Miranda; Gregory Joseph,37,0,37,0
1649977331459,CSE 8A,A50,083650,Miranda; Gregory Joseph,2,8,40,38
1649977337483,CSE 11,A01,083080,Cao; Yingjun,0,43,40,40
1649977343509,CSE 12,A01,083652,Staff,26,0,100,74
1649977349536,CSE 15L,A01,083654,Staff,0,0,50,50
1649977349536,CSE 15L,A02,083655,Staff,35,0,50,15
1649977355560,CSE 20,A01,083657,Staff,61,0,80,19
1649977361587,CSE 30,A01,083084,Eldon; John,0,50,40,40
1649977367610,CSE 100,A01,083659,Cao; Yingjun,1,50,50,49
1649977373634,CSE 134B,A01,083661,Powell; Thomas Allan,0,25,65,65
1649977379658,CSE 140,A01,083663,Staff,11,0,75,64
1649977385686,CSE 140L,A01,083088,Eldon; John,7,0,75,68
1649977391713,CSE 175,A01,083665,Kumar; Rakesh,10,0,25,15
1649977397743,CSE 190,A00,092507,Dubnov; Shlomo,17,0,20,3
1649977403765,ECE 45,A01,083139,Staff,0,6,40,40
1649977409863,ECE 65,A50,083695,Staff,2,0,30,28
1649977415887,ECE 109,A01,091882,Touri; Behrouz,51,0,70,19
1649977421918,ECE 180,A00,083140,Abi Samra; Nicholas Camill,26,0,30,4
1649977421918,ECE 180,B00,083141,Abi Samra; Nicholas Camill,10,0,30,20
1649977427940,MATH 10A,A01,083735,Patchell; Gregory David,18,0,30,12
1649977427940,MATH 10A,A02,083736,Patchell; Gregory David,28,0,30,2
1649977427940,MATH 10A,A03,083737,Patchell; Gregory David,27,0,30,3
1649977433980,MATH 10B,A01,083207,Staff,0,0,30,30
1649977433980,MATH 10B,A02,083208,Staff,20,0,30,10
1649977433980,MATH 10B,B01,083739,Staff,24,0,30,6
1649977433980,MATH 10B,B02,083740,Staff,30,0,30,0
1649977440006,MATH 18,A01,083743,Staff,21,0,30,9
1649977440006,MATH 18,A02,083744,Staff,29,0,30,1
1649977440006,MATH 18,A03,083745,Staff,26,0,30,4
1649977440006,MATH 18,A04,083746,Staff,27,0,30,3
1649977440006,MATH 18,B01,083748,Staff,0,1,30,30
1649977440006,MATH 18,B02,083749,Staff,0,0,30,30
1649977440006,MATH 18,B03,083750,Staff,20,0,30,10
1649977440006,MATH 18,B04,083751,Staff,14,0,30,16
1649977446037,MATH 20A,A01,083754,Staff,31,0,40,9
1649977452069,MATH 20B,A01,083756,Staff,8,0,30,22
1649977452069,MATH 20B,A02,083757,Staff,26,0,30,4
1649977458102,MATH 20C,A01,083760,Staff,5,0,30,25
1649977458102,MATH 20C,A02,083761,Staff,2,0,30,28
1649977458102,MATH 20C,B01,083762,Staff,24,0,30,6
1649977458102,MATH 20C,B02,083763,Staff,30,0,30,0
1649977464126,MATH 20D,A01,083765,Staff,3,0,30,27
1649977464126,MATH 20D,A02,083766,Staff,27,0,30,3
1649977464126,MATH 20D,A03,083767,Staff,28,0,30,2
1649977470155,MATH 20E,A01,083771,Staff,11,0,30,19
1649977470155,MATH 20E,A02,083772,Staff,21,0,30,9
1649977470155,MATH 20E,B01,083773,Staff,4,0,30,26
1649977470155,MATH 20E,B02,083774,Staff,27,0,30,3
1649977476177,MATH 103A,A01,083777,Staff,1,5,30,29
1649977476177,MATH 103A,A02,083778,Staff,0,5,30,30
1649977476177,MATH 103A,B01,083779,Staff,0,5,30,30
1649977476177,MATH 103A,B02,083780,Staff,0,4,30,30
1649977482204,MATH 105,A01,085443,Staff,0,10,30,30
1649977488237,MATH 109,A01,083213,Anzaldo; Leesa B,0,3,30,30
1649977488237,MATH 109,A02,083214,Anzaldo; Leesa B,0,1,30,30
1649977488237,MATH 109,B01,083215,Anzaldo; Leesa B,13,0,30,17
1649977488237,MATH 109,B02,083216,Anzaldo; Leesa B,0,0,30,30
1649977494260,MATH 142A,A01,083219,Chow; Bennett,0,5,30,30
1649977494260,MATH 142A,A02,083220,Chow; Bennett,0,3,30,30
1649977494260,MATH 142A,B01,083221,Chow; Bennett,0,4,30,30
1649977494260,MATH 142A,B02,083222,Chow; Bennett,0,5,30,30
1649977500284,MATH 193A,A01,083224,Staff,0,5,30,30
1649977500284,MATH 193A,A02,083225,Staff,0,4,30,30
1649977500284,MATH 193A,A03,083781,Staff,1,0,30,29
1649977500284,MATH 193A,A04,083782,Staff,13,0,30,17
1649977506306,MATH 197,001,091859,McAuley; Julian John,9999,0,9999,0
1649977512364,COGS 9,A01,083615,Staff,0,6,60,60
1649977518387,COGS 11,A01,083617,Boyle; Mary E. T.,29,0,40,11
1649977524411,COGS 13,A01,083071,Staff,0,24,40,40
1649977530434,COGS 14A,A01,092681,Staff,25,0,100,75
1649977536478,COGS 14B,A01,083073,Cheng; Tzu-Han,8,0,50,42
1649977542509,COGS 17,A01,092677,Staff,50,0,75,25
1649977553734,COGS 100,A01,083619,Staff,1,15,60,59
1649977559756,COGS 101A,A01,083621,Davis; Joshua Daniel,0,16,60,60
1649977565783,COGS 101B,A01,091572,Staff,22,0,60,38
1649977571814,COGS 101C,A01,083625,Delgado; Tania,22,0,30,8
1649977577836,COGS 107A,A01,083627,Boyle; Mary E. T.,0,1,60,60
1649977583863,COGS 118A,A01,083075,Staff,21,0,60,39
1649977589887,CSE 3,A50,083646,Miranda; Gregory Joseph,22,0,38,16
1649977589887,CSE 3,A51,083647,Miranda; Gregory Joseph,37,0,37,0
1649977595926,CSE 8A,A50,083650,Miranda; Gregory Joseph,2,8,40,38
1649977601954,CSE 11,A01,083080,Cao; Yingjun,0,44,40,40
1649977607977,CSE 12,A01,083652,Staff,26,0,100,74
1649977614000,CSE 15L,A01,083654,Staff,0,0,50,50
1649977614000,CSE 15L,A02,083655,Staff,35,0,50,15
1649977620024,CSE 20,A01,083657,Staff,61,0,80,19
1649977626046,CSE 30,A01,083084,Eldon; John,0,49,40,40
1649977632074,CSE 100,A01,083659,Cao; Yingjun,1,51,50,49
1649977638097,CSE 134B,A01,083661,Powell; Thomas Allan,0,25,65,65
1649977644126,CSE 140,A01,083663,Staff,11,0,75,64
1649977650150,CSE 140L,A01,083088,Eldon; John,7,0,75,68
1649977656173,CSE 175,A01,083665,Kumar; Rakesh,10,0,25,15
1649977662200,CSE 190,A00,092507,Dubnov; Shlomo,17,0,20,3
1649977668231,ECE 45,A01,083139,Staff,0,6,40,40
1649977674254,ECE 65,A50,083695,Staff,2,0,30,28
1649977680283,ECE 109,A01,091882,Touri; Behrouz,51,0,70,19
1649977686313,ECE 180,A00,083140,Abi Samra; Nicholas Camill,26,0,30,4
1649977686313,ECE 180,B00,083141,Abi Samra; Nicholas Camill,10,0,30,20
1649977692340,MATH 10A,A01,083735,Patchell; Gregory David,18,0,30,12
1649977692340,MATH 10A,A02,083736,Patchell; Gregory David,28,0,30,2
1649977692340,MATH 10A,A03,083737,Patchell; Gregory David,27,0,30,3
1649977698365,MATH 10B,A01,083207,Staff,0,0,30,30
1649977698365,MATH 10B,A02,083208,Staff,20,0,30,10
1649977698365,MATH 10B,B01,083739,Staff,24,0,30,6
1649977698365,MATH 10B,B02,083740,Staff,30,0,30,0
1649977704394,MATH 18,A01,083743,Staff,21,0,30,9
1649977704394,MATH 18,A02,083744,Staff,29,0,30,1
1649977704394,MATH 18,A03,083745,Staff,26,0,30,4
1649977704394,MATH 18,A04,083746,Staff,27,0,30,3
1649977704394,MATH 18,B01,083748,Staff,0,1,30,30
1649977704394,MATH 18,B02,083749,Staff,0,0,30,30
1649977704394,MATH 18,B03,083750,Staff,20,0,30,10
1649977704394,MATH 18,B04,083751,Staff,14,0,30,16
1649977710419,MATH 20A,A01,083754,Staff,31,0,40,9
1649977716451,MATH 20B,A01,083756,Staff,8,0,30,22
1649977716451,MATH 20B,A02,083757,Staff,26,0,30,4
1649977722476,MATH 20C,A01,083760,Staff,5,0,30,25
1649977722476,MATH 20C,A02,083761,Staff,2,0,30,28
1649977722476,MATH 20C,B01,083762,Staff,24,0,30,6
1649977722476,MATH 20C,B02,083763,Staff,30,0,30,0
1649977728503,MATH 20D,A01,083765,Staff,3,0,30,27
1649977728503,MATH 20D,A02,083766,Staff,27,0,30,3
1649977728503,MATH 20D,A03,083767,Staff,27,0,30,3
1649977734531,MATH 20E,A01,083771,Staff,11,0,30,19
1649977734531,MATH 20E,A02,083772,Staff,21,0,30,9
1649977734531,MATH 20E,B01,083773,Staff,3,0,30,27
1649977734531,MATH 20E,B02,083774,Staff,27,0,30,3
1649977740563,MATH 103A,A01,083777,Staff,1,5,30,29
1649977740563,MATH 103A,A02,083778,Staff,0,5,30,30
1649977740563,MATH 103A,B01,083779,Staff,0,5,30,30
1649977740563,MATH 103A,B02,083780,Staff,0,4,30,30
1649977746594,MATH 105,A01,085443,Staff,0,10,30,30
1649977752619,MATH 109,A01,083213,Anzaldo; Leesa B,0,3,30,30
1649977752619,MATH 109,A02,083214,Anzaldo; Leesa B,0,1,30,30
1649977752619,MATH 109,B01,083215,Anzaldo; Leesa B,13,0,30,17
1649977752619,MATH 109,B02,083216,Anzaldo; Leesa B,0,0,30,30
1649977758670,MATH 142A,A01,083219,Chow; Bennett,0,5,30,30
1649977758670,MATH 142A,A02,083220,Chow; Bennett,0,3,30,30
1649977758670,MATH 142A,B01,083221,Chow; Bennett,0,4,30,30
1649977758670,MATH 142A,B02,083222,Chow; Bennett,0,5,30,30
1649977764694,MATH 193A,A01,083224,Staff,0,5,30,30
1649977764694,MATH 193A,A02,083225,Staff,0,4,30,30
1649977764694,MATH 193A,A03,083781,Staff,1,0,30,29
1649977764694,MATH 193A,A04,083782,Staff,13,0,30,17
1649977770720,MATH 197,001,091859,McAuley; Julian John,9999,0,9999,0
1649977776767,COGS 9,A01,083615,Staff,0,6,60,60
1649977782792,COGS 11,A01,083617,Boyle; Mary E. T.,29,0,40,11
1649977788828,COGS 13,A01,083071,Staff,0,24,40,40
1649977794853,COGS 14A,A01,092681,Staff,25,0,100,75
1649977800888,COGS 14B,A01,083073,Cheng; Tzu-Han,8,0,50,42
1649977806925,COGS 17,A01,092677,Staff,50,0,75,25
1649977812959,COGS 100,A01,083619,Staff,1,15,60,59
1649977818983,COGS 101A,A01,083621,Davis; Joshua Daniel,0,16,60,60
1649977825011,COGS 101B,A01,091572,Staff,22,0,60,38
1649977831041,COGS 101C,A01,083625,Delgado; Tania,22,0,30,8
1649977837066,COGS 107A,A01,083627,Boyle; Mary E. T.,0,2,60,60
1649977843095,COGS 118A,A01,083075,Staff,21,0,60,39
1649977849123,CSE 3,A50,083646,Miranda; Gregory Joseph,22,0,38,16
1649977849123,CSE 3,A51,083647,Miranda; Gregory Joseph,37,0,37,0
1649977855148,CSE 8A,A50,083650,Miranda; Gregory Joseph,2,8,40,38
1649977861177,CSE 11,A01,083080,Cao; Yingjun,0,44,40,40
1649977867202,CSE 12,A01,083652,Staff,26,0,100,74
1649977873227,CSE 15L,A01,083654,Staff,0,0,50,50
1649977873227,CSE 15L,A02,083655,Staff,35,0,50,15
1649977879251,CSE 20,A01,083657,Staff,61,0,80,19
1649977885275,CSE 30,A01,083084,Eldon; John,0,50,40,40
1649977891306,CSE 100,A01,083659,Cao; Yingjun,1,51,50,49
1649977897330,CSE 134B,A01,083661,Powell; Thomas Allan,0,25,65,65
1649977903355,CSE 140,A01,083663,Staff,11,0,75,64
1649977909385,CSE 140L,A01,083088,Eldon; John,7,0,75,68
1649977915425,CSE 175,A01,083665,Kumar; Rakesh,10,0,25,15
1649977921459,CSE 190,A00,092507,Dubnov; Shlomo,17,0,20,3
1649977927482,ECE 45,A01,083139,Staff,0,6,40,40
1649977933508,ECE 65,A50,083695,Staff,2,0,30,28
1649977939540,ECE 109,A01,091882,Touri; Behrouz,51,0,70,19
1649977945576,ECE 180,A00,083140,Abi Samra; Nicholas Camill,26,0,30,4
1649977945576,ECE 180,B00,083141,Abi Samra; Nicholas Camill,10,0,30,20
1649977951602,MATH 10A,A01,083735,Patchell; Gregory David,17,0,30,13
1649977951602,MATH 10A,A02,083736,Patchell; Gregory David,28,0,30,2
1649977951602,MATH 10A,A03,083737,Patchell; Gregory David,27,0,30,3
1649977957626,MATH 10B,A01,083207,Staff,0,0,30,30
1649977957626,MATH 10B,A02,083208,Staff,20,0,30,10
1649977957626,MATH 10B,B01,083739,Staff,24,0,30,6
1649977957626,MATH 10B,B02,083740,Staff,30,0,30,0
1649977963655,MATH 18,A01,083743,Staff,20,0,30,10
1649977963655,MATH 18,A02,083744,Staff,29,0,30,1
1649977963655,MATH 18,A03,083745,Staff,26,0,30,4
1649977963655,MATH 18,A04,083746,Staff,27,0,30,3
1649977963655,MATH 18,B01,083748,Staff,0,1,30,30
1649977963655,MATH 18,B02,083749,Staff,0,0,30,30
1649977963655,MATH 18,B03,083750,Staff,20,0,30,10
1649977963655,MATH 18,B04,083751,Staff,11,0,30,19
1649977969685,MATH 20A,A01,083754,Staff,31,0,40,9
1649977975712,MATH 20B,A01,083756,Staff,8,0,30,22
1649977975712,MATH 20B,A02,083757,Staff,26,0,30,4
1649977981744,MATH 20C,A01,083760,Staff,5,0,30,25
1649977981744,MATH 20C,A02,083761,Staff,2,0,30,28
1649977981744,MATH 20C,B01,083762,Staff,24,0,30,6
1649977981744,MATH 20C,B02,083763,Staff,30,0,30,0
1649977987768,MATH 20D,A01,083765,Staff,3,0,30,27
1649977987768,MATH 20D,A02,083766,Staff,27,0,30,3
1649977987768,MATH 20D,A03,083767,Staff,28,0,30,2
1649977993800,MATH 20E,A01,083771,Staff,11,0,30,19
1649977993800,MATH 20E,A02,083772,Staff,21,0,30,9
1649977993800,MATH 20E,B01,083773,Staff,3,0,30,27
1649977993800,MATH 20E,B02,083774,Staff,27,0,30,3
1649977999825,MATH 103A,A01,083777,Staff,1,5,30,29
1649977999825,MATH 103A,A02,083778,Staff,0,5,30,30
1649977999825,MATH 103A,B01,083779,Staff,0,5,30,30
1649977999825,MATH 103A,B02,083780,Staff,0,4,30,30
1649978005853,MATH 105,A01,085443,Staff,0,10,30,30
1649978011986,MATH 109,A01,083213,Anzaldo; Leesa B,0,3,30,30
1649978011986,MATH 109,A02,083214,Anzaldo; Leesa B,0,1,30,30
1649978011986,MATH 109,B01,083215,Anzaldo; Leesa B,13,0,30,17
1649978011986,MATH 109,B02,083216,Anzaldo; Leesa B,0,0,30,30
1649978018017,MATH 142A,A01,083219,Chow; Bennett,0,5,30,30
1649978018017,MATH 142A,A02,083220,Chow; Bennett,0,3,30,30
1649978018017,MATH 142A,B01,083221,Chow; Bennett,0,4,30,30
1649978018017,MATH 142A,B02,083222,Chow; Bennett,0,5,30,30
1649978024043,MATH 193A,A01,083224,Staff,0,5,30,30
1649978024043,MATH 193A,A02,083225,Staff,0,4,30,30
1649978024043,MATH 193A,A03,083781,Staff,1,0,30,29
1649978024043,MATH 193A,A04,083782,Staff,13,0,30,17
1649978030067,MATH 197,001,091859,McAuley; Julian John,9999,0,9999,0
1649978036129,COGS 9,A01,083615,Staff,0,6,60,60
1649978042152,COGS 11,A01,083617,Boyle; Mary E. T.,29,0,40,11
1649978048176,COGS 13,A01,083071,Staff,0,24,40,40
1649978054202,COGS 14A,A01,092681,Staff,25,0,100,75
1649978060231,COGS 14B,A01,083073,Cheng; Tzu-Han,7,0,50,43
1649978066257,COGS 17,A01,092677,Staff,50,0,75,25
1649978072278,COGS 100,A01,083619,Staff,1,15,60,59
1649978078299,COGS 101A,A01,083621,Davis; Joshua Daniel,0,16,60,60
1649978084340,COGS 101B,A01,091572,Staff,22,0,60,38
1649978090362,COGS 101C,A01,083625,Delgado; Tania,22,0,30,8
1649978096396,COGS 107A,A01,083627,Boyle; Mary E. T.,0,2,60,60
1649978102421,COGS 118A,A01,083075,Staff,21,0,60,39
1649978108444,CSE 3,A50,083646,Miranda; Gregory Joseph,22,0,38,16
1649978108444,CSE 3,A51,083647,Miranda; Gregory Joseph,37,0,37,0
1649978114471,CSE 8A,A50,083650,Miranda; Gregory Joseph,2,8,40,38
1649978120497,CSE 11,A01,083080,Cao; Yingjun,0,45,40,40
1649978126520,CSE 12,A01,083652,Staff,26,0,100,74
1649978132546,CSE 15L,A01,083654,Staff,0,0,50,50
1649978132546,CSE 15L,A02,083655,Staff,35,0,50,15
1649978138579,CSE 20,A01,083657,Staff,61,0,80,19
1649978144603,CSE 30,A01,083084,Eldon; John,0,50,40,40
1649978150637,CSE 100,A01,083659,Cao; Yingjun,1,51,50,49
1649978156672,CSE 134B,A01,083661,Powell; Thomas Allan,0,25,65,65
1649978162701,CSE 140,A01,083663,Staff,11,0,75,64
1649978168725,CSE 140L,A01,083088,Eldon; John,7,0,75,68
1649978174748,CSE 175,A01,083665,Kumar; Rakesh,10,0,25,15
1649978180772,CSE 190,A00,092507,Dubnov; Shlomo,17,0,20,3
1649978186797,ECE 45,A01,083139,Staff,0,6,40,40
1649978192819,ECE 65,A50,083695,Staff,2,0,30,28
1649978198845,ECE 109,A01,091882,Touri; Behrouz,51,0,70,19
1649978204871,ECE 180,A00,083140,Abi Samra; Nicholas Camill,26,0,30,4
1649978204871,ECE 180,B00,083141,Abi Samra; Nicholas Camill,10,0,30,20
1649978210894,MATH 10A,A01,083735,Patchell; Gregory David,17,0,30,13
1649978210894,MATH 10A,A02,083736,Patchell; Gregory David,28,0,30,2
1649978210894,MATH 10A,A03,083737,Patchell; Gregory David,27,0,30,3
1649978216916,MATH 10B,A01,083207,Staff,0,0,30,30
1649978216916,MATH 10B,A02,083208,Staff,20,0,30,10
1649978216916,MATH 10B,B01,083739,Staff,24,0,30,6
1649978216916,MATH 10B,B02,083740,Staff,30,0,30,0
1649978222941,MATH 18,A01,083743,Staff,20,0,30,10
1649978222941,MATH 18,A02,083744,Staff,29,0,30,1
1649978222941,MATH 18,A03,083745,Staff,26,0,30,4
1649978222941,MATH 18,A04,083746,Staff,27,0,30,3
1649978222941,MATH 18,B01,083748,Staff,0,1,30,30
1649978222941,MATH 18,B02,083749,Staff,0,0,30,30
1649978222941,MATH 18,B03,083750,Staff,19,0,30,11
1649978222941,MATH 18,B04,083751,Staff,12,0,30,18
1649978228977,MATH 20A,A01,083754,Staff,31,0,40,9
1649978235000,MATH 20B,A01,083756,Staff,8,0,30,22
1649978235000,MATH 20B,A02,083757,Staff,26,0,30,4
1649978241024,MATH 20C,A01,083760,Staff,5,0,30,25
1649978241024,MATH 20C,A02,083761,Staff,2,0,30,28
1649978241024,MATH 20C,B01,083762,Staff,24,0,30,6
1649978241024,MATH 20C,B02,083763,Staff,30,0,30,0
1649978247051,MATH 20D,A01,083765,Staff,3,0,30,27
1649978247051,MATH 20D,A02,083766,Staff,27,0,30,3
1649978247051,MATH 20D,A03,083767,Staff,28,0,30,2
1649978253079,MATH 20E,A01,083771,Staff,11,0,30,19
1649978253079,MATH 20E,A02,083772,Staff,21,0,30,9
1649978253079,MATH 20E,B01,083773,Staff,3,0,30,27
1649978253079,MATH 20E,B02,083774,Staff,27,0,30,3
1649978259106,MATH 103A,A01,083777,Staff,1,5,30,29
1649978259106,MATH 103A,A02,083778,Staff,0,5,30,30
1649978259106,MATH 103A,B01,083779,Staff,0,5,30,30
1649978259106,MATH 103A,B02,083780,Staff,0,4,30,30
1649978265132,MATH 105,A01,085443,Staff,0,10,30,30
1649978271158,MATH 109,A01,083213,Anzaldo; Leesa B,0,3,30,30
1649978271158,MATH 109,A02,083214,Anzaldo; Leesa B,0,1,30,30
1649978271158,MATH 109,B01,083215,Anzaldo; Leesa B,13,0,30,17
1649978271158,MATH 109,B02,083216,Anzaldo; Leesa B,0,0,30,30
1649978277184,MATH 142A,A01,083219,Chow; Bennett,0,5,30,30
1649978277184,MATH 142A,A02,083220,Chow; Bennett,0,3,30,30
1649978277184,MATH 142A,B01,083221,Chow; Bennett,0,4,30,30
1649978277184,MATH 142A,B02,083222,Chow; Bennett,0,5,30,30
1649978283210,MATH 193A,A01,083224,Staff,0,5,30,30
1649978283210,MATH 193A,A02,083225,Staff,0,4,30,30
1649978283210,MATH 193A,A03,083781,Staff,1,0,30,29
1649978283210,MATH 193A,A04,083782,Staff,13,0,30,17
1649978289244,MATH 197,001,091859,McAuley; Julian John,9999,0,9999,0
1649978295295,COGS 9,A01,083615,Staff,0,6,60,60
1649978301319,COGS 11,A01,083617,Boyle; Mary E. T.,29,0,40,11
1649978307341,COGS 13,A01,083071,Staff,0,24,40,40
1649978313368,COGS 14A,A01,092681,Staff,25,0,100,75
1649978319399,COGS 14B,A01,083073,Cheng; Tzu-Han,7,0,50,43
1649978325424,COGS 17,A01,092677,Staff,50,0,75,25
1649978331448,COGS 100,A01,083619,Staff,1,15,60,59
1649978337472,COGS 101A,A01,083621,Davis; Joshua Daniel,0,16,60,60
1649978343495,COGS 101B,A01,091572,Staff,22,0,60,38
1649978349518,COGS 101C,A01,083625,Delgado; Tania,22,0,30,8
1649978355544,COGS 107A,A01,083627,Boyle; Mary E. T.,0,1,60,60
1649978361567,COGS 118A,A01,083075,Staff,21,0,60,39
1649978367593,CSE 3,A50,083646,Miranda; Gregory Joseph,22,0,38,16
1649978367593,CSE 3,A51,083647,Miranda; Gregory Joseph,37,0,37,0
1649978373622,CSE 8A,A50,083650,Miranda; Gregory Joseph,2,8,40,38
1649978379651,CSE 11,A01,083080,Cao; Yingjun,0,45,40,40
1649978385677,CSE 12,A01,083652,Staff,26,0,100,74
1649978391703,CSE 15L,A01,083654,Staff,0,0,50,50
1649978391703,CSE 15L,A02,083655,Staff,35,0,50,15
1649978397735,CSE 20,A01,083657,Staff,61,0,80,19
1649978403761,CSE 30,A01,083084,Eldon; John,0,50,40,40
1649978409792,CSE 100,A01,083659,Cao; Yingjun,1,51,50,49
1649978415826,CSE 134B,A01,083661,Powell; Thomas Allan,0,25,65,65
1649978421851,CSE 140,A01,083663,Staff,11,0,75,64
1649978427878,CSE 140L,A01,083088,Eldon; John,7,0,75,68
1649978433905,CSE 175,A01,083665,Kumar; Rakesh,10,0,25,15
1649978439935,CSE 190,A00,092507,Dubnov; Shlomo,17,0,20,3
1649978445969,ECE 45,A01,083139,Staff,0,6,40,40
1649978451991,ECE 65,A50,083695,Staff,2,0,30,28
1649978458017,ECE 109,A01,091882,Touri; Behrouz,51,0,70,19
1649978464041,ECE 180,A00,083140,Abi Samra; Nicholas Camill,26,0,30,4
1649978464041,ECE 180,B00,083141,Abi Samra; Nicholas Camill,10,0,30,20
1649978470071,MATH 10A,A01,083735,Patchell; Gregory David,17,0,30,13
1649978470071,MATH 10A,A02,083736,Patchell; Gregory David,28,0,30,2
1649978470071,MATH 10A,A03,083737,Patchell; Gregory David,27,0,30,3
1649978476093,MATH 10B,A01,083207,Staff,0,0,30,30
1649978476093,MATH 10B,A02,083208,Staff,20,0,30,10
1649978476093,MATH 10B,B01,083739,Staff,24,0,30,6
1649978476093,MATH 10B,B02,083740,Staff,30,0,30,0
1649978482123,MATH 18,A01,083743,Staff,20,0,30,10
1649978482123,MATH 18,A02,083744,Staff,29,0,30,1
1649978482123,MATH 18,A03,083745,Staff,26,0,30,4
1649978482123,MATH 18,A04,083746,Staff,27,0,30,3
1649978482123,MATH 18,B01,083748,Staff,0,1,30,30
1649978482123,MATH 18,B02,083749,Staff,0,0,30,30
1649978482123,MATH 18,B03,083750,Staff,19,0,30,11
1649978482123,MATH 18,B04,083751,Staff,12,0,30,18
1649978488154,MATH 20A,A01,083754,Staff,31,0,40,9
1649978494193,MATH 20B,A01,083756,Staff,8,0,30,22
1649978494193,MATH 20B,A02,083757,Staff,26,0,30,4
1649978500221,MATH 20C,A01,083760,Staff,4,0,30,26
1649978500221,MATH 20C,A02,083761,Staff,2,0,30,28
1649978500221,MATH 20C,B01,083762,Staff,24,0,30,6
1649978500221,MATH 20C,B02,083763,Staff,30,0,30,0
1649978506253,MATH 20D,A01,083765,Staff,2,0,30,28
1649978506253,MATH 20D,A02,083766,Staff,27,0,30,3
1649978506253,MATH 20D,A03,083767,Staff,28,0,30,2
1649978512283,MATH 20E,A01,083771,Staff,11,0,30,19
1649978512283,MATH 20E,A02,083772,Staff,21,0,30,9
1649978512283,MATH 20E,B01,083773,Staff,3,0,30,27
1649978512283,MATH 20E,B02,083774,Staff,27,0,30,3
1649978518314,MATH 103A,A01,083777,Staff,1,5,30,29
1649978518314,MATH 103A,A02,083778,Staff,0,5,30,30
1649978518314,MATH 103A,B01,083779,Staff,0,5,30,30
1649978518314,MATH 103A,B02,083780,Staff,0,5,30,30
1649978524345,MATH 105,A01,085443,Staff,0,10,30,30
1649978530367,MATH 109,A01,083213,Anzaldo; Leesa B,0,3,30,30
1649978530367,MATH 109,A02,083214,Anzaldo; Leesa B,0,1,30,30
1649978530367,MATH 109,B01,083215,Anzaldo; Leesa B,12,0,30,18
1649978530367,MATH 109,B02,083216,Anzaldo; Leesa B,0,0,30,30
1649978536400,MATH 142A,A01,083219,Chow; Bennett,0,5,30,30
1649978536400,MATH 142A,A02,083220,Chow; Bennett,0,3,30,30
1649978536400,MATH 142A,B01,083221,Chow; Bennett,0,4,30,30
1649978536400,MATH 142A,B02,083222,Chow; Bennett,0,5,30,30
1649978542427,MATH 193A,A01,083224,Staff,0,5,30,30
1649978542427,MATH 193A,A02,083225,Staff,0,4,30,30
1649978542427,MATH 193A,A03,083781,Staff,1,0,30,29
1649978542427,MATH 193A,A04,083782,Staff,13,0,30,17
1649978548451,MATH 197,001,091859,McAuley; Julian John,9999,0,9999,0
1649978554526,COGS 9,A01,083615,Staff,0,6,60,60
1649978560553,COGS 11,A01,083617,Boyle; Mary E. T.,29,0,40,11
1649978566576,COGS 13,A01,083071,Staff,0,24,40,40
1649978572601,COGS 14A,A01,092681,Staff,24,0,100,76
1649978578630,COGS 14B,A01,083073,Cheng; Tzu-Han,6,0,50,44
1649978584656,COGS 17,A01,092677,Staff,50,0,75,25
1649978590679,COGS 100,A01,083619,Staff,1,15,60,59
1649978596712,COGS 101A,A01,083621,Davis; Joshua Daniel,0,16,60,60
1649978602827,COGS 101B,A01,091572,Staff,22,0,60,38
1649978608851,COGS 101C,A01,083625,Delgado; Tania,22,0,30,8
1649978614894,COGS 107A,A01,083627,Boyle; Mary E. T.,0,1,60,60
1649978620923,COGS 118A,A01,083075,Staff,21,0,60,39
1649978626949,CSE 3,A50,083646,Miranda; Gregory Joseph,22,0,38,16
1649978626949,CSE 3,A51,083647,Miranda; Gregory Joseph,37,0,37,0
1649978632978,CSE 8A,A50,083650,Miranda; Gregory Joseph,2,8,40,38
1649978639002,CSE 11,A01,083080,Cao; Yingjun,0,45,40,40
1649978645029,CSE 12,A01,083652,Staff,26,0,100,74
1649978651055,CSE 15L,A01,083654,Staff,0,0,50,50
1649978651055,CSE 15L,A02,083655,Staff,35,0,50,15
1649978657077,CSE 20,A01,083657,Staff,60,0,80,20
1649978663109,CSE 30,A01,083084,Eldon; John,0,50,40,40
1649978669133,CSE 100,A01,083659,Cao; Yingjun,1,51,50,49
1649978675161,CSE 134B,A01,083661,Powell; Thomas Allan,0,25,65,65
1649978681183,CSE 140,A01,083663,Staff,11,0,75,64
1649978687208,CSE 140L,A01,083088,Eldon; John,7,0,75,68
1649978693231,CSE 175,A01,083665,Kumar; Rakesh,10,0,25,15
1649978699254,CSE 190,A00,092507,Dubnov; Shlomo,17,0,20,3
1649978705279,ECE 45,A01,083139,Staff,0,6,40,40
1649978711301,ECE 65,A50,083695,Staff,2,0,30,28
1649978717329,ECE 109,A01,091882,Touri; Behrouz,51,0,70,19
1649978723357,ECE 180,A00,083140,Abi Samra; Nicholas Camill,26,0,30,4
1649978723357,ECE 180,B00,083141,Abi Samra; Nicholas Camill,10,0,30,20
1649978729380,MATH 10A,A01,083735,Patchell; Gregory David,17,0,30,13
1649978729380,MATH 10A,A02,083736,Patchell; Gregory David,28,0,30,2
1649978729380,MATH 10A,A03,083737,Patchell; Gregory David,27,0,30,3
1649978735405,MATH 10B,A01,083207,Staff,0,0,30,30
1649978735405,MATH 10B,A02,083208,Staff,19,0,30,11
1649978735405,MATH 10B,B01,083739,Staff,24,0,30,6
1649978735405,MATH 10B,B02,083740,Staff,30,0,30,0
1649978741431,MATH 18,A01,083743,Staff,20,0,30,10
1649978741431,MATH 18,A02,083744,Staff,29,0,30,1
1649978741431,MATH 18,A03,083745,Staff,26,0,30,4
1649978741431,MATH 18,A04,083746,Staff,27,0,30,3
1649978741431,MATH 18,B01,083748,Staff,0,1,30,30
1649978741431,MATH 18,B02,083749,Staff,0,0,30,30
1649978741431,MATH 18,B03,083750,Staff,18,0,30,12
1649978741431,MATH 18,B04,083751,Staff,12,0,30,18
1649978747467,MATH 20A,A01,083754,Staff,31,0,40,9
1649978753490,MATH 20B,A01,083756,Staff,7,0,30,23
1649978753490,MATH 20B,A02,083757,Staff,26,0,30,4
1649978759531,MATH 20C,A01,083760,Staff,4,0,30,26
1649978759531,MATH 20C,A02,083761,Staff,2,0,30,28
1649978759531,MATH 20C,B01,083762,Staff,24,0,30,6
1649978759531,MATH 20C,B02,083763,Staff,30,0,30,0
1649978765557,MATH 20D,A01,083765,Staff,2,0,30,28
1649978765557,MATH 20D,A02,083766,Staff,27,0,30,3
1649978765557,MATH 20D,A03,083767,Staff,28,0,30,2
1649978771594,MATH 20E,A01,083771,Staff,11,0,30,19
1649978771594,MATH 20E,A02,083772,Staff,21,0,30,9
1649978771594,MATH 20E,B01,083773,Staff,3,0,30,27
1649978771594,MATH 20E,B02,083774,Staff,27,0,30,3
1649978777643,MATH 103A,A01,083777,Staff,1,5,30,29
1649978777643,MATH 103A,A02,083778,Staff,0,5,30,30
1649978777643,MATH 103A,B01,083779,Staff,0,5,30,30
1649978777643,MATH 103A,B02,083780,Staff,0,5,30,30
1649978783666,MATH 105,A01,085443,Staff,0,10,30,30
1649978789694,MATH 109,A01,083213,Anzaldo; Leesa B,0,3,30,30
1649978789694,MATH 109,A02,083214,Anzaldo; Leesa B,0,1,30,30
1649978789694,MATH 109,B01,083215,Anzaldo; Leesa B,11,0,30,19
1649978789694,MATH 109,B02,083216,Anzaldo; Leesa B,0,0,30,30
1649978795722,MATH 142A,A01,083219,Chow; Bennett,0,5,30,30
1649978795722,MATH 142A,A02,083220,Chow; Bennett,0,4,30,30
1649978795722,MATH 142A,B01,083221,Chow; Bennett,0,4,30,30
1649978795722,MATH 142A,B02,083222,Chow; Bennett,0,5,30,30
1649978801746,MATH 193A,A01,083224,Staff,0,5,30,30
1649978801746,MATH 193A,A02,083225,Staff,0,4,30,30
1649978801746,MATH 193A,A03,083781,Staff,1,0,30,29
1649978801746,MATH 193A,A04,083782,Staff,13,0,30,17
1649978807772,MATH 197,001,091859,McAuley; Julian John,9999,0,9999,0
1649978813822,COGS 9,A01,083615,Staff,0,6,60,60
1649978819857,COGS 11,A01,083617,Boyle; Mary E. T.,29,0,40,11
1649978825880,COGS 13,A01,083071,Staff,0,24,40,40
1649978831904,COGS 14A,A01,092681,Staff,24,0,100,76
1649978837927,COGS 14B,A01,083073,Cheng; Tzu-Han,6,0,50,44
1649978843950,COGS 17,A01,092677,Staff,49,0,75,26
1649978849976,COGS 100,A01,083619,Staff,1,15,60,59
1649978855999,COGS 101A,A01,083621,Davis; Joshua Daniel,0,16,60,60
1649978862033,COGS 101B,A01,091572,Staff,21,0,60,39
1649978868060,COGS 101C,A01,083625,Delgado; Tania,22,0,30,8
1649978874083,COGS 107A,A01,083627,Boyle; Mary E. T.,0,1,60,60
1649978880108,COGS 118A,A01,083075,Staff,21,0,60,39
1649978886144,CSE 3,A50,083646,Miranda; Gregory Joseph,22,0,38,16
1649978886144,CSE 3,A51,083647,Miranda; Gregory Joseph,37,0,37,0
1649978892171,CSE 8A,A50,083650,Miranda; Gregory Joseph,2,9,40,38
1649978898198,CSE 11,A01,083080,Cao; Yingjun,0,45,40,40
1649978904226,CSE 12,A01,083652,Staff,26,0,100,74
1649978910254,CSE 15L,A01,083654,Staff,0,0,50,50
1649978910254,CSE 15L,A02,083655,Staff,35,0,50,15
1649978916280,CSE 20,A01,083657,Staff,60,0,80,20
1649978922310,CSE 30,A01,083084,Eldon; John,0,50,40,40
1649978928334,CSE 100,A01,083659,Cao; Yingjun,1,52,50,49
1649978934361,CSE 134B,A01,083661,Powell; Thomas Allan,0,25,65,65
1649978940384,CSE 140,A01,083663,Staff,11,0,75,64
1649978946418,CSE 140L,A01,083088,Eldon; John,7,0,75,68
1649978952465,CSE 175,A01,083665,Kumar; Rakesh,10,0,25,15
1649978958493,CSE 190,A00,092507,Dubnov; Shlomo,17,0,20,3
1649978964519,ECE 45,A01,083139,Staff,0,6,40,40
1649978970542,ECE 65,A50,083695,Staff,2,0,30,28
1649978976564,ECE 109,A01,091882,Touri; Behrouz,51,0,70,19
1649978982588,ECE 180,A00,083140,Abi Samra; Nicholas Camill,26,0,30,4
1649978982588,ECE 180,B00,083141,Abi Samra; Nicholas Camill,10,0,30,20
1649978988626,MATH 10A,A01,083735,Patchell; Gregory David,17,0,30,13
1649978988626,MATH 10A,A02,083736,Patchell; Gregory David,28,0,30,2
1649978988626,MATH 10A,A03,083737,Patchell; Gregory David,27,0,30,3
1649978994649,MATH 10B,A01,083207,Staff,0,0,30,30
1649978994649,MATH 10B,A02,083208,Staff,19,0,30,11
1649978994649,MATH 10B,B01,083739,Staff,24,0,30,6
1649978994649,MATH 10B,B02,083740,Staff,30,0,30,0
1649979000672,MATH 18,A01,083743,Staff,20,0,30,10
1649979000672,MATH 18,A02,083744,Staff,29,0,30,1
1649979000672,MATH 18,A03,083745,Staff,26,0,30,4
1649979000672,MATH 18,A04,083746,Staff,27,0,30,3
1649979000672,MATH 18,B01,083748,Staff,0,1,30,30
1649979000672,MATH 18,B02,083749,Staff,0,0,30,30
1649979000672,MATH 18,B03,083750,Staff,19,0,30,11
1649979000672,MATH 18,B04,083751,Staff,12,0,30,18
1649979006709,MATH 20A,A01,083754,Staff,31,0,40,9
1649979012740,MATH 20B,A01,083756,Staff,7,0,30,23
1649979012740,MATH 20B,A02,083757,Staff,26,0,30,4
1649979018762,MATH 20C,A01,083760,Staff,4,0,30,26
1649979018762,MATH 20C,A02,083761,Staff,1,0,30,29
1649979018762,MATH 20C,B01,083762,Staff,24,0,30,6
1649979018762,MATH 20C,B02,083763,Staff,30,0,30,0
1649979024808,MATH 20D,A01,083765,Staff,3,0,30,27
1649979024808,MATH 20D,A02,083766,Staff,27,0,30,3
1649979024808,MATH 20D,A03,083767,Staff,28,0,30,2
1649979030844,MATH 20E,A01,083771,Staff,11,0,30,19
1649979030844,MATH 20E,A02,083772,Staff,21,0,30,9
1649979030844,MATH 20E,B01,083773,Staff,3,0,30,27
1649979030844,MATH 20E,B02,083774,Staff,27,0,30,3
1649979036866,MATH 103A,A01,083777,Staff,1,5,30,29
1649979036866,MATH 103A,A02,083778,Staff,0,5,30,30
1649979036866,MATH 103A,B01,083779,Staff,0,5,30,30
1649979036866,MATH 103A,B02,083780,Staff,0,5,30,30
1649979042892,MATH 105,A01,085443,Staff,0,10,30,30
1649979048916,MATH 109,A01,083213,Anzaldo; Leesa B,0,3,30,30
1649979048916,MATH 109,A02,083214,Anzaldo; Leesa B,0,1,30,30
1649979048916,MATH 109,B01,083215,Anzaldo; Leesa B,11,0,30,19
1649979048916,MATH 109,B02,083216,Anzaldo; Leesa B,0,0,30,30
1649979054948,MATH 142A,A01,083219,Chow; Bennett,0,5,30,30
1649979054948,MATH 142A,A02,083220,Chow; Bennett,0,5,30,30
1649979054948,MATH 142A,B01,083221,Chow; Bennett,0,4,30,30
1649979054948,MATH 142A,B02,083222,Chow; Bennett,0,5,30,30
1649979060971,MATH 193A,A01,083224,Staff,0,5,30,30
1649979060971,MATH 193A,A02,083225,Staff,0,4,30,30
1649979060971,MATH 193A,A03,083781,Staff,1,0,30,29
1649979060971,MATH 193A,A04,083782,Staff,13,0,30,17
1649979066996,MATH 197,001,091859,McAuley; Julian John,9999,0,9999,0
1649979073052,COGS 9,A01,083615,Staff,0,6,60,60
1649979079075,COGS 11,A01,083617,Boyle; Mary E. T.,29,0,40,11
1649979085102,COGS 13,A01,083071,Staff,0,24,40,40
1649979091125,COGS 14A,A01,092681,Staff,24,0,100,76
1649979097148,COGS 14B,A01,083073,Cheng; Tzu-Han,6,0,50,44
1649979103179,COGS 17,A01,092677,Staff,49,0,75,26
1649979109206,COGS 100,A01,083619,Staff,1,15,60,59
1649979115229,COGS 101A,A01,083621,Davis; Joshua Daniel,0,17,60,60
1649979121254,COGS 101B,A01,091572,Staff,21,0,60,39
1649979127283,COGS 101C,A01,083625,Delgado; Tania,22,0,30,8
1649979133317,COGS 107A,A01,083627,Boyle; Mary E. T.,0,1,60,60
1649979139355,COGS 118A,A01,083075,Staff,21,0,60,39
1649979145388,CSE 3,A50,083646,Miranda; Gregory Joseph,22,0,38,16
1649979145388,CSE 3,A51,083647,Miranda; Gregory Joseph,37,0,37,0
1649979151417,CSE 8A,A50,083650,Miranda; Gregory Joseph,2,9,40,38
1649979157442,CSE 11,A01,083080,Cao; Yingjun,0,45,40,40
1649979163465,CSE 12,A01,083652,Staff,26,0,100,74
1649979169492,CSE 15L,A01,083654,Staff,0,0,50,50
1649979169492,CSE 15L,A02,083655,Staff,35,0,50,15
1649979175518,CSE 20,A01,083657,Staff,60,0,80,20
1649979181554,CSE 30,A01,083084,Eldon; John,0,50,40,40
1649979187577,CSE 100,A01,083659,Cao; Yingjun,1,52,50,49
1649979193604,CSE 134B,A01,083661,Powell; Thomas Allan,0,25,65,65
1649979199716,CSE 140,A01,083663,Staff,10,0,75,65
1649979205740,CSE 140L,A01,083088,Eldon; John,6,0,75,69
1649979211763,CSE 175,A01,083665,Kumar; Rakesh,10,0,25,15
1649979217788,CSE 190,A00,092507,Dubnov; Shlomo,17,0,20,3
1649979223813,ECE 45,A01,083139,Staff,0,6,40,40
1649979229836,ECE 65,A50,083695,Staff,2,0,30,28
1649979235859,ECE 109,A01,091882,Touri; Behrouz,51,0,70,19
1649979241888,ECE 180,A00,083140,Abi Samra; Nicholas Camill,26,0,30,4
1649979241888,ECE 180,B00,083141,Abi Samra; Nicholas Camill,10,0,30,20
1649979247911,MATH 10A,A01,083735,Patchell; Gregory David,17,0,30,13
1649979247911,MATH 10A,A02,083736,Patchell; Gregory David,28,0,30,2
1649979247911,MATH 10A,A03,083737,Patchell; Gregory David,27,0,30,3
1649979253936,MATH 10B,A01,083207,Staff,0,0,30,30
1649979253936,MATH 10B,A02,083208,Staff,19,0,30,11
1649979253936,MATH 10B,B01,083739,Staff,24,0,30,6
1649979253936,MATH 10B,B02,083740,Staff,30,0,30,0
1649979259966,MATH 18,A01,083743,Staff,20,0,30,10
1649979259966,MATH 18,A02,083744,Staff,29,0,30,1
1649979259966,MATH 18,A03,083745,Staff,26,0,30,4
1649979259966,MATH 18,A04,083746,Staff,27,0,30,3
1649979259966,MATH 18,B01,083748,Staff,0,1,30,30
1649979259966,MATH 18,B02,083749,Staff,0,0,30,30
1649979259966,MATH 18,B03,083750,Staff,19,0,30,11
1649979259966,MATH 18,B04,083751,Staff,12,0,30,18
1649979265988,MATH 20A,A01,083754,Staff,31,0,40,9
1649979272012,MATH 20B,A01,083756,Staff,6,0,30,24
1649979272012,MATH 20B,A02,083757,Staff,26,0,30,4
1649979278034,MATH 20C,A01,083760,Staff,4,0,30,26
1649979278034,MATH 20C,A02,083761,Staff,0,0,30,30
1649979278034,MATH 20C,B01,083762,Staff,24,0,30,6
1649979278034,MATH 20C,B02,083763,Staff,30,0,30,0
1649979284070,MATH 20D,A01,083765,Staff,2,0,30,28
1649979284070,MATH 20D,A02,083766,Staff,27,0,30,3
1649979284070,MATH 20D,A03,083767,Staff,28,0,30,2
1649979290093,MATH 20E,A01,083771,Staff,11,0,30,19
1649979290093,MATH 20E,A02,083772,Staff,21,0,30,9
1649979290093,MATH 20E,B01,083773,Staff,3,0,30,27
1649979290093,MATH 20E,B02,083774,Staff,26,0,30,4
1649979296121,MATH 103A,A01,083777,Staff,1,5,30,29
1649979296121,MATH 103A,A02,083778,Staff,0,5,30,30
1649979296121,MATH 103A,B01,083779,Staff,0,5,30,30
1649979296121,MATH 103A,B02,083780,Staff,0,5,30,30
1649979302143,MATH 105,A01,085443,Staff,0,10,30,30
1649979308172,MATH 109,A01,083213,Anzaldo; Leesa B,0,3,30,30
1649979308172,MATH 109,A02,083214,Anzaldo; Leesa B,0,1,30,30
1649979308172,MATH 109,B01,083215,Anzaldo; Leesa B,10,0,30,20
1649979308172,MATH 109,B02,083216,Anzaldo; Leesa B,0,0,30,30
1649979314217,MATH 142A,A01,083219,Chow; Bennett,0,5,30,30
1649979314217,MATH 142A,A02,083220,Chow; Bennett,0,5,30,30
1649979314217,MATH 142A,B01,083221,Chow; Bennett,0,4,30,30
1649979314217,MATH 142A,B02,083222,Chow; Bennett,0,5,30,30
1649979320239,MATH 193A,A01,083224,Staff,0,5,30,30
1649979320239,MATH 193A,A02,083225,Staff,0,4,30,30
1649979320239,MATH 193A,A03,083781,Staff,1,0,30,29
1649979320239,MATH 193A,A04,083782,Staff,13,0,30,17
1649979326267,MATH 197,001,091859,McAuley; Julian John,9999,0,9999,0
1649979332368,COGS 9,A01,083615,Staff,0,6,60,60
1649979338392,COGS 11,A01,083617,Boyle; Mary E. T.,29,0,40,11
1649979344418,COGS 13,A01,083071,Staff,0,24,40,40
1649979350450,COGS 14A,A01,092681,Staff,24,0,100,76
1649979356474,COGS 14B,A01,083073,Cheng; Tzu-Han,6,0,50,44
1649979362501,COGS 17,A01,092677,Staff,49,0,75,26
1649979368528,COGS 100,A01,083619,Staff,1,15,60,59
1649979374555,COGS 101A,A01,083621,Davis; Joshua Daniel,0,17,60,60
1649979380591,COGS 101B,A01,091572,Staff,21,0,60,39
1649979386621,COGS 101C,A01,083625,Delgado; Tania,22,0,30,8
1649979392647,COGS 107A,A01,083627,Boyle; Mary E. T.,0,1,60,60
1649979398670,COGS 118A,A01,083075,Staff,21,0,60,39
1649979404695,CSE 3,A50,083646,Miranda; Gregory Joseph,22,0,38,16
1649979404695,CSE 3,A51,083647,Miranda; Gregory Joseph,37,0,37,0
1649979410719,CSE 8A,A50,083650,Miranda; Gregory Joseph,2,9,40,38
1649979416747,CSE 11,A01,083080,Cao; Yingjun,0,45,40,40
1649979422774,CSE 12,A01,083652,Staff,25,0,100,75
1649979428797,CSE 15L,A01,083654,Staff,0,0,50,50
1649979428797,CSE 15L,A02,083655,Staff,34,0,50,16
1649979434821,CSE 20,A01,083657,Staff,60,0,80,20
1649979440847,CSE 30,A01,083084,Eldon; John,0,50,40,40
1649979446871,CSE 100,A01,083659,Cao; Yingjun,1,52,50,49
1649979452894,CSE 134B,A01,083661,Powell; Thomas Allan,0,25,65,65
1649979458921,CSE 140,A01,083663,Staff,10,0,75,65
1649979464944,CSE 140L,A01,083088,Eldon; John,6,0,75,69
1649979470967,CSE 175,A01,083665,Kumar; Rakesh,10,0,25,15
1649979476999,CSE 190,A00,092507,Dubnov; Shlomo,17,0,20,3
1649979483023,ECE 45,A01,083139,Staff,0,6,40,40
1649979489052,ECE 65,A50,083695,Staff,2,0,30,28
1649979495076,ECE 109,A01,091882,Touri; Behrouz,51,0,70,19
1649979501123,ECE 180,A00,083140,Abi Samra; Nicholas Camill,26,0,30,4
1649979501123,ECE 180,B00,083141,Abi Samra; Nicholas Camill,10,0,30,20
1649979507150,MATH 10A,A01,083735,Patchell; Gregory David,17,0,30,13
1649979507150,MATH 10A,A02,083736,Patchell; Gregory David,28,0,30,2
1649979507150,MATH 10A,A03,083737,Patchell; Gregory David,27,0,30,3
1649979513175,MATH 10B,A01,083207,Staff,0,0,30,30
1649979513175,MATH 10B,A02,083208,Staff,19,0,30,11
1649979513175,MATH 10B,B01,083739,Staff,24,0,30,6
1649979513175,MATH 10B,B02,083740,Staff,30,0,30,0
1649979519204,MATH 18,A01,083743,Staff,20,0,30,10
1649979519204,MATH 18,A02,083744,Staff,29,0,30,1
1649979519204,MATH 18,A03,083745,Staff,26,0,30,4
1649979519204,MATH 18,A04,083746,Staff,27,0,30,3
1649979519204,MATH 18,B01,083748,Staff,0,1,30,30
1649979519204,MATH 18,B02,083749,Staff,0,0,30,30
1649979519204,MATH 18,B03,083750,Staff,19,0,30,11
1649979519204,MATH 18,B04,083751,Staff,12,0,30,18
1649979525227,MATH 20A,A01,083754,Staff,31,0,40,9
1649979531266,MATH 20B,A01,083756,Staff,6,0,30,24
1649979531266,MATH 20B,A02,083757,Staff,26,0,30,4
1649979537289,MATH 20C,A01,083760,Staff,4,0,30,26
1649979537289,MATH 20C,A02,083761,Staff,0,0,30,30
1649979537289,MATH 20C,B01,083762,Staff,24,0,30,6
1649979537289,MATH 20C,B02,083763,Staff,30,0,30,0
1649979543318,MATH 20D,A01,083765,Staff,2,0,30,28
1649979543318,MATH 20D,A02,083766,Staff,27,0,30,3
1649979543318,MATH 20D,A03,083767,Staff,28,0,30,2
1649979549340,MATH 20E,A01,083771,Staff,11,0,30,19
1649979549340,MATH 20E,A02,083772,Staff,21,0,30,9
1649979549340,MATH 20E,B01,083773,Staff,3,0,30,27
1649979549340,MATH 20E,B02,083774,Staff,26,0,30,4
1649979555369,MATH 103A,A01,083777,Staff,1,5,30,29
1649979555369,MATH 103A,A02,083778,Staff,0,5,30,30
1649979555369,MATH 103A,B01,083779,Staff,0,5,30,30
1649979555369,MATH 103A,B02,083780,Staff,0,5,30,30
1649979561400,MATH 105,A01,085443,Staff,0,10,30,30
1649979567424,MATH 109,A01,083213,Anzaldo; Leesa B,0,3,30,30
1649979567424,MATH 109,A02,083214,Anzaldo; Leesa B,0,1,30,30
1649979567424,MATH 109,B01,083215,Anzaldo; Leesa B,10,0,30,20
1649979567424,MATH 109,B02,083216,Anzaldo; Leesa B,0,0,30,30
1649979573456,MATH 142A,A01,083219,Chow; Bennett,0,5,30,30
1649979573456,MATH 142A,A02,083220,Chow; Bennett,0,5,30,30
1649979573456,MATH 142A,B01,083221,Chow; Bennett,0,4,30,30
1649979573456,MATH 142A,B02,083222,Chow; Bennett,0,5,30,30
1649979579482,MATH 193A,A01,083224,Staff,0,5,30,30
1649979579482,MATH 193A,A02,083225,Staff,0,4,30,30
1649979579482,MATH 193A,A03,083781,Staff,1,0,30,29
1649979579482,MATH 193A,A04,083782,Staff,13,0,30,17
1649979585504,MATH 197,001,091859,McAuley; Julian John,9999,0,9999,0
1649979591567,COGS 9,A01,083615,Staff,0,6,60,60
1649979597593,COGS 11,A01,083617,Boyle; Mary E. T.,28,0,40,12
1649979603617,COGS 13,A01,083071,Staff,0,24,40,40
1649979609643,COGS 14A,A01,092681,Staff,24,0,100,76
1649979615669,COGS 14B,A01,083073,Cheng; Tzu-Han,6,0,50,44
1649979621693,COGS 17,A01,092677,Staff,49,0,75,26
1649979627719,COGS 100,A01,083619,Staff,1,15,60,59
1649979633742,COGS 101A,A01,083621,Davis; Joshua Daniel,0,17,60,60
1649979639768,COGS 101B,A01,091572,Staff,21,0,60,39
1649979645803,COGS 101C,A01,083625,Delgado; Tania,22,0,30,8
1649979651847,COGS 107A,A01,083627,Boyle; Mary E. T.,0,1,60,60
1649979657877,COGS 118A,A01,083075,Staff,21,0,60,39
1649979663905,CSE 3,A50,083646,Miranda; Gregory Joseph,22,0,38,16
1649979663905,CSE 3,A51,083647,Miranda; Gregory Joseph,37,0,37,0
1649979669930,CSE 8A,A50,083650,Miranda; Gregory Joseph,2,9,40,38
1649979675954,CSE 11,A01,083080,Cao; Yingjun,0,45,40,40
1649979681980,CSE 12,A01,083652,Staff,23,0,100,77
1649979688006,CSE 15L,A01,083654,Staff,0,0,50,50
1649979688006,CSE 15L,A02,083655,Staff,32,0,50,18
1649979694029,CSE 20,A01,083657,Staff,60,0,80,20
1649979700056,CSE 30,A01,083084,Eldon; John,0,50,40,40
1649979706080,CSE 100,A01,083659,Cao; Yingjun,1,52,50,49
1649979712103,CSE 134B,A01,083661,Powell; Thomas Allan,0,25,65,65
1649979718129,CSE 140,A01,083663,Staff,10,0,75,65
1649979724155,CSE 140L,A01,083088,Eldon; John,6,0,75,69
1649979730182,CSE 175,A01,083665,Kumar; Rakesh,10,0,25,15
1649979736214,CSE 190,A00,092507,Dubnov; Shlomo,17,0,20,3
1649979742243,ECE 45,A01,083139,Staff,0,6,40,40
1649979748276,ECE 65,A50,083695,Staff,2,0,30,28
1649979754300,ECE 109,A01,091882,Touri; Behrouz,51,0,70,19
1649979760326,ECE 180,A00,083140,Abi Samra; Nicholas Camill,26,0,30,4
1649979760326,ECE 180,B00,083141,Abi Samra; Nicholas Camill,10,0,30,20
1649979766349,MATH 10A,A01,083735,Patchell; Gregory David,17,0,30,13
1649979766349,MATH 10A,A02,083736,Patchell; Gregory David,28,0,30,2
1649979766349,MATH 10A,A03,083737,Patchell; Gregory David,27,0,30,3
1649979772372,MATH 10B,A01,083207,Staff,0,0,30,30
1649979772372,MATH 10B,A02,083208,Staff,19,0,30,11
1649979772372,MATH 10B,B01,083739,Staff,24,0,30,6
1649979772372,MATH 10B,B02,083740,Staff,30,0,30,0
1649979778397,MATH 18,A01,083743,Staff,19,0,30,11
1649979778397,MATH 18,A02,083744,Staff,29,0,30,1
1649979778397,MATH 18,A03,083745,Staff,26,0,30,4
1649979778397,MATH 18,A04,083746,Staff,27,0,30,3
1649979778397,MATH 18,B01,083748,Staff,0,2,30,30
1649979778397,MATH 18,B02,083749,Staff,0,0,30,30
1649979778397,MATH 18,B03,083750,Staff,19,0,30,11
1649979778397,MATH 18,B04,083751,Staff,12,0,30,18
1649979784421,MATH 20A,A01,083754,Staff,31,0,40,9
1649979790446,MATH 20B,A01,083756,Staff,6,0,30,24
1649979790446,MATH 20B,A02,083757,Staff,26,0,30,4
1649979796561,MATH 20C,A01,083760,Staff,4,0,30,26
1649979796561,MATH 20C,A02,083761,Staff,0,0,30,30
1649979796561,MATH 20C,B01,083762,Staff,24,0,30,6
1649979796561,MATH 20C,B02,083763,Staff,30,0,30,0
1649979802585,MATH 20D,A01,083765,Staff,1,0,30,29
1649979802585,MATH 20D,A02,083766,Staff,26,0,30,4
1649979802585,MATH 20D,A03,083767,Staff,28,0,30,2
1649979808610,MATH 20E,A01,083771,Staff,11,0,30,19
1649979808610,MATH 20E,A02,083772,Staff,21,0,30,9
1649979808610,MATH 20E,B01,083773,Staff,3,0,30,27
1649979808610,MATH 20E,B02,083774,Staff,26,0,30,4
1649979814642,MATH 103A,A01,083777,Staff,1,5,30,29
1649979814642,MATH 103A,A02,083778,Staff,0,5,30,30
1649979814642,MATH 103A,B01,083779,Staff,0,5,30,30
1649979814642,MATH 103A,B02,083780,Staff,0,5,30,30
1649979820671,MATH 105,A01,085443,Staff,0,10,30,30
1649979826695,MATH 109,A01,083213,Anzaldo; Leesa B,0,3,30,30
1649979826695,MATH 109,A02,083214,Anzaldo; Leesa B,0,1,30,30
1649979826695,MATH 109,B01,083215,Anzaldo; Leesa B,10,0,30,20
1649979826695,MATH 109,B02,083216,Anzaldo; Leesa B,0,0,30,30
1649979832724,MATH 142A,A01,083219,Chow; Bennett,0,5,30,30
1649979832724,MATH 142A,A02,083220,Chow; Bennett,0,5,30,30
1649979832724,MATH 142A,B01,083221,Chow; Bennett,0,4,30,30
1649979832724,MATH 142A,B02,083222,Chow; Bennett,0,5,30,30
1649979838748,MATH 193A,A01,083224,Staff,0,5,30,30
1649979838748,MATH 193A,A02,083225,Staff,0,4,30,30
1649979838748,MATH 193A,A03,083781,Staff,1,0,30,29
1649979838748,MATH 193A,A04,083782,Staff,13,0,30,17
1649979844773,MATH 197,001,091859,McAuley; Julian John,9999,0,9999,0
1649979850824,COGS 9,A01,083615,Staff,0,7,60,60
1649979856848,COGS 11,A01,083617,Boyle; Mary E. T.,28,0,40,12
1649979862869,COGS 13,A01,083071,Staff,0,24,40,40
1649979868893,COGS 14A,A01,092681,Staff,23,0,100,77
1649979874917,COGS 14B,A01,083073,Cheng; Tzu-Han,6,0,50,44
1649979880941,COGS 17,A01,092677,Staff,49,0,75,26
1649979886967,COGS 100,A01,083619,Staff,1,15,60,59
1649979892995,COGS 101A,A01,083621,Davis; Joshua Daniel,0,17,60,60
1649979899024,COGS 101B,A01,091572,Staff,21,0,60,39
1649979905051,COGS 101C,A01,083625,Delgado; Tania,22,0,30,8
1649979911076,COGS 107A,A01,083627,Boyle; Mary E. T.,0,1,60,60
1649979917102,COGS 118A,A01,083075,Staff,21,0,60,39
1649979923124,CSE 3,A50,083646,Miranda; Gregory Joseph,22,0,38,16
1649979923124,CSE 3,A51,083647,Miranda; Gregory Joseph,37,0,37,0
1649979929153,CSE 8A,A50,083650,Miranda; Gregory Joseph,2,9,40,38
1649979935179,CSE 11,A01,083080,Cao; Yingjun,0,45,40,40
1649979941210,CSE 12,A01,083652,Staff,23,0,100,77
1649979947232,CSE 15L,A01,083654,Staff,0,0,50,50
1649979947232,CSE 15L,A02,083655,Staff,32,0,50,18
1649979953257,CSE 20,A01,083657,Staff,60,0,80,20
1649979959280,CSE 30,A01,083084,Eldon; John,0,51,40,40
1649979965306,CSE 100,A01,083659,Cao; Yingjun,1,52,50,49
1649979971343,CSE 134B,A01,083661,Powell; Thomas Allan,0,25,65,65
1649979977384,CSE 140,A01,083663,Staff,10,0,75,65
1649979983408,CSE 140L,A01,083088,Eldon; John,6,0,75,69
1649979989430,CSE 175,A01,083665,Kumar; Rakesh,10,0,25,15
1649979995456,CSE 190,A00,092507,Dubnov; Shlomo,17,0,20,3
1649980001482,ECE 45,A01,083139,Staff,0,6,40,40
1649980007505,ECE 65,A50,083695,Staff,2,0,30,28
1649980013532,ECE 109,A01,091882,Touri; Behrouz,50,0,70,20
1649980019557,ECE 180,A00,083140,Abi Samra; Nicholas Camill,26,0,30,4
1649980019557,ECE 180,B00,083141,Abi Samra; Nicholas Camill,10,0,30,20
1649980025587,MATH 10A,A01,083735,Patchell; Gregory David,17,0,30,13
1649980025587,MATH 10A,A02,083736,Patchell; Gregory David,28,0,30,2
1649980025587,MATH 10A,A03,083737,Patchell; Gregory David,27,0,30,3
1649980031615,MATH 10B,A01,083207,Staff,0,0,30,30
1649980031615,MATH 10B,A02,083208,Staff,19,0,30,11
1649980031615,MATH 10B,B01,083739,Staff,24,0,30,6
1649980031615,MATH 10B,B02,083740,Staff,30,0,30,0
1649980037639,MATH 18,A01,083743,Staff,19,0,30,11
1649980037639,MATH 18,A02,083744,Staff,29,0,30,1
1649980037639,MATH 18,A03,083745,Staff,26,0,30,4
1649980037639,MATH 18,A04,083746,Staff,27,0,30,3
1649980037639,MATH 18,B01,083748,Staff,0,2,30,30
1649980037639,MATH 18,B02,083749,Staff,0,0,30,30
1649980037639,MATH 18,B03,083750,Staff,18,0,30,12
1649980037639,MATH 18,B04,083751,Staff,11,0,30,19
1649980043664,MATH 20A,A01,083754,Staff,31,0,40,9
1649980049688,MATH 20B,A01,083756,Staff,6,0,30,24
1649980049688,MATH 20B,A02,083757,Staff,26,0,30,4
1649980055724,MATH 20C,A01,083760,Staff,4,0,30,26
1649980055724,MATH 20C,A02,083761,Staff,0,0,30,30
1649980055724,MATH 20C,B01,083762,Staff,24,0,30,6
1649980055724,MATH 20C,B02,083763,Staff,30,0,30,0
1649980061750,MATH 20D,A01,083765,Staff,1,0,30,29
1649980061750,MATH 20D,A02,083766,Staff,26,0,30,4
1649980061750,MATH 20D,A03,083767,Staff,28,0,30,2
1649980067775,MATH 20E,A01,083771,Staff,11,0,30,19
1649980067775,MATH 20E,A02,083772,Staff,21,0,30,9
1649980067775,MATH 20E,B01,083773,Staff,2,0,30,28
1649980067775,MATH 20E,B02,083774,Staff,26,0,30,4
1649980073803,MATH 103A,A01,083777,Staff,1,5,30,29
1649980073803,MATH 103A,A02,083778,Staff,0,5,30,30
1649980073803,MATH 103A,B01,083779,Staff,0,5,30,30
1649980073803,MATH 103A,B02,083780,Staff,0,5,30,30
1649980079827,MATH 105,A01,085443,Staff,0,10,30,30
1649980085853,MATH 109,A01,083213,Anzaldo; Leesa B,0,3,30,30
1649980085853,MATH 109,A02,083214,Anzaldo; Leesa B,0,1,30,30
1649980085853,MATH 109,B01,083215,Anzaldo; Leesa B,10,0,30,20
1649980085853,MATH 109,B02,083216,Anzaldo; Leesa B,0,0,30,30
1649980091876,MATH 142A,A01,083219,Chow; Bennett,0,5,30,30
1649980091876,MATH 142A,A02,083220,Chow; Bennett,0,5,30,30
1649980091876,MATH 142A,B01,083221,Chow; Bennett,0,4,30,30
1649980091876,MATH 142A,B02,083222,Chow; Bennett,0,5,30,30
1649980097901,MATH 193A,A01,083224,Staff,0,5,30,30
1649980097901,MATH 193A,A02,083225,Staff,0,4,30,30
1649980097901,MATH 193A,A03,083781,Staff,1,0,30,29
1649980097901,MATH 193A,A04,083782,Staff,13,0,30,17
1649980103927,MATH 197,001,091859,McAuley; Julian John,9999,0,9999,0
1649980109989,COGS 9,A01,083615,Staff,0,7,60,60
1649980116013,COGS 11,A01,083617,Boyle; Mary E. T.,29,0,40,11
1649980122042,COGS 13,A01,083071,Staff,0,24,40,40
1649980128066,COGS 14A,A01,092681,Staff,23,0,100,77
1649980134090,COGS 14B,A01,083073,Cheng; Tzu-Han,6,0,50,44
1649980140115,COGS 17,A01,092677,Staff,49,0,75,26
1649980146138,COGS 100,A01,083619,Staff,1,15,60,59
1649980152162,COGS 101A,A01,083621,Davis; Joshua Daniel,0,17,60,60
1649980158197,COGS 101B,A01,091572,Staff,21,0,60,39
1649980164223,COGS 101C,A01,083625,Delgado; Tania,22,0,30,8
1649980170246,COGS 107A,A01,083627,Boyle; Mary E. T.,0,1,60,60
1649980176273,COGS 118A,A01,083075,Staff,21,0,60,39
1649980182301,CSE 3,A50,083646,Miranda; Gregory Joseph,22,0,38,16
1649980182301,CSE 3,A51,083647,Miranda; Gregory Joseph,37,0,37,0
1649980188325,CSE 8A,A50,083650,Miranda; Gregory Joseph,2,9,40,38
1649980194349,CSE 11,A01,083080,Cao; Yingjun,0,45,40,40
1649980200382,CSE 12,A01,083652,Staff,23,0,100,77
1649980206407,CSE 15L,A01,083654,Staff,0,0,50,50
1649980206407,CSE 15L,A02,083655,Staff,31,0,50,19
1649980212433,CSE 20,A01,083657,Staff,60,0,80,20
1649980218456,CSE 30,A01,083084,Eldon; John,0,51,40,40
1649980224482,CSE 100,A01,083659,Cao; Yingjun,1,52,50,49
1649980230506,CSE 134B,A01,083661,Powell; Thomas Allan,0,25,65,65
1649980236530,CSE 140,A01,083663,Staff,10,0,75,65
1649980242554,CSE 140L,A01,083088,Eldon; John,6,0,75,69
1649980248580,CSE 175,A01,083665,Kumar; Rakesh,10,0,25,15
1649980254603,CSE 190,A00,092507,Dubnov; Shlomo,17,0,20,3
1649980260628,ECE 45,A01,083139,Staff,0,6,40,40
1649980266653,ECE 65,A50,083695,Staff,2,0,30,28
1649980272676,ECE 109,A01,091882,Touri; Behrouz,50,0,70,20
1649980278698,ECE 180,A00,083140,Abi Samra; Nicholas Camill,26,0,30,4
1649980278698,ECE 180,B00,083141,Abi Samra; Nicholas Camill,10,0,30,20
1649980284721,MATH 10A,A01,083735,Patchell; Gregory David,17,0,30,13
1649980284721,MATH 10A,A02,083736,Patchell; Gregory David,28,0,30,2
1649980284721,MATH 10A,A03,083737,Patchell; Gregory David,27,0,30,3
1649980290746,MATH 10B,A01,083207,Staff,0,1,30,30
1649980290746,MATH 10B,A02,083208,Staff,19,0,30,11
1649980290746,MATH 10B,B01,083739,Staff,24,0,30,6
1649980290746,MATH 10B,B02,083740,Staff,30,0,30,0
1649980296773,MATH 18,A01,083743,Staff,18,0,30,12
1649980296773,MATH 18,A02,083744,Staff,29,0,30,1
1649980296773,MATH 18,A03,083745,Staff,26,0,30,4
1649980296773,MATH 18,A04,083746,Staff,27,0,30,3
1649980296773,MATH 18,B01,083748,Staff,0,2,30,30
1649980296773,MATH 18,B02,083749,Staff,0,0,30,30
1649980296773,MATH 18,B03,083750,Staff,17,0,30,13
1649980296773,MATH 18,B04,083751,Staff,11,0,30,19
1649980302808,MATH 20A,A01,083754,Staff,31,0,40,9
1649980308837,MATH 20B,A01,083756,Staff,5,0,30,25
1649980308837,MATH 20B,A02,083757,Staff,26,0,30,4
1649980314870,MATH 20C,A01,083760,Staff,1,0,30,29
1649980314870,MATH 20C,A02,083761,Staff,0,0,30,30
1649980314870,MATH 20C,B01,083762,Staff,24,0,30,6
1649980314870,MATH 20C,B02,083763,Staff,30,0,30,0
1649980320894,MATH 20D,A01,083765,Staff,1,0,30,29
1649980320894,MATH 20D,A02,083766,Staff,26,0,30,4
1649980320894,MATH 20D,A03,083767,Staff,28,0,30,2
1649980326927,MATH 20E,A01,083771,Staff,11,0,30,19
1649980326927,MATH 20E,A02,083772,Staff,21,0,30,9
1649980326927,MATH 20E,B01,083773,Staff,2,0,30,28
1649980326927,MATH 20E,B02,083774,Staff,26,0,30,4
1649980332955,MATH 103A,A01,083777,Staff,1,5,30,29
1649980332955,MATH 103A,A02,083778,Staff,0,5,30,30
1649980332955,MATH 103A,B01,083779,Staff,0,5,30,30
1649980332955,MATH 103A,B02,083780,Staff,0,5,30,30
1649980338978,MATH 105,A01,085443,Staff,0,10,30,30
1649980345006,MATH 109,A01,083213,Anzaldo; Leesa B,0,3,30,30
1649980345006,MATH 109,A02,083214,Anzaldo; Leesa B,0,2,30,30
1649980345006,MATH 109,B01,083215,Anzaldo; Leesa B,10,0,30,20
1649980345006,MATH 109,B02,083216,Anzaldo; Leesa B,0,0,30,30
1649980351034,MATH 142A,A01,083219,Chow; Bennett,0,5,30,30
1649980351034,MATH 142A,A02,083220,Chow; Bennett,0,5,30,30
1649980351034,MATH 142A,B01,083221,Chow; Bennett,0,4,30,30
1649980351034,MATH 142A,B02,083222,Chow; Bennett,0,5,30,30
1649980357056,MATH 193A,A01,083224,Staff,0,5,30,30
1649980357056,MATH 193A,A02,083225,Staff,0,4,30,30
1649980357056,MATH 193A,A03,083781,Staff,1,0,30,29
1649980357056,MATH 193A,A04,083782,Staff,13,0,30,17
1649980363080,MATH 197,001,091859,McAuley; Julian John,9999,0,9999,0
1649980369138,COGS 9,A01,083615,Staff,0,7,60,60
1649980375162,COGS 11,A01,083617,Boyle; Mary E. T.,29,0,40,11
1649980381186,COGS 13,A01,083071,Staff,1,24,40,39
1649980387329,COGS 14A,A01,092681,Staff,21,0,100,79
1649980393353,COGS 14B,A01,083073,Cheng; Tzu-Han,6,0,50,44
1649980399378,COGS 17,A01,092677,Staff,49,0,75,26
1649980405401,COGS 100,A01,083619,Staff,1,15,60,59
1649980411428,COGS 101A,A01,083621,Davis; Joshua Daniel,0,17,60,60
1649980417469,COGS 101B,A01,091572,Staff,21,0,60,39
1649980423500,COGS 101C,A01,083625,Delgado; Tania,22,0,30,8
1649980429526,COGS 107A,A01,083627,Boyle; Mary E. T.,0,1,60,60
1649980435550,COGS 118A,A01,083075,Staff,21,0,60,39
1649980441574,CSE 3,A50,083646,Miranda; Gregory Joseph,22,0,38,16
1649980441574,CSE 3,A51,083647,Miranda; Gregory Joseph,37,0,37,0
1649980447597,CSE 8A,A50,083650,Miranda; Gregory Joseph,2,9,40,38
1649980453631,CSE 11,A01,083080,Cao; Yingjun,0,45,40,40
1649980459656,CSE 12,A01,083652,Staff,23,0,100,77
1649980465682,CSE 15L,A01,083654,Staff,0,0,50,50
1649980465682,CSE 15L,A02,083655,Staff,31,0,50,19
1649980471721,CSE 20,A01,083657,Staff,60,0,80,20
1649980477748,CSE 30,A01,083084,Eldon; John,0,51,40,40
1649980483772,CSE 100,A01,083659,Cao; Yingjun,1,53,50,49
1649980489799,CSE 134B,A01,083661,Powell; Thomas Allan,0,25,65,65
1649980495824,CSE 140,A01,083663,Staff,10,0,75,65
1649980501851,CSE 140L,A01,083088,Eldon; John,6,0,75,69
1649980507876,CSE 175,A01,083665,Kumar; Rakesh,10,0,25,15
1649980513898,CSE 190,A00,092507,Dubnov; Shlomo,17,0,20,3
1649980519921,ECE 45,A01,083139,Staff,0,6,40,40
1649980525945,ECE 65,A50,083695,Staff,2,0,30,28
1649980531972,ECE 109,A01,091882,Touri; Behrouz,50,0,70,20
1649980537997,ECE 180,A00,083140,Abi Samra; Nicholas Camill,26,0,30,4
1649980537997,ECE 180,B00,083141,Abi Samra; Nicholas Camill,10,0,30,20
1649980544034,MATH 10A,A01,083735,Patchell; Gregory David,17,0,30,13
1649980544034,MATH 10A,A02,083736,Patchell; Gregory David,28,0,30,2
1649980544034,MATH 10A,A03,083737,Patchell; Gregory David,27,0,30,3
1649980550065,MATH 10B,A01,083207,Staff,0,1,30,30
1649980550065,MATH 10B,A02,083208,Staff,19,0,30,11
1649980550065,MATH 10B,B01,083739,Staff,24,0,30,6
1649980550065,MATH 10B,B02,083740,Staff,30,0,30,0
1649980556093,MATH 18,A01,083743,Staff,18,0,30,12
1649980556093,MATH 18,A02,083744,Staff,29,0,30,1
1649980556093,MATH 18,A03,083745,Staff,26,0,30,4
1649980556093,MATH 18,A04,083746,Staff,27,0,30,3
1649980556093,MATH 18,B01,083748,Staff,0,2,30,30
1649980556093,MATH 18,B02,083749,Staff,0,0,30,30
1649980556093,MATH 18,B03,083750,Staff,16,0,30,14
1649980556093,MATH 18,B04,083751,Staff,10,0,30,20
1649980562116,MATH 20A,A01,083754,Staff,31,0,40,9
1649980568140,MATH 20B,A01,083756,Staff,5,0,30,25
1649980568140,MATH 20B,A02,083757,Staff,26,0,30,4
1649980574162,MATH 20C,A01,083760,Staff,1,0,30,29
1649980574162,MATH 20C,A02,083761,Staff,0,0,30,30
1649980574162,MATH 20C,B01,083762,Staff,24,0,30,6
1649980574162,MATH 20C,B02,083763,Staff,30,0,30,0
1649980580189,MATH 20D,A01,083765,Staff,1,0,30,29
1649980580189,MATH 20D,A02,083766,Staff,26,0,30,4
1649980580189,MATH 20D,A03,083767,Staff,28,0,30,2
1649980586213,MATH 20E,A01,083771,Staff,11,0,30,19
1649980586213,MATH 20E,A02,083772,Staff,21,0,30,9
1649980586213,MATH 20E,B01,083773,Staff,2,0,30,28
1649980586213,MATH 20E,B02,083774,Staff,26,0,30,4
1649980592254,MATH 103A,A01,083777,Staff,1,5,30,29
1649980592254,MATH 103A,A02,083778,Staff,0,5,30,30
1649980592254,MATH 103A,B01,083779,Staff,0,5,30,30
1649980592254,MATH 103A,B02,083780,Staff,0,5,30,30
1649980598276,MATH 105,A01,085443,Staff,0,10,30,30
1649980604298,MATH 109,A01,083213,Anzaldo; Leesa B,0,3,30,30
1649980604298,MATH 109,A02,083214,Anzaldo; Leesa B,0,2,30,30
1649980604298,MATH 109,B01,083215,Anzaldo; Leesa B,9,0,30,21
1649980604298,MATH 109,B02,083216,Anzaldo; Leesa B,0,0,30,30
1649980610323,MATH 142A,A01,083219,Chow; Bennett,0,5,30,30
1649980610323,MATH 142A,A02,083220,Chow; Bennett,0,5,30,30
1649980610323,MATH 142A,B01,083221,Chow; Bennett,0,4,30,30
1649980610323,MATH 142A,B02,083222,Chow; Bennett,0,5,30,30
1649980616349,MATH 193A,A01,083224,Staff,0,5,30,30
1649980616349,MATH 193A,A02,083225,Staff,0,4,30,30
1649980616349,MATH 193A,A03,083781,Staff,1,0,30,29
1649980616349,MATH 193A,A04,083782,Staff,13,0,30,17
1649980622372,MATH 197,001,091859,McAuley; Julian John,9999,0,9999,0
1649980628427,COGS 9,A01,083615,Staff,0,7,60,60
1649980634451,COGS 11,A01,083617,Boyle; Mary E. T.,29,0,40,11
1649980640481,COGS 13,A01,083071,Staff,1,24,40,39
1649980646511,COGS 14A,A01,092681,Staff,21,0,100,79
1649980652535,COGS 14B,A01,083073,Cheng; Tzu-Han,6,0,50,44
1649980658558,COGS 17,A01,092677,Staff,49,0,75,26
1649980664582,COGS 100,A01,083619,Staff,1,15,60,59
1649980670615,COGS 101A,A01,083621,Davis; Joshua Daniel,0,17,60,60
1649980676640,COGS 101B,A01,091572,Staff,21,0,60,39
1649980682665,COGS 101C,A01,083625,Delgado; Tania,22,0,30,8
1649980688693,COGS 107A,A01,083627,Boyle; Mary E. T.,0,1,60,60
1649980694734,COGS 118A,A01,083075,Staff,21,0,60,39
1649980700758,CSE 3,A50,083646,Miranda; Gregory Joseph,22,0,38,16
1649980700758,CSE 3,A51,083647,Miranda; Gregory Joseph,37,0,37,0
1649980706785,CSE 8A,A50,083650,Miranda; Gregory Joseph,2,9,40,38
1649980712815,CSE 11,A01,083080,Cao; Yingjun,0,45,40,40
1649980718854,CSE 12,A01,083652,Staff,23,0,100,77
1649980724880,CSE 15L,A01,083654,Staff,0,0,50,50
1649980724880,CSE 15L,A02,083655,Staff,31,0,50,19
1649980730904,CSE 20,A01,083657,Staff,60,0,80,20
1649980736937,CSE 30,A01,083084,Eldon; John,0,51,40,40
1649980742961,CSE 100,A01,083659,Cao; Yingjun,1,53,50,49
1649980748990,CSE 134B,A01,083661,Powell; Thomas Allan,0,25,65,65
1649980755023,CSE 140,A01,083663,Staff,10,0,75,65
1649980761048,CSE 140L,A01,083088,Eldon; John,6,0,75,69
1649980767072,CSE 175,A01,083665,Kumar; Rakesh,10,0,25,15
1649980773096,CSE 190,A00,092507,Dubnov; Shlomo,17,0,20,3
1649980779127,ECE 45,A01,083139,Staff,0,6,40,40
1649980785150,ECE 65,A50,083695,Staff,2,0,30,28
1649980791177,ECE 109,A01,091882,Touri; Behrouz,50,0,70,20
1649980797205,ECE 180,A00,083140,Abi Samra; Nicholas Camill,26,0,30,4
1649980797205,ECE 180,B00,083141,Abi Samra; Nicholas Camill,10,0,30,20
1649980803232,MATH 10A,A01,083735,Patchell; Gregory David,17,0,30,13
1649980803232,MATH 10A,A02,083736,Patchell; Gregory David,28,0,30,2
1649980803232,MATH 10A,A03,083737,Patchell; Gregory David,27,0,30,3
1649980809262,MATH 10B,A01,083207,Staff,0,1,30,30
1649980809262,MATH 10B,A02,083208,Staff,19,0,30,11
1649980809262,MATH 10B,B01,083739,Staff,24,0,30,6
1649980809262,MATH 10B,B02,083740,Staff,30,0,30,0
1649980815297,MATH 18,A01,083743,Staff,18,0,30,12
1649980815297,MATH 18,A02,083744,Staff,29,0,30,1
1649980815297,MATH 18,A03,083745,Staff,26,0,30,4
1649980815297,MATH 18,A04,083746,Staff,27,0,30,3
1649980815297,MATH 18,B01,083748,Staff,0,2,30,30
1649980815297,MATH 18,B02,083749,Staff,0,0,30,30
1649980815297,MATH 18,B03,083750,Staff,15,0,30,15
1649980815297,MATH 18,B04,083751,Staff,10,0,30,20
1649980821323,MATH 20A,A01,083754,Staff,31,0,40,9
1649980827347,MATH 20B,A01,083756,Staff,4,0,30,26
1649980827347,MATH 20B,A02,083757,Staff,26,0,30,4
1649980833371,MATH 20C,A01,083760,Staff,1,0,30,29
1649980833371,MATH 20C,A02,083761,Staff,0,0,30,30
1649980833371,MATH 20C,B01,083762,Staff,23,0,30,7
1649980833371,MATH 20C,B02,083763,Staff,30,0,30,0
1649980839401,MATH 20D,A01,083765,Staff,1,0,30,29
1649980839401,MATH 20D,A02,083766,Staff,25,0,30,5
1649980839401,MATH 20D,A03,083767,Staff,28,0,30,2
1649980845444,MATH 20E,A01,083771,Staff,11,0,30,19
1649980845444,MATH 20E,A02,083772,Staff,21,0,30,9
1649980845444,MATH 20E,B01,083773,Staff,2,0,30,28
1649980845444,MATH 20E,B02,083774,Staff,26,0,30,4
1649980851474,MATH 103A,A01,083777,Staff,1,5,30,29
1649980851474,MATH 103A,A02,083778,Staff,0,5,30,30
1649980851474,MATH 103A,B01,083779,Staff,0,5,30,30
1649980851474,MATH 103A,B02,083780,Staff,0,5,30,30
1649980857544,MATH 105,A01,085443,Staff,0,10,30,30
1649980863572,MATH 109,A01,083213,Anzaldo; Leesa B,0,3,30,30
1649980863572,MATH 109,A02,083214,Anzaldo; Leesa B,1,2,30,29
1649980863572,MATH 109,B01,083215,Anzaldo; Leesa B,6,0,30,24
1649980863572,MATH 109,B02,083216,Anzaldo; Leesa B,0,0,30,30
1649980869603,MATH 142A,A01,083219,Chow; Bennett,0,6,30,30
1649980869603,MATH 142A,A02,083220,Chow; Bennett,0,5,30,30
1649980869603,MATH 142A,B01,083221,Chow; Bennett,0,4,30,30
1649980869603,MATH 142A,B02,083222,Chow; Bennett,0,5,30,30
1649980875626,MATH 193A,A01,083224,Staff,0,5,30,30
1649980875626,MATH 193A,A02,083225,Staff,0,4,30,30
1649980875626,MATH 193A,A03,083781,Staff,1,0,30,29
1649980875626,MATH 193A,A04,083782,Staff,13,0,30,17
1649980881651,MATH 197,001,091859,McAuley; Julian John,9999,0,9999,0
1649980887718,COGS 9,A01,083615,Staff,0,7,60,60
1649980893747,COGS 11,A01,083617,Boyle; Mary E. T.,28,0,40,12
1649980899773,COGS 13,A01,083071,Staff,1,24,40,39
1649980905809,COGS 14A,A01,092681,Staff,20,0,100,80
1649980911847,COGS 14B,A01,083073,Cheng; Tzu-Han,6,0,50,44
1649980917874,COGS 17,A01,092677,Staff,49,0,75,26
1649980923897,COGS 100,A01,083619,Staff,1,15,60,59
1649980929929,COGS 101A,A01,083621,Davis; Joshua Daniel,0,17,60,60
1649980935955,COGS 101B,A01,091572,Staff,21,0,60,39
1649980941978,COGS 101C,A01,083625,Delgado; Tania,22,0,30,8
1649980948001,COGS 107A,A01,083627,Boyle; Mary E. T.,0,1,60,60
1649980954036,COGS 118A,A01,083075,Staff,21,0,60,39
1649980960069,CSE 3,A50,083646,Miranda; Gregory Joseph,22,0,38,16
1649980960069,CSE 3,A51,083647,Miranda; Gregory Joseph,37,0,37,0
1649980966100,CSE 8A,A50,083650,Miranda; Gregory Joseph,2,9,40,38
1649980972123,CSE 11,A01,083080,Cao; Yingjun,0,45,40,40
1649980978158,CSE 12,A01,083652,Staff,22,0,100,78
1649980984276,CSE 15L,A01,083654,Staff,0,0,50,50
1649980984276,CSE 15L,A02,083655,Staff,30,0,50,20
1649980990306,CSE 20,A01,083657,Staff,60,0,80,20
1649980996338,CSE 30,A01,083084,Eldon; John,0,51,40,40
1649981002364,CSE 100,A01,083659,Cao; Yingjun,1,53,50,49
1649981008391,CSE 134B,A01,083661,Powell; Thomas Allan,0,25,65,65
1649981014416,CSE 140,A01,083663,Staff,10,0,75,65
1649981020439,CSE 140L,A01,083088,Eldon; John,6,0,75,69
1649981026473,CSE 175,A01,083665,Kumar; Rakesh,10,0,25,15
1649981032498,CSE 190,A00,092507,Dubnov; Shlomo,17,0,20,3
1649981038522,ECE 45,A01,083139,Staff,0,6,40,40
1649981044563,ECE 65,A50,083695,Staff,2,0,30,28
1649981050586,ECE 109,A01,091882,Touri; Behrouz,50,0,70,20
1649981056625,ECE 180,A00,083140,Abi Samra; Nicholas Camill,26,0,30,4
1649981056625,ECE 180,B00,083141,Abi Samra; Nicholas Camill,10,0,30,20
1649981062661,MATH 10A,A01,083735,Patchell; Gregory David,17,0,30,13
1649981062661,MATH 10A,A02,083736,Patchell; Gregory David,28,0,30,2
1649981062661,MATH 10A,A03,083737,Patchell; Gregory David,27,0,30,3
1649981068705,MATH 10B,A01,083207,Staff,0,2,30,30
1649981068705,MATH 10B,A02,083208,Staff,19,0,30,11
1649981068705,MATH 10B,B01,083739,Staff,23,0,30,7
1649981068705,MATH 10B,B02,083740,Staff,30,0,30,0
1649981074738,MATH 18,A01,083743,Staff,18,0,30,12
1649981074738,MATH 18,A02,083744,Staff,29,0,30,1
1649981074738,MATH 18,A03,083745,Staff,26,0,30,4
1649981074738,MATH 18,A04,083746,Staff,27,0,30,3
1649981074738,MATH 18,B01,083748,Staff,0,2,30,30
1649981074738,MATH 18,B02,083749,Staff,0,0,30,30
1649981074738,MATH 18,B03,083750,Staff,15,0,30,15
1649981074738,MATH 18,B04,083751,Staff,10,0,30,20
1649981080766,MATH 20A,A01,083754,Staff,31,0,40,9
1649981086793,MATH 20B,A01,083756,Staff,4,0,30,26
1649981086793,MATH 20B,A02,083757,Staff,26,0,30,4
1649981092820,MATH 20C,A01,083760,Staff,1,0,30,29
1649981092820,MATH 20C,A02,083761,Staff,0,0,30,30
1649981092820,MATH 20C,B01,083762,Staff,23,0,30,7
1649981092820,MATH 20C,B02,083763,Staff,30,0,30,0
1649981098847,MATH 20D,A01,083765,Staff,1,0,30,29
1649981098847,MATH 20D,A02,083766,Staff,25,0,30,5
1649981098847,MATH 20D,A03,083767,Staff,28,0,30,2
1649981104873,MATH 20E,A01,083771,Staff,11,0,30,19
1649981104873,MATH 20E,A02,083772,Staff,21,0,30,9
1649981104873,MATH 20E,B01,083773,Staff,2,0,30,28
1649981104873,MATH 20E,B02,083774,Staff,26,0,30,4
1649981110899,MATH 103A,A01,083777,Staff,1,5,30,29
1649981110899,MATH 103A,A02,083778,Staff,0,5,30,30
1649981110899,MATH 103A,B01,083779,Staff,0,5,30,30
1649981110899,MATH 103A,B02,083780,Staff,0,5,30,30
1649981116928,MATH 105,A01,085443,Staff,0,10,30,30
1649981122957,MATH 109,A01,083213,Anzaldo; Leesa B,0,3,30,30
1649981122957,MATH 109,A02,083214,Anzaldo; Leesa B,1,2,30,29
1649981122957,MATH 109,B01,083215,Anzaldo; Leesa B,6,0,30,24
1649981122957,MATH 109,B02,083216,Anzaldo; Leesa B,0,0,30,30
1649981128982,MATH 142A,A01,083219,Chow; Bennett,0,6,30,30
1649981128982,MATH 142A,A02,083220,Chow; Bennett,0,5,30,30
1649981128982,MATH 142A,B01,083221,Chow; Bennett,0,4,30,30
1649981128982,MATH 142A,B02,083222,Chow; Bennett,0,5,30,30
1649981135007,MATH 193A,A01,083224,Staff,0,5,30,30
1649981135007,MATH 193A,A02,083225,Staff,0,4,30,30
1649981135007,MATH 193A,A03,083781,Staff,1,0,30,29
1649981135007,MATH 193A,A04,083782,Staff,13,0,30,17
1649981141029,MATH 197,001,091859,McAuley; Julian John,9999,0,9999,0
1649981147094,COGS 9,A01,083615,Staff,0,7,60,60
1649981153124,COGS 11,A01,083617,Boyle; Mary E. T.,28,0,40,12
1649981159147,COGS 13,A01,083071,Staff,1,24,40,39
1649981165172,COGS 14A,A01,092681,Staff,19,0,100,81
1649981171196,COGS 14B,A01,083073,Cheng; Tzu-Han,6,0,50,44
1649981177219,COGS 17,A01,092677,Staff,48,0,75,27
1649981183246,COGS 100,A01,083619,Staff,1,15,60,59
1649981189278,COGS 101A,A01,083621,Davis; Joshua Daniel,0,17,60,60
1649981195303,COGS 101B,A01,091572,Staff,21,0,60,39
1649981201333,COGS 101C,A01,083625,Delgado; Tania,22,0,30,8
1649981207355,COGS 107A,A01,083627,Boyle; Mary E. T.,0,1,60,60
1649981213380,COGS 118A,A01,083075,Staff,21,0,60,39
1649981219407,CSE 3,A50,083646,Miranda; Gregory Joseph,22,0,38,16
1649981219407,CSE 3,A51,083647,Miranda; Gregory Joseph,37,0,37,0
1649981225440,CSE 8A,A50,083650,Miranda; Gregory Joseph,2,9,40,38
1649981231465,CSE 11,A01,083080,Cao; Yingjun,0,45,40,40
1649981237488,CSE 12,A01,083652,Staff,22,0,100,78
1649981243527,CSE 15L,A01,083654,Staff,0,0,50,50
1649981243527,CSE 15L,A02,083655,Staff,30,0,50,20
1649981249559,CSE 20,A01,083657,Staff,60,0,80,20
1649981255583,CSE 30,A01,083084,Eldon; John,0,51,40,40
1649981261615,CSE 100,A01,083659,Cao; Yingjun,1,53,50,49
1649981267656,CSE 134B,A01,083661,Powell; Thomas Allan,0,25,65,65
1649981273685,CSE 140,A01,083663,Staff,10,0,75,65
1649981279708,CSE 140L,A01,083088,Eldon; John,6,0,75,69
1649981285735,CSE 175,A01,083665,Kumar; Rakesh,10,0,25,15
1649981291773,CSE 190,A00,092507,Dubnov; Shlomo,17,0,20,3
1649981297802,ECE 45,A01,083139,Staff,0,6,40,40
1649981303829,ECE 65,A50,083695,Staff,2,0,30,28
1649981309855,ECE 109,A01,091882,Touri; Behrouz,50,0,70,20
1649981315879,ECE 180,A00,083140,Abi Samra; Nicholas Camill,26,0,30,4
1649981315879,ECE 180,B00,083141,Abi Samra; Nicholas Camill,10,0,30,20
1649981321914,MATH 10A,A01,083735,Patchell; Gregory David,17,0,30,13
1649981321914,MATH 10A,A02,083736,Patchell; Gregory David,28,0,30,2
1649981321914,MATH 10A,A03,083737,Patchell; Gregory David,27,0,30,3
1649981327938,MATH 10B,A01,083207,Staff,0,3,30,30
1649981327938,MATH 10B,A02,083208,Staff,19,0,30,11
1649981327938,MATH 10B,B01,083739,Staff,23,0,30,7
1649981327938,MATH 10B,B02,083740,Staff,30,0,30,0
1649981333963,MATH 18,A01,083743,Staff,18,0,30,12
1649981333963,MATH 18,A02,083744,Staff,29,0,30,1
1649981333963,MATH 18,A03,083745,Staff,26,0,30,4
1649981333963,MATH 18,A04,083746,Staff,27,0,30,3
1649981333963,MATH 18,B01,083748,Staff,0,2,30,30
1649981333963,MATH 18,B02,083749,Staff,0,0,30,30
1649981333963,MATH 18,B03,083750,Staff,15,0,30,15
1649981333963,MATH 18,B04,083751,Staff,10,0,30,20
1649981339989,MATH 20A,A01,083754,Staff,31,0,40,9
1649981346013,MATH 20B,A01,083756,Staff,4,0,30,26
1649981346013,MATH 20B,A02,083757,Staff,26,0,30,4
1649981352049,MATH 20C,A01,083760,Staff,1,0,30,29
1649981352049,MATH 20C,A02,083761,Staff,0,0,30,30
1649981352049,MATH 20C,B01,083762,Staff,23,0,30,7
1649981352049,MATH 20C,B02,083763,Staff,30,0,30,0
1649981358075,MATH 20D,A01,083765,Staff,0,0,30,30
1649981358075,MATH 20D,A02,083766,Staff,25,0,30,5
1649981358075,MATH 20D,A03,083767,Staff,28,0,30,2
1649981364099,MATH 20E,A01,083771,Staff,11,0,30,19
1649981364099,MATH 20E,A02,083772,Staff,21,0,30,9
1649981364099,MATH 20E,B01,083773,Staff,2,0,30,28
1649981364099,MATH 20E,B02,083774,Staff,26,0,30,4
1649981370128,MATH 103A,A01,083777,Staff,1,5,30,29
1649981370128,MATH 103A,A02,083778,Staff,0,5,30,30
1649981370128,MATH 103A,B01,083779,Staff,0,5,30,30
1649981370128,MATH 103A,B02,083780,Staff,0,5,30,30
1649981376155,MATH 105,A01,085443,Staff,0,10,30,30
1649981382190,MATH 109,A01,083213,Anzaldo; Leesa B,0,3,30,30
1649981382190,MATH 109,A02,083214,Anzaldo; Leesa B,1,2,30,29
1649981382190,MATH 109,B01,083215,Anzaldo; Leesa B,6,0,30,24
1649981382190,MATH 109,B02,083216,Anzaldo; Leesa B,0,0,30,30
1649981388214,MATH 142A,A01,083219,Chow; Bennett,0,6,30,30
1649981388214,MATH 142A,A02,083220,Chow; Bennett,0,5,30,30
1649981388214,MATH 142A,B01,083221,Chow; Bennett,0,4,30,30
1649981388214,MATH 142A,B02,083222,Chow; Bennett,0,5,30,30
1649981394241,MATH 193A,A01,083224,Staff,0,5,30,30
1649981394241,MATH 193A,A02,083225,Staff,0,4,30,30
1649981394241,MATH 193A,A03,083781,Staff,1,0,30,29
1649981394241,MATH 193A,A04,083782,Staff,13,0,30,17
1649981406031,MATH 197,001,091859,McAuley; Julian John,9999,0,9999,0
1649981412082,COGS 9,A01,083615,Staff,0,7,60,60
1649981418109,COGS 11,A01,083617,Boyle; Mary E. T.,28,0,40,12
1649981424144,COGS 13,A01,083071,Staff,1,24,40,39
1649981430169,COGS 14A,A01,092681,Staff,17,0,100,83
1649981436191,COGS 14B,A01,083073,Cheng; Tzu-Han,6,0,50,44
1649981442216,COGS 17,A01,092677,Staff,48,0,75,27
1649981448243,COGS 100,A01,083619,Staff,1,15,60,59
1649981454275,COGS 101A,A01,083621,Davis; Joshua Daniel,0,17,60,60
1649981460308,COGS 101B,A01,091572,Staff,21,0,60,39
1649981466332,COGS 101C,A01,083625,Delgado; Tania,22,0,30,8
1649981472361,COGS 107A,A01,083627,Boyle; Mary E. T.,0,1,60,60
1649981478388,COGS 118A,A01,083075,Staff,21,0,60,39
1649981484429,CSE 3,A50,083646,Miranda; Gregory Joseph,22,0,38,16
1649981484429,CSE 3,A51,083647,Miranda; Gregory Joseph,37,0,37,0
1649981490485,CSE 8A,A50,083650,Miranda; Gregory Joseph,2,9,40,38
1649981496508,CSE 11,A01,083080,Cao; Yingjun,0,46,40,40
1649981502534,CSE 12,A01,083652,Staff,22,0,100,78
1649981508576,CSE 15L,A01,083654,Staff,0,0,50,50
1649981508576,CSE 15L,A02,083655,Staff,30,0,50,20
1649981514609,CSE 20,A01,083657,Staff,60,0,80,20
1649981520649,CSE 30,A01,083084,Eldon; John,0,51,40,40
1649981526707,CSE 100,A01,083659,Cao; Yingjun,1,53,50,49
1649981532738,CSE 134B,A01,083661,Powell; Thomas Allan,0,25,65,65
1649981538775,CSE 140,A01,083663,Staff,10,0,75,65
1649981544799,CSE 140L,A01,083088,Eldon; John,6,0,75,69
1649981550832,CSE 175,A01,083665,Kumar; Rakesh,10,0,25,15
1649981556856,CSE 190,A00,092507,Dubnov; Shlomo,17,0,20,3
1649981562879,ECE 45,A01,083139,Staff,0,6,40,40
1649981568916,ECE 65,A50,083695,Staff,2,0,30,28
1649981574943,ECE 109,A01,091882,Touri; Behrouz,50,0,70,20
1649981580984,ECE 180,A00,083140,Abi Samra; Nicholas Camill,26,0,30,4
1649981580984,ECE 180,B00,083141,Abi Samra; Nicholas Camill,10,0,30,20
1649981587106,MATH 10A,A01,083735,Patchell; Gregory David,17,0,30,13
1649981587106,MATH 10A,A02,083736,Patchell; Gregory David,28,0,30,2
1649981587106,MATH 10A,A03,083737,Patchell; Gregory David,27,0,30,3
1649981593131,MATH 10B,A01,083207,Staff,0,2,30,30
1649981593131,MATH 10B,A02,083208,Staff,17,0,30,13
1649981593131,MATH 10B,B01,083739,Staff,23,0,30,7
1649981593131,MATH 10B,B02,083740,Staff,30,0,30,0
1649981599163,MATH 18,A01,083743,Staff,17,0,30,13
1649981599163,MATH 18,A02,083744,Staff,29,0,30,1
1649981599163,MATH 18,A03,083745,Staff,26,0,30,4
1649981599163,MATH 18,A04,083746,Staff,27,0,30,3
1649981599163,MATH 18,B01,083748,Staff,0,2,30,30
1649981599163,MATH 18,B02,083749,Staff,0,0,30,30
1649981599163,MATH 18,B03,083750,Staff,15,0,30,15
1649981599163,MATH 18,B04,083751,Staff,9,0,30,21
1649981605204,MATH 20A,A01,083754,Staff,31,0,40,9
1649981611230,MATH 20B,A01,083756,Staff,4,0,30,26
1649981611230,MATH 20B,A02,083757,Staff,26,0,30,4
1649981617255,MATH 20C,A01,083760,Staff,0,0,30,30
1649981617255,MATH 20C,A02,083761,Staff,0,0,30,30
1649981617255,MATH 20C,B01,083762,Staff,23,0,30,7
1649981617255,MATH 20C,B02,083763,Staff,30,0,30,0
1649981623277,MATH 20D,A01,083765,Staff,0,0,30,30
1649981623277,MATH 20D,A02,083766,Staff,25,0,30,5
1649981623277,MATH 20D,A03,083767,Staff,28,0,30,2
1649981629304,MATH 20E,A01,083771,Staff,11,0,30,19
1649981629304,MATH 20E,A02,083772,Staff,21,0,30,9
1649981629304,MATH 20E,B01,083773,Staff,2,0,30,28
1649981629304,MATH 20E,B02,083774,Staff,26,0,30,4
1649981635329,MATH 103A,A01,083777,Staff,1,5,30,29
1649981635329,MATH 103A,A02,083778,Staff,0,5,30,30
1649981635329,MATH 103A,B01,083779,Staff,0,5,30,30
1649981635329,MATH 103A,B02,083780,Staff,0,5,30,30
1649981641353,MATH 105,A01,085443,Staff,0,10,30,30
1649981647380,MATH 109,A01,083213,Anzaldo; Leesa B,0,3,30,30
1649981647380,MATH 109,A02,083214,Anzaldo; Leesa B,1,2,30,29
1649981647380,MATH 109,B01,083215,Anzaldo; Leesa B,6,0,30,24
1649981647380,MATH 109,B02,083216,Anzaldo; Leesa B,0,0,30,30
1649981653409,MATH 142A,A01,083219,Chow; Bennett,0,6,30,30
1649981653409,MATH 142A,A02,083220,Chow; Bennett,0,5,30,30
1649981653409,MATH 142A,B01,083221,Chow; Bennett,0,4,30,30
1649981653409,MATH 142A,B02,083222,Chow; Bennett,0,5,30,30
1649981659435,MATH 193A,A01,083224,Staff,0,5,30,30
1649981659435,MATH 193A,A02,083225,Staff,0,4,30,30
1649981659435,MATH 193A,A03,083781,Staff,1,0,30,29
1649981659435,MATH 193A,A04,083782,Staff,13,0,30,17
1649981665458,MATH 197,001,091859,McAuley; Julian John,9999,0,9999,0
1649981671516,COGS 9,A01,083615,Staff,0,7,60,60
1649981677540,COGS 11,A01,083617,Boyle; Mary E. T.,28,0,40,12
1649981683564,COGS 13,A01,083071,Staff,1,24,40,39
1649981689588,COGS 14A,A01,092681,Staff,17,0,100,83
1649981695618,COGS 14B,A01,083073,Cheng; Tzu-Han,6,0,50,44
1649981701648,COGS 17,A01,092677,Staff,48,0,75,27
1649981707674,COGS 100,A01,083619,Staff,1,15,60,59
1649981713700,COGS 101A,A01,083621,Davis; Joshua Daniel,0,17,60,60
1649981719727,COGS 101B,A01,091572,Staff,21,0,60,39
1649981725751,COGS 101C,A01,083625,Delgado; Tania,22,0,30,8
1649981731786,COGS 107A,A01,083627,Boyle; Mary E. T.,0,1,60,60
1649981737811,COGS 118A,A01,083075,Staff,21,0,60,39
1649981743839,CSE 3,A50,083646,Miranda; Gregory Joseph,22,0,38,16
1649981743839,CSE 3,A51,083647,Miranda; Gregory Joseph,37,0,37,0
1649981749861,CSE 8A,A50,083650,Miranda; Gregory Joseph,2,9,40,38
1649981755884,CSE 11,A01,083080,Cao; Yingjun,0,46,40,40
1649981761911,CSE 12,A01,083652,Staff,20,0,100,80
1649981767935,CSE 15L,A01,083654,Staff,0,0,50,50
1649981767935,CSE 15L,A02,083655,Staff,28,0,50,22
1649981773963,CSE 20,A01,083657,Staff,60,0,80,20
1649981779985,CSE 30,A01,083084,Eldon; John,0,51,40,40
1649981786006,CSE 100,A01,083659,Cao; Yingjun,1,53,50,49
1649981792032,CSE 134B,A01,083661,Powell; Thomas Allan,0,25,65,65
1649981798059,CSE 140,A01,083663,Staff,10,0,75,65
1649981804082,CSE 140L,A01,083088,Eldon; John,6,0,75,69
1649981810105,CSE 175,A01,083665,Kumar; Rakesh,10,0,25,15
1649981816132,CSE 190,A00,092507,Dubnov; Shlomo,17,0,20,3
1649981822168,ECE 45,A01,083139,Staff,0,6,40,40
1649981828194,ECE 65,A50,083695,Staff,2,0,30,28
1649981834219,ECE 109,A01,091882,Touri; Behrouz,50,0,70,20
1649981840245,ECE 180,A00,083140,Abi Samra; Nicholas Camill,26,0,30,4
1649981840245,ECE 180,B00,083141,Abi Samra; Nicholas Camill,10,0,30,20
1649981846267,MATH 10A,A01,083735,Patchell; Gregory David,17,0,30,13
1649981846267,MATH 10A,A02,083736,Patchell; Gregory David,28,0,30,2
1649981846267,MATH 10A,A03,083737,Patchell; Gregory David,27,0,30,3
1649981852294,MATH 10B,A01,083207,Staff,0,2,30,30
1649981852294,MATH 10B,A02,083208,Staff,17,0,30,13
1649981852294,MATH 10B,B01,083739,Staff,23,0,30,7
1649981852294,MATH 10B,B02,083740,Staff,30,0,30,0
1649981858326,MATH 18,A01,083743,Staff,17,0,30,13
1649981858326,MATH 18,A02,083744,Staff,29,0,30,1
1649981858326,MATH 18,A03,083745,Staff,26,0,30,4
1649981858326,MATH 18,A04,083746,Staff,27,0,30,3
1649981858326,MATH 18,B01,083748,Staff,0,2,30,30
1649981858326,MATH 18,B02,083749,Staff,0,0,30,30
1649981858326,MATH 18,B03,083750,Staff,15,0,30,15
1649981858326,MATH 18,B04,083751,Staff,9,0,30,21
1649981864350,MATH 20A,A01,083754,Staff,31,0,40,9
1649981870373,MATH 20B,A01,083756,Staff,4,0,30,26
1649981870373,MATH 20B,A02,083757,Staff,26,0,30,4
1649981876395,MATH 20C,A01,083760,Staff,0,0,30,30
1649981876395,MATH 20C,A02,083761,Staff,0,0,30,30
1649981876395,MATH 20C,B01,083762,Staff,23,0,30,7
1649981876395,MATH 20C,B02,083763,Staff,30,0,30,0
1649981882424,MATH 20D,A01,083765,Staff,0,0,30,30
1649981882424,MATH 20D,A02,083766,Staff,25,0,30,5
1649981882424,MATH 20D,A03,083767,Staff,28,0,30,2
1649981888450,MATH 20E,A01,083771,Staff,11,0,30,19
1649981888450,MATH 20E,A02,083772,Staff,21,0,30,9
1649981888450,MATH 20E,B01,083773,Staff,2,0,30,28
1649981888450,MATH 20E,B02,083774,Staff,26,0,30,4
1649981894476,MATH 103A,A01,083777,Staff,1,5,30,29
1649981894476,MATH 103A,A02,083778,Staff,0,5,30,30
1649981894476,MATH 103A,B01,083779,Staff,0,5,30,30
1649981894476,MATH 103A,B02,083780,Staff,0,5,30,30
1649981900499,MATH 105,A01,085443,Staff,0,10,30,30
1649981906523,MATH 109,A01,083213,Anzaldo; Leesa B,0,3,30,30
1649981906523,MATH 109,A02,083214,Anzaldo; Leesa B,1,2,30,29
1649981906523,MATH 109,B01,083215,Anzaldo; Leesa B,6,0,30,24
1649981906523,MATH 109,B02,083216,Anzaldo; Leesa B,0,0,30,30
1649981912552,MATH 142A,A01,083219,Chow; Bennett,0,6,30,30
1649981912552,MATH 142A,A02,083220,Chow; Bennett,0,5,30,30
1649981912552,MATH 142A,B01,083221,Chow; Bennett,0,5,30,30
1649981912552,MATH 142A,B02,083222,Chow; Bennett,0,5,30,30
1649981918587,MATH 193A,A01,083224,Staff,0,5,30,30
1649981918587,MATH 193A,A02,083225,Staff,0,4,30,30
1649981918587,MATH 193A,A03,083781,Staff,1,0,30,29
1649981918587,MATH 193A,A04,083782,Staff,13,0,30,17
1649981924615,MATH 197,001,091859,McAuley; Julian John,9999,0,9999,0
1649981930663,COGS 9,A01,083615,Staff,0,7,60,60
1649981936686,COGS 11,A01,083617,Boyle; Mary E. T.,28,0,40,12
1649981942713,COGS 13,A01,083071,Staff,1,24,40,39
1649981948736,COGS 14A,A01,092681,Staff,16,0,100,84
1649981954759,COGS 14B,A01,083073,Cheng; Tzu-Han,6,0,50,44
1649981960785,COGS 17,A01,092677,Staff,48,0,75,27
1649981966806,COGS 100,A01,083619,Staff,1,15,60,59
1649981972837,COGS 101A,A01,083621,Davis; Joshua Daniel,0,17,60,60
1649981978878,COGS 101B,A01,091572,Staff,20,0,60,40
1649981984900,COGS 101C,A01,083625,Delgado; Tania,22,0,30,8
1649981990923,COGS 107A,A01,083627,Boyle; Mary E. T.,0,1,60,60
1649981996957,COGS 118A,A01,083075,Staff,21,0,60,39
1649982002981,CSE 3,A50,083646,Miranda; Gregory Joseph,22,0,38,16
1649982002981,CSE 3,A51,083647,Miranda; Gregory Joseph,37,0,37,0
1649982009004,CSE 8A,A50,083650,Miranda; Gregory Joseph,2,10,40,38
1649982015031,CSE 11,A01,083080,Cao; Yingjun,0,46,40,40
1649982021065,CSE 12,A01,083652,Staff,20,0,100,80
1649982027089,CSE 15L,A01,083654,Staff,0,0,50,50
1649982027089,CSE 15L,A02,083655,Staff,28,0,50,22
1649982033116,CSE 20,A01,083657,Staff,60,0,80,20
1649982039148,CSE 30,A01,083084,Eldon; John,0,51,40,40
1649982045171,CSE 100,A01,083659,Cao; Yingjun,1,53,50,49
1649982051196,CSE 134B,A01,083661,Powell; Thomas Allan,0,25,65,65
1649982057220,CSE 140,A01,083663,Staff,10,0,75,65
1649982063242,CSE 140L,A01,083088,Eldon; John,6,0,75,69
1649982069277,CSE 175,A01,083665,Kumar; Rakesh,10,0,25,15
1649982075309,CSE 190,A00,092507,Dubnov; Shlomo,17,0,20,3
1649982081332,ECE 45,A01,083139,Staff,0,6,40,40
1649982087358,ECE 65,A50,083695,Staff,2,0,30,28
1649982093381,ECE 109,A01,091882,Touri; Behrouz,50,0,70,20
1649982099412,ECE 180,A00,083140,Abi Samra; Nicholas Camill,26,0,30,4
1649982099412,ECE 180,B00,083141,Abi Samra; Nicholas Camill,10,0,30,20
1649982105438,MATH 10A,A01,083735,Patchell; Gregory David,17,0,30,13
1649982105438,MATH 10A,A02,083736,Patchell; Gregory David,28,0,30,2
1649982105438,MATH 10A,A03,083737,Patchell; Gregory David,27,0,30,3
1649982111463,MATH 10B,A01,083207,Staff,0,2,30,30
1649982111463,MATH 10B,A02,083208,Staff,17,0,30,13
1649982111463,MATH 10B,B01,083739,Staff,23,0,30,7
1649982111463,MATH 10B,B02,083740,Staff,30,0,30,0
1649982117495,MATH 18,A01,083743,Staff,17,0,30,13
1649982117495,MATH 18,A02,083744,Staff,29,0,30,1
1649982117495,MATH 18,A03,083745,Staff,26,0,30,4
1649982117495,MATH 18,A04,083746,Staff,27,0,30,3
1649982117495,MATH 18,B01,083748,Staff,0,2,30,30
1649982117495,MATH 18,B02,083749,Staff,0,0,30,30
1649982117495,MATH 18,B03,083750,Staff,15,0,30,15
1649982117495,MATH 18,B04,083751,Staff,9,0,30,21
1649982123517,MATH 20A,A01,083754,Staff,31,0,40,9
1649982129544,MATH 20B,A01,083756,Staff,4,0,30,26
1649982129544,MATH 20B,A02,083757,Staff,26,0,30,4
1649982135569,MATH 20C,A01,083760,Staff,0,1,30,30
1649982135569,MATH 20C,A02,083761,Staff,0,0,30,30
1649982135569,MATH 20C,B01,083762,Staff,23,0,30,7
1649982135569,MATH 20C,B02,083763,Staff,30,0,30,0
1649982141600,MATH 20D,A01,083765,Staff,0,0,30,30
1649982141600,MATH 20D,A02,083766,Staff,25,0,30,5
1649982141600,MATH 20D,A03,083767,Staff,28,0,30,2
1649982147626,MATH 20E,A01,083771,Staff,11,0,30,19
1649982147626,MATH 20E,A02,083772,Staff,21,0,30,9
1649982147626,MATH 20E,B01,083773,Staff,2,0,30,28
1649982147626,MATH 20E,B02,083774,Staff,26,0,30,4
1649982153658,MATH 103A,A01,083777,Staff,1,5,30,29
1649982153658,MATH 103A,A02,083778,Staff,0,5,30,30
1649982153658,MATH 103A,B01,083779,Staff,0,5,30,30
1649982153658,MATH 103A,B02,083780,Staff,0,5,30,30
1649982159679,MATH 105,A01,085443,Staff,0,10,30,30
1649982165706,MATH 109,A01,083213,Anzaldo; Leesa B,0,3,30,30
1649982165706,MATH 109,A02,083214,Anzaldo; Leesa B,1,2,30,29
1649982165706,MATH 109,B01,083215,Anzaldo; Leesa B,6,0,30,24
1649982165706,MATH 109,B02,083216,Anzaldo; Leesa B,0,0,30,30
1649982171730,MATH 142A,A01,083219,Chow; Bennett,0,6,30,30
1649982171730,MATH 142A,A02,083220,Chow; Bennett,0,5,30,30
1649982171730,MATH 142A,B01,083221,Chow; Bennett,0,5,30,30
1649982171730,MATH 142A,B02,083222,Chow; Bennett,0,5,30,30
1649982177766,MATH 193A,A01,083224,Staff,0,5,30,30
1649982177766,MATH 193A,A02,083225,Staff,0,4,30,30
1649982177766,MATH 193A,A03,083781,Staff,1,0,30,29
1649982177766,MATH 193A,A04,083782,Staff,13,0,30,17
1649982183889,MATH 197,001,091859,McAuley; Julian John,9999,0,9999,0
1649982190023,COGS 9,A01,083615,Staff,0,7,60,60
1649982196051,COGS 11,A01,083617,Boyle; Mary E. T.,28,0,40,12
1649982202077,COGS 13,A01,083071,Staff,1,25,40,39
1649982208099,COGS 14A,A01,092681,Staff,15,0,100,85
1649982214122,COGS 14B,A01,083073,Cheng; Tzu-Han,6,0,50,44
1649982220148,COGS 17,A01,092677,Staff,48,0,75,27
1649982226182,COGS 100,A01,083619,Staff,1,15,60,59
1649982232204,COGS 101A,A01,083621,Davis; Joshua Daniel,0,17,60,60
1649982238242,COGS 101B,A01,091572,Staff,20,0,60,40
1649982244265,COGS 101C,A01,083625,Delgado; Tania,22,0,30,8
1649982250289,COGS 107A,A01,083627,Boyle; Mary E. T.,0,1,60,60
1649982256311,COGS 118A,A01,083075,Staff,21,0,60,39
1649982262338,CSE 3,A50,083646,Miranda; Gregory Joseph,22,0,38,16
1649982262338,CSE 3,A51,083647,Miranda; Gregory Joseph,37,0,37,0
1649982268374,CSE 8A,A50,083650,Miranda; Gregory Joseph,2,10,40,38
1649982274402,CSE 11,A01,083080,Cao; Yingjun,0,46,40,40
1649982280429,CSE 12,A01,083652,Staff,20,0,100,80
1649982286452,CSE 15L,A01,083654,Staff,0,0,50,50
1649982286452,CSE 15L,A02,083655,Staff,28,0,50,22
1649982292496,CSE 20,A01,083657,Staff,60,0,80,20
1649982298518,CSE 30,A01,083084,Eldon; John,0,53,40,40
1649982304545,CSE 100,A01,083659,Cao; Yingjun,1,53,50,49
1649982310574,CSE 134B,A01,083661,Powell; Thomas Allan,0,25,65,65
1649982316599,CSE 140,A01,083663,Staff,10,0,75,65
1649982322622,CSE 140L,A01,083088,Eldon; John,6,0,75,69
1649982328667,CSE 175,A01,083665,Kumar; Rakesh,10,0,25,15
1649982334696,CSE 190,A00,092507,Dubnov; Shlomo,17,0,20,3
1649982340717,ECE 45,A01,083139,Staff,0,6,40,40
1649982346740,ECE 65,A50,083695,Staff,2,0,30,28
1649982352767,ECE 109,A01,091882,Touri; Behrouz,50,0,70,20
1649982358791,ECE 180,A00,083140,Abi Samra; Nicholas Camill,26,0,30,4
1649982358791,ECE 180,B00,083141,Abi Samra; Nicholas Camill,10,0,30,20
1649982364813,MATH 10A,A01,083735,Patchell; Gregory David,17,0,30,13
1649982364813,MATH 10A,A02,083736,Patchell; Gregory David,28,0,30,2
1649982364813,MATH 10A,A03,083737,Patchell; Gregory David,27,0,30,3
1649982370847,MATH 10B,A01,083207,Staff,0,2,30,30
1649982370847,MATH 10B,A02,083208,Staff,17,0,30,13
1649982370847,MATH 10B,B01,083739,Staff,23,0,30,7
1649982370847,MATH 10B,B02,083740,Staff,30,0,30,0
1649982376875,MATH 18,A01,083743,Staff,17,0,30,13
1649982376875,MATH 18,A02,083744,Staff,29,0,30,1
1649982376875,MATH 18,A03,083745,Staff,26,0,30,4
1649982376875,MATH 18,A04,083746,Staff,27,0,30,3
1649982376875,MATH 18,B01,083748,Staff,0,2,30,30
1649982376875,MATH 18,B02,083749,Staff,0,0,30,30
1649982376875,MATH 18,B03,083750,Staff,14,0,30,16
1649982376875,MATH 18,B04,083751,Staff,9,0,30,21
1649982382900,MATH 20A,A01,083754,Staff,31,0,40,9
1649982388928,MATH 20B,A01,083756,Staff,4,0,30,26
1649982388928,MATH 20B,A02,083757,Staff,26,0,30,4
1649982394951,MATH 20C,A01,083760,Staff,1,1,30,29
1649982394951,MATH 20C,A02,083761,Staff,0,1,30,30
1649982394951,MATH 20C,B01,083762,Staff,23,0,30,7
1649982394951,MATH 20C,B02,083763,Staff,30,0,30,0
1649982400985,MATH 20D,A01,083765,Staff,0,0,30,30
1649982400985,MATH 20D,A02,083766,Staff,25,0,30,5
1649982400985,MATH 20D,A03,083767,Staff,28,0,30,2
1649982407006,MATH 20E,A01,083771,Staff,11,0,30,19
1649982407006,MATH 20E,A02,083772,Staff,21,0,30,9
1649982407006,MATH 20E,B01,083773,Staff,2,0,30,28
1649982407006,MATH 20E,B02,083774,Staff,26,0,30,4
1649982413038,MATH 103A,A01,083777,Staff,1,5,30,29
1649982413038,MATH 103A,A02,083778,Staff,0,5,30,30
1649982413038,MATH 103A,B01,083779,Staff,0,5,30,30
1649982413038,MATH 103A,B02,083780,Staff,0,5,30,30
1649982419064,MATH 105,A01,085443,Staff,0,10,30,30
1649982425103,MATH 109,A01,083213,Anzaldo; Leesa B,0,3,30,30
1649982425103,MATH 109,A02,083214,Anzaldo; Leesa B,1,2,30,29
1649982425103,MATH 109,B01,083215,Anzaldo; Leesa B,6,0,30,24
1649982425103,MATH 109,B02,083216,Anzaldo; Leesa B,0,0,30,30
1649982431125,MATH 142A,A01,083219,Chow; Bennett,0,6,30,30
1649982431125,MATH 142A,A02,083220,Chow; Bennett,0,5,30,30
1649982431125,MATH 142A,B01,083221,Chow; Bennett,0,5,30,30
1649982431125,MATH 142A,B02,083222,Chow; Bennett,0,5,30,30
1649982437147,MATH 193A,A01,083224,Staff,0,5,30,30
1649982437147,MATH 193A,A02,083225,Staff,0,4,30,30
1649982437147,MATH 193A,A03,083781,Staff,1,0,30,29
1649982437147,MATH 193A,A04,083782,Staff,13,0,30,17
1649982443178,MATH 197,001,091859,McAuley; Julian John,9999,0,9999,0
1649982449225,COGS 9,A01,083615,Staff,0,7,60,60
1649982455248,COGS 11,A01,083617,Boyle; Mary E. T.,28,0,40,12
1649982461273,COGS 13,A01,083071,Staff,1,25,40,39
1649982467295,COGS 14A,A01,092681,Staff,14,0,100,86
1649982473316,COGS 14B,A01,083073,Cheng; Tzu-Han,6,0,50,44
1649982479349,COGS 17,A01,092677,Staff,48,0,75,27
1649982485371,COGS 100,A01,083619,Staff,1,15,60,59
1649982491397,COGS 101A,A01,083621,Davis; Joshua Daniel,0,17,60,60
1649982497422,COGS 101B,A01,091572,Staff,20,0,60,40
1649982503449,COGS 101C,A01,083625,Delgado; Tania,22,0,30,8
1649982509475,COGS 107A,A01,083627,Boyle; Mary E. T.,0,1,60,60
1649982515502,COGS 118A,A01,083075,Staff,21,0,60,39
1649982521527,CSE 3,A50,083646,Miranda; Gregory Joseph,22,0,38,16
1649982521527,CSE 3,A51,083647,Miranda; Gregory Joseph,37,0,37,0
1649982527549,CSE 8A,A50,083650,Miranda; Gregory Joseph,2,10,40,38
1649982533572,CSE 11,A01,083080,Cao; Yingjun,0,46,40,40
1649982539607,CSE 12,A01,083652,Staff,20,0,100,80
1649982545633,CSE 15L,A01,083654,Staff,0,0,50,50
1649982545633,CSE 15L,A02,083655,Staff,28,0,50,22
1649982551656,CSE 20,A01,083657,Staff,60,0,80,20
1649982557679,CSE 30,A01,083084,Eldon; John,0,53,40,40
1649982563717,CSE 100,A01,083659,Cao; Yingjun,1,53,50,49
1649982569744,CSE 134B,A01,083661,Powell; Thomas Allan,0,25,65,65
1649982575767,CSE 140,A01,083663,Staff,10,0,75,65
1649982581789,CSE 140L,A01,083088,Eldon; John,6,0,75,69
1649982587812,CSE 175,A01,083665,Kumar; Rakesh,10,0,25,15
1649982593832,CSE 190,A00,092507,Dubnov; Shlomo,17,0,20,3
1649982599854,ECE 45,A01,083139,Staff,0,6,40,40
1649982605878,ECE 65,A50,083695,Staff,2,0,30,28
1649982611904,ECE 109,A01,091882,Touri; Behrouz,50,0,70,20
1649982617929,ECE 180,A00,083140,Abi Samra; Nicholas Camill,26,0,30,4
1649982617929,ECE 180,B00,083141,Abi Samra; Nicholas Camill,10,0,30,20
1649982623951,MATH 10A,A01,083735,Patchell; Gregory David,17,0,30,13
1649982623951,MATH 10A,A02,083736,Patchell; Gregory David,28,0,30,2
1649982623951,MATH 10A,A03,083737,Patchell; Gregory David,27,0,30,3
1649982629986,MATH 10B,A01,083207,Staff,0,2,30,30
1649982629986,MATH 10B,A02,083208,Staff,17,0,30,13
1649982629986,MATH 10B,B01,083739,Staff,23,0,30,7
1649982629986,MATH 10B,B02,083740,Staff,30,0,30,0
1649982636025,MATH 18,A01,083743,Staff,17,0,30,13
1649982636025,MATH 18,A02,083744,Staff,29,0,30,1
1649982636025,MATH 18,A03,083745,Staff,26,0,30,4
1649982636025,MATH 18,A04,083746,Staff,27,0,30,3
1649982636025,MATH 18,B01,083748,Staff,0,2,30,30
1649982636025,MATH 18,B02,083749,Staff,0,0,30,30
1649982636025,MATH 18,B03,083750,Staff,14,0,30,16
1649982636025,MATH 18,B04,083751,Staff,9,0,30,21
1649982642060,MATH 20A,A01,083754,Staff,31,0,40,9
1649982648090,MATH 20B,A01,083756,Staff,4,0,30,26
1649982648090,MATH 20B,A02,083757,Staff,26,0,30,4
1649982654118,MATH 20C,A01,083760,Staff,1,1,30,29
1649982654118,MATH 20C,A02,083761,Staff,0,1,30,30
1649982654118,MATH 20C,B01,083762,Staff,23,0,30,7
1649982654118,MATH 20C,B02,083763,Staff,30,0,30,0
1649982660147,MATH 20D,A01,083765,Staff,0,0,30,30
1649982660147,MATH 20D,A02,083766,Staff,25,0,30,5
1649982660147,MATH 20D,A03,083767,Staff,28,0,30,2
1649982666174,MATH 20E,A01,083771,Staff,11,0,30,19
1649982666174,MATH 20E,A02,083772,Staff,21,0,30,9
1649982666174,MATH 20E,B01,083773,Staff,2,0,30,28
1649982666174,MATH 20E,B02,083774,Staff,26,0,30,4
1649982672205,MATH 103A,A01,083777,Staff,1,5,30,29
1649982672205,MATH 103A,A02,083778,Staff,0,5,30,30
1649982672205,MATH 103A,B01,083779,Staff,0,5,30,30
1649982672205,MATH 103A,B02,083780,Staff,0,5,30,30
1649982678231,MATH 105,A01,085443,Staff,0,10,30,30
1649982684261,MATH 109,A01,083213,Anzaldo; Leesa B,0,3,30,30
1649982684261,MATH 109,A02,083214,Anzaldo; Leesa B,1,2,30,29
1649982684261,MATH 109,B01,083215,Anzaldo; Leesa B,6,0,30,24
1649982684261,MATH 109,B02,083216,Anzaldo; Leesa B,0,0,30,30
1649982690302,MATH 142A,A01,083219,Chow; Bennett,0,6,30,30
1649982690302,MATH 142A,A02,083220,Chow; Bennett,0,5,30,30
1649982690302,MATH 142A,B01,083221,Chow; Bennett,0,5,30,30
1649982690302,MATH 142A,B02,083222,Chow; Bennett,0,5,30,30
1649982696331,MATH 193A,A01,083224,Staff,0,5,30,30
1649982696331,MATH 193A,A02,083225,Staff,0,4,30,30
1649982696331,MATH 193A,A03,083781,Staff,1,0,30,29
1649982696331,MATH 193A,A04,083782,Staff,12,0,30,18
1649982702356,MATH 197,001,091859,McAuley; Julian John,9999,0,9999,0
1649982708416,COGS 9,A01,083615,Staff,0,8,60,60
1649982714449,COGS 11,A01,083617,Boyle; Mary E. T.,28,0,40,12
1649982720471,COGS 13,A01,083071,Staff,1,25,40,39
1649982726497,COGS 14A,A01,092681,Staff,13,0,100,87
1649982732520,COGS 14B,A01,083073,Cheng; Tzu-Han,6,0,50,44
1649982738543,COGS 17,A01,092677,Staff,48,0,75,27
1649982744564,COGS 100,A01,083619,Staff,1,15,60,59
1649982750591,COGS 101A,A01,083621,Davis; Joshua Daniel,0,17,60,60
1649982756613,COGS 101B,A01,091572,Staff,20,0,60,40
1649982762635,COGS 101C,A01,083625,Delgado; Tania,22,0,30,8
1649982768667,COGS 107A,A01,083627,Boyle; Mary E. T.,0,1,60,60
1649982774779,COGS 118A,A01,083075,Staff,21,0,60,39
1649982780806,CSE 3,A50,083646,Miranda; Gregory Joseph,22,0,38,16
1649982780806,CSE 3,A51,083647,Miranda; Gregory Joseph,37,0,37,0
1649982786833,CSE 8A,A50,083650,Miranda; Gregory Joseph,2,10,40,38
1649982792856,CSE 11,A01,083080,Cao; Yingjun,0,47,40,40
1649982798883,CSE 12,A01,083652,Staff,19,0,100,81
1649982804906,CSE 15L,A01,083654,Staff,0,0,50,50
1649982804906,CSE 15L,A02,083655,Staff,28,0,50,22
1649982810943,CSE 20,A01,083657,Staff,60,0,80,20
1649982816969,CSE 30,A01,083084,Eldon; John,0,53,40,40
1649982822997,CSE 100,A01,083659,Cao; Yingjun,1,53,50,49
1649982829032,CSE 134B,A01,083661,Powell; Thomas Allan,0,25,65,65
1649982835056,CSE 140,A01,083663,Staff,10,0,75,65
1649982841082,CSE 140L,A01,083088,Eldon; John,6,0,75,69
1649982847115,CSE 175,A01,083665,Kumar; Rakesh,10,0,25,15
1649982853144,CSE 190,A00,092507,Dubnov; Shlomo,17,0,20,3
1649982859171,ECE 45,A01,083139,Staff,0,6,40,40
1649982865218,ECE 65,A50,083695,Staff,2,0,30,28
1649982871250,ECE 109,A01,091882,Touri; Behrouz,50,0,70,20
1649982877275,ECE 180,A00,083140,Abi Samra; Nicholas Camill,26,0,30,4
1649982877275,ECE 180,B00,083141,Abi Samra; Nicholas Camill,10,0,30,20
1649982883297,MATH 10A,A01,083735,Patchell; Gregory David,16,0,30,14
1649982883297,MATH 10A,A02,083736,Patchell; Gregory David,28,0,30,2
1649982883297,MATH 10A,A03,083737,Patchell; Gregory David,27,0,30,3
1649982889321,MATH 10B,A01,083207,Staff,0,2,30,30
1649982889321,MATH 10B,A02,083208,Staff,17,0,30,13
1649982889321,MATH 10B,B01,083739,Staff,22,0,30,8
1649982889321,MATH 10B,B02,083740,Staff,30,0,30,0
1649982895373,MATH 18,A01,083743,Staff,16,0,30,14
1649982895373,MATH 18,A02,083744,Staff,29,0,30,1
1649982895373,MATH 18,A03,083745,Staff,26,0,30,4
1649982895373,MATH 18,A04,083746,Staff,27,0,30,3
1649982895373,MATH 18,B01,083748,Staff,0,2,30,30
1649982895373,MATH 18,B02,083749,Staff,0,0,30,30
1649982895373,MATH 18,B03,083750,Staff,13,0,30,17
1649982895373,MATH 18,B04,083751,Staff,9,0,30,21
1649982901395,MATH 20A,A01,083754,Staff,31,0,40,9
1649982907418,MATH 20B,A01,083756,Staff,4,0,30,26
1649982907418,MATH 20B,A02,083757,Staff,26,0,30,4
1649982913442,MATH 20C,A01,083760,Staff,1,1,30,29
1649982913442,MATH 20C,A02,083761,Staff,0,1,30,30
1649982913442,MATH 20C,B01,083762,Staff,23,0,30,7
1649982913442,MATH 20C,B02,083763,Staff,30,0,30,0
1649982919469,MATH 20D,A01,083765,Staff,0,0,30,30
1649982919469,MATH 20D,A02,083766,Staff,25,0,30,5
1649982919469,MATH 20D,A03,083767,Staff,28,0,30,2
1649982925500,MATH 20E,A01,083771,Staff,11,0,30,19
1649982925500,MATH 20E,A02,083772,Staff,21,0,30,9
1649982925500,MATH 20E,B01,083773,Staff,2,0,30,28
1649982925500,MATH 20E,B02,083774,Staff,26,0,30,4
1649982931527,MATH 103A,A01,083777,Staff,1,5,30,29
1649982931527,MATH 103A,A02,083778,Staff,0,5,30,30
1649982931527,MATH 103A,B01,083779,Staff,0,5,30,30
1649982931527,MATH 103A,B02,083780,Staff,0,5,30,30
1649982937558,MATH 105,A01,085443,Staff,0,10,30,30
1649982943586,MATH 109,A01,083213,Anzaldo; Leesa B,0,3,30,30
1649982943586,MATH 109,A02,083214,Anzaldo; Leesa B,1,2,30,29
1649982943586,MATH 109,B01,083215,Anzaldo; Leesa B,6,0,30,24
1649982943586,MATH 109,B02,083216,Anzaldo; Leesa B,0,0,30,30
1649982949616,MATH 142A,A01,083219,Chow; Bennett,0,6,30,30
1649982949616,MATH 142A,A02,083220,Chow; Bennett,0,5,30,30
1649982949616,MATH 142A,B01,083221,Chow; Bennett,0,5,30,30
1649982949616,MATH 142A,B02,083222,Chow; Bennett,0,5,30,30
1649982955640,MATH 193A,A01,083224,Staff,0,5,30,30
1649982955640,MATH 193A,A02,083225,Staff,0,4,30,30
1649982955640,MATH 193A,A03,083781,Staff,1,0,30,29
1649982955640,MATH 193A,A04,083782,Staff,12,0,30,18
1649982961672,MATH 197,001,091859,McAuley; Julian John,9999,0,9999,0
1649982967753,COGS 9,A01,083615,Staff,0,8,60,60
1649982973774,COGS 11,A01,083617,Boyle; Mary E. T.,28,0,40,12
1649982979808,COGS 13,A01,083071,Staff,1,25,40,39
1649982985833,COGS 14A,A01,092681,Staff,13,0,100,87
1649982991856,COGS 14B,A01,083073,Cheng; Tzu-Han,6,0,50,44
1649982997884,COGS 17,A01,092677,Staff,48,0,75,27
1649983003910,COGS 100,A01,083619,Staff,1,15,60,59
1649983009933,COGS 101A,A01,083621,Davis; Joshua Daniel,0,17,60,60
1649983015970,COGS 101B,A01,091572,Staff,20,0,60,40
1649983021995,COGS 101C,A01,083625,Delgado; Tania,22,0,30,8
1649983028019,COGS 107A,A01,083627,Boyle; Mary E. T.,0,1,60,60
1649983034054,COGS 118A,A01,083075,Staff,21,0,60,39
1649983040078,CSE 3,A50,083646,Miranda; Gregory Joseph,22,0,38,16
1649983040078,CSE 3,A51,083647,Miranda; Gregory Joseph,37,0,37,0
1649983046103,CSE 8A,A50,083650,Miranda; Gregory Joseph,2,10,40,38
1649983052125,CSE 11,A01,083080,Cao; Yingjun,0,47,40,40
1649983058147,CSE 12,A01,083652,Staff,19,0,100,81
1649983064176,CSE 15L,A01,083654,Staff,0,0,50,50
1649983064176,CSE 15L,A02,083655,Staff,28,0,50,22
1649983070199,CSE 20,A01,083657,Staff,60,0,80,20
1649983076223,CSE 30,A01,083084,Eldon; John,0,53,40,40
1649983082249,CSE 100,A01,083659,Cao; Yingjun,1,53,50,49
1649983088279,CSE 134B,A01,083661,Powell; Thomas Allan,0,25,65,65
1649983094301,CSE 140,A01,083663,Staff,10,0,75,65
1649983100323,CSE 140L,A01,083088,Eldon; John,6,0,75,69
1649983106351,CSE 175,A01,083665,Kumar; Rakesh,10,0,25,15
1649983112393,CSE 190,A00,092507,Dubnov; Shlomo,17,0,20,3
1649983118416,ECE 45,A01,083139,Staff,0,6,40,40
1649983124436,ECE 65,A50,083695,Staff,2,0,30,28
1649983130464,ECE 109,A01,091882,Touri; Behrouz,50,0,70,20
1649983136494,ECE 180,A00,083140,Abi Samra; Nicholas Camill,26,0,30,4
1649983136494,ECE 180,B00,083141,Abi Samra; Nicholas Camill,10,0,30,20
1649983142529,MATH 10A,A01,083735,Patchell; Gregory David,16,0,30,14
1649983142529,MATH 10A,A02,083736,Patchell; Gregory David,28,0,30,2
1649983142529,MATH 10A,A03,083737,Patchell; Gregory David,27,0,30,3
1649983148562,MATH 10B,A01,083207,Staff,0,2,30,30
1649983148562,MATH 10B,A02,083208,Staff,17,0,30,13
1649983148562,MATH 10B,B01,083739,Staff,22,0,30,8
1649983148562,MATH 10B,B02,083740,Staff,30,0,30,0
1649983154589,MATH 18,A01,083743,Staff,16,0,30,14
1649983154589,MATH 18,A02,083744,Staff,29,0,30,1
1649983154589,MATH 18,A03,083745,Staff,26,0,30,4
1649983154589,MATH 18,A04,083746,Staff,27,0,30,3
1649983154589,MATH 18,B01,083748,Staff,0,2,30,30
1649983154589,MATH 18,B02,083749,Staff,0,0,30,30
1649983154589,MATH 18,B03,083750,Staff,13,0,30,17
1649983154589,MATH 18,B04,083751,Staff,9,0,30,21
1649983160621,MATH 20A,A01,083754,Staff,31,0,40,9
1649983166647,MATH 20B,A01,083756,Staff,4,0,30,26
1649983166647,MATH 20B,A02,083757,Staff,26,0,30,4
1649983172679,MATH 20C,A01,083760,Staff,1,1,30,29
1649983172679,MATH 20C,A02,083761,Staff,0,1,30,30
1649983172679,MATH 20C,B01,083762,Staff,23,0,30,7
1649983172679,MATH 20C,B02,083763,Staff,30,0,30,0
1649983178705,MATH 20D,A01,083765,Staff,0,0,30,30
1649983178705,MATH 20D,A02,083766,Staff,25,0,30,5
1649983178705,MATH 20D,A03,083767,Staff,28,0,30,2
1649983184731,MATH 20E,A01,083771,Staff,11,0,30,19
1649983184731,MATH 20E,A02,083772,Staff,21,0,30,9
1649983184731,MATH 20E,B01,083773,Staff,2,0,30,28
1649983184731,MATH 20E,B02,083774,Staff,26,0,30,4
1649983190756,MATH 103A,A01,083777,Staff,1,5,30,29
1649983190756,MATH 103A,A02,083778,Staff,0,5,30,30
1649983190756,MATH 103A,B01,083779,Staff,0,5,30,30
1649983190756,MATH 103A,B02,083780,Staff,0,5,30,30
1649983196779,MATH 105,A01,085443,Staff,0,10,30,30
1649983202802,MATH 109,A01,083213,Anzaldo; Leesa B,0,3,30,30
1649983202802,MATH 109,A02,083214,Anzaldo; Leesa B,1,2,30,29
1649983202802,MATH 109,B01,083215,Anzaldo; Leesa B,6,0,30,24
1649983202802,MATH 109,B02,083216,Anzaldo; Leesa B,0,0,30,30
1649983208830,MATH 142A,A01,083219,Chow; Bennett,0,6,30,30
1649983208830,MATH 142A,A02,083220,Chow; Bennett,0,5,30,30
1649983208830,MATH 142A,B01,083221,Chow; Bennett,0,5,30,30
1649983208830,MATH 142A,B02,083222,Chow; Bennett,0,5,30,30
1649983214864,MATH 193A,A01,083224,Staff,0,5,30,30
1649983214864,MATH 193A,A02,083225,Staff,0,4,30,30
1649983214864,MATH 193A,A03,083781,Staff,1,0,30,29
1649983214864,MATH 193A,A04,083782,Staff,12,0,30,18
1649983220891,MATH 197,001,091859,McAuley; Julian John,9999,0,9999,0
1649983226942,COGS 9,A01,083615,Staff,0,8,60,60
1649983232968,COGS 11,A01,083617,Boyle; Mary E. T.,28,0,40,12
1649983238992,COGS 13,A01,083071,Staff,1,25,40,39
1649983245016,COGS 14A,A01,092681,Staff,13,0,100,87
1649983251043,COGS 14B,A01,083073,Cheng; Tzu-Han,6,0,50,44
1649983257067,COGS 17,A01,092677,Staff,47,0,75,28
1649983263090,COGS 100,A01,083619,Staff,1,15,60,59
1649983269118,COGS 101A,A01,083621,Davis; Joshua Daniel,0,17,60,60
1649983275141,COGS 101B,A01,091572,Staff,20,0,60,40
1649983281166,COGS 101C,A01,083625,Delgado; Tania,22,0,30,8
1649983287189,COGS 107A,A01,083627,Boyle; Mary E. T.,0,1,60,60
1649983293214,COGS 118A,A01,083075,Staff,21,0,60,39
1649983299241,CSE 3,A50,083646,Miranda; Gregory Joseph,22,0,38,16
1649983299241,CSE 3,A51,083647,Miranda; Gregory Joseph,37,0,37,0
1649983305268,CSE 8A,A50,083650,Miranda; Gregory Joseph,2,10,40,38
1649983311291,CSE 11,A01,083080,Cao; Yingjun,0,47,40,40
1649983317313,CSE 12,A01,083652,Staff,19,0,100,81
1649983323342,CSE 15L,A01,083654,Staff,0,0,50,50
1649983323342,CSE 15L,A02,083655,Staff,28,0,50,22
1649983329364,CSE 20,A01,083657,Staff,60,0,80,20
1649983335387,CSE 30,A01,083084,Eldon; John,0,53,40,40
1649983341414,CSE 100,A01,083659,Cao; Yingjun,1,54,50,49
1649983347451,CSE 134B,A01,083661,Powell; Thomas Allan,0,26,65,65
1649983353473,CSE 140,A01,083663,Staff,10,0,75,65
1649983359500,CSE 140L,A01,083088,Eldon; John,6,0,75,69
1649983365523,CSE 175,A01,083665,Kumar; Rakesh,10,0,25,15
1649983371655,CSE 190,A00,092507,Dubnov; Shlomo,17,0,20,3
1649983377680,ECE 45,A01,083139,Staff,0,6,40,40
1649983383702,ECE 65,A50,083695,Staff,2,0,30,28
1649983389728,ECE 109,A01,091882,Touri; Behrouz,50,0,70,20
1649983395753,ECE 180,A00,083140,Abi Samra; Nicholas Camill,26,0,30,4
1649983395753,ECE 180,B00,083141,Abi Samra; Nicholas Camill,10,0,30,20
1649983401787,MATH 10A,A01,083735,Patchell; Gregory David,16,0,30,14
1649983401787,MATH 10A,A02,083736,Patchell; Gregory David,28,0,30,2
1649983401787,MATH 10A,A03,083737,Patchell; Gregory David,27,0,30,3
1649983407814,MATH 10B,A01,083207,Staff,0,2,30,30
1649983407814,MATH 10B,A02,083208,Staff,16,0,30,14
1649983407814,MATH 10B,B01,083739,Staff,22,0,30,8
1649983407814,MATH 10B,B02,083740,Staff,30,0,30,0
1649983413842,MATH 18,A01,083743,Staff,16,0,30,14
1649983413842,MATH 18,A02,083744,Staff,29,0,30,1
1649983413842,MATH 18,A03,083745,Staff,26,0,30,4
1649983413842,MATH 18,A04,083746,Staff,27,0,30,3
1649983413842,MATH 18,B01,083748,Staff,0,2,30,30
1649983413842,MATH 18,B02,083749,Staff,0,0,30,30
1649983413842,MATH 18,B03,083750,Staff,10,0,30,20
1649983413842,MATH 18,B04,083751,Staff,9,0,30,21
1649983419872,MATH 20A,A01,083754,Staff,31,0,40,9
1649983425896,MATH 20B,A01,083756,Staff,3,0,30,27
1649983425896,MATH 20B,A02,083757,Staff,26,0,30,4
1649983431922,MATH 20C,A01,083760,Staff,1,1,30,29
1649983431922,MATH 20C,A02,083761,Staff,0,1,30,30
1649983431922,MATH 20C,B01,083762,Staff,23,0,30,7
1649983431922,MATH 20C,B02,083763,Staff,30,0,30,0
1649983437946,MATH 20D,A01,083765,Staff,0,0,30,30
1649983437946,MATH 20D,A02,083766,Staff,24,0,30,6
1649983437946,MATH 20D,A03,083767,Staff,28,0,30,2
1649983443974,MATH 20E,A01,083771,Staff,11,0,30,19
1649983443974,MATH 20E,A02,083772,Staff,21,0,30,9
1649983443974,MATH 20E,B01,083773,Staff,2,0,30,28
1649983443974,MATH 20E,B02,083774,Staff,26,0,30,4
1649983449998,MATH 103A,A01,083777,Staff,1,5,30,29
1649983449998,MATH 103A,A02,083778,Staff,0,5,30,30
1649983449998,MATH 103A,B01,083779,Staff,0,5,30,30
1649983449998,MATH 103A,B02,083780,Staff,0,5,30,30
1649983456025,MATH 105,A01,085443,Staff,0,10,30,30
1649983462065,MATH 109,A01,083213,Anzaldo; Leesa B,0,3,30,30
1649983462065,MATH 109,A02,083214,Anzaldo; Leesa B,1,2,30,29
1649983462065,MATH 109,B01,083215,Anzaldo; Leesa B,6,0,30,24
1649983462065,MATH 109,B02,083216,Anzaldo; Leesa B,0,0,30,30
1649983468091,MATH 142A,A01,083219,Chow; Bennett,0,6,30,30
1649983468091,MATH 142A,A02,083220,Chow; Bennett,0,5,30,30
1649983468091,MATH 142A,B01,083221,Chow; Bennett,0,5,30,30
1649983468091,MATH 142A,B02,083222,Chow; Bennett,0,5,30,30
1649983474115,MATH 193A,A01,083224,Staff,0,5,30,30
1649983474115,MATH 193A,A02,083225,Staff,0,4,30,30
1649983474115,MATH 193A,A03,083781,Staff,1,0,30,29
1649983474115,MATH 193A,A04,083782,Staff,12,0,30,18
1649983480137,MATH 197,001,091859,McAuley; Julian John,9999,0,9999,0
1649983486197,COGS 9,A01,083615,Staff,0,8,60,60
1649983492220,COGS 11,A01,083617,Boyle; Mary E. T.,28,0,40,12
1649983498245,COGS 13,A01,083071,Staff,1,25,40,39
1649983504267,COGS 14A,A01,092681,Staff,13,0,100,87
1649983510291,COGS 14B,A01,083073,Cheng; Tzu-Han,6,0,50,44
1649983516321,COGS 17,A01,092677,Staff,47,0,75,28
1649983522366,COGS 100,A01,083619,Staff,1,15,60,59
1649983528388,COGS 101A,A01,083621,Davis; Joshua Daniel,0,17,60,60
1649983534411,COGS 101B,A01,091572,Staff,20,0,60,40
1649983540441,COGS 101C,A01,083625,Delgado; Tania,22,0,30,8
1649983546465,COGS 107A,A01,083627,Boyle; Mary E. T.,0,1,60,60
1649983552488,COGS 118A,A01,083075,Staff,21,0,60,39
1649983558513,CSE 3,A50,083646,Miranda; Gregory Joseph,22,0,38,16
1649983558513,CSE 3,A51,083647,Miranda; Gregory Joseph,37,0,37,0
1649983564536,CSE 8A,A50,083650,Miranda; Gregory Joseph,2,10,40,38
1649983570567,CSE 11,A01,083080,Cao; Yingjun,0,47,40,40
1649983576591,CSE 12,A01,083652,Staff,19,0,100,81
1649983582627,CSE 15L,A01,083654,Staff,0,0,50,50
1649983582627,CSE 15L,A02,083655,Staff,28,0,50,22
1649983588649,CSE 20,A01,083657,Staff,60,0,80,20
1649983594675,CSE 30,A01,083084,Eldon; John,0,53,40,40
1649983600704,CSE 100,A01,083659,Cao; Yingjun,1,54,50,49
1649983606726,CSE 134B,A01,083661,Powell; Thomas Allan,0,26,65,65
1649983612753,CSE 140,A01,083663,Staff,10,0,75,65
1649983618784,CSE 140L,A01,083088,Eldon; John,6,0,75,69
1649983624807,CSE 175,A01,083665,Kumar; Rakesh,10,0,25,15
1649983630831,CSE 190,A00,092507,Dubnov; Shlomo,17,0,20,3
1649983636854,ECE 45,A01,083139,Staff,0,6,40,40
1649983642884,ECE 65,A50,083695,Staff,2,0,30,28
1649983648908,ECE 109,A01,091882,Touri; Behrouz,50,0,70,20
1649983654943,ECE 180,A00,083140,Abi Samra; Nicholas Camill,26,0,30,4
1649983654943,ECE 180,B00,083141,Abi Samra; Nicholas Camill,10,0,30,20
1649983660968,MATH 10A,A01,083735,Patchell; Gregory David,16,0,30,14
1649983660968,MATH 10A,A02,083736,Patchell; Gregory David,28,0,30,2
1649983660968,MATH 10A,A03,083737,Patchell; Gregory David,27,0,30,3
1649983666991,MATH 10B,A01,083207,Staff,0,2,30,30
1649983666991,MATH 10B,A02,083208,Staff,15,0,30,15
1649983666991,MATH 10B,B01,083739,Staff,22,0,30,8
1649983666991,MATH 10B,B02,083740,Staff,30,0,30,0
1649983673017,MATH 18,A01,083743,Staff,16,0,30,14
1649983673017,MATH 18,A02,083744,Staff,29,0,30,1
1649983673017,MATH 18,A03,083745,Staff,26,0,30,4
1649983673017,MATH 18,A04,083746,Staff,27,0,30,3
1649983673017,MATH 18,B01,083748,Staff,0,2,30,30
1649983673017,MATH 18,B02,083749,Staff,0,0,30,30
1649983673017,MATH 18,B03,083750,Staff,9,0,30,21
1649983673017,MATH 18,B04,083751,Staff,9,0,30,21
1649983679041,MATH 20A,A01,083754,Staff,31,0,40,9
1649983685069,MATH 20B,A01,083756,Staff,3,0,30,27
1649983685069,MATH 20B,A02,083757,Staff,26,0,30,4
1649983691094,MATH 20C,A01,083760,Staff,1,1,30,29
1649983691094,MATH 20C,A02,083761,Staff,0,1,30,30
1649983691094,MATH 20C,B01,083762,Staff,23,0,30,7
1649983691094,MATH 20C,B02,083763,Staff,30,0,30,0
1649983697117,MATH 20D,A01,083765,Staff,0,0,30,30
1649983697117,MATH 20D,A02,083766,Staff,24,0,30,6
1649983697117,MATH 20D,A03,083767,Staff,28,0,30,2
1649983703140,MATH 20E,A01,083771,Staff,11,0,30,19
1649983703140,MATH 20E,A02,083772,Staff,21,0,30,9
1649983703140,MATH 20E,B01,083773,Staff,2,0,30,28
1649983703140,MATH 20E,B02,083774,Staff,26,0,30,4
1649983709167,MATH 103A,A01,083777,Staff,1,5,30,29
1649983709167,MATH 103A,A02,083778,Staff,0,5,30,30
1649983709167,MATH 103A,B01,083779,Staff,0,5,30,30
1649983709167,MATH 103A,B02,083780,Staff,0,5,30,30
1649983715190,MATH 105,A01,085443,Staff,0,10,30,30
1649983721213,MATH 109,A01,083213,Anzaldo; Leesa B,0,3,30,30
1649983721213,MATH 109,A02,083214,Anzaldo; Leesa B,1,2,30,29
1649983721213,MATH 109,B01,083215,Anzaldo; Leesa B,6,0,30,24
1649983721213,MATH 109,B02,083216,Anzaldo; Leesa B,0,0,30,30
1649983727236,MATH 142A,A01,083219,Chow; Bennett,0,6,30,30
1649983727236,MATH 142A,A02,083220,Chow; Bennett,0,5,30,30
1649983727236,MATH 142A,B01,083221,Chow; Bennett,0,5,30,30
1649983727236,MATH 142A,B02,083222,Chow; Bennett,0,5,30,30
1649983733259,MATH 193A,A01,083224,Staff,0,5,30,30
1649983733259,MATH 193A,A02,083225,Staff,0,4,30,30
1649983733259,MATH 193A,A03,083781,Staff,1,0,30,29
1649983733259,MATH 193A,A04,083782,Staff,12,0,30,18
1649983739283,MATH 197,001,091859,McAuley; Julian John,9999,0,9999,0
1649983745334,COGS 9,A01,083615,Staff,0,8,60,60
1649983751357,COGS 11,A01,083617,Boyle; Mary E. T.,28,0,40,12
1649983757380,COGS 13,A01,083071,Staff,1,25,40,39
1649983763405,COGS 14A,A01,092681,Staff,12,0,100,88
1649983769428,COGS 14B,A01,083073,Cheng; Tzu-Han,6,0,50,44
1649983775451,COGS 17,A01,092677,Staff,47,0,75,28
1649983781476,COGS 100,A01,083619,Staff,1,15,60,59
1649983787499,COGS 101A,A01,083621,Davis; Joshua Daniel,0,17,60,60
1649983793557,COGS 101B,A01,091572,Staff,20,0,60,40
1649983799580,COGS 101C,A01,083625,Delgado; Tania,22,0,30,8
1649983805603,COGS 107A,A01,083627,Boyle; Mary E. T.,0,1,60,60
1649983811627,COGS 118A,A01,083075,Staff,21,0,60,39
1649983817649,CSE 3,A50,083646,Miranda; Gregory Joseph,22,0,38,16
1649983817649,CSE 3,A51,083647,Miranda; Gregory Joseph,37,0,37,0
1649983823684,CSE 8A,A50,083650,Miranda; Gregory Joseph,2,10,40,38
1649983829710,CSE 11,A01,083080,Cao; Yingjun,0,48,40,40
1649983835734,CSE 12,A01,083652,Staff,19,0,100,81
1649983841759,CSE 15L,A01,083654,Staff,0,0,50,50
1649983841759,CSE 15L,A02,083655,Staff,28,0,50,22
1649983847792,CSE 20,A01,083657,Staff,60,0,80,20
1649983853819,CSE 30,A01,083084,Eldon; John,0,53,40,40
1649983859845,CSE 100,A01,083659,Cao; Yingjun,1,54,50,49
1649983865870,CSE 134B,A01,083661,Powell; Thomas Allan,0,26,65,65
1649983871894,CSE 140,A01,083663,Staff,10,0,75,65
1649983877916,CSE 140L,A01,083088,Eldon; John,6,0,75,69
1649983883946,CSE 175,A01,083665,Kumar; Rakesh,10,0,25,15
1649983889967,CSE 190,A00,092507,Dubnov; Shlomo,17,0,20,3
1649983895996,ECE 45,A01,083139,Staff,0,6,40,40
1649983902019,ECE 65,A50,083695,Staff,2,0,30,28
1649983908045,ECE 109,A01,091882,Touri; Behrouz,50,0,70,20
1649983914073,ECE 180,A00,083140,Abi Samra; Nicholas Camill,26,0,30,4
1649983914073,ECE 180,B00,083141,Abi Samra; Nicholas Camill,10,0,30,20
1649983920104,MATH 10A,A01,083735,Patchell; Gregory David,16,0,30,14
1649983920104,MATH 10A,A02,083736,Patchell; Gregory David,28,0,30,2
1649983920104,MATH 10A,A03,083737,Patchell; Gregory David,27,0,30,3
1649983926132,MATH 10B,A01,083207,Staff,0,2,30,30
1649983926132,MATH 10B,A02,083208,Staff,14,0,30,16
1649983926132,MATH 10B,B01,083739,Staff,22,0,30,8
1649983926132,MATH 10B,B02,083740,Staff,30,0,30,0
1649983932162,MATH 18,A01,083743,Staff,16,0,30,14
1649983932162,MATH 18,A02,083744,Staff,29,0,30,1
1649983932162,MATH 18,A03,083745,Staff,26,0,30,4
1649983932162,MATH 18,A04,083746,Staff,27,0,30,3
1649983932162,MATH 18,B01,083748,Staff,0,2,30,30
1649983932162,MATH 18,B02,083749,Staff,0,0,30,30
1649983932162,MATH 18,B03,083750,Staff,9,0,30,21
1649983932162,MATH 18,B04,083751,Staff,9,0,30,21
1649983938186,MATH 20A,A01,083754,Staff,31,0,40,9
1649983944220,MATH 20B,A01,083756,Staff,2,0,30,28
1649983944220,MATH 20B,A02,083757,Staff,26,0,30,4
1649983950266,MATH 20C,A01,083760,Staff,1,1,30,29
1649983950266,MATH 20C,A02,083761,Staff,0,1,30,30
1649983950266,MATH 20C,B01,083762,Staff,23,0,30,7
1649983950266,MATH 20C,B02,083763,Staff,30,0,30,0
1649983956290,MATH 20D,A01,083765,Staff,0,0,30,30
1649983956290,MATH 20D,A02,083766,Staff,24,0,30,6
1649983956290,MATH 20D,A03,083767,Staff,28,0,30,2
1649983962320,MATH 20E,A01,083771,Staff,11,0,30,19
1649983962320,MATH 20E,A02,083772,Staff,21,0,30,9
1649983962320,MATH 20E,B01,083773,Staff,2,0,30,28
1649983962320,MATH 20E,B02,083774,Staff,26,0,30,4
1649983968436,MATH 103A,A01,083777,Staff,1,5,30,29
1649983968436,MATH 103A,A02,083778,Staff,0,5,30,30
1649983968436,MATH 103A,B01,083779,Staff,0,6,30,30
1649983968436,MATH 103A,B02,083780,Staff,0,5,30,30
1649983974459,MATH 105,A01,085443,Staff,0,10,30,30
1649983980497,MATH 109,A01,083213,Anzaldo; Leesa B,0,3,30,30
1649983980497,MATH 109,A02,083214,Anzaldo; Leesa B,1,2,30,29
1649983980497,MATH 109,B01,083215,Anzaldo; Leesa B,6,0,30,24
1649983980497,MATH 109,B02,083216,Anzaldo; Leesa B,0,0,30,30
1649983986521,MATH 142A,A01,083219,Chow; Bennett,0,6,30,30
1649983986521,MATH 142A,A02,083220,Chow; Bennett,0,5,30,30
1649983986521,MATH 142A,B01,083221,Chow; Bennett,0,5,30,30
1649983986521,MATH 142A,B02,083222,Chow; Bennett,0,5,30,30
1649983992548,MATH 193A,A01,083224,Staff,0,5,30,30
1649983992548,MATH 193A,A02,083225,Staff,0,4,30,30
1649983992548,MATH 193A,A03,083781,Staff,1,0,30,29
1649983992548,MATH 193A,A04,083782,Staff,12,0,30,18
1649983998572,MATH 197,001,091859,McAuley; Julian John,9999,0,9999,0
1649984004633,COGS 9,A01,083615,Staff,0,8,60,60
1649984010663,COGS 11,A01,083617,Boyle; Mary E. T.,28,0,40,12
1649984016688,COGS 13,A01,083071,Staff,1,25,40,39
1649984022713,COGS 14A,A01,092681,Staff,12,0,100,88
1649984028740,COGS 14B,A01,083073,Cheng; Tzu-Han,6,0,50,44
1649984034763,COGS 17,A01,092677,Staff,47,0,75,28
1649984040786,COGS 100,A01,083619,Staff,1,15,60,59
1649984046810,COGS 101A,A01,083621,Davis; Joshua Daniel,0,17,60,60
1649984052835,COGS 101B,A01,091572,Staff,20,0,60,40
1649984058859,COGS 101C,A01,083625,Delgado; Tania,22,0,30,8
1649984064886,COGS 107A,A01,083627,Boyle; Mary E. T.,0,1,60,60
1649984070908,COGS 118A,A01,083075,Staff,21,0,60,39
1649984076931,CSE 3,A50,083646,Miranda; Gregory Joseph,22,0,38,16
1649984076931,CSE 3,A51,083647,Miranda; Gregory Joseph,37,0,37,0
1649984082958,CSE 8A,A50,083650,Miranda; Gregory Joseph,2,10,40,38
1649984088980,CSE 11,A01,083080,Cao; Yingjun,0,50,40,40
1649984095003,CSE 12,A01,083652,Staff,19,0,100,81
1649984101032,CSE 15L,A01,083654,Staff,0,0,50,50
1649984101032,CSE 15L,A02,083655,Staff,28,0,50,22
1649984107054,CSE 20,A01,083657,Staff,60,0,80,20
1649984113077,CSE 30,A01,083084,Eldon; John,0,53,40,40
1649984119101,CSE 100,A01,083659,Cao; Yingjun,1,54,50,49
1649984125141,CSE 134B,A01,083661,Powell; Thomas Allan,0,26,65,65
1649984131168,CSE 140,A01,083663,Staff,10,0,75,65
1649984137195,CSE 140L,A01,083088,Eldon; John,6,0,75,69
1649984143220,CSE 175,A01,083665,Kumar; Rakesh,10,0,25,15
1649984149248,CSE 190,A00,092507,Dubnov; Shlomo,17,0,20,3
1649984155274,ECE 45,A01,083139,Staff,0,6,40,40
1649984161297,ECE 65,A50,083695,Staff,2,0,30,28
1649984167323,ECE 109,A01,091882,Touri; Behrouz,50,0,70,20
1649984173350,ECE 180,A00,083140,Abi Samra; Nicholas Camill,26,0,30,4
1649984173350,ECE 180,B00,083141,Abi Samra; Nicholas Camill,10,0,30,20
1649984179374,MATH 10A,A01,083735,Patchell; Gregory David,16,0,30,14
1649984179374,MATH 10A,A02,083736,Patchell; Gregory David,28,0,30,2
1649984179374,MATH 10A,A03,083737,Patchell; Gregory David,27,0,30,3
1649984185401,MATH 10B,A01,083207,Staff,0,2,30,30
1649984185401,MATH 10B,A02,083208,Staff,14,0,30,16
1649984185401,MATH 10B,B01,083739,Staff,22,0,30,8
1649984185401,MATH 10B,B02,083740,Staff,30,0,30,0
1649984191426,MATH 18,A01,083743,Staff,16,0,30,14
1649984191426,MATH 18,A02,083744,Staff,29,0,30,1
1649984191426,MATH 18,A03,083745,Staff,26,0,30,4
1649984191426,MATH 18,A04,083746,Staff,27,0,30,3
1649984191426,MATH 18,B01,083748,Staff,0,2,30,30
1649984191426,MATH 18,B02,083749,Staff,0,0,30,30
1649984191426,MATH 18,B03,083750,Staff,9,0,30,21
1649984191426,MATH 18,B04,083751,Staff,9,0,30,21
1649984197454,MATH 20A,A01,083754,Staff,31,0,40,9
1649984203480,MATH 20B,A01,083756,Staff,2,0,30,28
1649984203480,MATH 20B,A02,083757,Staff,26,0,30,4
1649984209504,MATH 20C,A01,083760,Staff,1,1,30,29
1649984209504,MATH 20C,A02,083761,Staff,0,1,30,30
1649984209504,MATH 20C,B01,083762,Staff,23,0,30,7
1649984209504,MATH 20C,B02,083763,Staff,30,0,30,0
1649984215545,MATH 20D,A01,083765,Staff,0,0,30,30
1649984215545,MATH 20D,A02,083766,Staff,24,0,30,6
1649984215545,MATH 20D,A03,083767,Staff,28,0,30,2
1649984221572,MATH 20E,A01,083771,Staff,11,0,30,19
1649984221572,MATH 20E,A02,083772,Staff,21,0,30,9
1649984221572,MATH 20E,B01,083773,Staff,2,0,30,28
1649984221572,MATH 20E,B02,083774,Staff,26,0,30,4
1649984227608,MATH 103A,A01,083777,Staff,1,5,30,29
1649984227608,MATH 103A,A02,083778,Staff,0,5,30,30
1649984227608,MATH 103A,B01,083779,Staff,0,6,30,30
1649984227608,MATH 103A,B02,083780,Staff,0,5,30,30
1649984233631,MATH 105,A01,085443,Staff,0,10,30,30
1649984239654,MATH 109,A01,083213,Anzaldo; Leesa B,0,3,30,30
1649984239654,MATH 109,A02,083214,Anzaldo; Leesa B,1,2,30,29
1649984239654,MATH 109,B01,083215,Anzaldo; Leesa B,6,0,30,24
1649984239654,MATH 109,B02,083216,Anzaldo; Leesa B,0,0,30,30
1649984245678,MATH 142A,A01,083219,Chow; Bennett,0,6,30,30
1649984245678,MATH 142A,A02,083220,Chow; Bennett,0,5,30,30
1649984245678,MATH 142A,B01,083221,Chow; Bennett,0,5,30,30
1649984245678,MATH 142A,B02,083222,Chow; Bennett,0,5,30,30
1649984251704,MATH 193A,A01,083224,Staff,0,5,30,30
1649984251704,MATH 193A,A02,083225,Staff,0,4,30,30
1649984251704,MATH 193A,A03,083781,Staff,1,0,30,29
1649984251704,MATH 193A,A04,083782,Staff,12,0,30,18
1649984257727,MATH 197,001,091859,McAuley; Julian John,9999,0,9999,0
1649984263786,COGS 9,A01,083615,Staff,0,8,60,60
1649984269809,COGS 11,A01,083617,Boyle; Mary E. T.,28,0,40,12
1649984275831,COGS 13,A01,083071,Staff,1,25,40,39
1649984281855,COGS 14A,A01,092681,Staff,12,0,100,88
1649984287883,COGS 14B,A01,083073,Cheng; Tzu-Han,6,0,50,44
1649984293912,COGS 17,A01,092677,Staff,47,0,75,28
1649984299934,COGS 100,A01,083619,Staff,1,15,60,59
1649984305962,COGS 101A,A01,083621,Davis; Joshua Daniel,0,17,60,60
1649984311986,COGS 101B,A01,091572,Staff,20,0,60,40
1649984318015,COGS 101C,A01,083625,Delgado; Tania,22,0,30,8
1649984324052,COGS 107A,A01,083627,Boyle; Mary E. T.,0,1,60,60
1649984330080,COGS 118A,A01,083075,Staff,21,0,60,39
1649984336130,CSE 3,A50,083646,Miranda; Gregory Joseph,22,0,38,16
1649984336130,CSE 3,A51,083647,Miranda; Gregory Joseph,37,0,37,0
1649984342159,CSE 8A,A50,083650,Miranda; Gregory Joseph,2,10,40,38
1649984348180,CSE 11,A01,083080,Cao; Yingjun,0,51,40,40
1649984354204,CSE 12,A01,083652,Staff,19,0,100,81
1649984360255,CSE 15L,A01,083654,Staff,0,0,50,50
1649984360255,CSE 15L,A02,083655,Staff,28,0,50,22
1649984366277,CSE 20,A01,083657,Staff,60,0,80,20
1649984372300,CSE 30,A01,083084,Eldon; John,0,53,40,40
1649984378322,CSE 100,A01,083659,Cao; Yingjun,1,54,50,49
1649984384348,CSE 134B,A01,083661,Powell; Thomas Allan,0,26,65,65
1649984390384,CSE 140,A01,083663,Staff,10,0,75,65
1649984396407,CSE 140L,A01,083088,Eldon; John,6,0,75,69
1649984402429,CSE 175,A01,083665,Kumar; Rakesh,10,0,25,15
1649984408471,CSE 190,A00,092507,Dubnov; Shlomo,17,0,20,3
1649984414495,ECE 45,A01,083139,Staff,0,6,40,40
1649984420522,ECE 65,A50,083695,Staff,2,0,30,28
1649984426553,ECE 109,A01,091882,Touri; Behrouz,50,0,70,20
1649984432579,ECE 180,A00,083140,Abi Samra; Nicholas Camill,26,0,30,4
1649984432579,ECE 180,B00,083141,Abi Samra; Nicholas Camill,10,0,30,20
1649984438606,MATH 10A,A01,083735,Patchell; Gregory David,16,0,30,14
1649984438606,MATH 10A,A02,083736,Patchell; Gregory David,28,0,30,2
1649984438606,MATH 10A,A03,083737,Patchell; Gregory David,27,0,30,3
1649984444651,MATH 10B,A01,083207,Staff,0,2,30,30
1649984444651,MATH 10B,A02,083208,Staff,14,0,30,16
1649984444651,MATH 10B,B01,083739,Staff,22,0,30,8
1649984444651,MATH 10B,B02,083740,Staff,30,0,30,0
1649984450683,MATH 18,A01,083743,Staff,16,0,30,14
1649984450683,MATH 18,A02,083744,Staff,29,0,30,1
1649984450683,MATH 18,A03,083745,Staff,26,0,30,4
1649984450683,MATH 18,A04,083746,Staff,27,0,30,3
1649984450683,MATH 18,B01,083748,Staff,0,3,30,30
1649984450683,MATH 18,B02,083749,Staff,0,0,30,30
1649984450683,MATH 18,B03,083750,Staff,9,0,30,21
1649984450683,MATH 18,B04,083751,Staff,9,0,30,21
1649984456708,MATH 20A,A01,083754,Staff,31,0,40,9
1649984462740,MATH 20B,A01,083756,Staff,2,0,30,28
1649984462740,MATH 20B,A02,083757,Staff,26,0,30,4
1649984468770,MATH 20C,A01,083760,Staff,1,1,30,29
1649984468770,MATH 20C,A02,083761,Staff,0,1,30,30
1649984468770,MATH 20C,B01,083762,Staff,23,0,30,7
1649984468770,MATH 20C,B02,083763,Staff,30,0,30,0
1649984474801,MATH 20D,A01,083765,Staff,0,0,30,30
1649984474801,MATH 20D,A02,083766,Staff,24,0,30,6
1649984474801,MATH 20D,A03,083767,Staff,28,0,30,2
1649984480831,MATH 20E,A01,083771,Staff,11,0,30,19
1649984480831,MATH 20E,A02,083772,Staff,21,0,30,9
1649984480831,MATH 20E,B01,083773,Staff,2,0,30,28
1649984480831,MATH 20E,B02,083774,Staff,26,0,30,4
1649984486856,MATH 103A,A01,083777,Staff,1,5,30,29
1649984486856,MATH 103A,A02,083778,Staff,0,5,30,30
1649984486856,MATH 103A,B01,083779,Staff,0,6,30,30
1649984486856,MATH 103A,B02,083780,Staff,0,5,30,30
1649984492888,MATH 105,A01,085443,Staff,0,10,30,30
1649984498912,MATH 109,A01,083213,Anzaldo; Leesa B,0,3,30,30
1649984498912,MATH 109,A02,083214,Anzaldo; Leesa B,1,2,30,29
1649984498912,MATH 109,B01,083215,Anzaldo; Leesa B,5,0,30,25
1649984498912,MATH 109,B02,083216,Anzaldo; Leesa B,0,0,30,30
1649984504936,MATH 142A,A01,083219,Chow; Bennett,0,6,30,30
1649984504936,MATH 142A,A02,083220,Chow; Bennett,0,5,30,30
1649984504936,MATH 142A,B01,083221,Chow; Bennett,0,6,30,30
1649984504936,MATH 142A,B02,083222,Chow; Bennett,0,5,30,30
1649984510960,MATH 193A,A01,083224,Staff,0,5,30,30
1649984510960,MATH 193A,A02,083225,Staff,0,4,30,30
1649984510960,MATH 193A,A03,083781,Staff,1,0,30,29
1649984510960,MATH 193A,A04,083782,Staff,12,0,30,18
1649984516982,MATH 197,001,091859,McAuley; Julian John,9999,0,9999,0
1649984523046,COGS 9,A01,083615,Staff,1,11,60,59
1649984529070,COGS 11,A01,083617,Boyle; Mary E. T.,28,0,40,12
1649984535094,COGS 13,A01,083071,Staff,1,25,40,39
1649984541122,COGS 14A,A01,092681,Staff,12,0,100,88
1649984547146,COGS 14B,A01,083073,Cheng; Tzu-Han,6,0,50,44
1649984553169,COGS 17,A01,092677,Staff,47,0,75,28
1649984559283,COGS 100,A01,083619,Staff,1,15,60,59
1649984565306,COGS 101A,A01,083621,Davis; Joshua Daniel,0,17,60,60
1649984571330,COGS 101B,A01,091572,Staff,20,0,60,40
1649984577354,COGS 101C,A01,083625,Delgado; Tania,22,0,30,8
1649984583377,COGS 107A,A01,083627,Boyle; Mary E. T.,0,1,60,60
1649984589411,COGS 118A,A01,083075,Staff,21,0,60,39
1649984595439,CSE 3,A50,083646,Miranda; Gregory Joseph,22,0,38,16
1649984595439,CSE 3,A51,083647,Miranda; Gregory Joseph,37,0,37,0
1649984601464,CSE 8A,A50,083650,Miranda; Gregory Joseph,2,11,40,38
1649984607488,CSE 11,A01,083080,Cao; Yingjun,0,51,40,40
1649984613518,CSE 12,A01,083652,Staff,18,0,100,82
1649984619545,CSE 15L,A01,083654,Staff,0,0,50,50
1649984619545,CSE 15L,A02,083655,Staff,27,0,50,23
1649984625569,CSE 20,A01,083657,Staff,60,0,80,20
1649984631596,CSE 30,A01,083084,Eldon; John,0,53,40,40
1649984637622,CSE 100,A01,083659,Cao; Yingjun,1,54,50,49
1649984643645,CSE 134B,A01,083661,Powell; Thomas Allan,0,26,65,65
1649984649670,CSE 140,A01,083663,Staff,10,0,75,65
1649984655694,CSE 140L,A01,083088,Eldon; John,6,0,75,69
1649984661719,CSE 175,A01,083665,Kumar; Rakesh,10,0,25,15
1649984667745,CSE 190,A00,092507,Dubnov; Shlomo,17,0,20,3
1649984673770,ECE 45,A01,083139,Staff,0,6,40,40
1649984679793,ECE 65,A50,083695,Staff,2,0,30,28
1649984685832,ECE 109,A01,091882,Touri; Behrouz,50,0,70,20
1649984691855,ECE 180,A00,083140,Abi Samra; Nicholas Camill,26,0,30,4
1649984691855,ECE 180,B00,083141,Abi Samra; Nicholas Camill,10,0,30,20
1649984697879,MATH 10A,A01,083735,Patchell; Gregory David,16,0,30,14
1649984697879,MATH 10A,A02,083736,Patchell; Gregory David,28,0,30,2
1649984697879,MATH 10A,A03,083737,Patchell; Gregory David,27,0,30,3
1649984703902,MATH 10B,A01,083207,Staff,0,2,30,30
1649984703902,MATH 10B,A02,083208,Staff,14,0,30,16
1649984703902,MATH 10B,B01,083739,Staff,22,0,30,8
1649984703902,MATH 10B,B02,083740,Staff,30,0,30,0
1649984709926,MATH 18,A01,083743,Staff,15,0,30,15
1649984709926,MATH 18,A02,083744,Staff,29,0,30,1
1649984709926,MATH 18,A03,083745,Staff,26,0,30,4
1649984709926,MATH 18,A04,083746,Staff,27,0,30,3
1649984709926,MATH 18,B01,083748,Staff,0,3,30,30
1649984709926,MATH 18,B02,083749,Staff,0,0,30,30
1649984709926,MATH 18,B03,083750,Staff,7,0,30,23
1649984709926,MATH 18,B04,083751,Staff,9,0,30,21
1649984715957,MATH 20A,A01,083754,Staff,31,0,40,9
1649984721980,MATH 20B,A01,083756,Staff,2,0,30,28
1649984721980,MATH 20B,A02,083757,Staff,25,0,30,5
1649984728007,MATH 20C,A01,083760,Staff,1,2,30,29
1649984728007,MATH 20C,A02,083761,Staff,0,1,30,30
1649984728007,MATH 20C,B01,083762,Staff,23,0,30,7
1649984728007,MATH 20C,B02,083763,Staff,30,0,30,0
1649984734031,MATH 20D,A01,083765,Staff,0,0,30,30
1649984734031,MATH 20D,A02,083766,Staff,24,0,30,6
1649984734031,MATH 20D,A03,083767,Staff,28,0,30,2
1649984740054,MATH 20E,A01,083771,Staff,11,0,30,19
1649984740054,MATH 20E,A02,083772,Staff,21,0,30,9
1649984740054,MATH 20E,B01,083773,Staff,2,0,30,28
1649984740054,MATH 20E,B02,083774,Staff,26,0,30,4
1649984746081,MATH 103A,A01,083777,Staff,1,5,30,29
1649984746081,MATH 103A,A02,083778,Staff,0,5,30,30
1649984746081,MATH 103A,B01,083779,Staff,0,6,30,30
1649984746081,MATH 103A,B02,083780,Staff,0,5,30,30
1649984752110,MATH 105,A01,085443,Staff,0,10,30,30
1649984758145,MATH 109,A01,083213,Anzaldo; Leesa B,0,3,30,30
1649984758145,MATH 109,A02,083214,Anzaldo; Leesa B,1,2,30,29
1649984758145,MATH 109,B01,083215,Anzaldo; Leesa B,4,0,30,26
1649984758145,MATH 109,B02,083216,Anzaldo; Leesa B,0,0,30,30
1649984764173,MATH 142A,A01,083219,Chow; Bennett,0,6,30,30
1649984764173,MATH 142A,A02,083220,Chow; Bennett,0,5,30,30
1649984764173,MATH 142A,B01,083221,Chow; Bennett,0,6,30,30
1649984764173,MATH 142A,B02,083222,Chow; Bennett,0,5,30,30
1649984770197,MATH 193A,A01,083224,Staff,0,5,30,30
1649984770197,MATH 193A,A02,083225,Staff,0,4,30,30
1649984770197,MATH 193A,A03,083781,Staff,1,0,30,29
1649984770197,MATH 193A,A04,083782,Staff,12,0,30,18
1649984776222,MATH 197,001,091859,McAuley; Julian John,9999,0,9999,0
1649984782284,COGS 9,A01,083615,Staff,1,11,60,59
1649984788308,COGS 11,A01,083617,Boyle; Mary E. T.,28,0,40,12
1649984794332,COGS 13,A01,083071,Staff,1,25,40,39
1649984800355,COGS 14A,A01,092681,Staff,12,0,100,88
1649984806379,COGS 14B,A01,083073,Cheng; Tzu-Han,6,0,50,44
1649984812402,COGS 17,A01,092677,Staff,47,0,75,28
1649984818426,COGS 100,A01,083619,Staff,1,15,60,59
1649984824456,COGS 101A,A01,083621,Davis; Joshua Daniel,0,17,60,60
1649984830480,COGS 101B,A01,091572,Staff,20,0,60,40
1649984836502,COGS 101C,A01,083625,Delgado; Tania,22,0,30,8
1649984842529,COGS 107A,A01,083627,Boyle; Mary E. T.,0,1,60,60
1649984848566,COGS 118A,A01,083075,Staff,21,0,60,39
1649984854590,CSE 3,A50,083646,Miranda; Gregory Joseph,22,0,38,16
1649984854590,CSE 3,A51,083647,Miranda; Gregory Joseph,37,0,37,0
1649984860614,CSE 8A,A50,083650,Miranda; Gregory Joseph,2,11,40,38
1649984866651,CSE 11,A01,083080,Cao; Yingjun,0,51,40,40
1649984872675,CSE 12,A01,083652,Staff,18,0,100,82
1649984878701,CSE 15L,A01,083654,Staff,0,0,50,50
1649984878701,CSE 15L,A02,083655,Staff,27,0,50,23
1649984884727,CSE 20,A01,083657,Staff,60,0,80,20
1649984890755,CSE 30,A01,083084,Eldon; John,0,53,40,40
1649984896778,CSE 100,A01,083659,Cao; Yingjun,1,55,50,49
1649984902807,CSE 134B,A01,083661,Powell; Thomas Allan,0,26,65,65
1649984908834,CSE 140,A01,083663,Staff,10,0,75,65
1649984914857,CSE 140L,A01,083088,Eldon; John,6,0,75,69
1649984920884,CSE 175,A01,083665,Kumar; Rakesh,10,0,25,15
1649984926906,CSE 190,A00,092507,Dubnov; Shlomo,17,0,20,3
1649984932931,ECE 45,A01,083139,Staff,0,6,40,40
1649984938955,ECE 65,A50,083695,Staff,2,0,30,28
1649984944981,ECE 109,A01,091882,Touri; Behrouz,50,0,70,20
1649984951014,ECE 180,A00,083140,Abi Samra; Nicholas Camill,26,0,30,4
1649984951014,ECE 180,B00,083141,Abi Samra; Nicholas Camill,10,0,30,20
1649984957039,MATH 10A,A01,083735,Patchell; Gregory David,16,0,30,14
1649984957039,MATH 10A,A02,083736,Patchell; Gregory David,28,0,30,2
1649984957039,MATH 10A,A03,083737,Patchell; Gregory David,27,0,30,3
1649984963071,MATH 10B,A01,083207,Staff,0,2,30,30
1649984963071,MATH 10B,A02,083208,Staff,14,0,30,16
1649984963071,MATH 10B,B01,083739,Staff,22,0,30,8
1649984963071,MATH 10B,B02,083740,Staff,30,0,30,0
1649984969099,MATH 18,A01,083743,Staff,15,0,30,15
1649984969099,MATH 18,A02,083744,Staff,29,0,30,1
1649984969099,MATH 18,A03,083745,Staff,26,0,30,4
1649984969099,MATH 18,A04,083746,Staff,27,0,30,3
1649984969099,MATH 18,B01,083748,Staff,0,3,30,30
1649984969099,MATH 18,B02,083749,Staff,0,0,30,30
1649984969099,MATH 18,B03,083750,Staff,7,0,30,23
1649984969099,MATH 18,B04,083751,Staff,9,0,30,21
1649984975133,MATH 20A,A01,083754,Staff,31,0,40,9
1649984981162,MATH 20B,A01,083756,Staff,3,0,30,27
1649984981162,MATH 20B,A02,083757,Staff,25,0,30,5
1649984987191,MATH 20C,A01,083760,Staff,1,2,30,29
1649984987191,MATH 20C,A02,083761,Staff,0,2,30,30
1649984987191,MATH 20C,B01,083762,Staff,23,0,30,7
1649984987191,MATH 20C,B02,083763,Staff,30,0,30,0
1649984993215,MATH 20D,A01,083765,Staff,0,0,30,30
1649984993215,MATH 20D,A02,083766,Staff,24,0,30,6
1649984993215,MATH 20D,A03,083767,Staff,28,0,30,2
1649984999239,MATH 20E,A01,083771,Staff,11,0,30,19
1649984999239,MATH 20E,A02,083772,Staff,21,0,30,9
1649984999239,MATH 20E,B01,083773,Staff,2,0,30,28
1649984999239,MATH 20E,B02,083774,Staff,26,0,30,4
1649985005260,MATH 103A,A01,083777,Staff,1,5,30,29
1649985005260,MATH 103A,A02,083778,Staff,0,5,30,30
1649985005260,MATH 103A,B01,083779,Staff,0,6,30,30
1649985005260,MATH 103A,B02,083780,Staff,0,5,30,30
1649985011285,MATH 105,A01,085443,Staff,0,10,30,30
1649985017311,MATH 109,A01,083213,Anzaldo; Leesa B,0,3,30,30
1649985017311,MATH 109,A02,083214,Anzaldo; Leesa B,1,2,30,29
1649985017311,MATH 109,B01,083215,Anzaldo; Leesa B,4,0,30,26
1649985017311,MATH 109,B02,083216,Anzaldo; Leesa B,0,0,30,30
1649985023334,MATH 142A,A01,083219,Chow; Bennett,0,6,30,30
1649985023334,MATH 142A,A02,083220,Chow; Bennett,0,5,30,30
1649985023334,MATH 142A,B01,083221,Chow; Bennett,0,6,30,30
1649985023334,MATH 142A,B02,083222,Chow; Bennett,0,5,30,30
1649985029360,MATH 193A,A01,083224,Staff,0,5,30,30
1649985029360,MATH 193A,A02,083225,Staff,0,4,30,30
1649985029360,MATH 193A,A03,083781,Staff,1,0,30,29
1649985029360,MATH 193A,A04,083782,Staff,12,0,30,18
1649985035386,MATH 197,001,091859,McAuley; Julian John,9999,0,9999,0
1649985041470,COGS 9,A01,083615,Staff,1,10,60,59
1649985047496,COGS 11,A01,083617,Boyle; Mary E. T.,28,0,40,12
1649985053530,COGS 13,A01,083071,Staff,1,25,40,39
1649985059556,COGS 14A,A01,092681,Staff,11,0,100,89
1649985065588,COGS 14B,A01,083073,Cheng; Tzu-Han,6,0,50,44
1649985071614,COGS 17,A01,092677,Staff,47,0,75,28
1649985077640,COGS 100,A01,083619,Staff,1,15,60,59
1649985083667,COGS 101A,A01,083621,Davis; Joshua Daniel,0,17,60,60
1649985089692,COGS 101B,A01,091572,Staff,20,0,60,40
1649985095720,COGS 101C,A01,083625,Delgado; Tania,22,0,30,8
1649985101743,COGS 107A,A01,083627,Boyle; Mary E. T.,0,1,60,60
1649985107777,COGS 118A,A01,083075,Staff,21,0,60,39
1649985113817,CSE 3,A50,083646,Miranda; Gregory Joseph,22,0,38,16
1649985113817,CSE 3,A51,083647,Miranda; Gregory Joseph,37,0,37,0
1649985119851,CSE 8A,A50,083650,Miranda; Gregory Joseph,2,11,40,38
1649985125873,CSE 11,A01,083080,Cao; Yingjun,0,51,40,40
1649985131896,CSE 12,A01,083652,Staff,18,0,100,82
1649985137919,CSE 15L,A01,083654,Staff,0,0,50,50
1649985137919,CSE 15L,A02,083655,Staff,27,0,50,23
1649985143945,CSE 20,A01,083657,Staff,60,0,80,20
1649985149968,CSE 30,A01,083084,Eldon; John,0,54,40,40
1649985156083,CSE 100,A01,083659,Cao; Yingjun,1,55,50,49
1649985162106,CSE 134B,A01,083661,Powell; Thomas Allan,0,26,65,65
1649985168127,CSE 140,A01,083663,Staff,10,0,75,65
1649985174151,CSE 140L,A01,083088,Eldon; John,6,0,75,69
1649985180176,CSE 175,A01,083665,Kumar; Rakesh,10,0,25,15
1649985186219,CSE 190,A00,092507,Dubnov; Shlomo,17,0,20,3
1649985192241,ECE 45,A01,083139,Staff,0,6,40,40
1649985198266,ECE 65,A50,083695,Staff,2,0,30,28
1649985204292,ECE 109,A01,091882,Touri; Behrouz,50,0,70,20
1649985210316,ECE 180,A00,083140,Abi Samra; Nicholas Camill,26,0,30,4
1649985210316,ECE 180,B00,083141,Abi Samra; Nicholas Camill,10,0,30,20
1649985216347,MATH 10A,A01,083735,Patchell; Gregory David,15,0,30,15
1649985216347,MATH 10A,A02,083736,Patchell; Gregory David,28,0,30,2
1649985216347,MATH 10A,A03,083737,Patchell; Gregory David,27,0,30,3
1649985222371,MATH 10B,A01,083207,Staff,0,2,30,30
1649985222371,MATH 10B,A02,083208,Staff,11,0,30,19
1649985222371,MATH 10B,B01,083739,Staff,22,0,30,8
1649985222371,MATH 10B,B02,083740,Staff,30,0,30,0
1649985228403,MATH 18,A01,083743,Staff,15,0,30,15
1649985228403,MATH 18,A02,083744,Staff,29,0,30,1
1649985228403,MATH 18,A03,083745,Staff,26,0,30,4
1649985228403,MATH 18,A04,083746,Staff,27,0,30,3
1649985228403,MATH 18,B01,083748,Staff,0,3,30,30
1649985228403,MATH 18,B02,083749,Staff,0,1,30,30
1649985228403,MATH 18,B03,083750,Staff,6,0,30,24
1649985228403,MATH 18,B04,083751,Staff,9,0,30,21
1649985234437,MATH 20A,A01,083754,Staff,31,0,40,9
1649985240461,MATH 20B,A01,083756,Staff,3,0,30,27
1649985240461,MATH 20B,A02,083757,Staff,25,0,30,5
1649985246491,MATH 20C,A01,083760,Staff,1,2,30,29
1649985246491,MATH 20C,A02,083761,Staff,0,2,30,30
1649985246491,MATH 20C,B01,083762,Staff,23,0,30,7
1649985246491,MATH 20C,B02,083763,Staff,30,0,30,0
1649985252519,MATH 20D,A01,083765,Staff,0,0,30,30
1649985252519,MATH 20D,A02,083766,Staff,24,0,30,6
1649985252519,MATH 20D,A03,083767,Staff,28,0,30,2
1649985258543,MATH 20E,A01,083771,Staff,11,0,30,19
1649985258543,MATH 20E,A02,083772,Staff,21,0,30,9
1649985258543,MATH 20E,B01,083773,Staff,2,0,30,28
1649985258543,MATH 20E,B02,083774,Staff,26,0,30,4
1649985264567,MATH 103A,A01,083777,Staff,1,5,30,29
1649985264567,MATH 103A,A02,083778,Staff,0,5,30,30
1649985264567,MATH 103A,B01,083779,Staff,0,6,30,30
1649985264567,MATH 103A,B02,083780,Staff,0,5,30,30
1649985270594,MATH 105,A01,085443,Staff,0,10,30,30
1649985276621,MATH 109,A01,083213,Anzaldo; Leesa B,0,3,30,30
1649985276621,MATH 109,A02,083214,Anzaldo; Leesa B,1,2,30,29
1649985276621,MATH 109,B01,083215,Anzaldo; Leesa B,3,0,30,27
1649985276621,MATH 109,B02,083216,Anzaldo; Leesa B,0,0,30,30
1649985282648,MATH 142A,A01,083219,Chow; Bennett,0,6,30,30
1649985282648,MATH 142A,A02,083220,Chow; Bennett,0,5,30,30
1649985282648,MATH 142A,B01,083221,Chow; Bennett,0,6,30,30
1649985282648,MATH 142A,B02,083222,Chow; Bennett,0,5,30,30
1649985288675,MATH 193A,A01,083224,Staff,0,5,30,30
1649985288675,MATH 193A,A02,083225,Staff,0,4,30,30
1649985288675,MATH 193A,A03,083781,Staff,1,0,30,29
1649985288675,MATH 193A,A04,083782,Staff,12,0,30,18
1649985294698,MATH 197,001,091859,McAuley; Julian John,9999,0,9999,0
1649985300748,COGS 9,A01,083615,Staff,1,10,60,59
1649985306775,COGS 11,A01,083617,Boyle; Mary E. T.,28,0,40,12
1649985312810,COGS 13,A01,083071,Staff,1,25,40,39
1649985318834,COGS 14A,A01,092681,Staff,9,0,100,91
1649985324857,COGS 14B,A01,083073,Cheng; Tzu-Han,6,0,50,44
1649985330883,COGS 17,A01,092677,Staff,47,0,75,28
1649985336909,COGS 100,A01,083619,Staff,1,15,60,59
1649985342937,COGS 101A,A01,083621,Davis; Joshua Daniel,0,17,60,60
1649985348972,COGS 101B,A01,091572,Staff,19,0,60,41
1649985355001,COGS 101C,A01,083625,Delgado; Tania,22,0,30,8
1649985361025,COGS 107A,A01,083627,Boyle; Mary E. T.,0,1,60,60
1649985367057,COGS 118A,A01,083075,Staff,21,0,60,39
1649985373088,CSE 3,A50,083646,Miranda; Gregory Joseph,22,0,38,16
1649985373088,CSE 3,A51,083647,Miranda; Gregory Joseph,37,0,37,0
1649985379120,CSE 8A,A50,083650,Miranda; Gregory Joseph,2,12,40,38
1649985385148,CSE 11,A01,083080,Cao; Yingjun,0,51,40,40
1649985391173,CSE 12,A01,083652,Staff,18,0,100,82
1649985397209,CSE 15L,A01,083654,Staff,0,0,50,50
1649985397209,CSE 15L,A02,083655,Staff,27,0,50,23
1649985403235,CSE 20,A01,083657,Staff,60,0,80,20
1649985409263,CSE 30,A01,083084,Eldon; John,0,54,40,40
1649985415289,CSE 100,A01,083659,Cao; Yingjun,1,55,50,49
1649985421321,CSE 134B,A01,083661,Powell; Thomas Allan,0,26,65,65
1649985427351,CSE 140,A01,083663,Staff,10,0,75,65
1649985433375,CSE 140L,A01,083088,Eldon; John,6,0,75,69
1649985439398,CSE 175,A01,083665,Kumar; Rakesh,10,0,25,15
1649985445422,CSE 190,A00,092507,Dubnov; Shlomo,17,0,20,3
1649985451455,ECE 45,A01,083139,Staff,0,6,40,40
1649985457484,ECE 65,A50,083695,Staff,2,0,30,28
1649985463507,ECE 109,A01,091882,Touri; Behrouz,50,0,70,20
1649985469531,ECE 180,A00,083140,Abi Samra; Nicholas Camill,26,0,30,4
1649985469531,ECE 180,B00,083141,Abi Samra; Nicholas Camill,10,0,30,20
1649985475559,MATH 10A,A01,083735,Patchell; Gregory David,15,0,30,15
1649985475559,MATH 10A,A02,083736,Patchell; Gregory David,28,0,30,2
1649985475559,MATH 10A,A03,083737,Patchell; Gregory David,27,0,30,3
1649985481595,MATH 10B,A01,083207,Staff,0,2,30,30
1649985481595,MATH 10B,A02,083208,Staff,11,0,30,19
1649985481595,MATH 10B,B01,083739,Staff,22,0,30,8
1649985481595,MATH 10B,B02,083740,Staff,30,0,30,0
1649985487625,MATH 18,A01,083743,Staff,15,0,30,15
1649985487625,MATH 18,A02,083744,Staff,29,0,30,1
1649985487625,MATH 18,A03,083745,Staff,26,0,30,4
1649985487625,MATH 18,A04,083746,Staff,27,0,30,3
1649985487625,MATH 18,B01,083748,Staff,0,3,30,30
1649985487625,MATH 18,B02,083749,Staff,0,1,30,30
1649985487625,MATH 18,B03,083750,Staff,6,0,30,24
1649985487625,MATH 18,B04,083751,Staff,9,0,30,21
1649985493647,MATH 20A,A01,083754,Staff,31,0,40,9
1649985499674,MATH 20B,A01,083756,Staff,3,0,30,27
1649985499674,MATH 20B,A02,083757,Staff,25,0,30,5
1649985505702,MATH 20C,A01,083760,Staff,1,2,30,29
1649985505702,MATH 20C,A02,083761,Staff,0,3,30,30
1649985505702,MATH 20C,B01,083762,Staff,23,0,30,7
1649985505702,MATH 20C,B02,083763,Staff,30,0,30,0
1649985511730,MATH 20D,A01,083765,Staff,0,0,30,30
1649985511730,MATH 20D,A02,083766,Staff,24,0,30,6
1649985511730,MATH 20D,A03,083767,Staff,28,0,30,2
1649985517770,MATH 20E,A01,083771,Staff,11,0,30,19
1649985517770,MATH 20E,A02,083772,Staff,21,0,30,9
1649985517770,MATH 20E,B01,083773,Staff,2,0,30,28
1649985517770,MATH 20E,B02,083774,Staff,26,0,30,4
1649985523809,MATH 103A,A01,083777,Staff,1,5,30,29
1649985523809,MATH 103A,A02,083778,Staff,0,5,30,30
1649985523809,MATH 103A,B01,083779,Staff,0,6,30,30
1649985523809,MATH 103A,B02,083780,Staff,0,5,30,30
1649985529842,MATH 105,A01,085443,Staff,0,10,30,30
1649985535867,MATH 109,A01,083213,Anzaldo; Leesa B,0,3,30,30
1649985535867,MATH 109,A02,083214,Anzaldo; Leesa B,1,2,30,29
1649985535867,MATH 109,B01,083215,Anzaldo; Leesa B,3,0,30,27
1649985535867,MATH 109,B02,083216,Anzaldo; Leesa B,0,0,30,30
1649985541891,MATH 142A,A01,083219,Chow; Bennett,0,6,30,30
1649985541891,MATH 142A,A02,083220,Chow; Bennett,0,5,30,30
1649985541891,MATH 142A,B01,083221,Chow; Bennett,0,6,30,30
1649985541891,MATH 142A,B02,083222,Chow; Bennett,0,5,30,30
1649985547924,MATH 193A,A01,083224,Staff,0,5,30,30
1649985547924,MATH 193A,A02,083225,Staff,0,4,30,30
1649985547924,MATH 193A,A03,083781,Staff,1,0,30,29
1649985547924,MATH 193A,A04,083782,Staff,12,0,30,18
1649985553946,MATH 197,001,091859,McAuley; Julian John,9999,0,9999,0
1649985559997,COGS 9,A01,083615,Staff,1,11,60,59
1649985566035,COGS 11,A01,083617,Boyle; Mary E. T.,28,0,40,12
1649985572060,COGS 13,A01,083071,Staff,1,25,40,39
1649985578084,COGS 14A,A01,092681,Staff,10,0,100,90
1649985584105,COGS 14B,A01,083073,Cheng; Tzu-Han,5,0,50,45
1649985590127,COGS 17,A01,092677,Staff,47,0,75,28
1649985596152,COGS 100,A01,083619,Staff,1,15,60,59
1649985602177,COGS 101A,A01,083621,Davis; Joshua Daniel,0,17,60,60
1649985608201,COGS 101B,A01,091572,Staff,19,0,60,41
1649985614241,COGS 101C,A01,083625,Delgado; Tania,22,0,30,8
1649985620262,COGS 107A,A01,083627,Boyle; Mary E. T.,0,1,60,60
1649985626292,COGS 118A,A01,083075,Staff,21,0,60,39
1649985632319,CSE 3,A50,083646,Miranda; Gregory Joseph,22,0,38,16
1649985632319,CSE 3,A51,083647,Miranda; Gregory Joseph,37,0,37,0
1649985638353,CSE 8A,A50,083650,Miranda; Gregory Joseph,2,12,40,38
1649985644375,CSE 11,A01,083080,Cao; Yingjun,0,51,40,40
1649985650402,CSE 12,A01,083652,Staff,17,0,100,83
1649985656425,CSE 15L,A01,083654,Staff,0,0,50,50
1649985656425,CSE 15L,A02,083655,Staff,26,0,50,24
1649985662447,CSE 20,A01,083657,Staff,60,0,80,20
1649985668473,CSE 30,A01,083084,Eldon; John,0,54,40,40
1649985674496,CSE 100,A01,083659,Cao; Yingjun,1,55,50,49
1649985680525,CSE 134B,A01,083661,Powell; Thomas Allan,0,26,65,65
1649985686548,CSE 140,A01,083663,Staff,10,0,75,65
1649985692575,CSE 140L,A01,083088,Eldon; John,6,0,75,69
1649985698601,CSE 175,A01,083665,Kumar; Rakesh,10,0,25,15
1649985704648,CSE 190,A00,092507,Dubnov; Shlomo,17,0,20,3
1649985710672,ECE 45,A01,083139,Staff,0,6,40,40
1649985716696,ECE 65,A50,083695,Staff,2,0,30,28
1649985722724,ECE 109,A01,091882,Touri; Behrouz,50,0,70,20
1649985728747,ECE 180,A00,083140,Abi Samra; Nicholas Camill,26,0,30,4
1649985728747,ECE 180,B00,083141,Abi Samra; Nicholas Camill,10,0,30,20
1649985734774,MATH 10A,A01,083735,Patchell; Gregory David,15,0,30,15
1649985734774,MATH 10A,A02,083736,Patchell; Gregory David,28,0,30,2
1649985734774,MATH 10A,A03,083737,Patchell; Gregory David,27,0,30,3
1649985740804,MATH 10B,A01,083207,Staff,0,2,30,30
1649985740804,MATH 10B,A02,083208,Staff,10,0,30,20
1649985740804,MATH 10B,B01,083739,Staff,22,0,30,8
1649985740804,MATH 10B,B02,083740,Staff,30,0,30,0
1649985746829,MATH 18,A01,083743,Staff,14,0,30,16
1649985746829,MATH 18,A02,083744,Staff,29,0,30,1
1649985746829,MATH 18,A03,083745,Staff,26,0,30,4
1649985746829,MATH 18,A04,083746,Staff,27,0,30,3
1649985746829,MATH 18,B01,083748,Staff,0,3,30,30
1649985746829,MATH 18,B02,083749,Staff,0,0,30,30
1649985746829,MATH 18,B03,083750,Staff,4,0,30,26
1649985746829,MATH 18,B04,083751,Staff,8,0,30,22
1649985752929,MATH 20A,A01,083754,Staff,31,0,40,9
1649985758965,MATH 20B,A01,083756,Staff,3,0,30,27
1649985758965,MATH 20B,A02,083757,Staff,25,0,30,5
1649985764988,MATH 20C,A01,083760,Staff,1,3,30,29
1649985764988,MATH 20C,A02,083761,Staff,0,3,30,30
1649985764988,MATH 20C,B01,083762,Staff,23,0,30,7
1649985764988,MATH 20C,B02,083763,Staff,30,0,30,0
1649985771015,MATH 20D,A01,083765,Staff,0,0,30,30
1649985771015,MATH 20D,A02,083766,Staff,23,0,30,7
1649985771015,MATH 20D,A03,083767,Staff,28,0,30,2
1649985777045,MATH 20E,A01,083771,Staff,11,0,30,19
1649985777045,MATH 20E,A02,083772,Staff,21,0,30,9
1649985777045,MATH 20E,B01,083773,Staff,2,0,30,28
1649985777045,MATH 20E,B02,083774,Staff,25,0,30,5
1649985783073,MATH 103A,A01,083777,Staff,1,5,30,29
1649985783073,MATH 103A,A02,083778,Staff,0,5,30,30
1649985783073,MATH 103A,B01,083779,Staff,0,6,30,30
1649985783073,MATH 103A,B02,083780,Staff,0,5,30,30
1649985789117,MATH 105,A01,085443,Staff,0,10,30,30
1649985795140,MATH 109,A01,083213,Anzaldo; Leesa B,0,3,30,30
1649985795140,MATH 109,A02,083214,Anzaldo; Leesa B,1,2,30,29
1649985795140,MATH 109,B01,083215,Anzaldo; Leesa B,1,0,30,29
1649985795140,MATH 109,B02,083216,Anzaldo; Leesa B,0,0,30,30
1649985801181,MATH 142A,A01,083219,Chow; Bennett,0,6,30,30
1649985801181,MATH 142A,A02,083220,Chow; Bennett,0,5,30,30
1649985801181,MATH 142A,B01,083221,Chow; Bennett,0,7,30,30
1649985801181,MATH 142A,B02,083222,Chow; Bennett,0,5,30,30
1649985807204,MATH 193A,A01,083224,Staff,0,6,30,30
1649985807204,MATH 193A,A02,083225,Staff,0,4,30,30
1649985807204,MATH 193A,A03,083781,Staff,1,0,30,29
1649985807204,MATH 193A,A04,083782,Staff,12,0,30,18
1649985813227,MATH 197,001,091859,McAuley; Julian John,9999,0,9999,0
1649985819289,COGS 9,A01,083615,Staff,1,11,60,59
1649985825313,COGS 11,A01,083617,Boyle; Mary E. T.,28,0,40,12
1649985831337,COGS 13,A01,083071,Staff,1,25,40,39
1649985837363,COGS 14A,A01,092681,Staff,9,0,100,91
1649985843389,COGS 14B,A01,083073,Cheng; Tzu-Han,4,0,50,46
1649985849412,COGS 17,A01,092677,Staff,47,0,75,28
1649985855434,COGS 100,A01,083619,Staff,1,15,60,59
1649985861457,COGS 101A,A01,083621,Davis; Joshua Daniel,0,17,60,60
1649985867482,COGS 101B,A01,091572,Staff,19,0,60,41
1649985873508,COGS 101C,A01,083625,Delgado; Tania,22,0,30,8
1649985879530,COGS 107A,A01,083627,Boyle; Mary E. T.,0,1,60,60
1649985885553,COGS 118A,A01,083075,Staff,20,0,60,40
1649985891580,CSE 3,A50,083646,Miranda; Gregory Joseph,22,0,38,16
1649985891580,CSE 3,A51,083647,Miranda; Gregory Joseph,37,0,37,0
1649985897618,CSE 8A,A50,083650,Miranda; Gregory Joseph,2,12,40,38
1649985903650,CSE 11,A01,083080,Cao; Yingjun,0,52,40,40
1649985909673,CSE 12,A01,083652,Staff,16,0,100,84
1649985915712,CSE 15L,A01,083654,Staff,0,0,50,50
1649985915712,CSE 15L,A02,083655,Staff,26,0,50,24
1649985921739,CSE 20,A01,083657,Staff,60,0,80,20
1649985927774,CSE 30,A01,083084,Eldon; John,0,54,40,40
1649985933800,CSE 100,A01,083659,Cao; Yingjun,1,55,50,49
1649985939822,CSE 134B,A01,083661,Powell; Thomas Allan,0,26,65,65
1649985945849,CSE 140,A01,083663,Staff,10,0,75,65
1649985951876,CSE 140L,A01,083088,Eldon; John,6,0,75,69
1649985957902,CSE 175,A01,083665,Kumar; Rakesh,10,0,25,15
1649985963924,CSE 190,A00,092507,Dubnov; Shlomo,17,0,20,3
1649985969948,ECE 45,A01,083139,Staff,0,6,40,40
1649985975971,ECE 65,A50,083695,Staff,2,0,30,28
1649985981998,ECE 109,A01,091882,Touri; Behrouz,50,0,70,20
1649985988021,ECE 180,A00,083140,Abi Samra; Nicholas Camill,26,0,30,4
1649985988021,ECE 180,B00,083141,Abi Samra; Nicholas Camill,10,0,30,20
1649985994044,MATH 10A,A01,083735,Patchell; Gregory David,15,0,30,15
1649985994044,MATH 10A,A02,083736,Patchell; Gregory David,28,0,30,2
1649985994044,MATH 10A,A03,083737,Patchell; Gregory David,27,0,30,3
1649986000067,MATH 10B,A01,083207,Staff,0,2,30,30
1649986000067,MATH 10B,A02,083208,Staff,10,0,30,20
1649986000067,MATH 10B,B01,083739,Staff,22,0,30,8
1649986000067,MATH 10B,B02,083740,Staff,30,0,30,0
1649986006090,MATH 18,A01,083743,Staff,14,0,30,16
1649986006090,MATH 18,A02,083744,Staff,29,0,30,1
1649986006090,MATH 18,A03,083745,Staff,26,0,30,4
1649986006090,MATH 18,A04,083746,Staff,27,0,30,3
1649986006090,MATH 18,B01,083748,Staff,0,3,30,30
1649986006090,MATH 18,B02,083749,Staff,0,0,30,30
1649986006090,MATH 18,B03,083750,Staff,4,0,30,26
1649986006090,MATH 18,B04,083751,Staff,8,0,30,22
1649986012119,MATH 20A,A01,083754,Staff,31,0,40,9
1649986018142,MATH 20B,A01,083756,Staff,3,0,30,27
1649986018142,MATH 20B,A02,083757,Staff,25,0,30,5
1649986024165,MATH 20C,A01,083760,Staff,1,3,30,29
1649986024165,MATH 20C,A02,083761,Staff,0,1,30,30
1649986024165,MATH 20C,B01,083762,Staff,23,0,30,7
1649986024165,MATH 20C,B02,083763,Staff,30,0,30,0
1649986030188,MATH 20D,A01,083765,Staff,0,0,30,30
1649986030188,MATH 20D,A02,083766,Staff,23,0,30,7
1649986030188,MATH 20D,A03,083767,Staff,28,0,30,2
1649986036215,MATH 20E,A01,083771,Staff,11,0,30,19
1649986036215,MATH 20E,A02,083772,Staff,21,0,30,9
1649986036215,MATH 20E,B01,083773,Staff,2,0,30,28
1649986036215,MATH 20E,B02,083774,Staff,25,0,30,5
1649986042239,MATH 103A,A01,083777,Staff,1,5,30,29
1649986042239,MATH 103A,A02,083778,Staff,0,5,30,30
1649986042239,MATH 103A,B01,083779,Staff,0,6,30,30
1649986042239,MATH 103A,B02,083780,Staff,0,5,30,30
1649986048269,MATH 105,A01,085443,Staff,0,10,30,30
1649986054323,MATH 109,A01,083213,Anzaldo; Leesa B,0,3,30,30
1649986054323,MATH 109,A02,083214,Anzaldo; Leesa B,1,2,30,29
1649986054323,MATH 109,B01,083215,Anzaldo; Leesa B,1,0,30,29
1649986054323,MATH 109,B02,083216,Anzaldo; Leesa B,0,0,30,30
1649986060347,MATH 142A,A01,083219,Chow; Bennett,0,5,30,30
1649986060347,MATH 142A,A02,083220,Chow; Bennett,0,5,30,30
1649986060347,MATH 142A,B01,083221,Chow; Bennett,0,7,30,30
1649986060347,MATH 142A,B02,083222,Chow; Bennett,0,5,30,30
1649986066376,MATH 193A,A01,083224,Staff,0,6,30,30
1649986066376,MATH 193A,A02,083225,Staff,0,4,30,30
1649986066376,MATH 193A,A03,083781,Staff,1,0,30,29
1649986066376,MATH 193A,A04,083782,Staff,12,0,30,18
1649986072404,MATH 197,001,091859,McAuley; Julian John,9999,0,9999,0
1649986078464,COGS 9,A01,083615,Staff,1,11,60,59
1649986084495,COGS 11,A01,083617,Boyle; Mary E. T.,28,0,40,12
1649986090525,COGS 13,A01,083071,Staff,1,25,40,39
1649986096548,COGS 14A,A01,092681,Staff,9,0,100,91
1649986102569,COGS 14B,A01,083073,Cheng; Tzu-Han,4,0,50,46
1649986108597,COGS 17,A01,092677,Staff,47,0,75,28
1649986114622,COGS 100,A01,083619,Staff,1,15,60,59
1649986120646,COGS 101A,A01,083621,Davis; Joshua Daniel,0,17,60,60
1649986126677,COGS 101B,A01,091572,Staff,19,0,60,41
1649986132700,COGS 101C,A01,083625,Delgado; Tania,22,0,30,8
1649986138725,COGS 107A,A01,083627,Boyle; Mary E. T.,0,1,60,60
1649986144749,COGS 118A,A01,083075,Staff,20,0,60,40
1649986150778,CSE 3,A50,083646,Miranda; Gregory Joseph,22,0,38,16
1649986150778,CSE 3,A51,083647,Miranda; Gregory Joseph,37,0,37,0
1649986156800,CSE 8A,A50,083650,Miranda; Gregory Joseph,2,12,40,38
1649986162823,CSE 11,A01,083080,Cao; Yingjun,0,52,40,40
1649986168850,CSE 12,A01,083652,Staff,16,0,100,84
1649986174874,CSE 15L,A01,083654,Staff,0,0,50,50
1649986174874,CSE 15L,A02,083655,Staff,26,0,50,24
1649986180897,CSE 20,A01,083657,Staff,60,0,80,20
1649986186922,CSE 30,A01,083084,Eldon; John,0,54,40,40
1649986192944,CSE 100,A01,083659,Cao; Yingjun,1,55,50,49
1649986198967,CSE 134B,A01,083661,Powell; Thomas Allan,0,26,65,65
1649986204994,CSE 140,A01,083663,Staff,10,0,75,65
1649986211029,CSE 140L,A01,083088,Eldon; John,6,0,75,69
1649986217056,CSE 175,A01,083665,Kumar; Rakesh,10,0,25,15
1649986223095,CSE 190,A00,092507,Dubnov; Shlomo,17,0,20,3
1649986229129,ECE 45,A01,083139,Staff,0,6,40,40
1649986235155,ECE 65,A50,083695,Staff,2,0,30,28
1649986241186,ECE 109,A01,091882,Touri; Behrouz,50,0,70,20
1649986247216,ECE 180,A00,083140,Abi Samra; Nicholas Camill,26,0,30,4
1649986247216,ECE 180,B00,083141,Abi Samra; Nicholas Camill,10,0,30,20
1649986253265,MATH 10A,A01,083735,Patchell; Gregory David,15,0,30,15
1649986253265,MATH 10A,A02,083736,Patchell; Gregory David,28,0,30,2
1649986253265,MATH 10A,A03,083737,Patchell; Gregory David,27,0,30,3
1649986259292,MATH 10B,A01,083207,Staff,0,2,30,30
1649986259292,MATH 10B,A02,083208,Staff,10,0,30,20
1649986259292,MATH 10B,B01,083739,Staff,22,0,30,8
1649986259292,MATH 10B,B02,083740,Staff,30,0,30,0
1649986265315,MATH 18,A01,083743,Staff,14,0,30,16
1649986265315,MATH 18,A02,083744,Staff,29,0,30,1
1649986265315,MATH 18,A03,083745,Staff,26,0,30,4
1649986265315,MATH 18,A04,083746,Staff,27,0,30,3
1649986265315,MATH 18,B01,083748,Staff,0,3,30,30
1649986265315,MATH 18,B02,083749,Staff,0,0,30,30
1649986265315,MATH 18,B03,083750,Staff,3,0,30,27
1649986265315,MATH 18,B04,083751,Staff,8,0,30,22
1649986271355,MATH 20A,A01,083754,Staff,31,0,40,9
1649986277383,MATH 20B,A01,083756,Staff,3,0,30,27
1649986277383,MATH 20B,A02,083757,Staff,25,0,30,5
1649986283405,MATH 20C,A01,083760,Staff,1,3,30,29
1649986283405,MATH 20C,A02,083761,Staff,0,1,30,30
1649986283405,MATH 20C,B01,083762,Staff,23,0,30,7
1649986283405,MATH 20C,B02,083763,Staff,30,0,30,0
1649986289447,MATH 20D,A01,083765,Staff,0,0,30,30
1649986289447,MATH 20D,A02,083766,Staff,23,0,30,7
1649986289447,MATH 20D,A03,083767,Staff,28,0,30,2
1649986295475,MATH 20E,A01,083771,Staff,11,0,30,19
1649986295475,MATH 20E,A02,083772,Staff,21,0,30,9
1649986295475,MATH 20E,B01,083773,Staff,2,0,30,28
1649986295475,MATH 20E,B02,083774,Staff,25,0,30,5
1649986301499,MATH 103A,A01,083777,Staff,1,5,30,29
1649986301499,MATH 103A,A02,083778,Staff,0,5,30,30
1649986301499,MATH 103A,B01,083779,Staff,0,6,30,30
1649986301499,MATH 103A,B02,083780,Staff,0,5,30,30
1649986307521,MATH 105,A01,085443,Staff,0,10,30,30
1649986313548,MATH 109,A01,083213,Anzaldo; Leesa B,0,3,30,30
1649986313548,MATH 109,A02,083214,Anzaldo; Leesa B,1,2,30,29
1649986313548,MATH 109,B01,083215,Anzaldo; Leesa B,1,0,30,29
1649986313548,MATH 109,B02,083216,Anzaldo; Leesa B,0,0,30,30
1649986319578,MATH 142A,A01,083219,Chow; Bennett,0,5,30,30
1649986319578,MATH 142A,A02,083220,Chow; Bennett,0,5,30,30
1649986319578,MATH 142A,B01,083221,Chow; Bennett,0,7,30,30
1649986319578,MATH 142A,B02,083222,Chow; Bennett,0,5,30,30
1649986325617,MATH 193A,A01,083224,Staff,0,6,30,30
1649986325617,MATH 193A,A02,083225,Staff,0,4,30,30
1649986325617,MATH 193A,A03,083781,Staff,1,0,30,29
1649986325617,MATH 193A,A04,083782,Staff,12,0,30,18
1649986331642,MATH 197,001,091859,McAuley; Julian John,9999,0,9999,0
1649986337714,COGS 9,A01,083615,Staff,1,11,60,59
1649986343826,COGS 11,A01,083617,Boyle; Mary E. T.,28,0,40,12
1649986349849,COGS 13,A01,083071,Staff,1,25,40,39
1649986355878,COGS 14A,A01,092681,Staff,9,0,100,91
1649986361901,COGS 14B,A01,083073,Cheng; Tzu-Han,4,0,50,46
1649986367927,COGS 17,A01,092677,Staff,47,0,75,28
1649986373954,COGS 100,A01,083619,Staff,1,15,60,59
1649986379983,COGS 101A,A01,083621,Davis; Joshua Daniel,0,17,60,60
1649986386008,COGS 101B,A01,091572,Staff,19,0,60,41
1649986392030,COGS 101C,A01,083625,Delgado; Tania,22,0,30,8
1649986398057,COGS 107A,A01,083627,Boyle; Mary E. T.,0,1,60,60
1649986404085,COGS 118A,A01,083075,Staff,20,0,60,40
1649986410120,CSE 3,A50,083646,Miranda; Gregory Joseph,22,0,38,16
1649986410120,CSE 3,A51,083647,Miranda; Gregory Joseph,37,0,37,0
1649986416147,CSE 8A,A50,083650,Miranda; Gregory Joseph,2,12,40,38
1649986422171,CSE 11,A01,083080,Cao; Yingjun,0,52,40,40
1649986428198,CSE 12,A01,083652,Staff,16,0,100,84
1649986434228,CSE 15L,A01,083654,Staff,0,0,50,50
1649986434228,CSE 15L,A02,083655,Staff,26,0,50,24
1649986440262,CSE 20,A01,083657,Staff,60,0,80,20
1649986446294,CSE 30,A01,083084,Eldon; John,0,54,40,40
1649986452317,CSE 100,A01,083659,Cao; Yingjun,1,55,50,49
1649986458343,CSE 134B,A01,083661,Powell; Thomas Allan,0,26,65,65
1649986464367,CSE 140,A01,083663,Staff,10,0,75,65
1649986470394,CSE 140L,A01,083088,Eldon; John,6,0,75,69
1649986476421,CSE 175,A01,083665,Kumar; Rakesh,10,0,25,15
1649986482456,CSE 190,A00,092507,Dubnov; Shlomo,17,0,20,3
1649986488479,ECE 45,A01,083139,Staff,0,6,40,40
1649986494508,ECE 65,A50,083695,Staff,2,0,30,28
1649986500547,ECE 109,A01,091882,Touri; Behrouz,50,0,70,20
1649986506575,ECE 180,A00,083140,Abi Samra; Nicholas Camill,26,0,30,4
1649986506575,ECE 180,B00,083141,Abi Samra; Nicholas Camill,10,0,30,20
1649986526780,MATH 10A,A01,083735,Patchell; Gregory David,15,0,30,15
1649986526780,MATH 10A,A02,083736,Patchell; Gregory David,28,0,30,2
1649986526780,MATH 10A,A03,083737,Patchell; Gregory David,27,0,30,3
1649986532826,MATH 10B,A01,083207,Staff,0,2,30,30
1649986532826,MATH 10B,A02,083208,Staff,8,0,30,22
1649986532826,MATH 10B,B01,083739,Staff,22,0,30,8
1649986532826,MATH 10B,B02,083740,Staff,30,0,30,0
1649986538855,MATH 18,A01,083743,Staff,14,0,30,16
1649986538855,MATH 18,A02,083744,Staff,29,0,30,1
1649986538855,MATH 18,A03,083745,Staff,26,0,30,4
1649986538855,MATH 18,A04,083746,Staff,27,0,30,3
1649986538855,MATH 18,B01,083748,Staff,0,3,30,30
1649986538855,MATH 18,B02,083749,Staff,0,0,30,30
1649986538855,MATH 18,B03,083750,Staff,0,0,30,30
1649986538855,MATH 18,B04,083751,Staff,6,0,30,24
1649986544893,MATH 20A,A01,083754,Staff,31,0,40,9
1649986550925,MATH 20B,A01,083756,Staff,1,0,30,29
1649986550925,MATH 20B,A02,083757,Staff,24,0,30,6
1649986556962,MATH 20C,A01,083760,Staff,1,3,30,29
1649986556962,MATH 20C,A02,083761,Staff,0,2,30,30
1649986556962,MATH 20C,B01,083762,Staff,23,0,30,7
1649986556962,MATH 20C,B02,083763,Staff,30,0,30,0
1649986562986,MATH 20D,A01,083765,Staff,0,0,30,30
1649986562986,MATH 20D,A02,083766,Staff,23,0,30,7
1649986562986,MATH 20D,A03,083767,Staff,28,0,30,2
1649986569011,MATH 20E,A01,083771,Staff,11,0,30,19
1649986569011,MATH 20E,A02,083772,Staff,21,0,30,9
1649986569011,MATH 20E,B01,083773,Staff,2,0,30,28
1649986569011,MATH 20E,B02,083774,Staff,24,0,30,6
1649986575053,MATH 103A,A01,083777,Staff,1,5,30,29
1649986575053,MATH 103A,A02,083778,Staff,0,5,30,30
1649986575053,MATH 103A,B01,083779,Staff,0,6,30,30
1649986575053,MATH 103A,B02,083780,Staff,0,5,30,30
1649986581086,MATH 105,A01,085443,Staff,0,10,30,30
1649986587114,MATH 109,A01,083213,Anzaldo; Leesa B,0,3,30,30
1649986587114,MATH 109,A02,083214,Anzaldo; Leesa B,1,2,30,29
1649986587114,MATH 109,B01,083215,Anzaldo; Leesa B,1,0,30,29
1649986587114,MATH 109,B02,083216,Anzaldo; Leesa B,0,0,30,30
1649986593138,MATH 142A,A01,083219,Chow; Bennett,0,5,30,30
1649986593138,MATH 142A,A02,083220,Chow; Bennett,0,5,30,30
1649986593138,MATH 142A,B01,083221,Chow; Bennett,0,7,30,30
1649986593138,MATH 142A,B02,083222,Chow; Bennett,0,5,30,30
1649986599160,MATH 193A,A01,083224,Staff,0,6,30,30
1649986599160,MATH 193A,A02,083225,Staff,0,4,30,30
1649986599160,MATH 193A,A03,083781,Staff,1,0,30,29
1649986599160,MATH 193A,A04,083782,Staff,12,0,30,18
1649986605182,MATH 197,001,091859,McAuley; Julian John,9999,0,9999,0
1649986611237,COGS 9,A01,083615,Staff,1,11,60,59
1649986617261,COGS 11,A01,083617,Boyle; Mary E. T.,28,0,40,12
1649986623300,COGS 13,A01,083071,Staff,1,25,40,39
1649986629324,COGS 14A,A01,092681,Staff,9,0,100,91
1649986635347,COGS 14B,A01,083073,Cheng; Tzu-Han,4,0,50,46
1649986641376,COGS 17,A01,092677,Staff,47,0,75,28
1649986647400,COGS 100,A01,083619,Staff,1,15,60,59
1649986653428,COGS 101A,A01,083621,Davis; Joshua Daniel,0,17,60,60
1649986659451,COGS 101B,A01,091572,Staff,19,0,60,41
1649986665474,COGS 101C,A01,083625,Delgado; Tania,22,0,30,8
1649986671507,COGS 107A,A01,083627,Boyle; Mary E. T.,0,1,60,60
1649986677543,COGS 118A,A01,083075,Staff,20,0,60,40
1649986683565,CSE 3,A50,083646,Miranda; Gregory Joseph,22,0,38,16
1649986683565,CSE 3,A51,083647,Miranda; Gregory Joseph,37,0,37,0
1649986689598,CSE 8A,A50,083650,Miranda; Gregory Joseph,2,12,40,38
1649986695621,CSE 11,A01,083080,Cao; Yingjun,0,53,40,40
1649986701654,CSE 12,A01,083652,Staff,16,0,100,84
1649986707684,CSE 15L,A01,083654,Staff,0,0,50,50
1649986707684,CSE 15L,A02,083655,Staff,26,0,50,24
1649986713710,CSE 20,A01,083657,Staff,60,0,80,20
1649986719733,CSE 30,A01,083084,Eldon; John,0,54,40,40
1649986725756,CSE 100,A01,083659,Cao; Yingjun,1,55,50,49
1649986731780,CSE 134B,A01,083661,Powell; Thomas Allan,0,26,65,65
1649986737803,CSE 140,A01,083663,Staff,10,0,75,65
1649986743826,CSE 140L,A01,083088,Eldon; John,6,0,75,69
1649986749850,CSE 175,A01,083665,Kumar; Rakesh,10,0,25,15
1649986755880,CSE 190,A00,092507,Dubnov; Shlomo,17,0,20,3
1649986761904,ECE 45,A01,083139,Staff,0,6,40,40
1649986767926,ECE 65,A50,083695,Staff,2,0,30,28
1649986773964,ECE 109,A01,091882,Touri; Behrouz,50,0,70,20
1649986779987,ECE 180,A00,083140,Abi Samra; Nicholas Camill,26,0,30,4
1649986779987,ECE 180,B00,083141,Abi Samra; Nicholas Camill,10,0,30,20
1649986786011,MATH 10A,A01,083735,Patchell; Gregory David,15,0,30,15
1649986786011,MATH 10A,A02,083736,Patchell; Gregory David,28,0,30,2
1649986786011,MATH 10A,A03,083737,Patchell; Gregory David,27,0,30,3
1649986792046,MATH 10B,A01,083207,Staff,0,2,30,30
1649986792046,MATH 10B,A02,083208,Staff,9,0,30,21
1649986792046,MATH 10B,B01,083739,Staff,22,0,30,8
1649986792046,MATH 10B,B02,083740,Staff,30,0,30,0
1649986798072,MATH 18,A01,083743,Staff,14,0,30,16
1649986798072,MATH 18,A02,083744,Staff,29,0,30,1
1649986798072,MATH 18,A03,083745,Staff,26,0,30,4
1649986798072,MATH 18,A04,083746,Staff,27,0,30,3
1649986798072,MATH 18,B01,083748,Staff,0,4,30,30
1649986798072,MATH 18,B02,083749,Staff,0,0,30,30
1649986798072,MATH 18,B03,083750,Staff,0,0,30,30
1649986798072,MATH 18,B04,083751,Staff,5,0,30,25
1649986804101,MATH 20A,A01,083754,Staff,31,0,40,9
1649986810128,MATH 20B,A01,083756,Staff,1,0,30,29
1649986810128,MATH 20B,A02,083757,Staff,24,0,30,6
1649986816158,MATH 20C,A01,083760,Staff,1,4,30,29
1649986816158,MATH 20C,A02,083761,Staff,0,3,30,30
1649986816158,MATH 20C,B01,083762,Staff,23,0,30,7
1649986816158,MATH 20C,B02,083763,Staff,30,0,30,0
1649986822183,MATH 20D,A01,083765,Staff,0,0,30,30
1649986822183,MATH 20D,A02,083766,Staff,22,0,30,8
1649986822183,MATH 20D,A03,083767,Staff,28,0,30,2
1649986828208,MATH 20E,A01,083771,Staff,11,0,30,19
1649986828208,MATH 20E,A02,083772,Staff,21,0,30,9
1649986828208,MATH 20E,B01,083773,Staff,2,0,30,28
1649986828208,MATH 20E,B02,083774,Staff,24,0,30,6
1649986834232,MATH 103A,A01,083777,Staff,1,5,30,29
1649986834232,MATH 103A,A02,083778,Staff,0,5,30,30
1649986834232,MATH 103A,B01,083779,Staff,0,6,30,30
1649986834232,MATH 103A,B02,083780,Staff,0,5,30,30
1649986840255,MATH 105,A01,085443,Staff,0,10,30,30
1649986846283,MATH 109,A01,083213,Anzaldo; Leesa B,0,3,30,30
1649986846283,MATH 109,A02,083214,Anzaldo; Leesa B,1,2,30,29
1649986846283,MATH 109,B01,083215,Anzaldo; Leesa B,1,0,30,29
1649986846283,MATH 109,B02,083216,Anzaldo; Leesa B,0,0,30,30
1649986852308,MATH 142A,A01,083219,Chow; Bennett,0,5,30,30
1649986852308,MATH 142A,A02,083220,Chow; Bennett,0,5,30,30
1649986852308,MATH 142A,B01,083221,Chow; Bennett,0,7,30,30
1649986852308,MATH 142A,B02,083222,Chow; Bennett,0,5,30,30
1649986858337,MATH 193A,A01,083224,Staff,0,6,30,30
1649986858337,MATH 193A,A02,083225,Staff,0,4,30,30
1649986858337,MATH 193A,A03,083781,Staff,1,0,30,29
1649986858337,MATH 193A,A04,083782,Staff,12,0,30,18
1649986864359,MATH 197,001,091859,McAuley; Julian John,9999,0,9999,0
1649986870414,COGS 9,A01,083615,Staff,1,11,60,59
1649986876436,COGS 11,A01,083617,Boyle; Mary E. T.,28,0,40,12
1649986882466,COGS 13,A01,083071,Staff,1,25,40,39
1649986888489,COGS 14A,A01,092681,Staff,8,0,100,92
1649986894530,COGS 14B,A01,083073,Cheng; Tzu-Han,3,0,50,47
1649986900558,COGS 17,A01,092677,Staff,46,0,75,29
1649986906584,COGS 100,A01,083619,Staff,1,15,60,59
1649986912628,COGS 101A,A01,083621,Davis; Joshua Daniel,0,17,60,60
1649986918662,COGS 101B,A01,091572,Staff,19,0,60,41
1649986924687,COGS 101C,A01,083625,Delgado; Tania,22,0,30,8
1649986930714,COGS 107A,A01,083627,Boyle; Mary E. T.,0,1,60,60
1649986936750,COGS 118A,A01,083075,Staff,20,0,60,40
1649986942778,CSE 3,A50,083646,Miranda; Gregory Joseph,22,0,38,16
1649986942778,CSE 3,A51,083647,Miranda; Gregory Joseph,37,0,37,0
1649986948806,CSE 8A,A50,083650,Miranda; Gregory Joseph,2,12,40,38
1649986954920,CSE 11,A01,083080,Cao; Yingjun,0,53,40,40
1649986960944,CSE 12,A01,083652,Staff,16,0,100,84
1649986966971,CSE 15L,A01,083654,Staff,0,0,50,50
1649986966971,CSE 15L,A02,083655,Staff,26,0,50,24
1649986972994,CSE 20,A01,083657,Staff,60,0,80,20
1649986979029,CSE 30,A01,083084,Eldon; John,0,54,40,40
1649986985055,CSE 100,A01,083659,Cao; Yingjun,1,55,50,49
1649986991077,CSE 134B,A01,083661,Powell; Thomas Allan,1,26,65,64
1649986997100,CSE 140,A01,083663,Staff,10,0,75,65
1649987003127,CSE 140L,A01,083088,Eldon; John,6,0,75,69
1649987009167,CSE 175,A01,083665,Kumar; Rakesh,10,0,25,15
1649987015203,CSE 190,A00,092507,Dubnov; Shlomo,17,0,20,3
1649987021246,ECE 45,A01,083139,Staff,0,6,40,40
1649987027270,ECE 65,A50,083695,Staff,2,0,30,28
1649987033292,ECE 109,A01,091882,Touri; Behrouz,50,0,70,20
1649987039342,ECE 180,A00,083140,Abi Samra; Nicholas Camill,26,0,30,4
1649987039342,ECE 180,B00,083141,Abi Samra; Nicholas Camill,10,0,30,20
1649987045368,MATH 10A,A01,083735,Patchell; Gregory David,15,0,30,15
1649987045368,MATH 10A,A02,083736,Patchell; Gregory David,28,0,30,2
1649987045368,MATH 10A,A03,083737,Patchell; Gregory David,27,0,30,3
1649987051392,MATH 10B,A01,083207,Staff,0,2,30,30
1649987051392,MATH 10B,A02,083208,Staff,9,0,30,21
1649987051392,MATH 10B,B01,083739,Staff,22,0,30,8
1649987051392,MATH 10B,B02,083740,Staff,30,0,30,0
1649987057441,MATH 18,A01,083743,Staff,14,0,30,16
1649987057441,MATH 18,A02,083744,Staff,29,0,30,1
1649987057441,MATH 18,A03,083745,Staff,26,0,30,4
1649987057441,MATH 18,A04,083746,Staff,27,0,30,3
1649987057441,MATH 18,B01,083748,Staff,0,3,30,30
1649987057441,MATH 18,B02,083749,Staff,0,0,30,30
1649987057441,MATH 18,B03,083750,Staff,0,0,30,30
1649987057441,MATH 18,B04,083751,Staff,5,0,30,25
1649987063467,MATH 20A,A01,083754,Staff,31,0,40,9
1649987069492,MATH 20B,A01,083756,Staff,0,0,30,30
1649987069492,MATH 20B,A02,083757,Staff,23,0,30,7
1649987075525,MATH 20C,A01,083760,Staff,1,4,30,29
1649987075525,MATH 20C,A02,083761,Staff,0,3,30,30
1649987075525,MATH 20C,B01,083762,Staff,22,0,30,8
1649987075525,MATH 20C,B02,083763,Staff,30,0,30,0
1649987081552,MATH 20D,A01,083765,Staff,0,0,30,30
1649987081552,MATH 20D,A02,083766,Staff,22,0,30,8
1649987081552,MATH 20D,A03,083767,Staff,28,0,30,2
1649987087580,MATH 20E,A01,083771,Staff,11,0,30,19
1649987087580,MATH 20E,A02,083772,Staff,21,0,30,9
1649987087580,MATH 20E,B01,083773,Staff,2,0,30,28
1649987087580,MATH 20E,B02,083774,Staff,24,0,30,6
1649987093614,MATH 103A,A01,083777,Staff,1,5,30,29
1649987093614,MATH 103A,A02,083778,Staff,0,5,30,30
1649987093614,MATH 103A,B01,083779,Staff,0,6,30,30
1649987093614,MATH 103A,B02,083780,Staff,0,5,30,30
1649987099648,MATH 105,A01,085443,Staff,0,10,30,30
1649987105670,MATH 109,A01,083213,Anzaldo; Leesa B,0,3,30,30
1649987105670,MATH 109,A02,083214,Anzaldo; Leesa B,1,2,30,29
1649987105670,MATH 109,B01,083215,Anzaldo; Leesa B,1,1,30,29
1649987105670,MATH 109,B02,083216,Anzaldo; Leesa B,0,0,30,30
1649987111695,MATH 142A,A01,083219,Chow; Bennett,0,6,30,30
1649987111695,MATH 142A,A02,083220,Chow; Bennett,0,5,30,30
1649987111695,MATH 142A,B01,083221,Chow; Bennett,0,7,30,30
1649987111695,MATH 142A,B02,083222,Chow; Bennett,0,6,30,30
1649987117720,MATH 193A,A01,083224,Staff,0,6,30,30
1649987117720,MATH 193A,A02,083225,Staff,0,4,30,30
1649987117720,MATH 193A,A03,083781,Staff,1,0,30,29
1649987117720,MATH 193A,A04,083782,Staff,12,0,30,18
1649987123750,MATH 197,001,091859,McAuley; Julian John,9999,0,9999,0
1649987129800,COGS 9,A01,083615,Staff,1,11,60,59
1649987135840,COGS 11,A01,083617,Boyle; Mary E. T.,28,0,40,12
1649987141862,COGS 13,A01,083071,Staff,1,25,40,39
1649987147898,COGS 14A,A01,092681,Staff,8,0,100,92
1649987153923,COGS 14B,A01,083073,Cheng; Tzu-Han,3,0,50,47
1649987159957,COGS 17,A01,092677,Staff,46,0,75,29
1649987165986,COGS 100,A01,083619,Staff,1,15,60,59
1649987172011,COGS 101A,A01,083621,Davis; Joshua Daniel,0,17,60,60
1649987178047,COGS 101B,A01,091572,Staff,19,0,60,41
1649987184074,COGS 101C,A01,083625,Delgado; Tania,22,0,30,8
1649987190100,COGS 107A,A01,083627,Boyle; Mary E. T.,0,1,60,60
1649987196149,COGS 118A,A01,083075,Staff,20,0,60,40
1649987202190,CSE 3,A50,083646,Miranda; Gregory Joseph,22,0,38,16
1649987202190,CSE 3,A51,083647,Miranda; Gregory Joseph,37,0,37,0
1649987208222,CSE 8A,A50,083650,Miranda; Gregory Joseph,2,12,40,38
1649987214246,CSE 11,A01,083080,Cao; Yingjun,0,53,40,40
1649987220274,CSE 12,A01,083652,Staff,16,0,100,84
1649987226302,CSE 15L,A01,083654,Staff,0,0,50,50
1649987226302,CSE 15L,A02,083655,Staff,26,0,50,24
1649987232333,CSE 20,A01,083657,Staff,60,0,80,20
1649987238355,CSE 30,A01,083084,Eldon; John,0,54,40,40
1649987244387,CSE 100,A01,083659,Cao; Yingjun,1,55,50,49
1649987250410,CSE 134B,A01,083661,Powell; Thomas Allan,1,26,65,64
1649987256440,CSE 140,A01,083663,Staff,10,0,75,65
1649987262479,CSE 140L,A01,083088,Eldon; John,6,0,75,69
1649987268505,CSE 175,A01,083665,Kumar; Rakesh,10,0,25,15
1649987274529,CSE 190,A00,092507,Dubnov; Shlomo,17,0,20,3
1649987280580,ECE 45,A01,083139,Staff,0,6,40,40
1649987286606,ECE 65,A50,083695,Staff,2,0,30,28
1649987292630,ECE 109,A01,091882,Touri; Behrouz,50,0,70,20
1649987298656,ECE 180,A00,083140,Abi Samra; Nicholas Camill,26,0,30,4
1649987298656,ECE 180,B00,083141,Abi Samra; Nicholas Camill,10,0,30,20
1649987304696,MATH 10A,A01,083735,Patchell; Gregory David,15,0,30,15
1649987304696,MATH 10A,A02,083736,Patchell; Gregory David,28,0,30,2
1649987304696,MATH 10A,A03,083737,Patchell; Gregory David,27,0,30,3
1649987310729,MATH 10B,A01,083207,Staff,0,2,30,30
1649987310729,MATH 10B,A02,083208,Staff,9,0,30,21
1649987310729,MATH 10B,B01,083739,Staff,22,0,30,8
1649987310729,MATH 10B,B02,083740,Staff,30,0,30,0
1649987316783,MATH 18,A01,083743,Staff,14,0,30,16
1649987316783,MATH 18,A02,083744,Staff,29,0,30,1
1649987316783,MATH 18,A03,083745,Staff,25,0,30,5
1649987316783,MATH 18,A04,083746,Staff,27,0,30,3
1649987316783,MATH 18,B01,083748,Staff,0,3,30,30
1649987316783,MATH 18,B02,083749,Staff,0,0,30,30
1649987316783,MATH 18,B03,083750,Staff,0,0,30,30
1649987316783,MATH 18,B04,083751,Staff,5,0,30,25
1649987322822,MATH 20A,A01,083754,Staff,31,0,40,9
1649987328850,MATH 20B,A01,083756,Staff,0,0,30,30
1649987328850,MATH 20B,A02,083757,Staff,23,0,30,7
1649987334887,MATH 20C,A01,083760,Staff,1,4,30,29
1649987334887,MATH 20C,A02,083761,Staff,0,3,30,30
1649987334887,MATH 20C,B01,083762,Staff,23,0,30,7
1649987334887,MATH 20C,B02,083763,Staff,30,0,30,0
1649987340910,MATH 20D,A01,083765,Staff,0,0,30,30
1649987340910,MATH 20D,A02,083766,Staff,22,0,30,8
1649987340910,MATH 20D,A03,083767,Staff,28,0,30,2
1649987346934,MATH 20E,A01,083771,Staff,11,0,30,19
1649987346934,MATH 20E,A02,083772,Staff,21,0,30,9
1649987346934,MATH 20E,B01,083773,Staff,2,0,30,28
1649987346934,MATH 20E,B02,083774,Staff,24,0,30,6
1649987352961,MATH 103A,A01,083777,Staff,1,5,30,29
1649987352961,MATH 103A,A02,083778,Staff,0,5,30,30
1649987352961,MATH 103A,B01,083779,Staff,0,6,30,30
1649987352961,MATH 103A,B02,083780,Staff,0,5,30,30
1649987358983,MATH 105,A01,085443,Staff,0,10,30,30
1649987365036,MATH 109,A01,083213,Anzaldo; Leesa B,0,3,30,30
1649987365036,MATH 109,A02,083214,Anzaldo; Leesa B,1,2,30,29
1649987365036,MATH 109,B01,083215,Anzaldo; Leesa B,1,1,30,29
1649987365036,MATH 109,B02,083216,Anzaldo; Leesa B,0,0,30,30
1649987371075,MATH 142A,A01,083219,Chow; Bennett,0,6,30,30
1649987371075,MATH 142A,A02,083220,Chow; Bennett,0,5,30,30
1649987371075,MATH 142A,B01,083221,Chow; Bennett,0,7,30,30
1649987371075,MATH 142A,B02,083222,Chow; Bennett,0,6,30,30
1649987377099,MATH 193A,A01,083224,Staff,0,6,30,30
1649987377099,MATH 193A,A02,083225,Staff,0,4,30,30
1649987377099,MATH 193A,A03,083781,Staff,1,0,30,29
1649987377099,MATH 193A,A04,083782,Staff,12,0,30,18
1649987383133,MATH 197,001,091859,McAuley; Julian John,9999,0,9999,0
1649987389208,COGS 9,A01,083615,Staff,1,11,60,59
1649987395232,COGS 11,A01,083617,Boyle; Mary E. T.,28,0,40,12
1649987401277,COGS 13,A01,083071,Staff,1,26,40,39
1649987407321,COGS 14A,A01,092681,Staff,8,0,100,92
1649987413352,COGS 14B,A01,083073,Cheng; Tzu-Han,3,0,50,47
1649987419392,COGS 17,A01,092677,Staff,46,0,75,29
1649987425423,COGS 100,A01,083619,Staff,1,15,60,59
1649987431472,COGS 101A,A01,083621,Davis; Joshua Daniel,0,17,60,60
1649987437514,COGS 101B,A01,091572,Staff,19,0,60,41
1649987443543,COGS 101C,A01,083625,Delgado; Tania,22,0,30,8
1649987449592,COGS 107A,A01,083627,Boyle; Mary E. T.,0,1,60,60
1649987455625,COGS 118A,A01,083075,Staff,20,0,60,40
1649987461668,CSE 3,A50,083646,Miranda; Gregory Joseph,22,0,38,16
1649987461668,CSE 3,A51,083647,Miranda; Gregory Joseph,37,0,37,0
1649987467713,CSE 8A,A50,083650,Miranda; Gregory Joseph,2,12,40,38
1649987473746,CSE 11,A01,083080,Cao; Yingjun,0,53,40,40
1649987479787,CSE 12,A01,083652,Staff,16,0,100,84
1649987485814,CSE 15L,A01,083654,Staff,0,0,50,50
1649987485814,CSE 15L,A02,083655,Staff,26,0,50,24
1649987491850,CSE 20,A01,083657,Staff,60,0,80,20
1649987497905,CSE 30,A01,083084,Eldon; John,0,54,40,40
1649987503938,CSE 100,A01,083659,Cao; Yingjun,1,55,50,49
1649987509963,CSE 134B,A01,083661,Powell; Thomas Allan,1,26,65,64
1649987515993,CSE 140,A01,083663,Staff,10,0,75,65
1649987522032,CSE 140L,A01,083088,Eldon; John,6,0,75,69
1649987528067,CSE 175,A01,083665,Kumar; Rakesh,10,0,25,15
1649987534093,CSE 190,A00,092507,Dubnov; Shlomo,17,0,20,3
1649987540127,ECE 45,A01,083139,Staff,0,6,40,40
1649987546150,ECE 65,A50,083695,Staff,2,0,30,28
1649987552261,ECE 109,A01,091882,Touri; Behrouz,50,0,70,20
1649987558311,ECE 180,A00,083140,Abi Samra; Nicholas Camill,26,0,30,4
1649987558311,ECE 180,B00,083141,Abi Samra; Nicholas Camill,10,0,30,20
1649987564333,MATH 10A,A01,083735,Patchell; Gregory David,15,0,30,15
1649987564333,MATH 10A,A02,083736,Patchell; Gregory David,28,0,30,2
1649987564333,MATH 10A,A03,083737,Patchell; Gregory David,27,0,30,3
1649987570359,MATH 10B,A01,083207,Staff,0,2,30,30
1649987570359,MATH 10B,A02,083208,Staff,8,0,30,22
1649987570359,MATH 10B,B01,083739,Staff,22,0,30,8
1649987570359,MATH 10B,B02,083740,Staff,30,0,30,0
1649987576382,MATH 18,A01,083743,Staff,14,0,30,16
1649987576382,MATH 18,A02,083744,Staff,29,0,30,1
1649987576382,MATH 18,A03,083745,Staff,25,0,30,5
1649987576382,MATH 18,A04,083746,Staff,27,0,30,3
1649987576382,MATH 18,B01,083748,Staff,0,3,30,30
1649987576382,MATH 18,B02,083749,Staff,0,0,30,30
1649987576382,MATH 18,B03,083750,Staff,0,0,30,30
1649987576382,MATH 18,B04,083751,Staff,3,0,30,27
1649987582410,MATH 20A,A01,083754,Staff,31,0,40,9
1649987588438,MATH 20B,A01,083756,Staff,0,1,30,30
1649987588438,MATH 20B,A02,083757,Staff,23,0,30,7
1649987594470,MATH 20C,A01,083760,Staff,1,4,30,29
1649987594470,MATH 20C,A02,083761,Staff,0,3,30,30
1649987594470,MATH 20C,B01,083762,Staff,23,0,30,7
1649987594470,MATH 20C,B02,083763,Staff,30,0,30,0
1649987600519,MATH 20D,A01,083765,Staff,0,0,30,30
1649987600519,MATH 20D,A02,083766,Staff,21,0,30,9
1649987600519,MATH 20D,A03,083767,Staff,28,0,30,2
1649987606543,MATH 20E,A01,083771,Staff,11,0,30,19
1649987606543,MATH 20E,A02,083772,Staff,21,0,30,9
1649987606543,MATH 20E,B01,083773,Staff,2,0,30,28
1649987606543,MATH 20E,B02,083774,Staff,24,0,30,6
1649987612584,MATH 103A,A01,083777,Staff,1,5,30,29
1649987612584,MATH 103A,A02,083778,Staff,0,5,30,30
1649987612584,MATH 103A,B01,083779,Staff,0,6,30,30
1649987612584,MATH 103A,B02,083780,Staff,0,5,30,30
1649987618618,MATH 105,A01,085443,Staff,0,10,30,30
1649987624645,MATH 109,A01,083213,Anzaldo; Leesa B,0,3,30,30
1649987624645,MATH 109,A02,083214,Anzaldo; Leesa B,1,2,30,29
1649987624645,MATH 109,B01,083215,Anzaldo; Leesa B,1,1,30,29
1649987624645,MATH 109,B02,083216,Anzaldo; Leesa B,0,1,30,30
1649987630693,MATH 142A,A01,083219,Chow; Bennett,0,6,30,30
1649987630693,MATH 142A,A02,083220,Chow; Bennett,0,5,30,30
1649987630693,MATH 142A,B01,083221,Chow; Bennett,0,7,30,30
1649987630693,MATH 142A,B02,083222,Chow; Bennett,0,6,30,30
1649987636735,MATH 193A,A01,083224,Staff,0,6,30,30
1649987636735,MATH 193A,A02,083225,Staff,0,4,30,30
1649987636735,MATH 193A,A03,083781,Staff,1,0,30,29
1649987636735,MATH 193A,A04,083782,Staff,12,0,30,18
1649987642758,MATH 197,001,091859,McAuley; Julian John,9999,0,9999,0
1649987648883,COGS 9,A01,083615,Staff,1,11,60,59
1649987654909,COGS 11,A01,083617,Boyle; Mary E. T.,28,0,40,12
1649987660943,COGS 13,A01,083071,Staff,1,26,40,39
1649987666989,COGS 14A,A01,092681,Staff,8,0,100,92
1649987673032,COGS 14B,A01,083073,Cheng; Tzu-Han,3,0,50,47
1649987679056,COGS 17,A01,092677,Staff,46,0,75,29
1649987685091,COGS 100,A01,083619,Staff,1,15,60,59
1649987691130,COGS 101A,A01,083621,Davis; Joshua Daniel,0,17,60,60
1649987697178,COGS 101B,A01,091572,Staff,19,0,60,41
1649987703221,COGS 101C,A01,083625,Delgado; Tania,22,0,30,8
1649987709261,COGS 107A,A01,083627,Boyle; Mary E. T.,0,1,60,60
1649987715318,COGS 118A,A01,083075,Staff,20,0,60,40
1649987721376,CSE 3,A50,083646,Miranda; Gregory Joseph,22,0,38,16
1649987721376,CSE 3,A51,083647,Miranda; Gregory Joseph,37,0,37,0
1649987727400,CSE 8A,A50,083650,Miranda; Gregory Joseph,2,12,40,38
1649987733446,CSE 11,A01,083080,Cao; Yingjun,0,53,40,40
1649987739484,CSE 12,A01,083652,Staff,16,0,100,84
1649987745517,CSE 15L,A01,083654,Staff,0,0,50,50
1649987745517,CSE 15L,A02,083655,Staff,26,0,50,24
1649987751557,CSE 20,A01,083657,Staff,60,0,80,20
1649987757584,CSE 30,A01,083084,Eldon; John,0,54,40,40
1649987763622,CSE 100,A01,083659,Cao; Yingjun,1,55,50,49
1649987769656,CSE 134B,A01,083661,Powell; Thomas Allan,1,26,65,64
1649987775696,CSE 140,A01,083663,Staff,10,0,75,65
1649987781735,CSE 140L,A01,083088,Eldon; John,6,0,75,69
1649987787761,CSE 175,A01,083665,Kumar; Rakesh,10,0,25,15
1649987793804,CSE 190,A00,092507,Dubnov; Shlomo,17,0,20,3
1649987799829,ECE 45,A01,083139,Staff,0,6,40,40
1649987805854,ECE 65,A50,083695,Staff,2,0,30,28
1649987811889,ECE 109,A01,091882,Touri; Behrouz,50,0,70,20
1649987817922,ECE 180,A00,083140,Abi Samra; Nicholas Camill,26,0,30,4
1649987817922,ECE 180,B00,083141,Abi Samra; Nicholas Camill,10,0,30,20
1649987823966,MATH 10A,A01,083735,Patchell; Gregory David,15,0,30,15
1649987823966,MATH 10A,A02,083736,Patchell; Gregory David,28,0,30,2
1649987823966,MATH 10A,A03,083737,Patchell; Gregory David,27,0,30,3
1649987829989,MATH 10B,A01,083207,Staff,0,2,30,30
1649987829989,MATH 10B,A02,083208,Staff,8,0,30,22
1649987829989,MATH 10B,B01,083739,Staff,22,0,30,8
1649987829989,MATH 10B,B02,083740,Staff,30,0,30,0
1649987836019,MATH 18,A01,083743,Staff,14,0,30,16
1649987836019,MATH 18,A02,083744,Staff,29,0,30,1
1649987836019,MATH 18,A03,083745,Staff,25,0,30,5
1649987836019,MATH 18,A04,083746,Staff,27,0,30,3
1649987836019,MATH 18,B01,083748,Staff,0,3,30,30
1649987836019,MATH 18,B02,083749,Staff,0,0,30,30
1649987836019,MATH 18,B03,083750,Staff,0,0,30,30
1649987836019,MATH 18,B04,083751,Staff,0,0,30,30
1649987842058,MATH 20A,A01,083754,Staff,31,0,40,9
1649987848082,MATH 20B,A01,083756,Staff,0,1,30,30
1649987848082,MATH 20B,A02,083757,Staff,22,0,30,8
1649987854117,MATH 20C,A01,083760,Staff,1,4,30,29
1649987854117,MATH 20C,A02,083761,Staff,0,3,30,30
1649987854117,MATH 20C,B01,083762,Staff,23,0,30,7
1649987854117,MATH 20C,B02,083763,Staff,30,0,30,0
1649987860140,MATH 20D,A01,083765,Staff,0,0,30,30
1649987860140,MATH 20D,A02,083766,Staff,21,0,30,9
1649987860140,MATH 20D,A03,083767,Staff,28,0,30,2
1649987866167,MATH 20E,A01,083771,Staff,11,0,30,19
1649987866167,MATH 20E,A02,083772,Staff,21,0,30,9
1649987866167,MATH 20E,B01,083773,Staff,2,0,30,28
1649987866167,MATH 20E,B02,083774,Staff,24,0,30,6
1649987872210,MATH 103A,A01,083777,Staff,1,5,30,29
1649987872210,MATH 103A,A02,083778,Staff,0,5,30,30
1649987872210,MATH 103A,B01,083779,Staff,0,6,30,30
1649987872210,MATH 103A,B02,083780,Staff,0,5,30,30
1649987878247,MATH 105,A01,085443,Staff,0,10,30,30
1649987884280,MATH 109,A01,083213,Anzaldo; Leesa B,0,3,30,30
1649987884280,MATH 109,A02,083214,Anzaldo; Leesa B,1,2,30,29
1649987884280,MATH 109,B01,083215,Anzaldo; Leesa B,1,1,30,29
1649987884280,MATH 109,B02,083216,Anzaldo; Leesa B,0,1,30,30
1649987890316,MATH 142A,A01,083219,Chow; Bennett,0,7,30,30
1649987890316,MATH 142A,A02,083220,Chow; Bennett,0,5,30,30
1649987890316,MATH 142A,B01,083221,Chow; Bennett,0,7,30,30
1649987890316,MATH 142A,B02,083222,Chow; Bennett,0,6,30,30
1649987896348,MATH 193A,A01,083224,Staff,0,6,30,30
1649987896348,MATH 193A,A02,083225,Staff,0,4,30,30
1649987896348,MATH 193A,A03,083781,Staff,1,0,30,29
1649987896348,MATH 193A,A04,083782,Staff,12,0,30,18
1649987902370,MATH 197,001,091859,McAuley; Julian John,9999,0,9999,0
1649987908451,COGS 9,A01,083615,Staff,1,11,60,59
1649987914488,COGS 11,A01,083617,Boyle; Mary E. T.,28,0,40,12
1649987920536,COGS 13,A01,083071,Staff,1,26,40,39
1649987926578,COGS 14A,A01,092681,Staff,8,0,100,92
1649987932607,COGS 14B,A01,083073,Cheng; Tzu-Han,3,0,50,47
1649987938644,COGS 17,A01,092677,Staff,46,0,75,29
1649987944679,COGS 100,A01,083619,Staff,1,15,60,59
1649987950732,COGS 101A,A01,083621,Davis; Joshua Daniel,0,17,60,60
1649987956766,COGS 101B,A01,091572,Staff,19,0,60,41
1649987962790,COGS 101C,A01,083625,Delgado; Tania,22,0,30,8
1649987968816,COGS 107A,A01,083627,Boyle; Mary E. T.,0,1,60,60
1649987974848,COGS 118A,A01,083075,Staff,20,0,60,40
1649987980871,CSE 3,A50,083646,Miranda; Gregory Joseph,22,0,38,16
1649987980871,CSE 3,A51,083647,Miranda; Gregory Joseph,37,0,37,0
1649987986908,CSE 8A,A50,083650,Miranda; Gregory Joseph,2,12,40,38
1649987992935,CSE 11,A01,083080,Cao; Yingjun,0,54,40,40
1649987998963,CSE 12,A01,083652,Staff,16,0,100,84
1649988004988,CSE 15L,A01,083654,Staff,0,0,50,50
1649988004988,CSE 15L,A02,083655,Staff,26,0,50,24
1649988011024,CSE 20,A01,083657,Staff,60,0,80,20
1649988017045,CSE 30,A01,083084,Eldon; John,0,54,40,40
1649988023068,CSE 100,A01,083659,Cao; Yingjun,1,55,50,49
1649988029099,CSE 134B,A01,083661,Powell; Thomas Allan,1,26,65,64
1649988035124,CSE 140,A01,083663,Staff,10,0,75,65
1649988041152,CSE 140L,A01,083088,Eldon; John,6,0,75,69
1649988047175,CSE 175,A01,083665,Kumar; Rakesh,10,0,25,15
1649988053203,CSE 190,A00,092507,Dubnov; Shlomo,17,0,20,3
1649988059227,ECE 45,A01,083139,Staff,0,6,40,40
1649988065251,ECE 65,A50,083695,Staff,2,0,30,28
1649988071300,ECE 109,A01,091882,Touri; Behrouz,49,0,70,21
1649988077343,ECE 180,A00,083140,Abi Samra; Nicholas Camill,26,0,30,4
1649988077343,ECE 180,B00,083141,Abi Samra; Nicholas Camill,10,0,30,20
1649988083379,MATH 10A,A01,083735,Patchell; Gregory David,15,0,30,15
1649988083379,MATH 10A,A02,083736,Patchell; Gregory David,28,0,30,2
1649988083379,MATH 10A,A03,083737,Patchell; Gregory David,27,0,30,3
1649988089405,MATH 10B,A01,083207,Staff,0,2,30,30
1649988089405,MATH 10B,A02,083208,Staff,7,0,30,23
1649988089405,MATH 10B,B01,083739,Staff,22,0,30,8
1649988089405,MATH 10B,B02,083740,Staff,30,0,30,0
1649988095456,MATH 18,A01,083743,Staff,14,0,30,16
1649988095456,MATH 18,A02,083744,Staff,29,0,30,1
1649988095456,MATH 18,A03,083745,Staff,25,0,30,5
1649988095456,MATH 18,A04,083746,Staff,27,0,30,3
1649988095456,MATH 18,B01,083748,Staff,0,3,30,30
1649988095456,MATH 18,B02,083749,Staff,0,0,30,30
1649988095456,MATH 18,B03,083750,Staff,0,0,30,30
1649988095456,MATH 18,B04,083751,Staff,0,0,30,30
1649988101483,MATH 20A,A01,083754,Staff,31,0,40,9
1649988107507,MATH 20B,A01,083756,Staff,0,0,30,30
1649988107507,MATH 20B,A02,083757,Staff,20,0,30,10
1649988113547,MATH 20C,A01,083760,Staff,1,5,30,29
1649988113547,MATH 20C,A02,083761,Staff,0,3,30,30
1649988113547,MATH 20C,B01,083762,Staff,23,0,30,7
1649988113547,MATH 20C,B02,083763,Staff,30,0,30,0
1649988119589,MATH 20D,A01,083765,Staff,0,0,30,30
1649988119589,MATH 20D,A02,083766,Staff,21,0,30,9
1649988119589,MATH 20D,A03,083767,Staff,28,0,30,2
1649988125615,MATH 20E,A01,083771,Staff,11,0,30,19
1649988125615,MATH 20E,A02,083772,Staff,21,0,30,9
1649988125615,MATH 20E,B01,083773,Staff,2,0,30,28
1649988125615,MATH 20E,B02,083774,Staff,24,0,30,6
1649988131645,MATH 103A,A01,083777,Staff,1,5,30,29
1649988131645,MATH 103A,A02,083778,Staff,0,5,30,30
1649988131645,MATH 103A,B01,083779,Staff,0,6,30,30
1649988131645,MATH 103A,B02,083780,Staff,0,5,30,30
1649988137682,MATH 105,A01,085443,Staff,0,10,30,30
1649988143723,MATH 109,A01,083213,Anzaldo; Leesa B,0,3,30,30
1649988143723,MATH 109,A02,083214,Anzaldo; Leesa B,1,2,30,29
1649988143723,MATH 109,B01,083215,Anzaldo; Leesa B,1,1,30,29
1649988143723,MATH 109,B02,083216,Anzaldo; Leesa B,0,1,30,30
1649988149835,MATH 142A,A01,083219,Chow; Bennett,0,7,30,30
1649988149835,MATH 142A,A02,083220,Chow; Bennett,0,5,30,30
1649988149835,MATH 142A,B01,083221,Chow; Bennett,0,7,30,30
1649988149835,MATH 142A,B02,083222,Chow; Bennett,0,6,30,30
1649988155878,MATH 193A,A01,083224,Staff,0,6,30,30
1649988155878,MATH 193A,A02,083225,Staff,0,4,30,30
1649988155878,MATH 193A,A03,083781,Staff,1,0,30,29
1649988155878,MATH 193A,A04,083782,Staff,12,0,30,18
1649988161902,MATH 197,001,091859,McAuley; Julian John,9999,0,9999,0
1649988167972,COGS 9,A01,083615,Staff,1,12,60,59
1649988173996,COGS 11,A01,083617,Boyle; Mary E. T.,28,0,40,12
1649988180036,COGS 13,A01,083071,Staff,1,26,40,39
1649988186065,COGS 14A,A01,092681,Staff,8,0,100,92
1649988192097,COGS 14B,A01,083073,Cheng; Tzu-Han,2,0,50,48
1649988198149,COGS 17,A01,092677,Staff,46,0,75,29
1649988204191,COGS 100,A01,083619,Staff,1,15,60,59
1649988210216,COGS 101A,A01,083621,Davis; Joshua Daniel,0,17,60,60
1649988216264,COGS 101B,A01,091572,Staff,19,0,60,41
1649988222302,COGS 101C,A01,083625,Delgado; Tania,21,0,30,9
1649988228336,COGS 107A,A01,083627,Boyle; Mary E. T.,0,1,60,60
1649988234364,COGS 118A,A01,083075,Staff,20,0,60,40
1649988240398,CSE 3,A50,083646,Miranda; Gregory Joseph,22,0,38,16
1649988240398,CSE 3,A51,083647,Miranda; Gregory Joseph,37,0,37,0
1649988246429,CSE 8A,A50,083650,Miranda; Gregory Joseph,2,12,40,38
1649988252451,CSE 11,A01,083080,Cao; Yingjun,0,54,40,40
1649988258523,CSE 12,A01,083652,Staff,16,0,100,84
1649988264550,CSE 15L,A01,083654,Staff,0,0,50,50
1649988264550,CSE 15L,A02,083655,Staff,26,0,50,24
1649988270585,CSE 20,A01,083657,Staff,60,0,80,20
1649988276608,CSE 30,A01,083084,Eldon; John,0,54,40,40
1649988282649,CSE 100,A01,083659,Cao; Yingjun,1,55,50,49
1649988288678,CSE 134B,A01,083661,Powell; Thomas Allan,1,26,65,64
1649988294710,CSE 140,A01,083663,Staff,10,0,75,65
1649988300745,CSE 140L,A01,083088,Eldon; John,6,0,75,69
1649988306781,CSE 175,A01,083665,Kumar; Rakesh,10,0,25,15
1649988312807,CSE 190,A00,092507,Dubnov; Shlomo,17,0,20,3
1649988318842,ECE 45,A01,083139,Staff,0,6,40,40
1649988324871,ECE 65,A50,083695,Staff,2,0,30,28
1649988330917,ECE 109,A01,091882,Touri; Behrouz,49,0,70,21
1649988336964,ECE 180,A00,083140,Abi Samra; Nicholas Camill,26,0,30,4
1649988336964,ECE 180,B00,083141,Abi Samra; Nicholas Camill,10,0,30,20
1649988342995,MATH 10A,A01,083735,Patchell; Gregory David,15,0,30,15
1649988342995,MATH 10A,A02,083736,Patchell; Gregory David,28,0,30,2
1649988342995,MATH 10A,A03,083737,Patchell; Gregory David,27,0,30,3
1649988349019,MATH 10B,A01,083207,Staff,0,2,30,30
1649988349019,MATH 10B,A02,083208,Staff,7,0,30,23
1649988349019,MATH 10B,B01,083739,Staff,22,0,30,8
1649988349019,MATH 10B,B02,083740,Staff,30,0,30,0
1649988355065,MATH 18,A01,083743,Staff,14,0,30,16
1649988355065,MATH 18,A02,083744,Staff,29,0,30,1
1649988355065,MATH 18,A03,083745,Staff,25,0,30,5
1649988355065,MATH 18,A04,083746,Staff,27,0,30,3
1649988355065,MATH 18,B01,083748,Staff,0,3,30,30
1649988355065,MATH 18,B02,083749,Staff,0,0,30,30
1649988355065,MATH 18,B03,083750,Staff,0,0,30,30
1649988355065,MATH 18,B04,083751,Staff,0,0,30,30
1649988361101,MATH 20A,A01,083754,Staff,31,0,40,9
1649988367147,MATH 20B,A01,083756,Staff,0,0,30,30
1649988367147,MATH 20B,A02,083757,Staff,20,0,30,10
1649988373182,MATH 20C,A01,083760,Staff,1,5,30,29
1649988373182,MATH 20C,A02,083761,Staff,0,3,30,30
1649988373182,MATH 20C,B01,083762,Staff,23,0,30,7
1649988373182,MATH 20C,B02,083763,Staff,30,0,30,0
1649988379206,MATH 20D,A01,083765,Staff,0,0,30,30
1649988379206,MATH 20D,A02,083766,Staff,21,0,30,9
1649988379206,MATH 20D,A03,083767,Staff,28,0,30,2
1649988385258,MATH 20E,A01,083771,Staff,11,0,30,19
1649988385258,MATH 20E,A02,083772,Staff,21,0,30,9
1649988385258,MATH 20E,B01,083773,Staff,2,0,30,28
1649988385258,MATH 20E,B02,083774,Staff,24,0,30,6
1649988391287,MATH 103A,A01,083777,Staff,1,5,30,29
1649988391287,MATH 103A,A02,083778,Staff,0,5,30,30
1649988391287,MATH 103A,B01,083779,Staff,0,6,30,30
1649988391287,MATH 103A,B02,083780,Staff,0,5,30,30
1649988397351,MATH 105,A01,085443,Staff,0,10,30,30
1649988403389,MATH 109,A01,083213,Anzaldo; Leesa B,0,3,30,30
1649988403389,MATH 109,A02,083214,Anzaldo; Leesa B,1,2,30,29
1649988403389,MATH 109,B01,083215,Anzaldo; Leesa B,1,1,30,29
1649988403389,MATH 109,B02,083216,Anzaldo; Leesa B,0,1,30,30
1649988409431,MATH 142A,A01,083219,Chow; Bennett,0,7,30,30
1649988409431,MATH 142A,A02,083220,Chow; Bennett,0,5,30,30
1649988409431,MATH 142A,B01,083221,Chow; Bennett,0,7,30,30
1649988409431,MATH 142A,B02,083222,Chow; Bennett,0,6,30,30
1649988415470,MATH 193A,A01,083224,Staff,0,6,30,30
1649988415470,MATH 193A,A02,083225,Staff,0,4,30,30
1649988415470,MATH 193A,A03,083781,Staff,1,0,30,29
1649988415470,MATH 193A,A04,083782,Staff,12,0,30,18
1649988421510,MATH 197,001,091859,McAuley; Julian John,9999,0,9999,0
1649988427575,COGS 9,A01,083615,Staff,2,11,60,58
1649988433616,COGS 11,A01,083617,Boyle; Mary E. T.,28,0,40,12
1649988439653,COGS 13,A01,083071,Staff,1,26,40,39
1649988445703,COGS 14A,A01,092681,Staff,7,0,100,93
1649988451747,COGS 14B,A01,083073,Cheng; Tzu-Han,2,0,50,48
1649988457789,COGS 17,A01,092677,Staff,45,0,75,30
1649988463817,COGS 100,A01,083619,Staff,1,15,60,59
1649988469856,COGS 101A,A01,083621,Davis; Joshua Daniel,0,17,60,60
1649988475899,COGS 101B,A01,091572,Staff,19,0,60,41
1649988481925,COGS 101C,A01,083625,Delgado; Tania,21,0,30,9
1649988487954,COGS 107A,A01,083627,Boyle; Mary E. T.,0,1,60,60
1649988493990,COGS 118A,A01,083075,Staff,20,0,60,40
1649988500032,CSE 3,A50,083646,Miranda; Gregory Joseph,22,0,38,16
1649988500032,CSE 3,A51,083647,Miranda; Gregory Joseph,37,0,37,0
1649988506055,CSE 8A,A50,083650,Miranda; Gregory Joseph,2,12,40,38
1649988512094,CSE 11,A01,083080,Cao; Yingjun,0,54,40,40
1649988518142,CSE 12,A01,083652,Staff,16,0,100,84
1649988524172,CSE 15L,A01,083654,Staff,0,0,50,50
1649988524172,CSE 15L,A02,083655,Staff,26,0,50,24
1649988530211,CSE 20,A01,083657,Staff,60,0,80,20
1649988536253,CSE 30,A01,083084,Eldon; John,0,54,40,40
1649988542290,CSE 100,A01,083659,Cao; Yingjun,1,55,50,49
1649988548313,CSE 134B,A01,083661,Powell; Thomas Allan,1,26,65,64
1649988554361,CSE 140,A01,083663,Staff,10,0,75,65
1649988560409,CSE 140L,A01,083088,Eldon; John,6,0,75,69
1649988566445,CSE 175,A01,083665,Kumar; Rakesh,10,0,25,15
1649988572498,CSE 190,A00,092507,Dubnov; Shlomo,17,0,20,3
1649988578549,ECE 45,A01,083139,Staff,0,6,40,40
1649988584588,ECE 65,A50,083695,Staff,2,0,30,28
1649988590611,ECE 109,A01,091882,Touri; Behrouz,49,0,70,21
1649988596659,ECE 180,A00,083140,Abi Samra; Nicholas Camill,26,0,30,4
1649988596659,ECE 180,B00,083141,Abi Samra; Nicholas Camill,10,0,30,20
1649988602705,MATH 10A,A01,083735,Patchell; Gregory David,15,0,30,15
1649988602705,MATH 10A,A02,083736,Patchell; Gregory David,28,0,30,2
1649988602705,MATH 10A,A03,083737,Patchell; Gregory David,27,0,30,3
1649988608760,MATH 10B,A01,083207,Staff,0,2,30,30
1649988608760,MATH 10B,A02,083208,Staff,7,0,30,23
1649988608760,MATH 10B,B01,083739,Staff,22,0,30,8
1649988608760,MATH 10B,B02,083740,Staff,30,0,30,0
1649988614813,MATH 18,A01,083743,Staff,14,0,30,16
1649988614813,MATH 18,A02,083744,Staff,29,0,30,1
1649988614813,MATH 18,A03,083745,Staff,25,0,30,5
1649988614813,MATH 18,A04,083746,Staff,27,0,30,3
1649988614813,MATH 18,B01,083748,Staff,0,3,30,30
1649988614813,MATH 18,B02,083749,Staff,0,0,30,30
1649988614813,MATH 18,B03,083750,Staff,0,0,30,30
1649988614813,MATH 18,B04,083751,Staff,0,0,30,30
1649988620866,MATH 20A,A01,083754,Staff,31,0,40,9
1649988626916,MATH 20B,A01,083756,Staff,0,0,30,30
1649988626916,MATH 20B,A02,083757,Staff,20,0,30,10
1649988632949,MATH 20C,A01,083760,Staff,1,5,30,29
1649988632949,MATH 20C,A02,083761,Staff,0,3,30,30
1649988632949,MATH 20C,B01,083762,Staff,22,0,30,8
1649988632949,MATH 20C,B02,083763,Staff,30,0,30,0
1649988638972,MATH 20D,A01,083765,Staff,0,0,30,30
1649988638972,MATH 20D,A02,083766,Staff,21,0,30,9
1649988638972,MATH 20D,A03,083767,Staff,28,0,30,2
1649988645032,MATH 20E,A01,083771,Staff,11,0,30,19
1649988645032,MATH 20E,A02,083772,Staff,21,0,30,9
1649988645032,MATH 20E,B01,083773,Staff,1,0,30,29
1649988645032,MATH 20E,B02,083774,Staff,24,0,30,6
1649988651068,MATH 103A,A01,083777,Staff,1,5,30,29
1649988651068,MATH 103A,A02,083778,Staff,0,5,30,30
1649988651068,MATH 103A,B01,083779,Staff,0,6,30,30
1649988651068,MATH 103A,B02,083780,Staff,0,5,30,30
1649988657099,MATH 105,A01,085443,Staff,0,10,30,30
1649988663129,MATH 109,A01,083213,Anzaldo; Leesa B,0,3,30,30
1649988663129,MATH 109,A02,083214,Anzaldo; Leesa B,1,2,30,29
1649988663129,MATH 109,B01,083215,Anzaldo; Leesa B,1,1,30,29
1649988663129,MATH 109,B02,083216,Anzaldo; Leesa B,0,1,30,30
1649988669157,MATH 142A,A01,083219,Chow; Bennett,0,7,30,30
1649988669157,MATH 142A,A02,083220,Chow; Bennett,0,5,30,30
1649988669157,MATH 142A,B01,083221,Chow; Bennett,0,7,30,30
1649988669157,MATH 142A,B02,083222,Chow; Bennett,0,6,30,30
1649988675200,MATH 193A,A01,083224,Staff,0,6,30,30
1649988675200,MATH 193A,A02,083225,Staff,0,4,30,30
1649988675200,MATH 193A,A03,083781,Staff,1,0,30,29
1649988675200,MATH 193A,A04,083782,Staff,12,0,30,18
1649988681227,MATH 197,001,091859,McAuley; Julian John,9999,0,9999,0
1649988687327,COGS 9,A01,083615,Staff,2,11,60,58
1649988693363,COGS 11,A01,083617,Boyle; Mary E. T.,28,0,40,12
1649988699391,COGS 13,A01,083071,Staff,1,26,40,39
1649988705444,COGS 14A,A01,092681,Staff,7,0,100,93
1649988711479,COGS 14B,A01,083073,Cheng; Tzu-Han,2,0,50,48
1649988717518,COGS 17,A01,092677,Staff,45,0,75,30
1649988723548,COGS 100,A01,083619,Staff,1,15,60,59
1649988729577,COGS 101A,A01,083621,Davis; Joshua Daniel,0,17,60,60
1649988735616,COGS 101B,A01,091572,Staff,19,0,60,41
1649988741752,COGS 101C,A01,083625,Delgado; Tania,21,0,30,9
1649988747776,COGS 107A,A01,083627,Boyle; Mary E. T.,0,1,60,60
1649988753801,COGS 118A,A01,083075,Staff,20,0,60,40
1649988759831,CSE 3,A50,083646,Miranda; Gregory Joseph,22,0,38,16
1649988759831,CSE 3,A51,083647,Miranda; Gregory Joseph,37,0,37,0
1649988765857,CSE 8A,A50,083650,Miranda; Gregory Joseph,2,12,40,38
1649988771914,CSE 11,A01,083080,Cao; Yingjun,0,54,40,40
1649988777965,CSE 12,A01,083652,Staff,15,0,100,85
1649988784004,CSE 15L,A01,083654,Staff,0,0,50,50
1649988784004,CSE 15L,A02,083655,Staff,25,0,50,25
1649988790061,CSE 20,A01,083657,Staff,59,0,80,21
1649988796121,CSE 30,A01,083084,Eldon; John,0,54,40,40
1649988802170,CSE 100,A01,083659,Cao; Yingjun,1,55,50,49
1649988808226,CSE 134B,A01,083661,Powell; Thomas Allan,1,26,65,64
1649988814260,CSE 140,A01,083663,Staff,10,0,75,65
1649988820296,CSE 140L,A01,083088,Eldon; John,6,0,75,69
1649988826328,CSE 175,A01,083665,Kumar; Rakesh,10,0,25,15
1649988832355,CSE 190,A00,092507,Dubnov; Shlomo,17,0,20,3
1649988838381,ECE 45,A01,083139,Staff,0,6,40,40
1649988844410,ECE 65,A50,083695,Staff,2,0,30,28
1649988850459,ECE 109,A01,091882,Touri; Behrouz,49,0,70,21
1649988856497,ECE 180,A00,083140,Abi Samra; Nicholas Camill,26,0,30,4
1649988856497,ECE 180,B00,083141,Abi Samra; Nicholas Camill,10,0,30,20
1649988862525,MATH 10A,A01,083735,Patchell; Gregory David,15,0,30,15
1649988862525,MATH 10A,A02,083736,Patchell; Gregory David,28,0,30,2
1649988862525,MATH 10A,A03,083737,Patchell; Gregory David,27,0,30,3
1649988868568,MATH 10B,A01,083207,Staff,0,2,30,30
1649988868568,MATH 10B,A02,083208,Staff,7,0,30,23
1649988868568,MATH 10B,B01,083739,Staff,22,0,30,8
1649988868568,MATH 10B,B02,083740,Staff,30,0,30,0
1649988874617,MATH 18,A01,083743,Staff,14,0,30,16
1649988874617,MATH 18,A02,083744,Staff,29,0,30,1
1649988874617,MATH 18,A03,083745,Staff,25,0,30,5
1649988874617,MATH 18,A04,083746,Staff,27,0,30,3
1649988874617,MATH 18,B01,083748,Staff,0,3,30,30
1649988874617,MATH 18,B02,083749,Staff,0,0,30,30
1649988874617,MATH 18,B03,083750,Staff,0,0,30,30
1649988874617,MATH 18,B04,083751,Staff,0,0,30,30
1649988880649,MATH 20A,A01,083754,Staff,31,0,40,9
1649988886683,MATH 20B,A01,083756,Staff,0,0,30,30
1649988886683,MATH 20B,A02,083757,Staff,20,0,30,10
1649988892708,MATH 20C,A01,083760,Staff,1,5,30,29
1649988892708,MATH 20C,A02,083761,Staff,0,4,30,30
1649988892708,MATH 20C,B01,083762,Staff,21,0,30,9
1649988892708,MATH 20C,B02,083763,Staff,30,0,30,0
1649988898754,MATH 20D,A01,083765,Staff,0,0,30,30
1649988898754,MATH 20D,A02,083766,Staff,20,0,30,10
1649988898754,MATH 20D,A03,083767,Staff,28,0,30,2
1649988904777,MATH 20E,A01,083771,Staff,11,0,30,19
1649988904777,MATH 20E,A02,083772,Staff,21,0,30,9
1649988904777,MATH 20E,B01,083773,Staff,1,0,30,29
1649988904777,MATH 20E,B02,083774,Staff,24,0,30,6
1649988910806,MATH 103A,A01,083777,Staff,1,5,30,29
1649988910806,MATH 103A,A02,083778,Staff,0,5,30,30
1649988910806,MATH 103A,B01,083779,Staff,0,6,30,30
1649988910806,MATH 103A,B02,083780,Staff,0,5,30,30
1649988916850,MATH 105,A01,085443,Staff,0,10,30,30
1649988922877,MATH 109,A01,083213,Anzaldo; Leesa B,0,3,30,30
1649988922877,MATH 109,A02,083214,Anzaldo; Leesa B,1,2,30,29
1649988922877,MATH 109,B01,083215,Anzaldo; Leesa B,1,1,30,29
1649988922877,MATH 109,B02,083216,Anzaldo; Leesa B,0,1,30,30
1649988928906,MATH 142A,A01,083219,Chow; Bennett,0,7,30,30
1649988928906,MATH 142A,A02,083220,Chow; Bennett,0,5,30,30
1649988928906,MATH 142A,B01,083221,Chow; Bennett,0,7,30,30
1649988928906,MATH 142A,B02,083222,Chow; Bennett,0,6,30,30
1649988934930,MATH 193A,A01,083224,Staff,0,6,30,30
1649988934930,MATH 193A,A02,083225,Staff,0,4,30,30
1649988934930,MATH 193A,A03,083781,Staff,1,0,30,29
1649988934930,MATH 193A,A04,083782,Staff,12,0,30,18
1649988940955,MATH 197,001,091859,McAuley; Julian John,9999,0,9999,0
1649988947060,COGS 9,A01,083615,Staff,2,11,60,58
1649988953114,COGS 11,A01,083617,Boyle; Mary E. T.,28,0,40,12
1649988959146,COGS 13,A01,083071,Staff,1,26,40,39
1649988965180,COGS 14A,A01,092681,Staff,6,0,100,94
1649988971213,COGS 14B,A01,083073,Cheng; Tzu-Han,2,0,50,48
1649988977259,COGS 17,A01,092677,Staff,45,0,75,30
1649988983289,COGS 100,A01,083619,Staff,1,15,60,59
1649988989322,COGS 101A,A01,083621,Davis; Joshua Daniel,0,17,60,60
1649988995362,COGS 101B,A01,091572,Staff,19,0,60,41
1649989001388,COGS 101C,A01,083625,Delgado; Tania,21,0,30,9
1649989007413,COGS 107A,A01,083627,Boyle; Mary E. T.,0,1,60,60
1649989013444,COGS 118A,A01,083075,Staff,20,0,60,40
1649989019468,CSE 3,A50,083646,Miranda; Gregory Joseph,22,0,38,16
1649989019468,CSE 3,A51,083647,Miranda; Gregory Joseph,37,0,37,0
1649989025509,CSE 8A,A50,083650,Miranda; Gregory Joseph,2,12,40,38
1649989031531,CSE 11,A01,083080,Cao; Yingjun,0,54,40,40
1649989037565,CSE 12,A01,083652,Staff,14,0,100,86
1649989043598,CSE 15L,A01,083654,Staff,0,0,50,50
1649989043598,CSE 15L,A02,083655,Staff,24,0,50,26
1649989049645,CSE 20,A01,083657,Staff,59,0,80,21
1649989055694,CSE 30,A01,083084,Eldon; John,0,54,40,40
1649989061742,CSE 100,A01,083659,Cao; Yingjun,1,55,50,49
1649989067776,CSE 134B,A01,083661,Powell; Thomas Allan,1,26,65,64
1649989073821,CSE 140,A01,083663,Staff,10,0,75,65
1649989079846,CSE 140L,A01,083088,Eldon; John,6,0,75,69
1649989085892,CSE 175,A01,083665,Kumar; Rakesh,10,0,25,15
1649989091919,CSE 190,A00,092507,Dubnov; Shlomo,17,0,20,3
1649989097944,ECE 45,A01,083139,Staff,0,6,40,40
1649989103969,ECE 65,A50,083695,Staff,2,0,30,28
1649989110008,ECE 109,A01,091882,Touri; Behrouz,49,0,70,21
1649989116058,ECE 180,A00,083140,Abi Samra; Nicholas Camill,26,0,30,4
1649989116058,ECE 180,B00,083141,Abi Samra; Nicholas Camill,10,0,30,20
1649989122109,MATH 10A,A01,083735,Patchell; Gregory David,15,0,30,15
1649989122109,MATH 10A,A02,083736,Patchell; Gregory David,28,0,30,2
1649989122109,MATH 10A,A03,083737,Patchell; Gregory David,27,0,30,3
1649989128164,MATH 10B,A01,083207,Staff,0,2,30,30
1649989128164,MATH 10B,A02,083208,Staff,7,0,30,23
1649989128164,MATH 10B,B01,083739,Staff,21,0,30,9
1649989128164,MATH 10B,B02,083740,Staff,30,0,30,0
1649989134212,MATH 18,A01,083743,Staff,14,0,30,16
1649989134212,MATH 18,A02,083744,Staff,29,0,30,1
1649989134212,MATH 18,A03,083745,Staff,25,0,30,5
1649989134212,MATH 18,A04,083746,Staff,27,0,30,3
1649989134212,MATH 18,B01,083748,Staff,0,3,30,30
1649989134212,MATH 18,B02,083749,Staff,0,0,30,30
1649989134212,MATH 18,B03,083750,Staff,0,0,30,30
1649989134212,MATH 18,B04,083751,Staff,0,0,30,30
1649989140252,MATH 20A,A01,083754,Staff,30,0,40,10
1649989146292,MATH 20B,A01,083756,Staff,0,0,30,30
1649989146292,MATH 20B,A02,083757,Staff,20,0,30,10
1649989152332,MATH 20C,A01,083760,Staff,1,5,30,29
1649989152332,MATH 20C,A02,083761,Staff,0,4,30,30
1649989152332,MATH 20C,B01,083762,Staff,21,0,30,9
1649989152332,MATH 20C,B02,083763,Staff,30,0,30,0
1649989158374,MATH 20D,A01,083765,Staff,0,0,30,30
1649989158374,MATH 20D,A02,083766,Staff,20,0,30,10
1649989158374,MATH 20D,A03,083767,Staff,28,0,30,2
1649989164417,MATH 20E,A01,083771,Staff,11,0,30,19
1649989164417,MATH 20E,A02,083772,Staff,21,0,30,9
1649989164417,MATH 20E,B01,083773,Staff,0,0,30,30
1649989164417,MATH 20E,B02,083774,Staff,24,0,30,6
1649989170466,MATH 103A,A01,083777,Staff,1,5,30,29
1649989170466,MATH 103A,A02,083778,Staff,0,5,30,30
1649989170466,MATH 103A,B01,083779,Staff,0,6,30,30
1649989170466,MATH 103A,B02,083780,Staff,0,5,30,30
1649989176505,MATH 105,A01,085443,Staff,0,10,30,30
1649989182558,MATH 109,A01,083213,Anzaldo; Leesa B,0,3,30,30
1649989182558,MATH 109,A02,083214,Anzaldo; Leesa B,1,2,30,29
1649989182558,MATH 109,B01,083215,Anzaldo; Leesa B,1,1,30,29
1649989182558,MATH 109,B02,083216,Anzaldo; Leesa B,0,1,30,30
1649989188597,MATH 142A,A01,083219,Chow; Bennett,0,7,30,30
1649989188597,MATH 142A,A02,083220,Chow; Bennett,0,5,30,30
1649989188597,MATH 142A,B01,083221,Chow; Bennett,0,7,30,30
1649989188597,MATH 142A,B02,083222,Chow; Bennett,0,6,30,30
1649989194620,MATH 193A,A01,083224,Staff,0,6,30,30
1649989194620,MATH 193A,A02,083225,Staff,0,4,30,30
1649989194620,MATH 193A,A03,083781,Staff,1,0,30,29
1649989194620,MATH 193A,A04,083782,Staff,12,0,30,18
1649989200658,MATH 197,001,091859,McAuley; Julian John,9999,0,9999,0
1649989206736,COGS 9,A01,083615,Staff,2,11,60,58
1649989212780,COGS 11,A01,083617,Boyle; Mary E. T.,28,0,40,12
1649989218822,COGS 13,A01,083071,Staff,1,26,40,39
1649989224860,COGS 14A,A01,092681,Staff,6,0,100,94
1649989230895,COGS 14B,A01,083073,Cheng; Tzu-Han,2,0,50,48
1649989236942,COGS 17,A01,092677,Staff,45,0,75,30
1649989242993,COGS 100,A01,083619,Staff,1,15,60,59
1649989249024,COGS 101A,A01,083621,Davis; Joshua Daniel,0,17,60,60
1649989255081,COGS 101B,A01,091572,Staff,19,0,60,41
1649989261130,COGS 101C,A01,083625,Delgado; Tania,21,0,30,9
1649989267165,COGS 107A,A01,083627,Boyle; Mary E. T.,0,1,60,60
1649989273207,COGS 118A,A01,083075,Staff,20,0,60,40
1649989279257,CSE 3,A50,083646,Miranda; Gregory Joseph,22,0,38,16
1649989279257,CSE 3,A51,083647,Miranda; Gregory Joseph,37,0,37,0
1649989285293,CSE 8A,A50,083650,Miranda; Gregory Joseph,2,12,40,38
1649989291318,CSE 11,A01,083080,Cao; Yingjun,0,54,40,40
1649989297343,CSE 12,A01,083652,Staff,11,0,100,89
1649989303368,CSE 15L,A01,083654,Staff,0,0,50,50
1649989303368,CSE 15L,A02,083655,Staff,23,0,50,27
1649989309403,CSE 20,A01,083657,Staff,59,0,80,21
1649989315437,CSE 30,A01,083084,Eldon; John,0,54,40,40
1649989321476,CSE 100,A01,083659,Cao; Yingjun,1,55,50,49
1649989327514,CSE 134B,A01,083661,Powell; Thomas Allan,1,26,65,64
1649989333553,CSE 140,A01,083663,Staff,10,0,75,65
1649989339715,CSE 140L,A01,083088,Eldon; John,6,0,75,69
1649989345749,CSE 175,A01,083665,Kumar; Rakesh,10,0,25,15
1649989351794,CSE 190,A00,092507,Dubnov; Shlomo,17,0,20,3
1649989357821,ECE 45,A01,083139,Staff,0,6,40,40
1649989363855,ECE 65,A50,083695,Staff,2,0,30,28
1649989369887,ECE 109,A01,091882,Touri; Behrouz,49,0,70,21
1649989375910,ECE 180,A00,083140,Abi Samra; Nicholas Camill,26,0,30,4
1649989375910,ECE 180,B00,083141,Abi Samra; Nicholas Camill,10,0,30,20
1649989381953,MATH 10A,A01,083735,Patchell; Gregory David,15,0,30,15
1649989381953,MATH 10A,A02,083736,Patchell; Gregory David,28,0,30,2
1649989381953,MATH 10A,A03,083737,Patchell; Gregory David,27,0,30,3
1649989387981,MATH 10B,A01,083207,Staff,0,2,30,30
1649989387981,MATH 10B,A02,083208,Staff,7,0,30,23
1649989387981,MATH 10B,B01,083739,Staff,21,0,30,9
1649989387981,MATH 10B,B02,083740,Staff,30,0,30,0
1649989394006,MATH 18,A01,083743,Staff,14,0,30,16
1649989394006,MATH 18,A02,083744,Staff,29,0,30,1
1649989394006,MATH 18,A03,083745,Staff,25,0,30,5
1649989394006,MATH 18,A04,083746,Staff,27,0,30,3
1649989394006,MATH 18,B01,083748,Staff,0,3,30,30
1649989394006,MATH 18,B02,083749,Staff,0,1,30,30
1649989394006,MATH 18,B03,083750,Staff,0,0,30,30
1649989394006,MATH 18,B04,083751,Staff,0,1,30,30
1649989400033,MATH 20A,A01,083754,Staff,30,0,40,10
1649989406078,MATH 20B,A01,083756,Staff,0,1,30,30
1649989406078,MATH 20B,A02,083757,Staff,20,0,30,10
1649989412132,MATH 20C,A01,083760,Staff,1,5,30,29
1649989412132,MATH 20C,A02,083761,Staff,0,5,30,30
1649989412132,MATH 20C,B01,083762,Staff,21,0,30,9
1649989412132,MATH 20C,B02,083763,Staff,30,0,30,0
1649989418160,MATH 20D,A01,083765,Staff,0,0,30,30
1649989418160,MATH 20D,A02,083766,Staff,20,0,30,10
1649989418160,MATH 20D,A03,083767,Staff,28,0,30,2
1649989424192,MATH 20E,A01,083771,Staff,11,0,30,19
1649989424192,MATH 20E,A02,083772,Staff,21,0,30,9
1649989424192,MATH 20E,B01,083773,Staff,0,0,30,30
1649989424192,MATH 20E,B02,083774,Staff,24,0,30,6
1649989430220,MATH 103A,A01,083777,Staff,1,5,30,29
1649989430220,MATH 103A,A02,083778,Staff,0,5,30,30
1649989430220,MATH 103A,B01,083779,Staff,0,6,30,30
1649989430220,MATH 103A,B02,083780,Staff,0,5,30,30
1649989436265,MATH 105,A01,085443,Staff,0,10,30,30
1649989442287,MATH 109,A01,083213,Anzaldo; Leesa B,0,3,30,30
1649989442287,MATH 109,A02,083214,Anzaldo; Leesa B,1,2,30,29
1649989442287,MATH 109,B01,083215,Anzaldo; Leesa B,1,2,30,29
1649989442287,MATH 109,B02,083216,Anzaldo; Leesa B,0,1,30,30
1649989448324,MATH 142A,A01,083219,Chow; Bennett,0,7,30,30
1649989448324,MATH 142A,A02,083220,Chow; Bennett,0,5,30,30
1649989448324,MATH 142A,B01,083221,Chow; Bennett,0,7,30,30
1649989448324,MATH 142A,B02,083222,Chow; Bennett,0,6,30,30
1649989454352,MATH 193A,A01,083224,Staff,0,6,30,30
1649989454352,MATH 193A,A02,083225,Staff,0,4,30,30
1649989454352,MATH 193A,A03,083781,Staff,1,0,30,29
1649989454352,MATH 193A,A04,083782,Staff,12,0,30,18
1649989460382,MATH 197,001,091859,McAuley; Julian John,9999,0,9999,0
1649989466484,COGS 9,A01,083615,Staff,2,11,60,58
1649989472522,COGS 11,A01,083617,Boyle; Mary E. T.,28,0,40,12
1649989478573,COGS 13,A01,083071,Staff,1,27,40,39
1649989484598,COGS 14A,A01,092681,Staff,6,0,100,94
1649989490632,COGS 14B,A01,083073,Cheng; Tzu-Han,1,0,50,49
1649989496664,COGS 17,A01,092677,Staff,45,0,75,30
1649989502714,COGS 100,A01,083619,Staff,1,16,60,59
1649989508743,COGS 101A,A01,083621,Davis; Joshua Daniel,0,17,60,60
1649989514793,COGS 101B,A01,091572,Staff,19,0,60,41
1649989520820,COGS 101C,A01,083625,Delgado; Tania,21,0,30,9
1649989526860,COGS 107A,A01,083627,Boyle; Mary E. T.,0,1,60,60
1649989532883,COGS 118A,A01,083075,Staff,20,0,60,40
1649989538912,CSE 3,A50,083646,Miranda; Gregory Joseph,22,0,38,16
1649989538912,CSE 3,A51,083647,Miranda; Gregory Joseph,37,0,37,0
1649989544959,CSE 8A,A50,083650,Miranda; Gregory Joseph,2,12,40,38
1649989550988,CSE 11,A01,083080,Cao; Yingjun,0,54,40,40
1649989557013,CSE 12,A01,083652,Staff,10,0,100,90
1649989563069,CSE 15L,A01,083654,Staff,0,0,50,50
1649989563069,CSE 15L,A02,083655,Staff,21,0,50,29
1649989569101,CSE 20,A01,083657,Staff,59,0,80,21
1649989575150,CSE 30,A01,083084,Eldon; John,0,54,40,40
1649989581191,CSE 100,A01,083659,Cao; Yingjun,1,55,50,49
1649989587226,CSE 134B,A01,083661,Powell; Thomas Allan,1,26,65,64
1649989593281,CSE 140,A01,083663,Staff,10,0,75,65
1649989599314,CSE 140L,A01,083088,Eldon; John,6,0,75,69
1649989605340,CSE 175,A01,083665,Kumar; Rakesh,10,0,25,15
1649989611367,CSE 190,A00,092507,Dubnov; Shlomo,17,0,20,3
1649989617418,ECE 45,A01,083139,Staff,0,6,40,40
1649989623442,ECE 65,A50,083695,Staff,2,0,30,28
1649989629474,ECE 109,A01,091882,Touri; Behrouz,49,0,70,21
1649989635504,ECE 180,A00,083140,Abi Samra; Nicholas Camill,26,0,30,4
1649989635504,ECE 180,B00,083141,Abi Samra; Nicholas Camill,10,0,30,20
1649989641556,MATH 10A,A01,083735,Patchell; Gregory David,15,0,30,15
1649989641556,MATH 10A,A02,083736,Patchell; Gregory David,28,0,30,2
1649989641556,MATH 10A,A03,083737,Patchell; Gregory David,27,0,30,3
1649989647589,MATH 10B,A01,083207,Staff,0,2,30,30
1649989647589,MATH 10B,A02,083208,Staff,7,0,30,23
1649989647589,MATH 10B,B01,083739,Staff,21,0,30,9
1649989647589,MATH 10B,B02,083740,Staff,30,0,30,0
1649989653638,MATH 18,A01,083743,Staff,14,0,30,16
1649989653638,MATH 18,A02,083744,Staff,29,0,30,1
1649989653638,MATH 18,A03,083745,Staff,24,0,30,6
1649989653638,MATH 18,A04,083746,Staff,27,0,30,3
1649989653638,MATH 18,B01,083748,Staff,0,3,30,30
1649989653638,MATH 18,B02,083749,Staff,0,1,30,30
1649989653638,MATH 18,B03,083750,Staff,0,0,30,30
1649989653638,MATH 18,B04,083751,Staff,0,1,30,30
1649989659693,MATH 20A,A01,083754,Staff,30,0,40,10
1649989665750,MATH 20B,A01,083756,Staff,0,1,30,30
1649989665750,MATH 20B,A02,083757,Staff,19,0,30,11
1649989671794,MATH 20C,A01,083760,Staff,1,5,30,29
1649989671794,MATH 20C,A02,083761,Staff,0,5,30,30
1649989671794,MATH 20C,B01,083762,Staff,21,0,30,9
1649989671794,MATH 20C,B02,083763,Staff,30,0,30,0
1649989677841,MATH 20D,A01,083765,Staff,0,0,30,30
1649989677841,MATH 20D,A02,083766,Staff,20,0,30,10
1649989677841,MATH 20D,A03,083767,Staff,28,0,30,2
1649989683888,MATH 20E,A01,083771,Staff,11,0,30,19
1649989683888,MATH 20E,A02,083772,Staff,21,0,30,9
1649989683888,MATH 20E,B01,083773,Staff,0,0,30,30
1649989683888,MATH 20E,B02,083774,Staff,24,0,30,6
1649989689931,MATH 103A,A01,083777,Staff,1,5,30,29
1649989689931,MATH 103A,A02,083778,Staff,0,5,30,30
1649989689931,MATH 103A,B01,083779,Staff,0,6,30,30
1649989689931,MATH 103A,B02,083780,Staff,0,5,30,30
1649989695986,MATH 105,A01,085443,Staff,0,10,30,30
1649989702028,MATH 109,A01,083213,Anzaldo; Leesa B,0,3,30,30
1649989702028,MATH 109,A02,083214,Anzaldo; Leesa B,1,2,30,29
1649989702028,MATH 109,B01,083215,Anzaldo; Leesa B,1,2,30,29
1649989702028,MATH 109,B02,083216,Anzaldo; Leesa B,0,1,30,30
1649989708067,MATH 142A,A01,083219,Chow; Bennett,0,7,30,30
1649989708067,MATH 142A,A02,083220,Chow; Bennett,0,5,30,30
1649989708067,MATH 142A,B01,083221,Chow; Bennett,0,7,30,30
1649989708067,MATH 142A,B02,083222,Chow; Bennett,0,6,30,30
1649989714110,MATH 193A,A01,083224,Staff,0,6,30,30
1649989714110,MATH 193A,A02,083225,Staff,0,4,30,30
1649989714110,MATH 193A,A03,083781,Staff,1,0,30,29
1649989714110,MATH 193A,A04,083782,Staff,12,0,30,18
1649989720149,MATH 197,001,091859,McAuley; Julian John,9999,0,9999,0
1649989726231,COGS 9,A01,083615,Staff,2,11,60,58
1649989732277,COGS 11,A01,083617,Boyle; Mary E. T.,28,0,40,12
1649989738317,COGS 13,A01,083071,Staff,1,27,40,39
1649989744359,COGS 14A,A01,092681,Staff,6,0,100,94
1649989750385,COGS 14B,A01,083073,Cheng; Tzu-Han,1,0,50,49
1649989756420,COGS 17,A01,092677,Staff,46,0,75,29
1649989762457,COGS 100,A01,083619,Staff,1,16,60,59
1649989768505,COGS 101A,A01,083621,Davis; Joshua Daniel,0,17,60,60
1649989774551,COGS 101B,A01,091572,Staff,19,0,60,41
1649989780606,COGS 101C,A01,083625,Delgado; Tania,21,0,30,9
1649989786630,COGS 107A,A01,083627,Boyle; Mary E. T.,0,1,60,60
1649989792654,COGS 118A,A01,083075,Staff,20,0,60,40
1649989798689,CSE 3,A50,083646,Miranda; Gregory Joseph,22,0,38,16
1649989798689,CSE 3,A51,083647,Miranda; Gregory Joseph,37,0,37,0
1649989804716,CSE 8A,A50,083650,Miranda; Gregory Joseph,2,13,40,38
1649989810742,CSE 11,A01,083080,Cao; Yingjun,0,54,40,40
1649989816775,CSE 12,A01,083652,Staff,10,0,100,90
1649989822816,CSE 15L,A01,083654,Staff,0,0,50,50
1649989822816,CSE 15L,A02,083655,Staff,21,0,50,29
1649989828854,CSE 20,A01,083657,Staff,59,0,80,21
1649989834878,CSE 30,A01,083084,Eldon; John,0,54,40,40
1649989840908,CSE 100,A01,083659,Cao; Yingjun,1,55,50,49
1649989846933,CSE 134B,A01,083661,Powell; Thomas Allan,1,26,65,64
1649989852973,CSE 140,A01,083663,Staff,10,0,75,65
1649989859008,CSE 140L,A01,083088,Eldon; John,6,0,75,69
1649989865032,CSE 175,A01,083665,Kumar; Rakesh,10,0,25,15
1649989871058,CSE 190,A00,092507,Dubnov; Shlomo,17,0,20,3
1649989877107,ECE 45,A01,083139,Staff,0,6,40,40
1649989883142,ECE 65,A50,083695,Staff,1,0,30,29
1649989889196,ECE 109,A01,091882,Touri; Behrouz,49,0,70,21
1649989895222,ECE 180,A00,083140,Abi Samra; Nicholas Camill,26,0,30,4
1649989895222,ECE 180,B00,083141,Abi Samra; Nicholas Camill,10,0,30,20
1649989901266,MATH 10A,A01,083735,Patchell; Gregory David,15,0,30,15
1649989901266,MATH 10A,A02,083736,Patchell; Gregory David,28,0,30,2
1649989901266,MATH 10A,A03,083737,Patchell; Gregory David,27,0,30,3
1649989907315,MATH 10B,A01,083207,Staff,0,2,30,30
1649989907315,MATH 10B,A02,083208,Staff,7,0,30,23
1649989907315,MATH 10B,B01,083739,Staff,21,0,30,9
1649989907315,MATH 10B,B02,083740,Staff,30,0,30,0
1649989913350,MATH 18,A01,083743,Staff,14,0,30,16
1649989913350,MATH 18,A02,083744,Staff,29,0,30,1
1649989913350,MATH 18,A03,083745,Staff,24,0,30,6
1649989913350,MATH 18,A04,083746,Staff,27,0,30,3
1649989913350,MATH 18,B01,083748,Staff,0,3,30,30
1649989913350,MATH 18,B02,083749,Staff,0,1,30,30
1649989913350,MATH 18,B03,083750,Staff,0,0,30,30
1649989913350,MATH 18,B04,083751,Staff,0,1,30,30
1649989919377,MATH 20A,A01,083754,Staff,30,0,40,10
1649989925419,MATH 20B,A01,083756,Staff,0,0,30,30
1649989925419,MATH 20B,A02,083757,Staff,19,0,30,11
1649989931446,MATH 20C,A01,083760,Staff,1,5,30,29
1649989931446,MATH 20C,A02,083761,Staff,0,5,30,30
1649989931446,MATH 20C,B01,083762,Staff,21,0,30,9
1649989931446,MATH 20C,B02,083763,Staff,30,0,30,0
1649989937573,MATH 20D,A01,083765,Staff,0,0,30,30
1649989937573,MATH 20D,A02,083766,Staff,19,0,30,11
1649989937573,MATH 20D,A03,083767,Staff,28,0,30,2
1649989943622,MATH 20E,A01,083771,Staff,11,0,30,19
1649989943622,MATH 20E,A02,083772,Staff,21,0,30,9
1649989943622,MATH 20E,B01,083773,Staff,0,0,30,30
1649989943622,MATH 20E,B02,083774,Staff,24,0,30,6
1649989949645,MATH 103A,A01,083777,Staff,1,5,30,29
1649989949645,MATH 103A,A02,083778,Staff,0,5,30,30
1649989949645,MATH 103A,B01,083779,Staff,0,6,30,30
1649989949645,MATH 103A,B02,083780,Staff,0,5,30,30
1649989955673,MATH 105,A01,085443,Staff,0,10,30,30
1649989961722,MATH 109,A01,083213,Anzaldo; Leesa B,0,3,30,30
1649989961722,MATH 109,A02,083214,Anzaldo; Leesa B,1,2,30,29
1649989961722,MATH 109,B01,083215,Anzaldo; Leesa B,1,2,30,29
1649989961722,MATH 109,B02,083216,Anzaldo; Leesa B,0,1,30,30
1649989967764,MATH 142A,A01,083219,Chow; Bennett,0,7,30,30
1649989967764,MATH 142A,A02,083220,Chow; Bennett,0,5,30,30
1649989967764,MATH 142A,B01,083221,Chow; Bennett,0,7,30,30
1649989967764,MATH 142A,B02,083222,Chow; Bennett,0,6,30,30
1649989973804,MATH 193A,A01,083224,Staff,0,6,30,30
1649989973804,MATH 193A,A02,083225,Staff,0,4,30,30
1649989973804,MATH 193A,A03,083781,Staff,1,0,30,29
1649989973804,MATH 193A,A04,083782,Staff,12,0,30,18
1649989979835,MATH 197,001,091859,McAuley; Julian John,9999,0,9999,0
1649989985926,COGS 9,A01,083615,Staff,2,11,60,58
1649989991948,COGS 11,A01,083617,Boyle; Mary E. T.,28,0,40,12
1649989997986,COGS 13,A01,083071,Staff,1,27,40,39
1649990004016,COGS 14A,A01,092681,Staff,5,0,100,95
1649990010043,COGS 14B,A01,083073,Cheng; Tzu-Han,1,0,50,49
1649990016079,COGS 17,A01,092677,Staff,46,0,75,29
1649990022116,COGS 100,A01,083619,Staff,1,16,60,59
1649990028154,COGS 101A,A01,083621,Davis; Joshua Daniel,0,17,60,60
1649990034181,COGS 101B,A01,091572,Staff,19,0,60,41
1649990040211,COGS 101C,A01,083625,Delgado; Tania,21,0,30,9
1649990046234,COGS 107A,A01,083627,Boyle; Mary E. T.,0,1,60,60
1649990052263,COGS 118A,A01,083075,Staff,20,0,60,40
1649990058296,CSE 3,A50,083646,Miranda; Gregory Joseph,22,0,38,16
1649990058296,CSE 3,A51,083647,Miranda; Gregory Joseph,37,0,37,0
1649990064323,CSE 8A,A50,083650,Miranda; Gregory Joseph,2,13,40,38
1649990070347,CSE 11,A01,083080,Cao; Yingjun,0,54,40,40
1649990076382,CSE 12,A01,083652,Staff,9,0,100,91
1649990082430,CSE 15L,A01,083654,Staff,0,0,50,50
1649990082430,CSE 15L,A02,083655,Staff,20,0,50,30
1649990088454,CSE 20,A01,083657,Staff,59,0,80,21
1649990094508,CSE 30,A01,083084,Eldon; John,0,54,40,40
1649990100550,CSE 100,A01,083659,Cao; Yingjun,1,55,50,49
1649990106591,CSE 134B,A01,083661,Powell; Thomas Allan,1,26,65,64
1649990112626,CSE 140,A01,083663,Staff,10,0,75,65
1649990118663,CSE 140L,A01,083088,Eldon; John,6,0,75,69
1649990124713,CSE 175,A01,083665,Kumar; Rakesh,10,0,25,15
1649990130757,CSE 190,A00,092507,Dubnov; Shlomo,17,0,20,3
1649990136799,ECE 45,A01,083139,Staff,0,6,40,40
1649990142850,ECE 65,A50,083695,Staff,1,0,30,29
1649990148872,ECE 109,A01,091882,Touri; Behrouz,49,0,70,21
1649990154914,ECE 180,A00,083140,Abi Samra; Nicholas Camill,26,0,30,4
1649990154914,ECE 180,B00,083141,Abi Samra; Nicholas Camill,10,0,30,20
1649990160944,MATH 10A,A01,083735,Patchell; Gregory David,15,0,30,15
1649990160944,MATH 10A,A02,083736,Patchell; Gregory David,28,0,30,2
1649990160944,MATH 10A,A03,083737,Patchell; Gregory David,27,0,30,3
1649990166967,MATH 10B,A01,083207,Staff,0,3,30,30
1649990166967,MATH 10B,A02,083208,Staff,7,0,30,23
1649990166967,MATH 10B,B01,083739,Staff,21,0,30,9
1649990166967,MATH 10B,B02,083740,Staff,30,0,30,0
1649990172999,MATH 18,A01,083743,Staff,14,0,30,16
1649990172999,MATH 18,A02,083744,Staff,29,0,30,1
1649990172999,MATH 18,A03,083745,Staff,24,0,30,6
1649990172999,MATH 18,A04,083746,Staff,27,0,30,3
1649990172999,MATH 18,B01,083748,Staff,0,3,30,30
1649990172999,MATH 18,B02,083749,Staff,0,1,30,30
1649990172999,MATH 18,B03,083750,Staff,0,0,30,30
1649990172999,MATH 18,B04,083751,Staff,0,1,30,30
1649990179029,MATH 20A,A01,083754,Staff,30,0,40,10
1649990185079,MATH 20B,A01,083756,Staff,0,0,30,30
1649990185079,MATH 20B,A02,083757,Staff,17,0,30,13
1649990191107,MATH 20C,A01,083760,Staff,1,5,30,29
1649990191107,MATH 20C,A02,083761,Staff,0,6,30,30
1649990191107,MATH 20C,B01,083762,Staff,21,0,30,9
1649990191107,MATH 20C,B02,083763,Staff,30,0,30,0
1649990197153,MATH 20D,A01,083765,Staff,0,0,30,30
1649990197153,MATH 20D,A02,083766,Staff,19,0,30,11
1649990197153,MATH 20D,A03,083767,Staff,28,0,30,2
1649990203187,MATH 20E,A01,083771,Staff,11,0,30,19
1649990203187,MATH 20E,A02,083772,Staff,21,0,30,9
1649990203187,MATH 20E,B01,083773,Staff,0,0,30,30
1649990203187,MATH 20E,B02,083774,Staff,24,0,30,6
1649990209224,MATH 103A,A01,083777,Staff,1,5,30,29
1649990209224,MATH 103A,A02,083778,Staff,0,5,30,30
1649990209224,MATH 103A,B01,083779,Staff,0,6,30,30
1649990209224,MATH 103A,B02,083780,Staff,0,5,30,30
1649990215259,MATH 105,A01,085443,Staff,0,10,30,30
1649990221281,MATH 109,A01,083213,Anzaldo; Leesa B,0,3,30,30
1649990221281,MATH 109,A02,083214,Anzaldo; Leesa B,1,2,30,29
1649990221281,MATH 109,B01,083215,Anzaldo; Leesa B,1,2,30,29
1649990221281,MATH 109,B02,083216,Anzaldo; Leesa B,0,1,30,30
1649990227316,MATH 142A,A01,083219,Chow; Bennett,0,7,30,30
1649990227316,MATH 142A,A02,083220,Chow; Bennett,0,6,30,30
1649990227316,MATH 142A,B01,083221,Chow; Bennett,0,7,30,30
1649990227316,MATH 142A,B02,083222,Chow; Bennett,0,6,30,30
1649990233345,MATH 193A,A01,083224,Staff,0,6,30,30
1649990233345,MATH 193A,A02,083225,Staff,0,4,30,30
1649990233345,MATH 193A,A03,083781,Staff,1,0,30,29
1649990233345,MATH 193A,A04,083782,Staff,12,0,30,18
1649990239382,MATH 197,001,091859,McAuley; Julian John,9999,0,9999,0
1649990245473,COGS 9,A01,083615,Staff,2,11,60,58
1649990251496,COGS 11,A01,083617,Boyle; Mary E. T.,28,0,40,12
1649990257518,COGS 13,A01,083071,Staff,1,27,40,39
1649990263541,COGS 14A,A01,092681,Staff,5,0,100,95
1649990269593,COGS 14B,A01,083073,Cheng; Tzu-Han,0,0,50,50
1649990275633,COGS 17,A01,092677,Staff,46,0,75,29
1649990281662,COGS 100,A01,083619,Staff,1,16,60,59
1649990287705,COGS 101A,A01,083621,Davis; Joshua Daniel,0,17,60,60
1649990293753,COGS 101B,A01,091572,Staff,19,0,60,41
1649990299777,COGS 101C,A01,083625,Delgado; Tania,21,0,30,9
1649990305825,COGS 107A,A01,083627,Boyle; Mary E. T.,0,1,60,60
1649990311869,COGS 118A,A01,083075,Staff,20,0,60,40
1649990317911,CSE 3,A50,083646,Miranda; Gregory Joseph,22,0,38,16
1649990317911,CSE 3,A51,083647,Miranda; Gregory Joseph,37,0,37,0
1649990323956,CSE 8A,A50,083650,Miranda; Gregory Joseph,2,13,40,38
1649990329983,CSE 11,A01,083080,Cao; Yingjun,0,54,40,40
1649990336014,CSE 12,A01,083652,Staff,9,0,100,91
1649990342038,CSE 15L,A01,083654,Staff,0,0,50,50
1649990342038,CSE 15L,A02,083655,Staff,20,0,50,30
1649990348065,CSE 20,A01,083657,Staff,59,0,80,21
1649990354093,CSE 30,A01,083084,Eldon; John,0,55,40,40
1649990360126,CSE 100,A01,083659,Cao; Yingjun,1,55,50,49
1649990366159,CSE 134B,A01,083661,Powell; Thomas Allan,1,26,65,64
1649990372203,CSE 140,A01,083663,Staff,10,0,75,65
1649990378245,CSE 140L,A01,083088,Eldon; John,6,0,75,69
1649990384268,CSE 175,A01,083665,Kumar; Rakesh,10,0,25,15
1649990390293,CSE 190,A00,092507,Dubnov; Shlomo,17,0,20,3
1649990396317,ECE 45,A01,083139,Staff,0,6,40,40
1649990402358,ECE 65,A50,083695,Staff,1,0,30,29
1649990408399,ECE 109,A01,091882,Touri; Behrouz,49,0,70,21
1649990414431,ECE 180,A00,083140,Abi Samra; Nicholas Camill,26,0,30,4
1649990414431,ECE 180,B00,083141,Abi Samra; Nicholas Camill,10,0,30,20
1649990420464,MATH 10A,A01,083735,Patchell; Gregory David,15,0,30,15
1649990420464,MATH 10A,A02,083736,Patchell; Gregory David,28,0,30,2
1649990420464,MATH 10A,A03,083737,Patchell; Gregory David,27,0,30,3
1649990426527,MATH 10B,A01,083207,Staff,0,2,30,30
1649990426527,MATH 10B,A02,083208,Staff,6,0,30,24
1649990426527,MATH 10B,B01,083739,Staff,21,0,30,9
1649990426527,MATH 10B,B02,083740,Staff,30,0,30,0
1649990432565,MATH 18,A01,083743,Staff,14,0,30,16
1649990432565,MATH 18,A02,083744,Staff,29,0,30,1
1649990432565,MATH 18,A03,083745,Staff,24,0,30,6
1649990432565,MATH 18,A04,083746,Staff,27,0,30,3
1649990432565,MATH 18,B01,083748,Staff,0,3,30,30
1649990432565,MATH 18,B02,083749,Staff,0,1,30,30
1649990432565,MATH 18,B03,083750,Staff,0,0,30,30
1649990432565,MATH 18,B04,083751,Staff,0,1,30,30
1649990438594,MATH 20A,A01,083754,Staff,30,0,40,10
1649990444637,MATH 20B,A01,083756,Staff,0,0,30,30
1649990444637,MATH 20B,A02,083757,Staff,17,0,30,13
1649990450661,MATH 20C,A01,083760,Staff,1,5,30,29
1649990450661,MATH 20C,A02,083761,Staff,0,6,30,30
1649990450661,MATH 20C,B01,083762,Staff,21,0,30,9
1649990450661,MATH 20C,B02,083763,Staff,30,0,30,0
1649990456701,MATH 20D,A01,083765,Staff,0,0,30,30
1649990456701,MATH 20D,A02,083766,Staff,19,0,30,11
1649990456701,MATH 20D,A03,083767,Staff,28,0,30,2
1649990462752,MATH 20E,A01,083771,Staff,11,0,30,19
1649990462752,MATH 20E,A02,083772,Staff,21,0,30,9
1649990462752,MATH 20E,B01,083773,Staff,0,0,30,30
1649990462752,MATH 20E,B02,083774,Staff,24,0,30,6
1649990468775,MATH 103A,A01,083777,Staff,1,5,30,29
1649990468775,MATH 103A,A02,083778,Staff,0,5,30,30
1649990468775,MATH 103A,B01,083779,Staff,0,6,30,30
1649990468775,MATH 103A,B02,083780,Staff,0,5,30,30
1649990474816,MATH 105,A01,085443,Staff,0,10,30,30
1649990480850,MATH 109,A01,083213,Anzaldo; Leesa B,0,3,30,30
1649990480850,MATH 109,A02,083214,Anzaldo; Leesa B,1,2,30,29
1649990480850,MATH 109,B01,083215,Anzaldo; Leesa B,1,2,30,29
1649990480850,MATH 109,B02,083216,Anzaldo; Leesa B,0,1,30,30
1649990486905,MATH 142A,A01,083219,Chow; Bennett,0,7,30,30
1649990486905,MATH 142A,A02,083220,Chow; Bennett,0,6,30,30
1649990486905,MATH 142A,B01,083221,Chow; Bennett,0,7,30,30
1649990486905,MATH 142A,B02,083222,Chow; Bennett,0,6,30,30
1649990492945,MATH 193A,A01,083224,Staff,0,6,30,30
1649990492945,MATH 193A,A02,083225,Staff,0,4,30,30
1649990492945,MATH 193A,A03,083781,Staff,1,0,30,29
1649990492945,MATH 193A,A04,083782,Staff,12,0,30,18
1649990498975,MATH 197,001,091859,McAuley; Julian John,9999,0,9999,0
1649990505025,COGS 9,A01,083615,Staff,2,11,60,58
1649990511051,COGS 11,A01,083617,Boyle; Mary E. T.,28,0,40,12
1649990517076,COGS 13,A01,083071,Staff,1,27,40,39
1649990523109,COGS 14A,A01,092681,Staff,3,0,100,97
1649990529238,COGS 14B,A01,083073,Cheng; Tzu-Han,0,0,50,50
1649990535277,COGS 17,A01,092677,Staff,46,0,75,29
1649990541313,COGS 100,A01,083619,Staff,1,16,60,59
1649990547351,COGS 101A,A01,083621,Davis; Joshua Daniel,0,17,60,60
1649990553394,COGS 101B,A01,091572,Staff,19,0,60,41
1649990559440,COGS 101C,A01,083625,Delgado; Tania,21,0,30,9
1649990565463,COGS 107A,A01,083627,Boyle; Mary E. T.,0,1,60,60
1649990571495,COGS 118A,A01,083075,Staff,20,0,60,40
1649990577530,CSE 3,A50,083646,Miranda; Gregory Joseph,22,0,38,16
1649990577530,CSE 3,A51,083647,Miranda; Gregory Joseph,37,0,37,0
1649990583574,CSE 8A,A50,083650,Miranda; Gregory Joseph,2,13,40,38
1649990589617,CSE 11,A01,083080,Cao; Yingjun,0,54,40,40
1649990595661,CSE 12,A01,083652,Staff,9,0,100,91
1649990601696,CSE 15L,A01,083654,Staff,0,0,50,50
1649990601696,CSE 15L,A02,083655,Staff,20,0,50,30
1649990607729,CSE 20,A01,083657,Staff,59,0,80,21
1649990613784,CSE 30,A01,083084,Eldon; John,0,56,40,40
1649990619808,CSE 100,A01,083659,Cao; Yingjun,1,55,50,49
1649990625856,CSE 134B,A01,083661,Powell; Thomas Allan,1,26,65,64
1649990631888,CSE 140,A01,083663,Staff,10,0,75,65
1649990637936,CSE 140L,A01,083088,Eldon; John,6,0,75,69
1649990644001,CSE 175,A01,083665,Kumar; Rakesh,10,0,25,15
1649990650055,CSE 190,A00,092507,Dubnov; Shlomo,17,0,20,3
1649990656099,ECE 45,A01,083139,Staff,0,6,40,40
1649990662125,ECE 65,A50,083695,Staff,1,0,30,29
1649990668174,ECE 109,A01,091882,Touri; Behrouz,49,0,70,21
1649990674198,ECE 180,A00,083140,Abi Samra; Nicholas Camill,26,0,30,4
1649990674198,ECE 180,B00,083141,Abi Samra; Nicholas Camill,10,0,30,20
1649990680233,MATH 10A,A01,083735,Patchell; Gregory David,15,0,30,15
1649990680233,MATH 10A,A02,083736,Patchell; Gregory David,28,0,30,2
1649990680233,MATH 10A,A03,083737,Patchell; Gregory David,27,0,30,3
1649990686281,MATH 10B,A01,083207,Staff,0,2,30,30
1649990686281,MATH 10B,A02,083208,Staff,5,0,30,25
1649990686281,MATH 10B,B01,083739,Staff,20,0,30,10
1649990686281,MATH 10B,B02,083740,Staff,30,0,30,0
1649990692336,MATH 18,A01,083743,Staff,14,0,30,16
1649990692336,MATH 18,A02,083744,Staff,29,0,30,1
1649990692336,MATH 18,A03,083745,Staff,24,0,30,6
1649990692336,MATH 18,A04,083746,Staff,27,0,30,3
1649990692336,MATH 18,B01,083748,Staff,0,3,30,30
1649990692336,MATH 18,B02,083749,Staff,0,1,30,30
1649990692336,MATH 18,B03,083750,Staff,0,2,30,30
1649990692336,MATH 18,B04,083751,Staff,0,2,30,30
1649990698381,MATH 20A,A01,083754,Staff,30,0,40,10
1649990704431,MATH 20B,A01,083756,Staff,0,0,30,30
1649990704431,MATH 20B,A02,083757,Staff,17,0,30,13
1649990710470,MATH 20C,A01,083760,Staff,1,6,30,29
1649990710470,MATH 20C,A02,083761,Staff,0,7,30,30
1649990710470,MATH 20C,B01,083762,Staff,21,0,30,9
1649990710470,MATH 20C,B02,083763,Staff,30,0,30,0
1649990716522,MATH 20D,A01,083765,Staff,0,0,30,30
1649990716522,MATH 20D,A02,083766,Staff,19,0,30,11
1649990716522,MATH 20D,A03,083767,Staff,28,0,30,2
1649990722568,MATH 20E,A01,083771,Staff,11,0,30,19
1649990722568,MATH 20E,A02,083772,Staff,21,0,30,9
1649990722568,MATH 20E,B01,083773,Staff,0,0,30,30
1649990722568,MATH 20E,B02,083774,Staff,24,0,30,6
1649990728605,MATH 103A,A01,083777,Staff,1,5,30,29
1649990728605,MATH 103A,A02,083778,Staff,0,5,30,30
1649990728605,MATH 103A,B01,083779,Staff,0,6,30,30
1649990728605,MATH 103A,B02,083780,Staff,0,5,30,30
1649990734630,MATH 105,A01,085443,Staff,0,10,30,30
1649990740670,MATH 109,A01,083213,Anzaldo; Leesa B,0,3,30,30
1649990740670,MATH 109,A02,083214,Anzaldo; Leesa B,1,2,30,29
1649990740670,MATH 109,B01,083215,Anzaldo; Leesa B,1,2,30,29
1649990740670,MATH 109,B02,083216,Anzaldo; Leesa B,0,2,30,30
1649990746724,MATH 142A,A01,083219,Chow; Bennett,0,7,30,30
1649990746724,MATH 142A,A02,083220,Chow; Bennett,0,6,30,30
1649990746724,MATH 142A,B01,083221,Chow; Bennett,0,7,30,30
1649990746724,MATH 142A,B02,083222,Chow; Bennett,0,6,30,30
1649990752773,MATH 193A,A01,083224,Staff,0,6,30,30
1649990752773,MATH 193A,A02,083225,Staff,0,4,30,30
1649990752773,MATH 193A,A03,083781,Staff,1,0,30,29
1649990752773,MATH 193A,A04,083782,Staff,11,0,30,19
1649990758813,MATH 197,001,091859,McAuley; Julian John,9999,0,9999,0
1649990764903,COGS 9,A01,083615,Staff,2,11,60,58
1649990770940,COGS 11,A01,083617,Boyle; Mary E. T.,28,0,40,12
1649990776963,COGS 13,A01,083071,Staff,1,27,40,39
1649990782998,COGS 14A,A01,092681,Staff,2,0,100,98
1649990789022,COGS 14B,A01,083073,Cheng; Tzu-Han,0,0,50,50
1649990795055,COGS 17,A01,092677,Staff,45,0,75,30
1649990801077,COGS 100,A01,083619,Staff,1,16,60,59
1649990807103,COGS 101A,A01,083621,Davis; Joshua Daniel,0,17,60,60
1649990813158,COGS 101B,A01,091572,Staff,19,0,60,41
1649990819186,COGS 101C,A01,083625,Delgado; Tania,21,0,30,9
1649990825219,COGS 107A,A01,083627,Boyle; Mary E. T.,0,1,60,60
1649990831242,COGS 118A,A01,083075,Staff,20,0,60,40
1649990837295,CSE 3,A50,083646,Miranda; Gregory Joseph,22,0,38,16
1649990837295,CSE 3,A51,083647,Miranda; Gregory Joseph,37,0,37,0
1649990843329,CSE 8A,A50,083650,Miranda; Gregory Joseph,2,13,40,38
1649990849352,CSE 11,A01,083080,Cao; Yingjun,0,54,40,40
1649990855397,CSE 12,A01,083652,Staff,9,0,100,91
1649990861423,CSE 15L,A01,083654,Staff,0,0,50,50
1649990861423,CSE 15L,A02,083655,Staff,20,0,50,30
1649990867450,CSE 20,A01,083657,Staff,59,0,80,21
1649990873477,CSE 30,A01,083084,Eldon; John,0,56,40,40
1649990879507,CSE 100,A01,083659,Cao; Yingjun,1,55,50,49
1649990885551,CSE 134B,A01,083661,Powell; Thomas Allan,1,26,65,64
1649990891578,CSE 140,A01,083663,Staff,10,0,75,65
1649990897612,CSE 140L,A01,083088,Eldon; John,6,0,75,69
1649990903658,CSE 175,A01,083665,Kumar; Rakesh,10,0,25,15
1649990909701,CSE 190,A00,092507,Dubnov; Shlomo,17,0,20,3
1649990915733,ECE 45,A01,083139,Staff,0,6,40,40
1649990921760,ECE 65,A50,083695,Staff,1,0,30,29
1649990927791,ECE 109,A01,091882,Touri; Behrouz,49,0,70,21
1649990933847,ECE 180,A00,083140,Abi Samra; Nicholas Camill,26,0,30,4
1649990933847,ECE 180,B00,083141,Abi Samra; Nicholas Camill,10,0,30,20
1649990939897,MATH 10A,A01,083735,Patchell; Gregory David,15,0,30,15
1649990939897,MATH 10A,A02,083736,Patchell; Gregory David,28,0,30,2
1649990939897,MATH 10A,A03,083737,Patchell; Gregory David,27,0,30,3
1649990945934,MATH 10B,A01,083207,Staff,0,2,30,30
1649990945934,MATH 10B,A02,083208,Staff,5,0,30,25
1649990945934,MATH 10B,B01,083739,Staff,20,0,30,10
1649990945934,MATH 10B,B02,083740,Staff,30,0,30,0
1649990951961,MATH 18,A01,083743,Staff,14,0,30,16
1649990951961,MATH 18,A02,083744,Staff,29,0,30,1
1649990951961,MATH 18,A03,083745,Staff,24,0,30,6
1649990951961,MATH 18,A04,083746,Staff,27,0,30,3
1649990951961,MATH 18,B01,083748,Staff,0,3,30,30
1649990951961,MATH 18,B02,083749,Staff,0,1,30,30
1649990951961,MATH 18,B03,083750,Staff,0,2,30,30
1649990951961,MATH 18,B04,083751,Staff,0,2,30,30
1649990957983,MATH 20A,A01,083754,Staff,30,0,40,10
1649990964007,MATH 20B,A01,083756,Staff,0,0,30,30
1649990964007,MATH 20B,A02,083757,Staff,16,0,30,14
1649990970053,MATH 20C,A01,083760,Staff,1,6,30,29
1649990970053,MATH 20C,A02,083761,Staff,0,7,30,30
1649990970053,MATH 20C,B01,083762,Staff,21,0,30,9
1649990970053,MATH 20C,B02,083763,Staff,30,0,30,0
1649990976077,MATH 20D,A01,083765,Staff,0,0,30,30
1649990976077,MATH 20D,A02,083766,Staff,19,0,30,11
1649990976077,MATH 20D,A03,083767,Staff,28,0,30,2
1649990982123,MATH 20E,A01,083771,Staff,11,0,30,19
1649990982123,MATH 20E,A02,083772,Staff,21,0,30,9
1649990982123,MATH 20E,B01,083773,Staff,0,0,30,30
1649990982123,MATH 20E,B02,083774,Staff,24,0,30,6
1649990988152,MATH 103A,A01,083777,Staff,1,5,30,29
1649990988152,MATH 103A,A02,083778,Staff,0,5,30,30
1649990988152,MATH 103A,B01,083779,Staff,0,6,30,30
1649990988152,MATH 103A,B02,083780,Staff,0,5,30,30
1649990994195,MATH 105,A01,085443,Staff,0,10,30,30
1649991000219,MATH 109,A01,083213,Anzaldo; Leesa B,0,3,30,30
1649991000219,MATH 109,A02,083214,Anzaldo; Leesa B,1,2,30,29
1649991000219,MATH 109,B01,083215,Anzaldo; Leesa B,1,2,30,29
1649991000219,MATH 109,B02,083216,Anzaldo; Leesa B,0,2,30,30
1649991006247,MATH 142A,A01,083219,Chow; Bennett,0,7,30,30
1649991006247,MATH 142A,A02,083220,Chow; Bennett,0,6,30,30
1649991006247,MATH 142A,B01,083221,Chow; Bennett,0,7,30,30
1649991006247,MATH 142A,B02,083222,Chow; Bennett,0,6,30,30
1649991012277,MATH 193A,A01,083224,Staff,0,6,30,30
1649991012277,MATH 193A,A02,083225,Staff,0,4,30,30
1649991012277,MATH 193A,A03,083781,Staff,1,0,30,29
1649991012277,MATH 193A,A04,083782,Staff,11,0,30,19
1649991018331,MATH 197,001,091859,McAuley; Julian John,9999,0,9999,0
1649991024410,COGS 9,A01,083615,Staff,2,11,60,58
1649991030445,COGS 11,A01,083617,Boyle; Mary E. T.,28,0,40,12
1649991036482,COGS 13,A01,083071,Staff,1,27,40,39
1649991042524,COGS 14A,A01,092681,Staff,2,0,100,98
1649991048582,COGS 14B,A01,083073,Cheng; Tzu-Han,0,0,50,50
1649991054626,COGS 17,A01,092677,Staff,45,0,75,30
1649991060679,COGS 100,A01,083619,Staff,1,16,60,59
1649991066710,COGS 101A,A01,083621,Davis; Joshua Daniel,0,17,60,60
1649991072732,COGS 101B,A01,091572,Staff,19,0,60,41
1649991078776,COGS 101C,A01,083625,Delgado; Tania,21,0,30,9
1649991084821,COGS 107A,A01,083627,Boyle; Mary E. T.,0,1,60,60
1649991090872,COGS 118A,A01,083075,Staff,20,0,60,40
1649991096899,CSE 3,A50,083646,Miranda; Gregory Joseph,22,0,38,16
1649991096899,CSE 3,A51,083647,Miranda; Gregory Joseph,37,0,37,0
1649991102922,CSE 8A,A50,083650,Miranda; Gregory Joseph,2,13,40,38
1649991108958,CSE 11,A01,083080,Cao; Yingjun,0,54,40,40
1649991114994,CSE 12,A01,083652,Staff,9,0,100,91
1649991121035,CSE 15L,A01,083654,Staff,0,0,50,50
1649991121035,CSE 15L,A02,083655,Staff,20,0,50,30
1649991127196,CSE 20,A01,083657,Staff,59,0,80,21
1649991133230,CSE 30,A01,083084,Eldon; John,0,56,40,40
1649991139281,CSE 100,A01,083659,Cao; Yingjun,1,55,50,49
1649991145320,CSE 134B,A01,083661,Powell; Thomas Allan,1,26,65,64
1649991151363,CSE 140,A01,083663,Staff,10,0,75,65
1649991157401,CSE 140L,A01,083088,Eldon; John,6,0,75,69
1649991163439,CSE 175,A01,083665,Kumar; Rakesh,10,0,25,15
1649991169475,CSE 190,A00,092507,Dubnov; Shlomo,17,0,20,3
1649991175525,ECE 45,A01,083139,Staff,0,6,40,40
1649991181576,ECE 65,A50,083695,Staff,0,0,30,30
1649991187619,ECE 109,A01,091882,Touri; Behrouz,49,0,70,21
1649991193669,ECE 180,A00,083140,Abi Samra; Nicholas Camill,26,0,30,4
1649991193669,ECE 180,B00,083141,Abi Samra; Nicholas Camill,10,0,30,20
1649991199692,MATH 10A,A01,083735,Patchell; Gregory David,15,0,30,15
1649991199692,MATH 10A,A02,083736,Patchell; Gregory David,28,0,30,2
1649991199692,MATH 10A,A03,083737,Patchell; Gregory David,27,0,30,3
1649991205716,MATH 10B,A01,083207,Staff,0,2,30,30
1649991205716,MATH 10B,A02,083208,Staff,5,0,30,25
1649991205716,MATH 10B,B01,083739,Staff,20,0,30,10
1649991205716,MATH 10B,B02,083740,Staff,30,0,30,0
1649991211759,MATH 18,A01,083743,Staff,14,0,30,16
1649991211759,MATH 18,A02,083744,Staff,29,0,30,1
1649991211759,MATH 18,A03,083745,Staff,24,0,30,6
1649991211759,MATH 18,A04,083746,Staff,27,0,30,3
1649991211759,MATH 18,B01,083748,Staff,0,3,30,30
1649991211759,MATH 18,B02,083749,Staff,0,1,30,30
1649991211759,MATH 18,B03,083750,Staff,0,2,30,30
1649991211759,MATH 18,B04,083751,Staff,0,2,30,30
1649991217785,MATH 20A,A01,083754,Staff,30,0,40,10
1649991223816,MATH 20B,A01,083756,Staff,0,1,30,30
1649991223816,MATH 20B,A02,083757,Staff,15,0,30,15
1649991229840,MATH 20C,A01,083760,Staff,1,7,30,29
1649991229840,MATH 20C,A02,083761,Staff,0,7,30,30
1649991229840,MATH 20C,B01,083762,Staff,21,0,30,9
1649991229840,MATH 20C,B02,083763,Staff,30,0,30,0
1649991235877,MATH 20D,A01,083765,Staff,0,0,30,30
1649991235877,MATH 20D,A02,083766,Staff,19,0,30,11
1649991235877,MATH 20D,A03,083767,Staff,28,0,30,2
1649991241920,MATH 20E,A01,083771,Staff,11,0,30,19
1649991241920,MATH 20E,A02,083772,Staff,21,0,30,9
1649991241920,MATH 20E,B01,083773,Staff,0,0,30,30
1649991241920,MATH 20E,B02,083774,Staff,24,0,30,6
1649991247957,MATH 103A,A01,083777,Staff,1,5,30,29
1649991247957,MATH 103A,A02,083778,Staff,0,5,30,30
1649991247957,MATH 103A,B01,083779,Staff,0,6,30,30
1649991247957,MATH 103A,B02,083780,Staff,0,5,30,30
1649991253999,MATH 105,A01,085443,Staff,0,10,30,30
1649991260035,MATH 109,A01,083213,Anzaldo; Leesa B,0,3,30,30
1649991260035,MATH 109,A02,083214,Anzaldo; Leesa B,1,2,30,29
1649991260035,MATH 109,B01,083215,Anzaldo; Leesa B,1,2,30,29
1649991260035,MATH 109,B02,083216,Anzaldo; Leesa B,0,2,30,30
1649991266091,MATH 142A,A01,083219,Chow; Bennett,0,7,30,30
1649991266091,MATH 142A,A02,083220,Chow; Bennett,0,6,30,30
1649991266091,MATH 142A,B01,083221,Chow; Bennett,0,7,30,30
1649991266091,MATH 142A,B02,083222,Chow; Bennett,0,6,30,30
1649991272115,MATH 193A,A01,083224,Staff,0,6,30,30
1649991272115,MATH 193A,A02,083225,Staff,0,4,30,30
1649991272115,MATH 193A,A03,083781,Staff,1,0,30,29
1649991272115,MATH 193A,A04,083782,Staff,11,0,30,19
1649991278154,MATH 197,001,091859,McAuley; Julian John,9999,0,9999,0
1649991284216,COGS 9,A01,083615,Staff,2,11,60,58
1649991290246,COGS 11,A01,083617,Boyle; Mary E. T.,28,0,40,12
1649991296272,COGS 13,A01,083071,Staff,1,27,40,39
1649991302322,COGS 14A,A01,092681,Staff,1,0,100,99
1649991308358,COGS 14B,A01,083073,Cheng; Tzu-Han,0,0,50,50
1649991314388,COGS 17,A01,092677,Staff,44,0,75,31
1649991320440,COGS 100,A01,083619,Staff,1,16,60,59
1649991326468,COGS 101A,A01,083621,Davis; Joshua Daniel,0,17,60,60
1649991332494,COGS 101B,A01,091572,Staff,19,0,60,41
1649991338535,COGS 101C,A01,083625,Delgado; Tania,21,0,30,9
1649991344596,COGS 107A,A01,083627,Boyle; Mary E. T.,0,1,60,60
1649991350621,COGS 118A,A01,083075,Staff,20,0,60,40
1649991356672,CSE 3,A50,083646,Miranda; Gregory Joseph,22,0,38,16
1649991356672,CSE 3,A51,083647,Miranda; Gregory Joseph,37,0,37,0
1649991362705,CSE 8A,A50,083650,Miranda; Gregory Joseph,2,13,40,38
1649991368756,CSE 11,A01,083080,Cao; Yingjun,0,54,40,40
1649991374781,CSE 12,A01,083652,Staff,9,0,100,91
1649991380806,CSE 15L,A01,083654,Staff,0,0,50,50
1649991380806,CSE 15L,A02,083655,Staff,20,0,50,30
1649991386841,CSE 20,A01,083657,Staff,59,0,80,21
1649991392894,CSE 30,A01,083084,Eldon; John,0,56,40,40
1649991398945,CSE 100,A01,083659,Cao; Yingjun,1,55,50,49
1649991404970,CSE 134B,A01,083661,Powell; Thomas Allan,1,26,65,64
1649991411011,CSE 140,A01,083663,Staff,10,0,75,65
1649991417054,CSE 140L,A01,083088,Eldon; John,6,0,75,69
1649991423114,CSE 175,A01,083665,Kumar; Rakesh,10,0,25,15
1649991429161,CSE 190,A00,092507,Dubnov; Shlomo,17,0,20,3
1649991435213,ECE 45,A01,083139,Staff,0,6,40,40
1649991441247,ECE 65,A50,083695,Staff,0,0,30,30
1649991447274,ECE 109,A01,091882,Touri; Behrouz,49,0,70,21
1649991453297,ECE 180,A00,083140,Abi Samra; Nicholas Camill,26,0,30,4
1649991453297,ECE 180,B00,083141,Abi Samra; Nicholas Camill,10,0,30,20
1649991459350,MATH 10A,A01,083735,Patchell; Gregory David,15,0,30,15
1649991459350,MATH 10A,A02,083736,Patchell; Gregory David,28,0,30,2
1649991459350,MATH 10A,A03,083737,Patchell; Gregory David,27,0,30,3
1649991465398,MATH 10B,A01,083207,Staff,0,2,30,30
1649991465398,MATH 10B,A02,083208,Staff,4,0,30,26
1649991465398,MATH 10B,B01,083739,Staff,20,0,30,10
1649991465398,MATH 10B,B02,083740,Staff,30,0,30,0
1649991471421,MATH 18,A01,083743,Staff,14,0,30,16
1649991471421,MATH 18,A02,083744,Staff,29,0,30,1
1649991471421,MATH 18,A03,083745,Staff,24,0,30,6
1649991471421,MATH 18,A04,083746,Staff,27,0,30,3
1649991471421,MATH 18,B01,083748,Staff,0,3,30,30
1649991471421,MATH 18,B02,083749,Staff,0,1,30,30
1649991471421,MATH 18,B03,083750,Staff,0,2,30,30
1649991471421,MATH 18,B04,083751,Staff,0,2,30,30
1649991477474,MATH 20A,A01,083754,Staff,30,0,40,10
1649991483517,MATH 20B,A01,083756,Staff,0,1,30,30
1649991483517,MATH 20B,A02,083757,Staff,15,0,30,15
1649991489569,MATH 20C,A01,083760,Staff,1,7,30,29
1649991489569,MATH 20C,A02,083761,Staff,0,7,30,30
1649991489569,MATH 20C,B01,083762,Staff,21,0,30,9
1649991489569,MATH 20C,B02,083763,Staff,30,0,30,0
1649991495603,MATH 20D,A01,083765,Staff,0,0,30,30
1649991495603,MATH 20D,A02,083766,Staff,19,0,30,11
1649991495603,MATH 20D,A03,083767,Staff,28,0,30,2
1649991501643,MATH 20E,A01,083771,Staff,11,0,30,19
1649991501643,MATH 20E,A02,083772,Staff,21,0,30,9
1649991501643,MATH 20E,B01,083773,Staff,0,0,30,30
1649991501643,MATH 20E,B02,083774,Staff,24,0,30,6
1649991507691,MATH 103A,A01,083777,Staff,1,5,30,29
1649991507691,MATH 103A,A02,083778,Staff,0,5,30,30
1649991507691,MATH 103A,B01,083779,Staff,0,6,30,30
1649991507691,MATH 103A,B02,083780,Staff,0,5,30,30
1649991513727,MATH 105,A01,085443,Staff,0,10,30,30
1649991519764,MATH 109,A01,083213,Anzaldo; Leesa B,0,3,30,30
1649991519764,MATH 109,A02,083214,Anzaldo; Leesa B,1,2,30,29
1649991519764,MATH 109,B01,083215,Anzaldo; Leesa B,1,2,30,29
1649991519764,MATH 109,B02,083216,Anzaldo; Leesa B,0,2,30,30
1649991525802,MATH 142A,A01,083219,Chow; Bennett,0,7,30,30
1649991525802,MATH 142A,A02,083220,Chow; Bennett,0,6,30,30
1649991525802,MATH 142A,B01,083221,Chow; Bennett,0,7,30,30
1649991525802,MATH 142A,B02,083222,Chow; Bennett,0,6,30,30
1649991531851,MATH 193A,A01,083224,Staff,0,6,30,30
1649991531851,MATH 193A,A02,083225,Staff,0,4,30,30
1649991531851,MATH 193A,A03,083781,Staff,1,0,30,29
1649991531851,MATH 193A,A04,083782,Staff,11,0,30,19
1649991537879,MATH 197,001,091859,McAuley; Julian John,9999,0,9999,0
1649991543982,COGS 9,A01,083615,Staff,2,11,60,58
1649991550015,COGS 11,A01,083617,Boyle; Mary E. T.,28,0,40,12
1649991556042,COGS 13,A01,083071,Staff,1,27,40,39
1649991562093,COGS 14A,A01,092681,Staff,1,0,100,99
1649991568120,COGS 14B,A01,083073,Cheng; Tzu-Han,0,0,50,50
1649991574176,COGS 17,A01,092677,Staff,44,0,75,31
1649991580199,COGS 100,A01,083619,Staff,1,16,60,59
1649991586231,COGS 101A,A01,083621,Davis; Joshua Daniel,0,17,60,60
1649991592286,COGS 101B,A01,091572,Staff,19,0,60,41
1649991598335,COGS 101C,A01,083625,Delgado; Tania,21,0,30,9
1649991604374,COGS 107A,A01,083627,Boyle; Mary E. T.,0,1,60,60
1649991610401,COGS 118A,A01,083075,Staff,20,0,60,40
1649991616428,CSE 3,A50,083646,Miranda; Gregory Joseph,22,0,38,16
1649991616428,CSE 3,A51,083647,Miranda; Gregory Joseph,37,0,37,0
1649991622491,CSE 8A,A50,083650,Miranda; Gregory Joseph,2,13,40,38
1649991628544,CSE 11,A01,083080,Cao; Yingjun,0,54,40,40
1649991634597,CSE 12,A01,083652,Staff,9,0,100,91
1649991640629,CSE 15L,A01,083654,Staff,0,0,50,50
1649991640629,CSE 15L,A02,083655,Staff,20,0,50,30
1649991646674,CSE 20,A01,083657,Staff,59,0,80,21
1649991652706,CSE 30,A01,083084,Eldon; John,0,56,40,40
1649991658739,CSE 100,A01,083659,Cao; Yingjun,1,55,50,49
1649991664788,CSE 134B,A01,083661,Powell; Thomas Allan,1,26,65,64
1649991670837,CSE 140,A01,083663,Staff,10,0,75,65
1649991676880,CSE 140L,A01,083088,Eldon; John,6,0,75,69
1649991682922,CSE 175,A01,083665,Kumar; Rakesh,10,0,25,15
1649991688983,CSE 190,A00,092507,Dubnov; Shlomo,17,0,20,3
1649991695031,ECE 45,A01,083139,Staff,0,6,40,40
1649991701079,ECE 65,A50,083695,Staff,0,0,30,30
1649991707122,ECE 109,A01,091882,Touri; Behrouz,49,0,70,21
1649991713148,ECE 180,A00,083140,Abi Samra; Nicholas Camill,26,0,30,4
1649991713148,ECE 180,B00,083141,Abi Samra; Nicholas Camill,10,0,30,20
1649991719209,MATH 10A,A01,083735,Patchell; Gregory David,15,0,30,15
1649991719209,MATH 10A,A02,083736,Patchell; Gregory David,28,0,30,2
1649991719209,MATH 10A,A03,083737,Patchell; Gregory David,27,0,30,3
1649991725400,MATH 10B,A01,083207,Staff,0,2,30,30
1649991725400,MATH 10B,A02,083208,Staff,4,0,30,26
1649991725400,MATH 10B,B01,083739,Staff,20,0,30,10
1649991725400,MATH 10B,B02,083740,Staff,30,0,30,0
1649991731440,MATH 18,A01,083743,Staff,14,0,30,16
1649991731440,MATH 18,A02,083744,Staff,28,0,30,2
1649991731440,MATH 18,A03,083745,Staff,24,0,30,6
1649991731440,MATH 18,A04,083746,Staff,27,0,30,3
1649991731440,MATH 18,B01,083748,Staff,0,3,30,30
1649991731440,MATH 18,B02,083749,Staff,0,2,30,30
1649991731440,MATH 18,B03,083750,Staff,0,2,30,30
1649991731440,MATH 18,B04,083751,Staff,0,2,30,30
1649991737503,MATH 20A,A01,083754,Staff,30,0,40,10
1649991743552,MATH 20B,A01,083756,Staff,0,1,30,30
1649991743552,MATH 20B,A02,083757,Staff,14,0,30,16
1649991749601,MATH 20C,A01,083760,Staff,1,8,30,29
1649991749601,MATH 20C,A02,083761,Staff,0,7,30,30
1649991749601,MATH 20C,B01,083762,Staff,21,0,30,9
1649991749601,MATH 20C,B02,083763,Staff,30,0,30,0
1649991755639,MATH 20D,A01,083765,Staff,0,0,30,30
1649991755639,MATH 20D,A02,083766,Staff,19,0,30,11
1649991755639,MATH 20D,A03,083767,Staff,28,0,30,2
1649991761685,MATH 20E,A01,083771,Staff,11,0,30,19
1649991761685,MATH 20E,A02,083772,Staff,21,0,30,9
1649991761685,MATH 20E,B01,083773,Staff,0,0,30,30
1649991761685,MATH 20E,B02,083774,Staff,24,0,30,6
1649991767733,MATH 103A,A01,083777,Staff,1,5,30,29
1649991767733,MATH 103A,A02,083778,Staff,0,5,30,30
1649991767733,MATH 103A,B01,083779,Staff,0,6,30,30
1649991767733,MATH 103A,B02,083780,Staff,0,5,30,30
1649991773788,MATH 105,A01,085443,Staff,0,10,30,30
1649991779836,MATH 109,A01,083213,Anzaldo; Leesa B,0,3,30,30
1649991779836,MATH 109,A02,083214,Anzaldo; Leesa B,1,2,30,29
1649991779836,MATH 109,B01,083215,Anzaldo; Leesa B,1,2,30,29
1649991779836,MATH 109,B02,083216,Anzaldo; Leesa B,0,2,30,30
1649991785863,MATH 142A,A01,083219,Chow; Bennett,0,7,30,30
1649991785863,MATH 142A,A02,083220,Chow; Bennett,0,6,30,30
1649991785863,MATH 142A,B01,083221,Chow; Bennett,0,7,30,30
1649991785863,MATH 142A,B02,083222,Chow; Bennett,0,6,30,30
1649991791900,MATH 193A,A01,083224,Staff,0,6,30,30
1649991791900,MATH 193A,A02,083225,Staff,0,4,30,30
1649991791900,MATH 193A,A03,083781,Staff,1,0,30,29
1649991791900,MATH 193A,A04,083782,Staff,11,0,30,19
1649991797926,MATH 197,001,091859,McAuley; Julian John,9999,0,9999,0
1649991804026,COGS 9,A01,083615,Staff,2,13,60,58
1649991810072,COGS 11,A01,083617,Boyle; Mary E. T.,28,0,40,12
1649991816132,COGS 13,A01,083071,Staff,1,27,40,39
1649991822186,COGS 14A,A01,092681,Staff,0,1,100,100
1649991828234,COGS 14B,A01,083073,Cheng; Tzu-Han,0,0,50,50
1649991834287,COGS 17,A01,092677,Staff,43,0,75,32
1649991840321,COGS 100,A01,083619,Staff,1,16,60,59
1649991846364,COGS 101A,A01,083621,Davis; Joshua Daniel,0,17,60,60
1649991852402,COGS 101B,A01,091572,Staff,19,0,60,41
1649991858448,COGS 101C,A01,083625,Delgado; Tania,21,0,30,9
1649991864482,COGS 107A,A01,083627,Boyle; Mary E. T.,0,1,60,60
1649991870518,COGS 118A,A01,083075,Staff,20,0,60,40
1649991876551,CSE 3,A50,083646,Miranda; Gregory Joseph,22,0,38,16
1649991876551,CSE 3,A51,083647,Miranda; Gregory Joseph,37,0,37,0
1649991882616,CSE 8A,A50,083650,Miranda; Gregory Joseph,2,13,40,38
1649991888668,CSE 11,A01,083080,Cao; Yingjun,0,54,40,40
1649991894723,CSE 12,A01,083652,Staff,9,0,100,91
1649991900766,CSE 15L,A01,083654,Staff,0,0,50,50
1649991900766,CSE 15L,A02,083655,Staff,20,0,50,30
1649991906799,CSE 20,A01,083657,Staff,58,0,80,22
1649991912849,CSE 30,A01,083084,Eldon; John,0,56,40,40
1649991918871,CSE 100,A01,083659,Cao; Yingjun,1,55,50,49
1649991924895,CSE 134B,A01,083661,Powell; Thomas Allan,1,26,65,64
1649991930931,CSE 140,A01,083663,Staff,10,0,75,65
1649991936955,CSE 140L,A01,083088,Eldon; John,6,0,75,69
1649991942989,CSE 175,A01,083665,Kumar; Rakesh,10,0,25,15
1649991949050,CSE 190,A00,092507,Dubnov; Shlomo,17,0,20,3
1649991955086,ECE 45,A01,083139,Staff,0,6,40,40
1649991961113,ECE 65,A50,083695,Staff,0,0,30,30
1649991967142,ECE 109,A01,091882,Touri; Behrouz,49,0,70,21
1649991973194,ECE 180,A00,083140,Abi Samra; Nicholas Camill,26,0,30,4
1649991973194,ECE 180,B00,083141,Abi Samra; Nicholas Camill,10,0,30,20
1649991979244,MATH 10A,A01,083735,Patchell; Gregory David,15,0,30,15
1649991979244,MATH 10A,A02,083736,Patchell; Gregory David,28,0,30,2
1649991979244,MATH 10A,A03,083737,Patchell; Gregory David,27,0,30,3
1649991985295,MATH 10B,A01,083207,Staff,0,2,30,30
1649991985295,MATH 10B,A02,083208,Staff,4,0,30,26
1649991985295,MATH 10B,B01,083739,Staff,20,0,30,10
1649991985295,MATH 10B,B02,083740,Staff,30,0,30,0
1649991991352,MATH 18,A01,083743,Staff,14,0,30,16
1649991991352,MATH 18,A02,083744,Staff,28,0,30,2
1649991991352,MATH 18,A03,083745,Staff,24,0,30,6
1649991991352,MATH 18,A04,083746,Staff,27,0,30,3
1649991991352,MATH 18,B01,083748,Staff,0,4,30,30
1649991991352,MATH 18,B02,083749,Staff,0,2,30,30
1649991991352,MATH 18,B03,083750,Staff,0,2,30,30
1649991991352,MATH 18,B04,083751,Staff,0,2,30,30
1649991997387,MATH 20A,A01,083754,Staff,30,0,40,10
1649992003415,MATH 20B,A01,083756,Staff,0,1,30,30
1649992003415,MATH 20B,A02,083757,Staff,13,0,30,17
1649992009438,MATH 20C,A01,083760,Staff,1,8,30,29
1649992009438,MATH 20C,A02,083761,Staff,0,6,30,30
1649992009438,MATH 20C,B01,083762,Staff,21,0,30,9
1649992009438,MATH 20C,B02,083763,Staff,30,0,30,0
1649992015498,MATH 20D,A01,083765,Staff,0,0,30,30
1649992015498,MATH 20D,A02,083766,Staff,19,0,30,11
1649992015498,MATH 20D,A03,083767,Staff,27,0,30,3
1649992021542,MATH 20E,A01,083771,Staff,11,0,30,19
1649992021542,MATH 20E,A02,083772,Staff,21,0,30,9
1649992021542,MATH 20E,B01,083773,Staff,0,0,30,30
1649992021542,MATH 20E,B02,083774,Staff,24,0,30,6
1649992027592,MATH 103A,A01,083777,Staff,1,5,30,29
1649992027592,MATH 103A,A02,083778,Staff,0,5,30,30
1649992027592,MATH 103A,B01,083779,Staff,0,6,30,30
1649992027592,MATH 103A,B02,083780,Staff,0,5,30,30
1649992033647,MATH 105,A01,085443,Staff,0,10,30,30
1649992039693,MATH 109,A01,083213,Anzaldo; Leesa B,0,3,30,30
1649992039693,MATH 109,A02,083214,Anzaldo; Leesa B,1,2,30,29
1649992039693,MATH 109,B01,083215,Anzaldo; Leesa B,1,3,30,29
1649992039693,MATH 109,B02,083216,Anzaldo; Leesa B,0,2,30,30
1649992045749,MATH 142A,A01,083219,Chow; Bennett,0,7,30,30
1649992045749,MATH 142A,A02,083220,Chow; Bennett,0,6,30,30
1649992045749,MATH 142A,B01,083221,Chow; Bennett,0,7,30,30
1649992045749,MATH 142A,B02,083222,Chow; Bennett,0,6,30,30
1649992051784,MATH 193A,A01,083224,Staff,0,6,30,30
1649992051784,MATH 193A,A02,083225,Staff,0,4,30,30
1649992051784,MATH 193A,A03,083781,Staff,1,0,30,29
1649992051784,MATH 193A,A04,083782,Staff,11,0,30,19
1649992057806,MATH 197,001,091859,McAuley; Julian John,9999,0,9999,0
1649992063890,COGS 9,A01,083615,Staff,2,13,60,58
1649992069946,COGS 11,A01,083617,Boyle; Mary E. T.,28,0,40,12
1649992075971,COGS 13,A01,083071,Staff,1,27,40,39
1649992081997,COGS 14A,A01,092681,Staff,0,1,100,100
1649992088037,COGS 14B,A01,083073,Cheng; Tzu-Han,0,0,50,50
1649992094069,COGS 17,A01,092677,Staff,43,0,75,32
1649992100095,COGS 100,A01,083619,Staff,1,16,60,59
1649992106129,COGS 101A,A01,083621,Davis; Joshua Daniel,0,17,60,60
1649992112174,COGS 101B,A01,091572,Staff,18,0,60,42
1649992118234,COGS 101C,A01,083625,Delgado; Tania,21,0,30,9
1649992124256,COGS 107A,A01,083627,Boyle; Mary E. T.,0,1,60,60
1649992130309,COGS 118A,A01,083075,Staff,20,0,60,40
1649992136332,CSE 3,A50,083646,Miranda; Gregory Joseph,22,0,38,16
1649992136332,CSE 3,A51,083647,Miranda; Gregory Joseph,37,0,37,0
1649992142370,CSE 8A,A50,083650,Miranda; Gregory Joseph,2,13,40,38
1649992148417,CSE 11,A01,083080,Cao; Yingjun,0,54,40,40
1649992154449,CSE 12,A01,083652,Staff,9,0,100,91
1649992160480,CSE 15L,A01,083654,Staff,0,0,50,50
1649992160480,CSE 15L,A02,083655,Staff,20,0,50,30
1649992166503,CSE 20,A01,083657,Staff,58,0,80,22
1649992172541,CSE 30,A01,083084,Eldon; John,0,57,40,40
1649992178608,CSE 100,A01,083659,Cao; Yingjun,1,55,50,49
1649992184656,CSE 134B,A01,083661,Powell; Thomas Allan,1,26,65,64
1649992190709,CSE 140,A01,083663,Staff,10,0,75,65
1649992196735,CSE 140L,A01,083088,Eldon; John,6,0,75,69
1649992202760,CSE 175,A01,083665,Kumar; Rakesh,10,0,25,15
1649992208808,CSE 190,A00,092507,Dubnov; Shlomo,17,0,20,3
1649992214839,ECE 45,A01,083139,Staff,0,6,40,40
1649992220864,ECE 65,A50,083695,Staff,0,0,30,30
1649992226887,ECE 109,A01,091882,Touri; Behrouz,49,0,70,21
1649992232947,ECE 180,A00,083140,Abi Samra; Nicholas Camill,26,0,30,4
1649992232947,ECE 180,B00,083141,Abi Samra; Nicholas Camill,10,0,30,20
1649992238999,MATH 10A,A01,083735,Patchell; Gregory David,14,0,30,16
1649992238999,MATH 10A,A02,083736,Patchell; Gregory David,28,0,30,2
1649992238999,MATH 10A,A03,083737,Patchell; Gregory David,27,0,30,3
1649992245035,MATH 10B,A01,083207,Staff,0,2,30,30
1649992245035,MATH 10B,A02,083208,Staff,4,0,30,26
1649992245035,MATH 10B,B01,083739,Staff,20,0,30,10
1649992245035,MATH 10B,B02,083740,Staff,30,0,30,0
1649992251092,MATH 18,A01,083743,Staff,13,0,30,17
1649992251092,MATH 18,A02,083744,Staff,28,0,30,2
1649992251092,MATH 18,A03,083745,Staff,24,0,30,6
1649992251092,MATH 18,A04,083746,Staff,27,0,30,3
1649992251092,MATH 18,B01,083748,Staff,0,3,30,30
1649992251092,MATH 18,B02,083749,Staff,0,3,30,30
1649992251092,MATH 18,B03,083750,Staff,0,2,30,30
1649992251092,MATH 18,B04,083751,Staff,0,2,30,30
1649992257128,MATH 20A,A01,083754,Staff,30,0,40,10
1649992263151,MATH 20B,A01,083756,Staff,0,1,30,30
1649992263151,MATH 20B,A02,083757,Staff,13,0,30,17
1649992269177,MATH 20C,A01,083760,Staff,1,8,30,29
1649992269177,MATH 20C,A02,083761,Staff,0,6,30,30
1649992269177,MATH 20C,B01,083762,Staff,21,0,30,9
1649992269177,MATH 20C,B02,083763,Staff,30,0,30,0
1649992275231,MATH 20D,A01,083765,Staff,0,0,30,30
1649992275231,MATH 20D,A02,083766,Staff,18,0,30,12
1649992275231,MATH 20D,A03,083767,Staff,28,0,30,2
1649992281254,MATH 20E,A01,083771,Staff,11,0,30,19
1649992281254,MATH 20E,A02,083772,Staff,21,0,30,9
1649992281254,MATH 20E,B01,083773,Staff,0,0,30,30
1649992281254,MATH 20E,B02,083774,Staff,24,0,30,6
1649992287313,MATH 103A,A01,083777,Staff,1,5,30,29
1649992287313,MATH 103A,A02,083778,Staff,0,5,30,30
1649992287313,MATH 103A,B01,083779,Staff,0,6,30,30
1649992287313,MATH 103A,B02,083780,Staff,0,5,30,30
1649992293349,MATH 105,A01,085443,Staff,0,10,30,30
1649992299403,MATH 109,A01,083213,Anzaldo; Leesa B,0,3,30,30
1649992299403,MATH 109,A02,083214,Anzaldo; Leesa B,1,2,30,29
1649992299403,MATH 109,B01,083215,Anzaldo; Leesa B,1,3,30,29
1649992299403,MATH 109,B02,083216,Anzaldo; Leesa B,0,2,30,30
1649992305435,MATH 142A,A01,083219,Chow; Bennett,0,7,30,30
1649992305435,MATH 142A,A02,083220,Chow; Bennett,0,6,30,30
1649992305435,MATH 142A,B01,083221,Chow; Bennett,0,7,30,30
1649992305435,MATH 142A,B02,083222,Chow; Bennett,0,6,30,30
1649992311479,MATH 193A,A01,083224,Staff,0,6,30,30
1649992311479,MATH 193A,A02,083225,Staff,0,4,30,30
1649992311479,MATH 193A,A03,083781,Staff,1,0,30,29
1649992311479,MATH 193A,A04,083782,Staff,11,0,30,19
1649992317521,MATH 197,001,091859,McAuley; Julian John,9999,0,9999,0
1649992323733,COGS 9,A01,083615,Staff,2,13,60,58
1649992329784,COGS 11,A01,083617,Boyle; Mary E. T.,28,0,40,12
1649992335810,COGS 13,A01,083071,Staff,1,27,40,39
1649992343488,COGS 14A,A01,092681,Staff,0,1,100,100
1649992349542,COGS 14B,A01,083073,Cheng; Tzu-Han,0,0,50,50
1649992355584,COGS 17,A01,092677,Staff,43,0,75,32
1649992361618,COGS 100,A01,083619,Staff,1,16,60,59
1649992367683,COGS 101A,A01,083621,Davis; Joshua Daniel,0,17,60,60
1649992373719,COGS 101B,A01,091572,Staff,18,0,60,42
1649992379754,COGS 101C,A01,083625,Delgado; Tania,21,0,30,9
1649992385807,COGS 107A,A01,083627,Boyle; Mary E. T.,0,1,60,60
1649992391830,COGS 118A,A01,083075,Staff,20,0,60,40
1649992397856,CSE 3,A50,083646,Miranda; Gregory Joseph,22,0,38,16
1649992397856,CSE 3,A51,083647,Miranda; Gregory Joseph,37,0,37,0
1649992403887,CSE 8A,A50,083650,Miranda; Gregory Joseph,2,13,40,38
1649992409909,CSE 11,A01,083080,Cao; Yingjun,0,54,40,40
1649992415937,CSE 12,A01,083652,Staff,9,0,100,91
1649992421988,CSE 15L,A01,083654,Staff,0,0,50,50
1649992421988,CSE 15L,A02,083655,Staff,20,0,50,30
1649992428010,CSE 20,A01,083657,Staff,58,0,80,22
1649992434040,CSE 30,A01,083084,Eldon; John,0,58,40,40
1649992440101,CSE 100,A01,083659,Cao; Yingjun,1,55,50,49
1649992446123,CSE 134B,A01,083661,Powell; Thomas Allan,1,26,65,64
1649992452170,CSE 140,A01,083663,Staff,10,0,75,65
1649992458225,CSE 140L,A01,083088,Eldon; John,6,0,75,69
1649992471582,CSE 175,A01,083665,Kumar; Rakesh,10,0,25,15
1649992477631,CSE 190,A00,092507,Dubnov; Shlomo,17,0,20,3
1649992483654,ECE 45,A01,083139,Staff,0,6,40,40
1649992489695,ECE 65,A50,083695,Staff,0,0,30,30
1649992495725,ECE 109,A01,091882,Touri; Behrouz,49,0,70,21
1649992501768,ECE 180,A00,083140,Abi Samra; Nicholas Camill,26,0,30,4
1649992501768,ECE 180,B00,083141,Abi Samra; Nicholas Camill,10,0,30,20
1649992507820,MATH 10A,A01,083735,Patchell; Gregory David,14,0,30,16
1649992507820,MATH 10A,A02,083736,Patchell; Gregory David,28,0,30,2
1649992507820,MATH 10A,A03,083737,Patchell; Gregory David,27,0,30,3
1649992513860,MATH 10B,A01,083207,Staff,0,2,30,30
1649992513860,MATH 10B,A02,083208,Staff,4,0,30,26
1649992513860,MATH 10B,B01,083739,Staff,20,0,30,10
1649992513860,MATH 10B,B02,083740,Staff,30,0,30,0
1649992519886,MATH 18,A01,083743,Staff,13,0,30,17
1649992519886,MATH 18,A02,083744,Staff,28,0,30,2
1649992519886,MATH 18,A03,083745,Staff,24,0,30,6
1649992519886,MATH 18,A04,083746,Staff,27,0,30,3
1649992519886,MATH 18,B01,083748,Staff,0,3,30,30
1649992519886,MATH 18,B02,083749,Staff,0,3,30,30
1649992519886,MATH 18,B03,083750,Staff,0,2,30,30
1649992519886,MATH 18,B04,083751,Staff,0,4,30,30
1649992525944,MATH 20A,A01,083754,Staff,30,0,40,10
1649992531968,MATH 20B,A01,083756,Staff,0,1,30,30
1649992531968,MATH 20B,A02,083757,Staff,13,0,30,17
1649992538013,MATH 20C,A01,083760,Staff,1,8,30,29
1649992538013,MATH 20C,A02,083761,Staff,0,6,30,30
1649992538013,MATH 20C,B01,083762,Staff,21,0,30,9
1649992538013,MATH 20C,B02,083763,Staff,30,0,30,0
1649992544068,MATH 20D,A01,083765,Staff,0,0,30,30
1649992544068,MATH 20D,A02,083766,Staff,18,0,30,12
1649992544068,MATH 20D,A03,083767,Staff,28,0,30,2
1649992550115,MATH 20E,A01,083771,Staff,11,0,30,19
1649992550115,MATH 20E,A02,083772,Staff,21,0,30,9
1649992550115,MATH 20E,B01,083773,Staff,0,0,30,30
1649992550115,MATH 20E,B02,083774,Staff,24,0,30,6
1649992556160,MATH 103A,A01,083777,Staff,1,5,30,29
1649992556160,MATH 103A,A02,083778,Staff,0,5,30,30
1649992556160,MATH 103A,B01,083779,Staff,0,6,30,30
1649992556160,MATH 103A,B02,083780,Staff,0,5,30,30
1649992562206,MATH 105,A01,085443,Staff,0,10,30,30
1649992568265,MATH 109,A01,083213,Anzaldo; Leesa B,0,3,30,30
1649992568265,MATH 109,A02,083214,Anzaldo; Leesa B,1,2,30,29
1649992568265,MATH 109,B01,083215,Anzaldo; Leesa B,1,3,30,29
1649992568265,MATH 109,B02,083216,Anzaldo; Leesa B,0,2,30,30
1649992574312,MATH 142A,A01,083219,Chow; Bennett,0,7,30,30
1649992574312,MATH 142A,A02,083220,Chow; Bennett,0,6,30,30
1649992574312,MATH 142A,B01,083221,Chow; Bennett,0,7,30,30
1649992574312,MATH 142A,B02,083222,Chow; Bennett,0,6,30,30
1649992580335,MATH 193A,A01,083224,Staff,0,6,30,30
1649992580335,MATH 193A,A02,083225,Staff,0,4,30,30
1649992580335,MATH 193A,A03,083781,Staff,1,0,30,29
1649992580335,MATH 193A,A04,083782,Staff,11,0,30,19
1649992586371,MATH 197,001,091859,McAuley; Julian John,9999,0,9999,0
1649992592436,COGS 9,A01,083615,Staff,2,13,60,58
1649992598473,COGS 11,A01,083617,Boyle; Mary E. T.,28,0,40,12
1649992604512,COGS 13,A01,083071,Staff,1,28,40,39
1649992610560,COGS 14A,A01,092681,Staff,0,1,100,100
1649992616619,COGS 14B,A01,083073,Cheng; Tzu-Han,0,0,50,50
1649992622661,COGS 17,A01,092677,Staff,43,0,75,32
1649992628709,COGS 100,A01,083619,Staff,1,16,60,59
1649992634750,COGS 101A,A01,083621,Davis; Joshua Daniel,0,17,60,60
1649992640786,COGS 101B,A01,091572,Staff,18,0,60,42
1649992646821,COGS 101C,A01,083625,Delgado; Tania,21,0,30,9
1649992652869,COGS 107A,A01,083627,Boyle; Mary E. T.,0,1,60,60
1649992658907,COGS 118A,A01,083075,Staff,20,0,60,40
1649992664943,CSE 3,A50,083646,Miranda; Gregory Joseph,22,0,38,16
1649992664943,CSE 3,A51,083647,Miranda; Gregory Joseph,37,0,37,0
1649992670988,CSE 8A,A50,083650,Miranda; Gregory Joseph,2,13,40,38
1649992677019,CSE 11,A01,083080,Cao; Yingjun,0,54,40,40
1649992683081,CSE 12,A01,083652,Staff,9,0,100,91
1649992689125,CSE 15L,A01,083654,Staff,0,0,50,50
1649992689125,CSE 15L,A02,083655,Staff,20,0,50,30
1649992695159,CSE 20,A01,083657,Staff,58,0,80,22
1649992701192,CSE 30,A01,083084,Eldon; John,0,59,40,40
1649992707237,CSE 100,A01,083659,Cao; Yingjun,1,55,50,49
1649992713282,CSE 134B,A01,083661,Powell; Thomas Allan,1,26,65,64
1649992719334,CSE 140,A01,083663,Staff,10,0,75,65
1649992725363,CSE 140L,A01,083088,Eldon; John,6,0,75,69
1649992731385,CSE 175,A01,083665,Kumar; Rakesh,10,0,25,15
1649992737409,CSE 190,A00,092507,Dubnov; Shlomo,17,0,20,3
1649992743448,ECE 45,A01,083139,Staff,0,6,40,40
1649992749505,ECE 65,A50,083695,Staff,0,0,30,30
1649992755548,ECE 109,A01,091882,Touri; Behrouz,49,0,70,21
1649992761587,ECE 180,A00,083140,Abi Samra; Nicholas Camill,26,0,30,4
1649992761587,ECE 180,B00,083141,Abi Samra; Nicholas Camill,10,0,30,20
1649992767616,MATH 10A,A01,083735,Patchell; Gregory David,14,0,30,16
1649992767616,MATH 10A,A02,083736,Patchell; Gregory David,28,0,30,2
1649992767616,MATH 10A,A03,083737,Patchell; Gregory David,27,0,30,3
1649992773643,MATH 10B,A01,083207,Staff,0,2,30,30
1649992773643,MATH 10B,A02,083208,Staff,4,0,30,26
1649992773643,MATH 10B,B01,083739,Staff,20,0,30,10
1649992773643,MATH 10B,B02,083740,Staff,30,0,30,0
1649992779680,MATH 18,A01,083743,Staff,13,0,30,17
1649992779680,MATH 18,A02,083744,Staff,28,0,30,2
1649992779680,MATH 18,A03,083745,Staff,24,0,30,6
1649992779680,MATH 18,A04,083746,Staff,27,0,30,3
1649992779680,MATH 18,B01,083748,Staff,0,3,30,30
1649992779680,MATH 18,B02,083749,Staff,0,3,30,30
1649992779680,MATH 18,B03,083750,Staff,0,2,30,30
1649992779680,MATH 18,B04,083751,Staff,0,4,30,30
1649992785710,MATH 20A,A01,083754,Staff,30,0,40,10
1649992791745,MATH 20B,A01,083756,Staff,0,1,30,30
1649992791745,MATH 20B,A02,083757,Staff,13,0,30,17
1649992797780,MATH 20C,A01,083760,Staff,1,8,30,29
1649992797780,MATH 20C,A02,083761,Staff,0,6,30,30
1649992797780,MATH 20C,B01,083762,Staff,21,0,30,9
1649992797780,MATH 20C,B02,083763,Staff,30,0,30,0
1649992803808,MATH 20D,A01,083765,Staff,0,0,30,30
1649992803808,MATH 20D,A02,083766,Staff,18,0,30,12
1649992803808,MATH 20D,A03,083767,Staff,28,0,30,2
1649992809846,MATH 20E,A01,083771,Staff,11,0,30,19
1649992809846,MATH 20E,A02,083772,Staff,21,0,30,9
1649992809846,MATH 20E,B01,083773,Staff,0,0,30,30
1649992809846,MATH 20E,B02,083774,Staff,24,0,30,6
1649992815882,MATH 103A,A01,083777,Staff,1,5,30,29
1649992815882,MATH 103A,A02,083778,Staff,0,5,30,30
1649992815882,MATH 103A,B01,083779,Staff,0,6,30,30
1649992815882,MATH 103A,B02,083780,Staff,0,5,30,30
1649992821905,MATH 105,A01,085443,Staff,0,10,30,30
1649992827939,MATH 109,A01,083213,Anzaldo; Leesa B,0,3,30,30
1649992827939,MATH 109,A02,083214,Anzaldo; Leesa B,1,2,30,29
1649992827939,MATH 109,B01,083215,Anzaldo; Leesa B,1,3,30,29
1649992827939,MATH 109,B02,083216,Anzaldo; Leesa B,0,2,30,30
1649992833982,MATH 142A,A01,083219,Chow; Bennett,0,7,30,30
1649992833982,MATH 142A,A02,083220,Chow; Bennett,0,6,30,30
1649992833982,MATH 142A,B01,083221,Chow; Bennett,0,7,30,30
1649992833982,MATH 142A,B02,083222,Chow; Bennett,0,6,30,30
1649992840018,MATH 193A,A01,083224,Staff,0,6,30,30
1649992840018,MATH 193A,A02,083225,Staff,0,4,30,30
1649992840018,MATH 193A,A03,083781,Staff,1,0,30,29
1649992840018,MATH 193A,A04,083782,Staff,10,0,30,20
1649992846063,MATH 197,001,091859,McAuley; Julian John,9999,0,9999,0
1649992852123,COGS 9,A01,083615,Staff,2,13,60,58
1649992858152,COGS 11,A01,083617,Boyle; Mary E. T.,28,0,40,12
1649992864196,COGS 13,A01,083071,Staff,1,28,40,39
1649992870217,COGS 14A,A01,092681,Staff,0,1,100,100
1649992876251,COGS 14B,A01,083073,Cheng; Tzu-Han,0,0,50,50
1649992882294,COGS 17,A01,092677,Staff,43,0,75,32
1649992888318,COGS 100,A01,083619,Staff,1,16,60,59
1649992894358,COGS 101A,A01,083621,Davis; Joshua Daniel,0,17,60,60
1649992900392,COGS 101B,A01,091572,Staff,18,0,60,42
1649992906417,COGS 101C,A01,083625,Delgado; Tania,21,0,30,9
1649992912442,COGS 107A,A01,083627,Boyle; Mary E. T.,0,1,60,60
1649992918465,COGS 118A,A01,083075,Staff,20,0,60,40
1649992924612,CSE 3,A50,083646,Miranda; Gregory Joseph,22,0,38,16
1649992924612,CSE 3,A51,083647,Miranda; Gregory Joseph,37,0,37,0
1649992930652,CSE 8A,A50,083650,Miranda; Gregory Joseph,2,13,40,38
1649992936683,CSE 11,A01,083080,Cao; Yingjun,0,54,40,40
1649992942713,CSE 12,A01,083652,Staff,9,0,100,91
1649992948748,CSE 15L,A01,083654,Staff,0,0,50,50
1649992948748,CSE 15L,A02,083655,Staff,20,0,50,30
1649992954771,CSE 20,A01,083657,Staff,58,0,80,22
1649992960809,CSE 30,A01,083084,Eldon; John,0,59,40,40
1649992966844,CSE 100,A01,083659,Cao; Yingjun,1,55,50,49
1649992972868,CSE 134B,A01,083661,Powell; Thomas Allan,1,26,65,64
1649992978896,CSE 140,A01,083663,Staff,10,0,75,65
1649992984951,CSE 140L,A01,083088,Eldon; John,6,0,75,69
1649992990974,CSE 175,A01,083665,Kumar; Rakesh,10,0,25,15
1649992996997,CSE 190,A00,092507,Dubnov; Shlomo,17,0,20,3
1649993003021,ECE 45,A01,083139,Staff,0,6,40,40
1649993009047,ECE 65,A50,083695,Staff,0,0,30,30
1649993015075,ECE 109,A01,091882,Touri; Behrouz,49,0,70,21
1649993021116,ECE 180,A00,083140,Abi Samra; Nicholas Camill,26,0,30,4
1649993021116,ECE 180,B00,083141,Abi Samra; Nicholas Camill,10,0,30,20
1649993027142,MATH 10A,A01,083735,Patchell; Gregory David,14,0,30,16
1649993027142,MATH 10A,A02,083736,Patchell; Gregory David,28,0,30,2
1649993027142,MATH 10A,A03,083737,Patchell; Gregory David,27,0,30,3
1649993033179,MATH 10B,A01,083207,Staff,0,2,30,30
1649993033179,MATH 10B,A02,083208,Staff,4,0,30,26
1649993033179,MATH 10B,B01,083739,Staff,20,0,30,10
1649993033179,MATH 10B,B02,083740,Staff,30,0,30,0
1649993039227,MATH 18,A01,083743,Staff,13,0,30,17
1649993039227,MATH 18,A02,083744,Staff,28,0,30,2
1649993039227,MATH 18,A03,083745,Staff,24,0,30,6
1649993039227,MATH 18,A04,083746,Staff,27,0,30,3
1649993039227,MATH 18,B01,083748,Staff,0,3,30,30
1649993039227,MATH 18,B02,083749,Staff,0,3,30,30
1649993039227,MATH 18,B03,083750,Staff,0,3,30,30
1649993039227,MATH 18,B04,083751,Staff,0,4,30,30
1649993045271,MATH 20A,A01,083754,Staff,30,0,40,10
1649993051304,MATH 20B,A01,083756,Staff,0,3,30,30
1649993051304,MATH 20B,A02,083757,Staff,11,0,30,19
1649993057332,MATH 20C,A01,083760,Staff,1,8,30,29
1649993057332,MATH 20C,A02,083761,Staff,0,7,30,30
1649993057332,MATH 20C,B01,083762,Staff,21,0,30,9
1649993057332,MATH 20C,B02,083763,Staff,30,0,30,0
1649993063372,MATH 20D,A01,083765,Staff,0,0,30,30
1649993063372,MATH 20D,A02,083766,Staff,18,0,30,12
1649993063372,MATH 20D,A03,083767,Staff,28,0,30,2
1649993069415,MATH 20E,A01,083771,Staff,11,0,30,19
1649993069415,MATH 20E,A02,083772,Staff,21,0,30,9
1649993069415,MATH 20E,B01,083773,Staff,0,0,30,30
1649993069415,MATH 20E,B02,083774,Staff,24,0,30,6
1649993075446,MATH 103A,A01,083777,Staff,1,5,30,29
1649993075446,MATH 103A,A02,083778,Staff,0,5,30,30
1649993075446,MATH 103A,B01,083779,Staff,0,6,30,30
1649993075446,MATH 103A,B02,083780,Staff,0,5,30,30
1649993081478,MATH 105,A01,085443,Staff,0,10,30,30
1649993087524,MATH 109,A01,083213,Anzaldo; Leesa B,0,3,30,30
1649993087524,MATH 109,A02,083214,Anzaldo; Leesa B,1,2,30,29
1649993087524,MATH 109,B01,083215,Anzaldo; Leesa B,1,3,30,29
1649993087524,MATH 109,B02,083216,Anzaldo; Leesa B,0,2,30,30
1649993093568,MATH 142A,A01,083219,Chow; Bennett,0,7,30,30
1649993093568,MATH 142A,A02,083220,Chow; Bennett,0,6,30,30
1649993093568,MATH 142A,B01,083221,Chow; Bennett,0,7,30,30
1649993093568,MATH 142A,B02,083222,Chow; Bennett,0,6,30,30
1649993099594,MATH 193A,A01,083224,Staff,0,6,30,30
1649993099594,MATH 193A,A02,083225,Staff,0,4,30,30
1649993099594,MATH 193A,A03,083781,Staff,1,0,30,29
1649993099594,MATH 193A,A04,083782,Staff,9,0,30,21
1649993105617,MATH 197,001,091859,McAuley; Julian John,9999,0,9999,0
1649993111708,COGS 9,A01,083615,Staff,2,13,60,58
1649993117731,COGS 11,A01,083617,Boyle; Mary E. T.,28,0,40,12
1649993123756,COGS 13,A01,083071,Staff,1,28,40,39
1649993129779,COGS 14A,A01,092681,Staff,0,1,100,100
1649993135803,COGS 14B,A01,083073,Cheng; Tzu-Han,0,0,50,50
1649993141848,COGS 17,A01,092677,Staff,43,0,75,32
1649993147874,COGS 100,A01,083619,Staff,1,16,60,59
1649993153898,COGS 101A,A01,083621,Davis; Joshua Daniel,0,17,60,60
1649993159929,COGS 101B,A01,091572,Staff,18,0,60,42
1649993165952,COGS 101C,A01,083625,Delgado; Tania,21,0,30,9
1649993171974,COGS 107A,A01,083627,Boyle; Mary E. T.,0,1,60,60
1649993178014,COGS 118A,A01,083075,Staff,20,0,60,40
1649993184061,CSE 3,A50,083646,Miranda; Gregory Joseph,22,0,38,16
1649993184061,CSE 3,A51,083647,Miranda; Gregory Joseph,37,0,37,0
1649993190103,CSE 8A,A50,083650,Miranda; Gregory Joseph,2,14,40,38
1649993196133,CSE 11,A01,083080,Cao; Yingjun,0,54,40,40
1649993202168,CSE 12,A01,083652,Staff,9,0,100,91
1649993208208,CSE 15L,A01,083654,Staff,0,0,50,50
1649993208208,CSE 15L,A02,083655,Staff,20,0,50,30
1649993214237,CSE 20,A01,083657,Staff,58,0,80,22
1649993220261,CSE 30,A01,083084,Eldon; John,0,59,40,40
1649993226283,CSE 100,A01,083659,Cao; Yingjun,1,55,50,49
1649993232342,CSE 134B,A01,083661,Powell; Thomas Allan,1,26,65,64
1649993238368,CSE 140,A01,083663,Staff,10,0,75,65
1649993244416,CSE 140L,A01,083088,Eldon; John,6,0,75,69
1649993250453,CSE 175,A01,083665,Kumar; Rakesh,10,0,25,15
1649993256476,CSE 190,A00,092507,Dubnov; Shlomo,17,0,20,3
1649993262519,ECE 45,A01,083139,Staff,0,6,40,40
1649993268553,ECE 65,A50,083695,Staff,0,0,30,30
1649993274576,ECE 109,A01,091882,Touri; Behrouz,49,0,70,21
1649993280612,ECE 180,A00,083140,Abi Samra; Nicholas Camill,26,0,30,4
1649993280612,ECE 180,B00,083141,Abi Samra; Nicholas Camill,10,0,30,20
1649993286642,MATH 10A,A01,083735,Patchell; Gregory David,14,0,30,16
1649993286642,MATH 10A,A02,083736,Patchell; Gregory David,28,0,30,2
1649993286642,MATH 10A,A03,083737,Patchell; Gregory David,27,0,30,3
1649993292680,MATH 10B,A01,083207,Staff,0,2,30,30
1649993292680,MATH 10B,A02,083208,Staff,4,0,30,26
1649993292680,MATH 10B,B01,083739,Staff,20,0,30,10
1649993292680,MATH 10B,B02,083740,Staff,30,0,30,0
1649993298712,MATH 18,A01,083743,Staff,13,0,30,17
1649993298712,MATH 18,A02,083744,Staff,28,0,30,2
1649993298712,MATH 18,A03,083745,Staff,24,0,30,6
1649993298712,MATH 18,A04,083746,Staff,27,0,30,3
1649993298712,MATH 18,B01,083748,Staff,0,4,30,30
1649993298712,MATH 18,B02,083749,Staff,0,3,30,30
1649993298712,MATH 18,B03,083750,Staff,0,3,30,30
1649993298712,MATH 18,B04,083751,Staff,0,4,30,30
1649993304750,MATH 20A,A01,083754,Staff,30,0,40,10
1649993310806,MATH 20B,A01,083756,Staff,0,3,30,30
1649993310806,MATH 20B,A02,083757,Staff,11,0,30,19
1649993316831,MATH 20C,A01,083760,Staff,1,8,30,29
1649993316831,MATH 20C,A02,083761,Staff,0,7,30,30
1649993316831,MATH 20C,B01,083762,Staff,21,0,30,9
1649993316831,MATH 20C,B02,083763,Staff,30,0,30,0
1649993322886,MATH 20D,A01,083765,Staff,0,0,30,30
1649993322886,MATH 20D,A02,083766,Staff,18,0,30,12
1649993322886,MATH 20D,A03,083767,Staff,28,0,30,2
1649993328910,MATH 20E,A01,083771,Staff,11,0,30,19
1649993328910,MATH 20E,A02,083772,Staff,21,0,30,9
1649993328910,MATH 20E,B01,083773,Staff,0,0,30,30
1649993328910,MATH 20E,B02,083774,Staff,24,0,30,6
1649993334935,MATH 103A,A01,083777,Staff,1,5,30,29
1649993334935,MATH 103A,A02,083778,Staff,0,5,30,30
1649993334935,MATH 103A,B01,083779,Staff,0,6,30,30
1649993334935,MATH 103A,B02,083780,Staff,0,5,30,30
1649993340991,MATH 105,A01,085443,Staff,0,10,30,30
1649993347013,MATH 109,A01,083213,Anzaldo; Leesa B,0,3,30,30
1649993347013,MATH 109,A02,083214,Anzaldo; Leesa B,1,2,30,29
1649993347013,MATH 109,B01,083215,Anzaldo; Leesa B,1,3,30,29
1649993347013,MATH 109,B02,083216,Anzaldo; Leesa B,0,2,30,30
1649993353066,MATH 142A,A01,083219,Chow; Bennett,0,7,30,30
1649993353066,MATH 142A,A02,083220,Chow; Bennett,0,6,30,30
1649993353066,MATH 142A,B01,083221,Chow; Bennett,0,7,30,30
1649993353066,MATH 142A,B02,083222,Chow; Bennett,0,6,30,30
1649993359112,MATH 193A,A01,083224,Staff,0,6,30,30
1649993359112,MATH 193A,A02,083225,Staff,0,4,30,30
1649993359112,MATH 193A,A03,083781,Staff,1,0,30,29
1649993359112,MATH 193A,A04,083782,Staff,9,0,30,21
1649993365142,MATH 197,001,091859,McAuley; Julian John,9999,0,9999,0
1649993371207,COGS 9,A01,083615,Staff,2,13,60,58
1649993377230,COGS 11,A01,083617,Boyle; Mary E. T.,28,0,40,12
1649993383284,COGS 13,A01,083071,Staff,1,28,40,39
1649993389307,COGS 14A,A01,092681,Staff,0,1,100,100
1649993395333,COGS 14B,A01,083073,Cheng; Tzu-Han,0,0,50,50
1649993401359,COGS 17,A01,092677,Staff,42,0,75,33
1649993407406,COGS 100,A01,083619,Staff,1,16,60,59
1649993413434,COGS 101A,A01,083621,Davis; Joshua Daniel,0,17,60,60
1649993419464,COGS 101B,A01,091572,Staff,18,0,60,42
1649993425497,COGS 101C,A01,083625,Delgado; Tania,21,0,30,9
1649993431545,COGS 107A,A01,083627,Boyle; Mary E. T.,0,1,60,60
1649993437569,COGS 118A,A01,083075,Staff,20,0,60,40
1649993443603,CSE 3,A50,083646,Miranda; Gregory Joseph,22,0,38,16
1649993443603,CSE 3,A51,083647,Miranda; Gregory Joseph,37,0,37,0
1649993449639,CSE 8A,A50,083650,Miranda; Gregory Joseph,2,15,40,38
1649993455665,CSE 11,A01,083080,Cao; Yingjun,0,54,40,40
1649993461692,CSE 12,A01,083652,Staff,8,0,100,92
1649993467733,CSE 15L,A01,083654,Staff,0,0,50,50
1649993467733,CSE 15L,A02,083655,Staff,19,0,50,31
1649993473757,CSE 20,A01,083657,Staff,58,0,80,22
1649993479792,CSE 30,A01,083084,Eldon; John,0,59,40,40
1649993485820,CSE 100,A01,083659,Cao; Yingjun,1,55,50,49
1649993491871,CSE 134B,A01,083661,Powell; Thomas Allan,1,26,65,64
1649993497908,CSE 140,A01,083663,Staff,10,0,75,65
1649993503942,CSE 140L,A01,083088,Eldon; John,6,0,75,69
1649993509967,CSE 175,A01,083665,Kumar; Rakesh,10,0,25,15
1649993516027,CSE 190,A00,092507,Dubnov; Shlomo,17,0,20,3
1649993522137,ECE 45,A01,083139,Staff,0,6,40,40
1649993528170,ECE 65,A50,083695,Staff,0,0,30,30
1649993534193,ECE 109,A01,091882,Touri; Behrouz,49,0,70,21
1649993540219,ECE 180,A00,083140,Abi Samra; Nicholas Camill,26,0,30,4
1649993540219,ECE 180,B00,083141,Abi Samra; Nicholas Camill,10,0,30,20
1649993546240,MATH 10A,A01,083735,Patchell; Gregory David,14,0,30,16
1649993546240,MATH 10A,A02,083736,Patchell; Gregory David,28,0,30,2
1649993546240,MATH 10A,A03,083737,Patchell; Gregory David,27,0,30,3
1649993552263,MATH 10B,A01,083207,Staff,0,2,30,30
1649993552263,MATH 10B,A02,083208,Staff,4,0,30,26
1649993552263,MATH 10B,B01,083739,Staff,20,0,30,10
1649993552263,MATH 10B,B02,083740,Staff,30,0,30,0
1649993558284,MATH 18,A01,083743,Staff,13,0,30,17
1649993558284,MATH 18,A02,083744,Staff,28,0,30,2
1649993558284,MATH 18,A03,083745,Staff,24,0,30,6
1649993558284,MATH 18,A04,083746,Staff,27,0,30,3
1649993558284,MATH 18,B01,083748,Staff,0,4,30,30
1649993558284,MATH 18,B02,083749,Staff,0,3,30,30
1649993558284,MATH 18,B03,083750,Staff,0,4,30,30
1649993558284,MATH 18,B04,083751,Staff,0,4,30,30
1649993564307,MATH 20A,A01,083754,Staff,30,0,40,10
1649993570331,MATH 20B,A01,083756,Staff,0,3,30,30
1649993570331,MATH 20B,A02,083757,Staff,11,0,30,19
1649993576355,MATH 20C,A01,083760,Staff,1,8,30,29
1649993576355,MATH 20C,A02,083761,Staff,0,7,30,30
1649993576355,MATH 20C,B01,083762,Staff,21,0,30,9
1649993576355,MATH 20C,B02,083763,Staff,30,0,30,0
1649993582377,MATH 20D,A01,083765,Staff,0,0,30,30
1649993582377,MATH 20D,A02,083766,Staff,18,0,30,12
1649993582377,MATH 20D,A03,083767,Staff,28,0,30,2
1649993588431,MATH 20E,A01,083771,Staff,11,0,30,19
1649993588431,MATH 20E,A02,083772,Staff,21,0,30,9
1649993588431,MATH 20E,B01,083773,Staff,0,0,30,30
1649993588431,MATH 20E,B02,083774,Staff,24,0,30,6
1649993594459,MATH 103A,A01,083777,Staff,1,5,30,29
1649993594459,MATH 103A,A02,083778,Staff,0,5,30,30
1649993594459,MATH 103A,B01,083779,Staff,0,6,30,30
1649993594459,MATH 103A,B02,083780,Staff,0,5,30,30
1649993600499,MATH 105,A01,085443,Staff,0,10,30,30
1649993606545,MATH 109,A01,083213,Anzaldo; Leesa B,0,3,30,30
1649993606545,MATH 109,A02,083214,Anzaldo; Leesa B,1,2,30,29
1649993606545,MATH 109,B01,083215,Anzaldo; Leesa B,1,3,30,29
1649993606545,MATH 109,B02,083216,Anzaldo; Leesa B,1,2,30,29
1649993612592,MATH 142A,A01,083219,Chow; Bennett,0,7,30,30
1649993612592,MATH 142A,A02,083220,Chow; Bennett,0,6,30,30
1649993612592,MATH 142A,B01,083221,Chow; Bennett,0,7,30,30
1649993612592,MATH 142A,B02,083222,Chow; Bennett,0,6,30,30
1649993618632,MATH 193A,A01,083224,Staff,0,6,30,30
1649993618632,MATH 193A,A02,083225,Staff,0,4,30,30
1649993618632,MATH 193A,A03,083781,Staff,1,0,30,29
1649993618632,MATH 193A,A04,083782,Staff,10,0,30,20
1649993624666,MATH 197,001,091859,McAuley; Julian John,9999,0,9999,0
1649993630715,COGS 9,A01,083615,Staff,2,13,60,58
1649993636755,COGS 11,A01,083617,Boyle; Mary E. T.,28,0,40,12
1649993642808,COGS 13,A01,083071,Staff,1,28,40,39
1649993648835,COGS 14A,A01,092681,Staff,0,1,100,100
1649993654862,COGS 14B,A01,083073,Cheng; Tzu-Han,0,0,50,50
1649993660885,COGS 17,A01,092677,Staff,41,0,75,34
1649993666910,COGS 100,A01,083619,Staff,1,16,60,59
1649993672944,COGS 101A,A01,083621,Davis; Joshua Daniel,0,17,60,60
1649993678967,COGS 101B,A01,091572,Staff,18,0,60,42
1649993684996,COGS 101C,A01,083625,Delgado; Tania,21,0,30,9
1649993691029,COGS 107A,A01,083627,Boyle; Mary E. T.,0,1,60,60
1649993697052,COGS 118A,A01,083075,Staff,20,0,60,40
1649993703110,CSE 3,A50,083646,Miranda; Gregory Joseph,22,0,38,16
1649993703110,CSE 3,A51,083647,Miranda; Gregory Joseph,37,0,37,0
1649993709137,CSE 8A,A50,083650,Miranda; Gregory Joseph,2,15,40,38
1649993715176,CSE 11,A01,083080,Cao; Yingjun,0,54,40,40
1649993721199,CSE 12,A01,083652,Staff,8,0,100,92
1649993727226,CSE 15L,A01,083654,Staff,0,0,50,50
1649993727226,CSE 15L,A02,083655,Staff,19,0,50,31
1649993733252,CSE 20,A01,083657,Staff,58,0,80,22
1649993739296,CSE 30,A01,083084,Eldon; John,0,59,40,40
1649993745321,CSE 100,A01,083659,Cao; Yingjun,1,55,50,49
1649993751349,CSE 134B,A01,083661,Powell; Thomas Allan,1,26,65,64
1649993757381,CSE 140,A01,083663,Staff,10,0,75,65
1649993763404,CSE 140L,A01,083088,Eldon; John,6,0,75,69
1649993769459,CSE 175,A01,083665,Kumar; Rakesh,10,0,25,15
1649993775485,CSE 190,A00,092507,Dubnov; Shlomo,17,0,20,3
1649993781519,ECE 45,A01,083139,Staff,0,6,40,40
1649993787545,ECE 65,A50,083695,Staff,0,0,30,30
1649993793587,ECE 109,A01,091882,Touri; Behrouz,49,0,70,21
1649993799610,ECE 180,A00,083140,Abi Samra; Nicholas Camill,26,0,30,4
1649993799610,ECE 180,B00,083141,Abi Samra; Nicholas Camill,10,0,30,20
1649993805655,MATH 10A,A01,083735,Patchell; Gregory David,14,0,30,16
1649993805655,MATH 10A,A02,083736,Patchell; Gregory David,28,0,30,2
1649993805655,MATH 10A,A03,083737,Patchell; Gregory David,27,0,30,3
1649993811684,MATH 10B,A01,083207,Staff,0,2,30,30
1649993811684,MATH 10B,A02,083208,Staff,4,0,30,26
1649993811684,MATH 10B,B01,083739,Staff,20,0,30,10
1649993811684,MATH 10B,B02,083740,Staff,30,0,30,0
1649993817727,MATH 18,A01,083743,Staff,13,0,30,17
1649993817727,MATH 18,A02,083744,Staff,28,0,30,2
1649993817727,MATH 18,A03,083745,Staff,24,0,30,6
1649993817727,MATH 18,A04,083746,Staff,27,0,30,3
1649993817727,MATH 18,B01,083748,Staff,0,4,30,30
1649993817727,MATH 18,B02,083749,Staff,0,3,30,30
1649993817727,MATH 18,B03,083750,Staff,0,4,30,30
1649993817727,MATH 18,B04,083751,Staff,0,4,30,30
1649993823774,MATH 20A,A01,083754,Staff,30,0,40,10
1649993829831,MATH 20B,A01,083756,Staff,0,3,30,30
1649993829831,MATH 20B,A02,083757,Staff,11,0,30,19
1649993835855,MATH 20C,A01,083760,Staff,1,9,30,29
1649993835855,MATH 20C,A02,083761,Staff,0,9,30,30
1649993835855,MATH 20C,B01,083762,Staff,21,0,30,9
1649993835855,MATH 20C,B02,083763,Staff,30,0,30,0
1649993841882,MATH 20D,A01,083765,Staff,0,0,30,30
1649993841882,MATH 20D,A02,083766,Staff,18,0,30,12
1649993841882,MATH 20D,A03,083767,Staff,28,0,30,2
1649993847917,MATH 20E,A01,083771,Staff,11,0,30,19
1649993847917,MATH 20E,A02,083772,Staff,21,0,30,9
1649993847917,MATH 20E,B01,083773,Staff,0,0,30,30
1649993847917,MATH 20E,B02,083774,Staff,24,0,30,6
1649993853940,MATH 103A,A01,083777,Staff,1,5,30,29
1649993853940,MATH 103A,A02,083778,Staff,0,5,30,30
1649993853940,MATH 103A,B01,083779,Staff,0,6,30,30
1649993853940,MATH 103A,B02,083780,Staff,0,5,30,30
1649993859996,MATH 105,A01,085443,Staff,0,10,30,30
1649993866031,MATH 109,A01,083213,Anzaldo; Leesa B,0,3,30,30
1649993866031,MATH 109,A02,083214,Anzaldo; Leesa B,1,2,30,29
1649993866031,MATH 109,B01,083215,Anzaldo; Leesa B,1,3,30,29
1649993866031,MATH 109,B02,083216,Anzaldo; Leesa B,1,2,30,29
1649993872073,MATH 142A,A01,083219,Chow; Bennett,0,7,30,30
1649993872073,MATH 142A,A02,083220,Chow; Bennett,0,6,30,30
1649993872073,MATH 142A,B01,083221,Chow; Bennett,0,7,30,30
1649993872073,MATH 142A,B02,083222,Chow; Bennett,0,6,30,30
1649993878101,MATH 193A,A01,083224,Staff,0,6,30,30
1649993878101,MATH 193A,A02,083225,Staff,0,4,30,30
1649993878101,MATH 193A,A03,083781,Staff,1,0,30,29
1649993878101,MATH 193A,A04,083782,Staff,10,0,30,20
1649993884149,MATH 197,001,091859,McAuley; Julian John,9999,0,9999,0
1649993890244,COGS 9,A01,083615,Staff,2,13,60,58
1649993896270,COGS 11,A01,083617,Boyle; Mary E. T.,28,0,40,12
1649993902314,COGS 13,A01,083071,Staff,1,28,40,39
1649993908342,COGS 14A,A01,092681,Staff,0,2,100,100
1649993914370,COGS 14B,A01,083073,Cheng; Tzu-Han,0,0,50,50
1649993920404,COGS 17,A01,092677,Staff,40,0,75,35
1649993926438,COGS 100,A01,083619,Staff,1,16,60,59
1649993932471,COGS 101A,A01,083621,Davis; Joshua Daniel,0,17,60,60
1649993938493,COGS 101B,A01,091572,Staff,18,0,60,42
1649993944531,COGS 101C,A01,083625,Delgado; Tania,21,0,30,9
1649993950569,COGS 107A,A01,083627,Boyle; Mary E. T.,0,1,60,60
1649993956591,COGS 118A,A01,083075,Staff,20,0,60,40
1649993962651,CSE 3,A50,083646,Miranda; Gregory Joseph,22,0,38,16
1649993962651,CSE 3,A51,083647,Miranda; Gregory Joseph,37,0,37,0
1649993968685,CSE 8A,A50,083650,Miranda; Gregory Joseph,2,15,40,38
1649993974744,CSE 11,A01,083080,Cao; Yingjun,0,55,40,40
1649993980768,CSE 12,A01,083652,Staff,8,0,100,92
1649993986810,CSE 15L,A01,083654,Staff,0,0,50,50
1649993986810,CSE 15L,A02,083655,Staff,19,0,50,31
1649993992856,CSE 20,A01,083657,Staff,57,0,80,23
1649993998879,CSE 30,A01,083084,Eldon; John,0,59,40,40
1649994004936,CSE 100,A01,083659,Cao; Yingjun,1,55,50,49
1649994010976,CSE 134B,A01,083661,Powell; Thomas Allan,1,26,65,64
1649994017000,CSE 140,A01,083663,Staff,9,0,75,66
1649994023023,CSE 140L,A01,083088,Eldon; John,5,0,75,70
1649994029057,CSE 175,A01,083665,Kumar; Rakesh,10,0,25,15
1649994035079,CSE 190,A00,092507,Dubnov; Shlomo,17,0,20,3
1649994041116,ECE 45,A01,083139,Staff,0,6,40,40
1649994047165,ECE 65,A50,083695,Staff,0,0,30,30
1649994053205,ECE 109,A01,091882,Touri; Behrouz,49,0,70,21
1649994059249,ECE 180,A00,083140,Abi Samra; Nicholas Camill,26,0,30,4
1649994059249,ECE 180,B00,083141,Abi Samra; Nicholas Camill,10,0,30,20
1649994065276,MATH 10A,A01,083735,Patchell; Gregory David,14,0,30,16
1649994065276,MATH 10A,A02,083736,Patchell; Gregory David,28,0,30,2
1649994065276,MATH 10A,A03,083737,Patchell; Gregory David,27,0,30,3
1649994071314,MATH 10B,A01,083207,Staff,0,2,30,30
1649994071314,MATH 10B,A02,083208,Staff,4,0,30,26
1649994071314,MATH 10B,B01,083739,Staff,20,0,30,10
1649994071314,MATH 10B,B02,083740,Staff,30,0,30,0
1649994077347,MATH 18,A01,083743,Staff,13,0,30,17
1649994077347,MATH 18,A02,083744,Staff,28,0,30,2
1649994077347,MATH 18,A03,083745,Staff,24,0,30,6
1649994077347,MATH 18,A04,083746,Staff,27,0,30,3
1649994077347,MATH 18,B01,083748,Staff,0,4,30,30
1649994077347,MATH 18,B02,083749,Staff,0,4,30,30
1649994077347,MATH 18,B03,083750,Staff,0,4,30,30
1649994077347,MATH 18,B04,083751,Staff,0,4,30,30
1649994083390,MATH 20A,A01,083754,Staff,29,0,40,11
1649994089413,MATH 20B,A01,083756,Staff,0,3,30,30
1649994089413,MATH 20B,A02,083757,Staff,11,0,30,19
1649994095453,MATH 20C,A01,083760,Staff,1,9,30,29
1649994095453,MATH 20C,A02,083761,Staff,0,9,30,30
1649994095453,MATH 20C,B01,083762,Staff,20,0,30,10
1649994095453,MATH 20C,B02,083763,Staff,30,0,30,0
1649994101506,MATH 20D,A01,083765,Staff,0,1,30,30
1649994101506,MATH 20D,A02,083766,Staff,18,0,30,12
1649994101506,MATH 20D,A03,083767,Staff,28,0,30,2
1649994107533,MATH 20E,A01,083771,Staff,11,0,30,19
1649994107533,MATH 20E,A02,083772,Staff,21,0,30,9
1649994107533,MATH 20E,B01,083773,Staff,0,0,30,30
1649994107533,MATH 20E,B02,083774,Staff,24,0,30,6
1649994113564,MATH 103A,A01,083777,Staff,1,5,30,29
1649994113564,MATH 103A,A02,083778,Staff,0,5,30,30
1649994113564,MATH 103A,B01,083779,Staff,0,6,30,30
1649994113564,MATH 103A,B02,083780,Staff,0,5,30,30
1649994119704,MATH 105,A01,085443,Staff,0,10,30,30
1649994125754,MATH 109,A01,083213,Anzaldo; Leesa B,0,3,30,30
1649994125754,MATH 109,A02,083214,Anzaldo; Leesa B,1,3,30,29
1649994125754,MATH 109,B01,083215,Anzaldo; Leesa B,1,3,30,29
1649994125754,MATH 109,B02,083216,Anzaldo; Leesa B,1,2,30,29
1649994131787,MATH 142A,A01,083219,Chow; Bennett,0,7,30,30
1649994131787,MATH 142A,A02,083220,Chow; Bennett,0,6,30,30
1649994131787,MATH 142A,B01,083221,Chow; Bennett,0,7,30,30
1649994131787,MATH 142A,B02,083222,Chow; Bennett,0,6,30,30
1649994137833,MATH 193A,A01,083224,Staff,0,6,30,30
1649994137833,MATH 193A,A02,083225,Staff,0,4,30,30
1649994137833,MATH 193A,A03,083781,Staff,1,0,30,29
1649994137833,MATH 193A,A04,083782,Staff,10,0,30,20
1649994143854,MATH 197,001,091859,McAuley; Julian John,9999,0,9999,0
1649994149955,COGS 9,A01,083615,Staff,2,13,60,58
1649994155979,COGS 11,A01,083617,Boyle; Mary E. T.,28,0,40,12
1649994162015,COGS 13,A01,083071,Staff,1,28,40,39
1649994168050,COGS 14A,A01,092681,Staff,0,2,100,100
1649994174092,COGS 14B,A01,083073,Cheng; Tzu-Han,0,0,50,50
1649994180130,COGS 17,A01,092677,Staff,40,0,75,35
1649994186163,COGS 100,A01,083619,Staff,1,16,60,59
1649994192187,COGS 101A,A01,083621,Davis; Joshua Daniel,0,17,60,60
1649994198216,COGS 101B,A01,091572,Staff,18,0,60,42
1649994204262,COGS 101C,A01,083625,Delgado; Tania,21,0,30,9
1649994210289,COGS 107A,A01,083627,Boyle; Mary E. T.,0,1,60,60
1649994216341,COGS 118A,A01,083075,Staff,20,0,60,40
1649994222378,CSE 3,A50,083646,Miranda; Gregory Joseph,22,0,38,16
1649994222378,CSE 3,A51,083647,Miranda; Gregory Joseph,37,0,37,0
1649994228427,CSE 8A,A50,083650,Miranda; Gregory Joseph,2,15,40,38
1649994234460,CSE 11,A01,083080,Cao; Yingjun,0,55,40,40
1649994240513,CSE 12,A01,083652,Staff,9,0,100,91
1649994246537,CSE 15L,A01,083654,Staff,1,0,50,49
1649994246537,CSE 15L,A02,083655,Staff,19,0,50,31
1649994252564,CSE 20,A01,083657,Staff,57,0,80,23
1649994258586,CSE 30,A01,083084,Eldon; John,0,59,40,40
1649994264613,CSE 100,A01,083659,Cao; Yingjun,1,55,50,49
1649994270635,CSE 134B,A01,083661,Powell; Thomas Allan,1,26,65,64
1649994276674,CSE 140,A01,083663,Staff,9,0,75,66
1649994282700,CSE 140L,A01,083088,Eldon; John,5,0,75,70
1649994288742,CSE 175,A01,083665,Kumar; Rakesh,10,0,25,15
1649994294777,CSE 190,A00,092507,Dubnov; Shlomo,17,0,20,3
1649994300807,ECE 45,A01,083139,Staff,0,6,40,40
1649994306830,ECE 65,A50,083695,Staff,0,0,30,30
1649994312853,ECE 109,A01,091882,Touri; Behrouz,49,0,70,21
1649994318881,ECE 180,A00,083140,Abi Samra; Nicholas Camill,26,0,30,4
1649994318881,ECE 180,B00,083141,Abi Samra; Nicholas Camill,10,0,30,20
1649994324923,MATH 10A,A01,083735,Patchell; Gregory David,14,0,30,16
1649994324923,MATH 10A,A02,083736,Patchell; Gregory David,28,0,30,2
1649994324923,MATH 10A,A03,083737,Patchell; Gregory David,27,0,30,3
1649994330958,MATH 10B,A01,083207,Staff,0,2,30,30
1649994330958,MATH 10B,A02,083208,Staff,4,0,30,26
1649994330958,MATH 10B,B01,083739,Staff,20,0,30,10
1649994330958,MATH 10B,B02,083740,Staff,30,0,30,0
1649994337015,MATH 18,A01,083743,Staff,13,0,30,17
1649994337015,MATH 18,A02,083744,Staff,28,0,30,2
1649994337015,MATH 18,A03,083745,Staff,24,0,30,6
1649994337015,MATH 18,A04,083746,Staff,27,0,30,3
1649994337015,MATH 18,B01,083748,Staff,0,4,30,30
1649994337015,MATH 18,B02,083749,Staff,0,4,30,30
1649994337015,MATH 18,B03,083750,Staff,0,4,30,30
1649994337015,MATH 18,B04,083751,Staff,0,4,30,30
1649994343051,MATH 20A,A01,083754,Staff,29,0,40,11
1649994349074,MATH 20B,A01,083756,Staff,0,3,30,30
1649994349074,MATH 20B,A02,083757,Staff,11,0,30,19
1649994355109,MATH 20C,A01,083760,Staff,1,9,30,29
1649994355109,MATH 20C,A02,083761,Staff,0,9,30,30
1649994355109,MATH 20C,B01,083762,Staff,19,0,30,11
1649994355109,MATH 20C,B02,083763,Staff,30,0,30,0
1649994361137,MATH 20D,A01,083765,Staff,0,2,30,30
1649994361137,MATH 20D,A02,083766,Staff,18,0,30,12
1649994361137,MATH 20D,A03,083767,Staff,28,0,30,2
1649994367161,MATH 20E,A01,083771,Staff,11,0,30,19
1649994367161,MATH 20E,A02,083772,Staff,21,0,30,9
1649994367161,MATH 20E,B01,083773,Staff,0,0,30,30
1649994367161,MATH 20E,B02,083774,Staff,24,0,30,6
1649994373188,MATH 103A,A01,083777,Staff,1,5,30,29
1649994373188,MATH 103A,A02,083778,Staff,0,5,30,30
1649994373188,MATH 103A,B01,083779,Staff,0,6,30,30
1649994373188,MATH 103A,B02,083780,Staff,0,5,30,30
1649994379232,MATH 105,A01,085443,Staff,0,10,30,30
1649994385270,MATH 109,A01,083213,Anzaldo; Leesa B,0,3,30,30
1649994385270,MATH 109,A02,083214,Anzaldo; Leesa B,1,3,30,29
1649994385270,MATH 109,B01,083215,Anzaldo; Leesa B,1,3,30,29
1649994385270,MATH 109,B02,083216,Anzaldo; Leesa B,1,2,30,29
1649994391311,MATH 142A,A01,083219,Chow; Bennett,0,7,30,30
1649994391311,MATH 142A,A02,083220,Chow; Bennett,0,6,30,30
1649994391311,MATH 142A,B01,083221,Chow; Bennett,0,7,30,30
1649994391311,MATH 142A,B02,083222,Chow; Bennett,0,6,30,30
1649994397338,MATH 193A,A01,083224,Staff,0,6,30,30
1649994397338,MATH 193A,A02,083225,Staff,0,4,30,30
1649994397338,MATH 193A,A03,083781,Staff,0,0,30,30
1649994397338,MATH 193A,A04,083782,Staff,10,0,30,20
1649994403381,MATH 197,001,091859,McAuley; Julian John,9999,0,9999,0
1649994409434,COGS 9,A01,083615,Staff,2,13,60,58
1649994415469,COGS 11,A01,083617,Boyle; Mary E. T.,28,0,40,12
1649994421493,COGS 13,A01,083071,Staff,1,28,40,39
1649994427522,COGS 14A,A01,092681,Staff,0,2,100,100
1649994433552,COGS 14B,A01,083073,Cheng; Tzu-Han,0,0,50,50
1649994439577,COGS 17,A01,092677,Staff,40,0,75,35
1649994445603,COGS 100,A01,083619,Staff,1,16,60,59
1649994451629,COGS 101A,A01,083621,Davis; Joshua Daniel,0,17,60,60
1649994457672,COGS 101B,A01,091572,Staff,18,0,60,42
1649994463700,COGS 101C,A01,083625,Delgado; Tania,21,0,30,9
1649994469734,COGS 107A,A01,083627,Boyle; Mary E. T.,0,1,60,60
1649994475777,COGS 118A,A01,083075,Staff,20,0,60,40
1649994481808,CSE 3,A50,083646,Miranda; Gregory Joseph,22,0,38,16
1649994481808,CSE 3,A51,083647,Miranda; Gregory Joseph,37,0,37,0
1649994487843,CSE 8A,A50,083650,Miranda; Gregory Joseph,2,15,40,38
1649994493866,CSE 11,A01,083080,Cao; Yingjun,0,55,40,40
1649994499889,CSE 12,A01,083652,Staff,9,0,100,91
1649994505912,CSE 15L,A01,083654,Staff,1,0,50,49
1649994505912,CSE 15L,A02,083655,Staff,19,0,50,31
1649994511947,CSE 20,A01,083657,Staff,57,0,80,23
1649994518004,CSE 30,A01,083084,Eldon; John,0,60,40,40
1649994524026,CSE 100,A01,083659,Cao; Yingjun,1,55,50,49
1649994530074,CSE 134B,A01,083661,Powell; Thomas Allan,1,26,65,64
1649994536116,CSE 140,A01,083663,Staff,9,0,75,66
1649994542142,CSE 140L,A01,083088,Eldon; John,5,0,75,70
1649994548167,CSE 175,A01,083665,Kumar; Rakesh,10,0,25,15
1649994554215,CSE 190,A00,092507,Dubnov; Shlomo,17,0,20,3
1649994560247,ECE 45,A01,083139,Staff,0,7,40,40
1649994566272,ECE 65,A50,083695,Staff,0,0,30,30
1649994572308,ECE 109,A01,091882,Touri; Behrouz,49,0,70,21
1649994578334,ECE 180,A00,083140,Abi Samra; Nicholas Camill,26,0,30,4
1649994578334,ECE 180,B00,083141,Abi Samra; Nicholas Camill,10,0,30,20
1649994584380,MATH 10A,A01,083735,Patchell; Gregory David,14,0,30,16
1649994584380,MATH 10A,A02,083736,Patchell; Gregory David,28,0,30,2
1649994584380,MATH 10A,A03,083737,Patchell; Gregory David,27,0,30,3
1649994590410,MATH 10B,A01,083207,Staff,0,2,30,30
1649994590410,MATH 10B,A02,083208,Staff,3,0,30,27
1649994590410,MATH 10B,B01,083739,Staff,20,0,30,10
1649994590410,MATH 10B,B02,083740,Staff,30,0,30,0
1649994596445,MATH 18,A01,083743,Staff,13,0,30,17
1649994596445,MATH 18,A02,083744,Staff,28,0,30,2
1649994596445,MATH 18,A03,083745,Staff,24,0,30,6
1649994596445,MATH 18,A04,083746,Staff,27,0,30,3
1649994596445,MATH 18,B01,083748,Staff,0,4,30,30
1649994596445,MATH 18,B02,083749,Staff,0,4,30,30
1649994596445,MATH 18,B03,083750,Staff,0,4,30,30
1649994596445,MATH 18,B04,083751,Staff,0,4,30,30
1649994602469,MATH 20A,A01,083754,Staff,29,0,40,11
1649994608492,MATH 20B,A01,083756,Staff,0,3,30,30
1649994608492,MATH 20B,A02,083757,Staff,11,0,30,19
1649994614531,MATH 20C,A01,083760,Staff,1,9,30,29
1649994614531,MATH 20C,A02,083761,Staff,0,9,30,30
1649994614531,MATH 20C,B01,083762,Staff,19,0,30,11
1649994614531,MATH 20C,B02,083763,Staff,30,0,30,0
1649994620554,MATH 20D,A01,083765,Staff,0,2,30,30
1649994620554,MATH 20D,A02,083766,Staff,18,0,30,12
1649994620554,MATH 20D,A03,083767,Staff,28,0,30,2
1649994626601,MATH 20E,A01,083771,Staff,11,0,30,19
1649994626601,MATH 20E,A02,083772,Staff,21,0,30,9
1649994626601,MATH 20E,B01,083773,Staff,0,0,30,30
1649994626601,MATH 20E,B02,083774,Staff,24,0,30,6
1649994632643,MATH 103A,A01,083777,Staff,1,5,30,29
1649994632643,MATH 103A,A02,083778,Staff,0,6,30,30
1649994632643,MATH 103A,B01,083779,Staff,0,6,30,30
1649994632643,MATH 103A,B02,083780,Staff,0,5,30,30
1649994638669,MATH 105,A01,085443,Staff,0,10,30,30
1649994644693,MATH 109,A01,083213,Anzaldo; Leesa B,0,3,30,30
1649994644693,MATH 109,A02,083214,Anzaldo; Leesa B,1,3,30,29
1649994644693,MATH 109,B01,083215,Anzaldo; Leesa B,1,3,30,29
1649994644693,MATH 109,B02,083216,Anzaldo; Leesa B,1,2,30,29
1649994650725,MATH 142A,A01,083219,Chow; Bennett,0,7,30,30
1649994650725,MATH 142A,A02,083220,Chow; Bennett,0,6,30,30
1649994650725,MATH 142A,B01,083221,Chow; Bennett,0,7,30,30
1649994650725,MATH 142A,B02,083222,Chow; Bennett,0,6,30,30
1649994656772,MATH 193A,A01,083224,Staff,0,6,30,30
1649994656772,MATH 193A,A02,083225,Staff,0,4,30,30
1649994656772,MATH 193A,A03,083781,Staff,0,0,30,30
1649994656772,MATH 193A,A04,083782,Staff,10,0,30,20
1649994662803,MATH 197,001,091859,McAuley; Julian John,9999,0,9999,0
1649994668875,COGS 9,A01,083615,Staff,2,13,60,58
1649994674906,COGS 11,A01,083617,Boyle; Mary E. T.,28,0,40,12
1649994680967,COGS 13,A01,083071,Staff,1,28,40,39
1649994686989,COGS 14A,A01,092681,Staff,0,2,100,100
1649994693027,COGS 14B,A01,083073,Cheng; Tzu-Han,0,0,50,50
1649994699060,COGS 17,A01,092677,Staff,40,0,75,35
1649994705083,COGS 100,A01,083619,Staff,1,16,60,59
1649994711202,COGS 101A,A01,083621,Davis; Joshua Daniel,0,17,60,60
1649994717230,COGS 101B,A01,091572,Staff,18,0,60,42
1649994723288,COGS 101C,A01,083625,Delgado; Tania,21,0,30,9
1649994729341,COGS 107A,A01,083627,Boyle; Mary E. T.,0,1,60,60
1649994735374,COGS 118A,A01,083075,Staff,20,0,60,40
1649994741402,CSE 3,A50,083646,Miranda; Gregory Joseph,22,0,38,16
1649994741402,CSE 3,A51,083647,Miranda; Gregory Joseph,37,0,37,0
1649994747429,CSE 8A,A50,083650,Miranda; Gregory Joseph,2,15,40,38
1649994753465,CSE 11,A01,083080,Cao; Yingjun,0,55,40,40
1649994759514,CSE 12,A01,083652,Staff,8,0,100,92
1649994765547,CSE 15L,A01,083654,Staff,1,0,50,49
1649994765547,CSE 15L,A02,083655,Staff,19,0,50,31
1649994771595,CSE 20,A01,083657,Staff,57,0,80,23
1649994777618,CSE 30,A01,083084,Eldon; John,0,60,40,40
1649994783641,CSE 100,A01,083659,Cao; Yingjun,1,55,50,49
1649994789675,CSE 134B,A01,083661,Powell; Thomas Allan,1,26,65,64
1649994795698,CSE 140,A01,083663,Staff,9,0,75,66
1649994801735,CSE 140L,A01,083088,Eldon; John,5,0,75,70
1649994807761,CSE 175,A01,083665,Kumar; Rakesh,10,0,25,15
1649994813788,CSE 190,A00,092507,Dubnov; Shlomo,17,0,20,3
1649994819811,ECE 45,A01,083139,Staff,0,7,40,40
1649994825844,ECE 65,A50,083695,Staff,0,0,30,30
1649994831866,ECE 109,A01,091882,Touri; Behrouz,49,0,70,21
1649994837903,ECE 180,A00,083140,Abi Samra; Nicholas Camill,26,0,30,4
1649994837903,ECE 180,B00,083141,Abi Samra; Nicholas Camill,10,0,30,20
1649994843940,MATH 10A,A01,083735,Patchell; Gregory David,14,0,30,16
1649994843940,MATH 10A,A02,083736,Patchell; Gregory David,28,0,30,2
1649994843940,MATH 10A,A03,083737,Patchell; Gregory David,27,0,30,3
1649994849978,MATH 10B,A01,083207,Staff,0,2,30,30
1649994849978,MATH 10B,A02,083208,Staff,3,0,30,27
1649994849978,MATH 10B,B01,083739,Staff,20,0,30,10
1649994849978,MATH 10B,B02,083740,Staff,30,0,30,0
1649994856007,MATH 18,A01,083743,Staff,13,0,30,17
1649994856007,MATH 18,A02,083744,Staff,28,0,30,2
1649994856007,MATH 18,A03,083745,Staff,24,0,30,6
1649994856007,MATH 18,A04,083746,Staff,27,0,30,3
1649994856007,MATH 18,B01,083748,Staff,0,4,30,30
1649994856007,MATH 18,B02,083749,Staff,0,4,30,30
1649994856007,MATH 18,B03,083750,Staff,0,4,30,30
1649994856007,MATH 18,B04,083751,Staff,0,4,30,30
1649994862048,MATH 20A,A01,083754,Staff,29,0,40,11
1649994868082,MATH 20B,A01,083756,Staff,0,3,30,30
1649994868082,MATH 20B,A02,083757,Staff,11,0,30,19
1649994874109,MATH 20C,A01,083760,Staff,1,9,30,29
1649994874109,MATH 20C,A02,083761,Staff,0,9,30,30
1649994874109,MATH 20C,B01,083762,Staff,19,0,30,11
1649994874109,MATH 20C,B02,083763,Staff,30,0,30,0
1649994880138,MATH 20D,A01,083765,Staff,0,2,30,30
1649994880138,MATH 20D,A02,083766,Staff,18,0,30,12
1649994880138,MATH 20D,A03,083767,Staff,28,0,30,2
1649994886161,MATH 20E,A01,083771,Staff,11,0,30,19
1649994886161,MATH 20E,A02,083772,Staff,21,0,30,9
1649994886161,MATH 20E,B01,083773,Staff,0,0,30,30
1649994886161,MATH 20E,B02,083774,Staff,24,0,30,6
1649994892208,MATH 103A,A01,083777,Staff,1,5,30,29
1649994892208,MATH 103A,A02,083778,Staff,0,6,30,30
1649994892208,MATH 103A,B01,083779,Staff,0,6,30,30
1649994892208,MATH 103A,B02,083780,Staff,0,5,30,30
1649994898260,MATH 105,A01,085443,Staff,0,10,30,30
1649994904310,MATH 109,A01,083213,Anzaldo; Leesa B,0,3,30,30
1649994904310,MATH 109,A02,083214,Anzaldo; Leesa B,1,3,30,29
1649994904310,MATH 109,B01,083215,Anzaldo; Leesa B,1,3,30,29
1649994904310,MATH 109,B02,083216,Anzaldo; Leesa B,1,3,30,29
1649994910346,MATH 142A,A01,083219,Chow; Bennett,0,7,30,30
1649994910346,MATH 142A,A02,083220,Chow; Bennett,0,6,30,30
1649994910346,MATH 142A,B01,083221,Chow; Bennett,0,7,30,30
1649994910346,MATH 142A,B02,083222,Chow; Bennett,0,6,30,30
1649994916385,MATH 193A,A01,083224,Staff,0,6,30,30
1649994916385,MATH 193A,A02,083225,Staff,0,4,30,30
1649994916385,MATH 193A,A03,083781,Staff,0,0,30,30
1649994916385,MATH 193A,A04,083782,Staff,10,0,30,20
1649994922428,MATH 197,001,091859,McAuley; Julian John,9999,0,9999,0
1649994928528,COGS 9,A01,083615,Staff,2,14,60,58
1649994934561,COGS 11,A01,083617,Boyle; Mary E. T.,28,0,40,12
1649994940607,COGS 13,A01,083071,Staff,1,28,40,39
1649994946636,COGS 14A,A01,092681,Staff,0,2,100,100
1649994952660,COGS 14B,A01,083073,Cheng; Tzu-Han,0,0,50,50
1649994958693,COGS 17,A01,092677,Staff,39,0,75,36
1649994964719,COGS 100,A01,083619,Staff,1,16,60,59
1649994970754,COGS 101A,A01,083621,Davis; Joshua Daniel,0,17,60,60
1649994976780,COGS 101B,A01,091572,Staff,18,0,60,42
1649994982804,COGS 101C,A01,083625,Delgado; Tania,21,0,30,9
1649994988853,COGS 107A,A01,083627,Boyle; Mary E. T.,0,1,60,60
1649994994892,COGS 118A,A01,083075,Staff,20,0,60,40
1649995000918,CSE 3,A50,083646,Miranda; Gregory Joseph,22,0,38,16
1649995000918,CSE 3,A51,083647,Miranda; Gregory Joseph,37,0,37,0
1649995006955,CSE 8A,A50,083650,Miranda; Gregory Joseph,2,15,40,38
1649995012981,CSE 11,A01,083080,Cao; Yingjun,0,56,40,40
1649995019006,CSE 12,A01,083652,Staff,8,0,100,92
1649995025034,CSE 15L,A01,083654,Staff,1,0,50,49
1649995025034,CSE 15L,A02,083655,Staff,19,0,50,31
1649995031078,CSE 20,A01,083657,Staff,57,0,80,23
1649995037100,CSE 30,A01,083084,Eldon; John,0,60,40,40
1649995043131,CSE 100,A01,083659,Cao; Yingjun,1,55,50,49
1649995049159,CSE 134B,A01,083661,Powell; Thomas Allan,1,26,65,64
1649995055199,CSE 140,A01,083663,Staff,9,0,75,66
1649995061228,CSE 140L,A01,083088,Eldon; John,5,0,75,70
1649995067258,CSE 175,A01,083665,Kumar; Rakesh,10,0,25,15
1649995073295,CSE 190,A00,092507,Dubnov; Shlomo,17,0,20,3
1649995079317,ECE 45,A01,083139,Staff,0,7,40,40
1649995085353,ECE 65,A50,083695,Staff,0,0,30,30
1649995091376,ECE 109,A01,091882,Touri; Behrouz,49,0,70,21
1649995097421,ECE 180,A00,083140,Abi Samra; Nicholas Camill,26,0,30,4
1649995097421,ECE 180,B00,083141,Abi Samra; Nicholas Camill,10,0,30,20
1649995103450,MATH 10A,A01,083735,Patchell; Gregory David,14,0,30,16
1649995103450,MATH 10A,A02,083736,Patchell; Gregory David,28,0,30,2
1649995103450,MATH 10A,A03,083737,Patchell; Gregory David,27,0,30,3
1649995109474,MATH 10B,A01,083207,Staff,0,2,30,30
1649995109474,MATH 10B,A02,083208,Staff,3,0,30,27
1649995109474,MATH 10B,B01,083739,Staff,20,0,30,10
1649995109474,MATH 10B,B02,083740,Staff,30,0,30,0
1649995115513,MATH 18,A01,083743,Staff,13,0,30,17
1649995115513,MATH 18,A02,083744,Staff,28,0,30,2
1649995115513,MATH 18,A03,083745,Staff,24,0,30,6
1649995115513,MATH 18,A04,083746,Staff,27,0,30,3
1649995115513,MATH 18,B01,083748,Staff,0,4,30,30
1649995115513,MATH 18,B02,083749,Staff,0,4,30,30
1649995115513,MATH 18,B03,083750,Staff,0,4,30,30
1649995115513,MATH 18,B04,083751,Staff,0,4,30,30
1649995121537,MATH 20A,A01,083754,Staff,29,0,40,11
1649995127571,MATH 20B,A01,083756,Staff,0,3,30,30
1649995127571,MATH 20B,A02,083757,Staff,11,0,30,19
1649995133615,MATH 20C,A01,083760,Staff,1,9,30,29
1649995133615,MATH 20C,A02,083761,Staff,0,8,30,30
1649995133615,MATH 20C,B01,083762,Staff,18,0,30,12
1649995133615,MATH 20C,B02,083763,Staff,30,0,30,0
1649995139650,MATH 20D,A01,083765,Staff,0,2,30,30
1649995139650,MATH 20D,A02,083766,Staff,18,0,30,12
1649995139650,MATH 20D,A03,083767,Staff,28,0,30,2
1649995145704,MATH 20E,A01,083771,Staff,11,0,30,19
1649995145704,MATH 20E,A02,083772,Staff,21,0,30,9
1649995145704,MATH 20E,B01,083773,Staff,0,0,30,30
1649995145704,MATH 20E,B02,083774,Staff,24,0,30,6
1649995151731,MATH 103A,A01,083777,Staff,1,5,30,29
1649995151731,MATH 103A,A02,083778,Staff,0,6,30,30
1649995151731,MATH 103A,B01,083779,Staff,0,6,30,30
1649995151731,MATH 103A,B02,083780,Staff,0,5,30,30
1649995157765,MATH 105,A01,085443,Staff,0,10,30,30
1649995163814,MATH 109,A01,083213,Anzaldo; Leesa B,0,3,30,30
1649995163814,MATH 109,A02,083214,Anzaldo; Leesa B,1,3,30,29
1649995163814,MATH 109,B01,083215,Anzaldo; Leesa B,1,3,30,29
1649995163814,MATH 109,B02,083216,Anzaldo; Leesa B,1,3,30,29
1649995169857,MATH 142A,A01,083219,Chow; Bennett,0,7,30,30
1649995169857,MATH 142A,A02,083220,Chow; Bennett,0,6,30,30
1649995169857,MATH 142A,B01,083221,Chow; Bennett,0,7,30,30
1649995169857,MATH 142A,B02,083222,Chow; Bennett,0,6,30,30
1649995175880,MATH 193A,A01,083224,Staff,0,6,30,30
1649995175880,MATH 193A,A02,083225,Staff,0,4,30,30
1649995175880,MATH 193A,A03,083781,Staff,0,0,30,30
1649995175880,MATH 193A,A04,083782,Staff,10,0,30,20
1649995181918,MATH 197,001,091859,McAuley; Julian John,9999,0,9999,0
1649995187982,COGS 9,A01,083615,Staff,2,15,60,58
1649995194031,COGS 11,A01,083617,Boyle; Mary E. T.,28,0,40,12
1649995200055,COGS 13,A01,083071,Staff,1,28,40,39
1649995206082,COGS 14A,A01,092681,Staff,0,2,100,100
1649995212109,COGS 14B,A01,083073,Cheng; Tzu-Han,0,0,50,50
1649995218154,COGS 17,A01,092677,Staff,39,0,75,36
1649995224176,COGS 100,A01,083619,Staff,1,17,60,59
1649995230202,COGS 101A,A01,083621,Davis; Joshua Daniel,0,17,60,60
1649995236238,COGS 101B,A01,091572,Staff,18,0,60,42
1649995242282,COGS 101C,A01,083625,Delgado; Tania,21,0,30,9
1649995248311,COGS 107A,A01,083627,Boyle; Mary E. T.,0,1,60,60
1649995254337,COGS 118A,A01,083075,Staff,20,0,60,40
1649995260360,CSE 3,A50,083646,Miranda; Gregory Joseph,22,0,38,16
1649995260360,CSE 3,A51,083647,Miranda; Gregory Joseph,37,0,37,0
1649995266407,CSE 8A,A50,083650,Miranda; Gregory Joseph,2,15,40,38
1649995272433,CSE 11,A01,083080,Cao; Yingjun,0,56,40,40
1649995278488,CSE 12,A01,083652,Staff,8,0,100,92
1649995284515,CSE 15L,A01,083654,Staff,1,0,50,49
1649995284515,CSE 15L,A02,083655,Staff,19,0,50,31
1649995290541,CSE 20,A01,083657,Staff,57,0,80,23
1649995296567,CSE 30,A01,083084,Eldon; John,0,60,40,40
1649995302616,CSE 100,A01,083659,Cao; Yingjun,1,55,50,49
1649995308729,CSE 134B,A01,083661,Powell; Thomas Allan,1,26,65,64
1649995314752,CSE 140,A01,083663,Staff,9,0,75,66
1649995320775,CSE 140L,A01,083088,Eldon; John,5,0,75,70
1649995326816,CSE 175,A01,083665,Kumar; Rakesh,10,0,25,15
1649995332844,CSE 190,A00,092507,Dubnov; Shlomo,17,0,20,3
1649995338892,ECE 45,A01,083139,Staff,0,7,40,40
1649995344919,ECE 65,A50,083695,Staff,0,0,30,30
1649995350943,ECE 109,A01,091882,Touri; Behrouz,49,0,70,21
1649995356981,ECE 180,A00,083140,Abi Samra; Nicholas Camill,26,0,30,4
1649995356981,ECE 180,B00,083141,Abi Samra; Nicholas Camill,10,0,30,20
1649995363004,MATH 10A,A01,083735,Patchell; Gregory David,14,0,30,16
1649995363004,MATH 10A,A02,083736,Patchell; Gregory David,28,0,30,2
1649995363004,MATH 10A,A03,083737,Patchell; Gregory David,27,0,30,3
1649995369052,MATH 10B,A01,083207,Staff,0,2,30,30
1649995369052,MATH 10B,A02,083208,Staff,3,0,30,27
1649995369052,MATH 10B,B01,083739,Staff,20,0,30,10
1649995369052,MATH 10B,B02,083740,Staff,30,0,30,0
1649995375083,MATH 18,A01,083743,Staff,13,0,30,17
1649995375083,MATH 18,A02,083744,Staff,28,0,30,2
1649995375083,MATH 18,A03,083745,Staff,24,0,30,6
1649995375083,MATH 18,A04,083746,Staff,27,0,30,3
1649995375083,MATH 18,B01,083748,Staff,0,5,30,30
1649995375083,MATH 18,B02,083749,Staff,0,4,30,30
1649995375083,MATH 18,B03,083750,Staff,0,4,30,30
1649995375083,MATH 18,B04,083751,Staff,0,4,30,30
1649995381129,MATH 20A,A01,083754,Staff,29,0,40,11
1649995387156,MATH 20B,A01,083756,Staff,0,3,30,30
1649995387156,MATH 20B,A02,083757,Staff,11,0,30,19
1649995393183,MATH 20C,A01,083760,Staff,1,9,30,29
1649995393183,MATH 20C,A02,083761,Staff,0,8,30,30
1649995393183,MATH 20C,B01,083762,Staff,18,0,30,12
1649995393183,MATH 20C,B02,083763,Staff,30,0,30,0
1649995399223,MATH 20D,A01,083765,Staff,0,2,30,30
1649995399223,MATH 20D,A02,083766,Staff,18,0,30,12
1649995399223,MATH 20D,A03,083767,Staff,28,0,30,2
1649995405248,MATH 20E,A01,083771,Staff,11,0,30,19
1649995405248,MATH 20E,A02,083772,Staff,21,0,30,9
1649995405248,MATH 20E,B01,083773,Staff,0,0,30,30
1649995405248,MATH 20E,B02,083774,Staff,23,0,30,7
1649995411273,MATH 103A,A01,083777,Staff,1,5,30,29
1649995411273,MATH 103A,A02,083778,Staff,0,6,30,30
1649995411273,MATH 103A,B01,083779,Staff,0,6,30,30
1649995411273,MATH 103A,B02,083780,Staff,0,5,30,30
1649995417323,MATH 105,A01,085443,Staff,0,10,30,30
1649995423353,MATH 109,A01,083213,Anzaldo; Leesa B,0,3,30,30
1649995423353,MATH 109,A02,083214,Anzaldo; Leesa B,1,3,30,29
1649995423353,MATH 109,B01,083215,Anzaldo; Leesa B,1,3,30,29
1649995423353,MATH 109,B02,083216,Anzaldo; Leesa B,1,3,30,29
1649995429383,MATH 142A,A01,083219,Chow; Bennett,0,7,30,30
1649995429383,MATH 142A,A02,083220,Chow; Bennett,0,6,30,30
1649995429383,MATH 142A,B01,083221,Chow; Bennett,0,7,30,30
1649995429383,MATH 142A,B02,083222,Chow; Bennett,0,6,30,30
1649995435406,MATH 193A,A01,083224,Staff,0,6,30,30
1649995435406,MATH 193A,A02,083225,Staff,0,4,30,30
1649995435406,MATH 193A,A03,083781,Staff,0,0,30,30
1649995435406,MATH 193A,A04,083782,Staff,10,0,30,20
1649995441466,MATH 197,001,091859,McAuley; Julian John,9999,0,9999,0
1649995447562,COGS 9,A01,083615,Staff,2,15,60,58
1649995453597,COGS 11,A01,083617,Boyle; Mary E. T.,28,0,40,12
1649995459642,COGS 13,A01,083071,Staff,1,28,40,39
1649995465678,COGS 14A,A01,092681,Staff,0,2,100,100
1649995471707,COGS 14B,A01,083073,Cheng; Tzu-Han,0,0,50,50
1649995477748,COGS 17,A01,092677,Staff,39,0,75,36
1649995483774,COGS 100,A01,083619,Staff,1,17,60,59
1649995489825,COGS 101A,A01,083621,Davis; Joshua Daniel,0,17,60,60
1649995495855,COGS 101B,A01,091572,Staff,17,0,60,43
1649995501894,COGS 101C,A01,083625,Delgado; Tania,21,0,30,9
1649995507918,COGS 107A,A01,083627,Boyle; Mary E. T.,0,1,60,60
1649995513955,COGS 118A,A01,083075,Staff,20,0,60,40
1649995519979,CSE 3,A50,083646,Miranda; Gregory Joseph,22,0,38,16
1649995519979,CSE 3,A51,083647,Miranda; Gregory Joseph,37,0,37,0
1649995526002,CSE 8A,A50,083650,Miranda; Gregory Joseph,2,15,40,38
1649995532025,CSE 11,A01,083080,Cao; Yingjun,0,56,40,40
1649995538049,CSE 12,A01,083652,Staff,8,0,100,92
1649995544096,CSE 15L,A01,083654,Staff,1,0,50,49
1649995544096,CSE 15L,A02,083655,Staff,19,0,50,31
1649995550119,CSE 20,A01,083657,Staff,57,0,80,23
1649995556153,CSE 30,A01,083084,Eldon; John,0,60,40,40
1649995562191,CSE 100,A01,083659,Cao; Yingjun,1,55,50,49
1649995568214,CSE 134B,A01,083661,Powell; Thomas Allan,1,26,65,64
1649995574244,CSE 140,A01,083663,Staff,9,0,75,66
1649995580281,CSE 140L,A01,083088,Eldon; John,5,0,75,70
1649995586303,CSE 175,A01,083665,Kumar; Rakesh,10,0,25,15
1649995592365,CSE 190,A00,092507,Dubnov; Shlomo,17,0,20,3
1649995598401,ECE 45,A01,083139,Staff,0,7,40,40
1649995604437,ECE 65,A50,083695,Staff,0,0,30,30
1649995610471,ECE 109,A01,091882,Touri; Behrouz,49,0,70,21
1649995616513,ECE 180,A00,083140,Abi Samra; Nicholas Camill,26,0,30,4
1649995616513,ECE 180,B00,083141,Abi Samra; Nicholas Camill,10,0,30,20
1649995622539,MATH 10A,A01,083735,Patchell; Gregory David,14,0,30,16
1649995622539,MATH 10A,A02,083736,Patchell; Gregory David,28,0,30,2
1649995622539,MATH 10A,A03,083737,Patchell; Gregory David,27,0,30,3
1649995628598,MATH 10B,A01,083207,Staff,0,2,30,30
1649995628598,MATH 10B,A02,083208,Staff,3,0,30,27
1649995628598,MATH 10B,B01,083739,Staff,20,0,30,10
1649995628598,MATH 10B,B02,083740,Staff,30,0,30,0
1649995634647,MATH 18,A01,083743,Staff,13,0,30,17
1649995634647,MATH 18,A02,083744,Staff,28,0,30,2
1649995634647,MATH 18,A03,083745,Staff,24,0,30,6
1649995634647,MATH 18,A04,083746,Staff,27,0,30,3
1649995634647,MATH 18,B01,083748,Staff,0,5,30,30
1649995634647,MATH 18,B02,083749,Staff,0,4,30,30
1649995634647,MATH 18,B03,083750,Staff,0,4,30,30
1649995634647,MATH 18,B04,083751,Staff,0,4,30,30
1649995640671,MATH 20A,A01,083754,Staff,29,0,40,11
1649995646698,MATH 20B,A01,083756,Staff,0,4,30,30
1649995646698,MATH 20B,A02,083757,Staff,11,0,30,19
1649995652745,MATH 20C,A01,083760,Staff,1,9,30,29
1649995652745,MATH 20C,A02,083761,Staff,0,8,30,30
1649995652745,MATH 20C,B01,083762,Staff,18,0,30,12
1649995652745,MATH 20C,B02,083763,Staff,30,0,30,0
1649995658773,MATH 20D,A01,083765,Staff,0,2,30,30
1649995658773,MATH 20D,A02,083766,Staff,18,0,30,12
1649995658773,MATH 20D,A03,083767,Staff,28,0,30,2
1649995664806,MATH 20E,A01,083771,Staff,11,0,30,19
1649995664806,MATH 20E,A02,083772,Staff,21,0,30,9
1649995664806,MATH 20E,B01,083773,Staff,0,0,30,30
1649995664806,MATH 20E,B02,083774,Staff,23,0,30,7
1649995670843,MATH 103A,A01,083777,Staff,1,5,30,29
1649995670843,MATH 103A,A02,083778,Staff,0,6,30,30
1649995670843,MATH 103A,B01,083779,Staff,0,6,30,30
1649995670843,MATH 103A,B02,083780,Staff,0,5,30,30
1649995676870,MATH 105,A01,085443,Staff,0,10,30,30
1649995682922,MATH 109,A01,083213,Anzaldo; Leesa B,0,3,30,30
1649995682922,MATH 109,A02,083214,Anzaldo; Leesa B,1,4,30,29
1649995682922,MATH 109,B01,083215,Anzaldo; Leesa B,1,3,30,29
1649995682922,MATH 109,B02,083216,Anzaldo; Leesa B,1,3,30,29
1649995688961,MATH 142A,A01,083219,Chow; Bennett,0,7,30,30
1649995688961,MATH 142A,A02,083220,Chow; Bennett,0,6,30,30
1649995688961,MATH 142A,B01,083221,Chow; Bennett,0,7,30,30
1649995688961,MATH 142A,B02,083222,Chow; Bennett,0,6,30,30
1649995694986,MATH 193A,A01,083224,Staff,0,6,30,30
1649995694986,MATH 193A,A02,083225,Staff,0,4,30,30
1649995694986,MATH 193A,A03,083781,Staff,0,0,30,30
1649995694986,MATH 193A,A04,083782,Staff,10,0,30,20
1649995701021,MATH 197,001,091859,McAuley; Julian John,9999,0,9999,0
1649995707072,COGS 9,A01,083615,Staff,2,15,60,58
1649995713098,COGS 11,A01,083617,Boyle; Mary E. T.,28,0,40,12
1649995719143,COGS 13,A01,083071,Staff,1,28,40,39
1649995725180,COGS 14A,A01,092681,Staff,0,2,100,100
1649995731207,COGS 14B,A01,083073,Cheng; Tzu-Han,0,0,50,50
1649995737260,COGS 17,A01,092677,Staff,39,0,75,36
1649995743295,COGS 100,A01,083619,Staff,1,17,60,59
1649995749321,COGS 101A,A01,083621,Davis; Joshua Daniel,0,17,60,60
1649995755356,COGS 101B,A01,091572,Staff,17,0,60,43
1649995761383,COGS 101C,A01,083625,Delgado; Tania,21,0,30,9
1649995767432,COGS 107A,A01,083627,Boyle; Mary E. T.,0,1,60,60
1649995773466,COGS 118A,A01,083075,Staff,20,0,60,40
1649995779489,CSE 3,A50,083646,Miranda; Gregory Joseph,22,0,38,16
1649995779489,CSE 3,A51,083647,Miranda; Gregory Joseph,37,0,37,0
1649995785526,CSE 8A,A50,083650,Miranda; Gregory Joseph,2,15,40,38
1649995791553,CSE 11,A01,083080,Cao; Yingjun,0,56,40,40
1649995797577,CSE 12,A01,083652,Staff,8,0,100,92
1649995803624,CSE 15L,A01,083654,Staff,1,0,50,49
1649995803624,CSE 15L,A02,083655,Staff,19,0,50,31
1649995809661,CSE 20,A01,083657,Staff,57,0,80,23
1649995815683,CSE 30,A01,083084,Eldon; John,0,60,40,40
1649995821710,CSE 100,A01,083659,Cao; Yingjun,1,55,50,49
1649995827737,CSE 134B,A01,083661,Powell; Thomas Allan,1,26,65,64
1649995833764,CSE 140,A01,083663,Staff,9,0,75,66
1649995839809,CSE 140L,A01,083088,Eldon; John,5,0,75,70
1649995845834,CSE 175,A01,083665,Kumar; Rakesh,10,0,25,15
1649995851860,CSE 190,A00,092507,Dubnov; Shlomo,17,0,20,3
1649995857897,ECE 45,A01,083139,Staff,0,7,40,40
1649995863926,ECE 65,A50,083695,Staff,0,0,30,30
1649995869974,ECE 109,A01,091882,Touri; Behrouz,49,0,70,21
1649995876027,ECE 180,A00,083140,Abi Samra; Nicholas Camill,26,0,30,4
1649995876027,ECE 180,B00,083141,Abi Samra; Nicholas Camill,10,0,30,20
1649995882056,MATH 10A,A01,083735,Patchell; Gregory David,14,0,30,16
1649995882056,MATH 10A,A02,083736,Patchell; Gregory David,28,0,30,2
1649995882056,MATH 10A,A03,083737,Patchell; Gregory David,27,0,30,3
1649995888080,MATH 10B,A01,083207,Staff,0,2,30,30
1649995888080,MATH 10B,A02,083208,Staff,3,0,30,27
1649995888080,MATH 10B,B01,083739,Staff,20,0,30,10
1649995888080,MATH 10B,B02,083740,Staff,30,0,30,0
1649995894136,MATH 18,A01,083743,Staff,13,0,30,17
1649995894136,MATH 18,A02,083744,Staff,28,0,30,2
1649995894136,MATH 18,A03,083745,Staff,24,0,30,6
1649995894136,MATH 18,A04,083746,Staff,27,0,30,3
1649995894136,MATH 18,B01,083748,Staff,0,5,30,30
1649995894136,MATH 18,B02,083749,Staff,0,5,30,30
1649995894136,MATH 18,B03,083750,Staff,0,4,30,30
1649995894136,MATH 18,B04,083751,Staff,0,5,30,30
1649995900162,MATH 20A,A01,083754,Staff,29,0,40,11
1649995906284,MATH 20B,A01,083756,Staff,0,3,30,30
1649995906284,MATH 20B,A02,083757,Staff,10,0,30,20
1649995912318,MATH 20C,A01,083760,Staff,1,9,30,29
1649995912318,MATH 20C,A02,083761,Staff,0,8,30,30
1649995912318,MATH 20C,B01,083762,Staff,18,0,30,12
1649995912318,MATH 20C,B02,083763,Staff,30,0,30,0
1649995918346,MATH 20D,A01,083765,Staff,0,2,30,30
1649995918346,MATH 20D,A02,083766,Staff,18,0,30,12
1649995918346,MATH 20D,A03,083767,Staff,28,0,30,2
1649995924370,MATH 20E,A01,083771,Staff,11,0,30,19
1649995924370,MATH 20E,A02,083772,Staff,21,0,30,9
1649995924370,MATH 20E,B01,083773,Staff,0,0,30,30
1649995924370,MATH 20E,B02,083774,Staff,23,0,30,7
1649995930420,MATH 103A,A01,083777,Staff,1,5,30,29
1649995930420,MATH 103A,A02,083778,Staff,0,6,30,30
1649995930420,MATH 103A,B01,083779,Staff,0,6,30,30
1649995930420,MATH 103A,B02,083780,Staff,0,5,30,30
1649995936467,MATH 105,A01,085443,Staff,0,10,30,30
1649995942492,MATH 109,A01,083213,Anzaldo; Leesa B,0,3,30,30
1649995942492,MATH 109,A02,083214,Anzaldo; Leesa B,1,4,30,29
1649995942492,MATH 109,B01,083215,Anzaldo; Leesa B,1,3,30,29
1649995942492,MATH 109,B02,083216,Anzaldo; Leesa B,1,3,30,29
1649995948535,MATH 142A,A01,083219,Chow; Bennett,0,7,30,30
1649995948535,MATH 142A,A02,083220,Chow; Bennett,0,6,30,30
1649995948535,MATH 142A,B01,083221,Chow; Bennett,0,7,30,30
1649995948535,MATH 142A,B02,083222,Chow; Bennett,0,6,30,30
1649995954586,MATH 193A,A01,083224,Staff,0,6,30,30
1649995954586,MATH 193A,A02,083225,Staff,0,4,30,30
1649995954586,MATH 193A,A03,083781,Staff,0,0,30,30
1649995954586,MATH 193A,A04,083782,Staff,10,0,30,20
1649995960611,MATH 197,001,091859,McAuley; Julian John,9999,0,9999,0
1649995966694,COGS 9,A01,083615,Staff,2,15,60,58
1649995972734,COGS 11,A01,083617,Boyle; Mary E. T.,28,0,40,12
1649995978781,COGS 13,A01,083071,Staff,1,28,40,39
1649995984808,COGS 14A,A01,092681,Staff,0,2,100,100
1649995990830,COGS 14B,A01,083073,Cheng; Tzu-Han,0,0,50,50
1649995996856,COGS 17,A01,092677,Staff,39,0,75,36
1649996002879,COGS 100,A01,083619,Staff,1,17,60,59
1649996008903,COGS 101A,A01,083621,Davis; Joshua Daniel,0,17,60,60
1649996014941,COGS 101B,A01,091572,Staff,17,0,60,43
1649996020973,COGS 101C,A01,083625,Delgado; Tania,21,0,30,9
1649996027013,COGS 107A,A01,083627,Boyle; Mary E. T.,0,1,60,60
1649996033040,COGS 118A,A01,083075,Staff,20,0,60,40
1649996039076,CSE 3,A50,083646,Miranda; Gregory Joseph,22,0,38,16
1649996039076,CSE 3,A51,083647,Miranda; Gregory Joseph,37,0,37,0
1649996045113,CSE 8A,A50,083650,Miranda; Gregory Joseph,2,15,40,38
1649996051135,CSE 11,A01,083080,Cao; Yingjun,0,56,40,40
1649996057176,CSE 12,A01,083652,Staff,8,0,100,92
1649996063198,CSE 15L,A01,083654,Staff,1,0,50,49
1649996063198,CSE 15L,A02,083655,Staff,19,0,50,31
1649996069235,CSE 20,A01,083657,Staff,57,0,80,23
1649996075266,CSE 30,A01,083084,Eldon; John,0,60,40,40
1649996081289,CSE 100,A01,083659,Cao; Yingjun,1,55,50,49
1649996087322,CSE 134B,A01,083661,Powell; Thomas Allan,1,26,65,64
1649996093344,CSE 140,A01,083663,Staff,9,0,75,66
1649996099379,CSE 140L,A01,083088,Eldon; John,5,0,75,70
1649996105410,CSE 175,A01,083665,Kumar; Rakesh,10,0,25,15
1649996111433,CSE 190,A00,092507,Dubnov; Shlomo,17,0,20,3
1649996117461,ECE 45,A01,083139,Staff,0,7,40,40
1649996123488,ECE 65,A50,083695,Staff,1,0,30,29
1649996129512,ECE 109,A01,091882,Touri; Behrouz,49,0,70,21
1649996135557,ECE 180,A00,083140,Abi Samra; Nicholas Camill,26,0,30,4
1649996135557,ECE 180,B00,083141,Abi Samra; Nicholas Camill,10,0,30,20
1649996141590,MATH 10A,A01,083735,Patchell; Gregory David,14,0,30,16
1649996141590,MATH 10A,A02,083736,Patchell; Gregory David,28,0,30,2
1649996141590,MATH 10A,A03,083737,Patchell; Gregory David,27,0,30,3
1649996147613,MATH 10B,A01,083207,Staff,0,2,30,30
1649996147613,MATH 10B,A02,083208,Staff,3,0,30,27
1649996147613,MATH 10B,B01,083739,Staff,20,0,30,10
1649996147613,MATH 10B,B02,083740,Staff,30,0,30,0
1649996153654,MATH 18,A01,083743,Staff,13,0,30,17
1649996153654,MATH 18,A02,083744,Staff,28,0,30,2
1649996153654,MATH 18,A03,083745,Staff,24,0,30,6
1649996153654,MATH 18,A04,083746,Staff,27,0,30,3
1649996153654,MATH 18,B01,083748,Staff,0,5,30,30
1649996153654,MATH 18,B02,083749,Staff,0,5,30,30
1649996153654,MATH 18,B03,083750,Staff,0,4,30,30
1649996153654,MATH 18,B04,083751,Staff,0,5,30,30
1649996159708,MATH 20A,A01,083754,Staff,28,0,40,12
1649996165741,MATH 20B,A01,083756,Staff,0,3,30,30
1649996165741,MATH 20B,A02,083757,Staff,10,0,30,20
1649996171762,MATH 20C,A01,083760,Staff,1,9,30,29
1649996171762,MATH 20C,A02,083761,Staff,0,8,30,30
1649996171762,MATH 20C,B01,083762,Staff,17,0,30,13
1649996171762,MATH 20C,B02,083763,Staff,30,0,30,0
1649996177790,MATH 20D,A01,083765,Staff,0,2,30,30
1649996177790,MATH 20D,A02,083766,Staff,17,0,30,13
1649996177790,MATH 20D,A03,083767,Staff,28,0,30,2
1649996183815,MATH 20E,A01,083771,Staff,11,0,30,19
1649996183815,MATH 20E,A02,083772,Staff,21,0,30,9
1649996183815,MATH 20E,B01,083773,Staff,0,0,30,30
1649996183815,MATH 20E,B02,083774,Staff,23,0,30,7
1649996189849,MATH 103A,A01,083777,Staff,1,5,30,29
1649996189849,MATH 103A,A02,083778,Staff,0,6,30,30
1649996189849,MATH 103A,B01,083779,Staff,0,6,30,30
1649996189849,MATH 103A,B02,083780,Staff,0,5,30,30
1649996195887,MATH 105,A01,085443,Staff,0,10,30,30
1649996201937,MATH 109,A01,083213,Anzaldo; Leesa B,0,3,30,30
1649996201937,MATH 109,A02,083214,Anzaldo; Leesa B,1,4,30,29
1649996201937,MATH 109,B01,083215,Anzaldo; Leesa B,1,3,30,29
1649996201937,MATH 109,B02,083216,Anzaldo; Leesa B,1,3,30,29
1649996207967,MATH 142A,A01,083219,Chow; Bennett,0,7,30,30
1649996207967,MATH 142A,A02,083220,Chow; Bennett,0,6,30,30
1649996207967,MATH 142A,B01,083221,Chow; Bennett,0,7,30,30
1649996207967,MATH 142A,B02,083222,Chow; Bennett,0,6,30,30
1649996214014,MATH 193A,A01,083224,Staff,0,6,30,30
1649996214014,MATH 193A,A02,083225,Staff,0,4,30,30
1649996214014,MATH 193A,A03,083781,Staff,0,0,30,30
1649996214014,MATH 193A,A04,083782,Staff,10,0,30,20
1649996220049,MATH 197,001,091859,McAuley; Julian John,9999,0,9999,0
1649996226114,COGS 9,A01,083615,Staff,2,15,60,58
1649996232141,COGS 11,A01,083617,Boyle; Mary E. T.,28,0,40,12
1649996238171,COGS 13,A01,083071,Staff,1,28,40,39
1649996244201,COGS 14A,A01,092681,Staff,0,3,100,100
1649996250246,COGS 14B,A01,083073,Cheng; Tzu-Han,0,0,50,50
1649996256273,COGS 17,A01,092677,Staff,39,0,75,36
1649996262296,COGS 100,A01,083619,Staff,1,17,60,59
1649996268342,COGS 101A,A01,083621,Davis; Joshua Daniel,0,17,60,60
1649996274364,COGS 101B,A01,091572,Staff,17,0,60,43
1649996280404,COGS 101C,A01,083625,Delgado; Tania,21,0,30,9
1649996286436,COGS 107A,A01,083627,Boyle; Mary E. T.,0,1,60,60
1649996292485,COGS 118A,A01,083075,Staff,20,0,60,40
1649996298520,CSE 3,A50,083646,Miranda; Gregory Joseph,22,0,38,16
1649996298520,CSE 3,A51,083647,Miranda; Gregory Joseph,37,0,37,0
1649996304556,CSE 8A,A50,083650,Miranda; Gregory Joseph,2,15,40,38
1649996310590,CSE 11,A01,083080,Cao; Yingjun,0,56,40,40
1649996316630,CSE 12,A01,083652,Staff,8,0,100,92
1649996322663,CSE 15L,A01,083654,Staff,1,0,50,49
1649996322663,CSE 15L,A02,083655,Staff,19,0,50,31
1649996328691,CSE 20,A01,083657,Staff,57,0,80,23
1649996334721,CSE 30,A01,083084,Eldon; John,0,60,40,40
1649996340747,CSE 100,A01,083659,Cao; Yingjun,1,55,50,49
1649996346784,CSE 134B,A01,083661,Powell; Thomas Allan,1,26,65,64
1649996352816,CSE 140,A01,083663,Staff,9,0,75,66
1649996358863,CSE 140L,A01,083088,Eldon; John,5,0,75,70
1649996364903,CSE 175,A01,083665,Kumar; Rakesh,10,0,25,15
1649996370947,CSE 190,A00,092507,Dubnov; Shlomo,17,0,20,3
1649996376974,ECE 45,A01,083139,Staff,0,7,40,40
1649996382999,ECE 65,A50,083695,Staff,1,0,30,29
1649996389049,ECE 109,A01,091882,Touri; Behrouz,49,0,70,21
1649996395075,ECE 180,A00,083140,Abi Samra; Nicholas Camill,26,0,30,4
1649996395075,ECE 180,B00,083141,Abi Samra; Nicholas Camill,10,0,30,20
1649996401098,MATH 10A,A01,083735,Patchell; Gregory David,14,0,30,16
1649996401098,MATH 10A,A02,083736,Patchell; Gregory David,28,0,30,2
1649996401098,MATH 10A,A03,083737,Patchell; Gregory David,27,0,30,3
1649996407135,MATH 10B,A01,083207,Staff,0,2,30,30
1649996407135,MATH 10B,A02,083208,Staff,3,0,30,27
1649996407135,MATH 10B,B01,083739,Staff,20,0,30,10
1649996407135,MATH 10B,B02,083740,Staff,30,0,30,0
1649996413161,MATH 18,A01,083743,Staff,13,0,30,17
1649996413161,MATH 18,A02,083744,Staff,28,0,30,2
1649996413161,MATH 18,A03,083745,Staff,24,0,30,6
1649996413161,MATH 18,A04,083746,Staff,27,0,30,3
1649996413161,MATH 18,B01,083748,Staff,0,5,30,30
1649996413161,MATH 18,B02,083749,Staff,0,5,30,30
1649996413161,MATH 18,B03,083750,Staff,0,4,30,30
1649996413161,MATH 18,B04,083751,Staff,0,5,30,30
1649996419188,MATH 20A,A01,083754,Staff,28,0,40,12
1649996425239,MATH 20B,A01,083756,Staff,0,3,30,30
1649996425239,MATH 20B,A02,083757,Staff,10,0,30,20
1649996431289,MATH 20C,A01,083760,Staff,1,9,30,29
1649996431289,MATH 20C,A02,083761,Staff,0,8,30,30
1649996431289,MATH 20C,B01,083762,Staff,16,0,30,14
1649996431289,MATH 20C,B02,083763,Staff,30,0,30,0
1649996437316,MATH 20D,A01,083765,Staff,0,2,30,30
1649996437316,MATH 20D,A02,083766,Staff,17,0,30,13
1649996437316,MATH 20D,A03,083767,Staff,28,0,30,2
1649996443351,MATH 20E,A01,083771,Staff,11,0,30,19
1649996443351,MATH 20E,A02,083772,Staff,21,0,30,9
1649996443351,MATH 20E,B01,083773,Staff,0,0,30,30
1649996443351,MATH 20E,B02,083774,Staff,23,0,30,7
1649996449390,MATH 103A,A01,083777,Staff,1,5,30,29
1649996449390,MATH 103A,A02,083778,Staff,0,6,30,30
1649996449390,MATH 103A,B01,083779,Staff,0,6,30,30
1649996449390,MATH 103A,B02,083780,Staff,0,5,30,30
1649996455418,MATH 105,A01,085443,Staff,0,10,30,30
1649996461461,MATH 109,A01,083213,Anzaldo; Leesa B,0,3,30,30
1649996461461,MATH 109,A02,083214,Anzaldo; Leesa B,1,4,30,29
1649996461461,MATH 109,B01,083215,Anzaldo; Leesa B,1,3,30,29
1649996461461,MATH 109,B02,083216,Anzaldo; Leesa B,1,3,30,29
1649996467494,MATH 142A,A01,083219,Chow; Bennett,0,7,30,30
1649996467494,MATH 142A,A02,083220,Chow; Bennett,0,6,30,30
1649996467494,MATH 142A,B01,083221,Chow; Bennett,0,7,30,30
1649996467494,MATH 142A,B02,083222,Chow; Bennett,0,6,30,30
1649996473529,MATH 193A,A01,083224,Staff,0,6,30,30
1649996473529,MATH 193A,A02,083225,Staff,0,4,30,30
1649996473529,MATH 193A,A03,083781,Staff,0,0,30,30
1649996473529,MATH 193A,A04,083782,Staff,10,0,30,20
1649996479555,MATH 197,001,091859,McAuley; Julian John,9999,0,9999,0
1649996485634,COGS 9,A01,083615,Staff,2,15,60,58
1649996491657,COGS 11,A01,083617,Boyle; Mary E. T.,28,0,40,12
1649996497780,COGS 13,A01,083071,Staff,1,28,40,39
1649996503827,COGS 14A,A01,092681,Staff,0,3,100,100
1649996509867,COGS 14B,A01,083073,Cheng; Tzu-Han,0,0,50,50
1649996515890,COGS 17,A01,092677,Staff,39,0,75,36
1649996521913,COGS 100,A01,083619,Staff,1,17,60,59
1649996527956,COGS 101A,A01,083621,Davis; Joshua Daniel,0,17,60,60
1649996534004,COGS 101B,A01,091572,Staff,17,0,60,43
1649996540067,COGS 101C,A01,083625,Delgado; Tania,21,0,30,9
1649996546093,COGS 107A,A01,083627,Boyle; Mary E. T.,0,1,60,60
1649996552120,COGS 118A,A01,083075,Staff,20,0,60,40
1649996558145,CSE 3,A50,083646,Miranda; Gregory Joseph,22,0,38,16
1649996558145,CSE 3,A51,083647,Miranda; Gregory Joseph,37,0,37,0
1649996564183,CSE 8A,A50,083650,Miranda; Gregory Joseph,2,15,40,38
1649996570224,CSE 11,A01,083080,Cao; Yingjun,0,56,40,40
1649996576248,CSE 12,A01,083652,Staff,8,0,100,92
1649996582275,CSE 15L,A01,083654,Staff,1,0,50,49
1649996582275,CSE 15L,A02,083655,Staff,19,0,50,31
1649996588318,CSE 20,A01,083657,Staff,57,0,80,23
1649996594347,CSE 30,A01,083084,Eldon; John,0,60,40,40
1649996600375,CSE 100,A01,083659,Cao; Yingjun,1,55,50,49
1649996606429,CSE 134B,A01,083661,Powell; Thomas Allan,1,26,65,64
1649996612455,CSE 140,A01,083663,Staff,9,0,75,66
1649996618479,CSE 140L,A01,083088,Eldon; John,5,0,75,70
1649996624532,CSE 175,A01,083665,Kumar; Rakesh,10,0,25,15
1649996630560,CSE 190,A00,092507,Dubnov; Shlomo,17,0,20,3
1649996636606,ECE 45,A01,083139,Staff,0,7,40,40
1649996642661,ECE 65,A50,083695,Staff,1,0,30,29
1649996648684,ECE 109,A01,091882,Touri; Behrouz,49,0,70,21
1649996654729,ECE 180,A00,083140,Abi Samra; Nicholas Camill,26,0,30,4
1649996654729,ECE 180,B00,083141,Abi Samra; Nicholas Camill,10,0,30,20
1649996660753,MATH 10A,A01,083735,Patchell; Gregory David,14,0,30,16
1649996660753,MATH 10A,A02,083736,Patchell; Gregory David,28,0,30,2
1649996660753,MATH 10A,A03,083737,Patchell; Gregory David,27,0,30,3
1649996666798,MATH 10B,A01,083207,Staff,0,2,30,30
1649996666798,MATH 10B,A02,083208,Staff,3,0,30,27
1649996666798,MATH 10B,B01,083739,Staff,20,0,30,10
1649996666798,MATH 10B,B02,083740,Staff,30,0,30,0
1649996672838,MATH 18,A01,083743,Staff,13,0,30,17
1649996672838,MATH 18,A02,083744,Staff,28,0,30,2
1649996672838,MATH 18,A03,083745,Staff,24,0,30,6
1649996672838,MATH 18,A04,083746,Staff,27,0,30,3
1649996672838,MATH 18,B01,083748,Staff,0,5,30,30
1649996672838,MATH 18,B02,083749,Staff,0,5,30,30
1649996672838,MATH 18,B03,083750,Staff,0,4,30,30
1649996672838,MATH 18,B04,083751,Staff,0,5,30,30
1649996678864,MATH 20A,A01,083754,Staff,28,0,40,12
1649996684915,MATH 20B,A01,083756,Staff,0,3,30,30
1649996684915,MATH 20B,A02,083757,Staff,10,0,30,20
1649996690941,MATH 20C,A01,083760,Staff,1,9,30,29
1649996690941,MATH 20C,A02,083761,Staff,0,8,30,30
1649996690941,MATH 20C,B01,083762,Staff,16,0,30,14
1649996690941,MATH 20C,B02,083763,Staff,30,0,30,0
1649996696968,MATH 20D,A01,083765,Staff,0,2,30,30
1649996696968,MATH 20D,A02,083766,Staff,17,0,30,13
1649996696968,MATH 20D,A03,083767,Staff,28,0,30,2
1649996703017,MATH 20E,A01,083771,Staff,11,0,30,19
1649996703017,MATH 20E,A02,083772,Staff,21,0,30,9
1649996703017,MATH 20E,B01,083773,Staff,0,0,30,30
1649996703017,MATH 20E,B02,083774,Staff,23,0,30,7
1649996709049,MATH 103A,A01,083777,Staff,1,5,30,29
1649996709049,MATH 103A,A02,083778,Staff,0,6,30,30
1649996709049,MATH 103A,B01,083779,Staff,0,6,30,30
1649996709049,MATH 103A,B02,083780,Staff,0,5,30,30
1649996715075,MATH 105,A01,085443,Staff,0,10,30,30
1649996721100,MATH 109,A01,083213,Anzaldo; Leesa B,0,3,30,30
1649996721100,MATH 109,A02,083214,Anzaldo; Leesa B,1,4,30,29
1649996721100,MATH 109,B01,083215,Anzaldo; Leesa B,1,3,30,29
1649996721100,MATH 109,B02,083216,Anzaldo; Leesa B,1,3,30,29
1649996727137,MATH 142A,A01,083219,Chow; Bennett,0,7,30,30
1649996727137,MATH 142A,A02,083220,Chow; Bennett,0,6,30,30
1649996727137,MATH 142A,B01,083221,Chow; Bennett,0,7,30,30
1649996727137,MATH 142A,B02,083222,Chow; Bennett,0,6,30,30
1649996733171,MATH 193A,A01,083224,Staff,0,6,30,30
1649996733171,MATH 193A,A02,083225,Staff,0,4,30,30
1649996733171,MATH 193A,A03,083781,Staff,0,0,30,30
1649996733171,MATH 193A,A04,083782,Staff,10,0,30,20
1649996739193,MATH 197,001,091859,McAuley; Julian John,9999,0,9999,0
1649996745260,COGS 9,A01,083615,Staff,2,15,60,58
1649996751292,COGS 11,A01,083617,Boyle; Mary E. T.,27,0,40,13
1649996757316,COGS 13,A01,083071,Staff,1,28,40,39
1649996763343,COGS 14A,A01,092681,Staff,0,3,100,100
1649996769371,COGS 14B,A01,083073,Cheng; Tzu-Han,0,0,50,50
1649996775400,COGS 17,A01,092677,Staff,39,0,75,36
1649996781444,COGS 100,A01,083619,Staff,1,17,60,59
1649996787482,COGS 101A,A01,083621,Davis; Joshua Daniel,0,17,60,60
1649996793509,COGS 101B,A01,091572,Staff,17,0,60,43
1649996799533,COGS 101C,A01,083625,Delgado; Tania,21,0,30,9
1649996805560,COGS 107A,A01,083627,Boyle; Mary E. T.,0,1,60,60
1649996811584,COGS 118A,A01,083075,Staff,20,0,60,40
1649996817637,CSE 3,A50,083646,Miranda; Gregory Joseph,22,0,38,16
1649996817637,CSE 3,A51,083647,Miranda; Gregory Joseph,37,0,37,0
1649996823675,CSE 8A,A50,083650,Miranda; Gregory Joseph,2,15,40,38
1649996829705,CSE 11,A01,083080,Cao; Yingjun,0,56,40,40
1649996835729,CSE 12,A01,083652,Staff,8,0,100,92
1649996841756,CSE 15L,A01,083654,Staff,1,0,50,49
1649996841756,CSE 15L,A02,083655,Staff,19,0,50,31
1649996847781,CSE 20,A01,083657,Staff,57,0,80,23
1649996853804,CSE 30,A01,083084,Eldon; John,0,60,40,40
1649996859836,CSE 100,A01,083659,Cao; Yingjun,1,55,50,49
1649996865863,CSE 134B,A01,083661,Powell; Thomas Allan,1,26,65,64
1649996871887,CSE 140,A01,083663,Staff,9,0,75,66
1649996877911,CSE 140L,A01,083088,Eldon; John,5,0,75,70
1649996883947,CSE 175,A01,083665,Kumar; Rakesh,10,0,25,15
1649996889971,CSE 190,A00,092507,Dubnov; Shlomo,17,0,20,3
1649996895993,ECE 45,A01,083139,Staff,0,7,40,40
1649996902020,ECE 65,A50,083695,Staff,1,0,30,29
1649996908044,ECE 109,A01,091882,Touri; Behrouz,49,0,70,21
1649996914068,ECE 180,A00,083140,Abi Samra; Nicholas Camill,26,0,30,4
1649996914068,ECE 180,B00,083141,Abi Samra; Nicholas Camill,10,0,30,20
1649996920118,MATH 10A,A01,083735,Patchell; Gregory David,14,0,30,16
1649996920118,MATH 10A,A02,083736,Patchell; Gregory David,28,0,30,2
1649996920118,MATH 10A,A03,083737,Patchell; Gregory David,27,0,30,3
1649996926146,MATH 10B,A01,083207,Staff,0,2,30,30
1649996926146,MATH 10B,A02,083208,Staff,3,0,30,27
1649996926146,MATH 10B,B01,083739,Staff,20,0,30,10
1649996926146,MATH 10B,B02,083740,Staff,30,0,30,0
1649996932171,MATH 18,A01,083743,Staff,13,0,30,17
1649996932171,MATH 18,A02,083744,Staff,28,0,30,2
1649996932171,MATH 18,A03,083745,Staff,24,0,30,6
1649996932171,MATH 18,A04,083746,Staff,27,0,30,3
1649996932171,MATH 18,B01,083748,Staff,0,5,30,30
1649996932171,MATH 18,B02,083749,Staff,0,5,30,30
1649996932171,MATH 18,B03,083750,Staff,0,4,30,30
1649996932171,MATH 18,B04,083751,Staff,0,5,30,30
1649996938201,MATH 20A,A01,083754,Staff,28,0,40,12
1649996944223,MATH 20B,A01,083756,Staff,0,3,30,30
1649996944223,MATH 20B,A02,083757,Staff,10,0,30,20
1649996950250,MATH 20C,A01,083760,Staff,1,9,30,29
1649996950250,MATH 20C,A02,083761,Staff,0,8,30,30
1649996950250,MATH 20C,B01,083762,Staff,16,0,30,14
1649996950250,MATH 20C,B02,083763,Staff,30,0,30,0
1649996956284,MATH 20D,A01,083765,Staff,0,2,30,30
1649996956284,MATH 20D,A02,083766,Staff,17,0,30,13
1649996956284,MATH 20D,A03,083767,Staff,28,0,30,2
1649996962308,MATH 20E,A01,083771,Staff,11,0,30,19
1649996962308,MATH 20E,A02,083772,Staff,21,0,30,9
1649996962308,MATH 20E,B01,083773,Staff,0,0,30,30
1649996962308,MATH 20E,B02,083774,Staff,23,0,30,7
1649996968333,MATH 103A,A01,083777,Staff,1,5,30,29
1649996968333,MATH 103A,A02,083778,Staff,0,6,30,30
1649996968333,MATH 103A,B01,083779,Staff,0,6,30,30
1649996968333,MATH 103A,B02,083780,Staff,0,5,30,30
1649996974356,MATH 105,A01,085443,Staff,0,10,30,30
1649996980385,MATH 109,A01,083213,Anzaldo; Leesa B,0,3,30,30
1649996980385,MATH 109,A02,083214,Anzaldo; Leesa B,1,4,30,29
1649996980385,MATH 109,B01,083215,Anzaldo; Leesa B,1,3,30,29
1649996980385,MATH 109,B02,083216,Anzaldo; Leesa B,1,3,30,29
1649996986413,MATH 142A,A01,083219,Chow; Bennett,0,7,30,30
1649996986413,MATH 142A,A02,083220,Chow; Bennett,0,6,30,30
1649996986413,MATH 142A,B01,083221,Chow; Bennett,0,7,30,30
1649996986413,MATH 142A,B02,083222,Chow; Bennett,0,6,30,30
1649996992443,MATH 193A,A01,083224,Staff,0,6,30,30
1649996992443,MATH 193A,A02,083225,Staff,0,4,30,30
1649996992443,MATH 193A,A03,083781,Staff,0,0,30,30
1649996992443,MATH 193A,A04,083782,Staff,10,0,30,20
1649996998474,MATH 197,001,091859,McAuley; Julian John,9999,0,9999,0
1649997004538,COGS 9,A01,083615,Staff,2,15,60,58
1649997010564,COGS 11,A01,083617,Boyle; Mary E. T.,27,0,40,13
1649997016599,COGS 13,A01,083071,Staff,1,28,40,39
1649997022628,COGS 14A,A01,092681,Staff,0,3,100,100
1649997028654,COGS 14B,A01,083073,Cheng; Tzu-Han,0,0,50,50
1649997034681,COGS 17,A01,092677,Staff,39,0,75,36
1649997040707,COGS 100,A01,083619,Staff,1,17,60,59
1649997046732,COGS 101A,A01,083621,Davis; Joshua Daniel,0,17,60,60
1649997052756,COGS 101B,A01,091572,Staff,17,0,60,43
1649997058782,COGS 101C,A01,083625,Delgado; Tania,21,0,30,9
1649997064806,COGS 107A,A01,083627,Boyle; Mary E. T.,0,1,60,60
1649997070829,COGS 118A,A01,083075,Staff,20,0,60,40
1649997076852,CSE 3,A50,083646,Miranda; Gregory Joseph,22,0,38,16
1649997076852,CSE 3,A51,083647,Miranda; Gregory Joseph,37,0,37,0
1649997082876,CSE 8A,A50,083650,Miranda; Gregory Joseph,2,15,40,38
1649997088905,CSE 11,A01,083080,Cao; Yingjun,0,57,40,40
1649997095042,CSE 12,A01,083652,Staff,7,0,100,93
1649997101066,CSE 15L,A01,083654,Staff,0,0,50,50
1649997101066,CSE 15L,A02,083655,Staff,19,0,50,31
1649997107093,CSE 20,A01,083657,Staff,57,0,80,23
1649997113132,CSE 30,A01,083084,Eldon; John,0,60,40,40
1649997119162,CSE 100,A01,083659,Cao; Yingjun,1,55,50,49
1649997125184,CSE 134B,A01,083661,Powell; Thomas Allan,1,26,65,64
1649997131207,CSE 140,A01,083663,Staff,9,0,75,66
1649997137231,CSE 140L,A01,083088,Eldon; John,5,0,75,70
1649997143268,CSE 175,A01,083665,Kumar; Rakesh,10,0,25,15
1649997149291,CSE 190,A00,092507,Dubnov; Shlomo,17,0,20,3
1649997155312,ECE 45,A01,083139,Staff,0,7,40,40
1649997161344,ECE 65,A50,083695,Staff,1,0,30,29
1649997167371,ECE 109,A01,091882,Touri; Behrouz,49,0,70,21
1649997173395,ECE 180,A00,083140,Abi Samra; Nicholas Camill,26,0,30,4
1649997173395,ECE 180,B00,083141,Abi Samra; Nicholas Camill,10,0,30,20
1649997179434,MATH 10A,A01,083735,Patchell; Gregory David,14,0,30,16
1649997179434,MATH 10A,A02,083736,Patchell; Gregory David,28,0,30,2
1649997179434,MATH 10A,A03,083737,Patchell; Gregory David,27,0,30,3
1649997185456,MATH 10B,A01,083207,Staff,0,2,30,30
1649997185456,MATH 10B,A02,083208,Staff,3,0,30,27
1649997185456,MATH 10B,B01,083739,Staff,20,0,30,10
1649997185456,MATH 10B,B02,083740,Staff,30,0,30,0
1649997191481,MATH 18,A01,083743,Staff,13,0,30,17
1649997191481,MATH 18,A02,083744,Staff,28,0,30,2
1649997191481,MATH 18,A03,083745,Staff,24,0,30,6
1649997191481,MATH 18,A04,083746,Staff,27,0,30,3
1649997191481,MATH 18,B01,083748,Staff,0,5,30,30
1649997191481,MATH 18,B02,083749,Staff,0,5,30,30
1649997191481,MATH 18,B03,083750,Staff,0,4,30,30
1649997191481,MATH 18,B04,083751,Staff,0,5,30,30
1649997197512,MATH 20A,A01,083754,Staff,28,0,40,12
1649997203540,MATH 20B,A01,083756,Staff,0,3,30,30
1649997203540,MATH 20B,A02,083757,Staff,9,0,30,21
1649997209563,MATH 20C,A01,083760,Staff,1,9,30,29
1649997209563,MATH 20C,A02,083761,Staff,0,8,30,30
1649997209563,MATH 20C,B01,083762,Staff,16,0,30,14
1649997209563,MATH 20C,B02,083763,Staff,30,0,30,0
1649997215590,MATH 20D,A01,083765,Staff,0,2,30,30
1649997215590,MATH 20D,A02,083766,Staff,17,0,30,13
1649997215590,MATH 20D,A03,083767,Staff,28,0,30,2
1649997221617,MATH 20E,A01,083771,Staff,11,0,30,19
1649997221617,MATH 20E,A02,083772,Staff,21,0,30,9
1649997221617,MATH 20E,B01,083773,Staff,0,0,30,30
1649997221617,MATH 20E,B02,083774,Staff,23,0,30,7
1649997227641,MATH 103A,A01,083777,Staff,1,6,30,29
1649997227641,MATH 103A,A02,083778,Staff,0,6,30,30
1649997227641,MATH 103A,B01,083779,Staff,0,6,30,30
1649997227641,MATH 103A,B02,083780,Staff,0,5,30,30
1649997233679,MATH 105,A01,085443,Staff,0,10,30,30
1649997239707,MATH 109,A01,083213,Anzaldo; Leesa B,0,3,30,30
1649997239707,MATH 109,A02,083214,Anzaldo; Leesa B,1,4,30,29
1649997239707,MATH 109,B01,083215,Anzaldo; Leesa B,1,3,30,29
1649997239707,MATH 109,B02,083216,Anzaldo; Leesa B,1,3,30,29
1649997245741,MATH 142A,A01,083219,Chow; Bennett,0,7,30,30
1649997245741,MATH 142A,A02,083220,Chow; Bennett,0,6,30,30
1649997245741,MATH 142A,B01,083221,Chow; Bennett,0,7,30,30
1649997245741,MATH 142A,B02,083222,Chow; Bennett,0,6,30,30
1649997251776,MATH 193A,A01,083224,Staff,0,6,30,30
1649997251776,MATH 193A,A02,083225,Staff,0,4,30,30
1649997251776,MATH 193A,A03,083781,Staff,0,0,30,30
1649997251776,MATH 193A,A04,083782,Staff,10,0,30,20
1649997257800,MATH 197,001,091859,McAuley; Julian John,9999,0,9999,0
1649997263865,COGS 9,A01,083615,Staff,2,15,60,58
1649997269895,COGS 11,A01,083617,Boyle; Mary E. T.,26,0,40,14
1649997275924,COGS 13,A01,083071,Staff,1,28,40,39
1649997281949,COGS 14A,A01,092681,Staff,0,3,100,100
1649997287987,COGS 14B,A01,083073,Cheng; Tzu-Han,0,0,50,50
1649997294023,COGS 17,A01,092677,Staff,39,0,75,36
1649997300046,COGS 100,A01,083619,Staff,1,17,60,59
1649997306083,COGS 101A,A01,083621,Davis; Joshua Daniel,0,17,60,60
1649997312129,COGS 101B,A01,091572,Staff,17,0,60,43
1649997318153,COGS 101C,A01,083625,Delgado; Tania,21,0,30,9
1649997324175,COGS 107A,A01,083627,Boyle; Mary E. T.,0,1,60,60
1649997330219,COGS 118A,A01,083075,Staff,20,0,60,40
1649997336242,CSE 3,A50,083646,Miranda; Gregory Joseph,22,0,38,16
1649997336242,CSE 3,A51,083647,Miranda; Gregory Joseph,37,0,37,0
1649997342284,CSE 8A,A50,083650,Miranda; Gregory Joseph,2,15,40,38
1649997348335,CSE 11,A01,083080,Cao; Yingjun,0,57,40,40
1649997354360,CSE 12,A01,083652,Staff,7,0,100,93
1649997360393,CSE 15L,A01,083654,Staff,0,0,50,50
1649997360393,CSE 15L,A02,083655,Staff,19,0,50,31
1649997366416,CSE 20,A01,083657,Staff,57,0,80,23
1649997372467,CSE 30,A01,083084,Eldon; John,0,60,40,40
1649997378494,CSE 100,A01,083659,Cao; Yingjun,1,55,50,49
1649997384543,CSE 134B,A01,083661,Powell; Thomas Allan,1,26,65,64
1649997390567,CSE 140,A01,083663,Staff,9,0,75,66
1649997396595,CSE 140L,A01,083088,Eldon; John,5,0,75,70
1649997402621,CSE 175,A01,083665,Kumar; Rakesh,10,0,25,15
1649997408654,CSE 190,A00,092507,Dubnov; Shlomo,17,0,20,3
1649997414680,ECE 45,A01,083139,Staff,0,8,40,40
1649997420705,ECE 65,A50,083695,Staff,0,0,30,30
1649997426736,ECE 109,A01,091882,Touri; Behrouz,49,0,70,21
1649997432767,ECE 180,A00,083140,Abi Samra; Nicholas Camill,26,0,30,4
1649997432767,ECE 180,B00,083141,Abi Samra; Nicholas Camill,10,0,30,20
1649997438795,MATH 10A,A01,083735,Patchell; Gregory David,14,0,30,16
1649997438795,MATH 10A,A02,083736,Patchell; Gregory David,28,0,30,2
1649997438795,MATH 10A,A03,083737,Patchell; Gregory David,27,0,30,3
1649997444818,MATH 10B,A01,083207,Staff,0,3,30,30
1649997444818,MATH 10B,A02,083208,Staff,3,0,30,27
1649997444818,MATH 10B,B01,083739,Staff,20,0,30,10
1649997444818,MATH 10B,B02,083740,Staff,30,0,30,0
1649997450847,MATH 18,A01,083743,Staff,13,0,30,17
1649997450847,MATH 18,A02,083744,Staff,28,0,30,2
1649997450847,MATH 18,A03,083745,Staff,23,0,30,7
1649997450847,MATH 18,A04,083746,Staff,27,0,30,3
1649997450847,MATH 18,B01,083748,Staff,0,5,30,30
1649997450847,MATH 18,B02,083749,Staff,0,5,30,30
1649997450847,MATH 18,B03,083750,Staff,0,4,30,30
1649997450847,MATH 18,B04,083751,Staff,0,5,30,30
1649997456876,MATH 20A,A01,083754,Staff,28,0,40,12
1649997462902,MATH 20B,A01,083756,Staff,0,3,30,30
1649997462902,MATH 20B,A02,083757,Staff,9,0,30,21
1649997468934,MATH 20C,A01,083760,Staff,1,9,30,29
1649997468934,MATH 20C,A02,083761,Staff,0,8,30,30
1649997468934,MATH 20C,B01,083762,Staff,16,0,30,14
1649997468934,MATH 20C,B02,083763,Staff,30,0,30,0
1649997474958,MATH 20D,A01,083765,Staff,0,2,30,30
1649997474958,MATH 20D,A02,083766,Staff,17,0,30,13
1649997474958,MATH 20D,A03,083767,Staff,28,0,30,2
1649997480982,MATH 20E,A01,083771,Staff,11,0,30,19
1649997480982,MATH 20E,A02,083772,Staff,21,0,30,9
1649997480982,MATH 20E,B01,083773,Staff,0,0,30,30
1649997480982,MATH 20E,B02,083774,Staff,22,0,30,8
1649997487009,MATH 103A,A01,083777,Staff,1,6,30,29
1649997487009,MATH 103A,A02,083778,Staff,0,6,30,30
1649997487009,MATH 103A,B01,083779,Staff,0,6,30,30
1649997487009,MATH 103A,B02,083780,Staff,0,5,30,30
1649997493032,MATH 105,A01,085443,Staff,0,10,30,30
1649997499070,MATH 109,A01,083213,Anzaldo; Leesa B,0,3,30,30
1649997499070,MATH 109,A02,083214,Anzaldo; Leesa B,1,4,30,29
1649997499070,MATH 109,B01,083215,Anzaldo; Leesa B,1,3,30,29
1649997499070,MATH 109,B02,083216,Anzaldo; Leesa B,1,3,30,29
1649997505134,MATH 142A,A01,083219,Chow; Bennett,0,7,30,30
1649997505134,MATH 142A,A02,083220,Chow; Bennett,0,6,30,30
1649997505134,MATH 142A,B01,083221,Chow; Bennett,0,7,30,30
1649997505134,MATH 142A,B02,083222,Chow; Bennett,0,6,30,30
1649997511161,MATH 193A,A01,083224,Staff,0,6,30,30
1649997511161,MATH 193A,A02,083225,Staff,0,4,30,30
1649997511161,MATH 193A,A03,083781,Staff,0,0,30,30
1649997511161,MATH 193A,A04,083782,Staff,10,0,30,20
1649997517183,MATH 197,001,091859,McAuley; Julian John,9999,0,9999,0
1649997523243,COGS 9,A01,083615,Staff,2,15,60,58
1649997529278,COGS 11,A01,083617,Boyle; Mary E. T.,26,0,40,14
1649997535301,COGS 13,A01,083071,Staff,1,28,40,39
1649997541344,COGS 14A,A01,092681,Staff,0,3,100,100
1649997547394,COGS 14B,A01,083073,Cheng; Tzu-Han,0,0,50,50
1649997553418,COGS 17,A01,092677,Staff,39,0,75,36
1649997559440,COGS 100,A01,083619,Staff,1,17,60,59
1649997565464,COGS 101A,A01,083621,Davis; Joshua Daniel,0,17,60,60
1649997571491,COGS 101B,A01,091572,Staff,17,0,60,43
1649997577516,COGS 101C,A01,083625,Delgado; Tania,21,0,30,9
1649997583544,COGS 107A,A01,083627,Boyle; Mary E. T.,0,1,60,60
1649997589567,COGS 118A,A01,083075,Staff,20,0,60,40
1649997595596,CSE 3,A50,083646,Miranda; Gregory Joseph,22,0,38,16
1649997595596,CSE 3,A51,083647,Miranda; Gregory Joseph,37,0,37,0
1649997601630,CSE 8A,A50,083650,Miranda; Gregory Joseph,2,15,40,38
1649997607662,CSE 11,A01,083080,Cao; Yingjun,0,57,40,40
1649997613694,CSE 12,A01,083652,Staff,7,0,100,93
1649997619741,CSE 15L,A01,083654,Staff,0,0,50,50
1649997619741,CSE 15L,A02,083655,Staff,19,0,50,31
1649997625767,CSE 20,A01,083657,Staff,57,0,80,23
1649997631791,CSE 30,A01,083084,Eldon; John,0,60,40,40
1649997637827,CSE 100,A01,083659,Cao; Yingjun,1,55,50,49
1649997643860,CSE 134B,A01,083661,Powell; Thomas Allan,1,26,65,64
1649997649887,CSE 140,A01,083663,Staff,9,0,75,66
1649997655927,CSE 140L,A01,083088,Eldon; John,5,0,75,70
1649997661951,CSE 175,A01,083665,Kumar; Rakesh,10,0,25,15
1649997667976,CSE 190,A00,092507,Dubnov; Shlomo,17,0,20,3
1649997674029,ECE 45,A01,083139,Staff,0,8,40,40
1649997680056,ECE 65,A50,083695,Staff,0,0,30,30
1649997686105,ECE 109,A01,091882,Touri; Behrouz,49,0,70,21
1649997692225,ECE 180,A00,083140,Abi Samra; Nicholas Camill,26,0,30,4
1649997692225,ECE 180,B00,083141,Abi Samra; Nicholas Camill,10,0,30,20
1649997698257,MATH 10A,A01,083735,Patchell; Gregory David,14,0,30,16
1649997698257,MATH 10A,A02,083736,Patchell; Gregory David,28,0,30,2
1649997698257,MATH 10A,A03,083737,Patchell; Gregory David,27,0,30,3
1649997704283,MATH 10B,A01,083207,Staff,0,3,30,30
1649997704283,MATH 10B,A02,083208,Staff,3,0,30,27
1649997704283,MATH 10B,B01,083739,Staff,20,0,30,10
1649997704283,MATH 10B,B02,083740,Staff,30,0,30,0
1649997710312,MATH 18,A01,083743,Staff,13,0,30,17
1649997710312,MATH 18,A02,083744,Staff,28,0,30,2
1649997710312,MATH 18,A03,083745,Staff,23,0,30,7
1649997710312,MATH 18,A04,083746,Staff,27,0,30,3
1649997710312,MATH 18,B01,083748,Staff,0,5,30,30
1649997710312,MATH 18,B02,083749,Staff,0,5,30,30
1649997710312,MATH 18,B03,083750,Staff,0,5,30,30
1649997710312,MATH 18,B04,083751,Staff,0,5,30,30
1649997716334,MATH 20A,A01,083754,Staff,28,0,40,12
1649997722378,MATH 20B,A01,083756,Staff,0,3,30,30
1649997722378,MATH 20B,A02,083757,Staff,9,0,30,21
1649997728409,MATH 20C,A01,083760,Staff,1,9,30,29
1649997728409,MATH 20C,A02,083761,Staff,0,8,30,30
1649997728409,MATH 20C,B01,083762,Staff,16,0,30,14
1649997728409,MATH 20C,B02,083763,Staff,30,0,30,0
1649997734432,MATH 20D,A01,083765,Staff,0,2,30,30
1649997734432,MATH 20D,A02,083766,Staff,17,0,30,13
1649997734432,MATH 20D,A03,083767,Staff,28,0,30,2
1649997740466,MATH 20E,A01,083771,Staff,11,0,30,19
1649997740466,MATH 20E,A02,083772,Staff,21,0,30,9
1649997740466,MATH 20E,B01,083773,Staff,0,0,30,30
1649997740466,MATH 20E,B02,083774,Staff,22,0,30,8
1649997746490,MATH 103A,A01,083777,Staff,1,6,30,29
1649997746490,MATH 103A,A02,083778,Staff,0,6,30,30
1649997746490,MATH 103A,B01,083779,Staff,0,6,30,30
1649997746490,MATH 103A,B02,083780,Staff,0,5,30,30
1649997752517,MATH 105,A01,085443,Staff,0,10,30,30
1649997758549,MATH 109,A01,083213,Anzaldo; Leesa B,0,3,30,30
1649997758549,MATH 109,A02,083214,Anzaldo; Leesa B,1,4,30,29
1649997758549,MATH 109,B01,083215,Anzaldo; Leesa B,1,3,30,29
1649997758549,MATH 109,B02,083216,Anzaldo; Leesa B,1,3,30,29
1649997764573,MATH 142A,A01,083219,Chow; Bennett,0,7,30,30
1649997764573,MATH 142A,A02,083220,Chow; Bennett,0,6,30,30
1649997764573,MATH 142A,B01,083221,Chow; Bennett,0,7,30,30
1649997764573,MATH 142A,B02,083222,Chow; Bennett,0,6,30,30
1649997770596,MATH 193A,A01,083224,Staff,0,6,30,30
1649997770596,MATH 193A,A02,083225,Staff,0,4,30,30
1649997770596,MATH 193A,A03,083781,Staff,0,0,30,30
1649997770596,MATH 193A,A04,083782,Staff,10,0,30,20
1649997776617,MATH 197,001,091859,McAuley; Julian John,9999,0,9999,0
1649997782736,COGS 9,A01,083615,Staff,2,15,60,58
1649997788779,COGS 11,A01,083617,Boyle; Mary E. T.,26,0,40,14
1649997794810,COGS 13,A01,083071,Staff,1,28,40,39
1649997800839,COGS 14A,A01,092681,Staff,0,3,100,100
1649997806862,COGS 14B,A01,083073,Cheng; Tzu-Han,0,0,50,50
1649997812888,COGS 17,A01,092677,Staff,39,0,75,36
1649997818925,COGS 100,A01,083619,Staff,1,17,60,59
1649997824956,COGS 101A,A01,083621,Davis; Joshua Daniel,0,17,60,60
1649997831001,COGS 101B,A01,091572,Staff,17,0,60,43
1649997837026,COGS 101C,A01,083625,Delgado; Tania,21,0,30,9
1649997843076,COGS 107A,A01,083627,Boyle; Mary E. T.,0,1,60,60
1649997849104,COGS 118A,A01,083075,Staff,20,0,60,40
1649997855139,CSE 3,A50,083646,Miranda; Gregory Joseph,22,0,38,16
1649997855139,CSE 3,A51,083647,Miranda; Gregory Joseph,37,0,37,0
1649997861166,CSE 8A,A50,083650,Miranda; Gregory Joseph,2,15,40,38
1649997867215,CSE 11,A01,083080,Cao; Yingjun,0,57,40,40
1649997873238,CSE 12,A01,083652,Staff,7,0,100,93
1649997879261,CSE 15L,A01,083654,Staff,0,0,50,50
1649997879261,CSE 15L,A02,083655,Staff,19,0,50,31
1649997885301,CSE 20,A01,083657,Staff,57,0,80,23
1649997891328,CSE 30,A01,083084,Eldon; John,0,60,40,40
1649997897359,CSE 100,A01,083659,Cao; Yingjun,1,55,50,49
1649997903389,CSE 134B,A01,083661,Powell; Thomas Allan,1,26,65,64
1649997909416,CSE 140,A01,083663,Staff,9,0,75,66
1649997915440,CSE 140L,A01,083088,Eldon; John,5,0,75,70
1649997921472,CSE 175,A01,083665,Kumar; Rakesh,10,0,25,15
1649997927505,CSE 190,A00,092507,Dubnov; Shlomo,17,0,20,3
1649997933556,ECE 45,A01,083139,Staff,0,8,40,40
1649997939582,ECE 65,A50,083695,Staff,0,0,30,30
1649997945605,ECE 109,A01,091882,Touri; Behrouz,49,0,70,21
1649997951629,ECE 180,A00,083140,Abi Samra; Nicholas Camill,26,0,30,4
1649997951629,ECE 180,B00,083141,Abi Samra; Nicholas Camill,10,0,30,20
1649997957664,MATH 10A,A01,083735,Patchell; Gregory David,14,0,30,16
1649997957664,MATH 10A,A02,083736,Patchell; Gregory David,28,0,30,2
1649997957664,MATH 10A,A03,083737,Patchell; Gregory David,27,0,30,3
1649997963688,MATH 10B,A01,083207,Staff,0,3,30,30
1649997963688,MATH 10B,A02,083208,Staff,3,0,30,27
1649997963688,MATH 10B,B01,083739,Staff,20,0,30,10
1649997963688,MATH 10B,B02,083740,Staff,30,0,30,0
1649997969721,MATH 18,A01,083743,Staff,13,0,30,17
1649997969721,MATH 18,A02,083744,Staff,28,0,30,2
1649997969721,MATH 18,A03,083745,Staff,23,0,30,7
1649997969721,MATH 18,A04,083746,Staff,27,0,30,3
1649997969721,MATH 18,B01,083748,Staff,0,5,30,30
1649997969721,MATH 18,B02,083749,Staff,0,5,30,30
1649997969721,MATH 18,B03,083750,Staff,0,6,30,30
1649997969721,MATH 18,B04,083751,Staff,0,5,30,30
1649997975745,MATH 20A,A01,083754,Staff,28,0,40,12
1649997981776,MATH 20B,A01,083756,Staff,0,3,30,30
1649997981776,MATH 20B,A02,083757,Staff,9,0,30,21
1649997987813,MATH 20C,A01,083760,Staff,1,9,30,29
1649997987813,MATH 20C,A02,083761,Staff,0,8,30,30
1649997987813,MATH 20C,B01,083762,Staff,16,0,30,14
1649997987813,MATH 20C,B02,083763,Staff,30,0,30,0
1649997993847,MATH 20D,A01,083765,Staff,0,2,30,30
1649997993847,MATH 20D,A02,083766,Staff,17,0,30,13
1649997993847,MATH 20D,A03,083767,Staff,28,0,30,2
1649997999875,MATH 20E,A01,083771,Staff,11,0,30,19
1649997999875,MATH 20E,A02,083772,Staff,20,0,30,10
1649997999875,MATH 20E,B01,083773,Staff,0,0,30,30
1649997999875,MATH 20E,B02,083774,Staff,22,0,30,8
1649998005906,MATH 103A,A01,083777,Staff,1,6,30,29
1649998005906,MATH 103A,A02,083778,Staff,0,7,30,30
1649998005906,MATH 103A,B01,083779,Staff,0,6,30,30
1649998005906,MATH 103A,B02,083780,Staff,0,5,30,30
1649998011933,MATH 105,A01,085443,Staff,0,10,30,30
1649998017957,MATH 109,A01,083213,Anzaldo; Leesa B,0,3,30,30
1649998017957,MATH 109,A02,083214,Anzaldo; Leesa B,1,4,30,29
1649998017957,MATH 109,B01,083215,Anzaldo; Leesa B,1,3,30,29
1649998017957,MATH 109,B02,083216,Anzaldo; Leesa B,1,3,30,29
1649998023984,MATH 142A,A01,083219,Chow; Bennett,0,7,30,30
1649998023984,MATH 142A,A02,083220,Chow; Bennett,0,6,30,30
1649998023984,MATH 142A,B01,083221,Chow; Bennett,0,7,30,30
1649998023984,MATH 142A,B02,083222,Chow; Bennett,0,6,30,30
1649998030008,MATH 193A,A01,083224,Staff,0,6,30,30
1649998030008,MATH 193A,A02,083225,Staff,0,4,30,30
1649998030008,MATH 193A,A03,083781,Staff,0,0,30,30
1649998030008,MATH 193A,A04,083782,Staff,10,0,30,20
1649998036044,MATH 197,001,091859,McAuley; Julian John,9999,0,9999,0
1649998042095,COGS 9,A01,083615,Staff,2,15,60,58
1649998048117,COGS 11,A01,083617,Boyle; Mary E. T.,26,0,40,14
1649998054155,COGS 13,A01,083071,Staff,1,28,40,39
1649998060185,COGS 14A,A01,092681,Staff,0,3,100,100
1649998066210,COGS 14B,A01,083073,Cheng; Tzu-Han,0,1,50,50
1649998072246,COGS 17,A01,092677,Staff,38,0,75,37
1649998078270,COGS 100,A01,083619,Staff,1,17,60,59
1649998084297,COGS 101A,A01,083621,Davis; Joshua Daniel,0,17,60,60
1649998090332,COGS 101B,A01,091572,Staff,17,0,60,43
1649998096368,COGS 101C,A01,083625,Delgado; Tania,21,0,30,9
1649998102397,COGS 107A,A01,083627,Boyle; Mary E. T.,0,1,60,60
1649998108420,COGS 118A,A01,083075,Staff,19,0,60,41
1649998114449,CSE 3,A50,083646,Miranda; Gregory Joseph,22,0,38,16
1649998114449,CSE 3,A51,083647,Miranda; Gregory Joseph,37,0,37,0
1649998120475,CSE 8A,A50,083650,Miranda; Gregory Joseph,2,15,40,38
1649998126503,CSE 11,A01,083080,Cao; Yingjun,0,57,40,40
1649998132531,CSE 12,A01,083652,Staff,7,0,100,93
1649998138572,CSE 15L,A01,083654,Staff,0,0,50,50
1649998138572,CSE 15L,A02,083655,Staff,19,0,50,31
1649998144595,CSE 20,A01,083657,Staff,57,0,80,23
1649998150639,CSE 30,A01,083084,Eldon; John,0,60,40,40
1649998156671,CSE 100,A01,083659,Cao; Yingjun,1,56,50,49
1649998162713,CSE 134B,A01,083661,Powell; Thomas Allan,1,26,65,64
1649998168751,CSE 140,A01,083663,Staff,9,0,75,66
1649998174774,CSE 140L,A01,083088,Eldon; John,5,0,75,70
1649998180800,CSE 175,A01,083665,Kumar; Rakesh,10,0,25,15
1649998186827,CSE 190,A00,092507,Dubnov; Shlomo,17,0,20,3
1649998192857,ECE 45,A01,083139,Staff,0,8,40,40
1649998198884,ECE 65,A50,083695,Staff,0,0,30,30
1649998204915,ECE 109,A01,091882,Touri; Behrouz,49,0,70,21
1649998210937,ECE 180,A00,083140,Abi Samra; Nicholas Camill,26,0,30,4
1649998210937,ECE 180,B00,083141,Abi Samra; Nicholas Camill,10,0,30,20
1649998216964,MATH 10A,A01,083735,Patchell; Gregory David,14,0,30,16
1649998216964,MATH 10A,A02,083736,Patchell; Gregory David,28,0,30,2
1649998216964,MATH 10A,A03,083737,Patchell; Gregory David,27,0,30,3
1649998222998,MATH 10B,A01,083207,Staff,0,3,30,30
1649998222998,MATH 10B,A02,083208,Staff,3,0,30,27
1649998222998,MATH 10B,B01,083739,Staff,20,0,30,10
1649998222998,MATH 10B,B02,083740,Staff,30,0,30,0
1649998229033,MATH 18,A01,083743,Staff,12,0,30,18
1649998229033,MATH 18,A02,083744,Staff,28,0,30,2
1649998229033,MATH 18,A03,083745,Staff,23,0,30,7
1649998229033,MATH 18,A04,083746,Staff,27,0,30,3
1649998229033,MATH 18,B01,083748,Staff,0,5,30,30
1649998229033,MATH 18,B02,083749,Staff,0,5,30,30
1649998229033,MATH 18,B03,083750,Staff,0,6,30,30
1649998229033,MATH 18,B04,083751,Staff,0,5,30,30
1649998235067,MATH 20A,A01,083754,Staff,28,0,40,12
1649998241107,MATH 20B,A01,083756,Staff,0,3,30,30
1649998241107,MATH 20B,A02,083757,Staff,9,0,30,21
1649998247133,MATH 20C,A01,083760,Staff,1,9,30,29
1649998247133,MATH 20C,A02,083761,Staff,0,8,30,30
1649998247133,MATH 20C,B01,083762,Staff,16,0,30,14
1649998247133,MATH 20C,B02,083763,Staff,30,0,30,0
1649998253155,MATH 20D,A01,083765,Staff,0,2,30,30
1649998253155,MATH 20D,A02,083766,Staff,17,0,30,13
1649998253155,MATH 20D,A03,083767,Staff,28,0,30,2
1649998259181,MATH 20E,A01,083771,Staff,11,0,30,19
1649998259181,MATH 20E,A02,083772,Staff,20,0,30,10
1649998259181,MATH 20E,B01,083773,Staff,0,0,30,30
1649998259181,MATH 20E,B02,083774,Staff,22,0,30,8
1649998265208,MATH 103A,A01,083777,Staff,1,6,30,29
1649998265208,MATH 103A,A02,083778,Staff,0,7,30,30
1649998265208,MATH 103A,B01,083779,Staff,0,6,30,30
1649998265208,MATH 103A,B02,083780,Staff,0,5,30,30
1649998271235,MATH 105,A01,085443,Staff,0,10,30,30
1649998277264,MATH 109,A01,083213,Anzaldo; Leesa B,0,3,30,30
1649998277264,MATH 109,A02,083214,Anzaldo; Leesa B,1,4,30,29
1649998277264,MATH 109,B01,083215,Anzaldo; Leesa B,1,3,30,29
1649998277264,MATH 109,B02,083216,Anzaldo; Leesa B,1,3,30,29
1649998283290,MATH 142A,A01,083219,Chow; Bennett,0,7,30,30
1649998283290,MATH 142A,A02,083220,Chow; Bennett,0,6,30,30
1649998283290,MATH 142A,B01,083221,Chow; Bennett,0,7,30,30
1649998283290,MATH 142A,B02,083222,Chow; Bennett,0,6,30,30
1649998289428,MATH 193A,A01,083224,Staff,0,6,30,30
1649998289428,MATH 193A,A02,083225,Staff,0,4,30,30
1649998289428,MATH 193A,A03,083781,Staff,0,0,30,30
1649998289428,MATH 193A,A04,083782,Staff,10,0,30,20
1649998295451,MATH 197,001,091859,McAuley; Julian John,9999,0,9999,0
1649998301506,COGS 9,A01,083615,Staff,2,15,60,58
1649998307555,COGS 11,A01,083617,Boyle; Mary E. T.,26,0,40,14
1649998313581,COGS 13,A01,083071,Staff,1,28,40,39
1649998319611,COGS 14A,A01,092681,Staff,0,3,100,100
1649998325646,COGS 14B,A01,083073,Cheng; Tzu-Han,0,1,50,50
1649998331669,COGS 17,A01,092677,Staff,38,0,75,37
1649998337718,COGS 100,A01,083619,Staff,1,17,60,59
1649998343752,COGS 101A,A01,083621,Davis; Joshua Daniel,0,17,60,60
1649998349776,COGS 101B,A01,091572,Staff,17,0,60,43
1649998355826,COGS 101C,A01,083625,Delgado; Tania,21,0,30,9
1649998361853,COGS 107A,A01,083627,Boyle; Mary E. T.,0,1,60,60
1649998367891,COGS 118A,A01,083075,Staff,19,0,60,41
1649998373914,CSE 3,A50,083646,Miranda; Gregory Joseph,22,0,38,16
1649998373914,CSE 3,A51,083647,Miranda; Gregory Joseph,37,0,37,0
1649998379939,CSE 8A,A50,083650,Miranda; Gregory Joseph,2,15,40,38
1649998385966,CSE 11,A01,083080,Cao; Yingjun,0,57,40,40
1649998391992,CSE 12,A01,083652,Staff,7,0,100,93
1649998398015,CSE 15L,A01,083654,Staff,0,0,50,50
1649998398015,CSE 15L,A02,083655,Staff,19,0,50,31
1649998404041,CSE 20,A01,083657,Staff,57,0,80,23
1649998410068,CSE 30,A01,083084,Eldon; John,0,60,40,40
1649998416113,CSE 100,A01,083659,Cao; Yingjun,1,56,50,49
1649998422138,CSE 134B,A01,083661,Powell; Thomas Allan,1,26,65,64
1649998428164,CSE 140,A01,083663,Staff,9,0,75,66
1649998434191,CSE 140L,A01,083088,Eldon; John,5,0,75,70
1649998440220,CSE 175,A01,083665,Kumar; Rakesh,10,0,25,15
1649998446244,CSE 190,A00,092507,Dubnov; Shlomo,17,0,20,3
1649998452271,ECE 45,A01,083139,Staff,0,8,40,40
1649998458313,ECE 65,A50,083695,Staff,0,0,30,30
1649998464337,ECE 109,A01,091882,Touri; Behrouz,49,0,70,21
1649998470369,ECE 180,A00,083140,Abi Samra; Nicholas Camill,26,0,30,4
1649998470369,ECE 180,B00,083141,Abi Samra; Nicholas Camill,10,0,30,20
1649998476392,MATH 10A,A01,083735,Patchell; Gregory David,14,0,30,16
1649998476392,MATH 10A,A02,083736,Patchell; Gregory David,28,0,30,2
1649998476392,MATH 10A,A03,083737,Patchell; Gregory David,27,0,30,3
1649998482417,MATH 10B,A01,083207,Staff,0,3,30,30
1649998482417,MATH 10B,A02,083208,Staff,2,0,30,28
1649998482417,MATH 10B,B01,083739,Staff,20,0,30,10
1649998482417,MATH 10B,B02,083740,Staff,30,0,30,0
1649998488441,MATH 18,A01,083743,Staff,12,0,30,18
1649998488441,MATH 18,A02,083744,Staff,28,0,30,2
1649998488441,MATH 18,A03,083745,Staff,23,0,30,7
1649998488441,MATH 18,A04,083746,Staff,27,0,30,3
1649998488441,MATH 18,B01,083748,Staff,0,5,30,30
1649998488441,MATH 18,B02,083749,Staff,0,5,30,30
1649998488441,MATH 18,B03,083750,Staff,0,6,30,30
1649998488441,MATH 18,B04,083751,Staff,0,5,30,30
1649998494466,MATH 20A,A01,083754,Staff,28,0,40,12
1649998500491,MATH 20B,A01,083756,Staff,0,3,30,30
1649998500491,MATH 20B,A02,083757,Staff,9,0,30,21
1649998506519,MATH 20C,A01,083760,Staff,1,9,30,29
1649998506519,MATH 20C,A02,083761,Staff,0,8,30,30
1649998506519,MATH 20C,B01,083762,Staff,16,0,30,14
1649998506519,MATH 20C,B02,083763,Staff,30,0,30,0
1649998512552,MATH 20D,A01,083765,Staff,0,2,30,30
1649998512552,MATH 20D,A02,083766,Staff,17,0,30,13
1649998512552,MATH 20D,A03,083767,Staff,28,0,30,2
1649998518576,MATH 20E,A01,083771,Staff,11,0,30,19
1649998518576,MATH 20E,A02,083772,Staff,20,0,30,10
1649998518576,MATH 20E,B01,083773,Staff,0,0,30,30
1649998518576,MATH 20E,B02,083774,Staff,22,0,30,8
1649998524625,MATH 103A,A01,083777,Staff,1,6,30,29
1649998524625,MATH 103A,A02,083778,Staff,0,7,30,30
1649998524625,MATH 103A,B01,083779,Staff,0,6,30,30
1649998524625,MATH 103A,B02,083780,Staff,0,5,30,30
1649998530651,MATH 105,A01,085443,Staff,0,10,30,30
1649998536674,MATH 109,A01,083213,Anzaldo; Leesa B,0,3,30,30
1649998536674,MATH 109,A02,083214,Anzaldo; Leesa B,1,4,30,29
1649998536674,MATH 109,B01,083215,Anzaldo; Leesa B,1,3,30,29
1649998536674,MATH 109,B02,083216,Anzaldo; Leesa B,1,3,30,29
1649998542708,MATH 142A,A01,083219,Chow; Bennett,0,7,30,30
1649998542708,MATH 142A,A02,083220,Chow; Bennett,0,6,30,30
1649998542708,MATH 142A,B01,083221,Chow; Bennett,0,7,30,30
1649998542708,MATH 142A,B02,083222,Chow; Bennett,0,6,30,30
1649998548736,MATH 193A,A01,083224,Staff,0,6,30,30
1649998548736,MATH 193A,A02,083225,Staff,0,4,30,30
1649998548736,MATH 193A,A03,083781,Staff,0,0,30,30
1649998548736,MATH 193A,A04,083782,Staff,10,0,30,20
1649998554759,MATH 197,001,091859,McAuley; Julian John,9999,0,9999,0
1649998560822,COGS 9,A01,083615,Staff,2,15,60,58
1649998566846,COGS 11,A01,083617,Boyle; Mary E. T.,26,0,40,14
1649998572870,COGS 13,A01,083071,Staff,1,28,40,39
1649998578893,COGS 14A,A01,092681,Staff,0,3,100,100
1649998584926,COGS 14B,A01,083073,Cheng; Tzu-Han,0,1,50,50
1649998590954,COGS 17,A01,092677,Staff,37,0,75,38
1649998596982,COGS 100,A01,083619,Staff,1,17,60,59
1649998603009,COGS 101A,A01,083621,Davis; Joshua Daniel,0,17,60,60
1649998609034,COGS 101B,A01,091572,Staff,17,0,60,43
1649998615058,COGS 101C,A01,083625,Delgado; Tania,21,0,30,9
1649998621081,COGS 107A,A01,083627,Boyle; Mary E. T.,0,1,60,60
1649998627103,COGS 118A,A01,083075,Staff,19,0,60,41
1649998633149,CSE 3,A50,083646,Miranda; Gregory Joseph,22,0,38,16
1649998633149,CSE 3,A51,083647,Miranda; Gregory Joseph,37,0,37,0
1649998639176,CSE 8A,A50,083650,Miranda; Gregory Joseph,2,15,40,38
1649998645201,CSE 11,A01,083080,Cao; Yingjun,0,57,40,40
1649998651224,CSE 12,A01,083652,Staff,7,0,100,93
1649998657248,CSE 15L,A01,083654,Staff,0,0,50,50
1649998657248,CSE 15L,A02,083655,Staff,19,0,50,31
1649998663273,CSE 20,A01,083657,Staff,57,0,80,23
1649998669300,CSE 30,A01,083084,Eldon; John,0,60,40,40
1649998675346,CSE 100,A01,083659,Cao; Yingjun,1,56,50,49
1649998681380,CSE 134B,A01,083661,Powell; Thomas Allan,1,25,65,64
1649998687405,CSE 140,A01,083663,Staff,9,0,75,66
1649998693433,CSE 140L,A01,083088,Eldon; John,5,0,75,70
1649998699456,CSE 175,A01,083665,Kumar; Rakesh,10,0,25,15
1649998705480,CSE 190,A00,092507,Dubnov; Shlomo,17,0,20,3
1649998711504,ECE 45,A01,083139,Staff,0,8,40,40
1649998717531,ECE 65,A50,083695,Staff,0,0,30,30
1649998723558,ECE 109,A01,091882,Touri; Behrouz,49,0,70,21
1649998729582,ECE 180,A00,083140,Abi Samra; Nicholas Camill,26,0,30,4
1649998729582,ECE 180,B00,083141,Abi Samra; Nicholas Camill,10,0,30,20
1649998735609,MATH 10A,A01,083735,Patchell; Gregory David,14,0,30,16
1649998735609,MATH 10A,A02,083736,Patchell; Gregory David,28,0,30,2
1649998735609,MATH 10A,A03,083737,Patchell; Gregory David,27,0,30,3
1649998741638,MATH 10B,A01,083207,Staff,0,3,30,30
1649998741638,MATH 10B,A02,083208,Staff,2,0,30,28
1649998741638,MATH 10B,B01,083739,Staff,20,0,30,10
1649998741638,MATH 10B,B02,083740,Staff,30,0,30,0
1649998747663,MATH 18,A01,083743,Staff,12,0,30,18
1649998747663,MATH 18,A02,083744,Staff,28,0,30,2
1649998747663,MATH 18,A03,083745,Staff,23,0,30,7
1649998747663,MATH 18,A04,083746,Staff,27,0,30,3
1649998747663,MATH 18,B01,083748,Staff,0,5,30,30
1649998747663,MATH 18,B02,083749,Staff,0,5,30,30
1649998747663,MATH 18,B03,083750,Staff,0,6,30,30
1649998747663,MATH 18,B04,083751,Staff,0,5,30,30
1649998753685,MATH 20A,A01,083754,Staff,28,0,40,12
1649998759711,MATH 20B,A01,083756,Staff,0,3,30,30
1649998759711,MATH 20B,A02,083757,Staff,9,0,30,21
1649998765734,MATH 20C,A01,083760,Staff,1,10,30,29
1649998765734,MATH 20C,A02,083761,Staff,0,8,30,30
1649998765734,MATH 20C,B01,083762,Staff,16,0,30,14
1649998765734,MATH 20C,B02,083763,Staff,30,0,30,0
1649998771761,MATH 20D,A01,083765,Staff,0,2,30,30
1649998771761,MATH 20D,A02,083766,Staff,17,0,30,13
1649998771761,MATH 20D,A03,083767,Staff,28,0,30,2
1649998777786,MATH 20E,A01,083771,Staff,11,0,30,19
1649998777786,MATH 20E,A02,083772,Staff,20,0,30,10
1649998777786,MATH 20E,B01,083773,Staff,0,0,30,30
1649998777786,MATH 20E,B02,083774,Staff,22,0,30,8
1649998783811,MATH 103A,A01,083777,Staff,1,7,30,29
1649998783811,MATH 103A,A02,083778,Staff,0,7,30,30
1649998783811,MATH 103A,B01,083779,Staff,0,6,30,30
1649998783811,MATH 103A,B02,083780,Staff,0,5,30,30
1649998789835,MATH 105,A01,085443,Staff,0,10,30,30
1649998795860,MATH 109,A01,083213,Anzaldo; Leesa B,0,3,30,30
1649998795860,MATH 109,A02,083214,Anzaldo; Leesa B,1,4,30,29
1649998795860,MATH 109,B01,083215,Anzaldo; Leesa B,1,3,30,29
1649998795860,MATH 109,B02,083216,Anzaldo; Leesa B,1,3,30,29
1649998801887,MATH 142A,A01,083219,Chow; Bennett,0,8,30,30
1649998801887,MATH 142A,A02,083220,Chow; Bennett,0,6,30,30
1649998801887,MATH 142A,B01,083221,Chow; Bennett,0,7,30,30
1649998801887,MATH 142A,B02,083222,Chow; Bennett,0,6,30,30
1649998807925,MATH 193A,A01,083224,Staff,0,6,30,30
1649998807925,MATH 193A,A02,083225,Staff,0,4,30,30
1649998807925,MATH 193A,A03,083781,Staff,0,0,30,30
1649998807925,MATH 193A,A04,083782,Staff,10,0,30,20
1649998813958,MATH 197,001,091859,McAuley; Julian John,9999,0,9999,0
1649998820018,COGS 9,A01,083615,Staff,2,15,60,58
1649998826049,COGS 11,A01,083617,Boyle; Mary E. T.,26,0,40,14
1649998832081,COGS 13,A01,083071,Staff,1,28,40,39
1649998838105,COGS 14A,A01,092681,Staff,0,3,100,100
1649998844130,COGS 14B,A01,083073,Cheng; Tzu-Han,0,1,50,50
1649998850162,COGS 17,A01,092677,Staff,37,0,75,38
1649998856186,COGS 100,A01,083619,Staff,1,17,60,59
1649998862212,COGS 101A,A01,083621,Davis; Joshua Daniel,0,17,60,60
1649998868246,COGS 101B,A01,091572,Staff,17,0,60,43
1649998874283,COGS 101C,A01,083625,Delgado; Tania,21,0,30,9
1649998880395,COGS 107A,A01,083627,Boyle; Mary E. T.,0,1,60,60
1649998886417,COGS 118A,A01,083075,Staff,19,0,60,41
1649998892439,CSE 3,A50,083646,Miranda; Gregory Joseph,22,0,38,16
1649998892439,CSE 3,A51,083647,Miranda; Gregory Joseph,37,0,37,0
1649998898462,CSE 8A,A50,083650,Miranda; Gregory Joseph,2,15,40,38
1649998904489,CSE 11,A01,083080,Cao; Yingjun,0,57,40,40
1649998910525,CSE 12,A01,083652,Staff,7,0,100,93
1649998916552,CSE 15L,A01,083654,Staff,0,0,50,50
1649998916552,CSE 15L,A02,083655,Staff,19,0,50,31
1649998922577,CSE 20,A01,083657,Staff,57,0,80,23
1649998928606,CSE 30,A01,083084,Eldon; John,0,60,40,40
1649998934640,CSE 100,A01,083659,Cao; Yingjun,1,56,50,49
1649998940664,CSE 134B,A01,083661,Powell; Thomas Allan,1,25,65,64
1649998946691,CSE 140,A01,083663,Staff,9,0,75,66
1649998952715,CSE 140L,A01,083088,Eldon; John,5,0,75,70
1649998958741,CSE 175,A01,083665,Kumar; Rakesh,10,0,25,15
1649998964765,CSE 190,A00,092507,Dubnov; Shlomo,17,0,20,3
1649998970798,ECE 45,A01,083139,Staff,0,8,40,40
1649998976822,ECE 65,A50,083695,Staff,0,0,30,30
1649998982846,ECE 109,A01,091882,Touri; Behrouz,49,0,70,21
1649998988870,ECE 180,A00,083140,Abi Samra; Nicholas Camill,26,0,30,4
1649998988870,ECE 180,B00,083141,Abi Samra; Nicholas Camill,10,0,30,20
1649998994894,MATH 10A,A01,083735,Patchell; Gregory David,14,0,30,16
1649998994894,MATH 10A,A02,083736,Patchell; Gregory David,28,0,30,2
1649998994894,MATH 10A,A03,083737,Patchell; Gregory David,27,0,30,3
1649999000918,MATH 10B,A01,083207,Staff,0,3,30,30
1649999000918,MATH 10B,A02,083208,Staff,2,0,30,28
1649999000918,MATH 10B,B01,083739,Staff,20,0,30,10
1649999000918,MATH 10B,B02,083740,Staff,30,0,30,0
1649999006943,MATH 18,A01,083743,Staff,12,0,30,18
1649999006943,MATH 18,A02,083744,Staff,28,0,30,2
1649999006943,MATH 18,A03,083745,Staff,23,0,30,7
1649999006943,MATH 18,A04,083746,Staff,27,0,30,3
1649999006943,MATH 18,B01,083748,Staff,0,5,30,30
1649999006943,MATH 18,B02,083749,Staff,0,5,30,30
1649999006943,MATH 18,B03,083750,Staff,0,6,30,30
1649999006943,MATH 18,B04,083751,Staff,0,5,30,30
1649999012982,MATH 20A,A01,083754,Staff,28,0,40,12
1649999019006,MATH 20B,A01,083756,Staff,0,3,30,30
1649999019006,MATH 20B,A02,083757,Staff,9,0,30,21
1649999025055,MATH 20C,A01,083760,Staff,1,10,30,29
1649999025055,MATH 20C,A02,083761,Staff,0,9,30,30
1649999025055,MATH 20C,B01,083762,Staff,16,0,30,14
1649999025055,MATH 20C,B02,083763,Staff,30,0,30,0
1649999031082,MATH 20D,A01,083765,Staff,0,2,30,30
1649999031082,MATH 20D,A02,083766,Staff,17,0,30,13
1649999031082,MATH 20D,A03,083767,Staff,28,0,30,2
1649999037105,MATH 20E,A01,083771,Staff,11,0,30,19
1649999037105,MATH 20E,A02,083772,Staff,20,0,30,10
1649999037105,MATH 20E,B01,083773,Staff,0,0,30,30
1649999037105,MATH 20E,B02,083774,Staff,22,0,30,8
1649999043133,MATH 103A,A01,083777,Staff,1,6,30,29
1649999043133,MATH 103A,A02,083778,Staff,0,8,30,30
1649999043133,MATH 103A,B01,083779,Staff,0,6,30,30
1649999043133,MATH 103A,B02,083780,Staff,0,5,30,30
1649999049155,MATH 105,A01,085443,Staff,0,11,30,30
1649999055179,MATH 109,A01,083213,Anzaldo; Leesa B,0,3,30,30
1649999055179,MATH 109,A02,083214,Anzaldo; Leesa B,1,4,30,29
1649999055179,MATH 109,B01,083215,Anzaldo; Leesa B,1,3,30,29
1649999055179,MATH 109,B02,083216,Anzaldo; Leesa B,1,3,30,29
1649999061204,MATH 142A,A01,083219,Chow; Bennett,0,8,30,30
1649999061204,MATH 142A,A02,083220,Chow; Bennett,0,6,30,30
1649999061204,MATH 142A,B01,083221,Chow; Bennett,0,7,30,30
1649999061204,MATH 142A,B02,083222,Chow; Bennett,0,6,30,30
1649999067228,MATH 193A,A01,083224,Staff,0,6,30,30
1649999067228,MATH 193A,A02,083225,Staff,0,4,30,30
1649999067228,MATH 193A,A03,083781,Staff,0,0,30,30
1649999067228,MATH 193A,A04,083782,Staff,10,0,30,20
1649999073267,MATH 197,001,091859,McAuley; Julian John,9999,0,9999,0
1649999079321,COGS 9,A01,083615,Staff,2,15,60,58
1649999085347,COGS 11,A01,083617,Boyle; Mary E. T.,26,0,40,14
1649999091368,COGS 13,A01,083071,Staff,1,28,40,39
1649999097393,COGS 14A,A01,092681,Staff,0,3,100,100
1649999103422,COGS 14B,A01,083073,Cheng; Tzu-Han,0,1,50,50
1649999109446,COGS 17,A01,092677,Staff,37,0,75,38
1649999115469,COGS 100,A01,083619,Staff,1,17,60,59
1649999121494,COGS 101A,A01,083621,Davis; Joshua Daniel,0,17,60,60
1649999127521,COGS 101B,A01,091572,Staff,17,0,60,43
1649999133556,COGS 101C,A01,083625,Delgado; Tania,21,0,30,9
1649999139580,COGS 107A,A01,083627,Boyle; Mary E. T.,0,1,60,60
1649999145607,COGS 118A,A01,083075,Staff,19,0,60,41
1649999151631,CSE 3,A50,083646,Miranda; Gregory Joseph,22,0,38,16
1649999151631,CSE 3,A51,083647,Miranda; Gregory Joseph,37,0,37,0
1649999157652,CSE 8A,A50,083650,Miranda; Gregory Joseph,2,15,40,38
1649999163676,CSE 11,A01,083080,Cao; Yingjun,0,57,40,40
1649999169702,CSE 12,A01,083652,Staff,7,0,100,93
1649999175729,CSE 15L,A01,083654,Staff,0,0,50,50
1649999175729,CSE 15L,A02,083655,Staff,19,0,50,31
1649999181752,CSE 20,A01,083657,Staff,57,0,80,23
1649999187781,CSE 30,A01,083084,Eldon; John,0,60,40,40
1649999193808,CSE 100,A01,083659,Cao; Yingjun,1,56,50,49
1649999199836,CSE 134B,A01,083661,Powell; Thomas Allan,1,25,65,64
1649999205862,CSE 140,A01,083663,Staff,9,0,75,66
1649999211888,CSE 140L,A01,083088,Eldon; John,5,0,75,70
1649999217915,CSE 175,A01,083665,Kumar; Rakesh,10,0,25,15
1649999223938,CSE 190,A00,092507,Dubnov; Shlomo,17,0,20,3
1649999229965,ECE 45,A01,083139,Staff,0,8,40,40
1649999235990,ECE 65,A50,083695,Staff,0,0,30,30
1649999242017,ECE 109,A01,091882,Touri; Behrouz,49,0,70,21
1649999248043,ECE 180,A00,083140,Abi Samra; Nicholas Camill,26,0,30,4
1649999248043,ECE 180,B00,083141,Abi Samra; Nicholas Camill,10,0,30,20
1649999254069,MATH 10A,A01,083735,Patchell; Gregory David,14,0,30,16
1649999254069,MATH 10A,A02,083736,Patchell; Gregory David,28,0,30,2
1649999254069,MATH 10A,A03,083737,Patchell; Gregory David,27,0,30,3
1649999260097,MATH 10B,A01,083207,Staff,0,4,30,30
1649999260097,MATH 10B,A02,083208,Staff,2,0,30,28
1649999260097,MATH 10B,B01,083739,Staff,20,0,30,10
1649999260097,MATH 10B,B02,083740,Staff,30,0,30,0
1649999266124,MATH 18,A01,083743,Staff,11,0,30,19
1649999266124,MATH 18,A02,083744,Staff,28,0,30,2
1649999266124,MATH 18,A03,083745,Staff,23,0,30,7
1649999266124,MATH 18,A04,083746,Staff,27,0,30,3
1649999266124,MATH 18,B01,083748,Staff,0,5,30,30
1649999266124,MATH 18,B02,083749,Staff,0,5,30,30
1649999266124,MATH 18,B03,083750,Staff,0,6,30,30
1649999266124,MATH 18,B04,083751,Staff,0,5,30,30
1649999272147,MATH 20A,A01,083754,Staff,28,0,40,12
1649999278175,MATH 20B,A01,083756,Staff,0,3,30,30
1649999278175,MATH 20B,A02,083757,Staff,8,0,30,22
1649999284200,MATH 20C,A01,083760,Staff,1,10,30,29
1649999284200,MATH 20C,A02,083761,Staff,0,9,30,30
1649999284200,MATH 20C,B01,083762,Staff,16,0,30,14
1649999284200,MATH 20C,B02,083763,Staff,30,0,30,0
1649999290226,MATH 20D,A01,083765,Staff,0,2,30,30
1649999290226,MATH 20D,A02,083766,Staff,17,0,30,13
1649999290226,MATH 20D,A03,083767,Staff,28,0,30,2
1649999296251,MATH 20E,A01,083771,Staff,11,0,30,19
1649999296251,MATH 20E,A02,083772,Staff,20,0,30,10
1649999296251,MATH 20E,B01,083773,Staff,0,0,30,30
1649999296251,MATH 20E,B02,083774,Staff,22,0,30,8
1649999302293,MATH 103A,A01,083777,Staff,1,6,30,29
1649999302293,MATH 103A,A02,083778,Staff,0,8,30,30
1649999302293,MATH 103A,B01,083779,Staff,0,6,30,30
1649999302293,MATH 103A,B02,083780,Staff,0,5,30,30
1649999308318,MATH 105,A01,085443,Staff,0,11,30,30
1649999314342,MATH 109,A01,083213,Anzaldo; Leesa B,0,3,30,30
1649999314342,MATH 109,A02,083214,Anzaldo; Leesa B,1,4,30,29
1649999314342,MATH 109,B01,083215,Anzaldo; Leesa B,1,3,30,29
1649999314342,MATH 109,B02,083216,Anzaldo; Leesa B,1,3,30,29
1649999320365,MATH 142A,A01,083219,Chow; Bennett,0,7,30,30
1649999320365,MATH 142A,A02,083220,Chow; Bennett,0,6,30,30
1649999320365,MATH 142A,B01,083221,Chow; Bennett,0,7,30,30
1649999320365,MATH 142A,B02,083222,Chow; Bennett,0,7,30,30
1649999326388,MATH 193A,A01,083224,Staff,0,6,30,30
1649999326388,MATH 193A,A02,083225,Staff,0,4,30,30
1649999326388,MATH 193A,A03,083781,Staff,0,0,30,30
1649999326388,MATH 193A,A04,083782,Staff,10,0,30,20
1649999332412,MATH 197,001,091859,McAuley; Julian John,9999,0,9999,0
1649999338463,COGS 9,A01,083615,Staff,2,15,60,58
1649999344491,COGS 11,A01,083617,Boyle; Mary E. T.,25,0,40,15
1649999350521,COGS 13,A01,083071,Staff,1,28,40,39
1649999356548,COGS 14A,A01,092681,Staff,0,3,100,100
1649999362572,COGS 14B,A01,083073,Cheng; Tzu-Han,0,1,50,50
1649999368598,COGS 17,A01,092677,Staff,36,0,75,39
1649999374622,COGS 100,A01,083619,Staff,1,17,60,59
1649999380650,COGS 101A,A01,083621,Davis; Joshua Daniel,0,17,60,60
1649999386677,COGS 101B,A01,091572,Staff,17,0,60,43
1649999392700,COGS 101C,A01,083625,Delgado; Tania,21,0,30,9
1649999398724,COGS 107A,A01,083627,Boyle; Mary E. T.,0,1,60,60
1649999404749,COGS 118A,A01,083075,Staff,19,0,60,41
1649999410774,CSE 3,A50,083646,Miranda; Gregory Joseph,22,0,38,16
1649999410774,CSE 3,A51,083647,Miranda; Gregory Joseph,37,0,37,0
1649999416800,CSE 8A,A50,083650,Miranda; Gregory Joseph,2,15,40,38
1649999422825,CSE 11,A01,083080,Cao; Yingjun,0,57,40,40
1649999428863,CSE 12,A01,083652,Staff,7,0,100,93
1649999434890,CSE 15L,A01,083654,Staff,0,0,50,50
1649999434890,CSE 15L,A02,083655,Staff,19,0,50,31
1649999440916,CSE 20,A01,083657,Staff,57,0,80,23
1649999446941,CSE 30,A01,083084,Eldon; John,0,60,40,40
1649999452965,CSE 100,A01,083659,Cao; Yingjun,1,56,50,49
1649999458989,CSE 134B,A01,083661,Powell; Thomas Allan,1,25,65,64
1649999465016,CSE 140,A01,083663,Staff,9,0,75,66
1649999471043,CSE 140L,A01,083088,Eldon; John,5,0,75,70
1649999477155,CSE 175,A01,083665,Kumar; Rakesh,10,0,25,15
1649999483178,CSE 190,A00,092507,Dubnov; Shlomo,17,0,20,3
1649999489200,ECE 45,A01,083139,Staff,0,8,40,40
1649999495224,ECE 65,A50,083695,Staff,0,0,30,30
1649999501253,ECE 109,A01,091882,Touri; Behrouz,49,0,70,21
1649999507284,ECE 180,A00,083140,Abi Samra; Nicholas Camill,26,0,30,4
1649999507284,ECE 180,B00,083141,Abi Samra; Nicholas Camill,10,0,30,20
1649999513314,MATH 10A,A01,083735,Patchell; Gregory David,14,0,30,16
1649999513314,MATH 10A,A02,083736,Patchell; Gregory David,28,0,30,2
1649999513314,MATH 10A,A03,083737,Patchell; Gregory David,27,0,30,3
1649999519340,MATH 10B,A01,083207,Staff,0,4,30,30
1649999519340,MATH 10B,A02,083208,Staff,2,0,30,28
1649999519340,MATH 10B,B01,083739,Staff,20,0,30,10
1649999519340,MATH 10B,B02,083740,Staff,30,0,30,0
1649999525368,MATH 18,A01,083743,Staff,11,0,30,19
1649999525368,MATH 18,A02,083744,Staff,28,0,30,2
1649999525368,MATH 18,A03,083745,Staff,23,0,30,7
1649999525368,MATH 18,A04,083746,Staff,27,0,30,3
1649999525368,MATH 18,B01,083748,Staff,0,5,30,30
1649999525368,MATH 18,B02,083749,Staff,0,5,30,30
1649999525368,MATH 18,B03,083750,Staff,0,6,30,30
1649999525368,MATH 18,B04,083751,Staff,0,5,30,30
1649999531394,MATH 20A,A01,083754,Staff,28,0,40,12
1649999537480,MATH 20B,A01,083756,Staff,0,3,30,30
1649999537480,MATH 20B,A02,083757,Staff,8,0,30,22
1649999543504,MATH 20C,A01,083760,Staff,1,10,30,29
1649999543504,MATH 20C,A02,083761,Staff,0,9,30,30
1649999543504,MATH 20C,B01,083762,Staff,16,0,30,14
1649999543504,MATH 20C,B02,083763,Staff,30,0,30,0
1649999549530,MATH 20D,A01,083765,Staff,0,2,30,30
1649999549530,MATH 20D,A02,083766,Staff,17,0,30,13
1649999549530,MATH 20D,A03,083767,Staff,28,0,30,2
1649999555558,MATH 20E,A01,083771,Staff,11,0,30,19
1649999555558,MATH 20E,A02,083772,Staff,20,0,30,10
1649999555558,MATH 20E,B01,083773,Staff,0,0,30,30
1649999555558,MATH 20E,B02,083774,Staff,22,0,30,8
1649999561583,MATH 103A,A01,083777,Staff,1,6,30,29
1649999561583,MATH 103A,A02,083778,Staff,0,7,30,30
1649999561583,MATH 103A,B01,083779,Staff,0,7,30,30
1649999561583,MATH 103A,B02,083780,Staff,0,5,30,30
1649999567606,MATH 105,A01,085443,Staff,0,11,30,30
1649999573630,MATH 109,A01,083213,Anzaldo; Leesa B,0,3,30,30
1649999573630,MATH 109,A02,083214,Anzaldo; Leesa B,1,4,30,29
1649999573630,MATH 109,B01,083215,Anzaldo; Leesa B,1,3,30,29
1649999573630,MATH 109,B02,083216,Anzaldo; Leesa B,1,3,30,29
1649999579660,MATH 142A,A01,083219,Chow; Bennett,0,7,30,30
1649999579660,MATH 142A,A02,083220,Chow; Bennett,0,6,30,30
1649999579660,MATH 142A,B01,083221,Chow; Bennett,0,7,30,30
1649999579660,MATH 142A,B02,083222,Chow; Bennett,0,7,30,30
1649999585686,MATH 193A,A01,083224,Staff,0,6,30,30
1649999585686,MATH 193A,A02,083225,Staff,0,4,30,30
1649999585686,MATH 193A,A03,083781,Staff,0,0,30,30
1649999585686,MATH 193A,A04,083782,Staff,10,0,30,20
1649999591710,MATH 197,001,091859,McAuley; Julian John,9999,0,9999,0
1649999597771,COGS 9,A01,083615,Staff,2,15,60,58
1649999603796,COGS 11,A01,083617,Boyle; Mary E. T.,25,0,40,15
1649999609822,COGS 13,A01,083071,Staff,1,28,40,39
1649999615849,COGS 14A,A01,092681,Staff,0,3,100,100
1649999621877,COGS 14B,A01,083073,Cheng; Tzu-Han,0,1,50,50
1649999627905,COGS 17,A01,092677,Staff,36,0,75,39
1649999633929,COGS 100,A01,083619,Staff,1,18,60,59
1649999639956,COGS 101A,A01,083621,Davis; Joshua Daniel,0,17,60,60
1649999645980,COGS 101B,A01,091572,Staff,17,0,60,43
1649999652003,COGS 101C,A01,083625,Delgado; Tania,21,0,30,9
1649999658027,COGS 107A,A01,083627,Boyle; Mary E. T.,0,1,60,60
1649999664056,COGS 118A,A01,083075,Staff,19,0,60,41
1649999670083,CSE 3,A50,083646,Miranda; Gregory Joseph,22,0,38,16
1649999670083,CSE 3,A51,083647,Miranda; Gregory Joseph,37,0,37,0
1649999676112,CSE 8A,A50,083650,Miranda; Gregory Joseph,2,15,40,38
1649999682134,CSE 11,A01,083080,Cao; Yingjun,0,57,40,40
1649999688158,CSE 12,A01,083652,Staff,7,0,100,93
1649999694182,CSE 15L,A01,083654,Staff,0,0,50,50
1649999694182,CSE 15L,A02,083655,Staff,19,0,50,31
1649999700209,CSE 20,A01,083657,Staff,57,0,80,23
1649999706235,CSE 30,A01,083084,Eldon; John,0,60,40,40
1649999712271,CSE 100,A01,083659,Cao; Yingjun,1,56,50,49
1649999718306,CSE 134B,A01,083661,Powell; Thomas Allan,1,25,65,64
1649999724331,CSE 140,A01,083663,Staff,9,0,75,66
1649999730356,CSE 140L,A01,083088,Eldon; John,5,0,75,70
1649999745493,CSE 175,A01,083665,Kumar; Rakesh,10,0,25,15
1649999751516,CSE 190,A00,092507,Dubnov; Shlomo,17,0,20,3
1649999757539,ECE 45,A01,083139,Staff,0,8,40,40
1649999763564,ECE 65,A50,083695,Staff,0,0,30,30
1649999769588,ECE 109,A01,091882,Touri; Behrouz,49,0,70,21
1649999775614,ECE 180,A00,083140,Abi Samra; Nicholas Camill,26,0,30,4
1649999775614,ECE 180,B00,083141,Abi Samra; Nicholas Camill,10,0,30,20
1649999781647,MATH 10A,A01,083735,Patchell; Gregory David,14,0,30,16
1649999781647,MATH 10A,A02,083736,Patchell; Gregory David,28,0,30,2
1649999781647,MATH 10A,A03,083737,Patchell; Gregory David,27,0,30,3
1649999787675,MATH 10B,A01,083207,Staff,0,4,30,30
1649999787675,MATH 10B,A02,083208,Staff,2,0,30,28
1649999787675,MATH 10B,B01,083739,Staff,20,0,30,10
1649999787675,MATH 10B,B02,083740,Staff,30,0,30,0
1649999793709,MATH 18,A01,083743,Staff,11,0,30,19
1649999793709,MATH 18,A02,083744,Staff,28,0,30,2
1649999793709,MATH 18,A03,083745,Staff,23,0,30,7
1649999793709,MATH 18,A04,083746,Staff,27,0,30,3
1649999793709,MATH 18,B01,083748,Staff,0,5,30,30
1649999793709,MATH 18,B02,083749,Staff,0,5,30,30
1649999793709,MATH 18,B03,083750,Staff,0,6,30,30
1649999793709,MATH 18,B04,083751,Staff,0,5,30,30
1649999799733,MATH 20A,A01,083754,Staff,28,0,40,12
1649999805754,MATH 20B,A01,083756,Staff,0,3,30,30
1649999805754,MATH 20B,A02,083757,Staff,8,0,30,22
1649999811778,MATH 20C,A01,083760,Staff,1,10,30,29
1649999811778,MATH 20C,A02,083761,Staff,0,9,30,30
1649999811778,MATH 20C,B01,083762,Staff,16,0,30,14
1649999811778,MATH 20C,B02,083763,Staff,30,0,30,0
1649999817801,MATH 20D,A01,083765,Staff,0,2,30,30
1649999817801,MATH 20D,A02,083766,Staff,17,0,30,13
1649999817801,MATH 20D,A03,083767,Staff,28,0,30,2
1649999823829,MATH 20E,A01,083771,Staff,11,0,30,19
1649999823829,MATH 20E,A02,083772,Staff,20,0,30,10
1649999823829,MATH 20E,B01,083773,Staff,0,0,30,30
1649999823829,MATH 20E,B02,083774,Staff,22,0,30,8
1649999829860,MATH 103A,A01,083777,Staff,1,6,30,29
1649999829860,MATH 103A,A02,083778,Staff,0,7,30,30
1649999829860,MATH 103A,B01,083779,Staff,0,6,30,30
1649999829860,MATH 103A,B02,083780,Staff,0,6,30,30
1649999835882,MATH 105,A01,085443,Staff,0,11,30,30
1649999841910,MATH 109,A01,083213,Anzaldo; Leesa B,0,3,30,30
1649999841910,MATH 109,A02,083214,Anzaldo; Leesa B,1,4,30,29
1649999841910,MATH 109,B01,083215,Anzaldo; Leesa B,1,3,30,29
1649999841910,MATH 109,B02,083216,Anzaldo; Leesa B,1,3,30,29
1649999847934,MATH 142A,A01,083219,Chow; Bennett,0,7,30,30
1649999847934,MATH 142A,A02,083220,Chow; Bennett,0,6,30,30
1649999847934,MATH 142A,B01,083221,Chow; Bennett,0,7,30,30
1649999847934,MATH 142A,B02,083222,Chow; Bennett,0,7,30,30
1649999853958,MATH 193A,A01,083224,Staff,0,6,30,30
1649999853958,MATH 193A,A02,083225,Staff,0,4,30,30
1649999853958,MATH 193A,A03,083781,Staff,0,0,30,30
1649999853958,MATH 193A,A04,083782,Staff,10,0,30,20
1649999859982,MATH 197,001,091859,McAuley; Julian John,9999,0,9999,0
1649999866042,COGS 9,A01,083615,Staff,2,15,60,58
1649999872069,COGS 11,A01,083617,Boyle; Mary E. T.,25,0,40,15
1649999878093,COGS 13,A01,083071,Staff,1,28,40,39
1649999884120,COGS 14A,A01,092681,Staff,0,3,100,100
1649999890145,COGS 14B,A01,083073,Cheng; Tzu-Han,0,1,50,50
1649999896168,COGS 17,A01,092677,Staff,36,0,75,39
1649999902190,COGS 100,A01,083619,Staff,1,18,60,59
1649999908225,COGS 101A,A01,083621,Davis; Joshua Daniel,0,17,60,60
1649999914248,COGS 101B,A01,091572,Staff,17,0,60,43
1649999920271,COGS 101C,A01,083625,Delgado; Tania,21,0,30,9
1649999926295,COGS 107A,A01,083627,Boyle; Mary E. T.,0,1,60,60
1649999932319,COGS 118A,A01,083075,Staff,19,0,60,41
1649999938346,CSE 3,A50,083646,Miranda; Gregory Joseph,22,0,38,16
1649999938346,CSE 3,A51,083647,Miranda; Gregory Joseph,37,0,37,0
1649999944369,CSE 8A,A50,083650,Miranda; Gregory Joseph,2,15,40,38
1649999950393,CSE 11,A01,083080,Cao; Yingjun,0,57,40,40
1649999956419,CSE 12,A01,083652,Staff,6,0,100,94
1649999962442,CSE 15L,A01,083654,Staff,0,0,50,50
1649999962442,CSE 15L,A02,083655,Staff,18,0,50,32
1649999968477,CSE 20,A01,083657,Staff,57,0,80,23
1649999974507,CSE 30,A01,083084,Eldon; John,0,60,40,40
1649999980531,CSE 100,A01,083659,Cao; Yingjun,1,56,50,49
1649999986559,CSE 134B,A01,083661,Powell; Thomas Allan,1,25,65,64
1649999992585,CSE 140,A01,083663,Staff,9,0,75,66
1649999998618,CSE 140L,A01,083088,Eldon; John,5,0,75,70
1650000004668,CSE 175,A01,083665,Kumar; Rakesh,10,0,25,15
1650000010692,CSE 190,A00,092507,Dubnov; Shlomo,18,0,20,2
1650000016715,ECE 45,A01,083139,Staff,0,8,40,40
1650000022742,ECE 65,A50,083695,Staff,0,0,30,30
1650000028766,ECE 109,A01,091882,Touri; Behrouz,49,0,70,21
1650000034789,ECE 180,A00,083140,Abi Samra; Nicholas Camill,26,0,30,4
1650000034789,ECE 180,B00,083141,Abi Samra; Nicholas Camill,10,0,30,20
1650000040816,MATH 10A,A01,083735,Patchell; Gregory David,14,0,30,16
1650000040816,MATH 10A,A02,083736,Patchell; Gregory David,28,0,30,2
1650000040816,MATH 10A,A03,083737,Patchell; Gregory David,27,0,30,3
1650000046852,MATH 10B,A01,083207,Staff,0,4,30,30
1650000046852,MATH 10B,A02,083208,Staff,2,0,30,28
1650000046852,MATH 10B,B01,083739,Staff,20,0,30,10
1650000046852,MATH 10B,B02,083740,Staff,30,0,30,0
1650000052886,MATH 18,A01,083743,Staff,11,0,30,19
1650000052886,MATH 18,A02,083744,Staff,28,0,30,2
1650000052886,MATH 18,A03,083745,Staff,23,0,30,7
1650000052886,MATH 18,A04,083746,Staff,27,0,30,3
1650000052886,MATH 18,B01,083748,Staff,0,5,30,30
1650000052886,MATH 18,B02,083749,Staff,0,5,30,30
1650000052886,MATH 18,B03,083750,Staff,0,6,30,30
1650000052886,MATH 18,B04,083751,Staff,0,5,30,30
1650000058923,MATH 20A,A01,083754,Staff,28,0,40,12
1650000064947,MATH 20B,A01,083756,Staff,0,3,30,30
1650000064947,MATH 20B,A02,083757,Staff,8,0,30,22
1650000070972,MATH 20C,A01,083760,Staff,1,10,30,29
1650000070972,MATH 20C,A02,083761,Staff,0,9,30,30
1650000070972,MATH 20C,B01,083762,Staff,16,0,30,14
1650000070972,MATH 20C,B02,083763,Staff,30,0,30,0
1650000076995,MATH 20D,A01,083765,Staff,0,2,30,30
1650000076995,MATH 20D,A02,083766,Staff,17,0,30,13
1650000076995,MATH 20D,A03,083767,Staff,28,0,30,2
1650000083108,MATH 20E,A01,083771,Staff,11,0,30,19
1650000083108,MATH 20E,A02,083772,Staff,20,0,30,10
1650000083108,MATH 20E,B01,083773,Staff,0,0,30,30
1650000083108,MATH 20E,B02,083774,Staff,22,0,30,8
1650000089131,MATH 103A,A01,083777,Staff,1,6,30,29
1650000089131,MATH 103A,A02,083778,Staff,0,7,30,30
1650000089131,MATH 103A,B01,083779,Staff,0,6,30,30
1650000089131,MATH 103A,B02,083780,Staff,0,6,30,30
1650000095153,MATH 105,A01,085443,Staff,0,11,30,30
1650000101181,MATH 109,A01,083213,Anzaldo; Leesa B,0,3,30,30
1650000101181,MATH 109,A02,083214,Anzaldo; Leesa B,1,4,30,29
1650000101181,MATH 109,B01,083215,Anzaldo; Leesa B,1,3,30,29
1650000101181,MATH 109,B02,083216,Anzaldo; Leesa B,1,3,30,29
1650000107209,MATH 142A,A01,083219,Chow; Bennett,0,7,30,30
1650000107209,MATH 142A,A02,083220,Chow; Bennett,0,6,30,30
1650000107209,MATH 142A,B01,083221,Chow; Bennett,0,7,30,30
1650000107209,MATH 142A,B02,083222,Chow; Bennett,0,7,30,30
1650000113234,MATH 193A,A01,083224,Staff,0,6,30,30
1650000113234,MATH 193A,A02,083225,Staff,0,4,30,30
1650000113234,MATH 193A,A03,083781,Staff,0,0,30,30
1650000113234,MATH 193A,A04,083782,Staff,10,0,30,20
1650000119255,MATH 197,001,091859,McAuley; Julian John,9999,0,9999,0
1650000125314,COGS 9,A01,083615,Staff,2,15,60,58
1650000131336,COGS 11,A01,083617,Boyle; Mary E. T.,25,0,40,15
1650000137369,COGS 13,A01,083071,Staff,1,28,40,39
1650000143394,COGS 14A,A01,092681,Staff,0,3,100,100
1650000149420,COGS 14B,A01,083073,Cheng; Tzu-Han,0,1,50,50
1650000155447,COGS 17,A01,092677,Staff,36,0,75,39
1650000161478,COGS 100,A01,083619,Staff,1,18,60,59
1650000167508,COGS 101A,A01,083621,Davis; Joshua Daniel,0,17,60,60
1650000173536,COGS 101B,A01,091572,Staff,17,0,60,43
1650000179564,COGS 101C,A01,083625,Delgado; Tania,21,0,30,9
1650000185597,COGS 107A,A01,083627,Boyle; Mary E. T.,0,1,60,60
1650000191620,COGS 118A,A01,083075,Staff,19,0,60,41
1650000197647,CSE 3,A50,083646,Miranda; Gregory Joseph,22,0,38,16
1650000197647,CSE 3,A51,083647,Miranda; Gregory Joseph,37,0,37,0
1650000203675,CSE 8A,A50,083650,Miranda; Gregory Joseph,2,15,40,38
1650000209704,CSE 11,A01,083080,Cao; Yingjun,0,57,40,40
1650000215729,CSE 12,A01,083652,Staff,6,0,100,94
1650000221753,CSE 15L,A01,083654,Staff,0,0,50,50
1650000221753,CSE 15L,A02,083655,Staff,18,0,50,32
1650000227777,CSE 20,A01,083657,Staff,57,0,80,23
1650000233804,CSE 30,A01,083084,Eldon; John,0,60,40,40
1650000239830,CSE 100,A01,083659,Cao; Yingjun,1,57,50,49
1650000245869,CSE 134B,A01,083661,Powell; Thomas Allan,1,25,65,64
1650000251892,CSE 140,A01,083663,Staff,9,0,75,66
1650000257915,CSE 140L,A01,083088,Eldon; John,5,0,75,70
1650000263944,CSE 175,A01,083665,Kumar; Rakesh,10,0,25,15
1650000269970,CSE 190,A00,092507,Dubnov; Shlomo,18,0,20,2
1650000275997,ECE 45,A01,083139,Staff,0,8,40,40
1650000282021,ECE 65,A50,083695,Staff,0,1,30,30
1650000288047,ECE 109,A01,091882,Touri; Behrouz,49,0,70,21
1650000294075,ECE 180,A00,083140,Abi Samra; Nicholas Camill,26,0,30,4
1650000294075,ECE 180,B00,083141,Abi Samra; Nicholas Camill,10,0,30,20
1650000300099,MATH 10A,A01,083735,Patchell; Gregory David,14,0,30,16
1650000300099,MATH 10A,A02,083736,Patchell; Gregory David,28,0,30,2
1650000300099,MATH 10A,A03,083737,Patchell; Gregory David,27,0,30,3
1650000306129,MATH 10B,A01,083207,Staff,0,4,30,30
1650000306129,MATH 10B,A02,083208,Staff,2,0,30,28
1650000306129,MATH 10B,B01,083739,Staff,20,0,30,10
1650000306129,MATH 10B,B02,083740,Staff,30,0,30,0
1650000312152,MATH 18,A01,083743,Staff,11,0,30,19
1650000312152,MATH 18,A02,083744,Staff,28,0,30,2
1650000312152,MATH 18,A03,083745,Staff,23,0,30,7
1650000312152,MATH 18,A04,083746,Staff,27,0,30,3
1650000312152,MATH 18,B01,083748,Staff,0,5,30,30
1650000312152,MATH 18,B02,083749,Staff,0,5,30,30
1650000312152,MATH 18,B03,083750,Staff,0,6,30,30
1650000312152,MATH 18,B04,083751,Staff,0,5,30,30
1650000318176,MATH 20A,A01,083754,Staff,28,0,40,12
1650000324211,MATH 20B,A01,083756,Staff,0,3,30,30
1650000324211,MATH 20B,A02,083757,Staff,8,0,30,22
1650000330236,MATH 20C,A01,083760,Staff,1,10,30,29
1650000330236,MATH 20C,A02,083761,Staff,0,9,30,30
1650000330236,MATH 20C,B01,083762,Staff,16,0,30,14
1650000330236,MATH 20C,B02,083763,Staff,30,0,30,0
1650000336261,MATH 20D,A01,083765,Staff,0,2,30,30
1650000336261,MATH 20D,A02,083766,Staff,17,0,30,13
1650000336261,MATH 20D,A03,083767,Staff,28,0,30,2
1650000342290,MATH 20E,A01,083771,Staff,11,0,30,19
1650000342290,MATH 20E,A02,083772,Staff,20,0,30,10
1650000342290,MATH 20E,B01,083773,Staff,0,0,30,30
1650000342290,MATH 20E,B02,083774,Staff,22,0,30,8
1650000348316,MATH 103A,A01,083777,Staff,1,6,30,29
1650000348316,MATH 103A,A02,083778,Staff,0,7,30,30
1650000348316,MATH 103A,B01,083779,Staff,0,6,30,30
1650000348316,MATH 103A,B02,083780,Staff,0,6,30,30
1650000354341,MATH 105,A01,085443,Staff,0,11,30,30
1650000360368,MATH 109,A01,083213,Anzaldo; Leesa B,0,3,30,30
1650000360368,MATH 109,A02,083214,Anzaldo; Leesa B,1,4,30,29
1650000360368,MATH 109,B01,083215,Anzaldo; Leesa B,1,3,30,29
1650000360368,MATH 109,B02,083216,Anzaldo; Leesa B,1,3,30,29
1650000366394,MATH 142A,A01,083219,Chow; Bennett,0,7,30,30
1650000366394,MATH 142A,A02,083220,Chow; Bennett,0,6,30,30
1650000366394,MATH 142A,B01,083221,Chow; Bennett,0,7,30,30
1650000366394,MATH 142A,B02,083222,Chow; Bennett,0,7,30,30
1650000372417,MATH 193A,A01,083224,Staff,0,6,30,30
1650000372417,MATH 193A,A02,083225,Staff,0,4,30,30
1650000372417,MATH 193A,A03,083781,Staff,0,0,30,30
1650000372417,MATH 193A,A04,083782,Staff,10,0,30,20
1650000378440,MATH 197,001,091859,McAuley; Julian John,9999,0,9999,0
1650000384497,COGS 9,A01,083615,Staff,2,15,60,58
1650000390520,COGS 11,A01,083617,Boyle; Mary E. T.,25,0,40,15
1650000396549,COGS 13,A01,083071,Staff,1,28,40,39
1650000402582,COGS 14A,A01,092681,Staff,0,3,100,100
1650000408605,COGS 14B,A01,083073,Cheng; Tzu-Han,0,1,50,50
1650000414631,COGS 17,A01,092677,Staff,36,0,75,39
1650000420658,COGS 100,A01,083619,Staff,0,17,60,60
1650000426685,COGS 101A,A01,083621,Davis; Joshua Daniel,0,17,60,60
1650000432722,COGS 101B,A01,091572,Staff,17,0,60,43
1650000438746,COGS 101C,A01,083625,Delgado; Tania,21,0,30,9
1650000444770,COGS 107A,A01,083627,Boyle; Mary E. T.,0,1,60,60
1650000450795,COGS 118A,A01,083075,Staff,19,0,60,41
1650000456850,CSE 3,A50,083646,Miranda; Gregory Joseph,22,0,38,16
1650000456850,CSE 3,A51,083647,Miranda; Gregory Joseph,37,0,37,0
1650000462874,CSE 8A,A50,083650,Miranda; Gregory Joseph,0,13,40,40
1650000468908,CSE 11,A01,083080,Cao; Yingjun,0,57,40,40
1650000474937,CSE 12,A01,083652,Staff,6,0,100,94
1650000480960,CSE 15L,A01,083654,Staff,0,0,50,50
1650000480960,CSE 15L,A02,083655,Staff,18,0,50,32
1650000486983,CSE 20,A01,083657,Staff,57,0,80,23
1650000493007,CSE 30,A01,083084,Eldon; John,0,60,40,40
1650000499031,CSE 100,A01,083659,Cao; Yingjun,0,56,50,50
1650000505054,CSE 134B,A01,083661,Powell; Thomas Allan,0,24,65,65
1650000511087,CSE 140,A01,083663,Staff,9,0,75,66
1650000517119,CSE 140L,A01,083088,Eldon; John,5,0,75,70
1650000523142,CSE 175,A01,083665,Kumar; Rakesh,10,0,25,15
1650000529166,CSE 190,A00,092507,Dubnov; Shlomo,17,0,20,3
1650000535190,ECE 45,A01,083139,Staff,0,8,40,40
1650000541219,ECE 65,A50,083695,Staff,0,1,30,30
1650000547245,ECE 109,A01,091882,Touri; Behrouz,49,0,70,21
1650000553274,ECE 180,A00,083140,Abi Samra; Nicholas Camill,26,0,30,4
1650000553274,ECE 180,B00,083141,Abi Samra; Nicholas Camill,10,0,30,20
1650000559301,MATH 10A,A01,083735,Patchell; Gregory David,14,0,30,16
1650000559301,MATH 10A,A02,083736,Patchell; Gregory David,28,0,30,2
1650000559301,MATH 10A,A03,083737,Patchell; Gregory David,27,0,30,3
1650000565332,MATH 10B,A01,083207,Staff,0,4,30,30
1650000565332,MATH 10B,A02,083208,Staff,2,0,30,28
1650000565332,MATH 10B,B01,083739,Staff,20,0,30,10
1650000565332,MATH 10B,B02,083740,Staff,30,0,30,0
1650000571359,MATH 18,A01,083743,Staff,11,0,30,19
1650000571359,MATH 18,A02,083744,Staff,28,0,30,2
1650000571359,MATH 18,A03,083745,Staff,23,0,30,7
1650000571359,MATH 18,A04,083746,Staff,27,0,30,3
1650000571359,MATH 18,B01,083748,Staff,0,5,30,30
1650000571359,MATH 18,B02,083749,Staff,0,5,30,30
1650000571359,MATH 18,B03,083750,Staff,0,6,30,30
1650000571359,MATH 18,B04,083751,Staff,0,5,30,30
1650000577388,MATH 20A,A01,083754,Staff,28,0,40,12
1650000583414,MATH 20B,A01,083756,Staff,0,3,30,30
1650000583414,MATH 20B,A02,083757,Staff,8,0,30,22
1650000589448,MATH 20C,A01,083760,Staff,0,9,30,30
1650000589448,MATH 20C,A02,083761,Staff,0,9,30,30
1650000589448,MATH 20C,B01,083762,Staff,16,0,30,14
1650000589448,MATH 20C,B02,083763,Staff,30,0,30,0
1650000595471,MATH 20D,A01,083765,Staff,0,2,30,30
1650000595471,MATH 20D,A02,083766,Staff,17,0,30,13
1650000595471,MATH 20D,A03,083767,Staff,28,0,30,2
1650000601495,MATH 20E,A01,083771,Staff,11,0,30,19
1650000601495,MATH 20E,A02,083772,Staff,20,0,30,10
1650000601495,MATH 20E,B01,083773,Staff,0,0,30,30
1650000601495,MATH 20E,B02,083774,Staff,22,0,30,8
1650000607522,MATH 103A,A01,083777,Staff,0,5,30,30
1650000607522,MATH 103A,A02,083778,Staff,0,7,30,30
1650000607522,MATH 103A,B01,083779,Staff,0,6,30,30
1650000607522,MATH 103A,B02,083780,Staff,0,6,30,30
1650000613550,MATH 105,A01,085443,Staff,0,11,30,30
1650000619578,MATH 109,A01,083213,Anzaldo; Leesa B,0,3,30,30
1650000619578,MATH 109,A02,083214,Anzaldo; Leesa B,0,3,30,30
1650000619578,MATH 109,B01,083215,Anzaldo; Leesa B,0,2,30,30
1650000619578,MATH 109,B02,083216,Anzaldo; Leesa B,0,2,30,30
1650000625616,MATH 142A,A01,083219,Chow; Bennett,0,7,30,30
1650000625616,MATH 142A,A02,083220,Chow; Bennett,0,6,30,30
1650000625616,MATH 142A,B01,083221,Chow; Bennett,0,7,30,30
1650000625616,MATH 142A,B02,083222,Chow; Bennett,0,7,30,30
1650000631664,MATH 193A,A01,083224,Staff,0,6,30,30
1650000631664,MATH 193A,A02,083225,Staff,0,4,30,30
1650000631664,MATH 193A,A03,083781,Staff,0,0,30,30
1650000631664,MATH 193A,A04,083782,Staff,10,0,30,20
1650000637688,MATH 197,001,091859,McAuley; Julian John,9999,0,9999,0
1650000643738,COGS 9,A01,083615,Staff,1,13,60,59
1650000649763,COGS 11,A01,083617,Boyle; Mary E. T.,25,0,40,15
1650000655803,COGS 13,A01,083071,Staff,0,27,40,40
1650000661832,COGS 14A,A01,092681,Staff,0,3,100,100
1650000667855,COGS 14B,A01,083073,Cheng; Tzu-Han,0,1,50,50
1650000673971,COGS 17,A01,092677,Staff,36,0,75,39
1650000680016,COGS 100,A01,083619,Staff,0,17,60,60
1650000686042,COGS 101A,A01,083621,Davis; Joshua Daniel,0,17,60,60
1650000692066,COGS 101B,A01,091572,Staff,17,0,60,43
1650000698091,COGS 101C,A01,083625,Delgado; Tania,21,0,30,9
1650000704123,COGS 107A,A01,083627,Boyle; Mary E. T.,0,1,60,60
1650000710146,COGS 118A,A01,083075,Staff,19,0,60,41
1650000716168,CSE 3,A50,083646,Miranda; Gregory Joseph,22,0,38,16
1650000716168,CSE 3,A51,083647,Miranda; Gregory Joseph,37,0,37,0
1650000722219,CSE 8A,A50,083650,Miranda; Gregory Joseph,0,13,40,40
1650000728245,CSE 11,A01,083080,Cao; Yingjun,0,57,40,40
1650000734268,CSE 12,A01,083652,Staff,6,0,100,94
1650000740303,CSE 15L,A01,083654,Staff,0,0,50,50
1650000740303,CSE 15L,A02,083655,Staff,18,0,50,32
1650000746328,CSE 20,A01,083657,Staff,57,0,80,23
1650000752366,CSE 30,A01,083084,Eldon; John,0,61,40,40
1650000758397,CSE 100,A01,083659,Cao; Yingjun,0,56,50,50
1650000764423,CSE 134B,A01,083661,Powell; Thomas Allan,0,24,65,65
1650000770446,CSE 140,A01,083663,Staff,9,0,75,66
1650000776469,CSE 140L,A01,083088,Eldon; John,5,0,75,70
1650000782491,CSE 175,A01,083665,Kumar; Rakesh,10,0,25,15
1650000788518,CSE 190,A00,092507,Dubnov; Shlomo,17,0,20,3
1650000794555,ECE 45,A01,083139,Staff,0,8,40,40
1650000800580,ECE 65,A50,083695,Staff,0,1,30,30
1650000806603,ECE 109,A01,091882,Touri; Behrouz,49,0,70,21
1650000812626,ECE 180,A00,083140,Abi Samra; Nicholas Camill,26,0,30,4
1650000812626,ECE 180,B00,083141,Abi Samra; Nicholas Camill,10,0,30,20
1650000818658,MATH 10A,A01,083735,Patchell; Gregory David,14,0,30,16
1650000818658,MATH 10A,A02,083736,Patchell; Gregory David,28,0,30,2
1650000818658,MATH 10A,A03,083737,Patchell; Gregory David,27,0,30,3
1650000824697,MATH 10B,A01,083207,Staff,0,4,30,30
1650000824697,MATH 10B,A02,083208,Staff,2,0,30,28
1650000824697,MATH 10B,B01,083739,Staff,20,0,30,10
1650000824697,MATH 10B,B02,083740,Staff,30,0,30,0
1650000830722,MATH 18,A01,083743,Staff,11,0,30,19
1650000830722,MATH 18,A02,083744,Staff,28,0,30,2
1650000830722,MATH 18,A03,083745,Staff,23,0,30,7
1650000830722,MATH 18,A04,083746,Staff,27,0,30,3
1650000830722,MATH 18,B01,083748,Staff,0,5,30,30
1650000830722,MATH 18,B02,083749,Staff,0,5,30,30
1650000830722,MATH 18,B03,083750,Staff,0,6,30,30
1650000830722,MATH 18,B04,083751,Staff,0,5,30,30
1650000836744,MATH 20A,A01,083754,Staff,28,0,40,12
1650000842771,MATH 20B,A01,083756,Staff,0,3,30,30
1650000842771,MATH 20B,A02,083757,Staff,8,0,30,22
1650000848812,MATH 20C,A01,083760,Staff,0,9,30,30
1650000848812,MATH 20C,A02,083761,Staff,0,10,30,30
1650000848812,MATH 20C,B01,083762,Staff,17,0,30,13
1650000848812,MATH 20C,B02,083763,Staff,30,0,30,0
1650000854848,MATH 20D,A01,083765,Staff,0,2,30,30
1650000854848,MATH 20D,A02,083766,Staff,17,0,30,13
1650000854848,MATH 20D,A03,083767,Staff,28,0,30,2
1650000860871,MATH 20E,A01,083771,Staff,11,0,30,19
1650000860871,MATH 20E,A02,083772,Staff,20,0,30,10
1650000860871,MATH 20E,B01,083773,Staff,0,0,30,30
1650000860871,MATH 20E,B02,083774,Staff,22,0,30,8
1650000866897,MATH 103A,A01,083777,Staff,0,5,30,30
1650000866897,MATH 103A,A02,083778,Staff,0,7,30,30
1650000866897,MATH 103A,B01,083779,Staff,0,6,30,30
1650000866897,MATH 103A,B02,083780,Staff,0,6,30,30
1650000872932,MATH 105,A01,085443,Staff,0,11,30,30
1650000878956,MATH 109,A01,083213,Anzaldo; Leesa B,0,3,30,30
1650000878956,MATH 109,A02,083214,Anzaldo; Leesa B,0,3,30,30
1650000878956,MATH 109,B01,083215,Anzaldo; Leesa B,0,2,30,30
1650000878956,MATH 109,B02,083216,Anzaldo; Leesa B,0,2,30,30
1650000884981,MATH 142A,A01,083219,Chow; Bennett,0,7,30,30
1650000884981,MATH 142A,A02,083220,Chow; Bennett,0,6,30,30
1650000884981,MATH 142A,B01,083221,Chow; Bennett,0,7,30,30
1650000884981,MATH 142A,B02,083222,Chow; Bennett,0,7,30,30
1650000891005,MATH 193A,A01,083224,Staff,0,6,30,30
1650000891005,MATH 193A,A02,083225,Staff,0,4,30,30
1650000891005,MATH 193A,A03,083781,Staff,0,0,30,30
1650000891005,MATH 193A,A04,083782,Staff,10,0,30,20
1650000897034,MATH 197,001,091859,McAuley; Julian John,9999,0,9999,0
1650000903090,COGS 9,A01,083615,Staff,1,14,60,59
1650000909140,COGS 11,A01,083617,Boyle; Mary E. T.,25,0,40,15
1650000915163,COGS 13,A01,083071,Staff,0,27,40,40
1650000921191,COGS 14A,A01,092681,Staff,0,4,100,100
1650000927214,COGS 14B,A01,083073,Cheng; Tzu-Han,0,1,50,50
1650000933240,COGS 17,A01,092677,Staff,35,0,75,40
1650000939276,COGS 100,A01,083619,Staff,0,17,60,60
1650000945313,COGS 101A,A01,083621,Davis; Joshua Daniel,0,17,60,60
1650000951336,COGS 101B,A01,091572,Staff,17,0,60,43
1650000957362,COGS 101C,A01,083625,Delgado; Tania,21,0,30,9
1650000963389,COGS 107A,A01,083627,Boyle; Mary E. T.,0,1,60,60
1650000969428,COGS 118A,A01,083075,Staff,19,0,60,41
1650000975449,CSE 3,A50,083646,Miranda; Gregory Joseph,22,0,38,16
1650000975449,CSE 3,A51,083647,Miranda; Gregory Joseph,37,0,37,0
1650000981482,CSE 8A,A50,083650,Miranda; Gregory Joseph,0,13,40,40
1650000987505,CSE 11,A01,083080,Cao; Yingjun,0,57,40,40
1650000993534,CSE 12,A01,083652,Staff,6,0,100,94
1650000999563,CSE 15L,A01,083654,Staff,0,0,50,50
1650000999563,CSE 15L,A02,083655,Staff,18,0,50,32
1650001005592,CSE 20,A01,083657,Staff,57,0,80,23
1650001011617,CSE 30,A01,083084,Eldon; John,0,61,40,40
1650001017641,CSE 100,A01,083659,Cao; Yingjun,0,56,50,50
1650001023674,CSE 134B,A01,083661,Powell; Thomas Allan,0,24,65,65
1650001029699,CSE 140,A01,083663,Staff,9,0,75,66
1650001035726,CSE 140L,A01,083088,Eldon; John,4,0,75,71
1650001041749,CSE 175,A01,083665,Kumar; Rakesh,10,0,25,15
1650001047772,CSE 190,A00,092507,Dubnov; Shlomo,17,0,20,3
1650001053798,ECE 45,A01,083139,Staff,0,8,40,40
1650001059822,ECE 65,A50,083695,Staff,0,1,30,30
1650001065860,ECE 109,A01,091882,Touri; Behrouz,49,0,70,21
1650001071888,ECE 180,A00,083140,Abi Samra; Nicholas Camill,26,0,30,4
1650001071888,ECE 180,B00,083141,Abi Samra; Nicholas Camill,10,0,30,20
1650001077915,MATH 10A,A01,083735,Patchell; Gregory David,14,0,30,16
1650001077915,MATH 10A,A02,083736,Patchell; Gregory David,28,0,30,2
1650001077915,MATH 10A,A03,083737,Patchell; Gregory David,27,0,30,3
1650001083939,MATH 10B,A01,083207,Staff,0,4,30,30
1650001083939,MATH 10B,A02,083208,Staff,2,0,30,28
1650001083939,MATH 10B,B01,083739,Staff,20,0,30,10
1650001083939,MATH 10B,B02,083740,Staff,30,0,30,0
1650001089970,MATH 18,A01,083743,Staff,11,0,30,19
1650001089970,MATH 18,A02,083744,Staff,28,0,30,2
1650001089970,MATH 18,A03,083745,Staff,23,0,30,7
1650001089970,MATH 18,A04,083746,Staff,27,0,30,3
1650001089970,MATH 18,B01,083748,Staff,0,5,30,30
1650001089970,MATH 18,B02,083749,Staff,0,5,30,30
1650001089970,MATH 18,B03,083750,Staff,0,6,30,30
1650001089970,MATH 18,B04,083751,Staff,0,5,30,30
1650001095992,MATH 20A,A01,083754,Staff,28,0,40,12
1650001102018,MATH 20B,A01,083756,Staff,0,3,30,30
1650001102018,MATH 20B,A02,083757,Staff,7,0,30,23
1650001108046,MATH 20C,A01,083760,Staff,0,9,30,30
1650001108046,MATH 20C,A02,083761,Staff,0,10,30,30
1650001108046,MATH 20C,B01,083762,Staff,17,0,30,13
1650001108046,MATH 20C,B02,083763,Staff,30,0,30,0
1650001114072,MATH 20D,A01,083765,Staff,0,2,30,30
1650001114072,MATH 20D,A02,083766,Staff,17,0,30,13
1650001114072,MATH 20D,A03,083767,Staff,28,0,30,2
1650001120096,MATH 20E,A01,083771,Staff,11,0,30,19
1650001120096,MATH 20E,A02,083772,Staff,20,0,30,10
1650001120096,MATH 20E,B01,083773,Staff,0,0,30,30
1650001120096,MATH 20E,B02,083774,Staff,22,0,30,8
1650001126130,MATH 103A,A01,083777,Staff,0,5,30,30
1650001126130,MATH 103A,A02,083778,Staff,0,7,30,30
1650001126130,MATH 103A,B01,083779,Staff,0,6,30,30
1650001126130,MATH 103A,B02,083780,Staff,0,6,30,30
1650001132160,MATH 105,A01,085443,Staff,0,11,30,30
1650001138192,MATH 109,A01,083213,Anzaldo; Leesa B,0,3,30,30
1650001138192,MATH 109,A02,083214,Anzaldo; Leesa B,0,3,30,30
1650001138192,MATH 109,B01,083215,Anzaldo; Leesa B,0,2,30,30
1650001138192,MATH 109,B02,083216,Anzaldo; Leesa B,0,2,30,30
1650001144231,MATH 142A,A01,083219,Chow; Bennett,0,7,30,30
1650001144231,MATH 142A,A02,083220,Chow; Bennett,0,6,30,30
1650001144231,MATH 142A,B01,083221,Chow; Bennett,0,7,30,30
1650001144231,MATH 142A,B02,083222,Chow; Bennett,0,7,30,30
1650001150258,MATH 193A,A01,083224,Staff,0,6,30,30
1650001150258,MATH 193A,A02,083225,Staff,0,4,30,30
1650001150258,MATH 193A,A03,083781,Staff,0,0,30,30
1650001150258,MATH 193A,A04,083782,Staff,10,0,30,20
1650001156285,MATH 197,001,091859,McAuley; Julian John,9999,0,9999,0
1650001162346,COGS 9,A01,083615,Staff,1,14,60,59
1650001168374,COGS 11,A01,083617,Boyle; Mary E. T.,25,0,40,15
1650001174410,COGS 13,A01,083071,Staff,0,27,40,40
1650001180436,COGS 14A,A01,092681,Staff,0,4,100,100
1650001186467,COGS 14B,A01,083073,Cheng; Tzu-Han,0,1,50,50
1650001192501,COGS 17,A01,092677,Staff,35,0,75,40
1650001198523,COGS 100,A01,083619,Staff,0,17,60,60
1650001204551,COGS 101A,A01,083621,Davis; Joshua Daniel,0,17,60,60
1650001210573,COGS 101B,A01,091572,Staff,17,0,60,43
1650001216600,COGS 101C,A01,083625,Delgado; Tania,21,0,30,9
1650001222633,COGS 107A,A01,083627,Boyle; Mary E. T.,0,1,60,60
1650001228656,COGS 118A,A01,083075,Staff,19,0,60,41
1650001234680,CSE 3,A50,083646,Miranda; Gregory Joseph,22,0,38,16
1650001234680,CSE 3,A51,083647,Miranda; Gregory Joseph,37,0,37,0
1650001240704,CSE 8A,A50,083650,Miranda; Gregory Joseph,0,13,40,40
1650001246739,CSE 11,A01,083080,Cao; Yingjun,0,57,40,40
1650001252766,CSE 12,A01,083652,Staff,6,0,100,94
1650001258790,CSE 15L,A01,083654,Staff,0,0,50,50
1650001258790,CSE 15L,A02,083655,Staff,18,0,50,32
1650001264813,CSE 20,A01,083657,Staff,57,0,80,23
1650001270929,CSE 30,A01,083084,Eldon; John,0,61,40,40
1650001276950,CSE 100,A01,083659,Cao; Yingjun,0,56,50,50
1650001282973,CSE 134B,A01,083661,Powell; Thomas Allan,0,24,65,65
1650001289008,CSE 140,A01,083663,Staff,9,0,75,66
1650001295035,CSE 140L,A01,083088,Eldon; John,4,0,75,71
1650001301059,CSE 175,A01,083665,Kumar; Rakesh,10,0,25,15
1650001307082,CSE 190,A00,092507,Dubnov; Shlomo,17,0,20,3
1650001313115,ECE 45,A01,083139,Staff,0,8,40,40
1650001319137,ECE 65,A50,083695,Staff,0,1,30,30
1650001325160,ECE 109,A01,091882,Touri; Behrouz,49,0,70,21
1650001331187,ECE 180,A00,083140,Abi Samra; Nicholas Camill,26,0,30,4
1650001331187,ECE 180,B00,083141,Abi Samra; Nicholas Camill,10,0,30,20
1650001337209,MATH 10A,A01,083735,Patchell; Gregory David,14,0,30,16
1650001337209,MATH 10A,A02,083736,Patchell; Gregory David,28,0,30,2
1650001337209,MATH 10A,A03,083737,Patchell; Gregory David,27,0,30,3
1650001343233,MATH 10B,A01,083207,Staff,0,4,30,30
1650001343233,MATH 10B,A02,083208,Staff,2,0,30,28
1650001343233,MATH 10B,B01,083739,Staff,20,0,30,10
1650001343233,MATH 10B,B02,083740,Staff,30,0,30,0
1650001349258,MATH 18,A01,083743,Staff,11,0,30,19
1650001349258,MATH 18,A02,083744,Staff,28,0,30,2
1650001349258,MATH 18,A03,083745,Staff,23,0,30,7
1650001349258,MATH 18,A04,083746,Staff,27,0,30,3
1650001349258,MATH 18,B01,083748,Staff,0,6,30,30
1650001349258,MATH 18,B02,083749,Staff,0,5,30,30
1650001349258,MATH 18,B03,083750,Staff,0,6,30,30
1650001349258,MATH 18,B04,083751,Staff,0,5,30,30
1650001355280,MATH 20A,A01,083754,Staff,28,0,40,12
1650001361311,MATH 20B,A01,083756,Staff,0,4,30,30
1650001361311,MATH 20B,A02,083757,Staff,7,0,30,23
1650001367335,MATH 20C,A01,083760,Staff,0,9,30,30
1650001367335,MATH 20C,A02,083761,Staff,0,10,30,30
1650001367335,MATH 20C,B01,083762,Staff,17,0,30,13
1650001367335,MATH 20C,B02,083763,Staff,30,0,30,0
1650001373359,MATH 20D,A01,083765,Staff,0,2,30,30
1650001373359,MATH 20D,A02,083766,Staff,17,0,30,13
1650001373359,MATH 20D,A03,083767,Staff,28,0,30,2
1650001379390,MATH 20E,A01,083771,Staff,11,0,30,19
1650001379390,MATH 20E,A02,083772,Staff,20,0,30,10
1650001379390,MATH 20E,B01,083773,Staff,0,0,30,30
1650001379390,MATH 20E,B02,083774,Staff,22,0,30,8
1650001385415,MATH 103A,A01,083777,Staff,0,5,30,30
1650001385415,MATH 103A,A02,083778,Staff,0,7,30,30
1650001385415,MATH 103A,B01,083779,Staff,0,6,30,30
1650001385415,MATH 103A,B02,083780,Staff,0,6,30,30
1650001391437,MATH 105,A01,085443,Staff,0,11,30,30
1650001397474,MATH 109,A01,083213,Anzaldo; Leesa B,0,3,30,30
1650001397474,MATH 109,A02,083214,Anzaldo; Leesa B,0,3,30,30
1650001397474,MATH 109,B01,083215,Anzaldo; Leesa B,0,2,30,30
1650001397474,MATH 109,B02,083216,Anzaldo; Leesa B,0,2,30,30
1650001403501,MATH 142A,A01,083219,Chow; Bennett,0,7,30,30
1650001403501,MATH 142A,A02,083220,Chow; Bennett,0,6,30,30
1650001403501,MATH 142A,B01,083221,Chow; Bennett,0,7,30,30
1650001403501,MATH 142A,B02,083222,Chow; Bennett,0,7,30,30
1650001409525,MATH 193A,A01,083224,Staff,0,6,30,30
1650001409525,MATH 193A,A02,083225,Staff,0,4,30,30
1650001409525,MATH 193A,A03,083781,Staff,0,0,30,30
1650001409525,MATH 193A,A04,083782,Staff,10,0,30,20
1650001415551,MATH 197,001,091859,McAuley; Julian John,9999,0,9999,0
1650001421609,COGS 9,A01,083615,Staff,1,14,60,59
1650001427635,COGS 11,A01,083617,Boyle; Mary E. T.,25,0,40,15
1650001433657,COGS 13,A01,083071,Staff,0,27,40,40
1650001439682,COGS 14A,A01,092681,Staff,0,4,100,100
1650001445709,COGS 14B,A01,083073,Cheng; Tzu-Han,0,1,50,50
1650001451732,COGS 17,A01,092677,Staff,35,0,75,40
1650001457755,COGS 100,A01,083619,Staff,0,17,60,60
1650001463785,COGS 101A,A01,083621,Davis; Joshua Daniel,0,17,60,60
1650001469809,COGS 101B,A01,091572,Staff,17,0,60,43
1650001475832,COGS 101C,A01,083625,Delgado; Tania,21,0,30,9
1650001481856,COGS 107A,A01,083627,Boyle; Mary E. T.,0,1,60,60
1650001487879,COGS 118A,A01,083075,Staff,19,0,60,41
1650001493903,CSE 3,A50,083646,Miranda; Gregory Joseph,22,0,38,16
1650001493903,CSE 3,A51,083647,Miranda; Gregory Joseph,37,0,37,0
1650001499934,CSE 8A,A50,083650,Miranda; Gregory Joseph,0,13,40,40
1650001505958,CSE 11,A01,083080,Cao; Yingjun,0,57,40,40
1650001511981,CSE 12,A01,083652,Staff,6,0,100,94
1650001518004,CSE 15L,A01,083654,Staff,0,0,50,50
1650001518004,CSE 15L,A02,083655,Staff,18,0,50,32
1650001524031,CSE 20,A01,083657,Staff,57,0,80,23
1650001530053,CSE 30,A01,083084,Eldon; John,0,61,40,40
1650001536080,CSE 100,A01,083659,Cao; Yingjun,0,57,50,50
1650001542104,CSE 134B,A01,083661,Powell; Thomas Allan,0,24,65,65
1650001548131,CSE 140,A01,083663,Staff,8,0,75,67
1650001554167,CSE 140L,A01,083088,Eldon; John,4,0,75,71
1650001560202,CSE 175,A01,083665,Kumar; Rakesh,10,0,25,15
1650001566236,CSE 190,A00,092507,Dubnov; Shlomo,17,0,20,3
1650001572259,ECE 45,A01,083139,Staff,0,8,40,40
1650001578283,ECE 65,A50,083695,Staff,0,1,30,30
1650001584311,ECE 109,A01,091882,Touri; Behrouz,49,0,70,21
1650001590337,ECE 180,A00,083140,Abi Samra; Nicholas Camill,26,0,30,4
1650001590337,ECE 180,B00,083141,Abi Samra; Nicholas Camill,10,0,30,20
1650001596365,MATH 10A,A01,083735,Patchell; Gregory David,14,0,30,16
1650001596365,MATH 10A,A02,083736,Patchell; Gregory David,28,0,30,2
1650001596365,MATH 10A,A03,083737,Patchell; Gregory David,27,0,30,3
1650001602389,MATH 10B,A01,083207,Staff,0,4,30,30
1650001602389,MATH 10B,A02,083208,Staff,2,0,30,28
1650001602389,MATH 10B,B01,083739,Staff,20,0,30,10
1650001602389,MATH 10B,B02,083740,Staff,30,0,30,0
1650001608420,MATH 18,A01,083743,Staff,11,0,30,19
1650001608420,MATH 18,A02,083744,Staff,28,0,30,2
1650001608420,MATH 18,A03,083745,Staff,23,0,30,7
1650001608420,MATH 18,A04,083746,Staff,27,0,30,3
1650001608420,MATH 18,B01,083748,Staff,0,6,30,30
1650001608420,MATH 18,B02,083749,Staff,0,5,30,30
1650001608420,MATH 18,B03,083750,Staff,0,6,30,30
1650001608420,MATH 18,B04,083751,Staff,0,5,30,30
1650001614443,MATH 20A,A01,083754,Staff,28,0,40,12
1650001620472,MATH 20B,A01,083756,Staff,0,4,30,30
1650001620472,MATH 20B,A02,083757,Staff,7,0,30,23
1650001626502,MATH 20C,A01,083760,Staff,0,9,30,30
1650001626502,MATH 20C,A02,083761,Staff,0,10,30,30
1650001626502,MATH 20C,B01,083762,Staff,17,0,30,13
1650001626502,MATH 20C,B02,083763,Staff,30,0,30,0
1650001632528,MATH 20D,A01,083765,Staff,0,2,30,30
1650001632528,MATH 20D,A02,083766,Staff,17,0,30,13
1650001632528,MATH 20D,A03,083767,Staff,28,0,30,2
1650001638566,MATH 20E,A01,083771,Staff,11,0,30,19
1650001638566,MATH 20E,A02,083772,Staff,20,0,30,10
1650001638566,MATH 20E,B01,083773,Staff,0,0,30,30
1650001638566,MATH 20E,B02,083774,Staff,22,0,30,8
1650001644600,MATH 103A,A01,083777,Staff,0,5,30,30
1650001644600,MATH 103A,A02,083778,Staff,0,7,30,30
1650001644600,MATH 103A,B01,083779,Staff,0,6,30,30
1650001644600,MATH 103A,B02,083780,Staff,0,6,30,30
1650001650625,MATH 105,A01,085443,Staff,0,11,30,30
1650001656652,MATH 109,A01,083213,Anzaldo; Leesa B,0,3,30,30
1650001656652,MATH 109,A02,083214,Anzaldo; Leesa B,0,3,30,30
1650001656652,MATH 109,B01,083215,Anzaldo; Leesa B,0,2,30,30
1650001656652,MATH 109,B02,083216,Anzaldo; Leesa B,0,2,30,30
1650001662677,MATH 142A,A01,083219,Chow; Bennett,0,7,30,30
1650001662677,MATH 142A,A02,083220,Chow; Bennett,0,7,30,30
1650001662677,MATH 142A,B01,083221,Chow; Bennett,0,7,30,30
1650001662677,MATH 142A,B02,083222,Chow; Bennett,0,7,30,30
1650001668700,MATH 193A,A01,083224,Staff,0,6,30,30
1650001668700,MATH 193A,A02,083225,Staff,0,4,30,30
1650001668700,MATH 193A,A03,083781,Staff,0,0,30,30
1650001668700,MATH 193A,A04,083782,Staff,10,0,30,20
1650001674722,MATH 197,001,091859,McAuley; Julian John,9999,0,9999,0
1650001680779,COGS 9,A01,083615,Staff,1,14,60,59
1650001686817,COGS 11,A01,083617,Boyle; Mary E. T.,25,0,40,15
1650001692843,COGS 13,A01,083071,Staff,0,27,40,40
1650001698873,COGS 14A,A01,092681,Staff,0,5,100,100
1650001704896,COGS 14B,A01,083073,Cheng; Tzu-Han,0,1,50,50
1650001710921,COGS 17,A01,092677,Staff,35,0,75,40
1650001716944,COGS 100,A01,083619,Staff,0,17,60,60
1650001722976,COGS 101A,A01,083621,Davis; Joshua Daniel,0,17,60,60
1650001729004,COGS 101B,A01,091572,Staff,17,0,60,43
1650001735028,COGS 101C,A01,083625,Delgado; Tania,21,0,30,9
1650001741054,COGS 107A,A01,083627,Boyle; Mary E. T.,0,1,60,60
1650001747080,COGS 118A,A01,083075,Staff,19,0,60,41
1650001753108,CSE 3,A50,083646,Miranda; Gregory Joseph,22,0,38,16
1650001753108,CSE 3,A51,083647,Miranda; Gregory Joseph,37,0,37,0
1650001759153,CSE 8A,A50,083650,Miranda; Gregory Joseph,0,13,40,40
1650001765175,CSE 11,A01,083080,Cao; Yingjun,0,57,40,40
1650001771199,CSE 12,A01,083652,Staff,6,0,100,94
1650001777223,CSE 15L,A01,083654,Staff,0,0,50,50
1650001777223,CSE 15L,A02,083655,Staff,18,0,50,32
1650001783247,CSE 20,A01,083657,Staff,57,0,80,23
1650001789270,CSE 30,A01,083084,Eldon; John,0,61,40,40
1650001795293,CSE 100,A01,083659,Cao; Yingjun,0,57,50,50
1650001801325,CSE 134B,A01,083661,Powell; Thomas Allan,0,24,65,65
1650001807353,CSE 140,A01,083663,Staff,8,0,75,67
1650001813385,CSE 140L,A01,083088,Eldon; John,4,0,75,71
1650001819407,CSE 175,A01,083665,Kumar; Rakesh,10,0,25,15
1650001825437,CSE 190,A00,092507,Dubnov; Shlomo,17,0,20,3
1650001831461,ECE 45,A01,083139,Staff,0,8,40,40
1650001837484,ECE 65,A50,083695,Staff,0,1,30,30
1650001843508,ECE 109,A01,091882,Touri; Behrouz,49,0,70,21
1650001849531,ECE 180,A00,083140,Abi Samra; Nicholas Camill,26,0,30,4
1650001849531,ECE 180,B00,083141,Abi Samra; Nicholas Camill,10,0,30,20
1650001855560,MATH 10A,A01,083735,Patchell; Gregory David,14,0,30,16
1650001855560,MATH 10A,A02,083736,Patchell; Gregory David,28,0,30,2
1650001855560,MATH 10A,A03,083737,Patchell; Gregory David,27,0,30,3
1650001861588,MATH 10B,A01,083207,Staff,0,4,30,30
1650001861588,MATH 10B,A02,083208,Staff,2,0,30,28
1650001861588,MATH 10B,B01,083739,Staff,20,0,30,10
1650001861588,MATH 10B,B02,083740,Staff,30,0,30,0
1650001867687,MATH 18,A01,083743,Staff,11,0,30,19
1650001867687,MATH 18,A02,083744,Staff,28,0,30,2
1650001867687,MATH 18,A03,083745,Staff,23,0,30,7
1650001867687,MATH 18,A04,083746,Staff,27,0,30,3
1650001867687,MATH 18,B01,083748,Staff,0,6,30,30
1650001867687,MATH 18,B02,083749,Staff,0,5,30,30
1650001867687,MATH 18,B03,083750,Staff,0,6,30,30
1650001867687,MATH 18,B04,083751,Staff,0,5,30,30
1650001873710,MATH 20A,A01,083754,Staff,28,0,40,12
1650001879738,MATH 20B,A01,083756,Staff,0,4,30,30
1650001879738,MATH 20B,A02,083757,Staff,7,0,30,23
1650001885762,MATH 20C,A01,083760,Staff,0,9,30,30
1650001885762,MATH 20C,A02,083761,Staff,0,10,30,30
1650001885762,MATH 20C,B01,083762,Staff,17,0,30,13
1650001885762,MATH 20C,B02,083763,Staff,30,0,30,0
1650001891807,MATH 20D,A01,083765,Staff,0,2,30,30
1650001891807,MATH 20D,A02,083766,Staff,17,0,30,13
1650001891807,MATH 20D,A03,083767,Staff,28,0,30,2
1650001897835,MATH 20E,A01,083771,Staff,11,0,30,19
1650001897835,MATH 20E,A02,083772,Staff,20,0,30,10
1650001897835,MATH 20E,B01,083773,Staff,0,0,30,30
1650001897835,MATH 20E,B02,083774,Staff,22,0,30,8
1650001903858,MATH 103A,A01,083777,Staff,0,5,30,30
1650001903858,MATH 103A,A02,083778,Staff,0,7,30,30
1650001903858,MATH 103A,B01,083779,Staff,0,6,30,30
1650001903858,MATH 103A,B02,083780,Staff,0,6,30,30
1650001909893,MATH 105,A01,085443,Staff,0,11,30,30
1650001915918,MATH 109,A01,083213,Anzaldo; Leesa B,0,3,30,30
1650001915918,MATH 109,A02,083214,Anzaldo; Leesa B,0,3,30,30
1650001915918,MATH 109,B01,083215,Anzaldo; Leesa B,0,2,30,30
1650001915918,MATH 109,B02,083216,Anzaldo; Leesa B,0,2,30,30
1650001921948,MATH 142A,A01,083219,Chow; Bennett,0,7,30,30
1650001921948,MATH 142A,A02,083220,Chow; Bennett,0,7,30,30
1650001921948,MATH 142A,B01,083221,Chow; Bennett,0,7,30,30
1650001921948,MATH 142A,B02,083222,Chow; Bennett,0,7,30,30
1650001927972,MATH 193A,A01,083224,Staff,0,6,30,30
1650001927972,MATH 193A,A02,083225,Staff,0,4,30,30
1650001927972,MATH 193A,A03,083781,Staff,0,0,30,30
1650001927972,MATH 193A,A04,083782,Staff,10,0,30,20
1650001933994,MATH 197,001,091859,McAuley; Julian John,9999,0,9999,0
1650001940073,COGS 9,A01,083615,Staff,1,14,60,59
1650001946097,COGS 11,A01,083617,Boyle; Mary E. T.,25,0,40,15
1650001952121,COGS 13,A01,083071,Staff,0,27,40,40
1650001958145,COGS 14A,A01,092681,Staff,0,5,100,100
1650001964177,COGS 14B,A01,083073,Cheng; Tzu-Han,0,1,50,50
1650001970204,COGS 17,A01,092677,Staff,35,0,75,40
1650001976230,COGS 100,A01,083619,Staff,0,17,60,60
1650001982255,COGS 101A,A01,083621,Davis; Joshua Daniel,0,17,60,60
1650001988277,COGS 101B,A01,091572,Staff,17,0,60,43
1650001994300,COGS 101C,A01,083625,Delgado; Tania,21,0,30,9
1650002000322,COGS 107A,A01,083627,Boyle; Mary E. T.,0,1,60,60
1650002006350,COGS 118A,A01,083075,Staff,19,0,60,41
1650002012374,CSE 3,A50,083646,Miranda; Gregory Joseph,22,0,38,16
1650002012374,CSE 3,A51,083647,Miranda; Gregory Joseph,37,0,37,0
1650002018402,CSE 8A,A50,083650,Miranda; Gregory Joseph,0,13,40,40
1650002024426,CSE 11,A01,083080,Cao; Yingjun,0,57,40,40
1650002030454,CSE 12,A01,083652,Staff,5,0,100,95
1650002036481,CSE 15L,A01,083654,Staff,0,0,50,50
1650002036481,CSE 15L,A02,083655,Staff,18,0,50,32
1650002042504,CSE 20,A01,083657,Staff,57,0,80,23
1650002048528,CSE 30,A01,083084,Eldon; John,0,61,40,40
1650002054557,CSE 100,A01,083659,Cao; Yingjun,0,57,50,50
1650002060582,CSE 134B,A01,083661,Powell; Thomas Allan,0,24,65,65
1650002066611,CSE 140,A01,083663,Staff,8,0,75,67
1650002072635,CSE 140L,A01,083088,Eldon; John,4,0,75,71
1650002078662,CSE 175,A01,083665,Kumar; Rakesh,10,0,25,15
1650002084690,CSE 190,A00,092507,Dubnov; Shlomo,17,0,20,3
1650002090714,ECE 45,A01,083139,Staff,0,8,40,40
1650002096737,ECE 65,A50,083695,Staff,0,1,30,30
1650002102764,ECE 109,A01,091882,Touri; Behrouz,49,0,70,21
1650002108808,ECE 180,A00,083140,Abi Samra; Nicholas Camill,26,0,30,4
1650002108808,ECE 180,B00,083141,Abi Samra; Nicholas Camill,10,0,30,20
1650002114841,MATH 10A,A01,083735,Patchell; Gregory David,14,0,30,16
1650002114841,MATH 10A,A02,083736,Patchell; Gregory David,28,0,30,2
1650002114841,MATH 10A,A03,083737,Patchell; Gregory David,27,0,30,3
1650002120864,MATH 10B,A01,083207,Staff,0,4,30,30
1650002120864,MATH 10B,A02,083208,Staff,2,0,30,28
1650002120864,MATH 10B,B01,083739,Staff,20,0,30,10
1650002120864,MATH 10B,B02,083740,Staff,30,0,30,0
1650002126890,MATH 18,A01,083743,Staff,11,0,30,19
1650002126890,MATH 18,A02,083744,Staff,28,0,30,2
1650002126890,MATH 18,A03,083745,Staff,23,0,30,7
1650002126890,MATH 18,A04,083746,Staff,27,0,30,3
1650002126890,MATH 18,B01,083748,Staff,0,6,30,30
1650002126890,MATH 18,B02,083749,Staff,0,5,30,30
1650002126890,MATH 18,B03,083750,Staff,0,6,30,30
1650002126890,MATH 18,B04,083751,Staff,0,5,30,30
1650002132913,MATH 20A,A01,083754,Staff,28,0,40,12
1650002138939,MATH 20B,A01,083756,Staff,0,4,30,30
1650002138939,MATH 20B,A02,083757,Staff,7,0,30,23
1650002144968,MATH 20C,A01,083760,Staff,0,9,30,30
1650002144968,MATH 20C,A02,083761,Staff,0,11,30,30
1650002144968,MATH 20C,B01,083762,Staff,17,0,30,13
1650002144968,MATH 20C,B02,083763,Staff,30,0,30,0
1650002150998,MATH 20D,A01,083765,Staff,0,2,30,30
1650002150998,MATH 20D,A02,083766,Staff,17,0,30,13
1650002150998,MATH 20D,A03,083767,Staff,28,0,30,2
1650002157021,MATH 20E,A01,083771,Staff,11,0,30,19
1650002157021,MATH 20E,A02,083772,Staff,20,0,30,10
1650002157021,MATH 20E,B01,083773,Staff,0,0,30,30
1650002157021,MATH 20E,B02,083774,Staff,22,0,30,8
1650002163045,MATH 103A,A01,083777,Staff,0,5,30,30
1650002163045,MATH 103A,A02,083778,Staff,0,7,30,30
1650002163045,MATH 103A,B01,083779,Staff,0,6,30,30
1650002163045,MATH 103A,B02,083780,Staff,0,6,30,30
1650002169067,MATH 105,A01,085443,Staff,0,11,30,30
1650002175092,MATH 109,A01,083213,Anzaldo; Leesa B,0,3,30,30
1650002175092,MATH 109,A02,083214,Anzaldo; Leesa B,0,3,30,30
1650002175092,MATH 109,B01,083215,Anzaldo; Leesa B,0,2,30,30
1650002175092,MATH 109,B02,083216,Anzaldo; Leesa B,0,2,30,30
1650002181117,MATH 142A,A01,083219,Chow; Bennett,0,7,30,30
1650002181117,MATH 142A,A02,083220,Chow; Bennett,0,7,30,30
1650002181117,MATH 142A,B01,083221,Chow; Bennett,0,7,30,30
1650002181117,MATH 142A,B02,083222,Chow; Bennett,0,7,30,30
1650002187139,MATH 193A,A01,083224,Staff,0,6,30,30
1650002187139,MATH 193A,A02,083225,Staff,0,4,30,30
1650002187139,MATH 193A,A03,083781,Staff,0,0,30,30
1650002187139,MATH 193A,A04,083782,Staff,10,0,30,20
1650002193166,MATH 197,001,091859,McAuley; Julian John,9999,0,9999,0
1650002199241,COGS 9,A01,083615,Staff,1,14,60,59
1650002205264,COGS 11,A01,083617,Boyle; Mary E. T.,25,0,40,15
1650002211286,COGS 13,A01,083071,Staff,0,27,40,40
1650002217336,COGS 14A,A01,092681,Staff,0,5,100,100
1650002223358,COGS 14B,A01,083073,Cheng; Tzu-Han,0,2,50,50
1650002229385,COGS 17,A01,092677,Staff,35,0,75,40
1650002235412,COGS 100,A01,083619,Staff,0,17,60,60
1650002241436,COGS 101A,A01,083621,Davis; Joshua Daniel,0,17,60,60
1650002247459,COGS 101B,A01,091572,Staff,17,0,60,43
1650002253494,COGS 101C,A01,083625,Delgado; Tania,21,0,30,9
1650002259523,COGS 107A,A01,083627,Boyle; Mary E. T.,0,1,60,60
1650002265550,COGS 118A,A01,083075,Staff,19,0,60,41
1650002271574,CSE 3,A50,083646,Miranda; Gregory Joseph,22,0,38,16
1650002271574,CSE 3,A51,083647,Miranda; Gregory Joseph,37,0,37,0
1650002277613,CSE 8A,A50,083650,Miranda; Gregory Joseph,0,13,40,40
1650002283644,CSE 11,A01,083080,Cao; Yingjun,0,57,40,40
1650002289692,CSE 12,A01,083652,Staff,5,0,100,95
1650002295721,CSE 15L,A01,083654,Staff,0,0,50,50
1650002295721,CSE 15L,A02,083655,Staff,18,0,50,32
1650002301746,CSE 20,A01,083657,Staff,57,0,80,23
1650002307770,CSE 30,A01,083084,Eldon; John,0,61,40,40
1650002313793,CSE 100,A01,083659,Cao; Yingjun,0,57,50,50
1650002319817,CSE 134B,A01,083661,Powell; Thomas Allan,0,24,65,65
1650002325848,CSE 140,A01,083663,Staff,8,0,75,67
1650002331874,CSE 140L,A01,083088,Eldon; John,4,0,75,71
1650002337901,CSE 175,A01,083665,Kumar; Rakesh,10,0,25,15
1650002343925,CSE 190,A00,092507,Dubnov; Shlomo,17,0,20,3
1650002349948,ECE 45,A01,083139,Staff,0,8,40,40
1650002355974,ECE 65,A50,083695,Staff,0,1,30,30
1650002361998,ECE 109,A01,091882,Touri; Behrouz,49,0,70,21
1650002368025,ECE 180,A00,083140,Abi Samra; Nicholas Camill,26,0,30,4
1650002368025,ECE 180,B00,083141,Abi Samra; Nicholas Camill,10,0,30,20
1650002374053,MATH 10A,A01,083735,Patchell; Gregory David,14,0,30,16
1650002374053,MATH 10A,A02,083736,Patchell; Gregory David,28,0,30,2
1650002374053,MATH 10A,A03,083737,Patchell; Gregory David,27,0,30,3
1650002380076,MATH 10B,A01,083207,Staff,0,4,30,30
1650002380076,MATH 10B,A02,083208,Staff,1,0,30,29
1650002380076,MATH 10B,B01,083739,Staff,20,0,30,10
1650002380076,MATH 10B,B02,083740,Staff,30,0,30,0
1650002386158,MATH 18,A01,083743,Staff,11,0,30,19
1650002386158,MATH 18,A02,083744,Staff,28,0,30,2
1650002386158,MATH 18,A03,083745,Staff,23,0,30,7
1650002386158,MATH 18,A04,083746,Staff,27,0,30,3
1650002386158,MATH 18,B01,083748,Staff,0,6,30,30
1650002386158,MATH 18,B02,083749,Staff,0,5,30,30
1650002386158,MATH 18,B03,083750,Staff,0,6,30,30
1650002386158,MATH 18,B04,083751,Staff,0,5,30,30
1650002392181,MATH 20A,A01,083754,Staff,28,0,40,12
1650002398206,MATH 20B,A01,083756,Staff,0,4,30,30
1650002398206,MATH 20B,A02,083757,Staff,7,0,30,23
1650002404235,MATH 20C,A01,083760,Staff,0,9,30,30
1650002404235,MATH 20C,A02,083761,Staff,0,10,30,30
1650002404235,MATH 20C,B01,083762,Staff,17,0,30,13
1650002404235,MATH 20C,B02,083763,Staff,30,0,30,0
1650002410261,MATH 20D,A01,083765,Staff,0,2,30,30
1650002410261,MATH 20D,A02,083766,Staff,17,0,30,13
1650002410261,MATH 20D,A03,083767,Staff,28,0,30,2
1650002416288,MATH 20E,A01,083771,Staff,11,0,30,19
1650002416288,MATH 20E,A02,083772,Staff,20,0,30,10
1650002416288,MATH 20E,B01,083773,Staff,0,0,30,30
1650002416288,MATH 20E,B02,083774,Staff,22,0,30,8
1650002422314,MATH 103A,A01,083777,Staff,0,5,30,30
1650002422314,MATH 103A,A02,083778,Staff,0,7,30,30
1650002422314,MATH 103A,B01,083779,Staff,0,6,30,30
1650002422314,MATH 103A,B02,083780,Staff,0,6,30,30
1650002428342,MATH 105,A01,085443,Staff,0,11,30,30
1650002434367,MATH 109,A01,083213,Anzaldo; Leesa B,0,3,30,30
1650002434367,MATH 109,A02,083214,Anzaldo; Leesa B,0,3,30,30
1650002434367,MATH 109,B01,083215,Anzaldo; Leesa B,0,2,30,30
1650002434367,MATH 109,B02,083216,Anzaldo; Leesa B,0,2,30,30
1650002440390,MATH 142A,A01,083219,Chow; Bennett,0,7,30,30
1650002440390,MATH 142A,A02,083220,Chow; Bennett,0,7,30,30
1650002440390,MATH 142A,B01,083221,Chow; Bennett,0,7,30,30
1650002440390,MATH 142A,B02,083222,Chow; Bennett,0,7,30,30
1650002446423,MATH 193A,A01,083224,Staff,0,6,30,30
1650002446423,MATH 193A,A02,083225,Staff,0,4,30,30
1650002446423,MATH 193A,A03,083781,Staff,0,0,30,30
1650002446423,MATH 193A,A04,083782,Staff,10,0,30,20
1650002452446,MATH 197,001,091859,McAuley; Julian John,9999,0,9999,0
1650002458600,COGS 9,A01,083615,Staff,1,16,60,59
1650002464624,COGS 11,A01,083617,Boyle; Mary E. T.,25,0,40,15
1650002470650,COGS 13,A01,083071,Staff,0,27,40,40
1650002476683,COGS 14A,A01,092681,Staff,0,5,100,100
1650002482712,COGS 14B,A01,083073,Cheng; Tzu-Han,0,2,50,50
1650002488739,COGS 17,A01,092677,Staff,35,0,75,40
1650002494766,COGS 100,A01,083619,Staff,0,17,60,60
1650002500790,COGS 101A,A01,083621,Davis; Joshua Daniel,0,17,60,60
1650002506816,COGS 101B,A01,091572,Staff,17,0,60,43
1650002512843,COGS 101C,A01,083625,Delgado; Tania,21,0,30,9
1650002518871,COGS 107A,A01,083627,Boyle; Mary E. T.,0,1,60,60
1650002524894,COGS 118A,A01,083075,Staff,19,0,60,41
1650002530927,CSE 3,A50,083646,Miranda; Gregory Joseph,22,0,38,16
1650002530927,CSE 3,A51,083647,Miranda; Gregory Joseph,37,0,37,0
1650002536957,CSE 8A,A50,083650,Miranda; Gregory Joseph,0,13,40,40
1650002542988,CSE 11,A01,083080,Cao; Yingjun,0,57,40,40
1650002549016,CSE 12,A01,083652,Staff,5,0,100,95
1650002555038,CSE 15L,A01,083654,Staff,0,0,50,50
1650002555038,CSE 15L,A02,083655,Staff,18,0,50,32
1650002561064,CSE 20,A01,083657,Staff,57,0,80,23
1650002567091,CSE 30,A01,083084,Eldon; John,0,61,40,40
1650002573117,CSE 100,A01,083659,Cao; Yingjun,0,57,50,50
1650002579143,CSE 134B,A01,083661,Powell; Thomas Allan,0,24,65,65
1650002585173,CSE 140,A01,083663,Staff,8,0,75,67
1650002591196,CSE 140L,A01,083088,Eldon; John,4,0,75,71
1650002597220,CSE 175,A01,083665,Kumar; Rakesh,10,0,25,15
1650002603245,CSE 190,A00,092507,Dubnov; Shlomo,17,0,20,3
1650002609267,ECE 45,A01,083139,Staff,0,8,40,40
1650002615293,ECE 65,A50,083695,Staff,0,1,30,30
1650002621316,ECE 109,A01,091882,Touri; Behrouz,49,0,70,21
1650002627343,ECE 180,A00,083140,Abi Samra; Nicholas Camill,26,0,30,4
1650002627343,ECE 180,B00,083141,Abi Samra; Nicholas Camill,10,0,30,20
1650002633366,MATH 10A,A01,083735,Patchell; Gregory David,14,0,30,16
1650002633366,MATH 10A,A02,083736,Patchell; Gregory David,28,0,30,2
1650002633366,MATH 10A,A03,083737,Patchell; Gregory David,27,0,30,3
1650002639393,MATH 10B,A01,083207,Staff,0,4,30,30
1650002639393,MATH 10B,A02,083208,Staff,1,0,30,29
1650002639393,MATH 10B,B01,083739,Staff,20,0,30,10
1650002639393,MATH 10B,B02,083740,Staff,30,0,30,0
1650002645421,MATH 18,A01,083743,Staff,11,0,30,19
1650002645421,MATH 18,A02,083744,Staff,28,0,30,2
1650002645421,MATH 18,A03,083745,Staff,23,0,30,7
1650002645421,MATH 18,A04,083746,Staff,27,0,30,3
1650002645421,MATH 18,B01,083748,Staff,0,6,30,30
1650002645421,MATH 18,B02,083749,Staff,0,5,30,30
1650002645421,MATH 18,B03,083750,Staff,0,6,30,30
1650002645421,MATH 18,B04,083751,Staff,0,5,30,30
1650002651449,MATH 20A,A01,083754,Staff,28,0,40,12
1650002657476,MATH 20B,A01,083756,Staff,0,4,30,30
1650002657476,MATH 20B,A02,083757,Staff,7,0,30,23
1650002663504,MATH 20C,A01,083760,Staff,0,9,30,30
1650002663504,MATH 20C,A02,083761,Staff,0,10,30,30
1650002663504,MATH 20C,B01,083762,Staff,17,0,30,13
1650002663504,MATH 20C,B02,083763,Staff,29,0,30,1
1650002669535,MATH 20D,A01,083765,Staff,0,2,30,30
1650002669535,MATH 20D,A02,083766,Staff,17,0,30,13
1650002669535,MATH 20D,A03,083767,Staff,28,0,30,2
1650002675566,MATH 20E,A01,083771,Staff,11,0,30,19
1650002675566,MATH 20E,A02,083772,Staff,20,0,30,10
1650002675566,MATH 20E,B01,083773,Staff,0,0,30,30
1650002675566,MATH 20E,B02,083774,Staff,22,0,30,8
1650002681595,MATH 103A,A01,083777,Staff,0,5,30,30
1650002681595,MATH 103A,A02,083778,Staff,0,7,30,30
1650002681595,MATH 103A,B01,083779,Staff,0,6,30,30
1650002681595,MATH 103A,B02,083780,Staff,0,6,30,30
1650002687619,MATH 105,A01,085443,Staff,0,11,30,30
1650002693648,MATH 109,A01,083213,Anzaldo; Leesa B,0,3,30,30
1650002693648,MATH 109,A02,083214,Anzaldo; Leesa B,0,3,30,30
1650002693648,MATH 109,B01,083215,Anzaldo; Leesa B,0,2,30,30
1650002693648,MATH 109,B02,083216,Anzaldo; Leesa B,0,2,30,30
1650002699673,MATH 142A,A01,083219,Chow; Bennett,0,7,30,30
1650002699673,MATH 142A,A02,083220,Chow; Bennett,0,7,30,30
1650002699673,MATH 142A,B01,083221,Chow; Bennett,0,7,30,30
1650002699673,MATH 142A,B02,083222,Chow; Bennett,0,7,30,30
1650002705708,MATH 193A,A01,083224,Staff,0,6,30,30
1650002705708,MATH 193A,A02,083225,Staff,0,4,30,30
1650002705708,MATH 193A,A03,083781,Staff,0,0,30,30
1650002705708,MATH 193A,A04,083782,Staff,10,0,30,20
1650002711734,MATH 197,001,091859,McAuley; Julian John,9999,0,9999,0
1650002717795,COGS 9,A01,083615,Staff,1,16,60,59
1650002723819,COGS 11,A01,083617,Boyle; Mary E. T.,25,0,40,15
1650002729843,COGS 13,A01,083071,Staff,0,27,40,40
1650002735867,COGS 14A,A01,092681,Staff,0,5,100,100
1650002741899,COGS 14B,A01,083073,Cheng; Tzu-Han,0,2,50,50
1650002747924,COGS 17,A01,092677,Staff,35,0,75,40
1650002753951,COGS 100,A01,083619,Staff,0,17,60,60
1650002759981,COGS 101A,A01,083621,Davis; Joshua Daniel,0,17,60,60
1650002766016,COGS 101B,A01,091572,Staff,17,0,60,43
1650002772041,COGS 101C,A01,083625,Delgado; Tania,21,0,30,9
1650002778074,COGS 107A,A01,083627,Boyle; Mary E. T.,0,1,60,60
1650002784098,COGS 118A,A01,083075,Staff,19,0,60,41
1650002790127,CSE 3,A50,083646,Miranda; Gregory Joseph,22,0,38,16
1650002790127,CSE 3,A51,083647,Miranda; Gregory Joseph,37,0,37,0
1650002796150,CSE 8A,A50,083650,Miranda; Gregory Joseph,0,13,40,40
1650002802180,CSE 11,A01,083080,Cao; Yingjun,0,57,40,40
1650002808211,CSE 12,A01,083652,Staff,5,0,100,95
1650002814234,CSE 15L,A01,083654,Staff,0,0,50,50
1650002814234,CSE 15L,A02,083655,Staff,18,0,50,32
1650002820257,CSE 20,A01,083657,Staff,57,0,80,23
1650002826281,CSE 30,A01,083084,Eldon; John,0,61,40,40
1650002832306,CSE 100,A01,083659,Cao; Yingjun,0,57,50,50
1650002838328,CSE 134B,A01,083661,Powell; Thomas Allan,0,24,65,65
1650002844352,CSE 140,A01,083663,Staff,8,0,75,67
1650002850377,CSE 140L,A01,083088,Eldon; John,4,0,75,71
1650002856400,CSE 175,A01,083665,Kumar; Rakesh,10,0,25,15
1650002862428,CSE 190,A00,092507,Dubnov; Shlomo,17,0,20,3
1650002868454,ECE 45,A01,083139,Staff,0,8,40,40
1650002874486,ECE 65,A50,083695,Staff,0,1,30,30
1650002880519,ECE 109,A01,091882,Touri; Behrouz,49,0,70,21
1650002886552,ECE 180,A00,083140,Abi Samra; Nicholas Camill,26,0,30,4
1650002886552,ECE 180,B00,083141,Abi Samra; Nicholas Camill,10,0,30,20
1650002892581,MATH 10A,A01,083735,Patchell; Gregory David,14,0,30,16
1650002892581,MATH 10A,A02,083736,Patchell; Gregory David,28,0,30,2
1650002892581,MATH 10A,A03,083737,Patchell; Gregory David,27,0,30,3
1650002898610,MATH 10B,A01,083207,Staff,0,4,30,30
1650002898610,MATH 10B,A02,083208,Staff,1,0,30,29
1650002898610,MATH 10B,B01,083739,Staff,20,0,30,10
1650002898610,MATH 10B,B02,083740,Staff,30,0,30,0
1650002904641,MATH 18,A01,083743,Staff,11,0,30,19
1650002904641,MATH 18,A02,083744,Staff,28,0,30,2
1650002904641,MATH 18,A03,083745,Staff,23,0,30,7
1650002904641,MATH 18,A04,083746,Staff,27,0,30,3
1650002904641,MATH 18,B01,083748,Staff,0,6,30,30
1650002904641,MATH 18,B02,083749,Staff,0,5,30,30
1650002904641,MATH 18,B03,083750,Staff,0,6,30,30
1650002904641,MATH 18,B04,083751,Staff,0,5,30,30
1650002910667,MATH 20A,A01,083754,Staff,28,0,40,12
1650002916694,MATH 20B,A01,083756,Staff,0,4,30,30
1650002916694,MATH 20B,A02,083757,Staff,7,0,30,23
1650002922719,MATH 20C,A01,083760,Staff,0,9,30,30
1650002922719,MATH 20C,A02,083761,Staff,0,10,30,30
1650002922719,MATH 20C,B01,083762,Staff,17,0,30,13
1650002922719,MATH 20C,B02,083763,Staff,29,0,30,1
1650002928743,MATH 20D,A01,083765,Staff,0,2,30,30
1650002928743,MATH 20D,A02,083766,Staff,17,0,30,13
1650002928743,MATH 20D,A03,083767,Staff,28,0,30,2
1650002934772,MATH 20E,A01,083771,Staff,11,0,30,19
1650002934772,MATH 20E,A02,083772,Staff,20,0,30,10
1650002934772,MATH 20E,B01,083773,Staff,0,0,30,30
1650002934772,MATH 20E,B02,083774,Staff,22,0,30,8
1650002940795,MATH 103A,A01,083777,Staff,0,6,30,30
1650002940795,MATH 103A,A02,083778,Staff,0,7,30,30
1650002940795,MATH 103A,B01,083779,Staff,0,6,30,30
1650002940795,MATH 103A,B02,083780,Staff,0,6,30,30
1650002946818,MATH 105,A01,085443,Staff,0,11,30,30
1650002952843,MATH 109,A01,083213,Anzaldo; Leesa B,0,3,30,30
1650002952843,MATH 109,A02,083214,Anzaldo; Leesa B,0,3,30,30
1650002952843,MATH 109,B01,083215,Anzaldo; Leesa B,0,2,30,30
1650002952843,MATH 109,B02,083216,Anzaldo; Leesa B,0,2,30,30
1650002958887,MATH 142A,A01,083219,Chow; Bennett,0,7,30,30
1650002958887,MATH 142A,A02,083220,Chow; Bennett,0,7,30,30
1650002958887,MATH 142A,B01,083221,Chow; Bennett,0,7,30,30
1650002958887,MATH 142A,B02,083222,Chow; Bennett,0,7,30,30
1650002964910,MATH 193A,A01,083224,Staff,0,5,30,30
1650002964910,MATH 193A,A02,083225,Staff,0,4,30,30
1650002964910,MATH 193A,A03,083781,Staff,0,0,30,30
1650002964910,MATH 193A,A04,083782,Staff,9,0,30,21
1650002970945,MATH 197,001,091859,McAuley; Julian John,9999,0,9999,0
1650002976999,COGS 9,A01,083615,Staff,1,16,60,59
1650002983021,COGS 11,A01,083617,Boyle; Mary E. T.,25,0,40,15
1650002989055,COGS 13,A01,083071,Staff,0,27,40,40
1650002995082,COGS 14A,A01,092681,Staff,0,5,100,100
1650003001122,COGS 14B,A01,083073,Cheng; Tzu-Han,0,2,50,50
1650003007147,COGS 17,A01,092677,Staff,35,0,75,40
1650003013179,COGS 100,A01,083619,Staff,0,17,60,60
1650003019206,COGS 101A,A01,083621,Davis; Joshua Daniel,0,17,60,60
1650003025232,COGS 101B,A01,091572,Staff,17,0,60,43
1650003031259,COGS 101C,A01,083625,Delgado; Tania,21,0,30,9
1650003037287,COGS 107A,A01,083627,Boyle; Mary E. T.,0,1,60,60
1650003043317,COGS 118A,A01,083075,Staff,19,0,60,41
1650003049341,CSE 3,A50,083646,Miranda; Gregory Joseph,22,0,38,16
1650003049341,CSE 3,A51,083647,Miranda; Gregory Joseph,37,0,37,0
1650003055458,CSE 8A,A50,083650,Miranda; Gregory Joseph,0,13,40,40
1650003061486,CSE 11,A01,083080,Cao; Yingjun,0,57,40,40
1650003067512,CSE 12,A01,083652,Staff,5,0,100,95
1650003073536,CSE 15L,A01,083654,Staff,0,0,50,50
1650003073536,CSE 15L,A02,083655,Staff,18,0,50,32
1650003079561,CSE 20,A01,083657,Staff,57,0,80,23
1650003085592,CSE 30,A01,083084,Eldon; John,0,61,40,40
1650003091624,CSE 100,A01,083659,Cao; Yingjun,0,57,50,50
1650003097664,CSE 134B,A01,083661,Powell; Thomas Allan,0,24,65,65
1650003103690,CSE 140,A01,083663,Staff,8,0,75,67
1650003109713,CSE 140L,A01,083088,Eldon; John,4,0,75,71
1650003115736,CSE 175,A01,083665,Kumar; Rakesh,10,0,25,15
1650003121761,CSE 190,A00,092507,Dubnov; Shlomo,17,0,20,3
1650003127786,ECE 45,A01,083139,Staff,0,8,40,40
1650003133809,ECE 65,A50,083695,Staff,0,1,30,30
1650003139846,ECE 109,A01,091882,Touri; Behrouz,49,0,70,21
1650003145875,ECE 180,A00,083140,Abi Samra; Nicholas Camill,26,0,30,4
1650003145875,ECE 180,B00,083141,Abi Samra; Nicholas Camill,10,0,30,20
1650003151901,MATH 10A,A01,083735,Patchell; Gregory David,14,0,30,16
1650003151901,MATH 10A,A02,083736,Patchell; Gregory David,28,0,30,2
1650003151901,MATH 10A,A03,083737,Patchell; Gregory David,27,0,30,3
1650003157922,MATH 10B,A01,083207,Staff,0,4,30,30
1650003157922,MATH 10B,A02,083208,Staff,1,0,30,29
1650003157922,MATH 10B,B01,083739,Staff,20,0,30,10
1650003157922,MATH 10B,B02,083740,Staff,30,0,30,0
1650003163953,MATH 18,A01,083743,Staff,11,0,30,19
1650003163953,MATH 18,A02,083744,Staff,28,0,30,2
1650003163953,MATH 18,A03,083745,Staff,23,0,30,7
1650003163953,MATH 18,A04,083746,Staff,27,0,30,3
1650003163953,MATH 18,B01,083748,Staff,0,6,30,30
1650003163953,MATH 18,B02,083749,Staff,0,5,30,30
1650003163953,MATH 18,B03,083750,Staff,0,6,30,30
1650003163953,MATH 18,B04,083751,Staff,0,5,30,30
1650003169979,MATH 20A,A01,083754,Staff,28,0,40,12
1650003176005,MATH 20B,A01,083756,Staff,0,4,30,30
1650003176005,MATH 20B,A02,083757,Staff,7,0,30,23
1650003182028,MATH 20C,A01,083760,Staff,0,9,30,30
1650003182028,MATH 20C,A02,083761,Staff,0,10,30,30
1650003182028,MATH 20C,B01,083762,Staff,17,0,30,13
1650003182028,MATH 20C,B02,083763,Staff,29,0,30,1
1650003188052,MATH 20D,A01,083765,Staff,0,2,30,30
1650003188052,MATH 20D,A02,083766,Staff,17,0,30,13
1650003188052,MATH 20D,A03,083767,Staff,28,0,30,2
1650003194080,MATH 20E,A01,083771,Staff,11,0,30,19
1650003194080,MATH 20E,A02,083772,Staff,20,0,30,10
1650003194080,MATH 20E,B01,083773,Staff,0,0,30,30
1650003194080,MATH 20E,B02,083774,Staff,22,0,30,8
1650003200109,MATH 103A,A01,083777,Staff,0,6,30,30
1650003200109,MATH 103A,A02,083778,Staff,0,7,30,30
1650003200109,MATH 103A,B01,083779,Staff,0,6,30,30
1650003200109,MATH 103A,B02,083780,Staff,0,6,30,30
1650003206143,MATH 105,A01,085443,Staff,0,11,30,30
1650003212167,MATH 109,A01,083213,Anzaldo; Leesa B,0,3,30,30
1650003212167,MATH 109,A02,083214,Anzaldo; Leesa B,0,3,30,30
1650003212167,MATH 109,B01,083215,Anzaldo; Leesa B,0,2,30,30
1650003212167,MATH 109,B02,083216,Anzaldo; Leesa B,0,2,30,30
1650003218190,MATH 142A,A01,083219,Chow; Bennett,0,7,30,30
1650003218190,MATH 142A,A02,083220,Chow; Bennett,0,7,30,30
1650003218190,MATH 142A,B01,083221,Chow; Bennett,0,7,30,30
1650003218190,MATH 142A,B02,083222,Chow; Bennett,0,7,30,30
1650003224227,MATH 193A,A01,083224,Staff,0,5,30,30
1650003224227,MATH 193A,A02,083225,Staff,0,4,30,30
1650003224227,MATH 193A,A03,083781,Staff,0,0,30,30
1650003224227,MATH 193A,A04,083782,Staff,9,0,30,21
1650003230253,MATH 197,001,091859,McAuley; Julian John,9999,0,9999,0
1650003236325,COGS 9,A01,083615,Staff,1,16,60,59
1650003242348,COGS 11,A01,083617,Boyle; Mary E. T.,25,0,40,15
1650003248372,COGS 13,A01,083071,Staff,0,27,40,40
1650003254399,COGS 14A,A01,092681,Staff,0,5,100,100
1650003260436,COGS 14B,A01,083073,Cheng; Tzu-Han,0,2,50,50
1650003266462,COGS 17,A01,092677,Staff,35,0,75,40
1650003272486,COGS 100,A01,083619,Staff,0,17,60,60
1650003278510,COGS 101A,A01,083621,Davis; Joshua Daniel,0,17,60,60
1650003284534,COGS 101B,A01,091572,Staff,17,0,60,43
1650003290558,COGS 101C,A01,083625,Delgado; Tania,21,0,30,9
1650003296586,COGS 107A,A01,083627,Boyle; Mary E. T.,0,1,60,60
1650003302612,COGS 118A,A01,083075,Staff,19,0,60,41
1650003308644,CSE 3,A50,083646,Miranda; Gregory Joseph,22,0,38,16
1650003308644,CSE 3,A51,083647,Miranda; Gregory Joseph,37,0,37,0
1650003314671,CSE 8A,A50,083650,Miranda; Gregory Joseph,0,13,40,40
1650003320702,CSE 11,A01,083080,Cao; Yingjun,0,57,40,40
1650003326726,CSE 12,A01,083652,Staff,5,0,100,95
1650003332770,CSE 15L,A01,083654,Staff,0,0,50,50
1650003332770,CSE 15L,A02,083655,Staff,18,0,50,32
1650003338796,CSE 20,A01,083657,Staff,57,0,80,23
1650003344819,CSE 30,A01,083084,Eldon; John,0,61,40,40
1650003350843,CSE 100,A01,083659,Cao; Yingjun,0,57,50,50
1650003356870,CSE 134B,A01,083661,Powell; Thomas Allan,0,24,65,65
1650003362894,CSE 140,A01,083663,Staff,8,0,75,67
1650003368928,CSE 140L,A01,083088,Eldon; John,4,0,75,71
1650003374955,CSE 175,A01,083665,Kumar; Rakesh,10,0,25,15
1650003380993,CSE 190,A00,092507,Dubnov; Shlomo,17,0,20,3
1650003387024,ECE 45,A01,083139,Staff,0,8,40,40
1650003393052,ECE 65,A50,083695,Staff,0,1,30,30
1650003399077,ECE 109,A01,091882,Touri; Behrouz,49,0,70,21
1650003405100,ECE 180,A00,083140,Abi Samra; Nicholas Camill,26,0,30,4
1650003405100,ECE 180,B00,083141,Abi Samra; Nicholas Camill,10,0,30,20
1650003411125,MATH 10A,A01,083735,Patchell; Gregory David,14,0,30,16
1650003411125,MATH 10A,A02,083736,Patchell; Gregory David,28,0,30,2
1650003411125,MATH 10A,A03,083737,Patchell; Gregory David,27,0,30,3
1650003417154,MATH 10B,A01,083207,Staff,0,4,30,30
1650003417154,MATH 10B,A02,083208,Staff,1,0,30,29
1650003417154,MATH 10B,B01,083739,Staff,20,0,30,10
1650003417154,MATH 10B,B02,083740,Staff,30,0,30,0
1650003423181,MATH 18,A01,083743,Staff,11,0,30,19
1650003423181,MATH 18,A02,083744,Staff,28,0,30,2
1650003423181,MATH 18,A03,083745,Staff,23,0,30,7
1650003423181,MATH 18,A04,083746,Staff,27,0,30,3
1650003423181,MATH 18,B01,083748,Staff,0,6,30,30
1650003423181,MATH 18,B02,083749,Staff,0,5,30,30
1650003423181,MATH 18,B03,083750,Staff,0,6,30,30
1650003423181,MATH 18,B04,083751,Staff,0,5,30,30
1650003429216,MATH 20A,A01,083754,Staff,28,0,40,12
1650003435243,MATH 20B,A01,083756,Staff,0,4,30,30
1650003435243,MATH 20B,A02,083757,Staff,7,0,30,23
1650003441271,MATH 20C,A01,083760,Staff,0,9,30,30
1650003441271,MATH 20C,A02,083761,Staff,0,10,30,30
1650003441271,MATH 20C,B01,083762,Staff,17,0,30,13
1650003441271,MATH 20C,B02,083763,Staff,29,0,30,1
1650003447300,MATH 20D,A01,083765,Staff,0,2,30,30
1650003447300,MATH 20D,A02,083766,Staff,17,0,30,13
1650003447300,MATH 20D,A03,083767,Staff,28,0,30,2
1650003453329,MATH 20E,A01,083771,Staff,11,0,30,19
1650003453329,MATH 20E,A02,083772,Staff,20,0,30,10
1650003453329,MATH 20E,B01,083773,Staff,0,1,30,30
1650003453329,MATH 20E,B02,083774,Staff,22,0,30,8
1650003459354,MATH 103A,A01,083777,Staff,0,6,30,30
1650003459354,MATH 103A,A02,083778,Staff,0,7,30,30
1650003459354,MATH 103A,B01,083779,Staff,0,6,30,30
1650003459354,MATH 103A,B02,083780,Staff,0,6,30,30
1650003465386,MATH 105,A01,085443,Staff,0,11,30,30
1650003471412,MATH 109,A01,083213,Anzaldo; Leesa B,0,3,30,30
1650003471412,MATH 109,A02,083214,Anzaldo; Leesa B,0,3,30,30
1650003471412,MATH 109,B01,083215,Anzaldo; Leesa B,0,2,30,30
1650003471412,MATH 109,B02,083216,Anzaldo; Leesa B,0,2,30,30
1650003477439,MATH 142A,A01,083219,Chow; Bennett,0,7,30,30
1650003477439,MATH 142A,A02,083220,Chow; Bennett,0,7,30,30
1650003477439,MATH 142A,B01,083221,Chow; Bennett,0,7,30,30
1650003477439,MATH 142A,B02,083222,Chow; Bennett,0,7,30,30
1650003483490,MATH 193A,A01,083224,Staff,0,5,30,30
1650003483490,MATH 193A,A02,083225,Staff,0,4,30,30
1650003483490,MATH 193A,A03,083781,Staff,0,0,30,30
1650003483490,MATH 193A,A04,083782,Staff,9,0,30,21
1650003489520,MATH 197,001,091859,McAuley; Julian John,9999,0,9999,0
1650003495584,COGS 9,A01,083615,Staff,1,16,60,59
1650003501609,COGS 11,A01,083617,Boyle; Mary E. T.,25,0,40,15
1650003507632,COGS 13,A01,083071,Staff,0,28,40,40
1650003513666,COGS 14A,A01,092681,Staff,0,5,100,100
1650003519702,COGS 14B,A01,083073,Cheng; Tzu-Han,0,2,50,50
1650003525730,COGS 17,A01,092677,Staff,35,0,75,40
1650003531755,COGS 100,A01,083619,Staff,0,17,60,60
1650003537780,COGS 101A,A01,083621,Davis; Joshua Daniel,0,17,60,60
1650003543804,COGS 101B,A01,091572,Staff,17,0,60,43
1650003549834,COGS 101C,A01,083625,Delgado; Tania,21,0,30,9
1650003555861,COGS 107A,A01,083627,Boyle; Mary E. T.,0,1,60,60
1650003561897,COGS 118A,A01,083075,Staff,19,0,60,41
1650003567930,CSE 3,A50,083646,Miranda; Gregory Joseph,22,0,38,16
1650003567930,CSE 3,A51,083647,Miranda; Gregory Joseph,37,0,37,0
1650003573959,CSE 8A,A50,083650,Miranda; Gregory Joseph,0,13,40,40
1650003579986,CSE 11,A01,083080,Cao; Yingjun,0,57,40,40
1650003586010,CSE 12,A01,083652,Staff,5,0,100,95
1650003592034,CSE 15L,A01,083654,Staff,0,0,50,50
1650003592034,CSE 15L,A02,083655,Staff,18,0,50,32
1650003598063,CSE 20,A01,083657,Staff,57,0,80,23
1650003604088,CSE 30,A01,083084,Eldon; John,0,61,40,40
1650003610115,CSE 100,A01,083659,Cao; Yingjun,0,57,50,50
1650003616143,CSE 134B,A01,083661,Powell; Thomas Allan,0,24,65,65
1650003622176,CSE 140,A01,083663,Staff,8,0,75,67
1650003628207,CSE 140L,A01,083088,Eldon; John,4,0,75,71
1650003634232,CSE 175,A01,083665,Kumar; Rakesh,10,0,25,15
1650003640263,CSE 190,A00,092507,Dubnov; Shlomo,17,0,20,3
1650003646291,ECE 45,A01,083139,Staff,0,8,40,40
1650003652434,ECE 65,A50,083695,Staff,0,1,30,30
1650003658457,ECE 109,A01,091882,Touri; Behrouz,49,0,70,21
1650003664484,ECE 180,A00,083140,Abi Samra; Nicholas Camill,26,0,30,4
1650003664484,ECE 180,B00,083141,Abi Samra; Nicholas Camill,10,0,30,20
1650003670512,MATH 10A,A01,083735,Patchell; Gregory David,14,0,30,16
1650003670512,MATH 10A,A02,083736,Patchell; Gregory David,28,0,30,2
1650003670512,MATH 10A,A03,083737,Patchell; Gregory David,27,0,30,3
1650003676536,MATH 10B,A01,083207,Staff,0,4,30,30
1650003676536,MATH 10B,A02,083208,Staff,1,0,30,29
1650003676536,MATH 10B,B01,083739,Staff,20,0,30,10
1650003676536,MATH 10B,B02,083740,Staff,30,0,30,0
1650003682562,MATH 18,A01,083743,Staff,11,0,30,19
1650003682562,MATH 18,A02,083744,Staff,28,0,30,2
1650003682562,MATH 18,A03,083745,Staff,23,0,30,7
1650003682562,MATH 18,A04,083746,Staff,27,0,30,3
1650003682562,MATH 18,B01,083748,Staff,0,6,30,30
1650003682562,MATH 18,B02,083749,Staff,0,5,30,30
1650003682562,MATH 18,B03,083750,Staff,0,6,30,30
1650003682562,MATH 18,B04,083751,Staff,0,5,30,30
1650003688589,MATH 20A,A01,083754,Staff,28,0,40,12
1650003694613,MATH 20B,A01,083756,Staff,0,4,30,30
1650003694613,MATH 20B,A02,083757,Staff,7,0,30,23
1650003700647,MATH 20C,A01,083760,Staff,0,9,30,30
1650003700647,MATH 20C,A02,083761,Staff,0,10,30,30
1650003700647,MATH 20C,B01,083762,Staff,17,0,30,13
1650003700647,MATH 20C,B02,083763,Staff,29,0,30,1
1650003706671,MATH 20D,A01,083765,Staff,0,2,30,30
1650003706671,MATH 20D,A02,083766,Staff,17,0,30,13
1650003706671,MATH 20D,A03,083767,Staff,28,0,30,2
1650003712694,MATH 20E,A01,083771,Staff,11,0,30,19
1650003712694,MATH 20E,A02,083772,Staff,20,0,30,10
1650003712694,MATH 20E,B01,083773,Staff,0,1,30,30
1650003712694,MATH 20E,B02,083774,Staff,22,0,30,8
1650003718727,MATH 103A,A01,083777,Staff,0,6,30,30
1650003718727,MATH 103A,A02,083778,Staff,0,7,30,30
1650003718727,MATH 103A,B01,083779,Staff,0,6,30,30
1650003718727,MATH 103A,B02,083780,Staff,0,6,30,30
1650003724750,MATH 105,A01,085443,Staff,0,11,30,30
1650003730780,MATH 109,A01,083213,Anzaldo; Leesa B,0,3,30,30
1650003730780,MATH 109,A02,083214,Anzaldo; Leesa B,0,3,30,30
1650003730780,MATH 109,B01,083215,Anzaldo; Leesa B,0,2,30,30
1650003730780,MATH 109,B02,083216,Anzaldo; Leesa B,0,2,30,30
1650003736805,MATH 142A,A01,083219,Chow; Bennett,0,7,30,30
1650003736805,MATH 142A,A02,083220,Chow; Bennett,0,7,30,30
1650003736805,MATH 142A,B01,083221,Chow; Bennett,0,7,30,30
1650003736805,MATH 142A,B02,083222,Chow; Bennett,0,7,30,30
1650003742839,MATH 193A,A01,083224,Staff,0,5,30,30
1650003742839,MATH 193A,A02,083225,Staff,0,4,30,30
1650003742839,MATH 193A,A03,083781,Staff,0,0,30,30
1650003742839,MATH 193A,A04,083782,Staff,9,0,30,21
1650003748869,MATH 197,001,091859,McAuley; Julian John,9999,0,9999,0
1650003754929,COGS 9,A01,083615,Staff,1,16,60,59
1650003760952,COGS 11,A01,083617,Boyle; Mary E. T.,25,0,40,15
1650003766976,COGS 13,A01,083071,Staff,0,28,40,40
1650003773004,COGS 14A,A01,092681,Staff,0,5,100,100
1650003779031,COGS 14B,A01,083073,Cheng; Tzu-Han,0,2,50,50
1650003785058,COGS 17,A01,092677,Staff,35,0,75,40
1650003791089,COGS 100,A01,083619,Staff,0,17,60,60
1650003797121,COGS 101A,A01,083621,Davis; Joshua Daniel,0,16,60,60
1650003803146,COGS 101B,A01,091572,Staff,17,0,60,43
1650003809168,COGS 101C,A01,083625,Delgado; Tania,21,0,30,9
1650003815196,COGS 107A,A01,083627,Boyle; Mary E. T.,0,1,60,60
1650003821220,COGS 118A,A01,083075,Staff,19,0,60,41
1650003827245,CSE 3,A50,083646,Miranda; Gregory Joseph,22,0,38,16
1650003827245,CSE 3,A51,083647,Miranda; Gregory Joseph,37,0,37,0
1650003833268,CSE 8A,A50,083650,Miranda; Gregory Joseph,0,13,40,40
1650003839295,CSE 11,A01,083080,Cao; Yingjun,0,57,40,40
1650003845317,CSE 12,A01,083652,Staff,5,0,100,95
1650003851338,CSE 15L,A01,083654,Staff,0,0,50,50
1650003851338,CSE 15L,A02,083655,Staff,18,0,50,32
1650003857367,CSE 20,A01,083657,Staff,57,0,80,23
1650003863389,CSE 30,A01,083084,Eldon; John,0,61,40,40
1650003869417,CSE 100,A01,083659,Cao; Yingjun,0,57,50,50
1650003875439,CSE 134B,A01,083661,Powell; Thomas Allan,0,24,65,65
1650003881466,CSE 140,A01,083663,Staff,8,0,75,67
1650003887490,CSE 140L,A01,083088,Eldon; John,4,0,75,71
1650003893512,CSE 175,A01,083665,Kumar; Rakesh,10,0,25,15
1650003899556,CSE 190,A00,092507,Dubnov; Shlomo,17,0,20,3
1650003905581,ECE 45,A01,083139,Staff,0,8,40,40
1650003911605,ECE 65,A50,083695,Staff,0,1,30,30
1650003917631,ECE 109,A01,091882,Touri; Behrouz,49,0,70,21
1650003923663,ECE 180,A00,083140,Abi Samra; Nicholas Camill,26,0,30,4
1650003923663,ECE 180,B00,083141,Abi Samra; Nicholas Camill,10,0,30,20
1650003929688,MATH 10A,A01,083735,Patchell; Gregory David,14,0,30,16
1650003929688,MATH 10A,A02,083736,Patchell; Gregory David,28,0,30,2
1650003929688,MATH 10A,A03,083737,Patchell; Gregory David,27,0,30,3
1650003935712,MATH 10B,A01,083207,Staff,0,4,30,30
1650003935712,MATH 10B,A02,083208,Staff,1,0,30,29
1650003935712,MATH 10B,B01,083739,Staff,20,0,30,10
1650003935712,MATH 10B,B02,083740,Staff,30,0,30,0
1650003941745,MATH 18,A01,083743,Staff,11,0,30,19
1650003941745,MATH 18,A02,083744,Staff,28,0,30,2
1650003941745,MATH 18,A03,083745,Staff,23,0,30,7
1650003941745,MATH 18,A04,083746,Staff,27,0,30,3
1650003941745,MATH 18,B01,083748,Staff,0,6,30,30
1650003941745,MATH 18,B02,083749,Staff,0,5,30,30
1650003941745,MATH 18,B03,083750,Staff,0,6,30,30
1650003941745,MATH 18,B04,083751,Staff,0,6,30,30
1650003947771,MATH 20A,A01,083754,Staff,28,0,40,12
1650003953799,MATH 20B,A01,083756,Staff,0,4,30,30
1650003953799,MATH 20B,A02,083757,Staff,7,0,30,23
1650003959823,MATH 20C,A01,083760,Staff,0,9,30,30
1650003959823,MATH 20C,A02,083761,Staff,0,10,30,30
1650003959823,MATH 20C,B01,083762,Staff,17,0,30,13
1650003959823,MATH 20C,B02,083763,Staff,29,0,30,1
1650003965848,MATH 20D,A01,083765,Staff,0,2,30,30
1650003965848,MATH 20D,A02,083766,Staff,17,0,30,13
1650003965848,MATH 20D,A03,083767,Staff,28,0,30,2
1650003971872,MATH 20E,A01,083771,Staff,11,0,30,19
1650003971872,MATH 20E,A02,083772,Staff,20,0,30,10
1650003971872,MATH 20E,B01,083773,Staff,0,1,30,30
1650003971872,MATH 20E,B02,083774,Staff,22,0,30,8
1650003977896,MATH 103A,A01,083777,Staff,0,6,30,30
1650003977896,MATH 103A,A02,083778,Staff,0,7,30,30
1650003977896,MATH 103A,B01,083779,Staff,0,6,30,30
1650003977896,MATH 103A,B02,083780,Staff,0,6,30,30
1650003983924,MATH 105,A01,085443,Staff,0,11,30,30
1650003989947,MATH 109,A01,083213,Anzaldo; Leesa B,0,3,30,30
1650003989947,MATH 109,A02,083214,Anzaldo; Leesa B,0,3,30,30
1650003989947,MATH 109,B01,083215,Anzaldo; Leesa B,0,2,30,30
1650003989947,MATH 109,B02,083216,Anzaldo; Leesa B,0,2,30,30
1650003995973,MATH 142A,A01,083219,Chow; Bennett,0,7,30,30
1650003995973,MATH 142A,A02,083220,Chow; Bennett,0,7,30,30
1650003995973,MATH 142A,B01,083221,Chow; Bennett,0,7,30,30
1650003995973,MATH 142A,B02,083222,Chow; Bennett,0,7,30,30
1650004002001,MATH 193A,A01,083224,Staff,0,5,30,30
1650004002001,MATH 193A,A02,083225,Staff,0,4,30,30
1650004002001,MATH 193A,A03,083781,Staff,0,0,30,30
1650004002001,MATH 193A,A04,083782,Staff,9,0,30,21
1650004008026,MATH 197,001,091859,McAuley; Julian John,9999,0,9999,0
1650004014089,COGS 9,A01,083615,Staff,1,16,60,59
1650004020114,COGS 11,A01,083617,Boyle; Mary E. T.,25,0,40,15
1650004026139,COGS 13,A01,083071,Staff,0,28,40,40
1650004032164,COGS 14A,A01,092681,Staff,0,5,100,100
1650004038190,COGS 14B,A01,083073,Cheng; Tzu-Han,0,2,50,50
1650004044214,COGS 17,A01,092677,Staff,35,0,75,40
1650004050241,COGS 100,A01,083619,Staff,0,17,60,60
1650004056265,COGS 101A,A01,083621,Davis; Joshua Daniel,0,16,60,60
1650004062289,COGS 101B,A01,091572,Staff,17,0,60,43
1650004068321,COGS 101C,A01,083625,Delgado; Tania,21,0,30,9
1650004074349,COGS 107A,A01,083627,Boyle; Mary E. T.,0,1,60,60
1650004080373,COGS 118A,A01,083075,Staff,19,0,60,41
1650004086398,CSE 3,A50,083646,Miranda; Gregory Joseph,22,0,38,16
1650004086398,CSE 3,A51,083647,Miranda; Gregory Joseph,37,0,37,0
1650004092428,CSE 8A,A50,083650,Miranda; Gregory Joseph,0,14,40,40
1650004098454,CSE 11,A01,083080,Cao; Yingjun,0,57,40,40
1650004104477,CSE 12,A01,083652,Staff,5,0,100,95
1650004110499,CSE 15L,A01,083654,Staff,0,0,50,50
1650004110499,CSE 15L,A02,083655,Staff,18,0,50,32
1650004116528,CSE 20,A01,083657,Staff,57,0,80,23
1650004122551,CSE 30,A01,083084,Eldon; John,0,61,40,40
1650004128574,CSE 100,A01,083659,Cao; Yingjun,0,57,50,50
1650004134600,CSE 134B,A01,083661,Powell; Thomas Allan,0,24,65,65
1650004140624,CSE 140,A01,083663,Staff,8,0,75,67
1650004146652,CSE 140L,A01,083088,Eldon; John,4,0,75,71
1650004152678,CSE 175,A01,083665,Kumar; Rakesh,10,0,25,15
1650004158702,CSE 190,A00,092507,Dubnov; Shlomo,17,0,20,3
1650004164768,ECE 45,A01,083139,Staff,0,8,40,40
1650004170794,ECE 65,A50,083695,Staff,0,1,30,30
1650004176817,ECE 109,A01,091882,Touri; Behrouz,49,0,70,21
1650004182841,ECE 180,A00,083140,Abi Samra; Nicholas Camill,26,0,30,4
1650004182841,ECE 180,B00,083141,Abi Samra; Nicholas Camill,10,0,30,20
1650004188867,MATH 10A,A01,083735,Patchell; Gregory David,14,0,30,16
1650004188867,MATH 10A,A02,083736,Patchell; Gregory David,28,0,30,2
1650004188867,MATH 10A,A03,083737,Patchell; Gregory David,27,0,30,3
1650004194890,MATH 10B,A01,083207,Staff,0,4,30,30
1650004194890,MATH 10B,A02,083208,Staff,1,0,30,29
1650004194890,MATH 10B,B01,083739,Staff,20,0,30,10
1650004194890,MATH 10B,B02,083740,Staff,30,0,30,0
1650004200927,MATH 18,A01,083743,Staff,11,0,30,19
1650004200927,MATH 18,A02,083744,Staff,28,0,30,2
1650004200927,MATH 18,A03,083745,Staff,23,0,30,7
1650004200927,MATH 18,A04,083746,Staff,27,0,30,3
1650004200927,MATH 18,B01,083748,Staff,0,6,30,30
1650004200927,MATH 18,B02,083749,Staff,0,5,30,30
1650004200927,MATH 18,B03,083750,Staff,0,6,30,30
1650004200927,MATH 18,B04,083751,Staff,0,6,30,30
1650004206949,MATH 20A,A01,083754,Staff,28,0,40,12
1650004212971,MATH 20B,A01,083756,Staff,0,4,30,30
1650004212971,MATH 20B,A02,083757,Staff,7,0,30,23
1650004218995,MATH 20C,A01,083760,Staff,0,9,30,30
1650004218995,MATH 20C,A02,083761,Staff,0,10,30,30
1650004218995,MATH 20C,B01,083762,Staff,17,0,30,13
1650004218995,MATH 20C,B02,083763,Staff,29,0,30,1
1650004225021,MATH 20D,A01,083765,Staff,0,2,30,30
1650004225021,MATH 20D,A02,083766,Staff,17,0,30,13
1650004225021,MATH 20D,A03,083767,Staff,28,0,30,2
1650004231055,MATH 20E,A01,083771,Staff,11,0,30,19
1650004231055,MATH 20E,A02,083772,Staff,20,0,30,10
1650004231055,MATH 20E,B01,083773,Staff,0,1,30,30
1650004231055,MATH 20E,B02,083774,Staff,22,0,30,8
1650004237081,MATH 103A,A01,083777,Staff,0,6,30,30
1650004237081,MATH 103A,A02,083778,Staff,0,7,30,30
1650004237081,MATH 103A,B01,083779,Staff,0,6,30,30
1650004237081,MATH 103A,B02,083780,Staff,0,6,30,30
1650004243112,MATH 105,A01,085443,Staff,0,11,30,30
1650004249228,MATH 109,A01,083213,Anzaldo; Leesa B,0,3,30,30
1650004249228,MATH 109,A02,083214,Anzaldo; Leesa B,0,3,30,30
1650004249228,MATH 109,B01,083215,Anzaldo; Leesa B,0,2,30,30
1650004249228,MATH 109,B02,083216,Anzaldo; Leesa B,0,2,30,30
1650004255264,MATH 142A,A01,083219,Chow; Bennett,0,7,30,30
1650004255264,MATH 142A,A02,083220,Chow; Bennett,0,7,30,30
1650004255264,MATH 142A,B01,083221,Chow; Bennett,0,7,30,30
1650004255264,MATH 142A,B02,083222,Chow; Bennett,0,7,30,30
1650004261296,MATH 193A,A01,083224,Staff,0,5,30,30
1650004261296,MATH 193A,A02,083225,Staff,0,4,30,30
1650004261296,MATH 193A,A03,083781,Staff,0,0,30,30
1650004261296,MATH 193A,A04,083782,Staff,9,0,30,21
1650004267319,MATH 197,001,091859,McAuley; Julian John,9999,0,9999,0
1650004273374,COGS 9,A01,083615,Staff,1,15,60,59
1650004279397,COGS 11,A01,083617,Boyle; Mary E. T.,25,0,40,15
1650004285421,COGS 13,A01,083071,Staff,0,28,40,40
1650004291453,COGS 14A,A01,092681,Staff,0,5,100,100
1650004297476,COGS 14B,A01,083073,Cheng; Tzu-Han,0,2,50,50
1650004303503,COGS 17,A01,092677,Staff,35,0,75,40
1650004309528,COGS 100,A01,083619,Staff,0,17,60,60
1650004315559,COGS 101A,A01,083621,Davis; Joshua Daniel,0,16,60,60
1650004321585,COGS 101B,A01,091572,Staff,17,0,60,43
1650004327611,COGS 101C,A01,083625,Delgado; Tania,21,0,30,9
1650004333632,COGS 107A,A01,083627,Boyle; Mary E. T.,0,1,60,60
1650004339655,COGS 118A,A01,083075,Staff,19,0,60,41
1650004345683,CSE 3,A50,083646,Miranda; Gregory Joseph,22,0,38,16
1650004345683,CSE 3,A51,083647,Miranda; Gregory Joseph,37,0,37,0
1650004351710,CSE 8A,A50,083650,Miranda; Gregory Joseph,0,14,40,40
1650004357737,CSE 11,A01,083080,Cao; Yingjun,0,57,40,40
1650004363761,CSE 12,A01,083652,Staff,5,0,100,95
1650004369795,CSE 15L,A01,083654,Staff,0,0,50,50
1650004369795,CSE 15L,A02,083655,Staff,18,0,50,32
1650004375817,CSE 20,A01,083657,Staff,57,0,80,23
1650004381840,CSE 30,A01,083084,Eldon; John,0,62,40,40
1650004387866,CSE 100,A01,083659,Cao; Yingjun,0,57,50,50
1650004393894,CSE 134B,A01,083661,Powell; Thomas Allan,0,24,65,65
1650004399917,CSE 140,A01,083663,Staff,8,0,75,67
1650004405941,CSE 140L,A01,083088,Eldon; John,4,0,75,71
1650004411990,CSE 175,A01,083665,Kumar; Rakesh,10,0,25,15
1650004418017,CSE 190,A00,092507,Dubnov; Shlomo,17,0,20,3
1650004424043,ECE 45,A01,083139,Staff,0,8,40,40
1650004430066,ECE 65,A50,083695,Staff,0,1,30,30
1650004436101,ECE 109,A01,091882,Touri; Behrouz,49,0,70,21
1650004442128,ECE 180,A00,083140,Abi Samra; Nicholas Camill,26,0,30,4
1650004442128,ECE 180,B00,083141,Abi Samra; Nicholas Camill,10,0,30,20
1650004448152,MATH 10A,A01,083735,Patchell; Gregory David,14,0,30,16
1650004448152,MATH 10A,A02,083736,Patchell; Gregory David,28,0,30,2
1650004448152,MATH 10A,A03,083737,Patchell; Gregory David,27,0,30,3
1650004454187,MATH 10B,A01,083207,Staff,0,4,30,30
1650004454187,MATH 10B,A02,083208,Staff,1,0,30,29
1650004454187,MATH 10B,B01,083739,Staff,20,0,30,10
1650004454187,MATH 10B,B02,083740,Staff,30,0,30,0
1650004460211,MATH 18,A01,083743,Staff,11,0,30,19
1650004460211,MATH 18,A02,083744,Staff,28,0,30,2
1650004460211,MATH 18,A03,083745,Staff,23,0,30,7
1650004460211,MATH 18,A04,083746,Staff,27,0,30,3
1650004460211,MATH 18,B01,083748,Staff,0,6,30,30
1650004460211,MATH 18,B02,083749,Staff,0,5,30,30
1650004460211,MATH 18,B03,083750,Staff,0,6,30,30
1650004460211,MATH 18,B04,083751,Staff,0,6,30,30
1650004466237,MATH 20A,A01,083754,Staff,28,0,40,12
1650004472260,MATH 20B,A01,083756,Staff,0,5,30,30
1650004472260,MATH 20B,A02,083757,Staff,7,0,30,23
1650004478287,MATH 20C,A01,083760,Staff,0,9,30,30
1650004478287,MATH 20C,A02,083761,Staff,0,10,30,30
1650004478287,MATH 20C,B01,083762,Staff,17,0,30,13
1650004478287,MATH 20C,B02,083763,Staff,29,0,30,1
1650004484315,MATH 20D,A01,083765,Staff,0,2,30,30
1650004484315,MATH 20D,A02,083766,Staff,17,0,30,13
1650004484315,MATH 20D,A03,083767,Staff,28,0,30,2
1650004490336,MATH 20E,A01,083771,Staff,11,0,30,19
1650004490336,MATH 20E,A02,083772,Staff,20,0,30,10
1650004490336,MATH 20E,B01,083773,Staff,0,1,30,30
1650004490336,MATH 20E,B02,083774,Staff,22,0,30,8
1650004496360,MATH 103A,A01,083777,Staff,0,6,30,30
1650004496360,MATH 103A,A02,083778,Staff,0,7,30,30
1650004496360,MATH 103A,B01,083779,Staff,0,6,30,30
1650004496360,MATH 103A,B02,083780,Staff,0,6,30,30
1650004502387,MATH 105,A01,085443,Staff,0,11,30,30
1650004508412,MATH 109,A01,083213,Anzaldo; Leesa B,0,3,30,30
1650004508412,MATH 109,A02,083214,Anzaldo; Leesa B,0,3,30,30
1650004508412,MATH 109,B01,083215,Anzaldo; Leesa B,0,2,30,30
1650004508412,MATH 109,B02,083216,Anzaldo; Leesa B,0,2,30,30
1650004514442,MATH 142A,A01,083219,Chow; Bennett,0,7,30,30
1650004514442,MATH 142A,A02,083220,Chow; Bennett,0,7,30,30
1650004514442,MATH 142A,B01,083221,Chow; Bennett,0,7,30,30
1650004514442,MATH 142A,B02,083222,Chow; Bennett,0,7,30,30
1650004520486,MATH 193A,A01,083224,Staff,0,5,30,30
1650004520486,MATH 193A,A02,083225,Staff,0,4,30,30
1650004520486,MATH 193A,A03,083781,Staff,0,0,30,30
1650004520486,MATH 193A,A04,083782,Staff,9,0,30,21
1650004526511,MATH 197,001,091859,McAuley; Julian John,9999,0,9999,0
1650004532582,COGS 9,A01,083615,Staff,1,15,60,59
1650004538614,COGS 11,A01,083617,Boyle; Mary E. T.,25,0,40,15
1650004544642,COGS 13,A01,083071,Staff,0,28,40,40
1650004550667,COGS 14A,A01,092681,Staff,0,5,100,100
1650004556692,COGS 14B,A01,083073,Cheng; Tzu-Han,0,2,50,50
1650004562729,COGS 17,A01,092677,Staff,35,0,75,40
1650004568756,COGS 100,A01,083619,Staff,0,17,60,60
1650004574779,COGS 101A,A01,083621,Davis; Joshua Daniel,0,16,60,60
1650004580801,COGS 101B,A01,091572,Staff,17,0,60,43
1650004586824,COGS 101C,A01,083625,Delgado; Tania,21,0,30,9
1650004592850,COGS 107A,A01,083627,Boyle; Mary E. T.,0,1,60,60
1650004598874,COGS 118A,A01,083075,Staff,19,0,60,41
1650004604902,CSE 3,A50,083646,Miranda; Gregory Joseph,22,0,38,16
1650004604902,CSE 3,A51,083647,Miranda; Gregory Joseph,37,0,37,0
1650004610938,CSE 8A,A50,083650,Miranda; Gregory Joseph,0,14,40,40
1650004616962,CSE 11,A01,083080,Cao; Yingjun,0,57,40,40
1650004622990,CSE 12,A01,083652,Staff,5,0,100,95
1650004629030,CSE 15L,A01,083654,Staff,0,0,50,50
1650004629030,CSE 15L,A02,083655,Staff,18,0,50,32
1650004635054,CSE 20,A01,083657,Staff,57,0,80,23
1650004641079,CSE 30,A01,083084,Eldon; John,0,62,40,40
1650004647106,CSE 100,A01,083659,Cao; Yingjun,0,57,50,50
1650004653129,CSE 134B,A01,083661,Powell; Thomas Allan,0,24,65,65
1650004659156,CSE 140,A01,083663,Staff,8,0,75,67
1650004665190,CSE 140L,A01,083088,Eldon; John,4,0,75,71
1650004671214,CSE 175,A01,083665,Kumar; Rakesh,10,0,25,15
1650004677239,CSE 190,A00,092507,Dubnov; Shlomo,17,0,20,3
1650004683265,ECE 45,A01,083139,Staff,0,8,40,40
1650004689291,ECE 65,A50,083695,Staff,0,1,30,30
1650004695315,ECE 109,A01,091882,Touri; Behrouz,49,0,70,21
1650004701337,ECE 180,A00,083140,Abi Samra; Nicholas Camill,26,0,30,4
1650004701337,ECE 180,B00,083141,Abi Samra; Nicholas Camill,10,0,30,20
1650004707365,MATH 10A,A01,083735,Patchell; Gregory David,14,0,30,16
1650004707365,MATH 10A,A02,083736,Patchell; Gregory David,28,0,30,2
1650004707365,MATH 10A,A03,083737,Patchell; Gregory David,27,0,30,3
1650004713389,MATH 10B,A01,083207,Staff,0,4,30,30
1650004713389,MATH 10B,A02,083208,Staff,1,0,30,29
1650004713389,MATH 10B,B01,083739,Staff,20,0,30,10
1650004713389,MATH 10B,B02,083740,Staff,30,0,30,0
1650004719415,MATH 18,A01,083743,Staff,11,0,30,19
1650004719415,MATH 18,A02,083744,Staff,28,0,30,2
1650004719415,MATH 18,A03,083745,Staff,23,0,30,7
1650004719415,MATH 18,A04,083746,Staff,27,0,30,3
1650004719415,MATH 18,B01,083748,Staff,0,6,30,30
1650004719415,MATH 18,B02,083749,Staff,0,5,30,30
1650004719415,MATH 18,B03,083750,Staff,0,6,30,30
1650004719415,MATH 18,B04,083751,Staff,0,6,30,30
1650004725443,MATH 20A,A01,083754,Staff,28,0,40,12
1650004731471,MATH 20B,A01,083756,Staff,0,5,30,30
1650004731471,MATH 20B,A02,083757,Staff,7,0,30,23
1650004737507,MATH 20C,A01,083760,Staff,0,9,30,30
1650004737507,MATH 20C,A02,083761,Staff,0,10,30,30
1650004737507,MATH 20C,B01,083762,Staff,17,0,30,13
1650004737507,MATH 20C,B02,083763,Staff,29,0,30,1
1650004743567,MATH 20D,A01,083765,Staff,0,2,30,30
1650004743567,MATH 20D,A02,083766,Staff,17,0,30,13
1650004743567,MATH 20D,A03,083767,Staff,28,0,30,2
1650004749597,MATH 20E,A01,083771,Staff,11,0,30,19
1650004749597,MATH 20E,A02,083772,Staff,20,0,30,10
1650004749597,MATH 20E,B01,083773,Staff,0,1,30,30
1650004749597,MATH 20E,B02,083774,Staff,22,0,30,8
1650004755631,MATH 103A,A01,083777,Staff,0,6,30,30
1650004755631,MATH 103A,A02,083778,Staff,0,7,30,30
1650004755631,MATH 103A,B01,083779,Staff,0,6,30,30
1650004755631,MATH 103A,B02,083780,Staff,0,6,30,30
1650004761654,MATH 105,A01,085443,Staff,0,11,30,30
1650004767682,MATH 109,A01,083213,Anzaldo; Leesa B,0,3,30,30
1650004767682,MATH 109,A02,083214,Anzaldo; Leesa B,0,3,30,30
1650004767682,MATH 109,B01,083215,Anzaldo; Leesa B,0,2,30,30
1650004767682,MATH 109,B02,083216,Anzaldo; Leesa B,0,2,30,30
1650004773707,MATH 142A,A01,083219,Chow; Bennett,0,7,30,30
1650004773707,MATH 142A,A02,083220,Chow; Bennett,0,7,30,30
1650004773707,MATH 142A,B01,083221,Chow; Bennett,0,8,30,30
1650004773707,MATH 142A,B02,083222,Chow; Bennett,0,7,30,30
1650004779734,MATH 193A,A01,083224,Staff,0,5,30,30
1650004779734,MATH 193A,A02,083225,Staff,0,4,30,30
1650004779734,MATH 193A,A03,083781,Staff,0,0,30,30
1650004779734,MATH 193A,A04,083782,Staff,9,0,30,21
1650004785759,MATH 197,001,091859,McAuley; Julian John,9999,0,9999,0
1650004791812,COGS 9,A01,083615,Staff,1,15,60,59
1650004797841,COGS 11,A01,083617,Boyle; Mary E. T.,25,0,40,15
1650004803869,COGS 13,A01,083071,Staff,0,28,40,40
1650004809894,COGS 14A,A01,092681,Staff,0,5,100,100
1650004815919,COGS 14B,A01,083073,Cheng; Tzu-Han,0,2,50,50
1650004821943,COGS 17,A01,092677,Staff,35,0,75,40
1650004827971,COGS 100,A01,083619,Staff,0,18,60,60
1650004833998,COGS 101A,A01,083621,Davis; Joshua Daniel,0,16,60,60
1650004840114,COGS 101B,A01,091572,Staff,16,0,60,44
1650004846141,COGS 101C,A01,083625,Delgado; Tania,21,0,30,9
1650004852164,COGS 107A,A01,083627,Boyle; Mary E. T.,0,1,60,60
1650004858194,COGS 118A,A01,083075,Staff,19,0,60,41
1650004864223,CSE 3,A50,083646,Miranda; Gregory Joseph,22,0,38,16
1650004864223,CSE 3,A51,083647,Miranda; Gregory Joseph,37,0,37,0
1650004870246,CSE 8A,A50,083650,Miranda; Gregory Joseph,0,14,40,40
1650004876270,CSE 11,A01,083080,Cao; Yingjun,0,57,40,40
1650004882294,CSE 12,A01,083652,Staff,5,0,100,95
1650004888316,CSE 15L,A01,083654,Staff,0,0,50,50
1650004888316,CSE 15L,A02,083655,Staff,18,0,50,32
1650004894340,CSE 20,A01,083657,Staff,57,0,80,23
1650004900364,CSE 30,A01,083084,Eldon; John,0,62,40,40
1650004906387,CSE 100,A01,083659,Cao; Yingjun,0,57,50,50
1650004912411,CSE 134B,A01,083661,Powell; Thomas Allan,0,24,65,65
1650004918435,CSE 140,A01,083663,Staff,8,0,75,67
1650004924458,CSE 140L,A01,083088,Eldon; John,4,0,75,71
1650004930486,CSE 175,A01,083665,Kumar; Rakesh,10,0,25,15
1650004936509,CSE 190,A00,092507,Dubnov; Shlomo,17,0,20,3
1650004942533,ECE 45,A01,083139,Staff,0,8,40,40
1650004948557,ECE 65,A50,083695,Staff,0,1,30,30
1650004954579,ECE 109,A01,091882,Touri; Behrouz,49,0,70,21
1650004960605,ECE 180,A00,083140,Abi Samra; Nicholas Camill,26,0,30,4
1650004960605,ECE 180,B00,083141,Abi Samra; Nicholas Camill,10,0,30,20
1650004966633,MATH 10A,A01,083735,Patchell; Gregory David,14,0,30,16
1650004966633,MATH 10A,A02,083736,Patchell; Gregory David,28,0,30,2
1650004966633,MATH 10A,A03,083737,Patchell; Gregory David,27,0,30,3
1650004972656,MATH 10B,A01,083207,Staff,0,4,30,30
1650004972656,MATH 10B,A02,083208,Staff,1,0,30,29
1650004972656,MATH 10B,B01,083739,Staff,20,0,30,10
1650004972656,MATH 10B,B02,083740,Staff,30,0,30,0
1650004978683,MATH 18,A01,083743,Staff,11,0,30,19
1650004978683,MATH 18,A02,083744,Staff,28,0,30,2
1650004978683,MATH 18,A03,083745,Staff,23,0,30,7
1650004978683,MATH 18,A04,083746,Staff,27,0,30,3
1650004978683,MATH 18,B01,083748,Staff,0,6,30,30
1650004978683,MATH 18,B02,083749,Staff,0,5,30,30
1650004978683,MATH 18,B03,083750,Staff,0,6,30,30
1650004978683,MATH 18,B04,083751,Staff,0,7,30,30
1650004984706,MATH 20A,A01,083754,Staff,28,0,40,12
1650004990734,MATH 20B,A01,083756,Staff,0,5,30,30
1650004990734,MATH 20B,A02,083757,Staff,7,0,30,23
1650004996768,MATH 20C,A01,083760,Staff,0,9,30,30
1650004996768,MATH 20C,A02,083761,Staff,0,10,30,30
1650004996768,MATH 20C,B01,083762,Staff,17,0,30,13
1650004996768,MATH 20C,B02,083763,Staff,29,0,30,1
1650005002792,MATH 20D,A01,083765,Staff,0,2,30,30
1650005002792,MATH 20D,A02,083766,Staff,17,0,30,13
1650005002792,MATH 20D,A03,083767,Staff,28,0,30,2
1650005008819,MATH 20E,A01,083771,Staff,11,0,30,19
1650005008819,MATH 20E,A02,083772,Staff,20,0,30,10
1650005008819,MATH 20E,B01,083773,Staff,0,1,30,30
1650005008819,MATH 20E,B02,083774,Staff,22,0,30,8
1650005014842,MATH 103A,A01,083777,Staff,0,6,30,30
1650005014842,MATH 103A,A02,083778,Staff,0,7,30,30
1650005014842,MATH 103A,B01,083779,Staff,0,6,30,30
1650005014842,MATH 103A,B02,083780,Staff,0,6,30,30
1650005020866,MATH 105,A01,085443,Staff,0,11,30,30
1650005026891,MATH 109,A01,083213,Anzaldo; Leesa B,0,3,30,30
1650005026891,MATH 109,A02,083214,Anzaldo; Leesa B,0,3,30,30
1650005026891,MATH 109,B01,083215,Anzaldo; Leesa B,0,2,30,30
1650005026891,MATH 109,B02,083216,Anzaldo; Leesa B,0,2,30,30
1650005032915,MATH 142A,A01,083219,Chow; Bennett,0,7,30,30
1650005032915,MATH 142A,A02,083220,Chow; Bennett,0,7,30,30
1650005032915,MATH 142A,B01,083221,Chow; Bennett,0,8,30,30
1650005032915,MATH 142A,B02,083222,Chow; Bennett,0,7,30,30
1650005038937,MATH 193A,A01,083224,Staff,0,5,30,30
1650005038937,MATH 193A,A02,083225,Staff,0,4,30,30
1650005038937,MATH 193A,A03,083781,Staff,0,0,30,30
1650005038937,MATH 193A,A04,083782,Staff,9,0,30,21
1650005044963,MATH 197,001,091859,McAuley; Julian John,9999,0,9999,0
1650005051022,COGS 9,A01,083615,Staff,1,15,60,59
1650005057093,COGS 11,A01,083617,Boyle; Mary E. T.,25,0,40,15
1650005063121,COGS 13,A01,083071,Staff,0,28,40,40
1650005069145,COGS 14A,A01,092681,Staff,0,5,100,100
1650005075166,COGS 14B,A01,083073,Cheng; Tzu-Han,0,2,50,50
1650005081191,COGS 17,A01,092677,Staff,35,0,75,40
1650005087229,COGS 100,A01,083619,Staff,0,18,60,60
1650005093255,COGS 101A,A01,083621,Davis; Joshua Daniel,0,16,60,60
1650005099280,COGS 101B,A01,091572,Staff,16,0,60,44
1650005105315,COGS 101C,A01,083625,Delgado; Tania,21,0,30,9
1650005111340,COGS 107A,A01,083627,Boyle; Mary E. T.,0,1,60,60
1650005117362,COGS 118A,A01,083075,Staff,19,0,60,41
1650005123388,CSE 3,A50,083646,Miranda; Gregory Joseph,22,0,38,16
1650005123388,CSE 3,A51,083647,Miranda; Gregory Joseph,37,0,37,0
1650005129411,CSE 8A,A50,083650,Miranda; Gregory Joseph,0,14,40,40
1650005135432,CSE 11,A01,083080,Cao; Yingjun,0,57,40,40
1650005141456,CSE 12,A01,083652,Staff,5,0,100,95
1650005147483,CSE 15L,A01,083654,Staff,0,0,50,50
1650005147483,CSE 15L,A02,083655,Staff,18,0,50,32
1650005153509,CSE 20,A01,083657,Staff,57,0,80,23
1650005159535,CSE 30,A01,083084,Eldon; John,0,62,40,40
1650005165562,CSE 100,A01,083659,Cao; Yingjun,0,57,50,50
1650005171588,CSE 134B,A01,083661,Powell; Thomas Allan,0,24,65,65
1650005177619,CSE 140,A01,083663,Staff,8,0,75,67
1650005183644,CSE 140L,A01,083088,Eldon; John,4,0,75,71
1650005189668,CSE 175,A01,083665,Kumar; Rakesh,10,0,25,15
1650005195691,CSE 190,A00,092507,Dubnov; Shlomo,17,0,20,3
1650005201714,ECE 45,A01,083139,Staff,0,8,40,40
1650005207742,ECE 65,A50,083695,Staff,0,1,30,30
1650005213764,ECE 109,A01,091882,Touri; Behrouz,49,0,70,21
1650005219787,ECE 180,A00,083140,Abi Samra; Nicholas Camill,26,0,30,4
1650005219787,ECE 180,B00,083141,Abi Samra; Nicholas Camill,10,0,30,20
1650005225813,MATH 10A,A01,083735,Patchell; Gregory David,14,0,30,16
1650005225813,MATH 10A,A02,083736,Patchell; Gregory David,28,0,30,2
1650005225813,MATH 10A,A03,083737,Patchell; Gregory David,27,0,30,3
1650005231835,MATH 10B,A01,083207,Staff,0,4,30,30
1650005231835,MATH 10B,A02,083208,Staff,1,0,30,29
1650005231835,MATH 10B,B01,083739,Staff,20,0,30,10
1650005231835,MATH 10B,B02,083740,Staff,30,0,30,0
1650005237858,MATH 18,A01,083743,Staff,11,0,30,19
1650005237858,MATH 18,A02,083744,Staff,28,0,30,2
1650005237858,MATH 18,A03,083745,Staff,23,0,30,7
1650005237858,MATH 18,A04,083746,Staff,27,0,30,3
1650005237858,MATH 18,B01,083748,Staff,0,6,30,30
1650005237858,MATH 18,B02,083749,Staff,0,5,30,30
1650005237858,MATH 18,B03,083750,Staff,0,6,30,30
1650005237858,MATH 18,B04,083751,Staff,0,7,30,30
1650005243885,MATH 20A,A01,083754,Staff,27,0,40,13
1650005249908,MATH 20B,A01,083756,Staff,0,5,30,30
1650005249908,MATH 20B,A02,083757,Staff,7,0,30,23
1650005255943,MATH 20C,A01,083760,Staff,0,9,30,30
1650005255943,MATH 20C,A02,083761,Staff,0,10,30,30
1650005255943,MATH 20C,B01,083762,Staff,17,0,30,13
1650005255943,MATH 20C,B02,083763,Staff,29,0,30,1
1650005261970,MATH 20D,A01,083765,Staff,0,2,30,30
1650005261970,MATH 20D,A02,083766,Staff,17,0,30,13
1650005261970,MATH 20D,A03,083767,Staff,28,0,30,2
1650005267998,MATH 20E,A01,083771,Staff,11,0,30,19
1650005267998,MATH 20E,A02,083772,Staff,20,0,30,10
1650005267998,MATH 20E,B01,083773,Staff,0,1,30,30
1650005267998,MATH 20E,B02,083774,Staff,22,0,30,8
1650005274020,MATH 103A,A01,083777,Staff,0,6,30,30
1650005274020,MATH 103A,A02,083778,Staff,0,7,30,30
1650005274020,MATH 103A,B01,083779,Staff,0,6,30,30
1650005274020,MATH 103A,B02,083780,Staff,0,6,30,30
1650005280047,MATH 105,A01,085443,Staff,0,11,30,30
1650005286071,MATH 109,A01,083213,Anzaldo; Leesa B,0,3,30,30
1650005286071,MATH 109,A02,083214,Anzaldo; Leesa B,0,3,30,30
1650005286071,MATH 109,B01,083215,Anzaldo; Leesa B,0,2,30,30
1650005286071,MATH 109,B02,083216,Anzaldo; Leesa B,0,2,30,30
1650005292095,MATH 142A,A01,083219,Chow; Bennett,0,7,30,30
1650005292095,MATH 142A,A02,083220,Chow; Bennett,0,7,30,30
1650005292095,MATH 142A,B01,083221,Chow; Bennett,0,8,30,30
1650005292095,MATH 142A,B02,083222,Chow; Bennett,0,7,30,30
1650005298120,MATH 193A,A01,083224,Staff,0,5,30,30
1650005298120,MATH 193A,A02,083225,Staff,0,4,30,30
1650005298120,MATH 193A,A03,083781,Staff,0,0,30,30
1650005298120,MATH 193A,A04,083782,Staff,9,0,30,21
1650005304146,MATH 197,001,091859,McAuley; Julian John,9999,0,9999,0
1650005310204,COGS 9,A01,083615,Staff,1,15,60,59
1650005316231,COGS 11,A01,083617,Boyle; Mary E. T.,25,0,40,15
1650005322255,COGS 13,A01,083071,Staff,0,28,40,40
1650005328280,COGS 14A,A01,092681,Staff,0,5,100,100
1650005334307,COGS 14B,A01,083073,Cheng; Tzu-Han,0,2,50,50
1650005340332,COGS 17,A01,092677,Staff,35,0,75,40
1650005346364,COGS 100,A01,083619,Staff,0,18,60,60
1650005352387,COGS 101A,A01,083621,Davis; Joshua Daniel,0,16,60,60
1650005358410,COGS 101B,A01,091572,Staff,16,0,60,44
1650005364436,COGS 101C,A01,083625,Delgado; Tania,21,0,30,9
1650005370461,COGS 107A,A01,083627,Boyle; Mary E. T.,0,1,60,60
1650005376485,COGS 118A,A01,083075,Staff,19,0,60,41
1650005382529,CSE 3,A50,083646,Miranda; Gregory Joseph,22,0,38,16
1650005382529,CSE 3,A51,083647,Miranda; Gregory Joseph,37,0,37,0
1650005388556,CSE 8A,A50,083650,Miranda; Gregory Joseph,0,14,40,40
1650005394583,CSE 11,A01,083080,Cao; Yingjun,0,58,40,40
1650005400607,CSE 12,A01,083652,Staff,5,0,100,95
1650005406633,CSE 15L,A01,083654,Staff,0,0,50,50
1650005406633,CSE 15L,A02,083655,Staff,18,0,50,32
1650005412657,CSE 20,A01,083657,Staff,57,0,80,23
1650005418681,CSE 30,A01,083084,Eldon; John,0,62,40,40
1650005424708,CSE 100,A01,083659,Cao; Yingjun,0,57,50,50
1650005430738,CSE 134B,A01,083661,Powell; Thomas Allan,0,24,65,65
1650005436852,CSE 140,A01,083663,Staff,8,0,75,67
1650005442875,CSE 140L,A01,083088,Eldon; John,4,0,75,71
1650005448901,CSE 175,A01,083665,Kumar; Rakesh,10,0,25,15
1650005454927,CSE 190,A00,092507,Dubnov; Shlomo,17,0,20,3
1650005460951,ECE 45,A01,083139,Staff,0,8,40,40
1650005466978,ECE 65,A50,083695,Staff,0,1,30,30
1650005473003,ECE 109,A01,091882,Touri; Behrouz,49,0,70,21
1650005479030,ECE 180,A00,083140,Abi Samra; Nicholas Camill,26,0,30,4
1650005479030,ECE 180,B00,083141,Abi Samra; Nicholas Camill,10,0,30,20
1650005485057,MATH 10A,A01,083735,Patchell; Gregory David,14,0,30,16
1650005485057,MATH 10A,A02,083736,Patchell; Gregory David,28,0,30,2
1650005485057,MATH 10A,A03,083737,Patchell; Gregory David,27,0,30,3
1650005491081,MATH 10B,A01,083207,Staff,0,4,30,30
1650005491081,MATH 10B,A02,083208,Staff,1,0,30,29
1650005491081,MATH 10B,B01,083739,Staff,20,0,30,10
1650005491081,MATH 10B,B02,083740,Staff,30,0,30,0
1650005497114,MATH 18,A01,083743,Staff,11,0,30,19
1650005497114,MATH 18,A02,083744,Staff,28,0,30,2
1650005497114,MATH 18,A03,083745,Staff,23,0,30,7
1650005497114,MATH 18,A04,083746,Staff,27,0,30,3
1650005497114,MATH 18,B01,083748,Staff,0,6,30,30
1650005497114,MATH 18,B02,083749,Staff,0,5,30,30
1650005497114,MATH 18,B03,083750,Staff,0,6,30,30
1650005497114,MATH 18,B04,083751,Staff,0,7,30,30
1650005503138,MATH 20A,A01,083754,Staff,27,0,40,13
1650005509162,MATH 20B,A01,083756,Staff,0,5,30,30
1650005509162,MATH 20B,A02,083757,Staff,7,0,30,23
1650005515184,MATH 20C,A01,083760,Staff,0,9,30,30
1650005515184,MATH 20C,A02,083761,Staff,0,10,30,30
1650005515184,MATH 20C,B01,083762,Staff,17,0,30,13
1650005515184,MATH 20C,B02,083763,Staff,29,0,30,1
1650005521209,MATH 20D,A01,083765,Staff,0,2,30,30
1650005521209,MATH 20D,A02,083766,Staff,17,0,30,13
1650005521209,MATH 20D,A03,083767,Staff,28,0,30,2
1650005527233,MATH 20E,A01,083771,Staff,11,0,30,19
1650005527233,MATH 20E,A02,083772,Staff,20,0,30,10
1650005527233,MATH 20E,B01,083773,Staff,0,1,30,30
1650005527233,MATH 20E,B02,083774,Staff,22,0,30,8
1650005533266,MATH 103A,A01,083777,Staff,0,6,30,30
1650005533266,MATH 103A,A02,083778,Staff,0,7,30,30
1650005533266,MATH 103A,B01,083779,Staff,0,6,30,30
1650005533266,MATH 103A,B02,083780,Staff,0,6,30,30
1650005539291,MATH 105,A01,085443,Staff,0,11,30,30
1650005545315,MATH 109,A01,083213,Anzaldo; Leesa B,0,3,30,30
1650005545315,MATH 109,A02,083214,Anzaldo; Leesa B,0,3,30,30
1650005545315,MATH 109,B01,083215,Anzaldo; Leesa B,0,2,30,30
1650005545315,MATH 109,B02,083216,Anzaldo; Leesa B,0,2,30,30
1650005551346,MATH 142A,A01,083219,Chow; Bennett,0,7,30,30
1650005551346,MATH 142A,A02,083220,Chow; Bennett,0,7,30,30
1650005551346,MATH 142A,B01,083221,Chow; Bennett,0,8,30,30
1650005551346,MATH 142A,B02,083222,Chow; Bennett,0,7,30,30
1650005557371,MATH 193A,A01,083224,Staff,0,5,30,30
1650005557371,MATH 193A,A02,083225,Staff,0,4,30,30
1650005557371,MATH 193A,A03,083781,Staff,0,0,30,30
1650005557371,MATH 193A,A04,083782,Staff,9,0,30,21
1650005563398,MATH 197,001,091859,McAuley; Julian John,9999,0,9999,0
1650005569447,COGS 9,A01,083615,Staff,1,15,60,59
1650005575475,COGS 11,A01,083617,Boyle; Mary E. T.,25,0,40,15
1650005581497,COGS 13,A01,083071,Staff,0,28,40,40
1650005587519,COGS 14A,A01,092681,Staff,0,5,100,100
1650005593540,COGS 14B,A01,083073,Cheng; Tzu-Han,0,2,50,50
1650005599566,COGS 17,A01,092677,Staff,35,0,75,40
1650005605593,COGS 100,A01,083619,Staff,0,18,60,60
1650005611628,COGS 101A,A01,083621,Davis; Joshua Daniel,0,16,60,60
1650005617655,COGS 101B,A01,091572,Staff,16,0,60,44
1650005623684,COGS 101C,A01,083625,Delgado; Tania,21,0,30,9
1650005629706,COGS 107A,A01,083627,Boyle; Mary E. T.,0,1,60,60
1650005635729,COGS 118A,A01,083075,Staff,19,0,60,41
1650005641754,CSE 3,A50,083646,Miranda; Gregory Joseph,22,0,38,16
1650005641754,CSE 3,A51,083647,Miranda; Gregory Joseph,37,0,37,0
1650005647782,CSE 8A,A50,083650,Miranda; Gregory Joseph,0,14,40,40
1650005653816,CSE 11,A01,083080,Cao; Yingjun,0,57,40,40
1650005659849,CSE 12,A01,083652,Staff,5,0,100,95
1650005665872,CSE 15L,A01,083654,Staff,0,0,50,50
1650005665872,CSE 15L,A02,083655,Staff,18,0,50,32
1650005671899,CSE 20,A01,083657,Staff,57,0,80,23
1650005677926,CSE 30,A01,083084,Eldon; John,0,62,40,40
1650005683965,CSE 100,A01,083659,Cao; Yingjun,0,57,50,50
1650005689992,CSE 134B,A01,083661,Powell; Thomas Allan,0,24,65,65
1650005696016,CSE 140,A01,083663,Staff,8,0,75,67
1650005702040,CSE 140L,A01,083088,Eldon; John,4,0,75,71
1650005708070,CSE 175,A01,083665,Kumar; Rakesh,10,0,25,15
1650005714094,CSE 190,A00,092507,Dubnov; Shlomo,17,0,20,3
1650005720118,ECE 45,A01,083139,Staff,0,8,40,40
1650005726142,ECE 65,A50,083695,Staff,0,1,30,30
1650005732164,ECE 109,A01,091882,Touri; Behrouz,49,0,70,21
1650005738190,ECE 180,A00,083140,Abi Samra; Nicholas Camill,26,0,30,4
1650005738190,ECE 180,B00,083141,Abi Samra; Nicholas Camill,10,0,30,20
1650005744214,MATH 10A,A01,083735,Patchell; Gregory David,14,0,30,16
1650005744214,MATH 10A,A02,083736,Patchell; Gregory David,28,0,30,2
1650005744214,MATH 10A,A03,083737,Patchell; Gregory David,27,0,30,3
1650005750239,MATH 10B,A01,083207,Staff,0,4,30,30
1650005750239,MATH 10B,A02,083208,Staff,1,0,30,29
1650005750239,MATH 10B,B01,083739,Staff,20,0,30,10
1650005750239,MATH 10B,B02,083740,Staff,30,0,30,0
1650005756270,MATH 18,A01,083743,Staff,11,0,30,19
1650005756270,MATH 18,A02,083744,Staff,28,0,30,2
1650005756270,MATH 18,A03,083745,Staff,23,0,30,7
1650005756270,MATH 18,A04,083746,Staff,27,0,30,3
1650005756270,MATH 18,B01,083748,Staff,0,6,30,30
1650005756270,MATH 18,B02,083749,Staff,0,5,30,30
1650005756270,MATH 18,B03,083750,Staff,0,6,30,30
1650005756270,MATH 18,B04,083751,Staff,0,7,30,30
1650005762296,MATH 20A,A01,083754,Staff,27,0,40,13
1650005768326,MATH 20B,A01,083756,Staff,0,5,30,30
1650005768326,MATH 20B,A02,083757,Staff,7,0,30,23
1650005774354,MATH 20C,A01,083760,Staff,0,9,30,30
1650005774354,MATH 20C,A02,083761,Staff,0,10,30,30
1650005774354,MATH 20C,B01,083762,Staff,17,0,30,13
1650005774354,MATH 20C,B02,083763,Staff,29,0,30,1
1650005780381,MATH 20D,A01,083765,Staff,0,2,30,30
1650005780381,MATH 20D,A02,083766,Staff,17,0,30,13
1650005780381,MATH 20D,A03,083767,Staff,28,0,30,2
1650005786407,MATH 20E,A01,083771,Staff,11,0,30,19
1650005786407,MATH 20E,A02,083772,Staff,20,0,30,10
1650005786407,MATH 20E,B01,083773,Staff,0,1,30,30
1650005786407,MATH 20E,B02,083774,Staff,22,0,30,8
1650005792436,MATH 103A,A01,083777,Staff,0,6,30,30
1650005792436,MATH 103A,A02,083778,Staff,0,7,30,30
1650005792436,MATH 103A,B01,083779,Staff,0,6,30,30
1650005792436,MATH 103A,B02,083780,Staff,0,6,30,30
1650005798462,MATH 105,A01,085443,Staff,0,11,30,30
1650005804486,MATH 109,A01,083213,Anzaldo; Leesa B,0,3,30,30
1650005804486,MATH 109,A02,083214,Anzaldo; Leesa B,0,3,30,30
1650005804486,MATH 109,B01,083215,Anzaldo; Leesa B,0,2,30,30
1650005804486,MATH 109,B02,083216,Anzaldo; Leesa B,0,2,30,30
1650005810509,MATH 142A,A01,083219,Chow; Bennett,0,7,30,30
1650005810509,MATH 142A,A02,083220,Chow; Bennett,0,7,30,30
1650005810509,MATH 142A,B01,083221,Chow; Bennett,0,8,30,30
1650005810509,MATH 142A,B02,083222,Chow; Bennett,0,7,30,30
1650005816536,MATH 193A,A01,083224,Staff,0,5,30,30
1650005816536,MATH 193A,A02,083225,Staff,0,4,30,30
1650005816536,MATH 193A,A03,083781,Staff,0,0,30,30
1650005816536,MATH 193A,A04,083782,Staff,9,0,30,21
1650005822566,MATH 197,001,091859,McAuley; Julian John,9999,0,9999,0
1650005828627,COGS 9,A01,083615,Staff,1,15,60,59
1650005834649,COGS 11,A01,083617,Boyle; Mary E. T.,25,0,40,15
1650005840674,COGS 13,A01,083071,Staff,0,28,40,40
1650005846699,COGS 14A,A01,092681,Staff,0,5,100,100
1650005852726,COGS 14B,A01,083073,Cheng; Tzu-Han,0,2,50,50
1650005858756,COGS 17,A01,092677,Staff,35,0,75,40
1650005864780,COGS 100,A01,083619,Staff,0,18,60,60
1650005870809,COGS 101A,A01,083621,Davis; Joshua Daniel,0,16,60,60
1650005876832,COGS 101B,A01,091572,Staff,16,0,60,44
1650005882856,COGS 101C,A01,083625,Delgado; Tania,21,0,30,9
1650005888884,COGS 107A,A01,083627,Boyle; Mary E. T.,0,1,60,60
1650005894909,COGS 118A,A01,083075,Staff,19,0,60,41
1650005900947,CSE 3,A50,083646,Miranda; Gregory Joseph,22,0,38,16
1650005900947,CSE 3,A51,083647,Miranda; Gregory Joseph,37,0,37,0
1650005906975,CSE 8A,A50,083650,Miranda; Gregory Joseph,0,14,40,40
1650005913001,CSE 11,A01,083080,Cao; Yingjun,0,57,40,40
1650005919029,CSE 12,A01,083652,Staff,5,0,100,95
1650005925052,CSE 15L,A01,083654,Staff,0,0,50,50
1650005925052,CSE 15L,A02,083655,Staff,18,0,50,32
1650005931079,CSE 20,A01,083657,Staff,57,0,80,23
1650005937104,CSE 30,A01,083084,Eldon; John,0,62,40,40
1650005943128,CSE 100,A01,083659,Cao; Yingjun,0,57,50,50
1650005949153,CSE 134B,A01,083661,Powell; Thomas Allan,0,24,65,65
1650005955180,CSE 140,A01,083663,Staff,8,0,75,67
1650005961208,CSE 140L,A01,083088,Eldon; John,4,0,75,71
1650005967235,CSE 175,A01,083665,Kumar; Rakesh,10,0,25,15
1650005973258,CSE 190,A00,092507,Dubnov; Shlomo,17,0,20,3
1650005979292,ECE 45,A01,083139,Staff,0,8,40,40
1650005985316,ECE 65,A50,083695,Staff,0,1,30,30
1650005991340,ECE 109,A01,091882,Touri; Behrouz,49,0,70,21
1650005997366,ECE 180,A00,083140,Abi Samra; Nicholas Camill,26,0,30,4
1650005997366,ECE 180,B00,083141,Abi Samra; Nicholas Camill,10,0,30,20
1650006003390,MATH 10A,A01,083735,Patchell; Gregory David,14,0,30,16
1650006003390,MATH 10A,A02,083736,Patchell; Gregory David,28,0,30,2
1650006003390,MATH 10A,A03,083737,Patchell; Gregory David,27,0,30,3
1650006009420,MATH 10B,A01,083207,Staff,0,4,30,30
1650006009420,MATH 10B,A02,083208,Staff,1,0,30,29
1650006009420,MATH 10B,B01,083739,Staff,20,0,30,10
1650006009420,MATH 10B,B02,083740,Staff,30,0,30,0
1650006015450,MATH 18,A01,083743,Staff,11,0,30,19
1650006015450,MATH 18,A02,083744,Staff,28,0,30,2
1650006015450,MATH 18,A03,083745,Staff,23,0,30,7
1650006015450,MATH 18,A04,083746,Staff,27,0,30,3
1650006015450,MATH 18,B01,083748,Staff,0,6,30,30
1650006015450,MATH 18,B02,083749,Staff,0,5,30,30
1650006015450,MATH 18,B03,083750,Staff,0,6,30,30
1650006015450,MATH 18,B04,083751,Staff,0,7,30,30
1650006021479,MATH 20A,A01,083754,Staff,27,0,40,13
1650006027503,MATH 20B,A01,083756,Staff,0,5,30,30
1650006027503,MATH 20B,A02,083757,Staff,7,0,30,23
1650006033629,MATH 20C,A01,083760,Staff,0,9,30,30
1650006033629,MATH 20C,A02,083761,Staff,0,10,30,30
1650006033629,MATH 20C,B01,083762,Staff,17,0,30,13
1650006033629,MATH 20C,B02,083763,Staff,29,0,30,1
1650006039653,MATH 20D,A01,083765,Staff,0,2,30,30
1650006039653,MATH 20D,A02,083766,Staff,17,0,30,13
1650006039653,MATH 20D,A03,083767,Staff,28,0,30,2
1650006045677,MATH 20E,A01,083771,Staff,11,0,30,19
1650006045677,MATH 20E,A02,083772,Staff,20,0,30,10
1650006045677,MATH 20E,B01,083773,Staff,0,1,30,30
1650006045677,MATH 20E,B02,083774,Staff,22,0,30,8
1650006051703,MATH 103A,A01,083777,Staff,0,6,30,30
1650006051703,MATH 103A,A02,083778,Staff,0,7,30,30
1650006051703,MATH 103A,B01,083779,Staff,0,6,30,30
1650006051703,MATH 103A,B02,083780,Staff,0,6,30,30
1650006057728,MATH 105,A01,085443,Staff,0,11,30,30
1650006063839,MATH 109,A01,083213,Anzaldo; Leesa B,0,3,30,30
1650006063839,MATH 109,A02,083214,Anzaldo; Leesa B,0,3,30,30
1650006063839,MATH 109,B01,083215,Anzaldo; Leesa B,0,2,30,30
1650006063839,MATH 109,B02,083216,Anzaldo; Leesa B,0,2,30,30
1650006069863,MATH 142A,A01,083219,Chow; Bennett,0,7,30,30
1650006069863,MATH 142A,A02,083220,Chow; Bennett,0,7,30,30
1650006069863,MATH 142A,B01,083221,Chow; Bennett,0,8,30,30
1650006069863,MATH 142A,B02,083222,Chow; Bennett,0,7,30,30
1650006075890,MATH 193A,A01,083224,Staff,0,5,30,30
1650006075890,MATH 193A,A02,083225,Staff,0,4,30,30
1650006075890,MATH 193A,A03,083781,Staff,0,0,30,30
1650006075890,MATH 193A,A04,083782,Staff,9,0,30,21
1650006081914,MATH 197,001,091859,McAuley; Julian John,9999,0,9999,0
1650006087977,COGS 9,A01,083615,Staff,1,15,60,59
1650006094002,COGS 11,A01,083617,Boyle; Mary E. T.,25,0,40,15
1650006100040,COGS 13,A01,083071,Staff,0,28,40,40
1650006106067,COGS 14A,A01,092681,Staff,0,5,100,100
1650006117157,COGS 14B,A01,083073,Cheng; Tzu-Han,0,2,50,50
1650006128131,COGS 17,A01,092677,Staff,35,0,75,40
1650006134157,COGS 100,A01,083619,Staff,0,18,60,60
1650006140180,COGS 101A,A01,083621,Davis; Joshua Daniel,0,16,60,60
1650006146203,COGS 101B,A01,091572,Staff,16,0,60,44
1650006152227,COGS 101C,A01,083625,Delgado; Tania,21,0,30,9
1650006158249,COGS 107A,A01,083627,Boyle; Mary E. T.,0,1,60,60
1650006164273,COGS 118A,A01,083075,Staff,19,0,60,41
1650006170300,CSE 3,A50,083646,Miranda; Gregory Joseph,22,0,38,16
1650006170300,CSE 3,A51,083647,Miranda; Gregory Joseph,37,0,37,0
1650006176323,CSE 8A,A50,083650,Miranda; Gregory Joseph,0,14,40,40
1650006182349,CSE 11,A01,083080,Cao; Yingjun,0,57,40,40
1650006188397,CSE 12,A01,083652,Staff,5,0,100,95
1650006194435,CSE 15L,A01,083654,Staff,0,0,50,50
1650006194435,CSE 15L,A02,083655,Staff,18,0,50,32
1650006200465,CSE 20,A01,083657,Staff,57,0,80,23
1650006206494,CSE 30,A01,083084,Eldon; John,0,62,40,40
1650006212535,CSE 100,A01,083659,Cao; Yingjun,0,57,50,50
1650006218557,CSE 134B,A01,083661,Powell; Thomas Allan,0,24,65,65
1650006224582,CSE 140,A01,083663,Staff,8,0,75,67
1650006230611,CSE 140L,A01,083088,Eldon; John,4,0,75,71
1650006236635,CSE 175,A01,083665,Kumar; Rakesh,10,0,25,15
1650006242659,CSE 190,A00,092507,Dubnov; Shlomo,17,0,20,3
1650006248682,ECE 45,A01,083139,Staff,0,8,40,40
1650006254709,ECE 65,A50,083695,Staff,0,1,30,30
1650006260734,ECE 109,A01,091882,Touri; Behrouz,49,0,70,21
1650006266763,ECE 180,A00,083140,Abi Samra; Nicholas Camill,26,0,30,4
1650006266763,ECE 180,B00,083141,Abi Samra; Nicholas Camill,10,0,30,20
1650006272794,MATH 10A,A01,083735,Patchell; Gregory David,14,0,30,16
1650006272794,MATH 10A,A02,083736,Patchell; Gregory David,28,0,30,2
1650006272794,MATH 10A,A03,083737,Patchell; Gregory David,27,0,30,3
1650006278828,MATH 10B,A01,083207,Staff,0,4,30,30
1650006278828,MATH 10B,A02,083208,Staff,1,0,30,29
1650006278828,MATH 10B,B01,083739,Staff,20,0,30,10
1650006278828,MATH 10B,B02,083740,Staff,30,0,30,0
1650006284863,MATH 18,A01,083743,Staff,11,0,30,19
1650006284863,MATH 18,A02,083744,Staff,28,0,30,2
1650006284863,MATH 18,A03,083745,Staff,23,0,30,7
1650006284863,MATH 18,A04,083746,Staff,27,0,30,3
1650006284863,MATH 18,B01,083748,Staff,0,6,30,30
1650006284863,MATH 18,B02,083749,Staff,0,5,30,30
1650006284863,MATH 18,B03,083750,Staff,0,6,30,30
1650006284863,MATH 18,B04,083751,Staff,0,7,30,30
1650006290890,MATH 20A,A01,083754,Staff,27,0,40,13
1650006296918,MATH 20B,A01,083756,Staff,0,5,30,30
1650006296918,MATH 20B,A02,083757,Staff,7,0,30,23
1650006302943,MATH 20C,A01,083760,Staff,0,9,30,30
1650006302943,MATH 20C,A02,083761,Staff,0,10,30,30
1650006302943,MATH 20C,B01,083762,Staff,17,0,30,13
1650006302943,MATH 20C,B02,083763,Staff,29,0,30,1
1650006308974,MATH 20D,A01,083765,Staff,0,2,30,30
1650006308974,MATH 20D,A02,083766,Staff,17,0,30,13
1650006308974,MATH 20D,A03,083767,Staff,28,0,30,2
1650006315005,MATH 20E,A01,083771,Staff,11,0,30,19
1650006315005,MATH 20E,A02,083772,Staff,20,0,30,10
1650006315005,MATH 20E,B01,083773,Staff,0,1,30,30
1650006315005,MATH 20E,B02,083774,Staff,22,0,30,8
1650006321035,MATH 103A,A01,083777,Staff,0,6,30,30
1650006321035,MATH 103A,A02,083778,Staff,0,7,30,30
1650006321035,MATH 103A,B01,083779,Staff,0,6,30,30
1650006321035,MATH 103A,B02,083780,Staff,0,6,30,30
1650006327066,MATH 105,A01,085443,Staff,0,11,30,30
1650006333103,MATH 109,A01,083213,Anzaldo; Leesa B,0,3,30,30
1650006333103,MATH 109,A02,083214,Anzaldo; Leesa B,0,3,30,30
1650006333103,MATH 109,B01,083215,Anzaldo; Leesa B,0,2,30,30
1650006333103,MATH 109,B02,083216,Anzaldo; Leesa B,0,2,30,30
1650006339130,MATH 142A,A01,083219,Chow; Bennett,0,7,30,30
1650006339130,MATH 142A,A02,083220,Chow; Bennett,0,7,30,30
1650006339130,MATH 142A,B01,083221,Chow; Bennett,0,8,30,30
1650006339130,MATH 142A,B02,083222,Chow; Bennett,0,7,30,30
1650006345158,MATH 193A,A01,083224,Staff,0,5,30,30
1650006345158,MATH 193A,A02,083225,Staff,0,4,30,30
1650006345158,MATH 193A,A03,083781,Staff,0,0,30,30
1650006345158,MATH 193A,A04,083782,Staff,9,0,30,21
1650006351184,MATH 197,001,091859,McAuley; Julian John,9999,0,9999,0
1650006357237,COGS 9,A01,083615,Staff,1,15,60,59
1650006363271,COGS 11,A01,083617,Boyle; Mary E. T.,25,0,40,15
1650006369299,COGS 13,A01,083071,Staff,0,28,40,40
1650006375327,COGS 14A,A01,092681,Staff,0,6,100,100
1650006381360,COGS 14B,A01,083073,Cheng; Tzu-Han,0,2,50,50
1650006387393,COGS 17,A01,092677,Staff,35,0,75,40
1650006393419,COGS 100,A01,083619,Staff,0,18,60,60
1650006399445,COGS 101A,A01,083621,Davis; Joshua Daniel,0,16,60,60
1650006405473,COGS 101B,A01,091572,Staff,16,0,60,44
1650006411502,COGS 101C,A01,083625,Delgado; Tania,21,0,30,9
1650006417524,COGS 107A,A01,083627,Boyle; Mary E. T.,0,1,60,60
1650006423559,COGS 118A,A01,083075,Staff,19,0,60,41
1650006429588,CSE 3,A50,083646,Miranda; Gregory Joseph,22,0,38,16
1650006429588,CSE 3,A51,083647,Miranda; Gregory Joseph,37,0,37,0
1650006435618,CSE 8A,A50,083650,Miranda; Gregory Joseph,0,14,40,40
1650006441645,CSE 11,A01,083080,Cao; Yingjun,0,57,40,40
1650006447669,CSE 12,A01,083652,Staff,5,0,100,95
1650006453702,CSE 15L,A01,083654,Staff,0,0,50,50
1650006453702,CSE 15L,A02,083655,Staff,18,0,50,32
1650006459731,CSE 20,A01,083657,Staff,57,0,80,23
1650006465764,CSE 30,A01,083084,Eldon; John,0,62,40,40
1650006471791,CSE 100,A01,083659,Cao; Yingjun,0,57,50,50
1650006477816,CSE 134B,A01,083661,Powell; Thomas Allan,0,24,65,65
1650006483852,CSE 140,A01,083663,Staff,8,0,75,67
1650006489877,CSE 140L,A01,083088,Eldon; John,4,0,75,71
1650006495905,CSE 175,A01,083665,Kumar; Rakesh,10,0,25,15
1650006501932,CSE 190,A00,092507,Dubnov; Shlomo,17,0,20,3
1650006507956,ECE 45,A01,083139,Staff,0,8,40,40
1650006513984,ECE 65,A50,083695,Staff,0,1,30,30
1650006520015,ECE 109,A01,091882,Touri; Behrouz,49,0,70,21
1650006526048,ECE 180,A00,083140,Abi Samra; Nicholas Camill,26,0,30,4
1650006526048,ECE 180,B00,083141,Abi Samra; Nicholas Camill,10,0,30,20
1650006532078,MATH 10A,A01,083735,Patchell; Gregory David,14,0,30,16
1650006532078,MATH 10A,A02,083736,Patchell; Gregory David,28,0,30,2
1650006532078,MATH 10A,A03,083737,Patchell; Gregory David,27,0,30,3
1650006538101,MATH 10B,A01,083207,Staff,0,4,30,30
1650006538101,MATH 10B,A02,083208,Staff,1,0,30,29
1650006538101,MATH 10B,B01,083739,Staff,20,0,30,10
1650006538101,MATH 10B,B02,083740,Staff,30,0,30,0
1650006544127,MATH 18,A01,083743,Staff,11,0,30,19
1650006544127,MATH 18,A02,083744,Staff,28,0,30,2
1650006544127,MATH 18,A03,083745,Staff,23,0,30,7
1650006544127,MATH 18,A04,083746,Staff,27,0,30,3
1650006544127,MATH 18,B01,083748,Staff,0,6,30,30
1650006544127,MATH 18,B02,083749,Staff,0,5,30,30
1650006544127,MATH 18,B03,083750,Staff,0,6,30,30
1650006544127,MATH 18,B04,083751,Staff,0,7,30,30
1650006550158,MATH 20A,A01,083754,Staff,27,0,40,13
1650006556180,MATH 20B,A01,083756,Staff,0,5,30,30
1650006556180,MATH 20B,A02,083757,Staff,7,0,30,23
1650006562210,MATH 20C,A01,083760,Staff,0,9,30,30
1650006562210,MATH 20C,A02,083761,Staff,0,10,30,30
1650006562210,MATH 20C,B01,083762,Staff,17,0,30,13
1650006562210,MATH 20C,B02,083763,Staff,29,0,30,1
1650006568239,MATH 20D,A01,083765,Staff,0,2,30,30
1650006568239,MATH 20D,A02,083766,Staff,17,0,30,13
1650006568239,MATH 20D,A03,083767,Staff,28,0,30,2
1650006574268,MATH 20E,A01,083771,Staff,11,0,30,19
1650006574268,MATH 20E,A02,083772,Staff,20,0,30,10
1650006574268,MATH 20E,B01,083773,Staff,0,1,30,30
1650006574268,MATH 20E,B02,083774,Staff,22,0,30,8
1650006580297,MATH 103A,A01,083777,Staff,0,6,30,30
1650006580297,MATH 103A,A02,083778,Staff,0,7,30,30
1650006580297,MATH 103A,B01,083779,Staff,0,6,30,30
1650006580297,MATH 103A,B02,083780,Staff,0,6,30,30
1650006586321,MATH 105,A01,085443,Staff,0,11,30,30
1650006592347,MATH 109,A01,083213,Anzaldo; Leesa B,0,3,30,30
1650006592347,MATH 109,A02,083214,Anzaldo; Leesa B,0,3,30,30
1650006592347,MATH 109,B01,083215,Anzaldo; Leesa B,0,2,30,30
1650006592347,MATH 109,B02,083216,Anzaldo; Leesa B,0,2,30,30
1650006598376,MATH 142A,A01,083219,Chow; Bennett,0,7,30,30
1650006598376,MATH 142A,A02,083220,Chow; Bennett,0,7,30,30
1650006598376,MATH 142A,B01,083221,Chow; Bennett,0,8,30,30
1650006598376,MATH 142A,B02,083222,Chow; Bennett,0,7,30,30
1650006604399,MATH 193A,A01,083224,Staff,0,5,30,30
1650006604399,MATH 193A,A02,083225,Staff,0,4,30,30
1650006604399,MATH 193A,A03,083781,Staff,0,0,30,30
1650006604399,MATH 193A,A04,083782,Staff,9,0,30,21
1650006610426,MATH 197,001,091859,McAuley; Julian John,9999,0,9999,0
1650006616478,COGS 9,A01,083615,Staff,1,15,60,59
1650006622511,COGS 11,A01,083617,Boyle; Mary E. T.,25,0,40,15
1650006628535,COGS 13,A01,083071,Staff,0,28,40,40
1650006634647,COGS 14A,A01,092681,Staff,0,6,100,100
1650006640677,COGS 14B,A01,083073,Cheng; Tzu-Han,0,2,50,50
1650006646705,COGS 17,A01,092677,Staff,35,0,75,40
1650006652727,COGS 100,A01,083619,Staff,0,18,60,60
1650006658750,COGS 101A,A01,083621,Davis; Joshua Daniel,0,16,60,60
1650006664772,COGS 101B,A01,091572,Staff,16,0,60,44
1650006670822,COGS 101C,A01,083625,Delgado; Tania,21,0,30,9
1650006676848,COGS 107A,A01,083627,Boyle; Mary E. T.,0,1,60,60
1650006682879,COGS 118A,A01,083075,Staff,19,0,60,41
1650006688911,CSE 3,A50,083646,Miranda; Gregory Joseph,22,0,38,16
1650006688911,CSE 3,A51,083647,Miranda; Gregory Joseph,37,0,37,0
1650006694944,CSE 8A,A50,083650,Miranda; Gregory Joseph,0,14,40,40
1650006701018,CSE 11,A01,083080,Cao; Yingjun,0,57,40,40
1650006707045,CSE 12,A01,083652,Staff,5,0,100,95
1650006713076,CSE 15L,A01,083654,Staff,0,0,50,50
1650006713076,CSE 15L,A02,083655,Staff,18,0,50,32
1650006719104,CSE 20,A01,083657,Staff,57,0,80,23
1650006725131,CSE 30,A01,083084,Eldon; John,0,62,40,40
1650006731163,CSE 100,A01,083659,Cao; Yingjun,0,57,50,50
1650006737191,CSE 134B,A01,083661,Powell; Thomas Allan,0,24,65,65
1650006743225,CSE 140,A01,083663,Staff,8,0,75,67
1650006749252,CSE 140L,A01,083088,Eldon; John,4,0,75,71
1650006755285,CSE 175,A01,083665,Kumar; Rakesh,10,0,25,15
1650006761313,CSE 190,A00,092507,Dubnov; Shlomo,17,0,20,3
1650006767341,ECE 45,A01,083139,Staff,0,8,40,40
1650006773368,ECE 65,A50,083695,Staff,0,1,30,30
1650006779392,ECE 109,A01,091882,Touri; Behrouz,49,0,70,21
1650006785422,ECE 180,A00,083140,Abi Samra; Nicholas Camill,26,0,30,4
1650006785422,ECE 180,B00,083141,Abi Samra; Nicholas Camill,10,0,30,20
1650006791451,MATH 10A,A01,083735,Patchell; Gregory David,14,0,30,16
1650006791451,MATH 10A,A02,083736,Patchell; Gregory David,28,0,30,2
1650006791451,MATH 10A,A03,083737,Patchell; Gregory David,27,0,30,3
1650006797484,MATH 10B,A01,083207,Staff,0,4,30,30
1650006797484,MATH 10B,A02,083208,Staff,1,0,30,29
1650006797484,MATH 10B,B01,083739,Staff,20,0,30,10
1650006797484,MATH 10B,B02,083740,Staff,30,0,30,0
1650006803515,MATH 18,A01,083743,Staff,11,0,30,19
1650006803515,MATH 18,A02,083744,Staff,28,0,30,2
1650006803515,MATH 18,A03,083745,Staff,23,0,30,7
1650006803515,MATH 18,A04,083746,Staff,27,0,30,3
1650006803515,MATH 18,B01,083748,Staff,0,6,30,30
1650006803515,MATH 18,B02,083749,Staff,0,5,30,30
1650006803515,MATH 18,B03,083750,Staff,0,6,30,30
1650006803515,MATH 18,B04,083751,Staff,0,7,30,30
1650006809539,MATH 20A,A01,083754,Staff,27,0,40,13
1650006815563,MATH 20B,A01,083756,Staff,0,5,30,30
1650006815563,MATH 20B,A02,083757,Staff,7,0,30,23
1650006821594,MATH 20C,A01,083760,Staff,0,9,30,30
1650006821594,MATH 20C,A02,083761,Staff,0,10,30,30
1650006821594,MATH 20C,B01,083762,Staff,17,0,30,13
1650006821594,MATH 20C,B02,083763,Staff,29,0,30,1
1650006827619,MATH 20D,A01,083765,Staff,0,2,30,30
1650006827619,MATH 20D,A02,083766,Staff,17,0,30,13
1650006827619,MATH 20D,A03,083767,Staff,28,0,30,2
1650006833646,MATH 20E,A01,083771,Staff,11,0,30,19
1650006833646,MATH 20E,A02,083772,Staff,20,0,30,10
1650006833646,MATH 20E,B01,083773,Staff,0,1,30,30
1650006833646,MATH 20E,B02,083774,Staff,22,0,30,8
1650006839677,MATH 103A,A01,083777,Staff,0,6,30,30
1650006839677,MATH 103A,A02,083778,Staff,0,7,30,30
1650006839677,MATH 103A,B01,083779,Staff,0,6,30,30
1650006839677,MATH 103A,B02,083780,Staff,0,6,30,30
1650006845701,MATH 105,A01,085443,Staff,0,11,30,30
1650006851726,MATH 109,A01,083213,Anzaldo; Leesa B,0,3,30,30
1650006851726,MATH 109,A02,083214,Anzaldo; Leesa B,0,3,30,30
1650006851726,MATH 109,B01,083215,Anzaldo; Leesa B,0,2,30,30
1650006851726,MATH 109,B02,083216,Anzaldo; Leesa B,0,2,30,30
1650006857752,MATH 142A,A01,083219,Chow; Bennett,0,7,30,30
1650006857752,MATH 142A,A02,083220,Chow; Bennett,0,7,30,30
1650006857752,MATH 142A,B01,083221,Chow; Bennett,0,8,30,30
1650006857752,MATH 142A,B02,083222,Chow; Bennett,0,7,30,30
1650006863782,MATH 193A,A01,083224,Staff,0,5,30,30
1650006863782,MATH 193A,A02,083225,Staff,0,4,30,30
1650006863782,MATH 193A,A03,083781,Staff,0,0,30,30
1650006863782,MATH 193A,A04,083782,Staff,9,0,30,21
1650006869806,MATH 197,001,091859,McAuley; Julian John,9999,0,9999,0
1650006875877,COGS 9,A01,083615,Staff,1,15,60,59
1650006881902,COGS 11,A01,083617,Boyle; Mary E. T.,25,0,40,15
1650006887926,COGS 13,A01,083071,Staff,0,28,40,40
1650006893957,COGS 14A,A01,092681,Staff,0,6,100,100
1650006899982,COGS 14B,A01,083073,Cheng; Tzu-Han,0,2,50,50
1650006906004,COGS 17,A01,092677,Staff,35,0,75,40
1650006912033,COGS 100,A01,083619,Staff,0,18,60,60
1650006918058,COGS 101A,A01,083621,Davis; Joshua Daniel,0,16,60,60
1650006924087,COGS 101B,A01,091572,Staff,16,0,60,44
1650006930114,COGS 101C,A01,083625,Delgado; Tania,21,0,30,9
1650006936140,COGS 107A,A01,083627,Boyle; Mary E. T.,0,1,60,60
1650006942168,COGS 118A,A01,083075,Staff,19,0,60,41
1650006948205,CSE 3,A50,083646,Miranda; Gregory Joseph,22,0,38,16
1650006948205,CSE 3,A51,083647,Miranda; Gregory Joseph,37,0,37,0
1650006954230,CSE 8A,A50,083650,Miranda; Gregory Joseph,0,14,40,40
1650006960262,CSE 11,A01,083080,Cao; Yingjun,0,57,40,40
1650006966285,CSE 12,A01,083652,Staff,5,0,100,95
1650006972313,CSE 15L,A01,083654,Staff,0,0,50,50
1650006972313,CSE 15L,A02,083655,Staff,18,0,50,32
1650006978338,CSE 20,A01,083657,Staff,57,0,80,23
1650006984362,CSE 30,A01,083084,Eldon; John,0,62,40,40
1650006990387,CSE 100,A01,083659,Cao; Yingjun,0,57,50,50
1650006996418,CSE 134B,A01,083661,Powell; Thomas Allan,0,24,65,65
1650007002442,CSE 140,A01,083663,Staff,8,0,75,67
1650007008465,CSE 140L,A01,083088,Eldon; John,4,0,75,71
1650007014491,CSE 175,A01,083665,Kumar; Rakesh,10,0,25,15
1650007020520,CSE 190,A00,092507,Dubnov; Shlomo,17,0,20,3
1650007026545,ECE 45,A01,083139,Staff,0,8,40,40
1650007032569,ECE 65,A50,083695,Staff,0,1,30,30
1650007038594,ECE 109,A01,091882,Touri; Behrouz,49,0,70,21
1650007044623,ECE 180,A00,083140,Abi Samra; Nicholas Camill,26,0,30,4
1650007044623,ECE 180,B00,083141,Abi Samra; Nicholas Camill,10,0,30,20
1650007050649,MATH 10A,A01,083735,Patchell; Gregory David,14,0,30,16
1650007050649,MATH 10A,A02,083736,Patchell; Gregory David,28,0,30,2
1650007050649,MATH 10A,A03,083737,Patchell; Gregory David,27,0,30,3
1650007056678,MATH 10B,A01,083207,Staff,0,4,30,30
1650007056678,MATH 10B,A02,083208,Staff,1,0,30,29
1650007056678,MATH 10B,B01,083739,Staff,20,0,30,10
1650007056678,MATH 10B,B02,083740,Staff,30,0,30,0
1650007062710,MATH 18,A01,083743,Staff,11,0,30,19
1650007062710,MATH 18,A02,083744,Staff,28,0,30,2
1650007062710,MATH 18,A03,083745,Staff,23,0,30,7
1650007062710,MATH 18,A04,083746,Staff,27,0,30,3
1650007062710,MATH 18,B01,083748,Staff,0,7,30,30
1650007062710,MATH 18,B02,083749,Staff,0,5,30,30
1650007062710,MATH 18,B03,083750,Staff,0,6,30,30
1650007062710,MATH 18,B04,083751,Staff,0,7,30,30
1650007068739,MATH 20A,A01,083754,Staff,27,0,40,13
1650007074767,MATH 20B,A01,083756,Staff,0,5,30,30
1650007074767,MATH 20B,A02,083757,Staff,7,0,30,23
1650007080791,MATH 20C,A01,083760,Staff,0,9,30,30
1650007080791,MATH 20C,A02,083761,Staff,0,10,30,30
1650007080791,MATH 20C,B01,083762,Staff,17,0,30,13
1650007080791,MATH 20C,B02,083763,Staff,29,0,30,1
1650007086820,MATH 20D,A01,083765,Staff,0,2,30,30
1650007086820,MATH 20D,A02,083766,Staff,17,0,30,13
1650007086820,MATH 20D,A03,083767,Staff,28,0,30,2
1650007092850,MATH 20E,A01,083771,Staff,11,0,30,19
1650007092850,MATH 20E,A02,083772,Staff,20,0,30,10
1650007092850,MATH 20E,B01,083773,Staff,0,1,30,30
1650007092850,MATH 20E,B02,083774,Staff,22,0,30,8
1650007098887,MATH 103A,A01,083777,Staff,0,6,30,30
1650007098887,MATH 103A,A02,083778,Staff,0,7,30,30
1650007098887,MATH 103A,B01,083779,Staff,0,6,30,30
1650007098887,MATH 103A,B02,083780,Staff,0,6,30,30
1650007104913,MATH 105,A01,085443,Staff,0,11,30,30
1650007110937,MATH 109,A01,083213,Anzaldo; Leesa B,0,3,30,30
1650007110937,MATH 109,A02,083214,Anzaldo; Leesa B,0,3,30,30
1650007110937,MATH 109,B01,083215,Anzaldo; Leesa B,0,2,30,30
1650007110937,MATH 109,B02,083216,Anzaldo; Leesa B,0,2,30,30
1650007116963,MATH 142A,A01,083219,Chow; Bennett,0,7,30,30
1650007116963,MATH 142A,A02,083220,Chow; Bennett,0,7,30,30
1650007116963,MATH 142A,B01,083221,Chow; Bennett,0,8,30,30
1650007116963,MATH 142A,B02,083222,Chow; Bennett,0,7,30,30
1650007122992,MATH 193A,A01,083224,Staff,0,5,30,30
1650007122992,MATH 193A,A02,083225,Staff,0,4,30,30
1650007122992,MATH 193A,A03,083781,Staff,0,0,30,30
1650007122992,MATH 193A,A04,083782,Staff,9,0,30,21
1650007129054,MATH 197,001,091859,McAuley; Julian John,9999,0,9999,0
1650007135119,COGS 9,A01,083615,Staff,1,15,60,59
1650007141147,COGS 11,A01,083617,Boyle; Mary E. T.,25,0,40,15
1650007147169,COGS 13,A01,083071,Staff,0,28,40,40
1650007153198,COGS 14A,A01,092681,Staff,0,6,100,100
1650007159221,COGS 14B,A01,083073,Cheng; Tzu-Han,0,2,50,50
1650007165249,COGS 17,A01,092677,Staff,35,0,75,40
1650007171274,COGS 100,A01,083619,Staff,0,18,60,60
1650007177304,COGS 101A,A01,083621,Davis; Joshua Daniel,0,16,60,60
1650007183338,COGS 101B,A01,091572,Staff,16,0,60,44
1650007189369,COGS 101C,A01,083625,Delgado; Tania,21,0,30,9
1650007195397,COGS 107A,A01,083627,Boyle; Mary E. T.,0,1,60,60
1650007201432,COGS 118A,A01,083075,Staff,19,0,60,41
1650007207457,CSE 3,A50,083646,Miranda; Gregory Joseph,22,0,38,16
1650007207457,CSE 3,A51,083647,Miranda; Gregory Joseph,37,0,37,0
1650007213482,CSE 8A,A50,083650,Miranda; Gregory Joseph,0,14,40,40
1650007219507,CSE 11,A01,083080,Cao; Yingjun,0,57,40,40
1650007225536,CSE 12,A01,083652,Staff,5,0,100,95
1650007231639,CSE 15L,A01,083654,Staff,0,0,50,50
1650007231639,CSE 15L,A02,083655,Staff,18,0,50,32
1650007237663,CSE 20,A01,083657,Staff,57,0,80,23
1650007243695,CSE 30,A01,083084,Eldon; John,0,62,40,40
1650007249721,CSE 100,A01,083659,Cao; Yingjun,0,57,50,50
1650007255747,CSE 134B,A01,083661,Powell; Thomas Allan,0,24,65,65
1650007261775,CSE 140,A01,083663,Staff,8,0,75,67
1650007267802,CSE 140L,A01,083088,Eldon; John,4,0,75,71
1650007273826,CSE 175,A01,083665,Kumar; Rakesh,10,0,25,15
1650007279855,CSE 190,A00,092507,Dubnov; Shlomo,17,0,20,3
1650007285882,ECE 45,A01,083139,Staff,0,8,40,40
1650007291908,ECE 65,A50,083695,Staff,0,1,30,30
1650007297939,ECE 109,A01,091882,Touri; Behrouz,49,0,70,21
1650007303969,ECE 180,A00,083140,Abi Samra; Nicholas Camill,26,0,30,4
1650007303969,ECE 180,B00,083141,Abi Samra; Nicholas Camill,10,0,30,20
1650007309999,MATH 10A,A01,083735,Patchell; Gregory David,14,0,30,16
1650007309999,MATH 10A,A02,083736,Patchell; Gregory David,28,0,30,2
1650007309999,MATH 10A,A03,083737,Patchell; Gregory David,27,0,30,3
1650007316023,MATH 10B,A01,083207,Staff,0,4,30,30
1650007316023,MATH 10B,A02,083208,Staff,1,0,30,29
1650007316023,MATH 10B,B01,083739,Staff,20,0,30,10
1650007316023,MATH 10B,B02,083740,Staff,30,0,30,0
1650007322048,MATH 18,A01,083743,Staff,11,0,30,19
1650007322048,MATH 18,A02,083744,Staff,28,0,30,2
1650007322048,MATH 18,A03,083745,Staff,23,0,30,7
1650007322048,MATH 18,A04,083746,Staff,27,0,30,3
1650007322048,MATH 18,B01,083748,Staff,0,6,30,30
1650007322048,MATH 18,B02,083749,Staff,0,6,30,30
1650007322048,MATH 18,B03,083750,Staff,0,6,30,30
1650007322048,MATH 18,B04,083751,Staff,0,7,30,30
1650007328072,MATH 20A,A01,083754,Staff,27,0,40,13
1650007334100,MATH 20B,A01,083756,Staff,0,5,30,30
1650007334100,MATH 20B,A02,083757,Staff,7,0,30,23
1650007340137,MATH 20C,A01,083760,Staff,0,9,30,30
1650007340137,MATH 20C,A02,083761,Staff,0,10,30,30
1650007340137,MATH 20C,B01,083762,Staff,17,0,30,13
1650007340137,MATH 20C,B02,083763,Staff,29,0,30,1
1650007346164,MATH 20D,A01,083765,Staff,0,2,30,30
1650007346164,MATH 20D,A02,083766,Staff,17,0,30,13
1650007346164,MATH 20D,A03,083767,Staff,28,0,30,2
1650007352191,MATH 20E,A01,083771,Staff,11,0,30,19
1650007352191,MATH 20E,A02,083772,Staff,20,0,30,10
1650007352191,MATH 20E,B01,083773,Staff,0,1,30,30
1650007352191,MATH 20E,B02,083774,Staff,22,0,30,8
1650007358219,MATH 103A,A01,083777,Staff,0,6,30,30
1650007358219,MATH 103A,A02,083778,Staff,0,7,30,30
1650007358219,MATH 103A,B01,083779,Staff,0,6,30,30
1650007358219,MATH 103A,B02,083780,Staff,0,6,30,30
1650007364249,MATH 105,A01,085443,Staff,0,11,30,30
1650007370288,MATH 109,A01,083213,Anzaldo; Leesa B,0,3,30,30
1650007370288,MATH 109,A02,083214,Anzaldo; Leesa B,0,3,30,30
1650007370288,MATH 109,B01,083215,Anzaldo; Leesa B,0,2,30,30
1650007370288,MATH 109,B02,083216,Anzaldo; Leesa B,0,2,30,30
1650007376312,MATH 142A,A01,083219,Chow; Bennett,0,7,30,30
1650007376312,MATH 142A,A02,083220,Chow; Bennett,0,7,30,30
1650007376312,MATH 142A,B01,083221,Chow; Bennett,0,8,30,30
1650007376312,MATH 142A,B02,083222,Chow; Bennett,0,7,30,30
1650007382334,MATH 193A,A01,083224,Staff,0,5,30,30
1650007382334,MATH 193A,A02,083225,Staff,0,4,30,30
1650007382334,MATH 193A,A03,083781,Staff,0,0,30,30
1650007382334,MATH 193A,A04,083782,Staff,9,0,30,21
1650007388361,MATH 197,001,091859,McAuley; Julian John,9999,0,9999,0
1650007394417,COGS 9,A01,083615,Staff,1,15,60,59
1650007400443,COGS 11,A01,083617,Boyle; Mary E. T.,25,0,40,15
1650007406469,COGS 13,A01,083071,Staff,0,28,40,40
1650007412494,COGS 14A,A01,092681,Staff,0,6,100,100
1650007418538,COGS 14B,A01,083073,Cheng; Tzu-Han,0,2,50,50
1650007424568,COGS 17,A01,092677,Staff,35,0,75,40
1650007430596,COGS 100,A01,083619,Staff,0,18,60,60
1650007436621,COGS 101A,A01,083621,Davis; Joshua Daniel,0,16,60,60
1650007442656,COGS 101B,A01,091572,Staff,16,0,60,44
1650007448689,COGS 101C,A01,083625,Delgado; Tania,21,0,30,9
1650007454715,COGS 107A,A01,083627,Boyle; Mary E. T.,0,1,60,60
1650007460742,COGS 118A,A01,083075,Staff,19,0,60,41
1650007466781,CSE 3,A50,083646,Miranda; Gregory Joseph,22,0,38,16
1650007466781,CSE 3,A51,083647,Miranda; Gregory Joseph,37,0,37,0
1650007472805,CSE 8A,A50,083650,Miranda; Gregory Joseph,0,14,40,40
1650007478837,CSE 11,A01,083080,Cao; Yingjun,0,57,40,40
1650007484864,CSE 12,A01,083652,Staff,5,0,100,95
1650007490889,CSE 15L,A01,083654,Staff,0,0,50,50
1650007490889,CSE 15L,A02,083655,Staff,18,0,50,32
1650007496914,CSE 20,A01,083657,Staff,57,0,80,23
1650007502941,CSE 30,A01,083084,Eldon; John,0,62,40,40
1650007508975,CSE 100,A01,083659,Cao; Yingjun,0,57,50,50
1650007515003,CSE 134B,A01,083661,Powell; Thomas Allan,0,24,65,65
1650007521041,CSE 140,A01,083663,Staff,8,0,75,67
1650007527072,CSE 140L,A01,083088,Eldon; John,4,0,75,71
1650007533102,CSE 175,A01,083665,Kumar; Rakesh,10,0,25,15
1650007539127,CSE 190,A00,092507,Dubnov; Shlomo,17,0,20,3
1650007545151,ECE 45,A01,083139,Staff,0,8,40,40
1650007551178,ECE 65,A50,083695,Staff,0,1,30,30
1650007557203,ECE 109,A01,091882,Touri; Behrouz,48,0,70,22
1650007563228,ECE 180,A00,083140,Abi Samra; Nicholas Camill,26,0,30,4
1650007563228,ECE 180,B00,083141,Abi Samra; Nicholas Camill,10,0,30,20
1650007569257,MATH 10A,A01,083735,Patchell; Gregory David,14,0,30,16
1650007569257,MATH 10A,A02,083736,Patchell; Gregory David,28,0,30,2
1650007569257,MATH 10A,A03,083737,Patchell; Gregory David,27,0,30,3
1650007575283,MATH 10B,A01,083207,Staff,0,4,30,30
1650007575283,MATH 10B,A02,083208,Staff,1,0,30,29
1650007575283,MATH 10B,B01,083739,Staff,20,0,30,10
1650007575283,MATH 10B,B02,083740,Staff,30,0,30,0
1650007581316,MATH 18,A01,083743,Staff,11,0,30,19
1650007581316,MATH 18,A02,083744,Staff,28,0,30,2
1650007581316,MATH 18,A03,083745,Staff,23,0,30,7
1650007581316,MATH 18,A04,083746,Staff,27,0,30,3
1650007581316,MATH 18,B01,083748,Staff,0,6,30,30
1650007581316,MATH 18,B02,083749,Staff,0,6,30,30
1650007581316,MATH 18,B03,083750,Staff,0,6,30,30
1650007581316,MATH 18,B04,083751,Staff,0,7,30,30
1650007587343,MATH 20A,A01,083754,Staff,27,0,40,13
1650007593372,MATH 20B,A01,083756,Staff,0,4,30,30
1650007593372,MATH 20B,A02,083757,Staff,6,0,30,24
1650007599397,MATH 20C,A01,083760,Staff,0,9,30,30
1650007599397,MATH 20C,A02,083761,Staff,0,10,30,30
1650007599397,MATH 20C,B01,083762,Staff,17,0,30,13
1650007599397,MATH 20C,B02,083763,Staff,29,0,30,1
1650007605428,MATH 20D,A01,083765,Staff,0,2,30,30
1650007605428,MATH 20D,A02,083766,Staff,17,0,30,13
1650007605428,MATH 20D,A03,083767,Staff,28,0,30,2
1650007611455,MATH 20E,A01,083771,Staff,11,0,30,19
1650007611455,MATH 20E,A02,083772,Staff,20,0,30,10
1650007611455,MATH 20E,B01,083773,Staff,0,1,30,30
1650007611455,MATH 20E,B02,083774,Staff,21,0,30,9
1650007617491,MATH 103A,A01,083777,Staff,0,6,30,30
1650007617491,MATH 103A,A02,083778,Staff,0,7,30,30
1650007617491,MATH 103A,B01,083779,Staff,0,6,30,30
1650007617491,MATH 103A,B02,083780,Staff,0,6,30,30
1650007623523,MATH 105,A01,085443,Staff,0,11,30,30
1650007629550,MATH 109,A01,083213,Anzaldo; Leesa B,0,3,30,30
1650007629550,MATH 109,A02,083214,Anzaldo; Leesa B,0,3,30,30
1650007629550,MATH 109,B01,083215,Anzaldo; Leesa B,0,2,30,30
1650007629550,MATH 109,B02,083216,Anzaldo; Leesa B,0,2,30,30
1650007635580,MATH 142A,A01,083219,Chow; Bennett,0,7,30,30
1650007635580,MATH 142A,A02,083220,Chow; Bennett,0,7,30,30
1650007635580,MATH 142A,B01,083221,Chow; Bennett,0,8,30,30
1650007635580,MATH 142A,B02,083222,Chow; Bennett,0,7,30,30
1650007641618,MATH 193A,A01,083224,Staff,0,5,30,30
1650007641618,MATH 193A,A02,083225,Staff,0,4,30,30
1650007641618,MATH 193A,A03,083781,Staff,0,0,30,30
1650007641618,MATH 193A,A04,083782,Staff,9,0,30,21
1650007647642,MATH 197,001,091859,McAuley; Julian John,9999,0,9999,0
1650007653706,COGS 9,A01,083615,Staff,1,15,60,59
1650007659731,COGS 11,A01,083617,Boyle; Mary E. T.,25,0,40,15
1650007665754,COGS 13,A01,083071,Staff,0,28,40,40
1650007671779,COGS 14A,A01,092681,Staff,0,6,100,100
1650007677807,COGS 14B,A01,083073,Cheng; Tzu-Han,0,2,50,50
1650007683833,COGS 17,A01,092677,Staff,35,0,75,40
1650007689856,COGS 100,A01,083619,Staff,0,18,60,60
1650007695881,COGS 101A,A01,083621,Davis; Joshua Daniel,0,16,60,60
1650007701914,COGS 101B,A01,091572,Staff,16,0,60,44
1650007707939,COGS 101C,A01,083625,Delgado; Tania,21,0,30,9
1650007713966,COGS 107A,A01,083627,Boyle; Mary E. T.,0,1,60,60
1650007719989,COGS 118A,A01,083075,Staff,19,0,60,41
1650007726012,CSE 3,A50,083646,Miranda; Gregory Joseph,22,0,38,16
1650007726012,CSE 3,A51,083647,Miranda; Gregory Joseph,37,0,37,0
1650007732037,CSE 8A,A50,083650,Miranda; Gregory Joseph,0,14,40,40
1650007738059,CSE 11,A01,083080,Cao; Yingjun,0,57,40,40
1650007744085,CSE 12,A01,083652,Staff,5,0,100,95
1650007750115,CSE 15L,A01,083654,Staff,0,0,50,50
1650007750115,CSE 15L,A02,083655,Staff,18,0,50,32
1650007756141,CSE 20,A01,083657,Staff,57,0,80,23
1650007762165,CSE 30,A01,083084,Eldon; John,0,62,40,40
1650007768193,CSE 100,A01,083659,Cao; Yingjun,0,57,50,50
1650007774216,CSE 134B,A01,083661,Powell; Thomas Allan,0,24,65,65
1650007780243,CSE 140,A01,083663,Staff,8,0,75,67
1650007786269,CSE 140L,A01,083088,Eldon; John,4,0,75,71
1650007792294,CSE 175,A01,083665,Kumar; Rakesh,10,0,25,15
1650007798321,CSE 190,A00,092507,Dubnov; Shlomo,17,0,20,3
1650007804348,ECE 45,A01,083139,Staff,0,9,40,40
1650007810373,ECE 65,A50,083695,Staff,0,1,30,30
1650007816397,ECE 109,A01,091882,Touri; Behrouz,48,0,70,22
1650007822421,ECE 180,A00,083140,Abi Samra; Nicholas Camill,26,0,30,4
1650007822421,ECE 180,B00,083141,Abi Samra; Nicholas Camill,10,0,30,20
1650007828542,MATH 10A,A01,083735,Patchell; Gregory David,14,0,30,16
1650007828542,MATH 10A,A02,083736,Patchell; Gregory David,28,0,30,2
1650007828542,MATH 10A,A03,083737,Patchell; Gregory David,27,0,30,3
1650007834566,MATH 10B,A01,083207,Staff,0,4,30,30
1650007834566,MATH 10B,A02,083208,Staff,1,0,30,29
1650007834566,MATH 10B,B01,083739,Staff,20,0,30,10
1650007834566,MATH 10B,B02,083740,Staff,30,0,30,0
1650007840590,MATH 18,A01,083743,Staff,11,0,30,19
1650007840590,MATH 18,A02,083744,Staff,28,0,30,2
1650007840590,MATH 18,A03,083745,Staff,23,0,30,7
1650007840590,MATH 18,A04,083746,Staff,27,0,30,3
1650007840590,MATH 18,B01,083748,Staff,0,6,30,30
1650007840590,MATH 18,B02,083749,Staff,0,6,30,30
1650007840590,MATH 18,B03,083750,Staff,0,6,30,30
1650007840590,MATH 18,B04,083751,Staff,0,7,30,30
1650007846621,MATH 20A,A01,083754,Staff,27,0,40,13
1650007852647,MATH 20B,A01,083756,Staff,0,4,30,30
1650007852647,MATH 20B,A02,083757,Staff,6,0,30,24
1650007858677,MATH 20C,A01,083760,Staff,0,9,30,30
1650007858677,MATH 20C,A02,083761,Staff,0,10,30,30
1650007858677,MATH 20C,B01,083762,Staff,17,0,30,13
1650007858677,MATH 20C,B02,083763,Staff,29,0,30,1
1650007864701,MATH 20D,A01,083765,Staff,0,2,30,30
1650007864701,MATH 20D,A02,083766,Staff,17,0,30,13
1650007864701,MATH 20D,A03,083767,Staff,28,0,30,2
1650007870726,MATH 20E,A01,083771,Staff,11,0,30,19
1650007870726,MATH 20E,A02,083772,Staff,20,0,30,10
1650007870726,MATH 20E,B01,083773,Staff,0,1,30,30
1650007870726,MATH 20E,B02,083774,Staff,21,0,30,9
1650007876759,MATH 103A,A01,083777,Staff,0,6,30,30
1650007876759,MATH 103A,A02,083778,Staff,0,7,30,30
1650007876759,MATH 103A,B01,083779,Staff,0,6,30,30
1650007876759,MATH 103A,B02,083780,Staff,0,6,30,30
1650007882784,MATH 105,A01,085443,Staff,0,11,30,30
1650007888813,MATH 109,A01,083213,Anzaldo; Leesa B,0,3,30,30
1650007888813,MATH 109,A02,083214,Anzaldo; Leesa B,0,3,30,30
1650007888813,MATH 109,B01,083215,Anzaldo; Leesa B,0,2,30,30
1650007888813,MATH 109,B02,083216,Anzaldo; Leesa B,0,2,30,30
1650007894848,MATH 142A,A01,083219,Chow; Bennett,0,7,30,30
1650007894848,MATH 142A,A02,083220,Chow; Bennett,0,7,30,30
1650007894848,MATH 142A,B01,083221,Chow; Bennett,0,8,30,30
1650007894848,MATH 142A,B02,083222,Chow; Bennett,0,7,30,30
1650007900880,MATH 193A,A01,083224,Staff,0,5,30,30
1650007900880,MATH 193A,A02,083225,Staff,0,4,30,30
1650007900880,MATH 193A,A03,083781,Staff,0,0,30,30
1650007900880,MATH 193A,A04,083782,Staff,9,0,30,21
1650007906922,MATH 197,001,091859,McAuley; Julian John,9999,0,9999,0
1650007913018,COGS 9,A01,083615,Staff,1,15,60,59
1650007919040,COGS 11,A01,083617,Boyle; Mary E. T.,25,0,40,15
1650007925071,COGS 13,A01,083071,Staff,0,28,40,40
1650007931109,COGS 14A,A01,092681,Staff,0,6,100,100
1650007937134,COGS 14B,A01,083073,Cheng; Tzu-Han,0,2,50,50
1650007943161,COGS 17,A01,092677,Staff,35,0,75,40
1650007949186,COGS 100,A01,083619,Staff,0,18,60,60
1650007955240,COGS 101A,A01,083621,Davis; Joshua Daniel,0,16,60,60
1650007961267,COGS 101B,A01,091572,Staff,16,0,60,44
1650007967295,COGS 101C,A01,083625,Delgado; Tania,21,0,30,9
1650007973323,COGS 107A,A01,083627,Boyle; Mary E. T.,0,1,60,60
1650007979347,COGS 118A,A01,083075,Staff,19,0,60,41
1650007985371,CSE 3,A50,083646,Miranda; Gregory Joseph,22,0,38,16
1650007985371,CSE 3,A51,083647,Miranda; Gregory Joseph,37,0,37,0
1650007991393,CSE 8A,A50,083650,Miranda; Gregory Joseph,0,14,40,40
1650007997416,CSE 11,A01,083080,Cao; Yingjun,0,57,40,40
1650008003447,CSE 12,A01,083652,Staff,5,0,100,95
1650008009469,CSE 15L,A01,083654,Staff,0,0,50,50
1650008009469,CSE 15L,A02,083655,Staff,18,0,50,32
1650008015498,CSE 20,A01,083657,Staff,57,0,80,23
1650008021527,CSE 30,A01,083084,Eldon; John,0,62,40,40
1650008027558,CSE 100,A01,083659,Cao; Yingjun,0,57,50,50
1650008033583,CSE 134B,A01,083661,Powell; Thomas Allan,0,24,65,65
1650008039608,CSE 140,A01,083663,Staff,8,0,75,67
1650008045639,CSE 140L,A01,083088,Eldon; John,4,0,75,71
1650008051663,CSE 175,A01,083665,Kumar; Rakesh,10,0,25,15
1650008057691,CSE 190,A00,092507,Dubnov; Shlomo,17,0,20,3
1650008063725,ECE 45,A01,083139,Staff,0,9,40,40
1650008069751,ECE 65,A50,083695,Staff,0,1,30,30
1650008075777,ECE 109,A01,091882,Touri; Behrouz,48,0,70,22
1650008081802,ECE 180,A00,083140,Abi Samra; Nicholas Camill,26,0,30,4
1650008081802,ECE 180,B00,083141,Abi Samra; Nicholas Camill,10,0,30,20
1650008087834,MATH 10A,A01,083735,Patchell; Gregory David,14,0,30,16
1650008087834,MATH 10A,A02,083736,Patchell; Gregory David,28,0,30,2
1650008087834,MATH 10A,A03,083737,Patchell; Gregory David,27,0,30,3
1650008093863,MATH 10B,A01,083207,Staff,0,4,30,30
1650008093863,MATH 10B,A02,083208,Staff,1,0,30,29
1650008093863,MATH 10B,B01,083739,Staff,20,0,30,10
1650008093863,MATH 10B,B02,083740,Staff,30,0,30,0
1650008099896,MATH 18,A01,083743,Staff,11,0,30,19
1650008099896,MATH 18,A02,083744,Staff,28,0,30,2
1650008099896,MATH 18,A03,083745,Staff,23,0,30,7
1650008099896,MATH 18,A04,083746,Staff,27,0,30,3
1650008099896,MATH 18,B01,083748,Staff,0,6,30,30
1650008099896,MATH 18,B02,083749,Staff,0,6,30,30
1650008099896,MATH 18,B03,083750,Staff,0,6,30,30
1650008099896,MATH 18,B04,083751,Staff,0,7,30,30
1650008105929,MATH 20A,A01,083754,Staff,27,0,40,13
1650008111954,MATH 20B,A01,083756,Staff,0,4,30,30
1650008111954,MATH 20B,A02,083757,Staff,6,0,30,24
1650008117979,MATH 20C,A01,083760,Staff,0,9,30,30
1650008117979,MATH 20C,A02,083761,Staff,0,10,30,30
1650008117979,MATH 20C,B01,083762,Staff,17,0,30,13
1650008117979,MATH 20C,B02,083763,Staff,29,0,30,1
1650008124008,MATH 20D,A01,083765,Staff,0,2,30,30
1650008124008,MATH 20D,A02,083766,Staff,17,0,30,13
1650008124008,MATH 20D,A03,083767,Staff,28,0,30,2
1650008130040,MATH 20E,A01,083771,Staff,11,0,30,19
1650008130040,MATH 20E,A02,083772,Staff,20,0,30,10
1650008130040,MATH 20E,B01,083773,Staff,0,1,30,30
1650008130040,MATH 20E,B02,083774,Staff,21,0,30,9
1650008136072,MATH 103A,A01,083777,Staff,0,6,30,30
1650008136072,MATH 103A,A02,083778,Staff,0,7,30,30
1650008136072,MATH 103A,B01,083779,Staff,0,6,30,30
1650008136072,MATH 103A,B02,083780,Staff,0,6,30,30
1650008142102,MATH 105,A01,085443,Staff,0,11,30,30
1650008148133,MATH 109,A01,083213,Anzaldo; Leesa B,0,3,30,30
1650008148133,MATH 109,A02,083214,Anzaldo; Leesa B,0,3,30,30
1650008148133,MATH 109,B01,083215,Anzaldo; Leesa B,0,2,30,30
1650008148133,MATH 109,B02,083216,Anzaldo; Leesa B,0,2,30,30
1650008154163,MATH 142A,A01,083219,Chow; Bennett,0,7,30,30
1650008154163,MATH 142A,A02,083220,Chow; Bennett,0,7,30,30
1650008154163,MATH 142A,B01,083221,Chow; Bennett,0,8,30,30
1650008154163,MATH 142A,B02,083222,Chow; Bennett,0,7,30,30
1650008160192,MATH 193A,A01,083224,Staff,0,5,30,30
1650008160192,MATH 193A,A02,083225,Staff,0,4,30,30
1650008160192,MATH 193A,A03,083781,Staff,0,0,30,30
1650008160192,MATH 193A,A04,083782,Staff,9,0,30,21
1650008166217,MATH 197,001,091859,McAuley; Julian John,9999,0,9999,0
1650008172277,COGS 9,A01,083615,Staff,1,15,60,59
1650008178300,COGS 11,A01,083617,Boyle; Mary E. T.,25,0,40,15
1650008184328,COGS 13,A01,083071,Staff,0,28,40,40
1650008190353,COGS 14A,A01,092681,Staff,0,6,100,100
1650008196381,COGS 14B,A01,083073,Cheng; Tzu-Han,0,2,50,50
1650008202405,COGS 17,A01,092677,Staff,35,0,75,40
1650008208430,COGS 100,A01,083619,Staff,0,18,60,60
1650008214458,COGS 101A,A01,083621,Davis; Joshua Daniel,0,16,60,60
1650008220496,COGS 101B,A01,091572,Staff,16,0,60,44
1650008226522,COGS 101C,A01,083625,Delgado; Tania,21,0,30,9
1650008232550,COGS 107A,A01,083627,Boyle; Mary E. T.,0,1,60,60
1650008238580,COGS 118A,A01,083075,Staff,19,0,60,41
1650008244606,CSE 3,A50,083646,Miranda; Gregory Joseph,22,0,38,16
1650008244606,CSE 3,A51,083647,Miranda; Gregory Joseph,37,0,37,0
1650008250632,CSE 8A,A50,083650,Miranda; Gregory Joseph,0,14,40,40
1650008256661,CSE 11,A01,083080,Cao; Yingjun,0,57,40,40
1650008262693,CSE 12,A01,083652,Staff,4,0,100,96
1650008268720,CSE 15L,A01,083654,Staff,0,0,50,50
1650008268720,CSE 15L,A02,083655,Staff,17,0,50,33
1650008274745,CSE 20,A01,083657,Staff,57,0,80,23
1650008280771,CSE 30,A01,083084,Eldon; John,0,62,40,40
1650008286795,CSE 100,A01,083659,Cao; Yingjun,0,57,50,50
1650008292825,CSE 134B,A01,083661,Powell; Thomas Allan,0,24,65,65
1650008298848,CSE 140,A01,083663,Staff,8,0,75,67
1650008304877,CSE 140L,A01,083088,Eldon; John,4,0,75,71
1650008310907,CSE 175,A01,083665,Kumar; Rakesh,10,0,25,15
1650008316935,CSE 190,A00,092507,Dubnov; Shlomo,17,0,20,3
1650008322962,ECE 45,A01,083139,Staff,0,9,40,40
1650008328988,ECE 65,A50,083695,Staff,0,1,30,30
1650008335012,ECE 109,A01,091882,Touri; Behrouz,48,0,70,22
1650008341036,ECE 180,A00,083140,Abi Samra; Nicholas Camill,26,0,30,4
1650008341036,ECE 180,B00,083141,Abi Samra; Nicholas Camill,10,0,30,20
1650008347068,MATH 10A,A01,083735,Patchell; Gregory David,14,0,30,16
1650008347068,MATH 10A,A02,083736,Patchell; Gregory David,28,0,30,2
1650008347068,MATH 10A,A03,083737,Patchell; Gregory David,27,0,30,3
1650008353098,MATH 10B,A01,083207,Staff,0,4,30,30
1650008353098,MATH 10B,A02,083208,Staff,1,0,30,29
1650008353098,MATH 10B,B01,083739,Staff,20,0,30,10
1650008353098,MATH 10B,B02,083740,Staff,30,0,30,0
1650008359129,MATH 18,A01,083743,Staff,10,0,30,20
1650008359129,MATH 18,A02,083744,Staff,28,0,30,2
1650008359129,MATH 18,A03,083745,Staff,23,0,30,7
1650008359129,MATH 18,A04,083746,Staff,27,0,30,3
1650008359129,MATH 18,B01,083748,Staff,0,6,30,30
1650008359129,MATH 18,B02,083749,Staff,0,6,30,30
1650008359129,MATH 18,B03,083750,Staff,0,6,30,30
1650008359129,MATH 18,B04,083751,Staff,0,7,30,30
1650008365155,MATH 20A,A01,083754,Staff,27,0,40,13
1650008371183,MATH 20B,A01,083756,Staff,0,4,30,30
1650008371183,MATH 20B,A02,083757,Staff,5,0,30,25
1650008377207,MATH 20C,A01,083760,Staff,0,9,30,30
1650008377207,MATH 20C,A02,083761,Staff,0,10,30,30
1650008377207,MATH 20C,B01,083762,Staff,17,0,30,13
1650008377207,MATH 20C,B02,083763,Staff,29,0,30,1
1650008383232,MATH 20D,A01,083765,Staff,0,2,30,30
1650008383232,MATH 20D,A02,083766,Staff,16,0,30,14
1650008383232,MATH 20D,A03,083767,Staff,28,0,30,2
1650008389257,MATH 20E,A01,083771,Staff,11,0,30,19
1650008389257,MATH 20E,A02,083772,Staff,20,0,30,10
1650008389257,MATH 20E,B01,083773,Staff,0,1,30,30
1650008389257,MATH 20E,B02,083774,Staff,21,0,30,9
1650008395282,MATH 103A,A01,083777,Staff,0,6,30,30
1650008395282,MATH 103A,A02,083778,Staff,0,7,30,30
1650008395282,MATH 103A,B01,083779,Staff,0,6,30,30
1650008395282,MATH 103A,B02,083780,Staff,0,6,30,30
1650008401309,MATH 105,A01,085443,Staff,0,11,30,30
1650008407336,MATH 109,A01,083213,Anzaldo; Leesa B,0,3,30,30
1650008407336,MATH 109,A02,083214,Anzaldo; Leesa B,0,3,30,30
1650008407336,MATH 109,B01,083215,Anzaldo; Leesa B,0,2,30,30
1650008407336,MATH 109,B02,083216,Anzaldo; Leesa B,0,2,30,30
1650008413368,MATH 142A,A01,083219,Chow; Bennett,0,7,30,30
1650008413368,MATH 142A,A02,083220,Chow; Bennett,0,7,30,30
1650008413368,MATH 142A,B01,083221,Chow; Bennett,0,8,30,30
1650008413368,MATH 142A,B02,083222,Chow; Bennett,0,7,30,30
1650008419394,MATH 193A,A01,083224,Staff,0,5,30,30
1650008419394,MATH 193A,A02,083225,Staff,0,4,30,30
1650008419394,MATH 193A,A03,083781,Staff,0,0,30,30
1650008419394,MATH 193A,A04,083782,Staff,9,0,30,21
1650008425510,MATH 197,001,091859,McAuley; Julian John,9999,0,9999,0
1650008431587,COGS 9,A01,083615,Staff,1,15,60,59
1650008437613,COGS 11,A01,083617,Boyle; Mary E. T.,25,0,40,15
1650008443642,COGS 13,A01,083071,Staff,0,28,40,40
1650008449666,COGS 14A,A01,092681,Staff,0,6,100,100
1650008455691,COGS 14B,A01,083073,Cheng; Tzu-Han,0,2,50,50
1650008461716,COGS 17,A01,092677,Staff,35,0,75,40
1650008467739,COGS 100,A01,083619,Staff,0,18,60,60
1650008473764,COGS 101A,A01,083621,Davis; Joshua Daniel,0,16,60,60
1650008479799,COGS 101B,A01,091572,Staff,16,0,60,44
1650008485825,COGS 101C,A01,083625,Delgado; Tania,21,0,30,9
1650008491855,COGS 107A,A01,083627,Boyle; Mary E. T.,0,1,60,60
1650008497880,COGS 118A,A01,083075,Staff,19,0,60,41
1650008503907,CSE 3,A50,083646,Miranda; Gregory Joseph,22,0,38,16
1650008503907,CSE 3,A51,083647,Miranda; Gregory Joseph,37,0,37,0
1650008509965,CSE 8A,A50,083650,Miranda; Gregory Joseph,0,14,40,40
1650008515992,CSE 11,A01,083080,Cao; Yingjun,0,57,40,40
1650008522014,CSE 12,A01,083652,Staff,3,0,100,97
1650008528045,CSE 15L,A01,083654,Staff,0,0,50,50
1650008528045,CSE 15L,A02,083655,Staff,16,0,50,34
1650008534070,CSE 20,A01,083657,Staff,57,0,80,23
1650008540095,CSE 30,A01,083084,Eldon; John,0,62,40,40
1650008546126,CSE 100,A01,083659,Cao; Yingjun,0,57,50,50
1650008552154,CSE 134B,A01,083661,Powell; Thomas Allan,0,24,65,65
1650008558179,CSE 140,A01,083663,Staff,8,0,75,67
1650008564202,CSE 140L,A01,083088,Eldon; John,4,0,75,71
1650008570234,CSE 175,A01,083665,Kumar; Rakesh,10,0,25,15
1650008576264,CSE 190,A00,092507,Dubnov; Shlomo,17,0,20,3
1650008582291,ECE 45,A01,083139,Staff,0,9,40,40
1650008588315,ECE 65,A50,083695,Staff,0,1,30,30
1650008594347,ECE 109,A01,091882,Touri; Behrouz,48,0,70,22
1650008600371,ECE 180,A00,083140,Abi Samra; Nicholas Camill,26,0,30,4
1650008600371,ECE 180,B00,083141,Abi Samra; Nicholas Camill,10,0,30,20
1650008606405,MATH 10A,A01,083735,Patchell; Gregory David,14,0,30,16
1650008606405,MATH 10A,A02,083736,Patchell; Gregory David,28,0,30,2
1650008606405,MATH 10A,A03,083737,Patchell; Gregory David,27,0,30,3
1650008612435,MATH 10B,A01,083207,Staff,0,4,30,30
1650008612435,MATH 10B,A02,083208,Staff,1,0,30,29
1650008612435,MATH 10B,B01,083739,Staff,20,0,30,10
1650008612435,MATH 10B,B02,083740,Staff,30,0,30,0
1650008618462,MATH 18,A01,083743,Staff,10,0,30,20
1650008618462,MATH 18,A02,083744,Staff,28,0,30,2
1650008618462,MATH 18,A03,083745,Staff,23,0,30,7
1650008618462,MATH 18,A04,083746,Staff,27,0,30,3
1650008618462,MATH 18,B01,083748,Staff,0,6,30,30
1650008618462,MATH 18,B02,083749,Staff,0,6,30,30
1650008618462,MATH 18,B03,083750,Staff,0,6,30,30
1650008618462,MATH 18,B04,083751,Staff,0,7,30,30
1650008624487,MATH 20A,A01,083754,Staff,27,0,40,13
1650008630511,MATH 20B,A01,083756,Staff,0,4,30,30
1650008630511,MATH 20B,A02,083757,Staff,5,0,30,25
1650008636537,MATH 20C,A01,083760,Staff,0,9,30,30
1650008636537,MATH 20C,A02,083761,Staff,0,10,30,30
1650008636537,MATH 20C,B01,083762,Staff,17,0,30,13
1650008636537,MATH 20C,B02,083763,Staff,29,0,30,1
1650008642568,MATH 20D,A01,083765,Staff,0,2,30,30
1650008642568,MATH 20D,A02,083766,Staff,16,0,30,14
1650008642568,MATH 20D,A03,083767,Staff,28,0,30,2
1650008648592,MATH 20E,A01,083771,Staff,11,0,30,19
1650008648592,MATH 20E,A02,083772,Staff,20,0,30,10
1650008648592,MATH 20E,B01,083773,Staff,0,1,30,30
1650008648592,MATH 20E,B02,083774,Staff,21,0,30,9
1650008654628,MATH 103A,A01,083777,Staff,0,6,30,30
1650008654628,MATH 103A,A02,083778,Staff,0,7,30,30
1650008654628,MATH 103A,B01,083779,Staff,0,6,30,30
1650008654628,MATH 103A,B02,083780,Staff,0,6,30,30
1650008660661,MATH 105,A01,085443,Staff,0,11,30,30
1650008666693,MATH 109,A01,083213,Anzaldo; Leesa B,0,3,30,30
1650008666693,MATH 109,A02,083214,Anzaldo; Leesa B,0,3,30,30
1650008666693,MATH 109,B01,083215,Anzaldo; Leesa B,0,2,30,30
1650008666693,MATH 109,B02,083216,Anzaldo; Leesa B,0,2,30,30
1650008672719,MATH 142A,A01,083219,Chow; Bennett,0,7,30,30
1650008672719,MATH 142A,A02,083220,Chow; Bennett,0,7,30,30
1650008672719,MATH 142A,B01,083221,Chow; Bennett,0,8,30,30
1650008672719,MATH 142A,B02,083222,Chow; Bennett,0,7,30,30
1650008678749,MATH 193A,A01,083224,Staff,0,5,30,30
1650008678749,MATH 193A,A02,083225,Staff,0,4,30,30
1650008678749,MATH 193A,A03,083781,Staff,0,0,30,30
1650008678749,MATH 193A,A04,083782,Staff,9,0,30,21
1650008684771,MATH 197,001,091859,McAuley; Julian John,9999,0,9999,0
1650008690846,COGS 9,A01,083615,Staff,1,15,60,59
1650008696871,COGS 11,A01,083617,Boyle; Mary E. T.,25,0,40,15
1650008702894,COGS 13,A01,083071,Staff,0,28,40,40
1650008708919,COGS 14A,A01,092681,Staff,0,6,100,100
1650008714944,COGS 14B,A01,083073,Cheng; Tzu-Han,0,2,50,50
1650008720982,COGS 17,A01,092677,Staff,35,0,75,40
1650008727005,COGS 100,A01,083619,Staff,0,18,60,60
1650008733033,COGS 101A,A01,083621,Davis; Joshua Daniel,0,16,60,60
1650008739063,COGS 101B,A01,091572,Staff,16,0,60,44
1650008745090,COGS 101C,A01,083625,Delgado; Tania,21,0,30,9
1650008751116,COGS 107A,A01,083627,Boyle; Mary E. T.,0,1,60,60
1650008757153,COGS 118A,A01,083075,Staff,19,0,60,41
1650008763185,CSE 3,A50,083646,Miranda; Gregory Joseph,22,0,38,16
1650008763185,CSE 3,A51,083647,Miranda; Gregory Joseph,37,0,37,0
1650008769212,CSE 8A,A50,083650,Miranda; Gregory Joseph,0,14,40,40
1650008775238,CSE 11,A01,083080,Cao; Yingjun,0,57,40,40
1650008781277,CSE 12,A01,083652,Staff,2,0,100,98
1650008787300,CSE 15L,A01,083654,Staff,0,0,50,50
1650008787300,CSE 15L,A02,083655,Staff,15,0,50,35
1650008793324,CSE 20,A01,083657,Staff,57,0,80,23
1650008799357,CSE 30,A01,083084,Eldon; John,0,62,40,40
1650008805392,CSE 100,A01,083659,Cao; Yingjun,0,57,50,50
1650008811424,CSE 134B,A01,083661,Powell; Thomas Allan,0,24,65,65
1650008817448,CSE 140,A01,083663,Staff,8,0,75,67
1650008823478,CSE 140L,A01,083088,Eldon; John,4,0,75,71
1650008829503,CSE 175,A01,083665,Kumar; Rakesh,10,0,25,15
1650008835532,CSE 190,A00,092507,Dubnov; Shlomo,17,0,20,3
1650008841557,ECE 45,A01,083139,Staff,0,9,40,40
1650008847583,ECE 65,A50,083695,Staff,0,1,30,30
1650008853624,ECE 109,A01,091882,Touri; Behrouz,48,0,70,22
1650008859654,ECE 180,A00,083140,Abi Samra; Nicholas Camill,26,0,30,4
1650008859654,ECE 180,B00,083141,Abi Samra; Nicholas Camill,10,0,30,20
1650008865682,MATH 10A,A01,083735,Patchell; Gregory David,14,0,30,16
1650008865682,MATH 10A,A02,083736,Patchell; Gregory David,28,0,30,2
1650008865682,MATH 10A,A03,083737,Patchell; Gregory David,27,0,30,3
1650008871708,MATH 10B,A01,083207,Staff,0,4,30,30
1650008871708,MATH 10B,A02,083208,Staff,1,0,30,29
1650008871708,MATH 10B,B01,083739,Staff,20,0,30,10
1650008871708,MATH 10B,B02,083740,Staff,30,0,30,0
1650008877737,MATH 18,A01,083743,Staff,10,0,30,20
1650008877737,MATH 18,A02,083744,Staff,28,0,30,2
1650008877737,MATH 18,A03,083745,Staff,23,0,30,7
1650008877737,MATH 18,A04,083746,Staff,27,0,30,3
1650008877737,MATH 18,B01,083748,Staff,0,6,30,30
1650008877737,MATH 18,B02,083749,Staff,0,6,30,30
1650008877737,MATH 18,B03,083750,Staff,0,6,30,30
1650008877737,MATH 18,B04,083751,Staff,0,7,30,30
1650008883764,MATH 20A,A01,083754,Staff,27,0,40,13
1650008889788,MATH 20B,A01,083756,Staff,0,4,30,30
1650008889788,MATH 20B,A02,083757,Staff,5,0,30,25
1650008895812,MATH 20C,A01,083760,Staff,0,9,30,30
1650008895812,MATH 20C,A02,083761,Staff,0,10,30,30
1650008895812,MATH 20C,B01,083762,Staff,17,0,30,13
1650008895812,MATH 20C,B02,083763,Staff,29,0,30,1
1650008901837,MATH 20D,A01,083765,Staff,0,2,30,30
1650008901837,MATH 20D,A02,083766,Staff,16,0,30,14
1650008901837,MATH 20D,A03,083767,Staff,28,0,30,2
1650008907862,MATH 20E,A01,083771,Staff,11,0,30,19
1650008907862,MATH 20E,A02,083772,Staff,20,0,30,10
1650008907862,MATH 20E,B01,083773,Staff,0,1,30,30
1650008907862,MATH 20E,B02,083774,Staff,21,0,30,9
1650008913887,MATH 103A,A01,083777,Staff,0,6,30,30
1650008913887,MATH 103A,A02,083778,Staff,0,7,30,30
1650008913887,MATH 103A,B01,083779,Staff,0,6,30,30
1650008913887,MATH 103A,B02,083780,Staff,0,6,30,30
1650008919912,MATH 105,A01,085443,Staff,0,11,30,30
1650008925938,MATH 109,A01,083213,Anzaldo; Leesa B,0,3,30,30
1650008925938,MATH 109,A02,083214,Anzaldo; Leesa B,0,3,30,30
1650008925938,MATH 109,B01,083215,Anzaldo; Leesa B,0,2,30,30
1650008925938,MATH 109,B02,083216,Anzaldo; Leesa B,0,2,30,30
1650008931963,MATH 142A,A01,083219,Chow; Bennett,0,7,30,30
1650008931963,MATH 142A,A02,083220,Chow; Bennett,0,7,30,30
1650008931963,MATH 142A,B01,083221,Chow; Bennett,0,8,30,30
1650008931963,MATH 142A,B02,083222,Chow; Bennett,0,7,30,30
1650008937993,MATH 193A,A01,083224,Staff,0,5,30,30
1650008937993,MATH 193A,A02,083225,Staff,0,4,30,30
1650008937993,MATH 193A,A03,083781,Staff,0,0,30,30
1650008937993,MATH 193A,A04,083782,Staff,9,0,30,21
1650008944015,MATH 197,001,091859,McAuley; Julian John,9999,0,9999,0
1650008950098,COGS 9,A01,083615,Staff,1,15,60,59
1650008956122,COGS 11,A01,083617,Boyle; Mary E. T.,25,0,40,15
1650008962160,COGS 13,A01,083071,Staff,0,28,40,40
1650008968193,COGS 14A,A01,092681,Staff,0,6,100,100
1650008974219,COGS 14B,A01,083073,Cheng; Tzu-Han,0,2,50,50
1650008980243,COGS 17,A01,092677,Staff,35,0,75,40
1650008986271,COGS 100,A01,083619,Staff,0,18,60,60
1650008992297,COGS 101A,A01,083621,Davis; Joshua Daniel,0,16,60,60
1650008998322,COGS 101B,A01,091572,Staff,16,0,60,44
1650009004356,COGS 101C,A01,083625,Delgado; Tania,21,0,30,9
1650009010390,COGS 107A,A01,083627,Boyle; Mary E. T.,0,1,60,60
1650009016487,COGS 118A,A01,083075,Staff,19,0,60,41
1650009022512,CSE 3,A50,083646,Miranda; Gregory Joseph,22,0,38,16
1650009022512,CSE 3,A51,083647,Miranda; Gregory Joseph,37,0,37,0
1650009028542,CSE 8A,A50,083650,Miranda; Gregory Joseph,0,14,40,40
1650009034568,CSE 11,A01,083080,Cao; Yingjun,0,57,40,40
1650009040604,CSE 12,A01,083652,Staff,2,0,100,98
1650009046626,CSE 15L,A01,083654,Staff,0,0,50,50
1650009046626,CSE 15L,A02,083655,Staff,15,0,50,35
1650009052653,CSE 20,A01,083657,Staff,57,0,80,23
1650009058682,CSE 30,A01,083084,Eldon; John,0,62,40,40
1650009064706,CSE 100,A01,083659,Cao; Yingjun,0,57,50,50
1650009070737,CSE 134B,A01,083661,Powell; Thomas Allan,0,24,65,65
1650009076768,CSE 140,A01,083663,Staff,8,0,75,67
1650009082791,CSE 140L,A01,083088,Eldon; John,4,0,75,71
1650009088815,CSE 175,A01,083665,Kumar; Rakesh,10,0,25,15
1650009094847,CSE 190,A00,092507,Dubnov; Shlomo,17,0,20,3
1650009100872,ECE 45,A01,083139,Staff,0,10,40,40
1650009106898,ECE 65,A50,083695,Staff,0,1,30,30
1650009112922,ECE 109,A01,091882,Touri; Behrouz,48,0,70,22
1650009118960,ECE 180,A00,083140,Abi Samra; Nicholas Camill,26,0,30,4
1650009118960,ECE 180,B00,083141,Abi Samra; Nicholas Camill,10,0,30,20
1650009125000,MATH 10A,A01,083735,Patchell; Gregory David,14,0,30,16
1650009125000,MATH 10A,A02,083736,Patchell; Gregory David,28,0,30,2
1650009125000,MATH 10A,A03,083737,Patchell; Gregory David,27,0,30,3
1650009131027,MATH 10B,A01,083207,Staff,0,4,30,30
1650009131027,MATH 10B,A02,083208,Staff,1,0,30,29
1650009131027,MATH 10B,B01,083739,Staff,20,0,30,10
1650009131027,MATH 10B,B02,083740,Staff,30,0,30,0
1650009137070,MATH 18,A01,083743,Staff,10,0,30,20
1650009137070,MATH 18,A02,083744,Staff,28,0,30,2
1650009137070,MATH 18,A03,083745,Staff,23,0,30,7
1650009137070,MATH 18,A04,083746,Staff,27,0,30,3
1650009137070,MATH 18,B01,083748,Staff,0,6,30,30
1650009137070,MATH 18,B02,083749,Staff,0,6,30,30
1650009137070,MATH 18,B03,083750,Staff,0,6,30,30
1650009137070,MATH 18,B04,083751,Staff,0,7,30,30
1650009143107,MATH 20A,A01,083754,Staff,27,0,40,13
1650009149161,MATH 20B,A01,083756,Staff,0,4,30,30
1650009149161,MATH 20B,A02,083757,Staff,5,0,30,25
1650009155189,MATH 20C,A01,083760,Staff,0,9,30,30
1650009155189,MATH 20C,A02,083761,Staff,0,10,30,30
1650009155189,MATH 20C,B01,083762,Staff,17,0,30,13
1650009155189,MATH 20C,B02,083763,Staff,29,0,30,1
1650009161220,MATH 20D,A01,083765,Staff,0,2,30,30
1650009161220,MATH 20D,A02,083766,Staff,16,0,30,14
1650009161220,MATH 20D,A03,083767,Staff,28,0,30,2
1650009167253,MATH 20E,A01,083771,Staff,11,0,30,19
1650009167253,MATH 20E,A02,083772,Staff,20,0,30,10
1650009167253,MATH 20E,B01,083773,Staff,0,1,30,30
1650009167253,MATH 20E,B02,083774,Staff,21,0,30,9
1650009173284,MATH 103A,A01,083777,Staff,0,6,30,30
1650009173284,MATH 103A,A02,083778,Staff,0,7,30,30
1650009173284,MATH 103A,B01,083779,Staff,0,6,30,30
1650009173284,MATH 103A,B02,083780,Staff,0,6,30,30
1650009179314,MATH 105,A01,085443,Staff,0,11,30,30
1650009185338,MATH 109,A01,083213,Anzaldo; Leesa B,0,3,30,30
1650009185338,MATH 109,A02,083214,Anzaldo; Leesa B,0,3,30,30
1650009185338,MATH 109,B01,083215,Anzaldo; Leesa B,0,2,30,30
1650009185338,MATH 109,B02,083216,Anzaldo; Leesa B,0,2,30,30
1650009191368,MATH 142A,A01,083219,Chow; Bennett,0,7,30,30
1650009191368,MATH 142A,A02,083220,Chow; Bennett,0,7,30,30
1650009191368,MATH 142A,B01,083221,Chow; Bennett,0,8,30,30
1650009191368,MATH 142A,B02,083222,Chow; Bennett,0,7,30,30
1650009197489,MATH 193A,A01,083224,Staff,0,5,30,30
1650009197489,MATH 193A,A02,083225,Staff,0,4,30,30
1650009197489,MATH 193A,A03,083781,Staff,0,0,30,30
1650009197489,MATH 193A,A04,083782,Staff,9,0,30,21
1650009203513,MATH 197,001,091859,McAuley; Julian John,9999,0,9999,0
1650009209574,COGS 9,A01,083615,Staff,1,15,60,59
1650009215601,COGS 11,A01,083617,Boyle; Mary E. T.,25,0,40,15
1650009221626,COGS 13,A01,083071,Staff,0,28,40,40
1650009227656,COGS 14A,A01,092681,Staff,0,6,100,100
1650009233686,COGS 14B,A01,083073,Cheng; Tzu-Han,0,2,50,50
1650009239729,COGS 17,A01,092677,Staff,35,0,75,40
1650009245755,COGS 100,A01,083619,Staff,0,18,60,60
1650009251783,COGS 101A,A01,083621,Davis; Joshua Daniel,0,16,60,60
1650009257809,COGS 101B,A01,091572,Staff,16,0,60,44
1650009263834,COGS 101C,A01,083625,Delgado; Tania,21,0,30,9
1650009269859,COGS 107A,A01,083627,Boyle; Mary E. T.,0,1,60,60
1650009275883,COGS 118A,A01,083075,Staff,19,0,60,41
1650009281915,CSE 3,A50,083646,Miranda; Gregory Joseph,22,0,38,16
1650009281915,CSE 3,A51,083647,Miranda; Gregory Joseph,37,0,37,0
1650009287940,CSE 8A,A50,083650,Miranda; Gregory Joseph,0,14,40,40
1650009293973,CSE 11,A01,083080,Cao; Yingjun,0,57,40,40
1650009300003,CSE 12,A01,083652,Staff,2,0,100,98
1650009306041,CSE 15L,A01,083654,Staff,0,0,50,50
1650009306041,CSE 15L,A02,083655,Staff,15,0,50,35
1650009312067,CSE 20,A01,083657,Staff,57,0,80,23
1650009318097,CSE 30,A01,083084,Eldon; John,0,62,40,40
1650009324122,CSE 100,A01,083659,Cao; Yingjun,0,57,50,50
1650009330148,CSE 134B,A01,083661,Powell; Thomas Allan,0,24,65,65
1650009336171,CSE 140,A01,083663,Staff,8,0,75,67
1650009342201,CSE 140L,A01,083088,Eldon; John,4,0,75,71
1650009348230,CSE 175,A01,083665,Kumar; Rakesh,10,0,25,15
1650009354253,CSE 190,A00,092507,Dubnov; Shlomo,17,0,20,3
1650009360280,ECE 45,A01,083139,Staff,0,10,40,40
1650009366306,ECE 65,A50,083695,Staff,0,1,30,30
1650009372331,ECE 109,A01,091882,Touri; Behrouz,48,0,70,22
1650009378364,ECE 180,A00,083140,Abi Samra; Nicholas Camill,26,0,30,4
1650009378364,ECE 180,B00,083141,Abi Samra; Nicholas Camill,10,0,30,20
1650009384391,MATH 10A,A01,083735,Patchell; Gregory David,14,0,30,16
1650009384391,MATH 10A,A02,083736,Patchell; Gregory David,28,0,30,2
1650009384391,MATH 10A,A03,083737,Patchell; Gregory David,27,0,30,3
1650009390420,MATH 10B,A01,083207,Staff,0,4,30,30
1650009390420,MATH 10B,A02,083208,Staff,1,0,30,29
1650009390420,MATH 10B,B01,083739,Staff,20,0,30,10
1650009390420,MATH 10B,B02,083740,Staff,30,0,30,0
1650009396446,MATH 18,A01,083743,Staff,10,0,30,20
1650009396446,MATH 18,A02,083744,Staff,28,0,30,2
1650009396446,MATH 18,A03,083745,Staff,23,0,30,7
1650009396446,MATH 18,A04,083746,Staff,27,0,30,3
1650009396446,MATH 18,B01,083748,Staff,0,7,30,30
1650009396446,MATH 18,B02,083749,Staff,0,6,30,30
1650009396446,MATH 18,B03,083750,Staff,0,6,30,30
1650009396446,MATH 18,B04,083751,Staff,0,7,30,30
1650009402474,MATH 20A,A01,083754,Staff,27,0,40,13
1650009408498,MATH 20B,A01,083756,Staff,0,4,30,30
1650009408498,MATH 20B,A02,083757,Staff,5,0,30,25
1650009414523,MATH 20C,A01,083760,Staff,0,9,30,30
1650009414523,MATH 20C,A02,083761,Staff,0,10,30,30
1650009414523,MATH 20C,B01,083762,Staff,17,0,30,13
1650009414523,MATH 20C,B02,083763,Staff,29,0,30,1
1650009420563,MATH 20D,A01,083765,Staff,0,2,30,30
1650009420563,MATH 20D,A02,083766,Staff,16,0,30,14
1650009420563,MATH 20D,A03,083767,Staff,28,0,30,2
1650009426594,MATH 20E,A01,083771,Staff,11,0,30,19
1650009426594,MATH 20E,A02,083772,Staff,20,0,30,10
1650009426594,MATH 20E,B01,083773,Staff,0,1,30,30
1650009426594,MATH 20E,B02,083774,Staff,21,0,30,9
1650009432627,MATH 103A,A01,083777,Staff,0,6,30,30
1650009432627,MATH 103A,A02,083778,Staff,0,7,30,30
1650009432627,MATH 103A,B01,083779,Staff,0,6,30,30
1650009432627,MATH 103A,B02,083780,Staff,0,6,30,30
1650009438657,MATH 105,A01,085443,Staff,0,11,30,30
1650009444688,MATH 109,A01,083213,Anzaldo; Leesa B,0,3,30,30
1650009444688,MATH 109,A02,083214,Anzaldo; Leesa B,0,3,30,30
1650009444688,MATH 109,B01,083215,Anzaldo; Leesa B,0,2,30,30
1650009444688,MATH 109,B02,083216,Anzaldo; Leesa B,0,2,30,30
1650009450718,MATH 142A,A01,083219,Chow; Bennett,0,7,30,30
1650009450718,MATH 142A,A02,083220,Chow; Bennett,0,7,30,30
1650009450718,MATH 142A,B01,083221,Chow; Bennett,0,8,30,30
1650009450718,MATH 142A,B02,083222,Chow; Bennett,0,7,30,30
1650009456749,MATH 193A,A01,083224,Staff,0,5,30,30
1650009456749,MATH 193A,A02,083225,Staff,0,4,30,30
1650009456749,MATH 193A,A03,083781,Staff,0,0,30,30
1650009456749,MATH 193A,A04,083782,Staff,9,0,30,21
1650009462773,MATH 197,001,091859,McAuley; Julian John,9999,0,9999,0
1650009468870,COGS 9,A01,083615,Staff,1,15,60,59
1650009474895,COGS 11,A01,083617,Boyle; Mary E. T.,25,0,40,15
1650009480919,COGS 13,A01,083071,Staff,0,28,40,40
1650009486948,COGS 14A,A01,092681,Staff,0,6,100,100
1650009492975,COGS 14B,A01,083073,Cheng; Tzu-Han,0,2,50,50
1650009498999,COGS 17,A01,092677,Staff,35,0,75,40
1650009505029,COGS 100,A01,083619,Staff,0,18,60,60
1650009511057,COGS 101A,A01,083621,Davis; Joshua Daniel,0,16,60,60
1650009517101,COGS 101B,A01,091572,Staff,16,0,60,44
1650009523136,COGS 101C,A01,083625,Delgado; Tania,21,0,30,9
1650009529161,COGS 107A,A01,083627,Boyle; Mary E. T.,0,1,60,60
1650009535186,COGS 118A,A01,083075,Staff,19,0,60,41
1650009541212,CSE 3,A50,083646,Miranda; Gregory Joseph,22,0,38,16
1650009541212,CSE 3,A51,083647,Miranda; Gregory Joseph,37,0,37,0
1650009547238,CSE 8A,A50,083650,Miranda; Gregory Joseph,0,14,40,40
1650009553261,CSE 11,A01,083080,Cao; Yingjun,0,57,40,40
1650009559290,CSE 12,A01,083652,Staff,2,0,100,98
1650009565318,CSE 15L,A01,083654,Staff,0,0,50,50
1650009565318,CSE 15L,A02,083655,Staff,15,0,50,35
1650009571346,CSE 20,A01,083657,Staff,57,0,80,23
1650009577375,CSE 30,A01,083084,Eldon; John,0,62,40,40
1650009583402,CSE 100,A01,083659,Cao; Yingjun,0,57,50,50
1650009589428,CSE 134B,A01,083661,Powell; Thomas Allan,0,24,65,65
1650009595453,CSE 140,A01,083663,Staff,8,0,75,67
1650009601483,CSE 140L,A01,083088,Eldon; John,4,0,75,71
1650009607515,CSE 175,A01,083665,Kumar; Rakesh,10,0,25,15
1650009613619,CSE 190,A00,092507,Dubnov; Shlomo,17,0,20,3
1650009619643,ECE 45,A01,083139,Staff,0,10,40,40
1650009625681,ECE 65,A50,083695,Staff,0,1,30,30
1650009631712,ECE 109,A01,091882,Touri; Behrouz,48,0,70,22
1650009637738,ECE 180,A00,083140,Abi Samra; Nicholas Camill,26,0,30,4
1650009637738,ECE 180,B00,083141,Abi Samra; Nicholas Camill,10,0,30,20
1650009643765,MATH 10A,A01,083735,Patchell; Gregory David,14,0,30,16
1650009643765,MATH 10A,A02,083736,Patchell; Gregory David,28,0,30,2
1650009643765,MATH 10A,A03,083737,Patchell; Gregory David,27,0,30,3
1650009649791,MATH 10B,A01,083207,Staff,0,4,30,30
1650009649791,MATH 10B,A02,083208,Staff,1,0,30,29
1650009649791,MATH 10B,B01,083739,Staff,20,0,30,10
1650009649791,MATH 10B,B02,083740,Staff,30,0,30,0
1650009655828,MATH 18,A01,083743,Staff,10,0,30,20
1650009655828,MATH 18,A02,083744,Staff,28,0,30,2
1650009655828,MATH 18,A03,083745,Staff,23,0,30,7
1650009655828,MATH 18,A04,083746,Staff,27,0,30,3
1650009655828,MATH 18,B01,083748,Staff,0,7,30,30
1650009655828,MATH 18,B02,083749,Staff,0,6,30,30
1650009655828,MATH 18,B03,083750,Staff,0,6,30,30
1650009655828,MATH 18,B04,083751,Staff,0,7,30,30
1650009661852,MATH 20A,A01,083754,Staff,27,0,40,13
1650009667894,MATH 20B,A01,083756,Staff,0,4,30,30
1650009667894,MATH 20B,A02,083757,Staff,5,0,30,25
1650009673926,MATH 20C,A01,083760,Staff,0,9,30,30
1650009673926,MATH 20C,A02,083761,Staff,0,10,30,30
1650009673926,MATH 20C,B01,083762,Staff,17,0,30,13
1650009673926,MATH 20C,B02,083763,Staff,29,0,30,1
1650009679957,MATH 20D,A01,083765,Staff,0,2,30,30
1650009679957,MATH 20D,A02,083766,Staff,16,0,30,14
1650009679957,MATH 20D,A03,083767,Staff,28,0,30,2
1650009685987,MATH 20E,A01,083771,Staff,11,0,30,19
1650009685987,MATH 20E,A02,083772,Staff,20,0,30,10
1650009685987,MATH 20E,B01,083773,Staff,0,1,30,30
1650009685987,MATH 20E,B02,083774,Staff,21,0,30,9
1650009692012,MATH 103A,A01,083777,Staff,0,6,30,30
1650009692012,MATH 103A,A02,083778,Staff,0,7,30,30
1650009692012,MATH 103A,B01,083779,Staff,0,6,30,30
1650009692012,MATH 103A,B02,083780,Staff,0,6,30,30
1650009698043,MATH 105,A01,085443,Staff,0,11,30,30
1650009704075,MATH 109,A01,083213,Anzaldo; Leesa B,0,3,30,30
1650009704075,MATH 109,A02,083214,Anzaldo; Leesa B,0,3,30,30
1650009704075,MATH 109,B01,083215,Anzaldo; Leesa B,0,2,30,30
1650009704075,MATH 109,B02,083216,Anzaldo; Leesa B,0,2,30,30
1650009710113,MATH 142A,A01,083219,Chow; Bennett,0,7,30,30
1650009710113,MATH 142A,A02,083220,Chow; Bennett,0,7,30,30
1650009710113,MATH 142A,B01,083221,Chow; Bennett,0,8,30,30
1650009710113,MATH 142A,B02,083222,Chow; Bennett,0,7,30,30
1650009716139,MATH 193A,A01,083224,Staff,0,5,30,30
1650009716139,MATH 193A,A02,083225,Staff,0,4,30,30
1650009716139,MATH 193A,A03,083781,Staff,0,0,30,30
1650009716139,MATH 193A,A04,083782,Staff,9,0,30,21
1650009722167,MATH 197,001,091859,McAuley; Julian John,9999,0,9999,0
1650009728255,COGS 9,A01,083615,Staff,1,15,60,59
1650009734282,COGS 11,A01,083617,Boyle; Mary E. T.,25,0,40,15
1650009740322,COGS 13,A01,083071,Staff,0,28,40,40
1650009746346,COGS 14A,A01,092681,Staff,0,6,100,100
1650009752382,COGS 14B,A01,083073,Cheng; Tzu-Han,0,2,50,50
1650009758407,COGS 17,A01,092677,Staff,35,0,75,40
1650009764436,COGS 100,A01,083619,Staff,0,18,60,60
1650009770466,COGS 101A,A01,083621,Davis; Joshua Daniel,0,16,60,60
1650009776497,COGS 101B,A01,091572,Staff,16,0,60,44
1650009782522,COGS 101C,A01,083625,Delgado; Tania,21,0,30,9
1650009788547,COGS 107A,A01,083627,Boyle; Mary E. T.,0,1,60,60
1650009794577,COGS 118A,A01,083075,Staff,19,0,60,41
1650009800610,CSE 3,A50,083646,Miranda; Gregory Joseph,22,0,38,16
1650009800610,CSE 3,A51,083647,Miranda; Gregory Joseph,37,0,37,0
1650009806640,CSE 8A,A50,083650,Miranda; Gregory Joseph,0,14,40,40
1650009812664,CSE 11,A01,083080,Cao; Yingjun,0,57,40,40
1650009818694,CSE 12,A01,083652,Staff,2,0,100,98
1650009824721,CSE 15L,A01,083654,Staff,0,0,50,50
1650009824721,CSE 15L,A02,083655,Staff,15,0,50,35
1650009830745,CSE 20,A01,083657,Staff,57,0,80,23
1650009836770,CSE 30,A01,083084,Eldon; John,0,62,40,40
1650009842800,CSE 100,A01,083659,Cao; Yingjun,0,57,50,50
1650009848825,CSE 134B,A01,083661,Powell; Thomas Allan,0,24,65,65
1650009854854,CSE 140,A01,083663,Staff,8,0,75,67
1650009860878,CSE 140L,A01,083088,Eldon; John,4,0,75,71
1650009866901,CSE 175,A01,083665,Kumar; Rakesh,10,0,25,15
1650009872930,CSE 190,A00,092507,Dubnov; Shlomo,17,0,20,3
1650009878957,ECE 45,A01,083139,Staff,0,10,40,40
1650009884984,ECE 65,A50,083695,Staff,0,1,30,30
1650009891009,ECE 109,A01,091882,Touri; Behrouz,48,0,70,22
1650009897047,ECE 180,A00,083140,Abi Samra; Nicholas Camill,26,0,30,4
1650009897047,ECE 180,B00,083141,Abi Samra; Nicholas Camill,10,0,30,20
1650009903092,MATH 10A,A01,083735,Patchell; Gregory David,14,0,30,16
1650009903092,MATH 10A,A02,083736,Patchell; Gregory David,28,0,30,2
1650009903092,MATH 10A,A03,083737,Patchell; Gregory David,27,0,30,3
1650009909117,MATH 10B,A01,083207,Staff,0,4,30,30
1650009909117,MATH 10B,A02,083208,Staff,1,0,30,29
1650009909117,MATH 10B,B01,083739,Staff,20,0,30,10
1650009909117,MATH 10B,B02,083740,Staff,30,0,30,0
1650009915149,MATH 18,A01,083743,Staff,10,0,30,20
1650009915149,MATH 18,A02,083744,Staff,28,0,30,2
1650009915149,MATH 18,A03,083745,Staff,23,0,30,7
1650009915149,MATH 18,A04,083746,Staff,27,0,30,3
1650009915149,MATH 18,B01,083748,Staff,0,7,30,30
1650009915149,MATH 18,B02,083749,Staff,0,6,30,30
1650009915149,MATH 18,B03,083750,Staff,0,6,30,30
1650009915149,MATH 18,B04,083751,Staff,0,7,30,30
1650009921179,MATH 20A,A01,083754,Staff,27,0,40,13
1650009927210,MATH 20B,A01,083756,Staff,0,4,30,30
1650009927210,MATH 20B,A02,083757,Staff,5,0,30,25
1650009933235,MATH 20C,A01,083760,Staff,0,9,30,30
1650009933235,MATH 20C,A02,083761,Staff,0,10,30,30
1650009933235,MATH 20C,B01,083762,Staff,17,0,30,13
1650009933235,MATH 20C,B02,083763,Staff,29,0,30,1
1650009939260,MATH 20D,A01,083765,Staff,0,2,30,30
1650009939260,MATH 20D,A02,083766,Staff,16,0,30,14
1650009939260,MATH 20D,A03,083767,Staff,28,0,30,2
1650009945289,MATH 20E,A01,083771,Staff,11,0,30,19
1650009945289,MATH 20E,A02,083772,Staff,20,0,30,10
1650009945289,MATH 20E,B01,083773,Staff,0,1,30,30
1650009945289,MATH 20E,B02,083774,Staff,21,0,30,9
1650009951314,MATH 103A,A01,083777,Staff,0,6,30,30
1650009951314,MATH 103A,A02,083778,Staff,0,7,30,30
1650009951314,MATH 103A,B01,083779,Staff,0,6,30,30
1650009951314,MATH 103A,B02,083780,Staff,0,6,30,30
1650009957345,MATH 105,A01,085443,Staff,0,11,30,30
1650009963370,MATH 109,A01,083213,Anzaldo; Leesa B,0,3,30,30
1650009963370,MATH 109,A02,083214,Anzaldo; Leesa B,0,3,30,30
1650009963370,MATH 109,B01,083215,Anzaldo; Leesa B,0,2,30,30
1650009963370,MATH 109,B02,083216,Anzaldo; Leesa B,0,2,30,30
1650009969402,MATH 142A,A01,083219,Chow; Bennett,0,7,30,30
1650009969402,MATH 142A,A02,083220,Chow; Bennett,0,7,30,30
1650009969402,MATH 142A,B01,083221,Chow; Bennett,0,8,30,30
1650009969402,MATH 142A,B02,083222,Chow; Bennett,0,7,30,30
1650009975427,MATH 193A,A01,083224,Staff,0,5,30,30
1650009975427,MATH 193A,A02,083225,Staff,0,4,30,30
1650009975427,MATH 193A,A03,083781,Staff,0,0,30,30
1650009975427,MATH 193A,A04,083782,Staff,9,0,30,21
1650009981452,MATH 197,001,091859,McAuley; Julian John,9999,0,9999,0
1650009987522,COGS 9,A01,083615,Staff,1,15,60,59
1650009993551,COGS 11,A01,083617,Boyle; Mary E. T.,25,0,40,15
1650009999574,COGS 13,A01,083071,Staff,0,28,40,40
1650010005603,COGS 14A,A01,092681,Staff,0,6,100,100
1650010011627,COGS 14B,A01,083073,Cheng; Tzu-Han,0,2,50,50
1650010017651,COGS 17,A01,092677,Staff,35,0,75,40
1650010023677,COGS 100,A01,083619,Staff,0,18,60,60
1650010029702,COGS 101A,A01,083621,Davis; Joshua Daniel,0,16,60,60
1650010035727,COGS 101B,A01,091572,Staff,16,0,60,44
1650010041756,COGS 101C,A01,083625,Delgado; Tania,21,0,30,9
1650010047807,COGS 107A,A01,083627,Boyle; Mary E. T.,0,1,60,60
1650010053833,COGS 118A,A01,083075,Staff,19,0,60,41
1650010059859,CSE 3,A50,083646,Miranda; Gregory Joseph,22,0,38,16
1650010059859,CSE 3,A51,083647,Miranda; Gregory Joseph,37,0,37,0
1650010065891,CSE 8A,A50,083650,Miranda; Gregory Joseph,0,14,40,40
1650010071923,CSE 11,A01,083080,Cao; Yingjun,0,57,40,40
1650010077948,CSE 12,A01,083652,Staff,2,0,100,98
1650010083973,CSE 15L,A01,083654,Staff,0,0,50,50
1650010083973,CSE 15L,A02,083655,Staff,15,0,50,35
1650010089996,CSE 20,A01,083657,Staff,57,0,80,23
1650010096024,CSE 30,A01,083084,Eldon; John,0,62,40,40
1650010102057,CSE 100,A01,083659,Cao; Yingjun,0,57,50,50
1650010108087,CSE 134B,A01,083661,Powell; Thomas Allan,0,24,65,65
1650010114111,CSE 140,A01,083663,Staff,8,0,75,67
1650010120136,CSE 140L,A01,083088,Eldon; John,4,0,75,71
1650010126160,CSE 175,A01,083665,Kumar; Rakesh,10,0,25,15
1650010132188,CSE 190,A00,092507,Dubnov; Shlomo,17,0,20,3
1650010138212,ECE 45,A01,083139,Staff,0,10,40,40
1650010144241,ECE 65,A50,083695,Staff,0,1,30,30
1650010150266,ECE 109,A01,091882,Touri; Behrouz,48,0,70,22
1650010156293,ECE 180,A00,083140,Abi Samra; Nicholas Camill,26,0,30,4
1650010156293,ECE 180,B00,083141,Abi Samra; Nicholas Camill,10,0,30,20
1650010162318,MATH 10A,A01,083735,Patchell; Gregory David,14,0,30,16
1650010162318,MATH 10A,A02,083736,Patchell; Gregory David,28,0,30,2
1650010162318,MATH 10A,A03,083737,Patchell; Gregory David,27,0,30,3
1650010168343,MATH 10B,A01,083207,Staff,0,4,30,30
1650010168343,MATH 10B,A02,083208,Staff,1,0,30,29
1650010168343,MATH 10B,B01,083739,Staff,20,0,30,10
1650010168343,MATH 10B,B02,083740,Staff,30,0,30,0
1650010174377,MATH 18,A01,083743,Staff,10,0,30,20
1650010174377,MATH 18,A02,083744,Staff,28,0,30,2
1650010174377,MATH 18,A03,083745,Staff,23,0,30,7
1650010174377,MATH 18,A04,083746,Staff,27,0,30,3
1650010174377,MATH 18,B01,083748,Staff,0,7,30,30
1650010174377,MATH 18,B02,083749,Staff,0,6,30,30
1650010174377,MATH 18,B03,083750,Staff,0,6,30,30
1650010174377,MATH 18,B04,083751,Staff,0,7,30,30
1650010180405,MATH 20A,A01,083754,Staff,27,0,40,13
1650010186434,MATH 20B,A01,083756,Staff,0,4,30,30
1650010186434,MATH 20B,A02,083757,Staff,5,0,30,25
1650010192462,MATH 20C,A01,083760,Staff,0,9,30,30
1650010192462,MATH 20C,A02,083761,Staff,0,10,30,30
1650010192462,MATH 20C,B01,083762,Staff,17,0,30,13
1650010192462,MATH 20C,B02,083763,Staff,29,0,30,1
1650010198486,MATH 20D,A01,083765,Staff,0,2,30,30
1650010198486,MATH 20D,A02,083766,Staff,16,0,30,14
1650010198486,MATH 20D,A03,083767,Staff,28,0,30,2
1650010204515,MATH 20E,A01,083771,Staff,11,0,30,19
1650010204515,MATH 20E,A02,083772,Staff,20,0,30,10
1650010204515,MATH 20E,B01,083773,Staff,0,1,30,30
1650010204515,MATH 20E,B02,083774,Staff,21,0,30,9
1650010210615,MATH 103A,A01,083777,Staff,0,6,30,30
1650010210615,MATH 103A,A02,083778,Staff,0,7,30,30
1650010210615,MATH 103A,B01,083779,Staff,0,6,30,30
1650010210615,MATH 103A,B02,083780,Staff,0,6,30,30
1650010216640,MATH 105,A01,085443,Staff,0,11,30,30
1650010222669,MATH 109,A01,083213,Anzaldo; Leesa B,0,3,30,30
1650010222669,MATH 109,A02,083214,Anzaldo; Leesa B,0,3,30,30
1650010222669,MATH 109,B01,083215,Anzaldo; Leesa B,0,2,30,30
1650010222669,MATH 109,B02,083216,Anzaldo; Leesa B,0,2,30,30
1650010228693,MATH 142A,A01,083219,Chow; Bennett,0,7,30,30
1650010228693,MATH 142A,A02,083220,Chow; Bennett,0,7,30,30
1650010228693,MATH 142A,B01,083221,Chow; Bennett,0,8,30,30
1650010228693,MATH 142A,B02,083222,Chow; Bennett,0,7,30,30
1650010234723,MATH 193A,A01,083224,Staff,0,5,30,30
1650010234723,MATH 193A,A02,083225,Staff,0,4,30,30
1650010234723,MATH 193A,A03,083781,Staff,0,0,30,30
1650010234723,MATH 193A,A04,083782,Staff,9,0,30,21
1650010240748,MATH 197,001,091859,McAuley; Julian John,9999,0,9999,0
1650010246814,COGS 9,A01,083615,Staff,1,15,60,59
1650010252842,COGS 11,A01,083617,Boyle; Mary E. T.,25,0,40,15
1650010258869,COGS 13,A01,083071,Staff,0,28,40,40
1650010264897,COGS 14A,A01,092681,Staff,0,6,100,100
1650010270922,COGS 14B,A01,083073,Cheng; Tzu-Han,0,2,50,50
1650010276948,COGS 17,A01,092677,Staff,35,0,75,40
1650010282991,COGS 100,A01,083619,Staff,0,18,60,60
1650010289016,COGS 101A,A01,083621,Davis; Joshua Daniel,0,16,60,60
1650010295039,COGS 101B,A01,091572,Staff,16,0,60,44
1650010301065,COGS 101C,A01,083625,Delgado; Tania,21,0,30,9
1650010307097,COGS 107A,A01,083627,Boyle; Mary E. T.,0,1,60,60
1650010313120,COGS 118A,A01,083075,Staff,19,0,60,41
1650010319152,CSE 3,A50,083646,Miranda; Gregory Joseph,22,0,38,16
1650010319152,CSE 3,A51,083647,Miranda; Gregory Joseph,37,0,37,0
1650010325175,CSE 8A,A50,083650,Miranda; Gregory Joseph,0,14,40,40
1650010331201,CSE 11,A01,083080,Cao; Yingjun,0,57,40,40
1650010337225,CSE 12,A01,083652,Staff,2,0,100,98
1650010343252,CSE 15L,A01,083654,Staff,0,0,50,50
1650010343252,CSE 15L,A02,083655,Staff,15,0,50,35
1650010349284,CSE 20,A01,083657,Staff,57,0,80,23
1650010355314,CSE 30,A01,083084,Eldon; John,0,62,40,40
1650010361352,CSE 100,A01,083659,Cao; Yingjun,0,57,50,50
1650010367383,CSE 134B,A01,083661,Powell; Thomas Allan,0,24,65,65
1650010373413,CSE 140,A01,083663,Staff,8,0,75,67
1650010379438,CSE 140L,A01,083088,Eldon; John,4,0,75,71
1650010385462,CSE 175,A01,083665,Kumar; Rakesh,10,0,25,15
1650010391493,CSE 190,A00,092507,Dubnov; Shlomo,17,0,20,3
1650010397517,ECE 45,A01,083139,Staff,0,10,40,40
1650010403542,ECE 65,A50,083695,Staff,0,1,30,30
1650010409566,ECE 109,A01,091882,Touri; Behrouz,48,0,70,22
1650010415594,ECE 180,A00,083140,Abi Samra; Nicholas Camill,26,0,30,4
1650010415594,ECE 180,B00,083141,Abi Samra; Nicholas Camill,10,0,30,20
1650010421617,MATH 10A,A01,083735,Patchell; Gregory David,14,0,30,16
1650010421617,MATH 10A,A02,083736,Patchell; Gregory David,28,0,30,2
1650010421617,MATH 10A,A03,083737,Patchell; Gregory David,27,0,30,3
1650010427642,MATH 10B,A01,083207,Staff,0,4,30,30
1650010427642,MATH 10B,A02,083208,Staff,1,0,30,29
1650010427642,MATH 10B,B01,083739,Staff,20,0,30,10
1650010427642,MATH 10B,B02,083740,Staff,30,0,30,0
1650010433668,MATH 18,A01,083743,Staff,10,0,30,20
1650010433668,MATH 18,A02,083744,Staff,28,0,30,2
1650010433668,MATH 18,A03,083745,Staff,23,0,30,7
1650010433668,MATH 18,A04,083746,Staff,27,0,30,3
1650010433668,MATH 18,B01,083748,Staff,0,7,30,30
1650010433668,MATH 18,B02,083749,Staff,0,6,30,30
1650010433668,MATH 18,B03,083750,Staff,0,6,30,30
1650010433668,MATH 18,B04,083751,Staff,0,7,30,30
1650010439692,MATH 20A,A01,083754,Staff,27,0,40,13
1650010445717,MATH 20B,A01,083756,Staff,0,4,30,30
1650010445717,MATH 20B,A02,083757,Staff,5,0,30,25
1650010451742,MATH 20C,A01,083760,Staff,0,9,30,30
1650010451742,MATH 20C,A02,083761,Staff,0,10,30,30
1650010451742,MATH 20C,B01,083762,Staff,17,0,30,13
1650010451742,MATH 20C,B02,083763,Staff,29,0,30,1
1650010457773,MATH 20D,A01,083765,Staff,0,2,30,30
1650010457773,MATH 20D,A02,083766,Staff,16,0,30,14
1650010457773,MATH 20D,A03,083767,Staff,28,0,30,2
1650010463804,MATH 20E,A01,083771,Staff,11,0,30,19
1650010463804,MATH 20E,A02,083772,Staff,20,0,30,10
1650010463804,MATH 20E,B01,083773,Staff,0,1,30,30
1650010463804,MATH 20E,B02,083774,Staff,21,0,30,9
1650010469835,MATH 103A,A01,083777,Staff,0,6,30,30
1650010469835,MATH 103A,A02,083778,Staff,0,7,30,30
1650010469835,MATH 103A,B01,083779,Staff,0,6,30,30
1650010469835,MATH 103A,B02,083780,Staff,0,6,30,30
1650010475858,MATH 105,A01,085443,Staff,0,11,30,30
1650010481890,MATH 109,A01,083213,Anzaldo; Leesa B,0,3,30,30
1650010481890,MATH 109,A02,083214,Anzaldo; Leesa B,0,3,30,30
1650010481890,MATH 109,B01,083215,Anzaldo; Leesa B,0,2,30,30
1650010481890,MATH 109,B02,083216,Anzaldo; Leesa B,0,2,30,30
1650010487916,MATH 142A,A01,083219,Chow; Bennett,0,7,30,30
1650010487916,MATH 142A,A02,083220,Chow; Bennett,0,7,30,30
1650010487916,MATH 142A,B01,083221,Chow; Bennett,0,8,30,30
1650010487916,MATH 142A,B02,083222,Chow; Bennett,0,7,30,30
1650010493949,MATH 193A,A01,083224,Staff,0,5,30,30
1650010493949,MATH 193A,A02,083225,Staff,0,4,30,30
1650010493949,MATH 193A,A03,083781,Staff,0,0,30,30
1650010493949,MATH 193A,A04,083782,Staff,9,0,30,21
1650010499975,MATH 197,001,091859,McAuley; Julian John,9999,0,9999,0
1650010506034,COGS 9,A01,083615,Staff,1,15,60,59
1650010512062,COGS 11,A01,083617,Boyle; Mary E. T.,25,0,40,15
1650010518085,COGS 13,A01,083071,Staff,0,28,40,40
1650010524114,COGS 14A,A01,092681,Staff,0,6,100,100
1650010530138,COGS 14B,A01,083073,Cheng; Tzu-Han,0,2,50,50
1650010536166,COGS 17,A01,092677,Staff,35,0,75,40
1650010542200,COGS 100,A01,083619,Staff,0,18,60,60
1650010548226,COGS 101A,A01,083621,Davis; Joshua Daniel,0,16,60,60
1650010554251,COGS 101B,A01,091572,Staff,16,0,60,44
1650010560287,COGS 101C,A01,083625,Delgado; Tania,21,0,30,9
1650010566316,COGS 107A,A01,083627,Boyle; Mary E. T.,0,1,60,60
1650010572340,COGS 118A,A01,083075,Staff,19,0,60,41
1650010578379,CSE 3,A50,083646,Miranda; Gregory Joseph,22,0,38,16
1650010578379,CSE 3,A51,083647,Miranda; Gregory Joseph,37,0,37,0
1650010584406,CSE 8A,A50,083650,Miranda; Gregory Joseph,0,14,40,40
1650010590435,CSE 11,A01,083080,Cao; Yingjun,0,57,40,40
1650010596463,CSE 12,A01,083652,Staff,2,0,100,98
1650010602492,CSE 15L,A01,083654,Staff,0,0,50,50
1650010602492,CSE 15L,A02,083655,Staff,15,0,50,35
1650010608517,CSE 20,A01,083657,Staff,57,0,80,23
1650010614539,CSE 30,A01,083084,Eldon; John,0,62,40,40
1650010620567,CSE 100,A01,083659,Cao; Yingjun,0,57,50,50
1650010626594,CSE 134B,A01,083661,Powell; Thomas Allan,0,24,65,65
1650010632620,CSE 140,A01,083663,Staff,8,0,75,67
1650010638651,CSE 140L,A01,083088,Eldon; John,4,0,75,71
1650010644678,CSE 175,A01,083665,Kumar; Rakesh,10,0,25,15
1650010650702,CSE 190,A00,092507,Dubnov; Shlomo,17,0,20,3
1650010656730,ECE 45,A01,083139,Staff,0,10,40,40
1650010662756,ECE 65,A50,083695,Staff,0,1,30,30
1650010668780,ECE 109,A01,091882,Touri; Behrouz,48,0,70,22
1650010674804,ECE 180,A00,083140,Abi Samra; Nicholas Camill,26,0,30,4
1650010674804,ECE 180,B00,083141,Abi Samra; Nicholas Camill,10,0,30,20
1650010680848,MATH 10A,A01,083735,Patchell; Gregory David,14,0,30,16
1650010680848,MATH 10A,A02,083736,Patchell; Gregory David,28,0,30,2
1650010680848,MATH 10A,A03,083737,Patchell; Gregory David,27,0,30,3
1650010686873,MATH 10B,A01,083207,Staff,0,4,30,30
1650010686873,MATH 10B,A02,083208,Staff,1,0,30,29
1650010686873,MATH 10B,B01,083739,Staff,20,0,30,10
1650010686873,MATH 10B,B02,083740,Staff,30,0,30,0
1650010692905,MATH 18,A01,083743,Staff,10,0,30,20
1650010692905,MATH 18,A02,083744,Staff,28,0,30,2
1650010692905,MATH 18,A03,083745,Staff,23,0,30,7
1650010692905,MATH 18,A04,083746,Staff,27,0,30,3
1650010692905,MATH 18,B01,083748,Staff,0,7,30,30
1650010692905,MATH 18,B02,083749,Staff,0,6,30,30
1650010692905,MATH 18,B03,083750,Staff,0,6,30,30
1650010692905,MATH 18,B04,083751,Staff,0,7,30,30
1650010698942,MATH 20A,A01,083754,Staff,27,0,40,13
1650010704969,MATH 20B,A01,083756,Staff,0,4,30,30
1650010704969,MATH 20B,A02,083757,Staff,5,0,30,25
1650010710994,MATH 20C,A01,083760,Staff,0,9,30,30
1650010710994,MATH 20C,A02,083761,Staff,0,10,30,30
1650010710994,MATH 20C,B01,083762,Staff,17,0,30,13
1650010710994,MATH 20C,B02,083763,Staff,29,0,30,1
1650010717024,MATH 20D,A01,083765,Staff,0,2,30,30
1650010717024,MATH 20D,A02,083766,Staff,16,0,30,14
1650010717024,MATH 20D,A03,083767,Staff,28,0,30,2
1650010723058,MATH 20E,A01,083771,Staff,11,0,30,19
1650010723058,MATH 20E,A02,083772,Staff,20,0,30,10
1650010723058,MATH 20E,B01,083773,Staff,0,1,30,30
1650010723058,MATH 20E,B02,083774,Staff,21,0,30,9
1650010729083,MATH 103A,A01,083777,Staff,0,6,30,30
1650010729083,MATH 103A,A02,083778,Staff,0,7,30,30
1650010729083,MATH 103A,B01,083779,Staff,0,6,30,30
1650010729083,MATH 103A,B02,083780,Staff,0,6,30,30
1650010735114,MATH 105,A01,085443,Staff,0,11,30,30
1650010741144,MATH 109,A01,083213,Anzaldo; Leesa B,0,3,30,30
1650010741144,MATH 109,A02,083214,Anzaldo; Leesa B,0,3,30,30
1650010741144,MATH 109,B01,083215,Anzaldo; Leesa B,0,2,30,30
1650010741144,MATH 109,B02,083216,Anzaldo; Leesa B,0,2,30,30
1650010747167,MATH 142A,A01,083219,Chow; Bennett,0,7,30,30
1650010747167,MATH 142A,A02,083220,Chow; Bennett,0,7,30,30
1650010747167,MATH 142A,B01,083221,Chow; Bennett,0,8,30,30
1650010747167,MATH 142A,B02,083222,Chow; Bennett,0,7,30,30
1650010753196,MATH 193A,A01,083224,Staff,0,5,30,30
1650010753196,MATH 193A,A02,083225,Staff,0,4,30,30
1650010753196,MATH 193A,A03,083781,Staff,0,0,30,30
1650010753196,MATH 193A,A04,083782,Staff,9,0,30,21
1650010759234,MATH 197,001,091859,McAuley; Julian John,9999,0,9999,0
1650010765293,COGS 9,A01,083615,Staff,1,15,60,59
1650010771322,COGS 11,A01,083617,Boyle; Mary E. T.,25,0,40,15
1650010777347,COGS 13,A01,083071,Staff,0,28,40,40
1650010783370,COGS 14A,A01,092681,Staff,0,6,100,100
1650010789399,COGS 14B,A01,083073,Cheng; Tzu-Han,0,2,50,50
1650010795424,COGS 17,A01,092677,Staff,35,0,75,40
1650010801552,COGS 100,A01,083619,Staff,0,18,60,60
1650010807583,COGS 101A,A01,083621,Davis; Joshua Daniel,0,16,60,60
1650010813609,COGS 101B,A01,091572,Staff,16,0,60,44
1650010819641,COGS 101C,A01,083625,Delgado; Tania,21,0,30,9
1650010825673,COGS 107A,A01,083627,Boyle; Mary E. T.,0,1,60,60
1650010831697,COGS 118A,A01,083075,Staff,19,0,60,41
1650010837727,CSE 3,A50,083646,Miranda; Gregory Joseph,22,0,38,16
1650010837727,CSE 3,A51,083647,Miranda; Gregory Joseph,37,0,37,0
1650010843756,CSE 8A,A50,083650,Miranda; Gregory Joseph,0,14,40,40
1650010849781,CSE 11,A01,083080,Cao; Yingjun,0,57,40,40
1650010855806,CSE 12,A01,083652,Staff,2,0,100,98
1650010861837,CSE 15L,A01,083654,Staff,0,0,50,50
1650010861837,CSE 15L,A02,083655,Staff,15,0,50,35
1650010867860,CSE 20,A01,083657,Staff,57,0,80,23
1650010873889,CSE 30,A01,083084,Eldon; John,0,62,40,40
1650010879917,CSE 100,A01,083659,Cao; Yingjun,0,57,50,50
1650010885941,CSE 134B,A01,083661,Powell; Thomas Allan,0,24,65,65
1650010891963,CSE 140,A01,083663,Staff,8,0,75,67
1650010897986,CSE 140L,A01,083088,Eldon; John,4,0,75,71
1650010904022,CSE 175,A01,083665,Kumar; Rakesh,10,0,25,15
1650010910046,CSE 190,A00,092507,Dubnov; Shlomo,17,0,20,3
1650010916077,ECE 45,A01,083139,Staff,0,10,40,40
1650010922104,ECE 65,A50,083695,Staff,0,1,30,30
1650010928128,ECE 109,A01,091882,Touri; Behrouz,48,0,70,22
1650010934152,ECE 180,A00,083140,Abi Samra; Nicholas Camill,26,0,30,4
1650010934152,ECE 180,B00,083141,Abi Samra; Nicholas Camill,10,0,30,20
1650010940181,MATH 10A,A01,083735,Patchell; Gregory David,14,0,30,16
1650010940181,MATH 10A,A02,083736,Patchell; Gregory David,28,0,30,2
1650010940181,MATH 10A,A03,083737,Patchell; Gregory David,27,0,30,3
1650010946211,MATH 10B,A01,083207,Staff,0,4,30,30
1650010946211,MATH 10B,A02,083208,Staff,1,0,30,29
1650010946211,MATH 10B,B01,083739,Staff,20,0,30,10
1650010946211,MATH 10B,B02,083740,Staff,30,0,30,0
1650010952244,MATH 18,A01,083743,Staff,10,0,30,20
1650010952244,MATH 18,A02,083744,Staff,28,0,30,2
1650010952244,MATH 18,A03,083745,Staff,23,0,30,7
1650010952244,MATH 18,A04,083746,Staff,27,0,30,3
1650010952244,MATH 18,B01,083748,Staff,0,7,30,30
1650010952244,MATH 18,B02,083749,Staff,0,6,30,30
1650010952244,MATH 18,B03,083750,Staff,0,6,30,30
1650010952244,MATH 18,B04,083751,Staff,0,7,30,30
1650010958269,MATH 20A,A01,083754,Staff,27,0,40,13
1650010964295,MATH 20B,A01,083756,Staff,0,4,30,30
1650010964295,MATH 20B,A02,083757,Staff,5,0,30,25
1650010970318,MATH 20C,A01,083760,Staff,0,9,30,30
1650010970318,MATH 20C,A02,083761,Staff,0,10,30,30
1650010970318,MATH 20C,B01,083762,Staff,17,0,30,13
1650010970318,MATH 20C,B02,083763,Staff,29,0,30,1
1650010976346,MATH 20D,A01,083765,Staff,0,2,30,30
1650010976346,MATH 20D,A02,083766,Staff,16,0,30,14
1650010976346,MATH 20D,A03,083767,Staff,28,0,30,2
1650010982369,MATH 20E,A01,083771,Staff,11,0,30,19
1650010982369,MATH 20E,A02,083772,Staff,20,0,30,10
1650010982369,MATH 20E,B01,083773,Staff,0,1,30,30
1650010982369,MATH 20E,B02,083774,Staff,21,0,30,9
1650010988397,MATH 103A,A01,083777,Staff,0,6,30,30
1650010988397,MATH 103A,A02,083778,Staff,0,7,30,30
1650010988397,MATH 103A,B01,083779,Staff,0,6,30,30
1650010988397,MATH 103A,B02,083780,Staff,0,6,30,30
1650010994423,MATH 105,A01,085443,Staff,0,11,30,30
1650011000446,MATH 109,A01,083213,Anzaldo; Leesa B,0,3,30,30
1650011000446,MATH 109,A02,083214,Anzaldo; Leesa B,0,3,30,30
1650011000446,MATH 109,B01,083215,Anzaldo; Leesa B,0,2,30,30
1650011000446,MATH 109,B02,083216,Anzaldo; Leesa B,0,2,30,30
1650011006470,MATH 142A,A01,083219,Chow; Bennett,0,7,30,30
1650011006470,MATH 142A,A02,083220,Chow; Bennett,0,7,30,30
1650011006470,MATH 142A,B01,083221,Chow; Bennett,0,8,30,30
1650011006470,MATH 142A,B02,083222,Chow; Bennett,0,7,30,30
1650011012494,MATH 193A,A01,083224,Staff,0,5,30,30
1650011012494,MATH 193A,A02,083225,Staff,0,4,30,30
1650011012494,MATH 193A,A03,083781,Staff,0,0,30,30
1650011012494,MATH 193A,A04,083782,Staff,9,0,30,21
1650011018517,MATH 197,001,091859,McAuley; Julian John,9999,0,9999,0
1650011024572,COGS 9,A01,083615,Staff,1,15,60,59
1650011030606,COGS 11,A01,083617,Boyle; Mary E. T.,25,0,40,15
1650011036630,COGS 13,A01,083071,Staff,0,28,40,40
1650011042659,COGS 14A,A01,092681,Staff,0,6,100,100
1650011048684,COGS 14B,A01,083073,Cheng; Tzu-Han,0,2,50,50
1650011054708,COGS 17,A01,092677,Staff,35,0,75,40
1650011060733,COGS 100,A01,083619,Staff,0,18,60,60
1650011066757,COGS 101A,A01,083621,Davis; Joshua Daniel,0,16,60,60
1650011072783,COGS 101B,A01,091572,Staff,16,0,60,44
1650011078813,COGS 101C,A01,083625,Delgado; Tania,21,0,30,9
1650011084837,COGS 107A,A01,083627,Boyle; Mary E. T.,0,1,60,60
1650011090900,COGS 118A,A01,083075,Staff,19,0,60,41
1650011096945,CSE 3,A50,083646,Miranda; Gregory Joseph,22,0,38,16
1650011096945,CSE 3,A51,083647,Miranda; Gregory Joseph,37,0,37,0
1650011102989,CSE 8A,A50,083650,Miranda; Gregory Joseph,0,14,40,40
1650011109029,CSE 11,A01,083080,Cao; Yingjun,0,57,40,40
1650011115078,CSE 12,A01,083652,Staff,2,0,100,98
1650011121125,CSE 15L,A01,083654,Staff,0,0,50,50
1650011121125,CSE 15L,A02,083655,Staff,15,0,50,35
1650011127173,CSE 20,A01,083657,Staff,57,0,80,23
1650011133226,CSE 30,A01,083084,Eldon; John,0,62,40,40
1650011139264,CSE 100,A01,083659,Cao; Yingjun,0,57,50,50
1650011145309,CSE 134B,A01,083661,Powell; Thomas Allan,0,24,65,65
1650011151351,CSE 140,A01,083663,Staff,8,0,75,67
1650011157392,CSE 140L,A01,083088,Eldon; John,4,0,75,71
1650011163430,CSE 175,A01,083665,Kumar; Rakesh,10,0,25,15
1650011169455,CSE 190,A00,092507,Dubnov; Shlomo,17,0,20,3
1650011175479,ECE 45,A01,083139,Staff,0,10,40,40
1650011181507,ECE 65,A50,083695,Staff,0,1,30,30
1650011187532,ECE 109,A01,091882,Touri; Behrouz,48,0,70,22
1650011193560,ECE 180,A00,083140,Abi Samra; Nicholas Camill,26,0,30,4
1650011193560,ECE 180,B00,083141,Abi Samra; Nicholas Camill,10,0,30,20
1650011199587,MATH 10A,A01,083735,Patchell; Gregory David,14,0,30,16
1650011199587,MATH 10A,A02,083736,Patchell; Gregory David,28,0,30,2
1650011199587,MATH 10A,A03,083737,Patchell; Gregory David,27,0,30,3
1650011205616,MATH 10B,A01,083207,Staff,0,4,30,30
1650011205616,MATH 10B,A02,083208,Staff,1,0,30,29
1650011205616,MATH 10B,B01,083739,Staff,20,0,30,10
1650011205616,MATH 10B,B02,083740,Staff,30,0,30,0
1650011211649,MATH 18,A01,083743,Staff,10,0,30,20
1650011211649,MATH 18,A02,083744,Staff,28,0,30,2
1650011211649,MATH 18,A03,083745,Staff,23,0,30,7
1650011211649,MATH 18,A04,083746,Staff,27,0,30,3
1650011211649,MATH 18,B01,083748,Staff,0,7,30,30
1650011211649,MATH 18,B02,083749,Staff,0,6,30,30
1650011211649,MATH 18,B03,083750,Staff,0,6,30,30
1650011211649,MATH 18,B04,083751,Staff,0,7,30,30
1650011217677,MATH 20A,A01,083754,Staff,27,0,40,13
1650011223703,MATH 20B,A01,083756,Staff,0,4,30,30
1650011223703,MATH 20B,A02,083757,Staff,5,0,30,25
1650011229727,MATH 20C,A01,083760,Staff,0,9,30,30
1650011229727,MATH 20C,A02,083761,Staff,0,10,30,30
1650011229727,MATH 20C,B01,083762,Staff,17,0,30,13
1650011229727,MATH 20C,B02,083763,Staff,29,0,30,1
1650011235752,MATH 20D,A01,083765,Staff,0,2,30,30
1650011235752,MATH 20D,A02,083766,Staff,16,0,30,14
1650011235752,MATH 20D,A03,083767,Staff,28,0,30,2
1650011241782,MATH 20E,A01,083771,Staff,11,0,30,19
1650011241782,MATH 20E,A02,083772,Staff,20,0,30,10
1650011241782,MATH 20E,B01,083773,Staff,0,1,30,30
1650011241782,MATH 20E,B02,083774,Staff,21,0,30,9
1650011247807,MATH 103A,A01,083777,Staff,0,6,30,30
1650011247807,MATH 103A,A02,083778,Staff,0,7,30,30
1650011247807,MATH 103A,B01,083779,Staff,0,6,30,30
1650011247807,MATH 103A,B02,083780,Staff,0,6,30,30
1650011253835,MATH 105,A01,085443,Staff,0,11,30,30
1650011259859,MATH 109,A01,083213,Anzaldo; Leesa B,0,3,30,30
1650011259859,MATH 109,A02,083214,Anzaldo; Leesa B,0,3,30,30
1650011259859,MATH 109,B01,083215,Anzaldo; Leesa B,0,2,30,30
1650011259859,MATH 109,B02,083216,Anzaldo; Leesa B,0,2,30,30
1650011265886,MATH 142A,A01,083219,Chow; Bennett,0,7,30,30
1650011265886,MATH 142A,A02,083220,Chow; Bennett,0,7,30,30
1650011265886,MATH 142A,B01,083221,Chow; Bennett,0,8,30,30
1650011265886,MATH 142A,B02,083222,Chow; Bennett,0,7,30,30
1650011271918,MATH 193A,A01,083224,Staff,0,5,30,30
1650011271918,MATH 193A,A02,083225,Staff,0,4,30,30
1650011271918,MATH 193A,A03,083781,Staff,0,0,30,30
1650011271918,MATH 193A,A04,083782,Staff,9,0,30,21
1650011277942,MATH 197,001,091859,McAuley; Julian John,9999,0,9999,0
1650011284007,COGS 9,A01,083615,Staff,1,15,60,59
1650011290030,COGS 11,A01,083617,Boyle; Mary E. T.,25,0,40,15
1650011296054,COGS 13,A01,083071,Staff,0,28,40,40
1650011302076,COGS 14A,A01,092681,Staff,0,6,100,100
1650011308103,COGS 14B,A01,083073,Cheng; Tzu-Han,0,2,50,50
1650011314127,COGS 17,A01,092677,Staff,35,0,75,40
1650011320155,COGS 100,A01,083619,Staff,0,18,60,60
1650011326180,COGS 101A,A01,083621,Davis; Joshua Daniel,0,16,60,60
1650011332209,COGS 101B,A01,091572,Staff,16,0,60,44
1650011338231,COGS 101C,A01,083625,Delgado; Tania,21,0,30,9
1650011344260,COGS 107A,A01,083627,Boyle; Mary E. T.,0,1,60,60
1650011350285,COGS 118A,A01,083075,Staff,19,0,60,41
1650011356321,CSE 3,A50,083646,Miranda; Gregory Joseph,22,0,38,16
1650011356321,CSE 3,A51,083647,Miranda; Gregory Joseph,37,0,37,0
1650011362348,CSE 8A,A50,083650,Miranda; Gregory Joseph,0,14,40,40
1650011368382,CSE 11,A01,083080,Cao; Yingjun,0,57,40,40
1650011374408,CSE 12,A01,083652,Staff,2,0,100,98
1650011380435,CSE 15L,A01,083654,Staff,0,0,50,50
1650011380435,CSE 15L,A02,083655,Staff,15,0,50,35
1650011386459,CSE 20,A01,083657,Staff,57,0,80,23
1650011392493,CSE 30,A01,083084,Eldon; John,0,62,40,40
1650011398587,CSE 100,A01,083659,Cao; Yingjun,0,57,50,50
1650011404611,CSE 134B,A01,083661,Powell; Thomas Allan,0,24,65,65
1650011410635,CSE 140,A01,083663,Staff,8,0,75,67
1650011416667,CSE 140L,A01,083088,Eldon; John,4,0,75,71
1650011422691,CSE 175,A01,083665,Kumar; Rakesh,10,0,25,15
1650011428715,CSE 190,A00,092507,Dubnov; Shlomo,17,0,20,3
1650011434740,ECE 45,A01,083139,Staff,0,10,40,40
1650011440765,ECE 65,A50,083695,Staff,0,1,30,30
1650011446789,ECE 109,A01,091882,Touri; Behrouz,48,0,70,22
1650011452818,ECE 180,A00,083140,Abi Samra; Nicholas Camill,26,0,30,4
1650011452818,ECE 180,B00,083141,Abi Samra; Nicholas Camill,10,0,30,20
1650011458845,MATH 10A,A01,083735,Patchell; Gregory David,14,0,30,16
1650011458845,MATH 10A,A02,083736,Patchell; Gregory David,28,0,30,2
1650011458845,MATH 10A,A03,083737,Patchell; Gregory David,27,0,30,3
1650011464871,MATH 10B,A01,083207,Staff,0,4,30,30
1650011464871,MATH 10B,A02,083208,Staff,1,0,30,29
1650011464871,MATH 10B,B01,083739,Staff,20,0,30,10
1650011464871,MATH 10B,B02,083740,Staff,30,0,30,0
1650011470899,MATH 18,A01,083743,Staff,10,0,30,20
1650011470899,MATH 18,A02,083744,Staff,28,0,30,2
1650011470899,MATH 18,A03,083745,Staff,23,0,30,7
1650011470899,MATH 18,A04,083746,Staff,27,0,30,3
1650011470899,MATH 18,B01,083748,Staff,0,7,30,30
1650011470899,MATH 18,B02,083749,Staff,0,6,30,30
1650011470899,MATH 18,B03,083750,Staff,0,6,30,30
1650011470899,MATH 18,B04,083751,Staff,0,7,30,30
1650011476926,MATH 20A,A01,083754,Staff,27,0,40,13
1650011482955,MATH 20B,A01,083756,Staff,0,4,30,30
1650011482955,MATH 20B,A02,083757,Staff,5,0,30,25
1650011488987,MATH 20C,A01,083760,Staff,0,9,30,30
1650011488987,MATH 20C,A02,083761,Staff,0,10,30,30
1650011488987,MATH 20C,B01,083762,Staff,17,0,30,13
1650011488987,MATH 20C,B02,083763,Staff,29,0,30,1
1650011495014,MATH 20D,A01,083765,Staff,0,2,30,30
1650011495014,MATH 20D,A02,083766,Staff,16,0,30,14
1650011495014,MATH 20D,A03,083767,Staff,28,0,30,2
1650011501038,MATH 20E,A01,083771,Staff,11,0,30,19
1650011501038,MATH 20E,A02,083772,Staff,20,0,30,10
1650011501038,MATH 20E,B01,083773,Staff,0,1,30,30
1650011501038,MATH 20E,B02,083774,Staff,21,0,30,9
1650011507064,MATH 103A,A01,083777,Staff,0,6,30,30
1650011507064,MATH 103A,A02,083778,Staff,0,7,30,30
1650011507064,MATH 103A,B01,083779,Staff,0,6,30,30
1650011507064,MATH 103A,B02,083780,Staff,0,6,30,30
1650011513092,MATH 105,A01,085443,Staff,0,11,30,30
1650011519116,MATH 109,A01,083213,Anzaldo; Leesa B,0,3,30,30
1650011519116,MATH 109,A02,083214,Anzaldo; Leesa B,0,3,30,30
1650011519116,MATH 109,B01,083215,Anzaldo; Leesa B,0,2,30,30
1650011519116,MATH 109,B02,083216,Anzaldo; Leesa B,0,2,30,30
1650011525149,MATH 142A,A01,083219,Chow; Bennett,0,7,30,30
1650011525149,MATH 142A,A02,083220,Chow; Bennett,0,7,30,30
1650011525149,MATH 142A,B01,083221,Chow; Bennett,0,8,30,30
1650011525149,MATH 142A,B02,083222,Chow; Bennett,0,7,30,30
1650011531179,MATH 193A,A01,083224,Staff,0,5,30,30
1650011531179,MATH 193A,A02,083225,Staff,0,4,30,30
1650011531179,MATH 193A,A03,083781,Staff,0,0,30,30
1650011531179,MATH 193A,A04,083782,Staff,9,0,30,21
1650011537223,MATH 197,001,091859,McAuley; Julian John,9999,0,9999,0
1650011543306,COGS 9,A01,083615,Staff,1,15,60,59
1650011549330,COGS 11,A01,083617,Boyle; Mary E. T.,25,0,40,15
1650011555356,COGS 13,A01,083071,Staff,0,28,40,40
1650011561380,COGS 14A,A01,092681,Staff,0,6,100,100
1650011567411,COGS 14B,A01,083073,Cheng; Tzu-Han,0,2,50,50
1650011573439,COGS 17,A01,092677,Staff,35,0,75,40
1650011579461,COGS 100,A01,083619,Staff,0,18,60,60
1650011585490,COGS 101A,A01,083621,Davis; Joshua Daniel,0,16,60,60
1650011591515,COGS 101B,A01,091572,Staff,16,0,60,44
1650011597540,COGS 101C,A01,083625,Delgado; Tania,21,0,30,9
1650011603569,COGS 107A,A01,083627,Boyle; Mary E. T.,0,1,60,60
1650011609591,COGS 118A,A01,083075,Staff,19,0,60,41
1650011615621,CSE 3,A50,083646,Miranda; Gregory Joseph,22,0,38,16
1650011615621,CSE 3,A51,083647,Miranda; Gregory Joseph,37,0,37,0
1650011621731,CSE 8A,A50,083650,Miranda; Gregory Joseph,0,14,40,40
1650011627760,CSE 11,A01,083080,Cao; Yingjun,0,58,40,40
1650011633783,CSE 12,A01,083652,Staff,2,0,100,98
1650011639813,CSE 15L,A01,083654,Staff,0,0,50,50
1650011639813,CSE 15L,A02,083655,Staff,15,0,50,35
1650011645840,CSE 20,A01,083657,Staff,57,0,80,23
1650011651867,CSE 30,A01,083084,Eldon; John,0,62,40,40
1650011657893,CSE 100,A01,083659,Cao; Yingjun,0,57,50,50
1650011663917,CSE 134B,A01,083661,Powell; Thomas Allan,0,24,65,65
1650011669952,CSE 140,A01,083663,Staff,8,0,75,67
1650011675985,CSE 140L,A01,083088,Eldon; John,4,0,75,71
1650011682009,CSE 175,A01,083665,Kumar; Rakesh,10,0,25,15
1650011688037,CSE 190,A00,092507,Dubnov; Shlomo,17,0,20,3
1650011694061,ECE 45,A01,083139,Staff,0,10,40,40
1650011700087,ECE 65,A50,083695,Staff,0,1,30,30
1650011706116,ECE 109,A01,091882,Touri; Behrouz,48,0,70,22
1650011712148,ECE 180,A00,083140,Abi Samra; Nicholas Camill,26,0,30,4
1650011712148,ECE 180,B00,083141,Abi Samra; Nicholas Camill,10,0,30,20
1650011718174,MATH 10A,A01,083735,Patchell; Gregory David,14,0,30,16
1650011718174,MATH 10A,A02,083736,Patchell; Gregory David,28,0,30,2
1650011718174,MATH 10A,A03,083737,Patchell; Gregory David,27,0,30,3
1650011724198,MATH 10B,A01,083207,Staff,0,4,30,30
1650011724198,MATH 10B,A02,083208,Staff,1,0,30,29
1650011724198,MATH 10B,B01,083739,Staff,20,0,30,10
1650011724198,MATH 10B,B02,083740,Staff,30,0,30,0
1650011730229,MATH 18,A01,083743,Staff,10,0,30,20
1650011730229,MATH 18,A02,083744,Staff,28,0,30,2
1650011730229,MATH 18,A03,083745,Staff,23,0,30,7
1650011730229,MATH 18,A04,083746,Staff,27,0,30,3
1650011730229,MATH 18,B01,083748,Staff,0,7,30,30
1650011730229,MATH 18,B02,083749,Staff,0,6,30,30
1650011730229,MATH 18,B03,083750,Staff,0,6,30,30
1650011730229,MATH 18,B04,083751,Staff,1,7,30,29
1650011736256,MATH 20A,A01,083754,Staff,27,0,40,13
1650011742284,MATH 20B,A01,083756,Staff,0,4,30,30
1650011742284,MATH 20B,A02,083757,Staff,5,0,30,25
1650011748308,MATH 20C,A01,083760,Staff,0,9,30,30
1650011748308,MATH 20C,A02,083761,Staff,0,10,30,30
1650011748308,MATH 20C,B01,083762,Staff,17,0,30,13
1650011748308,MATH 20C,B02,083763,Staff,29,0,30,1
1650011754336,MATH 20D,A01,083765,Staff,0,2,30,30
1650011754336,MATH 20D,A02,083766,Staff,16,0,30,14
1650011754336,MATH 20D,A03,083767,Staff,28,0,30,2
1650011760377,MATH 20E,A01,083771,Staff,11,0,30,19
1650011760377,MATH 20E,A02,083772,Staff,20,0,30,10
1650011760377,MATH 20E,B01,083773,Staff,0,1,30,30
1650011760377,MATH 20E,B02,083774,Staff,21,0,30,9
1650011766407,MATH 103A,A01,083777,Staff,0,6,30,30
1650011766407,MATH 103A,A02,083778,Staff,0,7,30,30
1650011766407,MATH 103A,B01,083779,Staff,0,6,30,30
1650011766407,MATH 103A,B02,083780,Staff,0,6,30,30
1650011772434,MATH 105,A01,085443,Staff,0,11,30,30
1650011778469,MATH 109,A01,083213,Anzaldo; Leesa B,0,3,30,30
1650011778469,MATH 109,A02,083214,Anzaldo; Leesa B,0,3,30,30
1650011778469,MATH 109,B01,083215,Anzaldo; Leesa B,0,2,30,30
1650011778469,MATH 109,B02,083216,Anzaldo; Leesa B,0,2,30,30
1650011784493,MATH 142A,A01,083219,Chow; Bennett,0,7,30,30
1650011784493,MATH 142A,A02,083220,Chow; Bennett,0,7,30,30
1650011784493,MATH 142A,B01,083221,Chow; Bennett,0,8,30,30
1650011784493,MATH 142A,B02,083222,Chow; Bennett,0,7,30,30
1650011790518,MATH 193A,A01,083224,Staff,0,5,30,30
1650011790518,MATH 193A,A02,083225,Staff,0,4,30,30
1650011790518,MATH 193A,A03,083781,Staff,0,0,30,30
1650011790518,MATH 193A,A04,083782,Staff,9,0,30,21
1650011796544,MATH 197,001,091859,McAuley; Julian John,9999,0,9999,0
1650011802611,COGS 9,A01,083615,Staff,1,15,60,59
1650011808645,COGS 11,A01,083617,Boyle; Mary E. T.,25,0,40,15
1650011814672,COGS 13,A01,083071,Staff,0,28,40,40
1650011820697,COGS 14A,A01,092681,Staff,0,6,100,100
1650011826725,COGS 14B,A01,083073,Cheng; Tzu-Han,0,2,50,50
1650011832749,COGS 17,A01,092677,Staff,35,0,75,40
1650011838777,COGS 100,A01,083619,Staff,0,18,60,60
1650011844801,COGS 101A,A01,083621,Davis; Joshua Daniel,0,16,60,60
1650011850824,COGS 101B,A01,091572,Staff,16,0,60,44
1650011856850,COGS 101C,A01,083625,Delgado; Tania,21,0,30,9
1650011862874,COGS 107A,A01,083627,Boyle; Mary E. T.,0,1,60,60
1650011868903,COGS 118A,A01,083075,Staff,19,0,60,41
1650011874931,CSE 3,A50,083646,Miranda; Gregory Joseph,22,0,38,16
1650011874931,CSE 3,A51,083647,Miranda; Gregory Joseph,37,0,37,0
1650011880955,CSE 8A,A50,083650,Miranda; Gregory Joseph,0,14,40,40
1650011886982,CSE 11,A01,083080,Cao; Yingjun,0,59,40,40
1650011893010,CSE 12,A01,083652,Staff,2,0,100,98
1650011899032,CSE 15L,A01,083654,Staff,0,0,50,50
1650011899032,CSE 15L,A02,083655,Staff,15,0,50,35
1650011905060,CSE 20,A01,083657,Staff,57,0,80,23
1650011911083,CSE 30,A01,083084,Eldon; John,0,62,40,40
1650011917107,CSE 100,A01,083659,Cao; Yingjun,0,57,50,50
1650011923134,CSE 134B,A01,083661,Powell; Thomas Allan,0,24,65,65
1650011929160,CSE 140,A01,083663,Staff,8,0,75,67
1650011935188,CSE 140L,A01,083088,Eldon; John,4,0,75,71
1650011941226,CSE 175,A01,083665,Kumar; Rakesh,10,0,25,15
1650011947255,CSE 190,A00,092507,Dubnov; Shlomo,17,0,20,3
1650011953278,ECE 45,A01,083139,Staff,0,10,40,40
1650011959324,ECE 65,A50,083695,Staff,0,1,30,30
1650011965348,ECE 109,A01,091882,Touri; Behrouz,48,0,70,22
1650011971372,ECE 180,A00,083140,Abi Samra; Nicholas Camill,26,0,30,4
1650011971372,ECE 180,B00,083141,Abi Samra; Nicholas Camill,10,0,30,20
1650011977397,MATH 10A,A01,083735,Patchell; Gregory David,14,0,30,16
1650011977397,MATH 10A,A02,083736,Patchell; Gregory David,28,0,30,2
1650011977397,MATH 10A,A03,083737,Patchell; Gregory David,27,0,30,3
1650011983425,MATH 10B,A01,083207,Staff,0,4,30,30
1650011983425,MATH 10B,A02,083208,Staff,1,0,30,29
1650011983425,MATH 10B,B01,083739,Staff,20,0,30,10
1650011983425,MATH 10B,B02,083740,Staff,30,0,30,0
1650011989451,MATH 18,A01,083743,Staff,10,0,30,20
1650011989451,MATH 18,A02,083744,Staff,28,0,30,2
1650011989451,MATH 18,A03,083745,Staff,23,0,30,7
1650011989451,MATH 18,A04,083746,Staff,27,0,30,3
1650011989451,MATH 18,B01,083748,Staff,0,7,30,30
1650011989451,MATH 18,B02,083749,Staff,0,6,30,30
1650011989451,MATH 18,B03,083750,Staff,0,6,30,30
1650011989451,MATH 18,B04,083751,Staff,1,7,30,29
1650011995573,MATH 20A,A01,083754,Staff,27,0,40,13
1650012001598,MATH 20B,A01,083756,Staff,0,4,30,30
1650012001598,MATH 20B,A02,083757,Staff,5,0,30,25
1650012007626,MATH 20C,A01,083760,Staff,0,9,30,30
1650012007626,MATH 20C,A02,083761,Staff,0,10,30,30
1650012007626,MATH 20C,B01,083762,Staff,17,0,30,13
1650012007626,MATH 20C,B02,083763,Staff,29,0,30,1
1650012013650,MATH 20D,A01,083765,Staff,0,2,30,30
1650012013650,MATH 20D,A02,083766,Staff,16,0,30,14
1650012013650,MATH 20D,A03,083767,Staff,28,0,30,2
1650012019690,MATH 20E,A01,083771,Staff,11,0,30,19
1650012019690,MATH 20E,A02,083772,Staff,20,0,30,10
1650012019690,MATH 20E,B01,083773,Staff,0,1,30,30
1650012019690,MATH 20E,B02,083774,Staff,21,0,30,9
1650012025716,MATH 103A,A01,083777,Staff,0,6,30,30
1650012025716,MATH 103A,A02,083778,Staff,0,7,30,30
1650012025716,MATH 103A,B01,083779,Staff,0,6,30,30
1650012025716,MATH 103A,B02,083780,Staff,0,6,30,30
1650012031740,MATH 105,A01,085443,Staff,0,11,30,30
1650012037767,MATH 109,A01,083213,Anzaldo; Leesa B,0,3,30,30
1650012037767,MATH 109,A02,083214,Anzaldo; Leesa B,0,3,30,30
1650012037767,MATH 109,B01,083215,Anzaldo; Leesa B,0,2,30,30
1650012037767,MATH 109,B02,083216,Anzaldo; Leesa B,0,2,30,30
1650012043792,MATH 142A,A01,083219,Chow; Bennett,0,7,30,30
1650012043792,MATH 142A,A02,083220,Chow; Bennett,0,7,30,30
1650012043792,MATH 142A,B01,083221,Chow; Bennett,0,8,30,30
1650012043792,MATH 142A,B02,083222,Chow; Bennett,0,7,30,30
1650012049816,MATH 193A,A01,083224,Staff,0,5,30,30
1650012049816,MATH 193A,A02,083225,Staff,0,4,30,30
1650012049816,MATH 193A,A03,083781,Staff,0,0,30,30
1650012049816,MATH 193A,A04,083782,Staff,9,0,30,21
1650012055844,MATH 197,001,091859,McAuley; Julian John,9999,0,9999,0
1650012061912,COGS 9,A01,083615,Staff,1,15,60,59
1650012067942,COGS 11,A01,083617,Boyle; Mary E. T.,25,0,40,15
1650012073980,COGS 13,A01,083071,Staff,0,28,40,40
1650012080004,COGS 14A,A01,092681,Staff,0,6,100,100
1650012086035,COGS 14B,A01,083073,Cheng; Tzu-Han,0,2,50,50
1650012092058,COGS 17,A01,092677,Staff,35,0,75,40
1650012098084,COGS 100,A01,083619,Staff,0,18,60,60
1650012104109,COGS 101A,A01,083621,Davis; Joshua Daniel,0,16,60,60
1650012110138,COGS 101B,A01,091572,Staff,16,0,60,44
1650012116167,COGS 101C,A01,083625,Delgado; Tania,21,0,30,9
1650012122196,COGS 107A,A01,083627,Boyle; Mary E. T.,0,1,60,60
1650012128219,COGS 118A,A01,083075,Staff,19,0,60,41
1650012134249,CSE 3,A50,083646,Miranda; Gregory Joseph,22,0,38,16
1650012134249,CSE 3,A51,083647,Miranda; Gregory Joseph,37,0,37,0
1650012140276,CSE 8A,A50,083650,Miranda; Gregory Joseph,0,14,40,40
1650012146300,CSE 11,A01,083080,Cao; Yingjun,0,59,40,40
1650012152323,CSE 12,A01,083652,Staff,2,0,100,98
1650012158348,CSE 15L,A01,083654,Staff,0,0,50,50
1650012158348,CSE 15L,A02,083655,Staff,15,0,50,35
1650012164416,CSE 20,A01,083657,Staff,57,0,80,23
1650012170441,CSE 30,A01,083084,Eldon; John,0,62,40,40
1650012176464,CSE 100,A01,083659,Cao; Yingjun,0,57,50,50
1650012182492,CSE 134B,A01,083661,Powell; Thomas Allan,0,24,65,65
1650012188529,CSE 140,A01,083663,Staff,8,0,75,67
1650012194555,CSE 140L,A01,083088,Eldon; John,4,0,75,71
1650012200579,CSE 175,A01,083665,Kumar; Rakesh,10,0,25,15
1650012206610,CSE 190,A00,092507,Dubnov; Shlomo,17,0,20,3
1650012212638,ECE 45,A01,083139,Staff,0,10,40,40
1650012218668,ECE 65,A50,083695,Staff,0,1,30,30
1650012224695,ECE 109,A01,091882,Touri; Behrouz,48,0,70,22
1650012230719,ECE 180,A00,083140,Abi Samra; Nicholas Camill,26,0,30,4
1650012230719,ECE 180,B00,083141,Abi Samra; Nicholas Camill,10,0,30,20
1650012236747,MATH 10A,A01,083735,Patchell; Gregory David,14,0,30,16
1650012236747,MATH 10A,A02,083736,Patchell; Gregory David,28,0,30,2
1650012236747,MATH 10A,A03,083737,Patchell; Gregory David,27,0,30,3
1650012242772,MATH 10B,A01,083207,Staff,0,4,30,30
1650012242772,MATH 10B,A02,083208,Staff,1,0,30,29
1650012242772,MATH 10B,B01,083739,Staff,20,0,30,10
1650012242772,MATH 10B,B02,083740,Staff,30,0,30,0
1650012248803,MATH 18,A01,083743,Staff,10,0,30,20
1650012248803,MATH 18,A02,083744,Staff,28,0,30,2
1650012248803,MATH 18,A03,083745,Staff,23,0,30,7
1650012248803,MATH 18,A04,083746,Staff,27,0,30,3
1650012248803,MATH 18,B01,083748,Staff,0,8,30,30
1650012248803,MATH 18,B02,083749,Staff,0,6,30,30
1650012248803,MATH 18,B03,083750,Staff,0,6,30,30
1650012248803,MATH 18,B04,083751,Staff,1,7,30,29
1650012254827,MATH 20A,A01,083754,Staff,27,0,40,13
1650012260852,MATH 20B,A01,083756,Staff,0,4,30,30
1650012260852,MATH 20B,A02,083757,Staff,5,0,30,25
1650012266876,MATH 20C,A01,083760,Staff,0,9,30,30
1650012266876,MATH 20C,A02,083761,Staff,0,10,30,30
1650012266876,MATH 20C,B01,083762,Staff,17,0,30,13
1650012266876,MATH 20C,B02,083763,Staff,29,0,30,1
1650012272899,MATH 20D,A01,083765,Staff,0,2,30,30
1650012272899,MATH 20D,A02,083766,Staff,16,0,30,14
1650012272899,MATH 20D,A03,083767,Staff,28,0,30,2
1650012278922,MATH 20E,A01,083771,Staff,11,0,30,19
1650012278922,MATH 20E,A02,083772,Staff,20,0,30,10
1650012278922,MATH 20E,B01,083773,Staff,0,1,30,30
1650012278922,MATH 20E,B02,083774,Staff,21,0,30,9
1650012284946,MATH 103A,A01,083777,Staff,0,6,30,30
1650012284946,MATH 103A,A02,083778,Staff,0,7,30,30
1650012284946,MATH 103A,B01,083779,Staff,0,6,30,30
1650012284946,MATH 103A,B02,083780,Staff,0,6,30,30
1650012290970,MATH 105,A01,085443,Staff,0,11,30,30
1650012296995,MATH 109,A01,083213,Anzaldo; Leesa B,0,3,30,30
1650012296995,MATH 109,A02,083214,Anzaldo; Leesa B,0,3,30,30
1650012296995,MATH 109,B01,083215,Anzaldo; Leesa B,0,2,30,30
1650012296995,MATH 109,B02,083216,Anzaldo; Leesa B,0,2,30,30
1650012303025,MATH 142A,A01,083219,Chow; Bennett,0,7,30,30
1650012303025,MATH 142A,A02,083220,Chow; Bennett,0,7,30,30
1650012303025,MATH 142A,B01,083221,Chow; Bennett,0,8,30,30
1650012303025,MATH 142A,B02,083222,Chow; Bennett,0,7,30,30
1650012309053,MATH 193A,A01,083224,Staff,0,5,30,30
1650012309053,MATH 193A,A02,083225,Staff,0,4,30,30
1650012309053,MATH 193A,A03,083781,Staff,0,0,30,30
1650012309053,MATH 193A,A04,083782,Staff,9,0,30,21
1650012315081,MATH 197,001,091859,McAuley; Julian John,9999,0,9999,0
1650012321143,COGS 9,A01,083615,Staff,1,15,60,59
1650012327171,COGS 11,A01,083617,Boyle; Mary E. T.,25,0,40,15
1650012333196,COGS 13,A01,083071,Staff,0,28,40,40
1650012339224,COGS 14A,A01,092681,Staff,0,6,100,100
1650012345252,COGS 14B,A01,083073,Cheng; Tzu-Han,0,2,50,50
1650012351280,COGS 17,A01,092677,Staff,35,0,75,40
1650012357303,COGS 100,A01,083619,Staff,0,18,60,60
1650012363360,COGS 101A,A01,083621,Davis; Joshua Daniel,0,16,60,60
1650012369383,COGS 101B,A01,091572,Staff,16,0,60,44
1650012375413,COGS 101C,A01,083625,Delgado; Tania,21,0,30,9
1650012381441,COGS 107A,A01,083627,Boyle; Mary E. T.,0,1,60,60
1650012387465,COGS 118A,A01,083075,Staff,19,0,60,41
1650012393491,CSE 3,A50,083646,Miranda; Gregory Joseph,22,0,38,16
1650012393491,CSE 3,A51,083647,Miranda; Gregory Joseph,37,0,37,0
1650012399515,CSE 8A,A50,083650,Miranda; Gregory Joseph,0,14,40,40
1650012405543,CSE 11,A01,083080,Cao; Yingjun,0,59,40,40
1650012411567,CSE 12,A01,083652,Staff,2,0,100,98
1650012417590,CSE 15L,A01,083654,Staff,0,0,50,50
1650012417590,CSE 15L,A02,083655,Staff,15,0,50,35
1650012423620,CSE 20,A01,083657,Staff,57,0,80,23
1650012429642,CSE 30,A01,083084,Eldon; John,0,62,40,40
1650012435670,CSE 100,A01,083659,Cao; Yingjun,0,57,50,50
1650012441699,CSE 134B,A01,083661,Powell; Thomas Allan,0,24,65,65
1650012447725,CSE 140,A01,083663,Staff,8,0,75,67
1650012453750,CSE 140L,A01,083088,Eldon; John,4,0,75,71
1650012459774,CSE 175,A01,083665,Kumar; Rakesh,10,0,25,15
1650012465800,CSE 190,A00,092507,Dubnov; Shlomo,17,0,20,3
1650012471824,ECE 45,A01,083139,Staff,0,10,40,40
1650012477850,ECE 65,A50,083695,Staff,0,1,30,30
1650012483875,ECE 109,A01,091882,Touri; Behrouz,48,0,70,22
1650012489898,ECE 180,A00,083140,Abi Samra; Nicholas Camill,26,0,30,4
1650012489898,ECE 180,B00,083141,Abi Samra; Nicholas Camill,10,0,30,20
1650012495922,MATH 10A,A01,083735,Patchell; Gregory David,14,0,30,16
1650012495922,MATH 10A,A02,083736,Patchell; Gregory David,28,0,30,2
1650012495922,MATH 10A,A03,083737,Patchell; Gregory David,27,0,30,3
1650012501944,MATH 10B,A01,083207,Staff,0,4,30,30
1650012501944,MATH 10B,A02,083208,Staff,1,0,30,29
1650012501944,MATH 10B,B01,083739,Staff,20,0,30,10
1650012501944,MATH 10B,B02,083740,Staff,30,0,30,0
1650012507968,MATH 18,A01,083743,Staff,10,0,30,20
1650012507968,MATH 18,A02,083744,Staff,28,0,30,2
1650012507968,MATH 18,A03,083745,Staff,23,0,30,7
1650012507968,MATH 18,A04,083746,Staff,27,0,30,3
1650012507968,MATH 18,B01,083748,Staff,0,8,30,30
1650012507968,MATH 18,B02,083749,Staff,0,6,30,30
1650012507968,MATH 18,B03,083750,Staff,0,6,30,30
1650012507968,MATH 18,B04,083751,Staff,1,7,30,29
1650012513993,MATH 20A,A01,083754,Staff,27,0,40,13
1650012520020,MATH 20B,A01,083756,Staff,0,4,30,30
1650012520020,MATH 20B,A02,083757,Staff,5,0,30,25
1650012526048,MATH 20C,A01,083760,Staff,0,9,30,30
1650012526048,MATH 20C,A02,083761,Staff,0,10,30,30
1650012526048,MATH 20C,B01,083762,Staff,17,0,30,13
1650012526048,MATH 20C,B02,083763,Staff,29,0,30,1
1650012532069,MATH 20D,A01,083765,Staff,0,2,30,30
1650012532069,MATH 20D,A02,083766,Staff,16,0,30,14
1650012532069,MATH 20D,A03,083767,Staff,28,0,30,2
1650012538097,MATH 20E,A01,083771,Staff,11,0,30,19
1650012538097,MATH 20E,A02,083772,Staff,20,0,30,10
1650012538097,MATH 20E,B01,083773,Staff,0,1,30,30
1650012538097,MATH 20E,B02,083774,Staff,21,0,30,9
1650012544121,MATH 103A,A01,083777,Staff,0,6,30,30
1650012544121,MATH 103A,A02,083778,Staff,0,7,30,30
1650012544121,MATH 103A,B01,083779,Staff,0,6,30,30
1650012544121,MATH 103A,B02,083780,Staff,0,6,30,30
1650012550149,MATH 105,A01,085443,Staff,0,11,30,30
1650012556179,MATH 109,A01,083213,Anzaldo; Leesa B,0,3,30,30
1650012556179,MATH 109,A02,083214,Anzaldo; Leesa B,0,3,30,30
1650012556179,MATH 109,B01,083215,Anzaldo; Leesa B,0,2,30,30
1650012556179,MATH 109,B02,083216,Anzaldo; Leesa B,0,2,30,30
1650012562203,MATH 142A,A01,083219,Chow; Bennett,0,7,30,30
1650012562203,MATH 142A,A02,083220,Chow; Bennett,0,7,30,30
1650012562203,MATH 142A,B01,083221,Chow; Bennett,0,8,30,30
1650012562203,MATH 142A,B02,083222,Chow; Bennett,0,7,30,30
1650012568230,MATH 193A,A01,083224,Staff,0,5,30,30
1650012568230,MATH 193A,A02,083225,Staff,0,4,30,30
1650012568230,MATH 193A,A03,083781,Staff,0,0,30,30
1650012568230,MATH 193A,A04,083782,Staff,9,0,30,21
1650012574253,MATH 197,001,091859,McAuley; Julian John,9999,0,9999,0
1650012580318,COGS 9,A01,083615,Staff,1,15,60,59
1650012586424,COGS 11,A01,083617,Boyle; Mary E. T.,25,0,40,15
1650012592458,COGS 13,A01,083071,Staff,0,28,40,40
1650012598482,COGS 14A,A01,092681,Staff,0,6,100,100
1650012604511,COGS 14B,A01,083073,Cheng; Tzu-Han,0,2,50,50
1650012610536,COGS 17,A01,092677,Staff,35,0,75,40
1650012616569,COGS 100,A01,083619,Staff,0,18,60,60
1650012622593,COGS 101A,A01,083621,Davis; Joshua Daniel,0,16,60,60
1650012628618,COGS 101B,A01,091572,Staff,16,0,60,44
1650012634646,COGS 101C,A01,083625,Delgado; Tania,21,0,30,9
1650012640671,COGS 107A,A01,083627,Boyle; Mary E. T.,0,1,60,60
1650012646698,COGS 118A,A01,083075,Staff,19,0,60,41
1650012652729,CSE 3,A50,083646,Miranda; Gregory Joseph,22,0,38,16
1650012652729,CSE 3,A51,083647,Miranda; Gregory Joseph,37,0,37,0
1650012658752,CSE 8A,A50,083650,Miranda; Gregory Joseph,0,14,40,40
1650012664782,CSE 11,A01,083080,Cao; Yingjun,0,60,40,40
1650012670815,CSE 12,A01,083652,Staff,2,0,100,98
1650012676839,CSE 15L,A01,083654,Staff,0,0,50,50
1650012676839,CSE 15L,A02,083655,Staff,15,0,50,35
1650012682864,CSE 20,A01,083657,Staff,57,0,80,23
1650012688890,CSE 30,A01,083084,Eldon; John,0,62,40,40
1650012694914,CSE 100,A01,083659,Cao; Yingjun,0,57,50,50
1650012700943,CSE 134B,A01,083661,Powell; Thomas Allan,0,24,65,65
1650012706967,CSE 140,A01,083663,Staff,8,0,75,67
1650012712996,CSE 140L,A01,083088,Eldon; John,4,0,75,71
1650012719024,CSE 175,A01,083665,Kumar; Rakesh,10,0,25,15
1650012725048,CSE 190,A00,092507,Dubnov; Shlomo,17,0,20,3
1650012731076,ECE 45,A01,083139,Staff,0,10,40,40
1650012737101,ECE 65,A50,083695,Staff,0,1,30,30
1650012743126,ECE 109,A01,091882,Touri; Behrouz,48,0,70,22
1650012749153,ECE 180,A00,083140,Abi Samra; Nicholas Camill,26,0,30,4
1650012749153,ECE 180,B00,083141,Abi Samra; Nicholas Camill,10,0,30,20
1650012755178,MATH 10A,A01,083735,Patchell; Gregory David,14,0,30,16
1650012755178,MATH 10A,A02,083736,Patchell; Gregory David,28,0,30,2
1650012755178,MATH 10A,A03,083737,Patchell; Gregory David,27,0,30,3
1650012761211,MATH 10B,A01,083207,Staff,0,4,30,30
1650012761211,MATH 10B,A02,083208,Staff,1,0,30,29
1650012761211,MATH 10B,B01,083739,Staff,20,0,30,10
1650012761211,MATH 10B,B02,083740,Staff,30,0,30,0
1650012767240,MATH 18,A01,083743,Staff,10,0,30,20
1650012767240,MATH 18,A02,083744,Staff,28,0,30,2
1650012767240,MATH 18,A03,083745,Staff,23,0,30,7
1650012767240,MATH 18,A04,083746,Staff,27,0,30,3
1650012767240,MATH 18,B01,083748,Staff,0,8,30,30
1650012767240,MATH 18,B02,083749,Staff,0,6,30,30
1650012767240,MATH 18,B03,083750,Staff,0,6,30,30
1650012767240,MATH 18,B04,083751,Staff,1,7,30,29
1650012773265,MATH 20A,A01,083754,Staff,27,0,40,13
1650012779290,MATH 20B,A01,083756,Staff,0,4,30,30
1650012779290,MATH 20B,A02,083757,Staff,5,0,30,25
1650012785312,MATH 20C,A01,083760,Staff,0,9,30,30
1650012785312,MATH 20C,A02,083761,Staff,0,10,30,30
1650012785312,MATH 20C,B01,083762,Staff,17,0,30,13
1650012785312,MATH 20C,B02,083763,Staff,29,0,30,1
1650012791340,MATH 20D,A01,083765,Staff,0,2,30,30
1650012791340,MATH 20D,A02,083766,Staff,16,0,30,14
1650012791340,MATH 20D,A03,083767,Staff,28,0,30,2
1650012797366,MATH 20E,A01,083771,Staff,11,0,30,19
1650012797366,MATH 20E,A02,083772,Staff,20,0,30,10
1650012797366,MATH 20E,B01,083773,Staff,0,1,30,30
1650012797366,MATH 20E,B02,083774,Staff,21,0,30,9
1650012803390,MATH 103A,A01,083777,Staff,0,6,30,30
1650012803390,MATH 103A,A02,083778,Staff,0,7,30,30
1650012803390,MATH 103A,B01,083779,Staff,0,6,30,30
1650012803390,MATH 103A,B02,083780,Staff,0,6,30,30
1650012809416,MATH 105,A01,085443,Staff,0,11,30,30
1650012815441,MATH 109,A01,083213,Anzaldo; Leesa B,0,3,30,30
1650012815441,MATH 109,A02,083214,Anzaldo; Leesa B,0,3,30,30
1650012815441,MATH 109,B01,083215,Anzaldo; Leesa B,0,2,30,30
1650012815441,MATH 109,B02,083216,Anzaldo; Leesa B,0,2,30,30
1650012821465,MATH 142A,A01,083219,Chow; Bennett,0,7,30,30
1650012821465,MATH 142A,A02,083220,Chow; Bennett,0,7,30,30
1650012821465,MATH 142A,B01,083221,Chow; Bennett,0,8,30,30
1650012821465,MATH 142A,B02,083222,Chow; Bennett,0,7,30,30
1650012827489,MATH 193A,A01,083224,Staff,0,5,30,30
1650012827489,MATH 193A,A02,083225,Staff,0,4,30,30
1650012827489,MATH 193A,A03,083781,Staff,0,0,30,30
1650012827489,MATH 193A,A04,083782,Staff,9,0,30,21
1650012833514,MATH 197,001,091859,McAuley; Julian John,9999,0,9999,0
1650012839585,COGS 9,A01,083615,Staff,1,15,60,59
1650012845610,COGS 11,A01,083617,Boyle; Mary E. T.,25,0,40,15
1650012851637,COGS 13,A01,083071,Staff,0,28,40,40
1650012857665,COGS 14A,A01,092681,Staff,0,6,100,100
1650012863698,COGS 14B,A01,083073,Cheng; Tzu-Han,0,2,50,50
1650012869726,COGS 17,A01,092677,Staff,35,0,75,40
1650012875749,COGS 100,A01,083619,Staff,0,18,60,60
1650012881774,COGS 101A,A01,083621,Davis; Joshua Daniel,0,16,60,60
1650012887803,COGS 101B,A01,091572,Staff,16,0,60,44
1650012893832,COGS 101C,A01,083625,Delgado; Tania,21,0,30,9
1650012899857,COGS 107A,A01,083627,Boyle; Mary E. T.,0,1,60,60
1650012905904,COGS 118A,A01,083075,Staff,19,0,60,41
1650012911928,CSE 3,A50,083646,Miranda; Gregory Joseph,22,0,38,16
1650012911928,CSE 3,A51,083647,Miranda; Gregory Joseph,37,0,37,0
1650012917956,CSE 8A,A50,083650,Miranda; Gregory Joseph,0,14,40,40
1650012923985,CSE 11,A01,083080,Cao; Yingjun,0,60,40,40
1650012930009,CSE 12,A01,083652,Staff,2,0,100,98
1650012936033,CSE 15L,A01,083654,Staff,0,0,50,50
1650012936033,CSE 15L,A02,083655,Staff,15,0,50,35
1650012942062,CSE 20,A01,083657,Staff,57,0,80,23
1650012948086,CSE 30,A01,083084,Eldon; John,0,62,40,40
1650012954109,CSE 100,A01,083659,Cao; Yingjun,0,57,50,50
1650012960141,CSE 134B,A01,083661,Powell; Thomas Allan,0,24,65,65
1650012966165,CSE 140,A01,083663,Staff,8,0,75,67
1650012972190,CSE 140L,A01,083088,Eldon; John,4,0,75,71
1650012978220,CSE 175,A01,083665,Kumar; Rakesh,10,0,25,15
1650012984243,CSE 190,A00,092507,Dubnov; Shlomo,17,0,20,3
1650012990267,ECE 45,A01,083139,Staff,0,10,40,40
1650012996291,ECE 65,A50,083695,Staff,0,1,30,30
1650013002316,ECE 109,A01,091882,Touri; Behrouz,48,0,70,22
1650013008343,ECE 180,A00,083140,Abi Samra; Nicholas Camill,26,0,30,4
1650013008343,ECE 180,B00,083141,Abi Samra; Nicholas Camill,10,0,30,20
1650013014376,MATH 10A,A01,083735,Patchell; Gregory David,14,0,30,16
1650013014376,MATH 10A,A02,083736,Patchell; Gregory David,28,0,30,2
1650013014376,MATH 10A,A03,083737,Patchell; Gregory David,27,0,30,3
1650013020399,MATH 10B,A01,083207,Staff,0,4,30,30
1650013020399,MATH 10B,A02,083208,Staff,0,0,30,30
1650013020399,MATH 10B,B01,083739,Staff,20,0,30,10
1650013020399,MATH 10B,B02,083740,Staff,30,0,30,0
1650013026424,MATH 18,A01,083743,Staff,10,0,30,20
1650013026424,MATH 18,A02,083744,Staff,28,0,30,2
1650013026424,MATH 18,A03,083745,Staff,23,0,30,7
1650013026424,MATH 18,A04,083746,Staff,27,0,30,3
1650013026424,MATH 18,B01,083748,Staff,0,8,30,30
1650013026424,MATH 18,B02,083749,Staff,0,6,30,30
1650013026424,MATH 18,B03,083750,Staff,0,6,30,30
1650013026424,MATH 18,B04,083751,Staff,1,7,30,29
1650013032453,MATH 20A,A01,083754,Staff,27,0,40,13
1650013038477,MATH 20B,A01,083756,Staff,0,4,30,30
1650013038477,MATH 20B,A02,083757,Staff,5,0,30,25
1650013044500,MATH 20C,A01,083760,Staff,0,9,30,30
1650013044500,MATH 20C,A02,083761,Staff,0,10,30,30
1650013044500,MATH 20C,B01,083762,Staff,17,0,30,13
1650013044500,MATH 20C,B02,083763,Staff,29,0,30,1
1650013050532,MATH 20D,A01,083765,Staff,0,2,30,30
1650013050532,MATH 20D,A02,083766,Staff,16,0,30,14
1650013050532,MATH 20D,A03,083767,Staff,28,0,30,2
1650013056562,MATH 20E,A01,083771,Staff,11,0,30,19
1650013056562,MATH 20E,A02,083772,Staff,20,0,30,10
1650013056562,MATH 20E,B01,083773,Staff,0,1,30,30
1650013056562,MATH 20E,B02,083774,Staff,21,0,30,9
1650013062586,MATH 103A,A01,083777,Staff,0,6,30,30
1650013062586,MATH 103A,A02,083778,Staff,0,7,30,30
1650013062586,MATH 103A,B01,083779,Staff,0,6,30,30
1650013062586,MATH 103A,B02,083780,Staff,0,6,30,30
1650013068615,MATH 105,A01,085443,Staff,0,11,30,30
1650013074644,MATH 109,A01,083213,Anzaldo; Leesa B,0,3,30,30
1650013074644,MATH 109,A02,083214,Anzaldo; Leesa B,0,3,30,30
1650013074644,MATH 109,B01,083215,Anzaldo; Leesa B,0,2,30,30
1650013074644,MATH 109,B02,083216,Anzaldo; Leesa B,0,2,30,30
1650013080684,MATH 142A,A01,083219,Chow; Bennett,0,7,30,30
1650013080684,MATH 142A,A02,083220,Chow; Bennett,0,7,30,30
1650013080684,MATH 142A,B01,083221,Chow; Bennett,0,8,30,30
1650013080684,MATH 142A,B02,083222,Chow; Bennett,0,7,30,30
1650013086713,MATH 193A,A01,083224,Staff,0,5,30,30
1650013086713,MATH 193A,A02,083225,Staff,0,4,30,30
1650013086713,MATH 193A,A03,083781,Staff,0,0,30,30
1650013086713,MATH 193A,A04,083782,Staff,9,0,30,21
1650013092737,MATH 197,001,091859,McAuley; Julian John,9999,0,9999,0
1650013098793,COGS 9,A01,083615,Staff,1,15,60,59
1650013104816,COGS 11,A01,083617,Boyle; Mary E. T.,25,0,40,15
1650013110849,COGS 13,A01,083071,Staff,0,28,40,40
1650013116873,COGS 14A,A01,092681,Staff,0,6,100,100
1650013122902,COGS 14B,A01,083073,Cheng; Tzu-Han,0,2,50,50
1650013128927,COGS 17,A01,092677,Staff,35,0,75,40
1650013134955,COGS 100,A01,083619,Staff,0,18,60,60
1650013140977,COGS 101A,A01,083621,Davis; Joshua Daniel,0,16,60,60
1650013147012,COGS 101B,A01,091572,Staff,16,0,60,44
1650013153038,COGS 101C,A01,083625,Delgado; Tania,21,0,30,9
1650013159063,COGS 107A,A01,083627,Boyle; Mary E. T.,0,1,60,60
1650013165085,COGS 118A,A01,083075,Staff,19,0,60,41
1650013171110,CSE 3,A50,083646,Miranda; Gregory Joseph,22,0,38,16
1650013171110,CSE 3,A51,083647,Miranda; Gregory Joseph,37,0,37,0
1650013177141,CSE 8A,A50,083650,Miranda; Gregory Joseph,0,14,40,40
1650013183253,CSE 11,A01,083080,Cao; Yingjun,0,60,40,40
1650013189276,CSE 12,A01,083652,Staff,2,0,100,98
1650013195304,CSE 15L,A01,083654,Staff,0,0,50,50
1650013195304,CSE 15L,A02,083655,Staff,15,0,50,35
1650013201327,CSE 20,A01,083657,Staff,57,0,80,23
1650013207351,CSE 30,A01,083084,Eldon; John,0,62,40,40
1650013213376,CSE 100,A01,083659,Cao; Yingjun,0,57,50,50
1650013219405,CSE 134B,A01,083661,Powell; Thomas Allan,0,24,65,65
1650013225432,CSE 140,A01,083663,Staff,8,0,75,67
1650013231456,CSE 140L,A01,083088,Eldon; John,4,0,75,71
1650013237482,CSE 175,A01,083665,Kumar; Rakesh,10,0,25,15
1650013243505,CSE 190,A00,092507,Dubnov; Shlomo,17,0,20,3
1650013249529,ECE 45,A01,083139,Staff,0,10,40,40
1650013255552,ECE 65,A50,083695,Staff,0,1,30,30
1650013261579,ECE 109,A01,091882,Touri; Behrouz,48,0,70,22
1650013267602,ECE 180,A00,083140,Abi Samra; Nicholas Camill,26,0,30,4
1650013267602,ECE 180,B00,083141,Abi Samra; Nicholas Camill,10,0,30,20
1650013273633,MATH 10A,A01,083735,Patchell; Gregory David,14,0,30,16
1650013273633,MATH 10A,A02,083736,Patchell; Gregory David,28,0,30,2
1650013273633,MATH 10A,A03,083737,Patchell; Gregory David,27,0,30,3
1650013279664,MATH 10B,A01,083207,Staff,0,4,30,30
1650013279664,MATH 10B,A02,083208,Staff,0,0,30,30
1650013279664,MATH 10B,B01,083739,Staff,20,0,30,10
1650013279664,MATH 10B,B02,083740,Staff,30,0,30,0
1650013285697,MATH 18,A01,083743,Staff,10,0,30,20
1650013285697,MATH 18,A02,083744,Staff,28,0,30,2
1650013285697,MATH 18,A03,083745,Staff,23,0,30,7
1650013285697,MATH 18,A04,083746,Staff,27,0,30,3
1650013285697,MATH 18,B01,083748,Staff,0,8,30,30
1650013285697,MATH 18,B02,083749,Staff,0,6,30,30
1650013285697,MATH 18,B03,083750,Staff,0,6,30,30
1650013285697,MATH 18,B04,083751,Staff,1,7,30,29
1650013291724,MATH 20A,A01,083754,Staff,27,0,40,13
1650013297749,MATH 20B,A01,083756,Staff,0,4,30,30
1650013297749,MATH 20B,A02,083757,Staff,5,0,30,25
1650013303773,MATH 20C,A01,083760,Staff,0,9,30,30
1650013303773,MATH 20C,A02,083761,Staff,0,10,30,30
1650013303773,MATH 20C,B01,083762,Staff,17,0,30,13
1650013303773,MATH 20C,B02,083763,Staff,29,0,30,1
1650013309798,MATH 20D,A01,083765,Staff,0,2,30,30
1650013309798,MATH 20D,A02,083766,Staff,16,0,30,14
1650013309798,MATH 20D,A03,083767,Staff,28,0,30,2
1650013315827,MATH 20E,A01,083771,Staff,11,0,30,19
1650013315827,MATH 20E,A02,083772,Staff,20,0,30,10
1650013315827,MATH 20E,B01,083773,Staff,0,1,30,30
1650013315827,MATH 20E,B02,083774,Staff,21,0,30,9
1650013321859,MATH 103A,A01,083777,Staff,0,6,30,30
1650013321859,MATH 103A,A02,083778,Staff,0,7,30,30
1650013321859,MATH 103A,B01,083779,Staff,0,6,30,30
1650013321859,MATH 103A,B02,083780,Staff,0,6,30,30
1650013327883,MATH 105,A01,085443,Staff,0,11,30,30
1650013333909,MATH 109,A01,083213,Anzaldo; Leesa B,0,3,30,30
1650013333909,MATH 109,A02,083214,Anzaldo; Leesa B,0,3,30,30
1650013333909,MATH 109,B01,083215,Anzaldo; Leesa B,0,2,30,30
1650013333909,MATH 109,B02,083216,Anzaldo; Leesa B,0,2,30,30
1650013339934,MATH 142A,A01,083219,Chow; Bennett,0,7,30,30
1650013339934,MATH 142A,A02,083220,Chow; Bennett,0,7,30,30
1650013339934,MATH 142A,B01,083221,Chow; Bennett,0,8,30,30
1650013339934,MATH 142A,B02,083222,Chow; Bennett,0,7,30,30
1650013345958,MATH 193A,A01,083224,Staff,0,5,30,30
1650013345958,MATH 193A,A02,083225,Staff,0,4,30,30
1650013345958,MATH 193A,A03,083781,Staff,0,0,30,30
1650013345958,MATH 193A,A04,083782,Staff,9,0,30,21
1650013351982,MATH 197,001,091859,McAuley; Julian John,9999,0,9999,0
1650013358049,COGS 9,A01,083615,Staff,1,15,60,59
1650013364074,COGS 11,A01,083617,Boyle; Mary E. T.,25,0,40,15
1650013370105,COGS 13,A01,083071,Staff,0,28,40,40
1650013376132,COGS 14A,A01,092681,Staff,0,6,100,100
1650013382160,COGS 14B,A01,083073,Cheng; Tzu-Han,0,2,50,50
1650013388184,COGS 17,A01,092677,Staff,35,0,75,40
1650013394208,COGS 100,A01,083619,Staff,0,18,60,60
1650013400231,COGS 101A,A01,083621,Davis; Joshua Daniel,0,16,60,60
1650013406255,COGS 101B,A01,091572,Staff,16,0,60,44
1650013412284,COGS 101C,A01,083625,Delgado; Tania,21,0,30,9
1650013418311,COGS 107A,A01,083627,Boyle; Mary E. T.,0,1,60,60
1650013424332,COGS 118A,A01,083075,Staff,19,0,60,41
1650013430361,CSE 3,A50,083646,Miranda; Gregory Joseph,22,0,38,16
1650013430361,CSE 3,A51,083647,Miranda; Gregory Joseph,37,0,37,0
1650013436385,CSE 8A,A50,083650,Miranda; Gregory Joseph,0,14,40,40
1650013442413,CSE 11,A01,083080,Cao; Yingjun,0,60,40,40
1650013448441,CSE 12,A01,083652,Staff,2,0,100,98
1650013454468,CSE 15L,A01,083654,Staff,0,0,50,50
1650013454468,CSE 15L,A02,083655,Staff,15,0,50,35
1650013460492,CSE 20,A01,083657,Staff,57,0,80,23
1650013466520,CSE 30,A01,083084,Eldon; John,0,62,40,40
1650013472548,CSE 100,A01,083659,Cao; Yingjun,0,57,50,50
1650013478574,CSE 134B,A01,083661,Powell; Thomas Allan,0,24,65,65
1650013484600,CSE 140,A01,083663,Staff,8,0,75,67
1650013490624,CSE 140L,A01,083088,Eldon; John,4,0,75,71
1650013496647,CSE 175,A01,083665,Kumar; Rakesh,10,0,25,15
1650013502671,CSE 190,A00,092507,Dubnov; Shlomo,17,0,20,3
1650013508697,ECE 45,A01,083139,Staff,0,10,40,40
1650013514721,ECE 65,A50,083695,Staff,0,1,30,30
1650013520746,ECE 109,A01,091882,Touri; Behrouz,48,0,70,22
1650013526774,ECE 180,A00,083140,Abi Samra; Nicholas Camill,26,0,30,4
1650013526774,ECE 180,B00,083141,Abi Samra; Nicholas Camill,10,0,30,20
1650013532800,MATH 10A,A01,083735,Patchell; Gregory David,14,0,30,16
1650013532800,MATH 10A,A02,083736,Patchell; Gregory David,28,0,30,2
1650013532800,MATH 10A,A03,083737,Patchell; Gregory David,27,0,30,3
1650013538839,MATH 10B,A01,083207,Staff,0,4,30,30
1650013538839,MATH 10B,A02,083208,Staff,0,0,30,30
1650013538839,MATH 10B,B01,083739,Staff,20,0,30,10
1650013538839,MATH 10B,B02,083740,Staff,30,0,30,0
1650013544864,MATH 18,A01,083743,Staff,10,0,30,20
1650013544864,MATH 18,A02,083744,Staff,28,0,30,2
1650013544864,MATH 18,A03,083745,Staff,23,0,30,7
1650013544864,MATH 18,A04,083746,Staff,27,0,30,3
1650013544864,MATH 18,B01,083748,Staff,0,8,30,30
1650013544864,MATH 18,B02,083749,Staff,0,6,30,30
1650013544864,MATH 18,B03,083750,Staff,0,6,30,30
1650013544864,MATH 18,B04,083751,Staff,1,7,30,29
1650013550892,MATH 20A,A01,083754,Staff,27,0,40,13
1650013556918,MATH 20B,A01,083756,Staff,0,4,30,30
1650013556918,MATH 20B,A02,083757,Staff,5,0,30,25
1650013562943,MATH 20C,A01,083760,Staff,0,9,30,30
1650013562943,MATH 20C,A02,083761,Staff,0,10,30,30
1650013562943,MATH 20C,B01,083762,Staff,17,0,30,13
1650013562943,MATH 20C,B02,083763,Staff,29,0,30,1
1650013568972,MATH 20D,A01,083765,Staff,0,2,30,30
1650013568972,MATH 20D,A02,083766,Staff,16,0,30,14
1650013568972,MATH 20D,A03,083767,Staff,28,0,30,2
1650013574997,MATH 20E,A01,083771,Staff,11,0,30,19
1650013574997,MATH 20E,A02,083772,Staff,20,0,30,10
1650013574997,MATH 20E,B01,083773,Staff,0,1,30,30
1650013574997,MATH 20E,B02,083774,Staff,21,0,30,9
1650013581026,MATH 103A,A01,083777,Staff,0,6,30,30
1650013581026,MATH 103A,A02,083778,Staff,0,7,30,30
1650013581026,MATH 103A,B01,083779,Staff,0,6,30,30
1650013581026,MATH 103A,B02,083780,Staff,0,6,30,30
1650013587056,MATH 105,A01,085443,Staff,0,11,30,30
1650013593080,MATH 109,A01,083213,Anzaldo; Leesa B,0,3,30,30
1650013593080,MATH 109,A02,083214,Anzaldo; Leesa B,0,3,30,30
1650013593080,MATH 109,B01,083215,Anzaldo; Leesa B,0,2,30,30
1650013593080,MATH 109,B02,083216,Anzaldo; Leesa B,0,2,30,30
1650013599110,MATH 142A,A01,083219,Chow; Bennett,0,7,30,30
1650013599110,MATH 142A,A02,083220,Chow; Bennett,0,7,30,30
1650013599110,MATH 142A,B01,083221,Chow; Bennett,0,8,30,30
1650013599110,MATH 142A,B02,083222,Chow; Bennett,0,7,30,30
1650013605140,MATH 193A,A01,083224,Staff,0,5,30,30
1650013605140,MATH 193A,A02,083225,Staff,0,4,30,30
1650013605140,MATH 193A,A03,083781,Staff,0,0,30,30
1650013605140,MATH 193A,A04,083782,Staff,9,0,30,21
1650013611167,MATH 197,001,091859,McAuley; Julian John,9999,0,9999,0
1650013617242,COGS 9,A01,083615,Staff,1,15,60,59
1650013623266,COGS 11,A01,083617,Boyle; Mary E. T.,25,0,40,15
1650013629295,COGS 13,A01,083071,Staff,0,28,40,40
1650013635321,COGS 14A,A01,092681,Staff,0,6,100,100
1650013641356,COGS 14B,A01,083073,Cheng; Tzu-Han,0,2,50,50
1650013647379,COGS 17,A01,092677,Staff,35,0,75,40
1650013653409,COGS 100,A01,083619,Staff,0,18,60,60
1650013659436,COGS 101A,A01,083621,Davis; Joshua Daniel,0,16,60,60
1650013665461,COGS 101B,A01,091572,Staff,16,0,60,44
1650013671490,COGS 101C,A01,083625,Delgado; Tania,21,0,30,9
1650013677519,COGS 107A,A01,083627,Boyle; Mary E. T.,0,1,60,60
1650013683554,COGS 118A,A01,083075,Staff,19,0,60,41
1650013689581,CSE 3,A50,083646,Miranda; Gregory Joseph,22,0,38,16
1650013689581,CSE 3,A51,083647,Miranda; Gregory Joseph,37,0,37,0
1650013695609,CSE 8A,A50,083650,Miranda; Gregory Joseph,0,14,40,40
1650013701636,CSE 11,A01,083080,Cao; Yingjun,0,60,40,40
1650013707661,CSE 12,A01,083652,Staff,2,0,100,98
1650013713684,CSE 15L,A01,083654,Staff,0,0,50,50
1650013713684,CSE 15L,A02,083655,Staff,15,0,50,35
1650013719709,CSE 20,A01,083657,Staff,57,0,80,23
1650013725735,CSE 30,A01,083084,Eldon; John,0,62,40,40
1650013731762,CSE 100,A01,083659,Cao; Yingjun,0,57,50,50
1650013737792,CSE 134B,A01,083661,Powell; Thomas Allan,0,24,65,65
1650013743822,CSE 140,A01,083663,Staff,8,0,75,67
1650013749848,CSE 140L,A01,083088,Eldon; John,4,0,75,71
1650013755877,CSE 175,A01,083665,Kumar; Rakesh,10,0,25,15
1650013761912,CSE 190,A00,092507,Dubnov; Shlomo,17,0,20,3
1650013767937,ECE 45,A01,083139,Staff,0,10,40,40
1650013773967,ECE 65,A50,083695,Staff,0,1,30,30
1650013780082,ECE 109,A01,091882,Touri; Behrouz,48,0,70,22
1650013786107,ECE 180,A00,083140,Abi Samra; Nicholas Camill,26,0,30,4
1650013786107,ECE 180,B00,083141,Abi Samra; Nicholas Camill,10,0,30,20
1650013792140,MATH 10A,A01,083735,Patchell; Gregory David,14,0,30,16
1650013792140,MATH 10A,A02,083736,Patchell; Gregory David,28,0,30,2
1650013792140,MATH 10A,A03,083737,Patchell; Gregory David,27,0,30,3
1650013798165,MATH 10B,A01,083207,Staff,0,4,30,30
1650013798165,MATH 10B,A02,083208,Staff,0,0,30,30
1650013798165,MATH 10B,B01,083739,Staff,20,0,30,10
1650013798165,MATH 10B,B02,083740,Staff,30,0,30,0
1650013804194,MATH 18,A01,083743,Staff,10,0,30,20
1650013804194,MATH 18,A02,083744,Staff,28,0,30,2
1650013804194,MATH 18,A03,083745,Staff,23,0,30,7
1650013804194,MATH 18,A04,083746,Staff,27,0,30,3
1650013804194,MATH 18,B01,083748,Staff,0,8,30,30
1650013804194,MATH 18,B02,083749,Staff,0,6,30,30
1650013804194,MATH 18,B03,083750,Staff,0,6,30,30
1650013804194,MATH 18,B04,083751,Staff,1,7,30,29
1650013810224,MATH 20A,A01,083754,Staff,27,0,40,13
1650013816256,MATH 20B,A01,083756,Staff,0,4,30,30
1650013816256,MATH 20B,A02,083757,Staff,5,0,30,25
1650013822281,MATH 20C,A01,083760,Staff,0,9,30,30
1650013822281,MATH 20C,A02,083761,Staff,0,10,30,30
1650013822281,MATH 20C,B01,083762,Staff,17,0,30,13
1650013822281,MATH 20C,B02,083763,Staff,29,0,30,1
1650013828312,MATH 20D,A01,083765,Staff,0,2,30,30
1650013828312,MATH 20D,A02,083766,Staff,16,0,30,14
1650013828312,MATH 20D,A03,083767,Staff,28,0,30,2
1650013834337,MATH 20E,A01,083771,Staff,11,0,30,19
1650013834337,MATH 20E,A02,083772,Staff,20,0,30,10
1650013834337,MATH 20E,B01,083773,Staff,0,1,30,30
1650013834337,MATH 20E,B02,083774,Staff,21,0,30,9
1650013840363,MATH 103A,A01,083777,Staff,0,6,30,30
1650013840363,MATH 103A,A02,083778,Staff,0,7,30,30
1650013840363,MATH 103A,B01,083779,Staff,0,6,30,30
1650013840363,MATH 103A,B02,083780,Staff,0,6,30,30
1650013846391,MATH 105,A01,085443,Staff,0,11,30,30
1650013852417,MATH 109,A01,083213,Anzaldo; Leesa B,0,3,30,30
1650013852417,MATH 109,A02,083214,Anzaldo; Leesa B,0,3,30,30
1650013852417,MATH 109,B01,083215,Anzaldo; Leesa B,0,2,30,30
1650013852417,MATH 109,B02,083216,Anzaldo; Leesa B,0,2,30,30
1650013858442,MATH 142A,A01,083219,Chow; Bennett,0,7,30,30
1650013858442,MATH 142A,A02,083220,Chow; Bennett,0,7,30,30
1650013858442,MATH 142A,B01,083221,Chow; Bennett,0,8,30,30
1650013858442,MATH 142A,B02,083222,Chow; Bennett,0,7,30,30
1650013864466,MATH 193A,A01,083224,Staff,0,5,30,30
1650013864466,MATH 193A,A02,083225,Staff,0,4,30,30
1650013864466,MATH 193A,A03,083781,Staff,0,0,30,30
1650013864466,MATH 193A,A04,083782,Staff,9,0,30,21
1650013870490,MATH 197,001,091859,McAuley; Julian John,9999,0,9999,0
1650013876568,COGS 9,A01,083615,Staff,1,15,60,59
1650013882612,COGS 11,A01,083617,Boyle; Mary E. T.,25,0,40,15
1650013888636,COGS 13,A01,083071,Staff,0,28,40,40
1650013894663,COGS 14A,A01,092681,Staff,0,6,100,100
1650013900698,COGS 14B,A01,083073,Cheng; Tzu-Han,0,2,50,50
1650013906721,COGS 17,A01,092677,Staff,35,0,75,40
1650013912744,COGS 100,A01,083619,Staff,0,18,60,60
1650013918769,COGS 101A,A01,083621,Davis; Joshua Daniel,0,16,60,60
1650013924794,COGS 101B,A01,091572,Staff,16,0,60,44
1650013930820,COGS 101C,A01,083625,Delgado; Tania,21,0,30,9
1650013936850,COGS 107A,A01,083627,Boyle; Mary E. T.,0,1,60,60
1650013942875,COGS 118A,A01,083075,Staff,19,0,60,41
1650013948902,CSE 3,A50,083646,Miranda; Gregory Joseph,22,0,38,16
1650013948902,CSE 3,A51,083647,Miranda; Gregory Joseph,37,0,37,0
1650013954929,CSE 8A,A50,083650,Miranda; Gregory Joseph,0,14,40,40
1650013960954,CSE 11,A01,083080,Cao; Yingjun,0,60,40,40
1650013966980,CSE 12,A01,083652,Staff,2,0,100,98
1650013973012,CSE 15L,A01,083654,Staff,0,0,50,50
1650013973012,CSE 15L,A02,083655,Staff,15,0,50,35
1650013979035,CSE 20,A01,083657,Staff,57,0,80,23
1650013985059,CSE 30,A01,083084,Eldon; John,0,62,40,40
1650013991085,CSE 100,A01,083659,Cao; Yingjun,0,57,50,50
1650013997120,CSE 134B,A01,083661,Powell; Thomas Allan,0,24,65,65
1650014003144,CSE 140,A01,083663,Staff,8,0,75,67
1650014009172,CSE 140L,A01,083088,Eldon; John,4,0,75,71
1650014015195,CSE 175,A01,083665,Kumar; Rakesh,10,0,25,15
1650014021226,CSE 190,A00,092507,Dubnov; Shlomo,17,0,20,3
1650014027250,ECE 45,A01,083139,Staff,0,10,40,40
1650014033278,ECE 65,A50,083695,Staff,0,1,30,30
1650014039306,ECE 109,A01,091882,Touri; Behrouz,48,0,70,22
1650014045331,ECE 180,A00,083140,Abi Samra; Nicholas Camill,26,0,30,4
1650014045331,ECE 180,B00,083141,Abi Samra; Nicholas Camill,10,0,30,20
1650014051369,MATH 10A,A01,083735,Patchell; Gregory David,14,0,30,16
1650014051369,MATH 10A,A02,083736,Patchell; Gregory David,28,0,30,2
1650014051369,MATH 10A,A03,083737,Patchell; Gregory David,27,0,30,3
1650014057401,MATH 10B,A01,083207,Staff,0,4,30,30
1650014057401,MATH 10B,A02,083208,Staff,0,0,30,30
1650014057401,MATH 10B,B01,083739,Staff,20,0,30,10
1650014057401,MATH 10B,B02,083740,Staff,30,0,30,0
1650014063433,MATH 18,A01,083743,Staff,10,0,30,20
1650014063433,MATH 18,A02,083744,Staff,28,0,30,2
1650014063433,MATH 18,A03,083745,Staff,23,0,30,7
1650014063433,MATH 18,A04,083746,Staff,27,0,30,3
1650014063433,MATH 18,B01,083748,Staff,0,8,30,30
1650014063433,MATH 18,B02,083749,Staff,0,6,30,30
1650014063433,MATH 18,B03,083750,Staff,0,6,30,30
1650014063433,MATH 18,B04,083751,Staff,1,7,30,29
1650014069460,MATH 20A,A01,083754,Staff,27,0,40,13
1650014075491,MATH 20B,A01,083756,Staff,0,4,30,30
1650014075491,MATH 20B,A02,083757,Staff,5,0,30,25
1650014081517,MATH 20C,A01,083760,Staff,0,9,30,30
1650014081517,MATH 20C,A02,083761,Staff,0,10,30,30
1650014081517,MATH 20C,B01,083762,Staff,17,0,30,13
1650014081517,MATH 20C,B02,083763,Staff,28,0,30,2
1650014087542,MATH 20D,A01,083765,Staff,0,2,30,30
1650014087542,MATH 20D,A02,083766,Staff,16,0,30,14
1650014087542,MATH 20D,A03,083767,Staff,28,0,30,2
1650014093569,MATH 20E,A01,083771,Staff,11,0,30,19
1650014093569,MATH 20E,A02,083772,Staff,20,0,30,10
1650014093569,MATH 20E,B01,083773,Staff,0,1,30,30
1650014093569,MATH 20E,B02,083774,Staff,21,0,30,9
1650014099603,MATH 103A,A01,083777,Staff,0,6,30,30
1650014099603,MATH 103A,A02,083778,Staff,0,7,30,30
1650014099603,MATH 103A,B01,083779,Staff,0,6,30,30
1650014099603,MATH 103A,B02,083780,Staff,0,6,30,30
1650014105627,MATH 105,A01,085443,Staff,0,11,30,30
1650014111658,MATH 109,A01,083213,Anzaldo; Leesa B,0,3,30,30
1650014111658,MATH 109,A02,083214,Anzaldo; Leesa B,0,3,30,30
1650014111658,MATH 109,B01,083215,Anzaldo; Leesa B,0,2,30,30
1650014111658,MATH 109,B02,083216,Anzaldo; Leesa B,0,2,30,30
1650014117685,MATH 142A,A01,083219,Chow; Bennett,0,7,30,30
1650014117685,MATH 142A,A02,083220,Chow; Bennett,0,7,30,30
1650014117685,MATH 142A,B01,083221,Chow; Bennett,0,8,30,30
1650014117685,MATH 142A,B02,083222,Chow; Bennett,0,7,30,30
1650014123708,MATH 193A,A01,083224,Staff,0,5,30,30
1650014123708,MATH 193A,A02,083225,Staff,0,4,30,30
1650014123708,MATH 193A,A03,083781,Staff,0,0,30,30
1650014123708,MATH 193A,A04,083782,Staff,9,0,30,21
1650014129734,MATH 197,001,091859,McAuley; Julian John,9999,0,9999,0
1650014135808,COGS 9,A01,083615,Staff,1,15,60,59
1650014141834,COGS 11,A01,083617,Boyle; Mary E. T.,25,0,40,15
1650014147859,COGS 13,A01,083071,Staff,0,28,40,40
1650014153899,COGS 14A,A01,092681,Staff,0,6,100,100
1650014159922,COGS 14B,A01,083073,Cheng; Tzu-Han,0,2,50,50
1650014165973,COGS 17,A01,092677,Staff,35,0,75,40
1650014171997,COGS 100,A01,083619,Staff,0,18,60,60
1650014178029,COGS 101A,A01,083621,Davis; Joshua Daniel,0,16,60,60
1650014184066,COGS 101B,A01,091572,Staff,16,0,60,44
1650014190098,COGS 101C,A01,083625,Delgado; Tania,21,0,30,9
1650014196126,COGS 107A,A01,083627,Boyle; Mary E. T.,0,1,60,60
1650014202148,COGS 118A,A01,083075,Staff,19,0,60,41
1650014208174,CSE 3,A50,083646,Miranda; Gregory Joseph,22,0,38,16
1650014208174,CSE 3,A51,083647,Miranda; Gregory Joseph,37,0,37,0
1650014214198,CSE 8A,A50,083650,Miranda; Gregory Joseph,0,14,40,40
1650014220246,CSE 11,A01,083080,Cao; Yingjun,0,60,40,40
1650014226274,CSE 12,A01,083652,Staff,2,0,100,98
1650014232300,CSE 15L,A01,083654,Staff,0,0,50,50
1650014232300,CSE 15L,A02,083655,Staff,15,0,50,35
1650014238325,CSE 20,A01,083657,Staff,57,0,80,23
1650014244356,CSE 30,A01,083084,Eldon; John,0,62,40,40
1650014250386,CSE 100,A01,083659,Cao; Yingjun,0,57,50,50
1650014256417,CSE 134B,A01,083661,Powell; Thomas Allan,0,24,65,65
1650014262447,CSE 140,A01,083663,Staff,8,0,75,67
1650014268478,CSE 140L,A01,083088,Eldon; John,4,0,75,71
1650014274502,CSE 175,A01,083665,Kumar; Rakesh,10,0,25,15
1650014280527,CSE 190,A00,092507,Dubnov; Shlomo,17,0,20,3
1650014286556,ECE 45,A01,083139,Staff,0,10,40,40
1650014292581,ECE 65,A50,083695,Staff,0,1,30,30
1650014298611,ECE 109,A01,091882,Touri; Behrouz,48,0,70,22
1650014304639,ECE 180,A00,083140,Abi Samra; Nicholas Camill,26,0,30,4
1650014304639,ECE 180,B00,083141,Abi Samra; Nicholas Camill,10,0,30,20
1650014310681,MATH 10A,A01,083735,Patchell; Gregory David,14,0,30,16
1650014310681,MATH 10A,A02,083736,Patchell; Gregory David,28,0,30,2
1650014310681,MATH 10A,A03,083737,Patchell; Gregory David,27,0,30,3
1650014316707,MATH 10B,A01,083207,Staff,0,4,30,30
1650014316707,MATH 10B,A02,083208,Staff,0,0,30,30
1650014316707,MATH 10B,B01,083739,Staff,20,0,30,10
1650014316707,MATH 10B,B02,083740,Staff,30,0,30,0
1650014322753,MATH 18,A01,083743,Staff,10,0,30,20
1650014322753,MATH 18,A02,083744,Staff,28,0,30,2
1650014322753,MATH 18,A03,083745,Staff,23,0,30,7
1650014322753,MATH 18,A04,083746,Staff,27,0,30,3
1650014322753,MATH 18,B01,083748,Staff,0,8,30,30
1650014322753,MATH 18,B02,083749,Staff,0,6,30,30
1650014322753,MATH 18,B03,083750,Staff,0,6,30,30
1650014322753,MATH 18,B04,083751,Staff,1,7,30,29
1650014328776,MATH 20A,A01,083754,Staff,27,0,40,13
1650014334803,MATH 20B,A01,083756,Staff,0,4,30,30
1650014334803,MATH 20B,A02,083757,Staff,5,0,30,25
1650014340828,MATH 20C,A01,083760,Staff,0,9,30,30
1650014340828,MATH 20C,A02,083761,Staff,0,10,30,30
1650014340828,MATH 20C,B01,083762,Staff,17,0,30,13
1650014340828,MATH 20C,B02,083763,Staff,28,0,30,2
1650014346853,MATH 20D,A01,083765,Staff,0,2,30,30
1650014346853,MATH 20D,A02,083766,Staff,16,0,30,14
1650014346853,MATH 20D,A03,083767,Staff,28,0,30,2
1650014352885,MATH 20E,A01,083771,Staff,11,0,30,19
1650014352885,MATH 20E,A02,083772,Staff,20,0,30,10
1650014352885,MATH 20E,B01,083773,Staff,0,1,30,30
1650014352885,MATH 20E,B02,083774,Staff,21,0,30,9
1650014358910,MATH 103A,A01,083777,Staff,0,6,30,30
1650014358910,MATH 103A,A02,083778,Staff,0,7,30,30
1650014358910,MATH 103A,B01,083779,Staff,0,6,30,30
1650014358910,MATH 103A,B02,083780,Staff,0,6,30,30
1650014364936,MATH 105,A01,085443,Staff,0,11,30,30
1650014371050,MATH 109,A01,083213,Anzaldo; Leesa B,0,3,30,30
1650014371050,MATH 109,A02,083214,Anzaldo; Leesa B,0,3,30,30
1650014371050,MATH 109,B01,083215,Anzaldo; Leesa B,0,2,30,30
1650014371050,MATH 109,B02,083216,Anzaldo; Leesa B,0,2,30,30
1650014377083,MATH 142A,A01,083219,Chow; Bennett,0,7,30,30
1650014377083,MATH 142A,A02,083220,Chow; Bennett,0,7,30,30
1650014377083,MATH 142A,B01,083221,Chow; Bennett,0,8,30,30
1650014377083,MATH 142A,B02,083222,Chow; Bennett,0,7,30,30
1650014383111,MATH 193A,A01,083224,Staff,0,5,30,30
1650014383111,MATH 193A,A02,083225,Staff,0,4,30,30
1650014383111,MATH 193A,A03,083781,Staff,0,0,30,30
1650014383111,MATH 193A,A04,083782,Staff,9,0,30,21
1650014389136,MATH 197,001,091859,McAuley; Julian John,9999,0,9999,0
1650014395193,COGS 9,A01,083615,Staff,1,15,60,59
1650014401223,COGS 11,A01,083617,Boyle; Mary E. T.,25,0,40,15
1650014407252,COGS 13,A01,083071,Staff,0,28,40,40
1650014413274,COGS 14A,A01,092681,Staff,0,6,100,100
1650014419299,COGS 14B,A01,083073,Cheng; Tzu-Han,0,2,50,50
1650014425329,COGS 17,A01,092677,Staff,35,0,75,40
1650014431357,COGS 100,A01,083619,Staff,0,18,60,60
1650014437380,COGS 101A,A01,083621,Davis; Joshua Daniel,0,16,60,60
1650014443405,COGS 101B,A01,091572,Staff,16,0,60,44
1650014449436,COGS 101C,A01,083625,Delgado; Tania,21,0,30,9
1650014455465,COGS 107A,A01,083627,Boyle; Mary E. T.,0,1,60,60
1650014461499,COGS 118A,A01,083075,Staff,19,0,60,41
1650014467531,CSE 3,A50,083646,Miranda; Gregory Joseph,22,0,38,16
1650014467531,CSE 3,A51,083647,Miranda; Gregory Joseph,37,0,37,0
1650014473561,CSE 8A,A50,083650,Miranda; Gregory Joseph,0,14,40,40
1650014479585,CSE 11,A01,083080,Cao; Yingjun,0,60,40,40
1650014485613,CSE 12,A01,083652,Staff,2,0,100,98
1650014491638,CSE 15L,A01,083654,Staff,0,0,50,50
1650014491638,CSE 15L,A02,083655,Staff,15,0,50,35
1650014497661,CSE 20,A01,083657,Staff,57,0,80,23
1650014503684,CSE 30,A01,083084,Eldon; John,0,62,40,40
1650014509710,CSE 100,A01,083659,Cao; Yingjun,0,57,50,50
1650014515743,CSE 134B,A01,083661,Powell; Thomas Allan,0,24,65,65
1650014521774,CSE 140,A01,083663,Staff,8,0,75,67
1650014527800,CSE 140L,A01,083088,Eldon; John,4,0,75,71
1650014533848,CSE 175,A01,083665,Kumar; Rakesh,10,0,25,15
1650014539876,CSE 190,A00,092507,Dubnov; Shlomo,17,0,20,3
1650014545904,ECE 45,A01,083139,Staff,0,10,40,40
1650014551929,ECE 65,A50,083695,Staff,0,1,30,30
1650014557955,ECE 109,A01,091882,Touri; Behrouz,48,0,70,22
1650014563981,ECE 180,A00,083140,Abi Samra; Nicholas Camill,26,0,30,4
1650014563981,ECE 180,B00,083141,Abi Samra; Nicholas Camill,10,0,30,20
1650014570008,MATH 10A,A01,083735,Patchell; Gregory David,14,0,30,16
1650014570008,MATH 10A,A02,083736,Patchell; Gregory David,28,0,30,2
1650014570008,MATH 10A,A03,083737,Patchell; Gregory David,27,0,30,3
1650014576041,MATH 10B,A01,083207,Staff,0,4,30,30
1650014576041,MATH 10B,A02,083208,Staff,0,0,30,30
1650014576041,MATH 10B,B01,083739,Staff,20,0,30,10
1650014576041,MATH 10B,B02,083740,Staff,30,0,30,0
1650014582077,MATH 18,A01,083743,Staff,10,0,30,20
1650014582077,MATH 18,A02,083744,Staff,28,0,30,2
1650014582077,MATH 18,A03,083745,Staff,23,0,30,7
1650014582077,MATH 18,A04,083746,Staff,27,0,30,3
1650014582077,MATH 18,B01,083748,Staff,0,8,30,30
1650014582077,MATH 18,B02,083749,Staff,0,6,30,30
1650014582077,MATH 18,B03,083750,Staff,0,6,30,30
1650014582077,MATH 18,B04,083751,Staff,1,7,30,29
1650014588102,MATH 20A,A01,083754,Staff,27,0,40,13
1650014594127,MATH 20B,A01,083756,Staff,0,4,30,30
1650014594127,MATH 20B,A02,083757,Staff,5,0,30,25
1650014600152,MATH 20C,A01,083760,Staff,0,9,30,30
1650014600152,MATH 20C,A02,083761,Staff,0,10,30,30
1650014600152,MATH 20C,B01,083762,Staff,17,0,30,13
1650014600152,MATH 20C,B02,083763,Staff,28,0,30,2
1650014606178,MATH 20D,A01,083765,Staff,0,2,30,30
1650014606178,MATH 20D,A02,083766,Staff,16,0,30,14
1650014606178,MATH 20D,A03,083767,Staff,28,0,30,2
1650014612208,MATH 20E,A01,083771,Staff,11,0,30,19
1650014612208,MATH 20E,A02,083772,Staff,20,0,30,10
1650014612208,MATH 20E,B01,083773,Staff,0,1,30,30
1650014612208,MATH 20E,B02,083774,Staff,21,0,30,9
1650014618239,MATH 103A,A01,083777,Staff,0,6,30,30
1650014618239,MATH 103A,A02,083778,Staff,0,7,30,30
1650014618239,MATH 103A,B01,083779,Staff,0,6,30,30
1650014618239,MATH 103A,B02,083780,Staff,0,6,30,30
1650014624265,MATH 105,A01,085443,Staff,0,11,30,30
1650014630290,MATH 109,A01,083213,Anzaldo; Leesa B,0,3,30,30
1650014630290,MATH 109,A02,083214,Anzaldo; Leesa B,0,3,30,30
1650014630290,MATH 109,B01,083215,Anzaldo; Leesa B,0,2,30,30
1650014630290,MATH 109,B02,083216,Anzaldo; Leesa B,0,2,30,30
1650014636318,MATH 142A,A01,083219,Chow; Bennett,0,7,30,30
1650014636318,MATH 142A,A02,083220,Chow; Bennett,0,7,30,30
1650014636318,MATH 142A,B01,083221,Chow; Bennett,0,8,30,30
1650014636318,MATH 142A,B02,083222,Chow; Bennett,0,7,30,30
1650014642346,MATH 193A,A01,083224,Staff,0,5,30,30
1650014642346,MATH 193A,A02,083225,Staff,0,4,30,30
1650014642346,MATH 193A,A03,083781,Staff,0,0,30,30
1650014642346,MATH 193A,A04,083782,Staff,9,0,30,21
1650014648375,MATH 197,001,091859,McAuley; Julian John,9999,0,9999,0
1650014654462,COGS 9,A01,083615,Staff,1,15,60,59
1650014660491,COGS 11,A01,083617,Boyle; Mary E. T.,25,0,40,15
1650014666514,COGS 13,A01,083071,Staff,0,28,40,40
1650014672539,COGS 14A,A01,092681,Staff,0,6,100,100
1650014678569,COGS 14B,A01,083073,Cheng; Tzu-Han,0,2,50,50
1650014684597,COGS 17,A01,092677,Staff,35,0,75,40
1650014690626,COGS 100,A01,083619,Staff,0,18,60,60
1650014696655,COGS 101A,A01,083621,Davis; Joshua Daniel,0,16,60,60
1650014702683,COGS 101B,A01,091572,Staff,16,0,60,44
1650014708708,COGS 101C,A01,083625,Delgado; Tania,21,0,30,9
1650014714735,COGS 107A,A01,083627,Boyle; Mary E. T.,0,1,60,60
1650014720763,COGS 118A,A01,083075,Staff,19,0,60,41
1650014726797,CSE 3,A50,083646,Miranda; Gregory Joseph,22,0,38,16
1650014726797,CSE 3,A51,083647,Miranda; Gregory Joseph,37,0,37,0
1650014732821,CSE 8A,A50,083650,Miranda; Gregory Joseph,0,14,40,40
1650014738853,CSE 11,A01,083080,Cao; Yingjun,0,60,40,40
1650014744883,CSE 12,A01,083652,Staff,2,0,100,98
1650014750911,CSE 15L,A01,083654,Staff,0,0,50,50
1650014750911,CSE 15L,A02,083655,Staff,15,0,50,35
1650014756937,CSE 20,A01,083657,Staff,57,0,80,23
1650014762961,CSE 30,A01,083084,Eldon; John,0,62,40,40
1650014768989,CSE 100,A01,083659,Cao; Yingjun,0,57,50,50
1650014775016,CSE 134B,A01,083661,Powell; Thomas Allan,0,24,65,65
1650014781038,CSE 140,A01,083663,Staff,8,0,75,67
1650014787081,CSE 140L,A01,083088,Eldon; John,4,0,75,71
1650014793112,CSE 175,A01,083665,Kumar; Rakesh,10,0,25,15
1650014799139,CSE 190,A00,092507,Dubnov; Shlomo,17,0,20,3
1650014805168,ECE 45,A01,083139,Staff,0,10,40,40
1650014811194,ECE 65,A50,083695,Staff,0,1,30,30
1650014817220,ECE 109,A01,091882,Touri; Behrouz,48,0,70,22
1650014823251,ECE 180,A00,083140,Abi Samra; Nicholas Camill,26,0,30,4
1650014823251,ECE 180,B00,083141,Abi Samra; Nicholas Camill,10,0,30,20
1650014829279,MATH 10A,A01,083735,Patchell; Gregory David,14,0,30,16
1650014829279,MATH 10A,A02,083736,Patchell; Gregory David,28,0,30,2
1650014829279,MATH 10A,A03,083737,Patchell; Gregory David,27,0,30,3
1650014835308,MATH 10B,A01,083207,Staff,0,4,30,30
1650014835308,MATH 10B,A02,083208,Staff,0,0,30,30
1650014835308,MATH 10B,B01,083739,Staff,20,0,30,10
1650014835308,MATH 10B,B02,083740,Staff,30,0,30,0
1650014841350,MATH 18,A01,083743,Staff,10,0,30,20
1650014841350,MATH 18,A02,083744,Staff,28,0,30,2
1650014841350,MATH 18,A03,083745,Staff,23,0,30,7
1650014841350,MATH 18,A04,083746,Staff,27,0,30,3
1650014841350,MATH 18,B01,083748,Staff,0,8,30,30
1650014841350,MATH 18,B02,083749,Staff,0,6,30,30
1650014841350,MATH 18,B03,083750,Staff,0,6,30,30
1650014841350,MATH 18,B04,083751,Staff,1,7,30,29
1650014847376,MATH 20A,A01,083754,Staff,27,0,40,13
1650014853408,MATH 20B,A01,083756,Staff,0,4,30,30
1650014853408,MATH 20B,A02,083757,Staff,5,0,30,25
1650014859443,MATH 20C,A01,083760,Staff,0,9,30,30
1650014859443,MATH 20C,A02,083761,Staff,0,10,30,30
1650014859443,MATH 20C,B01,083762,Staff,17,0,30,13
1650014859443,MATH 20C,B02,083763,Staff,28,0,30,2
1650014865477,MATH 20D,A01,083765,Staff,0,2,30,30
1650014865477,MATH 20D,A02,083766,Staff,16,0,30,14
1650014865477,MATH 20D,A03,083767,Staff,28,0,30,2
1650014871504,MATH 20E,A01,083771,Staff,11,0,30,19
1650014871504,MATH 20E,A02,083772,Staff,20,0,30,10
1650014871504,MATH 20E,B01,083773,Staff,0,1,30,30
1650014871504,MATH 20E,B02,083774,Staff,21,0,30,9
1650014877537,MATH 103A,A01,083777,Staff,0,6,30,30
1650014877537,MATH 103A,A02,083778,Staff,0,7,30,30
1650014877537,MATH 103A,B01,083779,Staff,0,6,30,30
1650014877537,MATH 103A,B02,083780,Staff,0,6,30,30
1650014883560,MATH 105,A01,085443,Staff,0,11,30,30
1650014889595,MATH 109,A01,083213,Anzaldo; Leesa B,0,3,30,30
1650014889595,MATH 109,A02,083214,Anzaldo; Leesa B,0,3,30,30
1650014889595,MATH 109,B01,083215,Anzaldo; Leesa B,0,2,30,30
1650014889595,MATH 109,B02,083216,Anzaldo; Leesa B,0,2,30,30
1650014895625,MATH 142A,A01,083219,Chow; Bennett,0,7,30,30
1650014895625,MATH 142A,A02,083220,Chow; Bennett,0,7,30,30
1650014895625,MATH 142A,B01,083221,Chow; Bennett,0,8,30,30
1650014895625,MATH 142A,B02,083222,Chow; Bennett,0,7,30,30
1650014901658,MATH 193A,A01,083224,Staff,0,5,30,30
1650014901658,MATH 193A,A02,083225,Staff,0,4,30,30
1650014901658,MATH 193A,A03,083781,Staff,0,0,30,30
1650014901658,MATH 193A,A04,083782,Staff,9,0,30,21
1650014907687,MATH 197,001,091859,McAuley; Julian John,9999,0,9999,0
1650014913765,COGS 9,A01,083615,Staff,1,15,60,59
1650014919791,COGS 11,A01,083617,Boyle; Mary E. T.,25,0,40,15
1650014925821,COGS 13,A01,083071,Staff,0,28,40,40
1650014931845,COGS 14A,A01,092681,Staff,0,6,100,100
1650014937877,COGS 14B,A01,083073,Cheng; Tzu-Han,0,2,50,50
1650014943910,COGS 17,A01,092677,Staff,35,0,75,40
1650014949938,COGS 100,A01,083619,Staff,0,18,60,60
1650014955967,COGS 101A,A01,083621,Davis; Joshua Daniel,0,16,60,60
1650014962090,COGS 101B,A01,091572,Staff,16,0,60,44
1650014968132,COGS 101C,A01,083625,Delgado; Tania,21,0,30,9
1650014974158,COGS 107A,A01,083627,Boyle; Mary E. T.,0,1,60,60
1650014980181,COGS 118A,A01,083075,Staff,19,0,60,41
1650014986210,CSE 3,A50,083646,Miranda; Gregory Joseph,22,0,38,16
1650014986210,CSE 3,A51,083647,Miranda; Gregory Joseph,37,0,37,0
1650014992240,CSE 8A,A50,083650,Miranda; Gregory Joseph,0,14,40,40
1650014998265,CSE 11,A01,083080,Cao; Yingjun,0,60,40,40
1650015004290,CSE 12,A01,083652,Staff,2,0,100,98
1650015010320,CSE 15L,A01,083654,Staff,0,0,50,50
1650015010320,CSE 15L,A02,083655,Staff,15,0,50,35
1650015016345,CSE 20,A01,083657,Staff,57,0,80,23
1650015022375,CSE 30,A01,083084,Eldon; John,0,62,40,40
1650015028401,CSE 100,A01,083659,Cao; Yingjun,0,57,50,50
1650015034431,CSE 134B,A01,083661,Powell; Thomas Allan,0,24,65,65
1650015040455,CSE 140,A01,083663,Staff,8,0,75,67
1650015046489,CSE 140L,A01,083088,Eldon; John,4,0,75,71
1650015052514,CSE 175,A01,083665,Kumar; Rakesh,10,0,25,15
1650015058544,CSE 190,A00,092507,Dubnov; Shlomo,17,0,20,3
1650015064569,ECE 45,A01,083139,Staff,0,10,40,40
1650015070595,ECE 65,A50,083695,Staff,0,1,30,30
1650015076620,ECE 109,A01,091882,Touri; Behrouz,48,0,70,22
1650015082650,ECE 180,A00,083140,Abi Samra; Nicholas Camill,26,0,30,4
1650015082650,ECE 180,B00,083141,Abi Samra; Nicholas Camill,10,0,30,20
1650015088677,MATH 10A,A01,083735,Patchell; Gregory David,14,0,30,16
1650015088677,MATH 10A,A02,083736,Patchell; Gregory David,28,0,30,2
1650015088677,MATH 10A,A03,083737,Patchell; Gregory David,27,0,30,3
1650015094709,MATH 10B,A01,083207,Staff,0,4,30,30
1650015094709,MATH 10B,A02,083208,Staff,0,0,30,30
1650015094709,MATH 10B,B01,083739,Staff,20,0,30,10
1650015094709,MATH 10B,B02,083740,Staff,30,0,30,0
1650015100742,MATH 18,A01,083743,Staff,10,0,30,20
1650015100742,MATH 18,A02,083744,Staff,28,0,30,2
1650015100742,MATH 18,A03,083745,Staff,23,0,30,7
1650015100742,MATH 18,A04,083746,Staff,27,0,30,3
1650015100742,MATH 18,B01,083748,Staff,0,8,30,30
1650015100742,MATH 18,B02,083749,Staff,0,6,30,30
1650015100742,MATH 18,B03,083750,Staff,0,6,30,30
1650015100742,MATH 18,B04,083751,Staff,1,7,30,29
1650015106767,MATH 20A,A01,083754,Staff,27,0,40,13
1650015112798,MATH 20B,A01,083756,Staff,0,4,30,30
1650015112798,MATH 20B,A02,083757,Staff,5,0,30,25
1650015118824,MATH 20C,A01,083760,Staff,0,9,30,30
1650015118824,MATH 20C,A02,083761,Staff,0,10,30,30
1650015118824,MATH 20C,B01,083762,Staff,17,0,30,13
1650015118824,MATH 20C,B02,083763,Staff,28,0,30,2
1650015124848,MATH 20D,A01,083765,Staff,0,2,30,30
1650015124848,MATH 20D,A02,083766,Staff,16,0,30,14
1650015124848,MATH 20D,A03,083767,Staff,28,0,30,2
1650015130873,MATH 20E,A01,083771,Staff,11,0,30,19
1650015130873,MATH 20E,A02,083772,Staff,20,0,30,10
1650015130873,MATH 20E,B01,083773,Staff,0,1,30,30
1650015130873,MATH 20E,B02,083774,Staff,21,0,30,9
1650015136899,MATH 103A,A01,083777,Staff,0,6,30,30
1650015136899,MATH 103A,A02,083778,Staff,0,7,30,30
1650015136899,MATH 103A,B01,083779,Staff,0,6,30,30
1650015136899,MATH 103A,B02,083780,Staff,0,6,30,30
1650015142928,MATH 105,A01,085443,Staff,0,11,30,30
1650015148955,MATH 109,A01,083213,Anzaldo; Leesa B,0,3,30,30
1650015148955,MATH 109,A02,083214,Anzaldo; Leesa B,0,3,30,30
1650015148955,MATH 109,B01,083215,Anzaldo; Leesa B,0,2,30,30
1650015148955,MATH 109,B02,083216,Anzaldo; Leesa B,0,2,30,30
1650015154985,MATH 142A,A01,083219,Chow; Bennett,0,7,30,30
1650015154985,MATH 142A,A02,083220,Chow; Bennett,0,7,30,30
1650015154985,MATH 142A,B01,083221,Chow; Bennett,0,8,30,30
1650015154985,MATH 142A,B02,083222,Chow; Bennett,0,7,30,30
1650015161010,MATH 193A,A01,083224,Staff,0,5,30,30
1650015161010,MATH 193A,A02,083225,Staff,0,4,30,30
1650015161010,MATH 193A,A03,083781,Staff,0,0,30,30
1650015161010,MATH 193A,A04,083782,Staff,9,0,30,21
1650015167034,MATH 197,001,091859,McAuley; Julian John,9999,0,9999,0
1650015173102,COGS 9,A01,083615,Staff,1,15,60,59
1650015179132,COGS 11,A01,083617,Boyle; Mary E. T.,25,0,40,15
1650015185161,COGS 13,A01,083071,Staff,0,28,40,40
1650015191186,COGS 14A,A01,092681,Staff,0,6,100,100
1650015197215,COGS 14B,A01,083073,Cheng; Tzu-Han,0,2,50,50
1650015203248,COGS 17,A01,092677,Staff,35,0,75,40
1650015209279,COGS 100,A01,083619,Staff,0,18,60,60
1650015215308,COGS 101A,A01,083621,Davis; Joshua Daniel,0,16,60,60
1650015221332,COGS 101B,A01,091572,Staff,16,0,60,44
1650015227358,COGS 101C,A01,083625,Delgado; Tania,21,0,30,9
1650015233380,COGS 107A,A01,083627,Boyle; Mary E. T.,0,1,60,60
1650015239404,COGS 118A,A01,083075,Staff,19,0,60,41
1650015245434,CSE 3,A50,083646,Miranda; Gregory Joseph,22,0,38,16
1650015245434,CSE 3,A51,083647,Miranda; Gregory Joseph,37,0,37,0
1650015251459,CSE 8A,A50,083650,Miranda; Gregory Joseph,0,14,40,40
1650015257486,CSE 11,A01,083080,Cao; Yingjun,0,60,40,40
1650015263510,CSE 12,A01,083652,Staff,2,0,100,98
1650015269533,CSE 15L,A01,083654,Staff,0,0,50,50
1650015269533,CSE 15L,A02,083655,Staff,15,0,50,35
1650015275567,CSE 20,A01,083657,Staff,57,0,80,23
1650015281592,CSE 30,A01,083084,Eldon; John,0,62,40,40
1650015287621,CSE 100,A01,083659,Cao; Yingjun,0,57,50,50
1650015293645,CSE 134B,A01,083661,Powell; Thomas Allan,0,24,65,65
1650015299669,CSE 140,A01,083663,Staff,8,0,75,67
1650015305694,CSE 140L,A01,083088,Eldon; John,4,0,75,71
1650015311722,CSE 175,A01,083665,Kumar; Rakesh,10,0,25,15
1650015317748,CSE 190,A00,092507,Dubnov; Shlomo,17,0,20,3
1650015323778,ECE 45,A01,083139,Staff,0,10,40,40
1650015329807,ECE 65,A50,083695,Staff,0,1,30,30
1650015335835,ECE 109,A01,091882,Touri; Behrouz,48,0,70,22
1650015341866,ECE 180,A00,083140,Abi Samra; Nicholas Camill,26,0,30,4
1650015341866,ECE 180,B00,083141,Abi Samra; Nicholas Camill,10,0,30,20
1650015347890,MATH 10A,A01,083735,Patchell; Gregory David,14,0,30,16
1650015347890,MATH 10A,A02,083736,Patchell; Gregory David,28,0,30,2
1650015347890,MATH 10A,A03,083737,Patchell; Gregory David,27,0,30,3
1650015353916,MATH 10B,A01,083207,Staff,0,4,30,30
1650015353916,MATH 10B,A02,083208,Staff,0,0,30,30
1650015353916,MATH 10B,B01,083739,Staff,20,0,30,10
1650015353916,MATH 10B,B02,083740,Staff,30,0,30,0
1650015359942,MATH 18,A01,083743,Staff,10,0,30,20
1650015359942,MATH 18,A02,083744,Staff,28,0,30,2
1650015359942,MATH 18,A03,083745,Staff,23,0,30,7
1650015359942,MATH 18,A04,083746,Staff,27,0,30,3
1650015359942,MATH 18,B01,083748,Staff,0,8,30,30
1650015359942,MATH 18,B02,083749,Staff,0,6,30,30
1650015359942,MATH 18,B03,083750,Staff,0,6,30,30
1650015359942,MATH 18,B04,083751,Staff,1,7,30,29
1650015365971,MATH 20A,A01,083754,Staff,27,0,40,13
1650015371995,MATH 20B,A01,083756,Staff,0,4,30,30
1650015371995,MATH 20B,A02,083757,Staff,4,0,30,26
1650015378021,MATH 20C,A01,083760,Staff,0,9,30,30
1650015378021,MATH 20C,A02,083761,Staff,0,10,30,30
1650015378021,MATH 20C,B01,083762,Staff,17,0,30,13
1650015378021,MATH 20C,B02,083763,Staff,28,0,30,2
1650015384049,MATH 20D,A01,083765,Staff,0,2,30,30
1650015384049,MATH 20D,A02,083766,Staff,16,0,30,14
1650015384049,MATH 20D,A03,083767,Staff,28,0,30,2
1650015390075,MATH 20E,A01,083771,Staff,11,0,30,19
1650015390075,MATH 20E,A02,083772,Staff,20,0,30,10
1650015390075,MATH 20E,B01,083773,Staff,0,1,30,30
1650015390075,MATH 20E,B02,083774,Staff,21,0,30,9
1650015396101,MATH 103A,A01,083777,Staff,0,6,30,30
1650015396101,MATH 103A,A02,083778,Staff,0,7,30,30
1650015396101,MATH 103A,B01,083779,Staff,0,6,30,30
1650015396101,MATH 103A,B02,083780,Staff,0,6,30,30
1650015402131,MATH 105,A01,085443,Staff,0,11,30,30
1650015408162,MATH 109,A01,083213,Anzaldo; Leesa B,0,3,30,30
1650015408162,MATH 109,A02,083214,Anzaldo; Leesa B,0,3,30,30
1650015408162,MATH 109,B01,083215,Anzaldo; Leesa B,0,2,30,30
1650015408162,MATH 109,B02,083216,Anzaldo; Leesa B,0,2,30,30
1650015414187,MATH 142A,A01,083219,Chow; Bennett,0,7,30,30
1650015414187,MATH 142A,A02,083220,Chow; Bennett,0,7,30,30
1650015414187,MATH 142A,B01,083221,Chow; Bennett,0,8,30,30
1650015414187,MATH 142A,B02,083222,Chow; Bennett,0,7,30,30
1650015420213,MATH 193A,A01,083224,Staff,0,5,30,30
1650015420213,MATH 193A,A02,083225,Staff,0,4,30,30
1650015420213,MATH 193A,A03,083781,Staff,0,0,30,30
1650015420213,MATH 193A,A04,083782,Staff,9,0,30,21
1650015426239,MATH 197,001,091859,McAuley; Julian John,9999,0,9999,0
1650015432303,COGS 9,A01,083615,Staff,1,15,60,59
1650015438334,COGS 11,A01,083617,Boyle; Mary E. T.,25,0,40,15
1650015444360,COGS 13,A01,083071,Staff,0,28,40,40
1650015450385,COGS 14A,A01,092681,Staff,0,6,100,100
1650015456413,COGS 14B,A01,083073,Cheng; Tzu-Han,0,2,50,50
1650015462437,COGS 17,A01,092677,Staff,35,0,75,40
1650015468461,COGS 100,A01,083619,Staff,0,18,60,60
1650015474498,COGS 101A,A01,083621,Davis; Joshua Daniel,0,16,60,60
1650015480527,COGS 101B,A01,091572,Staff,16,0,60,44
1650015486556,COGS 101C,A01,083625,Delgado; Tania,21,0,30,9
1650015492585,COGS 107A,A01,083627,Boyle; Mary E. T.,0,1,60,60
1650015498610,COGS 118A,A01,083075,Staff,19,0,60,41
1650015504636,CSE 3,A50,083646,Miranda; Gregory Joseph,22,0,38,16
1650015504636,CSE 3,A51,083647,Miranda; Gregory Joseph,37,0,37,0
1650015510661,CSE 8A,A50,083650,Miranda; Gregory Joseph,0,14,40,40
1650015516686,CSE 11,A01,083080,Cao; Yingjun,0,60,40,40
1650015522709,CSE 12,A01,083652,Staff,2,0,100,98
1650015528733,CSE 15L,A01,083654,Staff,0,0,50,50
1650015528733,CSE 15L,A02,083655,Staff,15,0,50,35
1650015534763,CSE 20,A01,083657,Staff,57,0,80,23
1650015540787,CSE 30,A01,083084,Eldon; John,0,62,40,40
1650015546813,CSE 100,A01,083659,Cao; Yingjun,0,57,50,50
1650015552852,CSE 134B,A01,083661,Powell; Thomas Allan,0,24,65,65
1650015558957,CSE 140,A01,083663,Staff,8,0,75,67
1650015564989,CSE 140L,A01,083088,Eldon; John,4,0,75,71
1650015571016,CSE 175,A01,083665,Kumar; Rakesh,10,0,25,15
1650015577048,CSE 190,A00,092507,Dubnov; Shlomo,17,0,20,3
1650015583080,ECE 45,A01,083139,Staff,0,10,40,40
1650015589106,ECE 65,A50,083695,Staff,0,1,30,30
1650015595137,ECE 109,A01,091882,Touri; Behrouz,48,0,70,22
1650015601163,ECE 180,A00,083140,Abi Samra; Nicholas Camill,26,0,30,4
1650015601163,ECE 180,B00,083141,Abi Samra; Nicholas Camill,10,0,30,20
1650015607202,MATH 10A,A01,083735,Patchell; Gregory David,14,0,30,16
1650015607202,MATH 10A,A02,083736,Patchell; Gregory David,28,0,30,2
1650015607202,MATH 10A,A03,083737,Patchell; Gregory David,27,0,30,3
1650015613229,MATH 10B,A01,083207,Staff,0,4,30,30
1650015613229,MATH 10B,A02,083208,Staff,0,0,30,30
1650015613229,MATH 10B,B01,083739,Staff,20,0,30,10
1650015613229,MATH 10B,B02,083740,Staff,30,0,30,0
1650015619265,MATH 18,A01,083743,Staff,10,0,30,20
1650015619265,MATH 18,A02,083744,Staff,28,0,30,2
1650015619265,MATH 18,A03,083745,Staff,23,0,30,7
1650015619265,MATH 18,A04,083746,Staff,27,0,30,3
1650015619265,MATH 18,B01,083748,Staff,0,8,30,30
1650015619265,MATH 18,B02,083749,Staff,0,6,30,30
1650015619265,MATH 18,B03,083750,Staff,0,6,30,30
1650015619265,MATH 18,B04,083751,Staff,1,7,30,29
1650015625294,MATH 20A,A01,083754,Staff,27,0,40,13
1650015631326,MATH 20B,A01,083756,Staff,0,4,30,30
1650015631326,MATH 20B,A02,083757,Staff,4,0,30,26
1650015637362,MATH 20C,A01,083760,Staff,0,9,30,30
1650015637362,MATH 20C,A02,083761,Staff,0,10,30,30
1650015637362,MATH 20C,B01,083762,Staff,17,0,30,13
1650015637362,MATH 20C,B02,083763,Staff,28,0,30,2
1650015643391,MATH 20D,A01,083765,Staff,0,2,30,30
1650015643391,MATH 20D,A02,083766,Staff,16,0,30,14
1650015643391,MATH 20D,A03,083767,Staff,28,0,30,2
1650015649417,MATH 20E,A01,083771,Staff,11,0,30,19
1650015649417,MATH 20E,A02,083772,Staff,20,0,30,10
1650015649417,MATH 20E,B01,083773,Staff,0,1,30,30
1650015649417,MATH 20E,B02,083774,Staff,21,0,30,9
1650015655446,MATH 103A,A01,083777,Staff,0,6,30,30
1650015655446,MATH 103A,A02,083778,Staff,0,7,30,30
1650015655446,MATH 103A,B01,083779,Staff,0,6,30,30
1650015655446,MATH 103A,B02,083780,Staff,0,6,30,30
1650015661471,MATH 105,A01,085443,Staff,0,11,30,30
1650015667499,MATH 109,A01,083213,Anzaldo; Leesa B,0,3,30,30
1650015667499,MATH 109,A02,083214,Anzaldo; Leesa B,0,3,30,30
1650015667499,MATH 109,B01,083215,Anzaldo; Leesa B,0,2,30,30
1650015667499,MATH 109,B02,083216,Anzaldo; Leesa B,0,2,30,30
1650015673543,MATH 142A,A01,083219,Chow; Bennett,0,7,30,30
1650015673543,MATH 142A,A02,083220,Chow; Bennett,0,7,30,30
1650015673543,MATH 142A,B01,083221,Chow; Bennett,0,8,30,30
1650015673543,MATH 142A,B02,083222,Chow; Bennett,0,7,30,30
1650015679566,MATH 193A,A01,083224,Staff,0,5,30,30
1650015679566,MATH 193A,A02,083225,Staff,0,4,30,30
1650015679566,MATH 193A,A03,083781,Staff,0,0,30,30
1650015679566,MATH 193A,A04,083782,Staff,9,0,30,21
1650015685595,MATH 197,001,091859,McAuley; Julian John,9999,0,9999,0
1650015691688,COGS 9,A01,083615,Staff,1,15,60,59
1650015697723,COGS 11,A01,083617,Boyle; Mary E. T.,25,0,40,15
1650015703757,COGS 13,A01,083071,Staff,0,28,40,40
1650015709788,COGS 14A,A01,092681,Staff,0,6,100,100
1650015715813,COGS 14B,A01,083073,Cheng; Tzu-Han,0,2,50,50
1650015721837,COGS 17,A01,092677,Staff,35,0,75,40
1650015727867,COGS 100,A01,083619,Staff,0,18,60,60
1650015733897,COGS 101A,A01,083621,Davis; Joshua Daniel,0,16,60,60
1650015739921,COGS 101B,A01,091572,Staff,16,0,60,44
1650015745947,COGS 101C,A01,083625,Delgado; Tania,21,0,30,9
1650015751971,COGS 107A,A01,083627,Boyle; Mary E. T.,0,1,60,60
1650015757995,COGS 118A,A01,083075,Staff,19,0,60,41
1650015764023,CSE 3,A50,083646,Miranda; Gregory Joseph,22,0,38,16
1650015764023,CSE 3,A51,083647,Miranda; Gregory Joseph,37,0,37,0
1650015770047,CSE 8A,A50,083650,Miranda; Gregory Joseph,0,14,40,40
1650015776077,CSE 11,A01,083080,Cao; Yingjun,0,60,40,40
1650015782101,CSE 12,A01,083652,Staff,2,0,100,98
1650015788128,CSE 15L,A01,083654,Staff,0,0,50,50
1650015788128,CSE 15L,A02,083655,Staff,15,0,50,35
1650015794152,CSE 20,A01,083657,Staff,57,0,80,23
1650015800175,CSE 30,A01,083084,Eldon; John,0,62,40,40
1650015806206,CSE 100,A01,083659,Cao; Yingjun,0,57,50,50
1650015812239,CSE 134B,A01,083661,Powell; Thomas Allan,0,24,65,65
1650015818266,CSE 140,A01,083663,Staff,8,0,75,67
1650015824291,CSE 140L,A01,083088,Eldon; John,4,0,75,71
1650015830322,CSE 175,A01,083665,Kumar; Rakesh,10,0,25,15
1650015836347,CSE 190,A00,092507,Dubnov; Shlomo,17,0,20,3
1650015842371,ECE 45,A01,083139,Staff,0,10,40,40
1650015848395,ECE 65,A50,083695,Staff,0,1,30,30
1650015854426,ECE 109,A01,091882,Touri; Behrouz,48,0,70,22
1650015860453,ECE 180,A00,083140,Abi Samra; Nicholas Camill,26,0,30,4
1650015860453,ECE 180,B00,083141,Abi Samra; Nicholas Camill,10,0,30,20
1650015866480,MATH 10A,A01,083735,Patchell; Gregory David,14,0,30,16
1650015866480,MATH 10A,A02,083736,Patchell; Gregory David,28,0,30,2
1650015866480,MATH 10A,A03,083737,Patchell; Gregory David,27,0,30,3
1650015872510,MATH 10B,A01,083207,Staff,0,4,30,30
1650015872510,MATH 10B,A02,083208,Staff,0,0,30,30
1650015872510,MATH 10B,B01,083739,Staff,20,0,30,10
1650015872510,MATH 10B,B02,083740,Staff,30,0,30,0
1650015878543,MATH 18,A01,083743,Staff,10,0,30,20
1650015878543,MATH 18,A02,083744,Staff,28,0,30,2
1650015878543,MATH 18,A03,083745,Staff,23,0,30,7
1650015878543,MATH 18,A04,083746,Staff,27,0,30,3
1650015878543,MATH 18,B01,083748,Staff,0,8,30,30
1650015878543,MATH 18,B02,083749,Staff,0,6,30,30
1650015878543,MATH 18,B03,083750,Staff,0,6,30,30
1650015878543,MATH 18,B04,083751,Staff,1,7,30,29
1650015884569,MATH 20A,A01,083754,Staff,27,0,40,13
1650015890593,MATH 20B,A01,083756,Staff,0,4,30,30
1650015890593,MATH 20B,A02,083757,Staff,4,0,30,26
1650015896617,MATH 20C,A01,083760,Staff,0,9,30,30
1650015896617,MATH 20C,A02,083761,Staff,0,10,30,30
1650015896617,MATH 20C,B01,083762,Staff,17,0,30,13
1650015896617,MATH 20C,B02,083763,Staff,28,0,30,2
1650015902655,MATH 20D,A01,083765,Staff,0,2,30,30
1650015902655,MATH 20D,A02,083766,Staff,16,0,30,14
1650015902655,MATH 20D,A03,083767,Staff,28,0,30,2
1650015908682,MATH 20E,A01,083771,Staff,11,0,30,19
1650015908682,MATH 20E,A02,083772,Staff,20,0,30,10
1650015908682,MATH 20E,B01,083773,Staff,0,1,30,30
1650015908682,MATH 20E,B02,083774,Staff,21,0,30,9
1650015914712,MATH 103A,A01,083777,Staff,0,6,30,30
1650015914712,MATH 103A,A02,083778,Staff,0,7,30,30
1650015914712,MATH 103A,B01,083779,Staff,0,6,30,30
1650015914712,MATH 103A,B02,083780,Staff,0,6,30,30
1650015920743,MATH 105,A01,085443,Staff,0,11,30,30
1650015926767,MATH 109,A01,083213,Anzaldo; Leesa B,0,3,30,30
1650015926767,MATH 109,A02,083214,Anzaldo; Leesa B,0,3,30,30
1650015926767,MATH 109,B01,083215,Anzaldo; Leesa B,0,2,30,30
1650015926767,MATH 109,B02,083216,Anzaldo; Leesa B,0,2,30,30
1650015932792,MATH 142A,A01,083219,Chow; Bennett,0,7,30,30
1650015932792,MATH 142A,A02,083220,Chow; Bennett,0,7,30,30
1650015932792,MATH 142A,B01,083221,Chow; Bennett,0,8,30,30
1650015932792,MATH 142A,B02,083222,Chow; Bennett,0,7,30,30
1650015938819,MATH 193A,A01,083224,Staff,0,5,30,30
1650015938819,MATH 193A,A02,083225,Staff,0,4,30,30
1650015938819,MATH 193A,A03,083781,Staff,0,0,30,30
1650015938819,MATH 193A,A04,083782,Staff,9,0,30,21
1650015944849,MATH 197,001,091859,McAuley; Julian John,9999,0,9999,0
1650015950905,COGS 9,A01,083615,Staff,1,15,60,59
1650015956939,COGS 11,A01,083617,Boyle; Mary E. T.,25,0,40,15
1650015962962,COGS 13,A01,083071,Staff,0,28,40,40
1650015968992,COGS 14A,A01,092681,Staff,0,6,100,100
1650015975024,COGS 14B,A01,083073,Cheng; Tzu-Han,0,2,50,50
1650015981050,COGS 17,A01,092677,Staff,35,0,75,40
1650015987074,COGS 100,A01,083619,Staff,0,18,60,60
1650015993099,COGS 101A,A01,083621,Davis; Joshua Daniel,0,16,60,60
1650015999125,COGS 101B,A01,091572,Staff,16,0,60,44
1650016005154,COGS 101C,A01,083625,Delgado; Tania,21,0,30,9
1650016011178,COGS 107A,A01,083627,Boyle; Mary E. T.,0,1,60,60
1650016017202,COGS 118A,A01,083075,Staff,19,0,60,41
1650016023228,CSE 3,A50,083646,Miranda; Gregory Joseph,22,0,38,16
1650016023228,CSE 3,A51,083647,Miranda; Gregory Joseph,37,0,37,0
1650016029256,CSE 8A,A50,083650,Miranda; Gregory Joseph,0,14,40,40
1650016035279,CSE 11,A01,083080,Cao; Yingjun,0,60,40,40
1650016041308,CSE 12,A01,083652,Staff,2,0,100,98
1650016047335,CSE 15L,A01,083654,Staff,0,0,50,50
1650016047335,CSE 15L,A02,083655,Staff,15,0,50,35
1650016053362,CSE 20,A01,083657,Staff,57,0,80,23
1650016059394,CSE 30,A01,083084,Eldon; John,0,62,40,40
1650016065418,CSE 100,A01,083659,Cao; Yingjun,0,57,50,50
1650016071446,CSE 134B,A01,083661,Powell; Thomas Allan,0,24,65,65
1650016077472,CSE 140,A01,083663,Staff,8,0,75,67
1650016083516,CSE 140L,A01,083088,Eldon; John,4,0,75,71
1650016089539,CSE 175,A01,083665,Kumar; Rakesh,10,0,25,15
1650016095562,CSE 190,A00,092507,Dubnov; Shlomo,17,0,20,3
1650016101585,ECE 45,A01,083139,Staff,0,10,40,40
1650016107609,ECE 65,A50,083695,Staff,0,1,30,30
1650016113632,ECE 109,A01,091882,Touri; Behrouz,48,0,70,22
1650016119661,ECE 180,A00,083140,Abi Samra; Nicholas Camill,26,0,30,4
1650016119661,ECE 180,B00,083141,Abi Samra; Nicholas Camill,10,0,30,20
1650016125685,MATH 10A,A01,083735,Patchell; Gregory David,14,0,30,16
1650016125685,MATH 10A,A02,083736,Patchell; Gregory David,28,0,30,2
1650016125685,MATH 10A,A03,083737,Patchell; Gregory David,27,0,30,3
1650016131708,MATH 10B,A01,083207,Staff,0,4,30,30
1650016131708,MATH 10B,A02,083208,Staff,0,0,30,30
1650016131708,MATH 10B,B01,083739,Staff,20,0,30,10
1650016131708,MATH 10B,B02,083740,Staff,30,0,30,0
1650016137734,MATH 18,A01,083743,Staff,10,0,30,20
1650016137734,MATH 18,A02,083744,Staff,28,0,30,2
1650016137734,MATH 18,A03,083745,Staff,23,0,30,7
1650016137734,MATH 18,A04,083746,Staff,27,0,30,3
1650016137734,MATH 18,B01,083748,Staff,0,8,30,30
1650016137734,MATH 18,B02,083749,Staff,0,6,30,30
1650016137734,MATH 18,B03,083750,Staff,0,6,30,30
1650016137734,MATH 18,B04,083751,Staff,1,7,30,29
1650016143758,MATH 20A,A01,083754,Staff,27,0,40,13
1650016149784,MATH 20B,A01,083756,Staff,0,4,30,30
1650016149784,MATH 20B,A02,083757,Staff,4,0,30,26
1650016155900,MATH 20C,A01,083760,Staff,0,9,30,30
1650016155900,MATH 20C,A02,083761,Staff,0,10,30,30
1650016155900,MATH 20C,B01,083762,Staff,17,0,30,13
1650016155900,MATH 20C,B02,083763,Staff,28,0,30,2
1650016161927,MATH 20D,A01,083765,Staff,0,2,30,30
1650016161927,MATH 20D,A02,083766,Staff,16,0,30,14
1650016161927,MATH 20D,A03,083767,Staff,28,0,30,2
1650016167951,MATH 20E,A01,083771,Staff,11,0,30,19
1650016167951,MATH 20E,A02,083772,Staff,20,0,30,10
1650016167951,MATH 20E,B01,083773,Staff,0,1,30,30
1650016167951,MATH 20E,B02,083774,Staff,21,0,30,9
1650016173975,MATH 103A,A01,083777,Staff,0,6,30,30
1650016173975,MATH 103A,A02,083778,Staff,0,7,30,30
1650016173975,MATH 103A,B01,083779,Staff,0,6,30,30
1650016173975,MATH 103A,B02,083780,Staff,0,6,30,30
1650016179997,MATH 105,A01,085443,Staff,0,11,30,30
1650016186021,MATH 109,A01,083213,Anzaldo; Leesa B,0,3,30,30
1650016186021,MATH 109,A02,083214,Anzaldo; Leesa B,0,3,30,30
1650016186021,MATH 109,B01,083215,Anzaldo; Leesa B,0,2,30,30
1650016186021,MATH 109,B02,083216,Anzaldo; Leesa B,0,2,30,30
1650016192052,MATH 142A,A01,083219,Chow; Bennett,0,7,30,30
1650016192052,MATH 142A,A02,083220,Chow; Bennett,0,7,30,30
1650016192052,MATH 142A,B01,083221,Chow; Bennett,0,8,30,30
1650016192052,MATH 142A,B02,083222,Chow; Bennett,0,7,30,30
1650016198085,MATH 193A,A01,083224,Staff,0,5,30,30
1650016198085,MATH 193A,A02,083225,Staff,0,4,30,30
1650016198085,MATH 193A,A03,083781,Staff,0,0,30,30
1650016198085,MATH 193A,A04,083782,Staff,9,0,30,21
1650016204109,MATH 197,001,091859,McAuley; Julian John,9999,0,9999,0
1650016219461,COGS 9,A01,083615,Staff,1,15,60,59
1650016225484,COGS 11,A01,083617,Boyle; Mary E. T.,25,0,40,15
1650016231509,COGS 13,A01,083071,Staff,0,28,40,40
1650016237534,COGS 14A,A01,092681,Staff,0,6,100,100
1650016243559,COGS 14B,A01,083073,Cheng; Tzu-Han,0,2,50,50
1650016249582,COGS 17,A01,092677,Staff,35,0,75,40
1650016255633,COGS 100,A01,083619,Staff,0,18,60,60
1650016261660,COGS 101A,A01,083621,Davis; Joshua Daniel,0,16,60,60
1650016267690,COGS 101B,A01,091572,Staff,16,0,60,44
1650016273721,COGS 101C,A01,083625,Delgado; Tania,21,0,30,9
1650016279744,COGS 107A,A01,083627,Boyle; Mary E. T.,0,1,60,60
1650016285775,COGS 118A,A01,083075,Staff,19,0,60,41
1650016291800,CSE 3,A50,083646,Miranda; Gregory Joseph,22,0,38,16
1650016291800,CSE 3,A51,083647,Miranda; Gregory Joseph,37,0,37,0
1650016297823,CSE 8A,A50,083650,Miranda; Gregory Joseph,0,14,40,40
1650016303850,CSE 11,A01,083080,Cao; Yingjun,0,60,40,40
1650016309874,CSE 12,A01,083652,Staff,2,0,100,98
1650016315901,CSE 15L,A01,083654,Staff,0,0,50,50
1650016315901,CSE 15L,A02,083655,Staff,15,0,50,35
1650016321924,CSE 20,A01,083657,Staff,57,0,80,23
1650016327954,CSE 30,A01,083084,Eldon; John,0,62,40,40
1650016333977,CSE 100,A01,083659,Cao; Yingjun,0,57,50,50
1650016340001,CSE 134B,A01,083661,Powell; Thomas Allan,0,24,65,65
1650016346029,CSE 140,A01,083663,Staff,8,0,75,67
1650016352053,CSE 140L,A01,083088,Eldon; John,4,0,75,71
1650016358075,CSE 175,A01,083665,Kumar; Rakesh,10,0,25,15
1650016364098,CSE 190,A00,092507,Dubnov; Shlomo,17,0,20,3
1650016370125,ECE 45,A01,083139,Staff,0,10,40,40
1650016376150,ECE 65,A50,083695,Staff,0,1,30,30
1650016382174,ECE 109,A01,091882,Touri; Behrouz,48,0,70,22
1650016388198,ECE 180,A00,083140,Abi Samra; Nicholas Camill,26,0,30,4
1650016388198,ECE 180,B00,083141,Abi Samra; Nicholas Camill,10,0,30,20
1650016394222,MATH 10A,A01,083735,Patchell; Gregory David,14,0,30,16
1650016394222,MATH 10A,A02,083736,Patchell; Gregory David,28,0,30,2
1650016394222,MATH 10A,A03,083737,Patchell; Gregory David,27,0,30,3
1650016400246,MATH 10B,A01,083207,Staff,0,4,30,30
1650016400246,MATH 10B,A02,083208,Staff,0,0,30,30
1650016400246,MATH 10B,B01,083739,Staff,20,0,30,10
1650016400246,MATH 10B,B02,083740,Staff,30,0,30,0
1650016406273,MATH 18,A01,083743,Staff,10,0,30,20
1650016406273,MATH 18,A02,083744,Staff,28,0,30,2
1650016406273,MATH 18,A03,083745,Staff,23,0,30,7
1650016406273,MATH 18,A04,083746,Staff,27,0,30,3
1650016406273,MATH 18,B01,083748,Staff,0,8,30,30
1650016406273,MATH 18,B02,083749,Staff,0,6,30,30
1650016406273,MATH 18,B03,083750,Staff,0,6,30,30
1650016406273,MATH 18,B04,083751,Staff,1,7,30,29
1650016412298,MATH 20A,A01,083754,Staff,27,0,40,13
1650016418321,MATH 20B,A01,083756,Staff,0,4,30,30
1650016418321,MATH 20B,A02,083757,Staff,4,0,30,26
1650016424344,MATH 20C,A01,083760,Staff,0,9,30,30
1650016424344,MATH 20C,A02,083761,Staff,0,10,30,30
1650016424344,MATH 20C,B01,083762,Staff,17,0,30,13
1650016424344,MATH 20C,B02,083763,Staff,28,0,30,2
1650016430371,MATH 20D,A01,083765,Staff,0,2,30,30
1650016430371,MATH 20D,A02,083766,Staff,16,0,30,14
1650016430371,MATH 20D,A03,083767,Staff,28,0,30,2
1650016436399,MATH 20E,A01,083771,Staff,11,0,30,19
1650016436399,MATH 20E,A02,083772,Staff,20,0,30,10
1650016436399,MATH 20E,B01,083773,Staff,0,1,30,30
1650016436399,MATH 20E,B02,083774,Staff,20,0,30,10
1650016442427,MATH 103A,A01,083777,Staff,0,6,30,30
1650016442427,MATH 103A,A02,083778,Staff,0,7,30,30
1650016442427,MATH 103A,B01,083779,Staff,0,6,30,30
1650016442427,MATH 103A,B02,083780,Staff,0,6,30,30
1650016448451,MATH 105,A01,085443,Staff,0,11,30,30
1650016454483,MATH 109,A01,083213,Anzaldo; Leesa B,0,3,30,30
1650016454483,MATH 109,A02,083214,Anzaldo; Leesa B,0,3,30,30
1650016454483,MATH 109,B01,083215,Anzaldo; Leesa B,0,2,30,30
1650016454483,MATH 109,B02,083216,Anzaldo; Leesa B,0,2,30,30
1650016460508,MATH 142A,A01,083219,Chow; Bennett,0,7,30,30
1650016460508,MATH 142A,A02,083220,Chow; Bennett,0,7,30,30
1650016460508,MATH 142A,B01,083221,Chow; Bennett,0,8,30,30
1650016460508,MATH 142A,B02,083222,Chow; Bennett,0,7,30,30
1650016466538,MATH 193A,A01,083224,Staff,0,5,30,30
1650016466538,MATH 193A,A02,083225,Staff,0,4,30,30
1650016466538,MATH 193A,A03,083781,Staff,0,0,30,30
1650016466538,MATH 193A,A04,083782,Staff,9,0,30,21
1650016472565,MATH 197,001,091859,McAuley; Julian John,9999,0,9999,0
1650016478644,COGS 9,A01,083615,Staff,1,15,60,59
1650016484671,COGS 11,A01,083617,Boyle; Mary E. T.,25,0,40,15
1650016490694,COGS 13,A01,083071,Staff,0,28,40,40
1650016496733,COGS 14A,A01,092681,Staff,0,6,100,100
1650016502757,COGS 14B,A01,083073,Cheng; Tzu-Han,0,2,50,50
1650016508781,COGS 17,A01,092677,Staff,35,0,75,40
1650016514805,COGS 100,A01,083619,Staff,0,18,60,60
1650016520834,COGS 101A,A01,083621,Davis; Joshua Daniel,0,16,60,60
1650016526863,COGS 101B,A01,091572,Staff,16,0,60,44
1650016532891,COGS 101C,A01,083625,Delgado; Tania,21,0,30,9
1650016538919,COGS 107A,A01,083627,Boyle; Mary E. T.,0,1,60,60
1650016544946,COGS 118A,A01,083075,Staff,19,0,60,41
1650016550975,CSE 3,A50,083646,Miranda; Gregory Joseph,22,0,38,16
1650016550975,CSE 3,A51,083647,Miranda; Gregory Joseph,37,0,37,0
1650016557011,CSE 8A,A50,083650,Miranda; Gregory Joseph,0,14,40,40
1650016563035,CSE 11,A01,083080,Cao; Yingjun,0,60,40,40
1650016569064,CSE 12,A01,083652,Staff,2,0,100,98
1650016575087,CSE 15L,A01,083654,Staff,0,0,50,50
1650016575087,CSE 15L,A02,083655,Staff,15,0,50,35
1650016581112,CSE 20,A01,083657,Staff,57,0,80,23
1650016587136,CSE 30,A01,083084,Eldon; John,0,62,40,40
1650016593159,CSE 100,A01,083659,Cao; Yingjun,0,57,50,50
1650016599183,CSE 134B,A01,083661,Powell; Thomas Allan,0,24,65,65
1650016605208,CSE 140,A01,083663,Staff,8,0,75,67
1650016611235,CSE 140L,A01,083088,Eldon; John,4,0,75,71
1650016617258,CSE 175,A01,083665,Kumar; Rakesh,10,0,25,15
1650016623283,CSE 190,A00,092507,Dubnov; Shlomo,17,0,20,3
1650016629307,ECE 45,A01,083139,Staff,0,10,40,40
1650016635331,ECE 65,A50,083695,Staff,0,1,30,30
1650016641361,ECE 109,A01,091882,Touri; Behrouz,48,0,70,22
1650016647386,ECE 180,A00,083140,Abi Samra; Nicholas Camill,26,0,30,4
1650016647386,ECE 180,B00,083141,Abi Samra; Nicholas Camill,10,0,30,20
1650016653425,MATH 10A,A01,083735,Patchell; Gregory David,14,0,30,16
1650016653425,MATH 10A,A02,083736,Patchell; Gregory David,28,0,30,2
1650016653425,MATH 10A,A03,083737,Patchell; Gregory David,27,0,30,3
1650016659449,MATH 10B,A01,083207,Staff,0,4,30,30
1650016659449,MATH 10B,A02,083208,Staff,0,0,30,30
1650016659449,MATH 10B,B01,083739,Staff,20,0,30,10
1650016659449,MATH 10B,B02,083740,Staff,30,0,30,0
1650016665479,MATH 18,A01,083743,Staff,10,0,30,20
1650016665479,MATH 18,A02,083744,Staff,28,0,30,2
1650016665479,MATH 18,A03,083745,Staff,23,0,30,7
1650016665479,MATH 18,A04,083746,Staff,27,0,30,3
1650016665479,MATH 18,B01,083748,Staff,0,8,30,30
1650016665479,MATH 18,B02,083749,Staff,0,6,30,30
1650016665479,MATH 18,B03,083750,Staff,0,6,30,30
1650016665479,MATH 18,B04,083751,Staff,1,7,30,29
1650016671503,MATH 20A,A01,083754,Staff,27,0,40,13
1650016677526,MATH 20B,A01,083756,Staff,0,4,30,30
1650016677526,MATH 20B,A02,083757,Staff,4,0,30,26
1650016683558,MATH 20C,A01,083760,Staff,0,9,30,30
1650016683558,MATH 20C,A02,083761,Staff,0,10,30,30
1650016683558,MATH 20C,B01,083762,Staff,17,0,30,13
1650016683558,MATH 20C,B02,083763,Staff,28,0,30,2
1650016689582,MATH 20D,A01,083765,Staff,0,2,30,30
1650016689582,MATH 20D,A02,083766,Staff,16,0,30,14
1650016689582,MATH 20D,A03,083767,Staff,28,0,30,2
1650016695605,MATH 20E,A01,083771,Staff,11,0,30,19
1650016695605,MATH 20E,A02,083772,Staff,20,0,30,10
1650016695605,MATH 20E,B01,083773,Staff,0,1,30,30
1650016695605,MATH 20E,B02,083774,Staff,20,0,30,10
1650016701635,MATH 103A,A01,083777,Staff,0,6,30,30
1650016701635,MATH 103A,A02,083778,Staff,0,7,30,30
1650016701635,MATH 103A,B01,083779,Staff,0,6,30,30
1650016701635,MATH 103A,B02,083780,Staff,0,6,30,30
1650016707658,MATH 105,A01,085443,Staff,0,11,30,30
1650016713683,MATH 109,A01,083213,Anzaldo; Leesa B,0,3,30,30
1650016713683,MATH 109,A02,083214,Anzaldo; Leesa B,0,3,30,30
1650016713683,MATH 109,B01,083215,Anzaldo; Leesa B,0,2,30,30
1650016713683,MATH 109,B02,083216,Anzaldo; Leesa B,0,2,30,30
1650016719712,MATH 142A,A01,083219,Chow; Bennett,0,7,30,30
1650016719712,MATH 142A,A02,083220,Chow; Bennett,0,7,30,30
1650016719712,MATH 142A,B01,083221,Chow; Bennett,0,8,30,30
1650016719712,MATH 142A,B02,083222,Chow; Bennett,0,7,30,30
1650016725735,MATH 193A,A01,083224,Staff,0,5,30,30
1650016725735,MATH 193A,A02,083225,Staff,0,4,30,30
1650016725735,MATH 193A,A03,083781,Staff,0,0,30,30
1650016725735,MATH 193A,A04,083782,Staff,9,0,30,21
1650016731762,MATH 197,001,091859,McAuley; Julian John,9999,0,9999,0
1650016737825,COGS 9,A01,083615,Staff,1,15,60,59
1650016743850,COGS 11,A01,083617,Boyle; Mary E. T.,25,0,40,15
1650016749874,COGS 13,A01,083071,Staff,0,28,40,40
1650016755989,COGS 14A,A01,092681,Staff,0,6,100,100
1650016762012,COGS 14B,A01,083073,Cheng; Tzu-Han,0,2,50,50
1650016768041,COGS 17,A01,092677,Staff,35,0,75,40
1650016774063,COGS 100,A01,083619,Staff,0,18,60,60
1650016780086,COGS 101A,A01,083621,Davis; Joshua Daniel,0,16,60,60
1650016786114,COGS 101B,A01,091572,Staff,16,0,60,44
1650016792146,COGS 101C,A01,083625,Delgado; Tania,21,0,30,9
1650016798167,COGS 107A,A01,083627,Boyle; Mary E. T.,0,1,60,60
1650016804193,COGS 118A,A01,083075,Staff,19,0,60,41
1650016810218,CSE 3,A50,083646,Miranda; Gregory Joseph,22,0,38,16
1650016810218,CSE 3,A51,083647,Miranda; Gregory Joseph,37,0,37,0
1650016816242,CSE 8A,A50,083650,Miranda; Gregory Joseph,0,14,40,40
1650016822272,CSE 11,A01,083080,Cao; Yingjun,0,60,40,40
1650016828296,CSE 12,A01,083652,Staff,2,0,100,98
1650016834324,CSE 15L,A01,083654,Staff,0,0,50,50
1650016834324,CSE 15L,A02,083655,Staff,15,0,50,35
1650016840346,CSE 20,A01,083657,Staff,57,0,80,23
1650016846370,CSE 30,A01,083084,Eldon; John,0,62,40,40
1650016852401,CSE 100,A01,083659,Cao; Yingjun,0,57,50,50
1650016858429,CSE 134B,A01,083661,Powell; Thomas Allan,0,24,65,65
1650016864455,CSE 140,A01,083663,Staff,8,0,75,67
1650016870477,CSE 140L,A01,083088,Eldon; John,4,0,75,71
1650016876504,CSE 175,A01,083665,Kumar; Rakesh,10,0,25,15
1650016882528,CSE 190,A00,092507,Dubnov; Shlomo,17,0,20,3
1650016888552,ECE 45,A01,083139,Staff,0,10,40,40
1650016894576,ECE 65,A50,083695,Staff,0,1,30,30
1650016900597,ECE 109,A01,091882,Touri; Behrouz,48,0,70,22
1650016906622,ECE 180,A00,083140,Abi Samra; Nicholas Camill,26,0,30,4
1650016906622,ECE 180,B00,083141,Abi Samra; Nicholas Camill,10,0,30,20
1650016912647,MATH 10A,A01,083735,Patchell; Gregory David,14,0,30,16
1650016912647,MATH 10A,A02,083736,Patchell; Gregory David,28,0,30,2
1650016912647,MATH 10A,A03,083737,Patchell; Gregory David,27,0,30,3
1650016918676,MATH 10B,A01,083207,Staff,0,4,30,30
1650016918676,MATH 10B,A02,083208,Staff,0,0,30,30
1650016918676,MATH 10B,B01,083739,Staff,20,0,30,10
1650016918676,MATH 10B,B02,083740,Staff,30,0,30,0
1650016924703,MATH 18,A01,083743,Staff,10,0,30,20
1650016924703,MATH 18,A02,083744,Staff,28,0,30,2
1650016924703,MATH 18,A03,083745,Staff,23,0,30,7
1650016924703,MATH 18,A04,083746,Staff,27,0,30,3
1650016924703,MATH 18,B01,083748,Staff,0,8,30,30
1650016924703,MATH 18,B02,083749,Staff,0,6,30,30
1650016924703,MATH 18,B03,083750,Staff,0,6,30,30
1650016924703,MATH 18,B04,083751,Staff,1,7,30,29
1650016930731,MATH 20A,A01,083754,Staff,27,0,40,13
1650016936757,MATH 20B,A01,083756,Staff,0,4,30,30
1650016936757,MATH 20B,A02,083757,Staff,4,0,30,26
1650016942787,MATH 20C,A01,083760,Staff,0,9,30,30
1650016942787,MATH 20C,A02,083761,Staff,0,10,30,30
1650016942787,MATH 20C,B01,083762,Staff,17,0,30,13
1650016942787,MATH 20C,B02,083763,Staff,28,0,30,2
1650016948818,MATH 20D,A01,083765,Staff,0,2,30,30
1650016948818,MATH 20D,A02,083766,Staff,16,0,30,14
1650016948818,MATH 20D,A03,083767,Staff,28,0,30,2
1650016954842,MATH 20E,A01,083771,Staff,11,0,30,19
1650016954842,MATH 20E,A02,083772,Staff,20,0,30,10
1650016954842,MATH 20E,B01,083773,Staff,0,1,30,30
1650016954842,MATH 20E,B02,083774,Staff,20,0,30,10
1650016960874,MATH 103A,A01,083777,Staff,0,6,30,30
1650016960874,MATH 103A,A02,083778,Staff,0,7,30,30
1650016960874,MATH 103A,B01,083779,Staff,0,6,30,30
1650016960874,MATH 103A,B02,083780,Staff,0,6,30,30
1650016966902,MATH 105,A01,085443,Staff,0,11,30,30
1650016972926,MATH 109,A01,083213,Anzaldo; Leesa B,0,3,30,30
1650016972926,MATH 109,A02,083214,Anzaldo; Leesa B,0,3,30,30
1650016972926,MATH 109,B01,083215,Anzaldo; Leesa B,0,2,30,30
1650016972926,MATH 109,B02,083216,Anzaldo; Leesa B,0,2,30,30
1650016978953,MATH 142A,A01,083219,Chow; Bennett,0,7,30,30
1650016978953,MATH 142A,A02,083220,Chow; Bennett,0,7,30,30
1650016978953,MATH 142A,B01,083221,Chow; Bennett,0,8,30,30
1650016978953,MATH 142A,B02,083222,Chow; Bennett,0,7,30,30
1650016984975,MATH 193A,A01,083224,Staff,0,5,30,30
1650016984975,MATH 193A,A02,083225,Staff,0,4,30,30
1650016984975,MATH 193A,A03,083781,Staff,0,0,30,30
1650016984975,MATH 193A,A04,083782,Staff,9,0,30,21
1650016991010,MATH 197,001,091859,McAuley; Julian John,9999,0,9999,0
1650016997077,COGS 9,A01,083615,Staff,1,15,60,59
1650017003101,COGS 11,A01,083617,Boyle; Mary E. T.,25,0,40,15
1650017009130,COGS 13,A01,083071,Staff,0,28,40,40
1650017015158,COGS 14A,A01,092681,Staff,0,6,100,100
1650017021180,COGS 14B,A01,083073,Cheng; Tzu-Han,0,2,50,50
1650017027206,COGS 17,A01,092677,Staff,35,0,75,40
1650017033232,COGS 100,A01,083619,Staff,0,18,60,60
1650017039255,COGS 101A,A01,083621,Davis; Joshua Daniel,0,16,60,60
1650017045277,COGS 101B,A01,091572,Staff,16,0,60,44
1650017051300,COGS 101C,A01,083625,Delgado; Tania,21,0,30,9
1650017057324,COGS 107A,A01,083627,Boyle; Mary E. T.,0,1,60,60
1650017063350,COGS 118A,A01,083075,Staff,19,0,60,41
1650017069374,CSE 3,A50,083646,Miranda; Gregory Joseph,22,0,38,16
1650017069374,CSE 3,A51,083647,Miranda; Gregory Joseph,37,0,37,0
1650017075401,CSE 8A,A50,083650,Miranda; Gregory Joseph,0,14,40,40
1650017081426,CSE 11,A01,083080,Cao; Yingjun,0,60,40,40
1650017087455,CSE 12,A01,083652,Staff,2,0,100,98
1650017093478,CSE 15L,A01,083654,Staff,0,0,50,50
1650017093478,CSE 15L,A02,083655,Staff,15,0,50,35
1650017099501,CSE 20,A01,083657,Staff,57,0,80,23
1650017105525,CSE 30,A01,083084,Eldon; John,0,62,40,40
1650017111557,CSE 100,A01,083659,Cao; Yingjun,0,57,50,50
1650017117582,CSE 134B,A01,083661,Powell; Thomas Allan,0,24,65,65
1650017123610,CSE 140,A01,083663,Staff,8,0,75,67
1650017129633,CSE 140L,A01,083088,Eldon; John,4,0,75,71
1650017135660,CSE 175,A01,083665,Kumar; Rakesh,10,0,25,15
1650017141688,CSE 190,A00,092507,Dubnov; Shlomo,17,0,20,3
1650017147711,ECE 45,A01,083139,Staff,0,10,40,40
1650017153740,ECE 65,A50,083695,Staff,0,1,30,30
1650017159763,ECE 109,A01,091882,Touri; Behrouz,48,0,70,22
1650017165787,ECE 180,A00,083140,Abi Samra; Nicholas Camill,26,0,30,4
1650017165787,ECE 180,B00,083141,Abi Samra; Nicholas Camill,10,0,30,20
1650017171812,MATH 10A,A01,083735,Patchell; Gregory David,14,0,30,16
1650017171812,MATH 10A,A02,083736,Patchell; Gregory David,28,0,30,2
1650017171812,MATH 10A,A03,083737,Patchell; Gregory David,27,0,30,3
1650017177836,MATH 10B,A01,083207,Staff,0,4,30,30
1650017177836,MATH 10B,A02,083208,Staff,0,0,30,30
1650017177836,MATH 10B,B01,083739,Staff,20,0,30,10
1650017177836,MATH 10B,B02,083740,Staff,30,0,30,0
1650017183860,MATH 18,A01,083743,Staff,10,0,30,20
1650017183860,MATH 18,A02,083744,Staff,28,0,30,2
1650017183860,MATH 18,A03,083745,Staff,23,0,30,7
1650017183860,MATH 18,A04,083746,Staff,27,0,30,3
1650017183860,MATH 18,B01,083748,Staff,0,8,30,30
1650017183860,MATH 18,B02,083749,Staff,0,6,30,30
1650017183860,MATH 18,B03,083750,Staff,0,6,30,30
1650017183860,MATH 18,B04,083751,Staff,1,7,30,29
1650017189883,MATH 20A,A01,083754,Staff,27,0,40,13
1650017195913,MATH 20B,A01,083756,Staff,0,4,30,30
1650017195913,MATH 20B,A02,083757,Staff,4,0,30,26
1650017201941,MATH 20C,A01,083760,Staff,0,9,30,30
1650017201941,MATH 20C,A02,083761,Staff,0,10,30,30
1650017201941,MATH 20C,B01,083762,Staff,17,0,30,13
1650017201941,MATH 20C,B02,083763,Staff,28,0,30,2
1650017207965,MATH 20D,A01,083765,Staff,0,2,30,30
1650017207965,MATH 20D,A02,083766,Staff,16,0,30,14
1650017207965,MATH 20D,A03,083767,Staff,28,0,30,2
1650017213995,MATH 20E,A01,083771,Staff,11,0,30,19
1650017213995,MATH 20E,A02,083772,Staff,20,0,30,10
1650017213995,MATH 20E,B01,083773,Staff,0,1,30,30
1650017213995,MATH 20E,B02,083774,Staff,20,0,30,10
1650017220025,MATH 103A,A01,083777,Staff,0,6,30,30
1650017220025,MATH 103A,A02,083778,Staff,0,7,30,30
1650017220025,MATH 103A,B01,083779,Staff,0,6,30,30
1650017220025,MATH 103A,B02,083780,Staff,0,6,30,30
1650017226049,MATH 105,A01,085443,Staff,0,11,30,30
1650017232074,MATH 109,A01,083213,Anzaldo; Leesa B,0,3,30,30
1650017232074,MATH 109,A02,083214,Anzaldo; Leesa B,0,3,30,30
1650017232074,MATH 109,B01,083215,Anzaldo; Leesa B,0,2,30,30
1650017232074,MATH 109,B02,083216,Anzaldo; Leesa B,0,2,30,30
1650017238098,MATH 142A,A01,083219,Chow; Bennett,0,7,30,30
1650017238098,MATH 142A,A02,083220,Chow; Bennett,0,7,30,30
1650017238098,MATH 142A,B01,083221,Chow; Bennett,0,8,30,30
1650017238098,MATH 142A,B02,083222,Chow; Bennett,0,7,30,30
1650017244122,MATH 193A,A01,083224,Staff,0,5,30,30
1650017244122,MATH 193A,A02,083225,Staff,0,4,30,30
1650017244122,MATH 193A,A03,083781,Staff,0,0,30,30
1650017244122,MATH 193A,A04,083782,Staff,9,0,30,21
1650017250146,MATH 197,001,091859,McAuley; Julian John,9999,0,9999,0
1650017256205,COGS 9,A01,083615,Staff,1,15,60,59
1650017262236,COGS 11,A01,083617,Boyle; Mary E. T.,25,0,40,15
1650017268267,COGS 13,A01,083071,Staff,0,28,40,40
1650017274299,COGS 14A,A01,092681,Staff,0,6,100,100
1650017280323,COGS 14B,A01,083073,Cheng; Tzu-Han,0,2,50,50
1650017286351,COGS 17,A01,092677,Staff,35,0,75,40
1650017292374,COGS 100,A01,083619,Staff,0,18,60,60
1650017298401,COGS 101A,A01,083621,Davis; Joshua Daniel,0,16,60,60
1650017304427,COGS 101B,A01,091572,Staff,16,0,60,44
1650017310453,COGS 101C,A01,083625,Delgado; Tania,21,0,30,9
1650017316475,COGS 107A,A01,083627,Boyle; Mary E. T.,0,1,60,60
1650017322498,COGS 118A,A01,083075,Staff,19,0,60,41
1650017328522,CSE 3,A50,083646,Miranda; Gregory Joseph,22,0,38,16
1650017328522,CSE 3,A51,083647,Miranda; Gregory Joseph,37,0,37,0
1650017334546,CSE 8A,A50,083650,Miranda; Gregory Joseph,0,14,40,40
1650017340571,CSE 11,A01,083080,Cao; Yingjun,0,60,40,40
1650017346599,CSE 12,A01,083652,Staff,2,0,100,98
1650017352713,CSE 15L,A01,083654,Staff,0,0,50,50
1650017352713,CSE 15L,A02,083655,Staff,15,0,50,35
1650017358741,CSE 20,A01,083657,Staff,57,0,80,23
1650017364765,CSE 30,A01,083084,Eldon; John,0,62,40,40
1650017370798,CSE 100,A01,083659,Cao; Yingjun,0,57,50,50
1650017376824,CSE 134B,A01,083661,Powell; Thomas Allan,0,24,65,65
1650017382848,CSE 140,A01,083663,Staff,8,0,75,67
1650017388875,CSE 140L,A01,083088,Eldon; John,4,0,75,71
1650017394897,CSE 175,A01,083665,Kumar; Rakesh,10,0,25,15
1650017400920,CSE 190,A00,092507,Dubnov; Shlomo,17,0,20,3
1650017406944,ECE 45,A01,083139,Staff,0,10,40,40
1650017412969,ECE 65,A50,083695,Staff,0,1,30,30
1650017418994,ECE 109,A01,091882,Touri; Behrouz,48,0,70,22
1650017425017,ECE 180,A00,083140,Abi Samra; Nicholas Camill,26,0,30,4
1650017425017,ECE 180,B00,083141,Abi Samra; Nicholas Camill,10,0,30,20
1650017431041,MATH 10A,A01,083735,Patchell; Gregory David,14,0,30,16
1650017431041,MATH 10A,A02,083736,Patchell; Gregory David,28,0,30,2
1650017431041,MATH 10A,A03,083737,Patchell; Gregory David,27,0,30,3
1650017437065,MATH 10B,A01,083207,Staff,0,4,30,30
1650017437065,MATH 10B,A02,083208,Staff,0,0,30,30
1650017437065,MATH 10B,B01,083739,Staff,20,0,30,10
1650017437065,MATH 10B,B02,083740,Staff,30,0,30,0
1650017443091,MATH 18,A01,083743,Staff,10,0,30,20
1650017443091,MATH 18,A02,083744,Staff,28,0,30,2
1650017443091,MATH 18,A03,083745,Staff,23,0,30,7
1650017443091,MATH 18,A04,083746,Staff,27,0,30,3
1650017443091,MATH 18,B01,083748,Staff,0,8,30,30
1650017443091,MATH 18,B02,083749,Staff,0,6,30,30
1650017443091,MATH 18,B03,083750,Staff,0,6,30,30
1650017443091,MATH 18,B04,083751,Staff,1,7,30,29
1650017449114,MATH 20A,A01,083754,Staff,27,0,40,13
1650017455137,MATH 20B,A01,083756,Staff,0,4,30,30
1650017455137,MATH 20B,A02,083757,Staff,4,0,30,26
1650017461160,MATH 20C,A01,083760,Staff,0,9,30,30
1650017461160,MATH 20C,A02,083761,Staff,0,10,30,30
1650017461160,MATH 20C,B01,083762,Staff,17,0,30,13
1650017461160,MATH 20C,B02,083763,Staff,28,0,30,2
1650017467190,MATH 20D,A01,083765,Staff,0,2,30,30
1650017467190,MATH 20D,A02,083766,Staff,16,0,30,14
1650017467190,MATH 20D,A03,083767,Staff,28,0,30,2
1650017473212,MATH 20E,A01,083771,Staff,11,0,30,19
1650017473212,MATH 20E,A02,083772,Staff,20,0,30,10
1650017473212,MATH 20E,B01,083773,Staff,0,1,30,30
1650017473212,MATH 20E,B02,083774,Staff,20,0,30,10
1650017479236,MATH 103A,A01,083777,Staff,0,6,30,30
1650017479236,MATH 103A,A02,083778,Staff,0,7,30,30
1650017479236,MATH 103A,B01,083779,Staff,0,6,30,30
1650017479236,MATH 103A,B02,083780,Staff,0,6,30,30
1650017485261,MATH 105,A01,085443,Staff,0,11,30,30
1650017491283,MATH 109,A01,083213,Anzaldo; Leesa B,0,3,30,30
1650017491283,MATH 109,A02,083214,Anzaldo; Leesa B,0,3,30,30
1650017491283,MATH 109,B01,083215,Anzaldo; Leesa B,0,2,30,30
1650017491283,MATH 109,B02,083216,Anzaldo; Leesa B,0,2,30,30
1650017497308,MATH 142A,A01,083219,Chow; Bennett,0,7,30,30
1650017497308,MATH 142A,A02,083220,Chow; Bennett,0,7,30,30
1650017497308,MATH 142A,B01,083221,Chow; Bennett,0,8,30,30
1650017497308,MATH 142A,B02,083222,Chow; Bennett,0,7,30,30
1650017503331,MATH 193A,A01,083224,Staff,0,5,30,30
1650017503331,MATH 193A,A02,083225,Staff,0,4,30,30
1650017503331,MATH 193A,A03,083781,Staff,0,0,30,30
1650017503331,MATH 193A,A04,083782,Staff,9,0,30,21
1650017509354,MATH 197,001,091859,McAuley; Julian John,9999,0,9999,0
1650017515403,COGS 9,A01,083615,Staff,1,15,60,59
1650017521431,COGS 11,A01,083617,Boyle; Mary E. T.,25,0,40,15
1650017527457,COGS 13,A01,083071,Staff,0,28,40,40
1650017533486,COGS 14A,A01,092681,Staff,0,6,100,100
1650017539510,COGS 14B,A01,083073,Cheng; Tzu-Han,0,2,50,50
1650017545534,COGS 17,A01,092677,Staff,35,0,75,40
1650017551560,COGS 100,A01,083619,Staff,0,18,60,60
1650017557582,COGS 101A,A01,083621,Davis; Joshua Daniel,0,16,60,60
1650017563604,COGS 101B,A01,091572,Staff,16,0,60,44
1650017569634,COGS 101C,A01,083625,Delgado; Tania,21,0,30,9
1650017575657,COGS 107A,A01,083627,Boyle; Mary E. T.,0,1,60,60
1650017581687,COGS 118A,A01,083075,Staff,19,0,60,41
1650017587716,CSE 3,A50,083646,Miranda; Gregory Joseph,22,0,38,16
1650017587716,CSE 3,A51,083647,Miranda; Gregory Joseph,37,0,37,0
1650017593739,CSE 8A,A50,083650,Miranda; Gregory Joseph,0,14,40,40
1650017599763,CSE 11,A01,083080,Cao; Yingjun,0,60,40,40
1650017605786,CSE 12,A01,083652,Staff,2,0,100,98
1650017611813,CSE 15L,A01,083654,Staff,0,0,50,50
1650017611813,CSE 15L,A02,083655,Staff,15,0,50,35
1650017617839,CSE 20,A01,083657,Staff,57,0,80,23
1650017623864,CSE 30,A01,083084,Eldon; John,0,62,40,40
1650017629887,CSE 100,A01,083659,Cao; Yingjun,0,57,50,50
1650017635911,CSE 134B,A01,083661,Powell; Thomas Allan,0,24,65,65
1650017641937,CSE 140,A01,083663,Staff,8,0,75,67
1650017647963,CSE 140L,A01,083088,Eldon; John,4,0,75,71
1650017653987,CSE 175,A01,083665,Kumar; Rakesh,10,0,25,15
1650017660042,CSE 190,A00,092507,Dubnov; Shlomo,17,0,20,3
1650017666067,ECE 45,A01,083139,Staff,0,10,40,40
1650017672093,ECE 65,A50,083695,Staff,0,1,30,30
1650017678115,ECE 109,A01,091882,Touri; Behrouz,48,0,70,22
1650017684140,ECE 180,A00,083140,Abi Samra; Nicholas Camill,26,0,30,4
1650017684140,ECE 180,B00,083141,Abi Samra; Nicholas Camill,10,0,30,20
1650017690169,MATH 10A,A01,083735,Patchell; Gregory David,14,0,30,16
1650017690169,MATH 10A,A02,083736,Patchell; Gregory David,28,0,30,2
1650017690169,MATH 10A,A03,083737,Patchell; Gregory David,27,0,30,3
1650017696196,MATH 10B,A01,083207,Staff,0,4,30,30
1650017696196,MATH 10B,A02,083208,Staff,0,0,30,30
1650017696196,MATH 10B,B01,083739,Staff,20,0,30,10
1650017696196,MATH 10B,B02,083740,Staff,30,0,30,0
1650017702226,MATH 18,A01,083743,Staff,10,0,30,20
1650017702226,MATH 18,A02,083744,Staff,28,0,30,2
1650017702226,MATH 18,A03,083745,Staff,23,0,30,7
1650017702226,MATH 18,A04,083746,Staff,27,0,30,3
1650017702226,MATH 18,B01,083748,Staff,0,8,30,30
1650017702226,MATH 18,B02,083749,Staff,0,6,30,30
1650017702226,MATH 18,B03,083750,Staff,0,6,30,30
1650017702226,MATH 18,B04,083751,Staff,1,7,30,29
1650017708254,MATH 20A,A01,083754,Staff,27,0,40,13
1650017714282,MATH 20B,A01,083756,Staff,0,4,30,30
1650017714282,MATH 20B,A02,083757,Staff,4,0,30,26
1650017720311,MATH 20C,A01,083760,Staff,0,9,30,30
1650017720311,MATH 20C,A02,083761,Staff,0,10,30,30
1650017720311,MATH 20C,B01,083762,Staff,17,0,30,13
1650017720311,MATH 20C,B02,083763,Staff,28,0,30,2
1650017726337,MATH 20D,A01,083765,Staff,0,2,30,30
1650017726337,MATH 20D,A02,083766,Staff,16,0,30,14
1650017726337,MATH 20D,A03,083767,Staff,28,0,30,2
1650017732364,MATH 20E,A01,083771,Staff,11,0,30,19
1650017732364,MATH 20E,A02,083772,Staff,20,0,30,10
1650017732364,MATH 20E,B01,083773,Staff,0,1,30,30
1650017732364,MATH 20E,B02,083774,Staff,20,0,30,10
1650017738389,MATH 103A,A01,083777,Staff,0,6,30,30
1650017738389,MATH 103A,A02,083778,Staff,0,7,30,30
1650017738389,MATH 103A,B01,083779,Staff,0,6,30,30
1650017738389,MATH 103A,B02,083780,Staff,0,6,30,30
1650017744410,MATH 105,A01,085443,Staff,0,11,30,30
1650017750439,MATH 109,A01,083213,Anzaldo; Leesa B,0,3,30,30
1650017750439,MATH 109,A02,083214,Anzaldo; Leesa B,0,3,30,30
1650017750439,MATH 109,B01,083215,Anzaldo; Leesa B,0,2,30,30
1650017750439,MATH 109,B02,083216,Anzaldo; Leesa B,0,2,30,30
1650017756475,MATH 142A,A01,083219,Chow; Bennett,0,7,30,30
1650017756475,MATH 142A,A02,083220,Chow; Bennett,0,7,30,30
1650017756475,MATH 142A,B01,083221,Chow; Bennett,0,8,30,30
1650017756475,MATH 142A,B02,083222,Chow; Bennett,0,7,30,30
1650017762499,MATH 193A,A01,083224,Staff,0,5,30,30
1650017762499,MATH 193A,A02,083225,Staff,0,4,30,30
1650017762499,MATH 193A,A03,083781,Staff,0,0,30,30
1650017762499,MATH 193A,A04,083782,Staff,9,0,30,21
1650017768525,MATH 197,001,091859,McAuley; Julian John,9999,0,9999,0
1650017774601,COGS 9,A01,083615,Staff,1,15,60,59
1650017780630,COGS 11,A01,083617,Boyle; Mary E. T.,25,0,40,15
1650017786661,COGS 13,A01,083071,Staff,0,28,40,40
1650017792685,COGS 14A,A01,092681,Staff,0,6,100,100
1650017798713,COGS 14B,A01,083073,Cheng; Tzu-Han,0,2,50,50
1650017804741,COGS 17,A01,092677,Staff,35,0,75,40
1650017810772,COGS 100,A01,083619,Staff,0,18,60,60
1650017816799,COGS 101A,A01,083621,Davis; Joshua Daniel,0,16,60,60
1650017822823,COGS 101B,A01,091572,Staff,16,0,60,44
1650017828851,COGS 101C,A01,083625,Delgado; Tania,21,0,30,9
1650017834874,COGS 107A,A01,083627,Boyle; Mary E. T.,0,1,60,60
1650017840902,COGS 118A,A01,083075,Staff,19,0,60,41
1650017846927,CSE 3,A50,083646,Miranda; Gregory Joseph,22,0,38,16
1650017846927,CSE 3,A51,083647,Miranda; Gregory Joseph,37,0,37,0
1650017852951,CSE 8A,A50,083650,Miranda; Gregory Joseph,0,14,40,40
1650017858976,CSE 11,A01,083080,Cao; Yingjun,0,60,40,40
1650017865003,CSE 12,A01,083652,Staff,2,0,100,98
1650017871027,CSE 15L,A01,083654,Staff,0,0,50,50
1650017871027,CSE 15L,A02,083655,Staff,15,0,50,35
1650017877062,CSE 20,A01,083657,Staff,57,0,80,23
1650017883088,CSE 30,A01,083084,Eldon; John,0,62,40,40
1650017889119,CSE 100,A01,083659,Cao; Yingjun,0,57,50,50
1650017895151,CSE 134B,A01,083661,Powell; Thomas Allan,0,24,65,65
1650017901178,CSE 140,A01,083663,Staff,8,0,75,67
1650017907206,CSE 140L,A01,083088,Eldon; John,4,0,75,71
1650017913230,CSE 175,A01,083665,Kumar; Rakesh,10,0,25,15
1650017919253,CSE 190,A00,092507,Dubnov; Shlomo,17,0,20,3
1650017925277,ECE 45,A01,083139,Staff,0,10,40,40
1650017931304,ECE 65,A50,083695,Staff,0,1,30,30
1650017937335,ECE 109,A01,091882,Touri; Behrouz,48,0,70,22
1650017943364,ECE 180,A00,083140,Abi Samra; Nicholas Camill,26,0,30,4
1650017943364,ECE 180,B00,083141,Abi Samra; Nicholas Camill,10,0,30,20
1650017949459,MATH 10A,A01,083735,Patchell; Gregory David,14,0,30,16
1650017949459,MATH 10A,A02,083736,Patchell; Gregory David,28,0,30,2
1650017949459,MATH 10A,A03,083737,Patchell; Gregory David,27,0,30,3
1650017955484,MATH 10B,A01,083207,Staff,0,4,30,30
1650017955484,MATH 10B,A02,083208,Staff,0,0,30,30
1650017955484,MATH 10B,B01,083739,Staff,20,0,30,10
1650017955484,MATH 10B,B02,083740,Staff,30,0,30,0
1650017961510,MATH 18,A01,083743,Staff,10,0,30,20
1650017961510,MATH 18,A02,083744,Staff,28,0,30,2
1650017961510,MATH 18,A03,083745,Staff,23,0,30,7
1650017961510,MATH 18,A04,083746,Staff,27,0,30,3
1650017961510,MATH 18,B01,083748,Staff,0,8,30,30
1650017961510,MATH 18,B02,083749,Staff,0,6,30,30
1650017961510,MATH 18,B03,083750,Staff,0,6,30,30
1650017961510,MATH 18,B04,083751,Staff,1,7,30,29
1650017967534,MATH 20A,A01,083754,Staff,27,0,40,13
1650017973561,MATH 20B,A01,083756,Staff,0,4,30,30
1650017973561,MATH 20B,A02,083757,Staff,4,0,30,26
1650017979590,MATH 20C,A01,083760,Staff,0,9,30,30
1650017979590,MATH 20C,A02,083761,Staff,0,10,30,30
1650017979590,MATH 20C,B01,083762,Staff,17,0,30,13
1650017979590,MATH 20C,B02,083763,Staff,28,0,30,2
1650017985618,MATH 20D,A01,083765,Staff,0,2,30,30
1650017985618,MATH 20D,A02,083766,Staff,16,0,30,14
1650017985618,MATH 20D,A03,083767,Staff,28,0,30,2
1650017991643,MATH 20E,A01,083771,Staff,11,0,30,19
1650017991643,MATH 20E,A02,083772,Staff,20,0,30,10
1650017991643,MATH 20E,B01,083773,Staff,0,1,30,30
1650017991643,MATH 20E,B02,083774,Staff,20,0,30,10
1650017997667,MATH 103A,A01,083777,Staff,0,6,30,30
1650017997667,MATH 103A,A02,083778,Staff,0,7,30,30
1650017997667,MATH 103A,B01,083779,Staff,0,6,30,30
1650017997667,MATH 103A,B02,083780,Staff,0,6,30,30
1650018003691,MATH 105,A01,085443,Staff,0,11,30,30
1650018009715,MATH 109,A01,083213,Anzaldo; Leesa B,0,3,30,30
1650018009715,MATH 109,A02,083214,Anzaldo; Leesa B,0,3,30,30
1650018009715,MATH 109,B01,083215,Anzaldo; Leesa B,0,2,30,30
1650018009715,MATH 109,B02,083216,Anzaldo; Leesa B,0,2,30,30
1650018015740,MATH 142A,A01,083219,Chow; Bennett,0,7,30,30
1650018015740,MATH 142A,A02,083220,Chow; Bennett,0,7,30,30
1650018015740,MATH 142A,B01,083221,Chow; Bennett,0,8,30,30
1650018015740,MATH 142A,B02,083222,Chow; Bennett,0,7,30,30
1650018021764,MATH 193A,A01,083224,Staff,0,5,30,30
1650018021764,MATH 193A,A02,083225,Staff,0,4,30,30
1650018021764,MATH 193A,A03,083781,Staff,0,0,30,30
1650018021764,MATH 193A,A04,083782,Staff,9,0,30,21
1650018027787,MATH 197,001,091859,McAuley; Julian John,9999,0,9999,0
1650018033854,COGS 9,A01,083615,Staff,1,15,60,59
1650018039881,COGS 11,A01,083617,Boyle; Mary E. T.,25,0,40,15
1650018045904,COGS 13,A01,083071,Staff,0,28,40,40
1650018051927,COGS 14A,A01,092681,Staff,0,6,100,100
1650018057951,COGS 14B,A01,083073,Cheng; Tzu-Han,0,2,50,50
1650018063977,COGS 17,A01,092677,Staff,35,0,75,40
1650018070006,COGS 100,A01,083619,Staff,0,18,60,60
1650018076035,COGS 101A,A01,083621,Davis; Joshua Daniel,0,16,60,60
1650018082065,COGS 101B,A01,091572,Staff,16,0,60,44
1650018088090,COGS 101C,A01,083625,Delgado; Tania,21,0,30,9
1650018094114,COGS 107A,A01,083627,Boyle; Mary E. T.,0,1,60,60
1650018100137,COGS 118A,A01,083075,Staff,19,0,60,41
1650018106162,CSE 3,A50,083646,Miranda; Gregory Joseph,22,0,38,16
1650018106162,CSE 3,A51,083647,Miranda; Gregory Joseph,37,0,37,0
1650018112190,CSE 8A,A50,083650,Miranda; Gregory Joseph,0,14,40,40
1650018118217,CSE 11,A01,083080,Cao; Yingjun,0,60,40,40
1650018124243,CSE 12,A01,083652,Staff,2,0,100,98
1650018130268,CSE 15L,A01,083654,Staff,0,0,50,50
1650018130268,CSE 15L,A02,083655,Staff,15,0,50,35
1650018136291,CSE 20,A01,083657,Staff,57,0,80,23
1650018142314,CSE 30,A01,083084,Eldon; John,0,62,40,40
1650018148341,CSE 100,A01,083659,Cao; Yingjun,0,57,50,50
1650018154368,CSE 134B,A01,083661,Powell; Thomas Allan,0,24,65,65
1650018160392,CSE 140,A01,083663,Staff,8,0,75,67
1650018166415,CSE 140L,A01,083088,Eldon; John,4,0,75,71
1650018172439,CSE 175,A01,083665,Kumar; Rakesh,10,0,25,15
1650018178463,CSE 190,A00,092507,Dubnov; Shlomo,17,0,20,3
1650018184487,ECE 45,A01,083139,Staff,0,10,40,40
1650018190515,ECE 65,A50,083695,Staff,0,1,30,30
1650018196545,ECE 109,A01,091882,Touri; Behrouz,48,0,70,22
1650018202569,ECE 180,A00,083140,Abi Samra; Nicholas Camill,26,0,30,4
1650018202569,ECE 180,B00,083141,Abi Samra; Nicholas Camill,10,0,30,20
1650018208601,MATH 10A,A01,083735,Patchell; Gregory David,14,0,30,16
1650018208601,MATH 10A,A02,083736,Patchell; Gregory David,28,0,30,2
1650018208601,MATH 10A,A03,083737,Patchell; Gregory David,27,0,30,3
1650018214638,MATH 10B,A01,083207,Staff,0,4,30,30
1650018214638,MATH 10B,A02,083208,Staff,0,0,30,30
1650018214638,MATH 10B,B01,083739,Staff,20,0,30,10
1650018214638,MATH 10B,B02,083740,Staff,30,0,30,0
1650018220672,MATH 18,A01,083743,Staff,10,0,30,20
1650018220672,MATH 18,A02,083744,Staff,28,0,30,2
1650018220672,MATH 18,A03,083745,Staff,23,0,30,7
1650018220672,MATH 18,A04,083746,Staff,27,0,30,3
1650018220672,MATH 18,B01,083748,Staff,0,8,30,30
1650018220672,MATH 18,B02,083749,Staff,0,6,30,30
1650018220672,MATH 18,B03,083750,Staff,0,6,30,30
1650018220672,MATH 18,B04,083751,Staff,1,7,30,29
1650018226695,MATH 20A,A01,083754,Staff,27,0,40,13
1650018232727,MATH 20B,A01,083756,Staff,0,4,30,30
1650018232727,MATH 20B,A02,083757,Staff,4,0,30,26
1650018238756,MATH 20C,A01,083760,Staff,0,9,30,30
1650018238756,MATH 20C,A02,083761,Staff,0,10,30,30
1650018238756,MATH 20C,B01,083762,Staff,17,0,30,13
1650018238756,MATH 20C,B02,083763,Staff,28,0,30,2
1650018244781,MATH 20D,A01,083765,Staff,0,2,30,30
1650018244781,MATH 20D,A02,083766,Staff,16,0,30,14
1650018244781,MATH 20D,A03,083767,Staff,28,0,30,2
1650018250808,MATH 20E,A01,083771,Staff,11,0,30,19
1650018250808,MATH 20E,A02,083772,Staff,20,0,30,10
1650018250808,MATH 20E,B01,083773,Staff,0,1,30,30
1650018250808,MATH 20E,B02,083774,Staff,20,0,30,10
1650018256834,MATH 103A,A01,083777,Staff,0,6,30,30
1650018256834,MATH 103A,A02,083778,Staff,0,7,30,30
1650018256834,MATH 103A,B01,083779,Staff,0,6,30,30
1650018256834,MATH 103A,B02,083780,Staff,0,6,30,30
1650018262858,MATH 105,A01,085443,Staff,0,11,30,30
1650018268887,MATH 109,A01,083213,Anzaldo; Leesa B,0,3,30,30
1650018268887,MATH 109,A02,083214,Anzaldo; Leesa B,0,3,30,30
1650018268887,MATH 109,B01,083215,Anzaldo; Leesa B,0,2,30,30
1650018268887,MATH 109,B02,083216,Anzaldo; Leesa B,0,2,30,30
1650018274917,MATH 142A,A01,083219,Chow; Bennett,0,7,30,30
1650018274917,MATH 142A,A02,083220,Chow; Bennett,0,7,30,30
1650018274917,MATH 142A,B01,083221,Chow; Bennett,0,8,30,30
1650018274917,MATH 142A,B02,083222,Chow; Bennett,0,7,30,30
1650018280939,MATH 193A,A01,083224,Staff,0,5,30,30
1650018280939,MATH 193A,A02,083225,Staff,0,4,30,30
1650018280939,MATH 193A,A03,083781,Staff,0,0,30,30
1650018280939,MATH 193A,A04,083782,Staff,9,0,30,21
1650018286962,MATH 197,001,091859,McAuley; Julian John,9999,0,9999,0
1650018293016,COGS 9,A01,083615,Staff,1,15,60,59
1650018299044,COGS 11,A01,083617,Boyle; Mary E. T.,25,0,40,15
1650018305085,COGS 13,A01,083071,Staff,0,28,40,40
1650018311109,COGS 14A,A01,092681,Staff,0,6,100,100
1650018317130,COGS 14B,A01,083073,Cheng; Tzu-Han,0,2,50,50
1650018323158,COGS 17,A01,092677,Staff,35,0,75,40
1650018329180,COGS 100,A01,083619,Staff,0,18,60,60
1650018335202,COGS 101A,A01,083621,Davis; Joshua Daniel,0,16,60,60
1650018341224,COGS 101B,A01,091572,Staff,16,0,60,44
1650018347246,COGS 101C,A01,083625,Delgado; Tania,21,0,30,9
1650018353270,COGS 107A,A01,083627,Boyle; Mary E. T.,0,1,60,60
1650018359293,COGS 118A,A01,083075,Staff,19,0,60,41
1650018365315,CSE 3,A50,083646,Miranda; Gregory Joseph,22,0,38,16
1650018365315,CSE 3,A51,083647,Miranda; Gregory Joseph,37,0,37,0
1650018371351,CSE 8A,A50,083650,Miranda; Gregory Joseph,0,14,40,40
1650018377377,CSE 11,A01,083080,Cao; Yingjun,0,60,40,40
1650018383401,CSE 12,A01,083652,Staff,2,0,100,98
1650018389424,CSE 15L,A01,083654,Staff,0,0,50,50
1650018389424,CSE 15L,A02,083655,Staff,15,0,50,35
1650018395447,CSE 20,A01,083657,Staff,57,0,80,23
1650018401469,CSE 30,A01,083084,Eldon; John,0,62,40,40
1650018407497,CSE 100,A01,083659,Cao; Yingjun,0,57,50,50
1650018413520,CSE 134B,A01,083661,Powell; Thomas Allan,0,24,65,65
1650018419543,CSE 140,A01,083663,Staff,8,0,75,67
1650018425573,CSE 140L,A01,083088,Eldon; John,4,0,75,71
1650018431600,CSE 175,A01,083665,Kumar; Rakesh,10,0,25,15
1650018437627,CSE 190,A00,092507,Dubnov; Shlomo,17,0,20,3
1650018443660,ECE 45,A01,083139,Staff,0,10,40,40
1650018449684,ECE 65,A50,083695,Staff,0,1,30,30
1650018455709,ECE 109,A01,091882,Touri; Behrouz,48,0,70,22
1650018461736,ECE 180,A00,083140,Abi Samra; Nicholas Camill,26,0,30,4
1650018461736,ECE 180,B00,083141,Abi Samra; Nicholas Camill,10,0,30,20
1650018467764,MATH 10A,A01,083735,Patchell; Gregory David,14,0,30,16
1650018467764,MATH 10A,A02,083736,Patchell; Gregory David,28,0,30,2
1650018467764,MATH 10A,A03,083737,Patchell; Gregory David,27,0,30,3
1650018473789,MATH 10B,A01,083207,Staff,0,4,30,30
1650018473789,MATH 10B,A02,083208,Staff,0,0,30,30
1650018473789,MATH 10B,B01,083739,Staff,20,0,30,10
1650018473789,MATH 10B,B02,083740,Staff,30,0,30,0
1650018479814,MATH 18,A01,083743,Staff,10,0,30,20
1650018479814,MATH 18,A02,083744,Staff,28,0,30,2
1650018479814,MATH 18,A03,083745,Staff,23,0,30,7
1650018479814,MATH 18,A04,083746,Staff,27,0,30,3
1650018479814,MATH 18,B01,083748,Staff,0,8,30,30
1650018479814,MATH 18,B02,083749,Staff,0,6,30,30
1650018479814,MATH 18,B03,083750,Staff,0,6,30,30
1650018479814,MATH 18,B04,083751,Staff,1,7,30,29
1650018485837,MATH 20A,A01,083754,Staff,27,0,40,13
1650018491863,MATH 20B,A01,083756,Staff,0,4,30,30
1650018491863,MATH 20B,A02,083757,Staff,4,0,30,26
1650018497888,MATH 20C,A01,083760,Staff,0,9,30,30
1650018497888,MATH 20C,A02,083761,Staff,0,10,30,30
1650018497888,MATH 20C,B01,083762,Staff,17,0,30,13
1650018497888,MATH 20C,B02,083763,Staff,28,0,30,2
1650018503911,MATH 20D,A01,083765,Staff,0,2,30,30
1650018503911,MATH 20D,A02,083766,Staff,16,0,30,14
1650018503911,MATH 20D,A03,083767,Staff,28,0,30,2
1650018509936,MATH 20E,A01,083771,Staff,11,0,30,19
1650018509936,MATH 20E,A02,083772,Staff,20,0,30,10
1650018509936,MATH 20E,B01,083773,Staff,0,1,30,30
1650018509936,MATH 20E,B02,083774,Staff,20,0,30,10
1650018515960,MATH 103A,A01,083777,Staff,0,6,30,30
1650018515960,MATH 103A,A02,083778,Staff,0,7,30,30
1650018515960,MATH 103A,B01,083779,Staff,0,6,30,30
1650018515960,MATH 103A,B02,083780,Staff,0,6,30,30
1650018521984,MATH 105,A01,085443,Staff,0,11,30,30
1650018528008,MATH 109,A01,083213,Anzaldo; Leesa B,0,3,30,30
1650018528008,MATH 109,A02,083214,Anzaldo; Leesa B,0,3,30,30
1650018528008,MATH 109,B01,083215,Anzaldo; Leesa B,0,2,30,30
1650018528008,MATH 109,B02,083216,Anzaldo; Leesa B,0,2,30,30
1650018534034,MATH 142A,A01,083219,Chow; Bennett,0,7,30,30
1650018534034,MATH 142A,A02,083220,Chow; Bennett,0,7,30,30
1650018534034,MATH 142A,B01,083221,Chow; Bennett,0,8,30,30
1650018534034,MATH 142A,B02,083222,Chow; Bennett,0,7,30,30
1650018540066,MATH 193A,A01,083224,Staff,0,5,30,30
1650018540066,MATH 193A,A02,083225,Staff,0,4,30,30
1650018540066,MATH 193A,A03,083781,Staff,0,0,30,30
1650018540066,MATH 193A,A04,083782,Staff,9,0,30,21
1650018546178,MATH 197,001,091859,McAuley; Julian John,9999,0,9999,0
1650018552238,COGS 9,A01,083615,Staff,1,15,60,59
1650018558265,COGS 11,A01,083617,Boyle; Mary E. T.,25,0,40,15
1650018564288,COGS 13,A01,083071,Staff,0,28,40,40
1650018570312,COGS 14A,A01,092681,Staff,0,6,100,100
1650018576335,COGS 14B,A01,083073,Cheng; Tzu-Han,0,2,50,50
1650018582362,COGS 17,A01,092677,Staff,35,0,75,40
1650018588388,COGS 100,A01,083619,Staff,0,18,60,60
1650018594410,COGS 101A,A01,083621,Davis; Joshua Daniel,0,16,60,60
1650018600437,COGS 101B,A01,091572,Staff,16,0,60,44
1650018606464,COGS 101C,A01,083625,Delgado; Tania,21,0,30,9
1650018612491,COGS 107A,A01,083627,Boyle; Mary E. T.,0,1,60,60
1650018618516,COGS 118A,A01,083075,Staff,19,0,60,41
1650018624543,CSE 3,A50,083646,Miranda; Gregory Joseph,22,0,38,16
1650018624543,CSE 3,A51,083647,Miranda; Gregory Joseph,37,0,37,0
1650018630571,CSE 8A,A50,083650,Miranda; Gregory Joseph,0,14,40,40
1650018636596,CSE 11,A01,083080,Cao; Yingjun,0,60,40,40
1650018642628,CSE 12,A01,083652,Staff,2,0,100,98
1650018648650,CSE 15L,A01,083654,Staff,0,0,50,50
1650018648650,CSE 15L,A02,083655,Staff,15,0,50,35
1650018654678,CSE 20,A01,083657,Staff,57,0,80,23
1650018660705,CSE 30,A01,083084,Eldon; John,0,62,40,40
1650018666732,CSE 100,A01,083659,Cao; Yingjun,0,57,50,50
1650018672755,CSE 134B,A01,083661,Powell; Thomas Allan,0,24,65,65
1650018678785,CSE 140,A01,083663,Staff,8,0,75,67
1650018684811,CSE 140L,A01,083088,Eldon; John,4,0,75,71
1650018690849,CSE 175,A01,083665,Kumar; Rakesh,10,0,25,15
1650018696873,CSE 190,A00,092507,Dubnov; Shlomo,17,0,20,3
1650018702900,ECE 45,A01,083139,Staff,0,10,40,40
1650018708923,ECE 65,A50,083695,Staff,0,1,30,30
1650018714949,ECE 109,A01,091882,Touri; Behrouz,48,0,70,22
1650018720974,ECE 180,A00,083140,Abi Samra; Nicholas Camill,26,0,30,4
1650018720974,ECE 180,B00,083141,Abi Samra; Nicholas Camill,10,0,30,20
1650018727008,MATH 10A,A01,083735,Patchell; Gregory David,14,0,30,16
1650018727008,MATH 10A,A02,083736,Patchell; Gregory David,28,0,30,2
1650018727008,MATH 10A,A03,083737,Patchell; Gregory David,27,0,30,3
1650018733031,MATH 10B,A01,083207,Staff,0,4,30,30
1650018733031,MATH 10B,A02,083208,Staff,0,0,30,30
1650018733031,MATH 10B,B01,083739,Staff,20,0,30,10
1650018733031,MATH 10B,B02,083740,Staff,30,0,30,0
1650018739064,MATH 18,A01,083743,Staff,10,0,30,20
1650018739064,MATH 18,A02,083744,Staff,28,0,30,2
1650018739064,MATH 18,A03,083745,Staff,23,0,30,7
1650018739064,MATH 18,A04,083746,Staff,27,0,30,3
1650018739064,MATH 18,B01,083748,Staff,0,8,30,30
1650018739064,MATH 18,B02,083749,Staff,0,6,30,30
1650018739064,MATH 18,B03,083750,Staff,0,6,30,30
1650018739064,MATH 18,B04,083751,Staff,1,7,30,29
1650018745097,MATH 20A,A01,083754,Staff,27,0,40,13
1650018751120,MATH 20B,A01,083756,Staff,0,4,30,30
1650018751120,MATH 20B,A02,083757,Staff,4,0,30,26
1650018757144,MATH 20C,A01,083760,Staff,0,9,30,30
1650018757144,MATH 20C,A02,083761,Staff,0,10,30,30
1650018757144,MATH 20C,B01,083762,Staff,17,0,30,13
1650018757144,MATH 20C,B02,083763,Staff,28,0,30,2
1650018763170,MATH 20D,A01,083765,Staff,0,2,30,30
1650018763170,MATH 20D,A02,083766,Staff,16,0,30,14
1650018763170,MATH 20D,A03,083767,Staff,28,0,30,2
1650018769200,MATH 20E,A01,083771,Staff,11,0,30,19
1650018769200,MATH 20E,A02,083772,Staff,20,0,30,10
1650018769200,MATH 20E,B01,083773,Staff,0,1,30,30
1650018769200,MATH 20E,B02,083774,Staff,20,0,30,10
1650018775228,MATH 103A,A01,083777,Staff,0,6,30,30
1650018775228,MATH 103A,A02,083778,Staff,0,7,30,30
1650018775228,MATH 103A,B01,083779,Staff,0,6,30,30
1650018775228,MATH 103A,B02,083780,Staff,0,6,30,30
1650018781250,MATH 105,A01,085443,Staff,0,11,30,30
1650018787277,MATH 109,A01,083213,Anzaldo; Leesa B,0,3,30,30
1650018787277,MATH 109,A02,083214,Anzaldo; Leesa B,0,3,30,30
1650018787277,MATH 109,B01,083215,Anzaldo; Leesa B,0,2,30,30
1650018787277,MATH 109,B02,083216,Anzaldo; Leesa B,0,2,30,30
1650018793302,MATH 142A,A01,083219,Chow; Bennett,0,7,30,30
1650018793302,MATH 142A,A02,083220,Chow; Bennett,0,7,30,30
1650018793302,MATH 142A,B01,083221,Chow; Bennett,0,8,30,30
1650018793302,MATH 142A,B02,083222,Chow; Bennett,0,7,30,30
1650018799330,MATH 193A,A01,083224,Staff,0,5,30,30
1650018799330,MATH 193A,A02,083225,Staff,0,4,30,30
1650018799330,MATH 193A,A03,083781,Staff,0,0,30,30
1650018799330,MATH 193A,A04,083782,Staff,9,0,30,21
1650018805350,MATH 197,001,091859,McAuley; Julian John,9999,0,9999,0
1650018811415,COGS 9,A01,083615,Staff,1,15,60,59
1650018817438,COGS 11,A01,083617,Boyle; Mary E. T.,25,0,40,15
1650018823462,COGS 13,A01,083071,Staff,0,28,40,40
1650018829485,COGS 14A,A01,092681,Staff,0,6,100,100
1650018835509,COGS 14B,A01,083073,Cheng; Tzu-Han,0,2,50,50
1650018841534,COGS 17,A01,092677,Staff,35,0,75,40
1650018847562,COGS 100,A01,083619,Staff,0,18,60,60
1650018853584,COGS 101A,A01,083621,Davis; Joshua Daniel,0,16,60,60
1650018859621,COGS 101B,A01,091572,Staff,16,0,60,44
1650018865643,COGS 101C,A01,083625,Delgado; Tania,21,0,30,9
1650018871691,COGS 107A,A01,083627,Boyle; Mary E. T.,0,1,60,60
1650018877717,COGS 118A,A01,083075,Staff,19,0,60,41
1650018883739,CSE 3,A50,083646,Miranda; Gregory Joseph,22,0,38,16
1650018883739,CSE 3,A51,083647,Miranda; Gregory Joseph,37,0,37,0
1650018889762,CSE 8A,A50,083650,Miranda; Gregory Joseph,0,14,40,40
1650018895785,CSE 11,A01,083080,Cao; Yingjun,0,60,40,40
1650018901813,CSE 12,A01,083652,Staff,2,0,100,98
1650018907837,CSE 15L,A01,083654,Staff,0,0,50,50
1650018907837,CSE 15L,A02,083655,Staff,15,0,50,35
1650018913859,CSE 20,A01,083657,Staff,57,0,80,23
1650018919891,CSE 30,A01,083084,Eldon; John,0,62,40,40
1650018925913,CSE 100,A01,083659,Cao; Yingjun,0,57,50,50
1650018931936,CSE 134B,A01,083661,Powell; Thomas Allan,0,24,65,65
1650018937961,CSE 140,A01,083663,Staff,8,0,75,67
1650018943998,CSE 140L,A01,083088,Eldon; John,4,0,75,71
1650018950021,CSE 175,A01,083665,Kumar; Rakesh,10,0,25,15
1650018956047,CSE 190,A00,092507,Dubnov; Shlomo,17,0,20,3
1650018962076,ECE 45,A01,083139,Staff,0,10,40,40
1650018968100,ECE 65,A50,083695,Staff,0,1,30,30
1650018974153,ECE 109,A01,091882,Touri; Behrouz,48,0,70,22
1650018980178,ECE 180,A00,083140,Abi Samra; Nicholas Camill,26,0,30,4
1650018980178,ECE 180,B00,083141,Abi Samra; Nicholas Camill,10,0,30,20
1650018986201,MATH 10A,A01,083735,Patchell; Gregory David,14,0,30,16
1650018986201,MATH 10A,A02,083736,Patchell; Gregory David,28,0,30,2
1650018986201,MATH 10A,A03,083737,Patchell; Gregory David,27,0,30,3
1650018992226,MATH 10B,A01,083207,Staff,0,4,30,30
1650018992226,MATH 10B,A02,083208,Staff,0,0,30,30
1650018992226,MATH 10B,B01,083739,Staff,20,0,30,10
1650018992226,MATH 10B,B02,083740,Staff,30,0,30,0
1650018998263,MATH 18,A01,083743,Staff,10,0,30,20
1650018998263,MATH 18,A02,083744,Staff,28,0,30,2
1650018998263,MATH 18,A03,083745,Staff,23,0,30,7
1650018998263,MATH 18,A04,083746,Staff,27,0,30,3
1650018998263,MATH 18,B01,083748,Staff,0,8,30,30
1650018998263,MATH 18,B02,083749,Staff,0,6,30,30
1650018998263,MATH 18,B03,083750,Staff,0,6,30,30
1650018998263,MATH 18,B04,083751,Staff,1,7,30,29
1650019004286,MATH 20A,A01,083754,Staff,27,0,40,13
1650019010311,MATH 20B,A01,083756,Staff,0,4,30,30
1650019010311,MATH 20B,A02,083757,Staff,4,0,30,26
1650019016333,MATH 20C,A01,083760,Staff,0,9,30,30
1650019016333,MATH 20C,A02,083761,Staff,0,10,30,30
1650019016333,MATH 20C,B01,083762,Staff,17,0,30,13
1650019016333,MATH 20C,B02,083763,Staff,28,0,30,2
1650019022356,MATH 20D,A01,083765,Staff,0,2,30,30
1650019022356,MATH 20D,A02,083766,Staff,16,0,30,14
1650019022356,MATH 20D,A03,083767,Staff,28,0,30,2
1650019028380,MATH 20E,A01,083771,Staff,11,0,30,19
1650019028380,MATH 20E,A02,083772,Staff,20,0,30,10
1650019028380,MATH 20E,B01,083773,Staff,0,1,30,30
1650019028380,MATH 20E,B02,083774,Staff,20,0,30,10
1650019034410,MATH 103A,A01,083777,Staff,0,6,30,30
1650019034410,MATH 103A,A02,083778,Staff,0,7,30,30
1650019034410,MATH 103A,B01,083779,Staff,0,6,30,30
1650019034410,MATH 103A,B02,083780,Staff,0,6,30,30
1650019040442,MATH 105,A01,085443,Staff,0,11,30,30
1650019046473,MATH 109,A01,083213,Anzaldo; Leesa B,0,3,30,30
1650019046473,MATH 109,A02,083214,Anzaldo; Leesa B,0,3,30,30
1650019046473,MATH 109,B01,083215,Anzaldo; Leesa B,0,2,30,30
1650019046473,MATH 109,B02,083216,Anzaldo; Leesa B,0,2,30,30
1650019052504,MATH 142A,A01,083219,Chow; Bennett,0,7,30,30
1650019052504,MATH 142A,A02,083220,Chow; Bennett,0,7,30,30
1650019052504,MATH 142A,B01,083221,Chow; Bennett,0,8,30,30
1650019052504,MATH 142A,B02,083222,Chow; Bennett,0,7,30,30
1650019058541,MATH 193A,A01,083224,Staff,0,5,30,30
1650019058541,MATH 193A,A02,083225,Staff,0,4,30,30
1650019058541,MATH 193A,A03,083781,Staff,0,0,30,30
1650019058541,MATH 193A,A04,083782,Staff,9,0,30,21
1650019064567,MATH 197,001,091859,McAuley; Julian John,9999,0,9999,0
1650019070643,COGS 9,A01,083615,Staff,1,15,60,59
1650019076669,COGS 11,A01,083617,Boyle; Mary E. T.,25,0,40,15
1650019082700,COGS 13,A01,083071,Staff,0,28,40,40
1650019088725,COGS 14A,A01,092681,Staff,0,6,100,100
1650019094755,COGS 14B,A01,083073,Cheng; Tzu-Han,0,2,50,50
1650019100783,COGS 17,A01,092677,Staff,35,0,75,40
1650019106813,COGS 100,A01,083619,Staff,0,18,60,60
1650019112838,COGS 101A,A01,083621,Davis; Joshua Daniel,0,16,60,60
1650019118863,COGS 101B,A01,091572,Staff,16,0,60,44
1650019124888,COGS 101C,A01,083625,Delgado; Tania,21,0,30,9
1650019130912,COGS 107A,A01,083627,Boyle; Mary E. T.,0,1,60,60
1650019137028,COGS 118A,A01,083075,Staff,19,0,60,41
1650019143067,CSE 3,A50,083646,Miranda; Gregory Joseph,22,0,38,16
1650019143067,CSE 3,A51,083647,Miranda; Gregory Joseph,37,0,37,0
1650019149092,CSE 8A,A50,083650,Miranda; Gregory Joseph,0,14,40,40
1650019155120,CSE 11,A01,083080,Cao; Yingjun,0,60,40,40
1650019161144,CSE 12,A01,083652,Staff,2,0,100,98
1650019167174,CSE 15L,A01,083654,Staff,0,0,50,50
1650019167174,CSE 15L,A02,083655,Staff,15,0,50,35
1650019173203,CSE 20,A01,083657,Staff,57,0,80,23
1650019179226,CSE 30,A01,083084,Eldon; John,0,62,40,40
1650019185251,CSE 100,A01,083659,Cao; Yingjun,0,57,50,50
1650019191275,CSE 134B,A01,083661,Powell; Thomas Allan,0,24,65,65
1650019197298,CSE 140,A01,083663,Staff,8,0,75,67
1650019203326,CSE 140L,A01,083088,Eldon; John,4,0,75,71
1650019209357,CSE 175,A01,083665,Kumar; Rakesh,10,0,25,15
1650019215383,CSE 190,A00,092507,Dubnov; Shlomo,17,0,20,3
1650019221406,ECE 45,A01,083139,Staff,0,10,40,40
1650019227440,ECE 65,A50,083695,Staff,0,1,30,30
1650019233466,ECE 109,A01,091882,Touri; Behrouz,48,0,70,22
1650019239491,ECE 180,A00,083140,Abi Samra; Nicholas Camill,26,0,30,4
1650019239491,ECE 180,B00,083141,Abi Samra; Nicholas Camill,10,0,30,20
1650019245518,MATH 10A,A01,083735,Patchell; Gregory David,14,0,30,16
1650019245518,MATH 10A,A02,083736,Patchell; Gregory David,28,0,30,2
1650019245518,MATH 10A,A03,083737,Patchell; Gregory David,27,0,30,3
1650019251549,MATH 10B,A01,083207,Staff,0,4,30,30
1650019251549,MATH 10B,A02,083208,Staff,0,0,30,30
1650019251549,MATH 10B,B01,083739,Staff,20,0,30,10
1650019251549,MATH 10B,B02,083740,Staff,30,0,30,0
1650019257584,MATH 18,A01,083743,Staff,10,0,30,20
1650019257584,MATH 18,A02,083744,Staff,28,0,30,2
1650019257584,MATH 18,A03,083745,Staff,23,0,30,7
1650019257584,MATH 18,A04,083746,Staff,27,0,30,3
1650019257584,MATH 18,B01,083748,Staff,0,8,30,30
1650019257584,MATH 18,B02,083749,Staff,0,6,30,30
1650019257584,MATH 18,B03,083750,Staff,0,6,30,30
1650019257584,MATH 18,B04,083751,Staff,1,7,30,29
1650019263609,MATH 20A,A01,083754,Staff,27,0,40,13
1650019269635,MATH 20B,A01,083756,Staff,0,4,30,30
1650019269635,MATH 20B,A02,083757,Staff,4,0,30,26
1650019275662,MATH 20C,A01,083760,Staff,0,9,30,30
1650019275662,MATH 20C,A02,083761,Staff,0,10,30,30
1650019275662,MATH 20C,B01,083762,Staff,17,0,30,13
1650019275662,MATH 20C,B02,083763,Staff,28,0,30,2
1650019281685,MATH 20D,A01,083765,Staff,0,2,30,30
1650019281685,MATH 20D,A02,083766,Staff,16,0,30,14
1650019281685,MATH 20D,A03,083767,Staff,28,0,30,2
1650019287726,MATH 20E,A01,083771,Staff,11,0,30,19
1650019287726,MATH 20E,A02,083772,Staff,20,0,30,10
1650019287726,MATH 20E,B01,083773,Staff,0,1,30,30
1650019287726,MATH 20E,B02,083774,Staff,20,0,30,10
1650019293758,MATH 103A,A01,083777,Staff,0,6,30,30
1650019293758,MATH 103A,A02,083778,Staff,0,7,30,30
1650019293758,MATH 103A,B01,083779,Staff,0,6,30,30
1650019293758,MATH 103A,B02,083780,Staff,0,6,30,30
1650019299792,MATH 105,A01,085443,Staff,0,11,30,30
1650019305824,MATH 109,A01,083213,Anzaldo; Leesa B,0,3,30,30
1650019305824,MATH 109,A02,083214,Anzaldo; Leesa B,0,3,30,30
1650019305824,MATH 109,B01,083215,Anzaldo; Leesa B,0,2,30,30
1650019305824,MATH 109,B02,083216,Anzaldo; Leesa B,0,2,30,30
1650019311849,MATH 142A,A01,083219,Chow; Bennett,0,7,30,30
1650019311849,MATH 142A,A02,083220,Chow; Bennett,0,7,30,30
1650019311849,MATH 142A,B01,083221,Chow; Bennett,0,8,30,30
1650019311849,MATH 142A,B02,083222,Chow; Bennett,0,7,30,30
1650019317876,MATH 193A,A01,083224,Staff,0,5,30,30
1650019317876,MATH 193A,A02,083225,Staff,0,4,30,30
1650019317876,MATH 193A,A03,083781,Staff,0,0,30,30
1650019317876,MATH 193A,A04,083782,Staff,9,0,30,21
1650019323901,MATH 197,001,091859,McAuley; Julian John,9999,0,9999,0
1650019329985,COGS 9,A01,083615,Staff,1,15,60,59
1650019336015,COGS 11,A01,083617,Boyle; Mary E. T.,25,0,40,15
1650019342040,COGS 13,A01,083071,Staff,0,28,40,40
1650019348072,COGS 14A,A01,092681,Staff,0,6,100,100
1650019354097,COGS 14B,A01,083073,Cheng; Tzu-Han,0,2,50,50
1650019360124,COGS 17,A01,092677,Staff,35,0,75,40
1650019366149,COGS 100,A01,083619,Staff,0,18,60,60
1650019372179,COGS 101A,A01,083621,Davis; Joshua Daniel,0,16,60,60
1650019378210,COGS 101B,A01,091572,Staff,16,0,60,44
1650019384237,COGS 101C,A01,083625,Delgado; Tania,21,0,30,9
1650019390259,COGS 107A,A01,083627,Boyle; Mary E. T.,0,1,60,60
1650019396282,COGS 118A,A01,083075,Staff,19,0,60,41
1650019402315,CSE 3,A50,083646,Miranda; Gregory Joseph,22,0,38,16
1650019402315,CSE 3,A51,083647,Miranda; Gregory Joseph,37,0,37,0
1650019408338,CSE 8A,A50,083650,Miranda; Gregory Joseph,0,14,40,40
1650019414368,CSE 11,A01,083080,Cao; Yingjun,0,60,40,40
1650019420392,CSE 12,A01,083652,Staff,2,0,100,98
1650019426418,CSE 15L,A01,083654,Staff,0,0,50,50
1650019426418,CSE 15L,A02,083655,Staff,15,0,50,35
1650019432444,CSE 20,A01,083657,Staff,57,0,80,23
1650019438474,CSE 30,A01,083084,Eldon; John,0,62,40,40
1650019444499,CSE 100,A01,083659,Cao; Yingjun,0,57,50,50
1650019450522,CSE 134B,A01,083661,Powell; Thomas Allan,0,24,65,65
1650019456548,CSE 140,A01,083663,Staff,8,0,75,67
1650019462578,CSE 140L,A01,083088,Eldon; John,4,0,75,71
1650019468612,CSE 175,A01,083665,Kumar; Rakesh,10,0,25,15
1650019474643,CSE 190,A00,092507,Dubnov; Shlomo,17,0,20,3
1650019480667,ECE 45,A01,083139,Staff,0,10,40,40
1650019486692,ECE 65,A50,083695,Staff,0,1,30,30
1650019492723,ECE 109,A01,091882,Touri; Behrouz,48,0,70,22
1650019498749,ECE 180,A00,083140,Abi Samra; Nicholas Camill,26,0,30,4
1650019498749,ECE 180,B00,083141,Abi Samra; Nicholas Camill,10,0,30,20
1650019504775,MATH 10A,A01,083735,Patchell; Gregory David,14,0,30,16
1650019504775,MATH 10A,A02,083736,Patchell; Gregory David,28,0,30,2
1650019504775,MATH 10A,A03,083737,Patchell; Gregory David,27,0,30,3
1650019510814,MATH 10B,A01,083207,Staff,0,4,30,30
1650019510814,MATH 10B,A02,083208,Staff,0,0,30,30
1650019510814,MATH 10B,B01,083739,Staff,20,0,30,10
1650019510814,MATH 10B,B02,083740,Staff,30,0,30,0
1650019516842,MATH 18,A01,083743,Staff,10,0,30,20
1650019516842,MATH 18,A02,083744,Staff,28,0,30,2
1650019516842,MATH 18,A03,083745,Staff,23,0,30,7
1650019516842,MATH 18,A04,083746,Staff,27,0,30,3
1650019516842,MATH 18,B01,083748,Staff,0,8,30,30
1650019516842,MATH 18,B02,083749,Staff,0,6,30,30
1650019516842,MATH 18,B03,083750,Staff,0,6,30,30
1650019516842,MATH 18,B04,083751,Staff,1,7,30,29
1650019522872,MATH 20A,A01,083754,Staff,27,0,40,13
1650019528897,MATH 20B,A01,083756,Staff,0,4,30,30
1650019528897,MATH 20B,A02,083757,Staff,4,0,30,26
1650019534922,MATH 20C,A01,083760,Staff,0,9,30,30
1650019534922,MATH 20C,A02,083761,Staff,0,10,30,30
1650019534922,MATH 20C,B01,083762,Staff,17,0,30,13
1650019534922,MATH 20C,B02,083763,Staff,28,0,30,2
1650019540945,MATH 20D,A01,083765,Staff,0,2,30,30
1650019540945,MATH 20D,A02,083766,Staff,16,0,30,14
1650019540945,MATH 20D,A03,083767,Staff,28,0,30,2
1650019546975,MATH 20E,A01,083771,Staff,11,0,30,19
1650019546975,MATH 20E,A02,083772,Staff,20,0,30,10
1650019546975,MATH 20E,B01,083773,Staff,0,1,30,30
1650019546975,MATH 20E,B02,083774,Staff,20,0,30,10
1650019552999,MATH 103A,A01,083777,Staff,0,6,30,30
1650019552999,MATH 103A,A02,083778,Staff,0,7,30,30
1650019552999,MATH 103A,B01,083779,Staff,0,7,30,30
1650019552999,MATH 103A,B02,083780,Staff,0,6,30,30
1650019559038,MATH 105,A01,085443,Staff,0,11,30,30
1650019565062,MATH 109,A01,083213,Anzaldo; Leesa B,0,3,30,30
1650019565062,MATH 109,A02,083214,Anzaldo; Leesa B,0,3,30,30
1650019565062,MATH 109,B01,083215,Anzaldo; Leesa B,0,2,30,30
1650019565062,MATH 109,B02,083216,Anzaldo; Leesa B,0,2,30,30
1650019571092,MATH 142A,A01,083219,Chow; Bennett,0,7,30,30
1650019571092,MATH 142A,A02,083220,Chow; Bennett,0,7,30,30
1650019571092,MATH 142A,B01,083221,Chow; Bennett,0,8,30,30
1650019571092,MATH 142A,B02,083222,Chow; Bennett,0,7,30,30
1650019577118,MATH 193A,A01,083224,Staff,0,5,30,30
1650019577118,MATH 193A,A02,083225,Staff,0,4,30,30
1650019577118,MATH 193A,A03,083781,Staff,0,0,30,30
1650019577118,MATH 193A,A04,083782,Staff,9,0,30,21
1650019583141,MATH 197,001,091859,McAuley; Julian John,9999,0,9999,0
1650019589208,COGS 9,A01,083615,Staff,1,15,60,59
1650019595233,COGS 11,A01,083617,Boyle; Mary E. T.,25,0,40,15
1650019601256,COGS 13,A01,083071,Staff,0,28,40,40
1650019607281,COGS 14A,A01,092681,Staff,0,6,100,100
1650019613304,COGS 14B,A01,083073,Cheng; Tzu-Han,0,2,50,50
1650019619331,COGS 17,A01,092677,Staff,35,0,75,40
1650019625353,COGS 100,A01,083619,Staff,0,18,60,60
1650019631382,COGS 101A,A01,083621,Davis; Joshua Daniel,0,16,60,60
1650019637410,COGS 101B,A01,091572,Staff,16,0,60,44
1650019643434,COGS 101C,A01,083625,Delgado; Tania,21,0,30,9
1650019649459,COGS 107A,A01,083627,Boyle; Mary E. T.,0,1,60,60
1650019655484,COGS 118A,A01,083075,Staff,19,0,60,41
1650019661509,CSE 3,A50,083646,Miranda; Gregory Joseph,22,0,38,16
1650019661509,CSE 3,A51,083647,Miranda; Gregory Joseph,37,0,37,0
1650019667538,CSE 8A,A50,083650,Miranda; Gregory Joseph,0,14,40,40
1650019673562,CSE 11,A01,083080,Cao; Yingjun,0,60,40,40
1650019679591,CSE 12,A01,083652,Staff,2,0,100,98
1650019685617,CSE 15L,A01,083654,Staff,0,0,50,50
1650019685617,CSE 15L,A02,083655,Staff,15,0,50,35
1650019691651,CSE 20,A01,083657,Staff,57,0,80,23
1650019697675,CSE 30,A01,083084,Eldon; John,0,62,40,40
1650019703698,CSE 100,A01,083659,Cao; Yingjun,0,57,50,50
1650019709727,CSE 134B,A01,083661,Powell; Thomas Allan,0,24,65,65
1650019715764,CSE 140,A01,083663,Staff,8,0,75,67
1650019721787,CSE 140L,A01,083088,Eldon; John,4,0,75,71
1650019727820,CSE 175,A01,083665,Kumar; Rakesh,10,0,25,15
1650019733935,CSE 190,A00,092507,Dubnov; Shlomo,17,0,20,3
1650019739957,ECE 45,A01,083139,Staff,0,10,40,40
1650019745981,ECE 65,A50,083695,Staff,0,1,30,30
1650019752009,ECE 109,A01,091882,Touri; Behrouz,48,0,70,22
1650019758039,ECE 180,A00,083140,Abi Samra; Nicholas Camill,26,0,30,4
1650019758039,ECE 180,B00,083141,Abi Samra; Nicholas Camill,10,0,30,20
1650019764068,MATH 10A,A01,083735,Patchell; Gregory David,14,0,30,16
1650019764068,MATH 10A,A02,083736,Patchell; Gregory David,28,0,30,2
1650019764068,MATH 10A,A03,083737,Patchell; Gregory David,27,0,30,3
1650019770098,MATH 10B,A01,083207,Staff,0,4,30,30
1650019770098,MATH 10B,A02,083208,Staff,0,0,30,30
1650019770098,MATH 10B,B01,083739,Staff,20,0,30,10
1650019770098,MATH 10B,B02,083740,Staff,30,0,30,0
1650019776127,MATH 18,A01,083743,Staff,10,0,30,20
1650019776127,MATH 18,A02,083744,Staff,28,0,30,2
1650019776127,MATH 18,A03,083745,Staff,23,0,30,7
1650019776127,MATH 18,A04,083746,Staff,27,0,30,3
1650019776127,MATH 18,B01,083748,Staff,0,8,30,30
1650019776127,MATH 18,B02,083749,Staff,0,6,30,30
1650019776127,MATH 18,B03,083750,Staff,0,6,30,30
1650019776127,MATH 18,B04,083751,Staff,1,7,30,29
1650019782155,MATH 20A,A01,083754,Staff,27,0,40,13
1650019788189,MATH 20B,A01,083756,Staff,0,4,30,30
1650019788189,MATH 20B,A02,083757,Staff,4,0,30,26
1650019794218,MATH 20C,A01,083760,Staff,0,9,30,30
1650019794218,MATH 20C,A02,083761,Staff,0,10,30,30
1650019794218,MATH 20C,B01,083762,Staff,17,0,30,13
1650019794218,MATH 20C,B02,083763,Staff,28,0,30,2
1650019800246,MATH 20D,A01,083765,Staff,0,2,30,30
1650019800246,MATH 20D,A02,083766,Staff,16,0,30,14
1650019800246,MATH 20D,A03,083767,Staff,28,0,30,2
1650019806277,MATH 20E,A01,083771,Staff,11,0,30,19
1650019806277,MATH 20E,A02,083772,Staff,20,0,30,10
1650019806277,MATH 20E,B01,083773,Staff,0,1,30,30
1650019806277,MATH 20E,B02,083774,Staff,20,0,30,10
1650019812300,MATH 103A,A01,083777,Staff,0,6,30,30
1650019812300,MATH 103A,A02,083778,Staff,0,7,30,30
1650019812300,MATH 103A,B01,083779,Staff,0,7,30,30
1650019812300,MATH 103A,B02,083780,Staff,0,6,30,30
1650019818324,MATH 105,A01,085443,Staff,0,11,30,30
1650019824350,MATH 109,A01,083213,Anzaldo; Leesa B,0,3,30,30
1650019824350,MATH 109,A02,083214,Anzaldo; Leesa B,0,3,30,30
1650019824350,MATH 109,B01,083215,Anzaldo; Leesa B,0,2,30,30
1650019824350,MATH 109,B02,083216,Anzaldo; Leesa B,0,2,30,30
1650019830374,MATH 142A,A01,083219,Chow; Bennett,0,7,30,30
1650019830374,MATH 142A,A02,083220,Chow; Bennett,0,7,30,30
1650019830374,MATH 142A,B01,083221,Chow; Bennett,0,8,30,30
1650019830374,MATH 142A,B02,083222,Chow; Bennett,0,7,30,30
1650019836400,MATH 193A,A01,083224,Staff,0,5,30,30
1650019836400,MATH 193A,A02,083225,Staff,0,4,30,30
1650019836400,MATH 193A,A03,083781,Staff,0,0,30,30
1650019836400,MATH 193A,A04,083782,Staff,9,0,30,21
1650019842428,MATH 197,001,091859,McAuley; Julian John,9999,0,9999,0
1650019848488,COGS 9,A01,083615,Staff,1,15,60,59
1650019854523,COGS 11,A01,083617,Boyle; Mary E. T.,25,0,40,15
1650019860553,COGS 13,A01,083071,Staff,0,28,40,40
1650019866590,COGS 14A,A01,092681,Staff,0,6,100,100
1650019872614,COGS 14B,A01,083073,Cheng; Tzu-Han,0,2,50,50
1650019878640,COGS 17,A01,092677,Staff,35,0,75,40
1650019884665,COGS 100,A01,083619,Staff,0,18,60,60
1650019890695,COGS 101A,A01,083621,Davis; Joshua Daniel,0,16,60,60
1650019896725,COGS 101B,A01,091572,Staff,16,0,60,44
1650019902759,COGS 101C,A01,083625,Delgado; Tania,21,0,30,9
1650019908796,COGS 107A,A01,083627,Boyle; Mary E. T.,0,1,60,60
1650019914830,COGS 118A,A01,083075,Staff,19,0,60,41
1650019920861,CSE 3,A50,083646,Miranda; Gregory Joseph,22,0,38,16
1650019920861,CSE 3,A51,083647,Miranda; Gregory Joseph,37,0,37,0
1650019926885,CSE 8A,A50,083650,Miranda; Gregory Joseph,0,14,40,40
1650019932908,CSE 11,A01,083080,Cao; Yingjun,0,60,40,40
1650019938936,CSE 12,A01,083652,Staff,2,0,100,98
1650019944959,CSE 15L,A01,083654,Staff,0,0,50,50
1650019944959,CSE 15L,A02,083655,Staff,15,0,50,35
1650019950987,CSE 20,A01,083657,Staff,57,0,80,23
1650019957011,CSE 30,A01,083084,Eldon; John,0,62,40,40
1650019963036,CSE 100,A01,083659,Cao; Yingjun,0,57,50,50
1650019969060,CSE 134B,A01,083661,Powell; Thomas Allan,0,24,65,65
1650019975085,CSE 140,A01,083663,Staff,8,0,75,67
1650019981108,CSE 140L,A01,083088,Eldon; John,4,0,75,71
1650019987133,CSE 175,A01,083665,Kumar; Rakesh,10,0,25,15
1650019993163,CSE 190,A00,092507,Dubnov; Shlomo,17,0,20,3
1650019999191,ECE 45,A01,083139,Staff,0,10,40,40
1650020005228,ECE 65,A50,083695,Staff,0,1,30,30
1650020011254,ECE 109,A01,091882,Touri; Behrouz,48,0,70,22
1650020017283,ECE 180,A00,083140,Abi Samra; Nicholas Camill,26,0,30,4
1650020017283,ECE 180,B00,083141,Abi Samra; Nicholas Camill,10,0,30,20
1650020023308,MATH 10A,A01,083735,Patchell; Gregory David,14,0,30,16
1650020023308,MATH 10A,A02,083736,Patchell; Gregory David,28,0,30,2
1650020023308,MATH 10A,A03,083737,Patchell; Gregory David,27,0,30,3
1650020029343,MATH 10B,A01,083207,Staff,0,4,30,30
1650020029343,MATH 10B,A02,083208,Staff,0,0,30,30
1650020029343,MATH 10B,B01,083739,Staff,20,0,30,10
1650020029343,MATH 10B,B02,083740,Staff,30,0,30,0
1650020035369,MATH 18,A01,083743,Staff,10,0,30,20
1650020035369,MATH 18,A02,083744,Staff,28,0,30,2
1650020035369,MATH 18,A03,083745,Staff,23,0,30,7
1650020035369,MATH 18,A04,083746,Staff,27,0,30,3
1650020035369,MATH 18,B01,083748,Staff,0,8,30,30
1650020035369,MATH 18,B02,083749,Staff,0,6,30,30
1650020035369,MATH 18,B03,083750,Staff,0,6,30,30
1650020035369,MATH 18,B04,083751,Staff,1,7,30,29
1650020041394,MATH 20A,A01,083754,Staff,27,0,40,13
1650020047419,MATH 20B,A01,083756,Staff,0,4,30,30
1650020047419,MATH 20B,A02,083757,Staff,4,0,30,26
1650020053443,MATH 20C,A01,083760,Staff,0,9,30,30
1650020053443,MATH 20C,A02,083761,Staff,0,10,30,30
1650020053443,MATH 20C,B01,083762,Staff,17,0,30,13
1650020053443,MATH 20C,B02,083763,Staff,28,0,30,2
1650020059471,MATH 20D,A01,083765,Staff,0,2,30,30
1650020059471,MATH 20D,A02,083766,Staff,16,0,30,14
1650020059471,MATH 20D,A03,083767,Staff,28,0,30,2
1650020065503,MATH 20E,A01,083771,Staff,11,0,30,19
1650020065503,MATH 20E,A02,083772,Staff,20,0,30,10
1650020065503,MATH 20E,B01,083773,Staff,0,1,30,30
1650020065503,MATH 20E,B02,083774,Staff,20,0,30,10
1650020071527,MATH 103A,A01,083777,Staff,0,6,30,30
1650020071527,MATH 103A,A02,083778,Staff,0,7,30,30
1650020071527,MATH 103A,B01,083779,Staff,0,7,30,30
1650020071527,MATH 103A,B02,083780,Staff,0,6,30,30
1650020077556,MATH 105,A01,085443,Staff,0,11,30,30
1650020083587,MATH 109,A01,083213,Anzaldo; Leesa B,0,3,30,30
1650020083587,MATH 109,A02,083214,Anzaldo; Leesa B,0,3,30,30
1650020083587,MATH 109,B01,083215,Anzaldo; Leesa B,0,2,30,30
1650020083587,MATH 109,B02,083216,Anzaldo; Leesa B,0,2,30,30
1650020089613,MATH 142A,A01,083219,Chow; Bennett,0,7,30,30
1650020089613,MATH 142A,A02,083220,Chow; Bennett,0,7,30,30
1650020089613,MATH 142A,B01,083221,Chow; Bennett,0,8,30,30
1650020089613,MATH 142A,B02,083222,Chow; Bennett,0,7,30,30
1650020095642,MATH 193A,A01,083224,Staff,0,5,30,30
1650020095642,MATH 193A,A02,083225,Staff,0,4,30,30
1650020095642,MATH 193A,A03,083781,Staff,0,0,30,30
1650020095642,MATH 193A,A04,083782,Staff,9,0,30,21
1650020101669,MATH 197,001,091859,McAuley; Julian John,9999,0,9999,0
1650020107742,COGS 9,A01,083615,Staff,1,15,60,59
1650020113767,COGS 11,A01,083617,Boyle; Mary E. T.,25,0,40,15
1650020119793,COGS 13,A01,083071,Staff,0,28,40,40
1650020125817,COGS 14A,A01,092681,Staff,0,6,100,100
1650020131842,COGS 14B,A01,083073,Cheng; Tzu-Han,0,2,50,50
1650020137866,COGS 17,A01,092677,Staff,35,0,75,40
1650020143895,COGS 100,A01,083619,Staff,0,18,60,60
1650020149928,COGS 101A,A01,083621,Davis; Joshua Daniel,0,16,60,60
1650020155951,COGS 101B,A01,091572,Staff,16,0,60,44
1650020161975,COGS 101C,A01,083625,Delgado; Tania,21,0,30,9
1650020168009,COGS 107A,A01,083627,Boyle; Mary E. T.,0,1,60,60
1650020174031,COGS 118A,A01,083075,Staff,19,0,60,41
1650020180067,CSE 3,A50,083646,Miranda; Gregory Joseph,22,0,38,16
1650020180067,CSE 3,A51,083647,Miranda; Gregory Joseph,37,0,37,0
1650020186090,CSE 8A,A50,083650,Miranda; Gregory Joseph,0,14,40,40
1650020192130,CSE 11,A01,083080,Cao; Yingjun,0,60,40,40
1650020198154,CSE 12,A01,083652,Staff,2,0,100,98
1650020204183,CSE 15L,A01,083654,Staff,0,0,50,50
1650020204183,CSE 15L,A02,083655,Staff,15,0,50,35
1650020210216,CSE 20,A01,083657,Staff,57,0,80,23
1650020216245,CSE 30,A01,083084,Eldon; John,0,62,40,40
1650020222275,CSE 100,A01,083659,Cao; Yingjun,0,57,50,50
1650020228308,CSE 134B,A01,083661,Powell; Thomas Allan,0,24,65,65
1650020234332,CSE 140,A01,083663,Staff,8,0,75,67
1650020240360,CSE 140L,A01,083088,Eldon; John,4,0,75,71
1650020246391,CSE 175,A01,083665,Kumar; Rakesh,10,0,25,15
1650020252417,CSE 190,A00,092507,Dubnov; Shlomo,17,0,20,3
1650020258442,ECE 45,A01,083139,Staff,0,10,40,40
1650020264475,ECE 65,A50,083695,Staff,0,1,30,30
1650020270511,ECE 109,A01,091882,Touri; Behrouz,48,0,70,22
1650020276543,ECE 180,A00,083140,Abi Samra; Nicholas Camill,26,0,30,4
1650020276543,ECE 180,B00,083141,Abi Samra; Nicholas Camill,10,0,30,20
1650020282570,MATH 10A,A01,083735,Patchell; Gregory David,14,0,30,16
1650020282570,MATH 10A,A02,083736,Patchell; Gregory David,28,0,30,2
1650020282570,MATH 10A,A03,083737,Patchell; Gregory David,27,0,30,3
1650020288596,MATH 10B,A01,083207,Staff,0,4,30,30
1650020288596,MATH 10B,A02,083208,Staff,0,0,30,30
1650020288596,MATH 10B,B01,083739,Staff,20,0,30,10
1650020288596,MATH 10B,B02,083740,Staff,30,0,30,0
1650020294631,MATH 18,A01,083743,Staff,10,0,30,20
1650020294631,MATH 18,A02,083744,Staff,28,0,30,2
1650020294631,MATH 18,A03,083745,Staff,23,0,30,7
1650020294631,MATH 18,A04,083746,Staff,27,0,30,3
1650020294631,MATH 18,B01,083748,Staff,0,8,30,30
1650020294631,MATH 18,B02,083749,Staff,0,6,30,30
1650020294631,MATH 18,B03,083750,Staff,0,6,30,30
1650020294631,MATH 18,B04,083751,Staff,1,7,30,29
1650020300655,MATH 20A,A01,083754,Staff,27,0,40,13
1650020306687,MATH 20B,A01,083756,Staff,0,4,30,30
1650020306687,MATH 20B,A02,083757,Staff,4,0,30,26
1650020312711,MATH 20C,A01,083760,Staff,0,9,30,30
1650020312711,MATH 20C,A02,083761,Staff,0,10,30,30
1650020312711,MATH 20C,B01,083762,Staff,17,0,30,13
1650020312711,MATH 20C,B02,083763,Staff,28,0,30,2
1650020318741,MATH 20D,A01,083765,Staff,0,2,30,30
1650020318741,MATH 20D,A02,083766,Staff,16,0,30,14
1650020318741,MATH 20D,A03,083767,Staff,28,0,30,2
1650020324772,MATH 20E,A01,083771,Staff,11,0,30,19
1650020324772,MATH 20E,A02,083772,Staff,20,0,30,10
1650020324772,MATH 20E,B01,083773,Staff,0,1,30,30
1650020324772,MATH 20E,B02,083774,Staff,20,0,30,10
1650020330891,MATH 103A,A01,083777,Staff,0,6,30,30
1650020330891,MATH 103A,A02,083778,Staff,0,7,30,30
1650020330891,MATH 103A,B01,083779,Staff,0,7,30,30
1650020330891,MATH 103A,B02,083780,Staff,0,6,30,30
1650020336917,MATH 105,A01,085443,Staff,0,11,30,30
1650020342947,MATH 109,A01,083213,Anzaldo; Leesa B,0,3,30,30
1650020342947,MATH 109,A02,083214,Anzaldo; Leesa B,0,3,30,30
1650020342947,MATH 109,B01,083215,Anzaldo; Leesa B,0,2,30,30
1650020342947,MATH 109,B02,083216,Anzaldo; Leesa B,0,2,30,30
1650020348970,MATH 142A,A01,083219,Chow; Bennett,0,7,30,30
1650020348970,MATH 142A,A02,083220,Chow; Bennett,0,7,30,30
1650020348970,MATH 142A,B01,083221,Chow; Bennett,0,8,30,30
1650020348970,MATH 142A,B02,083222,Chow; Bennett,0,7,30,30
1650020355008,MATH 193A,A01,083224,Staff,0,5,30,30
1650020355008,MATH 193A,A02,083225,Staff,0,4,30,30
1650020355008,MATH 193A,A03,083781,Staff,0,0,30,30
1650020355008,MATH 193A,A04,083782,Staff,9,0,30,21
1650020361037,MATH 197,001,091859,McAuley; Julian John,9999,0,9999,0
1650020367123,COGS 9,A01,083615,Staff,1,15,60,59
1650020373148,COGS 11,A01,083617,Boyle; Mary E. T.,25,0,40,15
1650020379172,COGS 13,A01,083071,Staff,0,28,40,40
1650020385196,COGS 14A,A01,092681,Staff,0,6,100,100
1650020391221,COGS 14B,A01,083073,Cheng; Tzu-Han,0,2,50,50
1650020397248,COGS 17,A01,092677,Staff,35,0,75,40
1650020403271,COGS 100,A01,083619,Staff,0,18,60,60
1650020409295,COGS 101A,A01,083621,Davis; Joshua Daniel,0,16,60,60
1650020415323,COGS 101B,A01,091572,Staff,16,0,60,44
1650020421365,COGS 101C,A01,083625,Delgado; Tania,21,0,30,9
1650020427394,COGS 107A,A01,083627,Boyle; Mary E. T.,0,1,60,60
1650020433422,COGS 118A,A01,083075,Staff,19,0,60,41
1650020439449,CSE 3,A50,083646,Miranda; Gregory Joseph,22,0,38,16
1650020439449,CSE 3,A51,083647,Miranda; Gregory Joseph,37,0,37,0
1650020445488,CSE 8A,A50,083650,Miranda; Gregory Joseph,0,14,40,40
1650020451514,CSE 11,A01,083080,Cao; Yingjun,0,60,40,40
1650020457538,CSE 12,A01,083652,Staff,2,0,100,98
1650020463561,CSE 15L,A01,083654,Staff,0,0,50,50
1650020463561,CSE 15L,A02,083655,Staff,15,0,50,35
1650020469589,CSE 20,A01,083657,Staff,57,0,80,23
1650020475615,CSE 30,A01,083084,Eldon; John,0,62,40,40
1650020481640,CSE 100,A01,083659,Cao; Yingjun,0,57,50,50
1650020487669,CSE 134B,A01,083661,Powell; Thomas Allan,0,24,65,65
1650020493694,CSE 140,A01,083663,Staff,8,0,75,67
1650020499719,CSE 140L,A01,083088,Eldon; John,4,0,75,71
1650020505750,CSE 175,A01,083665,Kumar; Rakesh,10,0,25,15
1650020511776,CSE 190,A00,092507,Dubnov; Shlomo,17,0,20,3
1650020517804,ECE 45,A01,083139,Staff,0,10,40,40
1650020523828,ECE 65,A50,083695,Staff,0,1,30,30
1650020529857,ECE 109,A01,091882,Touri; Behrouz,48,0,70,22
1650020535881,ECE 180,A00,083140,Abi Samra; Nicholas Camill,26,0,30,4
1650020535881,ECE 180,B00,083141,Abi Samra; Nicholas Camill,10,0,30,20
1650020541915,MATH 10A,A01,083735,Patchell; Gregory David,14,0,30,16
1650020541915,MATH 10A,A02,083736,Patchell; Gregory David,28,0,30,2
1650020541915,MATH 10A,A03,083737,Patchell; Gregory David,27,0,30,3
1650020547941,MATH 10B,A01,083207,Staff,0,4,30,30
1650020547941,MATH 10B,A02,083208,Staff,0,0,30,30
1650020547941,MATH 10B,B01,083739,Staff,20,0,30,10
1650020547941,MATH 10B,B02,083740,Staff,30,0,30,0
1650020553971,MATH 18,A01,083743,Staff,10,0,30,20
1650020553971,MATH 18,A02,083744,Staff,28,0,30,2
1650020553971,MATH 18,A03,083745,Staff,23,0,30,7
1650020553971,MATH 18,A04,083746,Staff,27,0,30,3
1650020553971,MATH 18,B01,083748,Staff,0,8,30,30
1650020553971,MATH 18,B02,083749,Staff,0,6,30,30
1650020553971,MATH 18,B03,083750,Staff,0,6,30,30
1650020553971,MATH 18,B04,083751,Staff,1,7,30,29
1650020560018,MATH 20A,A01,083754,Staff,27,0,40,13
1650020566044,MATH 20B,A01,083756,Staff,0,4,30,30
1650020566044,MATH 20B,A02,083757,Staff,4,0,30,26
1650020572068,MATH 20C,A01,083760,Staff,0,9,30,30
1650020572068,MATH 20C,A02,083761,Staff,0,10,30,30
1650020572068,MATH 20C,B01,083762,Staff,17,0,30,13
1650020572068,MATH 20C,B02,083763,Staff,28,0,30,2
1650020578093,MATH 20D,A01,083765,Staff,0,2,30,30
1650020578093,MATH 20D,A02,083766,Staff,16,0,30,14
1650020578093,MATH 20D,A03,083767,Staff,28,0,30,2
1650020584126,MATH 20E,A01,083771,Staff,11,0,30,19
1650020584126,MATH 20E,A02,083772,Staff,20,0,30,10
1650020584126,MATH 20E,B01,083773,Staff,0,1,30,30
1650020584126,MATH 20E,B02,083774,Staff,20,0,30,10
1650020590151,MATH 103A,A01,083777,Staff,0,6,30,30
1650020590151,MATH 103A,A02,083778,Staff,0,7,30,30
1650020590151,MATH 103A,B01,083779,Staff,0,7,30,30
1650020590151,MATH 103A,B02,083780,Staff,0,6,30,30
1650020596176,MATH 105,A01,085443,Staff,0,11,30,30
1650020602211,MATH 109,A01,083213,Anzaldo; Leesa B,0,3,30,30
1650020602211,MATH 109,A02,083214,Anzaldo; Leesa B,0,3,30,30
1650020602211,MATH 109,B01,083215,Anzaldo; Leesa B,0,2,30,30
1650020602211,MATH 109,B02,083216,Anzaldo; Leesa B,0,2,30,30
1650020608234,MATH 142A,A01,083219,Chow; Bennett,0,7,30,30
1650020608234,MATH 142A,A02,083220,Chow; Bennett,0,7,30,30
1650020608234,MATH 142A,B01,083221,Chow; Bennett,0,8,30,30
1650020608234,MATH 142A,B02,083222,Chow; Bennett,0,7,30,30
1650020614259,MATH 193A,A01,083224,Staff,0,5,30,30
1650020614259,MATH 193A,A02,083225,Staff,0,4,30,30
1650020614259,MATH 193A,A03,083781,Staff,0,0,30,30
1650020614259,MATH 193A,A04,083782,Staff,9,0,30,21
1650020620288,MATH 197,001,091859,McAuley; Julian John,9999,0,9999,0
1650020626367,COGS 9,A01,083615,Staff,1,15,60,59
1650020632397,COGS 11,A01,083617,Boyle; Mary E. T.,25,0,40,15
1650020638430,COGS 13,A01,083071,Staff,0,28,40,40
1650020644474,COGS 14A,A01,092681,Staff,0,6,100,100
1650020650503,COGS 14B,A01,083073,Cheng; Tzu-Han,0,2,50,50
1650020656530,COGS 17,A01,092677,Staff,35,0,75,40
1650020662553,COGS 100,A01,083619,Staff,0,18,60,60
1650020668578,COGS 101A,A01,083621,Davis; Joshua Daniel,0,16,60,60
1650020674602,COGS 101B,A01,091572,Staff,16,0,60,44
1650020680627,COGS 101C,A01,083625,Delgado; Tania,21,0,30,9
1650020686769,COGS 107A,A01,083627,Boyle; Mary E. T.,0,1,60,60
1650020692799,COGS 118A,A01,083075,Staff,19,0,60,41
1650020698839,CSE 3,A50,083646,Miranda; Gregory Joseph,22,0,38,16
1650020698839,CSE 3,A51,083647,Miranda; Gregory Joseph,37,0,37,0
1650020704863,CSE 8A,A50,083650,Miranda; Gregory Joseph,0,14,40,40
1650020710895,CSE 11,A01,083080,Cao; Yingjun,0,60,40,40
1650020716923,CSE 12,A01,083652,Staff,2,0,100,98
1650020722958,CSE 15L,A01,083654,Staff,0,0,50,50
1650020722958,CSE 15L,A02,083655,Staff,15,0,50,35
1650020728982,CSE 20,A01,083657,Staff,57,0,80,23
1650020735010,CSE 30,A01,083084,Eldon; John,0,62,40,40
1650020741034,CSE 100,A01,083659,Cao; Yingjun,0,57,50,50
1650020747066,CSE 134B,A01,083661,Powell; Thomas Allan,0,24,65,65
1650020753091,CSE 140,A01,083663,Staff,8,0,75,67
1650020759127,CSE 140L,A01,083088,Eldon; John,4,0,75,71
1650020765152,CSE 175,A01,083665,Kumar; Rakesh,10,0,25,15
1650020771175,CSE 190,A00,092507,Dubnov; Shlomo,17,0,20,3
1650020777200,ECE 45,A01,083139,Staff,0,10,40,40
1650020783228,ECE 65,A50,083695,Staff,0,1,30,30
1650020789253,ECE 109,A01,091882,Touri; Behrouz,48,0,70,22
1650020795280,ECE 180,A00,083140,Abi Samra; Nicholas Camill,26,0,30,4
1650020795280,ECE 180,B00,083141,Abi Samra; Nicholas Camill,10,0,30,20
1650020801315,MATH 10A,A01,083735,Patchell; Gregory David,14,0,30,16
1650020801315,MATH 10A,A02,083736,Patchell; Gregory David,28,0,30,2
1650020801315,MATH 10A,A03,083737,Patchell; Gregory David,27,0,30,3
1650020807343,MATH 10B,A01,083207,Staff,0,4,30,30
1650020807343,MATH 10B,A02,083208,Staff,0,0,30,30
1650020807343,MATH 10B,B01,083739,Staff,20,0,30,10
1650020807343,MATH 10B,B02,083740,Staff,30,0,30,0
1650020813376,MATH 18,A01,083743,Staff,10,0,30,20
1650020813376,MATH 18,A02,083744,Staff,28,0,30,2
1650020813376,MATH 18,A03,083745,Staff,23,0,30,7
1650020813376,MATH 18,A04,083746,Staff,27,0,30,3
1650020813376,MATH 18,B01,083748,Staff,0,8,30,30
1650020813376,MATH 18,B02,083749,Staff,0,6,30,30
1650020813376,MATH 18,B03,083750,Staff,0,6,30,30
1650020813376,MATH 18,B04,083751,Staff,1,7,30,29
1650020819399,MATH 20A,A01,083754,Staff,27,0,40,13
1650020825433,MATH 20B,A01,083756,Staff,0,4,30,30
1650020825433,MATH 20B,A02,083757,Staff,4,0,30,26
1650020831459,MATH 20C,A01,083760,Staff,0,9,30,30
1650020831459,MATH 20C,A02,083761,Staff,0,10,30,30
1650020831459,MATH 20C,B01,083762,Staff,17,0,30,13
1650020831459,MATH 20C,B02,083763,Staff,28,0,30,2
