time,subj_course_id,sec_code,sec_id,prof,available,waitlist,total,enrolled_ct
1656155730416,COGS 9,A01,083615,Shannon; Kyle Michael,4,0,75,71
1656155736451,COGS 11,A01,083617,Boyle; Mary E. T.,14,0,48,34
1656155742489,COGS 13,A01,083071,Bastos; Amalia Pinkusfeld,6,0,71,65
1656155748531,COGS 14A,A01,092681,Semenuks; Arturs,4,15,100,96
1656155754560,COGS 14B,A01,083073,Cheng; Tzu-Han,7,0,63,56
1656155760586,COGS 17,A01,092677,Semenuks; Arturs,8,0,81,73
1656155766619,COGS 100,A01,083619,Allen; Michael Gordon,2,0,70,68
1656155772656,COGS 101A,A01,083621,Davis; Joshua Daniel,3,0,68,65
1656155778690,COGS 101B,A01,091572,Allen; Michael Gordon,6,0,65,59
1656155784722,COGS 101C,A01,083625,Delgado; Tania,10,0,35,25
1656155790757,COGS 107A,A01,083627,Boyle; Mary E. T.,0,0,60,60
1656155796788,COGS 118A,A01,083075,Gupta; Anjum,7,0,76,69
1656155802829,CSE 3,A50,083646,Miranda; Gregory Joseph,18,0,50,32
1656155808865,CSE 8A,A50,083650,Miranda; Gregory Joseph,3,3,56,53
1656155814897,CSE 11,A01,083080,Cao; Yingjun,1,54,40,39
1656155820934,CSE 12,A01,083652,Krause-Levy; Sophia Louisa,7,2,120,113
1656155826969,CSE 15L,A01,083654,Morris; Justin Loren,2,0,50,48
1656155826969,CSE 15L,A02,083655,Morris; Justin Loren,4,0,50,46
1656155832999,CSE 20,A01,083657,Tran; Khoa Dang,31,0,80,49
1656155839031,CSE 21,A01,095574,Bach; Quang Tran,25,0,48,23
1656155845066,CSE 30,A01,083084,Eldon; John,2,8,80,78
1656155845066,CSE 30,B01,095061,Bhaskar; Nishant,1,2,50,49
1656155851097,CSE 100,A01,083659,Cao; Yingjun,2,20,70,68
1656155857130,CSE 134B,A01,083661,Powell; Thomas Allan,3,0,100,97
1656155863173,CSE 140,A01,083663,Gungor; Onat,9,0,85,76
1656155869202,CSE 140L,A01,083088,Eldon; John,8,0,100,92
1656155875237,CSE 175,A01,083665,Kumar; Rakesh,0,0,25,25
1656155881269,CSE 190,A00,092507,Dubnov; Shlomo,3,0,20,17
1656155887299,ECE 45,A01,083139,Congero; Spencer William,1,0,75,74
1656155893348,ECE 65,A50,083695,Saad; Andrew S,8,0,30,22
1656155893348,ECE 65,A51,095125,Staff,23,0,26,3
1656155899386,ECE 109,A01,091882,Touri; Behrouz,0,1,70,70
1656155905414,ECE 180,A00,083140,Abi Samra; Nicholas Camill,1,0,30,29
1656155905414,ECE 180,B00,083141,Abi Samra; Nicholas Camill,0,4,30,30
1656155911442,MATH 10A,A01,083735,Patchell; Gregory David,0,0,30,30
1656155911442,MATH 10A,A02,083736,Patchell; Gregory David,22,0,30,8
1656155911442,MATH 10A,A03,083737,Patchell; Gregory David,16,0,30,14
1656155917482,MATH 10B,A01,083207,Lim; Seonhee,0,0,34,34
1656155917482,MATH 10B,A02,083208,Lim; Seonhee,7,0,35,28
1656155917482,MATH 10B,A03,093472,Staff,1,0,34,33
1656155917482,MATH 10B,B01,083739,Sinha; Shubham,10,0,30,20
1656155923516,MATH 18,A01,083743,Cinel; Cameron Alexander,7,0,30,23
1656155923516,MATH 18,A02,083744,Cinel; Cameron Alexander,10,0,30,20
1656155923516,MATH 18,A03,083745,Cinel; Cameron Alexander,4,0,30,26
1656155923516,MATH 18,B01,083748,Rideout; David Porter,0,0,36,36
1656155923516,MATH 18,B02,083749,Rideout; David Porter,0,0,36,36
1656155923516,MATH 18,B03,083750,Rideout; David Porter,0,0,36,36
1656155923516,MATH 18,B04,083751,Rideout; David Porter,0,0,36,36
1656155923516,MATH 18,B05,093473,Rideout; David Porter,1,0,36,35
1656155923516,MATH 18,B06,093474,Rideout; David Porter,4,0,36,32
1656155929553,MATH 20A,A01,083754,Zheng; Zequn,11,0,40,29
1656155935582,MATH 20B,A01,083756,Briones; Jor-el Thomas Caparas,0,0,36,36
1656155935582,MATH 20B,A02,083757,Briones; Jor-el Thomas Caparas,0,0,36,36
1656155935582,MATH 20B,A03,093475,Staff,2,0,36,34
1656155941615,MATH 20C,A01,083760,Briones; Jor-el Thomas Caparas,0,0,35,35
1656155941615,MATH 20C,A02,083761,Briones; Jor-el Thomas Caparas,9,1,35,26
1656155941615,MATH 20C,A03,093476,Staff,0,0,35,35
1656155941615,MATH 20C,B01,083762,Bach; Quang Tran,1,0,30,29
1656155947650,MATH 20D,A01,083765,Tran; Brian Kha,2,0,30,28
1656155947650,MATH 20D,A02,083766,Tran; Brian Kha,0,1,30,30
1656155947650,MATH 20D,A03,083767,Tran; Brian Kha,2,0,30,28
1656155953681,MATH 20E,A01,083771,Ganguly; Soumya,4,0,32,28
1656155953681,MATH 20E,A02,083772,Ganguly; Soumya,0,0,32,32
1656155953681,MATH 20E,B01,083773,Ciotti; Benjamin,15,0,35,20
1656155953681,MATH 20E,B02,083774,Ciotti; Benjamin,15,0,35,20
1656155959724,MATH 103A,A01,083777,Greenfeld; Be'Eri,1,0,36,35
1656155959724,MATH 103A,A02,083778,Greenfeld; Be'Eri,1,0,36,35
1656155959724,MATH 103A,A03,093561,Staff,4,0,36,32
1656155959724,MATH 103A,B01,083779,Greenfeld; Be'Eri,8,1,36,28
1656155959724,MATH 103A,B02,083780,Greenfeld; Be'Eri,1,0,36,35
1656155959724,MATH 103A,B03,093562,Staff,0,0,36,36
1656155965767,MATH 105,A01,085443,Carter; Anne Toulson,5,1,35,30
1656155965767,MATH 105,A02,093477,Staff,11,0,35,24
1656155971798,MATH 109,A01,083213,Ganzberger; Geoffrey Michael,0,0,34,34
1656155971798,MATH 109,A02,083214,Ganzberger; Geoffrey Michael,0,0,34,34
1656155971798,MATH 109,A03,093478,Staff,1,0,34,33
1656155971798,MATH 109,B01,083215,Ganzberger; Geoffrey Michael,4,0,32,28
1656155971798,MATH 109,B02,083216,Ganzberger; Geoffrey Michael,1,0,32,31
1656155971798,MATH 109,B03,093479,Staff,4,0,32,28
1656155977838,MATH 142A,A01,083219,Chow; Bennett,1,0,32,31
1656155977838,MATH 142A,A02,083220,Chow; Bennett,8,0,32,24
1656155977838,MATH 142A,A03,093480,Staff,5,0,32,27
1656155977838,MATH 142A,B03,093481,Staff,4,0,32,28
1656155977838,MATH 142A,B04,093558,Staff,6,0,32,26
1656155977838,MATH 142A,B05,093559,Staff,0,0,32,32
1656155983868,MATH 193A,A01,083224,Rotar; Vladimir,0,1,34,34
1656155983868,MATH 193A,A02,083225,Rotar; Vladimir,0,0,34,34
1656155983868,MATH 193A,A03,083781,Rotar; Vladimir,0,0,34,34
1656155983868,MATH 193A,A04,083782,Rotar; Vladimir,6,0,34,28
1656155983868,MATH 193A,A05,093482,Rotar; Vladimir,1,0,34,33
1656155989908,MATH 197,001,091859,McAuley; Julian John,9999,0,9999,0
1656155989908,MATH 197,002,095566,Kedlaya; Kiran S.,9997,0,9999,2
1656155989908,MATH 197,003,095567,Xiao; Ming,9999,0,9999,0
1656155989908,MATH 197,004,095571,Perols; Johan Lars,9998,0,9999,1
1656155996992,COGS 9,A01,083615,Shannon; Kyle Michael,4,0,75,71
1656156008159,COGS 11,A01,083617,Boyle; Mary E. T.,14,0,48,34
1656156014191,COGS 13,A01,083071,Bastos; Amalia Pinkusfeld,6,0,71,65
1656156028926,COGS 14A,A01,092681,Semenuks; Arturs,4,15,100,96
1656156034960,COGS 14B,A01,083073,Cheng; Tzu-Han,7,0,63,56
1656156040997,COGS 17,A01,092677,Semenuks; Arturs,8,0,81,73
1656156047022,COGS 100,A01,083619,Allen; Michael Gordon,2,0,70,68
1656156053057,COGS 101A,A01,083621,Davis; Joshua Daniel,3,0,68,65
1656156059085,COGS 101B,A01,091572,Allen; Michael Gordon,6,0,65,59
1656156065114,COGS 101C,A01,083625,Delgado; Tania,10,0,35,25
1656156071144,COGS 107A,A01,083627,Boyle; Mary E. T.,0,0,60,60
1656156077183,COGS 118A,A01,083075,Gupta; Anjum,7,0,76,69
1656156083215,CSE 3,A50,083646,Miranda; Gregory Joseph,18,0,50,32
1656156089252,CSE 8A,A50,083650,Miranda; Gregory Joseph,3,3,56,53
1656156095289,CSE 11,A01,083080,Cao; Yingjun,1,54,40,39
1656156101321,CSE 12,A01,083652,Krause-Levy; Sophia Louisa,7,2,120,113
1656156107359,CSE 15L,A01,083654,Morris; Justin Loren,2,0,50,48
1656156107359,CSE 15L,A02,083655,Morris; Justin Loren,4,0,50,46
1656156113396,CSE 20,A01,083657,Tran; Khoa Dang,31,0,80,49
1656156119431,CSE 21,A01,095574,Bach; Quang Tran,25,0,48,23
1656156125472,CSE 30,A01,083084,Eldon; John,2,8,80,78
1656156125472,CSE 30,B01,095061,Bhaskar; Nishant,1,2,50,49
1656156131504,CSE 100,A01,083659,Cao; Yingjun,2,20,70,68
1656156137539,CSE 134B,A01,083661,Powell; Thomas Allan,3,0,100,97
1656156143571,CSE 140,A01,083663,Gungor; Onat,9,0,85,76
1656156149600,CSE 140L,A01,083088,Eldon; John,8,0,100,92
1656156155630,CSE 175,A01,083665,Kumar; Rakesh,0,0,25,25
1656156161664,CSE 190,A00,092507,Dubnov; Shlomo,3,0,20,17
1656156167693,ECE 45,A01,083139,Congero; Spencer William,1,0,75,74
1656156173724,ECE 65,A50,083695,Saad; Andrew S,9,0,30,21
1656156173724,ECE 65,A51,095125,Staff,23,0,26,3
1656156179754,ECE 109,A01,091882,Touri; Behrouz,0,1,70,70
1656156185792,ECE 180,A00,083140,Abi Samra; Nicholas Camill,1,0,30,29
1656156185792,ECE 180,B00,083141,Abi Samra; Nicholas Camill,0,4,30,30
1656156191833,MATH 10A,A01,083735,Patchell; Gregory David,0,0,30,30
1656156191833,MATH 10A,A02,083736,Patchell; Gregory David,22,0,30,8
1656156191833,MATH 10A,A03,083737,Patchell; Gregory David,16,0,30,14
1656156197866,MATH 10B,A01,083207,Lim; Seonhee,0,0,34,34
1656156197866,MATH 10B,A02,083208,Lim; Seonhee,7,0,35,28
1656156197866,MATH 10B,A03,093472,Staff,1,0,34,33
1656156197866,MATH 10B,B01,083739,Sinha; Shubham,10,0,30,20
1656156203900,MATH 18,A01,083743,Cinel; Cameron Alexander,7,0,30,23
1656156203900,MATH 18,A02,083744,Cinel; Cameron Alexander,10,0,30,20
1656156203900,MATH 18,A03,083745,Cinel; Cameron Alexander,4,0,30,26
1656156203900,MATH 18,B01,083748,Rideout; David Porter,0,0,36,36
1656156203900,MATH 18,B02,083749,Rideout; David Porter,0,0,36,36
1656156203900,MATH 18,B03,083750,Rideout; David Porter,0,0,36,36
1656156203900,MATH 18,B04,083751,Rideout; David Porter,0,0,36,36
1656156203900,MATH 18,B05,093473,Rideout; David Porter,1,0,36,35
1656156203900,MATH 18,B06,093474,Rideout; David Porter,4,0,36,32
1656156209932,MATH 20A,A01,083754,Zheng; Zequn,11,0,40,29
1656156215962,MATH 20B,A01,083756,Briones; Jor-el Thomas Caparas,0,0,36,36
1656156215962,MATH 20B,A02,083757,Briones; Jor-el Thomas Caparas,0,0,36,36
1656156215962,MATH 20B,A03,093475,Staff,2,0,36,34
1656156222000,MATH 20C,A01,083760,Briones; Jor-el Thomas Caparas,0,0,35,35
1656156222000,MATH 20C,A02,083761,Briones; Jor-el Thomas Caparas,9,1,35,26
1656156222000,MATH 20C,A03,093476,Staff,0,0,35,35
1656156222000,MATH 20C,B01,083762,Bach; Quang Tran,1,0,30,29
1656156228037,MATH 20D,A01,083765,Tran; Brian Kha,2,0,30,28
1656156228037,MATH 20D,A02,083766,Tran; Brian Kha,0,1,30,30
1656156228037,MATH 20D,A03,083767,Tran; Brian Kha,2,0,30,28
1656156234078,MATH 20E,A01,083771,Ganguly; Soumya,4,0,32,28
1656156234078,MATH 20E,A02,083772,Ganguly; Soumya,0,0,32,32
1656156234078,MATH 20E,B01,083773,Ciotti; Benjamin,15,0,35,20
1656156234078,MATH 20E,B02,083774,Ciotti; Benjamin,15,0,35,20
1656156240119,MATH 103A,A01,083777,Greenfeld; Be'Eri,1,0,36,35
1656156240119,MATH 103A,A02,083778,Greenfeld; Be'Eri,1,0,36,35
1656156240119,MATH 103A,A03,093561,Staff,4,0,36,32
1656156240119,MATH 103A,B01,083779,Greenfeld; Be'Eri,8,1,36,28
1656156240119,MATH 103A,B02,083780,Greenfeld; Be'Eri,1,0,36,35
1656156240119,MATH 103A,B03,093562,Staff,0,0,36,36
1656156246157,MATH 105,A01,085443,Carter; Anne Toulson,5,1,35,30
1656156246157,MATH 105,A02,093477,Staff,11,0,35,24
1656156252187,MATH 109,A01,083213,Ganzberger; Geoffrey Michael,0,0,34,34
1656156252187,MATH 109,A02,083214,Ganzberger; Geoffrey Michael,0,0,34,34
1656156252187,MATH 109,A03,093478,Staff,1,0,34,33
1656156252187,MATH 109,B01,083215,Ganzberger; Geoffrey Michael,4,0,32,28
1656156252187,MATH 109,B02,083216,Ganzberger; Geoffrey Michael,1,0,32,31
1656156252187,MATH 109,B03,093479,Staff,4,0,32,28
1656156258226,MATH 142A,A01,083219,Chow; Bennett,1,0,32,31
1656156258226,MATH 142A,A02,083220,Chow; Bennett,8,0,32,24
1656156258226,MATH 142A,A03,093480,Staff,5,0,32,27
1656156258226,MATH 142A,B03,093481,Staff,4,0,32,28
1656156258226,MATH 142A,B04,093558,Staff,6,0,32,26
1656156258226,MATH 142A,B05,093559,Staff,0,0,32,32
1656156264255,MATH 193A,A01,083224,Rotar; Vladimir,0,1,34,34
1656156264255,MATH 193A,A02,083225,Rotar; Vladimir,0,0,34,34
1656156264255,MATH 193A,A03,083781,Rotar; Vladimir,0,0,34,34
1656156264255,MATH 193A,A04,083782,Rotar; Vladimir,6,0,34,28
1656156264255,MATH 193A,A05,093482,Rotar; Vladimir,1,0,34,33
1656156270284,MATH 197,001,091859,McAuley; Julian John,9999,0,9999,0
1656156270284,MATH 197,002,095566,Kedlaya; Kiran S.,9997,0,9999,2
1656156270284,MATH 197,003,095567,Xiao; Ming,9999,0,9999,0
1656156270284,MATH 197,004,095571,Perols; Johan Lars,9998,0,9999,1
1656156277392,COGS 9,A01,083615,Shannon; Kyle Michael,4,0,75,71
1656156283422,COGS 11,A01,083617,Boyle; Mary E. T.,14,0,48,34
1656156289455,COGS 13,A01,083071,Bastos; Amalia Pinkusfeld,6,0,71,65
1656156295484,COGS 14A,A01,092681,Semenuks; Arturs,4,15,100,96
1656156301512,COGS 14B,A01,083073,Cheng; Tzu-Han,7,0,63,56
1656156307536,COGS 17,A01,092677,Semenuks; Arturs,8,0,81,73
1656156313567,COGS 100,A01,083619,Allen; Michael Gordon,2,0,70,68
1656156319677,COGS 101A,A01,083621,Davis; Joshua Daniel,3,0,68,65
1656156325714,COGS 101B,A01,091572,Allen; Michael Gordon,6,0,65,59
1656156331742,COGS 101C,A01,083625,Delgado; Tania,10,0,35,25
1656156337769,COGS 107A,A01,083627,Boyle; Mary E. T.,0,0,60,60
1656156343804,COGS 118A,A01,083075,Gupta; Anjum,7,0,76,69
1656156349835,CSE 3,A50,083646,Miranda; Gregory Joseph,18,0,50,32
1656156355863,CSE 8A,A50,083650,Miranda; Gregory Joseph,3,3,56,53
1656156361891,CSE 11,A01,083080,Cao; Yingjun,1,54,40,39
1656156367925,CSE 12,A01,083652,Krause-Levy; Sophia Louisa,7,2,120,113
1656156373966,CSE 15L,A01,083654,Morris; Justin Loren,2,0,50,48
1656156373966,CSE 15L,A02,083655,Morris; Justin Loren,4,0,50,46
1656156380000,CSE 20,A01,083657,Tran; Khoa Dang,31,0,80,49
1656156386043,CSE 21,A01,095574,Bach; Quang Tran,25,0,48,23
1656156392076,CSE 30,A01,083084,Eldon; John,2,8,80,78
1656156392076,CSE 30,B01,095061,Bhaskar; Nishant,1,2,50,49
1656156398105,CSE 100,A01,083659,Cao; Yingjun,2,20,70,68
1656156404132,CSE 134B,A01,083661,Powell; Thomas Allan,3,0,100,97
1656156410165,CSE 140,A01,083663,Gungor; Onat,9,0,85,76
1656156416192,CSE 140L,A01,083088,Eldon; John,8,0,100,92
1656156422221,CSE 175,A01,083665,Kumar; Rakesh,0,0,25,25
1656156428249,CSE 190,A00,092507,Dubnov; Shlomo,3,0,20,17
1656156434294,ECE 45,A01,083139,Congero; Spencer William,1,0,75,74
1656156440325,ECE 65,A50,083695,Saad; Andrew S,9,0,30,21
1656156440325,ECE 65,A51,095125,Staff,23,0,26,3
1656156446360,ECE 109,A01,091882,Touri; Behrouz,0,1,70,70
1656156452386,ECE 180,A00,083140,Abi Samra; Nicholas Camill,1,0,30,29
1656156452386,ECE 180,B00,083141,Abi Samra; Nicholas Camill,0,4,30,30
1656156458426,MATH 10A,A01,083735,Patchell; Gregory David,0,0,30,30
1656156458426,MATH 10A,A02,083736,Patchell; Gregory David,22,0,30,8
1656156458426,MATH 10A,A03,083737,Patchell; Gregory David,16,0,30,14
1656156464458,MATH 10B,A01,083207,Lim; Seonhee,0,0,34,34
1656156464458,MATH 10B,A02,083208,Lim; Seonhee,7,0,35,28
1656156464458,MATH 10B,A03,093472,Staff,1,0,34,33
1656156464458,MATH 10B,B01,083739,Sinha; Shubham,10,0,30,20
1656156470490,MATH 18,A01,083743,Cinel; Cameron Alexander,7,0,30,23
1656156470490,MATH 18,A02,083744,Cinel; Cameron Alexander,10,0,30,20
1656156470490,MATH 18,A03,083745,Cinel; Cameron Alexander,4,0,30,26
1656156470490,MATH 18,B01,083748,Rideout; David Porter,0,0,36,36
1656156470490,MATH 18,B02,083749,Rideout; David Porter,0,0,36,36
1656156470490,MATH 18,B03,083750,Rideout; David Porter,0,0,36,36
1656156470490,MATH 18,B04,083751,Rideout; David Porter,0,0,36,36
1656156470490,MATH 18,B05,093473,Rideout; David Porter,1,0,36,35
1656156470490,MATH 18,B06,093474,Rideout; David Porter,4,0,36,32
1656156476524,MATH 20A,A01,083754,Zheng; Zequn,11,0,40,29
1656156482554,MATH 20B,A01,083756,Briones; Jor-el Thomas Caparas,0,0,36,36
1656156482554,MATH 20B,A02,083757,Briones; Jor-el Thomas Caparas,0,0,36,36
1656156482554,MATH 20B,A03,093475,Staff,2,0,36,34
1656156488592,MATH 20C,A01,083760,Briones; Jor-el Thomas Caparas,0,0,35,35
1656156488592,MATH 20C,A02,083761,Briones; Jor-el Thomas Caparas,9,1,35,26
1656156488592,MATH 20C,A03,093476,Staff,0,0,35,35
1656156488592,MATH 20C,B01,083762,Bach; Quang Tran,1,0,30,29
1656156494627,MATH 20D,A01,083765,Tran; Brian Kha,2,0,30,28
1656156494627,MATH 20D,A02,083766,Tran; Brian Kha,0,1,30,30
1656156494627,MATH 20D,A03,083767,Tran; Brian Kha,2,0,30,28
1656156500666,MATH 20E,A01,083771,Ganguly; Soumya,4,0,32,28
1656156500666,MATH 20E,A02,083772,Ganguly; Soumya,0,0,32,32
1656156500666,MATH 20E,B01,083773,Ciotti; Benjamin,15,0,35,20
1656156500666,MATH 20E,B02,083774,Ciotti; Benjamin,15,0,35,20
1656156506696,MATH 103A,A01,083777,Greenfeld; Be'Eri,1,0,36,35
1656156506696,MATH 103A,A02,083778,Greenfeld; Be'Eri,1,0,36,35
1656156506696,MATH 103A,A03,093561,Staff,4,0,36,32
1656156506696,MATH 103A,B01,083779,Greenfeld; Be'Eri,8,1,36,28
1656156506696,MATH 103A,B02,083780,Greenfeld; Be'Eri,1,0,36,35
1656156506696,MATH 103A,B03,093562,Staff,0,0,36,36
1656156512737,MATH 105,A01,085443,Carter; Anne Toulson,5,1,35,30
1656156512737,MATH 105,A02,093477,Staff,11,0,35,24
1656156518765,MATH 109,A01,083213,Ganzberger; Geoffrey Michael,0,0,34,34
1656156518765,MATH 109,A02,083214,Ganzberger; Geoffrey Michael,0,0,34,34
1656156518765,MATH 109,A03,093478,Staff,1,0,34,33
1656156518765,MATH 109,B01,083215,Ganzberger; Geoffrey Michael,4,0,32,28
1656156518765,MATH 109,B02,083216,Ganzberger; Geoffrey Michael,1,0,32,31
1656156518765,MATH 109,B03,093479,Staff,4,0,32,28
1656156524796,MATH 142A,A01,083219,Chow; Bennett,1,0,32,31
1656156524796,MATH 142A,A02,083220,Chow; Bennett,8,0,32,24
1656156524796,MATH 142A,A03,093480,Staff,5,0,32,27
1656156524796,MATH 142A,B03,093481,Staff,4,0,32,28
1656156524796,MATH 142A,B04,093558,Staff,6,0,32,26
1656156524796,MATH 142A,B05,093559,Staff,0,0,32,32
1656156530830,MATH 193A,A01,083224,Rotar; Vladimir,0,1,34,34
1656156530830,MATH 193A,A02,083225,Rotar; Vladimir,0,0,34,34
1656156530830,MATH 193A,A03,083781,Rotar; Vladimir,0,0,34,34
1656156530830,MATH 193A,A04,083782,Rotar; Vladimir,6,0,34,28
1656156530830,MATH 193A,A05,093482,Rotar; Vladimir,1,0,34,33
1656156536860,MATH 197,001,091859,McAuley; Julian John,9999,0,9999,0
1656156536860,MATH 197,002,095566,Kedlaya; Kiran S.,9997,0,9999,2
1656156536860,MATH 197,003,095567,Xiao; Ming,9999,0,9999,0
1656156536860,MATH 197,004,095571,Perols; Johan Lars,9998,0,9999,1
1656156543948,COGS 9,A01,083615,Shannon; Kyle Michael,4,0,75,71
1656156549984,COGS 11,A01,083617,Boyle; Mary E. T.,14,0,48,34
1656156556012,COGS 13,A01,083071,Bastos; Amalia Pinkusfeld,6,0,71,65
1656156562039,COGS 14A,A01,092681,Semenuks; Arturs,4,15,100,96
1656156568074,COGS 14B,A01,083073,Cheng; Tzu-Han,7,0,63,56
1656156574101,COGS 17,A01,092677,Semenuks; Arturs,8,0,81,73
1656156580135,COGS 100,A01,083619,Allen; Michael Gordon,2,0,70,68
1656156586162,COGS 101A,A01,083621,Davis; Joshua Daniel,3,0,68,65
1656156592188,COGS 101B,A01,091572,Allen; Michael Gordon,6,0,65,59
1656156598225,COGS 101C,A01,083625,Delgado; Tania,10,0,35,25
1656156604256,COGS 107A,A01,083627,Boyle; Mary E. T.,0,0,60,60
1656156610283,COGS 118A,A01,083075,Gupta; Anjum,7,0,76,69
1656156616320,CSE 3,A50,083646,Miranda; Gregory Joseph,18,0,50,32
1656156622352,CSE 8A,A50,083650,Miranda; Gregory Joseph,3,3,56,53
1656156628382,CSE 11,A01,083080,Cao; Yingjun,1,54,40,39
1656156634410,CSE 12,A01,083652,Krause-Levy; Sophia Louisa,7,2,120,113
1656156640435,CSE 15L,A01,083654,Morris; Justin Loren,2,0,50,48
1656156640435,CSE 15L,A02,083655,Morris; Justin Loren,4,0,50,46
1656156646467,CSE 20,A01,083657,Tran; Khoa Dang,31,0,80,49
1656156652492,CSE 21,A01,095574,Bach; Quang Tran,25,0,48,23
1656156658527,CSE 30,A01,083084,Eldon; John,2,8,80,78
1656156658527,CSE 30,B01,095061,Bhaskar; Nishant,1,2,50,49
1656156664554,CSE 100,A01,083659,Cao; Yingjun,2,20,70,68
1656156670584,CSE 134B,A01,083661,Powell; Thomas Allan,3,0,100,97
1656156676610,CSE 140,A01,083663,Gungor; Onat,9,0,85,76
1656156682638,CSE 140L,A01,083088,Eldon; John,8,0,100,92
1656156688665,CSE 175,A01,083665,Kumar; Rakesh,0,0,25,25
1656156694699,CSE 190,A00,092507,Dubnov; Shlomo,3,0,20,17
1656156700727,ECE 45,A01,083139,Congero; Spencer William,1,0,75,74
1656156706755,ECE 65,A50,083695,Saad; Andrew S,9,0,30,21
1656156706755,ECE 65,A51,095125,Staff,23,0,26,3
1656156712783,ECE 109,A01,091882,Touri; Behrouz,0,1,70,70
1656156718812,ECE 180,A00,083140,Abi Samra; Nicholas Camill,1,0,30,29
1656156718812,ECE 180,B00,083141,Abi Samra; Nicholas Camill,0,4,30,30
1656156724842,MATH 10A,A01,083735,Patchell; Gregory David,0,0,30,30
1656156724842,MATH 10A,A02,083736,Patchell; Gregory David,22,0,30,8
1656156724842,MATH 10A,A03,083737,Patchell; Gregory David,16,0,30,14
1656156730882,MATH 10B,A01,083207,Lim; Seonhee,0,0,34,34
1656156730882,MATH 10B,A02,083208,Lim; Seonhee,7,0,35,28
1656156730882,MATH 10B,A03,093472,Staff,1,0,34,33
1656156730882,MATH 10B,B01,083739,Sinha; Shubham,10,0,30,20
1656156736925,MATH 18,A01,083743,Cinel; Cameron Alexander,7,0,30,23
1656156736925,MATH 18,A02,083744,Cinel; Cameron Alexander,10,0,30,20
1656156736925,MATH 18,A03,083745,Cinel; Cameron Alexander,4,0,30,26
1656156736925,MATH 18,B01,083748,Rideout; David Porter,0,0,36,36
1656156736925,MATH 18,B02,083749,Rideout; David Porter,0,0,36,36
1656156736925,MATH 18,B03,083750,Rideout; David Porter,0,0,36,36
1656156736925,MATH 18,B04,083751,Rideout; David Porter,0,0,36,36
1656156736925,MATH 18,B05,093473,Rideout; David Porter,1,0,36,35
1656156736925,MATH 18,B06,093474,Rideout; David Porter,4,0,36,32
1656156742955,MATH 20A,A01,083754,Zheng; Zequn,11,0,40,29
1656156748983,MATH 20B,A01,083756,Briones; Jor-el Thomas Caparas,0,0,36,36
1656156748983,MATH 20B,A02,083757,Briones; Jor-el Thomas Caparas,0,0,36,36
1656156748983,MATH 20B,A03,093475,Staff,2,0,36,34
1656156755012,MATH 20C,A01,083760,Briones; Jor-el Thomas Caparas,0,0,35,35
1656156755012,MATH 20C,A02,083761,Briones; Jor-el Thomas Caparas,9,1,35,26
1656156755012,MATH 20C,A03,093476,Staff,0,0,35,35
1656156755012,MATH 20C,B01,083762,Bach; Quang Tran,1,0,30,29
1656156761045,MATH 20D,A01,083765,Tran; Brian Kha,2,0,30,28
1656156761045,MATH 20D,A02,083766,Tran; Brian Kha,0,1,30,30
1656156761045,MATH 20D,A03,083767,Tran; Brian Kha,2,0,30,28
1656156767073,MATH 20E,A01,083771,Ganguly; Soumya,4,0,32,28
1656156767073,MATH 20E,A02,083772,Ganguly; Soumya,0,0,32,32
1656156767073,MATH 20E,B01,083773,Ciotti; Benjamin,15,0,35,20
1656156767073,MATH 20E,B02,083774,Ciotti; Benjamin,15,0,35,20
1656156773104,MATH 103A,A01,083777,Greenfeld; Be'Eri,1,0,36,35
1656156773104,MATH 103A,A02,083778,Greenfeld; Be'Eri,1,0,36,35
1656156773104,MATH 103A,A03,093561,Staff,4,0,36,32
1656156773104,MATH 103A,B01,083779,Greenfeld; Be'Eri,8,1,36,28
1656156773104,MATH 103A,B02,083780,Greenfeld; Be'Eri,1,0,36,35
1656156773104,MATH 103A,B03,093562,Staff,0,0,36,36
1656156779131,MATH 105,A01,085443,Carter; Anne Toulson,5,1,35,30
1656156779131,MATH 105,A02,093477,Staff,11,0,35,24
1656156785159,MATH 109,A01,083213,Ganzberger; Geoffrey Michael,0,0,34,34
1656156785159,MATH 109,A02,083214,Ganzberger; Geoffrey Michael,0,0,34,34
1656156785159,MATH 109,A03,093478,Staff,1,0,34,33
1656156785159,MATH 109,B01,083215,Ganzberger; Geoffrey Michael,4,0,32,28
1656156785159,MATH 109,B02,083216,Ganzberger; Geoffrey Michael,1,0,32,31
1656156785159,MATH 109,B03,093479,Staff,4,0,32,28
1656156791188,MATH 142A,A01,083219,Chow; Bennett,1,0,32,31
1656156791188,MATH 142A,A02,083220,Chow; Bennett,8,0,32,24
1656156791188,MATH 142A,A03,093480,Staff,5,0,32,27
1656156791188,MATH 142A,B03,093481,Staff,4,0,32,28
1656156791188,MATH 142A,B04,093558,Staff,6,0,32,26
1656156791188,MATH 142A,B05,093559,Staff,0,0,32,32
1656156797217,MATH 193A,A01,083224,Rotar; Vladimir,0,1,34,34
1656156797217,MATH 193A,A02,083225,Rotar; Vladimir,0,0,34,34
1656156797217,MATH 193A,A03,083781,Rotar; Vladimir,0,0,34,34
1656156797217,MATH 193A,A04,083782,Rotar; Vladimir,6,0,34,28
1656156797217,MATH 193A,A05,093482,Rotar; Vladimir,1,0,34,33
1656156803250,MATH 197,001,091859,McAuley; Julian John,9999,0,9999,0
1656156803250,MATH 197,002,095566,Kedlaya; Kiran S.,9997,0,9999,2
1656156803250,MATH 197,003,095567,Xiao; Ming,9999,0,9999,0
1656156803250,MATH 197,004,095571,Perols; Johan Lars,9998,0,9999,1
1656156810332,COGS 9,A01,083615,Shannon; Kyle Michael,4,0,75,71
1656156816367,COGS 11,A01,083617,Boyle; Mary E. T.,14,0,48,34
1656156822402,COGS 13,A01,083071,Bastos; Amalia Pinkusfeld,6,0,71,65
1656156828431,COGS 14A,A01,092681,Semenuks; Arturs,4,15,100,96
1656156834457,COGS 14B,A01,083073,Cheng; Tzu-Han,7,0,63,56
1656156840484,COGS 17,A01,092677,Semenuks; Arturs,8,0,81,73
1656156846516,COGS 100,A01,083619,Allen; Michael Gordon,2,0,70,68
1656156852545,COGS 101A,A01,083621,Davis; Joshua Daniel,3,0,68,65
1656156858570,COGS 101B,A01,091572,Allen; Michael Gordon,6,0,65,59
1656156864602,COGS 101C,A01,083625,Delgado; Tania,10,0,35,25
1656156870629,COGS 107A,A01,083627,Boyle; Mary E. T.,0,0,60,60
1656156876657,COGS 118A,A01,083075,Gupta; Anjum,7,0,76,69
1656156882686,CSE 3,A50,083646,Miranda; Gregory Joseph,18,0,50,32
1656156888713,CSE 8A,A50,083650,Miranda; Gregory Joseph,3,3,56,53
1656156894745,CSE 11,A01,083080,Cao; Yingjun,1,54,40,39
1656156900772,CSE 12,A01,083652,Krause-Levy; Sophia Louisa,7,2,120,113
1656156906815,CSE 15L,A01,083654,Morris; Justin Loren,2,0,50,48
1656156906815,CSE 15L,A02,083655,Morris; Justin Loren,4,0,50,46
1656156912850,CSE 20,A01,083657,Tran; Khoa Dang,31,0,80,49
1656156918984,CSE 21,A01,095574,Bach; Quang Tran,25,0,48,23
1656156925013,CSE 30,A01,083084,Eldon; John,2,8,80,78
1656156925013,CSE 30,B01,095061,Bhaskar; Nishant,1,2,50,49
1656156931047,CSE 100,A01,083659,Cao; Yingjun,2,20,70,68
1656156937074,CSE 134B,A01,083661,Powell; Thomas Allan,3,0,100,97
1656156943101,CSE 140,A01,083663,Gungor; Onat,9,0,85,76
1656156949127,CSE 140L,A01,083088,Eldon; John,8,0,100,92
1656156955160,CSE 175,A01,083665,Kumar; Rakesh,0,0,25,25
1656156961191,CSE 190,A00,092507,Dubnov; Shlomo,3,0,20,17
1656156967226,ECE 45,A01,083139,Congero; Spencer William,1,0,75,74
1656156973253,ECE 65,A50,083695,Saad; Andrew S,9,0,30,21
1656156973253,ECE 65,A51,095125,Staff,23,0,26,3
1656156979285,ECE 109,A01,091882,Touri; Behrouz,0,1,70,70
1656156985311,ECE 180,A00,083140,Abi Samra; Nicholas Camill,1,0,30,29
1656156985311,ECE 180,B00,083141,Abi Samra; Nicholas Camill,0,4,30,30
1656156991339,MATH 10A,A01,083735,Patchell; Gregory David,0,0,30,30
1656156991339,MATH 10A,A02,083736,Patchell; Gregory David,22,0,30,8
1656156991339,MATH 10A,A03,083737,Patchell; Gregory David,16,0,30,14
1656156997375,MATH 10B,A01,083207,Lim; Seonhee,0,0,34,34
1656156997375,MATH 10B,A02,083208,Lim; Seonhee,7,0,35,28
1656156997375,MATH 10B,A03,093472,Staff,1,0,34,33
1656156997375,MATH 10B,B01,083739,Sinha; Shubham,10,0,30,20
1656157003415,MATH 18,A01,083743,Cinel; Cameron Alexander,7,0,30,23
1656157003415,MATH 18,A02,083744,Cinel; Cameron Alexander,10,0,30,20
1656157003415,MATH 18,A03,083745,Cinel; Cameron Alexander,4,0,30,26
1656157003415,MATH 18,B01,083748,Rideout; David Porter,0,0,36,36
1656157003415,MATH 18,B02,083749,Rideout; David Porter,0,0,36,36
1656157003415,MATH 18,B03,083750,Rideout; David Porter,0,0,36,36
1656157003415,MATH 18,B04,083751,Rideout; David Porter,0,0,36,36
1656157003415,MATH 18,B05,093473,Rideout; David Porter,1,0,36,35
1656157003415,MATH 18,B06,093474,Rideout; David Porter,4,0,36,32
1656157009444,MATH 20A,A01,083754,Zheng; Zequn,11,0,40,29
1656157015471,MATH 20B,A01,083756,Briones; Jor-el Thomas Caparas,0,0,36,36
1656157015471,MATH 20B,A02,083757,Briones; Jor-el Thomas Caparas,0,0,36,36
1656157015471,MATH 20B,A03,093475,Staff,2,0,36,34
1656157021498,MATH 20C,A01,083760,Briones; Jor-el Thomas Caparas,0,0,35,35
1656157021498,MATH 20C,A02,083761,Briones; Jor-el Thomas Caparas,9,1,35,26
1656157021498,MATH 20C,A03,093476,Staff,0,0,35,35
1656157021498,MATH 20C,B01,083762,Bach; Quang Tran,1,0,30,29
1656157027524,MATH 20D,A01,083765,Tran; Brian Kha,2,0,30,28
1656157027524,MATH 20D,A02,083766,Tran; Brian Kha,0,1,30,30
1656157027524,MATH 20D,A03,083767,Tran; Brian Kha,2,0,30,28
1656157033551,MATH 20E,A01,083771,Ganguly; Soumya,4,0,32,28
1656157033551,MATH 20E,A02,083772,Ganguly; Soumya,0,0,32,32
1656157033551,MATH 20E,B01,083773,Ciotti; Benjamin,15,0,35,20
1656157033551,MATH 20E,B02,083774,Ciotti; Benjamin,15,0,35,20
1656157039581,MATH 103A,A01,083777,Greenfeld; Be'Eri,1,0,36,35
1656157039581,MATH 103A,A02,083778,Greenfeld; Be'Eri,1,0,36,35
1656157039581,MATH 103A,A03,093561,Staff,4,0,36,32
1656157039581,MATH 103A,B01,083779,Greenfeld; Be'Eri,8,1,36,28
1656157039581,MATH 103A,B02,083780,Greenfeld; Be'Eri,1,0,36,35
1656157039581,MATH 103A,B03,093562,Staff,0,0,36,36
1656157045610,MATH 105,A01,085443,Carter; Anne Toulson,5,1,35,30
1656157045610,MATH 105,A02,093477,Staff,11,0,35,24
1656157051637,MATH 109,A01,083213,Ganzberger; Geoffrey Michael,0,0,34,34
1656157051637,MATH 109,A02,083214,Ganzberger; Geoffrey Michael,0,0,34,34
1656157051637,MATH 109,A03,093478,Staff,1,0,34,33
1656157051637,MATH 109,B01,083215,Ganzberger; Geoffrey Michael,4,0,32,28
1656157051637,MATH 109,B02,083216,Ganzberger; Geoffrey Michael,1,0,32,31
1656157051637,MATH 109,B03,093479,Staff,4,0,32,28
1656157057664,MATH 142A,A01,083219,Chow; Bennett,1,0,32,31
1656157057664,MATH 142A,A02,083220,Chow; Bennett,8,0,32,24
1656157057664,MATH 142A,A03,093480,Staff,5,0,32,27
1656157057664,MATH 142A,B03,093481,Staff,4,0,32,28
1656157057664,MATH 142A,B04,093558,Staff,6,0,32,26
1656157057664,MATH 142A,B05,093559,Staff,0,0,32,32
1656157063692,MATH 193A,A01,083224,Rotar; Vladimir,0,1,34,34
1656157063692,MATH 193A,A02,083225,Rotar; Vladimir,0,0,34,34
1656157063692,MATH 193A,A03,083781,Rotar; Vladimir,0,0,34,34
1656157063692,MATH 193A,A04,083782,Rotar; Vladimir,6,0,34,28
1656157063692,MATH 193A,A05,093482,Rotar; Vladimir,1,0,34,33
1656157069721,MATH 197,001,091859,McAuley; Julian John,9999,0,9999,0
1656157069721,MATH 197,002,095566,Kedlaya; Kiran S.,9997,0,9999,2
1656157069721,MATH 197,003,095567,Xiao; Ming,9999,0,9999,0
1656157069721,MATH 197,004,095571,Perols; Johan Lars,9998,0,9999,1
1656157076797,COGS 9,A01,083615,Shannon; Kyle Michael,4,0,75,71
1656157082826,COGS 11,A01,083617,Boyle; Mary E. T.,14,0,48,34
1656157088860,COGS 13,A01,083071,Bastos; Amalia Pinkusfeld,6,0,71,65
1656157094886,COGS 14A,A01,092681,Semenuks; Arturs,4,15,100,96
1656157100912,COGS 14B,A01,083073,Cheng; Tzu-Han,7,0,63,56
1656157106943,COGS 17,A01,092677,Semenuks; Arturs,8,0,81,73
1656157112971,COGS 100,A01,083619,Allen; Michael Gordon,2,0,70,68
1656157119004,COGS 101A,A01,083621,Davis; Joshua Daniel,3,0,68,65
1656157125036,COGS 101B,A01,091572,Allen; Michael Gordon,6,0,65,59
1656157131067,COGS 101C,A01,083625,Delgado; Tania,10,0,35,25
1656157137095,COGS 107A,A01,083627,Boyle; Mary E. T.,0,0,60,60
1656157143121,COGS 118A,A01,083075,Gupta; Anjum,7,0,76,69
1656157149162,CSE 3,A50,083646,Miranda; Gregory Joseph,18,0,50,32
1656157155188,CSE 8A,A50,083650,Miranda; Gregory Joseph,3,3,56,53
1656157161215,CSE 11,A01,083080,Cao; Yingjun,1,54,40,39
1656157167249,CSE 12,A01,083652,Krause-Levy; Sophia Louisa,7,2,120,113
1656157173276,CSE 15L,A01,083654,Morris; Justin Loren,2,0,50,48
1656157173276,CSE 15L,A02,083655,Morris; Justin Loren,4,0,50,46
1656157179310,CSE 20,A01,083657,Tran; Khoa Dang,31,0,80,49
1656157185343,CSE 21,A01,095574,Bach; Quang Tran,25,0,48,23
1656157191378,CSE 30,A01,083084,Eldon; John,2,8,80,78
1656157191378,CSE 30,B01,095061,Bhaskar; Nishant,1,2,50,49
1656157197406,CSE 100,A01,083659,Cao; Yingjun,2,20,70,68
1656157203437,CSE 134B,A01,083661,Powell; Thomas Allan,3,0,100,97
1656157209464,CSE 140,A01,083663,Gungor; Onat,9,0,85,76
1656157215492,CSE 140L,A01,083088,Eldon; John,8,0,100,92
1656157221520,CSE 175,A01,083665,Kumar; Rakesh,0,0,25,25
1656157227549,CSE 190,A00,092507,Dubnov; Shlomo,3,0,20,17
1656157233577,ECE 45,A01,083139,Congero; Spencer William,1,0,75,74
1656157239615,ECE 65,A50,083695,Saad; Andrew S,9,0,30,21
1656157239615,ECE 65,A51,095125,Staff,23,0,26,3
1656157245643,ECE 109,A01,091882,Touri; Behrouz,0,1,70,70
1656157251670,ECE 180,A00,083140,Abi Samra; Nicholas Camill,1,0,30,29
1656157251670,ECE 180,B00,083141,Abi Samra; Nicholas Camill,0,4,30,30
1656157257706,MATH 10A,A01,083735,Patchell; Gregory David,0,0,30,30
1656157257706,MATH 10A,A02,083736,Patchell; Gregory David,22,0,30,8
1656157257706,MATH 10A,A03,083737,Patchell; Gregory David,16,0,30,14
1656157263734,MATH 10B,A01,083207,Lim; Seonhee,0,0,34,34
1656157263734,MATH 10B,A02,083208,Lim; Seonhee,7,0,35,28
1656157263734,MATH 10B,A03,093472,Staff,1,0,34,33
1656157263734,MATH 10B,B01,083739,Sinha; Shubham,10,0,30,20
1656157269778,MATH 18,A01,083743,Cinel; Cameron Alexander,7,0,30,23
1656157269778,MATH 18,A02,083744,Cinel; Cameron Alexander,10,0,30,20
1656157269778,MATH 18,A03,083745,Cinel; Cameron Alexander,4,0,30,26
1656157269778,MATH 18,B01,083748,Rideout; David Porter,0,0,36,36
1656157269778,MATH 18,B02,083749,Rideout; David Porter,0,0,36,36
1656157269778,MATH 18,B03,083750,Rideout; David Porter,0,0,36,36
1656157269778,MATH 18,B04,083751,Rideout; David Porter,0,0,36,36
1656157269778,MATH 18,B05,093473,Rideout; David Porter,1,0,36,35
1656157269778,MATH 18,B06,093474,Rideout; David Porter,4,0,36,32
1656157275804,MATH 20A,A01,083754,Zheng; Zequn,11,0,40,29
1656157281839,MATH 20B,A01,083756,Briones; Jor-el Thomas Caparas,0,0,36,36
1656157281839,MATH 20B,A02,083757,Briones; Jor-el Thomas Caparas,0,0,36,36
1656157281839,MATH 20B,A03,093475,Staff,2,0,36,34
1656157287872,MATH 20C,A01,083760,Briones; Jor-el Thomas Caparas,0,0,35,35
1656157287872,MATH 20C,A02,083761,Briones; Jor-el Thomas Caparas,9,1,35,26
1656157287872,MATH 20C,A03,093476,Staff,0,0,35,35
1656157287872,MATH 20C,B01,083762,Bach; Quang Tran,1,0,30,29
1656157293909,MATH 20D,A01,083765,Tran; Brian Kha,2,0,30,28
1656157293909,MATH 20D,A02,083766,Tran; Brian Kha,0,1,30,30
1656157293909,MATH 20D,A03,083767,Tran; Brian Kha,2,0,30,28
1656157299936,MATH 20E,A01,083771,Ganguly; Soumya,4,0,32,28
1656157299936,MATH 20E,A02,083772,Ganguly; Soumya,0,0,32,32
1656157299936,MATH 20E,B01,083773,Ciotti; Benjamin,15,0,35,20
1656157299936,MATH 20E,B02,083774,Ciotti; Benjamin,15,0,35,20
1656157305966,MATH 103A,A01,083777,Greenfeld; Be'Eri,1,0,36,35
1656157305966,MATH 103A,A02,083778,Greenfeld; Be'Eri,1,0,36,35
1656157305966,MATH 103A,A03,093561,Staff,4,0,36,32
1656157305966,MATH 103A,B01,083779,Greenfeld; Be'Eri,8,1,36,28
1656157305966,MATH 103A,B02,083780,Greenfeld; Be'Eri,1,0,36,35
1656157305966,MATH 103A,B03,093562,Staff,0,0,36,36
1656157312000,MATH 105,A01,085443,Carter; Anne Toulson,5,1,35,30
1656157312000,MATH 105,A02,093477,Staff,11,0,35,24
1656157318027,MATH 109,A01,083213,Ganzberger; Geoffrey Michael,0,0,34,34
1656157318027,MATH 109,A02,083214,Ganzberger; Geoffrey Michael,0,0,34,34
1656157318027,MATH 109,A03,093478,Staff,1,0,34,33
1656157318027,MATH 109,B01,083215,Ganzberger; Geoffrey Michael,4,0,32,28
1656157318027,MATH 109,B02,083216,Ganzberger; Geoffrey Michael,1,0,32,31
1656157318027,MATH 109,B03,093479,Staff,4,0,32,28
1656157324061,MATH 142A,A01,083219,Chow; Bennett,1,0,32,31
1656157324061,MATH 142A,A02,083220,Chow; Bennett,8,0,32,24
1656157324061,MATH 142A,A03,093480,Staff,5,0,32,27
1656157324061,MATH 142A,B03,093481,Staff,4,0,32,28
1656157324061,MATH 142A,B04,093558,Staff,6,0,32,26
1656157324061,MATH 142A,B05,093559,Staff,0,0,32,32
1656157330089,MATH 193A,A01,083224,Rotar; Vladimir,0,1,34,34
1656157330089,MATH 193A,A02,083225,Rotar; Vladimir,0,0,34,34
1656157330089,MATH 193A,A03,083781,Rotar; Vladimir,0,0,34,34
1656157330089,MATH 193A,A04,083782,Rotar; Vladimir,6,0,34,28
1656157330089,MATH 193A,A05,093482,Rotar; Vladimir,1,0,34,33
1656157336122,MATH 197,001,091859,McAuley; Julian John,9999,0,9999,0
1656157336122,MATH 197,002,095566,Kedlaya; Kiran S.,9997,0,9999,2
1656157336122,MATH 197,003,095567,Xiao; Ming,9999,0,9999,0
1656157336122,MATH 197,004,095571,Perols; Johan Lars,9998,0,9999,1
1656157343198,COGS 9,A01,083615,Shannon; Kyle Michael,4,0,75,71
1656157349231,COGS 11,A01,083617,Boyle; Mary E. T.,14,0,48,34
1656157355263,COGS 13,A01,083071,Bastos; Amalia Pinkusfeld,6,0,71,65
1656157361294,COGS 14A,A01,092681,Semenuks; Arturs,4,15,100,96
1656157367320,COGS 14B,A01,083073,Cheng; Tzu-Han,7,0,63,56
1656157373350,COGS 17,A01,092677,Semenuks; Arturs,8,0,81,73
1656157379377,COGS 100,A01,083619,Allen; Michael Gordon,2,0,70,68
1656157385404,COGS 101A,A01,083621,Davis; Joshua Daniel,3,0,68,65
1656157391434,COGS 101B,A01,091572,Allen; Michael Gordon,6,0,65,59
1656157397472,COGS 101C,A01,083625,Delgado; Tania,10,0,35,25
1656157403498,COGS 107A,A01,083627,Boyle; Mary E. T.,0,0,60,60
1656157409524,COGS 118A,A01,083075,Gupta; Anjum,7,0,76,69
1656157415557,CSE 3,A50,083646,Miranda; Gregory Joseph,18,0,50,32
1656157421581,CSE 8A,A50,083650,Miranda; Gregory Joseph,3,3,56,53
1656157427616,CSE 11,A01,083080,Cao; Yingjun,1,54,40,39
1656157433643,CSE 12,A01,083652,Krause-Levy; Sophia Louisa,7,2,120,113
1656157439671,CSE 15L,A01,083654,Morris; Justin Loren,2,0,50,48
1656157439671,CSE 15L,A02,083655,Morris; Justin Loren,4,0,50,46
1656157445702,CSE 20,A01,083657,Tran; Khoa Dang,31,0,80,49
1656157451730,CSE 21,A01,095574,Bach; Quang Tran,25,0,48,23
1656157457758,CSE 30,A01,083084,Eldon; John,2,8,80,78
1656157457758,CSE 30,B01,095061,Bhaskar; Nishant,1,2,50,49
1656157463790,CSE 100,A01,083659,Cao; Yingjun,2,20,70,68
1656157469817,CSE 134B,A01,083661,Powell; Thomas Allan,3,0,100,97
1656157475841,CSE 140,A01,083663,Gungor; Onat,9,0,85,76
1656157481868,CSE 140L,A01,083088,Eldon; John,8,0,100,92
1656157487894,CSE 175,A01,083665,Kumar; Rakesh,0,0,25,25
1656157493921,CSE 190,A00,092507,Dubnov; Shlomo,3,0,20,17
1656157499952,ECE 45,A01,083139,Congero; Spencer William,1,0,75,74
1656157505979,ECE 65,A50,083695,Saad; Andrew S,9,0,30,21
1656157505979,ECE 65,A51,095125,Staff,23,0,26,3
1656157512009,ECE 109,A01,091882,Touri; Behrouz,0,1,70,70
1656157518126,ECE 180,A00,083140,Abi Samra; Nicholas Camill,1,0,30,29
1656157518126,ECE 180,B00,083141,Abi Samra; Nicholas Camill,0,4,30,30
1656157524155,MATH 10A,A01,083735,Patchell; Gregory David,0,0,30,30
1656157524155,MATH 10A,A02,083736,Patchell; Gregory David,22,0,30,8
1656157524155,MATH 10A,A03,083737,Patchell; Gregory David,16,0,30,14
1656157530196,MATH 10B,A01,083207,Lim; Seonhee,0,0,34,34
1656157530196,MATH 10B,A02,083208,Lim; Seonhee,7,0,35,28
1656157530196,MATH 10B,A03,093472,Staff,1,0,34,33
1656157530196,MATH 10B,B01,083739,Sinha; Shubham,10,0,30,20
1656157536228,MATH 18,A01,083743,Cinel; Cameron Alexander,7,0,30,23
1656157536228,MATH 18,A02,083744,Cinel; Cameron Alexander,10,0,30,20
1656157536228,MATH 18,A03,083745,Cinel; Cameron Alexander,4,0,30,26
1656157536228,MATH 18,B01,083748,Rideout; David Porter,0,0,36,36
1656157536228,MATH 18,B02,083749,Rideout; David Porter,0,0,36,36
1656157536228,MATH 18,B03,083750,Rideout; David Porter,0,0,36,36
1656157536228,MATH 18,B04,083751,Rideout; David Porter,0,0,36,36
1656157536228,MATH 18,B05,093473,Rideout; David Porter,1,0,36,35
1656157536228,MATH 18,B06,093474,Rideout; David Porter,4,0,36,32
1656157542254,MATH 20A,A01,083754,Zheng; Zequn,11,0,40,29
1656157548289,MATH 20B,A01,083756,Briones; Jor-el Thomas Caparas,0,0,36,36
1656157548289,MATH 20B,A02,083757,Briones; Jor-el Thomas Caparas,0,0,36,36
1656157548289,MATH 20B,A03,093475,Staff,2,0,36,34
1656157554316,MATH 20C,A01,083760,Briones; Jor-el Thomas Caparas,0,0,35,35
1656157554316,MATH 20C,A02,083761,Briones; Jor-el Thomas Caparas,9,1,35,26
1656157554316,MATH 20C,A03,093476,Staff,0,0,35,35
1656157554316,MATH 20C,B01,083762,Bach; Quang Tran,1,0,30,29
1656157560343,MATH 20D,A01,083765,Tran; Brian Kha,2,0,30,28
1656157560343,MATH 20D,A02,083766,Tran; Brian Kha,0,1,30,30
1656157560343,MATH 20D,A03,083767,Tran; Brian Kha,2,0,30,28
1656157566379,MATH 20E,A01,083771,Ganguly; Soumya,4,0,32,28
1656157566379,MATH 20E,A02,083772,Ganguly; Soumya,0,0,32,32
1656157566379,MATH 20E,B01,083773,Ciotti; Benjamin,15,0,35,20
1656157566379,MATH 20E,B02,083774,Ciotti; Benjamin,15,0,35,20
1656157572408,MATH 103A,A01,083777,Greenfeld; Be'Eri,1,0,36,35
1656157572408,MATH 103A,A02,083778,Greenfeld; Be'Eri,1,0,36,35
1656157572408,MATH 103A,A03,093561,Staff,4,0,36,32
1656157572408,MATH 103A,B01,083779,Greenfeld; Be'Eri,8,1,36,28
1656157572408,MATH 103A,B02,083780,Greenfeld; Be'Eri,1,0,36,35
1656157572408,MATH 103A,B03,093562,Staff,0,0,36,36
1656157578436,MATH 105,A01,085443,Carter; Anne Toulson,5,1,35,30
1656157578436,MATH 105,A02,093477,Staff,11,0,35,24
1656157584463,MATH 109,A01,083213,Ganzberger; Geoffrey Michael,0,0,34,34
1656157584463,MATH 109,A02,083214,Ganzberger; Geoffrey Michael,0,0,34,34
1656157584463,MATH 109,A03,093478,Staff,1,0,34,33
1656157584463,MATH 109,B01,083215,Ganzberger; Geoffrey Michael,4,0,32,28
1656157584463,MATH 109,B02,083216,Ganzberger; Geoffrey Michael,1,0,32,31
1656157584463,MATH 109,B03,093479,Staff,4,0,32,28
1656157590502,MATH 142A,A01,083219,Chow; Bennett,1,0,32,31
1656157590502,MATH 142A,A02,083220,Chow; Bennett,8,0,32,24
1656157590502,MATH 142A,A03,093480,Staff,5,0,32,27
1656157590502,MATH 142A,B03,093481,Staff,4,0,32,28
1656157590502,MATH 142A,B04,093558,Staff,6,0,32,26
1656157590502,MATH 142A,B05,093559,Staff,0,0,32,32
1656157596529,MATH 193A,A01,083224,Rotar; Vladimir,0,1,34,34
1656157596529,MATH 193A,A02,083225,Rotar; Vladimir,0,0,34,34
1656157596529,MATH 193A,A03,083781,Rotar; Vladimir,0,0,34,34
1656157596529,MATH 193A,A04,083782,Rotar; Vladimir,6,0,34,28
1656157596529,MATH 193A,A05,093482,Rotar; Vladimir,1,0,34,33
1656157602557,MATH 197,001,091859,McAuley; Julian John,9999,0,9999,0
1656157602557,MATH 197,002,095566,Kedlaya; Kiran S.,9997,0,9999,2
1656157602557,MATH 197,003,095567,Xiao; Ming,9999,0,9999,0
1656157602557,MATH 197,004,095571,Perols; Johan Lars,9998,0,9999,1
1656157609636,COGS 9,A01,083615,Shannon; Kyle Michael,4,0,75,71
1656157615663,COGS 11,A01,083617,Boyle; Mary E. T.,14,0,48,34
1656157621688,COGS 13,A01,083071,Bastos; Amalia Pinkusfeld,6,0,71,65
1656157627716,COGS 14A,A01,092681,Semenuks; Arturs,4,15,100,96
1656157633742,COGS 14B,A01,083073,Cheng; Tzu-Han,7,0,63,56
1656157639768,COGS 17,A01,092677,Semenuks; Arturs,8,0,81,73
1656157645795,COGS 100,A01,083619,Allen; Michael Gordon,2,0,70,68
1656157651821,COGS 101A,A01,083621,Davis; Joshua Daniel,3,0,68,65
1656157657847,COGS 101B,A01,091572,Allen; Michael Gordon,6,0,65,59
1656157663873,COGS 101C,A01,083625,Delgado; Tania,10,0,35,25
1656157669900,COGS 107A,A01,083627,Boyle; Mary E. T.,0,0,60,60
1656157675931,COGS 118A,A01,083075,Gupta; Anjum,7,0,76,69
1656157681965,CSE 3,A50,083646,Miranda; Gregory Joseph,18,0,50,32
1656157687997,CSE 8A,A50,083650,Miranda; Gregory Joseph,3,3,56,53
1656157694023,CSE 11,A01,083080,Cao; Yingjun,1,54,40,39
1656157700054,CSE 12,A01,083652,Krause-Levy; Sophia Louisa,7,2,120,113
1656157706086,CSE 15L,A01,083654,Morris; Justin Loren,2,0,50,48
1656157706086,CSE 15L,A02,083655,Morris; Justin Loren,4,0,50,46
1656157712117,CSE 20,A01,083657,Tran; Khoa Dang,31,0,80,49
1656157718148,CSE 21,A01,095574,Bach; Quang Tran,25,0,48,23
1656157724187,CSE 30,A01,083084,Eldon; John,2,8,80,78
1656157724187,CSE 30,B01,095061,Bhaskar; Nishant,1,2,50,49
1656157730213,CSE 100,A01,083659,Cao; Yingjun,2,20,70,68
1656157736239,CSE 134B,A01,083661,Powell; Thomas Allan,3,0,100,97
1656157742265,CSE 140,A01,083663,Gungor; Onat,9,0,85,76
1656157748295,CSE 140L,A01,083088,Eldon; John,8,0,100,92
1656157754327,CSE 175,A01,083665,Kumar; Rakesh,0,0,25,25
1656157760353,CSE 190,A00,092507,Dubnov; Shlomo,3,0,20,17
1656157766384,ECE 45,A01,083139,Congero; Spencer William,1,0,75,74
1656157772411,ECE 65,A50,083695,Saad; Andrew S,9,0,30,21
1656157772411,ECE 65,A51,095125,Staff,23,0,26,3
1656157778438,ECE 109,A01,091882,Touri; Behrouz,0,1,70,70
1656157784465,ECE 180,A00,083140,Abi Samra; Nicholas Camill,1,0,30,29
1656157784465,ECE 180,B00,083141,Abi Samra; Nicholas Camill,0,4,30,30
1656157790501,MATH 10A,A01,083735,Patchell; Gregory David,0,0,30,30
1656157790501,MATH 10A,A02,083736,Patchell; Gregory David,22,0,30,8
1656157790501,MATH 10A,A03,083737,Patchell; Gregory David,16,0,30,14
1656157796532,MATH 10B,A01,083207,Lim; Seonhee,0,0,34,34
1656157796532,MATH 10B,A02,083208,Lim; Seonhee,7,0,35,28
1656157796532,MATH 10B,A03,093472,Staff,1,0,34,33
1656157796532,MATH 10B,B01,083739,Sinha; Shubham,10,0,30,20
1656157802562,MATH 18,A01,083743,Cinel; Cameron Alexander,7,0,30,23
1656157802562,MATH 18,A02,083744,Cinel; Cameron Alexander,10,0,30,20
1656157802562,MATH 18,A03,083745,Cinel; Cameron Alexander,4,0,30,26
1656157802562,MATH 18,B01,083748,Rideout; David Porter,0,0,36,36
1656157802562,MATH 18,B02,083749,Rideout; David Porter,0,0,36,36
1656157802562,MATH 18,B03,083750,Rideout; David Porter,0,0,36,36
1656157802562,MATH 18,B04,083751,Rideout; David Porter,0,0,36,36
1656157802562,MATH 18,B05,093473,Rideout; David Porter,1,0,36,35
1656157802562,MATH 18,B06,093474,Rideout; David Porter,4,0,36,32
1656157808593,MATH 20A,A01,083754,Zheng; Zequn,11,0,40,29
1656157814626,MATH 20B,A01,083756,Briones; Jor-el Thomas Caparas,0,0,36,36
1656157814626,MATH 20B,A02,083757,Briones; Jor-el Thomas Caparas,0,0,36,36
1656157814626,MATH 20B,A03,093475,Staff,2,0,36,34
1656157820659,MATH 20C,A01,083760,Briones; Jor-el Thomas Caparas,0,0,35,35
1656157820659,MATH 20C,A02,083761,Briones; Jor-el Thomas Caparas,9,1,35,26
1656157820659,MATH 20C,A03,093476,Staff,0,0,35,35
1656157820659,MATH 20C,B01,083762,Bach; Quang Tran,1,0,30,29
1656157826686,MATH 20D,A01,083765,Tran; Brian Kha,2,0,30,28
1656157826686,MATH 20D,A02,083766,Tran; Brian Kha,0,1,30,30
1656157826686,MATH 20D,A03,083767,Tran; Brian Kha,2,0,30,28
1656157832723,MATH 20E,A01,083771,Ganguly; Soumya,4,0,32,28
1656157832723,MATH 20E,A02,083772,Ganguly; Soumya,0,0,32,32
1656157832723,MATH 20E,B01,083773,Ciotti; Benjamin,15,0,35,20
1656157832723,MATH 20E,B02,083774,Ciotti; Benjamin,15,0,35,20
1656157838761,MATH 103A,A01,083777,Greenfeld; Be'Eri,1,0,36,35
1656157838761,MATH 103A,A02,083778,Greenfeld; Be'Eri,1,0,36,35
1656157838761,MATH 103A,A03,093561,Staff,4,0,36,32
1656157838761,MATH 103A,B01,083779,Greenfeld; Be'Eri,8,1,36,28
1656157838761,MATH 103A,B02,083780,Greenfeld; Be'Eri,1,0,36,35
1656157838761,MATH 103A,B03,093562,Staff,0,0,36,36
1656157844789,MATH 105,A01,085443,Carter; Anne Toulson,5,1,35,30
1656157844789,MATH 105,A02,093477,Staff,11,0,35,24
1656157850822,MATH 109,A01,083213,Ganzberger; Geoffrey Michael,0,0,34,34
1656157850822,MATH 109,A02,083214,Ganzberger; Geoffrey Michael,0,0,34,34
1656157850822,MATH 109,A03,093478,Staff,1,0,34,33
1656157850822,MATH 109,B01,083215,Ganzberger; Geoffrey Michael,4,0,32,28
1656157850822,MATH 109,B02,083216,Ganzberger; Geoffrey Michael,1,0,32,31
1656157850822,MATH 109,B03,093479,Staff,4,0,32,28
1656157856856,MATH 142A,A01,083219,Chow; Bennett,1,0,32,31
1656157856856,MATH 142A,A02,083220,Chow; Bennett,8,0,32,24
1656157856856,MATH 142A,A03,093480,Staff,5,0,32,27
1656157856856,MATH 142A,B03,093481,Staff,4,0,32,28
1656157856856,MATH 142A,B04,093558,Staff,6,0,32,26
1656157856856,MATH 142A,B05,093559,Staff,0,0,32,32
1656157862885,MATH 193A,A01,083224,Rotar; Vladimir,0,1,34,34
1656157862885,MATH 193A,A02,083225,Rotar; Vladimir,0,0,34,34
1656157862885,MATH 193A,A03,083781,Rotar; Vladimir,0,0,34,34
1656157862885,MATH 193A,A04,083782,Rotar; Vladimir,6,0,34,28
1656157862885,MATH 193A,A05,093482,Rotar; Vladimir,1,0,34,33
1656157868911,MATH 197,001,091859,McAuley; Julian John,9999,0,9999,0
1656157868911,MATH 197,002,095566,Kedlaya; Kiran S.,9997,0,9999,2
1656157868911,MATH 197,003,095567,Xiao; Ming,9999,0,9999,0
1656157868911,MATH 197,004,095571,Perols; Johan Lars,9998,0,9999,1
1656157875999,COGS 9,A01,083615,Shannon; Kyle Michael,4,0,75,71
1656157882031,COGS 11,A01,083617,Boyle; Mary E. T.,14,0,48,34
1656157888058,COGS 13,A01,083071,Bastos; Amalia Pinkusfeld,6,0,71,65
1656157894091,COGS 14A,A01,092681,Semenuks; Arturs,4,15,100,96
1656157900117,COGS 14B,A01,083073,Cheng; Tzu-Han,7,0,63,56
1656157906143,COGS 17,A01,092677,Semenuks; Arturs,8,0,81,73
1656157912175,COGS 100,A01,083619,Allen; Michael Gordon,2,0,70,68
1656157918206,COGS 101A,A01,083621,Davis; Joshua Daniel,3,0,68,65
1656157924234,COGS 101B,A01,091572,Allen; Michael Gordon,6,0,65,59
1656157930265,COGS 101C,A01,083625,Delgado; Tania,10,0,35,25
1656157936294,COGS 107A,A01,083627,Boyle; Mary E. T.,0,0,60,60
1656157942320,COGS 118A,A01,083075,Gupta; Anjum,7,0,76,69
1656157948351,CSE 3,A50,083646,Miranda; Gregory Joseph,18,0,50,32
1656157954378,CSE 8A,A50,083650,Miranda; Gregory Joseph,3,3,56,53
1656157960406,CSE 11,A01,083080,Cao; Yingjun,1,54,40,39
1656157966437,CSE 12,A01,083652,Krause-Levy; Sophia Louisa,7,2,120,113
1656157972462,CSE 15L,A01,083654,Morris; Justin Loren,2,0,50,48
1656157972462,CSE 15L,A02,083655,Morris; Justin Loren,4,0,50,46
1656157978493,CSE 20,A01,083657,Tran; Khoa Dang,31,0,80,49
1656157984522,CSE 21,A01,095574,Bach; Quang Tran,25,0,48,23
1656157990548,CSE 30,A01,083084,Eldon; John,2,8,80,78
1656157990548,CSE 30,B01,095061,Bhaskar; Nishant,1,2,50,49
1656157996583,CSE 100,A01,083659,Cao; Yingjun,2,20,70,68
1656158002614,CSE 134B,A01,083661,Powell; Thomas Allan,3,0,100,97
1656158008642,CSE 140,A01,083663,Gungor; Onat,9,0,85,76
1656158014669,CSE 140L,A01,083088,Eldon; John,8,0,100,92
1656158020702,CSE 175,A01,083665,Kumar; Rakesh,0,0,25,25
1656158026729,CSE 190,A00,092507,Dubnov; Shlomo,3,0,20,17
1656158032762,ECE 45,A01,083139,Congero; Spencer William,1,0,75,74
1656158038792,ECE 65,A50,083695,Saad; Andrew S,9,0,30,21
1656158038792,ECE 65,A51,095125,Staff,23,0,26,3
1656158044823,ECE 109,A01,091882,Touri; Behrouz,0,1,70,70
1656158050857,ECE 180,A00,083140,Abi Samra; Nicholas Camill,1,0,30,29
1656158050857,ECE 180,B00,083141,Abi Samra; Nicholas Camill,0,4,30,30
1656158056893,MATH 10A,A01,083735,Patchell; Gregory David,0,0,30,30
1656158056893,MATH 10A,A02,083736,Patchell; Gregory David,22,0,30,8
1656158056893,MATH 10A,A03,083737,Patchell; Gregory David,16,0,30,14
1656158062925,MATH 10B,A01,083207,Lim; Seonhee,0,0,34,34
1656158062925,MATH 10B,A02,083208,Lim; Seonhee,7,0,35,28
1656158062925,MATH 10B,A03,093472,Staff,1,0,34,33
1656158062925,MATH 10B,B01,083739,Sinha; Shubham,10,0,30,20
1656158068963,MATH 18,A01,083743,Cinel; Cameron Alexander,7,0,30,23
1656158068963,MATH 18,A02,083744,Cinel; Cameron Alexander,10,0,30,20
1656158068963,MATH 18,A03,083745,Cinel; Cameron Alexander,4,0,30,26
1656158068963,MATH 18,B01,083748,Rideout; David Porter,0,0,36,36
1656158068963,MATH 18,B02,083749,Rideout; David Porter,0,0,36,36
1656158068963,MATH 18,B03,083750,Rideout; David Porter,0,0,36,36
1656158068963,MATH 18,B04,083751,Rideout; David Porter,0,0,36,36
1656158068963,MATH 18,B05,093473,Rideout; David Porter,1,0,36,35
1656158068963,MATH 18,B06,093474,Rideout; David Porter,4,0,36,32
1656158074994,MATH 20A,A01,083754,Zheng; Zequn,11,0,40,29
1656158081031,MATH 20B,A01,083756,Briones; Jor-el Thomas Caparas,0,0,36,36
1656158081031,MATH 20B,A02,083757,Briones; Jor-el Thomas Caparas,0,0,36,36
1656158081031,MATH 20B,A03,093475,Staff,2,0,36,34
1656158087059,MATH 20C,A01,083760,Briones; Jor-el Thomas Caparas,0,0,35,35
1656158087059,MATH 20C,A02,083761,Briones; Jor-el Thomas Caparas,9,1,35,26
1656158087059,MATH 20C,A03,093476,Staff,0,0,35,35
1656158087059,MATH 20C,B01,083762,Bach; Quang Tran,1,0,30,29
1656158093118,MATH 20D,A01,083765,Tran; Brian Kha,2,0,30,28
1656158093118,MATH 20D,A02,083766,Tran; Brian Kha,0,1,30,30
1656158093118,MATH 20D,A03,083767,Tran; Brian Kha,2,0,30,28
1656158099146,MATH 20E,A01,083771,Ganguly; Soumya,4,0,32,28
1656158099146,MATH 20E,A02,083772,Ganguly; Soumya,0,0,32,32
1656158099146,MATH 20E,B01,083773,Ciotti; Benjamin,15,0,35,20
1656158099146,MATH 20E,B02,083774,Ciotti; Benjamin,15,0,35,20
1656158105177,MATH 103A,A01,083777,Greenfeld; Be'Eri,1,0,36,35
1656158105177,MATH 103A,A02,083778,Greenfeld; Be'Eri,1,0,36,35
1656158105177,MATH 103A,A03,093561,Staff,4,0,36,32
1656158105177,MATH 103A,B01,083779,Greenfeld; Be'Eri,8,1,36,28
1656158105177,MATH 103A,B02,083780,Greenfeld; Be'Eri,1,0,36,35
1656158105177,MATH 103A,B03,093562,Staff,0,0,36,36
1656158111203,MATH 105,A01,085443,Carter; Anne Toulson,5,1,35,30
1656158111203,MATH 105,A02,093477,Staff,11,0,35,24
1656158117304,MATH 109,A01,083213,Ganzberger; Geoffrey Michael,0,0,34,34
1656158117304,MATH 109,A02,083214,Ganzberger; Geoffrey Michael,0,0,34,34
1656158117304,MATH 109,A03,093478,Staff,1,0,34,33
1656158117304,MATH 109,B01,083215,Ganzberger; Geoffrey Michael,4,0,32,28
1656158117304,MATH 109,B02,083216,Ganzberger; Geoffrey Michael,1,0,32,31
1656158117304,MATH 109,B03,093479,Staff,4,0,32,28
1656158123337,MATH 142A,A01,083219,Chow; Bennett,1,0,32,31
1656158123337,MATH 142A,A02,083220,Chow; Bennett,8,0,32,24
1656158123337,MATH 142A,A03,093480,Staff,5,0,32,27
1656158123337,MATH 142A,B03,093481,Staff,4,0,32,28
1656158123337,MATH 142A,B04,093558,Staff,6,0,32,26
1656158123337,MATH 142A,B05,093559,Staff,0,0,32,32
1656158129366,MATH 193A,A01,083224,Rotar; Vladimir,0,1,34,34
1656158129366,MATH 193A,A02,083225,Rotar; Vladimir,0,0,34,34
1656158129366,MATH 193A,A03,083781,Rotar; Vladimir,0,0,34,34
1656158129366,MATH 193A,A04,083782,Rotar; Vladimir,6,0,34,28
1656158129366,MATH 193A,A05,093482,Rotar; Vladimir,1,0,34,33
1656158135393,MATH 197,001,091859,McAuley; Julian John,9999,0,9999,0
1656158135393,MATH 197,002,095566,Kedlaya; Kiran S.,9997,0,9999,2
1656158135393,MATH 197,003,095567,Xiao; Ming,9999,0,9999,0
1656158135393,MATH 197,004,095571,Perols; Johan Lars,9998,0,9999,1
1656158142494,COGS 9,A01,083615,Shannon; Kyle Michael,4,0,75,71
1656158148520,COGS 11,A01,083617,Boyle; Mary E. T.,14,0,48,34
1656158154545,COGS 13,A01,083071,Bastos; Amalia Pinkusfeld,6,0,71,65
1656158160571,COGS 14A,A01,092681,Semenuks; Arturs,4,15,100,96
1656158166598,COGS 14B,A01,083073,Cheng; Tzu-Han,7,0,63,56
1656158172624,COGS 17,A01,092677,Semenuks; Arturs,8,0,81,73
1656158178651,COGS 100,A01,083619,Allen; Michael Gordon,2,0,70,68
1656158184680,COGS 101A,A01,083621,Davis; Joshua Daniel,3,0,68,65
1656158190706,COGS 101B,A01,091572,Allen; Michael Gordon,6,0,65,59
1656158196735,COGS 101C,A01,083625,Delgado; Tania,10,0,35,25
1656158202761,COGS 107A,A01,083627,Boyle; Mary E. T.,0,0,60,60
1656158208785,COGS 118A,A01,083075,Gupta; Anjum,7,0,76,69
1656158214821,CSE 3,A50,083646,Miranda; Gregory Joseph,18,0,50,32
1656158220851,CSE 8A,A50,083650,Miranda; Gregory Joseph,3,3,56,53
1656158226882,CSE 11,A01,083080,Cao; Yingjun,1,54,40,39
1656158232909,CSE 12,A01,083652,Krause-Levy; Sophia Louisa,7,2,120,113
1656158238939,CSE 15L,A01,083654,Morris; Justin Loren,2,0,50,48
1656158238939,CSE 15L,A02,083655,Morris; Justin Loren,4,0,50,46
1656158244966,CSE 20,A01,083657,Tran; Khoa Dang,31,0,80,49
1656158250991,CSE 21,A01,095574,Bach; Quang Tran,25,0,48,23
1656158257024,CSE 30,A01,083084,Eldon; John,2,8,80,78
1656158257024,CSE 30,B01,095061,Bhaskar; Nishant,1,2,50,49
1656158263051,CSE 100,A01,083659,Cao; Yingjun,2,20,70,68
1656158269079,CSE 134B,A01,083661,Powell; Thomas Allan,3,0,100,97
1656158275107,CSE 140,A01,083663,Gungor; Onat,9,0,85,76
1656158281136,CSE 140L,A01,083088,Eldon; John,8,0,100,92
1656158287163,CSE 175,A01,083665,Kumar; Rakesh,0,0,25,25
1656158293188,CSE 190,A00,092507,Dubnov; Shlomo,3,0,20,17
1656158299216,ECE 45,A01,083139,Congero; Spencer William,1,0,75,74
1656158305247,ECE 65,A50,083695,Saad; Andrew S,9,0,30,21
1656158305247,ECE 65,A51,095125,Staff,23,0,26,3
1656158311273,ECE 109,A01,091882,Touri; Behrouz,0,1,70,70
1656158317303,ECE 180,A00,083140,Abi Samra; Nicholas Camill,1,0,30,29
1656158317303,ECE 180,B00,083141,Abi Samra; Nicholas Camill,0,4,30,30
1656158323332,MATH 10A,A01,083735,Patchell; Gregory David,0,0,30,30
1656158323332,MATH 10A,A02,083736,Patchell; Gregory David,22,0,30,8
1656158323332,MATH 10A,A03,083737,Patchell; Gregory David,16,0,30,14
1656158329370,MATH 10B,A01,083207,Lim; Seonhee,0,0,34,34
1656158329370,MATH 10B,A02,083208,Lim; Seonhee,7,0,35,28
1656158329370,MATH 10B,A03,093472,Staff,1,0,34,33
1656158329370,MATH 10B,B01,083739,Sinha; Shubham,10,0,30,20
1656158335401,MATH 18,A01,083743,Cinel; Cameron Alexander,7,0,30,23
1656158335401,MATH 18,A02,083744,Cinel; Cameron Alexander,10,0,30,20
1656158335401,MATH 18,A03,083745,Cinel; Cameron Alexander,4,0,30,26
1656158335401,MATH 18,B01,083748,Rideout; David Porter,0,0,36,36
1656158335401,MATH 18,B02,083749,Rideout; David Porter,0,0,36,36
1656158335401,MATH 18,B03,083750,Rideout; David Porter,0,0,36,36
1656158335401,MATH 18,B04,083751,Rideout; David Porter,0,0,36,36
1656158335401,MATH 18,B05,093473,Rideout; David Porter,1,0,36,35
1656158335401,MATH 18,B06,093474,Rideout; David Porter,4,0,36,32
1656158341427,MATH 20A,A01,083754,Zheng; Zequn,11,0,40,29
1656158347452,MATH 20B,A01,083756,Briones; Jor-el Thomas Caparas,0,0,36,36
1656158347452,MATH 20B,A02,083757,Briones; Jor-el Thomas Caparas,0,0,36,36
1656158347452,MATH 20B,A03,093475,Staff,2,0,36,34
1656158353482,MATH 20C,A01,083760,Briones; Jor-el Thomas Caparas,0,0,35,35
1656158353482,MATH 20C,A02,083761,Briones; Jor-el Thomas Caparas,9,1,35,26
1656158353482,MATH 20C,A03,093476,Staff,0,0,35,35
1656158353482,MATH 20C,B01,083762,Bach; Quang Tran,1,0,30,29
1656158359508,MATH 20D,A01,083765,Tran; Brian Kha,2,0,30,28
1656158359508,MATH 20D,A02,083766,Tran; Brian Kha,0,1,30,30
1656158359508,MATH 20D,A03,083767,Tran; Brian Kha,2,0,30,28
1656158365537,MATH 20E,A01,083771,Ganguly; Soumya,4,0,32,28
1656158365537,MATH 20E,A02,083772,Ganguly; Soumya,0,0,32,32
1656158365537,MATH 20E,B01,083773,Ciotti; Benjamin,15,0,35,20
1656158365537,MATH 20E,B02,083774,Ciotti; Benjamin,15,0,35,20
1656158371565,MATH 103A,A01,083777,Greenfeld; Be'Eri,1,0,36,35
1656158371565,MATH 103A,A02,083778,Greenfeld; Be'Eri,1,0,36,35
1656158371565,MATH 103A,A03,093561,Staff,4,0,36,32
1656158371565,MATH 103A,B01,083779,Greenfeld; Be'Eri,8,1,36,28
1656158371565,MATH 103A,B02,083780,Greenfeld; Be'Eri,1,0,36,35
1656158371565,MATH 103A,B03,093562,Staff,0,0,36,36
1656158377590,MATH 105,A01,085443,Carter; Anne Toulson,5,1,35,30
1656158377590,MATH 105,A02,093477,Staff,11,0,35,24
1656158383623,MATH 109,A01,083213,Ganzberger; Geoffrey Michael,0,0,34,34
1656158383623,MATH 109,A02,083214,Ganzberger; Geoffrey Michael,0,0,34,34
1656158383623,MATH 109,A03,093478,Staff,1,0,34,33
1656158383623,MATH 109,B01,083215,Ganzberger; Geoffrey Michael,4,0,32,28
1656158383623,MATH 109,B02,083216,Ganzberger; Geoffrey Michael,1,0,32,31
1656158383623,MATH 109,B03,093479,Staff,4,0,32,28
1656158389652,MATH 142A,A01,083219,Chow; Bennett,1,0,32,31
1656158389652,MATH 142A,A02,083220,Chow; Bennett,8,0,32,24
1656158389652,MATH 142A,A03,093480,Staff,5,0,32,27
1656158389652,MATH 142A,B03,093481,Staff,4,0,32,28
1656158389652,MATH 142A,B04,093558,Staff,6,0,32,26
1656158389652,MATH 142A,B05,093559,Staff,0,0,32,32
1656158395679,MATH 193A,A01,083224,Rotar; Vladimir,0,1,34,34
1656158395679,MATH 193A,A02,083225,Rotar; Vladimir,0,0,34,34
1656158395679,MATH 193A,A03,083781,Rotar; Vladimir,0,0,34,34
1656158395679,MATH 193A,A04,083782,Rotar; Vladimir,6,0,34,28
1656158395679,MATH 193A,A05,093482,Rotar; Vladimir,1,0,34,33
1656158401716,MATH 197,001,091859,McAuley; Julian John,9999,0,9999,0
1656158401716,MATH 197,002,095566,Kedlaya; Kiran S.,9997,0,9999,2
1656158401716,MATH 197,003,095567,Xiao; Ming,9999,0,9999,0
1656158401716,MATH 197,004,095571,Perols; Johan Lars,9998,0,9999,1
1656158408793,COGS 9,A01,083615,Shannon; Kyle Michael,4,0,75,71
1656158414820,COGS 11,A01,083617,Boyle; Mary E. T.,14,0,48,34
1656158420848,COGS 13,A01,083071,Bastos; Amalia Pinkusfeld,6,0,71,65
1656158426881,COGS 14A,A01,092681,Semenuks; Arturs,4,15,100,96
1656158432911,COGS 14B,A01,083073,Cheng; Tzu-Han,7,0,63,56
1656158438943,COGS 17,A01,092677,Semenuks; Arturs,8,0,81,73
1656158444977,COGS 100,A01,083619,Allen; Michael Gordon,2,0,70,68
1656158451008,COGS 101A,A01,083621,Davis; Joshua Daniel,3,0,68,65
1656158457038,COGS 101B,A01,091572,Allen; Michael Gordon,6,0,65,59
1656158463073,COGS 101C,A01,083625,Delgado; Tania,10,0,35,25
1656158469102,COGS 107A,A01,083627,Boyle; Mary E. T.,0,0,60,60
1656158475127,COGS 118A,A01,083075,Gupta; Anjum,7,0,76,69
1656158481155,CSE 3,A50,083646,Miranda; Gregory Joseph,18,0,50,32
1656158487186,CSE 8A,A50,083650,Miranda; Gregory Joseph,3,3,56,53
1656158493223,CSE 11,A01,083080,Cao; Yingjun,1,54,40,39
1656158499263,CSE 12,A01,083652,Krause-Levy; Sophia Louisa,7,2,120,113
1656158505293,CSE 15L,A01,083654,Morris; Justin Loren,2,0,50,48
1656158505293,CSE 15L,A02,083655,Morris; Justin Loren,4,0,50,46
1656158511320,CSE 20,A01,083657,Tran; Khoa Dang,31,0,80,49
1656158517346,CSE 21,A01,095574,Bach; Quang Tran,25,0,48,23
1656158523383,CSE 30,A01,083084,Eldon; John,2,8,80,78
1656158523383,CSE 30,B01,095061,Bhaskar; Nishant,1,2,50,49
1656158529410,CSE 100,A01,083659,Cao; Yingjun,2,20,70,68
1656158535443,CSE 134B,A01,083661,Powell; Thomas Allan,3,0,100,97
1656158541474,CSE 140,A01,083663,Gungor; Onat,9,0,85,76
1656158547499,CSE 140L,A01,083088,Eldon; John,8,0,100,92
1656158553540,CSE 175,A01,083665,Kumar; Rakesh,0,0,25,25
1656158559565,CSE 190,A00,092507,Dubnov; Shlomo,3,0,20,17
1656158565596,ECE 45,A01,083139,Congero; Spencer William,1,0,75,74
1656158571623,ECE 65,A50,083695,Saad; Andrew S,9,0,30,21
1656158571623,ECE 65,A51,095125,Staff,23,0,26,3
1656158577649,ECE 109,A01,091882,Touri; Behrouz,0,1,70,70
1656158583674,ECE 180,A00,083140,Abi Samra; Nicholas Camill,1,0,30,29
1656158583674,ECE 180,B00,083141,Abi Samra; Nicholas Camill,0,4,30,30
1656158589703,MATH 10A,A01,083735,Patchell; Gregory David,0,0,30,30
1656158589703,MATH 10A,A02,083736,Patchell; Gregory David,22,0,30,8
1656158589703,MATH 10A,A03,083737,Patchell; Gregory David,16,0,30,14
1656158595744,MATH 10B,A01,083207,Lim; Seonhee,0,0,34,34
1656158595744,MATH 10B,A02,083208,Lim; Seonhee,7,0,35,28
1656158595744,MATH 10B,A03,093472,Staff,1,0,34,33
1656158595744,MATH 10B,B01,083739,Sinha; Shubham,10,0,30,20
1656158601783,MATH 18,A01,083743,Cinel; Cameron Alexander,7,0,30,23
1656158601783,MATH 18,A02,083744,Cinel; Cameron Alexander,10,0,30,20
1656158601783,MATH 18,A03,083745,Cinel; Cameron Alexander,4,0,30,26
1656158601783,MATH 18,B01,083748,Rideout; David Porter,0,0,36,36
1656158601783,MATH 18,B02,083749,Rideout; David Porter,0,0,36,36
1656158601783,MATH 18,B03,083750,Rideout; David Porter,0,0,36,36
1656158601783,MATH 18,B04,083751,Rideout; David Porter,0,0,36,36
1656158601783,MATH 18,B05,093473,Rideout; David Porter,1,0,36,35
1656158601783,MATH 18,B06,093474,Rideout; David Porter,4,0,36,32
1656158607812,MATH 20A,A01,083754,Zheng; Zequn,11,0,40,29
1656158613845,MATH 20B,A01,083756,Briones; Jor-el Thomas Caparas,0,0,36,36
1656158613845,MATH 20B,A02,083757,Briones; Jor-el Thomas Caparas,0,0,36,36
1656158613845,MATH 20B,A03,093475,Staff,2,0,36,34
1656158619874,MATH 20C,A01,083760,Briones; Jor-el Thomas Caparas,0,0,35,35
1656158619874,MATH 20C,A02,083761,Briones; Jor-el Thomas Caparas,9,1,35,26
1656158619874,MATH 20C,A03,093476,Staff,0,0,35,35
1656158619874,MATH 20C,B01,083762,Bach; Quang Tran,1,0,30,29
1656158625908,MATH 20D,A01,083765,Tran; Brian Kha,2,0,30,28
1656158625908,MATH 20D,A02,083766,Tran; Brian Kha,0,1,30,30
1656158625908,MATH 20D,A03,083767,Tran; Brian Kha,2,0,30,28
1656158631941,MATH 20E,A01,083771,Ganguly; Soumya,4,0,32,28
1656158631941,MATH 20E,A02,083772,Ganguly; Soumya,0,0,32,32
1656158631941,MATH 20E,B01,083773,Ciotti; Benjamin,15,0,35,20
1656158631941,MATH 20E,B02,083774,Ciotti; Benjamin,15,0,35,20
1656158637969,MATH 103A,A01,083777,Greenfeld; Be'Eri,1,0,36,35
1656158637969,MATH 103A,A02,083778,Greenfeld; Be'Eri,1,0,36,35
1656158637969,MATH 103A,A03,093561,Staff,4,0,36,32
1656158637969,MATH 103A,B01,083779,Greenfeld; Be'Eri,8,1,36,28
1656158637969,MATH 103A,B02,083780,Greenfeld; Be'Eri,1,0,36,35
1656158637969,MATH 103A,B03,093562,Staff,0,0,36,36
1656158644003,MATH 105,A01,085443,Carter; Anne Toulson,5,1,35,30
1656158644003,MATH 105,A02,093477,Staff,11,0,35,24
1656158650038,MATH 109,A01,083213,Ganzberger; Geoffrey Michael,0,0,34,34
1656158650038,MATH 109,A02,083214,Ganzberger; Geoffrey Michael,0,0,34,34
1656158650038,MATH 109,A03,093478,Staff,1,0,34,33
1656158650038,MATH 109,B01,083215,Ganzberger; Geoffrey Michael,4,0,32,28
1656158650038,MATH 109,B02,083216,Ganzberger; Geoffrey Michael,1,0,32,31
1656158650038,MATH 109,B03,093479,Staff,4,0,32,28
1656158656066,MATH 142A,A01,083219,Chow; Bennett,1,0,32,31
1656158656066,MATH 142A,A02,083220,Chow; Bennett,8,0,32,24
1656158656066,MATH 142A,A03,093480,Staff,5,0,32,27
1656158656066,MATH 142A,B03,093481,Staff,4,0,32,28
1656158656066,MATH 142A,B04,093558,Staff,6,0,32,26
1656158656066,MATH 142A,B05,093559,Staff,0,0,32,32
1656158662094,MATH 193A,A01,083224,Rotar; Vladimir,0,1,34,34
1656158662094,MATH 193A,A02,083225,Rotar; Vladimir,0,0,34,34
1656158662094,MATH 193A,A03,083781,Rotar; Vladimir,0,0,34,34
1656158662094,MATH 193A,A04,083782,Rotar; Vladimir,6,0,34,28
1656158662094,MATH 193A,A05,093482,Rotar; Vladimir,1,0,34,33
1656158668123,MATH 197,001,091859,McAuley; Julian John,9999,0,9999,0
1656158668123,MATH 197,002,095566,Kedlaya; Kiran S.,9997,0,9999,2
1656158668123,MATH 197,003,095567,Xiao; Ming,9999,0,9999,0
1656158668123,MATH 197,004,095571,Perols; Johan Lars,9998,0,9999,1
1656158675190,COGS 9,A01,083615,Shannon; Kyle Michael,4,0,75,71
1656158681220,COGS 11,A01,083617,Boyle; Mary E. T.,14,0,48,34
1656158687252,COGS 13,A01,083071,Bastos; Amalia Pinkusfeld,6,0,71,65
1656158693285,COGS 14A,A01,092681,Semenuks; Arturs,4,15,100,96
1656158699311,COGS 14B,A01,083073,Cheng; Tzu-Han,7,0,63,56
1656158705337,COGS 17,A01,092677,Semenuks; Arturs,8,0,81,73
1656158711439,COGS 100,A01,083619,Allen; Michael Gordon,2,0,70,68
1656158717473,COGS 101A,A01,083621,Davis; Joshua Daniel,3,0,68,65
1656158723501,COGS 101B,A01,091572,Allen; Michael Gordon,6,0,65,59
1656158729533,COGS 101C,A01,083625,Delgado; Tania,10,0,35,25
1656158735558,COGS 107A,A01,083627,Boyle; Mary E. T.,0,0,60,60
1656158741584,COGS 118A,A01,083075,Gupta; Anjum,7,0,76,69
1656158747619,CSE 3,A50,083646,Miranda; Gregory Joseph,18,0,50,32
1656158753648,CSE 8A,A50,083650,Miranda; Gregory Joseph,3,3,56,53
1656158759675,CSE 11,A01,083080,Cao; Yingjun,1,54,40,39
1656158765701,CSE 12,A01,083652,Krause-Levy; Sophia Louisa,7,2,120,113
1656158771729,CSE 15L,A01,083654,Morris; Justin Loren,2,0,50,48
1656158771729,CSE 15L,A02,083655,Morris; Justin Loren,4,0,50,46
1656158777755,CSE 20,A01,083657,Tran; Khoa Dang,31,0,80,49
1656158783787,CSE 21,A01,095574,Bach; Quang Tran,25,0,48,23
1656158789822,CSE 30,A01,083084,Eldon; John,2,8,80,78
1656158789822,CSE 30,B01,095061,Bhaskar; Nishant,1,2,50,49
1656158795855,CSE 100,A01,083659,Cao; Yingjun,2,20,70,68
1656158801888,CSE 134B,A01,083661,Powell; Thomas Allan,3,0,100,97
1656158807914,CSE 140,A01,083663,Gungor; Onat,9,0,85,76
1656158813941,CSE 140L,A01,083088,Eldon; John,8,0,100,92
1656158819984,CSE 175,A01,083665,Kumar; Rakesh,0,0,25,25
1656158826017,CSE 190,A00,092507,Dubnov; Shlomo,3,0,20,17
1656158832043,ECE 45,A01,083139,Congero; Spencer William,1,0,75,74
1656158838069,ECE 65,A50,083695,Saad; Andrew S,9,0,30,21
1656158838069,ECE 65,A51,095125,Staff,23,0,26,3
1656158844105,ECE 109,A01,091882,Touri; Behrouz,0,1,70,70
1656158850133,ECE 180,A00,083140,Abi Samra; Nicholas Camill,1,0,30,29
1656158850133,ECE 180,B00,083141,Abi Samra; Nicholas Camill,0,4,30,30
1656158856161,MATH 10A,A01,083735,Patchell; Gregory David,0,0,30,30
1656158856161,MATH 10A,A02,083736,Patchell; Gregory David,22,0,30,8
1656158856161,MATH 10A,A03,083737,Patchell; Gregory David,16,0,30,14
1656158862193,MATH 10B,A01,083207,Lim; Seonhee,0,0,34,34
1656158862193,MATH 10B,A02,083208,Lim; Seonhee,7,0,35,28
1656158862193,MATH 10B,A03,093472,Staff,1,0,34,33
1656158862193,MATH 10B,B01,083739,Sinha; Shubham,10,0,30,20
1656158868230,MATH 18,A01,083743,Cinel; Cameron Alexander,7,0,30,23
1656158868230,MATH 18,A02,083744,Cinel; Cameron Alexander,10,0,30,20
1656158868230,MATH 18,A03,083745,Cinel; Cameron Alexander,4,0,30,26
1656158868230,MATH 18,B01,083748,Rideout; David Porter,0,0,36,36
1656158868230,MATH 18,B02,083749,Rideout; David Porter,0,0,36,36
1656158868230,MATH 18,B03,083750,Rideout; David Porter,0,0,36,36
1656158868230,MATH 18,B04,083751,Rideout; David Porter,0,0,36,36
1656158868230,MATH 18,B05,093473,Rideout; David Porter,1,0,36,35
1656158868230,MATH 18,B06,093474,Rideout; David Porter,4,0,36,32
1656158874261,MATH 20A,A01,083754,Zheng; Zequn,11,0,40,29
1656158880300,MATH 20B,A01,083756,Briones; Jor-el Thomas Caparas,0,0,36,36
1656158880300,MATH 20B,A02,083757,Briones; Jor-el Thomas Caparas,0,0,36,36
1656158880300,MATH 20B,A03,093475,Staff,2,0,36,34
1656158886342,MATH 20C,A01,083760,Briones; Jor-el Thomas Caparas,0,0,35,35
1656158886342,MATH 20C,A02,083761,Briones; Jor-el Thomas Caparas,9,1,35,26
1656158886342,MATH 20C,A03,093476,Staff,0,0,35,35
1656158886342,MATH 20C,B01,083762,Bach; Quang Tran,1,0,30,29
1656158892374,MATH 20D,A01,083765,Tran; Brian Kha,2,0,30,28
1656158892374,MATH 20D,A02,083766,Tran; Brian Kha,0,1,30,30
1656158892374,MATH 20D,A03,083767,Tran; Brian Kha,2,0,30,28
1656158898404,MATH 20E,A01,083771,Ganguly; Soumya,4,0,32,28
1656158898404,MATH 20E,A02,083772,Ganguly; Soumya,0,0,32,32
1656158898404,MATH 20E,B01,083773,Ciotti; Benjamin,15,0,35,20
1656158898404,MATH 20E,B02,083774,Ciotti; Benjamin,15,0,35,20
1656158904441,MATH 103A,A01,083777,Greenfeld; Be'Eri,1,0,36,35
1656158904441,MATH 103A,A02,083778,Greenfeld; Be'Eri,1,0,36,35
1656158904441,MATH 103A,A03,093561,Staff,4,0,36,32
1656158904441,MATH 103A,B01,083779,Greenfeld; Be'Eri,8,1,36,28
1656158904441,MATH 103A,B02,083780,Greenfeld; Be'Eri,1,0,36,35
1656158904441,MATH 103A,B03,093562,Staff,0,0,36,36
1656158910468,MATH 105,A01,085443,Carter; Anne Toulson,5,1,35,30
1656158910468,MATH 105,A02,093477,Staff,11,0,35,24
1656158916502,MATH 109,A01,083213,Ganzberger; Geoffrey Michael,0,0,34,34
1656158916502,MATH 109,A02,083214,Ganzberger; Geoffrey Michael,0,0,34,34
1656158916502,MATH 109,A03,093478,Staff,1,0,34,33
1656158916502,MATH 109,B01,083215,Ganzberger; Geoffrey Michael,4,0,32,28
1656158916502,MATH 109,B02,083216,Ganzberger; Geoffrey Michael,1,0,32,31
1656158916502,MATH 109,B03,093479,Staff,4,0,32,28
1656158922537,MATH 142A,A01,083219,Chow; Bennett,1,0,32,31
1656158922537,MATH 142A,A02,083220,Chow; Bennett,8,0,32,24
1656158922537,MATH 142A,A03,093480,Staff,5,0,32,27
1656158922537,MATH 142A,B03,093481,Staff,4,0,32,28
1656158922537,MATH 142A,B04,093558,Staff,6,0,32,26
1656158922537,MATH 142A,B05,093559,Staff,0,0,32,32
1656158928569,MATH 193A,A01,083224,Rotar; Vladimir,0,1,34,34
1656158928569,MATH 193A,A02,083225,Rotar; Vladimir,0,0,34,34
1656158928569,MATH 193A,A03,083781,Rotar; Vladimir,0,0,34,34
1656158928569,MATH 193A,A04,083782,Rotar; Vladimir,6,0,34,28
1656158928569,MATH 193A,A05,093482,Rotar; Vladimir,1,0,34,33
1656158934598,MATH 197,001,091859,McAuley; Julian John,9999,0,9999,0
1656158934598,MATH 197,002,095566,Kedlaya; Kiran S.,9997,0,9999,2
1656158934598,MATH 197,003,095567,Xiao; Ming,9999,0,9999,0
1656158934598,MATH 197,004,095571,Perols; Johan Lars,9998,0,9999,1
1656158941690,COGS 9,A01,083615,Shannon; Kyle Michael,4,0,75,71
1656158947716,COGS 11,A01,083617,Boyle; Mary E. T.,14,0,48,34
1656158953743,COGS 13,A01,083071,Bastos; Amalia Pinkusfeld,6,0,71,65
1656158959783,COGS 14A,A01,092681,Semenuks; Arturs,4,15,100,96
1656158965815,COGS 14B,A01,083073,Cheng; Tzu-Han,7,0,63,56
1656158971843,COGS 17,A01,092677,Semenuks; Arturs,8,0,81,73
1656158977870,COGS 100,A01,083619,Allen; Michael Gordon,2,0,70,68
1656158983902,COGS 101A,A01,083621,Davis; Joshua Daniel,3,0,68,65
1656158989929,COGS 101B,A01,091572,Allen; Michael Gordon,6,0,65,59
1656158995956,COGS 101C,A01,083625,Delgado; Tania,10,0,35,25
1656159001984,COGS 107A,A01,083627,Boyle; Mary E. T.,0,0,60,60
1656159008018,COGS 118A,A01,083075,Gupta; Anjum,7,0,76,69
1656159014048,CSE 3,A50,083646,Miranda; Gregory Joseph,18,0,50,32
1656159020074,CSE 8A,A50,083650,Miranda; Gregory Joseph,3,3,56,53
1656159026111,CSE 11,A01,083080,Cao; Yingjun,1,54,40,39
1656159032147,CSE 12,A01,083652,Krause-Levy; Sophia Louisa,7,2,120,113
1656159038171,CSE 15L,A01,083654,Morris; Justin Loren,2,0,50,48
1656159038171,CSE 15L,A02,083655,Morris; Justin Loren,4,0,50,46
1656159044196,CSE 20,A01,083657,Tran; Khoa Dang,31,0,80,49
1656159050221,CSE 21,A01,095574,Bach; Quang Tran,25,0,48,23
1656159056254,CSE 30,A01,083084,Eldon; John,2,8,80,78
1656159056254,CSE 30,B01,095061,Bhaskar; Nishant,1,2,50,49
1656159062287,CSE 100,A01,083659,Cao; Yingjun,2,20,70,68
1656159068318,CSE 134B,A01,083661,Powell; Thomas Allan,3,0,100,97
1656159074345,CSE 140,A01,083663,Gungor; Onat,9,0,85,76
1656159080376,CSE 140L,A01,083088,Eldon; John,8,0,100,92
1656159086408,CSE 175,A01,083665,Kumar; Rakesh,0,0,25,25
1656159092438,CSE 190,A00,092507,Dubnov; Shlomo,3,0,20,17
1656159098469,ECE 45,A01,083139,Congero; Spencer William,1,0,75,74
1656159104496,ECE 65,A50,083695,Saad; Andrew S,9,0,30,21
1656159104496,ECE 65,A51,095125,Staff,23,0,26,3
1656159110526,ECE 109,A01,091882,Touri; Behrouz,0,1,70,70
1656159116553,ECE 180,A00,083140,Abi Samra; Nicholas Camill,1,0,30,29
1656159116553,ECE 180,B00,083141,Abi Samra; Nicholas Camill,0,4,30,30
1656159122581,MATH 10A,A01,083735,Patchell; Gregory David,0,0,30,30
1656159122581,MATH 10A,A02,083736,Patchell; Gregory David,22,0,30,8
1656159122581,MATH 10A,A03,083737,Patchell; Gregory David,16,0,30,14
1656159128614,MATH 10B,A01,083207,Lim; Seonhee,0,0,34,34
1656159128614,MATH 10B,A02,083208,Lim; Seonhee,7,0,35,28
1656159128614,MATH 10B,A03,093472,Staff,1,0,34,33
1656159128614,MATH 10B,B01,083739,Sinha; Shubham,10,0,30,20
1656159134654,MATH 18,A01,083743,Cinel; Cameron Alexander,7,0,30,23
1656159134654,MATH 18,A02,083744,Cinel; Cameron Alexander,10,0,30,20
1656159134654,MATH 18,A03,083745,Cinel; Cameron Alexander,4,0,30,26
1656159134654,MATH 18,B01,083748,Rideout; David Porter,0,0,36,36
1656159134654,MATH 18,B02,083749,Rideout; David Porter,0,0,36,36
1656159134654,MATH 18,B03,083750,Rideout; David Porter,0,0,36,36
1656159134654,MATH 18,B04,083751,Rideout; David Porter,0,0,36,36
1656159134654,MATH 18,B05,093473,Rideout; David Porter,1,0,36,35
1656159134654,MATH 18,B06,093474,Rideout; David Porter,4,0,36,32
1656159140680,MATH 20A,A01,083754,Zheng; Zequn,11,0,40,29
1656159146713,MATH 20B,A01,083756,Briones; Jor-el Thomas Caparas,0,0,36,36
1656159146713,MATH 20B,A02,083757,Briones; Jor-el Thomas Caparas,0,0,36,36
1656159146713,MATH 20B,A03,093475,Staff,2,0,36,34
1656159152746,MATH 20C,A01,083760,Briones; Jor-el Thomas Caparas,0,0,35,35
1656159152746,MATH 20C,A02,083761,Briones; Jor-el Thomas Caparas,9,1,35,26
1656159152746,MATH 20C,A03,093476,Staff,0,0,35,35
1656159152746,MATH 20C,B01,083762,Bach; Quang Tran,1,0,30,29
1656159158772,MATH 20D,A01,083765,Tran; Brian Kha,2,0,30,28
1656159158772,MATH 20D,A02,083766,Tran; Brian Kha,0,1,30,30
1656159158772,MATH 20D,A03,083767,Tran; Brian Kha,2,0,30,28
1656159164799,MATH 20E,A01,083771,Ganguly; Soumya,4,0,32,28
1656159164799,MATH 20E,A02,083772,Ganguly; Soumya,0,0,32,32
1656159164799,MATH 20E,B01,083773,Ciotti; Benjamin,15,0,35,20
1656159164799,MATH 20E,B02,083774,Ciotti; Benjamin,15,0,35,20
1656159170834,MATH 103A,A01,083777,Greenfeld; Be'Eri,1,0,36,35
1656159170834,MATH 103A,A02,083778,Greenfeld; Be'Eri,1,0,36,35
1656159170834,MATH 103A,A03,093561,Staff,4,0,36,32
1656159170834,MATH 103A,B01,083779,Greenfeld; Be'Eri,8,1,36,28
1656159170834,MATH 103A,B02,083780,Greenfeld; Be'Eri,1,0,36,35
1656159170834,MATH 103A,B03,093562,Staff,0,0,36,36
1656159176861,MATH 105,A01,085443,Carter; Anne Toulson,5,1,35,30
1656159176861,MATH 105,A02,093477,Staff,11,0,35,24
1656159182899,MATH 109,A01,083213,Ganzberger; Geoffrey Michael,0,0,34,34
1656159182899,MATH 109,A02,083214,Ganzberger; Geoffrey Michael,0,0,34,34
1656159182899,MATH 109,A03,093478,Staff,1,0,34,33
1656159182899,MATH 109,B01,083215,Ganzberger; Geoffrey Michael,4,0,32,28
1656159182899,MATH 109,B02,083216,Ganzberger; Geoffrey Michael,1,0,32,31
1656159182899,MATH 109,B03,093479,Staff,4,0,32,28
1656159188932,MATH 142A,A01,083219,Chow; Bennett,1,0,32,31
1656159188932,MATH 142A,A02,083220,Chow; Bennett,8,0,32,24
1656159188932,MATH 142A,A03,093480,Staff,5,0,32,27
1656159188932,MATH 142A,B03,093481,Staff,4,0,32,28
1656159188932,MATH 142A,B04,093558,Staff,6,0,32,26
1656159188932,MATH 142A,B05,093559,Staff,0,0,32,32
1656159194959,MATH 193A,A01,083224,Rotar; Vladimir,0,1,34,34
1656159194959,MATH 193A,A02,083225,Rotar; Vladimir,0,0,34,34
1656159194959,MATH 193A,A03,083781,Rotar; Vladimir,0,0,34,34
1656159194959,MATH 193A,A04,083782,Rotar; Vladimir,6,0,34,28
1656159194959,MATH 193A,A05,093482,Rotar; Vladimir,1,0,34,33
1656159200987,MATH 197,001,091859,McAuley; Julian John,9999,0,9999,0
1656159200987,MATH 197,002,095566,Kedlaya; Kiran S.,9997,0,9999,2
1656159200987,MATH 197,003,095567,Xiao; Ming,9999,0,9999,0
1656159200987,MATH 197,004,095571,Perols; Johan Lars,9998,0,9999,1
1656159208070,COGS 9,A01,083615,Shannon; Kyle Michael,4,0,75,71
1656159214101,COGS 11,A01,083617,Boyle; Mary E. T.,14,0,48,34
1656159220139,COGS 13,A01,083071,Bastos; Amalia Pinkusfeld,6,0,71,65
1656159226170,COGS 14A,A01,092681,Semenuks; Arturs,4,15,100,96
1656159232196,COGS 14B,A01,083073,Cheng; Tzu-Han,7,0,63,56
1656159238222,COGS 17,A01,092677,Semenuks; Arturs,8,0,81,73
1656159244248,COGS 100,A01,083619,Allen; Michael Gordon,2,0,70,68
1656159250275,COGS 101A,A01,083621,Davis; Joshua Daniel,3,0,68,65
1656159256304,COGS 101B,A01,091572,Allen; Michael Gordon,6,0,65,59
1656159262330,COGS 101C,A01,083625,Delgado; Tania,10,0,35,25
1656159268361,COGS 107A,A01,083627,Boyle; Mary E. T.,0,0,60,60
1656159274389,COGS 118A,A01,083075,Gupta; Anjum,7,0,76,69
1656159280435,CSE 3,A50,083646,Miranda; Gregory Joseph,18,0,50,32
1656159286459,CSE 8A,A50,083650,Miranda; Gregory Joseph,3,3,56,53
1656159292484,CSE 11,A01,083080,Cao; Yingjun,1,54,40,39
1656159298511,CSE 12,A01,083652,Krause-Levy; Sophia Louisa,7,2,120,113
1656159304540,CSE 15L,A01,083654,Morris; Justin Loren,2,0,50,48
1656159304540,CSE 15L,A02,083655,Morris; Justin Loren,4,0,50,46
1656159310640,CSE 20,A01,083657,Tran; Khoa Dang,31,0,80,49
1656159316667,CSE 21,A01,095574,Bach; Quang Tran,25,0,48,23
1656159322698,CSE 30,A01,083084,Eldon; John,2,8,80,78
1656159322698,CSE 30,B01,095061,Bhaskar; Nishant,1,2,50,49
1656159328723,CSE 100,A01,083659,Cao; Yingjun,2,20,70,68
1656159334750,CSE 134B,A01,083661,Powell; Thomas Allan,3,0,100,97
1656159340777,CSE 140,A01,083663,Gungor; Onat,9,0,85,76
1656159346801,CSE 140L,A01,083088,Eldon; John,8,0,100,92
1656159352829,CSE 175,A01,083665,Kumar; Rakesh,0,0,25,25
1656159358854,CSE 190,A00,092507,Dubnov; Shlomo,3,0,20,17
1656159364886,ECE 45,A01,083139,Congero; Spencer William,1,0,75,74
1656159370936,ECE 65,A50,083695,Saad; Andrew S,9,0,30,21
1656159370936,ECE 65,A51,095125,Staff,23,0,26,3
1656159376969,ECE 109,A01,091882,Touri; Behrouz,0,1,70,70
1656159383000,ECE 180,A00,083140,Abi Samra; Nicholas Camill,1,0,30,29
1656159383000,ECE 180,B00,083141,Abi Samra; Nicholas Camill,0,4,30,30
1656159389033,MATH 10A,A01,083735,Patchell; Gregory David,0,0,30,30
1656159389033,MATH 10A,A02,083736,Patchell; Gregory David,22,0,30,8
1656159389033,MATH 10A,A03,083737,Patchell; Gregory David,16,0,30,14
1656159395068,MATH 10B,A01,083207,Lim; Seonhee,0,0,34,34
1656159395068,MATH 10B,A02,083208,Lim; Seonhee,7,0,35,28
1656159395068,MATH 10B,A03,093472,Staff,1,0,34,33
1656159395068,MATH 10B,B01,083739,Sinha; Shubham,10,0,30,20
1656159401098,MATH 18,A01,083743,Cinel; Cameron Alexander,7,0,30,23
1656159401098,MATH 18,A02,083744,Cinel; Cameron Alexander,10,0,30,20
1656159401098,MATH 18,A03,083745,Cinel; Cameron Alexander,4,0,30,26
1656159401098,MATH 18,B01,083748,Rideout; David Porter,0,0,36,36
1656159401098,MATH 18,B02,083749,Rideout; David Porter,0,0,36,36
1656159401098,MATH 18,B03,083750,Rideout; David Porter,0,0,36,36
1656159401098,MATH 18,B04,083751,Rideout; David Porter,0,0,36,36
1656159401098,MATH 18,B05,093473,Rideout; David Porter,1,0,36,35
1656159401098,MATH 18,B06,093474,Rideout; David Porter,4,0,36,32
1656159407122,MATH 20A,A01,083754,Zheng; Zequn,11,0,40,29
1656159413150,MATH 20B,A01,083756,Briones; Jor-el Thomas Caparas,0,0,36,36
1656159413150,MATH 20B,A02,083757,Briones; Jor-el Thomas Caparas,0,0,36,36
1656159413150,MATH 20B,A03,093475,Staff,2,0,36,34
1656159419190,MATH 20C,A01,083760,Briones; Jor-el Thomas Caparas,0,0,35,35
1656159419190,MATH 20C,A02,083761,Briones; Jor-el Thomas Caparas,9,1,35,26
1656159419190,MATH 20C,A03,093476,Staff,0,0,35,35
1656159419190,MATH 20C,B01,083762,Bach; Quang Tran,1,0,30,29
1656159425225,MATH 20D,A01,083765,Tran; Brian Kha,2,0,30,28
1656159425225,MATH 20D,A02,083766,Tran; Brian Kha,0,1,30,30
1656159425225,MATH 20D,A03,083767,Tran; Brian Kha,2,0,30,28
1656159431264,MATH 20E,A01,083771,Ganguly; Soumya,4,0,32,28
1656159431264,MATH 20E,A02,083772,Ganguly; Soumya,0,0,32,32
1656159431264,MATH 20E,B01,083773,Ciotti; Benjamin,15,0,35,20
1656159431264,MATH 20E,B02,083774,Ciotti; Benjamin,15,0,35,20
1656159437293,MATH 103A,A01,083777,Greenfeld; Be'Eri,1,0,36,35
1656159437293,MATH 103A,A02,083778,Greenfeld; Be'Eri,1,0,36,35
1656159437293,MATH 103A,A03,093561,Staff,4,0,36,32
1656159437293,MATH 103A,B01,083779,Greenfeld; Be'Eri,8,1,36,28
1656159437293,MATH 103A,B02,083780,Greenfeld; Be'Eri,1,0,36,35
1656159437293,MATH 103A,B03,093562,Staff,0,0,36,36
1656159443320,MATH 105,A01,085443,Carter; Anne Toulson,5,1,35,30
1656159443320,MATH 105,A02,093477,Staff,11,0,35,24
1656159449345,MATH 109,A01,083213,Ganzberger; Geoffrey Michael,0,0,34,34
1656159449345,MATH 109,A02,083214,Ganzberger; Geoffrey Michael,0,0,34,34
1656159449345,MATH 109,A03,093478,Staff,1,0,34,33
1656159449345,MATH 109,B01,083215,Ganzberger; Geoffrey Michael,4,0,32,28
1656159449345,MATH 109,B02,083216,Ganzberger; Geoffrey Michael,1,0,32,31
1656159449345,MATH 109,B03,093479,Staff,4,0,32,28
1656159455379,MATH 142A,A01,083219,Chow; Bennett,1,0,32,31
1656159455379,MATH 142A,A02,083220,Chow; Bennett,8,0,32,24
1656159455379,MATH 142A,A03,093480,Staff,5,0,32,27
1656159455379,MATH 142A,B03,093481,Staff,4,0,32,28
1656159455379,MATH 142A,B04,093558,Staff,6,0,32,26
1656159455379,MATH 142A,B05,093559,Staff,0,0,32,32
1656159461405,MATH 193A,A01,083224,Rotar; Vladimir,0,1,34,34
1656159461405,MATH 193A,A02,083225,Rotar; Vladimir,0,0,34,34
1656159461405,MATH 193A,A03,083781,Rotar; Vladimir,0,0,34,34
1656159461405,MATH 193A,A04,083782,Rotar; Vladimir,6,0,34,28
1656159461405,MATH 193A,A05,093482,Rotar; Vladimir,1,0,34,33
1656159467434,MATH 197,001,091859,McAuley; Julian John,9999,0,9999,0
1656159467434,MATH 197,002,095566,Kedlaya; Kiran S.,9997,0,9999,2
1656159467434,MATH 197,003,095567,Xiao; Ming,9999,0,9999,0
1656159467434,MATH 197,004,095571,Perols; Johan Lars,9998,0,9999,1
1656159474497,COGS 9,A01,083615,Shannon; Kyle Michael,4,0,75,71
1656159480522,COGS 11,A01,083617,Boyle; Mary E. T.,14,0,48,34
1656159486548,COGS 13,A01,083071,Bastos; Amalia Pinkusfeld,6,0,71,65
1656159492572,COGS 14A,A01,092681,Semenuks; Arturs,4,15,100,96
1656159498603,COGS 14B,A01,083073,Cheng; Tzu-Han,7,0,63,56
1656159504641,COGS 17,A01,092677,Semenuks; Arturs,8,0,81,73
1656159510668,COGS 100,A01,083619,Allen; Michael Gordon,2,0,70,68
1656159516695,COGS 101A,A01,083621,Davis; Joshua Daniel,3,0,68,65
1656159522727,COGS 101B,A01,091572,Allen; Michael Gordon,6,0,65,59
1656159528754,COGS 101C,A01,083625,Delgado; Tania,10,0,35,25
1656159534784,COGS 107A,A01,083627,Boyle; Mary E. T.,0,0,60,60
1656159540809,COGS 118A,A01,083075,Gupta; Anjum,7,0,76,69
1656159546838,CSE 3,A50,083646,Miranda; Gregory Joseph,18,0,50,32
1656159552869,CSE 8A,A50,083650,Miranda; Gregory Joseph,3,3,56,53
1656159558895,CSE 11,A01,083080,Cao; Yingjun,1,54,40,39
1656159564923,CSE 12,A01,083652,Krause-Levy; Sophia Louisa,7,2,120,113
1656159570956,CSE 15L,A01,083654,Morris; Justin Loren,2,0,50,48
1656159570956,CSE 15L,A02,083655,Morris; Justin Loren,4,0,50,46
1656159576987,CSE 20,A01,083657,Tran; Khoa Dang,31,0,80,49
1656159583018,CSE 21,A01,095574,Bach; Quang Tran,25,0,48,23
1656159589046,CSE 30,A01,083084,Eldon; John,2,8,80,78
1656159589046,CSE 30,B01,095061,Bhaskar; Nishant,1,2,50,49
1656159595072,CSE 100,A01,083659,Cao; Yingjun,2,20,70,68
1656159601099,CSE 134B,A01,083661,Powell; Thomas Allan,3,0,100,97
1656159607124,CSE 140,A01,083663,Gungor; Onat,9,0,85,76
1656159613151,CSE 140L,A01,083088,Eldon; John,8,0,100,92
1656159619184,CSE 175,A01,083665,Kumar; Rakesh,0,0,25,25
1656159625210,CSE 190,A00,092507,Dubnov; Shlomo,3,0,20,17
1656159631257,ECE 45,A01,083139,Congero; Spencer William,1,0,75,74
1656159637285,ECE 65,A50,083695,Saad; Andrew S,9,0,30,21
1656159637285,ECE 65,A51,095125,Staff,23,0,26,3
1656159643315,ECE 109,A01,091882,Touri; Behrouz,0,1,70,70
1656159649341,ECE 180,A00,083140,Abi Samra; Nicholas Camill,1,0,30,29
1656159649341,ECE 180,B00,083141,Abi Samra; Nicholas Camill,0,4,30,30
1656159655371,MATH 10A,A01,083735,Patchell; Gregory David,0,0,30,30
1656159655371,MATH 10A,A02,083736,Patchell; Gregory David,22,0,30,8
1656159655371,MATH 10A,A03,083737,Patchell; Gregory David,16,0,30,14
1656159661401,MATH 10B,A01,083207,Lim; Seonhee,0,0,34,34
1656159661401,MATH 10B,A02,083208,Lim; Seonhee,7,0,35,28
1656159661401,MATH 10B,A03,093472,Staff,1,0,34,33
1656159661401,MATH 10B,B01,083739,Sinha; Shubham,10,0,30,20
1656159667444,MATH 18,A01,083743,Cinel; Cameron Alexander,7,0,30,23
1656159667444,MATH 18,A02,083744,Cinel; Cameron Alexander,10,0,30,20
1656159667444,MATH 18,A03,083745,Cinel; Cameron Alexander,4,0,30,26
1656159667444,MATH 18,B01,083748,Rideout; David Porter,0,0,36,36
1656159667444,MATH 18,B02,083749,Rideout; David Porter,0,0,36,36
1656159667444,MATH 18,B03,083750,Rideout; David Porter,0,0,36,36
1656159667444,MATH 18,B04,083751,Rideout; David Porter,0,0,36,36
1656159667444,MATH 18,B05,093473,Rideout; David Porter,1,0,36,35
1656159667444,MATH 18,B06,093474,Rideout; David Porter,4,0,36,32
1656159673470,MATH 20A,A01,083754,Zheng; Zequn,11,0,40,29
1656159679503,MATH 20B,A01,083756,Briones; Jor-el Thomas Caparas,0,0,36,36
1656159679503,MATH 20B,A02,083757,Briones; Jor-el Thomas Caparas,0,0,36,36
1656159679503,MATH 20B,A03,093475,Staff,2,0,36,34
1656159685536,MATH 20C,A01,083760,Briones; Jor-el Thomas Caparas,0,0,35,35
1656159685536,MATH 20C,A02,083761,Briones; Jor-el Thomas Caparas,9,1,35,26
1656159685536,MATH 20C,A03,093476,Staff,0,0,35,35
1656159685536,MATH 20C,B01,083762,Bach; Quang Tran,1,0,30,29
1656159691563,MATH 20D,A01,083765,Tran; Brian Kha,2,0,30,28
1656159691563,MATH 20D,A02,083766,Tran; Brian Kha,0,1,30,30
1656159691563,MATH 20D,A03,083767,Tran; Brian Kha,2,0,30,28
1656159697588,MATH 20E,A01,083771,Ganguly; Soumya,4,0,32,28
1656159697588,MATH 20E,A02,083772,Ganguly; Soumya,0,0,32,32
1656159697588,MATH 20E,B01,083773,Ciotti; Benjamin,15,0,35,20
1656159697588,MATH 20E,B02,083774,Ciotti; Benjamin,15,0,35,20
1656159703616,MATH 103A,A01,083777,Greenfeld; Be'Eri,1,0,36,35
1656159703616,MATH 103A,A02,083778,Greenfeld; Be'Eri,1,0,36,35
1656159703616,MATH 103A,A03,093561,Staff,4,0,36,32
1656159703616,MATH 103A,B01,083779,Greenfeld; Be'Eri,8,1,36,28
1656159703616,MATH 103A,B02,083780,Greenfeld; Be'Eri,1,0,36,35
1656159703616,MATH 103A,B03,093562,Staff,0,0,36,36
1656159709643,MATH 105,A01,085443,Carter; Anne Toulson,5,1,35,30
1656159709643,MATH 105,A02,093477,Staff,11,0,35,24
1656159715678,MATH 109,A01,083213,Ganzberger; Geoffrey Michael,0,0,34,34
1656159715678,MATH 109,A02,083214,Ganzberger; Geoffrey Michael,0,0,34,34
1656159715678,MATH 109,A03,093478,Staff,1,0,34,33
1656159715678,MATH 109,B01,083215,Ganzberger; Geoffrey Michael,4,0,32,28
1656159715678,MATH 109,B02,083216,Ganzberger; Geoffrey Michael,1,0,32,31
1656159715678,MATH 109,B03,093479,Staff,4,0,32,28
1656159721707,MATH 142A,A01,083219,Chow; Bennett,1,0,32,31
1656159721707,MATH 142A,A02,083220,Chow; Bennett,8,0,32,24
1656159721707,MATH 142A,A03,093480,Staff,5,0,32,27
1656159721707,MATH 142A,B03,093481,Staff,4,0,32,28
1656159721707,MATH 142A,B04,093558,Staff,6,0,32,26
1656159721707,MATH 142A,B05,093559,Staff,0,0,32,32
1656159727735,MATH 193A,A01,083224,Rotar; Vladimir,0,1,34,34
1656159727735,MATH 193A,A02,083225,Rotar; Vladimir,0,0,34,34
1656159727735,MATH 193A,A03,083781,Rotar; Vladimir,0,0,34,34
1656159727735,MATH 193A,A04,083782,Rotar; Vladimir,6,0,34,28
1656159727735,MATH 193A,A05,093482,Rotar; Vladimir,1,0,34,33
1656159733765,MATH 197,001,091859,McAuley; Julian John,9999,0,9999,0
1656159733765,MATH 197,002,095566,Kedlaya; Kiran S.,9997,0,9999,2
1656159733765,MATH 197,003,095567,Xiao; Ming,9999,0,9999,0
1656159733765,MATH 197,004,095571,Perols; Johan Lars,9998,0,9999,1
1656159740840,COGS 9,A01,083615,Shannon; Kyle Michael,4,0,75,71
1656159746864,COGS 11,A01,083617,Boyle; Mary E. T.,14,0,48,34
1656159752892,COGS 13,A01,083071,Bastos; Amalia Pinkusfeld,6,0,71,65
1656159758922,COGS 14A,A01,092681,Semenuks; Arturs,4,15,100,96
1656159764953,COGS 14B,A01,083073,Cheng; Tzu-Han,7,0,63,56
1656159770979,COGS 17,A01,092677,Semenuks; Arturs,8,0,81,73
1656159777007,COGS 100,A01,083619,Allen; Michael Gordon,2,0,70,68
1656159783037,COGS 101A,A01,083621,Davis; Joshua Daniel,3,0,68,65
1656159789063,COGS 101B,A01,091572,Allen; Michael Gordon,6,0,65,59
1656159795096,COGS 101C,A01,083625,Delgado; Tania,10,0,35,25
1656159801125,COGS 107A,A01,083627,Boyle; Mary E. T.,0,0,60,60
1656159807158,COGS 118A,A01,083075,Gupta; Anjum,7,0,76,69
1656159813189,CSE 3,A50,083646,Miranda; Gregory Joseph,18,0,50,32
1656159819219,CSE 8A,A50,083650,Miranda; Gregory Joseph,3,3,56,53
1656159825251,CSE 11,A01,083080,Cao; Yingjun,1,54,40,39
1656159831278,CSE 12,A01,083652,Krause-Levy; Sophia Louisa,7,2,120,113
1656159837305,CSE 15L,A01,083654,Morris; Justin Loren,2,0,50,48
1656159837305,CSE 15L,A02,083655,Morris; Justin Loren,4,0,50,46
1656159843330,CSE 20,A01,083657,Tran; Khoa Dang,31,0,80,49
1656159849357,CSE 21,A01,095574,Bach; Quang Tran,25,0,48,23
1656159855393,CSE 30,A01,083084,Eldon; John,2,8,80,78
1656159855393,CSE 30,B01,095061,Bhaskar; Nishant,1,2,50,49
1656159861423,CSE 100,A01,083659,Cao; Yingjun,2,20,70,68
1656159867450,CSE 134B,A01,083661,Powell; Thomas Allan,3,0,100,97
1656159873485,CSE 140,A01,083663,Gungor; Onat,9,0,85,76
1656159879511,CSE 140L,A01,083088,Eldon; John,8,0,100,92
1656159885538,CSE 175,A01,083665,Kumar; Rakesh,0,0,25,25
1656159891569,CSE 190,A00,092507,Dubnov; Shlomo,3,0,20,17
1656159897596,ECE 45,A01,083139,Congero; Spencer William,1,0,75,74
1656159903624,ECE 65,A50,083695,Saad; Andrew S,9,0,30,21
1656159903624,ECE 65,A51,095125,Staff,23,0,26,3
1656159909721,ECE 109,A01,091882,Touri; Behrouz,0,1,70,70
1656159915746,ECE 180,A00,083140,Abi Samra; Nicholas Camill,1,0,30,29
1656159915746,ECE 180,B00,083141,Abi Samra; Nicholas Camill,0,4,30,30
1656159921789,MATH 10A,A01,083735,Patchell; Gregory David,0,0,30,30
1656159921789,MATH 10A,A02,083736,Patchell; Gregory David,22,0,30,8
1656159921789,MATH 10A,A03,083737,Patchell; Gregory David,16,0,30,14
1656159927819,MATH 10B,A01,083207,Lim; Seonhee,0,0,34,34
1656159927819,MATH 10B,A02,083208,Lim; Seonhee,7,0,35,28
1656159927819,MATH 10B,A03,093472,Staff,1,0,34,33
1656159927819,MATH 10B,B01,083739,Sinha; Shubham,10,0,30,20
1656159933849,MATH 18,A01,083743,Cinel; Cameron Alexander,7,0,30,23
1656159933849,MATH 18,A02,083744,Cinel; Cameron Alexander,10,0,30,20
1656159933849,MATH 18,A03,083745,Cinel; Cameron Alexander,4,0,30,26
1656159933849,MATH 18,B01,083748,Rideout; David Porter,0,0,36,36
1656159933849,MATH 18,B02,083749,Rideout; David Porter,0,0,36,36
1656159933849,MATH 18,B03,083750,Rideout; David Porter,0,0,36,36
1656159933849,MATH 18,B04,083751,Rideout; David Porter,0,0,36,36
1656159933849,MATH 18,B05,093473,Rideout; David Porter,1,0,36,35
1656159933849,MATH 18,B06,093474,Rideout; David Porter,4,0,36,32
1656159939892,MATH 20A,A01,083754,Zheng; Zequn,11,0,40,29
1656159945919,MATH 20B,A01,083756,Briones; Jor-el Thomas Caparas,0,0,36,36
1656159945919,MATH 20B,A02,083757,Briones; Jor-el Thomas Caparas,0,0,36,36
1656159945919,MATH 20B,A03,093475,Staff,2,0,36,34
1656159951951,MATH 20C,A01,083760,Briones; Jor-el Thomas Caparas,0,0,35,35
1656159951951,MATH 20C,A02,083761,Briones; Jor-el Thomas Caparas,9,1,35,26
1656159951951,MATH 20C,A03,093476,Staff,0,0,35,35
1656159951951,MATH 20C,B01,083762,Bach; Quang Tran,1,0,30,29
1656159957993,MATH 20D,A01,083765,Tran; Brian Kha,2,0,30,28
1656159957993,MATH 20D,A02,083766,Tran; Brian Kha,0,1,30,30
1656159957993,MATH 20D,A03,083767,Tran; Brian Kha,2,0,30,28
1656159964021,MATH 20E,A01,083771,Ganguly; Soumya,4,0,32,28
1656159964021,MATH 20E,A02,083772,Ganguly; Soumya,0,0,32,32
1656159964021,MATH 20E,B01,083773,Ciotti; Benjamin,15,0,35,20
1656159964021,MATH 20E,B02,083774,Ciotti; Benjamin,15,0,35,20
1656159970049,MATH 103A,A01,083777,Greenfeld; Be'Eri,1,0,36,35
1656159970049,MATH 103A,A02,083778,Greenfeld; Be'Eri,1,0,36,35
1656159970049,MATH 103A,A03,093561,Staff,4,0,36,32
1656159970049,MATH 103A,B01,083779,Greenfeld; Be'Eri,8,1,36,28
1656159970049,MATH 103A,B02,083780,Greenfeld; Be'Eri,1,0,36,35
1656159970049,MATH 103A,B03,093562,Staff,0,0,36,36
1656159976088,MATH 105,A01,085443,Carter; Anne Toulson,5,1,35,30
1656159976088,MATH 105,A02,093477,Staff,11,0,35,24
1656159982115,MATH 109,A01,083213,Ganzberger; Geoffrey Michael,0,0,34,34
1656159982115,MATH 109,A02,083214,Ganzberger; Geoffrey Michael,0,0,34,34
1656159982115,MATH 109,A03,093478,Staff,1,0,34,33
1656159982115,MATH 109,B01,083215,Ganzberger; Geoffrey Michael,4,0,32,28
1656159982115,MATH 109,B02,083216,Ganzberger; Geoffrey Michael,1,0,32,31
1656159982115,MATH 109,B03,093479,Staff,4,0,32,28
1656159988148,MATH 142A,A01,083219,Chow; Bennett,1,0,32,31
1656159988148,MATH 142A,A02,083220,Chow; Bennett,8,0,32,24
1656159988148,MATH 142A,A03,093480,Staff,5,0,32,27
1656159988148,MATH 142A,B03,093481,Staff,4,0,32,28
1656159988148,MATH 142A,B04,093558,Staff,6,0,32,26
1656159988148,MATH 142A,B05,093559,Staff,0,0,32,32
1656159994184,MATH 193A,A01,083224,Rotar; Vladimir,0,1,34,34
1656159994184,MATH 193A,A02,083225,Rotar; Vladimir,0,0,34,34
1656159994184,MATH 193A,A03,083781,Rotar; Vladimir,0,0,34,34
1656159994184,MATH 193A,A04,083782,Rotar; Vladimir,6,0,34,28
1656159994184,MATH 193A,A05,093482,Rotar; Vladimir,1,0,34,33
1656160000212,MATH 197,001,091859,McAuley; Julian John,9999,0,9999,0
1656160000212,MATH 197,002,095566,Kedlaya; Kiran S.,9997,0,9999,2
1656160000212,MATH 197,003,095567,Xiao; Ming,9999,0,9999,0
1656160000212,MATH 197,004,095571,Perols; Johan Lars,9998,0,9999,1
1656160007307,COGS 9,A01,083615,Shannon; Kyle Michael,4,0,75,71
1656160013336,COGS 11,A01,083617,Boyle; Mary E. T.,14,0,48,34
1656160019370,COGS 13,A01,083071,Bastos; Amalia Pinkusfeld,6,0,71,65
1656160025409,COGS 14A,A01,092681,Semenuks; Arturs,4,15,100,96
1656160031438,COGS 14B,A01,083073,Cheng; Tzu-Han,7,0,63,56
1656160037463,COGS 17,A01,092677,Semenuks; Arturs,8,0,81,73
1656160043488,COGS 100,A01,083619,Allen; Michael Gordon,2,0,70,68
1656160049515,COGS 101A,A01,083621,Davis; Joshua Daniel,3,0,68,65
1656160055542,COGS 101B,A01,091572,Allen; Michael Gordon,6,0,65,59
1656160061567,COGS 101C,A01,083625,Delgado; Tania,10,0,35,25
1656160067600,COGS 107A,A01,083627,Boyle; Mary E. T.,0,0,60,60
1656160073627,COGS 118A,A01,083075,Gupta; Anjum,7,0,76,69
1656160079656,CSE 3,A50,083646,Miranda; Gregory Joseph,18,0,50,32
1656160085686,CSE 8A,A50,083650,Miranda; Gregory Joseph,3,3,56,53
1656160091712,CSE 11,A01,083080,Cao; Yingjun,1,54,40,39
1656160097745,CSE 12,A01,083652,Krause-Levy; Sophia Louisa,7,2,120,113
1656160103778,CSE 15L,A01,083654,Morris; Justin Loren,2,0,50,48
1656160103778,CSE 15L,A02,083655,Morris; Justin Loren,4,0,50,46
1656160109809,CSE 20,A01,083657,Tran; Khoa Dang,31,0,80,49
1656160115835,CSE 21,A01,095574,Bach; Quang Tran,25,0,48,23
1656160121863,CSE 30,A01,083084,Eldon; John,2,8,80,78
1656160121863,CSE 30,B01,095061,Bhaskar; Nishant,1,2,50,49
1656160127893,CSE 100,A01,083659,Cao; Yingjun,2,20,70,68
1656160133918,CSE 134B,A01,083661,Powell; Thomas Allan,3,0,100,97
1656160139963,CSE 140,A01,083663,Gungor; Onat,9,0,85,76
1656160145999,CSE 140L,A01,083088,Eldon; John,8,0,100,92
1656160152029,CSE 175,A01,083665,Kumar; Rakesh,0,0,25,25
1656160158062,CSE 190,A00,092507,Dubnov; Shlomo,3,0,20,17
1656160164091,ECE 45,A01,083139,Congero; Spencer William,1,0,75,74
1656160170124,ECE 65,A50,083695,Saad; Andrew S,9,0,30,21
1656160170124,ECE 65,A51,095125,Staff,23,0,26,3
1656160176149,ECE 109,A01,091882,Touri; Behrouz,0,1,70,70
1656160182184,ECE 180,A00,083140,Abi Samra; Nicholas Camill,1,0,30,29
1656160182184,ECE 180,B00,083141,Abi Samra; Nicholas Camill,0,4,30,30
1656160188220,MATH 10A,A01,083735,Patchell; Gregory David,0,0,30,30
1656160188220,MATH 10A,A02,083736,Patchell; Gregory David,22,0,30,8
1656160188220,MATH 10A,A03,083737,Patchell; Gregory David,16,0,30,14
1656160194259,MATH 10B,A01,083207,Lim; Seonhee,0,0,34,34
1656160194259,MATH 10B,A02,083208,Lim; Seonhee,7,0,35,28
1656160194259,MATH 10B,A03,093472,Staff,1,0,34,33
1656160194259,MATH 10B,B01,083739,Sinha; Shubham,10,0,30,20
1656160200302,MATH 18,A01,083743,Cinel; Cameron Alexander,7,0,30,23
1656160200302,MATH 18,A02,083744,Cinel; Cameron Alexander,10,0,30,20
1656160200302,MATH 18,A03,083745,Cinel; Cameron Alexander,4,0,30,26
1656160200302,MATH 18,B01,083748,Rideout; David Porter,0,0,36,36
1656160200302,MATH 18,B02,083749,Rideout; David Porter,0,0,36,36
1656160200302,MATH 18,B03,083750,Rideout; David Porter,0,0,36,36
1656160200302,MATH 18,B04,083751,Rideout; David Porter,0,0,36,36
1656160200302,MATH 18,B05,093473,Rideout; David Porter,1,0,36,35
1656160200302,MATH 18,B06,093474,Rideout; David Porter,3,0,36,33
1656160206332,MATH 20A,A01,083754,Zheng; Zequn,11,0,40,29
1656160212364,MATH 20B,A01,083756,Briones; Jor-el Thomas Caparas,0,0,36,36
1656160212364,MATH 20B,A02,083757,Briones; Jor-el Thomas Caparas,0,0,36,36
1656160212364,MATH 20B,A03,093475,Staff,2,0,36,34
1656160218401,MATH 20C,A01,083760,Briones; Jor-el Thomas Caparas,0,0,35,35
1656160218401,MATH 20C,A02,083761,Briones; Jor-el Thomas Caparas,9,1,35,26
1656160218401,MATH 20C,A03,093476,Staff,0,0,35,35
1656160218401,MATH 20C,B01,083762,Bach; Quang Tran,1,0,30,29
1656160224441,MATH 20D,A01,083765,Tran; Brian Kha,2,0,30,28
1656160224441,MATH 20D,A02,083766,Tran; Brian Kha,0,1,30,30
1656160224441,MATH 20D,A03,083767,Tran; Brian Kha,2,0,30,28
1656160230487,MATH 20E,A01,083771,Ganguly; Soumya,4,0,32,28
1656160230487,MATH 20E,A02,083772,Ganguly; Soumya,0,0,32,32
1656160230487,MATH 20E,B01,083773,Ciotti; Benjamin,15,0,35,20
1656160230487,MATH 20E,B02,083774,Ciotti; Benjamin,15,0,35,20
1656160236515,MATH 103A,A01,083777,Greenfeld; Be'Eri,1,0,36,35
1656160236515,MATH 103A,A02,083778,Greenfeld; Be'Eri,1,0,36,35
1656160236515,MATH 103A,A03,093561,Staff,4,0,36,32
1656160236515,MATH 103A,B01,083779,Greenfeld; Be'Eri,8,1,36,28
1656160236515,MATH 103A,B02,083780,Greenfeld; Be'Eri,1,0,36,35
1656160236515,MATH 103A,B03,093562,Staff,0,0,36,36
1656160242543,MATH 105,A01,085443,Carter; Anne Toulson,5,1,35,30
1656160242543,MATH 105,A02,093477,Staff,11,0,35,24
1656160248576,MATH 109,A01,083213,Ganzberger; Geoffrey Michael,0,0,34,34
1656160248576,MATH 109,A02,083214,Ganzberger; Geoffrey Michael,0,0,34,34
1656160248576,MATH 109,A03,093478,Staff,1,0,34,33
1656160248576,MATH 109,B01,083215,Ganzberger; Geoffrey Michael,4,0,32,28
1656160248576,MATH 109,B02,083216,Ganzberger; Geoffrey Michael,1,0,32,31
1656160248576,MATH 109,B03,093479,Staff,4,0,32,28
1656160254605,MATH 142A,A01,083219,Chow; Bennett,1,0,32,31
1656160254605,MATH 142A,A02,083220,Chow; Bennett,8,0,32,24
1656160254605,MATH 142A,A03,093480,Staff,5,0,32,27
1656160254605,MATH 142A,B03,093481,Staff,4,0,32,28
1656160254605,MATH 142A,B04,093558,Staff,6,0,32,26
1656160254605,MATH 142A,B05,093559,Staff,0,0,32,32
1656160260638,MATH 193A,A01,083224,Rotar; Vladimir,0,1,34,34
1656160260638,MATH 193A,A02,083225,Rotar; Vladimir,0,0,34,34
1656160260638,MATH 193A,A03,083781,Rotar; Vladimir,0,0,34,34
1656160260638,MATH 193A,A04,083782,Rotar; Vladimir,6,0,34,28
1656160260638,MATH 193A,A05,093482,Rotar; Vladimir,1,0,34,33
1656160266670,MATH 197,001,091859,McAuley; Julian John,9999,0,9999,0
1656160266670,MATH 197,002,095566,Kedlaya; Kiran S.,9997,0,9999,2
1656160266670,MATH 197,003,095567,Xiao; Ming,9999,0,9999,0
1656160266670,MATH 197,004,095571,Perols; Johan Lars,9998,0,9999,1
1656160273764,COGS 9,A01,083615,Shannon; Kyle Michael,4,0,75,71
1656160279790,COGS 11,A01,083617,Boyle; Mary E. T.,14,0,48,34
1656160285822,COGS 13,A01,083071,Bastos; Amalia Pinkusfeld,6,0,71,65
1656160291879,COGS 14A,A01,092681,Semenuks; Arturs,4,15,100,96
1656160297912,COGS 14B,A01,083073,Cheng; Tzu-Han,7,0,63,56
1656160303963,COGS 17,A01,092677,Semenuks; Arturs,8,0,81,73
1656160309996,COGS 100,A01,083619,Allen; Michael Gordon,2,0,70,68
1656160316022,COGS 101A,A01,083621,Davis; Joshua Daniel,3,0,68,65
1656160322053,COGS 101B,A01,091572,Allen; Michael Gordon,6,0,65,59
1656160328100,COGS 101C,A01,083625,Delgado; Tania,10,0,35,25
1656160334130,COGS 107A,A01,083627,Boyle; Mary E. T.,0,0,60,60
1656160340170,COGS 118A,A01,083075,Gupta; Anjum,7,0,76,69
1656160346205,CSE 3,A50,083646,Miranda; Gregory Joseph,18,0,50,32
1656160352251,CSE 8A,A50,083650,Miranda; Gregory Joseph,3,3,56,53
1656160358279,CSE 11,A01,083080,Cao; Yingjun,1,54,40,39
1656160364306,CSE 12,A01,083652,Krause-Levy; Sophia Louisa,7,2,120,113
1656160370332,CSE 15L,A01,083654,Morris; Justin Loren,2,0,50,48
1656160370332,CSE 15L,A02,083655,Morris; Justin Loren,4,0,50,46
1656160376369,CSE 20,A01,083657,Tran; Khoa Dang,31,0,80,49
1656160382394,CSE 21,A01,095574,Bach; Quang Tran,25,0,48,23
1656160388423,CSE 30,A01,083084,Eldon; John,2,8,80,78
1656160388423,CSE 30,B01,095061,Bhaskar; Nishant,1,2,50,49
1656160394450,CSE 100,A01,083659,Cao; Yingjun,2,20,70,68
1656160400477,CSE 134B,A01,083661,Powell; Thomas Allan,3,0,100,97
1656160406504,CSE 140,A01,083663,Gungor; Onat,9,0,85,76
1656160412532,CSE 140L,A01,083088,Eldon; John,8,0,100,92
1656160418559,CSE 175,A01,083665,Kumar; Rakesh,0,0,25,25
1656160424589,CSE 190,A00,092507,Dubnov; Shlomo,3,0,20,17
1656160430616,ECE 45,A01,083139,Congero; Spencer William,1,0,75,74
1656160436644,ECE 65,A50,083695,Saad; Andrew S,9,0,30,21
1656160436644,ECE 65,A51,095125,Staff,23,0,26,3
1656160442671,ECE 109,A01,091882,Touri; Behrouz,0,1,70,70
1656160448702,ECE 180,A00,083140,Abi Samra; Nicholas Camill,1,0,30,29
1656160448702,ECE 180,B00,083141,Abi Samra; Nicholas Camill,0,4,30,30
1656160454733,MATH 10A,A01,083735,Patchell; Gregory David,0,0,30,30
1656160454733,MATH 10A,A02,083736,Patchell; Gregory David,22,0,30,8
1656160454733,MATH 10A,A03,083737,Patchell; Gregory David,16,0,30,14
1656160460783,MATH 10B,A01,083207,Lim; Seonhee,0,0,34,34
1656160460783,MATH 10B,A02,083208,Lim; Seonhee,7,0,35,28
1656160460783,MATH 10B,A03,093472,Staff,1,0,34,33
1656160460783,MATH 10B,B01,083739,Sinha; Shubham,10,0,30,20
1656160466824,MATH 18,A01,083743,Cinel; Cameron Alexander,7,0,30,23
1656160466824,MATH 18,A02,083744,Cinel; Cameron Alexander,10,0,30,20
1656160466824,MATH 18,A03,083745,Cinel; Cameron Alexander,4,0,30,26
1656160466824,MATH 18,B01,083748,Rideout; David Porter,0,0,36,36
1656160466824,MATH 18,B02,083749,Rideout; David Porter,0,0,36,36
1656160466824,MATH 18,B03,083750,Rideout; David Porter,0,0,36,36
1656160466824,MATH 18,B04,083751,Rideout; David Porter,0,0,36,36
1656160466824,MATH 18,B05,093473,Rideout; David Porter,1,0,36,35
1656160466824,MATH 18,B06,093474,Rideout; David Porter,3,0,36,33
1656160472856,MATH 20A,A01,083754,Zheng; Zequn,11,0,40,29
1656160478884,MATH 20B,A01,083756,Briones; Jor-el Thomas Caparas,0,0,36,36
1656160478884,MATH 20B,A02,083757,Briones; Jor-el Thomas Caparas,0,0,36,36
1656160478884,MATH 20B,A03,093475,Staff,2,0,36,34
1656160484910,MATH 20C,A01,083760,Briones; Jor-el Thomas Caparas,0,0,35,35
1656160484910,MATH 20C,A02,083761,Briones; Jor-el Thomas Caparas,9,1,35,26
1656160484910,MATH 20C,A03,093476,Staff,0,0,35,35
1656160484910,MATH 20C,B01,083762,Bach; Quang Tran,1,0,30,29
1656160490943,MATH 20D,A01,083765,Tran; Brian Kha,2,0,30,28
1656160490943,MATH 20D,A02,083766,Tran; Brian Kha,0,1,30,30
1656160490943,MATH 20D,A03,083767,Tran; Brian Kha,2,0,30,28
1656160496970,MATH 20E,A01,083771,Ganguly; Soumya,4,0,32,28
1656160496970,MATH 20E,A02,083772,Ganguly; Soumya,0,0,32,32
1656160496970,MATH 20E,B01,083773,Ciotti; Benjamin,15,0,35,20
1656160496970,MATH 20E,B02,083774,Ciotti; Benjamin,15,0,35,20
1656160503009,MATH 103A,A01,083777,Greenfeld; Be'Eri,1,0,36,35
1656160503009,MATH 103A,A02,083778,Greenfeld; Be'Eri,1,0,36,35
1656160503009,MATH 103A,A03,093561,Staff,4,0,36,32
1656160503009,MATH 103A,B01,083779,Greenfeld; Be'Eri,8,1,36,28
1656160503009,MATH 103A,B02,083780,Greenfeld; Be'Eri,1,0,36,35
1656160503009,MATH 103A,B03,093562,Staff,0,0,36,36
1656160509132,MATH 105,A01,085443,Carter; Anne Toulson,5,1,35,30
1656160509132,MATH 105,A02,093477,Staff,11,0,35,24
1656160515159,MATH 109,A01,083213,Ganzberger; Geoffrey Michael,0,0,34,34
1656160515159,MATH 109,A02,083214,Ganzberger; Geoffrey Michael,0,0,34,34
1656160515159,MATH 109,A03,093478,Staff,1,0,34,33
1656160515159,MATH 109,B01,083215,Ganzberger; Geoffrey Michael,4,0,32,28
1656160515159,MATH 109,B02,083216,Ganzberger; Geoffrey Michael,1,0,32,31
1656160515159,MATH 109,B03,093479,Staff,4,0,32,28
1656160521192,MATH 142A,A01,083219,Chow; Bennett,1,0,32,31
1656160521192,MATH 142A,A02,083220,Chow; Bennett,8,0,32,24
1656160521192,MATH 142A,A03,093480,Staff,5,0,32,27
1656160521192,MATH 142A,B03,093481,Staff,4,0,32,28
1656160521192,MATH 142A,B04,093558,Staff,6,0,32,26
1656160521192,MATH 142A,B05,093559,Staff,0,0,32,32
1656160527224,MATH 193A,A01,083224,Rotar; Vladimir,0,1,34,34
1656160527224,MATH 193A,A02,083225,Rotar; Vladimir,0,0,34,34
1656160527224,MATH 193A,A03,083781,Rotar; Vladimir,0,0,34,34
1656160527224,MATH 193A,A04,083782,Rotar; Vladimir,6,0,34,28
1656160527224,MATH 193A,A05,093482,Rotar; Vladimir,1,0,34,33
1656160533250,MATH 197,001,091859,McAuley; Julian John,9999,0,9999,0
1656160533250,MATH 197,002,095566,Kedlaya; Kiran S.,9997,0,9999,2
1656160533250,MATH 197,003,095567,Xiao; Ming,9999,0,9999,0
1656160533250,MATH 197,004,095571,Perols; Johan Lars,9998,0,9999,1
1656160540325,COGS 9,A01,083615,Shannon; Kyle Michael,4,0,75,71
1656160546356,COGS 11,A01,083617,Boyle; Mary E. T.,14,0,48,34
1656160552385,COGS 13,A01,083071,Bastos; Amalia Pinkusfeld,6,0,71,65
1656160558410,COGS 14A,A01,092681,Semenuks; Arturs,4,15,100,96
1656160564436,COGS 14B,A01,083073,Cheng; Tzu-Han,7,0,63,56
1656160570461,COGS 17,A01,092677,Semenuks; Arturs,8,0,81,73
1656160576492,COGS 100,A01,083619,Allen; Michael Gordon,2,0,70,68
1656160582517,COGS 101A,A01,083621,Davis; Joshua Daniel,3,0,68,65
1656160588549,COGS 101B,A01,091572,Allen; Michael Gordon,6,0,65,59
1656160594579,COGS 101C,A01,083625,Delgado; Tania,10,0,35,25
1656160600604,COGS 107A,A01,083627,Boyle; Mary E. T.,0,0,60,60
1656160606635,COGS 118A,A01,083075,Gupta; Anjum,7,0,76,69
1656160612669,CSE 3,A50,083646,Miranda; Gregory Joseph,18,0,50,32
1656160618693,CSE 8A,A50,083650,Miranda; Gregory Joseph,3,3,56,53
1656160624727,CSE 11,A01,083080,Cao; Yingjun,1,54,40,39
1656160630759,CSE 12,A01,083652,Krause-Levy; Sophia Louisa,7,2,120,113
1656160636784,CSE 15L,A01,083654,Morris; Justin Loren,2,0,50,48
1656160636784,CSE 15L,A02,083655,Morris; Justin Loren,4,0,50,46
1656160642825,CSE 20,A01,083657,Tran; Khoa Dang,31,0,80,49
1656160648856,CSE 21,A01,095574,Bach; Quang Tran,25,0,48,23
1656160654882,CSE 30,A01,083084,Eldon; John,2,8,80,78
1656160654882,CSE 30,B01,095061,Bhaskar; Nishant,1,2,50,49
1656160660908,CSE 100,A01,083659,Cao; Yingjun,2,20,70,68
1656160666942,CSE 134B,A01,083661,Powell; Thomas Allan,3,0,100,97
1656160672968,CSE 140,A01,083663,Gungor; Onat,9,0,85,76
1656160678999,CSE 140L,A01,083088,Eldon; John,8,0,100,92
1656160685033,CSE 175,A01,083665,Kumar; Rakesh,0,0,25,25
1656160691062,CSE 190,A00,092507,Dubnov; Shlomo,3,0,20,17
1656160697094,ECE 45,A01,083139,Congero; Spencer William,1,0,75,74
1656160703127,ECE 65,A50,083695,Saad; Andrew S,9,0,30,21
1656160703127,ECE 65,A51,095125,Staff,23,0,26,3
1656160709158,ECE 109,A01,091882,Touri; Behrouz,0,1,70,70
1656160715185,ECE 180,A00,083140,Abi Samra; Nicholas Camill,1,0,30,29
1656160715185,ECE 180,B00,083141,Abi Samra; Nicholas Camill,0,4,30,30
1656160721215,MATH 10A,A01,083735,Patchell; Gregory David,0,0,30,30
1656160721215,MATH 10A,A02,083736,Patchell; Gregory David,22,0,30,8
1656160721215,MATH 10A,A03,083737,Patchell; Gregory David,16,0,30,14
1656160727244,MATH 10B,A01,083207,Lim; Seonhee,0,0,34,34
1656160727244,MATH 10B,A02,083208,Lim; Seonhee,7,0,35,28
1656160727244,MATH 10B,A03,093472,Staff,1,0,34,33
1656160727244,MATH 10B,B01,083739,Sinha; Shubham,10,0,30,20
1656160733283,MATH 18,A01,083743,Cinel; Cameron Alexander,7,0,30,23
1656160733283,MATH 18,A02,083744,Cinel; Cameron Alexander,10,0,30,20
1656160733283,MATH 18,A03,083745,Cinel; Cameron Alexander,4,0,30,26
1656160733283,MATH 18,B01,083748,Rideout; David Porter,0,0,36,36
1656160733283,MATH 18,B02,083749,Rideout; David Porter,0,0,36,36
1656160733283,MATH 18,B03,083750,Rideout; David Porter,0,0,36,36
1656160733283,MATH 18,B04,083751,Rideout; David Porter,0,0,36,36
1656160733283,MATH 18,B05,093473,Rideout; David Porter,1,0,36,35
1656160733283,MATH 18,B06,093474,Rideout; David Porter,3,0,36,33
1656160739317,MATH 20A,A01,083754,Zheng; Zequn,11,0,40,29
1656160745377,MATH 20B,A01,083756,Briones; Jor-el Thomas Caparas,0,0,36,36
1656160745377,MATH 20B,A02,083757,Briones; Jor-el Thomas Caparas,0,0,36,36
1656160745377,MATH 20B,A03,093475,Staff,2,0,36,34
1656160751417,MATH 20C,A01,083760,Briones; Jor-el Thomas Caparas,0,0,35,35
1656160751417,MATH 20C,A02,083761,Briones; Jor-el Thomas Caparas,9,1,35,26
1656160751417,MATH 20C,A03,093476,Staff,0,0,35,35
1656160751417,MATH 20C,B01,083762,Bach; Quang Tran,1,0,30,29
1656160757450,MATH 20D,A01,083765,Tran; Brian Kha,2,0,30,28
1656160757450,MATH 20D,A02,083766,Tran; Brian Kha,0,1,30,30
1656160757450,MATH 20D,A03,083767,Tran; Brian Kha,2,0,30,28
1656160763486,MATH 20E,A01,083771,Ganguly; Soumya,4,0,32,28
1656160763486,MATH 20E,A02,083772,Ganguly; Soumya,0,0,32,32
1656160763486,MATH 20E,B01,083773,Ciotti; Benjamin,15,0,35,20
1656160763486,MATH 20E,B02,083774,Ciotti; Benjamin,15,0,35,20
1656160769523,MATH 103A,A01,083777,Greenfeld; Be'Eri,1,0,36,35
1656160769523,MATH 103A,A02,083778,Greenfeld; Be'Eri,1,0,36,35
1656160769523,MATH 103A,A03,093561,Staff,4,0,36,32
1656160769523,MATH 103A,B01,083779,Greenfeld; Be'Eri,8,1,36,28
1656160769523,MATH 103A,B02,083780,Greenfeld; Be'Eri,1,0,36,35
1656160769523,MATH 103A,B03,093562,Staff,0,0,36,36
1656160775555,MATH 105,A01,085443,Carter; Anne Toulson,5,1,35,30
1656160775555,MATH 105,A02,093477,Staff,11,0,35,24
1656160781582,MATH 109,A01,083213,Ganzberger; Geoffrey Michael,0,0,34,34
1656160781582,MATH 109,A02,083214,Ganzberger; Geoffrey Michael,0,0,34,34
1656160781582,MATH 109,A03,093478,Staff,1,0,34,33
1656160781582,MATH 109,B01,083215,Ganzberger; Geoffrey Michael,4,0,32,28
1656160781582,MATH 109,B02,083216,Ganzberger; Geoffrey Michael,1,0,32,31
1656160781582,MATH 109,B03,093479,Staff,4,0,32,28
1656160787610,MATH 142A,A01,083219,Chow; Bennett,1,0,32,31
1656160787610,MATH 142A,A02,083220,Chow; Bennett,8,0,32,24
1656160787610,MATH 142A,A03,093480,Staff,5,0,32,27
1656160787610,MATH 142A,B03,093481,Staff,4,0,32,28
1656160787610,MATH 142A,B04,093558,Staff,6,0,32,26
1656160787610,MATH 142A,B05,093559,Staff,0,0,32,32
1656160793643,MATH 193A,A01,083224,Rotar; Vladimir,0,1,34,34
1656160793643,MATH 193A,A02,083225,Rotar; Vladimir,0,0,34,34
1656160793643,MATH 193A,A03,083781,Rotar; Vladimir,0,0,34,34
1656160793643,MATH 193A,A04,083782,Rotar; Vladimir,6,0,34,28
1656160793643,MATH 193A,A05,093482,Rotar; Vladimir,1,0,34,33
1656160799676,MATH 197,001,091859,McAuley; Julian John,9999,0,9999,0
1656160799676,MATH 197,002,095566,Kedlaya; Kiran S.,9997,0,9999,2
1656160799676,MATH 197,003,095567,Xiao; Ming,9999,0,9999,0
1656160799676,MATH 197,004,095571,Perols; Johan Lars,9998,0,9999,1
1656160806757,COGS 9,A01,083615,Shannon; Kyle Michael,4,0,75,71
1656160812793,COGS 11,A01,083617,Boyle; Mary E. T.,14,0,48,34
1656160818825,COGS 13,A01,083071,Bastos; Amalia Pinkusfeld,6,0,71,65
1656160824850,COGS 14A,A01,092681,Semenuks; Arturs,4,15,100,96
1656160830876,COGS 14B,A01,083073,Cheng; Tzu-Han,7,0,63,56
1656160836902,COGS 17,A01,092677,Semenuks; Arturs,8,0,81,73
1656160842934,COGS 100,A01,083619,Allen; Michael Gordon,2,0,70,68
1656160848959,COGS 101A,A01,083621,Davis; Joshua Daniel,3,0,68,65
1656160854985,COGS 101B,A01,091572,Allen; Michael Gordon,6,0,65,59
1656160861017,COGS 101C,A01,083625,Delgado; Tania,10,0,35,25
1656160867042,COGS 107A,A01,083627,Boyle; Mary E. T.,0,0,60,60
1656160873070,COGS 118A,A01,083075,Gupta; Anjum,7,0,76,69
1656160879103,CSE 3,A50,083646,Miranda; Gregory Joseph,18,0,50,32
1656160885127,CSE 8A,A50,083650,Miranda; Gregory Joseph,3,3,56,53
1656160891156,CSE 11,A01,083080,Cao; Yingjun,1,54,40,39
1656160897196,CSE 12,A01,083652,Krause-Levy; Sophia Louisa,7,2,120,113
1656160903222,CSE 15L,A01,083654,Morris; Justin Loren,2,0,50,48
1656160903222,CSE 15L,A02,083655,Morris; Justin Loren,4,0,50,46
1656160909254,CSE 20,A01,083657,Tran; Khoa Dang,31,0,80,49
1656160915279,CSE 21,A01,095574,Bach; Quang Tran,25,0,48,23
1656160921306,CSE 30,A01,083084,Eldon; John,2,8,80,78
1656160921306,CSE 30,B01,095061,Bhaskar; Nishant,1,2,50,49
1656160927331,CSE 100,A01,083659,Cao; Yingjun,2,20,70,68
1656160933360,CSE 134B,A01,083661,Powell; Thomas Allan,3,0,100,97
1656160939387,CSE 140,A01,083663,Gungor; Onat,9,0,85,76
1656160945410,CSE 140L,A01,083088,Eldon; John,8,0,100,92
1656160951440,CSE 175,A01,083665,Kumar; Rakesh,0,0,25,25
1656160957466,CSE 190,A00,092507,Dubnov; Shlomo,3,0,20,17
1656160963498,ECE 45,A01,083139,Congero; Spencer William,1,0,75,74
1656160969531,ECE 65,A50,083695,Saad; Andrew S,9,0,30,21
1656160969531,ECE 65,A51,095125,Staff,23,0,26,3
1656160975555,ECE 109,A01,091882,Touri; Behrouz,0,1,70,70
1656160981579,ECE 180,A00,083140,Abi Samra; Nicholas Camill,1,0,30,29
1656160981579,ECE 180,B00,083141,Abi Samra; Nicholas Camill,0,4,30,30
1656160987605,MATH 10A,A01,083735,Patchell; Gregory David,0,0,30,30
1656160987605,MATH 10A,A02,083736,Patchell; Gregory David,22,0,30,8
1656160987605,MATH 10A,A03,083737,Patchell; Gregory David,16,0,30,14
1656160993642,MATH 10B,A01,083207,Lim; Seonhee,0,0,34,34
1656160993642,MATH 10B,A02,083208,Lim; Seonhee,7,0,35,28
1656160993642,MATH 10B,A03,093472,Staff,1,0,34,33
1656160993642,MATH 10B,B01,083739,Sinha; Shubham,10,0,30,20
1656160999679,MATH 18,A01,083743,Cinel; Cameron Alexander,7,0,30,23
1656160999679,MATH 18,A02,083744,Cinel; Cameron Alexander,10,0,30,20
1656160999679,MATH 18,A03,083745,Cinel; Cameron Alexander,4,0,30,26
1656160999679,MATH 18,B01,083748,Rideout; David Porter,0,0,36,36
1656160999679,MATH 18,B02,083749,Rideout; David Porter,0,0,36,36
1656160999679,MATH 18,B03,083750,Rideout; David Porter,0,0,36,36
1656160999679,MATH 18,B04,083751,Rideout; David Porter,0,0,36,36
1656160999679,MATH 18,B05,093473,Rideout; David Porter,1,0,36,35
1656160999679,MATH 18,B06,093474,Rideout; David Porter,3,0,36,33
1656161005709,MATH 20A,A01,083754,Zheng; Zequn,11,0,40,29
1656161011735,MATH 20B,A01,083756,Briones; Jor-el Thomas Caparas,0,0,36,36
1656161011735,MATH 20B,A02,083757,Briones; Jor-el Thomas Caparas,0,0,36,36
1656161011735,MATH 20B,A03,093475,Staff,2,0,36,34
1656161017770,MATH 20C,A01,083760,Briones; Jor-el Thomas Caparas,0,0,35,35
1656161017770,MATH 20C,A02,083761,Briones; Jor-el Thomas Caparas,9,1,35,26
1656161017770,MATH 20C,A03,093476,Staff,0,0,35,35
1656161017770,MATH 20C,B01,083762,Bach; Quang Tran,1,0,30,29
1656161023798,MATH 20D,A01,083765,Tran; Brian Kha,2,0,30,28
1656161023798,MATH 20D,A02,083766,Tran; Brian Kha,0,1,30,30
1656161023798,MATH 20D,A03,083767,Tran; Brian Kha,2,0,30,28
1656161029833,MATH 20E,A01,083771,Ganguly; Soumya,4,0,32,28
1656161029833,MATH 20E,A02,083772,Ganguly; Soumya,0,0,32,32
1656161029833,MATH 20E,B01,083773,Ciotti; Benjamin,15,0,35,20
1656161029833,MATH 20E,B02,083774,Ciotti; Benjamin,15,0,35,20
1656161035858,MATH 103A,A01,083777,Greenfeld; Be'Eri,1,0,36,35
1656161035858,MATH 103A,A02,083778,Greenfeld; Be'Eri,1,0,36,35
1656161035858,MATH 103A,A03,093561,Staff,4,0,36,32
1656161035858,MATH 103A,B01,083779,Greenfeld; Be'Eri,8,1,36,28
1656161035858,MATH 103A,B02,083780,Greenfeld; Be'Eri,1,0,36,35
1656161035858,MATH 103A,B03,093562,Staff,0,0,36,36
1656161041885,MATH 105,A01,085443,Carter; Anne Toulson,5,1,35,30
1656161041885,MATH 105,A02,093477,Staff,11,0,35,24
1656161047918,MATH 109,A01,083213,Ganzberger; Geoffrey Michael,0,0,34,34
1656161047918,MATH 109,A02,083214,Ganzberger; Geoffrey Michael,0,0,34,34
1656161047918,MATH 109,A03,093478,Staff,1,0,34,33
1656161047918,MATH 109,B01,083215,Ganzberger; Geoffrey Michael,4,0,32,28
1656161047918,MATH 109,B02,083216,Ganzberger; Geoffrey Michael,1,0,32,31
1656161047918,MATH 109,B03,093479,Staff,4,0,32,28
1656161053947,MATH 142A,A01,083219,Chow; Bennett,1,0,32,31
1656161053947,MATH 142A,A02,083220,Chow; Bennett,8,0,32,24
1656161053947,MATH 142A,A03,093480,Staff,5,0,32,27
1656161053947,MATH 142A,B03,093481,Staff,4,0,32,28
1656161053947,MATH 142A,B04,093558,Staff,6,0,32,26
1656161053947,MATH 142A,B05,093559,Staff,0,0,32,32
1656161059983,MATH 193A,A01,083224,Rotar; Vladimir,0,1,34,34
1656161059983,MATH 193A,A02,083225,Rotar; Vladimir,0,0,34,34
1656161059983,MATH 193A,A03,083781,Rotar; Vladimir,0,0,34,34
1656161059983,MATH 193A,A04,083782,Rotar; Vladimir,6,0,34,28
1656161059983,MATH 193A,A05,093482,Rotar; Vladimir,1,0,34,33
1656161066019,MATH 197,001,091859,McAuley; Julian John,9999,0,9999,0
1656161066019,MATH 197,002,095566,Kedlaya; Kiran S.,9997,0,9999,2
1656161066019,MATH 197,003,095567,Xiao; Ming,9999,0,9999,0
1656161066019,MATH 197,004,095571,Perols; Johan Lars,9998,0,9999,1
1656161073120,COGS 9,A01,083615,Shannon; Kyle Michael,4,0,75,71
1656161079155,COGS 11,A01,083617,Boyle; Mary E. T.,14,0,48,34
1656161085186,COGS 13,A01,083071,Bastos; Amalia Pinkusfeld,6,0,71,65
1656161091213,COGS 14A,A01,092681,Semenuks; Arturs,4,15,100,96
1656161097246,COGS 14B,A01,083073,Cheng; Tzu-Han,7,0,63,56
1656161103368,COGS 17,A01,092677,Semenuks; Arturs,8,0,81,73
1656161109395,COGS 100,A01,083619,Allen; Michael Gordon,2,0,70,68
1656161115430,COGS 101A,A01,083621,Davis; Joshua Daniel,3,0,68,65
1656161121458,COGS 101B,A01,091572,Allen; Michael Gordon,6,0,65,59
1656161127487,COGS 101C,A01,083625,Delgado; Tania,10,0,35,25
1656161133515,COGS 107A,A01,083627,Boyle; Mary E. T.,0,0,60,60
1656161139541,COGS 118A,A01,083075,Gupta; Anjum,7,0,76,69
1656161145570,CSE 3,A50,083646,Miranda; Gregory Joseph,18,0,50,32
1656161151596,CSE 8A,A50,083650,Miranda; Gregory Joseph,3,3,56,53
1656161157622,CSE 11,A01,083080,Cao; Yingjun,1,54,40,39
1656161163646,CSE 12,A01,083652,Krause-Levy; Sophia Louisa,7,2,120,113
1656161169673,CSE 15L,A01,083654,Morris; Justin Loren,2,0,50,48
1656161169673,CSE 15L,A02,083655,Morris; Justin Loren,4,0,50,46
1656161175699,CSE 20,A01,083657,Tran; Khoa Dang,31,0,80,49
1656161181732,CSE 21,A01,095574,Bach; Quang Tran,25,0,48,23
1656161187760,CSE 30,A01,083084,Eldon; John,2,8,80,78
1656161187760,CSE 30,B01,095061,Bhaskar; Nishant,1,2,50,49
1656161193793,CSE 100,A01,083659,Cao; Yingjun,2,20,70,68
1656161199819,CSE 134B,A01,083661,Powell; Thomas Allan,3,0,100,97
1656161205844,CSE 140,A01,083663,Gungor; Onat,9,0,85,76
1656161211872,CSE 140L,A01,083088,Eldon; John,8,0,100,92
1656161217911,CSE 175,A01,083665,Kumar; Rakesh,0,0,25,25
1656161223935,CSE 190,A00,092507,Dubnov; Shlomo,3,0,20,17
1656161229962,ECE 45,A01,083139,Congero; Spencer William,1,0,75,74
1656161235990,ECE 65,A50,083695,Saad; Andrew S,9,0,30,21
1656161235990,ECE 65,A51,095125,Staff,23,0,26,3
1656161242016,ECE 109,A01,091882,Touri; Behrouz,0,1,70,70
1656161248042,ECE 180,A00,083140,Abi Samra; Nicholas Camill,1,0,30,29
1656161248042,ECE 180,B00,083141,Abi Samra; Nicholas Camill,0,4,30,30
1656161254079,MATH 10A,A01,083735,Patchell; Gregory David,0,0,30,30
1656161254079,MATH 10A,A02,083736,Patchell; Gregory David,22,0,30,8
1656161254079,MATH 10A,A03,083737,Patchell; Gregory David,16,0,30,14
1656161260107,MATH 10B,A01,083207,Lim; Seonhee,0,0,34,34
1656161260107,MATH 10B,A02,083208,Lim; Seonhee,7,0,35,28
1656161260107,MATH 10B,A03,093472,Staff,1,0,34,33
1656161260107,MATH 10B,B01,083739,Sinha; Shubham,10,0,30,20
1656161266137,MATH 18,A01,083743,Cinel; Cameron Alexander,7,0,30,23
1656161266137,MATH 18,A02,083744,Cinel; Cameron Alexander,10,0,30,20
1656161266137,MATH 18,A03,083745,Cinel; Cameron Alexander,4,0,30,26
1656161266137,MATH 18,B01,083748,Rideout; David Porter,0,0,36,36
1656161266137,MATH 18,B02,083749,Rideout; David Porter,0,0,36,36
1656161266137,MATH 18,B03,083750,Rideout; David Porter,0,0,36,36
1656161266137,MATH 18,B04,083751,Rideout; David Porter,0,0,36,36
1656161266137,MATH 18,B05,093473,Rideout; David Porter,1,0,36,35
1656161266137,MATH 18,B06,093474,Rideout; David Porter,3,0,36,33
1656161272163,MATH 20A,A01,083754,Zheng; Zequn,11,0,40,29
1656161278196,MATH 20B,A01,083756,Briones; Jor-el Thomas Caparas,0,0,36,36
1656161278196,MATH 20B,A02,083757,Briones; Jor-el Thomas Caparas,0,0,36,36
1656161278196,MATH 20B,A03,093475,Staff,2,0,36,34
1656161284231,MATH 20C,A01,083760,Briones; Jor-el Thomas Caparas,0,0,35,35
1656161284231,MATH 20C,A02,083761,Briones; Jor-el Thomas Caparas,9,1,35,26
1656161284231,MATH 20C,A03,093476,Staff,0,0,35,35
1656161284231,MATH 20C,B01,083762,Bach; Quang Tran,1,0,30,29
1656161290266,MATH 20D,A01,083765,Tran; Brian Kha,2,0,30,28
1656161290266,MATH 20D,A02,083766,Tran; Brian Kha,0,1,30,30
1656161290266,MATH 20D,A03,083767,Tran; Brian Kha,2,0,30,28
1656161296304,MATH 20E,A01,083771,Ganguly; Soumya,4,0,32,28
1656161296304,MATH 20E,A02,083772,Ganguly; Soumya,0,0,32,32
1656161296304,MATH 20E,B01,083773,Ciotti; Benjamin,15,0,35,20
1656161296304,MATH 20E,B02,083774,Ciotti; Benjamin,15,0,35,20
1656161302334,MATH 103A,A01,083777,Greenfeld; Be'Eri,1,0,36,35
1656161302334,MATH 103A,A02,083778,Greenfeld; Be'Eri,1,0,36,35
1656161302334,MATH 103A,A03,093561,Staff,4,0,36,32
1656161302334,MATH 103A,B01,083779,Greenfeld; Be'Eri,8,1,36,28
1656161302334,MATH 103A,B02,083780,Greenfeld; Be'Eri,1,0,36,35
1656161302334,MATH 103A,B03,093562,Staff,0,0,36,36
1656161308357,MATH 105,A01,085443,Carter; Anne Toulson,5,1,35,30
1656161308357,MATH 105,A02,093477,Staff,11,0,35,24
1656161314389,MATH 109,A01,083213,Ganzberger; Geoffrey Michael,0,0,34,34
1656161314389,MATH 109,A02,083214,Ganzberger; Geoffrey Michael,0,0,34,34
1656161314389,MATH 109,A03,093478,Staff,1,0,34,33
1656161314389,MATH 109,B01,083215,Ganzberger; Geoffrey Michael,4,0,32,28
1656161314389,MATH 109,B02,083216,Ganzberger; Geoffrey Michael,1,0,32,31
1656161314389,MATH 109,B03,093479,Staff,4,0,32,28
1656161320417,MATH 142A,A01,083219,Chow; Bennett,1,0,32,31
1656161320417,MATH 142A,A02,083220,Chow; Bennett,8,0,32,24
1656161320417,MATH 142A,A03,093480,Staff,5,0,32,27
1656161320417,MATH 142A,B03,093481,Staff,4,0,32,28
1656161320417,MATH 142A,B04,093558,Staff,6,0,32,26
1656161320417,MATH 142A,B05,093559,Staff,0,0,32,32
1656161326449,MATH 193A,A01,083224,Rotar; Vladimir,0,1,34,34
1656161326449,MATH 193A,A02,083225,Rotar; Vladimir,0,0,34,34
1656161326449,MATH 193A,A03,083781,Rotar; Vladimir,0,0,34,34
1656161326449,MATH 193A,A04,083782,Rotar; Vladimir,6,0,34,28
1656161326449,MATH 193A,A05,093482,Rotar; Vladimir,1,0,34,33
1656161332474,MATH 197,001,091859,McAuley; Julian John,9999,0,9999,0
1656161332474,MATH 197,002,095566,Kedlaya; Kiran S.,9997,0,9999,2
1656161332474,MATH 197,003,095567,Xiao; Ming,9999,0,9999,0
1656161332474,MATH 197,004,095571,Perols; Johan Lars,9998,0,9999,1
1656161339561,COGS 9,A01,083615,Shannon; Kyle Michael,4,0,75,71
1656161345594,COGS 11,A01,083617,Boyle; Mary E. T.,14,0,48,34
1656161351630,COGS 13,A01,083071,Bastos; Amalia Pinkusfeld,6,0,71,65
1656161357663,COGS 14A,A01,092681,Semenuks; Arturs,4,15,100,96
1656161363690,COGS 14B,A01,083073,Cheng; Tzu-Han,7,0,63,56
1656161369716,COGS 17,A01,092677,Semenuks; Arturs,8,0,81,73
1656161375747,COGS 100,A01,083619,Allen; Michael Gordon,2,0,70,68
1656161381779,COGS 101A,A01,083621,Davis; Joshua Daniel,3,0,68,65
1656161387806,COGS 101B,A01,091572,Allen; Michael Gordon,6,0,65,59
1656161393832,COGS 101C,A01,083625,Delgado; Tania,10,0,35,25
1656161399860,COGS 107A,A01,083627,Boyle; Mary E. T.,0,0,60,60
1656161405886,COGS 118A,A01,083075,Gupta; Anjum,7,0,76,69
1656161411919,CSE 3,A50,083646,Miranda; Gregory Joseph,18,0,50,32
1656161417945,CSE 8A,A50,083650,Miranda; Gregory Joseph,3,3,56,53
1656161423971,CSE 11,A01,083080,Cao; Yingjun,1,54,40,39
1656161430004,CSE 12,A01,083652,Krause-Levy; Sophia Louisa,7,2,120,113
1656161436031,CSE 15L,A01,083654,Morris; Justin Loren,2,0,50,48
1656161436031,CSE 15L,A02,083655,Morris; Justin Loren,4,0,50,46
1656161442057,CSE 20,A01,083657,Tran; Khoa Dang,31,0,80,49
1656161448082,CSE 21,A01,095574,Bach; Quang Tran,25,0,48,23
1656161454118,CSE 30,A01,083084,Eldon; John,2,8,80,78
1656161454118,CSE 30,B01,095061,Bhaskar; Nishant,1,2,50,49
1656161460150,CSE 100,A01,083659,Cao; Yingjun,2,20,70,68
1656161466177,CSE 134B,A01,083661,Powell; Thomas Allan,3,0,100,97
1656161472208,CSE 140,A01,083663,Gungor; Onat,9,0,85,76
1656161478234,CSE 140L,A01,083088,Eldon; John,8,0,100,92
1656161484262,CSE 175,A01,083665,Kumar; Rakesh,0,0,25,25
1656161490288,CSE 190,A00,092507,Dubnov; Shlomo,3,0,20,17
1656161496325,ECE 45,A01,083139,Congero; Spencer William,1,0,75,74
1656161502353,ECE 65,A50,083695,Saad; Andrew S,9,0,30,21
1656161502353,ECE 65,A51,095125,Staff,23,0,26,3
1656161508383,ECE 109,A01,091882,Touri; Behrouz,0,1,70,70
1656161514416,ECE 180,A00,083140,Abi Samra; Nicholas Camill,1,0,30,29
1656161514416,ECE 180,B00,083141,Abi Samra; Nicholas Camill,0,4,30,30
1656161520445,MATH 10A,A01,083735,Patchell; Gregory David,0,0,30,30
1656161520445,MATH 10A,A02,083736,Patchell; Gregory David,22,0,30,8
1656161520445,MATH 10A,A03,083737,Patchell; Gregory David,16,0,30,14
1656161526476,MATH 10B,A01,083207,Lim; Seonhee,0,0,34,34
1656161526476,MATH 10B,A02,083208,Lim; Seonhee,7,0,35,28
1656161526476,MATH 10B,A03,093472,Staff,1,0,34,33
1656161526476,MATH 10B,B01,083739,Sinha; Shubham,10,0,30,20
1656161532504,MATH 18,A01,083743,Cinel; Cameron Alexander,7,0,30,23
1656161532504,MATH 18,A02,083744,Cinel; Cameron Alexander,10,0,30,20
1656161532504,MATH 18,A03,083745,Cinel; Cameron Alexander,4,0,30,26
1656161532504,MATH 18,B01,083748,Rideout; David Porter,0,0,36,36
1656161532504,MATH 18,B02,083749,Rideout; David Porter,0,0,36,36
1656161532504,MATH 18,B03,083750,Rideout; David Porter,0,0,36,36
1656161532504,MATH 18,B04,083751,Rideout; David Porter,0,0,36,36
1656161532504,MATH 18,B05,093473,Rideout; David Porter,1,0,36,35
1656161532504,MATH 18,B06,093474,Rideout; David Porter,3,0,36,33
1656161538538,MATH 20A,A01,083754,Zheng; Zequn,11,0,40,29
1656161544565,MATH 20B,A01,083756,Briones; Jor-el Thomas Caparas,0,0,36,36
1656161544565,MATH 20B,A02,083757,Briones; Jor-el Thomas Caparas,0,0,36,36
1656161544565,MATH 20B,A03,093475,Staff,2,0,36,34
1656161550599,MATH 20C,A01,083760,Briones; Jor-el Thomas Caparas,0,0,35,35
1656161550599,MATH 20C,A02,083761,Briones; Jor-el Thomas Caparas,9,1,35,26
1656161550599,MATH 20C,A03,093476,Staff,0,0,35,35
1656161550599,MATH 20C,B01,083762,Bach; Quang Tran,1,0,30,29
1656161556624,MATH 20D,A01,083765,Tran; Brian Kha,2,0,30,28
1656161556624,MATH 20D,A02,083766,Tran; Brian Kha,0,1,30,30
1656161556624,MATH 20D,A03,083767,Tran; Brian Kha,2,0,30,28
1656161562654,MATH 20E,A01,083771,Ganguly; Soumya,4,0,32,28
1656161562654,MATH 20E,A02,083772,Ganguly; Soumya,0,0,32,32
1656161562654,MATH 20E,B01,083773,Ciotti; Benjamin,15,0,35,20
1656161562654,MATH 20E,B02,083774,Ciotti; Benjamin,15,0,35,20
1656161568681,MATH 103A,A01,083777,Greenfeld; Be'Eri,1,0,36,35
1656161568681,MATH 103A,A02,083778,Greenfeld; Be'Eri,1,0,36,35
1656161568681,MATH 103A,A03,093561,Staff,4,0,36,32
1656161568681,MATH 103A,B01,083779,Greenfeld; Be'Eri,8,1,36,28
1656161568681,MATH 103A,B02,083780,Greenfeld; Be'Eri,1,0,36,35
1656161568681,MATH 103A,B03,093562,Staff,0,0,36,36
1656161574713,MATH 105,A01,085443,Carter; Anne Toulson,5,1,35,30
1656161574713,MATH 105,A02,093477,Staff,11,0,35,24
1656161580748,MATH 109,A01,083213,Ganzberger; Geoffrey Michael,0,0,34,34
1656161580748,MATH 109,A02,083214,Ganzberger; Geoffrey Michael,0,0,34,34
1656161580748,MATH 109,A03,093478,Staff,1,0,34,33
1656161580748,MATH 109,B01,083215,Ganzberger; Geoffrey Michael,4,0,32,28
1656161580748,MATH 109,B02,083216,Ganzberger; Geoffrey Michael,1,0,32,31
1656161580748,MATH 109,B03,093479,Staff,4,0,32,28
1656161586777,MATH 142A,A01,083219,Chow; Bennett,1,0,32,31
1656161586777,MATH 142A,A02,083220,Chow; Bennett,8,0,32,24
1656161586777,MATH 142A,A03,093480,Staff,5,0,32,27
1656161586777,MATH 142A,B03,093481,Staff,4,0,32,28
1656161586777,MATH 142A,B04,093558,Staff,6,0,32,26
1656161586777,MATH 142A,B05,093559,Staff,0,0,32,32
1656161592804,MATH 193A,A01,083224,Rotar; Vladimir,0,1,34,34
1656161592804,MATH 193A,A02,083225,Rotar; Vladimir,0,0,34,34
1656161592804,MATH 193A,A03,083781,Rotar; Vladimir,0,0,34,34
1656161592804,MATH 193A,A04,083782,Rotar; Vladimir,6,0,34,28
1656161592804,MATH 193A,A05,093482,Rotar; Vladimir,1,0,34,33
1656161598835,MATH 197,001,091859,McAuley; Julian John,9999,0,9999,0
1656161598835,MATH 197,002,095566,Kedlaya; Kiran S.,9997,0,9999,2
1656161598835,MATH 197,003,095567,Xiao; Ming,9999,0,9999,0
1656161598835,MATH 197,004,095571,Perols; Johan Lars,9998,0,9999,1
1656161605908,COGS 9,A01,083615,Shannon; Kyle Michael,4,0,75,71
1656161611934,COGS 11,A01,083617,Boyle; Mary E. T.,14,0,48,34
1656161617961,COGS 13,A01,083071,Bastos; Amalia Pinkusfeld,6,0,71,65
1656161623987,COGS 14A,A01,092681,Semenuks; Arturs,4,15,100,96
1656161630015,COGS 14B,A01,083073,Cheng; Tzu-Han,7,0,63,56
1656161636040,COGS 17,A01,092677,Semenuks; Arturs,8,0,81,73
1656161642065,COGS 100,A01,083619,Allen; Michael Gordon,2,0,70,68
1656161648095,COGS 101A,A01,083621,Davis; Joshua Daniel,3,0,68,65
1656161654122,COGS 101B,A01,091572,Allen; Michael Gordon,6,0,65,59
1656161660161,COGS 101C,A01,083625,Delgado; Tania,10,0,35,25
1656161666190,COGS 107A,A01,083627,Boyle; Mary E. T.,0,0,60,60
1656161672223,COGS 118A,A01,083075,Gupta; Anjum,7,0,76,69
1656161678250,CSE 3,A50,083646,Miranda; Gregory Joseph,18,0,50,32
1656161684276,CSE 8A,A50,083650,Miranda; Gregory Joseph,3,3,56,53
1656161690306,CSE 11,A01,083080,Cao; Yingjun,1,54,40,39
1656161696340,CSE 12,A01,083652,Krause-Levy; Sophia Louisa,7,2,120,113
1656161702467,CSE 15L,A01,083654,Morris; Justin Loren,2,0,50,48
1656161702467,CSE 15L,A02,083655,Morris; Justin Loren,4,0,50,46
1656161708493,CSE 20,A01,083657,Tran; Khoa Dang,31,0,80,49
1656161714520,CSE 21,A01,095574,Bach; Quang Tran,25,0,48,23
1656161720567,CSE 30,A01,083084,Eldon; John,2,8,80,78
1656161720567,CSE 30,B01,095061,Bhaskar; Nishant,1,2,50,49
1656161726599,CSE 100,A01,083659,Cao; Yingjun,2,20,70,68
1656161732622,CSE 134B,A01,083661,Powell; Thomas Allan,3,0,100,97
1656161738655,CSE 140,A01,083663,Gungor; Onat,9,0,85,76
1656161744684,CSE 140L,A01,083088,Eldon; John,8,0,100,92
1656161750711,CSE 175,A01,083665,Kumar; Rakesh,0,0,25,25
1656161756737,CSE 190,A00,092507,Dubnov; Shlomo,3,0,20,17
1656161762763,ECE 45,A01,083139,Congero; Spencer William,1,0,75,74
1656161768793,ECE 65,A50,083695,Saad; Andrew S,9,0,30,21
1656161768793,ECE 65,A51,095125,Staff,23,0,26,3
1656161774818,ECE 109,A01,091882,Touri; Behrouz,0,1,70,70
1656161780850,ECE 180,A00,083140,Abi Samra; Nicholas Camill,1,0,30,29
1656161780850,ECE 180,B00,083141,Abi Samra; Nicholas Camill,0,4,30,30
1656161786889,MATH 10A,A01,083735,Patchell; Gregory David,0,0,30,30
1656161786889,MATH 10A,A02,083736,Patchell; Gregory David,22,0,30,8
1656161786889,MATH 10A,A03,083737,Patchell; Gregory David,16,0,30,14
1656161792918,MATH 10B,A01,083207,Lim; Seonhee,0,0,34,34
1656161792918,MATH 10B,A02,083208,Lim; Seonhee,7,0,35,28
1656161792918,MATH 10B,A03,093472,Staff,1,0,34,33
1656161792918,MATH 10B,B01,083739,Sinha; Shubham,10,0,30,20
1656161798957,MATH 18,A01,083743,Cinel; Cameron Alexander,7,0,30,23
1656161798957,MATH 18,A02,083744,Cinel; Cameron Alexander,10,0,30,20
1656161798957,MATH 18,A03,083745,Cinel; Cameron Alexander,4,0,30,26
1656161798957,MATH 18,B01,083748,Rideout; David Porter,0,0,36,36
1656161798957,MATH 18,B02,083749,Rideout; David Porter,0,0,36,36
1656161798957,MATH 18,B03,083750,Rideout; David Porter,0,0,36,36
1656161798957,MATH 18,B04,083751,Rideout; David Porter,0,0,36,36
1656161798957,MATH 18,B05,093473,Rideout; David Porter,1,0,36,35
1656161798957,MATH 18,B06,093474,Rideout; David Porter,3,0,36,33
1656161804982,MATH 20A,A01,083754,Zheng; Zequn,11,0,40,29
1656161811010,MATH 20B,A01,083756,Briones; Jor-el Thomas Caparas,0,0,36,36
1656161811010,MATH 20B,A02,083757,Briones; Jor-el Thomas Caparas,0,0,36,36
1656161811010,MATH 20B,A03,093475,Staff,2,0,36,34
1656161817037,MATH 20C,A01,083760,Briones; Jor-el Thomas Caparas,0,0,35,35
1656161817037,MATH 20C,A02,083761,Briones; Jor-el Thomas Caparas,9,1,35,26
1656161817037,MATH 20C,A03,093476,Staff,0,0,35,35
1656161817037,MATH 20C,B01,083762,Bach; Quang Tran,1,0,30,29
1656161823071,MATH 20D,A01,083765,Tran; Brian Kha,2,0,30,28
1656161823071,MATH 20D,A02,083766,Tran; Brian Kha,0,1,30,30
1656161823071,MATH 20D,A03,083767,Tran; Brian Kha,2,0,30,28
1656161829106,MATH 20E,A01,083771,Ganguly; Soumya,4,0,32,28
1656161829106,MATH 20E,A02,083772,Ganguly; Soumya,0,0,32,32
1656161829106,MATH 20E,B01,083773,Ciotti; Benjamin,15,0,35,20
1656161829106,MATH 20E,B02,083774,Ciotti; Benjamin,15,0,35,20
1656161835141,MATH 103A,A01,083777,Greenfeld; Be'Eri,1,0,36,35
1656161835141,MATH 103A,A02,083778,Greenfeld; Be'Eri,1,0,36,35
1656161835141,MATH 103A,A03,093561,Staff,4,0,36,32
1656161835141,MATH 103A,B01,083779,Greenfeld; Be'Eri,8,1,36,28
1656161835141,MATH 103A,B02,083780,Greenfeld; Be'Eri,1,0,36,35
1656161835141,MATH 103A,B03,093562,Staff,0,0,36,36
1656161841167,MATH 105,A01,085443,Carter; Anne Toulson,5,1,35,30
1656161841167,MATH 105,A02,093477,Staff,11,0,35,24
1656161847201,MATH 109,A01,083213,Ganzberger; Geoffrey Michael,0,0,34,34
1656161847201,MATH 109,A02,083214,Ganzberger; Geoffrey Michael,0,0,34,34
1656161847201,MATH 109,A03,093478,Staff,1,0,34,33
1656161847201,MATH 109,B01,083215,Ganzberger; Geoffrey Michael,4,0,32,28
1656161847201,MATH 109,B02,083216,Ganzberger; Geoffrey Michael,1,0,32,31
1656161847201,MATH 109,B03,093479,Staff,4,0,32,28
1656161853230,MATH 142A,A01,083219,Chow; Bennett,1,0,32,31
1656161853230,MATH 142A,A02,083220,Chow; Bennett,8,0,32,24
1656161853230,MATH 142A,A03,093480,Staff,5,0,32,27
1656161853230,MATH 142A,B03,093481,Staff,4,0,32,28
1656161853230,MATH 142A,B04,093558,Staff,6,0,32,26
1656161853230,MATH 142A,B05,093559,Staff,0,0,32,32
1656161859257,MATH 193A,A01,083224,Rotar; Vladimir,0,1,34,34
1656161859257,MATH 193A,A02,083225,Rotar; Vladimir,0,0,34,34
1656161859257,MATH 193A,A03,083781,Rotar; Vladimir,0,0,34,34
1656161859257,MATH 193A,A04,083782,Rotar; Vladimir,6,0,34,28
1656161859257,MATH 193A,A05,093482,Rotar; Vladimir,1,0,34,33
1656161865283,MATH 197,001,091859,McAuley; Julian John,9999,0,9999,0
1656161865283,MATH 197,002,095566,Kedlaya; Kiran S.,9997,0,9999,2
1656161865283,MATH 197,003,095567,Xiao; Ming,9999,0,9999,0
1656161865283,MATH 197,004,095571,Perols; Johan Lars,9998,0,9999,1
1656161872352,COGS 9,A01,083615,Shannon; Kyle Michael,4,0,75,71
1656161878379,COGS 11,A01,083617,Boyle; Mary E. T.,14,0,48,34
1656161884405,COGS 13,A01,083071,Bastos; Amalia Pinkusfeld,6,0,71,65
1656161890435,COGS 14A,A01,092681,Semenuks; Arturs,4,15,100,96
1656161896465,COGS 14B,A01,083073,Cheng; Tzu-Han,7,0,63,56
1656161902495,COGS 17,A01,092677,Semenuks; Arturs,8,0,81,73
1656161908525,COGS 100,A01,083619,Allen; Michael Gordon,2,0,70,68
1656161914555,COGS 101A,A01,083621,Davis; Joshua Daniel,3,0,68,65
1656161920581,COGS 101B,A01,091572,Allen; Michael Gordon,6,0,65,59
1656161926612,COGS 101C,A01,083625,Delgado; Tania,10,0,35,25
1656161932641,COGS 107A,A01,083627,Boyle; Mary E. T.,0,0,60,60
1656161938664,COGS 118A,A01,083075,Gupta; Anjum,7,0,76,69
1656161944691,CSE 3,A50,083646,Miranda; Gregory Joseph,18,0,50,32
1656161950722,CSE 8A,A50,083650,Miranda; Gregory Joseph,3,3,56,53
1656161956747,CSE 11,A01,083080,Cao; Yingjun,1,54,40,39
1656161962776,CSE 12,A01,083652,Krause-Levy; Sophia Louisa,7,2,120,113
1656161968802,CSE 15L,A01,083654,Morris; Justin Loren,2,0,50,48
1656161968802,CSE 15L,A02,083655,Morris; Justin Loren,4,0,50,46
1656161974829,CSE 20,A01,083657,Tran; Khoa Dang,31,0,80,49
1656161980854,CSE 21,A01,095574,Bach; Quang Tran,25,0,48,23
1656161986881,CSE 30,A01,083084,Eldon; John,2,8,80,78
1656161986881,CSE 30,B01,095061,Bhaskar; Nishant,1,2,50,49
1656161992905,CSE 100,A01,083659,Cao; Yingjun,2,20,70,68
1656161998930,CSE 134B,A01,083661,Powell; Thomas Allan,3,0,100,97
1656162004966,CSE 140,A01,083663,Gungor; Onat,9,0,85,76
1656162010992,CSE 140L,A01,083088,Eldon; John,8,0,100,92
1656162017024,CSE 175,A01,083665,Kumar; Rakesh,0,0,25,25
1656162023047,CSE 190,A00,092507,Dubnov; Shlomo,3,0,20,17
1656162029082,ECE 45,A01,083139,Congero; Spencer William,1,0,75,74
1656162035109,ECE 65,A50,083695,Saad; Andrew S,9,0,30,21
1656162035109,ECE 65,A51,095125,Staff,23,0,26,3
1656162041135,ECE 109,A01,091882,Touri; Behrouz,0,1,70,70
1656162047161,ECE 180,A00,083140,Abi Samra; Nicholas Camill,1,0,30,29
1656162047161,ECE 180,B00,083141,Abi Samra; Nicholas Camill,0,4,30,30
1656162053189,MATH 10A,A01,083735,Patchell; Gregory David,0,0,30,30
1656162053189,MATH 10A,A02,083736,Patchell; Gregory David,22,0,30,8
1656162053189,MATH 10A,A03,083737,Patchell; Gregory David,16,0,30,14
1656162059219,MATH 10B,A01,083207,Lim; Seonhee,0,0,34,34
1656162059219,MATH 10B,A02,083208,Lim; Seonhee,7,0,35,28
1656162059219,MATH 10B,A03,093472,Staff,1,0,34,33
1656162059219,MATH 10B,B01,083739,Sinha; Shubham,10,0,30,20
1656162065249,MATH 18,A01,083743,Cinel; Cameron Alexander,7,0,30,23
1656162065249,MATH 18,A02,083744,Cinel; Cameron Alexander,10,0,30,20
1656162065249,MATH 18,A03,083745,Cinel; Cameron Alexander,4,0,30,26
1656162065249,MATH 18,B01,083748,Rideout; David Porter,0,0,36,36
1656162065249,MATH 18,B02,083749,Rideout; David Porter,0,0,36,36
1656162065249,MATH 18,B03,083750,Rideout; David Porter,0,0,36,36
1656162065249,MATH 18,B04,083751,Rideout; David Porter,0,0,36,36
1656162065249,MATH 18,B05,093473,Rideout; David Porter,1,0,36,35
1656162065249,MATH 18,B06,093474,Rideout; David Porter,3,0,36,33
1656162071275,MATH 20A,A01,083754,Zheng; Zequn,11,0,40,29
1656162077310,MATH 20B,A01,083756,Briones; Jor-el Thomas Caparas,0,0,36,36
1656162077310,MATH 20B,A02,083757,Briones; Jor-el Thomas Caparas,0,0,36,36
1656162077310,MATH 20B,A03,093475,Staff,2,0,36,34
1656162083337,MATH 20C,A01,083760,Briones; Jor-el Thomas Caparas,0,0,35,35
1656162083337,MATH 20C,A02,083761,Briones; Jor-el Thomas Caparas,9,1,35,26
1656162083337,MATH 20C,A03,093476,Staff,0,0,35,35
1656162083337,MATH 20C,B01,083762,Bach; Quang Tran,1,0,30,29
1656162089366,MATH 20D,A01,083765,Tran; Brian Kha,2,0,30,28
1656162089366,MATH 20D,A02,083766,Tran; Brian Kha,0,1,30,30
1656162089366,MATH 20D,A03,083767,Tran; Brian Kha,2,0,30,28
1656162095393,MATH 20E,A01,083771,Ganguly; Soumya,4,0,32,28
1656162095393,MATH 20E,A02,083772,Ganguly; Soumya,0,0,32,32
1656162095393,MATH 20E,B01,083773,Ciotti; Benjamin,15,0,35,20
1656162095393,MATH 20E,B02,083774,Ciotti; Benjamin,15,0,35,20
1656162101428,MATH 103A,A01,083777,Greenfeld; Be'Eri,1,0,36,35
1656162101428,MATH 103A,A02,083778,Greenfeld; Be'Eri,1,0,36,35
1656162101428,MATH 103A,A03,093561,Staff,4,0,36,32
1656162101428,MATH 103A,B01,083779,Greenfeld; Be'Eri,8,1,36,28
1656162101428,MATH 103A,B02,083780,Greenfeld; Be'Eri,1,0,36,35
1656162101428,MATH 103A,B03,093562,Staff,0,0,36,36
1656162107460,MATH 105,A01,085443,Carter; Anne Toulson,5,1,35,30
1656162107460,MATH 105,A02,093477,Staff,11,0,35,24
1656162113491,MATH 109,A01,083213,Ganzberger; Geoffrey Michael,0,0,34,34
1656162113491,MATH 109,A02,083214,Ganzberger; Geoffrey Michael,0,0,34,34
1656162113491,MATH 109,A03,093478,Staff,1,0,34,33
1656162113491,MATH 109,B01,083215,Ganzberger; Geoffrey Michael,4,0,32,28
1656162113491,MATH 109,B02,083216,Ganzberger; Geoffrey Michael,1,0,32,31
1656162113491,MATH 109,B03,093479,Staff,4,0,32,28
1656162119526,MATH 142A,A01,083219,Chow; Bennett,1,0,32,31
1656162119526,MATH 142A,A02,083220,Chow; Bennett,8,0,32,24
1656162119526,MATH 142A,A03,093480,Staff,5,0,32,27
1656162119526,MATH 142A,B03,093481,Staff,4,0,32,28
1656162119526,MATH 142A,B04,093558,Staff,6,0,32,26
1656162119526,MATH 142A,B05,093559,Staff,0,0,32,32
1656162125557,MATH 193A,A01,083224,Rotar; Vladimir,0,1,34,34
1656162125557,MATH 193A,A02,083225,Rotar; Vladimir,0,0,34,34
1656162125557,MATH 193A,A03,083781,Rotar; Vladimir,0,0,34,34
1656162125557,MATH 193A,A04,083782,Rotar; Vladimir,6,0,34,28
1656162125557,MATH 193A,A05,093482,Rotar; Vladimir,1,0,34,33
1656162131585,MATH 197,001,091859,McAuley; Julian John,9999,0,9999,0
1656162131585,MATH 197,002,095566,Kedlaya; Kiran S.,9997,0,9999,2
1656162131585,MATH 197,003,095567,Xiao; Ming,9999,0,9999,0
1656162131585,MATH 197,004,095571,Perols; Johan Lars,9998,0,9999,1
1656162138664,COGS 9,A01,083615,Shannon; Kyle Michael,4,0,75,71
1656162144698,COGS 11,A01,083617,Boyle; Mary E. T.,14,0,48,34
1656162150728,COGS 13,A01,083071,Bastos; Amalia Pinkusfeld,6,0,71,65
1656162156759,COGS 14A,A01,092681,Semenuks; Arturs,4,15,100,96
1656162162788,COGS 14B,A01,083073,Cheng; Tzu-Han,7,0,63,56
1656162168814,COGS 17,A01,092677,Semenuks; Arturs,8,0,81,73
1656162174839,COGS 100,A01,083619,Allen; Michael Gordon,2,0,70,68
1656162180865,COGS 101A,A01,083621,Davis; Joshua Daniel,3,0,68,65
1656162186899,COGS 101B,A01,091572,Allen; Michael Gordon,6,0,65,59
1656162192923,COGS 101C,A01,083625,Delgado; Tania,10,0,35,25
1656162198949,COGS 107A,A01,083627,Boyle; Mary E. T.,0,0,60,60
1656162204974,COGS 118A,A01,083075,Gupta; Anjum,7,0,76,69
1656162211000,CSE 3,A50,083646,Miranda; Gregory Joseph,18,0,50,32
1656162217026,CSE 8A,A50,083650,Miranda; Gregory Joseph,3,3,56,53
1656162223052,CSE 11,A01,083080,Cao; Yingjun,1,54,40,39
1656162229083,CSE 12,A01,083652,Krause-Levy; Sophia Louisa,7,2,120,113
1656162235113,CSE 15L,A01,083654,Morris; Justin Loren,2,0,50,48
1656162235113,CSE 15L,A02,083655,Morris; Justin Loren,4,0,50,46
1656162241138,CSE 20,A01,083657,Tran; Khoa Dang,31,0,80,49
1656162247163,CSE 21,A01,095574,Bach; Quang Tran,25,0,48,23
1656162253193,CSE 30,A01,083084,Eldon; John,2,8,80,78
1656162253193,CSE 30,B01,095061,Bhaskar; Nishant,1,2,50,49
1656162259222,CSE 100,A01,083659,Cao; Yingjun,2,20,70,68
1656162265245,CSE 134B,A01,083661,Powell; Thomas Allan,3,0,100,97
1656162271276,CSE 140,A01,083663,Gungor; Onat,9,0,85,76
1656162277305,CSE 140L,A01,083088,Eldon; John,8,0,100,92
1656162283332,CSE 175,A01,083665,Kumar; Rakesh,0,0,25,25
1656162289357,CSE 190,A00,092507,Dubnov; Shlomo,3,0,20,17
1656162295381,ECE 45,A01,083139,Congero; Spencer William,1,0,75,74
1656162301481,ECE 65,A50,083695,Saad; Andrew S,9,0,30,21
1656162301481,ECE 65,A51,095125,Staff,23,0,26,3
1656162307506,ECE 109,A01,091882,Touri; Behrouz,0,1,70,70
1656162313541,ECE 180,A00,083140,Abi Samra; Nicholas Camill,1,0,30,29
1656162313541,ECE 180,B00,083141,Abi Samra; Nicholas Camill,0,4,30,30
1656162319567,MATH 10A,A01,083735,Patchell; Gregory David,0,0,30,30
1656162319567,MATH 10A,A02,083736,Patchell; Gregory David,22,0,30,8
1656162319567,MATH 10A,A03,083737,Patchell; Gregory David,16,0,30,14
1656162325594,MATH 10B,A01,083207,Lim; Seonhee,0,0,34,34
1656162325594,MATH 10B,A02,083208,Lim; Seonhee,7,0,35,28
1656162325594,MATH 10B,A03,093472,Staff,1,0,34,33
1656162325594,MATH 10B,B01,083739,Sinha; Shubham,10,0,30,20
1656162331633,MATH 18,A01,083743,Cinel; Cameron Alexander,7,0,30,23
1656162331633,MATH 18,A02,083744,Cinel; Cameron Alexander,10,0,30,20
1656162331633,MATH 18,A03,083745,Cinel; Cameron Alexander,4,0,30,26
1656162331633,MATH 18,B01,083748,Rideout; David Porter,0,0,36,36
1656162331633,MATH 18,B02,083749,Rideout; David Porter,0,0,36,36
1656162331633,MATH 18,B03,083750,Rideout; David Porter,0,0,36,36
1656162331633,MATH 18,B04,083751,Rideout; David Porter,0,0,36,36
1656162331633,MATH 18,B05,093473,Rideout; David Porter,1,0,36,35
1656162331633,MATH 18,B06,093474,Rideout; David Porter,3,0,36,33
1656162337658,MATH 20A,A01,083754,Zheng; Zequn,11,0,40,29
1656162343689,MATH 20B,A01,083756,Briones; Jor-el Thomas Caparas,0,0,36,36
1656162343689,MATH 20B,A02,083757,Briones; Jor-el Thomas Caparas,0,0,36,36
1656162343689,MATH 20B,A03,093475,Staff,2,0,36,34
1656162349717,MATH 20C,A01,083760,Briones; Jor-el Thomas Caparas,0,0,35,35
1656162349717,MATH 20C,A02,083761,Briones; Jor-el Thomas Caparas,9,1,35,26
1656162349717,MATH 20C,A03,093476,Staff,0,0,35,35
1656162349717,MATH 20C,B01,083762,Bach; Quang Tran,1,0,30,29
1656162355751,MATH 20D,A01,083765,Tran; Brian Kha,2,0,30,28
1656162355751,MATH 20D,A02,083766,Tran; Brian Kha,0,1,30,30
1656162355751,MATH 20D,A03,083767,Tran; Brian Kha,2,0,30,28
1656162361779,MATH 20E,A01,083771,Ganguly; Soumya,4,0,32,28
1656162361779,MATH 20E,A02,083772,Ganguly; Soumya,0,0,32,32
1656162361779,MATH 20E,B01,083773,Ciotti; Benjamin,15,0,35,20
1656162361779,MATH 20E,B02,083774,Ciotti; Benjamin,15,0,35,20
1656162367817,MATH 103A,A01,083777,Greenfeld; Be'Eri,1,0,36,35
1656162367817,MATH 103A,A02,083778,Greenfeld; Be'Eri,1,0,36,35
1656162367817,MATH 103A,A03,093561,Staff,4,0,36,32
1656162367817,MATH 103A,B01,083779,Greenfeld; Be'Eri,8,1,36,28
1656162367817,MATH 103A,B02,083780,Greenfeld; Be'Eri,1,0,36,35
1656162367817,MATH 103A,B03,093562,Staff,0,0,36,36
1656162373843,MATH 105,A01,085443,Carter; Anne Toulson,5,1,35,30
1656162373843,MATH 105,A02,093477,Staff,11,0,35,24
1656162379871,MATH 109,A01,083213,Ganzberger; Geoffrey Michael,0,0,34,34
1656162379871,MATH 109,A02,083214,Ganzberger; Geoffrey Michael,0,0,34,34
1656162379871,MATH 109,A03,093478,Staff,1,0,34,33
1656162379871,MATH 109,B01,083215,Ganzberger; Geoffrey Michael,4,0,32,28
1656162379871,MATH 109,B02,083216,Ganzberger; Geoffrey Michael,1,0,32,31
1656162379871,MATH 109,B03,093479,Staff,4,0,32,28
1656162385898,MATH 142A,A01,083219,Chow; Bennett,1,0,32,31
1656162385898,MATH 142A,A02,083220,Chow; Bennett,8,0,32,24
1656162385898,MATH 142A,A03,093480,Staff,5,0,32,27
1656162385898,MATH 142A,B03,093481,Staff,4,0,32,28
1656162385898,MATH 142A,B04,093558,Staff,6,0,32,26
1656162385898,MATH 142A,B05,093559,Staff,0,0,32,32
1656162391926,MATH 193A,A01,083224,Rotar; Vladimir,0,1,34,34
1656162391926,MATH 193A,A02,083225,Rotar; Vladimir,0,0,34,34
1656162391926,MATH 193A,A03,083781,Rotar; Vladimir,0,0,34,34
1656162391926,MATH 193A,A04,083782,Rotar; Vladimir,6,0,34,28
1656162391926,MATH 193A,A05,093482,Rotar; Vladimir,1,0,34,33
1656162397952,MATH 197,001,091859,McAuley; Julian John,9999,0,9999,0
1656162397952,MATH 197,002,095566,Kedlaya; Kiran S.,9997,0,9999,2
1656162397952,MATH 197,003,095567,Xiao; Ming,9999,0,9999,0
1656162397952,MATH 197,004,095571,Perols; Johan Lars,9998,0,9999,1
1656162405021,COGS 9,A01,083615,Shannon; Kyle Michael,4,0,75,71
1656162411047,COGS 11,A01,083617,Boyle; Mary E. T.,14,0,48,34
1656162417073,COGS 13,A01,083071,Bastos; Amalia Pinkusfeld,6,0,71,65
1656162423099,COGS 14A,A01,092681,Semenuks; Arturs,4,15,100,96
1656162429124,COGS 14B,A01,083073,Cheng; Tzu-Han,7,0,63,56
1656162435149,COGS 17,A01,092677,Semenuks; Arturs,8,0,81,73
1656162441180,COGS 100,A01,083619,Allen; Michael Gordon,2,0,70,68
1656162447205,COGS 101A,A01,083621,Davis; Joshua Daniel,3,0,68,65
1656162453236,COGS 101B,A01,091572,Allen; Michael Gordon,6,0,65,59
1656162459266,COGS 101C,A01,083625,Delgado; Tania,10,0,35,25
1656162465293,COGS 107A,A01,083627,Boyle; Mary E. T.,0,0,60,60
1656162471323,COGS 118A,A01,083075,Gupta; Anjum,7,0,76,69
1656162477352,CSE 3,A50,083646,Miranda; Gregory Joseph,18,0,50,32
1656162483383,CSE 8A,A50,083650,Miranda; Gregory Joseph,3,3,56,53
1656162489421,CSE 11,A01,083080,Cao; Yingjun,1,54,40,39
1656162495452,CSE 12,A01,083652,Krause-Levy; Sophia Louisa,7,2,120,113
1656162501478,CSE 15L,A01,083654,Morris; Justin Loren,2,0,50,48
1656162501478,CSE 15L,A02,083655,Morris; Justin Loren,4,0,50,46
1656162507509,CSE 20,A01,083657,Tran; Khoa Dang,31,0,80,49
1656162513535,CSE 21,A01,095574,Bach; Quang Tran,25,0,48,23
1656162519562,CSE 30,A01,083084,Eldon; John,2,8,80,78
1656162519562,CSE 30,B01,095061,Bhaskar; Nishant,1,2,50,49
1656162525595,CSE 100,A01,083659,Cao; Yingjun,2,20,70,68
1656162531622,CSE 134B,A01,083661,Powell; Thomas Allan,3,0,100,97
1656162537652,CSE 140,A01,083663,Gungor; Onat,9,0,85,76
1656162543678,CSE 140L,A01,083088,Eldon; John,8,0,100,92
1656162549705,CSE 175,A01,083665,Kumar; Rakesh,0,0,25,25
1656162555736,CSE 190,A00,092507,Dubnov; Shlomo,3,0,20,17
1656162561770,ECE 45,A01,083139,Congero; Spencer William,1,0,75,74
1656162567798,ECE 65,A50,083695,Saad; Andrew S,9,0,30,21
1656162567798,ECE 65,A51,095125,Staff,23,0,26,3
1656162573825,ECE 109,A01,091882,Touri; Behrouz,0,1,70,70
1656162579851,ECE 180,A00,083140,Abi Samra; Nicholas Camill,1,0,30,29
1656162579851,ECE 180,B00,083141,Abi Samra; Nicholas Camill,0,4,30,30
1656162585880,MATH 10A,A01,083735,Patchell; Gregory David,0,0,30,30
1656162585880,MATH 10A,A02,083736,Patchell; Gregory David,22,0,30,8
1656162585880,MATH 10A,A03,083737,Patchell; Gregory David,16,0,30,14
1656162591917,MATH 10B,A01,083207,Lim; Seonhee,0,0,34,34
1656162591917,MATH 10B,A02,083208,Lim; Seonhee,7,0,35,28
1656162591917,MATH 10B,A03,093472,Staff,1,0,34,33
1656162591917,MATH 10B,B01,083739,Sinha; Shubham,10,0,30,20
1656162597960,MATH 18,A01,083743,Cinel; Cameron Alexander,7,0,30,23
1656162597960,MATH 18,A02,083744,Cinel; Cameron Alexander,10,0,30,20
1656162597960,MATH 18,A03,083745,Cinel; Cameron Alexander,4,0,30,26
1656162597960,MATH 18,B01,083748,Rideout; David Porter,0,0,36,36
1656162597960,MATH 18,B02,083749,Rideout; David Porter,0,0,36,36
1656162597960,MATH 18,B03,083750,Rideout; David Porter,0,0,36,36
1656162597960,MATH 18,B04,083751,Rideout; David Porter,0,0,36,36
1656162597960,MATH 18,B05,093473,Rideout; David Porter,1,0,36,35
1656162597960,MATH 18,B06,093474,Rideout; David Porter,3,0,36,33
1656162603998,MATH 20A,A01,083754,Zheng; Zequn,11,0,40,29
1656162610025,MATH 20B,A01,083756,Briones; Jor-el Thomas Caparas,0,0,36,36
1656162610025,MATH 20B,A02,083757,Briones; Jor-el Thomas Caparas,0,0,36,36
1656162610025,MATH 20B,A03,093475,Staff,2,0,36,34
1656162616052,MATH 20C,A01,083760,Briones; Jor-el Thomas Caparas,0,0,35,35
1656162616052,MATH 20C,A02,083761,Briones; Jor-el Thomas Caparas,9,1,35,26
1656162616052,MATH 20C,A03,093476,Staff,0,0,35,35
1656162616052,MATH 20C,B01,083762,Bach; Quang Tran,1,0,30,29
1656162622083,MATH 20D,A01,083765,Tran; Brian Kha,2,0,30,28
1656162622083,MATH 20D,A02,083766,Tran; Brian Kha,0,1,30,30
1656162622083,MATH 20D,A03,083767,Tran; Brian Kha,2,0,30,28
1656162628110,MATH 20E,A01,083771,Ganguly; Soumya,4,0,32,28
1656162628110,MATH 20E,A02,083772,Ganguly; Soumya,0,0,32,32
1656162628110,MATH 20E,B01,083773,Ciotti; Benjamin,15,0,35,20
1656162628110,MATH 20E,B02,083774,Ciotti; Benjamin,15,0,35,20
1656162634147,MATH 103A,A01,083777,Greenfeld; Be'Eri,1,0,36,35
1656162634147,MATH 103A,A02,083778,Greenfeld; Be'Eri,1,0,36,35
1656162634147,MATH 103A,A03,093561,Staff,4,0,36,32
1656162634147,MATH 103A,B01,083779,Greenfeld; Be'Eri,8,1,36,28
1656162634147,MATH 103A,B02,083780,Greenfeld; Be'Eri,1,0,36,35
1656162634147,MATH 103A,B03,093562,Staff,0,0,36,36
1656162640179,MATH 105,A01,085443,Carter; Anne Toulson,5,1,35,30
1656162640179,MATH 105,A02,093477,Staff,11,0,35,24
1656162646206,MATH 109,A01,083213,Ganzberger; Geoffrey Michael,0,0,34,34
1656162646206,MATH 109,A02,083214,Ganzberger; Geoffrey Michael,0,0,34,34
1656162646206,MATH 109,A03,093478,Staff,1,0,34,33
1656162646206,MATH 109,B01,083215,Ganzberger; Geoffrey Michael,4,0,32,28
1656162646206,MATH 109,B02,083216,Ganzberger; Geoffrey Michael,1,0,32,31
1656162646206,MATH 109,B03,093479,Staff,4,0,32,28
1656162652246,MATH 142A,A01,083219,Chow; Bennett,1,0,32,31
1656162652246,MATH 142A,A02,083220,Chow; Bennett,8,0,32,24
1656162652246,MATH 142A,A03,093480,Staff,5,0,32,27
1656162652246,MATH 142A,B03,093481,Staff,4,0,32,28
1656162652246,MATH 142A,B04,093558,Staff,6,0,32,26
1656162652246,MATH 142A,B05,093559,Staff,0,0,32,32
1656162658273,MATH 193A,A01,083224,Rotar; Vladimir,0,1,34,34
1656162658273,MATH 193A,A02,083225,Rotar; Vladimir,0,0,34,34
1656162658273,MATH 193A,A03,083781,Rotar; Vladimir,0,0,34,34
1656162658273,MATH 193A,A04,083782,Rotar; Vladimir,6,0,34,28
1656162658273,MATH 193A,A05,093482,Rotar; Vladimir,1,0,34,33
1656162664300,MATH 197,001,091859,McAuley; Julian John,9999,0,9999,0
1656162664300,MATH 197,002,095566,Kedlaya; Kiran S.,9997,0,9999,2
1656162664300,MATH 197,003,095567,Xiao; Ming,9999,0,9999,0
1656162664300,MATH 197,004,095571,Perols; Johan Lars,9998,0,9999,1
1656162671371,COGS 9,A01,083615,Shannon; Kyle Michael,4,0,75,71
1656162677400,COGS 11,A01,083617,Boyle; Mary E. T.,14,0,48,34
1656162683426,COGS 13,A01,083071,Bastos; Amalia Pinkusfeld,6,0,71,65
1656162689453,COGS 14A,A01,092681,Semenuks; Arturs,4,15,100,96
1656162695478,COGS 14B,A01,083073,Cheng; Tzu-Han,7,0,63,56
1656162701503,COGS 17,A01,092677,Semenuks; Arturs,8,0,81,73
1656162707529,COGS 100,A01,083619,Allen; Michael Gordon,2,0,70,68
1656162713564,COGS 101A,A01,083621,Davis; Joshua Daniel,3,0,68,65
1656162719590,COGS 101B,A01,091572,Allen; Michael Gordon,6,0,65,59
1656162725618,COGS 101C,A01,083625,Delgado; Tania,10,0,35,25
1656162731643,COGS 107A,A01,083627,Boyle; Mary E. T.,0,0,60,60
1656162737674,COGS 118A,A01,083075,Gupta; Anjum,7,0,76,69
1656162743701,CSE 3,A50,083646,Miranda; Gregory Joseph,18,0,50,32
1656162749728,CSE 8A,A50,083650,Miranda; Gregory Joseph,3,3,56,53
1656162755755,CSE 11,A01,083080,Cao; Yingjun,1,54,40,39
1656162761782,CSE 12,A01,083652,Krause-Levy; Sophia Louisa,7,2,120,113
1656162767808,CSE 15L,A01,083654,Morris; Justin Loren,2,0,50,48
1656162767808,CSE 15L,A02,083655,Morris; Justin Loren,4,0,50,46
1656162773833,CSE 20,A01,083657,Tran; Khoa Dang,31,0,80,49
1656162779859,CSE 21,A01,095574,Bach; Quang Tran,25,0,48,23
1656162785888,CSE 30,A01,083084,Eldon; John,2,8,80,78
1656162785888,CSE 30,B01,095061,Bhaskar; Nishant,1,2,50,49
1656162791914,CSE 100,A01,083659,Cao; Yingjun,2,20,70,68
1656162797940,CSE 134B,A01,083661,Powell; Thomas Allan,3,0,100,97
1656162803965,CSE 140,A01,083663,Gungor; Onat,9,0,85,76
1656162809998,CSE 140L,A01,083088,Eldon; John,8,0,100,92
1656162816031,CSE 175,A01,083665,Kumar; Rakesh,0,0,25,25
1656162822059,CSE 190,A00,092507,Dubnov; Shlomo,3,0,20,17
1656162828086,ECE 45,A01,083139,Congero; Spencer William,1,0,75,74
1656162834113,ECE 65,A50,083695,Saad; Andrew S,9,0,30,21
1656162834113,ECE 65,A51,095125,Staff,23,0,26,3
1656162840143,ECE 109,A01,091882,Touri; Behrouz,0,1,70,70
1656162846173,ECE 180,A00,083140,Abi Samra; Nicholas Camill,1,0,30,29
1656162846173,ECE 180,B00,083141,Abi Samra; Nicholas Camill,0,4,30,30
1656162852206,MATH 10A,A01,083735,Patchell; Gregory David,0,0,30,30
1656162852206,MATH 10A,A02,083736,Patchell; Gregory David,22,0,30,8
1656162852206,MATH 10A,A03,083737,Patchell; Gregory David,16,0,30,14
1656162858236,MATH 10B,A01,083207,Lim; Seonhee,0,0,34,34
1656162858236,MATH 10B,A02,083208,Lim; Seonhee,7,0,35,28
1656162858236,MATH 10B,A03,093472,Staff,1,0,34,33
1656162858236,MATH 10B,B01,083739,Sinha; Shubham,10,0,30,20
1656162864266,MATH 18,A01,083743,Cinel; Cameron Alexander,7,0,30,23
1656162864266,MATH 18,A02,083744,Cinel; Cameron Alexander,10,0,30,20
1656162864266,MATH 18,A03,083745,Cinel; Cameron Alexander,4,0,30,26
1656162864266,MATH 18,B01,083748,Rideout; David Porter,0,0,36,36
1656162864266,MATH 18,B02,083749,Rideout; David Porter,0,0,36,36
1656162864266,MATH 18,B03,083750,Rideout; David Porter,0,0,36,36
1656162864266,MATH 18,B04,083751,Rideout; David Porter,0,0,36,36
1656162864266,MATH 18,B05,093473,Rideout; David Porter,1,0,36,35
1656162864266,MATH 18,B06,093474,Rideout; David Porter,3,0,36,33
1656162870293,MATH 20A,A01,083754,Zheng; Zequn,11,0,40,29
1656162876320,MATH 20B,A01,083756,Briones; Jor-el Thomas Caparas,0,0,36,36
1656162876320,MATH 20B,A02,083757,Briones; Jor-el Thomas Caparas,0,0,36,36
1656162876320,MATH 20B,A03,093475,Staff,2,0,36,34
1656162882349,MATH 20C,A01,083760,Briones; Jor-el Thomas Caparas,0,0,35,35
1656162882349,MATH 20C,A02,083761,Briones; Jor-el Thomas Caparas,9,1,35,26
1656162882349,MATH 20C,A03,093476,Staff,0,0,35,35
1656162882349,MATH 20C,B01,083762,Bach; Quang Tran,1,0,30,29
1656162888382,MATH 20D,A01,083765,Tran; Brian Kha,2,0,30,28
1656162888382,MATH 20D,A02,083766,Tran; Brian Kha,0,1,30,30
1656162888382,MATH 20D,A03,083767,Tran; Brian Kha,2,0,30,28
1656162894419,MATH 20E,A01,083771,Ganguly; Soumya,4,0,32,28
1656162894419,MATH 20E,A02,083772,Ganguly; Soumya,0,0,32,32
1656162894419,MATH 20E,B01,083773,Ciotti; Benjamin,15,0,35,20
1656162894419,MATH 20E,B02,083774,Ciotti; Benjamin,15,0,35,20
1656162900550,MATH 103A,A01,083777,Greenfeld; Be'Eri,1,0,36,35
1656162900550,MATH 103A,A02,083778,Greenfeld; Be'Eri,1,0,36,35
1656162900550,MATH 103A,A03,093561,Staff,4,0,36,32
1656162900550,MATH 103A,B01,083779,Greenfeld; Be'Eri,8,1,36,28
1656162900550,MATH 103A,B02,083780,Greenfeld; Be'Eri,1,0,36,35
1656162900550,MATH 103A,B03,093562,Staff,0,0,36,36
1656162906577,MATH 105,A01,085443,Carter; Anne Toulson,5,1,35,30
1656162906577,MATH 105,A02,093477,Staff,11,0,35,24
1656162912605,MATH 109,A01,083213,Ganzberger; Geoffrey Michael,0,0,34,34
1656162912605,MATH 109,A02,083214,Ganzberger; Geoffrey Michael,0,0,34,34
1656162912605,MATH 109,A03,093478,Staff,1,0,34,33
1656162912605,MATH 109,B01,083215,Ganzberger; Geoffrey Michael,4,0,32,28
1656162912605,MATH 109,B02,083216,Ganzberger; Geoffrey Michael,1,0,32,31
1656162912605,MATH 109,B03,093479,Staff,4,0,32,28
1656162918641,MATH 142A,A01,083219,Chow; Bennett,1,0,32,31
1656162918641,MATH 142A,A02,083220,Chow; Bennett,8,0,32,24
1656162918641,MATH 142A,A03,093480,Staff,5,0,32,27
1656162918641,MATH 142A,B03,093481,Staff,4,0,32,28
1656162918641,MATH 142A,B04,093558,Staff,6,0,32,26
1656162918641,MATH 142A,B05,093559,Staff,0,0,32,32
1656162924675,MATH 193A,A01,083224,Rotar; Vladimir,0,1,34,34
1656162924675,MATH 193A,A02,083225,Rotar; Vladimir,0,0,34,34
1656162924675,MATH 193A,A03,083781,Rotar; Vladimir,0,0,34,34
1656162924675,MATH 193A,A04,083782,Rotar; Vladimir,6,0,34,28
1656162924675,MATH 193A,A05,093482,Rotar; Vladimir,1,0,34,33
1656162930706,MATH 197,001,091859,McAuley; Julian John,9999,0,9999,0
1656162930706,MATH 197,002,095566,Kedlaya; Kiran S.,9997,0,9999,2
1656162930706,MATH 197,003,095567,Xiao; Ming,9999,0,9999,0
1656162930706,MATH 197,004,095571,Perols; Johan Lars,9998,0,9999,1
1656162937770,COGS 9,A01,083615,Shannon; Kyle Michael,4,0,75,71
1656162943795,COGS 11,A01,083617,Boyle; Mary E. T.,14,0,48,34
1656162949821,COGS 13,A01,083071,Bastos; Amalia Pinkusfeld,6,0,71,65
1656162955852,COGS 14A,A01,092681,Semenuks; Arturs,4,15,100,96
1656162961884,COGS 14B,A01,083073,Cheng; Tzu-Han,7,0,63,56
1656162967909,COGS 17,A01,092677,Semenuks; Arturs,8,0,81,73
1656162973935,COGS 100,A01,083619,Allen; Michael Gordon,2,0,70,68
1656162979966,COGS 101A,A01,083621,Davis; Joshua Daniel,3,0,68,65
1656162985995,COGS 101B,A01,091572,Allen; Michael Gordon,6,0,65,59
1656162992021,COGS 101C,A01,083625,Delgado; Tania,10,0,35,25
1656162998052,COGS 107A,A01,083627,Boyle; Mary E. T.,0,0,60,60
1656163004079,COGS 118A,A01,083075,Gupta; Anjum,7,0,76,69
1656163010110,CSE 3,A50,083646,Miranda; Gregory Joseph,18,0,50,32
1656163016139,CSE 8A,A50,083650,Miranda; Gregory Joseph,3,3,56,53
1656163022167,CSE 11,A01,083080,Cao; Yingjun,1,54,40,39
1656163028192,CSE 12,A01,083652,Krause-Levy; Sophia Louisa,7,2,120,113
1656163034223,CSE 15L,A01,083654,Morris; Justin Loren,2,0,50,48
1656163034223,CSE 15L,A02,083655,Morris; Justin Loren,4,0,50,46
1656163040250,CSE 20,A01,083657,Tran; Khoa Dang,31,0,80,49
1656163046277,CSE 21,A01,095574,Bach; Quang Tran,25,0,48,23
1656163052312,CSE 30,A01,083084,Eldon; John,2,8,80,78
1656163052312,CSE 30,B01,095061,Bhaskar; Nishant,1,2,50,49
1656163058343,CSE 100,A01,083659,Cao; Yingjun,2,20,70,68
1656163064366,CSE 134B,A01,083661,Powell; Thomas Allan,3,0,100,97
1656163070396,CSE 140,A01,083663,Gungor; Onat,9,0,85,76
1656163076420,CSE 140L,A01,083088,Eldon; John,8,0,100,92
1656163082452,CSE 175,A01,083665,Kumar; Rakesh,0,0,25,25
1656163088478,CSE 190,A00,092507,Dubnov; Shlomo,3,0,20,17
1656163094503,ECE 45,A01,083139,Congero; Spencer William,1,0,75,74
1656163100530,ECE 65,A50,083695,Saad; Andrew S,9,0,30,21
1656163100530,ECE 65,A51,095125,Staff,23,0,26,3
1656163106556,ECE 109,A01,091882,Touri; Behrouz,0,1,70,70
1656163112583,ECE 180,A00,083140,Abi Samra; Nicholas Camill,1,0,30,29
1656163112583,ECE 180,B00,083141,Abi Samra; Nicholas Camill,0,4,30,30
1656163118609,MATH 10A,A01,083735,Patchell; Gregory David,0,0,30,30
1656163118609,MATH 10A,A02,083736,Patchell; Gregory David,22,0,30,8
1656163118609,MATH 10A,A03,083737,Patchell; Gregory David,16,0,30,14
1656163124638,MATH 10B,A01,083207,Lim; Seonhee,0,0,34,34
1656163124638,MATH 10B,A02,083208,Lim; Seonhee,7,0,35,28
1656163124638,MATH 10B,A03,093472,Staff,1,0,34,33
1656163124638,MATH 10B,B01,083739,Sinha; Shubham,10,0,30,20
1656163130679,MATH 18,A01,083743,Cinel; Cameron Alexander,7,0,30,23
1656163130679,MATH 18,A02,083744,Cinel; Cameron Alexander,10,0,30,20
1656163130679,MATH 18,A03,083745,Cinel; Cameron Alexander,4,0,30,26
1656163130679,MATH 18,B01,083748,Rideout; David Porter,0,0,36,36
1656163130679,MATH 18,B02,083749,Rideout; David Porter,0,0,36,36
1656163130679,MATH 18,B03,083750,Rideout; David Porter,0,0,36,36
1656163130679,MATH 18,B04,083751,Rideout; David Porter,0,0,36,36
1656163130679,MATH 18,B05,093473,Rideout; David Porter,1,0,36,35
1656163130679,MATH 18,B06,093474,Rideout; David Porter,3,0,36,33
1656163136708,MATH 20A,A01,083754,Zheng; Zequn,11,0,40,29
1656163142735,MATH 20B,A01,083756,Briones; Jor-el Thomas Caparas,0,0,36,36
1656163142735,MATH 20B,A02,083757,Briones; Jor-el Thomas Caparas,0,0,36,36
1656163142735,MATH 20B,A03,093475,Staff,2,0,36,34
1656163148776,MATH 20C,A01,083760,Briones; Jor-el Thomas Caparas,0,0,35,35
1656163148776,MATH 20C,A02,083761,Briones; Jor-el Thomas Caparas,9,1,35,26
1656163148776,MATH 20C,A03,093476,Staff,0,0,35,35
1656163148776,MATH 20C,B01,083762,Bach; Quang Tran,1,0,30,29
1656163154808,MATH 20D,A01,083765,Tran; Brian Kha,2,0,30,28
1656163154808,MATH 20D,A02,083766,Tran; Brian Kha,0,1,30,30
1656163154808,MATH 20D,A03,083767,Tran; Brian Kha,2,0,30,28
1656163160835,MATH 20E,A01,083771,Ganguly; Soumya,4,0,32,28
1656163160835,MATH 20E,A02,083772,Ganguly; Soumya,0,0,32,32
1656163160835,MATH 20E,B01,083773,Ciotti; Benjamin,15,0,35,20
1656163160835,MATH 20E,B02,083774,Ciotti; Benjamin,15,0,35,20
1656163166868,MATH 103A,A01,083777,Greenfeld; Be'Eri,1,0,36,35
1656163166868,MATH 103A,A02,083778,Greenfeld; Be'Eri,1,0,36,35
1656163166868,MATH 103A,A03,093561,Staff,4,0,36,32
1656163166868,MATH 103A,B01,083779,Greenfeld; Be'Eri,8,1,36,28
1656163166868,MATH 103A,B02,083780,Greenfeld; Be'Eri,1,0,36,35
1656163166868,MATH 103A,B03,093562,Staff,0,0,36,36
1656163172892,MATH 105,A01,085443,Carter; Anne Toulson,5,1,35,30
1656163172892,MATH 105,A02,093477,Staff,11,0,35,24
1656163178924,MATH 109,A01,083213,Ganzberger; Geoffrey Michael,0,0,34,34
1656163178924,MATH 109,A02,083214,Ganzberger; Geoffrey Michael,0,0,34,34
1656163178924,MATH 109,A03,093478,Staff,1,0,34,33
1656163178924,MATH 109,B01,083215,Ganzberger; Geoffrey Michael,4,0,32,28
1656163178924,MATH 109,B02,083216,Ganzberger; Geoffrey Michael,1,0,32,31
1656163178924,MATH 109,B03,093479,Staff,4,0,32,28
1656163184950,MATH 142A,A01,083219,Chow; Bennett,1,0,32,31
1656163184950,MATH 142A,A02,083220,Chow; Bennett,8,0,32,24
1656163184950,MATH 142A,A03,093480,Staff,5,0,32,27
1656163184950,MATH 142A,B03,093481,Staff,4,0,32,28
1656163184950,MATH 142A,B04,093558,Staff,6,0,32,26
1656163184950,MATH 142A,B05,093559,Staff,0,0,32,32
1656163190977,MATH 193A,A01,083224,Rotar; Vladimir,0,1,34,34
1656163190977,MATH 193A,A02,083225,Rotar; Vladimir,0,0,34,34
1656163190977,MATH 193A,A03,083781,Rotar; Vladimir,0,0,34,34
1656163190977,MATH 193A,A04,083782,Rotar; Vladimir,6,0,34,28
1656163190977,MATH 193A,A05,093482,Rotar; Vladimir,1,0,34,33
1656163197004,MATH 197,001,091859,McAuley; Julian John,9999,0,9999,0
1656163197004,MATH 197,002,095566,Kedlaya; Kiran S.,9997,0,9999,2
1656163197004,MATH 197,003,095567,Xiao; Ming,9999,0,9999,0
1656163197004,MATH 197,004,095571,Perols; Johan Lars,9998,0,9999,1
1656163204067,COGS 9,A01,083615,Shannon; Kyle Michael,4,0,75,71
1656163210091,COGS 11,A01,083617,Boyle; Mary E. T.,14,0,48,34
1656163216116,COGS 13,A01,083071,Bastos; Amalia Pinkusfeld,6,0,71,65
1656163222144,COGS 14A,A01,092681,Semenuks; Arturs,4,15,100,96
1656163228168,COGS 14B,A01,083073,Cheng; Tzu-Han,7,0,63,56
1656163234198,COGS 17,A01,092677,Semenuks; Arturs,8,0,81,73
1656163240230,COGS 100,A01,083619,Allen; Michael Gordon,2,0,70,68
1656163246256,COGS 101A,A01,083621,Davis; Joshua Daniel,3,0,68,65
1656163252282,COGS 101B,A01,091572,Allen; Michael Gordon,6,0,65,59
1656163258307,COGS 101C,A01,083625,Delgado; Tania,10,0,35,25
1656163264335,COGS 107A,A01,083627,Boyle; Mary E. T.,0,0,60,60
1656163270362,COGS 118A,A01,083075,Gupta; Anjum,7,0,76,69
1656163276390,CSE 3,A50,083646,Miranda; Gregory Joseph,18,0,50,32
1656163282414,CSE 8A,A50,083650,Miranda; Gregory Joseph,3,3,56,53
1656163288438,CSE 11,A01,083080,Cao; Yingjun,1,54,40,39
1656163294469,CSE 12,A01,083652,Krause-Levy; Sophia Louisa,7,2,120,113
1656163300499,CSE 15L,A01,083654,Morris; Justin Loren,2,0,50,48
1656163300499,CSE 15L,A02,083655,Morris; Justin Loren,4,0,50,46
1656163306526,CSE 20,A01,083657,Tran; Khoa Dang,31,0,80,49
1656163312556,CSE 21,A01,095574,Bach; Quang Tran,25,0,48,23
1656163318582,CSE 30,A01,083084,Eldon; John,2,8,80,78
1656163318582,CSE 30,B01,095061,Bhaskar; Nishant,1,2,50,49
1656163324608,CSE 100,A01,083659,Cao; Yingjun,2,20,70,68
1656163330636,CSE 134B,A01,083661,Powell; Thomas Allan,3,0,100,97
1656163336664,CSE 140,A01,083663,Gungor; Onat,9,0,85,76
1656163342689,CSE 140L,A01,083088,Eldon; John,8,0,100,92
1656163348715,CSE 175,A01,083665,Kumar; Rakesh,0,0,25,25
1656163354744,CSE 190,A00,092507,Dubnov; Shlomo,3,0,20,17
1656163360772,ECE 45,A01,083139,Congero; Spencer William,1,0,75,74
1656163366799,ECE 65,A50,083695,Saad; Andrew S,9,0,30,21
1656163366799,ECE 65,A51,095125,Staff,23,0,26,3
1656163372832,ECE 109,A01,091882,Touri; Behrouz,0,1,70,70
1656163378857,ECE 180,A00,083140,Abi Samra; Nicholas Camill,1,0,30,29
1656163378857,ECE 180,B00,083141,Abi Samra; Nicholas Camill,0,4,30,30
1656163384888,MATH 10A,A01,083735,Patchell; Gregory David,0,0,30,30
1656163384888,MATH 10A,A02,083736,Patchell; Gregory David,22,0,30,8
1656163384888,MATH 10A,A03,083737,Patchell; Gregory David,16,0,30,14
1656163390916,MATH 10B,A01,083207,Lim; Seonhee,0,0,34,34
1656163390916,MATH 10B,A02,083208,Lim; Seonhee,7,0,35,28
1656163390916,MATH 10B,A03,093472,Staff,1,0,34,33
1656163390916,MATH 10B,B01,083739,Sinha; Shubham,10,0,30,20
1656163396944,MATH 18,A01,083743,Cinel; Cameron Alexander,7,0,30,23
1656163396944,MATH 18,A02,083744,Cinel; Cameron Alexander,10,0,30,20
1656163396944,MATH 18,A03,083745,Cinel; Cameron Alexander,4,0,30,26
1656163396944,MATH 18,B01,083748,Rideout; David Porter,0,0,36,36
1656163396944,MATH 18,B02,083749,Rideout; David Porter,0,0,36,36
1656163396944,MATH 18,B03,083750,Rideout; David Porter,0,0,36,36
1656163396944,MATH 18,B04,083751,Rideout; David Porter,0,0,36,36
1656163396944,MATH 18,B05,093473,Rideout; David Porter,1,0,36,35
1656163396944,MATH 18,B06,093474,Rideout; David Porter,3,0,36,33
1656163402970,MATH 20A,A01,083754,Zheng; Zequn,11,0,40,29
1656163409007,MATH 20B,A01,083756,Briones; Jor-el Thomas Caparas,0,0,36,36
1656163409007,MATH 20B,A02,083757,Briones; Jor-el Thomas Caparas,0,0,36,36
1656163409007,MATH 20B,A03,093475,Staff,2,0,36,34
1656163415042,MATH 20C,A01,083760,Briones; Jor-el Thomas Caparas,0,0,35,35
1656163415042,MATH 20C,A02,083761,Briones; Jor-el Thomas Caparas,9,1,35,26
1656163415042,MATH 20C,A03,093476,Staff,0,0,35,35
1656163415042,MATH 20C,B01,083762,Bach; Quang Tran,1,0,30,29
1656163421068,MATH 20D,A01,083765,Tran; Brian Kha,2,0,30,28
1656163421068,MATH 20D,A02,083766,Tran; Brian Kha,0,1,30,30
1656163421068,MATH 20D,A03,083767,Tran; Brian Kha,2,0,30,28
1656163427106,MATH 20E,A01,083771,Ganguly; Soumya,4,0,32,28
1656163427106,MATH 20E,A02,083772,Ganguly; Soumya,0,0,32,32
1656163427106,MATH 20E,B01,083773,Ciotti; Benjamin,15,0,35,20
1656163427106,MATH 20E,B02,083774,Ciotti; Benjamin,15,0,35,20
1656163433135,MATH 103A,A01,083777,Greenfeld; Be'Eri,1,0,36,35
1656163433135,MATH 103A,A02,083778,Greenfeld; Be'Eri,1,0,36,35
1656163433135,MATH 103A,A03,093561,Staff,4,0,36,32
1656163433135,MATH 103A,B01,083779,Greenfeld; Be'Eri,8,1,36,28
1656163433135,MATH 103A,B02,083780,Greenfeld; Be'Eri,1,0,36,35
1656163433135,MATH 103A,B03,093562,Staff,0,0,36,36
1656163439167,MATH 105,A01,085443,Carter; Anne Toulson,5,1,35,30
1656163439167,MATH 105,A02,093477,Staff,11,0,35,24
1656163445192,MATH 109,A01,083213,Ganzberger; Geoffrey Michael,0,0,34,34
1656163445192,MATH 109,A02,083214,Ganzberger; Geoffrey Michael,0,0,34,34
1656163445192,MATH 109,A03,093478,Staff,1,0,34,33
1656163445192,MATH 109,B01,083215,Ganzberger; Geoffrey Michael,4,0,32,28
1656163445192,MATH 109,B02,083216,Ganzberger; Geoffrey Michael,1,0,32,31
1656163445192,MATH 109,B03,093479,Staff,4,0,32,28
1656163451220,MATH 142A,A01,083219,Chow; Bennett,1,0,32,31
1656163451220,MATH 142A,A02,083220,Chow; Bennett,8,0,32,24
1656163451220,MATH 142A,A03,093480,Staff,5,0,32,27
1656163451220,MATH 142A,B03,093481,Staff,4,0,32,28
1656163451220,MATH 142A,B04,093558,Staff,6,0,32,26
1656163451220,MATH 142A,B05,093559,Staff,0,0,32,32
1656163457250,MATH 193A,A01,083224,Rotar; Vladimir,0,1,34,34
1656163457250,MATH 193A,A02,083225,Rotar; Vladimir,0,0,34,34
1656163457250,MATH 193A,A03,083781,Rotar; Vladimir,0,0,34,34
1656163457250,MATH 193A,A04,083782,Rotar; Vladimir,6,0,34,28
1656163457250,MATH 193A,A05,093482,Rotar; Vladimir,1,0,34,33
1656163463281,MATH 197,001,091859,McAuley; Julian John,9999,0,9999,0
1656163463281,MATH 197,002,095566,Kedlaya; Kiran S.,9997,0,9999,2
1656163463281,MATH 197,003,095567,Xiao; Ming,9999,0,9999,0
1656163463281,MATH 197,004,095571,Perols; Johan Lars,9998,0,9999,1
1656163470356,COGS 9,A01,083615,Shannon; Kyle Michael,4,0,75,71
1656163476400,COGS 11,A01,083617,Boyle; Mary E. T.,14,0,48,34
1656163482427,COGS 13,A01,083071,Bastos; Amalia Pinkusfeld,6,0,71,65
1656163488454,COGS 14A,A01,092681,Semenuks; Arturs,4,15,100,96
1656163494552,COGS 14B,A01,083073,Cheng; Tzu-Han,7,0,63,56
1656163500577,COGS 17,A01,092677,Semenuks; Arturs,8,0,81,73
1656163506605,COGS 100,A01,083619,Allen; Michael Gordon,2,0,70,68
1656163512630,COGS 101A,A01,083621,Davis; Joshua Daniel,3,0,68,65
1656163518655,COGS 101B,A01,091572,Allen; Michael Gordon,6,0,65,59
1656163524693,COGS 101C,A01,083625,Delgado; Tania,10,0,35,25
1656163530717,COGS 107A,A01,083627,Boyle; Mary E. T.,0,0,60,60
1656163536746,COGS 118A,A01,083075,Gupta; Anjum,7,0,76,69
1656163542774,CSE 3,A50,083646,Miranda; Gregory Joseph,18,0,50,32
1656163548804,CSE 8A,A50,083650,Miranda; Gregory Joseph,3,3,56,53
1656163554831,CSE 11,A01,083080,Cao; Yingjun,1,54,40,39
1656163560857,CSE 12,A01,083652,Krause-Levy; Sophia Louisa,7,2,120,113
1656163566881,CSE 15L,A01,083654,Morris; Justin Loren,2,0,50,48
1656163566881,CSE 15L,A02,083655,Morris; Justin Loren,4,0,50,46
1656163572909,CSE 20,A01,083657,Tran; Khoa Dang,31,0,80,49
1656163578934,CSE 21,A01,095574,Bach; Quang Tran,25,0,48,23
1656163584968,CSE 30,A01,083084,Eldon; John,2,8,80,78
1656163584968,CSE 30,B01,095061,Bhaskar; Nishant,1,2,50,49
1656163590993,CSE 100,A01,083659,Cao; Yingjun,2,20,70,68
1656163597032,CSE 134B,A01,083661,Powell; Thomas Allan,3,0,100,97
1656163603059,CSE 140,A01,083663,Gungor; Onat,9,0,85,76
1656163609090,CSE 140L,A01,083088,Eldon; John,8,0,100,92
1656163615117,CSE 175,A01,083665,Kumar; Rakesh,0,0,25,25
1656163621150,CSE 190,A00,092507,Dubnov; Shlomo,3,0,20,17
1656163627180,ECE 45,A01,083139,Congero; Spencer William,1,0,75,74
1656163633209,ECE 65,A50,083695,Saad; Andrew S,9,0,30,21
1656163633209,ECE 65,A51,095125,Staff,23,0,26,3
1656163639240,ECE 109,A01,091882,Touri; Behrouz,0,1,70,70
1656163645271,ECE 180,A00,083140,Abi Samra; Nicholas Camill,1,0,30,29
1656163645271,ECE 180,B00,083141,Abi Samra; Nicholas Camill,0,4,30,30
1656163651306,MATH 10A,A01,083735,Patchell; Gregory David,0,0,30,30
1656163651306,MATH 10A,A02,083736,Patchell; Gregory David,22,0,30,8
1656163651306,MATH 10A,A03,083737,Patchell; Gregory David,16,0,30,14
1656163657345,MATH 10B,A01,083207,Lim; Seonhee,0,0,34,34
1656163657345,MATH 10B,A02,083208,Lim; Seonhee,7,0,35,28
1656163657345,MATH 10B,A03,093472,Staff,1,0,34,33
1656163657345,MATH 10B,B01,083739,Sinha; Shubham,10,0,30,20
1656163663386,MATH 18,A01,083743,Cinel; Cameron Alexander,7,0,30,23
1656163663386,MATH 18,A02,083744,Cinel; Cameron Alexander,10,0,30,20
1656163663386,MATH 18,A03,083745,Cinel; Cameron Alexander,4,0,30,26
1656163663386,MATH 18,B01,083748,Rideout; David Porter,0,0,36,36
1656163663386,MATH 18,B02,083749,Rideout; David Porter,0,0,36,36
1656163663386,MATH 18,B03,083750,Rideout; David Porter,0,0,36,36
1656163663386,MATH 18,B04,083751,Rideout; David Porter,0,0,36,36
1656163663386,MATH 18,B05,093473,Rideout; David Porter,1,0,36,35
1656163663386,MATH 18,B06,093474,Rideout; David Porter,3,0,36,33
1656163669415,MATH 20A,A01,083754,Zheng; Zequn,11,0,40,29
1656163675449,MATH 20B,A01,083756,Briones; Jor-el Thomas Caparas,0,0,36,36
1656163675449,MATH 20B,A02,083757,Briones; Jor-el Thomas Caparas,0,0,36,36
1656163675449,MATH 20B,A03,093475,Staff,2,0,36,34
1656163681479,MATH 20C,A01,083760,Briones; Jor-el Thomas Caparas,0,0,35,35
1656163681479,MATH 20C,A02,083761,Briones; Jor-el Thomas Caparas,9,1,35,26
1656163681479,MATH 20C,A03,093476,Staff,0,0,35,35
1656163681479,MATH 20C,B01,083762,Bach; Quang Tran,1,0,30,29
1656163687510,MATH 20D,A01,083765,Tran; Brian Kha,2,0,30,28
1656163687510,MATH 20D,A02,083766,Tran; Brian Kha,0,1,30,30
1656163687510,MATH 20D,A03,083767,Tran; Brian Kha,2,0,30,28
1656163693548,MATH 20E,A01,083771,Ganguly; Soumya,4,0,32,28
1656163693548,MATH 20E,A02,083772,Ganguly; Soumya,0,0,32,32
1656163693548,MATH 20E,B01,083773,Ciotti; Benjamin,15,0,35,20
1656163693548,MATH 20E,B02,083774,Ciotti; Benjamin,15,0,35,20
1656163699576,MATH 103A,A01,083777,Greenfeld; Be'Eri,1,0,36,35
1656163699576,MATH 103A,A02,083778,Greenfeld; Be'Eri,1,0,36,35
1656163699576,MATH 103A,A03,093561,Staff,4,0,36,32
1656163699576,MATH 103A,B01,083779,Greenfeld; Be'Eri,8,1,36,28
1656163699576,MATH 103A,B02,083780,Greenfeld; Be'Eri,1,0,36,35
1656163699576,MATH 103A,B03,093562,Staff,0,0,36,36
1656163705618,MATH 105,A01,085443,Carter; Anne Toulson,5,1,35,30
1656163705618,MATH 105,A02,093477,Staff,11,0,35,24
1656163711667,MATH 109,A01,083213,Ganzberger; Geoffrey Michael,0,0,34,34
1656163711667,MATH 109,A02,083214,Ganzberger; Geoffrey Michael,0,0,34,34
1656163711667,MATH 109,A03,093478,Staff,1,0,34,33
1656163711667,MATH 109,B01,083215,Ganzberger; Geoffrey Michael,4,0,32,28
1656163711667,MATH 109,B02,083216,Ganzberger; Geoffrey Michael,1,0,32,31
1656163711667,MATH 109,B03,093479,Staff,4,0,32,28
1656163717698,MATH 142A,A01,083219,Chow; Bennett,1,0,32,31
1656163717698,MATH 142A,A02,083220,Chow; Bennett,8,0,32,24
1656163717698,MATH 142A,A03,093480,Staff,5,0,32,27
1656163717698,MATH 142A,B03,093481,Staff,4,0,32,28
1656163717698,MATH 142A,B04,093558,Staff,6,0,32,26
1656163717698,MATH 142A,B05,093559,Staff,0,0,32,32
1656163723739,MATH 193A,A01,083224,Rotar; Vladimir,0,1,34,34
1656163723739,MATH 193A,A02,083225,Rotar; Vladimir,0,0,34,34
1656163723739,MATH 193A,A03,083781,Rotar; Vladimir,0,0,34,34
1656163723739,MATH 193A,A04,083782,Rotar; Vladimir,6,0,34,28
1656163723739,MATH 193A,A05,093482,Rotar; Vladimir,1,0,34,33
1656163729769,MATH 197,001,091859,McAuley; Julian John,9999,0,9999,0
1656163729769,MATH 197,002,095566,Kedlaya; Kiran S.,9997,0,9999,2
1656163729769,MATH 197,003,095567,Xiao; Ming,9999,0,9999,0
1656163729769,MATH 197,004,095571,Perols; Johan Lars,9998,0,9999,1
1656163736840,COGS 9,A01,083615,Shannon; Kyle Michael,4,0,75,71
1656163742865,COGS 11,A01,083617,Boyle; Mary E. T.,14,0,48,34
1656163748893,COGS 13,A01,083071,Bastos; Amalia Pinkusfeld,6,0,71,65
1656163754922,COGS 14A,A01,092681,Semenuks; Arturs,4,15,100,96
1656163760949,COGS 14B,A01,083073,Cheng; Tzu-Han,7,0,63,56
1656163766972,COGS 17,A01,092677,Semenuks; Arturs,8,0,81,73
1656163773005,COGS 100,A01,083619,Allen; Michael Gordon,2,0,70,68
1656163779036,COGS 101A,A01,083621,Davis; Joshua Daniel,3,0,68,65
1656163785065,COGS 101B,A01,091572,Allen; Michael Gordon,6,0,65,59
1656163791091,COGS 101C,A01,083625,Delgado; Tania,10,0,35,25
1656163797115,COGS 107A,A01,083627,Boyle; Mary E. T.,0,0,60,60
1656163803147,COGS 118A,A01,083075,Gupta; Anjum,7,0,76,69
1656163809176,CSE 3,A50,083646,Miranda; Gregory Joseph,18,0,50,32
1656163815205,CSE 8A,A50,083650,Miranda; Gregory Joseph,3,3,56,53
1656163821236,CSE 11,A01,083080,Cao; Yingjun,1,54,40,39
1656163827266,CSE 12,A01,083652,Krause-Levy; Sophia Louisa,7,2,120,113
1656163833298,CSE 15L,A01,083654,Morris; Justin Loren,2,0,50,48
1656163833298,CSE 15L,A02,083655,Morris; Justin Loren,4,0,50,46
1656163839324,CSE 20,A01,083657,Tran; Khoa Dang,31,0,80,49
1656163845349,CSE 21,A01,095574,Bach; Quang Tran,25,0,48,23
1656163851375,CSE 30,A01,083084,Eldon; John,2,8,80,78
1656163851375,CSE 30,B01,095061,Bhaskar; Nishant,1,2,50,49
1656163857401,CSE 100,A01,083659,Cao; Yingjun,2,20,70,68
1656163863425,CSE 134B,A01,083661,Powell; Thomas Allan,3,0,100,97
1656163869456,CSE 140,A01,083663,Gungor; Onat,9,0,85,76
1656163875482,CSE 140L,A01,083088,Eldon; John,8,0,100,92
1656163881513,CSE 175,A01,083665,Kumar; Rakesh,0,0,25,25
1656163887541,CSE 190,A00,092507,Dubnov; Shlomo,3,0,20,17
1656163893573,ECE 45,A01,083139,Congero; Spencer William,1,0,75,74
1656163899606,ECE 65,A50,083695,Saad; Andrew S,9,0,30,21
1656163899606,ECE 65,A51,095125,Staff,23,0,26,3
1656163905633,ECE 109,A01,091882,Touri; Behrouz,0,1,70,70
1656163911662,ECE 180,A00,083140,Abi Samra; Nicholas Camill,1,0,30,29
1656163911662,ECE 180,B00,083141,Abi Samra; Nicholas Camill,0,4,30,30
1656163917690,MATH 10A,A01,083735,Patchell; Gregory David,0,0,30,30
1656163917690,MATH 10A,A02,083736,Patchell; Gregory David,22,0,30,8
1656163917690,MATH 10A,A03,083737,Patchell; Gregory David,16,0,30,14
1656163923719,MATH 10B,A01,083207,Lim; Seonhee,0,0,34,34
1656163923719,MATH 10B,A02,083208,Lim; Seonhee,7,0,35,28
1656163923719,MATH 10B,A03,093472,Staff,1,0,34,33
1656163923719,MATH 10B,B01,083739,Sinha; Shubham,10,0,30,20
1656163929746,MATH 18,A01,083743,Cinel; Cameron Alexander,7,0,30,23
1656163929746,MATH 18,A02,083744,Cinel; Cameron Alexander,10,0,30,20
1656163929746,MATH 18,A03,083745,Cinel; Cameron Alexander,4,0,30,26
1656163929746,MATH 18,B01,083748,Rideout; David Porter,0,0,36,36
1656163929746,MATH 18,B02,083749,Rideout; David Porter,0,0,36,36
1656163929746,MATH 18,B03,083750,Rideout; David Porter,0,0,36,36
1656163929746,MATH 18,B04,083751,Rideout; David Porter,0,0,36,36
1656163929746,MATH 18,B05,093473,Rideout; David Porter,1,0,36,35
1656163929746,MATH 18,B06,093474,Rideout; David Porter,3,0,36,33
1656163935777,MATH 20A,A01,083754,Zheng; Zequn,11,0,40,29
1656163941809,MATH 20B,A01,083756,Briones; Jor-el Thomas Caparas,0,0,36,36
1656163941809,MATH 20B,A02,083757,Briones; Jor-el Thomas Caparas,0,0,36,36
1656163941809,MATH 20B,A03,093475,Staff,2,0,36,34
1656163947842,MATH 20C,A01,083760,Briones; Jor-el Thomas Caparas,0,0,35,35
1656163947842,MATH 20C,A02,083761,Briones; Jor-el Thomas Caparas,9,1,35,26
1656163947842,MATH 20C,A03,093476,Staff,0,0,35,35
1656163947842,MATH 20C,B01,083762,Bach; Quang Tran,1,0,30,29
1656163953868,MATH 20D,A01,083765,Tran; Brian Kha,2,0,30,28
1656163953868,MATH 20D,A02,083766,Tran; Brian Kha,0,1,30,30
1656163953868,MATH 20D,A03,083767,Tran; Brian Kha,2,0,30,28
1656163959898,MATH 20E,A01,083771,Ganguly; Soumya,4,0,32,28
1656163959898,MATH 20E,A02,083772,Ganguly; Soumya,0,0,32,32
1656163959898,MATH 20E,B01,083773,Ciotti; Benjamin,15,0,35,20
1656163959898,MATH 20E,B02,083774,Ciotti; Benjamin,15,0,35,20
1656163965934,MATH 103A,A01,083777,Greenfeld; Be'Eri,1,0,36,35
1656163965934,MATH 103A,A02,083778,Greenfeld; Be'Eri,1,0,36,35
1656163965934,MATH 103A,A03,093561,Staff,4,0,36,32
1656163965934,MATH 103A,B01,083779,Greenfeld; Be'Eri,8,1,36,28
1656163965934,MATH 103A,B02,083780,Greenfeld; Be'Eri,1,0,36,35
1656163965934,MATH 103A,B03,093562,Staff,0,0,36,36
1656163971979,MATH 105,A01,085443,Carter; Anne Toulson,5,1,35,30
1656163971979,MATH 105,A02,093477,Staff,11,0,35,24
1656163978004,MATH 109,A01,083213,Ganzberger; Geoffrey Michael,0,0,34,34
1656163978004,MATH 109,A02,083214,Ganzberger; Geoffrey Michael,0,0,34,34
1656163978004,MATH 109,A03,093478,Staff,1,0,34,33
1656163978004,MATH 109,B01,083215,Ganzberger; Geoffrey Michael,4,0,32,28
1656163978004,MATH 109,B02,083216,Ganzberger; Geoffrey Michael,1,0,32,31
1656163978004,MATH 109,B03,093479,Staff,4,0,32,28
1656163984041,MATH 142A,A01,083219,Chow; Bennett,1,0,32,31
1656163984041,MATH 142A,A02,083220,Chow; Bennett,8,0,32,24
1656163984041,MATH 142A,A03,093480,Staff,5,0,32,27
1656163984041,MATH 142A,B03,093481,Staff,4,0,32,28
1656163984041,MATH 142A,B04,093558,Staff,6,0,32,26
1656163984041,MATH 142A,B05,093559,Staff,0,0,32,32
1656163990074,MATH 193A,A01,083224,Rotar; Vladimir,0,1,34,34
1656163990074,MATH 193A,A02,083225,Rotar; Vladimir,0,0,34,34
1656163990074,MATH 193A,A03,083781,Rotar; Vladimir,0,0,34,34
1656163990074,MATH 193A,A04,083782,Rotar; Vladimir,6,0,34,28
1656163990074,MATH 193A,A05,093482,Rotar; Vladimir,1,0,34,33
1656163996100,MATH 197,001,091859,McAuley; Julian John,9999,0,9999,0
1656163996100,MATH 197,002,095566,Kedlaya; Kiran S.,9997,0,9999,2
1656163996100,MATH 197,003,095567,Xiao; Ming,9999,0,9999,0
1656163996100,MATH 197,004,095571,Perols; Johan Lars,9998,0,9999,1
1656164003171,COGS 9,A01,083615,Shannon; Kyle Michael,4,0,75,71
1656164009201,COGS 11,A01,083617,Boyle; Mary E. T.,14,0,48,34
1656164015230,COGS 13,A01,083071,Bastos; Amalia Pinkusfeld,6,0,71,65
1656164021256,COGS 14A,A01,092681,Semenuks; Arturs,4,15,100,96
1656164027287,COGS 14B,A01,083073,Cheng; Tzu-Han,7,0,63,56
1656164033315,COGS 17,A01,092677,Semenuks; Arturs,8,0,81,73
1656164039341,COGS 100,A01,083619,Allen; Michael Gordon,2,0,70,68
1656164045377,COGS 101A,A01,083621,Davis; Joshua Daniel,3,0,68,65
1656164051402,COGS 101B,A01,091572,Allen; Michael Gordon,6,0,65,59
1656164057434,COGS 101C,A01,083625,Delgado; Tania,10,0,35,25
1656164063459,COGS 107A,A01,083627,Boyle; Mary E. T.,0,0,60,60
1656164069485,COGS 118A,A01,083075,Gupta; Anjum,7,0,76,69
1656164075513,CSE 3,A50,083646,Miranda; Gregory Joseph,18,0,50,32
1656164081543,CSE 8A,A50,083650,Miranda; Gregory Joseph,3,3,56,53
1656164087572,CSE 11,A01,083080,Cao; Yingjun,1,54,40,39
1656164093685,CSE 12,A01,083652,Krause-Levy; Sophia Louisa,7,2,120,113
1656164099713,CSE 15L,A01,083654,Morris; Justin Loren,2,0,50,48
1656164099713,CSE 15L,A02,083655,Morris; Justin Loren,4,0,50,46
1656164105746,CSE 20,A01,083657,Tran; Khoa Dang,31,0,80,49
1656164111783,CSE 21,A01,095574,Bach; Quang Tran,25,0,48,23
1656164117810,CSE 30,A01,083084,Eldon; John,2,8,80,78
1656164117810,CSE 30,B01,095061,Bhaskar; Nishant,1,2,50,49
1656164123835,CSE 100,A01,083659,Cao; Yingjun,2,20,70,68
1656164129865,CSE 134B,A01,083661,Powell; Thomas Allan,3,0,100,97
1656164135890,CSE 140,A01,083663,Gungor; Onat,9,0,85,76
1656164141919,CSE 140L,A01,083088,Eldon; John,8,0,100,92
1656164147944,CSE 175,A01,083665,Kumar; Rakesh,0,0,25,25
1656164153967,CSE 190,A00,092507,Dubnov; Shlomo,3,0,20,17
1656164159993,ECE 45,A01,083139,Congero; Spencer William,1,0,75,74
1656164166020,ECE 65,A50,083695,Saad; Andrew S,9,0,30,21
1656164166020,ECE 65,A51,095125,Staff,23,0,26,3
1656164172052,ECE 109,A01,091882,Touri; Behrouz,0,1,70,70
1656164178079,ECE 180,A00,083140,Abi Samra; Nicholas Camill,1,0,30,29
1656164178079,ECE 180,B00,083141,Abi Samra; Nicholas Camill,0,4,30,30
1656164184103,MATH 10A,A01,083735,Patchell; Gregory David,0,0,30,30
1656164184103,MATH 10A,A02,083736,Patchell; Gregory David,22,0,30,8
1656164184103,MATH 10A,A03,083737,Patchell; Gregory David,16,0,30,14
1656164190145,MATH 10B,A01,083207,Lim; Seonhee,0,0,34,34
1656164190145,MATH 10B,A02,083208,Lim; Seonhee,7,0,35,28
1656164190145,MATH 10B,A03,093472,Staff,1,0,34,33
1656164190145,MATH 10B,B01,083739,Sinha; Shubham,10,0,30,20
1656164196174,MATH 18,A01,083743,Cinel; Cameron Alexander,7,0,30,23
1656164196174,MATH 18,A02,083744,Cinel; Cameron Alexander,10,0,30,20
1656164196174,MATH 18,A03,083745,Cinel; Cameron Alexander,4,0,30,26
1656164196174,MATH 18,B01,083748,Rideout; David Porter,0,0,36,36
1656164196174,MATH 18,B02,083749,Rideout; David Porter,0,0,36,36
1656164196174,MATH 18,B03,083750,Rideout; David Porter,0,0,36,36
1656164196174,MATH 18,B04,083751,Rideout; David Porter,0,0,36,36
1656164196174,MATH 18,B05,093473,Rideout; David Porter,1,0,36,35
1656164196174,MATH 18,B06,093474,Rideout; David Porter,3,0,36,33
1656164202201,MATH 20A,A01,083754,Zheng; Zequn,11,0,40,29
1656164208234,MATH 20B,A01,083756,Briones; Jor-el Thomas Caparas,0,0,36,36
1656164208234,MATH 20B,A02,083757,Briones; Jor-el Thomas Caparas,0,0,36,36
1656164208234,MATH 20B,A03,093475,Staff,2,0,36,34
1656164214266,MATH 20C,A01,083760,Briones; Jor-el Thomas Caparas,0,0,35,35
1656164214266,MATH 20C,A02,083761,Briones; Jor-el Thomas Caparas,9,1,35,26
1656164214266,MATH 20C,A03,093476,Staff,0,0,35,35
1656164214266,MATH 20C,B01,083762,Bach; Quang Tran,1,0,30,29
1656164220291,MATH 20D,A01,083765,Tran; Brian Kha,2,0,30,28
1656164220291,MATH 20D,A02,083766,Tran; Brian Kha,0,1,30,30
1656164220291,MATH 20D,A03,083767,Tran; Brian Kha,2,0,30,28
1656164226318,MATH 20E,A01,083771,Ganguly; Soumya,4,0,32,28
1656164226318,MATH 20E,A02,083772,Ganguly; Soumya,0,0,32,32
1656164226318,MATH 20E,B01,083773,Ciotti; Benjamin,15,0,35,20
1656164226318,MATH 20E,B02,083774,Ciotti; Benjamin,15,0,35,20
1656164232355,MATH 103A,A01,083777,Greenfeld; Be'Eri,1,0,36,35
1656164232355,MATH 103A,A02,083778,Greenfeld; Be'Eri,1,0,36,35
1656164232355,MATH 103A,A03,093561,Staff,4,0,36,32
1656164232355,MATH 103A,B01,083779,Greenfeld; Be'Eri,8,1,36,28
1656164232355,MATH 103A,B02,083780,Greenfeld; Be'Eri,1,0,36,35
1656164232355,MATH 103A,B03,093562,Staff,0,0,36,36
1656164238384,MATH 105,A01,085443,Carter; Anne Toulson,5,1,35,30
1656164238384,MATH 105,A02,093477,Staff,11,0,35,24
1656164244417,MATH 109,A01,083213,Ganzberger; Geoffrey Michael,0,0,34,34
1656164244417,MATH 109,A02,083214,Ganzberger; Geoffrey Michael,0,0,34,34
1656164244417,MATH 109,A03,093478,Staff,1,0,34,33
1656164244417,MATH 109,B01,083215,Ganzberger; Geoffrey Michael,4,0,32,28
1656164244417,MATH 109,B02,083216,Ganzberger; Geoffrey Michael,1,0,32,31
1656164244417,MATH 109,B03,093479,Staff,4,0,32,28
1656164250444,MATH 142A,A01,083219,Chow; Bennett,1,0,32,31
1656164250444,MATH 142A,A02,083220,Chow; Bennett,8,0,32,24
1656164250444,MATH 142A,A03,093480,Staff,5,0,32,27
1656164250444,MATH 142A,B03,093481,Staff,4,0,32,28
1656164250444,MATH 142A,B04,093558,Staff,6,0,32,26
1656164250444,MATH 142A,B05,093559,Staff,0,0,32,32
1656164256471,MATH 193A,A01,083224,Rotar; Vladimir,0,1,34,34
1656164256471,MATH 193A,A02,083225,Rotar; Vladimir,0,0,34,34
1656164256471,MATH 193A,A03,083781,Rotar; Vladimir,0,0,34,34
1656164256471,MATH 193A,A04,083782,Rotar; Vladimir,6,0,34,28
1656164256471,MATH 193A,A05,093482,Rotar; Vladimir,1,0,34,33
1656164262502,MATH 197,001,091859,McAuley; Julian John,9999,0,9999,0
1656164262502,MATH 197,002,095566,Kedlaya; Kiran S.,9997,0,9999,2
1656164262502,MATH 197,003,095567,Xiao; Ming,9999,0,9999,0
1656164262502,MATH 197,004,095571,Perols; Johan Lars,9998,0,9999,1
1656164269581,COGS 9,A01,083615,Shannon; Kyle Michael,4,0,75,71
1656164275610,COGS 11,A01,083617,Boyle; Mary E. T.,14,0,48,34
1656164281633,COGS 13,A01,083071,Bastos; Amalia Pinkusfeld,6,0,71,65
1656164287659,COGS 14A,A01,092681,Semenuks; Arturs,4,15,100,96
1656164293693,COGS 14B,A01,083073,Cheng; Tzu-Han,7,0,63,56
1656164299717,COGS 17,A01,092677,Semenuks; Arturs,8,0,81,73
1656164305748,COGS 100,A01,083619,Allen; Michael Gordon,2,0,70,68
1656164311779,COGS 101A,A01,083621,Davis; Joshua Daniel,3,0,68,65
1656164317805,COGS 101B,A01,091572,Allen; Michael Gordon,6,0,65,59
1656164323830,COGS 101C,A01,083625,Delgado; Tania,10,0,35,25
1656164329856,COGS 107A,A01,083627,Boyle; Mary E. T.,0,0,60,60
1656164335880,COGS 118A,A01,083075,Gupta; Anjum,7,0,76,69
1656164341907,CSE 3,A50,083646,Miranda; Gregory Joseph,18,0,50,32
1656164347933,CSE 8A,A50,083650,Miranda; Gregory Joseph,3,3,56,53
1656164353964,CSE 11,A01,083080,Cao; Yingjun,1,54,40,39
1656164359991,CSE 12,A01,083652,Krause-Levy; Sophia Louisa,7,2,120,113
1656164366016,CSE 15L,A01,083654,Morris; Justin Loren,2,0,50,48
1656164366016,CSE 15L,A02,083655,Morris; Justin Loren,4,0,50,46
1656164372042,CSE 20,A01,083657,Tran; Khoa Dang,31,0,80,49
1656164378071,CSE 21,A01,095574,Bach; Quang Tran,25,0,48,23
1656164384103,CSE 30,A01,083084,Eldon; John,2,8,80,78
1656164384103,CSE 30,B01,095061,Bhaskar; Nishant,1,2,50,49
1656164390136,CSE 100,A01,083659,Cao; Yingjun,2,20,70,68
1656164396161,CSE 134B,A01,083661,Powell; Thomas Allan,3,0,100,97
1656164402192,CSE 140,A01,083663,Gungor; Onat,9,0,85,76
1656164408215,CSE 140L,A01,083088,Eldon; John,8,0,100,92
1656164414247,CSE 175,A01,083665,Kumar; Rakesh,0,0,25,25
1656164420282,CSE 190,A00,092507,Dubnov; Shlomo,3,0,20,17
1656164426309,ECE 45,A01,083139,Congero; Spencer William,1,0,75,74
1656164432341,ECE 65,A50,083695,Saad; Andrew S,9,0,30,21
1656164432341,ECE 65,A51,095125,Staff,23,0,26,3
1656164438366,ECE 109,A01,091882,Touri; Behrouz,0,1,70,70
1656164444393,ECE 180,A00,083140,Abi Samra; Nicholas Camill,1,0,30,29
1656164444393,ECE 180,B00,083141,Abi Samra; Nicholas Camill,0,4,30,30
1656164450421,MATH 10A,A01,083735,Patchell; Gregory David,0,0,30,30
1656164450421,MATH 10A,A02,083736,Patchell; Gregory David,22,0,30,8
1656164450421,MATH 10A,A03,083737,Patchell; Gregory David,16,0,30,14
1656164456449,MATH 10B,A01,083207,Lim; Seonhee,0,0,34,34
1656164456449,MATH 10B,A02,083208,Lim; Seonhee,7,0,35,28
1656164456449,MATH 10B,A03,093472,Staff,1,0,34,33
1656164456449,MATH 10B,B01,083739,Sinha; Shubham,10,0,30,20
1656164462478,MATH 18,A01,083743,Cinel; Cameron Alexander,7,0,30,23
1656164462478,MATH 18,A02,083744,Cinel; Cameron Alexander,10,0,30,20
1656164462478,MATH 18,A03,083745,Cinel; Cameron Alexander,4,0,30,26
1656164462478,MATH 18,B01,083748,Rideout; David Porter,0,0,36,36
1656164462478,MATH 18,B02,083749,Rideout; David Porter,0,0,36,36
1656164462478,MATH 18,B03,083750,Rideout; David Porter,0,0,36,36
1656164462478,MATH 18,B04,083751,Rideout; David Porter,0,0,36,36
1656164462478,MATH 18,B05,093473,Rideout; David Porter,1,0,36,35
1656164462478,MATH 18,B06,093474,Rideout; David Porter,3,0,36,33
1656164468503,MATH 20A,A01,083754,Zheng; Zequn,11,0,40,29
1656164474532,MATH 20B,A01,083756,Briones; Jor-el Thomas Caparas,0,0,36,36
1656164474532,MATH 20B,A02,083757,Briones; Jor-el Thomas Caparas,0,0,36,36
1656164474532,MATH 20B,A03,093475,Staff,2,0,36,34
1656164480561,MATH 20C,A01,083760,Briones; Jor-el Thomas Caparas,0,0,35,35
1656164480561,MATH 20C,A02,083761,Briones; Jor-el Thomas Caparas,9,1,35,26
1656164480561,MATH 20C,A03,093476,Staff,0,0,35,35
1656164480561,MATH 20C,B01,083762,Bach; Quang Tran,1,0,30,29
1656164486593,MATH 20D,A01,083765,Tran; Brian Kha,2,0,30,28
1656164486593,MATH 20D,A02,083766,Tran; Brian Kha,0,1,30,30
1656164486593,MATH 20D,A03,083767,Tran; Brian Kha,2,0,30,28
1656164492625,MATH 20E,A01,083771,Ganguly; Soumya,4,0,32,28
1656164492625,MATH 20E,A02,083772,Ganguly; Soumya,0,0,32,32
1656164492625,MATH 20E,B01,083773,Ciotti; Benjamin,15,0,35,20
1656164492625,MATH 20E,B02,083774,Ciotti; Benjamin,15,0,35,20
1656164498662,MATH 103A,A01,083777,Greenfeld; Be'Eri,1,0,36,35
1656164498662,MATH 103A,A02,083778,Greenfeld; Be'Eri,1,0,36,35
1656164498662,MATH 103A,A03,093561,Staff,4,0,36,32
1656164498662,MATH 103A,B01,083779,Greenfeld; Be'Eri,8,1,36,28
1656164498662,MATH 103A,B02,083780,Greenfeld; Be'Eri,1,0,36,35
1656164498662,MATH 103A,B03,093562,Staff,0,0,36,36
1656164504687,MATH 105,A01,085443,Carter; Anne Toulson,5,1,35,30
1656164504687,MATH 105,A02,093477,Staff,11,0,35,24
1656164510713,MATH 109,A01,083213,Ganzberger; Geoffrey Michael,0,0,34,34
1656164510713,MATH 109,A02,083214,Ganzberger; Geoffrey Michael,0,0,34,34
1656164510713,MATH 109,A03,093478,Staff,1,0,34,33
1656164510713,MATH 109,B01,083215,Ganzberger; Geoffrey Michael,4,0,32,28
1656164510713,MATH 109,B02,083216,Ganzberger; Geoffrey Michael,1,0,32,31
1656164510713,MATH 109,B03,093479,Staff,4,0,32,28
1656164516747,MATH 142A,A01,083219,Chow; Bennett,1,0,32,31
1656164516747,MATH 142A,A02,083220,Chow; Bennett,8,0,32,24
1656164516747,MATH 142A,A03,093480,Staff,5,0,32,27
1656164516747,MATH 142A,B03,093481,Staff,4,0,32,28
1656164516747,MATH 142A,B04,093558,Staff,6,0,32,26
1656164516747,MATH 142A,B05,093559,Staff,0,0,32,32
1656164522780,MATH 193A,A01,083224,Rotar; Vladimir,0,1,34,34
1656164522780,MATH 193A,A02,083225,Rotar; Vladimir,0,0,34,34
1656164522780,MATH 193A,A03,083781,Rotar; Vladimir,0,0,34,34
1656164522780,MATH 193A,A04,083782,Rotar; Vladimir,6,0,34,28
1656164522780,MATH 193A,A05,093482,Rotar; Vladimir,1,0,34,33
1656164528807,MATH 197,001,091859,McAuley; Julian John,9999,0,9999,0
1656164528807,MATH 197,002,095566,Kedlaya; Kiran S.,9997,0,9999,2
1656164528807,MATH 197,003,095567,Xiao; Ming,9999,0,9999,0
1656164528807,MATH 197,004,095571,Perols; Johan Lars,9998,0,9999,1
1656164535872,COGS 9,A01,083615,Shannon; Kyle Michael,4,0,75,71
1656164541919,COGS 11,A01,083617,Boyle; Mary E. T.,14,0,48,34
1656164547945,COGS 13,A01,083071,Bastos; Amalia Pinkusfeld,6,0,71,65
1656164553975,COGS 14A,A01,092681,Semenuks; Arturs,4,15,100,96
1656164560002,COGS 14B,A01,083073,Cheng; Tzu-Han,7,0,63,56
1656164566029,COGS 17,A01,092677,Semenuks; Arturs,8,0,81,73
1656164572059,COGS 100,A01,083619,Allen; Michael Gordon,2,0,70,68
1656164578083,COGS 101A,A01,083621,Davis; Joshua Daniel,3,0,68,65
1656164584109,COGS 101B,A01,091572,Allen; Michael Gordon,6,0,65,59
1656164590138,COGS 101C,A01,083625,Delgado; Tania,10,0,35,25
1656164596163,COGS 107A,A01,083627,Boyle; Mary E. T.,0,0,60,60
1656164602187,COGS 118A,A01,083075,Gupta; Anjum,7,0,76,69
1656164608222,CSE 3,A50,083646,Miranda; Gregory Joseph,18,0,50,32
1656164614248,CSE 8A,A50,083650,Miranda; Gregory Joseph,3,3,56,53
1656164620277,CSE 11,A01,083080,Cao; Yingjun,1,54,40,39
1656164626310,CSE 12,A01,083652,Krause-Levy; Sophia Louisa,7,2,120,113
1656164632336,CSE 15L,A01,083654,Morris; Justin Loren,2,0,50,48
1656164632336,CSE 15L,A02,083655,Morris; Justin Loren,4,0,50,46
1656164638366,CSE 20,A01,083657,Tran; Khoa Dang,31,0,80,49
1656164644396,CSE 21,A01,095574,Bach; Quang Tran,25,0,48,23
1656164650424,CSE 30,A01,083084,Eldon; John,2,8,80,78
1656164650424,CSE 30,B01,095061,Bhaskar; Nishant,1,2,50,49
1656164656454,CSE 100,A01,083659,Cao; Yingjun,2,20,70,68
1656164662483,CSE 134B,A01,083661,Powell; Thomas Allan,3,0,100,97
1656164668506,CSE 140,A01,083663,Gungor; Onat,9,0,85,76
1656164674534,CSE 140L,A01,083088,Eldon; John,8,0,100,92
1656164680565,CSE 175,A01,083665,Kumar; Rakesh,0,0,25,25
1656164686594,CSE 190,A00,092507,Dubnov; Shlomo,3,0,20,17
1656164692708,ECE 45,A01,083139,Congero; Spencer William,1,0,75,74
1656164698734,ECE 65,A50,083695,Saad; Andrew S,9,0,30,21
1656164698734,ECE 65,A51,095125,Staff,23,0,26,3
1656164704764,ECE 109,A01,091882,Touri; Behrouz,0,1,70,70
1656164710789,ECE 180,A00,083140,Abi Samra; Nicholas Camill,1,0,30,29
1656164710789,ECE 180,B00,083141,Abi Samra; Nicholas Camill,0,4,30,30
1656164716817,MATH 10A,A01,083735,Patchell; Gregory David,0,0,30,30
1656164716817,MATH 10A,A02,083736,Patchell; Gregory David,22,0,30,8
1656164716817,MATH 10A,A03,083737,Patchell; Gregory David,16,0,30,14
1656164722853,MATH 10B,A01,083207,Lim; Seonhee,0,0,34,34
1656164722853,MATH 10B,A02,083208,Lim; Seonhee,7,0,35,28
1656164722853,MATH 10B,A03,093472,Staff,1,0,34,33
1656164722853,MATH 10B,B01,083739,Sinha; Shubham,10,0,30,20
1656164728881,MATH 18,A01,083743,Cinel; Cameron Alexander,7,0,30,23
1656164728881,MATH 18,A02,083744,Cinel; Cameron Alexander,10,0,30,20
1656164728881,MATH 18,A03,083745,Cinel; Cameron Alexander,4,0,30,26
1656164728881,MATH 18,B01,083748,Rideout; David Porter,0,0,36,36
1656164728881,MATH 18,B02,083749,Rideout; David Porter,0,0,36,36
1656164728881,MATH 18,B03,083750,Rideout; David Porter,0,0,36,36
1656164728881,MATH 18,B04,083751,Rideout; David Porter,0,0,36,36
1656164728881,MATH 18,B05,093473,Rideout; David Porter,1,0,36,35
1656164728881,MATH 18,B06,093474,Rideout; David Porter,3,0,36,33
1656164734906,MATH 20A,A01,083754,Zheng; Zequn,11,0,40,29
1656164740933,MATH 20B,A01,083756,Briones; Jor-el Thomas Caparas,0,0,36,36
1656164740933,MATH 20B,A02,083757,Briones; Jor-el Thomas Caparas,0,0,36,36
1656164740933,MATH 20B,A03,093475,Staff,2,0,36,34
1656164746961,MATH 20C,A01,083760,Briones; Jor-el Thomas Caparas,0,0,35,35
1656164746961,MATH 20C,A02,083761,Briones; Jor-el Thomas Caparas,9,1,35,26
1656164746961,MATH 20C,A03,093476,Staff,0,0,35,35
1656164746961,MATH 20C,B01,083762,Bach; Quang Tran,1,0,30,29
1656164752988,MATH 20D,A01,083765,Tran; Brian Kha,2,0,30,28
1656164752988,MATH 20D,A02,083766,Tran; Brian Kha,0,1,30,30
1656164752988,MATH 20D,A03,083767,Tran; Brian Kha,2,0,30,28
1656164759020,MATH 20E,A01,083771,Ganguly; Soumya,4,0,32,28
1656164759020,MATH 20E,A02,083772,Ganguly; Soumya,0,0,32,32
1656164759020,MATH 20E,B01,083773,Ciotti; Benjamin,15,0,35,20
1656164759020,MATH 20E,B02,083774,Ciotti; Benjamin,15,0,35,20
1656164765050,MATH 103A,A01,083777,Greenfeld; Be'Eri,1,0,36,35
1656164765050,MATH 103A,A02,083778,Greenfeld; Be'Eri,1,0,36,35
1656164765050,MATH 103A,A03,093561,Staff,4,0,36,32
1656164765050,MATH 103A,B01,083779,Greenfeld; Be'Eri,8,1,36,28
1656164765050,MATH 103A,B02,083780,Greenfeld; Be'Eri,1,0,36,35
1656164765050,MATH 103A,B03,093562,Staff,0,0,36,36
1656164771081,MATH 105,A01,085443,Carter; Anne Toulson,5,1,35,30
1656164771081,MATH 105,A02,093477,Staff,11,0,35,24
1656164777115,MATH 109,A01,083213,Ganzberger; Geoffrey Michael,0,0,34,34
1656164777115,MATH 109,A02,083214,Ganzberger; Geoffrey Michael,0,0,34,34
1656164777115,MATH 109,A03,093478,Staff,1,0,34,33
1656164777115,MATH 109,B01,083215,Ganzberger; Geoffrey Michael,4,0,32,28
1656164777115,MATH 109,B02,083216,Ganzberger; Geoffrey Michael,1,0,32,31
1656164777115,MATH 109,B03,093479,Staff,4,0,32,28
1656164783149,MATH 142A,A01,083219,Chow; Bennett,1,0,32,31
1656164783149,MATH 142A,A02,083220,Chow; Bennett,8,0,32,24
1656164783149,MATH 142A,A03,093480,Staff,5,0,32,27
1656164783149,MATH 142A,B03,093481,Staff,4,0,32,28
1656164783149,MATH 142A,B04,093558,Staff,6,0,32,26
1656164783149,MATH 142A,B05,093559,Staff,0,0,32,32
1656164789175,MATH 193A,A01,083224,Rotar; Vladimir,0,1,34,34
1656164789175,MATH 193A,A02,083225,Rotar; Vladimir,0,0,34,34
1656164789175,MATH 193A,A03,083781,Rotar; Vladimir,0,0,34,34
1656164789175,MATH 193A,A04,083782,Rotar; Vladimir,6,0,34,28
1656164789175,MATH 193A,A05,093482,Rotar; Vladimir,1,0,34,33
1656164795207,MATH 197,001,091859,McAuley; Julian John,9999,0,9999,0
1656164795207,MATH 197,002,095566,Kedlaya; Kiran S.,9997,0,9999,2
1656164795207,MATH 197,003,095567,Xiao; Ming,9999,0,9999,0
1656164795207,MATH 197,004,095571,Perols; Johan Lars,9998,0,9999,1
1656164802266,COGS 9,A01,083615,Shannon; Kyle Michael,4,0,75,71
1656164808292,COGS 11,A01,083617,Boyle; Mary E. T.,14,0,48,34
1656164814323,COGS 13,A01,083071,Bastos; Amalia Pinkusfeld,6,0,71,65
1656164820354,COGS 14A,A01,092681,Semenuks; Arturs,4,15,100,96
1656164826379,COGS 14B,A01,083073,Cheng; Tzu-Han,7,0,63,56
1656164832408,COGS 17,A01,092677,Semenuks; Arturs,8,0,81,73
1656164838440,COGS 100,A01,083619,Allen; Michael Gordon,2,0,70,68
1656164844464,COGS 101A,A01,083621,Davis; Joshua Daniel,3,0,68,65
1656164850494,COGS 101B,A01,091572,Allen; Michael Gordon,6,0,65,59
1656164856520,COGS 101C,A01,083625,Delgado; Tania,10,0,35,25
1656164862545,COGS 107A,A01,083627,Boyle; Mary E. T.,0,0,60,60
1656164868575,COGS 118A,A01,083075,Gupta; Anjum,7,0,76,69
1656164874610,CSE 3,A50,083646,Miranda; Gregory Joseph,18,0,50,32
1656164880635,CSE 8A,A50,083650,Miranda; Gregory Joseph,3,3,56,53
1656164886661,CSE 11,A01,083080,Cao; Yingjun,1,54,40,39
1656164892687,CSE 12,A01,083652,Krause-Levy; Sophia Louisa,7,2,120,113
1656164898721,CSE 15L,A01,083654,Morris; Justin Loren,2,0,50,48
1656164898721,CSE 15L,A02,083655,Morris; Justin Loren,4,0,50,46
1656164904750,CSE 20,A01,083657,Tran; Khoa Dang,31,0,80,49
1656164910776,CSE 21,A01,095574,Bach; Quang Tran,25,0,48,23
1656164916810,CSE 30,A01,083084,Eldon; John,2,8,80,78
1656164916810,CSE 30,B01,095061,Bhaskar; Nishant,1,2,50,49
1656164922836,CSE 100,A01,083659,Cao; Yingjun,2,20,70,68
1656164928864,CSE 134B,A01,083661,Powell; Thomas Allan,3,0,100,97
1656164934898,CSE 140,A01,083663,Gungor; Onat,9,0,85,76
1656164940925,CSE 140L,A01,083088,Eldon; John,8,0,100,92
1656164946954,CSE 175,A01,083665,Kumar; Rakesh,0,0,25,25
1656164952986,CSE 190,A00,092507,Dubnov; Shlomo,3,0,20,17
1656164959012,ECE 45,A01,083139,Congero; Spencer William,1,0,75,74
1656164965038,ECE 65,A50,083695,Saad; Andrew S,9,0,30,21
1656164965038,ECE 65,A51,095125,Staff,23,0,26,3
1656164971067,ECE 109,A01,091882,Touri; Behrouz,0,1,70,70
1656164977093,ECE 180,A00,083140,Abi Samra; Nicholas Camill,1,0,30,29
1656164977093,ECE 180,B00,083141,Abi Samra; Nicholas Camill,0,4,30,30
1656164983122,MATH 10A,A01,083735,Patchell; Gregory David,0,0,30,30
1656164983122,MATH 10A,A02,083736,Patchell; Gregory David,22,0,30,8
1656164983122,MATH 10A,A03,083737,Patchell; Gregory David,16,0,30,14
1656164989161,MATH 10B,A01,083207,Lim; Seonhee,0,0,34,34
1656164989161,MATH 10B,A02,083208,Lim; Seonhee,7,0,35,28
1656164989161,MATH 10B,A03,093472,Staff,1,0,34,33
1656164989161,MATH 10B,B01,083739,Sinha; Shubham,10,0,30,20
1656164995197,MATH 18,A01,083743,Cinel; Cameron Alexander,7,0,30,23
1656164995197,MATH 18,A02,083744,Cinel; Cameron Alexander,10,0,30,20
1656164995197,MATH 18,A03,083745,Cinel; Cameron Alexander,4,0,30,26
1656164995197,MATH 18,B01,083748,Rideout; David Porter,0,0,36,36
1656164995197,MATH 18,B02,083749,Rideout; David Porter,0,0,36,36
1656164995197,MATH 18,B03,083750,Rideout; David Porter,0,0,36,36
1656164995197,MATH 18,B04,083751,Rideout; David Porter,0,0,36,36
1656164995197,MATH 18,B05,093473,Rideout; David Porter,1,0,36,35
1656164995197,MATH 18,B06,093474,Rideout; David Porter,3,0,36,33
1656165001223,MATH 20A,A01,083754,Zheng; Zequn,11,0,40,29
1656165007255,MATH 20B,A01,083756,Briones; Jor-el Thomas Caparas,0,0,36,36
1656165007255,MATH 20B,A02,083757,Briones; Jor-el Thomas Caparas,0,0,36,36
1656165007255,MATH 20B,A03,093475,Staff,2,0,36,34
1656165013281,MATH 20C,A01,083760,Briones; Jor-el Thomas Caparas,0,0,35,35
1656165013281,MATH 20C,A02,083761,Briones; Jor-el Thomas Caparas,9,1,35,26
1656165013281,MATH 20C,A03,093476,Staff,0,0,35,35
1656165013281,MATH 20C,B01,083762,Bach; Quang Tran,1,0,30,29
1656165019311,MATH 20D,A01,083765,Tran; Brian Kha,2,0,30,28
1656165019311,MATH 20D,A02,083766,Tran; Brian Kha,0,1,30,30
1656165019311,MATH 20D,A03,083767,Tran; Brian Kha,2,0,30,28
1656165025339,MATH 20E,A01,083771,Ganguly; Soumya,4,0,32,28
1656165025339,MATH 20E,A02,083772,Ganguly; Soumya,0,0,32,32
1656165025339,MATH 20E,B01,083773,Ciotti; Benjamin,15,0,35,20
1656165025339,MATH 20E,B02,083774,Ciotti; Benjamin,15,0,35,20
1656165031378,MATH 103A,A01,083777,Greenfeld; Be'Eri,1,0,36,35
1656165031378,MATH 103A,A02,083778,Greenfeld; Be'Eri,1,0,36,35
1656165031378,MATH 103A,A03,093561,Staff,4,0,36,32
1656165031378,MATH 103A,B01,083779,Greenfeld; Be'Eri,8,1,36,28
1656165031378,MATH 103A,B02,083780,Greenfeld; Be'Eri,1,0,36,35
1656165031378,MATH 103A,B03,093562,Staff,0,0,36,36
1656165037406,MATH 105,A01,085443,Carter; Anne Toulson,5,1,35,30
1656165037406,MATH 105,A02,093477,Staff,11,0,35,24
1656165043436,MATH 109,A01,083213,Ganzberger; Geoffrey Michael,0,0,34,34
1656165043436,MATH 109,A02,083214,Ganzberger; Geoffrey Michael,0,0,34,34
1656165043436,MATH 109,A03,093478,Staff,1,0,34,33
1656165043436,MATH 109,B01,083215,Ganzberger; Geoffrey Michael,4,0,32,28
1656165043436,MATH 109,B02,083216,Ganzberger; Geoffrey Michael,1,0,32,31
1656165043436,MATH 109,B03,093479,Staff,4,0,32,28
1656165049463,MATH 142A,A01,083219,Chow; Bennett,1,0,32,31
1656165049463,MATH 142A,A02,083220,Chow; Bennett,8,0,32,24
1656165049463,MATH 142A,A03,093480,Staff,5,0,32,27
1656165049463,MATH 142A,B03,093481,Staff,4,0,32,28
1656165049463,MATH 142A,B04,093558,Staff,6,0,32,26
1656165049463,MATH 142A,B05,093559,Staff,0,0,32,32
1656165055490,MATH 193A,A01,083224,Rotar; Vladimir,0,1,34,34
1656165055490,MATH 193A,A02,083225,Rotar; Vladimir,0,0,34,34
1656165055490,MATH 193A,A03,083781,Rotar; Vladimir,0,0,34,34
1656165055490,MATH 193A,A04,083782,Rotar; Vladimir,6,0,34,28
1656165055490,MATH 193A,A05,093482,Rotar; Vladimir,1,0,34,33
1656165061516,MATH 197,001,091859,McAuley; Julian John,9999,0,9999,0
1656165061516,MATH 197,002,095566,Kedlaya; Kiran S.,9997,0,9999,2
1656165061516,MATH 197,003,095567,Xiao; Ming,9999,0,9999,0
1656165061516,MATH 197,004,095571,Perols; Johan Lars,9998,0,9999,1
1656165068588,COGS 9,A01,083615,Shannon; Kyle Michael,4,0,75,71
1656165074621,COGS 11,A01,083617,Boyle; Mary E. T.,14,0,48,34
1656165080654,COGS 13,A01,083071,Bastos; Amalia Pinkusfeld,6,0,71,65
1656165086681,COGS 14A,A01,092681,Semenuks; Arturs,4,15,100,96
1656165092706,COGS 14B,A01,083073,Cheng; Tzu-Han,7,0,63,56
1656165098732,COGS 17,A01,092677,Semenuks; Arturs,8,0,81,73
1656165104759,COGS 100,A01,083619,Allen; Michael Gordon,2,0,70,68
1656165110794,COGS 101A,A01,083621,Davis; Joshua Daniel,3,0,68,65
1656165116837,COGS 101B,A01,091572,Allen; Michael Gordon,6,0,65,59
1656165122870,COGS 101C,A01,083625,Delgado; Tania,10,0,35,25
1656165128894,COGS 107A,A01,083627,Boyle; Mary E. T.,0,0,60,60
1656165134930,COGS 118A,A01,083075,Gupta; Anjum,7,0,76,69
1656165140963,CSE 3,A50,083646,Miranda; Gregory Joseph,18,0,50,32
1656165146988,CSE 8A,A50,083650,Miranda; Gregory Joseph,3,3,56,53
1656165153014,CSE 11,A01,083080,Cao; Yingjun,1,54,40,39
1656165159041,CSE 12,A01,083652,Krause-Levy; Sophia Louisa,7,2,120,113
1656165165071,CSE 15L,A01,083654,Morris; Justin Loren,2,0,50,48
1656165165071,CSE 15L,A02,083655,Morris; Justin Loren,4,0,50,46
1656165171102,CSE 20,A01,083657,Tran; Khoa Dang,31,0,80,49
1656165177128,CSE 21,A01,095574,Bach; Quang Tran,25,0,48,23
1656165183155,CSE 30,A01,083084,Eldon; John,2,8,80,78
1656165183155,CSE 30,B01,095061,Bhaskar; Nishant,1,2,50,49
1656165189187,CSE 100,A01,083659,Cao; Yingjun,2,20,70,68
1656165195213,CSE 134B,A01,083661,Powell; Thomas Allan,3,0,100,97
1656165201244,CSE 140,A01,083663,Gungor; Onat,9,0,85,76
1656165207291,CSE 140L,A01,083088,Eldon; John,8,0,100,92
1656165213324,CSE 175,A01,083665,Kumar; Rakesh,0,0,25,25
1656165219348,CSE 190,A00,092507,Dubnov; Shlomo,3,0,20,17
1656165225386,ECE 45,A01,083139,Congero; Spencer William,1,0,75,74
1656165231413,ECE 65,A50,083695,Saad; Andrew S,9,0,30,21
1656165231413,ECE 65,A51,095125,Staff,23,0,26,3
1656165237444,ECE 109,A01,091882,Touri; Behrouz,0,1,70,70
1656165243481,ECE 180,A00,083140,Abi Samra; Nicholas Camill,1,0,30,29
1656165243481,ECE 180,B00,083141,Abi Samra; Nicholas Camill,0,4,30,30
1656165249510,MATH 10A,A01,083735,Patchell; Gregory David,0,0,30,30
1656165249510,MATH 10A,A02,083736,Patchell; Gregory David,22,0,30,8
1656165249510,MATH 10A,A03,083737,Patchell; Gregory David,16,0,30,14
1656165255540,MATH 10B,A01,083207,Lim; Seonhee,0,0,34,34
1656165255540,MATH 10B,A02,083208,Lim; Seonhee,7,0,35,28
1656165255540,MATH 10B,A03,093472,Staff,1,0,34,33
1656165255540,MATH 10B,B01,083739,Sinha; Shubham,10,0,30,20
1656165261570,MATH 18,A01,083743,Cinel; Cameron Alexander,7,0,30,23
1656165261570,MATH 18,A02,083744,Cinel; Cameron Alexander,10,0,30,20
1656165261570,MATH 18,A03,083745,Cinel; Cameron Alexander,4,0,30,26
1656165261570,MATH 18,B01,083748,Rideout; David Porter,0,0,36,36
1656165261570,MATH 18,B02,083749,Rideout; David Porter,0,0,36,36
1656165261570,MATH 18,B03,083750,Rideout; David Porter,0,0,36,36
1656165261570,MATH 18,B04,083751,Rideout; David Porter,0,0,36,36
1656165261570,MATH 18,B05,093473,Rideout; David Porter,1,0,36,35
1656165261570,MATH 18,B06,093474,Rideout; David Porter,3,0,36,33
1656165267600,MATH 20A,A01,083754,Zheng; Zequn,11,0,40,29
1656165273627,MATH 20B,A01,083756,Briones; Jor-el Thomas Caparas,0,0,36,36
1656165273627,MATH 20B,A02,083757,Briones; Jor-el Thomas Caparas,0,0,36,36
1656165273627,MATH 20B,A03,093475,Staff,2,0,36,34
1656165279653,MATH 20C,A01,083760,Briones; Jor-el Thomas Caparas,0,0,35,35
1656165279653,MATH 20C,A02,083761,Briones; Jor-el Thomas Caparas,9,1,35,26
1656165279653,MATH 20C,A03,093476,Staff,0,0,35,35
1656165279653,MATH 20C,B01,083762,Bach; Quang Tran,1,0,30,29
1656165285681,MATH 20D,A01,083765,Tran; Brian Kha,2,0,30,28
1656165285681,MATH 20D,A02,083766,Tran; Brian Kha,0,1,30,30
1656165285681,MATH 20D,A03,083767,Tran; Brian Kha,2,0,30,28
1656165291792,MATH 20E,A01,083771,Ganguly; Soumya,4,0,32,28
1656165291792,MATH 20E,A02,083772,Ganguly; Soumya,0,0,32,32
1656165291792,MATH 20E,B01,083773,Ciotti; Benjamin,15,0,35,20
1656165291792,MATH 20E,B02,083774,Ciotti; Benjamin,15,0,35,20
1656165297819,MATH 103A,A01,083777,Greenfeld; Be'Eri,1,0,36,35
1656165297819,MATH 103A,A02,083778,Greenfeld; Be'Eri,1,0,36,35
1656165297819,MATH 103A,A03,093561,Staff,5,0,36,31
1656165297819,MATH 103A,B01,083779,Greenfeld; Be'Eri,8,1,36,28
1656165297819,MATH 103A,B02,083780,Greenfeld; Be'Eri,1,0,36,35
1656165297819,MATH 103A,B03,093562,Staff,0,0,36,36
1656165303853,MATH 105,A01,085443,Carter; Anne Toulson,5,1,35,30
1656165303853,MATH 105,A02,093477,Staff,11,0,35,24
1656165309882,MATH 109,A01,083213,Ganzberger; Geoffrey Michael,0,0,34,34
1656165309882,MATH 109,A02,083214,Ganzberger; Geoffrey Michael,0,0,34,34
1656165309882,MATH 109,A03,093478,Staff,1,0,34,33
1656165309882,MATH 109,B01,083215,Ganzberger; Geoffrey Michael,4,0,32,28
1656165309882,MATH 109,B02,083216,Ganzberger; Geoffrey Michael,1,0,32,31
1656165309882,MATH 109,B03,093479,Staff,4,0,32,28
1656165315909,MATH 142A,A01,083219,Chow; Bennett,1,0,32,31
1656165315909,MATH 142A,A02,083220,Chow; Bennett,8,0,32,24
1656165315909,MATH 142A,A03,093480,Staff,5,0,32,27
1656165315909,MATH 142A,B03,093481,Staff,4,0,32,28
1656165315909,MATH 142A,B04,093558,Staff,6,0,32,26
1656165315909,MATH 142A,B05,093559,Staff,0,0,32,32
1656165321933,MATH 193A,A01,083224,Rotar; Vladimir,0,1,34,34
1656165321933,MATH 193A,A02,083225,Rotar; Vladimir,0,0,34,34
1656165321933,MATH 193A,A03,083781,Rotar; Vladimir,0,0,34,34
1656165321933,MATH 193A,A04,083782,Rotar; Vladimir,6,0,34,28
1656165321933,MATH 193A,A05,093482,Rotar; Vladimir,1,0,34,33
1656165327958,MATH 197,001,091859,McAuley; Julian John,9999,0,9999,0
1656165327958,MATH 197,002,095566,Kedlaya; Kiran S.,9997,0,9999,2
1656165327958,MATH 197,003,095567,Xiao; Ming,9999,0,9999,0
1656165327958,MATH 197,004,095571,Perols; Johan Lars,9998,0,9999,1
1656165335020,COGS 9,A01,083615,Shannon; Kyle Michael,4,0,75,71
1656165341046,COGS 11,A01,083617,Boyle; Mary E. T.,14,0,48,34
1656165347091,COGS 13,A01,083071,Bastos; Amalia Pinkusfeld,6,0,71,65
1656165353122,COGS 14A,A01,092681,Semenuks; Arturs,4,15,100,96
1656165359149,COGS 14B,A01,083073,Cheng; Tzu-Han,7,0,63,56
1656165365175,COGS 17,A01,092677,Semenuks; Arturs,8,0,81,73
1656165371207,COGS 100,A01,083619,Allen; Michael Gordon,2,0,70,68
1656165377239,COGS 101A,A01,083621,Davis; Joshua Daniel,3,0,68,65
1656165383265,COGS 101B,A01,091572,Allen; Michael Gordon,6,0,65,59
1656165389296,COGS 101C,A01,083625,Delgado; Tania,10,0,35,25
1656165395325,COGS 107A,A01,083627,Boyle; Mary E. T.,0,0,60,60
1656165401355,COGS 118A,A01,083075,Gupta; Anjum,7,0,76,69
1656165407384,CSE 3,A50,083646,Miranda; Gregory Joseph,18,0,50,32
1656165413410,CSE 8A,A50,083650,Miranda; Gregory Joseph,3,3,56,53
1656165419435,CSE 11,A01,083080,Cao; Yingjun,1,54,40,39
1656165425466,CSE 12,A01,083652,Krause-Levy; Sophia Louisa,7,2,120,113
1656165431500,CSE 15L,A01,083654,Morris; Justin Loren,2,0,50,48
1656165431500,CSE 15L,A02,083655,Morris; Justin Loren,4,0,50,46
1656165437526,CSE 20,A01,083657,Tran; Khoa Dang,31,0,80,49
1656165443558,CSE 21,A01,095574,Bach; Quang Tran,25,0,48,23
1656165449596,CSE 30,A01,083084,Eldon; John,2,8,80,78
1656165449596,CSE 30,B01,095061,Bhaskar; Nishant,1,2,50,49
1656165455637,CSE 100,A01,083659,Cao; Yingjun,2,20,70,68
1656165461667,CSE 134B,A01,083661,Powell; Thomas Allan,3,0,100,97
1656165467697,CSE 140,A01,083663,Gungor; Onat,9,0,85,76
1656165473722,CSE 140L,A01,083088,Eldon; John,8,0,100,92
1656165479752,CSE 175,A01,083665,Kumar; Rakesh,0,0,25,25
1656165485778,CSE 190,A00,092507,Dubnov; Shlomo,3,0,20,17
1656165491806,ECE 45,A01,083139,Congero; Spencer William,1,0,75,74
1656165497841,ECE 65,A50,083695,Saad; Andrew S,9,0,30,21
1656165497841,ECE 65,A51,095125,Staff,23,0,26,3
1656165503884,ECE 109,A01,091882,Touri; Behrouz,0,1,70,70
1656165509909,ECE 180,A00,083140,Abi Samra; Nicholas Camill,1,0,30,29
1656165509909,ECE 180,B00,083141,Abi Samra; Nicholas Camill,0,4,30,30
1656165515936,MATH 10A,A01,083735,Patchell; Gregory David,0,0,30,30
1656165515936,MATH 10A,A02,083736,Patchell; Gregory David,22,0,30,8
1656165515936,MATH 10A,A03,083737,Patchell; Gregory David,16,0,30,14
1656165521968,MATH 10B,A01,083207,Lim; Seonhee,0,0,34,34
1656165521968,MATH 10B,A02,083208,Lim; Seonhee,7,0,35,28
1656165521968,MATH 10B,A03,093472,Staff,1,0,34,33
1656165521968,MATH 10B,B01,083739,Sinha; Shubham,10,0,30,20
1656165527999,MATH 18,A01,083743,Cinel; Cameron Alexander,7,0,30,23
1656165527999,MATH 18,A02,083744,Cinel; Cameron Alexander,10,0,30,20
1656165527999,MATH 18,A03,083745,Cinel; Cameron Alexander,4,0,30,26
1656165527999,MATH 18,B01,083748,Rideout; David Porter,0,0,36,36
1656165527999,MATH 18,B02,083749,Rideout; David Porter,0,0,36,36
1656165527999,MATH 18,B03,083750,Rideout; David Porter,0,0,36,36
1656165527999,MATH 18,B04,083751,Rideout; David Porter,0,0,36,36
1656165527999,MATH 18,B05,093473,Rideout; David Porter,1,0,36,35
1656165527999,MATH 18,B06,093474,Rideout; David Porter,3,0,36,33
1656165534025,MATH 20A,A01,083754,Zheng; Zequn,11,0,40,29
1656165540050,MATH 20B,A01,083756,Briones; Jor-el Thomas Caparas,0,0,36,36
1656165540050,MATH 20B,A02,083757,Briones; Jor-el Thomas Caparas,0,0,36,36
1656165540050,MATH 20B,A03,093475,Staff,2,0,36,34
1656165546102,MATH 20C,A01,083760,Briones; Jor-el Thomas Caparas,0,0,35,35
1656165546102,MATH 20C,A02,083761,Briones; Jor-el Thomas Caparas,9,1,35,26
1656165546102,MATH 20C,A03,093476,Staff,0,0,35,35
1656165546102,MATH 20C,B01,083762,Bach; Quang Tran,1,0,30,29
1656165552129,MATH 20D,A01,083765,Tran; Brian Kha,2,0,30,28
1656165552129,MATH 20D,A02,083766,Tran; Brian Kha,0,1,30,30
1656165552129,MATH 20D,A03,083767,Tran; Brian Kha,2,0,30,28
1656165558156,MATH 20E,A01,083771,Ganguly; Soumya,4,0,32,28
1656165558156,MATH 20E,A02,083772,Ganguly; Soumya,0,0,32,32
1656165558156,MATH 20E,B01,083773,Ciotti; Benjamin,15,0,35,20
1656165558156,MATH 20E,B02,083774,Ciotti; Benjamin,15,0,35,20
1656165564184,MATH 103A,A01,083777,Greenfeld; Be'Eri,1,0,36,35
1656165564184,MATH 103A,A02,083778,Greenfeld; Be'Eri,1,0,36,35
1656165564184,MATH 103A,A03,093561,Staff,5,0,36,31
1656165564184,MATH 103A,B01,083779,Greenfeld; Be'Eri,8,1,36,28
1656165564184,MATH 103A,B02,083780,Greenfeld; Be'Eri,1,0,36,35
1656165564184,MATH 103A,B03,093562,Staff,0,0,36,36
1656165570210,MATH 105,A01,085443,Carter; Anne Toulson,5,1,35,30
1656165570210,MATH 105,A02,093477,Staff,11,0,35,24
1656165576237,MATH 109,A01,083213,Ganzberger; Geoffrey Michael,0,0,34,34
1656165576237,MATH 109,A02,083214,Ganzberger; Geoffrey Michael,0,0,34,34
1656165576237,MATH 109,A03,093478,Staff,1,0,34,33
1656165576237,MATH 109,B01,083215,Ganzberger; Geoffrey Michael,4,0,32,28
1656165576237,MATH 109,B02,083216,Ganzberger; Geoffrey Michael,1,0,32,31
1656165576237,MATH 109,B03,093479,Staff,4,0,32,28
1656165582263,MATH 142A,A01,083219,Chow; Bennett,1,0,32,31
1656165582263,MATH 142A,A02,083220,Chow; Bennett,8,0,32,24
1656165582263,MATH 142A,A03,093480,Staff,5,0,32,27
1656165582263,MATH 142A,B03,093481,Staff,4,0,32,28
1656165582263,MATH 142A,B04,093558,Staff,6,0,32,26
1656165582263,MATH 142A,B05,093559,Staff,0,0,32,32
1656165588291,MATH 193A,A01,083224,Rotar; Vladimir,0,1,34,34
1656165588291,MATH 193A,A02,083225,Rotar; Vladimir,0,0,34,34
1656165588291,MATH 193A,A03,083781,Rotar; Vladimir,0,0,34,34
1656165588291,MATH 193A,A04,083782,Rotar; Vladimir,6,0,34,28
1656165588291,MATH 193A,A05,093482,Rotar; Vladimir,1,0,34,33
1656165594317,MATH 197,001,091859,McAuley; Julian John,9999,0,9999,0
1656165594317,MATH 197,002,095566,Kedlaya; Kiran S.,9997,0,9999,2
1656165594317,MATH 197,003,095567,Xiao; Ming,9999,0,9999,0
1656165594317,MATH 197,004,095571,Perols; Johan Lars,9998,0,9999,1
1656165601400,COGS 9,A01,083615,Shannon; Kyle Michael,4,0,75,71
1656165607425,COGS 11,A01,083617,Boyle; Mary E. T.,14,0,48,34
1656165613460,COGS 13,A01,083071,Bastos; Amalia Pinkusfeld,6,0,71,65
1656165619484,COGS 14A,A01,092681,Semenuks; Arturs,4,15,100,96
1656165625508,COGS 14B,A01,083073,Cheng; Tzu-Han,7,0,63,56
1656165631537,COGS 17,A01,092677,Semenuks; Arturs,8,0,81,73
1656165637565,COGS 100,A01,083619,Allen; Michael Gordon,2,0,70,68
1656165643592,COGS 101A,A01,083621,Davis; Joshua Daniel,3,0,68,65
1656165649632,COGS 101B,A01,091572,Allen; Michael Gordon,6,0,65,59
1656165655657,COGS 101C,A01,083625,Delgado; Tania,10,0,35,25
1656165661682,COGS 107A,A01,083627,Boyle; Mary E. T.,0,0,60,60
1656165667712,COGS 118A,A01,083075,Gupta; Anjum,7,0,76,69
1656165673742,CSE 3,A50,083646,Miranda; Gregory Joseph,18,0,50,32
1656165679768,CSE 8A,A50,083650,Miranda; Gregory Joseph,3,3,56,53
1656165685800,CSE 11,A01,083080,Cao; Yingjun,1,54,40,39
1656165691832,CSE 12,A01,083652,Krause-Levy; Sophia Louisa,7,2,120,113
1656165697861,CSE 15L,A01,083654,Morris; Justin Loren,2,0,50,48
1656165697861,CSE 15L,A02,083655,Morris; Justin Loren,4,0,50,46
1656165703894,CSE 20,A01,083657,Tran; Khoa Dang,31,0,80,49
1656165709920,CSE 21,A01,095574,Bach; Quang Tran,25,0,48,23
1656165715948,CSE 30,A01,083084,Eldon; John,2,8,80,78
1656165715948,CSE 30,B01,095061,Bhaskar; Nishant,1,2,50,49
1656165721981,CSE 100,A01,083659,Cao; Yingjun,2,20,70,68
1656165728008,CSE 134B,A01,083661,Powell; Thomas Allan,3,0,100,97
1656165734038,CSE 140,A01,083663,Gungor; Onat,9,0,85,76
1656165740065,CSE 140L,A01,083088,Eldon; John,8,0,100,92
1656165746098,CSE 175,A01,083665,Kumar; Rakesh,0,0,25,25
1656165752125,CSE 190,A00,092507,Dubnov; Shlomo,3,0,20,17
1656165758159,ECE 45,A01,083139,Congero; Spencer William,1,0,75,74
1656165764198,ECE 65,A50,083695,Saad; Andrew S,9,0,30,21
1656165764198,ECE 65,A51,095125,Staff,23,0,26,3
1656165770223,ECE 109,A01,091882,Touri; Behrouz,0,1,70,70
1656165776254,ECE 180,A00,083140,Abi Samra; Nicholas Camill,1,0,30,29
1656165776254,ECE 180,B00,083141,Abi Samra; Nicholas Camill,0,4,30,30
1656165782282,MATH 10A,A01,083735,Patchell; Gregory David,0,0,30,30
1656165782282,MATH 10A,A02,083736,Patchell; Gregory David,22,0,30,8
1656165782282,MATH 10A,A03,083737,Patchell; Gregory David,16,0,30,14
1656165788310,MATH 10B,A01,083207,Lim; Seonhee,0,0,34,34
1656165788310,MATH 10B,A02,083208,Lim; Seonhee,7,0,35,28
1656165788310,MATH 10B,A03,093472,Staff,1,0,34,33
1656165788310,MATH 10B,B01,083739,Sinha; Shubham,10,0,30,20
1656165794339,MATH 18,A01,083743,Cinel; Cameron Alexander,7,0,30,23
1656165794339,MATH 18,A02,083744,Cinel; Cameron Alexander,10,0,30,20
1656165794339,MATH 18,A03,083745,Cinel; Cameron Alexander,4,0,30,26
1656165794339,MATH 18,B01,083748,Rideout; David Porter,0,0,36,36
1656165794339,MATH 18,B02,083749,Rideout; David Porter,0,0,36,36
1656165794339,MATH 18,B03,083750,Rideout; David Porter,0,0,36,36
1656165794339,MATH 18,B04,083751,Rideout; David Porter,0,0,36,36
1656165794339,MATH 18,B05,093473,Rideout; David Porter,1,0,36,35
1656165794339,MATH 18,B06,093474,Rideout; David Porter,3,0,36,33
1656165800372,MATH 20A,A01,083754,Zheng; Zequn,11,0,40,29
1656165806400,MATH 20B,A01,083756,Briones; Jor-el Thomas Caparas,0,0,36,36
1656165806400,MATH 20B,A02,083757,Briones; Jor-el Thomas Caparas,0,0,36,36
1656165806400,MATH 20B,A03,093475,Staff,2,0,36,34
1656165812427,MATH 20C,A01,083760,Briones; Jor-el Thomas Caparas,0,0,35,35
1656165812427,MATH 20C,A02,083761,Briones; Jor-el Thomas Caparas,9,1,35,26
1656165812427,MATH 20C,A03,093476,Staff,0,0,35,35
1656165812427,MATH 20C,B01,083762,Bach; Quang Tran,1,0,30,29
1656165818452,MATH 20D,A01,083765,Tran; Brian Kha,2,0,30,28
1656165818452,MATH 20D,A02,083766,Tran; Brian Kha,0,1,30,30
1656165818452,MATH 20D,A03,083767,Tran; Brian Kha,2,0,30,28
1656165824479,MATH 20E,A01,083771,Ganguly; Soumya,4,0,32,28
1656165824479,MATH 20E,A02,083772,Ganguly; Soumya,0,0,32,32
1656165824479,MATH 20E,B01,083773,Ciotti; Benjamin,15,0,35,20
1656165824479,MATH 20E,B02,083774,Ciotti; Benjamin,15,0,35,20
1656165830514,MATH 103A,A01,083777,Greenfeld; Be'Eri,1,0,36,35
1656165830514,MATH 103A,A02,083778,Greenfeld; Be'Eri,1,0,36,35
1656165830514,MATH 103A,A03,093561,Staff,5,0,36,31
1656165830514,MATH 103A,B01,083779,Greenfeld; Be'Eri,8,1,36,28
1656165830514,MATH 103A,B02,083780,Greenfeld; Be'Eri,1,0,36,35
1656165830514,MATH 103A,B03,093562,Staff,0,0,36,36
1656165836548,MATH 105,A01,085443,Carter; Anne Toulson,5,1,35,30
1656165836548,MATH 105,A02,093477,Staff,11,0,35,24
1656165842577,MATH 109,A01,083213,Ganzberger; Geoffrey Michael,0,0,34,34
1656165842577,MATH 109,A02,083214,Ganzberger; Geoffrey Michael,0,0,34,34
1656165842577,MATH 109,A03,093478,Staff,1,0,34,33
1656165842577,MATH 109,B01,083215,Ganzberger; Geoffrey Michael,4,0,32,28
1656165842577,MATH 109,B02,083216,Ganzberger; Geoffrey Michael,1,0,32,31
1656165842577,MATH 109,B03,093479,Staff,4,0,32,28
1656165848611,MATH 142A,A01,083219,Chow; Bennett,1,0,32,31
1656165848611,MATH 142A,A02,083220,Chow; Bennett,8,0,32,24
1656165848611,MATH 142A,A03,093480,Staff,5,0,32,27
1656165848611,MATH 142A,B03,093481,Staff,4,0,32,28
1656165848611,MATH 142A,B04,093558,Staff,6,0,32,26
1656165848611,MATH 142A,B05,093559,Staff,0,0,32,32
1656165854645,MATH 193A,A01,083224,Rotar; Vladimir,0,1,34,34
1656165854645,MATH 193A,A02,083225,Rotar; Vladimir,0,0,34,34
1656165854645,MATH 193A,A03,083781,Rotar; Vladimir,0,0,34,34
1656165854645,MATH 193A,A04,083782,Rotar; Vladimir,6,0,34,28
1656165854645,MATH 193A,A05,093482,Rotar; Vladimir,1,0,34,33
1656165860670,MATH 197,001,091859,McAuley; Julian John,9999,0,9999,0
1656165860670,MATH 197,002,095566,Kedlaya; Kiran S.,9997,0,9999,2
1656165860670,MATH 197,003,095567,Xiao; Ming,9999,0,9999,0
1656165860670,MATH 197,004,095571,Perols; Johan Lars,9998,0,9999,1
1656165867744,COGS 9,A01,083615,Shannon; Kyle Michael,4,0,75,71
1656165873770,COGS 11,A01,083617,Boyle; Mary E. T.,14,0,48,34
1656165879805,COGS 13,A01,083071,Bastos; Amalia Pinkusfeld,6,0,71,65
1656165885930,COGS 14A,A01,092681,Semenuks; Arturs,4,15,100,96
1656165891956,COGS 14B,A01,083073,Cheng; Tzu-Han,7,0,63,56
1656165897987,COGS 17,A01,092677,Semenuks; Arturs,8,0,81,73
1656165904020,COGS 100,A01,083619,Allen; Michael Gordon,2,0,70,68
1656165910045,COGS 101A,A01,083621,Davis; Joshua Daniel,3,0,68,65
1656165916070,COGS 101B,A01,091572,Allen; Michael Gordon,6,0,65,59
1656165922103,COGS 101C,A01,083625,Delgado; Tania,10,0,35,25
1656165928128,COGS 107A,A01,083627,Boyle; Mary E. T.,0,0,60,60
1656165934158,COGS 118A,A01,083075,Gupta; Anjum,7,0,76,69
1656165940190,CSE 3,A50,083646,Miranda; Gregory Joseph,18,0,50,32
1656165946225,CSE 8A,A50,083650,Miranda; Gregory Joseph,3,3,56,53
1656165952252,CSE 11,A01,083080,Cao; Yingjun,1,54,40,39
1656165958277,CSE 12,A01,083652,Krause-Levy; Sophia Louisa,7,2,120,113
1656165964308,CSE 15L,A01,083654,Morris; Justin Loren,2,0,50,48
1656165964308,CSE 15L,A02,083655,Morris; Justin Loren,4,0,50,46
1656165970338,CSE 20,A01,083657,Tran; Khoa Dang,31,0,80,49
1656165976365,CSE 21,A01,095574,Bach; Quang Tran,25,0,48,23
1656165982397,CSE 30,A01,083084,Eldon; John,2,8,80,78
1656165982397,CSE 30,B01,095061,Bhaskar; Nishant,1,2,50,49
1656165988427,CSE 100,A01,083659,Cao; Yingjun,2,20,70,68
1656165994452,CSE 134B,A01,083661,Powell; Thomas Allan,3,0,100,97
1656166000488,CSE 140,A01,083663,Gungor; Onat,9,0,85,76
1656166006513,CSE 140L,A01,083088,Eldon; John,8,0,100,92
1656166012542,CSE 175,A01,083665,Kumar; Rakesh,0,0,25,25
1656166018572,CSE 190,A00,092507,Dubnov; Shlomo,3,0,20,17
1656166024598,ECE 45,A01,083139,Congero; Spencer William,1,0,75,74
1656166030624,ECE 65,A50,083695,Saad; Andrew S,9,0,30,21
1656166030624,ECE 65,A51,095125,Staff,23,0,26,3
1656166036649,ECE 109,A01,091882,Touri; Behrouz,0,1,70,70
1656166042681,ECE 180,A00,083140,Abi Samra; Nicholas Camill,1,0,30,29
1656166042681,ECE 180,B00,083141,Abi Samra; Nicholas Camill,0,4,30,30
1656166048709,MATH 10A,A01,083735,Patchell; Gregory David,0,0,30,30
1656166048709,MATH 10A,A02,083736,Patchell; Gregory David,22,0,30,8
1656166048709,MATH 10A,A03,083737,Patchell; Gregory David,16,0,30,14
1656166054742,MATH 10B,A01,083207,Lim; Seonhee,0,0,34,34
1656166054742,MATH 10B,A02,083208,Lim; Seonhee,7,0,35,28
1656166054742,MATH 10B,A03,093472,Staff,1,0,34,33
1656166054742,MATH 10B,B01,083739,Sinha; Shubham,10,0,30,20
1656166060771,MATH 18,A01,083743,Cinel; Cameron Alexander,7,0,30,23
1656166060771,MATH 18,A02,083744,Cinel; Cameron Alexander,10,0,30,20
1656166060771,MATH 18,A03,083745,Cinel; Cameron Alexander,4,0,30,26
1656166060771,MATH 18,B01,083748,Rideout; David Porter,0,0,36,36
1656166060771,MATH 18,B02,083749,Rideout; David Porter,0,0,36,36
1656166060771,MATH 18,B03,083750,Rideout; David Porter,0,0,36,36
1656166060771,MATH 18,B04,083751,Rideout; David Porter,0,0,36,36
1656166060771,MATH 18,B05,093473,Rideout; David Porter,1,0,36,35
1656166060771,MATH 18,B06,093474,Rideout; David Porter,3,0,36,33
1656166066800,MATH 20A,A01,083754,Zheng; Zequn,11,0,40,29
1656166072828,MATH 20B,A01,083756,Briones; Jor-el Thomas Caparas,0,0,36,36
1656166072828,MATH 20B,A02,083757,Briones; Jor-el Thomas Caparas,0,0,36,36
1656166072828,MATH 20B,A03,093475,Staff,2,0,36,34
1656166078860,MATH 20C,A01,083760,Briones; Jor-el Thomas Caparas,0,0,35,35
1656166078860,MATH 20C,A02,083761,Briones; Jor-el Thomas Caparas,9,1,35,26
1656166078860,MATH 20C,A03,093476,Staff,0,0,35,35
1656166078860,MATH 20C,B01,083762,Bach; Quang Tran,1,0,30,29
1656166084907,MATH 20D,A01,083765,Tran; Brian Kha,2,0,30,28
1656166084907,MATH 20D,A02,083766,Tran; Brian Kha,0,1,30,30
1656166084907,MATH 20D,A03,083767,Tran; Brian Kha,2,0,30,28
1656166090933,MATH 20E,A01,083771,Ganguly; Soumya,4,0,32,28
1656166090933,MATH 20E,A02,083772,Ganguly; Soumya,0,0,32,32
1656166090933,MATH 20E,B01,083773,Ciotti; Benjamin,15,0,35,20
1656166090933,MATH 20E,B02,083774,Ciotti; Benjamin,15,0,35,20
1656166096961,MATH 103A,A01,083777,Greenfeld; Be'Eri,1,0,36,35
1656166096961,MATH 103A,A02,083778,Greenfeld; Be'Eri,1,0,36,35
1656166096961,MATH 103A,A03,093561,Staff,5,0,36,31
1656166096961,MATH 103A,B01,083779,Greenfeld; Be'Eri,8,1,36,28
1656166096961,MATH 103A,B02,083780,Greenfeld; Be'Eri,1,0,36,35
1656166096961,MATH 103A,B03,093562,Staff,0,0,36,36
1656166102993,MATH 105,A01,085443,Carter; Anne Toulson,5,1,35,30
1656166102993,MATH 105,A02,093477,Staff,11,0,35,24
1656166109022,MATH 109,A01,083213,Ganzberger; Geoffrey Michael,0,0,34,34
1656166109022,MATH 109,A02,083214,Ganzberger; Geoffrey Michael,0,0,34,34
1656166109022,MATH 109,A03,093478,Staff,1,0,34,33
1656166109022,MATH 109,B01,083215,Ganzberger; Geoffrey Michael,4,0,32,28
1656166109022,MATH 109,B02,083216,Ganzberger; Geoffrey Michael,1,0,32,31
1656166109022,MATH 109,B03,093479,Staff,4,0,32,28
1656166115048,MATH 142A,A01,083219,Chow; Bennett,1,0,32,31
1656166115048,MATH 142A,A02,083220,Chow; Bennett,8,0,32,24
1656166115048,MATH 142A,A03,093480,Staff,5,0,32,27
1656166115048,MATH 142A,B03,093481,Staff,4,0,32,28
1656166115048,MATH 142A,B04,093558,Staff,6,0,32,26
1656166115048,MATH 142A,B05,093559,Staff,0,0,32,32
1656166121081,MATH 193A,A01,083224,Rotar; Vladimir,0,1,34,34
1656166121081,MATH 193A,A02,083225,Rotar; Vladimir,0,0,34,34
1656166121081,MATH 193A,A03,083781,Rotar; Vladimir,0,0,34,34
1656166121081,MATH 193A,A04,083782,Rotar; Vladimir,6,0,34,28
1656166121081,MATH 193A,A05,093482,Rotar; Vladimir,1,0,34,33
1656166127112,MATH 197,001,091859,McAuley; Julian John,9999,0,9999,0
1656166127112,MATH 197,002,095566,Kedlaya; Kiran S.,9997,0,9999,2
1656166127112,MATH 197,003,095567,Xiao; Ming,9999,0,9999,0
1656166127112,MATH 197,004,095571,Perols; Johan Lars,9998,0,9999,1
1656166134174,COGS 9,A01,083615,Shannon; Kyle Michael,4,0,75,71
1656166140204,COGS 11,A01,083617,Boyle; Mary E. T.,14,0,48,34
1656166146230,COGS 13,A01,083071,Bastos; Amalia Pinkusfeld,6,0,71,65
1656166152256,COGS 14A,A01,092681,Semenuks; Arturs,4,15,100,96
1656166158284,COGS 14B,A01,083073,Cheng; Tzu-Han,7,0,63,56
1656166164308,COGS 17,A01,092677,Semenuks; Arturs,8,0,81,73
1656166170333,COGS 100,A01,083619,Allen; Michael Gordon,2,0,70,68
1656166176358,COGS 101A,A01,083621,Davis; Joshua Daniel,3,0,68,65
1656166182387,COGS 101B,A01,091572,Allen; Michael Gordon,6,0,65,59
1656166188419,COGS 101C,A01,083625,Delgado; Tania,10,0,35,25
1656166194445,COGS 107A,A01,083627,Boyle; Mary E. T.,0,0,60,60
1656166200474,COGS 118A,A01,083075,Gupta; Anjum,7,0,76,69
1656166206501,CSE 3,A50,083646,Miranda; Gregory Joseph,18,0,50,32
1656166212526,CSE 8A,A50,083650,Miranda; Gregory Joseph,3,3,56,53
1656166218564,CSE 11,A01,083080,Cao; Yingjun,1,54,40,39
1656166224594,CSE 12,A01,083652,Krause-Levy; Sophia Louisa,7,2,120,113
1656166230620,CSE 15L,A01,083654,Morris; Justin Loren,2,0,50,48
1656166230620,CSE 15L,A02,083655,Morris; Justin Loren,4,0,50,46
1656166236655,CSE 20,A01,083657,Tran; Khoa Dang,31,0,80,49
1656166242684,CSE 21,A01,095574,Bach; Quang Tran,25,0,48,23
1656166248713,CSE 30,A01,083084,Eldon; John,2,8,80,78
1656166248713,CSE 30,B01,095061,Bhaskar; Nishant,1,2,50,49
1656166254746,CSE 100,A01,083659,Cao; Yingjun,2,20,70,68
1656166260771,CSE 134B,A01,083661,Powell; Thomas Allan,3,0,100,97
1656166266807,CSE 140,A01,083663,Gungor; Onat,9,0,85,76
1656166272832,CSE 140L,A01,083088,Eldon; John,8,0,100,92
1656166278862,CSE 175,A01,083665,Kumar; Rakesh,0,0,25,25
1656166284889,CSE 190,A00,092507,Dubnov; Shlomo,3,0,20,17
1656166290928,ECE 45,A01,083139,Congero; Spencer William,1,0,75,74
1656166296956,ECE 65,A50,083695,Saad; Andrew S,9,0,30,21
1656166296956,ECE 65,A51,095125,Staff,23,0,26,3
1656166302983,ECE 109,A01,091882,Touri; Behrouz,0,1,70,70
1656166309015,ECE 180,A00,083140,Abi Samra; Nicholas Camill,1,0,30,29
1656166309015,ECE 180,B00,083141,Abi Samra; Nicholas Camill,0,4,30,30
1656166315049,MATH 10A,A01,083735,Patchell; Gregory David,0,0,30,30
1656166315049,MATH 10A,A02,083736,Patchell; Gregory David,22,0,30,8
1656166315049,MATH 10A,A03,083737,Patchell; Gregory David,16,0,30,14
1656166321088,MATH 10B,A01,083207,Lim; Seonhee,0,0,34,34
1656166321088,MATH 10B,A02,083208,Lim; Seonhee,7,0,35,28
1656166321088,MATH 10B,A03,093472,Staff,1,0,34,33
1656166321088,MATH 10B,B01,083739,Sinha; Shubham,10,0,30,20
1656166327128,MATH 18,A01,083743,Cinel; Cameron Alexander,7,0,30,23
1656166327128,MATH 18,A02,083744,Cinel; Cameron Alexander,10,0,30,20
1656166327128,MATH 18,A03,083745,Cinel; Cameron Alexander,4,0,30,26
1656166327128,MATH 18,B01,083748,Rideout; David Porter,0,0,36,36
1656166327128,MATH 18,B02,083749,Rideout; David Porter,0,0,36,36
1656166327128,MATH 18,B03,083750,Rideout; David Porter,0,0,36,36
1656166327128,MATH 18,B04,083751,Rideout; David Porter,0,0,36,36
1656166327128,MATH 18,B05,093473,Rideout; David Porter,1,0,36,35
1656166327128,MATH 18,B06,093474,Rideout; David Porter,3,0,36,33
1656166333154,MATH 20A,A01,083754,Zheng; Zequn,11,0,40,29
1656166339180,MATH 20B,A01,083756,Briones; Jor-el Thomas Caparas,0,0,36,36
1656166339180,MATH 20B,A02,083757,Briones; Jor-el Thomas Caparas,0,0,36,36
1656166339180,MATH 20B,A03,093475,Staff,2,0,36,34
1656166345211,MATH 20C,A01,083760,Briones; Jor-el Thomas Caparas,0,0,35,35
1656166345211,MATH 20C,A02,083761,Briones; Jor-el Thomas Caparas,9,1,35,26
1656166345211,MATH 20C,A03,093476,Staff,0,0,35,35
1656166345211,MATH 20C,B01,083762,Bach; Quang Tran,1,0,30,29
1656166351243,MATH 20D,A01,083765,Tran; Brian Kha,2,0,30,28
1656166351243,MATH 20D,A02,083766,Tran; Brian Kha,0,1,30,30
1656166351243,MATH 20D,A03,083767,Tran; Brian Kha,2,0,30,28
1656166357273,MATH 20E,A01,083771,Ganguly; Soumya,4,0,32,28
1656166357273,MATH 20E,A02,083772,Ganguly; Soumya,0,0,32,32
1656166357273,MATH 20E,B01,083773,Ciotti; Benjamin,15,0,35,20
1656166357273,MATH 20E,B02,083774,Ciotti; Benjamin,15,0,35,20
1656166363309,MATH 103A,A01,083777,Greenfeld; Be'Eri,1,0,36,35
1656166363309,MATH 103A,A02,083778,Greenfeld; Be'Eri,1,0,36,35
1656166363309,MATH 103A,A03,093561,Staff,5,0,36,31
1656166363309,MATH 103A,B01,083779,Greenfeld; Be'Eri,8,1,36,28
1656166363309,MATH 103A,B02,083780,Greenfeld; Be'Eri,1,0,36,35
1656166363309,MATH 103A,B03,093562,Staff,0,0,36,36
1656166369333,MATH 105,A01,085443,Carter; Anne Toulson,5,1,35,30
1656166369333,MATH 105,A02,093477,Staff,11,0,35,24
1656166375356,MATH 109,A01,083213,Ganzberger; Geoffrey Michael,0,0,34,34
1656166375356,MATH 109,A02,083214,Ganzberger; Geoffrey Michael,0,0,34,34
1656166375356,MATH 109,A03,093478,Staff,1,0,34,33
1656166375356,MATH 109,B01,083215,Ganzberger; Geoffrey Michael,4,0,32,28
1656166375356,MATH 109,B02,083216,Ganzberger; Geoffrey Michael,1,0,32,31
1656166375356,MATH 109,B03,093479,Staff,4,0,32,28
1656166381390,MATH 142A,A01,083219,Chow; Bennett,1,0,32,31
1656166381390,MATH 142A,A02,083220,Chow; Bennett,8,0,32,24
1656166381390,MATH 142A,A03,093480,Staff,5,0,32,27
1656166381390,MATH 142A,B03,093481,Staff,4,0,32,28
1656166381390,MATH 142A,B04,093558,Staff,6,0,32,26
1656166381390,MATH 142A,B05,093559,Staff,0,0,32,32
1656166387420,MATH 193A,A01,083224,Rotar; Vladimir,0,1,34,34
1656166387420,MATH 193A,A02,083225,Rotar; Vladimir,0,0,34,34
1656166387420,MATH 193A,A03,083781,Rotar; Vladimir,0,0,34,34
1656166387420,MATH 193A,A04,083782,Rotar; Vladimir,6,0,34,28
1656166387420,MATH 193A,A05,093482,Rotar; Vladimir,1,0,34,33
1656166393451,MATH 197,001,091859,McAuley; Julian John,9999,0,9999,0
1656166393451,MATH 197,002,095566,Kedlaya; Kiran S.,9997,0,9999,2
1656166393451,MATH 197,003,095567,Xiao; Ming,9999,0,9999,0
1656166393451,MATH 197,004,095571,Perols; Johan Lars,9998,0,9999,1
1656166400520,COGS 9,A01,083615,Shannon; Kyle Michael,4,0,75,71
1656166406560,COGS 11,A01,083617,Boyle; Mary E. T.,14,0,48,34
1656166412586,COGS 13,A01,083071,Bastos; Amalia Pinkusfeld,6,0,71,65
1656166418616,COGS 14A,A01,092681,Semenuks; Arturs,4,15,100,96
1656166424642,COGS 14B,A01,083073,Cheng; Tzu-Han,7,0,63,56
1656166430669,COGS 17,A01,092677,Semenuks; Arturs,8,0,81,73
1656166436701,COGS 100,A01,083619,Allen; Michael Gordon,2,0,70,68
1656166442730,COGS 101A,A01,083621,Davis; Joshua Daniel,3,0,68,65
1656166448756,COGS 101B,A01,091572,Allen; Michael Gordon,6,0,65,59
1656166454799,COGS 101C,A01,083625,Delgado; Tania,10,0,35,25
1656166460835,COGS 107A,A01,083627,Boyle; Mary E. T.,0,0,60,60
1656166466865,COGS 118A,A01,083075,Gupta; Anjum,7,0,76,69
1656166472893,CSE 3,A50,083646,Miranda; Gregory Joseph,18,0,50,32
1656166478918,CSE 8A,A50,083650,Miranda; Gregory Joseph,3,3,56,53
1656166485016,CSE 11,A01,083080,Cao; Yingjun,1,54,40,39
1656166491048,CSE 12,A01,083652,Krause-Levy; Sophia Louisa,7,2,120,113
1656166497073,CSE 15L,A01,083654,Morris; Justin Loren,2,0,50,48
1656166497073,CSE 15L,A02,083655,Morris; Justin Loren,4,0,50,46
1656166503100,CSE 20,A01,083657,Tran; Khoa Dang,31,0,80,49
1656166509126,CSE 21,A01,095574,Bach; Quang Tran,25,0,48,23
1656166515153,CSE 30,A01,083084,Eldon; John,2,8,80,78
1656166515153,CSE 30,B01,095061,Bhaskar; Nishant,1,2,50,49
1656166521183,CSE 100,A01,083659,Cao; Yingjun,2,20,70,68
1656166527209,CSE 134B,A01,083661,Powell; Thomas Allan,3,0,100,97
1656166533239,CSE 140,A01,083663,Gungor; Onat,9,0,85,76
1656166539265,CSE 140L,A01,083088,Eldon; John,8,0,100,92
1656166545299,CSE 175,A01,083665,Kumar; Rakesh,0,0,25,25
1656166551334,CSE 190,A00,092507,Dubnov; Shlomo,3,0,20,17
1656166557368,ECE 45,A01,083139,Congero; Spencer William,1,0,75,74
1656166563395,ECE 65,A50,083695,Saad; Andrew S,9,0,30,21
1656166563395,ECE 65,A51,095125,Staff,23,0,26,3
1656166569421,ECE 109,A01,091882,Touri; Behrouz,0,1,70,70
1656166575452,ECE 180,A00,083140,Abi Samra; Nicholas Camill,1,0,30,29
1656166575452,ECE 180,B00,083141,Abi Samra; Nicholas Camill,0,4,30,30
1656166581485,MATH 10A,A01,083735,Patchell; Gregory David,0,0,30,30
1656166581485,MATH 10A,A02,083736,Patchell; Gregory David,22,0,30,8
1656166581485,MATH 10A,A03,083737,Patchell; Gregory David,16,0,30,14
1656166587514,MATH 10B,A01,083207,Lim; Seonhee,0,0,34,34
1656166587514,MATH 10B,A02,083208,Lim; Seonhee,7,0,35,28
1656166587514,MATH 10B,A03,093472,Staff,1,0,34,33
1656166587514,MATH 10B,B01,083739,Sinha; Shubham,10,0,30,20
1656166593543,MATH 18,A01,083743,Cinel; Cameron Alexander,7,0,30,23
1656166593543,MATH 18,A02,083744,Cinel; Cameron Alexander,10,0,30,20
1656166593543,MATH 18,A03,083745,Cinel; Cameron Alexander,4,0,30,26
1656166593543,MATH 18,B01,083748,Rideout; David Porter,0,0,36,36
1656166593543,MATH 18,B02,083749,Rideout; David Porter,0,0,36,36
1656166593543,MATH 18,B03,083750,Rideout; David Porter,0,0,36,36
1656166593543,MATH 18,B04,083751,Rideout; David Porter,0,0,36,36
1656166593543,MATH 18,B05,093473,Rideout; David Porter,1,0,36,35
1656166593543,MATH 18,B06,093474,Rideout; David Porter,3,0,36,33
1656166599572,MATH 20A,A01,083754,Zheng; Zequn,11,0,40,29
1656166605604,MATH 20B,A01,083756,Briones; Jor-el Thomas Caparas,0,0,36,36
1656166605604,MATH 20B,A02,083757,Briones; Jor-el Thomas Caparas,0,0,36,36
1656166605604,MATH 20B,A03,093475,Staff,2,0,36,34
1656166611637,MATH 20C,A01,083760,Briones; Jor-el Thomas Caparas,0,0,35,35
1656166611637,MATH 20C,A02,083761,Briones; Jor-el Thomas Caparas,9,1,35,26
1656166611637,MATH 20C,A03,093476,Staff,0,0,35,35
1656166611637,MATH 20C,B01,083762,Bach; Quang Tran,1,0,30,29
1656166617663,MATH 20D,A01,083765,Tran; Brian Kha,2,0,30,28
1656166617663,MATH 20D,A02,083766,Tran; Brian Kha,0,1,30,30
1656166617663,MATH 20D,A03,083767,Tran; Brian Kha,2,0,30,28
1656166623700,MATH 20E,A01,083771,Ganguly; Soumya,4,0,32,28
1656166623700,MATH 20E,A02,083772,Ganguly; Soumya,0,0,32,32
1656166623700,MATH 20E,B01,083773,Ciotti; Benjamin,15,0,35,20
1656166623700,MATH 20E,B02,083774,Ciotti; Benjamin,15,0,35,20
1656166629737,MATH 103A,A01,083777,Greenfeld; Be'Eri,1,0,36,35
1656166629737,MATH 103A,A02,083778,Greenfeld; Be'Eri,1,0,36,35
1656166629737,MATH 103A,A03,093561,Staff,5,0,36,31
1656166629737,MATH 103A,B01,083779,Greenfeld; Be'Eri,8,1,36,28
1656166629737,MATH 103A,B02,083780,Greenfeld; Be'Eri,1,0,36,35
1656166629737,MATH 103A,B03,093562,Staff,0,0,36,36
1656166635762,MATH 105,A01,085443,Carter; Anne Toulson,5,1,35,30
1656166635762,MATH 105,A02,093477,Staff,11,0,35,24
1656166641789,MATH 109,A01,083213,Ganzberger; Geoffrey Michael,0,0,34,34
1656166641789,MATH 109,A02,083214,Ganzberger; Geoffrey Michael,0,0,34,34
1656166641789,MATH 109,A03,093478,Staff,1,0,34,33
1656166641789,MATH 109,B01,083215,Ganzberger; Geoffrey Michael,4,0,32,28
1656166641789,MATH 109,B02,083216,Ganzberger; Geoffrey Michael,1,0,32,31
1656166641789,MATH 109,B03,093479,Staff,4,0,32,28
1656166647825,MATH 142A,A01,083219,Chow; Bennett,1,0,32,31
1656166647825,MATH 142A,A02,083220,Chow; Bennett,8,0,32,24
1656166647825,MATH 142A,A03,093480,Staff,5,0,32,27
1656166647825,MATH 142A,B03,093481,Staff,4,0,32,28
1656166647825,MATH 142A,B04,093558,Staff,6,0,32,26
1656166647825,MATH 142A,B05,093559,Staff,0,0,32,32
1656166653850,MATH 193A,A01,083224,Rotar; Vladimir,0,1,34,34
1656166653850,MATH 193A,A02,083225,Rotar; Vladimir,0,0,34,34
1656166653850,MATH 193A,A03,083781,Rotar; Vladimir,0,0,34,34
1656166653850,MATH 193A,A04,083782,Rotar; Vladimir,6,0,34,28
1656166653850,MATH 193A,A05,093482,Rotar; Vladimir,1,0,34,33
1656166659881,MATH 197,001,091859,McAuley; Julian John,9999,0,9999,0
1656166659881,MATH 197,002,095566,Kedlaya; Kiran S.,9997,0,9999,2
1656166659881,MATH 197,003,095567,Xiao; Ming,9999,0,9999,0
1656166659881,MATH 197,004,095571,Perols; Johan Lars,9998,0,9999,1
1656166666963,COGS 9,A01,083615,Shannon; Kyle Michael,4,0,75,71
1656166672990,COGS 11,A01,083617,Boyle; Mary E. T.,14,0,48,34
1656166679016,COGS 13,A01,083071,Bastos; Amalia Pinkusfeld,6,0,71,65
1656166685047,COGS 14A,A01,092681,Semenuks; Arturs,4,15,100,96
1656166691076,COGS 14B,A01,083073,Cheng; Tzu-Han,7,0,63,56
1656166697100,COGS 17,A01,092677,Semenuks; Arturs,8,0,81,73
1656166703134,COGS 100,A01,083619,Allen; Michael Gordon,2,0,70,68
1656166709162,COGS 101A,A01,083621,Davis; Joshua Daniel,3,0,68,65
1656166715186,COGS 101B,A01,091572,Allen; Michael Gordon,6,0,65,59
1656166721212,COGS 101C,A01,083625,Delgado; Tania,10,0,35,25
1656166727237,COGS 107A,A01,083627,Boyle; Mary E. T.,0,0,60,60
1656166733261,COGS 118A,A01,083075,Gupta; Anjum,7,0,76,69
1656166739291,CSE 3,A50,083646,Miranda; Gregory Joseph,18,0,50,32
1656166745316,CSE 8A,A50,083650,Miranda; Gregory Joseph,3,3,56,53
1656166751340,CSE 11,A01,083080,Cao; Yingjun,1,54,40,39
1656166757367,CSE 12,A01,083652,Krause-Levy; Sophia Louisa,7,2,120,113
1656166763392,CSE 15L,A01,083654,Morris; Justin Loren,2,0,50,48
1656166763392,CSE 15L,A02,083655,Morris; Justin Loren,4,0,50,46
1656166769417,CSE 20,A01,083657,Tran; Khoa Dang,31,0,80,49
1656166775443,CSE 21,A01,095574,Bach; Quang Tran,25,0,48,23
1656166781474,CSE 30,A01,083084,Eldon; John,2,8,80,78
1656166781474,CSE 30,B01,095061,Bhaskar; Nishant,1,2,50,49
1656166787507,CSE 100,A01,083659,Cao; Yingjun,2,20,70,68
1656166793536,CSE 134B,A01,083661,Powell; Thomas Allan,3,0,100,97
1656166799568,CSE 140,A01,083663,Gungor; Onat,9,0,85,76
1656166805595,CSE 140L,A01,083088,Eldon; John,8,0,100,92
1656166811622,CSE 175,A01,083665,Kumar; Rakesh,0,0,25,25
1656166817652,CSE 190,A00,092507,Dubnov; Shlomo,3,0,20,17
1656166823683,ECE 45,A01,083139,Congero; Spencer William,1,0,75,74
1656166829710,ECE 65,A50,083695,Saad; Andrew S,9,0,30,21
1656166829710,ECE 65,A51,095125,Staff,23,0,26,3
1656166835737,ECE 109,A01,091882,Touri; Behrouz,0,1,70,70
1656166841765,ECE 180,A00,083140,Abi Samra; Nicholas Camill,1,0,30,29
1656166841765,ECE 180,B00,083141,Abi Samra; Nicholas Camill,0,4,30,30
1656166847800,MATH 10A,A01,083735,Patchell; Gregory David,0,0,30,30
1656166847800,MATH 10A,A02,083736,Patchell; Gregory David,22,0,30,8
1656166847800,MATH 10A,A03,083737,Patchell; Gregory David,16,0,30,14
1656166853831,MATH 10B,A01,083207,Lim; Seonhee,0,0,34,34
1656166853831,MATH 10B,A02,083208,Lim; Seonhee,7,0,35,28
1656166853831,MATH 10B,A03,093472,Staff,1,0,34,33
1656166853831,MATH 10B,B01,083739,Sinha; Shubham,10,0,30,20
1656166859870,MATH 18,A01,083743,Cinel; Cameron Alexander,7,0,30,23
1656166859870,MATH 18,A02,083744,Cinel; Cameron Alexander,10,0,30,20
1656166859870,MATH 18,A03,083745,Cinel; Cameron Alexander,4,0,30,26
1656166859870,MATH 18,B01,083748,Rideout; David Porter,0,0,36,36
1656166859870,MATH 18,B02,083749,Rideout; David Porter,0,0,36,36
1656166859870,MATH 18,B03,083750,Rideout; David Porter,0,0,36,36
1656166859870,MATH 18,B04,083751,Rideout; David Porter,0,0,36,36
1656166859870,MATH 18,B05,093473,Rideout; David Porter,1,0,36,35
1656166859870,MATH 18,B06,093474,Rideout; David Porter,3,0,36,33
1656166865898,MATH 20A,A01,083754,Zheng; Zequn,11,0,40,29
1656166871930,MATH 20B,A01,083756,Briones; Jor-el Thomas Caparas,0,0,36,36
1656166871930,MATH 20B,A02,083757,Briones; Jor-el Thomas Caparas,0,0,36,36
1656166871930,MATH 20B,A03,093475,Staff,2,0,36,34
1656166877965,MATH 20C,A01,083760,Briones; Jor-el Thomas Caparas,0,0,35,35
1656166877965,MATH 20C,A02,083761,Briones; Jor-el Thomas Caparas,9,1,35,26
1656166877965,MATH 20C,A03,093476,Staff,0,0,35,35
1656166877965,MATH 20C,B01,083762,Bach; Quang Tran,1,0,30,29
1656166883991,MATH 20D,A01,083765,Tran; Brian Kha,2,0,30,28
1656166883991,MATH 20D,A02,083766,Tran; Brian Kha,0,1,30,30
1656166883991,MATH 20D,A03,083767,Tran; Brian Kha,2,0,30,28
1656166890021,MATH 20E,A01,083771,Ganguly; Soumya,4,0,32,28
1656166890021,MATH 20E,A02,083772,Ganguly; Soumya,0,0,32,32
1656166890021,MATH 20E,B01,083773,Ciotti; Benjamin,15,0,35,20
1656166890021,MATH 20E,B02,083774,Ciotti; Benjamin,15,0,35,20
1656166896057,MATH 103A,A01,083777,Greenfeld; Be'Eri,1,0,36,35
1656166896057,MATH 103A,A02,083778,Greenfeld; Be'Eri,1,0,36,35
1656166896057,MATH 103A,A03,093561,Staff,5,0,36,31
1656166896057,MATH 103A,B01,083779,Greenfeld; Be'Eri,8,1,36,28
1656166896057,MATH 103A,B02,083780,Greenfeld; Be'Eri,1,0,36,35
1656166896057,MATH 103A,B03,093562,Staff,0,0,36,36
1656166902082,MATH 105,A01,085443,Carter; Anne Toulson,5,1,35,30
1656166902082,MATH 105,A02,093477,Staff,11,0,35,24
1656166908116,MATH 109,A01,083213,Ganzberger; Geoffrey Michael,0,0,34,34
1656166908116,MATH 109,A02,083214,Ganzberger; Geoffrey Michael,0,0,34,34
1656166908116,MATH 109,A03,093478,Staff,1,0,34,33
1656166908116,MATH 109,B01,083215,Ganzberger; Geoffrey Michael,4,0,32,28
1656166908116,MATH 109,B02,083216,Ganzberger; Geoffrey Michael,1,0,32,31
1656166908116,MATH 109,B03,093479,Staff,4,0,32,28
1656166914149,MATH 142A,A01,083219,Chow; Bennett,1,0,32,31
1656166914149,MATH 142A,A02,083220,Chow; Bennett,8,0,32,24
1656166914149,MATH 142A,A03,093480,Staff,5,0,32,27
1656166914149,MATH 142A,B03,093481,Staff,4,0,32,28
1656166914149,MATH 142A,B04,093558,Staff,6,0,32,26
1656166914149,MATH 142A,B05,093559,Staff,0,0,32,32
1656166920180,MATH 193A,A01,083224,Rotar; Vladimir,0,1,34,34
1656166920180,MATH 193A,A02,083225,Rotar; Vladimir,0,0,34,34
1656166920180,MATH 193A,A03,083781,Rotar; Vladimir,0,0,34,34
1656166920180,MATH 193A,A04,083782,Rotar; Vladimir,6,0,34,28
1656166920180,MATH 193A,A05,093482,Rotar; Vladimir,1,0,34,33
1656166926211,MATH 197,001,091859,McAuley; Julian John,9999,0,9999,0
1656166926211,MATH 197,002,095566,Kedlaya; Kiran S.,9997,0,9999,2
1656166926211,MATH 197,003,095567,Xiao; Ming,9999,0,9999,0
1656166926211,MATH 197,004,095571,Perols; Johan Lars,9998,0,9999,1
1656166933289,COGS 9,A01,083615,Shannon; Kyle Michael,4,0,75,71
1656166939313,COGS 11,A01,083617,Boyle; Mary E. T.,14,0,48,34
1656166945345,COGS 13,A01,083071,Bastos; Amalia Pinkusfeld,6,0,71,65
1656166951369,COGS 14A,A01,092681,Semenuks; Arturs,4,15,100,96
1656166957393,COGS 14B,A01,083073,Cheng; Tzu-Han,7,0,63,56
1656166963417,COGS 17,A01,092677,Semenuks; Arturs,8,0,81,73
1656166969447,COGS 100,A01,083619,Allen; Michael Gordon,2,0,70,68
1656166975474,COGS 101A,A01,083621,Davis; Joshua Daniel,3,0,68,65
1656166981503,COGS 101B,A01,091572,Allen; Michael Gordon,6,0,65,59
1656166987527,COGS 101C,A01,083625,Delgado; Tania,10,0,35,25
1656166993549,COGS 107A,A01,083627,Boyle; Mary E. T.,0,0,60,60
1656166999577,COGS 118A,A01,083075,Gupta; Anjum,7,0,76,69
1656167005604,CSE 3,A50,083646,Miranda; Gregory Joseph,18,0,50,32
1656167011635,CSE 8A,A50,083650,Miranda; Gregory Joseph,3,3,56,53
1656167017663,CSE 11,A01,083080,Cao; Yingjun,1,54,40,39
1656167023696,CSE 12,A01,083652,Krause-Levy; Sophia Louisa,7,2,120,113
1656167029722,CSE 15L,A01,083654,Morris; Justin Loren,2,0,50,48
1656167029722,CSE 15L,A02,083655,Morris; Justin Loren,4,0,50,46
1656167035749,CSE 20,A01,083657,Tran; Khoa Dang,31,0,80,49
1656167041775,CSE 21,A01,095574,Bach; Quang Tran,25,0,48,23
1656167047803,CSE 30,A01,083084,Eldon; John,2,8,80,78
1656167047803,CSE 30,B01,095061,Bhaskar; Nishant,1,2,50,49
1656167053829,CSE 100,A01,083659,Cao; Yingjun,2,20,70,68
1656167059864,CSE 134B,A01,083661,Powell; Thomas Allan,3,0,100,97
1656167065890,CSE 140,A01,083663,Gungor; Onat,9,0,85,76
1656167071920,CSE 140L,A01,083088,Eldon; John,8,0,100,92
1656167077950,CSE 175,A01,083665,Kumar; Rakesh,0,0,25,25
1656167084052,CSE 190,A00,092507,Dubnov; Shlomo,3,0,20,17
1656167090084,ECE 45,A01,083139,Congero; Spencer William,1,0,75,74
1656167096110,ECE 65,A50,083695,Saad; Andrew S,9,0,30,21
1656167096110,ECE 65,A51,095125,Staff,23,0,26,3
1656167102139,ECE 109,A01,091882,Touri; Behrouz,0,1,70,70
1656167108163,ECE 180,A00,083140,Abi Samra; Nicholas Camill,1,0,30,29
1656167108163,ECE 180,B00,083141,Abi Samra; Nicholas Camill,0,4,30,30
1656167114192,MATH 10A,A01,083735,Patchell; Gregory David,0,0,30,30
1656167114192,MATH 10A,A02,083736,Patchell; Gregory David,22,0,30,8
1656167114192,MATH 10A,A03,083737,Patchell; Gregory David,16,0,30,14
1656167120226,MATH 10B,A01,083207,Lim; Seonhee,0,0,34,34
1656167120226,MATH 10B,A02,083208,Lim; Seonhee,7,0,35,28
1656167120226,MATH 10B,A03,093472,Staff,1,0,34,33
1656167120226,MATH 10B,B01,083739,Sinha; Shubham,10,0,30,20
1656167126264,MATH 18,A01,083743,Cinel; Cameron Alexander,7,0,30,23
1656167126264,MATH 18,A02,083744,Cinel; Cameron Alexander,10,0,30,20
1656167126264,MATH 18,A03,083745,Cinel; Cameron Alexander,4,0,30,26
1656167126264,MATH 18,B01,083748,Rideout; David Porter,0,0,36,36
1656167126264,MATH 18,B02,083749,Rideout; David Porter,0,0,36,36
1656167126264,MATH 18,B03,083750,Rideout; David Porter,0,0,36,36
1656167126264,MATH 18,B04,083751,Rideout; David Porter,0,0,36,36
1656167126264,MATH 18,B05,093473,Rideout; David Porter,1,0,36,35
1656167126264,MATH 18,B06,093474,Rideout; David Porter,3,0,36,33
1656167132291,MATH 20A,A01,083754,Zheng; Zequn,11,0,40,29
1656167138322,MATH 20B,A01,083756,Briones; Jor-el Thomas Caparas,0,0,36,36
1656167138322,MATH 20B,A02,083757,Briones; Jor-el Thomas Caparas,0,0,36,36
1656167138322,MATH 20B,A03,093475,Staff,2,0,36,34
1656167144349,MATH 20C,A01,083760,Briones; Jor-el Thomas Caparas,0,0,35,35
1656167144349,MATH 20C,A02,083761,Briones; Jor-el Thomas Caparas,9,1,35,26
1656167144349,MATH 20C,A03,093476,Staff,0,0,35,35
1656167144349,MATH 20C,B01,083762,Bach; Quang Tran,1,0,30,29
1656167150385,MATH 20D,A01,083765,Tran; Brian Kha,2,0,30,28
1656167150385,MATH 20D,A02,083766,Tran; Brian Kha,0,1,30,30
1656167150385,MATH 20D,A03,083767,Tran; Brian Kha,2,0,30,28
1656167156412,MATH 20E,A01,083771,Ganguly; Soumya,4,0,32,28
1656167156412,MATH 20E,A02,083772,Ganguly; Soumya,0,0,32,32
1656167156412,MATH 20E,B01,083773,Ciotti; Benjamin,15,0,35,20
1656167156412,MATH 20E,B02,083774,Ciotti; Benjamin,15,0,35,20
1656167162446,MATH 103A,A01,083777,Greenfeld; Be'Eri,1,0,36,35
1656167162446,MATH 103A,A02,083778,Greenfeld; Be'Eri,1,0,36,35
1656167162446,MATH 103A,A03,093561,Staff,5,0,36,31
1656167162446,MATH 103A,B01,083779,Greenfeld; Be'Eri,8,1,36,28
1656167162446,MATH 103A,B02,083780,Greenfeld; Be'Eri,1,0,36,35
1656167162446,MATH 103A,B03,093562,Staff,0,0,36,36
1656167168469,MATH 105,A01,085443,Carter; Anne Toulson,5,1,35,30
1656167168469,MATH 105,A02,093477,Staff,11,0,35,24
1656167174499,MATH 109,A01,083213,Ganzberger; Geoffrey Michael,0,0,34,34
1656167174499,MATH 109,A02,083214,Ganzberger; Geoffrey Michael,0,0,34,34
1656167174499,MATH 109,A03,093478,Staff,1,0,34,33
1656167174499,MATH 109,B01,083215,Ganzberger; Geoffrey Michael,4,0,32,28
1656167174499,MATH 109,B02,083216,Ganzberger; Geoffrey Michael,1,0,32,31
1656167174499,MATH 109,B03,093479,Staff,4,0,32,28
1656167180525,MATH 142A,A01,083219,Chow; Bennett,1,0,32,31
1656167180525,MATH 142A,A02,083220,Chow; Bennett,8,0,32,24
1656167180525,MATH 142A,A03,093480,Staff,5,0,32,27
1656167180525,MATH 142A,B03,093481,Staff,4,0,32,28
1656167180525,MATH 142A,B04,093558,Staff,6,0,32,26
1656167180525,MATH 142A,B05,093559,Staff,0,0,32,32
1656167186551,MATH 193A,A01,083224,Rotar; Vladimir,0,1,34,34
1656167186551,MATH 193A,A02,083225,Rotar; Vladimir,0,0,34,34
1656167186551,MATH 193A,A03,083781,Rotar; Vladimir,0,0,34,34
1656167186551,MATH 193A,A04,083782,Rotar; Vladimir,6,0,34,28
1656167186551,MATH 193A,A05,093482,Rotar; Vladimir,1,0,34,33
1656167192581,MATH 197,001,091859,McAuley; Julian John,9999,0,9999,0
1656167192581,MATH 197,002,095566,Kedlaya; Kiran S.,9997,0,9999,2
1656167192581,MATH 197,003,095567,Xiao; Ming,9999,0,9999,0
1656167192581,MATH 197,004,095571,Perols; Johan Lars,9998,0,9999,1
1656167199655,COGS 9,A01,083615,Shannon; Kyle Michael,4,0,75,71
1656167205680,COGS 11,A01,083617,Boyle; Mary E. T.,14,0,48,34
1656167211714,COGS 13,A01,083071,Bastos; Amalia Pinkusfeld,6,0,71,65
1656167217747,COGS 14A,A01,092681,Semenuks; Arturs,4,15,100,96
1656167223770,COGS 14B,A01,083073,Cheng; Tzu-Han,7,0,63,56
1656167229799,COGS 17,A01,092677,Semenuks; Arturs,8,0,81,73
1656167235828,COGS 100,A01,083619,Allen; Michael Gordon,2,0,70,68
1656167241862,COGS 101A,A01,083621,Davis; Joshua Daniel,3,0,68,65
1656167247892,COGS 101B,A01,091572,Allen; Michael Gordon,6,0,65,59
1656167253916,COGS 101C,A01,083625,Delgado; Tania,10,0,35,25
1656167259941,COGS 107A,A01,083627,Boyle; Mary E. T.,0,0,60,60
1656167265966,COGS 118A,A01,083075,Gupta; Anjum,7,0,76,69
1656167271999,CSE 3,A50,083646,Miranda; Gregory Joseph,18,0,50,32
1656167278025,CSE 8A,A50,083650,Miranda; Gregory Joseph,3,3,56,53
1656167284049,CSE 11,A01,083080,Cao; Yingjun,1,54,40,39
1656167290075,CSE 12,A01,083652,Krause-Levy; Sophia Louisa,7,2,120,113
1656167296100,CSE 15L,A01,083654,Morris; Justin Loren,2,0,50,48
1656167296100,CSE 15L,A02,083655,Morris; Justin Loren,4,0,50,46
1656167302125,CSE 20,A01,083657,Tran; Khoa Dang,31,0,80,49
1656167308154,CSE 21,A01,095574,Bach; Quang Tran,25,0,48,23
1656167314181,CSE 30,A01,083084,Eldon; John,2,8,80,78
1656167314181,CSE 30,B01,095061,Bhaskar; Nishant,1,2,50,49
1656167320206,CSE 100,A01,083659,Cao; Yingjun,2,20,70,68
1656167326230,CSE 134B,A01,083661,Powell; Thomas Allan,3,0,100,97
1656167332259,CSE 140,A01,083663,Gungor; Onat,9,0,85,76
1656167338283,CSE 140L,A01,083088,Eldon; John,8,0,100,92
1656167344307,CSE 175,A01,083665,Kumar; Rakesh,0,0,25,25
1656167350334,CSE 190,A00,092507,Dubnov; Shlomo,3,0,20,17
1656167356361,ECE 45,A01,083139,Congero; Spencer William,1,0,75,74
1656167362392,ECE 65,A50,083695,Saad; Andrew S,9,0,30,21
1656167362392,ECE 65,A51,095125,Staff,23,0,26,3
1656167368417,ECE 109,A01,091882,Touri; Behrouz,0,1,70,70
1656167374440,ECE 180,A00,083140,Abi Samra; Nicholas Camill,1,0,30,29
1656167374440,ECE 180,B00,083141,Abi Samra; Nicholas Camill,0,4,30,30
1656167380477,MATH 10A,A01,083735,Patchell; Gregory David,0,0,30,30
1656167380477,MATH 10A,A02,083736,Patchell; Gregory David,22,0,30,8
1656167380477,MATH 10A,A03,083737,Patchell; Gregory David,16,0,30,14
1656167386503,MATH 10B,A01,083207,Lim; Seonhee,0,0,34,34
1656167386503,MATH 10B,A02,083208,Lim; Seonhee,7,0,35,28
1656167386503,MATH 10B,A03,093472,Staff,1,0,34,33
1656167386503,MATH 10B,B01,083739,Sinha; Shubham,10,0,30,20
1656167392532,MATH 18,A01,083743,Cinel; Cameron Alexander,7,0,30,23
1656167392532,MATH 18,A02,083744,Cinel; Cameron Alexander,10,0,30,20
1656167392532,MATH 18,A03,083745,Cinel; Cameron Alexander,4,0,30,26
1656167392532,MATH 18,B01,083748,Rideout; David Porter,0,0,36,36
1656167392532,MATH 18,B02,083749,Rideout; David Porter,0,0,36,36
1656167392532,MATH 18,B03,083750,Rideout; David Porter,0,0,36,36
1656167392532,MATH 18,B04,083751,Rideout; David Porter,0,0,36,36
1656167392532,MATH 18,B05,093473,Rideout; David Porter,1,0,36,35
1656167392532,MATH 18,B06,093474,Rideout; David Porter,3,0,36,33
1656167398559,MATH 20A,A01,083754,Zheng; Zequn,11,0,40,29
1656167404592,MATH 20B,A01,083756,Briones; Jor-el Thomas Caparas,0,0,36,36
1656167404592,MATH 20B,A02,083757,Briones; Jor-el Thomas Caparas,0,0,36,36
1656167404592,MATH 20B,A03,093475,Staff,2,0,36,34
1656167410617,MATH 20C,A01,083760,Briones; Jor-el Thomas Caparas,0,0,35,35
1656167410617,MATH 20C,A02,083761,Briones; Jor-el Thomas Caparas,9,1,35,26
1656167410617,MATH 20C,A03,093476,Staff,0,0,35,35
1656167410617,MATH 20C,B01,083762,Bach; Quang Tran,1,0,30,29
1656167416647,MATH 20D,A01,083765,Tran; Brian Kha,2,0,30,28
1656167416647,MATH 20D,A02,083766,Tran; Brian Kha,0,1,30,30
1656167416647,MATH 20D,A03,083767,Tran; Brian Kha,2,0,30,28
1656167422680,MATH 20E,A01,083771,Ganguly; Soumya,4,0,32,28
1656167422680,MATH 20E,A02,083772,Ganguly; Soumya,0,0,32,32
1656167422680,MATH 20E,B01,083773,Ciotti; Benjamin,15,0,35,20
1656167422680,MATH 20E,B02,083774,Ciotti; Benjamin,15,0,35,20
1656167428712,MATH 103A,A01,083777,Greenfeld; Be'Eri,1,0,36,35
1656167428712,MATH 103A,A02,083778,Greenfeld; Be'Eri,1,0,36,35
1656167428712,MATH 103A,A03,093561,Staff,5,0,36,31
1656167428712,MATH 103A,B01,083779,Greenfeld; Be'Eri,8,1,36,28
1656167428712,MATH 103A,B02,083780,Greenfeld; Be'Eri,1,0,36,35
1656167428712,MATH 103A,B03,093562,Staff,0,0,36,36
1656167434736,MATH 105,A01,085443,Carter; Anne Toulson,5,1,35,30
1656167434736,MATH 105,A02,093477,Staff,11,0,35,24
1656167440761,MATH 109,A01,083213,Ganzberger; Geoffrey Michael,0,0,34,34
1656167440761,MATH 109,A02,083214,Ganzberger; Geoffrey Michael,0,0,34,34
1656167440761,MATH 109,A03,093478,Staff,1,0,34,33
1656167440761,MATH 109,B01,083215,Ganzberger; Geoffrey Michael,4,0,32,28
1656167440761,MATH 109,B02,083216,Ganzberger; Geoffrey Michael,1,0,32,31
1656167440761,MATH 109,B03,093479,Staff,4,0,32,28
1656167446790,MATH 142A,A01,083219,Chow; Bennett,1,0,32,31
1656167446790,MATH 142A,A02,083220,Chow; Bennett,8,0,32,24
1656167446790,MATH 142A,A03,093480,Staff,5,0,32,27
1656167446790,MATH 142A,B03,093481,Staff,4,0,32,28
1656167446790,MATH 142A,B04,093558,Staff,6,0,32,26
1656167446790,MATH 142A,B05,093559,Staff,0,0,32,32
1656167452822,MATH 193A,A01,083224,Rotar; Vladimir,0,1,34,34
1656167452822,MATH 193A,A02,083225,Rotar; Vladimir,0,0,34,34
1656167452822,MATH 193A,A03,083781,Rotar; Vladimir,0,0,34,34
1656167452822,MATH 193A,A04,083782,Rotar; Vladimir,6,0,34,28
1656167452822,MATH 193A,A05,093482,Rotar; Vladimir,1,0,34,33
1656167458852,MATH 197,001,091859,McAuley; Julian John,9999,0,9999,0
1656167458852,MATH 197,002,095566,Kedlaya; Kiran S.,9997,0,9999,2
1656167458852,MATH 197,003,095567,Xiao; Ming,9999,0,9999,0
1656167458852,MATH 197,004,095571,Perols; Johan Lars,9998,0,9999,1
1656167465909,COGS 9,A01,083615,Shannon; Kyle Michael,4,0,75,71
1656167471934,COGS 11,A01,083617,Boyle; Mary E. T.,14,0,48,34
1656167477959,COGS 13,A01,083071,Bastos; Amalia Pinkusfeld,6,0,71,65
1656167483988,COGS 14A,A01,092681,Semenuks; Arturs,4,15,100,96
1656167490013,COGS 14B,A01,083073,Cheng; Tzu-Han,7,0,63,56
1656167496042,COGS 17,A01,092677,Semenuks; Arturs,8,0,81,73
1656167502071,COGS 100,A01,083619,Allen; Michael Gordon,2,0,70,68
1656167508097,COGS 101A,A01,083621,Davis; Joshua Daniel,3,0,68,65
1656167514124,COGS 101B,A01,091572,Allen; Michael Gordon,6,0,65,59
1656167520148,COGS 101C,A01,083625,Delgado; Tania,10,0,35,25
1656167526175,COGS 107A,A01,083627,Boyle; Mary E. T.,0,0,60,60
1656167532212,COGS 118A,A01,083075,Gupta; Anjum,7,0,76,69
1656167538250,CSE 3,A50,083646,Miranda; Gregory Joseph,18,0,50,32
1656167544281,CSE 8A,A50,083650,Miranda; Gregory Joseph,3,3,56,53
1656167550319,CSE 11,A01,083080,Cao; Yingjun,1,54,40,39
1656167556347,CSE 12,A01,083652,Krause-Levy; Sophia Louisa,7,2,120,113
1656167562372,CSE 15L,A01,083654,Morris; Justin Loren,2,0,50,48
1656167562372,CSE 15L,A02,083655,Morris; Justin Loren,4,0,50,46
1656167568397,CSE 20,A01,083657,Tran; Khoa Dang,31,0,80,49
1656167574427,CSE 21,A01,095574,Bach; Quang Tran,25,0,48,23
1656167580460,CSE 30,A01,083084,Eldon; John,2,8,80,78
1656167580460,CSE 30,B01,095061,Bhaskar; Nishant,1,2,50,49
1656167586492,CSE 100,A01,083659,Cao; Yingjun,2,20,70,68
1656167592524,CSE 134B,A01,083661,Powell; Thomas Allan,3,0,100,97
1656167598547,CSE 140,A01,083663,Gungor; Onat,9,0,85,76
1656167604571,CSE 140L,A01,083088,Eldon; John,8,0,100,92
1656167610597,CSE 175,A01,083665,Kumar; Rakesh,0,0,25,25
1656167616621,CSE 190,A00,092507,Dubnov; Shlomo,3,0,20,17
1656167622657,ECE 45,A01,083139,Congero; Spencer William,1,0,75,74
1656167628692,ECE 65,A50,083695,Saad; Andrew S,9,0,30,21
1656167628692,ECE 65,A51,095125,Staff,23,0,26,3
1656167634718,ECE 109,A01,091882,Touri; Behrouz,0,1,70,70
1656167640755,ECE 180,A00,083140,Abi Samra; Nicholas Camill,1,0,30,29
1656167640755,ECE 180,B00,083141,Abi Samra; Nicholas Camill,0,4,30,30
1656167646793,MATH 10A,A01,083735,Patchell; Gregory David,0,0,30,30
1656167646793,MATH 10A,A02,083736,Patchell; Gregory David,22,0,30,8
1656167646793,MATH 10A,A03,083737,Patchell; Gregory David,16,0,30,14
1656167652835,MATH 10B,A01,083207,Lim; Seonhee,0,0,34,34
1656167652835,MATH 10B,A02,083208,Lim; Seonhee,7,0,35,28
1656167652835,MATH 10B,A03,093472,Staff,1,0,34,33
1656167652835,MATH 10B,B01,083739,Sinha; Shubham,10,0,30,20
1656167658862,MATH 18,A01,083743,Cinel; Cameron Alexander,7,0,30,23
1656167658862,MATH 18,A02,083744,Cinel; Cameron Alexander,10,0,30,20
1656167658862,MATH 18,A03,083745,Cinel; Cameron Alexander,4,0,30,26
1656167658862,MATH 18,B01,083748,Rideout; David Porter,0,0,36,36
1656167658862,MATH 18,B02,083749,Rideout; David Porter,0,0,36,36
1656167658862,MATH 18,B03,083750,Rideout; David Porter,0,0,36,36
1656167658862,MATH 18,B04,083751,Rideout; David Porter,0,0,36,36
1656167658862,MATH 18,B05,093473,Rideout; David Porter,1,0,36,35
1656167658862,MATH 18,B06,093474,Rideout; David Porter,3,0,36,33
1656167664889,MATH 20A,A01,083754,Zheng; Zequn,11,0,40,29
1656167670916,MATH 20B,A01,083756,Briones; Jor-el Thomas Caparas,0,0,36,36
1656167670916,MATH 20B,A02,083757,Briones; Jor-el Thomas Caparas,0,0,36,36
1656167670916,MATH 20B,A03,093475,Staff,2,0,36,34
1656167676943,MATH 20C,A01,083760,Briones; Jor-el Thomas Caparas,0,0,35,35
1656167676943,MATH 20C,A02,083761,Briones; Jor-el Thomas Caparas,9,1,35,26
1656167676943,MATH 20C,A03,093476,Staff,0,0,35,35
1656167676943,MATH 20C,B01,083762,Bach; Quang Tran,1,0,30,29
1656167683043,MATH 20D,A01,083765,Tran; Brian Kha,2,0,30,28
1656167683043,MATH 20D,A02,083766,Tran; Brian Kha,0,1,30,30
1656167683043,MATH 20D,A03,083767,Tran; Brian Kha,2,0,30,28
1656167689070,MATH 20E,A01,083771,Ganguly; Soumya,4,0,32,28
1656167689070,MATH 20E,A02,083772,Ganguly; Soumya,0,0,32,32
1656167689070,MATH 20E,B01,083773,Ciotti; Benjamin,15,0,35,20
1656167689070,MATH 20E,B02,083774,Ciotti; Benjamin,15,0,35,20
1656167695104,MATH 103A,A01,083777,Greenfeld; Be'Eri,1,0,36,35
1656167695104,MATH 103A,A02,083778,Greenfeld; Be'Eri,1,0,36,35
1656167695104,MATH 103A,A03,093561,Staff,5,0,36,31
1656167695104,MATH 103A,B01,083779,Greenfeld; Be'Eri,8,1,36,28
1656167695104,MATH 103A,B02,083780,Greenfeld; Be'Eri,1,0,36,35
1656167695104,MATH 103A,B03,093562,Staff,0,0,36,36
1656167701132,MATH 105,A01,085443,Carter; Anne Toulson,5,1,35,30
1656167701132,MATH 105,A02,093477,Staff,11,0,35,24
1656167707158,MATH 109,A01,083213,Ganzberger; Geoffrey Michael,0,0,34,34
1656167707158,MATH 109,A02,083214,Ganzberger; Geoffrey Michael,0,0,34,34
1656167707158,MATH 109,A03,093478,Staff,1,0,34,33
1656167707158,MATH 109,B01,083215,Ganzberger; Geoffrey Michael,4,0,32,28
1656167707158,MATH 109,B02,083216,Ganzberger; Geoffrey Michael,1,0,32,31
1656167707158,MATH 109,B03,093479,Staff,4,0,32,28
1656167713191,MATH 142A,A01,083219,Chow; Bennett,1,0,32,31
1656167713191,MATH 142A,A02,083220,Chow; Bennett,8,0,32,24
1656167713191,MATH 142A,A03,093480,Staff,5,0,32,27
1656167713191,MATH 142A,B03,093481,Staff,4,0,32,28
1656167713191,MATH 142A,B04,093558,Staff,6,0,32,26
1656167713191,MATH 142A,B05,093559,Staff,0,0,32,32
1656167719216,MATH 193A,A01,083224,Rotar; Vladimir,0,1,34,34
1656167719216,MATH 193A,A02,083225,Rotar; Vladimir,0,0,34,34
1656167719216,MATH 193A,A03,083781,Rotar; Vladimir,0,0,34,34
1656167719216,MATH 193A,A04,083782,Rotar; Vladimir,6,0,34,28
1656167719216,MATH 193A,A05,093482,Rotar; Vladimir,1,0,34,33
1656167725242,MATH 197,001,091859,McAuley; Julian John,9999,0,9999,0
1656167725242,MATH 197,002,095566,Kedlaya; Kiran S.,9997,0,9999,2
1656167725242,MATH 197,003,095567,Xiao; Ming,9999,0,9999,0
1656167725242,MATH 197,004,095571,Perols; Johan Lars,9998,0,9999,1
1656167732317,COGS 9,A01,083615,Shannon; Kyle Michael,4,0,75,71
1656167738343,COGS 11,A01,083617,Boyle; Mary E. T.,14,0,48,34
1656167744378,COGS 13,A01,083071,Bastos; Amalia Pinkusfeld,6,0,71,65
1656167750403,COGS 14A,A01,092681,Semenuks; Arturs,4,15,100,96
1656167756428,COGS 14B,A01,083073,Cheng; Tzu-Han,7,0,63,56
1656167762457,COGS 17,A01,092677,Semenuks; Arturs,8,0,81,73
1656167768488,COGS 100,A01,083619,Allen; Michael Gordon,2,0,70,68
1656167774514,COGS 101A,A01,083621,Davis; Joshua Daniel,3,0,68,65
1656167780545,COGS 101B,A01,091572,Allen; Michael Gordon,6,0,65,59
1656167786578,COGS 101C,A01,083625,Delgado; Tania,10,0,35,25
1656167792604,COGS 107A,A01,083627,Boyle; Mary E. T.,0,0,60,60
1656167798634,COGS 118A,A01,083075,Gupta; Anjum,7,0,76,69
1656167804667,CSE 3,A50,083646,Miranda; Gregory Joseph,18,0,50,32
1656167810692,CSE 8A,A50,083650,Miranda; Gregory Joseph,3,3,56,53
1656167816717,CSE 11,A01,083080,Cao; Yingjun,1,54,40,39
1656167822748,CSE 12,A01,083652,Krause-Levy; Sophia Louisa,7,2,120,113
1656167828773,CSE 15L,A01,083654,Morris; Justin Loren,2,0,50,48
1656167828773,CSE 15L,A02,083655,Morris; Justin Loren,4,0,50,46
1656167834799,CSE 20,A01,083657,Tran; Khoa Dang,31,0,80,49
1656167840824,CSE 21,A01,095574,Bach; Quang Tran,25,0,48,23
1656167846856,CSE 30,A01,083084,Eldon; John,2,8,80,78
1656167846856,CSE 30,B01,095061,Bhaskar; Nishant,1,2,50,49
1656167852888,CSE 100,A01,083659,Cao; Yingjun,2,20,70,68
1656167858921,CSE 134B,A01,083661,Powell; Thomas Allan,3,0,100,97
1656167864945,CSE 140,A01,083663,Gungor; Onat,9,0,85,76
1656167870973,CSE 140L,A01,083088,Eldon; John,8,0,100,92
1656167877003,CSE 175,A01,083665,Kumar; Rakesh,0,0,25,25
1656167883033,CSE 190,A00,092507,Dubnov; Shlomo,3,0,20,17
1656167889057,ECE 45,A01,083139,Congero; Spencer William,1,0,75,74
1656167895084,ECE 65,A50,083695,Saad; Andrew S,9,0,30,21
1656167895084,ECE 65,A51,095125,Staff,23,0,26,3
1656167901116,ECE 109,A01,091882,Touri; Behrouz,0,1,70,70
1656167907142,ECE 180,A00,083140,Abi Samra; Nicholas Camill,1,0,30,29
1656167907142,ECE 180,B00,083141,Abi Samra; Nicholas Camill,0,4,30,30
1656167913175,MATH 10A,A01,083735,Patchell; Gregory David,0,0,30,30
1656167913175,MATH 10A,A02,083736,Patchell; Gregory David,22,0,30,8
1656167913175,MATH 10A,A03,083737,Patchell; Gregory David,16,0,30,14
1656167919209,MATH 10B,A01,083207,Lim; Seonhee,0,0,34,34
1656167919209,MATH 10B,A02,083208,Lim; Seonhee,7,0,35,28
1656167919209,MATH 10B,A03,093472,Staff,1,0,34,33
1656167919209,MATH 10B,B01,083739,Sinha; Shubham,10,0,30,20
1656167925239,MATH 18,A01,083743,Cinel; Cameron Alexander,7,0,30,23
1656167925239,MATH 18,A02,083744,Cinel; Cameron Alexander,10,0,30,20
1656167925239,MATH 18,A03,083745,Cinel; Cameron Alexander,4,0,30,26
1656167925239,MATH 18,B01,083748,Rideout; David Porter,0,0,36,36
1656167925239,MATH 18,B02,083749,Rideout; David Porter,0,0,36,36
1656167925239,MATH 18,B03,083750,Rideout; David Porter,0,0,36,36
1656167925239,MATH 18,B04,083751,Rideout; David Porter,0,0,36,36
1656167925239,MATH 18,B05,093473,Rideout; David Porter,1,0,36,35
1656167925239,MATH 18,B06,093474,Rideout; David Porter,3,0,36,33
1656167931267,MATH 20A,A01,083754,Zheng; Zequn,11,0,40,29
1656167937295,MATH 20B,A01,083756,Briones; Jor-el Thomas Caparas,0,0,36,36
1656167937295,MATH 20B,A02,083757,Briones; Jor-el Thomas Caparas,0,0,36,36
1656167937295,MATH 20B,A03,093475,Staff,2,0,36,34
1656167943322,MATH 20C,A01,083760,Briones; Jor-el Thomas Caparas,0,0,35,35
1656167943322,MATH 20C,A02,083761,Briones; Jor-el Thomas Caparas,9,1,35,26
1656167943322,MATH 20C,A03,093476,Staff,0,0,35,35
1656167943322,MATH 20C,B01,083762,Bach; Quang Tran,1,0,30,29
1656167949356,MATH 20D,A01,083765,Tran; Brian Kha,1,0,30,29
1656167949356,MATH 20D,A02,083766,Tran; Brian Kha,0,1,30,30
1656167949356,MATH 20D,A03,083767,Tran; Brian Kha,2,0,30,28
1656167955391,MATH 20E,A01,083771,Ganguly; Soumya,4,0,32,28
1656167955391,MATH 20E,A02,083772,Ganguly; Soumya,0,0,32,32
1656167955391,MATH 20E,B01,083773,Ciotti; Benjamin,15,0,35,20
1656167955391,MATH 20E,B02,083774,Ciotti; Benjamin,15,0,35,20
1656167961432,MATH 103A,A01,083777,Greenfeld; Be'Eri,1,0,36,35
1656167961432,MATH 103A,A02,083778,Greenfeld; Be'Eri,1,0,36,35
1656167961432,MATH 103A,A03,093561,Staff,5,0,36,31
1656167961432,MATH 103A,B01,083779,Greenfeld; Be'Eri,8,1,36,28
1656167961432,MATH 103A,B02,083780,Greenfeld; Be'Eri,1,0,36,35
1656167961432,MATH 103A,B03,093562,Staff,0,0,36,36
1656167967458,MATH 105,A01,085443,Carter; Anne Toulson,5,1,35,30
1656167967458,MATH 105,A02,093477,Staff,11,0,35,24
1656167973490,MATH 109,A01,083213,Ganzberger; Geoffrey Michael,0,0,34,34
1656167973490,MATH 109,A02,083214,Ganzberger; Geoffrey Michael,0,0,34,34
1656167973490,MATH 109,A03,093478,Staff,1,0,34,33
1656167973490,MATH 109,B01,083215,Ganzberger; Geoffrey Michael,4,0,32,28
1656167973490,MATH 109,B02,083216,Ganzberger; Geoffrey Michael,1,0,32,31
1656167973490,MATH 109,B03,093479,Staff,4,0,32,28
1656167979526,MATH 142A,A01,083219,Chow; Bennett,1,0,32,31
1656167979526,MATH 142A,A02,083220,Chow; Bennett,8,0,32,24
1656167979526,MATH 142A,A03,093480,Staff,5,0,32,27
1656167979526,MATH 142A,B03,093481,Staff,4,0,32,28
1656167979526,MATH 142A,B04,093558,Staff,6,0,32,26
1656167979526,MATH 142A,B05,093559,Staff,0,0,32,32
1656167985556,MATH 193A,A01,083224,Rotar; Vladimir,0,1,34,34
1656167985556,MATH 193A,A02,083225,Rotar; Vladimir,0,0,34,34
1656167985556,MATH 193A,A03,083781,Rotar; Vladimir,0,0,34,34
1656167985556,MATH 193A,A04,083782,Rotar; Vladimir,6,0,34,28
1656167985556,MATH 193A,A05,093482,Rotar; Vladimir,1,0,34,33
1656167991581,MATH 197,001,091859,McAuley; Julian John,9999,0,9999,0
1656167991581,MATH 197,002,095566,Kedlaya; Kiran S.,9997,0,9999,2
1656167991581,MATH 197,003,095567,Xiao; Ming,9999,0,9999,0
1656167991581,MATH 197,004,095571,Perols; Johan Lars,9998,0,9999,1
1656167998648,COGS 9,A01,083615,Shannon; Kyle Michael,4,0,75,71
1656168004673,COGS 11,A01,083617,Boyle; Mary E. T.,14,0,48,34
1656168010700,COGS 13,A01,083071,Bastos; Amalia Pinkusfeld,6,0,71,65
1656168016727,COGS 14A,A01,092681,Semenuks; Arturs,4,15,100,96
1656168022756,COGS 14B,A01,083073,Cheng; Tzu-Han,7,0,63,56
1656168028788,COGS 17,A01,092677,Semenuks; Arturs,8,0,81,73
1656168034816,COGS 100,A01,083619,Allen; Michael Gordon,2,0,70,68
1656168040841,COGS 101A,A01,083621,Davis; Joshua Daniel,3,0,68,65
1656168046875,COGS 101B,A01,091572,Allen; Michael Gordon,6,0,65,59
1656168052905,COGS 101C,A01,083625,Delgado; Tania,10,0,35,25
1656168058933,COGS 107A,A01,083627,Boyle; Mary E. T.,0,0,60,60
1656168064959,COGS 118A,A01,083075,Gupta; Anjum,7,0,76,69
1656168070996,CSE 3,A50,083646,Miranda; Gregory Joseph,18,0,50,32
1656168077022,CSE 8A,A50,083650,Miranda; Gregory Joseph,3,3,56,53
1656168083047,CSE 11,A01,083080,Cao; Yingjun,1,54,40,39
1656168089074,CSE 12,A01,083652,Krause-Levy; Sophia Louisa,7,2,120,113
1656168095103,CSE 15L,A01,083654,Morris; Justin Loren,2,0,50,48
1656168095103,CSE 15L,A02,083655,Morris; Justin Loren,4,0,50,46
1656168101127,CSE 20,A01,083657,Tran; Khoa Dang,31,0,80,49
1656168107158,CSE 21,A01,095574,Bach; Quang Tran,25,0,48,23
1656168113185,CSE 30,A01,083084,Eldon; John,2,8,80,78
1656168113185,CSE 30,B01,095061,Bhaskar; Nishant,1,2,50,49
1656168119212,CSE 100,A01,083659,Cao; Yingjun,2,20,70,68
1656168125238,CSE 134B,A01,083661,Powell; Thomas Allan,3,0,100,97
1656168131274,CSE 140,A01,083663,Gungor; Onat,9,0,85,76
1656168137310,CSE 140L,A01,083088,Eldon; John,8,0,100,92
1656168143337,CSE 175,A01,083665,Kumar; Rakesh,0,0,25,25
1656168149364,CSE 190,A00,092507,Dubnov; Shlomo,3,0,20,17
1656168155395,ECE 45,A01,083139,Congero; Spencer William,1,0,75,74
1656168161422,ECE 65,A50,083695,Saad; Andrew S,9,0,30,21
1656168161422,ECE 65,A51,095125,Staff,23,0,26,3
1656168167452,ECE 109,A01,091882,Touri; Behrouz,0,1,70,70
1656168173477,ECE 180,A00,083140,Abi Samra; Nicholas Camill,1,0,30,29
1656168173477,ECE 180,B00,083141,Abi Samra; Nicholas Camill,0,4,30,30
1656168179510,MATH 10A,A01,083735,Patchell; Gregory David,0,0,30,30
1656168179510,MATH 10A,A02,083736,Patchell; Gregory David,22,0,30,8
1656168179510,MATH 10A,A03,083737,Patchell; Gregory David,16,0,30,14
1656168185553,MATH 10B,A01,083207,Lim; Seonhee,0,0,34,34
1656168185553,MATH 10B,A02,083208,Lim; Seonhee,7,0,35,28
1656168185553,MATH 10B,A03,093472,Staff,1,0,34,33
1656168185553,MATH 10B,B01,083739,Sinha; Shubham,10,0,30,20
1656168191587,MATH 18,A01,083743,Cinel; Cameron Alexander,7,0,30,23
1656168191587,MATH 18,A02,083744,Cinel; Cameron Alexander,10,0,30,20
1656168191587,MATH 18,A03,083745,Cinel; Cameron Alexander,4,0,30,26
1656168191587,MATH 18,B01,083748,Rideout; David Porter,0,0,36,36
1656168191587,MATH 18,B02,083749,Rideout; David Porter,0,0,36,36
1656168191587,MATH 18,B03,083750,Rideout; David Porter,0,0,36,36
1656168191587,MATH 18,B04,083751,Rideout; David Porter,0,0,36,36
1656168191587,MATH 18,B05,093473,Rideout; David Porter,1,0,36,35
1656168191587,MATH 18,B06,093474,Rideout; David Porter,3,0,36,33
1656168197620,MATH 20A,A01,083754,Zheng; Zequn,11,0,40,29
1656168203646,MATH 20B,A01,083756,Briones; Jor-el Thomas Caparas,0,0,36,36
1656168203646,MATH 20B,A02,083757,Briones; Jor-el Thomas Caparas,0,0,36,36
1656168203646,MATH 20B,A03,093475,Staff,2,0,36,34
1656168209674,MATH 20C,A01,083760,Briones; Jor-el Thomas Caparas,0,0,35,35
1656168209674,MATH 20C,A02,083761,Briones; Jor-el Thomas Caparas,9,1,35,26
1656168209674,MATH 20C,A03,093476,Staff,0,0,35,35
1656168209674,MATH 20C,B01,083762,Bach; Quang Tran,1,0,30,29
1656168215703,MATH 20D,A01,083765,Tran; Brian Kha,1,0,30,29
1656168215703,MATH 20D,A02,083766,Tran; Brian Kha,0,1,30,30
1656168215703,MATH 20D,A03,083767,Tran; Brian Kha,2,0,30,28
1656168221737,MATH 20E,A01,083771,Ganguly; Soumya,4,0,32,28
1656168221737,MATH 20E,A02,083772,Ganguly; Soumya,0,0,32,32
1656168221737,MATH 20E,B01,083773,Ciotti; Benjamin,15,0,35,20
1656168221737,MATH 20E,B02,083774,Ciotti; Benjamin,15,0,35,20
1656168227765,MATH 103A,A01,083777,Greenfeld; Be'Eri,1,0,36,35
1656168227765,MATH 103A,A02,083778,Greenfeld; Be'Eri,1,0,36,35
1656168227765,MATH 103A,A03,093561,Staff,5,0,36,31
1656168227765,MATH 103A,B01,083779,Greenfeld; Be'Eri,8,1,36,28
1656168227765,MATH 103A,B02,083780,Greenfeld; Be'Eri,1,0,36,35
1656168227765,MATH 103A,B03,093562,Staff,0,0,36,36
1656168233791,MATH 105,A01,085443,Carter; Anne Toulson,5,1,35,30
1656168233791,MATH 105,A02,093477,Staff,11,0,35,24
1656168239817,MATH 109,A01,083213,Ganzberger; Geoffrey Michael,0,0,34,34
1656168239817,MATH 109,A02,083214,Ganzberger; Geoffrey Michael,0,0,34,34
1656168239817,MATH 109,A03,093478,Staff,1,0,34,33
1656168239817,MATH 109,B01,083215,Ganzberger; Geoffrey Michael,4,0,32,28
1656168239817,MATH 109,B02,083216,Ganzberger; Geoffrey Michael,1,0,32,31
1656168239817,MATH 109,B03,093479,Staff,4,0,32,28
1656168245843,MATH 142A,A01,083219,Chow; Bennett,1,0,32,31
1656168245843,MATH 142A,A02,083220,Chow; Bennett,8,0,32,24
1656168245843,MATH 142A,A03,093480,Staff,5,0,32,27
1656168245843,MATH 142A,B03,093481,Staff,4,0,32,28
1656168245843,MATH 142A,B04,093558,Staff,6,0,32,26
1656168245843,MATH 142A,B05,093559,Staff,0,0,32,32
1656168251871,MATH 193A,A01,083224,Rotar; Vladimir,0,1,34,34
1656168251871,MATH 193A,A02,083225,Rotar; Vladimir,0,0,34,34
1656168251871,MATH 193A,A03,083781,Rotar; Vladimir,0,0,34,34
1656168251871,MATH 193A,A04,083782,Rotar; Vladimir,6,0,34,28
1656168251871,MATH 193A,A05,093482,Rotar; Vladimir,1,0,34,33
1656168257912,MATH 197,001,091859,McAuley; Julian John,9999,0,9999,0
1656168257912,MATH 197,002,095566,Kedlaya; Kiran S.,9997,0,9999,2
1656168257912,MATH 197,003,095567,Xiao; Ming,9999,0,9999,0
1656168257912,MATH 197,004,095571,Perols; Johan Lars,9998,0,9999,1
1656168264985,COGS 9,A01,083615,Shannon; Kyle Michael,4,0,75,71
1656168271010,COGS 11,A01,083617,Boyle; Mary E. T.,14,0,48,34
1656168277128,COGS 13,A01,083071,Bastos; Amalia Pinkusfeld,6,0,71,65
1656168283153,COGS 14A,A01,092681,Semenuks; Arturs,4,15,100,96
1656168289192,COGS 14B,A01,083073,Cheng; Tzu-Han,7,0,63,56
1656168295219,COGS 17,A01,092677,Semenuks; Arturs,8,0,81,73
1656168301250,COGS 100,A01,083619,Allen; Michael Gordon,2,0,70,68
1656168307279,COGS 101A,A01,083621,Davis; Joshua Daniel,3,0,68,65
1656168313304,COGS 101B,A01,091572,Allen; Michael Gordon,6,0,65,59
1656168319328,COGS 101C,A01,083625,Delgado; Tania,10,0,35,25
1656168325358,COGS 107A,A01,083627,Boyle; Mary E. T.,0,0,60,60
1656168331383,COGS 118A,A01,083075,Gupta; Anjum,7,0,76,69
1656168337415,CSE 3,A50,083646,Miranda; Gregory Joseph,18,0,50,32
1656168343444,CSE 8A,A50,083650,Miranda; Gregory Joseph,3,3,56,53
1656168349469,CSE 11,A01,083080,Cao; Yingjun,1,54,40,39
1656168355494,CSE 12,A01,083652,Krause-Levy; Sophia Louisa,7,2,120,113
1656168361518,CSE 15L,A01,083654,Morris; Justin Loren,2,0,50,48
1656168361518,CSE 15L,A02,083655,Morris; Justin Loren,4,0,50,46
1656168367547,CSE 20,A01,083657,Tran; Khoa Dang,31,0,80,49
1656168373577,CSE 21,A01,095574,Bach; Quang Tran,25,0,48,23
1656168379611,CSE 30,A01,083084,Eldon; John,2,8,80,78
1656168379611,CSE 30,B01,095061,Bhaskar; Nishant,1,2,50,49
1656168385643,CSE 100,A01,083659,Cao; Yingjun,2,20,70,68
1656168391668,CSE 134B,A01,083661,Powell; Thomas Allan,3,0,100,97
1656168397701,CSE 140,A01,083663,Gungor; Onat,9,0,85,76
1656168403724,CSE 140L,A01,083088,Eldon; John,8,0,100,92
1656168409750,CSE 175,A01,083665,Kumar; Rakesh,0,0,25,25
1656168415776,CSE 190,A00,092507,Dubnov; Shlomo,3,0,20,17
1656168421803,ECE 45,A01,083139,Congero; Spencer William,1,0,75,74
1656168427836,ECE 65,A50,083695,Saad; Andrew S,9,0,30,21
1656168427836,ECE 65,A51,095125,Staff,23,0,26,3
1656168433868,ECE 109,A01,091882,Touri; Behrouz,0,1,70,70
1656168439900,ECE 180,A00,083140,Abi Samra; Nicholas Camill,1,0,30,29
1656168439900,ECE 180,B00,083141,Abi Samra; Nicholas Camill,0,4,30,30
1656168445928,MATH 10A,A01,083735,Patchell; Gregory David,0,0,30,30
1656168445928,MATH 10A,A02,083736,Patchell; Gregory David,22,0,30,8
1656168445928,MATH 10A,A03,083737,Patchell; Gregory David,16,0,30,14
1656168451965,MATH 10B,A01,083207,Lim; Seonhee,0,0,34,34
1656168451965,MATH 10B,A02,083208,Lim; Seonhee,7,0,35,28
1656168451965,MATH 10B,A03,093472,Staff,1,0,34,33
1656168451965,MATH 10B,B01,083739,Sinha; Shubham,10,0,30,20
1656168458012,MATH 18,A01,083743,Cinel; Cameron Alexander,7,0,30,23
1656168458012,MATH 18,A02,083744,Cinel; Cameron Alexander,10,0,30,20
1656168458012,MATH 18,A03,083745,Cinel; Cameron Alexander,4,0,30,26
1656168458012,MATH 18,B01,083748,Rideout; David Porter,0,0,36,36
1656168458012,MATH 18,B02,083749,Rideout; David Porter,0,0,36,36
1656168458012,MATH 18,B03,083750,Rideout; David Porter,0,0,36,36
1656168458012,MATH 18,B04,083751,Rideout; David Porter,0,0,36,36
1656168458012,MATH 18,B05,093473,Rideout; David Porter,1,0,36,35
1656168458012,MATH 18,B06,093474,Rideout; David Porter,3,0,36,33
1656168464036,MATH 20A,A01,083754,Zheng; Zequn,11,0,40,29
1656168470062,MATH 20B,A01,083756,Briones; Jor-el Thomas Caparas,0,0,36,36
1656168470062,MATH 20B,A02,083757,Briones; Jor-el Thomas Caparas,0,0,36,36
1656168470062,MATH 20B,A03,093475,Staff,2,0,36,34
1656168476096,MATH 20C,A01,083760,Briones; Jor-el Thomas Caparas,0,0,35,35
1656168476096,MATH 20C,A02,083761,Briones; Jor-el Thomas Caparas,9,1,35,26
1656168476096,MATH 20C,A03,093476,Staff,0,0,35,35
1656168476096,MATH 20C,B01,083762,Bach; Quang Tran,1,0,30,29
1656168482124,MATH 20D,A01,083765,Tran; Brian Kha,1,0,30,29
1656168482124,MATH 20D,A02,083766,Tran; Brian Kha,0,1,30,30
1656168482124,MATH 20D,A03,083767,Tran; Brian Kha,2,0,30,28
1656168488150,MATH 20E,A01,083771,Ganguly; Soumya,4,0,32,28
1656168488150,MATH 20E,A02,083772,Ganguly; Soumya,0,0,32,32
1656168488150,MATH 20E,B01,083773,Ciotti; Benjamin,15,0,35,20
1656168488150,MATH 20E,B02,083774,Ciotti; Benjamin,15,0,35,20
1656168494177,MATH 103A,A01,083777,Greenfeld; Be'Eri,1,0,36,35
1656168494177,MATH 103A,A02,083778,Greenfeld; Be'Eri,1,0,36,35
1656168494177,MATH 103A,A03,093561,Staff,5,0,36,31
1656168494177,MATH 103A,B01,083779,Greenfeld; Be'Eri,8,1,36,28
1656168494177,MATH 103A,B02,083780,Greenfeld; Be'Eri,1,0,36,35
1656168494177,MATH 103A,B03,093562,Staff,0,0,36,36
1656168500209,MATH 105,A01,085443,Carter; Anne Toulson,5,1,35,30
1656168500209,MATH 105,A02,093477,Staff,11,0,35,24
1656168506235,MATH 109,A01,083213,Ganzberger; Geoffrey Michael,0,0,34,34
1656168506235,MATH 109,A02,083214,Ganzberger; Geoffrey Michael,0,0,34,34
1656168506235,MATH 109,A03,093478,Staff,1,0,34,33
1656168506235,MATH 109,B01,083215,Ganzberger; Geoffrey Michael,4,0,32,28
1656168506235,MATH 109,B02,083216,Ganzberger; Geoffrey Michael,1,0,32,31
1656168506235,MATH 109,B03,093479,Staff,4,0,32,28
1656168512263,MATH 142A,A01,083219,Chow; Bennett,1,0,32,31
1656168512263,MATH 142A,A02,083220,Chow; Bennett,8,0,32,24
1656168512263,MATH 142A,A03,093480,Staff,5,0,32,27
1656168512263,MATH 142A,B03,093481,Staff,4,0,32,28
1656168512263,MATH 142A,B04,093558,Staff,6,0,32,26
1656168512263,MATH 142A,B05,093559,Staff,0,0,32,32
1656168518290,MATH 193A,A01,083224,Rotar; Vladimir,0,1,34,34
1656168518290,MATH 193A,A02,083225,Rotar; Vladimir,0,0,34,34
1656168518290,MATH 193A,A03,083781,Rotar; Vladimir,0,0,34,34
1656168518290,MATH 193A,A04,083782,Rotar; Vladimir,6,0,34,28
1656168518290,MATH 193A,A05,093482,Rotar; Vladimir,1,0,34,33
1656168524316,MATH 197,001,091859,McAuley; Julian John,9999,0,9999,0
1656168524316,MATH 197,002,095566,Kedlaya; Kiran S.,9997,0,9999,2
1656168524316,MATH 197,003,095567,Xiao; Ming,9999,0,9999,0
1656168524316,MATH 197,004,095571,Perols; Johan Lars,9998,0,9999,1
1656168531383,COGS 9,A01,083615,Shannon; Kyle Michael,4,0,75,71
1656168537414,COGS 11,A01,083617,Boyle; Mary E. T.,14,0,48,34
1656168543446,COGS 13,A01,083071,Bastos; Amalia Pinkusfeld,6,0,71,65
1656168549486,COGS 14A,A01,092681,Semenuks; Arturs,4,15,100,96
1656168555516,COGS 14B,A01,083073,Cheng; Tzu-Han,7,0,63,56
1656168561540,COGS 17,A01,092677,Semenuks; Arturs,8,0,81,73
1656168567567,COGS 100,A01,083619,Allen; Michael Gordon,2,0,70,68
1656168573593,COGS 101A,A01,083621,Davis; Joshua Daniel,3,0,68,65
1656168579618,COGS 101B,A01,091572,Allen; Michael Gordon,6,0,65,59
1656168585643,COGS 101C,A01,083625,Delgado; Tania,10,0,35,25
1656168591671,COGS 107A,A01,083627,Boyle; Mary E. T.,0,0,60,60
1656168597702,COGS 118A,A01,083075,Gupta; Anjum,7,0,76,69
1656168603741,CSE 3,A50,083646,Miranda; Gregory Joseph,18,0,50,32
1656168609765,CSE 8A,A50,083650,Miranda; Gregory Joseph,3,3,56,53
1656168615799,CSE 11,A01,083080,Cao; Yingjun,1,54,40,39
1656168621827,CSE 12,A01,083652,Krause-Levy; Sophia Louisa,7,2,120,113
1656168627851,CSE 15L,A01,083654,Morris; Justin Loren,2,0,50,48
1656168627851,CSE 15L,A02,083655,Morris; Justin Loren,4,0,50,46
1656168633887,CSE 20,A01,083657,Tran; Khoa Dang,31,0,80,49
1656168639917,CSE 21,A01,095574,Bach; Quang Tran,25,0,48,23
1656168645957,CSE 30,A01,083084,Eldon; John,2,8,80,78
1656168645957,CSE 30,B01,095061,Bhaskar; Nishant,1,2,50,49
1656168651982,CSE 100,A01,083659,Cao; Yingjun,2,20,70,68
1656168658009,CSE 134B,A01,083661,Powell; Thomas Allan,3,0,100,97
1656168664044,CSE 140,A01,083663,Gungor; Onat,9,0,85,76
1656168670074,CSE 140L,A01,083088,Eldon; John,8,0,100,92
1656168676100,CSE 175,A01,083665,Kumar; Rakesh,0,0,25,25
1656168682135,CSE 190,A00,092507,Dubnov; Shlomo,3,0,20,17
1656168688161,ECE 45,A01,083139,Congero; Spencer William,1,0,75,74
1656168694193,ECE 65,A50,083695,Saad; Andrew S,9,0,30,21
1656168694193,ECE 65,A51,095125,Staff,23,0,26,3
1656168700223,ECE 109,A01,091882,Touri; Behrouz,0,1,70,70
1656168706253,ECE 180,A00,083140,Abi Samra; Nicholas Camill,1,0,30,29
1656168706253,ECE 180,B00,083141,Abi Samra; Nicholas Camill,0,4,30,30
1656168712280,MATH 10A,A01,083735,Patchell; Gregory David,0,0,30,30
1656168712280,MATH 10A,A02,083736,Patchell; Gregory David,22,0,30,8
1656168712280,MATH 10A,A03,083737,Patchell; Gregory David,16,0,30,14
1656168718315,MATH 10B,A01,083207,Lim; Seonhee,0,0,34,34
1656168718315,MATH 10B,A02,083208,Lim; Seonhee,7,0,35,28
1656168718315,MATH 10B,A03,093472,Staff,1,0,34,33
1656168718315,MATH 10B,B01,083739,Sinha; Shubham,10,0,30,20
1656168724346,MATH 18,A01,083743,Cinel; Cameron Alexander,7,0,30,23
1656168724346,MATH 18,A02,083744,Cinel; Cameron Alexander,10,0,30,20
1656168724346,MATH 18,A03,083745,Cinel; Cameron Alexander,4,0,30,26
1656168724346,MATH 18,B01,083748,Rideout; David Porter,0,0,36,36
1656168724346,MATH 18,B02,083749,Rideout; David Porter,0,0,36,36
1656168724346,MATH 18,B03,083750,Rideout; David Porter,0,0,36,36
1656168724346,MATH 18,B04,083751,Rideout; David Porter,0,0,36,36
1656168724346,MATH 18,B05,093473,Rideout; David Porter,1,0,36,35
1656168724346,MATH 18,B06,093474,Rideout; David Porter,3,0,36,33
1656168730372,MATH 20A,A01,083754,Zheng; Zequn,11,0,40,29
1656168736402,MATH 20B,A01,083756,Briones; Jor-el Thomas Caparas,0,0,36,36
1656168736402,MATH 20B,A02,083757,Briones; Jor-el Thomas Caparas,0,0,36,36
1656168736402,MATH 20B,A03,093475,Staff,2,0,36,34
1656168742428,MATH 20C,A01,083760,Briones; Jor-el Thomas Caparas,0,0,35,35
1656168742428,MATH 20C,A02,083761,Briones; Jor-el Thomas Caparas,9,1,35,26
1656168742428,MATH 20C,A03,093476,Staff,0,0,35,35
1656168742428,MATH 20C,B01,083762,Bach; Quang Tran,1,0,30,29
1656168748458,MATH 20D,A01,083765,Tran; Brian Kha,1,0,30,29
1656168748458,MATH 20D,A02,083766,Tran; Brian Kha,0,1,30,30
1656168748458,MATH 20D,A03,083767,Tran; Brian Kha,2,0,30,28
1656168754485,MATH 20E,A01,083771,Ganguly; Soumya,4,0,32,28
1656168754485,MATH 20E,A02,083772,Ganguly; Soumya,0,0,32,32
1656168754485,MATH 20E,B01,083773,Ciotti; Benjamin,15,0,35,20
1656168754485,MATH 20E,B02,083774,Ciotti; Benjamin,15,0,35,20
1656168760517,MATH 103A,A01,083777,Greenfeld; Be'Eri,1,0,36,35
1656168760517,MATH 103A,A02,083778,Greenfeld; Be'Eri,1,0,36,35
1656168760517,MATH 103A,A03,093561,Staff,5,0,36,31
1656168760517,MATH 103A,B01,083779,Greenfeld; Be'Eri,8,1,36,28
1656168760517,MATH 103A,B02,083780,Greenfeld; Be'Eri,1,0,36,35
1656168760517,MATH 103A,B03,093562,Staff,0,0,36,36
1656168766543,MATH 105,A01,085443,Carter; Anne Toulson,5,1,35,30
1656168766543,MATH 105,A02,093477,Staff,11,0,35,24
1656168772569,MATH 109,A01,083213,Ganzberger; Geoffrey Michael,0,0,34,34
1656168772569,MATH 109,A02,083214,Ganzberger; Geoffrey Michael,0,0,34,34
1656168772569,MATH 109,A03,093478,Staff,1,0,34,33
1656168772569,MATH 109,B01,083215,Ganzberger; Geoffrey Michael,4,0,32,28
1656168772569,MATH 109,B02,083216,Ganzberger; Geoffrey Michael,1,0,32,31
1656168772569,MATH 109,B03,093479,Staff,4,0,32,28
1656168778603,MATH 142A,A01,083219,Chow; Bennett,1,0,32,31
1656168778603,MATH 142A,A02,083220,Chow; Bennett,8,0,32,24
1656168778603,MATH 142A,A03,093480,Staff,5,0,32,27
1656168778603,MATH 142A,B03,093481,Staff,4,0,32,28
1656168778603,MATH 142A,B04,093558,Staff,6,0,32,26
1656168778603,MATH 142A,B05,093559,Staff,0,0,32,32
1656168784630,MATH 193A,A01,083224,Rotar; Vladimir,0,1,34,34
1656168784630,MATH 193A,A02,083225,Rotar; Vladimir,0,0,34,34
1656168784630,MATH 193A,A03,083781,Rotar; Vladimir,0,0,34,34
1656168784630,MATH 193A,A04,083782,Rotar; Vladimir,6,0,34,28
1656168784630,MATH 193A,A05,093482,Rotar; Vladimir,1,0,34,33
1656168790657,MATH 197,001,091859,McAuley; Julian John,9999,0,9999,0
1656168790657,MATH 197,002,095566,Kedlaya; Kiran S.,9997,0,9999,2
1656168790657,MATH 197,003,095567,Xiao; Ming,9999,0,9999,0
1656168790657,MATH 197,004,095571,Perols; Johan Lars,9998,0,9999,1
1656168797731,COGS 9,A01,083615,Shannon; Kyle Michael,4,0,75,71
1656168803757,COGS 11,A01,083617,Boyle; Mary E. T.,14,0,48,34
1656168809784,COGS 13,A01,083071,Bastos; Amalia Pinkusfeld,6,0,71,65
1656168815814,COGS 14A,A01,092681,Semenuks; Arturs,4,15,100,96
1656168821850,COGS 14B,A01,083073,Cheng; Tzu-Han,7,0,63,56
1656168827872,COGS 17,A01,092677,Semenuks; Arturs,8,0,81,73
1656168833902,COGS 100,A01,083619,Allen; Michael Gordon,2,0,70,68
1656168839933,COGS 101A,A01,083621,Davis; Joshua Daniel,3,0,68,65
1656168845957,COGS 101B,A01,091572,Allen; Michael Gordon,6,0,65,59
1656168851984,COGS 101C,A01,083625,Delgado; Tania,10,0,35,25
1656168858013,COGS 107A,A01,083627,Boyle; Mary E. T.,0,0,60,60
1656168864053,COGS 118A,A01,083075,Gupta; Anjum,7,0,76,69
1656168870089,CSE 3,A50,083646,Miranda; Gregory Joseph,18,0,50,32
1656168876207,CSE 8A,A50,083650,Miranda; Gregory Joseph,3,3,56,53
1656168882244,CSE 11,A01,083080,Cao; Yingjun,1,54,40,39
1656168888270,CSE 12,A01,083652,Krause-Levy; Sophia Louisa,7,2,120,113
1656168894301,CSE 15L,A01,083654,Morris; Justin Loren,2,0,50,48
1656168894301,CSE 15L,A02,083655,Morris; Justin Loren,4,0,50,46
1656168900335,CSE 20,A01,083657,Tran; Khoa Dang,31,0,80,49
1656168906361,CSE 21,A01,095574,Bach; Quang Tran,25,0,48,23
1656168912387,CSE 30,A01,083084,Eldon; John,2,8,80,78
1656168912387,CSE 30,B01,095061,Bhaskar; Nishant,1,2,50,49
1656168918412,CSE 100,A01,083659,Cao; Yingjun,2,20,70,68
1656168924437,CSE 134B,A01,083661,Powell; Thomas Allan,3,0,100,97
1656168930462,CSE 140,A01,083663,Gungor; Onat,9,0,85,76
1656168936487,CSE 140L,A01,083088,Eldon; John,8,0,100,92
1656168942512,CSE 175,A01,083665,Kumar; Rakesh,0,0,25,25
1656168948535,CSE 190,A00,092507,Dubnov; Shlomo,3,0,20,17
1656168954564,ECE 45,A01,083139,Congero; Spencer William,1,0,75,74
1656168960596,ECE 65,A50,083695,Saad; Andrew S,9,0,30,21
1656168960596,ECE 65,A51,095125,Staff,23,0,26,3
1656168966622,ECE 109,A01,091882,Touri; Behrouz,0,1,70,70
1656168972653,ECE 180,A00,083140,Abi Samra; Nicholas Camill,1,0,30,29
1656168972653,ECE 180,B00,083141,Abi Samra; Nicholas Camill,0,4,30,30
1656168978680,MATH 10A,A01,083735,Patchell; Gregory David,0,0,30,30
1656168978680,MATH 10A,A02,083736,Patchell; Gregory David,22,0,30,8
1656168978680,MATH 10A,A03,083737,Patchell; Gregory David,16,0,30,14
1656168984714,MATH 10B,A01,083207,Lim; Seonhee,0,0,34,34
1656168984714,MATH 10B,A02,083208,Lim; Seonhee,7,0,35,28
1656168984714,MATH 10B,A03,093472,Staff,1,0,34,33
1656168984714,MATH 10B,B01,083739,Sinha; Shubham,10,0,30,20
1656168990743,MATH 18,A01,083743,Cinel; Cameron Alexander,7,0,30,23
1656168990743,MATH 18,A02,083744,Cinel; Cameron Alexander,10,0,30,20
1656168990743,MATH 18,A03,083745,Cinel; Cameron Alexander,4,0,30,26
1656168990743,MATH 18,B01,083748,Rideout; David Porter,0,0,36,36
1656168990743,MATH 18,B02,083749,Rideout; David Porter,0,0,36,36
1656168990743,MATH 18,B03,083750,Rideout; David Porter,0,0,36,36
1656168990743,MATH 18,B04,083751,Rideout; David Porter,0,0,36,36
1656168990743,MATH 18,B05,093473,Rideout; David Porter,1,0,36,35
1656168990743,MATH 18,B06,093474,Rideout; David Porter,3,0,36,33
1656168996775,MATH 20A,A01,083754,Zheng; Zequn,11,0,40,29
1656169002803,MATH 20B,A01,083756,Briones; Jor-el Thomas Caparas,0,0,36,36
1656169002803,MATH 20B,A02,083757,Briones; Jor-el Thomas Caparas,0,0,36,36
1656169002803,MATH 20B,A03,093475,Staff,2,0,36,34
1656169008830,MATH 20C,A01,083760,Briones; Jor-el Thomas Caparas,0,0,35,35
1656169008830,MATH 20C,A02,083761,Briones; Jor-el Thomas Caparas,9,1,35,26
1656169008830,MATH 20C,A03,093476,Staff,0,0,35,35
1656169008830,MATH 20C,B01,083762,Bach; Quang Tran,1,0,30,29
1656169014855,MATH 20D,A01,083765,Tran; Brian Kha,1,0,30,29
1656169014855,MATH 20D,A02,083766,Tran; Brian Kha,0,1,30,30
1656169014855,MATH 20D,A03,083767,Tran; Brian Kha,2,0,30,28
1656169020888,MATH 20E,A01,083771,Ganguly; Soumya,4,0,32,28
1656169020888,MATH 20E,A02,083772,Ganguly; Soumya,0,0,32,32
1656169020888,MATH 20E,B01,083773,Ciotti; Benjamin,15,0,35,20
1656169020888,MATH 20E,B02,083774,Ciotti; Benjamin,15,0,35,20
1656169026920,MATH 103A,A01,083777,Greenfeld; Be'Eri,1,0,36,35
1656169026920,MATH 103A,A02,083778,Greenfeld; Be'Eri,1,0,36,35
1656169026920,MATH 103A,A03,093561,Staff,5,0,36,31
1656169026920,MATH 103A,B01,083779,Greenfeld; Be'Eri,8,1,36,28
1656169026920,MATH 103A,B02,083780,Greenfeld; Be'Eri,1,0,36,35
1656169026920,MATH 103A,B03,093562,Staff,0,0,36,36
1656169032945,MATH 105,A01,085443,Carter; Anne Toulson,5,1,35,30
1656169032945,MATH 105,A02,093477,Staff,11,0,35,24
1656169038972,MATH 109,A01,083213,Ganzberger; Geoffrey Michael,0,0,34,34
1656169038972,MATH 109,A02,083214,Ganzberger; Geoffrey Michael,0,0,34,34
1656169038972,MATH 109,A03,093478,Staff,1,0,34,33
1656169038972,MATH 109,B01,083215,Ganzberger; Geoffrey Michael,4,0,32,28
1656169038972,MATH 109,B02,083216,Ganzberger; Geoffrey Michael,1,0,32,31
1656169038972,MATH 109,B03,093479,Staff,4,0,32,28
1656169045006,MATH 142A,A01,083219,Chow; Bennett,1,0,32,31
1656169045006,MATH 142A,A02,083220,Chow; Bennett,8,0,32,24
1656169045006,MATH 142A,A03,093480,Staff,5,0,32,27
1656169045006,MATH 142A,B03,093481,Staff,4,0,32,28
1656169045006,MATH 142A,B04,093558,Staff,6,0,32,26
1656169045006,MATH 142A,B05,093559,Staff,0,0,32,32
1656169051032,MATH 193A,A01,083224,Rotar; Vladimir,0,1,34,34
1656169051032,MATH 193A,A02,083225,Rotar; Vladimir,0,0,34,34
1656169051032,MATH 193A,A03,083781,Rotar; Vladimir,0,0,34,34
1656169051032,MATH 193A,A04,083782,Rotar; Vladimir,6,0,34,28
1656169051032,MATH 193A,A05,093482,Rotar; Vladimir,1,0,34,33
1656169057059,MATH 197,001,091859,McAuley; Julian John,9999,0,9999,0
1656169057059,MATH 197,002,095566,Kedlaya; Kiran S.,9997,0,9999,2
1656169057059,MATH 197,003,095567,Xiao; Ming,9999,0,9999,0
1656169057059,MATH 197,004,095571,Perols; Johan Lars,9998,0,9999,1
1656169064128,COGS 9,A01,083615,Shannon; Kyle Michael,4,0,75,71
1656169070151,COGS 11,A01,083617,Boyle; Mary E. T.,14,0,48,34
1656169076176,COGS 13,A01,083071,Bastos; Amalia Pinkusfeld,5,0,71,66
1656169082208,COGS 14A,A01,092681,Semenuks; Arturs,4,15,100,96
1656169088234,COGS 14B,A01,083073,Cheng; Tzu-Han,7,0,63,56
1656169094262,COGS 17,A01,092677,Semenuks; Arturs,8,0,81,73
1656169100288,COGS 100,A01,083619,Allen; Michael Gordon,2,0,70,68
1656169106313,COGS 101A,A01,083621,Davis; Joshua Daniel,3,0,68,65
1656169112340,COGS 101B,A01,091572,Allen; Michael Gordon,6,0,65,59
1656169118364,COGS 101C,A01,083625,Delgado; Tania,10,0,35,25
1656169124390,COGS 107A,A01,083627,Boyle; Mary E. T.,0,0,60,60
1656169130417,COGS 118A,A01,083075,Gupta; Anjum,7,0,76,69
1656169136446,CSE 3,A50,083646,Miranda; Gregory Joseph,18,0,50,32
1656169142474,CSE 8A,A50,083650,Miranda; Gregory Joseph,3,3,56,53
1656169148499,CSE 11,A01,083080,Cao; Yingjun,1,54,40,39
1656169154525,CSE 12,A01,083652,Krause-Levy; Sophia Louisa,7,2,120,113
1656169160555,CSE 15L,A01,083654,Morris; Justin Loren,2,0,50,48
1656169160555,CSE 15L,A02,083655,Morris; Justin Loren,4,0,50,46
1656169166580,CSE 20,A01,083657,Tran; Khoa Dang,31,0,80,49
1656169172606,CSE 21,A01,095574,Bach; Quang Tran,25,0,48,23
1656169178632,CSE 30,A01,083084,Eldon; John,2,8,80,78
1656169178632,CSE 30,B01,095061,Bhaskar; Nishant,1,2,50,49
1656169184662,CSE 100,A01,083659,Cao; Yingjun,2,20,70,68
1656169190691,CSE 134B,A01,083661,Powell; Thomas Allan,3,0,100,97
1656169196716,CSE 140,A01,083663,Gungor; Onat,9,0,85,76
1656169202747,CSE 140L,A01,083088,Eldon; John,8,0,100,92
1656169208776,CSE 175,A01,083665,Kumar; Rakesh,0,0,25,25
1656169214804,CSE 190,A00,092507,Dubnov; Shlomo,3,0,20,17
1656169220829,ECE 45,A01,083139,Congero; Spencer William,1,0,75,74
1656169226864,ECE 65,A50,083695,Saad; Andrew S,9,0,30,21
1656169226864,ECE 65,A51,095125,Staff,23,0,26,3
1656169232889,ECE 109,A01,091882,Touri; Behrouz,0,1,70,70
1656169238988,ECE 180,A00,083140,Abi Samra; Nicholas Camill,1,0,30,29
1656169238988,ECE 180,B00,083141,Abi Samra; Nicholas Camill,0,4,30,30
1656169245017,MATH 10A,A01,083735,Patchell; Gregory David,0,0,30,30
1656169245017,MATH 10A,A02,083736,Patchell; Gregory David,22,0,30,8
1656169245017,MATH 10A,A03,083737,Patchell; Gregory David,16,0,30,14
1656169251050,MATH 10B,A01,083207,Lim; Seonhee,0,0,34,34
1656169251050,MATH 10B,A02,083208,Lim; Seonhee,7,0,35,28
1656169251050,MATH 10B,A03,093472,Staff,1,0,34,33
1656169251050,MATH 10B,B01,083739,Sinha; Shubham,10,0,30,20
1656169257079,MATH 18,A01,083743,Cinel; Cameron Alexander,7,0,30,23
1656169257079,MATH 18,A02,083744,Cinel; Cameron Alexander,10,0,30,20
1656169257079,MATH 18,A03,083745,Cinel; Cameron Alexander,4,0,30,26
1656169257079,MATH 18,B01,083748,Rideout; David Porter,0,0,36,36
1656169257079,MATH 18,B02,083749,Rideout; David Porter,0,0,36,36
1656169257079,MATH 18,B03,083750,Rideout; David Porter,0,0,36,36
1656169257079,MATH 18,B04,083751,Rideout; David Porter,0,0,36,36
1656169257079,MATH 18,B05,093473,Rideout; David Porter,1,0,36,35
1656169257079,MATH 18,B06,093474,Rideout; David Porter,3,0,36,33
1656169263116,MATH 20A,A01,083754,Zheng; Zequn,11,0,40,29
1656169269155,MATH 20B,A01,083756,Briones; Jor-el Thomas Caparas,0,0,36,36
1656169269155,MATH 20B,A02,083757,Briones; Jor-el Thomas Caparas,0,0,36,36
1656169269155,MATH 20B,A03,093475,Staff,2,0,36,34
1656169275178,MATH 20C,A01,083760,Briones; Jor-el Thomas Caparas,0,0,35,35
1656169275178,MATH 20C,A02,083761,Briones; Jor-el Thomas Caparas,9,1,35,26
1656169275178,MATH 20C,A03,093476,Staff,0,0,35,35
1656169275178,MATH 20C,B01,083762,Bach; Quang Tran,1,0,30,29
1656169281213,MATH 20D,A01,083765,Tran; Brian Kha,1,0,30,29
1656169281213,MATH 20D,A02,083766,Tran; Brian Kha,0,1,30,30
1656169281213,MATH 20D,A03,083767,Tran; Brian Kha,2,0,30,28
1656169287240,MATH 20E,A01,083771,Ganguly; Soumya,4,0,32,28
1656169287240,MATH 20E,A02,083772,Ganguly; Soumya,0,0,32,32
1656169287240,MATH 20E,B01,083773,Ciotti; Benjamin,15,0,35,20
1656169287240,MATH 20E,B02,083774,Ciotti; Benjamin,15,0,35,20
1656169293269,MATH 103A,A01,083777,Greenfeld; Be'Eri,1,0,36,35
1656169293269,MATH 103A,A02,083778,Greenfeld; Be'Eri,1,0,36,35
1656169293269,MATH 103A,A03,093561,Staff,5,0,36,31
1656169293269,MATH 103A,B01,083779,Greenfeld; Be'Eri,8,1,36,28
1656169293269,MATH 103A,B02,083780,Greenfeld; Be'Eri,1,0,36,35
1656169293269,MATH 103A,B03,093562,Staff,0,0,36,36
1656169299301,MATH 105,A01,085443,Carter; Anne Toulson,5,1,35,30
1656169299301,MATH 105,A02,093477,Staff,11,0,35,24
1656169305333,MATH 109,A01,083213,Ganzberger; Geoffrey Michael,0,0,34,34
1656169305333,MATH 109,A02,083214,Ganzberger; Geoffrey Michael,0,0,34,34
1656169305333,MATH 109,A03,093478,Staff,1,0,34,33
1656169305333,MATH 109,B01,083215,Ganzberger; Geoffrey Michael,4,0,32,28
1656169305333,MATH 109,B02,083216,Ganzberger; Geoffrey Michael,1,0,32,31
1656169305333,MATH 109,B03,093479,Staff,4,0,32,28
1656169311359,MATH 142A,A01,083219,Chow; Bennett,1,0,32,31
1656169311359,MATH 142A,A02,083220,Chow; Bennett,8,0,32,24
1656169311359,MATH 142A,A03,093480,Staff,5,0,32,27
1656169311359,MATH 142A,B03,093481,Staff,4,0,32,28
1656169311359,MATH 142A,B04,093558,Staff,6,0,32,26
1656169311359,MATH 142A,B05,093559,Staff,0,0,32,32
1656169317384,MATH 193A,A01,083224,Rotar; Vladimir,0,1,34,34
1656169317384,MATH 193A,A02,083225,Rotar; Vladimir,0,0,34,34
1656169317384,MATH 193A,A03,083781,Rotar; Vladimir,0,0,34,34
1656169317384,MATH 193A,A04,083782,Rotar; Vladimir,6,0,34,28
1656169317384,MATH 193A,A05,093482,Rotar; Vladimir,1,0,34,33
1656169323412,MATH 197,001,091859,McAuley; Julian John,9999,0,9999,0
1656169323412,MATH 197,002,095566,Kedlaya; Kiran S.,9997,0,9999,2
1656169323412,MATH 197,003,095567,Xiao; Ming,9999,0,9999,0
1656169323412,MATH 197,004,095571,Perols; Johan Lars,9998,0,9999,1
1656169330477,COGS 9,A01,083615,Shannon; Kyle Michael,4,0,75,71
1656169336502,COGS 11,A01,083617,Boyle; Mary E. T.,14,0,48,34
1656169342526,COGS 13,A01,083071,Bastos; Amalia Pinkusfeld,5,0,71,66
1656169348556,COGS 14A,A01,092681,Semenuks; Arturs,4,15,100,96
1656169354583,COGS 14B,A01,083073,Cheng; Tzu-Han,7,0,63,56
1656169360608,COGS 17,A01,092677,Semenuks; Arturs,8,0,81,73
1656169366633,COGS 100,A01,083619,Allen; Michael Gordon,2,0,70,68
1656169372659,COGS 101A,A01,083621,Davis; Joshua Daniel,3,0,68,65
1656169378684,COGS 101B,A01,091572,Allen; Michael Gordon,6,0,65,59
1656169384710,COGS 101C,A01,083625,Delgado; Tania,10,0,35,25
1656169390738,COGS 107A,A01,083627,Boyle; Mary E. T.,0,0,60,60
1656169396768,COGS 118A,A01,083075,Gupta; Anjum,7,0,76,69
1656169402794,CSE 3,A50,083646,Miranda; Gregory Joseph,18,0,50,32
1656169408823,CSE 8A,A50,083650,Miranda; Gregory Joseph,3,3,56,53
1656169414856,CSE 11,A01,083080,Cao; Yingjun,1,54,40,39
1656169420882,CSE 12,A01,083652,Krause-Levy; Sophia Louisa,7,2,120,113
1656169426909,CSE 15L,A01,083654,Morris; Justin Loren,2,0,50,48
1656169426909,CSE 15L,A02,083655,Morris; Justin Loren,4,0,50,46
1656169432939,CSE 20,A01,083657,Tran; Khoa Dang,31,0,80,49
1656169438964,CSE 21,A01,095574,Bach; Quang Tran,25,0,48,23
1656169444992,CSE 30,A01,083084,Eldon; John,2,8,80,78
1656169444992,CSE 30,B01,095061,Bhaskar; Nishant,1,2,50,49
1656169451059,CSE 100,A01,083659,Cao; Yingjun,2,20,70,68
1656169457088,CSE 134B,A01,083661,Powell; Thomas Allan,3,0,100,97
1656169463113,CSE 140,A01,083663,Gungor; Onat,9,0,85,76
1656169469140,CSE 140L,A01,083088,Eldon; John,8,0,100,92
1656169475259,CSE 175,A01,083665,Kumar; Rakesh,0,0,25,25
1656169481284,CSE 190,A00,092507,Dubnov; Shlomo,3,0,20,17
1656169487319,ECE 45,A01,083139,Congero; Spencer William,1,0,75,74
1656169493346,ECE 65,A50,083695,Saad; Andrew S,9,0,30,21
1656169493346,ECE 65,A51,095125,Staff,23,0,26,3
1656169499372,ECE 109,A01,091882,Touri; Behrouz,0,1,70,70
1656169505398,ECE 180,A00,083140,Abi Samra; Nicholas Camill,1,0,30,29
1656169505398,ECE 180,B00,083141,Abi Samra; Nicholas Camill,0,4,30,30
1656169511426,MATH 10A,A01,083735,Patchell; Gregory David,0,0,30,30
1656169511426,MATH 10A,A02,083736,Patchell; Gregory David,22,0,30,8
1656169511426,MATH 10A,A03,083737,Patchell; Gregory David,16,0,30,14
1656169517465,MATH 10B,A01,083207,Lim; Seonhee,0,0,34,34
1656169517465,MATH 10B,A02,083208,Lim; Seonhee,7,0,35,28
1656169517465,MATH 10B,A03,093472,Staff,1,0,34,33
1656169517465,MATH 10B,B01,083739,Sinha; Shubham,10,0,30,20
1656169523499,MATH 18,A01,083743,Cinel; Cameron Alexander,7,0,30,23
1656169523499,MATH 18,A02,083744,Cinel; Cameron Alexander,10,0,30,20
1656169523499,MATH 18,A03,083745,Cinel; Cameron Alexander,4,0,30,26
1656169523499,MATH 18,B01,083748,Rideout; David Porter,0,0,36,36
1656169523499,MATH 18,B02,083749,Rideout; David Porter,0,0,36,36
1656169523499,MATH 18,B03,083750,Rideout; David Porter,0,0,36,36
1656169523499,MATH 18,B04,083751,Rideout; David Porter,0,0,36,36
1656169523499,MATH 18,B05,093473,Rideout; David Porter,1,0,36,35
1656169523499,MATH 18,B06,093474,Rideout; David Porter,3,0,36,33
1656169529526,MATH 20A,A01,083754,Zheng; Zequn,11,0,40,29
1656169535560,MATH 20B,A01,083756,Briones; Jor-el Thomas Caparas,0,0,36,36
1656169535560,MATH 20B,A02,083757,Briones; Jor-el Thomas Caparas,0,0,36,36
1656169535560,MATH 20B,A03,093475,Staff,2,0,36,34
1656169541588,MATH 20C,A01,083760,Briones; Jor-el Thomas Caparas,0,0,35,35
1656169541588,MATH 20C,A02,083761,Briones; Jor-el Thomas Caparas,9,1,35,26
1656169541588,MATH 20C,A03,093476,Staff,0,0,35,35
1656169541588,MATH 20C,B01,083762,Bach; Quang Tran,1,0,30,29
1656169547616,MATH 20D,A01,083765,Tran; Brian Kha,1,0,30,29
1656169547616,MATH 20D,A02,083766,Tran; Brian Kha,0,1,30,30
1656169547616,MATH 20D,A03,083767,Tran; Brian Kha,2,0,30,28
1656169553645,MATH 20E,A01,083771,Ganguly; Soumya,4,0,32,28
1656169553645,MATH 20E,A02,083772,Ganguly; Soumya,0,0,32,32
1656169553645,MATH 20E,B01,083773,Ciotti; Benjamin,15,0,35,20
1656169553645,MATH 20E,B02,083774,Ciotti; Benjamin,15,0,35,20
1656169559675,MATH 103A,A01,083777,Greenfeld; Be'Eri,1,0,36,35
1656169559675,MATH 103A,A02,083778,Greenfeld; Be'Eri,1,0,36,35
1656169559675,MATH 103A,A03,093561,Staff,5,0,36,31
1656169559675,MATH 103A,B01,083779,Greenfeld; Be'Eri,8,1,36,28
1656169559675,MATH 103A,B02,083780,Greenfeld; Be'Eri,1,0,36,35
1656169559675,MATH 103A,B03,093562,Staff,0,0,36,36
1656169565709,MATH 105,A01,085443,Carter; Anne Toulson,5,1,35,30
1656169565709,MATH 105,A02,093477,Staff,11,0,35,24
1656169571742,MATH 109,A01,083213,Ganzberger; Geoffrey Michael,0,0,34,34
1656169571742,MATH 109,A02,083214,Ganzberger; Geoffrey Michael,0,0,34,34
1656169571742,MATH 109,A03,093478,Staff,1,0,34,33
1656169571742,MATH 109,B01,083215,Ganzberger; Geoffrey Michael,4,0,32,28
1656169571742,MATH 109,B02,083216,Ganzberger; Geoffrey Michael,1,0,32,31
1656169571742,MATH 109,B03,093479,Staff,4,0,32,28
1656169577769,MATH 142A,A01,083219,Chow; Bennett,1,0,32,31
1656169577769,MATH 142A,A02,083220,Chow; Bennett,8,0,32,24
1656169577769,MATH 142A,A03,093480,Staff,5,0,32,27
1656169577769,MATH 142A,B03,093481,Staff,4,0,32,28
1656169577769,MATH 142A,B04,093558,Staff,6,0,32,26
1656169577769,MATH 142A,B05,093559,Staff,0,0,32,32
1656169583796,MATH 193A,A01,083224,Rotar; Vladimir,0,1,34,34
1656169583796,MATH 193A,A02,083225,Rotar; Vladimir,0,0,34,34
1656169583796,MATH 193A,A03,083781,Rotar; Vladimir,0,0,34,34
1656169583796,MATH 193A,A04,083782,Rotar; Vladimir,6,0,34,28
1656169583796,MATH 193A,A05,093482,Rotar; Vladimir,1,0,34,33
1656169589825,MATH 197,001,091859,McAuley; Julian John,9999,0,9999,0
1656169589825,MATH 197,002,095566,Kedlaya; Kiran S.,9997,0,9999,2
1656169589825,MATH 197,003,095567,Xiao; Ming,9999,0,9999,0
1656169589825,MATH 197,004,095571,Perols; Johan Lars,9998,0,9999,1
1656169596895,COGS 9,A01,083615,Shannon; Kyle Michael,4,0,75,71
1656169602920,COGS 11,A01,083617,Boyle; Mary E. T.,14,0,48,34
1656169608947,COGS 13,A01,083071,Bastos; Amalia Pinkusfeld,5,0,71,66
1656169614972,COGS 14A,A01,092681,Semenuks; Arturs,4,15,100,96
1656169620997,COGS 14B,A01,083073,Cheng; Tzu-Han,7,0,63,56
1656169627025,COGS 17,A01,092677,Semenuks; Arturs,8,0,81,73
1656169633052,COGS 100,A01,083619,Allen; Michael Gordon,2,0,70,68
1656169639077,COGS 101A,A01,083621,Davis; Joshua Daniel,3,0,68,65
1656169645108,COGS 101B,A01,091572,Allen; Michael Gordon,6,0,65,59
1656169651134,COGS 101C,A01,083625,Delgado; Tania,10,0,35,25
1656169657160,COGS 107A,A01,083627,Boyle; Mary E. T.,0,0,60,60
1656169663200,COGS 118A,A01,083075,Gupta; Anjum,7,0,76,69
1656169669228,CSE 3,A50,083646,Miranda; Gregory Joseph,18,0,50,32
1656169675259,CSE 8A,A50,083650,Miranda; Gregory Joseph,3,3,56,53
1656169681289,CSE 11,A01,083080,Cao; Yingjun,1,54,40,39
1656169687317,CSE 12,A01,083652,Krause-Levy; Sophia Louisa,7,2,120,113
1656169693342,CSE 15L,A01,083654,Morris; Justin Loren,2,0,50,48
1656169693342,CSE 15L,A02,083655,Morris; Justin Loren,4,0,50,46
1656169699373,CSE 20,A01,083657,Tran; Khoa Dang,31,0,80,49
1656169705405,CSE 21,A01,095574,Bach; Quang Tran,25,0,48,23
1656169711431,CSE 30,A01,083084,Eldon; John,2,8,80,78
1656169711431,CSE 30,B01,095061,Bhaskar; Nishant,1,2,50,49
1656169717454,CSE 100,A01,083659,Cao; Yingjun,2,20,70,68
1656169723482,CSE 134B,A01,083661,Powell; Thomas Allan,3,0,100,97
1656169729511,CSE 140,A01,083663,Gungor; Onat,9,0,85,76
1656169735540,CSE 140L,A01,083088,Eldon; John,8,0,100,92
1656169741569,CSE 175,A01,083665,Kumar; Rakesh,0,0,25,25
1656169747594,CSE 190,A00,092507,Dubnov; Shlomo,3,0,20,17
1656169753626,ECE 45,A01,083139,Congero; Spencer William,1,0,75,74
1656169759660,ECE 65,A50,083695,Saad; Andrew S,9,0,30,21
1656169759660,ECE 65,A51,095125,Staff,23,0,26,3
1656169765687,ECE 109,A01,091882,Touri; Behrouz,0,1,70,70
1656169771718,ECE 180,A00,083140,Abi Samra; Nicholas Camill,1,0,30,29
1656169771718,ECE 180,B00,083141,Abi Samra; Nicholas Camill,0,4,30,30
1656169777749,MATH 10A,A01,083735,Patchell; Gregory David,0,0,30,30
1656169777749,MATH 10A,A02,083736,Patchell; Gregory David,22,0,30,8
1656169777749,MATH 10A,A03,083737,Patchell; Gregory David,16,0,30,14
1656169783778,MATH 10B,A01,083207,Lim; Seonhee,0,0,34,34
1656169783778,MATH 10B,A02,083208,Lim; Seonhee,7,0,35,28
1656169783778,MATH 10B,A03,093472,Staff,1,0,34,33
1656169783778,MATH 10B,B01,083739,Sinha; Shubham,10,0,30,20
1656169789815,MATH 18,A01,083743,Cinel; Cameron Alexander,7,0,30,23
1656169789815,MATH 18,A02,083744,Cinel; Cameron Alexander,10,0,30,20
1656169789815,MATH 18,A03,083745,Cinel; Cameron Alexander,4,0,30,26
1656169789815,MATH 18,B01,083748,Rideout; David Porter,0,0,36,36
1656169789815,MATH 18,B02,083749,Rideout; David Porter,0,0,36,36
1656169789815,MATH 18,B03,083750,Rideout; David Porter,0,0,36,36
1656169789815,MATH 18,B04,083751,Rideout; David Porter,0,0,36,36
1656169789815,MATH 18,B05,093473,Rideout; David Porter,1,0,36,35
1656169789815,MATH 18,B06,093474,Rideout; David Porter,3,0,36,33
1656169795865,MATH 20A,A01,083754,Zheng; Zequn,11,0,40,29
1656169801890,MATH 20B,A01,083756,Briones; Jor-el Thomas Caparas,0,0,36,36
1656169801890,MATH 20B,A02,083757,Briones; Jor-el Thomas Caparas,0,0,36,36
1656169801890,MATH 20B,A03,093475,Staff,2,0,36,34
1656169807921,MATH 20C,A01,083760,Briones; Jor-el Thomas Caparas,0,0,35,35
1656169807921,MATH 20C,A02,083761,Briones; Jor-el Thomas Caparas,9,1,35,26
1656169807921,MATH 20C,A03,093476,Staff,0,0,35,35
1656169807921,MATH 20C,B01,083762,Bach; Quang Tran,1,0,30,29
1656169813952,MATH 20D,A01,083765,Tran; Brian Kha,1,0,30,29
1656169813952,MATH 20D,A02,083766,Tran; Brian Kha,0,1,30,30
1656169813952,MATH 20D,A03,083767,Tran; Brian Kha,2,0,30,28
1656169819995,MATH 20E,A01,083771,Ganguly; Soumya,4,0,32,28
1656169819995,MATH 20E,A02,083772,Ganguly; Soumya,0,0,32,32
1656169819995,MATH 20E,B01,083773,Ciotti; Benjamin,15,0,35,20
1656169819995,MATH 20E,B02,083774,Ciotti; Benjamin,15,0,35,20
1656169826029,MATH 103A,A01,083777,Greenfeld; Be'Eri,1,0,36,35
1656169826029,MATH 103A,A02,083778,Greenfeld; Be'Eri,1,0,36,35
1656169826029,MATH 103A,A03,093561,Staff,5,0,36,31
1656169826029,MATH 103A,B01,083779,Greenfeld; Be'Eri,8,1,36,28
1656169826029,MATH 103A,B02,083780,Greenfeld; Be'Eri,1,0,36,35
1656169826029,MATH 103A,B03,093562,Staff,0,0,36,36
1656169832062,MATH 105,A01,085443,Carter; Anne Toulson,5,1,35,30
1656169832062,MATH 105,A02,093477,Staff,11,0,35,24
1656169838088,MATH 109,A01,083213,Ganzberger; Geoffrey Michael,0,0,34,34
1656169838088,MATH 109,A02,083214,Ganzberger; Geoffrey Michael,0,0,34,34
1656169838088,MATH 109,A03,093478,Staff,1,0,34,33
1656169838088,MATH 109,B01,083215,Ganzberger; Geoffrey Michael,4,0,32,28
1656169838088,MATH 109,B02,083216,Ganzberger; Geoffrey Michael,1,0,32,31
1656169838088,MATH 109,B03,093479,Staff,4,0,32,28
1656169844125,MATH 142A,A01,083219,Chow; Bennett,1,0,32,31
1656169844125,MATH 142A,A02,083220,Chow; Bennett,8,0,32,24
1656169844125,MATH 142A,A03,093480,Staff,5,0,32,27
1656169844125,MATH 142A,B03,093481,Staff,4,0,32,28
1656169844125,MATH 142A,B04,093558,Staff,6,0,32,26
1656169844125,MATH 142A,B05,093559,Staff,0,0,32,32
1656169850162,MATH 193A,A01,083224,Rotar; Vladimir,0,1,34,34
1656169850162,MATH 193A,A02,083225,Rotar; Vladimir,0,0,34,34
1656169850162,MATH 193A,A03,083781,Rotar; Vladimir,0,0,34,34
1656169850162,MATH 193A,A04,083782,Rotar; Vladimir,6,0,34,28
1656169850162,MATH 193A,A05,093482,Rotar; Vladimir,1,0,34,33
1656169856188,MATH 197,001,091859,McAuley; Julian John,9999,0,9999,0
1656169856188,MATH 197,002,095566,Kedlaya; Kiran S.,9997,0,9999,2
1656169856188,MATH 197,003,095567,Xiao; Ming,9999,0,9999,0
1656169856188,MATH 197,004,095571,Perols; Johan Lars,9998,0,9999,1
1656169863277,COGS 9,A01,083615,Shannon; Kyle Michael,4,0,75,71
1656169869302,COGS 11,A01,083617,Boyle; Mary E. T.,14,0,48,34
1656169875329,COGS 13,A01,083071,Bastos; Amalia Pinkusfeld,5,0,71,66
1656169881354,COGS 14A,A01,092681,Semenuks; Arturs,4,15,100,96
1656169887384,COGS 14B,A01,083073,Cheng; Tzu-Han,7,0,63,56
1656169893412,COGS 17,A01,092677,Semenuks; Arturs,8,0,81,73
1656169899443,COGS 100,A01,083619,Allen; Michael Gordon,2,0,70,68
1656169905467,COGS 101A,A01,083621,Davis; Joshua Daniel,3,0,68,65
1656169911497,COGS 101B,A01,091572,Allen; Michael Gordon,6,0,65,59
1656169917527,COGS 101C,A01,083625,Delgado; Tania,10,0,35,25
1656169923555,COGS 107A,A01,083627,Boyle; Mary E. T.,0,0,60,60
1656169929580,COGS 118A,A01,083075,Gupta; Anjum,7,0,76,69
1656169935607,CSE 3,A50,083646,Miranda; Gregory Joseph,18,0,50,32
1656169941638,CSE 8A,A50,083650,Miranda; Gregory Joseph,3,3,56,53
1656169947665,CSE 11,A01,083080,Cao; Yingjun,1,54,40,39
1656169953690,CSE 12,A01,083652,Krause-Levy; Sophia Louisa,7,2,120,113
1656169959717,CSE 15L,A01,083654,Morris; Justin Loren,2,0,50,48
1656169959717,CSE 15L,A02,083655,Morris; Justin Loren,4,0,50,46
1656169965740,CSE 20,A01,083657,Tran; Khoa Dang,31,0,80,49
1656169971770,CSE 21,A01,095574,Bach; Quang Tran,25,0,48,23
1656169977812,CSE 30,A01,083084,Eldon; John,2,8,80,78
1656169977812,CSE 30,B01,095061,Bhaskar; Nishant,1,2,50,49
1656169983844,CSE 100,A01,083659,Cao; Yingjun,2,20,70,68
1656169989869,CSE 134B,A01,083661,Powell; Thomas Allan,3,0,100,97
1656169995895,CSE 140,A01,083663,Gungor; Onat,9,0,85,76
1656170001919,CSE 140L,A01,083088,Eldon; John,8,0,100,92
1656170007944,CSE 175,A01,083665,Kumar; Rakesh,0,0,25,25
1656170013980,CSE 190,A00,092507,Dubnov; Shlomo,3,0,20,17
1656170020006,ECE 45,A01,083139,Congero; Spencer William,1,0,75,74
1656170026037,ECE 65,A50,083695,Saad; Andrew S,9,0,30,21
1656170026037,ECE 65,A51,095125,Staff,23,0,26,3
1656170032067,ECE 109,A01,091882,Touri; Behrouz,0,1,70,70
1656170038093,ECE 180,A00,083140,Abi Samra; Nicholas Camill,1,0,30,29
1656170038093,ECE 180,B00,083141,Abi Samra; Nicholas Camill,0,4,30,30
1656170044122,MATH 10A,A01,083735,Patchell; Gregory David,0,0,30,30
1656170044122,MATH 10A,A02,083736,Patchell; Gregory David,22,0,30,8
1656170044122,MATH 10A,A03,083737,Patchell; Gregory David,16,0,30,14
1656170050151,MATH 10B,A01,083207,Lim; Seonhee,0,0,34,34
1656170050151,MATH 10B,A02,083208,Lim; Seonhee,7,0,35,28
1656170050151,MATH 10B,A03,093472,Staff,1,0,34,33
1656170050151,MATH 10B,B01,083739,Sinha; Shubham,10,0,30,20
1656170056181,MATH 18,A01,083743,Cinel; Cameron Alexander,7,0,30,23
1656170056181,MATH 18,A02,083744,Cinel; Cameron Alexander,10,0,30,20
1656170056181,MATH 18,A03,083745,Cinel; Cameron Alexander,4,0,30,26
1656170056181,MATH 18,B01,083748,Rideout; David Porter,0,0,36,36
1656170056181,MATH 18,B02,083749,Rideout; David Porter,0,0,36,36
1656170056181,MATH 18,B03,083750,Rideout; David Porter,0,0,36,36
1656170056181,MATH 18,B04,083751,Rideout; David Porter,0,0,36,36
1656170056181,MATH 18,B05,093473,Rideout; David Porter,1,0,36,35
1656170056181,MATH 18,B06,093474,Rideout; David Porter,3,0,36,33
1656170062207,MATH 20A,A01,083754,Zheng; Zequn,11,0,40,29
1656170068240,MATH 20B,A01,083756,Briones; Jor-el Thomas Caparas,0,0,36,36
1656170068240,MATH 20B,A02,083757,Briones; Jor-el Thomas Caparas,0,0,36,36
1656170068240,MATH 20B,A03,093475,Staff,2,0,36,34
1656170074340,MATH 20C,A01,083760,Briones; Jor-el Thomas Caparas,0,0,35,35
1656170074340,MATH 20C,A02,083761,Briones; Jor-el Thomas Caparas,9,1,35,26
1656170074340,MATH 20C,A03,093476,Staff,0,0,35,35
1656170074340,MATH 20C,B01,083762,Bach; Quang Tran,1,0,30,29
1656170080371,MATH 20D,A01,083765,Tran; Brian Kha,1,0,30,29
1656170080371,MATH 20D,A02,083766,Tran; Brian Kha,0,1,30,30
1656170080371,MATH 20D,A03,083767,Tran; Brian Kha,2,0,30,28
1656170086399,MATH 20E,A01,083771,Ganguly; Soumya,4,0,32,28
1656170086399,MATH 20E,A02,083772,Ganguly; Soumya,0,0,32,32
1656170086399,MATH 20E,B01,083773,Ciotti; Benjamin,15,0,35,20
1656170086399,MATH 20E,B02,083774,Ciotti; Benjamin,15,0,35,20
1656170092434,MATH 103A,A01,083777,Greenfeld; Be'Eri,1,0,36,35
1656170092434,MATH 103A,A02,083778,Greenfeld; Be'Eri,1,0,36,35
1656170092434,MATH 103A,A03,093561,Staff,5,0,36,31
1656170092434,MATH 103A,B01,083779,Greenfeld; Be'Eri,8,1,36,28
1656170092434,MATH 103A,B02,083780,Greenfeld; Be'Eri,1,0,36,35
1656170092434,MATH 103A,B03,093562,Staff,0,0,36,36
1656170098457,MATH 105,A01,085443,Carter; Anne Toulson,5,1,35,30
1656170098457,MATH 105,A02,093477,Staff,11,0,35,24
1656170104487,MATH 109,A01,083213,Ganzberger; Geoffrey Michael,0,0,34,34
1656170104487,MATH 109,A02,083214,Ganzberger; Geoffrey Michael,0,0,34,34
1656170104487,MATH 109,A03,093478,Staff,1,0,34,33
1656170104487,MATH 109,B01,083215,Ganzberger; Geoffrey Michael,4,0,32,28
1656170104487,MATH 109,B02,083216,Ganzberger; Geoffrey Michael,1,0,32,31
1656170104487,MATH 109,B03,093479,Staff,4,0,32,28
1656170110516,MATH 142A,A01,083219,Chow; Bennett,1,0,32,31
1656170110516,MATH 142A,A02,083220,Chow; Bennett,8,0,32,24
1656170110516,MATH 142A,A03,093480,Staff,5,0,32,27
1656170110516,MATH 142A,B03,093481,Staff,4,0,32,28
1656170110516,MATH 142A,B04,093558,Staff,6,0,32,26
1656170110516,MATH 142A,B05,093559,Staff,0,0,32,32
1656170116543,MATH 193A,A01,083224,Rotar; Vladimir,0,1,34,34
1656170116543,MATH 193A,A02,083225,Rotar; Vladimir,0,0,34,34
1656170116543,MATH 193A,A03,083781,Rotar; Vladimir,0,0,34,34
1656170116543,MATH 193A,A04,083782,Rotar; Vladimir,6,0,34,28
1656170116543,MATH 193A,A05,093482,Rotar; Vladimir,1,0,34,33
1656170122569,MATH 197,001,091859,McAuley; Julian John,9999,0,9999,0
1656170122569,MATH 197,002,095566,Kedlaya; Kiran S.,9997,0,9999,2
1656170122569,MATH 197,003,095567,Xiao; Ming,9999,0,9999,0
1656170122569,MATH 197,004,095571,Perols; Johan Lars,9998,0,9999,1
1656170129631,COGS 9,A01,083615,Shannon; Kyle Michael,4,0,75,71
1656170135659,COGS 11,A01,083617,Boyle; Mary E. T.,14,0,48,34
1656170141685,COGS 13,A01,083071,Bastos; Amalia Pinkusfeld,5,0,71,66
1656170147722,COGS 14A,A01,092681,Semenuks; Arturs,4,15,100,96
1656170153752,COGS 14B,A01,083073,Cheng; Tzu-Han,7,0,63,56
1656170159805,COGS 17,A01,092677,Semenuks; Arturs,8,0,81,73
1656170165830,COGS 100,A01,083619,Allen; Michael Gordon,2,0,70,68
1656170171856,COGS 101A,A01,083621,Davis; Joshua Daniel,3,0,68,65
1656170177881,COGS 101B,A01,091572,Allen; Michael Gordon,6,0,65,59
1656170183907,COGS 101C,A01,083625,Delgado; Tania,10,0,35,25
1656170189937,COGS 107A,A01,083627,Boyle; Mary E. T.,0,0,60,60
1656170195974,COGS 118A,A01,083075,Gupta; Anjum,7,0,76,69
1656170202001,CSE 3,A50,083646,Miranda; Gregory Joseph,18,0,50,32
1656170208029,CSE 8A,A50,083650,Miranda; Gregory Joseph,3,3,56,53
1656170214054,CSE 11,A01,083080,Cao; Yingjun,1,54,40,39
1656170220082,CSE 12,A01,083652,Krause-Levy; Sophia Louisa,7,2,120,113
1656170226121,CSE 15L,A01,083654,Morris; Justin Loren,2,0,50,48
1656170226121,CSE 15L,A02,083655,Morris; Justin Loren,4,0,50,46
1656170232146,CSE 20,A01,083657,Tran; Khoa Dang,31,0,80,49
1656170238177,CSE 21,A01,095574,Bach; Quang Tran,25,0,48,23
1656170244214,CSE 30,A01,083084,Eldon; John,2,8,80,78
1656170244214,CSE 30,B01,095061,Bhaskar; Nishant,1,2,50,49
1656170250240,CSE 100,A01,083659,Cao; Yingjun,2,20,70,68
1656170256270,CSE 134B,A01,083661,Powell; Thomas Allan,3,0,100,97
1656170262303,CSE 140,A01,083663,Gungor; Onat,9,0,85,76
1656170268326,CSE 140L,A01,083088,Eldon; John,8,0,100,92
1656170274356,CSE 175,A01,083665,Kumar; Rakesh,0,0,25,25
1656170280388,CSE 190,A00,092507,Dubnov; Shlomo,3,0,20,17
1656170286414,ECE 45,A01,083139,Congero; Spencer William,1,0,75,74
1656170292448,ECE 65,A50,083695,Saad; Andrew S,9,0,30,21
1656170292448,ECE 65,A51,095125,Staff,23,0,26,3
1656170298475,ECE 109,A01,091882,Touri; Behrouz,0,1,70,70
1656170304501,ECE 180,A00,083140,Abi Samra; Nicholas Camill,1,0,30,29
1656170304501,ECE 180,B00,083141,Abi Samra; Nicholas Camill,0,4,30,30
1656170310529,MATH 10A,A01,083735,Patchell; Gregory David,0,0,30,30
1656170310529,MATH 10A,A02,083736,Patchell; Gregory David,22,0,30,8
1656170310529,MATH 10A,A03,083737,Patchell; Gregory David,16,0,30,14
1656170316568,MATH 10B,A01,083207,Lim; Seonhee,0,0,34,34
1656170316568,MATH 10B,A02,083208,Lim; Seonhee,7,0,35,28
1656170316568,MATH 10B,A03,093472,Staff,1,0,34,33
1656170316568,MATH 10B,B01,083739,Sinha; Shubham,10,0,30,20
1656170322597,MATH 18,A01,083743,Cinel; Cameron Alexander,7,0,30,23
1656170322597,MATH 18,A02,083744,Cinel; Cameron Alexander,10,0,30,20
1656170322597,MATH 18,A03,083745,Cinel; Cameron Alexander,4,0,30,26
1656170322597,MATH 18,B01,083748,Rideout; David Porter,0,0,36,36
1656170322597,MATH 18,B02,083749,Rideout; David Porter,0,0,36,36
1656170322597,MATH 18,B03,083750,Rideout; David Porter,0,0,36,36
1656170322597,MATH 18,B04,083751,Rideout; David Porter,0,0,36,36
1656170322597,MATH 18,B05,093473,Rideout; David Porter,1,0,36,35
1656170322597,MATH 18,B06,093474,Rideout; David Porter,3,0,36,33
1656170328624,MATH 20A,A01,083754,Zheng; Zequn,11,0,40,29
1656170334659,MATH 20B,A01,083756,Briones; Jor-el Thomas Caparas,0,0,36,36
1656170334659,MATH 20B,A02,083757,Briones; Jor-el Thomas Caparas,0,0,36,36
1656170334659,MATH 20B,A03,093475,Staff,2,0,36,34
1656170340686,MATH 20C,A01,083760,Briones; Jor-el Thomas Caparas,0,0,35,35
1656170340686,MATH 20C,A02,083761,Briones; Jor-el Thomas Caparas,9,1,35,26
1656170340686,MATH 20C,A03,093476,Staff,0,0,35,35
1656170340686,MATH 20C,B01,083762,Bach; Quang Tran,1,0,30,29
1656170346713,MATH 20D,A01,083765,Tran; Brian Kha,1,0,30,29
1656170346713,MATH 20D,A02,083766,Tran; Brian Kha,0,1,30,30
1656170346713,MATH 20D,A03,083767,Tran; Brian Kha,2,0,30,28
1656170352741,MATH 20E,A01,083771,Ganguly; Soumya,4,0,32,28
1656170352741,MATH 20E,A02,083772,Ganguly; Soumya,0,0,32,32
1656170352741,MATH 20E,B01,083773,Ciotti; Benjamin,15,0,35,20
1656170352741,MATH 20E,B02,083774,Ciotti; Benjamin,15,0,35,20
1656170358770,MATH 103A,A01,083777,Greenfeld; Be'Eri,1,0,36,35
1656170358770,MATH 103A,A02,083778,Greenfeld; Be'Eri,1,0,36,35
1656170358770,MATH 103A,A03,093561,Staff,5,0,36,31
1656170358770,MATH 103A,B01,083779,Greenfeld; Be'Eri,8,1,36,28
1656170358770,MATH 103A,B02,083780,Greenfeld; Be'Eri,1,0,36,35
1656170358770,MATH 103A,B03,093562,Staff,0,0,36,36
1656170364802,MATH 105,A01,085443,Carter; Anne Toulson,5,1,35,30
1656170364802,MATH 105,A02,093477,Staff,11,0,35,24
1656170370837,MATH 109,A01,083213,Ganzberger; Geoffrey Michael,0,0,34,34
1656170370837,MATH 109,A02,083214,Ganzberger; Geoffrey Michael,0,0,34,34
1656170370837,MATH 109,A03,093478,Staff,1,0,34,33
1656170370837,MATH 109,B01,083215,Ganzberger; Geoffrey Michael,4,0,32,28
1656170370837,MATH 109,B02,083216,Ganzberger; Geoffrey Michael,1,0,32,31
1656170370837,MATH 109,B03,093479,Staff,4,0,32,28
1656170376869,MATH 142A,A01,083219,Chow; Bennett,1,0,32,31
1656170376869,MATH 142A,A02,083220,Chow; Bennett,8,0,32,24
1656170376869,MATH 142A,A03,093480,Staff,5,0,32,27
1656170376869,MATH 142A,B03,093481,Staff,4,0,32,28
1656170376869,MATH 142A,B04,093558,Staff,6,0,32,26
1656170376869,MATH 142A,B05,093559,Staff,0,0,32,32
1656170382897,MATH 193A,A01,083224,Rotar; Vladimir,0,1,34,34
1656170382897,MATH 193A,A02,083225,Rotar; Vladimir,0,0,34,34
1656170382897,MATH 193A,A03,083781,Rotar; Vladimir,0,0,34,34
1656170382897,MATH 193A,A04,083782,Rotar; Vladimir,6,0,34,28
1656170382897,MATH 193A,A05,093482,Rotar; Vladimir,1,0,34,33
1656170388927,MATH 197,001,091859,McAuley; Julian John,9999,0,9999,0
1656170388927,MATH 197,002,095566,Kedlaya; Kiran S.,9997,0,9999,2
1656170388927,MATH 197,003,095567,Xiao; Ming,9999,0,9999,0
1656170388927,MATH 197,004,095571,Perols; Johan Lars,9998,0,9999,1
1656170395990,COGS 9,A01,083615,Shannon; Kyle Michael,4,0,75,71
1656170402014,COGS 11,A01,083617,Boyle; Mary E. T.,14,0,48,34
1656170408046,COGS 13,A01,083071,Bastos; Amalia Pinkusfeld,5,0,71,66
1656170414077,COGS 14A,A01,092681,Semenuks; Arturs,4,15,100,96
1656170420103,COGS 14B,A01,083073,Cheng; Tzu-Han,7,0,63,56
1656170426129,COGS 17,A01,092677,Semenuks; Arturs,7,0,81,74
1656170432154,COGS 100,A01,083619,Allen; Michael Gordon,2,0,70,68
1656170438184,COGS 101A,A01,083621,Davis; Joshua Daniel,3,0,68,65
1656170444221,COGS 101B,A01,091572,Allen; Michael Gordon,6,0,65,59
1656170450251,COGS 101C,A01,083625,Delgado; Tania,10,0,35,25
1656170456283,COGS 107A,A01,083627,Boyle; Mary E. T.,0,0,60,60
1656170462314,COGS 118A,A01,083075,Gupta; Anjum,7,0,76,69
1656170468345,CSE 3,A50,083646,Miranda; Gregory Joseph,18,0,50,32
1656170474374,CSE 8A,A50,083650,Miranda; Gregory Joseph,3,3,56,53
1656170480399,CSE 11,A01,083080,Cao; Yingjun,1,54,40,39
1656170486432,CSE 12,A01,083652,Krause-Levy; Sophia Louisa,7,2,120,113
1656170492457,CSE 15L,A01,083654,Morris; Justin Loren,2,0,50,48
1656170492457,CSE 15L,A02,083655,Morris; Justin Loren,4,0,50,46
1656170498483,CSE 20,A01,083657,Tran; Khoa Dang,31,0,80,49
1656170504511,CSE 21,A01,095574,Bach; Quang Tran,25,0,48,23
1656170510539,CSE 30,A01,083084,Eldon; John,2,8,80,78
1656170510539,CSE 30,B01,095061,Bhaskar; Nishant,1,2,50,49
1656170516569,CSE 100,A01,083659,Cao; Yingjun,2,20,70,68
1656170522594,CSE 134B,A01,083661,Powell; Thomas Allan,3,0,100,97
1656170528621,CSE 140,A01,083663,Gungor; Onat,9,0,85,76
1656170534659,CSE 140L,A01,083088,Eldon; John,8,0,100,92
1656170540700,CSE 175,A01,083665,Kumar; Rakesh,0,0,25,25
1656170546725,CSE 190,A00,092507,Dubnov; Shlomo,3,0,20,17
1656170552757,ECE 45,A01,083139,Congero; Spencer William,1,0,75,74
1656170558784,ECE 65,A50,083695,Saad; Andrew S,9,0,30,21
1656170558784,ECE 65,A51,095125,Staff,23,0,26,3
1656170564810,ECE 109,A01,091882,Touri; Behrouz,0,1,70,70
1656170570836,ECE 180,A00,083140,Abi Samra; Nicholas Camill,1,0,30,29
1656170570836,ECE 180,B00,083141,Abi Samra; Nicholas Camill,0,4,30,30
1656170576875,MATH 10A,A01,083735,Patchell; Gregory David,0,0,30,30
1656170576875,MATH 10A,A02,083736,Patchell; Gregory David,22,0,30,8
1656170576875,MATH 10A,A03,083737,Patchell; Gregory David,16,0,30,14
1656170582912,MATH 10B,A01,083207,Lim; Seonhee,0,0,34,34
1656170582912,MATH 10B,A02,083208,Lim; Seonhee,7,0,35,28
1656170582912,MATH 10B,A03,093472,Staff,1,0,34,33
1656170582912,MATH 10B,B01,083739,Sinha; Shubham,10,0,30,20
1656170588942,MATH 18,A01,083743,Cinel; Cameron Alexander,7,0,30,23
1656170588942,MATH 18,A02,083744,Cinel; Cameron Alexander,10,0,30,20
1656170588942,MATH 18,A03,083745,Cinel; Cameron Alexander,4,0,30,26
1656170588942,MATH 18,B01,083748,Rideout; David Porter,0,0,36,36
1656170588942,MATH 18,B02,083749,Rideout; David Porter,0,0,36,36
1656170588942,MATH 18,B03,083750,Rideout; David Porter,0,0,36,36
1656170588942,MATH 18,B04,083751,Rideout; David Porter,0,0,36,36
1656170588942,MATH 18,B05,093473,Rideout; David Porter,1,0,36,35
1656170588942,MATH 18,B06,093474,Rideout; David Porter,3,0,36,33
1656170594969,MATH 20A,A01,083754,Zheng; Zequn,11,0,40,29
1656170600995,MATH 20B,A01,083756,Briones; Jor-el Thomas Caparas,0,0,36,36
1656170600995,MATH 20B,A02,083757,Briones; Jor-el Thomas Caparas,0,0,36,36
1656170600995,MATH 20B,A03,093475,Staff,2,0,36,34
1656170607029,MATH 20C,A01,083760,Briones; Jor-el Thomas Caparas,0,0,35,35
1656170607029,MATH 20C,A02,083761,Briones; Jor-el Thomas Caparas,9,1,35,26
1656170607029,MATH 20C,A03,093476,Staff,0,0,35,35
1656170607029,MATH 20C,B01,083762,Bach; Quang Tran,1,0,30,29
1656170613056,MATH 20D,A01,083765,Tran; Brian Kha,1,0,30,29
1656170613056,MATH 20D,A02,083766,Tran; Brian Kha,0,1,30,30
1656170613056,MATH 20D,A03,083767,Tran; Brian Kha,2,0,30,28
1656170619090,MATH 20E,A01,083771,Ganguly; Soumya,4,0,32,28
1656170619090,MATH 20E,A02,083772,Ganguly; Soumya,0,0,32,32
1656170619090,MATH 20E,B01,083773,Ciotti; Benjamin,15,0,35,20
1656170619090,MATH 20E,B02,083774,Ciotti; Benjamin,15,0,35,20
1656170625120,MATH 103A,A01,083777,Greenfeld; Be'Eri,1,0,36,35
1656170625120,MATH 103A,A02,083778,Greenfeld; Be'Eri,1,0,36,35
1656170625120,MATH 103A,A03,093561,Staff,5,0,36,31
1656170625120,MATH 103A,B01,083779,Greenfeld; Be'Eri,8,1,36,28
1656170625120,MATH 103A,B02,083780,Greenfeld; Be'Eri,1,0,36,35
1656170625120,MATH 103A,B03,093562,Staff,0,0,36,36
1656170631148,MATH 105,A01,085443,Carter; Anne Toulson,5,1,35,30
1656170631148,MATH 105,A02,093477,Staff,11,0,35,24
1656170637175,MATH 109,A01,083213,Ganzberger; Geoffrey Michael,0,0,34,34
1656170637175,MATH 109,A02,083214,Ganzberger; Geoffrey Michael,0,0,34,34
1656170637175,MATH 109,A03,093478,Staff,1,0,34,33
1656170637175,MATH 109,B01,083215,Ganzberger; Geoffrey Michael,4,0,32,28
1656170637175,MATH 109,B02,083216,Ganzberger; Geoffrey Michael,1,0,32,31
1656170637175,MATH 109,B03,093479,Staff,4,0,32,28
1656170643202,MATH 142A,A01,083219,Chow; Bennett,1,0,32,31
1656170643202,MATH 142A,A02,083220,Chow; Bennett,8,0,32,24
1656170643202,MATH 142A,A03,093480,Staff,5,0,32,27
1656170643202,MATH 142A,B03,093481,Staff,4,0,32,28
1656170643202,MATH 142A,B04,093558,Staff,6,0,32,26
1656170643202,MATH 142A,B05,093559,Staff,0,0,32,32
1656170649234,MATH 193A,A01,083224,Rotar; Vladimir,0,1,34,34
1656170649234,MATH 193A,A02,083225,Rotar; Vladimir,0,0,34,34
1656170649234,MATH 193A,A03,083781,Rotar; Vladimir,0,0,34,34
1656170649234,MATH 193A,A04,083782,Rotar; Vladimir,6,0,34,28
1656170649234,MATH 193A,A05,093482,Rotar; Vladimir,1,0,34,33
1656170655265,MATH 197,001,091859,McAuley; Julian John,9999,0,9999,0
1656170655265,MATH 197,002,095566,Kedlaya; Kiran S.,9997,0,9999,2
1656170655265,MATH 197,003,095567,Xiao; Ming,9999,0,9999,0
1656170655265,MATH 197,004,095571,Perols; Johan Lars,9998,0,9999,1
1656170662349,COGS 9,A01,083615,Shannon; Kyle Michael,4,0,75,71
1656170668446,COGS 11,A01,083617,Boyle; Mary E. T.,14,0,48,34
1656170674471,COGS 13,A01,083071,Bastos; Amalia Pinkusfeld,5,0,71,66
1656170680502,COGS 14A,A01,092681,Semenuks; Arturs,4,15,100,96
1656170686528,COGS 14B,A01,083073,Cheng; Tzu-Han,7,0,63,56
1656170692551,COGS 17,A01,092677,Semenuks; Arturs,7,0,81,74
1656170698581,COGS 100,A01,083619,Allen; Michael Gordon,2,0,70,68
1656170704610,COGS 101A,A01,083621,Davis; Joshua Daniel,3,0,68,65
1656170710635,COGS 101B,A01,091572,Allen; Michael Gordon,6,0,65,59
1656170716664,COGS 101C,A01,083625,Delgado; Tania,10,0,35,25
1656170722687,COGS 107A,A01,083627,Boyle; Mary E. T.,0,0,60,60
1656170728714,COGS 118A,A01,083075,Gupta; Anjum,7,0,76,69
1656170734746,CSE 3,A50,083646,Miranda; Gregory Joseph,18,0,50,32
1656170740771,CSE 8A,A50,083650,Miranda; Gregory Joseph,3,3,56,53
1656170746801,CSE 11,A01,083080,Cao; Yingjun,1,54,40,39
1656170752832,CSE 12,A01,083652,Krause-Levy; Sophia Louisa,7,2,120,113
1656170758857,CSE 15L,A01,083654,Morris; Justin Loren,2,0,50,48
1656170758857,CSE 15L,A02,083655,Morris; Justin Loren,4,0,50,46
1656170764893,CSE 20,A01,083657,Tran; Khoa Dang,31,0,80,49
1656170770917,CSE 21,A01,095574,Bach; Quang Tran,25,0,48,23
1656170776943,CSE 30,A01,083084,Eldon; John,2,8,80,78
1656170776943,CSE 30,B01,095061,Bhaskar; Nishant,1,2,50,49
1656170782972,CSE 100,A01,083659,Cao; Yingjun,2,20,70,68
1656170789001,CSE 134B,A01,083661,Powell; Thomas Allan,3,0,100,97
1656170795027,CSE 140,A01,083663,Gungor; Onat,9,0,85,76
1656170801055,CSE 140L,A01,083088,Eldon; John,8,0,100,92
1656170807080,CSE 175,A01,083665,Kumar; Rakesh,0,0,25,25
1656170813108,CSE 190,A00,092507,Dubnov; Shlomo,3,0,20,17
1656170819139,ECE 45,A01,083139,Congero; Spencer William,1,0,75,74
1656170825170,ECE 65,A50,083695,Saad; Andrew S,9,0,30,21
1656170825170,ECE 65,A51,095125,Staff,23,0,26,3
1656170831197,ECE 109,A01,091882,Touri; Behrouz,0,1,70,70
1656170837226,ECE 180,A00,083140,Abi Samra; Nicholas Camill,1,0,30,29
1656170837226,ECE 180,B00,083141,Abi Samra; Nicholas Camill,0,4,30,30
1656170843253,MATH 10A,A01,083735,Patchell; Gregory David,0,0,30,30
1656170843253,MATH 10A,A02,083736,Patchell; Gregory David,22,0,30,8
1656170843253,MATH 10A,A03,083737,Patchell; Gregory David,16,0,30,14
1656170849281,MATH 10B,A01,083207,Lim; Seonhee,0,0,34,34
1656170849281,MATH 10B,A02,083208,Lim; Seonhee,7,0,35,28
1656170849281,MATH 10B,A03,093472,Staff,1,0,34,33
1656170849281,MATH 10B,B01,083739,Sinha; Shubham,10,0,30,20
1656170855317,MATH 18,A01,083743,Cinel; Cameron Alexander,7,0,30,23
1656170855317,MATH 18,A02,083744,Cinel; Cameron Alexander,10,0,30,20
1656170855317,MATH 18,A03,083745,Cinel; Cameron Alexander,4,0,30,26
1656170855317,MATH 18,B01,083748,Rideout; David Porter,0,0,36,36
1656170855317,MATH 18,B02,083749,Rideout; David Porter,0,0,36,36
1656170855317,MATH 18,B03,083750,Rideout; David Porter,0,0,36,36
1656170855317,MATH 18,B04,083751,Rideout; David Porter,0,0,36,36
1656170855317,MATH 18,B05,093473,Rideout; David Porter,1,0,36,35
1656170855317,MATH 18,B06,093474,Rideout; David Porter,3,0,36,33
1656170861345,MATH 20A,A01,083754,Zheng; Zequn,11,0,40,29
1656170867371,MATH 20B,A01,083756,Briones; Jor-el Thomas Caparas,0,0,36,36
1656170867371,MATH 20B,A02,083757,Briones; Jor-el Thomas Caparas,0,0,36,36
1656170867371,MATH 20B,A03,093475,Staff,2,0,36,34
1656170873410,MATH 20C,A01,083760,Briones; Jor-el Thomas Caparas,0,0,35,35
1656170873410,MATH 20C,A02,083761,Briones; Jor-el Thomas Caparas,9,1,35,26
1656170873410,MATH 20C,A03,093476,Staff,0,0,35,35
1656170873410,MATH 20C,B01,083762,Bach; Quang Tran,1,0,30,29
1656170879437,MATH 20D,A01,083765,Tran; Brian Kha,1,0,30,29
1656170879437,MATH 20D,A02,083766,Tran; Brian Kha,0,1,30,30
1656170879437,MATH 20D,A03,083767,Tran; Brian Kha,2,0,30,28
1656170885464,MATH 20E,A01,083771,Ganguly; Soumya,4,0,32,28
1656170885464,MATH 20E,A02,083772,Ganguly; Soumya,0,0,32,32
1656170885464,MATH 20E,B01,083773,Ciotti; Benjamin,15,0,35,20
1656170885464,MATH 20E,B02,083774,Ciotti; Benjamin,15,0,35,20
1656170891490,MATH 103A,A01,083777,Greenfeld; Be'Eri,1,0,36,35
1656170891490,MATH 103A,A02,083778,Greenfeld; Be'Eri,1,0,36,35
1656170891490,MATH 103A,A03,093561,Staff,5,0,36,31
1656170891490,MATH 103A,B01,083779,Greenfeld; Be'Eri,8,1,36,28
1656170891490,MATH 103A,B02,083780,Greenfeld; Be'Eri,1,0,36,35
1656170891490,MATH 103A,B03,093562,Staff,0,0,36,36
1656170897516,MATH 105,A01,085443,Carter; Anne Toulson,5,1,35,30
1656170897516,MATH 105,A02,093477,Staff,11,0,35,24
1656170903570,MATH 109,A01,083213,Ganzberger; Geoffrey Michael,0,0,34,34
1656170903570,MATH 109,A02,083214,Ganzberger; Geoffrey Michael,0,0,34,34
1656170903570,MATH 109,A03,093478,Staff,1,0,34,33
1656170903570,MATH 109,B01,083215,Ganzberger; Geoffrey Michael,4,0,32,28
1656170903570,MATH 109,B02,083216,Ganzberger; Geoffrey Michael,1,0,32,31
1656170903570,MATH 109,B03,093479,Staff,4,0,32,28
1656170909603,MATH 142A,A01,083219,Chow; Bennett,1,0,32,31
1656170909603,MATH 142A,A02,083220,Chow; Bennett,8,0,32,24
1656170909603,MATH 142A,A03,093480,Staff,5,0,32,27
1656170909603,MATH 142A,B03,093481,Staff,4,0,32,28
1656170909603,MATH 142A,B04,093558,Staff,6,0,32,26
1656170909603,MATH 142A,B05,093559,Staff,0,0,32,32
1656170915629,MATH 193A,A01,083224,Rotar; Vladimir,0,1,34,34
1656170915629,MATH 193A,A02,083225,Rotar; Vladimir,0,0,34,34
1656170915629,MATH 193A,A03,083781,Rotar; Vladimir,0,0,34,34
1656170915629,MATH 193A,A04,083782,Rotar; Vladimir,6,0,34,28
1656170915629,MATH 193A,A05,093482,Rotar; Vladimir,1,0,34,33
1656170921655,MATH 197,001,091859,McAuley; Julian John,9999,0,9999,0
1656170921655,MATH 197,002,095566,Kedlaya; Kiran S.,9997,0,9999,2
1656170921655,MATH 197,003,095567,Xiao; Ming,9999,0,9999,0
1656170921655,MATH 197,004,095571,Perols; Johan Lars,9998,0,9999,1
1656170928728,COGS 9,A01,083615,Shannon; Kyle Michael,4,0,75,71
1656170934753,COGS 11,A01,083617,Boyle; Mary E. T.,14,0,48,34
1656170940784,COGS 13,A01,083071,Bastos; Amalia Pinkusfeld,5,0,71,66
1656170946810,COGS 14A,A01,092681,Semenuks; Arturs,4,15,100,96
1656170952835,COGS 14B,A01,083073,Cheng; Tzu-Han,7,0,63,56
1656170958859,COGS 17,A01,092677,Semenuks; Arturs,7,0,81,74
1656170964889,COGS 100,A01,083619,Allen; Michael Gordon,2,0,70,68
1656170970913,COGS 101A,A01,083621,Davis; Joshua Daniel,3,0,68,65
1656170976937,COGS 101B,A01,091572,Allen; Michael Gordon,6,0,65,59
1656170982968,COGS 101C,A01,083625,Delgado; Tania,10,0,35,25
1656170988996,COGS 107A,A01,083627,Boyle; Mary E. T.,0,0,60,60
1656170995020,COGS 118A,A01,083075,Gupta; Anjum,7,0,76,69
1656171001053,CSE 3,A50,083646,Miranda; Gregory Joseph,18,0,50,32
1656171007080,CSE 8A,A50,083650,Miranda; Gregory Joseph,3,3,56,53
1656171013105,CSE 11,A01,083080,Cao; Yingjun,1,54,40,39
1656171019136,CSE 12,A01,083652,Krause-Levy; Sophia Louisa,7,2,120,113
1656171025164,CSE 15L,A01,083654,Morris; Justin Loren,2,0,50,48
1656171025164,CSE 15L,A02,083655,Morris; Justin Loren,4,0,50,46
1656171031194,CSE 20,A01,083657,Tran; Khoa Dang,31,0,80,49
1656171037220,CSE 21,A01,095574,Bach; Quang Tran,25,0,48,23
1656171043246,CSE 30,A01,083084,Eldon; John,2,8,80,78
1656171043246,CSE 30,B01,095061,Bhaskar; Nishant,1,2,50,49
1656171049275,CSE 100,A01,083659,Cao; Yingjun,2,20,70,68
1656171055303,CSE 134B,A01,083661,Powell; Thomas Allan,3,0,100,97
1656171061331,CSE 140,A01,083663,Gungor; Onat,9,0,85,76
1656171067361,CSE 140L,A01,083088,Eldon; John,8,0,100,92
1656171073386,CSE 175,A01,083665,Kumar; Rakesh,0,0,25,25
1656171079412,CSE 190,A00,092507,Dubnov; Shlomo,3,0,20,17
1656171085439,ECE 45,A01,083139,Congero; Spencer William,1,0,75,74
1656171091467,ECE 65,A50,083695,Saad; Andrew S,9,0,30,21
1656171091467,ECE 65,A51,095125,Staff,23,0,26,3
1656171097490,ECE 109,A01,091882,Touri; Behrouz,0,1,70,70
1656171103515,ECE 180,A00,083140,Abi Samra; Nicholas Camill,1,0,30,29
1656171103515,ECE 180,B00,083141,Abi Samra; Nicholas Camill,0,4,30,30
1656171109547,MATH 10A,A01,083735,Patchell; Gregory David,0,0,30,30
1656171109547,MATH 10A,A02,083736,Patchell; Gregory David,22,0,30,8
1656171109547,MATH 10A,A03,083737,Patchell; Gregory David,16,0,30,14
1656171115590,MATH 10B,A01,083207,Lim; Seonhee,0,0,34,34
1656171115590,MATH 10B,A02,083208,Lim; Seonhee,7,0,35,28
1656171115590,MATH 10B,A03,093472,Staff,1,0,34,33
1656171115590,MATH 10B,B01,083739,Sinha; Shubham,10,0,30,20
1656171121616,MATH 18,A01,083743,Cinel; Cameron Alexander,7,0,30,23
1656171121616,MATH 18,A02,083744,Cinel; Cameron Alexander,10,0,30,20
1656171121616,MATH 18,A03,083745,Cinel; Cameron Alexander,4,0,30,26
1656171121616,MATH 18,B01,083748,Rideout; David Porter,0,0,36,36
1656171121616,MATH 18,B02,083749,Rideout; David Porter,0,0,36,36
1656171121616,MATH 18,B03,083750,Rideout; David Porter,0,0,36,36
1656171121616,MATH 18,B04,083751,Rideout; David Porter,0,0,36,36
1656171121616,MATH 18,B05,093473,Rideout; David Porter,1,0,36,35
1656171121616,MATH 18,B06,093474,Rideout; David Porter,3,0,36,33
1656171127644,MATH 20A,A01,083754,Zheng; Zequn,11,0,40,29
1656171133673,MATH 20B,A01,083756,Briones; Jor-el Thomas Caparas,0,0,36,36
1656171133673,MATH 20B,A02,083757,Briones; Jor-el Thomas Caparas,0,0,36,36
1656171133673,MATH 20B,A03,093475,Staff,2,0,36,34
1656171139699,MATH 20C,A01,083760,Briones; Jor-el Thomas Caparas,0,0,35,35
1656171139699,MATH 20C,A02,083761,Briones; Jor-el Thomas Caparas,9,1,35,26
1656171139699,MATH 20C,A03,093476,Staff,0,0,35,35
1656171139699,MATH 20C,B01,083762,Bach; Quang Tran,1,0,30,29
1656171145739,MATH 20D,A01,083765,Tran; Brian Kha,1,0,30,29
1656171145739,MATH 20D,A02,083766,Tran; Brian Kha,0,1,30,30
1656171145739,MATH 20D,A03,083767,Tran; Brian Kha,2,0,30,28
1656171151766,MATH 20E,A01,083771,Ganguly; Soumya,4,0,32,28
1656171151766,MATH 20E,A02,083772,Ganguly; Soumya,0,0,32,32
1656171151766,MATH 20E,B01,083773,Ciotti; Benjamin,15,0,35,20
1656171151766,MATH 20E,B02,083774,Ciotti; Benjamin,15,0,35,20
1656171157801,MATH 103A,A01,083777,Greenfeld; Be'Eri,1,0,36,35
1656171157801,MATH 103A,A02,083778,Greenfeld; Be'Eri,1,0,36,35
1656171157801,MATH 103A,A03,093561,Staff,5,0,36,31
1656171157801,MATH 103A,B01,083779,Greenfeld; Be'Eri,8,1,36,28
1656171157801,MATH 103A,B02,083780,Greenfeld; Be'Eri,1,0,36,35
1656171157801,MATH 103A,B03,093562,Staff,0,0,36,36
1656171163825,MATH 105,A01,085443,Carter; Anne Toulson,5,1,35,30
1656171163825,MATH 105,A02,093477,Staff,11,0,35,24
1656171169850,MATH 109,A01,083213,Ganzberger; Geoffrey Michael,0,0,34,34
1656171169850,MATH 109,A02,083214,Ganzberger; Geoffrey Michael,0,0,34,34
1656171169850,MATH 109,A03,093478,Staff,1,0,34,33
1656171169850,MATH 109,B01,083215,Ganzberger; Geoffrey Michael,4,0,32,28
1656171169850,MATH 109,B02,083216,Ganzberger; Geoffrey Michael,1,0,32,31
1656171169850,MATH 109,B03,093479,Staff,4,0,32,28
1656171175874,MATH 142A,A01,083219,Chow; Bennett,1,0,32,31
1656171175874,MATH 142A,A02,083220,Chow; Bennett,8,0,32,24
1656171175874,MATH 142A,A03,093480,Staff,5,0,32,27
1656171175874,MATH 142A,B03,093481,Staff,4,0,32,28
1656171175874,MATH 142A,B04,093558,Staff,6,0,32,26
1656171175874,MATH 142A,B05,093559,Staff,0,0,32,32
1656171181900,MATH 193A,A01,083224,Rotar; Vladimir,0,1,34,34
1656171181900,MATH 193A,A02,083225,Rotar; Vladimir,0,0,34,34
1656171181900,MATH 193A,A03,083781,Rotar; Vladimir,0,0,34,34
1656171181900,MATH 193A,A04,083782,Rotar; Vladimir,6,0,34,28
1656171181900,MATH 193A,A05,093482,Rotar; Vladimir,1,0,34,33
1656171187931,MATH 197,001,091859,McAuley; Julian John,9999,0,9999,0
1656171187931,MATH 197,002,095566,Kedlaya; Kiran S.,9997,0,9999,2
1656171187931,MATH 197,003,095567,Xiao; Ming,9999,0,9999,0
1656171187931,MATH 197,004,095571,Perols; Johan Lars,9998,0,9999,1
1656171195004,COGS 9,A01,083615,Shannon; Kyle Michael,4,0,75,71
1656171201033,COGS 11,A01,083617,Boyle; Mary E. T.,14,0,48,34
1656171207064,COGS 13,A01,083071,Bastos; Amalia Pinkusfeld,5,0,71,66
1656171213093,COGS 14A,A01,092681,Semenuks; Arturs,4,15,100,96
1656171219124,COGS 14B,A01,083073,Cheng; Tzu-Han,7,0,63,56
1656171225154,COGS 17,A01,092677,Semenuks; Arturs,7,0,81,74
1656171231183,COGS 100,A01,083619,Allen; Michael Gordon,2,0,70,68
1656171237215,COGS 101A,A01,083621,Davis; Joshua Daniel,3,0,68,65
1656171243239,COGS 101B,A01,091572,Allen; Michael Gordon,6,0,65,59
1656171249268,COGS 101C,A01,083625,Delgado; Tania,10,0,35,25
1656171255299,COGS 107A,A01,083627,Boyle; Mary E. T.,0,0,60,60
1656171261324,COGS 118A,A01,083075,Gupta; Anjum,7,0,76,69
1656171267448,CSE 3,A50,083646,Miranda; Gregory Joseph,18,0,50,32
1656171273472,CSE 8A,A50,083650,Miranda; Gregory Joseph,3,3,56,53
1656171279497,CSE 11,A01,083080,Cao; Yingjun,1,54,40,39
1656171285524,CSE 12,A01,083652,Krause-Levy; Sophia Louisa,7,2,120,113
1656171291548,CSE 15L,A01,083654,Morris; Justin Loren,2,0,50,48
1656171291548,CSE 15L,A02,083655,Morris; Justin Loren,4,0,50,46
1656171297573,CSE 20,A01,083657,Tran; Khoa Dang,31,0,80,49
1656171303599,CSE 21,A01,095574,Bach; Quang Tran,25,0,48,23
1656171309631,CSE 30,A01,083084,Eldon; John,2,8,80,78
1656171309631,CSE 30,B01,095061,Bhaskar; Nishant,1,2,50,49
1656171315659,CSE 100,A01,083659,Cao; Yingjun,2,20,70,68
1656171321688,CSE 134B,A01,083661,Powell; Thomas Allan,3,0,100,97
1656171327712,CSE 140,A01,083663,Gungor; Onat,9,0,85,76
1656171333737,CSE 140L,A01,083088,Eldon; John,8,0,100,92
1656171339762,CSE 175,A01,083665,Kumar; Rakesh,0,0,25,25
1656171345785,CSE 190,A00,092507,Dubnov; Shlomo,3,0,20,17
1656171351816,ECE 45,A01,083139,Congero; Spencer William,1,0,75,74
1656171357843,ECE 65,A50,083695,Saad; Andrew S,9,0,30,21
1656171357843,ECE 65,A51,095125,Staff,23,0,26,3
1656171363871,ECE 109,A01,091882,Touri; Behrouz,0,1,70,70
1656171369896,ECE 180,A00,083140,Abi Samra; Nicholas Camill,1,0,30,29
1656171369896,ECE 180,B00,083141,Abi Samra; Nicholas Camill,0,4,30,30
1656171375926,MATH 10A,A01,083735,Patchell; Gregory David,0,0,30,30
1656171375926,MATH 10A,A02,083736,Patchell; Gregory David,22,0,30,8
1656171375926,MATH 10A,A03,083737,Patchell; Gregory David,16,0,30,14
1656171381951,MATH 10B,A01,083207,Lim; Seonhee,0,0,34,34
1656171381951,MATH 10B,A02,083208,Lim; Seonhee,7,0,35,28
1656171381951,MATH 10B,A03,093472,Staff,1,0,34,33
1656171381951,MATH 10B,B01,083739,Sinha; Shubham,10,0,30,20
1656171387989,MATH 18,A01,083743,Cinel; Cameron Alexander,7,0,30,23
1656171387989,MATH 18,A02,083744,Cinel; Cameron Alexander,10,0,30,20
1656171387989,MATH 18,A03,083745,Cinel; Cameron Alexander,4,0,30,26
1656171387989,MATH 18,B01,083748,Rideout; David Porter,0,0,36,36
1656171387989,MATH 18,B02,083749,Rideout; David Porter,0,0,36,36
1656171387989,MATH 18,B03,083750,Rideout; David Porter,0,0,36,36
1656171387989,MATH 18,B04,083751,Rideout; David Porter,0,0,36,36
1656171387989,MATH 18,B05,093473,Rideout; David Porter,1,0,36,35
1656171387989,MATH 18,B06,093474,Rideout; David Porter,3,0,36,33
1656171394019,MATH 20A,A01,083754,Zheng; Zequn,11,0,40,29
1656171400050,MATH 20B,A01,083756,Briones; Jor-el Thomas Caparas,0,0,36,36
1656171400050,MATH 20B,A02,083757,Briones; Jor-el Thomas Caparas,0,0,36,36
1656171400050,MATH 20B,A03,093475,Staff,2,0,36,34
1656171406081,MATH 20C,A01,083760,Briones; Jor-el Thomas Caparas,0,0,35,35
1656171406081,MATH 20C,A02,083761,Briones; Jor-el Thomas Caparas,9,1,35,26
1656171406081,MATH 20C,A03,093476,Staff,0,0,35,35
1656171406081,MATH 20C,B01,083762,Bach; Quang Tran,1,0,30,29
1656171412106,MATH 20D,A01,083765,Tran; Brian Kha,1,0,30,29
1656171412106,MATH 20D,A02,083766,Tran; Brian Kha,0,1,30,30
1656171412106,MATH 20D,A03,083767,Tran; Brian Kha,2,0,30,28
1656171418135,MATH 20E,A01,083771,Ganguly; Soumya,4,0,32,28
1656171418135,MATH 20E,A02,083772,Ganguly; Soumya,0,0,32,32
1656171418135,MATH 20E,B01,083773,Ciotti; Benjamin,15,0,35,20
1656171418135,MATH 20E,B02,083774,Ciotti; Benjamin,15,0,35,20
1656171424172,MATH 103A,A01,083777,Greenfeld; Be'Eri,1,0,36,35
1656171424172,MATH 103A,A02,083778,Greenfeld; Be'Eri,1,0,36,35
1656171424172,MATH 103A,A03,093561,Staff,5,0,36,31
1656171424172,MATH 103A,B01,083779,Greenfeld; Be'Eri,8,1,36,28
1656171424172,MATH 103A,B02,083780,Greenfeld; Be'Eri,1,0,36,35
1656171424172,MATH 103A,B03,093562,Staff,0,0,36,36
1656171430198,MATH 105,A01,085443,Carter; Anne Toulson,5,1,35,30
1656171430198,MATH 105,A02,093477,Staff,11,0,35,24
1656171436229,MATH 109,A01,083213,Ganzberger; Geoffrey Michael,0,0,34,34
1656171436229,MATH 109,A02,083214,Ganzberger; Geoffrey Michael,0,0,34,34
1656171436229,MATH 109,A03,093478,Staff,1,0,34,33
1656171436229,MATH 109,B01,083215,Ganzberger; Geoffrey Michael,4,0,32,28
1656171436229,MATH 109,B02,083216,Ganzberger; Geoffrey Michael,1,0,32,31
1656171436229,MATH 109,B03,093479,Staff,4,0,32,28
1656171442264,MATH 142A,A01,083219,Chow; Bennett,1,0,32,31
1656171442264,MATH 142A,A02,083220,Chow; Bennett,8,0,32,24
1656171442264,MATH 142A,A03,093480,Staff,5,0,32,27
1656171442264,MATH 142A,B03,093481,Staff,4,0,32,28
1656171442264,MATH 142A,B04,093558,Staff,6,0,32,26
1656171442264,MATH 142A,B05,093559,Staff,0,0,32,32
1656171448290,MATH 193A,A01,083224,Rotar; Vladimir,0,1,34,34
1656171448290,MATH 193A,A02,083225,Rotar; Vladimir,0,0,34,34
1656171448290,MATH 193A,A03,083781,Rotar; Vladimir,0,0,34,34
1656171448290,MATH 193A,A04,083782,Rotar; Vladimir,6,0,34,28
1656171448290,MATH 193A,A05,093482,Rotar; Vladimir,1,0,34,33
1656171454321,MATH 197,001,091859,McAuley; Julian John,9999,0,9999,0
1656171454321,MATH 197,002,095566,Kedlaya; Kiran S.,9997,0,9999,2
1656171454321,MATH 197,003,095567,Xiao; Ming,9999,0,9999,0
1656171454321,MATH 197,004,095571,Perols; Johan Lars,9998,0,9999,1
1656171461409,COGS 9,A01,083615,Shannon; Kyle Michael,4,0,75,71
1656171467438,COGS 11,A01,083617,Boyle; Mary E. T.,14,0,48,34
1656171473464,COGS 13,A01,083071,Bastos; Amalia Pinkusfeld,5,0,71,66
1656171479494,COGS 14A,A01,092681,Semenuks; Arturs,4,15,100,96
1656171485524,COGS 14B,A01,083073,Cheng; Tzu-Han,7,0,63,56
1656171491555,COGS 17,A01,092677,Semenuks; Arturs,7,0,81,74
1656171497580,COGS 100,A01,083619,Allen; Michael Gordon,2,0,70,68
1656171503605,COGS 101A,A01,083621,Davis; Joshua Daniel,3,0,68,65
1656171509629,COGS 101B,A01,091572,Allen; Michael Gordon,6,0,65,59
1656171515660,COGS 101C,A01,083625,Delgado; Tania,10,0,35,25
1656171521690,COGS 107A,A01,083627,Boyle; Mary E. T.,0,0,60,60
1656171527722,COGS 118A,A01,083075,Gupta; Anjum,7,0,76,69
1656171533751,CSE 3,A50,083646,Miranda; Gregory Joseph,18,0,50,32
1656171539777,CSE 8A,A50,083650,Miranda; Gregory Joseph,3,3,56,53
1656171545800,CSE 11,A01,083080,Cao; Yingjun,1,54,40,39
1656171551827,CSE 12,A01,083652,Krause-Levy; Sophia Louisa,7,2,120,113
1656171557857,CSE 15L,A01,083654,Morris; Justin Loren,2,0,50,48
1656171557857,CSE 15L,A02,083655,Morris; Justin Loren,4,0,50,46
1656171563919,CSE 20,A01,083657,Tran; Khoa Dang,31,0,80,49
1656171569945,CSE 21,A01,095574,Bach; Quang Tran,25,0,48,23
1656171575984,CSE 30,A01,083084,Eldon; John,2,8,80,78
1656171575984,CSE 30,B01,095061,Bhaskar; Nishant,1,2,50,49
1656171582009,CSE 100,A01,083659,Cao; Yingjun,2,20,70,68
1656171588033,CSE 134B,A01,083661,Powell; Thomas Allan,3,0,100,97
1656171594058,CSE 140,A01,083663,Gungor; Onat,9,0,85,76
1656171600088,CSE 140L,A01,083088,Eldon; John,8,0,100,92
1656171606114,CSE 175,A01,083665,Kumar; Rakesh,0,0,25,25
1656171612144,CSE 190,A00,092507,Dubnov; Shlomo,3,0,20,17
1656171618170,ECE 45,A01,083139,Congero; Spencer William,1,0,75,74
1656171624196,ECE 65,A50,083695,Saad; Andrew S,9,0,30,21
1656171624196,ECE 65,A51,095125,Staff,23,0,26,3
1656171630224,ECE 109,A01,091882,Touri; Behrouz,0,1,70,70
1656171636248,ECE 180,A00,083140,Abi Samra; Nicholas Camill,1,0,30,29
1656171636248,ECE 180,B00,083141,Abi Samra; Nicholas Camill,0,4,30,30
1656171642275,MATH 10A,A01,083735,Patchell; Gregory David,0,0,30,30
1656171642275,MATH 10A,A02,083736,Patchell; Gregory David,22,0,30,8
1656171642275,MATH 10A,A03,083737,Patchell; Gregory David,16,0,30,14
1656171648303,MATH 10B,A01,083207,Lim; Seonhee,0,0,34,34
1656171648303,MATH 10B,A02,083208,Lim; Seonhee,7,0,35,28
1656171648303,MATH 10B,A03,093472,Staff,1,0,34,33
1656171648303,MATH 10B,B01,083739,Sinha; Shubham,10,0,30,20
1656171654333,MATH 18,A01,083743,Cinel; Cameron Alexander,7,0,30,23
1656171654333,MATH 18,A02,083744,Cinel; Cameron Alexander,10,0,30,20
1656171654333,MATH 18,A03,083745,Cinel; Cameron Alexander,4,0,30,26
1656171654333,MATH 18,B01,083748,Rideout; David Porter,0,0,36,36
1656171654333,MATH 18,B02,083749,Rideout; David Porter,0,0,36,36
1656171654333,MATH 18,B03,083750,Rideout; David Porter,0,0,36,36
1656171654333,MATH 18,B04,083751,Rideout; David Porter,0,0,36,36
1656171654333,MATH 18,B05,093473,Rideout; David Porter,1,0,36,35
1656171654333,MATH 18,B06,093474,Rideout; David Porter,3,0,36,33
1656171660368,MATH 20A,A01,083754,Zheng; Zequn,11,0,40,29
1656171666394,MATH 20B,A01,083756,Briones; Jor-el Thomas Caparas,0,0,36,36
1656171666394,MATH 20B,A02,083757,Briones; Jor-el Thomas Caparas,0,0,36,36
1656171666394,MATH 20B,A03,093475,Staff,2,0,36,34
1656171672420,MATH 20C,A01,083760,Briones; Jor-el Thomas Caparas,0,0,35,35
1656171672420,MATH 20C,A02,083761,Briones; Jor-el Thomas Caparas,9,1,35,26
1656171672420,MATH 20C,A03,093476,Staff,0,0,35,35
1656171672420,MATH 20C,B01,083762,Bach; Quang Tran,1,0,30,29
1656171678452,MATH 20D,A01,083765,Tran; Brian Kha,1,0,30,29
1656171678452,MATH 20D,A02,083766,Tran; Brian Kha,0,1,30,30
1656171678452,MATH 20D,A03,083767,Tran; Brian Kha,2,0,30,28
1656171684479,MATH 20E,A01,083771,Ganguly; Soumya,4,0,32,28
1656171684479,MATH 20E,A02,083772,Ganguly; Soumya,0,0,32,32
1656171684479,MATH 20E,B01,083773,Ciotti; Benjamin,15,0,35,20
1656171684479,MATH 20E,B02,083774,Ciotti; Benjamin,15,0,35,20
1656171690508,MATH 103A,A01,083777,Greenfeld; Be'Eri,1,0,36,35
1656171690508,MATH 103A,A02,083778,Greenfeld; Be'Eri,1,0,36,35
1656171690508,MATH 103A,A03,093561,Staff,5,0,36,31
1656171690508,MATH 103A,B01,083779,Greenfeld; Be'Eri,8,1,36,28
1656171690508,MATH 103A,B02,083780,Greenfeld; Be'Eri,1,0,36,35
1656171690508,MATH 103A,B03,093562,Staff,0,0,36,36
1656171696533,MATH 105,A01,085443,Carter; Anne Toulson,5,1,35,30
1656171696533,MATH 105,A02,093477,Staff,11,0,35,24
1656171702572,MATH 109,A01,083213,Ganzberger; Geoffrey Michael,0,0,34,34
1656171702572,MATH 109,A02,083214,Ganzberger; Geoffrey Michael,0,0,34,34
1656171702572,MATH 109,A03,093478,Staff,1,0,34,33
1656171702572,MATH 109,B01,083215,Ganzberger; Geoffrey Michael,4,0,32,28
1656171702572,MATH 109,B02,083216,Ganzberger; Geoffrey Michael,1,0,32,31
1656171702572,MATH 109,B03,093479,Staff,4,0,32,28
1656171708605,MATH 142A,A01,083219,Chow; Bennett,1,0,32,31
1656171708605,MATH 142A,A02,083220,Chow; Bennett,8,0,32,24
1656171708605,MATH 142A,A03,093480,Staff,5,0,32,27
1656171708605,MATH 142A,B03,093481,Staff,4,0,32,28
1656171708605,MATH 142A,B04,093558,Staff,6,0,32,26
1656171708605,MATH 142A,B05,093559,Staff,0,0,32,32
1656171714637,MATH 193A,A01,083224,Rotar; Vladimir,0,1,34,34
1656171714637,MATH 193A,A02,083225,Rotar; Vladimir,0,0,34,34
1656171714637,MATH 193A,A03,083781,Rotar; Vladimir,0,0,34,34
1656171714637,MATH 193A,A04,083782,Rotar; Vladimir,6,0,34,28
1656171714637,MATH 193A,A05,093482,Rotar; Vladimir,1,0,34,33
1656171720669,MATH 197,001,091859,McAuley; Julian John,9999,0,9999,0
1656171720669,MATH 197,002,095566,Kedlaya; Kiran S.,9997,0,9999,2
1656171720669,MATH 197,003,095567,Xiao; Ming,9999,0,9999,0
1656171720669,MATH 197,004,095571,Perols; Johan Lars,9998,0,9999,1
1656171727746,COGS 9,A01,083615,Shannon; Kyle Michael,4,0,75,71
1656171733770,COGS 11,A01,083617,Boyle; Mary E. T.,14,0,48,34
1656171739806,COGS 13,A01,083071,Bastos; Amalia Pinkusfeld,5,0,71,66
1656171745834,COGS 14A,A01,092681,Semenuks; Arturs,4,15,100,96
1656171751857,COGS 14B,A01,083073,Cheng; Tzu-Han,7,0,63,56
1656171757882,COGS 17,A01,092677,Semenuks; Arturs,7,0,81,74
1656171763908,COGS 100,A01,083619,Allen; Michael Gordon,2,0,70,68
1656171769938,COGS 101A,A01,083621,Davis; Joshua Daniel,3,0,68,65
1656171775964,COGS 101B,A01,091572,Allen; Michael Gordon,6,0,65,59
1656171781993,COGS 101C,A01,083625,Delgado; Tania,10,0,35,25
1656171788023,COGS 107A,A01,083627,Boyle; Mary E. T.,0,0,60,60
1656171794046,COGS 118A,A01,083075,Gupta; Anjum,7,0,76,69
1656171800077,CSE 3,A50,083646,Miranda; Gregory Joseph,18,0,50,32
1656171806103,CSE 8A,A50,083650,Miranda; Gregory Joseph,3,3,56,53
1656171812132,CSE 11,A01,083080,Cao; Yingjun,1,54,40,39
1656171818161,CSE 12,A01,083652,Krause-Levy; Sophia Louisa,7,2,120,113
1656171824191,CSE 15L,A01,083654,Morris; Justin Loren,2,0,50,48
1656171824191,CSE 15L,A02,083655,Morris; Justin Loren,4,0,50,46
1656171830218,CSE 20,A01,083657,Tran; Khoa Dang,31,0,80,49
1656171836247,CSE 21,A01,095574,Bach; Quang Tran,25,0,48,23
1656171842272,CSE 30,A01,083084,Eldon; John,2,8,80,78
1656171842272,CSE 30,B01,095061,Bhaskar; Nishant,1,2,50,49
1656171848295,CSE 100,A01,083659,Cao; Yingjun,2,20,70,68
1656171854323,CSE 134B,A01,083661,Powell; Thomas Allan,3,0,100,97
1656171860350,CSE 140,A01,083663,Gungor; Onat,9,0,85,76
1656171866446,CSE 140L,A01,083088,Eldon; John,8,0,100,92
1656171872472,CSE 175,A01,083665,Kumar; Rakesh,0,0,25,25
1656171878496,CSE 190,A00,092507,Dubnov; Shlomo,3,0,20,17
1656171884527,ECE 45,A01,083139,Congero; Spencer William,1,0,75,74
1656171890557,ECE 65,A50,083695,Saad; Andrew S,9,0,30,21
1656171890557,ECE 65,A51,095125,Staff,23,0,26,3
1656171896585,ECE 109,A01,091882,Touri; Behrouz,0,1,70,70
1656171902615,ECE 180,A00,083140,Abi Samra; Nicholas Camill,1,0,30,29
1656171902615,ECE 180,B00,083141,Abi Samra; Nicholas Camill,0,4,30,30
1656171908646,MATH 10A,A01,083735,Patchell; Gregory David,0,0,30,30
1656171908646,MATH 10A,A02,083736,Patchell; Gregory David,22,0,30,8
1656171908646,MATH 10A,A03,083737,Patchell; Gregory David,16,0,30,14
1656171914673,MATH 10B,A01,083207,Lim; Seonhee,0,0,34,34
1656171914673,MATH 10B,A02,083208,Lim; Seonhee,7,0,35,28
1656171914673,MATH 10B,A03,093472,Staff,1,0,34,33
1656171914673,MATH 10B,B01,083739,Sinha; Shubham,10,0,30,20
1656171920700,MATH 18,A01,083743,Cinel; Cameron Alexander,7,0,30,23
1656171920700,MATH 18,A02,083744,Cinel; Cameron Alexander,10,0,30,20
1656171920700,MATH 18,A03,083745,Cinel; Cameron Alexander,4,0,30,26
1656171920700,MATH 18,B01,083748,Rideout; David Porter,0,0,36,36
1656171920700,MATH 18,B02,083749,Rideout; David Porter,0,0,36,36
1656171920700,MATH 18,B03,083750,Rideout; David Porter,0,0,36,36
1656171920700,MATH 18,B04,083751,Rideout; David Porter,0,0,36,36
1656171920700,MATH 18,B05,093473,Rideout; David Porter,1,0,36,35
1656171920700,MATH 18,B06,093474,Rideout; David Porter,3,0,36,33
1656171926736,MATH 20A,A01,083754,Zheng; Zequn,11,0,40,29
1656171932768,MATH 20B,A01,083756,Briones; Jor-el Thomas Caparas,0,0,36,36
1656171932768,MATH 20B,A02,083757,Briones; Jor-el Thomas Caparas,0,0,36,36
1656171932768,MATH 20B,A03,093475,Staff,2,0,36,34
1656171938799,MATH 20C,A01,083760,Briones; Jor-el Thomas Caparas,0,0,35,35
1656171938799,MATH 20C,A02,083761,Briones; Jor-el Thomas Caparas,9,1,35,26
1656171938799,MATH 20C,A03,093476,Staff,0,0,35,35
1656171938799,MATH 20C,B01,083762,Bach; Quang Tran,1,0,30,29
1656171944830,MATH 20D,A01,083765,Tran; Brian Kha,1,0,30,29
1656171944830,MATH 20D,A02,083766,Tran; Brian Kha,0,1,30,30
1656171944830,MATH 20D,A03,083767,Tran; Brian Kha,2,0,30,28
1656171950855,MATH 20E,A01,083771,Ganguly; Soumya,4,0,32,28
1656171950855,MATH 20E,A02,083772,Ganguly; Soumya,0,0,32,32
1656171950855,MATH 20E,B01,083773,Ciotti; Benjamin,15,0,35,20
1656171950855,MATH 20E,B02,083774,Ciotti; Benjamin,15,0,35,20
1656171956883,MATH 103A,A01,083777,Greenfeld; Be'Eri,1,0,36,35
1656171956883,MATH 103A,A02,083778,Greenfeld; Be'Eri,1,0,36,35
1656171956883,MATH 103A,A03,093561,Staff,5,0,36,31
1656171956883,MATH 103A,B01,083779,Greenfeld; Be'Eri,8,1,36,28
1656171956883,MATH 103A,B02,083780,Greenfeld; Be'Eri,1,0,36,35
1656171956883,MATH 103A,B03,093562,Staff,0,0,36,36
1656171962914,MATH 105,A01,085443,Carter; Anne Toulson,5,1,35,30
1656171962914,MATH 105,A02,093477,Staff,11,0,35,24
1656171968943,MATH 109,A01,083213,Ganzberger; Geoffrey Michael,0,0,34,34
1656171968943,MATH 109,A02,083214,Ganzberger; Geoffrey Michael,0,0,34,34
1656171968943,MATH 109,A03,093478,Staff,1,0,34,33
1656171968943,MATH 109,B01,083215,Ganzberger; Geoffrey Michael,4,0,32,28
1656171968943,MATH 109,B02,083216,Ganzberger; Geoffrey Michael,1,0,32,31
1656171968943,MATH 109,B03,093479,Staff,4,0,32,28
1656171974976,MATH 142A,A01,083219,Chow; Bennett,1,0,32,31
1656171974976,MATH 142A,A02,083220,Chow; Bennett,8,0,32,24
1656171974976,MATH 142A,A03,093480,Staff,5,0,32,27
1656171974976,MATH 142A,B03,093481,Staff,4,0,32,28
1656171974976,MATH 142A,B04,093558,Staff,6,0,32,26
1656171974976,MATH 142A,B05,093559,Staff,0,0,32,32
1656171981009,MATH 193A,A01,083224,Rotar; Vladimir,0,1,34,34
1656171981009,MATH 193A,A02,083225,Rotar; Vladimir,0,0,34,34
1656171981009,MATH 193A,A03,083781,Rotar; Vladimir,0,0,34,34
1656171981009,MATH 193A,A04,083782,Rotar; Vladimir,6,0,34,28
1656171981009,MATH 193A,A05,093482,Rotar; Vladimir,1,0,34,33
1656171987034,MATH 197,001,091859,McAuley; Julian John,9999,0,9999,0
1656171987034,MATH 197,002,095566,Kedlaya; Kiran S.,9997,0,9999,2
1656171987034,MATH 197,003,095567,Xiao; Ming,9999,0,9999,0
1656171987034,MATH 197,004,095571,Perols; Johan Lars,9998,0,9999,1
1656171994106,COGS 9,A01,083615,Shannon; Kyle Michael,4,0,75,71
1656172000132,COGS 11,A01,083617,Boyle; Mary E. T.,14,0,48,34
1656172006159,COGS 13,A01,083071,Bastos; Amalia Pinkusfeld,5,0,71,66
1656172012188,COGS 14A,A01,092681,Semenuks; Arturs,4,15,100,96
1656172018215,COGS 14B,A01,083073,Cheng; Tzu-Han,7,0,63,56
1656172024242,COGS 17,A01,092677,Semenuks; Arturs,7,0,81,74
1656172030273,COGS 100,A01,083619,Allen; Michael Gordon,2,0,70,68
1656172036297,COGS 101A,A01,083621,Davis; Joshua Daniel,3,0,68,65
1656172042326,COGS 101B,A01,091572,Allen; Michael Gordon,6,0,65,59
1656172048352,COGS 101C,A01,083625,Delgado; Tania,10,0,35,25
1656172054376,COGS 107A,A01,083627,Boyle; Mary E. T.,0,0,60,60
1656172060404,COGS 118A,A01,083075,Gupta; Anjum,7,0,76,69
1656172066436,CSE 3,A50,083646,Miranda; Gregory Joseph,18,0,50,32
1656172072459,CSE 8A,A50,083650,Miranda; Gregory Joseph,3,3,56,53
1656172078488,CSE 11,A01,083080,Cao; Yingjun,1,54,40,39
1656172084514,CSE 12,A01,083652,Krause-Levy; Sophia Louisa,7,2,120,113
1656172090542,CSE 15L,A01,083654,Morris; Justin Loren,2,0,50,48
1656172090542,CSE 15L,A02,083655,Morris; Justin Loren,4,0,50,46
1656172096565,CSE 20,A01,083657,Tran; Khoa Dang,31,0,80,49
1656172102589,CSE 21,A01,095574,Bach; Quang Tran,25,0,48,23
1656172108616,CSE 30,A01,083084,Eldon; John,2,8,80,78
1656172108616,CSE 30,B01,095061,Bhaskar; Nishant,1,2,50,49
1656172114640,CSE 100,A01,083659,Cao; Yingjun,2,20,70,68
1656172120663,CSE 134B,A01,083661,Powell; Thomas Allan,3,0,100,97
1656172126691,CSE 140,A01,083663,Gungor; Onat,9,0,85,76
1656172132715,CSE 140L,A01,083088,Eldon; John,8,0,100,92
1656172138746,CSE 175,A01,083665,Kumar; Rakesh,0,0,25,25
1656172144775,CSE 190,A00,092507,Dubnov; Shlomo,3,0,20,17
1656172150800,ECE 45,A01,083139,Congero; Spencer William,1,0,75,74
1656172156826,ECE 65,A50,083695,Saad; Andrew S,9,0,30,21
1656172156826,ECE 65,A51,095125,Staff,23,0,26,3
1656172162851,ECE 109,A01,091882,Touri; Behrouz,0,1,70,70
1656172168874,ECE 180,A00,083140,Abi Samra; Nicholas Camill,1,0,30,29
1656172168874,ECE 180,B00,083141,Abi Samra; Nicholas Camill,0,4,30,30
1656172174908,MATH 10A,A01,083735,Patchell; Gregory David,0,0,30,30
1656172174908,MATH 10A,A02,083736,Patchell; Gregory David,22,0,30,8
1656172174908,MATH 10A,A03,083737,Patchell; Gregory David,16,0,30,14
1656172180937,MATH 10B,A01,083207,Lim; Seonhee,0,0,34,34
1656172180937,MATH 10B,A02,083208,Lim; Seonhee,7,0,35,28
1656172180937,MATH 10B,A03,093472,Staff,1,0,34,33
1656172180937,MATH 10B,B01,083739,Sinha; Shubham,10,0,30,20
1656172186974,MATH 18,A01,083743,Cinel; Cameron Alexander,7,0,30,23
1656172186974,MATH 18,A02,083744,Cinel; Cameron Alexander,10,0,30,20
1656172186974,MATH 18,A03,083745,Cinel; Cameron Alexander,4,0,30,26
1656172186974,MATH 18,B01,083748,Rideout; David Porter,0,0,36,36
1656172186974,MATH 18,B02,083749,Rideout; David Porter,0,0,36,36
1656172186974,MATH 18,B03,083750,Rideout; David Porter,0,0,36,36
1656172186974,MATH 18,B04,083751,Rideout; David Porter,0,0,36,36
1656172186974,MATH 18,B05,093473,Rideout; David Porter,1,0,36,35
1656172186974,MATH 18,B06,093474,Rideout; David Porter,3,0,36,33
1656172193005,MATH 20A,A01,083754,Zheng; Zequn,11,0,40,29
1656172199031,MATH 20B,A01,083756,Briones; Jor-el Thomas Caparas,0,0,36,36
1656172199031,MATH 20B,A02,083757,Briones; Jor-el Thomas Caparas,0,0,36,36
1656172199031,MATH 20B,A03,093475,Staff,2,0,36,34
1656172205056,MATH 20C,A01,083760,Briones; Jor-el Thomas Caparas,0,0,35,35
1656172205056,MATH 20C,A02,083761,Briones; Jor-el Thomas Caparas,9,1,35,26
1656172205056,MATH 20C,A03,093476,Staff,0,0,35,35
1656172205056,MATH 20C,B01,083762,Bach; Quang Tran,1,0,30,29
1656172211098,MATH 20D,A01,083765,Tran; Brian Kha,1,0,30,29
1656172211098,MATH 20D,A02,083766,Tran; Brian Kha,0,1,30,30
1656172211098,MATH 20D,A03,083767,Tran; Brian Kha,2,0,30,28
1656172217131,MATH 20E,A01,083771,Ganguly; Soumya,4,0,32,28
1656172217131,MATH 20E,A02,083772,Ganguly; Soumya,0,0,32,32
1656172217131,MATH 20E,B01,083773,Ciotti; Benjamin,15,0,35,20
1656172217131,MATH 20E,B02,083774,Ciotti; Benjamin,15,0,35,20
1656172223158,MATH 103A,A01,083777,Greenfeld; Be'Eri,1,0,36,35
1656172223158,MATH 103A,A02,083778,Greenfeld; Be'Eri,1,0,36,35
1656172223158,MATH 103A,A03,093561,Staff,5,0,36,31
1656172223158,MATH 103A,B01,083779,Greenfeld; Be'Eri,8,1,36,28
1656172223158,MATH 103A,B02,083780,Greenfeld; Be'Eri,1,0,36,35
1656172223158,MATH 103A,B03,093562,Staff,0,0,36,36
1656172229186,MATH 105,A01,085443,Carter; Anne Toulson,5,1,35,30
1656172229186,MATH 105,A02,093477,Staff,11,0,35,24
1656172235217,MATH 109,A01,083213,Ganzberger; Geoffrey Michael,0,0,34,34
1656172235217,MATH 109,A02,083214,Ganzberger; Geoffrey Michael,0,0,34,34
1656172235217,MATH 109,A03,093478,Staff,1,0,34,33
1656172235217,MATH 109,B01,083215,Ganzberger; Geoffrey Michael,4,0,32,28
1656172235217,MATH 109,B02,083216,Ganzberger; Geoffrey Michael,1,0,32,31
1656172235217,MATH 109,B03,093479,Staff,4,0,32,28
1656172241246,MATH 142A,A01,083219,Chow; Bennett,1,0,32,31
1656172241246,MATH 142A,A02,083220,Chow; Bennett,8,0,32,24
1656172241246,MATH 142A,A03,093480,Staff,5,0,32,27
1656172241246,MATH 142A,B03,093481,Staff,4,0,32,28
1656172241246,MATH 142A,B04,093558,Staff,6,0,32,26
1656172241246,MATH 142A,B05,093559,Staff,0,0,32,32
1656172247273,MATH 193A,A01,083224,Rotar; Vladimir,0,1,34,34
1656172247273,MATH 193A,A02,083225,Rotar; Vladimir,0,0,34,34
1656172247273,MATH 193A,A03,083781,Rotar; Vladimir,0,0,34,34
1656172247273,MATH 193A,A04,083782,Rotar; Vladimir,6,0,34,28
1656172247273,MATH 193A,A05,093482,Rotar; Vladimir,1,0,34,33
1656172253299,MATH 197,001,091859,McAuley; Julian John,9999,0,9999,0
1656172253299,MATH 197,002,095566,Kedlaya; Kiran S.,9997,0,9999,2
1656172253299,MATH 197,003,095567,Xiao; Ming,9999,0,9999,0
1656172253299,MATH 197,004,095571,Perols; Johan Lars,9998,0,9999,1
1656172260379,COGS 9,A01,083615,Shannon; Kyle Michael,4,0,75,71
1656172266403,COGS 11,A01,083617,Boyle; Mary E. T.,14,0,48,34
1656172272428,COGS 13,A01,083071,Bastos; Amalia Pinkusfeld,5,0,71,66
1656172278458,COGS 14A,A01,092681,Semenuks; Arturs,4,15,100,96
1656172284483,COGS 14B,A01,083073,Cheng; Tzu-Han,7,0,63,56
1656172290511,COGS 17,A01,092677,Semenuks; Arturs,7,0,81,74
1656172296543,COGS 100,A01,083619,Allen; Michael Gordon,2,0,70,68
1656172302569,COGS 101A,A01,083621,Davis; Joshua Daniel,3,0,68,65
1656172308598,COGS 101B,A01,091572,Allen; Michael Gordon,6,0,65,59
1656172314627,COGS 101C,A01,083625,Delgado; Tania,10,0,35,25
1656172320656,COGS 107A,A01,083627,Boyle; Mary E. T.,0,0,60,60
1656172326679,COGS 118A,A01,083075,Gupta; Anjum,7,0,76,69
1656172332705,CSE 3,A50,083646,Miranda; Gregory Joseph,18,0,50,32
1656172338744,CSE 8A,A50,083650,Miranda; Gregory Joseph,3,3,56,53
1656172344767,CSE 11,A01,083080,Cao; Yingjun,1,54,40,39
1656172350792,CSE 12,A01,083652,Krause-Levy; Sophia Louisa,7,2,120,113
1656172356816,CSE 15L,A01,083654,Morris; Justin Loren,2,0,50,48
1656172356816,CSE 15L,A02,083655,Morris; Justin Loren,4,0,50,46
1656172362851,CSE 20,A01,083657,Tran; Khoa Dang,31,0,80,49
1656172368876,CSE 21,A01,095574,Bach; Quang Tran,25,0,48,23
1656172374907,CSE 30,A01,083084,Eldon; John,2,8,80,78
1656172374907,CSE 30,B01,095061,Bhaskar; Nishant,1,2,50,49
1656172380933,CSE 100,A01,083659,Cao; Yingjun,2,20,70,68
1656172386958,CSE 134B,A01,083661,Powell; Thomas Allan,3,0,100,97
1656172392983,CSE 140,A01,083663,Gungor; Onat,9,0,85,76
1656172399014,CSE 140L,A01,083088,Eldon; John,8,0,100,92
1656172405043,CSE 175,A01,083665,Kumar; Rakesh,0,0,25,25
1656172411071,CSE 190,A00,092507,Dubnov; Shlomo,3,0,20,17
1656172417100,ECE 45,A01,083139,Congero; Spencer William,1,0,75,74
1656172423125,ECE 65,A50,083695,Saad; Andrew S,9,0,30,21
1656172423125,ECE 65,A51,095125,Staff,23,0,26,3
1656172429151,ECE 109,A01,091882,Touri; Behrouz,0,1,70,70
1656172435182,ECE 180,A00,083140,Abi Samra; Nicholas Camill,1,0,30,29
1656172435182,ECE 180,B00,083141,Abi Samra; Nicholas Camill,0,4,30,30
1656172441214,MATH 10A,A01,083735,Patchell; Gregory David,0,0,30,30
1656172441214,MATH 10A,A02,083736,Patchell; Gregory David,22,0,30,8
1656172441214,MATH 10A,A03,083737,Patchell; Gregory David,16,0,30,14
1656172447240,MATH 10B,A01,083207,Lim; Seonhee,0,0,34,34
1656172447240,MATH 10B,A02,083208,Lim; Seonhee,7,0,35,28
1656172447240,MATH 10B,A03,093472,Staff,1,0,34,33
1656172447240,MATH 10B,B01,083739,Sinha; Shubham,10,0,30,20
1656172453269,MATH 18,A01,083743,Cinel; Cameron Alexander,7,0,30,23
1656172453269,MATH 18,A02,083744,Cinel; Cameron Alexander,10,0,30,20
1656172453269,MATH 18,A03,083745,Cinel; Cameron Alexander,4,0,30,26
1656172453269,MATH 18,B01,083748,Rideout; David Porter,0,0,36,36
1656172453269,MATH 18,B02,083749,Rideout; David Porter,0,0,36,36
1656172453269,MATH 18,B03,083750,Rideout; David Porter,0,0,36,36
1656172453269,MATH 18,B04,083751,Rideout; David Porter,0,0,36,36
1656172453269,MATH 18,B05,093473,Rideout; David Porter,1,0,36,35
1656172453269,MATH 18,B06,093474,Rideout; David Porter,2,0,36,34
1656172459292,MATH 20A,A01,083754,Zheng; Zequn,11,0,40,29
1656172465412,MATH 20B,A01,083756,Briones; Jor-el Thomas Caparas,0,0,36,36
1656172465412,MATH 20B,A02,083757,Briones; Jor-el Thomas Caparas,0,0,36,36
1656172465412,MATH 20B,A03,093475,Staff,2,0,36,34
1656172471442,MATH 20C,A01,083760,Briones; Jor-el Thomas Caparas,0,0,35,35
1656172471442,MATH 20C,A02,083761,Briones; Jor-el Thomas Caparas,9,1,35,26
1656172471442,MATH 20C,A03,093476,Staff,0,0,35,35
1656172471442,MATH 20C,B01,083762,Bach; Quang Tran,1,0,30,29
1656172477472,MATH 20D,A01,083765,Tran; Brian Kha,1,0,30,29
1656172477472,MATH 20D,A02,083766,Tran; Brian Kha,0,1,30,30
1656172477472,MATH 20D,A03,083767,Tran; Brian Kha,2,0,30,28
1656172483499,MATH 20E,A01,083771,Ganguly; Soumya,4,0,32,28
1656172483499,MATH 20E,A02,083772,Ganguly; Soumya,0,0,32,32
1656172483499,MATH 20E,B01,083773,Ciotti; Benjamin,15,0,35,20
1656172483499,MATH 20E,B02,083774,Ciotti; Benjamin,15,0,35,20
1656172489532,MATH 103A,A01,083777,Greenfeld; Be'Eri,1,0,36,35
1656172489532,MATH 103A,A02,083778,Greenfeld; Be'Eri,1,0,36,35
1656172489532,MATH 103A,A03,093561,Staff,5,0,36,31
1656172489532,MATH 103A,B01,083779,Greenfeld; Be'Eri,8,1,36,28
1656172489532,MATH 103A,B02,083780,Greenfeld; Be'Eri,1,0,36,35
1656172489532,MATH 103A,B03,093562,Staff,0,0,36,36
1656172495556,MATH 105,A01,085443,Carter; Anne Toulson,5,1,35,30
1656172495556,MATH 105,A02,093477,Staff,11,0,35,24
1656172501583,MATH 109,A01,083213,Ganzberger; Geoffrey Michael,0,0,34,34
1656172501583,MATH 109,A02,083214,Ganzberger; Geoffrey Michael,0,0,34,34
1656172501583,MATH 109,A03,093478,Staff,1,0,34,33
1656172501583,MATH 109,B01,083215,Ganzberger; Geoffrey Michael,4,0,32,28
1656172501583,MATH 109,B02,083216,Ganzberger; Geoffrey Michael,1,0,32,31
1656172501583,MATH 109,B03,093479,Staff,4,0,32,28
1656172507609,MATH 142A,A01,083219,Chow; Bennett,1,0,32,31
1656172507609,MATH 142A,A02,083220,Chow; Bennett,8,0,32,24
1656172507609,MATH 142A,A03,093480,Staff,5,0,32,27
1656172507609,MATH 142A,B03,093481,Staff,4,0,32,28
1656172507609,MATH 142A,B04,093558,Staff,6,0,32,26
1656172507609,MATH 142A,B05,093559,Staff,0,0,32,32
1656172513635,MATH 193A,A01,083224,Rotar; Vladimir,0,1,34,34
1656172513635,MATH 193A,A02,083225,Rotar; Vladimir,0,0,34,34
1656172513635,MATH 193A,A03,083781,Rotar; Vladimir,0,0,34,34
1656172513635,MATH 193A,A04,083782,Rotar; Vladimir,6,0,34,28
1656172513635,MATH 193A,A05,093482,Rotar; Vladimir,1,0,34,33
1656172519660,MATH 197,001,091859,McAuley; Julian John,9999,0,9999,0
1656172519660,MATH 197,002,095566,Kedlaya; Kiran S.,9997,0,9999,2
1656172519660,MATH 197,003,095567,Xiao; Ming,9999,0,9999,0
1656172519660,MATH 197,004,095571,Perols; Johan Lars,9998,0,9999,1
1656172526730,COGS 9,A01,083615,Shannon; Kyle Michael,4,0,75,71
1656172532755,COGS 11,A01,083617,Boyle; Mary E. T.,14,0,48,34
1656172538780,COGS 13,A01,083071,Bastos; Amalia Pinkusfeld,5,0,71,66
1656172544804,COGS 14A,A01,092681,Semenuks; Arturs,4,15,100,96
1656172550828,COGS 14B,A01,083073,Cheng; Tzu-Han,7,0,63,56
1656172556852,COGS 17,A01,092677,Semenuks; Arturs,7,0,81,74
1656172562882,COGS 100,A01,083619,Allen; Michael Gordon,2,0,70,68
1656172568908,COGS 101A,A01,083621,Davis; Joshua Daniel,3,0,68,65
1656172574934,COGS 101B,A01,091572,Allen; Michael Gordon,6,0,65,59
1656172580961,COGS 101C,A01,083625,Delgado; Tania,10,0,35,25
1656172586989,COGS 107A,A01,083627,Boyle; Mary E. T.,0,0,60,60
1656172593015,COGS 118A,A01,083075,Gupta; Anjum,7,0,76,69
1656172599056,CSE 3,A50,083646,Miranda; Gregory Joseph,18,0,50,32
1656172605088,CSE 8A,A50,083650,Miranda; Gregory Joseph,3,3,56,53
1656172611114,CSE 11,A01,083080,Cao; Yingjun,1,54,40,39
1656172617140,CSE 12,A01,083652,Krause-Levy; Sophia Louisa,7,2,120,113
1656172623164,CSE 15L,A01,083654,Morris; Justin Loren,2,0,50,48
1656172623164,CSE 15L,A02,083655,Morris; Justin Loren,4,0,50,46
1656172629196,CSE 20,A01,083657,Tran; Khoa Dang,31,0,80,49
1656172635231,CSE 21,A01,095574,Bach; Quang Tran,25,0,48,23
1656172641259,CSE 30,A01,083084,Eldon; John,2,8,80,78
1656172641259,CSE 30,B01,095061,Bhaskar; Nishant,1,2,50,49
1656172647284,CSE 100,A01,083659,Cao; Yingjun,2,20,70,68
1656172653309,CSE 134B,A01,083661,Powell; Thomas Allan,3,0,100,97
1656172659338,CSE 140,A01,083663,Gungor; Onat,9,0,85,76
1656172665362,CSE 140L,A01,083088,Eldon; John,8,0,100,92
1656172671386,CSE 175,A01,083665,Kumar; Rakesh,0,0,25,25
1656172677411,CSE 190,A00,092507,Dubnov; Shlomo,3,0,20,17
1656172683436,ECE 45,A01,083139,Congero; Spencer William,1,0,75,74
1656172689459,ECE 65,A50,083695,Saad; Andrew S,9,0,30,21
1656172689459,ECE 65,A51,095125,Staff,23,0,26,3
1656172695485,ECE 109,A01,091882,Touri; Behrouz,0,1,70,70
1656172701509,ECE 180,A00,083140,Abi Samra; Nicholas Camill,1,0,30,29
1656172701509,ECE 180,B00,083141,Abi Samra; Nicholas Camill,0,4,30,30
1656172707537,MATH 10A,A01,083735,Patchell; Gregory David,0,0,30,30
1656172707537,MATH 10A,A02,083736,Patchell; Gregory David,22,0,30,8
1656172707537,MATH 10A,A03,083737,Patchell; Gregory David,16,0,30,14
1656172713574,MATH 10B,A01,083207,Lim; Seonhee,0,0,34,34
1656172713574,MATH 10B,A02,083208,Lim; Seonhee,7,0,35,28
1656172713574,MATH 10B,A03,093472,Staff,1,0,34,33
1656172713574,MATH 10B,B01,083739,Sinha; Shubham,10,0,30,20
1656172719603,MATH 18,A01,083743,Cinel; Cameron Alexander,7,0,30,23
1656172719603,MATH 18,A02,083744,Cinel; Cameron Alexander,10,0,30,20
1656172719603,MATH 18,A03,083745,Cinel; Cameron Alexander,4,0,30,26
1656172719603,MATH 18,B01,083748,Rideout; David Porter,0,0,36,36
1656172719603,MATH 18,B02,083749,Rideout; David Porter,0,0,36,36
1656172719603,MATH 18,B03,083750,Rideout; David Porter,0,0,36,36
1656172719603,MATH 18,B04,083751,Rideout; David Porter,0,0,36,36
1656172719603,MATH 18,B05,093473,Rideout; David Porter,1,0,36,35
1656172719603,MATH 18,B06,093474,Rideout; David Porter,2,0,36,34
1656172725628,MATH 20A,A01,083754,Zheng; Zequn,11,0,40,29
1656172731661,MATH 20B,A01,083756,Briones; Jor-el Thomas Caparas,0,0,36,36
1656172731661,MATH 20B,A02,083757,Briones; Jor-el Thomas Caparas,0,0,36,36
1656172731661,MATH 20B,A03,093475,Staff,2,0,36,34
1656172737695,MATH 20C,A01,083760,Briones; Jor-el Thomas Caparas,0,0,35,35
1656172737695,MATH 20C,A02,083761,Briones; Jor-el Thomas Caparas,9,1,35,26
1656172737695,MATH 20C,A03,093476,Staff,0,0,35,35
1656172737695,MATH 20C,B01,083762,Bach; Quang Tran,1,0,30,29
1656172743721,MATH 20D,A01,083765,Tran; Brian Kha,1,0,30,29
1656172743721,MATH 20D,A02,083766,Tran; Brian Kha,0,1,30,30
1656172743721,MATH 20D,A03,083767,Tran; Brian Kha,2,0,30,28
1656172749756,MATH 20E,A01,083771,Ganguly; Soumya,4,0,32,28
1656172749756,MATH 20E,A02,083772,Ganguly; Soumya,0,0,32,32
1656172749756,MATH 20E,B01,083773,Ciotti; Benjamin,15,0,35,20
1656172749756,MATH 20E,B02,083774,Ciotti; Benjamin,15,0,35,20
1656172755784,MATH 103A,A01,083777,Greenfeld; Be'Eri,1,0,36,35
1656172755784,MATH 103A,A02,083778,Greenfeld; Be'Eri,1,0,36,35
1656172755784,MATH 103A,A03,093561,Staff,5,0,36,31
1656172755784,MATH 103A,B01,083779,Greenfeld; Be'Eri,8,1,36,28
1656172755784,MATH 103A,B02,083780,Greenfeld; Be'Eri,1,0,36,35
1656172755784,MATH 103A,B03,093562,Staff,0,0,36,36
1656172761818,MATH 105,A01,085443,Carter; Anne Toulson,5,1,35,30
1656172761818,MATH 105,A02,093477,Staff,11,0,35,24
1656172767841,MATH 109,A01,083213,Ganzberger; Geoffrey Michael,0,0,34,34
1656172767841,MATH 109,A02,083214,Ganzberger; Geoffrey Michael,0,0,34,34
1656172767841,MATH 109,A03,093478,Staff,1,0,34,33
1656172767841,MATH 109,B01,083215,Ganzberger; Geoffrey Michael,4,0,32,28
1656172767841,MATH 109,B02,083216,Ganzberger; Geoffrey Michael,1,0,32,31
1656172767841,MATH 109,B03,093479,Staff,4,0,32,28
1656172773875,MATH 142A,A01,083219,Chow; Bennett,1,0,32,31
1656172773875,MATH 142A,A02,083220,Chow; Bennett,8,0,32,24
1656172773875,MATH 142A,A03,093480,Staff,5,0,32,27
1656172773875,MATH 142A,B03,093481,Staff,4,0,32,28
1656172773875,MATH 142A,B04,093558,Staff,6,0,32,26
1656172773875,MATH 142A,B05,093559,Staff,0,0,32,32
1656172779909,MATH 193A,A01,083224,Rotar; Vladimir,0,1,34,34
1656172779909,MATH 193A,A02,083225,Rotar; Vladimir,0,0,34,34
1656172779909,MATH 193A,A03,083781,Rotar; Vladimir,0,0,34,34
1656172779909,MATH 193A,A04,083782,Rotar; Vladimir,6,0,34,28
1656172779909,MATH 193A,A05,093482,Rotar; Vladimir,1,0,34,33
1656172785938,MATH 197,001,091859,McAuley; Julian John,9999,0,9999,0
1656172785938,MATH 197,002,095566,Kedlaya; Kiran S.,9997,0,9999,2
1656172785938,MATH 197,003,095567,Xiao; Ming,9999,0,9999,0
1656172785938,MATH 197,004,095571,Perols; Johan Lars,9998,0,9999,1
1656172793012,COGS 9,A01,083615,Shannon; Kyle Michael,4,0,75,71
1656172799036,COGS 11,A01,083617,Boyle; Mary E. T.,14,0,48,34
1656172805059,COGS 13,A01,083071,Bastos; Amalia Pinkusfeld,5,0,71,66
1656172811085,COGS 14A,A01,092681,Semenuks; Arturs,4,15,100,96
1656172817111,COGS 14B,A01,083073,Cheng; Tzu-Han,7,0,63,56
1656172823134,COGS 17,A01,092677,Semenuks; Arturs,7,0,81,74
1656172829157,COGS 100,A01,083619,Allen; Michael Gordon,2,0,70,68
1656172835180,COGS 101A,A01,083621,Davis; Joshua Daniel,3,0,68,65
1656172841208,COGS 101B,A01,091572,Allen; Michael Gordon,6,0,65,59
1656172847231,COGS 101C,A01,083625,Delgado; Tania,10,0,35,25
1656172853256,COGS 107A,A01,083627,Boyle; Mary E. T.,0,0,60,60
1656172859279,COGS 118A,A01,083075,Gupta; Anjum,7,0,76,69
1656172865313,CSE 3,A50,083646,Miranda; Gregory Joseph,18,0,50,32
1656172871340,CSE 8A,A50,083650,Miranda; Gregory Joseph,3,3,56,53
1656172877363,CSE 11,A01,083080,Cao; Yingjun,1,54,40,39
1656172883386,CSE 12,A01,083652,Krause-Levy; Sophia Louisa,7,2,120,113
1656172889413,CSE 15L,A01,083654,Morris; Justin Loren,2,0,50,48
1656172889413,CSE 15L,A02,083655,Morris; Justin Loren,4,0,50,46
1656172895437,CSE 20,A01,083657,Tran; Khoa Dang,31,0,80,49
1656172901461,CSE 21,A01,095574,Bach; Quang Tran,25,0,48,23
1656172907498,CSE 30,A01,083084,Eldon; John,2,8,80,78
1656172907498,CSE 30,B01,095061,Bhaskar; Nishant,1,2,50,49
1656172913523,CSE 100,A01,083659,Cao; Yingjun,2,20,70,68
1656172919551,CSE 134B,A01,083661,Powell; Thomas Allan,3,0,100,97
1656172925576,CSE 140,A01,083663,Gungor; Onat,9,0,85,76
1656172931603,CSE 140L,A01,083088,Eldon; John,8,0,100,92
1656172937627,CSE 175,A01,083665,Kumar; Rakesh,0,0,25,25
1656172943651,CSE 190,A00,092507,Dubnov; Shlomo,3,0,20,17
1656172949679,ECE 45,A01,083139,Congero; Spencer William,1,0,75,74
1656172955707,ECE 65,A50,083695,Saad; Andrew S,9,0,30,21
1656172955707,ECE 65,A51,095125,Staff,23,0,26,3
1656172961733,ECE 109,A01,091882,Touri; Behrouz,0,1,70,70
1656172967756,ECE 180,A00,083140,Abi Samra; Nicholas Camill,1,0,30,29
1656172967756,ECE 180,B00,083141,Abi Samra; Nicholas Camill,0,4,30,30
1656172973779,MATH 10A,A01,083735,Patchell; Gregory David,0,0,30,30
1656172973779,MATH 10A,A02,083736,Patchell; Gregory David,22,0,30,8
1656172973779,MATH 10A,A03,083737,Patchell; Gregory David,16,0,30,14
1656172979806,MATH 10B,A01,083207,Lim; Seonhee,0,0,34,34
1656172979806,MATH 10B,A02,083208,Lim; Seonhee,7,0,35,28
1656172979806,MATH 10B,A03,093472,Staff,1,0,34,33
1656172979806,MATH 10B,B01,083739,Sinha; Shubham,10,0,30,20
1656172985832,MATH 18,A01,083743,Cinel; Cameron Alexander,7,0,30,23
1656172985832,MATH 18,A02,083744,Cinel; Cameron Alexander,10,0,30,20
1656172985832,MATH 18,A03,083745,Cinel; Cameron Alexander,4,0,30,26
1656172985832,MATH 18,B01,083748,Rideout; David Porter,0,0,36,36
1656172985832,MATH 18,B02,083749,Rideout; David Porter,0,0,36,36
1656172985832,MATH 18,B03,083750,Rideout; David Porter,0,0,36,36
1656172985832,MATH 18,B04,083751,Rideout; David Porter,0,0,36,36
1656172985832,MATH 18,B05,093473,Rideout; David Porter,1,0,36,35
1656172985832,MATH 18,B06,093474,Rideout; David Porter,2,0,36,34
1656172991857,MATH 20A,A01,083754,Zheng; Zequn,11,0,40,29
1656172997880,MATH 20B,A01,083756,Briones; Jor-el Thomas Caparas,0,0,36,36
1656172997880,MATH 20B,A02,083757,Briones; Jor-el Thomas Caparas,0,0,36,36
1656172997880,MATH 20B,A03,093475,Staff,2,0,36,34
1656173003906,MATH 20C,A01,083760,Briones; Jor-el Thomas Caparas,0,0,35,35
1656173003906,MATH 20C,A02,083761,Briones; Jor-el Thomas Caparas,9,1,35,26
1656173003906,MATH 20C,A03,093476,Staff,0,0,35,35
1656173003906,MATH 20C,B01,083762,Bach; Quang Tran,1,0,30,29
1656173009936,MATH 20D,A01,083765,Tran; Brian Kha,1,0,30,29
1656173009936,MATH 20D,A02,083766,Tran; Brian Kha,0,1,30,30
1656173009936,MATH 20D,A03,083767,Tran; Brian Kha,2,0,30,28
1656173015962,MATH 20E,A01,083771,Ganguly; Soumya,4,0,32,28
1656173015962,MATH 20E,A02,083772,Ganguly; Soumya,0,0,32,32
1656173015962,MATH 20E,B01,083773,Ciotti; Benjamin,15,0,35,20
1656173015962,MATH 20E,B02,083774,Ciotti; Benjamin,15,0,35,20
1656173021992,MATH 103A,A01,083777,Greenfeld; Be'Eri,1,0,36,35
1656173021992,MATH 103A,A02,083778,Greenfeld; Be'Eri,1,0,36,35
1656173021992,MATH 103A,A03,093561,Staff,5,0,36,31
1656173021992,MATH 103A,B01,083779,Greenfeld; Be'Eri,8,1,36,28
1656173021992,MATH 103A,B02,083780,Greenfeld; Be'Eri,1,0,36,35
1656173021992,MATH 103A,B03,093562,Staff,0,0,36,36
1656173028017,MATH 105,A01,085443,Carter; Anne Toulson,5,1,35,30
1656173028017,MATH 105,A02,093477,Staff,11,0,35,24
1656173034042,MATH 109,A01,083213,Ganzberger; Geoffrey Michael,0,0,34,34
1656173034042,MATH 109,A02,083214,Ganzberger; Geoffrey Michael,0,0,34,34
1656173034042,MATH 109,A03,093478,Staff,1,0,34,33
1656173034042,MATH 109,B01,083215,Ganzberger; Geoffrey Michael,4,0,32,28
1656173034042,MATH 109,B02,083216,Ganzberger; Geoffrey Michael,1,0,32,31
1656173034042,MATH 109,B03,093479,Staff,4,0,32,28
1656173040068,MATH 142A,A01,083219,Chow; Bennett,1,0,32,31
1656173040068,MATH 142A,A02,083220,Chow; Bennett,8,0,32,24
1656173040068,MATH 142A,A03,093480,Staff,5,0,32,27
1656173040068,MATH 142A,B03,093481,Staff,4,0,32,28
1656173040068,MATH 142A,B04,093558,Staff,6,0,32,26
1656173040068,MATH 142A,B05,093559,Staff,0,0,32,32
1656173046092,MATH 193A,A01,083224,Rotar; Vladimir,0,1,34,34
1656173046092,MATH 193A,A02,083225,Rotar; Vladimir,0,0,34,34
1656173046092,MATH 193A,A03,083781,Rotar; Vladimir,0,0,34,34
1656173046092,MATH 193A,A04,083782,Rotar; Vladimir,6,0,34,28
1656173046092,MATH 193A,A05,093482,Rotar; Vladimir,1,0,34,33
1656173052119,MATH 197,001,091859,McAuley; Julian John,9999,0,9999,0
1656173052119,MATH 197,002,095566,Kedlaya; Kiran S.,9997,0,9999,2
1656173052119,MATH 197,003,095567,Xiao; Ming,9999,0,9999,0
1656173052119,MATH 197,004,095571,Perols; Johan Lars,9998,0,9999,1
1656173059262,COGS 9,A01,083615,Shannon; Kyle Michael,4,0,75,71
1656173065284,COGS 11,A01,083617,Boyle; Mary E. T.,14,0,48,34
1656173071320,COGS 13,A01,083071,Bastos; Amalia Pinkusfeld,5,0,71,66
1656173077348,COGS 14A,A01,092681,Semenuks; Arturs,4,15,100,96
1656173083372,COGS 14B,A01,083073,Cheng; Tzu-Han,7,0,63,56
1656173089396,COGS 17,A01,092677,Semenuks; Arturs,7,0,81,74
1656173095423,COGS 100,A01,083619,Allen; Michael Gordon,2,0,70,68
1656173101451,COGS 101A,A01,083621,Davis; Joshua Daniel,3,0,68,65
1656173107473,COGS 101B,A01,091572,Allen; Michael Gordon,6,0,65,59
1656173113496,COGS 101C,A01,083625,Delgado; Tania,10,0,35,25
1656173119518,COGS 107A,A01,083627,Boyle; Mary E. T.,0,0,60,60
1656173125542,COGS 118A,A01,083075,Gupta; Anjum,7,0,76,69
1656173131565,CSE 3,A50,083646,Miranda; Gregory Joseph,18,0,50,32
1656173137598,CSE 8A,A50,083650,Miranda; Gregory Joseph,3,3,56,53
1656173143621,CSE 11,A01,083080,Cao; Yingjun,1,54,40,39
1656173149644,CSE 12,A01,083652,Krause-Levy; Sophia Louisa,7,2,120,113
1656173155668,CSE 15L,A01,083654,Morris; Justin Loren,2,0,50,48
1656173155668,CSE 15L,A02,083655,Morris; Justin Loren,4,0,50,46
1656173161696,CSE 20,A01,083657,Tran; Khoa Dang,31,0,80,49
1656173167719,CSE 21,A01,095574,Bach; Quang Tran,25,0,48,23
1656173173751,CSE 30,A01,083084,Eldon; John,2,8,80,78
1656173173751,CSE 30,B01,095061,Bhaskar; Nishant,1,2,50,49
1656173179773,CSE 100,A01,083659,Cao; Yingjun,2,20,70,68
1656173185801,CSE 134B,A01,083661,Powell; Thomas Allan,3,0,100,97
1656173191824,CSE 140,A01,083663,Gungor; Onat,9,0,85,76
1656173197850,CSE 140L,A01,083088,Eldon; John,8,0,100,92
1656173203874,CSE 175,A01,083665,Kumar; Rakesh,0,0,25,25
1656173209896,CSE 190,A00,092507,Dubnov; Shlomo,3,0,20,17
1656173215925,ECE 45,A01,083139,Congero; Spencer William,1,0,75,74
1656173221949,ECE 65,A50,083695,Saad; Andrew S,9,0,30,21
1656173221949,ECE 65,A51,095125,Staff,23,0,26,3
1656173227974,ECE 109,A01,091882,Touri; Behrouz,0,1,70,70
1656173233999,ECE 180,A00,083140,Abi Samra; Nicholas Camill,1,0,30,29
1656173233999,ECE 180,B00,083141,Abi Samra; Nicholas Camill,0,4,30,30
1656173240022,MATH 10A,A01,083735,Patchell; Gregory David,0,0,30,30
1656173240022,MATH 10A,A02,083736,Patchell; Gregory David,22,0,30,8
1656173240022,MATH 10A,A03,083737,Patchell; Gregory David,16,0,30,14
1656173246066,MATH 10B,A01,083207,Lim; Seonhee,0,0,34,34
1656173246066,MATH 10B,A02,083208,Lim; Seonhee,7,0,35,28
1656173246066,MATH 10B,A03,093472,Staff,1,0,34,33
1656173246066,MATH 10B,B01,083739,Sinha; Shubham,10,0,30,20
1656173252097,MATH 18,A01,083743,Cinel; Cameron Alexander,7,0,30,23
1656173252097,MATH 18,A02,083744,Cinel; Cameron Alexander,10,0,30,20
1656173252097,MATH 18,A03,083745,Cinel; Cameron Alexander,4,0,30,26
1656173252097,MATH 18,B01,083748,Rideout; David Porter,0,0,36,36
1656173252097,MATH 18,B02,083749,Rideout; David Porter,0,0,36,36
1656173252097,MATH 18,B03,083750,Rideout; David Porter,0,0,36,36
1656173252097,MATH 18,B04,083751,Rideout; David Porter,0,0,36,36
1656173252097,MATH 18,B05,093473,Rideout; David Porter,1,0,36,35
1656173252097,MATH 18,B06,093474,Rideout; David Porter,2,0,36,34
1656173258124,MATH 20A,A01,083754,Zheng; Zequn,11,0,40,29
1656173264152,MATH 20B,A01,083756,Briones; Jor-el Thomas Caparas,0,0,36,36
1656173264152,MATH 20B,A02,083757,Briones; Jor-el Thomas Caparas,0,0,36,36
1656173264152,MATH 20B,A03,093475,Staff,2,0,36,34
1656173270177,MATH 20C,A01,083760,Briones; Jor-el Thomas Caparas,0,0,35,35
1656173270177,MATH 20C,A02,083761,Briones; Jor-el Thomas Caparas,9,1,35,26
1656173270177,MATH 20C,A03,093476,Staff,0,0,35,35
1656173270177,MATH 20C,B01,083762,Bach; Quang Tran,1,0,30,29
1656173276203,MATH 20D,A01,083765,Tran; Brian Kha,1,0,30,29
1656173276203,MATH 20D,A02,083766,Tran; Brian Kha,0,1,30,30
1656173276203,MATH 20D,A03,083767,Tran; Brian Kha,2,0,30,28
1656173282228,MATH 20E,A01,083771,Ganguly; Soumya,4,0,32,28
1656173282228,MATH 20E,A02,083772,Ganguly; Soumya,0,0,32,32
1656173282228,MATH 20E,B01,083773,Ciotti; Benjamin,15,0,35,20
1656173282228,MATH 20E,B02,083774,Ciotti; Benjamin,15,0,35,20
1656173288258,MATH 103A,A01,083777,Greenfeld; Be'Eri,1,0,36,35
1656173288258,MATH 103A,A02,083778,Greenfeld; Be'Eri,1,0,36,35
1656173288258,MATH 103A,A03,093561,Staff,5,0,36,31
1656173288258,MATH 103A,B01,083779,Greenfeld; Be'Eri,8,1,36,28
1656173288258,MATH 103A,B02,083780,Greenfeld; Be'Eri,1,0,36,35
1656173288258,MATH 103A,B03,093562,Staff,0,0,36,36
1656173294282,MATH 105,A01,085443,Carter; Anne Toulson,5,1,35,30
1656173294282,MATH 105,A02,093477,Staff,11,0,35,24
1656173300311,MATH 109,A01,083213,Ganzberger; Geoffrey Michael,0,0,34,34
1656173300311,MATH 109,A02,083214,Ganzberger; Geoffrey Michael,0,0,34,34
1656173300311,MATH 109,A03,093478,Staff,1,0,34,33
1656173300311,MATH 109,B01,083215,Ganzberger; Geoffrey Michael,4,0,32,28
1656173300311,MATH 109,B02,083216,Ganzberger; Geoffrey Michael,1,0,32,31
1656173300311,MATH 109,B03,093479,Staff,4,0,32,28
1656173306334,MATH 142A,A01,083219,Chow; Bennett,1,0,32,31
1656173306334,MATH 142A,A02,083220,Chow; Bennett,8,0,32,24
1656173306334,MATH 142A,A03,093480,Staff,5,0,32,27
1656173306334,MATH 142A,B03,093481,Staff,4,0,32,28
1656173306334,MATH 142A,B04,093558,Staff,6,0,32,26
1656173306334,MATH 142A,B05,093559,Staff,0,0,32,32
1656173312358,MATH 193A,A01,083224,Rotar; Vladimir,0,1,34,34
1656173312358,MATH 193A,A02,083225,Rotar; Vladimir,0,0,34,34
1656173312358,MATH 193A,A03,083781,Rotar; Vladimir,0,0,34,34
1656173312358,MATH 193A,A04,083782,Rotar; Vladimir,6,0,34,28
1656173312358,MATH 193A,A05,093482,Rotar; Vladimir,1,0,34,33
1656173318381,MATH 197,001,091859,McAuley; Julian John,9999,0,9999,0
1656173318381,MATH 197,002,095566,Kedlaya; Kiran S.,9997,0,9999,2
1656173318381,MATH 197,003,095567,Xiao; Ming,9999,0,9999,0
1656173318381,MATH 197,004,095571,Perols; Johan Lars,9998,0,9999,1
1656173325445,COGS 9,A01,083615,Shannon; Kyle Michael,4,0,75,71
1656173331473,COGS 11,A01,083617,Boyle; Mary E. T.,14,0,48,34
1656173337499,COGS 13,A01,083071,Bastos; Amalia Pinkusfeld,5,0,71,66
1656173343526,COGS 14A,A01,092681,Semenuks; Arturs,4,15,100,96
1656173349550,COGS 14B,A01,083073,Cheng; Tzu-Han,7,0,63,56
1656173355578,COGS 17,A01,092677,Semenuks; Arturs,7,0,81,74
1656173361602,COGS 100,A01,083619,Allen; Michael Gordon,2,0,70,68
1656173367630,COGS 101A,A01,083621,Davis; Joshua Daniel,3,0,68,65
1656173373659,COGS 101B,A01,091572,Allen; Michael Gordon,6,0,65,59
1656173379691,COGS 101C,A01,083625,Delgado; Tania,10,0,35,25
1656173385720,COGS 107A,A01,083627,Boyle; Mary E. T.,0,0,60,60
1656173391744,COGS 118A,A01,083075,Gupta; Anjum,7,0,76,69
1656173397769,CSE 3,A50,083646,Miranda; Gregory Joseph,18,0,50,32
1656173403794,CSE 8A,A50,083650,Miranda; Gregory Joseph,3,3,56,53
1656173409821,CSE 11,A01,083080,Cao; Yingjun,1,54,40,39
1656173415854,CSE 12,A01,083652,Krause-Levy; Sophia Louisa,7,2,120,113
1656173421878,CSE 15L,A01,083654,Morris; Justin Loren,2,0,50,48
1656173421878,CSE 15L,A02,083655,Morris; Justin Loren,4,0,50,46
1656173427907,CSE 20,A01,083657,Tran; Khoa Dang,31,0,80,49
1656173433936,CSE 21,A01,095574,Bach; Quang Tran,25,0,48,23
1656173439960,CSE 30,A01,083084,Eldon; John,2,8,80,78
1656173439960,CSE 30,B01,095061,Bhaskar; Nishant,1,2,50,49
1656173445984,CSE 100,A01,083659,Cao; Yingjun,2,20,70,68
1656173452011,CSE 134B,A01,083661,Powell; Thomas Allan,3,0,100,97
1656173458039,CSE 140,A01,083663,Gungor; Onat,9,0,85,76
1656173464063,CSE 140L,A01,083088,Eldon; John,8,0,100,92
1656173470101,CSE 175,A01,083665,Kumar; Rakesh,0,0,25,25
1656173476126,CSE 190,A00,092507,Dubnov; Shlomo,3,0,20,17
1656173482156,ECE 45,A01,083139,Congero; Spencer William,1,0,75,74
1656173488191,ECE 65,A50,083695,Saad; Andrew S,9,0,30,21
1656173488191,ECE 65,A51,095125,Staff,23,0,26,3
1656173494222,ECE 109,A01,091882,Touri; Behrouz,0,1,70,70
1656173500247,ECE 180,A00,083140,Abi Samra; Nicholas Camill,1,0,30,29
1656173500247,ECE 180,B00,083141,Abi Samra; Nicholas Camill,0,4,30,30
1656173506271,MATH 10A,A01,083735,Patchell; Gregory David,0,0,30,30
1656173506271,MATH 10A,A02,083736,Patchell; Gregory David,22,0,30,8
1656173506271,MATH 10A,A03,083737,Patchell; Gregory David,16,0,30,14
1656173512299,MATH 10B,A01,083207,Lim; Seonhee,0,0,34,34
1656173512299,MATH 10B,A02,083208,Lim; Seonhee,7,0,35,28
1656173512299,MATH 10B,A03,093472,Staff,1,0,34,33
1656173512299,MATH 10B,B01,083739,Sinha; Shubham,10,0,30,20
1656173518325,MATH 18,A01,083743,Cinel; Cameron Alexander,7,0,30,23
1656173518325,MATH 18,A02,083744,Cinel; Cameron Alexander,10,0,30,20
1656173518325,MATH 18,A03,083745,Cinel; Cameron Alexander,4,0,30,26
1656173518325,MATH 18,B01,083748,Rideout; David Porter,0,0,36,36
1656173518325,MATH 18,B02,083749,Rideout; David Porter,0,0,36,36
1656173518325,MATH 18,B03,083750,Rideout; David Porter,0,0,36,36
1656173518325,MATH 18,B04,083751,Rideout; David Porter,0,0,36,36
1656173518325,MATH 18,B05,093473,Rideout; David Porter,1,0,36,35
1656173518325,MATH 18,B06,093474,Rideout; David Porter,2,0,36,34
1656173524349,MATH 20A,A01,083754,Zheng; Zequn,11,0,40,29
1656173530374,MATH 20B,A01,083756,Briones; Jor-el Thomas Caparas,0,0,36,36
1656173530374,MATH 20B,A02,083757,Briones; Jor-el Thomas Caparas,0,0,36,36
1656173530374,MATH 20B,A03,093475,Staff,2,0,36,34
1656173536399,MATH 20C,A01,083760,Briones; Jor-el Thomas Caparas,0,0,35,35
1656173536399,MATH 20C,A02,083761,Briones; Jor-el Thomas Caparas,9,1,35,26
1656173536399,MATH 20C,A03,093476,Staff,0,0,35,35
1656173536399,MATH 20C,B01,083762,Bach; Quang Tran,1,0,30,29
1656173542421,MATH 20D,A01,083765,Tran; Brian Kha,1,0,30,29
1656173542421,MATH 20D,A02,083766,Tran; Brian Kha,0,1,30,30
1656173542421,MATH 20D,A03,083767,Tran; Brian Kha,2,0,30,28
1656173548445,MATH 20E,A01,083771,Ganguly; Soumya,4,0,32,28
1656173548445,MATH 20E,A02,083772,Ganguly; Soumya,0,0,32,32
1656173548445,MATH 20E,B01,083773,Ciotti; Benjamin,15,0,35,20
1656173548445,MATH 20E,B02,083774,Ciotti; Benjamin,15,0,35,20
1656173554469,MATH 103A,A01,083777,Greenfeld; Be'Eri,1,0,36,35
1656173554469,MATH 103A,A02,083778,Greenfeld; Be'Eri,1,0,36,35
1656173554469,MATH 103A,A03,093561,Staff,5,0,36,31
1656173554469,MATH 103A,B01,083779,Greenfeld; Be'Eri,8,1,36,28
1656173554469,MATH 103A,B02,083780,Greenfeld; Be'Eri,1,0,36,35
1656173554469,MATH 103A,B03,093562,Staff,0,0,36,36
1656173560493,MATH 105,A01,085443,Carter; Anne Toulson,5,1,35,30
1656173560493,MATH 105,A02,093477,Staff,11,0,35,24
1656173566517,MATH 109,A01,083213,Ganzberger; Geoffrey Michael,0,0,34,34
1656173566517,MATH 109,A02,083214,Ganzberger; Geoffrey Michael,0,0,34,34
1656173566517,MATH 109,A03,093478,Staff,1,0,34,33
1656173566517,MATH 109,B01,083215,Ganzberger; Geoffrey Michael,4,0,32,28
1656173566517,MATH 109,B02,083216,Ganzberger; Geoffrey Michael,1,0,32,31
1656173566517,MATH 109,B03,093479,Staff,4,0,32,28
1656173572544,MATH 142A,A01,083219,Chow; Bennett,1,0,32,31
1656173572544,MATH 142A,A02,083220,Chow; Bennett,8,0,32,24
1656173572544,MATH 142A,A03,093480,Staff,5,0,32,27
1656173572544,MATH 142A,B03,093481,Staff,4,0,32,28
1656173572544,MATH 142A,B04,093558,Staff,6,0,32,26
1656173572544,MATH 142A,B05,093559,Staff,0,0,32,32
1656173578574,MATH 193A,A01,083224,Rotar; Vladimir,0,1,34,34
1656173578574,MATH 193A,A02,083225,Rotar; Vladimir,0,0,34,34
1656173578574,MATH 193A,A03,083781,Rotar; Vladimir,0,0,34,34
1656173578574,MATH 193A,A04,083782,Rotar; Vladimir,6,0,34,28
1656173578574,MATH 193A,A05,093482,Rotar; Vladimir,1,0,34,33
1656173584601,MATH 197,001,091859,McAuley; Julian John,9999,0,9999,0
1656173584601,MATH 197,002,095566,Kedlaya; Kiran S.,9997,0,9999,2
1656173584601,MATH 197,003,095567,Xiao; Ming,9999,0,9999,0
1656173584601,MATH 197,004,095571,Perols; Johan Lars,9998,0,9999,1
1656173591673,COGS 9,A01,083615,Shannon; Kyle Michael,4,0,75,71
1656173597697,COGS 11,A01,083617,Boyle; Mary E. T.,14,0,48,34
1656173603725,COGS 13,A01,083071,Bastos; Amalia Pinkusfeld,5,0,71,66
1656173609752,COGS 14A,A01,092681,Semenuks; Arturs,4,15,100,96
1656173615781,COGS 14B,A01,083073,Cheng; Tzu-Han,7,0,63,56
1656173621804,COGS 17,A01,092677,Semenuks; Arturs,7,0,81,74
1656173627834,COGS 100,A01,083619,Allen; Michael Gordon,2,0,70,68
1656173633862,COGS 101A,A01,083621,Davis; Joshua Daniel,3,0,68,65
1656173639888,COGS 101B,A01,091572,Allen; Michael Gordon,6,0,65,59
1656173645919,COGS 101C,A01,083625,Delgado; Tania,10,0,35,25
1656173651949,COGS 107A,A01,083627,Boyle; Mary E. T.,0,0,60,60
1656173658047,COGS 118A,A01,083075,Gupta; Anjum,7,0,76,69
1656173664072,CSE 3,A50,083646,Miranda; Gregory Joseph,18,0,50,32
1656173670096,CSE 8A,A50,083650,Miranda; Gregory Joseph,3,3,56,53
1656173676120,CSE 11,A01,083080,Cao; Yingjun,1,54,40,39
1656173682159,CSE 12,A01,083652,Krause-Levy; Sophia Louisa,7,2,120,113
1656173688189,CSE 15L,A01,083654,Morris; Justin Loren,2,0,50,48
1656173688189,CSE 15L,A02,083655,Morris; Justin Loren,4,0,50,46
1656173694214,CSE 20,A01,083657,Tran; Khoa Dang,31,0,80,49
1656173700237,CSE 21,A01,095574,Bach; Quang Tran,25,0,48,23
1656173706261,CSE 30,A01,083084,Eldon; John,2,8,80,78
1656173706261,CSE 30,B01,095061,Bhaskar; Nishant,1,2,50,49
1656173712289,CSE 100,A01,083659,Cao; Yingjun,2,20,70,68
1656173718327,CSE 134B,A01,083661,Powell; Thomas Allan,3,0,100,97
1656173724351,CSE 140,A01,083663,Gungor; Onat,9,0,85,76
1656173730379,CSE 140L,A01,083088,Eldon; John,8,0,100,92
1656173736409,CSE 175,A01,083665,Kumar; Rakesh,0,0,25,25
1656173742438,CSE 190,A00,092507,Dubnov; Shlomo,3,0,20,17
1656173748463,ECE 45,A01,083139,Congero; Spencer William,1,0,75,74
1656173754488,ECE 65,A50,083695,Saad; Andrew S,9,0,30,21
1656173754488,ECE 65,A51,095125,Staff,23,0,26,3
1656173760520,ECE 109,A01,091882,Touri; Behrouz,0,1,70,70
1656173766544,ECE 180,A00,083140,Abi Samra; Nicholas Camill,1,0,30,29
1656173766544,ECE 180,B00,083141,Abi Samra; Nicholas Camill,0,4,30,30
1656173772571,MATH 10A,A01,083735,Patchell; Gregory David,0,0,30,30
1656173772571,MATH 10A,A02,083736,Patchell; Gregory David,22,0,30,8
1656173772571,MATH 10A,A03,083737,Patchell; Gregory David,16,0,30,14
1656173778600,MATH 10B,A01,083207,Lim; Seonhee,0,0,34,34
1656173778600,MATH 10B,A02,083208,Lim; Seonhee,7,0,35,28
1656173778600,MATH 10B,A03,093472,Staff,1,0,34,33
1656173778600,MATH 10B,B01,083739,Sinha; Shubham,10,0,30,20
1656173784635,MATH 18,A01,083743,Cinel; Cameron Alexander,7,0,30,23
1656173784635,MATH 18,A02,083744,Cinel; Cameron Alexander,10,0,30,20
1656173784635,MATH 18,A03,083745,Cinel; Cameron Alexander,4,0,30,26
1656173784635,MATH 18,B01,083748,Rideout; David Porter,0,0,36,36
1656173784635,MATH 18,B02,083749,Rideout; David Porter,0,0,36,36
1656173784635,MATH 18,B03,083750,Rideout; David Porter,0,0,36,36
1656173784635,MATH 18,B04,083751,Rideout; David Porter,0,0,36,36
1656173784635,MATH 18,B05,093473,Rideout; David Porter,1,0,36,35
1656173784635,MATH 18,B06,093474,Rideout; David Porter,2,0,36,34
1656173790665,MATH 20A,A01,083754,Zheng; Zequn,11,0,40,29
1656173796694,MATH 20B,A01,083756,Briones; Jor-el Thomas Caparas,0,0,36,36
1656173796694,MATH 20B,A02,083757,Briones; Jor-el Thomas Caparas,0,0,36,36
1656173796694,MATH 20B,A03,093475,Staff,1,0,36,35
1656173802723,MATH 20C,A01,083760,Briones; Jor-el Thomas Caparas,0,0,35,35
1656173802723,MATH 20C,A02,083761,Briones; Jor-el Thomas Caparas,9,1,35,26
1656173802723,MATH 20C,A03,093476,Staff,0,0,35,35
1656173802723,MATH 20C,B01,083762,Bach; Quang Tran,1,0,30,29
1656173808748,MATH 20D,A01,083765,Tran; Brian Kha,1,0,30,29
1656173808748,MATH 20D,A02,083766,Tran; Brian Kha,0,1,30,30
1656173808748,MATH 20D,A03,083767,Tran; Brian Kha,2,0,30,28
1656173814780,MATH 20E,A01,083771,Ganguly; Soumya,4,0,32,28
1656173814780,MATH 20E,A02,083772,Ganguly; Soumya,0,0,32,32
1656173814780,MATH 20E,B01,083773,Ciotti; Benjamin,15,0,35,20
1656173814780,MATH 20E,B02,083774,Ciotti; Benjamin,15,0,35,20
1656173820807,MATH 103A,A01,083777,Greenfeld; Be'Eri,1,0,36,35
1656173820807,MATH 103A,A02,083778,Greenfeld; Be'Eri,1,0,36,35
1656173820807,MATH 103A,A03,093561,Staff,5,0,36,31
1656173820807,MATH 103A,B01,083779,Greenfeld; Be'Eri,8,1,36,28
1656173820807,MATH 103A,B02,083780,Greenfeld; Be'Eri,1,0,36,35
1656173820807,MATH 103A,B03,093562,Staff,0,0,36,36
1656173826849,MATH 105,A01,085443,Carter; Anne Toulson,5,1,35,30
1656173826849,MATH 105,A02,093477,Staff,11,0,35,24
1656173832879,MATH 109,A01,083213,Ganzberger; Geoffrey Michael,0,0,34,34
1656173832879,MATH 109,A02,083214,Ganzberger; Geoffrey Michael,0,0,34,34
1656173832879,MATH 109,A03,093478,Staff,1,0,34,33
1656173832879,MATH 109,B01,083215,Ganzberger; Geoffrey Michael,4,0,32,28
1656173832879,MATH 109,B02,083216,Ganzberger; Geoffrey Michael,1,0,32,31
1656173832879,MATH 109,B03,093479,Staff,4,0,32,28
1656173838903,MATH 142A,A01,083219,Chow; Bennett,1,0,32,31
1656173838903,MATH 142A,A02,083220,Chow; Bennett,8,0,32,24
1656173838903,MATH 142A,A03,093480,Staff,5,0,32,27
1656173838903,MATH 142A,B03,093481,Staff,4,0,32,28
1656173838903,MATH 142A,B04,093558,Staff,6,0,32,26
1656173838903,MATH 142A,B05,093559,Staff,0,0,32,32
1656173844937,MATH 193A,A01,083224,Rotar; Vladimir,0,1,34,34
1656173844937,MATH 193A,A02,083225,Rotar; Vladimir,0,0,34,34
1656173844937,MATH 193A,A03,083781,Rotar; Vladimir,0,0,34,34
1656173844937,MATH 193A,A04,083782,Rotar; Vladimir,6,0,34,28
1656173844937,MATH 193A,A05,093482,Rotar; Vladimir,1,0,34,33
1656173850966,MATH 197,001,091859,McAuley; Julian John,9999,0,9999,0
1656173850966,MATH 197,002,095566,Kedlaya; Kiran S.,9997,0,9999,2
1656173850966,MATH 197,003,095567,Xiao; Ming,9999,0,9999,0
1656173850966,MATH 197,004,095571,Perols; Johan Lars,9998,0,9999,1
1656173858031,COGS 9,A01,083615,Shannon; Kyle Michael,4,0,75,71
1656173864058,COGS 11,A01,083617,Boyle; Mary E. T.,14,0,48,34
1656173870082,COGS 13,A01,083071,Bastos; Amalia Pinkusfeld,5,0,71,66
1656173876107,COGS 14A,A01,092681,Semenuks; Arturs,4,15,100,96
1656173882132,COGS 14B,A01,083073,Cheng; Tzu-Han,7,0,63,56
1656173888156,COGS 17,A01,092677,Semenuks; Arturs,7,0,81,74
1656173894181,COGS 100,A01,083619,Allen; Michael Gordon,2,0,70,68
1656173900210,COGS 101A,A01,083621,Davis; Joshua Daniel,4,0,68,64
1656173906238,COGS 101B,A01,091572,Allen; Michael Gordon,6,0,65,59
1656173912262,COGS 101C,A01,083625,Delgado; Tania,10,0,35,25
1656173918287,COGS 107A,A01,083627,Boyle; Mary E. T.,0,0,60,60
1656173924309,COGS 118A,A01,083075,Gupta; Anjum,7,0,76,69
1656173930335,CSE 3,A50,083646,Miranda; Gregory Joseph,18,0,50,32
1656173936360,CSE 8A,A50,083650,Miranda; Gregory Joseph,3,3,56,53
1656173942384,CSE 11,A01,083080,Cao; Yingjun,1,54,40,39
1656173948406,CSE 12,A01,083652,Krause-Levy; Sophia Louisa,7,2,120,113
1656173954434,CSE 15L,A01,083654,Morris; Justin Loren,2,0,50,48
1656173954434,CSE 15L,A02,083655,Morris; Justin Loren,4,0,50,46
1656173960458,CSE 20,A01,083657,Tran; Khoa Dang,31,0,80,49
1656173966480,CSE 21,A01,095574,Bach; Quang Tran,25,0,48,23
1656173972504,CSE 30,A01,083084,Eldon; John,2,8,80,78
1656173972504,CSE 30,B01,095061,Bhaskar; Nishant,1,2,50,49
1656173978527,CSE 100,A01,083659,Cao; Yingjun,2,20,70,68
1656173984555,CSE 134B,A01,083661,Powell; Thomas Allan,3,0,100,97
1656173990581,CSE 140,A01,083663,Gungor; Onat,9,0,85,76
1656173996604,CSE 140L,A01,083088,Eldon; John,8,0,100,92
1656174002632,CSE 175,A01,083665,Kumar; Rakesh,0,0,25,25
1656174008655,CSE 190,A00,092507,Dubnov; Shlomo,3,0,20,17
1656174014680,ECE 45,A01,083139,Congero; Spencer William,1,0,75,74
1656174020705,ECE 65,A50,083695,Saad; Andrew S,9,0,30,21
1656174020705,ECE 65,A51,095125,Staff,23,0,26,3
1656174026732,ECE 109,A01,091882,Touri; Behrouz,0,1,70,70
1656174032759,ECE 180,A00,083140,Abi Samra; Nicholas Camill,1,0,30,29
1656174032759,ECE 180,B00,083141,Abi Samra; Nicholas Camill,0,4,30,30
1656174038788,MATH 10A,A01,083735,Patchell; Gregory David,0,0,30,30
1656174038788,MATH 10A,A02,083736,Patchell; Gregory David,22,0,30,8
1656174038788,MATH 10A,A03,083737,Patchell; Gregory David,16,0,30,14
1656174044821,MATH 10B,A01,083207,Lim; Seonhee,0,0,34,34
1656174044821,MATH 10B,A02,083208,Lim; Seonhee,7,0,35,28
1656174044821,MATH 10B,A03,093472,Staff,1,0,34,33
1656174044821,MATH 10B,B01,083739,Sinha; Shubham,10,0,30,20
1656174050847,MATH 18,A01,083743,Cinel; Cameron Alexander,7,0,30,23
1656174050847,MATH 18,A02,083744,Cinel; Cameron Alexander,10,0,30,20
1656174050847,MATH 18,A03,083745,Cinel; Cameron Alexander,4,0,30,26
1656174050847,MATH 18,B01,083748,Rideout; David Porter,0,0,36,36
1656174050847,MATH 18,B02,083749,Rideout; David Porter,0,0,36,36
1656174050847,MATH 18,B03,083750,Rideout; David Porter,0,0,36,36
1656174050847,MATH 18,B04,083751,Rideout; David Porter,0,0,36,36
1656174050847,MATH 18,B05,093473,Rideout; David Porter,1,0,36,35
1656174050847,MATH 18,B06,093474,Rideout; David Porter,2,0,36,34
1656174056871,MATH 20A,A01,083754,Zheng; Zequn,11,0,40,29
1656174062901,MATH 20B,A01,083756,Briones; Jor-el Thomas Caparas,0,0,36,36
1656174062901,MATH 20B,A02,083757,Briones; Jor-el Thomas Caparas,0,0,36,36
1656174062901,MATH 20B,A03,093475,Staff,1,0,36,35
1656174068926,MATH 20C,A01,083760,Briones; Jor-el Thomas Caparas,0,0,35,35
1656174068926,MATH 20C,A02,083761,Briones; Jor-el Thomas Caparas,9,1,35,26
1656174068926,MATH 20C,A03,093476,Staff,0,0,35,35
1656174068926,MATH 20C,B01,083762,Bach; Quang Tran,1,0,30,29
1656174074959,MATH 20D,A01,083765,Tran; Brian Kha,1,0,30,29
1656174074959,MATH 20D,A02,083766,Tran; Brian Kha,0,1,30,30
1656174074959,MATH 20D,A03,083767,Tran; Brian Kha,2,0,30,28
1656174080983,MATH 20E,A01,083771,Ganguly; Soumya,4,0,32,28
1656174080983,MATH 20E,A02,083772,Ganguly; Soumya,0,0,32,32
1656174080983,MATH 20E,B01,083773,Ciotti; Benjamin,15,0,35,20
1656174080983,MATH 20E,B02,083774,Ciotti; Benjamin,15,0,35,20
1656174087016,MATH 103A,A01,083777,Greenfeld; Be'Eri,1,0,36,35
1656174087016,MATH 103A,A02,083778,Greenfeld; Be'Eri,1,0,36,35
1656174087016,MATH 103A,A03,093561,Staff,5,0,36,31
1656174087016,MATH 103A,B01,083779,Greenfeld; Be'Eri,8,1,36,28
1656174087016,MATH 103A,B02,083780,Greenfeld; Be'Eri,1,0,36,35
1656174087016,MATH 103A,B03,093562,Staff,0,0,36,36
1656174093045,MATH 105,A01,085443,Carter; Anne Toulson,5,1,35,30
1656174093045,MATH 105,A02,093477,Staff,11,0,35,24
1656174099070,MATH 109,A01,083213,Ganzberger; Geoffrey Michael,0,0,34,34
1656174099070,MATH 109,A02,083214,Ganzberger; Geoffrey Michael,0,0,34,34
1656174099070,MATH 109,A03,093478,Staff,1,0,34,33
1656174099070,MATH 109,B01,083215,Ganzberger; Geoffrey Michael,4,0,32,28
1656174099070,MATH 109,B02,083216,Ganzberger; Geoffrey Michael,1,0,32,31
1656174099070,MATH 109,B03,093479,Staff,4,0,32,28
1656174105101,MATH 142A,A01,083219,Chow; Bennett,1,0,32,31
1656174105101,MATH 142A,A02,083220,Chow; Bennett,8,0,32,24
1656174105101,MATH 142A,A03,093480,Staff,5,0,32,27
1656174105101,MATH 142A,B03,093481,Staff,3,0,32,29
1656174105101,MATH 142A,B04,093558,Staff,6,0,32,26
1656174105101,MATH 142A,B05,093559,Staff,0,0,32,32
1656174111125,MATH 193A,A01,083224,Rotar; Vladimir,0,1,34,34
1656174111125,MATH 193A,A02,083225,Rotar; Vladimir,0,0,34,34
1656174111125,MATH 193A,A03,083781,Rotar; Vladimir,0,0,34,34
1656174111125,MATH 193A,A04,083782,Rotar; Vladimir,6,0,34,28
1656174111125,MATH 193A,A05,093482,Rotar; Vladimir,1,0,34,33
1656174117152,MATH 197,001,091859,McAuley; Julian John,9999,0,9999,0
1656174117152,MATH 197,002,095566,Kedlaya; Kiran S.,9997,0,9999,2
1656174117152,MATH 197,003,095567,Xiao; Ming,9999,0,9999,0
1656174117152,MATH 197,004,095571,Perols; Johan Lars,9998,0,9999,1
1656174124215,COGS 9,A01,083615,Shannon; Kyle Michael,4,0,75,71
1656174130242,COGS 11,A01,083617,Boyle; Mary E. T.,14,0,48,34
1656174136266,COGS 13,A01,083071,Bastos; Amalia Pinkusfeld,5,0,71,66
1656174142291,COGS 14A,A01,092681,Semenuks; Arturs,4,15,100,96
1656174148317,COGS 14B,A01,083073,Cheng; Tzu-Han,7,0,63,56
1656174154344,COGS 17,A01,092677,Semenuks; Arturs,7,0,81,74
1656174160369,COGS 100,A01,083619,Allen; Michael Gordon,2,0,70,68
1656174166394,COGS 101A,A01,083621,Davis; Joshua Daniel,4,0,68,64
1656174172421,COGS 101B,A01,091572,Allen; Michael Gordon,6,0,65,59
1656174178445,COGS 101C,A01,083625,Delgado; Tania,10,0,35,25
1656174184473,COGS 107A,A01,083627,Boyle; Mary E. T.,0,0,60,60
1656174190499,COGS 118A,A01,083075,Gupta; Anjum,7,0,76,69
1656174196528,CSE 3,A50,083646,Miranda; Gregory Joseph,18,0,50,32
1656174202555,CSE 8A,A50,083650,Miranda; Gregory Joseph,3,3,56,53
1656174208584,CSE 11,A01,083080,Cao; Yingjun,1,54,40,39
1656174214607,CSE 12,A01,083652,Krause-Levy; Sophia Louisa,7,2,120,113
1656174220634,CSE 15L,A01,083654,Morris; Justin Loren,2,0,50,48
1656174220634,CSE 15L,A02,083655,Morris; Justin Loren,4,0,50,46
1656174226667,CSE 20,A01,083657,Tran; Khoa Dang,31,0,80,49
1656174232694,CSE 21,A01,095574,Bach; Quang Tran,25,0,48,23
1656174238724,CSE 30,A01,083084,Eldon; John,2,8,80,78
1656174238724,CSE 30,B01,095061,Bhaskar; Nishant,1,2,50,49
1656174244751,CSE 100,A01,083659,Cao; Yingjun,2,20,70,68
1656174250778,CSE 134B,A01,083661,Powell; Thomas Allan,3,0,100,97
1656174256874,CSE 140,A01,083663,Gungor; Onat,9,0,85,76
1656174262899,CSE 140L,A01,083088,Eldon; John,8,0,100,92
1656174268923,CSE 175,A01,083665,Kumar; Rakesh,0,0,25,25
1656174274951,CSE 190,A00,092507,Dubnov; Shlomo,3,0,20,17
1656174280978,ECE 45,A01,083139,Congero; Spencer William,1,0,75,74
1656174287003,ECE 65,A50,083695,Saad; Andrew S,9,0,30,21
1656174287003,ECE 65,A51,095125,Staff,23,0,26,3
1656174293029,ECE 109,A01,091882,Touri; Behrouz,0,1,70,70
1656174299057,ECE 180,A00,083140,Abi Samra; Nicholas Camill,1,0,30,29
1656174299057,ECE 180,B00,083141,Abi Samra; Nicholas Camill,0,4,30,30
1656174305091,MATH 10A,A01,083735,Patchell; Gregory David,0,0,30,30
1656174305091,MATH 10A,A02,083736,Patchell; Gregory David,22,0,30,8
1656174305091,MATH 10A,A03,083737,Patchell; Gregory David,16,0,30,14
1656174311116,MATH 10B,A01,083207,Lim; Seonhee,0,0,34,34
1656174311116,MATH 10B,A02,083208,Lim; Seonhee,7,0,35,28
1656174311116,MATH 10B,A03,093472,Staff,1,0,34,33
1656174311116,MATH 10B,B01,083739,Sinha; Shubham,10,0,30,20
1656174317150,MATH 18,A01,083743,Cinel; Cameron Alexander,7,0,30,23
1656174317150,MATH 18,A02,083744,Cinel; Cameron Alexander,10,0,30,20
1656174317150,MATH 18,A03,083745,Cinel; Cameron Alexander,4,0,30,26
1656174317150,MATH 18,B01,083748,Rideout; David Porter,0,0,36,36
1656174317150,MATH 18,B02,083749,Rideout; David Porter,0,0,36,36
1656174317150,MATH 18,B03,083750,Rideout; David Porter,0,0,36,36
1656174317150,MATH 18,B04,083751,Rideout; David Porter,0,0,36,36
1656174317150,MATH 18,B05,093473,Rideout; David Porter,1,0,36,35
1656174317150,MATH 18,B06,093474,Rideout; David Porter,2,0,36,34
1656174323176,MATH 20A,A01,083754,Zheng; Zequn,11,0,40,29
1656174329201,MATH 20B,A01,083756,Briones; Jor-el Thomas Caparas,0,0,36,36
1656174329201,MATH 20B,A02,083757,Briones; Jor-el Thomas Caparas,0,0,36,36
1656174329201,MATH 20B,A03,093475,Staff,1,0,36,35
1656174335237,MATH 20C,A01,083760,Briones; Jor-el Thomas Caparas,0,0,35,35
1656174335237,MATH 20C,A02,083761,Briones; Jor-el Thomas Caparas,9,1,35,26
1656174335237,MATH 20C,A03,093476,Staff,0,0,35,35
1656174335237,MATH 20C,B01,083762,Bach; Quang Tran,1,0,30,29
1656174341263,MATH 20D,A01,083765,Tran; Brian Kha,1,0,30,29
1656174341263,MATH 20D,A02,083766,Tran; Brian Kha,0,1,30,30
1656174341263,MATH 20D,A03,083767,Tran; Brian Kha,2,0,30,28
1656174347300,MATH 20E,A01,083771,Ganguly; Soumya,4,0,32,28
1656174347300,MATH 20E,A02,083772,Ganguly; Soumya,0,0,32,32
1656174347300,MATH 20E,B01,083773,Ciotti; Benjamin,15,0,35,20
1656174347300,MATH 20E,B02,083774,Ciotti; Benjamin,15,0,35,20
1656174353338,MATH 103A,A01,083777,Greenfeld; Be'Eri,1,0,36,35
1656174353338,MATH 103A,A02,083778,Greenfeld; Be'Eri,1,0,36,35
1656174353338,MATH 103A,A03,093561,Staff,5,0,36,31
1656174353338,MATH 103A,B01,083779,Greenfeld; Be'Eri,8,1,36,28
1656174353338,MATH 103A,B02,083780,Greenfeld; Be'Eri,1,0,36,35
1656174353338,MATH 103A,B03,093562,Staff,0,0,36,36
1656174359361,MATH 105,A01,085443,Carter; Anne Toulson,5,1,35,30
1656174359361,MATH 105,A02,093477,Staff,11,0,35,24
1656174365388,MATH 109,A01,083213,Ganzberger; Geoffrey Michael,0,0,34,34
1656174365388,MATH 109,A02,083214,Ganzberger; Geoffrey Michael,0,0,34,34
1656174365388,MATH 109,A03,093478,Staff,1,0,34,33
1656174365388,MATH 109,B01,083215,Ganzberger; Geoffrey Michael,4,0,32,28
1656174365388,MATH 109,B02,083216,Ganzberger; Geoffrey Michael,1,0,32,31
1656174365388,MATH 109,B03,093479,Staff,4,0,32,28
1656174371420,MATH 142A,A01,083219,Chow; Bennett,1,0,32,31
1656174371420,MATH 142A,A02,083220,Chow; Bennett,8,0,32,24
1656174371420,MATH 142A,A03,093480,Staff,5,0,32,27
1656174371420,MATH 142A,B03,093481,Staff,3,0,32,29
1656174371420,MATH 142A,B04,093558,Staff,6,0,32,26
1656174371420,MATH 142A,B05,093559,Staff,0,0,32,32
1656174377452,MATH 193A,A01,083224,Rotar; Vladimir,0,1,34,34
1656174377452,MATH 193A,A02,083225,Rotar; Vladimir,0,0,34,34
1656174377452,MATH 193A,A03,083781,Rotar; Vladimir,0,0,34,34
1656174377452,MATH 193A,A04,083782,Rotar; Vladimir,6,0,34,28
1656174377452,MATH 193A,A05,093482,Rotar; Vladimir,1,0,34,33
1656174383478,MATH 197,001,091859,McAuley; Julian John,9999,0,9999,0
1656174383478,MATH 197,002,095566,Kedlaya; Kiran S.,9997,0,9999,2
1656174383478,MATH 197,003,095567,Xiao; Ming,9999,0,9999,0
1656174383478,MATH 197,004,095571,Perols; Johan Lars,9998,0,9999,1
1656174390540,COGS 9,A01,083615,Shannon; Kyle Michael,4,0,75,71
1656174396564,COGS 11,A01,083617,Boyle; Mary E. T.,14,0,48,34
1656174402589,COGS 13,A01,083071,Bastos; Amalia Pinkusfeld,5,0,71,66
1656174408618,COGS 14A,A01,092681,Semenuks; Arturs,4,15,100,96
1656174414646,COGS 14B,A01,083073,Cheng; Tzu-Han,7,0,63,56
1656174420672,COGS 17,A01,092677,Semenuks; Arturs,7,0,81,74
1656174426695,COGS 100,A01,083619,Allen; Michael Gordon,2,0,70,68
1656174432723,COGS 101A,A01,083621,Davis; Joshua Daniel,4,0,68,64
1656174438746,COGS 101B,A01,091572,Allen; Michael Gordon,6,0,65,59
1656174444777,COGS 101C,A01,083625,Delgado; Tania,10,0,35,25
1656174450802,COGS 107A,A01,083627,Boyle; Mary E. T.,0,0,60,60
1656174456827,COGS 118A,A01,083075,Gupta; Anjum,7,0,76,69
1656174462860,CSE 3,A50,083646,Miranda; Gregory Joseph,18,0,50,32
1656174468883,CSE 8A,A50,083650,Miranda; Gregory Joseph,3,3,56,53
1656174474909,CSE 11,A01,083080,Cao; Yingjun,1,54,40,39
1656174480935,CSE 12,A01,083652,Krause-Levy; Sophia Louisa,7,2,120,113
1656174486961,CSE 15L,A01,083654,Morris; Justin Loren,2,0,50,48
1656174486961,CSE 15L,A02,083655,Morris; Justin Loren,4,0,50,46
1656174492991,CSE 20,A01,083657,Tran; Khoa Dang,31,0,80,49
1656174499016,CSE 21,A01,095574,Bach; Quang Tran,25,0,48,23
1656174505043,CSE 30,A01,083084,Eldon; John,2,8,80,78
1656174505043,CSE 30,B01,095061,Bhaskar; Nishant,1,2,50,49
1656174511068,CSE 100,A01,083659,Cao; Yingjun,2,20,70,68
1656174517096,CSE 134B,A01,083661,Powell; Thomas Allan,3,0,100,97
1656174523125,CSE 140,A01,083663,Gungor; Onat,9,0,85,76
1656174529151,CSE 140L,A01,083088,Eldon; John,8,0,100,92
1656174535174,CSE 175,A01,083665,Kumar; Rakesh,0,0,25,25
1656174541201,CSE 190,A00,092507,Dubnov; Shlomo,3,0,20,17
1656174547226,ECE 45,A01,083139,Congero; Spencer William,1,0,75,74
1656174553258,ECE 65,A50,083695,Saad; Andrew S,9,0,30,21
1656174553258,ECE 65,A51,095125,Staff,23,0,26,3
1656174559292,ECE 109,A01,091882,Touri; Behrouz,0,1,70,70
1656174565317,ECE 180,A00,083140,Abi Samra; Nicholas Camill,1,0,30,29
1656174565317,ECE 180,B00,083141,Abi Samra; Nicholas Camill,0,4,30,30
1656174571339,MATH 10A,A01,083735,Patchell; Gregory David,0,0,30,30
1656174571339,MATH 10A,A02,083736,Patchell; Gregory David,22,0,30,8
1656174571339,MATH 10A,A03,083737,Patchell; Gregory David,16,0,30,14
1656174577366,MATH 10B,A01,083207,Lim; Seonhee,0,0,34,34
1656174577366,MATH 10B,A02,083208,Lim; Seonhee,7,0,35,28
1656174577366,MATH 10B,A03,093472,Staff,1,0,34,33
1656174577366,MATH 10B,B01,083739,Sinha; Shubham,10,0,30,20
1656174583402,MATH 18,A01,083743,Cinel; Cameron Alexander,7,0,30,23
1656174583402,MATH 18,A02,083744,Cinel; Cameron Alexander,10,0,30,20
1656174583402,MATH 18,A03,083745,Cinel; Cameron Alexander,4,0,30,26
1656174583402,MATH 18,B01,083748,Rideout; David Porter,0,0,36,36
1656174583402,MATH 18,B02,083749,Rideout; David Porter,0,0,36,36
1656174583402,MATH 18,B03,083750,Rideout; David Porter,0,0,36,36
1656174583402,MATH 18,B04,083751,Rideout; David Porter,0,0,36,36
1656174583402,MATH 18,B05,093473,Rideout; David Porter,1,0,36,35
1656174583402,MATH 18,B06,093474,Rideout; David Porter,2,0,36,34
1656174589441,MATH 20A,A01,083754,Zheng; Zequn,11,0,40,29
1656174595470,MATH 20B,A01,083756,Briones; Jor-el Thomas Caparas,0,0,36,36
1656174595470,MATH 20B,A02,083757,Briones; Jor-el Thomas Caparas,0,0,36,36
1656174595470,MATH 20B,A03,093475,Staff,1,0,36,35
1656174601493,MATH 20C,A01,083760,Briones; Jor-el Thomas Caparas,0,0,35,35
1656174601493,MATH 20C,A02,083761,Briones; Jor-el Thomas Caparas,9,1,35,26
1656174601493,MATH 20C,A03,093476,Staff,0,0,35,35
1656174601493,MATH 20C,B01,083762,Bach; Quang Tran,1,0,30,29
1656174607517,MATH 20D,A01,083765,Tran; Brian Kha,1,0,30,29
1656174607517,MATH 20D,A02,083766,Tran; Brian Kha,0,1,30,30
1656174607517,MATH 20D,A03,083767,Tran; Brian Kha,2,0,30,28
1656174613545,MATH 20E,A01,083771,Ganguly; Soumya,4,0,32,28
1656174613545,MATH 20E,A02,083772,Ganguly; Soumya,0,0,32,32
1656174613545,MATH 20E,B01,083773,Ciotti; Benjamin,15,0,35,20
1656174613545,MATH 20E,B02,083774,Ciotti; Benjamin,15,0,35,20
1656174619573,MATH 103A,A01,083777,Greenfeld; Be'Eri,1,0,36,35
1656174619573,MATH 103A,A02,083778,Greenfeld; Be'Eri,1,0,36,35
1656174619573,MATH 103A,A03,093561,Staff,5,0,36,31
1656174619573,MATH 103A,B01,083779,Greenfeld; Be'Eri,8,1,36,28
1656174619573,MATH 103A,B02,083780,Greenfeld; Be'Eri,1,0,36,35
1656174619573,MATH 103A,B03,093562,Staff,0,0,36,36
1656174625597,MATH 105,A01,085443,Carter; Anne Toulson,5,1,35,30
1656174625597,MATH 105,A02,093477,Staff,11,0,35,24
1656174631627,MATH 109,A01,083213,Ganzberger; Geoffrey Michael,0,0,34,34
1656174631627,MATH 109,A02,083214,Ganzberger; Geoffrey Michael,0,0,34,34
1656174631627,MATH 109,A03,093478,Staff,1,0,34,33
1656174631627,MATH 109,B01,083215,Ganzberger; Geoffrey Michael,4,0,32,28
1656174631627,MATH 109,B02,083216,Ganzberger; Geoffrey Michael,1,0,32,31
1656174631627,MATH 109,B03,093479,Staff,4,0,32,28
1656174637655,MATH 142A,A01,083219,Chow; Bennett,1,0,32,31
1656174637655,MATH 142A,A02,083220,Chow; Bennett,8,0,32,24
1656174637655,MATH 142A,A03,093480,Staff,5,0,32,27
1656174637655,MATH 142A,B03,093481,Staff,3,0,32,29
1656174637655,MATH 142A,B04,093558,Staff,6,0,32,26
1656174637655,MATH 142A,B05,093559,Staff,0,0,32,32
1656174643686,MATH 193A,A01,083224,Rotar; Vladimir,0,1,34,34
1656174643686,MATH 193A,A02,083225,Rotar; Vladimir,0,0,34,34
1656174643686,MATH 193A,A03,083781,Rotar; Vladimir,0,0,34,34
1656174643686,MATH 193A,A04,083782,Rotar; Vladimir,6,0,34,28
1656174643686,MATH 193A,A05,093482,Rotar; Vladimir,1,0,34,33
1656174649709,MATH 197,001,091859,McAuley; Julian John,9999,0,9999,0
1656174649709,MATH 197,002,095566,Kedlaya; Kiran S.,9997,0,9999,2
1656174649709,MATH 197,003,095567,Xiao; Ming,9999,0,9999,0
1656174649709,MATH 197,004,095571,Perols; Johan Lars,9998,0,9999,1
1656174656781,COGS 9,A01,083615,Shannon; Kyle Michael,4,0,75,71
1656174662814,COGS 11,A01,083617,Boyle; Mary E. T.,14,0,48,34
1656174668846,COGS 13,A01,083071,Bastos; Amalia Pinkusfeld,5,0,71,66
1656174674873,COGS 14A,A01,092681,Semenuks; Arturs,4,15,100,96
1656174680896,COGS 14B,A01,083073,Cheng; Tzu-Han,7,0,63,56
1656174686925,COGS 17,A01,092677,Semenuks; Arturs,7,0,81,74
1656174692962,COGS 100,A01,083619,Allen; Michael Gordon,2,0,70,68
1656174698986,COGS 101A,A01,083621,Davis; Joshua Daniel,4,0,68,64
1656174705027,COGS 101B,A01,091572,Allen; Michael Gordon,5,0,65,60
1656174711052,COGS 101C,A01,083625,Delgado; Tania,10,0,35,25
1656174717076,COGS 107A,A01,083627,Boyle; Mary E. T.,0,0,60,60
1656174723116,COGS 118A,A01,083075,Gupta; Anjum,7,0,76,69
1656174729146,CSE 3,A50,083646,Miranda; Gregory Joseph,18,0,50,32
1656174735168,CSE 8A,A50,083650,Miranda; Gregory Joseph,3,3,56,53
1656174741196,CSE 11,A01,083080,Cao; Yingjun,1,54,40,39
1656174747220,CSE 12,A01,083652,Krause-Levy; Sophia Louisa,7,2,120,113
1656174753252,CSE 15L,A01,083654,Morris; Justin Loren,2,0,50,48
1656174753252,CSE 15L,A02,083655,Morris; Justin Loren,4,0,50,46
1656174759274,CSE 20,A01,083657,Tran; Khoa Dang,31,0,80,49
1656174765308,CSE 21,A01,095574,Bach; Quang Tran,25,0,48,23
1656174771332,CSE 30,A01,083084,Eldon; John,2,8,80,78
1656174771332,CSE 30,B01,095061,Bhaskar; Nishant,1,2,50,49
1656174777359,CSE 100,A01,083659,Cao; Yingjun,2,20,70,68
1656174783387,CSE 134B,A01,083661,Powell; Thomas Allan,3,0,100,97
1656174789410,CSE 140,A01,083663,Gungor; Onat,9,0,85,76
1656174795437,CSE 140L,A01,083088,Eldon; John,8,0,100,92
1656174801461,CSE 175,A01,083665,Kumar; Rakesh,0,0,25,25
1656174807487,CSE 190,A00,092507,Dubnov; Shlomo,3,0,20,17
1656174813512,ECE 45,A01,083139,Congero; Spencer William,1,0,75,74
1656174819537,ECE 65,A50,083695,Saad; Andrew S,9,0,30,21
1656174819537,ECE 65,A51,095125,Staff,23,0,26,3
1656174825562,ECE 109,A01,091882,Touri; Behrouz,0,1,70,70
1656174831589,ECE 180,A00,083140,Abi Samra; Nicholas Camill,1,0,30,29
1656174831589,ECE 180,B00,083141,Abi Samra; Nicholas Camill,0,4,30,30
1656174837617,MATH 10A,A01,083735,Patchell; Gregory David,0,0,30,30
1656174837617,MATH 10A,A02,083736,Patchell; Gregory David,22,0,30,8
1656174837617,MATH 10A,A03,083737,Patchell; Gregory David,16,0,30,14
1656174843642,MATH 10B,A01,083207,Lim; Seonhee,0,0,34,34
1656174843642,MATH 10B,A02,083208,Lim; Seonhee,7,0,35,28
1656174843642,MATH 10B,A03,093472,Staff,1,0,34,33
1656174843642,MATH 10B,B01,083739,Sinha; Shubham,10,0,30,20
1656174849680,MATH 18,A01,083743,Cinel; Cameron Alexander,7,0,30,23
1656174849680,MATH 18,A02,083744,Cinel; Cameron Alexander,10,0,30,20
1656174849680,MATH 18,A03,083745,Cinel; Cameron Alexander,4,0,30,26
1656174849680,MATH 18,B01,083748,Rideout; David Porter,0,0,36,36
1656174849680,MATH 18,B02,083749,Rideout; David Porter,0,0,36,36
1656174849680,MATH 18,B03,083750,Rideout; David Porter,0,0,36,36
1656174849680,MATH 18,B04,083751,Rideout; David Porter,0,0,36,36
1656174849680,MATH 18,B05,093473,Rideout; David Porter,1,0,36,35
1656174849680,MATH 18,B06,093474,Rideout; David Porter,2,0,36,34
1656174855774,MATH 20A,A01,083754,Zheng; Zequn,11,0,40,29
1656174861798,MATH 20B,A01,083756,Briones; Jor-el Thomas Caparas,0,0,36,36
1656174861798,MATH 20B,A02,083757,Briones; Jor-el Thomas Caparas,0,0,36,36
1656174861798,MATH 20B,A03,093475,Staff,1,0,36,35
1656174867827,MATH 20C,A01,083760,Briones; Jor-el Thomas Caparas,0,0,35,35
1656174867827,MATH 20C,A02,083761,Briones; Jor-el Thomas Caparas,9,1,35,26
1656174867827,MATH 20C,A03,093476,Staff,0,0,35,35
1656174867827,MATH 20C,B01,083762,Bach; Quang Tran,1,0,30,29
1656174873852,MATH 20D,A01,083765,Tran; Brian Kha,1,0,30,29
1656174873852,MATH 20D,A02,083766,Tran; Brian Kha,0,1,30,30
1656174873852,MATH 20D,A03,083767,Tran; Brian Kha,2,0,30,28
1656174879886,MATH 20E,A01,083771,Ganguly; Soumya,4,0,32,28
1656174879886,MATH 20E,A02,083772,Ganguly; Soumya,0,0,32,32
1656174879886,MATH 20E,B01,083773,Ciotti; Benjamin,15,0,35,20
1656174879886,MATH 20E,B02,083774,Ciotti; Benjamin,15,0,35,20
1656174885928,MATH 103A,A01,083777,Greenfeld; Be'Eri,1,0,36,35
1656174885928,MATH 103A,A02,083778,Greenfeld; Be'Eri,1,0,36,35
1656174885928,MATH 103A,A03,093561,Staff,5,0,36,31
1656174885928,MATH 103A,B01,083779,Greenfeld; Be'Eri,8,1,36,28
1656174885928,MATH 103A,B02,083780,Greenfeld; Be'Eri,1,0,36,35
1656174885928,MATH 103A,B03,093562,Staff,0,0,36,36
1656174891951,MATH 105,A01,085443,Carter; Anne Toulson,5,1,35,30
1656174891951,MATH 105,A02,093477,Staff,11,0,35,24
1656174897982,MATH 109,A01,083213,Ganzberger; Geoffrey Michael,0,0,34,34
1656174897982,MATH 109,A02,083214,Ganzberger; Geoffrey Michael,0,0,34,34
1656174897982,MATH 109,A03,093478,Staff,1,0,34,33
1656174897982,MATH 109,B01,083215,Ganzberger; Geoffrey Michael,4,0,32,28
1656174897982,MATH 109,B02,083216,Ganzberger; Geoffrey Michael,1,0,32,31
1656174897982,MATH 109,B03,093479,Staff,4,0,32,28
1656174904009,MATH 142A,A01,083219,Chow; Bennett,1,0,32,31
1656174904009,MATH 142A,A02,083220,Chow; Bennett,8,0,32,24
1656174904009,MATH 142A,A03,093480,Staff,5,0,32,27
1656174904009,MATH 142A,B03,093481,Staff,3,0,32,29
1656174904009,MATH 142A,B04,093558,Staff,6,0,32,26
1656174904009,MATH 142A,B05,093559,Staff,0,0,32,32
1656174910032,MATH 193A,A01,083224,Rotar; Vladimir,0,1,34,34
1656174910032,MATH 193A,A02,083225,Rotar; Vladimir,0,0,34,34
1656174910032,MATH 193A,A03,083781,Rotar; Vladimir,0,0,34,34
1656174910032,MATH 193A,A04,083782,Rotar; Vladimir,6,0,34,28
1656174910032,MATH 193A,A05,093482,Rotar; Vladimir,1,0,34,33
1656174916056,MATH 197,001,091859,McAuley; Julian John,9999,0,9999,0
1656174916056,MATH 197,002,095566,Kedlaya; Kiran S.,9997,0,9999,2
1656174916056,MATH 197,003,095567,Xiao; Ming,9999,0,9999,0
1656174916056,MATH 197,004,095571,Perols; Johan Lars,9998,0,9999,1
1656174923121,COGS 9,A01,083615,Shannon; Kyle Michael,4,0,75,71
1656174929150,COGS 11,A01,083617,Boyle; Mary E. T.,14,0,48,34
1656174935186,COGS 13,A01,083071,Bastos; Amalia Pinkusfeld,5,0,71,66
1656174941213,COGS 14A,A01,092681,Semenuks; Arturs,4,15,100,96
1656174947237,COGS 14B,A01,083073,Cheng; Tzu-Han,7,0,63,56
1656174953264,COGS 17,A01,092677,Semenuks; Arturs,7,0,81,74
1656174959287,COGS 100,A01,083619,Allen; Michael Gordon,2,0,70,68
1656174965313,COGS 101A,A01,083621,Davis; Joshua Daniel,4,0,68,64
1656174971337,COGS 101B,A01,091572,Allen; Michael Gordon,5,0,65,60
1656174977362,COGS 101C,A01,083625,Delgado; Tania,10,0,35,25
1656174983387,COGS 107A,A01,083627,Boyle; Mary E. T.,0,0,60,60
1656174989412,COGS 118A,A01,083075,Gupta; Anjum,7,0,76,69
1656174995438,CSE 3,A50,083646,Miranda; Gregory Joseph,18,0,50,32
1656175001463,CSE 8A,A50,083650,Miranda; Gregory Joseph,3,3,56,53
1656175007488,CSE 11,A01,083080,Cao; Yingjun,1,54,40,39
1656175013512,CSE 12,A01,083652,Krause-Levy; Sophia Louisa,7,2,120,113
1656175019539,CSE 15L,A01,083654,Morris; Justin Loren,2,0,50,48
1656175019539,CSE 15L,A02,083655,Morris; Justin Loren,4,0,50,46
1656175025563,CSE 20,A01,083657,Tran; Khoa Dang,31,0,80,49
1656175031591,CSE 21,A01,095574,Bach; Quang Tran,25,0,48,23
1656175037616,CSE 30,A01,083084,Eldon; John,2,8,80,78
1656175037616,CSE 30,B01,095061,Bhaskar; Nishant,1,2,50,49
1656175043643,CSE 100,A01,083659,Cao; Yingjun,2,20,70,68
1656175049668,CSE 134B,A01,083661,Powell; Thomas Allan,3,0,100,97
1656175055694,CSE 140,A01,083663,Gungor; Onat,9,0,85,76
1656175061719,CSE 140L,A01,083088,Eldon; John,8,0,100,92
1656175067744,CSE 175,A01,083665,Kumar; Rakesh,0,0,25,25
1656175073773,CSE 190,A00,092507,Dubnov; Shlomo,3,0,20,17
1656175079803,ECE 45,A01,083139,Congero; Spencer William,1,0,75,74
1656175085829,ECE 65,A50,083695,Saad; Andrew S,9,0,30,21
1656175085829,ECE 65,A51,095125,Staff,23,0,26,3
1656175091858,ECE 109,A01,091882,Touri; Behrouz,0,1,70,70
1656175097881,ECE 180,A00,083140,Abi Samra; Nicholas Camill,1,0,30,29
1656175097881,ECE 180,B00,083141,Abi Samra; Nicholas Camill,0,4,30,30
1656175103907,MATH 10A,A01,083735,Patchell; Gregory David,0,0,30,30
1656175103907,MATH 10A,A02,083736,Patchell; Gregory David,22,0,30,8
1656175103907,MATH 10A,A03,083737,Patchell; Gregory David,16,0,30,14
1656175109940,MATH 10B,A01,083207,Lim; Seonhee,0,0,34,34
1656175109940,MATH 10B,A02,083208,Lim; Seonhee,7,0,35,28
1656175109940,MATH 10B,A03,093472,Staff,1,0,34,33
1656175109940,MATH 10B,B01,083739,Sinha; Shubham,10,0,30,20
1656175115977,MATH 18,A01,083743,Cinel; Cameron Alexander,7,0,30,23
1656175115977,MATH 18,A02,083744,Cinel; Cameron Alexander,10,0,30,20
1656175115977,MATH 18,A03,083745,Cinel; Cameron Alexander,4,0,30,26
1656175115977,MATH 18,B01,083748,Rideout; David Porter,0,0,36,36
1656175115977,MATH 18,B02,083749,Rideout; David Porter,0,0,36,36
1656175115977,MATH 18,B03,083750,Rideout; David Porter,0,0,36,36
1656175115977,MATH 18,B04,083751,Rideout; David Porter,0,0,36,36
1656175115977,MATH 18,B05,093473,Rideout; David Porter,1,0,36,35
1656175115977,MATH 18,B06,093474,Rideout; David Porter,2,0,36,34
1656175122004,MATH 20A,A01,083754,Zheng; Zequn,11,0,40,29
1656175128033,MATH 20B,A01,083756,Briones; Jor-el Thomas Caparas,0,0,36,36
1656175128033,MATH 20B,A02,083757,Briones; Jor-el Thomas Caparas,0,0,36,36
1656175128033,MATH 20B,A03,093475,Staff,1,0,36,35
1656175134058,MATH 20C,A01,083760,Briones; Jor-el Thomas Caparas,0,0,35,35
1656175134058,MATH 20C,A02,083761,Briones; Jor-el Thomas Caparas,9,1,35,26
1656175134058,MATH 20C,A03,093476,Staff,0,0,35,35
1656175134058,MATH 20C,B01,083762,Bach; Quang Tran,1,0,30,29
1656175140084,MATH 20D,A01,083765,Tran; Brian Kha,1,0,30,29
1656175140084,MATH 20D,A02,083766,Tran; Brian Kha,0,1,30,30
1656175140084,MATH 20D,A03,083767,Tran; Brian Kha,2,0,30,28
1656175146111,MATH 20E,A01,083771,Ganguly; Soumya,4,0,32,28
1656175146111,MATH 20E,A02,083772,Ganguly; Soumya,0,0,32,32
1656175146111,MATH 20E,B01,083773,Ciotti; Benjamin,15,0,35,20
1656175146111,MATH 20E,B02,083774,Ciotti; Benjamin,15,0,35,20
1656175152137,MATH 103A,A01,083777,Greenfeld; Be'Eri,1,0,36,35
1656175152137,MATH 103A,A02,083778,Greenfeld; Be'Eri,1,0,36,35
1656175152137,MATH 103A,A03,093561,Staff,5,0,36,31
1656175152137,MATH 103A,B01,083779,Greenfeld; Be'Eri,8,1,36,28
1656175152137,MATH 103A,B02,083780,Greenfeld; Be'Eri,1,0,36,35
1656175152137,MATH 103A,B03,093562,Staff,0,0,36,36
1656175158161,MATH 105,A01,085443,Carter; Anne Toulson,5,1,35,30
1656175158161,MATH 105,A02,093477,Staff,11,0,35,24
1656175164186,MATH 109,A01,083213,Ganzberger; Geoffrey Michael,0,0,34,34
1656175164186,MATH 109,A02,083214,Ganzberger; Geoffrey Michael,0,0,34,34
1656175164186,MATH 109,A03,093478,Staff,1,0,34,33
1656175164186,MATH 109,B01,083215,Ganzberger; Geoffrey Michael,4,0,32,28
1656175164186,MATH 109,B02,083216,Ganzberger; Geoffrey Michael,1,0,32,31
1656175164186,MATH 109,B03,093479,Staff,4,0,32,28
1656175170215,MATH 142A,A01,083219,Chow; Bennett,1,0,32,31
1656175170215,MATH 142A,A02,083220,Chow; Bennett,8,0,32,24
1656175170215,MATH 142A,A03,093480,Staff,5,0,32,27
1656175170215,MATH 142A,B03,093481,Staff,3,0,32,29
1656175170215,MATH 142A,B04,093558,Staff,6,0,32,26
1656175170215,MATH 142A,B05,093559,Staff,0,0,32,32
1656175176247,MATH 193A,A01,083224,Rotar; Vladimir,0,1,34,34
1656175176247,MATH 193A,A02,083225,Rotar; Vladimir,0,0,34,34
1656175176247,MATH 193A,A03,083781,Rotar; Vladimir,0,0,34,34
1656175176247,MATH 193A,A04,083782,Rotar; Vladimir,6,0,34,28
1656175176247,MATH 193A,A05,093482,Rotar; Vladimir,1,0,34,33
1656175182277,MATH 197,001,091859,McAuley; Julian John,9999,0,9999,0
1656175182277,MATH 197,002,095566,Kedlaya; Kiran S.,9997,0,9999,2
1656175182277,MATH 197,003,095567,Xiao; Ming,9999,0,9999,0
1656175182277,MATH 197,004,095571,Perols; Johan Lars,9998,0,9999,1
1656175189345,COGS 9,A01,083615,Shannon; Kyle Michael,4,0,75,71
1656175195369,COGS 11,A01,083617,Boyle; Mary E. T.,14,0,48,34
1656175201406,COGS 13,A01,083071,Bastos; Amalia Pinkusfeld,5,0,71,66
1656175207430,COGS 14A,A01,092681,Semenuks; Arturs,4,15,100,96
1656175213457,COGS 14B,A01,083073,Cheng; Tzu-Han,7,0,63,56
1656175219483,COGS 17,A01,092677,Semenuks; Arturs,7,0,81,74
1656175225505,COGS 100,A01,083619,Allen; Michael Gordon,2,0,70,68
1656175231529,COGS 101A,A01,083621,Davis; Joshua Daniel,4,0,68,64
1656175237552,COGS 101B,A01,091572,Allen; Michael Gordon,5,0,65,60
1656175243576,COGS 101C,A01,083625,Delgado; Tania,10,0,35,25
1656175249601,COGS 107A,A01,083627,Boyle; Mary E. T.,0,0,60,60
1656175255628,COGS 118A,A01,083075,Gupta; Anjum,7,0,76,69
1656175261660,CSE 3,A50,083646,Miranda; Gregory Joseph,18,0,50,32
1656175267685,CSE 8A,A50,083650,Miranda; Gregory Joseph,3,3,56,53
1656175273714,CSE 11,A01,083080,Cao; Yingjun,1,54,40,39
1656175279742,CSE 12,A01,083652,Krause-Levy; Sophia Louisa,7,2,120,113
1656175285771,CSE 15L,A01,083654,Morris; Justin Loren,2,0,50,48
1656175285771,CSE 15L,A02,083655,Morris; Justin Loren,4,0,50,46
1656175291799,CSE 20,A01,083657,Tran; Khoa Dang,31,0,80,49
1656175297825,CSE 21,A01,095574,Bach; Quang Tran,25,0,48,23
1656175303850,CSE 30,A01,083084,Eldon; John,2,8,80,78
1656175303850,CSE 30,B01,095061,Bhaskar; Nishant,1,2,50,49
1656175309879,CSE 100,A01,083659,Cao; Yingjun,2,20,70,68
1656175315904,CSE 134B,A01,083661,Powell; Thomas Allan,3,0,100,97
1656175321927,CSE 140,A01,083663,Gungor; Onat,9,0,85,76
1656175327953,CSE 140L,A01,083088,Eldon; John,8,0,100,92
1656175333981,CSE 175,A01,083665,Kumar; Rakesh,0,0,25,25
1656175340005,CSE 190,A00,092507,Dubnov; Shlomo,3,0,20,17
1656175346035,ECE 45,A01,083139,Congero; Spencer William,1,0,75,74
1656175352060,ECE 65,A50,083695,Saad; Andrew S,9,0,30,21
1656175352060,ECE 65,A51,095125,Staff,23,0,26,3
1656175358093,ECE 109,A01,091882,Touri; Behrouz,0,1,70,70
1656175364118,ECE 180,A00,083140,Abi Samra; Nicholas Camill,1,0,30,29
1656175364118,ECE 180,B00,083141,Abi Samra; Nicholas Camill,0,4,30,30
1656175370148,MATH 10A,A01,083735,Patchell; Gregory David,0,0,30,30
1656175370148,MATH 10A,A02,083736,Patchell; Gregory David,22,0,30,8
1656175370148,MATH 10A,A03,083737,Patchell; Gregory David,16,0,30,14
1656175376172,MATH 10B,A01,083207,Lim; Seonhee,0,0,34,34
1656175376172,MATH 10B,A02,083208,Lim; Seonhee,7,0,35,28
1656175376172,MATH 10B,A03,093472,Staff,1,0,34,33
1656175376172,MATH 10B,B01,083739,Sinha; Shubham,10,0,30,20
1656175382242,MATH 18,A01,083743,Cinel; Cameron Alexander,7,0,30,23
1656175382242,MATH 18,A02,083744,Cinel; Cameron Alexander,10,0,30,20
1656175382242,MATH 18,A03,083745,Cinel; Cameron Alexander,4,0,30,26
1656175382242,MATH 18,B01,083748,Rideout; David Porter,0,0,36,36
1656175382242,MATH 18,B02,083749,Rideout; David Porter,0,0,36,36
1656175382242,MATH 18,B03,083750,Rideout; David Porter,0,0,36,36
1656175382242,MATH 18,B04,083751,Rideout; David Porter,0,0,36,36
1656175382242,MATH 18,B05,093473,Rideout; David Porter,1,0,36,35
1656175382242,MATH 18,B06,093474,Rideout; David Porter,2,0,36,34
1656175388266,MATH 20A,A01,083754,Zheng; Zequn,11,0,40,29
1656175394296,MATH 20B,A01,083756,Briones; Jor-el Thomas Caparas,0,0,36,36
1656175394296,MATH 20B,A02,083757,Briones; Jor-el Thomas Caparas,0,0,36,36
1656175394296,MATH 20B,A03,093475,Staff,1,0,36,35
1656175400321,MATH 20C,A01,083760,Briones; Jor-el Thomas Caparas,0,0,35,35
1656175400321,MATH 20C,A02,083761,Briones; Jor-el Thomas Caparas,9,1,35,26
1656175400321,MATH 20C,A03,093476,Staff,0,0,35,35
1656175400321,MATH 20C,B01,083762,Bach; Quang Tran,1,0,30,29
1656175406346,MATH 20D,A01,083765,Tran; Brian Kha,1,0,30,29
1656175406346,MATH 20D,A02,083766,Tran; Brian Kha,0,1,30,30
1656175406346,MATH 20D,A03,083767,Tran; Brian Kha,2,0,30,28
1656175412377,MATH 20E,A01,083771,Ganguly; Soumya,4,0,32,28
1656175412377,MATH 20E,A02,083772,Ganguly; Soumya,0,0,32,32
1656175412377,MATH 20E,B01,083773,Ciotti; Benjamin,15,0,35,20
1656175412377,MATH 20E,B02,083774,Ciotti; Benjamin,15,0,35,20
1656175418404,MATH 103A,A01,083777,Greenfeld; Be'Eri,1,0,36,35
1656175418404,MATH 103A,A02,083778,Greenfeld; Be'Eri,1,0,36,35
1656175418404,MATH 103A,A03,093561,Staff,5,0,36,31
1656175418404,MATH 103A,B01,083779,Greenfeld; Be'Eri,8,1,36,28
1656175418404,MATH 103A,B02,083780,Greenfeld; Be'Eri,1,0,36,35
1656175418404,MATH 103A,B03,093562,Staff,0,0,36,36
1656175424436,MATH 105,A01,085443,Carter; Anne Toulson,5,1,35,30
1656175424436,MATH 105,A02,093477,Staff,11,0,35,24
1656175430468,MATH 109,A01,083213,Ganzberger; Geoffrey Michael,0,0,34,34
1656175430468,MATH 109,A02,083214,Ganzberger; Geoffrey Michael,0,0,34,34
1656175430468,MATH 109,A03,093478,Staff,1,0,34,33
1656175430468,MATH 109,B01,083215,Ganzberger; Geoffrey Michael,4,0,32,28
1656175430468,MATH 109,B02,083216,Ganzberger; Geoffrey Michael,1,0,32,31
1656175430468,MATH 109,B03,093479,Staff,4,0,32,28
1656175436493,MATH 142A,A01,083219,Chow; Bennett,1,0,32,31
1656175436493,MATH 142A,A02,083220,Chow; Bennett,8,0,32,24
1656175436493,MATH 142A,A03,093480,Staff,5,0,32,27
1656175436493,MATH 142A,B03,093481,Staff,3,0,32,29
1656175436493,MATH 142A,B04,093558,Staff,6,0,32,26
1656175436493,MATH 142A,B05,093559,Staff,0,0,32,32
1656175442524,MATH 193A,A01,083224,Rotar; Vladimir,0,1,34,34
1656175442524,MATH 193A,A02,083225,Rotar; Vladimir,0,0,34,34
1656175442524,MATH 193A,A03,083781,Rotar; Vladimir,0,0,34,34
1656175442524,MATH 193A,A04,083782,Rotar; Vladimir,6,0,34,28
1656175442524,MATH 193A,A05,093482,Rotar; Vladimir,1,0,34,33
1656175448553,MATH 197,001,091859,McAuley; Julian John,9999,0,9999,0
1656175448553,MATH 197,002,095566,Kedlaya; Kiran S.,9997,0,9999,2
1656175448553,MATH 197,003,095567,Xiao; Ming,9999,0,9999,0
1656175448553,MATH 197,004,095571,Perols; Johan Lars,9998,0,9999,1
1656175455711,COGS 9,A01,083615,Shannon; Kyle Michael,4,0,75,71
1656175461738,COGS 11,A01,083617,Boyle; Mary E. T.,14,0,48,34
1656175467766,COGS 13,A01,083071,Bastos; Amalia Pinkusfeld,5,0,71,66
1656175473795,COGS 14A,A01,092681,Semenuks; Arturs,4,15,100,96
1656175479819,COGS 14B,A01,083073,Cheng; Tzu-Han,7,0,63,56
1656175485843,COGS 17,A01,092677,Semenuks; Arturs,7,0,81,74
1656175491870,COGS 100,A01,083619,Allen; Michael Gordon,2,0,70,68
1656175497901,COGS 101A,A01,083621,Davis; Joshua Daniel,4,0,68,64
1656175503929,COGS 101B,A01,091572,Allen; Michael Gordon,5,0,65,60
1656175509958,COGS 101C,A01,083625,Delgado; Tania,10,0,35,25
1656175515982,COGS 107A,A01,083627,Boyle; Mary E. T.,0,0,60,60
1656175522005,COGS 118A,A01,083075,Gupta; Anjum,7,0,76,69
1656175528032,CSE 3,A50,083646,Miranda; Gregory Joseph,18,0,50,32
1656175534056,CSE 8A,A50,083650,Miranda; Gregory Joseph,3,3,56,53
1656175540080,CSE 11,A01,083080,Cao; Yingjun,1,54,40,39
1656175546120,CSE 12,A01,083652,Krause-Levy; Sophia Louisa,7,2,120,113
1656175552147,CSE 15L,A01,083654,Morris; Justin Loren,2,0,50,48
1656175552147,CSE 15L,A02,083655,Morris; Justin Loren,4,0,50,46
1656175558175,CSE 20,A01,083657,Tran; Khoa Dang,31,0,80,49
1656175564205,CSE 21,A01,095574,Bach; Quang Tran,25,0,48,23
1656175570236,CSE 30,A01,083084,Eldon; John,2,8,80,78
1656175570236,CSE 30,B01,095061,Bhaskar; Nishant,1,2,50,49
1656175576260,CSE 100,A01,083659,Cao; Yingjun,2,20,70,68
1656175582287,CSE 134B,A01,083661,Powell; Thomas Allan,3,0,100,97
1656175588312,CSE 140,A01,083663,Gungor; Onat,9,0,85,76
1656175594339,CSE 140L,A01,083088,Eldon; John,8,0,100,92
1656175600363,CSE 175,A01,083665,Kumar; Rakesh,0,0,25,25
1656175606392,CSE 190,A00,092507,Dubnov; Shlomo,3,0,20,17
1656175612418,ECE 45,A01,083139,Congero; Spencer William,1,0,75,74
1656175618461,ECE 65,A50,083695,Saad; Andrew S,9,0,30,21
1656175618461,ECE 65,A51,095125,Staff,23,0,26,3
1656175624483,ECE 109,A01,091882,Touri; Behrouz,0,1,70,70
1656175630507,ECE 180,A00,083140,Abi Samra; Nicholas Camill,1,0,30,29
1656175630507,ECE 180,B00,083141,Abi Samra; Nicholas Camill,0,4,30,30
1656175636531,MATH 10A,A01,083735,Patchell; Gregory David,0,0,30,30
1656175636531,MATH 10A,A02,083736,Patchell; Gregory David,22,0,30,8
1656175636531,MATH 10A,A03,083737,Patchell; Gregory David,16,0,30,14
1656175642567,MATH 10B,A01,083207,Lim; Seonhee,0,0,34,34
1656175642567,MATH 10B,A02,083208,Lim; Seonhee,7,0,35,28
1656175642567,MATH 10B,A03,093472,Staff,1,0,34,33
1656175642567,MATH 10B,B01,083739,Sinha; Shubham,10,0,30,20
1656175648606,MATH 18,A01,083743,Cinel; Cameron Alexander,7,0,30,23
1656175648606,MATH 18,A02,083744,Cinel; Cameron Alexander,10,0,30,20
1656175648606,MATH 18,A03,083745,Cinel; Cameron Alexander,4,0,30,26
1656175648606,MATH 18,B01,083748,Rideout; David Porter,0,0,36,36
1656175648606,MATH 18,B02,083749,Rideout; David Porter,0,0,36,36
1656175648606,MATH 18,B03,083750,Rideout; David Porter,0,0,36,36
1656175648606,MATH 18,B04,083751,Rideout; David Porter,0,0,36,36
1656175648606,MATH 18,B05,093473,Rideout; David Porter,1,0,36,35
1656175648606,MATH 18,B06,093474,Rideout; David Porter,2,0,36,34
1656175654632,MATH 20A,A01,083754,Zheng; Zequn,11,0,40,29
1656175660659,MATH 20B,A01,083756,Briones; Jor-el Thomas Caparas,0,0,36,36
1656175660659,MATH 20B,A02,083757,Briones; Jor-el Thomas Caparas,0,0,36,36
1656175660659,MATH 20B,A03,093475,Staff,1,0,36,35
1656175666683,MATH 20C,A01,083760,Briones; Jor-el Thomas Caparas,0,0,35,35
1656175666683,MATH 20C,A02,083761,Briones; Jor-el Thomas Caparas,9,1,35,26
1656175666683,MATH 20C,A03,093476,Staff,0,0,35,35
1656175666683,MATH 20C,B01,083762,Bach; Quang Tran,1,0,30,29
1656175672707,MATH 20D,A01,083765,Tran; Brian Kha,1,0,30,29
1656175672707,MATH 20D,A02,083766,Tran; Brian Kha,0,1,30,30
1656175672707,MATH 20D,A03,083767,Tran; Brian Kha,2,0,30,28
1656175678736,MATH 20E,A01,083771,Ganguly; Soumya,4,0,32,28
1656175678736,MATH 20E,A02,083772,Ganguly; Soumya,0,0,32,32
1656175678736,MATH 20E,B01,083773,Ciotti; Benjamin,15,0,35,20
1656175678736,MATH 20E,B02,083774,Ciotti; Benjamin,15,0,35,20
1656175684766,MATH 103A,A01,083777,Greenfeld; Be'Eri,1,0,36,35
1656175684766,MATH 103A,A02,083778,Greenfeld; Be'Eri,1,0,36,35
1656175684766,MATH 103A,A03,093561,Staff,5,0,36,31
1656175684766,MATH 103A,B01,083779,Greenfeld; Be'Eri,8,1,36,28
1656175684766,MATH 103A,B02,083780,Greenfeld; Be'Eri,1,0,36,35
1656175684766,MATH 103A,B03,093562,Staff,0,0,36,36
1656175690798,MATH 105,A01,085443,Carter; Anne Toulson,5,1,35,30
1656175690798,MATH 105,A02,093477,Staff,11,0,35,24
1656175696822,MATH 109,A01,083213,Ganzberger; Geoffrey Michael,0,0,34,34
1656175696822,MATH 109,A02,083214,Ganzberger; Geoffrey Michael,0,0,34,34
1656175696822,MATH 109,A03,093478,Staff,1,0,34,33
1656175696822,MATH 109,B01,083215,Ganzberger; Geoffrey Michael,4,0,32,28
1656175696822,MATH 109,B02,083216,Ganzberger; Geoffrey Michael,1,0,32,31
1656175696822,MATH 109,B03,093479,Staff,4,0,32,28
1656175702849,MATH 142A,A01,083219,Chow; Bennett,1,0,32,31
1656175702849,MATH 142A,A02,083220,Chow; Bennett,8,0,32,24
1656175702849,MATH 142A,A03,093480,Staff,5,0,32,27
1656175702849,MATH 142A,B03,093481,Staff,3,0,32,29
1656175702849,MATH 142A,B04,093558,Staff,6,0,32,26
1656175702849,MATH 142A,B05,093559,Staff,0,0,32,32
1656175708874,MATH 193A,A01,083224,Rotar; Vladimir,0,1,34,34
1656175708874,MATH 193A,A02,083225,Rotar; Vladimir,0,0,34,34
1656175708874,MATH 193A,A03,083781,Rotar; Vladimir,0,0,34,34
1656175708874,MATH 193A,A04,083782,Rotar; Vladimir,6,0,34,28
1656175708874,MATH 193A,A05,093482,Rotar; Vladimir,1,0,34,33
1656175714904,MATH 197,001,091859,McAuley; Julian John,9999,0,9999,0
1656175714904,MATH 197,002,095566,Kedlaya; Kiran S.,9997,0,9999,2
1656175714904,MATH 197,003,095567,Xiao; Ming,9999,0,9999,0
1656175714904,MATH 197,004,095571,Perols; Johan Lars,9998,0,9999,1
1656175721962,COGS 9,A01,083615,Shannon; Kyle Michael,4,0,75,71
1656175727990,COGS 11,A01,083617,Boyle; Mary E. T.,14,0,48,34
1656175734013,COGS 13,A01,083071,Bastos; Amalia Pinkusfeld,5,0,71,66
1656175740041,COGS 14A,A01,092681,Semenuks; Arturs,4,15,100,96
1656175746072,COGS 14B,A01,083073,Cheng; Tzu-Han,7,0,63,56
1656175752095,COGS 17,A01,092677,Semenuks; Arturs,7,0,81,74
1656175758119,COGS 100,A01,083619,Allen; Michael Gordon,2,0,70,68
1656175764149,COGS 101A,A01,083621,Davis; Joshua Daniel,4,0,68,64
1656175770176,COGS 101B,A01,091572,Allen; Michael Gordon,5,0,65,60
1656175776211,COGS 101C,A01,083625,Delgado; Tania,10,0,35,25
1656175782237,COGS 107A,A01,083627,Boyle; Mary E. T.,0,0,60,60
1656175788261,COGS 118A,A01,083075,Gupta; Anjum,7,0,76,69
1656175794293,CSE 3,A50,083646,Miranda; Gregory Joseph,18,0,50,32
1656175800325,CSE 8A,A50,083650,Miranda; Gregory Joseph,3,3,56,53
1656175806356,CSE 11,A01,083080,Cao; Yingjun,1,54,40,39
1656175812385,CSE 12,A01,083652,Krause-Levy; Sophia Louisa,7,2,120,113
1656175818408,CSE 15L,A01,083654,Morris; Justin Loren,2,0,50,48
1656175818408,CSE 15L,A02,083655,Morris; Justin Loren,4,0,50,46
1656175824436,CSE 20,A01,083657,Tran; Khoa Dang,31,0,80,49
1656175830460,CSE 21,A01,095574,Bach; Quang Tran,25,0,48,23
1656175836486,CSE 30,A01,083084,Eldon; John,2,8,80,78
1656175836486,CSE 30,B01,095061,Bhaskar; Nishant,1,2,50,49
1656175842968,CSE 100,A01,083659,Cao; Yingjun,2,20,70,68
1656175848996,CSE 134B,A01,083661,Powell; Thomas Allan,3,0,100,97
1656175855021,CSE 140,A01,083663,Gungor; Onat,9,0,85,76
1656175861044,CSE 140L,A01,083088,Eldon; John,8,0,100,92
1656175867069,CSE 175,A01,083665,Kumar; Rakesh,0,0,25,25
1656175873096,CSE 190,A00,092507,Dubnov; Shlomo,3,0,20,17
1656175879127,ECE 45,A01,083139,Congero; Spencer William,1,0,75,74
1656175885163,ECE 65,A50,083695,Saad; Andrew S,9,0,30,21
1656175885163,ECE 65,A51,095125,Staff,23,0,26,3
1656175891199,ECE 109,A01,091882,Touri; Behrouz,0,1,70,70
1656175897224,ECE 180,A00,083140,Abi Samra; Nicholas Camill,1,0,30,29
1656175897224,ECE 180,B00,083141,Abi Samra; Nicholas Camill,0,4,30,30
1656175903257,MATH 10A,A01,083735,Patchell; Gregory David,0,0,30,30
1656175903257,MATH 10A,A02,083736,Patchell; Gregory David,22,0,30,8
1656175903257,MATH 10A,A03,083737,Patchell; Gregory David,16,0,30,14
1656175909291,MATH 10B,A01,083207,Lim; Seonhee,0,0,34,34
1656175909291,MATH 10B,A02,083208,Lim; Seonhee,7,0,35,28
1656175909291,MATH 10B,A03,093472,Staff,1,0,34,33
1656175909291,MATH 10B,B01,083739,Sinha; Shubham,10,0,30,20
1656175915319,MATH 18,A01,083743,Cinel; Cameron Alexander,7,0,30,23
1656175915319,MATH 18,A02,083744,Cinel; Cameron Alexander,10,0,30,20
1656175915319,MATH 18,A03,083745,Cinel; Cameron Alexander,4,0,30,26
1656175915319,MATH 18,B01,083748,Rideout; David Porter,0,0,36,36
1656175915319,MATH 18,B02,083749,Rideout; David Porter,0,0,36,36
1656175915319,MATH 18,B03,083750,Rideout; David Porter,0,0,36,36
1656175915319,MATH 18,B04,083751,Rideout; David Porter,0,0,36,36
1656175915319,MATH 18,B05,093473,Rideout; David Porter,1,0,36,35
1656175915319,MATH 18,B06,093474,Rideout; David Porter,2,0,36,34
1656175921348,MATH 20A,A01,083754,Zheng; Zequn,11,0,40,29
1656175927375,MATH 20B,A01,083756,Briones; Jor-el Thomas Caparas,0,0,36,36
1656175927375,MATH 20B,A02,083757,Briones; Jor-el Thomas Caparas,0,0,36,36
1656175927375,MATH 20B,A03,093475,Staff,1,0,36,35
1656175933402,MATH 20C,A01,083760,Briones; Jor-el Thomas Caparas,0,0,35,35
1656175933402,MATH 20C,A02,083761,Briones; Jor-el Thomas Caparas,9,1,35,26
1656175933402,MATH 20C,A03,093476,Staff,0,0,35,35
1656175933402,MATH 20C,B01,083762,Bach; Quang Tran,1,0,30,29
1656175939430,MATH 20D,A01,083765,Tran; Brian Kha,1,0,30,29
1656175939430,MATH 20D,A02,083766,Tran; Brian Kha,0,1,30,30
1656175939430,MATH 20D,A03,083767,Tran; Brian Kha,2,0,30,28
1656175945460,MATH 20E,A01,083771,Ganguly; Soumya,4,0,32,28
1656175945460,MATH 20E,A02,083772,Ganguly; Soumya,0,0,32,32
1656175945460,MATH 20E,B01,083773,Ciotti; Benjamin,15,0,35,20
1656175945460,MATH 20E,B02,083774,Ciotti; Benjamin,15,0,35,20
1656175951483,MATH 103A,A01,083777,Greenfeld; Be'Eri,1,0,36,35
1656175951483,MATH 103A,A02,083778,Greenfeld; Be'Eri,1,0,36,35
1656175951483,MATH 103A,A03,093561,Staff,5,0,36,31
1656175951483,MATH 103A,B01,083779,Greenfeld; Be'Eri,8,1,36,28
1656175951483,MATH 103A,B02,083780,Greenfeld; Be'Eri,1,0,36,35
1656175951483,MATH 103A,B03,093562,Staff,0,0,36,36
1656175957510,MATH 105,A01,085443,Carter; Anne Toulson,5,1,35,30
1656175957510,MATH 105,A02,093477,Staff,11,0,35,24
1656175963537,MATH 109,A01,083213,Ganzberger; Geoffrey Michael,0,0,34,34
1656175963537,MATH 109,A02,083214,Ganzberger; Geoffrey Michael,0,0,34,34
1656175963537,MATH 109,A03,093478,Staff,1,0,34,33
1656175963537,MATH 109,B01,083215,Ganzberger; Geoffrey Michael,4,0,32,28
1656175963537,MATH 109,B02,083216,Ganzberger; Geoffrey Michael,1,0,32,31
1656175963537,MATH 109,B03,093479,Staff,4,0,32,28
1656175969563,MATH 142A,A01,083219,Chow; Bennett,1,0,32,31
1656175969563,MATH 142A,A02,083220,Chow; Bennett,8,0,32,24
1656175969563,MATH 142A,A03,093480,Staff,5,0,32,27
1656175969563,MATH 142A,B03,093481,Staff,3,0,32,29
1656175969563,MATH 142A,B04,093558,Staff,6,0,32,26
1656175969563,MATH 142A,B05,093559,Staff,0,0,32,32
1656175975591,MATH 193A,A01,083224,Rotar; Vladimir,0,1,34,34
1656175975591,MATH 193A,A02,083225,Rotar; Vladimir,0,0,34,34
1656175975591,MATH 193A,A03,083781,Rotar; Vladimir,0,0,34,34
1656175975591,MATH 193A,A04,083782,Rotar; Vladimir,6,0,34,28
1656175975591,MATH 193A,A05,093482,Rotar; Vladimir,1,0,34,33
1656175981614,MATH 197,001,091859,McAuley; Julian John,9999,0,9999,0
1656175981614,MATH 197,002,095566,Kedlaya; Kiran S.,9997,0,9999,2
1656175981614,MATH 197,003,095567,Xiao; Ming,9999,0,9999,0
1656175981614,MATH 197,004,095571,Perols; Johan Lars,9998,0,9999,1
1656175988675,COGS 9,A01,083615,Shannon; Kyle Michael,4,0,75,71
1656175994699,COGS 11,A01,083617,Boyle; Mary E. T.,14,0,48,34
1656176000724,COGS 13,A01,083071,Bastos; Amalia Pinkusfeld,5,0,71,66
1656176006751,COGS 14A,A01,092681,Semenuks; Arturs,4,15,100,96
1656176012777,COGS 14B,A01,083073,Cheng; Tzu-Han,7,0,63,56
1656176018803,COGS 17,A01,092677,Semenuks; Arturs,7,0,81,74
1656176024830,COGS 100,A01,083619,Allen; Michael Gordon,2,0,70,68
1656176030855,COGS 101A,A01,083621,Davis; Joshua Daniel,4,0,68,64
1656176036878,COGS 101B,A01,091572,Allen; Michael Gordon,5,0,65,60
1656176042903,COGS 101C,A01,083625,Delgado; Tania,10,0,35,25
1656176049011,COGS 107A,A01,083627,Boyle; Mary E. T.,0,0,60,60
1656176055033,COGS 118A,A01,083075,Gupta; Anjum,7,0,76,69
1656176061058,CSE 3,A50,083646,Miranda; Gregory Joseph,18,0,50,32
1656176067087,CSE 8A,A50,083650,Miranda; Gregory Joseph,3,3,56,53
1656176073114,CSE 11,A01,083080,Cao; Yingjun,1,54,40,39
1656176079141,CSE 12,A01,083652,Krause-Levy; Sophia Louisa,7,2,120,113
1656176085169,CSE 15L,A01,083654,Morris; Justin Loren,2,0,50,48
1656176085169,CSE 15L,A02,083655,Morris; Justin Loren,4,0,50,46
1656176091193,CSE 20,A01,083657,Tran; Khoa Dang,31,0,80,49
1656176097217,CSE 21,A01,095574,Bach; Quang Tran,25,0,48,23
1656176103249,CSE 30,A01,083084,Eldon; John,2,8,80,78
1656176103249,CSE 30,B01,095061,Bhaskar; Nishant,1,2,50,49
1656176109279,CSE 100,A01,083659,Cao; Yingjun,2,20,70,68
1656176115302,CSE 134B,A01,083661,Powell; Thomas Allan,3,0,100,97
1656176121335,CSE 140,A01,083663,Gungor; Onat,9,0,85,76
1656176127362,CSE 140L,A01,083088,Eldon; John,8,0,100,92
1656176133390,CSE 175,A01,083665,Kumar; Rakesh,0,0,25,25
1656176139417,CSE 190,A00,092507,Dubnov; Shlomo,3,0,20,17
1656176145445,ECE 45,A01,083139,Congero; Spencer William,1,0,75,74
1656176151472,ECE 65,A50,083695,Saad; Andrew S,9,0,30,21
1656176151472,ECE 65,A51,095125,Staff,23,0,26,3
1656176157496,ECE 109,A01,091882,Touri; Behrouz,0,1,70,70
1656176163526,ECE 180,A00,083140,Abi Samra; Nicholas Camill,1,0,30,29
1656176163526,ECE 180,B00,083141,Abi Samra; Nicholas Camill,0,4,30,30
1656176169552,MATH 10A,A01,083735,Patchell; Gregory David,0,0,30,30
1656176169552,MATH 10A,A02,083736,Patchell; Gregory David,22,0,30,8
1656176169552,MATH 10A,A03,083737,Patchell; Gregory David,16,0,30,14
1656176175577,MATH 10B,A01,083207,Lim; Seonhee,0,0,34,34
1656176175577,MATH 10B,A02,083208,Lim; Seonhee,7,0,35,28
1656176175577,MATH 10B,A03,093472,Staff,1,0,34,33
1656176175577,MATH 10B,B01,083739,Sinha; Shubham,10,0,30,20
1656176181609,MATH 18,A01,083743,Cinel; Cameron Alexander,7,0,30,23
1656176181609,MATH 18,A02,083744,Cinel; Cameron Alexander,10,0,30,20
1656176181609,MATH 18,A03,083745,Cinel; Cameron Alexander,4,0,30,26
1656176181609,MATH 18,B01,083748,Rideout; David Porter,0,0,36,36
1656176181609,MATH 18,B02,083749,Rideout; David Porter,0,0,36,36
1656176181609,MATH 18,B03,083750,Rideout; David Porter,0,0,36,36
1656176181609,MATH 18,B04,083751,Rideout; David Porter,0,0,36,36
1656176181609,MATH 18,B05,093473,Rideout; David Porter,1,0,36,35
1656176181609,MATH 18,B06,093474,Rideout; David Porter,2,0,36,34
1656176187633,MATH 20A,A01,083754,Zheng; Zequn,11,0,40,29
1656176193657,MATH 20B,A01,083756,Briones; Jor-el Thomas Caparas,0,0,36,36
1656176193657,MATH 20B,A02,083757,Briones; Jor-el Thomas Caparas,0,0,36,36
1656176193657,MATH 20B,A03,093475,Staff,1,0,36,35
1656176199682,MATH 20C,A01,083760,Briones; Jor-el Thomas Caparas,0,0,35,35
1656176199682,MATH 20C,A02,083761,Briones; Jor-el Thomas Caparas,9,1,35,26
1656176199682,MATH 20C,A03,093476,Staff,0,0,35,35
1656176199682,MATH 20C,B01,083762,Bach; Quang Tran,1,0,30,29
1656176205711,MATH 20D,A01,083765,Tran; Brian Kha,1,0,30,29
1656176205711,MATH 20D,A02,083766,Tran; Brian Kha,0,1,30,30
1656176205711,MATH 20D,A03,083767,Tran; Brian Kha,2,0,30,28
1656176211749,MATH 20E,A01,083771,Ganguly; Soumya,4,0,32,28
1656176211749,MATH 20E,A02,083772,Ganguly; Soumya,0,0,32,32
1656176211749,MATH 20E,B01,083773,Ciotti; Benjamin,15,0,35,20
1656176211749,MATH 20E,B02,083774,Ciotti; Benjamin,15,0,35,20
1656176217773,MATH 103A,A01,083777,Greenfeld; Be'Eri,1,0,36,35
1656176217773,MATH 103A,A02,083778,Greenfeld; Be'Eri,1,0,36,35
1656176217773,MATH 103A,A03,093561,Staff,5,0,36,31
1656176217773,MATH 103A,B01,083779,Greenfeld; Be'Eri,8,1,36,28
1656176217773,MATH 103A,B02,083780,Greenfeld; Be'Eri,1,0,36,35
1656176217773,MATH 103A,B03,093562,Staff,0,0,36,36
1656176223796,MATH 105,A01,085443,Carter; Anne Toulson,5,1,35,30
1656176223796,MATH 105,A02,093477,Staff,11,0,35,24
1656176229829,MATH 109,A01,083213,Ganzberger; Geoffrey Michael,0,0,34,34
1656176229829,MATH 109,A02,083214,Ganzberger; Geoffrey Michael,0,0,34,34
1656176229829,MATH 109,A03,093478,Staff,1,0,34,33
1656176229829,MATH 109,B01,083215,Ganzberger; Geoffrey Michael,4,0,32,28
1656176229829,MATH 109,B02,083216,Ganzberger; Geoffrey Michael,1,0,32,31
1656176229829,MATH 109,B03,093479,Staff,4,0,32,28
1656176235853,MATH 142A,A01,083219,Chow; Bennett,1,0,32,31
1656176235853,MATH 142A,A02,083220,Chow; Bennett,8,0,32,24
1656176235853,MATH 142A,A03,093480,Staff,5,0,32,27
1656176235853,MATH 142A,B03,093481,Staff,3,0,32,29
1656176235853,MATH 142A,B04,093558,Staff,6,0,32,26
1656176235853,MATH 142A,B05,093559,Staff,0,0,32,32
1656176241876,MATH 193A,A01,083224,Rotar; Vladimir,0,1,34,34
1656176241876,MATH 193A,A02,083225,Rotar; Vladimir,0,0,34,34
1656176241876,MATH 193A,A03,083781,Rotar; Vladimir,0,0,34,34
1656176241876,MATH 193A,A04,083782,Rotar; Vladimir,6,0,34,28
1656176241876,MATH 193A,A05,093482,Rotar; Vladimir,1,0,34,33
1656176247901,MATH 197,001,091859,McAuley; Julian John,9999,0,9999,0
1656176247901,MATH 197,002,095566,Kedlaya; Kiran S.,9997,0,9999,2
1656176247901,MATH 197,003,095567,Xiao; Ming,9999,0,9999,0
1656176247901,MATH 197,004,095571,Perols; Johan Lars,9998,0,9999,1
1656176254973,COGS 9,A01,083615,Shannon; Kyle Michael,4,0,75,71
1656176261002,COGS 11,A01,083617,Boyle; Mary E. T.,14,0,48,34
1656176267025,COGS 13,A01,083071,Bastos; Amalia Pinkusfeld,5,0,71,66
1656176273050,COGS 14A,A01,092681,Semenuks; Arturs,4,15,100,96
1656176279082,COGS 14B,A01,083073,Cheng; Tzu-Han,7,0,63,56
1656176285105,COGS 17,A01,092677,Semenuks; Arturs,7,0,81,74
1656176291130,COGS 100,A01,083619,Allen; Michael Gordon,2,0,70,68
1656176297155,COGS 101A,A01,083621,Davis; Joshua Daniel,4,0,68,64
1656176303183,COGS 101B,A01,091572,Allen; Michael Gordon,5,0,65,60
1656176309212,COGS 101C,A01,083625,Delgado; Tania,10,0,35,25
1656176315239,COGS 107A,A01,083627,Boyle; Mary E. T.,0,0,60,60
1656176321262,COGS 118A,A01,083075,Gupta; Anjum,7,0,76,69
1656176327286,CSE 3,A50,083646,Miranda; Gregory Joseph,18,0,50,32
1656176333318,CSE 8A,A50,083650,Miranda; Gregory Joseph,3,3,56,53
1656176339342,CSE 11,A01,083080,Cao; Yingjun,1,54,40,39
1656176345368,CSE 12,A01,083652,Krause-Levy; Sophia Louisa,7,2,120,113
1656176351395,CSE 15L,A01,083654,Morris; Justin Loren,2,0,50,48
1656176351395,CSE 15L,A02,083655,Morris; Justin Loren,4,0,50,46
1656176357421,CSE 20,A01,083657,Tran; Khoa Dang,31,0,80,49
1656176363450,CSE 21,A01,095574,Bach; Quang Tran,25,0,48,23
1656176369480,CSE 30,A01,083084,Eldon; John,2,8,80,78
1656176369480,CSE 30,B01,095061,Bhaskar; Nishant,1,2,50,49
1656176375504,CSE 100,A01,083659,Cao; Yingjun,2,20,70,68
1656176381531,CSE 134B,A01,083661,Powell; Thomas Allan,3,0,100,97
1656176387564,CSE 140,A01,083663,Gungor; Onat,9,0,85,76
1656176393590,CSE 140L,A01,083088,Eldon; John,8,0,100,92
1656176399617,CSE 175,A01,083665,Kumar; Rakesh,0,0,25,25
1656176405640,CSE 190,A00,092507,Dubnov; Shlomo,3,0,20,17
1656176411664,ECE 45,A01,083139,Congero; Spencer William,1,0,75,74
1656176417688,ECE 65,A50,083695,Saad; Andrew S,9,0,30,21
1656176417688,ECE 65,A51,095125,Staff,23,0,26,3
1656176423712,ECE 109,A01,091882,Touri; Behrouz,0,1,70,70
1656176429739,ECE 180,A00,083140,Abi Samra; Nicholas Camill,1,0,30,29
1656176429739,ECE 180,B00,083141,Abi Samra; Nicholas Camill,0,4,30,30
1656176435768,MATH 10A,A01,083735,Patchell; Gregory David,0,0,30,30
1656176435768,MATH 10A,A02,083736,Patchell; Gregory David,22,0,30,8
1656176435768,MATH 10A,A03,083737,Patchell; Gregory David,16,0,30,14
1656176441792,MATH 10B,A01,083207,Lim; Seonhee,0,0,34,34
1656176441792,MATH 10B,A02,083208,Lim; Seonhee,7,0,35,28
1656176441792,MATH 10B,A03,093472,Staff,1,0,34,33
1656176441792,MATH 10B,B01,083739,Sinha; Shubham,10,0,30,20
1656176447824,MATH 18,A01,083743,Cinel; Cameron Alexander,7,0,30,23
1656176447824,MATH 18,A02,083744,Cinel; Cameron Alexander,10,0,30,20
1656176447824,MATH 18,A03,083745,Cinel; Cameron Alexander,4,0,30,26
1656176447824,MATH 18,B01,083748,Rideout; David Porter,0,0,36,36
1656176447824,MATH 18,B02,083749,Rideout; David Porter,0,0,36,36
1656176447824,MATH 18,B03,083750,Rideout; David Porter,0,0,36,36
1656176447824,MATH 18,B04,083751,Rideout; David Porter,0,0,36,36
1656176447824,MATH 18,B05,093473,Rideout; David Porter,1,0,36,35
1656176447824,MATH 18,B06,093474,Rideout; David Porter,2,0,36,34
1656176453848,MATH 20A,A01,083754,Zheng; Zequn,11,0,40,29
1656176459871,MATH 20B,A01,083756,Briones; Jor-el Thomas Caparas,0,0,36,36
1656176459871,MATH 20B,A02,083757,Briones; Jor-el Thomas Caparas,0,0,36,36
1656176459871,MATH 20B,A03,093475,Staff,1,0,36,35
1656176465901,MATH 20C,A01,083760,Briones; Jor-el Thomas Caparas,0,0,35,35
1656176465901,MATH 20C,A02,083761,Briones; Jor-el Thomas Caparas,9,1,35,26
1656176465901,MATH 20C,A03,093476,Staff,0,0,35,35
1656176465901,MATH 20C,B01,083762,Bach; Quang Tran,1,0,30,29
1656176471936,MATH 20D,A01,083765,Tran; Brian Kha,1,0,30,29
1656176471936,MATH 20D,A02,083766,Tran; Brian Kha,0,1,30,30
1656176471936,MATH 20D,A03,083767,Tran; Brian Kha,2,0,30,28
1656176477961,MATH 20E,A01,083771,Ganguly; Soumya,4,0,32,28
1656176477961,MATH 20E,A02,083772,Ganguly; Soumya,0,0,32,32
1656176477961,MATH 20E,B01,083773,Ciotti; Benjamin,15,0,35,20
1656176477961,MATH 20E,B02,083774,Ciotti; Benjamin,15,0,35,20
1656176483990,MATH 103A,A01,083777,Greenfeld; Be'Eri,1,0,36,35
1656176483990,MATH 103A,A02,083778,Greenfeld; Be'Eri,1,0,36,35
1656176483990,MATH 103A,A03,093561,Staff,5,0,36,31
1656176483990,MATH 103A,B01,083779,Greenfeld; Be'Eri,8,1,36,28
1656176483990,MATH 103A,B02,083780,Greenfeld; Be'Eri,1,0,36,35
1656176483990,MATH 103A,B03,093562,Staff,0,0,36,36
1656176490024,MATH 105,A01,085443,Carter; Anne Toulson,5,1,35,30
1656176490024,MATH 105,A02,093477,Staff,11,0,35,24
1656176496059,MATH 109,A01,083213,Ganzberger; Geoffrey Michael,0,0,34,34
1656176496059,MATH 109,A02,083214,Ganzberger; Geoffrey Michael,0,0,34,34
1656176496059,MATH 109,A03,093478,Staff,1,0,34,33
1656176496059,MATH 109,B01,083215,Ganzberger; Geoffrey Michael,4,0,32,28
1656176496059,MATH 109,B02,083216,Ganzberger; Geoffrey Michael,1,0,32,31
1656176496059,MATH 109,B03,093479,Staff,4,0,32,28
1656176502083,MATH 142A,A01,083219,Chow; Bennett,1,0,32,31
1656176502083,MATH 142A,A02,083220,Chow; Bennett,8,0,32,24
1656176502083,MATH 142A,A03,093480,Staff,5,0,32,27
1656176502083,MATH 142A,B03,093481,Staff,3,0,32,29
1656176502083,MATH 142A,B04,093558,Staff,6,0,32,26
1656176502083,MATH 142A,B05,093559,Staff,0,0,32,32
1656176508108,MATH 193A,A01,083224,Rotar; Vladimir,0,1,34,34
1656176508108,MATH 193A,A02,083225,Rotar; Vladimir,0,0,34,34
1656176508108,MATH 193A,A03,083781,Rotar; Vladimir,0,0,34,34
1656176508108,MATH 193A,A04,083782,Rotar; Vladimir,6,0,34,28
1656176508108,MATH 193A,A05,093482,Rotar; Vladimir,1,0,34,33
1656176514135,MATH 197,001,091859,McAuley; Julian John,9999,0,9999,0
1656176514135,MATH 197,002,095566,Kedlaya; Kiran S.,9997,0,9999,2
1656176514135,MATH 197,003,095567,Xiao; Ming,9999,0,9999,0
1656176514135,MATH 197,004,095571,Perols; Johan Lars,9998,0,9999,1
1656176521187,COGS 9,A01,083615,Shannon; Kyle Michael,4,0,75,71
1656176527218,COGS 11,A01,083617,Boyle; Mary E. T.,14,0,48,34
1656176533246,COGS 13,A01,083071,Bastos; Amalia Pinkusfeld,5,0,71,66
1656176539274,COGS 14A,A01,092681,Semenuks; Arturs,4,15,100,96
1656176545296,COGS 14B,A01,083073,Cheng; Tzu-Han,7,0,63,56
1656176551320,COGS 17,A01,092677,Semenuks; Arturs,7,0,81,74
1656176557344,COGS 100,A01,083619,Allen; Michael Gordon,2,0,70,68
1656176563375,COGS 101A,A01,083621,Davis; Joshua Daniel,4,0,68,64
1656176569401,COGS 101B,A01,091572,Allen; Michael Gordon,5,0,65,60
1656176575423,COGS 101C,A01,083625,Delgado; Tania,10,0,35,25
1656176581446,COGS 107A,A01,083627,Boyle; Mary E. T.,0,0,60,60
1656176587469,COGS 118A,A01,083075,Gupta; Anjum,7,0,76,69
1656176593491,CSE 3,A50,083646,Miranda; Gregory Joseph,18,0,50,32
1656176599519,CSE 8A,A50,083650,Miranda; Gregory Joseph,3,3,56,53
1656176605546,CSE 11,A01,083080,Cao; Yingjun,1,54,40,39
1656176611578,CSE 12,A01,083652,Krause-Levy; Sophia Louisa,7,2,120,113
1656176617602,CSE 15L,A01,083654,Morris; Justin Loren,2,0,50,48
1656176617602,CSE 15L,A02,083655,Morris; Justin Loren,4,0,50,46
1656176623629,CSE 20,A01,083657,Tran; Khoa Dang,31,0,80,49
1656176629654,CSE 21,A01,095574,Bach; Quang Tran,25,0,48,23
1656176635684,CSE 30,A01,083084,Eldon; John,2,8,80,78
1656176635684,CSE 30,B01,095061,Bhaskar; Nishant,1,2,50,49
1656176641711,CSE 100,A01,083659,Cao; Yingjun,2,20,70,68
1656176647806,CSE 134B,A01,083661,Powell; Thomas Allan,3,0,100,97
1656176653830,CSE 140,A01,083663,Gungor; Onat,9,0,85,76
1656176659853,CSE 140L,A01,083088,Eldon; John,8,0,100,92
1656176665878,CSE 175,A01,083665,Kumar; Rakesh,0,0,25,25
1656176671901,CSE 190,A00,092507,Dubnov; Shlomo,3,0,20,17
1656176677927,ECE 45,A01,083139,Congero; Spencer William,1,0,75,74
1656176683951,ECE 65,A50,083695,Saad; Andrew S,9,0,30,21
1656176683951,ECE 65,A51,095125,Staff,23,0,26,3
1656176689974,ECE 109,A01,091882,Touri; Behrouz,0,1,70,70
1656176695996,ECE 180,A00,083140,Abi Samra; Nicholas Camill,1,0,30,29
1656176695996,ECE 180,B00,083141,Abi Samra; Nicholas Camill,0,4,30,30
1656176702020,MATH 10A,A01,083735,Patchell; Gregory David,0,0,30,30
1656176702020,MATH 10A,A02,083736,Patchell; Gregory David,22,0,30,8
1656176702020,MATH 10A,A03,083737,Patchell; Gregory David,16,0,30,14
1656176708044,MATH 10B,A01,083207,Lim; Seonhee,0,0,34,34
1656176708044,MATH 10B,A02,083208,Lim; Seonhee,7,0,35,28
1656176708044,MATH 10B,A03,093472,Staff,1,0,34,33
1656176708044,MATH 10B,B01,083739,Sinha; Shubham,10,0,30,20
1656176714067,MATH 18,A01,083743,Cinel; Cameron Alexander,7,0,30,23
1656176714067,MATH 18,A02,083744,Cinel; Cameron Alexander,10,0,30,20
1656176714067,MATH 18,A03,083745,Cinel; Cameron Alexander,4,0,30,26
1656176714067,MATH 18,B01,083748,Rideout; David Porter,0,0,36,36
1656176714067,MATH 18,B02,083749,Rideout; David Porter,0,0,36,36
1656176714067,MATH 18,B03,083750,Rideout; David Porter,0,0,36,36
1656176714067,MATH 18,B04,083751,Rideout; David Porter,0,0,36,36
1656176714067,MATH 18,B05,093473,Rideout; David Porter,1,0,36,35
1656176714067,MATH 18,B06,093474,Rideout; David Porter,2,0,36,34
1656176720091,MATH 20A,A01,083754,Zheng; Zequn,11,0,40,29
1656176726116,MATH 20B,A01,083756,Briones; Jor-el Thomas Caparas,0,0,36,36
1656176726116,MATH 20B,A02,083757,Briones; Jor-el Thomas Caparas,0,0,36,36
1656176726116,MATH 20B,A03,093475,Staff,1,0,36,35
1656176732144,MATH 20C,A01,083760,Briones; Jor-el Thomas Caparas,0,0,35,35
1656176732144,MATH 20C,A02,083761,Briones; Jor-el Thomas Caparas,9,1,35,26
1656176732144,MATH 20C,A03,093476,Staff,0,0,35,35
1656176732144,MATH 20C,B01,083762,Bach; Quang Tran,1,0,30,29
1656176738174,MATH 20D,A01,083765,Tran; Brian Kha,1,0,30,29
1656176738174,MATH 20D,A02,083766,Tran; Brian Kha,0,1,30,30
1656176738174,MATH 20D,A03,083767,Tran; Brian Kha,2,0,30,28
1656176744197,MATH 20E,A01,083771,Ganguly; Soumya,4,0,32,28
1656176744197,MATH 20E,A02,083772,Ganguly; Soumya,0,0,32,32
1656176744197,MATH 20E,B01,083773,Ciotti; Benjamin,15,0,35,20
1656176744197,MATH 20E,B02,083774,Ciotti; Benjamin,15,0,35,20
1656176750227,MATH 103A,A01,083777,Greenfeld; Be'Eri,1,0,36,35
1656176750227,MATH 103A,A02,083778,Greenfeld; Be'Eri,1,0,36,35
1656176750227,MATH 103A,A03,093561,Staff,5,0,36,31
1656176750227,MATH 103A,B01,083779,Greenfeld; Be'Eri,8,1,36,28
1656176750227,MATH 103A,B02,083780,Greenfeld; Be'Eri,1,0,36,35
1656176750227,MATH 103A,B03,093562,Staff,0,0,36,36
1656176756249,MATH 105,A01,085443,Carter; Anne Toulson,5,1,35,30
1656176756249,MATH 105,A02,093477,Staff,11,0,35,24
1656176762277,MATH 109,A01,083213,Ganzberger; Geoffrey Michael,0,0,34,34
1656176762277,MATH 109,A02,083214,Ganzberger; Geoffrey Michael,0,0,34,34
1656176762277,MATH 109,A03,093478,Staff,1,0,34,33
1656176762277,MATH 109,B01,083215,Ganzberger; Geoffrey Michael,4,0,32,28
1656176762277,MATH 109,B02,083216,Ganzberger; Geoffrey Michael,1,0,32,31
1656176762277,MATH 109,B03,093479,Staff,4,0,32,28
1656176768307,MATH 142A,A01,083219,Chow; Bennett,1,0,32,31
1656176768307,MATH 142A,A02,083220,Chow; Bennett,8,0,32,24
1656176768307,MATH 142A,A03,093480,Staff,5,0,32,27
1656176768307,MATH 142A,B03,093481,Staff,3,0,32,29
1656176768307,MATH 142A,B04,093558,Staff,6,0,32,26
1656176768307,MATH 142A,B05,093559,Staff,1,0,32,31
1656176774334,MATH 193A,A01,083224,Rotar; Vladimir,0,1,34,34
1656176774334,MATH 193A,A02,083225,Rotar; Vladimir,0,0,34,34
1656176774334,MATH 193A,A03,083781,Rotar; Vladimir,0,0,34,34
1656176774334,MATH 193A,A04,083782,Rotar; Vladimir,6,0,34,28
1656176774334,MATH 193A,A05,093482,Rotar; Vladimir,1,0,34,33
1656176780371,MATH 197,001,091859,McAuley; Julian John,9999,0,9999,0
1656176780371,MATH 197,002,095566,Kedlaya; Kiran S.,9997,0,9999,2
1656176780371,MATH 197,003,095567,Xiao; Ming,9999,0,9999,0
1656176780371,MATH 197,004,095571,Perols; Johan Lars,9998,0,9999,1
1656176787431,COGS 9,A01,083615,Shannon; Kyle Michael,4,0,75,71
1656176793456,COGS 11,A01,083617,Boyle; Mary E. T.,14,0,48,34
1656176799482,COGS 13,A01,083071,Bastos; Amalia Pinkusfeld,5,0,71,66
1656176805510,COGS 14A,A01,092681,Semenuks; Arturs,4,15,100,96
1656176811534,COGS 14B,A01,083073,Cheng; Tzu-Han,7,0,63,56
1656176817558,COGS 17,A01,092677,Semenuks; Arturs,7,0,81,74
1656176823590,COGS 100,A01,083619,Allen; Michael Gordon,2,0,70,68
1656176829613,COGS 101A,A01,083621,Davis; Joshua Daniel,4,0,68,64
1656176835636,COGS 101B,A01,091572,Allen; Michael Gordon,5,0,65,60
1656176841671,COGS 101C,A01,083625,Delgado; Tania,10,0,35,25
1656176847697,COGS 107A,A01,083627,Boyle; Mary E. T.,0,0,60,60
1656176853724,COGS 118A,A01,083075,Gupta; Anjum,7,0,76,69
1656176859766,CSE 3,A50,083646,Miranda; Gregory Joseph,18,0,50,32
1656176865790,CSE 8A,A50,083650,Miranda; Gregory Joseph,3,3,56,53
1656176871836,CSE 11,A01,083080,Cao; Yingjun,1,54,40,39
1656176877861,CSE 12,A01,083652,Krause-Levy; Sophia Louisa,7,3,120,113
1656176883887,CSE 15L,A01,083654,Morris; Justin Loren,2,0,50,48
1656176883887,CSE 15L,A02,083655,Morris; Justin Loren,4,0,50,46
1656176889917,CSE 20,A01,083657,Tran; Khoa Dang,31,0,80,49
1656176895941,CSE 21,A01,095574,Bach; Quang Tran,25,0,48,23
1656176901967,CSE 30,A01,083084,Eldon; John,2,8,80,78
1656176901967,CSE 30,B01,095061,Bhaskar; Nishant,1,2,50,49
1656176907998,CSE 100,A01,083659,Cao; Yingjun,2,20,70,68
1656176914022,CSE 134B,A01,083661,Powell; Thomas Allan,3,0,100,97
1656176920045,CSE 140,A01,083663,Gungor; Onat,9,0,85,76
1656176926069,CSE 140L,A01,083088,Eldon; John,8,0,100,92
1656176932097,CSE 175,A01,083665,Kumar; Rakesh,0,0,25,25
1656176938121,CSE 190,A00,092507,Dubnov; Shlomo,3,0,20,17
1656176944144,ECE 45,A01,083139,Congero; Spencer William,1,0,75,74
1656176950172,ECE 65,A50,083695,Saad; Andrew S,9,0,30,21
1656176950172,ECE 65,A51,095125,Staff,23,0,26,3
1656176956195,ECE 109,A01,091882,Touri; Behrouz,0,1,70,70
1656176962219,ECE 180,A00,083140,Abi Samra; Nicholas Camill,1,0,30,29
1656176962219,ECE 180,B00,083141,Abi Samra; Nicholas Camill,0,4,30,30
1656176968247,MATH 10A,A01,083735,Patchell; Gregory David,0,0,30,30
1656176968247,MATH 10A,A02,083736,Patchell; Gregory David,22,0,30,8
1656176968247,MATH 10A,A03,083737,Patchell; Gregory David,16,0,30,14
1656176974271,MATH 10B,A01,083207,Lim; Seonhee,0,0,34,34
1656176974271,MATH 10B,A02,083208,Lim; Seonhee,7,0,35,28
1656176974271,MATH 10B,A03,093472,Staff,1,0,34,33
1656176974271,MATH 10B,B01,083739,Sinha; Shubham,10,0,30,20
1656176980302,MATH 18,A01,083743,Cinel; Cameron Alexander,7,0,30,23
1656176980302,MATH 18,A02,083744,Cinel; Cameron Alexander,10,0,30,20
1656176980302,MATH 18,A03,083745,Cinel; Cameron Alexander,4,0,30,26
1656176980302,MATH 18,B01,083748,Rideout; David Porter,0,0,36,36
1656176980302,MATH 18,B02,083749,Rideout; David Porter,0,0,36,36
1656176980302,MATH 18,B03,083750,Rideout; David Porter,0,0,36,36
1656176980302,MATH 18,B04,083751,Rideout; David Porter,0,0,36,36
1656176980302,MATH 18,B05,093473,Rideout; David Porter,1,0,36,35
1656176980302,MATH 18,B06,093474,Rideout; David Porter,2,0,36,34
1656176986325,MATH 20A,A01,083754,Zheng; Zequn,11,0,40,29
1656176992351,MATH 20B,A01,083756,Briones; Jor-el Thomas Caparas,0,0,36,36
1656176992351,MATH 20B,A02,083757,Briones; Jor-el Thomas Caparas,0,0,36,36
1656176992351,MATH 20B,A03,093475,Staff,1,0,36,35
1656176998372,MATH 20C,A01,083760,Briones; Jor-el Thomas Caparas,0,0,35,35
1656176998372,MATH 20C,A02,083761,Briones; Jor-el Thomas Caparas,9,1,35,26
1656176998372,MATH 20C,A03,093476,Staff,0,0,35,35
1656176998372,MATH 20C,B01,083762,Bach; Quang Tran,1,0,30,29
1656177004401,MATH 20D,A01,083765,Tran; Brian Kha,1,0,30,29
1656177004401,MATH 20D,A02,083766,Tran; Brian Kha,0,1,30,30
1656177004401,MATH 20D,A03,083767,Tran; Brian Kha,2,0,30,28
1656177010435,MATH 20E,A01,083771,Ganguly; Soumya,4,0,32,28
1656177010435,MATH 20E,A02,083772,Ganguly; Soumya,0,0,32,32
1656177010435,MATH 20E,B01,083773,Ciotti; Benjamin,15,0,35,20
1656177010435,MATH 20E,B02,083774,Ciotti; Benjamin,15,0,35,20
1656177016458,MATH 103A,A01,083777,Greenfeld; Be'Eri,1,0,36,35
1656177016458,MATH 103A,A02,083778,Greenfeld; Be'Eri,1,0,36,35
1656177016458,MATH 103A,A03,093561,Staff,5,0,36,31
1656177016458,MATH 103A,B01,083779,Greenfeld; Be'Eri,8,1,36,28
1656177016458,MATH 103A,B02,083780,Greenfeld; Be'Eri,1,0,36,35
1656177016458,MATH 103A,B03,093562,Staff,0,0,36,36
1656177022482,MATH 105,A01,085443,Carter; Anne Toulson,5,1,35,30
1656177022482,MATH 105,A02,093477,Staff,11,0,35,24
1656177028507,MATH 109,A01,083213,Ganzberger; Geoffrey Michael,0,0,34,34
1656177028507,MATH 109,A02,083214,Ganzberger; Geoffrey Michael,0,0,34,34
1656177028507,MATH 109,A03,093478,Staff,1,0,34,33
1656177028507,MATH 109,B01,083215,Ganzberger; Geoffrey Michael,4,0,32,28
1656177028507,MATH 109,B02,083216,Ganzberger; Geoffrey Michael,1,0,32,31
1656177028507,MATH 109,B03,093479,Staff,4,0,32,28
1656177034537,MATH 142A,A01,083219,Chow; Bennett,1,0,32,31
1656177034537,MATH 142A,A02,083220,Chow; Bennett,8,0,32,24
1656177034537,MATH 142A,A03,093480,Staff,5,0,32,27
1656177034537,MATH 142A,B03,093481,Staff,3,0,32,29
1656177034537,MATH 142A,B04,093558,Staff,6,0,32,26
1656177034537,MATH 142A,B05,093559,Staff,1,0,32,31
1656177040559,MATH 193A,A01,083224,Rotar; Vladimir,0,1,34,34
1656177040559,MATH 193A,A02,083225,Rotar; Vladimir,0,0,34,34
1656177040559,MATH 193A,A03,083781,Rotar; Vladimir,0,0,34,34
1656177040559,MATH 193A,A04,083782,Rotar; Vladimir,6,0,34,28
1656177040559,MATH 193A,A05,093482,Rotar; Vladimir,1,0,34,33
1656177046586,MATH 197,001,091859,McAuley; Julian John,9999,0,9999,0
1656177046586,MATH 197,002,095566,Kedlaya; Kiran S.,9997,0,9999,2
1656177046586,MATH 197,003,095567,Xiao; Ming,9999,0,9999,0
1656177046586,MATH 197,004,095571,Perols; Johan Lars,9998,0,9999,1
1656177053640,COGS 9,A01,083615,Shannon; Kyle Michael,4,0,75,71
1656177059664,COGS 11,A01,083617,Boyle; Mary E. T.,14,0,48,34
1656177065693,COGS 13,A01,083071,Bastos; Amalia Pinkusfeld,5,0,71,66
1656177071718,COGS 14A,A01,092681,Semenuks; Arturs,4,15,100,96
1656177077739,COGS 14B,A01,083073,Cheng; Tzu-Han,7,0,63,56
1656177083762,COGS 17,A01,092677,Semenuks; Arturs,7,0,81,74
1656177089789,COGS 100,A01,083619,Allen; Michael Gordon,2,0,70,68
1656177095813,COGS 101A,A01,083621,Davis; Joshua Daniel,4,0,68,64
1656177101840,COGS 101B,A01,091572,Allen; Michael Gordon,5,0,65,60
1656177107867,COGS 101C,A01,083625,Delgado; Tania,10,0,35,25
1656177113895,COGS 107A,A01,083627,Boyle; Mary E. T.,0,0,60,60
1656177119918,COGS 118A,A01,083075,Gupta; Anjum,7,0,76,69
1656177125943,CSE 3,A50,083646,Miranda; Gregory Joseph,18,0,50,32
1656177131975,CSE 8A,A50,083650,Miranda; Gregory Joseph,3,3,56,53
1656177138002,CSE 11,A01,083080,Cao; Yingjun,1,54,40,39
1656177144029,CSE 12,A01,083652,Krause-Levy; Sophia Louisa,7,3,120,113
1656177150054,CSE 15L,A01,083654,Morris; Justin Loren,2,0,50,48
1656177150054,CSE 15L,A02,083655,Morris; Justin Loren,4,0,50,46
1656177156081,CSE 20,A01,083657,Tran; Khoa Dang,31,0,80,49
1656177162105,CSE 21,A01,095574,Bach; Quang Tran,25,0,48,23
1656177168130,CSE 30,A01,083084,Eldon; John,2,8,80,78
1656177168130,CSE 30,B01,095061,Bhaskar; Nishant,1,2,50,49
1656177174153,CSE 100,A01,083659,Cao; Yingjun,2,20,70,68
1656177180180,CSE 134B,A01,083661,Powell; Thomas Allan,3,0,100,97
1656177186206,CSE 140,A01,083663,Gungor; Onat,9,0,85,76
1656177192229,CSE 140L,A01,083088,Eldon; John,8,0,100,92
1656177198253,CSE 175,A01,083665,Kumar; Rakesh,0,0,25,25
1656177204276,CSE 190,A00,092507,Dubnov; Shlomo,3,0,20,17
1656177210302,ECE 45,A01,083139,Congero; Spencer William,1,0,75,74
1656177216326,ECE 65,A50,083695,Saad; Andrew S,9,0,30,21
1656177216326,ECE 65,A51,095125,Staff,23,0,26,3
1656177222354,ECE 109,A01,091882,Touri; Behrouz,0,1,70,70
1656177228378,ECE 180,A00,083140,Abi Samra; Nicholas Camill,1,0,30,29
1656177228378,ECE 180,B00,083141,Abi Samra; Nicholas Camill,0,4,30,30
1656177234406,MATH 10A,A01,083735,Patchell; Gregory David,0,0,30,30
1656177234406,MATH 10A,A02,083736,Patchell; Gregory David,22,0,30,8
1656177234406,MATH 10A,A03,083737,Patchell; Gregory David,16,0,30,14
1656177240429,MATH 10B,A01,083207,Lim; Seonhee,0,0,34,34
1656177240429,MATH 10B,A02,083208,Lim; Seonhee,7,0,35,28
1656177240429,MATH 10B,A03,093472,Staff,1,0,34,33
1656177240429,MATH 10B,B01,083739,Sinha; Shubham,10,0,30,20
1656177246552,MATH 18,A01,083743,Cinel; Cameron Alexander,7,0,30,23
1656177246552,MATH 18,A02,083744,Cinel; Cameron Alexander,10,0,30,20
1656177246552,MATH 18,A03,083745,Cinel; Cameron Alexander,4,0,30,26
1656177246552,MATH 18,B01,083748,Rideout; David Porter,0,0,36,36
1656177246552,MATH 18,B02,083749,Rideout; David Porter,0,0,36,36
1656177246552,MATH 18,B03,083750,Rideout; David Porter,0,0,36,36
1656177246552,MATH 18,B04,083751,Rideout; David Porter,0,0,36,36
1656177246552,MATH 18,B05,093473,Rideout; David Porter,1,0,36,35
1656177246552,MATH 18,B06,093474,Rideout; David Porter,2,0,36,34
1656177252579,MATH 20A,A01,083754,Zheng; Zequn,11,0,40,29
1656177258607,MATH 20B,A01,083756,Briones; Jor-el Thomas Caparas,0,0,36,36
1656177258607,MATH 20B,A02,083757,Briones; Jor-el Thomas Caparas,0,0,36,36
1656177258607,MATH 20B,A03,093475,Staff,1,0,36,35
1656177264636,MATH 20C,A01,083760,Briones; Jor-el Thomas Caparas,0,0,35,35
1656177264636,MATH 20C,A02,083761,Briones; Jor-el Thomas Caparas,9,1,35,26
1656177264636,MATH 20C,A03,093476,Staff,0,0,35,35
1656177264636,MATH 20C,B01,083762,Bach; Quang Tran,1,0,30,29
1656177270664,MATH 20D,A01,083765,Tran; Brian Kha,1,0,30,29
1656177270664,MATH 20D,A02,083766,Tran; Brian Kha,0,1,30,30
1656177270664,MATH 20D,A03,083767,Tran; Brian Kha,2,0,30,28
1656177276687,MATH 20E,A01,083771,Ganguly; Soumya,4,0,32,28
1656177276687,MATH 20E,A02,083772,Ganguly; Soumya,0,0,32,32
1656177276687,MATH 20E,B01,083773,Ciotti; Benjamin,15,0,35,20
1656177276687,MATH 20E,B02,083774,Ciotti; Benjamin,15,0,35,20
1656177282718,MATH 103A,A01,083777,Greenfeld; Be'Eri,1,0,36,35
1656177282718,MATH 103A,A02,083778,Greenfeld; Be'Eri,1,0,36,35
1656177282718,MATH 103A,A03,093561,Staff,5,0,36,31
1656177282718,MATH 103A,B01,083779,Greenfeld; Be'Eri,8,1,36,28
1656177282718,MATH 103A,B02,083780,Greenfeld; Be'Eri,1,0,36,35
1656177282718,MATH 103A,B03,093562,Staff,0,0,36,36
1656177288743,MATH 105,A01,085443,Carter; Anne Toulson,5,1,35,30
1656177288743,MATH 105,A02,093477,Staff,11,0,35,24
1656177294771,MATH 109,A01,083213,Ganzberger; Geoffrey Michael,0,0,34,34
1656177294771,MATH 109,A02,083214,Ganzberger; Geoffrey Michael,0,0,34,34
1656177294771,MATH 109,A03,093478,Staff,1,0,34,33
1656177294771,MATH 109,B01,083215,Ganzberger; Geoffrey Michael,4,0,32,28
1656177294771,MATH 109,B02,083216,Ganzberger; Geoffrey Michael,1,0,32,31
1656177294771,MATH 109,B03,093479,Staff,4,0,32,28
1656177300795,MATH 142A,A01,083219,Chow; Bennett,1,0,32,31
1656177300795,MATH 142A,A02,083220,Chow; Bennett,8,0,32,24
1656177300795,MATH 142A,A03,093480,Staff,5,0,32,27
1656177300795,MATH 142A,B03,093481,Staff,3,0,32,29
1656177300795,MATH 142A,B04,093558,Staff,6,0,32,26
1656177300795,MATH 142A,B05,093559,Staff,1,0,32,31
1656177306820,MATH 193A,A01,083224,Rotar; Vladimir,0,1,34,34
1656177306820,MATH 193A,A02,083225,Rotar; Vladimir,0,0,34,34
1656177306820,MATH 193A,A03,083781,Rotar; Vladimir,0,0,34,34
1656177306820,MATH 193A,A04,083782,Rotar; Vladimir,6,0,34,28
1656177306820,MATH 193A,A05,093482,Rotar; Vladimir,1,0,34,33
1656177312842,MATH 197,001,091859,McAuley; Julian John,9999,0,9999,0
1656177312842,MATH 197,002,095566,Kedlaya; Kiran S.,9997,0,9999,2
1656177312842,MATH 197,003,095567,Xiao; Ming,9999,0,9999,0
1656177312842,MATH 197,004,095571,Perols; Johan Lars,9998,0,9999,1
1656177319898,COGS 9,A01,083615,Shannon; Kyle Michael,4,0,75,71
1656177325933,COGS 11,A01,083617,Boyle; Mary E. T.,14,0,48,34
1656177331971,COGS 13,A01,083071,Bastos; Amalia Pinkusfeld,5,0,71,66
1656177337998,COGS 14A,A01,092681,Semenuks; Arturs,4,15,100,96
1656177344022,COGS 14B,A01,083073,Cheng; Tzu-Han,7,0,63,56
1656177350045,COGS 17,A01,092677,Semenuks; Arturs,7,0,81,74
1656177356068,COGS 100,A01,083619,Allen; Michael Gordon,2,0,70,68
1656177362091,COGS 101A,A01,083621,Davis; Joshua Daniel,4,0,68,64
1656177368125,COGS 101B,A01,091572,Allen; Michael Gordon,5,0,65,60
1656177374153,COGS 101C,A01,083625,Delgado; Tania,10,0,35,25
1656177380177,COGS 107A,A01,083627,Boyle; Mary E. T.,0,0,60,60
1656177386204,COGS 118A,A01,083075,Gupta; Anjum,7,0,76,69
1656177392229,CSE 3,A50,083646,Miranda; Gregory Joseph,18,0,50,32
1656177398253,CSE 8A,A50,083650,Miranda; Gregory Joseph,3,3,56,53
1656177404281,CSE 11,A01,083080,Cao; Yingjun,1,54,40,39
1656177410304,CSE 12,A01,083652,Krause-Levy; Sophia Louisa,7,3,120,113
1656177416332,CSE 15L,A01,083654,Morris; Justin Loren,2,0,50,48
1656177416332,CSE 15L,A02,083655,Morris; Justin Loren,4,0,50,46
1656177422361,CSE 20,A01,083657,Tran; Khoa Dang,31,0,80,49
1656177428384,CSE 21,A01,095574,Bach; Quang Tran,25,0,48,23
1656177434413,CSE 30,A01,083084,Eldon; John,2,8,80,78
1656177434413,CSE 30,B01,095061,Bhaskar; Nishant,1,2,50,49
1656177440440,CSE 100,A01,083659,Cao; Yingjun,2,20,70,68
1656177446464,CSE 134B,A01,083661,Powell; Thomas Allan,3,0,100,97
1656177452486,CSE 140,A01,083663,Gungor; Onat,9,0,85,76
1656177458513,CSE 140L,A01,083088,Eldon; John,8,0,100,92
1656177464537,CSE 175,A01,083665,Kumar; Rakesh,0,0,25,25
1656177470559,CSE 190,A00,092507,Dubnov; Shlomo,3,0,20,17
1656177476584,ECE 45,A01,083139,Congero; Spencer William,1,0,75,74
1656177482608,ECE 65,A50,083695,Saad; Andrew S,9,0,30,21
1656177482608,ECE 65,A51,095125,Staff,23,0,26,3
1656177488636,ECE 109,A01,091882,Touri; Behrouz,0,1,70,70
1656177494662,ECE 180,A00,083140,Abi Samra; Nicholas Camill,1,0,30,29
1656177494662,ECE 180,B00,083141,Abi Samra; Nicholas Camill,0,4,30,30
1656177500690,MATH 10A,A01,083735,Patchell; Gregory David,0,0,30,30
1656177500690,MATH 10A,A02,083736,Patchell; Gregory David,22,0,30,8
1656177500690,MATH 10A,A03,083737,Patchell; Gregory David,16,0,30,14
1656177506714,MATH 10B,A01,083207,Lim; Seonhee,0,0,34,34
1656177506714,MATH 10B,A02,083208,Lim; Seonhee,7,0,35,28
1656177506714,MATH 10B,A03,093472,Staff,1,0,34,33
1656177506714,MATH 10B,B01,083739,Sinha; Shubham,10,0,30,20
1656177512739,MATH 18,A01,083743,Cinel; Cameron Alexander,7,0,30,23
1656177512739,MATH 18,A02,083744,Cinel; Cameron Alexander,10,0,30,20
1656177512739,MATH 18,A03,083745,Cinel; Cameron Alexander,4,0,30,26
1656177512739,MATH 18,B01,083748,Rideout; David Porter,0,0,36,36
1656177512739,MATH 18,B02,083749,Rideout; David Porter,0,0,36,36
1656177512739,MATH 18,B03,083750,Rideout; David Porter,0,0,36,36
1656177512739,MATH 18,B04,083751,Rideout; David Porter,0,0,36,36
1656177512739,MATH 18,B05,093473,Rideout; David Porter,1,0,36,35
1656177512739,MATH 18,B06,093474,Rideout; David Porter,2,0,36,34
1656177518762,MATH 20A,A01,083754,Zheng; Zequn,11,0,40,29
1656177524786,MATH 20B,A01,083756,Briones; Jor-el Thomas Caparas,0,0,36,36
1656177524786,MATH 20B,A02,083757,Briones; Jor-el Thomas Caparas,0,0,36,36
1656177524786,MATH 20B,A03,093475,Staff,1,0,36,35
1656177530820,MATH 20C,A01,083760,Briones; Jor-el Thomas Caparas,0,0,35,35
1656177530820,MATH 20C,A02,083761,Briones; Jor-el Thomas Caparas,9,1,35,26
1656177530820,MATH 20C,A03,093476,Staff,0,0,35,35
1656177530820,MATH 20C,B01,083762,Bach; Quang Tran,1,0,30,29
1656177536844,MATH 20D,A01,083765,Tran; Brian Kha,1,0,30,29
1656177536844,MATH 20D,A02,083766,Tran; Brian Kha,0,1,30,30
1656177536844,MATH 20D,A03,083767,Tran; Brian Kha,2,0,30,28
1656177542873,MATH 20E,A01,083771,Ganguly; Soumya,3,0,32,29
1656177542873,MATH 20E,A02,083772,Ganguly; Soumya,0,0,32,32
1656177542873,MATH 20E,B01,083773,Ciotti; Benjamin,15,0,35,20
1656177542873,MATH 20E,B02,083774,Ciotti; Benjamin,15,0,35,20
1656177548904,MATH 103A,A01,083777,Greenfeld; Be'Eri,1,0,36,35
1656177548904,MATH 103A,A02,083778,Greenfeld; Be'Eri,1,0,36,35
1656177548904,MATH 103A,A03,093561,Staff,5,0,36,31
1656177548904,MATH 103A,B01,083779,Greenfeld; Be'Eri,8,1,36,28
1656177548904,MATH 103A,B02,083780,Greenfeld; Be'Eri,1,0,36,35
1656177548904,MATH 103A,B03,093562,Staff,0,0,36,36
1656177554938,MATH 105,A01,085443,Carter; Anne Toulson,5,1,35,30
1656177554938,MATH 105,A02,093477,Staff,11,0,35,24
1656177560965,MATH 109,A01,083213,Ganzberger; Geoffrey Michael,0,0,34,34
1656177560965,MATH 109,A02,083214,Ganzberger; Geoffrey Michael,0,0,34,34
1656177560965,MATH 109,A03,093478,Staff,1,0,34,33
1656177560965,MATH 109,B01,083215,Ganzberger; Geoffrey Michael,4,0,32,28
1656177560965,MATH 109,B02,083216,Ganzberger; Geoffrey Michael,1,0,32,31
1656177560965,MATH 109,B03,093479,Staff,4,0,32,28
1656177566995,MATH 142A,A01,083219,Chow; Bennett,1,0,32,31
1656177566995,MATH 142A,A02,083220,Chow; Bennett,8,0,32,24
1656177566995,MATH 142A,A03,093480,Staff,5,0,32,27
1656177566995,MATH 142A,B03,093481,Staff,3,0,32,29
1656177566995,MATH 142A,B04,093558,Staff,6,0,32,26
1656177566995,MATH 142A,B05,093559,Staff,1,0,32,31
1656177573024,MATH 193A,A01,083224,Rotar; Vladimir,0,1,34,34
1656177573024,MATH 193A,A02,083225,Rotar; Vladimir,0,0,34,34
1656177573024,MATH 193A,A03,083781,Rotar; Vladimir,0,0,34,34
1656177573024,MATH 193A,A04,083782,Rotar; Vladimir,6,0,34,28
1656177573024,MATH 193A,A05,093482,Rotar; Vladimir,1,0,34,33
1656177579060,MATH 197,001,091859,McAuley; Julian John,9999,0,9999,0
1656177579060,MATH 197,002,095566,Kedlaya; Kiran S.,9997,0,9999,2
1656177579060,MATH 197,003,095567,Xiao; Ming,9999,0,9999,0
1656177579060,MATH 197,004,095571,Perols; Johan Lars,9998,0,9999,1
1656177586131,COGS 9,A01,083615,Shannon; Kyle Michael,4,0,75,71
1656177592159,COGS 11,A01,083617,Boyle; Mary E. T.,14,0,48,34
1656177598187,COGS 13,A01,083071,Bastos; Amalia Pinkusfeld,5,0,71,66
1656177604214,COGS 14A,A01,092681,Semenuks; Arturs,4,15,100,96
1656177610240,COGS 14B,A01,083073,Cheng; Tzu-Han,7,0,63,56
1656177616268,COGS 17,A01,092677,Semenuks; Arturs,7,0,81,74
1656177622295,COGS 100,A01,083619,Allen; Michael Gordon,2,0,70,68
1656177628319,COGS 101A,A01,083621,Davis; Joshua Daniel,4,0,68,64
1656177634341,COGS 101B,A01,091572,Allen; Michael Gordon,5,0,65,60
1656177640368,COGS 101C,A01,083625,Delgado; Tania,10,0,35,25
1656177646398,COGS 107A,A01,083627,Boyle; Mary E. T.,0,0,60,60
1656177652426,COGS 118A,A01,083075,Gupta; Anjum,7,0,76,69
1656177658450,CSE 3,A50,083646,Miranda; Gregory Joseph,18,0,50,32
1656177664475,CSE 8A,A50,083650,Miranda; Gregory Joseph,3,3,56,53
1656177670497,CSE 11,A01,083080,Cao; Yingjun,1,54,40,39
1656177676527,CSE 12,A01,083652,Krause-Levy; Sophia Louisa,7,3,120,113
1656177682554,CSE 15L,A01,083654,Morris; Justin Loren,2,0,50,48
1656177682554,CSE 15L,A02,083655,Morris; Justin Loren,4,0,50,46
1656177688579,CSE 20,A01,083657,Tran; Khoa Dang,31,0,80,49
1656177694603,CSE 21,A01,095574,Bach; Quang Tran,25,0,48,23
1656177700630,CSE 30,A01,083084,Eldon; John,2,8,80,78
1656177700630,CSE 30,B01,095061,Bhaskar; Nishant,1,2,50,49
1656177706658,CSE 100,A01,083659,Cao; Yingjun,2,20,70,68
1656177712691,CSE 134B,A01,083661,Powell; Thomas Allan,3,0,100,97
1656177718714,CSE 140,A01,083663,Gungor; Onat,9,0,85,76
1656177724737,CSE 140L,A01,083088,Eldon; John,8,0,100,92
1656177730762,CSE 175,A01,083665,Kumar; Rakesh,0,0,25,25
1656177736789,CSE 190,A00,092507,Dubnov; Shlomo,3,0,20,17
1656177742816,ECE 45,A01,083139,Congero; Spencer William,1,0,75,74
1656177748840,ECE 65,A50,083695,Saad; Andrew S,9,0,30,21
1656177748840,ECE 65,A51,095125,Staff,23,0,26,3
1656177754868,ECE 109,A01,091882,Touri; Behrouz,0,1,70,70
1656177760896,ECE 180,A00,083140,Abi Samra; Nicholas Camill,1,0,30,29
1656177760896,ECE 180,B00,083141,Abi Samra; Nicholas Camill,0,4,30,30
1656177766924,MATH 10A,A01,083735,Patchell; Gregory David,0,0,30,30
1656177766924,MATH 10A,A02,083736,Patchell; Gregory David,22,0,30,8
1656177766924,MATH 10A,A03,083737,Patchell; Gregory David,16,0,30,14
1656177772949,MATH 10B,A01,083207,Lim; Seonhee,0,0,34,34
1656177772949,MATH 10B,A02,083208,Lim; Seonhee,7,0,35,28
1656177772949,MATH 10B,A03,093472,Staff,1,0,34,33
1656177772949,MATH 10B,B01,083739,Sinha; Shubham,10,0,30,20
1656177778975,MATH 18,A01,083743,Cinel; Cameron Alexander,7,0,30,23
1656177778975,MATH 18,A02,083744,Cinel; Cameron Alexander,10,0,30,20
1656177778975,MATH 18,A03,083745,Cinel; Cameron Alexander,4,0,30,26
1656177778975,MATH 18,B01,083748,Rideout; David Porter,0,0,36,36
1656177778975,MATH 18,B02,083749,Rideout; David Porter,0,0,36,36
1656177778975,MATH 18,B03,083750,Rideout; David Porter,0,0,36,36
1656177778975,MATH 18,B04,083751,Rideout; David Porter,0,0,36,36
1656177778975,MATH 18,B05,093473,Rideout; David Porter,1,0,36,35
1656177778975,MATH 18,B06,093474,Rideout; David Porter,2,0,36,34
1656177785002,MATH 20A,A01,083754,Zheng; Zequn,11,0,40,29
1656177791025,MATH 20B,A01,083756,Briones; Jor-el Thomas Caparas,0,0,36,36
1656177791025,MATH 20B,A02,083757,Briones; Jor-el Thomas Caparas,0,0,36,36
1656177791025,MATH 20B,A03,093475,Staff,1,0,36,35
1656177797053,MATH 20C,A01,083760,Briones; Jor-el Thomas Caparas,0,0,35,35
1656177797053,MATH 20C,A02,083761,Briones; Jor-el Thomas Caparas,9,1,35,26
1656177797053,MATH 20C,A03,093476,Staff,0,0,35,35
1656177797053,MATH 20C,B01,083762,Bach; Quang Tran,1,0,30,29
1656177803078,MATH 20D,A01,083765,Tran; Brian Kha,1,0,30,29
1656177803078,MATH 20D,A02,083766,Tran; Brian Kha,0,1,30,30
1656177803078,MATH 20D,A03,083767,Tran; Brian Kha,2,0,30,28
1656177809108,MATH 20E,A01,083771,Ganguly; Soumya,3,0,32,29
1656177809108,MATH 20E,A02,083772,Ganguly; Soumya,0,0,32,32
1656177809108,MATH 20E,B01,083773,Ciotti; Benjamin,15,0,35,20
1656177809108,MATH 20E,B02,083774,Ciotti; Benjamin,15,0,35,20
1656177815136,MATH 103A,A01,083777,Greenfeld; Be'Eri,1,0,36,35
1656177815136,MATH 103A,A02,083778,Greenfeld; Be'Eri,1,0,36,35
1656177815136,MATH 103A,A03,093561,Staff,5,0,36,31
1656177815136,MATH 103A,B01,083779,Greenfeld; Be'Eri,8,1,36,28
1656177815136,MATH 103A,B02,083780,Greenfeld; Be'Eri,1,0,36,35
1656177815136,MATH 103A,B03,093562,Staff,0,0,36,36
1656177821169,MATH 105,A01,085443,Carter; Anne Toulson,5,1,35,30
1656177821169,MATH 105,A02,093477,Staff,11,0,35,24
1656177827194,MATH 109,A01,083213,Ganzberger; Geoffrey Michael,0,0,34,34
1656177827194,MATH 109,A02,083214,Ganzberger; Geoffrey Michael,0,0,34,34
1656177827194,MATH 109,A03,093478,Staff,1,0,34,33
1656177827194,MATH 109,B01,083215,Ganzberger; Geoffrey Michael,4,0,32,28
1656177827194,MATH 109,B02,083216,Ganzberger; Geoffrey Michael,1,0,32,31
1656177827194,MATH 109,B03,093479,Staff,4,0,32,28
1656177833225,MATH 142A,A01,083219,Chow; Bennett,1,0,32,31
1656177833225,MATH 142A,A02,083220,Chow; Bennett,8,0,32,24
1656177833225,MATH 142A,A03,093480,Staff,5,0,32,27
1656177833225,MATH 142A,B03,093481,Staff,3,0,32,29
1656177833225,MATH 142A,B04,093558,Staff,6,0,32,26
1656177833225,MATH 142A,B05,093559,Staff,1,0,32,31
1656177839254,MATH 193A,A01,083224,Rotar; Vladimir,0,1,34,34
1656177839254,MATH 193A,A02,083225,Rotar; Vladimir,0,0,34,34
1656177839254,MATH 193A,A03,083781,Rotar; Vladimir,0,0,34,34
1656177839254,MATH 193A,A04,083782,Rotar; Vladimir,6,0,34,28
1656177839254,MATH 193A,A05,093482,Rotar; Vladimir,1,0,34,33
1656177845349,MATH 197,001,091859,McAuley; Julian John,9999,0,9999,0
1656177845349,MATH 197,002,095566,Kedlaya; Kiran S.,9997,0,9999,2
1656177845349,MATH 197,003,095567,Xiao; Ming,9999,0,9999,0
1656177845349,MATH 197,004,095571,Perols; Johan Lars,9998,0,9999,1
1656177852404,COGS 9,A01,083615,Shannon; Kyle Michael,4,0,75,71
1656177858430,COGS 11,A01,083617,Boyle; Mary E. T.,14,0,48,34
1656177864461,COGS 13,A01,083071,Bastos; Amalia Pinkusfeld,5,0,71,66
1656177870483,COGS 14A,A01,092681,Semenuks; Arturs,4,15,100,96
1656177876507,COGS 14B,A01,083073,Cheng; Tzu-Han,7,0,63,56
1656177882542,COGS 17,A01,092677,Semenuks; Arturs,7,0,81,74
1656177888565,COGS 100,A01,083619,Allen; Michael Gordon,2,0,70,68
1656177894592,COGS 101A,A01,083621,Davis; Joshua Daniel,4,0,68,64
1656177900626,COGS 101B,A01,091572,Allen; Michael Gordon,5,0,65,60
1656177906649,COGS 101C,A01,083625,Delgado; Tania,10,0,35,25
1656177912672,COGS 107A,A01,083627,Boyle; Mary E. T.,0,0,60,60
1656177918695,COGS 118A,A01,083075,Gupta; Anjum,7,0,76,69
1656177924723,CSE 3,A50,083646,Miranda; Gregory Joseph,18,0,50,32
1656177930751,CSE 8A,A50,083650,Miranda; Gregory Joseph,3,3,56,53
1656177936778,CSE 11,A01,083080,Cao; Yingjun,1,54,40,39
1656177942804,CSE 12,A01,083652,Krause-Levy; Sophia Louisa,7,3,120,113
1656177948827,CSE 15L,A01,083654,Morris; Justin Loren,2,0,50,48
1656177948827,CSE 15L,A02,083655,Morris; Justin Loren,4,0,50,46
1656177954853,CSE 20,A01,083657,Tran; Khoa Dang,31,0,80,49
1656177960886,CSE 21,A01,095574,Bach; Quang Tran,25,0,48,23
1656177966914,CSE 30,A01,083084,Eldon; John,2,8,80,78
1656177966914,CSE 30,B01,095061,Bhaskar; Nishant,1,2,50,49
1656177972940,CSE 100,A01,083659,Cao; Yingjun,2,20,70,68
1656177978964,CSE 134B,A01,083661,Powell; Thomas Allan,3,0,100,97
1656177984987,CSE 140,A01,083663,Gungor; Onat,9,0,85,76
1656177991011,CSE 140L,A01,083088,Eldon; John,8,0,100,92
1656177997036,CSE 175,A01,083665,Kumar; Rakesh,0,0,25,25
1656178003062,CSE 190,A00,092507,Dubnov; Shlomo,3,0,20,17
1656178009086,ECE 45,A01,083139,Congero; Spencer William,1,0,75,74
1656178015113,ECE 65,A50,083695,Saad; Andrew S,9,0,30,21
1656178015113,ECE 65,A51,095125,Staff,23,0,26,3
1656178021139,ECE 109,A01,091882,Touri; Behrouz,0,1,70,70
1656178027165,ECE 180,A00,083140,Abi Samra; Nicholas Camill,1,0,30,29
1656178027165,ECE 180,B00,083141,Abi Samra; Nicholas Camill,0,4,30,30
1656178033192,MATH 10A,A01,083735,Patchell; Gregory David,0,0,30,30
1656178033192,MATH 10A,A02,083736,Patchell; Gregory David,22,0,30,8
1656178033192,MATH 10A,A03,083737,Patchell; Gregory David,16,0,30,14
1656178039224,MATH 10B,A01,083207,Lim; Seonhee,0,0,34,34
1656178039224,MATH 10B,A02,083208,Lim; Seonhee,7,0,35,28
1656178039224,MATH 10B,A03,093472,Staff,1,0,34,33
1656178039224,MATH 10B,B01,083739,Sinha; Shubham,10,0,30,20
1656178045250,MATH 18,A01,083743,Cinel; Cameron Alexander,7,0,30,23
1656178045250,MATH 18,A02,083744,Cinel; Cameron Alexander,10,0,30,20
1656178045250,MATH 18,A03,083745,Cinel; Cameron Alexander,4,0,30,26
1656178045250,MATH 18,B01,083748,Rideout; David Porter,0,0,36,36
1656178045250,MATH 18,B02,083749,Rideout; David Porter,0,0,36,36
1656178045250,MATH 18,B03,083750,Rideout; David Porter,0,0,36,36
1656178045250,MATH 18,B04,083751,Rideout; David Porter,0,0,36,36
1656178045250,MATH 18,B05,093473,Rideout; David Porter,1,0,36,35
1656178045250,MATH 18,B06,093474,Rideout; David Porter,2,0,36,34
1656178051278,MATH 20A,A01,083754,Zheng; Zequn,11,0,40,29
1656178057305,MATH 20B,A01,083756,Briones; Jor-el Thomas Caparas,0,0,36,36
1656178057305,MATH 20B,A02,083757,Briones; Jor-el Thomas Caparas,0,0,36,36
1656178057305,MATH 20B,A03,093475,Staff,1,0,36,35
1656178063334,MATH 20C,A01,083760,Briones; Jor-el Thomas Caparas,0,0,35,35
1656178063334,MATH 20C,A02,083761,Briones; Jor-el Thomas Caparas,9,1,35,26
1656178063334,MATH 20C,A03,093476,Staff,0,0,35,35
1656178063334,MATH 20C,B01,083762,Bach; Quang Tran,1,0,30,29
1656178069363,MATH 20D,A01,083765,Tran; Brian Kha,1,0,30,29
1656178069363,MATH 20D,A02,083766,Tran; Brian Kha,0,1,30,30
1656178069363,MATH 20D,A03,083767,Tran; Brian Kha,2,0,30,28
1656178075392,MATH 20E,A01,083771,Ganguly; Soumya,3,0,32,29
1656178075392,MATH 20E,A02,083772,Ganguly; Soumya,0,0,32,32
1656178075392,MATH 20E,B01,083773,Ciotti; Benjamin,15,0,35,20
1656178075392,MATH 20E,B02,083774,Ciotti; Benjamin,15,0,35,20
1656178081420,MATH 103A,A01,083777,Greenfeld; Be'Eri,1,0,36,35
1656178081420,MATH 103A,A02,083778,Greenfeld; Be'Eri,1,0,36,35
1656178081420,MATH 103A,A03,093561,Staff,5,0,36,31
1656178081420,MATH 103A,B01,083779,Greenfeld; Be'Eri,8,1,36,28
1656178081420,MATH 103A,B02,083780,Greenfeld; Be'Eri,1,0,36,35
1656178081420,MATH 103A,B03,093562,Staff,0,0,36,36
1656178087447,MATH 105,A01,085443,Carter; Anne Toulson,5,1,35,30
1656178087447,MATH 105,A02,093477,Staff,11,0,35,24
1656178093470,MATH 109,A01,083213,Ganzberger; Geoffrey Michael,0,0,34,34
1656178093470,MATH 109,A02,083214,Ganzberger; Geoffrey Michael,0,0,34,34
1656178093470,MATH 109,A03,093478,Staff,1,0,34,33
1656178093470,MATH 109,B01,083215,Ganzberger; Geoffrey Michael,4,0,32,28
1656178093470,MATH 109,B02,083216,Ganzberger; Geoffrey Michael,1,0,32,31
1656178093470,MATH 109,B03,093479,Staff,4,0,32,28
1656178099498,MATH 142A,A01,083219,Chow; Bennett,1,0,32,31
1656178099498,MATH 142A,A02,083220,Chow; Bennett,8,0,32,24
1656178099498,MATH 142A,A03,093480,Staff,5,0,32,27
1656178099498,MATH 142A,B03,093481,Staff,3,0,32,29
1656178099498,MATH 142A,B04,093558,Staff,6,0,32,26
1656178099498,MATH 142A,B05,093559,Staff,1,0,32,31
1656178105522,MATH 193A,A01,083224,Rotar; Vladimir,0,1,34,34
1656178105522,MATH 193A,A02,083225,Rotar; Vladimir,0,0,34,34
1656178105522,MATH 193A,A03,083781,Rotar; Vladimir,0,0,34,34
1656178105522,MATH 193A,A04,083782,Rotar; Vladimir,6,0,34,28
1656178105522,MATH 193A,A05,093482,Rotar; Vladimir,1,0,34,33
1656178111549,MATH 197,001,091859,McAuley; Julian John,9999,0,9999,0
1656178111549,MATH 197,002,095566,Kedlaya; Kiran S.,9997,0,9999,2
1656178111549,MATH 197,003,095567,Xiao; Ming,9999,0,9999,0
1656178111549,MATH 197,004,095571,Perols; Johan Lars,9998,0,9999,1
1656178118612,COGS 9,A01,083615,Shannon; Kyle Michael,4,0,75,71
1656178124639,COGS 11,A01,083617,Boyle; Mary E. T.,14,0,48,34
1656178130666,COGS 13,A01,083071,Bastos; Amalia Pinkusfeld,5,0,71,66
1656178136691,COGS 14A,A01,092681,Semenuks; Arturs,4,15,100,96
1656178142728,COGS 14B,A01,083073,Cheng; Tzu-Han,7,0,63,56
1656178148751,COGS 17,A01,092677,Semenuks; Arturs,7,0,81,74
1656178154775,COGS 100,A01,083619,Allen; Michael Gordon,2,0,70,68
1656178160799,COGS 101A,A01,083621,Davis; Joshua Daniel,4,0,68,64
1656178166821,COGS 101B,A01,091572,Allen; Michael Gordon,5,0,65,60
1656178172845,COGS 101C,A01,083625,Delgado; Tania,10,0,35,25
1656178178871,COGS 107A,A01,083627,Boyle; Mary E. T.,0,0,60,60
1656178184898,COGS 118A,A01,083075,Gupta; Anjum,7,0,76,69
1656178190922,CSE 3,A50,083646,Miranda; Gregory Joseph,18,0,50,32
1656178196946,CSE 8A,A50,083650,Miranda; Gregory Joseph,3,3,56,53
1656178202973,CSE 11,A01,083080,Cao; Yingjun,1,54,40,39
1656178209000,CSE 12,A01,083652,Krause-Levy; Sophia Louisa,7,3,120,113
1656178215024,CSE 15L,A01,083654,Morris; Justin Loren,2,0,50,48
1656178215024,CSE 15L,A02,083655,Morris; Justin Loren,4,0,50,46
1656178221048,CSE 20,A01,083657,Tran; Khoa Dang,31,0,80,49
1656178227071,CSE 21,A01,095574,Bach; Quang Tran,25,0,48,23
1656178233100,CSE 30,A01,083084,Eldon; John,2,8,80,78
1656178233100,CSE 30,B01,095061,Bhaskar; Nishant,1,2,50,49
1656178239139,CSE 100,A01,083659,Cao; Yingjun,2,20,70,68
1656178245164,CSE 134B,A01,083661,Powell; Thomas Allan,3,0,100,97
1656178251186,CSE 140,A01,083663,Gungor; Onat,9,0,85,76
1656178257209,CSE 140L,A01,083088,Eldon; John,8,0,100,92
1656178263233,CSE 175,A01,083665,Kumar; Rakesh,0,0,25,25
1656178269265,CSE 190,A00,092507,Dubnov; Shlomo,3,0,20,17
1656178275289,ECE 45,A01,083139,Congero; Spencer William,1,0,75,74
1656178281316,ECE 65,A50,083695,Saad; Andrew S,9,0,30,21
1656178281316,ECE 65,A51,095125,Staff,23,0,26,3
1656178287344,ECE 109,A01,091882,Touri; Behrouz,0,1,70,70
1656178293370,ECE 180,A00,083140,Abi Samra; Nicholas Camill,1,0,30,29
1656178293370,ECE 180,B00,083141,Abi Samra; Nicholas Camill,0,4,30,30
1656178299398,MATH 10A,A01,083735,Patchell; Gregory David,0,0,30,30
1656178299398,MATH 10A,A02,083736,Patchell; Gregory David,22,0,30,8
1656178299398,MATH 10A,A03,083737,Patchell; Gregory David,16,0,30,14
1656178305438,MATH 10B,A01,083207,Lim; Seonhee,0,0,34,34
1656178305438,MATH 10B,A02,083208,Lim; Seonhee,7,0,35,28
1656178305438,MATH 10B,A03,093472,Staff,1,0,34,33
1656178305438,MATH 10B,B01,083739,Sinha; Shubham,10,0,30,20
1656178311463,MATH 18,A01,083743,Cinel; Cameron Alexander,7,0,30,23
1656178311463,MATH 18,A02,083744,Cinel; Cameron Alexander,10,0,30,20
1656178311463,MATH 18,A03,083745,Cinel; Cameron Alexander,4,0,30,26
1656178311463,MATH 18,B01,083748,Rideout; David Porter,0,0,36,36
1656178311463,MATH 18,B02,083749,Rideout; David Porter,0,0,36,36
1656178311463,MATH 18,B03,083750,Rideout; David Porter,0,0,36,36
1656178311463,MATH 18,B04,083751,Rideout; David Porter,0,0,36,36
1656178311463,MATH 18,B05,093473,Rideout; David Porter,1,0,36,35
1656178311463,MATH 18,B06,093474,Rideout; David Porter,2,0,36,34
1656178317486,MATH 20A,A01,083754,Zheng; Zequn,11,0,40,29
1656178323509,MATH 20B,A01,083756,Briones; Jor-el Thomas Caparas,0,0,36,36
1656178323509,MATH 20B,A02,083757,Briones; Jor-el Thomas Caparas,0,0,36,36
1656178323509,MATH 20B,A03,093475,Staff,1,0,36,35
1656178329546,MATH 20C,A01,083760,Briones; Jor-el Thomas Caparas,0,0,35,35
1656178329546,MATH 20C,A02,083761,Briones; Jor-el Thomas Caparas,9,1,35,26
1656178329546,MATH 20C,A03,093476,Staff,0,0,35,35
1656178329546,MATH 20C,B01,083762,Bach; Quang Tran,1,0,30,29
1656178335573,MATH 20D,A01,083765,Tran; Brian Kha,1,0,30,29
1656178335573,MATH 20D,A02,083766,Tran; Brian Kha,0,1,30,30
1656178335573,MATH 20D,A03,083767,Tran; Brian Kha,2,0,30,28
1656178341609,MATH 20E,A01,083771,Ganguly; Soumya,3,0,32,29
1656178341609,MATH 20E,A02,083772,Ganguly; Soumya,0,0,32,32
1656178341609,MATH 20E,B01,083773,Ciotti; Benjamin,15,0,35,20
1656178341609,MATH 20E,B02,083774,Ciotti; Benjamin,15,0,35,20
1656178347639,MATH 103A,A01,083777,Greenfeld; Be'Eri,1,0,36,35
1656178347639,MATH 103A,A02,083778,Greenfeld; Be'Eri,1,0,36,35
1656178347639,MATH 103A,A03,093561,Staff,5,0,36,31
1656178347639,MATH 103A,B01,083779,Greenfeld; Be'Eri,8,1,36,28
1656178347639,MATH 103A,B02,083780,Greenfeld; Be'Eri,1,0,36,35
1656178347639,MATH 103A,B03,093562,Staff,0,0,36,36
1656178353662,MATH 105,A01,085443,Carter; Anne Toulson,5,1,35,30
1656178353662,MATH 105,A02,093477,Staff,11,0,35,24
1656178359687,MATH 109,A01,083213,Ganzberger; Geoffrey Michael,0,0,34,34
1656178359687,MATH 109,A02,083214,Ganzberger; Geoffrey Michael,0,0,34,34
1656178359687,MATH 109,A03,093478,Staff,1,0,34,33
1656178359687,MATH 109,B01,083215,Ganzberger; Geoffrey Michael,4,0,32,28
1656178359687,MATH 109,B02,083216,Ganzberger; Geoffrey Michael,1,0,32,31
1656178359687,MATH 109,B03,093479,Staff,4,0,32,28
1656178365715,MATH 142A,A01,083219,Chow; Bennett,1,0,32,31
1656178365715,MATH 142A,A02,083220,Chow; Bennett,8,0,32,24
1656178365715,MATH 142A,A03,093480,Staff,5,0,32,27
1656178365715,MATH 142A,B03,093481,Staff,3,0,32,29
1656178365715,MATH 142A,B04,093558,Staff,6,0,32,26
1656178365715,MATH 142A,B05,093559,Staff,1,0,32,31
1656178371745,MATH 193A,A01,083224,Rotar; Vladimir,0,1,34,34
1656178371745,MATH 193A,A02,083225,Rotar; Vladimir,0,0,34,34
1656178371745,MATH 193A,A03,083781,Rotar; Vladimir,0,0,34,34
1656178371745,MATH 193A,A04,083782,Rotar; Vladimir,6,0,34,28
1656178371745,MATH 193A,A05,093482,Rotar; Vladimir,1,0,34,33
1656178377771,MATH 197,001,091859,McAuley; Julian John,9999,0,9999,0
1656178377771,MATH 197,002,095566,Kedlaya; Kiran S.,9997,0,9999,2
1656178377771,MATH 197,003,095567,Xiao; Ming,9999,0,9999,0
1656178377771,MATH 197,004,095571,Perols; Johan Lars,9998,0,9999,1
1656178384822,COGS 9,A01,083615,Shannon; Kyle Michael,4,0,75,71
1656178390845,COGS 11,A01,083617,Boyle; Mary E. T.,14,0,48,34
1656178396871,COGS 13,A01,083071,Bastos; Amalia Pinkusfeld,5,0,71,66
1656178402895,COGS 14A,A01,092681,Semenuks; Arturs,4,15,100,96
1656178408920,COGS 14B,A01,083073,Cheng; Tzu-Han,7,0,63,56
1656178414942,COGS 17,A01,092677,Semenuks; Arturs,7,0,81,74
1656178420966,COGS 100,A01,083619,Allen; Michael Gordon,2,0,70,68
1656178426999,COGS 101A,A01,083621,Davis; Joshua Daniel,4,0,68,64
1656178433021,COGS 101B,A01,091572,Allen; Michael Gordon,5,0,65,60
1656178439136,COGS 101C,A01,083625,Delgado; Tania,10,0,35,25
1656178445163,COGS 107A,A01,083627,Boyle; Mary E. T.,0,0,60,60
1656178451190,COGS 118A,A01,083075,Gupta; Anjum,7,0,76,69
1656178457213,CSE 3,A50,083646,Miranda; Gregory Joseph,18,0,50,32
1656178463236,CSE 8A,A50,083650,Miranda; Gregory Joseph,3,3,56,53
1656178469259,CSE 11,A01,083080,Cao; Yingjun,1,54,40,39
1656178475287,CSE 12,A01,083652,Krause-Levy; Sophia Louisa,7,3,120,113
1656178481313,CSE 15L,A01,083654,Morris; Justin Loren,2,0,50,48
1656178481313,CSE 15L,A02,083655,Morris; Justin Loren,4,0,50,46
1656178491436,CSE 20,A01,083657,Tran; Khoa Dang,31,0,80,49
1656178497464,CSE 21,A01,095574,Bach; Quang Tran,25,0,48,23
1656178503488,CSE 30,A01,083084,Eldon; John,2,8,80,78
1656178503488,CSE 30,B01,095061,Bhaskar; Nishant,1,2,50,49
1656178509515,CSE 100,A01,083659,Cao; Yingjun,2,20,70,68
1656178515542,CSE 134B,A01,083661,Powell; Thomas Allan,3,0,100,97
1656178521568,CSE 140,A01,083663,Gungor; Onat,9,0,85,76
1656178527593,CSE 140L,A01,083088,Eldon; John,8,0,100,92
1656178533616,CSE 175,A01,083665,Kumar; Rakesh,0,0,25,25
1656178539643,CSE 190,A00,092507,Dubnov; Shlomo,3,0,20,17
1656178545669,ECE 45,A01,083139,Congero; Spencer William,1,0,75,74
1656178551693,ECE 65,A50,083695,Saad; Andrew S,9,0,30,21
1656178551693,ECE 65,A51,095125,Staff,23,0,26,3
1656178557721,ECE 109,A01,091882,Touri; Behrouz,0,1,70,70
1656178563747,ECE 180,A00,083140,Abi Samra; Nicholas Camill,1,0,30,29
1656178563747,ECE 180,B00,083141,Abi Samra; Nicholas Camill,0,4,30,30
1656178569771,MATH 10A,A01,083735,Patchell; Gregory David,0,0,30,30
1656178569771,MATH 10A,A02,083736,Patchell; Gregory David,22,0,30,8
1656178569771,MATH 10A,A03,083737,Patchell; Gregory David,16,0,30,14
1656178575800,MATH 10B,A01,083207,Lim; Seonhee,0,0,34,34
1656178575800,MATH 10B,A02,083208,Lim; Seonhee,7,0,35,28
1656178575800,MATH 10B,A03,093472,Staff,1,0,34,33
1656178575800,MATH 10B,B01,083739,Sinha; Shubham,10,0,30,20
1656178581824,MATH 18,A01,083743,Cinel; Cameron Alexander,7,0,30,23
1656178581824,MATH 18,A02,083744,Cinel; Cameron Alexander,10,0,30,20
1656178581824,MATH 18,A03,083745,Cinel; Cameron Alexander,4,0,30,26
1656178581824,MATH 18,B01,083748,Rideout; David Porter,0,0,36,36
1656178581824,MATH 18,B02,083749,Rideout; David Porter,0,0,36,36
1656178581824,MATH 18,B03,083750,Rideout; David Porter,0,0,36,36
1656178581824,MATH 18,B04,083751,Rideout; David Porter,0,0,36,36
1656178581824,MATH 18,B05,093473,Rideout; David Porter,1,0,36,35
1656178581824,MATH 18,B06,093474,Rideout; David Porter,2,0,36,34
1656178587848,MATH 20A,A01,083754,Zheng; Zequn,11,0,40,29
1656178593873,MATH 20B,A01,083756,Briones; Jor-el Thomas Caparas,0,0,36,36
1656178593873,MATH 20B,A02,083757,Briones; Jor-el Thomas Caparas,0,0,36,36
1656178593873,MATH 20B,A03,093475,Staff,1,0,36,35
1656178599896,MATH 20C,A01,083760,Briones; Jor-el Thomas Caparas,0,0,35,35
1656178599896,MATH 20C,A02,083761,Briones; Jor-el Thomas Caparas,9,1,35,26
1656178599896,MATH 20C,A03,093476,Staff,0,0,35,35
1656178599896,MATH 20C,B01,083762,Bach; Quang Tran,1,0,30,29
1656178605920,MATH 20D,A01,083765,Tran; Brian Kha,1,0,30,29
1656178605920,MATH 20D,A02,083766,Tran; Brian Kha,0,1,30,30
1656178605920,MATH 20D,A03,083767,Tran; Brian Kha,2,0,30,28
1656178611947,MATH 20E,A01,083771,Ganguly; Soumya,3,0,32,29
1656178611947,MATH 20E,A02,083772,Ganguly; Soumya,0,0,32,32
1656178611947,MATH 20E,B01,083773,Ciotti; Benjamin,15,0,35,20
1656178611947,MATH 20E,B02,083774,Ciotti; Benjamin,15,0,35,20
1656178617976,MATH 103A,A01,083777,Greenfeld; Be'Eri,1,0,36,35
1656178617976,MATH 103A,A02,083778,Greenfeld; Be'Eri,1,0,36,35
1656178617976,MATH 103A,A03,093561,Staff,5,0,36,31
1656178617976,MATH 103A,B01,083779,Greenfeld; Be'Eri,8,1,36,28
1656178617976,MATH 103A,B02,083780,Greenfeld; Be'Eri,1,0,36,35
1656178617976,MATH 103A,B03,093562,Staff,0,0,36,36
1656178624005,MATH 105,A01,085443,Carter; Anne Toulson,5,1,35,30
1656178624005,MATH 105,A02,093477,Staff,11,0,35,24
1656178630034,MATH 109,A01,083213,Ganzberger; Geoffrey Michael,0,0,34,34
1656178630034,MATH 109,A02,083214,Ganzberger; Geoffrey Michael,0,0,34,34
1656178630034,MATH 109,A03,093478,Staff,1,0,34,33
1656178630034,MATH 109,B01,083215,Ganzberger; Geoffrey Michael,4,0,32,28
1656178630034,MATH 109,B02,083216,Ganzberger; Geoffrey Michael,1,0,32,31
1656178630034,MATH 109,B03,093479,Staff,4,0,32,28
1656178636058,MATH 142A,A01,083219,Chow; Bennett,1,0,32,31
1656178636058,MATH 142A,A02,083220,Chow; Bennett,8,0,32,24
1656178636058,MATH 142A,A03,093480,Staff,5,0,32,27
1656178636058,MATH 142A,B03,093481,Staff,3,0,32,29
1656178636058,MATH 142A,B04,093558,Staff,6,0,32,26
1656178636058,MATH 142A,B05,093559,Staff,1,0,32,31
1656178642088,MATH 193A,A01,083224,Rotar; Vladimir,0,1,34,34
1656178642088,MATH 193A,A02,083225,Rotar; Vladimir,0,0,34,34
1656178642088,MATH 193A,A03,083781,Rotar; Vladimir,0,0,34,34
1656178642088,MATH 193A,A04,083782,Rotar; Vladimir,6,0,34,28
1656178642088,MATH 193A,A05,093482,Rotar; Vladimir,1,0,34,33
1656178648111,MATH 197,001,091859,McAuley; Julian John,9999,0,9999,0
1656178648111,MATH 197,002,095566,Kedlaya; Kiran S.,9997,0,9999,2
1656178648111,MATH 197,003,095567,Xiao; Ming,9999,0,9999,0
1656178648111,MATH 197,004,095571,Perols; Johan Lars,9998,0,9999,1
1656178655166,COGS 9,A01,083615,Shannon; Kyle Michael,4,0,75,71
1656178661188,COGS 11,A01,083617,Boyle; Mary E. T.,14,0,48,34
1656178667212,COGS 13,A01,083071,Bastos; Amalia Pinkusfeld,5,0,71,66
1656178673239,COGS 14A,A01,092681,Semenuks; Arturs,4,15,100,96
1656178679268,COGS 14B,A01,083073,Cheng; Tzu-Han,7,0,63,56
1656178685295,COGS 17,A01,092677,Semenuks; Arturs,7,0,81,74
1656178691319,COGS 100,A01,083619,Allen; Michael Gordon,2,0,70,68
1656178697340,COGS 101A,A01,083621,Davis; Joshua Daniel,4,0,68,64
1656178703366,COGS 101B,A01,091572,Allen; Michael Gordon,5,0,65,60
1656178709393,COGS 101C,A01,083625,Delgado; Tania,10,0,35,25
1656178715418,COGS 107A,A01,083627,Boyle; Mary E. T.,0,0,60,60
1656178721441,COGS 118A,A01,083075,Gupta; Anjum,7,0,76,69
1656178727468,CSE 3,A50,083646,Miranda; Gregory Joseph,18,0,50,32
1656178733497,CSE 8A,A50,083650,Miranda; Gregory Joseph,3,3,56,53
1656178739522,CSE 11,A01,083080,Cao; Yingjun,1,54,40,39
1656178745552,CSE 12,A01,083652,Krause-Levy; Sophia Louisa,7,3,120,113
1656178751578,CSE 15L,A01,083654,Morris; Justin Loren,2,0,50,48
1656178751578,CSE 15L,A02,083655,Morris; Justin Loren,4,0,50,46
1656178757605,CSE 20,A01,083657,Tran; Khoa Dang,31,0,80,49
1656178763629,CSE 21,A01,095574,Bach; Quang Tran,25,0,48,23
1656178769653,CSE 30,A01,083084,Eldon; John,2,8,80,78
1656178769653,CSE 30,B01,095061,Bhaskar; Nishant,1,2,50,49
1656178775676,CSE 100,A01,083659,Cao; Yingjun,2,20,70,68
1656178781703,CSE 134B,A01,083661,Powell; Thomas Allan,3,0,100,97
1656178787727,CSE 140,A01,083663,Gungor; Onat,9,0,85,76
1656178793750,CSE 140L,A01,083088,Eldon; John,8,0,100,92
1656178799774,CSE 175,A01,083665,Kumar; Rakesh,0,0,25,25
1656178805799,CSE 190,A00,092507,Dubnov; Shlomo,3,0,20,17
1656178811825,ECE 45,A01,083139,Congero; Spencer William,1,0,75,74
1656178817851,ECE 65,A50,083695,Saad; Andrew S,9,0,30,21
1656178817851,ECE 65,A51,095125,Staff,23,0,26,3
1656178823874,ECE 109,A01,091882,Touri; Behrouz,0,1,70,70
1656178829909,ECE 180,A00,083140,Abi Samra; Nicholas Camill,1,0,30,29
1656178829909,ECE 180,B00,083141,Abi Samra; Nicholas Camill,0,4,30,30
1656178835933,MATH 10A,A01,083735,Patchell; Gregory David,0,0,30,30
1656178835933,MATH 10A,A02,083736,Patchell; Gregory David,22,0,30,8
1656178835933,MATH 10A,A03,083737,Patchell; Gregory David,16,0,30,14
1656178841967,MATH 10B,A01,083207,Lim; Seonhee,0,0,34,34
1656178841967,MATH 10B,A02,083208,Lim; Seonhee,7,0,35,28
1656178841967,MATH 10B,A03,093472,Staff,1,0,34,33
1656178841967,MATH 10B,B01,083739,Sinha; Shubham,10,0,30,20
1656178847992,MATH 18,A01,083743,Cinel; Cameron Alexander,7,0,30,23
1656178847992,MATH 18,A02,083744,Cinel; Cameron Alexander,10,0,30,20
1656178847992,MATH 18,A03,083745,Cinel; Cameron Alexander,4,0,30,26
1656178847992,MATH 18,B01,083748,Rideout; David Porter,0,0,36,36
1656178847992,MATH 18,B02,083749,Rideout; David Porter,0,0,36,36
1656178847992,MATH 18,B03,083750,Rideout; David Porter,0,0,36,36
1656178847992,MATH 18,B04,083751,Rideout; David Porter,0,0,36,36
1656178847992,MATH 18,B05,093473,Rideout; David Porter,1,0,36,35
1656178847992,MATH 18,B06,093474,Rideout; David Porter,2,0,36,34
1656178854015,MATH 20A,A01,083754,Zheng; Zequn,11,0,40,29
1656178860041,MATH 20B,A01,083756,Briones; Jor-el Thomas Caparas,0,0,36,36
1656178860041,MATH 20B,A02,083757,Briones; Jor-el Thomas Caparas,0,0,36,36
1656178860041,MATH 20B,A03,093475,Staff,1,0,36,35
1656178866065,MATH 20C,A01,083760,Briones; Jor-el Thomas Caparas,0,0,35,35
1656178866065,MATH 20C,A02,083761,Briones; Jor-el Thomas Caparas,9,1,35,26
1656178866065,MATH 20C,A03,093476,Staff,0,0,35,35
1656178866065,MATH 20C,B01,083762,Bach; Quang Tran,1,0,30,29
1656178872093,MATH 20D,A01,083765,Tran; Brian Kha,1,0,30,29
1656178872093,MATH 20D,A02,083766,Tran; Brian Kha,0,1,30,30
1656178872093,MATH 20D,A03,083767,Tran; Brian Kha,2,0,30,28
1656178878119,MATH 20E,A01,083771,Ganguly; Soumya,3,0,32,29
1656178878119,MATH 20E,A02,083772,Ganguly; Soumya,0,0,32,32
1656178878119,MATH 20E,B01,083773,Ciotti; Benjamin,15,0,35,20
1656178878119,MATH 20E,B02,083774,Ciotti; Benjamin,15,0,35,20
1656178884144,MATH 103A,A01,083777,Greenfeld; Be'Eri,1,0,36,35
1656178884144,MATH 103A,A02,083778,Greenfeld; Be'Eri,1,0,36,35
1656178884144,MATH 103A,A03,093561,Staff,5,0,36,31
1656178884144,MATH 103A,B01,083779,Greenfeld; Be'Eri,8,1,36,28
1656178884144,MATH 103A,B02,083780,Greenfeld; Be'Eri,1,0,36,35
1656178884144,MATH 103A,B03,093562,Staff,0,0,36,36
1656178890168,MATH 105,A01,085443,Carter; Anne Toulson,5,1,35,30
1656178890168,MATH 105,A02,093477,Staff,11,0,35,24
1656178896193,MATH 109,A01,083213,Ganzberger; Geoffrey Michael,0,0,34,34
1656178896193,MATH 109,A02,083214,Ganzberger; Geoffrey Michael,0,0,34,34
1656178896193,MATH 109,A03,093478,Staff,1,0,34,33
1656178896193,MATH 109,B01,083215,Ganzberger; Geoffrey Michael,4,0,32,28
1656178896193,MATH 109,B02,083216,Ganzberger; Geoffrey Michael,1,0,32,31
1656178896193,MATH 109,B03,093479,Staff,4,0,32,28
1656178902223,MATH 142A,A01,083219,Chow; Bennett,1,0,32,31
1656178902223,MATH 142A,A02,083220,Chow; Bennett,8,0,32,24
1656178902223,MATH 142A,A03,093480,Staff,5,0,32,27
1656178902223,MATH 142A,B03,093481,Staff,3,0,32,29
1656178902223,MATH 142A,B04,093558,Staff,6,0,32,26
1656178902223,MATH 142A,B05,093559,Staff,1,0,32,31
1656178908247,MATH 193A,A01,083224,Rotar; Vladimir,0,1,34,34
1656178908247,MATH 193A,A02,083225,Rotar; Vladimir,0,0,34,34
1656178908247,MATH 193A,A03,083781,Rotar; Vladimir,0,0,34,34
1656178908247,MATH 193A,A04,083782,Rotar; Vladimir,6,0,34,28
1656178908247,MATH 193A,A05,093482,Rotar; Vladimir,1,0,34,33
1656178914271,MATH 197,001,091859,McAuley; Julian John,9999,0,9999,0
1656178914271,MATH 197,002,095566,Kedlaya; Kiran S.,9997,0,9999,2
1656178914271,MATH 197,003,095567,Xiao; Ming,9999,0,9999,0
1656178914271,MATH 197,004,095571,Perols; Johan Lars,9998,0,9999,1
1656178921328,COGS 9,A01,083615,Shannon; Kyle Michael,4,0,75,71
1656178927358,COGS 11,A01,083617,Boyle; Mary E. T.,14,0,48,34
1656178933381,COGS 13,A01,083071,Bastos; Amalia Pinkusfeld,5,0,71,66
1656178939404,COGS 14A,A01,092681,Semenuks; Arturs,4,15,100,96
1656178945428,COGS 14B,A01,083073,Cheng; Tzu-Han,7,0,63,56
1656178951450,COGS 17,A01,092677,Semenuks; Arturs,7,0,81,74
1656178957471,COGS 100,A01,083619,Allen; Michael Gordon,2,0,70,68
1656178963493,COGS 101A,A01,083621,Davis; Joshua Daniel,4,0,68,64
1656178969516,COGS 101B,A01,091572,Allen; Michael Gordon,5,0,65,60
1656178975538,COGS 101C,A01,083625,Delgado; Tania,10,0,35,25
1656178981566,COGS 107A,A01,083627,Boyle; Mary E. T.,0,0,60,60
1656178987591,COGS 118A,A01,083075,Gupta; Anjum,7,0,76,69
1656178993615,CSE 3,A50,083646,Miranda; Gregory Joseph,18,0,50,32
1656178999652,CSE 8A,A50,083650,Miranda; Gregory Joseph,3,3,56,53
1656179005684,CSE 11,A01,083080,Cao; Yingjun,1,54,40,39
1656179011718,CSE 12,A01,083652,Krause-Levy; Sophia Louisa,7,3,120,113
1656179017741,CSE 15L,A01,083654,Morris; Justin Loren,2,0,50,48
1656179017741,CSE 15L,A02,083655,Morris; Justin Loren,4,0,50,46
1656179023764,CSE 20,A01,083657,Tran; Khoa Dang,31,0,80,49
1656179029791,CSE 21,A01,095574,Bach; Quang Tran,25,0,48,23
1656179035828,CSE 30,A01,083084,Eldon; John,2,8,80,78
1656179035828,CSE 30,B01,095061,Bhaskar; Nishant,1,2,50,49
1656179041940,CSE 100,A01,083659,Cao; Yingjun,2,20,70,68
1656179047964,CSE 134B,A01,083661,Powell; Thomas Allan,3,0,100,97
1656179053991,CSE 140,A01,083663,Gungor; Onat,9,0,85,76
1656179060013,CSE 140L,A01,083088,Eldon; John,8,0,100,92
1656179066036,CSE 175,A01,083665,Kumar; Rakesh,0,0,25,25
1656179072068,CSE 190,A00,092507,Dubnov; Shlomo,3,0,20,17
1656179078092,ECE 45,A01,083139,Congero; Spencer William,1,0,75,74
1656179084116,ECE 65,A50,083695,Saad; Andrew S,9,0,30,21
1656179084116,ECE 65,A51,095125,Staff,23,0,26,3
1656179090139,ECE 109,A01,091882,Touri; Behrouz,0,1,70,70
1656179096162,ECE 180,A00,083140,Abi Samra; Nicholas Camill,1,0,30,29
1656179096162,ECE 180,B00,083141,Abi Samra; Nicholas Camill,0,4,30,30
1656179102186,MATH 10A,A01,083735,Patchell; Gregory David,0,0,30,30
1656179102186,MATH 10A,A02,083736,Patchell; Gregory David,22,0,30,8
1656179102186,MATH 10A,A03,083737,Patchell; Gregory David,16,0,30,14
1656179108209,MATH 10B,A01,083207,Lim; Seonhee,0,0,34,34
1656179108209,MATH 10B,A02,083208,Lim; Seonhee,7,0,35,28
1656179108209,MATH 10B,A03,093472,Staff,1,0,34,33
1656179108209,MATH 10B,B01,083739,Sinha; Shubham,10,0,30,20
1656179114234,MATH 18,A01,083743,Cinel; Cameron Alexander,7,0,30,23
1656179114234,MATH 18,A02,083744,Cinel; Cameron Alexander,10,0,30,20
1656179114234,MATH 18,A03,083745,Cinel; Cameron Alexander,4,0,30,26
1656179114234,MATH 18,B01,083748,Rideout; David Porter,0,0,36,36
1656179114234,MATH 18,B02,083749,Rideout; David Porter,0,0,36,36
1656179114234,MATH 18,B03,083750,Rideout; David Porter,0,0,36,36
1656179114234,MATH 18,B04,083751,Rideout; David Porter,0,0,36,36
1656179114234,MATH 18,B05,093473,Rideout; David Porter,1,0,36,35
1656179114234,MATH 18,B06,093474,Rideout; David Porter,2,0,36,34
1656179120258,MATH 20A,A01,083754,Zheng; Zequn,11,0,40,29
1656179126289,MATH 20B,A01,083756,Briones; Jor-el Thomas Caparas,0,0,36,36
1656179126289,MATH 20B,A02,083757,Briones; Jor-el Thomas Caparas,0,0,36,36
1656179126289,MATH 20B,A03,093475,Staff,1,0,36,35
1656179132318,MATH 20C,A01,083760,Briones; Jor-el Thomas Caparas,0,0,35,35
1656179132318,MATH 20C,A02,083761,Briones; Jor-el Thomas Caparas,9,1,35,26
1656179132318,MATH 20C,A03,093476,Staff,0,0,35,35
1656179132318,MATH 20C,B01,083762,Bach; Quang Tran,1,0,30,29
1656179138343,MATH 20D,A01,083765,Tran; Brian Kha,1,0,30,29
1656179138343,MATH 20D,A02,083766,Tran; Brian Kha,0,1,30,30
1656179138343,MATH 20D,A03,083767,Tran; Brian Kha,2,0,30,28
1656179144368,MATH 20E,A01,083771,Ganguly; Soumya,3,0,32,29
1656179144368,MATH 20E,A02,083772,Ganguly; Soumya,0,0,32,32
1656179144368,MATH 20E,B01,083773,Ciotti; Benjamin,15,0,35,20
1656179144368,MATH 20E,B02,083774,Ciotti; Benjamin,15,0,35,20
1656179150392,MATH 103A,A01,083777,Greenfeld; Be'Eri,1,0,36,35
1656179150392,MATH 103A,A02,083778,Greenfeld; Be'Eri,1,0,36,35
1656179150392,MATH 103A,A03,093561,Staff,5,0,36,31
1656179150392,MATH 103A,B01,083779,Greenfeld; Be'Eri,8,1,36,28
1656179150392,MATH 103A,B02,083780,Greenfeld; Be'Eri,1,0,36,35
1656179150392,MATH 103A,B03,093562,Staff,0,0,36,36
1656179156415,MATH 105,A01,085443,Carter; Anne Toulson,5,1,35,30
1656179156415,MATH 105,A02,093477,Staff,11,0,35,24
1656179162440,MATH 109,A01,083213,Ganzberger; Geoffrey Michael,0,0,34,34
1656179162440,MATH 109,A02,083214,Ganzberger; Geoffrey Michael,0,0,34,34
1656179162440,MATH 109,A03,093478,Staff,1,0,34,33
1656179162440,MATH 109,B01,083215,Ganzberger; Geoffrey Michael,4,0,32,28
1656179162440,MATH 109,B02,083216,Ganzberger; Geoffrey Michael,1,0,32,31
1656179162440,MATH 109,B03,093479,Staff,4,0,32,28
1656179168463,MATH 142A,A01,083219,Chow; Bennett,1,0,32,31
1656179168463,MATH 142A,A02,083220,Chow; Bennett,8,0,32,24
1656179168463,MATH 142A,A03,093480,Staff,5,0,32,27
1656179168463,MATH 142A,B03,093481,Staff,3,0,32,29
1656179168463,MATH 142A,B04,093558,Staff,6,0,32,26
1656179168463,MATH 142A,B05,093559,Staff,1,0,32,31
1656179174492,MATH 193A,A01,083224,Rotar; Vladimir,0,1,34,34
1656179174492,MATH 193A,A02,083225,Rotar; Vladimir,0,0,34,34
1656179174492,MATH 193A,A03,083781,Rotar; Vladimir,0,0,34,34
1656179174492,MATH 193A,A04,083782,Rotar; Vladimir,6,0,34,28
1656179174492,MATH 193A,A05,093482,Rotar; Vladimir,1,0,34,33
1656179180515,MATH 197,001,091859,McAuley; Julian John,9999,0,9999,0
1656179180515,MATH 197,002,095566,Kedlaya; Kiran S.,9997,0,9999,2
1656179180515,MATH 197,003,095567,Xiao; Ming,9999,0,9999,0
1656179180515,MATH 197,004,095571,Perols; Johan Lars,9998,0,9999,1
1656179187572,COGS 9,A01,083615,Shannon; Kyle Michael,4,0,75,71
1656179193598,COGS 11,A01,083617,Boyle; Mary E. T.,14,0,48,34
1656179199622,COGS 13,A01,083071,Bastos; Amalia Pinkusfeld,5,0,71,66
1656179205645,COGS 14A,A01,092681,Semenuks; Arturs,4,15,100,96
1656179211672,COGS 14B,A01,083073,Cheng; Tzu-Han,7,0,63,56
1656179217695,COGS 17,A01,092677,Semenuks; Arturs,7,0,81,74
1656179223731,COGS 100,A01,083619,Allen; Michael Gordon,2,0,70,68
1656179229765,COGS 101A,A01,083621,Davis; Joshua Daniel,4,0,68,64
1656179235799,COGS 101B,A01,091572,Allen; Michael Gordon,5,0,65,60
1656179241825,COGS 101C,A01,083625,Delgado; Tania,10,0,35,25
1656179247849,COGS 107A,A01,083627,Boyle; Mary E. T.,0,0,60,60
1656179253875,COGS 118A,A01,083075,Gupta; Anjum,7,0,76,69
1656179259903,CSE 3,A50,083646,Miranda; Gregory Joseph,18,0,50,32
1656179265931,CSE 8A,A50,083650,Miranda; Gregory Joseph,3,3,56,53
1656179271958,CSE 11,A01,083080,Cao; Yingjun,1,54,40,39
1656179277982,CSE 12,A01,083652,Krause-Levy; Sophia Louisa,7,3,120,113
1656179284007,CSE 15L,A01,083654,Morris; Justin Loren,2,0,50,48
1656179284007,CSE 15L,A02,083655,Morris; Justin Loren,4,0,50,46
1656179290030,CSE 20,A01,083657,Tran; Khoa Dang,31,0,80,49
1656179296055,CSE 21,A01,095574,Bach; Quang Tran,25,0,48,23
1656179302079,CSE 30,A01,083084,Eldon; John,2,8,80,78
1656179302079,CSE 30,B01,095061,Bhaskar; Nishant,1,2,50,49
1656179308103,CSE 100,A01,083659,Cao; Yingjun,2,20,70,68
1656179314130,CSE 134B,A01,083661,Powell; Thomas Allan,3,0,100,97
1656179320157,CSE 140,A01,083663,Gungor; Onat,9,0,85,76
1656179326182,CSE 140L,A01,083088,Eldon; John,8,0,100,92
1656179332205,CSE 175,A01,083665,Kumar; Rakesh,0,0,25,25
1656179338229,CSE 190,A00,092507,Dubnov; Shlomo,3,0,20,17
1656179344251,ECE 45,A01,083139,Congero; Spencer William,1,0,75,74
1656179350278,ECE 65,A50,083695,Saad; Andrew S,9,0,30,21
1656179350278,ECE 65,A51,095125,Staff,23,0,26,3
1656179356300,ECE 109,A01,091882,Touri; Behrouz,0,1,70,70
1656179362325,ECE 180,A00,083140,Abi Samra; Nicholas Camill,1,0,30,29
1656179362325,ECE 180,B00,083141,Abi Samra; Nicholas Camill,0,4,30,30
1656179368353,MATH 10A,A01,083735,Patchell; Gregory David,0,0,30,30
1656179368353,MATH 10A,A02,083736,Patchell; Gregory David,22,0,30,8
1656179368353,MATH 10A,A03,083737,Patchell; Gregory David,16,0,30,14
1656179374376,MATH 10B,A01,083207,Lim; Seonhee,0,0,34,34
1656179374376,MATH 10B,A02,083208,Lim; Seonhee,7,0,35,28
1656179374376,MATH 10B,A03,093472,Staff,1,0,34,33
1656179374376,MATH 10B,B01,083739,Sinha; Shubham,10,0,30,20
1656179380405,MATH 18,A01,083743,Cinel; Cameron Alexander,7,0,30,23
1656179380405,MATH 18,A02,083744,Cinel; Cameron Alexander,10,0,30,20
1656179380405,MATH 18,A03,083745,Cinel; Cameron Alexander,4,0,30,26
1656179380405,MATH 18,B01,083748,Rideout; David Porter,0,0,36,36
1656179380405,MATH 18,B02,083749,Rideout; David Porter,0,0,36,36
1656179380405,MATH 18,B03,083750,Rideout; David Porter,0,0,36,36
1656179380405,MATH 18,B04,083751,Rideout; David Porter,0,0,36,36
1656179380405,MATH 18,B05,093473,Rideout; David Porter,1,0,36,35
1656179380405,MATH 18,B06,093474,Rideout; David Porter,2,0,36,34
1656179386432,MATH 20A,A01,083754,Zheng; Zequn,11,0,40,29
1656179392459,MATH 20B,A01,083756,Briones; Jor-el Thomas Caparas,0,0,36,36
1656179392459,MATH 20B,A02,083757,Briones; Jor-el Thomas Caparas,0,0,36,36
1656179392459,MATH 20B,A03,093475,Staff,1,0,36,35
1656179398483,MATH 20C,A01,083760,Briones; Jor-el Thomas Caparas,0,0,35,35
1656179398483,MATH 20C,A02,083761,Briones; Jor-el Thomas Caparas,9,1,35,26
1656179398483,MATH 20C,A03,093476,Staff,0,0,35,35
1656179398483,MATH 20C,B01,083762,Bach; Quang Tran,1,0,30,29
1656179404510,MATH 20D,A01,083765,Tran; Brian Kha,1,0,30,29
1656179404510,MATH 20D,A02,083766,Tran; Brian Kha,0,1,30,30
1656179404510,MATH 20D,A03,083767,Tran; Brian Kha,2,0,30,28
1656179410533,MATH 20E,A01,083771,Ganguly; Soumya,3,0,32,29
1656179410533,MATH 20E,A02,083772,Ganguly; Soumya,0,0,32,32
1656179410533,MATH 20E,B01,083773,Ciotti; Benjamin,15,0,35,20
1656179410533,MATH 20E,B02,083774,Ciotti; Benjamin,15,0,35,20
1656179416556,MATH 103A,A01,083777,Greenfeld; Be'Eri,1,0,36,35
1656179416556,MATH 103A,A02,083778,Greenfeld; Be'Eri,1,0,36,35
1656179416556,MATH 103A,A03,093561,Staff,5,0,36,31
1656179416556,MATH 103A,B01,083779,Greenfeld; Be'Eri,8,1,36,28
1656179416556,MATH 103A,B02,083780,Greenfeld; Be'Eri,1,0,36,35
1656179416556,MATH 103A,B03,093562,Staff,0,0,36,36
1656179422590,MATH 105,A01,085443,Carter; Anne Toulson,5,1,35,30
1656179422590,MATH 105,A02,093477,Staff,11,0,35,24
1656179428632,MATH 109,A01,083213,Ganzberger; Geoffrey Michael,0,0,34,34
1656179428632,MATH 109,A02,083214,Ganzberger; Geoffrey Michael,0,0,34,34
1656179428632,MATH 109,A03,093478,Staff,1,0,34,33
1656179428632,MATH 109,B01,083215,Ganzberger; Geoffrey Michael,4,0,32,28
1656179428632,MATH 109,B02,083216,Ganzberger; Geoffrey Michael,1,0,32,31
1656179428632,MATH 109,B03,093479,Staff,4,0,32,28
1656179434658,MATH 142A,A01,083219,Chow; Bennett,1,0,32,31
1656179434658,MATH 142A,A02,083220,Chow; Bennett,8,0,32,24
1656179434658,MATH 142A,A03,093480,Staff,5,0,32,27
1656179434658,MATH 142A,B03,093481,Staff,3,0,32,29
1656179434658,MATH 142A,B04,093558,Staff,6,0,32,26
1656179434658,MATH 142A,B05,093559,Staff,1,0,32,31
1656179440682,MATH 193A,A01,083224,Rotar; Vladimir,0,1,34,34
1656179440682,MATH 193A,A02,083225,Rotar; Vladimir,0,0,34,34
1656179440682,MATH 193A,A03,083781,Rotar; Vladimir,0,0,34,34
1656179440682,MATH 193A,A04,083782,Rotar; Vladimir,6,0,34,28
1656179440682,MATH 193A,A05,093482,Rotar; Vladimir,1,0,34,33
1656179446710,MATH 197,001,091859,McAuley; Julian John,9999,0,9999,0
1656179446710,MATH 197,002,095566,Kedlaya; Kiran S.,9997,0,9999,2
1656179446710,MATH 197,003,095567,Xiao; Ming,9999,0,9999,0
1656179446710,MATH 197,004,095571,Perols; Johan Lars,9998,0,9999,1
1656179453776,COGS 9,A01,083615,Shannon; Kyle Michael,4,0,75,71
1656179459803,COGS 11,A01,083617,Boyle; Mary E. T.,14,0,48,34
1656179465830,COGS 13,A01,083071,Bastos; Amalia Pinkusfeld,5,0,71,66
1656179471856,COGS 14A,A01,092681,Semenuks; Arturs,4,15,100,96
1656179477883,COGS 14B,A01,083073,Cheng; Tzu-Han,7,0,63,56
1656179483911,COGS 17,A01,092677,Semenuks; Arturs,7,0,81,74
1656179489933,COGS 100,A01,083619,Allen; Michael Gordon,2,0,70,68
1656179495956,COGS 101A,A01,083621,Davis; Joshua Daniel,4,0,68,64
1656179501978,COGS 101B,A01,091572,Allen; Michael Gordon,5,0,65,60
1656179508006,COGS 101C,A01,083625,Delgado; Tania,10,0,35,25
1656179514031,COGS 107A,A01,083627,Boyle; Mary E. T.,0,0,60,60
1656179520054,COGS 118A,A01,083075,Gupta; Anjum,7,0,76,69
1656179526078,CSE 3,A50,083646,Miranda; Gregory Joseph,18,0,50,32
1656179532101,CSE 8A,A50,083650,Miranda; Gregory Joseph,3,3,56,53
1656179538124,CSE 11,A01,083080,Cao; Yingjun,1,54,40,39
1656179544147,CSE 12,A01,083652,Krause-Levy; Sophia Louisa,7,3,120,113
1656179550172,CSE 15L,A01,083654,Morris; Justin Loren,2,0,50,48
1656179550172,CSE 15L,A02,083655,Morris; Justin Loren,4,0,50,46
1656179556200,CSE 20,A01,083657,Tran; Khoa Dang,31,0,80,49
1656179562228,CSE 21,A01,095574,Bach; Quang Tran,25,0,48,23
1656179568258,CSE 30,A01,083084,Eldon; John,2,8,80,78
1656179568258,CSE 30,B01,095061,Bhaskar; Nishant,1,2,50,49
1656179574281,CSE 100,A01,083659,Cao; Yingjun,2,20,70,68
1656179580308,CSE 134B,A01,083661,Powell; Thomas Allan,3,0,100,97
1656179586337,CSE 140,A01,083663,Gungor; Onat,9,0,85,76
1656179592360,CSE 140L,A01,083088,Eldon; John,8,0,100,92
1656179598381,CSE 175,A01,083665,Kumar; Rakesh,0,0,25,25
1656179604420,CSE 190,A00,092507,Dubnov; Shlomo,3,0,20,17
1656179610445,ECE 45,A01,083139,Congero; Spencer William,1,0,75,74
1656179616468,ECE 65,A50,083695,Saad; Andrew S,9,0,30,21
1656179616468,ECE 65,A51,095125,Staff,23,0,26,3
1656179622491,ECE 109,A01,091882,Touri; Behrouz,0,1,70,70
1656179628516,ECE 180,A00,083140,Abi Samra; Nicholas Camill,1,0,30,29
1656179628516,ECE 180,B00,083141,Abi Samra; Nicholas Camill,0,4,30,30
1656179634550,MATH 10A,A01,083735,Patchell; Gregory David,0,0,30,30
1656179634550,MATH 10A,A02,083736,Patchell; Gregory David,22,0,30,8
1656179634550,MATH 10A,A03,083737,Patchell; Gregory David,16,0,30,14
1656179640649,MATH 10B,A01,083207,Lim; Seonhee,0,0,34,34
1656179640649,MATH 10B,A02,083208,Lim; Seonhee,7,0,35,28
1656179640649,MATH 10B,A03,093472,Staff,1,0,34,33
1656179640649,MATH 10B,B01,083739,Sinha; Shubham,10,0,30,20
1656179646674,MATH 18,A01,083743,Cinel; Cameron Alexander,7,0,30,23
1656179646674,MATH 18,A02,083744,Cinel; Cameron Alexander,10,0,30,20
1656179646674,MATH 18,A03,083745,Cinel; Cameron Alexander,4,0,30,26
1656179646674,MATH 18,B01,083748,Rideout; David Porter,0,0,36,36
1656179646674,MATH 18,B02,083749,Rideout; David Porter,0,0,36,36
1656179646674,MATH 18,B03,083750,Rideout; David Porter,0,0,36,36
1656179646674,MATH 18,B04,083751,Rideout; David Porter,0,0,36,36
1656179646674,MATH 18,B05,093473,Rideout; David Porter,1,0,36,35
1656179646674,MATH 18,B06,093474,Rideout; David Porter,2,0,36,34
1656179652698,MATH 20A,A01,083754,Zheng; Zequn,11,0,40,29
1656179658726,MATH 20B,A01,083756,Briones; Jor-el Thomas Caparas,0,0,36,36
1656179658726,MATH 20B,A02,083757,Briones; Jor-el Thomas Caparas,0,0,36,36
1656179658726,MATH 20B,A03,093475,Staff,1,0,36,35
1656179664750,MATH 20C,A01,083760,Briones; Jor-el Thomas Caparas,0,0,35,35
1656179664750,MATH 20C,A02,083761,Briones; Jor-el Thomas Caparas,9,1,35,26
1656179664750,MATH 20C,A03,093476,Staff,0,0,35,35
1656179664750,MATH 20C,B01,083762,Bach; Quang Tran,1,0,30,29
1656179670774,MATH 20D,A01,083765,Tran; Brian Kha,1,0,30,29
1656179670774,MATH 20D,A02,083766,Tran; Brian Kha,0,1,30,30
1656179670774,MATH 20D,A03,083767,Tran; Brian Kha,2,0,30,28
1656179676798,MATH 20E,A01,083771,Ganguly; Soumya,3,0,32,29
1656179676798,MATH 20E,A02,083772,Ganguly; Soumya,0,0,32,32
1656179676798,MATH 20E,B01,083773,Ciotti; Benjamin,15,0,35,20
1656179676798,MATH 20E,B02,083774,Ciotti; Benjamin,15,0,35,20
1656179682822,MATH 103A,A01,083777,Greenfeld; Be'Eri,1,0,36,35
1656179682822,MATH 103A,A02,083778,Greenfeld; Be'Eri,1,0,36,35
1656179682822,MATH 103A,A03,093561,Staff,5,0,36,31
1656179682822,MATH 103A,B01,083779,Greenfeld; Be'Eri,8,1,36,28
1656179682822,MATH 103A,B02,083780,Greenfeld; Be'Eri,1,0,36,35
1656179682822,MATH 103A,B03,093562,Staff,0,0,36,36
1656179688848,MATH 105,A01,085443,Carter; Anne Toulson,5,1,35,30
1656179688848,MATH 105,A02,093477,Staff,11,0,35,24
1656179694872,MATH 109,A01,083213,Ganzberger; Geoffrey Michael,0,0,34,34
1656179694872,MATH 109,A02,083214,Ganzberger; Geoffrey Michael,0,0,34,34
1656179694872,MATH 109,A03,093478,Staff,1,0,34,33
1656179694872,MATH 109,B01,083215,Ganzberger; Geoffrey Michael,4,0,32,28
1656179694872,MATH 109,B02,083216,Ganzberger; Geoffrey Michael,1,0,32,31
1656179694872,MATH 109,B03,093479,Staff,4,0,32,28
1656179700911,MATH 142A,A01,083219,Chow; Bennett,1,0,32,31
1656179700911,MATH 142A,A02,083220,Chow; Bennett,8,0,32,24
1656179700911,MATH 142A,A03,093480,Staff,5,0,32,27
1656179700911,MATH 142A,B03,093481,Staff,3,0,32,29
1656179700911,MATH 142A,B04,093558,Staff,6,0,32,26
1656179700911,MATH 142A,B05,093559,Staff,1,0,32,31
1656179706941,MATH 193A,A01,083224,Rotar; Vladimir,0,1,34,34
1656179706941,MATH 193A,A02,083225,Rotar; Vladimir,0,0,34,34
1656179706941,MATH 193A,A03,083781,Rotar; Vladimir,0,0,34,34
1656179706941,MATH 193A,A04,083782,Rotar; Vladimir,6,0,34,28
1656179706941,MATH 193A,A05,093482,Rotar; Vladimir,1,0,34,33
1656179712966,MATH 197,001,091859,McAuley; Julian John,9999,0,9999,0
1656179712966,MATH 197,002,095566,Kedlaya; Kiran S.,9997,0,9999,2
1656179712966,MATH 197,003,095567,Xiao; Ming,9999,0,9999,0
1656179712966,MATH 197,004,095571,Perols; Johan Lars,9998,0,9999,1
1656179720024,COGS 9,A01,083615,Shannon; Kyle Michael,4,0,75,71
1656179726052,COGS 11,A01,083617,Boyle; Mary E. T.,14,0,48,34
1656179732079,COGS 13,A01,083071,Bastos; Amalia Pinkusfeld,5,0,71,66
1656179738103,COGS 14A,A01,092681,Semenuks; Arturs,4,15,100,96
1656179744126,COGS 14B,A01,083073,Cheng; Tzu-Han,7,0,63,56
1656179750148,COGS 17,A01,092677,Semenuks; Arturs,7,0,81,74
1656179756172,COGS 100,A01,083619,Allen; Michael Gordon,2,0,70,68
1656179762196,COGS 101A,A01,083621,Davis; Joshua Daniel,4,0,68,64
1656179768220,COGS 101B,A01,091572,Allen; Michael Gordon,5,0,65,60
1656179774248,COGS 101C,A01,083625,Delgado; Tania,10,0,35,25
1656179780278,COGS 107A,A01,083627,Boyle; Mary E. T.,0,0,60,60
1656179786302,COGS 118A,A01,083075,Gupta; Anjum,7,0,76,69
1656179792332,CSE 3,A50,083646,Miranda; Gregory Joseph,18,0,50,32
1656179798355,CSE 8A,A50,083650,Miranda; Gregory Joseph,3,3,56,53
1656179804378,CSE 11,A01,083080,Cao; Yingjun,1,54,40,39
1656179810406,CSE 12,A01,083652,Krause-Levy; Sophia Louisa,7,3,120,113
1656179816429,CSE 15L,A01,083654,Morris; Justin Loren,2,0,50,48
1656179816429,CSE 15L,A02,083655,Morris; Justin Loren,4,0,50,46
1656179822453,CSE 20,A01,083657,Tran; Khoa Dang,31,0,80,49
1656179828476,CSE 21,A01,095574,Bach; Quang Tran,25,0,48,23
1656179834504,CSE 30,A01,083084,Eldon; John,2,8,80,78
1656179834504,CSE 30,B01,095061,Bhaskar; Nishant,1,2,50,49
1656179840529,CSE 100,A01,083659,Cao; Yingjun,2,20,70,68
1656179846558,CSE 134B,A01,083661,Powell; Thomas Allan,3,0,100,97
1656179852589,CSE 140,A01,083663,Gungor; Onat,9,0,85,76
1656179858617,CSE 140L,A01,083088,Eldon; John,8,0,100,92
1656179864640,CSE 175,A01,083665,Kumar; Rakesh,0,0,25,25
1656179870668,CSE 190,A00,092507,Dubnov; Shlomo,3,0,20,17
1656179876693,ECE 45,A01,083139,Congero; Spencer William,1,0,75,74
1656179882716,ECE 65,A50,083695,Saad; Andrew S,9,0,30,21
1656179882716,ECE 65,A51,095125,Staff,23,0,26,3
1656179888741,ECE 109,A01,091882,Touri; Behrouz,0,1,70,70
1656179894768,ECE 180,A00,083140,Abi Samra; Nicholas Camill,1,0,30,29
1656179894768,ECE 180,B00,083141,Abi Samra; Nicholas Camill,0,4,30,30
1656179900796,MATH 10A,A01,083735,Patchell; Gregory David,0,0,30,30
1656179900796,MATH 10A,A02,083736,Patchell; Gregory David,22,0,30,8
1656179900796,MATH 10A,A03,083737,Patchell; Gregory David,16,0,30,14
1656179906824,MATH 10B,A01,083207,Lim; Seonhee,0,0,34,34
1656179906824,MATH 10B,A02,083208,Lim; Seonhee,7,0,35,28
1656179906824,MATH 10B,A03,093472,Staff,1,0,34,33
1656179906824,MATH 10B,B01,083739,Sinha; Shubham,10,0,30,20
1656179912850,MATH 18,A01,083743,Cinel; Cameron Alexander,7,0,30,23
1656179912850,MATH 18,A02,083744,Cinel; Cameron Alexander,10,0,30,20
1656179912850,MATH 18,A03,083745,Cinel; Cameron Alexander,4,0,30,26
1656179912850,MATH 18,B01,083748,Rideout; David Porter,0,0,36,36
1656179912850,MATH 18,B02,083749,Rideout; David Porter,0,0,36,36
1656179912850,MATH 18,B03,083750,Rideout; David Porter,0,0,36,36
1656179912850,MATH 18,B04,083751,Rideout; David Porter,0,0,36,36
1656179912850,MATH 18,B05,093473,Rideout; David Porter,1,0,36,35
1656179912850,MATH 18,B06,093474,Rideout; David Porter,2,0,36,34
1656179918873,MATH 20A,A01,083754,Zheng; Zequn,11,0,40,29
1656179924898,MATH 20B,A01,083756,Briones; Jor-el Thomas Caparas,0,0,36,36
1656179924898,MATH 20B,A02,083757,Briones; Jor-el Thomas Caparas,0,0,36,36
1656179924898,MATH 20B,A03,093475,Staff,1,0,36,35
1656179930926,MATH 20C,A01,083760,Briones; Jor-el Thomas Caparas,0,0,35,35
1656179930926,MATH 20C,A02,083761,Briones; Jor-el Thomas Caparas,9,1,35,26
1656179930926,MATH 20C,A03,093476,Staff,0,0,35,35
1656179930926,MATH 20C,B01,083762,Bach; Quang Tran,1,0,30,29
1656179936956,MATH 20D,A01,083765,Tran; Brian Kha,1,0,30,29
1656179936956,MATH 20D,A02,083766,Tran; Brian Kha,0,1,30,30
1656179936956,MATH 20D,A03,083767,Tran; Brian Kha,2,0,30,28
1656179942980,MATH 20E,A01,083771,Ganguly; Soumya,3,0,32,29
1656179942980,MATH 20E,A02,083772,Ganguly; Soumya,0,0,32,32
1656179942980,MATH 20E,B01,083773,Ciotti; Benjamin,15,0,35,20
1656179942980,MATH 20E,B02,083774,Ciotti; Benjamin,15,0,35,20
1656179949005,MATH 103A,A01,083777,Greenfeld; Be'Eri,1,0,36,35
1656179949005,MATH 103A,A02,083778,Greenfeld; Be'Eri,1,0,36,35
1656179949005,MATH 103A,A03,093561,Staff,5,0,36,31
1656179949005,MATH 103A,B01,083779,Greenfeld; Be'Eri,8,1,36,28
1656179949005,MATH 103A,B02,083780,Greenfeld; Be'Eri,1,0,36,35
1656179949005,MATH 103A,B03,093562,Staff,0,0,36,36
1656179955034,MATH 105,A01,085443,Carter; Anne Toulson,5,1,35,30
1656179955034,MATH 105,A02,093477,Staff,11,0,35,24
1656179961056,MATH 109,A01,083213,Ganzberger; Geoffrey Michael,0,0,34,34
1656179961056,MATH 109,A02,083214,Ganzberger; Geoffrey Michael,0,0,34,34
1656179961056,MATH 109,A03,093478,Staff,1,0,34,33
1656179961056,MATH 109,B01,083215,Ganzberger; Geoffrey Michael,4,0,32,28
1656179961056,MATH 109,B02,083216,Ganzberger; Geoffrey Michael,1,0,32,31
1656179961056,MATH 109,B03,093479,Staff,4,0,32,28
1656179967085,MATH 142A,A01,083219,Chow; Bennett,1,0,32,31
1656179967085,MATH 142A,A02,083220,Chow; Bennett,8,0,32,24
1656179967085,MATH 142A,A03,093480,Staff,5,0,32,27
1656179967085,MATH 142A,B03,093481,Staff,3,0,32,29
1656179967085,MATH 142A,B04,093558,Staff,6,0,32,26
1656179967085,MATH 142A,B05,093559,Staff,1,0,32,31
1656179973107,MATH 193A,A01,083224,Rotar; Vladimir,0,1,34,34
1656179973107,MATH 193A,A02,083225,Rotar; Vladimir,0,0,34,34
1656179973107,MATH 193A,A03,083781,Rotar; Vladimir,0,0,34,34
1656179973107,MATH 193A,A04,083782,Rotar; Vladimir,6,0,34,28
1656179973107,MATH 193A,A05,093482,Rotar; Vladimir,1,0,34,33
1656179979131,MATH 197,001,091859,McAuley; Julian John,9999,0,9999,0
1656179979131,MATH 197,002,095566,Kedlaya; Kiran S.,9997,0,9999,2
1656179979131,MATH 197,003,095567,Xiao; Ming,9999,0,9999,0
1656179979131,MATH 197,004,095571,Perols; Johan Lars,9998,0,9999,1
1656179986182,COGS 9,A01,083615,Shannon; Kyle Michael,4,0,75,71
1656179992206,COGS 11,A01,083617,Boyle; Mary E. T.,14,0,48,34
1656179998229,COGS 13,A01,083071,Bastos; Amalia Pinkusfeld,5,0,71,66
1656180004255,COGS 14A,A01,092681,Semenuks; Arturs,4,15,100,96
1656180010285,COGS 14B,A01,083073,Cheng; Tzu-Han,7,0,63,56
1656180016310,COGS 17,A01,092677,Semenuks; Arturs,7,0,81,74
1656180022330,COGS 100,A01,083619,Allen; Michael Gordon,2,0,70,68
1656180028359,COGS 101A,A01,083621,Davis; Joshua Daniel,4,0,68,64
1656180034381,COGS 101B,A01,091572,Allen; Michael Gordon,5,0,65,60
1656180040407,COGS 101C,A01,083625,Delgado; Tania,10,0,35,25
1656180046434,COGS 107A,A01,083627,Boyle; Mary E. T.,0,0,60,60
1656180052459,COGS 118A,A01,083075,Gupta; Anjum,7,0,76,69
1656180058485,CSE 3,A50,083646,Miranda; Gregory Joseph,18,0,50,32
1656180064519,CSE 8A,A50,083650,Miranda; Gregory Joseph,3,3,56,53
1656180070548,CSE 11,A01,083080,Cao; Yingjun,1,54,40,39
1656180076572,CSE 12,A01,083652,Krause-Levy; Sophia Louisa,7,3,120,113
1656180082614,CSE 15L,A01,083654,Morris; Justin Loren,2,0,50,48
1656180082614,CSE 15L,A02,083655,Morris; Justin Loren,4,0,50,46
1656180088639,CSE 20,A01,083657,Tran; Khoa Dang,31,0,80,49
1656180094662,CSE 21,A01,095574,Bach; Quang Tran,25,0,48,23
1656180100684,CSE 30,A01,083084,Eldon; John,2,8,80,78
1656180100684,CSE 30,B01,095061,Bhaskar; Nishant,1,2,50,49
1656180106710,CSE 100,A01,083659,Cao; Yingjun,2,20,70,68
1656180112733,CSE 134B,A01,083661,Powell; Thomas Allan,3,0,100,97
1656180118764,CSE 140,A01,083663,Gungor; Onat,9,0,85,76
1656180124788,CSE 140L,A01,083088,Eldon; John,8,0,100,92
1656180130810,CSE 175,A01,083665,Kumar; Rakesh,0,0,25,25
1656180136836,CSE 190,A00,092507,Dubnov; Shlomo,3,0,20,17
1656180142860,ECE 45,A01,083139,Congero; Spencer William,1,0,75,74
1656180148886,ECE 65,A50,083695,Saad; Andrew S,9,0,30,21
1656180148886,ECE 65,A51,095125,Staff,23,0,26,3
1656180154909,ECE 109,A01,091882,Touri; Behrouz,0,1,70,70
1656180160933,ECE 180,A00,083140,Abi Samra; Nicholas Camill,1,0,30,29
1656180160933,ECE 180,B00,083141,Abi Samra; Nicholas Camill,0,4,30,30
1656180166959,MATH 10A,A01,083735,Patchell; Gregory David,0,0,30,30
1656180166959,MATH 10A,A02,083736,Patchell; Gregory David,22,0,30,8
1656180166959,MATH 10A,A03,083737,Patchell; Gregory David,16,0,30,14
1656180172988,MATH 10B,A01,083207,Lim; Seonhee,0,0,34,34
1656180172988,MATH 10B,A02,083208,Lim; Seonhee,7,0,35,28
1656180172988,MATH 10B,A03,093472,Staff,1,0,34,33
1656180172988,MATH 10B,B01,083739,Sinha; Shubham,11,0,30,19
1656180179023,MATH 18,A01,083743,Cinel; Cameron Alexander,7,0,30,23
1656180179023,MATH 18,A02,083744,Cinel; Cameron Alexander,10,0,30,20
1656180179023,MATH 18,A03,083745,Cinel; Cameron Alexander,4,0,30,26
1656180179023,MATH 18,B01,083748,Rideout; David Porter,0,0,36,36
1656180179023,MATH 18,B02,083749,Rideout; David Porter,0,0,36,36
1656180179023,MATH 18,B03,083750,Rideout; David Porter,0,0,36,36
1656180179023,MATH 18,B04,083751,Rideout; David Porter,0,0,36,36
1656180179023,MATH 18,B05,093473,Rideout; David Porter,1,0,36,35
1656180179023,MATH 18,B06,093474,Rideout; David Porter,2,0,36,34
1656180185045,MATH 20A,A01,083754,Zheng; Zequn,11,0,40,29
1656180191070,MATH 20B,A01,083756,Briones; Jor-el Thomas Caparas,0,0,36,36
1656180191070,MATH 20B,A02,083757,Briones; Jor-el Thomas Caparas,0,0,36,36
1656180191070,MATH 20B,A03,093475,Staff,1,0,36,35
1656180197098,MATH 20C,A01,083760,Briones; Jor-el Thomas Caparas,0,0,35,35
1656180197098,MATH 20C,A02,083761,Briones; Jor-el Thomas Caparas,9,1,35,26
1656180197098,MATH 20C,A03,093476,Staff,0,0,35,35
1656180197098,MATH 20C,B01,083762,Bach; Quang Tran,1,0,30,29
1656180203121,MATH 20D,A01,083765,Tran; Brian Kha,1,0,30,29
1656180203121,MATH 20D,A02,083766,Tran; Brian Kha,0,1,30,30
1656180203121,MATH 20D,A03,083767,Tran; Brian Kha,2,0,30,28
1656180209145,MATH 20E,A01,083771,Ganguly; Soumya,3,0,32,29
1656180209145,MATH 20E,A02,083772,Ganguly; Soumya,0,0,32,32
1656180209145,MATH 20E,B01,083773,Ciotti; Benjamin,15,0,35,20
1656180209145,MATH 20E,B02,083774,Ciotti; Benjamin,15,0,35,20
1656180215169,MATH 103A,A01,083777,Greenfeld; Be'Eri,1,0,36,35
1656180215169,MATH 103A,A02,083778,Greenfeld; Be'Eri,1,0,36,35
1656180215169,MATH 103A,A03,093561,Staff,5,0,36,31
1656180215169,MATH 103A,B01,083779,Greenfeld; Be'Eri,8,1,36,28
1656180215169,MATH 103A,B02,083780,Greenfeld; Be'Eri,1,0,36,35
1656180215169,MATH 103A,B03,093562,Staff,0,0,36,36
1656180221199,MATH 105,A01,085443,Carter; Anne Toulson,5,1,35,30
1656180221199,MATH 105,A02,093477,Staff,11,0,35,24
1656180227222,MATH 109,A01,083213,Ganzberger; Geoffrey Michael,0,0,34,34
1656180227222,MATH 109,A02,083214,Ganzberger; Geoffrey Michael,0,0,34,34
1656180227222,MATH 109,A03,093478,Staff,1,0,34,33
1656180227222,MATH 109,B01,083215,Ganzberger; Geoffrey Michael,4,0,32,28
1656180227222,MATH 109,B02,083216,Ganzberger; Geoffrey Michael,1,0,32,31
1656180227222,MATH 109,B03,093479,Staff,4,0,32,28
1656180233246,MATH 142A,A01,083219,Chow; Bennett,1,0,32,31
1656180233246,MATH 142A,A02,083220,Chow; Bennett,8,0,32,24
1656180233246,MATH 142A,A03,093480,Staff,5,0,32,27
1656180233246,MATH 142A,B03,093481,Staff,3,0,32,29
1656180233246,MATH 142A,B04,093558,Staff,6,0,32,26
1656180233246,MATH 142A,B05,093559,Staff,1,0,32,31
1656180239341,MATH 193A,A01,083224,Rotar; Vladimir,0,1,34,34
1656180239341,MATH 193A,A02,083225,Rotar; Vladimir,0,0,34,34
1656180239341,MATH 193A,A03,083781,Rotar; Vladimir,0,0,34,34
1656180239341,MATH 193A,A04,083782,Rotar; Vladimir,6,0,34,28
1656180239341,MATH 193A,A05,093482,Rotar; Vladimir,1,0,34,33
1656180245367,MATH 197,001,091859,McAuley; Julian John,9999,0,9999,0
1656180245367,MATH 197,002,095566,Kedlaya; Kiran S.,9997,0,9999,2
1656180245367,MATH 197,003,095567,Xiao; Ming,9999,0,9999,0
1656180245367,MATH 197,004,095571,Perols; Johan Lars,9998,0,9999,1
1656180252441,COGS 9,A01,083615,Shannon; Kyle Michael,4,0,75,71
1656180258471,COGS 11,A01,083617,Boyle; Mary E. T.,14,0,48,34
1656180264498,COGS 13,A01,083071,Bastos; Amalia Pinkusfeld,5,0,71,66
1656180270521,COGS 14A,A01,092681,Semenuks; Arturs,4,15,100,96
1656180276543,COGS 14B,A01,083073,Cheng; Tzu-Han,7,0,63,56
1656180282568,COGS 17,A01,092677,Semenuks; Arturs,7,0,81,74
1656180288591,COGS 100,A01,083619,Allen; Michael Gordon,2,0,70,68
1656180294615,COGS 101A,A01,083621,Davis; Joshua Daniel,4,0,68,64
1656180300637,COGS 101B,A01,091572,Allen; Michael Gordon,5,0,65,60
1656180306660,COGS 101C,A01,083625,Delgado; Tania,10,0,35,25
1656180312688,COGS 107A,A01,083627,Boyle; Mary E. T.,0,0,60,60
1656180318709,COGS 118A,A01,083075,Gupta; Anjum,7,0,76,69
1656180324732,CSE 3,A50,083646,Miranda; Gregory Joseph,18,0,50,32
1656180330755,CSE 8A,A50,083650,Miranda; Gregory Joseph,3,3,56,53
1656180336782,CSE 11,A01,083080,Cao; Yingjun,1,54,40,39
1656180342807,CSE 12,A01,083652,Krause-Levy; Sophia Louisa,7,3,120,113
1656180348833,CSE 15L,A01,083654,Morris; Justin Loren,2,0,50,48
1656180348833,CSE 15L,A02,083655,Morris; Justin Loren,4,0,50,46
1656180354857,CSE 20,A01,083657,Tran; Khoa Dang,31,0,80,49
1656180360879,CSE 21,A01,095574,Bach; Quang Tran,25,0,48,23
1656180366905,CSE 30,A01,083084,Eldon; John,2,8,80,78
1656180366905,CSE 30,B01,095061,Bhaskar; Nishant,1,2,50,49
1656180372931,CSE 100,A01,083659,Cao; Yingjun,2,20,70,68
1656180378955,CSE 134B,A01,083661,Powell; Thomas Allan,3,0,100,97
1656180384977,CSE 140,A01,083663,Gungor; Onat,9,0,85,76
1656180391018,CSE 140L,A01,083088,Eldon; John,8,0,100,92
1656180397052,CSE 175,A01,083665,Kumar; Rakesh,0,0,25,25
1656180403079,CSE 190,A00,092507,Dubnov; Shlomo,3,0,20,17
1656180409101,ECE 45,A01,083139,Congero; Spencer William,1,0,75,74
1656180415125,ECE 65,A50,083695,Saad; Andrew S,9,0,30,21
1656180415125,ECE 65,A51,095125,Staff,23,0,26,3
1656180421148,ECE 109,A01,091882,Touri; Behrouz,0,1,70,70
1656180427179,ECE 180,A00,083140,Abi Samra; Nicholas Camill,1,0,30,29
1656180427179,ECE 180,B00,083141,Abi Samra; Nicholas Camill,0,4,30,30
1656180433201,MATH 10A,A01,083735,Patchell; Gregory David,0,0,30,30
1656180433201,MATH 10A,A02,083736,Patchell; Gregory David,22,0,30,8
1656180433201,MATH 10A,A03,083737,Patchell; Gregory David,16,0,30,14
1656180439229,MATH 10B,A01,083207,Lim; Seonhee,0,0,34,34
1656180439229,MATH 10B,A02,083208,Lim; Seonhee,7,0,35,28
1656180439229,MATH 10B,A03,093472,Staff,1,0,34,33
1656180439229,MATH 10B,B01,083739,Sinha; Shubham,11,0,30,19
1656180445254,MATH 18,A01,083743,Cinel; Cameron Alexander,7,0,30,23
1656180445254,MATH 18,A02,083744,Cinel; Cameron Alexander,10,0,30,20
1656180445254,MATH 18,A03,083745,Cinel; Cameron Alexander,4,0,30,26
1656180445254,MATH 18,B01,083748,Rideout; David Porter,0,0,36,36
1656180445254,MATH 18,B02,083749,Rideout; David Porter,0,0,36,36
1656180445254,MATH 18,B03,083750,Rideout; David Porter,0,0,36,36
1656180445254,MATH 18,B04,083751,Rideout; David Porter,0,0,36,36
1656180445254,MATH 18,B05,093473,Rideout; David Porter,1,0,36,35
1656180445254,MATH 18,B06,093474,Rideout; David Porter,2,0,36,34
1656180451281,MATH 20A,A01,083754,Zheng; Zequn,11,0,40,29
1656180457304,MATH 20B,A01,083756,Briones; Jor-el Thomas Caparas,0,0,36,36
1656180457304,MATH 20B,A02,083757,Briones; Jor-el Thomas Caparas,0,0,36,36
1656180457304,MATH 20B,A03,093475,Staff,1,0,36,35
1656180463332,MATH 20C,A01,083760,Briones; Jor-el Thomas Caparas,0,0,35,35
1656180463332,MATH 20C,A02,083761,Briones; Jor-el Thomas Caparas,9,1,35,26
1656180463332,MATH 20C,A03,093476,Staff,0,0,35,35
1656180463332,MATH 20C,B01,083762,Bach; Quang Tran,1,0,30,29
1656180469362,MATH 20D,A01,083765,Tran; Brian Kha,1,0,30,29
1656180469362,MATH 20D,A02,083766,Tran; Brian Kha,0,1,30,30
1656180469362,MATH 20D,A03,083767,Tran; Brian Kha,2,0,30,28
1656180475385,MATH 20E,A01,083771,Ganguly; Soumya,3,0,32,29
1656180475385,MATH 20E,A02,083772,Ganguly; Soumya,0,0,32,32
1656180475385,MATH 20E,B01,083773,Ciotti; Benjamin,15,0,35,20
1656180475385,MATH 20E,B02,083774,Ciotti; Benjamin,15,0,35,20
1656180481407,MATH 103A,A01,083777,Greenfeld; Be'Eri,1,0,36,35
1656180481407,MATH 103A,A02,083778,Greenfeld; Be'Eri,1,0,36,35
1656180481407,MATH 103A,A03,093561,Staff,5,0,36,31
1656180481407,MATH 103A,B01,083779,Greenfeld; Be'Eri,8,1,36,28
1656180481407,MATH 103A,B02,083780,Greenfeld; Be'Eri,1,0,36,35
1656180481407,MATH 103A,B03,093562,Staff,0,0,36,36
1656180487428,MATH 105,A01,085443,Carter; Anne Toulson,5,1,35,30
1656180487428,MATH 105,A02,093477,Staff,11,0,35,24
1656180493452,MATH 109,A01,083213,Ganzberger; Geoffrey Michael,0,0,34,34
1656180493452,MATH 109,A02,083214,Ganzberger; Geoffrey Michael,0,0,34,34
1656180493452,MATH 109,A03,093478,Staff,1,0,34,33
1656180493452,MATH 109,B01,083215,Ganzberger; Geoffrey Michael,4,0,32,28
1656180493452,MATH 109,B02,083216,Ganzberger; Geoffrey Michael,1,0,32,31
1656180493452,MATH 109,B03,093479,Staff,4,0,32,28
1656180499475,MATH 142A,A01,083219,Chow; Bennett,1,0,32,31
1656180499475,MATH 142A,A02,083220,Chow; Bennett,8,0,32,24
1656180499475,MATH 142A,A03,093480,Staff,5,0,32,27
1656180499475,MATH 142A,B03,093481,Staff,3,0,32,29
1656180499475,MATH 142A,B04,093558,Staff,6,0,32,26
1656180499475,MATH 142A,B05,093559,Staff,1,0,32,31
1656180505502,MATH 193A,A01,083224,Rotar; Vladimir,0,1,34,34
1656180505502,MATH 193A,A02,083225,Rotar; Vladimir,0,0,34,34
1656180505502,MATH 193A,A03,083781,Rotar; Vladimir,0,0,34,34
1656180505502,MATH 193A,A04,083782,Rotar; Vladimir,6,0,34,28
1656180505502,MATH 193A,A05,093482,Rotar; Vladimir,1,0,34,33
1656180511526,MATH 197,001,091859,McAuley; Julian John,9999,0,9999,0
1656180511526,MATH 197,002,095566,Kedlaya; Kiran S.,9997,0,9999,2
1656180511526,MATH 197,003,095567,Xiao; Ming,9999,0,9999,0
1656180511526,MATH 197,004,095571,Perols; Johan Lars,9998,0,9999,1
1656180518589,COGS 9,A01,083615,Shannon; Kyle Michael,4,0,75,71
1656180524612,COGS 11,A01,083617,Boyle; Mary E. T.,14,0,48,34
1656180530636,COGS 13,A01,083071,Bastos; Amalia Pinkusfeld,5,0,71,66
1656180536662,COGS 14A,A01,092681,Semenuks; Arturs,4,15,100,96
1656180542686,COGS 14B,A01,083073,Cheng; Tzu-Han,7,0,63,56
1656180548715,COGS 17,A01,092677,Semenuks; Arturs,7,0,81,74
1656180554738,COGS 100,A01,083619,Allen; Michael Gordon,2,0,70,68
1656180560761,COGS 101A,A01,083621,Davis; Joshua Daniel,4,0,68,64
1656180566784,COGS 101B,A01,091572,Allen; Michael Gordon,5,0,65,60
1656180572810,COGS 101C,A01,083625,Delgado; Tania,10,0,35,25
1656180578833,COGS 107A,A01,083627,Boyle; Mary E. T.,0,0,60,60
1656180584860,COGS 118A,A01,083075,Gupta; Anjum,7,0,76,69
1656180590888,CSE 3,A50,083646,Miranda; Gregory Joseph,18,0,50,32
1656180596915,CSE 8A,A50,083650,Miranda; Gregory Joseph,3,3,56,53
1656180602938,CSE 11,A01,083080,Cao; Yingjun,1,54,40,39
1656180608965,CSE 12,A01,083652,Krause-Levy; Sophia Louisa,7,3,120,113
1656180614992,CSE 15L,A01,083654,Morris; Justin Loren,2,0,50,48
1656180614992,CSE 15L,A02,083655,Morris; Justin Loren,4,0,50,46
1656180621016,CSE 20,A01,083657,Tran; Khoa Dang,31,0,80,49
1656180627061,CSE 21,A01,095574,Bach; Quang Tran,25,0,48,23
1656180633085,CSE 30,A01,083084,Eldon; John,2,8,80,78
1656180633085,CSE 30,B01,095061,Bhaskar; Nishant,1,2,50,49
1656180639119,CSE 100,A01,083659,Cao; Yingjun,2,20,70,68
1656180645151,CSE 134B,A01,083661,Powell; Thomas Allan,3,0,100,97
1656180651175,CSE 140,A01,083663,Gungor; Onat,9,0,85,76
1656180657198,CSE 140L,A01,083088,Eldon; John,8,0,100,92
1656180663220,CSE 175,A01,083665,Kumar; Rakesh,0,0,25,25
1656180669243,CSE 190,A00,092507,Dubnov; Shlomo,3,0,20,17
1656180675270,ECE 45,A01,083139,Congero; Spencer William,1,0,75,74
1656180681293,ECE 65,A50,083695,Saad; Andrew S,9,0,30,21
1656180681293,ECE 65,A51,095125,Staff,23,0,26,3
1656180687316,ECE 109,A01,091882,Touri; Behrouz,0,1,70,70
1656180693345,ECE 180,A00,083140,Abi Samra; Nicholas Camill,1,0,30,29
1656180693345,ECE 180,B00,083141,Abi Samra; Nicholas Camill,0,4,30,30
1656180699377,MATH 10A,A01,083735,Patchell; Gregory David,0,0,30,30
1656180699377,MATH 10A,A02,083736,Patchell; Gregory David,22,0,30,8
1656180699377,MATH 10A,A03,083737,Patchell; Gregory David,16,0,30,14
1656180705402,MATH 10B,A01,083207,Lim; Seonhee,0,0,34,34
1656180705402,MATH 10B,A02,083208,Lim; Seonhee,7,0,35,28
1656180705402,MATH 10B,A03,093472,Staff,1,0,34,33
1656180705402,MATH 10B,B01,083739,Sinha; Shubham,11,0,30,19
1656180711426,MATH 18,A01,083743,Cinel; Cameron Alexander,7,0,30,23
1656180711426,MATH 18,A02,083744,Cinel; Cameron Alexander,10,0,30,20
1656180711426,MATH 18,A03,083745,Cinel; Cameron Alexander,4,0,30,26
1656180711426,MATH 18,B01,083748,Rideout; David Porter,0,0,36,36
1656180711426,MATH 18,B02,083749,Rideout; David Porter,0,0,36,36
1656180711426,MATH 18,B03,083750,Rideout; David Porter,0,0,36,36
1656180711426,MATH 18,B04,083751,Rideout; David Porter,0,0,36,36
1656180711426,MATH 18,B05,093473,Rideout; David Porter,1,0,36,35
1656180711426,MATH 18,B06,093474,Rideout; David Porter,2,0,36,34
1656180717454,MATH 20A,A01,083754,Zheng; Zequn,11,0,40,29
1656180723482,MATH 20B,A01,083756,Briones; Jor-el Thomas Caparas,0,0,36,36
1656180723482,MATH 20B,A02,083757,Briones; Jor-el Thomas Caparas,0,0,36,36
1656180723482,MATH 20B,A03,093475,Staff,1,0,36,35
1656180729506,MATH 20C,A01,083760,Briones; Jor-el Thomas Caparas,0,0,35,35
1656180729506,MATH 20C,A02,083761,Briones; Jor-el Thomas Caparas,9,1,35,26
1656180729506,MATH 20C,A03,093476,Staff,0,0,35,35
1656180729506,MATH 20C,B01,083762,Bach; Quang Tran,1,0,30,29
1656180735531,MATH 20D,A01,083765,Tran; Brian Kha,1,0,30,29
1656180735531,MATH 20D,A02,083766,Tran; Brian Kha,0,1,30,30
1656180735531,MATH 20D,A03,083767,Tran; Brian Kha,2,0,30,28
1656180741561,MATH 20E,A01,083771,Ganguly; Soumya,3,0,32,29
1656180741561,MATH 20E,A02,083772,Ganguly; Soumya,0,0,32,32
1656180741561,MATH 20E,B01,083773,Ciotti; Benjamin,15,0,35,20
1656180741561,MATH 20E,B02,083774,Ciotti; Benjamin,15,0,35,20
1656180747592,MATH 103A,A01,083777,Greenfeld; Be'Eri,1,0,36,35
1656180747592,MATH 103A,A02,083778,Greenfeld; Be'Eri,1,0,36,35
1656180747592,MATH 103A,A03,093561,Staff,5,0,36,31
1656180747592,MATH 103A,B01,083779,Greenfeld; Be'Eri,9,1,36,27
1656180747592,MATH 103A,B02,083780,Greenfeld; Be'Eri,1,0,36,35
1656180747592,MATH 103A,B03,093562,Staff,0,0,36,36
1656180753619,MATH 105,A01,085443,Carter; Anne Toulson,5,1,35,30
1656180753619,MATH 105,A02,093477,Staff,11,0,35,24
1656180759649,MATH 109,A01,083213,Ganzberger; Geoffrey Michael,0,0,34,34
1656180759649,MATH 109,A02,083214,Ganzberger; Geoffrey Michael,0,0,34,34
1656180759649,MATH 109,A03,093478,Staff,1,0,34,33
1656180759649,MATH 109,B01,083215,Ganzberger; Geoffrey Michael,4,0,32,28
1656180759649,MATH 109,B02,083216,Ganzberger; Geoffrey Michael,1,0,32,31
1656180759649,MATH 109,B03,093479,Staff,4,0,32,28
1656180765673,MATH 142A,A01,083219,Chow; Bennett,1,0,32,31
1656180765673,MATH 142A,A02,083220,Chow; Bennett,8,0,32,24
1656180765673,MATH 142A,A03,093480,Staff,5,0,32,27
1656180765673,MATH 142A,B03,093481,Staff,3,0,32,29
1656180765673,MATH 142A,B04,093558,Staff,6,0,32,26
1656180765673,MATH 142A,B05,093559,Staff,1,0,32,31
1656180771697,MATH 193A,A01,083224,Rotar; Vladimir,0,1,34,34
1656180771697,MATH 193A,A02,083225,Rotar; Vladimir,0,0,34,34
1656180771697,MATH 193A,A03,083781,Rotar; Vladimir,0,0,34,34
1656180771697,MATH 193A,A04,083782,Rotar; Vladimir,6,0,34,28
1656180771697,MATH 193A,A05,093482,Rotar; Vladimir,1,0,34,33
1656180777723,MATH 197,001,091859,McAuley; Julian John,9999,0,9999,0
1656180777723,MATH 197,002,095566,Kedlaya; Kiran S.,9997,0,9999,2
1656180777723,MATH 197,003,095567,Xiao; Ming,9999,0,9999,0
1656180777723,MATH 197,004,095571,Perols; Johan Lars,9998,0,9999,1
1656180784780,COGS 9,A01,083615,Shannon; Kyle Michael,4,0,75,71
1656180790804,COGS 11,A01,083617,Boyle; Mary E. T.,14,0,48,34
1656180796827,COGS 13,A01,083071,Bastos; Amalia Pinkusfeld,5,0,71,66
1656180802878,COGS 14A,A01,092681,Semenuks; Arturs,4,15,100,96
1656180808902,COGS 14B,A01,083073,Cheng; Tzu-Han,7,0,63,56
1656180814927,COGS 17,A01,092677,Semenuks; Arturs,7,0,81,74
1656180820950,COGS 100,A01,083619,Allen; Michael Gordon,2,0,70,68
1656180826974,COGS 101A,A01,083621,Davis; Joshua Daniel,4,0,68,64
1656180833067,COGS 101B,A01,091572,Allen; Michael Gordon,5,0,65,60
1656180839089,COGS 101C,A01,083625,Delgado; Tania,10,0,35,25
1656180845111,COGS 107A,A01,083627,Boyle; Mary E. T.,0,0,60,60
1656180851133,COGS 118A,A01,083075,Gupta; Anjum,7,0,76,69
1656180857157,CSE 3,A50,083646,Miranda; Gregory Joseph,18,0,50,32
1656180863186,CSE 8A,A50,083650,Miranda; Gregory Joseph,3,3,56,53
1656180869213,CSE 11,A01,083080,Cao; Yingjun,1,54,40,39
1656180875241,CSE 12,A01,083652,Krause-Levy; Sophia Louisa,7,3,120,113
1656180881265,CSE 15L,A01,083654,Morris; Justin Loren,2,0,50,48
1656180881265,CSE 15L,A02,083655,Morris; Justin Loren,4,0,50,46
1656180887290,CSE 20,A01,083657,Tran; Khoa Dang,31,0,80,49
1656180893314,CSE 21,A01,095574,Bach; Quang Tran,25,0,48,23
1656180899340,CSE 30,A01,083084,Eldon; John,2,8,80,78
1656180899340,CSE 30,B01,095061,Bhaskar; Nishant,1,2,50,49
1656180905373,CSE 100,A01,083659,Cao; Yingjun,2,20,70,68
1656180911397,CSE 134B,A01,083661,Powell; Thomas Allan,3,0,100,97
1656180917420,CSE 140,A01,083663,Gungor; Onat,9,0,85,76
1656180923446,CSE 140L,A01,083088,Eldon; John,8,0,100,92
1656180929475,CSE 175,A01,083665,Kumar; Rakesh,0,0,25,25
1656180935499,CSE 190,A00,092507,Dubnov; Shlomo,3,0,20,17
1656180941534,ECE 45,A01,083139,Congero; Spencer William,1,0,75,74
1656180947561,ECE 65,A50,083695,Saad; Andrew S,9,0,30,21
1656180947561,ECE 65,A51,095125,Staff,23,0,26,3
1656180953588,ECE 109,A01,091882,Touri; Behrouz,0,1,70,70
1656180959615,ECE 180,A00,083140,Abi Samra; Nicholas Camill,1,0,30,29
1656180959615,ECE 180,B00,083141,Abi Samra; Nicholas Camill,0,4,30,30
1656180965639,MATH 10A,A01,083735,Patchell; Gregory David,0,0,30,30
1656180965639,MATH 10A,A02,083736,Patchell; Gregory David,22,0,30,8
1656180965639,MATH 10A,A03,083737,Patchell; Gregory David,16,0,30,14
1656180971680,MATH 10B,A01,083207,Lim; Seonhee,0,0,34,34
1656180971680,MATH 10B,A02,083208,Lim; Seonhee,7,0,35,28
1656180971680,MATH 10B,A03,093472,Staff,1,0,34,33
1656180971680,MATH 10B,B01,083739,Sinha; Shubham,11,0,30,19
1656180977705,MATH 18,A01,083743,Cinel; Cameron Alexander,7,0,30,23
1656180977705,MATH 18,A02,083744,Cinel; Cameron Alexander,10,0,30,20
1656180977705,MATH 18,A03,083745,Cinel; Cameron Alexander,4,0,30,26
1656180977705,MATH 18,B01,083748,Rideout; David Porter,0,0,36,36
1656180977705,MATH 18,B02,083749,Rideout; David Porter,0,0,36,36
1656180977705,MATH 18,B03,083750,Rideout; David Porter,0,0,36,36
1656180977705,MATH 18,B04,083751,Rideout; David Porter,0,0,36,36
1656180977705,MATH 18,B05,093473,Rideout; David Porter,1,0,36,35
1656180977705,MATH 18,B06,093474,Rideout; David Porter,2,0,36,34
1656180983728,MATH 20A,A01,083754,Zheng; Zequn,11,0,40,29
1656180989756,MATH 20B,A01,083756,Briones; Jor-el Thomas Caparas,0,0,36,36
1656180989756,MATH 20B,A02,083757,Briones; Jor-el Thomas Caparas,0,0,36,36
1656180989756,MATH 20B,A03,093475,Staff,1,0,36,35
1656180995780,MATH 20C,A01,083760,Briones; Jor-el Thomas Caparas,0,0,35,35
1656180995780,MATH 20C,A02,083761,Briones; Jor-el Thomas Caparas,9,1,35,26
1656180995780,MATH 20C,A03,093476,Staff,0,0,35,35
1656180995780,MATH 20C,B01,083762,Bach; Quang Tran,1,0,30,29
1656181001805,MATH 20D,A01,083765,Tran; Brian Kha,1,0,30,29
1656181001805,MATH 20D,A02,083766,Tran; Brian Kha,0,1,30,30
1656181001805,MATH 20D,A03,083767,Tran; Brian Kha,2,0,30,28
1656181007832,MATH 20E,A01,083771,Ganguly; Soumya,3,0,32,29
1656181007832,MATH 20E,A02,083772,Ganguly; Soumya,0,0,32,32
1656181007832,MATH 20E,B01,083773,Ciotti; Benjamin,15,0,35,20
1656181007832,MATH 20E,B02,083774,Ciotti; Benjamin,15,0,35,20
1656181013859,MATH 103A,A01,083777,Greenfeld; Be'Eri,1,0,36,35
1656181013859,MATH 103A,A02,083778,Greenfeld; Be'Eri,1,0,36,35
1656181013859,MATH 103A,A03,093561,Staff,5,0,36,31
1656181013859,MATH 103A,B01,083779,Greenfeld; Be'Eri,9,1,36,27
1656181013859,MATH 103A,B02,083780,Greenfeld; Be'Eri,1,0,36,35
1656181013859,MATH 103A,B03,093562,Staff,0,0,36,36
1656181019882,MATH 105,A01,085443,Carter; Anne Toulson,5,1,35,30
1656181019882,MATH 105,A02,093477,Staff,11,0,35,24
1656181025910,MATH 109,A01,083213,Ganzberger; Geoffrey Michael,0,0,34,34
1656181025910,MATH 109,A02,083214,Ganzberger; Geoffrey Michael,0,0,34,34
1656181025910,MATH 109,A03,093478,Staff,1,0,34,33
1656181025910,MATH 109,B01,083215,Ganzberger; Geoffrey Michael,4,0,32,28
1656181025910,MATH 109,B02,083216,Ganzberger; Geoffrey Michael,1,0,32,31
1656181025910,MATH 109,B03,093479,Staff,4,0,32,28
1656181031934,MATH 142A,A01,083219,Chow; Bennett,1,0,32,31
1656181031934,MATH 142A,A02,083220,Chow; Bennett,8,0,32,24
1656181031934,MATH 142A,A03,093480,Staff,5,0,32,27
1656181031934,MATH 142A,B03,093481,Staff,3,0,32,29
1656181031934,MATH 142A,B04,093558,Staff,6,0,32,26
1656181031934,MATH 142A,B05,093559,Staff,1,0,32,31
1656181037962,MATH 193A,A01,083224,Rotar; Vladimir,0,1,34,34
1656181037962,MATH 193A,A02,083225,Rotar; Vladimir,0,0,34,34
1656181037962,MATH 193A,A03,083781,Rotar; Vladimir,0,0,34,34
1656181037962,MATH 193A,A04,083782,Rotar; Vladimir,6,0,34,28
1656181037962,MATH 193A,A05,093482,Rotar; Vladimir,1,0,34,33
1656181043985,MATH 197,001,091859,McAuley; Julian John,9999,0,9999,0
1656181043985,MATH 197,002,095566,Kedlaya; Kiran S.,9997,0,9999,2
1656181043985,MATH 197,003,095567,Xiao; Ming,9999,0,9999,0
1656181043985,MATH 197,004,095571,Perols; Johan Lars,9998,0,9999,1
1656181051055,COGS 9,A01,083615,Shannon; Kyle Michael,4,0,75,71
1656181057078,COGS 11,A01,083617,Boyle; Mary E. T.,14,0,48,34
1656181063101,COGS 13,A01,083071,Bastos; Amalia Pinkusfeld,5,0,71,66
1656181069129,COGS 14A,A01,092681,Semenuks; Arturs,4,15,100,96
1656181075156,COGS 14B,A01,083073,Cheng; Tzu-Han,7,0,63,56
1656181081179,COGS 17,A01,092677,Semenuks; Arturs,7,0,81,74
1656181087202,COGS 100,A01,083619,Allen; Michael Gordon,2,0,70,68
1656181093226,COGS 101A,A01,083621,Davis; Joshua Daniel,4,0,68,64
1656181099250,COGS 101B,A01,091572,Allen; Michael Gordon,5,0,65,60
1656181105272,COGS 101C,A01,083625,Delgado; Tania,10,0,35,25
1656181111299,COGS 107A,A01,083627,Boyle; Mary E. T.,0,0,60,60
1656181117324,COGS 118A,A01,083075,Gupta; Anjum,7,0,76,69
1656181123362,CSE 3,A50,083646,Miranda; Gregory Joseph,18,0,50,32
1656181129384,CSE 8A,A50,083650,Miranda; Gregory Joseph,3,3,56,53
1656181135408,CSE 11,A01,083080,Cao; Yingjun,1,54,40,39
1656181141430,CSE 12,A01,083652,Krause-Levy; Sophia Louisa,7,3,120,113
1656181147455,CSE 15L,A01,083654,Morris; Justin Loren,2,0,50,48
1656181147455,CSE 15L,A02,083655,Morris; Justin Loren,4,0,50,46
1656181153481,CSE 20,A01,083657,Tran; Khoa Dang,31,0,80,49
1656181159507,CSE 21,A01,095574,Bach; Quang Tran,24,0,48,24
1656181165529,CSE 30,A01,083084,Eldon; John,2,8,80,78
1656181165529,CSE 30,B01,095061,Bhaskar; Nishant,1,2,50,49
1656181171555,CSE 100,A01,083659,Cao; Yingjun,2,20,70,68
1656181177577,CSE 134B,A01,083661,Powell; Thomas Allan,3,0,100,97
1656181183604,CSE 140,A01,083663,Gungor; Onat,9,0,85,76
1656181189628,CSE 140L,A01,083088,Eldon; John,8,0,100,92
1656181195654,CSE 175,A01,083665,Kumar; Rakesh,0,0,25,25
1656181201680,CSE 190,A00,092507,Dubnov; Shlomo,3,0,20,17
1656181207703,ECE 45,A01,083139,Congero; Spencer William,1,0,75,74
1656181213730,ECE 65,A50,083695,Saad; Andrew S,9,0,30,21
1656181213730,ECE 65,A51,095125,Staff,23,0,26,3
1656181219755,ECE 109,A01,091882,Touri; Behrouz,0,1,70,70
1656181225779,ECE 180,A00,083140,Abi Samra; Nicholas Camill,1,0,30,29
1656181225779,ECE 180,B00,083141,Abi Samra; Nicholas Camill,0,4,30,30
1656181231803,MATH 10A,A01,083735,Patchell; Gregory David,0,0,30,30
1656181231803,MATH 10A,A02,083736,Patchell; Gregory David,22,0,30,8
1656181231803,MATH 10A,A03,083737,Patchell; Gregory David,16,0,30,14
1656181237825,MATH 10B,A01,083207,Lim; Seonhee,0,0,34,34
1656181237825,MATH 10B,A02,083208,Lim; Seonhee,7,0,35,28
1656181237825,MATH 10B,A03,093472,Staff,1,0,34,33
1656181237825,MATH 10B,B01,083739,Sinha; Shubham,11,0,30,19
1656181243850,MATH 18,A01,083743,Cinel; Cameron Alexander,7,0,30,23
1656181243850,MATH 18,A02,083744,Cinel; Cameron Alexander,10,0,30,20
1656181243850,MATH 18,A03,083745,Cinel; Cameron Alexander,4,0,30,26
1656181243850,MATH 18,B01,083748,Rideout; David Porter,0,0,36,36
1656181243850,MATH 18,B02,083749,Rideout; David Porter,0,0,36,36
1656181243850,MATH 18,B03,083750,Rideout; David Porter,0,0,36,36
1656181243850,MATH 18,B04,083751,Rideout; David Porter,0,0,36,36
1656181243850,MATH 18,B05,093473,Rideout; David Porter,1,0,36,35
1656181243850,MATH 18,B06,093474,Rideout; David Porter,2,0,36,34
1656181249874,MATH 20A,A01,083754,Zheng; Zequn,11,0,40,29
1656181255902,MATH 20B,A01,083756,Briones; Jor-el Thomas Caparas,0,0,36,36
1656181255902,MATH 20B,A02,083757,Briones; Jor-el Thomas Caparas,0,0,36,36
1656181255902,MATH 20B,A03,093475,Staff,1,0,36,35
1656181261929,MATH 20C,A01,083760,Briones; Jor-el Thomas Caparas,0,0,35,35
1656181261929,MATH 20C,A02,083761,Briones; Jor-el Thomas Caparas,9,1,35,26
1656181261929,MATH 20C,A03,093476,Staff,0,0,35,35
1656181261929,MATH 20C,B01,083762,Bach; Quang Tran,1,0,30,29
1656181267963,MATH 20D,A01,083765,Tran; Brian Kha,1,0,30,29
1656181267963,MATH 20D,A02,083766,Tran; Brian Kha,0,1,30,30
1656181267963,MATH 20D,A03,083767,Tran; Brian Kha,2,0,30,28
1656181273987,MATH 20E,A01,083771,Ganguly; Soumya,3,0,32,29
1656181273987,MATH 20E,A02,083772,Ganguly; Soumya,0,0,32,32
1656181273987,MATH 20E,B01,083773,Ciotti; Benjamin,15,0,35,20
1656181273987,MATH 20E,B02,083774,Ciotti; Benjamin,15,0,35,20
1656181280010,MATH 103A,A01,083777,Greenfeld; Be'Eri,1,0,36,35
1656181280010,MATH 103A,A02,083778,Greenfeld; Be'Eri,1,0,36,35
1656181280010,MATH 103A,A03,093561,Staff,5,0,36,31
1656181280010,MATH 103A,B01,083779,Greenfeld; Be'Eri,9,1,36,27
1656181280010,MATH 103A,B02,083780,Greenfeld; Be'Eri,1,0,36,35
1656181280010,MATH 103A,B03,093562,Staff,0,0,36,36
1656181286037,MATH 105,A01,085443,Carter; Anne Toulson,5,1,35,30
1656181286037,MATH 105,A02,093477,Staff,11,0,35,24
1656181292063,MATH 109,A01,083213,Ganzberger; Geoffrey Michael,0,0,34,34
1656181292063,MATH 109,A02,083214,Ganzberger; Geoffrey Michael,0,0,34,34
1656181292063,MATH 109,A03,093478,Staff,1,0,34,33
1656181292063,MATH 109,B01,083215,Ganzberger; Geoffrey Michael,4,0,32,28
1656181292063,MATH 109,B02,083216,Ganzberger; Geoffrey Michael,1,0,32,31
1656181292063,MATH 109,B03,093479,Staff,4,0,32,28
1656181298088,MATH 142A,A01,083219,Chow; Bennett,1,0,32,31
1656181298088,MATH 142A,A02,083220,Chow; Bennett,8,0,32,24
1656181298088,MATH 142A,A03,093480,Staff,5,0,32,27
1656181298088,MATH 142A,B03,093481,Staff,3,0,32,29
1656181298088,MATH 142A,B04,093558,Staff,6,0,32,26
1656181298088,MATH 142A,B05,093559,Staff,1,0,32,31
1656181304119,MATH 193A,A01,083224,Rotar; Vladimir,0,1,34,34
1656181304119,MATH 193A,A02,083225,Rotar; Vladimir,0,0,34,34
1656181304119,MATH 193A,A03,083781,Rotar; Vladimir,0,0,34,34
1656181304119,MATH 193A,A04,083782,Rotar; Vladimir,6,0,34,28
1656181304119,MATH 193A,A05,093482,Rotar; Vladimir,1,0,34,33
1656181310143,MATH 197,001,091859,McAuley; Julian John,9999,0,9999,0
1656181310143,MATH 197,002,095566,Kedlaya; Kiran S.,9997,0,9999,2
1656181310143,MATH 197,003,095567,Xiao; Ming,9999,0,9999,0
1656181310143,MATH 197,004,095571,Perols; Johan Lars,9998,0,9999,1
1656181317199,COGS 9,A01,083615,Shannon; Kyle Michael,4,0,75,71
1656181323225,COGS 11,A01,083617,Boyle; Mary E. T.,14,0,48,34
1656181329252,COGS 13,A01,083071,Bastos; Amalia Pinkusfeld,5,0,71,66
1656181335275,COGS 14A,A01,092681,Semenuks; Arturs,4,15,100,96
1656181341299,COGS 14B,A01,083073,Cheng; Tzu-Han,7,0,63,56
1656181347322,COGS 17,A01,092677,Semenuks; Arturs,7,0,81,74
1656181353355,COGS 100,A01,083619,Allen; Michael Gordon,2,0,70,68
1656181359382,COGS 101A,A01,083621,Davis; Joshua Daniel,4,0,68,64
1656181365415,COGS 101B,A01,091572,Allen; Michael Gordon,5,0,65,60
1656181371440,COGS 101C,A01,083625,Delgado; Tania,10,0,35,25
1656181377467,COGS 107A,A01,083627,Boyle; Mary E. T.,0,0,60,60
1656181383488,COGS 118A,A01,083075,Gupta; Anjum,7,0,76,69
1656181389516,CSE 3,A50,083646,Miranda; Gregory Joseph,18,0,50,32
1656181395543,CSE 8A,A50,083650,Miranda; Gregory Joseph,3,3,56,53
1656181401565,CSE 11,A01,083080,Cao; Yingjun,1,54,40,39
1656181407592,CSE 12,A01,083652,Krause-Levy; Sophia Louisa,7,3,120,113
1656181413618,CSE 15L,A01,083654,Morris; Justin Loren,2,0,50,48
1656181413618,CSE 15L,A02,083655,Morris; Justin Loren,4,0,50,46
1656181419641,CSE 20,A01,083657,Tran; Khoa Dang,31,0,80,49
1656181425670,CSE 21,A01,095574,Bach; Quang Tran,24,0,48,24
1656181431764,CSE 30,A01,083084,Eldon; John,2,8,80,78
1656181431764,CSE 30,B01,095061,Bhaskar; Nishant,1,2,50,49
1656181437788,CSE 100,A01,083659,Cao; Yingjun,2,20,70,68
1656181443810,CSE 134B,A01,083661,Powell; Thomas Allan,3,0,100,97
1656181449856,CSE 140,A01,083663,Gungor; Onat,9,0,85,76
1656181455880,CSE 140L,A01,083088,Eldon; John,8,0,100,92
1656181461910,CSE 175,A01,083665,Kumar; Rakesh,0,0,25,25
1656181467935,CSE 190,A00,092507,Dubnov; Shlomo,3,0,20,17
1656181473959,ECE 45,A01,083139,Congero; Spencer William,1,0,75,74
1656181479982,ECE 65,A50,083695,Saad; Andrew S,9,0,30,21
1656181479982,ECE 65,A51,095125,Staff,23,0,26,3
1656181486011,ECE 109,A01,091882,Touri; Behrouz,0,1,70,70
1656181492034,ECE 180,A00,083140,Abi Samra; Nicholas Camill,1,0,30,29
1656181492034,ECE 180,B00,083141,Abi Samra; Nicholas Camill,0,4,30,30
1656181498058,MATH 10A,A01,083735,Patchell; Gregory David,0,0,30,30
1656181498058,MATH 10A,A02,083736,Patchell; Gregory David,22,0,30,8
1656181498058,MATH 10A,A03,083737,Patchell; Gregory David,16,0,30,14
1656181504085,MATH 10B,A01,083207,Lim; Seonhee,0,0,34,34
1656181504085,MATH 10B,A02,083208,Lim; Seonhee,7,0,35,28
1656181504085,MATH 10B,A03,093472,Staff,1,0,34,33
1656181504085,MATH 10B,B01,083739,Sinha; Shubham,11,0,30,19
1656181510110,MATH 18,A01,083743,Cinel; Cameron Alexander,7,0,30,23
1656181510110,MATH 18,A02,083744,Cinel; Cameron Alexander,10,0,30,20
1656181510110,MATH 18,A03,083745,Cinel; Cameron Alexander,4,0,30,26
1656181510110,MATH 18,B01,083748,Rideout; David Porter,0,0,36,36
1656181510110,MATH 18,B02,083749,Rideout; David Porter,0,0,36,36
1656181510110,MATH 18,B03,083750,Rideout; David Porter,0,0,36,36
1656181510110,MATH 18,B04,083751,Rideout; David Porter,0,0,36,36
1656181510110,MATH 18,B05,093473,Rideout; David Porter,1,0,36,35
1656181510110,MATH 18,B06,093474,Rideout; David Porter,2,0,36,34
1656181516134,MATH 20A,A01,083754,Zheng; Zequn,11,0,40,29
1656181522156,MATH 20B,A01,083756,Briones; Jor-el Thomas Caparas,0,0,36,36
1656181522156,MATH 20B,A02,083757,Briones; Jor-el Thomas Caparas,0,0,36,36
1656181522156,MATH 20B,A03,093475,Staff,1,0,36,35
1656181528179,MATH 20C,A01,083760,Briones; Jor-el Thomas Caparas,0,0,35,35
1656181528179,MATH 20C,A02,083761,Briones; Jor-el Thomas Caparas,9,1,35,26
1656181528179,MATH 20C,A03,093476,Staff,0,0,35,35
1656181528179,MATH 20C,B01,083762,Bach; Quang Tran,1,0,30,29
1656181534208,MATH 20D,A01,083765,Tran; Brian Kha,1,0,30,29
1656181534208,MATH 20D,A02,083766,Tran; Brian Kha,0,1,30,30
1656181534208,MATH 20D,A03,083767,Tran; Brian Kha,2,0,30,28
1656181540235,MATH 20E,A01,083771,Ganguly; Soumya,3,0,32,29
1656181540235,MATH 20E,A02,083772,Ganguly; Soumya,0,0,32,32
1656181540235,MATH 20E,B01,083773,Ciotti; Benjamin,15,0,35,20
1656181540235,MATH 20E,B02,083774,Ciotti; Benjamin,15,0,35,20
1656181546265,MATH 103A,A01,083777,Greenfeld; Be'Eri,1,0,36,35
1656181546265,MATH 103A,A02,083778,Greenfeld; Be'Eri,1,0,36,35
1656181546265,MATH 103A,A03,093561,Staff,5,0,36,31
1656181546265,MATH 103A,B01,083779,Greenfeld; Be'Eri,9,1,36,27
1656181546265,MATH 103A,B02,083780,Greenfeld; Be'Eri,1,0,36,35
1656181546265,MATH 103A,B03,093562,Staff,0,0,36,36
1656181552288,MATH 105,A01,085443,Carter; Anne Toulson,5,1,35,30
1656181552288,MATH 105,A02,093477,Staff,11,0,35,24
1656181558315,MATH 109,A01,083213,Ganzberger; Geoffrey Michael,0,0,34,34
1656181558315,MATH 109,A02,083214,Ganzberger; Geoffrey Michael,0,0,34,34
1656181558315,MATH 109,A03,093478,Staff,1,0,34,33
1656181558315,MATH 109,B01,083215,Ganzberger; Geoffrey Michael,4,0,32,28
1656181558315,MATH 109,B02,083216,Ganzberger; Geoffrey Michael,1,0,32,31
1656181558315,MATH 109,B03,093479,Staff,4,0,32,28
1656181564336,MATH 142A,A01,083219,Chow; Bennett,1,0,32,31
1656181564336,MATH 142A,A02,083220,Chow; Bennett,8,0,32,24
1656181564336,MATH 142A,A03,093480,Staff,5,0,32,27
1656181564336,MATH 142A,B03,093481,Staff,3,0,32,29
1656181564336,MATH 142A,B04,093558,Staff,6,0,32,26
1656181564336,MATH 142A,B05,093559,Staff,1,0,32,31
1656181570373,MATH 193A,A01,083224,Rotar; Vladimir,0,1,34,34
1656181570373,MATH 193A,A02,083225,Rotar; Vladimir,0,0,34,34
1656181570373,MATH 193A,A03,083781,Rotar; Vladimir,0,0,34,34
1656181570373,MATH 193A,A04,083782,Rotar; Vladimir,6,0,34,28
1656181570373,MATH 193A,A05,093482,Rotar; Vladimir,1,0,34,33
1656181576399,MATH 197,001,091859,McAuley; Julian John,9999,0,9999,0
1656181576399,MATH 197,002,095566,Kedlaya; Kiran S.,9997,0,9999,2
1656181576399,MATH 197,003,095567,Xiao; Ming,9999,0,9999,0
1656181576399,MATH 197,004,095571,Perols; Johan Lars,9998,0,9999,1
1656181583457,COGS 9,A01,083615,Shannon; Kyle Michael,4,0,75,71
1656181589484,COGS 11,A01,083617,Boyle; Mary E. T.,14,0,48,34
1656181595511,COGS 13,A01,083071,Bastos; Amalia Pinkusfeld,5,0,71,66
1656181601542,COGS 14A,A01,092681,Semenuks; Arturs,4,15,100,96
1656181607569,COGS 14B,A01,083073,Cheng; Tzu-Han,7,0,63,56
1656181613592,COGS 17,A01,092677,Semenuks; Arturs,7,0,81,74
1656181619615,COGS 100,A01,083619,Allen; Michael Gordon,2,0,70,68
1656181625647,COGS 101A,A01,083621,Davis; Joshua Daniel,4,0,68,64
1656181631673,COGS 101B,A01,091572,Allen; Michael Gordon,5,0,65,60
1656181637700,COGS 101C,A01,083625,Delgado; Tania,10,0,35,25
1656181643730,COGS 107A,A01,083627,Boyle; Mary E. T.,0,0,60,60
1656181649757,COGS 118A,A01,083075,Gupta; Anjum,7,0,76,69
1656181655780,CSE 3,A50,083646,Miranda; Gregory Joseph,18,0,50,32
1656181661804,CSE 8A,A50,083650,Miranda; Gregory Joseph,3,3,56,53
1656181667831,CSE 11,A01,083080,Cao; Yingjun,1,54,40,39
1656181673868,CSE 12,A01,083652,Krause-Levy; Sophia Louisa,7,3,120,113
1656181679892,CSE 15L,A01,083654,Morris; Justin Loren,2,0,50,48
1656181679892,CSE 15L,A02,083655,Morris; Justin Loren,4,0,50,46
1656181685916,CSE 20,A01,083657,Tran; Khoa Dang,31,0,80,49
1656181691939,CSE 21,A01,095574,Bach; Quang Tran,24,0,48,24
1656181697965,CSE 30,A01,083084,Eldon; John,2,8,80,78
1656181697965,CSE 30,B01,095061,Bhaskar; Nishant,1,2,50,49
1656181703989,CSE 100,A01,083659,Cao; Yingjun,2,20,70,68
1656181710016,CSE 134B,A01,083661,Powell; Thomas Allan,3,0,100,97
1656181716049,CSE 140,A01,083663,Gungor; Onat,9,0,85,76
1656181722075,CSE 140L,A01,083088,Eldon; John,8,0,100,92
1656181728098,CSE 175,A01,083665,Kumar; Rakesh,0,0,25,25
1656181734127,CSE 190,A00,092507,Dubnov; Shlomo,3,0,20,17
1656181740152,ECE 45,A01,083139,Congero; Spencer William,1,0,75,74
1656181746176,ECE 65,A50,083695,Saad; Andrew S,9,0,30,21
1656181746176,ECE 65,A51,095125,Staff,23,0,26,3
1656181752202,ECE 109,A01,091882,Touri; Behrouz,0,1,70,70
1656181758225,ECE 180,A00,083140,Abi Samra; Nicholas Camill,1,0,30,29
1656181758225,ECE 180,B00,083141,Abi Samra; Nicholas Camill,0,4,30,30
1656181764251,MATH 10A,A01,083735,Patchell; Gregory David,0,0,30,30
1656181764251,MATH 10A,A02,083736,Patchell; Gregory David,22,0,30,8
1656181764251,MATH 10A,A03,083737,Patchell; Gregory David,16,0,30,14
1656181770275,MATH 10B,A01,083207,Lim; Seonhee,0,0,34,34
1656181770275,MATH 10B,A02,083208,Lim; Seonhee,7,0,35,28
1656181770275,MATH 10B,A03,093472,Staff,1,0,34,33
1656181770275,MATH 10B,B01,083739,Sinha; Shubham,11,0,30,19
1656181776299,MATH 18,A01,083743,Cinel; Cameron Alexander,7,0,30,23
1656181776299,MATH 18,A02,083744,Cinel; Cameron Alexander,10,0,30,20
1656181776299,MATH 18,A03,083745,Cinel; Cameron Alexander,4,0,30,26
1656181776299,MATH 18,B01,083748,Rideout; David Porter,0,0,36,36
1656181776299,MATH 18,B02,083749,Rideout; David Porter,0,0,36,36
1656181776299,MATH 18,B03,083750,Rideout; David Porter,0,0,36,36
1656181776299,MATH 18,B04,083751,Rideout; David Porter,0,0,36,36
1656181776299,MATH 18,B05,093473,Rideout; David Porter,1,0,36,35
1656181776299,MATH 18,B06,093474,Rideout; David Porter,2,0,36,34
1656181782330,MATH 20A,A01,083754,Zheng; Zequn,11,0,40,29
1656181788356,MATH 20B,A01,083756,Briones; Jor-el Thomas Caparas,0,0,36,36
1656181788356,MATH 20B,A02,083757,Briones; Jor-el Thomas Caparas,0,0,36,36
1656181788356,MATH 20B,A03,093475,Staff,1,0,36,35
1656181794380,MATH 20C,A01,083760,Briones; Jor-el Thomas Caparas,0,0,35,35
1656181794380,MATH 20C,A02,083761,Briones; Jor-el Thomas Caparas,9,1,35,26
1656181794380,MATH 20C,A03,093476,Staff,0,0,35,35
1656181794380,MATH 20C,B01,083762,Bach; Quang Tran,1,0,30,29
1656181800404,MATH 20D,A01,083765,Tran; Brian Kha,1,0,30,29
1656181800404,MATH 20D,A02,083766,Tran; Brian Kha,0,1,30,30
1656181800404,MATH 20D,A03,083767,Tran; Brian Kha,2,0,30,28
1656181806428,MATH 20E,A01,083771,Ganguly; Soumya,3,0,32,29
1656181806428,MATH 20E,A02,083772,Ganguly; Soumya,0,0,32,32
1656181806428,MATH 20E,B01,083773,Ciotti; Benjamin,15,0,35,20
1656181806428,MATH 20E,B02,083774,Ciotti; Benjamin,15,0,35,20
1656181812453,MATH 103A,A01,083777,Greenfeld; Be'Eri,1,0,36,35
1656181812453,MATH 103A,A02,083778,Greenfeld; Be'Eri,1,0,36,35
1656181812453,MATH 103A,A03,093561,Staff,5,0,36,31
1656181812453,MATH 103A,B01,083779,Greenfeld; Be'Eri,9,1,36,27
1656181812453,MATH 103A,B02,083780,Greenfeld; Be'Eri,1,0,36,35
1656181812453,MATH 103A,B03,093562,Staff,0,0,36,36
1656181818479,MATH 105,A01,085443,Carter; Anne Toulson,5,1,35,30
1656181818479,MATH 105,A02,093477,Staff,11,0,35,24
1656181824508,MATH 109,A01,083213,Ganzberger; Geoffrey Michael,0,0,34,34
1656181824508,MATH 109,A02,083214,Ganzberger; Geoffrey Michael,0,0,34,34
1656181824508,MATH 109,A03,093478,Staff,1,0,34,33
1656181824508,MATH 109,B01,083215,Ganzberger; Geoffrey Michael,4,0,32,28
1656181824508,MATH 109,B02,083216,Ganzberger; Geoffrey Michael,1,0,32,31
1656181824508,MATH 109,B03,093479,Staff,4,0,32,28
1656181830531,MATH 142A,A01,083219,Chow; Bennett,1,0,32,31
1656181830531,MATH 142A,A02,083220,Chow; Bennett,8,0,32,24
1656181830531,MATH 142A,A03,093480,Staff,5,0,32,27
1656181830531,MATH 142A,B03,093481,Staff,3,0,32,29
1656181830531,MATH 142A,B04,093558,Staff,6,0,32,26
1656181830531,MATH 142A,B05,093559,Staff,1,0,32,31
1656181836558,MATH 193A,A01,083224,Rotar; Vladimir,0,1,34,34
1656181836558,MATH 193A,A02,083225,Rotar; Vladimir,0,0,34,34
1656181836558,MATH 193A,A03,083781,Rotar; Vladimir,0,0,34,34
1656181836558,MATH 193A,A04,083782,Rotar; Vladimir,6,0,34,28
1656181836558,MATH 193A,A05,093482,Rotar; Vladimir,1,0,34,33
1656181842583,MATH 197,001,091859,McAuley; Julian John,9999,0,9999,0
1656181842583,MATH 197,002,095566,Kedlaya; Kiran S.,9997,0,9999,2
1656181842583,MATH 197,003,095567,Xiao; Ming,9999,0,9999,0
1656181842583,MATH 197,004,095571,Perols; Johan Lars,9998,0,9999,1
1656181849633,COGS 9,A01,083615,Shannon; Kyle Michael,4,0,75,71
1656181855656,COGS 11,A01,083617,Boyle; Mary E. T.,14,0,48,34
1656181861683,COGS 13,A01,083071,Bastos; Amalia Pinkusfeld,5,0,71,66
1656181867706,COGS 14A,A01,092681,Semenuks; Arturs,4,15,100,96
1656181873729,COGS 14B,A01,083073,Cheng; Tzu-Han,7,0,63,56
1656181879765,COGS 17,A01,092677,Semenuks; Arturs,7,0,81,74
1656181885788,COGS 100,A01,083619,Allen; Michael Gordon,2,0,70,68
1656181891822,COGS 101A,A01,083621,Davis; Joshua Daniel,4,0,68,64
1656181897844,COGS 101B,A01,091572,Allen; Michael Gordon,5,0,65,60
1656181903868,COGS 101C,A01,083625,Delgado; Tania,10,0,35,25
1656181909891,COGS 107A,A01,083627,Boyle; Mary E. T.,0,0,60,60
1656181915914,COGS 118A,A01,083075,Gupta; Anjum,7,0,76,69
1656181921942,CSE 3,A50,083646,Miranda; Gregory Joseph,18,0,50,32
1656181927968,CSE 8A,A50,083650,Miranda; Gregory Joseph,3,3,56,53
1656181933991,CSE 11,A01,083080,Cao; Yingjun,1,53,40,39
1656181940013,CSE 12,A01,083652,Krause-Levy; Sophia Louisa,7,3,120,113
1656181946042,CSE 15L,A01,083654,Morris; Justin Loren,2,0,50,48
1656181946042,CSE 15L,A02,083655,Morris; Justin Loren,4,0,50,46
1656181952070,CSE 20,A01,083657,Tran; Khoa Dang,31,0,80,49
1656181958092,CSE 21,A01,095574,Bach; Quang Tran,24,0,48,24
1656181964117,CSE 30,A01,083084,Eldon; John,2,8,80,78
1656181964117,CSE 30,B01,095061,Bhaskar; Nishant,1,2,50,49
1656181970140,CSE 100,A01,083659,Cao; Yingjun,2,20,70,68
1656181976162,CSE 134B,A01,083661,Powell; Thomas Allan,3,0,100,97
1656181982186,CSE 140,A01,083663,Gungor; Onat,9,0,85,76
1656181988210,CSE 140L,A01,083088,Eldon; John,8,0,100,92
1656181994233,CSE 175,A01,083665,Kumar; Rakesh,0,0,25,25
1656182000260,CSE 190,A00,092507,Dubnov; Shlomo,3,0,20,17
1656182006288,ECE 45,A01,083139,Congero; Spencer William,1,0,75,74
1656182012316,ECE 65,A50,083695,Saad; Andrew S,9,0,30,21
1656182012316,ECE 65,A51,095125,Staff,23,0,26,3
1656182018344,ECE 109,A01,091882,Touri; Behrouz,0,1,70,70
1656182024368,ECE 180,A00,083140,Abi Samra; Nicholas Camill,1,0,30,29
1656182024368,ECE 180,B00,083141,Abi Samra; Nicholas Camill,0,4,30,30
1656182030467,MATH 10A,A01,083735,Patchell; Gregory David,0,0,30,30
1656182030467,MATH 10A,A02,083736,Patchell; Gregory David,22,0,30,8
1656182030467,MATH 10A,A03,083737,Patchell; Gregory David,16,0,30,14
1656182036496,MATH 10B,A01,083207,Lim; Seonhee,0,0,34,34
1656182036496,MATH 10B,A02,083208,Lim; Seonhee,7,0,35,28
1656182036496,MATH 10B,A03,093472,Staff,1,0,34,33
1656182036496,MATH 10B,B01,083739,Sinha; Shubham,11,0,30,19
1656182042522,MATH 18,A01,083743,Cinel; Cameron Alexander,7,0,30,23
1656182042522,MATH 18,A02,083744,Cinel; Cameron Alexander,10,0,30,20
1656182042522,MATH 18,A03,083745,Cinel; Cameron Alexander,4,0,30,26
1656182042522,MATH 18,B01,083748,Rideout; David Porter,0,0,36,36
1656182042522,MATH 18,B02,083749,Rideout; David Porter,0,0,36,36
1656182042522,MATH 18,B03,083750,Rideout; David Porter,0,0,36,36
1656182042522,MATH 18,B04,083751,Rideout; David Porter,0,0,36,36
1656182042522,MATH 18,B05,093473,Rideout; David Porter,1,0,36,35
1656182042522,MATH 18,B06,093474,Rideout; David Porter,2,0,36,34
1656182048548,MATH 20A,A01,083754,Zheng; Zequn,11,0,40,29
1656182054574,MATH 20B,A01,083756,Briones; Jor-el Thomas Caparas,0,0,36,36
1656182054574,MATH 20B,A02,083757,Briones; Jor-el Thomas Caparas,0,0,36,36
1656182054574,MATH 20B,A03,093475,Staff,1,0,36,35
1656182060599,MATH 20C,A01,083760,Briones; Jor-el Thomas Caparas,0,0,35,35
1656182060599,MATH 20C,A02,083761,Briones; Jor-el Thomas Caparas,9,1,35,26
1656182060599,MATH 20C,A03,093476,Staff,0,0,35,35
1656182060599,MATH 20C,B01,083762,Bach; Quang Tran,1,0,30,29
1656182066624,MATH 20D,A01,083765,Tran; Brian Kha,1,0,30,29
1656182066624,MATH 20D,A02,083766,Tran; Brian Kha,0,1,30,30
1656182066624,MATH 20D,A03,083767,Tran; Brian Kha,2,0,30,28
1656182072647,MATH 20E,A01,083771,Ganguly; Soumya,3,0,32,29
1656182072647,MATH 20E,A02,083772,Ganguly; Soumya,0,0,32,32
1656182072647,MATH 20E,B01,083773,Ciotti; Benjamin,15,0,35,20
1656182072647,MATH 20E,B02,083774,Ciotti; Benjamin,15,0,35,20
1656182078672,MATH 103A,A01,083777,Greenfeld; Be'Eri,1,0,36,35
1656182078672,MATH 103A,A02,083778,Greenfeld; Be'Eri,1,0,36,35
1656182078672,MATH 103A,A03,093561,Staff,5,0,36,31
1656182078672,MATH 103A,B01,083779,Greenfeld; Be'Eri,9,1,36,27
1656182078672,MATH 103A,B02,083780,Greenfeld; Be'Eri,1,0,36,35
1656182078672,MATH 103A,B03,093562,Staff,0,0,36,36
1656182084695,MATH 105,A01,085443,Carter; Anne Toulson,5,1,35,30
1656182084695,MATH 105,A02,093477,Staff,11,0,35,24
1656182090724,MATH 109,A01,083213,Ganzberger; Geoffrey Michael,0,0,34,34
1656182090724,MATH 109,A02,083214,Ganzberger; Geoffrey Michael,0,0,34,34
1656182090724,MATH 109,A03,093478,Staff,1,0,34,33
1656182090724,MATH 109,B01,083215,Ganzberger; Geoffrey Michael,4,0,32,28
1656182090724,MATH 109,B02,083216,Ganzberger; Geoffrey Michael,1,0,32,31
1656182090724,MATH 109,B03,093479,Staff,4,0,32,28
1656182096751,MATH 142A,A01,083219,Chow; Bennett,1,0,32,31
1656182096751,MATH 142A,A02,083220,Chow; Bennett,8,0,32,24
1656182096751,MATH 142A,A03,093480,Staff,5,0,32,27
1656182096751,MATH 142A,B03,093481,Staff,3,0,32,29
1656182096751,MATH 142A,B04,093558,Staff,6,0,32,26
1656182096751,MATH 142A,B05,093559,Staff,1,0,32,31
1656182102786,MATH 193A,A01,083224,Rotar; Vladimir,0,1,34,34
1656182102786,MATH 193A,A02,083225,Rotar; Vladimir,0,0,34,34
1656182102786,MATH 193A,A03,083781,Rotar; Vladimir,0,0,34,34
1656182102786,MATH 193A,A04,083782,Rotar; Vladimir,6,0,34,28
1656182102786,MATH 193A,A05,093482,Rotar; Vladimir,1,0,34,33
1656182108809,MATH 197,001,091859,McAuley; Julian John,9999,0,9999,0
1656182108809,MATH 197,002,095566,Kedlaya; Kiran S.,9997,0,9999,2
1656182108809,MATH 197,003,095567,Xiao; Ming,9999,0,9999,0
1656182108809,MATH 197,004,095571,Perols; Johan Lars,9998,0,9999,1
1656182115866,COGS 9,A01,083615,Shannon; Kyle Michael,4,0,75,71
1656182121890,COGS 11,A01,083617,Boyle; Mary E. T.,14,0,48,34
1656182127917,COGS 13,A01,083071,Bastos; Amalia Pinkusfeld,5,0,71,66
1656182133943,COGS 14A,A01,092681,Semenuks; Arturs,4,15,100,96
1656182139966,COGS 14B,A01,083073,Cheng; Tzu-Han,7,0,63,56
1656182146000,COGS 17,A01,092677,Semenuks; Arturs,7,0,81,74
1656182152023,COGS 100,A01,083619,Allen; Michael Gordon,2,0,70,68
1656182158050,COGS 101A,A01,083621,Davis; Joshua Daniel,4,0,68,64
1656182164077,COGS 101B,A01,091572,Allen; Michael Gordon,5,0,65,60
1656182170104,COGS 101C,A01,083625,Delgado; Tania,10,0,35,25
1656182176127,COGS 107A,A01,083627,Boyle; Mary E. T.,0,0,60,60
1656182182156,COGS 118A,A01,083075,Gupta; Anjum,7,0,76,69
1656182188184,CSE 3,A50,083646,Miranda; Gregory Joseph,18,0,50,32
1656182194212,CSE 8A,A50,083650,Miranda; Gregory Joseph,3,3,56,53
1656182200236,CSE 11,A01,083080,Cao; Yingjun,1,53,40,39
1656182206259,CSE 12,A01,083652,Krause-Levy; Sophia Louisa,7,3,120,113
1656182212283,CSE 15L,A01,083654,Morris; Justin Loren,2,0,50,48
1656182212283,CSE 15L,A02,083655,Morris; Justin Loren,4,0,50,46
1656182218310,CSE 20,A01,083657,Tran; Khoa Dang,31,0,80,49
1656182224333,CSE 21,A01,095574,Bach; Quang Tran,24,0,48,24
1656182230359,CSE 30,A01,083084,Eldon; John,2,8,80,78
1656182230359,CSE 30,B01,095061,Bhaskar; Nishant,1,2,50,49
1656182236382,CSE 100,A01,083659,Cao; Yingjun,2,20,70,68
1656182242406,CSE 134B,A01,083661,Powell; Thomas Allan,3,0,100,97
1656182248427,CSE 140,A01,083663,Gungor; Onat,9,0,85,76
1656182254454,CSE 140L,A01,083088,Eldon; John,8,0,100,92
1656182260483,CSE 175,A01,083665,Kumar; Rakesh,0,0,25,25
1656182266507,CSE 190,A00,092507,Dubnov; Shlomo,3,0,20,17
1656182272530,ECE 45,A01,083139,Congero; Spencer William,1,0,75,74
1656182278555,ECE 65,A50,083695,Saad; Andrew S,9,0,30,21
1656182278555,ECE 65,A51,095125,Staff,23,0,26,3
1656182284580,ECE 109,A01,091882,Touri; Behrouz,0,1,70,70
1656182290608,ECE 180,A00,083140,Abi Samra; Nicholas Camill,1,0,30,29
1656182290608,ECE 180,B00,083141,Abi Samra; Nicholas Camill,0,4,30,30
1656182296634,MATH 10A,A01,083735,Patchell; Gregory David,0,0,30,30
1656182296634,MATH 10A,A02,083736,Patchell; Gregory David,22,0,30,8
1656182296634,MATH 10A,A03,083737,Patchell; Gregory David,16,0,30,14
1656182302658,MATH 10B,A01,083207,Lim; Seonhee,0,0,34,34
1656182302658,MATH 10B,A02,083208,Lim; Seonhee,7,0,35,28
1656182302658,MATH 10B,A03,093472,Staff,1,0,34,33
1656182302658,MATH 10B,B01,083739,Sinha; Shubham,11,0,30,19
1656182308683,MATH 18,A01,083743,Cinel; Cameron Alexander,7,0,30,23
1656182308683,MATH 18,A02,083744,Cinel; Cameron Alexander,10,0,30,20
1656182308683,MATH 18,A03,083745,Cinel; Cameron Alexander,4,0,30,26
1656182308683,MATH 18,B01,083748,Rideout; David Porter,0,0,36,36
1656182308683,MATH 18,B02,083749,Rideout; David Porter,0,0,36,36
1656182308683,MATH 18,B03,083750,Rideout; David Porter,0,0,36,36
1656182308683,MATH 18,B04,083751,Rideout; David Porter,0,0,36,36
1656182308683,MATH 18,B05,093473,Rideout; David Porter,1,0,36,35
1656182308683,MATH 18,B06,093474,Rideout; David Porter,2,0,36,34
1656182314710,MATH 20A,A01,083754,Zheng; Zequn,11,0,40,29
1656182320736,MATH 20B,A01,083756,Briones; Jor-el Thomas Caparas,0,0,36,36
1656182320736,MATH 20B,A02,083757,Briones; Jor-el Thomas Caparas,0,0,36,36
1656182320736,MATH 20B,A03,093475,Staff,1,0,36,35
1656182326761,MATH 20C,A01,083760,Briones; Jor-el Thomas Caparas,0,0,35,35
1656182326761,MATH 20C,A02,083761,Briones; Jor-el Thomas Caparas,9,1,35,26
1656182326761,MATH 20C,A03,093476,Staff,0,0,35,35
1656182326761,MATH 20C,B01,083762,Bach; Quang Tran,1,0,30,29
1656182332789,MATH 20D,A01,083765,Tran; Brian Kha,1,0,30,29
1656182332789,MATH 20D,A02,083766,Tran; Brian Kha,0,1,30,30
1656182332789,MATH 20D,A03,083767,Tran; Brian Kha,2,0,30,28
1656182338824,MATH 20E,A01,083771,Ganguly; Soumya,3,0,32,29
1656182338824,MATH 20E,A02,083772,Ganguly; Soumya,0,0,32,32
1656182338824,MATH 20E,B01,083773,Ciotti; Benjamin,15,0,35,20
1656182338824,MATH 20E,B02,083774,Ciotti; Benjamin,15,0,35,20
1656182344848,MATH 103A,A01,083777,Greenfeld; Be'Eri,1,0,36,35
1656182344848,MATH 103A,A02,083778,Greenfeld; Be'Eri,1,0,36,35
1656182344848,MATH 103A,A03,093561,Staff,5,0,36,31
1656182344848,MATH 103A,B01,083779,Greenfeld; Be'Eri,9,1,36,27
1656182344848,MATH 103A,B02,083780,Greenfeld; Be'Eri,1,0,36,35
1656182344848,MATH 103A,B03,093562,Staff,0,0,36,36
1656182350876,MATH 105,A01,085443,Carter; Anne Toulson,5,1,35,30
1656182350876,MATH 105,A02,093477,Staff,11,0,35,24
1656182356908,MATH 109,A01,083213,Ganzberger; Geoffrey Michael,0,0,34,34
1656182356908,MATH 109,A02,083214,Ganzberger; Geoffrey Michael,0,0,34,34
1656182356908,MATH 109,A03,093478,Staff,1,0,34,33
1656182356908,MATH 109,B01,083215,Ganzberger; Geoffrey Michael,4,0,32,28
1656182356908,MATH 109,B02,083216,Ganzberger; Geoffrey Michael,1,0,32,31
1656182356908,MATH 109,B03,093479,Staff,4,0,32,28
1656182362932,MATH 142A,A01,083219,Chow; Bennett,1,0,32,31
1656182362932,MATH 142A,A02,083220,Chow; Bennett,8,0,32,24
1656182362932,MATH 142A,A03,093480,Staff,5,0,32,27
1656182362932,MATH 142A,B03,093481,Staff,3,0,32,29
1656182362932,MATH 142A,B04,093558,Staff,6,0,32,26
1656182362932,MATH 142A,B05,093559,Staff,1,0,32,31
1656182368956,MATH 193A,A01,083224,Rotar; Vladimir,0,1,34,34
1656182368956,MATH 193A,A02,083225,Rotar; Vladimir,0,0,34,34
1656182368956,MATH 193A,A03,083781,Rotar; Vladimir,0,0,34,34
1656182368956,MATH 193A,A04,083782,Rotar; Vladimir,6,0,34,28
1656182368956,MATH 193A,A05,093482,Rotar; Vladimir,1,0,34,33
1656182374983,MATH 197,001,091859,McAuley; Julian John,9999,0,9999,0
1656182374983,MATH 197,002,095566,Kedlaya; Kiran S.,9997,0,9999,2
1656182374983,MATH 197,003,095567,Xiao; Ming,9999,0,9999,0
1656182374983,MATH 197,004,095571,Perols; Johan Lars,9998,0,9999,1
1656182382047,COGS 9,A01,083615,Shannon; Kyle Michael,4,0,75,71
1656182388090,COGS 11,A01,083617,Boyle; Mary E. T.,14,0,48,34
1656182394119,COGS 13,A01,083071,Bastos; Amalia Pinkusfeld,5,0,71,66
1656182400142,COGS 14A,A01,092681,Semenuks; Arturs,4,15,100,96
1656182406166,COGS 14B,A01,083073,Cheng; Tzu-Han,7,0,63,56
1656182412189,COGS 17,A01,092677,Semenuks; Arturs,7,0,81,74
1656182418218,COGS 100,A01,083619,Allen; Michael Gordon,2,0,70,68
1656182424250,COGS 101A,A01,083621,Davis; Joshua Daniel,4,0,68,64
1656182430273,COGS 101B,A01,091572,Allen; Michael Gordon,5,0,65,60
1656182436299,COGS 101C,A01,083625,Delgado; Tania,10,0,35,25
1656182442325,COGS 107A,A01,083627,Boyle; Mary E. T.,0,0,60,60
1656182448351,COGS 118A,A01,083075,Gupta; Anjum,7,0,76,69
1656182454375,CSE 3,A50,083646,Miranda; Gregory Joseph,18,0,50,32
1656182460403,CSE 8A,A50,083650,Miranda; Gregory Joseph,3,3,56,53
1656182466427,CSE 11,A01,083080,Cao; Yingjun,1,53,40,39
1656182472457,CSE 12,A01,083652,Krause-Levy; Sophia Louisa,7,3,120,113
1656182478480,CSE 15L,A01,083654,Morris; Justin Loren,2,0,50,48
1656182478480,CSE 15L,A02,083655,Morris; Justin Loren,4,0,50,46
1656182484504,CSE 20,A01,083657,Tran; Khoa Dang,31,0,80,49
1656182490527,CSE 21,A01,095574,Bach; Quang Tran,24,0,48,24
1656182496556,CSE 30,A01,083084,Eldon; John,2,8,80,78
1656182496556,CSE 30,B01,095061,Bhaskar; Nishant,1,2,50,49
1656182502582,CSE 100,A01,083659,Cao; Yingjun,2,20,70,68
1656182508604,CSE 134B,A01,083661,Powell; Thomas Allan,3,0,100,97
1656182514630,CSE 140,A01,083663,Gungor; Onat,9,0,85,76
1656182520663,CSE 140L,A01,083088,Eldon; John,8,0,100,92
1656182526688,CSE 175,A01,083665,Kumar; Rakesh,0,0,25,25
1656182532710,CSE 190,A00,092507,Dubnov; Shlomo,3,0,20,17
1656182538737,ECE 45,A01,083139,Congero; Spencer William,1,0,75,74
1656182544760,ECE 65,A50,083695,Saad; Andrew S,9,0,30,21
1656182544760,ECE 65,A51,095125,Staff,23,0,26,3
1656182550784,ECE 109,A01,091882,Touri; Behrouz,0,1,70,70
1656182556807,ECE 180,A00,083140,Abi Samra; Nicholas Camill,1,0,30,29
1656182556807,ECE 180,B00,083141,Abi Samra; Nicholas Camill,0,4,30,30
1656182562832,MATH 10A,A01,083735,Patchell; Gregory David,0,0,30,30
1656182562832,MATH 10A,A02,083736,Patchell; Gregory David,22,0,30,8
1656182562832,MATH 10A,A03,083737,Patchell; Gregory David,16,0,30,14
1656182568881,MATH 10B,A01,083207,Lim; Seonhee,0,0,34,34
1656182568881,MATH 10B,A02,083208,Lim; Seonhee,7,0,35,28
1656182568881,MATH 10B,A03,093472,Staff,1,0,34,33
1656182568881,MATH 10B,B01,083739,Sinha; Shubham,11,0,30,19
1656182574907,MATH 18,A01,083743,Cinel; Cameron Alexander,7,0,30,23
1656182574907,MATH 18,A02,083744,Cinel; Cameron Alexander,10,0,30,20
1656182574907,MATH 18,A03,083745,Cinel; Cameron Alexander,4,0,30,26
1656182574907,MATH 18,B01,083748,Rideout; David Porter,0,0,36,36
1656182574907,MATH 18,B02,083749,Rideout; David Porter,0,0,36,36
1656182574907,MATH 18,B03,083750,Rideout; David Porter,0,0,36,36
1656182574907,MATH 18,B04,083751,Rideout; David Porter,0,0,36,36
1656182574907,MATH 18,B05,093473,Rideout; David Porter,1,0,36,35
1656182574907,MATH 18,B06,093474,Rideout; David Porter,2,0,36,34
1656182580934,MATH 20A,A01,083754,Zheng; Zequn,11,0,40,29
1656182586957,MATH 20B,A01,083756,Briones; Jor-el Thomas Caparas,0,0,36,36
1656182586957,MATH 20B,A02,083757,Briones; Jor-el Thomas Caparas,0,0,36,36
1656182586957,MATH 20B,A03,093475,Staff,1,0,36,35
1656182592983,MATH 20C,A01,083760,Briones; Jor-el Thomas Caparas,0,0,35,35
1656182592983,MATH 20C,A02,083761,Briones; Jor-el Thomas Caparas,9,1,35,26
1656182592983,MATH 20C,A03,093476,Staff,0,0,35,35
1656182592983,MATH 20C,B01,083762,Bach; Quang Tran,1,0,30,29
1656182599012,MATH 20D,A01,083765,Tran; Brian Kha,1,0,30,29
1656182599012,MATH 20D,A02,083766,Tran; Brian Kha,0,1,30,30
1656182599012,MATH 20D,A03,083767,Tran; Brian Kha,2,0,30,28
1656182605040,MATH 20E,A01,083771,Ganguly; Soumya,3,0,32,29
1656182605040,MATH 20E,A02,083772,Ganguly; Soumya,0,0,32,32
1656182605040,MATH 20E,B01,083773,Ciotti; Benjamin,15,0,35,20
1656182605040,MATH 20E,B02,083774,Ciotti; Benjamin,15,0,35,20
1656182611064,MATH 103A,A01,083777,Greenfeld; Be'Eri,1,0,36,35
1656182611064,MATH 103A,A02,083778,Greenfeld; Be'Eri,1,0,36,35
1656182611064,MATH 103A,A03,093561,Staff,5,0,36,31
1656182611064,MATH 103A,B01,083779,Greenfeld; Be'Eri,9,1,36,27
1656182611064,MATH 103A,B02,083780,Greenfeld; Be'Eri,1,0,36,35
1656182611064,MATH 103A,B03,093562,Staff,0,0,36,36
1656182617093,MATH 105,A01,085443,Carter; Anne Toulson,5,1,35,30
1656182617093,MATH 105,A02,093477,Staff,11,0,35,24
1656182623119,MATH 109,A01,083213,Ganzberger; Geoffrey Michael,0,0,34,34
1656182623119,MATH 109,A02,083214,Ganzberger; Geoffrey Michael,0,0,34,34
1656182623119,MATH 109,A03,093478,Staff,1,0,34,33
1656182623119,MATH 109,B01,083215,Ganzberger; Geoffrey Michael,4,0,32,28
1656182623119,MATH 109,B02,083216,Ganzberger; Geoffrey Michael,1,0,32,31
1656182623119,MATH 109,B03,093479,Staff,4,0,32,28
1656182629233,MATH 142A,A01,083219,Chow; Bennett,1,0,32,31
1656182629233,MATH 142A,A02,083220,Chow; Bennett,8,0,32,24
1656182629233,MATH 142A,A03,093480,Staff,5,0,32,27
1656182629233,MATH 142A,B03,093481,Staff,3,0,32,29
1656182629233,MATH 142A,B04,093558,Staff,6,0,32,26
1656182629233,MATH 142A,B05,093559,Staff,1,0,32,31
1656182635262,MATH 193A,A01,083224,Rotar; Vladimir,0,1,34,34
1656182635262,MATH 193A,A02,083225,Rotar; Vladimir,0,0,34,34
1656182635262,MATH 193A,A03,083781,Rotar; Vladimir,0,0,34,34
1656182635262,MATH 193A,A04,083782,Rotar; Vladimir,6,0,34,28
1656182635262,MATH 193A,A05,093482,Rotar; Vladimir,1,0,34,33
1656182641284,MATH 197,001,091859,McAuley; Julian John,9999,0,9999,0
1656182641284,MATH 197,002,095566,Kedlaya; Kiran S.,9997,0,9999,2
1656182641284,MATH 197,003,095567,Xiao; Ming,9999,0,9999,0
1656182641284,MATH 197,004,095571,Perols; Johan Lars,9998,0,9999,1
1656182648340,COGS 9,A01,083615,Shannon; Kyle Michael,4,0,75,71
1656182654363,COGS 11,A01,083617,Boyle; Mary E. T.,14,0,48,34
1656182660385,COGS 13,A01,083071,Bastos; Amalia Pinkusfeld,5,0,71,66
1656182666408,COGS 14A,A01,092681,Semenuks; Arturs,4,15,100,96
1656182672431,COGS 14B,A01,083073,Cheng; Tzu-Han,7,0,63,56
1656182678455,COGS 17,A01,092677,Semenuks; Arturs,7,0,81,74
1656182684480,COGS 100,A01,083619,Allen; Michael Gordon,2,0,70,68
1656182690518,COGS 101A,A01,083621,Davis; Joshua Daniel,4,0,68,64
1656182696544,COGS 101B,A01,091572,Allen; Michael Gordon,5,0,65,60
1656182702566,COGS 101C,A01,083625,Delgado; Tania,10,0,35,25
1656182708593,COGS 107A,A01,083627,Boyle; Mary E. T.,0,0,60,60
1656182714616,COGS 118A,A01,083075,Gupta; Anjum,7,0,76,69
1656182720645,CSE 3,A50,083646,Miranda; Gregory Joseph,18,0,50,32
1656182726669,CSE 8A,A50,083650,Miranda; Gregory Joseph,3,3,56,53
1656182732695,CSE 11,A01,083080,Cao; Yingjun,1,53,40,39
1656182738723,CSE 12,A01,083652,Krause-Levy; Sophia Louisa,7,3,120,113
1656182744746,CSE 15L,A01,083654,Morris; Justin Loren,2,0,50,48
1656182744746,CSE 15L,A02,083655,Morris; Justin Loren,4,0,50,46
1656182750770,CSE 20,A01,083657,Tran; Khoa Dang,31,0,80,49
1656182756797,CSE 21,A01,095574,Bach; Quang Tran,24,0,48,24
1656182762821,CSE 30,A01,083084,Eldon; John,2,8,80,78
1656182762821,CSE 30,B01,095061,Bhaskar; Nishant,1,2,50,49
1656182768848,CSE 100,A01,083659,Cao; Yingjun,2,20,70,68
1656182774871,CSE 134B,A01,083661,Powell; Thomas Allan,3,0,100,97
1656182780893,CSE 140,A01,083663,Gungor; Onat,9,0,85,76
1656182786919,CSE 140L,A01,083088,Eldon; John,8,0,100,92
1656182792946,CSE 175,A01,083665,Kumar; Rakesh,0,0,25,25
1656182798974,CSE 190,A00,092507,Dubnov; Shlomo,3,0,20,17
1656182804997,ECE 45,A01,083139,Congero; Spencer William,1,0,75,74
1656182811036,ECE 65,A50,083695,Saad; Andrew S,9,0,30,21
1656182811036,ECE 65,A51,095125,Staff,23,0,26,3
1656182817061,ECE 109,A01,091882,Touri; Behrouz,0,1,70,70
1656182823085,ECE 180,A00,083140,Abi Samra; Nicholas Camill,1,0,30,29
1656182823085,ECE 180,B00,083141,Abi Samra; Nicholas Camill,0,4,30,30
1656182829112,MATH 10A,A01,083735,Patchell; Gregory David,0,0,30,30
1656182829112,MATH 10A,A02,083736,Patchell; Gregory David,22,0,30,8
1656182829112,MATH 10A,A03,083737,Patchell; Gregory David,16,0,30,14
1656182835142,MATH 10B,A01,083207,Lim; Seonhee,0,0,34,34
1656182835142,MATH 10B,A02,083208,Lim; Seonhee,7,0,35,28
1656182835142,MATH 10B,A03,093472,Staff,1,0,34,33
1656182835142,MATH 10B,B01,083739,Sinha; Shubham,11,0,30,19
1656182841175,MATH 18,A01,083743,Cinel; Cameron Alexander,7,0,30,23
1656182841175,MATH 18,A02,083744,Cinel; Cameron Alexander,10,0,30,20
1656182841175,MATH 18,A03,083745,Cinel; Cameron Alexander,4,0,30,26
1656182841175,MATH 18,B01,083748,Rideout; David Porter,0,0,36,36
1656182841175,MATH 18,B02,083749,Rideout; David Porter,0,0,36,36
1656182841175,MATH 18,B03,083750,Rideout; David Porter,0,0,36,36
1656182841175,MATH 18,B04,083751,Rideout; David Porter,0,0,36,36
1656182841175,MATH 18,B05,093473,Rideout; David Porter,1,0,36,35
1656182841175,MATH 18,B06,093474,Rideout; David Porter,2,0,36,34
1656182847199,MATH 20A,A01,083754,Zheng; Zequn,11,0,40,29
1656182853222,MATH 20B,A01,083756,Briones; Jor-el Thomas Caparas,0,0,36,36
1656182853222,MATH 20B,A02,083757,Briones; Jor-el Thomas Caparas,0,0,36,36
1656182853222,MATH 20B,A03,093475,Staff,1,0,36,35
1656182859246,MATH 20C,A01,083760,Briones; Jor-el Thomas Caparas,0,0,35,35
1656182859246,MATH 20C,A02,083761,Briones; Jor-el Thomas Caparas,9,1,35,26
1656182859246,MATH 20C,A03,093476,Staff,0,0,35,35
1656182859246,MATH 20C,B01,083762,Bach; Quang Tran,1,0,30,29
1656182865271,MATH 20D,A01,083765,Tran; Brian Kha,1,0,30,29
1656182865271,MATH 20D,A02,083766,Tran; Brian Kha,0,1,30,30
1656182865271,MATH 20D,A03,083767,Tran; Brian Kha,2,0,30,28
1656182871298,MATH 20E,A01,083771,Ganguly; Soumya,3,0,32,29
1656182871298,MATH 20E,A02,083772,Ganguly; Soumya,0,0,32,32
1656182871298,MATH 20E,B01,083773,Ciotti; Benjamin,15,0,35,20
1656182871298,MATH 20E,B02,083774,Ciotti; Benjamin,15,0,35,20
1656182877321,MATH 103A,A01,083777,Greenfeld; Be'Eri,1,0,36,35
1656182877321,MATH 103A,A02,083778,Greenfeld; Be'Eri,1,0,36,35
1656182877321,MATH 103A,A03,093561,Staff,5,0,36,31
1656182877321,MATH 103A,B01,083779,Greenfeld; Be'Eri,9,1,36,27
1656182877321,MATH 103A,B02,083780,Greenfeld; Be'Eri,1,0,36,35
1656182877321,MATH 103A,B03,093562,Staff,0,0,36,36
1656182883345,MATH 105,A01,085443,Carter; Anne Toulson,5,1,35,30
1656182883345,MATH 105,A02,093477,Staff,11,0,35,24
1656182889371,MATH 109,A01,083213,Ganzberger; Geoffrey Michael,0,0,34,34
1656182889371,MATH 109,A02,083214,Ganzberger; Geoffrey Michael,0,0,34,34
1656182889371,MATH 109,A03,093478,Staff,1,0,34,33
1656182889371,MATH 109,B01,083215,Ganzberger; Geoffrey Michael,4,0,32,28
1656182889371,MATH 109,B02,083216,Ganzberger; Geoffrey Michael,1,0,32,31
1656182889371,MATH 109,B03,093479,Staff,4,0,32,28
1656182895395,MATH 142A,A01,083219,Chow; Bennett,1,0,32,31
1656182895395,MATH 142A,A02,083220,Chow; Bennett,8,0,32,24
1656182895395,MATH 142A,A03,093480,Staff,5,0,32,27
1656182895395,MATH 142A,B03,093481,Staff,3,0,32,29
1656182895395,MATH 142A,B04,093558,Staff,6,0,32,26
1656182895395,MATH 142A,B05,093559,Staff,1,0,32,31
1656182901419,MATH 193A,A01,083224,Rotar; Vladimir,0,1,34,34
1656182901419,MATH 193A,A02,083225,Rotar; Vladimir,0,0,34,34
1656182901419,MATH 193A,A03,083781,Rotar; Vladimir,0,0,34,34
1656182901419,MATH 193A,A04,083782,Rotar; Vladimir,6,0,34,28
1656182901419,MATH 193A,A05,093482,Rotar; Vladimir,1,0,34,33
1656182907445,MATH 197,001,091859,McAuley; Julian John,9999,0,9999,0
1656182907445,MATH 197,002,095566,Kedlaya; Kiran S.,9997,0,9999,2
1656182907445,MATH 197,003,095567,Xiao; Ming,9999,0,9999,0
1656182907445,MATH 197,004,095571,Perols; Johan Lars,9998,0,9999,1
1656182914500,COGS 9,A01,083615,Shannon; Kyle Michael,4,0,75,71
1656182920522,COGS 11,A01,083617,Boyle; Mary E. T.,14,0,48,34
1656182926549,COGS 13,A01,083071,Bastos; Amalia Pinkusfeld,5,0,71,66
1656182932572,COGS 14A,A01,092681,Semenuks; Arturs,4,15,100,96
1656182938596,COGS 14B,A01,083073,Cheng; Tzu-Han,7,0,63,56
1656182944623,COGS 17,A01,092677,Semenuks; Arturs,7,0,81,74
1656182950649,COGS 100,A01,083619,Allen; Michael Gordon,2,0,70,68
1656182956672,COGS 101A,A01,083621,Davis; Joshua Daniel,4,0,68,64
1656182962695,COGS 101B,A01,091572,Allen; Michael Gordon,5,0,65,60
1656182968719,COGS 101C,A01,083625,Delgado; Tania,10,0,35,25
1656182974745,COGS 107A,A01,083627,Boyle; Mary E. T.,0,0,60,60
1656182980769,COGS 118A,A01,083075,Gupta; Anjum,7,0,76,69
1656182986792,CSE 3,A50,083646,Miranda; Gregory Joseph,18,0,50,32
1656182992825,CSE 8A,A50,083650,Miranda; Gregory Joseph,3,3,56,53
1656182998851,CSE 11,A01,083080,Cao; Yingjun,1,53,40,39
1656183004875,CSE 12,A01,083652,Krause-Levy; Sophia Louisa,7,3,120,113
1656183010898,CSE 15L,A01,083654,Morris; Justin Loren,2,0,50,48
1656183010898,CSE 15L,A02,083655,Morris; Justin Loren,4,0,50,46
1656183016920,CSE 20,A01,083657,Tran; Khoa Dang,31,0,80,49
1656183022950,CSE 21,A01,095574,Bach; Quang Tran,24,0,48,24
1656183028978,CSE 30,A01,083084,Eldon; John,2,8,80,78
1656183028978,CSE 30,B01,095061,Bhaskar; Nishant,1,2,50,49
1656183035018,CSE 100,A01,083659,Cao; Yingjun,2,20,70,68
1656183041042,CSE 134B,A01,083661,Powell; Thomas Allan,3,0,100,97
1656183047070,CSE 140,A01,083663,Gungor; Onat,9,0,85,76
1656183053101,CSE 140L,A01,083088,Eldon; John,8,0,100,92
1656183059125,CSE 175,A01,083665,Kumar; Rakesh,0,0,25,25
1656183065148,CSE 190,A00,092507,Dubnov; Shlomo,3,0,20,17
1656183071171,ECE 45,A01,083139,Congero; Spencer William,1,0,75,74
1656183077195,ECE 65,A50,083695,Saad; Andrew S,9,0,30,21
1656183077195,ECE 65,A51,095125,Staff,23,0,26,3
1656183083221,ECE 109,A01,091882,Touri; Behrouz,0,1,70,70
1656183089270,ECE 180,A00,083140,Abi Samra; Nicholas Camill,1,0,30,29
1656183089270,ECE 180,B00,083141,Abi Samra; Nicholas Camill,0,4,30,30
1656183095295,MATH 10A,A01,083735,Patchell; Gregory David,0,0,30,30
1656183095295,MATH 10A,A02,083736,Patchell; Gregory David,22,0,30,8
1656183095295,MATH 10A,A03,083737,Patchell; Gregory David,16,0,30,14
1656183101318,MATH 10B,A01,083207,Lim; Seonhee,0,0,34,34
1656183101318,MATH 10B,A02,083208,Lim; Seonhee,7,0,35,28
1656183101318,MATH 10B,A03,093472,Staff,1,0,34,33
1656183101318,MATH 10B,B01,083739,Sinha; Shubham,11,0,30,19
1656183107344,MATH 18,A01,083743,Cinel; Cameron Alexander,7,0,30,23
1656183107344,MATH 18,A02,083744,Cinel; Cameron Alexander,10,0,30,20
1656183107344,MATH 18,A03,083745,Cinel; Cameron Alexander,4,0,30,26
1656183107344,MATH 18,B01,083748,Rideout; David Porter,0,0,36,36
1656183107344,MATH 18,B02,083749,Rideout; David Porter,0,0,36,36
1656183107344,MATH 18,B03,083750,Rideout; David Porter,0,0,36,36
1656183107344,MATH 18,B04,083751,Rideout; David Porter,0,0,36,36
1656183107344,MATH 18,B05,093473,Rideout; David Porter,1,0,36,35
1656183107344,MATH 18,B06,093474,Rideout; David Porter,2,0,36,34
1656183113367,MATH 20A,A01,083754,Zheng; Zequn,11,0,40,29
1656183119390,MATH 20B,A01,083756,Briones; Jor-el Thomas Caparas,0,0,36,36
1656183119390,MATH 20B,A02,083757,Briones; Jor-el Thomas Caparas,0,0,36,36
1656183119390,MATH 20B,A03,093475,Staff,1,0,36,35
1656183125417,MATH 20C,A01,083760,Briones; Jor-el Thomas Caparas,0,0,35,35
1656183125417,MATH 20C,A02,083761,Briones; Jor-el Thomas Caparas,9,1,35,26
1656183125417,MATH 20C,A03,093476,Staff,0,0,35,35
1656183125417,MATH 20C,B01,083762,Bach; Quang Tran,1,0,30,29
1656183131445,MATH 20D,A01,083765,Tran; Brian Kha,1,0,30,29
1656183131445,MATH 20D,A02,083766,Tran; Brian Kha,0,1,30,30
1656183131445,MATH 20D,A03,083767,Tran; Brian Kha,2,0,30,28
1656183137475,MATH 20E,A01,083771,Ganguly; Soumya,3,0,32,29
1656183137475,MATH 20E,A02,083772,Ganguly; Soumya,0,0,32,32
1656183137475,MATH 20E,B01,083773,Ciotti; Benjamin,15,0,35,20
1656183137475,MATH 20E,B02,083774,Ciotti; Benjamin,15,0,35,20
1656183143511,MATH 103A,A01,083777,Greenfeld; Be'Eri,1,0,36,35
1656183143511,MATH 103A,A02,083778,Greenfeld; Be'Eri,1,0,36,35
1656183143511,MATH 103A,A03,093561,Staff,5,0,36,31
1656183143511,MATH 103A,B01,083779,Greenfeld; Be'Eri,9,1,36,27
1656183143511,MATH 103A,B02,083780,Greenfeld; Be'Eri,1,0,36,35
1656183143511,MATH 103A,B03,093562,Staff,0,0,36,36
1656183149535,MATH 105,A01,085443,Carter; Anne Toulson,5,1,35,30
1656183149535,MATH 105,A02,093477,Staff,11,0,35,24
1656183155564,MATH 109,A01,083213,Ganzberger; Geoffrey Michael,0,0,34,34
1656183155564,MATH 109,A02,083214,Ganzberger; Geoffrey Michael,0,0,34,34
1656183155564,MATH 109,A03,093478,Staff,1,0,34,33
1656183155564,MATH 109,B01,083215,Ganzberger; Geoffrey Michael,4,0,32,28
1656183155564,MATH 109,B02,083216,Ganzberger; Geoffrey Michael,1,0,32,31
1656183155564,MATH 109,B03,093479,Staff,4,0,32,28
1656183161586,MATH 142A,A01,083219,Chow; Bennett,1,0,32,31
1656183161586,MATH 142A,A02,083220,Chow; Bennett,8,0,32,24
1656183161586,MATH 142A,A03,093480,Staff,5,0,32,27
1656183161586,MATH 142A,B03,093481,Staff,3,0,32,29
1656183161586,MATH 142A,B04,093558,Staff,6,0,32,26
1656183161586,MATH 142A,B05,093559,Staff,1,0,32,31
1656183167610,MATH 193A,A01,083224,Rotar; Vladimir,0,1,34,34
1656183167610,MATH 193A,A02,083225,Rotar; Vladimir,0,0,34,34
1656183167610,MATH 193A,A03,083781,Rotar; Vladimir,0,0,34,34
1656183167610,MATH 193A,A04,083782,Rotar; Vladimir,6,0,34,28
1656183167610,MATH 193A,A05,093482,Rotar; Vladimir,1,0,34,33
1656183173633,MATH 197,001,091859,McAuley; Julian John,9999,0,9999,0
1656183173633,MATH 197,002,095566,Kedlaya; Kiran S.,9997,0,9999,2
1656183173633,MATH 197,003,095567,Xiao; Ming,9999,0,9999,0
1656183173633,MATH 197,004,095571,Perols; Johan Lars,9998,0,9999,1
1656183180693,COGS 9,A01,083615,Shannon; Kyle Michael,4,0,75,71
1656183186715,COGS 11,A01,083617,Boyle; Mary E. T.,14,0,48,34
1656183192738,COGS 13,A01,083071,Bastos; Amalia Pinkusfeld,5,0,71,66
1656183198765,COGS 14A,A01,092681,Semenuks; Arturs,4,15,100,96
1656183204789,COGS 14B,A01,083073,Cheng; Tzu-Han,7,0,63,56
1656183210811,COGS 17,A01,092677,Semenuks; Arturs,7,0,81,74
1656183216838,COGS 100,A01,083619,Allen; Michael Gordon,2,0,70,68
1656183222964,COGS 101A,A01,083621,Davis; Joshua Daniel,4,0,68,64
1656183228990,COGS 101B,A01,091572,Allen; Michael Gordon,5,0,65,60
1656183235014,COGS 101C,A01,083625,Delgado; Tania,10,0,35,25
1656183241041,COGS 107A,A01,083627,Boyle; Mary E. T.,0,0,60,60
1656183247068,COGS 118A,A01,083075,Gupta; Anjum,7,0,76,69
1656183253096,CSE 3,A50,083646,Miranda; Gregory Joseph,18,0,50,32
1656183259122,CSE 8A,A50,083650,Miranda; Gregory Joseph,3,3,56,53
1656183265146,CSE 11,A01,083080,Cao; Yingjun,1,53,40,39
1656183271169,CSE 12,A01,083652,Krause-Levy; Sophia Louisa,7,3,120,113
1656183277196,CSE 15L,A01,083654,Morris; Justin Loren,2,0,50,48
1656183277196,CSE 15L,A02,083655,Morris; Justin Loren,4,0,50,46
1656183283223,CSE 20,A01,083657,Tran; Khoa Dang,31,0,80,49
1656183289247,CSE 21,A01,095574,Bach; Quang Tran,24,0,48,24
1656183295271,CSE 30,A01,083084,Eldon; John,2,8,80,78
1656183295271,CSE 30,B01,095061,Bhaskar; Nishant,1,2,50,49
1656183301295,CSE 100,A01,083659,Cao; Yingjun,2,20,70,68
1656183307321,CSE 134B,A01,083661,Powell; Thomas Allan,3,0,100,97
1656183313344,CSE 140,A01,083663,Gungor; Onat,9,0,85,76
1656183319367,CSE 140L,A01,083088,Eldon; John,8,0,100,92
1656183325389,CSE 175,A01,083665,Kumar; Rakesh,0,0,25,25
1656183331411,CSE 190,A00,092507,Dubnov; Shlomo,3,0,20,17
1656183337433,ECE 45,A01,083139,Congero; Spencer William,1,0,75,74
1656183343460,ECE 65,A50,083695,Saad; Andrew S,9,0,30,21
1656183343460,ECE 65,A51,095125,Staff,23,0,26,3
1656183349482,ECE 109,A01,091882,Touri; Behrouz,0,1,70,70
1656183355504,ECE 180,A00,083140,Abi Samra; Nicholas Camill,1,0,30,29
1656183355504,ECE 180,B00,083141,Abi Samra; Nicholas Camill,0,4,30,30
1656183361529,MATH 10A,A01,083735,Patchell; Gregory David,0,0,30,30
1656183361529,MATH 10A,A02,083736,Patchell; Gregory David,22,0,30,8
1656183361529,MATH 10A,A03,083737,Patchell; Gregory David,16,0,30,14
1656183367552,MATH 10B,A01,083207,Lim; Seonhee,0,0,34,34
1656183367552,MATH 10B,A02,083208,Lim; Seonhee,7,0,35,28
1656183367552,MATH 10B,A03,093472,Staff,1,0,34,33
1656183367552,MATH 10B,B01,083739,Sinha; Shubham,11,0,30,19
1656183373576,MATH 18,A01,083743,Cinel; Cameron Alexander,7,0,30,23
1656183373576,MATH 18,A02,083744,Cinel; Cameron Alexander,10,0,30,20
1656183373576,MATH 18,A03,083745,Cinel; Cameron Alexander,4,0,30,26
1656183373576,MATH 18,B01,083748,Rideout; David Porter,0,0,36,36
1656183373576,MATH 18,B02,083749,Rideout; David Porter,0,0,36,36
1656183373576,MATH 18,B03,083750,Rideout; David Porter,0,0,36,36
1656183373576,MATH 18,B04,083751,Rideout; David Porter,0,0,36,36
1656183373576,MATH 18,B05,093473,Rideout; David Porter,0,0,36,36
1656183373576,MATH 18,B06,093474,Rideout; David Porter,2,0,36,34
1656183379602,MATH 20A,A01,083754,Zheng; Zequn,11,0,40,29
1656183385625,MATH 20B,A01,083756,Briones; Jor-el Thomas Caparas,0,0,36,36
1656183385625,MATH 20B,A02,083757,Briones; Jor-el Thomas Caparas,0,0,36,36
1656183385625,MATH 20B,A03,093475,Staff,1,0,36,35
1656183391652,MATH 20C,A01,083760,Briones; Jor-el Thomas Caparas,0,0,35,35
1656183391652,MATH 20C,A02,083761,Briones; Jor-el Thomas Caparas,9,1,35,26
1656183391652,MATH 20C,A03,093476,Staff,0,0,35,35
1656183391652,MATH 20C,B01,083762,Bach; Quang Tran,1,0,30,29
1656183397680,MATH 20D,A01,083765,Tran; Brian Kha,1,0,30,29
1656183397680,MATH 20D,A02,083766,Tran; Brian Kha,0,1,30,30
1656183397680,MATH 20D,A03,083767,Tran; Brian Kha,2,0,30,28
1656183403709,MATH 20E,A01,083771,Ganguly; Soumya,3,0,32,29
1656183403709,MATH 20E,A02,083772,Ganguly; Soumya,0,0,32,32
1656183403709,MATH 20E,B01,083773,Ciotti; Benjamin,15,0,35,20
1656183403709,MATH 20E,B02,083774,Ciotti; Benjamin,15,0,35,20
1656183409734,MATH 103A,A01,083777,Greenfeld; Be'Eri,1,0,36,35
1656183409734,MATH 103A,A02,083778,Greenfeld; Be'Eri,1,0,36,35
1656183409734,MATH 103A,A03,093561,Staff,5,0,36,31
1656183409734,MATH 103A,B01,083779,Greenfeld; Be'Eri,9,1,36,27
1656183409734,MATH 103A,B02,083780,Greenfeld; Be'Eri,1,0,36,35
1656183409734,MATH 103A,B03,093562,Staff,0,0,36,36
1656183415760,MATH 105,A01,085443,Carter; Anne Toulson,5,1,35,30
1656183415760,MATH 105,A02,093477,Staff,11,0,35,24
1656183421785,MATH 109,A01,083213,Ganzberger; Geoffrey Michael,0,0,34,34
1656183421785,MATH 109,A02,083214,Ganzberger; Geoffrey Michael,0,0,34,34
1656183421785,MATH 109,A03,093478,Staff,1,0,34,33
1656183421785,MATH 109,B01,083215,Ganzberger; Geoffrey Michael,4,0,32,28
1656183421785,MATH 109,B02,083216,Ganzberger; Geoffrey Michael,1,0,32,31
1656183421785,MATH 109,B03,093479,Staff,4,0,32,28
1656183427809,MATH 142A,A01,083219,Chow; Bennett,1,0,32,31
1656183427809,MATH 142A,A02,083220,Chow; Bennett,8,0,32,24
1656183427809,MATH 142A,A03,093480,Staff,5,0,32,27
1656183427809,MATH 142A,B03,093481,Staff,3,0,32,29
1656183427809,MATH 142A,B04,093558,Staff,6,0,32,26
1656183427809,MATH 142A,B05,093559,Staff,1,0,32,31
1656183433835,MATH 193A,A01,083224,Rotar; Vladimir,0,1,34,34
1656183433835,MATH 193A,A02,083225,Rotar; Vladimir,0,0,34,34
1656183433835,MATH 193A,A03,083781,Rotar; Vladimir,0,0,34,34
1656183433835,MATH 193A,A04,083782,Rotar; Vladimir,6,0,34,28
1656183433835,MATH 193A,A05,093482,Rotar; Vladimir,1,0,34,33
1656183439859,MATH 197,001,091859,McAuley; Julian John,9999,0,9999,0
1656183439859,MATH 197,002,095566,Kedlaya; Kiran S.,9997,0,9999,2
1656183439859,MATH 197,003,095567,Xiao; Ming,9999,0,9999,0
1656183439859,MATH 197,004,095571,Perols; Johan Lars,9998,0,9999,1
1656183446921,COGS 9,A01,083615,Shannon; Kyle Michael,4,0,75,71
1656183452951,COGS 11,A01,083617,Boyle; Mary E. T.,14,0,48,34
1656183458978,COGS 13,A01,083071,Bastos; Amalia Pinkusfeld,5,0,71,66
1656183465003,COGS 14A,A01,092681,Semenuks; Arturs,4,15,100,96
1656183471027,COGS 14B,A01,083073,Cheng; Tzu-Han,7,0,63,56
1656183477050,COGS 17,A01,092677,Semenuks; Arturs,7,0,81,74
1656183483073,COGS 100,A01,083619,Allen; Michael Gordon,2,0,70,68
1656183489096,COGS 101A,A01,083621,Davis; Joshua Daniel,4,0,68,64
1656183495134,COGS 101B,A01,091572,Allen; Michael Gordon,5,0,65,60
1656183501159,COGS 101C,A01,083625,Delgado; Tania,10,0,35,25
1656183507182,COGS 107A,A01,083627,Boyle; Mary E. T.,0,0,60,60
1656183513204,COGS 118A,A01,083075,Gupta; Anjum,7,0,76,69
1656183519227,CSE 3,A50,083646,Miranda; Gregory Joseph,18,0,50,32
1656183525254,CSE 8A,A50,083650,Miranda; Gregory Joseph,3,3,56,53
1656183531285,CSE 11,A01,083080,Cao; Yingjun,1,53,40,39
1656183537308,CSE 12,A01,083652,Krause-Levy; Sophia Louisa,7,3,120,113
1656183543332,CSE 15L,A01,083654,Morris; Justin Loren,2,0,50,48
1656183543332,CSE 15L,A02,083655,Morris; Justin Loren,4,0,50,46
1656183549355,CSE 20,A01,083657,Tran; Khoa Dang,31,0,80,49
1656183555383,CSE 21,A01,095574,Bach; Quang Tran,24,0,48,24
1656183561413,CSE 30,A01,083084,Eldon; John,2,8,80,78
1656183561413,CSE 30,B01,095061,Bhaskar; Nishant,1,2,50,49
1656183567436,CSE 100,A01,083659,Cao; Yingjun,2,20,70,68
1656183573459,CSE 134B,A01,083661,Powell; Thomas Allan,3,0,100,97
1656183579485,CSE 140,A01,083663,Gungor; Onat,9,0,85,76
1656183585515,CSE 140L,A01,083088,Eldon; John,8,0,100,92
1656183591540,CSE 175,A01,083665,Kumar; Rakesh,0,0,25,25
1656183597564,CSE 190,A00,092507,Dubnov; Shlomo,3,0,20,17
1656183603586,ECE 45,A01,083139,Congero; Spencer William,1,0,75,74
1656183609610,ECE 65,A50,083695,Saad; Andrew S,9,0,30,21
1656183609610,ECE 65,A51,095125,Staff,23,0,26,3
1656183615648,ECE 109,A01,091882,Touri; Behrouz,0,1,70,70
1656183621670,ECE 180,A00,083140,Abi Samra; Nicholas Camill,1,0,30,29
1656183621670,ECE 180,B00,083141,Abi Samra; Nicholas Camill,0,4,30,30
1656183627697,MATH 10A,A01,083735,Patchell; Gregory David,0,0,30,30
1656183627697,MATH 10A,A02,083736,Patchell; Gregory David,22,0,30,8
1656183627697,MATH 10A,A03,083737,Patchell; Gregory David,16,0,30,14
1656183633721,MATH 10B,A01,083207,Lim; Seonhee,0,0,34,34
1656183633721,MATH 10B,A02,083208,Lim; Seonhee,7,0,35,28
1656183633721,MATH 10B,A03,093472,Staff,1,0,34,33
1656183633721,MATH 10B,B01,083739,Sinha; Shubham,11,0,30,19
1656183639749,MATH 18,A01,083743,Cinel; Cameron Alexander,7,0,30,23
1656183639749,MATH 18,A02,083744,Cinel; Cameron Alexander,10,0,30,20
1656183639749,MATH 18,A03,083745,Cinel; Cameron Alexander,4,0,30,26
1656183639749,MATH 18,B01,083748,Rideout; David Porter,0,0,36,36
1656183639749,MATH 18,B02,083749,Rideout; David Porter,0,0,36,36
1656183639749,MATH 18,B03,083750,Rideout; David Porter,0,0,36,36
1656183639749,MATH 18,B04,083751,Rideout; David Porter,0,0,36,36
1656183639749,MATH 18,B05,093473,Rideout; David Porter,0,0,36,36
1656183639749,MATH 18,B06,093474,Rideout; David Porter,2,0,36,34
1656183645773,MATH 20A,A01,083754,Zheng; Zequn,11,0,40,29
1656183651799,MATH 20B,A01,083756,Briones; Jor-el Thomas Caparas,0,0,36,36
1656183651799,MATH 20B,A02,083757,Briones; Jor-el Thomas Caparas,0,0,36,36
1656183651799,MATH 20B,A03,093475,Staff,1,0,36,35
1656183657823,MATH 20C,A01,083760,Briones; Jor-el Thomas Caparas,0,0,35,35
1656183657823,MATH 20C,A02,083761,Briones; Jor-el Thomas Caparas,9,1,35,26
1656183657823,MATH 20C,A03,093476,Staff,0,0,35,35
1656183657823,MATH 20C,B01,083762,Bach; Quang Tran,1,0,30,29
1656183663846,MATH 20D,A01,083765,Tran; Brian Kha,1,0,30,29
1656183663846,MATH 20D,A02,083766,Tran; Brian Kha,0,1,30,30
1656183663846,MATH 20D,A03,083767,Tran; Brian Kha,2,0,30,28
1656183669875,MATH 20E,A01,083771,Ganguly; Soumya,3,0,32,29
1656183669875,MATH 20E,A02,083772,Ganguly; Soumya,0,0,32,32
1656183669875,MATH 20E,B01,083773,Ciotti; Benjamin,15,0,35,20
1656183669875,MATH 20E,B02,083774,Ciotti; Benjamin,15,0,35,20
1656183675899,MATH 103A,A01,083777,Greenfeld; Be'Eri,1,0,36,35
1656183675899,MATH 103A,A02,083778,Greenfeld; Be'Eri,1,0,36,35
1656183675899,MATH 103A,A03,093561,Staff,5,0,36,31
1656183675899,MATH 103A,B01,083779,Greenfeld; Be'Eri,9,1,36,27
1656183675899,MATH 103A,B02,083780,Greenfeld; Be'Eri,1,0,36,35
1656183675899,MATH 103A,B03,093562,Staff,0,0,36,36
1656183681927,MATH 105,A01,085443,Carter; Anne Toulson,5,1,35,30
1656183681927,MATH 105,A02,093477,Staff,11,0,35,24
1656183687949,MATH 109,A01,083213,Ganzberger; Geoffrey Michael,0,0,34,34
1656183687949,MATH 109,A02,083214,Ganzberger; Geoffrey Michael,0,0,34,34
1656183687949,MATH 109,A03,093478,Staff,1,0,34,33
1656183687949,MATH 109,B01,083215,Ganzberger; Geoffrey Michael,4,0,32,28
1656183687949,MATH 109,B02,083216,Ganzberger; Geoffrey Michael,1,0,32,31
1656183687949,MATH 109,B03,093479,Staff,4,0,32,28
1656183693978,MATH 142A,A01,083219,Chow; Bennett,1,0,32,31
1656183693978,MATH 142A,A02,083220,Chow; Bennett,8,0,32,24
1656183693978,MATH 142A,A03,093480,Staff,5,0,32,27
1656183693978,MATH 142A,B03,093481,Staff,3,0,32,29
1656183693978,MATH 142A,B04,093558,Staff,6,0,32,26
1656183693978,MATH 142A,B05,093559,Staff,1,0,32,31
1656183700002,MATH 193A,A01,083224,Rotar; Vladimir,0,1,34,34
1656183700002,MATH 193A,A02,083225,Rotar; Vladimir,0,0,34,34
1656183700002,MATH 193A,A03,083781,Rotar; Vladimir,0,0,34,34
1656183700002,MATH 193A,A04,083782,Rotar; Vladimir,6,0,34,28
1656183700002,MATH 193A,A05,093482,Rotar; Vladimir,1,0,34,33
1656183706025,MATH 197,001,091859,McAuley; Julian John,9999,0,9999,0
1656183706025,MATH 197,002,095566,Kedlaya; Kiran S.,9997,0,9999,2
1656183706025,MATH 197,003,095567,Xiao; Ming,9999,0,9999,0
1656183706025,MATH 197,004,095571,Perols; Johan Lars,9998,0,9999,1
1656183713088,COGS 9,A01,083615,Shannon; Kyle Michael,4,0,75,71
1656183719119,COGS 11,A01,083617,Boyle; Mary E. T.,14,0,48,34
1656183725141,COGS 13,A01,083071,Bastos; Amalia Pinkusfeld,5,0,71,66
1656183731178,COGS 14A,A01,092681,Semenuks; Arturs,4,15,100,96
1656183737205,COGS 14B,A01,083073,Cheng; Tzu-Han,7,0,63,56
1656183743228,COGS 17,A01,092677,Semenuks; Arturs,7,0,81,74
1656183749260,COGS 100,A01,083619,Allen; Michael Gordon,2,0,70,68
1656183755287,COGS 101A,A01,083621,Davis; Joshua Daniel,4,0,68,64
1656183761313,COGS 101B,A01,091572,Allen; Michael Gordon,5,0,65,60
1656183767348,COGS 101C,A01,083625,Delgado; Tania,10,0,35,25
1656183773371,COGS 107A,A01,083627,Boyle; Mary E. T.,0,0,60,60
1656183779394,COGS 118A,A01,083075,Gupta; Anjum,7,0,76,69
1656183785418,CSE 3,A50,083646,Miranda; Gregory Joseph,18,0,50,32
1656183791442,CSE 8A,A50,083650,Miranda; Gregory Joseph,3,3,56,53
1656183797475,CSE 11,A01,083080,Cao; Yingjun,1,53,40,39
1656183803502,CSE 12,A01,083652,Krause-Levy; Sophia Louisa,7,3,120,113
1656183809525,CSE 15L,A01,083654,Morris; Justin Loren,2,0,50,48
1656183809525,CSE 15L,A02,083655,Morris; Justin Loren,4,0,50,46
1656183815551,CSE 20,A01,083657,Tran; Khoa Dang,31,0,80,49
1656183821649,CSE 21,A01,095574,Bach; Quang Tran,24,0,48,24
1656183827680,CSE 30,A01,083084,Eldon; John,2,8,80,78
1656183827680,CSE 30,B01,095061,Bhaskar; Nishant,1,2,50,49
1656183833704,CSE 100,A01,083659,Cao; Yingjun,2,20,70,68
1656183839732,CSE 134B,A01,083661,Powell; Thomas Allan,3,0,100,97
1656183845760,CSE 140,A01,083663,Gungor; Onat,9,0,85,76
1656183851792,CSE 140L,A01,083088,Eldon; John,8,0,100,92
1656183857816,CSE 175,A01,083665,Kumar; Rakesh,0,0,25,25
1656183863839,CSE 190,A00,092507,Dubnov; Shlomo,3,0,20,17
1656183869863,ECE 45,A01,083139,Congero; Spencer William,1,0,75,74
1656183875887,ECE 65,A50,083695,Saad; Andrew S,9,0,30,21
1656183875887,ECE 65,A51,095125,Staff,23,0,26,3
1656183881914,ECE 109,A01,091882,Touri; Behrouz,0,1,70,70
1656183887936,ECE 180,A00,083140,Abi Samra; Nicholas Camill,1,0,30,29
1656183887936,ECE 180,B00,083141,Abi Samra; Nicholas Camill,0,4,30,30
1656183893965,MATH 10A,A01,083735,Patchell; Gregory David,0,0,30,30
1656183893965,MATH 10A,A02,083736,Patchell; Gregory David,22,0,30,8
1656183893965,MATH 10A,A03,083737,Patchell; Gregory David,16,0,30,14
1656183899993,MATH 10B,A01,083207,Lim; Seonhee,0,0,34,34
1656183899993,MATH 10B,A02,083208,Lim; Seonhee,7,0,35,28
1656183899993,MATH 10B,A03,093472,Staff,1,0,34,33
1656183899993,MATH 10B,B01,083739,Sinha; Shubham,11,0,30,19
1656183906025,MATH 18,A01,083743,Cinel; Cameron Alexander,7,0,30,23
1656183906025,MATH 18,A02,083744,Cinel; Cameron Alexander,10,0,30,20
1656183906025,MATH 18,A03,083745,Cinel; Cameron Alexander,4,0,30,26
1656183906025,MATH 18,B01,083748,Rideout; David Porter,0,0,36,36
1656183906025,MATH 18,B02,083749,Rideout; David Porter,0,0,36,36
1656183906025,MATH 18,B03,083750,Rideout; David Porter,0,0,36,36
1656183906025,MATH 18,B04,083751,Rideout; David Porter,0,0,36,36
1656183906025,MATH 18,B05,093473,Rideout; David Porter,0,0,36,36
1656183906025,MATH 18,B06,093474,Rideout; David Porter,2,0,36,34
1656183912048,MATH 20A,A01,083754,Zheng; Zequn,11,0,40,29
1656183918072,MATH 20B,A01,083756,Briones; Jor-el Thomas Caparas,0,0,36,36
1656183918072,MATH 20B,A02,083757,Briones; Jor-el Thomas Caparas,0,0,36,36
1656183918072,MATH 20B,A03,093475,Staff,1,0,36,35
1656183924097,MATH 20C,A01,083760,Briones; Jor-el Thomas Caparas,0,0,35,35
1656183924097,MATH 20C,A02,083761,Briones; Jor-el Thomas Caparas,9,1,35,26
1656183924097,MATH 20C,A03,093476,Staff,0,0,35,35
1656183924097,MATH 20C,B01,083762,Bach; Quang Tran,1,0,30,29
1656183930120,MATH 20D,A01,083765,Tran; Brian Kha,1,0,30,29
1656183930120,MATH 20D,A02,083766,Tran; Brian Kha,0,1,30,30
1656183930120,MATH 20D,A03,083767,Tran; Brian Kha,2,0,30,28
1656183936144,MATH 20E,A01,083771,Ganguly; Soumya,3,0,32,29
1656183936144,MATH 20E,A02,083772,Ganguly; Soumya,0,0,32,32
1656183936144,MATH 20E,B01,083773,Ciotti; Benjamin,15,0,35,20
1656183936144,MATH 20E,B02,083774,Ciotti; Benjamin,15,0,35,20
1656183942177,MATH 103A,A01,083777,Greenfeld; Be'Eri,1,0,36,35
1656183942177,MATH 103A,A02,083778,Greenfeld; Be'Eri,1,0,36,35
1656183942177,MATH 103A,A03,093561,Staff,5,0,36,31
1656183942177,MATH 103A,B01,083779,Greenfeld; Be'Eri,9,1,36,27
1656183942177,MATH 103A,B02,083780,Greenfeld; Be'Eri,1,0,36,35
1656183942177,MATH 103A,B03,093562,Staff,0,0,36,36
1656183948200,MATH 105,A01,085443,Carter; Anne Toulson,5,1,35,30
1656183948200,MATH 105,A02,093477,Staff,11,0,35,24
1656183954229,MATH 109,A01,083213,Ganzberger; Geoffrey Michael,0,0,34,34
1656183954229,MATH 109,A02,083214,Ganzberger; Geoffrey Michael,0,0,34,34
1656183954229,MATH 109,A03,093478,Staff,1,0,34,33
1656183954229,MATH 109,B01,083215,Ganzberger; Geoffrey Michael,4,0,32,28
1656183954229,MATH 109,B02,083216,Ganzberger; Geoffrey Michael,1,0,32,31
1656183954229,MATH 109,B03,093479,Staff,4,0,32,28
1656183960258,MATH 142A,A01,083219,Chow; Bennett,1,0,32,31
1656183960258,MATH 142A,A02,083220,Chow; Bennett,8,0,32,24
1656183960258,MATH 142A,A03,093480,Staff,5,0,32,27
1656183960258,MATH 142A,B03,093481,Staff,3,0,32,29
1656183960258,MATH 142A,B04,093558,Staff,6,0,32,26
1656183960258,MATH 142A,B05,093559,Staff,1,0,32,31
1656183966282,MATH 193A,A01,083224,Rotar; Vladimir,0,1,34,34
1656183966282,MATH 193A,A02,083225,Rotar; Vladimir,0,0,34,34
1656183966282,MATH 193A,A03,083781,Rotar; Vladimir,0,0,34,34
1656183966282,MATH 193A,A04,083782,Rotar; Vladimir,6,0,34,28
1656183966282,MATH 193A,A05,093482,Rotar; Vladimir,1,0,34,33
1656183972309,MATH 197,001,091859,McAuley; Julian John,9999,0,9999,0
1656183972309,MATH 197,002,095566,Kedlaya; Kiran S.,9997,0,9999,2
1656183972309,MATH 197,003,095567,Xiao; Ming,9999,0,9999,0
1656183972309,MATH 197,004,095571,Perols; Johan Lars,9998,0,9999,1
1656183979379,COGS 9,A01,083615,Shannon; Kyle Michael,4,0,75,71
1656183985408,COGS 11,A01,083617,Boyle; Mary E. T.,14,0,48,34
1656183991431,COGS 13,A01,083071,Bastos; Amalia Pinkusfeld,5,0,71,66
1656183997457,COGS 14A,A01,092681,Semenuks; Arturs,4,15,100,96
1656184003480,COGS 14B,A01,083073,Cheng; Tzu-Han,7,0,63,56
1656184009502,COGS 17,A01,092677,Semenuks; Arturs,7,0,81,74
1656184015530,COGS 100,A01,083619,Allen; Michael Gordon,2,0,70,68
1656184021557,COGS 101A,A01,083621,Davis; Joshua Daniel,4,0,68,64
1656184027580,COGS 101B,A01,091572,Allen; Michael Gordon,5,0,65,60
1656184033603,COGS 101C,A01,083625,Delgado; Tania,10,0,35,25
1656184039627,COGS 107A,A01,083627,Boyle; Mary E. T.,0,0,60,60
1656184045650,COGS 118A,A01,083075,Gupta; Anjum,7,0,76,69
1656184051678,CSE 3,A50,083646,Miranda; Gregory Joseph,18,0,50,32
1656184057713,CSE 8A,A50,083650,Miranda; Gregory Joseph,3,3,56,53
1656184063736,CSE 11,A01,083080,Cao; Yingjun,1,53,40,39
1656184069760,CSE 12,A01,083652,Krause-Levy; Sophia Louisa,7,3,120,113
1656184075784,CSE 15L,A01,083654,Morris; Justin Loren,2,0,50,48
1656184075784,CSE 15L,A02,083655,Morris; Justin Loren,4,0,50,46
1656184081816,CSE 20,A01,083657,Tran; Khoa Dang,30,0,80,50
1656184087841,CSE 21,A01,095574,Bach; Quang Tran,24,0,48,24
1656184093866,CSE 30,A01,083084,Eldon; John,2,8,80,78
1656184093866,CSE 30,B01,095061,Bhaskar; Nishant,1,2,50,49
1656184099892,CSE 100,A01,083659,Cao; Yingjun,2,20,70,68
1656184105916,CSE 134B,A01,083661,Powell; Thomas Allan,3,0,100,97
1656184111943,CSE 140,A01,083663,Gungor; Onat,9,0,85,76
1656184117966,CSE 140L,A01,083088,Eldon; John,8,0,100,92
1656184123992,CSE 175,A01,083665,Kumar; Rakesh,0,0,25,25
1656184130018,CSE 190,A00,092507,Dubnov; Shlomo,3,0,20,17
1656184136041,ECE 45,A01,083139,Congero; Spencer William,1,0,75,74
1656184142065,ECE 65,A50,083695,Saad; Andrew S,9,0,30,21
1656184142065,ECE 65,A51,095125,Staff,23,0,26,3
1656184148095,ECE 109,A01,091882,Touri; Behrouz,0,1,70,70
1656184154116,ECE 180,A00,083140,Abi Samra; Nicholas Camill,1,0,30,29
1656184154116,ECE 180,B00,083141,Abi Samra; Nicholas Camill,0,4,30,30
1656184160144,MATH 10A,A01,083735,Patchell; Gregory David,0,0,30,30
1656184160144,MATH 10A,A02,083736,Patchell; Gregory David,22,0,30,8
1656184160144,MATH 10A,A03,083737,Patchell; Gregory David,16,0,30,14
1656184166170,MATH 10B,A01,083207,Lim; Seonhee,0,0,34,34
1656184166170,MATH 10B,A02,083208,Lim; Seonhee,7,0,35,28
1656184166170,MATH 10B,A03,093472,Staff,1,0,34,33
1656184166170,MATH 10B,B01,083739,Sinha; Shubham,11,0,30,19
1656184172195,MATH 18,A01,083743,Cinel; Cameron Alexander,7,0,30,23
1656184172195,MATH 18,A02,083744,Cinel; Cameron Alexander,10,0,30,20
1656184172195,MATH 18,A03,083745,Cinel; Cameron Alexander,4,0,30,26
1656184172195,MATH 18,B01,083748,Rideout; David Porter,0,0,36,36
1656184172195,MATH 18,B02,083749,Rideout; David Porter,0,0,36,36
1656184172195,MATH 18,B03,083750,Rideout; David Porter,0,0,36,36
1656184172195,MATH 18,B04,083751,Rideout; David Porter,0,0,36,36
1656184172195,MATH 18,B05,093473,Rideout; David Porter,0,0,36,36
1656184172195,MATH 18,B06,093474,Rideout; David Porter,2,0,36,34
1656184178217,MATH 20A,A01,083754,Zheng; Zequn,11,0,40,29
1656184184241,MATH 20B,A01,083756,Briones; Jor-el Thomas Caparas,0,0,36,36
1656184184241,MATH 20B,A02,083757,Briones; Jor-el Thomas Caparas,0,0,36,36
1656184184241,MATH 20B,A03,093475,Staff,1,0,36,35
1656184190263,MATH 20C,A01,083760,Briones; Jor-el Thomas Caparas,0,0,35,35
1656184190263,MATH 20C,A02,083761,Briones; Jor-el Thomas Caparas,9,1,35,26
1656184190263,MATH 20C,A03,093476,Staff,0,0,35,35
1656184190263,MATH 20C,B01,083762,Bach; Quang Tran,1,0,30,29
1656184196305,MATH 20D,A01,083765,Tran; Brian Kha,1,0,30,29
1656184196305,MATH 20D,A02,083766,Tran; Brian Kha,0,1,30,30
1656184196305,MATH 20D,A03,083767,Tran; Brian Kha,2,0,30,28
1656184202330,MATH 20E,A01,083771,Ganguly; Soumya,3,0,32,29
1656184202330,MATH 20E,A02,083772,Ganguly; Soumya,0,0,32,32
1656184202330,MATH 20E,B01,083773,Ciotti; Benjamin,15,0,35,20
1656184202330,MATH 20E,B02,083774,Ciotti; Benjamin,15,0,35,20
1656184208354,MATH 103A,A01,083777,Greenfeld; Be'Eri,1,0,36,35
1656184208354,MATH 103A,A02,083778,Greenfeld; Be'Eri,1,0,36,35
1656184208354,MATH 103A,A03,093561,Staff,5,0,36,31
1656184208354,MATH 103A,B01,083779,Greenfeld; Be'Eri,9,1,36,27
1656184208354,MATH 103A,B02,083780,Greenfeld; Be'Eri,1,0,36,35
1656184208354,MATH 103A,B03,093562,Staff,0,0,36,36
1656184214377,MATH 105,A01,085443,Carter; Anne Toulson,5,1,35,30
1656184214377,MATH 105,A02,093477,Staff,12,0,35,23
1656184220399,MATH 109,A01,083213,Ganzberger; Geoffrey Michael,0,0,34,34
1656184220399,MATH 109,A02,083214,Ganzberger; Geoffrey Michael,0,0,34,34
1656184220399,MATH 109,A03,093478,Staff,1,0,34,33
1656184220399,MATH 109,B01,083215,Ganzberger; Geoffrey Michael,4,0,32,28
1656184220399,MATH 109,B02,083216,Ganzberger; Geoffrey Michael,1,0,32,31
1656184220399,MATH 109,B03,093479,Staff,4,0,32,28
1656184226424,MATH 142A,A01,083219,Chow; Bennett,1,0,32,31
1656184226424,MATH 142A,A02,083220,Chow; Bennett,8,0,32,24
1656184226424,MATH 142A,A03,093480,Staff,5,0,32,27
1656184226424,MATH 142A,B03,093481,Staff,3,0,32,29
1656184226424,MATH 142A,B04,093558,Staff,6,0,32,26
1656184226424,MATH 142A,B05,093559,Staff,1,0,32,31
1656184232449,MATH 193A,A01,083224,Rotar; Vladimir,0,1,34,34
1656184232449,MATH 193A,A02,083225,Rotar; Vladimir,0,0,34,34
1656184232449,MATH 193A,A03,083781,Rotar; Vladimir,0,0,34,34
1656184232449,MATH 193A,A04,083782,Rotar; Vladimir,6,0,34,28
1656184232449,MATH 193A,A05,093482,Rotar; Vladimir,1,0,34,33
1656184238473,MATH 197,001,091859,McAuley; Julian John,9999,0,9999,0
1656184238473,MATH 197,002,095566,Kedlaya; Kiran S.,9997,0,9999,2
1656184238473,MATH 197,003,095567,Xiao; Ming,9999,0,9999,0
1656184238473,MATH 197,004,095571,Perols; Johan Lars,9998,0,9999,1
1656184245534,COGS 9,A01,083615,Shannon; Kyle Michael,4,0,75,71
1656184251557,COGS 11,A01,083617,Boyle; Mary E. T.,14,0,48,34
1656184257580,COGS 13,A01,083071,Bastos; Amalia Pinkusfeld,5,0,71,66
1656184263608,COGS 14A,A01,092681,Semenuks; Arturs,4,15,100,96
1656184269632,COGS 14B,A01,083073,Cheng; Tzu-Han,7,0,63,56
1656184275655,COGS 17,A01,092677,Semenuks; Arturs,7,0,81,74
1656184281679,COGS 100,A01,083619,Allen; Michael Gordon,2,0,70,68
1656184287703,COGS 101A,A01,083621,Davis; Joshua Daniel,4,0,68,64
1656184293730,COGS 101B,A01,091572,Allen; Michael Gordon,5,0,65,60
1656184299759,COGS 101C,A01,083625,Delgado; Tania,10,0,35,25
1656184305784,COGS 107A,A01,083627,Boyle; Mary E. T.,0,0,60,60
1656184311812,COGS 118A,A01,083075,Gupta; Anjum,7,0,76,69
1656184317840,CSE 3,A50,083646,Miranda; Gregory Joseph,18,0,50,32
1656184323865,CSE 8A,A50,083650,Miranda; Gregory Joseph,3,3,56,53
1656184329888,CSE 11,A01,083080,Cao; Yingjun,1,53,40,39
1656184335912,CSE 12,A01,083652,Krause-Levy; Sophia Louisa,7,3,120,113
1656184341936,CSE 15L,A01,083654,Morris; Justin Loren,2,0,50,48
1656184341936,CSE 15L,A02,083655,Morris; Justin Loren,4,0,50,46
1656184347963,CSE 20,A01,083657,Tran; Khoa Dang,30,0,80,50
1656184353987,CSE 21,A01,095574,Bach; Quang Tran,24,0,48,24
1656184360015,CSE 30,A01,083084,Eldon; John,2,8,80,78
1656184360015,CSE 30,B01,095061,Bhaskar; Nishant,1,2,50,49
1656184366052,CSE 100,A01,083659,Cao; Yingjun,2,20,70,68
1656184372075,CSE 134B,A01,083661,Powell; Thomas Allan,3,0,100,97
1656184378103,CSE 140,A01,083663,Gungor; Onat,9,0,85,76
1656184384128,CSE 140L,A01,083088,Eldon; John,8,0,100,92
1656184390156,CSE 175,A01,083665,Kumar; Rakesh,0,0,25,25
1656184396183,CSE 190,A00,092507,Dubnov; Shlomo,3,0,20,17
1656184402209,ECE 45,A01,083139,Congero; Spencer William,1,0,75,74
1656184408233,ECE 65,A50,083695,Saad; Andrew S,9,0,30,21
1656184408233,ECE 65,A51,095125,Staff,23,0,26,3
1656184414257,ECE 109,A01,091882,Touri; Behrouz,0,1,70,70
1656184420355,ECE 180,A00,083140,Abi Samra; Nicholas Camill,1,0,30,29
1656184420355,ECE 180,B00,083141,Abi Samra; Nicholas Camill,0,4,30,30
1656184426380,MATH 10A,A01,083735,Patchell; Gregory David,0,0,30,30
1656184426380,MATH 10A,A02,083736,Patchell; Gregory David,22,0,30,8
1656184426380,MATH 10A,A03,083737,Patchell; Gregory David,16,0,30,14
1656184432406,MATH 10B,A01,083207,Lim; Seonhee,0,0,34,34
1656184432406,MATH 10B,A02,083208,Lim; Seonhee,7,0,35,28
1656184432406,MATH 10B,A03,093472,Staff,1,0,34,33
1656184432406,MATH 10B,B01,083739,Sinha; Shubham,11,0,30,19
1656184438429,MATH 18,A01,083743,Cinel; Cameron Alexander,7,0,30,23
1656184438429,MATH 18,A02,083744,Cinel; Cameron Alexander,10,0,30,20
1656184438429,MATH 18,A03,083745,Cinel; Cameron Alexander,4,0,30,26
1656184438429,MATH 18,B01,083748,Rideout; David Porter,0,0,36,36
1656184438429,MATH 18,B02,083749,Rideout; David Porter,0,0,36,36
1656184438429,MATH 18,B03,083750,Rideout; David Porter,0,0,36,36
1656184438429,MATH 18,B04,083751,Rideout; David Porter,0,0,36,36
1656184438429,MATH 18,B05,093473,Rideout; David Porter,0,0,36,36
1656184438429,MATH 18,B06,093474,Rideout; David Porter,2,0,36,34
1656184444454,MATH 20A,A01,083754,Zheng; Zequn,11,0,40,29
1656184450481,MATH 20B,A01,083756,Briones; Jor-el Thomas Caparas,0,0,36,36
1656184450481,MATH 20B,A02,083757,Briones; Jor-el Thomas Caparas,0,0,36,36
1656184450481,MATH 20B,A03,093475,Staff,1,0,36,35
1656184456504,MATH 20C,A01,083760,Briones; Jor-el Thomas Caparas,0,0,35,35
1656184456504,MATH 20C,A02,083761,Briones; Jor-el Thomas Caparas,9,1,35,26
1656184456504,MATH 20C,A03,093476,Staff,0,0,35,35
1656184456504,MATH 20C,B01,083762,Bach; Quang Tran,1,0,30,29
1656184462526,MATH 20D,A01,083765,Tran; Brian Kha,1,0,30,29
1656184462526,MATH 20D,A02,083766,Tran; Brian Kha,0,1,30,30
1656184462526,MATH 20D,A03,083767,Tran; Brian Kha,2,0,30,28
1656184468555,MATH 20E,A01,083771,Ganguly; Soumya,3,0,32,29
1656184468555,MATH 20E,A02,083772,Ganguly; Soumya,0,0,32,32
1656184468555,MATH 20E,B01,083773,Ciotti; Benjamin,15,0,35,20
1656184468555,MATH 20E,B02,083774,Ciotti; Benjamin,15,0,35,20
1656184474583,MATH 103A,A01,083777,Greenfeld; Be'Eri,1,0,36,35
1656184474583,MATH 103A,A02,083778,Greenfeld; Be'Eri,1,0,36,35
1656184474583,MATH 103A,A03,093561,Staff,5,0,36,31
1656184474583,MATH 103A,B01,083779,Greenfeld; Be'Eri,9,1,36,27
1656184474583,MATH 103A,B02,083780,Greenfeld; Be'Eri,1,0,36,35
1656184474583,MATH 103A,B03,093562,Staff,0,0,36,36
1656184480612,MATH 105,A01,085443,Carter; Anne Toulson,5,1,35,30
1656184480612,MATH 105,A02,093477,Staff,12,0,35,23
1656184486635,MATH 109,A01,083213,Ganzberger; Geoffrey Michael,0,0,34,34
1656184486635,MATH 109,A02,083214,Ganzberger; Geoffrey Michael,0,0,34,34
1656184486635,MATH 109,A03,093478,Staff,1,0,34,33
1656184486635,MATH 109,B01,083215,Ganzberger; Geoffrey Michael,4,0,32,28
1656184486635,MATH 109,B02,083216,Ganzberger; Geoffrey Michael,1,0,32,31
1656184486635,MATH 109,B03,093479,Staff,4,0,32,28
1656184492673,MATH 142A,A01,083219,Chow; Bennett,1,0,32,31
1656184492673,MATH 142A,A02,083220,Chow; Bennett,8,0,32,24
1656184492673,MATH 142A,A03,093480,Staff,5,0,32,27
1656184492673,MATH 142A,B03,093481,Staff,3,0,32,29
1656184492673,MATH 142A,B04,093558,Staff,6,0,32,26
1656184492673,MATH 142A,B05,093559,Staff,1,0,32,31
1656184498702,MATH 193A,A01,083224,Rotar; Vladimir,0,1,34,34
1656184498702,MATH 193A,A02,083225,Rotar; Vladimir,0,0,34,34
1656184498702,MATH 193A,A03,083781,Rotar; Vladimir,0,0,34,34
1656184498702,MATH 193A,A04,083782,Rotar; Vladimir,6,0,34,28
1656184498702,MATH 193A,A05,093482,Rotar; Vladimir,1,0,34,33
1656184504725,MATH 197,001,091859,McAuley; Julian John,9999,0,9999,0
1656184504725,MATH 197,002,095566,Kedlaya; Kiran S.,9997,0,9999,2
1656184504725,MATH 197,003,095567,Xiao; Ming,9999,0,9999,0
1656184504725,MATH 197,004,095571,Perols; Johan Lars,9998,0,9999,1
1656184511782,COGS 9,A01,083615,Shannon; Kyle Michael,4,0,75,71
1656184517808,COGS 11,A01,083617,Boyle; Mary E. T.,14,0,48,34
1656184523834,COGS 13,A01,083071,Bastos; Amalia Pinkusfeld,5,0,71,66
1656184529861,COGS 14A,A01,092681,Semenuks; Arturs,4,15,100,96
1656184535888,COGS 14B,A01,083073,Cheng; Tzu-Han,7,0,63,56
1656184541910,COGS 17,A01,092677,Semenuks; Arturs,7,0,81,74
1656184547937,COGS 100,A01,083619,Allen; Michael Gordon,2,0,70,68
1656184553961,COGS 101A,A01,083621,Davis; Joshua Daniel,4,0,68,64
1656184559988,COGS 101B,A01,091572,Allen; Michael Gordon,5,0,65,60
1656184566012,COGS 101C,A01,083625,Delgado; Tania,10,0,35,25
1656184572043,COGS 107A,A01,083627,Boyle; Mary E. T.,0,0,60,60
1656184578066,COGS 118A,A01,083075,Gupta; Anjum,7,0,76,69
1656184584090,CSE 3,A50,083646,Miranda; Gregory Joseph,18,0,50,32
1656184590114,CSE 8A,A50,083650,Miranda; Gregory Joseph,3,3,56,53
1656184596137,CSE 11,A01,083080,Cao; Yingjun,1,53,40,39
1656184602163,CSE 12,A01,083652,Krause-Levy; Sophia Louisa,7,3,120,113
1656184608187,CSE 15L,A01,083654,Morris; Justin Loren,2,0,50,48
1656184608187,CSE 15L,A02,083655,Morris; Justin Loren,4,0,50,46
1656184614210,CSE 20,A01,083657,Tran; Khoa Dang,30,0,80,50
1656184620238,CSE 21,A01,095574,Bach; Quang Tran,24,0,48,24
1656184626265,CSE 30,A01,083084,Eldon; John,2,8,80,78
1656184626265,CSE 30,B01,095061,Bhaskar; Nishant,1,2,50,49
1656184632289,CSE 100,A01,083659,Cao; Yingjun,2,20,70,68
1656184638312,CSE 134B,A01,083661,Powell; Thomas Allan,3,0,100,97
1656184644335,CSE 140,A01,083663,Gungor; Onat,9,0,85,76
1656184650362,CSE 140L,A01,083088,Eldon; John,8,0,100,92
1656184656384,CSE 175,A01,083665,Kumar; Rakesh,0,0,25,25
1656184662412,CSE 190,A00,092507,Dubnov; Shlomo,3,0,20,17
1656184668435,ECE 45,A01,083139,Congero; Spencer William,1,0,75,74
1656184674463,ECE 65,A50,083695,Saad; Andrew S,9,0,30,21
1656184674463,ECE 65,A51,095125,Staff,23,0,26,3
1656184680485,ECE 109,A01,091882,Touri; Behrouz,0,1,70,70
1656184686509,ECE 180,A00,083140,Abi Samra; Nicholas Camill,1,0,30,29
1656184686509,ECE 180,B00,083141,Abi Samra; Nicholas Camill,0,4,30,30
1656184692533,MATH 10A,A01,083735,Patchell; Gregory David,0,0,30,30
1656184692533,MATH 10A,A02,083736,Patchell; Gregory David,22,0,30,8
1656184692533,MATH 10A,A03,083737,Patchell; Gregory David,16,0,30,14
1656184698566,MATH 10B,A01,083207,Lim; Seonhee,0,0,34,34
1656184698566,MATH 10B,A02,083208,Lim; Seonhee,7,0,35,28
1656184698566,MATH 10B,A03,093472,Staff,1,0,34,33
1656184698566,MATH 10B,B01,083739,Sinha; Shubham,11,0,30,19
1656184704599,MATH 18,A01,083743,Cinel; Cameron Alexander,7,0,30,23
1656184704599,MATH 18,A02,083744,Cinel; Cameron Alexander,10,0,30,20
1656184704599,MATH 18,A03,083745,Cinel; Cameron Alexander,4,0,30,26
1656184704599,MATH 18,B01,083748,Rideout; David Porter,0,0,36,36
1656184704599,MATH 18,B02,083749,Rideout; David Porter,0,0,36,36
1656184704599,MATH 18,B03,083750,Rideout; David Porter,0,0,36,36
1656184704599,MATH 18,B04,083751,Rideout; David Porter,0,0,36,36
1656184704599,MATH 18,B05,093473,Rideout; David Porter,0,0,36,36
1656184704599,MATH 18,B06,093474,Rideout; David Porter,2,0,36,34
1656184710624,MATH 20A,A01,083754,Zheng; Zequn,11,0,40,29
1656184716647,MATH 20B,A01,083756,Briones; Jor-el Thomas Caparas,0,0,36,36
1656184716647,MATH 20B,A02,083757,Briones; Jor-el Thomas Caparas,0,0,36,36
1656184716647,MATH 20B,A03,093475,Staff,1,0,36,35
1656184722670,MATH 20C,A01,083760,Briones; Jor-el Thomas Caparas,0,0,35,35
1656184722670,MATH 20C,A02,083761,Briones; Jor-el Thomas Caparas,9,1,35,26
1656184722670,MATH 20C,A03,093476,Staff,0,0,35,35
1656184722670,MATH 20C,B01,083762,Bach; Quang Tran,1,0,30,29
1656184728695,MATH 20D,A01,083765,Tran; Brian Kha,1,0,30,29
1656184728695,MATH 20D,A02,083766,Tran; Brian Kha,0,1,30,30
1656184728695,MATH 20D,A03,083767,Tran; Brian Kha,2,0,30,28
1656184734723,MATH 20E,A01,083771,Ganguly; Soumya,3,0,32,29
1656184734723,MATH 20E,A02,083772,Ganguly; Soumya,0,0,32,32
1656184734723,MATH 20E,B01,083773,Ciotti; Benjamin,15,0,35,20
1656184734723,MATH 20E,B02,083774,Ciotti; Benjamin,15,0,35,20
1656184740748,MATH 103A,A01,083777,Greenfeld; Be'Eri,1,0,36,35
1656184740748,MATH 103A,A02,083778,Greenfeld; Be'Eri,1,0,36,35
1656184740748,MATH 103A,A03,093561,Staff,5,0,36,31
1656184740748,MATH 103A,B01,083779,Greenfeld; Be'Eri,9,1,36,27
1656184740748,MATH 103A,B02,083780,Greenfeld; Be'Eri,1,0,36,35
1656184740748,MATH 103A,B03,093562,Staff,0,0,36,36
1656184746771,MATH 105,A01,085443,Carter; Anne Toulson,5,1,35,30
1656184746771,MATH 105,A02,093477,Staff,12,0,35,23
1656184752797,MATH 109,A01,083213,Ganzberger; Geoffrey Michael,0,0,34,34
1656184752797,MATH 109,A02,083214,Ganzberger; Geoffrey Michael,0,0,34,34
1656184752797,MATH 109,A03,093478,Staff,1,0,34,33
1656184752797,MATH 109,B01,083215,Ganzberger; Geoffrey Michael,4,0,32,28
1656184752797,MATH 109,B02,083216,Ganzberger; Geoffrey Michael,1,0,32,31
1656184752797,MATH 109,B03,093479,Staff,4,0,32,28
1656184758828,MATH 142A,A01,083219,Chow; Bennett,1,0,32,31
1656184758828,MATH 142A,A02,083220,Chow; Bennett,8,0,32,24
1656184758828,MATH 142A,A03,093480,Staff,5,0,32,27
1656184758828,MATH 142A,B03,093481,Staff,3,0,32,29
1656184758828,MATH 142A,B04,093558,Staff,6,0,32,26
1656184758828,MATH 142A,B05,093559,Staff,1,0,32,31
1656184764863,MATH 193A,A01,083224,Rotar; Vladimir,0,1,34,34
1656184764863,MATH 193A,A02,083225,Rotar; Vladimir,0,0,34,34
1656184764863,MATH 193A,A03,083781,Rotar; Vladimir,0,0,34,34
1656184764863,MATH 193A,A04,083782,Rotar; Vladimir,6,0,34,28
1656184764863,MATH 193A,A05,093482,Rotar; Vladimir,1,0,34,33
1656184770887,MATH 197,001,091859,McAuley; Julian John,9999,0,9999,0
1656184770887,MATH 197,002,095566,Kedlaya; Kiran S.,9997,0,9999,2
1656184770887,MATH 197,003,095567,Xiao; Ming,9999,0,9999,0
1656184770887,MATH 197,004,095571,Perols; Johan Lars,9998,0,9999,1
1656184777954,COGS 9,A01,083615,Shannon; Kyle Michael,4,0,75,71
1656184783978,COGS 11,A01,083617,Boyle; Mary E. T.,14,0,48,34
1656184790003,COGS 13,A01,083071,Bastos; Amalia Pinkusfeld,5,0,71,66
1656184796047,COGS 14A,A01,092681,Semenuks; Arturs,4,15,100,96
1656184802071,COGS 14B,A01,083073,Cheng; Tzu-Han,7,0,63,56
1656184808095,COGS 17,A01,092677,Semenuks; Arturs,7,0,81,74
1656184814123,COGS 100,A01,083619,Allen; Michael Gordon,2,0,70,68
1656184820154,COGS 101A,A01,083621,Davis; Joshua Daniel,4,0,68,64
1656184826175,COGS 101B,A01,091572,Allen; Michael Gordon,5,0,65,60
1656184832198,COGS 101C,A01,083625,Delgado; Tania,10,0,35,25
1656184838224,COGS 107A,A01,083627,Boyle; Mary E. T.,0,0,60,60
1656184844247,COGS 118A,A01,083075,Gupta; Anjum,7,0,76,69
1656184850275,CSE 3,A50,083646,Miranda; Gregory Joseph,18,0,50,32
1656184856298,CSE 8A,A50,083650,Miranda; Gregory Joseph,3,3,56,53
1656184862327,CSE 11,A01,083080,Cao; Yingjun,1,53,40,39
1656184868357,CSE 12,A01,083652,Krause-Levy; Sophia Louisa,7,3,120,113
1656184874384,CSE 15L,A01,083654,Morris; Justin Loren,2,0,50,48
1656184874384,CSE 15L,A02,083655,Morris; Justin Loren,4,0,50,46
1656184880408,CSE 20,A01,083657,Tran; Khoa Dang,30,0,80,50
1656184886430,CSE 21,A01,095574,Bach; Quang Tran,24,0,48,24
1656184892452,CSE 30,A01,083084,Eldon; John,2,8,80,78
1656184892452,CSE 30,B01,095061,Bhaskar; Nishant,1,2,50,49
1656184898480,CSE 100,A01,083659,Cao; Yingjun,2,20,70,68
1656184904504,CSE 134B,A01,083661,Powell; Thomas Allan,3,0,100,97
1656184910528,CSE 140,A01,083663,Gungor; Onat,9,0,85,76
1656184916552,CSE 140L,A01,083088,Eldon; John,8,0,100,92
1656184922576,CSE 175,A01,083665,Kumar; Rakesh,0,0,25,25
1656184928597,CSE 190,A00,092507,Dubnov; Shlomo,3,0,20,17
1656184934621,ECE 45,A01,083139,Congero; Spencer William,1,0,75,74
1656184940648,ECE 65,A50,083695,Saad; Andrew S,9,0,30,21
1656184940648,ECE 65,A51,095125,Staff,23,0,26,3
1656184946670,ECE 109,A01,091882,Touri; Behrouz,0,1,70,70
1656184952697,ECE 180,A00,083140,Abi Samra; Nicholas Camill,1,0,30,29
1656184952697,ECE 180,B00,083141,Abi Samra; Nicholas Camill,0,4,30,30
1656184958720,MATH 10A,A01,083735,Patchell; Gregory David,0,0,30,30
1656184958720,MATH 10A,A02,083736,Patchell; Gregory David,22,0,30,8
1656184958720,MATH 10A,A03,083737,Patchell; Gregory David,16,0,30,14
1656184964748,MATH 10B,A01,083207,Lim; Seonhee,0,0,34,34
1656184964748,MATH 10B,A02,083208,Lim; Seonhee,7,0,35,28
1656184964748,MATH 10B,A03,093472,Staff,1,0,34,33
1656184964748,MATH 10B,B01,083739,Sinha; Shubham,11,0,30,19
1656184970778,MATH 18,A01,083743,Cinel; Cameron Alexander,7,0,30,23
1656184970778,MATH 18,A02,083744,Cinel; Cameron Alexander,10,0,30,20
1656184970778,MATH 18,A03,083745,Cinel; Cameron Alexander,4,0,30,26
1656184970778,MATH 18,B01,083748,Rideout; David Porter,0,0,36,36
1656184970778,MATH 18,B02,083749,Rideout; David Porter,0,0,36,36
1656184970778,MATH 18,B03,083750,Rideout; David Porter,0,0,36,36
1656184970778,MATH 18,B04,083751,Rideout; David Porter,0,0,36,36
1656184970778,MATH 18,B05,093473,Rideout; David Porter,0,0,36,36
1656184970778,MATH 18,B06,093474,Rideout; David Porter,2,0,36,34
1656184976807,MATH 20A,A01,083754,Zheng; Zequn,11,0,40,29
1656184982832,MATH 20B,A01,083756,Briones; Jor-el Thomas Caparas,0,0,36,36
1656184982832,MATH 20B,A02,083757,Briones; Jor-el Thomas Caparas,0,0,36,36
1656184982832,MATH 20B,A03,093475,Staff,1,0,36,35
1656184988860,MATH 20C,A01,083760,Briones; Jor-el Thomas Caparas,0,0,35,35
1656184988860,MATH 20C,A02,083761,Briones; Jor-el Thomas Caparas,9,1,35,26
1656184988860,MATH 20C,A03,093476,Staff,0,0,35,35
1656184988860,MATH 20C,B01,083762,Bach; Quang Tran,1,0,30,29
1656184994889,MATH 20D,A01,083765,Tran; Brian Kha,1,0,30,29
1656184994889,MATH 20D,A02,083766,Tran; Brian Kha,0,1,30,30
1656184994889,MATH 20D,A03,083767,Tran; Brian Kha,2,0,30,28
1656185000918,MATH 20E,A01,083771,Ganguly; Soumya,3,0,32,29
1656185000918,MATH 20E,A02,083772,Ganguly; Soumya,0,0,32,32
1656185000918,MATH 20E,B01,083773,Ciotti; Benjamin,15,0,35,20
1656185000918,MATH 20E,B02,083774,Ciotti; Benjamin,15,0,35,20
1656185006942,MATH 103A,A01,083777,Greenfeld; Be'Eri,1,0,36,35
1656185006942,MATH 103A,A02,083778,Greenfeld; Be'Eri,1,0,36,35
1656185006942,MATH 103A,A03,093561,Staff,5,0,36,31
1656185006942,MATH 103A,B01,083779,Greenfeld; Be'Eri,9,1,36,27
1656185006942,MATH 103A,B02,083780,Greenfeld; Be'Eri,1,0,36,35
1656185006942,MATH 103A,B03,093562,Staff,0,0,36,36
1656185012966,MATH 105,A01,085443,Carter; Anne Toulson,5,1,35,30
1656185012966,MATH 105,A02,093477,Staff,12,0,35,23
1656185019066,MATH 109,A01,083213,Ganzberger; Geoffrey Michael,0,0,34,34
1656185019066,MATH 109,A02,083214,Ganzberger; Geoffrey Michael,0,0,34,34
1656185019066,MATH 109,A03,093478,Staff,1,0,34,33
1656185019066,MATH 109,B01,083215,Ganzberger; Geoffrey Michael,4,0,32,28
1656185019066,MATH 109,B02,083216,Ganzberger; Geoffrey Michael,1,0,32,31
1656185019066,MATH 109,B03,093479,Staff,4,0,32,28
1656185025089,MATH 142A,A01,083219,Chow; Bennett,1,0,32,31
1656185025089,MATH 142A,A02,083220,Chow; Bennett,8,0,32,24
1656185025089,MATH 142A,A03,093480,Staff,5,0,32,27
1656185025089,MATH 142A,B03,093481,Staff,3,0,32,29
1656185025089,MATH 142A,B04,093558,Staff,6,0,32,26
1656185025089,MATH 142A,B05,093559,Staff,1,0,32,31
1656185031113,MATH 193A,A01,083224,Rotar; Vladimir,0,1,34,34
1656185031113,MATH 193A,A02,083225,Rotar; Vladimir,0,0,34,34
1656185031113,MATH 193A,A03,083781,Rotar; Vladimir,0,0,34,34
1656185031113,MATH 193A,A04,083782,Rotar; Vladimir,6,0,34,28
1656185031113,MATH 193A,A05,093482,Rotar; Vladimir,1,0,34,33
1656185037140,MATH 197,001,091859,McAuley; Julian John,9999,0,9999,0
1656185037140,MATH 197,002,095566,Kedlaya; Kiran S.,9997,0,9999,2
1656185037140,MATH 197,003,095567,Xiao; Ming,9999,0,9999,0
1656185037140,MATH 197,004,095571,Perols; Johan Lars,9998,0,9999,1
1656185044208,COGS 9,A01,083615,Shannon; Kyle Michael,4,0,75,71
1656185050232,COGS 11,A01,083617,Boyle; Mary E. T.,14,0,48,34
1656185056255,COGS 13,A01,083071,Bastos; Amalia Pinkusfeld,5,0,71,66
1656185062281,COGS 14A,A01,092681,Semenuks; Arturs,4,15,100,96
1656185068310,COGS 14B,A01,083073,Cheng; Tzu-Han,7,0,63,56
1656185074332,COGS 17,A01,092677,Semenuks; Arturs,7,0,81,74
1656185080356,COGS 100,A01,083619,Allen; Michael Gordon,2,0,70,68
1656185086379,COGS 101A,A01,083621,Davis; Joshua Daniel,4,0,68,64
1656185092404,COGS 101B,A01,091572,Allen; Michael Gordon,5,0,65,60
1656185098427,COGS 101C,A01,083625,Delgado; Tania,10,0,35,25
1656185104451,COGS 107A,A01,083627,Boyle; Mary E. T.,0,0,60,60
1656185110473,COGS 118A,A01,083075,Gupta; Anjum,7,0,76,69
1656185116495,CSE 3,A50,083646,Miranda; Gregory Joseph,18,0,50,32
1656185122517,CSE 8A,A50,083650,Miranda; Gregory Joseph,3,3,56,53
1656185128543,CSE 11,A01,083080,Cao; Yingjun,1,53,40,39
1656185134567,CSE 12,A01,083652,Krause-Levy; Sophia Louisa,7,3,120,113
1656185140590,CSE 15L,A01,083654,Morris; Justin Loren,2,0,50,48
1656185140590,CSE 15L,A02,083655,Morris; Justin Loren,4,0,50,46
1656185146615,CSE 20,A01,083657,Tran; Khoa Dang,30,0,80,50
1656185152643,CSE 21,A01,095574,Bach; Quang Tran,24,0,48,24
1656185158669,CSE 30,A01,083084,Eldon; John,2,8,80,78
1656185158669,CSE 30,B01,095061,Bhaskar; Nishant,1,2,50,49
1656185164692,CSE 100,A01,083659,Cao; Yingjun,2,20,70,68
1656185170719,CSE 134B,A01,083661,Powell; Thomas Allan,3,0,100,97
1656185176742,CSE 140,A01,083663,Gungor; Onat,9,0,85,76
1656185182769,CSE 140L,A01,083088,Eldon; John,8,0,100,92
1656185188800,CSE 175,A01,083665,Kumar; Rakesh,0,0,25,25
1656185194831,CSE 190,A00,092507,Dubnov; Shlomo,3,0,20,17
1656185200858,ECE 45,A01,083139,Congero; Spencer William,1,0,75,74
1656185206886,ECE 65,A50,083695,Saad; Andrew S,9,0,30,21
1656185206886,ECE 65,A51,095125,Staff,23,0,26,3
1656185212912,ECE 109,A01,091882,Touri; Behrouz,0,1,70,70
1656185218938,ECE 180,A00,083140,Abi Samra; Nicholas Camill,1,0,30,29
1656185218938,ECE 180,B00,083141,Abi Samra; Nicholas Camill,0,4,30,30
1656185224962,MATH 10A,A01,083735,Patchell; Gregory David,0,0,30,30
1656185224962,MATH 10A,A02,083736,Patchell; Gregory David,22,0,30,8
1656185224962,MATH 10A,A03,083737,Patchell; Gregory David,16,0,30,14
1656185230985,MATH 10B,A01,083207,Lim; Seonhee,0,0,34,34
1656185230985,MATH 10B,A02,083208,Lim; Seonhee,7,0,35,28
1656185230985,MATH 10B,A03,093472,Staff,1,0,34,33
1656185230985,MATH 10B,B01,083739,Sinha; Shubham,11,0,30,19
1656185237011,MATH 18,A01,083743,Cinel; Cameron Alexander,7,0,30,23
1656185237011,MATH 18,A02,083744,Cinel; Cameron Alexander,10,0,30,20
1656185237011,MATH 18,A03,083745,Cinel; Cameron Alexander,4,0,30,26
1656185237011,MATH 18,B01,083748,Rideout; David Porter,0,0,36,36
1656185237011,MATH 18,B02,083749,Rideout; David Porter,0,0,36,36
1656185237011,MATH 18,B03,083750,Rideout; David Porter,0,0,36,36
1656185237011,MATH 18,B04,083751,Rideout; David Porter,0,0,36,36
1656185237011,MATH 18,B05,093473,Rideout; David Porter,0,0,36,36
1656185237011,MATH 18,B06,093474,Rideout; David Porter,2,0,36,34
1656185243040,MATH 20A,A01,083754,Zheng; Zequn,11,0,40,29
1656185249068,MATH 20B,A01,083756,Briones; Jor-el Thomas Caparas,0,0,36,36
1656185249068,MATH 20B,A02,083757,Briones; Jor-el Thomas Caparas,0,0,36,36
1656185249068,MATH 20B,A03,093475,Staff,1,0,36,35
1656185255098,MATH 20C,A01,083760,Briones; Jor-el Thomas Caparas,0,0,35,35
1656185255098,MATH 20C,A02,083761,Briones; Jor-el Thomas Caparas,9,1,35,26
1656185255098,MATH 20C,A03,093476,Staff,0,0,35,35
1656185255098,MATH 20C,B01,083762,Bach; Quang Tran,1,0,30,29
1656185261121,MATH 20D,A01,083765,Tran; Brian Kha,1,0,30,29
1656185261121,MATH 20D,A02,083766,Tran; Brian Kha,0,1,30,30
1656185261121,MATH 20D,A03,083767,Tran; Brian Kha,2,0,30,28
1656185267156,MATH 20E,A01,083771,Ganguly; Soumya,3,0,32,29
1656185267156,MATH 20E,A02,083772,Ganguly; Soumya,0,0,32,32
1656185267156,MATH 20E,B01,083773,Ciotti; Benjamin,15,0,35,20
1656185267156,MATH 20E,B02,083774,Ciotti; Benjamin,15,0,35,20
1656185273180,MATH 103A,A01,083777,Greenfeld; Be'Eri,1,0,36,35
1656185273180,MATH 103A,A02,083778,Greenfeld; Be'Eri,1,0,36,35
1656185273180,MATH 103A,A03,093561,Staff,5,0,36,31
1656185273180,MATH 103A,B01,083779,Greenfeld; Be'Eri,9,1,36,27
1656185273180,MATH 103A,B02,083780,Greenfeld; Be'Eri,1,0,36,35
1656185273180,MATH 103A,B03,093562,Staff,0,0,36,36
1656185279203,MATH 105,A01,085443,Carter; Anne Toulson,5,1,35,30
1656185279203,MATH 105,A02,093477,Staff,12,0,35,23
1656185285234,MATH 109,A01,083213,Ganzberger; Geoffrey Michael,0,0,34,34
1656185285234,MATH 109,A02,083214,Ganzberger; Geoffrey Michael,0,0,34,34
1656185285234,MATH 109,A03,093478,Staff,1,0,34,33
1656185285234,MATH 109,B01,083215,Ganzberger; Geoffrey Michael,4,0,32,28
1656185285234,MATH 109,B02,083216,Ganzberger; Geoffrey Michael,1,0,32,31
1656185285234,MATH 109,B03,093479,Staff,4,0,32,28
1656185291262,MATH 142A,A01,083219,Chow; Bennett,1,0,32,31
1656185291262,MATH 142A,A02,083220,Chow; Bennett,8,0,32,24
1656185291262,MATH 142A,A03,093480,Staff,5,0,32,27
1656185291262,MATH 142A,B03,093481,Staff,3,0,32,29
1656185291262,MATH 142A,B04,093558,Staff,6,0,32,26
1656185291262,MATH 142A,B05,093559,Staff,1,0,32,31
1656185297290,MATH 193A,A01,083224,Rotar; Vladimir,0,1,34,34
1656185297290,MATH 193A,A02,083225,Rotar; Vladimir,0,0,34,34
1656185297290,MATH 193A,A03,083781,Rotar; Vladimir,0,0,34,34
1656185297290,MATH 193A,A04,083782,Rotar; Vladimir,6,0,34,28
1656185297290,MATH 193A,A05,093482,Rotar; Vladimir,1,0,34,33
1656185303313,MATH 197,001,091859,McAuley; Julian John,9999,0,9999,0
1656185303313,MATH 197,002,095566,Kedlaya; Kiran S.,9997,0,9999,2
1656185303313,MATH 197,003,095567,Xiao; Ming,9999,0,9999,0
1656185303313,MATH 197,004,095571,Perols; Johan Lars,9998,0,9999,1
1656185310386,COGS 9,A01,083615,Shannon; Kyle Michael,4,0,75,71
1656185316410,COGS 11,A01,083617,Boyle; Mary E. T.,14,0,48,34
1656185322436,COGS 13,A01,083071,Bastos; Amalia Pinkusfeld,5,0,71,66
1656185328458,COGS 14A,A01,092681,Semenuks; Arturs,4,15,100,96
1656185334495,COGS 14B,A01,083073,Cheng; Tzu-Han,7,0,63,56
1656185340517,COGS 17,A01,092677,Semenuks; Arturs,7,0,81,74
1656185346540,COGS 100,A01,083619,Allen; Michael Gordon,2,0,70,68
1656185352575,COGS 101A,A01,083621,Davis; Joshua Daniel,4,0,68,64
1656185358599,COGS 101B,A01,091572,Allen; Michael Gordon,5,0,65,60
1656185364624,COGS 101C,A01,083625,Delgado; Tania,10,0,35,25
1656185370652,COGS 107A,A01,083627,Boyle; Mary E. T.,0,0,60,60
1656185376675,COGS 118A,A01,083075,Gupta; Anjum,7,0,76,69
1656185382710,CSE 3,A50,083646,Miranda; Gregory Joseph,18,0,50,32
1656185388740,CSE 8A,A50,083650,Miranda; Gregory Joseph,3,3,56,53
1656185394770,CSE 11,A01,083080,Cao; Yingjun,1,53,40,39
1656185400796,CSE 12,A01,083652,Krause-Levy; Sophia Louisa,7,3,120,113
1656185406840,CSE 15L,A01,083654,Morris; Justin Loren,2,0,50,48
1656185406840,CSE 15L,A02,083655,Morris; Justin Loren,4,0,50,46
1656185412863,CSE 20,A01,083657,Tran; Khoa Dang,30,0,80,50
1656185418890,CSE 21,A01,095574,Bach; Quang Tran,24,0,48,24
1656185424914,CSE 30,A01,083084,Eldon; John,2,8,80,78
1656185424914,CSE 30,B01,095061,Bhaskar; Nishant,1,2,50,49
1656185430942,CSE 100,A01,083659,Cao; Yingjun,2,20,70,68
1656185436966,CSE 134B,A01,083661,Powell; Thomas Allan,3,0,100,97
1656185442993,CSE 140,A01,083663,Gungor; Onat,9,0,85,76
1656185449017,CSE 140L,A01,083088,Eldon; John,8,0,100,92
1656185455045,CSE 175,A01,083665,Kumar; Rakesh,0,0,25,25
1656185461071,CSE 190,A00,092507,Dubnov; Shlomo,3,0,20,17
1656185467096,ECE 45,A01,083139,Congero; Spencer William,1,0,75,74
1656185473122,ECE 65,A50,083695,Saad; Andrew S,9,0,30,21
1656185473122,ECE 65,A51,095125,Staff,23,0,26,3
1656185479146,ECE 109,A01,091882,Touri; Behrouz,0,1,70,70
1656185485173,ECE 180,A00,083140,Abi Samra; Nicholas Camill,1,0,30,29
1656185485173,ECE 180,B00,083141,Abi Samra; Nicholas Camill,0,4,30,30
1656185491197,MATH 10A,A01,083735,Patchell; Gregory David,0,0,30,30
1656185491197,MATH 10A,A02,083736,Patchell; Gregory David,22,0,30,8
1656185491197,MATH 10A,A03,083737,Patchell; Gregory David,16,0,30,14
1656185497221,MATH 10B,A01,083207,Lim; Seonhee,0,0,34,34
1656185497221,MATH 10B,A02,083208,Lim; Seonhee,7,0,35,28
1656185497221,MATH 10B,A03,093472,Staff,1,0,34,33
1656185497221,MATH 10B,B01,083739,Sinha; Shubham,11,0,30,19
1656185503250,MATH 18,A01,083743,Cinel; Cameron Alexander,7,0,30,23
1656185503250,MATH 18,A02,083744,Cinel; Cameron Alexander,10,0,30,20
1656185503250,MATH 18,A03,083745,Cinel; Cameron Alexander,4,0,30,26
1656185503250,MATH 18,B01,083748,Rideout; David Porter,0,0,36,36
1656185503250,MATH 18,B02,083749,Rideout; David Porter,0,0,36,36
1656185503250,MATH 18,B03,083750,Rideout; David Porter,0,0,36,36
1656185503250,MATH 18,B04,083751,Rideout; David Porter,0,0,36,36
1656185503250,MATH 18,B05,093473,Rideout; David Porter,0,0,36,36
1656185503250,MATH 18,B06,093474,Rideout; David Porter,2,0,36,34
1656185509276,MATH 20A,A01,083754,Zheng; Zequn,11,0,40,29
1656185515299,MATH 20B,A01,083756,Briones; Jor-el Thomas Caparas,0,0,36,36
1656185515299,MATH 20B,A02,083757,Briones; Jor-el Thomas Caparas,0,0,36,36
1656185515299,MATH 20B,A03,093475,Staff,1,0,36,35
1656185521327,MATH 20C,A01,083760,Briones; Jor-el Thomas Caparas,0,0,35,35
1656185521327,MATH 20C,A02,083761,Briones; Jor-el Thomas Caparas,9,1,35,26
1656185521327,MATH 20C,A03,093476,Staff,0,0,35,35
1656185521327,MATH 20C,B01,083762,Bach; Quang Tran,1,0,30,29
1656185527353,MATH 20D,A01,083765,Tran; Brian Kha,1,0,30,29
1656185527353,MATH 20D,A02,083766,Tran; Brian Kha,0,1,30,30
1656185527353,MATH 20D,A03,083767,Tran; Brian Kha,2,0,30,28
1656185533381,MATH 20E,A01,083771,Ganguly; Soumya,3,0,32,29
1656185533381,MATH 20E,A02,083772,Ganguly; Soumya,0,0,32,32
1656185533381,MATH 20E,B01,083773,Ciotti; Benjamin,15,0,35,20
1656185533381,MATH 20E,B02,083774,Ciotti; Benjamin,15,0,35,20
1656185539406,MATH 103A,A01,083777,Greenfeld; Be'Eri,1,0,36,35
1656185539406,MATH 103A,A02,083778,Greenfeld; Be'Eri,1,0,36,35
1656185539406,MATH 103A,A03,093561,Staff,5,0,36,31
1656185539406,MATH 103A,B01,083779,Greenfeld; Be'Eri,9,1,36,27
1656185539406,MATH 103A,B02,083780,Greenfeld; Be'Eri,1,0,36,35
1656185539406,MATH 103A,B03,093562,Staff,0,0,36,36
1656185545431,MATH 105,A01,085443,Carter; Anne Toulson,5,1,35,30
1656185545431,MATH 105,A02,093477,Staff,12,0,35,23
1656185551455,MATH 109,A01,083213,Ganzberger; Geoffrey Michael,0,0,34,34
1656185551455,MATH 109,A02,083214,Ganzberger; Geoffrey Michael,0,0,34,34
1656185551455,MATH 109,A03,093478,Staff,1,0,34,33
1656185551455,MATH 109,B01,083215,Ganzberger; Geoffrey Michael,4,0,32,28
1656185551455,MATH 109,B02,083216,Ganzberger; Geoffrey Michael,1,0,32,31
1656185551455,MATH 109,B03,093479,Staff,4,0,32,28
1656185557476,MATH 142A,A01,083219,Chow; Bennett,1,0,32,31
1656185557476,MATH 142A,A02,083220,Chow; Bennett,8,0,32,24
1656185557476,MATH 142A,A03,093480,Staff,5,0,32,27
1656185557476,MATH 142A,B03,093481,Staff,3,0,32,29
1656185557476,MATH 142A,B04,093558,Staff,6,0,32,26
1656185557476,MATH 142A,B05,093559,Staff,1,0,32,31
1656185563505,MATH 193A,A01,083224,Rotar; Vladimir,0,1,34,34
1656185563505,MATH 193A,A02,083225,Rotar; Vladimir,0,0,34,34
1656185563505,MATH 193A,A03,083781,Rotar; Vladimir,0,0,34,34
1656185563505,MATH 193A,A04,083782,Rotar; Vladimir,6,0,34,28
1656185563505,MATH 193A,A05,093482,Rotar; Vladimir,1,0,34,33
1656185569527,MATH 197,001,091859,McAuley; Julian John,9999,0,9999,0
1656185569527,MATH 197,002,095566,Kedlaya; Kiran S.,9997,0,9999,2
1656185569527,MATH 197,003,095567,Xiao; Ming,9999,0,9999,0
1656185569527,MATH 197,004,095571,Perols; Johan Lars,9998,0,9999,1
1656185576577,COGS 9,A01,083615,Shannon; Kyle Michael,4,0,75,71
1656185582601,COGS 11,A01,083617,Boyle; Mary E. T.,14,0,48,34
1656185588627,COGS 13,A01,083071,Bastos; Amalia Pinkusfeld,5,0,71,66
1656185594650,COGS 14A,A01,092681,Semenuks; Arturs,4,15,100,96
1656185600681,COGS 14B,A01,083073,Cheng; Tzu-Han,7,0,63,56
1656185606706,COGS 17,A01,092677,Semenuks; Arturs,7,0,81,74
1656185612805,COGS 100,A01,083619,Allen; Michael Gordon,2,0,70,68
1656185618828,COGS 101A,A01,083621,Davis; Joshua Daniel,4,0,68,64
1656185624861,COGS 101B,A01,091572,Allen; Michael Gordon,5,0,65,60
1656185630886,COGS 101C,A01,083625,Delgado; Tania,10,0,35,25
1656185636911,COGS 107A,A01,083627,Boyle; Mary E. T.,0,0,60,60
1656185642939,COGS 118A,A01,083075,Gupta; Anjum,7,0,76,69
1656185648969,CSE 3,A50,083646,Miranda; Gregory Joseph,18,0,50,32
1656185654992,CSE 8A,A50,083650,Miranda; Gregory Joseph,3,3,56,53
1656185661018,CSE 11,A01,083080,Cao; Yingjun,1,53,40,39
1656185667042,CSE 12,A01,083652,Krause-Levy; Sophia Louisa,7,3,120,113
1656185673066,CSE 15L,A01,083654,Morris; Justin Loren,2,0,50,48
1656185673066,CSE 15L,A02,083655,Morris; Justin Loren,4,0,50,46
1656185679091,CSE 20,A01,083657,Tran; Khoa Dang,30,0,80,50
1656185685115,CSE 21,A01,095574,Bach; Quang Tran,24,0,48,24
1656185691141,CSE 30,A01,083084,Eldon; John,2,8,80,78
1656185691141,CSE 30,B01,095061,Bhaskar; Nishant,1,2,50,49
1656185697168,CSE 100,A01,083659,Cao; Yingjun,2,20,70,68
1656185703197,CSE 134B,A01,083661,Powell; Thomas Allan,3,0,100,97
1656185709220,CSE 140,A01,083663,Gungor; Onat,9,0,85,76
1656185715243,CSE 140L,A01,083088,Eldon; John,8,0,100,92
1656185721269,CSE 175,A01,083665,Kumar; Rakesh,0,0,25,25
1656185727301,CSE 190,A00,092507,Dubnov; Shlomo,3,0,20,17
1656185733328,ECE 45,A01,083139,Congero; Spencer William,1,0,75,74
1656185739355,ECE 65,A50,083695,Saad; Andrew S,9,0,30,21
1656185739355,ECE 65,A51,095125,Staff,23,0,26,3
1656185745378,ECE 109,A01,091882,Touri; Behrouz,0,1,70,70
1656185751407,ECE 180,A00,083140,Abi Samra; Nicholas Camill,1,0,30,29
1656185751407,ECE 180,B00,083141,Abi Samra; Nicholas Camill,0,4,30,30
1656185757434,MATH 10A,A01,083735,Patchell; Gregory David,0,0,30,30
1656185757434,MATH 10A,A02,083736,Patchell; Gregory David,22,0,30,8
1656185757434,MATH 10A,A03,083737,Patchell; Gregory David,16,0,30,14
1656185763467,MATH 10B,A01,083207,Lim; Seonhee,0,0,34,34
1656185763467,MATH 10B,A02,083208,Lim; Seonhee,7,0,35,28
1656185763467,MATH 10B,A03,093472,Staff,1,0,34,33
1656185763467,MATH 10B,B01,083739,Sinha; Shubham,11,0,30,19
1656185769499,MATH 18,A01,083743,Cinel; Cameron Alexander,7,0,30,23
1656185769499,MATH 18,A02,083744,Cinel; Cameron Alexander,10,0,30,20
1656185769499,MATH 18,A03,083745,Cinel; Cameron Alexander,4,0,30,26
1656185769499,MATH 18,B01,083748,Rideout; David Porter,0,0,36,36
1656185769499,MATH 18,B02,083749,Rideout; David Porter,0,0,36,36
1656185769499,MATH 18,B03,083750,Rideout; David Porter,0,0,36,36
1656185769499,MATH 18,B04,083751,Rideout; David Porter,0,0,36,36
1656185769499,MATH 18,B05,093473,Rideout; David Porter,0,0,36,36
1656185769499,MATH 18,B06,093474,Rideout; David Porter,2,0,36,34
1656185775522,MATH 20A,A01,083754,Zheng; Zequn,11,0,40,29
1656185781546,MATH 20B,A01,083756,Briones; Jor-el Thomas Caparas,0,0,36,36
1656185781546,MATH 20B,A02,083757,Briones; Jor-el Thomas Caparas,0,0,36,36
1656185781546,MATH 20B,A03,093475,Staff,1,0,36,35
1656185787570,MATH 20C,A01,083760,Briones; Jor-el Thomas Caparas,0,0,35,35
1656185787570,MATH 20C,A02,083761,Briones; Jor-el Thomas Caparas,9,1,35,26
1656185787570,MATH 20C,A03,093476,Staff,0,0,35,35
1656185787570,MATH 20C,B01,083762,Bach; Quang Tran,1,0,30,29
1656185793594,MATH 20D,A01,083765,Tran; Brian Kha,1,0,30,29
1656185793594,MATH 20D,A02,083766,Tran; Brian Kha,0,1,30,30
1656185793594,MATH 20D,A03,083767,Tran; Brian Kha,2,0,30,28
1656185799626,MATH 20E,A01,083771,Ganguly; Soumya,3,0,32,29
1656185799626,MATH 20E,A02,083772,Ganguly; Soumya,0,0,32,32
1656185799626,MATH 20E,B01,083773,Ciotti; Benjamin,15,0,35,20
1656185799626,MATH 20E,B02,083774,Ciotti; Benjamin,15,0,35,20
1656185805656,MATH 103A,A01,083777,Greenfeld; Be'Eri,1,0,36,35
1656185805656,MATH 103A,A02,083778,Greenfeld; Be'Eri,1,0,36,35
1656185805656,MATH 103A,A03,093561,Staff,5,0,36,31
1656185805656,MATH 103A,B01,083779,Greenfeld; Be'Eri,9,1,36,27
1656185805656,MATH 103A,B02,083780,Greenfeld; Be'Eri,1,0,36,35
1656185805656,MATH 103A,B03,093562,Staff,0,0,36,36
1656185811684,MATH 105,A01,085443,Carter; Anne Toulson,5,1,35,30
1656185811684,MATH 105,A02,093477,Staff,12,0,35,23
1656185823920,MATH 109,A01,083213,Ganzberger; Geoffrey Michael,0,0,34,34
1656185823920,MATH 109,A02,083214,Ganzberger; Geoffrey Michael,0,0,34,34
1656185823920,MATH 109,A03,093478,Staff,1,0,34,33
1656185823920,MATH 109,B01,083215,Ganzberger; Geoffrey Michael,4,0,32,28
1656185823920,MATH 109,B02,083216,Ganzberger; Geoffrey Michael,1,0,32,31
1656185823920,MATH 109,B03,093479,Staff,4,0,32,28
1656185829943,MATH 142A,A01,083219,Chow; Bennett,1,0,32,31
1656185829943,MATH 142A,A02,083220,Chow; Bennett,8,0,32,24
1656185829943,MATH 142A,A03,093480,Staff,5,0,32,27
1656185829943,MATH 142A,B03,093481,Staff,3,0,32,29
1656185829943,MATH 142A,B04,093558,Staff,6,0,32,26
1656185829943,MATH 142A,B05,093559,Staff,1,0,32,31
1656185835971,MATH 193A,A01,083224,Rotar; Vladimir,0,1,34,34
1656185835971,MATH 193A,A02,083225,Rotar; Vladimir,0,0,34,34
1656185835971,MATH 193A,A03,083781,Rotar; Vladimir,0,0,34,34
1656185835971,MATH 193A,A04,083782,Rotar; Vladimir,6,0,34,28
1656185835971,MATH 193A,A05,093482,Rotar; Vladimir,1,0,34,33
1656185841996,MATH 197,001,091859,McAuley; Julian John,9999,0,9999,0
1656185841996,MATH 197,002,095566,Kedlaya; Kiran S.,9997,0,9999,2
1656185841996,MATH 197,003,095567,Xiao; Ming,9999,0,9999,0
1656185841996,MATH 197,004,095571,Perols; Johan Lars,9998,0,9999,1
1656185849063,COGS 9,A01,083615,Shannon; Kyle Michael,4,0,75,71
1656185855091,COGS 11,A01,083617,Boyle; Mary E. T.,14,0,48,34
1656185861119,COGS 13,A01,083071,Bastos; Amalia Pinkusfeld,5,0,71,66
1656185867146,COGS 14A,A01,092681,Semenuks; Arturs,4,15,100,96
1656185873169,COGS 14B,A01,083073,Cheng; Tzu-Han,7,0,63,56
1656185879197,COGS 17,A01,092677,Semenuks; Arturs,7,0,81,74
1656185885226,COGS 100,A01,083619,Allen; Michael Gordon,2,0,70,68
1656185891251,COGS 101A,A01,083621,Davis; Joshua Daniel,4,0,68,64
1656185897275,COGS 101B,A01,091572,Allen; Michael Gordon,5,0,65,60
1656185903298,COGS 101C,A01,083625,Delgado; Tania,10,0,35,25
1656185909325,COGS 107A,A01,083627,Boyle; Mary E. T.,0,0,60,60
1656185915352,COGS 118A,A01,083075,Gupta; Anjum,7,0,76,69
1656185921377,CSE 3,A50,083646,Miranda; Gregory Joseph,18,0,50,32
1656185927400,CSE 8A,A50,083650,Miranda; Gregory Joseph,3,3,56,53
1656185933424,CSE 11,A01,083080,Cao; Yingjun,1,53,40,39
1656185939450,CSE 12,A01,083652,Krause-Levy; Sophia Louisa,7,3,120,113
1656185945478,CSE 15L,A01,083654,Morris; Justin Loren,2,0,50,48
1656185945478,CSE 15L,A02,083655,Morris; Justin Loren,4,0,50,46
1656185951501,CSE 20,A01,083657,Tran; Khoa Dang,30,0,80,50
1656185957527,CSE 21,A01,095574,Bach; Quang Tran,24,0,48,24
1656185963550,CSE 30,A01,083084,Eldon; John,2,8,80,78
1656185963550,CSE 30,B01,095061,Bhaskar; Nishant,1,2,50,49
1656185969576,CSE 100,A01,083659,Cao; Yingjun,2,20,70,68
1656185975603,CSE 134B,A01,083661,Powell; Thomas Allan,3,0,100,97
1656185981626,CSE 140,A01,083663,Gungor; Onat,9,0,85,76
1656185987652,CSE 140L,A01,083088,Eldon; John,8,0,100,92
1656185993677,CSE 175,A01,083665,Kumar; Rakesh,0,0,25,25
1656185999699,CSE 190,A00,092507,Dubnov; Shlomo,3,0,20,17
1656186005722,ECE 45,A01,083139,Congero; Spencer William,1,0,75,74
1656186011749,ECE 65,A50,083695,Saad; Andrew S,9,0,30,21
1656186011749,ECE 65,A51,095125,Staff,23,0,26,3
1656186017771,ECE 109,A01,091882,Touri; Behrouz,0,1,70,70
1656186023793,ECE 180,A00,083140,Abi Samra; Nicholas Camill,1,0,30,29
1656186023793,ECE 180,B00,083141,Abi Samra; Nicholas Camill,0,4,30,30
1656186029815,MATH 10A,A01,083735,Patchell; Gregory David,0,0,30,30
1656186029815,MATH 10A,A02,083736,Patchell; Gregory David,22,0,30,8
1656186029815,MATH 10A,A03,083737,Patchell; Gregory David,16,0,30,14
1656186035853,MATH 10B,A01,083207,Lim; Seonhee,0,0,34,34
1656186035853,MATH 10B,A02,083208,Lim; Seonhee,7,0,35,28
1656186035853,MATH 10B,A03,093472,Staff,1,0,34,33
1656186035853,MATH 10B,B01,083739,Sinha; Shubham,11,0,30,19
1656186041885,MATH 18,A01,083743,Cinel; Cameron Alexander,7,0,30,23
1656186041885,MATH 18,A02,083744,Cinel; Cameron Alexander,10,0,30,20
1656186041885,MATH 18,A03,083745,Cinel; Cameron Alexander,4,0,30,26
1656186041885,MATH 18,B01,083748,Rideout; David Porter,0,0,36,36
1656186041885,MATH 18,B02,083749,Rideout; David Porter,0,0,36,36
1656186041885,MATH 18,B03,083750,Rideout; David Porter,0,0,36,36
1656186041885,MATH 18,B04,083751,Rideout; David Porter,0,0,36,36
1656186041885,MATH 18,B05,093473,Rideout; David Porter,0,0,36,36
1656186041885,MATH 18,B06,093474,Rideout; David Porter,2,0,36,34
1656186047909,MATH 20A,A01,083754,Zheng; Zequn,11,0,40,29
1656186053937,MATH 20B,A01,083756,Briones; Jor-el Thomas Caparas,0,0,36,36
1656186053937,MATH 20B,A02,083757,Briones; Jor-el Thomas Caparas,0,0,36,36
1656186053937,MATH 20B,A03,093475,Staff,1,0,36,35
1656186059967,MATH 20C,A01,083760,Briones; Jor-el Thomas Caparas,0,0,35,35
1656186059967,MATH 20C,A02,083761,Briones; Jor-el Thomas Caparas,9,1,35,26
1656186059967,MATH 20C,A03,093476,Staff,0,0,35,35
1656186059967,MATH 20C,B01,083762,Bach; Quang Tran,1,0,30,29
1656186065994,MATH 20D,A01,083765,Tran; Brian Kha,1,0,30,29
1656186065994,MATH 20D,A02,083766,Tran; Brian Kha,0,1,30,30
1656186065994,MATH 20D,A03,083767,Tran; Brian Kha,2,0,30,28
1656186072018,MATH 20E,A01,083771,Ganguly; Soumya,3,0,32,29
1656186072018,MATH 20E,A02,083772,Ganguly; Soumya,0,0,32,32
1656186072018,MATH 20E,B01,083773,Ciotti; Benjamin,15,0,35,20
1656186072018,MATH 20E,B02,083774,Ciotti; Benjamin,15,0,35,20
1656186078043,MATH 103A,A01,083777,Greenfeld; Be'Eri,1,0,36,35
1656186078043,MATH 103A,A02,083778,Greenfeld; Be'Eri,1,0,36,35
1656186078043,MATH 103A,A03,093561,Staff,5,0,36,31
1656186078043,MATH 103A,B01,083779,Greenfeld; Be'Eri,9,1,36,27
1656186078043,MATH 103A,B02,083780,Greenfeld; Be'Eri,1,0,36,35
1656186078043,MATH 103A,B03,093562,Staff,0,0,36,36
1656186084067,MATH 105,A01,085443,Carter; Anne Toulson,5,1,35,30
1656186084067,MATH 105,A02,093477,Staff,12,0,35,23
1656186090090,MATH 109,A01,083213,Ganzberger; Geoffrey Michael,0,0,34,34
1656186090090,MATH 109,A02,083214,Ganzberger; Geoffrey Michael,0,0,34,34
1656186090090,MATH 109,A03,093478,Staff,1,0,34,33
1656186090090,MATH 109,B01,083215,Ganzberger; Geoffrey Michael,4,0,32,28
1656186090090,MATH 109,B02,083216,Ganzberger; Geoffrey Michael,1,0,32,31
1656186090090,MATH 109,B03,093479,Staff,4,0,32,28
1656186096114,MATH 142A,A01,083219,Chow; Bennett,1,0,32,31
1656186096114,MATH 142A,A02,083220,Chow; Bennett,8,0,32,24
1656186096114,MATH 142A,A03,093480,Staff,5,0,32,27
1656186096114,MATH 142A,B03,093481,Staff,3,0,32,29
1656186096114,MATH 142A,B04,093558,Staff,6,0,32,26
1656186096114,MATH 142A,B05,093559,Staff,1,0,32,31
1656186102141,MATH 193A,A01,083224,Rotar; Vladimir,0,1,34,34
1656186102141,MATH 193A,A02,083225,Rotar; Vladimir,0,0,34,34
1656186102141,MATH 193A,A03,083781,Rotar; Vladimir,0,0,34,34
1656186102141,MATH 193A,A04,083782,Rotar; Vladimir,6,0,34,28
1656186102141,MATH 193A,A05,093482,Rotar; Vladimir,1,0,34,33
1656186108165,MATH 197,001,091859,McAuley; Julian John,9999,0,9999,0
1656186108165,MATH 197,002,095566,Kedlaya; Kiran S.,9997,0,9999,2
1656186108165,MATH 197,003,095567,Xiao; Ming,9999,0,9999,0
1656186108165,MATH 197,004,095571,Perols; Johan Lars,9998,0,9999,1
1656186115222,COGS 9,A01,083615,Shannon; Kyle Michael,4,0,75,71
1656186121248,COGS 11,A01,083617,Boyle; Mary E. T.,14,0,48,34
1656186127270,COGS 13,A01,083071,Bastos; Amalia Pinkusfeld,5,0,71,66
1656186133296,COGS 14A,A01,092681,Semenuks; Arturs,4,15,100,96
1656186139325,COGS 14B,A01,083073,Cheng; Tzu-Han,7,0,63,56
1656186145347,COGS 17,A01,092677,Semenuks; Arturs,7,0,81,74
1656186151371,COGS 100,A01,083619,Allen; Michael Gordon,2,0,70,68
1656186157392,COGS 101A,A01,083621,Davis; Joshua Daniel,4,0,68,64
1656186163415,COGS 101B,A01,091572,Allen; Michael Gordon,5,0,65,60
1656186169440,COGS 101C,A01,083625,Delgado; Tania,10,0,35,25
1656186175462,COGS 107A,A01,083627,Boyle; Mary E. T.,0,0,60,60
1656186181484,COGS 118A,A01,083075,Gupta; Anjum,7,0,76,69
1656186187506,CSE 3,A50,083646,Miranda; Gregory Joseph,18,0,50,32
1656186193529,CSE 8A,A50,083650,Miranda; Gregory Joseph,3,3,56,53
1656186199552,CSE 11,A01,083080,Cao; Yingjun,1,53,40,39
1656186205587,CSE 12,A01,083652,Krause-Levy; Sophia Louisa,7,3,120,113
1656186211609,CSE 15L,A01,083654,Morris; Justin Loren,2,0,50,48
1656186211609,CSE 15L,A02,083655,Morris; Justin Loren,4,0,50,46
1656186217703,CSE 20,A01,083657,Tran; Khoa Dang,30,0,80,50
1656186223728,CSE 21,A01,095574,Bach; Quang Tran,24,0,48,24
1656186229751,CSE 30,A01,083084,Eldon; John,2,8,80,78
1656186229751,CSE 30,B01,095061,Bhaskar; Nishant,1,2,50,49
1656186235779,CSE 100,A01,083659,Cao; Yingjun,2,20,70,68
1656186241803,CSE 134B,A01,083661,Powell; Thomas Allan,3,0,100,97
1656186247830,CSE 140,A01,083663,Gungor; Onat,9,0,85,76
1656186253857,CSE 140L,A01,083088,Eldon; John,8,0,100,92
1656186259880,CSE 175,A01,083665,Kumar; Rakesh,0,0,25,25
1656186265918,CSE 190,A00,092507,Dubnov; Shlomo,3,0,20,17
1656186271941,ECE 45,A01,083139,Congero; Spencer William,1,0,75,74
1656186277964,ECE 65,A50,083695,Saad; Andrew S,9,0,30,21
1656186277964,ECE 65,A51,095125,Staff,23,0,26,3
1656186283986,ECE 109,A01,091882,Touri; Behrouz,0,1,70,70
1656186290009,ECE 180,A00,083140,Abi Samra; Nicholas Camill,1,0,30,29
1656186290009,ECE 180,B00,083141,Abi Samra; Nicholas Camill,0,4,30,30
1656186296037,MATH 10A,A01,083735,Patchell; Gregory David,0,0,30,30
1656186296037,MATH 10A,A02,083736,Patchell; Gregory David,22,0,30,8
1656186296037,MATH 10A,A03,083737,Patchell; Gregory David,16,0,30,14
1656186302079,MATH 10B,A01,083207,Lim; Seonhee,0,0,34,34
1656186302079,MATH 10B,A02,083208,Lim; Seonhee,7,0,35,28
1656186302079,MATH 10B,A03,093472,Staff,1,0,34,33
1656186302079,MATH 10B,B01,083739,Sinha; Shubham,11,0,30,19
1656186308106,MATH 18,A01,083743,Cinel; Cameron Alexander,7,0,30,23
1656186308106,MATH 18,A02,083744,Cinel; Cameron Alexander,10,0,30,20
1656186308106,MATH 18,A03,083745,Cinel; Cameron Alexander,4,0,30,26
1656186308106,MATH 18,B01,083748,Rideout; David Porter,0,0,36,36
1656186308106,MATH 18,B02,083749,Rideout; David Porter,0,0,36,36
1656186308106,MATH 18,B03,083750,Rideout; David Porter,0,0,36,36
1656186308106,MATH 18,B04,083751,Rideout; David Porter,0,0,36,36
1656186308106,MATH 18,B05,093473,Rideout; David Porter,0,0,36,36
1656186308106,MATH 18,B06,093474,Rideout; David Porter,2,0,36,34
1656186314130,MATH 20A,A01,083754,Zheng; Zequn,11,0,40,29
1656186320152,MATH 20B,A01,083756,Briones; Jor-el Thomas Caparas,0,0,36,36
1656186320152,MATH 20B,A02,083757,Briones; Jor-el Thomas Caparas,0,0,36,36
1656186320152,MATH 20B,A03,093475,Staff,1,0,36,35
1656186326177,MATH 20C,A01,083760,Briones; Jor-el Thomas Caparas,0,0,35,35
1656186326177,MATH 20C,A02,083761,Briones; Jor-el Thomas Caparas,9,1,35,26
1656186326177,MATH 20C,A03,093476,Staff,0,0,35,35
1656186326177,MATH 20C,B01,083762,Bach; Quang Tran,1,0,30,29
1656186332200,MATH 20D,A01,083765,Tran; Brian Kha,1,0,30,29
1656186332200,MATH 20D,A02,083766,Tran; Brian Kha,0,1,30,30
1656186332200,MATH 20D,A03,083767,Tran; Brian Kha,2,0,30,28
1656186338223,MATH 20E,A01,083771,Ganguly; Soumya,3,0,32,29
1656186338223,MATH 20E,A02,083772,Ganguly; Soumya,0,0,32,32
1656186338223,MATH 20E,B01,083773,Ciotti; Benjamin,15,0,35,20
1656186338223,MATH 20E,B02,083774,Ciotti; Benjamin,15,0,35,20
1656186344245,MATH 103A,A01,083777,Greenfeld; Be'Eri,1,0,36,35
1656186344245,MATH 103A,A02,083778,Greenfeld; Be'Eri,1,0,36,35
1656186344245,MATH 103A,A03,093561,Staff,5,0,36,31
1656186344245,MATH 103A,B01,083779,Greenfeld; Be'Eri,9,1,36,27
1656186344245,MATH 103A,B02,083780,Greenfeld; Be'Eri,1,0,36,35
1656186344245,MATH 103A,B03,093562,Staff,0,0,36,36
1656186350272,MATH 105,A01,085443,Carter; Anne Toulson,5,1,35,30
1656186350272,MATH 105,A02,093477,Staff,12,0,35,23
1656186356297,MATH 109,A01,083213,Ganzberger; Geoffrey Michael,0,0,34,34
1656186356297,MATH 109,A02,083214,Ganzberger; Geoffrey Michael,0,0,34,34
1656186356297,MATH 109,A03,093478,Staff,1,0,34,33
1656186356297,MATH 109,B01,083215,Ganzberger; Geoffrey Michael,4,0,32,28
1656186356297,MATH 109,B02,083216,Ganzberger; Geoffrey Michael,1,0,32,31
1656186356297,MATH 109,B03,093479,Staff,4,0,32,28
1656186362322,MATH 142A,A01,083219,Chow; Bennett,1,0,32,31
1656186362322,MATH 142A,A02,083220,Chow; Bennett,8,0,32,24
1656186362322,MATH 142A,A03,093480,Staff,5,0,32,27
1656186362322,MATH 142A,B03,093481,Staff,3,0,32,29
1656186362322,MATH 142A,B04,093558,Staff,6,0,32,26
1656186362322,MATH 142A,B05,093559,Staff,1,0,32,31
1656186368346,MATH 193A,A01,083224,Rotar; Vladimir,0,1,34,34
1656186368346,MATH 193A,A02,083225,Rotar; Vladimir,0,0,34,34
1656186368346,MATH 193A,A03,083781,Rotar; Vladimir,0,0,34,34
1656186368346,MATH 193A,A04,083782,Rotar; Vladimir,6,0,34,28
1656186368346,MATH 193A,A05,093482,Rotar; Vladimir,1,0,34,33
1656186374371,MATH 197,001,091859,McAuley; Julian John,9999,0,9999,0
1656186374371,MATH 197,002,095566,Kedlaya; Kiran S.,9997,0,9999,2
1656186374371,MATH 197,003,095567,Xiao; Ming,9999,0,9999,0
1656186374371,MATH 197,004,095571,Perols; Johan Lars,9998,0,9999,1
1656186381449,COGS 9,A01,083615,Shannon; Kyle Michael,4,0,75,71
1656186387473,COGS 11,A01,083617,Boyle; Mary E. T.,14,0,48,34
1656186393498,COGS 13,A01,083071,Bastos; Amalia Pinkusfeld,5,0,71,66
1656186399525,COGS 14A,A01,092681,Semenuks; Arturs,4,15,100,96
1656186405549,COGS 14B,A01,083073,Cheng; Tzu-Han,7,0,63,56
1656186411581,COGS 17,A01,092677,Semenuks; Arturs,7,0,81,74
1656186417609,COGS 100,A01,083619,Allen; Michael Gordon,2,0,70,68
1656186423638,COGS 101A,A01,083621,Davis; Joshua Daniel,4,0,68,64
1656186429660,COGS 101B,A01,091572,Allen; Michael Gordon,5,0,65,60
1656186435685,COGS 101C,A01,083625,Delgado; Tania,10,0,35,25
1656186441707,COGS 107A,A01,083627,Boyle; Mary E. T.,0,0,60,60
1656186447734,COGS 118A,A01,083075,Gupta; Anjum,7,0,76,69
1656186453757,CSE 3,A50,083646,Miranda; Gregory Joseph,18,0,50,32
1656186459785,CSE 8A,A50,083650,Miranda; Gregory Joseph,3,3,56,53
1656186465807,CSE 11,A01,083080,Cao; Yingjun,1,53,40,39
1656186471830,CSE 12,A01,083652,Krause-Levy; Sophia Louisa,7,3,120,113
1656186477857,CSE 15L,A01,083654,Morris; Justin Loren,2,0,50,48
1656186477857,CSE 15L,A02,083655,Morris; Justin Loren,4,0,50,46
1656186483879,CSE 20,A01,083657,Tran; Khoa Dang,30,0,80,50
1656186489908,CSE 21,A01,095574,Bach; Quang Tran,24,0,48,24
1656186495934,CSE 30,A01,083084,Eldon; John,2,8,80,78
1656186495934,CSE 30,B01,095061,Bhaskar; Nishant,1,2,50,49
1656186501961,CSE 100,A01,083659,Cao; Yingjun,2,20,70,68
1656186507993,CSE 134B,A01,083661,Powell; Thomas Allan,3,0,100,97
1656186514023,CSE 140,A01,083663,Gungor; Onat,9,0,85,76
1656186520044,CSE 140L,A01,083088,Eldon; John,8,0,100,92
1656186526068,CSE 175,A01,083665,Kumar; Rakesh,0,0,25,25
1656186532094,CSE 190,A00,092507,Dubnov; Shlomo,3,0,20,17
1656186538120,ECE 45,A01,083139,Congero; Spencer William,1,0,75,74
1656186544143,ECE 65,A50,083695,Saad; Andrew S,9,0,30,21
1656186544143,ECE 65,A51,095125,Staff,23,0,26,3
1656186550166,ECE 109,A01,091882,Touri; Behrouz,0,1,70,70
1656186556192,ECE 180,A00,083140,Abi Samra; Nicholas Camill,1,0,30,29
1656186556192,ECE 180,B00,083141,Abi Samra; Nicholas Camill,0,4,30,30
1656186562216,MATH 10A,A01,083735,Patchell; Gregory David,0,0,30,30
1656186562216,MATH 10A,A02,083736,Patchell; Gregory David,22,0,30,8
1656186562216,MATH 10A,A03,083737,Patchell; Gregory David,16,0,30,14
1656186568239,MATH 10B,A01,083207,Lim; Seonhee,0,0,34,34
1656186568239,MATH 10B,A02,083208,Lim; Seonhee,7,0,35,28
1656186568239,MATH 10B,A03,093472,Staff,1,0,34,33
1656186568239,MATH 10B,B01,083739,Sinha; Shubham,11,0,30,19
1656186574265,MATH 18,A01,083743,Cinel; Cameron Alexander,7,0,30,23
1656186574265,MATH 18,A02,083744,Cinel; Cameron Alexander,10,0,30,20
1656186574265,MATH 18,A03,083745,Cinel; Cameron Alexander,4,0,30,26
1656186574265,MATH 18,B01,083748,Rideout; David Porter,0,0,36,36
1656186574265,MATH 18,B02,083749,Rideout; David Porter,0,0,36,36
1656186574265,MATH 18,B03,083750,Rideout; David Porter,0,0,36,36
1656186574265,MATH 18,B04,083751,Rideout; David Porter,0,0,36,36
1656186574265,MATH 18,B05,093473,Rideout; David Porter,0,0,36,36
1656186574265,MATH 18,B06,093474,Rideout; David Porter,2,0,36,34
1656186580290,MATH 20A,A01,083754,Zheng; Zequn,11,0,40,29
1656186586313,MATH 20B,A01,083756,Briones; Jor-el Thomas Caparas,0,0,36,36
1656186586313,MATH 20B,A02,083757,Briones; Jor-el Thomas Caparas,0,0,36,36
1656186586313,MATH 20B,A03,093475,Staff,1,0,36,35
1656186592338,MATH 20C,A01,083760,Briones; Jor-el Thomas Caparas,0,0,35,35
1656186592338,MATH 20C,A02,083761,Briones; Jor-el Thomas Caparas,9,1,35,26
1656186592338,MATH 20C,A03,093476,Staff,0,0,35,35
1656186592338,MATH 20C,B01,083762,Bach; Quang Tran,1,0,30,29
1656186598361,MATH 20D,A01,083765,Tran; Brian Kha,1,0,30,29
1656186598361,MATH 20D,A02,083766,Tran; Brian Kha,0,1,30,30
1656186598361,MATH 20D,A03,083767,Tran; Brian Kha,2,0,30,28
1656186604383,MATH 20E,A01,083771,Ganguly; Soumya,3,0,32,29
1656186604383,MATH 20E,A02,083772,Ganguly; Soumya,0,0,32,32
1656186604383,MATH 20E,B01,083773,Ciotti; Benjamin,15,0,35,20
1656186604383,MATH 20E,B02,083774,Ciotti; Benjamin,15,0,35,20
1656186610412,MATH 103A,A01,083777,Greenfeld; Be'Eri,1,0,36,35
1656186610412,MATH 103A,A02,083778,Greenfeld; Be'Eri,1,0,36,35
1656186610412,MATH 103A,A03,093561,Staff,5,0,36,31
1656186610412,MATH 103A,B01,083779,Greenfeld; Be'Eri,9,1,36,27
1656186610412,MATH 103A,B02,083780,Greenfeld; Be'Eri,1,0,36,35
1656186610412,MATH 103A,B03,093562,Staff,0,0,36,36
1656186616439,MATH 105,A01,085443,Carter; Anne Toulson,5,1,35,30
1656186616439,MATH 105,A02,093477,Staff,12,0,35,23
1656186622466,MATH 109,A01,083213,Ganzberger; Geoffrey Michael,0,0,34,34
1656186622466,MATH 109,A02,083214,Ganzberger; Geoffrey Michael,0,0,34,34
1656186622466,MATH 109,A03,093478,Staff,1,0,34,33
1656186622466,MATH 109,B01,083215,Ganzberger; Geoffrey Michael,4,0,32,28
1656186622466,MATH 109,B02,083216,Ganzberger; Geoffrey Michael,1,0,32,31
1656186622466,MATH 109,B03,093479,Staff,4,0,32,28
1656186628494,MATH 142A,A01,083219,Chow; Bennett,1,0,32,31
1656186628494,MATH 142A,A02,083220,Chow; Bennett,8,0,32,24
1656186628494,MATH 142A,A03,093480,Staff,5,0,32,27
1656186628494,MATH 142A,B03,093481,Staff,3,0,32,29
1656186628494,MATH 142A,B04,093558,Staff,6,0,32,26
1656186628494,MATH 142A,B05,093559,Staff,1,0,32,31
1656186634516,MATH 193A,A01,083224,Rotar; Vladimir,0,1,34,34
1656186634516,MATH 193A,A02,083225,Rotar; Vladimir,0,0,34,34
1656186634516,MATH 193A,A03,083781,Rotar; Vladimir,0,0,34,34
1656186634516,MATH 193A,A04,083782,Rotar; Vladimir,6,0,34,28
1656186634516,MATH 193A,A05,093482,Rotar; Vladimir,1,0,34,33
1656186640543,MATH 197,001,091859,McAuley; Julian John,9999,0,9999,0
1656186640543,MATH 197,002,095566,Kedlaya; Kiran S.,9997,0,9999,2
1656186640543,MATH 197,003,095567,Xiao; Ming,9999,0,9999,0
1656186640543,MATH 197,004,095571,Perols; Johan Lars,9998,0,9999,1
1656186647595,COGS 9,A01,083615,Shannon; Kyle Michael,4,0,75,71
1656186653618,COGS 11,A01,083617,Boyle; Mary E. T.,14,0,48,34
1656186659645,COGS 13,A01,083071,Bastos; Amalia Pinkusfeld,5,0,71,66
1656186665674,COGS 14A,A01,092681,Semenuks; Arturs,4,15,100,96
1656186671700,COGS 14B,A01,083073,Cheng; Tzu-Han,7,0,63,56
1656186677726,COGS 17,A01,092677,Semenuks; Arturs,7,0,81,74
1656186683753,COGS 100,A01,083619,Allen; Michael Gordon,2,0,70,68
1656186689777,COGS 101A,A01,083621,Davis; Joshua Daniel,4,0,68,64
1656186695799,COGS 101B,A01,091572,Allen; Michael Gordon,5,0,65,60
1656186701826,COGS 101C,A01,083625,Delgado; Tania,10,0,35,25
1656186707853,COGS 107A,A01,083627,Boyle; Mary E. T.,0,0,60,60
1656186713881,COGS 118A,A01,083075,Gupta; Anjum,7,0,76,69
1656186719905,CSE 3,A50,083646,Miranda; Gregory Joseph,18,0,50,32
1656186725929,CSE 8A,A50,083650,Miranda; Gregory Joseph,3,3,56,53
1656186731952,CSE 11,A01,083080,Cao; Yingjun,1,53,40,39
1656186737975,CSE 12,A01,083652,Krause-Levy; Sophia Louisa,7,3,120,113
1656186743998,CSE 15L,A01,083654,Morris; Justin Loren,2,0,50,48
1656186743998,CSE 15L,A02,083655,Morris; Justin Loren,4,0,50,46
1656186750029,CSE 20,A01,083657,Tran; Khoa Dang,30,0,80,50
1656186756055,CSE 21,A01,095574,Bach; Quang Tran,24,0,48,24
1656186762084,CSE 30,A01,083084,Eldon; John,2,8,80,78
1656186762084,CSE 30,B01,095061,Bhaskar; Nishant,1,2,50,49
1656186768118,CSE 100,A01,083659,Cao; Yingjun,2,20,70,68
1656186774142,CSE 134B,A01,083661,Powell; Thomas Allan,3,0,100,97
1656186780168,CSE 140,A01,083663,Gungor; Onat,9,0,85,76
1656186786193,CSE 140L,A01,083088,Eldon; John,8,0,100,92
1656186792219,CSE 175,A01,083665,Kumar; Rakesh,0,0,25,25
1656186798245,CSE 190,A00,092507,Dubnov; Shlomo,3,0,20,17
1656186804270,ECE 45,A01,083139,Congero; Spencer William,1,0,75,74
1656186810304,ECE 65,A50,083695,Saad; Andrew S,9,0,30,21
1656186810304,ECE 65,A51,095125,Staff,23,0,26,3
1656186816412,ECE 109,A01,091882,Touri; Behrouz,0,1,70,70
1656186822435,ECE 180,A00,083140,Abi Samra; Nicholas Camill,1,0,30,29
1656186822435,ECE 180,B00,083141,Abi Samra; Nicholas Camill,0,4,30,30
1656186828459,MATH 10A,A01,083735,Patchell; Gregory David,0,0,30,30
1656186828459,MATH 10A,A02,083736,Patchell; Gregory David,22,0,30,8
1656186828459,MATH 10A,A03,083737,Patchell; Gregory David,16,0,30,14
1656186834482,MATH 10B,A01,083207,Lim; Seonhee,0,0,34,34
1656186834482,MATH 10B,A02,083208,Lim; Seonhee,7,0,35,28
1656186834482,MATH 10B,A03,093472,Staff,1,0,34,33
1656186834482,MATH 10B,B01,083739,Sinha; Shubham,11,0,30,19
1656186840514,MATH 18,A01,083743,Cinel; Cameron Alexander,7,0,30,23
1656186840514,MATH 18,A02,083744,Cinel; Cameron Alexander,10,0,30,20
1656186840514,MATH 18,A03,083745,Cinel; Cameron Alexander,4,0,30,26
1656186840514,MATH 18,B01,083748,Rideout; David Porter,0,0,36,36
1656186840514,MATH 18,B02,083749,Rideout; David Porter,0,0,36,36
1656186840514,MATH 18,B03,083750,Rideout; David Porter,0,0,36,36
1656186840514,MATH 18,B04,083751,Rideout; David Porter,0,0,36,36
1656186840514,MATH 18,B05,093473,Rideout; David Porter,0,0,36,36
1656186840514,MATH 18,B06,093474,Rideout; David Porter,2,0,36,34
1656186846539,MATH 20A,A01,083754,Zheng; Zequn,11,0,40,29
1656186852567,MATH 20B,A01,083756,Briones; Jor-el Thomas Caparas,0,0,36,36
1656186852567,MATH 20B,A02,083757,Briones; Jor-el Thomas Caparas,0,0,36,36
1656186852567,MATH 20B,A03,093475,Staff,1,0,36,35
1656186858591,MATH 20C,A01,083760,Briones; Jor-el Thomas Caparas,0,0,35,35
1656186858591,MATH 20C,A02,083761,Briones; Jor-el Thomas Caparas,9,1,35,26
1656186858591,MATH 20C,A03,093476,Staff,0,0,35,35
1656186858591,MATH 20C,B01,083762,Bach; Quang Tran,1,0,30,29
1656186864614,MATH 20D,A01,083765,Tran; Brian Kha,1,0,30,29
1656186864614,MATH 20D,A02,083766,Tran; Brian Kha,0,1,30,30
1656186864614,MATH 20D,A03,083767,Tran; Brian Kha,2,0,30,28
1656186870639,MATH 20E,A01,083771,Ganguly; Soumya,3,0,32,29
1656186870639,MATH 20E,A02,083772,Ganguly; Soumya,0,0,32,32
1656186870639,MATH 20E,B01,083773,Ciotti; Benjamin,15,0,35,20
1656186870639,MATH 20E,B02,083774,Ciotti; Benjamin,15,0,35,20
1656186876675,MATH 103A,A01,083777,Greenfeld; Be'Eri,1,0,36,35
1656186876675,MATH 103A,A02,083778,Greenfeld; Be'Eri,1,0,36,35
1656186876675,MATH 103A,A03,093561,Staff,5,0,36,31
1656186876675,MATH 103A,B01,083779,Greenfeld; Be'Eri,9,1,36,27
1656186876675,MATH 103A,B02,083780,Greenfeld; Be'Eri,1,0,36,35
1656186876675,MATH 103A,B03,093562,Staff,0,0,36,36
1656186882703,MATH 105,A01,085443,Carter; Anne Toulson,5,1,35,30
1656186882703,MATH 105,A02,093477,Staff,12,0,35,23
1656186888732,MATH 109,A01,083213,Ganzberger; Geoffrey Michael,0,0,34,34
1656186888732,MATH 109,A02,083214,Ganzberger; Geoffrey Michael,0,0,34,34
1656186888732,MATH 109,A03,093478,Staff,1,0,34,33
1656186888732,MATH 109,B01,083215,Ganzberger; Geoffrey Michael,4,0,32,28
1656186888732,MATH 109,B02,083216,Ganzberger; Geoffrey Michael,1,0,32,31
1656186888732,MATH 109,B03,093479,Staff,4,0,32,28
1656186894756,MATH 142A,A01,083219,Chow; Bennett,1,0,32,31
1656186894756,MATH 142A,A02,083220,Chow; Bennett,8,0,32,24
1656186894756,MATH 142A,A03,093480,Staff,5,0,32,27
1656186894756,MATH 142A,B03,093481,Staff,3,0,32,29
1656186894756,MATH 142A,B04,093558,Staff,6,0,32,26
1656186894756,MATH 142A,B05,093559,Staff,1,0,32,31
1656186900779,MATH 193A,A01,083224,Rotar; Vladimir,0,1,34,34
1656186900779,MATH 193A,A02,083225,Rotar; Vladimir,0,0,34,34
1656186900779,MATH 193A,A03,083781,Rotar; Vladimir,0,0,34,34
1656186900779,MATH 193A,A04,083782,Rotar; Vladimir,6,0,34,28
1656186900779,MATH 193A,A05,093482,Rotar; Vladimir,1,0,34,33
1656186906808,MATH 197,001,091859,McAuley; Julian John,9999,0,9999,0
1656186906808,MATH 197,002,095566,Kedlaya; Kiran S.,9997,0,9999,2
1656186906808,MATH 197,003,095567,Xiao; Ming,9999,0,9999,0
1656186906808,MATH 197,004,095571,Perols; Johan Lars,9998,0,9999,1
1656186913888,COGS 9,A01,083615,Shannon; Kyle Michael,4,0,75,71
1656186919915,COGS 11,A01,083617,Boyle; Mary E. T.,14,0,48,34
1656186925939,COGS 13,A01,083071,Bastos; Amalia Pinkusfeld,5,0,71,66
1656186931962,COGS 14A,A01,092681,Semenuks; Arturs,4,15,100,96
1656186937991,COGS 14B,A01,083073,Cheng; Tzu-Han,7,0,63,56
1656186944015,COGS 17,A01,092677,Semenuks; Arturs,7,0,81,74
1656186950036,COGS 100,A01,083619,Allen; Michael Gordon,2,0,70,68
1656186956061,COGS 101A,A01,083621,Davis; Joshua Daniel,4,0,68,64
1656186962089,COGS 101B,A01,091572,Allen; Michael Gordon,5,0,65,60
1656186968117,COGS 101C,A01,083625,Delgado; Tania,10,0,35,25
1656186974139,COGS 107A,A01,083627,Boyle; Mary E. T.,0,0,60,60
1656186980164,COGS 118A,A01,083075,Gupta; Anjum,7,0,76,69
1656186986189,CSE 3,A50,083646,Miranda; Gregory Joseph,18,0,50,32
1656186992215,CSE 8A,A50,083650,Miranda; Gregory Joseph,3,3,56,53
1656186998242,CSE 11,A01,083080,Cao; Yingjun,1,53,40,39
1656187004275,CSE 12,A01,083652,Krause-Levy; Sophia Louisa,7,3,120,113
1656187010297,CSE 15L,A01,083654,Morris; Justin Loren,2,0,50,48
1656187010297,CSE 15L,A02,083655,Morris; Justin Loren,4,0,50,46
1656187016323,CSE 20,A01,083657,Tran; Khoa Dang,30,0,80,50
1656187022346,CSE 21,A01,095574,Bach; Quang Tran,24,0,48,24
1656187028374,CSE 30,A01,083084,Eldon; John,2,8,80,78
1656187028374,CSE 30,B01,095061,Bhaskar; Nishant,1,2,50,49
1656187034397,CSE 100,A01,083659,Cao; Yingjun,2,20,70,68
1656187040421,CSE 134B,A01,083661,Powell; Thomas Allan,3,0,100,97
1656187046448,CSE 140,A01,083663,Gungor; Onat,9,0,85,76
1656187052475,CSE 140L,A01,083088,Eldon; John,8,0,100,92
1656187058504,CSE 175,A01,083665,Kumar; Rakesh,0,0,25,25
1656187064528,CSE 190,A00,092507,Dubnov; Shlomo,3,0,20,17
1656187070552,ECE 45,A01,083139,Congero; Spencer William,1,0,75,74
1656187076579,ECE 65,A50,083695,Saad; Andrew S,9,0,30,21
1656187076579,ECE 65,A51,095125,Staff,23,0,26,3
1656187082603,ECE 109,A01,091882,Touri; Behrouz,0,1,70,70
1656187088632,ECE 180,A00,083140,Abi Samra; Nicholas Camill,1,0,30,29
1656187088632,ECE 180,B00,083141,Abi Samra; Nicholas Camill,0,4,30,30
1656187094655,MATH 10A,A01,083735,Patchell; Gregory David,0,0,30,30
1656187094655,MATH 10A,A02,083736,Patchell; Gregory David,22,0,30,8
1656187094655,MATH 10A,A03,083737,Patchell; Gregory David,16,0,30,14
1656187100680,MATH 10B,A01,083207,Lim; Seonhee,0,0,34,34
1656187100680,MATH 10B,A02,083208,Lim; Seonhee,7,0,35,28
1656187100680,MATH 10B,A03,093472,Staff,1,0,34,33
1656187100680,MATH 10B,B01,083739,Sinha; Shubham,11,0,30,19
1656187106706,MATH 18,A01,083743,Cinel; Cameron Alexander,7,0,30,23
1656187106706,MATH 18,A02,083744,Cinel; Cameron Alexander,10,0,30,20
1656187106706,MATH 18,A03,083745,Cinel; Cameron Alexander,4,0,30,26
1656187106706,MATH 18,B01,083748,Rideout; David Porter,0,0,36,36
1656187106706,MATH 18,B02,083749,Rideout; David Porter,0,0,36,36
1656187106706,MATH 18,B03,083750,Rideout; David Porter,0,0,36,36
1656187106706,MATH 18,B04,083751,Rideout; David Porter,0,0,36,36
1656187106706,MATH 18,B05,093473,Rideout; David Porter,0,0,36,36
1656187106706,MATH 18,B06,093474,Rideout; David Porter,2,0,36,34
1656187112729,MATH 20A,A01,083754,Zheng; Zequn,11,0,40,29
1656187118757,MATH 20B,A01,083756,Briones; Jor-el Thomas Caparas,0,0,36,36
1656187118757,MATH 20B,A02,083757,Briones; Jor-el Thomas Caparas,0,0,36,36
1656187118757,MATH 20B,A03,093475,Staff,1,0,36,35
1656187124785,MATH 20C,A01,083760,Briones; Jor-el Thomas Caparas,0,0,35,35
1656187124785,MATH 20C,A02,083761,Briones; Jor-el Thomas Caparas,9,1,35,26
1656187124785,MATH 20C,A03,093476,Staff,0,0,35,35
1656187124785,MATH 20C,B01,083762,Bach; Quang Tran,1,0,30,29
1656187130821,MATH 20D,A01,083765,Tran; Brian Kha,1,0,30,29
1656187130821,MATH 20D,A02,083766,Tran; Brian Kha,0,1,30,30
1656187130821,MATH 20D,A03,083767,Tran; Brian Kha,2,0,30,28
1656187136850,MATH 20E,A01,083771,Ganguly; Soumya,3,0,32,29
1656187136850,MATH 20E,A02,083772,Ganguly; Soumya,0,0,32,32
1656187136850,MATH 20E,B01,083773,Ciotti; Benjamin,15,0,35,20
1656187136850,MATH 20E,B02,083774,Ciotti; Benjamin,15,0,35,20
1656187142874,MATH 103A,A01,083777,Greenfeld; Be'Eri,1,0,36,35
1656187142874,MATH 103A,A02,083778,Greenfeld; Be'Eri,1,0,36,35
1656187142874,MATH 103A,A03,093561,Staff,5,0,36,31
1656187142874,MATH 103A,B01,083779,Greenfeld; Be'Eri,9,1,36,27
1656187142874,MATH 103A,B02,083780,Greenfeld; Be'Eri,1,0,36,35
1656187142874,MATH 103A,B03,093562,Staff,0,0,36,36
1656187148897,MATH 105,A01,085443,Carter; Anne Toulson,5,1,35,30
1656187148897,MATH 105,A02,093477,Staff,12,0,35,23
1656187154927,MATH 109,A01,083213,Ganzberger; Geoffrey Michael,0,0,34,34
1656187154927,MATH 109,A02,083214,Ganzberger; Geoffrey Michael,0,0,34,34
1656187154927,MATH 109,A03,093478,Staff,1,0,34,33
1656187154927,MATH 109,B01,083215,Ganzberger; Geoffrey Michael,4,0,32,28
1656187154927,MATH 109,B02,083216,Ganzberger; Geoffrey Michael,1,0,32,31
1656187154927,MATH 109,B03,093479,Staff,4,0,32,28
1656187160952,MATH 142A,A01,083219,Chow; Bennett,1,0,32,31
1656187160952,MATH 142A,A02,083220,Chow; Bennett,8,0,32,24
1656187160952,MATH 142A,A03,093480,Staff,5,0,32,27
1656187160952,MATH 142A,B03,093481,Staff,3,0,32,29
1656187160952,MATH 142A,B04,093558,Staff,6,0,32,26
1656187160952,MATH 142A,B05,093559,Staff,1,0,32,31
1656187166981,MATH 193A,A01,083224,Rotar; Vladimir,0,1,34,34
1656187166981,MATH 193A,A02,083225,Rotar; Vladimir,0,0,34,34
1656187166981,MATH 193A,A03,083781,Rotar; Vladimir,0,0,34,34
1656187166981,MATH 193A,A04,083782,Rotar; Vladimir,6,0,34,28
1656187166981,MATH 193A,A05,093482,Rotar; Vladimir,1,0,34,33
1656187173014,MATH 197,001,091859,McAuley; Julian John,9999,0,9999,0
1656187173014,MATH 197,002,095566,Kedlaya; Kiran S.,9997,0,9999,2
1656187173014,MATH 197,003,095567,Xiao; Ming,9999,0,9999,0
1656187173014,MATH 197,004,095571,Perols; Johan Lars,9998,0,9999,1
1656187180066,COGS 9,A01,083615,Shannon; Kyle Michael,4,0,75,71
1656187186089,COGS 11,A01,083617,Boyle; Mary E. T.,14,0,48,34
1656187192113,COGS 13,A01,083071,Bastos; Amalia Pinkusfeld,5,0,71,66
1656187198136,COGS 14A,A01,092681,Semenuks; Arturs,4,15,100,96
1656187204160,COGS 14B,A01,083073,Cheng; Tzu-Han,7,0,63,56
1656187210185,COGS 17,A01,092677,Semenuks; Arturs,7,0,81,74
1656187216209,COGS 100,A01,083619,Allen; Michael Gordon,2,0,70,68
1656187222237,COGS 101A,A01,083621,Davis; Joshua Daniel,4,0,68,64
1656187228264,COGS 101B,A01,091572,Allen; Michael Gordon,5,0,65,60
1656187234291,COGS 101C,A01,083625,Delgado; Tania,10,0,35,25
1656187240321,COGS 107A,A01,083627,Boyle; Mary E. T.,0,0,60,60
1656187246347,COGS 118A,A01,083075,Gupta; Anjum,7,0,76,69
1656187252377,CSE 3,A50,083646,Miranda; Gregory Joseph,18,0,50,32
1656187258400,CSE 8A,A50,083650,Miranda; Gregory Joseph,3,3,56,53
1656187264427,CSE 11,A01,083080,Cao; Yingjun,1,52,40,39
1656187270452,CSE 12,A01,083652,Krause-Levy; Sophia Louisa,7,3,120,113
1656187276477,CSE 15L,A01,083654,Morris; Justin Loren,2,0,50,48
1656187276477,CSE 15L,A02,083655,Morris; Justin Loren,4,0,50,46
1656187282501,CSE 20,A01,083657,Tran; Khoa Dang,30,0,80,50
1656187288528,CSE 21,A01,095574,Bach; Quang Tran,24,0,48,24
1656187294550,CSE 30,A01,083084,Eldon; John,2,8,80,78
1656187294550,CSE 30,B01,095061,Bhaskar; Nishant,1,2,50,49
1656187300573,CSE 100,A01,083659,Cao; Yingjun,2,20,70,68
1656187306599,CSE 134B,A01,083661,Powell; Thomas Allan,3,0,100,97
1656187312626,CSE 140,A01,083663,Gungor; Onat,9,0,85,76
1656187318649,CSE 140L,A01,083088,Eldon; John,8,0,100,92
1656187324683,CSE 175,A01,083665,Kumar; Rakesh,0,0,25,25
1656187330706,CSE 190,A00,092507,Dubnov; Shlomo,3,0,20,17
1656187336729,ECE 45,A01,083139,Congero; Spencer William,1,0,75,74
1656187342756,ECE 65,A50,083695,Saad; Andrew S,9,0,30,21
1656187342756,ECE 65,A51,095125,Staff,23,0,26,3
1656187348779,ECE 109,A01,091882,Touri; Behrouz,0,1,70,70
1656187354802,ECE 180,A00,083140,Abi Samra; Nicholas Camill,1,0,30,29
1656187354802,ECE 180,B00,083141,Abi Samra; Nicholas Camill,0,4,30,30
1656187360827,MATH 10A,A01,083735,Patchell; Gregory David,0,0,30,30
1656187360827,MATH 10A,A02,083736,Patchell; Gregory David,22,0,30,8
1656187360827,MATH 10A,A03,083737,Patchell; Gregory David,16,0,30,14
1656187366854,MATH 10B,A01,083207,Lim; Seonhee,0,0,34,34
1656187366854,MATH 10B,A02,083208,Lim; Seonhee,7,0,35,28
1656187366854,MATH 10B,A03,093472,Staff,1,0,34,33
1656187366854,MATH 10B,B01,083739,Sinha; Shubham,11,0,30,19
1656187372879,MATH 18,A01,083743,Cinel; Cameron Alexander,7,0,30,23
1656187372879,MATH 18,A02,083744,Cinel; Cameron Alexander,10,0,30,20
1656187372879,MATH 18,A03,083745,Cinel; Cameron Alexander,4,0,30,26
1656187372879,MATH 18,B01,083748,Rideout; David Porter,0,0,36,36
1656187372879,MATH 18,B02,083749,Rideout; David Porter,0,0,36,36
1656187372879,MATH 18,B03,083750,Rideout; David Porter,0,0,36,36
1656187372879,MATH 18,B04,083751,Rideout; David Porter,0,0,36,36
1656187372879,MATH 18,B05,093473,Rideout; David Porter,0,0,36,36
1656187372879,MATH 18,B06,093474,Rideout; David Porter,2,0,36,34
1656187378903,MATH 20A,A01,083754,Zheng; Zequn,11,0,40,29
1656187384926,MATH 20B,A01,083756,Briones; Jor-el Thomas Caparas,0,0,36,36
1656187384926,MATH 20B,A02,083757,Briones; Jor-el Thomas Caparas,0,0,36,36
1656187384926,MATH 20B,A03,093475,Staff,1,0,36,35
1656187390956,MATH 20C,A01,083760,Briones; Jor-el Thomas Caparas,0,0,35,35
1656187390956,MATH 20C,A02,083761,Briones; Jor-el Thomas Caparas,9,1,35,26
1656187390956,MATH 20C,A03,093476,Staff,0,0,35,35
1656187390956,MATH 20C,B01,083762,Bach; Quang Tran,1,0,30,29
1656187396978,MATH 20D,A01,083765,Tran; Brian Kha,1,0,30,29
1656187396978,MATH 20D,A02,083766,Tran; Brian Kha,0,1,30,30
1656187396978,MATH 20D,A03,083767,Tran; Brian Kha,2,0,30,28
1656187403003,MATH 20E,A01,083771,Ganguly; Soumya,3,0,32,29
1656187403003,MATH 20E,A02,083772,Ganguly; Soumya,0,0,32,32
1656187403003,MATH 20E,B01,083773,Ciotti; Benjamin,15,0,35,20
1656187403003,MATH 20E,B02,083774,Ciotti; Benjamin,15,0,35,20
1656187409032,MATH 103A,A01,083777,Greenfeld; Be'Eri,1,0,36,35
1656187409032,MATH 103A,A02,083778,Greenfeld; Be'Eri,1,0,36,35
1656187409032,MATH 103A,A03,093561,Staff,5,0,36,31
1656187409032,MATH 103A,B01,083779,Greenfeld; Be'Eri,9,1,36,27
1656187409032,MATH 103A,B02,083780,Greenfeld; Be'Eri,1,0,36,35
1656187409032,MATH 103A,B03,093562,Staff,0,0,36,36
1656187415140,MATH 105,A01,085443,Carter; Anne Toulson,5,1,35,30
1656187415140,MATH 105,A02,093477,Staff,12,0,35,23
1656187421168,MATH 109,A01,083213,Ganzberger; Geoffrey Michael,0,0,34,34
1656187421168,MATH 109,A02,083214,Ganzberger; Geoffrey Michael,0,0,34,34
1656187421168,MATH 109,A03,093478,Staff,1,0,34,33
1656187421168,MATH 109,B01,083215,Ganzberger; Geoffrey Michael,4,0,32,28
1656187421168,MATH 109,B02,083216,Ganzberger; Geoffrey Michael,1,0,32,31
1656187421168,MATH 109,B03,093479,Staff,4,0,32,28
1656187427200,MATH 142A,A01,083219,Chow; Bennett,1,0,32,31
1656187427200,MATH 142A,A02,083220,Chow; Bennett,8,0,32,24
1656187427200,MATH 142A,A03,093480,Staff,5,0,32,27
1656187427200,MATH 142A,B03,093481,Staff,3,0,32,29
1656187427200,MATH 142A,B04,093558,Staff,6,0,32,26
1656187427200,MATH 142A,B05,093559,Staff,1,0,32,31
1656187433224,MATH 193A,A01,083224,Rotar; Vladimir,0,1,34,34
1656187433224,MATH 193A,A02,083225,Rotar; Vladimir,0,0,34,34
1656187433224,MATH 193A,A03,083781,Rotar; Vladimir,0,0,34,34
1656187433224,MATH 193A,A04,083782,Rotar; Vladimir,6,0,34,28
1656187433224,MATH 193A,A05,093482,Rotar; Vladimir,1,0,34,33
1656187439248,MATH 197,001,091859,McAuley; Julian John,9999,0,9999,0
1656187439248,MATH 197,002,095566,Kedlaya; Kiran S.,9997,0,9999,2
1656187439248,MATH 197,003,095567,Xiao; Ming,9999,0,9999,0
1656187439248,MATH 197,004,095571,Perols; Johan Lars,9998,0,9999,1
1656187446300,COGS 9,A01,083615,Shannon; Kyle Michael,4,0,75,71
1656187452325,COGS 11,A01,083617,Boyle; Mary E. T.,14,0,48,34
1656187458351,COGS 13,A01,083071,Bastos; Amalia Pinkusfeld,5,0,71,66
1656187464378,COGS 14A,A01,092681,Semenuks; Arturs,4,15,100,96
1656187470402,COGS 14B,A01,083073,Cheng; Tzu-Han,7,0,63,56
1656187476427,COGS 17,A01,092677,Semenuks; Arturs,7,0,81,74
1656187482451,COGS 100,A01,083619,Allen; Michael Gordon,2,0,70,68
1656187488489,COGS 101A,A01,083621,Davis; Joshua Daniel,4,0,68,64
1656187494512,COGS 101B,A01,091572,Allen; Michael Gordon,5,0,65,60
1656187500536,COGS 101C,A01,083625,Delgado; Tania,10,0,35,25
1656187506561,COGS 107A,A01,083627,Boyle; Mary E. T.,0,0,60,60
1656187512585,COGS 118A,A01,083075,Gupta; Anjum,7,0,76,69
1656187518609,CSE 3,A50,083646,Miranda; Gregory Joseph,18,0,50,32
1656187524637,CSE 8A,A50,083650,Miranda; Gregory Joseph,3,3,56,53
1656187530665,CSE 11,A01,083080,Cao; Yingjun,1,52,40,39
1656187536689,CSE 12,A01,083652,Krause-Levy; Sophia Louisa,7,3,120,113
1656187542714,CSE 15L,A01,083654,Morris; Justin Loren,2,0,50,48
1656187542714,CSE 15L,A02,083655,Morris; Justin Loren,4,0,50,46
1656187548744,CSE 20,A01,083657,Tran; Khoa Dang,30,0,80,50
1656187554768,CSE 21,A01,095574,Bach; Quang Tran,24,0,48,24
1656187560795,CSE 30,A01,083084,Eldon; John,2,8,80,78
1656187560795,CSE 30,B01,095061,Bhaskar; Nishant,1,2,50,49
1656187566819,CSE 100,A01,083659,Cao; Yingjun,2,20,70,68
1656187572841,CSE 134B,A01,083661,Powell; Thomas Allan,3,0,100,97
1656187578864,CSE 140,A01,083663,Gungor; Onat,9,0,85,76
1656187584892,CSE 140L,A01,083088,Eldon; John,8,0,100,92
1656187590915,CSE 175,A01,083665,Kumar; Rakesh,0,0,25,25
1656187596940,CSE 190,A00,092507,Dubnov; Shlomo,3,0,20,17
1656187602969,ECE 45,A01,083139,Congero; Spencer William,1,0,75,74
1656187608992,ECE 65,A50,083695,Saad; Andrew S,9,0,30,21
1656187608992,ECE 65,A51,095125,Staff,23,0,26,3
1656187615016,ECE 109,A01,091882,Touri; Behrouz,0,1,70,70
1656187621044,ECE 180,A00,083140,Abi Samra; Nicholas Camill,1,0,30,29
1656187621044,ECE 180,B00,083141,Abi Samra; Nicholas Camill,0,4,30,30
1656187627073,MATH 10A,A01,083735,Patchell; Gregory David,0,0,30,30
1656187627073,MATH 10A,A02,083736,Patchell; Gregory David,22,0,30,8
1656187627073,MATH 10A,A03,083737,Patchell; Gregory David,16,0,30,14
1656187633105,MATH 10B,A01,083207,Lim; Seonhee,0,0,34,34
1656187633105,MATH 10B,A02,083208,Lim; Seonhee,7,0,35,28
1656187633105,MATH 10B,A03,093472,Staff,1,0,34,33
1656187633105,MATH 10B,B01,083739,Sinha; Shubham,11,0,30,19
1656187639136,MATH 18,A01,083743,Cinel; Cameron Alexander,7,0,30,23
1656187639136,MATH 18,A02,083744,Cinel; Cameron Alexander,10,0,30,20
1656187639136,MATH 18,A03,083745,Cinel; Cameron Alexander,4,0,30,26
1656187639136,MATH 18,B01,083748,Rideout; David Porter,0,0,36,36
1656187639136,MATH 18,B02,083749,Rideout; David Porter,0,0,36,36
1656187639136,MATH 18,B03,083750,Rideout; David Porter,0,0,36,36
1656187639136,MATH 18,B04,083751,Rideout; David Porter,0,0,36,36
1656187639136,MATH 18,B05,093473,Rideout; David Porter,0,0,36,36
1656187639136,MATH 18,B06,093474,Rideout; David Porter,2,0,36,34
1656187645158,MATH 20A,A01,083754,Zheng; Zequn,11,0,40,29
1656187651180,MATH 20B,A01,083756,Briones; Jor-el Thomas Caparas,0,0,36,36
1656187651180,MATH 20B,A02,083757,Briones; Jor-el Thomas Caparas,0,0,36,36
1656187651180,MATH 20B,A03,093475,Staff,1,0,36,35
1656187657204,MATH 20C,A01,083760,Briones; Jor-el Thomas Caparas,0,0,35,35
1656187657204,MATH 20C,A02,083761,Briones; Jor-el Thomas Caparas,9,1,35,26
1656187657204,MATH 20C,A03,093476,Staff,0,0,35,35
1656187657204,MATH 20C,B01,083762,Bach; Quang Tran,1,0,30,29
1656187663245,MATH 20D,A01,083765,Tran; Brian Kha,1,0,30,29
1656187663245,MATH 20D,A02,083766,Tran; Brian Kha,0,1,30,30
1656187663245,MATH 20D,A03,083767,Tran; Brian Kha,2,0,30,28
1656187669268,MATH 20E,A01,083771,Ganguly; Soumya,3,0,32,29
1656187669268,MATH 20E,A02,083772,Ganguly; Soumya,0,0,32,32
1656187669268,MATH 20E,B01,083773,Ciotti; Benjamin,15,0,35,20
1656187669268,MATH 20E,B02,083774,Ciotti; Benjamin,15,0,35,20
1656187675292,MATH 103A,A01,083777,Greenfeld; Be'Eri,1,0,36,35
1656187675292,MATH 103A,A02,083778,Greenfeld; Be'Eri,1,0,36,35
1656187675292,MATH 103A,A03,093561,Staff,5,0,36,31
1656187675292,MATH 103A,B01,083779,Greenfeld; Be'Eri,9,1,36,27
1656187675292,MATH 103A,B02,083780,Greenfeld; Be'Eri,1,0,36,35
1656187675292,MATH 103A,B03,093562,Staff,0,0,36,36
1656187681330,MATH 105,A01,085443,Carter; Anne Toulson,5,1,35,30
1656187681330,MATH 105,A02,093477,Staff,12,0,35,23
1656187687353,MATH 109,A01,083213,Ganzberger; Geoffrey Michael,0,0,34,34
1656187687353,MATH 109,A02,083214,Ganzberger; Geoffrey Michael,0,0,34,34
1656187687353,MATH 109,A03,093478,Staff,1,0,34,33
1656187687353,MATH 109,B01,083215,Ganzberger; Geoffrey Michael,4,0,32,28
1656187687353,MATH 109,B02,083216,Ganzberger; Geoffrey Michael,1,0,32,31
1656187687353,MATH 109,B03,093479,Staff,4,0,32,28
1656187693377,MATH 142A,A01,083219,Chow; Bennett,1,0,32,31
1656187693377,MATH 142A,A02,083220,Chow; Bennett,8,0,32,24
1656187693377,MATH 142A,A03,093480,Staff,5,0,32,27
1656187693377,MATH 142A,B03,093481,Staff,3,0,32,29
1656187693377,MATH 142A,B04,093558,Staff,6,0,32,26
1656187693377,MATH 142A,B05,093559,Staff,1,0,32,31
1656187699401,MATH 193A,A01,083224,Rotar; Vladimir,0,1,34,34
1656187699401,MATH 193A,A02,083225,Rotar; Vladimir,0,0,34,34
1656187699401,MATH 193A,A03,083781,Rotar; Vladimir,0,0,34,34
1656187699401,MATH 193A,A04,083782,Rotar; Vladimir,6,0,34,28
1656187699401,MATH 193A,A05,093482,Rotar; Vladimir,1,0,34,33
1656187705424,MATH 197,001,091859,McAuley; Julian John,9999,0,9999,0
1656187705424,MATH 197,002,095566,Kedlaya; Kiran S.,9997,0,9999,2
1656187705424,MATH 197,003,095567,Xiao; Ming,9999,0,9999,0
1656187705424,MATH 197,004,095571,Perols; Johan Lars,9998,0,9999,1
1656187712478,COGS 9,A01,083615,Shannon; Kyle Michael,4,0,75,71
1656187718500,COGS 11,A01,083617,Boyle; Mary E. T.,14,0,48,34
1656187724526,COGS 13,A01,083071,Bastos; Amalia Pinkusfeld,5,0,71,66
1656187730550,COGS 14A,A01,092681,Semenuks; Arturs,4,15,100,96
1656187736576,COGS 14B,A01,083073,Cheng; Tzu-Han,7,0,63,56
1656187742601,COGS 17,A01,092677,Semenuks; Arturs,7,0,81,74
1656187748627,COGS 100,A01,083619,Allen; Michael Gordon,2,0,70,68
1656187754662,COGS 101A,A01,083621,Davis; Joshua Daniel,4,0,68,64
1656187760686,COGS 101B,A01,091572,Allen; Michael Gordon,5,0,65,60
1656187766717,COGS 101C,A01,083625,Delgado; Tania,10,0,35,25
1656187772739,COGS 107A,A01,083627,Boyle; Mary E. T.,0,0,60,60
1656187778767,COGS 118A,A01,083075,Gupta; Anjum,7,0,76,69
1656187784796,CSE 3,A50,083646,Miranda; Gregory Joseph,18,0,50,32
1656187790820,CSE 8A,A50,083650,Miranda; Gregory Joseph,3,3,56,53
1656187796842,CSE 11,A01,083080,Cao; Yingjun,1,52,40,39
1656187802877,CSE 12,A01,083652,Krause-Levy; Sophia Louisa,7,3,120,113
1656187808910,CSE 15L,A01,083654,Morris; Justin Loren,2,0,50,48
1656187808910,CSE 15L,A02,083655,Morris; Justin Loren,4,0,50,46
1656187814934,CSE 20,A01,083657,Tran; Khoa Dang,30,0,80,50
1656187820961,CSE 21,A01,095574,Bach; Quang Tran,24,0,48,24
1656187826990,CSE 30,A01,083084,Eldon; John,2,8,80,78
1656187826990,CSE 30,B01,095061,Bhaskar; Nishant,1,2,50,49
1656187833013,CSE 100,A01,083659,Cao; Yingjun,2,20,70,68
1656187839040,CSE 134B,A01,083661,Powell; Thomas Allan,3,0,100,97
1656187845063,CSE 140,A01,083663,Gungor; Onat,9,0,85,76
1656187851087,CSE 140L,A01,083088,Eldon; John,8,0,100,92
1656187857111,CSE 175,A01,083665,Kumar; Rakesh,0,0,25,25
1656187863135,CSE 190,A00,092507,Dubnov; Shlomo,3,0,20,17
1656187869159,ECE 45,A01,083139,Congero; Spencer William,1,0,75,74
1656187875188,ECE 65,A50,083695,Saad; Andrew S,9,0,30,21
1656187875188,ECE 65,A51,095125,Staff,23,0,26,3
1656187881216,ECE 109,A01,091882,Touri; Behrouz,0,1,70,70
1656187887243,ECE 180,A00,083140,Abi Samra; Nicholas Camill,1,0,30,29
1656187887243,ECE 180,B00,083141,Abi Samra; Nicholas Camill,0,4,30,30
1656187893267,MATH 10A,A01,083735,Patchell; Gregory David,0,0,30,30
1656187893267,MATH 10A,A02,083736,Patchell; Gregory David,22,0,30,8
1656187893267,MATH 10A,A03,083737,Patchell; Gregory David,16,0,30,14
1656187899299,MATH 10B,A01,083207,Lim; Seonhee,0,0,34,34
1656187899299,MATH 10B,A02,083208,Lim; Seonhee,7,0,35,28
1656187899299,MATH 10B,A03,093472,Staff,1,0,34,33
1656187899299,MATH 10B,B01,083739,Sinha; Shubham,11,0,30,19
1656187905325,MATH 18,A01,083743,Cinel; Cameron Alexander,7,0,30,23
1656187905325,MATH 18,A02,083744,Cinel; Cameron Alexander,10,0,30,20
1656187905325,MATH 18,A03,083745,Cinel; Cameron Alexander,4,0,30,26
1656187905325,MATH 18,B01,083748,Rideout; David Porter,0,0,36,36
1656187905325,MATH 18,B02,083749,Rideout; David Porter,0,0,36,36
1656187905325,MATH 18,B03,083750,Rideout; David Porter,0,0,36,36
1656187905325,MATH 18,B04,083751,Rideout; David Porter,0,0,36,36
1656187905325,MATH 18,B05,093473,Rideout; David Porter,0,0,36,36
1656187905325,MATH 18,B06,093474,Rideout; David Porter,2,0,36,34
1656187911352,MATH 20A,A01,083754,Zheng; Zequn,11,0,40,29
1656187917377,MATH 20B,A01,083756,Briones; Jor-el Thomas Caparas,0,0,36,36
1656187917377,MATH 20B,A02,083757,Briones; Jor-el Thomas Caparas,0,0,36,36
1656187917377,MATH 20B,A03,093475,Staff,1,0,36,35
1656187923401,MATH 20C,A01,083760,Briones; Jor-el Thomas Caparas,0,0,35,35
1656187923401,MATH 20C,A02,083761,Briones; Jor-el Thomas Caparas,9,1,35,26
1656187923401,MATH 20C,A03,093476,Staff,0,0,35,35
1656187923401,MATH 20C,B01,083762,Bach; Quang Tran,1,0,30,29
1656187929425,MATH 20D,A01,083765,Tran; Brian Kha,1,0,30,29
1656187929425,MATH 20D,A02,083766,Tran; Brian Kha,0,1,30,30
1656187929425,MATH 20D,A03,083767,Tran; Brian Kha,2,0,30,28
1656187935448,MATH 20E,A01,083771,Ganguly; Soumya,3,0,32,29
1656187935448,MATH 20E,A02,083772,Ganguly; Soumya,0,0,32,32
1656187935448,MATH 20E,B01,083773,Ciotti; Benjamin,15,0,35,20
1656187935448,MATH 20E,B02,083774,Ciotti; Benjamin,15,0,35,20
1656187941477,MATH 103A,A01,083777,Greenfeld; Be'Eri,1,0,36,35
1656187941477,MATH 103A,A02,083778,Greenfeld; Be'Eri,1,0,36,35
1656187941477,MATH 103A,A03,093561,Staff,5,0,36,31
1656187941477,MATH 103A,B01,083779,Greenfeld; Be'Eri,9,1,36,27
1656187941477,MATH 103A,B02,083780,Greenfeld; Be'Eri,1,0,36,35
1656187941477,MATH 103A,B03,093562,Staff,0,0,36,36
1656187947501,MATH 105,A01,085443,Carter; Anne Toulson,5,1,35,30
1656187947501,MATH 105,A02,093477,Staff,12,0,35,23
1656187953529,MATH 109,A01,083213,Ganzberger; Geoffrey Michael,0,0,34,34
1656187953529,MATH 109,A02,083214,Ganzberger; Geoffrey Michael,0,0,34,34
1656187953529,MATH 109,A03,093478,Staff,1,0,34,33
1656187953529,MATH 109,B01,083215,Ganzberger; Geoffrey Michael,4,0,32,28
1656187953529,MATH 109,B02,083216,Ganzberger; Geoffrey Michael,1,0,32,31
1656187953529,MATH 109,B03,093479,Staff,4,0,32,28
1656187959553,MATH 142A,A01,083219,Chow; Bennett,1,0,32,31
1656187959553,MATH 142A,A02,083220,Chow; Bennett,8,0,32,24
1656187959553,MATH 142A,A03,093480,Staff,5,0,32,27
1656187959553,MATH 142A,B03,093481,Staff,3,0,32,29
1656187959553,MATH 142A,B04,093558,Staff,6,0,32,26
1656187959553,MATH 142A,B05,093559,Staff,1,0,32,31
1656187965576,MATH 193A,A01,083224,Rotar; Vladimir,0,1,34,34
1656187965576,MATH 193A,A02,083225,Rotar; Vladimir,0,0,34,34
1656187965576,MATH 193A,A03,083781,Rotar; Vladimir,0,0,34,34
1656187965576,MATH 193A,A04,083782,Rotar; Vladimir,6,0,34,28
1656187965576,MATH 193A,A05,093482,Rotar; Vladimir,1,0,34,33
1656187971604,MATH 197,001,091859,McAuley; Julian John,9999,0,9999,0
1656187971604,MATH 197,002,095566,Kedlaya; Kiran S.,9997,0,9999,2
1656187971604,MATH 197,003,095567,Xiao; Ming,9999,0,9999,0
1656187971604,MATH 197,004,095571,Perols; Johan Lars,9998,0,9999,1
1656187978654,COGS 9,A01,083615,Shannon; Kyle Michael,4,0,75,71
1656187984683,COGS 11,A01,083617,Boyle; Mary E. T.,14,0,48,34
1656187990710,COGS 13,A01,083071,Bastos; Amalia Pinkusfeld,5,0,71,66
1656187996733,COGS 14A,A01,092681,Semenuks; Arturs,4,15,100,96
1656188002758,COGS 14B,A01,083073,Cheng; Tzu-Han,7,0,63,56
1656188008874,COGS 17,A01,092677,Semenuks; Arturs,7,0,81,74
1656188014903,COGS 100,A01,083619,Allen; Michael Gordon,2,0,70,68
1656188020927,COGS 101A,A01,083621,Davis; Joshua Daniel,4,0,68,64
1656188026954,COGS 101B,A01,091572,Allen; Michael Gordon,5,0,65,60
1656188032977,COGS 101C,A01,083625,Delgado; Tania,10,0,35,25
1656188039001,COGS 107A,A01,083627,Boyle; Mary E. T.,0,0,60,60
1656188045023,COGS 118A,A01,083075,Gupta; Anjum,7,0,76,69
1656188051046,CSE 3,A50,083646,Miranda; Gregory Joseph,18,0,50,32
1656188057070,CSE 8A,A50,083650,Miranda; Gregory Joseph,3,3,56,53
1656188063096,CSE 11,A01,083080,Cao; Yingjun,1,52,40,39
1656188069120,CSE 12,A01,083652,Krause-Levy; Sophia Louisa,7,3,120,113
1656188075144,CSE 15L,A01,083654,Morris; Justin Loren,2,0,50,48
1656188075144,CSE 15L,A02,083655,Morris; Justin Loren,4,0,50,46
1656188081167,CSE 20,A01,083657,Tran; Khoa Dang,30,0,80,50
1656188087195,CSE 21,A01,095574,Bach; Quang Tran,24,0,48,24
1656188093220,CSE 30,A01,083084,Eldon; John,2,8,80,78
1656188093220,CSE 30,B01,095061,Bhaskar; Nishant,1,2,50,49
1656188099243,CSE 100,A01,083659,Cao; Yingjun,2,20,70,68
1656188105271,CSE 134B,A01,083661,Powell; Thomas Allan,3,0,100,97
1656188111298,CSE 140,A01,083663,Gungor; Onat,9,0,85,76
1656188117329,CSE 140L,A01,083088,Eldon; John,8,0,100,92
1656188123352,CSE 175,A01,083665,Kumar; Rakesh,0,0,25,25
1656188129380,CSE 190,A00,092507,Dubnov; Shlomo,3,0,20,17
1656188135403,ECE 45,A01,083139,Congero; Spencer William,1,0,75,74
1656188141427,ECE 65,A50,083695,Saad; Andrew S,9,0,30,21
1656188141427,ECE 65,A51,095125,Staff,23,0,26,3
1656188147455,ECE 109,A01,091882,Touri; Behrouz,0,1,70,70
1656188153481,ECE 180,A00,083140,Abi Samra; Nicholas Camill,1,0,30,29
1656188153481,ECE 180,B00,083141,Abi Samra; Nicholas Camill,0,4,30,30
1656188159509,MATH 10A,A01,083735,Patchell; Gregory David,0,0,30,30
1656188159509,MATH 10A,A02,083736,Patchell; Gregory David,22,0,30,8
1656188159509,MATH 10A,A03,083737,Patchell; Gregory David,16,0,30,14
1656188165538,MATH 10B,A01,083207,Lim; Seonhee,0,0,34,34
1656188165538,MATH 10B,A02,083208,Lim; Seonhee,7,0,35,28
1656188165538,MATH 10B,A03,093472,Staff,1,0,34,33
1656188165538,MATH 10B,B01,083739,Sinha; Shubham,11,0,30,19
1656188171563,MATH 18,A01,083743,Cinel; Cameron Alexander,7,0,30,23
1656188171563,MATH 18,A02,083744,Cinel; Cameron Alexander,10,0,30,20
1656188171563,MATH 18,A03,083745,Cinel; Cameron Alexander,4,0,30,26
1656188171563,MATH 18,B01,083748,Rideout; David Porter,0,0,36,36
1656188171563,MATH 18,B02,083749,Rideout; David Porter,0,0,36,36
1656188171563,MATH 18,B03,083750,Rideout; David Porter,0,0,36,36
1656188171563,MATH 18,B04,083751,Rideout; David Porter,0,0,36,36
1656188171563,MATH 18,B05,093473,Rideout; David Porter,0,0,36,36
1656188171563,MATH 18,B06,093474,Rideout; David Porter,2,0,36,34
1656188177590,MATH 20A,A01,083754,Zheng; Zequn,11,0,40,29
1656188183613,MATH 20B,A01,083756,Briones; Jor-el Thomas Caparas,0,0,36,36
1656188183613,MATH 20B,A02,083757,Briones; Jor-el Thomas Caparas,0,0,36,36
1656188183613,MATH 20B,A03,093475,Staff,1,0,36,35
1656188189645,MATH 20C,A01,083760,Briones; Jor-el Thomas Caparas,0,0,35,35
1656188189645,MATH 20C,A02,083761,Briones; Jor-el Thomas Caparas,9,1,35,26
1656188189645,MATH 20C,A03,093476,Staff,0,0,35,35
1656188189645,MATH 20C,B01,083762,Bach; Quang Tran,1,0,30,29
1656188195673,MATH 20D,A01,083765,Tran; Brian Kha,1,0,30,29
1656188195673,MATH 20D,A02,083766,Tran; Brian Kha,0,1,30,30
1656188195673,MATH 20D,A03,083767,Tran; Brian Kha,2,0,30,28
1656188201696,MATH 20E,A01,083771,Ganguly; Soumya,3,0,32,29
1656188201696,MATH 20E,A02,083772,Ganguly; Soumya,0,0,32,32
1656188201696,MATH 20E,B01,083773,Ciotti; Benjamin,15,0,35,20
1656188201696,MATH 20E,B02,083774,Ciotti; Benjamin,15,0,35,20
1656188207724,MATH 103A,A01,083777,Greenfeld; Be'Eri,1,0,36,35
1656188207724,MATH 103A,A02,083778,Greenfeld; Be'Eri,1,0,36,35
1656188207724,MATH 103A,A03,093561,Staff,5,0,36,31
1656188207724,MATH 103A,B01,083779,Greenfeld; Be'Eri,9,1,36,27
1656188207724,MATH 103A,B02,083780,Greenfeld; Be'Eri,1,0,36,35
1656188207724,MATH 103A,B03,093562,Staff,0,0,36,36
1656188213752,MATH 105,A01,085443,Carter; Anne Toulson,5,1,35,30
1656188213752,MATH 105,A02,093477,Staff,12,0,35,23
1656188219777,MATH 109,A01,083213,Ganzberger; Geoffrey Michael,0,0,34,34
1656188219777,MATH 109,A02,083214,Ganzberger; Geoffrey Michael,0,0,34,34
1656188219777,MATH 109,A03,093478,Staff,1,0,34,33
1656188219777,MATH 109,B01,083215,Ganzberger; Geoffrey Michael,4,0,32,28
1656188219777,MATH 109,B02,083216,Ganzberger; Geoffrey Michael,1,0,32,31
1656188219777,MATH 109,B03,093479,Staff,4,0,32,28
1656188225807,MATH 142A,A01,083219,Chow; Bennett,1,0,32,31
1656188225807,MATH 142A,A02,083220,Chow; Bennett,8,0,32,24
1656188225807,MATH 142A,A03,093480,Staff,5,0,32,27
1656188225807,MATH 142A,B03,093481,Staff,3,0,32,29
1656188225807,MATH 142A,B04,093558,Staff,6,0,32,26
1656188225807,MATH 142A,B05,093559,Staff,1,0,32,31
1656188231835,MATH 193A,A01,083224,Rotar; Vladimir,0,1,34,34
1656188231835,MATH 193A,A02,083225,Rotar; Vladimir,0,0,34,34
1656188231835,MATH 193A,A03,083781,Rotar; Vladimir,0,0,34,34
1656188231835,MATH 193A,A04,083782,Rotar; Vladimir,6,0,34,28
1656188231835,MATH 193A,A05,093482,Rotar; Vladimir,1,0,34,33
1656188237859,MATH 197,001,091859,McAuley; Julian John,9999,0,9999,0
1656188237859,MATH 197,002,095566,Kedlaya; Kiran S.,9997,0,9999,2
1656188237859,MATH 197,003,095567,Xiao; Ming,9999,0,9999,0
1656188237859,MATH 197,004,095571,Perols; Johan Lars,9998,0,9999,1
1656188244915,COGS 9,A01,083615,Shannon; Kyle Michael,4,0,75,71
1656188250940,COGS 11,A01,083617,Boyle; Mary E. T.,14,0,48,34
1656188256978,COGS 13,A01,083071,Bastos; Amalia Pinkusfeld,5,0,71,66
1656188263006,COGS 14A,A01,092681,Semenuks; Arturs,4,15,100,96
1656188269034,COGS 14B,A01,083073,Cheng; Tzu-Han,7,0,63,56
1656188275069,COGS 17,A01,092677,Semenuks; Arturs,7,0,81,74
1656188281096,COGS 100,A01,083619,Allen; Michael Gordon,2,0,70,68
1656188287123,COGS 101A,A01,083621,Davis; Joshua Daniel,4,0,68,64
1656188293150,COGS 101B,A01,091572,Allen; Michael Gordon,5,0,65,60
1656188299175,COGS 101C,A01,083625,Delgado; Tania,10,0,35,25
1656188305206,COGS 107A,A01,083627,Boyle; Mary E. T.,0,0,60,60
1656188311231,COGS 118A,A01,083075,Gupta; Anjum,7,0,76,69
1656188317256,CSE 3,A50,083646,Miranda; Gregory Joseph,18,0,50,32
1656188323279,CSE 8A,A50,083650,Miranda; Gregory Joseph,3,3,56,53
1656188329305,CSE 11,A01,083080,Cao; Yingjun,1,52,40,39
1656188335337,CSE 12,A01,083652,Krause-Levy; Sophia Louisa,7,3,120,113
1656188341361,CSE 15L,A01,083654,Morris; Justin Loren,2,0,50,48
1656188341361,CSE 15L,A02,083655,Morris; Justin Loren,4,0,50,46
1656188347383,CSE 20,A01,083657,Tran; Khoa Dang,30,0,80,50
1656188353414,CSE 21,A01,095574,Bach; Quang Tran,24,0,48,24
1656188359436,CSE 30,A01,083084,Eldon; John,2,8,80,78
1656188359436,CSE 30,B01,095061,Bhaskar; Nishant,1,2,50,49
1656188365459,CSE 100,A01,083659,Cao; Yingjun,2,20,70,68
1656188371486,CSE 134B,A01,083661,Powell; Thomas Allan,3,0,100,97
1656188377511,CSE 140,A01,083663,Gungor; Onat,9,0,85,76
1656188383534,CSE 140L,A01,083088,Eldon; John,8,0,100,92
1656188389560,CSE 175,A01,083665,Kumar; Rakesh,0,0,25,25
1656188395586,CSE 190,A00,092507,Dubnov; Shlomo,3,0,20,17
1656188401612,ECE 45,A01,083139,Congero; Spencer William,1,0,75,74
1656188407635,ECE 65,A50,083695,Saad; Andrew S,9,0,30,21
1656188407635,ECE 65,A51,095125,Staff,23,0,26,3
1656188413698,ECE 109,A01,091882,Touri; Behrouz,0,1,70,70
1656188419721,ECE 180,A00,083140,Abi Samra; Nicholas Camill,1,0,30,29
1656188419721,ECE 180,B00,083141,Abi Samra; Nicholas Camill,0,4,30,30
1656188425745,MATH 10A,A01,083735,Patchell; Gregory David,0,0,30,30
1656188425745,MATH 10A,A02,083736,Patchell; Gregory David,22,0,30,8
1656188425745,MATH 10A,A03,083737,Patchell; Gregory David,16,0,30,14
1656188431768,MATH 10B,A01,083207,Lim; Seonhee,0,0,34,34
1656188431768,MATH 10B,A02,083208,Lim; Seonhee,7,0,35,28
1656188431768,MATH 10B,A03,093472,Staff,1,0,34,33
1656188431768,MATH 10B,B01,083739,Sinha; Shubham,11,0,30,19
1656188437794,MATH 18,A01,083743,Cinel; Cameron Alexander,7,0,30,23
1656188437794,MATH 18,A02,083744,Cinel; Cameron Alexander,10,0,30,20
1656188437794,MATH 18,A03,083745,Cinel; Cameron Alexander,4,0,30,26
1656188437794,MATH 18,B01,083748,Rideout; David Porter,0,0,36,36
1656188437794,MATH 18,B02,083749,Rideout; David Porter,0,0,36,36
1656188437794,MATH 18,B03,083750,Rideout; David Porter,0,0,36,36
1656188437794,MATH 18,B04,083751,Rideout; David Porter,0,0,36,36
1656188437794,MATH 18,B05,093473,Rideout; David Porter,0,0,36,36
1656188437794,MATH 18,B06,093474,Rideout; David Porter,2,0,36,34
1656188443838,MATH 20A,A01,083754,Zheng; Zequn,11,0,40,29
1656188449862,MATH 20B,A01,083756,Briones; Jor-el Thomas Caparas,0,0,36,36
1656188449862,MATH 20B,A02,083757,Briones; Jor-el Thomas Caparas,0,0,36,36
1656188449862,MATH 20B,A03,093475,Staff,1,0,36,35
1656188455897,MATH 20C,A01,083760,Briones; Jor-el Thomas Caparas,0,0,35,35
1656188455897,MATH 20C,A02,083761,Briones; Jor-el Thomas Caparas,9,1,35,26
1656188455897,MATH 20C,A03,093476,Staff,0,0,35,35
1656188455897,MATH 20C,B01,083762,Bach; Quang Tran,1,0,30,29
1656188461922,MATH 20D,A01,083765,Tran; Brian Kha,1,0,30,29
1656188461922,MATH 20D,A02,083766,Tran; Brian Kha,0,1,30,30
1656188461922,MATH 20D,A03,083767,Tran; Brian Kha,2,0,30,28
1656188467945,MATH 20E,A01,083771,Ganguly; Soumya,3,0,32,29
1656188467945,MATH 20E,A02,083772,Ganguly; Soumya,0,0,32,32
1656188467945,MATH 20E,B01,083773,Ciotti; Benjamin,15,0,35,20
1656188467945,MATH 20E,B02,083774,Ciotti; Benjamin,15,0,35,20
1656188473975,MATH 103A,A01,083777,Greenfeld; Be'Eri,1,0,36,35
1656188473975,MATH 103A,A02,083778,Greenfeld; Be'Eri,1,0,36,35
1656188473975,MATH 103A,A03,093561,Staff,5,0,36,31
1656188473975,MATH 103A,B01,083779,Greenfeld; Be'Eri,9,1,36,27
1656188473975,MATH 103A,B02,083780,Greenfeld; Be'Eri,1,0,36,35
1656188473975,MATH 103A,B03,093562,Staff,0,0,36,36
1656188480004,MATH 105,A01,085443,Carter; Anne Toulson,5,1,35,30
1656188480004,MATH 105,A02,093477,Staff,12,0,35,23
1656188486028,MATH 109,A01,083213,Ganzberger; Geoffrey Michael,0,0,34,34
1656188486028,MATH 109,A02,083214,Ganzberger; Geoffrey Michael,0,0,34,34
1656188486028,MATH 109,A03,093478,Staff,1,0,34,33
1656188486028,MATH 109,B01,083215,Ganzberger; Geoffrey Michael,4,0,32,28
1656188486028,MATH 109,B02,083216,Ganzberger; Geoffrey Michael,1,0,32,31
1656188486028,MATH 109,B03,093479,Staff,4,0,32,28
1656188492053,MATH 142A,A01,083219,Chow; Bennett,1,0,32,31
1656188492053,MATH 142A,A02,083220,Chow; Bennett,8,0,32,24
1656188492053,MATH 142A,A03,093480,Staff,5,0,32,27
1656188492053,MATH 142A,B03,093481,Staff,3,0,32,29
1656188492053,MATH 142A,B04,093558,Staff,6,0,32,26
1656188492053,MATH 142A,B05,093559,Staff,1,0,32,31
1656188498077,MATH 193A,A01,083224,Rotar; Vladimir,0,1,34,34
1656188498077,MATH 193A,A02,083225,Rotar; Vladimir,0,0,34,34
1656188498077,MATH 193A,A03,083781,Rotar; Vladimir,0,0,34,34
1656188498077,MATH 193A,A04,083782,Rotar; Vladimir,6,0,34,28
1656188498077,MATH 193A,A05,093482,Rotar; Vladimir,1,0,34,33
1656188504106,MATH 197,001,091859,McAuley; Julian John,9999,0,9999,0
1656188504106,MATH 197,002,095566,Kedlaya; Kiran S.,9997,0,9999,2
1656188504106,MATH 197,003,095567,Xiao; Ming,9999,0,9999,0
1656188504106,MATH 197,004,095571,Perols; Johan Lars,9998,0,9999,1
1656188511160,COGS 9,A01,083615,Shannon; Kyle Michael,4,0,75,71
1656188517199,COGS 11,A01,083617,Boyle; Mary E. T.,14,0,48,34
1656188523224,COGS 13,A01,083071,Bastos; Amalia Pinkusfeld,5,0,71,66
1656188529260,COGS 14A,A01,092681,Semenuks; Arturs,4,15,100,96
1656188535283,COGS 14B,A01,083073,Cheng; Tzu-Han,7,0,63,56
1656188541307,COGS 17,A01,092677,Semenuks; Arturs,7,0,81,74
1656188547330,COGS 100,A01,083619,Allen; Michael Gordon,2,0,70,68
1656188553354,COGS 101A,A01,083621,Davis; Joshua Daniel,4,0,68,64
1656188559378,COGS 101B,A01,091572,Allen; Michael Gordon,5,0,65,60
1656188565407,COGS 101C,A01,083625,Delgado; Tania,10,0,35,25
1656188571436,COGS 107A,A01,083627,Boyle; Mary E. T.,0,0,60,60
1656188577459,COGS 118A,A01,083075,Gupta; Anjum,7,0,76,69
1656188583489,CSE 3,A50,083646,Miranda; Gregory Joseph,18,0,50,32
1656188589512,CSE 8A,A50,083650,Miranda; Gregory Joseph,3,3,56,53
1656188595535,CSE 11,A01,083080,Cao; Yingjun,1,52,40,39
1656188601560,CSE 12,A01,083652,Krause-Levy; Sophia Louisa,7,3,120,113
1656188607684,CSE 15L,A01,083654,Morris; Justin Loren,2,0,50,48
1656188607684,CSE 15L,A02,083655,Morris; Justin Loren,4,0,50,46
1656188613708,CSE 20,A01,083657,Tran; Khoa Dang,30,0,80,50
1656188619741,CSE 21,A01,095574,Bach; Quang Tran,24,0,48,24
1656188625765,CSE 30,A01,083084,Eldon; John,2,8,80,78
1656188625765,CSE 30,B01,095061,Bhaskar; Nishant,1,2,50,49
1656188631788,CSE 100,A01,083659,Cao; Yingjun,2,20,70,68
1656188637827,CSE 134B,A01,083661,Powell; Thomas Allan,3,0,100,97
1656188643850,CSE 140,A01,083663,Gungor; Onat,9,0,85,76
1656188649877,CSE 140L,A01,083088,Eldon; John,8,0,100,92
1656188655903,CSE 175,A01,083665,Kumar; Rakesh,0,0,25,25
1656188661925,CSE 190,A00,092507,Dubnov; Shlomo,3,0,20,17
1656188667948,ECE 45,A01,083139,Congero; Spencer William,1,0,75,74
1656188673970,ECE 65,A50,083695,Saad; Andrew S,9,0,30,21
1656188673970,ECE 65,A51,095125,Staff,23,0,26,3
1656188679993,ECE 109,A01,091882,Touri; Behrouz,0,1,70,70
1656188686016,ECE 180,A00,083140,Abi Samra; Nicholas Camill,1,0,30,29
1656188686016,ECE 180,B00,083141,Abi Samra; Nicholas Camill,0,4,30,30
1656188692040,MATH 10A,A01,083735,Patchell; Gregory David,0,0,30,30
1656188692040,MATH 10A,A02,083736,Patchell; Gregory David,22,0,30,8
1656188692040,MATH 10A,A03,083737,Patchell; Gregory David,16,0,30,14
1656188698070,MATH 10B,A01,083207,Lim; Seonhee,0,0,34,34
1656188698070,MATH 10B,A02,083208,Lim; Seonhee,7,0,35,28
1656188698070,MATH 10B,A03,093472,Staff,1,0,34,33
1656188698070,MATH 10B,B01,083739,Sinha; Shubham,11,0,30,19
1656188704100,MATH 18,A01,083743,Cinel; Cameron Alexander,7,0,30,23
1656188704100,MATH 18,A02,083744,Cinel; Cameron Alexander,10,0,30,20
1656188704100,MATH 18,A03,083745,Cinel; Cameron Alexander,4,0,30,26
1656188704100,MATH 18,B01,083748,Rideout; David Porter,0,0,36,36
1656188704100,MATH 18,B02,083749,Rideout; David Porter,0,0,36,36
1656188704100,MATH 18,B03,083750,Rideout; David Porter,0,0,36,36
1656188704100,MATH 18,B04,083751,Rideout; David Porter,0,0,36,36
1656188704100,MATH 18,B05,093473,Rideout; David Porter,0,0,36,36
1656188704100,MATH 18,B06,093474,Rideout; David Porter,2,0,36,34
1656188710126,MATH 20A,A01,083754,Zheng; Zequn,11,0,40,29
1656188716151,MATH 20B,A01,083756,Briones; Jor-el Thomas Caparas,0,0,36,36
1656188716151,MATH 20B,A02,083757,Briones; Jor-el Thomas Caparas,0,0,36,36
1656188716151,MATH 20B,A03,093475,Staff,1,0,36,35
1656188722179,MATH 20C,A01,083760,Briones; Jor-el Thomas Caparas,0,0,35,35
1656188722179,MATH 20C,A02,083761,Briones; Jor-el Thomas Caparas,9,1,35,26
1656188722179,MATH 20C,A03,093476,Staff,0,0,35,35
1656188722179,MATH 20C,B01,083762,Bach; Quang Tran,1,0,30,29
1656188728203,MATH 20D,A01,083765,Tran; Brian Kha,1,0,30,29
1656188728203,MATH 20D,A02,083766,Tran; Brian Kha,0,1,30,30
1656188728203,MATH 20D,A03,083767,Tran; Brian Kha,2,0,30,28
1656188734226,MATH 20E,A01,083771,Ganguly; Soumya,3,0,32,29
1656188734226,MATH 20E,A02,083772,Ganguly; Soumya,0,0,32,32
1656188734226,MATH 20E,B01,083773,Ciotti; Benjamin,15,0,35,20
1656188734226,MATH 20E,B02,083774,Ciotti; Benjamin,15,0,35,20
1656188740254,MATH 103A,A01,083777,Greenfeld; Be'Eri,1,0,36,35
1656188740254,MATH 103A,A02,083778,Greenfeld; Be'Eri,1,0,36,35
1656188740254,MATH 103A,A03,093561,Staff,5,0,36,31
1656188740254,MATH 103A,B01,083779,Greenfeld; Be'Eri,9,1,36,27
1656188740254,MATH 103A,B02,083780,Greenfeld; Be'Eri,1,0,36,35
1656188740254,MATH 103A,B03,093562,Staff,0,0,36,36
1656188746281,MATH 105,A01,085443,Carter; Anne Toulson,5,1,35,30
1656188746281,MATH 105,A02,093477,Staff,12,0,35,23
1656188752306,MATH 109,A01,083213,Ganzberger; Geoffrey Michael,0,0,34,34
1656188752306,MATH 109,A02,083214,Ganzberger; Geoffrey Michael,0,0,34,34
1656188752306,MATH 109,A03,093478,Staff,1,0,34,33
1656188752306,MATH 109,B01,083215,Ganzberger; Geoffrey Michael,4,0,32,28
1656188752306,MATH 109,B02,083216,Ganzberger; Geoffrey Michael,1,0,32,31
1656188752306,MATH 109,B03,093479,Staff,4,0,32,28
1656188758329,MATH 142A,A01,083219,Chow; Bennett,1,0,32,31
1656188758329,MATH 142A,A02,083220,Chow; Bennett,8,0,32,24
1656188758329,MATH 142A,A03,093480,Staff,5,0,32,27
1656188758329,MATH 142A,B03,093481,Staff,3,0,32,29
1656188758329,MATH 142A,B04,093558,Staff,6,0,32,26
1656188758329,MATH 142A,B05,093559,Staff,1,0,32,31
1656188764356,MATH 193A,A01,083224,Rotar; Vladimir,0,1,34,34
1656188764356,MATH 193A,A02,083225,Rotar; Vladimir,0,0,34,34
1656188764356,MATH 193A,A03,083781,Rotar; Vladimir,0,0,34,34
1656188764356,MATH 193A,A04,083782,Rotar; Vladimir,6,0,34,28
1656188764356,MATH 193A,A05,093482,Rotar; Vladimir,1,0,34,33
1656188770385,MATH 197,001,091859,McAuley; Julian John,9999,0,9999,0
1656188770385,MATH 197,002,095566,Kedlaya; Kiran S.,9997,0,9999,2
1656188770385,MATH 197,003,095567,Xiao; Ming,9999,0,9999,0
1656188770385,MATH 197,004,095571,Perols; Johan Lars,9998,0,9999,1
1656188777445,COGS 9,A01,083615,Shannon; Kyle Michael,4,0,75,71
1656188783469,COGS 11,A01,083617,Boyle; Mary E. T.,14,0,48,34
1656188789497,COGS 13,A01,083071,Bastos; Amalia Pinkusfeld,5,0,71,66
1656188795524,COGS 14A,A01,092681,Semenuks; Arturs,4,15,100,96
1656188801551,COGS 14B,A01,083073,Cheng; Tzu-Han,7,0,63,56
1656188807575,COGS 17,A01,092677,Semenuks; Arturs,7,0,81,74
1656188813605,COGS 100,A01,083619,Allen; Michael Gordon,2,0,70,68
1656188819631,COGS 101A,A01,083621,Davis; Joshua Daniel,4,0,68,64
1656188825654,COGS 101B,A01,091572,Allen; Michael Gordon,5,0,65,60
1656188831701,COGS 101C,A01,083625,Delgado; Tania,10,0,35,25
1656188837726,COGS 107A,A01,083627,Boyle; Mary E. T.,0,0,60,60
1656188843752,COGS 118A,A01,083075,Gupta; Anjum,7,0,76,69
1656188849776,CSE 3,A50,083646,Miranda; Gregory Joseph,18,0,50,32
1656188855800,CSE 8A,A50,083650,Miranda; Gregory Joseph,3,3,56,53
1656188861822,CSE 11,A01,083080,Cao; Yingjun,1,52,40,39
1656188867849,CSE 12,A01,083652,Krause-Levy; Sophia Louisa,7,3,120,113
1656188873873,CSE 15L,A01,083654,Morris; Justin Loren,2,0,50,48
1656188873873,CSE 15L,A02,083655,Morris; Justin Loren,4,0,50,46
1656188879899,CSE 20,A01,083657,Tran; Khoa Dang,30,0,80,50
1656188885921,CSE 21,A01,095574,Bach; Quang Tran,24,0,48,24
1656188891951,CSE 30,A01,083084,Eldon; John,2,8,80,78
1656188891951,CSE 30,B01,095061,Bhaskar; Nishant,1,2,50,49
1656188898004,CSE 100,A01,083659,Cao; Yingjun,2,20,70,68
1656188904034,CSE 134B,A01,083661,Powell; Thomas Allan,3,0,100,97
1656188910062,CSE 140,A01,083663,Gungor; Onat,9,0,85,76
1656188916086,CSE 140L,A01,083088,Eldon; John,8,0,100,92
1656188922112,CSE 175,A01,083665,Kumar; Rakesh,0,0,25,25
1656188928139,CSE 190,A00,092507,Dubnov; Shlomo,3,0,20,17
1656188934165,ECE 45,A01,083139,Congero; Spencer William,1,0,75,74
1656188940193,ECE 65,A50,083695,Saad; Andrew S,9,0,30,21
1656188940193,ECE 65,A51,095125,Staff,23,0,26,3
1656188946221,ECE 109,A01,091882,Touri; Behrouz,0,1,70,70
1656188952243,ECE 180,A00,083140,Abi Samra; Nicholas Camill,1,0,30,29
1656188952243,ECE 180,B00,083141,Abi Samra; Nicholas Camill,0,4,30,30
1656188958268,MATH 10A,A01,083735,Patchell; Gregory David,0,0,30,30
1656188958268,MATH 10A,A02,083736,Patchell; Gregory David,22,0,30,8
1656188958268,MATH 10A,A03,083737,Patchell; Gregory David,16,0,30,14
1656188964292,MATH 10B,A01,083207,Lim; Seonhee,0,0,34,34
1656188964292,MATH 10B,A02,083208,Lim; Seonhee,7,0,35,28
1656188964292,MATH 10B,A03,093472,Staff,1,0,34,33
1656188964292,MATH 10B,B01,083739,Sinha; Shubham,11,0,30,19
1656188970320,MATH 18,A01,083743,Cinel; Cameron Alexander,7,0,30,23
1656188970320,MATH 18,A02,083744,Cinel; Cameron Alexander,10,0,30,20
1656188970320,MATH 18,A03,083745,Cinel; Cameron Alexander,4,0,30,26
1656188970320,MATH 18,B01,083748,Rideout; David Porter,0,0,36,36
1656188970320,MATH 18,B02,083749,Rideout; David Porter,0,0,36,36
1656188970320,MATH 18,B03,083750,Rideout; David Porter,0,0,36,36
1656188970320,MATH 18,B04,083751,Rideout; David Porter,0,0,36,36
1656188970320,MATH 18,B05,093473,Rideout; David Porter,0,0,36,36
1656188970320,MATH 18,B06,093474,Rideout; David Porter,2,0,36,34
1656188976344,MATH 20A,A01,083754,Zheng; Zequn,11,0,40,29
1656188982367,MATH 20B,A01,083756,Briones; Jor-el Thomas Caparas,0,0,36,36
1656188982367,MATH 20B,A02,083757,Briones; Jor-el Thomas Caparas,0,0,36,36
1656188982367,MATH 20B,A03,093475,Staff,1,0,36,35
1656188988395,MATH 20C,A01,083760,Briones; Jor-el Thomas Caparas,0,0,35,35
1656188988395,MATH 20C,A02,083761,Briones; Jor-el Thomas Caparas,9,1,35,26
1656188988395,MATH 20C,A03,093476,Staff,0,0,35,35
1656188988395,MATH 20C,B01,083762,Bach; Quang Tran,1,0,30,29
1656188994419,MATH 20D,A01,083765,Tran; Brian Kha,1,0,30,29
1656188994419,MATH 20D,A02,083766,Tran; Brian Kha,0,1,30,30
1656188994419,MATH 20D,A03,083767,Tran; Brian Kha,2,0,30,28
1656189000448,MATH 20E,A01,083771,Ganguly; Soumya,3,0,32,29
1656189000448,MATH 20E,A02,083772,Ganguly; Soumya,0,0,32,32
1656189000448,MATH 20E,B01,083773,Ciotti; Benjamin,15,0,35,20
1656189000448,MATH 20E,B02,083774,Ciotti; Benjamin,15,0,35,20
1656189006478,MATH 103A,A01,083777,Greenfeld; Be'Eri,1,0,36,35
1656189006478,MATH 103A,A02,083778,Greenfeld; Be'Eri,1,0,36,35
1656189006478,MATH 103A,A03,093561,Staff,5,0,36,31
1656189006478,MATH 103A,B01,083779,Greenfeld; Be'Eri,9,1,36,27
1656189006478,MATH 103A,B02,083780,Greenfeld; Be'Eri,1,0,36,35
1656189006478,MATH 103A,B03,093562,Staff,0,0,36,36
1656189012503,MATH 105,A01,085443,Carter; Anne Toulson,5,1,35,30
1656189012503,MATH 105,A02,093477,Staff,13,0,35,22
1656189018527,MATH 109,A01,083213,Ganzberger; Geoffrey Michael,0,0,34,34
1656189018527,MATH 109,A02,083214,Ganzberger; Geoffrey Michael,0,0,34,34
1656189018527,MATH 109,A03,093478,Staff,1,0,34,33
1656189018527,MATH 109,B01,083215,Ganzberger; Geoffrey Michael,4,0,32,28
1656189018527,MATH 109,B02,083216,Ganzberger; Geoffrey Michael,1,0,32,31
1656189018527,MATH 109,B03,093479,Staff,4,0,32,28
1656189024554,MATH 142A,A01,083219,Chow; Bennett,1,0,32,31
1656189024554,MATH 142A,A02,083220,Chow; Bennett,8,0,32,24
1656189024554,MATH 142A,A03,093480,Staff,5,0,32,27
1656189024554,MATH 142A,B03,093481,Staff,3,0,32,29
1656189024554,MATH 142A,B04,093558,Staff,6,0,32,26
1656189024554,MATH 142A,B05,093559,Staff,1,0,32,31
1656189030575,MATH 193A,A01,083224,Rotar; Vladimir,0,1,34,34
1656189030575,MATH 193A,A02,083225,Rotar; Vladimir,0,0,34,34
1656189030575,MATH 193A,A03,083781,Rotar; Vladimir,0,0,34,34
1656189030575,MATH 193A,A04,083782,Rotar; Vladimir,6,0,34,28
1656189030575,MATH 193A,A05,093482,Rotar; Vladimir,1,0,34,33
1656189036599,MATH 197,001,091859,McAuley; Julian John,9999,0,9999,0
1656189036599,MATH 197,002,095566,Kedlaya; Kiran S.,9997,0,9999,2
1656189036599,MATH 197,003,095567,Xiao; Ming,9999,0,9999,0
1656189036599,MATH 197,004,095571,Perols; Johan Lars,9998,0,9999,1
1656189043661,COGS 9,A01,083615,Shannon; Kyle Michael,4,0,75,71
1656189049692,COGS 11,A01,083617,Boyle; Mary E. T.,14,0,48,34
1656189055716,COGS 13,A01,083071,Bastos; Amalia Pinkusfeld,5,0,71,66
1656189061743,COGS 14A,A01,092681,Semenuks; Arturs,4,15,100,96
1656189067772,COGS 14B,A01,083073,Cheng; Tzu-Han,7,0,63,56
1656189073796,COGS 17,A01,092677,Semenuks; Arturs,7,0,81,74
1656189079827,COGS 100,A01,083619,Allen; Michael Gordon,2,0,70,68
1656189085854,COGS 101A,A01,083621,Davis; Joshua Daniel,4,0,68,64
1656189091881,COGS 101B,A01,091572,Allen; Michael Gordon,5,0,65,60
1656189097909,COGS 101C,A01,083625,Delgado; Tania,10,0,35,25
1656189103930,COGS 107A,A01,083627,Boyle; Mary E. T.,0,0,60,60
1656189109951,COGS 118A,A01,083075,Gupta; Anjum,7,0,76,69
1656189115978,CSE 3,A50,083646,Miranda; Gregory Joseph,18,0,50,32
1656189122007,CSE 8A,A50,083650,Miranda; Gregory Joseph,3,3,56,53
1656189128032,CSE 11,A01,083080,Cao; Yingjun,1,52,40,39
1656189134093,CSE 12,A01,083652,Krause-Levy; Sophia Louisa,7,3,120,113
1656189140125,CSE 15L,A01,083654,Morris; Justin Loren,2,0,50,48
1656189140125,CSE 15L,A02,083655,Morris; Justin Loren,4,0,50,46
1656189146153,CSE 20,A01,083657,Tran; Khoa Dang,30,0,80,50
1656189152275,CSE 21,A01,095574,Bach; Quang Tran,24,0,48,24
1656189158304,CSE 30,A01,083084,Eldon; John,2,8,80,78
1656189158304,CSE 30,B01,095061,Bhaskar; Nishant,1,2,50,49
1656189164330,CSE 100,A01,083659,Cao; Yingjun,2,20,70,68
1656189170352,CSE 134B,A01,083661,Powell; Thomas Allan,3,0,100,97
1656189176378,CSE 140,A01,083663,Gungor; Onat,9,0,85,76
1656189182402,CSE 140L,A01,083088,Eldon; John,8,0,100,92
1656189188426,CSE 175,A01,083665,Kumar; Rakesh,0,0,25,25
1656189194451,CSE 190,A00,092507,Dubnov; Shlomo,3,0,20,17
1656189200484,ECE 45,A01,083139,Congero; Spencer William,1,0,75,74
1656189206602,ECE 65,A50,083695,Saad; Andrew S,9,0,30,21
1656189206602,ECE 65,A51,095125,Staff,23,0,26,3
1656189212627,ECE 109,A01,091882,Touri; Behrouz,0,1,70,70
1656189218655,ECE 180,A00,083140,Abi Samra; Nicholas Camill,1,0,30,29
1656189218655,ECE 180,B00,083141,Abi Samra; Nicholas Camill,0,4,30,30
1656189224682,MATH 10A,A01,083735,Patchell; Gregory David,0,0,30,30
1656189224682,MATH 10A,A02,083736,Patchell; Gregory David,22,0,30,8
1656189224682,MATH 10A,A03,083737,Patchell; Gregory David,16,0,30,14
1656189230711,MATH 10B,A01,083207,Lim; Seonhee,0,0,34,34
1656189230711,MATH 10B,A02,083208,Lim; Seonhee,7,0,35,28
1656189230711,MATH 10B,A03,093472,Staff,1,0,34,33
1656189230711,MATH 10B,B01,083739,Sinha; Shubham,11,0,30,19
1656189236741,MATH 18,A01,083743,Cinel; Cameron Alexander,7,0,30,23
1656189236741,MATH 18,A02,083744,Cinel; Cameron Alexander,10,0,30,20
1656189236741,MATH 18,A03,083745,Cinel; Cameron Alexander,4,0,30,26
1656189236741,MATH 18,B01,083748,Rideout; David Porter,0,0,36,36
1656189236741,MATH 18,B02,083749,Rideout; David Porter,0,0,36,36
1656189236741,MATH 18,B03,083750,Rideout; David Porter,0,0,36,36
1656189236741,MATH 18,B04,083751,Rideout; David Porter,0,0,36,36
1656189236741,MATH 18,B05,093473,Rideout; David Porter,0,0,36,36
1656189236741,MATH 18,B06,093474,Rideout; David Porter,2,0,36,34
1656189242764,MATH 20A,A01,083754,Zheng; Zequn,11,0,40,29
1656189248794,MATH 20B,A01,083756,Briones; Jor-el Thomas Caparas,0,0,36,36
1656189248794,MATH 20B,A02,083757,Briones; Jor-el Thomas Caparas,0,0,36,36
1656189248794,MATH 20B,A03,093475,Staff,1,0,36,35
1656189254818,MATH 20C,A01,083760,Briones; Jor-el Thomas Caparas,0,0,35,35
1656189254818,MATH 20C,A02,083761,Briones; Jor-el Thomas Caparas,9,1,35,26
1656189254818,MATH 20C,A03,093476,Staff,0,0,35,35
1656189254818,MATH 20C,B01,083762,Bach; Quang Tran,1,0,30,29
1656189260853,MATH 20D,A01,083765,Tran; Brian Kha,1,0,30,29
1656189260853,MATH 20D,A02,083766,Tran; Brian Kha,0,1,30,30
1656189260853,MATH 20D,A03,083767,Tran; Brian Kha,2,0,30,28
1656189266883,MATH 20E,A01,083771,Ganguly; Soumya,3,0,32,29
1656189266883,MATH 20E,A02,083772,Ganguly; Soumya,0,0,32,32
1656189266883,MATH 20E,B01,083773,Ciotti; Benjamin,15,0,35,20
1656189266883,MATH 20E,B02,083774,Ciotti; Benjamin,15,0,35,20
1656189272912,MATH 103A,A01,083777,Greenfeld; Be'Eri,1,0,36,35
1656189272912,MATH 103A,A02,083778,Greenfeld; Be'Eri,1,0,36,35
1656189272912,MATH 103A,A03,093561,Staff,5,0,36,31
1656189272912,MATH 103A,B01,083779,Greenfeld; Be'Eri,9,1,36,27
1656189272912,MATH 103A,B02,083780,Greenfeld; Be'Eri,1,0,36,35
1656189272912,MATH 103A,B03,093562,Staff,0,0,36,36
1656189278941,MATH 105,A01,085443,Carter; Anne Toulson,5,1,35,30
1656189278941,MATH 105,A02,093477,Staff,13,0,35,22
1656189284970,MATH 109,A01,083213,Ganzberger; Geoffrey Michael,0,0,34,34
1656189284970,MATH 109,A02,083214,Ganzberger; Geoffrey Michael,0,0,34,34
1656189284970,MATH 109,A03,093478,Staff,1,0,34,33
1656189284970,MATH 109,B01,083215,Ganzberger; Geoffrey Michael,4,0,32,28
1656189284970,MATH 109,B02,083216,Ganzberger; Geoffrey Michael,1,0,32,31
1656189284970,MATH 109,B03,093479,Staff,4,0,32,28
1656189291001,MATH 142A,A01,083219,Chow; Bennett,1,0,32,31
1656189291001,MATH 142A,A02,083220,Chow; Bennett,8,0,32,24
1656189291001,MATH 142A,A03,093480,Staff,5,0,32,27
1656189291001,MATH 142A,B03,093481,Staff,3,0,32,29
1656189291001,MATH 142A,B04,093558,Staff,6,0,32,26
1656189291001,MATH 142A,B05,093559,Staff,1,0,32,31
1656189297023,MATH 193A,A01,083224,Rotar; Vladimir,0,1,34,34
1656189297023,MATH 193A,A02,083225,Rotar; Vladimir,0,0,34,34
1656189297023,MATH 193A,A03,083781,Rotar; Vladimir,0,0,34,34
1656189297023,MATH 193A,A04,083782,Rotar; Vladimir,6,0,34,28
1656189297023,MATH 193A,A05,093482,Rotar; Vladimir,1,0,34,33
1656189303050,MATH 197,001,091859,McAuley; Julian John,9999,0,9999,0
1656189303050,MATH 197,002,095566,Kedlaya; Kiran S.,9997,0,9999,2
1656189303050,MATH 197,003,095567,Xiao; Ming,9999,0,9999,0
1656189303050,MATH 197,004,095571,Perols; Johan Lars,9998,0,9999,1
1656189310103,COGS 9,A01,083615,Shannon; Kyle Michael,4,0,75,71
1656189316127,COGS 11,A01,083617,Boyle; Mary E. T.,14,0,48,34
1656189322154,COGS 13,A01,083071,Bastos; Amalia Pinkusfeld,5,0,71,66
1656189328176,COGS 14A,A01,092681,Semenuks; Arturs,4,15,100,96
1656189334199,COGS 14B,A01,083073,Cheng; Tzu-Han,7,0,63,56
1656189340223,COGS 17,A01,092677,Semenuks; Arturs,7,0,81,74
1656189346247,COGS 100,A01,083619,Allen; Michael Gordon,2,0,70,68
1656189352274,COGS 101A,A01,083621,Davis; Joshua Daniel,4,0,68,64
1656189358298,COGS 101B,A01,091572,Allen; Michael Gordon,5,0,65,60
1656189364325,COGS 101C,A01,083625,Delgado; Tania,10,0,35,25
1656189370348,COGS 107A,A01,083627,Boyle; Mary E. T.,0,0,60,60
1656189376385,COGS 118A,A01,083075,Gupta; Anjum,7,0,76,69
1656189382414,CSE 3,A50,083646,Miranda; Gregory Joseph,18,0,50,32
1656189388442,CSE 8A,A50,083650,Miranda; Gregory Joseph,3,3,56,53
1656189394466,CSE 11,A01,083080,Cao; Yingjun,1,52,40,39
1656189400491,CSE 12,A01,083652,Krause-Levy; Sophia Louisa,7,3,120,113
1656189406519,CSE 15L,A01,083654,Morris; Justin Loren,2,0,50,48
1656189406519,CSE 15L,A02,083655,Morris; Justin Loren,4,0,50,46
1656189412540,CSE 20,A01,083657,Tran; Khoa Dang,30,0,80,50
1656189418567,CSE 21,A01,095574,Bach; Quang Tran,24,0,48,24
1656189424590,CSE 30,A01,083084,Eldon; John,2,8,80,78
1656189424590,CSE 30,B01,095061,Bhaskar; Nishant,1,2,50,49
1656189430618,CSE 100,A01,083659,Cao; Yingjun,2,20,70,68
1656189436641,CSE 134B,A01,083661,Powell; Thomas Allan,3,0,100,97
1656189442669,CSE 140,A01,083663,Gungor; Onat,9,0,85,76
1656189448697,CSE 140L,A01,083088,Eldon; John,8,0,100,92
1656189454724,CSE 175,A01,083665,Kumar; Rakesh,0,0,25,25
1656189460750,CSE 190,A00,092507,Dubnov; Shlomo,3,0,20,17
1656189466774,ECE 45,A01,083139,Congero; Spencer William,1,0,75,74
1656189472802,ECE 65,A50,083695,Saad; Andrew S,9,0,30,21
1656189472802,ECE 65,A51,095125,Staff,23,0,26,3
1656189478826,ECE 109,A01,091882,Touri; Behrouz,0,1,70,70
1656189484853,ECE 180,A00,083140,Abi Samra; Nicholas Camill,1,0,30,29
1656189484853,ECE 180,B00,083141,Abi Samra; Nicholas Camill,0,4,30,30
1656189490881,MATH 10A,A01,083735,Patchell; Gregory David,0,0,30,30
1656189490881,MATH 10A,A02,083736,Patchell; Gregory David,22,0,30,8
1656189490881,MATH 10A,A03,083737,Patchell; Gregory David,16,0,30,14
1656189496909,MATH 10B,A01,083207,Lim; Seonhee,0,0,34,34
1656189496909,MATH 10B,A02,083208,Lim; Seonhee,7,0,35,28
1656189496909,MATH 10B,A03,093472,Staff,1,0,34,33
1656189496909,MATH 10B,B01,083739,Sinha; Shubham,11,0,30,19
1656189502942,MATH 18,A01,083743,Cinel; Cameron Alexander,7,0,30,23
1656189502942,MATH 18,A02,083744,Cinel; Cameron Alexander,10,0,30,20
1656189502942,MATH 18,A03,083745,Cinel; Cameron Alexander,4,0,30,26
1656189502942,MATH 18,B01,083748,Rideout; David Porter,0,0,36,36
1656189502942,MATH 18,B02,083749,Rideout; David Porter,0,0,36,36
1656189502942,MATH 18,B03,083750,Rideout; David Porter,0,0,36,36
1656189502942,MATH 18,B04,083751,Rideout; David Porter,0,0,36,36
1656189502942,MATH 18,B05,093473,Rideout; David Porter,0,0,36,36
1656189502942,MATH 18,B06,093474,Rideout; David Porter,2,0,36,34
1656189508964,MATH 20A,A01,083754,Zheng; Zequn,11,0,40,29
1656189514990,MATH 20B,A01,083756,Briones; Jor-el Thomas Caparas,0,0,36,36
1656189514990,MATH 20B,A02,083757,Briones; Jor-el Thomas Caparas,0,0,36,36
1656189514990,MATH 20B,A03,093475,Staff,1,0,36,35
1656189521019,MATH 20C,A01,083760,Briones; Jor-el Thomas Caparas,0,0,35,35
1656189521019,MATH 20C,A02,083761,Briones; Jor-el Thomas Caparas,9,1,35,26
1656189521019,MATH 20C,A03,093476,Staff,0,0,35,35
1656189521019,MATH 20C,B01,083762,Bach; Quang Tran,1,0,30,29
1656189527042,MATH 20D,A01,083765,Tran; Brian Kha,1,0,30,29
1656189527042,MATH 20D,A02,083766,Tran; Brian Kha,0,1,30,30
1656189527042,MATH 20D,A03,083767,Tran; Brian Kha,2,0,30,28
1656189533072,MATH 20E,A01,083771,Ganguly; Soumya,3,0,32,29
1656189533072,MATH 20E,A02,083772,Ganguly; Soumya,0,0,32,32
1656189533072,MATH 20E,B01,083773,Ciotti; Benjamin,15,0,35,20
1656189533072,MATH 20E,B02,083774,Ciotti; Benjamin,15,0,35,20
1656189539097,MATH 103A,A01,083777,Greenfeld; Be'Eri,1,0,36,35
1656189539097,MATH 103A,A02,083778,Greenfeld; Be'Eri,1,0,36,35
1656189539097,MATH 103A,A03,093561,Staff,5,0,36,31
1656189539097,MATH 103A,B01,083779,Greenfeld; Be'Eri,9,1,36,27
1656189539097,MATH 103A,B02,083780,Greenfeld; Be'Eri,1,0,36,35
1656189539097,MATH 103A,B03,093562,Staff,0,0,36,36
1656189545127,MATH 105,A01,085443,Carter; Anne Toulson,5,1,35,30
1656189545127,MATH 105,A02,093477,Staff,13,0,35,22
1656189551157,MATH 109,A01,083213,Ganzberger; Geoffrey Michael,0,0,34,34
1656189551157,MATH 109,A02,083214,Ganzberger; Geoffrey Michael,0,0,34,34
1656189551157,MATH 109,A03,093478,Staff,1,0,34,33
1656189551157,MATH 109,B01,083215,Ganzberger; Geoffrey Michael,4,0,32,28
1656189551157,MATH 109,B02,083216,Ganzberger; Geoffrey Michael,1,0,32,31
1656189551157,MATH 109,B03,093479,Staff,4,0,32,28
1656189557189,MATH 142A,A01,083219,Chow; Bennett,1,0,32,31
1656189557189,MATH 142A,A02,083220,Chow; Bennett,8,0,32,24
1656189557189,MATH 142A,A03,093480,Staff,5,0,32,27
1656189557189,MATH 142A,B03,093481,Staff,3,0,32,29
1656189557189,MATH 142A,B04,093558,Staff,6,0,32,26
1656189557189,MATH 142A,B05,093559,Staff,1,0,32,31
1656189563217,MATH 193A,A01,083224,Rotar; Vladimir,0,1,34,34
1656189563217,MATH 193A,A02,083225,Rotar; Vladimir,0,0,34,34
1656189563217,MATH 193A,A03,083781,Rotar; Vladimir,0,0,34,34
1656189563217,MATH 193A,A04,083782,Rotar; Vladimir,6,0,34,28
1656189563217,MATH 193A,A05,093482,Rotar; Vladimir,1,0,34,33
1656189569240,MATH 197,001,091859,McAuley; Julian John,9999,0,9999,0
1656189569240,MATH 197,002,095566,Kedlaya; Kiran S.,9997,0,9999,2
1656189569240,MATH 197,003,095567,Xiao; Ming,9999,0,9999,0
1656189569240,MATH 197,004,095571,Perols; Johan Lars,9998,0,9999,1
1656189576303,COGS 9,A01,083615,Shannon; Kyle Michael,4,0,75,71
1656189582334,COGS 11,A01,083617,Boyle; Mary E. T.,14,0,48,34
1656189588358,COGS 13,A01,083071,Bastos; Amalia Pinkusfeld,5,0,71,66
1656189594380,COGS 14A,A01,092681,Semenuks; Arturs,4,15,100,96
1656189600405,COGS 14B,A01,083073,Cheng; Tzu-Han,7,0,63,56
1656189606429,COGS 17,A01,092677,Semenuks; Arturs,7,0,81,74
1656189612456,COGS 100,A01,083619,Allen; Michael Gordon,2,0,70,68
1656189618480,COGS 101A,A01,083621,Davis; Joshua Daniel,4,0,68,64
1656189624503,COGS 101B,A01,091572,Allen; Michael Gordon,5,0,65,60
1656189630530,COGS 101C,A01,083625,Delgado; Tania,10,0,35,25
1656189636558,COGS 107A,A01,083627,Boyle; Mary E. T.,0,0,60,60
1656189642582,COGS 118A,A01,083075,Gupta; Anjum,7,0,76,69
1656189648609,CSE 3,A50,083646,Miranda; Gregory Joseph,18,0,50,32
1656189654636,CSE 8A,A50,083650,Miranda; Gregory Joseph,3,3,56,53
1656189660663,CSE 11,A01,083080,Cao; Yingjun,1,52,40,39
1656189666696,CSE 12,A01,083652,Krause-Levy; Sophia Louisa,7,3,120,113
1656189672719,CSE 15L,A01,083654,Morris; Justin Loren,2,0,50,48
1656189672719,CSE 15L,A02,083655,Morris; Justin Loren,4,0,50,46
1656189678744,CSE 20,A01,083657,Tran; Khoa Dang,30,0,80,50
1656189684766,CSE 21,A01,095574,Bach; Quang Tran,24,0,48,24
1656189690792,CSE 30,A01,083084,Eldon; John,2,8,80,78
1656189690792,CSE 30,B01,095061,Bhaskar; Nishant,1,2,50,49
1656189696815,CSE 100,A01,083659,Cao; Yingjun,2,20,70,68
1656189702841,CSE 134B,A01,083661,Powell; Thomas Allan,3,0,100,97
1656189708868,CSE 140,A01,083663,Gungor; Onat,9,0,85,76
1656189714892,CSE 140L,A01,083088,Eldon; John,8,0,100,92
1656189720915,CSE 175,A01,083665,Kumar; Rakesh,0,0,25,25
1656189726941,CSE 190,A00,092507,Dubnov; Shlomo,3,0,20,17
1656189732968,ECE 45,A01,083139,Congero; Spencer William,1,0,75,74
1656189738991,ECE 65,A50,083695,Saad; Andrew S,9,0,30,21
1656189738991,ECE 65,A51,095125,Staff,23,0,26,3
1656189745015,ECE 109,A01,091882,Touri; Behrouz,0,1,70,70
1656189751042,ECE 180,A00,083140,Abi Samra; Nicholas Camill,1,0,30,29
1656189751042,ECE 180,B00,083141,Abi Samra; Nicholas Camill,0,4,30,30
1656189757065,MATH 10A,A01,083735,Patchell; Gregory David,0,0,30,30
1656189757065,MATH 10A,A02,083736,Patchell; Gregory David,22,0,30,8
1656189757065,MATH 10A,A03,083737,Patchell; Gregory David,16,0,30,14
1656189763095,MATH 10B,A01,083207,Lim; Seonhee,0,0,34,34
1656189763095,MATH 10B,A02,083208,Lim; Seonhee,7,0,35,28
1656189763095,MATH 10B,A03,093472,Staff,1,0,34,33
1656189763095,MATH 10B,B01,083739,Sinha; Shubham,11,0,30,19
1656189769120,MATH 18,A01,083743,Cinel; Cameron Alexander,7,0,30,23
1656189769120,MATH 18,A02,083744,Cinel; Cameron Alexander,10,0,30,20
1656189769120,MATH 18,A03,083745,Cinel; Cameron Alexander,4,0,30,26
1656189769120,MATH 18,B01,083748,Rideout; David Porter,0,0,36,36
1656189769120,MATH 18,B02,083749,Rideout; David Porter,0,0,36,36
1656189769120,MATH 18,B03,083750,Rideout; David Porter,0,0,36,36
1656189769120,MATH 18,B04,083751,Rideout; David Porter,0,0,36,36
1656189769120,MATH 18,B05,093473,Rideout; David Porter,0,0,36,36
1656189769120,MATH 18,B06,093474,Rideout; David Porter,2,0,36,34
1656189775147,MATH 20A,A01,083754,Zheng; Zequn,11,0,40,29
1656189781182,MATH 20B,A01,083756,Briones; Jor-el Thomas Caparas,0,0,36,36
1656189781182,MATH 20B,A02,083757,Briones; Jor-el Thomas Caparas,0,0,36,36
1656189781182,MATH 20B,A03,093475,Staff,1,0,36,35
1656189787210,MATH 20C,A01,083760,Briones; Jor-el Thomas Caparas,0,0,35,35
1656189787210,MATH 20C,A02,083761,Briones; Jor-el Thomas Caparas,9,1,35,26
1656189787210,MATH 20C,A03,093476,Staff,0,0,35,35
1656189787210,MATH 20C,B01,083762,Bach; Quang Tran,1,0,30,29
1656189793239,MATH 20D,A01,083765,Tran; Brian Kha,1,0,30,29
1656189793239,MATH 20D,A02,083766,Tran; Brian Kha,0,1,30,30
1656189793239,MATH 20D,A03,083767,Tran; Brian Kha,2,0,30,28
1656189799263,MATH 20E,A01,083771,Ganguly; Soumya,3,0,32,29
1656189799263,MATH 20E,A02,083772,Ganguly; Soumya,0,0,32,32
1656189799263,MATH 20E,B01,083773,Ciotti; Benjamin,15,0,35,20
1656189799263,MATH 20E,B02,083774,Ciotti; Benjamin,15,0,35,20
1656189805359,MATH 103A,A01,083777,Greenfeld; Be'Eri,1,0,36,35
1656189805359,MATH 103A,A02,083778,Greenfeld; Be'Eri,1,0,36,35
1656189805359,MATH 103A,A03,093561,Staff,5,0,36,31
1656189805359,MATH 103A,B01,083779,Greenfeld; Be'Eri,9,1,36,27
1656189805359,MATH 103A,B02,083780,Greenfeld; Be'Eri,1,0,36,35
1656189805359,MATH 103A,B03,093562,Staff,0,0,36,36
1656189811386,MATH 105,A01,085443,Carter; Anne Toulson,5,1,35,30
1656189811386,MATH 105,A02,093477,Staff,13,0,35,22
1656189817413,MATH 109,A01,083213,Ganzberger; Geoffrey Michael,0,0,34,34
1656189817413,MATH 109,A02,083214,Ganzberger; Geoffrey Michael,0,0,34,34
1656189817413,MATH 109,A03,093478,Staff,1,0,34,33
1656189817413,MATH 109,B01,083215,Ganzberger; Geoffrey Michael,4,0,32,28
1656189817413,MATH 109,B02,083216,Ganzberger; Geoffrey Michael,1,0,32,31
1656189817413,MATH 109,B03,093479,Staff,4,0,32,28
1656189823436,MATH 142A,A01,083219,Chow; Bennett,1,0,32,31
1656189823436,MATH 142A,A02,083220,Chow; Bennett,8,0,32,24
1656189823436,MATH 142A,A03,093480,Staff,5,0,32,27
1656189823436,MATH 142A,B03,093481,Staff,3,0,32,29
1656189823436,MATH 142A,B04,093558,Staff,6,0,32,26
1656189823436,MATH 142A,B05,093559,Staff,1,0,32,31
1656189829460,MATH 193A,A01,083224,Rotar; Vladimir,0,1,34,34
1656189829460,MATH 193A,A02,083225,Rotar; Vladimir,0,0,34,34
1656189829460,MATH 193A,A03,083781,Rotar; Vladimir,1,0,34,33
1656189829460,MATH 193A,A04,083782,Rotar; Vladimir,6,0,34,28
1656189829460,MATH 193A,A05,093482,Rotar; Vladimir,0,0,34,34
1656189835483,MATH 197,001,091859,McAuley; Julian John,9999,0,9999,0
1656189835483,MATH 197,002,095566,Kedlaya; Kiran S.,9997,0,9999,2
1656189835483,MATH 197,003,095567,Xiao; Ming,9999,0,9999,0
1656189835483,MATH 197,004,095571,Perols; Johan Lars,9998,0,9999,1
1656189842536,COGS 9,A01,083615,Shannon; Kyle Michael,4,0,75,71
1656189848559,COGS 11,A01,083617,Boyle; Mary E. T.,14,0,48,34
1656189854582,COGS 13,A01,083071,Bastos; Amalia Pinkusfeld,5,0,71,66
1656189860605,COGS 14A,A01,092681,Semenuks; Arturs,4,15,100,96
1656189866636,COGS 14B,A01,083073,Cheng; Tzu-Han,7,0,63,56
1656189872664,COGS 17,A01,092677,Semenuks; Arturs,7,0,81,74
1656189878692,COGS 100,A01,083619,Allen; Michael Gordon,2,0,70,68
1656189884720,COGS 101A,A01,083621,Davis; Joshua Daniel,4,0,68,64
1656189890750,COGS 101B,A01,091572,Allen; Michael Gordon,5,0,65,60
1656189896781,COGS 101C,A01,083625,Delgado; Tania,10,0,35,25
1656189902813,COGS 107A,A01,083627,Boyle; Mary E. T.,0,0,60,60
1656189908840,COGS 118A,A01,083075,Gupta; Anjum,7,0,76,69
1656189914866,CSE 3,A50,083646,Miranda; Gregory Joseph,18,0,50,32
1656189920893,CSE 8A,A50,083650,Miranda; Gregory Joseph,3,3,56,53
1656189926917,CSE 11,A01,083080,Cao; Yingjun,1,52,40,39
1656189932941,CSE 12,A01,083652,Krause-Levy; Sophia Louisa,7,3,120,113
1656189938969,CSE 15L,A01,083654,Morris; Justin Loren,2,0,50,48
1656189938969,CSE 15L,A02,083655,Morris; Justin Loren,4,0,50,46
1656189945001,CSE 20,A01,083657,Tran; Khoa Dang,30,0,80,50
1656189951028,CSE 21,A01,095574,Bach; Quang Tran,24,0,48,24
1656189957062,CSE 30,A01,083084,Eldon; John,2,8,80,78
1656189957062,CSE 30,B01,095061,Bhaskar; Nishant,1,2,50,49
1656189963091,CSE 100,A01,083659,Cao; Yingjun,2,20,70,68
1656189969114,CSE 134B,A01,083661,Powell; Thomas Allan,3,0,100,97
1656189975143,CSE 140,A01,083663,Gungor; Onat,9,0,85,76
1656189981168,CSE 140L,A01,083088,Eldon; John,8,0,100,92
1656189987191,CSE 175,A01,083665,Kumar; Rakesh,0,0,25,25
1656189993216,CSE 190,A00,092507,Dubnov; Shlomo,3,0,20,17
1656189999239,ECE 45,A01,083139,Congero; Spencer William,1,0,75,74
1656190005266,ECE 65,A50,083695,Saad; Andrew S,9,0,30,21
1656190005266,ECE 65,A51,095125,Staff,23,0,26,3
1656190011300,ECE 109,A01,091882,Touri; Behrouz,0,1,70,70
1656190017329,ECE 180,A00,083140,Abi Samra; Nicholas Camill,1,0,30,29
1656190017329,ECE 180,B00,083141,Abi Samra; Nicholas Camill,0,4,30,30
1656190023349,MATH 10A,A01,083735,Patchell; Gregory David,0,0,30,30
1656190023349,MATH 10A,A02,083736,Patchell; Gregory David,22,0,30,8
1656190023349,MATH 10A,A03,083737,Patchell; Gregory David,16,0,30,14
1656190029379,MATH 10B,A01,083207,Lim; Seonhee,0,0,34,34
1656190029379,MATH 10B,A02,083208,Lim; Seonhee,7,0,35,28
1656190029379,MATH 10B,A03,093472,Staff,1,0,34,33
1656190029379,MATH 10B,B01,083739,Sinha; Shubham,11,0,30,19
1656190035412,MATH 18,A01,083743,Cinel; Cameron Alexander,7,0,30,23
1656190035412,MATH 18,A02,083744,Cinel; Cameron Alexander,10,0,30,20
1656190035412,MATH 18,A03,083745,Cinel; Cameron Alexander,4,0,30,26
1656190035412,MATH 18,B01,083748,Rideout; David Porter,1,0,36,35
1656190035412,MATH 18,B02,083749,Rideout; David Porter,0,0,36,36
1656190035412,MATH 18,B03,083750,Rideout; David Porter,0,0,36,36
1656190035412,MATH 18,B04,083751,Rideout; David Porter,0,0,36,36
1656190035412,MATH 18,B05,093473,Rideout; David Porter,0,0,36,36
1656190035412,MATH 18,B06,093474,Rideout; David Porter,2,0,36,34
1656190041441,MATH 20A,A01,083754,Zheng; Zequn,11,0,40,29
1656190047465,MATH 20B,A01,083756,Briones; Jor-el Thomas Caparas,0,0,36,36
1656190047465,MATH 20B,A02,083757,Briones; Jor-el Thomas Caparas,0,0,36,36
1656190047465,MATH 20B,A03,093475,Staff,1,0,36,35
1656190053492,MATH 20C,A01,083760,Briones; Jor-el Thomas Caparas,0,0,35,35
1656190053492,MATH 20C,A02,083761,Briones; Jor-el Thomas Caparas,9,1,35,26
1656190053492,MATH 20C,A03,093476,Staff,0,0,35,35
1656190053492,MATH 20C,B01,083762,Bach; Quang Tran,1,0,30,29
1656190059515,MATH 20D,A01,083765,Tran; Brian Kha,1,0,30,29
1656190059515,MATH 20D,A02,083766,Tran; Brian Kha,0,1,30,30
1656190059515,MATH 20D,A03,083767,Tran; Brian Kha,2,0,30,28
1656190065539,MATH 20E,A01,083771,Ganguly; Soumya,3,0,32,29
1656190065539,MATH 20E,A02,083772,Ganguly; Soumya,0,0,32,32
1656190065539,MATH 20E,B01,083773,Ciotti; Benjamin,15,0,35,20
1656190065539,MATH 20E,B02,083774,Ciotti; Benjamin,15,0,35,20
1656190071563,MATH 103A,A01,083777,Greenfeld; Be'Eri,1,0,36,35
1656190071563,MATH 103A,A02,083778,Greenfeld; Be'Eri,1,0,36,35
1656190071563,MATH 103A,A03,093561,Staff,5,0,36,31
1656190071563,MATH 103A,B01,083779,Greenfeld; Be'Eri,9,1,36,27
1656190071563,MATH 103A,B02,083780,Greenfeld; Be'Eri,1,0,36,35
1656190071563,MATH 103A,B03,093562,Staff,0,0,36,36
1656190077590,MATH 105,A01,085443,Carter; Anne Toulson,5,1,35,30
1656190077590,MATH 105,A02,093477,Staff,13,0,35,22
1656190083625,MATH 109,A01,083213,Ganzberger; Geoffrey Michael,0,0,34,34
1656190083625,MATH 109,A02,083214,Ganzberger; Geoffrey Michael,0,0,34,34
1656190083625,MATH 109,A03,093478,Staff,1,0,34,33
1656190083625,MATH 109,B01,083215,Ganzberger; Geoffrey Michael,4,0,32,28
1656190083625,MATH 109,B02,083216,Ganzberger; Geoffrey Michael,1,0,32,31
1656190083625,MATH 109,B03,093479,Staff,4,0,32,28
1656190089650,MATH 142A,A01,083219,Chow; Bennett,1,0,32,31
1656190089650,MATH 142A,A02,083220,Chow; Bennett,8,0,32,24
1656190089650,MATH 142A,A03,093480,Staff,5,0,32,27
1656190089650,MATH 142A,B03,093481,Staff,3,0,32,29
1656190089650,MATH 142A,B04,093558,Staff,6,0,32,26
1656190089650,MATH 142A,B05,093559,Staff,1,0,32,31
1656190095675,MATH 193A,A01,083224,Rotar; Vladimir,0,1,34,34
1656190095675,MATH 193A,A02,083225,Rotar; Vladimir,0,0,34,34
1656190095675,MATH 193A,A03,083781,Rotar; Vladimir,1,0,34,33
1656190095675,MATH 193A,A04,083782,Rotar; Vladimir,6,0,34,28
1656190095675,MATH 193A,A05,093482,Rotar; Vladimir,0,0,34,34
1656190101700,MATH 197,001,091859,McAuley; Julian John,9999,0,9999,0
1656190101700,MATH 197,002,095566,Kedlaya; Kiran S.,9997,0,9999,2
1656190101700,MATH 197,003,095567,Xiao; Ming,9999,0,9999,0
1656190101700,MATH 197,004,095571,Perols; Johan Lars,9998,0,9999,1
1656190108755,COGS 9,A01,083615,Shannon; Kyle Michael,4,0,75,71
1656190114781,COGS 11,A01,083617,Boyle; Mary E. T.,14,0,48,34
1656190120807,COGS 13,A01,083071,Bastos; Amalia Pinkusfeld,5,0,71,66
1656190126831,COGS 14A,A01,092681,Semenuks; Arturs,4,15,100,96
1656190132854,COGS 14B,A01,083073,Cheng; Tzu-Han,7,0,63,56
1656190138877,COGS 17,A01,092677,Semenuks; Arturs,7,0,81,74
1656190144901,COGS 100,A01,083619,Allen; Michael Gordon,2,0,70,68
1656190150926,COGS 101A,A01,083621,Davis; Joshua Daniel,4,0,68,64
1656190156949,COGS 101B,A01,091572,Allen; Michael Gordon,5,0,65,60
1656190162972,COGS 101C,A01,083625,Delgado; Tania,10,0,35,25
1656190168996,COGS 107A,A01,083627,Boyle; Mary E. T.,0,0,60,60
1656190175020,COGS 118A,A01,083075,Gupta; Anjum,7,0,76,69
1656190181045,CSE 3,A50,083646,Miranda; Gregory Joseph,18,0,50,32
1656190187070,CSE 8A,A50,083650,Miranda; Gregory Joseph,3,3,56,53
1656190193093,CSE 11,A01,083080,Cao; Yingjun,1,52,40,39
1656190199122,CSE 12,A01,083652,Krause-Levy; Sophia Louisa,7,3,120,113
1656190205153,CSE 15L,A01,083654,Morris; Justin Loren,2,0,50,48
1656190205153,CSE 15L,A02,083655,Morris; Justin Loren,4,0,50,46
1656190211180,CSE 20,A01,083657,Tran; Khoa Dang,30,0,80,50
1656190217204,CSE 21,A01,095574,Bach; Quang Tran,24,0,48,24
1656190223233,CSE 30,A01,083084,Eldon; John,2,8,80,78
1656190223233,CSE 30,B01,095061,Bhaskar; Nishant,1,2,50,49
1656190229257,CSE 100,A01,083659,Cao; Yingjun,2,20,70,68
1656190235280,CSE 134B,A01,083661,Powell; Thomas Allan,3,0,100,97
1656190241303,CSE 140,A01,083663,Gungor; Onat,9,0,85,76
1656190247327,CSE 140L,A01,083088,Eldon; John,8,0,100,92
1656190253358,CSE 175,A01,083665,Kumar; Rakesh,0,0,25,25
1656190259388,CSE 190,A00,092507,Dubnov; Shlomo,3,0,20,17
1656190265412,ECE 45,A01,083139,Congero; Spencer William,1,0,75,74
1656190271435,ECE 65,A50,083695,Saad; Andrew S,9,0,30,21
1656190271435,ECE 65,A51,095125,Staff,23,0,26,3
1656190277461,ECE 109,A01,091882,Touri; Behrouz,0,1,70,70
1656190283485,ECE 180,A00,083140,Abi Samra; Nicholas Camill,1,0,30,29
1656190283485,ECE 180,B00,083141,Abi Samra; Nicholas Camill,0,4,30,30
1656190289508,MATH 10A,A01,083735,Patchell; Gregory David,0,0,30,30
1656190289508,MATH 10A,A02,083736,Patchell; Gregory David,22,0,30,8
1656190289508,MATH 10A,A03,083737,Patchell; Gregory David,16,0,30,14
1656190295536,MATH 10B,A01,083207,Lim; Seonhee,0,0,34,34
1656190295536,MATH 10B,A02,083208,Lim; Seonhee,7,0,35,28
1656190295536,MATH 10B,A03,093472,Staff,1,0,34,33
1656190295536,MATH 10B,B01,083739,Sinha; Shubham,11,0,30,19
1656190301561,MATH 18,A01,083743,Cinel; Cameron Alexander,7,0,30,23
1656190301561,MATH 18,A02,083744,Cinel; Cameron Alexander,10,0,30,20
1656190301561,MATH 18,A03,083745,Cinel; Cameron Alexander,4,0,30,26
1656190301561,MATH 18,B01,083748,Rideout; David Porter,1,0,36,35
1656190301561,MATH 18,B02,083749,Rideout; David Porter,0,0,36,36
1656190301561,MATH 18,B03,083750,Rideout; David Porter,0,0,36,36
1656190301561,MATH 18,B04,083751,Rideout; David Porter,0,0,36,36
1656190301561,MATH 18,B05,093473,Rideout; David Porter,0,0,36,36
1656190301561,MATH 18,B06,093474,Rideout; David Porter,2,0,36,34
1656190307586,MATH 20A,A01,083754,Zheng; Zequn,11,0,40,29
1656190313625,MATH 20B,A01,083756,Briones; Jor-el Thomas Caparas,0,0,36,36
1656190313625,MATH 20B,A02,083757,Briones; Jor-el Thomas Caparas,0,0,36,36
1656190313625,MATH 20B,A03,093475,Staff,1,0,36,35
1656190319654,MATH 20C,A01,083760,Briones; Jor-el Thomas Caparas,0,0,35,35
1656190319654,MATH 20C,A02,083761,Briones; Jor-el Thomas Caparas,9,1,35,26
1656190319654,MATH 20C,A03,093476,Staff,0,0,35,35
1656190319654,MATH 20C,B01,083762,Bach; Quang Tran,1,0,30,29
1656190325687,MATH 20D,A01,083765,Tran; Brian Kha,1,0,30,29
1656190325687,MATH 20D,A02,083766,Tran; Brian Kha,0,1,30,30
1656190325687,MATH 20D,A03,083767,Tran; Brian Kha,2,0,30,28
1656190331712,MATH 20E,A01,083771,Ganguly; Soumya,3,0,32,29
1656190331712,MATH 20E,A02,083772,Ganguly; Soumya,0,0,32,32
1656190331712,MATH 20E,B01,083773,Ciotti; Benjamin,15,0,35,20
1656190331712,MATH 20E,B02,083774,Ciotti; Benjamin,15,0,35,20
1656190337742,MATH 103A,A01,083777,Greenfeld; Be'Eri,1,0,36,35
1656190337742,MATH 103A,A02,083778,Greenfeld; Be'Eri,1,0,36,35
1656190337742,MATH 103A,A03,093561,Staff,5,0,36,31
1656190337742,MATH 103A,B01,083779,Greenfeld; Be'Eri,9,1,36,27
1656190337742,MATH 103A,B02,083780,Greenfeld; Be'Eri,1,0,36,35
1656190337742,MATH 103A,B03,093562,Staff,0,0,36,36
1656190343770,MATH 105,A01,085443,Carter; Anne Toulson,5,1,35,30
1656190343770,MATH 105,A02,093477,Staff,13,0,35,22
1656190349793,MATH 109,A01,083213,Ganzberger; Geoffrey Michael,0,0,34,34
1656190349793,MATH 109,A02,083214,Ganzberger; Geoffrey Michael,0,0,34,34
1656190349793,MATH 109,A03,093478,Staff,1,0,34,33
1656190349793,MATH 109,B01,083215,Ganzberger; Geoffrey Michael,4,0,32,28
1656190349793,MATH 109,B02,083216,Ganzberger; Geoffrey Michael,1,0,32,31
1656190349793,MATH 109,B03,093479,Staff,4,0,32,28
1656190355817,MATH 142A,A01,083219,Chow; Bennett,1,0,32,31
1656190355817,MATH 142A,A02,083220,Chow; Bennett,8,0,32,24
1656190355817,MATH 142A,A03,093480,Staff,5,0,32,27
1656190355817,MATH 142A,B03,093481,Staff,3,0,32,29
1656190355817,MATH 142A,B04,093558,Staff,6,0,32,26
1656190355817,MATH 142A,B05,093559,Staff,1,0,32,31
1656190361848,MATH 193A,A01,083224,Rotar; Vladimir,0,1,34,34
1656190361848,MATH 193A,A02,083225,Rotar; Vladimir,0,0,34,34
1656190361848,MATH 193A,A03,083781,Rotar; Vladimir,1,0,34,33
1656190361848,MATH 193A,A04,083782,Rotar; Vladimir,6,0,34,28
1656190361848,MATH 193A,A05,093482,Rotar; Vladimir,0,0,34,34
1656190367872,MATH 197,001,091859,McAuley; Julian John,9999,0,9999,0
1656190367872,MATH 197,002,095566,Kedlaya; Kiran S.,9997,0,9999,2
1656190367872,MATH 197,003,095567,Xiao; Ming,9999,0,9999,0
1656190367872,MATH 197,004,095571,Perols; Johan Lars,9998,0,9999,1
1656190374935,COGS 9,A01,083615,Shannon; Kyle Michael,4,0,75,71
1656190380964,COGS 11,A01,083617,Boyle; Mary E. T.,14,0,48,34
1656190386988,COGS 13,A01,083071,Bastos; Amalia Pinkusfeld,4,0,71,67
1656190393011,COGS 14A,A01,092681,Semenuks; Arturs,4,15,100,96
1656190399126,COGS 14B,A01,083073,Cheng; Tzu-Han,7,0,63,56
1656190405149,COGS 17,A01,092677,Semenuks; Arturs,7,0,81,74
1656190411183,COGS 100,A01,083619,Allen; Michael Gordon,2,0,70,68
1656190417212,COGS 101A,A01,083621,Davis; Joshua Daniel,4,0,68,64
1656190423242,COGS 101B,A01,091572,Allen; Michael Gordon,5,0,65,60
1656190429267,COGS 101C,A01,083625,Delgado; Tania,10,0,35,25
1656190435289,COGS 107A,A01,083627,Boyle; Mary E. T.,0,0,60,60
1656190441313,COGS 118A,A01,083075,Gupta; Anjum,7,0,76,69
1656190447341,CSE 3,A50,083646,Miranda; Gregory Joseph,18,0,50,32
1656190453364,CSE 8A,A50,083650,Miranda; Gregory Joseph,3,3,56,53
1656190459387,CSE 11,A01,083080,Cao; Yingjun,1,52,40,39
1656190465409,CSE 12,A01,083652,Krause-Levy; Sophia Louisa,7,3,120,113
1656190471434,CSE 15L,A01,083654,Morris; Justin Loren,2,0,50,48
1656190471434,CSE 15L,A02,083655,Morris; Justin Loren,4,0,50,46
1656190477463,CSE 20,A01,083657,Tran; Khoa Dang,30,0,80,50
1656190483485,CSE 21,A01,095574,Bach; Quang Tran,24,0,48,24
1656190489512,CSE 30,A01,083084,Eldon; John,2,8,80,78
1656190489512,CSE 30,B01,095061,Bhaskar; Nishant,1,2,50,49
1656190495534,CSE 100,A01,083659,Cao; Yingjun,2,20,70,68
1656190501557,CSE 134B,A01,083661,Powell; Thomas Allan,3,0,100,97
1656190507580,CSE 140,A01,083663,Gungor; Onat,9,0,85,76
1656190513606,CSE 140L,A01,083088,Eldon; John,8,0,100,92
1656190519629,CSE 175,A01,083665,Kumar; Rakesh,0,0,25,25
1656190525652,CSE 190,A00,092507,Dubnov; Shlomo,3,0,20,17
1656190531675,ECE 45,A01,083139,Congero; Spencer William,1,0,75,74
1656190537703,ECE 65,A50,083695,Saad; Andrew S,9,0,30,21
1656190537703,ECE 65,A51,095125,Staff,23,0,26,3
1656190543726,ECE 109,A01,091882,Touri; Behrouz,0,1,70,70
1656190549750,ECE 180,A00,083140,Abi Samra; Nicholas Camill,1,0,30,29
1656190549750,ECE 180,B00,083141,Abi Samra; Nicholas Camill,0,4,30,30
1656190555777,MATH 10A,A01,083735,Patchell; Gregory David,0,0,30,30
1656190555777,MATH 10A,A02,083736,Patchell; Gregory David,22,0,30,8
1656190555777,MATH 10A,A03,083737,Patchell; Gregory David,16,0,30,14
1656190561808,MATH 10B,A01,083207,Lim; Seonhee,0,0,34,34
1656190561808,MATH 10B,A02,083208,Lim; Seonhee,7,0,35,28
1656190561808,MATH 10B,A03,093472,Staff,1,0,34,33
1656190561808,MATH 10B,B01,083739,Sinha; Shubham,11,0,30,19
1656190567833,MATH 18,A01,083743,Cinel; Cameron Alexander,7,0,30,23
1656190567833,MATH 18,A02,083744,Cinel; Cameron Alexander,10,0,30,20
1656190567833,MATH 18,A03,083745,Cinel; Cameron Alexander,4,0,30,26
1656190567833,MATH 18,B01,083748,Rideout; David Porter,1,0,36,35
1656190567833,MATH 18,B02,083749,Rideout; David Porter,0,0,36,36
1656190567833,MATH 18,B03,083750,Rideout; David Porter,0,0,36,36
1656190567833,MATH 18,B04,083751,Rideout; David Porter,0,0,36,36
1656190567833,MATH 18,B05,093473,Rideout; David Porter,0,0,36,36
1656190567833,MATH 18,B06,093474,Rideout; David Porter,2,0,36,34
1656190573856,MATH 20A,A01,083754,Zheng; Zequn,11,0,40,29
1656190579883,MATH 20B,A01,083756,Briones; Jor-el Thomas Caparas,0,0,36,36
1656190579883,MATH 20B,A02,083757,Briones; Jor-el Thomas Caparas,0,0,36,36
1656190579883,MATH 20B,A03,093475,Staff,1,0,36,35
1656190585907,MATH 20C,A01,083760,Briones; Jor-el Thomas Caparas,0,0,35,35
1656190585907,MATH 20C,A02,083761,Briones; Jor-el Thomas Caparas,9,1,35,26
1656190585907,MATH 20C,A03,093476,Staff,0,0,35,35
1656190585907,MATH 20C,B01,083762,Bach; Quang Tran,1,0,30,29
1656190591936,MATH 20D,A01,083765,Tran; Brian Kha,1,0,30,29
1656190591936,MATH 20D,A02,083766,Tran; Brian Kha,0,1,30,30
1656190591936,MATH 20D,A03,083767,Tran; Brian Kha,2,0,30,28
1656190597970,MATH 20E,A01,083771,Ganguly; Soumya,3,0,32,29
1656190597970,MATH 20E,A02,083772,Ganguly; Soumya,0,0,32,32
1656190597970,MATH 20E,B01,083773,Ciotti; Benjamin,15,0,35,20
1656190597970,MATH 20E,B02,083774,Ciotti; Benjamin,15,0,35,20
1656190604001,MATH 103A,A01,083777,Greenfeld; Be'Eri,1,0,36,35
1656190604001,MATH 103A,A02,083778,Greenfeld; Be'Eri,1,0,36,35
1656190604001,MATH 103A,A03,093561,Staff,5,0,36,31
1656190604001,MATH 103A,B01,083779,Greenfeld; Be'Eri,9,1,36,27
1656190604001,MATH 103A,B02,083780,Greenfeld; Be'Eri,1,0,36,35
1656190604001,MATH 103A,B03,093562,Staff,0,0,36,36
1656190610029,MATH 105,A01,085443,Carter; Anne Toulson,5,1,35,30
1656190610029,MATH 105,A02,093477,Staff,13,0,35,22
1656190616051,MATH 109,A01,083213,Ganzberger; Geoffrey Michael,0,0,34,34
1656190616051,MATH 109,A02,083214,Ganzberger; Geoffrey Michael,0,0,34,34
1656190616051,MATH 109,A03,093478,Staff,1,0,34,33
1656190616051,MATH 109,B01,083215,Ganzberger; Geoffrey Michael,4,0,32,28
1656190616051,MATH 109,B02,083216,Ganzberger; Geoffrey Michael,1,0,32,31
1656190616051,MATH 109,B03,093479,Staff,4,0,32,28
1656190622081,MATH 142A,A01,083219,Chow; Bennett,1,0,32,31
1656190622081,MATH 142A,A02,083220,Chow; Bennett,8,0,32,24
1656190622081,MATH 142A,A03,093480,Staff,5,0,32,27
1656190622081,MATH 142A,B03,093481,Staff,3,0,32,29
1656190622081,MATH 142A,B04,093558,Staff,6,0,32,26
1656190622081,MATH 142A,B05,093559,Staff,1,0,32,31
1656190628109,MATH 193A,A01,083224,Rotar; Vladimir,0,1,34,34
1656190628109,MATH 193A,A02,083225,Rotar; Vladimir,0,0,34,34
1656190628109,MATH 193A,A03,083781,Rotar; Vladimir,1,0,34,33
1656190628109,MATH 193A,A04,083782,Rotar; Vladimir,6,0,34,28
1656190628109,MATH 193A,A05,093482,Rotar; Vladimir,0,0,34,34
1656190634139,MATH 197,001,091859,McAuley; Julian John,9999,0,9999,0
1656190634139,MATH 197,002,095566,Kedlaya; Kiran S.,9997,0,9999,2
1656190634139,MATH 197,003,095567,Xiao; Ming,9999,0,9999,0
1656190634139,MATH 197,004,095571,Perols; Johan Lars,9998,0,9999,1
1656190641204,COGS 9,A01,083615,Shannon; Kyle Michael,4,0,75,71
1656190647228,COGS 11,A01,083617,Boyle; Mary E. T.,14,0,48,34
1656190653256,COGS 13,A01,083071,Bastos; Amalia Pinkusfeld,4,0,71,67
1656190659282,COGS 14A,A01,092681,Semenuks; Arturs,4,15,100,96
1656190665317,COGS 14B,A01,083073,Cheng; Tzu-Han,7,0,63,56
1656190671339,COGS 17,A01,092677,Semenuks; Arturs,7,0,81,74
1656190677366,COGS 100,A01,083619,Allen; Michael Gordon,2,0,70,68
1656190683389,COGS 101A,A01,083621,Davis; Joshua Daniel,4,0,68,64
1656190689419,COGS 101B,A01,091572,Allen; Michael Gordon,5,0,65,60
1656190695445,COGS 101C,A01,083625,Delgado; Tania,10,0,35,25
1656190701473,COGS 107A,A01,083627,Boyle; Mary E. T.,0,0,60,60
1656190707496,COGS 118A,A01,083075,Gupta; Anjum,7,0,76,69
1656190713529,CSE 3,A50,083646,Miranda; Gregory Joseph,18,0,50,32
1656190719568,CSE 8A,A50,083650,Miranda; Gregory Joseph,3,3,56,53
1656190725597,CSE 11,A01,083080,Cao; Yingjun,1,52,40,39
1656190731620,CSE 12,A01,083652,Krause-Levy; Sophia Louisa,7,3,120,113
1656190737643,CSE 15L,A01,083654,Morris; Justin Loren,2,0,50,48
1656190737643,CSE 15L,A02,083655,Morris; Justin Loren,4,0,50,46
1656190743667,CSE 20,A01,083657,Tran; Khoa Dang,30,0,80,50
1656190749695,CSE 21,A01,095574,Bach; Quang Tran,24,0,48,24
1656190755719,CSE 30,A01,083084,Eldon; John,2,8,80,78
1656190755719,CSE 30,B01,095061,Bhaskar; Nishant,1,2,50,49
1656190761742,CSE 100,A01,083659,Cao; Yingjun,2,20,70,68
1656190767769,CSE 134B,A01,083661,Powell; Thomas Allan,3,0,100,97
1656190773792,CSE 140,A01,083663,Gungor; Onat,9,0,85,76
1656190779815,CSE 140L,A01,083088,Eldon; John,8,0,100,92
1656190785838,CSE 175,A01,083665,Kumar; Rakesh,0,0,25,25
1656190791862,CSE 190,A00,092507,Dubnov; Shlomo,3,0,20,17
1656190797891,ECE 45,A01,083139,Congero; Spencer William,1,0,75,74
1656190803918,ECE 65,A50,083695,Saad; Andrew S,9,0,30,21
1656190803918,ECE 65,A51,095125,Staff,23,0,26,3
1656190809943,ECE 109,A01,091882,Touri; Behrouz,0,1,70,70
1656190815970,ECE 180,A00,083140,Abi Samra; Nicholas Camill,1,0,30,29
1656190815970,ECE 180,B00,083141,Abi Samra; Nicholas Camill,0,4,30,30
1656190821996,MATH 10A,A01,083735,Patchell; Gregory David,0,0,30,30
1656190821996,MATH 10A,A02,083736,Patchell; Gregory David,22,0,30,8
1656190821996,MATH 10A,A03,083737,Patchell; Gregory David,16,0,30,14
1656190828019,MATH 10B,A01,083207,Lim; Seonhee,0,0,34,34
1656190828019,MATH 10B,A02,083208,Lim; Seonhee,7,0,35,28
1656190828019,MATH 10B,A03,093472,Staff,1,0,34,33
1656190828019,MATH 10B,B01,083739,Sinha; Shubham,11,0,30,19
1656190834044,MATH 18,A01,083743,Cinel; Cameron Alexander,7,0,30,23
1656190834044,MATH 18,A02,083744,Cinel; Cameron Alexander,10,0,30,20
1656190834044,MATH 18,A03,083745,Cinel; Cameron Alexander,4,0,30,26
1656190834044,MATH 18,B01,083748,Rideout; David Porter,1,0,36,35
1656190834044,MATH 18,B02,083749,Rideout; David Porter,0,0,36,36
1656190834044,MATH 18,B03,083750,Rideout; David Porter,0,0,36,36
1656190834044,MATH 18,B04,083751,Rideout; David Porter,0,0,36,36
1656190834044,MATH 18,B05,093473,Rideout; David Porter,0,0,36,36
1656190834044,MATH 18,B06,093474,Rideout; David Porter,2,0,36,34
1656190840071,MATH 20A,A01,083754,Zheng; Zequn,11,0,40,29
1656190846092,MATH 20B,A01,083756,Briones; Jor-el Thomas Caparas,0,0,36,36
1656190846092,MATH 20B,A02,083757,Briones; Jor-el Thomas Caparas,0,0,36,36
1656190846092,MATH 20B,A03,093475,Staff,1,0,36,35
1656190852115,MATH 20C,A01,083760,Briones; Jor-el Thomas Caparas,0,0,35,35
1656190852115,MATH 20C,A02,083761,Briones; Jor-el Thomas Caparas,9,1,35,26
1656190852115,MATH 20C,A03,093476,Staff,0,0,35,35
1656190852115,MATH 20C,B01,083762,Bach; Quang Tran,1,0,30,29
1656190858158,MATH 20D,A01,083765,Tran; Brian Kha,1,0,30,29
1656190858158,MATH 20D,A02,083766,Tran; Brian Kha,0,1,30,30
1656190858158,MATH 20D,A03,083767,Tran; Brian Kha,2,0,30,28
1656190864187,MATH 20E,A01,083771,Ganguly; Soumya,3,0,32,29
1656190864187,MATH 20E,A02,083772,Ganguly; Soumya,0,0,32,32
1656190864187,MATH 20E,B01,083773,Ciotti; Benjamin,15,0,35,20
1656190864187,MATH 20E,B02,083774,Ciotti; Benjamin,15,0,35,20
1656190870218,MATH 103A,A01,083777,Greenfeld; Be'Eri,1,0,36,35
1656190870218,MATH 103A,A02,083778,Greenfeld; Be'Eri,1,0,36,35
1656190870218,MATH 103A,A03,093561,Staff,5,0,36,31
1656190870218,MATH 103A,B01,083779,Greenfeld; Be'Eri,9,1,36,27
1656190870218,MATH 103A,B02,083780,Greenfeld; Be'Eri,1,0,36,35
1656190870218,MATH 103A,B03,093562,Staff,0,0,36,36
1656190876241,MATH 105,A01,085443,Carter; Anne Toulson,5,1,35,30
1656190876241,MATH 105,A02,093477,Staff,13,0,35,22
1656190882264,MATH 109,A01,083213,Ganzberger; Geoffrey Michael,0,0,34,34
1656190882264,MATH 109,A02,083214,Ganzberger; Geoffrey Michael,0,0,34,34
1656190882264,MATH 109,A03,093478,Staff,1,0,34,33
1656190882264,MATH 109,B01,083215,Ganzberger; Geoffrey Michael,4,0,32,28
1656190882264,MATH 109,B02,083216,Ganzberger; Geoffrey Michael,1,0,32,31
1656190882264,MATH 109,B03,093479,Staff,4,0,32,28
1656190888287,MATH 142A,A01,083219,Chow; Bennett,1,0,32,31
1656190888287,MATH 142A,A02,083220,Chow; Bennett,8,0,32,24
1656190888287,MATH 142A,A03,093480,Staff,5,0,32,27
1656190888287,MATH 142A,B03,093481,Staff,3,0,32,29
1656190888287,MATH 142A,B04,093558,Staff,6,0,32,26
1656190888287,MATH 142A,B05,093559,Staff,1,0,32,31
1656190894311,MATH 193A,A01,083224,Rotar; Vladimir,0,1,34,34
1656190894311,MATH 193A,A02,083225,Rotar; Vladimir,0,0,34,34
1656190894311,MATH 193A,A03,083781,Rotar; Vladimir,1,0,34,33
1656190894311,MATH 193A,A04,083782,Rotar; Vladimir,6,0,34,28
1656190894311,MATH 193A,A05,093482,Rotar; Vladimir,0,0,34,34
1656190900336,MATH 197,001,091859,McAuley; Julian John,9999,0,9999,0
1656190900336,MATH 197,002,095566,Kedlaya; Kiran S.,9997,0,9999,2
1656190900336,MATH 197,003,095567,Xiao; Ming,9999,0,9999,0
1656190900336,MATH 197,004,095571,Perols; Johan Lars,9998,0,9999,1
1656190907403,COGS 9,A01,083615,Shannon; Kyle Michael,4,0,75,71
1656190913426,COGS 11,A01,083617,Boyle; Mary E. T.,14,0,48,34
1656190919449,COGS 13,A01,083071,Bastos; Amalia Pinkusfeld,4,0,71,67
1656190925472,COGS 14A,A01,092681,Semenuks; Arturs,4,15,100,96
1656190931497,COGS 14B,A01,083073,Cheng; Tzu-Han,7,0,63,56
1656190937524,COGS 17,A01,092677,Semenuks; Arturs,7,0,81,74
1656190943551,COGS 100,A01,083619,Allen; Michael Gordon,2,0,70,68
1656190949579,COGS 101A,A01,083621,Davis; Joshua Daniel,4,0,68,64
1656190955605,COGS 101B,A01,091572,Allen; Michael Gordon,5,0,65,60
1656190961636,COGS 101C,A01,083625,Delgado; Tania,10,0,35,25
1656190967666,COGS 107A,A01,083627,Boyle; Mary E. T.,0,0,60,60
1656190973690,COGS 118A,A01,083075,Gupta; Anjum,7,0,76,69
1656190979719,CSE 3,A50,083646,Miranda; Gregory Joseph,18,0,50,32
1656190985755,CSE 8A,A50,083650,Miranda; Gregory Joseph,3,3,56,53
1656190991779,CSE 11,A01,083080,Cao; Yingjun,1,52,40,39
1656190997895,CSE 12,A01,083652,Krause-Levy; Sophia Louisa,7,3,120,113
1656191003918,CSE 15L,A01,083654,Morris; Justin Loren,2,0,50,48
1656191003918,CSE 15L,A02,083655,Morris; Justin Loren,4,0,50,46
1656191009947,CSE 20,A01,083657,Tran; Khoa Dang,30,0,80,50
1656191015971,CSE 21,A01,095574,Bach; Quang Tran,24,0,48,24
1656191021999,CSE 30,A01,083084,Eldon; John,2,8,80,78
1656191021999,CSE 30,B01,095061,Bhaskar; Nishant,1,2,50,49
1656191028022,CSE 100,A01,083659,Cao; Yingjun,2,20,70,68
1656191034045,CSE 134B,A01,083661,Powell; Thomas Allan,3,0,100,97
1656191040071,CSE 140,A01,083663,Gungor; Onat,9,0,85,76
1656191046094,CSE 140L,A01,083088,Eldon; John,8,0,100,92
1656191052129,CSE 175,A01,083665,Kumar; Rakesh,0,0,25,25
1656191058152,CSE 190,A00,092507,Dubnov; Shlomo,2,0,20,18
1656191064179,ECE 45,A01,083139,Congero; Spencer William,1,0,75,74
1656191070206,ECE 65,A50,083695,Saad; Andrew S,9,0,30,21
1656191070206,ECE 65,A51,095125,Staff,23,0,26,3
1656191076239,ECE 109,A01,091882,Touri; Behrouz,0,1,70,70
1656191082271,ECE 180,A00,083140,Abi Samra; Nicholas Camill,1,0,30,29
1656191082271,ECE 180,B00,083141,Abi Samra; Nicholas Camill,0,4,30,30
1656191088304,MATH 10A,A01,083735,Patchell; Gregory David,0,0,30,30
1656191088304,MATH 10A,A02,083736,Patchell; Gregory David,22,0,30,8
1656191088304,MATH 10A,A03,083737,Patchell; Gregory David,16,0,30,14
1656191094329,MATH 10B,A01,083207,Lim; Seonhee,0,0,34,34
1656191094329,MATH 10B,A02,083208,Lim; Seonhee,7,0,35,28
1656191094329,MATH 10B,A03,093472,Staff,1,0,34,33
1656191094329,MATH 10B,B01,083739,Sinha; Shubham,11,0,30,19
1656191100366,MATH 18,A01,083743,Cinel; Cameron Alexander,7,0,30,23
1656191100366,MATH 18,A02,083744,Cinel; Cameron Alexander,10,0,30,20
1656191100366,MATH 18,A03,083745,Cinel; Cameron Alexander,4,0,30,26
1656191100366,MATH 18,B01,083748,Rideout; David Porter,1,0,36,35
1656191100366,MATH 18,B02,083749,Rideout; David Porter,0,0,36,36
1656191100366,MATH 18,B03,083750,Rideout; David Porter,0,0,36,36
1656191100366,MATH 18,B04,083751,Rideout; David Porter,0,0,36,36
1656191100366,MATH 18,B05,093473,Rideout; David Porter,0,0,36,36
1656191100366,MATH 18,B06,093474,Rideout; David Porter,2,0,36,34
1656191106390,MATH 20A,A01,083754,Zheng; Zequn,11,0,40,29
1656191112413,MATH 20B,A01,083756,Briones; Jor-el Thomas Caparas,0,0,36,36
1656191112413,MATH 20B,A02,083757,Briones; Jor-el Thomas Caparas,0,0,36,36
1656191112413,MATH 20B,A03,093475,Staff,1,0,36,35
1656191118444,MATH 20C,A01,083760,Briones; Jor-el Thomas Caparas,0,0,35,35
1656191118444,MATH 20C,A02,083761,Briones; Jor-el Thomas Caparas,9,1,35,26
1656191118444,MATH 20C,A03,093476,Staff,0,0,35,35
1656191118444,MATH 20C,B01,083762,Bach; Quang Tran,1,0,30,29
1656191124472,MATH 20D,A01,083765,Tran; Brian Kha,1,0,30,29
1656191124472,MATH 20D,A02,083766,Tran; Brian Kha,0,1,30,30
1656191124472,MATH 20D,A03,083767,Tran; Brian Kha,2,0,30,28
1656191130500,MATH 20E,A01,083771,Ganguly; Soumya,3,0,32,29
1656191130500,MATH 20E,A02,083772,Ganguly; Soumya,0,0,32,32
1656191130500,MATH 20E,B01,083773,Ciotti; Benjamin,15,0,35,20
1656191130500,MATH 20E,B02,083774,Ciotti; Benjamin,15,0,35,20
1656191136529,MATH 103A,A01,083777,Greenfeld; Be'Eri,1,0,36,35
1656191136529,MATH 103A,A02,083778,Greenfeld; Be'Eri,1,0,36,35
1656191136529,MATH 103A,A03,093561,Staff,5,0,36,31
1656191136529,MATH 103A,B01,083779,Greenfeld; Be'Eri,9,1,36,27
1656191136529,MATH 103A,B02,083780,Greenfeld; Be'Eri,1,0,36,35
1656191136529,MATH 103A,B03,093562,Staff,0,0,36,36
1656191142558,MATH 105,A01,085443,Carter; Anne Toulson,5,1,35,30
1656191142558,MATH 105,A02,093477,Staff,13,0,35,22
1656191148582,MATH 109,A01,083213,Ganzberger; Geoffrey Michael,0,0,34,34
1656191148582,MATH 109,A02,083214,Ganzberger; Geoffrey Michael,0,0,34,34
1656191148582,MATH 109,A03,093478,Staff,1,0,34,33
1656191148582,MATH 109,B01,083215,Ganzberger; Geoffrey Michael,4,0,32,28
1656191148582,MATH 109,B02,083216,Ganzberger; Geoffrey Michael,1,0,32,31
1656191148582,MATH 109,B03,093479,Staff,4,0,32,28
1656191154612,MATH 142A,A01,083219,Chow; Bennett,1,0,32,31
1656191154612,MATH 142A,A02,083220,Chow; Bennett,8,0,32,24
1656191154612,MATH 142A,A03,093480,Staff,5,0,32,27
1656191154612,MATH 142A,B03,093481,Staff,3,0,32,29
1656191154612,MATH 142A,B04,093558,Staff,6,0,32,26
1656191154612,MATH 142A,B05,093559,Staff,1,0,32,31
1656191160644,MATH 193A,A01,083224,Rotar; Vladimir,0,1,34,34
1656191160644,MATH 193A,A02,083225,Rotar; Vladimir,0,0,34,34
1656191160644,MATH 193A,A03,083781,Rotar; Vladimir,1,0,34,33
1656191160644,MATH 193A,A04,083782,Rotar; Vladimir,6,0,34,28
1656191160644,MATH 193A,A05,093482,Rotar; Vladimir,0,0,34,34
1656191166669,MATH 197,001,091859,McAuley; Julian John,9999,0,9999,0
1656191166669,MATH 197,002,095566,Kedlaya; Kiran S.,9997,0,9999,2
1656191166669,MATH 197,003,095567,Xiao; Ming,9999,0,9999,0
1656191166669,MATH 197,004,095571,Perols; Johan Lars,9998,0,9999,1
1656191173739,COGS 9,A01,083615,Shannon; Kyle Michael,4,0,75,71
1656191179761,COGS 11,A01,083617,Boyle; Mary E. T.,14,0,48,34
1656191185788,COGS 13,A01,083071,Bastos; Amalia Pinkusfeld,4,0,71,67
1656191191815,COGS 14A,A01,092681,Semenuks; Arturs,4,15,100,96
1656191197842,COGS 14B,A01,083073,Cheng; Tzu-Han,7,0,63,56
1656191203865,COGS 17,A01,092677,Semenuks; Arturs,7,0,81,74
1656191209889,COGS 100,A01,083619,Allen; Michael Gordon,2,0,70,68
1656191215915,COGS 101A,A01,083621,Davis; Joshua Daniel,4,0,68,64
1656191221942,COGS 101B,A01,091572,Allen; Michael Gordon,5,0,65,60
1656191227968,COGS 101C,A01,083625,Delgado; Tania,10,0,35,25
1656191233994,COGS 107A,A01,083627,Boyle; Mary E. T.,0,0,60,60
1656191240016,COGS 118A,A01,083075,Gupta; Anjum,7,0,76,69
1656191246044,CSE 3,A50,083646,Miranda; Gregory Joseph,18,0,50,32
1656191252073,CSE 8A,A50,083650,Miranda; Gregory Joseph,3,3,56,53
1656191258100,CSE 11,A01,083080,Cao; Yingjun,1,52,40,39
1656191264124,CSE 12,A01,083652,Krause-Levy; Sophia Louisa,7,3,120,113
1656191270146,CSE 15L,A01,083654,Morris; Justin Loren,2,0,50,48
1656191270146,CSE 15L,A02,083655,Morris; Justin Loren,4,0,50,46
1656191276169,CSE 20,A01,083657,Tran; Khoa Dang,30,0,80,50
1656191282191,CSE 21,A01,095574,Bach; Quang Tran,24,0,48,24
1656191288214,CSE 30,A01,083084,Eldon; John,2,8,80,78
1656191288214,CSE 30,B01,095061,Bhaskar; Nishant,1,2,50,49
1656191294241,CSE 100,A01,083659,Cao; Yingjun,2,20,70,68
1656191300265,CSE 134B,A01,083661,Powell; Thomas Allan,3,0,100,97
1656191306287,CSE 140,A01,083663,Gungor; Onat,9,0,85,76
1656191312315,CSE 140L,A01,083088,Eldon; John,8,0,100,92
1656191318339,CSE 175,A01,083665,Kumar; Rakesh,0,0,25,25
1656191324362,CSE 190,A00,092507,Dubnov; Shlomo,2,0,20,18
1656191330387,ECE 45,A01,083139,Congero; Spencer William,1,0,75,74
1656191336410,ECE 65,A50,083695,Saad; Andrew S,9,0,30,21
1656191336410,ECE 65,A51,095125,Staff,23,0,26,3
1656191342434,ECE 109,A01,091882,Touri; Behrouz,0,1,70,70
1656191348458,ECE 180,A00,083140,Abi Samra; Nicholas Camill,1,0,30,29
1656191348458,ECE 180,B00,083141,Abi Samra; Nicholas Camill,0,4,30,30
1656191354485,MATH 10A,A01,083735,Patchell; Gregory David,0,0,30,30
1656191354485,MATH 10A,A02,083736,Patchell; Gregory David,22,0,30,8
1656191354485,MATH 10A,A03,083737,Patchell; Gregory David,16,0,30,14
1656191360518,MATH 10B,A01,083207,Lim; Seonhee,0,0,34,34
1656191360518,MATH 10B,A02,083208,Lim; Seonhee,7,0,35,28
1656191360518,MATH 10B,A03,093472,Staff,1,0,34,33
1656191360518,MATH 10B,B01,083739,Sinha; Shubham,11,0,30,19
1656191366548,MATH 18,A01,083743,Cinel; Cameron Alexander,7,0,30,23
1656191366548,MATH 18,A02,083744,Cinel; Cameron Alexander,10,0,30,20
1656191366548,MATH 18,A03,083745,Cinel; Cameron Alexander,4,0,30,26
1656191366548,MATH 18,B01,083748,Rideout; David Porter,1,0,36,35
1656191366548,MATH 18,B02,083749,Rideout; David Porter,0,0,36,36
1656191366548,MATH 18,B03,083750,Rideout; David Porter,0,0,36,36
1656191366548,MATH 18,B04,083751,Rideout; David Porter,0,0,36,36
1656191366548,MATH 18,B05,093473,Rideout; David Porter,0,0,36,36
1656191366548,MATH 18,B06,093474,Rideout; David Porter,2,0,36,34
1656191372577,MATH 20A,A01,083754,Zheng; Zequn,11,0,40,29
1656191378605,MATH 20B,A01,083756,Briones; Jor-el Thomas Caparas,0,0,36,36
1656191378605,MATH 20B,A02,083757,Briones; Jor-el Thomas Caparas,0,0,36,36
1656191378605,MATH 20B,A03,093475,Staff,1,0,36,35
1656191384634,MATH 20C,A01,083760,Briones; Jor-el Thomas Caparas,0,0,35,35
1656191384634,MATH 20C,A02,083761,Briones; Jor-el Thomas Caparas,9,1,35,26
1656191384634,MATH 20C,A03,093476,Staff,0,0,35,35
1656191384634,MATH 20C,B01,083762,Bach; Quang Tran,1,0,30,29
1656191390658,MATH 20D,A01,083765,Tran; Brian Kha,1,0,30,29
1656191390658,MATH 20D,A02,083766,Tran; Brian Kha,0,1,30,30
1656191390658,MATH 20D,A03,083767,Tran; Brian Kha,2,0,30,28
1656191396681,MATH 20E,A01,083771,Ganguly; Soumya,3,0,32,29
1656191396681,MATH 20E,A02,083772,Ganguly; Soumya,0,0,32,32
1656191396681,MATH 20E,B01,083773,Ciotti; Benjamin,15,0,35,20
1656191396681,MATH 20E,B02,083774,Ciotti; Benjamin,15,0,35,20
1656191402706,MATH 103A,A01,083777,Greenfeld; Be'Eri,1,0,36,35
1656191402706,MATH 103A,A02,083778,Greenfeld; Be'Eri,1,0,36,35
1656191402706,MATH 103A,A03,093561,Staff,5,0,36,31
1656191402706,MATH 103A,B01,083779,Greenfeld; Be'Eri,9,1,36,27
1656191402706,MATH 103A,B02,083780,Greenfeld; Be'Eri,1,0,36,35
1656191402706,MATH 103A,B03,093562,Staff,0,0,36,36
1656191408734,MATH 105,A01,085443,Carter; Anne Toulson,5,1,35,30
1656191408734,MATH 105,A02,093477,Staff,13,0,35,22
1656191414761,MATH 109,A01,083213,Ganzberger; Geoffrey Michael,0,0,34,34
1656191414761,MATH 109,A02,083214,Ganzberger; Geoffrey Michael,0,0,34,34
1656191414761,MATH 109,A03,093478,Staff,1,0,34,33
1656191414761,MATH 109,B01,083215,Ganzberger; Geoffrey Michael,4,0,32,28
1656191414761,MATH 109,B02,083216,Ganzberger; Geoffrey Michael,1,0,32,31
1656191414761,MATH 109,B03,093479,Staff,4,0,32,28
1656191420785,MATH 142A,A01,083219,Chow; Bennett,1,0,32,31
1656191420785,MATH 142A,A02,083220,Chow; Bennett,8,0,32,24
1656191420785,MATH 142A,A03,093480,Staff,5,0,32,27
1656191420785,MATH 142A,B03,093481,Staff,3,0,32,29
1656191420785,MATH 142A,B04,093558,Staff,6,0,32,26
1656191420785,MATH 142A,B05,093559,Staff,1,0,32,31
1656191426809,MATH 193A,A01,083224,Rotar; Vladimir,0,1,34,34
1656191426809,MATH 193A,A02,083225,Rotar; Vladimir,0,0,34,34
1656191426809,MATH 193A,A03,083781,Rotar; Vladimir,1,0,34,33
1656191426809,MATH 193A,A04,083782,Rotar; Vladimir,6,0,34,28
1656191426809,MATH 193A,A05,093482,Rotar; Vladimir,0,0,34,34
1656191432840,MATH 197,001,091859,McAuley; Julian John,9999,0,9999,0
1656191432840,MATH 197,002,095566,Kedlaya; Kiran S.,9997,0,9999,2
1656191432840,MATH 197,003,095567,Xiao; Ming,9999,0,9999,0
1656191432840,MATH 197,004,095571,Perols; Johan Lars,9998,0,9999,1
1656191439906,COGS 9,A01,083615,Shannon; Kyle Michael,4,0,75,71
1656191445929,COGS 11,A01,083617,Boyle; Mary E. T.,14,0,48,34
1656191451954,COGS 13,A01,083071,Bastos; Amalia Pinkusfeld,4,0,71,67
1656191457988,COGS 14A,A01,092681,Semenuks; Arturs,4,15,100,96
1656191464015,COGS 14B,A01,083073,Cheng; Tzu-Han,7,0,63,56
1656191470039,COGS 17,A01,092677,Semenuks; Arturs,7,0,81,74
1656191476062,COGS 100,A01,083619,Allen; Michael Gordon,2,0,70,68
1656191482089,COGS 101A,A01,083621,Davis; Joshua Daniel,4,0,68,64
1656191488117,COGS 101B,A01,091572,Allen; Michael Gordon,5,0,65,60
1656191494140,COGS 101C,A01,083625,Delgado; Tania,10,0,35,25
1656191500168,COGS 107A,A01,083627,Boyle; Mary E. T.,0,0,60,60
1656191506215,COGS 118A,A01,083075,Gupta; Anjum,7,0,76,69
1656191512244,CSE 3,A50,083646,Miranda; Gregory Joseph,18,0,50,32
1656191518268,CSE 8A,A50,083650,Miranda; Gregory Joseph,3,3,56,53
1656191524291,CSE 11,A01,083080,Cao; Yingjun,1,52,40,39
1656191530312,CSE 12,A01,083652,Krause-Levy; Sophia Louisa,7,3,120,113
1656191536335,CSE 15L,A01,083654,Morris; Justin Loren,2,0,50,48
1656191536335,CSE 15L,A02,083655,Morris; Justin Loren,4,0,50,46
1656191542356,CSE 20,A01,083657,Tran; Khoa Dang,30,0,80,50
1656191548382,CSE 21,A01,095574,Bach; Quang Tran,24,0,48,24
1656191554409,CSE 30,A01,083084,Eldon; John,2,8,80,78
1656191554409,CSE 30,B01,095061,Bhaskar; Nishant,1,2,50,49
1656191560435,CSE 100,A01,083659,Cao; Yingjun,2,20,70,68
1656191566463,CSE 134B,A01,083661,Powell; Thomas Allan,3,0,100,97
1656191572485,CSE 140,A01,083663,Gungor; Onat,9,0,85,76
1656191578507,CSE 140L,A01,083088,Eldon; John,8,0,100,92
1656191584533,CSE 175,A01,083665,Kumar; Rakesh,0,0,25,25
1656191590555,CSE 190,A00,092507,Dubnov; Shlomo,2,0,20,18
1656191596661,ECE 45,A01,083139,Congero; Spencer William,1,0,75,74
1656191602688,ECE 65,A50,083695,Saad; Andrew S,9,0,30,21
1656191602688,ECE 65,A51,095125,Staff,23,0,26,3
1656191608714,ECE 109,A01,091882,Touri; Behrouz,0,1,70,70
1656191614740,ECE 180,A00,083140,Abi Samra; Nicholas Camill,1,0,30,29
1656191614740,ECE 180,B00,083141,Abi Samra; Nicholas Camill,0,4,30,30
1656191620773,MATH 10A,A01,083735,Patchell; Gregory David,0,0,30,30
1656191620773,MATH 10A,A02,083736,Patchell; Gregory David,22,0,30,8
1656191620773,MATH 10A,A03,083737,Patchell; Gregory David,16,0,30,14
1656191626804,MATH 10B,A01,083207,Lim; Seonhee,0,0,34,34
1656191626804,MATH 10B,A02,083208,Lim; Seonhee,7,0,35,28
1656191626804,MATH 10B,A03,093472,Staff,1,0,34,33
1656191626804,MATH 10B,B01,083739,Sinha; Shubham,11,0,30,19
1656191632835,MATH 18,A01,083743,Cinel; Cameron Alexander,7,0,30,23
1656191632835,MATH 18,A02,083744,Cinel; Cameron Alexander,10,0,30,20
1656191632835,MATH 18,A03,083745,Cinel; Cameron Alexander,4,0,30,26
1656191632835,MATH 18,B01,083748,Rideout; David Porter,1,0,36,35
1656191632835,MATH 18,B02,083749,Rideout; David Porter,0,0,36,36
1656191632835,MATH 18,B03,083750,Rideout; David Porter,0,0,36,36
1656191632835,MATH 18,B04,083751,Rideout; David Porter,0,0,36,36
1656191632835,MATH 18,B05,093473,Rideout; David Porter,0,0,36,36
1656191632835,MATH 18,B06,093474,Rideout; David Porter,2,0,36,34
1656191638861,MATH 20A,A01,083754,Zheng; Zequn,11,0,40,29
1656191644884,MATH 20B,A01,083756,Briones; Jor-el Thomas Caparas,0,0,36,36
1656191644884,MATH 20B,A02,083757,Briones; Jor-el Thomas Caparas,0,0,36,36
1656191644884,MATH 20B,A03,093475,Staff,1,0,36,35
1656191650909,MATH 20C,A01,083760,Briones; Jor-el Thomas Caparas,0,0,35,35
1656191650909,MATH 20C,A02,083761,Briones; Jor-el Thomas Caparas,9,1,35,26
1656191650909,MATH 20C,A03,093476,Staff,0,0,35,35
1656191650909,MATH 20C,B01,083762,Bach; Quang Tran,1,0,30,29
1656191656935,MATH 20D,A01,083765,Tran; Brian Kha,1,0,30,29
1656191656935,MATH 20D,A02,083766,Tran; Brian Kha,0,1,30,30
1656191656935,MATH 20D,A03,083767,Tran; Brian Kha,2,0,30,28
1656191662968,MATH 20E,A01,083771,Ganguly; Soumya,3,0,32,29
1656191662968,MATH 20E,A02,083772,Ganguly; Soumya,0,0,32,32
1656191662968,MATH 20E,B01,083773,Ciotti; Benjamin,15,0,35,20
1656191662968,MATH 20E,B02,083774,Ciotti; Benjamin,15,0,35,20
1656191668991,MATH 103A,A01,083777,Greenfeld; Be'Eri,1,0,36,35
1656191668991,MATH 103A,A02,083778,Greenfeld; Be'Eri,1,0,36,35
1656191668991,MATH 103A,A03,093561,Staff,5,0,36,31
1656191668991,MATH 103A,B01,083779,Greenfeld; Be'Eri,9,1,36,27
1656191668991,MATH 103A,B02,083780,Greenfeld; Be'Eri,1,0,36,35
1656191668991,MATH 103A,B03,093562,Staff,0,0,36,36
1656191675019,MATH 105,A01,085443,Carter; Anne Toulson,5,1,35,30
1656191675019,MATH 105,A02,093477,Staff,13,0,35,22
1656191681043,MATH 109,A01,083213,Ganzberger; Geoffrey Michael,0,0,34,34
1656191681043,MATH 109,A02,083214,Ganzberger; Geoffrey Michael,0,0,34,34
1656191681043,MATH 109,A03,093478,Staff,1,0,34,33
1656191681043,MATH 109,B01,083215,Ganzberger; Geoffrey Michael,4,0,32,28
1656191681043,MATH 109,B02,083216,Ganzberger; Geoffrey Michael,1,0,32,31
1656191681043,MATH 109,B03,093479,Staff,4,0,32,28
1656191687072,MATH 142A,A01,083219,Chow; Bennett,1,0,32,31
1656191687072,MATH 142A,A02,083220,Chow; Bennett,8,0,32,24
1656191687072,MATH 142A,A03,093480,Staff,5,0,32,27
1656191687072,MATH 142A,B03,093481,Staff,3,0,32,29
1656191687072,MATH 142A,B04,093558,Staff,6,0,32,26
1656191687072,MATH 142A,B05,093559,Staff,1,0,32,31
1656191693100,MATH 193A,A01,083224,Rotar; Vladimir,0,1,34,34
1656191693100,MATH 193A,A02,083225,Rotar; Vladimir,0,0,34,34
1656191693100,MATH 193A,A03,083781,Rotar; Vladimir,1,0,34,33
1656191693100,MATH 193A,A04,083782,Rotar; Vladimir,6,0,34,28
1656191693100,MATH 193A,A05,093482,Rotar; Vladimir,0,0,34,34
1656191699123,MATH 197,001,091859,McAuley; Julian John,9999,0,9999,0
1656191699123,MATH 197,002,095566,Kedlaya; Kiran S.,9997,0,9999,2
1656191699123,MATH 197,003,095567,Xiao; Ming,9999,0,9999,0
1656191699123,MATH 197,004,095571,Perols; Johan Lars,9998,0,9999,1
1656191706178,COGS 9,A01,083615,Shannon; Kyle Michael,4,0,75,71
1656191712206,COGS 11,A01,083617,Boyle; Mary E. T.,14,0,48,34
1656191718230,COGS 13,A01,083071,Bastos; Amalia Pinkusfeld,4,0,71,67
1656191724257,COGS 14A,A01,092681,Semenuks; Arturs,4,15,100,96
1656191730284,COGS 14B,A01,083073,Cheng; Tzu-Han,7,0,63,56
1656191736320,COGS 17,A01,092677,Semenuks; Arturs,7,0,81,74
1656191742342,COGS 100,A01,083619,Allen; Michael Gordon,2,0,70,68
1656191748366,COGS 101A,A01,083621,Davis; Joshua Daniel,4,0,68,64
1656191754394,COGS 101B,A01,091572,Allen; Michael Gordon,5,0,65,60
1656191760416,COGS 101C,A01,083625,Delgado; Tania,10,0,35,25
1656191766439,COGS 107A,A01,083627,Boyle; Mary E. T.,0,0,60,60
1656191772463,COGS 118A,A01,083075,Gupta; Anjum,7,0,76,69
1656191778493,CSE 3,A50,083646,Miranda; Gregory Joseph,18,0,50,32
1656191784526,CSE 8A,A50,083650,Miranda; Gregory Joseph,3,3,56,53
1656191790553,CSE 11,A01,083080,Cao; Yingjun,1,52,40,39
1656191796580,CSE 12,A01,083652,Krause-Levy; Sophia Louisa,7,3,120,113
1656191802608,CSE 15L,A01,083654,Morris; Justin Loren,2,0,50,48
1656191802608,CSE 15L,A02,083655,Morris; Justin Loren,4,0,50,46
1656191808635,CSE 20,A01,083657,Tran; Khoa Dang,30,0,80,50
1656191814662,CSE 21,A01,095574,Bach; Quang Tran,24,0,48,24
1656191820689,CSE 30,A01,083084,Eldon; John,2,8,80,78
1656191820689,CSE 30,B01,095061,Bhaskar; Nishant,1,2,50,49
1656191826713,CSE 100,A01,083659,Cao; Yingjun,2,20,70,68
1656191832735,CSE 134B,A01,083661,Powell; Thomas Allan,3,0,100,97
1656191838766,CSE 140,A01,083663,Gungor; Onat,9,0,85,76
1656191844789,CSE 140L,A01,083088,Eldon; John,8,0,100,92
1656191850820,CSE 175,A01,083665,Kumar; Rakesh,0,0,25,25
1656191856843,CSE 190,A00,092507,Dubnov; Shlomo,2,0,20,18
1656191862871,ECE 45,A01,083139,Congero; Spencer William,1,0,75,74
1656191868895,ECE 65,A50,083695,Saad; Andrew S,9,0,30,21
1656191868895,ECE 65,A51,095125,Staff,23,0,26,3
1656191874922,ECE 109,A01,091882,Touri; Behrouz,0,1,70,70
1656191880944,ECE 180,A00,083140,Abi Samra; Nicholas Camill,1,0,30,29
1656191880944,ECE 180,B00,083141,Abi Samra; Nicholas Camill,0,4,30,30
1656191886967,MATH 10A,A01,083735,Patchell; Gregory David,0,0,30,30
1656191886967,MATH 10A,A02,083736,Patchell; Gregory David,22,0,30,8
1656191886967,MATH 10A,A03,083737,Patchell; Gregory David,16,0,30,14
1656191892997,MATH 10B,A01,083207,Lim; Seonhee,0,0,34,34
1656191892997,MATH 10B,A02,083208,Lim; Seonhee,7,0,35,28
1656191892997,MATH 10B,A03,093472,Staff,1,0,34,33
1656191892997,MATH 10B,B01,083739,Sinha; Shubham,11,0,30,19
1656191899028,MATH 18,A01,083743,Cinel; Cameron Alexander,7,0,30,23
1656191899028,MATH 18,A02,083744,Cinel; Cameron Alexander,10,0,30,20
1656191899028,MATH 18,A03,083745,Cinel; Cameron Alexander,4,0,30,26
1656191899028,MATH 18,B01,083748,Rideout; David Porter,1,0,36,35
1656191899028,MATH 18,B02,083749,Rideout; David Porter,0,0,36,36
1656191899028,MATH 18,B03,083750,Rideout; David Porter,0,0,36,36
1656191899028,MATH 18,B04,083751,Rideout; David Porter,0,0,36,36
1656191899028,MATH 18,B05,093473,Rideout; David Porter,0,0,36,36
1656191899028,MATH 18,B06,093474,Rideout; David Porter,2,0,36,34
1656191905056,MATH 20A,A01,083754,Zheng; Zequn,11,0,40,29
1656191911079,MATH 20B,A01,083756,Briones; Jor-el Thomas Caparas,0,0,36,36
1656191911079,MATH 20B,A02,083757,Briones; Jor-el Thomas Caparas,0,0,36,36
1656191911079,MATH 20B,A03,093475,Staff,1,0,36,35
1656191917112,MATH 20C,A01,083760,Briones; Jor-el Thomas Caparas,0,0,35,35
1656191917112,MATH 20C,A02,083761,Briones; Jor-el Thomas Caparas,9,1,35,26
1656191917112,MATH 20C,A03,093476,Staff,0,0,35,35
1656191917112,MATH 20C,B01,083762,Bach; Quang Tran,1,0,30,29
1656191923140,MATH 20D,A01,083765,Tran; Brian Kha,1,0,30,29
1656191923140,MATH 20D,A02,083766,Tran; Brian Kha,0,1,30,30
1656191923140,MATH 20D,A03,083767,Tran; Brian Kha,2,0,30,28
1656191929170,MATH 20E,A01,083771,Ganguly; Soumya,3,0,32,29
1656191929170,MATH 20E,A02,083772,Ganguly; Soumya,0,0,32,32
1656191929170,MATH 20E,B01,083773,Ciotti; Benjamin,15,0,35,20
1656191929170,MATH 20E,B02,083774,Ciotti; Benjamin,15,0,35,20
1656191935198,MATH 103A,A01,083777,Greenfeld; Be'Eri,1,0,36,35
1656191935198,MATH 103A,A02,083778,Greenfeld; Be'Eri,1,0,36,35
1656191935198,MATH 103A,A03,093561,Staff,5,0,36,31
1656191935198,MATH 103A,B01,083779,Greenfeld; Be'Eri,9,1,36,27
1656191935198,MATH 103A,B02,083780,Greenfeld; Be'Eri,1,0,36,35
1656191935198,MATH 103A,B03,093562,Staff,0,0,36,36
1656191941221,MATH 105,A01,085443,Carter; Anne Toulson,5,1,35,30
1656191941221,MATH 105,A02,093477,Staff,13,0,35,22
1656191947250,MATH 109,A01,083213,Ganzberger; Geoffrey Michael,0,0,34,34
1656191947250,MATH 109,A02,083214,Ganzberger; Geoffrey Michael,0,0,34,34
1656191947250,MATH 109,A03,093478,Staff,1,0,34,33
1656191947250,MATH 109,B01,083215,Ganzberger; Geoffrey Michael,4,0,32,28
1656191947250,MATH 109,B02,083216,Ganzberger; Geoffrey Michael,1,0,32,31
1656191947250,MATH 109,B03,093479,Staff,4,0,32,28
1656191953275,MATH 142A,A01,083219,Chow; Bennett,1,0,32,31
1656191953275,MATH 142A,A02,083220,Chow; Bennett,8,0,32,24
1656191953275,MATH 142A,A03,093480,Staff,5,0,32,27
1656191953275,MATH 142A,B03,093481,Staff,3,0,32,29
1656191953275,MATH 142A,B04,093558,Staff,6,0,32,26
1656191953275,MATH 142A,B05,093559,Staff,1,0,32,31
1656191959303,MATH 193A,A01,083224,Rotar; Vladimir,0,1,34,34
1656191959303,MATH 193A,A02,083225,Rotar; Vladimir,0,0,34,34
1656191959303,MATH 193A,A03,083781,Rotar; Vladimir,1,0,34,33
1656191959303,MATH 193A,A04,083782,Rotar; Vladimir,6,0,34,28
1656191959303,MATH 193A,A05,093482,Rotar; Vladimir,0,0,34,34
1656191965327,MATH 197,001,091859,McAuley; Julian John,9999,0,9999,0
1656191965327,MATH 197,002,095566,Kedlaya; Kiran S.,9997,0,9999,2
1656191965327,MATH 197,003,095567,Xiao; Ming,9999,0,9999,0
1656191965327,MATH 197,004,095571,Perols; Johan Lars,9998,0,9999,1
1656191972395,COGS 9,A01,083615,Shannon; Kyle Michael,4,0,75,71
1656191978420,COGS 11,A01,083617,Boyle; Mary E. T.,14,0,48,34
1656191984445,COGS 13,A01,083071,Bastos; Amalia Pinkusfeld,4,0,71,67
1656191990468,COGS 14A,A01,092681,Semenuks; Arturs,4,15,100,96
1656191996495,COGS 14B,A01,083073,Cheng; Tzu-Han,7,0,63,56
1656192002538,COGS 17,A01,092677,Semenuks; Arturs,7,0,81,74
1656192008574,COGS 100,A01,083619,Allen; Michael Gordon,2,0,70,68
1656192014600,COGS 101A,A01,083621,Davis; Joshua Daniel,4,0,68,64
1656192020625,COGS 101B,A01,091572,Allen; Michael Gordon,5,0,65,60
1656192026651,COGS 101C,A01,083625,Delgado; Tania,10,0,35,25
1656192032675,COGS 107A,A01,083627,Boyle; Mary E. T.,0,0,60,60
1656192038704,COGS 118A,A01,083075,Gupta; Anjum,7,0,76,69
1656192044742,CSE 3,A50,083646,Miranda; Gregory Joseph,18,0,50,32
1656192050766,CSE 8A,A50,083650,Miranda; Gregory Joseph,3,3,56,53
1656192056792,CSE 11,A01,083080,Cao; Yingjun,1,52,40,39
1656192062816,CSE 12,A01,083652,Krause-Levy; Sophia Louisa,7,3,120,113
1656192068841,CSE 15L,A01,083654,Morris; Justin Loren,2,0,50,48
1656192068841,CSE 15L,A02,083655,Morris; Justin Loren,4,0,50,46
1656192074869,CSE 20,A01,083657,Tran; Khoa Dang,30,0,80,50
1656192080896,CSE 21,A01,095574,Bach; Quang Tran,24,0,48,24
1656192086926,CSE 30,A01,083084,Eldon; John,2,8,80,78
1656192086926,CSE 30,B01,095061,Bhaskar; Nishant,1,2,50,49
1656192092949,CSE 100,A01,083659,Cao; Yingjun,2,20,70,68
1656192098980,CSE 134B,A01,083661,Powell; Thomas Allan,3,0,100,97
1656192105013,CSE 140,A01,083663,Gungor; Onat,9,0,85,76
1656192111038,CSE 140L,A01,083088,Eldon; John,8,0,100,92
1656192117064,CSE 175,A01,083665,Kumar; Rakesh,0,0,25,25
1656192123087,CSE 190,A00,092507,Dubnov; Shlomo,2,0,20,18
1656192129115,ECE 45,A01,083139,Congero; Spencer William,1,0,75,74
1656192135139,ECE 65,A50,083695,Saad; Andrew S,9,0,30,21
1656192135139,ECE 65,A51,095125,Staff,23,0,26,3
1656192141169,ECE 109,A01,091882,Touri; Behrouz,0,1,70,70
1656192147201,ECE 180,A00,083140,Abi Samra; Nicholas Camill,1,0,30,29
1656192147201,ECE 180,B00,083141,Abi Samra; Nicholas Camill,0,4,30,30
1656192153226,MATH 10A,A01,083735,Patchell; Gregory David,0,0,30,30
1656192153226,MATH 10A,A02,083736,Patchell; Gregory David,22,0,30,8
1656192153226,MATH 10A,A03,083737,Patchell; Gregory David,16,0,30,14
1656192159262,MATH 10B,A01,083207,Lim; Seonhee,0,0,34,34
1656192159262,MATH 10B,A02,083208,Lim; Seonhee,7,0,35,28
1656192159262,MATH 10B,A03,093472,Staff,1,0,34,33
1656192159262,MATH 10B,B01,083739,Sinha; Shubham,11,0,30,19
1656192165294,MATH 18,A01,083743,Cinel; Cameron Alexander,7,0,30,23
1656192165294,MATH 18,A02,083744,Cinel; Cameron Alexander,10,0,30,20
1656192165294,MATH 18,A03,083745,Cinel; Cameron Alexander,4,0,30,26
1656192165294,MATH 18,B01,083748,Rideout; David Porter,1,0,36,35
1656192165294,MATH 18,B02,083749,Rideout; David Porter,0,0,36,36
1656192165294,MATH 18,B03,083750,Rideout; David Porter,0,0,36,36
1656192165294,MATH 18,B04,083751,Rideout; David Porter,0,0,36,36
1656192165294,MATH 18,B05,093473,Rideout; David Porter,0,0,36,36
1656192165294,MATH 18,B06,093474,Rideout; David Porter,2,0,36,34
1656192171321,MATH 20A,A01,083754,Zheng; Zequn,11,0,40,29
1656192177356,MATH 20B,A01,083756,Briones; Jor-el Thomas Caparas,0,0,36,36
1656192177356,MATH 20B,A02,083757,Briones; Jor-el Thomas Caparas,0,0,36,36
1656192177356,MATH 20B,A03,093475,Staff,1,0,36,35
1656192183381,MATH 20C,A01,083760,Briones; Jor-el Thomas Caparas,0,0,35,35
1656192183381,MATH 20C,A02,083761,Briones; Jor-el Thomas Caparas,9,1,35,26
1656192183381,MATH 20C,A03,093476,Staff,0,0,35,35
1656192183381,MATH 20C,B01,083762,Bach; Quang Tran,1,0,30,29
1656192189409,MATH 20D,A01,083765,Tran; Brian Kha,1,0,30,29
1656192189409,MATH 20D,A02,083766,Tran; Brian Kha,0,1,30,30
1656192189409,MATH 20D,A03,083767,Tran; Brian Kha,2,0,30,28
1656192195514,MATH 20E,A01,083771,Ganguly; Soumya,3,0,32,29
1656192195514,MATH 20E,A02,083772,Ganguly; Soumya,0,0,32,32
1656192195514,MATH 20E,B01,083773,Ciotti; Benjamin,15,0,35,20
1656192195514,MATH 20E,B02,083774,Ciotti; Benjamin,15,0,35,20
1656192201542,MATH 103A,A01,083777,Greenfeld; Be'Eri,1,0,36,35
1656192201542,MATH 103A,A02,083778,Greenfeld; Be'Eri,1,0,36,35
1656192201542,MATH 103A,A03,093561,Staff,5,0,36,31
1656192201542,MATH 103A,B01,083779,Greenfeld; Be'Eri,9,1,36,27
1656192201542,MATH 103A,B02,083780,Greenfeld; Be'Eri,1,0,36,35
1656192201542,MATH 103A,B03,093562,Staff,0,0,36,36
1656192207565,MATH 105,A01,085443,Carter; Anne Toulson,5,1,35,30
1656192207565,MATH 105,A02,093477,Staff,13,0,35,22
1656192213596,MATH 109,A01,083213,Ganzberger; Geoffrey Michael,0,0,34,34
1656192213596,MATH 109,A02,083214,Ganzberger; Geoffrey Michael,0,0,34,34
1656192213596,MATH 109,A03,093478,Staff,1,0,34,33
1656192213596,MATH 109,B01,083215,Ganzberger; Geoffrey Michael,4,0,32,28
1656192213596,MATH 109,B02,083216,Ganzberger; Geoffrey Michael,1,0,32,31
1656192213596,MATH 109,B03,093479,Staff,4,0,32,28
1656192219619,MATH 142A,A01,083219,Chow; Bennett,1,0,32,31
1656192219619,MATH 142A,A02,083220,Chow; Bennett,8,0,32,24
1656192219619,MATH 142A,A03,093480,Staff,5,0,32,27
1656192219619,MATH 142A,B03,093481,Staff,3,0,32,29
1656192219619,MATH 142A,B04,093558,Staff,6,0,32,26
1656192219619,MATH 142A,B05,093559,Staff,1,0,32,31
1656192225655,MATH 193A,A01,083224,Rotar; Vladimir,0,1,34,34
1656192225655,MATH 193A,A02,083225,Rotar; Vladimir,0,0,34,34
1656192225655,MATH 193A,A03,083781,Rotar; Vladimir,1,0,34,33
1656192225655,MATH 193A,A04,083782,Rotar; Vladimir,6,0,34,28
1656192225655,MATH 193A,A05,093482,Rotar; Vladimir,0,0,34,34
1656192231682,MATH 197,001,091859,McAuley; Julian John,9999,0,9999,0
1656192231682,MATH 197,002,095566,Kedlaya; Kiran S.,9997,0,9999,2
1656192231682,MATH 197,003,095567,Xiao; Ming,9999,0,9999,0
1656192231682,MATH 197,004,095571,Perols; Johan Lars,9998,0,9999,1
1656192238744,COGS 9,A01,083615,Shannon; Kyle Michael,4,0,75,71
1656192244768,COGS 11,A01,083617,Boyle; Mary E. T.,14,0,48,34
1656192250802,COGS 13,A01,083071,Bastos; Amalia Pinkusfeld,4,0,71,67
1656192256826,COGS 14A,A01,092681,Semenuks; Arturs,4,15,100,96
1656192262853,COGS 14B,A01,083073,Cheng; Tzu-Han,7,0,63,56
1656192268876,COGS 17,A01,092677,Semenuks; Arturs,7,0,81,74
1656192274899,COGS 100,A01,083619,Allen; Michael Gordon,2,0,70,68
1656192280921,COGS 101A,A01,083621,Davis; Joshua Daniel,4,0,68,64
1656192286955,COGS 101B,A01,091572,Allen; Michael Gordon,5,0,65,60
1656192292981,COGS 101C,A01,083625,Delgado; Tania,10,0,35,25
1656192299004,COGS 107A,A01,083627,Boyle; Mary E. T.,0,0,60,60
1656192305031,COGS 118A,A01,083075,Gupta; Anjum,7,0,76,69
1656192311058,CSE 3,A50,083646,Miranda; Gregory Joseph,18,0,50,32
1656192317082,CSE 8A,A50,083650,Miranda; Gregory Joseph,3,3,56,53
1656192323110,CSE 11,A01,083080,Cao; Yingjun,1,52,40,39
1656192329138,CSE 12,A01,083652,Krause-Levy; Sophia Louisa,7,3,120,113
1656192335165,CSE 15L,A01,083654,Morris; Justin Loren,2,0,50,48
1656192335165,CSE 15L,A02,083655,Morris; Justin Loren,4,0,50,46
1656192341189,CSE 20,A01,083657,Tran; Khoa Dang,30,0,80,50
1656192347214,CSE 21,A01,095574,Bach; Quang Tran,24,0,48,24
1656192353244,CSE 30,A01,083084,Eldon; John,2,8,80,78
1656192353244,CSE 30,B01,095061,Bhaskar; Nishant,1,2,50,49
1656192359267,CSE 100,A01,083659,Cao; Yingjun,2,20,70,68
1656192365291,CSE 134B,A01,083661,Powell; Thomas Allan,3,0,100,97
1656192371317,CSE 140,A01,083663,Gungor; Onat,9,0,85,76
1656192377341,CSE 140L,A01,083088,Eldon; John,8,0,100,92
1656192383363,CSE 175,A01,083665,Kumar; Rakesh,0,0,25,25
1656192389387,CSE 190,A00,092507,Dubnov; Shlomo,2,0,20,18
1656192395410,ECE 45,A01,083139,Congero; Spencer William,1,0,75,74
1656192401435,ECE 65,A50,083695,Saad; Andrew S,9,0,30,21
1656192401435,ECE 65,A51,095125,Staff,23,0,26,3
1656192407458,ECE 109,A01,091882,Touri; Behrouz,0,1,70,70
1656192413487,ECE 180,A00,083140,Abi Samra; Nicholas Camill,1,0,30,29
1656192413487,ECE 180,B00,083141,Abi Samra; Nicholas Camill,0,4,30,30
1656192419513,MATH 10A,A01,083735,Patchell; Gregory David,0,0,30,30
1656192419513,MATH 10A,A02,083736,Patchell; Gregory David,22,0,30,8
1656192419513,MATH 10A,A03,083737,Patchell; Gregory David,16,0,30,14
1656192425537,MATH 10B,A01,083207,Lim; Seonhee,0,0,34,34
1656192425537,MATH 10B,A02,083208,Lim; Seonhee,7,0,35,28
1656192425537,MATH 10B,A03,093472,Staff,1,0,34,33
1656192425537,MATH 10B,B01,083739,Sinha; Shubham,11,0,30,19
1656192431563,MATH 18,A01,083743,Cinel; Cameron Alexander,7,0,30,23
1656192431563,MATH 18,A02,083744,Cinel; Cameron Alexander,10,0,30,20
1656192431563,MATH 18,A03,083745,Cinel; Cameron Alexander,4,0,30,26
1656192431563,MATH 18,B01,083748,Rideout; David Porter,1,0,36,35
1656192431563,MATH 18,B02,083749,Rideout; David Porter,0,0,36,36
1656192431563,MATH 18,B03,083750,Rideout; David Porter,0,0,36,36
1656192431563,MATH 18,B04,083751,Rideout; David Porter,0,0,36,36
1656192431563,MATH 18,B05,093473,Rideout; David Porter,0,0,36,36
1656192431563,MATH 18,B06,093474,Rideout; David Porter,2,0,36,34
1656192437590,MATH 20A,A01,083754,Zheng; Zequn,11,0,40,29
1656192443619,MATH 20B,A01,083756,Briones; Jor-el Thomas Caparas,0,0,36,36
1656192443619,MATH 20B,A02,083757,Briones; Jor-el Thomas Caparas,0,0,36,36
1656192443619,MATH 20B,A03,093475,Staff,1,0,36,35
1656192449643,MATH 20C,A01,083760,Briones; Jor-el Thomas Caparas,0,0,35,35
1656192449643,MATH 20C,A02,083761,Briones; Jor-el Thomas Caparas,9,1,35,26
1656192449643,MATH 20C,A03,093476,Staff,0,0,35,35
1656192449643,MATH 20C,B01,083762,Bach; Quang Tran,1,0,30,29
1656192455669,MATH 20D,A01,083765,Tran; Brian Kha,1,0,30,29
1656192455669,MATH 20D,A02,083766,Tran; Brian Kha,0,1,30,30
1656192455669,MATH 20D,A03,083767,Tran; Brian Kha,2,0,30,28
1656192461693,MATH 20E,A01,083771,Ganguly; Soumya,3,0,32,29
1656192461693,MATH 20E,A02,083772,Ganguly; Soumya,0,0,32,32
1656192461693,MATH 20E,B01,083773,Ciotti; Benjamin,15,0,35,20
1656192461693,MATH 20E,B02,083774,Ciotti; Benjamin,15,0,35,20
1656192467720,MATH 103A,A01,083777,Greenfeld; Be'Eri,1,0,36,35
1656192467720,MATH 103A,A02,083778,Greenfeld; Be'Eri,1,0,36,35
1656192467720,MATH 103A,A03,093561,Staff,5,0,36,31
1656192467720,MATH 103A,B01,083779,Greenfeld; Be'Eri,9,1,36,27
1656192467720,MATH 103A,B02,083780,Greenfeld; Be'Eri,1,0,36,35
1656192467720,MATH 103A,B03,093562,Staff,0,0,36,36
1656192473749,MATH 105,A01,085443,Carter; Anne Toulson,5,1,35,30
1656192473749,MATH 105,A02,093477,Staff,13,0,35,22
1656192479779,MATH 109,A01,083213,Ganzberger; Geoffrey Michael,0,0,34,34
1656192479779,MATH 109,A02,083214,Ganzberger; Geoffrey Michael,0,0,34,34
1656192479779,MATH 109,A03,093478,Staff,1,0,34,33
1656192479779,MATH 109,B01,083215,Ganzberger; Geoffrey Michael,4,0,32,28
1656192479779,MATH 109,B02,083216,Ganzberger; Geoffrey Michael,1,0,32,31
1656192479779,MATH 109,B03,093479,Staff,4,0,32,28
1656192485804,MATH 142A,A01,083219,Chow; Bennett,1,0,32,31
1656192485804,MATH 142A,A02,083220,Chow; Bennett,8,0,32,24
1656192485804,MATH 142A,A03,093480,Staff,5,0,32,27
1656192485804,MATH 142A,B03,093481,Staff,3,0,32,29
1656192485804,MATH 142A,B04,093558,Staff,6,0,32,26
1656192485804,MATH 142A,B05,093559,Staff,1,0,32,31
1656192491833,MATH 193A,A01,083224,Rotar; Vladimir,0,1,34,34
1656192491833,MATH 193A,A02,083225,Rotar; Vladimir,0,0,34,34
1656192491833,MATH 193A,A03,083781,Rotar; Vladimir,1,0,34,33
1656192491833,MATH 193A,A04,083782,Rotar; Vladimir,6,0,34,28
1656192491833,MATH 193A,A05,093482,Rotar; Vladimir,0,0,34,34
1656192497856,MATH 197,001,091859,McAuley; Julian John,9999,0,9999,0
1656192497856,MATH 197,002,095566,Kedlaya; Kiran S.,9997,0,9999,2
1656192497856,MATH 197,003,095567,Xiao; Ming,9999,0,9999,0
1656192497856,MATH 197,004,095571,Perols; Johan Lars,9998,0,9999,1
1656192504913,COGS 9,A01,083615,Shannon; Kyle Michael,4,0,75,71
1656192510935,COGS 11,A01,083617,Boyle; Mary E. T.,14,0,48,34
1656192516961,COGS 13,A01,083071,Bastos; Amalia Pinkusfeld,4,0,71,67
1656192522985,COGS 14A,A01,092681,Semenuks; Arturs,4,15,100,96
1656192529011,COGS 14B,A01,083073,Cheng; Tzu-Han,7,0,63,56
1656192535035,COGS 17,A01,092677,Semenuks; Arturs,7,0,81,74
1656192541061,COGS 100,A01,083619,Allen; Michael Gordon,2,0,70,68
1656192547085,COGS 101A,A01,083621,Davis; Joshua Daniel,4,0,68,64
1656192553111,COGS 101B,A01,091572,Allen; Michael Gordon,5,0,65,60
1656192559135,COGS 101C,A01,083625,Delgado; Tania,10,0,35,25
1656192565162,COGS 107A,A01,083627,Boyle; Mary E. T.,0,0,60,60
1656192571185,COGS 118A,A01,083075,Gupta; Anjum,7,0,76,69
1656192577209,CSE 3,A50,083646,Miranda; Gregory Joseph,18,0,50,32
1656192583237,CSE 8A,A50,083650,Miranda; Gregory Joseph,3,3,56,53
1656192589270,CSE 11,A01,083080,Cao; Yingjun,1,52,40,39
1656192595297,CSE 12,A01,083652,Krause-Levy; Sophia Louisa,7,3,120,113
1656192601320,CSE 15L,A01,083654,Morris; Justin Loren,2,0,50,48
1656192601320,CSE 15L,A02,083655,Morris; Justin Loren,4,0,50,46
1656192607345,CSE 20,A01,083657,Tran; Khoa Dang,30,0,80,50
1656192613369,CSE 21,A01,095574,Bach; Quang Tran,24,0,48,24
1656192619400,CSE 30,A01,083084,Eldon; John,2,8,80,78
1656192619400,CSE 30,B01,095061,Bhaskar; Nishant,1,2,50,49
1656192625427,CSE 100,A01,083659,Cao; Yingjun,2,20,70,68
1656192631453,CSE 134B,A01,083661,Powell; Thomas Allan,3,0,100,97
1656192637474,CSE 140,A01,083663,Gungor; Onat,9,0,85,76
1656192643505,CSE 140L,A01,083088,Eldon; John,8,0,100,92
1656192649526,CSE 175,A01,083665,Kumar; Rakesh,0,0,25,25
1656192655548,CSE 190,A00,092507,Dubnov; Shlomo,2,0,20,18
1656192661577,ECE 45,A01,083139,Congero; Spencer William,1,0,75,74
1656192667600,ECE 65,A50,083695,Saad; Andrew S,9,0,30,21
1656192667600,ECE 65,A51,095125,Staff,23,0,26,3
1656192673623,ECE 109,A01,091882,Touri; Behrouz,0,1,70,70
1656192679660,ECE 180,A00,083140,Abi Samra; Nicholas Camill,1,0,30,29
1656192679660,ECE 180,B00,083141,Abi Samra; Nicholas Camill,0,4,30,30
1656192685694,MATH 10A,A01,083735,Patchell; Gregory David,0,0,30,30
1656192685694,MATH 10A,A02,083736,Patchell; Gregory David,22,0,30,8
1656192685694,MATH 10A,A03,083737,Patchell; Gregory David,16,0,30,14
1656192691721,MATH 10B,A01,083207,Lim; Seonhee,0,0,34,34
1656192691721,MATH 10B,A02,083208,Lim; Seonhee,7,0,35,28
1656192691721,MATH 10B,A03,093472,Staff,1,0,34,33
1656192691721,MATH 10B,B01,083739,Sinha; Shubham,11,0,30,19
1656192697747,MATH 18,A01,083743,Cinel; Cameron Alexander,7,0,30,23
1656192697747,MATH 18,A02,083744,Cinel; Cameron Alexander,10,0,30,20
1656192697747,MATH 18,A03,083745,Cinel; Cameron Alexander,4,0,30,26
1656192697747,MATH 18,B01,083748,Rideout; David Porter,1,0,36,35
1656192697747,MATH 18,B02,083749,Rideout; David Porter,0,0,36,36
1656192697747,MATH 18,B03,083750,Rideout; David Porter,0,0,36,36
1656192697747,MATH 18,B04,083751,Rideout; David Porter,0,0,36,36
1656192697747,MATH 18,B05,093473,Rideout; David Porter,0,0,36,36
1656192697747,MATH 18,B06,093474,Rideout; David Porter,2,0,36,34
1656192703771,MATH 20A,A01,083754,Zheng; Zequn,11,0,40,29
1656192709796,MATH 20B,A01,083756,Briones; Jor-el Thomas Caparas,0,0,36,36
1656192709796,MATH 20B,A02,083757,Briones; Jor-el Thomas Caparas,0,0,36,36
1656192709796,MATH 20B,A03,093475,Staff,1,0,36,35
1656192715820,MATH 20C,A01,083760,Briones; Jor-el Thomas Caparas,0,0,35,35
1656192715820,MATH 20C,A02,083761,Briones; Jor-el Thomas Caparas,9,1,35,26
1656192715820,MATH 20C,A03,093476,Staff,0,0,35,35
1656192715820,MATH 20C,B01,083762,Bach; Quang Tran,1,0,30,29
1656192721844,MATH 20D,A01,083765,Tran; Brian Kha,1,0,30,29
1656192721844,MATH 20D,A02,083766,Tran; Brian Kha,0,1,30,30
1656192721844,MATH 20D,A03,083767,Tran; Brian Kha,2,0,30,28
1656192727873,MATH 20E,A01,083771,Ganguly; Soumya,3,0,32,29
1656192727873,MATH 20E,A02,083772,Ganguly; Soumya,0,0,32,32
1656192727873,MATH 20E,B01,083773,Ciotti; Benjamin,15,0,35,20
1656192727873,MATH 20E,B02,083774,Ciotti; Benjamin,15,0,35,20
1656192733902,MATH 103A,A01,083777,Greenfeld; Be'Eri,1,0,36,35
1656192733902,MATH 103A,A02,083778,Greenfeld; Be'Eri,1,0,36,35
1656192733902,MATH 103A,A03,093561,Staff,5,0,36,31
1656192733902,MATH 103A,B01,083779,Greenfeld; Be'Eri,9,1,36,27
1656192733902,MATH 103A,B02,083780,Greenfeld; Be'Eri,1,0,36,35
1656192733902,MATH 103A,B03,093562,Staff,0,0,36,36
1656192739929,MATH 105,A01,085443,Carter; Anne Toulson,5,1,35,30
1656192739929,MATH 105,A02,093477,Staff,13,0,35,22
1656192745957,MATH 109,A01,083213,Ganzberger; Geoffrey Michael,0,0,34,34
1656192745957,MATH 109,A02,083214,Ganzberger; Geoffrey Michael,0,0,34,34
1656192745957,MATH 109,A03,093478,Staff,1,0,34,33
1656192745957,MATH 109,B01,083215,Ganzberger; Geoffrey Michael,4,0,32,28
1656192745957,MATH 109,B02,083216,Ganzberger; Geoffrey Michael,1,0,32,31
1656192745957,MATH 109,B03,093479,Staff,4,0,32,28
1656192751986,MATH 142A,A01,083219,Chow; Bennett,1,0,32,31
1656192751986,MATH 142A,A02,083220,Chow; Bennett,8,0,32,24
1656192751986,MATH 142A,A03,093480,Staff,5,0,32,27
1656192751986,MATH 142A,B03,093481,Staff,3,0,32,29
1656192751986,MATH 142A,B04,093558,Staff,6,0,32,26
1656192751986,MATH 142A,B05,093559,Staff,1,0,32,31
1656192758015,MATH 193A,A01,083224,Rotar; Vladimir,0,1,34,34
1656192758015,MATH 193A,A02,083225,Rotar; Vladimir,0,0,34,34
1656192758015,MATH 193A,A03,083781,Rotar; Vladimir,1,0,34,33
1656192758015,MATH 193A,A04,083782,Rotar; Vladimir,6,0,34,28
1656192758015,MATH 193A,A05,093482,Rotar; Vladimir,0,0,34,34
1656192764038,MATH 197,001,091859,McAuley; Julian John,9999,0,9999,0
1656192764038,MATH 197,002,095566,Kedlaya; Kiran S.,9997,0,9999,2
1656192764038,MATH 197,003,095567,Xiao; Ming,9999,0,9999,0
1656192764038,MATH 197,004,095571,Perols; Johan Lars,9998,0,9999,1
1656192771094,COGS 9,A01,083615,Shannon; Kyle Michael,4,0,75,71
1656192777117,COGS 11,A01,083617,Boyle; Mary E. T.,14,0,48,34
1656192783149,COGS 13,A01,083071,Bastos; Amalia Pinkusfeld,4,0,71,67
1656192789243,COGS 14A,A01,092681,Semenuks; Arturs,4,15,100,96
1656192795275,COGS 14B,A01,083073,Cheng; Tzu-Han,7,0,63,56
1656192801308,COGS 17,A01,092677,Semenuks; Arturs,7,0,81,74
1656192807334,COGS 100,A01,083619,Allen; Michael Gordon,2,0,70,68
1656192813362,COGS 101A,A01,083621,Davis; Joshua Daniel,4,0,68,64
1656192819386,COGS 101B,A01,091572,Allen; Michael Gordon,5,0,65,60
1656192825418,COGS 101C,A01,083625,Delgado; Tania,10,0,35,25
1656192831450,COGS 107A,A01,083627,Boyle; Mary E. T.,0,0,60,60
1656192837478,COGS 118A,A01,083075,Gupta; Anjum,7,0,76,69
1656192843502,CSE 3,A50,083646,Miranda; Gregory Joseph,18,0,50,32
1656192849526,CSE 8A,A50,083650,Miranda; Gregory Joseph,3,3,56,53
1656192855552,CSE 11,A01,083080,Cao; Yingjun,1,52,40,39
1656192861577,CSE 12,A01,083652,Krause-Levy; Sophia Louisa,7,3,120,113
1656192867603,CSE 15L,A01,083654,Morris; Justin Loren,2,0,50,48
1656192867603,CSE 15L,A02,083655,Morris; Justin Loren,4,0,50,46
1656192873631,CSE 20,A01,083657,Tran; Khoa Dang,30,0,80,50
1656192879656,CSE 21,A01,095574,Bach; Quang Tran,24,0,48,24
1656192885685,CSE 30,A01,083084,Eldon; John,2,8,80,78
1656192885685,CSE 30,B01,095061,Bhaskar; Nishant,1,2,50,49
1656192891709,CSE 100,A01,083659,Cao; Yingjun,2,20,70,68
1656192897735,CSE 134B,A01,083661,Powell; Thomas Allan,3,0,100,97
1656192903766,CSE 140,A01,083663,Gungor; Onat,9,0,85,76
1656192909789,CSE 140L,A01,083088,Eldon; John,8,0,100,92
1656192915816,CSE 175,A01,083665,Kumar; Rakesh,0,0,25,25
1656192921842,CSE 190,A00,092507,Dubnov; Shlomo,2,0,20,18
1656192927867,ECE 45,A01,083139,Congero; Spencer William,1,0,75,74
1656192933894,ECE 65,A50,083695,Saad; Andrew S,9,0,30,21
1656192933894,ECE 65,A51,095125,Staff,23,0,26,3
1656192939918,ECE 109,A01,091882,Touri; Behrouz,0,1,70,70
1656192945941,ECE 180,A00,083140,Abi Samra; Nicholas Camill,1,0,30,29
1656192945941,ECE 180,B00,083141,Abi Samra; Nicholas Camill,0,4,30,30
1656192951969,MATH 10A,A01,083735,Patchell; Gregory David,0,0,30,30
1656192951969,MATH 10A,A02,083736,Patchell; Gregory David,22,0,30,8
1656192951969,MATH 10A,A03,083737,Patchell; Gregory David,16,0,30,14
1656192957993,MATH 10B,A01,083207,Lim; Seonhee,0,0,34,34
1656192957993,MATH 10B,A02,083208,Lim; Seonhee,7,0,35,28
1656192957993,MATH 10B,A03,093472,Staff,1,0,34,33
1656192957993,MATH 10B,B01,083739,Sinha; Shubham,11,0,30,19
1656192964016,MATH 18,A01,083743,Cinel; Cameron Alexander,7,0,30,23
1656192964016,MATH 18,A02,083744,Cinel; Cameron Alexander,10,0,30,20
1656192964016,MATH 18,A03,083745,Cinel; Cameron Alexander,4,0,30,26
1656192964016,MATH 18,B01,083748,Rideout; David Porter,1,0,36,35
1656192964016,MATH 18,B02,083749,Rideout; David Porter,0,0,36,36
1656192964016,MATH 18,B03,083750,Rideout; David Porter,0,0,36,36
1656192964016,MATH 18,B04,083751,Rideout; David Porter,0,0,36,36
1656192964016,MATH 18,B05,093473,Rideout; David Porter,0,0,36,36
1656192964016,MATH 18,B06,093474,Rideout; David Porter,2,0,36,34
1656192970043,MATH 20A,A01,083754,Zheng; Zequn,11,0,40,29
1656192976071,MATH 20B,A01,083756,Briones; Jor-el Thomas Caparas,0,0,36,36
1656192976071,MATH 20B,A02,083757,Briones; Jor-el Thomas Caparas,0,0,36,36
1656192976071,MATH 20B,A03,093475,Staff,1,0,36,35
1656192982099,MATH 20C,A01,083760,Briones; Jor-el Thomas Caparas,0,0,35,35
1656192982099,MATH 20C,A02,083761,Briones; Jor-el Thomas Caparas,9,1,35,26
1656192982099,MATH 20C,A03,093476,Staff,0,0,35,35
1656192982099,MATH 20C,B01,083762,Bach; Quang Tran,1,0,30,29
1656192988125,MATH 20D,A01,083765,Tran; Brian Kha,1,0,30,29
1656192988125,MATH 20D,A02,083766,Tran; Brian Kha,0,1,30,30
1656192988125,MATH 20D,A03,083767,Tran; Brian Kha,2,0,30,28
1656192994148,MATH 20E,A01,083771,Ganguly; Soumya,3,0,32,29
1656192994148,MATH 20E,A02,083772,Ganguly; Soumya,0,0,32,32
1656192994148,MATH 20E,B01,083773,Ciotti; Benjamin,15,0,35,20
1656192994148,MATH 20E,B02,083774,Ciotti; Benjamin,15,0,35,20
1656193000172,MATH 103A,A01,083777,Greenfeld; Be'Eri,1,0,36,35
1656193000172,MATH 103A,A02,083778,Greenfeld; Be'Eri,1,0,36,35
1656193000172,MATH 103A,A03,093561,Staff,5,0,36,31
1656193000172,MATH 103A,B01,083779,Greenfeld; Be'Eri,9,1,36,27
1656193000172,MATH 103A,B02,083780,Greenfeld; Be'Eri,1,0,36,35
1656193000172,MATH 103A,B03,093562,Staff,0,0,36,36
1656193006201,MATH 105,A01,085443,Carter; Anne Toulson,5,1,35,30
1656193006201,MATH 105,A02,093477,Staff,13,0,35,22
1656193012224,MATH 109,A01,083213,Ganzberger; Geoffrey Michael,0,0,34,34
1656193012224,MATH 109,A02,083214,Ganzberger; Geoffrey Michael,0,0,34,34
1656193012224,MATH 109,A03,093478,Staff,1,0,34,33
1656193012224,MATH 109,B01,083215,Ganzberger; Geoffrey Michael,4,0,32,28
1656193012224,MATH 109,B02,083216,Ganzberger; Geoffrey Michael,1,0,32,31
1656193012224,MATH 109,B03,093479,Staff,4,0,32,28
1656193018254,MATH 142A,A01,083219,Chow; Bennett,1,0,32,31
1656193018254,MATH 142A,A02,083220,Chow; Bennett,8,0,32,24
1656193018254,MATH 142A,A03,093480,Staff,5,0,32,27
1656193018254,MATH 142A,B03,093481,Staff,3,0,32,29
1656193018254,MATH 142A,B04,093558,Staff,6,0,32,26
1656193018254,MATH 142A,B05,093559,Staff,1,0,32,31
1656193024277,MATH 193A,A01,083224,Rotar; Vladimir,0,1,34,34
1656193024277,MATH 193A,A02,083225,Rotar; Vladimir,0,0,34,34
1656193024277,MATH 193A,A03,083781,Rotar; Vladimir,1,0,34,33
1656193024277,MATH 193A,A04,083782,Rotar; Vladimir,6,0,34,28
1656193024277,MATH 193A,A05,093482,Rotar; Vladimir,0,0,34,34
1656193030301,MATH 197,001,091859,McAuley; Julian John,9999,0,9999,0
1656193030301,MATH 197,002,095566,Kedlaya; Kiran S.,9997,0,9999,2
1656193030301,MATH 197,003,095567,Xiao; Ming,9999,0,9999,0
1656193030301,MATH 197,004,095571,Perols; Johan Lars,9998,0,9999,1
1656193037350,COGS 9,A01,083615,Shannon; Kyle Michael,4,0,75,71
1656193043374,COGS 11,A01,083617,Boyle; Mary E. T.,14,0,48,34
1656193049398,COGS 13,A01,083071,Bastos; Amalia Pinkusfeld,4,0,71,67
1656193055421,COGS 14A,A01,092681,Semenuks; Arturs,4,15,100,96
1656193061445,COGS 14B,A01,083073,Cheng; Tzu-Han,7,0,63,56
1656193067480,COGS 17,A01,092677,Semenuks; Arturs,7,0,81,74
1656193073504,COGS 100,A01,083619,Allen; Michael Gordon,2,0,70,68
1656193079535,COGS 101A,A01,083621,Davis; Joshua Daniel,4,0,68,64
1656193085559,COGS 101B,A01,091572,Allen; Michael Gordon,5,0,65,60
1656193091582,COGS 101C,A01,083625,Delgado; Tania,10,0,35,25
1656193097605,COGS 107A,A01,083627,Boyle; Mary E. T.,0,0,60,60
1656193103628,COGS 118A,A01,083075,Gupta; Anjum,7,0,76,69
1656193109655,CSE 3,A50,083646,Miranda; Gregory Joseph,18,0,50,32
1656193115684,CSE 8A,A50,083650,Miranda; Gregory Joseph,3,3,56,53
1656193121713,CSE 11,A01,083080,Cao; Yingjun,1,52,40,39
1656193127736,CSE 12,A01,083652,Krause-Levy; Sophia Louisa,7,3,120,113
1656193133759,CSE 15L,A01,083654,Morris; Justin Loren,2,0,50,48
1656193133759,CSE 15L,A02,083655,Morris; Justin Loren,4,0,50,46
1656193139786,CSE 20,A01,083657,Tran; Khoa Dang,30,0,80,50
1656193145814,CSE 21,A01,095574,Bach; Quang Tran,24,0,48,24
1656193151838,CSE 30,A01,083084,Eldon; John,2,8,80,78
1656193151838,CSE 30,B01,095061,Bhaskar; Nishant,1,2,50,49
1656193157862,CSE 100,A01,083659,Cao; Yingjun,2,20,70,68
1656193163885,CSE 134B,A01,083661,Powell; Thomas Allan,3,0,100,97
1656193169909,CSE 140,A01,083663,Gungor; Onat,9,0,85,76
1656193175933,CSE 140L,A01,083088,Eldon; John,8,0,100,92
1656193181960,CSE 175,A01,083665,Kumar; Rakesh,0,0,25,25
1656193187986,CSE 190,A00,092507,Dubnov; Shlomo,2,0,20,18
1656193194017,ECE 45,A01,083139,Congero; Spencer William,1,0,75,74
1656193200043,ECE 65,A50,083695,Saad; Andrew S,9,0,30,21
1656193200043,ECE 65,A51,095125,Staff,23,0,26,3
1656193206066,ECE 109,A01,091882,Touri; Behrouz,0,1,70,70
1656193212095,ECE 180,A00,083140,Abi Samra; Nicholas Camill,1,0,30,29
1656193212095,ECE 180,B00,083141,Abi Samra; Nicholas Camill,0,4,30,30
1656193218119,MATH 10A,A01,083735,Patchell; Gregory David,0,0,30,30
1656193218119,MATH 10A,A02,083736,Patchell; Gregory David,22,0,30,8
1656193218119,MATH 10A,A03,083737,Patchell; Gregory David,16,0,30,14
1656193224149,MATH 10B,A01,083207,Lim; Seonhee,0,0,34,34
1656193224149,MATH 10B,A02,083208,Lim; Seonhee,7,0,35,28
1656193224149,MATH 10B,A03,093472,Staff,1,0,34,33
1656193224149,MATH 10B,B01,083739,Sinha; Shubham,11,0,30,19
1656193230174,MATH 18,A01,083743,Cinel; Cameron Alexander,7,0,30,23
1656193230174,MATH 18,A02,083744,Cinel; Cameron Alexander,10,0,30,20
1656193230174,MATH 18,A03,083745,Cinel; Cameron Alexander,4,0,30,26
1656193230174,MATH 18,B01,083748,Rideout; David Porter,1,0,36,35
1656193230174,MATH 18,B02,083749,Rideout; David Porter,0,0,36,36
1656193230174,MATH 18,B03,083750,Rideout; David Porter,0,0,36,36
1656193230174,MATH 18,B04,083751,Rideout; David Porter,0,0,36,36
1656193230174,MATH 18,B05,093473,Rideout; David Porter,0,0,36,36
1656193230174,MATH 18,B06,093474,Rideout; David Porter,2,0,36,34
1656193236200,MATH 20A,A01,083754,Zheng; Zequn,11,0,40,29
1656193242233,MATH 20B,A01,083756,Briones; Jor-el Thomas Caparas,0,0,36,36
1656193242233,MATH 20B,A02,083757,Briones; Jor-el Thomas Caparas,0,0,36,36
1656193242233,MATH 20B,A03,093475,Staff,1,0,36,35
1656193248257,MATH 20C,A01,083760,Briones; Jor-el Thomas Caparas,0,0,35,35
1656193248257,MATH 20C,A02,083761,Briones; Jor-el Thomas Caparas,9,1,35,26
1656193248257,MATH 20C,A03,093476,Staff,0,0,35,35
1656193248257,MATH 20C,B01,083762,Bach; Quang Tran,1,0,30,29
1656193254282,MATH 20D,A01,083765,Tran; Brian Kha,1,0,30,29
1656193254282,MATH 20D,A02,083766,Tran; Brian Kha,0,1,30,30
1656193254282,MATH 20D,A03,083767,Tran; Brian Kha,2,0,30,28
1656193260313,MATH 20E,A01,083771,Ganguly; Soumya,3,0,32,29
1656193260313,MATH 20E,A02,083772,Ganguly; Soumya,0,0,32,32
1656193260313,MATH 20E,B01,083773,Ciotti; Benjamin,15,0,35,20
1656193260313,MATH 20E,B02,083774,Ciotti; Benjamin,15,0,35,20
1656193266337,MATH 103A,A01,083777,Greenfeld; Be'Eri,1,0,36,35
1656193266337,MATH 103A,A02,083778,Greenfeld; Be'Eri,1,0,36,35
1656193266337,MATH 103A,A03,093561,Staff,5,0,36,31
1656193266337,MATH 103A,B01,083779,Greenfeld; Be'Eri,9,1,36,27
1656193266337,MATH 103A,B02,083780,Greenfeld; Be'Eri,1,0,36,35
1656193266337,MATH 103A,B03,093562,Staff,0,0,36,36
1656193272373,MATH 105,A01,085443,Carter; Anne Toulson,5,1,35,30
1656193272373,MATH 105,A02,093477,Staff,13,0,35,22
1656193278397,MATH 109,A01,083213,Ganzberger; Geoffrey Michael,0,0,34,34
1656193278397,MATH 109,A02,083214,Ganzberger; Geoffrey Michael,0,0,34,34
1656193278397,MATH 109,A03,093478,Staff,1,0,34,33
1656193278397,MATH 109,B01,083215,Ganzberger; Geoffrey Michael,4,0,32,28
1656193278397,MATH 109,B02,083216,Ganzberger; Geoffrey Michael,1,0,32,31
1656193278397,MATH 109,B03,093479,Staff,4,0,32,28
1656193284421,MATH 142A,A01,083219,Chow; Bennett,1,0,32,31
1656193284421,MATH 142A,A02,083220,Chow; Bennett,8,0,32,24
1656193284421,MATH 142A,A03,093480,Staff,5,0,32,27
1656193284421,MATH 142A,B03,093481,Staff,3,0,32,29
1656193284421,MATH 142A,B04,093558,Staff,6,0,32,26
1656193284421,MATH 142A,B05,093559,Staff,1,0,32,31
1656193290449,MATH 193A,A01,083224,Rotar; Vladimir,0,1,34,34
1656193290449,MATH 193A,A02,083225,Rotar; Vladimir,0,0,34,34
1656193290449,MATH 193A,A03,083781,Rotar; Vladimir,1,0,34,33
1656193290449,MATH 193A,A04,083782,Rotar; Vladimir,6,0,34,28
1656193290449,MATH 193A,A05,093482,Rotar; Vladimir,0,0,34,34
1656193296472,MATH 197,001,091859,McAuley; Julian John,9999,0,9999,0
1656193296472,MATH 197,002,095566,Kedlaya; Kiran S.,9997,0,9999,2
1656193296472,MATH 197,003,095567,Xiao; Ming,9999,0,9999,0
1656193296472,MATH 197,004,095571,Perols; Johan Lars,9998,0,9999,1
1656193303535,COGS 9,A01,083615,Shannon; Kyle Michael,4,0,75,71
1656193309560,COGS 11,A01,083617,Boyle; Mary E. T.,14,0,48,34
1656193315583,COGS 13,A01,083071,Bastos; Amalia Pinkusfeld,4,0,71,67
1656193321607,COGS 14A,A01,092681,Semenuks; Arturs,4,15,100,96
1656193327632,COGS 14B,A01,083073,Cheng; Tzu-Han,7,0,63,56
1656193333656,COGS 17,A01,092677,Semenuks; Arturs,7,0,81,74
1656193339679,COGS 100,A01,083619,Allen; Michael Gordon,2,0,70,68
1656193345705,COGS 101A,A01,083621,Davis; Joshua Daniel,4,0,68,64
1656193351728,COGS 101B,A01,091572,Allen; Michael Gordon,5,0,65,60
1656193357758,COGS 101C,A01,083625,Delgado; Tania,10,0,35,25
1656193363783,COGS 107A,A01,083627,Boyle; Mary E. T.,0,0,60,60
1656193369810,COGS 118A,A01,083075,Gupta; Anjum,7,0,76,69
1656193375833,CSE 3,A50,083646,Miranda; Gregory Joseph,18,0,50,32
1656193381857,CSE 8A,A50,083650,Miranda; Gregory Joseph,3,3,56,53
1656193387959,CSE 11,A01,083080,Cao; Yingjun,1,52,40,39
1656193393981,CSE 12,A01,083652,Krause-Levy; Sophia Louisa,7,3,120,113
1656193400004,CSE 15L,A01,083654,Morris; Justin Loren,2,0,50,48
1656193400004,CSE 15L,A02,083655,Morris; Justin Loren,4,0,50,46
1656193406040,CSE 20,A01,083657,Tran; Khoa Dang,30,0,80,50
1656193412064,CSE 21,A01,095574,Bach; Quang Tran,24,0,48,24
1656193418092,CSE 30,A01,083084,Eldon; John,2,8,80,78
1656193418092,CSE 30,B01,095061,Bhaskar; Nishant,1,2,50,49
1656193424125,CSE 100,A01,083659,Cao; Yingjun,2,20,70,68
1656193430155,CSE 134B,A01,083661,Powell; Thomas Allan,3,0,100,97
1656193436181,CSE 140,A01,083663,Gungor; Onat,9,0,85,76
1656193442209,CSE 140L,A01,083088,Eldon; John,8,0,100,92
1656193448236,CSE 175,A01,083665,Kumar; Rakesh,0,0,25,25
1656193454265,CSE 190,A00,092507,Dubnov; Shlomo,2,0,20,18
1656193460286,ECE 45,A01,083139,Congero; Spencer William,1,0,75,74
1656193466310,ECE 65,A50,083695,Saad; Andrew S,9,0,30,21
1656193466310,ECE 65,A51,095125,Staff,23,0,26,3
1656193472335,ECE 109,A01,091882,Touri; Behrouz,0,1,70,70
1656193478358,ECE 180,A00,083140,Abi Samra; Nicholas Camill,1,0,30,29
1656193478358,ECE 180,B00,083141,Abi Samra; Nicholas Camill,0,4,30,30
1656193484385,MATH 10A,A01,083735,Patchell; Gregory David,0,0,30,30
1656193484385,MATH 10A,A02,083736,Patchell; Gregory David,22,0,30,8
1656193484385,MATH 10A,A03,083737,Patchell; Gregory David,16,0,30,14
1656193490408,MATH 10B,A01,083207,Lim; Seonhee,0,0,34,34
1656193490408,MATH 10B,A02,083208,Lim; Seonhee,7,0,35,28
1656193490408,MATH 10B,A03,093472,Staff,1,0,34,33
1656193490408,MATH 10B,B01,083739,Sinha; Shubham,11,0,30,19
1656193496439,MATH 18,A01,083743,Cinel; Cameron Alexander,7,0,30,23
1656193496439,MATH 18,A02,083744,Cinel; Cameron Alexander,10,0,30,20
1656193496439,MATH 18,A03,083745,Cinel; Cameron Alexander,4,0,30,26
1656193496439,MATH 18,B01,083748,Rideout; David Porter,1,0,36,35
1656193496439,MATH 18,B02,083749,Rideout; David Porter,0,0,36,36
1656193496439,MATH 18,B03,083750,Rideout; David Porter,0,0,36,36
1656193496439,MATH 18,B04,083751,Rideout; David Porter,0,0,36,36
1656193496439,MATH 18,B05,093473,Rideout; David Porter,0,0,36,36
1656193496439,MATH 18,B06,093474,Rideout; David Porter,2,0,36,34
1656193502465,MATH 20A,A01,083754,Zheng; Zequn,11,0,40,29
1656193508489,MATH 20B,A01,083756,Briones; Jor-el Thomas Caparas,0,0,36,36
1656193508489,MATH 20B,A02,083757,Briones; Jor-el Thomas Caparas,0,0,36,36
1656193508489,MATH 20B,A03,093475,Staff,1,0,36,35
1656193514514,MATH 20C,A01,083760,Briones; Jor-el Thomas Caparas,0,0,35,35
1656193514514,MATH 20C,A02,083761,Briones; Jor-el Thomas Caparas,9,1,35,26
1656193514514,MATH 20C,A03,093476,Staff,0,0,35,35
1656193514514,MATH 20C,B01,083762,Bach; Quang Tran,1,0,30,29
1656193520543,MATH 20D,A01,083765,Tran; Brian Kha,1,0,30,29
1656193520543,MATH 20D,A02,083766,Tran; Brian Kha,0,1,30,30
1656193520543,MATH 20D,A03,083767,Tran; Brian Kha,2,0,30,28
1656193526572,MATH 20E,A01,083771,Ganguly; Soumya,3,0,32,29
1656193526572,MATH 20E,A02,083772,Ganguly; Soumya,0,0,32,32
1656193526572,MATH 20E,B01,083773,Ciotti; Benjamin,15,0,35,20
1656193526572,MATH 20E,B02,083774,Ciotti; Benjamin,15,0,35,20
1656193532595,MATH 103A,A01,083777,Greenfeld; Be'Eri,1,0,36,35
1656193532595,MATH 103A,A02,083778,Greenfeld; Be'Eri,1,0,36,35
1656193532595,MATH 103A,A03,093561,Staff,5,0,36,31
1656193532595,MATH 103A,B01,083779,Greenfeld; Be'Eri,9,1,36,27
1656193532595,MATH 103A,B02,083780,Greenfeld; Be'Eri,1,0,36,35
1656193532595,MATH 103A,B03,093562,Staff,0,0,36,36
1656193538619,MATH 105,A01,085443,Carter; Anne Toulson,5,1,35,30
1656193538619,MATH 105,A02,093477,Staff,13,0,35,22
1656193544644,MATH 109,A01,083213,Ganzberger; Geoffrey Michael,0,0,34,34
1656193544644,MATH 109,A02,083214,Ganzberger; Geoffrey Michael,0,0,34,34
1656193544644,MATH 109,A03,093478,Staff,1,0,34,33
1656193544644,MATH 109,B01,083215,Ganzberger; Geoffrey Michael,4,0,32,28
1656193544644,MATH 109,B02,083216,Ganzberger; Geoffrey Michael,1,0,32,31
1656193544644,MATH 109,B03,093479,Staff,4,0,32,28
1656193550671,MATH 142A,A01,083219,Chow; Bennett,1,0,32,31
1656193550671,MATH 142A,A02,083220,Chow; Bennett,8,0,32,24
1656193550671,MATH 142A,A03,093480,Staff,5,0,32,27
1656193550671,MATH 142A,B03,093481,Staff,3,0,32,29
1656193550671,MATH 142A,B04,093558,Staff,6,0,32,26
1656193550671,MATH 142A,B05,093559,Staff,1,0,32,31
1656193556703,MATH 193A,A01,083224,Rotar; Vladimir,0,1,34,34
1656193556703,MATH 193A,A02,083225,Rotar; Vladimir,0,0,34,34
1656193556703,MATH 193A,A03,083781,Rotar; Vladimir,1,0,34,33
1656193556703,MATH 193A,A04,083782,Rotar; Vladimir,6,0,34,28
1656193556703,MATH 193A,A05,093482,Rotar; Vladimir,0,0,34,34
1656193562730,MATH 197,001,091859,McAuley; Julian John,9999,0,9999,0
1656193562730,MATH 197,002,095566,Kedlaya; Kiran S.,9997,0,9999,2
1656193562730,MATH 197,003,095567,Xiao; Ming,9999,0,9999,0
1656193562730,MATH 197,004,095571,Perols; Johan Lars,9998,0,9999,1
1656193569814,COGS 9,A01,083615,Shannon; Kyle Michael,4,0,75,71
1656193575839,COGS 11,A01,083617,Boyle; Mary E. T.,14,0,48,34
1656193581866,COGS 13,A01,083071,Bastos; Amalia Pinkusfeld,4,0,71,67
1656193587893,COGS 14A,A01,092681,Semenuks; Arturs,4,15,100,96
1656193593916,COGS 14B,A01,083073,Cheng; Tzu-Han,7,0,63,56
1656193599939,COGS 17,A01,092677,Semenuks; Arturs,7,0,81,74
1656193605961,COGS 100,A01,083619,Allen; Michael Gordon,2,0,70,68
1656193611984,COGS 101A,A01,083621,Davis; Joshua Daniel,4,0,68,64
1656193618007,COGS 101B,A01,091572,Allen; Michael Gordon,5,0,65,60
1656193624034,COGS 101C,A01,083625,Delgado; Tania,10,0,35,25
1656193630058,COGS 107A,A01,083627,Boyle; Mary E. T.,0,0,60,60
1656193636082,COGS 118A,A01,083075,Gupta; Anjum,7,0,76,69
1656193642109,CSE 3,A50,083646,Miranda; Gregory Joseph,18,0,50,32
1656193648133,CSE 8A,A50,083650,Miranda; Gregory Joseph,3,3,56,53
1656193654157,CSE 11,A01,083080,Cao; Yingjun,1,52,40,39
1656193660180,CSE 12,A01,083652,Krause-Levy; Sophia Louisa,7,3,120,113
1656193666203,CSE 15L,A01,083654,Morris; Justin Loren,2,0,50,48
1656193666203,CSE 15L,A02,083655,Morris; Justin Loren,4,0,50,46
1656193672230,CSE 20,A01,083657,Tran; Khoa Dang,30,0,80,50
1656193678258,CSE 21,A01,095574,Bach; Quang Tran,24,0,48,24
1656193684282,CSE 30,A01,083084,Eldon; John,2,8,80,78
1656193684282,CSE 30,B01,095061,Bhaskar; Nishant,1,2,50,49
1656193690311,CSE 100,A01,083659,Cao; Yingjun,2,20,70,68
1656193696334,CSE 134B,A01,083661,Powell; Thomas Allan,3,0,100,97
1656193702361,CSE 140,A01,083663,Gungor; Onat,9,0,85,76
1656193708383,CSE 140L,A01,083088,Eldon; John,8,0,100,92
1656193714404,CSE 175,A01,083665,Kumar; Rakesh,0,0,25,25
1656193720427,CSE 190,A00,092507,Dubnov; Shlomo,2,0,20,18
1656193726455,ECE 45,A01,083139,Congero; Spencer William,1,0,75,74
1656193732479,ECE 65,A50,083695,Saad; Andrew S,9,0,30,21
1656193732479,ECE 65,A51,095125,Staff,23,0,26,3
1656193738512,ECE 109,A01,091882,Touri; Behrouz,0,1,70,70
1656193744535,ECE 180,A00,083140,Abi Samra; Nicholas Camill,1,0,30,29
1656193744535,ECE 180,B00,083141,Abi Samra; Nicholas Camill,0,4,30,30
1656193750559,MATH 10A,A01,083735,Patchell; Gregory David,0,0,30,30
1656193750559,MATH 10A,A02,083736,Patchell; Gregory David,22,0,30,8
1656193750559,MATH 10A,A03,083737,Patchell; Gregory David,16,0,30,14
1656193756586,MATH 10B,A01,083207,Lim; Seonhee,0,0,34,34
1656193756586,MATH 10B,A02,083208,Lim; Seonhee,7,0,35,28
1656193756586,MATH 10B,A03,093472,Staff,1,0,34,33
1656193756586,MATH 10B,B01,083739,Sinha; Shubham,11,0,30,19
1656193762617,MATH 18,A01,083743,Cinel; Cameron Alexander,7,0,30,23
1656193762617,MATH 18,A02,083744,Cinel; Cameron Alexander,10,0,30,20
1656193762617,MATH 18,A03,083745,Cinel; Cameron Alexander,4,0,30,26
1656193762617,MATH 18,B01,083748,Rideout; David Porter,1,0,36,35
1656193762617,MATH 18,B02,083749,Rideout; David Porter,0,0,36,36
1656193762617,MATH 18,B03,083750,Rideout; David Porter,0,0,36,36
1656193762617,MATH 18,B04,083751,Rideout; David Porter,0,0,36,36
1656193762617,MATH 18,B05,093473,Rideout; David Porter,0,0,36,36
1656193762617,MATH 18,B06,093474,Rideout; David Porter,2,0,36,34
1656193768644,MATH 20A,A01,083754,Zheng; Zequn,11,0,40,29
1656193774668,MATH 20B,A01,083756,Briones; Jor-el Thomas Caparas,0,0,36,36
1656193774668,MATH 20B,A02,083757,Briones; Jor-el Thomas Caparas,0,0,36,36
1656193774668,MATH 20B,A03,093475,Staff,1,0,36,35
1656193780699,MATH 20C,A01,083760,Briones; Jor-el Thomas Caparas,0,0,35,35
1656193780699,MATH 20C,A02,083761,Briones; Jor-el Thomas Caparas,9,1,35,26
1656193780699,MATH 20C,A03,093476,Staff,0,0,35,35
1656193780699,MATH 20C,B01,083762,Bach; Quang Tran,1,0,30,29
1656193786722,MATH 20D,A01,083765,Tran; Brian Kha,1,0,30,29
1656193786722,MATH 20D,A02,083766,Tran; Brian Kha,0,1,30,30
1656193786722,MATH 20D,A03,083767,Tran; Brian Kha,2,0,30,28
1656193792746,MATH 20E,A01,083771,Ganguly; Soumya,3,0,32,29
1656193792746,MATH 20E,A02,083772,Ganguly; Soumya,0,0,32,32
1656193792746,MATH 20E,B01,083773,Ciotti; Benjamin,15,0,35,20
1656193792746,MATH 20E,B02,083774,Ciotti; Benjamin,15,0,35,20
1656193798771,MATH 103A,A01,083777,Greenfeld; Be'Eri,1,0,36,35
1656193798771,MATH 103A,A02,083778,Greenfeld; Be'Eri,1,0,36,35
1656193798771,MATH 103A,A03,093561,Staff,5,0,36,31
1656193798771,MATH 103A,B01,083779,Greenfeld; Be'Eri,9,1,36,27
1656193798771,MATH 103A,B02,083780,Greenfeld; Be'Eri,1,0,36,35
1656193798771,MATH 103A,B03,093562,Staff,0,0,36,36
1656193804794,MATH 105,A01,085443,Carter; Anne Toulson,5,1,35,30
1656193804794,MATH 105,A02,093477,Staff,13,0,35,22
1656193810818,MATH 109,A01,083213,Ganzberger; Geoffrey Michael,0,0,34,34
1656193810818,MATH 109,A02,083214,Ganzberger; Geoffrey Michael,0,0,34,34
1656193810818,MATH 109,A03,093478,Staff,1,0,34,33
1656193810818,MATH 109,B01,083215,Ganzberger; Geoffrey Michael,4,0,32,28
1656193810818,MATH 109,B02,083216,Ganzberger; Geoffrey Michael,1,0,32,31
1656193810818,MATH 109,B03,093479,Staff,4,0,32,28
1656193816843,MATH 142A,A01,083219,Chow; Bennett,1,0,32,31
1656193816843,MATH 142A,A02,083220,Chow; Bennett,8,0,32,24
1656193816843,MATH 142A,A03,093480,Staff,5,0,32,27
1656193816843,MATH 142A,B03,093481,Staff,3,0,32,29
1656193816843,MATH 142A,B04,093558,Staff,6,0,32,26
1656193816843,MATH 142A,B05,093559,Staff,1,0,32,31
1656193822871,MATH 193A,A01,083224,Rotar; Vladimir,0,1,34,34
1656193822871,MATH 193A,A02,083225,Rotar; Vladimir,0,0,34,34
1656193822871,MATH 193A,A03,083781,Rotar; Vladimir,1,0,34,33
1656193822871,MATH 193A,A04,083782,Rotar; Vladimir,6,0,34,28
1656193822871,MATH 193A,A05,093482,Rotar; Vladimir,0,0,34,34
1656193828897,MATH 197,001,091859,McAuley; Julian John,9999,0,9999,0
1656193828897,MATH 197,002,095566,Kedlaya; Kiran S.,9997,0,9999,2
1656193828897,MATH 197,003,095567,Xiao; Ming,9999,0,9999,0
1656193828897,MATH 197,004,095571,Perols; Johan Lars,9998,0,9999,1
1656193835956,COGS 9,A01,083615,Shannon; Kyle Michael,4,0,75,71
1656193841978,COGS 11,A01,083617,Boyle; Mary E. T.,14,0,48,34
1656193848001,COGS 13,A01,083071,Bastos; Amalia Pinkusfeld,4,0,71,67
1656193854025,COGS 14A,A01,092681,Semenuks; Arturs,4,15,100,96
1656193860066,COGS 14B,A01,083073,Cheng; Tzu-Han,7,0,63,56
1656193866089,COGS 17,A01,092677,Semenuks; Arturs,7,0,81,74
1656193872112,COGS 100,A01,083619,Allen; Michael Gordon,2,0,70,68
1656193878135,COGS 101A,A01,083621,Davis; Joshua Daniel,4,0,68,64
1656193884163,COGS 101B,A01,091572,Allen; Michael Gordon,5,0,65,60
1656193890189,COGS 101C,A01,083625,Delgado; Tania,10,0,35,25
1656193896212,COGS 107A,A01,083627,Boyle; Mary E. T.,0,0,60,60
1656193902236,COGS 118A,A01,083075,Gupta; Anjum,7,0,76,69
1656193908265,CSE 3,A50,083646,Miranda; Gregory Joseph,18,0,50,32
1656193914290,CSE 8A,A50,083650,Miranda; Gregory Joseph,3,3,56,53
1656193920318,CSE 11,A01,083080,Cao; Yingjun,1,52,40,39
1656193926349,CSE 12,A01,083652,Krause-Levy; Sophia Louisa,7,3,120,113
1656193932370,CSE 15L,A01,083654,Morris; Justin Loren,2,0,50,48
1656193932370,CSE 15L,A02,083655,Morris; Justin Loren,4,0,50,46
1656193938393,CSE 20,A01,083657,Tran; Khoa Dang,30,0,80,50
1656193944419,CSE 21,A01,095574,Bach; Quang Tran,24,0,48,24
1656193950442,CSE 30,A01,083084,Eldon; John,2,8,80,78
1656193950442,CSE 30,B01,095061,Bhaskar; Nishant,1,2,50,49
1656193956469,CSE 100,A01,083659,Cao; Yingjun,2,20,70,68
1656193962493,CSE 134B,A01,083661,Powell; Thomas Allan,3,0,100,97
1656193968516,CSE 140,A01,083663,Gungor; Onat,9,0,85,76
1656193974540,CSE 140L,A01,083088,Eldon; John,8,0,100,92
1656193980568,CSE 175,A01,083665,Kumar; Rakesh,0,0,25,25
1656193986667,CSE 190,A00,092507,Dubnov; Shlomo,2,0,20,18
1656193992697,ECE 45,A01,083139,Congero; Spencer William,1,0,75,74
1656193998720,ECE 65,A50,083695,Saad; Andrew S,9,0,30,21
1656193998720,ECE 65,A51,095125,Staff,23,0,26,3
1656194004743,ECE 109,A01,091882,Touri; Behrouz,0,1,70,70
1656194010768,ECE 180,A00,083140,Abi Samra; Nicholas Camill,1,0,30,29
1656194010768,ECE 180,B00,083141,Abi Samra; Nicholas Camill,0,4,30,30
1656194016793,MATH 10A,A01,083735,Patchell; Gregory David,0,0,30,30
1656194016793,MATH 10A,A02,083736,Patchell; Gregory David,22,0,30,8
1656194016793,MATH 10A,A03,083737,Patchell; Gregory David,16,0,30,14
1656194022824,MATH 10B,A01,083207,Lim; Seonhee,0,0,34,34
1656194022824,MATH 10B,A02,083208,Lim; Seonhee,7,0,35,28
1656194022824,MATH 10B,A03,093472,Staff,1,0,34,33
1656194022824,MATH 10B,B01,083739,Sinha; Shubham,11,0,30,19
1656194028856,MATH 18,A01,083743,Cinel; Cameron Alexander,7,0,30,23
1656194028856,MATH 18,A02,083744,Cinel; Cameron Alexander,10,0,30,20
1656194028856,MATH 18,A03,083745,Cinel; Cameron Alexander,4,0,30,26
1656194028856,MATH 18,B01,083748,Rideout; David Porter,1,0,36,35
1656194028856,MATH 18,B02,083749,Rideout; David Porter,0,0,36,36
1656194028856,MATH 18,B03,083750,Rideout; David Porter,0,0,36,36
1656194028856,MATH 18,B04,083751,Rideout; David Porter,0,0,36,36
1656194028856,MATH 18,B05,093473,Rideout; David Porter,0,0,36,36
1656194028856,MATH 18,B06,093474,Rideout; David Porter,2,0,36,34
1656194034879,MATH 20A,A01,083754,Zheng; Zequn,11,0,40,29
1656194040904,MATH 20B,A01,083756,Briones; Jor-el Thomas Caparas,0,0,36,36
1656194040904,MATH 20B,A02,083757,Briones; Jor-el Thomas Caparas,0,0,36,36
1656194040904,MATH 20B,A03,093475,Staff,1,0,36,35
1656194046930,MATH 20C,A01,083760,Briones; Jor-el Thomas Caparas,0,0,35,35
1656194046930,MATH 20C,A02,083761,Briones; Jor-el Thomas Caparas,9,1,35,26
1656194046930,MATH 20C,A03,093476,Staff,0,0,35,35
1656194046930,MATH 20C,B01,083762,Bach; Quang Tran,1,0,30,29
1656194052965,MATH 20D,A01,083765,Tran; Brian Kha,1,0,30,29
1656194052965,MATH 20D,A02,083766,Tran; Brian Kha,0,1,30,30
1656194052965,MATH 20D,A03,083767,Tran; Brian Kha,2,0,30,28
1656194058995,MATH 20E,A01,083771,Ganguly; Soumya,3,0,32,29
1656194058995,MATH 20E,A02,083772,Ganguly; Soumya,0,0,32,32
1656194058995,MATH 20E,B01,083773,Ciotti; Benjamin,15,0,35,20
1656194058995,MATH 20E,B02,083774,Ciotti; Benjamin,15,0,35,20
1656194065025,MATH 103A,A01,083777,Greenfeld; Be'Eri,1,0,36,35
1656194065025,MATH 103A,A02,083778,Greenfeld; Be'Eri,1,0,36,35
1656194065025,MATH 103A,A03,093561,Staff,5,0,36,31
1656194065025,MATH 103A,B01,083779,Greenfeld; Be'Eri,9,1,36,27
1656194065025,MATH 103A,B02,083780,Greenfeld; Be'Eri,1,0,36,35
1656194065025,MATH 103A,B03,093562,Staff,0,0,36,36
1656194071048,MATH 105,A01,085443,Carter; Anne Toulson,5,1,35,30
1656194071048,MATH 105,A02,093477,Staff,13,0,35,22
1656194077073,MATH 109,A01,083213,Ganzberger; Geoffrey Michael,0,0,34,34
1656194077073,MATH 109,A02,083214,Ganzberger; Geoffrey Michael,0,0,34,34
1656194077073,MATH 109,A03,093478,Staff,1,0,34,33
1656194077073,MATH 109,B01,083215,Ganzberger; Geoffrey Michael,4,0,32,28
1656194077073,MATH 109,B02,083216,Ganzberger; Geoffrey Michael,1,0,32,31
1656194077073,MATH 109,B03,093479,Staff,4,0,32,28
1656194083097,MATH 142A,A01,083219,Chow; Bennett,1,0,32,31
1656194083097,MATH 142A,A02,083220,Chow; Bennett,8,0,32,24
1656194083097,MATH 142A,A03,093480,Staff,5,0,32,27
1656194083097,MATH 142A,B03,093481,Staff,3,0,32,29
1656194083097,MATH 142A,B04,093558,Staff,6,0,32,26
1656194083097,MATH 142A,B05,093559,Staff,1,0,32,31
1656194089133,MATH 193A,A01,083224,Rotar; Vladimir,0,1,34,34
1656194089133,MATH 193A,A02,083225,Rotar; Vladimir,0,0,34,34
1656194089133,MATH 193A,A03,083781,Rotar; Vladimir,1,0,34,33
1656194089133,MATH 193A,A04,083782,Rotar; Vladimir,6,0,34,28
1656194089133,MATH 193A,A05,093482,Rotar; Vladimir,0,0,34,34
1656194095157,MATH 197,001,091859,McAuley; Julian John,9999,0,9999,0
1656194095157,MATH 197,002,095566,Kedlaya; Kiran S.,9997,0,9999,2
1656194095157,MATH 197,003,095567,Xiao; Ming,9999,0,9999,0
1656194095157,MATH 197,004,095571,Perols; Johan Lars,9998,0,9999,1
1656194102245,COGS 9,A01,083615,Shannon; Kyle Michael,4,0,75,71
1656194108269,COGS 11,A01,083617,Boyle; Mary E. T.,14,0,48,34
1656194114293,COGS 13,A01,083071,Bastos; Amalia Pinkusfeld,4,0,71,67
1656194120320,COGS 14A,A01,092681,Semenuks; Arturs,4,15,100,96
1656194126347,COGS 14B,A01,083073,Cheng; Tzu-Han,7,0,63,56
1656194132375,COGS 17,A01,092677,Semenuks; Arturs,7,0,81,74
1656194138397,COGS 100,A01,083619,Allen; Michael Gordon,2,0,70,68
1656194144423,COGS 101A,A01,083621,Davis; Joshua Daniel,4,0,68,64
1656194150447,COGS 101B,A01,091572,Allen; Michael Gordon,5,0,65,60
1656194156471,COGS 101C,A01,083625,Delgado; Tania,10,0,35,25
1656194162502,COGS 107A,A01,083627,Boyle; Mary E. T.,0,0,60,60
1656194168532,COGS 118A,A01,083075,Gupta; Anjum,7,0,76,69
1656194174560,CSE 3,A50,083646,Miranda; Gregory Joseph,18,0,50,32
1656194180583,CSE 8A,A50,083650,Miranda; Gregory Joseph,3,3,56,53
1656194186606,CSE 11,A01,083080,Cao; Yingjun,1,52,40,39
1656194192644,CSE 12,A01,083652,Krause-Levy; Sophia Louisa,7,3,120,113
1656194198668,CSE 15L,A01,083654,Morris; Justin Loren,2,0,50,48
1656194198668,CSE 15L,A02,083655,Morris; Justin Loren,4,0,50,46
1656194204698,CSE 20,A01,083657,Tran; Khoa Dang,30,0,80,50
1656194210728,CSE 21,A01,095574,Bach; Quang Tran,24,0,48,24
1656194216769,CSE 30,A01,083084,Eldon; John,2,8,80,78
1656194216769,CSE 30,B01,095061,Bhaskar; Nishant,1,2,50,49
1656194222795,CSE 100,A01,083659,Cao; Yingjun,2,20,70,68
1656194228818,CSE 134B,A01,083661,Powell; Thomas Allan,3,0,100,97
1656194234841,CSE 140,A01,083663,Gungor; Onat,9,0,85,76
1656194240866,CSE 140L,A01,083088,Eldon; John,8,0,100,92
1656194246901,CSE 175,A01,083665,Kumar; Rakesh,0,0,25,25
1656194252928,CSE 190,A00,092507,Dubnov; Shlomo,2,0,20,18
1656194258958,ECE 45,A01,083139,Congero; Spencer William,1,0,75,74
1656194265002,ECE 65,A50,083695,Saad; Andrew S,9,0,30,21
1656194265002,ECE 65,A51,095125,Staff,23,0,26,3
1656194271029,ECE 109,A01,091882,Touri; Behrouz,0,1,70,70
1656194277053,ECE 180,A00,083140,Abi Samra; Nicholas Camill,1,0,30,29
1656194277053,ECE 180,B00,083141,Abi Samra; Nicholas Camill,0,4,30,30
1656194283078,MATH 10A,A01,083735,Patchell; Gregory David,0,0,30,30
1656194283078,MATH 10A,A02,083736,Patchell; Gregory David,22,0,30,8
1656194283078,MATH 10A,A03,083737,Patchell; Gregory David,16,0,30,14
1656194289102,MATH 10B,A01,083207,Lim; Seonhee,0,0,34,34
1656194289102,MATH 10B,A02,083208,Lim; Seonhee,7,0,35,28
1656194289102,MATH 10B,A03,093472,Staff,1,0,34,33
1656194289102,MATH 10B,B01,083739,Sinha; Shubham,11,0,30,19
1656194295134,MATH 18,A01,083743,Cinel; Cameron Alexander,7,0,30,23
1656194295134,MATH 18,A02,083744,Cinel; Cameron Alexander,10,0,30,20
1656194295134,MATH 18,A03,083745,Cinel; Cameron Alexander,4,0,30,26
1656194295134,MATH 18,B01,083748,Rideout; David Porter,1,0,36,35
1656194295134,MATH 18,B02,083749,Rideout; David Porter,0,0,36,36
1656194295134,MATH 18,B03,083750,Rideout; David Porter,0,0,36,36
1656194295134,MATH 18,B04,083751,Rideout; David Porter,0,0,36,36
1656194295134,MATH 18,B05,093473,Rideout; David Porter,0,0,36,36
1656194295134,MATH 18,B06,093474,Rideout; David Porter,2,0,36,34
1656194301158,MATH 20A,A01,083754,Zheng; Zequn,11,0,40,29
1656194307185,MATH 20B,A01,083756,Briones; Jor-el Thomas Caparas,0,0,36,36
1656194307185,MATH 20B,A02,083757,Briones; Jor-el Thomas Caparas,0,0,36,36
1656194307185,MATH 20B,A03,093475,Staff,1,0,36,35
1656194313209,MATH 20C,A01,083760,Briones; Jor-el Thomas Caparas,0,0,35,35
1656194313209,MATH 20C,A02,083761,Briones; Jor-el Thomas Caparas,9,1,35,26
1656194313209,MATH 20C,A03,093476,Staff,0,0,35,35
1656194313209,MATH 20C,B01,083762,Bach; Quang Tran,1,0,30,29
1656194319243,MATH 20D,A01,083765,Tran; Brian Kha,1,0,30,29
1656194319243,MATH 20D,A02,083766,Tran; Brian Kha,0,1,30,30
1656194319243,MATH 20D,A03,083767,Tran; Brian Kha,2,0,30,28
1656194325266,MATH 20E,A01,083771,Ganguly; Soumya,3,0,32,29
1656194325266,MATH 20E,A02,083772,Ganguly; Soumya,0,0,32,32
1656194325266,MATH 20E,B01,083773,Ciotti; Benjamin,15,0,35,20
1656194325266,MATH 20E,B02,083774,Ciotti; Benjamin,15,0,35,20
1656194331295,MATH 103A,A01,083777,Greenfeld; Be'Eri,1,0,36,35
1656194331295,MATH 103A,A02,083778,Greenfeld; Be'Eri,1,0,36,35
1656194331295,MATH 103A,A03,093561,Staff,5,0,36,31
1656194331295,MATH 103A,B01,083779,Greenfeld; Be'Eri,9,1,36,27
1656194331295,MATH 103A,B02,083780,Greenfeld; Be'Eri,1,0,36,35
1656194331295,MATH 103A,B03,093562,Staff,0,0,36,36
1656194337318,MATH 105,A01,085443,Carter; Anne Toulson,5,1,35,30
1656194337318,MATH 105,A02,093477,Staff,13,0,35,22
1656194343350,MATH 109,A01,083213,Ganzberger; Geoffrey Michael,0,0,34,34
1656194343350,MATH 109,A02,083214,Ganzberger; Geoffrey Michael,0,0,34,34
1656194343350,MATH 109,A03,093478,Staff,1,0,34,33
1656194343350,MATH 109,B01,083215,Ganzberger; Geoffrey Michael,4,0,32,28
1656194343350,MATH 109,B02,083216,Ganzberger; Geoffrey Michael,1,0,32,31
1656194343350,MATH 109,B03,093479,Staff,4,0,32,28
1656194349372,MATH 142A,A01,083219,Chow; Bennett,1,0,32,31
1656194349372,MATH 142A,A02,083220,Chow; Bennett,8,0,32,24
1656194349372,MATH 142A,A03,093480,Staff,5,0,32,27
1656194349372,MATH 142A,B03,093481,Staff,3,0,32,29
1656194349372,MATH 142A,B04,093558,Staff,6,0,32,26
1656194349372,MATH 142A,B05,093559,Staff,1,0,32,31
1656194355395,MATH 193A,A01,083224,Rotar; Vladimir,0,1,34,34
1656194355395,MATH 193A,A02,083225,Rotar; Vladimir,0,0,34,34
1656194355395,MATH 193A,A03,083781,Rotar; Vladimir,1,0,34,33
1656194355395,MATH 193A,A04,083782,Rotar; Vladimir,6,0,34,28
1656194355395,MATH 193A,A05,093482,Rotar; Vladimir,0,0,34,34
1656194361418,MATH 197,001,091859,McAuley; Julian John,9999,0,9999,0
1656194361418,MATH 197,002,095566,Kedlaya; Kiran S.,9997,0,9999,2
1656194361418,MATH 197,003,095567,Xiao; Ming,9999,0,9999,0
1656194361418,MATH 197,004,095571,Perols; Johan Lars,9998,0,9999,1
1656194368470,COGS 9,A01,083615,Shannon; Kyle Michael,4,0,75,71
1656194374497,COGS 11,A01,083617,Boyle; Mary E. T.,14,0,48,34
1656194380521,COGS 13,A01,083071,Bastos; Amalia Pinkusfeld,4,0,71,67
1656194386544,COGS 14A,A01,092681,Semenuks; Arturs,4,15,100,96
1656194392572,COGS 14B,A01,083073,Cheng; Tzu-Han,7,0,63,56
1656194398595,COGS 17,A01,092677,Semenuks; Arturs,7,0,81,74
1656194404618,COGS 100,A01,083619,Allen; Michael Gordon,2,0,70,68
1656194410646,COGS 101A,A01,083621,Davis; Joshua Daniel,4,0,68,64
1656194416669,COGS 101B,A01,091572,Allen; Michael Gordon,5,0,65,60
1656194422699,COGS 101C,A01,083625,Delgado; Tania,10,0,35,25
1656194428723,COGS 107A,A01,083627,Boyle; Mary E. T.,0,0,60,60
1656194434750,COGS 118A,A01,083075,Gupta; Anjum,7,0,76,69
1656194440775,CSE 3,A50,083646,Miranda; Gregory Joseph,18,0,50,32
1656194446803,CSE 8A,A50,083650,Miranda; Gregory Joseph,3,3,56,53
1656194452830,CSE 11,A01,083080,Cao; Yingjun,1,52,40,39
1656194458859,CSE 12,A01,083652,Krause-Levy; Sophia Louisa,7,3,120,113
1656194464883,CSE 15L,A01,083654,Morris; Justin Loren,2,0,50,48
1656194464883,CSE 15L,A02,083655,Morris; Justin Loren,4,0,50,46
1656194470909,CSE 20,A01,083657,Tran; Khoa Dang,30,0,80,50
1656194476931,CSE 21,A01,095574,Bach; Quang Tran,24,0,48,24
1656194482955,CSE 30,A01,083084,Eldon; John,2,8,80,78
1656194482955,CSE 30,B01,095061,Bhaskar; Nishant,1,2,50,49
1656194488983,CSE 100,A01,083659,Cao; Yingjun,2,20,70,68
1656194495008,CSE 134B,A01,083661,Powell; Thomas Allan,3,0,100,97
1656194501035,CSE 140,A01,083663,Gungor; Onat,9,0,85,76
1656194507057,CSE 140L,A01,083088,Eldon; John,8,0,100,92
1656194513089,CSE 175,A01,083665,Kumar; Rakesh,0,0,25,25
1656194519112,CSE 190,A00,092507,Dubnov; Shlomo,2,0,20,18
1656194525140,ECE 45,A01,083139,Congero; Spencer William,1,0,75,74
1656194531163,ECE 65,A50,083695,Saad; Andrew S,9,0,30,21
1656194531163,ECE 65,A51,095125,Staff,23,0,26,3
1656194537190,ECE 109,A01,091882,Touri; Behrouz,0,1,70,70
1656194543213,ECE 180,A00,083140,Abi Samra; Nicholas Camill,1,0,30,29
1656194543213,ECE 180,B00,083141,Abi Samra; Nicholas Camill,0,4,30,30
1656194549242,MATH 10A,A01,083735,Patchell; Gregory David,0,0,30,30
1656194549242,MATH 10A,A02,083736,Patchell; Gregory David,22,0,30,8
1656194549242,MATH 10A,A03,083737,Patchell; Gregory David,16,0,30,14
1656194555266,MATH 10B,A01,083207,Lim; Seonhee,0,0,34,34
1656194555266,MATH 10B,A02,083208,Lim; Seonhee,7,0,35,28
1656194555266,MATH 10B,A03,093472,Staff,1,0,34,33
1656194555266,MATH 10B,B01,083739,Sinha; Shubham,11,0,30,19
1656194561290,MATH 18,A01,083743,Cinel; Cameron Alexander,7,0,30,23
1656194561290,MATH 18,A02,083744,Cinel; Cameron Alexander,10,0,30,20
1656194561290,MATH 18,A03,083745,Cinel; Cameron Alexander,4,0,30,26
1656194561290,MATH 18,B01,083748,Rideout; David Porter,1,0,36,35
1656194561290,MATH 18,B02,083749,Rideout; David Porter,0,0,36,36
1656194561290,MATH 18,B03,083750,Rideout; David Porter,0,0,36,36
1656194561290,MATH 18,B04,083751,Rideout; David Porter,0,0,36,36
1656194561290,MATH 18,B05,093473,Rideout; David Porter,0,0,36,36
1656194561290,MATH 18,B06,093474,Rideout; David Porter,2,0,36,34
1656194567325,MATH 20A,A01,083754,Zheng; Zequn,11,0,40,29
1656194573360,MATH 20B,A01,083756,Briones; Jor-el Thomas Caparas,0,0,36,36
1656194573360,MATH 20B,A02,083757,Briones; Jor-el Thomas Caparas,0,0,36,36
1656194573360,MATH 20B,A03,093475,Staff,1,0,36,35
1656194579384,MATH 20C,A01,083760,Briones; Jor-el Thomas Caparas,0,0,35,35
1656194579384,MATH 20C,A02,083761,Briones; Jor-el Thomas Caparas,9,1,35,26
1656194579384,MATH 20C,A03,093476,Staff,0,0,35,35
1656194579384,MATH 20C,B01,083762,Bach; Quang Tran,1,0,30,29
1656194585482,MATH 20D,A01,083765,Tran; Brian Kha,1,0,30,29
1656194585482,MATH 20D,A02,083766,Tran; Brian Kha,0,1,30,30
1656194585482,MATH 20D,A03,083767,Tran; Brian Kha,2,0,30,28
1656194591507,MATH 20E,A01,083771,Ganguly; Soumya,3,0,32,29
1656194591507,MATH 20E,A02,083772,Ganguly; Soumya,0,0,32,32
1656194591507,MATH 20E,B01,083773,Ciotti; Benjamin,15,0,35,20
1656194591507,MATH 20E,B02,083774,Ciotti; Benjamin,15,0,35,20
1656194597531,MATH 103A,A01,083777,Greenfeld; Be'Eri,1,0,36,35
1656194597531,MATH 103A,A02,083778,Greenfeld; Be'Eri,1,0,36,35
1656194597531,MATH 103A,A03,093561,Staff,5,0,36,31
1656194597531,MATH 103A,B01,083779,Greenfeld; Be'Eri,9,1,36,27
1656194597531,MATH 103A,B02,083780,Greenfeld; Be'Eri,1,0,36,35
1656194597531,MATH 103A,B03,093562,Staff,0,0,36,36
1656194603556,MATH 105,A01,085443,Carter; Anne Toulson,5,1,35,30
1656194603556,MATH 105,A02,093477,Staff,13,0,35,22
1656194609588,MATH 109,A01,083213,Ganzberger; Geoffrey Michael,0,0,34,34
1656194609588,MATH 109,A02,083214,Ganzberger; Geoffrey Michael,0,0,34,34
1656194609588,MATH 109,A03,093478,Staff,1,0,34,33
1656194609588,MATH 109,B01,083215,Ganzberger; Geoffrey Michael,4,0,32,28
1656194609588,MATH 109,B02,083216,Ganzberger; Geoffrey Michael,1,0,32,31
1656194609588,MATH 109,B03,093479,Staff,4,0,32,28
1656194615612,MATH 142A,A01,083219,Chow; Bennett,1,0,32,31
1656194615612,MATH 142A,A02,083220,Chow; Bennett,8,0,32,24
1656194615612,MATH 142A,A03,093480,Staff,5,0,32,27
1656194615612,MATH 142A,B03,093481,Staff,3,0,32,29
1656194615612,MATH 142A,B04,093558,Staff,6,0,32,26
1656194615612,MATH 142A,B05,093559,Staff,1,0,32,31
1656194621637,MATH 193A,A01,083224,Rotar; Vladimir,0,1,34,34
1656194621637,MATH 193A,A02,083225,Rotar; Vladimir,0,0,34,34
1656194621637,MATH 193A,A03,083781,Rotar; Vladimir,1,0,34,33
1656194621637,MATH 193A,A04,083782,Rotar; Vladimir,6,0,34,28
1656194621637,MATH 193A,A05,093482,Rotar; Vladimir,0,0,34,34
1656194627665,MATH 197,001,091859,McAuley; Julian John,9999,0,9999,0
1656194627665,MATH 197,002,095566,Kedlaya; Kiran S.,9997,0,9999,2
1656194627665,MATH 197,003,095567,Xiao; Ming,9999,0,9999,0
1656194627665,MATH 197,004,095571,Perols; Johan Lars,9998,0,9999,1
1656194634732,COGS 9,A01,083615,Shannon; Kyle Michael,4,0,75,71
1656194640761,COGS 11,A01,083617,Boyle; Mary E. T.,14,0,48,34
1656194646804,COGS 13,A01,083071,Bastos; Amalia Pinkusfeld,4,0,71,67
1656194652830,COGS 14A,A01,092681,Semenuks; Arturs,4,15,100,96
1656194658853,COGS 14B,A01,083073,Cheng; Tzu-Han,7,0,63,56
1656194664875,COGS 17,A01,092677,Semenuks; Arturs,7,0,81,74
1656194670898,COGS 100,A01,083619,Allen; Michael Gordon,2,0,70,68
1656194676926,COGS 101A,A01,083621,Davis; Joshua Daniel,4,0,68,64
1656194682947,COGS 101B,A01,091572,Allen; Michael Gordon,5,0,65,60
1656194688974,COGS 101C,A01,083625,Delgado; Tania,10,0,35,25
1656194695001,COGS 107A,A01,083627,Boyle; Mary E. T.,0,0,60,60
1656194701028,COGS 118A,A01,083075,Gupta; Anjum,7,0,76,69
1656194707053,CSE 3,A50,083646,Miranda; Gregory Joseph,18,0,50,32
1656194713081,CSE 8A,A50,083650,Miranda; Gregory Joseph,3,3,56,53
1656194719108,CSE 11,A01,083080,Cao; Yingjun,1,52,40,39
1656194725135,CSE 12,A01,083652,Krause-Levy; Sophia Louisa,7,3,120,113
1656194731158,CSE 15L,A01,083654,Morris; Justin Loren,2,0,50,48
1656194731158,CSE 15L,A02,083655,Morris; Justin Loren,4,0,50,46
1656194737181,CSE 20,A01,083657,Tran; Khoa Dang,30,0,80,50
1656194743207,CSE 21,A01,095574,Bach; Quang Tran,24,0,48,24
1656194749235,CSE 30,A01,083084,Eldon; John,2,8,80,78
1656194749235,CSE 30,B01,095061,Bhaskar; Nishant,1,2,50,49
1656194755265,CSE 100,A01,083659,Cao; Yingjun,2,20,70,68
1656194761289,CSE 134B,A01,083661,Powell; Thomas Allan,3,0,100,97
1656194767312,CSE 140,A01,083663,Gungor; Onat,9,0,85,76
1656194773334,CSE 140L,A01,083088,Eldon; John,8,0,100,92
1656194779356,CSE 175,A01,083665,Kumar; Rakesh,0,0,25,25
1656194785382,CSE 190,A00,092507,Dubnov; Shlomo,2,0,20,18
1656194791408,ECE 45,A01,083139,Congero; Spencer William,1,0,75,74
1656194797429,ECE 65,A50,083695,Saad; Andrew S,9,0,30,21
1656194797429,ECE 65,A51,095125,Staff,23,0,26,3
1656194803456,ECE 109,A01,091882,Touri; Behrouz,0,1,70,70
1656194809478,ECE 180,A00,083140,Abi Samra; Nicholas Camill,1,0,30,29
1656194809478,ECE 180,B00,083141,Abi Samra; Nicholas Camill,0,4,30,30
1656194815499,MATH 10A,A01,083735,Patchell; Gregory David,0,0,30,30
1656194815499,MATH 10A,A02,083736,Patchell; Gregory David,22,0,30,8
1656194815499,MATH 10A,A03,083737,Patchell; Gregory David,16,0,30,14
1656194821523,MATH 10B,A01,083207,Lim; Seonhee,0,0,34,34
1656194821523,MATH 10B,A02,083208,Lim; Seonhee,7,0,35,28
1656194821523,MATH 10B,A03,093472,Staff,1,0,34,33
1656194821523,MATH 10B,B01,083739,Sinha; Shubham,11,0,30,19
1656194827555,MATH 18,A01,083743,Cinel; Cameron Alexander,7,0,30,23
1656194827555,MATH 18,A02,083744,Cinel; Cameron Alexander,10,0,30,20
1656194827555,MATH 18,A03,083745,Cinel; Cameron Alexander,4,0,30,26
1656194827555,MATH 18,B01,083748,Rideout; David Porter,1,0,36,35
1656194827555,MATH 18,B02,083749,Rideout; David Porter,0,0,36,36
1656194827555,MATH 18,B03,083750,Rideout; David Porter,0,0,36,36
1656194827555,MATH 18,B04,083751,Rideout; David Porter,0,0,36,36
1656194827555,MATH 18,B05,093473,Rideout; David Porter,0,0,36,36
1656194827555,MATH 18,B06,093474,Rideout; David Porter,2,0,36,34
1656194833579,MATH 20A,A01,083754,Zheng; Zequn,11,0,40,29
1656194839603,MATH 20B,A01,083756,Briones; Jor-el Thomas Caparas,0,0,36,36
1656194839603,MATH 20B,A02,083757,Briones; Jor-el Thomas Caparas,0,0,36,36
1656194839603,MATH 20B,A03,093475,Staff,1,0,36,35
1656194845633,MATH 20C,A01,083760,Briones; Jor-el Thomas Caparas,0,0,35,35
1656194845633,MATH 20C,A02,083761,Briones; Jor-el Thomas Caparas,9,1,35,26
1656194845633,MATH 20C,A03,093476,Staff,0,0,35,35
1656194845633,MATH 20C,B01,083762,Bach; Quang Tran,1,0,30,29
1656194851660,MATH 20D,A01,083765,Tran; Brian Kha,1,0,30,29
1656194851660,MATH 20D,A02,083766,Tran; Brian Kha,0,1,30,30
1656194851660,MATH 20D,A03,083767,Tran; Brian Kha,2,0,30,28
1656194857695,MATH 20E,A01,083771,Ganguly; Soumya,3,0,32,29
1656194857695,MATH 20E,A02,083772,Ganguly; Soumya,0,0,32,32
1656194857695,MATH 20E,B01,083773,Ciotti; Benjamin,15,0,35,20
1656194857695,MATH 20E,B02,083774,Ciotti; Benjamin,15,0,35,20
1656194863718,MATH 103A,A01,083777,Greenfeld; Be'Eri,1,0,36,35
1656194863718,MATH 103A,A02,083778,Greenfeld; Be'Eri,1,0,36,35
1656194863718,MATH 103A,A03,093561,Staff,5,0,36,31
1656194863718,MATH 103A,B01,083779,Greenfeld; Be'Eri,9,1,36,27
1656194863718,MATH 103A,B02,083780,Greenfeld; Be'Eri,1,0,36,35
1656194863718,MATH 103A,B03,093562,Staff,0,0,36,36
1656194869743,MATH 105,A01,085443,Carter; Anne Toulson,5,1,35,30
1656194869743,MATH 105,A02,093477,Staff,13,0,35,22
1656194875766,MATH 109,A01,083213,Ganzberger; Geoffrey Michael,0,0,34,34
1656194875766,MATH 109,A02,083214,Ganzberger; Geoffrey Michael,0,0,34,34
1656194875766,MATH 109,A03,093478,Staff,1,0,34,33
1656194875766,MATH 109,B01,083215,Ganzberger; Geoffrey Michael,4,0,32,28
1656194875766,MATH 109,B02,083216,Ganzberger; Geoffrey Michael,1,0,32,31
1656194875766,MATH 109,B03,093479,Staff,4,0,32,28
1656194881796,MATH 142A,A01,083219,Chow; Bennett,1,0,32,31
1656194881796,MATH 142A,A02,083220,Chow; Bennett,8,0,32,24
1656194881796,MATH 142A,A03,093480,Staff,5,0,32,27
1656194881796,MATH 142A,B03,093481,Staff,3,0,32,29
1656194881796,MATH 142A,B04,093558,Staff,6,0,32,26
1656194881796,MATH 142A,B05,093559,Staff,1,0,32,31
1656194887820,MATH 193A,A01,083224,Rotar; Vladimir,0,1,34,34
1656194887820,MATH 193A,A02,083225,Rotar; Vladimir,0,0,34,34
1656194887820,MATH 193A,A03,083781,Rotar; Vladimir,1,0,34,33
1656194887820,MATH 193A,A04,083782,Rotar; Vladimir,6,0,34,28
1656194887820,MATH 193A,A05,093482,Rotar; Vladimir,0,0,34,34
1656194893844,MATH 197,001,091859,McAuley; Julian John,9999,0,9999,0
1656194893844,MATH 197,002,095566,Kedlaya; Kiran S.,9997,0,9999,2
1656194893844,MATH 197,003,095567,Xiao; Ming,9999,0,9999,0
1656194893844,MATH 197,004,095571,Perols; Johan Lars,9998,0,9999,1
1656194900894,COGS 9,A01,083615,Shannon; Kyle Michael,4,0,75,71
1656194906918,COGS 11,A01,083617,Boyle; Mary E. T.,14,0,48,34
1656194912942,COGS 13,A01,083071,Bastos; Amalia Pinkusfeld,4,0,71,67
1656194918964,COGS 14A,A01,092681,Semenuks; Arturs,4,15,100,96
1656194925019,COGS 14B,A01,083073,Cheng; Tzu-Han,7,0,63,56
1656194931046,COGS 17,A01,092677,Semenuks; Arturs,7,0,81,74
1656194937069,COGS 100,A01,083619,Allen; Michael Gordon,2,0,70,68
1656194943092,COGS 101A,A01,083621,Davis; Joshua Daniel,4,0,68,64
1656194949115,COGS 101B,A01,091572,Allen; Michael Gordon,5,0,65,60
1656194955138,COGS 101C,A01,083625,Delgado; Tania,10,0,35,25
1656194961174,COGS 107A,A01,083627,Boyle; Mary E. T.,0,0,60,60
1656194967198,COGS 118A,A01,083075,Gupta; Anjum,7,0,76,69
1656194973224,CSE 3,A50,083646,Miranda; Gregory Joseph,18,0,50,32
1656194979252,CSE 8A,A50,083650,Miranda; Gregory Joseph,3,3,56,53
1656194985276,CSE 11,A01,083080,Cao; Yingjun,1,52,40,39
1656194991305,CSE 12,A01,083652,Krause-Levy; Sophia Louisa,7,3,120,113
1656194997332,CSE 15L,A01,083654,Morris; Justin Loren,2,0,50,48
1656194997332,CSE 15L,A02,083655,Morris; Justin Loren,4,0,50,46
1656195003359,CSE 20,A01,083657,Tran; Khoa Dang,30,0,80,50
1656195009382,CSE 21,A01,095574,Bach; Quang Tran,24,0,48,24
1656195015411,CSE 30,A01,083084,Eldon; John,2,8,80,78
1656195015411,CSE 30,B01,095061,Bhaskar; Nishant,1,2,50,49
1656195021432,CSE 100,A01,083659,Cao; Yingjun,2,20,70,68
1656195027454,CSE 134B,A01,083661,Powell; Thomas Allan,3,0,100,97
1656195033483,CSE 140,A01,083663,Gungor; Onat,9,0,85,76
1656195039507,CSE 140L,A01,083088,Eldon; John,8,0,100,92
1656195045530,CSE 175,A01,083665,Kumar; Rakesh,0,0,25,25
1656195051553,CSE 190,A00,092507,Dubnov; Shlomo,2,0,20,18
1656195057582,ECE 45,A01,083139,Congero; Spencer William,1,0,75,74
1656195063611,ECE 65,A50,083695,Saad; Andrew S,9,0,30,21
1656195063611,ECE 65,A51,095125,Staff,23,0,26,3
1656195069639,ECE 109,A01,091882,Touri; Behrouz,0,1,70,70
1656195075666,ECE 180,A00,083140,Abi Samra; Nicholas Camill,1,0,30,29
1656195075666,ECE 180,B00,083141,Abi Samra; Nicholas Camill,0,4,30,30
1656195081690,MATH 10A,A01,083735,Patchell; Gregory David,0,0,30,30
1656195081690,MATH 10A,A02,083736,Patchell; Gregory David,22,0,30,8
1656195081690,MATH 10A,A03,083737,Patchell; Gregory David,16,0,30,14
1656195087719,MATH 10B,A01,083207,Lim; Seonhee,0,0,34,34
1656195087719,MATH 10B,A02,083208,Lim; Seonhee,7,0,35,28
1656195087719,MATH 10B,A03,093472,Staff,1,0,34,33
1656195087719,MATH 10B,B01,083739,Sinha; Shubham,11,0,30,19
1656195093745,MATH 18,A01,083743,Cinel; Cameron Alexander,7,0,30,23
1656195093745,MATH 18,A02,083744,Cinel; Cameron Alexander,10,0,30,20
1656195093745,MATH 18,A03,083745,Cinel; Cameron Alexander,4,0,30,26
1656195093745,MATH 18,B01,083748,Rideout; David Porter,1,0,36,35
1656195093745,MATH 18,B02,083749,Rideout; David Porter,0,0,36,36
1656195093745,MATH 18,B03,083750,Rideout; David Porter,0,0,36,36
1656195093745,MATH 18,B04,083751,Rideout; David Porter,0,0,36,36
1656195093745,MATH 18,B05,093473,Rideout; David Porter,0,0,36,36
1656195093745,MATH 18,B06,093474,Rideout; David Porter,2,0,36,34
1656195099769,MATH 20A,A01,083754,Zheng; Zequn,11,0,40,29
1656195105797,MATH 20B,A01,083756,Briones; Jor-el Thomas Caparas,0,0,36,36
1656195105797,MATH 20B,A02,083757,Briones; Jor-el Thomas Caparas,0,0,36,36
1656195105797,MATH 20B,A03,093475,Staff,1,0,36,35
1656195111827,MATH 20C,A01,083760,Briones; Jor-el Thomas Caparas,0,0,35,35
1656195111827,MATH 20C,A02,083761,Briones; Jor-el Thomas Caparas,9,1,35,26
1656195111827,MATH 20C,A03,093476,Staff,0,0,35,35
1656195111827,MATH 20C,B01,083762,Bach; Quang Tran,1,0,30,29
1656195117855,MATH 20D,A01,083765,Tran; Brian Kha,1,0,30,29
1656195117855,MATH 20D,A02,083766,Tran; Brian Kha,0,1,30,30
1656195117855,MATH 20D,A03,083767,Tran; Brian Kha,2,0,30,28
1656195123885,MATH 20E,A01,083771,Ganguly; Soumya,3,0,32,29
1656195123885,MATH 20E,A02,083772,Ganguly; Soumya,0,0,32,32
1656195123885,MATH 20E,B01,083773,Ciotti; Benjamin,15,0,35,20
1656195123885,MATH 20E,B02,083774,Ciotti; Benjamin,15,0,35,20
1656195129910,MATH 103A,A01,083777,Greenfeld; Be'Eri,1,0,36,35
1656195129910,MATH 103A,A02,083778,Greenfeld; Be'Eri,1,0,36,35
1656195129910,MATH 103A,A03,093561,Staff,5,0,36,31
1656195129910,MATH 103A,B01,083779,Greenfeld; Be'Eri,9,1,36,27
1656195129910,MATH 103A,B02,083780,Greenfeld; Be'Eri,1,0,36,35
1656195129910,MATH 103A,B03,093562,Staff,0,0,36,36
1656195135939,MATH 105,A01,085443,Carter; Anne Toulson,5,1,35,30
1656195135939,MATH 105,A02,093477,Staff,13,0,35,22
1656195141967,MATH 109,A01,083213,Ganzberger; Geoffrey Michael,0,0,34,34
1656195141967,MATH 109,A02,083214,Ganzberger; Geoffrey Michael,0,0,34,34
1656195141967,MATH 109,A03,093478,Staff,1,0,34,33
1656195141967,MATH 109,B01,083215,Ganzberger; Geoffrey Michael,4,0,32,28
1656195141967,MATH 109,B02,083216,Ganzberger; Geoffrey Michael,1,0,32,31
1656195141967,MATH 109,B03,093479,Staff,4,0,32,28
1656195148003,MATH 142A,A01,083219,Chow; Bennett,1,0,32,31
1656195148003,MATH 142A,A02,083220,Chow; Bennett,8,0,32,24
1656195148003,MATH 142A,A03,093480,Staff,5,0,32,27
1656195148003,MATH 142A,B03,093481,Staff,3,0,32,29
1656195148003,MATH 142A,B04,093558,Staff,6,0,32,26
1656195148003,MATH 142A,B05,093559,Staff,1,0,32,31
1656195154028,MATH 193A,A01,083224,Rotar; Vladimir,0,1,34,34
1656195154028,MATH 193A,A02,083225,Rotar; Vladimir,0,0,34,34
1656195154028,MATH 193A,A03,083781,Rotar; Vladimir,1,0,34,33
1656195154028,MATH 193A,A04,083782,Rotar; Vladimir,6,0,34,28
1656195154028,MATH 193A,A05,093482,Rotar; Vladimir,0,0,34,34
1656195160052,MATH 197,001,091859,McAuley; Julian John,9999,0,9999,0
1656195160052,MATH 197,002,095566,Kedlaya; Kiran S.,9997,0,9999,2
1656195160052,MATH 197,003,095567,Xiao; Ming,9999,0,9999,0
1656195160052,MATH 197,004,095571,Perols; Johan Lars,9998,0,9999,1
1656195167108,COGS 9,A01,083615,Shannon; Kyle Michael,4,0,75,71
1656195173137,COGS 11,A01,083617,Boyle; Mary E. T.,14,0,48,34
1656195179233,COGS 13,A01,083071,Bastos; Amalia Pinkusfeld,4,0,71,67
1656195185260,COGS 14A,A01,092681,Semenuks; Arturs,4,15,100,96
1656195191283,COGS 14B,A01,083073,Cheng; Tzu-Han,7,0,63,56
1656195197307,COGS 17,A01,092677,Semenuks; Arturs,7,0,81,74
1656195203330,COGS 100,A01,083619,Allen; Michael Gordon,2,0,70,68
1656195209363,COGS 101A,A01,083621,Davis; Joshua Daniel,4,0,68,64
1656195215386,COGS 101B,A01,091572,Allen; Michael Gordon,5,0,65,60
1656195221410,COGS 101C,A01,083625,Delgado; Tania,10,0,35,25
1656195227438,COGS 107A,A01,083627,Boyle; Mary E. T.,0,0,60,60
1656195233459,COGS 118A,A01,083075,Gupta; Anjum,7,0,76,69
1656195239483,CSE 3,A50,083646,Miranda; Gregory Joseph,18,0,50,32
1656195245511,CSE 8A,A50,083650,Miranda; Gregory Joseph,3,3,56,53
1656195251534,CSE 11,A01,083080,Cao; Yingjun,1,52,40,39
1656195257558,CSE 12,A01,083652,Krause-Levy; Sophia Louisa,7,3,120,113
1656195263585,CSE 15L,A01,083654,Morris; Justin Loren,2,0,50,48
1656195263585,CSE 15L,A02,083655,Morris; Justin Loren,4,0,50,46
1656195269616,CSE 20,A01,083657,Tran; Khoa Dang,30,0,80,50
1656195275643,CSE 21,A01,095574,Bach; Quang Tran,24,0,48,24
1656195281666,CSE 30,A01,083084,Eldon; John,2,8,80,78
1656195281666,CSE 30,B01,095061,Bhaskar; Nishant,1,2,50,49
1656195287692,CSE 100,A01,083659,Cao; Yingjun,2,20,70,68
1656195293719,CSE 134B,A01,083661,Powell; Thomas Allan,3,0,100,97
1656195299743,CSE 140,A01,083663,Gungor; Onat,9,0,85,76
1656195305771,CSE 140L,A01,083088,Eldon; John,8,0,100,92
1656195311797,CSE 175,A01,083665,Kumar; Rakesh,0,0,25,25
1656195317823,CSE 190,A00,092507,Dubnov; Shlomo,2,0,20,18
1656195323851,ECE 45,A01,083139,Congero; Spencer William,1,0,75,74
1656195329874,ECE 65,A50,083695,Saad; Andrew S,9,0,30,21
1656195329874,ECE 65,A51,095125,Staff,23,0,26,3
1656195335897,ECE 109,A01,091882,Touri; Behrouz,0,1,70,70
1656195341927,ECE 180,A00,083140,Abi Samra; Nicholas Camill,1,0,30,29
1656195341927,ECE 180,B00,083141,Abi Samra; Nicholas Camill,0,4,30,30
1656195347955,MATH 10A,A01,083735,Patchell; Gregory David,0,0,30,30
1656195347955,MATH 10A,A02,083736,Patchell; Gregory David,22,0,30,8
1656195347955,MATH 10A,A03,083737,Patchell; Gregory David,16,0,30,14
1656195353989,MATH 10B,A01,083207,Lim; Seonhee,0,0,34,34
1656195353989,MATH 10B,A02,083208,Lim; Seonhee,7,0,35,28
1656195353989,MATH 10B,A03,093472,Staff,1,0,34,33
1656195353989,MATH 10B,B01,083739,Sinha; Shubham,11,0,30,19
1656195360020,MATH 18,A01,083743,Cinel; Cameron Alexander,7,0,30,23
1656195360020,MATH 18,A02,083744,Cinel; Cameron Alexander,10,0,30,20
1656195360020,MATH 18,A03,083745,Cinel; Cameron Alexander,4,0,30,26
1656195360020,MATH 18,B01,083748,Rideout; David Porter,1,0,36,35
1656195360020,MATH 18,B02,083749,Rideout; David Porter,0,0,36,36
1656195360020,MATH 18,B03,083750,Rideout; David Porter,0,0,36,36
1656195360020,MATH 18,B04,083751,Rideout; David Porter,0,0,36,36
1656195360020,MATH 18,B05,093473,Rideout; David Porter,0,0,36,36
1656195360020,MATH 18,B06,093474,Rideout; David Porter,2,0,36,34
1656195366042,MATH 20A,A01,083754,Zheng; Zequn,11,0,40,29
1656195372067,MATH 20B,A01,083756,Briones; Jor-el Thomas Caparas,0,0,36,36
1656195372067,MATH 20B,A02,083757,Briones; Jor-el Thomas Caparas,0,0,36,36
1656195372067,MATH 20B,A03,093475,Staff,1,0,36,35
1656195378101,MATH 20C,A01,083760,Briones; Jor-el Thomas Caparas,0,0,35,35
1656195378101,MATH 20C,A02,083761,Briones; Jor-el Thomas Caparas,9,1,35,26
1656195378101,MATH 20C,A03,093476,Staff,0,0,35,35
1656195378101,MATH 20C,B01,083762,Bach; Quang Tran,1,0,30,29
1656195384129,MATH 20D,A01,083765,Tran; Brian Kha,1,0,30,29
1656195384129,MATH 20D,A02,083766,Tran; Brian Kha,0,1,30,30
1656195384129,MATH 20D,A03,083767,Tran; Brian Kha,2,0,30,28
1656195390158,MATH 20E,A01,083771,Ganguly; Soumya,3,0,32,29
1656195390158,MATH 20E,A02,083772,Ganguly; Soumya,0,0,32,32
1656195390158,MATH 20E,B01,083773,Ciotti; Benjamin,15,0,35,20
1656195390158,MATH 20E,B02,083774,Ciotti; Benjamin,15,0,35,20
1656195396190,MATH 103A,A01,083777,Greenfeld; Be'Eri,1,0,36,35
1656195396190,MATH 103A,A02,083778,Greenfeld; Be'Eri,1,0,36,35
1656195396190,MATH 103A,A03,093561,Staff,5,0,36,31
1656195396190,MATH 103A,B01,083779,Greenfeld; Be'Eri,9,1,36,27
1656195396190,MATH 103A,B02,083780,Greenfeld; Be'Eri,1,0,36,35
1656195396190,MATH 103A,B03,093562,Staff,0,0,36,36
1656195402218,MATH 105,A01,085443,Carter; Anne Toulson,5,1,35,30
1656195402218,MATH 105,A02,093477,Staff,13,0,35,22
1656195408243,MATH 109,A01,083213,Ganzberger; Geoffrey Michael,0,0,34,34
1656195408243,MATH 109,A02,083214,Ganzberger; Geoffrey Michael,0,0,34,34
1656195408243,MATH 109,A03,093478,Staff,1,0,34,33
1656195408243,MATH 109,B01,083215,Ganzberger; Geoffrey Michael,4,0,32,28
1656195408243,MATH 109,B02,083216,Ganzberger; Geoffrey Michael,1,0,32,31
1656195408243,MATH 109,B03,093479,Staff,4,0,32,28
1656195414267,MATH 142A,A01,083219,Chow; Bennett,1,0,32,31
1656195414267,MATH 142A,A02,083220,Chow; Bennett,8,0,32,24
1656195414267,MATH 142A,A03,093480,Staff,5,0,32,27
1656195414267,MATH 142A,B03,093481,Staff,3,0,32,29
1656195414267,MATH 142A,B04,093558,Staff,6,0,32,26
1656195414267,MATH 142A,B05,093559,Staff,1,0,32,31
1656195420290,MATH 193A,A01,083224,Rotar; Vladimir,0,1,34,34
1656195420290,MATH 193A,A02,083225,Rotar; Vladimir,0,0,34,34
1656195420290,MATH 193A,A03,083781,Rotar; Vladimir,1,0,34,33
1656195420290,MATH 193A,A04,083782,Rotar; Vladimir,6,0,34,28
1656195420290,MATH 193A,A05,093482,Rotar; Vladimir,0,0,34,34
1656195426313,MATH 197,001,091859,McAuley; Julian John,9999,0,9999,0
1656195426313,MATH 197,002,095566,Kedlaya; Kiran S.,9997,0,9999,2
1656195426313,MATH 197,003,095567,Xiao; Ming,9999,0,9999,0
1656195426313,MATH 197,004,095571,Perols; Johan Lars,9998,0,9999,1
1656195433368,COGS 9,A01,083615,Shannon; Kyle Michael,4,0,75,71
1656195439391,COGS 11,A01,083617,Boyle; Mary E. T.,14,0,48,34
1656195445415,COGS 13,A01,083071,Bastos; Amalia Pinkusfeld,4,0,71,67
1656195451441,COGS 14A,A01,092681,Semenuks; Arturs,4,15,100,96
1656195457473,COGS 14B,A01,083073,Cheng; Tzu-Han,7,0,63,56
1656195463495,COGS 17,A01,092677,Semenuks; Arturs,7,0,81,74
1656195469517,COGS 100,A01,083619,Allen; Michael Gordon,2,0,70,68
1656195475549,COGS 101A,A01,083621,Davis; Joshua Daniel,4,0,68,64
1656195481570,COGS 101B,A01,091572,Allen; Michael Gordon,5,0,65,60
1656195487593,COGS 101C,A01,083625,Delgado; Tania,10,0,35,25
1656195493617,COGS 107A,A01,083627,Boyle; Mary E. T.,0,0,60,60
1656195499644,COGS 118A,A01,083075,Gupta; Anjum,7,0,76,69
1656195505668,CSE 3,A50,083646,Miranda; Gregory Joseph,18,0,50,32
1656195511689,CSE 8A,A50,083650,Miranda; Gregory Joseph,3,3,56,53
1656195517716,CSE 11,A01,083080,Cao; Yingjun,1,52,40,39
1656195523744,CSE 12,A01,083652,Krause-Levy; Sophia Louisa,7,3,120,113
1656195529775,CSE 15L,A01,083654,Morris; Justin Loren,2,0,50,48
1656195529775,CSE 15L,A02,083655,Morris; Justin Loren,4,0,50,46
1656195535801,CSE 20,A01,083657,Tran; Khoa Dang,30,0,80,50
1656195541825,CSE 21,A01,095574,Bach; Quang Tran,24,0,48,24
1656195547847,CSE 30,A01,083084,Eldon; John,2,8,80,78
1656195547847,CSE 30,B01,095061,Bhaskar; Nishant,1,2,50,49
1656195553873,CSE 100,A01,083659,Cao; Yingjun,2,20,70,68
1656195559898,CSE 134B,A01,083661,Powell; Thomas Allan,3,0,100,97
1656195565924,CSE 140,A01,083663,Gungor; Onat,9,0,85,76
1656195571948,CSE 140L,A01,083088,Eldon; John,8,0,100,92
1656195577971,CSE 175,A01,083665,Kumar; Rakesh,0,0,25,25
1656195583994,CSE 190,A00,092507,Dubnov; Shlomo,2,0,20,18
1656195590020,ECE 45,A01,083139,Congero; Spencer William,1,0,75,74
1656195596045,ECE 65,A50,083695,Saad; Andrew S,9,0,30,21
1656195596045,ECE 65,A51,095125,Staff,23,0,26,3
1656195602073,ECE 109,A01,091882,Touri; Behrouz,0,1,70,70
1656195608106,ECE 180,A00,083140,Abi Samra; Nicholas Camill,1,0,30,29
1656195608106,ECE 180,B00,083141,Abi Samra; Nicholas Camill,0,4,30,30
1656195614131,MATH 10A,A01,083735,Patchell; Gregory David,0,0,30,30
1656195614131,MATH 10A,A02,083736,Patchell; Gregory David,22,0,30,8
1656195614131,MATH 10A,A03,083737,Patchell; Gregory David,16,0,30,14
1656195620160,MATH 10B,A01,083207,Lim; Seonhee,0,0,34,34
1656195620160,MATH 10B,A02,083208,Lim; Seonhee,7,0,35,28
1656195620160,MATH 10B,A03,093472,Staff,1,0,34,33
1656195620160,MATH 10B,B01,083739,Sinha; Shubham,11,0,30,19
1656195626184,MATH 18,A01,083743,Cinel; Cameron Alexander,7,0,30,23
1656195626184,MATH 18,A02,083744,Cinel; Cameron Alexander,10,0,30,20
1656195626184,MATH 18,A03,083745,Cinel; Cameron Alexander,4,0,30,26
1656195626184,MATH 18,B01,083748,Rideout; David Porter,1,0,36,35
1656195626184,MATH 18,B02,083749,Rideout; David Porter,0,0,36,36
1656195626184,MATH 18,B03,083750,Rideout; David Porter,0,0,36,36
1656195626184,MATH 18,B04,083751,Rideout; David Porter,0,0,36,36
1656195626184,MATH 18,B05,093473,Rideout; David Porter,0,0,36,36
1656195626184,MATH 18,B06,093474,Rideout; David Porter,2,0,36,34
1656195632207,MATH 20A,A01,083754,Zheng; Zequn,11,0,40,29
1656195638234,MATH 20B,A01,083756,Briones; Jor-el Thomas Caparas,0,0,36,36
1656195638234,MATH 20B,A02,083757,Briones; Jor-el Thomas Caparas,0,0,36,36
1656195638234,MATH 20B,A03,093475,Staff,1,0,36,35
1656195644258,MATH 20C,A01,083760,Briones; Jor-el Thomas Caparas,0,0,35,35
1656195644258,MATH 20C,A02,083761,Briones; Jor-el Thomas Caparas,9,1,35,26
1656195644258,MATH 20C,A03,093476,Staff,0,0,35,35
1656195644258,MATH 20C,B01,083762,Bach; Quang Tran,1,0,30,29
1656195650282,MATH 20D,A01,083765,Tran; Brian Kha,1,0,30,29
1656195650282,MATH 20D,A02,083766,Tran; Brian Kha,0,1,30,30
1656195650282,MATH 20D,A03,083767,Tran; Brian Kha,2,0,30,28
1656195656310,MATH 20E,A01,083771,Ganguly; Soumya,3,0,32,29
1656195656310,MATH 20E,A02,083772,Ganguly; Soumya,0,0,32,32
1656195656310,MATH 20E,B01,083773,Ciotti; Benjamin,16,0,35,19
1656195656310,MATH 20E,B02,083774,Ciotti; Benjamin,15,0,35,20
1656195662333,MATH 103A,A01,083777,Greenfeld; Be'Eri,1,0,36,35
1656195662333,MATH 103A,A02,083778,Greenfeld; Be'Eri,1,0,36,35
1656195662333,MATH 103A,A03,093561,Staff,5,0,36,31
1656195662333,MATH 103A,B01,083779,Greenfeld; Be'Eri,9,1,36,27
1656195662333,MATH 103A,B02,083780,Greenfeld; Be'Eri,1,0,36,35
1656195662333,MATH 103A,B03,093562,Staff,0,0,36,36
1656195668363,MATH 105,A01,085443,Carter; Anne Toulson,5,1,35,30
1656195668363,MATH 105,A02,093477,Staff,13,0,35,22
1656195674387,MATH 109,A01,083213,Ganzberger; Geoffrey Michael,0,0,34,34
1656195674387,MATH 109,A02,083214,Ganzberger; Geoffrey Michael,0,0,34,34
1656195674387,MATH 109,A03,093478,Staff,1,0,34,33
1656195674387,MATH 109,B01,083215,Ganzberger; Geoffrey Michael,4,0,32,28
1656195674387,MATH 109,B02,083216,Ganzberger; Geoffrey Michael,1,0,32,31
1656195674387,MATH 109,B03,093479,Staff,4,0,32,28
1656195680416,MATH 142A,A01,083219,Chow; Bennett,1,0,32,31
1656195680416,MATH 142A,A02,083220,Chow; Bennett,8,0,32,24
1656195680416,MATH 142A,A03,093480,Staff,5,0,32,27
1656195680416,MATH 142A,B03,093481,Staff,3,0,32,29
1656195680416,MATH 142A,B04,093558,Staff,6,0,32,26
1656195680416,MATH 142A,B05,093559,Staff,1,0,32,31
1656195686440,MATH 193A,A01,083224,Rotar; Vladimir,0,1,34,34
1656195686440,MATH 193A,A02,083225,Rotar; Vladimir,0,0,34,34
1656195686440,MATH 193A,A03,083781,Rotar; Vladimir,1,0,34,33
1656195686440,MATH 193A,A04,083782,Rotar; Vladimir,6,0,34,28
1656195686440,MATH 193A,A05,093482,Rotar; Vladimir,0,0,34,34
1656195692464,MATH 197,001,091859,McAuley; Julian John,9999,0,9999,0
1656195692464,MATH 197,002,095566,Kedlaya; Kiran S.,9997,0,9999,2
1656195692464,MATH 197,003,095567,Xiao; Ming,9999,0,9999,0
1656195692464,MATH 197,004,095571,Perols; Johan Lars,9998,0,9999,1
1656195699527,COGS 9,A01,083615,Shannon; Kyle Michael,4,0,75,71
1656195705551,COGS 11,A01,083617,Boyle; Mary E. T.,14,0,48,34
1656195711583,COGS 13,A01,083071,Bastos; Amalia Pinkusfeld,4,0,71,67
1656195717607,COGS 14A,A01,092681,Semenuks; Arturs,4,15,100,96
1656195723632,COGS 14B,A01,083073,Cheng; Tzu-Han,7,0,63,56
1656195729667,COGS 17,A01,092677,Semenuks; Arturs,7,0,81,74
1656195735694,COGS 100,A01,083619,Allen; Michael Gordon,2,0,70,68
1656195741719,COGS 101A,A01,083621,Davis; Joshua Daniel,4,0,68,64
1656195747742,COGS 101B,A01,091572,Allen; Michael Gordon,5,0,65,60
1656195753764,COGS 101C,A01,083625,Delgado; Tania,10,0,35,25
1656195759787,COGS 107A,A01,083627,Boyle; Mary E. T.,0,0,60,60
1656195765823,COGS 118A,A01,083075,Gupta; Anjum,7,0,76,69
1656195771856,CSE 3,A50,083646,Miranda; Gregory Joseph,18,0,50,32
1656195777950,CSE 8A,A50,083650,Miranda; Gregory Joseph,3,3,56,53
1656195783977,CSE 11,A01,083080,Cao; Yingjun,1,52,40,39
1656195790008,CSE 12,A01,083652,Krause-Levy; Sophia Louisa,7,3,120,113
1656195796032,CSE 15L,A01,083654,Morris; Justin Loren,2,0,50,48
1656195796032,CSE 15L,A02,083655,Morris; Justin Loren,4,0,50,46
1656195802058,CSE 20,A01,083657,Tran; Khoa Dang,30,0,80,50
1656195808082,CSE 21,A01,095574,Bach; Quang Tran,24,0,48,24
1656195814103,CSE 30,A01,083084,Eldon; John,2,8,80,78
1656195814103,CSE 30,B01,095061,Bhaskar; Nishant,1,2,50,49
1656195820128,CSE 100,A01,083659,Cao; Yingjun,2,20,70,68
1656195826151,CSE 134B,A01,083661,Powell; Thomas Allan,3,0,100,97
1656195832174,CSE 140,A01,083663,Gungor; Onat,9,0,85,76
1656195838202,CSE 140L,A01,083088,Eldon; John,8,0,100,92
1656195844230,CSE 175,A01,083665,Kumar; Rakesh,0,0,25,25
1656195850256,CSE 190,A00,092507,Dubnov; Shlomo,2,0,20,18
1656195856280,ECE 45,A01,083139,Congero; Spencer William,1,0,75,74
1656195862314,ECE 65,A50,083695,Saad; Andrew S,9,0,30,21
1656195862314,ECE 65,A51,095125,Staff,23,0,26,3
1656195868337,ECE 109,A01,091882,Touri; Behrouz,0,1,70,70
1656195874364,ECE 180,A00,083140,Abi Samra; Nicholas Camill,1,0,30,29
1656195874364,ECE 180,B00,083141,Abi Samra; Nicholas Camill,0,4,30,30
1656195880392,MATH 10A,A01,083735,Patchell; Gregory David,0,0,30,30
1656195880392,MATH 10A,A02,083736,Patchell; Gregory David,22,0,30,8
1656195880392,MATH 10A,A03,083737,Patchell; Gregory David,16,0,30,14
1656195886421,MATH 10B,A01,083207,Lim; Seonhee,0,0,34,34
1656195886421,MATH 10B,A02,083208,Lim; Seonhee,7,0,35,28
1656195886421,MATH 10B,A03,093472,Staff,1,0,34,33
1656195886421,MATH 10B,B01,083739,Sinha; Shubham,11,0,30,19
1656195892453,MATH 18,A01,083743,Cinel; Cameron Alexander,7,0,30,23
1656195892453,MATH 18,A02,083744,Cinel; Cameron Alexander,10,0,30,20
1656195892453,MATH 18,A03,083745,Cinel; Cameron Alexander,4,0,30,26
1656195892453,MATH 18,B01,083748,Rideout; David Porter,1,0,36,35
1656195892453,MATH 18,B02,083749,Rideout; David Porter,0,0,36,36
1656195892453,MATH 18,B03,083750,Rideout; David Porter,0,0,36,36
1656195892453,MATH 18,B04,083751,Rideout; David Porter,0,0,36,36
1656195892453,MATH 18,B05,093473,Rideout; David Porter,0,0,36,36
1656195892453,MATH 18,B06,093474,Rideout; David Porter,2,0,36,34
1656195898474,MATH 20A,A01,083754,Zheng; Zequn,11,0,40,29
1656195904498,MATH 20B,A01,083756,Briones; Jor-el Thomas Caparas,0,0,36,36
1656195904498,MATH 20B,A02,083757,Briones; Jor-el Thomas Caparas,0,0,36,36
1656195904498,MATH 20B,A03,093475,Staff,1,0,36,35
1656195910522,MATH 20C,A01,083760,Briones; Jor-el Thomas Caparas,0,0,35,35
1656195910522,MATH 20C,A02,083761,Briones; Jor-el Thomas Caparas,9,1,35,26
1656195910522,MATH 20C,A03,093476,Staff,0,0,35,35
1656195910522,MATH 20C,B01,083762,Bach; Quang Tran,1,0,30,29
1656195916544,MATH 20D,A01,083765,Tran; Brian Kha,1,0,30,29
1656195916544,MATH 20D,A02,083766,Tran; Brian Kha,0,1,30,30
1656195916544,MATH 20D,A03,083767,Tran; Brian Kha,2,0,30,28
1656195922568,MATH 20E,A01,083771,Ganguly; Soumya,3,0,32,29
1656195922568,MATH 20E,A02,083772,Ganguly; Soumya,0,0,32,32
1656195922568,MATH 20E,B01,083773,Ciotti; Benjamin,16,0,35,19
1656195922568,MATH 20E,B02,083774,Ciotti; Benjamin,15,0,35,20
1656195928598,MATH 103A,A01,083777,Greenfeld; Be'Eri,1,0,36,35
1656195928598,MATH 103A,A02,083778,Greenfeld; Be'Eri,1,0,36,35
1656195928598,MATH 103A,A03,093561,Staff,5,0,36,31
1656195928598,MATH 103A,B01,083779,Greenfeld; Be'Eri,9,1,36,27
1656195928598,MATH 103A,B02,083780,Greenfeld; Be'Eri,1,0,36,35
1656195928598,MATH 103A,B03,093562,Staff,0,0,36,36
1656195934623,MATH 105,A01,085443,Carter; Anne Toulson,5,1,35,30
1656195934623,MATH 105,A02,093477,Staff,13,0,35,22
1656195940649,MATH 109,A01,083213,Ganzberger; Geoffrey Michael,0,0,34,34
1656195940649,MATH 109,A02,083214,Ganzberger; Geoffrey Michael,0,0,34,34
1656195940649,MATH 109,A03,093478,Staff,1,0,34,33
1656195940649,MATH 109,B01,083215,Ganzberger; Geoffrey Michael,4,0,32,28
1656195940649,MATH 109,B02,083216,Ganzberger; Geoffrey Michael,1,0,32,31
1656195940649,MATH 109,B03,093479,Staff,4,0,32,28
1656195946679,MATH 142A,A01,083219,Chow; Bennett,1,0,32,31
1656195946679,MATH 142A,A02,083220,Chow; Bennett,8,0,32,24
1656195946679,MATH 142A,A03,093480,Staff,5,0,32,27
1656195946679,MATH 142A,B03,093481,Staff,3,0,32,29
1656195946679,MATH 142A,B04,093558,Staff,6,0,32,26
1656195946679,MATH 142A,B05,093559,Staff,1,0,32,31
1656195952703,MATH 193A,A01,083224,Rotar; Vladimir,0,1,34,34
1656195952703,MATH 193A,A02,083225,Rotar; Vladimir,0,0,34,34
1656195952703,MATH 193A,A03,083781,Rotar; Vladimir,1,0,34,33
1656195952703,MATH 193A,A04,083782,Rotar; Vladimir,6,0,34,28
1656195952703,MATH 193A,A05,093482,Rotar; Vladimir,0,0,34,34
1656195958726,MATH 197,001,091859,McAuley; Julian John,9999,0,9999,0
1656195958726,MATH 197,002,095566,Kedlaya; Kiran S.,9997,0,9999,2
1656195958726,MATH 197,003,095567,Xiao; Ming,9999,0,9999,0
1656195958726,MATH 197,004,095571,Perols; Johan Lars,9998,0,9999,1
1656195965782,COGS 9,A01,083615,Shannon; Kyle Michael,4,0,75,71
1656195971809,COGS 11,A01,083617,Boyle; Mary E. T.,14,0,48,34
1656195977831,COGS 13,A01,083071,Bastos; Amalia Pinkusfeld,4,0,71,67
1656195983855,COGS 14A,A01,092681,Semenuks; Arturs,4,15,100,96
1656195989879,COGS 14B,A01,083073,Cheng; Tzu-Han,7,0,63,56
1656195995907,COGS 17,A01,092677,Semenuks; Arturs,7,0,81,74
1656196001930,COGS 100,A01,083619,Allen; Michael Gordon,2,0,70,68
1656196007952,COGS 101A,A01,083621,Davis; Joshua Daniel,4,0,68,64
1656196013975,COGS 101B,A01,091572,Allen; Michael Gordon,5,0,65,60
1656196019999,COGS 101C,A01,083625,Delgado; Tania,10,0,35,25
1656196026026,COGS 107A,A01,083627,Boyle; Mary E. T.,0,0,60,60
1656196032051,COGS 118A,A01,083075,Gupta; Anjum,7,0,76,69
1656196038083,CSE 3,A50,083646,Miranda; Gregory Joseph,18,0,50,32
1656196044107,CSE 8A,A50,083650,Miranda; Gregory Joseph,3,3,56,53
1656196050129,CSE 11,A01,083080,Cao; Yingjun,1,52,40,39
1656196056157,CSE 12,A01,083652,Krause-Levy; Sophia Louisa,7,3,120,113
1656196062189,CSE 15L,A01,083654,Morris; Justin Loren,2,0,50,48
1656196062189,CSE 15L,A02,083655,Morris; Justin Loren,4,0,50,46
1656196068212,CSE 20,A01,083657,Tran; Khoa Dang,30,0,80,50
1656196074238,CSE 21,A01,095574,Bach; Quang Tran,24,0,48,24
1656196080266,CSE 30,A01,083084,Eldon; John,2,8,80,78
1656196080266,CSE 30,B01,095061,Bhaskar; Nishant,1,2,50,49
1656196086295,CSE 100,A01,083659,Cao; Yingjun,2,20,70,68
1656196092319,CSE 134B,A01,083661,Powell; Thomas Allan,3,0,100,97
1656196098341,CSE 140,A01,083663,Gungor; Onat,9,0,85,76
1656196104367,CSE 140L,A01,083088,Eldon; John,8,0,100,92
1656196110396,CSE 175,A01,083665,Kumar; Rakesh,0,0,25,25
1656196116419,CSE 190,A00,092507,Dubnov; Shlomo,2,0,20,18
1656196122443,ECE 45,A01,083139,Congero; Spencer William,1,0,75,74
1656196128465,ECE 65,A50,083695,Saad; Andrew S,9,0,30,21
1656196128465,ECE 65,A51,095125,Staff,23,0,26,3
1656196134489,ECE 109,A01,091882,Touri; Behrouz,0,1,70,70
1656196140511,ECE 180,A00,083140,Abi Samra; Nicholas Camill,1,0,30,29
1656196140511,ECE 180,B00,083141,Abi Samra; Nicholas Camill,0,4,30,30
1656196146539,MATH 10A,A01,083735,Patchell; Gregory David,0,0,30,30
1656196146539,MATH 10A,A02,083736,Patchell; Gregory David,22,0,30,8
1656196146539,MATH 10A,A03,083737,Patchell; Gregory David,16,0,30,14
1656196152563,MATH 10B,A01,083207,Lim; Seonhee,0,0,34,34
1656196152563,MATH 10B,A02,083208,Lim; Seonhee,7,0,35,28
1656196152563,MATH 10B,A03,093472,Staff,1,0,34,33
1656196152563,MATH 10B,B01,083739,Sinha; Shubham,11,0,30,19
1656196158588,MATH 18,A01,083743,Cinel; Cameron Alexander,7,0,30,23
1656196158588,MATH 18,A02,083744,Cinel; Cameron Alexander,10,0,30,20
1656196158588,MATH 18,A03,083745,Cinel; Cameron Alexander,4,0,30,26
1656196158588,MATH 18,B01,083748,Rideout; David Porter,1,0,36,35
1656196158588,MATH 18,B02,083749,Rideout; David Porter,0,0,36,36
1656196158588,MATH 18,B03,083750,Rideout; David Porter,0,0,36,36
1656196158588,MATH 18,B04,083751,Rideout; David Porter,0,0,36,36
1656196158588,MATH 18,B05,093473,Rideout; David Porter,0,0,36,36
1656196158588,MATH 18,B06,093474,Rideout; David Porter,2,0,36,34
1656196164612,MATH 20A,A01,083754,Zheng; Zequn,11,0,40,29
1656196170641,MATH 20B,A01,083756,Briones; Jor-el Thomas Caparas,0,0,36,36
1656196170641,MATH 20B,A02,083757,Briones; Jor-el Thomas Caparas,0,0,36,36
1656196170641,MATH 20B,A03,093475,Staff,1,0,36,35
1656196176666,MATH 20C,A01,083760,Briones; Jor-el Thomas Caparas,0,0,35,35
1656196176666,MATH 20C,A02,083761,Briones; Jor-el Thomas Caparas,9,1,35,26
1656196176666,MATH 20C,A03,093476,Staff,0,0,35,35
1656196176666,MATH 20C,B01,083762,Bach; Quang Tran,1,0,30,29
1656196182695,MATH 20D,A01,083765,Tran; Brian Kha,1,0,30,29
1656196182695,MATH 20D,A02,083766,Tran; Brian Kha,0,1,30,30
1656196182695,MATH 20D,A03,083767,Tran; Brian Kha,2,0,30,28
1656196188724,MATH 20E,A01,083771,Ganguly; Soumya,3,0,32,29
1656196188724,MATH 20E,A02,083772,Ganguly; Soumya,0,0,32,32
1656196188724,MATH 20E,B01,083773,Ciotti; Benjamin,16,0,35,19
1656196188724,MATH 20E,B02,083774,Ciotti; Benjamin,15,0,35,20
1656196194750,MATH 103A,A01,083777,Greenfeld; Be'Eri,1,0,36,35
1656196194750,MATH 103A,A02,083778,Greenfeld; Be'Eri,1,0,36,35
1656196194750,MATH 103A,A03,093561,Staff,5,0,36,31
1656196194750,MATH 103A,B01,083779,Greenfeld; Be'Eri,9,1,36,27
1656196194750,MATH 103A,B02,083780,Greenfeld; Be'Eri,1,0,36,35
1656196194750,MATH 103A,B03,093562,Staff,0,0,36,36
1656196200772,MATH 105,A01,085443,Carter; Anne Toulson,5,1,35,30
1656196200772,MATH 105,A02,093477,Staff,13,0,35,22
1656196206796,MATH 109,A01,083213,Ganzberger; Geoffrey Michael,0,0,34,34
1656196206796,MATH 109,A02,083214,Ganzberger; Geoffrey Michael,0,0,34,34
1656196206796,MATH 109,A03,093478,Staff,1,0,34,33
1656196206796,MATH 109,B01,083215,Ganzberger; Geoffrey Michael,4,0,32,28
1656196206796,MATH 109,B02,083216,Ganzberger; Geoffrey Michael,1,0,32,31
1656196206796,MATH 109,B03,093479,Staff,4,0,32,28
1656196212826,MATH 142A,A01,083219,Chow; Bennett,1,0,32,31
1656196212826,MATH 142A,A02,083220,Chow; Bennett,8,0,32,24
1656196212826,MATH 142A,A03,093480,Staff,5,0,32,27
1656196212826,MATH 142A,B03,093481,Staff,3,0,32,29
1656196212826,MATH 142A,B04,093558,Staff,6,0,32,26
1656196212826,MATH 142A,B05,093559,Staff,1,0,32,31
1656196218849,MATH 193A,A01,083224,Rotar; Vladimir,0,1,34,34
1656196218849,MATH 193A,A02,083225,Rotar; Vladimir,0,0,34,34
1656196218849,MATH 193A,A03,083781,Rotar; Vladimir,1,0,34,33
1656196218849,MATH 193A,A04,083782,Rotar; Vladimir,6,0,34,28
1656196218849,MATH 193A,A05,093482,Rotar; Vladimir,0,0,34,34
1656196224876,MATH 197,001,091859,McAuley; Julian John,9999,0,9999,0
1656196224876,MATH 197,002,095566,Kedlaya; Kiran S.,9997,0,9999,2
1656196224876,MATH 197,003,095567,Xiao; Ming,9999,0,9999,0
1656196224876,MATH 197,004,095571,Perols; Johan Lars,9998,0,9999,1
1656196231937,COGS 9,A01,083615,Shannon; Kyle Michael,4,0,75,71
1656196237963,COGS 11,A01,083617,Boyle; Mary E. T.,14,0,48,34
1656196243991,COGS 13,A01,083071,Bastos; Amalia Pinkusfeld,4,0,71,67
1656196250012,COGS 14A,A01,092681,Semenuks; Arturs,4,15,100,96
1656196256039,COGS 14B,A01,083073,Cheng; Tzu-Han,7,0,63,56
1656196262063,COGS 17,A01,092677,Semenuks; Arturs,7,0,81,74
1656196268088,COGS 100,A01,083619,Allen; Michael Gordon,2,0,70,68
1656196274112,COGS 101A,A01,083621,Davis; Joshua Daniel,4,0,68,64
1656196280135,COGS 101B,A01,091572,Allen; Michael Gordon,5,0,65,60
1656196286159,COGS 101C,A01,083625,Delgado; Tania,10,0,35,25
1656196292184,COGS 107A,A01,083627,Boyle; Mary E. T.,0,0,60,60
1656196298212,COGS 118A,A01,083075,Gupta; Anjum,7,0,76,69
1656196304236,CSE 3,A50,083646,Miranda; Gregory Joseph,18,0,50,32
1656196310264,CSE 8A,A50,083650,Miranda; Gregory Joseph,3,3,56,53
1656196316292,CSE 11,A01,083080,Cao; Yingjun,1,52,40,39
1656196322322,CSE 12,A01,083652,Krause-Levy; Sophia Louisa,7,3,120,113
1656196328348,CSE 15L,A01,083654,Morris; Justin Loren,2,0,50,48
1656196328348,CSE 15L,A02,083655,Morris; Justin Loren,4,0,50,46
1656196334376,CSE 20,A01,083657,Tran; Khoa Dang,30,0,80,50
1656196340403,CSE 21,A01,095574,Bach; Quang Tran,24,0,48,24
1656196346428,CSE 30,A01,083084,Eldon; John,2,8,80,78
1656196346428,CSE 30,B01,095061,Bhaskar; Nishant,1,2,50,49
1656196352451,CSE 100,A01,083659,Cao; Yingjun,2,20,70,68
1656196358475,CSE 134B,A01,083661,Powell; Thomas Allan,3,0,100,97
1656196364507,CSE 140,A01,083663,Gungor; Onat,9,0,85,76
1656196370530,CSE 140L,A01,083088,Eldon; John,8,0,100,92
1656196376629,CSE 175,A01,083665,Kumar; Rakesh,0,0,25,25
1656196382655,CSE 190,A00,092507,Dubnov; Shlomo,2,0,20,18
1656196388678,ECE 45,A01,083139,Congero; Spencer William,1,0,75,74
1656196394705,ECE 65,A50,083695,Saad; Andrew S,9,0,30,21
1656196394705,ECE 65,A51,095125,Staff,23,0,26,3
1656196400741,ECE 109,A01,091882,Touri; Behrouz,0,1,70,70
1656196406767,ECE 180,A00,083140,Abi Samra; Nicholas Camill,1,0,30,29
1656196406767,ECE 180,B00,083141,Abi Samra; Nicholas Camill,0,4,30,30
1656196412791,MATH 10A,A01,083735,Patchell; Gregory David,0,0,30,30
1656196412791,MATH 10A,A02,083736,Patchell; Gregory David,22,0,30,8
1656196412791,MATH 10A,A03,083737,Patchell; Gregory David,16,0,30,14
1656196418814,MATH 10B,A01,083207,Lim; Seonhee,0,0,34,34
1656196418814,MATH 10B,A02,083208,Lim; Seonhee,7,0,35,28
1656196418814,MATH 10B,A03,093472,Staff,1,0,34,33
1656196418814,MATH 10B,B01,083739,Sinha; Shubham,11,0,30,19
1656196424840,MATH 18,A01,083743,Cinel; Cameron Alexander,7,0,30,23
1656196424840,MATH 18,A02,083744,Cinel; Cameron Alexander,10,0,30,20
1656196424840,MATH 18,A03,083745,Cinel; Cameron Alexander,4,0,30,26
1656196424840,MATH 18,B01,083748,Rideout; David Porter,1,0,36,35
1656196424840,MATH 18,B02,083749,Rideout; David Porter,0,0,36,36
1656196424840,MATH 18,B03,083750,Rideout; David Porter,0,0,36,36
1656196424840,MATH 18,B04,083751,Rideout; David Porter,0,0,36,36
1656196424840,MATH 18,B05,093473,Rideout; David Porter,0,0,36,36
1656196424840,MATH 18,B06,093474,Rideout; David Porter,2,0,36,34
1656196430863,MATH 20A,A01,083754,Zheng; Zequn,11,0,40,29
1656196436887,MATH 20B,A01,083756,Briones; Jor-el Thomas Caparas,0,0,36,36
1656196436887,MATH 20B,A02,083757,Briones; Jor-el Thomas Caparas,0,0,36,36
1656196436887,MATH 20B,A03,093475,Staff,1,0,36,35
1656196442918,MATH 20C,A01,083760,Briones; Jor-el Thomas Caparas,0,0,35,35
1656196442918,MATH 20C,A02,083761,Briones; Jor-el Thomas Caparas,9,1,35,26
1656196442918,MATH 20C,A03,093476,Staff,0,0,35,35
1656196442918,MATH 20C,B01,083762,Bach; Quang Tran,1,0,30,29
1656196448946,MATH 20D,A01,083765,Tran; Brian Kha,1,0,30,29
1656196448946,MATH 20D,A02,083766,Tran; Brian Kha,0,1,30,30
1656196448946,MATH 20D,A03,083767,Tran; Brian Kha,2,0,30,28
1656196454969,MATH 20E,A01,083771,Ganguly; Soumya,3,0,32,29
1656196454969,MATH 20E,A02,083772,Ganguly; Soumya,0,0,32,32
1656196454969,MATH 20E,B01,083773,Ciotti; Benjamin,16,0,35,19
1656196454969,MATH 20E,B02,083774,Ciotti; Benjamin,15,0,35,20
1656196460994,MATH 103A,A01,083777,Greenfeld; Be'Eri,1,0,36,35
1656196460994,MATH 103A,A02,083778,Greenfeld; Be'Eri,1,0,36,35
1656196460994,MATH 103A,A03,093561,Staff,5,0,36,31
1656196460994,MATH 103A,B01,083779,Greenfeld; Be'Eri,9,1,36,27
1656196460994,MATH 103A,B02,083780,Greenfeld; Be'Eri,1,0,36,35
1656196460994,MATH 103A,B03,093562,Staff,0,0,36,36
1656196467018,MATH 105,A01,085443,Carter; Anne Toulson,5,1,35,30
1656196467018,MATH 105,A02,093477,Staff,13,0,35,22
1656196473041,MATH 109,A01,083213,Ganzberger; Geoffrey Michael,0,0,34,34
1656196473041,MATH 109,A02,083214,Ganzberger; Geoffrey Michael,0,0,34,34
1656196473041,MATH 109,A03,093478,Staff,1,0,34,33
1656196473041,MATH 109,B01,083215,Ganzberger; Geoffrey Michael,4,0,32,28
1656196473041,MATH 109,B02,083216,Ganzberger; Geoffrey Michael,1,0,32,31
1656196473041,MATH 109,B03,093479,Staff,4,0,32,28
1656196479066,MATH 142A,A01,083219,Chow; Bennett,1,0,32,31
1656196479066,MATH 142A,A02,083220,Chow; Bennett,8,0,32,24
1656196479066,MATH 142A,A03,093480,Staff,5,0,32,27
1656196479066,MATH 142A,B03,093481,Staff,3,0,32,29
1656196479066,MATH 142A,B04,093558,Staff,6,0,32,26
1656196479066,MATH 142A,B05,093559,Staff,1,0,32,31
1656196485091,MATH 193A,A01,083224,Rotar; Vladimir,0,1,34,34
1656196485091,MATH 193A,A02,083225,Rotar; Vladimir,0,0,34,34
1656196485091,MATH 193A,A03,083781,Rotar; Vladimir,1,0,34,33
1656196485091,MATH 193A,A04,083782,Rotar; Vladimir,6,0,34,28
1656196485091,MATH 193A,A05,093482,Rotar; Vladimir,0,0,34,34
1656196491113,MATH 197,001,091859,McAuley; Julian John,9999,0,9999,0
1656196491113,MATH 197,002,095566,Kedlaya; Kiran S.,9997,0,9999,2
1656196491113,MATH 197,003,095567,Xiao; Ming,9999,0,9999,0
1656196491113,MATH 197,004,095571,Perols; Johan Lars,9998,0,9999,1
1656196498167,COGS 9,A01,083615,Shannon; Kyle Michael,4,0,75,71
1656196504201,COGS 11,A01,083617,Boyle; Mary E. T.,14,0,48,34
1656196510225,COGS 13,A01,083071,Bastos; Amalia Pinkusfeld,4,0,71,67
1656196516248,COGS 14A,A01,092681,Semenuks; Arturs,4,15,100,96
1656196522271,COGS 14B,A01,083073,Cheng; Tzu-Han,7,0,63,56
1656196528294,COGS 17,A01,092677,Semenuks; Arturs,7,0,81,74
1656196534317,COGS 100,A01,083619,Allen; Michael Gordon,2,0,70,68
1656196540341,COGS 101A,A01,083621,Davis; Joshua Daniel,4,0,68,64
1656196546363,COGS 101B,A01,091572,Allen; Michael Gordon,5,0,65,60
1656196552389,COGS 101C,A01,083625,Delgado; Tania,10,0,35,25
1656196558412,COGS 107A,A01,083627,Boyle; Mary E. T.,0,0,60,60
1656196564435,COGS 118A,A01,083075,Gupta; Anjum,7,0,76,69
1656196570461,CSE 3,A50,083646,Miranda; Gregory Joseph,18,0,50,32
1656196576485,CSE 8A,A50,083650,Miranda; Gregory Joseph,3,3,56,53
1656196582506,CSE 11,A01,083080,Cao; Yingjun,1,52,40,39
1656196588529,CSE 12,A01,083652,Krause-Levy; Sophia Louisa,7,3,120,113
1656196594553,CSE 15L,A01,083654,Morris; Justin Loren,2,0,50,48
1656196594553,CSE 15L,A02,083655,Morris; Justin Loren,4,0,50,46
1656196600575,CSE 20,A01,083657,Tran; Khoa Dang,30,0,80,50
1656196606599,CSE 21,A01,095574,Bach; Quang Tran,24,0,48,24
1656196612622,CSE 30,A01,083084,Eldon; John,2,8,80,78
1656196612622,CSE 30,B01,095061,Bhaskar; Nishant,1,2,50,49
1656196618648,CSE 100,A01,083659,Cao; Yingjun,2,20,70,68
1656196624677,CSE 134B,A01,083661,Powell; Thomas Allan,3,0,100,97
1656196630700,CSE 140,A01,083663,Gungor; Onat,9,0,85,76
1656196636724,CSE 140L,A01,083088,Eldon; John,8,0,100,92
1656196642782,CSE 175,A01,083665,Kumar; Rakesh,0,0,25,25
1656196648815,CSE 190,A00,092507,Dubnov; Shlomo,2,0,20,18
1656196654843,ECE 45,A01,083139,Congero; Spencer William,1,0,75,74
1656196660868,ECE 65,A50,083695,Saad; Andrew S,9,0,30,21
1656196660868,ECE 65,A51,095125,Staff,23,0,26,3
1656196666891,ECE 109,A01,091882,Touri; Behrouz,0,1,70,70
1656196672913,ECE 180,A00,083140,Abi Samra; Nicholas Camill,1,0,30,29
1656196672913,ECE 180,B00,083141,Abi Samra; Nicholas Camill,0,4,30,30
1656196678937,MATH 10A,A01,083735,Patchell; Gregory David,0,0,30,30
1656196678937,MATH 10A,A02,083736,Patchell; Gregory David,22,0,30,8
1656196678937,MATH 10A,A03,083737,Patchell; Gregory David,16,0,30,14
1656196684966,MATH 10B,A01,083207,Lim; Seonhee,0,0,34,34
1656196684966,MATH 10B,A02,083208,Lim; Seonhee,7,0,35,28
1656196684966,MATH 10B,A03,093472,Staff,1,0,34,33
1656196684966,MATH 10B,B01,083739,Sinha; Shubham,11,0,30,19
1656196696129,MATH 18,A01,083743,Cinel; Cameron Alexander,7,0,30,23
1656196696129,MATH 18,A02,083744,Cinel; Cameron Alexander,10,0,30,20
1656196696129,MATH 18,A03,083745,Cinel; Cameron Alexander,4,0,30,26
1656196696129,MATH 18,B01,083748,Rideout; David Porter,1,0,36,35
1656196696129,MATH 18,B02,083749,Rideout; David Porter,0,0,36,36
1656196696129,MATH 18,B03,083750,Rideout; David Porter,0,0,36,36
1656196696129,MATH 18,B04,083751,Rideout; David Porter,0,0,36,36
1656196696129,MATH 18,B05,093473,Rideout; David Porter,0,0,36,36
1656196696129,MATH 18,B06,093474,Rideout; David Porter,2,0,36,34
1656196702158,MATH 20A,A01,083754,Zheng; Zequn,11,0,40,29
1656196708194,MATH 20B,A01,083756,Briones; Jor-el Thomas Caparas,0,0,36,36
1656196708194,MATH 20B,A02,083757,Briones; Jor-el Thomas Caparas,0,0,36,36
1656196708194,MATH 20B,A03,093475,Staff,1,0,36,35
1656196714217,MATH 20C,A01,083760,Briones; Jor-el Thomas Caparas,0,0,35,35
1656196714217,MATH 20C,A02,083761,Briones; Jor-el Thomas Caparas,9,1,35,26
1656196714217,MATH 20C,A03,093476,Staff,0,0,35,35
1656196714217,MATH 20C,B01,083762,Bach; Quang Tran,1,0,30,29
1656196720243,MATH 20D,A01,083765,Tran; Brian Kha,1,0,30,29
1656196720243,MATH 20D,A02,083766,Tran; Brian Kha,0,1,30,30
1656196720243,MATH 20D,A03,083767,Tran; Brian Kha,2,0,30,28
1656196726268,MATH 20E,A01,083771,Ganguly; Soumya,3,0,32,29
1656196726268,MATH 20E,A02,083772,Ganguly; Soumya,0,0,32,32
1656196726268,MATH 20E,B01,083773,Ciotti; Benjamin,16,0,35,19
1656196726268,MATH 20E,B02,083774,Ciotti; Benjamin,15,0,35,20
1656196732296,MATH 103A,A01,083777,Greenfeld; Be'Eri,1,0,36,35
1656196732296,MATH 103A,A02,083778,Greenfeld; Be'Eri,1,0,36,35
1656196732296,MATH 103A,A03,093561,Staff,5,0,36,31
1656196732296,MATH 103A,B01,083779,Greenfeld; Be'Eri,9,1,36,27
1656196732296,MATH 103A,B02,083780,Greenfeld; Be'Eri,1,0,36,35
1656196732296,MATH 103A,B03,093562,Staff,0,0,36,36
1656196738319,MATH 105,A01,085443,Carter; Anne Toulson,5,1,35,30
1656196738319,MATH 105,A02,093477,Staff,13,0,35,22
1656196744342,MATH 109,A01,083213,Ganzberger; Geoffrey Michael,0,0,34,34
1656196744342,MATH 109,A02,083214,Ganzberger; Geoffrey Michael,0,0,34,34
1656196744342,MATH 109,A03,093478,Staff,1,0,34,33
1656196744342,MATH 109,B01,083215,Ganzberger; Geoffrey Michael,4,0,32,28
1656196744342,MATH 109,B02,083216,Ganzberger; Geoffrey Michael,1,0,32,31
1656196744342,MATH 109,B03,093479,Staff,4,0,32,28
1656196750365,MATH 142A,A01,083219,Chow; Bennett,1,0,32,31
1656196750365,MATH 142A,A02,083220,Chow; Bennett,8,0,32,24
1656196750365,MATH 142A,A03,093480,Staff,5,0,32,27
1656196750365,MATH 142A,B03,093481,Staff,3,0,32,29
1656196750365,MATH 142A,B04,093558,Staff,6,0,32,26
1656196750365,MATH 142A,B05,093559,Staff,1,0,32,31
1656196756392,MATH 193A,A01,083224,Rotar; Vladimir,0,1,34,34
1656196756392,MATH 193A,A02,083225,Rotar; Vladimir,0,0,34,34
1656196756392,MATH 193A,A03,083781,Rotar; Vladimir,1,0,34,33
1656196756392,MATH 193A,A04,083782,Rotar; Vladimir,6,0,34,28
1656196756392,MATH 193A,A05,093482,Rotar; Vladimir,0,0,34,34
1656196762416,MATH 197,001,091859,McAuley; Julian John,9999,0,9999,0
1656196762416,MATH 197,002,095566,Kedlaya; Kiran S.,9997,0,9999,2
1656196762416,MATH 197,003,095567,Xiao; Ming,9999,0,9999,0
1656196762416,MATH 197,004,095571,Perols; Johan Lars,9998,0,9999,1
1656196769475,COGS 9,A01,083615,Shannon; Kyle Michael,4,0,75,71
1656196775497,COGS 11,A01,083617,Boyle; Mary E. T.,14,0,48,34
1656196781521,COGS 13,A01,083071,Bastos; Amalia Pinkusfeld,4,0,71,67
1656196787545,COGS 14A,A01,092681,Semenuks; Arturs,4,15,100,96
1656196793572,COGS 14B,A01,083073,Cheng; Tzu-Han,7,0,63,56
1656196799595,COGS 17,A01,092677,Semenuks; Arturs,7,0,81,74
1656196805617,COGS 100,A01,083619,Allen; Michael Gordon,2,0,70,68
1656196811646,COGS 101A,A01,083621,Davis; Joshua Daniel,4,0,68,64
1656196817668,COGS 101B,A01,091572,Allen; Michael Gordon,5,0,65,60
1656196823693,COGS 101C,A01,083625,Delgado; Tania,10,0,35,25
1656196829720,COGS 107A,A01,083627,Boyle; Mary E. T.,0,0,60,60
1656196835744,COGS 118A,A01,083075,Gupta; Anjum,7,0,76,69
1656196841771,CSE 3,A50,083646,Miranda; Gregory Joseph,18,0,50,32
1656196847795,CSE 8A,A50,083650,Miranda; Gregory Joseph,3,3,56,53
1656196853818,CSE 11,A01,083080,Cao; Yingjun,1,52,40,39
1656196859844,CSE 12,A01,083652,Krause-Levy; Sophia Louisa,7,3,120,113
1656196865872,CSE 15L,A01,083654,Morris; Justin Loren,2,0,50,48
1656196865872,CSE 15L,A02,083655,Morris; Justin Loren,4,0,50,46
1656196871894,CSE 20,A01,083657,Tran; Khoa Dang,30,0,80,50
1656196877920,CSE 21,A01,095574,Bach; Quang Tran,24,0,48,24
1656196883944,CSE 30,A01,083084,Eldon; John,2,8,80,78
1656196883944,CSE 30,B01,095061,Bhaskar; Nishant,1,2,50,49
1656196889967,CSE 100,A01,083659,Cao; Yingjun,2,20,70,68
1656196895989,CSE 134B,A01,083661,Powell; Thomas Allan,3,0,100,97
1656196902013,CSE 140,A01,083663,Gungor; Onat,9,0,85,76
1656196908038,CSE 140L,A01,083088,Eldon; John,8,0,100,92
1656196914066,CSE 175,A01,083665,Kumar; Rakesh,0,0,25,25
1656196920094,CSE 190,A00,092507,Dubnov; Shlomo,2,0,20,18
1656196926121,ECE 45,A01,083139,Congero; Spencer William,1,0,75,74
1656196932145,ECE 65,A50,083695,Saad; Andrew S,9,0,30,21
1656196932145,ECE 65,A51,095125,Staff,23,0,26,3
1656196938172,ECE 109,A01,091882,Touri; Behrouz,0,1,70,70
1656196944195,ECE 180,A00,083140,Abi Samra; Nicholas Camill,1,0,30,29
1656196944195,ECE 180,B00,083141,Abi Samra; Nicholas Camill,0,4,30,30
1656196950220,MATH 10A,A01,083735,Patchell; Gregory David,0,0,30,30
1656196950220,MATH 10A,A02,083736,Patchell; Gregory David,22,0,30,8
1656196950220,MATH 10A,A03,083737,Patchell; Gregory David,16,0,30,14
1656196956243,MATH 10B,A01,083207,Lim; Seonhee,0,0,34,34
1656196956243,MATH 10B,A02,083208,Lim; Seonhee,7,0,35,28
1656196956243,MATH 10B,A03,093472,Staff,1,0,34,33
1656196956243,MATH 10B,B01,083739,Sinha; Shubham,11,0,30,19
1656196962270,MATH 18,A01,083743,Cinel; Cameron Alexander,7,0,30,23
1656196962270,MATH 18,A02,083744,Cinel; Cameron Alexander,10,0,30,20
1656196962270,MATH 18,A03,083745,Cinel; Cameron Alexander,4,0,30,26
1656196962270,MATH 18,B01,083748,Rideout; David Porter,1,0,36,35
1656196962270,MATH 18,B02,083749,Rideout; David Porter,0,0,36,36
1656196962270,MATH 18,B03,083750,Rideout; David Porter,0,0,36,36
1656196962270,MATH 18,B04,083751,Rideout; David Porter,0,0,36,36
1656196962270,MATH 18,B05,093473,Rideout; David Porter,0,0,36,36
1656196962270,MATH 18,B06,093474,Rideout; David Porter,2,0,36,34
1656196968303,MATH 20A,A01,083754,Zheng; Zequn,11,0,40,29
1656196974328,MATH 20B,A01,083756,Briones; Jor-el Thomas Caparas,0,0,36,36
1656196974328,MATH 20B,A02,083757,Briones; Jor-el Thomas Caparas,0,0,36,36
1656196974328,MATH 20B,A03,093475,Staff,1,0,36,35
1656196980445,MATH 20C,A01,083760,Briones; Jor-el Thomas Caparas,0,0,35,35
1656196980445,MATH 20C,A02,083761,Briones; Jor-el Thomas Caparas,9,1,35,26
1656196980445,MATH 20C,A03,093476,Staff,0,0,35,35
1656196980445,MATH 20C,B01,083762,Bach; Quang Tran,1,0,30,29
1656196986469,MATH 20D,A01,083765,Tran; Brian Kha,1,0,30,29
1656196986469,MATH 20D,A02,083766,Tran; Brian Kha,0,1,30,30
1656196986469,MATH 20D,A03,083767,Tran; Brian Kha,2,0,30,28
1656196992491,MATH 20E,A01,083771,Ganguly; Soumya,3,0,32,29
1656196992491,MATH 20E,A02,083772,Ganguly; Soumya,0,0,32,32
1656196992491,MATH 20E,B01,083773,Ciotti; Benjamin,16,0,35,19
1656196992491,MATH 20E,B02,083774,Ciotti; Benjamin,15,0,35,20
1656196998520,MATH 103A,A01,083777,Greenfeld; Be'Eri,1,0,36,35
1656196998520,MATH 103A,A02,083778,Greenfeld; Be'Eri,1,0,36,35
1656196998520,MATH 103A,A03,093561,Staff,5,0,36,31
1656196998520,MATH 103A,B01,083779,Greenfeld; Be'Eri,9,1,36,27
1656196998520,MATH 103A,B02,083780,Greenfeld; Be'Eri,1,0,36,35
1656196998520,MATH 103A,B03,093562,Staff,0,0,36,36
1656197004547,MATH 105,A01,085443,Carter; Anne Toulson,5,1,35,30
1656197004547,MATH 105,A02,093477,Staff,13,0,35,22
1656197010571,MATH 109,A01,083213,Ganzberger; Geoffrey Michael,0,0,34,34
1656197010571,MATH 109,A02,083214,Ganzberger; Geoffrey Michael,0,0,34,34
1656197010571,MATH 109,A03,093478,Staff,1,0,34,33
1656197010571,MATH 109,B01,083215,Ganzberger; Geoffrey Michael,4,0,32,28
1656197010571,MATH 109,B02,083216,Ganzberger; Geoffrey Michael,1,0,32,31
1656197010571,MATH 109,B03,093479,Staff,4,0,32,28
1656197016601,MATH 142A,A01,083219,Chow; Bennett,1,0,32,31
1656197016601,MATH 142A,A02,083220,Chow; Bennett,8,0,32,24
1656197016601,MATH 142A,A03,093480,Staff,5,0,32,27
1656197016601,MATH 142A,B03,093481,Staff,3,0,32,29
1656197016601,MATH 142A,B04,093558,Staff,6,0,32,26
1656197016601,MATH 142A,B05,093559,Staff,1,0,32,31
1656197022628,MATH 193A,A01,083224,Rotar; Vladimir,0,1,34,34
1656197022628,MATH 193A,A02,083225,Rotar; Vladimir,0,0,34,34
1656197022628,MATH 193A,A03,083781,Rotar; Vladimir,1,0,34,33
1656197022628,MATH 193A,A04,083782,Rotar; Vladimir,6,0,34,28
1656197022628,MATH 193A,A05,093482,Rotar; Vladimir,0,0,34,34
1656197028651,MATH 197,001,091859,McAuley; Julian John,9999,0,9999,0
1656197028651,MATH 197,002,095566,Kedlaya; Kiran S.,9997,0,9999,2
1656197028651,MATH 197,003,095567,Xiao; Ming,9999,0,9999,0
1656197028651,MATH 197,004,095571,Perols; Johan Lars,9998,0,9999,1
1656197035729,COGS 9,A01,083615,Shannon; Kyle Michael,4,0,75,71
1656197041760,COGS 11,A01,083617,Boyle; Mary E. T.,14,0,48,34
1656197047786,COGS 13,A01,083071,Bastos; Amalia Pinkusfeld,4,0,71,67
1656197053809,COGS 14A,A01,092681,Semenuks; Arturs,4,15,100,96
1656197059832,COGS 14B,A01,083073,Cheng; Tzu-Han,7,0,63,56
1656197065855,COGS 17,A01,092677,Semenuks; Arturs,7,0,81,74
1656197071887,COGS 100,A01,083619,Allen; Michael Gordon,2,0,70,68
1656197077913,COGS 101A,A01,083621,Davis; Joshua Daniel,4,0,68,64
1656197083940,COGS 101B,A01,091572,Allen; Michael Gordon,5,0,65,60
1656197089968,COGS 101C,A01,083625,Delgado; Tania,10,0,35,25
1656197095994,COGS 107A,A01,083627,Boyle; Mary E. T.,0,0,60,60
1656197102017,COGS 118A,A01,083075,Gupta; Anjum,7,0,76,69
1656197108045,CSE 3,A50,083646,Miranda; Gregory Joseph,18,0,50,32
1656197114072,CSE 8A,A50,083650,Miranda; Gregory Joseph,3,3,56,53
1656197120096,CSE 11,A01,083080,Cao; Yingjun,1,52,40,39
1656197126124,CSE 12,A01,083652,Krause-Levy; Sophia Louisa,7,3,120,113
1656197132151,CSE 15L,A01,083654,Morris; Justin Loren,2,0,50,48
1656197132151,CSE 15L,A02,083655,Morris; Justin Loren,4,0,50,46
1656197138177,CSE 20,A01,083657,Tran; Khoa Dang,30,0,80,50
1656197144203,CSE 21,A01,095574,Bach; Quang Tran,24,0,48,24
1656197150227,CSE 30,A01,083084,Eldon; John,2,8,80,78
1656197150227,CSE 30,B01,095061,Bhaskar; Nishant,1,2,50,49
1656197156253,CSE 100,A01,083659,Cao; Yingjun,2,20,70,68
1656197162276,CSE 134B,A01,083661,Powell; Thomas Allan,3,0,100,97
1656197168303,CSE 140,A01,083663,Gungor; Onat,9,0,85,76
1656197174327,CSE 140L,A01,083088,Eldon; John,8,0,100,92
1656197180351,CSE 175,A01,083665,Kumar; Rakesh,0,0,25,25
1656197186374,CSE 190,A00,092507,Dubnov; Shlomo,2,0,20,18
1656197192402,ECE 45,A01,083139,Congero; Spencer William,1,0,75,74
1656197198425,ECE 65,A50,083695,Saad; Andrew S,9,0,30,21
1656197198425,ECE 65,A51,095125,Staff,23,0,26,3
1656197204448,ECE 109,A01,091882,Touri; Behrouz,0,1,70,70
1656197210479,ECE 180,A00,083140,Abi Samra; Nicholas Camill,1,0,30,29
1656197210479,ECE 180,B00,083141,Abi Samra; Nicholas Camill,0,4,30,30
1656197216507,MATH 10A,A01,083735,Patchell; Gregory David,0,0,30,30
1656197216507,MATH 10A,A02,083736,Patchell; Gregory David,22,0,30,8
1656197216507,MATH 10A,A03,083737,Patchell; Gregory David,16,0,30,14
1656197222532,MATH 10B,A01,083207,Lim; Seonhee,0,0,34,34
1656197222532,MATH 10B,A02,083208,Lim; Seonhee,7,0,35,28
1656197222532,MATH 10B,A03,093472,Staff,1,0,34,33
1656197222532,MATH 10B,B01,083739,Sinha; Shubham,11,0,30,19
1656197228555,MATH 18,A01,083743,Cinel; Cameron Alexander,7,0,30,23
1656197228555,MATH 18,A02,083744,Cinel; Cameron Alexander,10,0,30,20
1656197228555,MATH 18,A03,083745,Cinel; Cameron Alexander,4,0,30,26
1656197228555,MATH 18,B01,083748,Rideout; David Porter,1,0,36,35
1656197228555,MATH 18,B02,083749,Rideout; David Porter,0,0,36,36
1656197228555,MATH 18,B03,083750,Rideout; David Porter,0,0,36,36
1656197228555,MATH 18,B04,083751,Rideout; David Porter,0,0,36,36
1656197228555,MATH 18,B05,093473,Rideout; David Porter,0,0,36,36
1656197228555,MATH 18,B06,093474,Rideout; David Porter,2,0,36,34
1656197234582,MATH 20A,A01,083754,Zheng; Zequn,11,0,40,29
1656197240605,MATH 20B,A01,083756,Briones; Jor-el Thomas Caparas,0,0,36,36
1656197240605,MATH 20B,A02,083757,Briones; Jor-el Thomas Caparas,0,0,36,36
1656197240605,MATH 20B,A03,093475,Staff,1,0,36,35
1656197246629,MATH 20C,A01,083760,Briones; Jor-el Thomas Caparas,0,0,35,35
1656197246629,MATH 20C,A02,083761,Briones; Jor-el Thomas Caparas,9,1,35,26
1656197246629,MATH 20C,A03,093476,Staff,0,0,35,35
1656197246629,MATH 20C,B01,083762,Bach; Quang Tran,1,0,30,29
1656197252659,MATH 20D,A01,083765,Tran; Brian Kha,1,0,30,29
1656197252659,MATH 20D,A02,083766,Tran; Brian Kha,0,1,30,30
1656197252659,MATH 20D,A03,083767,Tran; Brian Kha,2,0,30,28
1656197258688,MATH 20E,A01,083771,Ganguly; Soumya,3,0,32,29
1656197258688,MATH 20E,A02,083772,Ganguly; Soumya,0,0,32,32
1656197258688,MATH 20E,B01,083773,Ciotti; Benjamin,16,0,35,19
1656197258688,MATH 20E,B02,083774,Ciotti; Benjamin,15,0,35,20
1656197264713,MATH 103A,A01,083777,Greenfeld; Be'Eri,1,0,36,35
1656197264713,MATH 103A,A02,083778,Greenfeld; Be'Eri,1,0,36,35
1656197264713,MATH 103A,A03,093561,Staff,5,0,36,31
1656197264713,MATH 103A,B01,083779,Greenfeld; Be'Eri,9,1,36,27
1656197264713,MATH 103A,B02,083780,Greenfeld; Be'Eri,1,0,36,35
1656197264713,MATH 103A,B03,093562,Staff,0,0,36,36
1656197270736,MATH 105,A01,085443,Carter; Anne Toulson,5,1,35,30
1656197270736,MATH 105,A02,093477,Staff,13,0,35,22
1656197276761,MATH 109,A01,083213,Ganzberger; Geoffrey Michael,0,0,34,34
1656197276761,MATH 109,A02,083214,Ganzberger; Geoffrey Michael,0,0,34,34
1656197276761,MATH 109,A03,093478,Staff,1,0,34,33
1656197276761,MATH 109,B01,083215,Ganzberger; Geoffrey Michael,4,0,32,28
1656197276761,MATH 109,B02,083216,Ganzberger; Geoffrey Michael,1,0,32,31
1656197276761,MATH 109,B03,093479,Staff,4,0,32,28
1656197282786,MATH 142A,A01,083219,Chow; Bennett,1,0,32,31
1656197282786,MATH 142A,A02,083220,Chow; Bennett,8,0,32,24
1656197282786,MATH 142A,A03,093480,Staff,5,0,32,27
1656197282786,MATH 142A,B03,093481,Staff,3,0,32,29
1656197282786,MATH 142A,B04,093558,Staff,6,0,32,26
1656197282786,MATH 142A,B05,093559,Staff,1,0,32,31
1656197288809,MATH 193A,A01,083224,Rotar; Vladimir,0,1,34,34
1656197288809,MATH 193A,A02,083225,Rotar; Vladimir,0,0,34,34
1656197288809,MATH 193A,A03,083781,Rotar; Vladimir,1,0,34,33
1656197288809,MATH 193A,A04,083782,Rotar; Vladimir,6,0,34,28
1656197288809,MATH 193A,A05,093482,Rotar; Vladimir,0,0,34,34
1656197294835,MATH 197,001,091859,McAuley; Julian John,9999,0,9999,0
1656197294835,MATH 197,002,095566,Kedlaya; Kiran S.,9997,0,9999,2
1656197294835,MATH 197,003,095567,Xiao; Ming,9999,0,9999,0
1656197294835,MATH 197,004,095571,Perols; Johan Lars,9998,0,9999,1
1656197301890,COGS 9,A01,083615,Shannon; Kyle Michael,4,0,75,71
1656197307913,COGS 11,A01,083617,Boyle; Mary E. T.,14,0,48,34
1656197313937,COGS 13,A01,083071,Bastos; Amalia Pinkusfeld,4,0,71,67
1656197319964,COGS 14A,A01,092681,Semenuks; Arturs,4,15,100,96
1656197325987,COGS 14B,A01,083073,Cheng; Tzu-Han,7,0,63,56
1656197332012,COGS 17,A01,092677,Semenuks; Arturs,7,0,81,74
1656197338035,COGS 100,A01,083619,Allen; Michael Gordon,2,0,70,68
1656197344060,COGS 101A,A01,083621,Davis; Joshua Daniel,4,0,68,64
1656197350083,COGS 101B,A01,091572,Allen; Michael Gordon,5,0,65,60
1656197356107,COGS 101C,A01,083625,Delgado; Tania,10,0,35,25
1656197362128,COGS 107A,A01,083627,Boyle; Mary E. T.,0,0,60,60
1656197368153,COGS 118A,A01,083075,Gupta; Anjum,7,0,76,69
1656197374178,CSE 3,A50,083646,Miranda; Gregory Joseph,18,0,50,32
1656197380204,CSE 8A,A50,083650,Miranda; Gregory Joseph,3,3,56,53
1656197386230,CSE 11,A01,083080,Cao; Yingjun,1,52,40,39
1656197392254,CSE 12,A01,083652,Krause-Levy; Sophia Louisa,7,3,120,113
1656197398278,CSE 15L,A01,083654,Morris; Justin Loren,2,0,50,48
1656197398278,CSE 15L,A02,083655,Morris; Justin Loren,4,0,50,46
1656197404306,CSE 20,A01,083657,Tran; Khoa Dang,30,0,80,50
1656197410329,CSE 21,A01,095574,Bach; Quang Tran,24,0,48,24
1656197416353,CSE 30,A01,083084,Eldon; John,2,8,80,78
1656197416353,CSE 30,B01,095061,Bhaskar; Nishant,1,2,50,49
1656197422373,CSE 100,A01,083659,Cao; Yingjun,2,20,70,68
1656197428406,CSE 134B,A01,083661,Powell; Thomas Allan,3,0,100,97
1656197434432,CSE 140,A01,083663,Gungor; Onat,9,0,85,76
1656197440459,CSE 140L,A01,083088,Eldon; John,8,0,100,92
1656197446484,CSE 175,A01,083665,Kumar; Rakesh,0,0,25,25
1656197452512,CSE 190,A00,092507,Dubnov; Shlomo,2,0,20,18
1656197458542,ECE 45,A01,083139,Congero; Spencer William,1,0,75,74
1656197464569,ECE 65,A50,083695,Saad; Andrew S,9,0,30,21
1656197464569,ECE 65,A51,095125,Staff,23,0,26,3
1656197470595,ECE 109,A01,091882,Touri; Behrouz,0,1,70,70
1656197476620,ECE 180,A00,083140,Abi Samra; Nicholas Camill,1,0,30,29
1656197476620,ECE 180,B00,083141,Abi Samra; Nicholas Camill,0,4,30,30
1656197482645,MATH 10A,A01,083735,Patchell; Gregory David,0,0,30,30
1656197482645,MATH 10A,A02,083736,Patchell; Gregory David,22,0,30,8
1656197482645,MATH 10A,A03,083737,Patchell; Gregory David,16,0,30,14
1656197488671,MATH 10B,A01,083207,Lim; Seonhee,0,0,34,34
1656197488671,MATH 10B,A02,083208,Lim; Seonhee,7,0,35,28
1656197488671,MATH 10B,A03,093472,Staff,1,0,34,33
1656197488671,MATH 10B,B01,083739,Sinha; Shubham,11,0,30,19
1656197494695,MATH 18,A01,083743,Cinel; Cameron Alexander,7,0,30,23
1656197494695,MATH 18,A02,083744,Cinel; Cameron Alexander,10,0,30,20
1656197494695,MATH 18,A03,083745,Cinel; Cameron Alexander,4,0,30,26
1656197494695,MATH 18,B01,083748,Rideout; David Porter,1,0,36,35
1656197494695,MATH 18,B02,083749,Rideout; David Porter,0,0,36,36
1656197494695,MATH 18,B03,083750,Rideout; David Porter,0,0,36,36
1656197494695,MATH 18,B04,083751,Rideout; David Porter,0,0,36,36
1656197494695,MATH 18,B05,093473,Rideout; David Porter,0,0,36,36
1656197494695,MATH 18,B06,093474,Rideout; David Porter,2,0,36,34
1656197500719,MATH 20A,A01,083754,Zheng; Zequn,11,0,40,29
1656197506744,MATH 20B,A01,083756,Briones; Jor-el Thomas Caparas,0,0,36,36
1656197506744,MATH 20B,A02,083757,Briones; Jor-el Thomas Caparas,0,0,36,36
1656197506744,MATH 20B,A03,093475,Staff,1,0,36,35
1656197512768,MATH 20C,A01,083760,Briones; Jor-el Thomas Caparas,0,0,35,35
1656197512768,MATH 20C,A02,083761,Briones; Jor-el Thomas Caparas,9,1,35,26
1656197512768,MATH 20C,A03,093476,Staff,0,0,35,35
1656197512768,MATH 20C,B01,083762,Bach; Quang Tran,1,0,30,29
1656197518792,MATH 20D,A01,083765,Tran; Brian Kha,1,0,30,29
1656197518792,MATH 20D,A02,083766,Tran; Brian Kha,0,1,30,30
1656197518792,MATH 20D,A03,083767,Tran; Brian Kha,2,0,30,28
1656197524821,MATH 20E,A01,083771,Ganguly; Soumya,3,0,32,29
1656197524821,MATH 20E,A02,083772,Ganguly; Soumya,0,0,32,32
1656197524821,MATH 20E,B01,083773,Ciotti; Benjamin,16,0,35,19
1656197524821,MATH 20E,B02,083774,Ciotti; Benjamin,15,0,35,20
1656197530851,MATH 103A,A01,083777,Greenfeld; Be'Eri,1,0,36,35
1656197530851,MATH 103A,A02,083778,Greenfeld; Be'Eri,1,0,36,35
1656197530851,MATH 103A,A03,093561,Staff,5,0,36,31
1656197530851,MATH 103A,B01,083779,Greenfeld; Be'Eri,9,1,36,27
1656197530851,MATH 103A,B02,083780,Greenfeld; Be'Eri,1,0,36,35
1656197530851,MATH 103A,B03,093562,Staff,0,0,36,36
1656197536879,MATH 105,A01,085443,Carter; Anne Toulson,5,1,35,30
1656197536879,MATH 105,A02,093477,Staff,13,0,35,22
1656197542907,MATH 109,A01,083213,Ganzberger; Geoffrey Michael,0,0,34,34
1656197542907,MATH 109,A02,083214,Ganzberger; Geoffrey Michael,0,0,34,34
1656197542907,MATH 109,A03,093478,Staff,1,0,34,33
1656197542907,MATH 109,B01,083215,Ganzberger; Geoffrey Michael,4,0,32,28
1656197542907,MATH 109,B02,083216,Ganzberger; Geoffrey Michael,1,0,32,31
1656197542907,MATH 109,B03,093479,Staff,4,0,32,28
1656197548940,MATH 142A,A01,083219,Chow; Bennett,1,0,32,31
1656197548940,MATH 142A,A02,083220,Chow; Bennett,8,0,32,24
1656197548940,MATH 142A,A03,093480,Staff,5,0,32,27
1656197548940,MATH 142A,B03,093481,Staff,3,0,32,29
1656197548940,MATH 142A,B04,093558,Staff,6,0,32,26
1656197548940,MATH 142A,B05,093559,Staff,1,0,32,31
1656197554967,MATH 193A,A01,083224,Rotar; Vladimir,0,1,34,34
1656197554967,MATH 193A,A02,083225,Rotar; Vladimir,0,0,34,34
1656197554967,MATH 193A,A03,083781,Rotar; Vladimir,1,0,34,33
1656197554967,MATH 193A,A04,083782,Rotar; Vladimir,6,0,34,28
1656197554967,MATH 193A,A05,093482,Rotar; Vladimir,0,0,34,34
1656197560994,MATH 197,001,091859,McAuley; Julian John,9999,0,9999,0
1656197560994,MATH 197,002,095566,Kedlaya; Kiran S.,9997,0,9999,2
1656197560994,MATH 197,003,095567,Xiao; Ming,9999,0,9999,0
1656197560994,MATH 197,004,095571,Perols; Johan Lars,9998,0,9999,1
1656197568055,COGS 9,A01,083615,Shannon; Kyle Michael,4,0,75,71
1656197574153,COGS 11,A01,083617,Boyle; Mary E. T.,14,0,48,34
1656197580176,COGS 13,A01,083071,Bastos; Amalia Pinkusfeld,4,0,71,67
1656197586205,COGS 14A,A01,092681,Semenuks; Arturs,4,15,100,96
1656197592229,COGS 14B,A01,083073,Cheng; Tzu-Han,7,0,63,56
1656197598255,COGS 17,A01,092677,Semenuks; Arturs,7,0,81,74
1656197604279,COGS 100,A01,083619,Allen; Michael Gordon,2,0,70,68
1656197610308,COGS 101A,A01,083621,Davis; Joshua Daniel,4,0,68,64
1656197616341,COGS 101B,A01,091572,Allen; Michael Gordon,5,0,65,60
1656197622364,COGS 101C,A01,083625,Delgado; Tania,10,0,35,25
1656197628387,COGS 107A,A01,083627,Boyle; Mary E. T.,0,0,60,60
1656197634420,COGS 118A,A01,083075,Gupta; Anjum,7,0,76,69
1656197640444,CSE 3,A50,083646,Miranda; Gregory Joseph,18,0,50,32
1656197646467,CSE 8A,A50,083650,Miranda; Gregory Joseph,3,3,56,53
1656197652489,CSE 11,A01,083080,Cao; Yingjun,1,52,40,39
1656197658526,CSE 12,A01,083652,Krause-Levy; Sophia Louisa,7,3,120,113
1656197664557,CSE 15L,A01,083654,Morris; Justin Loren,2,0,50,48
1656197664557,CSE 15L,A02,083655,Morris; Justin Loren,4,0,50,46
1656197670592,CSE 20,A01,083657,Tran; Khoa Dang,30,0,80,50
1656197676613,CSE 21,A01,095574,Bach; Quang Tran,24,0,48,24
1656197682637,CSE 30,A01,083084,Eldon; John,2,8,80,78
1656197682637,CSE 30,B01,095061,Bhaskar; Nishant,1,2,50,49
1656197688662,CSE 100,A01,083659,Cao; Yingjun,2,20,70,68
1656197694685,CSE 134B,A01,083661,Powell; Thomas Allan,3,0,100,97
1656197700708,CSE 140,A01,083663,Gungor; Onat,9,0,85,76
1656197706738,CSE 140L,A01,083088,Eldon; John,8,0,100,92
1656197712761,CSE 175,A01,083665,Kumar; Rakesh,0,0,25,25
1656197718789,CSE 190,A00,092507,Dubnov; Shlomo,2,0,20,18
1656197724815,ECE 45,A01,083139,Congero; Spencer William,1,0,75,74
1656197730851,ECE 65,A50,083695,Saad; Andrew S,9,0,30,21
1656197730851,ECE 65,A51,095125,Staff,23,0,26,3
1656197736876,ECE 109,A01,091882,Touri; Behrouz,0,1,70,70
1656197742899,ECE 180,A00,083140,Abi Samra; Nicholas Camill,1,0,30,29
1656197742899,ECE 180,B00,083141,Abi Samra; Nicholas Camill,0,4,30,30
1656197748923,MATH 10A,A01,083735,Patchell; Gregory David,0,0,30,30
1656197748923,MATH 10A,A02,083736,Patchell; Gregory David,22,0,30,8
1656197748923,MATH 10A,A03,083737,Patchell; Gregory David,16,0,30,14
1656197754946,MATH 10B,A01,083207,Lim; Seonhee,0,0,34,34
1656197754946,MATH 10B,A02,083208,Lim; Seonhee,7,0,35,28
1656197754946,MATH 10B,A03,093472,Staff,1,0,34,33
1656197754946,MATH 10B,B01,083739,Sinha; Shubham,11,0,30,19
1656197760978,MATH 18,A01,083743,Cinel; Cameron Alexander,7,0,30,23
1656197760978,MATH 18,A02,083744,Cinel; Cameron Alexander,10,0,30,20
1656197760978,MATH 18,A03,083745,Cinel; Cameron Alexander,4,0,30,26
1656197760978,MATH 18,B01,083748,Rideout; David Porter,1,0,36,35
1656197760978,MATH 18,B02,083749,Rideout; David Porter,0,0,36,36
1656197760978,MATH 18,B03,083750,Rideout; David Porter,0,0,36,36
1656197760978,MATH 18,B04,083751,Rideout; David Porter,0,0,36,36
1656197760978,MATH 18,B05,093473,Rideout; David Porter,0,0,36,36
1656197760978,MATH 18,B06,093474,Rideout; David Porter,2,0,36,34
1656197767004,MATH 20A,A01,083754,Zheng; Zequn,11,0,40,29
1656197773028,MATH 20B,A01,083756,Briones; Jor-el Thomas Caparas,0,0,36,36
1656197773028,MATH 20B,A02,083757,Briones; Jor-el Thomas Caparas,0,0,36,36
1656197773028,MATH 20B,A03,093475,Staff,1,0,36,35
1656197779052,MATH 20C,A01,083760,Briones; Jor-el Thomas Caparas,0,0,35,35
1656197779052,MATH 20C,A02,083761,Briones; Jor-el Thomas Caparas,9,1,35,26
1656197779052,MATH 20C,A03,093476,Staff,0,0,35,35
1656197779052,MATH 20C,B01,083762,Bach; Quang Tran,1,0,30,29
1656197785075,MATH 20D,A01,083765,Tran; Brian Kha,1,0,30,29
1656197785075,MATH 20D,A02,083766,Tran; Brian Kha,0,1,30,30
1656197785075,MATH 20D,A03,083767,Tran; Brian Kha,2,0,30,28
1656197791104,MATH 20E,A01,083771,Ganguly; Soumya,3,0,32,29
1656197791104,MATH 20E,A02,083772,Ganguly; Soumya,0,0,32,32
1656197791104,MATH 20E,B01,083773,Ciotti; Benjamin,16,0,35,19
1656197791104,MATH 20E,B02,083774,Ciotti; Benjamin,15,0,35,20
1656197797128,MATH 103A,A01,083777,Greenfeld; Be'Eri,1,0,36,35
1656197797128,MATH 103A,A02,083778,Greenfeld; Be'Eri,1,0,36,35
1656197797128,MATH 103A,A03,093561,Staff,5,0,36,31
1656197797128,MATH 103A,B01,083779,Greenfeld; Be'Eri,9,1,36,27
1656197797128,MATH 103A,B02,083780,Greenfeld; Be'Eri,1,0,36,35
1656197797128,MATH 103A,B03,093562,Staff,0,0,36,36
1656197803151,MATH 105,A01,085443,Carter; Anne Toulson,5,1,35,30
1656197803151,MATH 105,A02,093477,Staff,13,0,35,22
1656197809175,MATH 109,A01,083213,Ganzberger; Geoffrey Michael,0,0,34,34
1656197809175,MATH 109,A02,083214,Ganzberger; Geoffrey Michael,0,0,34,34
1656197809175,MATH 109,A03,093478,Staff,1,0,34,33
1656197809175,MATH 109,B01,083215,Ganzberger; Geoffrey Michael,4,0,32,28
1656197809175,MATH 109,B02,083216,Ganzberger; Geoffrey Michael,1,0,32,31
1656197809175,MATH 109,B03,093479,Staff,4,0,32,28
1656197815199,MATH 142A,A01,083219,Chow; Bennett,1,0,32,31
1656197815199,MATH 142A,A02,083220,Chow; Bennett,8,0,32,24
1656197815199,MATH 142A,A03,093480,Staff,5,0,32,27
1656197815199,MATH 142A,B03,093481,Staff,3,0,32,29
1656197815199,MATH 142A,B04,093558,Staff,6,0,32,26
1656197815199,MATH 142A,B05,093559,Staff,1,0,32,31
1656197821227,MATH 193A,A01,083224,Rotar; Vladimir,0,1,34,34
1656197821227,MATH 193A,A02,083225,Rotar; Vladimir,0,0,34,34
1656197821227,MATH 193A,A03,083781,Rotar; Vladimir,1,0,34,33
1656197821227,MATH 193A,A04,083782,Rotar; Vladimir,6,0,34,28
1656197821227,MATH 193A,A05,093482,Rotar; Vladimir,0,0,34,34
1656197827254,MATH 197,001,091859,McAuley; Julian John,9999,0,9999,0
1656197827254,MATH 197,002,095566,Kedlaya; Kiran S.,9997,0,9999,2
1656197827254,MATH 197,003,095567,Xiao; Ming,9999,0,9999,0
1656197827254,MATH 197,004,095571,Perols; Johan Lars,9998,0,9999,1
1656197834318,COGS 9,A01,083615,Shannon; Kyle Michael,4,0,75,71
1656197840346,COGS 11,A01,083617,Boyle; Mary E. T.,14,0,48,34
1656197846369,COGS 13,A01,083071,Bastos; Amalia Pinkusfeld,4,0,71,67
1656197852395,COGS 14A,A01,092681,Semenuks; Arturs,4,15,100,96
1656197858444,COGS 14B,A01,083073,Cheng; Tzu-Han,7,0,63,56
1656197864467,COGS 17,A01,092677,Semenuks; Arturs,7,0,81,74
1656197870491,COGS 100,A01,083619,Allen; Michael Gordon,2,0,70,68
1656197876518,COGS 101A,A01,083621,Davis; Joshua Daniel,4,0,68,64
1656197882540,COGS 101B,A01,091572,Allen; Michael Gordon,5,0,65,60
1656197888566,COGS 101C,A01,083625,Delgado; Tania,10,0,35,25
1656197894601,COGS 107A,A01,083627,Boyle; Mary E. T.,0,0,60,60
1656197900624,COGS 118A,A01,083075,Gupta; Anjum,7,0,76,69
1656197906654,CSE 3,A50,083646,Miranda; Gregory Joseph,18,0,50,32
1656197912679,CSE 8A,A50,083650,Miranda; Gregory Joseph,3,3,56,53
1656197918703,CSE 11,A01,083080,Cao; Yingjun,1,52,40,39
1656197924730,CSE 12,A01,083652,Krause-Levy; Sophia Louisa,7,3,120,113
1656197930752,CSE 15L,A01,083654,Morris; Justin Loren,2,0,50,48
1656197930752,CSE 15L,A02,083655,Morris; Justin Loren,4,0,50,46
1656197936778,CSE 20,A01,083657,Tran; Khoa Dang,30,0,80,50
1656197942801,CSE 21,A01,095574,Bach; Quang Tran,24,0,48,24
1656197948827,CSE 30,A01,083084,Eldon; John,2,8,80,78
1656197948827,CSE 30,B01,095061,Bhaskar; Nishant,1,2,50,49
1656197954850,CSE 100,A01,083659,Cao; Yingjun,2,20,70,68
1656197960873,CSE 134B,A01,083661,Powell; Thomas Allan,3,0,100,97
1656197966896,CSE 140,A01,083663,Gungor; Onat,9,0,85,76
1656197972920,CSE 140L,A01,083088,Eldon; John,8,0,100,92
1656197978947,CSE 175,A01,083665,Kumar; Rakesh,0,0,25,25
1656197984976,CSE 190,A00,092507,Dubnov; Shlomo,2,0,20,18
1656197991002,ECE 45,A01,083139,Congero; Spencer William,1,0,75,74
1656197997025,ECE 65,A50,083695,Saad; Andrew S,9,0,30,21
1656197997025,ECE 65,A51,095125,Staff,23,0,26,3
1656198003063,ECE 109,A01,091882,Touri; Behrouz,0,1,70,70
1656198009085,ECE 180,A00,083140,Abi Samra; Nicholas Camill,1,0,30,29
1656198009085,ECE 180,B00,083141,Abi Samra; Nicholas Camill,0,4,30,30
1656198015109,MATH 10A,A01,083735,Patchell; Gregory David,0,0,30,30
1656198015109,MATH 10A,A02,083736,Patchell; Gregory David,22,0,30,8
1656198015109,MATH 10A,A03,083737,Patchell; Gregory David,16,0,30,14
1656198021139,MATH 10B,A01,083207,Lim; Seonhee,0,0,34,34
1656198021139,MATH 10B,A02,083208,Lim; Seonhee,7,0,35,28
1656198021139,MATH 10B,A03,093472,Staff,1,0,34,33
1656198021139,MATH 10B,B01,083739,Sinha; Shubham,11,0,30,19
1656198027171,MATH 18,A01,083743,Cinel; Cameron Alexander,7,0,30,23
1656198027171,MATH 18,A02,083744,Cinel; Cameron Alexander,10,0,30,20
1656198027171,MATH 18,A03,083745,Cinel; Cameron Alexander,4,0,30,26
1656198027171,MATH 18,B01,083748,Rideout; David Porter,1,0,36,35
1656198027171,MATH 18,B02,083749,Rideout; David Porter,0,0,36,36
1656198027171,MATH 18,B03,083750,Rideout; David Porter,0,0,36,36
1656198027171,MATH 18,B04,083751,Rideout; David Porter,0,0,36,36
1656198027171,MATH 18,B05,093473,Rideout; David Porter,0,0,36,36
1656198027171,MATH 18,B06,093474,Rideout; David Porter,2,0,36,34
1656198033199,MATH 20A,A01,083754,Zheng; Zequn,11,0,40,29
1656198039223,MATH 20B,A01,083756,Briones; Jor-el Thomas Caparas,0,0,36,36
1656198039223,MATH 20B,A02,083757,Briones; Jor-el Thomas Caparas,0,0,36,36
1656198039223,MATH 20B,A03,093475,Staff,1,0,36,35
1656198045250,MATH 20C,A01,083760,Briones; Jor-el Thomas Caparas,0,0,35,35
1656198045250,MATH 20C,A02,083761,Briones; Jor-el Thomas Caparas,9,1,35,26
1656198045250,MATH 20C,A03,093476,Staff,0,0,35,35
1656198045250,MATH 20C,B01,083762,Bach; Quang Tran,1,0,30,29
1656198051282,MATH 20D,A01,083765,Tran; Brian Kha,1,0,30,29
1656198051282,MATH 20D,A02,083766,Tran; Brian Kha,0,1,30,30
1656198051282,MATH 20D,A03,083767,Tran; Brian Kha,2,0,30,28
1656198057308,MATH 20E,A01,083771,Ganguly; Soumya,3,0,32,29
1656198057308,MATH 20E,A02,083772,Ganguly; Soumya,0,0,32,32
1656198057308,MATH 20E,B01,083773,Ciotti; Benjamin,16,0,35,19
1656198057308,MATH 20E,B02,083774,Ciotti; Benjamin,15,0,35,20
1656198063339,MATH 103A,A01,083777,Greenfeld; Be'Eri,1,0,36,35
1656198063339,MATH 103A,A02,083778,Greenfeld; Be'Eri,1,0,36,35
1656198063339,MATH 103A,A03,093561,Staff,5,0,36,31
1656198063339,MATH 103A,B01,083779,Greenfeld; Be'Eri,9,1,36,27
1656198063339,MATH 103A,B02,083780,Greenfeld; Be'Eri,1,0,36,35
1656198063339,MATH 103A,B03,093562,Staff,0,0,36,36
1656198069362,MATH 105,A01,085443,Carter; Anne Toulson,5,1,35,30
1656198069362,MATH 105,A02,093477,Staff,13,0,35,22
1656198075390,MATH 109,A01,083213,Ganzberger; Geoffrey Michael,0,0,34,34
1656198075390,MATH 109,A02,083214,Ganzberger; Geoffrey Michael,0,0,34,34
1656198075390,MATH 109,A03,093478,Staff,1,0,34,33
1656198075390,MATH 109,B01,083215,Ganzberger; Geoffrey Michael,4,0,32,28
1656198075390,MATH 109,B02,083216,Ganzberger; Geoffrey Michael,1,0,32,31
1656198075390,MATH 109,B03,093479,Staff,4,0,32,28
1656198081415,MATH 142A,A01,083219,Chow; Bennett,1,0,32,31
1656198081415,MATH 142A,A02,083220,Chow; Bennett,8,0,32,24
1656198081415,MATH 142A,A03,093480,Staff,5,0,32,27
1656198081415,MATH 142A,B03,093481,Staff,3,0,32,29
1656198081415,MATH 142A,B04,093558,Staff,6,0,32,26
1656198081415,MATH 142A,B05,093559,Staff,1,0,32,31
1656198087438,MATH 193A,A01,083224,Rotar; Vladimir,0,1,34,34
1656198087438,MATH 193A,A02,083225,Rotar; Vladimir,0,0,34,34
1656198087438,MATH 193A,A03,083781,Rotar; Vladimir,1,0,34,33
1656198087438,MATH 193A,A04,083782,Rotar; Vladimir,6,0,34,28
1656198087438,MATH 193A,A05,093482,Rotar; Vladimir,0,0,34,34
1656198093462,MATH 197,001,091859,McAuley; Julian John,9999,0,9999,0
1656198093462,MATH 197,002,095566,Kedlaya; Kiran S.,9997,0,9999,2
1656198093462,MATH 197,003,095567,Xiao; Ming,9999,0,9999,0
1656198093462,MATH 197,004,095571,Perols; Johan Lars,9998,0,9999,1
1656198100512,COGS 9,A01,083615,Shannon; Kyle Michael,4,0,75,71
1656198106535,COGS 11,A01,083617,Boyle; Mary E. T.,14,0,48,34
1656198112559,COGS 13,A01,083071,Bastos; Amalia Pinkusfeld,4,0,71,67
1656198118583,COGS 14A,A01,092681,Semenuks; Arturs,4,15,100,96
1656198124611,COGS 14B,A01,083073,Cheng; Tzu-Han,7,0,63,56
1656198130635,COGS 17,A01,092677,Semenuks; Arturs,7,0,81,74
1656198136657,COGS 100,A01,083619,Allen; Michael Gordon,2,0,70,68
1656198142681,COGS 101A,A01,083621,Davis; Joshua Daniel,4,0,68,64
1656198148704,COGS 101B,A01,091572,Allen; Michael Gordon,5,0,65,60
1656198154728,COGS 101C,A01,083625,Delgado; Tania,10,0,35,25
1656198160752,COGS 107A,A01,083627,Boyle; Mary E. T.,0,0,60,60
1656198166776,COGS 118A,A01,083075,Gupta; Anjum,7,0,76,69
1656198172880,CSE 3,A50,083646,Miranda; Gregory Joseph,18,0,50,32
1656198178907,CSE 8A,A50,083650,Miranda; Gregory Joseph,3,3,56,53
1656198184933,CSE 11,A01,083080,Cao; Yingjun,1,52,40,39
1656198190956,CSE 12,A01,083652,Krause-Levy; Sophia Louisa,7,3,120,113
1656198196980,CSE 15L,A01,083654,Morris; Justin Loren,2,0,50,48
1656198196980,CSE 15L,A02,083655,Morris; Justin Loren,4,0,50,46
1656198203004,CSE 20,A01,083657,Tran; Khoa Dang,30,0,80,50
1656198209027,CSE 21,A01,095574,Bach; Quang Tran,24,0,48,24
1656198215051,CSE 30,A01,083084,Eldon; John,2,8,80,78
1656198215051,CSE 30,B01,095061,Bhaskar; Nishant,1,2,50,49
1656198221078,CSE 100,A01,083659,Cao; Yingjun,2,20,70,68
1656198227102,CSE 134B,A01,083661,Powell; Thomas Allan,3,0,100,97
1656198233129,CSE 140,A01,083663,Gungor; Onat,9,0,85,76
1656198239153,CSE 140L,A01,083088,Eldon; John,8,0,100,92
1656198245179,CSE 175,A01,083665,Kumar; Rakesh,0,0,25,25
1656198251205,CSE 190,A00,092507,Dubnov; Shlomo,2,0,20,18
1656198257233,ECE 45,A01,083139,Congero; Spencer William,1,0,75,74
1656198263260,ECE 65,A50,083695,Saad; Andrew S,9,0,30,21
1656198263260,ECE 65,A51,095125,Staff,23,0,26,3
1656198269291,ECE 109,A01,091882,Touri; Behrouz,0,1,70,70
1656198275322,ECE 180,A00,083140,Abi Samra; Nicholas Camill,1,0,30,29
1656198275322,ECE 180,B00,083141,Abi Samra; Nicholas Camill,0,4,30,30
1656198281349,MATH 10A,A01,083735,Patchell; Gregory David,0,0,30,30
1656198281349,MATH 10A,A02,083736,Patchell; Gregory David,22,0,30,8
1656198281349,MATH 10A,A03,083737,Patchell; Gregory David,16,0,30,14
1656198287374,MATH 10B,A01,083207,Lim; Seonhee,0,0,34,34
1656198287374,MATH 10B,A02,083208,Lim; Seonhee,7,0,35,28
1656198287374,MATH 10B,A03,093472,Staff,1,0,34,33
1656198287374,MATH 10B,B01,083739,Sinha; Shubham,11,0,30,19
1656198293404,MATH 18,A01,083743,Cinel; Cameron Alexander,7,0,30,23
1656198293404,MATH 18,A02,083744,Cinel; Cameron Alexander,10,0,30,20
1656198293404,MATH 18,A03,083745,Cinel; Cameron Alexander,4,0,30,26
1656198293404,MATH 18,B01,083748,Rideout; David Porter,1,0,36,35
1656198293404,MATH 18,B02,083749,Rideout; David Porter,0,0,36,36
1656198293404,MATH 18,B03,083750,Rideout; David Porter,0,0,36,36
1656198293404,MATH 18,B04,083751,Rideout; David Porter,0,0,36,36
1656198293404,MATH 18,B05,093473,Rideout; David Porter,0,0,36,36
1656198293404,MATH 18,B06,093474,Rideout; David Porter,2,0,36,34
1656198299427,MATH 20A,A01,083754,Zheng; Zequn,11,0,40,29
1656198305450,MATH 20B,A01,083756,Briones; Jor-el Thomas Caparas,0,0,36,36
1656198305450,MATH 20B,A02,083757,Briones; Jor-el Thomas Caparas,0,0,36,36
1656198305450,MATH 20B,A03,093475,Staff,1,0,36,35
1656198311479,MATH 20C,A01,083760,Briones; Jor-el Thomas Caparas,0,0,35,35
1656198311479,MATH 20C,A02,083761,Briones; Jor-el Thomas Caparas,9,1,35,26
1656198311479,MATH 20C,A03,093476,Staff,0,0,35,35
1656198311479,MATH 20C,B01,083762,Bach; Quang Tran,1,0,30,29
1656198317504,MATH 20D,A01,083765,Tran; Brian Kha,1,0,30,29
1656198317504,MATH 20D,A02,083766,Tran; Brian Kha,0,1,30,30
1656198317504,MATH 20D,A03,083767,Tran; Brian Kha,2,0,30,28
1656198323532,MATH 20E,A01,083771,Ganguly; Soumya,3,0,32,29
1656198323532,MATH 20E,A02,083772,Ganguly; Soumya,0,0,32,32
1656198323532,MATH 20E,B01,083773,Ciotti; Benjamin,16,0,35,19
1656198323532,MATH 20E,B02,083774,Ciotti; Benjamin,15,0,35,20
1656198329562,MATH 103A,A01,083777,Greenfeld; Be'Eri,1,0,36,35
1656198329562,MATH 103A,A02,083778,Greenfeld; Be'Eri,1,0,36,35
1656198329562,MATH 103A,A03,093561,Staff,5,0,36,31
1656198329562,MATH 103A,B01,083779,Greenfeld; Be'Eri,9,1,36,27
1656198329562,MATH 103A,B02,083780,Greenfeld; Be'Eri,1,0,36,35
1656198329562,MATH 103A,B03,093562,Staff,0,0,36,36
1656198335590,MATH 105,A01,085443,Carter; Anne Toulson,5,1,35,30
1656198335590,MATH 105,A02,093477,Staff,13,0,35,22
1656198341615,MATH 109,A01,083213,Ganzberger; Geoffrey Michael,0,0,34,34
1656198341615,MATH 109,A02,083214,Ganzberger; Geoffrey Michael,0,0,34,34
1656198341615,MATH 109,A03,093478,Staff,1,0,34,33
1656198341615,MATH 109,B01,083215,Ganzberger; Geoffrey Michael,4,0,32,28
1656198341615,MATH 109,B02,083216,Ganzberger; Geoffrey Michael,1,0,32,31
1656198341615,MATH 109,B03,093479,Staff,4,0,32,28
1656198347638,MATH 142A,A01,083219,Chow; Bennett,1,0,32,31
1656198347638,MATH 142A,A02,083220,Chow; Bennett,8,0,32,24
1656198347638,MATH 142A,A03,093480,Staff,5,0,32,27
1656198347638,MATH 142A,B03,093481,Staff,3,0,32,29
1656198347638,MATH 142A,B04,093558,Staff,6,0,32,26
1656198347638,MATH 142A,B05,093559,Staff,1,0,32,31
1656198353664,MATH 193A,A01,083224,Rotar; Vladimir,0,1,34,34
1656198353664,MATH 193A,A02,083225,Rotar; Vladimir,0,0,34,34
1656198353664,MATH 193A,A03,083781,Rotar; Vladimir,1,0,34,33
1656198353664,MATH 193A,A04,083782,Rotar; Vladimir,6,0,34,28
1656198353664,MATH 193A,A05,093482,Rotar; Vladimir,0,0,34,34
1656198359688,MATH 197,001,091859,McAuley; Julian John,9999,0,9999,0
1656198359688,MATH 197,002,095566,Kedlaya; Kiran S.,9997,0,9999,2
1656198359688,MATH 197,003,095567,Xiao; Ming,9999,0,9999,0
1656198359688,MATH 197,004,095571,Perols; Johan Lars,9998,0,9999,1
1656198366755,COGS 9,A01,083615,Shannon; Kyle Michael,4,0,75,71
1656198372802,COGS 11,A01,083617,Boyle; Mary E. T.,14,0,48,34
1656198378826,COGS 13,A01,083071,Bastos; Amalia Pinkusfeld,4,0,71,67
1656198384853,COGS 14A,A01,092681,Semenuks; Arturs,4,15,100,96
1656198390877,COGS 14B,A01,083073,Cheng; Tzu-Han,7,0,63,56
1656198396902,COGS 17,A01,092677,Semenuks; Arturs,7,0,81,74
1656198402930,COGS 100,A01,083619,Allen; Michael Gordon,2,0,70,68
1656198408954,COGS 101A,A01,083621,Davis; Joshua Daniel,4,0,68,64
1656198414980,COGS 101B,A01,091572,Allen; Michael Gordon,5,0,65,60
1656198421008,COGS 101C,A01,083625,Delgado; Tania,10,0,35,25
1656198427041,COGS 107A,A01,083627,Boyle; Mary E. T.,0,0,60,60
1656198433065,COGS 118A,A01,083075,Gupta; Anjum,7,0,76,69
1656198439089,CSE 3,A50,083646,Miranda; Gregory Joseph,18,0,50,32
1656198445124,CSE 8A,A50,083650,Miranda; Gregory Joseph,3,3,56,53
1656198451147,CSE 11,A01,083080,Cao; Yingjun,1,52,40,39
1656198457170,CSE 12,A01,083652,Krause-Levy; Sophia Louisa,7,3,120,113
1656198463193,CSE 15L,A01,083654,Morris; Justin Loren,2,0,50,48
1656198463193,CSE 15L,A02,083655,Morris; Justin Loren,4,0,50,46
1656198469242,CSE 20,A01,083657,Tran; Khoa Dang,30,0,80,50
1656198475268,CSE 21,A01,095574,Bach; Quang Tran,24,0,48,24
1656198481290,CSE 30,A01,083084,Eldon; John,2,8,80,78
1656198481290,CSE 30,B01,095061,Bhaskar; Nishant,1,2,50,49
1656198487315,CSE 100,A01,083659,Cao; Yingjun,2,20,70,68
1656198493339,CSE 134B,A01,083661,Powell; Thomas Allan,3,0,100,97
1656198499361,CSE 140,A01,083663,Gungor; Onat,9,0,85,76
1656198505385,CSE 140L,A01,083088,Eldon; John,8,0,100,92
1656198511409,CSE 175,A01,083665,Kumar; Rakesh,0,0,25,25
1656198517430,CSE 190,A00,092507,Dubnov; Shlomo,2,0,20,18
1656198523455,ECE 45,A01,083139,Congero; Spencer William,1,0,75,74
1656198529484,ECE 65,A50,083695,Saad; Andrew S,9,0,30,21
1656198529484,ECE 65,A51,095125,Staff,23,0,26,3
1656198535507,ECE 109,A01,091882,Touri; Behrouz,0,1,70,70
1656198541529,ECE 180,A00,083140,Abi Samra; Nicholas Camill,1,0,30,29
1656198541529,ECE 180,B00,083141,Abi Samra; Nicholas Camill,0,4,30,30
1656198547551,MATH 10A,A01,083735,Patchell; Gregory David,0,0,30,30
1656198547551,MATH 10A,A02,083736,Patchell; Gregory David,22,0,30,8
1656198547551,MATH 10A,A03,083737,Patchell; Gregory David,16,0,30,14
1656198553575,MATH 10B,A01,083207,Lim; Seonhee,0,0,34,34
1656198553575,MATH 10B,A02,083208,Lim; Seonhee,7,0,35,28
1656198553575,MATH 10B,A03,093472,Staff,1,0,34,33
1656198553575,MATH 10B,B01,083739,Sinha; Shubham,11,0,30,19
1656198559601,MATH 18,A01,083743,Cinel; Cameron Alexander,7,0,30,23
1656198559601,MATH 18,A02,083744,Cinel; Cameron Alexander,10,0,30,20
1656198559601,MATH 18,A03,083745,Cinel; Cameron Alexander,4,0,30,26
1656198559601,MATH 18,B01,083748,Rideout; David Porter,1,0,36,35
1656198559601,MATH 18,B02,083749,Rideout; David Porter,0,0,36,36
1656198559601,MATH 18,B03,083750,Rideout; David Porter,0,0,36,36
1656198559601,MATH 18,B04,083751,Rideout; David Porter,0,0,36,36
1656198559601,MATH 18,B05,093473,Rideout; David Porter,0,0,36,36
1656198559601,MATH 18,B06,093474,Rideout; David Porter,2,0,36,34
1656198565624,MATH 20A,A01,083754,Zheng; Zequn,11,0,40,29
1656198571647,MATH 20B,A01,083756,Briones; Jor-el Thomas Caparas,0,0,36,36
1656198571647,MATH 20B,A02,083757,Briones; Jor-el Thomas Caparas,0,0,36,36
1656198571647,MATH 20B,A03,093475,Staff,1,0,36,35
1656198577670,MATH 20C,A01,083760,Briones; Jor-el Thomas Caparas,0,0,35,35
1656198577670,MATH 20C,A02,083761,Briones; Jor-el Thomas Caparas,9,1,35,26
1656198577670,MATH 20C,A03,093476,Staff,0,0,35,35
1656198577670,MATH 20C,B01,083762,Bach; Quang Tran,1,0,30,29
1656198583697,MATH 20D,A01,083765,Tran; Brian Kha,1,0,30,29
1656198583697,MATH 20D,A02,083766,Tran; Brian Kha,0,1,30,30
1656198583697,MATH 20D,A03,083767,Tran; Brian Kha,2,0,30,28
1656198589732,MATH 20E,A01,083771,Ganguly; Soumya,3,0,32,29
1656198589732,MATH 20E,A02,083772,Ganguly; Soumya,0,0,32,32
1656198589732,MATH 20E,B01,083773,Ciotti; Benjamin,16,0,35,19
1656198589732,MATH 20E,B02,083774,Ciotti; Benjamin,15,0,35,20
1656198595757,MATH 103A,A01,083777,Greenfeld; Be'Eri,1,0,36,35
1656198595757,MATH 103A,A02,083778,Greenfeld; Be'Eri,1,0,36,35
1656198595757,MATH 103A,A03,093561,Staff,5,0,36,31
1656198595757,MATH 103A,B01,083779,Greenfeld; Be'Eri,9,1,36,27
1656198595757,MATH 103A,B02,083780,Greenfeld; Be'Eri,1,0,36,35
1656198595757,MATH 103A,B03,093562,Staff,0,0,36,36
1656198601781,MATH 105,A01,085443,Carter; Anne Toulson,5,1,35,30
1656198601781,MATH 105,A02,093477,Staff,13,0,35,22
1656198607803,MATH 109,A01,083213,Ganzberger; Geoffrey Michael,0,0,34,34
1656198607803,MATH 109,A02,083214,Ganzberger; Geoffrey Michael,0,0,34,34
1656198607803,MATH 109,A03,093478,Staff,1,0,34,33
1656198607803,MATH 109,B01,083215,Ganzberger; Geoffrey Michael,4,0,32,28
1656198607803,MATH 109,B02,083216,Ganzberger; Geoffrey Michael,1,0,32,31
1656198607803,MATH 109,B03,093479,Staff,4,0,32,28
1656198613832,MATH 142A,A01,083219,Chow; Bennett,1,0,32,31
1656198613832,MATH 142A,A02,083220,Chow; Bennett,8,0,32,24
1656198613832,MATH 142A,A03,093480,Staff,5,0,32,27
1656198613832,MATH 142A,B03,093481,Staff,3,0,32,29
1656198613832,MATH 142A,B04,093558,Staff,6,0,32,26
1656198613832,MATH 142A,B05,093559,Staff,1,0,32,31
1656198619857,MATH 193A,A01,083224,Rotar; Vladimir,0,1,34,34
1656198619857,MATH 193A,A02,083225,Rotar; Vladimir,0,0,34,34
1656198619857,MATH 193A,A03,083781,Rotar; Vladimir,1,0,34,33
1656198619857,MATH 193A,A04,083782,Rotar; Vladimir,6,0,34,28
1656198619857,MATH 193A,A05,093482,Rotar; Vladimir,0,0,34,34
1656198625882,MATH 197,001,091859,McAuley; Julian John,9999,0,9999,0
1656198625882,MATH 197,002,095566,Kedlaya; Kiran S.,9997,0,9999,2
1656198625882,MATH 197,003,095567,Xiao; Ming,9999,0,9999,0
1656198625882,MATH 197,004,095571,Perols; Johan Lars,9998,0,9999,1
1656198632944,COGS 9,A01,083615,Shannon; Kyle Michael,4,0,75,71
1656198638969,COGS 11,A01,083617,Boyle; Mary E. T.,14,0,48,34
1656198644998,COGS 13,A01,083071,Bastos; Amalia Pinkusfeld,4,0,71,67
1656198651028,COGS 14A,A01,092681,Semenuks; Arturs,4,15,100,96
1656198657054,COGS 14B,A01,083073,Cheng; Tzu-Han,7,0,63,56
1656198663079,COGS 17,A01,092677,Semenuks; Arturs,7,0,81,74
1656198669115,COGS 100,A01,083619,Allen; Michael Gordon,2,0,70,68
1656198675138,COGS 101A,A01,083621,Davis; Joshua Daniel,4,0,68,64
1656198681162,COGS 101B,A01,091572,Allen; Michael Gordon,5,0,65,60
1656198687194,COGS 101C,A01,083625,Delgado; Tania,10,0,35,25
1656198693221,COGS 107A,A01,083627,Boyle; Mary E. T.,0,0,60,60
1656198699246,COGS 118A,A01,083075,Gupta; Anjum,7,0,76,69
1656198705287,CSE 3,A50,083646,Miranda; Gregory Joseph,18,0,50,32
1656198711312,CSE 8A,A50,083650,Miranda; Gregory Joseph,3,3,56,53
1656198717336,CSE 11,A01,083080,Cao; Yingjun,1,51,40,39
1656198723363,CSE 12,A01,083652,Krause-Levy; Sophia Louisa,7,3,120,113
1656198729390,CSE 15L,A01,083654,Morris; Justin Loren,2,0,50,48
1656198729390,CSE 15L,A02,083655,Morris; Justin Loren,4,0,50,46
1656198735413,CSE 20,A01,083657,Tran; Khoa Dang,30,0,80,50
1656198741445,CSE 21,A01,095574,Bach; Quang Tran,24,0,48,24
1656198747469,CSE 30,A01,083084,Eldon; John,2,8,80,78
1656198747469,CSE 30,B01,095061,Bhaskar; Nishant,1,2,50,49
1656198753497,CSE 100,A01,083659,Cao; Yingjun,2,20,70,68
1656198759524,CSE 134B,A01,083661,Powell; Thomas Allan,3,0,100,97
1656198765548,CSE 140,A01,083663,Gungor; Onat,9,0,85,76
1656198771647,CSE 140L,A01,083088,Eldon; John,8,0,100,92
1656198777674,CSE 175,A01,083665,Kumar; Rakesh,0,0,25,25
1656198783701,CSE 190,A00,092507,Dubnov; Shlomo,2,0,20,18
1656198789729,ECE 45,A01,083139,Congero; Spencer William,1,0,75,74
1656198795754,ECE 65,A50,083695,Saad; Andrew S,9,0,30,21
1656198795754,ECE 65,A51,095125,Staff,23,0,26,3
1656198801777,ECE 109,A01,091882,Touri; Behrouz,0,1,70,70
1656198807802,ECE 180,A00,083140,Abi Samra; Nicholas Camill,1,0,30,29
1656198807802,ECE 180,B00,083141,Abi Samra; Nicholas Camill,0,4,30,30
1656198813829,MATH 10A,A01,083735,Patchell; Gregory David,0,0,30,30
1656198813829,MATH 10A,A02,083736,Patchell; Gregory David,22,0,30,8
1656198813829,MATH 10A,A03,083737,Patchell; Gregory David,16,0,30,14
1656198819854,MATH 10B,A01,083207,Lim; Seonhee,0,0,34,34
1656198819854,MATH 10B,A02,083208,Lim; Seonhee,7,0,35,28
1656198819854,MATH 10B,A03,093472,Staff,1,0,34,33
1656198819854,MATH 10B,B01,083739,Sinha; Shubham,11,0,30,19
1656198825886,MATH 18,A01,083743,Cinel; Cameron Alexander,7,0,30,23
1656198825886,MATH 18,A02,083744,Cinel; Cameron Alexander,10,0,30,20
1656198825886,MATH 18,A03,083745,Cinel; Cameron Alexander,4,0,30,26
1656198825886,MATH 18,B01,083748,Rideout; David Porter,1,0,36,35
1656198825886,MATH 18,B02,083749,Rideout; David Porter,0,0,36,36
1656198825886,MATH 18,B03,083750,Rideout; David Porter,0,0,36,36
1656198825886,MATH 18,B04,083751,Rideout; David Porter,0,0,36,36
1656198825886,MATH 18,B05,093473,Rideout; David Porter,0,0,36,36
1656198825886,MATH 18,B06,093474,Rideout; David Porter,2,0,36,34
1656198831912,MATH 20A,A01,083754,Zheng; Zequn,11,0,40,29
1656198837939,MATH 20B,A01,083756,Briones; Jor-el Thomas Caparas,0,0,36,36
1656198837939,MATH 20B,A02,083757,Briones; Jor-el Thomas Caparas,0,0,36,36
1656198837939,MATH 20B,A03,093475,Staff,1,0,36,35
1656198843963,MATH 20C,A01,083760,Briones; Jor-el Thomas Caparas,0,0,35,35
1656198843963,MATH 20C,A02,083761,Briones; Jor-el Thomas Caparas,9,1,35,26
1656198843963,MATH 20C,A03,093476,Staff,0,0,35,35
1656198843963,MATH 20C,B01,083762,Bach; Quang Tran,1,0,30,29
1656198849987,MATH 20D,A01,083765,Tran; Brian Kha,1,0,30,29
1656198849987,MATH 20D,A02,083766,Tran; Brian Kha,0,1,30,30
1656198849987,MATH 20D,A03,083767,Tran; Brian Kha,2,0,30,28
1656198856015,MATH 20E,A01,083771,Ganguly; Soumya,3,0,32,29
1656198856015,MATH 20E,A02,083772,Ganguly; Soumya,0,0,32,32
1656198856015,MATH 20E,B01,083773,Ciotti; Benjamin,16,0,35,19
1656198856015,MATH 20E,B02,083774,Ciotti; Benjamin,15,0,35,20
1656198862042,MATH 103A,A01,083777,Greenfeld; Be'Eri,1,0,36,35
1656198862042,MATH 103A,A02,083778,Greenfeld; Be'Eri,1,0,36,35
1656198862042,MATH 103A,A03,093561,Staff,5,0,36,31
1656198862042,MATH 103A,B01,083779,Greenfeld; Be'Eri,9,1,36,27
1656198862042,MATH 103A,B02,083780,Greenfeld; Be'Eri,1,0,36,35
1656198862042,MATH 103A,B03,093562,Staff,0,0,36,36
1656198868066,MATH 105,A01,085443,Carter; Anne Toulson,5,1,35,30
1656198868066,MATH 105,A02,093477,Staff,13,0,35,22
1656198874095,MATH 109,A01,083213,Ganzberger; Geoffrey Michael,0,0,34,34
1656198874095,MATH 109,A02,083214,Ganzberger; Geoffrey Michael,0,0,34,34
1656198874095,MATH 109,A03,093478,Staff,1,0,34,33
1656198874095,MATH 109,B01,083215,Ganzberger; Geoffrey Michael,4,0,32,28
1656198874095,MATH 109,B02,083216,Ganzberger; Geoffrey Michael,1,0,32,31
1656198874095,MATH 109,B03,093479,Staff,4,0,32,28
1656198880118,MATH 142A,A01,083219,Chow; Bennett,1,0,32,31
1656198880118,MATH 142A,A02,083220,Chow; Bennett,8,0,32,24
1656198880118,MATH 142A,A03,093480,Staff,5,0,32,27
1656198880118,MATH 142A,B03,093481,Staff,3,0,32,29
1656198880118,MATH 142A,B04,093558,Staff,6,0,32,26
1656198880118,MATH 142A,B05,093559,Staff,1,0,32,31
1656198886142,MATH 193A,A01,083224,Rotar; Vladimir,0,1,34,34
1656198886142,MATH 193A,A02,083225,Rotar; Vladimir,0,0,34,34
1656198886142,MATH 193A,A03,083781,Rotar; Vladimir,1,0,34,33
1656198886142,MATH 193A,A04,083782,Rotar; Vladimir,6,0,34,28
1656198886142,MATH 193A,A05,093482,Rotar; Vladimir,0,0,34,34
1656198892167,MATH 197,001,091859,McAuley; Julian John,9999,0,9999,0
1656198892167,MATH 197,002,095566,Kedlaya; Kiran S.,9997,0,9999,2
1656198892167,MATH 197,003,095567,Xiao; Ming,9999,0,9999,0
1656198892167,MATH 197,004,095571,Perols; Johan Lars,9998,0,9999,1
1656198899228,COGS 9,A01,083615,Shannon; Kyle Michael,4,0,75,71
1656198905260,COGS 11,A01,083617,Boyle; Mary E. T.,14,0,48,34
1656198911285,COGS 13,A01,083071,Bastos; Amalia Pinkusfeld,4,0,71,67
1656198917308,COGS 14A,A01,092681,Semenuks; Arturs,4,15,100,96
1656198923341,COGS 14B,A01,083073,Cheng; Tzu-Han,7,0,63,56
1656198929365,COGS 17,A01,092677,Semenuks; Arturs,7,0,81,74
1656198935388,COGS 100,A01,083619,Allen; Michael Gordon,2,0,70,68
1656198941413,COGS 101A,A01,083621,Davis; Joshua Daniel,4,0,68,64
1656198947437,COGS 101B,A01,091572,Allen; Michael Gordon,5,0,65,60
1656198953460,COGS 101C,A01,083625,Delgado; Tania,10,0,35,25
1656198959484,COGS 107A,A01,083627,Boyle; Mary E. T.,0,0,60,60
1656198965512,COGS 118A,A01,083075,Gupta; Anjum,7,0,76,69
1656198971536,CSE 3,A50,083646,Miranda; Gregory Joseph,18,0,50,32
1656198977558,CSE 8A,A50,083650,Miranda; Gregory Joseph,3,3,56,53
1656198983585,CSE 11,A01,083080,Cao; Yingjun,1,51,40,39
1656198989608,CSE 12,A01,083652,Krause-Levy; Sophia Louisa,7,3,120,113
1656198995634,CSE 15L,A01,083654,Morris; Justin Loren,2,0,50,48
1656198995634,CSE 15L,A02,083655,Morris; Justin Loren,4,0,50,46
1656199001664,CSE 20,A01,083657,Tran; Khoa Dang,30,0,80,50
1656199007694,CSE 21,A01,095574,Bach; Quang Tran,24,0,48,24
1656199013717,CSE 30,A01,083084,Eldon; John,2,8,80,78
1656199013717,CSE 30,B01,095061,Bhaskar; Nishant,1,2,50,49
1656199019741,CSE 100,A01,083659,Cao; Yingjun,2,20,70,68
1656199025764,CSE 134B,A01,083661,Powell; Thomas Allan,3,0,100,97
1656199031788,CSE 140,A01,083663,Gungor; Onat,9,0,85,76
1656199037812,CSE 140L,A01,083088,Eldon; John,8,0,100,92
1656199043838,CSE 175,A01,083665,Kumar; Rakesh,0,0,25,25
1656199049862,CSE 190,A00,092507,Dubnov; Shlomo,3,0,20,17
1656199055888,ECE 45,A01,083139,Congero; Spencer William,1,0,75,74
1656199061917,ECE 65,A50,083695,Saad; Andrew S,9,0,30,21
1656199061917,ECE 65,A51,095125,Staff,23,0,26,3
1656199067940,ECE 109,A01,091882,Touri; Behrouz,0,1,70,70
1656199073963,ECE 180,A00,083140,Abi Samra; Nicholas Camill,1,0,30,29
1656199073963,ECE 180,B00,083141,Abi Samra; Nicholas Camill,0,4,30,30
1656199079987,MATH 10A,A01,083735,Patchell; Gregory David,0,0,30,30
1656199079987,MATH 10A,A02,083736,Patchell; Gregory David,22,0,30,8
1656199079987,MATH 10A,A03,083737,Patchell; Gregory David,16,0,30,14
1656199086010,MATH 10B,A01,083207,Lim; Seonhee,0,0,34,34
1656199086010,MATH 10B,A02,083208,Lim; Seonhee,7,0,35,28
1656199086010,MATH 10B,A03,093472,Staff,1,0,34,33
1656199086010,MATH 10B,B01,083739,Sinha; Shubham,11,0,30,19
1656199092036,MATH 18,A01,083743,Cinel; Cameron Alexander,7,0,30,23
1656199092036,MATH 18,A02,083744,Cinel; Cameron Alexander,10,0,30,20
1656199092036,MATH 18,A03,083745,Cinel; Cameron Alexander,4,0,30,26
1656199092036,MATH 18,B01,083748,Rideout; David Porter,1,0,36,35
1656199092036,MATH 18,B02,083749,Rideout; David Porter,0,0,36,36
1656199092036,MATH 18,B03,083750,Rideout; David Porter,0,0,36,36
1656199092036,MATH 18,B04,083751,Rideout; David Porter,0,0,36,36
1656199092036,MATH 18,B05,093473,Rideout; David Porter,0,0,36,36
1656199092036,MATH 18,B06,093474,Rideout; David Porter,2,0,36,34
1656199098064,MATH 20A,A01,083754,Zheng; Zequn,11,0,40,29
1656199104087,MATH 20B,A01,083756,Briones; Jor-el Thomas Caparas,0,0,36,36
1656199104087,MATH 20B,A02,083757,Briones; Jor-el Thomas Caparas,0,0,36,36
1656199104087,MATH 20B,A03,093475,Staff,1,0,36,35
1656199110111,MATH 20C,A01,083760,Briones; Jor-el Thomas Caparas,0,0,35,35
1656199110111,MATH 20C,A02,083761,Briones; Jor-el Thomas Caparas,9,1,35,26
1656199110111,MATH 20C,A03,093476,Staff,0,0,35,35
1656199110111,MATH 20C,B01,083762,Bach; Quang Tran,1,0,30,29
1656199116144,MATH 20D,A01,083765,Tran; Brian Kha,1,0,30,29
1656199116144,MATH 20D,A02,083766,Tran; Brian Kha,0,1,30,30
1656199116144,MATH 20D,A03,083767,Tran; Brian Kha,2,0,30,28
1656199122167,MATH 20E,A01,083771,Ganguly; Soumya,3,0,32,29
1656199122167,MATH 20E,A02,083772,Ganguly; Soumya,0,0,32,32
1656199122167,MATH 20E,B01,083773,Ciotti; Benjamin,16,0,35,19
1656199122167,MATH 20E,B02,083774,Ciotti; Benjamin,15,0,35,20
1656199128191,MATH 103A,A01,083777,Greenfeld; Be'Eri,1,0,36,35
1656199128191,MATH 103A,A02,083778,Greenfeld; Be'Eri,1,0,36,35
1656199128191,MATH 103A,A03,093561,Staff,5,0,36,31
1656199128191,MATH 103A,B01,083779,Greenfeld; Be'Eri,9,1,36,27
1656199128191,MATH 103A,B02,083780,Greenfeld; Be'Eri,1,0,36,35
1656199128191,MATH 103A,B03,093562,Staff,0,0,36,36
1656199134215,MATH 105,A01,085443,Carter; Anne Toulson,5,1,35,30
1656199134215,MATH 105,A02,093477,Staff,13,0,35,22
1656199140244,MATH 109,A01,083213,Ganzberger; Geoffrey Michael,0,0,34,34
1656199140244,MATH 109,A02,083214,Ganzberger; Geoffrey Michael,0,0,34,34
1656199140244,MATH 109,A03,093478,Staff,1,0,34,33
1656199140244,MATH 109,B01,083215,Ganzberger; Geoffrey Michael,4,0,32,28
1656199140244,MATH 109,B02,083216,Ganzberger; Geoffrey Michael,1,0,32,31
1656199140244,MATH 109,B03,093479,Staff,4,0,32,28
1656199146272,MATH 142A,A01,083219,Chow; Bennett,1,0,32,31
1656199146272,MATH 142A,A02,083220,Chow; Bennett,8,0,32,24
1656199146272,MATH 142A,A03,093480,Staff,5,0,32,27
1656199146272,MATH 142A,B03,093481,Staff,3,0,32,29
1656199146272,MATH 142A,B04,093558,Staff,6,0,32,26
1656199146272,MATH 142A,B05,093559,Staff,1,0,32,31
1656199152300,MATH 193A,A01,083224,Rotar; Vladimir,0,1,34,34
1656199152300,MATH 193A,A02,083225,Rotar; Vladimir,0,0,34,34
1656199152300,MATH 193A,A03,083781,Rotar; Vladimir,1,0,34,33
1656199152300,MATH 193A,A04,083782,Rotar; Vladimir,6,0,34,28
1656199152300,MATH 193A,A05,093482,Rotar; Vladimir,0,0,34,34
1656199158326,MATH 197,001,091859,McAuley; Julian John,9999,0,9999,0
1656199158326,MATH 197,002,095566,Kedlaya; Kiran S.,9997,0,9999,2
1656199158326,MATH 197,003,095567,Xiao; Ming,9999,0,9999,0
1656199158326,MATH 197,004,095571,Perols; Johan Lars,9998,0,9999,1
1656199165389,COGS 9,A01,083615,Shannon; Kyle Michael,4,0,75,71
1656199171417,COGS 11,A01,083617,Boyle; Mary E. T.,14,0,48,34
1656199177441,COGS 13,A01,083071,Bastos; Amalia Pinkusfeld,4,0,71,67
1656199183467,COGS 14A,A01,092681,Semenuks; Arturs,4,15,100,96
1656199189491,COGS 14B,A01,083073,Cheng; Tzu-Han,7,0,63,56
1656199195513,COGS 17,A01,092677,Semenuks; Arturs,7,0,81,74
1656199201539,COGS 100,A01,083619,Allen; Michael Gordon,2,0,70,68
1656199207560,COGS 101A,A01,083621,Davis; Joshua Daniel,4,0,68,64
1656199213587,COGS 101B,A01,091572,Allen; Michael Gordon,5,0,65,60
1656199219616,COGS 101C,A01,083625,Delgado; Tania,10,0,35,25
1656199225638,COGS 107A,A01,083627,Boyle; Mary E. T.,0,0,60,60
1656199231662,COGS 118A,A01,083075,Gupta; Anjum,7,0,76,69
1656199237689,CSE 3,A50,083646,Miranda; Gregory Joseph,18,0,50,32
1656199243717,CSE 8A,A50,083650,Miranda; Gregory Joseph,3,3,56,53
1656199249744,CSE 11,A01,083080,Cao; Yingjun,1,51,40,39
1656199255768,CSE 12,A01,083652,Krause-Levy; Sophia Louisa,7,3,120,113
1656199261796,CSE 15L,A01,083654,Morris; Justin Loren,2,0,50,48
1656199261796,CSE 15L,A02,083655,Morris; Justin Loren,4,0,50,46
1656199267823,CSE 20,A01,083657,Tran; Khoa Dang,30,0,80,50
1656199273849,CSE 21,A01,095574,Bach; Quang Tran,24,0,48,24
1656199279885,CSE 30,A01,083084,Eldon; John,2,8,80,78
1656199279885,CSE 30,B01,095061,Bhaskar; Nishant,1,2,50,49
1656199285909,CSE 100,A01,083659,Cao; Yingjun,2,20,70,68
1656199291942,CSE 134B,A01,083661,Powell; Thomas Allan,3,0,100,97
1656199297966,CSE 140,A01,083663,Gungor; Onat,9,0,85,76
1656199303991,CSE 140L,A01,083088,Eldon; John,8,0,100,92
1656199310018,CSE 175,A01,083665,Kumar; Rakesh,0,0,25,25
1656199316041,CSE 190,A00,092507,Dubnov; Shlomo,3,0,20,17
1656199322066,ECE 45,A01,083139,Congero; Spencer William,1,0,75,74
1656199328089,ECE 65,A50,083695,Saad; Andrew S,9,0,30,21
1656199328089,ECE 65,A51,095125,Staff,23,0,26,3
1656199334120,ECE 109,A01,091882,Touri; Behrouz,0,1,70,70
1656199340147,ECE 180,A00,083140,Abi Samra; Nicholas Camill,1,0,30,29
1656199340147,ECE 180,B00,083141,Abi Samra; Nicholas Camill,0,4,30,30
1656199346173,MATH 10A,A01,083735,Patchell; Gregory David,0,0,30,30
1656199346173,MATH 10A,A02,083736,Patchell; Gregory David,22,0,30,8
1656199346173,MATH 10A,A03,083737,Patchell; Gregory David,16,0,30,14
1656199352204,MATH 10B,A01,083207,Lim; Seonhee,0,0,34,34
1656199352204,MATH 10B,A02,083208,Lim; Seonhee,7,0,35,28
1656199352204,MATH 10B,A03,093472,Staff,1,0,34,33
1656199352204,MATH 10B,B01,083739,Sinha; Shubham,11,0,30,19
1656199358230,MATH 18,A01,083743,Cinel; Cameron Alexander,7,0,30,23
1656199358230,MATH 18,A02,083744,Cinel; Cameron Alexander,10,0,30,20
1656199358230,MATH 18,A03,083745,Cinel; Cameron Alexander,4,0,30,26
1656199358230,MATH 18,B01,083748,Rideout; David Porter,1,0,36,35
1656199358230,MATH 18,B02,083749,Rideout; David Porter,0,0,36,36
1656199358230,MATH 18,B03,083750,Rideout; David Porter,0,0,36,36
1656199358230,MATH 18,B04,083751,Rideout; David Porter,0,0,36,36
1656199358230,MATH 18,B05,093473,Rideout; David Porter,0,0,36,36
1656199358230,MATH 18,B06,093474,Rideout; David Porter,2,0,36,34
1656199364255,MATH 20A,A01,083754,Zheng; Zequn,11,0,40,29
1656199370350,MATH 20B,A01,083756,Briones; Jor-el Thomas Caparas,0,0,36,36
1656199370350,MATH 20B,A02,083757,Briones; Jor-el Thomas Caparas,0,0,36,36
1656199370350,MATH 20B,A03,093475,Staff,1,0,36,35
1656199376379,MATH 20C,A01,083760,Briones; Jor-el Thomas Caparas,0,0,35,35
1656199376379,MATH 20C,A02,083761,Briones; Jor-el Thomas Caparas,9,1,35,26
1656199376379,MATH 20C,A03,093476,Staff,0,0,35,35
1656199376379,MATH 20C,B01,083762,Bach; Quang Tran,1,0,30,29
1656199382403,MATH 20D,A01,083765,Tran; Brian Kha,1,0,30,29
1656199382403,MATH 20D,A02,083766,Tran; Brian Kha,0,1,30,30
1656199382403,MATH 20D,A03,083767,Tran; Brian Kha,2,0,30,28
1656199388427,MATH 20E,A01,083771,Ganguly; Soumya,3,0,32,29
1656199388427,MATH 20E,A02,083772,Ganguly; Soumya,0,0,32,32
1656199388427,MATH 20E,B01,083773,Ciotti; Benjamin,16,0,35,19
1656199388427,MATH 20E,B02,083774,Ciotti; Benjamin,15,0,35,20
1656199394455,MATH 103A,A01,083777,Greenfeld; Be'Eri,1,0,36,35
1656199394455,MATH 103A,A02,083778,Greenfeld; Be'Eri,1,0,36,35
1656199394455,MATH 103A,A03,093561,Staff,5,0,36,31
1656199394455,MATH 103A,B01,083779,Greenfeld; Be'Eri,9,1,36,27
1656199394455,MATH 103A,B02,083780,Greenfeld; Be'Eri,1,0,36,35
1656199394455,MATH 103A,B03,093562,Staff,0,0,36,36
1656199400482,MATH 105,A01,085443,Carter; Anne Toulson,5,1,35,30
1656199400482,MATH 105,A02,093477,Staff,13,0,35,22
1656199406506,MATH 109,A01,083213,Ganzberger; Geoffrey Michael,0,0,34,34
1656199406506,MATH 109,A02,083214,Ganzberger; Geoffrey Michael,0,0,34,34
1656199406506,MATH 109,A03,093478,Staff,1,0,34,33
1656199406506,MATH 109,B01,083215,Ganzberger; Geoffrey Michael,4,0,32,28
1656199406506,MATH 109,B02,083216,Ganzberger; Geoffrey Michael,1,0,32,31
1656199406506,MATH 109,B03,093479,Staff,4,0,32,28
1656199412535,MATH 142A,A01,083219,Chow; Bennett,1,0,32,31
1656199412535,MATH 142A,A02,083220,Chow; Bennett,8,0,32,24
1656199412535,MATH 142A,A03,093480,Staff,5,0,32,27
1656199412535,MATH 142A,B03,093481,Staff,3,0,32,29
1656199412535,MATH 142A,B04,093558,Staff,6,0,32,26
1656199412535,MATH 142A,B05,093559,Staff,1,0,32,31
1656199418565,MATH 193A,A01,083224,Rotar; Vladimir,0,1,34,34
1656199418565,MATH 193A,A02,083225,Rotar; Vladimir,0,0,34,34
1656199418565,MATH 193A,A03,083781,Rotar; Vladimir,1,0,34,33
1656199418565,MATH 193A,A04,083782,Rotar; Vladimir,6,0,34,28
1656199418565,MATH 193A,A05,093482,Rotar; Vladimir,0,0,34,34
1656199424587,MATH 197,001,091859,McAuley; Julian John,9999,0,9999,0
1656199424587,MATH 197,002,095566,Kedlaya; Kiran S.,9997,0,9999,2
1656199424587,MATH 197,003,095567,Xiao; Ming,9999,0,9999,0
1656199424587,MATH 197,004,095571,Perols; Johan Lars,9998,0,9999,1
1656199431641,COGS 9,A01,083615,Shannon; Kyle Michael,4,0,75,71
1656199437678,COGS 11,A01,083617,Boyle; Mary E. T.,14,0,48,34
1656199443700,COGS 13,A01,083071,Bastos; Amalia Pinkusfeld,4,0,71,67
1656199449720,COGS 14A,A01,092681,Semenuks; Arturs,4,15,100,96
1656199455744,COGS 14B,A01,083073,Cheng; Tzu-Han,7,0,63,56
1656199461768,COGS 17,A01,092677,Semenuks; Arturs,7,0,81,74
1656199467789,COGS 100,A01,083619,Allen; Michael Gordon,2,0,70,68
1656199473812,COGS 101A,A01,083621,Davis; Joshua Daniel,4,0,68,64
1656199479835,COGS 101B,A01,091572,Allen; Michael Gordon,5,0,65,60
1656199485858,COGS 101C,A01,083625,Delgado; Tania,10,0,35,25
1656199491882,COGS 107A,A01,083627,Boyle; Mary E. T.,0,0,60,60
1656199497908,COGS 118A,A01,083075,Gupta; Anjum,7,0,76,69
1656199503936,CSE 3,A50,083646,Miranda; Gregory Joseph,18,0,50,32
1656199509961,CSE 8A,A50,083650,Miranda; Gregory Joseph,3,3,56,53
1656199515984,CSE 11,A01,083080,Cao; Yingjun,1,51,40,39
1656199522011,CSE 12,A01,083652,Krause-Levy; Sophia Louisa,7,3,120,113
1656199528035,CSE 15L,A01,083654,Morris; Justin Loren,2,0,50,48
1656199528035,CSE 15L,A02,083655,Morris; Justin Loren,4,0,50,46
1656199534062,CSE 20,A01,083657,Tran; Khoa Dang,30,0,80,50
1656199540085,CSE 21,A01,095574,Bach; Quang Tran,24,0,48,24
1656199546112,CSE 30,A01,083084,Eldon; John,2,8,80,78
1656199546112,CSE 30,B01,095061,Bhaskar; Nishant,1,2,50,49
1656199552138,CSE 100,A01,083659,Cao; Yingjun,2,20,70,68
1656199558165,CSE 134B,A01,083661,Powell; Thomas Allan,3,0,100,97
1656199564189,CSE 140,A01,083663,Gungor; Onat,9,0,85,76
1656199570212,CSE 140L,A01,083088,Eldon; John,8,0,100,92
1656199576235,CSE 175,A01,083665,Kumar; Rakesh,0,0,25,25
1656199582258,CSE 190,A00,092507,Dubnov; Shlomo,3,0,20,17
1656199588285,ECE 45,A01,083139,Congero; Spencer William,1,0,75,74
1656199594308,ECE 65,A50,083695,Saad; Andrew S,9,0,30,21
1656199594308,ECE 65,A51,095125,Staff,23,0,26,3
1656199600332,ECE 109,A01,091882,Touri; Behrouz,0,1,70,70
1656199606356,ECE 180,A00,083140,Abi Samra; Nicholas Camill,1,0,30,29
1656199606356,ECE 180,B00,083141,Abi Samra; Nicholas Camill,0,4,30,30
1656199612380,MATH 10A,A01,083735,Patchell; Gregory David,0,0,30,30
1656199612380,MATH 10A,A02,083736,Patchell; Gregory David,22,0,30,8
1656199612380,MATH 10A,A03,083737,Patchell; Gregory David,16,0,30,14
1656199618405,MATH 10B,A01,083207,Lim; Seonhee,0,0,34,34
1656199618405,MATH 10B,A02,083208,Lim; Seonhee,7,0,35,28
1656199618405,MATH 10B,A03,093472,Staff,1,0,34,33
1656199618405,MATH 10B,B01,083739,Sinha; Shubham,11,0,30,19
1656199624429,MATH 18,A01,083743,Cinel; Cameron Alexander,7,0,30,23
1656199624429,MATH 18,A02,083744,Cinel; Cameron Alexander,10,0,30,20
1656199624429,MATH 18,A03,083745,Cinel; Cameron Alexander,4,0,30,26
1656199624429,MATH 18,B01,083748,Rideout; David Porter,1,0,36,35
1656199624429,MATH 18,B02,083749,Rideout; David Porter,0,0,36,36
1656199624429,MATH 18,B03,083750,Rideout; David Porter,0,0,36,36
1656199624429,MATH 18,B04,083751,Rideout; David Porter,0,0,36,36
1656199624429,MATH 18,B05,093473,Rideout; David Porter,0,0,36,36
1656199624429,MATH 18,B06,093474,Rideout; David Porter,2,0,36,34
1656199630456,MATH 20A,A01,083754,Zheng; Zequn,11,0,40,29
1656199636479,MATH 20B,A01,083756,Briones; Jor-el Thomas Caparas,0,0,36,36
1656199636479,MATH 20B,A02,083757,Briones; Jor-el Thomas Caparas,0,0,36,36
1656199636479,MATH 20B,A03,093475,Staff,1,0,36,35
1656199642501,MATH 20C,A01,083760,Briones; Jor-el Thomas Caparas,0,0,35,35
1656199642501,MATH 20C,A02,083761,Briones; Jor-el Thomas Caparas,9,1,35,26
1656199642501,MATH 20C,A03,093476,Staff,0,0,35,35
1656199642501,MATH 20C,B01,083762,Bach; Quang Tran,1,0,30,29
1656199648528,MATH 20D,A01,083765,Tran; Brian Kha,1,0,30,29
1656199648528,MATH 20D,A02,083766,Tran; Brian Kha,0,1,30,30
1656199648528,MATH 20D,A03,083767,Tran; Brian Kha,2,0,30,28
1656199654555,MATH 20E,A01,083771,Ganguly; Soumya,3,0,32,29
1656199654555,MATH 20E,A02,083772,Ganguly; Soumya,0,0,32,32
1656199654555,MATH 20E,B01,083773,Ciotti; Benjamin,16,0,35,19
1656199654555,MATH 20E,B02,083774,Ciotti; Benjamin,15,0,35,20
1656199660583,MATH 103A,A01,083777,Greenfeld; Be'Eri,1,0,36,35
1656199660583,MATH 103A,A02,083778,Greenfeld; Be'Eri,1,0,36,35
1656199660583,MATH 103A,A03,093561,Staff,5,0,36,31
1656199660583,MATH 103A,B01,083779,Greenfeld; Be'Eri,9,1,36,27
1656199660583,MATH 103A,B02,083780,Greenfeld; Be'Eri,1,0,36,35
1656199660583,MATH 103A,B03,093562,Staff,0,0,36,36
1656199666605,MATH 105,A01,085443,Carter; Anne Toulson,5,1,35,30
1656199666605,MATH 105,A02,093477,Staff,13,0,35,22
1656199672634,MATH 109,A01,083213,Ganzberger; Geoffrey Michael,0,0,34,34
1656199672634,MATH 109,A02,083214,Ganzberger; Geoffrey Michael,0,0,34,34
1656199672634,MATH 109,A03,093478,Staff,1,0,34,33
1656199672634,MATH 109,B01,083215,Ganzberger; Geoffrey Michael,4,0,32,28
1656199672634,MATH 109,B02,083216,Ganzberger; Geoffrey Michael,1,0,32,31
1656199672634,MATH 109,B03,093479,Staff,4,0,32,28
1656199678658,MATH 142A,A01,083219,Chow; Bennett,1,0,32,31
1656199678658,MATH 142A,A02,083220,Chow; Bennett,8,0,32,24
1656199678658,MATH 142A,A03,093480,Staff,5,0,32,27
1656199678658,MATH 142A,B03,093481,Staff,3,0,32,29
1656199678658,MATH 142A,B04,093558,Staff,6,0,32,26
1656199678658,MATH 142A,B05,093559,Staff,1,0,32,31
1656199684681,MATH 193A,A01,083224,Rotar; Vladimir,0,1,34,34
1656199684681,MATH 193A,A02,083225,Rotar; Vladimir,0,0,34,34
1656199684681,MATH 193A,A03,083781,Rotar; Vladimir,1,0,34,33
1656199684681,MATH 193A,A04,083782,Rotar; Vladimir,6,0,34,28
1656199684681,MATH 193A,A05,093482,Rotar; Vladimir,0,0,34,34
1656199690705,MATH 197,001,091859,McAuley; Julian John,9999,0,9999,0
1656199690705,MATH 197,002,095566,Kedlaya; Kiran S.,9997,0,9999,2
1656199690705,MATH 197,003,095567,Xiao; Ming,9999,0,9999,0
1656199690705,MATH 197,004,095571,Perols; Johan Lars,9998,0,9999,1
1656199697768,COGS 9,A01,083615,Shannon; Kyle Michael,4,0,75,71
1656199703796,COGS 11,A01,083617,Boyle; Mary E. T.,14,0,48,34
1656199709823,COGS 13,A01,083071,Bastos; Amalia Pinkusfeld,4,0,71,67
1656199715851,COGS 14A,A01,092681,Semenuks; Arturs,4,15,100,96
1656199721876,COGS 14B,A01,083073,Cheng; Tzu-Han,7,0,63,56
1656199727903,COGS 17,A01,092677,Semenuks; Arturs,7,0,81,74
1656199733929,COGS 100,A01,083619,Allen; Michael Gordon,2,0,70,68
1656199739951,COGS 101A,A01,083621,Davis; Joshua Daniel,4,0,68,64
1656199745972,COGS 101B,A01,091572,Allen; Michael Gordon,5,0,65,60
1656199751994,COGS 101C,A01,083625,Delgado; Tania,10,0,35,25
1656199758018,COGS 107A,A01,083627,Boyle; Mary E. T.,0,0,60,60
1656199764045,COGS 118A,A01,083075,Gupta; Anjum,7,0,76,69
1656199770071,CSE 3,A50,083646,Miranda; Gregory Joseph,18,0,50,32
1656199776102,CSE 8A,A50,083650,Miranda; Gregory Joseph,3,3,56,53
1656199782128,CSE 11,A01,083080,Cao; Yingjun,1,51,40,39
1656199788155,CSE 12,A01,083652,Krause-Levy; Sophia Louisa,7,3,120,113
1656199794179,CSE 15L,A01,083654,Morris; Justin Loren,2,0,50,48
1656199794179,CSE 15L,A02,083655,Morris; Justin Loren,4,0,50,46
1656199800216,CSE 20,A01,083657,Tran; Khoa Dang,30,0,80,50
1656199806239,CSE 21,A01,095574,Bach; Quang Tran,24,0,48,24
1656199812267,CSE 30,A01,083084,Eldon; John,2,8,80,78
1656199812267,CSE 30,B01,095061,Bhaskar; Nishant,1,2,50,49
1656199818289,CSE 100,A01,083659,Cao; Yingjun,2,20,70,68
1656199824316,CSE 134B,A01,083661,Powell; Thomas Allan,3,0,100,97
1656199830338,CSE 140,A01,083663,Gungor; Onat,9,0,85,76
1656199836366,CSE 140L,A01,083088,Eldon; John,8,0,100,92
1656199842388,CSE 175,A01,083665,Kumar; Rakesh,0,0,25,25
1656199848419,CSE 190,A00,092507,Dubnov; Shlomo,3,0,20,17
1656199854445,ECE 45,A01,083139,Congero; Spencer William,1,0,75,74
1656199860471,ECE 65,A50,083695,Saad; Andrew S,9,0,30,21
1656199860471,ECE 65,A51,095125,Staff,23,0,26,3
1656199866499,ECE 109,A01,091882,Touri; Behrouz,0,1,70,70
1656199872522,ECE 180,A00,083140,Abi Samra; Nicholas Camill,1,0,30,29
1656199872522,ECE 180,B00,083141,Abi Samra; Nicholas Camill,0,4,30,30
1656199878547,MATH 10A,A01,083735,Patchell; Gregory David,0,0,30,30
1656199878547,MATH 10A,A02,083736,Patchell; Gregory David,22,0,30,8
1656199878547,MATH 10A,A03,083737,Patchell; Gregory David,16,0,30,14
1656199884571,MATH 10B,A01,083207,Lim; Seonhee,0,0,34,34
1656199884571,MATH 10B,A02,083208,Lim; Seonhee,7,0,35,28
1656199884571,MATH 10B,A03,093472,Staff,1,0,34,33
1656199884571,MATH 10B,B01,083739,Sinha; Shubham,11,0,30,19
1656199890602,MATH 18,A01,083743,Cinel; Cameron Alexander,7,0,30,23
1656199890602,MATH 18,A02,083744,Cinel; Cameron Alexander,10,0,30,20
1656199890602,MATH 18,A03,083745,Cinel; Cameron Alexander,4,0,30,26
1656199890602,MATH 18,B01,083748,Rideout; David Porter,1,0,36,35
1656199890602,MATH 18,B02,083749,Rideout; David Porter,0,0,36,36
1656199890602,MATH 18,B03,083750,Rideout; David Porter,0,0,36,36
1656199890602,MATH 18,B04,083751,Rideout; David Porter,0,0,36,36
1656199890602,MATH 18,B05,093473,Rideout; David Porter,0,0,36,36
1656199890602,MATH 18,B06,093474,Rideout; David Porter,2,0,36,34
1656199896631,MATH 20A,A01,083754,Zheng; Zequn,11,0,40,29
1656199902655,MATH 20B,A01,083756,Briones; Jor-el Thomas Caparas,0,0,36,36
1656199902655,MATH 20B,A02,083757,Briones; Jor-el Thomas Caparas,0,0,36,36
1656199902655,MATH 20B,A03,093475,Staff,1,0,36,35
1656199908679,MATH 20C,A01,083760,Briones; Jor-el Thomas Caparas,0,0,35,35
1656199908679,MATH 20C,A02,083761,Briones; Jor-el Thomas Caparas,9,1,35,26
1656199908679,MATH 20C,A03,093476,Staff,0,0,35,35
1656199908679,MATH 20C,B01,083762,Bach; Quang Tran,1,0,30,29
1656199914703,MATH 20D,A01,083765,Tran; Brian Kha,1,0,30,29
1656199914703,MATH 20D,A02,083766,Tran; Brian Kha,0,1,30,30
1656199914703,MATH 20D,A03,083767,Tran; Brian Kha,2,0,30,28
1656199920726,MATH 20E,A01,083771,Ganguly; Soumya,3,0,32,29
1656199920726,MATH 20E,A02,083772,Ganguly; Soumya,0,0,32,32
1656199920726,MATH 20E,B01,083773,Ciotti; Benjamin,16,0,35,19
1656199920726,MATH 20E,B02,083774,Ciotti; Benjamin,15,0,35,20
1656199926749,MATH 103A,A01,083777,Greenfeld; Be'Eri,1,0,36,35
1656199926749,MATH 103A,A02,083778,Greenfeld; Be'Eri,1,0,36,35
1656199926749,MATH 103A,A03,093561,Staff,5,0,36,31
1656199926749,MATH 103A,B01,083779,Greenfeld; Be'Eri,9,1,36,27
1656199926749,MATH 103A,B02,083780,Greenfeld; Be'Eri,1,0,36,35
1656199926749,MATH 103A,B03,093562,Staff,0,0,36,36
1656199932774,MATH 105,A01,085443,Carter; Anne Toulson,5,1,35,30
1656199932774,MATH 105,A02,093477,Staff,13,0,35,22
1656199938810,MATH 109,A01,083213,Ganzberger; Geoffrey Michael,0,0,34,34
1656199938810,MATH 109,A02,083214,Ganzberger; Geoffrey Michael,0,0,34,34
1656199938810,MATH 109,A03,093478,Staff,1,0,34,33
1656199938810,MATH 109,B01,083215,Ganzberger; Geoffrey Michael,4,0,32,28
1656199938810,MATH 109,B02,083216,Ganzberger; Geoffrey Michael,1,0,32,31
1656199938810,MATH 109,B03,093479,Staff,4,0,32,28
1656199944853,MATH 142A,A01,083219,Chow; Bennett,1,0,32,31
1656199944853,MATH 142A,A02,083220,Chow; Bennett,8,0,32,24
1656199944853,MATH 142A,A03,093480,Staff,5,0,32,27
1656199944853,MATH 142A,B03,093481,Staff,3,0,32,29
1656199944853,MATH 142A,B04,093558,Staff,6,0,32,26
1656199944853,MATH 142A,B05,093559,Staff,1,0,32,31
1656199950874,MATH 193A,A01,083224,Rotar; Vladimir,0,1,34,34
1656199950874,MATH 193A,A02,083225,Rotar; Vladimir,0,0,34,34
1656199950874,MATH 193A,A03,083781,Rotar; Vladimir,1,0,34,33
1656199950874,MATH 193A,A04,083782,Rotar; Vladimir,6,0,34,28
1656199950874,MATH 193A,A05,093482,Rotar; Vladimir,0,0,34,34
1656199956902,MATH 197,001,091859,McAuley; Julian John,9999,0,9999,0
1656199956902,MATH 197,002,095566,Kedlaya; Kiran S.,9997,0,9999,2
1656199956902,MATH 197,003,095567,Xiao; Ming,9999,0,9999,0
1656199956902,MATH 197,004,095571,Perols; Johan Lars,9998,0,9999,1
1656199964054,COGS 9,A01,083615,Shannon; Kyle Michael,4,0,75,71
1656199970077,COGS 11,A01,083617,Boyle; Mary E. T.,14,0,48,34
1656199976103,COGS 13,A01,083071,Bastos; Amalia Pinkusfeld,4,0,71,67
1656199982131,COGS 14A,A01,092681,Semenuks; Arturs,4,15,100,96
1656199988162,COGS 14B,A01,083073,Cheng; Tzu-Han,7,0,63,56
1656199994188,COGS 17,A01,092677,Semenuks; Arturs,7,0,81,74
1656200000223,COGS 100,A01,083619,Allen; Michael Gordon,2,0,70,68
1656200006245,COGS 101A,A01,083621,Davis; Joshua Daniel,4,0,68,64
1656200012267,COGS 101B,A01,091572,Allen; Michael Gordon,5,0,65,60
1656200018291,COGS 101C,A01,083625,Delgado; Tania,10,0,35,25
1656200024315,COGS 107A,A01,083627,Boyle; Mary E. T.,0,0,60,60
1656200030340,COGS 118A,A01,083075,Gupta; Anjum,7,0,76,69
1656200036364,CSE 3,A50,083646,Miranda; Gregory Joseph,18,0,50,32
1656200042393,CSE 8A,A50,083650,Miranda; Gregory Joseph,3,3,56,53
1656200048416,CSE 11,A01,083080,Cao; Yingjun,1,51,40,39
1656200054443,CSE 12,A01,083652,Krause-Levy; Sophia Louisa,7,3,120,113
1656200060466,CSE 15L,A01,083654,Morris; Justin Loren,2,0,50,48
1656200060466,CSE 15L,A02,083655,Morris; Justin Loren,4,0,50,46
1656200066489,CSE 20,A01,083657,Tran; Khoa Dang,30,0,80,50
1656200072511,CSE 21,A01,095574,Bach; Quang Tran,24,0,48,24
1656200078537,CSE 30,A01,083084,Eldon; John,2,8,80,78
1656200078537,CSE 30,B01,095061,Bhaskar; Nishant,1,2,50,49
1656200084561,CSE 100,A01,083659,Cao; Yingjun,2,20,70,68
1656200090585,CSE 134B,A01,083661,Powell; Thomas Allan,3,0,100,97
1656200096612,CSE 140,A01,083663,Gungor; Onat,9,0,85,76
1656200102639,CSE 140L,A01,083088,Eldon; John,8,0,100,92
1656200108661,CSE 175,A01,083665,Kumar; Rakesh,0,0,25,25
1656200114684,CSE 190,A00,092507,Dubnov; Shlomo,3,0,20,17
1656200120710,ECE 45,A01,083139,Congero; Spencer William,1,0,75,74
1656200126733,ECE 65,A50,083695,Saad; Andrew S,9,0,30,21
1656200126733,ECE 65,A51,095125,Staff,23,0,26,3
1656200132757,ECE 109,A01,091882,Touri; Behrouz,0,1,70,70
1656200138782,ECE 180,A00,083140,Abi Samra; Nicholas Camill,1,0,30,29
1656200138782,ECE 180,B00,083141,Abi Samra; Nicholas Camill,0,4,30,30
1656200144809,MATH 10A,A01,083735,Patchell; Gregory David,0,0,30,30
1656200144809,MATH 10A,A02,083736,Patchell; Gregory David,22,0,30,8
1656200144809,MATH 10A,A03,083737,Patchell; Gregory David,16,0,30,14
1656200150842,MATH 10B,A01,083207,Lim; Seonhee,0,0,34,34
1656200150842,MATH 10B,A02,083208,Lim; Seonhee,7,0,35,28
1656200150842,MATH 10B,A03,093472,Staff,1,0,34,33
1656200150842,MATH 10B,B01,083739,Sinha; Shubham,11,0,30,19
1656200156873,MATH 18,A01,083743,Cinel; Cameron Alexander,7,0,30,23
1656200156873,MATH 18,A02,083744,Cinel; Cameron Alexander,10,0,30,20
1656200156873,MATH 18,A03,083745,Cinel; Cameron Alexander,4,0,30,26
1656200156873,MATH 18,B01,083748,Rideout; David Porter,1,0,36,35
1656200156873,MATH 18,B02,083749,Rideout; David Porter,0,0,36,36
1656200156873,MATH 18,B03,083750,Rideout; David Porter,0,0,36,36
1656200156873,MATH 18,B04,083751,Rideout; David Porter,0,0,36,36
1656200156873,MATH 18,B05,093473,Rideout; David Porter,0,0,36,36
1656200156873,MATH 18,B06,093474,Rideout; David Porter,3,0,36,33
1656200162896,MATH 20A,A01,083754,Zheng; Zequn,11,0,40,29
1656200168920,MATH 20B,A01,083756,Briones; Jor-el Thomas Caparas,0,0,36,36
1656200168920,MATH 20B,A02,083757,Briones; Jor-el Thomas Caparas,0,0,36,36
1656200168920,MATH 20B,A03,093475,Staff,1,0,36,35
1656200174944,MATH 20C,A01,083760,Briones; Jor-el Thomas Caparas,0,0,35,35
1656200174944,MATH 20C,A02,083761,Briones; Jor-el Thomas Caparas,9,1,35,26
1656200174944,MATH 20C,A03,093476,Staff,0,0,35,35
1656200174944,MATH 20C,B01,083762,Bach; Quang Tran,1,0,30,29
1656200180969,MATH 20D,A01,083765,Tran; Brian Kha,1,0,30,29
1656200180969,MATH 20D,A02,083766,Tran; Brian Kha,0,1,30,30
1656200180969,MATH 20D,A03,083767,Tran; Brian Kha,2,0,30,28
1656200186999,MATH 20E,A01,083771,Ganguly; Soumya,3,0,32,29
1656200186999,MATH 20E,A02,083772,Ganguly; Soumya,0,0,32,32
1656200186999,MATH 20E,B01,083773,Ciotti; Benjamin,16,0,35,19
1656200186999,MATH 20E,B02,083774,Ciotti; Benjamin,15,0,35,20
1656200193024,MATH 103A,A01,083777,Greenfeld; Be'Eri,1,0,36,35
1656200193024,MATH 103A,A02,083778,Greenfeld; Be'Eri,1,0,36,35
1656200193024,MATH 103A,A03,093561,Staff,5,0,36,31
1656200193024,MATH 103A,B01,083779,Greenfeld; Be'Eri,9,1,36,27
1656200193024,MATH 103A,B02,083780,Greenfeld; Be'Eri,1,0,36,35
1656200193024,MATH 103A,B03,093562,Staff,0,0,36,36
1656200199047,MATH 105,A01,085443,Carter; Anne Toulson,5,1,35,30
1656200199047,MATH 105,A02,093477,Staff,13,0,35,22
1656200205076,MATH 109,A01,083213,Ganzberger; Geoffrey Michael,0,0,34,34
1656200205076,MATH 109,A02,083214,Ganzberger; Geoffrey Michael,0,0,34,34
1656200205076,MATH 109,A03,093478,Staff,1,0,34,33
1656200205076,MATH 109,B01,083215,Ganzberger; Geoffrey Michael,4,0,32,28
1656200205076,MATH 109,B02,083216,Ganzberger; Geoffrey Michael,1,0,32,31
1656200205076,MATH 109,B03,093479,Staff,4,0,32,28
1656200211099,MATH 142A,A01,083219,Chow; Bennett,1,0,32,31
1656200211099,MATH 142A,A02,083220,Chow; Bennett,8,0,32,24
1656200211099,MATH 142A,A03,093480,Staff,5,0,32,27
1656200211099,MATH 142A,B03,093481,Staff,3,0,32,29
1656200211099,MATH 142A,B04,093558,Staff,6,0,32,26
1656200211099,MATH 142A,B05,093559,Staff,1,0,32,31
1656200217123,MATH 193A,A01,083224,Rotar; Vladimir,0,1,34,34
1656200217123,MATH 193A,A02,083225,Rotar; Vladimir,0,0,34,34
1656200217123,MATH 193A,A03,083781,Rotar; Vladimir,1,0,34,33
1656200217123,MATH 193A,A04,083782,Rotar; Vladimir,6,0,34,28
1656200217123,MATH 193A,A05,093482,Rotar; Vladimir,0,0,34,34
1656200223150,MATH 197,001,091859,McAuley; Julian John,9999,0,9999,0
1656200223150,MATH 197,002,095566,Kedlaya; Kiran S.,9997,0,9999,2
1656200223150,MATH 197,003,095567,Xiao; Ming,9999,0,9999,0
1656200223150,MATH 197,004,095571,Perols; Johan Lars,9998,0,9999,1
1656200230210,COGS 9,A01,083615,Shannon; Kyle Michael,4,0,75,71
1656200236234,COGS 11,A01,083617,Boyle; Mary E. T.,14,0,48,34
1656200242261,COGS 13,A01,083071,Bastos; Amalia Pinkusfeld,4,0,71,67
1656200248289,COGS 14A,A01,092681,Semenuks; Arturs,4,15,100,96
1656200254314,COGS 14B,A01,083073,Cheng; Tzu-Han,7,0,63,56
1656200260346,COGS 17,A01,092677,Semenuks; Arturs,7,0,81,74
1656200266368,COGS 100,A01,083619,Allen; Michael Gordon,2,0,70,68
1656200272393,COGS 101A,A01,083621,Davis; Joshua Daniel,4,0,68,64
1656200278416,COGS 101B,A01,091572,Allen; Michael Gordon,5,0,65,60
1656200284442,COGS 101C,A01,083625,Delgado; Tania,10,0,35,25
1656200290465,COGS 107A,A01,083627,Boyle; Mary E. T.,0,0,60,60
1656200296487,COGS 118A,A01,083075,Gupta; Anjum,7,0,76,69
1656200302515,CSE 3,A50,083646,Miranda; Gregory Joseph,18,0,50,32
1656200308537,CSE 8A,A50,083650,Miranda; Gregory Joseph,3,3,56,53
1656200314561,CSE 11,A01,083080,Cao; Yingjun,1,51,40,39
1656200320587,CSE 12,A01,083652,Krause-Levy; Sophia Louisa,7,3,120,113
1656200326611,CSE 15L,A01,083654,Morris; Justin Loren,2,0,50,48
1656200326611,CSE 15L,A02,083655,Morris; Justin Loren,4,0,50,46
1656200332637,CSE 20,A01,083657,Tran; Khoa Dang,30,0,80,50
1656200338663,CSE 21,A01,095574,Bach; Quang Tran,24,0,48,24
1656200344688,CSE 30,A01,083084,Eldon; John,2,8,80,78
1656200344688,CSE 30,B01,095061,Bhaskar; Nishant,1,2,50,49
1656200350710,CSE 100,A01,083659,Cao; Yingjun,2,20,70,68
1656200356740,CSE 134B,A01,083661,Powell; Thomas Allan,3,0,100,97
1656200362763,CSE 140,A01,083663,Gungor; Onat,9,0,85,76
1656200368786,CSE 140L,A01,083088,Eldon; John,8,0,100,92
1656200374809,CSE 175,A01,083665,Kumar; Rakesh,0,0,25,25
1656200380833,CSE 190,A00,092507,Dubnov; Shlomo,3,0,20,17
1656200386860,ECE 45,A01,083139,Congero; Spencer William,1,0,75,74
1656200392888,ECE 65,A50,083695,Saad; Andrew S,9,0,30,21
1656200392888,ECE 65,A51,095125,Staff,23,0,26,3
1656200398912,ECE 109,A01,091882,Touri; Behrouz,0,1,70,70
1656200404936,ECE 180,A00,083140,Abi Samra; Nicholas Camill,1,0,30,29
1656200404936,ECE 180,B00,083141,Abi Samra; Nicholas Camill,0,4,30,30
1656200410960,MATH 10A,A01,083735,Patchell; Gregory David,0,0,30,30
1656200410960,MATH 10A,A02,083736,Patchell; Gregory David,22,0,30,8
1656200410960,MATH 10A,A03,083737,Patchell; Gregory David,16,0,30,14
1656200416986,MATH 10B,A01,083207,Lim; Seonhee,0,0,34,34
1656200416986,MATH 10B,A02,083208,Lim; Seonhee,7,0,35,28
1656200416986,MATH 10B,A03,093472,Staff,1,0,34,33
1656200416986,MATH 10B,B01,083739,Sinha; Shubham,11,0,30,19
1656200423018,MATH 18,A01,083743,Cinel; Cameron Alexander,7,0,30,23
1656200423018,MATH 18,A02,083744,Cinel; Cameron Alexander,10,0,30,20
1656200423018,MATH 18,A03,083745,Cinel; Cameron Alexander,4,0,30,26
1656200423018,MATH 18,B01,083748,Rideout; David Porter,1,0,36,35
1656200423018,MATH 18,B02,083749,Rideout; David Porter,0,0,36,36
1656200423018,MATH 18,B03,083750,Rideout; David Porter,0,0,36,36
1656200423018,MATH 18,B04,083751,Rideout; David Porter,0,0,36,36
1656200423018,MATH 18,B05,093473,Rideout; David Porter,0,0,36,36
1656200423018,MATH 18,B06,093474,Rideout; David Porter,3,0,36,33
1656200429051,MATH 20A,A01,083754,Zheng; Zequn,11,0,40,29
1656200435076,MATH 20B,A01,083756,Briones; Jor-el Thomas Caparas,0,0,36,36
1656200435076,MATH 20B,A02,083757,Briones; Jor-el Thomas Caparas,0,0,36,36
1656200435076,MATH 20B,A03,093475,Staff,1,0,36,35
1656200441117,MATH 20C,A01,083760,Briones; Jor-el Thomas Caparas,0,0,35,35
1656200441117,MATH 20C,A02,083761,Briones; Jor-el Thomas Caparas,9,1,35,26
1656200441117,MATH 20C,A03,093476,Staff,0,0,35,35
1656200441117,MATH 20C,B01,083762,Bach; Quang Tran,1,0,30,29
1656200447142,MATH 20D,A01,083765,Tran; Brian Kha,1,0,30,29
1656200447142,MATH 20D,A02,083766,Tran; Brian Kha,0,1,30,30
1656200447142,MATH 20D,A03,083767,Tran; Brian Kha,2,0,30,28
1656200453170,MATH 20E,A01,083771,Ganguly; Soumya,3,0,32,29
1656200453170,MATH 20E,A02,083772,Ganguly; Soumya,0,0,32,32
1656200453170,MATH 20E,B01,083773,Ciotti; Benjamin,16,0,35,19
1656200453170,MATH 20E,B02,083774,Ciotti; Benjamin,15,0,35,20
1656200459195,MATH 103A,A01,083777,Greenfeld; Be'Eri,1,0,36,35
1656200459195,MATH 103A,A02,083778,Greenfeld; Be'Eri,1,0,36,35
1656200459195,MATH 103A,A03,093561,Staff,5,0,36,31
1656200459195,MATH 103A,B01,083779,Greenfeld; Be'Eri,9,1,36,27
1656200459195,MATH 103A,B02,083780,Greenfeld; Be'Eri,1,0,36,35
1656200459195,MATH 103A,B03,093562,Staff,0,0,36,36
1656200465229,MATH 105,A01,085443,Carter; Anne Toulson,5,1,35,30
1656200465229,MATH 105,A02,093477,Staff,13,0,35,22
1656200471257,MATH 109,A01,083213,Ganzberger; Geoffrey Michael,0,0,34,34
1656200471257,MATH 109,A02,083214,Ganzberger; Geoffrey Michael,0,0,34,34
1656200471257,MATH 109,A03,093478,Staff,1,0,34,33
1656200471257,MATH 109,B01,083215,Ganzberger; Geoffrey Michael,4,0,32,28
1656200471257,MATH 109,B02,083216,Ganzberger; Geoffrey Michael,1,0,32,31
1656200471257,MATH 109,B03,093479,Staff,4,0,32,28
1656200477281,MATH 142A,A01,083219,Chow; Bennett,1,0,32,31
1656200477281,MATH 142A,A02,083220,Chow; Bennett,8,0,32,24
1656200477281,MATH 142A,A03,093480,Staff,5,0,32,27
1656200477281,MATH 142A,B03,093481,Staff,3,0,32,29
1656200477281,MATH 142A,B04,093558,Staff,6,0,32,26
1656200477281,MATH 142A,B05,093559,Staff,1,0,32,31
1656200483306,MATH 193A,A01,083224,Rotar; Vladimir,0,1,34,34
1656200483306,MATH 193A,A02,083225,Rotar; Vladimir,0,0,34,34
1656200483306,MATH 193A,A03,083781,Rotar; Vladimir,1,0,34,33
1656200483306,MATH 193A,A04,083782,Rotar; Vladimir,6,0,34,28
1656200483306,MATH 193A,A05,093482,Rotar; Vladimir,0,0,34,34
1656200489329,MATH 197,001,091859,McAuley; Julian John,9999,0,9999,0
1656200489329,MATH 197,002,095566,Kedlaya; Kiran S.,9997,0,9999,2
1656200489329,MATH 197,003,095567,Xiao; Ming,9999,0,9999,0
1656200489329,MATH 197,004,095571,Perols; Johan Lars,9998,0,9999,1
1656200496394,COGS 9,A01,083615,Shannon; Kyle Michael,4,0,75,71
1656200502423,COGS 11,A01,083617,Boyle; Mary E. T.,14,0,48,34
1656200508447,COGS 13,A01,083071,Bastos; Amalia Pinkusfeld,4,0,71,67
1656200514471,COGS 14A,A01,092681,Semenuks; Arturs,4,15,100,96
1656200520501,COGS 14B,A01,083073,Cheng; Tzu-Han,7,0,63,56
1656200526525,COGS 17,A01,092677,Semenuks; Arturs,7,0,81,74
1656200532553,COGS 100,A01,083619,Allen; Michael Gordon,2,0,70,68
1656200538576,COGS 101A,A01,083621,Davis; Joshua Daniel,4,0,68,64
1656200544599,COGS 101B,A01,091572,Allen; Michael Gordon,5,0,65,60
1656200550623,COGS 101C,A01,083625,Delgado; Tania,10,0,35,25
1656200556651,COGS 107A,A01,083627,Boyle; Mary E. T.,0,0,60,60
1656200562773,COGS 118A,A01,083075,Gupta; Anjum,7,0,76,69
1656200568797,CSE 3,A50,083646,Miranda; Gregory Joseph,18,0,50,32
1656200574825,CSE 8A,A50,083650,Miranda; Gregory Joseph,3,3,56,53
1656200580849,CSE 11,A01,083080,Cao; Yingjun,1,51,40,39
1656200586875,CSE 12,A01,083652,Krause-Levy; Sophia Louisa,7,3,120,113
1656200592900,CSE 15L,A01,083654,Morris; Justin Loren,2,0,50,48
1656200592900,CSE 15L,A02,083655,Morris; Justin Loren,4,0,50,46
1656200598927,CSE 20,A01,083657,Tran; Khoa Dang,30,0,80,50
1656200604962,CSE 21,A01,095574,Bach; Quang Tran,24,0,48,24
1656200610985,CSE 30,A01,083084,Eldon; John,2,8,80,78
1656200610985,CSE 30,B01,095061,Bhaskar; Nishant,1,2,50,49
1656200617008,CSE 100,A01,083659,Cao; Yingjun,2,20,70,68
1656200623035,CSE 134B,A01,083661,Powell; Thomas Allan,3,0,100,97
1656200629062,CSE 140,A01,083663,Gungor; Onat,9,0,85,76
1656200635093,CSE 140L,A01,083088,Eldon; John,8,0,100,92
1656200641116,CSE 175,A01,083665,Kumar; Rakesh,0,0,25,25
1656200647143,CSE 190,A00,092507,Dubnov; Shlomo,3,0,20,17
1656200653166,ECE 45,A01,083139,Congero; Spencer William,1,0,75,74
1656200659191,ECE 65,A50,083695,Saad; Andrew S,9,0,30,21
1656200659191,ECE 65,A51,095125,Staff,23,0,26,3
1656200665213,ECE 109,A01,091882,Touri; Behrouz,0,1,70,70
1656200671235,ECE 180,A00,083140,Abi Samra; Nicholas Camill,1,0,30,29
1656200671235,ECE 180,B00,083141,Abi Samra; Nicholas Camill,0,4,30,30
1656200677262,MATH 10A,A01,083735,Patchell; Gregory David,0,0,30,30
1656200677262,MATH 10A,A02,083736,Patchell; Gregory David,22,0,30,8
1656200677262,MATH 10A,A03,083737,Patchell; Gregory David,16,0,30,14
1656200683286,MATH 10B,A01,083207,Lim; Seonhee,0,0,34,34
1656200683286,MATH 10B,A02,083208,Lim; Seonhee,7,0,35,28
1656200683286,MATH 10B,A03,093472,Staff,1,0,34,33
1656200683286,MATH 10B,B01,083739,Sinha; Shubham,11,0,30,19
1656200689310,MATH 18,A01,083743,Cinel; Cameron Alexander,7,0,30,23
1656200689310,MATH 18,A02,083744,Cinel; Cameron Alexander,10,0,30,20
1656200689310,MATH 18,A03,083745,Cinel; Cameron Alexander,4,0,30,26
1656200689310,MATH 18,B01,083748,Rideout; David Porter,1,0,36,35
1656200689310,MATH 18,B02,083749,Rideout; David Porter,0,0,36,36
1656200689310,MATH 18,B03,083750,Rideout; David Porter,0,0,36,36
1656200689310,MATH 18,B04,083751,Rideout; David Porter,0,0,36,36
1656200689310,MATH 18,B05,093473,Rideout; David Porter,0,0,36,36
1656200689310,MATH 18,B06,093474,Rideout; David Porter,3,0,36,33
1656200695331,MATH 20A,A01,083754,Zheng; Zequn,11,0,40,29
1656200701353,MATH 20B,A01,083756,Briones; Jor-el Thomas Caparas,0,0,36,36
1656200701353,MATH 20B,A02,083757,Briones; Jor-el Thomas Caparas,0,0,36,36
1656200701353,MATH 20B,A03,093475,Staff,1,0,36,35
1656200707375,MATH 20C,A01,083760,Briones; Jor-el Thomas Caparas,0,0,35,35
1656200707375,MATH 20C,A02,083761,Briones; Jor-el Thomas Caparas,9,1,35,26
1656200707375,MATH 20C,A03,093476,Staff,0,0,35,35
1656200707375,MATH 20C,B01,083762,Bach; Quang Tran,1,0,30,29
1656200713399,MATH 20D,A01,083765,Tran; Brian Kha,1,0,30,29
1656200713399,MATH 20D,A02,083766,Tran; Brian Kha,0,1,30,30
1656200713399,MATH 20D,A03,083767,Tran; Brian Kha,2,0,30,28
1656200719425,MATH 20E,A01,083771,Ganguly; Soumya,3,0,32,29
1656200719425,MATH 20E,A02,083772,Ganguly; Soumya,0,0,32,32
1656200719425,MATH 20E,B01,083773,Ciotti; Benjamin,16,0,35,19
1656200719425,MATH 20E,B02,083774,Ciotti; Benjamin,15,0,35,20
1656200725447,MATH 103A,A01,083777,Greenfeld; Be'Eri,1,0,36,35
1656200725447,MATH 103A,A02,083778,Greenfeld; Be'Eri,1,0,36,35
1656200725447,MATH 103A,A03,093561,Staff,5,0,36,31
1656200725447,MATH 103A,B01,083779,Greenfeld; Be'Eri,9,1,36,27
1656200725447,MATH 103A,B02,083780,Greenfeld; Be'Eri,1,0,36,35
1656200725447,MATH 103A,B03,093562,Staff,0,0,36,36
1656200731470,MATH 105,A01,085443,Carter; Anne Toulson,5,1,35,30
1656200731470,MATH 105,A02,093477,Staff,13,0,35,22
1656200737495,MATH 109,A01,083213,Ganzberger; Geoffrey Michael,0,0,34,34
1656200737495,MATH 109,A02,083214,Ganzberger; Geoffrey Michael,0,0,34,34
1656200737495,MATH 109,A03,093478,Staff,1,0,34,33
1656200737495,MATH 109,B01,083215,Ganzberger; Geoffrey Michael,4,0,32,28
1656200737495,MATH 109,B02,083216,Ganzberger; Geoffrey Michael,1,0,32,31
1656200737495,MATH 109,B03,093479,Staff,4,0,32,28
1656200743518,MATH 142A,A01,083219,Chow; Bennett,1,0,32,31
1656200743518,MATH 142A,A02,083220,Chow; Bennett,8,0,32,24
1656200743518,MATH 142A,A03,093480,Staff,5,0,32,27
1656200743518,MATH 142A,B03,093481,Staff,3,0,32,29
1656200743518,MATH 142A,B04,093558,Staff,6,0,32,26
1656200743518,MATH 142A,B05,093559,Staff,1,0,32,31
1656200749549,MATH 193A,A01,083224,Rotar; Vladimir,0,1,34,34
1656200749549,MATH 193A,A02,083225,Rotar; Vladimir,0,0,34,34
1656200749549,MATH 193A,A03,083781,Rotar; Vladimir,1,0,34,33
1656200749549,MATH 193A,A04,083782,Rotar; Vladimir,6,0,34,28
1656200749549,MATH 193A,A05,093482,Rotar; Vladimir,0,0,34,34
1656200755572,MATH 197,001,091859,McAuley; Julian John,9999,0,9999,0
1656200755572,MATH 197,002,095566,Kedlaya; Kiran S.,9997,0,9999,2
1656200755572,MATH 197,003,095567,Xiao; Ming,9999,0,9999,0
1656200755572,MATH 197,004,095571,Perols; Johan Lars,9998,0,9999,1
1656200762626,COGS 9,A01,083615,Shannon; Kyle Michael,4,0,75,71
1656200768649,COGS 11,A01,083617,Boyle; Mary E. T.,14,0,48,34
1656200774680,COGS 13,A01,083071,Bastos; Amalia Pinkusfeld,4,0,71,67
1656200780703,COGS 14A,A01,092681,Semenuks; Arturs,4,15,100,96
1656200786731,COGS 14B,A01,083073,Cheng; Tzu-Han,7,0,63,56
1656200792758,COGS 17,A01,092677,Semenuks; Arturs,7,0,81,74
1656200799006,COGS 100,A01,083619,Allen; Michael Gordon,2,0,70,68
1656200805032,COGS 101A,A01,083621,Davis; Joshua Daniel,4,0,68,64
1656200811055,COGS 101B,A01,091572,Allen; Michael Gordon,5,0,65,60
1656200817076,COGS 101C,A01,083625,Delgado; Tania,10,0,35,25
1656200823101,COGS 107A,A01,083627,Boyle; Mary E. T.,0,0,60,60
1656200829131,COGS 118A,A01,083075,Gupta; Anjum,7,0,76,69
1656200835153,CSE 3,A50,083646,Miranda; Gregory Joseph,18,0,50,32
1656200841177,CSE 8A,A50,083650,Miranda; Gregory Joseph,3,3,56,53
1656200847200,CSE 11,A01,083080,Cao; Yingjun,1,51,40,39
1656200853224,CSE 12,A01,083652,Krause-Levy; Sophia Louisa,7,3,120,113
1656200859248,CSE 15L,A01,083654,Morris; Justin Loren,2,0,50,48
1656200859248,CSE 15L,A02,083655,Morris; Justin Loren,4,0,50,46
1656200865279,CSE 20,A01,083657,Tran; Khoa Dang,30,0,80,50
1656200871307,CSE 21,A01,095574,Bach; Quang Tran,24,0,48,24
1656200877344,CSE 30,A01,083084,Eldon; John,2,8,80,78
1656200877344,CSE 30,B01,095061,Bhaskar; Nishant,1,2,50,49
1656200883373,CSE 100,A01,083659,Cao; Yingjun,2,20,70,68
1656200889399,CSE 134B,A01,083661,Powell; Thomas Allan,3,0,100,97
1656200895434,CSE 140,A01,083663,Gungor; Onat,9,0,85,76
1656200901461,CSE 140L,A01,083088,Eldon; John,8,0,100,92
1656200907484,CSE 175,A01,083665,Kumar; Rakesh,0,0,25,25
1656200913511,CSE 190,A00,092507,Dubnov; Shlomo,3,0,20,17
1656200919535,ECE 45,A01,083139,Congero; Spencer William,1,0,75,74
1656200925560,ECE 65,A50,083695,Saad; Andrew S,9,0,30,21
1656200925560,ECE 65,A51,095125,Staff,23,0,26,3
1656200931581,ECE 109,A01,091882,Touri; Behrouz,0,1,70,70
1656200937604,ECE 180,A00,083140,Abi Samra; Nicholas Camill,1,0,30,29
1656200937604,ECE 180,B00,083141,Abi Samra; Nicholas Camill,0,4,30,30
1656200943627,MATH 10A,A01,083735,Patchell; Gregory David,0,0,30,30
1656200943627,MATH 10A,A02,083736,Patchell; Gregory David,22,0,30,8
1656200943627,MATH 10A,A03,083737,Patchell; Gregory David,16,0,30,14
1656200949649,MATH 10B,A01,083207,Lim; Seonhee,0,0,34,34
1656200949649,MATH 10B,A02,083208,Lim; Seonhee,7,0,35,28
1656200949649,MATH 10B,A03,093472,Staff,1,0,34,33
1656200949649,MATH 10B,B01,083739,Sinha; Shubham,11,0,30,19
1656200955675,MATH 18,A01,083743,Cinel; Cameron Alexander,7,0,30,23
1656200955675,MATH 18,A02,083744,Cinel; Cameron Alexander,10,0,30,20
1656200955675,MATH 18,A03,083745,Cinel; Cameron Alexander,4,0,30,26
1656200955675,MATH 18,B01,083748,Rideout; David Porter,1,0,36,35
1656200955675,MATH 18,B02,083749,Rideout; David Porter,0,0,36,36
1656200955675,MATH 18,B03,083750,Rideout; David Porter,0,0,36,36
1656200955675,MATH 18,B04,083751,Rideout; David Porter,0,0,36,36
1656200955675,MATH 18,B05,093473,Rideout; David Porter,0,0,36,36
1656200955675,MATH 18,B06,093474,Rideout; David Porter,3,0,36,33
1656200961705,MATH 20A,A01,083754,Zheng; Zequn,11,0,40,29
1656200967731,MATH 20B,A01,083756,Briones; Jor-el Thomas Caparas,0,0,36,36
1656200967731,MATH 20B,A02,083757,Briones; Jor-el Thomas Caparas,0,0,36,36
1656200967731,MATH 20B,A03,093475,Staff,1,0,36,35
1656200973754,MATH 20C,A01,083760,Briones; Jor-el Thomas Caparas,0,0,35,35
1656200973754,MATH 20C,A02,083761,Briones; Jor-el Thomas Caparas,9,1,35,26
1656200973754,MATH 20C,A03,093476,Staff,0,0,35,35
1656200973754,MATH 20C,B01,083762,Bach; Quang Tran,1,0,30,29
1656200979781,MATH 20D,A01,083765,Tran; Brian Kha,1,0,30,29
1656200979781,MATH 20D,A02,083766,Tran; Brian Kha,0,1,30,30
1656200979781,MATH 20D,A03,083767,Tran; Brian Kha,2,0,30,28
1656200985808,MATH 20E,A01,083771,Ganguly; Soumya,3,0,32,29
1656200985808,MATH 20E,A02,083772,Ganguly; Soumya,0,0,32,32
1656200985808,MATH 20E,B01,083773,Ciotti; Benjamin,16,0,35,19
1656200985808,MATH 20E,B02,083774,Ciotti; Benjamin,15,0,35,20
1656200991833,MATH 103A,A01,083777,Greenfeld; Be'Eri,1,0,36,35
1656200991833,MATH 103A,A02,083778,Greenfeld; Be'Eri,1,0,36,35
1656200991833,MATH 103A,A03,093561,Staff,5,0,36,31
1656200991833,MATH 103A,B01,083779,Greenfeld; Be'Eri,9,1,36,27
1656200991833,MATH 103A,B02,083780,Greenfeld; Be'Eri,1,0,36,35
1656200991833,MATH 103A,B03,093562,Staff,0,0,36,36
1656200997856,MATH 105,A01,085443,Carter; Anne Toulson,5,1,35,30
1656200997856,MATH 105,A02,093477,Staff,13,0,35,22
1656201003881,MATH 109,A01,083213,Ganzberger; Geoffrey Michael,0,0,34,34
1656201003881,MATH 109,A02,083214,Ganzberger; Geoffrey Michael,0,0,34,34
1656201003881,MATH 109,A03,093478,Staff,1,0,34,33
1656201003881,MATH 109,B01,083215,Ganzberger; Geoffrey Michael,4,0,32,28
1656201003881,MATH 109,B02,083216,Ganzberger; Geoffrey Michael,1,0,32,31
1656201003881,MATH 109,B03,093479,Staff,4,0,32,28
1656201009911,MATH 142A,A01,083219,Chow; Bennett,1,0,32,31
1656201009911,MATH 142A,A02,083220,Chow; Bennett,8,0,32,24
1656201009911,MATH 142A,A03,093480,Staff,5,0,32,27
1656201009911,MATH 142A,B03,093481,Staff,3,0,32,29
1656201009911,MATH 142A,B04,093558,Staff,6,0,32,26
1656201009911,MATH 142A,B05,093559,Staff,1,0,32,31
1656201015934,MATH 193A,A01,083224,Rotar; Vladimir,0,1,34,34
1656201015934,MATH 193A,A02,083225,Rotar; Vladimir,0,0,34,34
1656201015934,MATH 193A,A03,083781,Rotar; Vladimir,1,0,34,33
1656201015934,MATH 193A,A04,083782,Rotar; Vladimir,6,0,34,28
1656201015934,MATH 193A,A05,093482,Rotar; Vladimir,0,0,34,34
1656201021957,MATH 197,001,091859,McAuley; Julian John,9999,0,9999,0
1656201021957,MATH 197,002,095566,Kedlaya; Kiran S.,9997,0,9999,2
1656201021957,MATH 197,003,095567,Xiao; Ming,9999,0,9999,0
1656201021957,MATH 197,004,095571,Perols; Johan Lars,9998,0,9999,1
1656201029010,COGS 9,A01,083615,Shannon; Kyle Michael,4,0,75,71
1656201035034,COGS 11,A01,083617,Boyle; Mary E. T.,14,0,48,34
1656201041070,COGS 13,A01,083071,Bastos; Amalia Pinkusfeld,4,0,71,67
1656201047093,COGS 14A,A01,092681,Semenuks; Arturs,4,15,100,96
1656201053120,COGS 14B,A01,083073,Cheng; Tzu-Han,7,0,63,56
1656201059145,COGS 17,A01,092677,Semenuks; Arturs,7,0,81,74
1656201065177,COGS 100,A01,083619,Allen; Michael Gordon,2,0,70,68
1656201071200,COGS 101A,A01,083621,Davis; Joshua Daniel,4,0,68,64
1656201077228,COGS 101B,A01,091572,Allen; Michael Gordon,5,0,65,60
1656201083251,COGS 101C,A01,083625,Delgado; Tania,10,0,35,25
1656201089277,COGS 107A,A01,083627,Boyle; Mary E. T.,0,0,60,60
1656201095299,COGS 118A,A01,083075,Gupta; Anjum,7,0,76,69
1656201101329,CSE 3,A50,083646,Miranda; Gregory Joseph,18,0,50,32
1656201107354,CSE 8A,A50,083650,Miranda; Gregory Joseph,3,3,56,53
1656201113376,CSE 11,A01,083080,Cao; Yingjun,1,51,40,39
1656201119400,CSE 12,A01,083652,Krause-Levy; Sophia Louisa,7,3,120,113
1656201125427,CSE 15L,A01,083654,Morris; Justin Loren,2,0,50,48
1656201125427,CSE 15L,A02,083655,Morris; Justin Loren,4,0,50,46
1656201131457,CSE 20,A01,083657,Tran; Khoa Dang,30,0,80,50
1656201137480,CSE 21,A01,095574,Bach; Quang Tran,24,0,48,24
1656201143502,CSE 30,A01,083084,Eldon; John,2,8,80,78
1656201143502,CSE 30,B01,095061,Bhaskar; Nishant,1,2,50,49
1656201149529,CSE 100,A01,083659,Cao; Yingjun,2,20,70,68
1656201155553,CSE 134B,A01,083661,Powell; Thomas Allan,3,0,100,97
1656201161669,CSE 140,A01,083663,Gungor; Onat,9,0,85,76
1656201167692,CSE 140L,A01,083088,Eldon; John,8,0,100,92
1656201173718,CSE 175,A01,083665,Kumar; Rakesh,0,0,25,25
1656201179743,CSE 190,A00,092507,Dubnov; Shlomo,3,0,20,17
1656201185768,ECE 45,A01,083139,Congero; Spencer William,1,0,75,74
1656201191795,ECE 65,A50,083695,Saad; Andrew S,9,0,30,21
1656201191795,ECE 65,A51,095125,Staff,23,0,26,3
1656201197822,ECE 109,A01,091882,Touri; Behrouz,0,1,70,70
1656201203849,ECE 180,A00,083140,Abi Samra; Nicholas Camill,1,0,30,29
1656201203849,ECE 180,B00,083141,Abi Samra; Nicholas Camill,0,4,30,30
1656201209876,MATH 10A,A01,083735,Patchell; Gregory David,0,0,30,30
1656201209876,MATH 10A,A02,083736,Patchell; Gregory David,22,0,30,8
1656201209876,MATH 10A,A03,083737,Patchell; Gregory David,16,0,30,14
1656201215900,MATH 10B,A01,083207,Lim; Seonhee,0,0,34,34
1656201215900,MATH 10B,A02,083208,Lim; Seonhee,7,0,35,28
1656201215900,MATH 10B,A03,093472,Staff,1,0,34,33
1656201215900,MATH 10B,B01,083739,Sinha; Shubham,11,0,30,19
1656201221925,MATH 18,A01,083743,Cinel; Cameron Alexander,7,0,30,23
1656201221925,MATH 18,A02,083744,Cinel; Cameron Alexander,10,0,30,20
1656201221925,MATH 18,A03,083745,Cinel; Cameron Alexander,4,0,30,26
1656201221925,MATH 18,B01,083748,Rideout; David Porter,1,0,36,35
1656201221925,MATH 18,B02,083749,Rideout; David Porter,0,0,36,36
1656201221925,MATH 18,B03,083750,Rideout; David Porter,0,0,36,36
1656201221925,MATH 18,B04,083751,Rideout; David Porter,0,0,36,36
1656201221925,MATH 18,B05,093473,Rideout; David Porter,0,0,36,36
1656201221925,MATH 18,B06,093474,Rideout; David Porter,3,0,36,33
1656201227949,MATH 20A,A01,083754,Zheng; Zequn,11,0,40,29
1656201233972,MATH 20B,A01,083756,Briones; Jor-el Thomas Caparas,0,0,36,36
1656201233972,MATH 20B,A02,083757,Briones; Jor-el Thomas Caparas,0,0,36,36
1656201233972,MATH 20B,A03,093475,Staff,1,0,36,35
1656201239998,MATH 20C,A01,083760,Briones; Jor-el Thomas Caparas,0,0,35,35
1656201239998,MATH 20C,A02,083761,Briones; Jor-el Thomas Caparas,9,1,35,26
1656201239998,MATH 20C,A03,093476,Staff,0,0,35,35
1656201239998,MATH 20C,B01,083762,Bach; Quang Tran,1,0,30,29
1656201246027,MATH 20D,A01,083765,Tran; Brian Kha,1,0,30,29
1656201246027,MATH 20D,A02,083766,Tran; Brian Kha,0,1,30,30
1656201246027,MATH 20D,A03,083767,Tran; Brian Kha,2,0,30,28
1656201252051,MATH 20E,A01,083771,Ganguly; Soumya,3,0,32,29
1656201252051,MATH 20E,A02,083772,Ganguly; Soumya,0,0,32,32
1656201252051,MATH 20E,B01,083773,Ciotti; Benjamin,16,0,35,19
1656201252051,MATH 20E,B02,083774,Ciotti; Benjamin,15,0,35,20
1656201258074,MATH 103A,A01,083777,Greenfeld; Be'Eri,1,0,36,35
1656201258074,MATH 103A,A02,083778,Greenfeld; Be'Eri,1,0,36,35
1656201258074,MATH 103A,A03,093561,Staff,5,0,36,31
1656201258074,MATH 103A,B01,083779,Greenfeld; Be'Eri,9,1,36,27
1656201258074,MATH 103A,B02,083780,Greenfeld; Be'Eri,1,0,36,35
1656201258074,MATH 103A,B03,093562,Staff,0,0,36,36
1656201264097,MATH 105,A01,085443,Carter; Anne Toulson,5,1,35,30
1656201264097,MATH 105,A02,093477,Staff,13,0,35,22
1656201270122,MATH 109,A01,083213,Ganzberger; Geoffrey Michael,0,0,34,34
1656201270122,MATH 109,A02,083214,Ganzberger; Geoffrey Michael,0,0,34,34
1656201270122,MATH 109,A03,093478,Staff,1,0,34,33
1656201270122,MATH 109,B01,083215,Ganzberger; Geoffrey Michael,4,0,32,28
1656201270122,MATH 109,B02,083216,Ganzberger; Geoffrey Michael,1,0,32,31
1656201270122,MATH 109,B03,093479,Staff,4,0,32,28
1656201276155,MATH 142A,A01,083219,Chow; Bennett,1,0,32,31
1656201276155,MATH 142A,A02,083220,Chow; Bennett,8,0,32,24
1656201276155,MATH 142A,A03,093480,Staff,5,0,32,27
1656201276155,MATH 142A,B03,093481,Staff,3,0,32,29
1656201276155,MATH 142A,B04,093558,Staff,6,0,32,26
1656201276155,MATH 142A,B05,093559,Staff,1,0,32,31
1656201282194,MATH 193A,A01,083224,Rotar; Vladimir,0,1,34,34
1656201282194,MATH 193A,A02,083225,Rotar; Vladimir,0,0,34,34
1656201282194,MATH 193A,A03,083781,Rotar; Vladimir,1,0,34,33
1656201282194,MATH 193A,A04,083782,Rotar; Vladimir,6,0,34,28
1656201282194,MATH 193A,A05,093482,Rotar; Vladimir,0,0,34,34
1656201288221,MATH 197,001,091859,McAuley; Julian John,9999,0,9999,0
1656201288221,MATH 197,002,095566,Kedlaya; Kiran S.,9997,0,9999,2
1656201288221,MATH 197,003,095567,Xiao; Ming,9999,0,9999,0
1656201288221,MATH 197,004,095571,Perols; Johan Lars,9998,0,9999,1
1656201295284,COGS 9,A01,083615,Shannon; Kyle Michael,4,0,75,71
1656201301315,COGS 11,A01,083617,Boyle; Mary E. T.,14,0,48,34
1656201307337,COGS 13,A01,083071,Bastos; Amalia Pinkusfeld,4,0,71,67
1656201313365,COGS 14A,A01,092681,Semenuks; Arturs,4,15,100,96
1656201319393,COGS 14B,A01,083073,Cheng; Tzu-Han,7,0,63,56
1656201325427,COGS 17,A01,092677,Semenuks; Arturs,7,0,81,74
1656201331449,COGS 100,A01,083619,Allen; Michael Gordon,2,0,70,68
1656201337471,COGS 101A,A01,083621,Davis; Joshua Daniel,4,0,68,64
1656201343493,COGS 101B,A01,091572,Allen; Michael Gordon,5,0,65,60
1656201349519,COGS 101C,A01,083625,Delgado; Tania,10,0,35,25
1656201355543,COGS 107A,A01,083627,Boyle; Mary E. T.,0,0,60,60
1656201361566,COGS 118A,A01,083075,Gupta; Anjum,7,0,76,69
1656201367594,CSE 3,A50,083646,Miranda; Gregory Joseph,18,0,50,32
1656201373621,CSE 8A,A50,083650,Miranda; Gregory Joseph,3,3,56,53
1656201379650,CSE 11,A01,083080,Cao; Yingjun,1,51,40,39
1656201385675,CSE 12,A01,083652,Krause-Levy; Sophia Louisa,7,3,120,113
1656201391702,CSE 15L,A01,083654,Morris; Justin Loren,2,0,50,48
1656201391702,CSE 15L,A02,083655,Morris; Justin Loren,4,0,50,46
1656201397725,CSE 20,A01,083657,Tran; Khoa Dang,30,0,80,50
1656201403754,CSE 21,A01,095574,Bach; Quang Tran,24,0,48,24
1656201409777,CSE 30,A01,083084,Eldon; John,2,8,80,78
1656201409777,CSE 30,B01,095061,Bhaskar; Nishant,1,2,50,49
1656201415805,CSE 100,A01,083659,Cao; Yingjun,2,20,70,68
1656201421829,CSE 134B,A01,083661,Powell; Thomas Allan,3,0,100,97
1656201427866,CSE 140,A01,083663,Gungor; Onat,9,0,85,76
1656201433890,CSE 140L,A01,083088,Eldon; John,8,0,100,92
1656201439912,CSE 175,A01,083665,Kumar; Rakesh,0,0,25,25
1656201445934,CSE 190,A00,092507,Dubnov; Shlomo,3,0,20,17
1656201451972,ECE 45,A01,083139,Congero; Spencer William,1,0,75,74
1656201457996,ECE 65,A50,083695,Saad; Andrew S,9,0,30,21
1656201457996,ECE 65,A51,095125,Staff,23,0,26,3
1656201464023,ECE 109,A01,091882,Touri; Behrouz,0,1,70,70
1656201470045,ECE 180,A00,083140,Abi Samra; Nicholas Camill,1,0,30,29
1656201470045,ECE 180,B00,083141,Abi Samra; Nicholas Camill,0,4,30,30
1656201476071,MATH 10A,A01,083735,Patchell; Gregory David,0,0,30,30
1656201476071,MATH 10A,A02,083736,Patchell; Gregory David,22,0,30,8
1656201476071,MATH 10A,A03,083737,Patchell; Gregory David,16,0,30,14
1656201482096,MATH 10B,A01,083207,Lim; Seonhee,0,0,34,34
1656201482096,MATH 10B,A02,083208,Lim; Seonhee,7,0,35,28
1656201482096,MATH 10B,A03,093472,Staff,1,0,34,33
1656201482096,MATH 10B,B01,083739,Sinha; Shubham,11,0,30,19
1656201488128,MATH 18,A01,083743,Cinel; Cameron Alexander,7,0,30,23
1656201488128,MATH 18,A02,083744,Cinel; Cameron Alexander,10,0,30,20
1656201488128,MATH 18,A03,083745,Cinel; Cameron Alexander,4,0,30,26
1656201488128,MATH 18,B01,083748,Rideout; David Porter,1,0,36,35
1656201488128,MATH 18,B02,083749,Rideout; David Porter,0,0,36,36
1656201488128,MATH 18,B03,083750,Rideout; David Porter,0,0,36,36
1656201488128,MATH 18,B04,083751,Rideout; David Porter,0,0,36,36
1656201488128,MATH 18,B05,093473,Rideout; David Porter,0,0,36,36
1656201488128,MATH 18,B06,093474,Rideout; David Porter,3,0,36,33
1656201494155,MATH 20A,A01,083754,Zheng; Zequn,11,0,40,29
1656201500178,MATH 20B,A01,083756,Briones; Jor-el Thomas Caparas,0,0,36,36
1656201500178,MATH 20B,A02,083757,Briones; Jor-el Thomas Caparas,0,0,36,36
1656201500178,MATH 20B,A03,093475,Staff,1,0,36,35
1656201506203,MATH 20C,A01,083760,Briones; Jor-el Thomas Caparas,0,0,35,35
1656201506203,MATH 20C,A02,083761,Briones; Jor-el Thomas Caparas,9,1,35,26
1656201506203,MATH 20C,A03,093476,Staff,0,0,35,35
1656201506203,MATH 20C,B01,083762,Bach; Quang Tran,1,0,30,29
1656201512242,MATH 20D,A01,083765,Tran; Brian Kha,1,0,30,29
1656201512242,MATH 20D,A02,083766,Tran; Brian Kha,0,1,30,30
1656201512242,MATH 20D,A03,083767,Tran; Brian Kha,2,0,30,28
1656201518281,MATH 20E,A01,083771,Ganguly; Soumya,3,0,32,29
1656201518281,MATH 20E,A02,083772,Ganguly; Soumya,0,0,32,32
1656201518281,MATH 20E,B01,083773,Ciotti; Benjamin,16,0,35,19
1656201518281,MATH 20E,B02,083774,Ciotti; Benjamin,15,0,35,20
1656201524311,MATH 103A,A01,083777,Greenfeld; Be'Eri,1,0,36,35
1656201524311,MATH 103A,A02,083778,Greenfeld; Be'Eri,1,0,36,35
1656201524311,MATH 103A,A03,093561,Staff,5,0,36,31
1656201524311,MATH 103A,B01,083779,Greenfeld; Be'Eri,9,1,36,27
1656201524311,MATH 103A,B02,083780,Greenfeld; Be'Eri,1,0,36,35
1656201524311,MATH 103A,B03,093562,Staff,0,0,36,36
1656201530340,MATH 105,A01,085443,Carter; Anne Toulson,5,1,35,30
1656201530340,MATH 105,A02,093477,Staff,13,0,35,22
1656201536372,MATH 109,A01,083213,Ganzberger; Geoffrey Michael,0,0,34,34
1656201536372,MATH 109,A02,083214,Ganzberger; Geoffrey Michael,0,0,34,34
1656201536372,MATH 109,A03,093478,Staff,1,0,34,33
1656201536372,MATH 109,B01,083215,Ganzberger; Geoffrey Michael,4,0,32,28
1656201536372,MATH 109,B02,083216,Ganzberger; Geoffrey Michael,1,0,32,31
1656201536372,MATH 109,B03,093479,Staff,4,0,32,28
1656201542402,MATH 142A,A01,083219,Chow; Bennett,1,0,32,31
1656201542402,MATH 142A,A02,083220,Chow; Bennett,8,0,32,24
1656201542402,MATH 142A,A03,093480,Staff,5,0,32,27
1656201542402,MATH 142A,B03,093481,Staff,3,0,32,29
1656201542402,MATH 142A,B04,093558,Staff,6,0,32,26
1656201542402,MATH 142A,B05,093559,Staff,1,0,32,31
1656201548430,MATH 193A,A01,083224,Rotar; Vladimir,0,1,34,34
1656201548430,MATH 193A,A02,083225,Rotar; Vladimir,0,0,34,34
1656201548430,MATH 193A,A03,083781,Rotar; Vladimir,1,0,34,33
1656201548430,MATH 193A,A04,083782,Rotar; Vladimir,6,0,34,28
1656201548430,MATH 193A,A05,093482,Rotar; Vladimir,0,0,34,34
1656201554453,MATH 197,001,091859,McAuley; Julian John,9999,0,9999,0
1656201554453,MATH 197,002,095566,Kedlaya; Kiran S.,9997,0,9999,2
1656201554453,MATH 197,003,095567,Xiao; Ming,9999,0,9999,0
1656201554453,MATH 197,004,095571,Perols; Johan Lars,9998,0,9999,1
1656201561515,COGS 9,A01,083615,Shannon; Kyle Michael,4,0,75,71
1656201567544,COGS 11,A01,083617,Boyle; Mary E. T.,14,0,48,34
1656201573568,COGS 13,A01,083071,Bastos; Amalia Pinkusfeld,4,0,71,67
1656201579595,COGS 14A,A01,092681,Semenuks; Arturs,4,15,100,96
1656201585621,COGS 14B,A01,083073,Cheng; Tzu-Han,7,0,63,56
1656201591682,COGS 17,A01,092677,Semenuks; Arturs,7,0,81,74
1656201597709,COGS 100,A01,083619,Allen; Michael Gordon,2,0,70,68
1656201603737,COGS 101A,A01,083621,Davis; Joshua Daniel,4,0,68,64
1656201609774,COGS 101B,A01,091572,Allen; Michael Gordon,5,0,65,60
1656201615799,COGS 101C,A01,083625,Delgado; Tania,10,0,35,25
1656201621825,COGS 107A,A01,083627,Boyle; Mary E. T.,0,0,60,60
1656201627853,COGS 118A,A01,083075,Gupta; Anjum,7,0,76,69
1656201633876,CSE 3,A50,083646,Miranda; Gregory Joseph,18,0,50,32
1656201639903,CSE 8A,A50,083650,Miranda; Gregory Joseph,3,3,56,53
1656201645927,CSE 11,A01,083080,Cao; Yingjun,1,51,40,39
1656201651950,CSE 12,A01,083652,Krause-Levy; Sophia Louisa,7,3,120,113
1656201657978,CSE 15L,A01,083654,Morris; Justin Loren,2,0,50,48
1656201657978,CSE 15L,A02,083655,Morris; Justin Loren,4,0,50,46
1656201664008,CSE 20,A01,083657,Tran; Khoa Dang,30,0,80,50
1656201670037,CSE 21,A01,095574,Bach; Quang Tran,24,0,48,24
1656201676060,CSE 30,A01,083084,Eldon; John,2,8,80,78
1656201676060,CSE 30,B01,095061,Bhaskar; Nishant,1,2,50,49
1656201682083,CSE 100,A01,083659,Cao; Yingjun,2,20,70,68
1656201688106,CSE 134B,A01,083661,Powell; Thomas Allan,3,0,100,97
1656201694128,CSE 140,A01,083663,Gungor; Onat,9,0,85,76
1656201700155,CSE 140L,A01,083088,Eldon; John,8,0,100,92
1656201706179,CSE 175,A01,083665,Kumar; Rakesh,0,0,25,25
1656201712206,CSE 190,A00,092507,Dubnov; Shlomo,3,0,20,17
1656201718230,ECE 45,A01,083139,Congero; Spencer William,1,0,75,74
1656201724254,ECE 65,A50,083695,Saad; Andrew S,9,0,30,21
1656201724254,ECE 65,A51,095125,Staff,23,0,26,3
1656201730277,ECE 109,A01,091882,Touri; Behrouz,0,1,70,70
1656201736304,ECE 180,A00,083140,Abi Samra; Nicholas Camill,1,0,30,29
1656201736304,ECE 180,B00,083141,Abi Samra; Nicholas Camill,0,4,30,30
1656201742329,MATH 10A,A01,083735,Patchell; Gregory David,0,0,30,30
1656201742329,MATH 10A,A02,083736,Patchell; Gregory David,22,0,30,8
1656201742329,MATH 10A,A03,083737,Patchell; Gregory David,16,0,30,14
1656201748352,MATH 10B,A01,083207,Lim; Seonhee,0,0,34,34
1656201748352,MATH 10B,A02,083208,Lim; Seonhee,7,0,35,28
1656201748352,MATH 10B,A03,093472,Staff,1,0,34,33
1656201748352,MATH 10B,B01,083739,Sinha; Shubham,11,0,30,19
1656201754375,MATH 18,A01,083743,Cinel; Cameron Alexander,7,0,30,23
1656201754375,MATH 18,A02,083744,Cinel; Cameron Alexander,10,0,30,20
1656201754375,MATH 18,A03,083745,Cinel; Cameron Alexander,4,0,30,26
1656201754375,MATH 18,B01,083748,Rideout; David Porter,1,0,36,35
1656201754375,MATH 18,B02,083749,Rideout; David Porter,0,0,36,36
1656201754375,MATH 18,B03,083750,Rideout; David Porter,0,0,36,36
1656201754375,MATH 18,B04,083751,Rideout; David Porter,0,0,36,36
1656201754375,MATH 18,B05,093473,Rideout; David Porter,0,0,36,36
1656201754375,MATH 18,B06,093474,Rideout; David Porter,3,0,36,33
1656201760498,MATH 20A,A01,083754,Zheng; Zequn,11,0,40,29
1656201766520,MATH 20B,A01,083756,Briones; Jor-el Thomas Caparas,0,0,36,36
1656201766520,MATH 20B,A02,083757,Briones; Jor-el Thomas Caparas,0,0,36,36
1656201766520,MATH 20B,A03,093475,Staff,1,0,36,35
1656201772547,MATH 20C,A01,083760,Briones; Jor-el Thomas Caparas,0,0,35,35
1656201772547,MATH 20C,A02,083761,Briones; Jor-el Thomas Caparas,9,1,35,26
1656201772547,MATH 20C,A03,093476,Staff,0,0,35,35
1656201772547,MATH 20C,B01,083762,Bach; Quang Tran,1,0,30,29
1656201778569,MATH 20D,A01,083765,Tran; Brian Kha,1,0,30,29
1656201778569,MATH 20D,A02,083766,Tran; Brian Kha,0,1,30,30
1656201778569,MATH 20D,A03,083767,Tran; Brian Kha,2,0,30,28
1656201784593,MATH 20E,A01,083771,Ganguly; Soumya,3,0,32,29
1656201784593,MATH 20E,A02,083772,Ganguly; Soumya,0,0,32,32
1656201784593,MATH 20E,B01,083773,Ciotti; Benjamin,16,0,35,19
1656201784593,MATH 20E,B02,083774,Ciotti; Benjamin,15,0,35,20
1656201790633,MATH 103A,A01,083777,Greenfeld; Be'Eri,1,0,36,35
1656201790633,MATH 103A,A02,083778,Greenfeld; Be'Eri,1,0,36,35
1656201790633,MATH 103A,A03,093561,Staff,5,0,36,31
1656201790633,MATH 103A,B01,083779,Greenfeld; Be'Eri,9,1,36,27
1656201790633,MATH 103A,B02,083780,Greenfeld; Be'Eri,1,0,36,35
1656201790633,MATH 103A,B03,093562,Staff,0,0,36,36
1656201796663,MATH 105,A01,085443,Carter; Anne Toulson,5,1,35,30
1656201796663,MATH 105,A02,093477,Staff,13,0,35,22
1656201802686,MATH 109,A01,083213,Ganzberger; Geoffrey Michael,0,0,34,34
1656201802686,MATH 109,A02,083214,Ganzberger; Geoffrey Michael,0,0,34,34
1656201802686,MATH 109,A03,093478,Staff,1,0,34,33
1656201802686,MATH 109,B01,083215,Ganzberger; Geoffrey Michael,4,0,32,28
1656201802686,MATH 109,B02,083216,Ganzberger; Geoffrey Michael,1,0,32,31
1656201802686,MATH 109,B03,093479,Staff,4,0,32,28
1656201808710,MATH 142A,A01,083219,Chow; Bennett,1,0,32,31
1656201808710,MATH 142A,A02,083220,Chow; Bennett,8,0,32,24
1656201808710,MATH 142A,A03,093480,Staff,5,0,32,27
1656201808710,MATH 142A,B03,093481,Staff,3,0,32,29
1656201808710,MATH 142A,B04,093558,Staff,6,0,32,26
1656201808710,MATH 142A,B05,093559,Staff,1,0,32,31
1656201814735,MATH 193A,A01,083224,Rotar; Vladimir,0,1,34,34
1656201814735,MATH 193A,A02,083225,Rotar; Vladimir,0,0,34,34
1656201814735,MATH 193A,A03,083781,Rotar; Vladimir,1,0,34,33
1656201814735,MATH 193A,A04,083782,Rotar; Vladimir,6,0,34,28
1656201814735,MATH 193A,A05,093482,Rotar; Vladimir,0,0,34,34
1656201820768,MATH 197,001,091859,McAuley; Julian John,9999,0,9999,0
1656201820768,MATH 197,002,095566,Kedlaya; Kiran S.,9997,0,9999,2
1656201820768,MATH 197,003,095567,Xiao; Ming,9999,0,9999,0
1656201820768,MATH 197,004,095571,Perols; Johan Lars,9998,0,9999,1
1656201827824,COGS 9,A01,083615,Shannon; Kyle Michael,4,0,75,71
1656201833852,COGS 11,A01,083617,Boyle; Mary E. T.,14,0,48,34
1656201839880,COGS 13,A01,083071,Bastos; Amalia Pinkusfeld,4,0,71,67
1656201845903,COGS 14A,A01,092681,Semenuks; Arturs,4,16,100,96
1656201851926,COGS 14B,A01,083073,Cheng; Tzu-Han,7,0,63,56
1656201857951,COGS 17,A01,092677,Semenuks; Arturs,7,0,81,74
1656201863974,COGS 100,A01,083619,Allen; Michael Gordon,2,0,70,68
1656201869998,COGS 101A,A01,083621,Davis; Joshua Daniel,4,0,68,64
1656201876022,COGS 101B,A01,091572,Allen; Michael Gordon,5,0,65,60
1656201882045,COGS 101C,A01,083625,Delgado; Tania,10,0,35,25
1656201888070,COGS 107A,A01,083627,Boyle; Mary E. T.,0,0,60,60
1656201894103,COGS 118A,A01,083075,Gupta; Anjum,7,0,76,69
1656201900129,CSE 3,A50,083646,Miranda; Gregory Joseph,18,0,50,32
1656201906154,CSE 8A,A50,083650,Miranda; Gregory Joseph,3,3,56,53
1656201912181,CSE 11,A01,083080,Cao; Yingjun,1,51,40,39
1656201918205,CSE 12,A01,083652,Krause-Levy; Sophia Louisa,7,2,120,113
1656201924229,CSE 15L,A01,083654,Morris; Justin Loren,2,0,50,48
1656201924229,CSE 15L,A02,083655,Morris; Justin Loren,4,0,50,46
1656201930257,CSE 20,A01,083657,Tran; Khoa Dang,30,0,80,50
1656201936285,CSE 21,A01,095574,Bach; Quang Tran,24,0,48,24
1656201942320,CSE 30,A01,083084,Eldon; John,2,8,80,78
1656201942320,CSE 30,B01,095061,Bhaskar; Nishant,1,2,50,49
1656201948347,CSE 100,A01,083659,Cao; Yingjun,2,20,70,68
1656201954368,CSE 134B,A01,083661,Powell; Thomas Allan,3,0,100,97
1656201960392,CSE 140,A01,083663,Gungor; Onat,9,0,85,76
1656201966415,CSE 140L,A01,083088,Eldon; John,8,0,100,92
1656201972440,CSE 175,A01,083665,Kumar; Rakesh,0,0,25,25
1656201978464,CSE 190,A00,092507,Dubnov; Shlomo,3,0,20,17
1656201984496,ECE 45,A01,083139,Congero; Spencer William,1,0,75,74
1656201990521,ECE 65,A50,083695,Saad; Andrew S,9,0,30,21
1656201990521,ECE 65,A51,095125,Staff,23,0,26,3
1656201996545,ECE 109,A01,091882,Touri; Behrouz,0,1,70,70
1656202002568,ECE 180,A00,083140,Abi Samra; Nicholas Camill,1,0,30,29
1656202002568,ECE 180,B00,083141,Abi Samra; Nicholas Camill,0,4,30,30
1656202008593,MATH 10A,A01,083735,Patchell; Gregory David,0,0,30,30
1656202008593,MATH 10A,A02,083736,Patchell; Gregory David,22,0,30,8
1656202008593,MATH 10A,A03,083737,Patchell; Gregory David,16,0,30,14
1656202014615,MATH 10B,A01,083207,Lim; Seonhee,0,0,34,34
1656202014615,MATH 10B,A02,083208,Lim; Seonhee,7,0,35,28
1656202014615,MATH 10B,A03,093472,Staff,1,0,34,33
1656202014615,MATH 10B,B01,083739,Sinha; Shubham,11,0,30,19
1656202020655,MATH 18,A01,083743,Cinel; Cameron Alexander,7,0,30,23
1656202020655,MATH 18,A02,083744,Cinel; Cameron Alexander,10,0,30,20
1656202020655,MATH 18,A03,083745,Cinel; Cameron Alexander,4,0,30,26
1656202020655,MATH 18,B01,083748,Rideout; David Porter,1,0,36,35
1656202020655,MATH 18,B02,083749,Rideout; David Porter,0,0,36,36
1656202020655,MATH 18,B03,083750,Rideout; David Porter,0,0,36,36
1656202020655,MATH 18,B04,083751,Rideout; David Porter,0,0,36,36
1656202020655,MATH 18,B05,093473,Rideout; David Porter,0,0,36,36
1656202020655,MATH 18,B06,093474,Rideout; David Porter,3,0,36,33
1656202026686,MATH 20A,A01,083754,Zheng; Zequn,11,0,40,29
1656202032709,MATH 20B,A01,083756,Briones; Jor-el Thomas Caparas,0,0,36,36
1656202032709,MATH 20B,A02,083757,Briones; Jor-el Thomas Caparas,0,0,36,36
1656202032709,MATH 20B,A03,093475,Staff,1,0,36,35
1656202038735,MATH 20C,A01,083760,Briones; Jor-el Thomas Caparas,0,0,35,35
1656202038735,MATH 20C,A02,083761,Briones; Jor-el Thomas Caparas,9,1,35,26
1656202038735,MATH 20C,A03,093476,Staff,0,0,35,35
1656202038735,MATH 20C,B01,083762,Bach; Quang Tran,1,0,30,29
1656202044765,MATH 20D,A01,083765,Tran; Brian Kha,1,0,30,29
1656202044765,MATH 20D,A02,083766,Tran; Brian Kha,0,1,30,30
1656202044765,MATH 20D,A03,083767,Tran; Brian Kha,2,0,30,28
1656202050789,MATH 20E,A01,083771,Ganguly; Soumya,3,0,32,29
1656202050789,MATH 20E,A02,083772,Ganguly; Soumya,0,0,32,32
1656202050789,MATH 20E,B01,083773,Ciotti; Benjamin,16,0,35,19
1656202050789,MATH 20E,B02,083774,Ciotti; Benjamin,15,0,35,20
1656202056814,MATH 103A,A01,083777,Greenfeld; Be'Eri,1,0,36,35
1656202056814,MATH 103A,A02,083778,Greenfeld; Be'Eri,1,0,36,35
1656202056814,MATH 103A,A03,093561,Staff,5,0,36,31
1656202056814,MATH 103A,B01,083779,Greenfeld; Be'Eri,9,1,36,27
1656202056814,MATH 103A,B02,083780,Greenfeld; Be'Eri,1,0,36,35
1656202056814,MATH 103A,B03,093562,Staff,0,0,36,36
1656202062840,MATH 105,A01,085443,Carter; Anne Toulson,5,1,35,30
1656202062840,MATH 105,A02,093477,Staff,13,0,35,22
1656202068874,MATH 109,A01,083213,Ganzberger; Geoffrey Michael,0,0,34,34
1656202068874,MATH 109,A02,083214,Ganzberger; Geoffrey Michael,0,0,34,34
1656202068874,MATH 109,A03,093478,Staff,1,0,34,33
1656202068874,MATH 109,B01,083215,Ganzberger; Geoffrey Michael,4,0,32,28
1656202068874,MATH 109,B02,083216,Ganzberger; Geoffrey Michael,1,0,32,31
1656202068874,MATH 109,B03,093479,Staff,4,0,32,28
1656202074910,MATH 142A,A01,083219,Chow; Bennett,1,0,32,31
1656202074910,MATH 142A,A02,083220,Chow; Bennett,8,0,32,24
1656202074910,MATH 142A,A03,093480,Staff,5,0,32,27
1656202074910,MATH 142A,B03,093481,Staff,3,0,32,29
1656202074910,MATH 142A,B04,093558,Staff,6,0,32,26
1656202074910,MATH 142A,B05,093559,Staff,1,0,32,31
1656202080934,MATH 193A,A01,083224,Rotar; Vladimir,0,1,34,34
1656202080934,MATH 193A,A02,083225,Rotar; Vladimir,0,0,34,34
1656202080934,MATH 193A,A03,083781,Rotar; Vladimir,1,0,34,33
1656202080934,MATH 193A,A04,083782,Rotar; Vladimir,6,0,34,28
1656202080934,MATH 193A,A05,093482,Rotar; Vladimir,0,0,34,34
1656202086957,MATH 197,001,091859,McAuley; Julian John,9999,0,9999,0
1656202086957,MATH 197,002,095566,Kedlaya; Kiran S.,9997,0,9999,2
1656202086957,MATH 197,003,095567,Xiao; Ming,9999,0,9999,0
1656202086957,MATH 197,004,095571,Perols; Johan Lars,9998,0,9999,1
1656202094016,COGS 9,A01,083615,Shannon; Kyle Michael,4,0,75,71
1656202100045,COGS 11,A01,083617,Boyle; Mary E. T.,14,0,48,34
1656202106069,COGS 13,A01,083071,Bastos; Amalia Pinkusfeld,4,0,71,67
1656202112094,COGS 14A,A01,092681,Semenuks; Arturs,4,16,100,96
1656202118121,COGS 14B,A01,083073,Cheng; Tzu-Han,7,0,63,56
1656202124146,COGS 17,A01,092677,Semenuks; Arturs,7,0,81,74
1656202130176,COGS 100,A01,083619,Allen; Michael Gordon,2,0,70,68
1656202136199,COGS 101A,A01,083621,Davis; Joshua Daniel,4,0,68,64
1656202142228,COGS 101B,A01,091572,Allen; Michael Gordon,5,0,65,60
1656202148257,COGS 101C,A01,083625,Delgado; Tania,10,0,35,25
1656202154285,COGS 107A,A01,083627,Boyle; Mary E. T.,0,0,60,60
1656202160313,COGS 118A,A01,083075,Gupta; Anjum,7,0,76,69
1656202166336,CSE 3,A50,083646,Miranda; Gregory Joseph,18,0,50,32
1656202172361,CSE 8A,A50,083650,Miranda; Gregory Joseph,3,3,56,53
1656202178388,CSE 11,A01,083080,Cao; Yingjun,1,51,40,39
1656202184412,CSE 12,A01,083652,Krause-Levy; Sophia Louisa,7,2,120,113
1656202190443,CSE 15L,A01,083654,Morris; Justin Loren,2,0,50,48
1656202190443,CSE 15L,A02,083655,Morris; Justin Loren,4,0,50,46
1656202196471,CSE 20,A01,083657,Tran; Khoa Dang,30,0,80,50
1656202202495,CSE 21,A01,095574,Bach; Quang Tran,24,0,48,24
1656202208519,CSE 30,A01,083084,Eldon; John,2,8,80,78
1656202208519,CSE 30,B01,095061,Bhaskar; Nishant,1,2,50,49
1656202214544,CSE 100,A01,083659,Cao; Yingjun,2,20,70,68
1656202220573,CSE 134B,A01,083661,Powell; Thomas Allan,3,0,100,97
1656202226600,CSE 140,A01,083663,Gungor; Onat,9,0,85,76
1656202232628,CSE 140L,A01,083088,Eldon; John,8,0,100,92
1656202238652,CSE 175,A01,083665,Kumar; Rakesh,0,0,25,25
1656202244678,CSE 190,A00,092507,Dubnov; Shlomo,3,0,20,17
1656202250702,ECE 45,A01,083139,Congero; Spencer William,1,0,75,74
1656202256728,ECE 65,A50,083695,Saad; Andrew S,9,0,30,21
1656202256728,ECE 65,A51,095125,Staff,23,0,26,3
1656202262753,ECE 109,A01,091882,Touri; Behrouz,0,1,70,70
1656202268782,ECE 180,A00,083140,Abi Samra; Nicholas Camill,1,0,30,29
1656202268782,ECE 180,B00,083141,Abi Samra; Nicholas Camill,0,4,30,30
1656202274806,MATH 10A,A01,083735,Patchell; Gregory David,0,0,30,30
1656202274806,MATH 10A,A02,083736,Patchell; Gregory David,22,0,30,8
1656202274806,MATH 10A,A03,083737,Patchell; Gregory David,16,0,30,14
1656202280838,MATH 10B,A01,083207,Lim; Seonhee,0,0,34,34
1656202280838,MATH 10B,A02,083208,Lim; Seonhee,7,0,35,28
1656202280838,MATH 10B,A03,093472,Staff,1,0,34,33
1656202280838,MATH 10B,B01,083739,Sinha; Shubham,11,0,30,19
1656202286877,MATH 18,A01,083743,Cinel; Cameron Alexander,7,0,30,23
1656202286877,MATH 18,A02,083744,Cinel; Cameron Alexander,10,0,30,20
1656202286877,MATH 18,A03,083745,Cinel; Cameron Alexander,4,0,30,26
1656202286877,MATH 18,B01,083748,Rideout; David Porter,1,0,36,35
1656202286877,MATH 18,B02,083749,Rideout; David Porter,0,0,36,36
1656202286877,MATH 18,B03,083750,Rideout; David Porter,0,0,36,36
1656202286877,MATH 18,B04,083751,Rideout; David Porter,0,0,36,36
1656202286877,MATH 18,B05,093473,Rideout; David Porter,0,0,36,36
1656202286877,MATH 18,B06,093474,Rideout; David Porter,3,0,36,33
1656202292901,MATH 20A,A01,083754,Zheng; Zequn,11,0,40,29
1656202298925,MATH 20B,A01,083756,Briones; Jor-el Thomas Caparas,0,0,36,36
1656202298925,MATH 20B,A02,083757,Briones; Jor-el Thomas Caparas,0,0,36,36
1656202298925,MATH 20B,A03,093475,Staff,1,0,36,35
1656202304949,MATH 20C,A01,083760,Briones; Jor-el Thomas Caparas,0,0,35,35
1656202304949,MATH 20C,A02,083761,Briones; Jor-el Thomas Caparas,9,1,35,26
1656202304949,MATH 20C,A03,093476,Staff,0,0,35,35
1656202304949,MATH 20C,B01,083762,Bach; Quang Tran,1,0,30,29
1656202310977,MATH 20D,A01,083765,Tran; Brian Kha,1,0,30,29
1656202310977,MATH 20D,A02,083766,Tran; Brian Kha,0,1,30,30
1656202310977,MATH 20D,A03,083767,Tran; Brian Kha,2,0,30,28
1656202317002,MATH 20E,A01,083771,Ganguly; Soumya,3,0,32,29
1656202317002,MATH 20E,A02,083772,Ganguly; Soumya,0,0,32,32
1656202317002,MATH 20E,B01,083773,Ciotti; Benjamin,16,0,35,19
1656202317002,MATH 20E,B02,083774,Ciotti; Benjamin,15,0,35,20
1656202323032,MATH 103A,A01,083777,Greenfeld; Be'Eri,1,0,36,35
1656202323032,MATH 103A,A02,083778,Greenfeld; Be'Eri,1,0,36,35
1656202323032,MATH 103A,A03,093561,Staff,5,0,36,31
1656202323032,MATH 103A,B01,083779,Greenfeld; Be'Eri,9,1,36,27
1656202323032,MATH 103A,B02,083780,Greenfeld; Be'Eri,1,0,36,35
1656202323032,MATH 103A,B03,093562,Staff,0,0,36,36
1656202329068,MATH 105,A01,085443,Carter; Anne Toulson,5,1,35,30
1656202329068,MATH 105,A02,093477,Staff,13,0,35,22
1656202335096,MATH 109,A01,083213,Ganzberger; Geoffrey Michael,0,0,34,34
1656202335096,MATH 109,A02,083214,Ganzberger; Geoffrey Michael,0,0,34,34
1656202335096,MATH 109,A03,093478,Staff,1,0,34,33
1656202335096,MATH 109,B01,083215,Ganzberger; Geoffrey Michael,4,0,32,28
1656202335096,MATH 109,B02,083216,Ganzberger; Geoffrey Michael,1,0,32,31
1656202335096,MATH 109,B03,093479,Staff,4,0,32,28
1656202341121,MATH 142A,A01,083219,Chow; Bennett,1,0,32,31
1656202341121,MATH 142A,A02,083220,Chow; Bennett,8,0,32,24
1656202341121,MATH 142A,A03,093480,Staff,5,0,32,27
1656202341121,MATH 142A,B03,093481,Staff,3,0,32,29
1656202341121,MATH 142A,B04,093558,Staff,6,0,32,26
1656202341121,MATH 142A,B05,093559,Staff,1,0,32,31
1656202347153,MATH 193A,A01,083224,Rotar; Vladimir,0,1,34,34
1656202347153,MATH 193A,A02,083225,Rotar; Vladimir,0,0,34,34
1656202347153,MATH 193A,A03,083781,Rotar; Vladimir,1,0,34,33
1656202347153,MATH 193A,A04,083782,Rotar; Vladimir,6,0,34,28
1656202347153,MATH 193A,A05,093482,Rotar; Vladimir,0,0,34,34
1656202353181,MATH 197,001,091859,McAuley; Julian John,9999,0,9999,0
1656202353181,MATH 197,002,095566,Kedlaya; Kiran S.,9997,0,9999,2
1656202353181,MATH 197,003,095567,Xiao; Ming,9999,0,9999,0
1656202353181,MATH 197,004,095571,Perols; Johan Lars,9998,0,9999,1
1656202360331,COGS 9,A01,083615,Shannon; Kyle Michael,4,0,75,71
1656202366357,COGS 11,A01,083617,Boyle; Mary E. T.,14,0,48,34
1656202372386,COGS 13,A01,083071,Bastos; Amalia Pinkusfeld,4,0,71,67
1656202378409,COGS 14A,A01,092681,Semenuks; Arturs,4,16,100,96
1656202384442,COGS 14B,A01,083073,Cheng; Tzu-Han,7,0,63,56
1656202390476,COGS 17,A01,092677,Semenuks; Arturs,7,0,81,74
1656202396498,COGS 100,A01,083619,Allen; Michael Gordon,2,0,70,68
1656202402524,COGS 101A,A01,083621,Davis; Joshua Daniel,4,0,68,64
1656202408551,COGS 101B,A01,091572,Allen; Michael Gordon,5,0,65,60
1656202414574,COGS 101C,A01,083625,Delgado; Tania,10,0,35,25
1656202420598,COGS 107A,A01,083627,Boyle; Mary E. T.,0,0,60,60
1656202426626,COGS 118A,A01,083075,Gupta; Anjum,7,0,76,69
1656202432652,CSE 3,A50,083646,Miranda; Gregory Joseph,18,0,50,32
1656202438688,CSE 8A,A50,083650,Miranda; Gregory Joseph,3,3,56,53
1656202444715,CSE 11,A01,083080,Cao; Yingjun,1,51,40,39
1656202450742,CSE 12,A01,083652,Krause-Levy; Sophia Louisa,7,2,120,113
1656202456766,CSE 15L,A01,083654,Morris; Justin Loren,2,0,50,48
1656202456766,CSE 15L,A02,083655,Morris; Justin Loren,4,0,50,46
1656202462790,CSE 20,A01,083657,Tran; Khoa Dang,30,0,80,50
1656202468817,CSE 21,A01,095574,Bach; Quang Tran,24,0,48,24
1656202474841,CSE 30,A01,083084,Eldon; John,2,8,80,78
1656202474841,CSE 30,B01,095061,Bhaskar; Nishant,1,2,50,49
1656202480865,CSE 100,A01,083659,Cao; Yingjun,2,20,70,68
1656202486889,CSE 134B,A01,083661,Powell; Thomas Allan,3,0,100,97
1656202492916,CSE 140,A01,083663,Gungor; Onat,9,0,85,76
1656202498939,CSE 140L,A01,083088,Eldon; John,8,0,100,92
1656202504965,CSE 175,A01,083665,Kumar; Rakesh,0,0,25,25
1656202510989,CSE 190,A00,092507,Dubnov; Shlomo,3,0,20,17
1656202517015,ECE 45,A01,083139,Congero; Spencer William,1,0,75,74
1656202523037,ECE 65,A50,083695,Saad; Andrew S,9,0,30,21
1656202523037,ECE 65,A51,095125,Staff,23,0,26,3
1656202529061,ECE 109,A01,091882,Touri; Behrouz,0,1,70,70
1656202535084,ECE 180,A00,083140,Abi Samra; Nicholas Camill,1,0,30,29
1656202535084,ECE 180,B00,083141,Abi Samra; Nicholas Camill,0,4,30,30
1656202541109,MATH 10A,A01,083735,Patchell; Gregory David,0,0,30,30
1656202541109,MATH 10A,A02,083736,Patchell; Gregory David,22,0,30,8
1656202541109,MATH 10A,A03,083737,Patchell; Gregory David,16,0,30,14
1656202547138,MATH 10B,A01,083207,Lim; Seonhee,0,0,34,34
1656202547138,MATH 10B,A02,083208,Lim; Seonhee,7,0,35,28
1656202547138,MATH 10B,A03,093472,Staff,1,0,34,33
1656202547138,MATH 10B,B01,083739,Sinha; Shubham,11,0,30,19
1656202553172,MATH 18,A01,083743,Cinel; Cameron Alexander,7,0,30,23
1656202553172,MATH 18,A02,083744,Cinel; Cameron Alexander,10,0,30,20
1656202553172,MATH 18,A03,083745,Cinel; Cameron Alexander,4,0,30,26
1656202553172,MATH 18,B01,083748,Rideout; David Porter,1,0,36,35
1656202553172,MATH 18,B02,083749,Rideout; David Porter,0,0,36,36
1656202553172,MATH 18,B03,083750,Rideout; David Porter,0,0,36,36
1656202553172,MATH 18,B04,083751,Rideout; David Porter,0,0,36,36
1656202553172,MATH 18,B05,093473,Rideout; David Porter,0,0,36,36
1656202553172,MATH 18,B06,093474,Rideout; David Porter,3,0,36,33
1656202559200,MATH 20A,A01,083754,Zheng; Zequn,11,0,40,29
1656202565227,MATH 20B,A01,083756,Briones; Jor-el Thomas Caparas,0,0,36,36
1656202565227,MATH 20B,A02,083757,Briones; Jor-el Thomas Caparas,0,0,36,36
1656202565227,MATH 20B,A03,093475,Staff,1,0,36,35
1656202571257,MATH 20C,A01,083760,Briones; Jor-el Thomas Caparas,0,0,35,35
1656202571257,MATH 20C,A02,083761,Briones; Jor-el Thomas Caparas,9,1,35,26
1656202571257,MATH 20C,A03,093476,Staff,0,0,35,35
1656202571257,MATH 20C,B01,083762,Bach; Quang Tran,1,0,30,29
1656202577281,MATH 20D,A01,083765,Tran; Brian Kha,1,0,30,29
1656202577281,MATH 20D,A02,083766,Tran; Brian Kha,0,1,30,30
1656202577281,MATH 20D,A03,083767,Tran; Brian Kha,2,0,30,28
1656202583325,MATH 20E,A01,083771,Ganguly; Soumya,3,0,32,29
1656202583325,MATH 20E,A02,083772,Ganguly; Soumya,0,0,32,32
1656202583325,MATH 20E,B01,083773,Ciotti; Benjamin,16,0,35,19
1656202583325,MATH 20E,B02,083774,Ciotti; Benjamin,15,0,35,20
1656202589350,MATH 103A,A01,083777,Greenfeld; Be'Eri,1,0,36,35
1656202589350,MATH 103A,A02,083778,Greenfeld; Be'Eri,1,0,36,35
1656202589350,MATH 103A,A03,093561,Staff,5,0,36,31
1656202589350,MATH 103A,B01,083779,Greenfeld; Be'Eri,9,1,36,27
1656202589350,MATH 103A,B02,083780,Greenfeld; Be'Eri,1,0,36,35
1656202589350,MATH 103A,B03,093562,Staff,0,0,36,36
1656202595373,MATH 105,A01,085443,Carter; Anne Toulson,5,1,35,30
1656202595373,MATH 105,A02,093477,Staff,13,0,35,22
1656202601402,MATH 109,A01,083213,Ganzberger; Geoffrey Michael,0,0,34,34
1656202601402,MATH 109,A02,083214,Ganzberger; Geoffrey Michael,0,0,34,34
1656202601402,MATH 109,A03,093478,Staff,1,0,34,33
1656202601402,MATH 109,B01,083215,Ganzberger; Geoffrey Michael,4,0,32,28
1656202601402,MATH 109,B02,083216,Ganzberger; Geoffrey Michael,1,0,32,31
1656202601402,MATH 109,B03,093479,Staff,4,0,32,28
1656202607431,MATH 142A,A01,083219,Chow; Bennett,1,0,32,31
1656202607431,MATH 142A,A02,083220,Chow; Bennett,8,0,32,24
1656202607431,MATH 142A,A03,093480,Staff,5,0,32,27
1656202607431,MATH 142A,B03,093481,Staff,3,0,32,29
1656202607431,MATH 142A,B04,093558,Staff,6,0,32,26
1656202607431,MATH 142A,B05,093559,Staff,1,0,32,31
1656202613455,MATH 193A,A01,083224,Rotar; Vladimir,0,1,34,34
1656202613455,MATH 193A,A02,083225,Rotar; Vladimir,0,0,34,34
1656202613455,MATH 193A,A03,083781,Rotar; Vladimir,1,0,34,33
1656202613455,MATH 193A,A04,083782,Rotar; Vladimir,6,0,34,28
1656202613455,MATH 193A,A05,093482,Rotar; Vladimir,0,0,34,34
1656202619478,MATH 197,001,091859,McAuley; Julian John,9999,0,9999,0
1656202619478,MATH 197,002,095566,Kedlaya; Kiran S.,9997,0,9999,2
1656202619478,MATH 197,003,095567,Xiao; Ming,9999,0,9999,0
1656202619478,MATH 197,004,095571,Perols; Johan Lars,9998,0,9999,1
1656202626532,COGS 9,A01,083615,Shannon; Kyle Michael,4,0,75,71
1656202632556,COGS 11,A01,083617,Boyle; Mary E. T.,14,0,48,34
1656202638579,COGS 13,A01,083071,Bastos; Amalia Pinkusfeld,4,0,71,67
1656202644605,COGS 14A,A01,092681,Semenuks; Arturs,4,16,100,96
1656202650628,COGS 14B,A01,083073,Cheng; Tzu-Han,7,0,63,56
1656202656655,COGS 17,A01,092677,Semenuks; Arturs,7,0,81,74
1656202662679,COGS 100,A01,083619,Allen; Michael Gordon,2,0,70,68
1656202668706,COGS 101A,A01,083621,Davis; Joshua Daniel,4,0,68,64
1656202674729,COGS 101B,A01,091572,Allen; Michael Gordon,5,0,65,60
1656202680756,COGS 101C,A01,083625,Delgado; Tania,10,0,35,25
1656202686792,COGS 107A,A01,083627,Boyle; Mary E. T.,0,0,60,60
1656202692818,COGS 118A,A01,083075,Gupta; Anjum,7,0,76,69
1656202698841,CSE 3,A50,083646,Miranda; Gregory Joseph,18,0,50,32
1656202704870,CSE 8A,A50,083650,Miranda; Gregory Joseph,3,3,56,53
1656202710898,CSE 11,A01,083080,Cao; Yingjun,1,51,40,39
1656202716925,CSE 12,A01,083652,Krause-Levy; Sophia Louisa,7,2,120,113
1656202722954,CSE 15L,A01,083654,Morris; Justin Loren,2,0,50,48
1656202722954,CSE 15L,A02,083655,Morris; Justin Loren,4,0,50,46
1656202728981,CSE 20,A01,083657,Tran; Khoa Dang,30,0,80,50
1656202735005,CSE 21,A01,095574,Bach; Quang Tran,24,0,48,24
1656202741029,CSE 30,A01,083084,Eldon; John,2,8,80,78
1656202741029,CSE 30,B01,095061,Bhaskar; Nishant,1,2,50,49
1656202747056,CSE 100,A01,083659,Cao; Yingjun,2,20,70,68
1656202753080,CSE 134B,A01,083661,Powell; Thomas Allan,3,0,100,97
1656202759103,CSE 140,A01,083663,Gungor; Onat,9,0,85,76
1656202765131,CSE 140L,A01,083088,Eldon; John,8,0,100,92
1656202771159,CSE 175,A01,083665,Kumar; Rakesh,0,0,25,25
1656202777182,CSE 190,A00,092507,Dubnov; Shlomo,3,0,20,17
1656202783210,ECE 45,A01,083139,Congero; Spencer William,1,0,75,74
1656202789234,ECE 65,A50,083695,Saad; Andrew S,9,0,30,21
1656202789234,ECE 65,A51,095125,Staff,23,0,26,3
1656202795258,ECE 109,A01,091882,Touri; Behrouz,0,1,70,70
1656202801282,ECE 180,A00,083140,Abi Samra; Nicholas Camill,1,0,30,29
1656202801282,ECE 180,B00,083141,Abi Samra; Nicholas Camill,0,4,30,30
1656202807322,MATH 10A,A01,083735,Patchell; Gregory David,0,0,30,30
1656202807322,MATH 10A,A02,083736,Patchell; Gregory David,22,0,30,8
1656202807322,MATH 10A,A03,083737,Patchell; Gregory David,16,0,30,14
1656202813356,MATH 10B,A01,083207,Lim; Seonhee,0,0,34,34
1656202813356,MATH 10B,A02,083208,Lim; Seonhee,7,0,35,28
1656202813356,MATH 10B,A03,093472,Staff,1,0,34,33
1656202813356,MATH 10B,B01,083739,Sinha; Shubham,11,0,30,19
1656202819385,MATH 18,A01,083743,Cinel; Cameron Alexander,7,0,30,23
1656202819385,MATH 18,A02,083744,Cinel; Cameron Alexander,10,0,30,20
1656202819385,MATH 18,A03,083745,Cinel; Cameron Alexander,4,0,30,26
1656202819385,MATH 18,B01,083748,Rideout; David Porter,1,0,36,35
1656202819385,MATH 18,B02,083749,Rideout; David Porter,0,0,36,36
1656202819385,MATH 18,B03,083750,Rideout; David Porter,0,0,36,36
1656202819385,MATH 18,B04,083751,Rideout; David Porter,0,0,36,36
1656202819385,MATH 18,B05,093473,Rideout; David Porter,0,0,36,36
1656202819385,MATH 18,B06,093474,Rideout; David Porter,3,0,36,33
1656202825411,MATH 20A,A01,083754,Zheng; Zequn,11,0,40,29
1656202831441,MATH 20B,A01,083756,Briones; Jor-el Thomas Caparas,0,0,36,36
1656202831441,MATH 20B,A02,083757,Briones; Jor-el Thomas Caparas,0,0,36,36
1656202831441,MATH 20B,A03,093475,Staff,1,0,36,35
1656202837465,MATH 20C,A01,083760,Briones; Jor-el Thomas Caparas,0,0,35,35
1656202837465,MATH 20C,A02,083761,Briones; Jor-el Thomas Caparas,9,1,35,26
1656202837465,MATH 20C,A03,093476,Staff,0,0,35,35
1656202837465,MATH 20C,B01,083762,Bach; Quang Tran,1,0,30,29
1656202843487,MATH 20D,A01,083765,Tran; Brian Kha,1,0,30,29
1656202843487,MATH 20D,A02,083766,Tran; Brian Kha,0,1,30,30
1656202843487,MATH 20D,A03,083767,Tran; Brian Kha,2,0,30,28
1656202849515,MATH 20E,A01,083771,Ganguly; Soumya,3,0,32,29
1656202849515,MATH 20E,A02,083772,Ganguly; Soumya,0,0,32,32
1656202849515,MATH 20E,B01,083773,Ciotti; Benjamin,16,0,35,19
1656202849515,MATH 20E,B02,083774,Ciotti; Benjamin,15,0,35,20
1656202855544,MATH 103A,A01,083777,Greenfeld; Be'Eri,1,0,36,35
1656202855544,MATH 103A,A02,083778,Greenfeld; Be'Eri,1,0,36,35
1656202855544,MATH 103A,A03,093561,Staff,5,0,36,31
1656202855544,MATH 103A,B01,083779,Greenfeld; Be'Eri,9,1,36,27
1656202855544,MATH 103A,B02,083780,Greenfeld; Be'Eri,1,0,36,35
1656202855544,MATH 103A,B03,093562,Staff,0,0,36,36
1656202861568,MATH 105,A01,085443,Carter; Anne Toulson,5,1,35,30
1656202861568,MATH 105,A02,093477,Staff,13,0,35,22
1656202867591,MATH 109,A01,083213,Ganzberger; Geoffrey Michael,0,0,34,34
1656202867591,MATH 109,A02,083214,Ganzberger; Geoffrey Michael,0,0,34,34
1656202867591,MATH 109,A03,093478,Staff,1,0,34,33
1656202867591,MATH 109,B01,083215,Ganzberger; Geoffrey Michael,4,0,32,28
1656202867591,MATH 109,B02,083216,Ganzberger; Geoffrey Michael,1,0,32,31
1656202867591,MATH 109,B03,093479,Staff,4,0,32,28
1656202873619,MATH 142A,A01,083219,Chow; Bennett,1,0,32,31
1656202873619,MATH 142A,A02,083220,Chow; Bennett,8,0,32,24
1656202873619,MATH 142A,A03,093480,Staff,5,0,32,27
1656202873619,MATH 142A,B03,093481,Staff,3,0,32,29
1656202873619,MATH 142A,B04,093558,Staff,6,0,32,26
1656202873619,MATH 142A,B05,093559,Staff,1,0,32,31
1656202879643,MATH 193A,A01,083224,Rotar; Vladimir,0,1,34,34
1656202879643,MATH 193A,A02,083225,Rotar; Vladimir,0,0,34,34
1656202879643,MATH 193A,A03,083781,Rotar; Vladimir,1,0,34,33
1656202879643,MATH 193A,A04,083782,Rotar; Vladimir,6,0,34,28
1656202879643,MATH 193A,A05,093482,Rotar; Vladimir,0,0,34,34
1656202885669,MATH 197,001,091859,McAuley; Julian John,9999,0,9999,0
1656202885669,MATH 197,002,095566,Kedlaya; Kiran S.,9997,0,9999,2
1656202885669,MATH 197,003,095567,Xiao; Ming,9999,0,9999,0
1656202885669,MATH 197,004,095571,Perols; Johan Lars,9998,0,9999,1
1656202892731,COGS 9,A01,083615,Shannon; Kyle Michael,4,0,75,71
1656202898755,COGS 11,A01,083617,Boyle; Mary E. T.,14,0,48,34
1656202904779,COGS 13,A01,083071,Bastos; Amalia Pinkusfeld,4,0,71,67
1656202910808,COGS 14A,A01,092681,Semenuks; Arturs,4,16,100,96
1656202916832,COGS 14B,A01,083073,Cheng; Tzu-Han,7,0,63,56
1656202922860,COGS 17,A01,092677,Semenuks; Arturs,7,0,81,74
1656202928884,COGS 100,A01,083619,Allen; Michael Gordon,2,0,70,68
1656202934908,COGS 101A,A01,083621,Davis; Joshua Daniel,4,0,68,64
1656202940936,COGS 101B,A01,091572,Allen; Michael Gordon,5,0,65,60
1656202946963,COGS 101C,A01,083625,Delgado; Tania,10,0,35,25
1656202953077,COGS 107A,A01,083627,Boyle; Mary E. T.,0,0,60,60
1656202959104,COGS 118A,A01,083075,Gupta; Anjum,7,0,76,69
1656202965133,CSE 3,A50,083646,Miranda; Gregory Joseph,18,0,50,32
1656202971155,CSE 8A,A50,083650,Miranda; Gregory Joseph,3,3,56,53
1656202977182,CSE 11,A01,083080,Cao; Yingjun,1,50,40,39
1656202983217,CSE 12,A01,083652,Krause-Levy; Sophia Louisa,7,2,120,113
1656202989245,CSE 15L,A01,083654,Morris; Justin Loren,2,0,50,48
1656202989245,CSE 15L,A02,083655,Morris; Justin Loren,4,0,50,46
1656202995269,CSE 20,A01,083657,Tran; Khoa Dang,30,0,80,50
1656203001295,CSE 21,A01,095574,Bach; Quang Tran,24,0,48,24
1656203007319,CSE 30,A01,083084,Eldon; John,2,8,80,78
1656203007319,CSE 30,B01,095061,Bhaskar; Nishant,1,2,50,49
1656203013342,CSE 100,A01,083659,Cao; Yingjun,2,20,70,68
1656203019364,CSE 134B,A01,083661,Powell; Thomas Allan,3,0,100,97
1656203025390,CSE 140,A01,083663,Gungor; Onat,9,0,85,76
1656203031415,CSE 140L,A01,083088,Eldon; John,8,0,100,92
1656203037450,CSE 175,A01,083665,Kumar; Rakesh,0,0,25,25
1656203043487,CSE 190,A00,092507,Dubnov; Shlomo,3,0,20,17
1656203049510,ECE 45,A01,083139,Congero; Spencer William,1,0,75,74
1656203055538,ECE 65,A50,083695,Saad; Andrew S,9,0,30,21
1656203055538,ECE 65,A51,095125,Staff,23,0,26,3
1656203061566,ECE 109,A01,091882,Touri; Behrouz,0,1,70,70
1656203067591,ECE 180,A00,083140,Abi Samra; Nicholas Camill,1,0,30,29
1656203067591,ECE 180,B00,083141,Abi Samra; Nicholas Camill,0,4,30,30
1656203073613,MATH 10A,A01,083735,Patchell; Gregory David,0,0,30,30
1656203073613,MATH 10A,A02,083736,Patchell; Gregory David,22,0,30,8
1656203073613,MATH 10A,A03,083737,Patchell; Gregory David,16,0,30,14
1656203079637,MATH 10B,A01,083207,Lim; Seonhee,0,0,34,34
1656203079637,MATH 10B,A02,083208,Lim; Seonhee,7,0,35,28
1656203079637,MATH 10B,A03,093472,Staff,1,0,34,33
1656203079637,MATH 10B,B01,083739,Sinha; Shubham,11,0,30,19
1656203085668,MATH 18,A01,083743,Cinel; Cameron Alexander,7,0,30,23
1656203085668,MATH 18,A02,083744,Cinel; Cameron Alexander,10,0,30,20
1656203085668,MATH 18,A03,083745,Cinel; Cameron Alexander,4,0,30,26
1656203085668,MATH 18,B01,083748,Rideout; David Porter,1,0,36,35
1656203085668,MATH 18,B02,083749,Rideout; David Porter,0,0,36,36
1656203085668,MATH 18,B03,083750,Rideout; David Porter,0,0,36,36
1656203085668,MATH 18,B04,083751,Rideout; David Porter,0,0,36,36
1656203085668,MATH 18,B05,093473,Rideout; David Porter,0,0,36,36
1656203085668,MATH 18,B06,093474,Rideout; David Porter,3,0,36,33
1656203091692,MATH 20A,A01,083754,Zheng; Zequn,11,0,40,29
1656203097720,MATH 20B,A01,083756,Briones; Jor-el Thomas Caparas,0,0,36,36
1656203097720,MATH 20B,A02,083757,Briones; Jor-el Thomas Caparas,0,0,36,36
1656203097720,MATH 20B,A03,093475,Staff,1,0,36,35
1656203103744,MATH 20C,A01,083760,Briones; Jor-el Thomas Caparas,0,0,35,35
1656203103744,MATH 20C,A02,083761,Briones; Jor-el Thomas Caparas,9,1,35,26
1656203103744,MATH 20C,A03,093476,Staff,0,0,35,35
1656203103744,MATH 20C,B01,083762,Bach; Quang Tran,1,0,30,29
1656203109768,MATH 20D,A01,083765,Tran; Brian Kha,1,0,30,29
1656203109768,MATH 20D,A02,083766,Tran; Brian Kha,0,1,30,30
1656203109768,MATH 20D,A03,083767,Tran; Brian Kha,2,0,30,28
1656203115792,MATH 20E,A01,083771,Ganguly; Soumya,3,0,32,29
1656203115792,MATH 20E,A02,083772,Ganguly; Soumya,0,0,32,32
1656203115792,MATH 20E,B01,083773,Ciotti; Benjamin,16,0,35,19
1656203115792,MATH 20E,B02,083774,Ciotti; Benjamin,15,0,35,20
1656203121818,MATH 103A,A01,083777,Greenfeld; Be'Eri,1,0,36,35
1656203121818,MATH 103A,A02,083778,Greenfeld; Be'Eri,1,0,36,35
1656203121818,MATH 103A,A03,093561,Staff,5,0,36,31
1656203121818,MATH 103A,B01,083779,Greenfeld; Be'Eri,9,1,36,27
1656203121818,MATH 103A,B02,083780,Greenfeld; Be'Eri,1,0,36,35
1656203121818,MATH 103A,B03,093562,Staff,0,0,36,36
1656203127842,MATH 105,A01,085443,Carter; Anne Toulson,5,1,35,30
1656203127842,MATH 105,A02,093477,Staff,13,0,35,22
1656203133867,MATH 109,A01,083213,Ganzberger; Geoffrey Michael,0,0,34,34
1656203133867,MATH 109,A02,083214,Ganzberger; Geoffrey Michael,0,0,34,34
1656203133867,MATH 109,A03,093478,Staff,1,0,34,33
1656203133867,MATH 109,B01,083215,Ganzberger; Geoffrey Michael,4,0,32,28
1656203133867,MATH 109,B02,083216,Ganzberger; Geoffrey Michael,1,0,32,31
1656203133867,MATH 109,B03,093479,Staff,4,0,32,28
1656203139898,MATH 142A,A01,083219,Chow; Bennett,1,0,32,31
1656203139898,MATH 142A,A02,083220,Chow; Bennett,8,0,32,24
1656203139898,MATH 142A,A03,093480,Staff,5,0,32,27
1656203139898,MATH 142A,B03,093481,Staff,3,0,32,29
1656203139898,MATH 142A,B04,093558,Staff,6,0,32,26
1656203139898,MATH 142A,B05,093559,Staff,1,0,32,31
1656203145925,MATH 193A,A01,083224,Rotar; Vladimir,0,1,34,34
1656203145925,MATH 193A,A02,083225,Rotar; Vladimir,0,0,34,34
1656203145925,MATH 193A,A03,083781,Rotar; Vladimir,1,0,34,33
1656203145925,MATH 193A,A04,083782,Rotar; Vladimir,6,0,34,28
1656203145925,MATH 193A,A05,093482,Rotar; Vladimir,0,0,34,34
1656203151952,MATH 197,001,091859,McAuley; Julian John,9999,0,9999,0
1656203151952,MATH 197,002,095566,Kedlaya; Kiran S.,9997,0,9999,2
1656203151952,MATH 197,003,095567,Xiao; Ming,9999,0,9999,0
1656203151952,MATH 197,004,095571,Perols; Johan Lars,9998,0,9999,1
1656203159005,COGS 9,A01,083615,Shannon; Kyle Michael,4,0,75,71
1656203165031,COGS 11,A01,083617,Boyle; Mary E. T.,14,0,48,34
1656203171058,COGS 13,A01,083071,Bastos; Amalia Pinkusfeld,4,0,71,67
1656203177087,COGS 14A,A01,092681,Semenuks; Arturs,4,16,100,96
1656203183110,COGS 14B,A01,083073,Cheng; Tzu-Han,7,0,63,56
1656203189137,COGS 17,A01,092677,Semenuks; Arturs,7,0,81,74
1656203195161,COGS 100,A01,083619,Allen; Michael Gordon,2,0,70,68
1656203201185,COGS 101A,A01,083621,Davis; Joshua Daniel,4,0,68,64
1656203207210,COGS 101B,A01,091572,Allen; Michael Gordon,5,0,65,60
1656203213236,COGS 101C,A01,083625,Delgado; Tania,10,0,35,25
1656203219263,COGS 107A,A01,083627,Boyle; Mary E. T.,0,0,60,60
1656203225288,COGS 118A,A01,083075,Gupta; Anjum,7,0,76,69
1656203231311,CSE 3,A50,083646,Miranda; Gregory Joseph,18,0,50,32
1656203237335,CSE 8A,A50,083650,Miranda; Gregory Joseph,3,3,56,53
1656203243359,CSE 11,A01,083080,Cao; Yingjun,1,50,40,39
1656203249382,CSE 12,A01,083652,Krause-Levy; Sophia Louisa,7,2,120,113
1656203255405,CSE 15L,A01,083654,Morris; Justin Loren,2,0,50,48
1656203255405,CSE 15L,A02,083655,Morris; Justin Loren,4,0,50,46
1656203261429,CSE 20,A01,083657,Tran; Khoa Dang,30,0,80,50
1656203267453,CSE 21,A01,095574,Bach; Quang Tran,24,0,48,24
1656203273482,CSE 30,A01,083084,Eldon; John,2,8,80,78
1656203273482,CSE 30,B01,095061,Bhaskar; Nishant,1,2,50,49
1656203279506,CSE 100,A01,083659,Cao; Yingjun,2,20,70,68
1656203285535,CSE 134B,A01,083661,Powell; Thomas Allan,3,0,100,97
1656203291559,CSE 140,A01,083663,Gungor; Onat,9,0,85,76
1656203297582,CSE 140L,A01,083088,Eldon; John,8,0,100,92
1656203303606,CSE 175,A01,083665,Kumar; Rakesh,0,0,25,25
1656203309629,CSE 190,A00,092507,Dubnov; Shlomo,3,0,20,17
1656203315653,ECE 45,A01,083139,Congero; Spencer William,1,0,75,74
1656203321676,ECE 65,A50,083695,Saad; Andrew S,9,0,30,21
1656203321676,ECE 65,A51,095125,Staff,23,0,26,3
1656203327700,ECE 109,A01,091882,Touri; Behrouz,0,1,70,70
1656203333727,ECE 180,A00,083140,Abi Samra; Nicholas Camill,1,0,30,29
1656203333727,ECE 180,B00,083141,Abi Samra; Nicholas Camill,0,4,30,30
1656203339749,MATH 10A,A01,083735,Patchell; Gregory David,0,0,30,30
1656203339749,MATH 10A,A02,083736,Patchell; Gregory David,22,0,30,8
1656203339749,MATH 10A,A03,083737,Patchell; Gregory David,16,0,30,14
1656203345774,MATH 10B,A01,083207,Lim; Seonhee,0,0,34,34
1656203345774,MATH 10B,A02,083208,Lim; Seonhee,7,0,35,28
1656203345774,MATH 10B,A03,093472,Staff,1,0,34,33
1656203345774,MATH 10B,B01,083739,Sinha; Shubham,11,0,30,19
1656203351801,MATH 18,A01,083743,Cinel; Cameron Alexander,7,0,30,23
1656203351801,MATH 18,A02,083744,Cinel; Cameron Alexander,10,0,30,20
1656203351801,MATH 18,A03,083745,Cinel; Cameron Alexander,4,0,30,26
1656203351801,MATH 18,B01,083748,Rideout; David Porter,1,0,36,35
1656203351801,MATH 18,B02,083749,Rideout; David Porter,0,0,36,36
1656203351801,MATH 18,B03,083750,Rideout; David Porter,0,0,36,36
1656203351801,MATH 18,B04,083751,Rideout; David Porter,0,0,36,36
1656203351801,MATH 18,B05,093473,Rideout; David Porter,0,0,36,36
1656203351801,MATH 18,B06,093474,Rideout; David Porter,3,0,36,33
1656203357824,MATH 20A,A01,083754,Zheng; Zequn,11,0,40,29
1656203363847,MATH 20B,A01,083756,Briones; Jor-el Thomas Caparas,0,0,36,36
1656203363847,MATH 20B,A02,083757,Briones; Jor-el Thomas Caparas,0,0,36,36
1656203363847,MATH 20B,A03,093475,Staff,1,0,36,35
1656203369872,MATH 20C,A01,083760,Briones; Jor-el Thomas Caparas,0,0,35,35
1656203369872,MATH 20C,A02,083761,Briones; Jor-el Thomas Caparas,9,1,35,26
1656203369872,MATH 20C,A03,093476,Staff,0,0,35,35
1656203369872,MATH 20C,B01,083762,Bach; Quang Tran,1,0,30,29
1656203375900,MATH 20D,A01,083765,Tran; Brian Kha,1,0,30,29
1656203375900,MATH 20D,A02,083766,Tran; Brian Kha,0,1,30,30
1656203375900,MATH 20D,A03,083767,Tran; Brian Kha,2,0,30,28
1656203381930,MATH 20E,A01,083771,Ganguly; Soumya,3,0,32,29
1656203381930,MATH 20E,A02,083772,Ganguly; Soumya,0,0,32,32
1656203381930,MATH 20E,B01,083773,Ciotti; Benjamin,16,0,35,19
1656203381930,MATH 20E,B02,083774,Ciotti; Benjamin,15,0,35,20
1656203387955,MATH 103A,A01,083777,Greenfeld; Be'Eri,1,0,36,35
1656203387955,MATH 103A,A02,083778,Greenfeld; Be'Eri,1,0,36,35
1656203387955,MATH 103A,A03,093561,Staff,5,0,36,31
1656203387955,MATH 103A,B01,083779,Greenfeld; Be'Eri,9,1,36,27
1656203387955,MATH 103A,B02,083780,Greenfeld; Be'Eri,1,0,36,35
1656203387955,MATH 103A,B03,093562,Staff,0,0,36,36
1656203393983,MATH 105,A01,085443,Carter; Anne Toulson,5,1,35,30
1656203393983,MATH 105,A02,093477,Staff,13,0,35,22
1656203400016,MATH 109,A01,083213,Ganzberger; Geoffrey Michael,0,0,34,34
1656203400016,MATH 109,A02,083214,Ganzberger; Geoffrey Michael,0,0,34,34
1656203400016,MATH 109,A03,093478,Staff,1,0,34,33
1656203400016,MATH 109,B01,083215,Ganzberger; Geoffrey Michael,4,0,32,28
1656203400016,MATH 109,B02,083216,Ganzberger; Geoffrey Michael,1,0,32,31
1656203400016,MATH 109,B03,093479,Staff,4,0,32,28
1656203406044,MATH 142A,A01,083219,Chow; Bennett,1,0,32,31
1656203406044,MATH 142A,A02,083220,Chow; Bennett,8,0,32,24
1656203406044,MATH 142A,A03,093480,Staff,5,0,32,27
1656203406044,MATH 142A,B03,093481,Staff,3,0,32,29
1656203406044,MATH 142A,B04,093558,Staff,6,0,32,26
1656203406044,MATH 142A,B05,093559,Staff,1,0,32,31
1656203412068,MATH 193A,A01,083224,Rotar; Vladimir,0,1,34,34
1656203412068,MATH 193A,A02,083225,Rotar; Vladimir,0,0,34,34
1656203412068,MATH 193A,A03,083781,Rotar; Vladimir,1,0,34,33
1656203412068,MATH 193A,A04,083782,Rotar; Vladimir,6,0,34,28
1656203412068,MATH 193A,A05,093482,Rotar; Vladimir,0,0,34,34
1656203418095,MATH 197,001,091859,McAuley; Julian John,9999,0,9999,0
1656203418095,MATH 197,002,095566,Kedlaya; Kiran S.,9997,0,9999,2
1656203418095,MATH 197,003,095567,Xiao; Ming,9999,0,9999,0
1656203418095,MATH 197,004,095571,Perols; Johan Lars,9998,0,9999,1
1656203425157,COGS 9,A01,083615,Shannon; Kyle Michael,4,0,75,71
1656203431184,COGS 11,A01,083617,Boyle; Mary E. T.,14,0,48,34
1656203437208,COGS 13,A01,083071,Bastos; Amalia Pinkusfeld,4,0,71,67
1656203443236,COGS 14A,A01,092681,Semenuks; Arturs,4,16,100,96
1656203449263,COGS 14B,A01,083073,Cheng; Tzu-Han,7,0,63,56
1656203455287,COGS 17,A01,092677,Semenuks; Arturs,7,0,81,74
1656203461314,COGS 100,A01,083619,Allen; Michael Gordon,2,0,70,68
1656203467336,COGS 101A,A01,083621,Davis; Joshua Daniel,4,0,68,64
1656203473367,COGS 101B,A01,091572,Allen; Michael Gordon,5,0,65,60
1656203479394,COGS 101C,A01,083625,Delgado; Tania,10,0,35,25
1656203485417,COGS 107A,A01,083627,Boyle; Mary E. T.,0,0,60,60
1656203491442,COGS 118A,A01,083075,Gupta; Anjum,7,0,76,69
1656203497463,CSE 3,A50,083646,Miranda; Gregory Joseph,18,0,50,32
1656203503491,CSE 8A,A50,083650,Miranda; Gregory Joseph,3,3,56,53
1656203509513,CSE 11,A01,083080,Cao; Yingjun,1,50,40,39
1656203515535,CSE 12,A01,083652,Krause-Levy; Sophia Louisa,7,2,120,113
1656203521567,CSE 15L,A01,083654,Morris; Justin Loren,2,0,50,48
1656203521567,CSE 15L,A02,083655,Morris; Justin Loren,4,0,50,46
1656203527591,CSE 20,A01,083657,Tran; Khoa Dang,30,0,80,50
1656203533617,CSE 21,A01,095574,Bach; Quang Tran,24,0,48,24
1656203539645,CSE 30,A01,083084,Eldon; John,2,8,80,78
1656203539645,CSE 30,B01,095061,Bhaskar; Nishant,1,2,50,49
1656203545669,CSE 100,A01,083659,Cao; Yingjun,2,20,70,68
1656203551770,CSE 134B,A01,083661,Powell; Thomas Allan,3,0,100,97
1656203557792,CSE 140,A01,083663,Gungor; Onat,9,0,85,76
1656203563820,CSE 140L,A01,083088,Eldon; John,8,0,100,92
1656203569844,CSE 175,A01,083665,Kumar; Rakesh,0,0,25,25
1656203575867,CSE 190,A00,092507,Dubnov; Shlomo,3,0,20,17
1656203581891,ECE 45,A01,083139,Congero; Spencer William,1,0,75,74
1656203587920,ECE 65,A50,083695,Saad; Andrew S,9,0,30,21
1656203587920,ECE 65,A51,095125,Staff,23,0,26,3
1656203593947,ECE 109,A01,091882,Touri; Behrouz,0,1,70,70
1656203599975,ECE 180,A00,083140,Abi Samra; Nicholas Camill,1,0,30,29
1656203599975,ECE 180,B00,083141,Abi Samra; Nicholas Camill,0,4,30,30
1656203606001,MATH 10A,A01,083735,Patchell; Gregory David,0,0,30,30
1656203606001,MATH 10A,A02,083736,Patchell; Gregory David,22,0,30,8
1656203606001,MATH 10A,A03,083737,Patchell; Gregory David,16,0,30,14
1656203612027,MATH 10B,A01,083207,Lim; Seonhee,0,0,34,34
1656203612027,MATH 10B,A02,083208,Lim; Seonhee,7,0,35,28
1656203612027,MATH 10B,A03,093472,Staff,1,0,34,33
1656203612027,MATH 10B,B01,083739,Sinha; Shubham,11,0,30,19
1656203618053,MATH 18,A01,083743,Cinel; Cameron Alexander,7,0,30,23
1656203618053,MATH 18,A02,083744,Cinel; Cameron Alexander,10,0,30,20
1656203618053,MATH 18,A03,083745,Cinel; Cameron Alexander,4,0,30,26
1656203618053,MATH 18,B01,083748,Rideout; David Porter,1,0,36,35
1656203618053,MATH 18,B02,083749,Rideout; David Porter,0,0,36,36
1656203618053,MATH 18,B03,083750,Rideout; David Porter,0,0,36,36
1656203618053,MATH 18,B04,083751,Rideout; David Porter,0,0,36,36
1656203618053,MATH 18,B05,093473,Rideout; David Porter,0,0,36,36
1656203618053,MATH 18,B06,093474,Rideout; David Porter,3,0,36,33
1656203624083,MATH 20A,A01,083754,Zheng; Zequn,11,0,40,29
1656203630110,MATH 20B,A01,083756,Briones; Jor-el Thomas Caparas,0,0,36,36
1656203630110,MATH 20B,A02,083757,Briones; Jor-el Thomas Caparas,0,0,36,36
1656203630110,MATH 20B,A03,093475,Staff,1,0,36,35
1656203636138,MATH 20C,A01,083760,Briones; Jor-el Thomas Caparas,0,0,35,35
1656203636138,MATH 20C,A02,083761,Briones; Jor-el Thomas Caparas,9,1,35,26
1656203636138,MATH 20C,A03,093476,Staff,0,0,35,35
1656203636138,MATH 20C,B01,083762,Bach; Quang Tran,1,0,30,29
1656203642162,MATH 20D,A01,083765,Tran; Brian Kha,1,0,30,29
1656203642162,MATH 20D,A02,083766,Tran; Brian Kha,0,1,30,30
1656203642162,MATH 20D,A03,083767,Tran; Brian Kha,2,0,30,28
1656203648191,MATH 20E,A01,083771,Ganguly; Soumya,3,0,32,29
1656203648191,MATH 20E,A02,083772,Ganguly; Soumya,0,0,32,32
1656203648191,MATH 20E,B01,083773,Ciotti; Benjamin,16,0,35,19
1656203648191,MATH 20E,B02,083774,Ciotti; Benjamin,15,0,35,20
1656203654221,MATH 103A,A01,083777,Greenfeld; Be'Eri,1,0,36,35
1656203654221,MATH 103A,A02,083778,Greenfeld; Be'Eri,1,0,36,35
1656203654221,MATH 103A,A03,093561,Staff,5,0,36,31
1656203654221,MATH 103A,B01,083779,Greenfeld; Be'Eri,9,1,36,27
1656203654221,MATH 103A,B02,083780,Greenfeld; Be'Eri,1,0,36,35
1656203654221,MATH 103A,B03,093562,Staff,0,0,36,36
1656203660245,MATH 105,A01,085443,Carter; Anne Toulson,5,1,35,30
1656203660245,MATH 105,A02,093477,Staff,13,0,35,22
1656203666275,MATH 109,A01,083213,Ganzberger; Geoffrey Michael,0,0,34,34
1656203666275,MATH 109,A02,083214,Ganzberger; Geoffrey Michael,0,0,34,34
1656203666275,MATH 109,A03,093478,Staff,1,0,34,33
1656203666275,MATH 109,B01,083215,Ganzberger; Geoffrey Michael,4,0,32,28
1656203666275,MATH 109,B02,083216,Ganzberger; Geoffrey Michael,1,0,32,31
1656203666275,MATH 109,B03,093479,Staff,4,0,32,28
1656203672304,MATH 142A,A01,083219,Chow; Bennett,1,0,32,31
1656203672304,MATH 142A,A02,083220,Chow; Bennett,8,0,32,24
1656203672304,MATH 142A,A03,093480,Staff,5,0,32,27
1656203672304,MATH 142A,B03,093481,Staff,3,0,32,29
1656203672304,MATH 142A,B04,093558,Staff,6,0,32,26
1656203672304,MATH 142A,B05,093559,Staff,1,0,32,31
1656203678327,MATH 193A,A01,083224,Rotar; Vladimir,0,1,34,34
1656203678327,MATH 193A,A02,083225,Rotar; Vladimir,0,0,34,34
1656203678327,MATH 193A,A03,083781,Rotar; Vladimir,1,0,34,33
1656203678327,MATH 193A,A04,083782,Rotar; Vladimir,6,0,34,28
1656203678327,MATH 193A,A05,093482,Rotar; Vladimir,0,0,34,34
1656203684350,MATH 197,001,091859,McAuley; Julian John,9999,0,9999,0
1656203684350,MATH 197,002,095566,Kedlaya; Kiran S.,9997,0,9999,2
1656203684350,MATH 197,003,095567,Xiao; Ming,9999,0,9999,0
1656203684350,MATH 197,004,095571,Perols; Johan Lars,9998,0,9999,1
1656203691417,COGS 9,A01,083615,Shannon; Kyle Michael,4,0,75,71
1656203697451,COGS 11,A01,083617,Boyle; Mary E. T.,14,0,48,34
1656203703479,COGS 13,A01,083071,Bastos; Amalia Pinkusfeld,4,0,71,67
1656203709506,COGS 14A,A01,092681,Semenuks; Arturs,4,16,100,96
1656203715534,COGS 14B,A01,083073,Cheng; Tzu-Han,7,0,63,56
1656203721557,COGS 17,A01,092677,Semenuks; Arturs,7,0,81,74
1656203727581,COGS 100,A01,083619,Allen; Michael Gordon,2,0,70,68
1656203733603,COGS 101A,A01,083621,Davis; Joshua Daniel,4,0,68,64
1656203739630,COGS 101B,A01,091572,Allen; Michael Gordon,5,0,65,60
1656203745654,COGS 101C,A01,083625,Delgado; Tania,10,0,35,25
1656203751681,COGS 107A,A01,083627,Boyle; Mary E. T.,0,0,60,60
1656203757708,COGS 118A,A01,083075,Gupta; Anjum,7,0,76,69
1656203763738,CSE 3,A50,083646,Miranda; Gregory Joseph,18,0,50,32
1656203769760,CSE 8A,A50,083650,Miranda; Gregory Joseph,3,3,56,53
1656203775784,CSE 11,A01,083080,Cao; Yingjun,1,50,40,39
1656203781812,CSE 12,A01,083652,Krause-Levy; Sophia Louisa,7,2,120,113
1656203787837,CSE 15L,A01,083654,Morris; Justin Loren,2,0,50,48
1656203787837,CSE 15L,A02,083655,Morris; Justin Loren,4,0,50,46
1656203793860,CSE 20,A01,083657,Tran; Khoa Dang,30,0,80,50
1656203799887,CSE 21,A01,095574,Bach; Quang Tran,24,0,48,24
1656203805912,CSE 30,A01,083084,Eldon; John,2,8,80,78
1656203805912,CSE 30,B01,095061,Bhaskar; Nishant,1,2,50,49
1656203811938,CSE 100,A01,083659,Cao; Yingjun,2,20,70,68
1656203817962,CSE 134B,A01,083661,Powell; Thomas Allan,3,0,100,97
1656203823989,CSE 140,A01,083663,Gungor; Onat,9,0,85,76
1656203830012,CSE 140L,A01,083088,Eldon; John,8,0,100,92
1656203836035,CSE 175,A01,083665,Kumar; Rakesh,0,0,25,25
1656203842059,CSE 190,A00,092507,Dubnov; Shlomo,3,0,20,17
1656203848083,ECE 45,A01,083139,Congero; Spencer William,1,0,75,74
1656203854108,ECE 65,A50,083695,Saad; Andrew S,9,0,30,21
1656203854108,ECE 65,A51,095125,Staff,23,0,26,3
1656203860136,ECE 109,A01,091882,Touri; Behrouz,0,1,70,70
1656203866160,ECE 180,A00,083140,Abi Samra; Nicholas Camill,1,0,30,29
1656203866160,ECE 180,B00,083141,Abi Samra; Nicholas Camill,0,4,30,30
1656203872184,MATH 10A,A01,083735,Patchell; Gregory David,0,0,30,30
1656203872184,MATH 10A,A02,083736,Patchell; Gregory David,22,0,30,8
1656203872184,MATH 10A,A03,083737,Patchell; Gregory David,16,0,30,14
1656203878213,MATH 10B,A01,083207,Lim; Seonhee,0,0,34,34
1656203878213,MATH 10B,A02,083208,Lim; Seonhee,7,0,35,28
1656203878213,MATH 10B,A03,093472,Staff,1,0,34,33
1656203878213,MATH 10B,B01,083739,Sinha; Shubham,11,0,30,19
1656203884245,MATH 18,A01,083743,Cinel; Cameron Alexander,7,0,30,23
1656203884245,MATH 18,A02,083744,Cinel; Cameron Alexander,10,0,30,20
1656203884245,MATH 18,A03,083745,Cinel; Cameron Alexander,4,0,30,26
1656203884245,MATH 18,B01,083748,Rideout; David Porter,1,0,36,35
1656203884245,MATH 18,B02,083749,Rideout; David Porter,0,0,36,36
1656203884245,MATH 18,B03,083750,Rideout; David Porter,0,0,36,36
1656203884245,MATH 18,B04,083751,Rideout; David Porter,0,0,36,36
1656203884245,MATH 18,B05,093473,Rideout; David Porter,0,0,36,36
1656203884245,MATH 18,B06,093474,Rideout; David Porter,3,0,36,33
1656203890273,MATH 20A,A01,083754,Zheng; Zequn,11,0,40,29
1656203896300,MATH 20B,A01,083756,Briones; Jor-el Thomas Caparas,0,0,36,36
1656203896300,MATH 20B,A02,083757,Briones; Jor-el Thomas Caparas,0,0,36,36
1656203896300,MATH 20B,A03,093475,Staff,1,0,36,35
1656203902328,MATH 20C,A01,083760,Briones; Jor-el Thomas Caparas,0,0,35,35
1656203902328,MATH 20C,A02,083761,Briones; Jor-el Thomas Caparas,9,1,35,26
1656203902328,MATH 20C,A03,093476,Staff,0,0,35,35
1656203902328,MATH 20C,B01,083762,Bach; Quang Tran,1,0,30,29
1656203908357,MATH 20D,A01,083765,Tran; Brian Kha,1,0,30,29
1656203908357,MATH 20D,A02,083766,Tran; Brian Kha,0,1,30,30
1656203908357,MATH 20D,A03,083767,Tran; Brian Kha,2,0,30,28
1656203914383,MATH 20E,A01,083771,Ganguly; Soumya,3,0,32,29
1656203914383,MATH 20E,A02,083772,Ganguly; Soumya,0,0,32,32
1656203914383,MATH 20E,B01,083773,Ciotti; Benjamin,16,0,35,19
1656203914383,MATH 20E,B02,083774,Ciotti; Benjamin,15,0,35,20
1656203920405,MATH 103A,A01,083777,Greenfeld; Be'Eri,1,0,36,35
1656203920405,MATH 103A,A02,083778,Greenfeld; Be'Eri,1,0,36,35
1656203920405,MATH 103A,A03,093561,Staff,5,0,36,31
1656203920405,MATH 103A,B01,083779,Greenfeld; Be'Eri,9,1,36,27
1656203920405,MATH 103A,B02,083780,Greenfeld; Be'Eri,1,0,36,35
1656203920405,MATH 103A,B03,093562,Staff,0,0,36,36
1656203926437,MATH 105,A01,085443,Carter; Anne Toulson,5,1,35,30
1656203926437,MATH 105,A02,093477,Staff,13,0,35,22
1656203932462,MATH 109,A01,083213,Ganzberger; Geoffrey Michael,0,0,34,34
1656203932462,MATH 109,A02,083214,Ganzberger; Geoffrey Michael,0,0,34,34
1656203932462,MATH 109,A03,093478,Staff,1,0,34,33
1656203932462,MATH 109,B01,083215,Ganzberger; Geoffrey Michael,4,0,32,28
1656203932462,MATH 109,B02,083216,Ganzberger; Geoffrey Michael,1,0,32,31
1656203932462,MATH 109,B03,093479,Staff,4,0,32,28
1656203938489,MATH 142A,A01,083219,Chow; Bennett,1,0,32,31
1656203938489,MATH 142A,A02,083220,Chow; Bennett,8,0,32,24
1656203938489,MATH 142A,A03,093480,Staff,5,0,32,27
1656203938489,MATH 142A,B03,093481,Staff,3,0,32,29
1656203938489,MATH 142A,B04,093558,Staff,6,0,32,26
1656203938489,MATH 142A,B05,093559,Staff,1,0,32,31
1656203944523,MATH 193A,A01,083224,Rotar; Vladimir,0,1,34,34
1656203944523,MATH 193A,A02,083225,Rotar; Vladimir,0,0,34,34
1656203944523,MATH 193A,A03,083781,Rotar; Vladimir,1,0,34,33
1656203944523,MATH 193A,A04,083782,Rotar; Vladimir,6,0,34,28
1656203944523,MATH 193A,A05,093482,Rotar; Vladimir,0,0,34,34
1656203950550,MATH 197,001,091859,McAuley; Julian John,9999,0,9999,0
1656203950550,MATH 197,002,095566,Kedlaya; Kiran S.,9997,0,9999,2
1656203950550,MATH 197,003,095567,Xiao; Ming,9999,0,9999,0
1656203950550,MATH 197,004,095571,Perols; Johan Lars,9998,0,9999,1
1656203957605,COGS 9,A01,083615,Shannon; Kyle Michael,4,0,75,71
1656203963631,COGS 11,A01,083617,Boyle; Mary E. T.,14,0,48,34
1656203969655,COGS 13,A01,083071,Bastos; Amalia Pinkusfeld,4,0,71,67
1656203975683,COGS 14A,A01,092681,Semenuks; Arturs,4,16,100,96
1656203981707,COGS 14B,A01,083073,Cheng; Tzu-Han,7,0,63,56
1656203987737,COGS 17,A01,092677,Semenuks; Arturs,7,0,81,74
1656203993764,COGS 100,A01,083619,Allen; Michael Gordon,2,0,70,68
1656203999791,COGS 101A,A01,083621,Davis; Joshua Daniel,4,0,68,64
1656204005814,COGS 101B,A01,091572,Allen; Michael Gordon,5,0,65,60
1656204011838,COGS 101C,A01,083625,Delgado; Tania,10,0,35,25
1656204017866,COGS 107A,A01,083627,Boyle; Mary E. T.,0,0,60,60
1656204023890,COGS 118A,A01,083075,Gupta; Anjum,7,0,76,69
1656204029916,CSE 3,A50,083646,Miranda; Gregory Joseph,18,0,50,32
1656204035953,CSE 8A,A50,083650,Miranda; Gregory Joseph,3,3,56,53
1656204041981,CSE 11,A01,083080,Cao; Yingjun,1,50,40,39
1656204048005,CSE 12,A01,083652,Krause-Levy; Sophia Louisa,7,2,120,113
1656204054028,CSE 15L,A01,083654,Morris; Justin Loren,2,0,50,48
1656204054028,CSE 15L,A02,083655,Morris; Justin Loren,4,0,50,46
1656204060053,CSE 20,A01,083657,Tran; Khoa Dang,30,0,80,50
1656204066081,CSE 21,A01,095574,Bach; Quang Tran,24,0,48,24
1656204072106,CSE 30,A01,083084,Eldon; John,2,8,80,78
1656204072106,CSE 30,B01,095061,Bhaskar; Nishant,1,2,50,49
1656204078129,CSE 100,A01,083659,Cao; Yingjun,2,20,70,68
1656204084157,CSE 134B,A01,083661,Powell; Thomas Allan,3,0,100,97
1656204090185,CSE 140,A01,083663,Gungor; Onat,9,0,85,76
1656204096208,CSE 140L,A01,083088,Eldon; John,8,0,100,92
1656204102232,CSE 175,A01,083665,Kumar; Rakesh,0,0,25,25
1656204108258,CSE 190,A00,092507,Dubnov; Shlomo,3,0,20,17
1656204114286,ECE 45,A01,083139,Congero; Spencer William,1,0,75,74
1656204120315,ECE 65,A50,083695,Saad; Andrew S,9,0,30,21
1656204120315,ECE 65,A51,095125,Staff,23,0,26,3
1656204126351,ECE 109,A01,091882,Touri; Behrouz,0,1,70,70
1656204132374,ECE 180,A00,083140,Abi Samra; Nicholas Camill,1,0,30,29
1656204132374,ECE 180,B00,083141,Abi Samra; Nicholas Camill,0,4,30,30
1656204138398,MATH 10A,A01,083735,Patchell; Gregory David,0,0,30,30
1656204138398,MATH 10A,A02,083736,Patchell; Gregory David,22,0,30,8
1656204138398,MATH 10A,A03,083737,Patchell; Gregory David,16,0,30,14
1656204144428,MATH 10B,A01,083207,Lim; Seonhee,0,0,34,34
1656204144428,MATH 10B,A02,083208,Lim; Seonhee,7,0,35,28
1656204144428,MATH 10B,A03,093472,Staff,1,0,34,33
1656204144428,MATH 10B,B01,083739,Sinha; Shubham,11,0,30,19
1656204150535,MATH 18,A01,083743,Cinel; Cameron Alexander,7,0,30,23
1656204150535,MATH 18,A02,083744,Cinel; Cameron Alexander,10,0,30,20
1656204150535,MATH 18,A03,083745,Cinel; Cameron Alexander,4,0,30,26
1656204150535,MATH 18,B01,083748,Rideout; David Porter,1,0,36,35
1656204150535,MATH 18,B02,083749,Rideout; David Porter,0,0,36,36
1656204150535,MATH 18,B03,083750,Rideout; David Porter,0,0,36,36
1656204150535,MATH 18,B04,083751,Rideout; David Porter,0,0,36,36
1656204150535,MATH 18,B05,093473,Rideout; David Porter,0,0,36,36
1656204150535,MATH 18,B06,093474,Rideout; David Porter,3,0,36,33
1656204156556,MATH 20A,A01,083754,Zheng; Zequn,11,0,40,29
1656204162580,MATH 20B,A01,083756,Briones; Jor-el Thomas Caparas,0,0,36,36
1656204162580,MATH 20B,A02,083757,Briones; Jor-el Thomas Caparas,0,0,36,36
1656204162580,MATH 20B,A03,093475,Staff,1,0,36,35
1656204168610,MATH 20C,A01,083760,Briones; Jor-el Thomas Caparas,0,0,35,35
1656204168610,MATH 20C,A02,083761,Briones; Jor-el Thomas Caparas,9,1,35,26
1656204168610,MATH 20C,A03,093476,Staff,0,0,35,35
1656204168610,MATH 20C,B01,083762,Bach; Quang Tran,1,0,30,29
1656204174635,MATH 20D,A01,083765,Tran; Brian Kha,1,0,30,29
1656204174635,MATH 20D,A02,083766,Tran; Brian Kha,0,1,30,30
1656204174635,MATH 20D,A03,083767,Tran; Brian Kha,2,0,30,28
1656204180658,MATH 20E,A01,083771,Ganguly; Soumya,3,0,32,29
1656204180658,MATH 20E,A02,083772,Ganguly; Soumya,0,0,32,32
1656204180658,MATH 20E,B01,083773,Ciotti; Benjamin,16,0,35,19
1656204180658,MATH 20E,B02,083774,Ciotti; Benjamin,15,0,35,20
1656204186688,MATH 103A,A01,083777,Greenfeld; Be'Eri,1,0,36,35
1656204186688,MATH 103A,A02,083778,Greenfeld; Be'Eri,1,0,36,35
1656204186688,MATH 103A,A03,093561,Staff,5,0,36,31
1656204186688,MATH 103A,B01,083779,Greenfeld; Be'Eri,9,1,36,27
1656204186688,MATH 103A,B02,083780,Greenfeld; Be'Eri,1,0,36,35
1656204186688,MATH 103A,B03,093562,Staff,0,0,36,36
1656204192712,MATH 105,A01,085443,Carter; Anne Toulson,5,1,35,30
1656204192712,MATH 105,A02,093477,Staff,13,0,35,22
1656204198737,MATH 109,A01,083213,Ganzberger; Geoffrey Michael,0,0,34,34
1656204198737,MATH 109,A02,083214,Ganzberger; Geoffrey Michael,0,0,34,34
1656204198737,MATH 109,A03,093478,Staff,1,0,34,33
1656204198737,MATH 109,B01,083215,Ganzberger; Geoffrey Michael,4,0,32,28
1656204198737,MATH 109,B02,083216,Ganzberger; Geoffrey Michael,1,0,32,31
1656204198737,MATH 109,B03,093479,Staff,4,0,32,28
1656204204762,MATH 142A,A01,083219,Chow; Bennett,1,0,32,31
1656204204762,MATH 142A,A02,083220,Chow; Bennett,8,0,32,24
1656204204762,MATH 142A,A03,093480,Staff,5,0,32,27
1656204204762,MATH 142A,B03,093481,Staff,3,0,32,29
1656204204762,MATH 142A,B04,093558,Staff,6,0,32,26
1656204204762,MATH 142A,B05,093559,Staff,1,0,32,31
1656204210791,MATH 193A,A01,083224,Rotar; Vladimir,0,1,34,34
1656204210791,MATH 193A,A02,083225,Rotar; Vladimir,0,0,34,34
1656204210791,MATH 193A,A03,083781,Rotar; Vladimir,1,0,34,33
1656204210791,MATH 193A,A04,083782,Rotar; Vladimir,6,0,34,28
1656204210791,MATH 193A,A05,093482,Rotar; Vladimir,0,0,34,34
1656204216814,MATH 197,001,091859,McAuley; Julian John,9999,0,9999,0
1656204216814,MATH 197,002,095566,Kedlaya; Kiran S.,9997,0,9999,2
1656204216814,MATH 197,003,095567,Xiao; Ming,9999,0,9999,0
1656204216814,MATH 197,004,095571,Perols; Johan Lars,9998,0,9999,1
1656204223869,COGS 9,A01,083615,Shannon; Kyle Michael,4,0,75,71
1656204229897,COGS 11,A01,083617,Boyle; Mary E. T.,14,0,48,34
1656204235920,COGS 13,A01,083071,Bastos; Amalia Pinkusfeld,4,0,71,67
1656204241943,COGS 14A,A01,092681,Semenuks; Arturs,4,16,100,96
1656204247970,COGS 14B,A01,083073,Cheng; Tzu-Han,7,0,63,56
1656204253994,COGS 17,A01,092677,Semenuks; Arturs,7,0,81,74
1656204260016,COGS 100,A01,083619,Allen; Michael Gordon,2,0,70,68
1656204266040,COGS 101A,A01,083621,Davis; Joshua Daniel,4,0,68,64
1656204272064,COGS 101B,A01,091572,Allen; Michael Gordon,5,0,65,60
1656204278089,COGS 101C,A01,083625,Delgado; Tania,10,0,35,25
1656204284115,COGS 107A,A01,083627,Boyle; Mary E. T.,0,0,60,60
1656204290145,COGS 118A,A01,083075,Gupta; Anjum,7,0,76,69
1656204296175,CSE 3,A50,083646,Miranda; Gregory Joseph,18,0,50,32
1656204302199,CSE 8A,A50,083650,Miranda; Gregory Joseph,3,3,56,53
1656204308222,CSE 11,A01,083080,Cao; Yingjun,1,50,40,39
1656204314246,CSE 12,A01,083652,Krause-Levy; Sophia Louisa,7,2,120,113
1656204320274,CSE 15L,A01,083654,Morris; Justin Loren,2,0,50,48
1656204320274,CSE 15L,A02,083655,Morris; Justin Loren,4,0,50,46
1656204326303,CSE 20,A01,083657,Tran; Khoa Dang,30,0,80,50
1656204332330,CSE 21,A01,095574,Bach; Quang Tran,24,0,48,24
1656204338352,CSE 30,A01,083084,Eldon; John,2,8,80,78
1656204338352,CSE 30,B01,095061,Bhaskar; Nishant,1,2,50,49
1656204344381,CSE 100,A01,083659,Cao; Yingjun,2,20,70,68
1656204350403,CSE 134B,A01,083661,Powell; Thomas Allan,3,0,100,97
1656204356429,CSE 140,A01,083663,Gungor; Onat,9,0,85,76
1656204362457,CSE 140L,A01,083088,Eldon; John,8,0,100,92
1656204368483,CSE 175,A01,083665,Kumar; Rakesh,0,0,25,25
1656204374509,CSE 190,A00,092507,Dubnov; Shlomo,3,0,20,17
1656204380535,ECE 45,A01,083139,Congero; Spencer William,1,0,75,74
1656204386559,ECE 65,A50,083695,Saad; Andrew S,9,0,30,21
1656204386559,ECE 65,A51,095125,Staff,23,0,26,3
1656204392589,ECE 109,A01,091882,Touri; Behrouz,0,1,70,70
1656204398617,ECE 180,A00,083140,Abi Samra; Nicholas Camill,1,0,30,29
1656204398617,ECE 180,B00,083141,Abi Samra; Nicholas Camill,0,4,30,30
1656204404644,MATH 10A,A01,083735,Patchell; Gregory David,0,0,30,30
1656204404644,MATH 10A,A02,083736,Patchell; Gregory David,22,0,30,8
1656204404644,MATH 10A,A03,083737,Patchell; Gregory David,16,0,30,14
1656204410674,MATH 10B,A01,083207,Lim; Seonhee,0,0,34,34
1656204410674,MATH 10B,A02,083208,Lim; Seonhee,7,0,35,28
1656204410674,MATH 10B,A03,093472,Staff,1,0,34,33
1656204410674,MATH 10B,B01,083739,Sinha; Shubham,11,0,30,19
1656204416705,MATH 18,A01,083743,Cinel; Cameron Alexander,7,0,30,23
1656204416705,MATH 18,A02,083744,Cinel; Cameron Alexander,10,0,30,20
1656204416705,MATH 18,A03,083745,Cinel; Cameron Alexander,4,0,30,26
1656204416705,MATH 18,B01,083748,Rideout; David Porter,1,0,36,35
1656204416705,MATH 18,B02,083749,Rideout; David Porter,0,0,36,36
1656204416705,MATH 18,B03,083750,Rideout; David Porter,0,0,36,36
1656204416705,MATH 18,B04,083751,Rideout; David Porter,0,0,36,36
1656204416705,MATH 18,B05,093473,Rideout; David Porter,0,0,36,36
1656204416705,MATH 18,B06,093474,Rideout; David Porter,3,0,36,33
1656204422728,MATH 20A,A01,083754,Zheng; Zequn,11,0,40,29
1656204428756,MATH 20B,A01,083756,Briones; Jor-el Thomas Caparas,0,0,36,36
1656204428756,MATH 20B,A02,083757,Briones; Jor-el Thomas Caparas,0,0,36,36
1656204428756,MATH 20B,A03,093475,Staff,1,0,36,35
1656204434784,MATH 20C,A01,083760,Briones; Jor-el Thomas Caparas,0,0,35,35
1656204434784,MATH 20C,A02,083761,Briones; Jor-el Thomas Caparas,9,1,35,26
1656204434784,MATH 20C,A03,093476,Staff,0,0,35,35
1656204434784,MATH 20C,B01,083762,Bach; Quang Tran,1,0,30,29
1656204440812,MATH 20D,A01,083765,Tran; Brian Kha,1,0,30,29
1656204440812,MATH 20D,A02,083766,Tran; Brian Kha,0,1,30,30
1656204440812,MATH 20D,A03,083767,Tran; Brian Kha,2,0,30,28
1656204446836,MATH 20E,A01,083771,Ganguly; Soumya,3,0,32,29
1656204446836,MATH 20E,A02,083772,Ganguly; Soumya,0,0,32,32
1656204446836,MATH 20E,B01,083773,Ciotti; Benjamin,16,0,35,19
1656204446836,MATH 20E,B02,083774,Ciotti; Benjamin,15,0,35,20
1656204452866,MATH 103A,A01,083777,Greenfeld; Be'Eri,1,0,36,35
1656204452866,MATH 103A,A02,083778,Greenfeld; Be'Eri,1,0,36,35
1656204452866,MATH 103A,A03,093561,Staff,5,0,36,31
1656204452866,MATH 103A,B01,083779,Greenfeld; Be'Eri,9,1,36,27
1656204452866,MATH 103A,B02,083780,Greenfeld; Be'Eri,1,0,36,35
1656204452866,MATH 103A,B03,093562,Staff,0,0,36,36
1656204458889,MATH 105,A01,085443,Carter; Anne Toulson,5,1,35,30
1656204458889,MATH 105,A02,093477,Staff,13,0,35,22
1656204464917,MATH 109,A01,083213,Ganzberger; Geoffrey Michael,0,0,34,34
1656204464917,MATH 109,A02,083214,Ganzberger; Geoffrey Michael,0,0,34,34
1656204464917,MATH 109,A03,093478,Staff,1,0,34,33
1656204464917,MATH 109,B01,083215,Ganzberger; Geoffrey Michael,4,0,32,28
1656204464917,MATH 109,B02,083216,Ganzberger; Geoffrey Michael,1,0,32,31
1656204464917,MATH 109,B03,093479,Staff,4,0,32,28
1656204470946,MATH 142A,A01,083219,Chow; Bennett,2,0,32,30
1656204470946,MATH 142A,A02,083220,Chow; Bennett,8,0,32,24
1656204470946,MATH 142A,A03,093480,Staff,5,0,32,27
1656204470946,MATH 142A,B03,093481,Staff,3,0,32,29
1656204470946,MATH 142A,B04,093558,Staff,6,0,32,26
1656204470946,MATH 142A,B05,093559,Staff,1,0,32,31
1656204476970,MATH 193A,A01,083224,Rotar; Vladimir,0,1,34,34
1656204476970,MATH 193A,A02,083225,Rotar; Vladimir,0,0,34,34
1656204476970,MATH 193A,A03,083781,Rotar; Vladimir,1,0,34,33
1656204476970,MATH 193A,A04,083782,Rotar; Vladimir,6,0,34,28
1656204476970,MATH 193A,A05,093482,Rotar; Vladimir,0,0,34,34
1656204483005,MATH 197,001,091859,McAuley; Julian John,9999,0,9999,0
1656204483005,MATH 197,002,095566,Kedlaya; Kiran S.,9997,0,9999,2
1656204483005,MATH 197,003,095567,Xiao; Ming,9999,0,9999,0
1656204483005,MATH 197,004,095571,Perols; Johan Lars,9998,0,9999,1
1656204490066,COGS 9,A01,083615,Shannon; Kyle Michael,4,0,75,71
1656204496093,COGS 11,A01,083617,Boyle; Mary E. T.,14,0,48,34
1656204502116,COGS 13,A01,083071,Bastos; Amalia Pinkusfeld,4,0,71,67
1656204508140,COGS 14A,A01,092681,Semenuks; Arturs,4,16,100,96
1656204514165,COGS 14B,A01,083073,Cheng; Tzu-Han,7,0,63,56
1656204520189,COGS 17,A01,092677,Semenuks; Arturs,7,0,81,74
1656204526211,COGS 100,A01,083619,Allen; Michael Gordon,2,0,70,68
1656204532235,COGS 101A,A01,083621,Davis; Joshua Daniel,4,0,68,64
1656204538271,COGS 101B,A01,091572,Allen; Michael Gordon,5,0,65,60
1656204544307,COGS 101C,A01,083625,Delgado; Tania,10,0,35,25
1656204550329,COGS 107A,A01,083627,Boyle; Mary E. T.,0,0,60,60
1656204556355,COGS 118A,A01,083075,Gupta; Anjum,7,0,76,69
1656204562383,CSE 3,A50,083646,Miranda; Gregory Joseph,18,0,50,32
1656204568408,CSE 8A,A50,083650,Miranda; Gregory Joseph,3,3,56,53
1656204574435,CSE 11,A01,083080,Cao; Yingjun,1,50,40,39
1656204580458,CSE 12,A01,083652,Krause-Levy; Sophia Louisa,7,2,120,113
1656204586484,CSE 15L,A01,083654,Morris; Justin Loren,2,0,50,48
1656204586484,CSE 15L,A02,083655,Morris; Justin Loren,4,0,50,46
1656204592506,CSE 20,A01,083657,Tran; Khoa Dang,30,0,80,50
1656204598533,CSE 21,A01,095574,Bach; Quang Tran,24,0,48,24
1656204604562,CSE 30,A01,083084,Eldon; John,2,8,80,78
1656204604562,CSE 30,B01,095061,Bhaskar; Nishant,1,2,50,49
1656204610585,CSE 100,A01,083659,Cao; Yingjun,2,20,70,68
1656204616613,CSE 134B,A01,083661,Powell; Thomas Allan,3,0,100,97
1656204622638,CSE 140,A01,083663,Gungor; Onat,9,0,85,76
1656204628661,CSE 140L,A01,083088,Eldon; John,8,0,100,92
1656204634688,CSE 175,A01,083665,Kumar; Rakesh,0,0,25,25
1656204640721,CSE 190,A00,092507,Dubnov; Shlomo,3,0,20,17
1656204646745,ECE 45,A01,083139,Congero; Spencer William,1,0,75,74
1656204652772,ECE 65,A50,083695,Saad; Andrew S,9,0,30,21
1656204652772,ECE 65,A51,095125,Staff,23,0,26,3
1656204658796,ECE 109,A01,091882,Touri; Behrouz,0,1,70,70
1656204664824,ECE 180,A00,083140,Abi Samra; Nicholas Camill,1,0,30,29
1656204664824,ECE 180,B00,083141,Abi Samra; Nicholas Camill,0,4,30,30
1656204670857,MATH 10A,A01,083735,Patchell; Gregory David,0,0,30,30
1656204670857,MATH 10A,A02,083736,Patchell; Gregory David,22,0,30,8
1656204670857,MATH 10A,A03,083737,Patchell; Gregory David,16,0,30,14
1656204676880,MATH 10B,A01,083207,Lim; Seonhee,0,0,34,34
1656204676880,MATH 10B,A02,083208,Lim; Seonhee,7,0,35,28
1656204676880,MATH 10B,A03,093472,Staff,1,0,34,33
1656204676880,MATH 10B,B01,083739,Sinha; Shubham,11,0,30,19
1656204682904,MATH 18,A01,083743,Cinel; Cameron Alexander,7,0,30,23
1656204682904,MATH 18,A02,083744,Cinel; Cameron Alexander,10,0,30,20
1656204682904,MATH 18,A03,083745,Cinel; Cameron Alexander,4,0,30,26
1656204682904,MATH 18,B01,083748,Rideout; David Porter,1,0,36,35
1656204682904,MATH 18,B02,083749,Rideout; David Porter,0,0,36,36
1656204682904,MATH 18,B03,083750,Rideout; David Porter,0,0,36,36
1656204682904,MATH 18,B04,083751,Rideout; David Porter,0,0,36,36
1656204682904,MATH 18,B05,093473,Rideout; David Porter,0,0,36,36
1656204682904,MATH 18,B06,093474,Rideout; David Porter,3,0,36,33
1656204688930,MATH 20A,A01,083754,Zheng; Zequn,11,0,40,29
1656204694956,MATH 20B,A01,083756,Briones; Jor-el Thomas Caparas,0,0,36,36
1656204694956,MATH 20B,A02,083757,Briones; Jor-el Thomas Caparas,0,0,36,36
1656204694956,MATH 20B,A03,093475,Staff,1,0,36,35
1656204700984,MATH 20C,A01,083760,Briones; Jor-el Thomas Caparas,0,0,35,35
1656204700984,MATH 20C,A02,083761,Briones; Jor-el Thomas Caparas,9,1,35,26
1656204700984,MATH 20C,A03,093476,Staff,0,0,35,35
1656204700984,MATH 20C,B01,083762,Bach; Quang Tran,1,0,30,29
1656204707007,MATH 20D,A01,083765,Tran; Brian Kha,1,0,30,29
1656204707007,MATH 20D,A02,083766,Tran; Brian Kha,0,1,30,30
1656204707007,MATH 20D,A03,083767,Tran; Brian Kha,2,0,30,28
1656204713031,MATH 20E,A01,083771,Ganguly; Soumya,3,0,32,29
1656204713031,MATH 20E,A02,083772,Ganguly; Soumya,0,0,32,32
1656204713031,MATH 20E,B01,083773,Ciotti; Benjamin,16,0,35,19
1656204713031,MATH 20E,B02,083774,Ciotti; Benjamin,15,0,35,20
1656204719055,MATH 103A,A01,083777,Greenfeld; Be'Eri,1,0,36,35
1656204719055,MATH 103A,A02,083778,Greenfeld; Be'Eri,1,0,36,35
1656204719055,MATH 103A,A03,093561,Staff,5,0,36,31
1656204719055,MATH 103A,B01,083779,Greenfeld; Be'Eri,9,1,36,27
1656204719055,MATH 103A,B02,083780,Greenfeld; Be'Eri,1,0,36,35
1656204719055,MATH 103A,B03,093562,Staff,0,0,36,36
1656204725092,MATH 105,A01,085443,Carter; Anne Toulson,5,1,35,30
1656204725092,MATH 105,A02,093477,Staff,13,0,35,22
1656204731117,MATH 109,A01,083213,Ganzberger; Geoffrey Michael,0,0,34,34
1656204731117,MATH 109,A02,083214,Ganzberger; Geoffrey Michael,0,0,34,34
1656204731117,MATH 109,A03,093478,Staff,1,0,34,33
1656204731117,MATH 109,B01,083215,Ganzberger; Geoffrey Michael,4,0,32,28
1656204731117,MATH 109,B02,083216,Ganzberger; Geoffrey Michael,1,0,32,31
1656204731117,MATH 109,B03,093479,Staff,4,0,32,28
1656204737147,MATH 142A,A01,083219,Chow; Bennett,2,0,32,30
1656204737147,MATH 142A,A02,083220,Chow; Bennett,8,0,32,24
1656204737147,MATH 142A,A03,093480,Staff,5,0,32,27
1656204737147,MATH 142A,B03,093481,Staff,3,0,32,29
1656204737147,MATH 142A,B04,093558,Staff,6,0,32,26
1656204737147,MATH 142A,B05,093559,Staff,1,0,32,31
1656204743172,MATH 193A,A01,083224,Rotar; Vladimir,0,1,34,34
1656204743172,MATH 193A,A02,083225,Rotar; Vladimir,0,0,34,34
1656204743172,MATH 193A,A03,083781,Rotar; Vladimir,1,0,34,33
1656204743172,MATH 193A,A04,083782,Rotar; Vladimir,6,0,34,28
1656204743172,MATH 193A,A05,093482,Rotar; Vladimir,0,0,34,34
1656204749265,MATH 197,001,091859,McAuley; Julian John,9999,0,9999,0
1656204749265,MATH 197,002,095566,Kedlaya; Kiran S.,9997,0,9999,2
1656204749265,MATH 197,003,095567,Xiao; Ming,9999,0,9999,0
1656204749265,MATH 197,004,095571,Perols; Johan Lars,9998,0,9999,1
1656204756320,COGS 9,A01,083615,Shannon; Kyle Michael,4,0,75,71
1656204762342,COGS 11,A01,083617,Boyle; Mary E. T.,14,0,48,34
1656204768364,COGS 13,A01,083071,Bastos; Amalia Pinkusfeld,4,0,71,67
1656204774390,COGS 14A,A01,092681,Semenuks; Arturs,4,16,100,96
1656204780413,COGS 14B,A01,083073,Cheng; Tzu-Han,7,0,63,56
1656204786438,COGS 17,A01,092677,Semenuks; Arturs,7,0,81,74
1656204792461,COGS 100,A01,083619,Allen; Michael Gordon,2,0,70,68
1656204798487,COGS 101A,A01,083621,Davis; Joshua Daniel,4,0,68,64
1656204804514,COGS 101B,A01,091572,Allen; Michael Gordon,5,0,65,60
1656204810538,COGS 101C,A01,083625,Delgado; Tania,10,0,35,25
1656204816564,COGS 107A,A01,083627,Boyle; Mary E. T.,0,0,60,60
1656204822589,COGS 118A,A01,083075,Gupta; Anjum,7,0,76,69
1656204828612,CSE 3,A50,083646,Miranda; Gregory Joseph,18,0,50,32
1656204834640,CSE 8A,A50,083650,Miranda; Gregory Joseph,3,3,56,53
1656204840664,CSE 11,A01,083080,Cao; Yingjun,1,50,40,39
1656204846690,CSE 12,A01,083652,Krause-Levy; Sophia Louisa,7,2,120,113
1656204852712,CSE 15L,A01,083654,Morris; Justin Loren,2,0,50,48
1656204852712,CSE 15L,A02,083655,Morris; Justin Loren,4,0,50,46
1656204858734,CSE 20,A01,083657,Tran; Khoa Dang,30,0,80,50
1656204864758,CSE 21,A01,095574,Bach; Quang Tran,24,0,48,24
1656204870781,CSE 30,A01,083084,Eldon; John,2,8,80,78
1656204870781,CSE 30,B01,095061,Bhaskar; Nishant,1,2,50,49
1656204876807,CSE 100,A01,083659,Cao; Yingjun,2,20,70,68
1656204882835,CSE 134B,A01,083661,Powell; Thomas Allan,3,0,100,97
1656204888865,CSE 140,A01,083663,Gungor; Onat,9,0,85,76
1656204894893,CSE 140L,A01,083088,Eldon; John,8,0,100,92
1656204900916,CSE 175,A01,083665,Kumar; Rakesh,0,0,25,25
1656204906944,CSE 190,A00,092507,Dubnov; Shlomo,3,0,20,17
1656204912971,ECE 45,A01,083139,Congero; Spencer William,1,0,75,74
1656204918994,ECE 65,A50,083695,Saad; Andrew S,9,0,30,21
1656204918994,ECE 65,A51,095125,Staff,23,0,26,3
1656204925017,ECE 109,A01,091882,Touri; Behrouz,0,1,70,70
1656204931045,ECE 180,A00,083140,Abi Samra; Nicholas Camill,1,0,30,29
1656204931045,ECE 180,B00,083141,Abi Samra; Nicholas Camill,0,4,30,30
1656204937070,MATH 10A,A01,083735,Patchell; Gregory David,0,0,30,30
1656204937070,MATH 10A,A02,083736,Patchell; Gregory David,22,0,30,8
1656204937070,MATH 10A,A03,083737,Patchell; Gregory David,16,0,30,14
1656204943095,MATH 10B,A01,083207,Lim; Seonhee,0,0,34,34
1656204943095,MATH 10B,A02,083208,Lim; Seonhee,7,0,35,28
1656204943095,MATH 10B,A03,093472,Staff,1,0,34,33
1656204943095,MATH 10B,B01,083739,Sinha; Shubham,11,0,30,19
1656204949117,MATH 18,A01,083743,Cinel; Cameron Alexander,7,0,30,23
1656204949117,MATH 18,A02,083744,Cinel; Cameron Alexander,10,0,30,20
1656204949117,MATH 18,A03,083745,Cinel; Cameron Alexander,4,0,30,26
1656204949117,MATH 18,B01,083748,Rideout; David Porter,1,0,36,35
1656204949117,MATH 18,B02,083749,Rideout; David Porter,0,0,36,36
1656204949117,MATH 18,B03,083750,Rideout; David Porter,0,0,36,36
1656204949117,MATH 18,B04,083751,Rideout; David Porter,0,0,36,36
1656204949117,MATH 18,B05,093473,Rideout; David Porter,0,0,36,36
1656204949117,MATH 18,B06,093474,Rideout; David Porter,3,0,36,33
1656204955140,MATH 20A,A01,083754,Zheng; Zequn,11,0,40,29
1656204961165,MATH 20B,A01,083756,Briones; Jor-el Thomas Caparas,0,0,36,36
1656204961165,MATH 20B,A02,083757,Briones; Jor-el Thomas Caparas,0,0,36,36
1656204961165,MATH 20B,A03,093475,Staff,1,0,36,35
1656204967188,MATH 20C,A01,083760,Briones; Jor-el Thomas Caparas,0,0,35,35
1656204967188,MATH 20C,A02,083761,Briones; Jor-el Thomas Caparas,9,1,35,26
1656204967188,MATH 20C,A03,093476,Staff,0,0,35,35
1656204967188,MATH 20C,B01,083762,Bach; Quang Tran,1,0,30,29
1656204973217,MATH 20D,A01,083765,Tran; Brian Kha,1,0,30,29
1656204973217,MATH 20D,A02,083766,Tran; Brian Kha,0,1,30,30
1656204973217,MATH 20D,A03,083767,Tran; Brian Kha,2,0,30,28
1656204979246,MATH 20E,A01,083771,Ganguly; Soumya,3,0,32,29
1656204979246,MATH 20E,A02,083772,Ganguly; Soumya,0,0,32,32
1656204979246,MATH 20E,B01,083773,Ciotti; Benjamin,16,0,35,19
1656204979246,MATH 20E,B02,083774,Ciotti; Benjamin,15,0,35,20
1656204985270,MATH 103A,A01,083777,Greenfeld; Be'Eri,1,0,36,35
1656204985270,MATH 103A,A02,083778,Greenfeld; Be'Eri,1,0,36,35
1656204985270,MATH 103A,A03,093561,Staff,5,0,36,31
1656204985270,MATH 103A,B01,083779,Greenfeld; Be'Eri,9,1,36,27
1656204985270,MATH 103A,B02,083780,Greenfeld; Be'Eri,1,0,36,35
1656204985270,MATH 103A,B03,093562,Staff,0,0,36,36
1656204991309,MATH 105,A01,085443,Carter; Anne Toulson,5,1,35,30
1656204991309,MATH 105,A02,093477,Staff,13,0,35,22
1656204997336,MATH 109,A01,083213,Ganzberger; Geoffrey Michael,0,0,34,34
1656204997336,MATH 109,A02,083214,Ganzberger; Geoffrey Michael,0,0,34,34
1656204997336,MATH 109,A03,093478,Staff,1,0,34,33
1656204997336,MATH 109,B01,083215,Ganzberger; Geoffrey Michael,4,0,32,28
1656204997336,MATH 109,B02,083216,Ganzberger; Geoffrey Michael,1,0,32,31
1656204997336,MATH 109,B03,093479,Staff,4,0,32,28
1656205003364,MATH 142A,A01,083219,Chow; Bennett,2,0,32,30
1656205003364,MATH 142A,A02,083220,Chow; Bennett,8,0,32,24
1656205003364,MATH 142A,A03,093480,Staff,5,0,32,27
1656205003364,MATH 142A,B03,093481,Staff,3,0,32,29
1656205003364,MATH 142A,B04,093558,Staff,6,0,32,26
1656205003364,MATH 142A,B05,093559,Staff,1,0,32,31
1656205009388,MATH 193A,A01,083224,Rotar; Vladimir,0,1,34,34
1656205009388,MATH 193A,A02,083225,Rotar; Vladimir,0,0,34,34
1656205009388,MATH 193A,A03,083781,Rotar; Vladimir,1,0,34,33
1656205009388,MATH 193A,A04,083782,Rotar; Vladimir,6,0,34,28
1656205009388,MATH 193A,A05,093482,Rotar; Vladimir,0,0,34,34
1656205015412,MATH 197,001,091859,McAuley; Julian John,9999,0,9999,0
1656205015412,MATH 197,002,095566,Kedlaya; Kiran S.,9997,0,9999,2
1656205015412,MATH 197,003,095567,Xiao; Ming,9999,0,9999,0
1656205015412,MATH 197,004,095571,Perols; Johan Lars,9998,0,9999,1
1656205022467,COGS 9,A01,083615,Shannon; Kyle Michael,4,0,75,71
1656205028493,COGS 11,A01,083617,Boyle; Mary E. T.,14,0,48,34
1656205034517,COGS 13,A01,083071,Bastos; Amalia Pinkusfeld,4,0,71,67
1656205040539,COGS 14A,A01,092681,Semenuks; Arturs,4,16,100,96
1656205046561,COGS 14B,A01,083073,Cheng; Tzu-Han,7,0,63,56
1656205052584,COGS 17,A01,092677,Semenuks; Arturs,7,0,81,74
1656205058607,COGS 100,A01,083619,Allen; Michael Gordon,2,0,70,68
1656205064631,COGS 101A,A01,083621,Davis; Joshua Daniel,4,0,68,64
1656205070658,COGS 101B,A01,091572,Allen; Michael Gordon,4,0,65,61
1656205076684,COGS 101C,A01,083625,Delgado; Tania,10,0,35,25
1656205082710,COGS 107A,A01,083627,Boyle; Mary E. T.,0,0,60,60
1656205088734,COGS 118A,A01,083075,Gupta; Anjum,7,0,76,69
1656205094759,CSE 3,A50,083646,Miranda; Gregory Joseph,18,0,50,32
1656205100783,CSE 8A,A50,083650,Miranda; Gregory Joseph,3,3,56,53
1656205106807,CSE 11,A01,083080,Cao; Yingjun,1,50,40,39
1656205112831,CSE 12,A01,083652,Krause-Levy; Sophia Louisa,7,2,120,113
1656205118857,CSE 15L,A01,083654,Morris; Justin Loren,2,0,50,48
1656205118857,CSE 15L,A02,083655,Morris; Justin Loren,4,0,50,46
1656205124881,CSE 20,A01,083657,Tran; Khoa Dang,30,0,80,50
1656205130903,CSE 21,A01,095574,Bach; Quang Tran,24,0,48,24
1656205136933,CSE 30,A01,083084,Eldon; John,2,8,80,78
1656205136933,CSE 30,B01,095061,Bhaskar; Nishant,1,2,50,49
1656205142959,CSE 100,A01,083659,Cao; Yingjun,2,20,70,68
1656205148982,CSE 134B,A01,083661,Powell; Thomas Allan,3,0,100,97
1656205155003,CSE 140,A01,083663,Gungor; Onat,9,0,85,76
1656205161026,CSE 140L,A01,083088,Eldon; John,8,0,100,92
1656205167052,CSE 175,A01,083665,Kumar; Rakesh,0,0,25,25
1656205173077,CSE 190,A00,092507,Dubnov; Shlomo,3,0,20,17
1656205179103,ECE 45,A01,083139,Congero; Spencer William,1,0,75,74
1656205185130,ECE 65,A50,083695,Saad; Andrew S,9,0,30,21
1656205185130,ECE 65,A51,095125,Staff,23,0,26,3
1656205191156,ECE 109,A01,091882,Touri; Behrouz,0,1,70,70
1656205197180,ECE 180,A00,083140,Abi Samra; Nicholas Camill,1,0,30,29
1656205197180,ECE 180,B00,083141,Abi Samra; Nicholas Camill,0,4,30,30
1656205203208,MATH 10A,A01,083735,Patchell; Gregory David,0,0,30,30
1656205203208,MATH 10A,A02,083736,Patchell; Gregory David,22,0,30,8
1656205203208,MATH 10A,A03,083737,Patchell; Gregory David,16,0,30,14
1656205209235,MATH 10B,A01,083207,Lim; Seonhee,0,0,34,34
1656205209235,MATH 10B,A02,083208,Lim; Seonhee,7,0,35,28
1656205209235,MATH 10B,A03,093472,Staff,1,0,34,33
1656205209235,MATH 10B,B01,083739,Sinha; Shubham,11,0,30,19
1656205215265,MATH 18,A01,083743,Cinel; Cameron Alexander,7,0,30,23
1656205215265,MATH 18,A02,083744,Cinel; Cameron Alexander,10,0,30,20
1656205215265,MATH 18,A03,083745,Cinel; Cameron Alexander,4,0,30,26
1656205215265,MATH 18,B01,083748,Rideout; David Porter,1,0,36,35
1656205215265,MATH 18,B02,083749,Rideout; David Porter,0,0,36,36
1656205215265,MATH 18,B03,083750,Rideout; David Porter,0,0,36,36
1656205215265,MATH 18,B04,083751,Rideout; David Porter,0,0,36,36
1656205215265,MATH 18,B05,093473,Rideout; David Porter,0,0,36,36
1656205215265,MATH 18,B06,093474,Rideout; David Porter,3,0,36,33
1656205221292,MATH 20A,A01,083754,Zheng; Zequn,11,0,40,29
1656205227319,MATH 20B,A01,083756,Briones; Jor-el Thomas Caparas,0,0,36,36
1656205227319,MATH 20B,A02,083757,Briones; Jor-el Thomas Caparas,0,0,36,36
1656205227319,MATH 20B,A03,093475,Staff,1,0,36,35
1656205233346,MATH 20C,A01,083760,Briones; Jor-el Thomas Caparas,0,0,35,35
1656205233346,MATH 20C,A02,083761,Briones; Jor-el Thomas Caparas,9,1,35,26
1656205233346,MATH 20C,A03,093476,Staff,0,0,35,35
1656205233346,MATH 20C,B01,083762,Bach; Quang Tran,1,0,30,29
1656205239369,MATH 20D,A01,083765,Tran; Brian Kha,1,0,30,29
1656205239369,MATH 20D,A02,083766,Tran; Brian Kha,0,1,30,30
1656205239369,MATH 20D,A03,083767,Tran; Brian Kha,2,0,30,28
1656205245398,MATH 20E,A01,083771,Ganguly; Soumya,3,0,32,29
1656205245398,MATH 20E,A02,083772,Ganguly; Soumya,0,0,32,32
1656205245398,MATH 20E,B01,083773,Ciotti; Benjamin,16,0,35,19
1656205245398,MATH 20E,B02,083774,Ciotti; Benjamin,15,0,35,20
1656205251421,MATH 103A,A01,083777,Greenfeld; Be'Eri,1,0,36,35
1656205251421,MATH 103A,A02,083778,Greenfeld; Be'Eri,1,0,36,35
1656205251421,MATH 103A,A03,093561,Staff,5,0,36,31
1656205251421,MATH 103A,B01,083779,Greenfeld; Be'Eri,9,1,36,27
1656205251421,MATH 103A,B02,083780,Greenfeld; Be'Eri,1,0,36,35
1656205251421,MATH 103A,B03,093562,Staff,0,0,36,36
1656205257445,MATH 105,A01,085443,Carter; Anne Toulson,5,1,35,30
1656205257445,MATH 105,A02,093477,Staff,13,0,35,22
1656205263476,MATH 109,A01,083213,Ganzberger; Geoffrey Michael,0,0,34,34
1656205263476,MATH 109,A02,083214,Ganzberger; Geoffrey Michael,0,0,34,34
1656205263476,MATH 109,A03,093478,Staff,1,0,34,33
1656205263476,MATH 109,B01,083215,Ganzberger; Geoffrey Michael,4,0,32,28
1656205263476,MATH 109,B02,083216,Ganzberger; Geoffrey Michael,1,0,32,31
1656205263476,MATH 109,B03,093479,Staff,4,0,32,28
1656205269499,MATH 142A,A01,083219,Chow; Bennett,2,0,32,30
1656205269499,MATH 142A,A02,083220,Chow; Bennett,8,0,32,24
1656205269499,MATH 142A,A03,093480,Staff,5,0,32,27
1656205269499,MATH 142A,B03,093481,Staff,3,0,32,29
1656205269499,MATH 142A,B04,093558,Staff,6,0,32,26
1656205269499,MATH 142A,B05,093559,Staff,1,0,32,31
1656205275534,MATH 193A,A01,083224,Rotar; Vladimir,0,1,34,34
1656205275534,MATH 193A,A02,083225,Rotar; Vladimir,0,0,34,34
1656205275534,MATH 193A,A03,083781,Rotar; Vladimir,0,0,34,34
1656205275534,MATH 193A,A04,083782,Rotar; Vladimir,6,0,34,28
1656205275534,MATH 193A,A05,093482,Rotar; Vladimir,0,0,34,34
1656205281557,MATH 197,001,091859,McAuley; Julian John,9999,0,9999,0
1656205281557,MATH 197,002,095566,Kedlaya; Kiran S.,9997,0,9999,2
1656205281557,MATH 197,003,095567,Xiao; Ming,9999,0,9999,0
1656205281557,MATH 197,004,095571,Perols; Johan Lars,9998,0,9999,1
1656205288610,COGS 9,A01,083615,Shannon; Kyle Michael,4,0,75,71
1656205294634,COGS 11,A01,083617,Boyle; Mary E. T.,14,0,48,34
1656205300660,COGS 13,A01,083071,Bastos; Amalia Pinkusfeld,5,0,71,66
1656205306688,COGS 14A,A01,092681,Semenuks; Arturs,4,16,100,96
1656205312716,COGS 14B,A01,083073,Cheng; Tzu-Han,7,0,63,56
1656205318739,COGS 17,A01,092677,Semenuks; Arturs,7,0,81,74
1656205324773,COGS 100,A01,083619,Allen; Michael Gordon,2,0,70,68
1656205330799,COGS 101A,A01,083621,Davis; Joshua Daniel,4,0,68,64
1656205336828,COGS 101B,A01,091572,Allen; Michael Gordon,4,0,65,61
1656205342943,COGS 101C,A01,083625,Delgado; Tania,10,0,35,25
1656205348972,COGS 107A,A01,083627,Boyle; Mary E. T.,0,0,60,60
1656205354997,COGS 118A,A01,083075,Gupta; Anjum,7,0,76,69
1656205361024,CSE 3,A50,083646,Miranda; Gregory Joseph,18,0,50,32
1656205367048,CSE 8A,A50,083650,Miranda; Gregory Joseph,3,3,56,53
1656205373076,CSE 11,A01,083080,Cao; Yingjun,1,50,40,39
1656205379101,CSE 12,A01,083652,Krause-Levy; Sophia Louisa,7,2,120,113
1656205385125,CSE 15L,A01,083654,Morris; Justin Loren,2,0,50,48
1656205385125,CSE 15L,A02,083655,Morris; Justin Loren,4,0,50,46
1656205391159,CSE 20,A01,083657,Tran; Khoa Dang,30,0,80,50
1656205397183,CSE 21,A01,095574,Bach; Quang Tran,24,0,48,24
1656205403207,CSE 30,A01,083084,Eldon; John,2,8,80,78
1656205403207,CSE 30,B01,095061,Bhaskar; Nishant,1,2,50,49
1656205409234,CSE 100,A01,083659,Cao; Yingjun,2,20,70,68
1656205415262,CSE 134B,A01,083661,Powell; Thomas Allan,2,0,100,98
1656205421286,CSE 140,A01,083663,Gungor; Onat,9,0,85,76
1656205427310,CSE 140L,A01,083088,Eldon; John,8,0,100,92
1656205433338,CSE 175,A01,083665,Kumar; Rakesh,0,0,25,25
1656205439361,CSE 190,A00,092507,Dubnov; Shlomo,3,0,20,17
1656205445385,ECE 45,A01,083139,Congero; Spencer William,1,0,75,74
1656205451408,ECE 65,A50,083695,Saad; Andrew S,9,0,30,21
1656205451408,ECE 65,A51,095125,Staff,23,0,26,3
1656205457436,ECE 109,A01,091882,Touri; Behrouz,0,1,70,70
1656205463458,ECE 180,A00,083140,Abi Samra; Nicholas Camill,1,0,30,29
1656205463458,ECE 180,B00,083141,Abi Samra; Nicholas Camill,0,4,30,30
1656205469487,MATH 10A,A01,083735,Patchell; Gregory David,0,0,30,30
1656205469487,MATH 10A,A02,083736,Patchell; Gregory David,22,0,30,8
1656205469487,MATH 10A,A03,083737,Patchell; Gregory David,16,0,30,14
1656205475510,MATH 10B,A01,083207,Lim; Seonhee,0,0,34,34
1656205475510,MATH 10B,A02,083208,Lim; Seonhee,7,0,35,28
1656205475510,MATH 10B,A03,093472,Staff,1,0,34,33
1656205475510,MATH 10B,B01,083739,Sinha; Shubham,11,0,30,19
1656205481536,MATH 18,A01,083743,Cinel; Cameron Alexander,7,0,30,23
1656205481536,MATH 18,A02,083744,Cinel; Cameron Alexander,10,0,30,20
1656205481536,MATH 18,A03,083745,Cinel; Cameron Alexander,4,0,30,26
1656205481536,MATH 18,B01,083748,Rideout; David Porter,1,0,36,35
1656205481536,MATH 18,B02,083749,Rideout; David Porter,0,0,36,36
1656205481536,MATH 18,B03,083750,Rideout; David Porter,0,0,36,36
1656205481536,MATH 18,B04,083751,Rideout; David Porter,0,0,36,36
1656205481536,MATH 18,B05,093473,Rideout; David Porter,0,0,36,36
1656205481536,MATH 18,B06,093474,Rideout; David Porter,3,0,36,33
1656205487563,MATH 20A,A01,083754,Zheng; Zequn,11,0,40,29
1656205493593,MATH 20B,A01,083756,Briones; Jor-el Thomas Caparas,0,0,36,36
1656205493593,MATH 20B,A02,083757,Briones; Jor-el Thomas Caparas,0,0,36,36
1656205493593,MATH 20B,A03,093475,Staff,1,0,36,35
1656205499617,MATH 20C,A01,083760,Briones; Jor-el Thomas Caparas,0,0,35,35
1656205499617,MATH 20C,A02,083761,Briones; Jor-el Thomas Caparas,9,1,35,26
1656205499617,MATH 20C,A03,093476,Staff,0,0,35,35
1656205499617,MATH 20C,B01,083762,Bach; Quang Tran,1,0,30,29
1656205505646,MATH 20D,A01,083765,Tran; Brian Kha,1,0,30,29
1656205505646,MATH 20D,A02,083766,Tran; Brian Kha,0,1,30,30
1656205505646,MATH 20D,A03,083767,Tran; Brian Kha,2,0,30,28
1656205511677,MATH 20E,A01,083771,Ganguly; Soumya,3,0,32,29
1656205511677,MATH 20E,A02,083772,Ganguly; Soumya,0,0,32,32
1656205511677,MATH 20E,B01,083773,Ciotti; Benjamin,16,0,35,19
1656205511677,MATH 20E,B02,083774,Ciotti; Benjamin,15,0,35,20
1656205517702,MATH 103A,A01,083777,Greenfeld; Be'Eri,1,0,36,35
1656205517702,MATH 103A,A02,083778,Greenfeld; Be'Eri,1,0,36,35
1656205517702,MATH 103A,A03,093561,Staff,5,0,36,31
1656205517702,MATH 103A,B01,083779,Greenfeld; Be'Eri,9,1,36,27
1656205517702,MATH 103A,B02,083780,Greenfeld; Be'Eri,1,0,36,35
1656205517702,MATH 103A,B03,093562,Staff,0,0,36,36
1656205523727,MATH 105,A01,085443,Carter; Anne Toulson,5,1,35,30
1656205523727,MATH 105,A02,093477,Staff,13,0,35,22
1656205529753,MATH 109,A01,083213,Ganzberger; Geoffrey Michael,0,0,34,34
1656205529753,MATH 109,A02,083214,Ganzberger; Geoffrey Michael,0,0,34,34
1656205529753,MATH 109,A03,093478,Staff,1,0,34,33
1656205529753,MATH 109,B01,083215,Ganzberger; Geoffrey Michael,4,0,32,28
1656205529753,MATH 109,B02,083216,Ganzberger; Geoffrey Michael,1,0,32,31
1656205529753,MATH 109,B03,093479,Staff,4,0,32,28
1656205535777,MATH 142A,A01,083219,Chow; Bennett,2,0,32,30
1656205535777,MATH 142A,A02,083220,Chow; Bennett,8,0,32,24
1656205535777,MATH 142A,A03,093480,Staff,5,0,32,27
1656205535777,MATH 142A,B03,093481,Staff,3,0,32,29
1656205535777,MATH 142A,B04,093558,Staff,6,0,32,26
1656205535777,MATH 142A,B05,093559,Staff,1,0,32,31
1656205541805,MATH 193A,A01,083224,Rotar; Vladimir,0,1,34,34
1656205541805,MATH 193A,A02,083225,Rotar; Vladimir,0,0,34,34
1656205541805,MATH 193A,A03,083781,Rotar; Vladimir,0,0,34,34
1656205541805,MATH 193A,A04,083782,Rotar; Vladimir,6,0,34,28
1656205541805,MATH 193A,A05,093482,Rotar; Vladimir,0,0,34,34
1656205547827,MATH 197,001,091859,McAuley; Julian John,9999,0,9999,0
1656205547827,MATH 197,002,095566,Kedlaya; Kiran S.,9997,0,9999,2
1656205547827,MATH 197,003,095567,Xiao; Ming,9999,0,9999,0
1656205547827,MATH 197,004,095571,Perols; Johan Lars,9998,0,9999,1
1656205554895,COGS 9,A01,083615,Shannon; Kyle Michael,4,0,75,71
1656205560918,COGS 11,A01,083617,Boyle; Mary E. T.,14,0,48,34
1656205566945,COGS 13,A01,083071,Bastos; Amalia Pinkusfeld,5,0,71,66
1656205572970,COGS 14A,A01,092681,Semenuks; Arturs,4,16,100,96
1656205578996,COGS 14B,A01,083073,Cheng; Tzu-Han,7,0,63,56
1656205585030,COGS 17,A01,092677,Semenuks; Arturs,7,0,81,74
1656205591058,COGS 100,A01,083619,Allen; Michael Gordon,2,0,70,68
1656205597085,COGS 101A,A01,083621,Davis; Joshua Daniel,4,0,68,64
1656205603108,COGS 101B,A01,091572,Allen; Michael Gordon,4,0,65,61
1656205609132,COGS 101C,A01,083625,Delgado; Tania,10,0,35,25
1656205615160,COGS 107A,A01,083627,Boyle; Mary E. T.,0,0,60,60
1656205621186,COGS 118A,A01,083075,Gupta; Anjum,7,0,76,69
1656205627209,CSE 3,A50,083646,Miranda; Gregory Joseph,18,0,50,32
1656205633233,CSE 8A,A50,083650,Miranda; Gregory Joseph,3,3,56,53
1656205639258,CSE 11,A01,083080,Cao; Yingjun,1,50,40,39
1656205645284,CSE 12,A01,083652,Krause-Levy; Sophia Louisa,7,2,120,113
1656205651313,CSE 15L,A01,083654,Morris; Justin Loren,2,0,50,48
1656205651313,CSE 15L,A02,083655,Morris; Justin Loren,4,0,50,46
1656205657340,CSE 20,A01,083657,Tran; Khoa Dang,30,0,80,50
1656205663364,CSE 21,A01,095574,Bach; Quang Tran,24,0,48,24
1656205669385,CSE 30,A01,083084,Eldon; John,2,8,80,78
1656205669385,CSE 30,B01,095061,Bhaskar; Nishant,1,2,50,49
1656205675408,CSE 100,A01,083659,Cao; Yingjun,2,20,70,68
1656205681434,CSE 134B,A01,083661,Powell; Thomas Allan,2,0,100,98
1656205687456,CSE 140,A01,083663,Gungor; Onat,9,0,85,76
1656205693477,CSE 140L,A01,083088,Eldon; John,8,0,100,92
1656205699500,CSE 175,A01,083665,Kumar; Rakesh,0,0,25,25
1656205705525,CSE 190,A00,092507,Dubnov; Shlomo,3,0,20,17
1656205711553,ECE 45,A01,083139,Congero; Spencer William,1,0,75,74
1656205717576,ECE 65,A50,083695,Saad; Andrew S,9,0,30,21
1656205717576,ECE 65,A51,095125,Staff,23,0,26,3
1656205723602,ECE 109,A01,091882,Touri; Behrouz,0,1,70,70
1656205729629,ECE 180,A00,083140,Abi Samra; Nicholas Camill,1,0,30,29
1656205729629,ECE 180,B00,083141,Abi Samra; Nicholas Camill,0,4,30,30
1656205735656,MATH 10A,A01,083735,Patchell; Gregory David,0,0,30,30
1656205735656,MATH 10A,A02,083736,Patchell; Gregory David,22,0,30,8
1656205735656,MATH 10A,A03,083737,Patchell; Gregory David,16,0,30,14
1656205741681,MATH 10B,A01,083207,Lim; Seonhee,0,0,34,34
1656205741681,MATH 10B,A02,083208,Lim; Seonhee,7,0,35,28
1656205741681,MATH 10B,A03,093472,Staff,1,0,34,33
1656205741681,MATH 10B,B01,083739,Sinha; Shubham,11,0,30,19
1656205747705,MATH 18,A01,083743,Cinel; Cameron Alexander,7,0,30,23
1656205747705,MATH 18,A02,083744,Cinel; Cameron Alexander,10,0,30,20
1656205747705,MATH 18,A03,083745,Cinel; Cameron Alexander,4,0,30,26
1656205747705,MATH 18,B01,083748,Rideout; David Porter,1,0,36,35
1656205747705,MATH 18,B02,083749,Rideout; David Porter,0,0,36,36
1656205747705,MATH 18,B03,083750,Rideout; David Porter,0,0,36,36
1656205747705,MATH 18,B04,083751,Rideout; David Porter,0,0,36,36
1656205747705,MATH 18,B05,093473,Rideout; David Porter,0,0,36,36
1656205747705,MATH 18,B06,093474,Rideout; David Porter,3,0,36,33
1656205753732,MATH 20A,A01,083754,Zheng; Zequn,11,0,40,29
1656205759756,MATH 20B,A01,083756,Briones; Jor-el Thomas Caparas,0,0,36,36
1656205759756,MATH 20B,A02,083757,Briones; Jor-el Thomas Caparas,0,0,36,36
1656205759756,MATH 20B,A03,093475,Staff,1,0,36,35
1656205765778,MATH 20C,A01,083760,Briones; Jor-el Thomas Caparas,0,0,35,35
1656205765778,MATH 20C,A02,083761,Briones; Jor-el Thomas Caparas,9,1,35,26
1656205765778,MATH 20C,A03,093476,Staff,0,0,35,35
1656205765778,MATH 20C,B01,083762,Bach; Quang Tran,1,0,30,29
1656205771803,MATH 20D,A01,083765,Tran; Brian Kha,1,0,30,29
1656205771803,MATH 20D,A02,083766,Tran; Brian Kha,0,1,30,30
1656205771803,MATH 20D,A03,083767,Tran; Brian Kha,2,0,30,28
1656205777826,MATH 20E,A01,083771,Ganguly; Soumya,3,0,32,29
1656205777826,MATH 20E,A02,083772,Ganguly; Soumya,0,0,32,32
1656205777826,MATH 20E,B01,083773,Ciotti; Benjamin,16,0,35,19
1656205777826,MATH 20E,B02,083774,Ciotti; Benjamin,15,0,35,20
1656205783849,MATH 103A,A01,083777,Greenfeld; Be'Eri,1,0,36,35
1656205783849,MATH 103A,A02,083778,Greenfeld; Be'Eri,1,0,36,35
1656205783849,MATH 103A,A03,093561,Staff,5,0,36,31
1656205783849,MATH 103A,B01,083779,Greenfeld; Be'Eri,9,1,36,27
1656205783849,MATH 103A,B02,083780,Greenfeld; Be'Eri,1,0,36,35
1656205783849,MATH 103A,B03,093562,Staff,0,0,36,36
1656205789877,MATH 105,A01,085443,Carter; Anne Toulson,5,1,35,30
1656205789877,MATH 105,A02,093477,Staff,13,0,35,22
1656205795904,MATH 109,A01,083213,Ganzberger; Geoffrey Michael,0,0,34,34
1656205795904,MATH 109,A02,083214,Ganzberger; Geoffrey Michael,0,0,34,34
1656205795904,MATH 109,A03,093478,Staff,1,0,34,33
1656205795904,MATH 109,B01,083215,Ganzberger; Geoffrey Michael,4,0,32,28
1656205795904,MATH 109,B02,083216,Ganzberger; Geoffrey Michael,1,0,32,31
1656205795904,MATH 109,B03,093479,Staff,4,0,32,28
1656205801933,MATH 142A,A01,083219,Chow; Bennett,2,0,32,30
1656205801933,MATH 142A,A02,083220,Chow; Bennett,8,0,32,24
1656205801933,MATH 142A,A03,093480,Staff,5,0,32,27
1656205801933,MATH 142A,B03,093481,Staff,3,0,32,29
1656205801933,MATH 142A,B04,093558,Staff,6,0,32,26
1656205801933,MATH 142A,B05,093559,Staff,1,0,32,31
1656205807974,MATH 193A,A01,083224,Rotar; Vladimir,0,1,34,34
1656205807974,MATH 193A,A02,083225,Rotar; Vladimir,0,0,34,34
1656205807974,MATH 193A,A03,083781,Rotar; Vladimir,0,0,34,34
1656205807974,MATH 193A,A04,083782,Rotar; Vladimir,6,0,34,28
1656205807974,MATH 193A,A05,093482,Rotar; Vladimir,0,0,34,34
1656205813998,MATH 197,001,091859,McAuley; Julian John,9999,0,9999,0
1656205813998,MATH 197,002,095566,Kedlaya; Kiran S.,9997,0,9999,2
1656205813998,MATH 197,003,095567,Xiao; Ming,9999,0,9999,0
1656205813998,MATH 197,004,095571,Perols; Johan Lars,9998,0,9999,1
1656205821066,COGS 9,A01,083615,Shannon; Kyle Michael,4,0,75,71
1656205827093,COGS 11,A01,083617,Boyle; Mary E. T.,14,0,48,34
1656205833121,COGS 13,A01,083071,Bastos; Amalia Pinkusfeld,5,0,71,66
1656205839153,COGS 14A,A01,092681,Semenuks; Arturs,4,16,100,96
1656205845179,COGS 14B,A01,083073,Cheng; Tzu-Han,7,0,63,56
1656205851202,COGS 17,A01,092677,Semenuks; Arturs,7,0,81,74
1656205857230,COGS 100,A01,083619,Allen; Michael Gordon,2,0,70,68
1656205863258,COGS 101A,A01,083621,Davis; Joshua Daniel,4,0,68,64
1656205869283,COGS 101B,A01,091572,Allen; Michael Gordon,4,0,65,61
1656205875307,COGS 101C,A01,083625,Delgado; Tania,10,0,35,25
1656205881332,COGS 107A,A01,083627,Boyle; Mary E. T.,0,0,60,60
1656205887356,COGS 118A,A01,083075,Gupta; Anjum,7,0,76,69
1656205893378,CSE 3,A50,083646,Miranda; Gregory Joseph,18,0,50,32
1656205899408,CSE 8A,A50,083650,Miranda; Gregory Joseph,3,3,56,53
1656205905431,CSE 11,A01,083080,Cao; Yingjun,1,50,40,39
1656205911460,CSE 12,A01,083652,Krause-Levy; Sophia Louisa,7,2,120,113
1656205917491,CSE 15L,A01,083654,Morris; Justin Loren,2,0,50,48
1656205917491,CSE 15L,A02,083655,Morris; Justin Loren,4,0,50,46
1656205923515,CSE 20,A01,083657,Tran; Khoa Dang,30,0,80,50
1656205929541,CSE 21,A01,095574,Bach; Quang Tran,24,0,48,24
1656205935571,CSE 30,A01,083084,Eldon; John,2,8,80,78
1656205935571,CSE 30,B01,095061,Bhaskar; Nishant,1,2,50,49
1656205941664,CSE 100,A01,083659,Cao; Yingjun,2,20,70,68
1656205947686,CSE 134B,A01,083661,Powell; Thomas Allan,2,0,100,98
1656205953713,CSE 140,A01,083663,Gungor; Onat,9,0,85,76
1656205959737,CSE 140L,A01,083088,Eldon; John,8,0,100,92
1656205965759,CSE 175,A01,083665,Kumar; Rakesh,0,0,25,25
1656205971782,CSE 190,A00,092507,Dubnov; Shlomo,3,0,20,17
1656205977809,ECE 45,A01,083139,Congero; Spencer William,1,0,75,74
1656205983833,ECE 65,A50,083695,Saad; Andrew S,9,0,30,21
1656205983833,ECE 65,A51,095125,Staff,23,0,26,3
1656205989855,ECE 109,A01,091882,Touri; Behrouz,0,1,70,70
1656205995884,ECE 180,A00,083140,Abi Samra; Nicholas Camill,1,0,30,29
1656205995884,ECE 180,B00,083141,Abi Samra; Nicholas Camill,0,4,30,30
1656206001911,MATH 10A,A01,083735,Patchell; Gregory David,0,0,30,30
1656206001911,MATH 10A,A02,083736,Patchell; Gregory David,22,0,30,8
1656206001911,MATH 10A,A03,083737,Patchell; Gregory David,16,0,30,14
1656206007935,MATH 10B,A01,083207,Lim; Seonhee,0,0,34,34
1656206007935,MATH 10B,A02,083208,Lim; Seonhee,7,0,35,28
1656206007935,MATH 10B,A03,093472,Staff,1,0,34,33
1656206007935,MATH 10B,B01,083739,Sinha; Shubham,11,0,30,19
1656206013972,MATH 18,A01,083743,Cinel; Cameron Alexander,7,0,30,23
1656206013972,MATH 18,A02,083744,Cinel; Cameron Alexander,10,0,30,20
1656206013972,MATH 18,A03,083745,Cinel; Cameron Alexander,4,0,30,26
1656206013972,MATH 18,B01,083748,Rideout; David Porter,1,0,36,35
1656206013972,MATH 18,B02,083749,Rideout; David Porter,0,0,36,36
1656206013972,MATH 18,B03,083750,Rideout; David Porter,0,0,36,36
1656206013972,MATH 18,B04,083751,Rideout; David Porter,0,0,36,36
1656206013972,MATH 18,B05,093473,Rideout; David Porter,0,0,36,36
1656206013972,MATH 18,B06,093474,Rideout; David Porter,3,0,36,33
1656206019997,MATH 20A,A01,083754,Zheng; Zequn,11,0,40,29
1656206026025,MATH 20B,A01,083756,Briones; Jor-el Thomas Caparas,0,0,36,36
1656206026025,MATH 20B,A02,083757,Briones; Jor-el Thomas Caparas,0,0,36,36
1656206026025,MATH 20B,A03,093475,Staff,1,0,36,35
1656206032053,MATH 20C,A01,083760,Briones; Jor-el Thomas Caparas,0,0,35,35
1656206032053,MATH 20C,A02,083761,Briones; Jor-el Thomas Caparas,9,1,35,26
1656206032053,MATH 20C,A03,093476,Staff,0,0,35,35
1656206032053,MATH 20C,B01,083762,Bach; Quang Tran,1,0,30,29
1656206038084,MATH 20D,A01,083765,Tran; Brian Kha,1,0,30,29
1656206038084,MATH 20D,A02,083766,Tran; Brian Kha,0,1,30,30
1656206038084,MATH 20D,A03,083767,Tran; Brian Kha,2,0,30,28
1656206044108,MATH 20E,A01,083771,Ganguly; Soumya,3,0,32,29
1656206044108,MATH 20E,A02,083772,Ganguly; Soumya,0,0,32,32
1656206044108,MATH 20E,B01,083773,Ciotti; Benjamin,16,0,35,19
1656206044108,MATH 20E,B02,083774,Ciotti; Benjamin,15,0,35,20
1656206050140,MATH 103A,A01,083777,Greenfeld; Be'Eri,1,0,36,35
1656206050140,MATH 103A,A02,083778,Greenfeld; Be'Eri,1,0,36,35
1656206050140,MATH 103A,A03,093561,Staff,5,0,36,31
1656206050140,MATH 103A,B01,083779,Greenfeld; Be'Eri,9,1,36,27
1656206050140,MATH 103A,B02,083780,Greenfeld; Be'Eri,1,0,36,35
1656206050140,MATH 103A,B03,093562,Staff,0,0,36,36
1656206056166,MATH 105,A01,085443,Carter; Anne Toulson,5,1,35,30
1656206056166,MATH 105,A02,093477,Staff,13,0,35,22
1656206062195,MATH 109,A01,083213,Ganzberger; Geoffrey Michael,0,0,34,34
1656206062195,MATH 109,A02,083214,Ganzberger; Geoffrey Michael,0,0,34,34
1656206062195,MATH 109,A03,093478,Staff,1,0,34,33
1656206062195,MATH 109,B01,083215,Ganzberger; Geoffrey Michael,4,0,32,28
1656206062195,MATH 109,B02,083216,Ganzberger; Geoffrey Michael,1,0,32,31
1656206062195,MATH 109,B03,093479,Staff,4,0,32,28
1656206068220,MATH 142A,A01,083219,Chow; Bennett,2,0,32,30
1656206068220,MATH 142A,A02,083220,Chow; Bennett,8,0,32,24
1656206068220,MATH 142A,A03,093480,Staff,5,0,32,27
1656206068220,MATH 142A,B03,093481,Staff,3,0,32,29
1656206068220,MATH 142A,B04,093558,Staff,6,0,32,26
1656206068220,MATH 142A,B05,093559,Staff,1,0,32,31
1656206074243,MATH 193A,A01,083224,Rotar; Vladimir,0,1,34,34
1656206074243,MATH 193A,A02,083225,Rotar; Vladimir,0,0,34,34
1656206074243,MATH 193A,A03,083781,Rotar; Vladimir,0,0,34,34
1656206074243,MATH 193A,A04,083782,Rotar; Vladimir,6,0,34,28
1656206074243,MATH 193A,A05,093482,Rotar; Vladimir,0,0,34,34
1656206080266,MATH 197,001,091859,McAuley; Julian John,9999,0,9999,0
1656206080266,MATH 197,002,095566,Kedlaya; Kiran S.,9997,0,9999,2
1656206080266,MATH 197,003,095567,Xiao; Ming,9999,0,9999,0
1656206080266,MATH 197,004,095571,Perols; Johan Lars,9998,0,9999,1
1656206087332,COGS 9,A01,083615,Shannon; Kyle Michael,4,0,75,71
1656206093356,COGS 11,A01,083617,Boyle; Mary E. T.,14,0,48,34
1656206099379,COGS 13,A01,083071,Bastos; Amalia Pinkusfeld,5,0,71,66
1656206105403,COGS 14A,A01,092681,Semenuks; Arturs,4,16,100,96
1656206111427,COGS 14B,A01,083073,Cheng; Tzu-Han,7,0,63,56
1656206117453,COGS 17,A01,092677,Semenuks; Arturs,7,0,81,74
1656206123479,COGS 100,A01,083619,Allen; Michael Gordon,2,0,70,68
1656206129506,COGS 101A,A01,083621,Davis; Joshua Daniel,4,0,68,64
1656206135534,COGS 101B,A01,091572,Allen; Michael Gordon,4,0,65,61
1656206141568,COGS 101C,A01,083625,Delgado; Tania,10,0,35,25
1656206147590,COGS 107A,A01,083627,Boyle; Mary E. T.,0,0,60,60
1656206153614,COGS 118A,A01,083075,Gupta; Anjum,7,0,76,69
1656206159644,CSE 3,A50,083646,Miranda; Gregory Joseph,18,0,50,32
1656206165671,CSE 8A,A50,083650,Miranda; Gregory Joseph,3,3,56,53
1656206171695,CSE 11,A01,083080,Cao; Yingjun,1,50,40,39
1656206177721,CSE 12,A01,083652,Krause-Levy; Sophia Louisa,7,2,120,113
1656206183745,CSE 15L,A01,083654,Morris; Justin Loren,2,0,50,48
1656206183745,CSE 15L,A02,083655,Morris; Justin Loren,4,0,50,46
1656206189770,CSE 20,A01,083657,Tran; Khoa Dang,30,0,80,50
1656206195798,CSE 21,A01,095574,Bach; Quang Tran,24,0,48,24
1656206201826,CSE 30,A01,083084,Eldon; John,2,8,80,78
1656206201826,CSE 30,B01,095061,Bhaskar; Nishant,1,2,50,49
1656206207849,CSE 100,A01,083659,Cao; Yingjun,2,20,70,68
1656206213876,CSE 134B,A01,083661,Powell; Thomas Allan,2,0,100,98
1656206219905,CSE 140,A01,083663,Gungor; Onat,9,0,85,76
1656206225931,CSE 140L,A01,083088,Eldon; John,8,0,100,92
1656206231961,CSE 175,A01,083665,Kumar; Rakesh,0,0,25,25
1656206237984,CSE 190,A00,092507,Dubnov; Shlomo,3,0,20,17
1656206244023,ECE 45,A01,083139,Congero; Spencer William,1,0,75,74
1656206250050,ECE 65,A50,083695,Saad; Andrew S,9,0,30,21
1656206250050,ECE 65,A51,095125,Staff,23,0,26,3
1656206256074,ECE 109,A01,091882,Touri; Behrouz,0,1,70,70
1656206262103,ECE 180,A00,083140,Abi Samra; Nicholas Camill,1,0,30,29
1656206262103,ECE 180,B00,083141,Abi Samra; Nicholas Camill,0,4,30,30
1656206268133,MATH 10A,A01,083735,Patchell; Gregory David,0,0,30,30
1656206268133,MATH 10A,A02,083736,Patchell; Gregory David,22,0,30,8
1656206268133,MATH 10A,A03,083737,Patchell; Gregory David,16,0,30,14
1656206274155,MATH 10B,A01,083207,Lim; Seonhee,0,0,34,34
1656206274155,MATH 10B,A02,083208,Lim; Seonhee,7,0,35,28
1656206274155,MATH 10B,A03,093472,Staff,1,0,34,33
1656206274155,MATH 10B,B01,083739,Sinha; Shubham,11,0,30,19
1656206280181,MATH 18,A01,083743,Cinel; Cameron Alexander,7,0,30,23
1656206280181,MATH 18,A02,083744,Cinel; Cameron Alexander,10,0,30,20
1656206280181,MATH 18,A03,083745,Cinel; Cameron Alexander,4,0,30,26
1656206280181,MATH 18,B01,083748,Rideout; David Porter,1,0,36,35
1656206280181,MATH 18,B02,083749,Rideout; David Porter,0,0,36,36
1656206280181,MATH 18,B03,083750,Rideout; David Porter,0,0,36,36
1656206280181,MATH 18,B04,083751,Rideout; David Porter,0,0,36,36
1656206280181,MATH 18,B05,093473,Rideout; David Porter,0,0,36,36
1656206280181,MATH 18,B06,093474,Rideout; David Porter,3,0,36,33
1656206286203,MATH 20A,A01,083754,Zheng; Zequn,11,0,40,29
1656206292229,MATH 20B,A01,083756,Briones; Jor-el Thomas Caparas,0,0,36,36
1656206292229,MATH 20B,A02,083757,Briones; Jor-el Thomas Caparas,0,0,36,36
1656206292229,MATH 20B,A03,093475,Staff,1,0,36,35
1656206298254,MATH 20C,A01,083760,Briones; Jor-el Thomas Caparas,0,0,35,35
1656206298254,MATH 20C,A02,083761,Briones; Jor-el Thomas Caparas,9,1,35,26
1656206298254,MATH 20C,A03,093476,Staff,0,0,35,35
1656206298254,MATH 20C,B01,083762,Bach; Quang Tran,1,0,30,29
1656206304282,MATH 20D,A01,083765,Tran; Brian Kha,1,0,30,29
1656206304282,MATH 20D,A02,083766,Tran; Brian Kha,0,1,30,30
1656206304282,MATH 20D,A03,083767,Tran; Brian Kha,2,0,30,28
1656206310310,MATH 20E,A01,083771,Ganguly; Soumya,3,0,32,29
1656206310310,MATH 20E,A02,083772,Ganguly; Soumya,0,0,32,32
1656206310310,MATH 20E,B01,083773,Ciotti; Benjamin,16,0,35,19
1656206310310,MATH 20E,B02,083774,Ciotti; Benjamin,15,0,35,20
1656206316334,MATH 103A,A01,083777,Greenfeld; Be'Eri,1,0,36,35
1656206316334,MATH 103A,A02,083778,Greenfeld; Be'Eri,1,0,36,35
1656206316334,MATH 103A,A03,093561,Staff,5,0,36,31
1656206316334,MATH 103A,B01,083779,Greenfeld; Be'Eri,9,1,36,27
1656206316334,MATH 103A,B02,083780,Greenfeld; Be'Eri,1,0,36,35
1656206316334,MATH 103A,B03,093562,Staff,0,0,36,36
1656206322362,MATH 105,A01,085443,Carter; Anne Toulson,5,1,35,30
1656206322362,MATH 105,A02,093477,Staff,13,0,35,22
1656206328389,MATH 109,A01,083213,Ganzberger; Geoffrey Michael,0,0,34,34
1656206328389,MATH 109,A02,083214,Ganzberger; Geoffrey Michael,0,0,34,34
1656206328389,MATH 109,A03,093478,Staff,1,0,34,33
1656206328389,MATH 109,B01,083215,Ganzberger; Geoffrey Michael,4,0,32,28
1656206328389,MATH 109,B02,083216,Ganzberger; Geoffrey Michael,1,0,32,31
1656206328389,MATH 109,B03,093479,Staff,4,0,32,28
1656206334413,MATH 142A,A01,083219,Chow; Bennett,2,0,32,30
1656206334413,MATH 142A,A02,083220,Chow; Bennett,8,0,32,24
1656206334413,MATH 142A,A03,093480,Staff,5,0,32,27
1656206334413,MATH 142A,B03,093481,Staff,3,0,32,29
1656206334413,MATH 142A,B04,093558,Staff,6,0,32,26
1656206334413,MATH 142A,B05,093559,Staff,1,0,32,31
1656206340441,MATH 193A,A01,083224,Rotar; Vladimir,0,1,34,34
1656206340441,MATH 193A,A02,083225,Rotar; Vladimir,0,0,34,34
1656206340441,MATH 193A,A03,083781,Rotar; Vladimir,0,0,34,34
1656206340441,MATH 193A,A04,083782,Rotar; Vladimir,6,0,34,28
1656206340441,MATH 193A,A05,093482,Rotar; Vladimir,0,0,34,34
1656206346469,MATH 197,001,091859,McAuley; Julian John,9999,0,9999,0
1656206346469,MATH 197,002,095566,Kedlaya; Kiran S.,9997,0,9999,2
1656206346469,MATH 197,003,095567,Xiao; Ming,9999,0,9999,0
1656206346469,MATH 197,004,095571,Perols; Johan Lars,9998,0,9999,1
1656206353520,COGS 9,A01,083615,Shannon; Kyle Michael,3,0,75,72
1656206359546,COGS 11,A01,083617,Boyle; Mary E. T.,14,0,48,34
1656206365569,COGS 13,A01,083071,Bastos; Amalia Pinkusfeld,5,0,71,66
1656206371591,COGS 14A,A01,092681,Semenuks; Arturs,4,16,100,96
1656206377616,COGS 14B,A01,083073,Cheng; Tzu-Han,7,0,63,56
1656206383639,COGS 17,A01,092677,Semenuks; Arturs,7,0,81,74
1656206389661,COGS 100,A01,083619,Allen; Michael Gordon,2,0,70,68
1656206395689,COGS 101A,A01,083621,Davis; Joshua Daniel,4,0,68,64
1656206401721,COGS 101B,A01,091572,Allen; Michael Gordon,4,0,65,61
1656206407748,COGS 101C,A01,083625,Delgado; Tania,10,0,35,25
1656206413772,COGS 107A,A01,083627,Boyle; Mary E. T.,0,0,60,60
1656206419799,COGS 118A,A01,083075,Gupta; Anjum,7,0,76,69
1656206425824,CSE 3,A50,083646,Miranda; Gregory Joseph,18,0,50,32
1656206431849,CSE 8A,A50,083650,Miranda; Gregory Joseph,3,3,56,53
1656206437872,CSE 11,A01,083080,Cao; Yingjun,1,50,40,39
1656206443896,CSE 12,A01,083652,Krause-Levy; Sophia Louisa,7,2,120,113
1656206449919,CSE 15L,A01,083654,Morris; Justin Loren,2,0,50,48
1656206449919,CSE 15L,A02,083655,Morris; Justin Loren,4,0,50,46
1656206455946,CSE 20,A01,083657,Tran; Khoa Dang,30,0,80,50
1656206461972,CSE 21,A01,095574,Bach; Quang Tran,24,0,48,24
1656206468000,CSE 30,A01,083084,Eldon; John,2,8,80,78
1656206468000,CSE 30,B01,095061,Bhaskar; Nishant,1,2,50,49
1656206474027,CSE 100,A01,083659,Cao; Yingjun,2,20,70,68
1656206480056,CSE 134B,A01,083661,Powell; Thomas Allan,2,0,100,98
1656206486080,CSE 140,A01,083663,Gungor; Onat,9,0,85,76
1656206492104,CSE 140L,A01,083088,Eldon; John,8,0,100,92
1656206498128,CSE 175,A01,083665,Kumar; Rakesh,0,0,25,25
1656206504152,CSE 190,A00,092507,Dubnov; Shlomo,3,0,20,17
1656206510177,ECE 45,A01,083139,Congero; Spencer William,1,0,75,74
1656206516203,ECE 65,A50,083695,Saad; Andrew S,9,0,30,21
1656206516203,ECE 65,A51,095125,Staff,23,0,26,3
1656206522236,ECE 109,A01,091882,Touri; Behrouz,0,1,70,70
1656206528262,ECE 180,A00,083140,Abi Samra; Nicholas Camill,1,0,30,29
1656206528262,ECE 180,B00,083141,Abi Samra; Nicholas Camill,0,4,30,30
1656206534291,MATH 10A,A01,083735,Patchell; Gregory David,0,0,30,30
1656206534291,MATH 10A,A02,083736,Patchell; Gregory David,22,0,30,8
1656206534291,MATH 10A,A03,083737,Patchell; Gregory David,16,0,30,14
1656206540393,MATH 10B,A01,083207,Lim; Seonhee,0,0,34,34
1656206540393,MATH 10B,A02,083208,Lim; Seonhee,7,0,35,28
1656206540393,MATH 10B,A03,093472,Staff,1,0,34,33
1656206540393,MATH 10B,B01,083739,Sinha; Shubham,11,0,30,19
1656206546436,MATH 18,A01,083743,Cinel; Cameron Alexander,7,0,30,23
1656206546436,MATH 18,A02,083744,Cinel; Cameron Alexander,10,0,30,20
1656206546436,MATH 18,A03,083745,Cinel; Cameron Alexander,4,0,30,26
1656206546436,MATH 18,B01,083748,Rideout; David Porter,1,0,36,35
1656206546436,MATH 18,B02,083749,Rideout; David Porter,0,0,36,36
1656206546436,MATH 18,B03,083750,Rideout; David Porter,0,0,36,36
1656206546436,MATH 18,B04,083751,Rideout; David Porter,0,0,36,36
1656206546436,MATH 18,B05,093473,Rideout; David Porter,0,0,36,36
1656206546436,MATH 18,B06,093474,Rideout; David Porter,3,0,36,33
1656206552470,MATH 20A,A01,083754,Zheng; Zequn,11,0,40,29
1656206558494,MATH 20B,A01,083756,Briones; Jor-el Thomas Caparas,0,0,36,36
1656206558494,MATH 20B,A02,083757,Briones; Jor-el Thomas Caparas,0,0,36,36
1656206558494,MATH 20B,A03,093475,Staff,1,0,36,35
1656206564518,MATH 20C,A01,083760,Briones; Jor-el Thomas Caparas,0,0,35,35
1656206564518,MATH 20C,A02,083761,Briones; Jor-el Thomas Caparas,9,1,35,26
1656206564518,MATH 20C,A03,093476,Staff,0,0,35,35
1656206564518,MATH 20C,B01,083762,Bach; Quang Tran,1,0,30,29
1656206570544,MATH 20D,A01,083765,Tran; Brian Kha,1,0,30,29
1656206570544,MATH 20D,A02,083766,Tran; Brian Kha,0,1,30,30
1656206570544,MATH 20D,A03,083767,Tran; Brian Kha,2,0,30,28
1656206576571,MATH 20E,A01,083771,Ganguly; Soumya,3,0,32,29
1656206576571,MATH 20E,A02,083772,Ganguly; Soumya,0,0,32,32
1656206576571,MATH 20E,B01,083773,Ciotti; Benjamin,16,0,35,19
1656206576571,MATH 20E,B02,083774,Ciotti; Benjamin,15,0,35,20
1656206582598,MATH 103A,A01,083777,Greenfeld; Be'Eri,1,0,36,35
1656206582598,MATH 103A,A02,083778,Greenfeld; Be'Eri,1,0,36,35
1656206582598,MATH 103A,A03,093561,Staff,5,0,36,31
1656206582598,MATH 103A,B01,083779,Greenfeld; Be'Eri,9,1,36,27
1656206582598,MATH 103A,B02,083780,Greenfeld; Be'Eri,1,0,36,35
1656206582598,MATH 103A,B03,093562,Staff,0,0,36,36
1656206588625,MATH 105,A01,085443,Carter; Anne Toulson,5,1,35,30
1656206588625,MATH 105,A02,093477,Staff,13,0,35,22
1656206594649,MATH 109,A01,083213,Ganzberger; Geoffrey Michael,0,0,34,34
1656206594649,MATH 109,A02,083214,Ganzberger; Geoffrey Michael,0,0,34,34
1656206594649,MATH 109,A03,093478,Staff,1,0,34,33
1656206594649,MATH 109,B01,083215,Ganzberger; Geoffrey Michael,4,0,32,28
1656206594649,MATH 109,B02,083216,Ganzberger; Geoffrey Michael,1,0,32,31
1656206594649,MATH 109,B03,093479,Staff,4,0,32,28
1656206600681,MATH 142A,A01,083219,Chow; Bennett,2,0,32,30
1656206600681,MATH 142A,A02,083220,Chow; Bennett,8,0,32,24
1656206600681,MATH 142A,A03,093480,Staff,5,0,32,27
1656206600681,MATH 142A,B03,093481,Staff,3,0,32,29
1656206600681,MATH 142A,B04,093558,Staff,6,0,32,26
1656206600681,MATH 142A,B05,093559,Staff,1,0,32,31
1656206606707,MATH 193A,A01,083224,Rotar; Vladimir,0,1,34,34
1656206606707,MATH 193A,A02,083225,Rotar; Vladimir,0,0,34,34
1656206606707,MATH 193A,A03,083781,Rotar; Vladimir,0,0,34,34
1656206606707,MATH 193A,A04,083782,Rotar; Vladimir,6,0,34,28
1656206606707,MATH 193A,A05,093482,Rotar; Vladimir,0,0,34,34
1656206612733,MATH 197,001,091859,McAuley; Julian John,9999,0,9999,0
1656206612733,MATH 197,002,095566,Kedlaya; Kiran S.,9997,0,9999,2
1656206612733,MATH 197,003,095567,Xiao; Ming,9999,0,9999,0
1656206612733,MATH 197,004,095571,Perols; Johan Lars,9998,0,9999,1
1656206619782,COGS 9,A01,083615,Shannon; Kyle Michael,3,0,75,72
1656206625805,COGS 11,A01,083617,Boyle; Mary E. T.,14,0,48,34
1656206631835,COGS 13,A01,083071,Bastos; Amalia Pinkusfeld,5,0,71,66
1656206637865,COGS 14A,A01,092681,Semenuks; Arturs,4,16,100,96
1656206643887,COGS 14B,A01,083073,Cheng; Tzu-Han,7,0,63,56
1656206649909,COGS 17,A01,092677,Semenuks; Arturs,7,0,81,74
1656206655934,COGS 100,A01,083619,Allen; Michael Gordon,2,0,70,68
1656206661960,COGS 101A,A01,083621,Davis; Joshua Daniel,4,0,68,64
1656206667986,COGS 101B,A01,091572,Allen; Michael Gordon,4,0,65,61
1656206674011,COGS 101C,A01,083625,Delgado; Tania,10,0,35,25
1656206680034,COGS 107A,A01,083627,Boyle; Mary E. T.,0,0,60,60
1656206686061,COGS 118A,A01,083075,Gupta; Anjum,7,0,76,69
1656206692086,CSE 3,A50,083646,Miranda; Gregory Joseph,18,0,50,32
1656206698114,CSE 8A,A50,083650,Miranda; Gregory Joseph,3,3,56,53
1656206704143,CSE 11,A01,083080,Cao; Yingjun,1,50,40,39
1656206710169,CSE 12,A01,083652,Krause-Levy; Sophia Louisa,7,3,120,113
1656206716197,CSE 15L,A01,083654,Morris; Justin Loren,2,0,50,48
1656206716197,CSE 15L,A02,083655,Morris; Justin Loren,4,0,50,46
1656206722221,CSE 20,A01,083657,Tran; Khoa Dang,30,0,80,50
1656206728249,CSE 21,A01,095574,Bach; Quang Tran,24,0,48,24
1656206734273,CSE 30,A01,083084,Eldon; John,2,8,80,78
1656206734273,CSE 30,B01,095061,Bhaskar; Nishant,1,2,50,49
1656206740302,CSE 100,A01,083659,Cao; Yingjun,2,20,70,68
1656206746323,CSE 134B,A01,083661,Powell; Thomas Allan,2,0,100,98
1656206752346,CSE 140,A01,083663,Gungor; Onat,9,0,85,76
1656206758374,CSE 140L,A01,083088,Eldon; John,8,0,100,92
1656206764397,CSE 175,A01,083665,Kumar; Rakesh,0,0,25,25
1656206770421,CSE 190,A00,092507,Dubnov; Shlomo,3,0,20,17
1656206776451,ECE 45,A01,083139,Congero; Spencer William,1,0,75,74
1656206782474,ECE 65,A50,083695,Saad; Andrew S,9,0,30,21
1656206782474,ECE 65,A51,095125,Staff,23,0,26,3
1656206788497,ECE 109,A01,091882,Touri; Behrouz,0,1,70,70
1656206794522,ECE 180,A00,083140,Abi Samra; Nicholas Camill,1,0,30,29
1656206794522,ECE 180,B00,083141,Abi Samra; Nicholas Camill,0,4,30,30
1656206800545,MATH 10A,A01,083735,Patchell; Gregory David,0,0,30,30
1656206800545,MATH 10A,A02,083736,Patchell; Gregory David,22,0,30,8
1656206800545,MATH 10A,A03,083737,Patchell; Gregory David,16,0,30,14
1656206806570,MATH 10B,A01,083207,Lim; Seonhee,0,0,34,34
1656206806570,MATH 10B,A02,083208,Lim; Seonhee,7,0,35,28
1656206806570,MATH 10B,A03,093472,Staff,1,0,34,33
1656206806570,MATH 10B,B01,083739,Sinha; Shubham,11,0,30,19
1656206812599,MATH 18,A01,083743,Cinel; Cameron Alexander,7,0,30,23
1656206812599,MATH 18,A02,083744,Cinel; Cameron Alexander,10,0,30,20
1656206812599,MATH 18,A03,083745,Cinel; Cameron Alexander,4,0,30,26
1656206812599,MATH 18,B01,083748,Rideout; David Porter,1,0,36,35
1656206812599,MATH 18,B02,083749,Rideout; David Porter,0,0,36,36
1656206812599,MATH 18,B03,083750,Rideout; David Porter,0,0,36,36
1656206812599,MATH 18,B04,083751,Rideout; David Porter,0,0,36,36
1656206812599,MATH 18,B05,093473,Rideout; David Porter,0,0,36,36
1656206812599,MATH 18,B06,093474,Rideout; David Porter,3,0,36,33
1656206818633,MATH 20A,A01,083754,Zheng; Zequn,11,0,40,29
1656206824666,MATH 20B,A01,083756,Briones; Jor-el Thomas Caparas,0,0,36,36
1656206824666,MATH 20B,A02,083757,Briones; Jor-el Thomas Caparas,0,0,36,36
1656206824666,MATH 20B,A03,093475,Staff,1,0,36,35
1656206830690,MATH 20C,A01,083760,Briones; Jor-el Thomas Caparas,0,0,35,35
1656206830690,MATH 20C,A02,083761,Briones; Jor-el Thomas Caparas,9,1,35,26
1656206830690,MATH 20C,A03,093476,Staff,0,0,35,35
1656206830690,MATH 20C,B01,083762,Bach; Quang Tran,1,0,30,29
1656206836714,MATH 20D,A01,083765,Tran; Brian Kha,1,0,30,29
1656206836714,MATH 20D,A02,083766,Tran; Brian Kha,0,1,30,30
1656206836714,MATH 20D,A03,083767,Tran; Brian Kha,2,0,30,28
1656206842739,MATH 20E,A01,083771,Ganguly; Soumya,3,0,32,29
1656206842739,MATH 20E,A02,083772,Ganguly; Soumya,0,0,32,32
1656206842739,MATH 20E,B01,083773,Ciotti; Benjamin,16,0,35,19
1656206842739,MATH 20E,B02,083774,Ciotti; Benjamin,15,0,35,20
1656206848763,MATH 103A,A01,083777,Greenfeld; Be'Eri,1,0,36,35
1656206848763,MATH 103A,A02,083778,Greenfeld; Be'Eri,1,0,36,35
1656206848763,MATH 103A,A03,093561,Staff,5,0,36,31
1656206848763,MATH 103A,B01,083779,Greenfeld; Be'Eri,9,1,36,27
1656206848763,MATH 103A,B02,083780,Greenfeld; Be'Eri,1,0,36,35
1656206848763,MATH 103A,B03,093562,Staff,0,0,36,36
1656206854786,MATH 105,A01,085443,Carter; Anne Toulson,5,1,35,30
1656206854786,MATH 105,A02,093477,Staff,13,0,35,22
1656206860810,MATH 109,A01,083213,Ganzberger; Geoffrey Michael,0,0,34,34
1656206860810,MATH 109,A02,083214,Ganzberger; Geoffrey Michael,0,0,34,34
1656206860810,MATH 109,A03,093478,Staff,1,0,34,33
1656206860810,MATH 109,B01,083215,Ganzberger; Geoffrey Michael,4,0,32,28
1656206860810,MATH 109,B02,083216,Ganzberger; Geoffrey Michael,1,0,32,31
1656206860810,MATH 109,B03,093479,Staff,4,0,32,28
1656206866834,MATH 142A,A01,083219,Chow; Bennett,2,0,32,30
1656206866834,MATH 142A,A02,083220,Chow; Bennett,8,0,32,24
1656206866834,MATH 142A,A03,093480,Staff,5,0,32,27
1656206866834,MATH 142A,B03,093481,Staff,3,0,32,29
1656206866834,MATH 142A,B04,093558,Staff,6,0,32,26
1656206866834,MATH 142A,B05,093559,Staff,1,0,32,31
1656206872863,MATH 193A,A01,083224,Rotar; Vladimir,0,1,34,34
1656206872863,MATH 193A,A02,083225,Rotar; Vladimir,0,0,34,34
1656206872863,MATH 193A,A03,083781,Rotar; Vladimir,0,0,34,34
1656206872863,MATH 193A,A04,083782,Rotar; Vladimir,6,0,34,28
1656206872863,MATH 193A,A05,093482,Rotar; Vladimir,0,0,34,34
1656206878890,MATH 197,001,091859,McAuley; Julian John,9999,0,9999,0
1656206878890,MATH 197,002,095566,Kedlaya; Kiran S.,9997,0,9999,2
1656206878890,MATH 197,003,095567,Xiao; Ming,9999,0,9999,0
1656206878890,MATH 197,004,095571,Perols; Johan Lars,9998,0,9999,1
1656206885949,COGS 9,A01,083615,Shannon; Kyle Michael,3,0,75,72
1656206891973,COGS 11,A01,083617,Boyle; Mary E. T.,14,0,48,34
1656206897998,COGS 13,A01,083071,Bastos; Amalia Pinkusfeld,5,0,71,66
1656206904023,COGS 14A,A01,092681,Semenuks; Arturs,4,16,100,96
1656206910046,COGS 14B,A01,083073,Cheng; Tzu-Han,7,0,63,56
1656206916075,COGS 17,A01,092677,Semenuks; Arturs,7,0,81,74
1656206922102,COGS 100,A01,083619,Allen; Michael Gordon,2,0,70,68
1656206928125,COGS 101A,A01,083621,Davis; Joshua Daniel,4,0,68,64
1656206934163,COGS 101B,A01,091572,Allen; Michael Gordon,4,0,65,61
1656206940191,COGS 101C,A01,083625,Delgado; Tania,10,0,35,25
1656206946214,COGS 107A,A01,083627,Boyle; Mary E. T.,0,0,60,60
1656206952238,COGS 118A,A01,083075,Gupta; Anjum,7,0,76,69
1656206958261,CSE 3,A50,083646,Miranda; Gregory Joseph,18,0,50,32
1656206964289,CSE 8A,A50,083650,Miranda; Gregory Joseph,3,3,56,53
1656206970315,CSE 11,A01,083080,Cao; Yingjun,1,50,40,39
1656206976338,CSE 12,A01,083652,Krause-Levy; Sophia Louisa,7,3,120,113
1656206982369,CSE 15L,A01,083654,Morris; Justin Loren,2,0,50,48
1656206982369,CSE 15L,A02,083655,Morris; Justin Loren,4,0,50,46
1656206988394,CSE 20,A01,083657,Tran; Khoa Dang,30,0,80,50
1656206994421,CSE 21,A01,095574,Bach; Quang Tran,24,0,48,24
1656207000451,CSE 30,A01,083084,Eldon; John,2,8,80,78
1656207000451,CSE 30,B01,095061,Bhaskar; Nishant,1,2,50,49
1656207006474,CSE 100,A01,083659,Cao; Yingjun,2,20,70,68
1656207012500,CSE 134B,A01,083661,Powell; Thomas Allan,2,0,100,98
1656207018528,CSE 140,A01,083663,Gungor; Onat,9,0,85,76
1656207024551,CSE 140L,A01,083088,Eldon; John,8,0,100,92
1656207030579,CSE 175,A01,083665,Kumar; Rakesh,0,0,25,25
1656207036603,CSE 190,A00,092507,Dubnov; Shlomo,3,0,20,17
1656207042632,ECE 45,A01,083139,Congero; Spencer William,1,0,75,74
1656207048657,ECE 65,A50,083695,Saad; Andrew S,9,0,30,21
1656207048657,ECE 65,A51,095125,Staff,23,0,26,3
1656207054681,ECE 109,A01,091882,Touri; Behrouz,0,1,70,70
1656207060706,ECE 180,A00,083140,Abi Samra; Nicholas Camill,1,0,30,29
1656207060706,ECE 180,B00,083141,Abi Samra; Nicholas Camill,0,4,30,30
1656207066729,MATH 10A,A01,083735,Patchell; Gregory David,0,0,30,30
1656207066729,MATH 10A,A02,083736,Patchell; Gregory David,22,0,30,8
1656207066729,MATH 10A,A03,083737,Patchell; Gregory David,16,0,30,14
1656207072758,MATH 10B,A01,083207,Lim; Seonhee,0,0,34,34
1656207072758,MATH 10B,A02,083208,Lim; Seonhee,7,0,35,28
1656207072758,MATH 10B,A03,093472,Staff,1,0,34,33
1656207072758,MATH 10B,B01,083739,Sinha; Shubham,11,0,30,19
1656207078783,MATH 18,A01,083743,Cinel; Cameron Alexander,7,0,30,23
1656207078783,MATH 18,A02,083744,Cinel; Cameron Alexander,10,0,30,20
1656207078783,MATH 18,A03,083745,Cinel; Cameron Alexander,4,0,30,26
1656207078783,MATH 18,B01,083748,Rideout; David Porter,1,0,36,35
1656207078783,MATH 18,B02,083749,Rideout; David Porter,0,0,36,36
1656207078783,MATH 18,B03,083750,Rideout; David Porter,0,0,36,36
1656207078783,MATH 18,B04,083751,Rideout; David Porter,0,0,36,36
1656207078783,MATH 18,B05,093473,Rideout; David Porter,0,0,36,36
1656207078783,MATH 18,B06,093474,Rideout; David Porter,3,0,36,33
1656207084810,MATH 20A,A01,083754,Zheng; Zequn,11,0,40,29
1656207090834,MATH 20B,A01,083756,Briones; Jor-el Thomas Caparas,0,0,36,36
1656207090834,MATH 20B,A02,083757,Briones; Jor-el Thomas Caparas,0,0,36,36
1656207090834,MATH 20B,A03,093475,Staff,1,0,36,35
1656207096859,MATH 20C,A01,083760,Briones; Jor-el Thomas Caparas,0,0,35,35
1656207096859,MATH 20C,A02,083761,Briones; Jor-el Thomas Caparas,9,1,35,26
1656207096859,MATH 20C,A03,093476,Staff,0,0,35,35
1656207096859,MATH 20C,B01,083762,Bach; Quang Tran,1,0,30,29
1656207102888,MATH 20D,A01,083765,Tran; Brian Kha,1,0,30,29
1656207102888,MATH 20D,A02,083766,Tran; Brian Kha,0,1,30,30
1656207102888,MATH 20D,A03,083767,Tran; Brian Kha,2,0,30,28
1656207108917,MATH 20E,A01,083771,Ganguly; Soumya,3,0,32,29
1656207108917,MATH 20E,A02,083772,Ganguly; Soumya,0,0,32,32
1656207108917,MATH 20E,B01,083773,Ciotti; Benjamin,16,0,35,19
1656207108917,MATH 20E,B02,083774,Ciotti; Benjamin,15,0,35,20
1656207114946,MATH 103A,A01,083777,Greenfeld; Be'Eri,1,0,36,35
1656207114946,MATH 103A,A02,083778,Greenfeld; Be'Eri,1,0,36,35
1656207114946,MATH 103A,A03,093561,Staff,5,0,36,31
1656207114946,MATH 103A,B01,083779,Greenfeld; Be'Eri,9,1,36,27
1656207114946,MATH 103A,B02,083780,Greenfeld; Be'Eri,1,0,36,35
1656207114946,MATH 103A,B03,093562,Staff,0,0,36,36
1656207120969,MATH 105,A01,085443,Carter; Anne Toulson,5,1,35,30
1656207120969,MATH 105,A02,093477,Staff,13,0,35,22
1656207126993,MATH 109,A01,083213,Ganzberger; Geoffrey Michael,0,0,34,34
1656207126993,MATH 109,A02,083214,Ganzberger; Geoffrey Michael,0,0,34,34
1656207126993,MATH 109,A03,093478,Staff,1,0,34,33
1656207126993,MATH 109,B01,083215,Ganzberger; Geoffrey Michael,4,0,32,28
1656207126993,MATH 109,B02,083216,Ganzberger; Geoffrey Michael,1,0,32,31
1656207126993,MATH 109,B03,093479,Staff,4,0,32,28
1656207133027,MATH 142A,A01,083219,Chow; Bennett,2,0,32,30
1656207133027,MATH 142A,A02,083220,Chow; Bennett,8,0,32,24
1656207133027,MATH 142A,A03,093480,Staff,5,0,32,27
1656207133027,MATH 142A,B03,093481,Staff,3,0,32,29
1656207133027,MATH 142A,B04,093558,Staff,6,0,32,26
1656207133027,MATH 142A,B05,093559,Staff,1,0,32,31
1656207139120,MATH 193A,A01,083224,Rotar; Vladimir,0,1,34,34
1656207139120,MATH 193A,A02,083225,Rotar; Vladimir,0,0,34,34
1656207139120,MATH 193A,A03,083781,Rotar; Vladimir,0,0,34,34
1656207139120,MATH 193A,A04,083782,Rotar; Vladimir,6,0,34,28
1656207139120,MATH 193A,A05,093482,Rotar; Vladimir,0,0,34,34
1656207145145,MATH 197,001,091859,McAuley; Julian John,9999,0,9999,0
1656207145145,MATH 197,002,095566,Kedlaya; Kiran S.,9997,0,9999,2
1656207145145,MATH 197,003,095567,Xiao; Ming,9999,0,9999,0
1656207145145,MATH 197,004,095571,Perols; Johan Lars,9998,0,9999,1
1656207152333,COGS 9,A01,083615,Shannon; Kyle Michael,3,0,75,72
1656207158361,COGS 11,A01,083617,Boyle; Mary E. T.,14,0,48,34
1656207164389,COGS 13,A01,083071,Bastos; Amalia Pinkusfeld,5,0,71,66
1656207170412,COGS 14A,A01,092681,Semenuks; Arturs,4,16,100,96
1656207176440,COGS 14B,A01,083073,Cheng; Tzu-Han,7,0,63,56
1656207182466,COGS 17,A01,092677,Semenuks; Arturs,7,0,81,74
1656207188490,COGS 100,A01,083619,Allen; Michael Gordon,2,0,70,68
1656207194512,COGS 101A,A01,083621,Davis; Joshua Daniel,4,0,68,64
1656207200536,COGS 101B,A01,091572,Allen; Michael Gordon,4,0,65,61
1656207206559,COGS 101C,A01,083625,Delgado; Tania,10,0,35,25
1656207212582,COGS 107A,A01,083627,Boyle; Mary E. T.,0,0,60,60
1656207218610,COGS 118A,A01,083075,Gupta; Anjum,7,0,76,69
1656207224639,CSE 3,A50,083646,Miranda; Gregory Joseph,18,0,50,32
1656207230666,CSE 8A,A50,083650,Miranda; Gregory Joseph,3,3,56,53
1656207236690,CSE 11,A01,083080,Cao; Yingjun,1,50,40,39
1656207242717,CSE 12,A01,083652,Krause-Levy; Sophia Louisa,7,3,120,113
1656207248741,CSE 15L,A01,083654,Morris; Justin Loren,2,0,50,48
1656207248741,CSE 15L,A02,083655,Morris; Justin Loren,4,0,50,46
1656207254764,CSE 20,A01,083657,Tran; Khoa Dang,30,0,80,50
1656207260789,CSE 21,A01,095574,Bach; Quang Tran,24,0,48,24
1656207266813,CSE 30,A01,083084,Eldon; John,2,8,80,78
1656207266813,CSE 30,B01,095061,Bhaskar; Nishant,1,2,50,49
1656207272838,CSE 100,A01,083659,Cao; Yingjun,2,20,70,68
1656207278865,CSE 134B,A01,083661,Powell; Thomas Allan,2,0,100,98
1656207284892,CSE 140,A01,083663,Gungor; Onat,9,0,85,76
1656207290919,CSE 140L,A01,083088,Eldon; John,8,0,100,92
1656207296943,CSE 175,A01,083665,Kumar; Rakesh,0,0,25,25
1656207302968,CSE 190,A00,092507,Dubnov; Shlomo,3,0,20,17
1656207308991,ECE 45,A01,083139,Congero; Spencer William,1,0,75,74
1656207315014,ECE 65,A50,083695,Saad; Andrew S,9,0,30,21
1656207315014,ECE 65,A51,095125,Staff,23,0,26,3
1656207321040,ECE 109,A01,091882,Touri; Behrouz,0,1,70,70
1656207327067,ECE 180,A00,083140,Abi Samra; Nicholas Camill,1,0,30,29
1656207327067,ECE 180,B00,083141,Abi Samra; Nicholas Camill,0,4,30,30
1656207333091,MATH 10A,A01,083735,Patchell; Gregory David,0,0,30,30
1656207333091,MATH 10A,A02,083736,Patchell; Gregory David,22,0,30,8
1656207333091,MATH 10A,A03,083737,Patchell; Gregory David,16,0,30,14
1656207339116,MATH 10B,A01,083207,Lim; Seonhee,0,0,34,34
1656207339116,MATH 10B,A02,083208,Lim; Seonhee,7,0,35,28
1656207339116,MATH 10B,A03,093472,Staff,1,0,34,33
1656207339116,MATH 10B,B01,083739,Sinha; Shubham,11,0,30,19
1656207345140,MATH 18,A01,083743,Cinel; Cameron Alexander,7,0,30,23
1656207345140,MATH 18,A02,083744,Cinel; Cameron Alexander,10,0,30,20
1656207345140,MATH 18,A03,083745,Cinel; Cameron Alexander,4,0,30,26
1656207345140,MATH 18,B01,083748,Rideout; David Porter,1,0,36,35
1656207345140,MATH 18,B02,083749,Rideout; David Porter,0,0,36,36
1656207345140,MATH 18,B03,083750,Rideout; David Porter,0,0,36,36
1656207345140,MATH 18,B04,083751,Rideout; David Porter,0,0,36,36
1656207345140,MATH 18,B05,093473,Rideout; David Porter,0,0,36,36
1656207345140,MATH 18,B06,093474,Rideout; David Porter,3,0,36,33
1656207351182,MATH 20A,A01,083754,Zheng; Zequn,11,0,40,29
1656207357204,MATH 20B,A01,083756,Briones; Jor-el Thomas Caparas,0,0,36,36
1656207357204,MATH 20B,A02,083757,Briones; Jor-el Thomas Caparas,0,0,36,36
1656207357204,MATH 20B,A03,093475,Staff,1,0,36,35
1656207363234,MATH 20C,A01,083760,Briones; Jor-el Thomas Caparas,0,0,35,35
1656207363234,MATH 20C,A02,083761,Briones; Jor-el Thomas Caparas,9,1,35,26
1656207363234,MATH 20C,A03,093476,Staff,0,0,35,35
1656207363234,MATH 20C,B01,083762,Bach; Quang Tran,1,0,30,29
1656207369280,MATH 20D,A01,083765,Tran; Brian Kha,1,0,30,29
1656207369280,MATH 20D,A02,083766,Tran; Brian Kha,0,1,30,30
1656207369280,MATH 20D,A03,083767,Tran; Brian Kha,2,0,30,28
1656207375312,MATH 20E,A01,083771,Ganguly; Soumya,3,0,32,29
1656207375312,MATH 20E,A02,083772,Ganguly; Soumya,0,0,32,32
1656207375312,MATH 20E,B01,083773,Ciotti; Benjamin,16,0,35,19
1656207375312,MATH 20E,B02,083774,Ciotti; Benjamin,15,0,35,20
1656207381336,MATH 103A,A01,083777,Greenfeld; Be'Eri,1,0,36,35
1656207381336,MATH 103A,A02,083778,Greenfeld; Be'Eri,1,0,36,35
1656207381336,MATH 103A,A03,093561,Staff,5,0,36,31
1656207381336,MATH 103A,B01,083779,Greenfeld; Be'Eri,9,1,36,27
1656207381336,MATH 103A,B02,083780,Greenfeld; Be'Eri,1,0,36,35
1656207381336,MATH 103A,B03,093562,Staff,0,0,36,36
1656207387360,MATH 105,A01,085443,Carter; Anne Toulson,5,1,35,30
1656207387360,MATH 105,A02,093477,Staff,13,0,35,22
1656207393385,MATH 109,A01,083213,Ganzberger; Geoffrey Michael,0,0,34,34
1656207393385,MATH 109,A02,083214,Ganzberger; Geoffrey Michael,0,0,34,34
1656207393385,MATH 109,A03,093478,Staff,1,0,34,33
1656207393385,MATH 109,B01,083215,Ganzberger; Geoffrey Michael,4,0,32,28
1656207393385,MATH 109,B02,083216,Ganzberger; Geoffrey Michael,1,0,32,31
1656207393385,MATH 109,B03,093479,Staff,4,0,32,28
1656207399416,MATH 142A,A01,083219,Chow; Bennett,2,0,32,30
1656207399416,MATH 142A,A02,083220,Chow; Bennett,8,0,32,24
1656207399416,MATH 142A,A03,093480,Staff,5,0,32,27
1656207399416,MATH 142A,B03,093481,Staff,3,0,32,29
1656207399416,MATH 142A,B04,093558,Staff,6,0,32,26
1656207399416,MATH 142A,B05,093559,Staff,1,0,32,31
1656207405446,MATH 193A,A01,083224,Rotar; Vladimir,0,1,34,34
1656207405446,MATH 193A,A02,083225,Rotar; Vladimir,0,0,34,34
1656207405446,MATH 193A,A03,083781,Rotar; Vladimir,0,0,34,34
1656207405446,MATH 193A,A04,083782,Rotar; Vladimir,6,0,34,28
1656207405446,MATH 193A,A05,093482,Rotar; Vladimir,0,0,34,34
1656207411471,MATH 197,001,091859,McAuley; Julian John,9999,0,9999,0
1656207411471,MATH 197,002,095566,Kedlaya; Kiran S.,9997,0,9999,2
1656207411471,MATH 197,003,095567,Xiao; Ming,9999,0,9999,0
1656207411471,MATH 197,004,095571,Perols; Johan Lars,9998,0,9999,1
1656207418534,COGS 9,A01,083615,Shannon; Kyle Michael,3,0,75,72
1656207424560,COGS 11,A01,083617,Boyle; Mary E. T.,14,0,48,34
1656207430585,COGS 13,A01,083071,Bastos; Amalia Pinkusfeld,5,0,71,66
1656207436608,COGS 14A,A01,092681,Semenuks; Arturs,4,16,100,96
1656207442631,COGS 14B,A01,083073,Cheng; Tzu-Han,7,0,63,56
1656207448655,COGS 17,A01,092677,Semenuks; Arturs,7,0,81,74
1656207454679,COGS 100,A01,083619,Allen; Michael Gordon,2,0,70,68
1656207460703,COGS 101A,A01,083621,Davis; Joshua Daniel,4,0,68,64
1656207466729,COGS 101B,A01,091572,Allen; Michael Gordon,4,0,65,61
1656207472752,COGS 101C,A01,083625,Delgado; Tania,10,0,35,25
1656207478779,COGS 107A,A01,083627,Boyle; Mary E. T.,0,0,60,60
1656207484803,COGS 118A,A01,083075,Gupta; Anjum,7,0,76,69
1656207490831,CSE 3,A50,083646,Miranda; Gregory Joseph,18,0,50,32
1656207496853,CSE 8A,A50,083650,Miranda; Gregory Joseph,3,3,56,53
1656207502876,CSE 11,A01,083080,Cao; Yingjun,1,50,40,39
1656207508904,CSE 12,A01,083652,Krause-Levy; Sophia Louisa,7,3,120,113
1656207514931,CSE 15L,A01,083654,Morris; Justin Loren,2,0,50,48
1656207514931,CSE 15L,A02,083655,Morris; Justin Loren,4,0,50,46
1656207520955,CSE 20,A01,083657,Tran; Khoa Dang,30,0,80,50
1656207526981,CSE 21,A01,095574,Bach; Quang Tran,24,0,48,24
1656207533007,CSE 30,A01,083084,Eldon; John,2,8,80,78
1656207533007,CSE 30,B01,095061,Bhaskar; Nishant,1,2,50,49
1656207539033,CSE 100,A01,083659,Cao; Yingjun,2,20,70,68
1656207545057,CSE 134B,A01,083661,Powell; Thomas Allan,2,0,100,98
1656207551080,CSE 140,A01,083663,Gungor; Onat,9,0,85,76
1656207557107,CSE 140L,A01,083088,Eldon; John,8,0,100,92
1656207563133,CSE 175,A01,083665,Kumar; Rakesh,0,0,25,25
1656207569159,CSE 190,A00,092507,Dubnov; Shlomo,3,0,20,17
1656207575200,ECE 45,A01,083139,Congero; Spencer William,1,0,75,74
1656207581228,ECE 65,A50,083695,Saad; Andrew S,9,0,30,21
1656207581228,ECE 65,A51,095125,Staff,23,0,26,3
1656207587251,ECE 109,A01,091882,Touri; Behrouz,0,1,70,70
1656207593275,ECE 180,A00,083140,Abi Samra; Nicholas Camill,1,0,30,29
1656207593275,ECE 180,B00,083141,Abi Samra; Nicholas Camill,0,4,30,30
1656207599300,MATH 10A,A01,083735,Patchell; Gregory David,0,0,30,30
1656207599300,MATH 10A,A02,083736,Patchell; Gregory David,22,0,30,8
1656207599300,MATH 10A,A03,083737,Patchell; Gregory David,16,0,30,14
1656207605324,MATH 10B,A01,083207,Lim; Seonhee,0,0,34,34
1656207605324,MATH 10B,A02,083208,Lim; Seonhee,7,0,35,28
1656207605324,MATH 10B,A03,093472,Staff,1,0,34,33
1656207605324,MATH 10B,B01,083739,Sinha; Shubham,11,0,30,19
1656207611357,MATH 18,A01,083743,Cinel; Cameron Alexander,7,0,30,23
1656207611357,MATH 18,A02,083744,Cinel; Cameron Alexander,10,0,30,20
1656207611357,MATH 18,A03,083745,Cinel; Cameron Alexander,4,0,30,26
1656207611357,MATH 18,B01,083748,Rideout; David Porter,1,0,36,35
1656207611357,MATH 18,B02,083749,Rideout; David Porter,0,0,36,36
1656207611357,MATH 18,B03,083750,Rideout; David Porter,0,0,36,36
1656207611357,MATH 18,B04,083751,Rideout; David Porter,0,0,36,36
1656207611357,MATH 18,B05,093473,Rideout; David Porter,0,0,36,36
1656207611357,MATH 18,B06,093474,Rideout; David Porter,3,0,36,33
1656207617381,MATH 20A,A01,083754,Zheng; Zequn,11,0,40,29
1656207623410,MATH 20B,A01,083756,Briones; Jor-el Thomas Caparas,0,0,36,36
1656207623410,MATH 20B,A02,083757,Briones; Jor-el Thomas Caparas,0,0,36,36
1656207623410,MATH 20B,A03,093475,Staff,1,0,36,35
1656207629437,MATH 20C,A01,083760,Briones; Jor-el Thomas Caparas,0,0,35,35
1656207629437,MATH 20C,A02,083761,Briones; Jor-el Thomas Caparas,9,1,35,26
1656207629437,MATH 20C,A03,093476,Staff,0,0,35,35
1656207629437,MATH 20C,B01,083762,Bach; Quang Tran,1,0,30,29
1656207635463,MATH 20D,A01,083765,Tran; Brian Kha,1,0,30,29
1656207635463,MATH 20D,A02,083766,Tran; Brian Kha,0,1,30,30
1656207635463,MATH 20D,A03,083767,Tran; Brian Kha,2,0,30,28
1656207641492,MATH 20E,A01,083771,Ganguly; Soumya,3,0,32,29
1656207641492,MATH 20E,A02,083772,Ganguly; Soumya,0,0,32,32
1656207641492,MATH 20E,B01,083773,Ciotti; Benjamin,16,0,35,19
1656207641492,MATH 20E,B02,083774,Ciotti; Benjamin,15,0,35,20
1656207647520,MATH 103A,A01,083777,Greenfeld; Be'Eri,1,0,36,35
1656207647520,MATH 103A,A02,083778,Greenfeld; Be'Eri,1,0,36,35
1656207647520,MATH 103A,A03,093561,Staff,5,0,36,31
1656207647520,MATH 103A,B01,083779,Greenfeld; Be'Eri,9,1,36,27
1656207647520,MATH 103A,B02,083780,Greenfeld; Be'Eri,1,0,36,35
1656207647520,MATH 103A,B03,093562,Staff,0,0,36,36
1656207653543,MATH 105,A01,085443,Carter; Anne Toulson,5,1,35,30
1656207653543,MATH 105,A02,093477,Staff,13,0,35,22
1656207659568,MATH 109,A01,083213,Ganzberger; Geoffrey Michael,0,0,34,34
1656207659568,MATH 109,A02,083214,Ganzberger; Geoffrey Michael,0,0,34,34
1656207659568,MATH 109,A03,093478,Staff,1,0,34,33
1656207659568,MATH 109,B01,083215,Ganzberger; Geoffrey Michael,4,0,32,28
1656207659568,MATH 109,B02,083216,Ganzberger; Geoffrey Michael,1,0,32,31
1656207659568,MATH 109,B03,093479,Staff,4,0,32,28
1656207665591,MATH 142A,A01,083219,Chow; Bennett,2,0,32,30
1656207665591,MATH 142A,A02,083220,Chow; Bennett,8,0,32,24
1656207665591,MATH 142A,A03,093480,Staff,5,0,32,27
1656207665591,MATH 142A,B03,093481,Staff,3,0,32,29
1656207665591,MATH 142A,B04,093558,Staff,6,0,32,26
1656207665591,MATH 142A,B05,093559,Staff,1,0,32,31
1656207671617,MATH 193A,A01,083224,Rotar; Vladimir,0,1,34,34
1656207671617,MATH 193A,A02,083225,Rotar; Vladimir,0,0,34,34
1656207671617,MATH 193A,A03,083781,Rotar; Vladimir,0,0,34,34
1656207671617,MATH 193A,A04,083782,Rotar; Vladimir,6,0,34,28
1656207671617,MATH 193A,A05,093482,Rotar; Vladimir,0,0,34,34
1656207677639,MATH 197,001,091859,McAuley; Julian John,9999,0,9999,0
1656207677639,MATH 197,002,095566,Kedlaya; Kiran S.,9997,0,9999,2
1656207677639,MATH 197,003,095567,Xiao; Ming,9999,0,9999,0
1656207677639,MATH 197,004,095571,Perols; Johan Lars,9998,0,9999,1
1656207684704,COGS 9,A01,083615,Shannon; Kyle Michael,3,0,75,72
1656207690730,COGS 11,A01,083617,Boyle; Mary E. T.,14,0,48,34
1656207696754,COGS 13,A01,083071,Bastos; Amalia Pinkusfeld,5,0,71,66
1656207702783,COGS 14A,A01,092681,Semenuks; Arturs,4,16,100,96
1656207708812,COGS 14B,A01,083073,Cheng; Tzu-Han,7,0,63,56
1656207714839,COGS 17,A01,092677,Semenuks; Arturs,7,0,81,74
1656207720863,COGS 100,A01,083619,Allen; Michael Gordon,2,0,70,68
1656207726898,COGS 101A,A01,083621,Davis; Joshua Daniel,4,0,68,64
1656207733012,COGS 101B,A01,091572,Allen; Michael Gordon,4,0,65,61
1656207739038,COGS 101C,A01,083625,Delgado; Tania,10,0,35,25
1656207745066,COGS 107A,A01,083627,Boyle; Mary E. T.,0,0,60,60
1656207751089,COGS 118A,A01,083075,Gupta; Anjum,7,0,76,69
1656207757113,CSE 3,A50,083646,Miranda; Gregory Joseph,18,0,50,32
1656207763138,CSE 8A,A50,083650,Miranda; Gregory Joseph,3,3,56,53
1656207769161,CSE 11,A01,083080,Cao; Yingjun,1,50,40,39
1656207775186,CSE 12,A01,083652,Krause-Levy; Sophia Louisa,7,3,120,113
1656207781210,CSE 15L,A01,083654,Morris; Justin Loren,2,0,50,48
1656207781210,CSE 15L,A02,083655,Morris; Justin Loren,4,0,50,46
1656207787232,CSE 20,A01,083657,Tran; Khoa Dang,30,0,80,50
1656207793255,CSE 21,A01,095574,Bach; Quang Tran,24,0,48,24
1656207799279,CSE 30,A01,083084,Eldon; John,2,8,80,78
1656207799279,CSE 30,B01,095061,Bhaskar; Nishant,1,2,50,49
1656207805300,CSE 100,A01,083659,Cao; Yingjun,2,20,70,68
1656207811324,CSE 134B,A01,083661,Powell; Thomas Allan,2,0,100,98
1656207817345,CSE 140,A01,083663,Gungor; Onat,9,0,85,76
1656207823368,CSE 140L,A01,083088,Eldon; John,8,0,100,92
1656207829390,CSE 175,A01,083665,Kumar; Rakesh,0,0,25,25
1656207835414,CSE 190,A00,092507,Dubnov; Shlomo,3,0,20,17
1656207841436,ECE 45,A01,083139,Congero; Spencer William,1,0,75,74
1656207847461,ECE 65,A50,083695,Saad; Andrew S,9,0,30,21
1656207847461,ECE 65,A51,095125,Staff,23,0,26,3
1656207853484,ECE 109,A01,091882,Touri; Behrouz,0,1,70,70
1656207859507,ECE 180,A00,083140,Abi Samra; Nicholas Camill,1,0,30,29
1656207859507,ECE 180,B00,083141,Abi Samra; Nicholas Camill,0,4,30,30
1656207865533,MATH 10A,A01,083735,Patchell; Gregory David,0,0,30,30
1656207865533,MATH 10A,A02,083736,Patchell; Gregory David,22,0,30,8
1656207865533,MATH 10A,A03,083737,Patchell; Gregory David,16,0,30,14
1656207871561,MATH 10B,A01,083207,Lim; Seonhee,0,0,34,34
1656207871561,MATH 10B,A02,083208,Lim; Seonhee,7,0,35,28
1656207871561,MATH 10B,A03,093472,Staff,1,0,34,33
1656207871561,MATH 10B,B01,083739,Sinha; Shubham,11,0,30,19
1656207877583,MATH 18,A01,083743,Cinel; Cameron Alexander,7,0,30,23
1656207877583,MATH 18,A02,083744,Cinel; Cameron Alexander,10,0,30,20
1656207877583,MATH 18,A03,083745,Cinel; Cameron Alexander,4,0,30,26
1656207877583,MATH 18,B01,083748,Rideout; David Porter,1,0,36,35
1656207877583,MATH 18,B02,083749,Rideout; David Porter,0,0,36,36
1656207877583,MATH 18,B03,083750,Rideout; David Porter,0,0,36,36
1656207877583,MATH 18,B04,083751,Rideout; David Porter,0,0,36,36
1656207877583,MATH 18,B05,093473,Rideout; David Porter,0,0,36,36
1656207877583,MATH 18,B06,093474,Rideout; David Porter,3,0,36,33
1656207883607,MATH 20A,A01,083754,Zheng; Zequn,11,0,40,29
1656207889630,MATH 20B,A01,083756,Briones; Jor-el Thomas Caparas,0,0,36,36
1656207889630,MATH 20B,A02,083757,Briones; Jor-el Thomas Caparas,0,0,36,36
1656207889630,MATH 20B,A03,093475,Staff,1,0,36,35
1656207895653,MATH 20C,A01,083760,Briones; Jor-el Thomas Caparas,0,0,35,35
1656207895653,MATH 20C,A02,083761,Briones; Jor-el Thomas Caparas,9,1,35,26
1656207895653,MATH 20C,A03,093476,Staff,0,0,35,35
1656207895653,MATH 20C,B01,083762,Bach; Quang Tran,1,0,30,29
1656207901676,MATH 20D,A01,083765,Tran; Brian Kha,1,0,30,29
1656207901676,MATH 20D,A02,083766,Tran; Brian Kha,0,1,30,30
1656207901676,MATH 20D,A03,083767,Tran; Brian Kha,2,0,30,28
1656207907703,MATH 20E,A01,083771,Ganguly; Soumya,3,0,32,29
1656207907703,MATH 20E,A02,083772,Ganguly; Soumya,0,0,32,32
1656207907703,MATH 20E,B01,083773,Ciotti; Benjamin,16,0,35,19
1656207907703,MATH 20E,B02,083774,Ciotti; Benjamin,15,0,35,20
1656207913727,MATH 103A,A01,083777,Greenfeld; Be'Eri,1,0,36,35
1656207913727,MATH 103A,A02,083778,Greenfeld; Be'Eri,1,0,36,35
1656207913727,MATH 103A,A03,093561,Staff,5,0,36,31
1656207913727,MATH 103A,B01,083779,Greenfeld; Be'Eri,9,1,36,27
1656207913727,MATH 103A,B02,083780,Greenfeld; Be'Eri,1,0,36,35
1656207913727,MATH 103A,B03,093562,Staff,0,0,36,36
1656207919753,MATH 105,A01,085443,Carter; Anne Toulson,5,1,35,30
1656207919753,MATH 105,A02,093477,Staff,13,0,35,22
1656207925778,MATH 109,A01,083213,Ganzberger; Geoffrey Michael,0,0,34,34
1656207925778,MATH 109,A02,083214,Ganzberger; Geoffrey Michael,0,0,34,34
1656207925778,MATH 109,A03,093478,Staff,1,0,34,33
1656207925778,MATH 109,B01,083215,Ganzberger; Geoffrey Michael,4,0,32,28
1656207925778,MATH 109,B02,083216,Ganzberger; Geoffrey Michael,1,0,32,31
1656207925778,MATH 109,B03,093479,Staff,4,0,32,28
1656207931802,MATH 142A,A01,083219,Chow; Bennett,2,0,32,30
1656207931802,MATH 142A,A02,083220,Chow; Bennett,8,0,32,24
1656207931802,MATH 142A,A03,093480,Staff,5,0,32,27
1656207931802,MATH 142A,B03,093481,Staff,3,0,32,29
1656207931802,MATH 142A,B04,093558,Staff,6,0,32,26
1656207931802,MATH 142A,B05,093559,Staff,1,0,32,31
1656207937827,MATH 193A,A01,083224,Rotar; Vladimir,0,1,34,34
1656207937827,MATH 193A,A02,083225,Rotar; Vladimir,0,0,34,34
1656207937827,MATH 193A,A03,083781,Rotar; Vladimir,0,0,34,34
1656207937827,MATH 193A,A04,083782,Rotar; Vladimir,6,0,34,28
1656207937827,MATH 193A,A05,093482,Rotar; Vladimir,0,0,34,34
1656207943850,MATH 197,001,091859,McAuley; Julian John,9999,0,9999,0
1656207943850,MATH 197,002,095566,Kedlaya; Kiran S.,9997,0,9999,2
1656207943850,MATH 197,003,095567,Xiao; Ming,9999,0,9999,0
1656207943850,MATH 197,004,095571,Perols; Johan Lars,9998,0,9999,1
1656207950910,COGS 9,A01,083615,Shannon; Kyle Michael,3,0,75,72
1656207956933,COGS 11,A01,083617,Boyle; Mary E. T.,14,0,48,34
1656207962958,COGS 13,A01,083071,Bastos; Amalia Pinkusfeld,5,0,71,66
1656207968988,COGS 14A,A01,092681,Semenuks; Arturs,4,16,100,96
1656207975017,COGS 14B,A01,083073,Cheng; Tzu-Han,7,0,63,56
1656207981041,COGS 17,A01,092677,Semenuks; Arturs,7,0,81,74
1656207987067,COGS 100,A01,083619,Allen; Michael Gordon,2,0,70,68
1656207993091,COGS 101A,A01,083621,Davis; Joshua Daniel,4,0,68,64
1656207999121,COGS 101B,A01,091572,Allen; Michael Gordon,4,0,65,61
1656208005142,COGS 101C,A01,083625,Delgado; Tania,10,0,35,25
1656208011169,COGS 107A,A01,083627,Boyle; Mary E. T.,0,0,60,60
1656208017199,COGS 118A,A01,083075,Gupta; Anjum,7,0,76,69
1656208023229,CSE 3,A50,083646,Miranda; Gregory Joseph,18,0,50,32
1656208029254,CSE 8A,A50,083650,Miranda; Gregory Joseph,3,3,56,53
1656208035278,CSE 11,A01,083080,Cao; Yingjun,1,50,40,39
1656208041303,CSE 12,A01,083652,Krause-Levy; Sophia Louisa,7,3,120,113
1656208047326,CSE 15L,A01,083654,Morris; Justin Loren,2,0,50,48
1656208047326,CSE 15L,A02,083655,Morris; Justin Loren,4,0,50,46
1656208053356,CSE 20,A01,083657,Tran; Khoa Dang,30,0,80,50
1656208059381,CSE 21,A01,095574,Bach; Quang Tran,24,0,48,24
1656208065406,CSE 30,A01,083084,Eldon; John,2,8,80,78
1656208065406,CSE 30,B01,095061,Bhaskar; Nishant,1,2,50,49
1656208071440,CSE 100,A01,083659,Cao; Yingjun,2,20,70,68
1656208077476,CSE 134B,A01,083661,Powell; Thomas Allan,2,0,100,98
1656208083499,CSE 140,A01,083663,Gungor; Onat,9,0,85,76
1656208089526,CSE 140L,A01,083088,Eldon; John,8,0,100,92
1656208095550,CSE 175,A01,083665,Kumar; Rakesh,0,0,25,25
1656208101573,CSE 190,A00,092507,Dubnov; Shlomo,3,0,20,17
1656208107596,ECE 45,A01,083139,Congero; Spencer William,1,0,75,74
1656208113624,ECE 65,A50,083695,Saad; Andrew S,9,0,30,21
1656208113624,ECE 65,A51,095125,Staff,23,0,26,3
1656208119647,ECE 109,A01,091882,Touri; Behrouz,0,1,70,70
1656208125674,ECE 180,A00,083140,Abi Samra; Nicholas Camill,1,0,30,29
1656208125674,ECE 180,B00,083141,Abi Samra; Nicholas Camill,0,4,30,30
1656208131701,MATH 10A,A01,083735,Patchell; Gregory David,0,0,30,30
1656208131701,MATH 10A,A02,083736,Patchell; Gregory David,22,0,30,8
1656208131701,MATH 10A,A03,083737,Patchell; Gregory David,16,0,30,14
1656208137724,MATH 10B,A01,083207,Lim; Seonhee,0,0,34,34
1656208137724,MATH 10B,A02,083208,Lim; Seonhee,7,0,35,28
1656208137724,MATH 10B,A03,093472,Staff,1,0,34,33
1656208137724,MATH 10B,B01,083739,Sinha; Shubham,11,0,30,19
1656208143749,MATH 18,A01,083743,Cinel; Cameron Alexander,7,0,30,23
1656208143749,MATH 18,A02,083744,Cinel; Cameron Alexander,10,0,30,20
1656208143749,MATH 18,A03,083745,Cinel; Cameron Alexander,4,0,30,26
1656208143749,MATH 18,B01,083748,Rideout; David Porter,1,0,36,35
1656208143749,MATH 18,B02,083749,Rideout; David Porter,0,0,36,36
1656208143749,MATH 18,B03,083750,Rideout; David Porter,0,0,36,36
1656208143749,MATH 18,B04,083751,Rideout; David Porter,0,0,36,36
1656208143749,MATH 18,B05,093473,Rideout; David Porter,0,0,36,36
1656208143749,MATH 18,B06,093474,Rideout; David Porter,3,0,36,33
1656208149776,MATH 20A,A01,083754,Zheng; Zequn,11,0,40,29
1656208155803,MATH 20B,A01,083756,Briones; Jor-el Thomas Caparas,0,0,36,36
1656208155803,MATH 20B,A02,083757,Briones; Jor-el Thomas Caparas,0,0,36,36
1656208155803,MATH 20B,A03,093475,Staff,1,0,36,35
1656208161827,MATH 20C,A01,083760,Briones; Jor-el Thomas Caparas,0,0,35,35
1656208161827,MATH 20C,A02,083761,Briones; Jor-el Thomas Caparas,9,1,35,26
1656208161827,MATH 20C,A03,093476,Staff,0,0,35,35
1656208161827,MATH 20C,B01,083762,Bach; Quang Tran,1,0,30,29
1656208167851,MATH 20D,A01,083765,Tran; Brian Kha,1,0,30,29
1656208167851,MATH 20D,A02,083766,Tran; Brian Kha,0,1,30,30
1656208167851,MATH 20D,A03,083767,Tran; Brian Kha,2,0,30,28
1656208173874,MATH 20E,A01,083771,Ganguly; Soumya,3,0,32,29
1656208173874,MATH 20E,A02,083772,Ganguly; Soumya,0,0,32,32
1656208173874,MATH 20E,B01,083773,Ciotti; Benjamin,16,0,35,19
1656208173874,MATH 20E,B02,083774,Ciotti; Benjamin,15,0,35,20
1656208179902,MATH 103A,A01,083777,Greenfeld; Be'Eri,1,0,36,35
1656208179902,MATH 103A,A02,083778,Greenfeld; Be'Eri,1,0,36,35
1656208179902,MATH 103A,A03,093561,Staff,5,0,36,31
1656208179902,MATH 103A,B01,083779,Greenfeld; Be'Eri,9,1,36,27
1656208179902,MATH 103A,B02,083780,Greenfeld; Be'Eri,1,0,36,35
1656208179902,MATH 103A,B03,093562,Staff,0,0,36,36
1656208185926,MATH 105,A01,085443,Carter; Anne Toulson,5,1,35,30
1656208185926,MATH 105,A02,093477,Staff,13,0,35,22
1656208191956,MATH 109,A01,083213,Ganzberger; Geoffrey Michael,0,0,34,34
1656208191956,MATH 109,A02,083214,Ganzberger; Geoffrey Michael,0,0,34,34
1656208191956,MATH 109,A03,093478,Staff,1,0,34,33
1656208191956,MATH 109,B01,083215,Ganzberger; Geoffrey Michael,4,0,32,28
1656208191956,MATH 109,B02,083216,Ganzberger; Geoffrey Michael,1,0,32,31
1656208191956,MATH 109,B03,093479,Staff,4,0,32,28
1656208197980,MATH 142A,A01,083219,Chow; Bennett,2,0,32,30
1656208197980,MATH 142A,A02,083220,Chow; Bennett,8,0,32,24
1656208197980,MATH 142A,A03,093480,Staff,5,0,32,27
1656208197980,MATH 142A,B03,093481,Staff,3,0,32,29
1656208197980,MATH 142A,B04,093558,Staff,6,0,32,26
1656208197980,MATH 142A,B05,093559,Staff,1,0,32,31
1656208204012,MATH 193A,A01,083224,Rotar; Vladimir,0,1,34,34
1656208204012,MATH 193A,A02,083225,Rotar; Vladimir,0,0,34,34
1656208204012,MATH 193A,A03,083781,Rotar; Vladimir,0,0,34,34
1656208204012,MATH 193A,A04,083782,Rotar; Vladimir,6,0,34,28
1656208204012,MATH 193A,A05,093482,Rotar; Vladimir,0,0,34,34
1656208210035,MATH 197,001,091859,McAuley; Julian John,9999,0,9999,0
1656208210035,MATH 197,002,095566,Kedlaya; Kiran S.,9997,0,9999,2
1656208210035,MATH 197,003,095567,Xiao; Ming,9999,0,9999,0
1656208210035,MATH 197,004,095571,Perols; Johan Lars,9998,0,9999,1
1656208217090,COGS 9,A01,083615,Shannon; Kyle Michael,3,0,75,72
1656208223128,COGS 11,A01,083617,Boyle; Mary E. T.,14,0,48,34
1656208229151,COGS 13,A01,083071,Bastos; Amalia Pinkusfeld,5,0,71,66
1656208235175,COGS 14A,A01,092681,Semenuks; Arturs,4,16,100,96
1656208241198,COGS 14B,A01,083073,Cheng; Tzu-Han,7,0,63,56
1656208247222,COGS 17,A01,092677,Semenuks; Arturs,7,0,81,74
1656208253244,COGS 100,A01,083619,Allen; Michael Gordon,2,0,70,68
1656208259271,COGS 101A,A01,083621,Davis; Joshua Daniel,4,0,68,64
1656208265305,COGS 101B,A01,091572,Allen; Michael Gordon,4,0,65,61
1656208271333,COGS 101C,A01,083625,Delgado; Tania,10,0,35,25
1656208277357,COGS 107A,A01,083627,Boyle; Mary E. T.,0,0,60,60
1656208283381,COGS 118A,A01,083075,Gupta; Anjum,7,0,76,69
1656208289413,CSE 3,A50,083646,Miranda; Gregory Joseph,18,0,50,32
1656208295436,CSE 8A,A50,083650,Miranda; Gregory Joseph,3,3,56,53
1656208301472,CSE 11,A01,083080,Cao; Yingjun,1,50,40,39
1656208307497,CSE 12,A01,083652,Krause-Levy; Sophia Louisa,7,3,120,113
1656208313524,CSE 15L,A01,083654,Morris; Justin Loren,2,0,50,48
1656208313524,CSE 15L,A02,083655,Morris; Justin Loren,4,0,50,46
1656208319546,CSE 20,A01,083657,Tran; Khoa Dang,30,0,80,50
1656208325569,CSE 21,A01,095574,Bach; Quang Tran,24,0,48,24
1656208331668,CSE 30,A01,083084,Eldon; John,2,8,80,78
1656208331668,CSE 30,B01,095061,Bhaskar; Nishant,1,2,50,49
1656208337691,CSE 100,A01,083659,Cao; Yingjun,2,20,70,68
1656208343714,CSE 134B,A01,083661,Powell; Thomas Allan,2,0,100,98
1656208349741,CSE 140,A01,083663,Gungor; Onat,9,0,85,76
1656208355765,CSE 140L,A01,083088,Eldon; John,8,0,100,92
1656208361790,CSE 175,A01,083665,Kumar; Rakesh,0,0,25,25
1656208367825,CSE 190,A00,092507,Dubnov; Shlomo,3,0,20,17
1656208373863,ECE 45,A01,083139,Congero; Spencer William,1,0,75,74
1656208379890,ECE 65,A50,083695,Saad; Andrew S,9,0,30,21
1656208379890,ECE 65,A51,095125,Staff,23,0,26,3
1656208385912,ECE 109,A01,091882,Touri; Behrouz,0,1,70,70
1656208391939,ECE 180,A00,083140,Abi Samra; Nicholas Camill,1,0,30,29
1656208391939,ECE 180,B00,083141,Abi Samra; Nicholas Camill,0,4,30,30
1656208397964,MATH 10A,A01,083735,Patchell; Gregory David,0,0,30,30
1656208397964,MATH 10A,A02,083736,Patchell; Gregory David,22,0,30,8
1656208397964,MATH 10A,A03,083737,Patchell; Gregory David,16,0,30,14
1656208403988,MATH 10B,A01,083207,Lim; Seonhee,0,0,34,34
1656208403988,MATH 10B,A02,083208,Lim; Seonhee,7,0,35,28
1656208403988,MATH 10B,A03,093472,Staff,1,0,34,33
1656208403988,MATH 10B,B01,083739,Sinha; Shubham,11,0,30,19
1656208410021,MATH 18,A01,083743,Cinel; Cameron Alexander,7,0,30,23
1656208410021,MATH 18,A02,083744,Cinel; Cameron Alexander,10,0,30,20
1656208410021,MATH 18,A03,083745,Cinel; Cameron Alexander,4,0,30,26
1656208410021,MATH 18,B01,083748,Rideout; David Porter,1,0,36,35
1656208410021,MATH 18,B02,083749,Rideout; David Porter,0,0,36,36
1656208410021,MATH 18,B03,083750,Rideout; David Porter,0,0,36,36
1656208410021,MATH 18,B04,083751,Rideout; David Porter,0,0,36,36
1656208410021,MATH 18,B05,093473,Rideout; David Porter,0,0,36,36
1656208410021,MATH 18,B06,093474,Rideout; David Porter,3,0,36,33
1656208416043,MATH 20A,A01,083754,Zheng; Zequn,11,0,40,29
1656208422067,MATH 20B,A01,083756,Briones; Jor-el Thomas Caparas,0,0,36,36
1656208422067,MATH 20B,A02,083757,Briones; Jor-el Thomas Caparas,0,0,36,36
1656208422067,MATH 20B,A03,093475,Staff,1,0,36,35
1656208428090,MATH 20C,A01,083760,Briones; Jor-el Thomas Caparas,0,0,35,35
1656208428090,MATH 20C,A02,083761,Briones; Jor-el Thomas Caparas,9,1,35,26
1656208428090,MATH 20C,A03,093476,Staff,0,0,35,35
1656208428090,MATH 20C,B01,083762,Bach; Quang Tran,1,0,30,29
1656208434114,MATH 20D,A01,083765,Tran; Brian Kha,1,0,30,29
1656208434114,MATH 20D,A02,083766,Tran; Brian Kha,0,1,30,30
1656208434114,MATH 20D,A03,083767,Tran; Brian Kha,2,0,30,28
1656208440141,MATH 20E,A01,083771,Ganguly; Soumya,3,0,32,29
1656208440141,MATH 20E,A02,083772,Ganguly; Soumya,0,0,32,32
1656208440141,MATH 20E,B01,083773,Ciotti; Benjamin,16,0,35,19
1656208440141,MATH 20E,B02,083774,Ciotti; Benjamin,15,0,35,20
1656208446169,MATH 103A,A01,083777,Greenfeld; Be'Eri,1,0,36,35
1656208446169,MATH 103A,A02,083778,Greenfeld; Be'Eri,1,0,36,35
1656208446169,MATH 103A,A03,093561,Staff,5,0,36,31
1656208446169,MATH 103A,B01,083779,Greenfeld; Be'Eri,9,1,36,27
1656208446169,MATH 103A,B02,083780,Greenfeld; Be'Eri,1,0,36,35
1656208446169,MATH 103A,B03,093562,Staff,0,0,36,36
1656208452192,MATH 105,A01,085443,Carter; Anne Toulson,5,1,35,30
1656208452192,MATH 105,A02,093477,Staff,13,0,35,22
1656208458215,MATH 109,A01,083213,Ganzberger; Geoffrey Michael,0,0,34,34
1656208458215,MATH 109,A02,083214,Ganzberger; Geoffrey Michael,0,0,34,34
1656208458215,MATH 109,A03,093478,Staff,1,0,34,33
1656208458215,MATH 109,B01,083215,Ganzberger; Geoffrey Michael,4,0,32,28
1656208458215,MATH 109,B02,083216,Ganzberger; Geoffrey Michael,1,0,32,31
1656208458215,MATH 109,B03,093479,Staff,4,0,32,28
1656208464245,MATH 142A,A01,083219,Chow; Bennett,2,0,32,30
1656208464245,MATH 142A,A02,083220,Chow; Bennett,8,0,32,24
1656208464245,MATH 142A,A03,093480,Staff,5,0,32,27
1656208464245,MATH 142A,B03,093481,Staff,3,0,32,29
1656208464245,MATH 142A,B04,093558,Staff,6,0,32,26
1656208464245,MATH 142A,B05,093559,Staff,1,0,32,31
1656208470267,MATH 193A,A01,083224,Rotar; Vladimir,0,1,34,34
1656208470267,MATH 193A,A02,083225,Rotar; Vladimir,0,0,34,34
1656208470267,MATH 193A,A03,083781,Rotar; Vladimir,0,0,34,34
1656208470267,MATH 193A,A04,083782,Rotar; Vladimir,6,0,34,28
1656208470267,MATH 193A,A05,093482,Rotar; Vladimir,0,0,34,34
1656208476295,MATH 197,001,091859,McAuley; Julian John,9999,0,9999,0
1656208476295,MATH 197,002,095566,Kedlaya; Kiran S.,9997,0,9999,2
1656208476295,MATH 197,003,095567,Xiao; Ming,9999,0,9999,0
1656208476295,MATH 197,004,095571,Perols; Johan Lars,9998,0,9999,1
1656208483352,COGS 9,A01,083615,Shannon; Kyle Michael,3,0,75,72
1656208489374,COGS 11,A01,083617,Boyle; Mary E. T.,14,0,48,34
1656208495399,COGS 13,A01,083071,Bastos; Amalia Pinkusfeld,5,0,71,66
1656208501436,COGS 14A,A01,092681,Semenuks; Arturs,4,16,100,96
1656208507463,COGS 14B,A01,083073,Cheng; Tzu-Han,7,0,63,56
1656208513489,COGS 17,A01,092677,Semenuks; Arturs,7,0,81,74
1656208519510,COGS 100,A01,083619,Allen; Michael Gordon,2,0,70,68
1656208525533,COGS 101A,A01,083621,Davis; Joshua Daniel,4,0,68,64
1656208531560,COGS 101B,A01,091572,Allen; Michael Gordon,4,0,65,61
1656208537584,COGS 101C,A01,083625,Delgado; Tania,10,0,35,25
1656208543607,COGS 107A,A01,083627,Boyle; Mary E. T.,0,0,60,60
1656208549629,COGS 118A,A01,083075,Gupta; Anjum,7,0,76,69
1656208555653,CSE 3,A50,083646,Miranda; Gregory Joseph,18,0,50,32
1656208561681,CSE 8A,A50,083650,Miranda; Gregory Joseph,3,3,56,53
1656208567703,CSE 11,A01,083080,Cao; Yingjun,1,50,40,39
1656208573738,CSE 12,A01,083652,Krause-Levy; Sophia Louisa,7,3,120,113
1656208579761,CSE 15L,A01,083654,Morris; Justin Loren,2,0,50,48
1656208579761,CSE 15L,A02,083655,Morris; Justin Loren,4,0,50,46
1656208585788,CSE 20,A01,083657,Tran; Khoa Dang,30,0,80,50
1656208591812,CSE 21,A01,095574,Bach; Quang Tran,24,0,48,24
1656208597836,CSE 30,A01,083084,Eldon; John,2,8,80,78
1656208597836,CSE 30,B01,095061,Bhaskar; Nishant,1,2,50,49
1656208603861,CSE 100,A01,083659,Cao; Yingjun,2,20,70,68
1656208609885,CSE 134B,A01,083661,Powell; Thomas Allan,2,0,100,98
1656208615909,CSE 140,A01,083663,Gungor; Onat,9,0,85,76
1656208621932,CSE 140L,A01,083088,Eldon; John,8,0,100,92
1656208627955,CSE 175,A01,083665,Kumar; Rakesh,0,0,25,25
1656208633978,CSE 190,A00,092507,Dubnov; Shlomo,3,0,20,17
1656208640009,ECE 45,A01,083139,Congero; Spencer William,1,0,75,74
1656208646036,ECE 65,A50,083695,Saad; Andrew S,9,0,30,21
1656208646036,ECE 65,A51,095125,Staff,23,0,26,3
1656208652060,ECE 109,A01,091882,Touri; Behrouz,0,1,70,70
1656208658091,ECE 180,A00,083140,Abi Samra; Nicholas Camill,1,0,30,29
1656208658091,ECE 180,B00,083141,Abi Samra; Nicholas Camill,0,4,30,30
1656208664115,MATH 10A,A01,083735,Patchell; Gregory David,0,0,30,30
1656208664115,MATH 10A,A02,083736,Patchell; Gregory David,22,0,30,8
1656208664115,MATH 10A,A03,083737,Patchell; Gregory David,16,0,30,14
1656208670145,MATH 10B,A01,083207,Lim; Seonhee,0,0,34,34
1656208670145,MATH 10B,A02,083208,Lim; Seonhee,7,0,35,28
1656208670145,MATH 10B,A03,093472,Staff,1,0,34,33
1656208670145,MATH 10B,B01,083739,Sinha; Shubham,11,0,30,19
1656208676170,MATH 18,A01,083743,Cinel; Cameron Alexander,7,0,30,23
1656208676170,MATH 18,A02,083744,Cinel; Cameron Alexander,10,0,30,20
1656208676170,MATH 18,A03,083745,Cinel; Cameron Alexander,4,0,30,26
1656208676170,MATH 18,B01,083748,Rideout; David Porter,1,0,36,35
1656208676170,MATH 18,B02,083749,Rideout; David Porter,0,0,36,36
1656208676170,MATH 18,B03,083750,Rideout; David Porter,0,0,36,36
1656208676170,MATH 18,B04,083751,Rideout; David Porter,0,0,36,36
1656208676170,MATH 18,B05,093473,Rideout; David Porter,0,0,36,36
1656208676170,MATH 18,B06,093474,Rideout; David Porter,3,0,36,33
1656208682193,MATH 20A,A01,083754,Zheng; Zequn,11,0,40,29
1656208688236,MATH 20B,A01,083756,Briones; Jor-el Thomas Caparas,0,0,36,36
1656208688236,MATH 20B,A02,083757,Briones; Jor-el Thomas Caparas,0,0,36,36
1656208688236,MATH 20B,A03,093475,Staff,1,0,36,35
1656208694265,MATH 20C,A01,083760,Briones; Jor-el Thomas Caparas,0,0,35,35
1656208694265,MATH 20C,A02,083761,Briones; Jor-el Thomas Caparas,9,1,35,26
1656208694265,MATH 20C,A03,093476,Staff,0,0,35,35
1656208694265,MATH 20C,B01,083762,Bach; Quang Tran,1,0,30,29
1656208700289,MATH 20D,A01,083765,Tran; Brian Kha,1,0,30,29
1656208700289,MATH 20D,A02,083766,Tran; Brian Kha,0,1,30,30
1656208700289,MATH 20D,A03,083767,Tran; Brian Kha,2,0,30,28
1656208706319,MATH 20E,A01,083771,Ganguly; Soumya,3,0,32,29
1656208706319,MATH 20E,A02,083772,Ganguly; Soumya,0,0,32,32
1656208706319,MATH 20E,B01,083773,Ciotti; Benjamin,16,0,35,19
1656208706319,MATH 20E,B02,083774,Ciotti; Benjamin,15,0,35,20
1656208712344,MATH 103A,A01,083777,Greenfeld; Be'Eri,1,0,36,35
1656208712344,MATH 103A,A02,083778,Greenfeld; Be'Eri,1,0,36,35
1656208712344,MATH 103A,A03,093561,Staff,5,0,36,31
1656208712344,MATH 103A,B01,083779,Greenfeld; Be'Eri,9,1,36,27
1656208712344,MATH 103A,B02,083780,Greenfeld; Be'Eri,1,0,36,35
1656208712344,MATH 103A,B03,093562,Staff,0,0,36,36
1656208718366,MATH 105,A01,085443,Carter; Anne Toulson,5,1,35,30
1656208718366,MATH 105,A02,093477,Staff,13,0,35,22
1656208724391,MATH 109,A01,083213,Ganzberger; Geoffrey Michael,0,0,34,34
1656208724391,MATH 109,A02,083214,Ganzberger; Geoffrey Michael,0,0,34,34
1656208724391,MATH 109,A03,093478,Staff,1,0,34,33
1656208724391,MATH 109,B01,083215,Ganzberger; Geoffrey Michael,4,0,32,28
1656208724391,MATH 109,B02,083216,Ganzberger; Geoffrey Michael,1,0,32,31
1656208724391,MATH 109,B03,093479,Staff,4,0,32,28
1656208730415,MATH 142A,A01,083219,Chow; Bennett,2,0,32,30
1656208730415,MATH 142A,A02,083220,Chow; Bennett,8,0,32,24
1656208730415,MATH 142A,A03,093480,Staff,5,0,32,27
1656208730415,MATH 142A,B03,093481,Staff,3,0,32,29
1656208730415,MATH 142A,B04,093558,Staff,6,0,32,26
1656208730415,MATH 142A,B05,093559,Staff,1,0,32,31
1656208736440,MATH 193A,A01,083224,Rotar; Vladimir,0,1,34,34
1656208736440,MATH 193A,A02,083225,Rotar; Vladimir,0,0,34,34
1656208736440,MATH 193A,A03,083781,Rotar; Vladimir,0,0,34,34
1656208736440,MATH 193A,A04,083782,Rotar; Vladimir,6,0,34,28
1656208736440,MATH 193A,A05,093482,Rotar; Vladimir,0,0,34,34
1656208742469,MATH 197,001,091859,McAuley; Julian John,9999,0,9999,0
1656208742469,MATH 197,002,095566,Kedlaya; Kiran S.,9997,0,9999,2
1656208742469,MATH 197,003,095567,Xiao; Ming,9999,0,9999,0
1656208742469,MATH 197,004,095571,Perols; Johan Lars,9998,0,9999,1
1656208749537,COGS 9,A01,083615,Shannon; Kyle Michael,3,0,75,72
1656208755561,COGS 11,A01,083617,Boyle; Mary E. T.,14,0,48,34
1656208761589,COGS 13,A01,083071,Bastos; Amalia Pinkusfeld,5,0,71,66
1656208767616,COGS 14A,A01,092681,Semenuks; Arturs,4,16,100,96
1656208773638,COGS 14B,A01,083073,Cheng; Tzu-Han,7,0,63,56
1656208779665,COGS 17,A01,092677,Semenuks; Arturs,7,0,81,74
1656208785692,COGS 100,A01,083619,Allen; Michael Gordon,2,0,70,68
1656208791719,COGS 101A,A01,083621,Davis; Joshua Daniel,4,0,68,64
1656208797743,COGS 101B,A01,091572,Allen; Michael Gordon,4,0,65,61
1656208803772,COGS 101C,A01,083625,Delgado; Tania,10,0,35,25
1656208809800,COGS 107A,A01,083627,Boyle; Mary E. T.,0,0,60,60
1656208815832,COGS 118A,A01,083075,Gupta; Anjum,7,0,76,69
1656208821854,CSE 3,A50,083646,Miranda; Gregory Joseph,18,0,50,32
1656208827877,CSE 8A,A50,083650,Miranda; Gregory Joseph,3,3,56,53
1656208833902,CSE 11,A01,083080,Cao; Yingjun,1,50,40,39
1656208839925,CSE 12,A01,083652,Krause-Levy; Sophia Louisa,7,3,120,113
1656208845950,CSE 15L,A01,083654,Morris; Justin Loren,2,0,50,48
1656208845950,CSE 15L,A02,083655,Morris; Justin Loren,4,0,50,46
1656208851972,CSE 20,A01,083657,Tran; Khoa Dang,30,0,80,50
1656208858003,CSE 21,A01,095574,Bach; Quang Tran,24,0,48,24
1656208864027,CSE 30,A01,083084,Eldon; John,2,8,80,78
1656208864027,CSE 30,B01,095061,Bhaskar; Nishant,1,2,50,49
1656208870050,CSE 100,A01,083659,Cao; Yingjun,2,20,70,68
1656208876073,CSE 134B,A01,083661,Powell; Thomas Allan,2,0,100,98
1656208882097,CSE 140,A01,083663,Gungor; Onat,9,0,85,76
1656208888120,CSE 140L,A01,083088,Eldon; John,8,0,100,92
1656208894144,CSE 175,A01,083665,Kumar; Rakesh,0,0,25,25
1656208900172,CSE 190,A00,092507,Dubnov; Shlomo,3,0,20,17
1656208906198,ECE 45,A01,083139,Congero; Spencer William,1,0,75,74
1656208912222,ECE 65,A50,083695,Saad; Andrew S,9,0,30,21
1656208912222,ECE 65,A51,095125,Staff,23,0,26,3
1656208918249,ECE 109,A01,091882,Touri; Behrouz,0,1,70,70
1656208924273,ECE 180,A00,083140,Abi Samra; Nicholas Camill,1,0,30,29
1656208924273,ECE 180,B00,083141,Abi Samra; Nicholas Camill,0,4,30,30
1656208930368,MATH 10A,A01,083735,Patchell; Gregory David,0,0,30,30
1656208930368,MATH 10A,A02,083736,Patchell; Gregory David,22,0,30,8
1656208930368,MATH 10A,A03,083737,Patchell; Gregory David,16,0,30,14
1656208936399,MATH 10B,A01,083207,Lim; Seonhee,0,0,34,34
1656208936399,MATH 10B,A02,083208,Lim; Seonhee,7,0,35,28
1656208936399,MATH 10B,A03,093472,Staff,1,0,34,33
1656208936399,MATH 10B,B01,083739,Sinha; Shubham,11,0,30,19
1656208942424,MATH 18,A01,083743,Cinel; Cameron Alexander,7,0,30,23
1656208942424,MATH 18,A02,083744,Cinel; Cameron Alexander,10,0,30,20
1656208942424,MATH 18,A03,083745,Cinel; Cameron Alexander,4,0,30,26
1656208942424,MATH 18,B01,083748,Rideout; David Porter,1,0,36,35
1656208942424,MATH 18,B02,083749,Rideout; David Porter,0,0,36,36
1656208942424,MATH 18,B03,083750,Rideout; David Porter,0,0,36,36
1656208942424,MATH 18,B04,083751,Rideout; David Porter,0,0,36,36
1656208942424,MATH 18,B05,093473,Rideout; David Porter,0,0,36,36
1656208942424,MATH 18,B06,093474,Rideout; David Porter,3,0,36,33
1656208948451,MATH 20A,A01,083754,Zheng; Zequn,11,0,40,29
1656208954476,MATH 20B,A01,083756,Briones; Jor-el Thomas Caparas,0,0,36,36
1656208954476,MATH 20B,A02,083757,Briones; Jor-el Thomas Caparas,0,0,36,36
1656208954476,MATH 20B,A03,093475,Staff,1,0,36,35
1656208960504,MATH 20C,A01,083760,Briones; Jor-el Thomas Caparas,0,0,35,35
1656208960504,MATH 20C,A02,083761,Briones; Jor-el Thomas Caparas,9,1,35,26
1656208960504,MATH 20C,A03,093476,Staff,0,0,35,35
1656208960504,MATH 20C,B01,083762,Bach; Quang Tran,1,0,30,29
1656208966526,MATH 20D,A01,083765,Tran; Brian Kha,1,0,30,29
1656208966526,MATH 20D,A02,083766,Tran; Brian Kha,0,1,30,30
1656208966526,MATH 20D,A03,083767,Tran; Brian Kha,2,0,30,28
1656208972550,MATH 20E,A01,083771,Ganguly; Soumya,3,0,32,29
1656208972550,MATH 20E,A02,083772,Ganguly; Soumya,0,0,32,32
1656208972550,MATH 20E,B01,083773,Ciotti; Benjamin,16,0,35,19
1656208972550,MATH 20E,B02,083774,Ciotti; Benjamin,15,0,35,20
1656208978573,MATH 103A,A01,083777,Greenfeld; Be'Eri,1,0,36,35
1656208978573,MATH 103A,A02,083778,Greenfeld; Be'Eri,1,0,36,35
1656208978573,MATH 103A,A03,093561,Staff,5,0,36,31
1656208978573,MATH 103A,B01,083779,Greenfeld; Be'Eri,9,1,36,27
1656208978573,MATH 103A,B02,083780,Greenfeld; Be'Eri,1,0,36,35
1656208978573,MATH 103A,B03,093562,Staff,0,0,36,36
1656208984599,MATH 105,A01,085443,Carter; Anne Toulson,5,1,35,30
1656208984599,MATH 105,A02,093477,Staff,13,0,35,22
1656208990623,MATH 109,A01,083213,Ganzberger; Geoffrey Michael,0,0,34,34
1656208990623,MATH 109,A02,083214,Ganzberger; Geoffrey Michael,0,0,34,34
1656208990623,MATH 109,A03,093478,Staff,1,0,34,33
1656208990623,MATH 109,B01,083215,Ganzberger; Geoffrey Michael,4,0,32,28
1656208990623,MATH 109,B02,083216,Ganzberger; Geoffrey Michael,1,0,32,31
1656208990623,MATH 109,B03,093479,Staff,4,0,32,28
1656208996652,MATH 142A,A01,083219,Chow; Bennett,2,0,32,30
1656208996652,MATH 142A,A02,083220,Chow; Bennett,8,0,32,24
1656208996652,MATH 142A,A03,093480,Staff,5,0,32,27
1656208996652,MATH 142A,B03,093481,Staff,3,0,32,29
1656208996652,MATH 142A,B04,093558,Staff,6,0,32,26
1656208996652,MATH 142A,B05,093559,Staff,1,0,32,31
1656209002675,MATH 193A,A01,083224,Rotar; Vladimir,0,1,34,34
1656209002675,MATH 193A,A02,083225,Rotar; Vladimir,0,0,34,34
1656209002675,MATH 193A,A03,083781,Rotar; Vladimir,0,0,34,34
1656209002675,MATH 193A,A04,083782,Rotar; Vladimir,6,0,34,28
1656209002675,MATH 193A,A05,093482,Rotar; Vladimir,0,0,34,34
1656209008711,MATH 197,001,091859,McAuley; Julian John,9999,0,9999,0
1656209008711,MATH 197,002,095566,Kedlaya; Kiran S.,9997,0,9999,2
1656209008711,MATH 197,003,095567,Xiao; Ming,9999,0,9999,0
1656209008711,MATH 197,004,095571,Perols; Johan Lars,9998,0,9999,1
1656209015769,COGS 9,A01,083615,Shannon; Kyle Michael,3,0,75,72
1656209021793,COGS 11,A01,083617,Boyle; Mary E. T.,14,0,48,34
1656209027816,COGS 13,A01,083071,Bastos; Amalia Pinkusfeld,5,0,71,66
1656209033837,COGS 14A,A01,092681,Semenuks; Arturs,4,16,100,96
1656209039861,COGS 14B,A01,083073,Cheng; Tzu-Han,7,0,63,56
1656209045885,COGS 17,A01,092677,Semenuks; Arturs,7,0,81,74
1656209051913,COGS 100,A01,083619,Allen; Michael Gordon,2,0,70,68
1656209057936,COGS 101A,A01,083621,Davis; Joshua Daniel,4,0,68,64
1656209063962,COGS 101B,A01,091572,Allen; Michael Gordon,4,0,65,61
1656209069986,COGS 101C,A01,083625,Delgado; Tania,10,0,35,25
1656209076013,COGS 107A,A01,083627,Boyle; Mary E. T.,0,0,60,60
1656209082036,COGS 118A,A01,083075,Gupta; Anjum,7,0,76,69
1656209088059,CSE 3,A50,083646,Miranda; Gregory Joseph,18,0,50,32
1656209094085,CSE 8A,A50,083650,Miranda; Gregory Joseph,3,3,56,53
1656209100112,CSE 11,A01,083080,Cao; Yingjun,1,50,40,39
1656209106139,CSE 12,A01,083652,Krause-Levy; Sophia Louisa,7,3,120,113
1656209112166,CSE 15L,A01,083654,Morris; Justin Loren,2,0,50,48
1656209112166,CSE 15L,A02,083655,Morris; Justin Loren,4,0,50,46
1656209118194,CSE 20,A01,083657,Tran; Khoa Dang,30,0,80,50
1656209124227,CSE 21,A01,095574,Bach; Quang Tran,24,0,48,24
1656209130250,CSE 30,A01,083084,Eldon; John,2,8,80,78
1656209130250,CSE 30,B01,095061,Bhaskar; Nishant,1,2,50,49
1656209136272,CSE 100,A01,083659,Cao; Yingjun,2,20,70,68
1656209142304,CSE 134B,A01,083661,Powell; Thomas Allan,2,0,100,98
1656209148330,CSE 140,A01,083663,Gungor; Onat,9,0,85,76
1656209154353,CSE 140L,A01,083088,Eldon; John,8,0,100,92
1656209160379,CSE 175,A01,083665,Kumar; Rakesh,0,0,25,25
1656209166407,CSE 190,A00,092507,Dubnov; Shlomo,3,0,20,17
1656209172433,ECE 45,A01,083139,Congero; Spencer William,1,0,75,74
1656209178460,ECE 65,A50,083695,Saad; Andrew S,9,0,30,21
1656209178460,ECE 65,A51,095125,Staff,23,0,26,3
1656209184485,ECE 109,A01,091882,Touri; Behrouz,0,1,70,70
1656209190509,ECE 180,A00,083140,Abi Samra; Nicholas Camill,1,0,30,29
1656209190509,ECE 180,B00,083141,Abi Samra; Nicholas Camill,0,4,30,30
1656209196533,MATH 10A,A01,083735,Patchell; Gregory David,0,0,30,30
1656209196533,MATH 10A,A02,083736,Patchell; Gregory David,22,0,30,8
1656209196533,MATH 10A,A03,083737,Patchell; Gregory David,16,0,30,14
1656209202556,MATH 10B,A01,083207,Lim; Seonhee,0,0,34,34
1656209202556,MATH 10B,A02,083208,Lim; Seonhee,7,0,35,28
1656209202556,MATH 10B,A03,093472,Staff,1,0,34,33
1656209202556,MATH 10B,B01,083739,Sinha; Shubham,11,0,30,19
1656209208588,MATH 18,A01,083743,Cinel; Cameron Alexander,7,0,30,23
1656209208588,MATH 18,A02,083744,Cinel; Cameron Alexander,10,0,30,20
1656209208588,MATH 18,A03,083745,Cinel; Cameron Alexander,4,0,30,26
1656209208588,MATH 18,B01,083748,Rideout; David Porter,1,0,36,35
1656209208588,MATH 18,B02,083749,Rideout; David Porter,0,0,36,36
1656209208588,MATH 18,B03,083750,Rideout; David Porter,0,0,36,36
1656209208588,MATH 18,B04,083751,Rideout; David Porter,0,0,36,36
1656209208588,MATH 18,B05,093473,Rideout; David Porter,0,0,36,36
1656209208588,MATH 18,B06,093474,Rideout; David Porter,3,0,36,33
1656209214614,MATH 20A,A01,083754,Zheng; Zequn,11,0,40,29
1656209220641,MATH 20B,A01,083756,Briones; Jor-el Thomas Caparas,0,0,36,36
1656209220641,MATH 20B,A02,083757,Briones; Jor-el Thomas Caparas,0,0,36,36
1656209220641,MATH 20B,A03,093475,Staff,1,0,36,35
1656209226665,MATH 20C,A01,083760,Briones; Jor-el Thomas Caparas,0,0,35,35
1656209226665,MATH 20C,A02,083761,Briones; Jor-el Thomas Caparas,9,1,35,26
1656209226665,MATH 20C,A03,093476,Staff,0,0,35,35
1656209226665,MATH 20C,B01,083762,Bach; Quang Tran,1,0,30,29
1656209232697,MATH 20D,A01,083765,Tran; Brian Kha,1,0,30,29
1656209232697,MATH 20D,A02,083766,Tran; Brian Kha,0,1,30,30
1656209232697,MATH 20D,A03,083767,Tran; Brian Kha,2,0,30,28
1656209238720,MATH 20E,A01,083771,Ganguly; Soumya,3,0,32,29
1656209238720,MATH 20E,A02,083772,Ganguly; Soumya,0,0,32,32
1656209238720,MATH 20E,B01,083773,Ciotti; Benjamin,16,0,35,19
1656209238720,MATH 20E,B02,083774,Ciotti; Benjamin,15,0,35,20
1656209244744,MATH 103A,A01,083777,Greenfeld; Be'Eri,1,0,36,35
1656209244744,MATH 103A,A02,083778,Greenfeld; Be'Eri,1,0,36,35
1656209244744,MATH 103A,A03,093561,Staff,5,0,36,31
1656209244744,MATH 103A,B01,083779,Greenfeld; Be'Eri,9,1,36,27
1656209244744,MATH 103A,B02,083780,Greenfeld; Be'Eri,1,0,36,35
1656209244744,MATH 103A,B03,093562,Staff,0,0,36,36
1656209250767,MATH 105,A01,085443,Carter; Anne Toulson,5,1,35,30
1656209250767,MATH 105,A02,093477,Staff,13,0,35,22
1656209256798,MATH 109,A01,083213,Ganzberger; Geoffrey Michael,0,0,34,34
1656209256798,MATH 109,A02,083214,Ganzberger; Geoffrey Michael,0,0,34,34
1656209256798,MATH 109,A03,093478,Staff,1,0,34,33
1656209256798,MATH 109,B01,083215,Ganzberger; Geoffrey Michael,4,0,32,28
1656209256798,MATH 109,B02,083216,Ganzberger; Geoffrey Michael,1,0,32,31
1656209256798,MATH 109,B03,093479,Staff,4,0,32,28
1656209262828,MATH 142A,A01,083219,Chow; Bennett,2,0,32,30
1656209262828,MATH 142A,A02,083220,Chow; Bennett,8,0,32,24
1656209262828,MATH 142A,A03,093480,Staff,5,0,32,27
1656209262828,MATH 142A,B03,093481,Staff,3,0,32,29
1656209262828,MATH 142A,B04,093558,Staff,6,0,32,26
1656209262828,MATH 142A,B05,093559,Staff,1,0,32,31
1656209268855,MATH 193A,A01,083224,Rotar; Vladimir,0,1,34,34
1656209268855,MATH 193A,A02,083225,Rotar; Vladimir,0,0,34,34
1656209268855,MATH 193A,A03,083781,Rotar; Vladimir,0,0,34,34
1656209268855,MATH 193A,A04,083782,Rotar; Vladimir,6,0,34,28
1656209268855,MATH 193A,A05,093482,Rotar; Vladimir,0,0,34,34
1656209274879,MATH 197,001,091859,McAuley; Julian John,9999,0,9999,0
1656209274879,MATH 197,002,095566,Kedlaya; Kiran S.,9997,0,9999,2
1656209274879,MATH 197,003,095567,Xiao; Ming,9999,0,9999,0
1656209274879,MATH 197,004,095571,Perols; Johan Lars,9998,0,9999,1
1656209281941,COGS 9,A01,083615,Shannon; Kyle Michael,3,0,75,72
1656209287964,COGS 11,A01,083617,Boyle; Mary E. T.,14,0,48,34
1656209293986,COGS 13,A01,083071,Bastos; Amalia Pinkusfeld,5,0,71,66
1656209300013,COGS 14A,A01,092681,Semenuks; Arturs,4,16,100,96
1656209306040,COGS 14B,A01,083073,Cheng; Tzu-Han,7,0,63,56
1656209312065,COGS 17,A01,092677,Semenuks; Arturs,7,0,81,74
1656209318090,COGS 100,A01,083619,Allen; Michael Gordon,2,0,70,68
1656209324114,COGS 101A,A01,083621,Davis; Joshua Daniel,4,0,68,64
1656209330141,COGS 101B,A01,091572,Allen; Michael Gordon,4,0,65,61
1656209336165,COGS 101C,A01,083625,Delgado; Tania,10,0,35,25
1656209342189,COGS 107A,A01,083627,Boyle; Mary E. T.,0,0,60,60
1656209348212,COGS 118A,A01,083075,Gupta; Anjum,7,0,76,69
1656209354235,CSE 3,A50,083646,Miranda; Gregory Joseph,18,0,50,32
1656209360259,CSE 8A,A50,083650,Miranda; Gregory Joseph,3,3,56,53
1656209366289,CSE 11,A01,083080,Cao; Yingjun,1,50,40,39
1656209372312,CSE 12,A01,083652,Krause-Levy; Sophia Louisa,7,3,120,113
1656209378338,CSE 15L,A01,083654,Morris; Justin Loren,2,0,50,48
1656209378338,CSE 15L,A02,083655,Morris; Justin Loren,4,0,50,46
1656209384370,CSE 20,A01,083657,Tran; Khoa Dang,30,0,80,50
1656209390392,CSE 21,A01,095574,Bach; Quang Tran,24,0,48,24
1656209396415,CSE 30,A01,083084,Eldon; John,2,8,80,78
1656209396415,CSE 30,B01,095061,Bhaskar; Nishant,1,2,50,49
1656209402441,CSE 100,A01,083659,Cao; Yingjun,2,20,70,68
1656209408463,CSE 134B,A01,083661,Powell; Thomas Allan,2,0,100,98
1656209414490,CSE 140,A01,083663,Gungor; Onat,9,0,85,76
1656209420515,CSE 140L,A01,083088,Eldon; John,8,0,100,92
1656209426541,CSE 175,A01,083665,Kumar; Rakesh,0,0,25,25
1656209432566,CSE 190,A00,092507,Dubnov; Shlomo,3,0,20,17
1656209438591,ECE 45,A01,083139,Congero; Spencer William,1,0,75,74
1656209444614,ECE 65,A50,083695,Saad; Andrew S,9,0,30,21
1656209444614,ECE 65,A51,095125,Staff,23,0,26,3
1656209450637,ECE 109,A01,091882,Touri; Behrouz,0,1,70,70
1656209456664,ECE 180,A00,083140,Abi Samra; Nicholas Camill,1,0,30,29
1656209456664,ECE 180,B00,083141,Abi Samra; Nicholas Camill,0,4,30,30
1656209462687,MATH 10A,A01,083735,Patchell; Gregory David,0,0,30,30
1656209462687,MATH 10A,A02,083736,Patchell; Gregory David,22,0,30,8
1656209462687,MATH 10A,A03,083737,Patchell; Gregory David,16,0,30,14
1656209468717,MATH 10B,A01,083207,Lim; Seonhee,0,0,34,34
1656209468717,MATH 10B,A02,083208,Lim; Seonhee,7,0,35,28
1656209468717,MATH 10B,A03,093472,Staff,1,0,34,33
1656209468717,MATH 10B,B01,083739,Sinha; Shubham,11,0,30,19
1656209474870,MATH 18,A01,083743,Cinel; Cameron Alexander,7,0,30,23
1656209474870,MATH 18,A02,083744,Cinel; Cameron Alexander,10,0,30,20
1656209474870,MATH 18,A03,083745,Cinel; Cameron Alexander,4,0,30,26
1656209474870,MATH 18,B01,083748,Rideout; David Porter,1,0,36,35
1656209474870,MATH 18,B02,083749,Rideout; David Porter,0,0,36,36
1656209474870,MATH 18,B03,083750,Rideout; David Porter,0,0,36,36
1656209474870,MATH 18,B04,083751,Rideout; David Porter,0,0,36,36
1656209474870,MATH 18,B05,093473,Rideout; David Porter,0,0,36,36
1656209474870,MATH 18,B06,093474,Rideout; David Porter,3,0,36,33
1656209480898,MATH 20A,A01,083754,Zheng; Zequn,11,0,40,29
1656209486925,MATH 20B,A01,083756,Briones; Jor-el Thomas Caparas,0,0,36,36
1656209486925,MATH 20B,A02,083757,Briones; Jor-el Thomas Caparas,0,0,36,36
1656209486925,MATH 20B,A03,093475,Staff,1,0,36,35
1656209492949,MATH 20C,A01,083760,Briones; Jor-el Thomas Caparas,0,0,35,35
1656209492949,MATH 20C,A02,083761,Briones; Jor-el Thomas Caparas,9,1,35,26
1656209492949,MATH 20C,A03,093476,Staff,0,0,35,35
1656209492949,MATH 20C,B01,083762,Bach; Quang Tran,1,0,30,29
1656209498974,MATH 20D,A01,083765,Tran; Brian Kha,1,0,30,29
1656209498974,MATH 20D,A02,083766,Tran; Brian Kha,0,1,30,30
1656209498974,MATH 20D,A03,083767,Tran; Brian Kha,2,0,30,28
1656209504998,MATH 20E,A01,083771,Ganguly; Soumya,3,0,32,29
1656209504998,MATH 20E,A02,083772,Ganguly; Soumya,0,0,32,32
1656209504998,MATH 20E,B01,083773,Ciotti; Benjamin,16,0,35,19
1656209504998,MATH 20E,B02,083774,Ciotti; Benjamin,15,0,35,20
1656209511030,MATH 103A,A01,083777,Greenfeld; Be'Eri,1,0,36,35
1656209511030,MATH 103A,A02,083778,Greenfeld; Be'Eri,1,0,36,35
1656209511030,MATH 103A,A03,093561,Staff,5,0,36,31
1656209511030,MATH 103A,B01,083779,Greenfeld; Be'Eri,9,1,36,27
1656209511030,MATH 103A,B02,083780,Greenfeld; Be'Eri,1,0,36,35
1656209511030,MATH 103A,B03,093562,Staff,0,0,36,36
1656209517054,MATH 105,A01,085443,Carter; Anne Toulson,5,1,35,30
1656209517054,MATH 105,A02,093477,Staff,13,0,35,22
1656209523078,MATH 109,A01,083213,Ganzberger; Geoffrey Michael,0,0,34,34
1656209523078,MATH 109,A02,083214,Ganzberger; Geoffrey Michael,0,0,34,34
1656209523078,MATH 109,A03,093478,Staff,1,0,34,33
1656209523078,MATH 109,B01,083215,Ganzberger; Geoffrey Michael,4,0,32,28
1656209523078,MATH 109,B02,083216,Ganzberger; Geoffrey Michael,1,0,32,31
1656209523078,MATH 109,B03,093479,Staff,4,0,32,28
1656209529178,MATH 142A,A01,083219,Chow; Bennett,2,0,32,30
1656209529178,MATH 142A,A02,083220,Chow; Bennett,8,0,32,24
1656209529178,MATH 142A,A03,093480,Staff,5,0,32,27
1656209529178,MATH 142A,B03,093481,Staff,3,0,32,29
1656209529178,MATH 142A,B04,093558,Staff,6,0,32,26
1656209529178,MATH 142A,B05,093559,Staff,1,0,32,31
1656209535206,MATH 193A,A01,083224,Rotar; Vladimir,0,1,34,34
1656209535206,MATH 193A,A02,083225,Rotar; Vladimir,0,0,34,34
1656209535206,MATH 193A,A03,083781,Rotar; Vladimir,0,0,34,34
1656209535206,MATH 193A,A04,083782,Rotar; Vladimir,6,0,34,28
1656209535206,MATH 193A,A05,093482,Rotar; Vladimir,0,0,34,34
1656209541230,MATH 197,001,091859,McAuley; Julian John,9999,0,9999,0
1656209541230,MATH 197,002,095566,Kedlaya; Kiran S.,9997,0,9999,2
1656209541230,MATH 197,003,095567,Xiao; Ming,9999,0,9999,0
1656209541230,MATH 197,004,095571,Perols; Johan Lars,9998,0,9999,1
1656209548303,COGS 9,A01,083615,Shannon; Kyle Michael,3,0,75,72
1656209554326,COGS 11,A01,083617,Boyle; Mary E. T.,14,0,48,34
1656209560351,COGS 13,A01,083071,Bastos; Amalia Pinkusfeld,5,0,71,66
1656209566378,COGS 14A,A01,092681,Semenuks; Arturs,4,16,100,96
1656209572402,COGS 14B,A01,083073,Cheng; Tzu-Han,7,0,63,56
1656209578426,COGS 17,A01,092677,Semenuks; Arturs,7,0,81,74
1656209584450,COGS 100,A01,083619,Allen; Michael Gordon,2,0,70,68
1656209590473,COGS 101A,A01,083621,Davis; Joshua Daniel,4,0,68,64
1656209596498,COGS 101B,A01,091572,Allen; Michael Gordon,4,0,65,61
1656209602519,COGS 101C,A01,083625,Delgado; Tania,10,0,35,25
1656209608546,COGS 107A,A01,083627,Boyle; Mary E. T.,0,0,60,60
1656209614569,COGS 118A,A01,083075,Gupta; Anjum,7,0,76,69
1656209620597,CSE 3,A50,083646,Miranda; Gregory Joseph,18,0,50,32
1656209626621,CSE 8A,A50,083650,Miranda; Gregory Joseph,3,3,56,53
1656209632647,CSE 11,A01,083080,Cao; Yingjun,1,50,40,39
1656209638670,CSE 12,A01,083652,Krause-Levy; Sophia Louisa,7,3,120,113
1656209644705,CSE 15L,A01,083654,Morris; Justin Loren,2,0,50,48
1656209644705,CSE 15L,A02,083655,Morris; Justin Loren,4,0,50,46
1656209650728,CSE 20,A01,083657,Tran; Khoa Dang,30,0,80,50
1656209656751,CSE 21,A01,095574,Bach; Quang Tran,24,0,48,24
1656209662775,CSE 30,A01,083084,Eldon; John,2,8,80,78
1656209662775,CSE 30,B01,095061,Bhaskar; Nishant,1,2,50,49
1656209668805,CSE 100,A01,083659,Cao; Yingjun,2,20,70,68
1656209674828,CSE 134B,A01,083661,Powell; Thomas Allan,2,0,100,98
1656209680855,CSE 140,A01,083663,Gungor; Onat,9,0,85,76
1656209686882,CSE 140L,A01,083088,Eldon; John,8,0,100,92
1656209692907,CSE 175,A01,083665,Kumar; Rakesh,0,0,25,25
1656209698934,CSE 190,A00,092507,Dubnov; Shlomo,3,0,20,17
1656209704959,ECE 45,A01,083139,Congero; Spencer William,1,0,75,74
1656209710993,ECE 65,A50,083695,Saad; Andrew S,9,0,30,21
1656209710993,ECE 65,A51,095125,Staff,23,0,26,3
1656209717029,ECE 109,A01,091882,Touri; Behrouz,0,1,70,70
1656209723057,ECE 180,A00,083140,Abi Samra; Nicholas Camill,1,0,30,29
1656209723057,ECE 180,B00,083141,Abi Samra; Nicholas Camill,0,4,30,30
1656209729083,MATH 10A,A01,083735,Patchell; Gregory David,0,0,30,30
1656209729083,MATH 10A,A02,083736,Patchell; Gregory David,22,0,30,8
1656209729083,MATH 10A,A03,083737,Patchell; Gregory David,16,0,30,14
1656209735112,MATH 10B,A01,083207,Lim; Seonhee,0,0,34,34
1656209735112,MATH 10B,A02,083208,Lim; Seonhee,7,0,35,28
1656209735112,MATH 10B,A03,093472,Staff,1,0,34,33
1656209735112,MATH 10B,B01,083739,Sinha; Shubham,11,0,30,19
1656209741143,MATH 18,A01,083743,Cinel; Cameron Alexander,7,0,30,23
1656209741143,MATH 18,A02,083744,Cinel; Cameron Alexander,10,0,30,20
1656209741143,MATH 18,A03,083745,Cinel; Cameron Alexander,4,0,30,26
1656209741143,MATH 18,B01,083748,Rideout; David Porter,1,0,36,35
1656209741143,MATH 18,B02,083749,Rideout; David Porter,0,0,36,36
1656209741143,MATH 18,B03,083750,Rideout; David Porter,0,0,36,36
1656209741143,MATH 18,B04,083751,Rideout; David Porter,0,0,36,36
1656209741143,MATH 18,B05,093473,Rideout; David Porter,0,0,36,36
1656209741143,MATH 18,B06,093474,Rideout; David Porter,3,0,36,33
1656209747169,MATH 20A,A01,083754,Zheng; Zequn,11,0,40,29
1656209753193,MATH 20B,A01,083756,Briones; Jor-el Thomas Caparas,0,0,36,36
1656209753193,MATH 20B,A02,083757,Briones; Jor-el Thomas Caparas,0,0,36,36
1656209753193,MATH 20B,A03,093475,Staff,1,0,36,35
1656209759217,MATH 20C,A01,083760,Briones; Jor-el Thomas Caparas,0,0,35,35
1656209759217,MATH 20C,A02,083761,Briones; Jor-el Thomas Caparas,9,1,35,26
1656209759217,MATH 20C,A03,093476,Staff,0,0,35,35
1656209759217,MATH 20C,B01,083762,Bach; Quang Tran,1,0,30,29
1656209765244,MATH 20D,A01,083765,Tran; Brian Kha,1,0,30,29
1656209765244,MATH 20D,A02,083766,Tran; Brian Kha,0,1,30,30
1656209765244,MATH 20D,A03,083767,Tran; Brian Kha,2,0,30,28
1656209771269,MATH 20E,A01,083771,Ganguly; Soumya,3,0,32,29
1656209771269,MATH 20E,A02,083772,Ganguly; Soumya,0,0,32,32
1656209771269,MATH 20E,B01,083773,Ciotti; Benjamin,16,0,35,19
1656209771269,MATH 20E,B02,083774,Ciotti; Benjamin,15,0,35,20
1656209777298,MATH 103A,A01,083777,Greenfeld; Be'Eri,1,0,36,35
1656209777298,MATH 103A,A02,083778,Greenfeld; Be'Eri,1,0,36,35
1656209777298,MATH 103A,A03,093561,Staff,5,0,36,31
1656209777298,MATH 103A,B01,083779,Greenfeld; Be'Eri,9,1,36,27
1656209777298,MATH 103A,B02,083780,Greenfeld; Be'Eri,1,0,36,35
1656209777298,MATH 103A,B03,093562,Staff,0,0,36,36
1656209783321,MATH 105,A01,085443,Carter; Anne Toulson,5,1,35,30
1656209783321,MATH 105,A02,093477,Staff,13,0,35,22
1656209789344,MATH 109,A01,083213,Ganzberger; Geoffrey Michael,0,0,34,34
1656209789344,MATH 109,A02,083214,Ganzberger; Geoffrey Michael,0,0,34,34
1656209789344,MATH 109,A03,093478,Staff,1,0,34,33
1656209789344,MATH 109,B01,083215,Ganzberger; Geoffrey Michael,4,0,32,28
1656209789344,MATH 109,B02,083216,Ganzberger; Geoffrey Michael,1,0,32,31
1656209789344,MATH 109,B03,093479,Staff,4,0,32,28
1656209795368,MATH 142A,A01,083219,Chow; Bennett,2,0,32,30
1656209795368,MATH 142A,A02,083220,Chow; Bennett,8,0,32,24
1656209795368,MATH 142A,A03,093480,Staff,5,0,32,27
1656209795368,MATH 142A,B03,093481,Staff,3,0,32,29
1656209795368,MATH 142A,B04,093558,Staff,6,0,32,26
1656209795368,MATH 142A,B05,093559,Staff,1,0,32,31
1656209801394,MATH 193A,A01,083224,Rotar; Vladimir,0,1,34,34
1656209801394,MATH 193A,A02,083225,Rotar; Vladimir,0,0,34,34
1656209801394,MATH 193A,A03,083781,Rotar; Vladimir,0,0,34,34
1656209801394,MATH 193A,A04,083782,Rotar; Vladimir,6,0,34,28
1656209801394,MATH 193A,A05,093482,Rotar; Vladimir,0,0,34,34
1656209807419,MATH 197,001,091859,McAuley; Julian John,9999,0,9999,0
1656209807419,MATH 197,002,095566,Kedlaya; Kiran S.,9997,0,9999,2
1656209807419,MATH 197,003,095567,Xiao; Ming,9999,0,9999,0
1656209807419,MATH 197,004,095571,Perols; Johan Lars,9998,0,9999,1
1656209814496,COGS 9,A01,083615,Shannon; Kyle Michael,3,0,75,72
1656209820520,COGS 11,A01,083617,Boyle; Mary E. T.,14,0,48,34
1656209826544,COGS 13,A01,083071,Bastos; Amalia Pinkusfeld,5,0,71,66
1656209832568,COGS 14A,A01,092681,Semenuks; Arturs,4,16,100,96
1656209838595,COGS 14B,A01,083073,Cheng; Tzu-Han,7,0,63,56
1656209844618,COGS 17,A01,092677,Semenuks; Arturs,7,0,81,74
1656209850642,COGS 100,A01,083619,Allen; Michael Gordon,2,0,70,68
1656209856666,COGS 101A,A01,083621,Davis; Joshua Daniel,4,0,68,64
1656209862691,COGS 101B,A01,091572,Allen; Michael Gordon,4,0,65,61
1656209868714,COGS 101C,A01,083625,Delgado; Tania,10,0,35,25
1656209874741,COGS 107A,A01,083627,Boyle; Mary E. T.,0,0,60,60
1656209880769,COGS 118A,A01,083075,Gupta; Anjum,7,0,76,69
1656209886801,CSE 3,A50,083646,Miranda; Gregory Joseph,18,0,50,32
1656209892826,CSE 8A,A50,083650,Miranda; Gregory Joseph,3,3,56,53
1656209910228,CSE 11,A01,083080,Cao; Yingjun,1,50,40,39
1656209916251,CSE 12,A01,083652,Krause-Levy; Sophia Louisa,7,3,120,113
1656209922274,CSE 15L,A01,083654,Morris; Justin Loren,2,0,50,48
1656209922274,CSE 15L,A02,083655,Morris; Justin Loren,4,0,50,46
1656209928296,CSE 20,A01,083657,Tran; Khoa Dang,30,0,80,50
1656209934319,CSE 21,A01,095574,Bach; Quang Tran,24,0,48,24
1656209940343,CSE 30,A01,083084,Eldon; John,2,8,80,78
1656209940343,CSE 30,B01,095061,Bhaskar; Nishant,1,2,50,49
1656209946365,CSE 100,A01,083659,Cao; Yingjun,2,20,70,68
1656209952390,CSE 134B,A01,083661,Powell; Thomas Allan,2,0,100,98
1656209958413,CSE 140,A01,083663,Gungor; Onat,9,0,85,76
1656209964443,CSE 140L,A01,083088,Eldon; John,8,0,100,92
1656209970467,CSE 175,A01,083665,Kumar; Rakesh,0,0,25,25
1656209976490,CSE 190,A00,092507,Dubnov; Shlomo,3,0,20,17
1656209982523,ECE 45,A01,083139,Congero; Spencer William,1,0,75,74
1656209988547,ECE 65,A50,083695,Saad; Andrew S,9,0,30,21
1656209988547,ECE 65,A51,095125,Staff,23,0,26,3
1656209994570,ECE 109,A01,091882,Touri; Behrouz,0,1,70,70
1656210000607,ECE 180,A00,083140,Abi Samra; Nicholas Camill,1,0,30,29
1656210000607,ECE 180,B00,083141,Abi Samra; Nicholas Camill,0,4,30,30
1656210006635,MATH 10A,A01,083735,Patchell; Gregory David,0,0,30,30
1656210006635,MATH 10A,A02,083736,Patchell; Gregory David,22,0,30,8
1656210006635,MATH 10A,A03,083737,Patchell; Gregory David,16,0,30,14
1656210012662,MATH 10B,A01,083207,Lim; Seonhee,0,0,34,34
1656210012662,MATH 10B,A02,083208,Lim; Seonhee,7,0,35,28
1656210012662,MATH 10B,A03,093472,Staff,1,0,34,33
1656210012662,MATH 10B,B01,083739,Sinha; Shubham,11,0,30,19
1656210018693,MATH 18,A01,083743,Cinel; Cameron Alexander,7,0,30,23
1656210018693,MATH 18,A02,083744,Cinel; Cameron Alexander,10,0,30,20
1656210018693,MATH 18,A03,083745,Cinel; Cameron Alexander,4,0,30,26
1656210018693,MATH 18,B01,083748,Rideout; David Porter,1,0,36,35
1656210018693,MATH 18,B02,083749,Rideout; David Porter,0,0,36,36
1656210018693,MATH 18,B03,083750,Rideout; David Porter,0,0,36,36
1656210018693,MATH 18,B04,083751,Rideout; David Porter,0,0,36,36
1656210018693,MATH 18,B05,093473,Rideout; David Porter,0,0,36,36
1656210018693,MATH 18,B06,093474,Rideout; David Porter,3,0,36,33
1656210024718,MATH 20A,A01,083754,Zheng; Zequn,11,0,40,29
1656210030746,MATH 20B,A01,083756,Briones; Jor-el Thomas Caparas,0,0,36,36
1656210030746,MATH 20B,A02,083757,Briones; Jor-el Thomas Caparas,0,0,36,36
1656210030746,MATH 20B,A03,093475,Staff,1,0,36,35
1656210036775,MATH 20C,A01,083760,Briones; Jor-el Thomas Caparas,0,0,35,35
1656210036775,MATH 20C,A02,083761,Briones; Jor-el Thomas Caparas,9,1,35,26
1656210036775,MATH 20C,A03,093476,Staff,0,0,35,35
1656210036775,MATH 20C,B01,083762,Bach; Quang Tran,1,0,30,29
1656210042802,MATH 20D,A01,083765,Tran; Brian Kha,1,0,30,29
1656210042802,MATH 20D,A02,083766,Tran; Brian Kha,0,1,30,30
1656210042802,MATH 20D,A03,083767,Tran; Brian Kha,2,0,30,28
1656210048826,MATH 20E,A01,083771,Ganguly; Soumya,3,0,32,29
1656210048826,MATH 20E,A02,083772,Ganguly; Soumya,0,0,32,32
1656210048826,MATH 20E,B01,083773,Ciotti; Benjamin,16,0,35,19
1656210048826,MATH 20E,B02,083774,Ciotti; Benjamin,15,0,35,20
1656210054848,MATH 103A,A01,083777,Greenfeld; Be'Eri,1,0,36,35
1656210054848,MATH 103A,A02,083778,Greenfeld; Be'Eri,1,0,36,35
1656210054848,MATH 103A,A03,093561,Staff,5,0,36,31
1656210054848,MATH 103A,B01,083779,Greenfeld; Be'Eri,9,1,36,27
1656210054848,MATH 103A,B02,083780,Greenfeld; Be'Eri,1,0,36,35
1656210054848,MATH 103A,B03,093562,Staff,0,0,36,36
1656210060876,MATH 105,A01,085443,Carter; Anne Toulson,5,1,35,30
1656210060876,MATH 105,A02,093477,Staff,13,0,35,22
1656210066911,MATH 109,A01,083213,Ganzberger; Geoffrey Michael,0,0,34,34
1656210066911,MATH 109,A02,083214,Ganzberger; Geoffrey Michael,0,0,34,34
1656210066911,MATH 109,A03,093478,Staff,1,0,34,33
1656210066911,MATH 109,B01,083215,Ganzberger; Geoffrey Michael,4,0,32,28
1656210066911,MATH 109,B02,083216,Ganzberger; Geoffrey Michael,1,0,32,31
1656210066911,MATH 109,B03,093479,Staff,4,0,32,28
1656210072937,MATH 142A,A01,083219,Chow; Bennett,2,0,32,30
1656210072937,MATH 142A,A02,083220,Chow; Bennett,8,0,32,24
1656210072937,MATH 142A,A03,093480,Staff,5,0,32,27
1656210072937,MATH 142A,B03,093481,Staff,3,0,32,29
1656210072937,MATH 142A,B04,093558,Staff,6,0,32,26
1656210072937,MATH 142A,B05,093559,Staff,1,0,32,31
1656210078972,MATH 193A,A01,083224,Rotar; Vladimir,0,1,34,34
1656210078972,MATH 193A,A02,083225,Rotar; Vladimir,0,0,34,34
1656210078972,MATH 193A,A03,083781,Rotar; Vladimir,0,0,34,34
1656210078972,MATH 193A,A04,083782,Rotar; Vladimir,6,0,34,28
1656210078972,MATH 193A,A05,093482,Rotar; Vladimir,0,0,34,34
1656210084999,MATH 197,001,091859,McAuley; Julian John,9999,0,9999,0
1656210084999,MATH 197,002,095566,Kedlaya; Kiran S.,9997,0,9999,2
1656210084999,MATH 197,003,095567,Xiao; Ming,9999,0,9999,0
1656210084999,MATH 197,004,095571,Perols; Johan Lars,9998,0,9999,1
1656210092065,COGS 9,A01,083615,Shannon; Kyle Michael,3,0,75,72
1656210098096,COGS 11,A01,083617,Boyle; Mary E. T.,14,0,48,34
1656210104119,COGS 13,A01,083071,Bastos; Amalia Pinkusfeld,5,0,71,66
1656210110146,COGS 14A,A01,092681,Semenuks; Arturs,4,16,100,96
1656210116174,COGS 14B,A01,083073,Cheng; Tzu-Han,7,0,63,56
1656210122197,COGS 17,A01,092677,Semenuks; Arturs,7,0,81,74
1656210128226,COGS 100,A01,083619,Allen; Michael Gordon,2,0,70,68
1656210134322,COGS 101A,A01,083621,Davis; Joshua Daniel,4,0,68,64
1656210140345,COGS 101B,A01,091572,Allen; Michael Gordon,4,0,65,61
1656210146367,COGS 101C,A01,083625,Delgado; Tania,10,0,35,25
1656210152393,COGS 107A,A01,083627,Boyle; Mary E. T.,0,0,60,60
1656210158416,COGS 118A,A01,083075,Gupta; Anjum,7,0,76,69
1656210164443,CSE 3,A50,083646,Miranda; Gregory Joseph,18,0,50,32
1656210170466,CSE 8A,A50,083650,Miranda; Gregory Joseph,3,3,56,53
1656210176495,CSE 11,A01,083080,Cao; Yingjun,1,50,40,39
1656210182520,CSE 12,A01,083652,Krause-Levy; Sophia Louisa,7,3,120,113
1656210188544,CSE 15L,A01,083654,Morris; Justin Loren,2,0,50,48
1656210188544,CSE 15L,A02,083655,Morris; Justin Loren,4,0,50,46
1656210194570,CSE 20,A01,083657,Tran; Khoa Dang,30,0,80,50
1656210200597,CSE 21,A01,095574,Bach; Quang Tran,24,0,48,24
1656210206622,CSE 30,A01,083084,Eldon; John,2,8,80,78
1656210206622,CSE 30,B01,095061,Bhaskar; Nishant,1,2,50,49
1656210212644,CSE 100,A01,083659,Cao; Yingjun,2,20,70,68
1656210218672,CSE 134B,A01,083661,Powell; Thomas Allan,2,0,100,98
1656210224699,CSE 140,A01,083663,Gungor; Onat,9,0,85,76
1656210230721,CSE 140L,A01,083088,Eldon; John,8,0,100,92
1656210236747,CSE 175,A01,083665,Kumar; Rakesh,0,0,25,25
1656210242774,CSE 190,A00,092507,Dubnov; Shlomo,3,0,20,17
1656210248798,ECE 45,A01,083139,Congero; Spencer William,1,0,75,74
1656210254821,ECE 65,A50,083695,Saad; Andrew S,9,0,30,21
1656210254821,ECE 65,A51,095125,Staff,23,0,26,3
1656210260844,ECE 109,A01,091882,Touri; Behrouz,0,1,70,70
1656210266867,ECE 180,A00,083140,Abi Samra; Nicholas Camill,1,0,30,29
1656210266867,ECE 180,B00,083141,Abi Samra; Nicholas Camill,0,4,30,30
1656210272891,MATH 10A,A01,083735,Patchell; Gregory David,0,0,30,30
1656210272891,MATH 10A,A02,083736,Patchell; Gregory David,22,0,30,8
1656210272891,MATH 10A,A03,083737,Patchell; Gregory David,16,0,30,14
1656210278920,MATH 10B,A01,083207,Lim; Seonhee,0,0,34,34
1656210278920,MATH 10B,A02,083208,Lim; Seonhee,7,0,35,28
1656210278920,MATH 10B,A03,093472,Staff,1,0,34,33
1656210278920,MATH 10B,B01,083739,Sinha; Shubham,11,0,30,19
1656210284944,MATH 18,A01,083743,Cinel; Cameron Alexander,7,0,30,23
1656210284944,MATH 18,A02,083744,Cinel; Cameron Alexander,10,0,30,20
1656210284944,MATH 18,A03,083745,Cinel; Cameron Alexander,5,0,30,25
1656210284944,MATH 18,B01,083748,Rideout; David Porter,0,0,36,36
1656210284944,MATH 18,B02,083749,Rideout; David Porter,0,0,36,36
1656210284944,MATH 18,B03,083750,Rideout; David Porter,0,0,36,36
1656210284944,MATH 18,B04,083751,Rideout; David Porter,0,0,36,36
1656210284944,MATH 18,B05,093473,Rideout; David Porter,0,0,36,36
1656210284944,MATH 18,B06,093474,Rideout; David Porter,3,0,36,33
1656210290968,MATH 20A,A01,083754,Zheng; Zequn,11,0,40,29
1656210296992,MATH 20B,A01,083756,Briones; Jor-el Thomas Caparas,0,0,36,36
1656210296992,MATH 20B,A02,083757,Briones; Jor-el Thomas Caparas,0,0,36,36
1656210296992,MATH 20B,A03,093475,Staff,1,0,36,35
1656210303022,MATH 20C,A01,083760,Briones; Jor-el Thomas Caparas,0,0,35,35
1656210303022,MATH 20C,A02,083761,Briones; Jor-el Thomas Caparas,9,1,35,26
1656210303022,MATH 20C,A03,093476,Staff,0,0,35,35
1656210303022,MATH 20C,B01,083762,Bach; Quang Tran,1,0,30,29
1656210309057,MATH 20D,A01,083765,Tran; Brian Kha,1,0,30,29
1656210309057,MATH 20D,A02,083766,Tran; Brian Kha,0,1,30,30
1656210309057,MATH 20D,A03,083767,Tran; Brian Kha,2,0,30,28
1656210315082,MATH 20E,A01,083771,Ganguly; Soumya,3,0,32,29
1656210315082,MATH 20E,A02,083772,Ganguly; Soumya,0,0,32,32
1656210315082,MATH 20E,B01,083773,Ciotti; Benjamin,16,0,35,19
1656210315082,MATH 20E,B02,083774,Ciotti; Benjamin,15,0,35,20
1656210321107,MATH 103A,A01,083777,Greenfeld; Be'Eri,1,0,36,35
1656210321107,MATH 103A,A02,083778,Greenfeld; Be'Eri,1,0,36,35
1656210321107,MATH 103A,A03,093561,Staff,5,0,36,31
1656210321107,MATH 103A,B01,083779,Greenfeld; Be'Eri,9,1,36,27
1656210321107,MATH 103A,B02,083780,Greenfeld; Be'Eri,1,0,36,35
1656210321107,MATH 103A,B03,093562,Staff,0,0,36,36
1656210327130,MATH 105,A01,085443,Carter; Anne Toulson,5,1,35,30
1656210327130,MATH 105,A02,093477,Staff,13,0,35,22
1656210333155,MATH 109,A01,083213,Ganzberger; Geoffrey Michael,0,0,34,34
1656210333155,MATH 109,A02,083214,Ganzberger; Geoffrey Michael,0,0,34,34
1656210333155,MATH 109,A03,093478,Staff,1,0,34,33
1656210333155,MATH 109,B01,083215,Ganzberger; Geoffrey Michael,4,0,32,28
1656210333155,MATH 109,B02,083216,Ganzberger; Geoffrey Michael,1,0,32,31
1656210333155,MATH 109,B03,093479,Staff,4,0,32,28
1656210339179,MATH 142A,A01,083219,Chow; Bennett,2,0,32,30
1656210339179,MATH 142A,A02,083220,Chow; Bennett,8,0,32,24
1656210339179,MATH 142A,A03,093480,Staff,5,0,32,27
1656210339179,MATH 142A,B03,093481,Staff,3,0,32,29
1656210339179,MATH 142A,B04,093558,Staff,6,0,32,26
1656210339179,MATH 142A,B05,093559,Staff,1,0,32,31
1656210345208,MATH 193A,A01,083224,Rotar; Vladimir,0,1,34,34
1656210345208,MATH 193A,A02,083225,Rotar; Vladimir,0,0,34,34
1656210345208,MATH 193A,A03,083781,Rotar; Vladimir,0,0,34,34
1656210345208,MATH 193A,A04,083782,Rotar; Vladimir,6,0,34,28
1656210345208,MATH 193A,A05,093482,Rotar; Vladimir,0,0,34,34
1656210351238,MATH 197,001,091859,McAuley; Julian John,9999,0,9999,0
1656210351238,MATH 197,002,095566,Kedlaya; Kiran S.,9997,0,9999,2
1656210351238,MATH 197,003,095567,Xiao; Ming,9999,0,9999,0
1656210351238,MATH 197,004,095571,Perols; Johan Lars,9998,0,9999,1
1656210358304,COGS 9,A01,083615,Shannon; Kyle Michael,3,0,75,72
1656210364331,COGS 11,A01,083617,Boyle; Mary E. T.,14,0,48,34
1656210370357,COGS 13,A01,083071,Bastos; Amalia Pinkusfeld,5,0,71,66
1656210376379,COGS 14A,A01,092681,Semenuks; Arturs,4,16,100,96
1656210382401,COGS 14B,A01,083073,Cheng; Tzu-Han,7,0,63,56
1656210388428,COGS 17,A01,092677,Semenuks; Arturs,7,0,81,74
1656210394461,COGS 100,A01,083619,Allen; Michael Gordon,2,0,70,68
1656210400482,COGS 101A,A01,083621,Davis; Joshua Daniel,4,0,68,64
1656210406507,COGS 101B,A01,091572,Allen; Michael Gordon,4,0,65,61
1656210412533,COGS 101C,A01,083625,Delgado; Tania,10,0,35,25
1656210418560,COGS 107A,A01,083627,Boyle; Mary E. T.,0,0,60,60
1656210424585,COGS 118A,A01,083075,Gupta; Anjum,7,0,76,69
1656210430615,CSE 3,A50,083646,Miranda; Gregory Joseph,18,0,50,32
1656210436648,CSE 8A,A50,083650,Miranda; Gregory Joseph,3,3,56,53
1656210442674,CSE 11,A01,083080,Cao; Yingjun,1,50,40,39
1656210448702,CSE 12,A01,083652,Krause-Levy; Sophia Louisa,7,3,120,113
1656210454724,CSE 15L,A01,083654,Morris; Justin Loren,2,0,50,48
1656210454724,CSE 15L,A02,083655,Morris; Justin Loren,4,0,50,46
1656210460751,CSE 20,A01,083657,Tran; Khoa Dang,30,0,80,50
1656210466778,CSE 21,A01,095574,Bach; Quang Tran,24,0,48,24
1656210472801,CSE 30,A01,083084,Eldon; John,2,8,80,78
1656210472801,CSE 30,B01,095061,Bhaskar; Nishant,1,2,50,49
1656210478824,CSE 100,A01,083659,Cao; Yingjun,2,20,70,68
1656210484851,CSE 134B,A01,083661,Powell; Thomas Allan,2,0,100,98
1656210490878,CSE 140,A01,083663,Gungor; Onat,9,0,85,76
1656210496907,CSE 140L,A01,083088,Eldon; John,8,0,100,92
1656210502931,CSE 175,A01,083665,Kumar; Rakesh,0,0,25,25
1656210508954,CSE 190,A00,092507,Dubnov; Shlomo,3,0,20,17
1656210514988,ECE 45,A01,083139,Congero; Spencer William,1,0,75,74
1656210521017,ECE 65,A50,083695,Saad; Andrew S,9,0,30,21
1656210521017,ECE 65,A51,095125,Staff,23,0,26,3
1656210527042,ECE 109,A01,091882,Touri; Behrouz,0,1,70,70
1656210533067,ECE 180,A00,083140,Abi Samra; Nicholas Camill,1,0,30,29
1656210533067,ECE 180,B00,083141,Abi Samra; Nicholas Camill,0,4,30,30
1656210539095,MATH 10A,A01,083735,Patchell; Gregory David,0,0,30,30
1656210539095,MATH 10A,A02,083736,Patchell; Gregory David,22,0,30,8
1656210539095,MATH 10A,A03,083737,Patchell; Gregory David,16,0,30,14
1656210545118,MATH 10B,A01,083207,Lim; Seonhee,0,0,34,34
1656210545118,MATH 10B,A02,083208,Lim; Seonhee,7,0,35,28
1656210545118,MATH 10B,A03,093472,Staff,1,0,34,33
1656210545118,MATH 10B,B01,083739,Sinha; Shubham,11,0,30,19
1656210551143,MATH 18,A01,083743,Cinel; Cameron Alexander,7,0,30,23
1656210551143,MATH 18,A02,083744,Cinel; Cameron Alexander,10,0,30,20
1656210551143,MATH 18,A03,083745,Cinel; Cameron Alexander,5,0,30,25
1656210551143,MATH 18,B01,083748,Rideout; David Porter,0,0,36,36
1656210551143,MATH 18,B02,083749,Rideout; David Porter,0,0,36,36
1656210551143,MATH 18,B03,083750,Rideout; David Porter,0,0,36,36
1656210551143,MATH 18,B04,083751,Rideout; David Porter,0,0,36,36
1656210551143,MATH 18,B05,093473,Rideout; David Porter,0,0,36,36
1656210551143,MATH 18,B06,093474,Rideout; David Porter,3,0,36,33
1656210557166,MATH 20A,A01,083754,Zheng; Zequn,11,0,40,29
1656210563190,MATH 20B,A01,083756,Briones; Jor-el Thomas Caparas,0,0,36,36
1656210563190,MATH 20B,A02,083757,Briones; Jor-el Thomas Caparas,0,0,36,36
1656210563190,MATH 20B,A03,093475,Staff,1,0,36,35
1656210569213,MATH 20C,A01,083760,Briones; Jor-el Thomas Caparas,0,0,35,35
1656210569213,MATH 20C,A02,083761,Briones; Jor-el Thomas Caparas,9,1,35,26
1656210569213,MATH 20C,A03,093476,Staff,0,0,35,35
1656210569213,MATH 20C,B01,083762,Bach; Quang Tran,1,0,30,29
1656210575239,MATH 20D,A01,083765,Tran; Brian Kha,1,0,30,29
1656210575239,MATH 20D,A02,083766,Tran; Brian Kha,0,1,30,30
1656210575239,MATH 20D,A03,083767,Tran; Brian Kha,2,0,30,28
1656210581264,MATH 20E,A01,083771,Ganguly; Soumya,3,0,32,29
1656210581264,MATH 20E,A02,083772,Ganguly; Soumya,0,0,32,32
1656210581264,MATH 20E,B01,083773,Ciotti; Benjamin,16,0,35,19
1656210581264,MATH 20E,B02,083774,Ciotti; Benjamin,15,0,35,20
1656210587289,MATH 103A,A01,083777,Greenfeld; Be'Eri,1,0,36,35
1656210587289,MATH 103A,A02,083778,Greenfeld; Be'Eri,1,0,36,35
1656210587289,MATH 103A,A03,093561,Staff,5,0,36,31
1656210587289,MATH 103A,B01,083779,Greenfeld; Be'Eri,9,1,36,27
1656210587289,MATH 103A,B02,083780,Greenfeld; Be'Eri,1,0,36,35
1656210587289,MATH 103A,B03,093562,Staff,0,0,36,36
1656210593317,MATH 105,A01,085443,Carter; Anne Toulson,5,1,35,30
1656210593317,MATH 105,A02,093477,Staff,13,0,35,22
1656210599340,MATH 109,A01,083213,Ganzberger; Geoffrey Michael,0,0,34,34
1656210599340,MATH 109,A02,083214,Ganzberger; Geoffrey Michael,0,0,34,34
1656210599340,MATH 109,A03,093478,Staff,1,0,34,33
1656210599340,MATH 109,B01,083215,Ganzberger; Geoffrey Michael,4,0,32,28
1656210599340,MATH 109,B02,083216,Ganzberger; Geoffrey Michael,1,0,32,31
1656210599340,MATH 109,B03,093479,Staff,4,0,32,28
1656210605363,MATH 142A,A01,083219,Chow; Bennett,2,0,32,30
1656210605363,MATH 142A,A02,083220,Chow; Bennett,8,0,32,24
1656210605363,MATH 142A,A03,093480,Staff,5,0,32,27
1656210605363,MATH 142A,B03,093481,Staff,3,0,32,29
1656210605363,MATH 142A,B04,093558,Staff,6,0,32,26
1656210605363,MATH 142A,B05,093559,Staff,1,0,32,31
1656210611386,MATH 193A,A01,083224,Rotar; Vladimir,0,1,34,34
1656210611386,MATH 193A,A02,083225,Rotar; Vladimir,0,0,34,34
1656210611386,MATH 193A,A03,083781,Rotar; Vladimir,0,0,34,34
1656210611386,MATH 193A,A04,083782,Rotar; Vladimir,6,0,34,28
1656210611386,MATH 193A,A05,093482,Rotar; Vladimir,0,0,34,34
1656210617410,MATH 197,001,091859,McAuley; Julian John,9999,0,9999,0
1656210617410,MATH 197,002,095566,Kedlaya; Kiran S.,9997,0,9999,2
1656210617410,MATH 197,003,095567,Xiao; Ming,9999,0,9999,0
1656210617410,MATH 197,004,095571,Perols; Johan Lars,9998,0,9999,1
1656210624475,COGS 9,A01,083615,Shannon; Kyle Michael,3,0,75,72
1656210630498,COGS 11,A01,083617,Boyle; Mary E. T.,14,0,48,34
1656210636525,COGS 13,A01,083071,Bastos; Amalia Pinkusfeld,5,0,71,66
1656210642551,COGS 14A,A01,092681,Semenuks; Arturs,4,16,100,96
1656210648574,COGS 14B,A01,083073,Cheng; Tzu-Han,7,0,63,56
1656210654601,COGS 17,A01,092677,Semenuks; Arturs,7,0,81,74
1656210660629,COGS 100,A01,083619,Allen; Michael Gordon,2,0,70,68
1656210666657,COGS 101A,A01,083621,Davis; Joshua Daniel,4,0,68,64
1656210672696,COGS 101B,A01,091572,Allen; Michael Gordon,4,0,65,61
1656210678723,COGS 101C,A01,083625,Delgado; Tania,10,0,35,25
1656210684750,COGS 107A,A01,083627,Boyle; Mary E. T.,0,0,60,60
1656210690773,COGS 118A,A01,083075,Gupta; Anjum,7,0,76,69
1656210696800,CSE 3,A50,083646,Miranda; Gregory Joseph,18,0,50,32
1656210702826,CSE 8A,A50,083650,Miranda; Gregory Joseph,3,3,56,53
1656210708848,CSE 11,A01,083080,Cao; Yingjun,1,50,40,39
1656210714873,CSE 12,A01,083652,Krause-Levy; Sophia Louisa,7,3,120,113
1656210720896,CSE 15L,A01,083654,Morris; Justin Loren,2,0,50,48
1656210720896,CSE 15L,A02,083655,Morris; Justin Loren,4,0,50,46
1656210726920,CSE 20,A01,083657,Tran; Khoa Dang,30,0,80,50
1656210733040,CSE 21,A01,095574,Bach; Quang Tran,24,0,48,24
1656210739063,CSE 30,A01,083084,Eldon; John,2,8,80,78
1656210739063,CSE 30,B01,095061,Bhaskar; Nishant,1,2,50,49
1656210745086,CSE 100,A01,083659,Cao; Yingjun,2,20,70,68
1656210751109,CSE 134B,A01,083661,Powell; Thomas Allan,2,0,100,98
1656210757132,CSE 140,A01,083663,Gungor; Onat,9,0,85,76
1656210763160,CSE 140L,A01,083088,Eldon; John,8,0,100,92
1656210769182,CSE 175,A01,083665,Kumar; Rakesh,0,0,25,25
1656210775205,CSE 190,A00,092507,Dubnov; Shlomo,3,0,20,17
1656210781229,ECE 45,A01,083139,Congero; Spencer William,1,0,75,74
1656210787257,ECE 65,A50,083695,Saad; Andrew S,9,0,30,21
1656210787257,ECE 65,A51,095125,Staff,23,0,26,3
1656210793279,ECE 109,A01,091882,Touri; Behrouz,0,1,70,70
1656210799305,ECE 180,A00,083140,Abi Samra; Nicholas Camill,1,0,30,29
1656210799305,ECE 180,B00,083141,Abi Samra; Nicholas Camill,0,4,30,30
1656210805332,MATH 10A,A01,083735,Patchell; Gregory David,0,0,30,30
1656210805332,MATH 10A,A02,083736,Patchell; Gregory David,22,0,30,8
1656210805332,MATH 10A,A03,083737,Patchell; Gregory David,16,0,30,14
1656210811357,MATH 10B,A01,083207,Lim; Seonhee,0,0,34,34
1656210811357,MATH 10B,A02,083208,Lim; Seonhee,7,0,35,28
1656210811357,MATH 10B,A03,093472,Staff,1,0,34,33
1656210811357,MATH 10B,B01,083739,Sinha; Shubham,11,0,30,19
1656210817391,MATH 18,A01,083743,Cinel; Cameron Alexander,7,0,30,23
1656210817391,MATH 18,A02,083744,Cinel; Cameron Alexander,10,0,30,20
1656210817391,MATH 18,A03,083745,Cinel; Cameron Alexander,5,0,30,25
1656210817391,MATH 18,B01,083748,Rideout; David Porter,0,0,36,36
1656210817391,MATH 18,B02,083749,Rideout; David Porter,0,0,36,36
1656210817391,MATH 18,B03,083750,Rideout; David Porter,0,0,36,36
1656210817391,MATH 18,B04,083751,Rideout; David Porter,0,0,36,36
1656210817391,MATH 18,B05,093473,Rideout; David Porter,0,0,36,36
1656210817391,MATH 18,B06,093474,Rideout; David Porter,3,0,36,33
1656210823413,MATH 20A,A01,083754,Zheng; Zequn,11,0,40,29
1656210829435,MATH 20B,A01,083756,Briones; Jor-el Thomas Caparas,0,0,36,36
1656210829435,MATH 20B,A02,083757,Briones; Jor-el Thomas Caparas,0,0,36,36
1656210829435,MATH 20B,A03,093475,Staff,1,0,36,35
1656210835465,MATH 20C,A01,083760,Briones; Jor-el Thomas Caparas,0,0,35,35
1656210835465,MATH 20C,A02,083761,Briones; Jor-el Thomas Caparas,9,1,35,26
1656210835465,MATH 20C,A03,093476,Staff,0,0,35,35
1656210835465,MATH 20C,B01,083762,Bach; Quang Tran,1,0,30,29
1656210841492,MATH 20D,A01,083765,Tran; Brian Kha,1,0,30,29
1656210841492,MATH 20D,A02,083766,Tran; Brian Kha,0,1,30,30
1656210841492,MATH 20D,A03,083767,Tran; Brian Kha,2,0,30,28
1656210847518,MATH 20E,A01,083771,Ganguly; Soumya,3,0,32,29
1656210847518,MATH 20E,A02,083772,Ganguly; Soumya,0,0,32,32
1656210847518,MATH 20E,B01,083773,Ciotti; Benjamin,16,0,35,19
1656210847518,MATH 20E,B02,083774,Ciotti; Benjamin,15,0,35,20
1656210853547,MATH 103A,A01,083777,Greenfeld; Be'Eri,1,0,36,35
1656210853547,MATH 103A,A02,083778,Greenfeld; Be'Eri,1,0,36,35
1656210853547,MATH 103A,A03,093561,Staff,5,0,36,31
1656210853547,MATH 103A,B01,083779,Greenfeld; Be'Eri,9,1,36,27
1656210853547,MATH 103A,B02,083780,Greenfeld; Be'Eri,1,0,36,35
1656210853547,MATH 103A,B03,093562,Staff,0,0,36,36
1656210859591,MATH 105,A01,085443,Carter; Anne Toulson,5,1,35,30
1656210859591,MATH 105,A02,093477,Staff,13,0,35,22
1656210865619,MATH 109,A01,083213,Ganzberger; Geoffrey Michael,0,0,34,34
1656210865619,MATH 109,A02,083214,Ganzberger; Geoffrey Michael,0,0,34,34
1656210865619,MATH 109,A03,093478,Staff,1,0,34,33
1656210865619,MATH 109,B01,083215,Ganzberger; Geoffrey Michael,4,0,32,28
1656210865619,MATH 109,B02,083216,Ganzberger; Geoffrey Michael,1,0,32,31
1656210865619,MATH 109,B03,093479,Staff,4,0,32,28
1656210871643,MATH 142A,A01,083219,Chow; Bennett,2,0,32,30
1656210871643,MATH 142A,A02,083220,Chow; Bennett,8,0,32,24
1656210871643,MATH 142A,A03,093480,Staff,5,0,32,27
1656210871643,MATH 142A,B03,093481,Staff,3,0,32,29
1656210871643,MATH 142A,B04,093558,Staff,6,0,32,26
1656210871643,MATH 142A,B05,093559,Staff,1,0,32,31
1656210877671,MATH 193A,A01,083224,Rotar; Vladimir,0,1,34,34
1656210877671,MATH 193A,A02,083225,Rotar; Vladimir,0,0,34,34
1656210877671,MATH 193A,A03,083781,Rotar; Vladimir,0,0,34,34
1656210877671,MATH 193A,A04,083782,Rotar; Vladimir,6,0,34,28
1656210877671,MATH 193A,A05,093482,Rotar; Vladimir,0,0,34,34
1656210883698,MATH 197,001,091859,McAuley; Julian John,9999,0,9999,0
1656210883698,MATH 197,002,095566,Kedlaya; Kiran S.,9997,0,9999,2
1656210883698,MATH 197,003,095567,Xiao; Ming,9999,0,9999,0
1656210883698,MATH 197,004,095571,Perols; Johan Lars,9998,0,9999,1
1656210890762,COGS 9,A01,083615,Shannon; Kyle Michael,3,0,75,72
1656210896797,COGS 11,A01,083617,Boyle; Mary E. T.,14,0,48,34
1656210902820,COGS 13,A01,083071,Bastos; Amalia Pinkusfeld,5,0,71,66
1656210908843,COGS 14A,A01,092681,Semenuks; Arturs,4,16,100,96
1656210914867,COGS 14B,A01,083073,Cheng; Tzu-Han,7,0,63,56
1656210920893,COGS 17,A01,092677,Semenuks; Arturs,7,0,81,74
1656210926916,COGS 100,A01,083619,Allen; Michael Gordon,2,0,70,68
1656210932938,COGS 101A,A01,083621,Davis; Joshua Daniel,4,0,68,64
1656210938960,COGS 101B,A01,091572,Allen; Michael Gordon,4,0,65,61
1656210944984,COGS 101C,A01,083625,Delgado; Tania,10,0,35,25
1656210951011,COGS 107A,A01,083627,Boyle; Mary E. T.,0,0,60,60
1656210957034,COGS 118A,A01,083075,Gupta; Anjum,7,0,76,69
1656210963058,CSE 3,A50,083646,Miranda; Gregory Joseph,18,0,50,32
1656210969086,CSE 8A,A50,083650,Miranda; Gregory Joseph,3,3,56,53
1656210975111,CSE 11,A01,083080,Cao; Yingjun,1,50,40,39
1656210981140,CSE 12,A01,083652,Krause-Levy; Sophia Louisa,7,3,120,113
1656210987163,CSE 15L,A01,083654,Morris; Justin Loren,2,0,50,48
1656210987163,CSE 15L,A02,083655,Morris; Justin Loren,4,0,50,46
1656210993184,CSE 20,A01,083657,Tran; Khoa Dang,30,0,80,50
1656210999206,CSE 21,A01,095574,Bach; Quang Tran,24,0,48,24
1656211005228,CSE 30,A01,083084,Eldon; John,2,8,80,78
1656211005228,CSE 30,B01,095061,Bhaskar; Nishant,1,2,50,49
1656211011250,CSE 100,A01,083659,Cao; Yingjun,2,20,70,68
1656211017274,CSE 134B,A01,083661,Powell; Thomas Allan,2,0,100,98
1656211023294,CSE 140,A01,083663,Gungor; Onat,9,0,85,76
1656211029318,CSE 140L,A01,083088,Eldon; John,8,0,100,92
1656211035340,CSE 175,A01,083665,Kumar; Rakesh,0,0,25,25
1656211041366,CSE 190,A00,092507,Dubnov; Shlomo,3,0,20,17
1656211047391,ECE 45,A01,083139,Congero; Spencer William,1,0,75,74
1656211053414,ECE 65,A50,083695,Saad; Andrew S,9,0,30,21
1656211053414,ECE 65,A51,095125,Staff,23,0,26,3
1656211059438,ECE 109,A01,091882,Touri; Behrouz,0,1,70,70
1656211065465,ECE 180,A00,083140,Abi Samra; Nicholas Camill,1,0,30,29
1656211065465,ECE 180,B00,083141,Abi Samra; Nicholas Camill,0,4,30,30
1656211071488,MATH 10A,A01,083735,Patchell; Gregory David,0,0,30,30
1656211071488,MATH 10A,A02,083736,Patchell; Gregory David,22,0,30,8
1656211071488,MATH 10A,A03,083737,Patchell; Gregory David,16,0,30,14
1656211077516,MATH 10B,A01,083207,Lim; Seonhee,0,0,34,34
1656211077516,MATH 10B,A02,083208,Lim; Seonhee,7,0,35,28
1656211077516,MATH 10B,A03,093472,Staff,1,0,34,33
1656211077516,MATH 10B,B01,083739,Sinha; Shubham,11,0,30,19
1656211083543,MATH 18,A01,083743,Cinel; Cameron Alexander,7,0,30,23
1656211083543,MATH 18,A02,083744,Cinel; Cameron Alexander,10,0,30,20
1656211083543,MATH 18,A03,083745,Cinel; Cameron Alexander,5,0,30,25
1656211083543,MATH 18,B01,083748,Rideout; David Porter,0,0,36,36
1656211083543,MATH 18,B02,083749,Rideout; David Porter,0,0,36,36
1656211083543,MATH 18,B03,083750,Rideout; David Porter,0,0,36,36
1656211083543,MATH 18,B04,083751,Rideout; David Porter,0,0,36,36
1656211083543,MATH 18,B05,093473,Rideout; David Porter,0,0,36,36
1656211083543,MATH 18,B06,093474,Rideout; David Porter,3,0,36,33
1656211089568,MATH 20A,A01,083754,Zheng; Zequn,11,0,40,29
1656211095590,MATH 20B,A01,083756,Briones; Jor-el Thomas Caparas,0,0,36,36
1656211095590,MATH 20B,A02,083757,Briones; Jor-el Thomas Caparas,0,0,36,36
1656211095590,MATH 20B,A03,093475,Staff,1,0,36,35
1656211101613,MATH 20C,A01,083760,Briones; Jor-el Thomas Caparas,0,0,35,35
1656211101613,MATH 20C,A02,083761,Briones; Jor-el Thomas Caparas,9,1,35,26
1656211101613,MATH 20C,A03,093476,Staff,0,0,35,35
1656211101613,MATH 20C,B01,083762,Bach; Quang Tran,1,0,30,29
1656211107642,MATH 20D,A01,083765,Tran; Brian Kha,1,0,30,29
1656211107642,MATH 20D,A02,083766,Tran; Brian Kha,0,1,30,30
1656211107642,MATH 20D,A03,083767,Tran; Brian Kha,2,0,30,28
1656211113665,MATH 20E,A01,083771,Ganguly; Soumya,3,0,32,29
1656211113665,MATH 20E,A02,083772,Ganguly; Soumya,0,0,32,32
1656211113665,MATH 20E,B01,083773,Ciotti; Benjamin,16,0,35,19
1656211113665,MATH 20E,B02,083774,Ciotti; Benjamin,15,0,35,20
1656211119695,MATH 103A,A01,083777,Greenfeld; Be'Eri,1,0,36,35
1656211119695,MATH 103A,A02,083778,Greenfeld; Be'Eri,1,0,36,35
1656211119695,MATH 103A,A03,093561,Staff,5,0,36,31
1656211119695,MATH 103A,B01,083779,Greenfeld; Be'Eri,9,1,36,27
1656211119695,MATH 103A,B02,083780,Greenfeld; Be'Eri,1,0,36,35
1656211119695,MATH 103A,B03,093562,Staff,0,0,36,36
1656211125721,MATH 105,A01,085443,Carter; Anne Toulson,5,1,35,30
1656211125721,MATH 105,A02,093477,Staff,13,0,35,22
1656211131754,MATH 109,A01,083213,Ganzberger; Geoffrey Michael,0,0,34,34
1656211131754,MATH 109,A02,083214,Ganzberger; Geoffrey Michael,0,0,34,34
1656211131754,MATH 109,A03,093478,Staff,1,0,34,33
1656211131754,MATH 109,B01,083215,Ganzberger; Geoffrey Michael,4,0,32,28
1656211131754,MATH 109,B02,083216,Ganzberger; Geoffrey Michael,1,0,32,31
1656211131754,MATH 109,B03,093479,Staff,4,0,32,28
1656211137784,MATH 142A,A01,083219,Chow; Bennett,2,0,32,30
1656211137784,MATH 142A,A02,083220,Chow; Bennett,8,0,32,24
1656211137784,MATH 142A,A03,093480,Staff,5,0,32,27
1656211137784,MATH 142A,B03,093481,Staff,3,0,32,29
1656211137784,MATH 142A,B04,093558,Staff,6,0,32,26
1656211137784,MATH 142A,B05,093559,Staff,1,0,32,31
1656211143816,MATH 193A,A01,083224,Rotar; Vladimir,0,1,34,34
1656211143816,MATH 193A,A02,083225,Rotar; Vladimir,0,0,34,34
1656211143816,MATH 193A,A03,083781,Rotar; Vladimir,0,0,34,34
1656211143816,MATH 193A,A04,083782,Rotar; Vladimir,6,0,34,28
1656211143816,MATH 193A,A05,093482,Rotar; Vladimir,0,0,34,34
1656211149838,MATH 197,001,091859,McAuley; Julian John,9999,0,9999,0
1656211149838,MATH 197,002,095566,Kedlaya; Kiran S.,9997,0,9999,2
1656211149838,MATH 197,003,095567,Xiao; Ming,9999,0,9999,0
1656211149838,MATH 197,004,095571,Perols; Johan Lars,9998,0,9999,1
1656211156889,COGS 9,A01,083615,Shannon; Kyle Michael,3,0,75,72
1656211162916,COGS 11,A01,083617,Boyle; Mary E. T.,14,0,48,34
1656211168944,COGS 13,A01,083071,Bastos; Amalia Pinkusfeld,5,0,71,66
1656211174976,COGS 14A,A01,092681,Semenuks; Arturs,4,16,100,96
1656211180998,COGS 14B,A01,083073,Cheng; Tzu-Han,7,0,63,56
1656211187022,COGS 17,A01,092677,Semenuks; Arturs,7,0,81,74
1656211193045,COGS 100,A01,083619,Allen; Michael Gordon,2,0,70,68
1656211199072,COGS 101A,A01,083621,Davis; Joshua Daniel,4,0,68,64
1656211205095,COGS 101B,A01,091572,Allen; Michael Gordon,4,0,65,61
1656211211119,COGS 101C,A01,083625,Delgado; Tania,10,0,35,25
1656211217143,COGS 107A,A01,083627,Boyle; Mary E. T.,0,0,60,60
1656211223175,COGS 118A,A01,083075,Gupta; Anjum,7,0,76,69
1656211229200,CSE 3,A50,083646,Miranda; Gregory Joseph,18,0,50,32
1656211235229,CSE 8A,A50,083650,Miranda; Gregory Joseph,3,3,56,53
1656211241257,CSE 11,A01,083080,Cao; Yingjun,1,50,40,39
1656211247284,CSE 12,A01,083652,Krause-Levy; Sophia Louisa,7,3,120,113
1656211253311,CSE 15L,A01,083654,Morris; Justin Loren,2,0,50,48
1656211253311,CSE 15L,A02,083655,Morris; Justin Loren,4,0,50,46
1656211259334,CSE 20,A01,083657,Tran; Khoa Dang,30,0,80,50
1656211265363,CSE 21,A01,095574,Bach; Quang Tran,24,0,48,24
1656211271391,CSE 30,A01,083084,Eldon; John,2,8,80,78
1656211271391,CSE 30,B01,095061,Bhaskar; Nishant,1,2,50,49
1656211277417,CSE 100,A01,083659,Cao; Yingjun,2,20,70,68
1656211283444,CSE 134B,A01,083661,Powell; Thomas Allan,2,0,100,98
1656211289470,CSE 140,A01,083663,Gungor; Onat,9,0,85,76
1656211295493,CSE 140L,A01,083088,Eldon; John,8,0,100,92
1656211301518,CSE 175,A01,083665,Kumar; Rakesh,0,0,25,25
1656211307542,CSE 190,A00,092507,Dubnov; Shlomo,3,0,20,17
1656211313564,ECE 45,A01,083139,Congero; Spencer William,1,0,75,74
1656211319599,ECE 65,A50,083695,Saad; Andrew S,9,0,30,21
1656211319599,ECE 65,A51,095125,Staff,23,0,26,3
1656211325625,ECE 109,A01,091882,Touri; Behrouz,0,1,70,70
1656211331727,ECE 180,A00,083140,Abi Samra; Nicholas Camill,1,0,30,29
1656211331727,ECE 180,B00,083141,Abi Samra; Nicholas Camill,0,4,30,30
1656211337752,MATH 10A,A01,083735,Patchell; Gregory David,0,0,30,30
1656211337752,MATH 10A,A02,083736,Patchell; Gregory David,22,0,30,8
1656211337752,MATH 10A,A03,083737,Patchell; Gregory David,16,0,30,14
1656211343777,MATH 10B,A01,083207,Lim; Seonhee,0,0,34,34
1656211343777,MATH 10B,A02,083208,Lim; Seonhee,7,0,35,28
1656211343777,MATH 10B,A03,093472,Staff,1,0,34,33
1656211343777,MATH 10B,B01,083739,Sinha; Shubham,11,0,30,19
1656211349807,MATH 18,A01,083743,Cinel; Cameron Alexander,7,0,30,23
1656211349807,MATH 18,A02,083744,Cinel; Cameron Alexander,10,0,30,20
1656211349807,MATH 18,A03,083745,Cinel; Cameron Alexander,5,0,30,25
1656211349807,MATH 18,B01,083748,Rideout; David Porter,0,0,36,36
1656211349807,MATH 18,B02,083749,Rideout; David Porter,0,0,36,36
1656211349807,MATH 18,B03,083750,Rideout; David Porter,0,0,36,36
1656211349807,MATH 18,B04,083751,Rideout; David Porter,0,0,36,36
1656211349807,MATH 18,B05,093473,Rideout; David Porter,0,0,36,36
1656211349807,MATH 18,B06,093474,Rideout; David Porter,3,0,36,33
1656211355837,MATH 20A,A01,083754,Zheng; Zequn,11,0,40,29
1656211361861,MATH 20B,A01,083756,Briones; Jor-el Thomas Caparas,0,0,36,36
1656211361861,MATH 20B,A02,083757,Briones; Jor-el Thomas Caparas,0,0,36,36
1656211361861,MATH 20B,A03,093475,Staff,1,0,36,35
1656211367891,MATH 20C,A01,083760,Briones; Jor-el Thomas Caparas,0,0,35,35
1656211367891,MATH 20C,A02,083761,Briones; Jor-el Thomas Caparas,9,1,35,26
1656211367891,MATH 20C,A03,093476,Staff,0,0,35,35
1656211367891,MATH 20C,B01,083762,Bach; Quang Tran,1,0,30,29
1656211373916,MATH 20D,A01,083765,Tran; Brian Kha,1,0,30,29
1656211373916,MATH 20D,A02,083766,Tran; Brian Kha,0,1,30,30
1656211373916,MATH 20D,A03,083767,Tran; Brian Kha,2,0,30,28
1656211379941,MATH 20E,A01,083771,Ganguly; Soumya,3,0,32,29
1656211379941,MATH 20E,A02,083772,Ganguly; Soumya,0,0,32,32
1656211379941,MATH 20E,B01,083773,Ciotti; Benjamin,16,0,35,19
1656211379941,MATH 20E,B02,083774,Ciotti; Benjamin,15,0,35,20
1656211385970,MATH 103A,A01,083777,Greenfeld; Be'Eri,1,0,36,35
1656211385970,MATH 103A,A02,083778,Greenfeld; Be'Eri,1,0,36,35
1656211385970,MATH 103A,A03,093561,Staff,5,0,36,31
1656211385970,MATH 103A,B01,083779,Greenfeld; Be'Eri,9,1,36,27
1656211385970,MATH 103A,B02,083780,Greenfeld; Be'Eri,1,0,36,35
1656211385970,MATH 103A,B03,093562,Staff,0,0,36,36
1656211392003,MATH 105,A01,085443,Carter; Anne Toulson,5,1,35,30
1656211392003,MATH 105,A02,093477,Staff,13,0,35,22
1656211398025,MATH 109,A01,083213,Ganzberger; Geoffrey Michael,0,0,34,34
1656211398025,MATH 109,A02,083214,Ganzberger; Geoffrey Michael,0,0,34,34
1656211398025,MATH 109,A03,093478,Staff,1,0,34,33
1656211398025,MATH 109,B01,083215,Ganzberger; Geoffrey Michael,4,0,32,28
1656211398025,MATH 109,B02,083216,Ganzberger; Geoffrey Michael,1,0,32,31
1656211398025,MATH 109,B03,093479,Staff,4,0,32,28
1656211404056,MATH 142A,A01,083219,Chow; Bennett,2,0,32,30
1656211404056,MATH 142A,A02,083220,Chow; Bennett,8,0,32,24
1656211404056,MATH 142A,A03,093480,Staff,5,0,32,27
1656211404056,MATH 142A,B03,093481,Staff,3,0,32,29
1656211404056,MATH 142A,B04,093558,Staff,6,0,32,26
1656211404056,MATH 142A,B05,093559,Staff,1,0,32,31
1656211410084,MATH 193A,A01,083224,Rotar; Vladimir,0,1,34,34
1656211410084,MATH 193A,A02,083225,Rotar; Vladimir,0,0,34,34
1656211410084,MATH 193A,A03,083781,Rotar; Vladimir,0,0,34,34
1656211410084,MATH 193A,A04,083782,Rotar; Vladimir,6,0,34,28
1656211410084,MATH 193A,A05,093482,Rotar; Vladimir,0,0,34,34
1656211416112,MATH 197,001,091859,McAuley; Julian John,9999,0,9999,0
1656211416112,MATH 197,002,095566,Kedlaya; Kiran S.,9997,0,9999,2
1656211416112,MATH 197,003,095567,Xiao; Ming,9999,0,9999,0
1656211416112,MATH 197,004,095571,Perols; Johan Lars,9998,0,9999,1
1656211423179,COGS 9,A01,083615,Shannon; Kyle Michael,3,0,75,72
1656211429202,COGS 11,A01,083617,Boyle; Mary E. T.,14,0,48,34
1656211435225,COGS 13,A01,083071,Bastos; Amalia Pinkusfeld,5,0,71,66
1656211441252,COGS 14A,A01,092681,Semenuks; Arturs,4,16,100,96
1656211447275,COGS 14B,A01,083073,Cheng; Tzu-Han,7,0,63,56
1656211453303,COGS 17,A01,092677,Semenuks; Arturs,7,0,81,74
1656211459327,COGS 100,A01,083619,Allen; Michael Gordon,2,0,70,68
1656211465351,COGS 101A,A01,083621,Davis; Joshua Daniel,4,0,68,64
1656211471378,COGS 101B,A01,091572,Allen; Michael Gordon,4,0,65,61
1656211477407,COGS 101C,A01,083625,Delgado; Tania,10,0,35,25
1656211483430,COGS 107A,A01,083627,Boyle; Mary E. T.,0,0,60,60
1656211489455,COGS 118A,A01,083075,Gupta; Anjum,7,0,76,69
1656211495480,CSE 3,A50,083646,Miranda; Gregory Joseph,18,0,50,32
1656211501503,CSE 8A,A50,083650,Miranda; Gregory Joseph,3,3,56,53
1656211507527,CSE 11,A01,083080,Cao; Yingjun,1,50,40,39
1656211513550,CSE 12,A01,083652,Krause-Levy; Sophia Louisa,7,3,120,113
1656211519576,CSE 15L,A01,083654,Morris; Justin Loren,2,0,50,48
1656211519576,CSE 15L,A02,083655,Morris; Justin Loren,4,0,50,46
1656211525599,CSE 20,A01,083657,Tran; Khoa Dang,30,0,80,50
1656211531626,CSE 21,A01,095574,Bach; Quang Tran,24,0,48,24
1656211537651,CSE 30,A01,083084,Eldon; John,2,8,80,78
1656211537651,CSE 30,B01,095061,Bhaskar; Nishant,1,2,50,49
1656211543679,CSE 100,A01,083659,Cao; Yingjun,2,20,70,68
1656211549709,CSE 134B,A01,083661,Powell; Thomas Allan,2,0,100,98
1656211555735,CSE 140,A01,083663,Gungor; Onat,9,0,85,76
1656211561761,CSE 140L,A01,083088,Eldon; John,8,0,100,92
1656211567788,CSE 175,A01,083665,Kumar; Rakesh,0,0,25,25
1656211573811,CSE 190,A00,092507,Dubnov; Shlomo,3,0,20,17
1656211579851,ECE 45,A01,083139,Congero; Spencer William,1,0,75,74
1656211585878,ECE 65,A50,083695,Saad; Andrew S,9,0,30,21
1656211585878,ECE 65,A51,095125,Staff,23,0,26,3
1656211591905,ECE 109,A01,091882,Touri; Behrouz,0,1,70,70
1656211597928,ECE 180,A00,083140,Abi Samra; Nicholas Camill,1,0,30,29
1656211597928,ECE 180,B00,083141,Abi Samra; Nicholas Camill,0,4,30,30
1656211603951,MATH 10A,A01,083735,Patchell; Gregory David,0,0,30,30
1656211603951,MATH 10A,A02,083736,Patchell; Gregory David,22,0,30,8
1656211603951,MATH 10A,A03,083737,Patchell; Gregory David,16,0,30,14
1656211609975,MATH 10B,A01,083207,Lim; Seonhee,0,0,34,34
1656211609975,MATH 10B,A02,083208,Lim; Seonhee,7,0,35,28
1656211609975,MATH 10B,A03,093472,Staff,1,0,34,33
1656211609975,MATH 10B,B01,083739,Sinha; Shubham,11,0,30,19
1656211616006,MATH 18,A01,083743,Cinel; Cameron Alexander,7,0,30,23
1656211616006,MATH 18,A02,083744,Cinel; Cameron Alexander,10,0,30,20
1656211616006,MATH 18,A03,083745,Cinel; Cameron Alexander,5,0,30,25
1656211616006,MATH 18,B01,083748,Rideout; David Porter,0,0,36,36
1656211616006,MATH 18,B02,083749,Rideout; David Porter,0,0,36,36
1656211616006,MATH 18,B03,083750,Rideout; David Porter,0,0,36,36
1656211616006,MATH 18,B04,083751,Rideout; David Porter,0,0,36,36
1656211616006,MATH 18,B05,093473,Rideout; David Porter,0,0,36,36
1656211616006,MATH 18,B06,093474,Rideout; David Porter,3,0,36,33
1656211622036,MATH 20A,A01,083754,Zheng; Zequn,11,0,40,29
1656211628064,MATH 20B,A01,083756,Briones; Jor-el Thomas Caparas,0,0,36,36
1656211628064,MATH 20B,A02,083757,Briones; Jor-el Thomas Caparas,0,0,36,36
1656211628064,MATH 20B,A03,093475,Staff,1,0,36,35
1656211634087,MATH 20C,A01,083760,Briones; Jor-el Thomas Caparas,0,0,35,35
1656211634087,MATH 20C,A02,083761,Briones; Jor-el Thomas Caparas,9,1,35,26
1656211634087,MATH 20C,A03,093476,Staff,0,0,35,35
1656211634087,MATH 20C,B01,083762,Bach; Quang Tran,1,0,30,29
1656211640111,MATH 20D,A01,083765,Tran; Brian Kha,1,0,30,29
1656211640111,MATH 20D,A02,083766,Tran; Brian Kha,0,1,30,30
1656211640111,MATH 20D,A03,083767,Tran; Brian Kha,2,0,30,28
1656211646135,MATH 20E,A01,083771,Ganguly; Soumya,3,0,32,29
1656211646135,MATH 20E,A02,083772,Ganguly; Soumya,0,0,32,32
1656211646135,MATH 20E,B01,083773,Ciotti; Benjamin,16,0,35,19
1656211646135,MATH 20E,B02,083774,Ciotti; Benjamin,15,0,35,20
1656211652165,MATH 103A,A01,083777,Greenfeld; Be'Eri,1,0,36,35
1656211652165,MATH 103A,A02,083778,Greenfeld; Be'Eri,1,0,36,35
1656211652165,MATH 103A,A03,093561,Staff,5,0,36,31
1656211652165,MATH 103A,B01,083779,Greenfeld; Be'Eri,9,1,36,27
1656211652165,MATH 103A,B02,083780,Greenfeld; Be'Eri,1,0,36,35
1656211652165,MATH 103A,B03,093562,Staff,0,0,36,36
1656211658189,MATH 105,A01,085443,Carter; Anne Toulson,5,1,35,30
1656211658189,MATH 105,A02,093477,Staff,13,0,35,22
1656211664212,MATH 109,A01,083213,Ganzberger; Geoffrey Michael,0,0,34,34
1656211664212,MATH 109,A02,083214,Ganzberger; Geoffrey Michael,0,0,34,34
1656211664212,MATH 109,A03,093478,Staff,1,0,34,33
1656211664212,MATH 109,B01,083215,Ganzberger; Geoffrey Michael,4,0,32,28
1656211664212,MATH 109,B02,083216,Ganzberger; Geoffrey Michael,1,0,32,31
1656211664212,MATH 109,B03,093479,Staff,4,0,32,28
1656211670236,MATH 142A,A01,083219,Chow; Bennett,2,0,32,30
1656211670236,MATH 142A,A02,083220,Chow; Bennett,8,0,32,24
1656211670236,MATH 142A,A03,093480,Staff,5,0,32,27
1656211670236,MATH 142A,B03,093481,Staff,3,0,32,29
1656211670236,MATH 142A,B04,093558,Staff,6,0,32,26
1656211670236,MATH 142A,B05,093559,Staff,1,0,32,31
1656211676263,MATH 193A,A01,083224,Rotar; Vladimir,0,1,34,34
1656211676263,MATH 193A,A02,083225,Rotar; Vladimir,0,0,34,34
1656211676263,MATH 193A,A03,083781,Rotar; Vladimir,0,0,34,34
1656211676263,MATH 193A,A04,083782,Rotar; Vladimir,6,0,34,28
1656211676263,MATH 193A,A05,093482,Rotar; Vladimir,0,0,34,34
1656211682287,MATH 197,001,091859,McAuley; Julian John,9999,0,9999,0
1656211682287,MATH 197,002,095566,Kedlaya; Kiran S.,9997,0,9999,2
1656211682287,MATH 197,003,095567,Xiao; Ming,9999,0,9999,0
1656211682287,MATH 197,004,095571,Perols; Johan Lars,9998,0,9999,1
1656211689339,COGS 9,A01,083615,Shannon; Kyle Michael,3,0,75,72
1656211695362,COGS 11,A01,083617,Boyle; Mary E. T.,14,0,48,34
1656211701390,COGS 13,A01,083071,Bastos; Amalia Pinkusfeld,5,0,71,66
1656211707418,COGS 14A,A01,092681,Semenuks; Arturs,4,16,100,96
1656211713442,COGS 14B,A01,083073,Cheng; Tzu-Han,7,0,63,56
1656211719469,COGS 17,A01,092677,Semenuks; Arturs,7,0,81,74
1656211725495,COGS 100,A01,083619,Allen; Michael Gordon,2,0,70,68
1656211731518,COGS 101A,A01,083621,Davis; Joshua Daniel,4,0,68,64
1656211737542,COGS 101B,A01,091572,Allen; Michael Gordon,4,0,65,61
1656211743564,COGS 101C,A01,083625,Delgado; Tania,10,0,35,25
1656211749590,COGS 107A,A01,083627,Boyle; Mary E. T.,0,0,60,60
1656211755614,COGS 118A,A01,083075,Gupta; Anjum,7,0,76,69
1656211761636,CSE 3,A50,083646,Miranda; Gregory Joseph,18,0,50,32
1656211767659,CSE 8A,A50,083650,Miranda; Gregory Joseph,3,3,56,53
1656211773691,CSE 11,A01,083080,Cao; Yingjun,1,50,40,39
1656211779714,CSE 12,A01,083652,Krause-Levy; Sophia Louisa,7,3,120,113
1656211785740,CSE 15L,A01,083654,Morris; Justin Loren,2,0,50,48
1656211785740,CSE 15L,A02,083655,Morris; Justin Loren,4,0,50,46
1656211791764,CSE 20,A01,083657,Tran; Khoa Dang,30,0,80,50
1656211797788,CSE 21,A01,095574,Bach; Quang Tran,24,0,48,24
1656211803811,CSE 30,A01,083084,Eldon; John,2,8,80,78
1656211803811,CSE 30,B01,095061,Bhaskar; Nishant,1,2,50,49
1656211809846,CSE 100,A01,083659,Cao; Yingjun,2,20,70,68
1656211815870,CSE 134B,A01,083661,Powell; Thomas Allan,2,0,100,98
1656211821893,CSE 140,A01,083663,Gungor; Onat,9,0,85,76
1656211827919,CSE 140L,A01,083088,Eldon; John,8,0,100,92
1656211833952,CSE 175,A01,083665,Kumar; Rakesh,0,0,25,25
1656211839975,CSE 190,A00,092507,Dubnov; Shlomo,3,0,20,17
1656211845998,ECE 45,A01,083139,Congero; Spencer William,1,0,75,74
1656211852023,ECE 65,A50,083695,Saad; Andrew S,9,0,30,21
1656211852023,ECE 65,A51,095125,Staff,23,0,26,3
1656211858046,ECE 109,A01,091882,Touri; Behrouz,0,1,70,70
1656211864069,ECE 180,A00,083140,Abi Samra; Nicholas Camill,1,0,30,29
1656211864069,ECE 180,B00,083141,Abi Samra; Nicholas Camill,0,4,30,30
1656211870092,MATH 10A,A01,083735,Patchell; Gregory David,0,0,30,30
1656211870092,MATH 10A,A02,083736,Patchell; Gregory David,22,0,30,8
1656211870092,MATH 10A,A03,083737,Patchell; Gregory David,16,0,30,14
1656211876116,MATH 10B,A01,083207,Lim; Seonhee,0,0,34,34
1656211876116,MATH 10B,A02,083208,Lim; Seonhee,7,0,35,28
1656211876116,MATH 10B,A03,093472,Staff,1,0,34,33
1656211876116,MATH 10B,B01,083739,Sinha; Shubham,11,0,30,19
1656211882147,MATH 18,A01,083743,Cinel; Cameron Alexander,7,0,30,23
1656211882147,MATH 18,A02,083744,Cinel; Cameron Alexander,10,0,30,20
1656211882147,MATH 18,A03,083745,Cinel; Cameron Alexander,5,0,30,25
1656211882147,MATH 18,B01,083748,Rideout; David Porter,0,0,36,36
1656211882147,MATH 18,B02,083749,Rideout; David Porter,0,0,36,36
1656211882147,MATH 18,B03,083750,Rideout; David Porter,0,0,36,36
1656211882147,MATH 18,B04,083751,Rideout; David Porter,0,0,36,36
1656211882147,MATH 18,B05,093473,Rideout; David Porter,0,0,36,36
1656211882147,MATH 18,B06,093474,Rideout; David Porter,3,0,36,33
1656211888175,MATH 20A,A01,083754,Zheng; Zequn,11,0,40,29
1656211894198,MATH 20B,A01,083756,Briones; Jor-el Thomas Caparas,0,0,36,36
1656211894198,MATH 20B,A02,083757,Briones; Jor-el Thomas Caparas,0,0,36,36
1656211894198,MATH 20B,A03,093475,Staff,1,0,36,35
1656211900226,MATH 20C,A01,083760,Briones; Jor-el Thomas Caparas,0,0,35,35
1656211900226,MATH 20C,A02,083761,Briones; Jor-el Thomas Caparas,9,1,35,26
1656211900226,MATH 20C,A03,093476,Staff,0,0,35,35
1656211900226,MATH 20C,B01,083762,Bach; Quang Tran,1,0,30,29
1656211906250,MATH 20D,A01,083765,Tran; Brian Kha,1,0,30,29
1656211906250,MATH 20D,A02,083766,Tran; Brian Kha,0,1,30,30
1656211906250,MATH 20D,A03,083767,Tran; Brian Kha,2,0,30,28
1656211912275,MATH 20E,A01,083771,Ganguly; Soumya,3,0,32,29
1656211912275,MATH 20E,A02,083772,Ganguly; Soumya,0,0,32,32
1656211912275,MATH 20E,B01,083773,Ciotti; Benjamin,16,0,35,19
1656211912275,MATH 20E,B02,083774,Ciotti; Benjamin,15,0,35,20
1656211918298,MATH 103A,A01,083777,Greenfeld; Be'Eri,1,0,36,35
1656211918298,MATH 103A,A02,083778,Greenfeld; Be'Eri,1,0,36,35
1656211918298,MATH 103A,A03,093561,Staff,5,0,36,31
1656211918298,MATH 103A,B01,083779,Greenfeld; Be'Eri,9,1,36,27
1656211918298,MATH 103A,B02,083780,Greenfeld; Be'Eri,1,0,36,35
1656211918298,MATH 103A,B03,093562,Staff,0,0,36,36
1656211924326,MATH 105,A01,085443,Carter; Anne Toulson,5,1,35,30
1656211924326,MATH 105,A02,093477,Staff,13,0,35,22
1656211930423,MATH 109,A01,083213,Ganzberger; Geoffrey Michael,0,0,34,34
1656211930423,MATH 109,A02,083214,Ganzberger; Geoffrey Michael,0,0,34,34
1656211930423,MATH 109,A03,093478,Staff,1,0,34,33
1656211930423,MATH 109,B01,083215,Ganzberger; Geoffrey Michael,4,0,32,28
1656211930423,MATH 109,B02,083216,Ganzberger; Geoffrey Michael,1,0,32,31
1656211930423,MATH 109,B03,093479,Staff,4,0,32,28
1656211936447,MATH 142A,A01,083219,Chow; Bennett,2,0,32,30
1656211936447,MATH 142A,A02,083220,Chow; Bennett,8,0,32,24
1656211936447,MATH 142A,A03,093480,Staff,5,0,32,27
1656211936447,MATH 142A,B03,093481,Staff,3,0,32,29
1656211936447,MATH 142A,B04,093558,Staff,6,0,32,26
1656211936447,MATH 142A,B05,093559,Staff,1,0,32,31
1656211942471,MATH 193A,A01,083224,Rotar; Vladimir,0,1,34,34
1656211942471,MATH 193A,A02,083225,Rotar; Vladimir,0,0,34,34
1656211942471,MATH 193A,A03,083781,Rotar; Vladimir,0,0,34,34
1656211942471,MATH 193A,A04,083782,Rotar; Vladimir,6,0,34,28
1656211942471,MATH 193A,A05,093482,Rotar; Vladimir,0,0,34,34
1656211948492,MATH 197,001,091859,McAuley; Julian John,9999,0,9999,0
1656211948492,MATH 197,002,095566,Kedlaya; Kiran S.,9997,0,9999,2
1656211948492,MATH 197,003,095567,Xiao; Ming,9999,0,9999,0
1656211948492,MATH 197,004,095571,Perols; Johan Lars,9998,0,9999,1
1656211955558,COGS 9,A01,083615,Shannon; Kyle Michael,3,0,75,72
1656211961584,COGS 11,A01,083617,Boyle; Mary E. T.,14,0,48,34
1656211967612,COGS 13,A01,083071,Bastos; Amalia Pinkusfeld,5,0,71,66
1656211973635,COGS 14A,A01,092681,Semenuks; Arturs,4,16,100,96
1656211979658,COGS 14B,A01,083073,Cheng; Tzu-Han,7,0,63,56
1656211985690,COGS 17,A01,092677,Semenuks; Arturs,7,0,81,74
1656211991718,COGS 100,A01,083619,Allen; Michael Gordon,2,0,70,68
1656211997745,COGS 101A,A01,083621,Davis; Joshua Daniel,4,0,68,64
1656212003771,COGS 101B,A01,091572,Allen; Michael Gordon,4,0,65,61
1656212009796,COGS 101C,A01,083625,Delgado; Tania,10,0,35,25
1656212015824,COGS 107A,A01,083627,Boyle; Mary E. T.,0,0,60,60
1656212021846,COGS 118A,A01,083075,Gupta; Anjum,7,0,76,69
1656212027870,CSE 3,A50,083646,Miranda; Gregory Joseph,18,0,50,32
1656212033903,CSE 8A,A50,083650,Miranda; Gregory Joseph,3,3,56,53
1656212039930,CSE 11,A01,083080,Cao; Yingjun,1,50,40,39
1656212045956,CSE 12,A01,083652,Krause-Levy; Sophia Louisa,7,3,120,113
1656212051980,CSE 15L,A01,083654,Morris; Justin Loren,2,0,50,48
1656212051980,CSE 15L,A02,083655,Morris; Justin Loren,4,0,50,46
1656212058004,CSE 20,A01,083657,Tran; Khoa Dang,30,0,80,50
1656212064028,CSE 21,A01,095574,Bach; Quang Tran,24,0,48,24
1656212070050,CSE 30,A01,083084,Eldon; John,2,8,80,78
1656212070050,CSE 30,B01,095061,Bhaskar; Nishant,1,2,50,49
1656212076074,CSE 100,A01,083659,Cao; Yingjun,2,20,70,68
1656212082098,CSE 134B,A01,083661,Powell; Thomas Allan,2,0,100,98
1656212088125,CSE 140,A01,083663,Gungor; Onat,9,0,85,76
1656212094154,CSE 140L,A01,083088,Eldon; John,8,0,100,92
1656212100180,CSE 175,A01,083665,Kumar; Rakesh,0,0,25,25
1656212106202,CSE 190,A00,092507,Dubnov; Shlomo,3,0,20,17
1656212112227,ECE 45,A01,083139,Congero; Spencer William,1,0,75,74
1656212118254,ECE 65,A50,083695,Saad; Andrew S,9,0,30,21
1656212118254,ECE 65,A51,095125,Staff,23,0,26,3
1656212124277,ECE 109,A01,091882,Touri; Behrouz,0,1,70,70
1656212130304,ECE 180,A00,083140,Abi Samra; Nicholas Camill,1,0,30,29
1656212130304,ECE 180,B00,083141,Abi Samra; Nicholas Camill,0,4,30,30
1656212136331,MATH 10A,A01,083735,Patchell; Gregory David,0,0,30,30
1656212136331,MATH 10A,A02,083736,Patchell; Gregory David,22,0,30,8
1656212136331,MATH 10A,A03,083737,Patchell; Gregory David,16,0,30,14
1656212142356,MATH 10B,A01,083207,Lim; Seonhee,0,0,34,34
1656212142356,MATH 10B,A02,083208,Lim; Seonhee,7,0,35,28
1656212142356,MATH 10B,A03,093472,Staff,1,0,34,33
1656212142356,MATH 10B,B01,083739,Sinha; Shubham,11,0,30,19
1656212148404,MATH 18,A01,083743,Cinel; Cameron Alexander,7,0,30,23
1656212148404,MATH 18,A02,083744,Cinel; Cameron Alexander,10,0,30,20
1656212148404,MATH 18,A03,083745,Cinel; Cameron Alexander,5,0,30,25
1656212148404,MATH 18,B01,083748,Rideout; David Porter,0,0,36,36
1656212148404,MATH 18,B02,083749,Rideout; David Porter,0,0,36,36
1656212148404,MATH 18,B03,083750,Rideout; David Porter,0,0,36,36
1656212148404,MATH 18,B04,083751,Rideout; David Porter,0,0,36,36
1656212148404,MATH 18,B05,093473,Rideout; David Porter,0,0,36,36
1656212148404,MATH 18,B06,093474,Rideout; David Porter,3,0,36,33
1656212154430,MATH 20A,A01,083754,Zheng; Zequn,11,0,40,29
1656212160456,MATH 20B,A01,083756,Briones; Jor-el Thomas Caparas,0,0,36,36
1656212160456,MATH 20B,A02,083757,Briones; Jor-el Thomas Caparas,0,0,36,36
1656212160456,MATH 20B,A03,093475,Staff,1,0,36,35
1656212166480,MATH 20C,A01,083760,Briones; Jor-el Thomas Caparas,0,0,35,35
1656212166480,MATH 20C,A02,083761,Briones; Jor-el Thomas Caparas,9,1,35,26
1656212166480,MATH 20C,A03,093476,Staff,0,0,35,35
1656212166480,MATH 20C,B01,083762,Bach; Quang Tran,1,0,30,29
1656212172509,MATH 20D,A01,083765,Tran; Brian Kha,1,0,30,29
1656212172509,MATH 20D,A02,083766,Tran; Brian Kha,0,1,30,30
1656212172509,MATH 20D,A03,083767,Tran; Brian Kha,2,0,30,28
1656212178534,MATH 20E,A01,083771,Ganguly; Soumya,3,0,32,29
1656212178534,MATH 20E,A02,083772,Ganguly; Soumya,0,0,32,32
1656212178534,MATH 20E,B01,083773,Ciotti; Benjamin,16,0,35,19
1656212178534,MATH 20E,B02,083774,Ciotti; Benjamin,15,0,35,20
1656212184558,MATH 103A,A01,083777,Greenfeld; Be'Eri,1,0,36,35
1656212184558,MATH 103A,A02,083778,Greenfeld; Be'Eri,1,0,36,35
1656212184558,MATH 103A,A03,093561,Staff,5,0,36,31
1656212184558,MATH 103A,B01,083779,Greenfeld; Be'Eri,9,1,36,27
1656212184558,MATH 103A,B02,083780,Greenfeld; Be'Eri,1,0,36,35
1656212184558,MATH 103A,B03,093562,Staff,0,0,36,36
1656212190581,MATH 105,A01,085443,Carter; Anne Toulson,5,1,35,30
1656212190581,MATH 105,A02,093477,Staff,13,0,35,22
1656212196608,MATH 109,A01,083213,Ganzberger; Geoffrey Michael,0,0,34,34
1656212196608,MATH 109,A02,083214,Ganzberger; Geoffrey Michael,0,0,34,34
1656212196608,MATH 109,A03,093478,Staff,1,0,34,33
1656212196608,MATH 109,B01,083215,Ganzberger; Geoffrey Michael,4,0,32,28
1656212196608,MATH 109,B02,083216,Ganzberger; Geoffrey Michael,1,0,32,31
1656212196608,MATH 109,B03,093479,Staff,4,0,32,28
1656212202637,MATH 142A,A01,083219,Chow; Bennett,2,0,32,30
1656212202637,MATH 142A,A02,083220,Chow; Bennett,8,0,32,24
1656212202637,MATH 142A,A03,093480,Staff,5,0,32,27
1656212202637,MATH 142A,B03,093481,Staff,3,0,32,29
1656212202637,MATH 142A,B04,093558,Staff,6,0,32,26
1656212202637,MATH 142A,B05,093559,Staff,1,0,32,31
1656212208667,MATH 193A,A01,083224,Rotar; Vladimir,0,1,34,34
1656212208667,MATH 193A,A02,083225,Rotar; Vladimir,0,0,34,34
1656212208667,MATH 193A,A03,083781,Rotar; Vladimir,0,0,34,34
1656212208667,MATH 193A,A04,083782,Rotar; Vladimir,6,0,34,28
1656212208667,MATH 193A,A05,093482,Rotar; Vladimir,0,0,34,34
1656212214706,MATH 197,001,091859,McAuley; Julian John,9999,0,9999,0
1656212214706,MATH 197,002,095566,Kedlaya; Kiran S.,9997,0,9999,2
1656212214706,MATH 197,003,095567,Xiao; Ming,9999,0,9999,0
1656212214706,MATH 197,004,095571,Perols; Johan Lars,9998,0,9999,1
1656212221768,COGS 9,A01,083615,Shannon; Kyle Michael,3,0,75,72
1656212227791,COGS 11,A01,083617,Boyle; Mary E. T.,14,0,48,34
1656212233814,COGS 13,A01,083071,Bastos; Amalia Pinkusfeld,5,0,71,66
1656212239837,COGS 14A,A01,092681,Semenuks; Arturs,4,16,100,96
1656212245871,COGS 14B,A01,083073,Cheng; Tzu-Han,7,0,63,56
1656212251896,COGS 17,A01,092677,Semenuks; Arturs,7,0,81,74
1656212257922,COGS 100,A01,083619,Allen; Michael Gordon,2,0,70,68
1656212263947,COGS 101A,A01,083621,Davis; Joshua Daniel,4,0,68,64
1656212269970,COGS 101B,A01,091572,Allen; Michael Gordon,4,0,65,61
1656212276003,COGS 101C,A01,083625,Delgado; Tania,10,0,35,25
1656212282026,COGS 107A,A01,083627,Boyle; Mary E. T.,0,0,60,60
1656212288052,COGS 118A,A01,083075,Gupta; Anjum,7,0,76,69
1656212294080,CSE 3,A50,083646,Miranda; Gregory Joseph,18,0,50,32
1656212300105,CSE 8A,A50,083650,Miranda; Gregory Joseph,3,3,56,53
1656212306137,CSE 11,A01,083080,Cao; Yingjun,1,50,40,39
1656212312160,CSE 12,A01,083652,Krause-Levy; Sophia Louisa,7,3,120,113
1656212318184,CSE 15L,A01,083654,Morris; Justin Loren,2,0,50,48
1656212318184,CSE 15L,A02,083655,Morris; Justin Loren,4,0,50,46
1656212324207,CSE 20,A01,083657,Tran; Khoa Dang,30,0,80,50
1656212330235,CSE 21,A01,095574,Bach; Quang Tran,24,0,48,24
1656212336260,CSE 30,A01,083084,Eldon; John,2,8,80,78
1656212336260,CSE 30,B01,095061,Bhaskar; Nishant,1,2,50,49
1656212342289,CSE 100,A01,083659,Cao; Yingjun,2,20,70,68
1656212348312,CSE 134B,A01,083661,Powell; Thomas Allan,2,0,100,98
1656212354338,CSE 140,A01,083663,Gungor; Onat,9,0,85,76
1656212360369,CSE 140L,A01,083088,Eldon; John,8,0,100,92
1656212366402,CSE 175,A01,083665,Kumar; Rakesh,0,0,25,25
1656212372425,CSE 190,A00,092507,Dubnov; Shlomo,3,0,20,17
1656212378449,ECE 45,A01,083139,Congero; Spencer William,1,0,75,74
1656212384473,ECE 65,A50,083695,Saad; Andrew S,9,0,30,21
1656212384473,ECE 65,A51,095125,Staff,23,0,26,3
1656212390499,ECE 109,A01,091882,Touri; Behrouz,0,1,70,70
1656212396526,ECE 180,A00,083140,Abi Samra; Nicholas Camill,1,0,30,29
1656212396526,ECE 180,B00,083141,Abi Samra; Nicholas Camill,0,4,30,30
1656212402555,MATH 10A,A01,083735,Patchell; Gregory David,0,0,30,30
1656212402555,MATH 10A,A02,083736,Patchell; Gregory David,22,0,30,8
1656212402555,MATH 10A,A03,083737,Patchell; Gregory David,16,0,30,14
1656212408581,MATH 10B,A01,083207,Lim; Seonhee,0,0,34,34
1656212408581,MATH 10B,A02,083208,Lim; Seonhee,7,0,35,28
1656212408581,MATH 10B,A03,093472,Staff,1,0,34,33
1656212408581,MATH 10B,B01,083739,Sinha; Shubham,11,0,30,19
1656212414616,MATH 18,A01,083743,Cinel; Cameron Alexander,7,0,30,23
1656212414616,MATH 18,A02,083744,Cinel; Cameron Alexander,10,0,30,20
1656212414616,MATH 18,A03,083745,Cinel; Cameron Alexander,5,0,30,25
1656212414616,MATH 18,B01,083748,Rideout; David Porter,0,0,36,36
1656212414616,MATH 18,B02,083749,Rideout; David Porter,0,0,36,36
1656212414616,MATH 18,B03,083750,Rideout; David Porter,0,0,36,36
1656212414616,MATH 18,B04,083751,Rideout; David Porter,0,0,36,36
1656212414616,MATH 18,B05,093473,Rideout; David Porter,0,0,36,36
1656212414616,MATH 18,B06,093474,Rideout; David Porter,3,0,36,33
1656212420644,MATH 20A,A01,083754,Zheng; Zequn,11,0,40,29
1656212426669,MATH 20B,A01,083756,Briones; Jor-el Thomas Caparas,0,0,36,36
1656212426669,MATH 20B,A02,083757,Briones; Jor-el Thomas Caparas,0,0,36,36
1656212426669,MATH 20B,A03,093475,Staff,1,0,36,35
1656212432697,MATH 20C,A01,083760,Briones; Jor-el Thomas Caparas,0,0,35,35
1656212432697,MATH 20C,A02,083761,Briones; Jor-el Thomas Caparas,9,1,35,26
1656212432697,MATH 20C,A03,093476,Staff,0,0,35,35
1656212432697,MATH 20C,B01,083762,Bach; Quang Tran,1,0,30,29
1656212438722,MATH 20D,A01,083765,Tran; Brian Kha,1,0,30,29
1656212438722,MATH 20D,A02,083766,Tran; Brian Kha,0,1,30,30
1656212438722,MATH 20D,A03,083767,Tran; Brian Kha,2,0,30,28
1656212444751,MATH 20E,A01,083771,Ganguly; Soumya,3,0,32,29
1656212444751,MATH 20E,A02,083772,Ganguly; Soumya,0,0,32,32
1656212444751,MATH 20E,B01,083773,Ciotti; Benjamin,16,0,35,19
1656212444751,MATH 20E,B02,083774,Ciotti; Benjamin,15,0,35,20
1656212450775,MATH 103A,A01,083777,Greenfeld; Be'Eri,1,0,36,35
1656212450775,MATH 103A,A02,083778,Greenfeld; Be'Eri,1,0,36,35
1656212450775,MATH 103A,A03,093561,Staff,5,0,36,31
1656212450775,MATH 103A,B01,083779,Greenfeld; Be'Eri,9,1,36,27
1656212450775,MATH 103A,B02,083780,Greenfeld; Be'Eri,1,0,36,35
1656212450775,MATH 103A,B03,093562,Staff,0,0,36,36
1656212456802,MATH 105,A01,085443,Carter; Anne Toulson,5,1,35,30
1656212456802,MATH 105,A02,093477,Staff,13,0,35,22
1656212462840,MATH 109,A01,083213,Ganzberger; Geoffrey Michael,0,0,34,34
1656212462840,MATH 109,A02,083214,Ganzberger; Geoffrey Michael,0,0,34,34
1656212462840,MATH 109,A03,093478,Staff,1,0,34,33
1656212462840,MATH 109,B01,083215,Ganzberger; Geoffrey Michael,4,0,32,28
1656212462840,MATH 109,B02,083216,Ganzberger; Geoffrey Michael,1,0,32,31
1656212462840,MATH 109,B03,093479,Staff,4,0,32,28
1656212468864,MATH 142A,A01,083219,Chow; Bennett,2,0,32,30
1656212468864,MATH 142A,A02,083220,Chow; Bennett,8,0,32,24
1656212468864,MATH 142A,A03,093480,Staff,5,0,32,27
1656212468864,MATH 142A,B03,093481,Staff,3,0,32,29
1656212468864,MATH 142A,B04,093558,Staff,6,0,32,26
1656212468864,MATH 142A,B05,093559,Staff,1,0,32,31
1656212474888,MATH 193A,A01,083224,Rotar; Vladimir,0,1,34,34
1656212474888,MATH 193A,A02,083225,Rotar; Vladimir,0,0,34,34
1656212474888,MATH 193A,A03,083781,Rotar; Vladimir,0,0,34,34
1656212474888,MATH 193A,A04,083782,Rotar; Vladimir,6,0,34,28
1656212474888,MATH 193A,A05,093482,Rotar; Vladimir,0,0,34,34
1656212480914,MATH 197,001,091859,McAuley; Julian John,9999,0,9999,0
1656212480914,MATH 197,002,095566,Kedlaya; Kiran S.,9997,0,9999,2
1656212480914,MATH 197,003,095567,Xiao; Ming,9999,0,9999,0
1656212480914,MATH 197,004,095571,Perols; Johan Lars,9998,0,9999,1
1656212487972,COGS 9,A01,083615,Shannon; Kyle Michael,3,0,75,72
1656212493999,COGS 11,A01,083617,Boyle; Mary E. T.,14,0,48,34
1656212500022,COGS 13,A01,083071,Bastos; Amalia Pinkusfeld,5,0,71,66
1656212506049,COGS 14A,A01,092681,Semenuks; Arturs,4,16,100,96
1656212512075,COGS 14B,A01,083073,Cheng; Tzu-Han,7,0,63,56
1656212518098,COGS 17,A01,092677,Semenuks; Arturs,7,0,81,74
1656212524191,COGS 100,A01,083619,Allen; Michael Gordon,2,0,70,68
1656212530218,COGS 101A,A01,083621,Davis; Joshua Daniel,4,0,68,64
1656212536242,COGS 101B,A01,091572,Allen; Michael Gordon,4,0,65,61
1656212542269,COGS 101C,A01,083625,Delgado; Tania,10,0,35,25
1656212548291,COGS 107A,A01,083627,Boyle; Mary E. T.,0,0,60,60
1656212554323,COGS 118A,A01,083075,Gupta; Anjum,7,0,76,69
1656212560350,CSE 3,A50,083646,Miranda; Gregory Joseph,18,0,50,32
1656212566377,CSE 8A,A50,083650,Miranda; Gregory Joseph,3,3,56,53
1656212572415,CSE 11,A01,083080,Cao; Yingjun,1,50,40,39
1656212578438,CSE 12,A01,083652,Krause-Levy; Sophia Louisa,7,3,120,113
1656212584459,CSE 15L,A01,083654,Morris; Justin Loren,2,0,50,48
1656212584459,CSE 15L,A02,083655,Morris; Justin Loren,4,0,50,46
1656212590487,CSE 20,A01,083657,Tran; Khoa Dang,30,0,80,50
1656212596528,CSE 21,A01,095574,Bach; Quang Tran,24,0,48,24
1656212602552,CSE 30,A01,083084,Eldon; John,2,8,80,78
1656212602552,CSE 30,B01,095061,Bhaskar; Nishant,1,2,50,49
1656212608577,CSE 100,A01,083659,Cao; Yingjun,2,20,70,68
1656212614603,CSE 134B,A01,083661,Powell; Thomas Allan,2,0,100,98
1656212620630,CSE 140,A01,083663,Gungor; Onat,9,0,85,76
1656212626660,CSE 140L,A01,083088,Eldon; John,8,0,100,92
1656212632686,CSE 175,A01,083665,Kumar; Rakesh,0,0,25,25
1656212638715,CSE 190,A00,092507,Dubnov; Shlomo,3,0,20,17
1656212644739,ECE 45,A01,083139,Congero; Spencer William,1,0,75,74
1656212650763,ECE 65,A50,083695,Saad; Andrew S,9,0,30,21
1656212650763,ECE 65,A51,095125,Staff,23,0,26,3
1656212656786,ECE 109,A01,091882,Touri; Behrouz,0,1,70,70
1656212662844,ECE 180,A00,083140,Abi Samra; Nicholas Camill,1,0,30,29
1656212662844,ECE 180,B00,083141,Abi Samra; Nicholas Camill,0,4,30,30
1656212668869,MATH 10A,A01,083735,Patchell; Gregory David,0,0,30,30
1656212668869,MATH 10A,A02,083736,Patchell; Gregory David,22,0,30,8
1656212668869,MATH 10A,A03,083737,Patchell; Gregory David,16,0,30,14
1656212674907,MATH 10B,A01,083207,Lim; Seonhee,0,0,34,34
1656212674907,MATH 10B,A02,083208,Lim; Seonhee,7,0,35,28
1656212674907,MATH 10B,A03,093472,Staff,1,0,34,33
1656212674907,MATH 10B,B01,083739,Sinha; Shubham,11,0,30,19
1656212680932,MATH 18,A01,083743,Cinel; Cameron Alexander,7,0,30,23
1656212680932,MATH 18,A02,083744,Cinel; Cameron Alexander,10,0,30,20
1656212680932,MATH 18,A03,083745,Cinel; Cameron Alexander,5,0,30,25
1656212680932,MATH 18,B01,083748,Rideout; David Porter,0,0,36,36
1656212680932,MATH 18,B02,083749,Rideout; David Porter,0,0,36,36
1656212680932,MATH 18,B03,083750,Rideout; David Porter,0,0,36,36
1656212680932,MATH 18,B04,083751,Rideout; David Porter,0,1,36,36
1656212680932,MATH 18,B05,093473,Rideout; David Porter,0,0,36,36
1656212680932,MATH 18,B06,093474,Rideout; David Porter,3,0,36,33
1656212686964,MATH 20A,A01,083754,Zheng; Zequn,11,0,40,29
1656212692988,MATH 20B,A01,083756,Briones; Jor-el Thomas Caparas,0,0,36,36
1656212692988,MATH 20B,A02,083757,Briones; Jor-el Thomas Caparas,0,0,36,36
1656212692988,MATH 20B,A03,093475,Staff,1,0,36,35
1656212699012,MATH 20C,A01,083760,Briones; Jor-el Thomas Caparas,0,0,35,35
1656212699012,MATH 20C,A02,083761,Briones; Jor-el Thomas Caparas,9,1,35,26
1656212699012,MATH 20C,A03,093476,Staff,0,0,35,35
1656212699012,MATH 20C,B01,083762,Bach; Quang Tran,1,0,30,29
1656212705047,MATH 20D,A01,083765,Tran; Brian Kha,1,0,30,29
1656212705047,MATH 20D,A02,083766,Tran; Brian Kha,0,1,30,30
1656212705047,MATH 20D,A03,083767,Tran; Brian Kha,2,0,30,28
1656212711072,MATH 20E,A01,083771,Ganguly; Soumya,3,0,32,29
1656212711072,MATH 20E,A02,083772,Ganguly; Soumya,0,0,32,32
1656212711072,MATH 20E,B01,083773,Ciotti; Benjamin,16,0,35,19
1656212711072,MATH 20E,B02,083774,Ciotti; Benjamin,15,0,35,20
1656212717102,MATH 103A,A01,083777,Greenfeld; Be'Eri,1,0,36,35
1656212717102,MATH 103A,A02,083778,Greenfeld; Be'Eri,1,0,36,35
1656212717102,MATH 103A,A03,093561,Staff,5,0,36,31
1656212717102,MATH 103A,B01,083779,Greenfeld; Be'Eri,9,1,36,27
1656212717102,MATH 103A,B02,083780,Greenfeld; Be'Eri,1,0,36,35
1656212717102,MATH 103A,B03,093562,Staff,0,0,36,36
1656212723125,MATH 105,A01,085443,Carter; Anne Toulson,5,1,35,30
1656212723125,MATH 105,A02,093477,Staff,13,0,35,22
1656212729158,MATH 109,A01,083213,Ganzberger; Geoffrey Michael,0,0,34,34
1656212729158,MATH 109,A02,083214,Ganzberger; Geoffrey Michael,0,0,34,34
1656212729158,MATH 109,A03,093478,Staff,1,0,34,33
1656212729158,MATH 109,B01,083215,Ganzberger; Geoffrey Michael,4,0,32,28
1656212729158,MATH 109,B02,083216,Ganzberger; Geoffrey Michael,1,0,32,31
1656212729158,MATH 109,B03,093479,Staff,4,0,32,28
1656212735194,MATH 142A,A01,083219,Chow; Bennett,2,0,32,30
1656212735194,MATH 142A,A02,083220,Chow; Bennett,8,0,32,24
1656212735194,MATH 142A,A03,093480,Staff,5,0,32,27
1656212735194,MATH 142A,B03,093481,Staff,3,0,32,29
1656212735194,MATH 142A,B04,093558,Staff,6,0,32,26
1656212735194,MATH 142A,B05,093559,Staff,1,0,32,31
1656212741230,MATH 193A,A01,083224,Rotar; Vladimir,0,1,34,34
1656212741230,MATH 193A,A02,083225,Rotar; Vladimir,0,0,34,34
1656212741230,MATH 193A,A03,083781,Rotar; Vladimir,0,0,34,34
1656212741230,MATH 193A,A04,083782,Rotar; Vladimir,6,0,34,28
1656212741230,MATH 193A,A05,093482,Rotar; Vladimir,0,0,34,34
1656212747253,MATH 197,001,091859,McAuley; Julian John,9999,0,9999,0
1656212747253,MATH 197,002,095566,Kedlaya; Kiran S.,9997,0,9999,2
1656212747253,MATH 197,003,095567,Xiao; Ming,9999,0,9999,0
1656212747253,MATH 197,004,095571,Perols; Johan Lars,9998,0,9999,1
1656212754307,COGS 9,A01,083615,Shannon; Kyle Michael,3,0,75,72
1656212760337,COGS 11,A01,083617,Boyle; Mary E. T.,14,0,48,34
1656212766359,COGS 13,A01,083071,Bastos; Amalia Pinkusfeld,5,0,71,66
1656212772383,COGS 14A,A01,092681,Semenuks; Arturs,4,16,100,96
1656212778411,COGS 14B,A01,083073,Cheng; Tzu-Han,7,0,63,56
1656212784436,COGS 17,A01,092677,Semenuks; Arturs,7,0,81,74
1656212790464,COGS 100,A01,083619,Allen; Michael Gordon,2,0,70,68
1656212796488,COGS 101A,A01,083621,Davis; Joshua Daniel,4,0,68,64
1656212802511,COGS 101B,A01,091572,Allen; Michael Gordon,4,0,65,61
1656212808538,COGS 101C,A01,083625,Delgado; Tania,10,0,35,25
1656212814565,COGS 107A,A01,083627,Boyle; Mary E. T.,0,0,60,60
1656212820594,COGS 118A,A01,083075,Gupta; Anjum,7,0,76,69
1656212826618,CSE 3,A50,083646,Miranda; Gregory Joseph,18,0,50,32
1656212832643,CSE 8A,A50,083650,Miranda; Gregory Joseph,3,3,56,53
1656212838666,CSE 11,A01,083080,Cao; Yingjun,1,50,40,39
1656212844714,CSE 12,A01,083652,Krause-Levy; Sophia Louisa,7,3,120,113
1656212850747,CSE 15L,A01,083654,Morris; Justin Loren,2,0,50,48
1656212850747,CSE 15L,A02,083655,Morris; Justin Loren,4,0,50,46
1656212856770,CSE 20,A01,083657,Tran; Khoa Dang,30,0,80,50
1656212862793,CSE 21,A01,095574,Bach; Quang Tran,24,0,48,24
1656212868826,CSE 30,A01,083084,Eldon; John,2,8,80,78
1656212868826,CSE 30,B01,095061,Bhaskar; Nishant,1,2,50,49
1656212874852,CSE 100,A01,083659,Cao; Yingjun,2,20,70,68
1656212880876,CSE 134B,A01,083661,Powell; Thomas Allan,2,0,100,98
1656212886903,CSE 140,A01,083663,Gungor; Onat,9,0,85,76
1656212892926,CSE 140L,A01,083088,Eldon; John,8,0,100,92
1656212898949,CSE 175,A01,083665,Kumar; Rakesh,0,0,25,25
1656212904972,CSE 190,A00,092507,Dubnov; Shlomo,3,0,20,17
1656212910996,ECE 45,A01,083139,Congero; Spencer William,1,0,75,74
1656212917023,ECE 65,A50,083695,Saad; Andrew S,9,0,30,21
1656212917023,ECE 65,A51,095125,Staff,23,0,26,3
1656212923050,ECE 109,A01,091882,Touri; Behrouz,0,1,70,70
1656212929086,ECE 180,A00,083140,Abi Samra; Nicholas Camill,1,0,30,29
1656212929086,ECE 180,B00,083141,Abi Samra; Nicholas Camill,0,4,30,30
1656212935110,MATH 10A,A01,083735,Patchell; Gregory David,0,0,30,30
1656212935110,MATH 10A,A02,083736,Patchell; Gregory David,22,0,30,8
1656212935110,MATH 10A,A03,083737,Patchell; Gregory David,16,0,30,14
1656212941132,MATH 10B,A01,083207,Lim; Seonhee,0,0,34,34
1656212941132,MATH 10B,A02,083208,Lim; Seonhee,7,0,35,28
1656212941132,MATH 10B,A03,093472,Staff,1,0,34,33
1656212941132,MATH 10B,B01,083739,Sinha; Shubham,11,0,30,19
1656212947157,MATH 18,A01,083743,Cinel; Cameron Alexander,7,0,30,23
1656212947157,MATH 18,A02,083744,Cinel; Cameron Alexander,10,0,30,20
1656212947157,MATH 18,A03,083745,Cinel; Cameron Alexander,5,0,30,25
1656212947157,MATH 18,B01,083748,Rideout; David Porter,0,0,36,36
1656212947157,MATH 18,B02,083749,Rideout; David Porter,0,0,36,36
1656212947157,MATH 18,B03,083750,Rideout; David Porter,0,0,36,36
1656212947157,MATH 18,B04,083751,Rideout; David Porter,0,0,36,36
1656212947157,MATH 18,B05,093473,Rideout; David Porter,0,0,36,36
1656212947157,MATH 18,B06,093474,Rideout; David Porter,3,0,36,33
1656212953180,MATH 20A,A01,083754,Zheng; Zequn,11,0,40,29
1656212959204,MATH 20B,A01,083756,Briones; Jor-el Thomas Caparas,0,0,36,36
1656212959204,MATH 20B,A02,083757,Briones; Jor-el Thomas Caparas,0,0,36,36
1656212959204,MATH 20B,A03,093475,Staff,1,0,36,35
1656212965232,MATH 20C,A01,083760,Briones; Jor-el Thomas Caparas,0,0,35,35
1656212965232,MATH 20C,A02,083761,Briones; Jor-el Thomas Caparas,9,1,35,26
1656212965232,MATH 20C,A03,093476,Staff,0,0,35,35
1656212965232,MATH 20C,B01,083762,Bach; Quang Tran,1,0,30,29
1656212971262,MATH 20D,A01,083765,Tran; Brian Kha,1,0,30,29
1656212971262,MATH 20D,A02,083766,Tran; Brian Kha,0,1,30,30
1656212971262,MATH 20D,A03,083767,Tran; Brian Kha,2,0,30,28
1656212977288,MATH 20E,A01,083771,Ganguly; Soumya,3,0,32,29
1656212977288,MATH 20E,A02,083772,Ganguly; Soumya,0,0,32,32
1656212977288,MATH 20E,B01,083773,Ciotti; Benjamin,16,0,35,19
1656212977288,MATH 20E,B02,083774,Ciotti; Benjamin,15,0,35,20
1656212983311,MATH 103A,A01,083777,Greenfeld; Be'Eri,1,0,36,35
1656212983311,MATH 103A,A02,083778,Greenfeld; Be'Eri,1,0,36,35
1656212983311,MATH 103A,A03,093561,Staff,5,0,36,31
1656212983311,MATH 103A,B01,083779,Greenfeld; Be'Eri,9,1,36,27
1656212983311,MATH 103A,B02,083780,Greenfeld; Be'Eri,1,0,36,35
1656212983311,MATH 103A,B03,093562,Staff,0,0,36,36
1656212989338,MATH 105,A01,085443,Carter; Anne Toulson,5,1,35,30
1656212989338,MATH 105,A02,093477,Staff,13,0,35,22
1656212995367,MATH 109,A01,083213,Ganzberger; Geoffrey Michael,0,0,34,34
1656212995367,MATH 109,A02,083214,Ganzberger; Geoffrey Michael,0,0,34,34
1656212995367,MATH 109,A03,093478,Staff,1,0,34,33
1656212995367,MATH 109,B01,083215,Ganzberger; Geoffrey Michael,4,0,32,28
1656212995367,MATH 109,B02,083216,Ganzberger; Geoffrey Michael,1,0,32,31
1656212995367,MATH 109,B03,093479,Staff,4,0,32,28
1656213001392,MATH 142A,A01,083219,Chow; Bennett,2,0,32,30
1656213001392,MATH 142A,A02,083220,Chow; Bennett,8,0,32,24
1656213001392,MATH 142A,A03,093480,Staff,5,0,32,27
1656213001392,MATH 142A,B03,093481,Staff,3,0,32,29
1656213001392,MATH 142A,B04,093558,Staff,6,0,32,26
1656213001392,MATH 142A,B05,093559,Staff,1,0,32,31
1656213007420,MATH 193A,A01,083224,Rotar; Vladimir,0,1,34,34
1656213007420,MATH 193A,A02,083225,Rotar; Vladimir,0,0,34,34
1656213007420,MATH 193A,A03,083781,Rotar; Vladimir,0,0,34,34
1656213007420,MATH 193A,A04,083782,Rotar; Vladimir,6,0,34,28
1656213007420,MATH 193A,A05,093482,Rotar; Vladimir,0,0,34,34
1656213013458,MATH 197,001,091859,McAuley; Julian John,9999,0,9999,0
1656213013458,MATH 197,002,095566,Kedlaya; Kiran S.,9997,0,9999,2
1656213013458,MATH 197,003,095567,Xiao; Ming,9999,0,9999,0
1656213013458,MATH 197,004,095571,Perols; Johan Lars,9998,0,9999,1
1656213020510,COGS 9,A01,083615,Shannon; Kyle Michael,3,0,75,72
1656213026532,COGS 11,A01,083617,Boyle; Mary E. T.,14,0,48,34
1656213032560,COGS 13,A01,083071,Bastos; Amalia Pinkusfeld,5,0,71,66
1656213038588,COGS 14A,A01,092681,Semenuks; Arturs,4,16,100,96
1656213044610,COGS 14B,A01,083073,Cheng; Tzu-Han,7,0,63,56
1656213050638,COGS 17,A01,092677,Semenuks; Arturs,7,0,81,74
1656213056665,COGS 100,A01,083619,Allen; Michael Gordon,2,0,70,68
1656213062700,COGS 101A,A01,083621,Davis; Joshua Daniel,4,0,68,64
1656213068723,COGS 101B,A01,091572,Allen; Michael Gordon,4,0,65,61
1656213074748,COGS 101C,A01,083625,Delgado; Tania,10,0,35,25
1656213080775,COGS 107A,A01,083627,Boyle; Mary E. T.,0,0,60,60
1656213086798,COGS 118A,A01,083075,Gupta; Anjum,7,0,76,69
1656213092822,CSE 3,A50,083646,Miranda; Gregory Joseph,18,0,50,32
1656213098858,CSE 8A,A50,083650,Miranda; Gregory Joseph,3,3,56,53
1656213104881,CSE 11,A01,083080,Cao; Yingjun,1,50,40,39
1656213110909,CSE 12,A01,083652,Krause-Levy; Sophia Louisa,7,3,120,113
1656213116934,CSE 15L,A01,083654,Morris; Justin Loren,2,0,50,48
1656213116934,CSE 15L,A02,083655,Morris; Justin Loren,4,0,50,46
1656213123032,CSE 20,A01,083657,Tran; Khoa Dang,30,0,80,50
1656213129055,CSE 21,A01,095574,Bach; Quang Tran,24,0,48,24
1656213135079,CSE 30,A01,083084,Eldon; John,2,8,80,78
1656213135079,CSE 30,B01,095061,Bhaskar; Nishant,1,2,50,49
1656213141108,CSE 100,A01,083659,Cao; Yingjun,2,20,70,68
1656213147146,CSE 134B,A01,083661,Powell; Thomas Allan,2,0,100,98
1656213153175,CSE 140,A01,083663,Gungor; Onat,9,0,85,76
1656213159202,CSE 140L,A01,083088,Eldon; John,8,0,100,92
1656213165226,CSE 175,A01,083665,Kumar; Rakesh,0,0,25,25
1656213171253,CSE 190,A00,092507,Dubnov; Shlomo,3,0,20,17
1656213177287,ECE 45,A01,083139,Congero; Spencer William,1,0,75,74
1656213183312,ECE 65,A50,083695,Saad; Andrew S,9,0,30,21
1656213183312,ECE 65,A51,095125,Staff,23,0,26,3
1656213189335,ECE 109,A01,091882,Touri; Behrouz,0,1,70,70
1656213195362,ECE 180,A00,083140,Abi Samra; Nicholas Camill,1,0,30,29
1656213195362,ECE 180,B00,083141,Abi Samra; Nicholas Camill,0,4,30,30
1656213201387,MATH 10A,A01,083735,Patchell; Gregory David,0,0,30,30
1656213201387,MATH 10A,A02,083736,Patchell; Gregory David,22,0,30,8
1656213201387,MATH 10A,A03,083737,Patchell; Gregory David,16,0,30,14
1656213207424,MATH 10B,A01,083207,Lim; Seonhee,0,0,34,34
1656213207424,MATH 10B,A02,083208,Lim; Seonhee,7,0,35,28
1656213207424,MATH 10B,A03,093472,Staff,1,0,34,33
1656213207424,MATH 10B,B01,083739,Sinha; Shubham,11,0,30,19
1656213213456,MATH 18,A01,083743,Cinel; Cameron Alexander,7,0,30,23
1656213213456,MATH 18,A02,083744,Cinel; Cameron Alexander,10,0,30,20
1656213213456,MATH 18,A03,083745,Cinel; Cameron Alexander,5,0,30,25
1656213213456,MATH 18,B01,083748,Rideout; David Porter,0,0,36,36
1656213213456,MATH 18,B02,083749,Rideout; David Porter,0,0,36,36
1656213213456,MATH 18,B03,083750,Rideout; David Porter,0,0,36,36
1656213213456,MATH 18,B04,083751,Rideout; David Porter,0,1,36,36
1656213213456,MATH 18,B05,093473,Rideout; David Porter,0,0,36,36
1656213213456,MATH 18,B06,093474,Rideout; David Porter,3,0,36,33
1656213219477,MATH 20A,A01,083754,Zheng; Zequn,11,0,40,29
1656213225505,MATH 20B,A01,083756,Briones; Jor-el Thomas Caparas,0,0,36,36
1656213225505,MATH 20B,A02,083757,Briones; Jor-el Thomas Caparas,0,0,36,36
1656213225505,MATH 20B,A03,093475,Staff,1,0,36,35
1656213231531,MATH 20C,A01,083760,Briones; Jor-el Thomas Caparas,0,0,35,35
1656213231531,MATH 20C,A02,083761,Briones; Jor-el Thomas Caparas,9,1,35,26
1656213231531,MATH 20C,A03,093476,Staff,0,0,35,35
1656213231531,MATH 20C,B01,083762,Bach; Quang Tran,1,0,30,29
1656213237555,MATH 20D,A01,083765,Tran; Brian Kha,1,0,30,29
1656213237555,MATH 20D,A02,083766,Tran; Brian Kha,0,1,30,30
1656213237555,MATH 20D,A03,083767,Tran; Brian Kha,2,0,30,28
1656213243580,MATH 20E,A01,083771,Ganguly; Soumya,3,0,32,29
1656213243580,MATH 20E,A02,083772,Ganguly; Soumya,0,0,32,32
1656213243580,MATH 20E,B01,083773,Ciotti; Benjamin,16,0,35,19
1656213243580,MATH 20E,B02,083774,Ciotti; Benjamin,15,0,35,20
1656213249610,MATH 103A,A01,083777,Greenfeld; Be'Eri,1,0,36,35
1656213249610,MATH 103A,A02,083778,Greenfeld; Be'Eri,1,0,36,35
1656213249610,MATH 103A,A03,093561,Staff,5,0,36,31
1656213249610,MATH 103A,B01,083779,Greenfeld; Be'Eri,9,1,36,27
1656213249610,MATH 103A,B02,083780,Greenfeld; Be'Eri,1,0,36,35
1656213249610,MATH 103A,B03,093562,Staff,0,0,36,36
1656213255633,MATH 105,A01,085443,Carter; Anne Toulson,5,1,35,30
1656213255633,MATH 105,A02,093477,Staff,14,0,35,21
1656213261662,MATH 109,A01,083213,Ganzberger; Geoffrey Michael,0,0,34,34
1656213261662,MATH 109,A02,083214,Ganzberger; Geoffrey Michael,0,0,34,34
1656213261662,MATH 109,A03,093478,Staff,1,0,34,33
1656213261662,MATH 109,B01,083215,Ganzberger; Geoffrey Michael,4,0,32,28
1656213261662,MATH 109,B02,083216,Ganzberger; Geoffrey Michael,1,0,32,31
1656213261662,MATH 109,B03,093479,Staff,4,0,32,28
1656213267690,MATH 142A,A01,083219,Chow; Bennett,2,0,32,30
1656213267690,MATH 142A,A02,083220,Chow; Bennett,8,0,32,24
1656213267690,MATH 142A,A03,093480,Staff,5,0,32,27
1656213267690,MATH 142A,B03,093481,Staff,3,0,32,29
1656213267690,MATH 142A,B04,093558,Staff,6,0,32,26
1656213267690,MATH 142A,B05,093559,Staff,1,0,32,31
1656213273718,MATH 193A,A01,083224,Rotar; Vladimir,0,1,34,34
1656213273718,MATH 193A,A02,083225,Rotar; Vladimir,0,0,34,34
1656213273718,MATH 193A,A03,083781,Rotar; Vladimir,0,0,34,34
1656213273718,MATH 193A,A04,083782,Rotar; Vladimir,6,0,34,28
1656213273718,MATH 193A,A05,093482,Rotar; Vladimir,0,0,34,34
1656213279747,MATH 197,001,091859,McAuley; Julian John,9999,0,9999,0
1656213279747,MATH 197,002,095566,Kedlaya; Kiran S.,9997,0,9999,2
1656213279747,MATH 197,003,095567,Xiao; Ming,9999,0,9999,0
1656213279747,MATH 197,004,095571,Perols; Johan Lars,9998,0,9999,1
1656213286817,COGS 9,A01,083615,Shannon; Kyle Michael,3,0,75,72
1656213292840,COGS 11,A01,083617,Boyle; Mary E. T.,14,0,48,34
1656213298877,COGS 13,A01,083071,Bastos; Amalia Pinkusfeld,5,0,71,66
1656213304905,COGS 14A,A01,092681,Semenuks; Arturs,4,16,100,96
1656213310933,COGS 14B,A01,083073,Cheng; Tzu-Han,7,0,63,56
1656213316960,COGS 17,A01,092677,Semenuks; Arturs,7,0,81,74
1656213322987,COGS 100,A01,083619,Allen; Michael Gordon,2,0,70,68
1656213329029,COGS 101A,A01,083621,Davis; Joshua Daniel,4,0,68,64
1656213335056,COGS 101B,A01,091572,Allen; Michael Gordon,4,0,65,61
1656213341080,COGS 101C,A01,083625,Delgado; Tania,10,0,35,25
1656213347116,COGS 107A,A01,083627,Boyle; Mary E. T.,0,0,60,60
1656213353141,COGS 118A,A01,083075,Gupta; Anjum,7,0,76,69
1656213359169,CSE 3,A50,083646,Miranda; Gregory Joseph,18,0,50,32
1656213365194,CSE 8A,A50,083650,Miranda; Gregory Joseph,3,3,56,53
1656213371221,CSE 11,A01,083080,Cao; Yingjun,1,50,40,39
1656213377244,CSE 12,A01,083652,Krause-Levy; Sophia Louisa,7,3,120,113
1656213383267,CSE 15L,A01,083654,Morris; Justin Loren,2,0,50,48
1656213383267,CSE 15L,A02,083655,Morris; Justin Loren,4,0,50,46
1656213389291,CSE 20,A01,083657,Tran; Khoa Dang,30,0,80,50
1656213395322,CSE 21,A01,095574,Bach; Quang Tran,24,0,48,24
1656213401350,CSE 30,A01,083084,Eldon; John,2,8,80,78
1656213401350,CSE 30,B01,095061,Bhaskar; Nishant,1,2,50,49
1656213407376,CSE 100,A01,083659,Cao; Yingjun,2,20,70,68
1656213413409,CSE 134B,A01,083661,Powell; Thomas Allan,2,0,100,98
1656213419436,CSE 140,A01,083663,Gungor; Onat,9,0,85,76
1656213425462,CSE 140L,A01,083088,Eldon; John,8,0,100,92
1656213431492,CSE 175,A01,083665,Kumar; Rakesh,0,0,25,25
1656213437518,CSE 190,A00,092507,Dubnov; Shlomo,3,0,20,17
1656213443542,ECE 45,A01,083139,Congero; Spencer William,1,0,75,74
1656213449566,ECE 65,A50,083695,Saad; Andrew S,9,0,30,21
1656213449566,ECE 65,A51,095125,Staff,23,0,26,3
1656213455597,ECE 109,A01,091882,Touri; Behrouz,0,1,70,70
1656213461621,ECE 180,A00,083140,Abi Samra; Nicholas Camill,1,0,30,29
1656213461621,ECE 180,B00,083141,Abi Samra; Nicholas Camill,0,4,30,30
1656213467644,MATH 10A,A01,083735,Patchell; Gregory David,0,0,30,30
1656213467644,MATH 10A,A02,083736,Patchell; Gregory David,22,0,30,8
1656213467644,MATH 10A,A03,083737,Patchell; Gregory David,16,0,30,14
1656213473672,MATH 10B,A01,083207,Lim; Seonhee,0,0,34,34
1656213473672,MATH 10B,A02,083208,Lim; Seonhee,7,0,35,28
1656213473672,MATH 10B,A03,093472,Staff,1,0,34,33
1656213473672,MATH 10B,B01,083739,Sinha; Shubham,11,0,30,19
1656213479697,MATH 18,A01,083743,Cinel; Cameron Alexander,7,0,30,23
1656213479697,MATH 18,A02,083744,Cinel; Cameron Alexander,10,0,30,20
1656213479697,MATH 18,A03,083745,Cinel; Cameron Alexander,5,0,30,25
1656213479697,MATH 18,B01,083748,Rideout; David Porter,0,0,36,36
1656213479697,MATH 18,B02,083749,Rideout; David Porter,0,0,36,36
1656213479697,MATH 18,B03,083750,Rideout; David Porter,0,0,36,36
1656213479697,MATH 18,B04,083751,Rideout; David Porter,0,1,36,36
1656213479697,MATH 18,B05,093473,Rideout; David Porter,0,0,36,36
1656213479697,MATH 18,B06,093474,Rideout; David Porter,3,0,36,33
1656213485721,MATH 20A,A01,083754,Zheng; Zequn,11,0,40,29
1656213491749,MATH 20B,A01,083756,Briones; Jor-el Thomas Caparas,0,0,36,36
1656213491749,MATH 20B,A02,083757,Briones; Jor-el Thomas Caparas,0,0,36,36
1656213491749,MATH 20B,A03,093475,Staff,1,0,36,35
1656213497776,MATH 20C,A01,083760,Briones; Jor-el Thomas Caparas,0,0,35,35
1656213497776,MATH 20C,A02,083761,Briones; Jor-el Thomas Caparas,9,1,35,26
1656213497776,MATH 20C,A03,093476,Staff,0,0,35,35
1656213497776,MATH 20C,B01,083762,Bach; Quang Tran,1,0,30,29
1656213503800,MATH 20D,A01,083765,Tran; Brian Kha,1,0,30,29
1656213503800,MATH 20D,A02,083766,Tran; Brian Kha,0,1,30,30
1656213503800,MATH 20D,A03,083767,Tran; Brian Kha,2,0,30,28
1656213509825,MATH 20E,A01,083771,Ganguly; Soumya,3,0,32,29
1656213509825,MATH 20E,A02,083772,Ganguly; Soumya,0,0,32,32
1656213509825,MATH 20E,B01,083773,Ciotti; Benjamin,16,0,35,19
1656213509825,MATH 20E,B02,083774,Ciotti; Benjamin,15,0,35,20
1656213515853,MATH 103A,A01,083777,Greenfeld; Be'Eri,1,0,36,35
1656213515853,MATH 103A,A02,083778,Greenfeld; Be'Eri,1,0,36,35
1656213515853,MATH 103A,A03,093561,Staff,5,0,36,31
1656213515853,MATH 103A,B01,083779,Greenfeld; Be'Eri,9,1,36,27
1656213515853,MATH 103A,B02,083780,Greenfeld; Be'Eri,1,0,36,35
1656213515853,MATH 103A,B03,093562,Staff,0,0,36,36
1656213521880,MATH 105,A01,085443,Carter; Anne Toulson,5,1,35,30
1656213521880,MATH 105,A02,093477,Staff,14,0,35,21
1656213527908,MATH 109,A01,083213,Ganzberger; Geoffrey Michael,0,0,34,34
1656213527908,MATH 109,A02,083214,Ganzberger; Geoffrey Michael,0,0,34,34
1656213527908,MATH 109,A03,093478,Staff,1,0,34,33
1656213527908,MATH 109,B01,083215,Ganzberger; Geoffrey Michael,4,0,32,28
1656213527908,MATH 109,B02,083216,Ganzberger; Geoffrey Michael,1,0,32,31
1656213527908,MATH 109,B03,093479,Staff,4,0,32,28
1656213533932,MATH 142A,A01,083219,Chow; Bennett,2,0,32,30
1656213533932,MATH 142A,A02,083220,Chow; Bennett,8,0,32,24
1656213533932,MATH 142A,A03,093480,Staff,5,0,32,27
1656213533932,MATH 142A,B03,093481,Staff,3,0,32,29
1656213533932,MATH 142A,B04,093558,Staff,6,0,32,26
1656213533932,MATH 142A,B05,093559,Staff,1,0,32,31
1656213539956,MATH 193A,A01,083224,Rotar; Vladimir,0,1,34,34
1656213539956,MATH 193A,A02,083225,Rotar; Vladimir,0,0,34,34
1656213539956,MATH 193A,A03,083781,Rotar; Vladimir,0,0,34,34
1656213539956,MATH 193A,A04,083782,Rotar; Vladimir,6,0,34,28
1656213539956,MATH 193A,A05,093482,Rotar; Vladimir,0,0,34,34
1656213545982,MATH 197,001,091859,McAuley; Julian John,9999,0,9999,0
1656213545982,MATH 197,002,095566,Kedlaya; Kiran S.,9997,0,9999,2
1656213545982,MATH 197,003,095567,Xiao; Ming,9999,0,9999,0
1656213545982,MATH 197,004,095571,Perols; Johan Lars,9998,0,9999,1
1656213553044,COGS 9,A01,083615,Shannon; Kyle Michael,3,0,75,72
1656213559069,COGS 11,A01,083617,Boyle; Mary E. T.,14,0,48,34
1656213565100,COGS 13,A01,083071,Bastos; Amalia Pinkusfeld,5,0,71,66
1656213571128,COGS 14A,A01,092681,Semenuks; Arturs,4,16,100,96
1656213577155,COGS 14B,A01,083073,Cheng; Tzu-Han,7,0,63,56
1656213583179,COGS 17,A01,092677,Semenuks; Arturs,7,0,81,74
1656213589203,COGS 100,A01,083619,Allen; Michael Gordon,2,0,70,68
1656213595225,COGS 101A,A01,083621,Davis; Joshua Daniel,4,0,68,64
1656213601249,COGS 101B,A01,091572,Allen; Michael Gordon,4,0,65,61
1656213607275,COGS 101C,A01,083625,Delgado; Tania,10,0,35,25
1656213613299,COGS 107A,A01,083627,Boyle; Mary E. T.,0,0,60,60
1656213619326,COGS 118A,A01,083075,Gupta; Anjum,7,0,76,69
1656213625354,CSE 3,A50,083646,Miranda; Gregory Joseph,18,0,50,32
1656213631391,CSE 8A,A50,083650,Miranda; Gregory Joseph,3,3,56,53
1656213637418,CSE 11,A01,083080,Cao; Yingjun,1,50,40,39
1656213643441,CSE 12,A01,083652,Krause-Levy; Sophia Louisa,7,3,120,113
1656213649463,CSE 15L,A01,083654,Morris; Justin Loren,2,0,50,48
1656213649463,CSE 15L,A02,083655,Morris; Justin Loren,4,0,50,46
1656213655486,CSE 20,A01,083657,Tran; Khoa Dang,30,0,80,50
1656213661511,CSE 21,A01,095574,Bach; Quang Tran,24,0,48,24
1656213667535,CSE 30,A01,083084,Eldon; John,2,8,80,78
1656213667535,CSE 30,B01,095061,Bhaskar; Nishant,1,2,50,49
1656213673558,CSE 100,A01,083659,Cao; Yingjun,2,20,70,68
1656213679584,CSE 134B,A01,083661,Powell; Thomas Allan,2,0,100,98
1656213685613,CSE 140,A01,083663,Gungor; Onat,9,0,85,76
1656213691640,CSE 140L,A01,083088,Eldon; John,8,0,100,92
1656213697662,CSE 175,A01,083665,Kumar; Rakesh,0,0,25,25
1656213703695,CSE 190,A00,092507,Dubnov; Shlomo,3,0,20,17
1656213709718,ECE 45,A01,083139,Congero; Spencer William,1,0,75,74
1656213715741,ECE 65,A50,083695,Saad; Andrew S,9,0,30,21
1656213715741,ECE 65,A51,095125,Staff,23,0,26,3
1656213721862,ECE 109,A01,091882,Touri; Behrouz,0,1,70,70
1656213727883,ECE 180,A00,083140,Abi Samra; Nicholas Camill,1,0,30,29
1656213727883,ECE 180,B00,083141,Abi Samra; Nicholas Camill,0,4,30,30
1656213733915,MATH 10A,A01,083735,Patchell; Gregory David,0,0,30,30
1656213733915,MATH 10A,A02,083736,Patchell; Gregory David,22,0,30,8
1656213733915,MATH 10A,A03,083737,Patchell; Gregory David,16,0,30,14
1656213739945,MATH 10B,A01,083207,Lim; Seonhee,0,0,34,34
1656213739945,MATH 10B,A02,083208,Lim; Seonhee,7,0,35,28
1656213739945,MATH 10B,A03,093472,Staff,1,0,34,33
1656213739945,MATH 10B,B01,083739,Sinha; Shubham,11,0,30,19
1656213745976,MATH 18,A01,083743,Cinel; Cameron Alexander,7,0,30,23
1656213745976,MATH 18,A02,083744,Cinel; Cameron Alexander,10,0,30,20
1656213745976,MATH 18,A03,083745,Cinel; Cameron Alexander,5,0,30,25
1656213745976,MATH 18,B01,083748,Rideout; David Porter,0,0,36,36
1656213745976,MATH 18,B02,083749,Rideout; David Porter,0,0,36,36
1656213745976,MATH 18,B03,083750,Rideout; David Porter,0,0,36,36
1656213745976,MATH 18,B04,083751,Rideout; David Porter,0,1,36,36
1656213745976,MATH 18,B05,093473,Rideout; David Porter,0,0,36,36
1656213745976,MATH 18,B06,093474,Rideout; David Porter,3,0,36,33
1656213752003,MATH 20A,A01,083754,Zheng; Zequn,11,0,40,29
1656213758026,MATH 20B,A01,083756,Briones; Jor-el Thomas Caparas,0,0,36,36
1656213758026,MATH 20B,A02,083757,Briones; Jor-el Thomas Caparas,0,0,36,36
1656213758026,MATH 20B,A03,093475,Staff,1,0,36,35
1656213764063,MATH 20C,A01,083760,Briones; Jor-el Thomas Caparas,0,0,35,35
1656213764063,MATH 20C,A02,083761,Briones; Jor-el Thomas Caparas,9,1,35,26
1656213764063,MATH 20C,A03,093476,Staff,0,0,35,35
1656213764063,MATH 20C,B01,083762,Bach; Quang Tran,1,0,30,29
1656213770090,MATH 20D,A01,083765,Tran; Brian Kha,1,0,30,29
1656213770090,MATH 20D,A02,083766,Tran; Brian Kha,0,1,30,30
1656213770090,MATH 20D,A03,083767,Tran; Brian Kha,2,0,30,28
1656213776119,MATH 20E,A01,083771,Ganguly; Soumya,3,0,32,29
1656213776119,MATH 20E,A02,083772,Ganguly; Soumya,0,0,32,32
1656213776119,MATH 20E,B01,083773,Ciotti; Benjamin,16,0,35,19
1656213776119,MATH 20E,B02,083774,Ciotti; Benjamin,15,0,35,20
1656213782150,MATH 103A,A01,083777,Greenfeld; Be'Eri,1,0,36,35
1656213782150,MATH 103A,A02,083778,Greenfeld; Be'Eri,1,0,36,35
1656213782150,MATH 103A,A03,093561,Staff,5,0,36,31
1656213782150,MATH 103A,B01,083779,Greenfeld; Be'Eri,9,1,36,27
1656213782150,MATH 103A,B02,083780,Greenfeld; Be'Eri,1,0,36,35
1656213782150,MATH 103A,B03,093562,Staff,0,0,36,36
1656213788175,MATH 105,A01,085443,Carter; Anne Toulson,5,1,35,30
1656213788175,MATH 105,A02,093477,Staff,14,0,35,21
1656213794206,MATH 109,A01,083213,Ganzberger; Geoffrey Michael,0,0,34,34
1656213794206,MATH 109,A02,083214,Ganzberger; Geoffrey Michael,0,0,34,34
1656213794206,MATH 109,A03,093478,Staff,1,0,34,33
1656213794206,MATH 109,B01,083215,Ganzberger; Geoffrey Michael,4,0,32,28
1656213794206,MATH 109,B02,083216,Ganzberger; Geoffrey Michael,1,0,32,31
1656213794206,MATH 109,B03,093479,Staff,4,0,32,28
1656213800228,MATH 142A,A01,083219,Chow; Bennett,2,0,32,30
1656213800228,MATH 142A,A02,083220,Chow; Bennett,8,0,32,24
1656213800228,MATH 142A,A03,093480,Staff,5,0,32,27
1656213800228,MATH 142A,B03,093481,Staff,3,0,32,29
1656213800228,MATH 142A,B04,093558,Staff,6,0,32,26
1656213800228,MATH 142A,B05,093559,Staff,1,0,32,31
1656213806249,MATH 193A,A01,083224,Rotar; Vladimir,0,1,34,34
1656213806249,MATH 193A,A02,083225,Rotar; Vladimir,0,0,34,34
1656213806249,MATH 193A,A03,083781,Rotar; Vladimir,0,0,34,34
1656213806249,MATH 193A,A04,083782,Rotar; Vladimir,6,0,34,28
1656213806249,MATH 193A,A05,093482,Rotar; Vladimir,0,0,34,34
1656213812276,MATH 197,001,091859,McAuley; Julian John,9999,0,9999,0
1656213812276,MATH 197,002,095566,Kedlaya; Kiran S.,9997,0,9999,2
1656213812276,MATH 197,003,095567,Xiao; Ming,9999,0,9999,0
1656213812276,MATH 197,004,095571,Perols; Johan Lars,9998,0,9999,1
1656213819327,COGS 9,A01,083615,Shannon; Kyle Michael,3,0,75,72
1656213825370,COGS 11,A01,083617,Boyle; Mary E. T.,14,0,48,34
1656213831395,COGS 13,A01,083071,Bastos; Amalia Pinkusfeld,5,0,71,66
1656213837418,COGS 14A,A01,092681,Semenuks; Arturs,4,16,100,96
1656213843445,COGS 14B,A01,083073,Cheng; Tzu-Han,7,0,63,56
1656213849468,COGS 17,A01,092677,Semenuks; Arturs,7,0,81,74
1656213855496,COGS 100,A01,083619,Allen; Michael Gordon,2,0,70,68
1656213861521,COGS 101A,A01,083621,Davis; Joshua Daniel,4,0,68,64
1656213867547,COGS 101B,A01,091572,Allen; Michael Gordon,4,0,65,61
1656213873571,COGS 101C,A01,083625,Delgado; Tania,10,0,35,25
1656213879594,COGS 107A,A01,083627,Boyle; Mary E. T.,0,0,60,60
1656213885622,COGS 118A,A01,083075,Gupta; Anjum,7,0,76,69
1656213891647,CSE 3,A50,083646,Miranda; Gregory Joseph,18,0,50,32
1656213897671,CSE 8A,A50,083650,Miranda; Gregory Joseph,3,3,56,53
1656213903698,CSE 11,A01,083080,Cao; Yingjun,1,50,40,39
1656213909724,CSE 12,A01,083652,Krause-Levy; Sophia Louisa,7,3,120,113
1656213915747,CSE 15L,A01,083654,Morris; Justin Loren,2,0,50,48
1656213915747,CSE 15L,A02,083655,Morris; Justin Loren,4,0,50,46
1656213921770,CSE 20,A01,083657,Tran; Khoa Dang,30,0,80,50
1656213927794,CSE 21,A01,095574,Bach; Quang Tran,24,0,48,24
1656213933818,CSE 30,A01,083084,Eldon; John,2,8,80,78
1656213933818,CSE 30,B01,095061,Bhaskar; Nishant,1,2,50,49
1656213939840,CSE 100,A01,083659,Cao; Yingjun,2,20,70,68
1656213945868,CSE 134B,A01,083661,Powell; Thomas Allan,2,0,100,98
1656213951890,CSE 140,A01,083663,Gungor; Onat,9,0,85,76
1656213957913,CSE 140L,A01,083088,Eldon; John,8,0,100,92
1656213963936,CSE 175,A01,083665,Kumar; Rakesh,0,0,25,25
1656213969960,CSE 190,A00,092507,Dubnov; Shlomo,3,0,20,17
1656213975984,ECE 45,A01,083139,Congero; Spencer William,1,0,75,74
1656213982009,ECE 65,A50,083695,Saad; Andrew S,9,0,30,21
1656213982009,ECE 65,A51,095125,Staff,23,0,26,3
1656213988031,ECE 109,A01,091882,Touri; Behrouz,0,1,70,70
1656213994054,ECE 180,A00,083140,Abi Samra; Nicholas Camill,1,0,30,29
1656213994054,ECE 180,B00,083141,Abi Samra; Nicholas Camill,0,4,30,30
1656214000078,MATH 10A,A01,083735,Patchell; Gregory David,0,0,30,30
1656214000078,MATH 10A,A02,083736,Patchell; Gregory David,22,0,30,8
1656214000078,MATH 10A,A03,083737,Patchell; Gregory David,16,0,30,14
1656214006105,MATH 10B,A01,083207,Lim; Seonhee,0,0,34,34
1656214006105,MATH 10B,A02,083208,Lim; Seonhee,7,0,35,28
1656214006105,MATH 10B,A03,093472,Staff,1,0,34,33
1656214006105,MATH 10B,B01,083739,Sinha; Shubham,11,0,30,19
1656214012131,MATH 18,A01,083743,Cinel; Cameron Alexander,7,0,30,23
1656214012131,MATH 18,A02,083744,Cinel; Cameron Alexander,10,0,30,20
1656214012131,MATH 18,A03,083745,Cinel; Cameron Alexander,5,0,30,25
1656214012131,MATH 18,B01,083748,Rideout; David Porter,0,0,36,36
1656214012131,MATH 18,B02,083749,Rideout; David Porter,0,0,36,36
1656214012131,MATH 18,B03,083750,Rideout; David Porter,0,0,36,36
1656214012131,MATH 18,B04,083751,Rideout; David Porter,0,1,36,36
1656214012131,MATH 18,B05,093473,Rideout; David Porter,0,0,36,36
1656214012131,MATH 18,B06,093474,Rideout; David Porter,3,0,36,33
1656214018155,MATH 20A,A01,083754,Zheng; Zequn,11,0,40,29
1656214024179,MATH 20B,A01,083756,Briones; Jor-el Thomas Caparas,0,0,36,36
1656214024179,MATH 20B,A02,083757,Briones; Jor-el Thomas Caparas,0,0,36,36
1656214024179,MATH 20B,A03,093475,Staff,1,0,36,35
1656214030202,MATH 20C,A01,083760,Briones; Jor-el Thomas Caparas,0,0,35,35
1656214030202,MATH 20C,A02,083761,Briones; Jor-el Thomas Caparas,9,1,35,26
1656214030202,MATH 20C,A03,093476,Staff,0,0,35,35
1656214030202,MATH 20C,B01,083762,Bach; Quang Tran,1,0,30,29
1656214036230,MATH 20D,A01,083765,Tran; Brian Kha,1,0,30,29
1656214036230,MATH 20D,A02,083766,Tran; Brian Kha,0,1,30,30
1656214036230,MATH 20D,A03,083767,Tran; Brian Kha,2,0,30,28
1656214042255,MATH 20E,A01,083771,Ganguly; Soumya,3,0,32,29
1656214042255,MATH 20E,A02,083772,Ganguly; Soumya,0,0,32,32
1656214042255,MATH 20E,B01,083773,Ciotti; Benjamin,16,0,35,19
1656214042255,MATH 20E,B02,083774,Ciotti; Benjamin,15,0,35,20
1656214048290,MATH 103A,A01,083777,Greenfeld; Be'Eri,1,0,36,35
1656214048290,MATH 103A,A02,083778,Greenfeld; Be'Eri,1,0,36,35
1656214048290,MATH 103A,A03,093561,Staff,5,0,36,31
1656214048290,MATH 103A,B01,083779,Greenfeld; Be'Eri,9,1,36,27
1656214048290,MATH 103A,B02,083780,Greenfeld; Be'Eri,1,0,36,35
1656214048290,MATH 103A,B03,093562,Staff,0,0,36,36
1656214054314,MATH 105,A01,085443,Carter; Anne Toulson,5,1,35,30
1656214054314,MATH 105,A02,093477,Staff,14,0,35,21
1656214060341,MATH 109,A01,083213,Ganzberger; Geoffrey Michael,0,0,34,34
1656214060341,MATH 109,A02,083214,Ganzberger; Geoffrey Michael,0,0,34,34
1656214060341,MATH 109,A03,093478,Staff,1,0,34,33
1656214060341,MATH 109,B01,083215,Ganzberger; Geoffrey Michael,4,0,32,28
1656214060341,MATH 109,B02,083216,Ganzberger; Geoffrey Michael,1,0,32,31
1656214060341,MATH 109,B03,093479,Staff,4,0,32,28
1656214066363,MATH 142A,A01,083219,Chow; Bennett,2,0,32,30
1656214066363,MATH 142A,A02,083220,Chow; Bennett,8,0,32,24
1656214066363,MATH 142A,A03,093480,Staff,5,0,32,27
1656214066363,MATH 142A,B03,093481,Staff,3,0,32,29
1656214066363,MATH 142A,B04,093558,Staff,6,0,32,26
1656214066363,MATH 142A,B05,093559,Staff,1,0,32,31
1656214072386,MATH 193A,A01,083224,Rotar; Vladimir,0,1,34,34
1656214072386,MATH 193A,A02,083225,Rotar; Vladimir,0,0,34,34
1656214072386,MATH 193A,A03,083781,Rotar; Vladimir,0,0,34,34
1656214072386,MATH 193A,A04,083782,Rotar; Vladimir,6,0,34,28
1656214072386,MATH 193A,A05,093482,Rotar; Vladimir,0,0,34,34
1656214078412,MATH 197,001,091859,McAuley; Julian John,9999,0,9999,0
1656214078412,MATH 197,002,095566,Kedlaya; Kiran S.,9997,0,9999,2
1656214078412,MATH 197,003,095567,Xiao; Ming,9999,0,9999,0
1656214078412,MATH 197,004,095571,Perols; Johan Lars,9998,0,9999,1
1656214085471,COGS 9,A01,083615,Shannon; Kyle Michael,3,0,75,72
1656214091495,COGS 11,A01,083617,Boyle; Mary E. T.,14,0,48,34
1656214097522,COGS 13,A01,083071,Bastos; Amalia Pinkusfeld,5,0,71,66
1656214103546,COGS 14A,A01,092681,Semenuks; Arturs,4,16,100,96
1656214109568,COGS 14B,A01,083073,Cheng; Tzu-Han,7,0,63,56
1656214115592,COGS 17,A01,092677,Semenuks; Arturs,7,0,81,74
1656214121623,COGS 100,A01,083619,Allen; Michael Gordon,2,0,70,68
1656214127647,COGS 101A,A01,083621,Davis; Joshua Daniel,4,0,68,64
1656214133673,COGS 101B,A01,091572,Allen; Michael Gordon,4,0,65,61
1656214139695,COGS 101C,A01,083625,Delgado; Tania,10,0,35,25
1656214145719,COGS 107A,A01,083627,Boyle; Mary E. T.,0,0,60,60
1656214151741,COGS 118A,A01,083075,Gupta; Anjum,7,0,76,69
1656214157770,CSE 3,A50,083646,Miranda; Gregory Joseph,18,0,50,32
1656214163794,CSE 8A,A50,083650,Miranda; Gregory Joseph,3,3,56,53
1656214169824,CSE 11,A01,083080,Cao; Yingjun,1,50,40,39
1656214175847,CSE 12,A01,083652,Krause-Levy; Sophia Louisa,7,3,120,113
1656214181874,CSE 15L,A01,083654,Morris; Justin Loren,2,0,50,48
1656214181874,CSE 15L,A02,083655,Morris; Justin Loren,4,0,50,46
1656214187899,CSE 20,A01,083657,Tran; Khoa Dang,30,0,80,50
1656214193930,CSE 21,A01,095574,Bach; Quang Tran,24,0,48,24
1656214199954,CSE 30,A01,083084,Eldon; John,2,8,80,78
1656214199954,CSE 30,B01,095061,Bhaskar; Nishant,1,2,50,49
1656214205980,CSE 100,A01,083659,Cao; Yingjun,2,20,70,68
1656214212006,CSE 134B,A01,083661,Powell; Thomas Allan,2,0,100,98
1656214218034,CSE 140,A01,083663,Gungor; Onat,9,0,85,76
1656214224057,CSE 140L,A01,083088,Eldon; John,8,0,100,92
1656214230081,CSE 175,A01,083665,Kumar; Rakesh,0,0,25,25
1656214236107,CSE 190,A00,092507,Dubnov; Shlomo,3,0,20,17
1656214242131,ECE 45,A01,083139,Congero; Spencer William,1,0,75,74
1656214248154,ECE 65,A50,083695,Saad; Andrew S,9,0,30,21
1656214248154,ECE 65,A51,095125,Staff,23,0,26,3
1656214254178,ECE 109,A01,091882,Touri; Behrouz,0,1,70,70
1656214260205,ECE 180,A00,083140,Abi Samra; Nicholas Camill,1,0,30,29
1656214260205,ECE 180,B00,083141,Abi Samra; Nicholas Camill,0,4,30,30
1656214266232,MATH 10A,A01,083735,Patchell; Gregory David,0,0,30,30
1656214266232,MATH 10A,A02,083736,Patchell; Gregory David,22,0,30,8
1656214266232,MATH 10A,A03,083737,Patchell; Gregory David,16,0,30,14
1656214272256,MATH 10B,A01,083207,Lim; Seonhee,0,0,34,34
1656214272256,MATH 10B,A02,083208,Lim; Seonhee,7,0,35,28
1656214272256,MATH 10B,A03,093472,Staff,1,0,34,33
1656214272256,MATH 10B,B01,083739,Sinha; Shubham,11,0,30,19
1656214278282,MATH 18,A01,083743,Cinel; Cameron Alexander,7,0,30,23
1656214278282,MATH 18,A02,083744,Cinel; Cameron Alexander,10,0,30,20
1656214278282,MATH 18,A03,083745,Cinel; Cameron Alexander,5,0,30,25
1656214278282,MATH 18,B01,083748,Rideout; David Porter,0,0,36,36
1656214278282,MATH 18,B02,083749,Rideout; David Porter,0,0,36,36
1656214278282,MATH 18,B03,083750,Rideout; David Porter,0,0,36,36
1656214278282,MATH 18,B04,083751,Rideout; David Porter,0,1,36,36
1656214278282,MATH 18,B05,093473,Rideout; David Porter,0,0,36,36
1656214278282,MATH 18,B06,093474,Rideout; David Porter,3,0,36,33
1656214284309,MATH 20A,A01,083754,Zheng; Zequn,11,0,40,29
1656214290333,MATH 20B,A01,083756,Briones; Jor-el Thomas Caparas,0,0,36,36
1656214290333,MATH 20B,A02,083757,Briones; Jor-el Thomas Caparas,0,0,36,36
1656214290333,MATH 20B,A03,093475,Staff,1,0,36,35
1656214296356,MATH 20C,A01,083760,Briones; Jor-el Thomas Caparas,0,0,35,35
1656214296356,MATH 20C,A02,083761,Briones; Jor-el Thomas Caparas,9,1,35,26
1656214296356,MATH 20C,A03,093476,Staff,0,0,35,35
1656214296356,MATH 20C,B01,083762,Bach; Quang Tran,1,0,30,29
1656214302385,MATH 20D,A01,083765,Tran; Brian Kha,1,0,30,29
1656214302385,MATH 20D,A02,083766,Tran; Brian Kha,0,1,30,30
1656214302385,MATH 20D,A03,083767,Tran; Brian Kha,2,0,30,28
1656214308409,MATH 20E,A01,083771,Ganguly; Soumya,3,0,32,29
1656214308409,MATH 20E,A02,083772,Ganguly; Soumya,0,0,32,32
1656214308409,MATH 20E,B01,083773,Ciotti; Benjamin,16,0,35,19
1656214308409,MATH 20E,B02,083774,Ciotti; Benjamin,15,0,35,20
1656214314434,MATH 103A,A01,083777,Greenfeld; Be'Eri,1,0,36,35
1656214314434,MATH 103A,A02,083778,Greenfeld; Be'Eri,1,0,36,35
1656214314434,MATH 103A,A03,093561,Staff,5,0,36,31
1656214314434,MATH 103A,B01,083779,Greenfeld; Be'Eri,9,1,36,27
1656214314434,MATH 103A,B02,083780,Greenfeld; Be'Eri,1,0,36,35
1656214314434,MATH 103A,B03,093562,Staff,0,0,36,36
1656214320533,MATH 105,A01,085443,Carter; Anne Toulson,5,1,35,30
1656214320533,MATH 105,A02,093477,Staff,14,0,35,21
1656214326558,MATH 109,A01,083213,Ganzberger; Geoffrey Michael,0,0,34,34
1656214326558,MATH 109,A02,083214,Ganzberger; Geoffrey Michael,0,0,34,34
1656214326558,MATH 109,A03,093478,Staff,1,0,34,33
1656214326558,MATH 109,B01,083215,Ganzberger; Geoffrey Michael,4,0,32,28
1656214326558,MATH 109,B02,083216,Ganzberger; Geoffrey Michael,1,0,32,31
1656214326558,MATH 109,B03,093479,Staff,4,0,32,28
1656214332583,MATH 142A,A01,083219,Chow; Bennett,2,0,32,30
1656214332583,MATH 142A,A02,083220,Chow; Bennett,8,0,32,24
1656214332583,MATH 142A,A03,093480,Staff,5,0,32,27
1656214332583,MATH 142A,B03,093481,Staff,3,0,32,29
1656214332583,MATH 142A,B04,093558,Staff,6,0,32,26
1656214332583,MATH 142A,B05,093559,Staff,1,0,32,31
1656214338622,MATH 193A,A01,083224,Rotar; Vladimir,0,1,34,34
1656214338622,MATH 193A,A02,083225,Rotar; Vladimir,0,0,34,34
1656214338622,MATH 193A,A03,083781,Rotar; Vladimir,0,0,34,34
1656214338622,MATH 193A,A04,083782,Rotar; Vladimir,6,0,34,28
1656214338622,MATH 193A,A05,093482,Rotar; Vladimir,0,0,34,34
1656214344655,MATH 197,001,091859,McAuley; Julian John,9999,0,9999,0
1656214344655,MATH 197,002,095566,Kedlaya; Kiran S.,9997,0,9999,2
1656214344655,MATH 197,003,095567,Xiao; Ming,9999,0,9999,0
1656214344655,MATH 197,004,095571,Perols; Johan Lars,9998,0,9999,1
1656214351720,COGS 9,A01,083615,Shannon; Kyle Michael,3,0,75,72
1656214357749,COGS 11,A01,083617,Boyle; Mary E. T.,14,0,48,34
1656214363788,COGS 13,A01,083071,Bastos; Amalia Pinkusfeld,5,0,71,66
1656214369823,COGS 14A,A01,092681,Semenuks; Arturs,4,16,100,96
1656214375848,COGS 14B,A01,083073,Cheng; Tzu-Han,7,0,63,56
1656214381870,COGS 17,A01,092677,Semenuks; Arturs,7,0,81,74
1656214387897,COGS 100,A01,083619,Allen; Michael Gordon,2,0,70,68
1656214393923,COGS 101A,A01,083621,Davis; Joshua Daniel,4,0,68,64
1656214399947,COGS 101B,A01,091572,Allen; Michael Gordon,4,0,65,61
1656214405973,COGS 101C,A01,083625,Delgado; Tania,10,0,35,25
1656214411999,COGS 107A,A01,083627,Boyle; Mary E. T.,0,0,60,60
1656214418026,COGS 118A,A01,083075,Gupta; Anjum,7,0,76,69
1656214424049,CSE 3,A50,083646,Miranda; Gregory Joseph,18,0,50,32
1656214430074,CSE 8A,A50,083650,Miranda; Gregory Joseph,3,3,56,53
1656214436098,CSE 11,A01,083080,Cao; Yingjun,1,50,40,39
1656214442123,CSE 12,A01,083652,Krause-Levy; Sophia Louisa,7,3,120,113
1656214448148,CSE 15L,A01,083654,Morris; Justin Loren,2,0,50,48
1656214448148,CSE 15L,A02,083655,Morris; Justin Loren,4,0,50,46
1656214454172,CSE 20,A01,083657,Tran; Khoa Dang,30,0,80,50
1656214460198,CSE 21,A01,095574,Bach; Quang Tran,24,0,48,24
1656214466221,CSE 30,A01,083084,Eldon; John,2,8,80,78
1656214466221,CSE 30,B01,095061,Bhaskar; Nishant,1,2,50,49
1656214472245,CSE 100,A01,083659,Cao; Yingjun,2,20,70,68
1656214478270,CSE 134B,A01,083661,Powell; Thomas Allan,2,0,100,98
1656214484298,CSE 140,A01,083663,Gungor; Onat,9,0,85,76
1656214490322,CSE 140L,A01,083088,Eldon; John,8,0,100,92
1656214496345,CSE 175,A01,083665,Kumar; Rakesh,0,0,25,25
1656214502373,CSE 190,A00,092507,Dubnov; Shlomo,3,0,20,17
1656214508397,ECE 45,A01,083139,Congero; Spencer William,1,0,75,74
1656214514421,ECE 65,A50,083695,Saad; Andrew S,9,0,30,21
1656214514421,ECE 65,A51,095125,Staff,23,0,26,3
1656214520446,ECE 109,A01,091882,Touri; Behrouz,0,1,70,70
1656214526469,ECE 180,A00,083140,Abi Samra; Nicholas Camill,1,0,30,29
1656214526469,ECE 180,B00,083141,Abi Samra; Nicholas Camill,0,4,30,30
1656214532499,MATH 10A,A01,083735,Patchell; Gregory David,0,0,30,30
1656214532499,MATH 10A,A02,083736,Patchell; Gregory David,22,0,30,8
1656214532499,MATH 10A,A03,083737,Patchell; Gregory David,16,0,30,14
1656214538540,MATH 10B,A01,083207,Lim; Seonhee,0,0,34,34
1656214538540,MATH 10B,A02,083208,Lim; Seonhee,7,0,35,28
1656214538540,MATH 10B,A03,093472,Staff,1,0,34,33
1656214538540,MATH 10B,B01,083739,Sinha; Shubham,11,0,30,19
1656214544566,MATH 18,A01,083743,Cinel; Cameron Alexander,7,0,30,23
1656214544566,MATH 18,A02,083744,Cinel; Cameron Alexander,10,0,30,20
1656214544566,MATH 18,A03,083745,Cinel; Cameron Alexander,5,0,30,25
1656214544566,MATH 18,B01,083748,Rideout; David Porter,0,0,36,36
1656214544566,MATH 18,B02,083749,Rideout; David Porter,0,0,36,36
1656214544566,MATH 18,B03,083750,Rideout; David Porter,0,0,36,36
1656214544566,MATH 18,B04,083751,Rideout; David Porter,0,1,36,36
1656214544566,MATH 18,B05,093473,Rideout; David Porter,0,0,36,36
1656214544566,MATH 18,B06,093474,Rideout; David Porter,3,0,36,33
1656214550589,MATH 20A,A01,083754,Zheng; Zequn,11,0,40,29
1656214556612,MATH 20B,A01,083756,Briones; Jor-el Thomas Caparas,0,0,36,36
1656214556612,MATH 20B,A02,083757,Briones; Jor-el Thomas Caparas,0,0,36,36
1656214556612,MATH 20B,A03,093475,Staff,1,0,36,35
1656214562637,MATH 20C,A01,083760,Briones; Jor-el Thomas Caparas,0,0,35,35
1656214562637,MATH 20C,A02,083761,Briones; Jor-el Thomas Caparas,9,1,35,26
1656214562637,MATH 20C,A03,093476,Staff,0,0,35,35
1656214562637,MATH 20C,B01,083762,Bach; Quang Tran,1,0,30,29
1656214568666,MATH 20D,A01,083765,Tran; Brian Kha,1,0,30,29
1656214568666,MATH 20D,A02,083766,Tran; Brian Kha,0,1,30,30
1656214568666,MATH 20D,A03,083767,Tran; Brian Kha,2,0,30,28
1656214574688,MATH 20E,A01,083771,Ganguly; Soumya,3,0,32,29
1656214574688,MATH 20E,A02,083772,Ganguly; Soumya,0,0,32,32
1656214574688,MATH 20E,B01,083773,Ciotti; Benjamin,16,0,35,19
1656214574688,MATH 20E,B02,083774,Ciotti; Benjamin,15,0,35,20
1656214580717,MATH 103A,A01,083777,Greenfeld; Be'Eri,1,0,36,35
1656214580717,MATH 103A,A02,083778,Greenfeld; Be'Eri,1,0,36,35
1656214580717,MATH 103A,A03,093561,Staff,5,0,36,31
1656214580717,MATH 103A,B01,083779,Greenfeld; Be'Eri,9,1,36,27
1656214580717,MATH 103A,B02,083780,Greenfeld; Be'Eri,1,0,36,35
1656214580717,MATH 103A,B03,093562,Staff,0,0,36,36
1656214586742,MATH 105,A01,085443,Carter; Anne Toulson,5,1,35,30
1656214586742,MATH 105,A02,093477,Staff,14,0,35,21
1656214592766,MATH 109,A01,083213,Ganzberger; Geoffrey Michael,0,0,34,34
1656214592766,MATH 109,A02,083214,Ganzberger; Geoffrey Michael,0,0,34,34
1656214592766,MATH 109,A03,093478,Staff,1,0,34,33
1656214592766,MATH 109,B01,083215,Ganzberger; Geoffrey Michael,4,0,32,28
1656214592766,MATH 109,B02,083216,Ganzberger; Geoffrey Michael,1,0,32,31
1656214592766,MATH 109,B03,093479,Staff,4,0,32,28
1656214598795,MATH 142A,A01,083219,Chow; Bennett,2,0,32,30
1656214598795,MATH 142A,A02,083220,Chow; Bennett,8,0,32,24
1656214598795,MATH 142A,A03,093480,Staff,5,0,32,27
1656214598795,MATH 142A,B03,093481,Staff,3,0,32,29
1656214598795,MATH 142A,B04,093558,Staff,6,0,32,26
1656214598795,MATH 142A,B05,093559,Staff,1,0,32,31
1656214604819,MATH 193A,A01,083224,Rotar; Vladimir,0,1,34,34
1656214604819,MATH 193A,A02,083225,Rotar; Vladimir,0,0,34,34
1656214604819,MATH 193A,A03,083781,Rotar; Vladimir,0,0,34,34
1656214604819,MATH 193A,A04,083782,Rotar; Vladimir,6,0,34,28
1656214604819,MATH 193A,A05,093482,Rotar; Vladimir,0,0,34,34
1656214610846,MATH 197,001,091859,McAuley; Julian John,9999,0,9999,0
1656214610846,MATH 197,002,095566,Kedlaya; Kiran S.,9997,0,9999,2
1656214610846,MATH 197,003,095567,Xiao; Ming,9999,0,9999,0
1656214610846,MATH 197,004,095571,Perols; Johan Lars,9998,0,9999,1
1656214617898,COGS 9,A01,083615,Shannon; Kyle Michael,3,0,75,72
1656214623925,COGS 11,A01,083617,Boyle; Mary E. T.,14,0,48,34
1656214629948,COGS 13,A01,083071,Bastos; Amalia Pinkusfeld,5,0,71,66
1656214635972,COGS 14A,A01,092681,Semenuks; Arturs,4,16,100,96
1656214641996,COGS 14B,A01,083073,Cheng; Tzu-Han,7,0,63,56
1656214648022,COGS 17,A01,092677,Semenuks; Arturs,7,0,81,74
1656214654045,COGS 100,A01,083619,Allen; Michael Gordon,2,0,70,68
1656214660081,COGS 101A,A01,083621,Davis; Joshua Daniel,4,0,68,64
1656214666109,COGS 101B,A01,091572,Allen; Michael Gordon,4,0,65,61
1656214672134,COGS 101C,A01,083625,Delgado; Tania,10,0,35,25
1656214678158,COGS 107A,A01,083627,Boyle; Mary E. T.,0,0,60,60
1656214684181,COGS 118A,A01,083075,Gupta; Anjum,7,0,76,69
1656214690206,CSE 3,A50,083646,Miranda; Gregory Joseph,18,0,50,32
1656214696234,CSE 8A,A50,083650,Miranda; Gregory Joseph,3,3,56,53
1656214702260,CSE 11,A01,083080,Cao; Yingjun,1,50,40,39
1656214708282,CSE 12,A01,083652,Krause-Levy; Sophia Louisa,7,3,120,113
1656214714309,CSE 15L,A01,083654,Morris; Justin Loren,2,0,50,48
1656214714309,CSE 15L,A02,083655,Morris; Justin Loren,4,0,50,46
1656214720332,CSE 20,A01,083657,Tran; Khoa Dang,30,0,80,50
1656214726358,CSE 21,A01,095574,Bach; Quang Tran,24,0,48,24
1656214732394,CSE 30,A01,083084,Eldon; John,2,8,80,78
1656214732394,CSE 30,B01,095061,Bhaskar; Nishant,1,2,50,49
1656214738421,CSE 100,A01,083659,Cao; Yingjun,2,20,70,68
1656214744444,CSE 134B,A01,083661,Powell; Thomas Allan,2,0,100,98
1656214750469,CSE 140,A01,083663,Gungor; Onat,9,0,85,76
1656214756493,CSE 140L,A01,083088,Eldon; John,8,0,100,92
1656214762516,CSE 175,A01,083665,Kumar; Rakesh,0,0,25,25
1656214768542,CSE 190,A00,092507,Dubnov; Shlomo,3,0,20,17
1656214774569,ECE 45,A01,083139,Congero; Spencer William,1,0,75,74
1656214780595,ECE 65,A50,083695,Saad; Andrew S,9,0,30,21
1656214780595,ECE 65,A51,095125,Staff,23,0,26,3
1656214786618,ECE 109,A01,091882,Touri; Behrouz,0,1,70,70
1656214792640,ECE 180,A00,083140,Abi Samra; Nicholas Camill,1,0,30,29
1656214792640,ECE 180,B00,083141,Abi Samra; Nicholas Camill,0,4,30,30
1656214798666,MATH 10A,A01,083735,Patchell; Gregory David,0,0,30,30
1656214798666,MATH 10A,A02,083736,Patchell; Gregory David,22,0,30,8
1656214798666,MATH 10A,A03,083737,Patchell; Gregory David,16,0,30,14
1656214804690,MATH 10B,A01,083207,Lim; Seonhee,0,0,34,34
1656214804690,MATH 10B,A02,083208,Lim; Seonhee,7,0,35,28
1656214804690,MATH 10B,A03,093472,Staff,1,0,34,33
1656214804690,MATH 10B,B01,083739,Sinha; Shubham,11,0,30,19
1656214810729,MATH 18,A01,083743,Cinel; Cameron Alexander,7,0,30,23
1656214810729,MATH 18,A02,083744,Cinel; Cameron Alexander,10,0,30,20
1656214810729,MATH 18,A03,083745,Cinel; Cameron Alexander,5,0,30,25
1656214810729,MATH 18,B01,083748,Rideout; David Porter,0,0,36,36
1656214810729,MATH 18,B02,083749,Rideout; David Porter,0,0,36,36
1656214810729,MATH 18,B03,083750,Rideout; David Porter,0,0,36,36
1656214810729,MATH 18,B04,083751,Rideout; David Porter,0,1,36,36
1656214810729,MATH 18,B05,093473,Rideout; David Porter,0,0,36,36
1656214810729,MATH 18,B06,093474,Rideout; David Porter,3,0,36,33
1656214816752,MATH 20A,A01,083754,Zheng; Zequn,11,0,40,29
1656214822776,MATH 20B,A01,083756,Briones; Jor-el Thomas Caparas,0,0,36,36
1656214822776,MATH 20B,A02,083757,Briones; Jor-el Thomas Caparas,0,0,36,36
1656214822776,MATH 20B,A03,093475,Staff,1,0,36,35
1656214828803,MATH 20C,A01,083760,Briones; Jor-el Thomas Caparas,0,0,35,35
1656214828803,MATH 20C,A02,083761,Briones; Jor-el Thomas Caparas,9,1,35,26
1656214828803,MATH 20C,A03,093476,Staff,0,0,35,35
1656214828803,MATH 20C,B01,083762,Bach; Quang Tran,1,0,30,29
1656214834830,MATH 20D,A01,083765,Tran; Brian Kha,1,0,30,29
1656214834830,MATH 20D,A02,083766,Tran; Brian Kha,0,1,30,30
1656214834830,MATH 20D,A03,083767,Tran; Brian Kha,2,0,30,28
1656214840859,MATH 20E,A01,083771,Ganguly; Soumya,3,0,32,29
1656214840859,MATH 20E,A02,083772,Ganguly; Soumya,0,0,32,32
1656214840859,MATH 20E,B01,083773,Ciotti; Benjamin,16,0,35,19
1656214840859,MATH 20E,B02,083774,Ciotti; Benjamin,15,0,35,20
1656214846889,MATH 103A,A01,083777,Greenfeld; Be'Eri,1,0,36,35
1656214846889,MATH 103A,A02,083778,Greenfeld; Be'Eri,1,0,36,35
1656214846889,MATH 103A,A03,093561,Staff,5,0,36,31
1656214846889,MATH 103A,B01,083779,Greenfeld; Be'Eri,9,1,36,27
1656214846889,MATH 103A,B02,083780,Greenfeld; Be'Eri,1,0,36,35
1656214846889,MATH 103A,B03,093562,Staff,0,0,36,36
1656214852916,MATH 105,A01,085443,Carter; Anne Toulson,5,1,35,30
1656214852916,MATH 105,A02,093477,Staff,14,0,35,21
1656214858940,MATH 109,A01,083213,Ganzberger; Geoffrey Michael,0,0,34,34
1656214858940,MATH 109,A02,083214,Ganzberger; Geoffrey Michael,0,0,34,34
1656214858940,MATH 109,A03,093478,Staff,1,0,34,33
1656214858940,MATH 109,B01,083215,Ganzberger; Geoffrey Michael,4,0,32,28
1656214858940,MATH 109,B02,083216,Ganzberger; Geoffrey Michael,1,0,32,31
1656214858940,MATH 109,B03,093479,Staff,4,0,32,28
1656214864967,MATH 142A,A01,083219,Chow; Bennett,2,0,32,30
1656214864967,MATH 142A,A02,083220,Chow; Bennett,8,0,32,24
1656214864967,MATH 142A,A03,093480,Staff,5,0,32,27
1656214864967,MATH 142A,B03,093481,Staff,3,0,32,29
1656214864967,MATH 142A,B04,093558,Staff,6,0,32,26
1656214864967,MATH 142A,B05,093559,Staff,1,0,32,31
1656214870991,MATH 193A,A01,083224,Rotar; Vladimir,0,1,34,34
1656214870991,MATH 193A,A02,083225,Rotar; Vladimir,0,0,34,34
1656214870991,MATH 193A,A03,083781,Rotar; Vladimir,0,0,34,34
1656214870991,MATH 193A,A04,083782,Rotar; Vladimir,6,0,34,28
1656214870991,MATH 193A,A05,093482,Rotar; Vladimir,0,0,34,34
1656214877014,MATH 197,001,091859,McAuley; Julian John,9999,0,9999,0
1656214877014,MATH 197,002,095566,Kedlaya; Kiran S.,9997,0,9999,2
1656214877014,MATH 197,003,095567,Xiao; Ming,9999,0,9999,0
1656214877014,MATH 197,004,095571,Perols; Johan Lars,9998,0,9999,1
1656214884066,COGS 9,A01,083615,Shannon; Kyle Michael,3,0,75,72
1656214890092,COGS 11,A01,083617,Boyle; Mary E. T.,14,0,48,34
1656214896120,COGS 13,A01,083071,Bastos; Amalia Pinkusfeld,5,0,71,66
1656214902146,COGS 14A,A01,092681,Semenuks; Arturs,4,16,100,96
1656214908180,COGS 14B,A01,083073,Cheng; Tzu-Han,7,0,63,56
1656214914298,COGS 17,A01,092677,Semenuks; Arturs,7,0,81,74
1656214920321,COGS 100,A01,083619,Allen; Michael Gordon,2,0,70,68
1656214926345,COGS 101A,A01,083621,Davis; Joshua Daniel,4,0,68,64
1656214932368,COGS 101B,A01,091572,Allen; Michael Gordon,4,0,65,61
1656214938391,COGS 101C,A01,083625,Delgado; Tania,10,0,35,25
1656214944415,COGS 107A,A01,083627,Boyle; Mary E. T.,0,0,60,60
1656214950437,COGS 118A,A01,083075,Gupta; Anjum,7,0,76,69
1656214956470,CSE 3,A50,083646,Miranda; Gregory Joseph,18,0,50,32
1656214962493,CSE 8A,A50,083650,Miranda; Gregory Joseph,3,3,56,53
1656214968518,CSE 11,A01,083080,Cao; Yingjun,1,50,40,39
1656214974542,CSE 12,A01,083652,Krause-Levy; Sophia Louisa,7,3,120,113
1656214980574,CSE 15L,A01,083654,Morris; Justin Loren,2,0,50,48
1656214980574,CSE 15L,A02,083655,Morris; Justin Loren,4,0,50,46
1656214986603,CSE 20,A01,083657,Tran; Khoa Dang,30,0,80,50
1656214992626,CSE 21,A01,095574,Bach; Quang Tran,24,0,48,24
1656214998653,CSE 30,A01,083084,Eldon; John,2,8,80,78
1656214998653,CSE 30,B01,095061,Bhaskar; Nishant,1,2,50,49
1656215004677,CSE 100,A01,083659,Cao; Yingjun,2,20,70,68
1656215010703,CSE 134B,A01,083661,Powell; Thomas Allan,2,0,100,98
1656215016729,CSE 140,A01,083663,Gungor; Onat,9,0,85,76
1656215022760,CSE 140L,A01,083088,Eldon; John,8,0,100,92
1656215028783,CSE 175,A01,083665,Kumar; Rakesh,0,0,25,25
1656215034809,CSE 190,A00,092507,Dubnov; Shlomo,3,0,20,17
1656215040836,ECE 45,A01,083139,Congero; Spencer William,1,0,75,74
1656215046870,ECE 65,A50,083695,Saad; Andrew S,9,0,30,21
1656215046870,ECE 65,A51,095125,Staff,23,0,26,3
1656215052893,ECE 109,A01,091882,Touri; Behrouz,0,1,70,70
1656215058915,ECE 180,A00,083140,Abi Samra; Nicholas Camill,1,0,30,29
1656215058915,ECE 180,B00,083141,Abi Samra; Nicholas Camill,0,4,30,30
1656215064943,MATH 10A,A01,083735,Patchell; Gregory David,0,0,30,30
1656215064943,MATH 10A,A02,083736,Patchell; Gregory David,22,0,30,8
1656215064943,MATH 10A,A03,083737,Patchell; Gregory David,16,0,30,14
1656215070974,MATH 10B,A01,083207,Lim; Seonhee,0,0,34,34
1656215070974,MATH 10B,A02,083208,Lim; Seonhee,7,0,35,28
1656215070974,MATH 10B,A03,093472,Staff,1,0,34,33
1656215070974,MATH 10B,B01,083739,Sinha; Shubham,11,0,30,19
1656215077004,MATH 18,A01,083743,Cinel; Cameron Alexander,7,0,30,23
1656215077004,MATH 18,A02,083744,Cinel; Cameron Alexander,10,0,30,20
1656215077004,MATH 18,A03,083745,Cinel; Cameron Alexander,5,0,30,25
1656215077004,MATH 18,B01,083748,Rideout; David Porter,0,0,36,36
1656215077004,MATH 18,B02,083749,Rideout; David Porter,0,0,36,36
1656215077004,MATH 18,B03,083750,Rideout; David Porter,0,0,36,36
1656215077004,MATH 18,B04,083751,Rideout; David Porter,0,1,36,36
1656215077004,MATH 18,B05,093473,Rideout; David Porter,0,0,36,36
1656215077004,MATH 18,B06,093474,Rideout; David Porter,3,0,36,33
1656215083028,MATH 20A,A01,083754,Zheng; Zequn,11,0,40,29
1656215089052,MATH 20B,A01,083756,Briones; Jor-el Thomas Caparas,0,0,36,36
1656215089052,MATH 20B,A02,083757,Briones; Jor-el Thomas Caparas,0,0,36,36
1656215089052,MATH 20B,A03,093475,Staff,1,0,36,35
1656215095075,MATH 20C,A01,083760,Briones; Jor-el Thomas Caparas,0,0,35,35
1656215095075,MATH 20C,A02,083761,Briones; Jor-el Thomas Caparas,9,1,35,26
1656215095075,MATH 20C,A03,093476,Staff,0,0,35,35
1656215095075,MATH 20C,B01,083762,Bach; Quang Tran,1,0,30,29
1656215101100,MATH 20D,A01,083765,Tran; Brian Kha,1,0,30,29
1656215101100,MATH 20D,A02,083766,Tran; Brian Kha,0,1,30,30
1656215101100,MATH 20D,A03,083767,Tran; Brian Kha,2,0,30,28
1656215107123,MATH 20E,A01,083771,Ganguly; Soumya,3,0,32,29
1656215107123,MATH 20E,A02,083772,Ganguly; Soumya,0,0,32,32
1656215107123,MATH 20E,B01,083773,Ciotti; Benjamin,16,0,35,19
1656215107123,MATH 20E,B02,083774,Ciotti; Benjamin,15,0,35,20
1656215113151,MATH 103A,A01,083777,Greenfeld; Be'Eri,1,0,36,35
1656215113151,MATH 103A,A02,083778,Greenfeld; Be'Eri,1,0,36,35
1656215113151,MATH 103A,A03,093561,Staff,5,0,36,31
1656215113151,MATH 103A,B01,083779,Greenfeld; Be'Eri,9,1,36,27
1656215113151,MATH 103A,B02,083780,Greenfeld; Be'Eri,1,0,36,35
1656215113151,MATH 103A,B03,093562,Staff,0,0,36,36
1656215119175,MATH 105,A01,085443,Carter; Anne Toulson,5,1,35,30
1656215119175,MATH 105,A02,093477,Staff,14,0,35,21
1656215125203,MATH 109,A01,083213,Ganzberger; Geoffrey Michael,0,0,34,34
1656215125203,MATH 109,A02,083214,Ganzberger; Geoffrey Michael,0,0,34,34
1656215125203,MATH 109,A03,093478,Staff,1,0,34,33
1656215125203,MATH 109,B01,083215,Ganzberger; Geoffrey Michael,4,0,32,28
1656215125203,MATH 109,B02,083216,Ganzberger; Geoffrey Michael,1,0,32,31
1656215125203,MATH 109,B03,093479,Staff,4,0,32,28
1656215131229,MATH 142A,A01,083219,Chow; Bennett,2,0,32,30
1656215131229,MATH 142A,A02,083220,Chow; Bennett,8,0,32,24
1656215131229,MATH 142A,A03,093480,Staff,5,0,32,27
1656215131229,MATH 142A,B03,093481,Staff,3,0,32,29
1656215131229,MATH 142A,B04,093558,Staff,6,0,32,26
1656215131229,MATH 142A,B05,093559,Staff,1,0,32,31
1656215137253,MATH 193A,A01,083224,Rotar; Vladimir,0,1,34,34
1656215137253,MATH 193A,A02,083225,Rotar; Vladimir,0,0,34,34
1656215137253,MATH 193A,A03,083781,Rotar; Vladimir,0,0,34,34
1656215137253,MATH 193A,A04,083782,Rotar; Vladimir,6,0,34,28
1656215137253,MATH 193A,A05,093482,Rotar; Vladimir,0,0,34,34
1656215143275,MATH 197,001,091859,McAuley; Julian John,9999,0,9999,0
1656215143275,MATH 197,002,095566,Kedlaya; Kiran S.,9997,0,9999,2
1656215143275,MATH 197,003,095567,Xiao; Ming,9999,0,9999,0
1656215143275,MATH 197,004,095571,Perols; Johan Lars,9998,0,9999,1
1656215150349,COGS 9,A01,083615,Shannon; Kyle Michael,3,0,75,72
1656215156377,COGS 11,A01,083617,Boyle; Mary E. T.,14,0,48,34
1656215162403,COGS 13,A01,083071,Bastos; Amalia Pinkusfeld,5,0,71,66
1656215168427,COGS 14A,A01,092681,Semenuks; Arturs,4,16,100,96
1656215174460,COGS 14B,A01,083073,Cheng; Tzu-Han,7,0,63,56
1656215180486,COGS 17,A01,092677,Semenuks; Arturs,7,0,81,74
1656215186509,COGS 100,A01,083619,Allen; Michael Gordon,2,0,70,68
1656215192537,COGS 101A,A01,083621,Davis; Joshua Daniel,4,0,68,64
1656215198560,COGS 101B,A01,091572,Allen; Michael Gordon,4,0,65,61
1656215204583,COGS 101C,A01,083625,Delgado; Tania,10,0,35,25
1656215210606,COGS 107A,A01,083627,Boyle; Mary E. T.,0,0,60,60
1656215216637,COGS 118A,A01,083075,Gupta; Anjum,7,0,76,69
1656215222665,CSE 3,A50,083646,Miranda; Gregory Joseph,18,0,50,32
1656215228694,CSE 8A,A50,083650,Miranda; Gregory Joseph,3,3,56,53
1656215234717,CSE 11,A01,083080,Cao; Yingjun,1,50,40,39
1656215240739,CSE 12,A01,083652,Krause-Levy; Sophia Louisa,7,3,120,113
1656215246763,CSE 15L,A01,083654,Morris; Justin Loren,2,0,50,48
1656215246763,CSE 15L,A02,083655,Morris; Justin Loren,4,0,50,46
1656215252786,CSE 20,A01,083657,Tran; Khoa Dang,30,0,80,50
1656215258809,CSE 21,A01,095574,Bach; Quang Tran,24,0,48,24
1656215264832,CSE 30,A01,083084,Eldon; John,2,8,80,78
1656215264832,CSE 30,B01,095061,Bhaskar; Nishant,1,2,50,49
1656215270855,CSE 100,A01,083659,Cao; Yingjun,2,20,70,68
1656215276882,CSE 134B,A01,083661,Powell; Thomas Allan,2,0,100,98
1656215282906,CSE 140,A01,083663,Gungor; Onat,9,0,85,76
1656215288931,CSE 140L,A01,083088,Eldon; John,8,0,100,92
1656215294958,CSE 175,A01,083665,Kumar; Rakesh,0,0,25,25
1656215300984,CSE 190,A00,092507,Dubnov; Shlomo,3,0,20,17
1656215307007,ECE 45,A01,083139,Congero; Spencer William,1,0,75,74
1656215313033,ECE 65,A50,083695,Saad; Andrew S,9,0,30,21
1656215313033,ECE 65,A51,095125,Staff,23,0,26,3
1656215319057,ECE 109,A01,091882,Touri; Behrouz,0,1,70,70
1656215325084,ECE 180,A00,083140,Abi Samra; Nicholas Camill,1,0,30,29
1656215325084,ECE 180,B00,083141,Abi Samra; Nicholas Camill,0,4,30,30
1656215331108,MATH 10A,A01,083735,Patchell; Gregory David,0,0,30,30
1656215331108,MATH 10A,A02,083736,Patchell; Gregory David,22,0,30,8
1656215331108,MATH 10A,A03,083737,Patchell; Gregory David,16,0,30,14
1656215337145,MATH 10B,A01,083207,Lim; Seonhee,0,0,34,34
1656215337145,MATH 10B,A02,083208,Lim; Seonhee,7,0,35,28
1656215337145,MATH 10B,A03,093472,Staff,1,0,34,33
1656215337145,MATH 10B,B01,083739,Sinha; Shubham,11,0,30,19
1656215343171,MATH 18,A01,083743,Cinel; Cameron Alexander,7,0,30,23
1656215343171,MATH 18,A02,083744,Cinel; Cameron Alexander,10,0,30,20
1656215343171,MATH 18,A03,083745,Cinel; Cameron Alexander,5,0,30,25
1656215343171,MATH 18,B01,083748,Rideout; David Porter,0,0,36,36
1656215343171,MATH 18,B02,083749,Rideout; David Porter,0,0,36,36
1656215343171,MATH 18,B03,083750,Rideout; David Porter,0,0,36,36
1656215343171,MATH 18,B04,083751,Rideout; David Porter,0,1,36,36
1656215343171,MATH 18,B05,093473,Rideout; David Porter,0,0,36,36
1656215343171,MATH 18,B06,093474,Rideout; David Porter,3,0,36,33
1656215349192,MATH 20A,A01,083754,Zheng; Zequn,11,0,40,29
1656215355220,MATH 20B,A01,083756,Briones; Jor-el Thomas Caparas,0,0,36,36
1656215355220,MATH 20B,A02,083757,Briones; Jor-el Thomas Caparas,0,0,36,36
1656215355220,MATH 20B,A03,093475,Staff,1,0,36,35
1656215361260,MATH 20C,A01,083760,Briones; Jor-el Thomas Caparas,0,0,35,35
1656215361260,MATH 20C,A02,083761,Briones; Jor-el Thomas Caparas,9,1,35,26
1656215361260,MATH 20C,A03,093476,Staff,0,0,35,35
1656215361260,MATH 20C,B01,083762,Bach; Quang Tran,1,0,30,29
1656215367282,MATH 20D,A01,083765,Tran; Brian Kha,1,0,30,29
1656215367282,MATH 20D,A02,083766,Tran; Brian Kha,0,1,30,30
1656215367282,MATH 20D,A03,083767,Tran; Brian Kha,2,0,30,28
1656215373309,MATH 20E,A01,083771,Ganguly; Soumya,3,0,32,29
1656215373309,MATH 20E,A02,083772,Ganguly; Soumya,0,0,32,32
1656215373309,MATH 20E,B01,083773,Ciotti; Benjamin,16,0,35,19
1656215373309,MATH 20E,B02,083774,Ciotti; Benjamin,15,0,35,20
1656215379333,MATH 103A,A01,083777,Greenfeld; Be'Eri,1,0,36,35
1656215379333,MATH 103A,A02,083778,Greenfeld; Be'Eri,1,0,36,35
1656215379333,MATH 103A,A03,093561,Staff,5,0,36,31
1656215379333,MATH 103A,B01,083779,Greenfeld; Be'Eri,9,1,36,27
1656215379333,MATH 103A,B02,083780,Greenfeld; Be'Eri,1,0,36,35
1656215379333,MATH 103A,B03,093562,Staff,0,0,36,36
1656215385357,MATH 105,A01,085443,Carter; Anne Toulson,5,1,35,30
1656215385357,MATH 105,A02,093477,Staff,14,0,35,21
1656215391382,MATH 109,A01,083213,Ganzberger; Geoffrey Michael,0,0,34,34
1656215391382,MATH 109,A02,083214,Ganzberger; Geoffrey Michael,0,0,34,34
1656215391382,MATH 109,A03,093478,Staff,1,0,34,33
1656215391382,MATH 109,B01,083215,Ganzberger; Geoffrey Michael,4,0,32,28
1656215391382,MATH 109,B02,083216,Ganzberger; Geoffrey Michael,1,0,32,31
1656215391382,MATH 109,B03,093479,Staff,4,0,32,28
1656215397412,MATH 142A,A01,083219,Chow; Bennett,2,0,32,30
1656215397412,MATH 142A,A02,083220,Chow; Bennett,8,0,32,24
1656215397412,MATH 142A,A03,093480,Staff,5,0,32,27
1656215397412,MATH 142A,B03,093481,Staff,3,0,32,29
1656215397412,MATH 142A,B04,093558,Staff,6,0,32,26
1656215397412,MATH 142A,B05,093559,Staff,1,0,32,31
1656215403436,MATH 193A,A01,083224,Rotar; Vladimir,0,1,34,34
1656215403436,MATH 193A,A02,083225,Rotar; Vladimir,0,0,34,34
1656215403436,MATH 193A,A03,083781,Rotar; Vladimir,0,0,34,34
1656215403436,MATH 193A,A04,083782,Rotar; Vladimir,6,0,34,28
1656215403436,MATH 193A,A05,093482,Rotar; Vladimir,0,0,34,34
1656215409472,MATH 197,001,091859,McAuley; Julian John,9999,0,9999,0
1656215409472,MATH 197,002,095566,Kedlaya; Kiran S.,9997,0,9999,2
1656215409472,MATH 197,003,095567,Xiao; Ming,9999,0,9999,0
1656215409472,MATH 197,004,095571,Perols; Johan Lars,9998,0,9999,1
1656215416536,COGS 9,A01,083615,Shannon; Kyle Michael,3,0,75,72
1656215422566,COGS 11,A01,083617,Boyle; Mary E. T.,14,0,48,34
1656215428590,COGS 13,A01,083071,Bastos; Amalia Pinkusfeld,5,0,71,66
1656215434613,COGS 14A,A01,092681,Semenuks; Arturs,4,16,100,96
1656215440635,COGS 14B,A01,083073,Cheng; Tzu-Han,7,0,63,56
1656215446658,COGS 17,A01,092677,Semenuks; Arturs,7,0,81,74
1656215452682,COGS 100,A01,083619,Allen; Michael Gordon,2,0,70,68
1656215458710,COGS 101A,A01,083621,Davis; Joshua Daniel,4,0,68,64
1656215464733,COGS 101B,A01,091572,Allen; Michael Gordon,4,0,65,61
1656215470761,COGS 101C,A01,083625,Delgado; Tania,10,0,35,25
1656215476785,COGS 107A,A01,083627,Boyle; Mary E. T.,0,0,60,60
1656215482812,COGS 118A,A01,083075,Gupta; Anjum,7,0,76,69
1656215488839,CSE 3,A50,083646,Miranda; Gregory Joseph,18,0,50,32
1656215494869,CSE 8A,A50,083650,Miranda; Gregory Joseph,3,3,56,53
1656215500892,CSE 11,A01,083080,Cao; Yingjun,1,50,40,39
1656215506919,CSE 12,A01,083652,Krause-Levy; Sophia Louisa,7,3,120,113
1656215513035,CSE 15L,A01,083654,Morris; Justin Loren,2,0,50,48
1656215513035,CSE 15L,A02,083655,Morris; Justin Loren,4,0,50,46
1656215519059,CSE 20,A01,083657,Tran; Khoa Dang,30,0,80,50
1656215525088,CSE 21,A01,095574,Bach; Quang Tran,24,0,48,24
1656215531112,CSE 30,A01,083084,Eldon; John,2,8,80,78
1656215531112,CSE 30,B01,095061,Bhaskar; Nishant,1,2,50,49
1656215537133,CSE 100,A01,083659,Cao; Yingjun,2,20,70,68
1656215543157,CSE 134B,A01,083661,Powell; Thomas Allan,2,0,100,98
1656215549182,CSE 140,A01,083663,Gungor; Onat,9,0,85,76
1656215555208,CSE 140L,A01,083088,Eldon; John,8,0,100,92
1656215561232,CSE 175,A01,083665,Kumar; Rakesh,0,0,25,25
1656215567255,CSE 190,A00,092507,Dubnov; Shlomo,3,0,20,17
1656215573283,ECE 45,A01,083139,Congero; Spencer William,1,0,75,74
1656215579307,ECE 65,A50,083695,Saad; Andrew S,9,0,30,21
1656215579307,ECE 65,A51,095125,Staff,23,0,26,3
1656215585335,ECE 109,A01,091882,Touri; Behrouz,0,1,70,70
1656215591358,ECE 180,A00,083140,Abi Samra; Nicholas Camill,1,0,30,29
1656215591358,ECE 180,B00,083141,Abi Samra; Nicholas Camill,0,4,30,30
1656215597387,MATH 10A,A01,083735,Patchell; Gregory David,0,0,30,30
1656215597387,MATH 10A,A02,083736,Patchell; Gregory David,22,0,30,8
1656215597387,MATH 10A,A03,083737,Patchell; Gregory David,16,0,30,14
1656215603416,MATH 10B,A01,083207,Lim; Seonhee,0,0,34,34
1656215603416,MATH 10B,A02,083208,Lim; Seonhee,7,0,35,28
1656215603416,MATH 10B,A03,093472,Staff,1,0,34,33
1656215603416,MATH 10B,B01,083739,Sinha; Shubham,11,0,30,19
1656215609440,MATH 18,A01,083743,Cinel; Cameron Alexander,7,0,30,23
1656215609440,MATH 18,A02,083744,Cinel; Cameron Alexander,10,0,30,20
1656215609440,MATH 18,A03,083745,Cinel; Cameron Alexander,5,0,30,25
1656215609440,MATH 18,B01,083748,Rideout; David Porter,0,0,36,36
1656215609440,MATH 18,B02,083749,Rideout; David Porter,0,0,36,36
1656215609440,MATH 18,B03,083750,Rideout; David Porter,0,0,36,36
1656215609440,MATH 18,B04,083751,Rideout; David Porter,0,1,36,36
1656215609440,MATH 18,B05,093473,Rideout; David Porter,0,0,36,36
1656215609440,MATH 18,B06,093474,Rideout; David Porter,3,0,36,33
1656215615464,MATH 20A,A01,083754,Zheng; Zequn,11,0,40,29
1656215621491,MATH 20B,A01,083756,Briones; Jor-el Thomas Caparas,0,0,36,36
1656215621491,MATH 20B,A02,083757,Briones; Jor-el Thomas Caparas,0,0,36,36
1656215621491,MATH 20B,A03,093475,Staff,1,0,36,35
1656215627520,MATH 20C,A01,083760,Briones; Jor-el Thomas Caparas,0,0,35,35
1656215627520,MATH 20C,A02,083761,Briones; Jor-el Thomas Caparas,9,1,35,26
1656215627520,MATH 20C,A03,093476,Staff,0,0,35,35
1656215627520,MATH 20C,B01,083762,Bach; Quang Tran,1,0,30,29
1656215633544,MATH 20D,A01,083765,Tran; Brian Kha,1,0,30,29
1656215633544,MATH 20D,A02,083766,Tran; Brian Kha,0,1,30,30
1656215633544,MATH 20D,A03,083767,Tran; Brian Kha,2,0,30,28
1656215639568,MATH 20E,A01,083771,Ganguly; Soumya,3,0,32,29
1656215639568,MATH 20E,A02,083772,Ganguly; Soumya,0,0,32,32
1656215639568,MATH 20E,B01,083773,Ciotti; Benjamin,16,0,35,19
1656215639568,MATH 20E,B02,083774,Ciotti; Benjamin,15,0,35,20
1656215645607,MATH 103A,A01,083777,Greenfeld; Be'Eri,1,0,36,35
1656215645607,MATH 103A,A02,083778,Greenfeld; Be'Eri,1,0,36,35
1656215645607,MATH 103A,A03,093561,Staff,5,0,36,31
1656215645607,MATH 103A,B01,083779,Greenfeld; Be'Eri,9,1,36,27
1656215645607,MATH 103A,B02,083780,Greenfeld; Be'Eri,1,0,36,35
1656215645607,MATH 103A,B03,093562,Staff,0,0,36,36
1656215651635,MATH 105,A01,085443,Carter; Anne Toulson,5,1,35,30
1656215651635,MATH 105,A02,093477,Staff,14,0,35,21
1656215657660,MATH 109,A01,083213,Ganzberger; Geoffrey Michael,0,0,34,34
1656215657660,MATH 109,A02,083214,Ganzberger; Geoffrey Michael,0,0,34,34
1656215657660,MATH 109,A03,093478,Staff,1,0,34,33
1656215657660,MATH 109,B01,083215,Ganzberger; Geoffrey Michael,4,0,32,28
1656215657660,MATH 109,B02,083216,Ganzberger; Geoffrey Michael,1,0,32,31
1656215657660,MATH 109,B03,093479,Staff,4,0,32,28
1656215663683,MATH 142A,A01,083219,Chow; Bennett,2,0,32,30
1656215663683,MATH 142A,A02,083220,Chow; Bennett,8,0,32,24
1656215663683,MATH 142A,A03,093480,Staff,5,0,32,27
1656215663683,MATH 142A,B03,093481,Staff,3,0,32,29
1656215663683,MATH 142A,B04,093558,Staff,6,0,32,26
1656215663683,MATH 142A,B05,093559,Staff,1,0,32,31
1656215669707,MATH 193A,A01,083224,Rotar; Vladimir,0,1,34,34
1656215669707,MATH 193A,A02,083225,Rotar; Vladimir,0,0,34,34
1656215669707,MATH 193A,A03,083781,Rotar; Vladimir,0,0,34,34
1656215669707,MATH 193A,A04,083782,Rotar; Vladimir,6,0,34,28
1656215669707,MATH 193A,A05,093482,Rotar; Vladimir,0,0,34,34
1656215675730,MATH 197,001,091859,McAuley; Julian John,9999,0,9999,0
1656215675730,MATH 197,002,095566,Kedlaya; Kiran S.,9997,0,9999,2
1656215675730,MATH 197,003,095567,Xiao; Ming,9999,0,9999,0
1656215675730,MATH 197,004,095571,Perols; Johan Lars,9998,0,9999,1
1656215682794,COGS 9,A01,083615,Shannon; Kyle Michael,3,0,75,72
1656215688818,COGS 11,A01,083617,Boyle; Mary E. T.,14,0,48,34
1656215694844,COGS 13,A01,083071,Bastos; Amalia Pinkusfeld,5,0,71,66
1656215700866,COGS 14A,A01,092681,Semenuks; Arturs,4,16,100,96
1656215706902,COGS 14B,A01,083073,Cheng; Tzu-Han,7,0,63,56
1656215712929,COGS 17,A01,092677,Semenuks; Arturs,7,0,81,74
1656215718956,COGS 100,A01,083619,Allen; Michael Gordon,2,0,70,68
1656215724983,COGS 101A,A01,083621,Davis; Joshua Daniel,4,0,68,64
1656215731007,COGS 101B,A01,091572,Allen; Michael Gordon,4,0,65,61
1656215737034,COGS 101C,A01,083625,Delgado; Tania,10,0,35,25
1656215743060,COGS 107A,A01,083627,Boyle; Mary E. T.,0,0,60,60
1656215749084,COGS 118A,A01,083075,Gupta; Anjum,7,0,76,69
1656215755109,CSE 3,A50,083646,Miranda; Gregory Joseph,18,0,50,32
1656215761134,CSE 8A,A50,083650,Miranda; Gregory Joseph,3,3,56,53
1656215767157,CSE 11,A01,083080,Cao; Yingjun,1,50,40,39
1656215773190,CSE 12,A01,083652,Krause-Levy; Sophia Louisa,7,3,120,113
1656215779217,CSE 15L,A01,083654,Morris; Justin Loren,2,0,50,48
1656215779217,CSE 15L,A02,083655,Morris; Justin Loren,4,0,50,46
1656215785242,CSE 20,A01,083657,Tran; Khoa Dang,30,0,80,50
1656215791265,CSE 21,A01,095574,Bach; Quang Tran,24,0,48,24
1656215797289,CSE 30,A01,083084,Eldon; John,2,8,80,78
1656215797289,CSE 30,B01,095061,Bhaskar; Nishant,1,2,50,49
1656215803313,CSE 100,A01,083659,Cao; Yingjun,2,20,70,68
1656215809337,CSE 134B,A01,083661,Powell; Thomas Allan,2,0,100,98
1656215815363,CSE 140,A01,083663,Gungor; Onat,9,0,85,76
1656215821386,CSE 140L,A01,083088,Eldon; John,8,0,100,92
1656215827417,CSE 175,A01,083665,Kumar; Rakesh,0,0,25,25
1656215833446,CSE 190,A00,092507,Dubnov; Shlomo,3,0,20,17
1656215839471,ECE 45,A01,083139,Congero; Spencer William,1,0,75,74
1656215845505,ECE 65,A50,083695,Saad; Andrew S,9,0,30,21
1656215845505,ECE 65,A51,095125,Staff,23,0,26,3
1656215851530,ECE 109,A01,091882,Touri; Behrouz,0,1,70,70
1656215857552,ECE 180,A00,083140,Abi Samra; Nicholas Camill,1,0,30,29
1656215857552,ECE 180,B00,083141,Abi Samra; Nicholas Camill,0,4,30,30
1656215863579,MATH 10A,A01,083735,Patchell; Gregory David,0,0,30,30
1656215863579,MATH 10A,A02,083736,Patchell; Gregory David,22,0,30,8
1656215863579,MATH 10A,A03,083737,Patchell; Gregory David,16,0,30,14
1656215869603,MATH 10B,A01,083207,Lim; Seonhee,0,0,34,34
1656215869603,MATH 10B,A02,083208,Lim; Seonhee,7,0,35,28
1656215869603,MATH 10B,A03,093472,Staff,1,0,34,33
1656215869603,MATH 10B,B01,083739,Sinha; Shubham,11,0,30,19
1656215875626,MATH 18,A01,083743,Cinel; Cameron Alexander,7,0,30,23
1656215875626,MATH 18,A02,083744,Cinel; Cameron Alexander,10,0,30,20
1656215875626,MATH 18,A03,083745,Cinel; Cameron Alexander,5,0,30,25
1656215875626,MATH 18,B01,083748,Rideout; David Porter,0,0,36,36
1656215875626,MATH 18,B02,083749,Rideout; David Porter,0,0,36,36
1656215875626,MATH 18,B03,083750,Rideout; David Porter,0,0,36,36
1656215875626,MATH 18,B04,083751,Rideout; David Porter,0,1,36,36
1656215875626,MATH 18,B05,093473,Rideout; David Porter,0,0,36,36
1656215875626,MATH 18,B06,093474,Rideout; David Porter,3,0,36,33
1656215881651,MATH 20A,A01,083754,Zheng; Zequn,11,0,40,29
1656215887678,MATH 20B,A01,083756,Briones; Jor-el Thomas Caparas,0,0,36,36
1656215887678,MATH 20B,A02,083757,Briones; Jor-el Thomas Caparas,0,0,36,36
1656215887678,MATH 20B,A03,093475,Staff,1,0,36,35
1656215893701,MATH 20C,A01,083760,Briones; Jor-el Thomas Caparas,0,0,35,35
1656215893701,MATH 20C,A02,083761,Briones; Jor-el Thomas Caparas,9,1,35,26
1656215893701,MATH 20C,A03,093476,Staff,0,0,35,35
1656215893701,MATH 20C,B01,083762,Bach; Quang Tran,1,0,30,29
1656215899729,MATH 20D,A01,083765,Tran; Brian Kha,1,0,30,29
1656215899729,MATH 20D,A02,083766,Tran; Brian Kha,0,1,30,30
1656215899729,MATH 20D,A03,083767,Tran; Brian Kha,2,0,30,28
1656215905753,MATH 20E,A01,083771,Ganguly; Soumya,3,0,32,29
1656215905753,MATH 20E,A02,083772,Ganguly; Soumya,0,0,32,32
1656215905753,MATH 20E,B01,083773,Ciotti; Benjamin,16,0,35,19
1656215905753,MATH 20E,B02,083774,Ciotti; Benjamin,15,0,35,20
1656215911794,MATH 103A,A01,083777,Greenfeld; Be'Eri,1,0,36,35
1656215911794,MATH 103A,A02,083778,Greenfeld; Be'Eri,1,0,36,35
1656215911794,MATH 103A,A03,093561,Staff,5,0,36,31
1656215911794,MATH 103A,B01,083779,Greenfeld; Be'Eri,9,1,36,27
1656215911794,MATH 103A,B02,083780,Greenfeld; Be'Eri,1,0,36,35
1656215911794,MATH 103A,B03,093562,Staff,0,0,36,36
1656215917816,MATH 105,A01,085443,Carter; Anne Toulson,5,1,35,30
1656215917816,MATH 105,A02,093477,Staff,14,0,35,21
1656215923845,MATH 109,A01,083213,Ganzberger; Geoffrey Michael,0,0,34,34
1656215923845,MATH 109,A02,083214,Ganzberger; Geoffrey Michael,0,0,34,34
1656215923845,MATH 109,A03,093478,Staff,1,0,34,33
1656215923845,MATH 109,B01,083215,Ganzberger; Geoffrey Michael,4,0,32,28
1656215923845,MATH 109,B02,083216,Ganzberger; Geoffrey Michael,1,0,32,31
1656215923845,MATH 109,B03,093479,Staff,4,0,32,28
1656215929875,MATH 142A,A01,083219,Chow; Bennett,2,0,32,30
1656215929875,MATH 142A,A02,083220,Chow; Bennett,8,0,32,24
1656215929875,MATH 142A,A03,093480,Staff,5,0,32,27
1656215929875,MATH 142A,B03,093481,Staff,3,0,32,29
1656215929875,MATH 142A,B04,093558,Staff,6,0,32,26
1656215929875,MATH 142A,B05,093559,Staff,1,0,32,31
1656215935903,MATH 193A,A01,083224,Rotar; Vladimir,0,1,34,34
1656215935903,MATH 193A,A02,083225,Rotar; Vladimir,0,0,34,34
1656215935903,MATH 193A,A03,083781,Rotar; Vladimir,0,0,34,34
1656215935903,MATH 193A,A04,083782,Rotar; Vladimir,6,0,34,28
1656215935903,MATH 193A,A05,093482,Rotar; Vladimir,0,0,34,34
1656215941927,MATH 197,001,091859,McAuley; Julian John,9999,0,9999,0
1656215941927,MATH 197,002,095566,Kedlaya; Kiran S.,9997,0,9999,2
1656215941927,MATH 197,003,095567,Xiao; Ming,9999,0,9999,0
1656215941927,MATH 197,004,095571,Perols; Johan Lars,9998,0,9999,1
1656215948981,COGS 9,A01,083615,Shannon; Kyle Michael,3,0,75,72
1656215955005,COGS 11,A01,083617,Boyle; Mary E. T.,14,0,48,34
1656215961028,COGS 13,A01,083071,Bastos; Amalia Pinkusfeld,4,0,71,67
1656215967053,COGS 14A,A01,092681,Semenuks; Arturs,4,16,100,96
1656215973075,COGS 14B,A01,083073,Cheng; Tzu-Han,7,0,63,56
1656215979101,COGS 17,A01,092677,Semenuks; Arturs,7,0,81,74
1656215985124,COGS 100,A01,083619,Allen; Michael Gordon,2,0,70,68
1656215991148,COGS 101A,A01,083621,Davis; Joshua Daniel,4,0,68,64
1656215997181,COGS 101B,A01,091572,Allen; Michael Gordon,4,0,65,61
1656216003208,COGS 101C,A01,083625,Delgado; Tania,10,0,35,25
1656216009243,COGS 107A,A01,083627,Boyle; Mary E. T.,0,0,60,60
1656216015266,COGS 118A,A01,083075,Gupta; Anjum,7,0,76,69
1656216021293,CSE 3,A50,083646,Miranda; Gregory Joseph,18,0,50,32
1656216027320,CSE 8A,A50,083650,Miranda; Gregory Joseph,3,3,56,53
1656216033344,CSE 11,A01,083080,Cao; Yingjun,1,50,40,39
1656216039371,CSE 12,A01,083652,Krause-Levy; Sophia Louisa,7,3,120,113
1656216045395,CSE 15L,A01,083654,Morris; Justin Loren,2,0,50,48
1656216045395,CSE 15L,A02,083655,Morris; Justin Loren,4,0,50,46
1656216051416,CSE 20,A01,083657,Tran; Khoa Dang,30,0,80,50
1656216057450,CSE 21,A01,095574,Bach; Quang Tran,24,0,48,24
1656216063474,CSE 30,A01,083084,Eldon; John,2,8,80,78
1656216063474,CSE 30,B01,095061,Bhaskar; Nishant,1,2,50,49
1656216069500,CSE 100,A01,083659,Cao; Yingjun,2,20,70,68
1656216075527,CSE 134B,A01,083661,Powell; Thomas Allan,2,0,100,98
1656216081551,CSE 140,A01,083663,Gungor; Onat,9,0,85,76
1656216087573,CSE 140L,A01,083088,Eldon; John,8,0,100,92
1656216093599,CSE 175,A01,083665,Kumar; Rakesh,0,0,25,25
1656216099624,CSE 190,A00,092507,Dubnov; Shlomo,3,0,20,17
1656216105651,ECE 45,A01,083139,Congero; Spencer William,1,0,75,74
1656216111750,ECE 65,A50,083695,Saad; Andrew S,9,0,30,21
1656216111750,ECE 65,A51,095125,Staff,23,0,26,3
1656216117773,ECE 109,A01,091882,Touri; Behrouz,0,1,70,70
1656216123797,ECE 180,A00,083140,Abi Samra; Nicholas Camill,1,0,30,29
1656216123797,ECE 180,B00,083141,Abi Samra; Nicholas Camill,0,4,30,30
1656216129820,MATH 10A,A01,083735,Patchell; Gregory David,0,0,30,30
1656216129820,MATH 10A,A02,083736,Patchell; Gregory David,22,0,30,8
1656216129820,MATH 10A,A03,083737,Patchell; Gregory David,16,0,30,14
1656216135845,MATH 10B,A01,083207,Lim; Seonhee,0,0,34,34
1656216135845,MATH 10B,A02,083208,Lim; Seonhee,7,0,35,28
1656216135845,MATH 10B,A03,093472,Staff,1,0,34,33
1656216135845,MATH 10B,B01,083739,Sinha; Shubham,11,0,30,19
1656216141870,MATH 18,A01,083743,Cinel; Cameron Alexander,7,0,30,23
1656216141870,MATH 18,A02,083744,Cinel; Cameron Alexander,10,0,30,20
1656216141870,MATH 18,A03,083745,Cinel; Cameron Alexander,5,0,30,25
1656216141870,MATH 18,B01,083748,Rideout; David Porter,1,0,36,35
1656216141870,MATH 18,B02,083749,Rideout; David Porter,0,0,36,36
1656216141870,MATH 18,B03,083750,Rideout; David Porter,0,0,36,36
1656216141870,MATH 18,B04,083751,Rideout; David Porter,0,1,36,36
1656216141870,MATH 18,B05,093473,Rideout; David Porter,0,0,36,36
1656216141870,MATH 18,B06,093474,Rideout; David Porter,3,0,36,33
1656216147901,MATH 20A,A01,083754,Zheng; Zequn,11,0,40,29
1656216153925,MATH 20B,A01,083756,Briones; Jor-el Thomas Caparas,0,0,36,36
1656216153925,MATH 20B,A02,083757,Briones; Jor-el Thomas Caparas,0,0,36,36
1656216153925,MATH 20B,A03,093475,Staff,1,0,36,35
1656216159950,MATH 20C,A01,083760,Briones; Jor-el Thomas Caparas,0,0,35,35
1656216159950,MATH 20C,A02,083761,Briones; Jor-el Thomas Caparas,9,1,35,26
1656216159950,MATH 20C,A03,093476,Staff,0,0,35,35
1656216159950,MATH 20C,B01,083762,Bach; Quang Tran,1,0,30,29
1656216165980,MATH 20D,A01,083765,Tran; Brian Kha,1,0,30,29
1656216165980,MATH 20D,A02,083766,Tran; Brian Kha,0,1,30,30
1656216165980,MATH 20D,A03,083767,Tran; Brian Kha,2,0,30,28
1656216172011,MATH 20E,A01,083771,Ganguly; Soumya,3,0,32,29
1656216172011,MATH 20E,A02,083772,Ganguly; Soumya,0,0,32,32
1656216172011,MATH 20E,B01,083773,Ciotti; Benjamin,16,0,35,19
1656216172011,MATH 20E,B02,083774,Ciotti; Benjamin,15,0,35,20
1656216178035,MATH 103A,A01,083777,Greenfeld; Be'Eri,1,0,36,35
1656216178035,MATH 103A,A02,083778,Greenfeld; Be'Eri,1,0,36,35
1656216178035,MATH 103A,A03,093561,Staff,5,0,36,31
1656216178035,MATH 103A,B01,083779,Greenfeld; Be'Eri,9,1,36,27
1656216178035,MATH 103A,B02,083780,Greenfeld; Be'Eri,1,0,36,35
1656216178035,MATH 103A,B03,093562,Staff,0,0,36,36
1656216184063,MATH 105,A01,085443,Carter; Anne Toulson,5,1,35,30
1656216184063,MATH 105,A02,093477,Staff,14,0,35,21
1656216190088,MATH 109,A01,083213,Ganzberger; Geoffrey Michael,0,0,34,34
1656216190088,MATH 109,A02,083214,Ganzberger; Geoffrey Michael,0,0,34,34
1656216190088,MATH 109,A03,093478,Staff,1,0,34,33
1656216190088,MATH 109,B01,083215,Ganzberger; Geoffrey Michael,4,0,32,28
1656216190088,MATH 109,B02,083216,Ganzberger; Geoffrey Michael,1,0,32,31
1656216190088,MATH 109,B03,093479,Staff,4,0,32,28
1656216196114,MATH 142A,A01,083219,Chow; Bennett,2,0,32,30
1656216196114,MATH 142A,A02,083220,Chow; Bennett,8,0,32,24
1656216196114,MATH 142A,A03,093480,Staff,5,0,32,27
1656216196114,MATH 142A,B03,093481,Staff,3,0,32,29
1656216196114,MATH 142A,B04,093558,Staff,6,0,32,26
1656216196114,MATH 142A,B05,093559,Staff,1,0,32,31
1656216202138,MATH 193A,A01,083224,Rotar; Vladimir,0,1,34,34
1656216202138,MATH 193A,A02,083225,Rotar; Vladimir,0,0,34,34
1656216202138,MATH 193A,A03,083781,Rotar; Vladimir,0,0,34,34
1656216202138,MATH 193A,A04,083782,Rotar; Vladimir,6,0,34,28
1656216202138,MATH 193A,A05,093482,Rotar; Vladimir,0,0,34,34
1656216208163,MATH 197,001,091859,McAuley; Julian John,9999,0,9999,0
1656216208163,MATH 197,002,095566,Kedlaya; Kiran S.,9997,0,9999,2
1656216208163,MATH 197,003,095567,Xiao; Ming,9999,0,9999,0
1656216208163,MATH 197,004,095571,Perols; Johan Lars,9998,0,9999,1
1656216215230,COGS 9,A01,083615,Shannon; Kyle Michael,3,0,75,72
1656216221254,COGS 11,A01,083617,Boyle; Mary E. T.,14,0,48,34
1656216227280,COGS 13,A01,083071,Bastos; Amalia Pinkusfeld,4,0,71,67
1656216233307,COGS 14A,A01,092681,Semenuks; Arturs,4,16,100,96
1656216239334,COGS 14B,A01,083073,Cheng; Tzu-Han,7,0,63,56
1656216245357,COGS 17,A01,092677,Semenuks; Arturs,7,0,81,74
1656216251379,COGS 100,A01,083619,Allen; Michael Gordon,2,0,70,68
1656216257403,COGS 101A,A01,083621,Davis; Joshua Daniel,4,0,68,64
1656216263427,COGS 101B,A01,091572,Allen; Michael Gordon,4,0,65,61
1656216269454,COGS 101C,A01,083625,Delgado; Tania,10,0,35,25
1656216275483,COGS 107A,A01,083627,Boyle; Mary E. T.,0,0,60,60
1656216281506,COGS 118A,A01,083075,Gupta; Anjum,7,0,76,69
1656216287530,CSE 3,A50,083646,Miranda; Gregory Joseph,18,0,50,32
1656216293558,CSE 8A,A50,083650,Miranda; Gregory Joseph,3,3,56,53
1656216299581,CSE 11,A01,083080,Cao; Yingjun,1,50,40,39
1656216305604,CSE 12,A01,083652,Krause-Levy; Sophia Louisa,7,3,120,113
1656216311627,CSE 15L,A01,083654,Morris; Justin Loren,2,0,50,48
1656216311627,CSE 15L,A02,083655,Morris; Justin Loren,4,0,50,46
1656216317653,CSE 20,A01,083657,Tran; Khoa Dang,30,0,80,50
1656216323677,CSE 21,A01,095574,Bach; Quang Tran,24,0,48,24
1656216329704,CSE 30,A01,083084,Eldon; John,2,8,80,78
1656216329704,CSE 30,B01,095061,Bhaskar; Nishant,1,2,50,49
1656216335726,CSE 100,A01,083659,Cao; Yingjun,2,20,70,68
1656216341753,CSE 134B,A01,083661,Powell; Thomas Allan,2,0,100,98
1656216347780,CSE 140,A01,083663,Gungor; Onat,9,0,85,76
1656216353808,CSE 140L,A01,083088,Eldon; John,8,0,100,92
1656216359832,CSE 175,A01,083665,Kumar; Rakesh,0,0,25,25
1656216365855,CSE 190,A00,092507,Dubnov; Shlomo,3,0,20,17
1656216371879,ECE 45,A01,083139,Congero; Spencer William,1,0,75,74
1656216377913,ECE 65,A50,083695,Saad; Andrew S,9,0,30,21
1656216377913,ECE 65,A51,095125,Staff,23,0,26,3
1656216383935,ECE 109,A01,091882,Touri; Behrouz,0,1,70,70
1656216389959,ECE 180,A00,083140,Abi Samra; Nicholas Camill,1,0,30,29
1656216389959,ECE 180,B00,083141,Abi Samra; Nicholas Camill,0,4,30,30
1656216395989,MATH 10A,A01,083735,Patchell; Gregory David,0,0,30,30
1656216395989,MATH 10A,A02,083736,Patchell; Gregory David,22,0,30,8
1656216395989,MATH 10A,A03,083737,Patchell; Gregory David,16,0,30,14
1656216402020,MATH 10B,A01,083207,Lim; Seonhee,0,0,34,34
1656216402020,MATH 10B,A02,083208,Lim; Seonhee,7,0,35,28
1656216402020,MATH 10B,A03,093472,Staff,1,0,34,33
1656216402020,MATH 10B,B01,083739,Sinha; Shubham,11,0,30,19
1656216408046,MATH 18,A01,083743,Cinel; Cameron Alexander,7,0,30,23
1656216408046,MATH 18,A02,083744,Cinel; Cameron Alexander,10,0,30,20
1656216408046,MATH 18,A03,083745,Cinel; Cameron Alexander,5,0,30,25
1656216408046,MATH 18,B01,083748,Rideout; David Porter,1,0,36,35
1656216408046,MATH 18,B02,083749,Rideout; David Porter,0,0,36,36
1656216408046,MATH 18,B03,083750,Rideout; David Porter,0,0,36,36
1656216408046,MATH 18,B04,083751,Rideout; David Porter,0,1,36,36
1656216408046,MATH 18,B05,093473,Rideout; David Porter,0,0,36,36
1656216408046,MATH 18,B06,093474,Rideout; David Porter,3,0,36,33
1656216414070,MATH 20A,A01,083754,Zheng; Zequn,11,0,40,29
1656216420096,MATH 20B,A01,083756,Briones; Jor-el Thomas Caparas,0,0,36,36
1656216420096,MATH 20B,A02,083757,Briones; Jor-el Thomas Caparas,0,0,36,36
1656216420096,MATH 20B,A03,093475,Staff,1,0,36,35
1656216426121,MATH 20C,A01,083760,Briones; Jor-el Thomas Caparas,0,0,35,35
1656216426121,MATH 20C,A02,083761,Briones; Jor-el Thomas Caparas,9,1,35,26
1656216426121,MATH 20C,A03,093476,Staff,0,0,35,35
1656216426121,MATH 20C,B01,083762,Bach; Quang Tran,1,0,30,29
1656216432145,MATH 20D,A01,083765,Tran; Brian Kha,1,0,30,29
1656216432145,MATH 20D,A02,083766,Tran; Brian Kha,0,1,30,30
1656216432145,MATH 20D,A03,083767,Tran; Brian Kha,2,0,30,28
1656216438168,MATH 20E,A01,083771,Ganguly; Soumya,3,0,32,29
1656216438168,MATH 20E,A02,083772,Ganguly; Soumya,0,0,32,32
1656216438168,MATH 20E,B01,083773,Ciotti; Benjamin,16,0,35,19
1656216438168,MATH 20E,B02,083774,Ciotti; Benjamin,15,0,35,20
1656216444197,MATH 103A,A01,083777,Greenfeld; Be'Eri,1,0,36,35
1656216444197,MATH 103A,A02,083778,Greenfeld; Be'Eri,1,0,36,35
1656216444197,MATH 103A,A03,093561,Staff,5,0,36,31
1656216444197,MATH 103A,B01,083779,Greenfeld; Be'Eri,9,1,36,27
1656216444197,MATH 103A,B02,083780,Greenfeld; Be'Eri,1,0,36,35
1656216444197,MATH 103A,B03,093562,Staff,0,0,36,36
1656216450224,MATH 105,A01,085443,Carter; Anne Toulson,5,1,35,30
1656216450224,MATH 105,A02,093477,Staff,14,0,35,21
1656216456249,MATH 109,A01,083213,Ganzberger; Geoffrey Michael,0,0,34,34
1656216456249,MATH 109,A02,083214,Ganzberger; Geoffrey Michael,0,0,34,34
1656216456249,MATH 109,A03,093478,Staff,1,0,34,33
1656216456249,MATH 109,B01,083215,Ganzberger; Geoffrey Michael,4,0,32,28
1656216456249,MATH 109,B02,083216,Ganzberger; Geoffrey Michael,1,0,32,31
1656216456249,MATH 109,B03,093479,Staff,4,0,32,28
1656216462279,MATH 142A,A01,083219,Chow; Bennett,2,0,32,30
1656216462279,MATH 142A,A02,083220,Chow; Bennett,8,0,32,24
1656216462279,MATH 142A,A03,093480,Staff,5,0,32,27
1656216462279,MATH 142A,B03,093481,Staff,3,0,32,29
1656216462279,MATH 142A,B04,093558,Staff,6,0,32,26
1656216462279,MATH 142A,B05,093559,Staff,1,0,32,31
1656216468302,MATH 193A,A01,083224,Rotar; Vladimir,0,1,34,34
1656216468302,MATH 193A,A02,083225,Rotar; Vladimir,0,0,34,34
1656216468302,MATH 193A,A03,083781,Rotar; Vladimir,0,0,34,34
1656216468302,MATH 193A,A04,083782,Rotar; Vladimir,6,0,34,28
1656216468302,MATH 193A,A05,093482,Rotar; Vladimir,0,0,34,34
1656216474324,MATH 197,001,091859,McAuley; Julian John,9999,0,9999,0
1656216474324,MATH 197,002,095566,Kedlaya; Kiran S.,9997,0,9999,2
1656216474324,MATH 197,003,095567,Xiao; Ming,9999,0,9999,0
1656216474324,MATH 197,004,095571,Perols; Johan Lars,9998,0,9999,1
1656216481389,COGS 9,A01,083615,Shannon; Kyle Michael,3,0,75,72
1656216487420,COGS 11,A01,083617,Boyle; Mary E. T.,14,0,48,34
1656216493451,COGS 13,A01,083071,Bastos; Amalia Pinkusfeld,4,0,71,67
1656216499479,COGS 14A,A01,092681,Semenuks; Arturs,4,16,100,96
1656216505506,COGS 14B,A01,083073,Cheng; Tzu-Han,7,0,63,56
1656216511530,COGS 17,A01,092677,Semenuks; Arturs,7,0,81,74
1656216517561,COGS 100,A01,083619,Allen; Michael Gordon,2,0,70,68
1656216523585,COGS 101A,A01,083621,Davis; Joshua Daniel,4,0,68,64
1656216529613,COGS 101B,A01,091572,Allen; Michael Gordon,4,0,65,61
1656216535637,COGS 101C,A01,083625,Delgado; Tania,10,0,35,25
1656216541665,COGS 107A,A01,083627,Boyle; Mary E. T.,0,0,60,60
1656216547696,COGS 118A,A01,083075,Gupta; Anjum,7,0,76,69
1656216553724,CSE 3,A50,083646,Miranda; Gregory Joseph,18,0,50,32
1656216559756,CSE 8A,A50,083650,Miranda; Gregory Joseph,3,3,56,53
1656216565795,CSE 11,A01,083080,Cao; Yingjun,1,50,40,39
1656216571823,CSE 12,A01,083652,Krause-Levy; Sophia Louisa,7,3,120,113
1656216577849,CSE 15L,A01,083654,Morris; Justin Loren,2,0,50,48
1656216577849,CSE 15L,A02,083655,Morris; Justin Loren,4,0,50,46
1656216583876,CSE 20,A01,083657,Tran; Khoa Dang,30,0,80,50
1656216589903,CSE 21,A01,095574,Bach; Quang Tran,24,0,48,24
1656216595930,CSE 30,A01,083084,Eldon; John,2,8,80,78
1656216595930,CSE 30,B01,095061,Bhaskar; Nishant,1,2,50,49
1656216601954,CSE 100,A01,083659,Cao; Yingjun,2,20,70,68
1656216607977,CSE 134B,A01,083661,Powell; Thomas Allan,2,0,100,98
1656216614004,CSE 140,A01,083663,Gungor; Onat,9,0,85,76
1656216620027,CSE 140L,A01,083088,Eldon; John,8,0,100,92
1656216626051,CSE 175,A01,083665,Kumar; Rakesh,0,0,25,25
1656216632073,CSE 190,A00,092507,Dubnov; Shlomo,3,0,20,17
1656216638097,ECE 45,A01,083139,Congero; Spencer William,1,0,75,74
1656216644133,ECE 65,A50,083695,Saad; Andrew S,9,0,30,21
1656216644133,ECE 65,A51,095125,Staff,23,0,26,3
1656216650159,ECE 109,A01,091882,Touri; Behrouz,0,1,70,70
1656216656187,ECE 180,A00,083140,Abi Samra; Nicholas Camill,1,0,30,29
1656216656187,ECE 180,B00,083141,Abi Samra; Nicholas Camill,0,4,30,30
1656216662213,MATH 10A,A01,083735,Patchell; Gregory David,0,0,30,30
1656216662213,MATH 10A,A02,083736,Patchell; Gregory David,22,0,30,8
1656216662213,MATH 10A,A03,083737,Patchell; Gregory David,16,0,30,14
1656216668240,MATH 10B,A01,083207,Lim; Seonhee,0,0,34,34
1656216668240,MATH 10B,A02,083208,Lim; Seonhee,7,0,35,28
1656216668240,MATH 10B,A03,093472,Staff,1,0,34,33
1656216668240,MATH 10B,B01,083739,Sinha; Shubham,11,0,30,19
1656216674264,MATH 18,A01,083743,Cinel; Cameron Alexander,7,0,30,23
1656216674264,MATH 18,A02,083744,Cinel; Cameron Alexander,10,0,30,20
1656216674264,MATH 18,A03,083745,Cinel; Cameron Alexander,5,0,30,25
1656216674264,MATH 18,B01,083748,Rideout; David Porter,1,0,36,35
1656216674264,MATH 18,B02,083749,Rideout; David Porter,0,0,36,36
1656216674264,MATH 18,B03,083750,Rideout; David Porter,0,0,36,36
1656216674264,MATH 18,B04,083751,Rideout; David Porter,0,1,36,36
1656216674264,MATH 18,B05,093473,Rideout; David Porter,0,0,36,36
1656216674264,MATH 18,B06,093474,Rideout; David Porter,3,0,36,33
1656216680288,MATH 20A,A01,083754,Zheng; Zequn,11,0,40,29
1656216686311,MATH 20B,A01,083756,Briones; Jor-el Thomas Caparas,0,0,36,36
1656216686311,MATH 20B,A02,083757,Briones; Jor-el Thomas Caparas,0,0,36,36
1656216686311,MATH 20B,A03,093475,Staff,1,0,36,35
1656216692335,MATH 20C,A01,083760,Briones; Jor-el Thomas Caparas,0,0,35,35
1656216692335,MATH 20C,A02,083761,Briones; Jor-el Thomas Caparas,9,1,35,26
1656216692335,MATH 20C,A03,093476,Staff,0,0,35,35
1656216692335,MATH 20C,B01,083762,Bach; Quang Tran,1,0,30,29
1656216698363,MATH 20D,A01,083765,Tran; Brian Kha,1,0,30,29
1656216698363,MATH 20D,A02,083766,Tran; Brian Kha,0,1,30,30
1656216698363,MATH 20D,A03,083767,Tran; Brian Kha,2,0,30,28
1656216704391,MATH 20E,A01,083771,Ganguly; Soumya,3,0,32,29
1656216704391,MATH 20E,A02,083772,Ganguly; Soumya,0,0,32,32
1656216704391,MATH 20E,B01,083773,Ciotti; Benjamin,16,0,35,19
1656216704391,MATH 20E,B02,083774,Ciotti; Benjamin,15,0,35,20
1656216710500,MATH 103A,A01,083777,Greenfeld; Be'Eri,1,0,36,35
1656216710500,MATH 103A,A02,083778,Greenfeld; Be'Eri,1,0,36,35
1656216710500,MATH 103A,A03,093561,Staff,5,0,36,31
1656216710500,MATH 103A,B01,083779,Greenfeld; Be'Eri,9,1,36,27
1656216710500,MATH 103A,B02,083780,Greenfeld; Be'Eri,1,0,36,35
1656216710500,MATH 103A,B03,093562,Staff,0,0,36,36
1656216716527,MATH 105,A01,085443,Carter; Anne Toulson,5,1,35,30
1656216716527,MATH 105,A02,093477,Staff,14,0,35,21
1656216722555,MATH 109,A01,083213,Ganzberger; Geoffrey Michael,0,0,34,34
1656216722555,MATH 109,A02,083214,Ganzberger; Geoffrey Michael,0,0,34,34
1656216722555,MATH 109,A03,093478,Staff,1,0,34,33
1656216722555,MATH 109,B01,083215,Ganzberger; Geoffrey Michael,4,0,32,28
1656216722555,MATH 109,B02,083216,Ganzberger; Geoffrey Michael,1,0,32,31
1656216722555,MATH 109,B03,093479,Staff,4,0,32,28
1656216728587,MATH 142A,A01,083219,Chow; Bennett,2,0,32,30
1656216728587,MATH 142A,A02,083220,Chow; Bennett,8,0,32,24
1656216728587,MATH 142A,A03,093480,Staff,5,0,32,27
1656216728587,MATH 142A,B03,093481,Staff,3,0,32,29
1656216728587,MATH 142A,B04,093558,Staff,6,0,32,26
1656216728587,MATH 142A,B05,093559,Staff,1,0,32,31
1656216734615,MATH 193A,A01,083224,Rotar; Vladimir,0,1,34,34
1656216734615,MATH 193A,A02,083225,Rotar; Vladimir,0,0,34,34
1656216734615,MATH 193A,A03,083781,Rotar; Vladimir,0,0,34,34
1656216734615,MATH 193A,A04,083782,Rotar; Vladimir,6,0,34,28
1656216734615,MATH 193A,A05,093482,Rotar; Vladimir,0,0,34,34
1656216740642,MATH 197,001,091859,McAuley; Julian John,9999,0,9999,0
1656216740642,MATH 197,002,095566,Kedlaya; Kiran S.,9997,0,9999,2
1656216740642,MATH 197,003,095567,Xiao; Ming,9999,0,9999,0
1656216740642,MATH 197,004,095571,Perols; Johan Lars,9998,0,9999,1
1656216747701,COGS 9,A01,083615,Shannon; Kyle Michael,3,0,75,72
1656216753737,COGS 11,A01,083617,Boyle; Mary E. T.,14,0,48,34
1656216759760,COGS 13,A01,083071,Bastos; Amalia Pinkusfeld,4,0,71,67
1656216765788,COGS 14A,A01,092681,Semenuks; Arturs,4,16,100,96
1656216771816,COGS 14B,A01,083073,Cheng; Tzu-Han,7,0,63,56
1656216777839,COGS 17,A01,092677,Semenuks; Arturs,7,0,81,74
1656216783866,COGS 100,A01,083619,Allen; Michael Gordon,2,0,70,68
1656216789895,COGS 101A,A01,083621,Davis; Joshua Daniel,4,0,68,64
1656216795923,COGS 101B,A01,091572,Allen; Michael Gordon,4,0,65,61
1656216801945,COGS 101C,A01,083625,Delgado; Tania,10,0,35,25
1656216807967,COGS 107A,A01,083627,Boyle; Mary E. T.,0,0,60,60
1656216813991,COGS 118A,A01,083075,Gupta; Anjum,7,0,76,69
1656216820021,CSE 3,A50,083646,Miranda; Gregory Joseph,18,0,50,32
1656216826046,CSE 8A,A50,083650,Miranda; Gregory Joseph,3,3,56,53
1656216832070,CSE 11,A01,083080,Cao; Yingjun,1,50,40,39
1656216838099,CSE 12,A01,083652,Krause-Levy; Sophia Louisa,7,3,120,113
1656216844126,CSE 15L,A01,083654,Morris; Justin Loren,2,0,50,48
1656216844126,CSE 15L,A02,083655,Morris; Justin Loren,4,0,50,46
1656216850150,CSE 20,A01,083657,Tran; Khoa Dang,30,0,80,50
1656216856181,CSE 21,A01,095574,Bach; Quang Tran,24,0,48,24
1656216862209,CSE 30,A01,083084,Eldon; John,2,8,80,78
1656216862209,CSE 30,B01,095061,Bhaskar; Nishant,1,2,50,49
1656216868235,CSE 100,A01,083659,Cao; Yingjun,2,20,70,68
1656216874261,CSE 134B,A01,083661,Powell; Thomas Allan,2,0,100,98
1656216880293,CSE 140,A01,083663,Gungor; Onat,9,0,85,76
1656216886316,CSE 140L,A01,083088,Eldon; John,8,0,100,92
1656216892341,CSE 175,A01,083665,Kumar; Rakesh,0,0,25,25
1656216898365,CSE 190,A00,092507,Dubnov; Shlomo,3,0,20,17
1656216904388,ECE 45,A01,083139,Congero; Spencer William,1,0,75,74
1656216910410,ECE 65,A50,083695,Saad; Andrew S,9,0,30,21
1656216910410,ECE 65,A51,095125,Staff,23,0,26,3
1656216916438,ECE 109,A01,091882,Touri; Behrouz,0,1,70,70
1656216922465,ECE 180,A00,083140,Abi Samra; Nicholas Camill,1,0,30,29
1656216922465,ECE 180,B00,083141,Abi Samra; Nicholas Camill,0,4,30,30
1656216928492,MATH 10A,A01,083735,Patchell; Gregory David,0,0,30,30
1656216928492,MATH 10A,A02,083736,Patchell; Gregory David,22,0,30,8
1656216928492,MATH 10A,A03,083737,Patchell; Gregory David,16,0,30,14
1656216934513,MATH 10B,A01,083207,Lim; Seonhee,0,0,34,34
1656216934513,MATH 10B,A02,083208,Lim; Seonhee,7,0,35,28
1656216934513,MATH 10B,A03,093472,Staff,1,0,34,33
1656216934513,MATH 10B,B01,083739,Sinha; Shubham,11,0,30,19
1656216940550,MATH 18,A01,083743,Cinel; Cameron Alexander,7,0,30,23
1656216940550,MATH 18,A02,083744,Cinel; Cameron Alexander,10,0,30,20
1656216940550,MATH 18,A03,083745,Cinel; Cameron Alexander,5,0,30,25
1656216940550,MATH 18,B01,083748,Rideout; David Porter,1,0,36,35
1656216940550,MATH 18,B02,083749,Rideout; David Porter,0,0,36,36
1656216940550,MATH 18,B03,083750,Rideout; David Porter,0,0,36,36
1656216940550,MATH 18,B04,083751,Rideout; David Porter,0,1,36,36
1656216940550,MATH 18,B05,093473,Rideout; David Porter,0,0,36,36
1656216940550,MATH 18,B06,093474,Rideout; David Porter,3,0,36,33
1656216946575,MATH 20A,A01,083754,Zheng; Zequn,11,0,40,29
1656216952603,MATH 20B,A01,083756,Briones; Jor-el Thomas Caparas,0,0,36,36
1656216952603,MATH 20B,A02,083757,Briones; Jor-el Thomas Caparas,0,0,36,36
1656216952603,MATH 20B,A03,093475,Staff,1,0,36,35
1656216958630,MATH 20C,A01,083760,Briones; Jor-el Thomas Caparas,0,0,35,35
1656216958630,MATH 20C,A02,083761,Briones; Jor-el Thomas Caparas,9,1,35,26
1656216958630,MATH 20C,A03,093476,Staff,0,0,35,35
1656216958630,MATH 20C,B01,083762,Bach; Quang Tran,1,0,30,29
1656216964655,MATH 20D,A01,083765,Tran; Brian Kha,1,0,30,29
1656216964655,MATH 20D,A02,083766,Tran; Brian Kha,0,1,30,30
1656216964655,MATH 20D,A03,083767,Tran; Brian Kha,2,0,30,28
1656216970699,MATH 20E,A01,083771,Ganguly; Soumya,3,0,32,29
1656216970699,MATH 20E,A02,083772,Ganguly; Soumya,0,0,32,32
1656216970699,MATH 20E,B01,083773,Ciotti; Benjamin,16,0,35,19
1656216970699,MATH 20E,B02,083774,Ciotti; Benjamin,15,0,35,20
1656216976727,MATH 103A,A01,083777,Greenfeld; Be'Eri,1,0,36,35
1656216976727,MATH 103A,A02,083778,Greenfeld; Be'Eri,1,0,36,35
1656216976727,MATH 103A,A03,093561,Staff,5,0,36,31
1656216976727,MATH 103A,B01,083779,Greenfeld; Be'Eri,9,1,36,27
1656216976727,MATH 103A,B02,083780,Greenfeld; Be'Eri,1,0,36,35
1656216976727,MATH 103A,B03,093562,Staff,0,0,36,36
1656216982755,MATH 105,A01,085443,Carter; Anne Toulson,5,1,35,30
1656216982755,MATH 105,A02,093477,Staff,14,0,35,21
1656216988780,MATH 109,A01,083213,Ganzberger; Geoffrey Michael,0,0,34,34
1656216988780,MATH 109,A02,083214,Ganzberger; Geoffrey Michael,0,0,34,34
1656216988780,MATH 109,A03,093478,Staff,1,0,34,33
1656216988780,MATH 109,B01,083215,Ganzberger; Geoffrey Michael,4,0,32,28
1656216988780,MATH 109,B02,083216,Ganzberger; Geoffrey Michael,1,0,32,31
1656216988780,MATH 109,B03,093479,Staff,4,0,32,28
1656216994806,MATH 142A,A01,083219,Chow; Bennett,2,0,32,30
1656216994806,MATH 142A,A02,083220,Chow; Bennett,8,0,32,24
1656216994806,MATH 142A,A03,093480,Staff,5,0,32,27
1656216994806,MATH 142A,B03,093481,Staff,3,0,32,29
1656216994806,MATH 142A,B04,093558,Staff,6,0,32,26
1656216994806,MATH 142A,B05,093559,Staff,1,0,32,31
1656217000830,MATH 193A,A01,083224,Rotar; Vladimir,0,1,34,34
1656217000830,MATH 193A,A02,083225,Rotar; Vladimir,0,0,34,34
1656217000830,MATH 193A,A03,083781,Rotar; Vladimir,0,0,34,34
1656217000830,MATH 193A,A04,083782,Rotar; Vladimir,6,0,34,28
1656217000830,MATH 193A,A05,093482,Rotar; Vladimir,0,0,34,34
1656217006856,MATH 197,001,091859,McAuley; Julian John,9999,0,9999,0
1656217006856,MATH 197,002,095566,Kedlaya; Kiran S.,9997,0,9999,2
1656217006856,MATH 197,003,095567,Xiao; Ming,9999,0,9999,0
1656217006856,MATH 197,004,095571,Perols; Johan Lars,9998,0,9999,1
1656217013916,COGS 9,A01,083615,Shannon; Kyle Michael,3,0,75,72
1656217019940,COGS 11,A01,083617,Boyle; Mary E. T.,14,0,48,34
1656217025964,COGS 13,A01,083071,Bastos; Amalia Pinkusfeld,4,0,71,67
1656217031988,COGS 14A,A01,092681,Semenuks; Arturs,4,16,100,96
1656217038013,COGS 14B,A01,083073,Cheng; Tzu-Han,7,0,63,56
1656217044040,COGS 17,A01,092677,Semenuks; Arturs,7,0,81,74
1656217050064,COGS 100,A01,083619,Allen; Michael Gordon,2,0,70,68
1656217056091,COGS 101A,A01,083621,Davis; Joshua Daniel,4,0,68,64
1656217062113,COGS 101B,A01,091572,Allen; Michael Gordon,4,0,65,61
1656217068137,COGS 101C,A01,083625,Delgado; Tania,10,0,35,25
1656217074159,COGS 107A,A01,083627,Boyle; Mary E. T.,0,0,60,60
1656217080194,COGS 118A,A01,083075,Gupta; Anjum,7,0,76,69
1656217086227,CSE 3,A50,083646,Miranda; Gregory Joseph,18,0,50,32
1656217092251,CSE 8A,A50,083650,Miranda; Gregory Joseph,3,3,56,53
1656217098275,CSE 11,A01,083080,Cao; Yingjun,1,50,40,39
1656217104299,CSE 12,A01,083652,Krause-Levy; Sophia Louisa,7,3,120,113
1656217110327,CSE 15L,A01,083654,Morris; Justin Loren,2,0,50,48
1656217110327,CSE 15L,A02,083655,Morris; Justin Loren,4,0,50,46
1656217116352,CSE 20,A01,083657,Tran; Khoa Dang,30,0,80,50
1656217122378,CSE 21,A01,095574,Bach; Quang Tran,24,0,48,24
1656217128403,CSE 30,A01,083084,Eldon; John,2,8,80,78
1656217128403,CSE 30,B01,095061,Bhaskar; Nishant,1,2,50,49
1656217134426,CSE 100,A01,083659,Cao; Yingjun,2,20,70,68
1656217140450,CSE 134B,A01,083661,Powell; Thomas Allan,2,0,100,98
1656217146473,CSE 140,A01,083663,Gungor; Onat,9,0,85,76
1656217152497,CSE 140L,A01,083088,Eldon; John,8,0,100,92
1656217158522,CSE 175,A01,083665,Kumar; Rakesh,0,0,25,25
1656217164551,CSE 190,A00,092507,Dubnov; Shlomo,3,0,20,17
1656217170579,ECE 45,A01,083139,Congero; Spencer William,1,0,75,74
1656217176606,ECE 65,A50,083695,Saad; Andrew S,9,0,30,21
1656217176606,ECE 65,A51,095125,Staff,23,0,26,3
1656217182635,ECE 109,A01,091882,Touri; Behrouz,0,1,70,70
1656217188658,ECE 180,A00,083140,Abi Samra; Nicholas Camill,1,0,30,29
1656217188658,ECE 180,B00,083141,Abi Samra; Nicholas Camill,0,4,30,30
1656217194682,MATH 10A,A01,083735,Patchell; Gregory David,0,0,30,30
1656217194682,MATH 10A,A02,083736,Patchell; Gregory David,22,0,30,8
1656217194682,MATH 10A,A03,083737,Patchell; Gregory David,16,0,30,14
1656217200711,MATH 10B,A01,083207,Lim; Seonhee,0,0,34,34
1656217200711,MATH 10B,A02,083208,Lim; Seonhee,7,0,35,28
1656217200711,MATH 10B,A03,093472,Staff,1,0,34,33
1656217200711,MATH 10B,B01,083739,Sinha; Shubham,11,0,30,19
1656217206743,MATH 18,A01,083743,Cinel; Cameron Alexander,7,0,30,23
1656217206743,MATH 18,A02,083744,Cinel; Cameron Alexander,10,0,30,20
1656217206743,MATH 18,A03,083745,Cinel; Cameron Alexander,5,0,30,25
1656217206743,MATH 18,B01,083748,Rideout; David Porter,1,0,36,35
1656217206743,MATH 18,B02,083749,Rideout; David Porter,0,0,36,36
1656217206743,MATH 18,B03,083750,Rideout; David Porter,0,0,36,36
1656217206743,MATH 18,B04,083751,Rideout; David Porter,0,1,36,36
1656217206743,MATH 18,B05,093473,Rideout; David Porter,0,0,36,36
1656217206743,MATH 18,B06,093474,Rideout; David Porter,3,0,36,33
1656217212777,MATH 20A,A01,083754,Zheng; Zequn,11,0,40,29
1656217218800,MATH 20B,A01,083756,Briones; Jor-el Thomas Caparas,0,0,36,36
1656217218800,MATH 20B,A02,083757,Briones; Jor-el Thomas Caparas,0,0,36,36
1656217218800,MATH 20B,A03,093475,Staff,1,0,36,35
1656217224823,MATH 20C,A01,083760,Briones; Jor-el Thomas Caparas,0,0,35,35
1656217224823,MATH 20C,A02,083761,Briones; Jor-el Thomas Caparas,9,1,35,26
1656217224823,MATH 20C,A03,093476,Staff,0,0,35,35
1656217224823,MATH 20C,B01,083762,Bach; Quang Tran,1,0,30,29
1656217230851,MATH 20D,A01,083765,Tran; Brian Kha,1,0,30,29
1656217230851,MATH 20D,A02,083766,Tran; Brian Kha,0,1,30,30
1656217230851,MATH 20D,A03,083767,Tran; Brian Kha,2,0,30,28
1656217236876,MATH 20E,A01,083771,Ganguly; Soumya,3,0,32,29
1656217236876,MATH 20E,A02,083772,Ganguly; Soumya,0,0,32,32
1656217236876,MATH 20E,B01,083773,Ciotti; Benjamin,16,0,35,19
1656217236876,MATH 20E,B02,083774,Ciotti; Benjamin,15,0,35,20
1656217242899,MATH 103A,A01,083777,Greenfeld; Be'Eri,1,0,36,35
1656217242899,MATH 103A,A02,083778,Greenfeld; Be'Eri,1,0,36,35
1656217242899,MATH 103A,A03,093561,Staff,5,0,36,31
1656217242899,MATH 103A,B01,083779,Greenfeld; Be'Eri,9,1,36,27
1656217242899,MATH 103A,B02,083780,Greenfeld; Be'Eri,1,0,36,35
1656217242899,MATH 103A,B03,093562,Staff,0,0,36,36
1656217248925,MATH 105,A01,085443,Carter; Anne Toulson,5,1,35,30
1656217248925,MATH 105,A02,093477,Staff,14,0,35,21
1656217254956,MATH 109,A01,083213,Ganzberger; Geoffrey Michael,0,0,34,34
1656217254956,MATH 109,A02,083214,Ganzberger; Geoffrey Michael,0,0,34,34
1656217254956,MATH 109,A03,093478,Staff,1,0,34,33
1656217254956,MATH 109,B01,083215,Ganzberger; Geoffrey Michael,4,0,32,28
1656217254956,MATH 109,B02,083216,Ganzberger; Geoffrey Michael,1,0,32,31
1656217254956,MATH 109,B03,093479,Staff,4,0,32,28
1656217260981,MATH 142A,A01,083219,Chow; Bennett,2,0,32,30
1656217260981,MATH 142A,A02,083220,Chow; Bennett,8,0,32,24
1656217260981,MATH 142A,A03,093480,Staff,5,0,32,27
1656217260981,MATH 142A,B03,093481,Staff,3,0,32,29
1656217260981,MATH 142A,B04,093558,Staff,6,0,32,26
1656217260981,MATH 142A,B05,093559,Staff,1,0,32,31
1656217267005,MATH 193A,A01,083224,Rotar; Vladimir,0,1,34,34
1656217267005,MATH 193A,A02,083225,Rotar; Vladimir,0,0,34,34
1656217267005,MATH 193A,A03,083781,Rotar; Vladimir,0,0,34,34
1656217267005,MATH 193A,A04,083782,Rotar; Vladimir,6,0,34,28
1656217267005,MATH 193A,A05,093482,Rotar; Vladimir,0,0,34,34
1656217273031,MATH 197,001,091859,McAuley; Julian John,9999,0,9999,0
1656217273031,MATH 197,002,095566,Kedlaya; Kiran S.,9997,0,9999,2
1656217273031,MATH 197,003,095567,Xiao; Ming,9999,0,9999,0
1656217273031,MATH 197,004,095571,Perols; Johan Lars,9998,0,9999,1
1656217280097,COGS 9,A01,083615,Shannon; Kyle Michael,3,0,75,72
1656217286125,COGS 11,A01,083617,Boyle; Mary E. T.,14,0,48,34
1656217292152,COGS 13,A01,083071,Bastos; Amalia Pinkusfeld,4,0,71,67
1656217298177,COGS 14A,A01,092681,Semenuks; Arturs,4,16,100,96
1656217304273,COGS 14B,A01,083073,Cheng; Tzu-Han,7,0,63,56
1656217310299,COGS 17,A01,092677,Semenuks; Arturs,7,0,81,74
1656217316321,COGS 100,A01,083619,Allen; Michael Gordon,2,0,70,68
1656217322344,COGS 101A,A01,083621,Davis; Joshua Daniel,4,0,68,64
1656217328372,COGS 101B,A01,091572,Allen; Michael Gordon,4,0,65,61
1656217334398,COGS 101C,A01,083625,Delgado; Tania,10,0,35,25
1656217340423,COGS 107A,A01,083627,Boyle; Mary E. T.,0,0,60,60
1656217346446,COGS 118A,A01,083075,Gupta; Anjum,7,0,76,69
1656217352474,CSE 3,A50,083646,Miranda; Gregory Joseph,18,0,50,32
1656217358500,CSE 8A,A50,083650,Miranda; Gregory Joseph,3,3,56,53
1656217364530,CSE 11,A01,083080,Cao; Yingjun,1,50,40,39
1656217370555,CSE 12,A01,083652,Krause-Levy; Sophia Louisa,7,3,120,113
1656217376578,CSE 15L,A01,083654,Morris; Justin Loren,2,0,50,48
1656217376578,CSE 15L,A02,083655,Morris; Justin Loren,4,0,50,46
1656217382602,CSE 20,A01,083657,Tran; Khoa Dang,30,0,80,50
1656217388632,CSE 21,A01,095574,Bach; Quang Tran,24,0,48,24
1656217394661,CSE 30,A01,083084,Eldon; John,2,8,80,78
1656217394661,CSE 30,B01,095061,Bhaskar; Nishant,1,2,50,49
1656217400694,CSE 100,A01,083659,Cao; Yingjun,2,20,70,68
1656217406720,CSE 134B,A01,083661,Powell; Thomas Allan,2,0,100,98
1656217412750,CSE 140,A01,083663,Gungor; Onat,9,0,85,76
1656217418774,CSE 140L,A01,083088,Eldon; John,8,0,100,92
1656217424798,CSE 175,A01,083665,Kumar; Rakesh,0,0,25,25
1656217430822,CSE 190,A00,092507,Dubnov; Shlomo,3,0,20,17
1656217436849,ECE 45,A01,083139,Congero; Spencer William,1,0,75,74
1656217442873,ECE 65,A50,083695,Saad; Andrew S,9,0,30,21
1656217442873,ECE 65,A51,095125,Staff,23,0,26,3
1656217448900,ECE 109,A01,091882,Touri; Behrouz,0,1,70,70
1656217454923,ECE 180,A00,083140,Abi Samra; Nicholas Camill,1,0,30,29
1656217454923,ECE 180,B00,083141,Abi Samra; Nicholas Camill,0,4,30,30
1656217460947,MATH 10A,A01,083735,Patchell; Gregory David,0,0,30,30
1656217460947,MATH 10A,A02,083736,Patchell; Gregory David,22,0,30,8
1656217460947,MATH 10A,A03,083737,Patchell; Gregory David,16,0,30,14
1656217466975,MATH 10B,A01,083207,Lim; Seonhee,0,0,34,34
1656217466975,MATH 10B,A02,083208,Lim; Seonhee,7,0,35,28
1656217466975,MATH 10B,A03,093472,Staff,1,0,34,33
1656217466975,MATH 10B,B01,083739,Sinha; Shubham,11,0,30,19
1656217473005,MATH 18,A01,083743,Cinel; Cameron Alexander,7,0,30,23
1656217473005,MATH 18,A02,083744,Cinel; Cameron Alexander,10,0,30,20
1656217473005,MATH 18,A03,083745,Cinel; Cameron Alexander,5,0,30,25
1656217473005,MATH 18,B01,083748,Rideout; David Porter,1,0,36,35
1656217473005,MATH 18,B02,083749,Rideout; David Porter,0,0,36,36
1656217473005,MATH 18,B03,083750,Rideout; David Porter,0,0,36,36
1656217473005,MATH 18,B04,083751,Rideout; David Porter,0,1,36,36
1656217473005,MATH 18,B05,093473,Rideout; David Porter,0,0,36,36
1656217473005,MATH 18,B06,093474,Rideout; David Porter,3,0,36,33
1656217479032,MATH 20A,A01,083754,Zheng; Zequn,11,0,40,29
1656217485058,MATH 20B,A01,083756,Briones; Jor-el Thomas Caparas,0,0,36,36
1656217485058,MATH 20B,A02,083757,Briones; Jor-el Thomas Caparas,0,0,36,36
1656217485058,MATH 20B,A03,093475,Staff,1,0,36,35
1656217491086,MATH 20C,A01,083760,Briones; Jor-el Thomas Caparas,0,0,35,35
1656217491086,MATH 20C,A02,083761,Briones; Jor-el Thomas Caparas,9,1,35,26
1656217491086,MATH 20C,A03,093476,Staff,0,0,35,35
1656217491086,MATH 20C,B01,083762,Bach; Quang Tran,1,0,30,29
1656217497115,MATH 20D,A01,083765,Tran; Brian Kha,1,0,30,29
1656217497115,MATH 20D,A02,083766,Tran; Brian Kha,0,1,30,30
1656217497115,MATH 20D,A03,083767,Tran; Brian Kha,2,0,30,28
1656217503140,MATH 20E,A01,083771,Ganguly; Soumya,3,0,32,29
1656217503140,MATH 20E,A02,083772,Ganguly; Soumya,0,0,32,32
1656217503140,MATH 20E,B01,083773,Ciotti; Benjamin,16,0,35,19
1656217503140,MATH 20E,B02,083774,Ciotti; Benjamin,15,0,35,20
1656217509170,MATH 103A,A01,083777,Greenfeld; Be'Eri,1,0,36,35
1656217509170,MATH 103A,A02,083778,Greenfeld; Be'Eri,1,0,36,35
1656217509170,MATH 103A,A03,093561,Staff,5,0,36,31
1656217509170,MATH 103A,B01,083779,Greenfeld; Be'Eri,9,1,36,27
1656217509170,MATH 103A,B02,083780,Greenfeld; Be'Eri,1,0,36,35
1656217509170,MATH 103A,B03,093562,Staff,0,0,36,36
1656217515198,MATH 105,A01,085443,Carter; Anne Toulson,5,1,35,30
1656217515198,MATH 105,A02,093477,Staff,14,0,35,21
1656217521226,MATH 109,A01,083213,Ganzberger; Geoffrey Michael,0,0,34,34
1656217521226,MATH 109,A02,083214,Ganzberger; Geoffrey Michael,0,0,34,34
1656217521226,MATH 109,A03,093478,Staff,1,0,34,33
1656217521226,MATH 109,B01,083215,Ganzberger; Geoffrey Michael,4,0,32,28
1656217521226,MATH 109,B02,083216,Ganzberger; Geoffrey Michael,1,0,32,31
1656217521226,MATH 109,B03,093479,Staff,4,0,32,28
1656217527255,MATH 142A,A01,083219,Chow; Bennett,2,0,32,30
1656217527255,MATH 142A,A02,083220,Chow; Bennett,8,0,32,24
1656217527255,MATH 142A,A03,093480,Staff,5,0,32,27
1656217527255,MATH 142A,B03,093481,Staff,3,0,32,29
1656217527255,MATH 142A,B04,093558,Staff,6,0,32,26
1656217527255,MATH 142A,B05,093559,Staff,1,0,32,31
1656217533281,MATH 193A,A01,083224,Rotar; Vladimir,0,1,34,34
1656217533281,MATH 193A,A02,083225,Rotar; Vladimir,0,0,34,34
1656217533281,MATH 193A,A03,083781,Rotar; Vladimir,0,0,34,34
1656217533281,MATH 193A,A04,083782,Rotar; Vladimir,6,0,34,28
1656217533281,MATH 193A,A05,093482,Rotar; Vladimir,0,0,34,34
1656217539304,MATH 197,001,091859,McAuley; Julian John,9999,0,9999,0
1656217539304,MATH 197,002,095566,Kedlaya; Kiran S.,9997,0,9999,2
1656217539304,MATH 197,003,095567,Xiao; Ming,9999,0,9999,0
1656217539304,MATH 197,004,095571,Perols; Johan Lars,9998,0,9999,1
1656217546363,COGS 9,A01,083615,Shannon; Kyle Michael,3,0,75,72
1656217552389,COGS 11,A01,083617,Boyle; Mary E. T.,14,0,48,34
1656217558413,COGS 13,A01,083071,Bastos; Amalia Pinkusfeld,4,0,71,67
1656217564437,COGS 14A,A01,092681,Semenuks; Arturs,4,16,100,96
1656217570460,COGS 14B,A01,083073,Cheng; Tzu-Han,7,0,63,56
1656217576482,COGS 17,A01,092677,Semenuks; Arturs,7,0,81,74
1656217582512,COGS 100,A01,083619,Allen; Michael Gordon,2,0,70,68
1656217588535,COGS 101A,A01,083621,Davis; Joshua Daniel,4,0,68,64
1656217594563,COGS 101B,A01,091572,Allen; Michael Gordon,4,0,65,61
1656217600589,COGS 101C,A01,083625,Delgado; Tania,10,0,35,25
1656217606612,COGS 107A,A01,083627,Boyle; Mary E. T.,0,0,60,60
1656217612635,COGS 118A,A01,083075,Gupta; Anjum,7,0,76,69
1656217618659,CSE 3,A50,083646,Miranda; Gregory Joseph,18,0,50,32
1656217624684,CSE 8A,A50,083650,Miranda; Gregory Joseph,3,3,56,53
1656217630707,CSE 11,A01,083080,Cao; Yingjun,1,50,40,39
1656217636730,CSE 12,A01,083652,Krause-Levy; Sophia Louisa,7,3,120,113
1656217642757,CSE 15L,A01,083654,Morris; Justin Loren,2,0,50,48
1656217642757,CSE 15L,A02,083655,Morris; Justin Loren,4,0,50,46
1656217648785,CSE 20,A01,083657,Tran; Khoa Dang,30,0,80,50
1656217654808,CSE 21,A01,095574,Bach; Quang Tran,23,0,48,25
1656217660836,CSE 30,A01,083084,Eldon; John,2,8,80,78
1656217660836,CSE 30,B01,095061,Bhaskar; Nishant,1,2,50,49
1656217666865,CSE 100,A01,083659,Cao; Yingjun,2,20,70,68
1656217672893,CSE 134B,A01,083661,Powell; Thomas Allan,2,0,100,98
1656217678921,CSE 140,A01,083663,Gungor; Onat,9,0,85,76
1656217684947,CSE 140L,A01,083088,Eldon; John,8,0,100,92
1656217690978,CSE 175,A01,083665,Kumar; Rakesh,0,0,25,25
1656217697003,CSE 190,A00,092507,Dubnov; Shlomo,3,0,20,17
1656217703026,ECE 45,A01,083139,Congero; Spencer William,1,0,75,74
1656217709050,ECE 65,A50,083695,Saad; Andrew S,9,0,30,21
1656217709050,ECE 65,A51,095125,Staff,23,0,26,3
1656217715077,ECE 109,A01,091882,Touri; Behrouz,0,1,70,70
1656217721104,ECE 180,A00,083140,Abi Samra; Nicholas Camill,1,0,30,29
1656217721104,ECE 180,B00,083141,Abi Samra; Nicholas Camill,0,4,30,30
1656217727133,MATH 10A,A01,083735,Patchell; Gregory David,0,0,30,30
1656217727133,MATH 10A,A02,083736,Patchell; Gregory David,22,0,30,8
1656217727133,MATH 10A,A03,083737,Patchell; Gregory David,16,0,30,14
1656217733161,MATH 10B,A01,083207,Lim; Seonhee,0,0,34,34
1656217733161,MATH 10B,A02,083208,Lim; Seonhee,7,0,35,28
1656217733161,MATH 10B,A03,093472,Staff,1,0,34,33
1656217733161,MATH 10B,B01,083739,Sinha; Shubham,11,0,30,19
1656217739192,MATH 18,A01,083743,Cinel; Cameron Alexander,7,0,30,23
1656217739192,MATH 18,A02,083744,Cinel; Cameron Alexander,10,0,30,20
1656217739192,MATH 18,A03,083745,Cinel; Cameron Alexander,5,0,30,25
1656217739192,MATH 18,B01,083748,Rideout; David Porter,1,0,36,35
1656217739192,MATH 18,B02,083749,Rideout; David Porter,0,0,36,36
1656217739192,MATH 18,B03,083750,Rideout; David Porter,0,0,36,36
1656217739192,MATH 18,B04,083751,Rideout; David Porter,0,1,36,36
1656217739192,MATH 18,B05,093473,Rideout; David Porter,0,0,36,36
1656217739192,MATH 18,B06,093474,Rideout; David Porter,3,0,36,33
1656217745227,MATH 20A,A01,083754,Zheng; Zequn,11,0,40,29
1656217751255,MATH 20B,A01,083756,Briones; Jor-el Thomas Caparas,0,0,36,36
1656217751255,MATH 20B,A02,083757,Briones; Jor-el Thomas Caparas,0,0,36,36
1656217751255,MATH 20B,A03,093475,Staff,1,0,36,35
1656217757283,MATH 20C,A01,083760,Briones; Jor-el Thomas Caparas,0,0,35,35
1656217757283,MATH 20C,A02,083761,Briones; Jor-el Thomas Caparas,9,1,35,26
1656217757283,MATH 20C,A03,093476,Staff,0,0,35,35
1656217757283,MATH 20C,B01,083762,Bach; Quang Tran,1,0,30,29
1656217763307,MATH 20D,A01,083765,Tran; Brian Kha,1,0,30,29
1656217763307,MATH 20D,A02,083766,Tran; Brian Kha,0,1,30,30
1656217763307,MATH 20D,A03,083767,Tran; Brian Kha,2,0,30,28
1656217769331,MATH 20E,A01,083771,Ganguly; Soumya,3,0,32,29
1656217769331,MATH 20E,A02,083772,Ganguly; Soumya,0,0,32,32
1656217769331,MATH 20E,B01,083773,Ciotti; Benjamin,16,0,35,19
1656217769331,MATH 20E,B02,083774,Ciotti; Benjamin,15,0,35,20
1656217775359,MATH 103A,A01,083777,Greenfeld; Be'Eri,1,0,36,35
1656217775359,MATH 103A,A02,083778,Greenfeld; Be'Eri,1,0,36,35
1656217775359,MATH 103A,A03,093561,Staff,5,0,36,31
1656217775359,MATH 103A,B01,083779,Greenfeld; Be'Eri,9,1,36,27
1656217775359,MATH 103A,B02,083780,Greenfeld; Be'Eri,1,0,36,35
1656217775359,MATH 103A,B03,093562,Staff,0,0,36,36
1656217781383,MATH 105,A01,085443,Carter; Anne Toulson,5,1,35,30
1656217781383,MATH 105,A02,093477,Staff,14,0,35,21
1656217787411,MATH 109,A01,083213,Ganzberger; Geoffrey Michael,0,0,34,34
1656217787411,MATH 109,A02,083214,Ganzberger; Geoffrey Michael,0,0,34,34
1656217787411,MATH 109,A03,093478,Staff,1,0,34,33
1656217787411,MATH 109,B01,083215,Ganzberger; Geoffrey Michael,4,0,32,28
1656217787411,MATH 109,B02,083216,Ganzberger; Geoffrey Michael,1,0,32,31
1656217787411,MATH 109,B03,093479,Staff,4,0,32,28
1656217793436,MATH 142A,A01,083219,Chow; Bennett,2,0,32,30
1656217793436,MATH 142A,A02,083220,Chow; Bennett,8,0,32,24
1656217793436,MATH 142A,A03,093480,Staff,5,0,32,27
1656217793436,MATH 142A,B03,093481,Staff,3,0,32,29
1656217793436,MATH 142A,B04,093558,Staff,6,0,32,26
1656217793436,MATH 142A,B05,093559,Staff,1,0,32,31
1656217799457,MATH 193A,A01,083224,Rotar; Vladimir,0,1,34,34
1656217799457,MATH 193A,A02,083225,Rotar; Vladimir,0,0,34,34
1656217799457,MATH 193A,A03,083781,Rotar; Vladimir,0,0,34,34
1656217799457,MATH 193A,A04,083782,Rotar; Vladimir,6,0,34,28
1656217799457,MATH 193A,A05,093482,Rotar; Vladimir,0,0,34,34
1656217805479,MATH 197,001,091859,McAuley; Julian John,9999,0,9999,0
1656217805479,MATH 197,002,095566,Kedlaya; Kiran S.,9997,0,9999,2
1656217805479,MATH 197,003,095567,Xiao; Ming,9999,0,9999,0
1656217805479,MATH 197,004,095571,Perols; Johan Lars,9998,0,9999,1
1656217812536,COGS 9,A01,083615,Shannon; Kyle Michael,3,0,75,72
1656217818559,COGS 11,A01,083617,Boyle; Mary E. T.,14,0,48,34
1656217824585,COGS 13,A01,083071,Bastos; Amalia Pinkusfeld,4,0,71,67
1656217830608,COGS 14A,A01,092681,Semenuks; Arturs,4,16,100,96
1656217836635,COGS 14B,A01,083073,Cheng; Tzu-Han,7,0,63,56
1656217842658,COGS 17,A01,092677,Semenuks; Arturs,7,0,81,74
1656217848682,COGS 100,A01,083619,Allen; Michael Gordon,2,0,70,68
1656217854704,COGS 101A,A01,083621,Davis; Joshua Daniel,4,0,68,64
1656217860732,COGS 101B,A01,091572,Allen; Michael Gordon,4,0,65,61
1656217866756,COGS 101C,A01,083625,Delgado; Tania,10,0,35,25
1656217872784,COGS 107A,A01,083627,Boyle; Mary E. T.,0,0,60,60
1656217878812,COGS 118A,A01,083075,Gupta; Anjum,7,0,76,69
1656217884841,CSE 3,A50,083646,Miranda; Gregory Joseph,18,0,50,32
1656217890870,CSE 8A,A50,083650,Miranda; Gregory Joseph,3,3,56,53
1656217896892,CSE 11,A01,083080,Cao; Yingjun,1,50,40,39
1656217903009,CSE 12,A01,083652,Krause-Levy; Sophia Louisa,7,3,120,113
1656217909033,CSE 15L,A01,083654,Morris; Justin Loren,2,0,50,48
1656217909033,CSE 15L,A02,083655,Morris; Justin Loren,4,0,50,46
1656217915056,CSE 20,A01,083657,Tran; Khoa Dang,30,0,80,50
1656217921080,CSE 21,A01,095574,Bach; Quang Tran,23,0,48,25
1656217927103,CSE 30,A01,083084,Eldon; John,2,8,80,78
1656217927103,CSE 30,B01,095061,Bhaskar; Nishant,1,2,50,49
1656217933125,CSE 100,A01,083659,Cao; Yingjun,2,20,70,68
1656217939152,CSE 134B,A01,083661,Powell; Thomas Allan,3,0,100,97
1656217945180,CSE 140,A01,083663,Gungor; Onat,9,0,85,76
1656217951209,CSE 140L,A01,083088,Eldon; John,8,0,100,92
1656217957234,CSE 175,A01,083665,Kumar; Rakesh,0,0,25,25
1656217963262,CSE 190,A00,092507,Dubnov; Shlomo,3,0,20,17
1656217969289,ECE 45,A01,083139,Congero; Spencer William,1,0,75,74
1656217975314,ECE 65,A50,083695,Saad; Andrew S,9,0,30,21
1656217975314,ECE 65,A51,095125,Staff,23,0,26,3
1656217981339,ECE 109,A01,091882,Touri; Behrouz,0,1,70,70
1656217987365,ECE 180,A00,083140,Abi Samra; Nicholas Camill,1,0,30,29
1656217987365,ECE 180,B00,083141,Abi Samra; Nicholas Camill,0,4,30,30
1656217993388,MATH 10A,A01,083735,Patchell; Gregory David,0,0,30,30
1656217993388,MATH 10A,A02,083736,Patchell; Gregory David,22,0,30,8
1656217993388,MATH 10A,A03,083737,Patchell; Gregory David,16,0,30,14
1656217999415,MATH 10B,A01,083207,Lim; Seonhee,0,0,34,34
1656217999415,MATH 10B,A02,083208,Lim; Seonhee,7,0,35,28
1656217999415,MATH 10B,A03,093472,Staff,1,0,34,33
1656217999415,MATH 10B,B01,083739,Sinha; Shubham,11,0,30,19
1656218005452,MATH 18,A01,083743,Cinel; Cameron Alexander,7,0,30,23
1656218005452,MATH 18,A02,083744,Cinel; Cameron Alexander,10,0,30,20
1656218005452,MATH 18,A03,083745,Cinel; Cameron Alexander,5,0,30,25
1656218005452,MATH 18,B01,083748,Rideout; David Porter,1,0,36,35
1656218005452,MATH 18,B02,083749,Rideout; David Porter,0,0,36,36
1656218005452,MATH 18,B03,083750,Rideout; David Porter,0,0,36,36
1656218005452,MATH 18,B04,083751,Rideout; David Porter,0,1,36,36
1656218005452,MATH 18,B05,093473,Rideout; David Porter,0,0,36,36
1656218005452,MATH 18,B06,093474,Rideout; David Porter,3,0,36,33
1656218011474,MATH 20A,A01,083754,Zheng; Zequn,11,0,40,29
1656218017500,MATH 20B,A01,083756,Briones; Jor-el Thomas Caparas,0,0,36,36
1656218017500,MATH 20B,A02,083757,Briones; Jor-el Thomas Caparas,0,0,36,36
1656218017500,MATH 20B,A03,093475,Staff,1,0,36,35
1656218023523,MATH 20C,A01,083760,Briones; Jor-el Thomas Caparas,0,0,35,35
1656218023523,MATH 20C,A02,083761,Briones; Jor-el Thomas Caparas,9,1,35,26
1656218023523,MATH 20C,A03,093476,Staff,0,0,35,35
1656218023523,MATH 20C,B01,083762,Bach; Quang Tran,1,0,30,29
1656218029547,MATH 20D,A01,083765,Tran; Brian Kha,1,0,30,29
1656218029547,MATH 20D,A02,083766,Tran; Brian Kha,0,1,30,30
1656218029547,MATH 20D,A03,083767,Tran; Brian Kha,2,0,30,28
1656218035571,MATH 20E,A01,083771,Ganguly; Soumya,3,0,32,29
1656218035571,MATH 20E,A02,083772,Ganguly; Soumya,0,0,32,32
1656218035571,MATH 20E,B01,083773,Ciotti; Benjamin,16,0,35,19
1656218035571,MATH 20E,B02,083774,Ciotti; Benjamin,15,0,35,20
1656218041614,MATH 103A,A01,083777,Greenfeld; Be'Eri,1,0,36,35
1656218041614,MATH 103A,A02,083778,Greenfeld; Be'Eri,1,0,36,35
1656218041614,MATH 103A,A03,093561,Staff,5,0,36,31
1656218041614,MATH 103A,B01,083779,Greenfeld; Be'Eri,9,1,36,27
1656218041614,MATH 103A,B02,083780,Greenfeld; Be'Eri,1,0,36,35
1656218041614,MATH 103A,B03,093562,Staff,0,0,36,36
1656218047637,MATH 105,A01,085443,Carter; Anne Toulson,5,1,35,30
1656218047637,MATH 105,A02,093477,Staff,14,0,35,21
1656218053662,MATH 109,A01,083213,Ganzberger; Geoffrey Michael,0,0,34,34
1656218053662,MATH 109,A02,083214,Ganzberger; Geoffrey Michael,0,0,34,34
1656218053662,MATH 109,A03,093478,Staff,1,0,34,33
1656218053662,MATH 109,B01,083215,Ganzberger; Geoffrey Michael,4,0,32,28
1656218053662,MATH 109,B02,083216,Ganzberger; Geoffrey Michael,1,0,32,31
1656218053662,MATH 109,B03,093479,Staff,4,0,32,28
1656218059691,MATH 142A,A01,083219,Chow; Bennett,2,0,32,30
1656218059691,MATH 142A,A02,083220,Chow; Bennett,8,0,32,24
1656218059691,MATH 142A,A03,093480,Staff,5,0,32,27
1656218059691,MATH 142A,B03,093481,Staff,3,0,32,29
1656218059691,MATH 142A,B04,093558,Staff,6,0,32,26
1656218059691,MATH 142A,B05,093559,Staff,1,0,32,31
1656218065714,MATH 193A,A01,083224,Rotar; Vladimir,0,1,34,34
1656218065714,MATH 193A,A02,083225,Rotar; Vladimir,0,0,34,34
1656218065714,MATH 193A,A03,083781,Rotar; Vladimir,0,0,34,34
1656218065714,MATH 193A,A04,083782,Rotar; Vladimir,6,0,34,28
1656218065714,MATH 193A,A05,093482,Rotar; Vladimir,0,0,34,34
1656218071742,MATH 197,001,091859,McAuley; Julian John,9999,0,9999,0
1656218071742,MATH 197,002,095566,Kedlaya; Kiran S.,9997,0,9999,2
1656218071742,MATH 197,003,095567,Xiao; Ming,9999,0,9999,0
1656218071742,MATH 197,004,095571,Perols; Johan Lars,9998,0,9999,1
1656218078795,COGS 9,A01,083615,Shannon; Kyle Michael,3,0,75,72
1656218084817,COGS 11,A01,083617,Boyle; Mary E. T.,14,0,48,34
1656218090840,COGS 13,A01,083071,Bastos; Amalia Pinkusfeld,4,0,71,67
1656218096864,COGS 14A,A01,092681,Semenuks; Arturs,4,16,100,96
1656218102906,COGS 14B,A01,083073,Cheng; Tzu-Han,7,0,63,56
1656218108932,COGS 17,A01,092677,Semenuks; Arturs,7,0,81,74
1656218114958,COGS 100,A01,083619,Allen; Michael Gordon,2,0,70,68
1656218120982,COGS 101A,A01,083621,Davis; Joshua Daniel,4,0,68,64
1656218127004,COGS 101B,A01,091572,Allen; Michael Gordon,4,0,65,61
1656218133028,COGS 101C,A01,083625,Delgado; Tania,10,0,35,25
1656218139051,COGS 107A,A01,083627,Boyle; Mary E. T.,0,0,60,60
1656218145078,COGS 118A,A01,083075,Gupta; Anjum,7,0,76,69
1656218151106,CSE 3,A50,083646,Miranda; Gregory Joseph,18,0,50,32
1656218157135,CSE 8A,A50,083650,Miranda; Gregory Joseph,3,3,56,53
1656218163163,CSE 11,A01,083080,Cao; Yingjun,1,50,40,39
1656218169191,CSE 12,A01,083652,Krause-Levy; Sophia Louisa,7,3,120,113
1656218175213,CSE 15L,A01,083654,Morris; Justin Loren,2,0,50,48
1656218175213,CSE 15L,A02,083655,Morris; Justin Loren,4,0,50,46
1656218181242,CSE 20,A01,083657,Tran; Khoa Dang,30,0,80,50
1656218187267,CSE 21,A01,095574,Bach; Quang Tran,23,0,48,25
1656218193291,CSE 30,A01,083084,Eldon; John,2,8,80,78
1656218193291,CSE 30,B01,095061,Bhaskar; Nishant,1,2,50,49
1656218199318,CSE 100,A01,083659,Cao; Yingjun,2,20,70,68
1656218205342,CSE 134B,A01,083661,Powell; Thomas Allan,3,0,100,97
1656218211366,CSE 140,A01,083663,Gungor; Onat,9,0,85,76
1656218217389,CSE 140L,A01,083088,Eldon; John,8,0,100,92
1656218223416,CSE 175,A01,083665,Kumar; Rakesh,0,0,25,25
1656218229440,CSE 190,A00,092507,Dubnov; Shlomo,3,0,20,17
1656218235464,ECE 45,A01,083139,Congero; Spencer William,1,0,75,74
1656218241498,ECE 65,A50,083695,Saad; Andrew S,9,0,30,21
1656218241498,ECE 65,A51,095125,Staff,23,0,26,3
1656218247522,ECE 109,A01,091882,Touri; Behrouz,0,1,70,70
1656218253546,ECE 180,A00,083140,Abi Samra; Nicholas Camill,1,0,30,29
1656218253546,ECE 180,B00,083141,Abi Samra; Nicholas Camill,0,4,30,30
1656218259569,MATH 10A,A01,083735,Patchell; Gregory David,0,0,30,30
1656218259569,MATH 10A,A02,083736,Patchell; Gregory David,22,0,30,8
1656218259569,MATH 10A,A03,083737,Patchell; Gregory David,16,0,30,14
1656218265593,MATH 10B,A01,083207,Lim; Seonhee,0,0,34,34
1656218265593,MATH 10B,A02,083208,Lim; Seonhee,7,0,35,28
1656218265593,MATH 10B,A03,093472,Staff,1,0,34,33
1656218265593,MATH 10B,B01,083739,Sinha; Shubham,11,0,30,19
1656218271617,MATH 18,A01,083743,Cinel; Cameron Alexander,7,0,30,23
1656218271617,MATH 18,A02,083744,Cinel; Cameron Alexander,10,0,30,20
1656218271617,MATH 18,A03,083745,Cinel; Cameron Alexander,5,0,30,25
1656218271617,MATH 18,B01,083748,Rideout; David Porter,1,0,36,35
1656218271617,MATH 18,B02,083749,Rideout; David Porter,0,0,36,36
1656218271617,MATH 18,B03,083750,Rideout; David Porter,0,0,36,36
1656218271617,MATH 18,B04,083751,Rideout; David Porter,0,1,36,36
1656218271617,MATH 18,B05,093473,Rideout; David Porter,0,0,36,36
1656218271617,MATH 18,B06,093474,Rideout; David Porter,3,0,36,33
1656218277641,MATH 20A,A01,083754,Zheng; Zequn,11,0,40,29
1656218283665,MATH 20B,A01,083756,Briones; Jor-el Thomas Caparas,0,0,36,36
1656218283665,MATH 20B,A02,083757,Briones; Jor-el Thomas Caparas,0,0,36,36
1656218283665,MATH 20B,A03,093475,Staff,1,0,36,35
1656218289693,MATH 20C,A01,083760,Briones; Jor-el Thomas Caparas,0,0,35,35
1656218289693,MATH 20C,A02,083761,Briones; Jor-el Thomas Caparas,9,1,35,26
1656218289693,MATH 20C,A03,093476,Staff,0,0,35,35
1656218289693,MATH 20C,B01,083762,Bach; Quang Tran,1,0,30,29
1656218295719,MATH 20D,A01,083765,Tran; Brian Kha,1,0,30,29
1656218295719,MATH 20D,A02,083766,Tran; Brian Kha,0,1,30,30
1656218295719,MATH 20D,A03,083767,Tran; Brian Kha,2,0,30,28
1656218301743,MATH 20E,A01,083771,Ganguly; Soumya,3,0,32,29
1656218301743,MATH 20E,A02,083772,Ganguly; Soumya,0,0,32,32
1656218301743,MATH 20E,B01,083773,Ciotti; Benjamin,16,0,35,19
1656218301743,MATH 20E,B02,083774,Ciotti; Benjamin,15,0,35,20
1656218307767,MATH 103A,A01,083777,Greenfeld; Be'Eri,1,0,36,35
1656218307767,MATH 103A,A02,083778,Greenfeld; Be'Eri,1,0,36,35
1656218307767,MATH 103A,A03,093561,Staff,5,0,36,31
1656218307767,MATH 103A,B01,083779,Greenfeld; Be'Eri,9,1,36,27
1656218307767,MATH 103A,B02,083780,Greenfeld; Be'Eri,1,0,36,35
1656218307767,MATH 103A,B03,093562,Staff,0,0,36,36
1656218313791,MATH 105,A01,085443,Carter; Anne Toulson,5,1,35,30
1656218313791,MATH 105,A02,093477,Staff,14,0,35,21
1656218319813,MATH 109,A01,083213,Ganzberger; Geoffrey Michael,0,0,34,34
1656218319813,MATH 109,A02,083214,Ganzberger; Geoffrey Michael,0,0,34,34
1656218319813,MATH 109,A03,093478,Staff,1,0,34,33
1656218319813,MATH 109,B01,083215,Ganzberger; Geoffrey Michael,4,0,32,28
1656218319813,MATH 109,B02,083216,Ganzberger; Geoffrey Michael,1,0,32,31
1656218319813,MATH 109,B03,093479,Staff,4,0,32,28
1656218325853,MATH 142A,A01,083219,Chow; Bennett,2,0,32,30
1656218325853,MATH 142A,A02,083220,Chow; Bennett,8,0,32,24
1656218325853,MATH 142A,A03,093480,Staff,5,0,32,27
1656218325853,MATH 142A,B03,093481,Staff,3,0,32,29
1656218325853,MATH 142A,B04,093558,Staff,6,0,32,26
1656218325853,MATH 142A,B05,093559,Staff,1,0,32,31
1656218331881,MATH 193A,A01,083224,Rotar; Vladimir,0,1,34,34
1656218331881,MATH 193A,A02,083225,Rotar; Vladimir,0,0,34,34
1656218331881,MATH 193A,A03,083781,Rotar; Vladimir,0,0,34,34
1656218331881,MATH 193A,A04,083782,Rotar; Vladimir,6,0,34,28
1656218331881,MATH 193A,A05,093482,Rotar; Vladimir,0,0,34,34
1656218337903,MATH 197,001,091859,McAuley; Julian John,9999,0,9999,0
1656218337903,MATH 197,002,095566,Kedlaya; Kiran S.,9997,0,9999,2
1656218337903,MATH 197,003,095567,Xiao; Ming,9999,0,9999,0
1656218337903,MATH 197,004,095571,Perols; Johan Lars,9998,0,9999,1
1656218344960,COGS 9,A01,083615,Shannon; Kyle Michael,3,0,75,72
1656218350995,COGS 11,A01,083617,Boyle; Mary E. T.,14,0,48,34
1656218357018,COGS 13,A01,083071,Bastos; Amalia Pinkusfeld,4,0,71,67
1656218363042,COGS 14A,A01,092681,Semenuks; Arturs,4,16,100,96
1656218369067,COGS 14B,A01,083073,Cheng; Tzu-Han,7,0,63,56
1656218375095,COGS 17,A01,092677,Semenuks; Arturs,7,0,81,74
1656218381119,COGS 100,A01,083619,Allen; Michael Gordon,2,0,70,68
1656218387146,COGS 101A,A01,083621,Davis; Joshua Daniel,4,0,68,64
1656218393169,COGS 101B,A01,091572,Allen; Michael Gordon,4,0,65,61
1656218399192,COGS 101C,A01,083625,Delgado; Tania,10,0,35,25
1656218405219,COGS 107A,A01,083627,Boyle; Mary E. T.,0,0,60,60
1656218411250,COGS 118A,A01,083075,Gupta; Anjum,7,0,76,69
1656218417279,CSE 3,A50,083646,Miranda; Gregory Joseph,18,0,50,32
1656218423302,CSE 8A,A50,083650,Miranda; Gregory Joseph,3,3,56,53
1656218429336,CSE 11,A01,083080,Cao; Yingjun,1,50,40,39
1656218442373,CSE 12,A01,083652,Krause-Levy; Sophia Louisa,7,3,120,113
1656218448397,CSE 15L,A01,083654,Morris; Justin Loren,2,0,50,48
1656218448397,CSE 15L,A02,083655,Morris; Justin Loren,4,0,50,46
1656218454420,CSE 20,A01,083657,Tran; Khoa Dang,30,0,80,50
1656218460446,CSE 21,A01,095574,Bach; Quang Tran,23,0,48,25
1656218466471,CSE 30,A01,083084,Eldon; John,2,8,80,78
1656218466471,CSE 30,B01,095061,Bhaskar; Nishant,1,2,50,49
1656218472495,CSE 100,A01,083659,Cao; Yingjun,2,20,70,68
1656218478523,CSE 134B,A01,083661,Powell; Thomas Allan,3,0,100,97
1656218484546,CSE 140,A01,083663,Gungor; Onat,9,0,85,76
1656218490571,CSE 140L,A01,083088,Eldon; John,8,0,100,92
1656218496594,CSE 175,A01,083665,Kumar; Rakesh,0,0,25,25
1656218502617,CSE 190,A00,092507,Dubnov; Shlomo,3,0,20,17
1656218508713,ECE 45,A01,083139,Congero; Spencer William,1,0,75,74
1656218514739,ECE 65,A50,083695,Saad; Andrew S,9,0,30,21
1656218514739,ECE 65,A51,095125,Staff,23,0,26,3
1656218520767,ECE 109,A01,091882,Touri; Behrouz,0,1,70,70
1656218526806,ECE 180,A00,083140,Abi Samra; Nicholas Camill,1,0,30,29
1656218526806,ECE 180,B00,083141,Abi Samra; Nicholas Camill,0,4,30,30
1656218532836,MATH 10A,A01,083735,Patchell; Gregory David,0,0,30,30
1656218532836,MATH 10A,A02,083736,Patchell; Gregory David,22,0,30,8
1656218532836,MATH 10A,A03,083737,Patchell; Gregory David,16,0,30,14
1656218538866,MATH 10B,A01,083207,Lim; Seonhee,0,0,34,34
1656218538866,MATH 10B,A02,083208,Lim; Seonhee,7,0,35,28
1656218538866,MATH 10B,A03,093472,Staff,1,0,34,33
1656218538866,MATH 10B,B01,083739,Sinha; Shubham,11,0,30,19
1656218544895,MATH 18,A01,083743,Cinel; Cameron Alexander,7,0,30,23
1656218544895,MATH 18,A02,083744,Cinel; Cameron Alexander,10,0,30,20
1656218544895,MATH 18,A03,083745,Cinel; Cameron Alexander,5,0,30,25
1656218544895,MATH 18,B01,083748,Rideout; David Porter,1,0,36,35
1656218544895,MATH 18,B02,083749,Rideout; David Porter,0,0,36,36
1656218544895,MATH 18,B03,083750,Rideout; David Porter,0,0,36,36
1656218544895,MATH 18,B04,083751,Rideout; David Porter,0,1,36,36
1656218544895,MATH 18,B05,093473,Rideout; David Porter,0,0,36,36
1656218544895,MATH 18,B06,093474,Rideout; David Porter,3,0,36,33
1656218550918,MATH 20A,A01,083754,Zheng; Zequn,11,0,40,29
1656218556942,MATH 20B,A01,083756,Briones; Jor-el Thomas Caparas,0,0,36,36
1656218556942,MATH 20B,A02,083757,Briones; Jor-el Thomas Caparas,0,0,36,36
1656218556942,MATH 20B,A03,093475,Staff,1,0,36,35
1656218562971,MATH 20C,A01,083760,Briones; Jor-el Thomas Caparas,0,0,35,35
1656218562971,MATH 20C,A02,083761,Briones; Jor-el Thomas Caparas,9,1,35,26
1656218562971,MATH 20C,A03,093476,Staff,0,0,35,35
1656218562971,MATH 20C,B01,083762,Bach; Quang Tran,1,0,30,29
1656218568999,MATH 20D,A01,083765,Tran; Brian Kha,1,0,30,29
1656218568999,MATH 20D,A02,083766,Tran; Brian Kha,0,1,30,30
1656218568999,MATH 20D,A03,083767,Tran; Brian Kha,2,0,30,28
1656218575024,MATH 20E,A01,083771,Ganguly; Soumya,3,0,32,29
1656218575024,MATH 20E,A02,083772,Ganguly; Soumya,0,0,32,32
1656218575024,MATH 20E,B01,083773,Ciotti; Benjamin,16,0,35,19
1656218575024,MATH 20E,B02,083774,Ciotti; Benjamin,15,0,35,20
1656218581048,MATH 103A,A01,083777,Greenfeld; Be'Eri,1,0,36,35
1656218581048,MATH 103A,A02,083778,Greenfeld; Be'Eri,1,0,36,35
1656218581048,MATH 103A,A03,093561,Staff,5,0,36,31
1656218581048,MATH 103A,B01,083779,Greenfeld; Be'Eri,9,1,36,27
1656218581048,MATH 103A,B02,083780,Greenfeld; Be'Eri,1,0,36,35
1656218581048,MATH 103A,B03,093562,Staff,0,0,36,36
1656218587072,MATH 105,A01,085443,Carter; Anne Toulson,5,1,35,30
1656218587072,MATH 105,A02,093477,Staff,14,0,35,21
1656218593093,MATH 109,A01,083213,Ganzberger; Geoffrey Michael,0,0,34,34
1656218593093,MATH 109,A02,083214,Ganzberger; Geoffrey Michael,0,0,34,34
1656218593093,MATH 109,A03,093478,Staff,1,0,34,33
1656218593093,MATH 109,B01,083215,Ganzberger; Geoffrey Michael,4,0,32,28
1656218593093,MATH 109,B02,083216,Ganzberger; Geoffrey Michael,1,0,32,31
1656218593093,MATH 109,B03,093479,Staff,4,0,32,28
1656218599117,MATH 142A,A01,083219,Chow; Bennett,2,0,32,30
1656218599117,MATH 142A,A02,083220,Chow; Bennett,8,0,32,24
1656218599117,MATH 142A,A03,093480,Staff,5,0,32,27
1656218599117,MATH 142A,B03,093481,Staff,3,0,32,29
1656218599117,MATH 142A,B04,093558,Staff,6,0,32,26
1656218599117,MATH 142A,B05,093559,Staff,1,0,32,31
1656218605141,MATH 193A,A01,083224,Rotar; Vladimir,0,1,34,34
1656218605141,MATH 193A,A02,083225,Rotar; Vladimir,0,0,34,34
1656218605141,MATH 193A,A03,083781,Rotar; Vladimir,0,0,34,34
1656218605141,MATH 193A,A04,083782,Rotar; Vladimir,6,0,34,28
1656218605141,MATH 193A,A05,093482,Rotar; Vladimir,0,0,34,34
1656218611163,MATH 197,001,091859,McAuley; Julian John,9999,0,9999,0
1656218611163,MATH 197,002,095566,Kedlaya; Kiran S.,9997,0,9999,2
1656218611163,MATH 197,003,095567,Xiao; Ming,9999,0,9999,0
1656218611163,MATH 197,004,095571,Perols; Johan Lars,9998,0,9999,1
1656218618225,COGS 9,A01,083615,Shannon; Kyle Michael,3,0,75,72
1656218624251,COGS 11,A01,083617,Boyle; Mary E. T.,14,0,48,34
1656218630277,COGS 13,A01,083071,Bastos; Amalia Pinkusfeld,4,0,71,67
1656218636317,COGS 14A,A01,092681,Semenuks; Arturs,4,16,100,96
1656218642341,COGS 14B,A01,083073,Cheng; Tzu-Han,7,0,63,56
1656218648364,COGS 17,A01,092677,Semenuks; Arturs,7,0,81,74
1656218654391,COGS 100,A01,083619,Allen; Michael Gordon,2,0,70,68
1656218660418,COGS 101A,A01,083621,Davis; Joshua Daniel,4,0,68,64
1656218666443,COGS 101B,A01,091572,Allen; Michael Gordon,4,0,65,61
1656218672467,COGS 101C,A01,083625,Delgado; Tania,10,0,35,25
1656218678494,COGS 107A,A01,083627,Boyle; Mary E. T.,0,0,60,60
1656218684517,COGS 118A,A01,083075,Gupta; Anjum,7,0,76,69
1656218690540,CSE 3,A50,083646,Miranda; Gregory Joseph,18,0,50,32
1656218696564,CSE 8A,A50,083650,Miranda; Gregory Joseph,3,3,56,53
1656218702587,CSE 11,A01,083080,Cao; Yingjun,1,50,40,39
1656218708610,CSE 12,A01,083652,Krause-Levy; Sophia Louisa,7,3,120,113
1656218714638,CSE 15L,A01,083654,Morris; Justin Loren,2,0,50,48
1656218714638,CSE 15L,A02,083655,Morris; Justin Loren,4,0,50,46
1656218720673,CSE 20,A01,083657,Tran; Khoa Dang,30,0,80,50
1656218726697,CSE 21,A01,095574,Bach; Quang Tran,23,0,48,25
1656218732724,CSE 30,A01,083084,Eldon; John,2,8,80,78
1656218732724,CSE 30,B01,095061,Bhaskar; Nishant,1,2,50,49
1656218738750,CSE 100,A01,083659,Cao; Yingjun,2,20,70,68
1656218744774,CSE 134B,A01,083661,Powell; Thomas Allan,3,0,100,97
1656218750801,CSE 140,A01,083663,Gungor; Onat,9,0,85,76
1656218756829,CSE 140L,A01,083088,Eldon; John,8,0,100,92
1656218762852,CSE 175,A01,083665,Kumar; Rakesh,0,0,25,25
1656218768888,CSE 190,A00,092507,Dubnov; Shlomo,3,0,20,17
1656218774912,ECE 45,A01,083139,Congero; Spencer William,1,0,75,74
1656218780937,ECE 65,A50,083695,Saad; Andrew S,9,0,30,21
1656218780937,ECE 65,A51,095125,Staff,23,0,26,3
1656218786960,ECE 109,A01,091882,Touri; Behrouz,0,1,70,70
1656218792989,ECE 180,A00,083140,Abi Samra; Nicholas Camill,1,0,30,29
1656218792989,ECE 180,B00,083141,Abi Samra; Nicholas Camill,0,4,30,30
1656218799014,MATH 10A,A01,083735,Patchell; Gregory David,0,0,30,30
1656218799014,MATH 10A,A02,083736,Patchell; Gregory David,22,0,30,8
1656218799014,MATH 10A,A03,083737,Patchell; Gregory David,16,0,30,14
1656218805037,MATH 10B,A01,083207,Lim; Seonhee,0,0,34,34
1656218805037,MATH 10B,A02,083208,Lim; Seonhee,7,0,35,28
1656218805037,MATH 10B,A03,093472,Staff,1,0,34,33
1656218805037,MATH 10B,B01,083739,Sinha; Shubham,11,0,30,19
1656218811063,MATH 18,A01,083743,Cinel; Cameron Alexander,7,0,30,23
1656218811063,MATH 18,A02,083744,Cinel; Cameron Alexander,10,0,30,20
1656218811063,MATH 18,A03,083745,Cinel; Cameron Alexander,5,0,30,25
1656218811063,MATH 18,B01,083748,Rideout; David Porter,1,0,36,35
1656218811063,MATH 18,B02,083749,Rideout; David Porter,0,0,36,36
1656218811063,MATH 18,B03,083750,Rideout; David Porter,0,0,36,36
1656218811063,MATH 18,B04,083751,Rideout; David Porter,0,1,36,36
1656218811063,MATH 18,B05,093473,Rideout; David Porter,0,0,36,36
1656218811063,MATH 18,B06,093474,Rideout; David Porter,3,0,36,33
1656218817088,MATH 20A,A01,083754,Zheng; Zequn,11,0,40,29
1656218823118,MATH 20B,A01,083756,Briones; Jor-el Thomas Caparas,0,0,36,36
1656218823118,MATH 20B,A02,083757,Briones; Jor-el Thomas Caparas,0,0,36,36
1656218823118,MATH 20B,A03,093475,Staff,1,0,36,35
1656218829140,MATH 20C,A01,083760,Briones; Jor-el Thomas Caparas,0,0,35,35
1656218829140,MATH 20C,A02,083761,Briones; Jor-el Thomas Caparas,9,1,35,26
1656218829140,MATH 20C,A03,093476,Staff,0,0,35,35
1656218829140,MATH 20C,B01,083762,Bach; Quang Tran,1,0,30,29
1656218835163,MATH 20D,A01,083765,Tran; Brian Kha,1,0,30,29
1656218835163,MATH 20D,A02,083766,Tran; Brian Kha,0,1,30,30
1656218835163,MATH 20D,A03,083767,Tran; Brian Kha,2,0,30,28
1656218841194,MATH 20E,A01,083771,Ganguly; Soumya,3,0,32,29
1656218841194,MATH 20E,A02,083772,Ganguly; Soumya,0,0,32,32
1656218841194,MATH 20E,B01,083773,Ciotti; Benjamin,16,0,35,19
1656218841194,MATH 20E,B02,083774,Ciotti; Benjamin,15,0,35,20
1656218847216,MATH 103A,A01,083777,Greenfeld; Be'Eri,1,0,36,35
1656218847216,MATH 103A,A02,083778,Greenfeld; Be'Eri,1,0,36,35
1656218847216,MATH 103A,A03,093561,Staff,5,0,36,31
1656218847216,MATH 103A,B01,083779,Greenfeld; Be'Eri,9,1,36,27
1656218847216,MATH 103A,B02,083780,Greenfeld; Be'Eri,1,0,36,35
1656218847216,MATH 103A,B03,093562,Staff,0,0,36,36
1656218853242,MATH 105,A01,085443,Carter; Anne Toulson,5,1,35,30
1656218853242,MATH 105,A02,093477,Staff,14,0,35,21
1656218859282,MATH 109,A01,083213,Ganzberger; Geoffrey Michael,0,0,34,34
1656218859282,MATH 109,A02,083214,Ganzberger; Geoffrey Michael,0,0,34,34
1656218859282,MATH 109,A03,093478,Staff,1,0,34,33
1656218859282,MATH 109,B01,083215,Ganzberger; Geoffrey Michael,4,0,32,28
1656218859282,MATH 109,B02,083216,Ganzberger; Geoffrey Michael,1,0,32,31
1656218859282,MATH 109,B03,093479,Staff,4,0,32,28
1656218865305,MATH 142A,A01,083219,Chow; Bennett,2,0,32,30
1656218865305,MATH 142A,A02,083220,Chow; Bennett,8,0,32,24
1656218865305,MATH 142A,A03,093480,Staff,5,0,32,27
1656218865305,MATH 142A,B03,093481,Staff,3,0,32,29
1656218865305,MATH 142A,B04,093558,Staff,6,0,32,26
1656218865305,MATH 142A,B05,093559,Staff,1,0,32,31
1656218871328,MATH 193A,A01,083224,Rotar; Vladimir,0,1,34,34
1656218871328,MATH 193A,A02,083225,Rotar; Vladimir,0,0,34,34
1656218871328,MATH 193A,A03,083781,Rotar; Vladimir,0,0,34,34
1656218871328,MATH 193A,A04,083782,Rotar; Vladimir,6,0,34,28
1656218871328,MATH 193A,A05,093482,Rotar; Vladimir,0,0,34,34
1656218877355,MATH 197,001,091859,McAuley; Julian John,9999,0,9999,0
1656218877355,MATH 197,002,095566,Kedlaya; Kiran S.,9997,0,9999,2
1656218877355,MATH 197,003,095567,Xiao; Ming,9999,0,9999,0
1656218877355,MATH 197,004,095571,Perols; Johan Lars,9998,0,9999,1
1656218884590,COGS 9,A01,083615,Shannon; Kyle Michael,3,0,75,72
1656218890616,COGS 11,A01,083617,Boyle; Mary E. T.,14,0,48,34
1656218896640,COGS 13,A01,083071,Bastos; Amalia Pinkusfeld,4,0,71,67
1656218902672,COGS 14A,A01,092681,Semenuks; Arturs,4,16,100,96
1656218908698,COGS 14B,A01,083073,Cheng; Tzu-Han,7,0,63,56
1656218914734,COGS 17,A01,092677,Semenuks; Arturs,7,0,81,74
1656218920759,COGS 100,A01,083619,Allen; Michael Gordon,2,0,70,68
1656218926790,COGS 101A,A01,083621,Davis; Joshua Daniel,4,0,68,64
1656218932813,COGS 101B,A01,091572,Allen; Michael Gordon,4,0,65,61
1656218938840,COGS 101C,A01,083625,Delgado; Tania,10,0,35,25
1656218944866,COGS 107A,A01,083627,Boyle; Mary E. T.,0,0,60,60
1656218950893,COGS 118A,A01,083075,Gupta; Anjum,7,0,76,69
1656218956917,CSE 3,A50,083646,Miranda; Gregory Joseph,18,0,50,32
1656218962945,CSE 8A,A50,083650,Miranda; Gregory Joseph,3,3,56,53
1656218968974,CSE 11,A01,083080,Cao; Yingjun,1,50,40,39
1656218974996,CSE 12,A01,083652,Krause-Levy; Sophia Louisa,7,3,120,113
1656218981024,CSE 15L,A01,083654,Morris; Justin Loren,2,0,50,48
1656218981024,CSE 15L,A02,083655,Morris; Justin Loren,4,0,50,46
1656218987047,CSE 20,A01,083657,Tran; Khoa Dang,30,0,80,50
1656218993070,CSE 21,A01,095574,Bach; Quang Tran,23,0,48,25
1656218999098,CSE 30,A01,083084,Eldon; John,2,8,80,78
1656218999098,CSE 30,B01,095061,Bhaskar; Nishant,1,2,50,49
1656219005131,CSE 100,A01,083659,Cao; Yingjun,2,20,70,68
1656219011159,CSE 134B,A01,083661,Powell; Thomas Allan,3,0,100,97
1656219017182,CSE 140,A01,083663,Gungor; Onat,9,0,85,76
1656219023204,CSE 140L,A01,083088,Eldon; John,8,0,100,92
1656219029228,CSE 175,A01,083665,Kumar; Rakesh,0,0,25,25
1656219035250,CSE 190,A00,092507,Dubnov; Shlomo,3,0,20,17
1656219041274,ECE 45,A01,083139,Congero; Spencer William,1,0,75,74
1656219047302,ECE 65,A50,083695,Saad; Andrew S,9,0,30,21
1656219047302,ECE 65,A51,095125,Staff,23,0,26,3
1656219053326,ECE 109,A01,091882,Touri; Behrouz,0,1,70,70
1656219059354,ECE 180,A00,083140,Abi Samra; Nicholas Camill,1,0,30,29
1656219059354,ECE 180,B00,083141,Abi Samra; Nicholas Camill,0,4,30,30
1656219065379,MATH 10A,A01,083735,Patchell; Gregory David,0,0,30,30
1656219065379,MATH 10A,A02,083736,Patchell; Gregory David,22,0,30,8
1656219065379,MATH 10A,A03,083737,Patchell; Gregory David,16,0,30,14
1656219071404,MATH 10B,A01,083207,Lim; Seonhee,0,0,34,34
1656219071404,MATH 10B,A02,083208,Lim; Seonhee,7,0,35,28
1656219071404,MATH 10B,A03,093472,Staff,1,0,34,33
1656219071404,MATH 10B,B01,083739,Sinha; Shubham,11,0,30,19
1656219077433,MATH 18,A01,083743,Cinel; Cameron Alexander,7,0,30,23
1656219077433,MATH 18,A02,083744,Cinel; Cameron Alexander,10,0,30,20
1656219077433,MATH 18,A03,083745,Cinel; Cameron Alexander,5,0,30,25
1656219077433,MATH 18,B01,083748,Rideout; David Porter,1,0,36,35
1656219077433,MATH 18,B02,083749,Rideout; David Porter,0,0,36,36
1656219077433,MATH 18,B03,083750,Rideout; David Porter,0,0,36,36
1656219077433,MATH 18,B04,083751,Rideout; David Porter,0,1,36,36
1656219077433,MATH 18,B05,093473,Rideout; David Porter,0,0,36,36
1656219077433,MATH 18,B06,093474,Rideout; David Porter,3,0,36,33
1656219083459,MATH 20A,A01,083754,Zheng; Zequn,11,0,40,29
1656219089482,MATH 20B,A01,083756,Briones; Jor-el Thomas Caparas,0,0,36,36
1656219089482,MATH 20B,A02,083757,Briones; Jor-el Thomas Caparas,0,0,36,36
1656219089482,MATH 20B,A03,093475,Staff,1,0,36,35
1656219095509,MATH 20C,A01,083760,Briones; Jor-el Thomas Caparas,0,0,35,35
1656219095509,MATH 20C,A02,083761,Briones; Jor-el Thomas Caparas,9,1,35,26
1656219095509,MATH 20C,A03,093476,Staff,0,0,35,35
1656219095509,MATH 20C,B01,083762,Bach; Quang Tran,1,0,30,29
1656219101538,MATH 20D,A01,083765,Tran; Brian Kha,1,0,30,29
1656219101538,MATH 20D,A02,083766,Tran; Brian Kha,0,1,30,30
1656219101538,MATH 20D,A03,083767,Tran; Brian Kha,2,0,30,28
1656219107642,MATH 20E,A01,083771,Ganguly; Soumya,3,0,32,29
1656219107642,MATH 20E,A02,083772,Ganguly; Soumya,0,0,32,32
1656219107642,MATH 20E,B01,083773,Ciotti; Benjamin,16,0,35,19
1656219107642,MATH 20E,B02,083774,Ciotti; Benjamin,15,0,35,20
1656219113671,MATH 103A,A01,083777,Greenfeld; Be'Eri,1,0,36,35
1656219113671,MATH 103A,A02,083778,Greenfeld; Be'Eri,1,0,36,35
1656219113671,MATH 103A,A03,093561,Staff,5,0,36,31
1656219113671,MATH 103A,B01,083779,Greenfeld; Be'Eri,9,1,36,27
1656219113671,MATH 103A,B02,083780,Greenfeld; Be'Eri,1,0,36,35
1656219113671,MATH 103A,B03,093562,Staff,0,0,36,36
1656219119695,MATH 105,A01,085443,Carter; Anne Toulson,5,1,35,30
1656219119695,MATH 105,A02,093477,Staff,14,0,35,21
1656219125718,MATH 109,A01,083213,Ganzberger; Geoffrey Michael,0,0,34,34
1656219125718,MATH 109,A02,083214,Ganzberger; Geoffrey Michael,0,0,34,34
1656219125718,MATH 109,A03,093478,Staff,1,0,34,33
1656219125718,MATH 109,B01,083215,Ganzberger; Geoffrey Michael,4,0,32,28
1656219125718,MATH 109,B02,083216,Ganzberger; Geoffrey Michael,1,0,32,31
1656219125718,MATH 109,B03,093479,Staff,4,0,32,28
1656219131748,MATH 142A,A01,083219,Chow; Bennett,2,0,32,30
1656219131748,MATH 142A,A02,083220,Chow; Bennett,8,0,32,24
1656219131748,MATH 142A,A03,093480,Staff,5,0,32,27
1656219131748,MATH 142A,B03,093481,Staff,3,0,32,29
1656219131748,MATH 142A,B04,093558,Staff,6,0,32,26
1656219131748,MATH 142A,B05,093559,Staff,1,0,32,31
1656219137772,MATH 193A,A01,083224,Rotar; Vladimir,0,1,34,34
1656219137772,MATH 193A,A02,083225,Rotar; Vladimir,0,0,34,34
1656219137772,MATH 193A,A03,083781,Rotar; Vladimir,0,0,34,34
1656219137772,MATH 193A,A04,083782,Rotar; Vladimir,6,0,34,28
1656219137772,MATH 193A,A05,093482,Rotar; Vladimir,0,0,34,34
1656219143795,MATH 197,001,091859,McAuley; Julian John,9999,0,9999,0
1656219143795,MATH 197,002,095566,Kedlaya; Kiran S.,9997,0,9999,2
1656219143795,MATH 197,003,095567,Xiao; Ming,9999,0,9999,0
1656219143795,MATH 197,004,095571,Perols; Johan Lars,9998,0,9999,1
1656219150850,COGS 9,A01,083615,Shannon; Kyle Michael,3,0,75,72
1656219156874,COGS 11,A01,083617,Boyle; Mary E. T.,14,0,48,34
1656219162901,COGS 13,A01,083071,Bastos; Amalia Pinkusfeld,4,0,71,67
1656219168929,COGS 14A,A01,092681,Semenuks; Arturs,4,16,100,96
1656219174956,COGS 14B,A01,083073,Cheng; Tzu-Han,7,0,63,56
1656219180979,COGS 17,A01,092677,Semenuks; Arturs,7,0,81,74
1656219187001,COGS 100,A01,083619,Allen; Michael Gordon,2,0,70,68
1656219193024,COGS 101A,A01,083621,Davis; Joshua Daniel,4,0,68,64
1656219199051,COGS 101B,A01,091572,Allen; Michael Gordon,4,0,65,61
1656219205074,COGS 101C,A01,083625,Delgado; Tania,10,0,35,25
1656219211106,COGS 107A,A01,083627,Boyle; Mary E. T.,0,0,60,60
1656219217129,COGS 118A,A01,083075,Gupta; Anjum,7,0,76,69
1656219223158,CSE 3,A50,083646,Miranda; Gregory Joseph,18,0,50,32
1656219229187,CSE 8A,A50,083650,Miranda; Gregory Joseph,3,3,56,53
1656219235211,CSE 11,A01,083080,Cao; Yingjun,1,50,40,39
1656219241235,CSE 12,A01,083652,Krause-Levy; Sophia Louisa,7,3,120,113
1656219247258,CSE 15L,A01,083654,Morris; Justin Loren,2,0,50,48
1656219247258,CSE 15L,A02,083655,Morris; Justin Loren,4,0,50,46
1656219253282,CSE 20,A01,083657,Tran; Khoa Dang,30,0,80,50
1656219259313,CSE 21,A01,095574,Bach; Quang Tran,23,0,48,25
1656219265340,CSE 30,A01,083084,Eldon; John,2,8,80,78
1656219265340,CSE 30,B01,095061,Bhaskar; Nishant,1,2,50,49
1656219271366,CSE 100,A01,083659,Cao; Yingjun,2,20,70,68
1656219277395,CSE 134B,A01,083661,Powell; Thomas Allan,4,0,100,96
1656219283422,CSE 140,A01,083663,Gungor; Onat,9,0,85,76
1656219289444,CSE 140L,A01,083088,Eldon; John,8,0,100,92
1656219295467,CSE 175,A01,083665,Kumar; Rakesh,0,0,25,25
1656219301497,CSE 190,A00,092507,Dubnov; Shlomo,3,0,20,17
1656219307524,ECE 45,A01,083139,Congero; Spencer William,1,0,75,74
1656219313547,ECE 65,A50,083695,Saad; Andrew S,9,0,30,21
1656219313547,ECE 65,A51,095125,Staff,23,0,26,3
1656219319575,ECE 109,A01,091882,Touri; Behrouz,0,1,70,70
1656219325598,ECE 180,A00,083140,Abi Samra; Nicholas Camill,1,0,30,29
1656219325598,ECE 180,B00,083141,Abi Samra; Nicholas Camill,0,4,30,30
1656219331626,MATH 10A,A01,083735,Patchell; Gregory David,0,0,30,30
1656219331626,MATH 10A,A02,083736,Patchell; Gregory David,22,0,30,8
1656219331626,MATH 10A,A03,083737,Patchell; Gregory David,16,0,30,14
1656219337655,MATH 10B,A01,083207,Lim; Seonhee,0,0,34,34
1656219337655,MATH 10B,A02,083208,Lim; Seonhee,7,0,35,28
1656219337655,MATH 10B,A03,093472,Staff,1,0,34,33
1656219337655,MATH 10B,B01,083739,Sinha; Shubham,11,0,30,19
1656219343681,MATH 18,A01,083743,Cinel; Cameron Alexander,7,0,30,23
1656219343681,MATH 18,A02,083744,Cinel; Cameron Alexander,9,0,30,21
1656219343681,MATH 18,A03,083745,Cinel; Cameron Alexander,5,0,30,25
1656219343681,MATH 18,B01,083748,Rideout; David Porter,1,0,36,35
1656219343681,MATH 18,B02,083749,Rideout; David Porter,0,0,36,36
1656219343681,MATH 18,B03,083750,Rideout; David Porter,0,0,36,36
1656219343681,MATH 18,B04,083751,Rideout; David Porter,0,1,36,36
1656219343681,MATH 18,B05,093473,Rideout; David Porter,0,0,36,36
1656219343681,MATH 18,B06,093474,Rideout; David Porter,3,0,36,33
1656219349704,MATH 20A,A01,083754,Zheng; Zequn,11,0,40,29
1656219355734,MATH 20B,A01,083756,Briones; Jor-el Thomas Caparas,0,0,36,36
1656219355734,MATH 20B,A02,083757,Briones; Jor-el Thomas Caparas,0,0,36,36
1656219355734,MATH 20B,A03,093475,Staff,1,0,36,35
1656219361758,MATH 20C,A01,083760,Briones; Jor-el Thomas Caparas,0,0,35,35
1656219361758,MATH 20C,A02,083761,Briones; Jor-el Thomas Caparas,9,1,35,26
1656219361758,MATH 20C,A03,093476,Staff,0,0,35,35
1656219361758,MATH 20C,B01,083762,Bach; Quang Tran,1,0,30,29
1656219367786,MATH 20D,A01,083765,Tran; Brian Kha,1,0,30,29
1656219367786,MATH 20D,A02,083766,Tran; Brian Kha,0,1,30,30
1656219367786,MATH 20D,A03,083767,Tran; Brian Kha,2,0,30,28
1656219373809,MATH 20E,A01,083771,Ganguly; Soumya,3,0,32,29
1656219373809,MATH 20E,A02,083772,Ganguly; Soumya,0,0,32,32
1656219373809,MATH 20E,B01,083773,Ciotti; Benjamin,16,0,35,19
1656219373809,MATH 20E,B02,083774,Ciotti; Benjamin,15,0,35,20
1656219379838,MATH 103A,A01,083777,Greenfeld; Be'Eri,1,0,36,35
1656219379838,MATH 103A,A02,083778,Greenfeld; Be'Eri,1,0,36,35
1656219379838,MATH 103A,A03,093561,Staff,5,0,36,31
1656219379838,MATH 103A,B01,083779,Greenfeld; Be'Eri,9,1,36,27
1656219379838,MATH 103A,B02,083780,Greenfeld; Be'Eri,1,0,36,35
1656219379838,MATH 103A,B03,093562,Staff,0,0,36,36
1656219385865,MATH 105,A01,085443,Carter; Anne Toulson,5,1,35,30
1656219385865,MATH 105,A02,093477,Staff,14,0,35,21
1656219391887,MATH 109,A01,083213,Ganzberger; Geoffrey Michael,0,0,34,34
1656219391887,MATH 109,A02,083214,Ganzberger; Geoffrey Michael,0,0,34,34
1656219391887,MATH 109,A03,093478,Staff,1,0,34,33
1656219391887,MATH 109,B01,083215,Ganzberger; Geoffrey Michael,4,0,32,28
1656219391887,MATH 109,B02,083216,Ganzberger; Geoffrey Michael,1,0,32,31
1656219391887,MATH 109,B03,093479,Staff,4,0,32,28
1656219397917,MATH 142A,A01,083219,Chow; Bennett,2,0,32,30
1656219397917,MATH 142A,A02,083220,Chow; Bennett,8,0,32,24
1656219397917,MATH 142A,A03,093480,Staff,5,0,32,27
1656219397917,MATH 142A,B03,093481,Staff,3,0,32,29
1656219397917,MATH 142A,B04,093558,Staff,6,0,32,26
1656219397917,MATH 142A,B05,093559,Staff,1,0,32,31
1656219403942,MATH 193A,A01,083224,Rotar; Vladimir,0,1,34,34
1656219403942,MATH 193A,A02,083225,Rotar; Vladimir,0,0,34,34
1656219403942,MATH 193A,A03,083781,Rotar; Vladimir,0,0,34,34
1656219403942,MATH 193A,A04,083782,Rotar; Vladimir,6,0,34,28
1656219403942,MATH 193A,A05,093482,Rotar; Vladimir,0,0,34,34
1656219409964,MATH 197,001,091859,McAuley; Julian John,9999,0,9999,0
1656219409964,MATH 197,002,095566,Kedlaya; Kiran S.,9997,0,9999,2
1656219409964,MATH 197,003,095567,Xiao; Ming,9999,0,9999,0
1656219409964,MATH 197,004,095571,Perols; Johan Lars,9998,0,9999,1
1656219417022,COGS 9,A01,083615,Shannon; Kyle Michael,3,0,75,72
1656219423050,COGS 11,A01,083617,Boyle; Mary E. T.,14,0,48,34
1656219429074,COGS 13,A01,083071,Bastos; Amalia Pinkusfeld,4,0,71,67
1656219435101,COGS 14A,A01,092681,Semenuks; Arturs,4,16,100,96
1656219441125,COGS 14B,A01,083073,Cheng; Tzu-Han,7,0,63,56
1656219447148,COGS 17,A01,092677,Semenuks; Arturs,7,0,81,74
1656219453178,COGS 100,A01,083619,Allen; Michael Gordon,2,0,70,68
1656219459206,COGS 101A,A01,083621,Davis; Joshua Daniel,4,0,68,64
1656219465231,COGS 101B,A01,091572,Allen; Michael Gordon,4,0,65,61
1656219471256,COGS 101C,A01,083625,Delgado; Tania,10,0,35,25
1656219477277,COGS 107A,A01,083627,Boyle; Mary E. T.,0,0,60,60
1656219483301,COGS 118A,A01,083075,Gupta; Anjum,7,0,76,69
1656219489324,CSE 3,A50,083646,Miranda; Gregory Joseph,18,0,50,32
1656219495345,CSE 8A,A50,083650,Miranda; Gregory Joseph,3,3,56,53
1656219501368,CSE 11,A01,083080,Cao; Yingjun,1,50,40,39
1656219507392,CSE 12,A01,083652,Krause-Levy; Sophia Louisa,7,3,120,113
1656219513416,CSE 15L,A01,083654,Morris; Justin Loren,2,0,50,48
1656219513416,CSE 15L,A02,083655,Morris; Justin Loren,4,0,50,46
1656219519439,CSE 20,A01,083657,Tran; Khoa Dang,30,0,80,50
1656219525466,CSE 21,A01,095574,Bach; Quang Tran,23,0,48,25
1656219531487,CSE 30,A01,083084,Eldon; John,2,8,80,78
1656219531487,CSE 30,B01,095061,Bhaskar; Nishant,1,2,50,49
1656219537514,CSE 100,A01,083659,Cao; Yingjun,2,20,70,68
1656219543542,CSE 134B,A01,083661,Powell; Thomas Allan,4,0,100,96
1656219549564,CSE 140,A01,083663,Gungor; Onat,9,0,85,76
1656219555591,CSE 140L,A01,083088,Eldon; John,8,0,100,92
1656219561615,CSE 175,A01,083665,Kumar; Rakesh,0,0,25,25
1656219567639,CSE 190,A00,092507,Dubnov; Shlomo,3,0,20,17
1656219573663,ECE 45,A01,083139,Congero; Spencer William,1,0,75,74
1656219579686,ECE 65,A50,083695,Saad; Andrew S,9,0,30,21
1656219579686,ECE 65,A51,095125,Staff,23,0,26,3
1656219585718,ECE 109,A01,091882,Touri; Behrouz,0,1,70,70
1656219591745,ECE 180,A00,083140,Abi Samra; Nicholas Camill,1,0,30,29
1656219591745,ECE 180,B00,083141,Abi Samra; Nicholas Camill,0,4,30,30
1656219597773,MATH 10A,A01,083735,Patchell; Gregory David,0,0,30,30
1656219597773,MATH 10A,A02,083736,Patchell; Gregory David,22,0,30,8
1656219597773,MATH 10A,A03,083737,Patchell; Gregory David,16,0,30,14
1656219603801,MATH 10B,A01,083207,Lim; Seonhee,0,0,34,34
1656219603801,MATH 10B,A02,083208,Lim; Seonhee,7,0,35,28
1656219603801,MATH 10B,A03,093472,Staff,1,0,34,33
1656219603801,MATH 10B,B01,083739,Sinha; Shubham,11,0,30,19
1656219609827,MATH 18,A01,083743,Cinel; Cameron Alexander,7,0,30,23
1656219609827,MATH 18,A02,083744,Cinel; Cameron Alexander,9,0,30,21
1656219609827,MATH 18,A03,083745,Cinel; Cameron Alexander,5,0,30,25
1656219609827,MATH 18,B01,083748,Rideout; David Porter,1,0,36,35
1656219609827,MATH 18,B02,083749,Rideout; David Porter,0,0,36,36
1656219609827,MATH 18,B03,083750,Rideout; David Porter,0,0,36,36
1656219609827,MATH 18,B04,083751,Rideout; David Porter,0,1,36,36
1656219609827,MATH 18,B05,093473,Rideout; David Porter,0,0,36,36
1656219609827,MATH 18,B06,093474,Rideout; David Porter,3,0,36,33
1656219615851,MATH 20A,A01,083754,Zheng; Zequn,11,0,40,29
1656219621872,MATH 20B,A01,083756,Briones; Jor-el Thomas Caparas,0,0,36,36
1656219621872,MATH 20B,A02,083757,Briones; Jor-el Thomas Caparas,0,0,36,36
1656219621872,MATH 20B,A03,093475,Staff,1,0,36,35
1656219627901,MATH 20C,A01,083760,Briones; Jor-el Thomas Caparas,0,0,35,35
1656219627901,MATH 20C,A02,083761,Briones; Jor-el Thomas Caparas,9,1,35,26
1656219627901,MATH 20C,A03,093476,Staff,0,0,35,35
1656219627901,MATH 20C,B01,083762,Bach; Quang Tran,1,0,30,29
1656219633930,MATH 20D,A01,083765,Tran; Brian Kha,1,0,30,29
1656219633930,MATH 20D,A02,083766,Tran; Brian Kha,0,1,30,30
1656219633930,MATH 20D,A03,083767,Tran; Brian Kha,2,0,30,28
1656219639959,MATH 20E,A01,083771,Ganguly; Soumya,3,0,32,29
1656219639959,MATH 20E,A02,083772,Ganguly; Soumya,0,0,32,32
1656219639959,MATH 20E,B01,083773,Ciotti; Benjamin,16,0,35,19
1656219639959,MATH 20E,B02,083774,Ciotti; Benjamin,15,0,35,20
1656219645989,MATH 103A,A01,083777,Greenfeld; Be'Eri,1,0,36,35
1656219645989,MATH 103A,A02,083778,Greenfeld; Be'Eri,1,0,36,35
1656219645989,MATH 103A,A03,093561,Staff,5,0,36,31
1656219645989,MATH 103A,B01,083779,Greenfeld; Be'Eri,9,1,36,27
1656219645989,MATH 103A,B02,083780,Greenfeld; Be'Eri,1,0,36,35
1656219645989,MATH 103A,B03,093562,Staff,0,0,36,36
1656219652018,MATH 105,A01,085443,Carter; Anne Toulson,5,1,35,30
1656219652018,MATH 105,A02,093477,Staff,14,0,35,21
1656219658042,MATH 109,A01,083213,Ganzberger; Geoffrey Michael,0,0,34,34
1656219658042,MATH 109,A02,083214,Ganzberger; Geoffrey Michael,0,0,34,34
1656219658042,MATH 109,A03,093478,Staff,1,0,34,33
1656219658042,MATH 109,B01,083215,Ganzberger; Geoffrey Michael,4,0,32,28
1656219658042,MATH 109,B02,083216,Ganzberger; Geoffrey Michael,1,0,32,31
1656219658042,MATH 109,B03,093479,Staff,4,0,32,28
1656219664073,MATH 142A,A01,083219,Chow; Bennett,2,0,32,30
1656219664073,MATH 142A,A02,083220,Chow; Bennett,8,0,32,24
1656219664073,MATH 142A,A03,093480,Staff,5,0,32,27
1656219664073,MATH 142A,B03,093481,Staff,3,0,32,29
1656219664073,MATH 142A,B04,093558,Staff,6,0,32,26
1656219664073,MATH 142A,B05,093559,Staff,1,0,32,31
1656219670102,MATH 193A,A01,083224,Rotar; Vladimir,0,1,34,34
1656219670102,MATH 193A,A02,083225,Rotar; Vladimir,0,0,34,34
1656219670102,MATH 193A,A03,083781,Rotar; Vladimir,0,0,34,34
1656219670102,MATH 193A,A04,083782,Rotar; Vladimir,6,0,34,28
1656219670102,MATH 193A,A05,093482,Rotar; Vladimir,0,0,34,34
1656219676125,MATH 197,001,091859,McAuley; Julian John,9999,0,9999,0
1656219676125,MATH 197,002,095566,Kedlaya; Kiran S.,9997,0,9999,2
1656219676125,MATH 197,003,095567,Xiao; Ming,9999,0,9999,0
1656219676125,MATH 197,004,095571,Perols; Johan Lars,9998,0,9999,1
1656219683180,COGS 9,A01,083615,Shannon; Kyle Michael,3,0,75,72
1656219689204,COGS 11,A01,083617,Boyle; Mary E. T.,14,0,48,34
1656219695227,COGS 13,A01,083071,Bastos; Amalia Pinkusfeld,4,0,71,67
1656219701337,COGS 14A,A01,092681,Semenuks; Arturs,4,16,100,96
1656219707369,COGS 14B,A01,083073,Cheng; Tzu-Han,7,0,63,56
1656219713392,COGS 17,A01,092677,Semenuks; Arturs,7,0,81,74
1656219719414,COGS 100,A01,083619,Allen; Michael Gordon,2,0,70,68
1656219725443,COGS 101A,A01,083621,Davis; Joshua Daniel,4,0,68,64
1656219731471,COGS 101B,A01,091572,Allen; Michael Gordon,4,0,65,61
1656219737500,COGS 101C,A01,083625,Delgado; Tania,10,0,35,25
1656219743527,COGS 107A,A01,083627,Boyle; Mary E. T.,0,0,60,60
1656219749555,COGS 118A,A01,083075,Gupta; Anjum,8,0,76,68
1656219755583,CSE 3,A50,083646,Miranda; Gregory Joseph,18,0,50,32
1656219761606,CSE 8A,A50,083650,Miranda; Gregory Joseph,3,3,56,53
1656219767633,CSE 11,A01,083080,Cao; Yingjun,1,50,40,39
1656219773657,CSE 12,A01,083652,Krause-Levy; Sophia Louisa,7,3,120,113
1656219779678,CSE 15L,A01,083654,Morris; Justin Loren,2,0,50,48
1656219779678,CSE 15L,A02,083655,Morris; Justin Loren,4,0,50,46
1656219785702,CSE 20,A01,083657,Tran; Khoa Dang,30,0,80,50
1656219791726,CSE 21,A01,095574,Bach; Quang Tran,23,0,48,25
1656219797750,CSE 30,A01,083084,Eldon; John,2,8,80,78
1656219797750,CSE 30,B01,095061,Bhaskar; Nishant,1,2,50,49
1656219803774,CSE 100,A01,083659,Cao; Yingjun,2,20,70,68
1656219809798,CSE 134B,A01,083661,Powell; Thomas Allan,5,0,100,95
1656219815822,CSE 140,A01,083663,Gungor; Onat,9,0,85,76
1656219821846,CSE 140L,A01,083088,Eldon; John,8,0,100,92
1656219827870,CSE 175,A01,083665,Kumar; Rakesh,0,0,25,25
1656219833897,CSE 190,A00,092507,Dubnov; Shlomo,3,0,20,17
1656219839924,ECE 45,A01,083139,Congero; Spencer William,1,0,75,74
1656219845951,ECE 65,A50,083695,Saad; Andrew S,9,0,30,21
1656219845951,ECE 65,A51,095125,Staff,23,0,26,3
1656219851979,ECE 109,A01,091882,Touri; Behrouz,0,1,70,70
1656219858003,ECE 180,A00,083140,Abi Samra; Nicholas Camill,1,0,30,29
1656219858003,ECE 180,B00,083141,Abi Samra; Nicholas Camill,0,4,30,30
1656219864031,MATH 10A,A01,083735,Patchell; Gregory David,0,0,30,30
1656219864031,MATH 10A,A02,083736,Patchell; Gregory David,22,0,30,8
1656219864031,MATH 10A,A03,083737,Patchell; Gregory David,16,0,30,14
1656219870063,MATH 10B,A01,083207,Lim; Seonhee,0,0,34,34
1656219870063,MATH 10B,A02,083208,Lim; Seonhee,7,0,35,28
1656219870063,MATH 10B,A03,093472,Staff,1,0,34,33
1656219870063,MATH 10B,B01,083739,Sinha; Shubham,11,0,30,19
1656219876088,MATH 18,A01,083743,Cinel; Cameron Alexander,7,0,30,23
1656219876088,MATH 18,A02,083744,Cinel; Cameron Alexander,9,0,30,21
1656219876088,MATH 18,A03,083745,Cinel; Cameron Alexander,5,0,30,25
1656219876088,MATH 18,B01,083748,Rideout; David Porter,1,0,36,35
1656219876088,MATH 18,B02,083749,Rideout; David Porter,0,0,36,36
1656219876088,MATH 18,B03,083750,Rideout; David Porter,0,0,36,36
1656219876088,MATH 18,B04,083751,Rideout; David Porter,0,1,36,36
1656219876088,MATH 18,B05,093473,Rideout; David Porter,0,0,36,36
1656219876088,MATH 18,B06,093474,Rideout; David Porter,3,0,36,33
1656219882112,MATH 20A,A01,083754,Zheng; Zequn,11,0,40,29
1656219888148,MATH 20B,A01,083756,Briones; Jor-el Thomas Caparas,0,0,36,36
1656219888148,MATH 20B,A02,083757,Briones; Jor-el Thomas Caparas,0,0,36,36
1656219888148,MATH 20B,A03,093475,Staff,1,0,36,35
1656219894177,MATH 20C,A01,083760,Briones; Jor-el Thomas Caparas,0,0,35,35
1656219894177,MATH 20C,A02,083761,Briones; Jor-el Thomas Caparas,9,1,35,26
1656219894177,MATH 20C,A03,093476,Staff,0,0,35,35
1656219894177,MATH 20C,B01,083762,Bach; Quang Tran,1,0,30,29
1656219900216,MATH 20D,A01,083765,Tran; Brian Kha,1,0,30,29
1656219900216,MATH 20D,A02,083766,Tran; Brian Kha,0,1,30,30
1656219900216,MATH 20D,A03,083767,Tran; Brian Kha,2,0,30,28
1656219906244,MATH 20E,A01,083771,Ganguly; Soumya,3,0,32,29
1656219906244,MATH 20E,A02,083772,Ganguly; Soumya,0,0,32,32
1656219906244,MATH 20E,B01,083773,Ciotti; Benjamin,16,0,35,19
1656219906244,MATH 20E,B02,083774,Ciotti; Benjamin,15,0,35,20
1656219912268,MATH 103A,A01,083777,Greenfeld; Be'Eri,1,0,36,35
1656219912268,MATH 103A,A02,083778,Greenfeld; Be'Eri,1,0,36,35
1656219912268,MATH 103A,A03,093561,Staff,5,0,36,31
1656219912268,MATH 103A,B01,083779,Greenfeld; Be'Eri,9,1,36,27
1656219912268,MATH 103A,B02,083780,Greenfeld; Be'Eri,1,0,36,35
1656219912268,MATH 103A,B03,093562,Staff,0,0,36,36
1656219918292,MATH 105,A01,085443,Carter; Anne Toulson,5,1,35,30
1656219918292,MATH 105,A02,093477,Staff,14,0,35,21
1656219924323,MATH 109,A01,083213,Ganzberger; Geoffrey Michael,0,0,34,34
1656219924323,MATH 109,A02,083214,Ganzberger; Geoffrey Michael,0,0,34,34
1656219924323,MATH 109,A03,093478,Staff,1,0,34,33
1656219924323,MATH 109,B01,083215,Ganzberger; Geoffrey Michael,4,0,32,28
1656219924323,MATH 109,B02,083216,Ganzberger; Geoffrey Michael,1,0,32,31
1656219924323,MATH 109,B03,093479,Staff,4,0,32,28
1656219930360,MATH 142A,A01,083219,Chow; Bennett,2,0,32,30
1656219930360,MATH 142A,A02,083220,Chow; Bennett,8,0,32,24
1656219930360,MATH 142A,A03,093480,Staff,5,0,32,27
1656219930360,MATH 142A,B03,093481,Staff,3,0,32,29
1656219930360,MATH 142A,B04,093558,Staff,6,0,32,26
1656219930360,MATH 142A,B05,093559,Staff,1,0,32,31
1656219936407,MATH 193A,A01,083224,Rotar; Vladimir,0,1,34,34
1656219936407,MATH 193A,A02,083225,Rotar; Vladimir,0,0,34,34
1656219936407,MATH 193A,A03,083781,Rotar; Vladimir,0,0,34,34
1656219936407,MATH 193A,A04,083782,Rotar; Vladimir,6,0,34,28
1656219936407,MATH 193A,A05,093482,Rotar; Vladimir,0,0,34,34
1656219942431,MATH 197,001,091859,McAuley; Julian John,9999,0,9999,0
1656219942431,MATH 197,002,095566,Kedlaya; Kiran S.,9997,0,9999,2
1656219942431,MATH 197,003,095567,Xiao; Ming,9999,0,9999,0
1656219942431,MATH 197,004,095571,Perols; Johan Lars,9998,0,9999,1
1656219949481,COGS 9,A01,083615,Shannon; Kyle Michael,3,0,75,72
1656219955508,COGS 11,A01,083617,Boyle; Mary E. T.,14,0,48,34
1656219961529,COGS 13,A01,083071,Bastos; Amalia Pinkusfeld,4,0,71,67
1656219967552,COGS 14A,A01,092681,Semenuks; Arturs,4,16,100,96
1656219973585,COGS 14B,A01,083073,Cheng; Tzu-Han,7,0,63,56
1656219979607,COGS 17,A01,092677,Semenuks; Arturs,7,0,81,74
1656219985630,COGS 100,A01,083619,Allen; Michael Gordon,2,0,70,68
1656219991669,COGS 101A,A01,083621,Davis; Joshua Daniel,4,0,68,64
1656219997694,COGS 101B,A01,091572,Allen; Michael Gordon,4,0,65,61
1656220003720,COGS 101C,A01,083625,Delgado; Tania,10,0,35,25
1656220009745,COGS 107A,A01,083627,Boyle; Mary E. T.,0,0,60,60
1656220015770,COGS 118A,A01,083075,Gupta; Anjum,8,0,76,68
1656220021793,CSE 3,A50,083646,Miranda; Gregory Joseph,18,0,50,32
1656220027823,CSE 8A,A50,083650,Miranda; Gregory Joseph,3,3,56,53
1656220033851,CSE 11,A01,083080,Cao; Yingjun,1,50,40,39
1656220039880,CSE 12,A01,083652,Krause-Levy; Sophia Louisa,7,3,120,113
1656220045905,CSE 15L,A01,083654,Morris; Justin Loren,2,0,50,48
1656220045905,CSE 15L,A02,083655,Morris; Justin Loren,4,0,50,46
1656220051927,CSE 20,A01,083657,Tran; Khoa Dang,30,0,80,50
1656220057953,CSE 21,A01,095574,Bach; Quang Tran,23,0,48,25
1656220063977,CSE 30,A01,083084,Eldon; John,2,8,80,78
1656220063977,CSE 30,B01,095061,Bhaskar; Nishant,1,2,50,49
1656220070001,CSE 100,A01,083659,Cao; Yingjun,2,20,70,68
1656220076029,CSE 134B,A01,083661,Powell; Thomas Allan,5,0,100,95
1656220082051,CSE 140,A01,083663,Gungor; Onat,9,0,85,76
1656220088075,CSE 140L,A01,083088,Eldon; John,8,0,100,92
1656220094097,CSE 175,A01,083665,Kumar; Rakesh,0,0,25,25
1656220100119,CSE 190,A00,092507,Dubnov; Shlomo,3,0,20,17
1656220106143,ECE 45,A01,083139,Congero; Spencer William,1,0,75,74
1656220112169,ECE 65,A50,083695,Saad; Andrew S,9,0,30,21
1656220112169,ECE 65,A51,095125,Staff,23,0,26,3
1656220118199,ECE 109,A01,091882,Touri; Behrouz,0,1,70,70
1656220124222,ECE 180,A00,083140,Abi Samra; Nicholas Camill,1,0,30,29
1656220124222,ECE 180,B00,083141,Abi Samra; Nicholas Camill,0,4,30,30
1656220130244,MATH 10A,A01,083735,Patchell; Gregory David,0,0,30,30
1656220130244,MATH 10A,A02,083736,Patchell; Gregory David,22,0,30,8
1656220130244,MATH 10A,A03,083737,Patchell; Gregory David,16,0,30,14
1656220136269,MATH 10B,A01,083207,Lim; Seonhee,0,0,34,34
1656220136269,MATH 10B,A02,083208,Lim; Seonhee,7,0,35,28
1656220136269,MATH 10B,A03,093472,Staff,1,0,34,33
1656220136269,MATH 10B,B01,083739,Sinha; Shubham,11,0,30,19
1656220142292,MATH 18,A01,083743,Cinel; Cameron Alexander,7,0,30,23
1656220142292,MATH 18,A02,083744,Cinel; Cameron Alexander,9,0,30,21
1656220142292,MATH 18,A03,083745,Cinel; Cameron Alexander,5,0,30,25
1656220142292,MATH 18,B01,083748,Rideout; David Porter,1,0,36,35
1656220142292,MATH 18,B02,083749,Rideout; David Porter,0,0,36,36
1656220142292,MATH 18,B03,083750,Rideout; David Porter,0,0,36,36
1656220142292,MATH 18,B04,083751,Rideout; David Porter,0,1,36,36
1656220142292,MATH 18,B05,093473,Rideout; David Porter,0,0,36,36
1656220142292,MATH 18,B06,093474,Rideout; David Porter,3,0,36,33
1656220148318,MATH 20A,A01,083754,Zheng; Zequn,11,0,40,29
1656220154345,MATH 20B,A01,083756,Briones; Jor-el Thomas Caparas,0,0,36,36
1656220154345,MATH 20B,A02,083757,Briones; Jor-el Thomas Caparas,0,0,36,36
1656220154345,MATH 20B,A03,093475,Staff,1,0,36,35
1656220160368,MATH 20C,A01,083760,Briones; Jor-el Thomas Caparas,0,0,35,35
1656220160368,MATH 20C,A02,083761,Briones; Jor-el Thomas Caparas,9,1,35,26
1656220160368,MATH 20C,A03,093476,Staff,0,0,35,35
1656220160368,MATH 20C,B01,083762,Bach; Quang Tran,1,0,30,29
1656220166395,MATH 20D,A01,083765,Tran; Brian Kha,1,0,30,29
1656220166395,MATH 20D,A02,083766,Tran; Brian Kha,0,1,30,30
1656220166395,MATH 20D,A03,083767,Tran; Brian Kha,2,0,30,28
1656220172419,MATH 20E,A01,083771,Ganguly; Soumya,3,0,32,29
1656220172419,MATH 20E,A02,083772,Ganguly; Soumya,0,0,32,32
1656220172419,MATH 20E,B01,083773,Ciotti; Benjamin,16,0,35,19
1656220172419,MATH 20E,B02,083774,Ciotti; Benjamin,15,0,35,20
1656220178444,MATH 103A,A01,083777,Greenfeld; Be'Eri,1,0,36,35
1656220178444,MATH 103A,A02,083778,Greenfeld; Be'Eri,1,0,36,35
1656220178444,MATH 103A,A03,093561,Staff,5,0,36,31
1656220178444,MATH 103A,B01,083779,Greenfeld; Be'Eri,9,1,36,27
1656220178444,MATH 103A,B02,083780,Greenfeld; Be'Eri,1,0,36,35
1656220178444,MATH 103A,B03,093562,Staff,0,0,36,36
1656220184470,MATH 105,A01,085443,Carter; Anne Toulson,5,1,35,30
1656220184470,MATH 105,A02,093477,Staff,14,0,35,21
1656220190497,MATH 109,A01,083213,Ganzberger; Geoffrey Michael,0,0,34,34
1656220190497,MATH 109,A02,083214,Ganzberger; Geoffrey Michael,0,0,34,34
1656220190497,MATH 109,A03,093478,Staff,1,0,34,33
1656220190497,MATH 109,B01,083215,Ganzberger; Geoffrey Michael,4,0,32,28
1656220190497,MATH 109,B02,083216,Ganzberger; Geoffrey Michael,1,0,32,31
1656220190497,MATH 109,B03,093479,Staff,4,0,32,28
1656220196520,MATH 142A,A01,083219,Chow; Bennett,2,0,32,30
1656220196520,MATH 142A,A02,083220,Chow; Bennett,8,0,32,24
1656220196520,MATH 142A,A03,093480,Staff,5,0,32,27
1656220196520,MATH 142A,B03,093481,Staff,3,0,32,29
1656220196520,MATH 142A,B04,093558,Staff,6,0,32,26
1656220196520,MATH 142A,B05,093559,Staff,1,0,32,31
1656220202545,MATH 193A,A01,083224,Rotar; Vladimir,0,1,34,34
1656220202545,MATH 193A,A02,083225,Rotar; Vladimir,0,0,34,34
1656220202545,MATH 193A,A03,083781,Rotar; Vladimir,0,0,34,34
1656220202545,MATH 193A,A04,083782,Rotar; Vladimir,6,0,34,28
1656220202545,MATH 193A,A05,093482,Rotar; Vladimir,0,0,34,34
1656220208573,MATH 197,001,091859,McAuley; Julian John,9999,0,9999,0
1656220208573,MATH 197,002,095566,Kedlaya; Kiran S.,9997,0,9999,2
1656220208573,MATH 197,003,095567,Xiao; Ming,9999,0,9999,0
1656220208573,MATH 197,004,095571,Perols; Johan Lars,9998,0,9999,1
1656220215640,COGS 9,A01,083615,Shannon; Kyle Michael,3,0,75,72
1656220221663,COGS 11,A01,083617,Boyle; Mary E. T.,14,0,48,34
1656220227689,COGS 13,A01,083071,Bastos; Amalia Pinkusfeld,4,0,71,67
1656220233711,COGS 14A,A01,092681,Semenuks; Arturs,4,16,100,96
1656220239740,COGS 14B,A01,083073,Cheng; Tzu-Han,7,0,63,56
1656220245772,COGS 17,A01,092677,Semenuks; Arturs,7,0,81,74
1656220251797,COGS 100,A01,083619,Allen; Michael Gordon,2,0,70,68
1656220257823,COGS 101A,A01,083621,Davis; Joshua Daniel,4,0,68,64
1656220263847,COGS 101B,A01,091572,Allen; Michael Gordon,4,0,65,61
1656220269875,COGS 101C,A01,083625,Delgado; Tania,10,0,35,25
1656220275902,COGS 107A,A01,083627,Boyle; Mary E. T.,0,0,60,60
1656220281924,COGS 118A,A01,083075,Gupta; Anjum,8,0,76,68
1656220287948,CSE 3,A50,083646,Miranda; Gregory Joseph,18,0,50,32
1656220293975,CSE 8A,A50,083650,Miranda; Gregory Joseph,3,3,56,53
1656220300074,CSE 11,A01,083080,Cao; Yingjun,1,50,40,39
1656220306100,CSE 12,A01,083652,Krause-Levy; Sophia Louisa,7,3,120,113
1656220312126,CSE 15L,A01,083654,Morris; Justin Loren,2,0,50,48
1656220312126,CSE 15L,A02,083655,Morris; Justin Loren,4,0,50,46
1656220318150,CSE 20,A01,083657,Tran; Khoa Dang,30,0,80,50
1656220324173,CSE 21,A01,095574,Bach; Quang Tran,23,0,48,25
1656220330197,CSE 30,A01,083084,Eldon; John,2,8,80,78
1656220330197,CSE 30,B01,095061,Bhaskar; Nishant,1,2,50,49
1656220336220,CSE 100,A01,083659,Cao; Yingjun,2,20,70,68
1656220342254,CSE 134B,A01,083661,Powell; Thomas Allan,5,0,100,95
1656220348280,CSE 140,A01,083663,Gungor; Onat,9,0,85,76
1656220354303,CSE 140L,A01,083088,Eldon; John,8,0,100,92
1656220360329,CSE 175,A01,083665,Kumar; Rakesh,0,0,25,25
1656220366356,CSE 190,A00,092507,Dubnov; Shlomo,3,0,20,17
1656220372384,ECE 45,A01,083139,Congero; Spencer William,1,0,75,74
1656220378407,ECE 65,A50,083695,Saad; Andrew S,9,0,30,21
1656220378407,ECE 65,A51,095125,Staff,23,0,26,3
1656220384434,ECE 109,A01,091882,Touri; Behrouz,0,1,70,70
1656220390457,ECE 180,A00,083140,Abi Samra; Nicholas Camill,1,0,30,29
1656220390457,ECE 180,B00,083141,Abi Samra; Nicholas Camill,0,4,30,30
1656220396484,MATH 10A,A01,083735,Patchell; Gregory David,0,0,30,30
1656220396484,MATH 10A,A02,083736,Patchell; Gregory David,22,0,30,8
1656220396484,MATH 10A,A03,083737,Patchell; Gregory David,16,0,30,14
1656220402507,MATH 10B,A01,083207,Lim; Seonhee,0,0,34,34
1656220402507,MATH 10B,A02,083208,Lim; Seonhee,7,0,35,28
1656220402507,MATH 10B,A03,093472,Staff,1,0,34,33
1656220402507,MATH 10B,B01,083739,Sinha; Shubham,11,0,30,19
1656220408545,MATH 18,A01,083743,Cinel; Cameron Alexander,7,0,30,23
1656220408545,MATH 18,A02,083744,Cinel; Cameron Alexander,9,0,30,21
1656220408545,MATH 18,A03,083745,Cinel; Cameron Alexander,5,0,30,25
1656220408545,MATH 18,B01,083748,Rideout; David Porter,1,0,36,35
1656220408545,MATH 18,B02,083749,Rideout; David Porter,0,0,36,36
1656220408545,MATH 18,B03,083750,Rideout; David Porter,0,0,36,36
1656220408545,MATH 18,B04,083751,Rideout; David Porter,0,1,36,36
1656220408545,MATH 18,B05,093473,Rideout; David Porter,0,0,36,36
1656220408545,MATH 18,B06,093474,Rideout; David Porter,3,0,36,33
1656220414572,MATH 20A,A01,083754,Zheng; Zequn,11,0,40,29
1656220420595,MATH 20B,A01,083756,Briones; Jor-el Thomas Caparas,0,0,36,36
1656220420595,MATH 20B,A02,083757,Briones; Jor-el Thomas Caparas,0,0,36,36
1656220420595,MATH 20B,A03,093475,Staff,1,0,36,35
1656220426619,MATH 20C,A01,083760,Briones; Jor-el Thomas Caparas,0,0,35,35
1656220426619,MATH 20C,A02,083761,Briones; Jor-el Thomas Caparas,9,1,35,26
1656220426619,MATH 20C,A03,093476,Staff,0,0,35,35
1656220426619,MATH 20C,B01,083762,Bach; Quang Tran,1,0,30,29
1656220432650,MATH 20D,A01,083765,Tran; Brian Kha,1,0,30,29
1656220432650,MATH 20D,A02,083766,Tran; Brian Kha,0,1,30,30
1656220432650,MATH 20D,A03,083767,Tran; Brian Kha,2,0,30,28
1656220438673,MATH 20E,A01,083771,Ganguly; Soumya,3,0,32,29
1656220438673,MATH 20E,A02,083772,Ganguly; Soumya,0,0,32,32
1656220438673,MATH 20E,B01,083773,Ciotti; Benjamin,16,0,35,19
1656220438673,MATH 20E,B02,083774,Ciotti; Benjamin,15,0,35,20
1656220444704,MATH 103A,A01,083777,Greenfeld; Be'Eri,1,0,36,35
1656220444704,MATH 103A,A02,083778,Greenfeld; Be'Eri,1,0,36,35
1656220444704,MATH 103A,A03,093561,Staff,5,0,36,31
1656220444704,MATH 103A,B01,083779,Greenfeld; Be'Eri,9,1,36,27
1656220444704,MATH 103A,B02,083780,Greenfeld; Be'Eri,1,0,36,35
1656220444704,MATH 103A,B03,093562,Staff,0,0,36,36
1656220450728,MATH 105,A01,085443,Carter; Anne Toulson,5,1,35,30
1656220450728,MATH 105,A02,093477,Staff,14,0,35,21
1656220456754,MATH 109,A01,083213,Ganzberger; Geoffrey Michael,0,0,34,34
1656220456754,MATH 109,A02,083214,Ganzberger; Geoffrey Michael,0,0,34,34
1656220456754,MATH 109,A03,093478,Staff,1,0,34,33
1656220456754,MATH 109,B01,083215,Ganzberger; Geoffrey Michael,4,0,32,28
1656220456754,MATH 109,B02,083216,Ganzberger; Geoffrey Michael,1,0,32,31
1656220456754,MATH 109,B03,093479,Staff,4,0,32,28
1656220462784,MATH 142A,A01,083219,Chow; Bennett,2,0,32,30
1656220462784,MATH 142A,A02,083220,Chow; Bennett,8,0,32,24
1656220462784,MATH 142A,A03,093480,Staff,5,0,32,27
1656220462784,MATH 142A,B03,093481,Staff,3,0,32,29
1656220462784,MATH 142A,B04,093558,Staff,6,0,32,26
1656220462784,MATH 142A,B05,093559,Staff,1,0,32,31
1656220468807,MATH 193A,A01,083224,Rotar; Vladimir,0,1,34,34
1656220468807,MATH 193A,A02,083225,Rotar; Vladimir,0,0,34,34
1656220468807,MATH 193A,A03,083781,Rotar; Vladimir,0,0,34,34
1656220468807,MATH 193A,A04,083782,Rotar; Vladimir,6,0,34,28
1656220468807,MATH 193A,A05,093482,Rotar; Vladimir,0,0,34,34
1656220474830,MATH 197,001,091859,McAuley; Julian John,9999,0,9999,0
1656220474830,MATH 197,002,095566,Kedlaya; Kiran S.,9997,0,9999,2
1656220474830,MATH 197,003,095567,Xiao; Ming,9999,0,9999,0
1656220474830,MATH 197,004,095571,Perols; Johan Lars,9998,0,9999,1
1656220481893,COGS 9,A01,083615,Shannon; Kyle Michael,3,0,75,72
1656220487916,COGS 11,A01,083617,Boyle; Mary E. T.,14,0,48,34
1656220493940,COGS 13,A01,083071,Bastos; Amalia Pinkusfeld,4,0,71,67
1656220499971,COGS 14A,A01,092681,Semenuks; Arturs,4,16,100,96
1656220505996,COGS 14B,A01,083073,Cheng; Tzu-Han,7,0,63,56
1656220512021,COGS 17,A01,092677,Semenuks; Arturs,7,0,81,74
1656220518043,COGS 100,A01,083619,Allen; Michael Gordon,2,0,70,68
1656220524070,COGS 101A,A01,083621,Davis; Joshua Daniel,4,0,68,64
1656220530095,COGS 101B,A01,091572,Allen; Michael Gordon,4,0,65,61
1656220536123,COGS 101C,A01,083625,Delgado; Tania,10,0,35,25
1656220542150,COGS 107A,A01,083627,Boyle; Mary E. T.,0,0,60,60
1656220548178,COGS 118A,A01,083075,Gupta; Anjum,8,0,76,68
1656220554208,CSE 3,A50,083646,Miranda; Gregory Joseph,18,0,50,32
1656220560237,CSE 8A,A50,083650,Miranda; Gregory Joseph,3,3,56,53
1656220566260,CSE 11,A01,083080,Cao; Yingjun,1,50,40,39
1656220572287,CSE 12,A01,083652,Krause-Levy; Sophia Louisa,7,3,120,113
1656220578309,CSE 15L,A01,083654,Morris; Justin Loren,2,0,50,48
1656220578309,CSE 15L,A02,083655,Morris; Justin Loren,4,0,50,46
1656220584331,CSE 20,A01,083657,Tran; Khoa Dang,30,0,80,50
1656220590363,CSE 21,A01,095574,Bach; Quang Tran,23,0,48,25
1656220596402,CSE 30,A01,083084,Eldon; John,2,8,80,78
1656220596402,CSE 30,B01,095061,Bhaskar; Nishant,1,2,50,49
1656220602426,CSE 100,A01,083659,Cao; Yingjun,2,20,70,68
1656220608450,CSE 134B,A01,083661,Powell; Thomas Allan,5,0,100,95
1656220614474,CSE 140,A01,083663,Gungor; Onat,9,0,85,76
1656220620497,CSE 140L,A01,083088,Eldon; John,8,0,100,92
1656220626521,CSE 175,A01,083665,Kumar; Rakesh,0,0,25,25
1656220632549,CSE 190,A00,092507,Dubnov; Shlomo,3,0,20,17
1656220638571,ECE 45,A01,083139,Congero; Spencer William,1,0,75,74
1656220644595,ECE 65,A50,083695,Saad; Andrew S,9,0,30,21
1656220644595,ECE 65,A51,095125,Staff,23,0,26,3
1656220650618,ECE 109,A01,091882,Touri; Behrouz,0,1,70,70
1656220656641,ECE 180,A00,083140,Abi Samra; Nicholas Camill,1,0,30,29
1656220656641,ECE 180,B00,083141,Abi Samra; Nicholas Camill,0,4,30,30
1656220662676,MATH 10A,A01,083735,Patchell; Gregory David,0,0,30,30
1656220662676,MATH 10A,A02,083736,Patchell; Gregory David,22,0,30,8
1656220662676,MATH 10A,A03,083737,Patchell; Gregory David,16,0,30,14
1656220668703,MATH 10B,A01,083207,Lim; Seonhee,0,0,34,34
1656220668703,MATH 10B,A02,083208,Lim; Seonhee,7,0,35,28
1656220668703,MATH 10B,A03,093472,Staff,1,0,34,33
1656220668703,MATH 10B,B01,083739,Sinha; Shubham,11,0,30,19
1656220674728,MATH 18,A01,083743,Cinel; Cameron Alexander,7,0,30,23
1656220674728,MATH 18,A02,083744,Cinel; Cameron Alexander,9,0,30,21
1656220674728,MATH 18,A03,083745,Cinel; Cameron Alexander,5,0,30,25
1656220674728,MATH 18,B01,083748,Rideout; David Porter,1,0,36,35
1656220674728,MATH 18,B02,083749,Rideout; David Porter,0,0,36,36
1656220674728,MATH 18,B03,083750,Rideout; David Porter,0,0,36,36
1656220674728,MATH 18,B04,083751,Rideout; David Porter,0,1,36,36
1656220674728,MATH 18,B05,093473,Rideout; David Porter,0,0,36,36
1656220674728,MATH 18,B06,093474,Rideout; David Porter,3,0,36,33
1656220680752,MATH 20A,A01,083754,Zheng; Zequn,11,0,40,29
1656220686789,MATH 20B,A01,083756,Briones; Jor-el Thomas Caparas,0,0,36,36
1656220686789,MATH 20B,A02,083757,Briones; Jor-el Thomas Caparas,0,0,36,36
1656220686789,MATH 20B,A03,093475,Staff,1,0,36,35
1656220692812,MATH 20C,A01,083760,Briones; Jor-el Thomas Caparas,0,0,35,35
1656220692812,MATH 20C,A02,083761,Briones; Jor-el Thomas Caparas,9,1,35,26
1656220692812,MATH 20C,A03,093476,Staff,0,0,35,35
1656220692812,MATH 20C,B01,083762,Bach; Quang Tran,1,0,30,29
1656220698836,MATH 20D,A01,083765,Tran; Brian Kha,1,0,30,29
1656220698836,MATH 20D,A02,083766,Tran; Brian Kha,0,1,30,30
1656220698836,MATH 20D,A03,083767,Tran; Brian Kha,2,0,30,28
1656220704863,MATH 20E,A01,083771,Ganguly; Soumya,3,0,32,29
1656220704863,MATH 20E,A02,083772,Ganguly; Soumya,0,0,32,32
1656220704863,MATH 20E,B01,083773,Ciotti; Benjamin,16,0,35,19
1656220704863,MATH 20E,B02,083774,Ciotti; Benjamin,15,0,35,20
1656220710892,MATH 103A,A01,083777,Greenfeld; Be'Eri,1,0,36,35
1656220710892,MATH 103A,A02,083778,Greenfeld; Be'Eri,1,0,36,35
1656220710892,MATH 103A,A03,093561,Staff,5,0,36,31
1656220710892,MATH 103A,B01,083779,Greenfeld; Be'Eri,9,1,36,27
1656220710892,MATH 103A,B02,083780,Greenfeld; Be'Eri,1,0,36,35
1656220710892,MATH 103A,B03,093562,Staff,0,0,36,36
1656220716921,MATH 105,A01,085443,Carter; Anne Toulson,5,1,35,30
1656220716921,MATH 105,A02,093477,Staff,14,0,35,21
1656220722944,MATH 109,A01,083213,Ganzberger; Geoffrey Michael,0,0,34,34
1656220722944,MATH 109,A02,083214,Ganzberger; Geoffrey Michael,0,0,34,34
1656220722944,MATH 109,A03,093478,Staff,1,0,34,33
1656220722944,MATH 109,B01,083215,Ganzberger; Geoffrey Michael,4,0,32,28
1656220722944,MATH 109,B02,083216,Ganzberger; Geoffrey Michael,1,0,32,31
1656220722944,MATH 109,B03,093479,Staff,4,0,32,28
1656220728968,MATH 142A,A01,083219,Chow; Bennett,2,0,32,30
1656220728968,MATH 142A,A02,083220,Chow; Bennett,8,0,32,24
1656220728968,MATH 142A,A03,093480,Staff,5,0,32,27
1656220728968,MATH 142A,B03,093481,Staff,3,0,32,29
1656220728968,MATH 142A,B04,093558,Staff,6,0,32,26
1656220728968,MATH 142A,B05,093559,Staff,1,0,32,31
1656220734996,MATH 193A,A01,083224,Rotar; Vladimir,0,1,34,34
1656220734996,MATH 193A,A02,083225,Rotar; Vladimir,0,0,34,34
1656220734996,MATH 193A,A03,083781,Rotar; Vladimir,0,0,34,34
1656220734996,MATH 193A,A04,083782,Rotar; Vladimir,6,0,34,28
1656220734996,MATH 193A,A05,093482,Rotar; Vladimir,0,0,34,34
1656220741019,MATH 197,001,091859,McAuley; Julian John,9999,0,9999,0
1656220741019,MATH 197,002,095566,Kedlaya; Kiran S.,9997,0,9999,2
1656220741019,MATH 197,003,095567,Xiao; Ming,9999,0,9999,0
1656220741019,MATH 197,004,095571,Perols; Johan Lars,9998,0,9999,1
1656220748070,COGS 9,A01,083615,Shannon; Kyle Michael,3,0,75,72
1656220754097,COGS 11,A01,083617,Boyle; Mary E. T.,14,0,48,34
1656220760120,COGS 13,A01,083071,Bastos; Amalia Pinkusfeld,4,0,71,67
1656220766151,COGS 14A,A01,092681,Semenuks; Arturs,4,16,100,96
1656220772184,COGS 14B,A01,083073,Cheng; Tzu-Han,7,0,63,56
1656220778212,COGS 17,A01,092677,Semenuks; Arturs,7,0,81,74
1656220784234,COGS 100,A01,083619,Allen; Michael Gordon,2,0,70,68
1656220790259,COGS 101A,A01,083621,Davis; Joshua Daniel,4,0,68,64
1656220796287,COGS 101B,A01,091572,Allen; Michael Gordon,4,0,65,61
1656220802312,COGS 101C,A01,083625,Delgado; Tania,10,0,35,25
1656220808336,COGS 107A,A01,083627,Boyle; Mary E. T.,0,0,60,60
1656220814372,COGS 118A,A01,083075,Gupta; Anjum,8,0,76,68
1656220820395,CSE 3,A50,083646,Miranda; Gregory Joseph,18,0,50,32
1656220826419,CSE 8A,A50,083650,Miranda; Gregory Joseph,3,3,56,53
1656220832442,CSE 11,A01,083080,Cao; Yingjun,1,50,40,39
1656220838470,CSE 12,A01,083652,Krause-Levy; Sophia Louisa,7,3,120,113
1656220844498,CSE 15L,A01,083654,Morris; Justin Loren,2,0,50,48
1656220844498,CSE 15L,A02,083655,Morris; Justin Loren,4,0,50,46
1656220850524,CSE 20,A01,083657,Tran; Khoa Dang,30,0,80,50
1656220856551,CSE 21,A01,095574,Bach; Quang Tran,23,0,48,25
1656220862575,CSE 30,A01,083084,Eldon; John,2,8,80,78
1656220862575,CSE 30,B01,095061,Bhaskar; Nishant,1,2,50,49
1656220868601,CSE 100,A01,083659,Cao; Yingjun,2,20,70,68
1656220874629,CSE 134B,A01,083661,Powell; Thomas Allan,5,0,100,95
1656220880655,CSE 140,A01,083663,Gungor; Onat,9,0,85,76
1656220886678,CSE 140L,A01,083088,Eldon; John,8,0,100,92
1656220892705,CSE 175,A01,083665,Kumar; Rakesh,0,0,25,25
1656220898799,CSE 190,A00,092507,Dubnov; Shlomo,3,0,20,17
1656220904823,ECE 45,A01,083139,Congero; Spencer William,1,0,75,74
1656220910847,ECE 65,A50,083695,Saad; Andrew S,9,0,30,21
1656220910847,ECE 65,A51,095125,Staff,23,0,26,3
1656220916873,ECE 109,A01,091882,Touri; Behrouz,0,1,70,70
1656220922901,ECE 180,A00,083140,Abi Samra; Nicholas Camill,1,0,30,29
1656220922901,ECE 180,B00,083141,Abi Samra; Nicholas Camill,0,4,30,30
1656220928924,MATH 10A,A01,083735,Patchell; Gregory David,0,0,30,30
1656220928924,MATH 10A,A02,083736,Patchell; Gregory David,22,0,30,8
1656220928924,MATH 10A,A03,083737,Patchell; Gregory David,16,0,30,14
1656220934952,MATH 10B,A01,083207,Lim; Seonhee,0,0,34,34
1656220934952,MATH 10B,A02,083208,Lim; Seonhee,7,0,35,28
1656220934952,MATH 10B,A03,093472,Staff,1,0,34,33
1656220934952,MATH 10B,B01,083739,Sinha; Shubham,11,0,30,19
1656220940978,MATH 18,A01,083743,Cinel; Cameron Alexander,7,0,30,23
1656220940978,MATH 18,A02,083744,Cinel; Cameron Alexander,9,0,30,21
1656220940978,MATH 18,A03,083745,Cinel; Cameron Alexander,5,0,30,25
1656220940978,MATH 18,B01,083748,Rideout; David Porter,1,0,36,35
1656220940978,MATH 18,B02,083749,Rideout; David Porter,0,0,36,36
1656220940978,MATH 18,B03,083750,Rideout; David Porter,0,0,36,36
1656220940978,MATH 18,B04,083751,Rideout; David Porter,0,1,36,36
1656220940978,MATH 18,B05,093473,Rideout; David Porter,0,0,36,36
1656220940978,MATH 18,B06,093474,Rideout; David Porter,3,0,36,33
1656220947000,MATH 20A,A01,083754,Zheng; Zequn,11,0,40,29
1656220953024,MATH 20B,A01,083756,Briones; Jor-el Thomas Caparas,0,0,36,36
1656220953024,MATH 20B,A02,083757,Briones; Jor-el Thomas Caparas,0,0,36,36
1656220953024,MATH 20B,A03,093475,Staff,1,0,36,35
1656220959067,MATH 20C,A01,083760,Briones; Jor-el Thomas Caparas,0,0,35,35
1656220959067,MATH 20C,A02,083761,Briones; Jor-el Thomas Caparas,9,1,35,26
1656220959067,MATH 20C,A03,093476,Staff,0,0,35,35
1656220959067,MATH 20C,B01,083762,Bach; Quang Tran,1,0,30,29
1656220965091,MATH 20D,A01,083765,Tran; Brian Kha,1,0,30,29
1656220965091,MATH 20D,A02,083766,Tran; Brian Kha,0,1,30,30
1656220965091,MATH 20D,A03,083767,Tran; Brian Kha,2,0,30,28
1656220971121,MATH 20E,A01,083771,Ganguly; Soumya,3,0,32,29
1656220971121,MATH 20E,A02,083772,Ganguly; Soumya,0,0,32,32
1656220971121,MATH 20E,B01,083773,Ciotti; Benjamin,16,0,35,19
1656220971121,MATH 20E,B02,083774,Ciotti; Benjamin,15,0,35,20
1656220977150,MATH 103A,A01,083777,Greenfeld; Be'Eri,1,0,36,35
1656220977150,MATH 103A,A02,083778,Greenfeld; Be'Eri,1,0,36,35
1656220977150,MATH 103A,A03,093561,Staff,5,0,36,31
1656220977150,MATH 103A,B01,083779,Greenfeld; Be'Eri,9,1,36,27
1656220977150,MATH 103A,B02,083780,Greenfeld; Be'Eri,1,0,36,35
1656220977150,MATH 103A,B03,093562,Staff,0,0,36,36
1656220983174,MATH 105,A01,085443,Carter; Anne Toulson,5,1,35,30
1656220983174,MATH 105,A02,093477,Staff,14,0,35,21
1656220989206,MATH 109,A01,083213,Ganzberger; Geoffrey Michael,0,0,34,34
1656220989206,MATH 109,A02,083214,Ganzberger; Geoffrey Michael,0,0,34,34
1656220989206,MATH 109,A03,093478,Staff,1,0,34,33
1656220989206,MATH 109,B01,083215,Ganzberger; Geoffrey Michael,4,0,32,28
1656220989206,MATH 109,B02,083216,Ganzberger; Geoffrey Michael,1,0,32,31
1656220989206,MATH 109,B03,093479,Staff,4,0,32,28
1656220995237,MATH 142A,A01,083219,Chow; Bennett,2,0,32,30
1656220995237,MATH 142A,A02,083220,Chow; Bennett,8,0,32,24
1656220995237,MATH 142A,A03,093480,Staff,5,0,32,27
1656220995237,MATH 142A,B03,093481,Staff,3,0,32,29
1656220995237,MATH 142A,B04,093558,Staff,6,0,32,26
1656220995237,MATH 142A,B05,093559,Staff,1,0,32,31
1656221001265,MATH 193A,A01,083224,Rotar; Vladimir,0,1,34,34
1656221001265,MATH 193A,A02,083225,Rotar; Vladimir,0,0,34,34
1656221001265,MATH 193A,A03,083781,Rotar; Vladimir,0,0,34,34
1656221001265,MATH 193A,A04,083782,Rotar; Vladimir,6,0,34,28
1656221001265,MATH 193A,A05,093482,Rotar; Vladimir,0,0,34,34
1656221007292,MATH 197,001,091859,McAuley; Julian John,9999,0,9999,0
1656221007292,MATH 197,002,095566,Kedlaya; Kiran S.,9997,0,9999,2
1656221007292,MATH 197,003,095567,Xiao; Ming,9999,0,9999,0
1656221007292,MATH 197,004,095571,Perols; Johan Lars,9998,0,9999,1
1656221014350,COGS 9,A01,083615,Shannon; Kyle Michael,3,0,75,72
1656221020373,COGS 11,A01,083617,Boyle; Mary E. T.,14,0,48,34
1656221026400,COGS 13,A01,083071,Bastos; Amalia Pinkusfeld,4,0,71,67
1656221032423,COGS 14A,A01,092681,Semenuks; Arturs,4,16,100,96
1656221038453,COGS 14B,A01,083073,Cheng; Tzu-Han,7,0,63,56
1656221044474,COGS 17,A01,092677,Semenuks; Arturs,7,0,81,74
1656221050501,COGS 100,A01,083619,Allen; Michael Gordon,2,0,70,68
1656221056524,COGS 101A,A01,083621,Davis; Joshua Daniel,4,0,68,64
1656221062546,COGS 101B,A01,091572,Allen; Michael Gordon,4,0,65,61
1656221068576,COGS 101C,A01,083625,Delgado; Tania,10,0,35,25
1656221074599,COGS 107A,A01,083627,Boyle; Mary E. T.,0,0,60,60
1656221080621,COGS 118A,A01,083075,Gupta; Anjum,8,0,76,68
1656221086645,CSE 3,A50,083646,Miranda; Gregory Joseph,18,0,50,32
1656221092669,CSE 8A,A50,083650,Miranda; Gregory Joseph,3,3,56,53
1656221098694,CSE 11,A01,083080,Cao; Yingjun,1,50,40,39
1656221104717,CSE 12,A01,083652,Krause-Levy; Sophia Louisa,7,3,120,113
1656221110744,CSE 15L,A01,083654,Morris; Justin Loren,2,0,50,48
1656221110744,CSE 15L,A02,083655,Morris; Justin Loren,4,0,50,46
1656221116772,CSE 20,A01,083657,Tran; Khoa Dang,30,0,80,50
1656221122800,CSE 21,A01,095574,Bach; Quang Tran,23,0,48,25
1656221128835,CSE 30,A01,083084,Eldon; John,2,8,80,78
1656221128835,CSE 30,B01,095061,Bhaskar; Nishant,1,2,50,49
1656221134858,CSE 100,A01,083659,Cao; Yingjun,2,20,70,68
1656221140880,CSE 134B,A01,083661,Powell; Thomas Allan,5,0,100,95
1656221146907,CSE 140,A01,083663,Gungor; Onat,9,0,85,76
1656221152931,CSE 140L,A01,083088,Eldon; John,8,0,100,92
1656221158953,CSE 175,A01,083665,Kumar; Rakesh,0,0,25,25
1656221164980,CSE 190,A00,092507,Dubnov; Shlomo,3,0,20,17
1656221171004,ECE 45,A01,083139,Congero; Spencer William,1,0,75,74
1656221177028,ECE 65,A50,083695,Saad; Andrew S,9,0,30,21
1656221177028,ECE 65,A51,095125,Staff,23,0,26,3
1656221183051,ECE 109,A01,091882,Touri; Behrouz,0,1,70,70
1656221189079,ECE 180,A00,083140,Abi Samra; Nicholas Camill,1,0,30,29
1656221189079,ECE 180,B00,083141,Abi Samra; Nicholas Camill,0,4,30,30
1656221195104,MATH 10A,A01,083735,Patchell; Gregory David,0,0,30,30
1656221195104,MATH 10A,A02,083736,Patchell; Gregory David,22,0,30,8
1656221195104,MATH 10A,A03,083737,Patchell; Gregory David,16,0,30,14
1656221201136,MATH 10B,A01,083207,Lim; Seonhee,0,0,34,34
1656221201136,MATH 10B,A02,083208,Lim; Seonhee,7,0,35,28
1656221201136,MATH 10B,A03,093472,Staff,1,0,34,33
1656221201136,MATH 10B,B01,083739,Sinha; Shubham,11,0,30,19
1656221207161,MATH 18,A01,083743,Cinel; Cameron Alexander,7,0,30,23
1656221207161,MATH 18,A02,083744,Cinel; Cameron Alexander,9,0,30,21
1656221207161,MATH 18,A03,083745,Cinel; Cameron Alexander,5,0,30,25
1656221207161,MATH 18,B01,083748,Rideout; David Porter,1,0,36,35
1656221207161,MATH 18,B02,083749,Rideout; David Porter,0,0,36,36
1656221207161,MATH 18,B03,083750,Rideout; David Porter,0,0,36,36
1656221207161,MATH 18,B04,083751,Rideout; David Porter,0,1,36,36
1656221207161,MATH 18,B05,093473,Rideout; David Porter,0,0,36,36
1656221207161,MATH 18,B06,093474,Rideout; David Porter,3,0,36,33
1656221213183,MATH 20A,A01,083754,Zheng; Zequn,11,0,40,29
1656221219208,MATH 20B,A01,083756,Briones; Jor-el Thomas Caparas,0,0,36,36
1656221219208,MATH 20B,A02,083757,Briones; Jor-el Thomas Caparas,0,0,36,36
1656221219208,MATH 20B,A03,093475,Staff,1,0,36,35
1656221225246,MATH 20C,A01,083760,Briones; Jor-el Thomas Caparas,0,0,35,35
1656221225246,MATH 20C,A02,083761,Briones; Jor-el Thomas Caparas,9,1,35,26
1656221225246,MATH 20C,A03,093476,Staff,0,0,35,35
1656221225246,MATH 20C,B01,083762,Bach; Quang Tran,1,0,30,29
1656221231270,MATH 20D,A01,083765,Tran; Brian Kha,1,0,30,29
1656221231270,MATH 20D,A02,083766,Tran; Brian Kha,0,1,30,30
1656221231270,MATH 20D,A03,083767,Tran; Brian Kha,2,0,30,28
1656221237297,MATH 20E,A01,083771,Ganguly; Soumya,3,0,32,29
1656221237297,MATH 20E,A02,083772,Ganguly; Soumya,0,0,32,32
1656221237297,MATH 20E,B01,083773,Ciotti; Benjamin,16,0,35,19
1656221237297,MATH 20E,B02,083774,Ciotti; Benjamin,15,0,35,20
1656221243322,MATH 103A,A01,083777,Greenfeld; Be'Eri,1,0,36,35
1656221243322,MATH 103A,A02,083778,Greenfeld; Be'Eri,1,0,36,35
1656221243322,MATH 103A,A03,093561,Staff,5,0,36,31
1656221243322,MATH 103A,B01,083779,Greenfeld; Be'Eri,8,0,36,28
1656221243322,MATH 103A,B02,083780,Greenfeld; Be'Eri,1,0,36,35
1656221243322,MATH 103A,B03,093562,Staff,0,0,36,36
1656221249346,MATH 105,A01,085443,Carter; Anne Toulson,4,0,35,31
1656221249346,MATH 105,A02,093477,Staff,14,0,35,21
1656221255370,MATH 109,A01,083213,Ganzberger; Geoffrey Michael,0,0,34,34
1656221255370,MATH 109,A02,083214,Ganzberger; Geoffrey Michael,0,0,34,34
1656221255370,MATH 109,A03,093478,Staff,1,0,34,33
1656221255370,MATH 109,B01,083215,Ganzberger; Geoffrey Michael,4,0,32,28
1656221255370,MATH 109,B02,083216,Ganzberger; Geoffrey Michael,1,0,32,31
1656221255370,MATH 109,B03,093479,Staff,4,0,32,28
1656221261395,MATH 142A,A01,083219,Chow; Bennett,2,0,32,30
1656221261395,MATH 142A,A02,083220,Chow; Bennett,8,0,32,24
1656221261395,MATH 142A,A03,093480,Staff,5,0,32,27
1656221261395,MATH 142A,B03,093481,Staff,3,0,32,29
1656221261395,MATH 142A,B04,093558,Staff,6,0,32,26
1656221261395,MATH 142A,B05,093559,Staff,1,0,32,31
1656221267424,MATH 193A,A01,083224,Rotar; Vladimir,0,1,34,34
1656221267424,MATH 193A,A02,083225,Rotar; Vladimir,0,0,34,34
1656221267424,MATH 193A,A03,083781,Rotar; Vladimir,0,0,34,34
1656221267424,MATH 193A,A04,083782,Rotar; Vladimir,6,0,34,28
1656221267424,MATH 193A,A05,093482,Rotar; Vladimir,0,0,34,34
1656221273450,MATH 197,001,091859,McAuley; Julian John,9999,0,9999,0
1656221273450,MATH 197,002,095566,Kedlaya; Kiran S.,9997,0,9999,2
1656221273450,MATH 197,003,095567,Xiao; Ming,9999,0,9999,0
1656221273450,MATH 197,004,095571,Perols; Johan Lars,9998,0,9999,1
1656221280510,COGS 9,A01,083615,Shannon; Kyle Michael,3,0,75,72
1656221286536,COGS 11,A01,083617,Boyle; Mary E. T.,14,0,48,34
1656221292562,COGS 13,A01,083071,Bastos; Amalia Pinkusfeld,4,0,71,67
1656221298585,COGS 14A,A01,092681,Semenuks; Arturs,0,12,100,100
1656221304608,COGS 14B,A01,083073,Cheng; Tzu-Han,7,0,63,56
1656221310635,COGS 17,A01,092677,Semenuks; Arturs,7,0,81,74
1656221316659,COGS 100,A01,083619,Allen; Michael Gordon,2,0,70,68
1656221322682,COGS 101A,A01,083621,Davis; Joshua Daniel,4,0,68,64
1656221328706,COGS 101B,A01,091572,Allen; Michael Gordon,4,0,65,61
1656221334728,COGS 101C,A01,083625,Delgado; Tania,10,0,35,25
1656221340752,COGS 107A,A01,083627,Boyle; Mary E. T.,0,0,60,60
1656221346795,COGS 118A,A01,083075,Gupta; Anjum,8,0,76,68
1656221352824,CSE 3,A50,083646,Miranda; Gregory Joseph,18,0,50,32
1656221358847,CSE 8A,A50,083650,Miranda; Gregory Joseph,2,2,56,54
1656221364870,CSE 11,A01,083080,Cao; Yingjun,0,49,40,40
1656221370898,CSE 12,A01,083652,Krause-Levy; Sophia Louisa,5,1,120,115
1656221376923,CSE 15L,A01,083654,Morris; Justin Loren,2,0,50,48
1656221376923,CSE 15L,A02,083655,Morris; Justin Loren,4,0,50,46
1656221382948,CSE 20,A01,083657,Tran; Khoa Dang,30,0,80,50
1656221388975,CSE 21,A01,095574,Bach; Quang Tran,23,0,48,25
1656221395000,CSE 30,A01,083084,Eldon; John,2,6,80,78
1656221395000,CSE 30,B01,095061,Bhaskar; Nishant,0,1,50,50
1656221401028,CSE 100,A01,083659,Cao; Yingjun,1,18,70,69
1656221407051,CSE 134B,A01,083661,Powell; Thomas Allan,5,0,100,95
1656221413078,CSE 140,A01,083663,Gungor; Onat,9,0,85,76
1656221419105,CSE 140L,A01,083088,Eldon; John,8,0,100,92
1656221425127,CSE 175,A01,083665,Kumar; Rakesh,0,0,25,25
1656221431150,CSE 190,A00,092507,Dubnov; Shlomo,3,0,20,17
1656221437174,ECE 45,A01,083139,Congero; Spencer William,1,0,75,74
1656221443203,ECE 65,A50,083695,Saad; Andrew S,9,0,30,21
1656221443203,ECE 65,A51,095125,Staff,23,0,26,3
1656221449226,ECE 109,A01,091882,Touri; Behrouz,0,1,70,70
1656221455261,ECE 180,A00,083140,Abi Samra; Nicholas Camill,1,0,30,29
1656221455261,ECE 180,B00,083141,Abi Samra; Nicholas Camill,0,4,30,30
1656221461285,MATH 10A,A01,083735,Patchell; Gregory David,0,0,30,30
1656221461285,MATH 10A,A02,083736,Patchell; Gregory David,22,0,30,8
1656221461285,MATH 10A,A03,083737,Patchell; Gregory David,16,0,30,14
1656221467310,MATH 10B,A01,083207,Lim; Seonhee,0,0,34,34
1656221467310,MATH 10B,A02,083208,Lim; Seonhee,7,0,35,28
1656221467310,MATH 10B,A03,093472,Staff,1,0,34,33
1656221467310,MATH 10B,B01,083739,Sinha; Shubham,11,0,30,19
1656221473345,MATH 18,A01,083743,Cinel; Cameron Alexander,7,0,30,23
1656221473345,MATH 18,A02,083744,Cinel; Cameron Alexander,9,0,30,21
1656221473345,MATH 18,A03,083745,Cinel; Cameron Alexander,5,0,30,25
1656221473345,MATH 18,B01,083748,Rideout; David Porter,1,0,36,35
1656221473345,MATH 18,B02,083749,Rideout; David Porter,0,0,36,36
1656221473345,MATH 18,B03,083750,Rideout; David Porter,0,0,36,36
1656221473345,MATH 18,B04,083751,Rideout; David Porter,0,1,36,36
1656221473345,MATH 18,B05,093473,Rideout; David Porter,0,0,36,36
1656221473345,MATH 18,B06,093474,Rideout; David Porter,3,0,36,33
1656221479380,MATH 20A,A01,083754,Zheng; Zequn,11,0,40,29
1656221485410,MATH 20B,A01,083756,Briones; Jor-el Thomas Caparas,0,0,36,36
1656221485410,MATH 20B,A02,083757,Briones; Jor-el Thomas Caparas,0,0,36,36
1656221485410,MATH 20B,A03,093475,Staff,1,0,36,35
1656221491435,MATH 20C,A01,083760,Briones; Jor-el Thomas Caparas,0,0,35,35
1656221491435,MATH 20C,A02,083761,Briones; Jor-el Thomas Caparas,9,1,35,26
1656221491435,MATH 20C,A03,093476,Staff,0,0,35,35
1656221491435,MATH 20C,B01,083762,Bach; Quang Tran,1,0,30,29
1656221497539,MATH 20D,A01,083765,Tran; Brian Kha,1,0,30,29
1656221497539,MATH 20D,A02,083766,Tran; Brian Kha,0,1,30,30
1656221497539,MATH 20D,A03,083767,Tran; Brian Kha,2,0,30,28
1656221503562,MATH 20E,A01,083771,Ganguly; Soumya,3,0,32,29
1656221503562,MATH 20E,A02,083772,Ganguly; Soumya,0,0,32,32
1656221503562,MATH 20E,B01,083773,Ciotti; Benjamin,16,0,35,19
1656221503562,MATH 20E,B02,083774,Ciotti; Benjamin,15,0,35,20
1656221509592,MATH 103A,A01,083777,Greenfeld; Be'Eri,1,0,36,35
1656221509592,MATH 103A,A02,083778,Greenfeld; Be'Eri,1,0,36,35
1656221509592,MATH 103A,A03,093561,Staff,5,0,36,31
1656221509592,MATH 103A,B01,083779,Greenfeld; Be'Eri,8,0,36,28
1656221509592,MATH 103A,B02,083780,Greenfeld; Be'Eri,1,0,36,35
1656221509592,MATH 103A,B03,093562,Staff,0,0,36,36
1656221515614,MATH 105,A01,085443,Carter; Anne Toulson,4,0,35,31
1656221515614,MATH 105,A02,093477,Staff,14,0,35,21
1656221521638,MATH 109,A01,083213,Ganzberger; Geoffrey Michael,0,0,34,34
1656221521638,MATH 109,A02,083214,Ganzberger; Geoffrey Michael,0,0,34,34
1656221521638,MATH 109,A03,093478,Staff,1,0,34,33
1656221521638,MATH 109,B01,083215,Ganzberger; Geoffrey Michael,4,0,32,28
1656221521638,MATH 109,B02,083216,Ganzberger; Geoffrey Michael,1,0,32,31
1656221521638,MATH 109,B03,093479,Staff,4,0,32,28
1656221527668,MATH 142A,A01,083219,Chow; Bennett,2,0,32,30
1656221527668,MATH 142A,A02,083220,Chow; Bennett,8,0,32,24
1656221527668,MATH 142A,A03,093480,Staff,5,0,32,27
1656221527668,MATH 142A,B03,093481,Staff,3,0,32,29
1656221527668,MATH 142A,B04,093558,Staff,6,0,32,26
1656221527668,MATH 142A,B05,093559,Staff,1,0,32,31
1656221533693,MATH 193A,A01,083224,Rotar; Vladimir,0,1,34,34
1656221533693,MATH 193A,A02,083225,Rotar; Vladimir,0,0,34,34
1656221533693,MATH 193A,A03,083781,Rotar; Vladimir,0,0,34,34
1656221533693,MATH 193A,A04,083782,Rotar; Vladimir,6,0,34,28
1656221533693,MATH 193A,A05,093482,Rotar; Vladimir,0,0,34,34
1656221539718,MATH 197,001,091859,McAuley; Julian John,9999,0,9999,0
1656221539718,MATH 197,002,095566,Kedlaya; Kiran S.,9997,0,9999,2
1656221539718,MATH 197,003,095567,Xiao; Ming,9999,0,9999,0
1656221539718,MATH 197,004,095571,Perols; Johan Lars,9998,0,9999,1
1656221546785,COGS 9,A01,083615,Shannon; Kyle Michael,3,0,75,72
1656221552809,COGS 11,A01,083617,Boyle; Mary E. T.,14,0,48,34
1656221558835,COGS 13,A01,083071,Bastos; Amalia Pinkusfeld,4,0,71,67
1656221564865,COGS 14A,A01,092681,Semenuks; Arturs,0,12,100,100
1656221570899,COGS 14B,A01,083073,Cheng; Tzu-Han,7,0,63,56
1656221576924,COGS 17,A01,092677,Semenuks; Arturs,7,0,81,74
1656221582950,COGS 100,A01,083619,Allen; Michael Gordon,2,0,70,68
1656221588973,COGS 101A,A01,083621,Davis; Joshua Daniel,4,0,68,64
1656221594999,COGS 101B,A01,091572,Allen; Michael Gordon,4,0,65,61
1656221601030,COGS 101C,A01,083625,Delgado; Tania,10,0,35,25
1656221607053,COGS 107A,A01,083627,Boyle; Mary E. T.,0,0,60,60
1656221613075,COGS 118A,A01,083075,Gupta; Anjum,8,0,76,68
1656221619099,CSE 3,A50,083646,Miranda; Gregory Joseph,18,0,50,32
1656221625127,CSE 8A,A50,083650,Miranda; Gregory Joseph,2,2,56,54
1656221631153,CSE 11,A01,083080,Cao; Yingjun,0,49,40,40
1656221637175,CSE 12,A01,083652,Krause-Levy; Sophia Louisa,5,1,120,115
1656221643208,CSE 15L,A01,083654,Morris; Justin Loren,2,0,50,48
1656221643208,CSE 15L,A02,083655,Morris; Justin Loren,4,0,50,46
1656221649232,CSE 20,A01,083657,Tran; Khoa Dang,30,0,80,50
1656221655259,CSE 21,A01,095574,Bach; Quang Tran,23,0,48,25
1656221661288,CSE 30,A01,083084,Eldon; John,2,6,80,78
1656221661288,CSE 30,B01,095061,Bhaskar; Nishant,0,1,50,50
1656221667314,CSE 100,A01,083659,Cao; Yingjun,1,18,70,69
1656221673338,CSE 134B,A01,083661,Powell; Thomas Allan,5,0,100,95
1656221679369,CSE 140,A01,083663,Gungor; Onat,9,0,85,76
1656221685395,CSE 140L,A01,083088,Eldon; John,8,0,100,92
1656221691419,CSE 175,A01,083665,Kumar; Rakesh,0,0,25,25
1656221697442,CSE 190,A00,092507,Dubnov; Shlomo,3,0,20,17
1656221703470,ECE 45,A01,083139,Congero; Spencer William,1,0,75,74
1656221709493,ECE 65,A50,083695,Saad; Andrew S,9,0,30,21
1656221709493,ECE 65,A51,095125,Staff,23,0,26,3
1656221715519,ECE 109,A01,091882,Touri; Behrouz,0,1,70,70
1656221721553,ECE 180,A00,083140,Abi Samra; Nicholas Camill,1,0,30,29
1656221721553,ECE 180,B00,083141,Abi Samra; Nicholas Camill,0,4,30,30
1656221727577,MATH 10A,A01,083735,Patchell; Gregory David,0,0,30,30
1656221727577,MATH 10A,A02,083736,Patchell; Gregory David,22,0,30,8
1656221727577,MATH 10A,A03,083737,Patchell; Gregory David,16,0,30,14
1656221733602,MATH 10B,A01,083207,Lim; Seonhee,0,0,34,34
1656221733602,MATH 10B,A02,083208,Lim; Seonhee,7,0,35,28
1656221733602,MATH 10B,A03,093472,Staff,1,0,34,33
1656221733602,MATH 10B,B01,083739,Sinha; Shubham,11,0,30,19
1656221739628,MATH 18,A01,083743,Cinel; Cameron Alexander,7,0,30,23
1656221739628,MATH 18,A02,083744,Cinel; Cameron Alexander,9,0,30,21
1656221739628,MATH 18,A03,083745,Cinel; Cameron Alexander,5,0,30,25
1656221739628,MATH 18,B01,083748,Rideout; David Porter,1,0,36,35
1656221739628,MATH 18,B02,083749,Rideout; David Porter,0,0,36,36
1656221739628,MATH 18,B03,083750,Rideout; David Porter,0,0,36,36
1656221739628,MATH 18,B04,083751,Rideout; David Porter,0,1,36,36
1656221739628,MATH 18,B05,093473,Rideout; David Porter,0,0,36,36
1656221739628,MATH 18,B06,093474,Rideout; David Porter,3,0,36,33
1656221745649,MATH 20A,A01,083754,Zheng; Zequn,11,0,40,29
1656221751671,MATH 20B,A01,083756,Briones; Jor-el Thomas Caparas,0,0,36,36
1656221751671,MATH 20B,A02,083757,Briones; Jor-el Thomas Caparas,0,0,36,36
1656221751671,MATH 20B,A03,093475,Staff,1,0,36,35
1656221757696,MATH 20C,A01,083760,Briones; Jor-el Thomas Caparas,0,0,35,35
1656221757696,MATH 20C,A02,083761,Briones; Jor-el Thomas Caparas,9,1,35,26
1656221757696,MATH 20C,A03,093476,Staff,0,0,35,35
1656221757696,MATH 20C,B01,083762,Bach; Quang Tran,1,0,30,29
1656221763720,MATH 20D,A01,083765,Tran; Brian Kha,1,0,30,29
1656221763720,MATH 20D,A02,083766,Tran; Brian Kha,0,1,30,30
1656221763720,MATH 20D,A03,083767,Tran; Brian Kha,2,0,30,28
1656221769744,MATH 20E,A01,083771,Ganguly; Soumya,3,0,32,29
1656221769744,MATH 20E,A02,083772,Ganguly; Soumya,0,0,32,32
1656221769744,MATH 20E,B01,083773,Ciotti; Benjamin,16,0,35,19
1656221769744,MATH 20E,B02,083774,Ciotti; Benjamin,15,0,35,20
1656221775767,MATH 103A,A01,083777,Greenfeld; Be'Eri,1,0,36,35
1656221775767,MATH 103A,A02,083778,Greenfeld; Be'Eri,1,0,36,35
1656221775767,MATH 103A,A03,093561,Staff,5,0,36,31
1656221775767,MATH 103A,B01,083779,Greenfeld; Be'Eri,8,0,36,28
1656221775767,MATH 103A,B02,083780,Greenfeld; Be'Eri,1,0,36,35
1656221775767,MATH 103A,B03,093562,Staff,0,0,36,36
1656221781790,MATH 105,A01,085443,Carter; Anne Toulson,4,0,35,31
1656221781790,MATH 105,A02,093477,Staff,14,0,35,21
1656221787813,MATH 109,A01,083213,Ganzberger; Geoffrey Michael,0,0,34,34
1656221787813,MATH 109,A02,083214,Ganzberger; Geoffrey Michael,0,0,34,34
1656221787813,MATH 109,A03,093478,Staff,1,0,34,33
1656221787813,MATH 109,B01,083215,Ganzberger; Geoffrey Michael,4,0,32,28
1656221787813,MATH 109,B02,083216,Ganzberger; Geoffrey Michael,1,0,32,31
1656221787813,MATH 109,B03,093479,Staff,4,0,32,28
1656221793838,MATH 142A,A01,083219,Chow; Bennett,2,0,32,30
1656221793838,MATH 142A,A02,083220,Chow; Bennett,8,0,32,24
1656221793838,MATH 142A,A03,093480,Staff,5,0,32,27
1656221793838,MATH 142A,B03,093481,Staff,3,0,32,29
1656221793838,MATH 142A,B04,093558,Staff,6,0,32,26
1656221793838,MATH 142A,B05,093559,Staff,1,0,32,31
1656221799862,MATH 193A,A01,083224,Rotar; Vladimir,0,1,34,34
1656221799862,MATH 193A,A02,083225,Rotar; Vladimir,0,0,34,34
1656221799862,MATH 193A,A03,083781,Rotar; Vladimir,0,0,34,34
1656221799862,MATH 193A,A04,083782,Rotar; Vladimir,6,0,34,28
1656221799862,MATH 193A,A05,093482,Rotar; Vladimir,0,0,34,34
1656221805885,MATH 197,001,091859,McAuley; Julian John,9999,0,9999,0
1656221805885,MATH 197,002,095566,Kedlaya; Kiran S.,9997,0,9999,2
1656221805885,MATH 197,003,095567,Xiao; Ming,9999,0,9999,0
1656221805885,MATH 197,004,095571,Perols; Johan Lars,9998,0,9999,1
1656221812945,COGS 9,A01,083615,Shannon; Kyle Michael,3,0,75,72
1656221818969,COGS 11,A01,083617,Boyle; Mary E. T.,14,0,48,34
1656221824997,COGS 13,A01,083071,Bastos; Amalia Pinkusfeld,4,0,71,67
1656221831023,COGS 14A,A01,092681,Semenuks; Arturs,0,12,100,100
1656221837047,COGS 14B,A01,083073,Cheng; Tzu-Han,7,0,63,56
1656221843073,COGS 17,A01,092677,Semenuks; Arturs,7,0,81,74
1656221849097,COGS 100,A01,083619,Allen; Michael Gordon,2,0,70,68
1656221855121,COGS 101A,A01,083621,Davis; Joshua Daniel,4,0,68,64
1656221861150,COGS 101B,A01,091572,Allen; Michael Gordon,4,0,65,61
1656221867186,COGS 101C,A01,083625,Delgado; Tania,10,0,35,25
1656221873210,COGS 107A,A01,083627,Boyle; Mary E. T.,0,0,60,60
1656221879240,COGS 118A,A01,083075,Gupta; Anjum,8,0,76,68
1656221885265,CSE 3,A50,083646,Miranda; Gregory Joseph,18,0,50,32
1656221891288,CSE 8A,A50,083650,Miranda; Gregory Joseph,2,2,56,54
1656221897316,CSE 11,A01,083080,Cao; Yingjun,0,49,40,40
1656221903348,CSE 12,A01,083652,Krause-Levy; Sophia Louisa,5,1,120,115
1656221909371,CSE 15L,A01,083654,Morris; Justin Loren,2,0,50,48
1656221909371,CSE 15L,A02,083655,Morris; Justin Loren,4,0,50,46
1656221915395,CSE 20,A01,083657,Tran; Khoa Dang,30,0,80,50
1656221921422,CSE 21,A01,095574,Bach; Quang Tran,23,0,48,25
1656221927450,CSE 30,A01,083084,Eldon; John,2,6,80,78
1656221927450,CSE 30,B01,095061,Bhaskar; Nishant,0,1,50,50
1656221933477,CSE 100,A01,083659,Cao; Yingjun,1,18,70,69
1656221939503,CSE 134B,A01,083661,Powell; Thomas Allan,5,0,100,95
1656221945530,CSE 140,A01,083663,Gungor; Onat,9,0,85,76
1656221951563,CSE 140L,A01,083088,Eldon; John,8,0,100,92
1656221957591,CSE 175,A01,083665,Kumar; Rakesh,0,0,25,25
1656221963617,CSE 190,A00,092507,Dubnov; Shlomo,3,0,20,17
1656221969642,ECE 45,A01,083139,Congero; Spencer William,1,0,75,74
1656221975665,ECE 65,A50,083695,Saad; Andrew S,9,0,30,21
1656221975665,ECE 65,A51,095125,Staff,23,0,26,3
1656221981688,ECE 109,A01,091882,Touri; Behrouz,0,1,70,70
1656221987714,ECE 180,A00,083140,Abi Samra; Nicholas Camill,1,0,30,29
1656221987714,ECE 180,B00,083141,Abi Samra; Nicholas Camill,0,4,30,30
1656221993739,MATH 10A,A01,083735,Patchell; Gregory David,0,0,30,30
1656221993739,MATH 10A,A02,083736,Patchell; Gregory David,22,0,30,8
1656221993739,MATH 10A,A03,083737,Patchell; Gregory David,16,0,30,14
1656221999764,MATH 10B,A01,083207,Lim; Seonhee,0,0,34,34
1656221999764,MATH 10B,A02,083208,Lim; Seonhee,7,0,35,28
1656221999764,MATH 10B,A03,093472,Staff,1,0,34,33
1656221999764,MATH 10B,B01,083739,Sinha; Shubham,11,0,30,19
1656222005789,MATH 18,A01,083743,Cinel; Cameron Alexander,7,0,30,23
1656222005789,MATH 18,A02,083744,Cinel; Cameron Alexander,9,0,30,21
1656222005789,MATH 18,A03,083745,Cinel; Cameron Alexander,5,0,30,25
1656222005789,MATH 18,B01,083748,Rideout; David Porter,1,0,36,35
1656222005789,MATH 18,B02,083749,Rideout; David Porter,0,0,36,36
1656222005789,MATH 18,B03,083750,Rideout; David Porter,0,0,36,36
1656222005789,MATH 18,B04,083751,Rideout; David Porter,0,1,36,36
1656222005789,MATH 18,B05,093473,Rideout; David Porter,0,0,36,36
1656222005789,MATH 18,B06,093474,Rideout; David Porter,3,0,36,33
1656222011821,MATH 20A,A01,083754,Zheng; Zequn,11,0,40,29
1656222017845,MATH 20B,A01,083756,Briones; Jor-el Thomas Caparas,0,0,36,36
1656222017845,MATH 20B,A02,083757,Briones; Jor-el Thomas Caparas,0,0,36,36
1656222017845,MATH 20B,A03,093475,Staff,1,0,36,35
1656222023872,MATH 20C,A01,083760,Briones; Jor-el Thomas Caparas,0,0,35,35
1656222023872,MATH 20C,A02,083761,Briones; Jor-el Thomas Caparas,9,1,35,26
1656222023872,MATH 20C,A03,093476,Staff,0,0,35,35
1656222023872,MATH 20C,B01,083762,Bach; Quang Tran,1,0,30,29
1656222029901,MATH 20D,A01,083765,Tran; Brian Kha,1,0,30,29
1656222029901,MATH 20D,A02,083766,Tran; Brian Kha,0,1,30,30
1656222029901,MATH 20D,A03,083767,Tran; Brian Kha,2,0,30,28
1656222035925,MATH 20E,A01,083771,Ganguly; Soumya,3,0,32,29
1656222035925,MATH 20E,A02,083772,Ganguly; Soumya,0,0,32,32
1656222035925,MATH 20E,B01,083773,Ciotti; Benjamin,16,0,35,19
1656222035925,MATH 20E,B02,083774,Ciotti; Benjamin,15,0,35,20
1656222041949,MATH 103A,A01,083777,Greenfeld; Be'Eri,1,0,36,35
1656222041949,MATH 103A,A02,083778,Greenfeld; Be'Eri,1,0,36,35
1656222041949,MATH 103A,A03,093561,Staff,5,0,36,31
1656222041949,MATH 103A,B01,083779,Greenfeld; Be'Eri,8,0,36,28
1656222041949,MATH 103A,B02,083780,Greenfeld; Be'Eri,1,0,36,35
1656222041949,MATH 103A,B03,093562,Staff,0,0,36,36
1656222047973,MATH 105,A01,085443,Carter; Anne Toulson,4,0,35,31
1656222047973,MATH 105,A02,093477,Staff,14,0,35,21
1656222054001,MATH 109,A01,083213,Ganzberger; Geoffrey Michael,0,0,34,34
1656222054001,MATH 109,A02,083214,Ganzberger; Geoffrey Michael,0,0,34,34
1656222054001,MATH 109,A03,093478,Staff,1,0,34,33
1656222054001,MATH 109,B01,083215,Ganzberger; Geoffrey Michael,4,0,32,28
1656222054001,MATH 109,B02,083216,Ganzberger; Geoffrey Michael,1,0,32,31
1656222054001,MATH 109,B03,093479,Staff,4,0,32,28
1656222060033,MATH 142A,A01,083219,Chow; Bennett,2,0,32,30
1656222060033,MATH 142A,A02,083220,Chow; Bennett,8,0,32,24
1656222060033,MATH 142A,A03,093480,Staff,5,0,32,27
1656222060033,MATH 142A,B03,093481,Staff,3,0,32,29
1656222060033,MATH 142A,B04,093558,Staff,6,0,32,26
1656222060033,MATH 142A,B05,093559,Staff,1,0,32,31
1656222066057,MATH 193A,A01,083224,Rotar; Vladimir,0,1,34,34
1656222066057,MATH 193A,A02,083225,Rotar; Vladimir,0,0,34,34
1656222066057,MATH 193A,A03,083781,Rotar; Vladimir,0,0,34,34
1656222066057,MATH 193A,A04,083782,Rotar; Vladimir,6,0,34,28
1656222066057,MATH 193A,A05,093482,Rotar; Vladimir,0,0,34,34
1656222072079,MATH 197,001,091859,McAuley; Julian John,9999,0,9999,0
1656222072079,MATH 197,002,095566,Kedlaya; Kiran S.,9997,0,9999,2
1656222072079,MATH 197,003,095567,Xiao; Ming,9999,0,9999,0
1656222072079,MATH 197,004,095571,Perols; Johan Lars,9998,0,9999,1
1656222079132,COGS 9,A01,083615,Shannon; Kyle Michael,3,0,75,72
1656222085156,COGS 11,A01,083617,Boyle; Mary E. T.,14,0,48,34
1656222091252,COGS 13,A01,083071,Bastos; Amalia Pinkusfeld,4,0,71,67
1656222097274,COGS 14A,A01,092681,Semenuks; Arturs,0,12,100,100
1656222103297,COGS 14B,A01,083073,Cheng; Tzu-Han,7,0,63,56
1656222109326,COGS 17,A01,092677,Semenuks; Arturs,7,0,81,74
1656222115365,COGS 100,A01,083619,Allen; Michael Gordon,2,0,70,68
1656222121388,COGS 101A,A01,083621,Davis; Joshua Daniel,4,0,68,64
1656222127416,COGS 101B,A01,091572,Allen; Michael Gordon,4,0,65,61
1656222133443,COGS 101C,A01,083625,Delgado; Tania,10,0,35,25
1656222139470,COGS 107A,A01,083627,Boyle; Mary E. T.,0,0,60,60
1656222145492,COGS 118A,A01,083075,Gupta; Anjum,8,0,76,68
1656222151519,CSE 3,A50,083646,Miranda; Gregory Joseph,18,0,50,32
1656222157544,CSE 8A,A50,083650,Miranda; Gregory Joseph,2,2,56,54
1656222163568,CSE 11,A01,083080,Cao; Yingjun,0,49,40,40
1656222169590,CSE 12,A01,083652,Krause-Levy; Sophia Louisa,5,1,120,115
1656222175614,CSE 15L,A01,083654,Morris; Justin Loren,2,0,50,48
1656222175614,CSE 15L,A02,083655,Morris; Justin Loren,4,0,50,46
1656222181638,CSE 20,A01,083657,Tran; Khoa Dang,30,0,80,50
1656222187671,CSE 21,A01,095574,Bach; Quang Tran,23,0,48,25
1656222193693,CSE 30,A01,083084,Eldon; John,2,6,80,78
1656222193693,CSE 30,B01,095061,Bhaskar; Nishant,0,1,50,50
1656222199716,CSE 100,A01,083659,Cao; Yingjun,1,18,70,69
1656222205741,CSE 134B,A01,083661,Powell; Thomas Allan,5,0,100,95
1656222211764,CSE 140,A01,083663,Gungor; Onat,9,0,85,76
1656222217787,CSE 140L,A01,083088,Eldon; John,8,0,100,92
1656222223818,CSE 175,A01,083665,Kumar; Rakesh,0,0,25,25
1656222229842,CSE 190,A00,092507,Dubnov; Shlomo,3,0,20,17
1656222235867,ECE 45,A01,083139,Congero; Spencer William,1,0,75,74
1656222241894,ECE 65,A50,083695,Saad; Andrew S,9,0,30,21
1656222241894,ECE 65,A51,095125,Staff,23,0,26,3
1656222247918,ECE 109,A01,091882,Touri; Behrouz,0,1,70,70
1656222253944,ECE 180,A00,083140,Abi Samra; Nicholas Camill,1,0,30,29
1656222253944,ECE 180,B00,083141,Abi Samra; Nicholas Camill,0,4,30,30
1656222259968,MATH 10A,A01,083735,Patchell; Gregory David,0,0,30,30
1656222259968,MATH 10A,A02,083736,Patchell; Gregory David,22,0,30,8
1656222259968,MATH 10A,A03,083737,Patchell; Gregory David,16,0,30,14
1656222265992,MATH 10B,A01,083207,Lim; Seonhee,0,0,34,34
1656222265992,MATH 10B,A02,083208,Lim; Seonhee,7,0,35,28
1656222265992,MATH 10B,A03,093472,Staff,1,0,34,33
1656222265992,MATH 10B,B01,083739,Sinha; Shubham,11,0,30,19
1656222272016,MATH 18,A01,083743,Cinel; Cameron Alexander,7,0,30,23
1656222272016,MATH 18,A02,083744,Cinel; Cameron Alexander,9,0,30,21
1656222272016,MATH 18,A03,083745,Cinel; Cameron Alexander,5,0,30,25
1656222272016,MATH 18,B01,083748,Rideout; David Porter,1,0,36,35
1656222272016,MATH 18,B02,083749,Rideout; David Porter,0,0,36,36
1656222272016,MATH 18,B03,083750,Rideout; David Porter,0,0,36,36
1656222272016,MATH 18,B04,083751,Rideout; David Porter,0,1,36,36
1656222272016,MATH 18,B05,093473,Rideout; David Porter,0,0,36,36
1656222272016,MATH 18,B06,093474,Rideout; David Porter,3,0,36,33
1656222278043,MATH 20A,A01,083754,Zheng; Zequn,11,0,40,29
1656222284067,MATH 20B,A01,083756,Briones; Jor-el Thomas Caparas,0,0,36,36
1656222284067,MATH 20B,A02,083757,Briones; Jor-el Thomas Caparas,0,0,36,36
1656222284067,MATH 20B,A03,093475,Staff,0,0,36,36
1656222290093,MATH 20C,A01,083760,Briones; Jor-el Thomas Caparas,0,0,35,35
1656222290093,MATH 20C,A02,083761,Briones; Jor-el Thomas Caparas,9,1,35,26
1656222290093,MATH 20C,A03,093476,Staff,0,0,35,35
1656222290093,MATH 20C,B01,083762,Bach; Quang Tran,1,0,30,29
1656222296121,MATH 20D,A01,083765,Tran; Brian Kha,1,0,30,29
1656222296121,MATH 20D,A02,083766,Tran; Brian Kha,0,1,30,30
1656222296121,MATH 20D,A03,083767,Tran; Brian Kha,2,0,30,28
1656222302151,MATH 20E,A01,083771,Ganguly; Soumya,3,0,32,29
1656222302151,MATH 20E,A02,083772,Ganguly; Soumya,0,0,32,32
1656222302151,MATH 20E,B01,083773,Ciotti; Benjamin,16,0,35,19
1656222302151,MATH 20E,B02,083774,Ciotti; Benjamin,15,0,35,20
1656222308180,MATH 103A,A01,083777,Greenfeld; Be'Eri,1,0,36,35
1656222308180,MATH 103A,A02,083778,Greenfeld; Be'Eri,1,0,36,35
1656222308180,MATH 103A,A03,093561,Staff,5,0,36,31
1656222308180,MATH 103A,B01,083779,Greenfeld; Be'Eri,8,0,36,28
1656222308180,MATH 103A,B02,083780,Greenfeld; Be'Eri,1,0,36,35
1656222308180,MATH 103A,B03,093562,Staff,0,0,36,36
1656222314202,MATH 105,A01,085443,Carter; Anne Toulson,4,0,35,31
1656222314202,MATH 105,A02,093477,Staff,14,0,35,21
1656222320226,MATH 109,A01,083213,Ganzberger; Geoffrey Michael,0,0,34,34
1656222320226,MATH 109,A02,083214,Ganzberger; Geoffrey Michael,0,0,34,34
1656222320226,MATH 109,A03,093478,Staff,1,0,34,33
1656222320226,MATH 109,B01,083215,Ganzberger; Geoffrey Michael,4,0,32,28
1656222320226,MATH 109,B02,083216,Ganzberger; Geoffrey Michael,1,0,32,31
1656222320226,MATH 109,B03,093479,Staff,4,0,32,28
1656222326251,MATH 142A,A01,083219,Chow; Bennett,2,0,32,30
1656222326251,MATH 142A,A02,083220,Chow; Bennett,8,0,32,24
1656222326251,MATH 142A,A03,093480,Staff,5,0,32,27
1656222326251,MATH 142A,B03,093481,Staff,3,0,32,29
1656222326251,MATH 142A,B04,093558,Staff,6,0,32,26
1656222326251,MATH 142A,B05,093559,Staff,1,0,32,31
1656222332274,MATH 193A,A01,083224,Rotar; Vladimir,0,1,34,34
1656222332274,MATH 193A,A02,083225,Rotar; Vladimir,0,0,34,34
1656222332274,MATH 193A,A03,083781,Rotar; Vladimir,0,0,34,34
1656222332274,MATH 193A,A04,083782,Rotar; Vladimir,6,0,34,28
1656222332274,MATH 193A,A05,093482,Rotar; Vladimir,0,0,34,34
1656222338298,MATH 197,001,091859,McAuley; Julian John,9999,0,9999,0
1656222338298,MATH 197,002,095566,Kedlaya; Kiran S.,9997,0,9999,2
1656222338298,MATH 197,003,095567,Xiao; Ming,9999,0,9999,0
1656222338298,MATH 197,004,095571,Perols; Johan Lars,9998,0,9999,1
1656222345356,COGS 9,A01,083615,Shannon; Kyle Michael,3,0,75,72
1656222351378,COGS 11,A01,083617,Boyle; Mary E. T.,14,0,48,34
1656222357405,COGS 13,A01,083071,Bastos; Amalia Pinkusfeld,4,0,71,67
1656222363432,COGS 14A,A01,092681,Semenuks; Arturs,0,12,100,100
1656222369465,COGS 14B,A01,083073,Cheng; Tzu-Han,7,0,63,56
1656222375489,COGS 17,A01,092677,Semenuks; Arturs,7,0,81,74
1656222381513,COGS 100,A01,083619,Allen; Michael Gordon,2,0,70,68
1656222387542,COGS 101A,A01,083621,Davis; Joshua Daniel,4,0,68,64
1656222393563,COGS 101B,A01,091572,Allen; Michael Gordon,4,0,65,61
1656222399590,COGS 101C,A01,083625,Delgado; Tania,10,0,35,25
1656222405617,COGS 107A,A01,083627,Boyle; Mary E. T.,0,0,60,60
1656222411639,COGS 118A,A01,083075,Gupta; Anjum,8,0,76,68
1656222417665,CSE 3,A50,083646,Miranda; Gregory Joseph,18,0,50,32
1656222423692,CSE 8A,A50,083650,Miranda; Gregory Joseph,2,2,56,54
1656222429714,CSE 11,A01,083080,Cao; Yingjun,0,49,40,40
1656222435738,CSE 12,A01,083652,Krause-Levy; Sophia Louisa,5,1,120,115
1656222441768,CSE 15L,A01,083654,Morris; Justin Loren,2,0,50,48
1656222441768,CSE 15L,A02,083655,Morris; Justin Loren,4,0,50,46
1656222447790,CSE 20,A01,083657,Tran; Khoa Dang,30,0,80,50
1656222453819,CSE 21,A01,095574,Bach; Quang Tran,23,0,48,25
1656222459842,CSE 30,A01,083084,Eldon; John,2,6,80,78
1656222459842,CSE 30,B01,095061,Bhaskar; Nishant,0,1,50,50
1656222465875,CSE 100,A01,083659,Cao; Yingjun,1,18,70,69
1656222471899,CSE 134B,A01,083661,Powell; Thomas Allan,5,0,100,95
1656222477921,CSE 140,A01,083663,Gungor; Onat,9,0,85,76
1656222483942,CSE 140L,A01,083088,Eldon; John,8,0,100,92
1656222489969,CSE 175,A01,083665,Kumar; Rakesh,0,0,25,25
1656222495992,CSE 190,A00,092507,Dubnov; Shlomo,3,0,20,17
1656222502020,ECE 45,A01,083139,Congero; Spencer William,1,0,75,74
1656222508058,ECE 65,A50,083695,Saad; Andrew S,9,0,30,21
1656222508058,ECE 65,A51,095125,Staff,23,0,26,3
1656222514082,ECE 109,A01,091882,Touri; Behrouz,0,1,70,70
1656222520114,ECE 180,A00,083140,Abi Samra; Nicholas Camill,1,0,30,29
1656222520114,ECE 180,B00,083141,Abi Samra; Nicholas Camill,0,4,30,30
1656222526141,MATH 10A,A01,083735,Patchell; Gregory David,0,0,30,30
1656222526141,MATH 10A,A02,083736,Patchell; Gregory David,22,0,30,8
1656222526141,MATH 10A,A03,083737,Patchell; Gregory David,16,0,30,14
1656222532165,MATH 10B,A01,083207,Lim; Seonhee,0,0,34,34
1656222532165,MATH 10B,A02,083208,Lim; Seonhee,7,0,35,28
1656222532165,MATH 10B,A03,093472,Staff,1,0,34,33
1656222532165,MATH 10B,B01,083739,Sinha; Shubham,11,0,30,19
1656222538195,MATH 18,A01,083743,Cinel; Cameron Alexander,7,0,30,23
1656222538195,MATH 18,A02,083744,Cinel; Cameron Alexander,9,0,30,21
1656222538195,MATH 18,A03,083745,Cinel; Cameron Alexander,5,0,30,25
1656222538195,MATH 18,B01,083748,Rideout; David Porter,1,0,36,35
1656222538195,MATH 18,B02,083749,Rideout; David Porter,0,0,36,36
1656222538195,MATH 18,B03,083750,Rideout; David Porter,0,0,36,36
1656222538195,MATH 18,B04,083751,Rideout; David Porter,0,1,36,36
1656222538195,MATH 18,B05,093473,Rideout; David Porter,0,0,36,36
1656222538195,MATH 18,B06,093474,Rideout; David Porter,3,0,36,33
1656222544223,MATH 20A,A01,083754,Zheng; Zequn,11,0,40,29
1656222550255,MATH 20B,A01,083756,Briones; Jor-el Thomas Caparas,0,0,36,36
1656222550255,MATH 20B,A02,083757,Briones; Jor-el Thomas Caparas,0,0,36,36
1656222550255,MATH 20B,A03,093475,Staff,0,0,36,36
1656222556282,MATH 20C,A01,083760,Briones; Jor-el Thomas Caparas,0,0,35,35
1656222556282,MATH 20C,A02,083761,Briones; Jor-el Thomas Caparas,9,1,35,26
1656222556282,MATH 20C,A03,093476,Staff,0,0,35,35
1656222556282,MATH 20C,B01,083762,Bach; Quang Tran,1,0,30,29
1656222562306,MATH 20D,A01,083765,Tran; Brian Kha,1,0,30,29
1656222562306,MATH 20D,A02,083766,Tran; Brian Kha,0,1,30,30
1656222562306,MATH 20D,A03,083767,Tran; Brian Kha,2,0,30,28
1656222568332,MATH 20E,A01,083771,Ganguly; Soumya,3,0,32,29
1656222568332,MATH 20E,A02,083772,Ganguly; Soumya,0,0,32,32
1656222568332,MATH 20E,B01,083773,Ciotti; Benjamin,16,0,35,19
1656222568332,MATH 20E,B02,083774,Ciotti; Benjamin,15,0,35,20
1656222574367,MATH 103A,A01,083777,Greenfeld; Be'Eri,1,0,36,35
1656222574367,MATH 103A,A02,083778,Greenfeld; Be'Eri,1,0,36,35
1656222574367,MATH 103A,A03,093561,Staff,5,0,36,31
1656222574367,MATH 103A,B01,083779,Greenfeld; Be'Eri,8,0,36,28
1656222574367,MATH 103A,B02,083780,Greenfeld; Be'Eri,1,0,36,35
1656222574367,MATH 103A,B03,093562,Staff,0,0,36,36
1656222580394,MATH 105,A01,085443,Carter; Anne Toulson,4,0,35,31
1656222580394,MATH 105,A02,093477,Staff,14,0,35,21
1656222586417,MATH 109,A01,083213,Ganzberger; Geoffrey Michael,0,0,34,34
1656222586417,MATH 109,A02,083214,Ganzberger; Geoffrey Michael,0,0,34,34
1656222586417,MATH 109,A03,093478,Staff,1,0,34,33
1656222586417,MATH 109,B01,083215,Ganzberger; Geoffrey Michael,4,0,32,28
1656222586417,MATH 109,B02,083216,Ganzberger; Geoffrey Michael,1,0,32,31
1656222586417,MATH 109,B03,093479,Staff,4,0,32,28
1656222592441,MATH 142A,A01,083219,Chow; Bennett,2,0,32,30
1656222592441,MATH 142A,A02,083220,Chow; Bennett,8,0,32,24
1656222592441,MATH 142A,A03,093480,Staff,5,0,32,27
1656222592441,MATH 142A,B03,093481,Staff,3,0,32,29
1656222592441,MATH 142A,B04,093558,Staff,6,0,32,26
1656222592441,MATH 142A,B05,093559,Staff,1,0,32,31
1656222598463,MATH 193A,A01,083224,Rotar; Vladimir,0,1,34,34
1656222598463,MATH 193A,A02,083225,Rotar; Vladimir,0,0,34,34
1656222598463,MATH 193A,A03,083781,Rotar; Vladimir,0,0,34,34
1656222598463,MATH 193A,A04,083782,Rotar; Vladimir,6,0,34,28
1656222598463,MATH 193A,A05,093482,Rotar; Vladimir,0,0,34,34
1656222604493,MATH 197,001,091859,McAuley; Julian John,9999,0,9999,0
1656222604493,MATH 197,002,095566,Kedlaya; Kiran S.,9997,0,9999,2
1656222604493,MATH 197,003,095567,Xiao; Ming,9999,0,9999,0
1656222604493,MATH 197,004,095571,Perols; Johan Lars,9998,0,9999,1
1656222611545,COGS 9,A01,083615,Shannon; Kyle Michael,3,0,75,72
1656222617569,COGS 11,A01,083617,Boyle; Mary E. T.,14,0,48,34
1656222623596,COGS 13,A01,083071,Bastos; Amalia Pinkusfeld,4,0,71,67
1656222629620,COGS 14A,A01,092681,Semenuks; Arturs,0,12,100,100
1656222635642,COGS 14B,A01,083073,Cheng; Tzu-Han,7,0,63,56
1656222641667,COGS 17,A01,092677,Semenuks; Arturs,7,0,81,74
1656222647694,COGS 100,A01,083619,Allen; Michael Gordon,2,0,70,68
1656222653718,COGS 101A,A01,083621,Davis; Joshua Daniel,4,0,68,64
1656222659741,COGS 101B,A01,091572,Allen; Michael Gordon,4,0,65,61
1656222665765,COGS 101C,A01,083625,Delgado; Tania,10,0,35,25
1656222671792,COGS 107A,A01,083627,Boyle; Mary E. T.,0,0,60,60
1656222677815,COGS 118A,A01,083075,Gupta; Anjum,8,0,76,68
1656222683840,CSE 3,A50,083646,Miranda; Gregory Joseph,18,0,50,32
1656222689956,CSE 8A,A50,083650,Miranda; Gregory Joseph,2,2,56,54
1656222695980,CSE 11,A01,083080,Cao; Yingjun,0,49,40,40
1656222702002,CSE 12,A01,083652,Krause-Levy; Sophia Louisa,5,1,120,115
1656222708025,CSE 15L,A01,083654,Morris; Justin Loren,2,0,50,48
1656222708025,CSE 15L,A02,083655,Morris; Justin Loren,4,0,50,46
1656222714053,CSE 20,A01,083657,Tran; Khoa Dang,30,0,80,50
1656222720077,CSE 21,A01,095574,Bach; Quang Tran,23,0,48,25
1656222726101,CSE 30,A01,083084,Eldon; John,2,6,80,78
1656222726101,CSE 30,B01,095061,Bhaskar; Nishant,0,1,50,50
1656222732124,CSE 100,A01,083659,Cao; Yingjun,1,18,70,69
1656222738157,CSE 134B,A01,083661,Powell; Thomas Allan,5,0,100,95
1656222744184,CSE 140,A01,083663,Gungor; Onat,9,0,85,76
1656222750207,CSE 140L,A01,083088,Eldon; John,8,0,100,92
1656222756231,CSE 175,A01,083665,Kumar; Rakesh,0,0,25,25
1656222762254,CSE 190,A00,092507,Dubnov; Shlomo,3,0,20,17
1656222768276,ECE 45,A01,083139,Congero; Spencer William,1,0,75,74
1656222774300,ECE 65,A50,083695,Saad; Andrew S,9,0,30,21
1656222774300,ECE 65,A51,095125,Staff,23,0,26,3
1656222780328,ECE 109,A01,091882,Touri; Behrouz,0,1,70,70
1656222786352,ECE 180,A00,083140,Abi Samra; Nicholas Camill,1,0,30,29
1656222786352,ECE 180,B00,083141,Abi Samra; Nicholas Camill,0,4,30,30
1656222792378,MATH 10A,A01,083735,Patchell; Gregory David,0,0,30,30
1656222792378,MATH 10A,A02,083736,Patchell; Gregory David,22,0,30,8
1656222792378,MATH 10A,A03,083737,Patchell; Gregory David,16,0,30,14
1656222798411,MATH 10B,A01,083207,Lim; Seonhee,0,0,34,34
1656222798411,MATH 10B,A02,083208,Lim; Seonhee,7,0,35,28
1656222798411,MATH 10B,A03,093472,Staff,1,0,34,33
1656222798411,MATH 10B,B01,083739,Sinha; Shubham,11,0,30,19
1656222804456,MATH 18,A01,083743,Cinel; Cameron Alexander,7,0,30,23
1656222804456,MATH 18,A02,083744,Cinel; Cameron Alexander,9,0,30,21
1656222804456,MATH 18,A03,083745,Cinel; Cameron Alexander,5,0,30,25
1656222804456,MATH 18,B01,083748,Rideout; David Porter,1,0,36,35
1656222804456,MATH 18,B02,083749,Rideout; David Porter,0,0,36,36
1656222804456,MATH 18,B03,083750,Rideout; David Porter,0,0,36,36
1656222804456,MATH 18,B04,083751,Rideout; David Porter,0,1,36,36
1656222804456,MATH 18,B05,093473,Rideout; David Porter,0,0,36,36
1656222804456,MATH 18,B06,093474,Rideout; David Porter,3,0,36,33
1656222810477,MATH 20A,A01,083754,Zheng; Zequn,11,0,40,29
1656222816509,MATH 20B,A01,083756,Briones; Jor-el Thomas Caparas,0,0,36,36
1656222816509,MATH 20B,A02,083757,Briones; Jor-el Thomas Caparas,0,0,36,36
1656222816509,MATH 20B,A03,093475,Staff,0,0,36,36
1656222822533,MATH 20C,A01,083760,Briones; Jor-el Thomas Caparas,0,0,35,35
1656222822533,MATH 20C,A02,083761,Briones; Jor-el Thomas Caparas,9,1,35,26
1656222822533,MATH 20C,A03,093476,Staff,0,0,35,35
1656222822533,MATH 20C,B01,083762,Bach; Quang Tran,1,0,30,29
1656222828556,MATH 20D,A01,083765,Tran; Brian Kha,1,0,30,29
1656222828556,MATH 20D,A02,083766,Tran; Brian Kha,0,1,30,30
1656222828556,MATH 20D,A03,083767,Tran; Brian Kha,2,0,30,28
1656222834580,MATH 20E,A01,083771,Ganguly; Soumya,3,0,32,29
1656222834580,MATH 20E,A02,083772,Ganguly; Soumya,0,0,32,32
1656222834580,MATH 20E,B01,083773,Ciotti; Benjamin,16,0,35,19
1656222834580,MATH 20E,B02,083774,Ciotti; Benjamin,15,0,35,20
1656222840614,MATH 103A,A01,083777,Greenfeld; Be'Eri,1,0,36,35
1656222840614,MATH 103A,A02,083778,Greenfeld; Be'Eri,1,0,36,35
1656222840614,MATH 103A,A03,093561,Staff,5,0,36,31
1656222840614,MATH 103A,B01,083779,Greenfeld; Be'Eri,8,0,36,28
1656222840614,MATH 103A,B02,083780,Greenfeld; Be'Eri,1,0,36,35
1656222840614,MATH 103A,B03,093562,Staff,0,0,36,36
1656222846638,MATH 105,A01,085443,Carter; Anne Toulson,4,0,35,31
1656222846638,MATH 105,A02,093477,Staff,14,0,35,21
1656222852670,MATH 109,A01,083213,Ganzberger; Geoffrey Michael,0,0,34,34
1656222852670,MATH 109,A02,083214,Ganzberger; Geoffrey Michael,0,0,34,34
1656222852670,MATH 109,A03,093478,Staff,1,0,34,33
1656222852670,MATH 109,B01,083215,Ganzberger; Geoffrey Michael,4,0,32,28
1656222852670,MATH 109,B02,083216,Ganzberger; Geoffrey Michael,1,0,32,31
1656222852670,MATH 109,B03,093479,Staff,4,0,32,28
1656222858694,MATH 142A,A01,083219,Chow; Bennett,2,0,32,30
1656222858694,MATH 142A,A02,083220,Chow; Bennett,8,0,32,24
1656222858694,MATH 142A,A03,093480,Staff,5,0,32,27
1656222858694,MATH 142A,B03,093481,Staff,3,0,32,29
1656222858694,MATH 142A,B04,093558,Staff,6,0,32,26
1656222858694,MATH 142A,B05,093559,Staff,1,0,32,31
1656222864718,MATH 193A,A01,083224,Rotar; Vladimir,0,1,34,34
1656222864718,MATH 193A,A02,083225,Rotar; Vladimir,0,0,34,34
1656222864718,MATH 193A,A03,083781,Rotar; Vladimir,0,0,34,34
1656222864718,MATH 193A,A04,083782,Rotar; Vladimir,6,0,34,28
1656222864718,MATH 193A,A05,093482,Rotar; Vladimir,0,0,34,34
1656222870741,MATH 197,001,091859,McAuley; Julian John,9999,0,9999,0
1656222870741,MATH 197,002,095566,Kedlaya; Kiran S.,9997,0,9999,2
1656222870741,MATH 197,003,095567,Xiao; Ming,9999,0,9999,0
1656222870741,MATH 197,004,095571,Perols; Johan Lars,9998,0,9999,1
1656222877793,COGS 9,A01,083615,Shannon; Kyle Michael,3,0,75,72
1656222883822,COGS 11,A01,083617,Boyle; Mary E. T.,14,0,48,34
1656222889849,COGS 13,A01,083071,Bastos; Amalia Pinkusfeld,4,0,71,67
1656222895873,COGS 14A,A01,092681,Semenuks; Arturs,0,12,100,100
1656222901900,COGS 14B,A01,083073,Cheng; Tzu-Han,7,0,63,56
1656222907921,COGS 17,A01,092677,Semenuks; Arturs,7,0,81,74
1656222913949,COGS 100,A01,083619,Allen; Michael Gordon,2,0,70,68
1656222919973,COGS 101A,A01,083621,Davis; Joshua Daniel,4,0,68,64
1656222925995,COGS 101B,A01,091572,Allen; Michael Gordon,4,0,65,61
1656222932018,COGS 101C,A01,083625,Delgado; Tania,10,0,35,25
1656222938044,COGS 107A,A01,083627,Boyle; Mary E. T.,0,0,60,60
1656222944070,COGS 118A,A01,083075,Gupta; Anjum,8,0,76,68
1656222950094,CSE 3,A50,083646,Miranda; Gregory Joseph,18,0,50,32
1656222956122,CSE 8A,A50,083650,Miranda; Gregory Joseph,2,2,56,54
1656222962146,CSE 11,A01,083080,Cao; Yingjun,0,49,40,40
1656222968170,CSE 12,A01,083652,Krause-Levy; Sophia Louisa,5,1,120,115
1656222974194,CSE 15L,A01,083654,Morris; Justin Loren,2,0,50,48
1656222974194,CSE 15L,A02,083655,Morris; Justin Loren,4,0,50,46
1656222980222,CSE 20,A01,083657,Tran; Khoa Dang,30,0,80,50
1656222986244,CSE 21,A01,095574,Bach; Quang Tran,23,0,48,25
1656222992269,CSE 30,A01,083084,Eldon; John,2,6,80,78
1656222992269,CSE 30,B01,095061,Bhaskar; Nishant,0,1,50,50
1656222998296,CSE 100,A01,083659,Cao; Yingjun,1,18,70,69
1656223004319,CSE 134B,A01,083661,Powell; Thomas Allan,5,0,100,95
1656223010344,CSE 140,A01,083663,Gungor; Onat,9,0,85,76
1656223016368,CSE 140L,A01,083088,Eldon; John,8,0,100,92
1656223022391,CSE 175,A01,083665,Kumar; Rakesh,0,0,25,25
1656223028420,CSE 190,A00,092507,Dubnov; Shlomo,3,0,20,17
1656223034445,ECE 45,A01,083139,Congero; Spencer William,1,0,75,74
1656223040468,ECE 65,A50,083695,Saad; Andrew S,9,0,30,21
1656223040468,ECE 65,A51,095125,Staff,23,0,26,3
1656223046496,ECE 109,A01,091882,Touri; Behrouz,0,1,70,70
1656223052519,ECE 180,A00,083140,Abi Samra; Nicholas Camill,1,0,30,29
1656223052519,ECE 180,B00,083141,Abi Samra; Nicholas Camill,0,4,30,30
1656223058554,MATH 10A,A01,083735,Patchell; Gregory David,0,0,30,30
1656223058554,MATH 10A,A02,083736,Patchell; Gregory David,22,0,30,8
1656223058554,MATH 10A,A03,083737,Patchell; Gregory David,16,0,30,14
1656223064583,MATH 10B,A01,083207,Lim; Seonhee,0,0,34,34
1656223064583,MATH 10B,A02,083208,Lim; Seonhee,7,0,35,28
1656223064583,MATH 10B,A03,093472,Staff,1,0,34,33
1656223064583,MATH 10B,B01,083739,Sinha; Shubham,11,0,30,19
1656223070615,MATH 18,A01,083743,Cinel; Cameron Alexander,7,0,30,23
1656223070615,MATH 18,A02,083744,Cinel; Cameron Alexander,9,0,30,21
1656223070615,MATH 18,A03,083745,Cinel; Cameron Alexander,5,0,30,25
1656223070615,MATH 18,B01,083748,Rideout; David Porter,1,0,36,35
1656223070615,MATH 18,B02,083749,Rideout; David Porter,0,0,36,36
1656223070615,MATH 18,B03,083750,Rideout; David Porter,0,0,36,36
1656223070615,MATH 18,B04,083751,Rideout; David Porter,0,1,36,36
1656223070615,MATH 18,B05,093473,Rideout; David Porter,0,0,36,36
1656223070615,MATH 18,B06,093474,Rideout; David Porter,3,0,36,33
1656223076645,MATH 20A,A01,083754,Zheng; Zequn,11,0,40,29
1656223082669,MATH 20B,A01,083756,Briones; Jor-el Thomas Caparas,0,0,36,36
1656223082669,MATH 20B,A02,083757,Briones; Jor-el Thomas Caparas,0,0,36,36
1656223082669,MATH 20B,A03,093475,Staff,0,0,36,36
1656223088698,MATH 20C,A01,083760,Briones; Jor-el Thomas Caparas,0,0,35,35
1656223088698,MATH 20C,A02,083761,Briones; Jor-el Thomas Caparas,9,1,35,26
1656223088698,MATH 20C,A03,093476,Staff,0,0,35,35
1656223088698,MATH 20C,B01,083762,Bach; Quang Tran,1,0,30,29
1656223094721,MATH 20D,A01,083765,Tran; Brian Kha,1,0,30,29
1656223094721,MATH 20D,A02,083766,Tran; Brian Kha,0,1,30,30
1656223094721,MATH 20D,A03,083767,Tran; Brian Kha,2,0,30,28
1656223100745,MATH 20E,A01,083771,Ganguly; Soumya,3,0,32,29
1656223100745,MATH 20E,A02,083772,Ganguly; Soumya,0,0,32,32
1656223100745,MATH 20E,B01,083773,Ciotti; Benjamin,16,0,35,19
1656223100745,MATH 20E,B02,083774,Ciotti; Benjamin,15,0,35,20
1656223106770,MATH 103A,A01,083777,Greenfeld; Be'Eri,1,0,36,35
1656223106770,MATH 103A,A02,083778,Greenfeld; Be'Eri,1,0,36,35
1656223106770,MATH 103A,A03,093561,Staff,5,0,36,31
1656223106770,MATH 103A,B01,083779,Greenfeld; Be'Eri,8,0,36,28
1656223106770,MATH 103A,B02,083780,Greenfeld; Be'Eri,1,0,36,35
1656223106770,MATH 103A,B03,093562,Staff,0,0,36,36
1656223112796,MATH 105,A01,085443,Carter; Anne Toulson,4,0,35,31
1656223112796,MATH 105,A02,093477,Staff,14,0,35,21
1656223118820,MATH 109,A01,083213,Ganzberger; Geoffrey Michael,0,0,34,34
1656223118820,MATH 109,A02,083214,Ganzberger; Geoffrey Michael,0,0,34,34
1656223118820,MATH 109,A03,093478,Staff,1,0,34,33
1656223118820,MATH 109,B01,083215,Ganzberger; Geoffrey Michael,4,0,32,28
1656223118820,MATH 109,B02,083216,Ganzberger; Geoffrey Michael,1,0,32,31
1656223118820,MATH 109,B03,093479,Staff,4,0,32,28
1656223124854,MATH 142A,A01,083219,Chow; Bennett,2,0,32,30
1656223124854,MATH 142A,A02,083220,Chow; Bennett,8,0,32,24
1656223124854,MATH 142A,A03,093480,Staff,5,0,32,27
1656223124854,MATH 142A,B03,093481,Staff,3,0,32,29
1656223124854,MATH 142A,B04,093558,Staff,6,0,32,26
1656223124854,MATH 142A,B05,093559,Staff,1,0,32,31
1656223130877,MATH 193A,A01,083224,Rotar; Vladimir,0,1,34,34
1656223130877,MATH 193A,A02,083225,Rotar; Vladimir,0,0,34,34
1656223130877,MATH 193A,A03,083781,Rotar; Vladimir,0,0,34,34
1656223130877,MATH 193A,A04,083782,Rotar; Vladimir,6,0,34,28
1656223130877,MATH 193A,A05,093482,Rotar; Vladimir,0,0,34,34
1656223136901,MATH 197,001,091859,McAuley; Julian John,9999,0,9999,0
1656223136901,MATH 197,002,095566,Kedlaya; Kiran S.,9997,0,9999,2
1656223136901,MATH 197,003,095567,Xiao; Ming,9999,0,9999,0
1656223136901,MATH 197,004,095571,Perols; Johan Lars,9998,0,9999,1
1656223143965,COGS 9,A01,083615,Shannon; Kyle Michael,3,0,75,72
1656223149987,COGS 11,A01,083617,Boyle; Mary E. T.,14,0,48,34
1656223156009,COGS 13,A01,083071,Bastos; Amalia Pinkusfeld,4,0,71,67
1656223162043,COGS 14A,A01,092681,Semenuks; Arturs,0,12,100,100
1656223168068,COGS 14B,A01,083073,Cheng; Tzu-Han,7,0,63,56
1656223174089,COGS 17,A01,092677,Semenuks; Arturs,7,0,81,74
1656223180116,COGS 100,A01,083619,Allen; Michael Gordon,2,0,70,68
1656223186141,COGS 101A,A01,083621,Davis; Joshua Daniel,4,0,68,64
1656223192169,COGS 101B,A01,091572,Allen; Michael Gordon,4,0,65,61
1656223198193,COGS 101C,A01,083625,Delgado; Tania,10,0,35,25
1656223204220,COGS 107A,A01,083627,Boyle; Mary E. T.,0,0,60,60
1656223210245,COGS 118A,A01,083075,Gupta; Anjum,8,0,76,68
1656223216269,CSE 3,A50,083646,Miranda; Gregory Joseph,18,0,50,32
1656223222293,CSE 8A,A50,083650,Miranda; Gregory Joseph,2,2,56,54
1656223228315,CSE 11,A01,083080,Cao; Yingjun,0,49,40,40
1656223234338,CSE 12,A01,083652,Krause-Levy; Sophia Louisa,5,1,120,115
1656223240363,CSE 15L,A01,083654,Morris; Justin Loren,2,0,50,48
1656223240363,CSE 15L,A02,083655,Morris; Justin Loren,4,0,50,46
1656223246391,CSE 20,A01,083657,Tran; Khoa Dang,30,0,80,50
1656223252414,CSE 21,A01,095574,Bach; Quang Tran,23,0,48,25
1656223258443,CSE 30,A01,083084,Eldon; John,2,6,80,78
1656223258443,CSE 30,B01,095061,Bhaskar; Nishant,0,1,50,50
1656223264468,CSE 100,A01,083659,Cao; Yingjun,1,18,70,69
1656223270491,CSE 134B,A01,083661,Powell; Thomas Allan,5,0,100,95
1656223276515,CSE 140,A01,083663,Gungor; Onat,9,0,85,76
1656223282542,CSE 140L,A01,083088,Eldon; John,8,0,100,92
1656223288646,CSE 175,A01,083665,Kumar; Rakesh,0,0,25,25
1656223294673,CSE 190,A00,092507,Dubnov; Shlomo,3,0,20,17
1656223300696,ECE 45,A01,083139,Congero; Spencer William,1,0,75,74
1656223306720,ECE 65,A50,083695,Saad; Andrew S,9,0,30,21
1656223306720,ECE 65,A51,095125,Staff,23,0,26,3
1656223312745,ECE 109,A01,091882,Touri; Behrouz,0,1,70,70
1656223318776,ECE 180,A00,083140,Abi Samra; Nicholas Camill,1,0,30,29
1656223318776,ECE 180,B00,083141,Abi Samra; Nicholas Camill,0,4,30,30
1656223324815,MATH 10A,A01,083735,Patchell; Gregory David,0,0,30,30
1656223324815,MATH 10A,A02,083736,Patchell; Gregory David,22,0,30,8
1656223324815,MATH 10A,A03,083737,Patchell; Gregory David,16,0,30,14
1656223330840,MATH 10B,A01,083207,Lim; Seonhee,0,0,34,34
1656223330840,MATH 10B,A02,083208,Lim; Seonhee,7,0,35,28
1656223330840,MATH 10B,A03,093472,Staff,1,0,34,33
1656223330840,MATH 10B,B01,083739,Sinha; Shubham,11,0,30,19
1656223336874,MATH 18,A01,083743,Cinel; Cameron Alexander,7,0,30,23
1656223336874,MATH 18,A02,083744,Cinel; Cameron Alexander,9,0,30,21
1656223336874,MATH 18,A03,083745,Cinel; Cameron Alexander,5,0,30,25
1656223336874,MATH 18,B01,083748,Rideout; David Porter,1,0,36,35
1656223336874,MATH 18,B02,083749,Rideout; David Porter,0,0,36,36
1656223336874,MATH 18,B03,083750,Rideout; David Porter,0,0,36,36
1656223336874,MATH 18,B04,083751,Rideout; David Porter,0,1,36,36
1656223336874,MATH 18,B05,093473,Rideout; David Porter,0,0,36,36
1656223336874,MATH 18,B06,093474,Rideout; David Porter,3,0,36,33
1656223342898,MATH 20A,A01,083754,Zheng; Zequn,11,0,40,29
1656223348924,MATH 20B,A01,083756,Briones; Jor-el Thomas Caparas,0,0,36,36
1656223348924,MATH 20B,A02,083757,Briones; Jor-el Thomas Caparas,0,0,36,36
1656223348924,MATH 20B,A03,093475,Staff,0,0,36,36
1656223354947,MATH 20C,A01,083760,Briones; Jor-el Thomas Caparas,0,0,35,35
1656223354947,MATH 20C,A02,083761,Briones; Jor-el Thomas Caparas,9,1,35,26
1656223354947,MATH 20C,A03,093476,Staff,0,0,35,35
1656223354947,MATH 20C,B01,083762,Bach; Quang Tran,1,0,30,29
1656223360974,MATH 20D,A01,083765,Tran; Brian Kha,1,0,30,29
1656223360974,MATH 20D,A02,083766,Tran; Brian Kha,0,1,30,30
1656223360974,MATH 20D,A03,083767,Tran; Brian Kha,2,0,30,28
1656223367000,MATH 20E,A01,083771,Ganguly; Soumya,3,0,32,29
1656223367000,MATH 20E,A02,083772,Ganguly; Soumya,0,0,32,32
1656223367000,MATH 20E,B01,083773,Ciotti; Benjamin,16,0,35,19
1656223367000,MATH 20E,B02,083774,Ciotti; Benjamin,15,0,35,20
1656223373037,MATH 103A,A01,083777,Greenfeld; Be'Eri,1,0,36,35
1656223373037,MATH 103A,A02,083778,Greenfeld; Be'Eri,1,0,36,35
1656223373037,MATH 103A,A03,093561,Staff,5,0,36,31
1656223373037,MATH 103A,B01,083779,Greenfeld; Be'Eri,8,0,36,28
1656223373037,MATH 103A,B02,083780,Greenfeld; Be'Eri,1,0,36,35
1656223373037,MATH 103A,B03,093562,Staff,0,0,36,36
1656223379062,MATH 105,A01,085443,Carter; Anne Toulson,4,0,35,31
1656223379062,MATH 105,A02,093477,Staff,14,0,35,21
1656223385097,MATH 109,A01,083213,Ganzberger; Geoffrey Michael,0,0,34,34
1656223385097,MATH 109,A02,083214,Ganzberger; Geoffrey Michael,0,0,34,34
1656223385097,MATH 109,A03,093478,Staff,1,0,34,33
1656223385097,MATH 109,B01,083215,Ganzberger; Geoffrey Michael,4,0,32,28
1656223385097,MATH 109,B02,083216,Ganzberger; Geoffrey Michael,1,0,32,31
1656223385097,MATH 109,B03,093479,Staff,4,0,32,28
1656223391131,MATH 142A,A01,083219,Chow; Bennett,2,0,32,30
1656223391131,MATH 142A,A02,083220,Chow; Bennett,8,0,32,24
1656223391131,MATH 142A,A03,093480,Staff,5,0,32,27
1656223391131,MATH 142A,B03,093481,Staff,3,0,32,29
1656223391131,MATH 142A,B04,093558,Staff,6,0,32,26
1656223391131,MATH 142A,B05,093559,Staff,1,0,32,31
1656223397154,MATH 193A,A01,083224,Rotar; Vladimir,0,1,34,34
1656223397154,MATH 193A,A02,083225,Rotar; Vladimir,0,0,34,34
1656223397154,MATH 193A,A03,083781,Rotar; Vladimir,0,0,34,34
1656223397154,MATH 193A,A04,083782,Rotar; Vladimir,6,0,34,28
1656223397154,MATH 193A,A05,093482,Rotar; Vladimir,0,0,34,34
1656223403185,MATH 197,001,091859,McAuley; Julian John,9999,0,9999,0
1656223403185,MATH 197,002,095566,Kedlaya; Kiran S.,9997,0,9999,2
1656223403185,MATH 197,003,095567,Xiao; Ming,9999,0,9999,0
1656223403185,MATH 197,004,095571,Perols; Johan Lars,9998,0,9999,1
1656223410250,COGS 9,A01,083615,Shannon; Kyle Michael,3,0,75,72
1656223416273,COGS 11,A01,083617,Boyle; Mary E. T.,14,0,48,34
1656223422299,COGS 13,A01,083071,Bastos; Amalia Pinkusfeld,4,0,71,67
1656223428325,COGS 14A,A01,092681,Semenuks; Arturs,0,12,100,100
1656223434350,COGS 14B,A01,083073,Cheng; Tzu-Han,7,0,63,56
1656223440379,COGS 17,A01,092677,Semenuks; Arturs,7,0,81,74
1656223446410,COGS 100,A01,083619,Allen; Michael Gordon,2,0,70,68
1656223452433,COGS 101A,A01,083621,Davis; Joshua Daniel,4,0,68,64
1656223458456,COGS 101B,A01,091572,Allen; Michael Gordon,4,0,65,61
1656223464483,COGS 101C,A01,083625,Delgado; Tania,10,0,35,25
1656223470506,COGS 107A,A01,083627,Boyle; Mary E. T.,0,0,60,60
1656223476533,COGS 118A,A01,083075,Gupta; Anjum,8,0,76,68
1656223482561,CSE 3,A50,083646,Miranda; Gregory Joseph,18,0,50,32
1656223488592,CSE 8A,A50,083650,Miranda; Gregory Joseph,2,2,56,54
1656223494616,CSE 11,A01,083080,Cao; Yingjun,0,49,40,40
1656223500642,CSE 12,A01,083652,Krause-Levy; Sophia Louisa,5,1,120,115
1656223506667,CSE 15L,A01,083654,Morris; Justin Loren,2,0,50,48
1656223506667,CSE 15L,A02,083655,Morris; Justin Loren,4,0,50,46
1656223512692,CSE 20,A01,083657,Tran; Khoa Dang,30,0,80,50
1656223518720,CSE 21,A01,095574,Bach; Quang Tran,23,0,48,25
1656223524744,CSE 30,A01,083084,Eldon; John,2,6,80,78
1656223524744,CSE 30,B01,095061,Bhaskar; Nishant,0,1,50,50
1656223530772,CSE 100,A01,083659,Cao; Yingjun,1,18,70,69
1656223536795,CSE 134B,A01,083661,Powell; Thomas Allan,5,0,100,95
1656223542818,CSE 140,A01,083663,Gungor; Onat,9,0,85,76
1656223548845,CSE 140L,A01,083088,Eldon; John,8,0,100,92
1656223554866,CSE 175,A01,083665,Kumar; Rakesh,0,0,25,25
1656223560890,CSE 190,A00,092507,Dubnov; Shlomo,3,0,20,17
1656223566933,ECE 45,A01,083139,Congero; Spencer William,1,0,75,74
1656223572958,ECE 65,A50,083695,Saad; Andrew S,9,0,30,21
1656223572958,ECE 65,A51,095125,Staff,23,0,26,3
1656223578982,ECE 109,A01,091882,Touri; Behrouz,0,1,70,70
1656223585005,ECE 180,A00,083140,Abi Samra; Nicholas Camill,1,0,30,29
1656223585005,ECE 180,B00,083141,Abi Samra; Nicholas Camill,0,4,30,30
1656223591034,MATH 10A,A01,083735,Patchell; Gregory David,0,0,30,30
1656223591034,MATH 10A,A02,083736,Patchell; Gregory David,22,0,30,8
1656223591034,MATH 10A,A03,083737,Patchell; Gregory David,16,0,30,14
1656223597058,MATH 10B,A01,083207,Lim; Seonhee,0,0,34,34
1656223597058,MATH 10B,A02,083208,Lim; Seonhee,7,0,35,28
1656223597058,MATH 10B,A03,093472,Staff,1,0,34,33
1656223597058,MATH 10B,B01,083739,Sinha; Shubham,11,0,30,19
1656223603084,MATH 18,A01,083743,Cinel; Cameron Alexander,7,0,30,23
1656223603084,MATH 18,A02,083744,Cinel; Cameron Alexander,9,0,30,21
1656223603084,MATH 18,A03,083745,Cinel; Cameron Alexander,5,0,30,25
1656223603084,MATH 18,B01,083748,Rideout; David Porter,1,0,36,35
1656223603084,MATH 18,B02,083749,Rideout; David Porter,0,0,36,36
1656223603084,MATH 18,B03,083750,Rideout; David Porter,0,0,36,36
1656223603084,MATH 18,B04,083751,Rideout; David Porter,0,1,36,36
1656223603084,MATH 18,B05,093473,Rideout; David Porter,0,0,36,36
1656223603084,MATH 18,B06,093474,Rideout; David Porter,3,0,36,33
1656223609112,MATH 20A,A01,083754,Zheng; Zequn,11,0,40,29
1656223615137,MATH 20B,A01,083756,Briones; Jor-el Thomas Caparas,0,0,36,36
1656223615137,MATH 20B,A02,083757,Briones; Jor-el Thomas Caparas,0,0,36,36
1656223615137,MATH 20B,A03,093475,Staff,0,0,36,36
1656223621161,MATH 20C,A01,083760,Briones; Jor-el Thomas Caparas,0,0,35,35
1656223621161,MATH 20C,A02,083761,Briones; Jor-el Thomas Caparas,9,1,35,26
1656223621161,MATH 20C,A03,093476,Staff,0,0,35,35
1656223621161,MATH 20C,B01,083762,Bach; Quang Tran,1,0,30,29
1656223627190,MATH 20D,A01,083765,Tran; Brian Kha,1,0,30,29
1656223627190,MATH 20D,A02,083766,Tran; Brian Kha,0,1,30,30
1656223627190,MATH 20D,A03,083767,Tran; Brian Kha,2,0,30,28
1656223633213,MATH 20E,A01,083771,Ganguly; Soumya,3,0,32,29
1656223633213,MATH 20E,A02,083772,Ganguly; Soumya,0,0,32,32
1656223633213,MATH 20E,B01,083773,Ciotti; Benjamin,16,0,35,19
1656223633213,MATH 20E,B02,083774,Ciotti; Benjamin,15,0,35,20
1656223639238,MATH 103A,A01,083777,Greenfeld; Be'Eri,1,0,36,35
1656223639238,MATH 103A,A02,083778,Greenfeld; Be'Eri,1,0,36,35
1656223639238,MATH 103A,A03,093561,Staff,5,0,36,31
1656223639238,MATH 103A,B01,083779,Greenfeld; Be'Eri,8,0,36,28
1656223639238,MATH 103A,B02,083780,Greenfeld; Be'Eri,1,0,36,35
1656223639238,MATH 103A,B03,093562,Staff,0,0,36,36
1656223645260,MATH 105,A01,085443,Carter; Anne Toulson,4,0,35,31
1656223645260,MATH 105,A02,093477,Staff,14,0,35,21
1656223651294,MATH 109,A01,083213,Ganzberger; Geoffrey Michael,0,0,34,34
1656223651294,MATH 109,A02,083214,Ganzberger; Geoffrey Michael,0,0,34,34
1656223651294,MATH 109,A03,093478,Staff,1,0,34,33
1656223651294,MATH 109,B01,083215,Ganzberger; Geoffrey Michael,4,0,32,28
1656223651294,MATH 109,B02,083216,Ganzberger; Geoffrey Michael,1,0,32,31
1656223651294,MATH 109,B03,093479,Staff,4,0,32,28
1656223657323,MATH 142A,A01,083219,Chow; Bennett,2,0,32,30
1656223657323,MATH 142A,A02,083220,Chow; Bennett,8,0,32,24
1656223657323,MATH 142A,A03,093480,Staff,5,0,32,27
1656223657323,MATH 142A,B03,093481,Staff,3,0,32,29
1656223657323,MATH 142A,B04,093558,Staff,6,0,32,26
1656223657323,MATH 142A,B05,093559,Staff,1,0,32,31
1656223663349,MATH 193A,A01,083224,Rotar; Vladimir,0,1,34,34
1656223663349,MATH 193A,A02,083225,Rotar; Vladimir,0,0,34,34
1656223663349,MATH 193A,A03,083781,Rotar; Vladimir,0,0,34,34
1656223663349,MATH 193A,A04,083782,Rotar; Vladimir,6,0,34,28
1656223663349,MATH 193A,A05,093482,Rotar; Vladimir,0,0,34,34
1656223669370,MATH 197,001,091859,McAuley; Julian John,9999,0,9999,0
1656223669370,MATH 197,002,095566,Kedlaya; Kiran S.,9997,0,9999,2
1656223669370,MATH 197,003,095567,Xiao; Ming,9999,0,9999,0
1656223669370,MATH 197,004,095571,Perols; Johan Lars,9998,0,9999,1
1656223676417,COGS 9,A01,083615,Shannon; Kyle Michael,3,0,75,72
1656223682442,COGS 11,A01,083617,Boyle; Mary E. T.,14,0,48,34
1656223688473,COGS 13,A01,083071,Bastos; Amalia Pinkusfeld,4,0,71,67
1656223694497,COGS 14A,A01,092681,Semenuks; Arturs,0,12,100,100
1656223700523,COGS 14B,A01,083073,Cheng; Tzu-Han,7,0,63,56
1656223706545,COGS 17,A01,092677,Semenuks; Arturs,7,0,81,74
1656223712575,COGS 100,A01,083619,Allen; Michael Gordon,2,0,70,68
1656223718598,COGS 101A,A01,083621,Davis; Joshua Daniel,4,0,68,64
1656223724622,COGS 101B,A01,091572,Allen; Michael Gordon,4,0,65,61
1656223730645,COGS 101C,A01,083625,Delgado; Tania,10,0,35,25
1656223736669,COGS 107A,A01,083627,Boyle; Mary E. T.,0,0,60,60
1656223742696,COGS 118A,A01,083075,Gupta; Anjum,8,0,76,68
1656223748720,CSE 3,A50,083646,Miranda; Gregory Joseph,18,0,50,32
1656223754745,CSE 8A,A50,083650,Miranda; Gregory Joseph,2,2,56,54
1656223760769,CSE 11,A01,083080,Cao; Yingjun,0,49,40,40
1656223766796,CSE 12,A01,083652,Krause-Levy; Sophia Louisa,5,1,120,115
1656223772819,CSE 15L,A01,083654,Morris; Justin Loren,2,0,50,48
1656223772819,CSE 15L,A02,083655,Morris; Justin Loren,4,0,50,46
1656223778843,CSE 20,A01,083657,Tran; Khoa Dang,30,0,80,50
1656223784869,CSE 21,A01,095574,Bach; Quang Tran,23,0,48,25
1656223790898,CSE 30,A01,083084,Eldon; John,2,6,80,78
1656223790898,CSE 30,B01,095061,Bhaskar; Nishant,0,1,50,50
1656223796921,CSE 100,A01,083659,Cao; Yingjun,1,18,70,69
1656223802947,CSE 134B,A01,083661,Powell; Thomas Allan,5,0,100,95
1656223808971,CSE 140,A01,083663,Gungor; Onat,9,0,85,76
1656223814998,CSE 140L,A01,083088,Eldon; John,8,0,100,92
1656223821025,CSE 175,A01,083665,Kumar; Rakesh,0,0,25,25
1656223827051,CSE 190,A00,092507,Dubnov; Shlomo,3,0,20,17
1656223833078,ECE 45,A01,083139,Congero; Spencer William,1,0,75,74
1656223839105,ECE 65,A50,083695,Saad; Andrew S,9,0,30,21
1656223839105,ECE 65,A51,095125,Staff,23,0,26,3
1656223845128,ECE 109,A01,091882,Touri; Behrouz,0,1,70,70
1656223851152,ECE 180,A00,083140,Abi Samra; Nicholas Camill,1,0,30,29
1656223851152,ECE 180,B00,083141,Abi Samra; Nicholas Camill,0,4,30,30
1656223857176,MATH 10A,A01,083735,Patchell; Gregory David,0,0,30,30
1656223857176,MATH 10A,A02,083736,Patchell; Gregory David,22,0,30,8
1656223857176,MATH 10A,A03,083737,Patchell; Gregory David,16,0,30,14
1656223863205,MATH 10B,A01,083207,Lim; Seonhee,0,0,34,34
1656223863205,MATH 10B,A02,083208,Lim; Seonhee,7,0,35,28
1656223863205,MATH 10B,A03,093472,Staff,1,0,34,33
1656223863205,MATH 10B,B01,083739,Sinha; Shubham,11,0,30,19
1656223869230,MATH 18,A01,083743,Cinel; Cameron Alexander,7,0,30,23
1656223869230,MATH 18,A02,083744,Cinel; Cameron Alexander,9,0,30,21
1656223869230,MATH 18,A03,083745,Cinel; Cameron Alexander,5,0,30,25
1656223869230,MATH 18,B01,083748,Rideout; David Porter,1,0,36,35
1656223869230,MATH 18,B02,083749,Rideout; David Porter,0,0,36,36
1656223869230,MATH 18,B03,083750,Rideout; David Porter,0,0,36,36
1656223869230,MATH 18,B04,083751,Rideout; David Porter,0,1,36,36
1656223869230,MATH 18,B05,093473,Rideout; David Porter,0,0,36,36
1656223869230,MATH 18,B06,093474,Rideout; David Porter,3,0,36,33
1656223875254,MATH 20A,A01,083754,Zheng; Zequn,11,0,40,29
1656223881277,MATH 20B,A01,083756,Briones; Jor-el Thomas Caparas,0,0,36,36
1656223881277,MATH 20B,A02,083757,Briones; Jor-el Thomas Caparas,0,0,36,36
1656223881277,MATH 20B,A03,093475,Staff,0,0,36,36
1656223887371,MATH 20C,A01,083760,Briones; Jor-el Thomas Caparas,0,0,35,35
1656223887371,MATH 20C,A02,083761,Briones; Jor-el Thomas Caparas,9,1,35,26
1656223887371,MATH 20C,A03,093476,Staff,0,0,35,35
1656223887371,MATH 20C,B01,083762,Bach; Quang Tran,1,0,30,29
1656223893401,MATH 20D,A01,083765,Tran; Brian Kha,1,0,30,29
1656223893401,MATH 20D,A02,083766,Tran; Brian Kha,0,1,30,30
1656223893401,MATH 20D,A03,083767,Tran; Brian Kha,2,0,30,28
1656223899425,MATH 20E,A01,083771,Ganguly; Soumya,3,0,32,29
1656223899425,MATH 20E,A02,083772,Ganguly; Soumya,0,0,32,32
1656223899425,MATH 20E,B01,083773,Ciotti; Benjamin,16,0,35,19
1656223899425,MATH 20E,B02,083774,Ciotti; Benjamin,15,0,35,20
1656223905448,MATH 103A,A01,083777,Greenfeld; Be'Eri,1,0,36,35
1656223905448,MATH 103A,A02,083778,Greenfeld; Be'Eri,1,0,36,35
1656223905448,MATH 103A,A03,093561,Staff,5,0,36,31
1656223905448,MATH 103A,B01,083779,Greenfeld; Be'Eri,8,0,36,28
1656223905448,MATH 103A,B02,083780,Greenfeld; Be'Eri,1,0,36,35
1656223905448,MATH 103A,B03,093562,Staff,0,0,36,36
1656223911473,MATH 105,A01,085443,Carter; Anne Toulson,4,0,35,31
1656223911473,MATH 105,A02,093477,Staff,14,0,35,21
1656223917504,MATH 109,A01,083213,Ganzberger; Geoffrey Michael,0,0,34,34
1656223917504,MATH 109,A02,083214,Ganzberger; Geoffrey Michael,0,0,34,34
1656223917504,MATH 109,A03,093478,Staff,1,0,34,33
1656223917504,MATH 109,B01,083215,Ganzberger; Geoffrey Michael,4,0,32,28
1656223917504,MATH 109,B02,083216,Ganzberger; Geoffrey Michael,1,0,32,31
1656223917504,MATH 109,B03,093479,Staff,4,0,32,28
1656223923529,MATH 142A,A01,083219,Chow; Bennett,2,0,32,30
1656223923529,MATH 142A,A02,083220,Chow; Bennett,8,0,32,24
1656223923529,MATH 142A,A03,093480,Staff,5,0,32,27
1656223923529,MATH 142A,B03,093481,Staff,3,0,32,29
1656223923529,MATH 142A,B04,093558,Staff,6,0,32,26
1656223923529,MATH 142A,B05,093559,Staff,1,0,32,31
1656223929557,MATH 193A,A01,083224,Rotar; Vladimir,0,1,34,34
1656223929557,MATH 193A,A02,083225,Rotar; Vladimir,0,0,34,34
1656223929557,MATH 193A,A03,083781,Rotar; Vladimir,0,0,34,34
1656223929557,MATH 193A,A04,083782,Rotar; Vladimir,6,0,34,28
1656223929557,MATH 193A,A05,093482,Rotar; Vladimir,0,0,34,34
1656223935580,MATH 197,001,091859,McAuley; Julian John,9999,0,9999,0
1656223935580,MATH 197,002,095566,Kedlaya; Kiran S.,9997,0,9999,2
1656223935580,MATH 197,003,095567,Xiao; Ming,9999,0,9999,0
1656223935580,MATH 197,004,095571,Perols; Johan Lars,9998,0,9999,1
1656223942629,COGS 9,A01,083615,Shannon; Kyle Michael,3,0,75,72
1656223948658,COGS 11,A01,083617,Boyle; Mary E. T.,14,0,48,34
1656223954681,COGS 13,A01,083071,Bastos; Amalia Pinkusfeld,4,0,71,67
1656223960706,COGS 14A,A01,092681,Semenuks; Arturs,0,12,100,100
1656223966730,COGS 14B,A01,083073,Cheng; Tzu-Han,7,0,63,56
1656223972757,COGS 17,A01,092677,Semenuks; Arturs,7,0,81,74
1656223978780,COGS 100,A01,083619,Allen; Michael Gordon,2,0,70,68
1656223984804,COGS 101A,A01,083621,Davis; Joshua Daniel,4,0,68,64
1656223990828,COGS 101B,A01,091572,Allen; Michael Gordon,4,0,65,61
1656223996854,COGS 101C,A01,083625,Delgado; Tania,10,0,35,25
1656224002881,COGS 107A,A01,083627,Boyle; Mary E. T.,0,0,60,60
1656224008904,COGS 118A,A01,083075,Gupta; Anjum,8,0,76,68
1656224014932,CSE 3,A50,083646,Miranda; Gregory Joseph,18,0,50,32
1656224020956,CSE 8A,A50,083650,Miranda; Gregory Joseph,2,2,56,54
1656224026980,CSE 11,A01,083080,Cao; Yingjun,0,49,40,40
1656224033009,CSE 12,A01,083652,Krause-Levy; Sophia Louisa,5,1,120,115
1656224039033,CSE 15L,A01,083654,Morris; Justin Loren,2,0,50,48
1656224039033,CSE 15L,A02,083655,Morris; Justin Loren,4,0,50,46
1656224045060,CSE 20,A01,083657,Tran; Khoa Dang,30,0,80,50
1656224051087,CSE 21,A01,095574,Bach; Quang Tran,23,0,48,25
1656224057116,CSE 30,A01,083084,Eldon; John,2,6,80,78
1656224057116,CSE 30,B01,095061,Bhaskar; Nishant,0,1,50,50
1656224063142,CSE 100,A01,083659,Cao; Yingjun,1,18,70,69
1656224069169,CSE 134B,A01,083661,Powell; Thomas Allan,5,0,100,95
1656224075198,CSE 140,A01,083663,Gungor; Onat,9,0,85,76
1656224081221,CSE 140L,A01,083088,Eldon; John,8,0,100,92
1656224087246,CSE 175,A01,083665,Kumar; Rakesh,0,0,25,25
1656224093272,CSE 190,A00,092507,Dubnov; Shlomo,3,0,20,17
1656224099299,ECE 45,A01,083139,Congero; Spencer William,1,0,75,74
1656224105325,ECE 65,A50,083695,Saad; Andrew S,9,0,30,21
1656224105325,ECE 65,A51,095125,Staff,23,0,26,3
1656224111347,ECE 109,A01,091882,Touri; Behrouz,0,1,70,70
1656224117375,ECE 180,A00,083140,Abi Samra; Nicholas Camill,1,0,30,29
1656224117375,ECE 180,B00,083141,Abi Samra; Nicholas Camill,0,4,30,30
1656224123401,MATH 10A,A01,083735,Patchell; Gregory David,0,0,30,30
1656224123401,MATH 10A,A02,083736,Patchell; Gregory David,22,0,30,8
1656224123401,MATH 10A,A03,083737,Patchell; Gregory David,16,0,30,14
1656224129427,MATH 10B,A01,083207,Lim; Seonhee,0,0,34,34
1656224129427,MATH 10B,A02,083208,Lim; Seonhee,7,0,35,28
1656224129427,MATH 10B,A03,093472,Staff,1,0,34,33
1656224129427,MATH 10B,B01,083739,Sinha; Shubham,11,0,30,19
1656224135459,MATH 18,A01,083743,Cinel; Cameron Alexander,7,0,30,23
1656224135459,MATH 18,A02,083744,Cinel; Cameron Alexander,9,0,30,21
1656224135459,MATH 18,A03,083745,Cinel; Cameron Alexander,5,0,30,25
1656224135459,MATH 18,B01,083748,Rideout; David Porter,1,0,36,35
1656224135459,MATH 18,B02,083749,Rideout; David Porter,0,0,36,36
1656224135459,MATH 18,B03,083750,Rideout; David Porter,0,0,36,36
1656224135459,MATH 18,B04,083751,Rideout; David Porter,0,1,36,36
1656224135459,MATH 18,B05,093473,Rideout; David Porter,0,0,36,36
1656224135459,MATH 18,B06,093474,Rideout; David Porter,3,0,36,33
1656224141482,MATH 20A,A01,083754,Zheng; Zequn,11,0,40,29
1656224147509,MATH 20B,A01,083756,Briones; Jor-el Thomas Caparas,0,0,36,36
1656224147509,MATH 20B,A02,083757,Briones; Jor-el Thomas Caparas,0,0,36,36
1656224147509,MATH 20B,A03,093475,Staff,0,0,36,36
1656224153533,MATH 20C,A01,083760,Briones; Jor-el Thomas Caparas,0,0,35,35
1656224153533,MATH 20C,A02,083761,Briones; Jor-el Thomas Caparas,9,1,35,26
1656224153533,MATH 20C,A03,093476,Staff,0,0,35,35
1656224153533,MATH 20C,B01,083762,Bach; Quang Tran,1,0,30,29
1656224159560,MATH 20D,A01,083765,Tran; Brian Kha,1,0,30,29
1656224159560,MATH 20D,A02,083766,Tran; Brian Kha,0,1,30,30
1656224159560,MATH 20D,A03,083767,Tran; Brian Kha,2,0,30,28
1656224165590,MATH 20E,A01,083771,Ganguly; Soumya,3,0,32,29
1656224165590,MATH 20E,A02,083772,Ganguly; Soumya,0,0,32,32
1656224165590,MATH 20E,B01,083773,Ciotti; Benjamin,16,0,35,19
1656224165590,MATH 20E,B02,083774,Ciotti; Benjamin,15,0,35,20
1656224171620,MATH 103A,A01,083777,Greenfeld; Be'Eri,1,0,36,35
1656224171620,MATH 103A,A02,083778,Greenfeld; Be'Eri,1,0,36,35
1656224171620,MATH 103A,A03,093561,Staff,5,0,36,31
1656224171620,MATH 103A,B01,083779,Greenfeld; Be'Eri,8,0,36,28
1656224171620,MATH 103A,B02,083780,Greenfeld; Be'Eri,1,0,36,35
1656224171620,MATH 103A,B03,093562,Staff,0,0,36,36
1656224177643,MATH 105,A01,085443,Carter; Anne Toulson,4,0,35,31
1656224177643,MATH 105,A02,093477,Staff,14,0,35,21
1656224183673,MATH 109,A01,083213,Ganzberger; Geoffrey Michael,0,0,34,34
1656224183673,MATH 109,A02,083214,Ganzberger; Geoffrey Michael,0,0,34,34
1656224183673,MATH 109,A03,093478,Staff,1,0,34,33
1656224183673,MATH 109,B01,083215,Ganzberger; Geoffrey Michael,4,0,32,28
1656224183673,MATH 109,B02,083216,Ganzberger; Geoffrey Michael,1,0,32,31
1656224183673,MATH 109,B03,093479,Staff,4,0,32,28
1656224189704,MATH 142A,A01,083219,Chow; Bennett,2,0,32,30
1656224189704,MATH 142A,A02,083220,Chow; Bennett,8,0,32,24
1656224189704,MATH 142A,A03,093480,Staff,5,0,32,27
1656224189704,MATH 142A,B03,093481,Staff,3,0,32,29
1656224189704,MATH 142A,B04,093558,Staff,6,0,32,26
1656224189704,MATH 142A,B05,093559,Staff,1,0,32,31
1656224195729,MATH 193A,A01,083224,Rotar; Vladimir,0,1,34,34
1656224195729,MATH 193A,A02,083225,Rotar; Vladimir,0,0,34,34
1656224195729,MATH 193A,A03,083781,Rotar; Vladimir,0,0,34,34
1656224195729,MATH 193A,A04,083782,Rotar; Vladimir,6,0,34,28
1656224195729,MATH 193A,A05,093482,Rotar; Vladimir,0,0,34,34
1656224201754,MATH 197,001,091859,McAuley; Julian John,9999,0,9999,0
1656224201754,MATH 197,002,095566,Kedlaya; Kiran S.,9997,0,9999,2
1656224201754,MATH 197,003,095567,Xiao; Ming,9999,0,9999,0
1656224201754,MATH 197,004,095571,Perols; Johan Lars,9998,0,9999,1
1656224208824,COGS 9,A01,083615,Shannon; Kyle Michael,3,0,75,72
1656224214857,COGS 11,A01,083617,Boyle; Mary E. T.,14,0,48,34
1656224220881,COGS 13,A01,083071,Bastos; Amalia Pinkusfeld,4,0,71,67
1656224226904,COGS 14A,A01,092681,Semenuks; Arturs,0,12,100,100
1656224232932,COGS 14B,A01,083073,Cheng; Tzu-Han,7,0,63,56
1656224238954,COGS 17,A01,092677,Semenuks; Arturs,7,0,81,74
1656224244982,COGS 100,A01,083619,Allen; Michael Gordon,2,0,70,68
1656224251007,COGS 101A,A01,083621,Davis; Joshua Daniel,4,0,68,64
1656224257031,COGS 101B,A01,091572,Allen; Michael Gordon,4,0,65,61
1656224263056,COGS 101C,A01,083625,Delgado; Tania,10,0,35,25
1656224269082,COGS 107A,A01,083627,Boyle; Mary E. T.,0,0,60,60
1656224275110,COGS 118A,A01,083075,Gupta; Anjum,8,0,76,68
1656224281137,CSE 3,A50,083646,Miranda; Gregory Joseph,18,0,50,32
1656224287160,CSE 8A,A50,083650,Miranda; Gregory Joseph,2,2,56,54
1656224293193,CSE 11,A01,083080,Cao; Yingjun,0,49,40,40
1656224299216,CSE 12,A01,083652,Krause-Levy; Sophia Louisa,5,1,120,115
1656224305239,CSE 15L,A01,083654,Morris; Justin Loren,2,0,50,48
1656224305239,CSE 15L,A02,083655,Morris; Justin Loren,4,0,50,46
1656224311282,CSE 20,A01,083657,Tran; Khoa Dang,30,0,80,50
1656224317308,CSE 21,A01,095574,Bach; Quang Tran,23,0,48,25
1656224323332,CSE 30,A01,083084,Eldon; John,2,6,80,78
1656224323332,CSE 30,B01,095061,Bhaskar; Nishant,0,1,50,50
1656224329357,CSE 100,A01,083659,Cao; Yingjun,1,18,70,69
1656224335384,CSE 134B,A01,083661,Powell; Thomas Allan,5,0,100,95
1656224341410,CSE 140,A01,083663,Gungor; Onat,9,0,85,76
1656224347433,CSE 140L,A01,083088,Eldon; John,8,0,100,92
1656224353482,CSE 175,A01,083665,Kumar; Rakesh,0,0,25,25
1656224359507,CSE 190,A00,092507,Dubnov; Shlomo,3,0,20,17
1656224365530,ECE 45,A01,083139,Congero; Spencer William,1,0,75,74
1656224371558,ECE 65,A50,083695,Saad; Andrew S,9,0,30,21
1656224371558,ECE 65,A51,095125,Staff,23,0,26,3
1656224377583,ECE 109,A01,091882,Touri; Behrouz,0,1,70,70
1656224383613,ECE 180,A00,083140,Abi Samra; Nicholas Camill,1,0,30,29
1656224383613,ECE 180,B00,083141,Abi Samra; Nicholas Camill,0,4,30,30
1656224389638,MATH 10A,A01,083735,Patchell; Gregory David,0,0,30,30
1656224389638,MATH 10A,A02,083736,Patchell; Gregory David,22,0,30,8
1656224389638,MATH 10A,A03,083737,Patchell; Gregory David,16,0,30,14
1656224395663,MATH 10B,A01,083207,Lim; Seonhee,0,0,34,34
1656224395663,MATH 10B,A02,083208,Lim; Seonhee,7,0,35,28
1656224395663,MATH 10B,A03,093472,Staff,1,0,34,33
1656224395663,MATH 10B,B01,083739,Sinha; Shubham,11,0,30,19
1656224401700,MATH 18,A01,083743,Cinel; Cameron Alexander,7,0,30,23
1656224401700,MATH 18,A02,083744,Cinel; Cameron Alexander,9,0,30,21
1656224401700,MATH 18,A03,083745,Cinel; Cameron Alexander,5,0,30,25
1656224401700,MATH 18,B01,083748,Rideout; David Porter,1,0,36,35
1656224401700,MATH 18,B02,083749,Rideout; David Porter,0,0,36,36
1656224401700,MATH 18,B03,083750,Rideout; David Porter,0,0,36,36
1656224401700,MATH 18,B04,083751,Rideout; David Porter,0,1,36,36
1656224401700,MATH 18,B05,093473,Rideout; David Porter,0,0,36,36
1656224401700,MATH 18,B06,093474,Rideout; David Porter,3,0,36,33
1656224407726,MATH 20A,A01,083754,Zheng; Zequn,11,0,40,29
1656224413749,MATH 20B,A01,083756,Briones; Jor-el Thomas Caparas,0,0,36,36
1656224413749,MATH 20B,A02,083757,Briones; Jor-el Thomas Caparas,0,0,36,36
1656224413749,MATH 20B,A03,093475,Staff,0,0,36,36
1656224419778,MATH 20C,A01,083760,Briones; Jor-el Thomas Caparas,0,0,35,35
1656224419778,MATH 20C,A02,083761,Briones; Jor-el Thomas Caparas,9,1,35,26
1656224419778,MATH 20C,A03,093476,Staff,0,0,35,35
1656224419778,MATH 20C,B01,083762,Bach; Quang Tran,1,0,30,29
1656224425801,MATH 20D,A01,083765,Tran; Brian Kha,1,0,30,29
1656224425801,MATH 20D,A02,083766,Tran; Brian Kha,0,1,30,30
1656224425801,MATH 20D,A03,083767,Tran; Brian Kha,2,0,30,28
1656224431834,MATH 20E,A01,083771,Ganguly; Soumya,3,0,32,29
1656224431834,MATH 20E,A02,083772,Ganguly; Soumya,0,0,32,32
1656224431834,MATH 20E,B01,083773,Ciotti; Benjamin,16,0,35,19
1656224431834,MATH 20E,B02,083774,Ciotti; Benjamin,15,0,35,20
1656224437860,MATH 103A,A01,083777,Greenfeld; Be'Eri,1,0,36,35
1656224437860,MATH 103A,A02,083778,Greenfeld; Be'Eri,1,0,36,35
1656224437860,MATH 103A,A03,093561,Staff,5,0,36,31
1656224437860,MATH 103A,B01,083779,Greenfeld; Be'Eri,8,0,36,28
1656224437860,MATH 103A,B02,083780,Greenfeld; Be'Eri,1,0,36,35
1656224437860,MATH 103A,B03,093562,Staff,0,0,36,36
1656224443885,MATH 105,A01,085443,Carter; Anne Toulson,4,0,35,31
1656224443885,MATH 105,A02,093477,Staff,14,0,35,21
1656224449909,MATH 109,A01,083213,Ganzberger; Geoffrey Michael,0,0,34,34
1656224449909,MATH 109,A02,083214,Ganzberger; Geoffrey Michael,0,0,34,34
1656224449909,MATH 109,A03,093478,Staff,1,0,34,33
1656224449909,MATH 109,B01,083215,Ganzberger; Geoffrey Michael,4,0,32,28
1656224449909,MATH 109,B02,083216,Ganzberger; Geoffrey Michael,1,0,32,31
1656224449909,MATH 109,B03,093479,Staff,4,0,32,28
1656224455933,MATH 142A,A01,083219,Chow; Bennett,2,0,32,30
1656224455933,MATH 142A,A02,083220,Chow; Bennett,8,0,32,24
1656224455933,MATH 142A,A03,093480,Staff,5,0,32,27
1656224455933,MATH 142A,B03,093481,Staff,3,0,32,29
1656224455933,MATH 142A,B04,093558,Staff,6,0,32,26
1656224455933,MATH 142A,B05,093559,Staff,1,0,32,31
1656224461962,MATH 193A,A01,083224,Rotar; Vladimir,0,1,34,34
1656224461962,MATH 193A,A02,083225,Rotar; Vladimir,0,0,34,34
1656224461962,MATH 193A,A03,083781,Rotar; Vladimir,0,0,34,34
1656224461962,MATH 193A,A04,083782,Rotar; Vladimir,6,0,34,28
1656224461962,MATH 193A,A05,093482,Rotar; Vladimir,0,0,34,34
1656224467988,MATH 197,001,091859,McAuley; Julian John,9999,0,9999,0
1656224467988,MATH 197,002,095566,Kedlaya; Kiran S.,9997,0,9999,2
1656224467988,MATH 197,003,095567,Xiao; Ming,9999,0,9999,0
1656224467988,MATH 197,004,095571,Perols; Johan Lars,9998,0,9999,1
1656224475045,COGS 9,A01,083615,Shannon; Kyle Michael,3,0,75,72
1656224481144,COGS 11,A01,083617,Boyle; Mary E. T.,14,0,48,34
1656224487168,COGS 13,A01,083071,Bastos; Amalia Pinkusfeld,4,0,71,67
1656224493193,COGS 14A,A01,092681,Semenuks; Arturs,0,12,100,100
1656224499216,COGS 14B,A01,083073,Cheng; Tzu-Han,7,0,63,56
1656224505244,COGS 17,A01,092677,Semenuks; Arturs,7,0,81,74
1656224511267,COGS 100,A01,083619,Allen; Michael Gordon,2,0,70,68
1656224517292,COGS 101A,A01,083621,Davis; Joshua Daniel,4,0,68,64
1656224523319,COGS 101B,A01,091572,Allen; Michael Gordon,4,0,65,61
1656224529347,COGS 101C,A01,083625,Delgado; Tania,10,0,35,25
1656224535371,COGS 107A,A01,083627,Boyle; Mary E. T.,0,0,60,60
1656224541404,COGS 118A,A01,083075,Gupta; Anjum,8,0,76,68
1656224547431,CSE 3,A50,083646,Miranda; Gregory Joseph,18,0,50,32
1656224553456,CSE 8A,A50,083650,Miranda; Gregory Joseph,2,2,56,54
1656224559479,CSE 11,A01,083080,Cao; Yingjun,0,49,40,40
1656224565502,CSE 12,A01,083652,Krause-Levy; Sophia Louisa,5,1,120,115
1656224571528,CSE 15L,A01,083654,Morris; Justin Loren,2,0,50,48
1656224571528,CSE 15L,A02,083655,Morris; Justin Loren,4,0,50,46
1656224577552,CSE 20,A01,083657,Tran; Khoa Dang,30,0,80,50
1656224583578,CSE 21,A01,095574,Bach; Quang Tran,23,0,48,25
1656224589601,CSE 30,A01,083084,Eldon; John,2,6,80,78
1656224589601,CSE 30,B01,095061,Bhaskar; Nishant,0,1,50,50
1656224595627,CSE 100,A01,083659,Cao; Yingjun,1,18,70,69
1656224601654,CSE 134B,A01,083661,Powell; Thomas Allan,5,0,100,95
1656224607677,CSE 140,A01,083663,Gungor; Onat,9,0,85,76
1656224613704,CSE 140L,A01,083088,Eldon; John,8,0,100,92
1656224619727,CSE 175,A01,083665,Kumar; Rakesh,0,0,25,25
1656224625749,CSE 190,A00,092507,Dubnov; Shlomo,3,0,20,17
1656224631777,ECE 45,A01,083139,Congero; Spencer William,1,0,75,74
1656224637805,ECE 65,A50,083695,Saad; Andrew S,9,0,30,21
1656224637805,ECE 65,A51,095125,Staff,23,0,26,3
1656224643836,ECE 109,A01,091882,Touri; Behrouz,0,1,70,70
1656224649864,ECE 180,A00,083140,Abi Samra; Nicholas Camill,1,0,30,29
1656224649864,ECE 180,B00,083141,Abi Samra; Nicholas Camill,0,4,30,30
1656224655890,MATH 10A,A01,083735,Patchell; Gregory David,0,0,30,30
1656224655890,MATH 10A,A02,083736,Patchell; Gregory David,22,0,30,8
1656224655890,MATH 10A,A03,083737,Patchell; Gregory David,16,0,30,14
1656224661915,MATH 10B,A01,083207,Lim; Seonhee,0,0,34,34
1656224661915,MATH 10B,A02,083208,Lim; Seonhee,7,0,35,28
1656224661915,MATH 10B,A03,093472,Staff,1,0,34,33
1656224661915,MATH 10B,B01,083739,Sinha; Shubham,11,0,30,19
1656224667947,MATH 18,A01,083743,Cinel; Cameron Alexander,7,0,30,23
1656224667947,MATH 18,A02,083744,Cinel; Cameron Alexander,9,0,30,21
1656224667947,MATH 18,A03,083745,Cinel; Cameron Alexander,5,0,30,25
1656224667947,MATH 18,B01,083748,Rideout; David Porter,1,0,36,35
1656224667947,MATH 18,B02,083749,Rideout; David Porter,0,0,36,36
1656224667947,MATH 18,B03,083750,Rideout; David Porter,0,0,36,36
1656224667947,MATH 18,B04,083751,Rideout; David Porter,0,1,36,36
1656224667947,MATH 18,B05,093473,Rideout; David Porter,0,0,36,36
1656224667947,MATH 18,B06,093474,Rideout; David Porter,3,0,36,33
1656224673973,MATH 20A,A01,083754,Zheng; Zequn,11,0,40,29
1656224679997,MATH 20B,A01,083756,Briones; Jor-el Thomas Caparas,0,0,36,36
1656224679997,MATH 20B,A02,083757,Briones; Jor-el Thomas Caparas,0,0,36,36
1656224679997,MATH 20B,A03,093475,Staff,0,0,36,36
1656224686022,MATH 20C,A01,083760,Briones; Jor-el Thomas Caparas,0,0,35,35
1656224686022,MATH 20C,A02,083761,Briones; Jor-el Thomas Caparas,9,1,35,26
1656224686022,MATH 20C,A03,093476,Staff,0,0,35,35
1656224686022,MATH 20C,B01,083762,Bach; Quang Tran,1,0,30,29
1656224692050,MATH 20D,A01,083765,Tran; Brian Kha,1,0,30,29
1656224692050,MATH 20D,A02,083766,Tran; Brian Kha,0,1,30,30
1656224692050,MATH 20D,A03,083767,Tran; Brian Kha,2,0,30,28
1656224698074,MATH 20E,A01,083771,Ganguly; Soumya,3,0,32,29
1656224698074,MATH 20E,A02,083772,Ganguly; Soumya,0,0,32,32
1656224698074,MATH 20E,B01,083773,Ciotti; Benjamin,16,0,35,19
1656224698074,MATH 20E,B02,083774,Ciotti; Benjamin,15,0,35,20
1656224704100,MATH 103A,A01,083777,Greenfeld; Be'Eri,1,0,36,35
1656224704100,MATH 103A,A02,083778,Greenfeld; Be'Eri,1,0,36,35
1656224704100,MATH 103A,A03,093561,Staff,5,0,36,31
1656224704100,MATH 103A,B01,083779,Greenfeld; Be'Eri,8,0,36,28
1656224704100,MATH 103A,B02,083780,Greenfeld; Be'Eri,1,0,36,35
1656224704100,MATH 103A,B03,093562,Staff,0,0,36,36
1656224710125,MATH 105,A01,085443,Carter; Anne Toulson,4,0,35,31
1656224710125,MATH 105,A02,093477,Staff,14,0,35,21
1656224716149,MATH 109,A01,083213,Ganzberger; Geoffrey Michael,0,0,34,34
1656224716149,MATH 109,A02,083214,Ganzberger; Geoffrey Michael,0,0,34,34
1656224716149,MATH 109,A03,093478,Staff,1,0,34,33
1656224716149,MATH 109,B01,083215,Ganzberger; Geoffrey Michael,4,0,32,28
1656224716149,MATH 109,B02,083216,Ganzberger; Geoffrey Michael,1,0,32,31
1656224716149,MATH 109,B03,093479,Staff,4,0,32,28
1656224722179,MATH 142A,A01,083219,Chow; Bennett,2,0,32,30
1656224722179,MATH 142A,A02,083220,Chow; Bennett,8,0,32,24
1656224722179,MATH 142A,A03,093480,Staff,5,0,32,27
1656224722179,MATH 142A,B03,093481,Staff,3,0,32,29
1656224722179,MATH 142A,B04,093558,Staff,6,0,32,26
1656224722179,MATH 142A,B05,093559,Staff,1,0,32,31
1656224728207,MATH 193A,A01,083224,Rotar; Vladimir,0,1,34,34
1656224728207,MATH 193A,A02,083225,Rotar; Vladimir,0,0,34,34
1656224728207,MATH 193A,A03,083781,Rotar; Vladimir,0,0,34,34
1656224728207,MATH 193A,A04,083782,Rotar; Vladimir,6,0,34,28
1656224728207,MATH 193A,A05,093482,Rotar; Vladimir,0,0,34,34
1656224734231,MATH 197,001,091859,McAuley; Julian John,9999,0,9999,0
1656224734231,MATH 197,002,095566,Kedlaya; Kiran S.,9997,0,9999,2
1656224734231,MATH 197,003,095567,Xiao; Ming,9999,0,9999,0
1656224734231,MATH 197,004,095571,Perols; Johan Lars,9998,0,9999,1
1656224741287,COGS 9,A01,083615,Shannon; Kyle Michael,3,0,75,72
1656224747311,COGS 11,A01,083617,Boyle; Mary E. T.,14,0,48,34
1656224753334,COGS 13,A01,083071,Bastos; Amalia Pinkusfeld,4,0,71,67
1656224759361,COGS 14A,A01,092681,Semenuks; Arturs,0,12,100,100
1656224765383,COGS 14B,A01,083073,Cheng; Tzu-Han,7,0,63,56
1656224771410,COGS 17,A01,092677,Semenuks; Arturs,7,0,81,74
1656224777432,COGS 100,A01,083619,Allen; Michael Gordon,2,0,70,68
1656224783456,COGS 101A,A01,083621,Davis; Joshua Daniel,4,0,68,64
1656224789480,COGS 101B,A01,091572,Allen; Michael Gordon,4,0,65,61
1656224795503,COGS 101C,A01,083625,Delgado; Tania,10,0,35,25
1656224801526,COGS 107A,A01,083627,Boyle; Mary E. T.,0,0,60,60
1656224807549,COGS 118A,A01,083075,Gupta; Anjum,8,0,76,68
1656224813576,CSE 3,A50,083646,Miranda; Gregory Joseph,18,0,50,32
1656224819604,CSE 8A,A50,083650,Miranda; Gregory Joseph,2,2,56,54
1656224825628,CSE 11,A01,083080,Cao; Yingjun,0,49,40,40
1656224831653,CSE 12,A01,083652,Krause-Levy; Sophia Louisa,5,1,120,115
1656224837677,CSE 15L,A01,083654,Morris; Justin Loren,2,0,50,48
1656224837677,CSE 15L,A02,083655,Morris; Justin Loren,4,0,50,46
1656224843700,CSE 20,A01,083657,Tran; Khoa Dang,30,0,80,50
1656224849728,CSE 21,A01,095574,Bach; Quang Tran,23,0,48,25
1656224855754,CSE 30,A01,083084,Eldon; John,2,6,80,78
1656224855754,CSE 30,B01,095061,Bhaskar; Nishant,0,1,50,50
1656224861776,CSE 100,A01,083659,Cao; Yingjun,1,18,70,69
1656224867800,CSE 134B,A01,083661,Powell; Thomas Allan,5,0,100,95
1656224873824,CSE 140,A01,083663,Gungor; Onat,9,0,85,76
1656224879848,CSE 140L,A01,083088,Eldon; John,8,0,100,92
1656224885876,CSE 175,A01,083665,Kumar; Rakesh,0,0,25,25
1656224891899,CSE 190,A00,092507,Dubnov; Shlomo,3,0,20,17
1656224897927,ECE 45,A01,083139,Congero; Spencer William,1,0,75,74
1656224903950,ECE 65,A50,083695,Saad; Andrew S,9,0,30,21
1656224903950,ECE 65,A51,095125,Staff,23,0,26,3
1656224909975,ECE 109,A01,091882,Touri; Behrouz,0,1,70,70
1656224916003,ECE 180,A00,083140,Abi Samra; Nicholas Camill,1,0,30,29
1656224916003,ECE 180,B00,083141,Abi Samra; Nicholas Camill,0,4,30,30
1656224922030,MATH 10A,A01,083735,Patchell; Gregory David,0,0,30,30
1656224922030,MATH 10A,A02,083736,Patchell; Gregory David,22,0,30,8
1656224922030,MATH 10A,A03,083737,Patchell; Gregory David,16,0,30,14
1656224928056,MATH 10B,A01,083207,Lim; Seonhee,0,0,34,34
1656224928056,MATH 10B,A02,083208,Lim; Seonhee,7,0,35,28
1656224928056,MATH 10B,A03,093472,Staff,1,0,34,33
1656224928056,MATH 10B,B01,083739,Sinha; Shubham,11,0,30,19
1656224934081,MATH 18,A01,083743,Cinel; Cameron Alexander,7,0,30,23
1656224934081,MATH 18,A02,083744,Cinel; Cameron Alexander,9,0,30,21
1656224934081,MATH 18,A03,083745,Cinel; Cameron Alexander,5,0,30,25
1656224934081,MATH 18,B01,083748,Rideout; David Porter,1,0,36,35
1656224934081,MATH 18,B02,083749,Rideout; David Porter,0,0,36,36
1656224934081,MATH 18,B03,083750,Rideout; David Porter,0,0,36,36
1656224934081,MATH 18,B04,083751,Rideout; David Porter,0,1,36,36
1656224934081,MATH 18,B05,093473,Rideout; David Porter,0,0,36,36
1656224934081,MATH 18,B06,093474,Rideout; David Porter,3,0,36,33
1656224940108,MATH 20A,A01,083754,Zheng; Zequn,11,0,40,29
1656224946132,MATH 20B,A01,083756,Briones; Jor-el Thomas Caparas,0,0,36,36
1656224946132,MATH 20B,A02,083757,Briones; Jor-el Thomas Caparas,0,0,36,36
1656224946132,MATH 20B,A03,093475,Staff,0,0,36,36
1656224952160,MATH 20C,A01,083760,Briones; Jor-el Thomas Caparas,0,0,35,35
1656224952160,MATH 20C,A02,083761,Briones; Jor-el Thomas Caparas,9,1,35,26
1656224952160,MATH 20C,A03,093476,Staff,0,0,35,35
1656224952160,MATH 20C,B01,083762,Bach; Quang Tran,1,0,30,29
1656224958189,MATH 20D,A01,083765,Tran; Brian Kha,1,0,30,29
1656224958189,MATH 20D,A02,083766,Tran; Brian Kha,0,1,30,30
1656224958189,MATH 20D,A03,083767,Tran; Brian Kha,2,0,30,28
1656224964212,MATH 20E,A01,083771,Ganguly; Soumya,3,0,32,29
1656224964212,MATH 20E,A02,083772,Ganguly; Soumya,0,0,32,32
1656224964212,MATH 20E,B01,083773,Ciotti; Benjamin,16,0,35,19
1656224964212,MATH 20E,B02,083774,Ciotti; Benjamin,15,0,35,20
1656224970235,MATH 103A,A01,083777,Greenfeld; Be'Eri,1,0,36,35
1656224970235,MATH 103A,A02,083778,Greenfeld; Be'Eri,1,0,36,35
1656224970235,MATH 103A,A03,093561,Staff,5,0,36,31
1656224970235,MATH 103A,B01,083779,Greenfeld; Be'Eri,8,0,36,28
1656224970235,MATH 103A,B02,083780,Greenfeld; Be'Eri,1,0,36,35
1656224970235,MATH 103A,B03,093562,Staff,0,0,36,36
1656224976263,MATH 105,A01,085443,Carter; Anne Toulson,4,0,35,31
1656224976263,MATH 105,A02,093477,Staff,14,0,35,21
1656224982292,MATH 109,A01,083213,Ganzberger; Geoffrey Michael,0,0,34,34
1656224982292,MATH 109,A02,083214,Ganzberger; Geoffrey Michael,0,0,34,34
1656224982292,MATH 109,A03,093478,Staff,1,0,34,33
1656224982292,MATH 109,B01,083215,Ganzberger; Geoffrey Michael,4,0,32,28
1656224982292,MATH 109,B02,083216,Ganzberger; Geoffrey Michael,1,0,32,31
1656224982292,MATH 109,B03,093479,Staff,4,0,32,28
1656224988321,MATH 142A,A01,083219,Chow; Bennett,2,0,32,30
1656224988321,MATH 142A,A02,083220,Chow; Bennett,8,0,32,24
1656224988321,MATH 142A,A03,093480,Staff,5,0,32,27
1656224988321,MATH 142A,B03,093481,Staff,3,0,32,29
1656224988321,MATH 142A,B04,093558,Staff,6,0,32,26
1656224988321,MATH 142A,B05,093559,Staff,1,0,32,31
1656224994351,MATH 193A,A01,083224,Rotar; Vladimir,0,1,34,34
1656224994351,MATH 193A,A02,083225,Rotar; Vladimir,0,0,34,34
1656224994351,MATH 193A,A03,083781,Rotar; Vladimir,0,0,34,34
1656224994351,MATH 193A,A04,083782,Rotar; Vladimir,6,0,34,28
1656224994351,MATH 193A,A05,093482,Rotar; Vladimir,0,0,34,34
1656225000379,MATH 197,001,091859,McAuley; Julian John,9999,0,9999,0
1656225000379,MATH 197,002,095566,Kedlaya; Kiran S.,9997,0,9999,2
1656225000379,MATH 197,003,095567,Xiao; Ming,9999,0,9999,0
1656225000379,MATH 197,004,095571,Perols; Johan Lars,9998,0,9999,1
1656225007444,COGS 9,A01,083615,Shannon; Kyle Michael,3,0,75,72
1656225013466,COGS 11,A01,083617,Boyle; Mary E. T.,14,0,48,34
1656225019490,COGS 13,A01,083071,Bastos; Amalia Pinkusfeld,4,0,71,67
1656225025517,COGS 14A,A01,092681,Semenuks; Arturs,0,12,100,100
1656225031543,COGS 14B,A01,083073,Cheng; Tzu-Han,7,0,63,56
1656225037563,COGS 17,A01,092677,Semenuks; Arturs,7,0,81,74
1656225043589,COGS 100,A01,083619,Allen; Michael Gordon,2,0,70,68
1656225049615,COGS 101A,A01,083621,Davis; Joshua Daniel,4,0,68,64
1656225055637,COGS 101B,A01,091572,Allen; Michael Gordon,4,0,65,61
1656225061664,COGS 101C,A01,083625,Delgado; Tania,10,0,35,25
1656225067690,COGS 107A,A01,083627,Boyle; Mary E. T.,0,0,60,60
1656225073714,COGS 118A,A01,083075,Gupta; Anjum,8,0,76,68
1656225079812,CSE 3,A50,083646,Miranda; Gregory Joseph,18,0,50,32
1656225085840,CSE 8A,A50,083650,Miranda; Gregory Joseph,2,2,56,54
1656225091863,CSE 11,A01,083080,Cao; Yingjun,0,49,40,40
1656225097897,CSE 12,A01,083652,Krause-Levy; Sophia Louisa,5,1,120,115
1656225103924,CSE 15L,A01,083654,Morris; Justin Loren,2,0,50,48
1656225103924,CSE 15L,A02,083655,Morris; Justin Loren,4,0,50,46
1656225109948,CSE 20,A01,083657,Tran; Khoa Dang,30,0,80,50
1656225115976,CSE 21,A01,095574,Bach; Quang Tran,23,0,48,25
1656225122005,CSE 30,A01,083084,Eldon; John,2,6,80,78
1656225122005,CSE 30,B01,095061,Bhaskar; Nishant,0,1,50,50
1656225128028,CSE 100,A01,083659,Cao; Yingjun,1,18,70,69
1656225134067,CSE 134B,A01,083661,Powell; Thomas Allan,5,0,100,95
1656225140091,CSE 140,A01,083663,Gungor; Onat,9,0,85,76
1656225146117,CSE 140L,A01,083088,Eldon; John,8,0,100,92
1656225152139,CSE 175,A01,083665,Kumar; Rakesh,0,0,25,25
1656225158165,CSE 190,A00,092507,Dubnov; Shlomo,3,0,20,17
1656225164188,ECE 45,A01,083139,Congero; Spencer William,1,0,75,74
1656225170211,ECE 65,A50,083695,Saad; Andrew S,9,0,30,21
1656225170211,ECE 65,A51,095125,Staff,23,0,26,3
1656225176240,ECE 109,A01,091882,Touri; Behrouz,0,1,70,70
1656225182262,ECE 180,A00,083140,Abi Samra; Nicholas Camill,1,0,30,29
1656225182262,ECE 180,B00,083141,Abi Samra; Nicholas Camill,0,4,30,30
1656225188285,MATH 10A,A01,083735,Patchell; Gregory David,0,0,30,30
1656225188285,MATH 10A,A02,083736,Patchell; Gregory David,22,0,30,8
1656225188285,MATH 10A,A03,083737,Patchell; Gregory David,16,0,30,14
1656225194313,MATH 10B,A01,083207,Lim; Seonhee,0,0,34,34
1656225194313,MATH 10B,A02,083208,Lim; Seonhee,7,0,35,28
1656225194313,MATH 10B,A03,093472,Staff,1,0,34,33
1656225194313,MATH 10B,B01,083739,Sinha; Shubham,11,0,30,19
1656225200340,MATH 18,A01,083743,Cinel; Cameron Alexander,7,0,30,23
1656225200340,MATH 18,A02,083744,Cinel; Cameron Alexander,9,0,30,21
1656225200340,MATH 18,A03,083745,Cinel; Cameron Alexander,5,0,30,25
1656225200340,MATH 18,B01,083748,Rideout; David Porter,1,0,36,35
1656225200340,MATH 18,B02,083749,Rideout; David Porter,0,0,36,36
1656225200340,MATH 18,B03,083750,Rideout; David Porter,0,0,36,36
1656225200340,MATH 18,B04,083751,Rideout; David Porter,0,1,36,36
1656225200340,MATH 18,B05,093473,Rideout; David Porter,0,0,36,36
1656225200340,MATH 18,B06,093474,Rideout; David Porter,3,0,36,33
1656225206363,MATH 20A,A01,083754,Zheng; Zequn,11,0,40,29
1656225212386,MATH 20B,A01,083756,Briones; Jor-el Thomas Caparas,0,0,36,36
1656225212386,MATH 20B,A02,083757,Briones; Jor-el Thomas Caparas,0,0,36,36
1656225212386,MATH 20B,A03,093475,Staff,0,0,36,36
1656225218412,MATH 20C,A01,083760,Briones; Jor-el Thomas Caparas,0,0,35,35
1656225218412,MATH 20C,A02,083761,Briones; Jor-el Thomas Caparas,9,1,35,26
1656225218412,MATH 20C,A03,093476,Staff,0,0,35,35
1656225218412,MATH 20C,B01,083762,Bach; Quang Tran,1,0,30,29
1656225224438,MATH 20D,A01,083765,Tran; Brian Kha,1,0,30,29
1656225224438,MATH 20D,A02,083766,Tran; Brian Kha,0,1,30,30
1656225224438,MATH 20D,A03,083767,Tran; Brian Kha,2,0,30,28
1656225230465,MATH 20E,A01,083771,Ganguly; Soumya,3,0,32,29
1656225230465,MATH 20E,A02,083772,Ganguly; Soumya,0,0,32,32
1656225230465,MATH 20E,B01,083773,Ciotti; Benjamin,16,0,35,19
1656225230465,MATH 20E,B02,083774,Ciotti; Benjamin,15,0,35,20
1656225236490,MATH 103A,A01,083777,Greenfeld; Be'Eri,1,0,36,35
1656225236490,MATH 103A,A02,083778,Greenfeld; Be'Eri,1,0,36,35
1656225236490,MATH 103A,A03,093561,Staff,5,0,36,31
1656225236490,MATH 103A,B01,083779,Greenfeld; Be'Eri,8,0,36,28
1656225236490,MATH 103A,B02,083780,Greenfeld; Be'Eri,1,0,36,35
1656225236490,MATH 103A,B03,093562,Staff,0,0,36,36
1656225242517,MATH 105,A01,085443,Carter; Anne Toulson,4,0,35,31
1656225242517,MATH 105,A02,093477,Staff,14,0,35,21
1656225248541,MATH 109,A01,083213,Ganzberger; Geoffrey Michael,0,0,34,34
1656225248541,MATH 109,A02,083214,Ganzberger; Geoffrey Michael,0,0,34,34
1656225248541,MATH 109,A03,093478,Staff,1,0,34,33
1656225248541,MATH 109,B01,083215,Ganzberger; Geoffrey Michael,4,0,32,28
1656225248541,MATH 109,B02,083216,Ganzberger; Geoffrey Michael,1,0,32,31
1656225248541,MATH 109,B03,093479,Staff,4,0,32,28
1656225254565,MATH 142A,A01,083219,Chow; Bennett,2,0,32,30
1656225254565,MATH 142A,A02,083220,Chow; Bennett,8,0,32,24
1656225254565,MATH 142A,A03,093480,Staff,5,0,32,27
1656225254565,MATH 142A,B03,093481,Staff,3,0,32,29
1656225254565,MATH 142A,B04,093558,Staff,6,0,32,26
1656225254565,MATH 142A,B05,093559,Staff,1,0,32,31
1656225260590,MATH 193A,A01,083224,Rotar; Vladimir,0,1,34,34
1656225260590,MATH 193A,A02,083225,Rotar; Vladimir,0,0,34,34
1656225260590,MATH 193A,A03,083781,Rotar; Vladimir,0,0,34,34
1656225260590,MATH 193A,A04,083782,Rotar; Vladimir,6,0,34,28
1656225260590,MATH 193A,A05,093482,Rotar; Vladimir,0,0,34,34
1656225266614,MATH 197,001,091859,McAuley; Julian John,9999,0,9999,0
1656225266614,MATH 197,002,095566,Kedlaya; Kiran S.,9997,0,9999,2
1656225266614,MATH 197,003,095567,Xiao; Ming,9999,0,9999,0
1656225266614,MATH 197,004,095571,Perols; Johan Lars,9998,0,9999,1
1656225273667,COGS 9,A01,083615,Shannon; Kyle Michael,3,0,75,72
1656225279690,COGS 11,A01,083617,Boyle; Mary E. T.,14,0,48,34
1656225285716,COGS 13,A01,083071,Bastos; Amalia Pinkusfeld,4,0,71,67
1656225291740,COGS 14A,A01,092681,Semenuks; Arturs,0,12,100,100
1656225297765,COGS 14B,A01,083073,Cheng; Tzu-Han,7,0,63,56
1656225303788,COGS 17,A01,092677,Semenuks; Arturs,7,0,81,74
1656225309811,COGS 100,A01,083619,Allen; Michael Gordon,2,0,70,68
1656225315835,COGS 101A,A01,083621,Davis; Joshua Daniel,4,0,68,64
1656225321862,COGS 101B,A01,091572,Allen; Michael Gordon,4,0,65,61
1656225327886,COGS 101C,A01,083625,Delgado; Tania,10,0,35,25
1656225333910,COGS 107A,A01,083627,Boyle; Mary E. T.,0,0,60,60
1656225339940,COGS 118A,A01,083075,Gupta; Anjum,8,0,76,68
1656225345965,CSE 3,A50,083646,Miranda; Gregory Joseph,18,0,50,32
1656225352016,CSE 8A,A50,083650,Miranda; Gregory Joseph,2,2,56,54
1656225358049,CSE 11,A01,083080,Cao; Yingjun,0,49,40,40
1656225364073,CSE 12,A01,083652,Krause-Levy; Sophia Louisa,5,1,120,115
1656225370096,CSE 15L,A01,083654,Morris; Justin Loren,2,0,50,48
1656225370096,CSE 15L,A02,083655,Morris; Justin Loren,4,0,50,46
1656225376119,CSE 20,A01,083657,Tran; Khoa Dang,30,0,80,50
1656225382143,CSE 21,A01,095574,Bach; Quang Tran,23,0,48,25
1656225388165,CSE 30,A01,083084,Eldon; John,2,6,80,78
1656225388165,CSE 30,B01,095061,Bhaskar; Nishant,0,1,50,50
1656225394189,CSE 100,A01,083659,Cao; Yingjun,1,18,70,69
1656225400214,CSE 134B,A01,083661,Powell; Thomas Allan,5,0,100,95
1656225406247,CSE 140,A01,083663,Gungor; Onat,9,0,85,76
1656225412270,CSE 140L,A01,083088,Eldon; John,8,0,100,92
1656225418293,CSE 175,A01,083665,Kumar; Rakesh,0,0,25,25
1656225424324,CSE 190,A00,092507,Dubnov; Shlomo,3,0,20,17
1656225430346,ECE 45,A01,083139,Congero; Spencer William,1,0,75,74
1656225436374,ECE 65,A50,083695,Saad; Andrew S,9,0,30,21
1656225436374,ECE 65,A51,095125,Staff,23,0,26,3
1656225442401,ECE 109,A01,091882,Touri; Behrouz,0,1,70,70
1656225448424,ECE 180,A00,083140,Abi Samra; Nicholas Camill,1,0,30,29
1656225448424,ECE 180,B00,083141,Abi Samra; Nicholas Camill,0,4,30,30
1656225454450,MATH 10A,A01,083735,Patchell; Gregory David,0,0,30,30
1656225454450,MATH 10A,A02,083736,Patchell; Gregory David,22,0,30,8
1656225454450,MATH 10A,A03,083737,Patchell; Gregory David,16,0,30,14
1656225460473,MATH 10B,A01,083207,Lim; Seonhee,0,0,34,34
1656225460473,MATH 10B,A02,083208,Lim; Seonhee,7,0,35,28
1656225460473,MATH 10B,A03,093472,Staff,1,0,34,33
1656225460473,MATH 10B,B01,083739,Sinha; Shubham,11,0,30,19
1656225466503,MATH 18,A01,083743,Cinel; Cameron Alexander,7,0,30,23
1656225466503,MATH 18,A02,083744,Cinel; Cameron Alexander,9,0,30,21
1656225466503,MATH 18,A03,083745,Cinel; Cameron Alexander,5,0,30,25
1656225466503,MATH 18,B01,083748,Rideout; David Porter,1,0,36,35
1656225466503,MATH 18,B02,083749,Rideout; David Porter,0,0,36,36
1656225466503,MATH 18,B03,083750,Rideout; David Porter,0,0,36,36
1656225466503,MATH 18,B04,083751,Rideout; David Porter,0,1,36,36
1656225466503,MATH 18,B05,093473,Rideout; David Porter,0,0,36,36
1656225466503,MATH 18,B06,093474,Rideout; David Porter,3,0,36,33
1656225472525,MATH 20A,A01,083754,Zheng; Zequn,11,0,40,29
1656225478550,MATH 20B,A01,083756,Briones; Jor-el Thomas Caparas,0,0,36,36
1656225478550,MATH 20B,A02,083757,Briones; Jor-el Thomas Caparas,0,0,36,36
1656225478550,MATH 20B,A03,093475,Staff,0,0,36,36
1656225484575,MATH 20C,A01,083760,Briones; Jor-el Thomas Caparas,0,0,35,35
1656225484575,MATH 20C,A02,083761,Briones; Jor-el Thomas Caparas,9,1,35,26
1656225484575,MATH 20C,A03,093476,Staff,0,0,35,35
1656225484575,MATH 20C,B01,083762,Bach; Quang Tran,1,0,30,29
1656225490599,MATH 20D,A01,083765,Tran; Brian Kha,1,0,30,29
1656225490599,MATH 20D,A02,083766,Tran; Brian Kha,0,1,30,30
1656225490599,MATH 20D,A03,083767,Tran; Brian Kha,2,0,30,28
1656225496622,MATH 20E,A01,083771,Ganguly; Soumya,3,0,32,29
1656225496622,MATH 20E,A02,083772,Ganguly; Soumya,0,0,32,32
1656225496622,MATH 20E,B01,083773,Ciotti; Benjamin,16,0,35,19
1656225496622,MATH 20E,B02,083774,Ciotti; Benjamin,15,0,35,20
1656225502649,MATH 103A,A01,083777,Greenfeld; Be'Eri,1,0,36,35
1656225502649,MATH 103A,A02,083778,Greenfeld; Be'Eri,1,0,36,35
1656225502649,MATH 103A,A03,093561,Staff,5,0,36,31
1656225502649,MATH 103A,B01,083779,Greenfeld; Be'Eri,8,0,36,28
1656225502649,MATH 103A,B02,083780,Greenfeld; Be'Eri,1,0,36,35
1656225502649,MATH 103A,B03,093562,Staff,0,0,36,36
1656225508671,MATH 105,A01,085443,Carter; Anne Toulson,4,0,35,31
1656225508671,MATH 105,A02,093477,Staff,14,0,35,21
1656225514695,MATH 109,A01,083213,Ganzberger; Geoffrey Michael,0,0,34,34
1656225514695,MATH 109,A02,083214,Ganzberger; Geoffrey Michael,0,0,34,34
1656225514695,MATH 109,A03,093478,Staff,1,0,34,33
1656225514695,MATH 109,B01,083215,Ganzberger; Geoffrey Michael,4,0,32,28
1656225514695,MATH 109,B02,083216,Ganzberger; Geoffrey Michael,1,0,32,31
1656225514695,MATH 109,B03,093479,Staff,4,0,32,28
1656225520725,MATH 142A,A01,083219,Chow; Bennett,2,0,32,30
1656225520725,MATH 142A,A02,083220,Chow; Bennett,8,0,32,24
1656225520725,MATH 142A,A03,093480,Staff,5,0,32,27
1656225520725,MATH 142A,B03,093481,Staff,3,0,32,29
1656225520725,MATH 142A,B04,093558,Staff,6,0,32,26
1656225520725,MATH 142A,B05,093559,Staff,1,0,32,31
1656225526749,MATH 193A,A01,083224,Rotar; Vladimir,0,1,34,34
1656225526749,MATH 193A,A02,083225,Rotar; Vladimir,0,0,34,34
1656225526749,MATH 193A,A03,083781,Rotar; Vladimir,0,0,34,34
1656225526749,MATH 193A,A04,083782,Rotar; Vladimir,6,0,34,28
1656225526749,MATH 193A,A05,093482,Rotar; Vladimir,0,0,34,34
1656225532780,MATH 197,001,091859,McAuley; Julian John,9999,0,9999,0
1656225532780,MATH 197,002,095566,Kedlaya; Kiran S.,9997,0,9999,2
1656225532780,MATH 197,003,095567,Xiao; Ming,9999,0,9999,0
1656225532780,MATH 197,004,095571,Perols; Johan Lars,9998,0,9999,1
1656225539834,COGS 9,A01,083615,Shannon; Kyle Michael,3,0,75,72
1656225545862,COGS 11,A01,083617,Boyle; Mary E. T.,14,0,48,34
1656225551891,COGS 13,A01,083071,Bastos; Amalia Pinkusfeld,4,0,71,67
1656225557916,COGS 14A,A01,092681,Semenuks; Arturs,0,12,100,100
1656225563937,COGS 14B,A01,083073,Cheng; Tzu-Han,7,0,63,56
1656225569960,COGS 17,A01,092677,Semenuks; Arturs,7,0,81,74
1656225575987,COGS 100,A01,083619,Allen; Michael Gordon,2,0,70,68
1656225582015,COGS 101A,A01,083621,Davis; Joshua Daniel,4,0,68,64
1656225588039,COGS 101B,A01,091572,Allen; Michael Gordon,4,0,65,61
1656225594063,COGS 101C,A01,083625,Delgado; Tania,10,0,35,25
1656225600090,COGS 107A,A01,083627,Boyle; Mary E. T.,0,0,60,60
1656225606111,COGS 118A,A01,083075,Gupta; Anjum,8,0,76,68
1656225612134,CSE 3,A50,083646,Miranda; Gregory Joseph,18,0,50,32
1656225618159,CSE 8A,A50,083650,Miranda; Gregory Joseph,2,2,56,54
1656225624182,CSE 11,A01,083080,Cao; Yingjun,0,49,40,40
1656225630207,CSE 12,A01,083652,Krause-Levy; Sophia Louisa,5,1,120,115
1656225636235,CSE 15L,A01,083654,Morris; Justin Loren,2,0,50,48
1656225636235,CSE 15L,A02,083655,Morris; Justin Loren,4,0,50,46
1656225642257,CSE 20,A01,083657,Tran; Khoa Dang,30,0,80,50
1656225648280,CSE 21,A01,095574,Bach; Quang Tran,23,0,48,25
1656225654304,CSE 30,A01,083084,Eldon; John,2,6,80,78
1656225654304,CSE 30,B01,095061,Bhaskar; Nishant,0,1,50,50
1656225660327,CSE 100,A01,083659,Cao; Yingjun,1,18,70,69
1656225666356,CSE 134B,A01,083661,Powell; Thomas Allan,5,0,100,95
1656225672379,CSE 140,A01,083663,Gungor; Onat,9,0,85,76
1656225678475,CSE 140L,A01,083088,Eldon; John,8,0,100,92
1656225684499,CSE 175,A01,083665,Kumar; Rakesh,0,0,25,25
1656225690526,CSE 190,A00,092507,Dubnov; Shlomo,3,0,20,17
1656225696549,ECE 45,A01,083139,Congero; Spencer William,1,0,75,74
1656225702576,ECE 65,A50,083695,Saad; Andrew S,9,0,30,21
1656225702576,ECE 65,A51,095125,Staff,23,0,26,3
1656225708601,ECE 109,A01,091882,Touri; Behrouz,0,1,70,70
1656225714625,ECE 180,A00,083140,Abi Samra; Nicholas Camill,1,0,30,29
1656225714625,ECE 180,B00,083141,Abi Samra; Nicholas Camill,0,4,30,30
1656225720652,MATH 10A,A01,083735,Patchell; Gregory David,0,0,30,30
1656225720652,MATH 10A,A02,083736,Patchell; Gregory David,22,0,30,8
1656225720652,MATH 10A,A03,083737,Patchell; Gregory David,16,0,30,14
1656225726682,MATH 10B,A01,083207,Lim; Seonhee,0,0,34,34
1656225726682,MATH 10B,A02,083208,Lim; Seonhee,7,0,35,28
1656225726682,MATH 10B,A03,093472,Staff,1,0,34,33
1656225726682,MATH 10B,B01,083739,Sinha; Shubham,11,0,30,19
1656225732713,MATH 18,A01,083743,Cinel; Cameron Alexander,7,0,30,23
1656225732713,MATH 18,A02,083744,Cinel; Cameron Alexander,9,0,30,21
1656225732713,MATH 18,A03,083745,Cinel; Cameron Alexander,5,0,30,25
1656225732713,MATH 18,B01,083748,Rideout; David Porter,1,0,36,35
1656225732713,MATH 18,B02,083749,Rideout; David Porter,0,0,36,36
1656225732713,MATH 18,B03,083750,Rideout; David Porter,0,0,36,36
1656225732713,MATH 18,B04,083751,Rideout; David Porter,0,1,36,36
1656225732713,MATH 18,B05,093473,Rideout; David Porter,0,0,36,36
1656225732713,MATH 18,B06,093474,Rideout; David Porter,3,0,36,33
1656225738739,MATH 20A,A01,083754,Zheng; Zequn,11,0,40,29
1656225744763,MATH 20B,A01,083756,Briones; Jor-el Thomas Caparas,0,0,36,36
1656225744763,MATH 20B,A02,083757,Briones; Jor-el Thomas Caparas,0,0,36,36
1656225744763,MATH 20B,A03,093475,Staff,0,0,36,36
1656225750791,MATH 20C,A01,083760,Briones; Jor-el Thomas Caparas,0,0,35,35
1656225750791,MATH 20C,A02,083761,Briones; Jor-el Thomas Caparas,9,1,35,26
1656225750791,MATH 20C,A03,093476,Staff,0,0,35,35
1656225750791,MATH 20C,B01,083762,Bach; Quang Tran,1,0,30,29
1656225756814,MATH 20D,A01,083765,Tran; Brian Kha,1,0,30,29
1656225756814,MATH 20D,A02,083766,Tran; Brian Kha,0,1,30,30
1656225756814,MATH 20D,A03,083767,Tran; Brian Kha,2,0,30,28
1656225762838,MATH 20E,A01,083771,Ganguly; Soumya,3,0,32,29
1656225762838,MATH 20E,A02,083772,Ganguly; Soumya,0,0,32,32
1656225762838,MATH 20E,B01,083773,Ciotti; Benjamin,16,0,35,19
1656225762838,MATH 20E,B02,083774,Ciotti; Benjamin,15,0,35,20
1656225768863,MATH 103A,A01,083777,Greenfeld; Be'Eri,1,0,36,35
1656225768863,MATH 103A,A02,083778,Greenfeld; Be'Eri,1,0,36,35
1656225768863,MATH 103A,A03,093561,Staff,5,0,36,31
1656225768863,MATH 103A,B01,083779,Greenfeld; Be'Eri,8,0,36,28
1656225768863,MATH 103A,B02,083780,Greenfeld; Be'Eri,1,0,36,35
1656225768863,MATH 103A,B03,093562,Staff,0,0,36,36
1656225774890,MATH 105,A01,085443,Carter; Anne Toulson,4,0,35,31
1656225774890,MATH 105,A02,093477,Staff,14,0,35,21
1656225780920,MATH 109,A01,083213,Ganzberger; Geoffrey Michael,0,0,34,34
1656225780920,MATH 109,A02,083214,Ganzberger; Geoffrey Michael,0,0,34,34
1656225780920,MATH 109,A03,093478,Staff,1,0,34,33
1656225780920,MATH 109,B01,083215,Ganzberger; Geoffrey Michael,4,0,32,28
1656225780920,MATH 109,B02,083216,Ganzberger; Geoffrey Michael,1,0,32,31
1656225780920,MATH 109,B03,093479,Staff,4,0,32,28
1656225786950,MATH 142A,A01,083219,Chow; Bennett,2,0,32,30
1656225786950,MATH 142A,A02,083220,Chow; Bennett,8,0,32,24
1656225786950,MATH 142A,A03,093480,Staff,5,0,32,27
1656225786950,MATH 142A,B03,093481,Staff,3,0,32,29
1656225786950,MATH 142A,B04,093558,Staff,6,0,32,26
1656225786950,MATH 142A,B05,093559,Staff,1,0,32,31
1656225792974,MATH 193A,A01,083224,Rotar; Vladimir,0,1,34,34
1656225792974,MATH 193A,A02,083225,Rotar; Vladimir,0,0,34,34
1656225792974,MATH 193A,A03,083781,Rotar; Vladimir,0,0,34,34
1656225792974,MATH 193A,A04,083782,Rotar; Vladimir,6,0,34,28
1656225792974,MATH 193A,A05,093482,Rotar; Vladimir,0,0,34,34
1656225799001,MATH 197,001,091859,McAuley; Julian John,9999,0,9999,0
1656225799001,MATH 197,002,095566,Kedlaya; Kiran S.,9997,0,9999,2
1656225799001,MATH 197,003,095567,Xiao; Ming,9999,0,9999,0
1656225799001,MATH 197,004,095571,Perols; Johan Lars,9998,0,9999,1
1656225806065,COGS 9,A01,083615,Shannon; Kyle Michael,3,0,75,72
1656225812093,COGS 11,A01,083617,Boyle; Mary E. T.,14,0,48,34
1656225818120,COGS 13,A01,083071,Bastos; Amalia Pinkusfeld,4,0,71,67
1656225824144,COGS 14A,A01,092681,Semenuks; Arturs,0,12,100,100
1656225830171,COGS 14B,A01,083073,Cheng; Tzu-Han,7,0,63,56
1656225836197,COGS 17,A01,092677,Semenuks; Arturs,7,0,81,74
1656225842223,COGS 100,A01,083619,Allen; Michael Gordon,2,0,70,68
1656225848249,COGS 101A,A01,083621,Davis; Joshua Daniel,4,0,68,64
1656225854273,COGS 101B,A01,091572,Allen; Michael Gordon,4,0,65,61
1656225860296,COGS 101C,A01,083625,Delgado; Tania,10,0,35,25
1656225866320,COGS 107A,A01,083627,Boyle; Mary E. T.,0,0,60,60
1656225872341,COGS 118A,A01,083075,Gupta; Anjum,8,0,76,68
1656225878364,CSE 3,A50,083646,Miranda; Gregory Joseph,18,0,50,32
1656225884388,CSE 8A,A50,083650,Miranda; Gregory Joseph,2,2,56,54
1656225890411,CSE 11,A01,083080,Cao; Yingjun,0,49,40,40
1656225896434,CSE 12,A01,083652,Krause-Levy; Sophia Louisa,5,1,120,115
1656225902457,CSE 15L,A01,083654,Morris; Justin Loren,2,0,50,48
1656225902457,CSE 15L,A02,083655,Morris; Justin Loren,4,0,50,46
1656225908481,CSE 20,A01,083657,Tran; Khoa Dang,30,0,80,50
1656225914508,CSE 21,A01,095574,Bach; Quang Tran,23,0,48,25
1656225920536,CSE 30,A01,083084,Eldon; John,2,6,80,78
1656225920536,CSE 30,B01,095061,Bhaskar; Nishant,0,1,50,50
1656225926563,CSE 100,A01,083659,Cao; Yingjun,1,18,70,69
1656225932591,CSE 134B,A01,083661,Powell; Thomas Allan,5,0,100,95
1656225938613,CSE 140,A01,083663,Gungor; Onat,9,0,85,76
1656225944639,CSE 140L,A01,083088,Eldon; John,8,0,100,92
1656225950661,CSE 175,A01,083665,Kumar; Rakesh,0,0,25,25
1656225956684,CSE 190,A00,092507,Dubnov; Shlomo,3,0,20,17
1656225962710,ECE 45,A01,083139,Congero; Spencer William,1,0,75,74
1656225968735,ECE 65,A50,083695,Saad; Andrew S,9,0,30,21
1656225968735,ECE 65,A51,095125,Staff,23,0,26,3
1656225974760,ECE 109,A01,091882,Touri; Behrouz,0,1,70,70
1656225980786,ECE 180,A00,083140,Abi Samra; Nicholas Camill,1,0,30,29
1656225980786,ECE 180,B00,083141,Abi Samra; Nicholas Camill,0,4,30,30
1656225986816,MATH 10A,A01,083735,Patchell; Gregory David,0,0,30,30
1656225986816,MATH 10A,A02,083736,Patchell; Gregory David,22,0,30,8
1656225986816,MATH 10A,A03,083737,Patchell; Gregory David,16,0,30,14
1656225992839,MATH 10B,A01,083207,Lim; Seonhee,0,0,34,34
1656225992839,MATH 10B,A02,083208,Lim; Seonhee,7,0,35,28
1656225992839,MATH 10B,A03,093472,Staff,1,0,34,33
1656225992839,MATH 10B,B01,083739,Sinha; Shubham,11,0,30,19
1656225998865,MATH 18,A01,083743,Cinel; Cameron Alexander,7,0,30,23
1656225998865,MATH 18,A02,083744,Cinel; Cameron Alexander,9,0,30,21
1656225998865,MATH 18,A03,083745,Cinel; Cameron Alexander,5,0,30,25
1656225998865,MATH 18,B01,083748,Rideout; David Porter,1,0,36,35
1656225998865,MATH 18,B02,083749,Rideout; David Porter,0,0,36,36
1656225998865,MATH 18,B03,083750,Rideout; David Porter,0,0,36,36
1656225998865,MATH 18,B04,083751,Rideout; David Porter,0,1,36,36
1656225998865,MATH 18,B05,093473,Rideout; David Porter,0,0,36,36
1656225998865,MATH 18,B06,093474,Rideout; David Porter,3,0,36,33
1656226004887,MATH 20A,A01,083754,Zheng; Zequn,11,0,40,29
1656226010915,MATH 20B,A01,083756,Briones; Jor-el Thomas Caparas,0,0,36,36
1656226010915,MATH 20B,A02,083757,Briones; Jor-el Thomas Caparas,0,0,36,36
1656226010915,MATH 20B,A03,093475,Staff,0,0,36,36
1656226016945,MATH 20C,A01,083760,Briones; Jor-el Thomas Caparas,0,0,35,35
1656226016945,MATH 20C,A02,083761,Briones; Jor-el Thomas Caparas,9,1,35,26
1656226016945,MATH 20C,A03,093476,Staff,0,0,35,35
1656226016945,MATH 20C,B01,083762,Bach; Quang Tran,1,0,30,29
1656226022975,MATH 20D,A01,083765,Tran; Brian Kha,1,0,30,29
1656226022975,MATH 20D,A02,083766,Tran; Brian Kha,0,1,30,30
1656226022975,MATH 20D,A03,083767,Tran; Brian Kha,2,0,30,28
1656226028997,MATH 20E,A01,083771,Ganguly; Soumya,3,0,32,29
1656226028997,MATH 20E,A02,083772,Ganguly; Soumya,0,0,32,32
1656226028997,MATH 20E,B01,083773,Ciotti; Benjamin,16,0,35,19
1656226028997,MATH 20E,B02,083774,Ciotti; Benjamin,15,0,35,20
1656226035027,MATH 103A,A01,083777,Greenfeld; Be'Eri,1,0,36,35
1656226035027,MATH 103A,A02,083778,Greenfeld; Be'Eri,1,0,36,35
1656226035027,MATH 103A,A03,093561,Staff,5,0,36,31
1656226035027,MATH 103A,B01,083779,Greenfeld; Be'Eri,8,0,36,28
1656226035027,MATH 103A,B02,083780,Greenfeld; Be'Eri,1,0,36,35
1656226035027,MATH 103A,B03,093562,Staff,0,0,36,36
1656226041054,MATH 105,A01,085443,Carter; Anne Toulson,5,0,35,30
1656226041054,MATH 105,A02,093477,Staff,14,0,35,21
1656226047082,MATH 109,A01,083213,Ganzberger; Geoffrey Michael,0,0,34,34
1656226047082,MATH 109,A02,083214,Ganzberger; Geoffrey Michael,0,0,34,34
1656226047082,MATH 109,A03,093478,Staff,1,0,34,33
1656226047082,MATH 109,B01,083215,Ganzberger; Geoffrey Michael,4,0,32,28
1656226047082,MATH 109,B02,083216,Ganzberger; Geoffrey Michael,1,0,32,31
1656226047082,MATH 109,B03,093479,Staff,4,0,32,28
1656226053107,MATH 142A,A01,083219,Chow; Bennett,2,0,32,30
1656226053107,MATH 142A,A02,083220,Chow; Bennett,8,0,32,24
1656226053107,MATH 142A,A03,093480,Staff,5,0,32,27
1656226053107,MATH 142A,B03,093481,Staff,3,0,32,29
1656226053107,MATH 142A,B04,093558,Staff,6,0,32,26
1656226053107,MATH 142A,B05,093559,Staff,1,0,32,31
1656226059142,MATH 193A,A01,083224,Rotar; Vladimir,0,1,34,34
1656226059142,MATH 193A,A02,083225,Rotar; Vladimir,0,0,34,34
1656226059142,MATH 193A,A03,083781,Rotar; Vladimir,0,0,34,34
1656226059142,MATH 193A,A04,083782,Rotar; Vladimir,6,0,34,28
1656226059142,MATH 193A,A05,093482,Rotar; Vladimir,0,0,34,34
1656226065168,MATH 197,001,091859,McAuley; Julian John,9999,0,9999,0
1656226065168,MATH 197,002,095566,Kedlaya; Kiran S.,9997,0,9999,2
1656226065168,MATH 197,003,095567,Xiao; Ming,9999,0,9999,0
1656226065168,MATH 197,004,095571,Perols; Johan Lars,9998,0,9999,1
1656226072235,COGS 9,A01,083615,Shannon; Kyle Michael,3,0,75,72
1656226078261,COGS 11,A01,083617,Boyle; Mary E. T.,14,0,48,34
1656226084285,COGS 13,A01,083071,Bastos; Amalia Pinkusfeld,4,0,71,67
1656226090308,COGS 14A,A01,092681,Semenuks; Arturs,0,12,100,100
1656226096332,COGS 14B,A01,083073,Cheng; Tzu-Han,7,0,63,56
1656226102355,COGS 17,A01,092677,Semenuks; Arturs,7,0,81,74
1656226108380,COGS 100,A01,083619,Allen; Michael Gordon,2,0,70,68
1656226114406,COGS 101A,A01,083621,Davis; Joshua Daniel,4,0,68,64
1656226120433,COGS 101B,A01,091572,Allen; Michael Gordon,4,0,65,61
1656226126459,COGS 101C,A01,083625,Delgado; Tania,10,0,35,25
1656226132481,COGS 107A,A01,083627,Boyle; Mary E. T.,0,0,60,60
1656226138503,COGS 118A,A01,083075,Gupta; Anjum,8,0,76,68
1656226144528,CSE 3,A50,083646,Miranda; Gregory Joseph,18,0,50,32
1656226150552,CSE 8A,A50,083650,Miranda; Gregory Joseph,2,2,56,54
1656226156574,CSE 11,A01,083080,Cao; Yingjun,0,49,40,40
1656226162599,CSE 12,A01,083652,Krause-Levy; Sophia Louisa,5,1,120,115
1656226168625,CSE 15L,A01,083654,Morris; Justin Loren,2,0,50,48
1656226168625,CSE 15L,A02,083655,Morris; Justin Loren,4,0,50,46
1656226174657,CSE 20,A01,083657,Tran; Khoa Dang,30,0,80,50
1656226180685,CSE 21,A01,095574,Bach; Quang Tran,23,0,48,25
1656226186709,CSE 30,A01,083084,Eldon; John,2,6,80,78
1656226186709,CSE 30,B01,095061,Bhaskar; Nishant,0,1,50,50
1656226192733,CSE 100,A01,083659,Cao; Yingjun,1,18,70,69
1656226198756,CSE 134B,A01,083661,Powell; Thomas Allan,5,0,100,95
1656226204783,CSE 140,A01,083663,Gungor; Onat,9,0,85,76
1656226210807,CSE 140L,A01,083088,Eldon; John,8,0,100,92
1656226216831,CSE 175,A01,083665,Kumar; Rakesh,0,0,25,25
1656226222858,CSE 190,A00,092507,Dubnov; Shlomo,3,0,20,17
1656226228884,ECE 45,A01,083139,Congero; Spencer William,1,0,75,74
1656226234907,ECE 65,A50,083695,Saad; Andrew S,9,0,30,21
1656226234907,ECE 65,A51,095125,Staff,23,0,26,3
1656226240934,ECE 109,A01,091882,Touri; Behrouz,0,1,70,70
1656226246958,ECE 180,A00,083140,Abi Samra; Nicholas Camill,1,0,30,29
1656226246958,ECE 180,B00,083141,Abi Samra; Nicholas Camill,0,4,30,30
1656226252987,MATH 10A,A01,083735,Patchell; Gregory David,0,0,30,30
1656226252987,MATH 10A,A02,083736,Patchell; Gregory David,22,0,30,8
1656226252987,MATH 10A,A03,083737,Patchell; Gregory David,16,0,30,14
1656226259010,MATH 10B,A01,083207,Lim; Seonhee,0,0,34,34
1656226259010,MATH 10B,A02,083208,Lim; Seonhee,7,0,35,28
1656226259010,MATH 10B,A03,093472,Staff,1,0,34,33
1656226259010,MATH 10B,B01,083739,Sinha; Shubham,11,0,30,19
1656226265042,MATH 18,A01,083743,Cinel; Cameron Alexander,7,0,30,23
1656226265042,MATH 18,A02,083744,Cinel; Cameron Alexander,9,0,30,21
1656226265042,MATH 18,A03,083745,Cinel; Cameron Alexander,5,0,30,25
1656226265042,MATH 18,B01,083748,Rideout; David Porter,1,0,36,35
1656226265042,MATH 18,B02,083749,Rideout; David Porter,0,0,36,36
1656226265042,MATH 18,B03,083750,Rideout; David Porter,0,0,36,36
1656226265042,MATH 18,B04,083751,Rideout; David Porter,0,1,36,36
1656226265042,MATH 18,B05,093473,Rideout; David Porter,0,0,36,36
1656226265042,MATH 18,B06,093474,Rideout; David Porter,3,0,36,33
1656226271065,MATH 20A,A01,083754,Zheng; Zequn,11,0,40,29
1656226277179,MATH 20B,A01,083756,Briones; Jor-el Thomas Caparas,0,0,36,36
1656226277179,MATH 20B,A02,083757,Briones; Jor-el Thomas Caparas,0,0,36,36
1656226277179,MATH 20B,A03,093475,Staff,0,0,36,36
1656226283204,MATH 20C,A01,083760,Briones; Jor-el Thomas Caparas,0,0,35,35
1656226283204,MATH 20C,A02,083761,Briones; Jor-el Thomas Caparas,9,1,35,26
1656226283204,MATH 20C,A03,093476,Staff,0,0,35,35
1656226283204,MATH 20C,B01,083762,Bach; Quang Tran,1,0,30,29
1656226289232,MATH 20D,A01,083765,Tran; Brian Kha,1,0,30,29
1656226289232,MATH 20D,A02,083766,Tran; Brian Kha,0,1,30,30
1656226289232,MATH 20D,A03,083767,Tran; Brian Kha,2,0,30,28
1656226295257,MATH 20E,A01,083771,Ganguly; Soumya,3,0,32,29
1656226295257,MATH 20E,A02,083772,Ganguly; Soumya,0,0,32,32
1656226295257,MATH 20E,B01,083773,Ciotti; Benjamin,16,0,35,19
1656226295257,MATH 20E,B02,083774,Ciotti; Benjamin,15,0,35,20
1656226301284,MATH 103A,A01,083777,Greenfeld; Be'Eri,1,0,36,35
1656226301284,MATH 103A,A02,083778,Greenfeld; Be'Eri,1,0,36,35
1656226301284,MATH 103A,A03,093561,Staff,5,0,36,31
1656226301284,MATH 103A,B01,083779,Greenfeld; Be'Eri,8,0,36,28
1656226301284,MATH 103A,B02,083780,Greenfeld; Be'Eri,1,0,36,35
1656226301284,MATH 103A,B03,093562,Staff,0,0,36,36
1656226307307,MATH 105,A01,085443,Carter; Anne Toulson,5,0,35,30
1656226307307,MATH 105,A02,093477,Staff,14,0,35,21
1656226313332,MATH 109,A01,083213,Ganzberger; Geoffrey Michael,0,0,34,34
1656226313332,MATH 109,A02,083214,Ganzberger; Geoffrey Michael,0,0,34,34
1656226313332,MATH 109,A03,093478,Staff,1,0,34,33
1656226313332,MATH 109,B01,083215,Ganzberger; Geoffrey Michael,4,0,32,28
1656226313332,MATH 109,B02,083216,Ganzberger; Geoffrey Michael,1,0,32,31
1656226313332,MATH 109,B03,093479,Staff,4,0,32,28
1656226319356,MATH 142A,A01,083219,Chow; Bennett,2,0,32,30
1656226319356,MATH 142A,A02,083220,Chow; Bennett,8,0,32,24
1656226319356,MATH 142A,A03,093480,Staff,5,0,32,27
1656226319356,MATH 142A,B03,093481,Staff,3,0,32,29
1656226319356,MATH 142A,B04,093558,Staff,6,0,32,26
1656226319356,MATH 142A,B05,093559,Staff,1,0,32,31
1656226325385,MATH 193A,A01,083224,Rotar; Vladimir,0,1,34,34
1656226325385,MATH 193A,A02,083225,Rotar; Vladimir,0,0,34,34
1656226325385,MATH 193A,A03,083781,Rotar; Vladimir,0,0,34,34
1656226325385,MATH 193A,A04,083782,Rotar; Vladimir,6,0,34,28
1656226325385,MATH 193A,A05,093482,Rotar; Vladimir,0,0,34,34
1656226331409,MATH 197,001,091859,McAuley; Julian John,9999,0,9999,0
1656226331409,MATH 197,002,095566,Kedlaya; Kiran S.,9997,0,9999,2
1656226331409,MATH 197,003,095567,Xiao; Ming,9999,0,9999,0
1656226331409,MATH 197,004,095571,Perols; Johan Lars,9998,0,9999,1
1656226338461,COGS 9,A01,083615,Shannon; Kyle Michael,3,0,75,72
1656226344485,COGS 11,A01,083617,Boyle; Mary E. T.,14,0,48,34
1656226350508,COGS 13,A01,083071,Bastos; Amalia Pinkusfeld,4,0,71,67
1656226356536,COGS 14A,A01,092681,Semenuks; Arturs,0,12,100,100
1656226362559,COGS 14B,A01,083073,Cheng; Tzu-Han,7,0,63,56
1656226368585,COGS 17,A01,092677,Semenuks; Arturs,7,0,81,74
1656226374616,COGS 100,A01,083619,Allen; Michael Gordon,2,0,70,68
1656226380641,COGS 101A,A01,083621,Davis; Joshua Daniel,4,0,68,64
1656226386664,COGS 101B,A01,091572,Allen; Michael Gordon,4,0,65,61
1656226392688,COGS 101C,A01,083625,Delgado; Tania,10,0,35,25
1656226398716,COGS 107A,A01,083627,Boyle; Mary E. T.,0,0,60,60
1656226404742,COGS 118A,A01,083075,Gupta; Anjum,8,0,76,68
1656226410766,CSE 3,A50,083646,Miranda; Gregory Joseph,18,0,50,32
1656226416789,CSE 8A,A50,083650,Miranda; Gregory Joseph,2,2,56,54
1656226422813,CSE 11,A01,083080,Cao; Yingjun,0,49,40,40
1656226434629,CSE 12,A01,083652,Krause-Levy; Sophia Louisa,5,1,120,115
1656226440664,CSE 15L,A01,083654,Morris; Justin Loren,2,0,50,48
1656226440664,CSE 15L,A02,083655,Morris; Justin Loren,4,0,50,46
1656226446690,CSE 20,A01,083657,Tran; Khoa Dang,30,0,80,50
1656226452718,CSE 21,A01,095574,Bach; Quang Tran,23,0,48,25
1656226458743,CSE 30,A01,083084,Eldon; John,2,6,80,78
1656226458743,CSE 30,B01,095061,Bhaskar; Nishant,0,1,50,50
1656226464775,CSE 100,A01,083659,Cao; Yingjun,1,18,70,69
1656226470797,CSE 134B,A01,083661,Powell; Thomas Allan,5,0,100,95
1656226476823,CSE 140,A01,083663,Gungor; Onat,9,0,85,76
1656226482848,CSE 140L,A01,083088,Eldon; John,8,0,100,92
1656226488870,CSE 175,A01,083665,Kumar; Rakesh,0,0,25,25
1656226494896,CSE 190,A00,092507,Dubnov; Shlomo,3,0,20,17
1656226500922,ECE 45,A01,083139,Congero; Spencer William,1,0,75,74
1656226506945,ECE 65,A50,083695,Saad; Andrew S,9,0,30,21
1656226506945,ECE 65,A51,095125,Staff,23,0,26,3
1656226512969,ECE 109,A01,091882,Touri; Behrouz,0,1,70,70
1656226518993,ECE 180,A00,083140,Abi Samra; Nicholas Camill,1,0,30,29
1656226518993,ECE 180,B00,083141,Abi Samra; Nicholas Camill,0,4,30,30
1656226525024,MATH 10A,A01,083735,Patchell; Gregory David,0,0,30,30
1656226525024,MATH 10A,A02,083736,Patchell; Gregory David,22,0,30,8
1656226525024,MATH 10A,A03,083737,Patchell; Gregory David,16,0,30,14
1656226531050,MATH 10B,A01,083207,Lim; Seonhee,0,0,34,34
1656226531050,MATH 10B,A02,083208,Lim; Seonhee,7,0,35,28
1656226531050,MATH 10B,A03,093472,Staff,1,0,34,33
1656226531050,MATH 10B,B01,083739,Sinha; Shubham,11,0,30,19
1656226537073,MATH 18,A01,083743,Cinel; Cameron Alexander,7,0,30,23
1656226537073,MATH 18,A02,083744,Cinel; Cameron Alexander,9,0,30,21
1656226537073,MATH 18,A03,083745,Cinel; Cameron Alexander,5,0,30,25
1656226537073,MATH 18,B01,083748,Rideout; David Porter,1,0,36,35
1656226537073,MATH 18,B02,083749,Rideout; David Porter,0,0,36,36
1656226537073,MATH 18,B03,083750,Rideout; David Porter,0,0,36,36
1656226537073,MATH 18,B04,083751,Rideout; David Porter,0,1,36,36
1656226537073,MATH 18,B05,093473,Rideout; David Porter,0,0,36,36
1656226537073,MATH 18,B06,093474,Rideout; David Porter,3,0,36,33
1656226543098,MATH 20A,A01,083754,Zheng; Zequn,11,0,40,29
1656226549125,MATH 20B,A01,083756,Briones; Jor-el Thomas Caparas,0,0,36,36
1656226549125,MATH 20B,A02,083757,Briones; Jor-el Thomas Caparas,0,0,36,36
1656226549125,MATH 20B,A03,093475,Staff,0,0,36,36
1656226555150,MATH 20C,A01,083760,Briones; Jor-el Thomas Caparas,0,0,35,35
1656226555150,MATH 20C,A02,083761,Briones; Jor-el Thomas Caparas,9,1,35,26
1656226555150,MATH 20C,A03,093476,Staff,0,0,35,35
1656226555150,MATH 20C,B01,083762,Bach; Quang Tran,1,0,30,29
1656226561176,MATH 20D,A01,083765,Tran; Brian Kha,1,0,30,29
1656226561176,MATH 20D,A02,083766,Tran; Brian Kha,0,1,30,30
1656226561176,MATH 20D,A03,083767,Tran; Brian Kha,2,0,30,28
1656226567207,MATH 20E,A01,083771,Ganguly; Soumya,3,0,32,29
1656226567207,MATH 20E,A02,083772,Ganguly; Soumya,0,0,32,32
1656226567207,MATH 20E,B01,083773,Ciotti; Benjamin,16,0,35,19
1656226567207,MATH 20E,B02,083774,Ciotti; Benjamin,15,0,35,20
1656226573237,MATH 103A,A01,083777,Greenfeld; Be'Eri,1,0,36,35
1656226573237,MATH 103A,A02,083778,Greenfeld; Be'Eri,1,0,36,35
1656226573237,MATH 103A,A03,093561,Staff,5,0,36,31
1656226573237,MATH 103A,B01,083779,Greenfeld; Be'Eri,8,0,36,28
1656226573237,MATH 103A,B02,083780,Greenfeld; Be'Eri,1,0,36,35
1656226573237,MATH 103A,B03,093562,Staff,0,0,36,36
1656226579261,MATH 105,A01,085443,Carter; Anne Toulson,5,0,35,30
1656226579261,MATH 105,A02,093477,Staff,14,0,35,21
1656226585285,MATH 109,A01,083213,Ganzberger; Geoffrey Michael,0,0,34,34
1656226585285,MATH 109,A02,083214,Ganzberger; Geoffrey Michael,0,0,34,34
1656226585285,MATH 109,A03,093478,Staff,1,0,34,33
1656226585285,MATH 109,B01,083215,Ganzberger; Geoffrey Michael,4,0,32,28
1656226585285,MATH 109,B02,083216,Ganzberger; Geoffrey Michael,1,0,32,31
1656226585285,MATH 109,B03,093479,Staff,4,0,32,28
1656226591308,MATH 142A,A01,083219,Chow; Bennett,2,0,32,30
1656226591308,MATH 142A,A02,083220,Chow; Bennett,8,0,32,24
1656226591308,MATH 142A,A03,093480,Staff,5,0,32,27
1656226591308,MATH 142A,B03,093481,Staff,3,0,32,29
1656226591308,MATH 142A,B04,093558,Staff,6,0,32,26
1656226591308,MATH 142A,B05,093559,Staff,1,0,32,31
1656226597331,MATH 193A,A01,083224,Rotar; Vladimir,0,1,34,34
1656226597331,MATH 193A,A02,083225,Rotar; Vladimir,0,0,34,34
1656226597331,MATH 193A,A03,083781,Rotar; Vladimir,0,0,34,34
1656226597331,MATH 193A,A04,083782,Rotar; Vladimir,6,0,34,28
1656226597331,MATH 193A,A05,093482,Rotar; Vladimir,0,0,34,34
1656226603354,MATH 197,001,091859,McAuley; Julian John,9999,0,9999,0
1656226603354,MATH 197,002,095566,Kedlaya; Kiran S.,9997,0,9999,2
1656226603354,MATH 197,003,095567,Xiao; Ming,9999,0,9999,0
1656226603354,MATH 197,004,095571,Perols; Johan Lars,9998,0,9999,1
1656226610407,COGS 9,A01,083615,Shannon; Kyle Michael,3,0,75,72
1656226616434,COGS 11,A01,083617,Boyle; Mary E. T.,14,0,48,34
1656226622461,COGS 13,A01,083071,Bastos; Amalia Pinkusfeld,4,0,71,67
1656226628488,COGS 14A,A01,092681,Semenuks; Arturs,0,12,100,100
1656226634513,COGS 14B,A01,083073,Cheng; Tzu-Han,7,0,63,56
1656226640539,COGS 17,A01,092677,Semenuks; Arturs,7,0,81,74
1656226646567,COGS 100,A01,083619,Allen; Michael Gordon,2,0,70,68
1656226652598,COGS 101A,A01,083621,Davis; Joshua Daniel,4,0,68,64
1656226658625,COGS 101B,A01,091572,Allen; Michael Gordon,4,0,65,61
1656226664647,COGS 101C,A01,083625,Delgado; Tania,10,0,35,25
1656226670671,COGS 107A,A01,083627,Boyle; Mary E. T.,0,0,60,60
1656226676695,COGS 118A,A01,083075,Gupta; Anjum,8,0,76,68
1656226682718,CSE 3,A50,083646,Miranda; Gregory Joseph,18,0,50,32
1656226688763,CSE 8A,A50,083650,Miranda; Gregory Joseph,2,2,56,54
1656226694787,CSE 11,A01,083080,Cao; Yingjun,0,49,40,40
1656226700814,CSE 12,A01,083652,Krause-Levy; Sophia Louisa,5,1,120,115
1656226706838,CSE 15L,A01,083654,Morris; Justin Loren,2,0,50,48
1656226706838,CSE 15L,A02,083655,Morris; Justin Loren,4,0,50,46
1656226712862,CSE 20,A01,083657,Tran; Khoa Dang,30,0,80,50
1656226718885,CSE 21,A01,095574,Bach; Quang Tran,23,0,48,25
1656226724910,CSE 30,A01,083084,Eldon; John,2,6,80,78
1656226724910,CSE 30,B01,095061,Bhaskar; Nishant,0,1,50,50
1656226730935,CSE 100,A01,083659,Cao; Yingjun,1,18,70,69
1656226736959,CSE 134B,A01,083661,Powell; Thomas Allan,5,0,100,95
1656226742982,CSE 140,A01,083663,Gungor; Onat,9,0,85,76
1656226749010,CSE 140L,A01,083088,Eldon; John,8,0,100,92
1656226755033,CSE 175,A01,083665,Kumar; Rakesh,0,0,25,25
1656226761057,CSE 190,A00,092507,Dubnov; Shlomo,3,0,20,17
1656226767081,ECE 45,A01,083139,Congero; Spencer William,1,0,75,74
1656226773109,ECE 65,A50,083695,Saad; Andrew S,9,0,30,21
1656226773109,ECE 65,A51,095125,Staff,23,0,26,3
1656226779133,ECE 109,A01,091882,Touri; Behrouz,0,1,70,70
1656226785158,ECE 180,A00,083140,Abi Samra; Nicholas Camill,1,0,30,29
1656226785158,ECE 180,B00,083141,Abi Samra; Nicholas Camill,0,4,30,30
1656226791181,MATH 10A,A01,083735,Patchell; Gregory David,0,0,30,30
1656226791181,MATH 10A,A02,083736,Patchell; Gregory David,22,0,30,8
1656226791181,MATH 10A,A03,083737,Patchell; Gregory David,16,0,30,14
1656226797209,MATH 10B,A01,083207,Lim; Seonhee,0,0,34,34
1656226797209,MATH 10B,A02,083208,Lim; Seonhee,7,0,35,28
1656226797209,MATH 10B,A03,093472,Staff,1,0,34,33
1656226797209,MATH 10B,B01,083739,Sinha; Shubham,11,0,30,19
1656226803247,MATH 18,A01,083743,Cinel; Cameron Alexander,7,0,30,23
1656226803247,MATH 18,A02,083744,Cinel; Cameron Alexander,9,0,30,21
1656226803247,MATH 18,A03,083745,Cinel; Cameron Alexander,5,0,30,25
1656226803247,MATH 18,B01,083748,Rideout; David Porter,1,0,36,35
1656226803247,MATH 18,B02,083749,Rideout; David Porter,0,0,36,36
1656226803247,MATH 18,B03,083750,Rideout; David Porter,0,0,36,36
1656226803247,MATH 18,B04,083751,Rideout; David Porter,0,1,36,36
1656226803247,MATH 18,B05,093473,Rideout; David Porter,0,0,36,36
1656226803247,MATH 18,B06,093474,Rideout; David Porter,3,0,36,33
1656226809270,MATH 20A,A01,083754,Zheng; Zequn,11,0,40,29
1656226815294,MATH 20B,A01,083756,Briones; Jor-el Thomas Caparas,0,0,36,36
1656226815294,MATH 20B,A02,083757,Briones; Jor-el Thomas Caparas,0,0,36,36
1656226815294,MATH 20B,A03,093475,Staff,0,0,36,36
1656226821319,MATH 20C,A01,083760,Briones; Jor-el Thomas Caparas,0,0,35,35
1656226821319,MATH 20C,A02,083761,Briones; Jor-el Thomas Caparas,9,1,35,26
1656226821319,MATH 20C,A03,093476,Staff,0,0,35,35
1656226821319,MATH 20C,B01,083762,Bach; Quang Tran,1,0,30,29
1656226827348,MATH 20D,A01,083765,Tran; Brian Kha,1,0,30,29
1656226827348,MATH 20D,A02,083766,Tran; Brian Kha,0,1,30,30
1656226827348,MATH 20D,A03,083767,Tran; Brian Kha,2,0,30,28
1656226833379,MATH 20E,A01,083771,Ganguly; Soumya,3,0,32,29
1656226833379,MATH 20E,A02,083772,Ganguly; Soumya,0,0,32,32
1656226833379,MATH 20E,B01,083773,Ciotti; Benjamin,16,0,35,19
1656226833379,MATH 20E,B02,083774,Ciotti; Benjamin,15,0,35,20
1656226839406,MATH 103A,A01,083777,Greenfeld; Be'Eri,1,0,36,35
1656226839406,MATH 103A,A02,083778,Greenfeld; Be'Eri,1,0,36,35
1656226839406,MATH 103A,A03,093561,Staff,5,0,36,31
1656226839406,MATH 103A,B01,083779,Greenfeld; Be'Eri,8,0,36,28
1656226839406,MATH 103A,B02,083780,Greenfeld; Be'Eri,1,0,36,35
1656226839406,MATH 103A,B03,093562,Staff,0,0,36,36
1656226845434,MATH 105,A01,085443,Carter; Anne Toulson,5,0,35,30
1656226845434,MATH 105,A02,093477,Staff,14,0,35,21
1656226851464,MATH 109,A01,083213,Ganzberger; Geoffrey Michael,0,0,34,34
1656226851464,MATH 109,A02,083214,Ganzberger; Geoffrey Michael,0,0,34,34
1656226851464,MATH 109,A03,093478,Staff,1,0,34,33
1656226851464,MATH 109,B01,083215,Ganzberger; Geoffrey Michael,4,0,32,28
1656226851464,MATH 109,B02,083216,Ganzberger; Geoffrey Michael,1,0,32,31
1656226851464,MATH 109,B03,093479,Staff,4,0,32,28
1656226857487,MATH 142A,A01,083219,Chow; Bennett,2,0,32,30
1656226857487,MATH 142A,A02,083220,Chow; Bennett,8,0,32,24
1656226857487,MATH 142A,A03,093480,Staff,5,0,32,27
1656226857487,MATH 142A,B03,093481,Staff,3,0,32,29
1656226857487,MATH 142A,B04,093558,Staff,6,0,32,26
1656226857487,MATH 142A,B05,093559,Staff,1,0,32,31
1656226863516,MATH 193A,A01,083224,Rotar; Vladimir,0,1,34,34
1656226863516,MATH 193A,A02,083225,Rotar; Vladimir,0,0,34,34
1656226863516,MATH 193A,A03,083781,Rotar; Vladimir,0,0,34,34
1656226863516,MATH 193A,A04,083782,Rotar; Vladimir,6,0,34,28
1656226863516,MATH 193A,A05,093482,Rotar; Vladimir,0,0,34,34
1656226869539,MATH 197,001,091859,McAuley; Julian John,9999,0,9999,0
1656226869539,MATH 197,002,095566,Kedlaya; Kiran S.,9997,0,9999,2
1656226869539,MATH 197,003,095567,Xiao; Ming,9999,0,9999,0
1656226869539,MATH 197,004,095571,Perols; Johan Lars,9998,0,9999,1
1656226876666,COGS 9,A01,083615,Shannon; Kyle Michael,3,0,75,72
1656226882690,COGS 11,A01,083617,Boyle; Mary E. T.,14,0,48,34
1656226888717,COGS 13,A01,083071,Bastos; Amalia Pinkusfeld,4,0,71,67
1656226894746,COGS 14A,A01,092681,Semenuks; Arturs,0,12,100,100
1656226900778,COGS 14B,A01,083073,Cheng; Tzu-Han,7,0,63,56
1656226906803,COGS 17,A01,092677,Semenuks; Arturs,7,0,81,74
1656226912827,COGS 100,A01,083619,Allen; Michael Gordon,2,0,70,68
1656226918854,COGS 101A,A01,083621,Davis; Joshua Daniel,4,0,68,64
1656226924878,COGS 101B,A01,091572,Allen; Michael Gordon,4,0,65,61
1656226930905,COGS 101C,A01,083625,Delgado; Tania,10,0,35,25
1656226936928,COGS 107A,A01,083627,Boyle; Mary E. T.,0,0,60,60
1656226942957,COGS 118A,A01,083075,Gupta; Anjum,8,0,76,68
1656226948986,CSE 3,A50,083646,Miranda; Gregory Joseph,18,0,50,32
1656226955011,CSE 8A,A50,083650,Miranda; Gregory Joseph,2,2,56,54
1656226961035,CSE 11,A01,083080,Cao; Yingjun,0,49,40,40
1656226967059,CSE 12,A01,083652,Krause-Levy; Sophia Louisa,5,1,120,115
1656226973083,CSE 15L,A01,083654,Morris; Justin Loren,2,0,50,48
1656226973083,CSE 15L,A02,083655,Morris; Justin Loren,4,0,50,46
1656226979106,CSE 20,A01,083657,Tran; Khoa Dang,30,0,80,50
1656226985129,CSE 21,A01,095574,Bach; Quang Tran,23,0,48,25
1656226991158,CSE 30,A01,083084,Eldon; John,2,6,80,78
1656226991158,CSE 30,B01,095061,Bhaskar; Nishant,0,1,50,50
1656226997180,CSE 100,A01,083659,Cao; Yingjun,1,18,70,69
1656227003202,CSE 134B,A01,083661,Powell; Thomas Allan,5,0,100,95
1656227009226,CSE 140,A01,083663,Gungor; Onat,9,0,85,76
1656227015255,CSE 140L,A01,083088,Eldon; John,8,0,100,92
1656227021278,CSE 175,A01,083665,Kumar; Rakesh,0,0,25,25
1656227027302,CSE 190,A00,092507,Dubnov; Shlomo,3,0,20,17
1656227033325,ECE 45,A01,083139,Congero; Spencer William,1,0,75,74
1656227039349,ECE 65,A50,083695,Saad; Andrew S,9,0,30,21
1656227039349,ECE 65,A51,095125,Staff,23,0,26,3
1656227045375,ECE 109,A01,091882,Touri; Behrouz,0,1,70,70
1656227051404,ECE 180,A00,083140,Abi Samra; Nicholas Camill,1,0,30,29
1656227051404,ECE 180,B00,083141,Abi Samra; Nicholas Camill,0,4,30,30
1656227057433,MATH 10A,A01,083735,Patchell; Gregory David,0,0,30,30
1656227057433,MATH 10A,A02,083736,Patchell; Gregory David,22,0,30,8
1656227057433,MATH 10A,A03,083737,Patchell; Gregory David,16,0,30,14
1656227063464,MATH 10B,A01,083207,Lim; Seonhee,0,0,34,34
1656227063464,MATH 10B,A02,083208,Lim; Seonhee,7,0,35,28
1656227063464,MATH 10B,A03,093472,Staff,1,0,34,33
1656227063464,MATH 10B,B01,083739,Sinha; Shubham,11,0,30,19
1656227069490,MATH 18,A01,083743,Cinel; Cameron Alexander,7,0,30,23
1656227069490,MATH 18,A02,083744,Cinel; Cameron Alexander,9,0,30,21
1656227069490,MATH 18,A03,083745,Cinel; Cameron Alexander,5,0,30,25
1656227069490,MATH 18,B01,083748,Rideout; David Porter,1,0,36,35
1656227069490,MATH 18,B02,083749,Rideout; David Porter,0,0,36,36
1656227069490,MATH 18,B03,083750,Rideout; David Porter,0,0,36,36
1656227069490,MATH 18,B04,083751,Rideout; David Porter,0,1,36,36
1656227069490,MATH 18,B05,093473,Rideout; David Porter,0,0,36,36
1656227069490,MATH 18,B06,093474,Rideout; David Porter,3,0,36,33
1656227075516,MATH 20A,A01,083754,Zheng; Zequn,11,0,40,29
1656227081540,MATH 20B,A01,083756,Briones; Jor-el Thomas Caparas,0,0,36,36
1656227081540,MATH 20B,A02,083757,Briones; Jor-el Thomas Caparas,0,0,36,36
1656227081540,MATH 20B,A03,093475,Staff,0,0,36,36
1656227087564,MATH 20C,A01,083760,Briones; Jor-el Thomas Caparas,0,0,35,35
1656227087564,MATH 20C,A02,083761,Briones; Jor-el Thomas Caparas,9,1,35,26
1656227087564,MATH 20C,A03,093476,Staff,0,0,35,35
1656227087564,MATH 20C,B01,083762,Bach; Quang Tran,1,0,30,29
1656227093592,MATH 20D,A01,083765,Tran; Brian Kha,1,0,30,29
1656227093592,MATH 20D,A02,083766,Tran; Brian Kha,0,1,30,30
1656227093592,MATH 20D,A03,083767,Tran; Brian Kha,2,0,30,28
1656227099616,MATH 20E,A01,083771,Ganguly; Soumya,3,0,32,29
1656227099616,MATH 20E,A02,083772,Ganguly; Soumya,0,0,32,32
1656227099616,MATH 20E,B01,083773,Ciotti; Benjamin,16,0,35,19
1656227099616,MATH 20E,B02,083774,Ciotti; Benjamin,15,0,35,20
1656227105648,MATH 103A,A01,083777,Greenfeld; Be'Eri,1,0,36,35
1656227105648,MATH 103A,A02,083778,Greenfeld; Be'Eri,1,0,36,35
1656227105648,MATH 103A,A03,093561,Staff,5,0,36,31
1656227105648,MATH 103A,B01,083779,Greenfeld; Be'Eri,8,0,36,28
1656227105648,MATH 103A,B02,083780,Greenfeld; Be'Eri,1,0,36,35
1656227105648,MATH 103A,B03,093562,Staff,0,0,36,36
1656227111675,MATH 105,A01,085443,Carter; Anne Toulson,5,0,35,30
1656227111675,MATH 105,A02,093477,Staff,14,0,35,21
1656227117705,MATH 109,A01,083213,Ganzberger; Geoffrey Michael,0,0,34,34
1656227117705,MATH 109,A02,083214,Ganzberger; Geoffrey Michael,0,0,34,34
1656227117705,MATH 109,A03,093478,Staff,1,0,34,33
1656227117705,MATH 109,B01,083215,Ganzberger; Geoffrey Michael,4,0,32,28
1656227117705,MATH 109,B02,083216,Ganzberger; Geoffrey Michael,1,0,32,31
1656227117705,MATH 109,B03,093479,Staff,4,0,32,28
1656227123729,MATH 142A,A01,083219,Chow; Bennett,2,0,32,30
1656227123729,MATH 142A,A02,083220,Chow; Bennett,8,0,32,24
1656227123729,MATH 142A,A03,093480,Staff,5,0,32,27
1656227123729,MATH 142A,B03,093481,Staff,3,0,32,29
1656227123729,MATH 142A,B04,093558,Staff,6,0,32,26
1656227123729,MATH 142A,B05,093559,Staff,1,0,32,31
1656227129754,MATH 193A,A01,083224,Rotar; Vladimir,0,1,34,34
1656227129754,MATH 193A,A02,083225,Rotar; Vladimir,0,0,34,34
1656227129754,MATH 193A,A03,083781,Rotar; Vladimir,0,0,34,34
1656227129754,MATH 193A,A04,083782,Rotar; Vladimir,6,0,34,28
1656227129754,MATH 193A,A05,093482,Rotar; Vladimir,0,0,34,34
1656227135779,MATH 197,001,091859,McAuley; Julian John,9999,0,9999,0
1656227135779,MATH 197,002,095566,Kedlaya; Kiran S.,9997,0,9999,2
1656227135779,MATH 197,003,095567,Xiao; Ming,9999,0,9999,0
1656227135779,MATH 197,004,095571,Perols; Johan Lars,9998,0,9999,1
1656227142837,COGS 9,A01,083615,Shannon; Kyle Michael,3,0,75,72
1656227148860,COGS 11,A01,083617,Boyle; Mary E. T.,14,0,48,34
1656227154886,COGS 13,A01,083071,Bastos; Amalia Pinkusfeld,4,0,71,67
1656227160913,COGS 14A,A01,092681,Semenuks; Arturs,0,12,100,100
1656227166941,COGS 14B,A01,083073,Cheng; Tzu-Han,7,0,63,56
1656227172968,COGS 17,A01,092677,Semenuks; Arturs,7,0,81,74
1656227179000,COGS 100,A01,083619,Allen; Michael Gordon,2,0,70,68
1656227185028,COGS 101A,A01,083621,Davis; Joshua Daniel,4,0,68,64
1656227191050,COGS 101B,A01,091572,Allen; Michael Gordon,4,0,65,61
1656227197075,COGS 101C,A01,083625,Delgado; Tania,10,0,35,25
1656227203103,COGS 107A,A01,083627,Boyle; Mary E. T.,0,0,60,60
1656227209131,COGS 118A,A01,083075,Gupta; Anjum,8,0,76,68
1656227215155,CSE 3,A50,083646,Miranda; Gregory Joseph,18,0,50,32
1656227221179,CSE 8A,A50,083650,Miranda; Gregory Joseph,2,2,56,54
1656227227202,CSE 11,A01,083080,Cao; Yingjun,0,49,40,40
1656227233238,CSE 12,A01,083652,Krause-Levy; Sophia Louisa,5,1,120,115
1656227239266,CSE 15L,A01,083654,Morris; Justin Loren,2,0,50,48
1656227239266,CSE 15L,A02,083655,Morris; Justin Loren,4,0,50,46
1656227245293,CSE 20,A01,083657,Tran; Khoa Dang,30,0,80,50
1656227251322,CSE 21,A01,095574,Bach; Quang Tran,23,0,48,25
1656227257346,CSE 30,A01,083084,Eldon; John,2,6,80,78
1656227257346,CSE 30,B01,095061,Bhaskar; Nishant,0,1,50,50
1656227263372,CSE 100,A01,083659,Cao; Yingjun,1,18,70,69
1656227269399,CSE 134B,A01,083661,Powell; Thomas Allan,5,0,100,95
1656227275426,CSE 140,A01,083663,Gungor; Onat,9,0,85,76
1656227281456,CSE 140L,A01,083088,Eldon; John,8,0,100,92
1656227287481,CSE 175,A01,083665,Kumar; Rakesh,0,0,25,25
1656227293509,CSE 190,A00,092507,Dubnov; Shlomo,3,0,20,17
1656227299533,ECE 45,A01,083139,Congero; Spencer William,1,0,75,74
1656227305556,ECE 65,A50,083695,Saad; Andrew S,9,0,30,21
1656227305556,ECE 65,A51,095125,Staff,23,0,26,3
1656227311584,ECE 109,A01,091882,Touri; Behrouz,0,1,70,70
1656227317612,ECE 180,A00,083140,Abi Samra; Nicholas Camill,1,0,30,29
1656227317612,ECE 180,B00,083141,Abi Samra; Nicholas Camill,0,4,30,30
1656227323634,MATH 10A,A01,083735,Patchell; Gregory David,0,0,30,30
1656227323634,MATH 10A,A02,083736,Patchell; Gregory David,22,0,30,8
1656227323634,MATH 10A,A03,083737,Patchell; Gregory David,16,0,30,14
1656227329671,MATH 10B,A01,083207,Lim; Seonhee,0,0,34,34
1656227329671,MATH 10B,A02,083208,Lim; Seonhee,7,0,35,28
1656227329671,MATH 10B,A03,093472,Staff,1,0,34,33
1656227329671,MATH 10B,B01,083739,Sinha; Shubham,11,0,30,19
1656227335696,MATH 18,A01,083743,Cinel; Cameron Alexander,7,0,30,23
1656227335696,MATH 18,A02,083744,Cinel; Cameron Alexander,9,0,30,21
1656227335696,MATH 18,A03,083745,Cinel; Cameron Alexander,5,0,30,25
1656227335696,MATH 18,B01,083748,Rideout; David Porter,1,0,36,35
1656227335696,MATH 18,B02,083749,Rideout; David Porter,0,0,36,36
1656227335696,MATH 18,B03,083750,Rideout; David Porter,0,0,36,36
1656227335696,MATH 18,B04,083751,Rideout; David Porter,0,1,36,36
1656227335696,MATH 18,B05,093473,Rideout; David Porter,0,0,36,36
1656227335696,MATH 18,B06,093474,Rideout; David Porter,3,0,36,33
1656227341725,MATH 20A,A01,083754,Zheng; Zequn,11,0,40,29
1656227347749,MATH 20B,A01,083756,Briones; Jor-el Thomas Caparas,0,0,36,36
1656227347749,MATH 20B,A02,083757,Briones; Jor-el Thomas Caparas,0,0,36,36
1656227347749,MATH 20B,A03,093475,Staff,0,0,36,36
1656227353780,MATH 20C,A01,083760,Briones; Jor-el Thomas Caparas,0,0,35,35
1656227353780,MATH 20C,A02,083761,Briones; Jor-el Thomas Caparas,9,1,35,26
1656227353780,MATH 20C,A03,093476,Staff,0,0,35,35
1656227353780,MATH 20C,B01,083762,Bach; Quang Tran,1,0,30,29
1656227359811,MATH 20D,A01,083765,Tran; Brian Kha,1,0,30,29
1656227359811,MATH 20D,A02,083766,Tran; Brian Kha,0,1,30,30
1656227359811,MATH 20D,A03,083767,Tran; Brian Kha,2,0,30,28
1656227365840,MATH 20E,A01,083771,Ganguly; Soumya,3,0,32,29
1656227365840,MATH 20E,A02,083772,Ganguly; Soumya,0,0,32,32
1656227365840,MATH 20E,B01,083773,Ciotti; Benjamin,16,0,35,19
1656227365840,MATH 20E,B02,083774,Ciotti; Benjamin,15,0,35,20
1656227371870,MATH 103A,A01,083777,Greenfeld; Be'Eri,1,0,36,35
1656227371870,MATH 103A,A02,083778,Greenfeld; Be'Eri,1,0,36,35
1656227371870,MATH 103A,A03,093561,Staff,5,0,36,31
1656227371870,MATH 103A,B01,083779,Greenfeld; Be'Eri,8,0,36,28
1656227371870,MATH 103A,B02,083780,Greenfeld; Be'Eri,1,0,36,35
1656227371870,MATH 103A,B03,093562,Staff,0,0,36,36
1656227377903,MATH 105,A01,085443,Carter; Anne Toulson,5,0,35,30
1656227377903,MATH 105,A02,093477,Staff,14,0,35,21
1656227383927,MATH 109,A01,083213,Ganzberger; Geoffrey Michael,0,0,34,34
1656227383927,MATH 109,A02,083214,Ganzberger; Geoffrey Michael,0,0,34,34
1656227383927,MATH 109,A03,093478,Staff,1,0,34,33
1656227383927,MATH 109,B01,083215,Ganzberger; Geoffrey Michael,4,0,32,28
1656227383927,MATH 109,B02,083216,Ganzberger; Geoffrey Michael,1,0,32,31
1656227383927,MATH 109,B03,093479,Staff,4,0,32,28
1656227389957,MATH 142A,A01,083219,Chow; Bennett,2,0,32,30
1656227389957,MATH 142A,A02,083220,Chow; Bennett,8,0,32,24
1656227389957,MATH 142A,A03,093480,Staff,5,0,32,27
1656227389957,MATH 142A,B03,093481,Staff,3,0,32,29
1656227389957,MATH 142A,B04,093558,Staff,6,0,32,26
1656227389957,MATH 142A,B05,093559,Staff,1,0,32,31
1656227395981,MATH 193A,A01,083224,Rotar; Vladimir,0,1,34,34
1656227395981,MATH 193A,A02,083225,Rotar; Vladimir,0,0,34,34
1656227395981,MATH 193A,A03,083781,Rotar; Vladimir,0,0,34,34
1656227395981,MATH 193A,A04,083782,Rotar; Vladimir,6,0,34,28
1656227395981,MATH 193A,A05,093482,Rotar; Vladimir,0,0,34,34
1656227402005,MATH 197,001,091859,McAuley; Julian John,9999,0,9999,0
1656227402005,MATH 197,002,095566,Kedlaya; Kiran S.,9997,0,9999,2
1656227402005,MATH 197,003,095567,Xiao; Ming,9999,0,9999,0
1656227402005,MATH 197,004,095571,Perols; Johan Lars,9998,0,9999,1
1656227409066,COGS 9,A01,083615,Shannon; Kyle Michael,3,0,75,72
1656227415091,COGS 11,A01,083617,Boyle; Mary E. T.,14,0,48,34
1656227421117,COGS 13,A01,083071,Bastos; Amalia Pinkusfeld,4,0,71,67
1656227427141,COGS 14A,A01,092681,Semenuks; Arturs,0,12,100,100
1656227433165,COGS 14B,A01,083073,Cheng; Tzu-Han,7,0,63,56
1656227439190,COGS 17,A01,092677,Semenuks; Arturs,7,0,81,74
1656227445218,COGS 100,A01,083619,Allen; Michael Gordon,2,0,70,68
1656227451245,COGS 101A,A01,083621,Davis; Joshua Daniel,4,0,68,64
1656227457279,COGS 101B,A01,091572,Allen; Michael Gordon,4,0,65,61
1656227463303,COGS 101C,A01,083625,Delgado; Tania,10,0,35,25
1656227469328,COGS 107A,A01,083627,Boyle; Mary E. T.,0,0,60,60
1656227475442,COGS 118A,A01,083075,Gupta; Anjum,8,0,76,68
1656227481466,CSE 3,A50,083646,Miranda; Gregory Joseph,18,0,50,32
1656227487495,CSE 8A,A50,083650,Miranda; Gregory Joseph,2,2,56,54
1656227493519,CSE 11,A01,083080,Cao; Yingjun,0,49,40,40
1656227499551,CSE 12,A01,083652,Krause-Levy; Sophia Louisa,5,1,120,115
1656227505579,CSE 15L,A01,083654,Morris; Justin Loren,2,0,50,48
1656227505579,CSE 15L,A02,083655,Morris; Justin Loren,4,0,50,46
1656227511603,CSE 20,A01,083657,Tran; Khoa Dang,30,0,80,50
1656227517627,CSE 21,A01,095574,Bach; Quang Tran,23,0,48,25
1656227523658,CSE 30,A01,083084,Eldon; John,2,6,80,78
1656227523658,CSE 30,B01,095061,Bhaskar; Nishant,0,1,50,50
1656227529689,CSE 100,A01,083659,Cao; Yingjun,1,18,70,69
1656227535712,CSE 134B,A01,083661,Powell; Thomas Allan,5,0,100,95
1656227541736,CSE 140,A01,083663,Gungor; Onat,9,0,85,76
1656227547762,CSE 140L,A01,083088,Eldon; John,8,0,100,92
1656227553790,CSE 175,A01,083665,Kumar; Rakesh,0,0,25,25
1656227559814,CSE 190,A00,092507,Dubnov; Shlomo,3,0,20,17
1656227565845,ECE 45,A01,083139,Congero; Spencer William,1,0,75,74
1656227571878,ECE 65,A50,083695,Saad; Andrew S,9,0,30,21
1656227571878,ECE 65,A51,095125,Staff,23,0,26,3
1656227577902,ECE 109,A01,091882,Touri; Behrouz,0,1,70,70
1656227583926,ECE 180,A00,083140,Abi Samra; Nicholas Camill,1,0,30,29
1656227583926,ECE 180,B00,083141,Abi Samra; Nicholas Camill,0,4,30,30
1656227589952,MATH 10A,A01,083735,Patchell; Gregory David,0,0,30,30
1656227589952,MATH 10A,A02,083736,Patchell; Gregory David,22,0,30,8
1656227589952,MATH 10A,A03,083737,Patchell; Gregory David,16,0,30,14
1656227595988,MATH 10B,A01,083207,Lim; Seonhee,0,0,34,34
1656227595988,MATH 10B,A02,083208,Lim; Seonhee,7,0,35,28
1656227595988,MATH 10B,A03,093472,Staff,1,0,34,33
1656227595988,MATH 10B,B01,083739,Sinha; Shubham,11,0,30,19
1656227602014,MATH 18,A01,083743,Cinel; Cameron Alexander,7,0,30,23
1656227602014,MATH 18,A02,083744,Cinel; Cameron Alexander,9,0,30,21
1656227602014,MATH 18,A03,083745,Cinel; Cameron Alexander,5,0,30,25
1656227602014,MATH 18,B01,083748,Rideout; David Porter,1,0,36,35
1656227602014,MATH 18,B02,083749,Rideout; David Porter,0,0,36,36
1656227602014,MATH 18,B03,083750,Rideout; David Porter,0,0,36,36
1656227602014,MATH 18,B04,083751,Rideout; David Porter,0,1,36,36
1656227602014,MATH 18,B05,093473,Rideout; David Porter,0,0,36,36
1656227602014,MATH 18,B06,093474,Rideout; David Porter,3,0,36,33
1656227608037,MATH 20A,A01,083754,Zheng; Zequn,11,0,40,29
1656227614061,MATH 20B,A01,083756,Briones; Jor-el Thomas Caparas,0,0,36,36
1656227614061,MATH 20B,A02,083757,Briones; Jor-el Thomas Caparas,0,0,36,36
1656227614061,MATH 20B,A03,093475,Staff,0,0,36,36
1656227620086,MATH 20C,A01,083760,Briones; Jor-el Thomas Caparas,0,0,35,35
1656227620086,MATH 20C,A02,083761,Briones; Jor-el Thomas Caparas,9,1,35,26
1656227620086,MATH 20C,A03,093476,Staff,0,0,35,35
1656227620086,MATH 20C,B01,083762,Bach; Quang Tran,1,0,30,29
1656227626118,MATH 20D,A01,083765,Tran; Brian Kha,1,0,30,29
1656227626118,MATH 20D,A02,083766,Tran; Brian Kha,0,1,30,30
1656227626118,MATH 20D,A03,083767,Tran; Brian Kha,2,0,30,28
1656227632153,MATH 20E,A01,083771,Ganguly; Soumya,3,0,32,29
1656227632153,MATH 20E,A02,083772,Ganguly; Soumya,0,0,32,32
1656227632153,MATH 20E,B01,083773,Ciotti; Benjamin,16,0,35,19
1656227632153,MATH 20E,B02,083774,Ciotti; Benjamin,15,0,35,20
1656227638194,MATH 103A,A01,083777,Greenfeld; Be'Eri,1,0,36,35
1656227638194,MATH 103A,A02,083778,Greenfeld; Be'Eri,1,0,36,35
1656227638194,MATH 103A,A03,093561,Staff,5,0,36,31
1656227638194,MATH 103A,B01,083779,Greenfeld; Be'Eri,8,0,36,28
1656227638194,MATH 103A,B02,083780,Greenfeld; Be'Eri,1,0,36,35
1656227638194,MATH 103A,B03,093562,Staff,0,0,36,36
1656227644225,MATH 105,A01,085443,Carter; Anne Toulson,5,0,35,30
1656227644225,MATH 105,A02,093477,Staff,14,0,35,21
1656227650257,MATH 109,A01,083213,Ganzberger; Geoffrey Michael,0,0,34,34
1656227650257,MATH 109,A02,083214,Ganzberger; Geoffrey Michael,0,0,34,34
1656227650257,MATH 109,A03,093478,Staff,1,0,34,33
1656227650257,MATH 109,B01,083215,Ganzberger; Geoffrey Michael,4,0,32,28
1656227650257,MATH 109,B02,083216,Ganzberger; Geoffrey Michael,1,0,32,31
1656227650257,MATH 109,B03,093479,Staff,4,0,32,28
1656227656290,MATH 142A,A01,083219,Chow; Bennett,2,0,32,30
1656227656290,MATH 142A,A02,083220,Chow; Bennett,8,0,32,24
1656227656290,MATH 142A,A03,093480,Staff,5,0,32,27
1656227656290,MATH 142A,B03,093481,Staff,3,0,32,29
1656227656290,MATH 142A,B04,093558,Staff,6,0,32,26
1656227656290,MATH 142A,B05,093559,Staff,1,0,32,31
1656227662314,MATH 193A,A01,083224,Rotar; Vladimir,0,1,34,34
1656227662314,MATH 193A,A02,083225,Rotar; Vladimir,0,0,34,34
1656227662314,MATH 193A,A03,083781,Rotar; Vladimir,0,0,34,34
1656227662314,MATH 193A,A04,083782,Rotar; Vladimir,6,0,34,28
1656227662314,MATH 193A,A05,093482,Rotar; Vladimir,0,0,34,34
1656227668336,MATH 197,001,091859,McAuley; Julian John,9999,0,9999,0
1656227668336,MATH 197,002,095566,Kedlaya; Kiran S.,9997,0,9999,2
1656227668336,MATH 197,003,095567,Xiao; Ming,9999,0,9999,0
1656227668336,MATH 197,004,095571,Perols; Johan Lars,9998,0,9999,1
1656227675413,COGS 9,A01,083615,Shannon; Kyle Michael,3,0,75,72
1656227681438,COGS 11,A01,083617,Boyle; Mary E. T.,14,0,48,34
1656227687475,COGS 13,A01,083071,Bastos; Amalia Pinkusfeld,4,0,71,67
1656227693522,COGS 14A,A01,092681,Semenuks; Arturs,0,12,100,100
1656227699556,COGS 14B,A01,083073,Cheng; Tzu-Han,7,0,63,56
1656227705586,COGS 17,A01,092677,Semenuks; Arturs,7,0,81,74
1656227711611,COGS 100,A01,083619,Allen; Michael Gordon,2,0,70,68
1656227717637,COGS 101A,A01,083621,Davis; Joshua Daniel,4,0,68,64
1656227723684,COGS 101B,A01,091572,Allen; Michael Gordon,4,0,65,61
1656227729728,COGS 101C,A01,083625,Delgado; Tania,10,0,35,25
1656227735787,COGS 107A,A01,083627,Boyle; Mary E. T.,0,0,60,60
1656227741814,COGS 118A,A01,083075,Gupta; Anjum,8,0,76,68
1656227747855,CSE 3,A50,083646,Miranda; Gregory Joseph,18,0,50,32
1656227753901,CSE 8A,A50,083650,Miranda; Gregory Joseph,2,2,56,54
1656227759931,CSE 11,A01,083080,Cao; Yingjun,0,49,40,40
1656227765961,CSE 12,A01,083652,Krause-Levy; Sophia Louisa,5,1,120,115
1656227771986,CSE 15L,A01,083654,Morris; Justin Loren,2,0,50,48
1656227771986,CSE 15L,A02,083655,Morris; Justin Loren,4,0,50,46
1656227778015,CSE 20,A01,083657,Tran; Khoa Dang,30,0,80,50
1656227784039,CSE 21,A01,095574,Bach; Quang Tran,23,0,48,25
1656227790064,CSE 30,A01,083084,Eldon; John,2,6,80,78
1656227790064,CSE 30,B01,095061,Bhaskar; Nishant,0,1,50,50
1656227796096,CSE 100,A01,083659,Cao; Yingjun,1,18,70,69
1656227802121,CSE 134B,A01,083661,Powell; Thomas Allan,5,0,100,95
1656227808149,CSE 140,A01,083663,Gungor; Onat,9,0,85,76
1656227814176,CSE 140L,A01,083088,Eldon; John,8,0,100,92
1656227820204,CSE 175,A01,083665,Kumar; Rakesh,0,0,25,25
1656227826226,CSE 190,A00,092507,Dubnov; Shlomo,3,0,20,17
1656227832263,ECE 45,A01,083139,Congero; Spencer William,1,0,75,74
1656227838297,ECE 65,A50,083695,Saad; Andrew S,9,0,30,21
1656227838297,ECE 65,A51,095125,Staff,23,0,26,3
1656227844322,ECE 109,A01,091882,Touri; Behrouz,0,1,70,70
1656227850351,ECE 180,A00,083140,Abi Samra; Nicholas Camill,1,0,30,29
1656227850351,ECE 180,B00,083141,Abi Samra; Nicholas Camill,0,4,30,30
1656227856385,MATH 10A,A01,083735,Patchell; Gregory David,0,0,30,30
1656227856385,MATH 10A,A02,083736,Patchell; Gregory David,22,0,30,8
1656227856385,MATH 10A,A03,083737,Patchell; Gregory David,16,0,30,14
1656227862412,MATH 10B,A01,083207,Lim; Seonhee,0,0,34,34
1656227862412,MATH 10B,A02,083208,Lim; Seonhee,7,0,35,28
1656227862412,MATH 10B,A03,093472,Staff,1,0,34,33
1656227862412,MATH 10B,B01,083739,Sinha; Shubham,11,0,30,19
1656227868437,MATH 18,A01,083743,Cinel; Cameron Alexander,7,0,30,23
1656227868437,MATH 18,A02,083744,Cinel; Cameron Alexander,9,0,30,21
1656227868437,MATH 18,A03,083745,Cinel; Cameron Alexander,5,0,30,25
1656227868437,MATH 18,B01,083748,Rideout; David Porter,1,0,36,35
1656227868437,MATH 18,B02,083749,Rideout; David Porter,0,0,36,36
1656227868437,MATH 18,B03,083750,Rideout; David Porter,0,0,36,36
1656227868437,MATH 18,B04,083751,Rideout; David Porter,0,1,36,36
1656227868437,MATH 18,B05,093473,Rideout; David Porter,0,0,36,36
1656227868437,MATH 18,B06,093474,Rideout; David Porter,3,0,36,33
1656227874467,MATH 20A,A01,083754,Zheng; Zequn,11,0,40,29
1656227880497,MATH 20B,A01,083756,Briones; Jor-el Thomas Caparas,0,0,36,36
1656227880497,MATH 20B,A02,083757,Briones; Jor-el Thomas Caparas,0,0,36,36
1656227880497,MATH 20B,A03,093475,Staff,0,0,36,36
1656227886522,MATH 20C,A01,083760,Briones; Jor-el Thomas Caparas,0,0,35,35
1656227886522,MATH 20C,A02,083761,Briones; Jor-el Thomas Caparas,9,1,35,26
1656227886522,MATH 20C,A03,093476,Staff,0,0,35,35
1656227886522,MATH 20C,B01,083762,Bach; Quang Tran,1,0,30,29
1656227892545,MATH 20D,A01,083765,Tran; Brian Kha,1,0,30,29
1656227892545,MATH 20D,A02,083766,Tran; Brian Kha,0,1,30,30
1656227892545,MATH 20D,A03,083767,Tran; Brian Kha,2,0,30,28
1656227898569,MATH 20E,A01,083771,Ganguly; Soumya,3,0,32,29
1656227898569,MATH 20E,A02,083772,Ganguly; Soumya,0,0,32,32
1656227898569,MATH 20E,B01,083773,Ciotti; Benjamin,16,0,35,19
1656227898569,MATH 20E,B02,083774,Ciotti; Benjamin,15,0,35,20
1656227904608,MATH 103A,A01,083777,Greenfeld; Be'Eri,1,0,36,35
1656227904608,MATH 103A,A02,083778,Greenfeld; Be'Eri,1,0,36,35
1656227904608,MATH 103A,A03,093561,Staff,5,0,36,31
1656227904608,MATH 103A,B01,083779,Greenfeld; Be'Eri,8,0,36,28
1656227904608,MATH 103A,B02,083780,Greenfeld; Be'Eri,1,0,36,35
1656227904608,MATH 103A,B03,093562,Staff,0,0,36,36
1656227910636,MATH 105,A01,085443,Carter; Anne Toulson,5,0,35,30
1656227910636,MATH 105,A02,093477,Staff,14,0,35,21
1656227916665,MATH 109,A01,083213,Ganzberger; Geoffrey Michael,0,0,34,34
1656227916665,MATH 109,A02,083214,Ganzberger; Geoffrey Michael,0,0,34,34
1656227916665,MATH 109,A03,093478,Staff,1,0,34,33
1656227916665,MATH 109,B01,083215,Ganzberger; Geoffrey Michael,4,0,32,28
1656227916665,MATH 109,B02,083216,Ganzberger; Geoffrey Michael,1,0,32,31
1656227916665,MATH 109,B03,093479,Staff,4,0,32,28
1656227922697,MATH 142A,A01,083219,Chow; Bennett,2,0,32,30
1656227922697,MATH 142A,A02,083220,Chow; Bennett,8,0,32,24
1656227922697,MATH 142A,A03,093480,Staff,5,0,32,27
1656227922697,MATH 142A,B03,093481,Staff,3,0,32,29
1656227922697,MATH 142A,B04,093558,Staff,6,0,32,26
1656227922697,MATH 142A,B05,093559,Staff,1,0,32,31
1656227928723,MATH 193A,A01,083224,Rotar; Vladimir,0,1,34,34
1656227928723,MATH 193A,A02,083225,Rotar; Vladimir,0,0,34,34
1656227928723,MATH 193A,A03,083781,Rotar; Vladimir,0,0,34,34
1656227928723,MATH 193A,A04,083782,Rotar; Vladimir,6,0,34,28
1656227928723,MATH 193A,A05,093482,Rotar; Vladimir,0,0,34,34
1656227934753,MATH 197,001,091859,McAuley; Julian John,9999,0,9999,0
1656227934753,MATH 197,002,095566,Kedlaya; Kiran S.,9997,0,9999,2
1656227934753,MATH 197,003,095567,Xiao; Ming,9999,0,9999,0
1656227934753,MATH 197,004,095571,Perols; Johan Lars,9998,0,9999,1
1656227941823,COGS 9,A01,083615,Shannon; Kyle Michael,3,0,75,72
1656227947851,COGS 11,A01,083617,Boyle; Mary E. T.,14,0,48,34
1656227953876,COGS 13,A01,083071,Bastos; Amalia Pinkusfeld,4,0,71,67
1656227959901,COGS 14A,A01,092681,Semenuks; Arturs,0,12,100,100
1656227965926,COGS 14B,A01,083073,Cheng; Tzu-Han,7,0,63,56
1656227971950,COGS 17,A01,092677,Semenuks; Arturs,7,0,81,74
1656227977980,COGS 100,A01,083619,Allen; Michael Gordon,2,0,70,68
1656227984018,COGS 101A,A01,083621,Davis; Joshua Daniel,4,0,68,64
1656227990042,COGS 101B,A01,091572,Allen; Michael Gordon,4,0,65,61
1656227996086,COGS 101C,A01,083625,Delgado; Tania,10,0,35,25
1656228002114,COGS 107A,A01,083627,Boyle; Mary E. T.,0,0,60,60
1656228008138,COGS 118A,A01,083075,Gupta; Anjum,8,0,76,68
1656228014164,CSE 3,A50,083646,Miranda; Gregory Joseph,18,0,50,32
1656228020189,CSE 8A,A50,083650,Miranda; Gregory Joseph,2,2,56,54
1656228026213,CSE 11,A01,083080,Cao; Yingjun,0,49,40,40
1656228032241,CSE 12,A01,083652,Krause-Levy; Sophia Louisa,5,1,120,115
1656228038270,CSE 15L,A01,083654,Morris; Justin Loren,2,0,50,48
1656228038270,CSE 15L,A02,083655,Morris; Justin Loren,4,0,50,46
1656228044297,CSE 20,A01,083657,Tran; Khoa Dang,30,0,80,50
1656228050321,CSE 21,A01,095574,Bach; Quang Tran,23,0,48,25
1656228056351,CSE 30,A01,083084,Eldon; John,2,6,80,78
1656228056351,CSE 30,B01,095061,Bhaskar; Nishant,0,1,50,50
1656228062378,CSE 100,A01,083659,Cao; Yingjun,1,18,70,69
1656228068408,CSE 134B,A01,083661,Powell; Thomas Allan,5,0,100,95
1656228074524,CSE 140,A01,083663,Gungor; Onat,9,0,85,76
1656228080547,CSE 140L,A01,083088,Eldon; John,8,0,100,92
1656228086571,CSE 175,A01,083665,Kumar; Rakesh,0,0,25,25
1656228092594,CSE 190,A00,092507,Dubnov; Shlomo,3,0,20,17
1656228098618,ECE 45,A01,083139,Congero; Spencer William,1,0,75,74
1656228104641,ECE 65,A50,083695,Saad; Andrew S,9,0,30,21
1656228104641,ECE 65,A51,095125,Staff,23,0,26,3
1656228110674,ECE 109,A01,091882,Touri; Behrouz,0,1,70,70
1656228116698,ECE 180,A00,083140,Abi Samra; Nicholas Camill,1,0,30,29
1656228116698,ECE 180,B00,083141,Abi Samra; Nicholas Camill,0,4,30,30
1656228122727,MATH 10A,A01,083735,Patchell; Gregory David,0,0,30,30
1656228122727,MATH 10A,A02,083736,Patchell; Gregory David,22,0,30,8
1656228122727,MATH 10A,A03,083737,Patchell; Gregory David,16,0,30,14
1656228128751,MATH 10B,A01,083207,Lim; Seonhee,0,0,34,34
1656228128751,MATH 10B,A02,083208,Lim; Seonhee,7,0,35,28
1656228128751,MATH 10B,A03,093472,Staff,1,0,34,33
1656228128751,MATH 10B,B01,083739,Sinha; Shubham,11,0,30,19
1656228134784,MATH 18,A01,083743,Cinel; Cameron Alexander,7,0,30,23
1656228134784,MATH 18,A02,083744,Cinel; Cameron Alexander,9,0,30,21
1656228134784,MATH 18,A03,083745,Cinel; Cameron Alexander,5,0,30,25
1656228134784,MATH 18,B01,083748,Rideout; David Porter,1,0,36,35
1656228134784,MATH 18,B02,083749,Rideout; David Porter,0,0,36,36
1656228134784,MATH 18,B03,083750,Rideout; David Porter,0,0,36,36
1656228134784,MATH 18,B04,083751,Rideout; David Porter,0,1,36,36
1656228134784,MATH 18,B05,093473,Rideout; David Porter,0,0,36,36
1656228134784,MATH 18,B06,093474,Rideout; David Porter,3,0,36,33
1656228140811,MATH 20A,A01,083754,Zheng; Zequn,11,0,40,29
1656228146835,MATH 20B,A01,083756,Briones; Jor-el Thomas Caparas,0,0,36,36
1656228146835,MATH 20B,A02,083757,Briones; Jor-el Thomas Caparas,0,0,36,36
1656228146835,MATH 20B,A03,093475,Staff,0,0,36,36
1656228152864,MATH 20C,A01,083760,Briones; Jor-el Thomas Caparas,0,0,35,35
1656228152864,MATH 20C,A02,083761,Briones; Jor-el Thomas Caparas,9,1,35,26
1656228152864,MATH 20C,A03,093476,Staff,0,0,35,35
1656228152864,MATH 20C,B01,083762,Bach; Quang Tran,1,0,30,29
1656228158889,MATH 20D,A01,083765,Tran; Brian Kha,1,0,30,29
1656228158889,MATH 20D,A02,083766,Tran; Brian Kha,0,1,30,30
1656228158889,MATH 20D,A03,083767,Tran; Brian Kha,2,0,30,28
1656228164917,MATH 20E,A01,083771,Ganguly; Soumya,3,0,32,29
1656228164917,MATH 20E,A02,083772,Ganguly; Soumya,0,0,32,32
1656228164917,MATH 20E,B01,083773,Ciotti; Benjamin,16,0,35,19
1656228164917,MATH 20E,B02,083774,Ciotti; Benjamin,15,0,35,20
1656228170942,MATH 103A,A01,083777,Greenfeld; Be'Eri,1,0,36,35
1656228170942,MATH 103A,A02,083778,Greenfeld; Be'Eri,1,0,36,35
1656228170942,MATH 103A,A03,093561,Staff,5,0,36,31
1656228170942,MATH 103A,B01,083779,Greenfeld; Be'Eri,8,0,36,28
1656228170942,MATH 103A,B02,083780,Greenfeld; Be'Eri,1,0,36,35
1656228170942,MATH 103A,B03,093562,Staff,0,0,36,36
1656228176970,MATH 105,A01,085443,Carter; Anne Toulson,5,0,35,30
1656228176970,MATH 105,A02,093477,Staff,14,0,35,21
1656228182995,MATH 109,A01,083213,Ganzberger; Geoffrey Michael,0,0,34,34
1656228182995,MATH 109,A02,083214,Ganzberger; Geoffrey Michael,0,0,34,34
1656228182995,MATH 109,A03,093478,Staff,1,0,34,33
1656228182995,MATH 109,B01,083215,Ganzberger; Geoffrey Michael,4,0,32,28
1656228182995,MATH 109,B02,083216,Ganzberger; Geoffrey Michael,1,0,32,31
1656228182995,MATH 109,B03,093479,Staff,4,0,32,28
1656228189026,MATH 142A,A01,083219,Chow; Bennett,2,0,32,30
1656228189026,MATH 142A,A02,083220,Chow; Bennett,8,0,32,24
1656228189026,MATH 142A,A03,093480,Staff,5,0,32,27
1656228189026,MATH 142A,B03,093481,Staff,3,0,32,29
1656228189026,MATH 142A,B04,093558,Staff,6,0,32,26
1656228189026,MATH 142A,B05,093559,Staff,1,0,32,31
1656228195050,MATH 193A,A01,083224,Rotar; Vladimir,0,1,34,34
1656228195050,MATH 193A,A02,083225,Rotar; Vladimir,0,0,34,34
1656228195050,MATH 193A,A03,083781,Rotar; Vladimir,0,0,34,34
1656228195050,MATH 193A,A04,083782,Rotar; Vladimir,6,0,34,28
1656228195050,MATH 193A,A05,093482,Rotar; Vladimir,0,0,34,34
1656228201074,MATH 197,001,091859,McAuley; Julian John,9999,0,9999,0
1656228201074,MATH 197,002,095566,Kedlaya; Kiran S.,9997,0,9999,2
1656228201074,MATH 197,003,095567,Xiao; Ming,9999,0,9999,0
1656228201074,MATH 197,004,095571,Perols; Johan Lars,9998,0,9999,1
1656228208135,COGS 9,A01,083615,Shannon; Kyle Michael,3,0,75,72
1656228214158,COGS 11,A01,083617,Boyle; Mary E. T.,14,0,48,34
1656228220182,COGS 13,A01,083071,Bastos; Amalia Pinkusfeld,4,0,71,67
1656228226206,COGS 14A,A01,092681,Semenuks; Arturs,0,12,100,100
1656228232233,COGS 14B,A01,083073,Cheng; Tzu-Han,7,0,63,56
1656228238256,COGS 17,A01,092677,Semenuks; Arturs,7,0,81,74
1656228244283,COGS 100,A01,083619,Allen; Michael Gordon,2,0,70,68
1656228250305,COGS 101A,A01,083621,Davis; Joshua Daniel,4,0,68,64
1656228256327,COGS 101B,A01,091572,Allen; Michael Gordon,4,0,65,61
1656228262350,COGS 101C,A01,083625,Delgado; Tania,10,0,35,25
1656228268377,COGS 107A,A01,083627,Boyle; Mary E. T.,0,0,60,60
1656228274401,COGS 118A,A01,083075,Gupta; Anjum,8,0,76,68
1656228280425,CSE 3,A50,083646,Miranda; Gregory Joseph,18,0,50,32
1656228286455,CSE 8A,A50,083650,Miranda; Gregory Joseph,2,2,56,54
1656228292478,CSE 11,A01,083080,Cao; Yingjun,0,49,40,40
1656228298500,CSE 12,A01,083652,Krause-Levy; Sophia Louisa,5,1,120,115
1656228304523,CSE 15L,A01,083654,Morris; Justin Loren,2,0,50,48
1656228304523,CSE 15L,A02,083655,Morris; Justin Loren,4,0,50,46
1656228310548,CSE 20,A01,083657,Tran; Khoa Dang,30,0,80,50
1656228316572,CSE 21,A01,095574,Bach; Quang Tran,23,0,48,25
1656228322594,CSE 30,A01,083084,Eldon; John,2,6,80,78
1656228322594,CSE 30,B01,095061,Bhaskar; Nishant,0,1,50,50
1656228328628,CSE 100,A01,083659,Cao; Yingjun,1,18,70,69
1656228334653,CSE 134B,A01,083661,Powell; Thomas Allan,5,0,100,95
1656228340676,CSE 140,A01,083663,Gungor; Onat,9,0,85,76
1656228346700,CSE 140L,A01,083088,Eldon; John,8,0,100,92
1656228352723,CSE 175,A01,083665,Kumar; Rakesh,0,0,25,25
1656228358747,CSE 190,A00,092507,Dubnov; Shlomo,3,0,20,17
1656228364770,ECE 45,A01,083139,Congero; Spencer William,1,0,75,74
1656228370793,ECE 65,A50,083695,Saad; Andrew S,9,0,30,21
1656228370793,ECE 65,A51,095125,Staff,23,0,26,3
1656228376820,ECE 109,A01,091882,Touri; Behrouz,0,1,70,70
1656228382848,ECE 180,A00,083140,Abi Samra; Nicholas Camill,1,0,30,29
1656228382848,ECE 180,B00,083141,Abi Samra; Nicholas Camill,0,4,30,30
1656228388871,MATH 10A,A01,083735,Patchell; Gregory David,0,0,30,30
1656228388871,MATH 10A,A02,083736,Patchell; Gregory David,22,0,30,8
1656228388871,MATH 10A,A03,083737,Patchell; Gregory David,16,0,30,14
1656228394895,MATH 10B,A01,083207,Lim; Seonhee,0,0,34,34
1656228394895,MATH 10B,A02,083208,Lim; Seonhee,7,0,35,28
1656228394895,MATH 10B,A03,093472,Staff,1,0,34,33
1656228394895,MATH 10B,B01,083739,Sinha; Shubham,11,0,30,19
1656228400926,MATH 18,A01,083743,Cinel; Cameron Alexander,7,0,30,23
1656228400926,MATH 18,A02,083744,Cinel; Cameron Alexander,9,0,30,21
1656228400926,MATH 18,A03,083745,Cinel; Cameron Alexander,5,0,30,25
1656228400926,MATH 18,B01,083748,Rideout; David Porter,1,0,36,35
1656228400926,MATH 18,B02,083749,Rideout; David Porter,0,0,36,36
1656228400926,MATH 18,B03,083750,Rideout; David Porter,0,0,36,36
1656228400926,MATH 18,B04,083751,Rideout; David Porter,0,1,36,36
1656228400926,MATH 18,B05,093473,Rideout; David Porter,0,0,36,36
1656228400926,MATH 18,B06,093474,Rideout; David Porter,3,0,36,33
1656228406953,MATH 20A,A01,083754,Zheng; Zequn,11,0,40,29
1656228412982,MATH 20B,A01,083756,Briones; Jor-el Thomas Caparas,0,0,36,36
1656228412982,MATH 20B,A02,083757,Briones; Jor-el Thomas Caparas,0,0,36,36
1656228412982,MATH 20B,A03,093475,Staff,0,0,36,36
1656228419010,MATH 20C,A01,083760,Briones; Jor-el Thomas Caparas,0,0,35,35
1656228419010,MATH 20C,A02,083761,Briones; Jor-el Thomas Caparas,9,1,35,26
1656228419010,MATH 20C,A03,093476,Staff,0,0,35,35
1656228419010,MATH 20C,B01,083762,Bach; Quang Tran,1,0,30,29
1656228425033,MATH 20D,A01,083765,Tran; Brian Kha,1,0,30,29
1656228425033,MATH 20D,A02,083766,Tran; Brian Kha,0,1,30,30
1656228425033,MATH 20D,A03,083767,Tran; Brian Kha,2,0,30,28
1656228431056,MATH 20E,A01,083771,Ganguly; Soumya,3,0,32,29
1656228431056,MATH 20E,A02,083772,Ganguly; Soumya,0,0,32,32
1656228431056,MATH 20E,B01,083773,Ciotti; Benjamin,16,0,35,19
1656228431056,MATH 20E,B02,083774,Ciotti; Benjamin,15,0,35,20
1656228437084,MATH 103A,A01,083777,Greenfeld; Be'Eri,1,0,36,35
1656228437084,MATH 103A,A02,083778,Greenfeld; Be'Eri,1,0,36,35
1656228437084,MATH 103A,A03,093561,Staff,5,0,36,31
1656228437084,MATH 103A,B01,083779,Greenfeld; Be'Eri,8,0,36,28
1656228437084,MATH 103A,B02,083780,Greenfeld; Be'Eri,1,0,36,35
1656228437084,MATH 103A,B03,093562,Staff,0,0,36,36
1656228443107,MATH 105,A01,085443,Carter; Anne Toulson,5,0,35,30
1656228443107,MATH 105,A02,093477,Staff,14,0,35,21
1656228449136,MATH 109,A01,083213,Ganzberger; Geoffrey Michael,0,0,34,34
1656228449136,MATH 109,A02,083214,Ganzberger; Geoffrey Michael,0,0,34,34
1656228449136,MATH 109,A03,093478,Staff,1,0,34,33
1656228449136,MATH 109,B01,083215,Ganzberger; Geoffrey Michael,4,0,32,28
1656228449136,MATH 109,B02,083216,Ganzberger; Geoffrey Michael,1,0,32,31
1656228449136,MATH 109,B03,093479,Staff,4,0,32,28
1656228455166,MATH 142A,A01,083219,Chow; Bennett,2,0,32,30
1656228455166,MATH 142A,A02,083220,Chow; Bennett,8,0,32,24
1656228455166,MATH 142A,A03,093480,Staff,5,0,32,27
1656228455166,MATH 142A,B03,093481,Staff,3,0,32,29
1656228455166,MATH 142A,B04,093558,Staff,6,0,32,26
1656228455166,MATH 142A,B05,093559,Staff,1,0,32,31
1656228461194,MATH 193A,A01,083224,Rotar; Vladimir,0,1,34,34
1656228461194,MATH 193A,A02,083225,Rotar; Vladimir,0,0,34,34
1656228461194,MATH 193A,A03,083781,Rotar; Vladimir,0,0,34,34
1656228461194,MATH 193A,A04,083782,Rotar; Vladimir,6,0,34,28
1656228461194,MATH 193A,A05,093482,Rotar; Vladimir,0,0,34,34
1656228467218,MATH 197,001,091859,McAuley; Julian John,9999,0,9999,0
1656228467218,MATH 197,002,095566,Kedlaya; Kiran S.,9997,0,9999,2
1656228467218,MATH 197,003,095567,Xiao; Ming,9999,0,9999,0
1656228467218,MATH 197,004,095571,Perols; Johan Lars,9998,0,9999,1
1656228474280,COGS 9,A01,083615,Shannon; Kyle Michael,3,0,75,72
1656228480314,COGS 11,A01,083617,Boyle; Mary E. T.,14,0,48,34
1656228486338,COGS 13,A01,083071,Bastos; Amalia Pinkusfeld,4,0,71,67
1656228492370,COGS 14A,A01,092681,Semenuks; Arturs,0,12,100,100
1656228498397,COGS 14B,A01,083073,Cheng; Tzu-Han,7,0,63,56
1656228504424,COGS 17,A01,092677,Semenuks; Arturs,7,0,81,74
1656228510448,COGS 100,A01,083619,Allen; Michael Gordon,2,0,70,68
1656228516481,COGS 101A,A01,083621,Davis; Joshua Daniel,4,0,68,64
1656228522508,COGS 101B,A01,091572,Allen; Michael Gordon,4,0,65,61
1656228528535,COGS 101C,A01,083625,Delgado; Tania,10,0,35,25
1656228534557,COGS 107A,A01,083627,Boyle; Mary E. T.,0,0,60,60
1656228540585,COGS 118A,A01,083075,Gupta; Anjum,8,0,76,68
1656228546611,CSE 3,A50,083646,Miranda; Gregory Joseph,18,0,50,32
1656228552634,CSE 8A,A50,083650,Miranda; Gregory Joseph,2,2,56,54
1656228558658,CSE 11,A01,083080,Cao; Yingjun,0,49,40,40
1656228564685,CSE 12,A01,083652,Krause-Levy; Sophia Louisa,5,1,120,115
1656228570711,CSE 15L,A01,083654,Morris; Justin Loren,2,0,50,48
1656228570711,CSE 15L,A02,083655,Morris; Justin Loren,4,0,50,46
1656228576736,CSE 20,A01,083657,Tran; Khoa Dang,30,0,80,50
1656228582759,CSE 21,A01,095574,Bach; Quang Tran,23,0,48,25
1656228588783,CSE 30,A01,083084,Eldon; John,2,6,80,78
1656228588783,CSE 30,B01,095061,Bhaskar; Nishant,0,1,50,50
1656228594806,CSE 100,A01,083659,Cao; Yingjun,1,18,70,69
1656228600829,CSE 134B,A01,083661,Powell; Thomas Allan,5,0,100,95
1656228606857,CSE 140,A01,083663,Gungor; Onat,9,0,85,76
1656228612884,CSE 140L,A01,083088,Eldon; John,8,0,100,92
1656228618910,CSE 175,A01,083665,Kumar; Rakesh,0,0,25,25
1656228624933,CSE 190,A00,092507,Dubnov; Shlomo,3,0,20,17
1656228630956,ECE 45,A01,083139,Congero; Spencer William,1,0,75,74
1656228636985,ECE 65,A50,083695,Saad; Andrew S,9,0,30,21
1656228636985,ECE 65,A51,095125,Staff,23,0,26,3
1656228643007,ECE 109,A01,091882,Touri; Behrouz,0,1,70,70
1656228649032,ECE 180,A00,083140,Abi Samra; Nicholas Camill,1,0,30,29
1656228649032,ECE 180,B00,083141,Abi Samra; Nicholas Camill,0,4,30,30
1656228655055,MATH 10A,A01,083735,Patchell; Gregory David,0,0,30,30
1656228655055,MATH 10A,A02,083736,Patchell; Gregory David,22,0,30,8
1656228655055,MATH 10A,A03,083737,Patchell; Gregory David,16,0,30,14
1656228661081,MATH 10B,A01,083207,Lim; Seonhee,0,0,34,34
1656228661081,MATH 10B,A02,083208,Lim; Seonhee,7,0,35,28
1656228661081,MATH 10B,A03,093472,Staff,1,0,34,33
1656228661081,MATH 10B,B01,083739,Sinha; Shubham,11,0,30,19
1656228667110,MATH 18,A01,083743,Cinel; Cameron Alexander,7,0,30,23
1656228667110,MATH 18,A02,083744,Cinel; Cameron Alexander,9,0,30,21
1656228667110,MATH 18,A03,083745,Cinel; Cameron Alexander,5,0,30,25
1656228667110,MATH 18,B01,083748,Rideout; David Porter,1,0,36,35
1656228667110,MATH 18,B02,083749,Rideout; David Porter,0,0,36,36
1656228667110,MATH 18,B03,083750,Rideout; David Porter,0,0,36,36
1656228667110,MATH 18,B04,083751,Rideout; David Porter,0,1,36,36
1656228667110,MATH 18,B05,093473,Rideout; David Porter,0,0,36,36
1656228667110,MATH 18,B06,093474,Rideout; David Porter,3,0,36,33
1656228673213,MATH 20A,A01,083754,Zheng; Zequn,11,0,40,29
1656228679237,MATH 20B,A01,083756,Briones; Jor-el Thomas Caparas,0,0,36,36
1656228679237,MATH 20B,A02,083757,Briones; Jor-el Thomas Caparas,0,0,36,36
1656228679237,MATH 20B,A03,093475,Staff,0,0,36,36
1656228685265,MATH 20C,A01,083760,Briones; Jor-el Thomas Caparas,0,0,35,35
1656228685265,MATH 20C,A02,083761,Briones; Jor-el Thomas Caparas,9,1,35,26
1656228685265,MATH 20C,A03,093476,Staff,0,0,35,35
1656228685265,MATH 20C,B01,083762,Bach; Quang Tran,1,0,30,29
1656228691294,MATH 20D,A01,083765,Tran; Brian Kha,1,0,30,29
1656228691294,MATH 20D,A02,083766,Tran; Brian Kha,0,1,30,30
1656228691294,MATH 20D,A03,083767,Tran; Brian Kha,2,0,30,28
1656228697326,MATH 20E,A01,083771,Ganguly; Soumya,3,0,32,29
1656228697326,MATH 20E,A02,083772,Ganguly; Soumya,0,0,32,32
1656228697326,MATH 20E,B01,083773,Ciotti; Benjamin,16,0,35,19
1656228697326,MATH 20E,B02,083774,Ciotti; Benjamin,15,0,35,20
1656228703360,MATH 103A,A01,083777,Greenfeld; Be'Eri,1,0,36,35
1656228703360,MATH 103A,A02,083778,Greenfeld; Be'Eri,1,0,36,35
1656228703360,MATH 103A,A03,093561,Staff,5,0,36,31
1656228703360,MATH 103A,B01,083779,Greenfeld; Be'Eri,8,0,36,28
1656228703360,MATH 103A,B02,083780,Greenfeld; Be'Eri,1,0,36,35
1656228703360,MATH 103A,B03,093562,Staff,0,0,36,36
1656228709388,MATH 105,A01,085443,Carter; Anne Toulson,5,0,35,30
1656228709388,MATH 105,A02,093477,Staff,14,0,35,21
1656228715411,MATH 109,A01,083213,Ganzberger; Geoffrey Michael,0,0,34,34
1656228715411,MATH 109,A02,083214,Ganzberger; Geoffrey Michael,0,0,34,34
1656228715411,MATH 109,A03,093478,Staff,1,0,34,33
1656228715411,MATH 109,B01,083215,Ganzberger; Geoffrey Michael,4,0,32,28
1656228715411,MATH 109,B02,083216,Ganzberger; Geoffrey Michael,1,0,32,31
1656228715411,MATH 109,B03,093479,Staff,4,0,32,28
1656228721450,MATH 142A,A01,083219,Chow; Bennett,2,0,32,30
1656228721450,MATH 142A,A02,083220,Chow; Bennett,8,0,32,24
1656228721450,MATH 142A,A03,093480,Staff,5,0,32,27
1656228721450,MATH 142A,B03,093481,Staff,3,0,32,29
1656228721450,MATH 142A,B04,093558,Staff,6,0,32,26
1656228721450,MATH 142A,B05,093559,Staff,1,0,32,31
1656228727479,MATH 193A,A01,083224,Rotar; Vladimir,0,1,34,34
1656228727479,MATH 193A,A02,083225,Rotar; Vladimir,0,0,34,34
1656228727479,MATH 193A,A03,083781,Rotar; Vladimir,0,0,34,34
1656228727479,MATH 193A,A04,083782,Rotar; Vladimir,6,0,34,28
1656228727479,MATH 193A,A05,093482,Rotar; Vladimir,0,0,34,34
1656228733502,MATH 197,001,091859,McAuley; Julian John,9999,0,9999,0
1656228733502,MATH 197,002,095566,Kedlaya; Kiran S.,9997,0,9999,2
1656228733502,MATH 197,003,095567,Xiao; Ming,9999,0,9999,0
1656228733502,MATH 197,004,095571,Perols; Johan Lars,9998,0,9999,1
1656228740595,COGS 9,A01,083615,Shannon; Kyle Michael,3,0,75,72
1656228746626,COGS 11,A01,083617,Boyle; Mary E. T.,14,0,48,34
1656228752650,COGS 13,A01,083071,Bastos; Amalia Pinkusfeld,4,0,71,67
1656228758674,COGS 14A,A01,092681,Semenuks; Arturs,0,12,100,100
1656228764713,COGS 14B,A01,083073,Cheng; Tzu-Han,7,0,63,56
1656228770737,COGS 17,A01,092677,Semenuks; Arturs,7,0,81,74
1656228776765,COGS 100,A01,083619,Allen; Michael Gordon,2,0,70,68
1656228782790,COGS 101A,A01,083621,Davis; Joshua Daniel,4,0,68,64
1656228788812,COGS 101B,A01,091572,Allen; Michael Gordon,4,0,65,61
1656228794839,COGS 101C,A01,083625,Delgado; Tania,10,0,35,25
1656228800867,COGS 107A,A01,083627,Boyle; Mary E. T.,0,0,60,60
1656228806889,COGS 118A,A01,083075,Gupta; Anjum,8,0,76,68
1656228812914,CSE 3,A50,083646,Miranda; Gregory Joseph,18,0,50,32
1656228818937,CSE 8A,A50,083650,Miranda; Gregory Joseph,2,2,56,54
1656228824959,CSE 11,A01,083080,Cao; Yingjun,0,49,40,40
1656228830987,CSE 12,A01,083652,Krause-Levy; Sophia Louisa,5,1,120,115
1656228837014,CSE 15L,A01,083654,Morris; Justin Loren,2,0,50,48
1656228837014,CSE 15L,A02,083655,Morris; Justin Loren,4,0,50,46
1656228843043,CSE 20,A01,083657,Tran; Khoa Dang,30,0,80,50
1656228849073,CSE 21,A01,095574,Bach; Quang Tran,23,0,48,25
1656228855112,CSE 30,A01,083084,Eldon; John,2,6,80,78
1656228855112,CSE 30,B01,095061,Bhaskar; Nishant,0,1,50,50
1656228861138,CSE 100,A01,083659,Cao; Yingjun,1,18,70,69
1656228867166,CSE 134B,A01,083661,Powell; Thomas Allan,5,0,100,95
1656228873200,CSE 140,A01,083663,Gungor; Onat,9,0,85,76
1656228879229,CSE 140L,A01,083088,Eldon; John,8,0,100,92
1656228885252,CSE 175,A01,083665,Kumar; Rakesh,0,0,25,25
1656228891279,CSE 190,A00,092507,Dubnov; Shlomo,3,0,20,17
1656228897307,ECE 45,A01,083139,Congero; Spencer William,1,0,75,74
1656228903331,ECE 65,A50,083695,Saad; Andrew S,9,0,30,21
1656228903331,ECE 65,A51,095125,Staff,23,0,26,3
1656228909371,ECE 109,A01,091882,Touri; Behrouz,0,1,70,70
1656228915397,ECE 180,A00,083140,Abi Samra; Nicholas Camill,1,0,30,29
1656228915397,ECE 180,B00,083141,Abi Samra; Nicholas Camill,0,4,30,30
1656228921427,MATH 10A,A01,083735,Patchell; Gregory David,0,0,30,30
1656228921427,MATH 10A,A02,083736,Patchell; Gregory David,22,0,30,8
1656228921427,MATH 10A,A03,083737,Patchell; Gregory David,16,0,30,14
1656228927452,MATH 10B,A01,083207,Lim; Seonhee,0,0,34,34
1656228927452,MATH 10B,A02,083208,Lim; Seonhee,7,0,35,28
1656228927452,MATH 10B,A03,093472,Staff,1,0,34,33
1656228927452,MATH 10B,B01,083739,Sinha; Shubham,11,0,30,19
1656228933476,MATH 18,A01,083743,Cinel; Cameron Alexander,7,0,30,23
1656228933476,MATH 18,A02,083744,Cinel; Cameron Alexander,9,0,30,21
1656228933476,MATH 18,A03,083745,Cinel; Cameron Alexander,5,0,30,25
1656228933476,MATH 18,B01,083748,Rideout; David Porter,1,0,36,35
1656228933476,MATH 18,B02,083749,Rideout; David Porter,0,0,36,36
1656228933476,MATH 18,B03,083750,Rideout; David Porter,0,0,36,36
1656228933476,MATH 18,B04,083751,Rideout; David Porter,0,1,36,36
1656228933476,MATH 18,B05,093473,Rideout; David Porter,0,0,36,36
1656228933476,MATH 18,B06,093474,Rideout; David Porter,3,0,36,33
1656228939499,MATH 20A,A01,083754,Zheng; Zequn,11,0,40,29
1656228945529,MATH 20B,A01,083756,Briones; Jor-el Thomas Caparas,0,0,36,36
1656228945529,MATH 20B,A02,083757,Briones; Jor-el Thomas Caparas,0,0,36,36
1656228945529,MATH 20B,A03,093475,Staff,0,0,36,36
1656228951554,MATH 20C,A01,083760,Briones; Jor-el Thomas Caparas,0,0,35,35
1656228951554,MATH 20C,A02,083761,Briones; Jor-el Thomas Caparas,9,1,35,26
1656228951554,MATH 20C,A03,093476,Staff,0,0,35,35
1656228951554,MATH 20C,B01,083762,Bach; Quang Tran,1,0,30,29
1656228957579,MATH 20D,A01,083765,Tran; Brian Kha,1,0,30,29
1656228957579,MATH 20D,A02,083766,Tran; Brian Kha,0,1,30,30
1656228957579,MATH 20D,A03,083767,Tran; Brian Kha,2,0,30,28
1656228963603,MATH 20E,A01,083771,Ganguly; Soumya,3,0,32,29
1656228963603,MATH 20E,A02,083772,Ganguly; Soumya,0,0,32,32
1656228963603,MATH 20E,B01,083773,Ciotti; Benjamin,16,0,35,19
1656228963603,MATH 20E,B02,083774,Ciotti; Benjamin,15,0,35,20
1656228969639,MATH 103A,A01,083777,Greenfeld; Be'Eri,1,0,36,35
1656228969639,MATH 103A,A02,083778,Greenfeld; Be'Eri,1,0,36,35
1656228969639,MATH 103A,A03,093561,Staff,5,0,36,31
1656228969639,MATH 103A,B01,083779,Greenfeld; Be'Eri,8,0,36,28
1656228969639,MATH 103A,B02,083780,Greenfeld; Be'Eri,1,0,36,35
1656228969639,MATH 103A,B03,093562,Staff,0,0,36,36
1656228975668,MATH 105,A01,085443,Carter; Anne Toulson,5,0,35,30
1656228975668,MATH 105,A02,093477,Staff,14,0,35,21
1656228981699,MATH 109,A01,083213,Ganzberger; Geoffrey Michael,0,0,34,34
1656228981699,MATH 109,A02,083214,Ganzberger; Geoffrey Michael,0,0,34,34
1656228981699,MATH 109,A03,093478,Staff,1,0,34,33
1656228981699,MATH 109,B01,083215,Ganzberger; Geoffrey Michael,4,0,32,28
1656228981699,MATH 109,B02,083216,Ganzberger; Geoffrey Michael,1,0,32,31
1656228981699,MATH 109,B03,093479,Staff,4,0,32,28
1656228987729,MATH 142A,A01,083219,Chow; Bennett,2,0,32,30
1656228987729,MATH 142A,A02,083220,Chow; Bennett,8,0,32,24
1656228987729,MATH 142A,A03,093480,Staff,5,0,32,27
1656228987729,MATH 142A,B03,093481,Staff,3,0,32,29
1656228987729,MATH 142A,B04,093558,Staff,6,0,32,26
1656228987729,MATH 142A,B05,093559,Staff,1,0,32,31
1656228993754,MATH 193A,A01,083224,Rotar; Vladimir,0,1,34,34
1656228993754,MATH 193A,A02,083225,Rotar; Vladimir,0,0,34,34
1656228993754,MATH 193A,A03,083781,Rotar; Vladimir,0,0,34,34
1656228993754,MATH 193A,A04,083782,Rotar; Vladimir,6,0,34,28
1656228993754,MATH 193A,A05,093482,Rotar; Vladimir,0,0,34,34
1656228999778,MATH 197,001,091859,McAuley; Julian John,9999,0,9999,0
1656228999778,MATH 197,002,095566,Kedlaya; Kiran S.,9997,0,9999,2
1656228999778,MATH 197,003,095567,Xiao; Ming,9999,0,9999,0
1656228999778,MATH 197,004,095571,Perols; Johan Lars,9998,0,9999,1
1656229006862,COGS 9,A01,083615,Shannon; Kyle Michael,3,0,75,72
1656229012890,COGS 11,A01,083617,Boyle; Mary E. T.,14,0,48,34
1656229018914,COGS 13,A01,083071,Bastos; Amalia Pinkusfeld,4,0,71,67
1656229024939,COGS 14A,A01,092681,Semenuks; Arturs,0,12,100,100
1656229030963,COGS 14B,A01,083073,Cheng; Tzu-Han,7,0,63,56
1656229036986,COGS 17,A01,092677,Semenuks; Arturs,7,0,81,74
1656229043014,COGS 100,A01,083619,Allen; Michael Gordon,2,0,70,68
1656229049038,COGS 101A,A01,083621,Davis; Joshua Daniel,4,0,68,64
1656229055060,COGS 101B,A01,091572,Allen; Michael Gordon,4,0,65,61
1656229061085,COGS 101C,A01,083625,Delgado; Tania,10,0,35,25
1656229067107,COGS 107A,A01,083627,Boyle; Mary E. T.,0,0,60,60
1656229073134,COGS 118A,A01,083075,Gupta; Anjum,8,0,76,68
1656229079159,CSE 3,A50,083646,Miranda; Gregory Joseph,18,0,50,32
1656229085184,CSE 8A,A50,083650,Miranda; Gregory Joseph,2,2,56,54
1656229091209,CSE 11,A01,083080,Cao; Yingjun,0,49,40,40
1656229097235,CSE 12,A01,083652,Krause-Levy; Sophia Louisa,5,1,120,115
1656229103264,CSE 15L,A01,083654,Morris; Justin Loren,2,0,50,48
1656229103264,CSE 15L,A02,083655,Morris; Justin Loren,4,0,50,46
1656229109288,CSE 20,A01,083657,Tran; Khoa Dang,30,0,80,50
1656229115320,CSE 21,A01,095574,Bach; Quang Tran,23,0,48,25
1656229121348,CSE 30,A01,083084,Eldon; John,2,6,80,78
1656229121348,CSE 30,B01,095061,Bhaskar; Nishant,0,1,50,50
1656229127372,CSE 100,A01,083659,Cao; Yingjun,1,18,70,69
1656229133395,CSE 134B,A01,083661,Powell; Thomas Allan,5,0,100,95
1656229139419,CSE 140,A01,083663,Gungor; Onat,9,0,85,76
1656229145444,CSE 140L,A01,083088,Eldon; John,8,0,100,92
1656229151467,CSE 175,A01,083665,Kumar; Rakesh,0,0,25,25
1656229157491,CSE 190,A00,092507,Dubnov; Shlomo,3,0,20,17
1656229163514,ECE 45,A01,083139,Congero; Spencer William,1,0,75,74
1656229169537,ECE 65,A50,083695,Saad; Andrew S,9,0,30,21
1656229169537,ECE 65,A51,095125,Staff,23,0,26,3
1656229175562,ECE 109,A01,091882,Touri; Behrouz,0,1,70,70
1656229181591,ECE 180,A00,083140,Abi Samra; Nicholas Camill,1,0,30,29
1656229181591,ECE 180,B00,083141,Abi Samra; Nicholas Camill,0,4,30,30
1656229187615,MATH 10A,A01,083735,Patchell; Gregory David,0,0,30,30
1656229187615,MATH 10A,A02,083736,Patchell; Gregory David,22,0,30,8
1656229187615,MATH 10A,A03,083737,Patchell; Gregory David,16,0,30,14
1656229193643,MATH 10B,A01,083207,Lim; Seonhee,0,0,34,34
1656229193643,MATH 10B,A02,083208,Lim; Seonhee,7,0,35,28
1656229193643,MATH 10B,A03,093472,Staff,1,0,34,33
1656229193643,MATH 10B,B01,083739,Sinha; Shubham,11,0,30,19
1656229199677,MATH 18,A01,083743,Cinel; Cameron Alexander,7,0,30,23
1656229199677,MATH 18,A02,083744,Cinel; Cameron Alexander,9,0,30,21
1656229199677,MATH 18,A03,083745,Cinel; Cameron Alexander,5,0,30,25
1656229199677,MATH 18,B01,083748,Rideout; David Porter,1,0,36,35
1656229199677,MATH 18,B02,083749,Rideout; David Porter,0,0,36,36
1656229199677,MATH 18,B03,083750,Rideout; David Porter,0,0,36,36
1656229199677,MATH 18,B04,083751,Rideout; David Porter,0,1,36,36
1656229199677,MATH 18,B05,093473,Rideout; David Porter,0,0,36,36
1656229199677,MATH 18,B06,093474,Rideout; David Porter,3,0,36,33
1656229205700,MATH 20A,A01,083754,Zheng; Zequn,11,0,40,29
1656229211724,MATH 20B,A01,083756,Briones; Jor-el Thomas Caparas,0,0,36,36
1656229211724,MATH 20B,A02,083757,Briones; Jor-el Thomas Caparas,0,0,36,36
1656229211724,MATH 20B,A03,093475,Staff,0,0,36,36
1656229217748,MATH 20C,A01,083760,Briones; Jor-el Thomas Caparas,0,0,35,35
1656229217748,MATH 20C,A02,083761,Briones; Jor-el Thomas Caparas,9,1,35,26
1656229217748,MATH 20C,A03,093476,Staff,0,0,35,35
1656229217748,MATH 20C,B01,083762,Bach; Quang Tran,1,0,30,29
1656229223772,MATH 20D,A01,083765,Tran; Brian Kha,1,0,30,29
1656229223772,MATH 20D,A02,083766,Tran; Brian Kha,0,1,30,30
1656229223772,MATH 20D,A03,083767,Tran; Brian Kha,2,0,30,28
1656229229795,MATH 20E,A01,083771,Ganguly; Soumya,3,0,32,29
1656229229795,MATH 20E,A02,083772,Ganguly; Soumya,0,0,32,32
1656229229795,MATH 20E,B01,083773,Ciotti; Benjamin,16,0,35,19
1656229229795,MATH 20E,B02,083774,Ciotti; Benjamin,15,0,35,20
1656229235826,MATH 103A,A01,083777,Greenfeld; Be'Eri,1,0,36,35
1656229235826,MATH 103A,A02,083778,Greenfeld; Be'Eri,1,0,36,35
1656229235826,MATH 103A,A03,093561,Staff,5,0,36,31
1656229235826,MATH 103A,B01,083779,Greenfeld; Be'Eri,8,0,36,28
1656229235826,MATH 103A,B02,083780,Greenfeld; Be'Eri,1,0,36,35
1656229235826,MATH 103A,B03,093562,Staff,0,0,36,36
1656229241849,MATH 105,A01,085443,Carter; Anne Toulson,5,0,35,30
1656229241849,MATH 105,A02,093477,Staff,14,0,35,21
1656229247878,MATH 109,A01,083213,Ganzberger; Geoffrey Michael,0,0,34,34
1656229247878,MATH 109,A02,083214,Ganzberger; Geoffrey Michael,0,0,34,34
1656229247878,MATH 109,A03,093478,Staff,1,0,34,33
1656229247878,MATH 109,B01,083215,Ganzberger; Geoffrey Michael,4,0,32,28
1656229247878,MATH 109,B02,083216,Ganzberger; Geoffrey Michael,1,0,32,31
1656229247878,MATH 109,B03,093479,Staff,4,0,32,28
1656229253903,MATH 142A,A01,083219,Chow; Bennett,2,0,32,30
1656229253903,MATH 142A,A02,083220,Chow; Bennett,8,0,32,24
1656229253903,MATH 142A,A03,093480,Staff,5,0,32,27
1656229253903,MATH 142A,B03,093481,Staff,3,0,32,29
1656229253903,MATH 142A,B04,093558,Staff,6,0,32,26
1656229253903,MATH 142A,B05,093559,Staff,1,0,32,31
1656229259927,MATH 193A,A01,083224,Rotar; Vladimir,0,1,34,34
1656229259927,MATH 193A,A02,083225,Rotar; Vladimir,0,0,34,34
1656229259927,MATH 193A,A03,083781,Rotar; Vladimir,0,0,34,34
1656229259927,MATH 193A,A04,083782,Rotar; Vladimir,6,0,34,28
1656229259927,MATH 193A,A05,093482,Rotar; Vladimir,0,0,34,34
1656229265951,MATH 197,001,091859,McAuley; Julian John,9999,0,9999,0
1656229265951,MATH 197,002,095566,Kedlaya; Kiran S.,9997,0,9999,2
1656229265951,MATH 197,003,095567,Xiao; Ming,9999,0,9999,0
1656229265951,MATH 197,004,095571,Perols; Johan Lars,9998,0,9999,1
1656229273082,COGS 9,A01,083615,Shannon; Kyle Michael,3,0,75,72
1656229279115,COGS 11,A01,083617,Boyle; Mary E. T.,14,0,48,34
1656229285148,COGS 13,A01,083071,Bastos; Amalia Pinkusfeld,4,0,71,67
1656229291177,COGS 14A,A01,092681,Semenuks; Arturs,0,12,100,100
1656229297205,COGS 14B,A01,083073,Cheng; Tzu-Han,7,0,63,56
1656229303229,COGS 17,A01,092677,Semenuks; Arturs,7,0,81,74
1656229309257,COGS 100,A01,083619,Allen; Michael Gordon,2,0,70,68
1656229315280,COGS 101A,A01,083621,Davis; Joshua Daniel,4,0,68,64
1656229321302,COGS 101B,A01,091572,Allen; Michael Gordon,4,0,65,61
1656229327325,COGS 101C,A01,083625,Delgado; Tania,10,0,35,25
1656229333347,COGS 107A,A01,083627,Boyle; Mary E. T.,0,0,60,60
1656229339370,COGS 118A,A01,083075,Gupta; Anjum,8,0,76,68
1656229345395,CSE 3,A50,083646,Miranda; Gregory Joseph,18,0,50,32
1656229351419,CSE 8A,A50,083650,Miranda; Gregory Joseph,2,2,56,54
1656229357441,CSE 11,A01,083080,Cao; Yingjun,0,49,40,40
1656229363466,CSE 12,A01,083652,Krause-Levy; Sophia Louisa,5,1,120,115
1656229369488,CSE 15L,A01,083654,Morris; Justin Loren,2,0,50,48
1656229369488,CSE 15L,A02,083655,Morris; Justin Loren,4,0,50,46
1656229375509,CSE 20,A01,083657,Tran; Khoa Dang,30,0,80,50
1656229381533,CSE 21,A01,095574,Bach; Quang Tran,23,0,48,25
1656229387556,CSE 30,A01,083084,Eldon; John,2,6,80,78
1656229387556,CSE 30,B01,095061,Bhaskar; Nishant,0,1,50,50
1656229393579,CSE 100,A01,083659,Cao; Yingjun,1,18,70,69
1656229399602,CSE 134B,A01,083661,Powell; Thomas Allan,5,0,100,95
1656229405629,CSE 140,A01,083663,Gungor; Onat,9,0,85,76
1656229411652,CSE 140L,A01,083088,Eldon; John,8,0,100,92
1656229417676,CSE 175,A01,083665,Kumar; Rakesh,0,0,25,25
1656229423703,CSE 190,A00,092507,Dubnov; Shlomo,3,0,20,17
1656229429726,ECE 45,A01,083139,Congero; Spencer William,1,0,75,74
1656229435750,ECE 65,A50,083695,Saad; Andrew S,9,0,30,21
1656229435750,ECE 65,A51,095125,Staff,23,0,26,3
1656229441776,ECE 109,A01,091882,Touri; Behrouz,0,1,70,70
1656229447799,ECE 180,A00,083140,Abi Samra; Nicholas Camill,1,0,30,29
1656229447799,ECE 180,B00,083141,Abi Samra; Nicholas Camill,0,4,30,30
1656229453821,MATH 10A,A01,083735,Patchell; Gregory David,0,0,30,30
1656229453821,MATH 10A,A02,083736,Patchell; Gregory David,22,0,30,8
1656229453821,MATH 10A,A03,083737,Patchell; Gregory David,16,0,30,14
1656229459847,MATH 10B,A01,083207,Lim; Seonhee,0,0,34,34
1656229459847,MATH 10B,A02,083208,Lim; Seonhee,7,0,35,28
1656229459847,MATH 10B,A03,093472,Staff,1,0,34,33
1656229459847,MATH 10B,B01,083739,Sinha; Shubham,11,0,30,19
1656229465876,MATH 18,A01,083743,Cinel; Cameron Alexander,7,0,30,23
1656229465876,MATH 18,A02,083744,Cinel; Cameron Alexander,9,0,30,21
1656229465876,MATH 18,A03,083745,Cinel; Cameron Alexander,5,0,30,25
1656229465876,MATH 18,B01,083748,Rideout; David Porter,1,0,36,35
1656229465876,MATH 18,B02,083749,Rideout; David Porter,0,0,36,36
1656229465876,MATH 18,B03,083750,Rideout; David Porter,0,0,36,36
1656229465876,MATH 18,B04,083751,Rideout; David Porter,0,1,36,36
1656229465876,MATH 18,B05,093473,Rideout; David Porter,0,0,36,36
1656229465876,MATH 18,B06,093474,Rideout; David Porter,3,0,36,33
1656229471902,MATH 20A,A01,083754,Zheng; Zequn,11,0,40,29
1656229477930,MATH 20B,A01,083756,Briones; Jor-el Thomas Caparas,0,0,36,36
1656229477930,MATH 20B,A02,083757,Briones; Jor-el Thomas Caparas,0,0,36,36
1656229477930,MATH 20B,A03,093475,Staff,0,0,36,36
1656229483957,MATH 20C,A01,083760,Briones; Jor-el Thomas Caparas,0,0,35,35
1656229483957,MATH 20C,A02,083761,Briones; Jor-el Thomas Caparas,9,1,35,26
1656229483957,MATH 20C,A03,093476,Staff,0,0,35,35
1656229483957,MATH 20C,B01,083762,Bach; Quang Tran,1,0,30,29
1656229489980,MATH 20D,A01,083765,Tran; Brian Kha,1,0,30,29
1656229489980,MATH 20D,A02,083766,Tran; Brian Kha,0,1,30,30
1656229489980,MATH 20D,A03,083767,Tran; Brian Kha,2,0,30,28
1656229496010,MATH 20E,A01,083771,Ganguly; Soumya,3,0,32,29
1656229496010,MATH 20E,A02,083772,Ganguly; Soumya,0,0,32,32
1656229496010,MATH 20E,B01,083773,Ciotti; Benjamin,16,0,35,19
1656229496010,MATH 20E,B02,083774,Ciotti; Benjamin,15,0,35,20
1656229502039,MATH 103A,A01,083777,Greenfeld; Be'Eri,1,0,36,35
1656229502039,MATH 103A,A02,083778,Greenfeld; Be'Eri,1,0,36,35
1656229502039,MATH 103A,A03,093561,Staff,5,0,36,31
1656229502039,MATH 103A,B01,083779,Greenfeld; Be'Eri,8,0,36,28
1656229502039,MATH 103A,B02,083780,Greenfeld; Be'Eri,1,0,36,35
1656229502039,MATH 103A,B03,093562,Staff,0,0,36,36
1656229508064,MATH 105,A01,085443,Carter; Anne Toulson,5,0,35,30
1656229508064,MATH 105,A02,093477,Staff,14,0,35,21
1656229514088,MATH 109,A01,083213,Ganzberger; Geoffrey Michael,0,0,34,34
1656229514088,MATH 109,A02,083214,Ganzberger; Geoffrey Michael,0,0,34,34
1656229514088,MATH 109,A03,093478,Staff,1,0,34,33
1656229514088,MATH 109,B01,083215,Ganzberger; Geoffrey Michael,4,0,32,28
1656229514088,MATH 109,B02,083216,Ganzberger; Geoffrey Michael,1,0,32,31
1656229514088,MATH 109,B03,093479,Staff,4,0,32,28
1656229520111,MATH 142A,A01,083219,Chow; Bennett,2,0,32,30
1656229520111,MATH 142A,A02,083220,Chow; Bennett,8,0,32,24
1656229520111,MATH 142A,A03,093480,Staff,5,0,32,27
1656229520111,MATH 142A,B03,093481,Staff,3,0,32,29
1656229520111,MATH 142A,B04,093558,Staff,6,0,32,26
1656229520111,MATH 142A,B05,093559,Staff,1,0,32,31
1656229526136,MATH 193A,A01,083224,Rotar; Vladimir,0,1,34,34
1656229526136,MATH 193A,A02,083225,Rotar; Vladimir,0,0,34,34
1656229526136,MATH 193A,A03,083781,Rotar; Vladimir,0,0,34,34
1656229526136,MATH 193A,A04,083782,Rotar; Vladimir,6,0,34,28
1656229526136,MATH 193A,A05,093482,Rotar; Vladimir,0,0,34,34
1656229532161,MATH 197,001,091859,McAuley; Julian John,9999,0,9999,0
1656229532161,MATH 197,002,095566,Kedlaya; Kiran S.,9997,0,9999,2
1656229532161,MATH 197,003,095567,Xiao; Ming,9999,0,9999,0
1656229532161,MATH 197,004,095571,Perols; Johan Lars,9998,0,9999,1
1656229539215,COGS 9,A01,083615,Shannon; Kyle Michael,3,0,75,72
1656229545239,COGS 11,A01,083617,Boyle; Mary E. T.,14,0,48,34
1656229551265,COGS 13,A01,083071,Bastos; Amalia Pinkusfeld,4,0,71,67
1656229557288,COGS 14A,A01,092681,Semenuks; Arturs,0,12,100,100
1656229563311,COGS 14B,A01,083073,Cheng; Tzu-Han,7,0,63,56
1656229569337,COGS 17,A01,092677,Semenuks; Arturs,7,0,81,74
1656229575363,COGS 100,A01,083619,Allen; Michael Gordon,2,0,70,68
1656229581387,COGS 101A,A01,083621,Davis; Joshua Daniel,4,0,68,64
1656229587410,COGS 101B,A01,091572,Allen; Michael Gordon,4,0,65,61
1656229593438,COGS 101C,A01,083625,Delgado; Tania,10,0,35,25
1656229599465,COGS 107A,A01,083627,Boyle; Mary E. T.,0,0,60,60
1656229605486,COGS 118A,A01,083075,Gupta; Anjum,8,0,76,68
1656229611515,CSE 3,A50,083646,Miranda; Gregory Joseph,18,0,50,32
1656229617541,CSE 8A,A50,083650,Miranda; Gregory Joseph,2,2,56,54
1656229623565,CSE 11,A01,083080,Cao; Yingjun,0,49,40,40
1656229629588,CSE 12,A01,083652,Krause-Levy; Sophia Louisa,5,1,120,115
1656229635621,CSE 15L,A01,083654,Morris; Justin Loren,2,0,50,48
1656229635621,CSE 15L,A02,083655,Morris; Justin Loren,4,0,50,46
1656229641644,CSE 20,A01,083657,Tran; Khoa Dang,30,0,80,50
1656229647667,CSE 21,A01,095574,Bach; Quang Tran,23,0,48,25
1656229653690,CSE 30,A01,083084,Eldon; John,2,6,80,78
1656229653690,CSE 30,B01,095061,Bhaskar; Nishant,0,1,50,50
1656229659718,CSE 100,A01,083659,Cao; Yingjun,1,18,70,69
1656229665745,CSE 134B,A01,083661,Powell; Thomas Allan,5,0,100,95
1656229671768,CSE 140,A01,083663,Gungor; Onat,9,0,85,76
1656229677790,CSE 140L,A01,083088,Eldon; John,8,0,100,92
1656229683812,CSE 175,A01,083665,Kumar; Rakesh,0,0,25,25
1656229689839,CSE 190,A00,092507,Dubnov; Shlomo,3,0,20,17
1656229695865,ECE 45,A01,083139,Congero; Spencer William,1,0,75,74
1656229701894,ECE 65,A50,083695,Saad; Andrew S,9,0,30,21
1656229701894,ECE 65,A51,095125,Staff,23,0,26,3
1656229707916,ECE 109,A01,091882,Touri; Behrouz,0,1,70,70
1656229713940,ECE 180,A00,083140,Abi Samra; Nicholas Camill,1,0,30,29
1656229713940,ECE 180,B00,083141,Abi Samra; Nicholas Camill,0,4,30,30
1656229719963,MATH 10A,A01,083735,Patchell; Gregory David,0,0,30,30
1656229719963,MATH 10A,A02,083736,Patchell; Gregory David,22,0,30,8
1656229719963,MATH 10A,A03,083737,Patchell; Gregory David,16,0,30,14
1656229725987,MATH 10B,A01,083207,Lim; Seonhee,0,0,34,34
1656229725987,MATH 10B,A02,083208,Lim; Seonhee,7,0,35,28
1656229725987,MATH 10B,A03,093472,Staff,1,0,34,33
1656229725987,MATH 10B,B01,083739,Sinha; Shubham,11,0,30,19
1656229732012,MATH 18,A01,083743,Cinel; Cameron Alexander,7,0,30,23
1656229732012,MATH 18,A02,083744,Cinel; Cameron Alexander,9,0,30,21
1656229732012,MATH 18,A03,083745,Cinel; Cameron Alexander,5,0,30,25
1656229732012,MATH 18,B01,083748,Rideout; David Porter,1,0,36,35
1656229732012,MATH 18,B02,083749,Rideout; David Porter,0,0,36,36
1656229732012,MATH 18,B03,083750,Rideout; David Porter,0,0,36,36
1656229732012,MATH 18,B04,083751,Rideout; David Porter,0,1,36,36
1656229732012,MATH 18,B05,093473,Rideout; David Porter,0,0,36,36
1656229732012,MATH 18,B06,093474,Rideout; David Porter,3,0,36,33
1656229738037,MATH 20A,A01,083754,Zheng; Zequn,11,0,40,29
1656229744071,MATH 20B,A01,083756,Briones; Jor-el Thomas Caparas,0,0,36,36
1656229744071,MATH 20B,A02,083757,Briones; Jor-el Thomas Caparas,0,0,36,36
1656229744071,MATH 20B,A03,093475,Staff,0,0,36,36
1656229750096,MATH 20C,A01,083760,Briones; Jor-el Thomas Caparas,0,0,35,35
1656229750096,MATH 20C,A02,083761,Briones; Jor-el Thomas Caparas,9,1,35,26
1656229750096,MATH 20C,A03,093476,Staff,0,0,35,35
1656229750096,MATH 20C,B01,083762,Bach; Quang Tran,1,0,30,29
1656229756120,MATH 20D,A01,083765,Tran; Brian Kha,1,0,30,29
1656229756120,MATH 20D,A02,083766,Tran; Brian Kha,0,1,30,30
1656229756120,MATH 20D,A03,083767,Tran; Brian Kha,2,0,30,28
1656229762152,MATH 20E,A01,083771,Ganguly; Soumya,3,0,32,29
1656229762152,MATH 20E,A02,083772,Ganguly; Soumya,0,0,32,32
1656229762152,MATH 20E,B01,083773,Ciotti; Benjamin,16,0,35,19
1656229762152,MATH 20E,B02,083774,Ciotti; Benjamin,15,0,35,20
1656229768175,MATH 103A,A01,083777,Greenfeld; Be'Eri,1,0,36,35
1656229768175,MATH 103A,A02,083778,Greenfeld; Be'Eri,1,0,36,35
1656229768175,MATH 103A,A03,093561,Staff,5,0,36,31
1656229768175,MATH 103A,B01,083779,Greenfeld; Be'Eri,8,0,36,28
1656229768175,MATH 103A,B02,083780,Greenfeld; Be'Eri,1,0,36,35
1656229768175,MATH 103A,B03,093562,Staff,0,0,36,36
1656229774197,MATH 105,A01,085443,Carter; Anne Toulson,5,0,35,30
1656229774197,MATH 105,A02,093477,Staff,14,0,35,21
1656229780221,MATH 109,A01,083213,Ganzberger; Geoffrey Michael,0,0,34,34
1656229780221,MATH 109,A02,083214,Ganzberger; Geoffrey Michael,0,0,34,34
1656229780221,MATH 109,A03,093478,Staff,1,0,34,33
1656229780221,MATH 109,B01,083215,Ganzberger; Geoffrey Michael,4,0,32,28
1656229780221,MATH 109,B02,083216,Ganzberger; Geoffrey Michael,1,0,32,31
1656229780221,MATH 109,B03,093479,Staff,4,0,32,28
1656229786250,MATH 142A,A01,083219,Chow; Bennett,2,0,32,30
1656229786250,MATH 142A,A02,083220,Chow; Bennett,8,0,32,24
1656229786250,MATH 142A,A03,093480,Staff,5,0,32,27
1656229786250,MATH 142A,B03,093481,Staff,3,0,32,29
1656229786250,MATH 142A,B04,093558,Staff,6,0,32,26
1656229786250,MATH 142A,B05,093559,Staff,1,0,32,31
1656229792274,MATH 193A,A01,083224,Rotar; Vladimir,0,1,34,34
1656229792274,MATH 193A,A02,083225,Rotar; Vladimir,0,0,34,34
1656229792274,MATH 193A,A03,083781,Rotar; Vladimir,0,0,34,34
1656229792274,MATH 193A,A04,083782,Rotar; Vladimir,6,0,34,28
1656229792274,MATH 193A,A05,093482,Rotar; Vladimir,0,0,34,34
1656229798296,MATH 197,001,091859,McAuley; Julian John,9999,0,9999,0
1656229798296,MATH 197,002,095566,Kedlaya; Kiran S.,9997,0,9999,2
1656229798296,MATH 197,003,095567,Xiao; Ming,9999,0,9999,0
1656229798296,MATH 197,004,095571,Perols; Johan Lars,9998,0,9999,1
1656229805353,COGS 9,A01,083615,Shannon; Kyle Michael,3,0,75,72
1656229811379,COGS 11,A01,083617,Boyle; Mary E. T.,14,0,48,34
1656229817406,COGS 13,A01,083071,Bastos; Amalia Pinkusfeld,4,0,71,67
1656229823430,COGS 14A,A01,092681,Semenuks; Arturs,0,12,100,100
1656229829453,COGS 14B,A01,083073,Cheng; Tzu-Han,7,0,63,56
1656229835477,COGS 17,A01,092677,Semenuks; Arturs,7,0,81,74
1656229841505,COGS 100,A01,083619,Allen; Michael Gordon,2,0,70,68
1656229847531,COGS 101A,A01,083621,Davis; Joshua Daniel,4,0,68,64
1656229853554,COGS 101B,A01,091572,Allen; Michael Gordon,4,0,65,61
1656229859581,COGS 101C,A01,083625,Delgado; Tania,10,0,35,25
1656229865680,COGS 107A,A01,083627,Boyle; Mary E. T.,0,0,60,60
1656229871705,COGS 118A,A01,083075,Gupta; Anjum,8,0,76,68
1656229877734,CSE 3,A50,083646,Miranda; Gregory Joseph,18,0,50,32
1656229883760,CSE 8A,A50,083650,Miranda; Gregory Joseph,2,2,56,54
1656229889783,CSE 11,A01,083080,Cao; Yingjun,0,49,40,40
1656229895805,CSE 12,A01,083652,Krause-Levy; Sophia Louisa,5,1,120,115
1656229901827,CSE 15L,A01,083654,Morris; Justin Loren,2,0,50,48
1656229901827,CSE 15L,A02,083655,Morris; Justin Loren,4,0,50,46
1656229907850,CSE 20,A01,083657,Tran; Khoa Dang,30,0,80,50
1656229913872,CSE 21,A01,095574,Bach; Quang Tran,23,0,48,25
1656229919900,CSE 30,A01,083084,Eldon; John,2,6,80,78
1656229919900,CSE 30,B01,095061,Bhaskar; Nishant,0,1,50,50
1656229925928,CSE 100,A01,083659,Cao; Yingjun,1,18,70,69
1656229931954,CSE 134B,A01,083661,Powell; Thomas Allan,5,0,100,95
1656229937979,CSE 140,A01,083663,Gungor; Onat,9,0,85,76
1656229944006,CSE 140L,A01,083088,Eldon; John,8,0,100,92
1656229950031,CSE 175,A01,083665,Kumar; Rakesh,0,0,25,25
1656229956060,CSE 190,A00,092507,Dubnov; Shlomo,3,0,20,17
1656229962084,ECE 45,A01,083139,Congero; Spencer William,1,0,75,74
1656229968110,ECE 65,A50,083695,Saad; Andrew S,9,0,30,21
1656229968110,ECE 65,A51,095125,Staff,23,0,26,3
1656229974136,ECE 109,A01,091882,Touri; Behrouz,0,1,70,70
1656229980161,ECE 180,A00,083140,Abi Samra; Nicholas Camill,1,0,30,29
1656229980161,ECE 180,B00,083141,Abi Samra; Nicholas Camill,0,4,30,30
1656229986188,MATH 10A,A01,083735,Patchell; Gregory David,0,0,30,30
1656229986188,MATH 10A,A02,083736,Patchell; Gregory David,22,0,30,8
1656229986188,MATH 10A,A03,083737,Patchell; Gregory David,16,0,30,14
1656229992218,MATH 10B,A01,083207,Lim; Seonhee,0,0,34,34
1656229992218,MATH 10B,A02,083208,Lim; Seonhee,7,0,35,28
1656229992218,MATH 10B,A03,093472,Staff,1,0,34,33
1656229992218,MATH 10B,B01,083739,Sinha; Shubham,11,0,30,19
1656229998251,MATH 18,A01,083743,Cinel; Cameron Alexander,7,0,30,23
1656229998251,MATH 18,A02,083744,Cinel; Cameron Alexander,9,0,30,21
1656229998251,MATH 18,A03,083745,Cinel; Cameron Alexander,5,0,30,25
1656229998251,MATH 18,B01,083748,Rideout; David Porter,1,0,36,35
1656229998251,MATH 18,B02,083749,Rideout; David Porter,0,0,36,36
1656229998251,MATH 18,B03,083750,Rideout; David Porter,0,0,36,36
1656229998251,MATH 18,B04,083751,Rideout; David Porter,0,1,36,36
1656229998251,MATH 18,B05,093473,Rideout; David Porter,0,0,36,36
1656229998251,MATH 18,B06,093474,Rideout; David Porter,3,0,36,33
1656230004273,MATH 20A,A01,083754,Zheng; Zequn,11,0,40,29
1656230010298,MATH 20B,A01,083756,Briones; Jor-el Thomas Caparas,0,0,36,36
1656230010298,MATH 20B,A02,083757,Briones; Jor-el Thomas Caparas,0,0,36,36
1656230010298,MATH 20B,A03,093475,Staff,0,0,36,36
1656230016327,MATH 20C,A01,083760,Briones; Jor-el Thomas Caparas,0,0,35,35
1656230016327,MATH 20C,A02,083761,Briones; Jor-el Thomas Caparas,9,1,35,26
1656230016327,MATH 20C,A03,093476,Staff,0,0,35,35
1656230016327,MATH 20C,B01,083762,Bach; Quang Tran,1,0,30,29
1656230022355,MATH 20D,A01,083765,Tran; Brian Kha,1,0,30,29
1656230022355,MATH 20D,A02,083766,Tran; Brian Kha,0,1,30,30
1656230022355,MATH 20D,A03,083767,Tran; Brian Kha,2,0,30,28
1656230028380,MATH 20E,A01,083771,Ganguly; Soumya,3,0,32,29
1656230028380,MATH 20E,A02,083772,Ganguly; Soumya,0,0,32,32
1656230028380,MATH 20E,B01,083773,Ciotti; Benjamin,16,0,35,19
1656230028380,MATH 20E,B02,083774,Ciotti; Benjamin,15,0,35,20
1656230034410,MATH 103A,A01,083777,Greenfeld; Be'Eri,1,0,36,35
1656230034410,MATH 103A,A02,083778,Greenfeld; Be'Eri,1,0,36,35
1656230034410,MATH 103A,A03,093561,Staff,5,0,36,31
1656230034410,MATH 103A,B01,083779,Greenfeld; Be'Eri,8,0,36,28
1656230034410,MATH 103A,B02,083780,Greenfeld; Be'Eri,1,0,36,35
1656230034410,MATH 103A,B03,093562,Staff,0,0,36,36
1656230040438,MATH 105,A01,085443,Carter; Anne Toulson,5,0,35,30
1656230040438,MATH 105,A02,093477,Staff,14,0,35,21
1656230046462,MATH 109,A01,083213,Ganzberger; Geoffrey Michael,0,0,34,34
1656230046462,MATH 109,A02,083214,Ganzberger; Geoffrey Michael,0,0,34,34
1656230046462,MATH 109,A03,093478,Staff,1,0,34,33
1656230046462,MATH 109,B01,083215,Ganzberger; Geoffrey Michael,4,0,32,28
1656230046462,MATH 109,B02,083216,Ganzberger; Geoffrey Michael,1,0,32,31
1656230046462,MATH 109,B03,093479,Staff,4,0,32,28
1656230052491,MATH 142A,A01,083219,Chow; Bennett,2,0,32,30
1656230052491,MATH 142A,A02,083220,Chow; Bennett,8,0,32,24
1656230052491,MATH 142A,A03,093480,Staff,5,0,32,27
1656230052491,MATH 142A,B03,093481,Staff,3,0,32,29
1656230052491,MATH 142A,B04,093558,Staff,6,0,32,26
1656230052491,MATH 142A,B05,093559,Staff,1,0,32,31
1656230058522,MATH 193A,A01,083224,Rotar; Vladimir,0,1,34,34
1656230058522,MATH 193A,A02,083225,Rotar; Vladimir,0,0,34,34
1656230058522,MATH 193A,A03,083781,Rotar; Vladimir,0,0,34,34
1656230058522,MATH 193A,A04,083782,Rotar; Vladimir,6,0,34,28
1656230058522,MATH 193A,A05,093482,Rotar; Vladimir,0,0,34,34
1656230064549,MATH 197,001,091859,McAuley; Julian John,9999,0,9999,0
1656230064549,MATH 197,002,095566,Kedlaya; Kiran S.,9997,0,9999,2
1656230064549,MATH 197,003,095567,Xiao; Ming,9999,0,9999,0
1656230064549,MATH 197,004,095571,Perols; Johan Lars,9998,0,9999,1
1656230071612,COGS 9,A01,083615,Shannon; Kyle Michael,3,0,75,72
1656230077638,COGS 11,A01,083617,Boyle; Mary E. T.,14,0,48,34
1656230083660,COGS 13,A01,083071,Bastos; Amalia Pinkusfeld,4,0,71,67
1656230089689,COGS 14A,A01,092681,Semenuks; Arturs,0,12,100,100
1656230095716,COGS 14B,A01,083073,Cheng; Tzu-Han,7,0,63,56
1656230101739,COGS 17,A01,092677,Semenuks; Arturs,7,0,81,74
1656230107765,COGS 100,A01,083619,Allen; Michael Gordon,2,0,70,68
1656230113792,COGS 101A,A01,083621,Davis; Joshua Daniel,4,0,68,64
1656230119816,COGS 101B,A01,091572,Allen; Michael Gordon,4,0,65,61
1656230125843,COGS 101C,A01,083625,Delgado; Tania,10,0,35,25
1656230131869,COGS 107A,A01,083627,Boyle; Mary E. T.,0,0,60,60
1656230137895,COGS 118A,A01,083075,Gupta; Anjum,8,0,76,68
1656230143923,CSE 3,A50,083646,Miranda; Gregory Joseph,18,0,50,32
1656230149951,CSE 8A,A50,083650,Miranda; Gregory Joseph,2,2,56,54
1656230155978,CSE 11,A01,083080,Cao; Yingjun,0,49,40,40
1656230162002,CSE 12,A01,083652,Krause-Levy; Sophia Louisa,5,1,120,115
1656230168025,CSE 15L,A01,083654,Morris; Justin Loren,2,0,50,48
1656230168025,CSE 15L,A02,083655,Morris; Justin Loren,4,0,50,46
1656230174050,CSE 20,A01,083657,Tran; Khoa Dang,30,0,80,50
1656230180073,CSE 21,A01,095574,Bach; Quang Tran,23,0,48,25
1656230186096,CSE 30,A01,083084,Eldon; John,2,6,80,78
1656230186096,CSE 30,B01,095061,Bhaskar; Nishant,0,1,50,50
1656230192123,CSE 100,A01,083659,Cao; Yingjun,1,18,70,69
1656230198146,CSE 134B,A01,083661,Powell; Thomas Allan,5,0,100,95
1656230204170,CSE 140,A01,083663,Gungor; Onat,9,0,85,76
1656230210196,CSE 140L,A01,083088,Eldon; John,8,0,100,92
1656230216230,CSE 175,A01,083665,Kumar; Rakesh,0,0,25,25
1656230222252,CSE 190,A00,092507,Dubnov; Shlomo,3,0,20,17
1656230228277,ECE 45,A01,083139,Congero; Spencer William,1,0,75,74
1656230234300,ECE 65,A50,083695,Saad; Andrew S,9,0,30,21
1656230234300,ECE 65,A51,095125,Staff,23,0,26,3
1656230240324,ECE 109,A01,091882,Touri; Behrouz,0,1,70,70
1656230246348,ECE 180,A00,083140,Abi Samra; Nicholas Camill,1,0,30,29
1656230246348,ECE 180,B00,083141,Abi Samra; Nicholas Camill,0,4,30,30
1656230252371,MATH 10A,A01,083735,Patchell; Gregory David,0,0,30,30
1656230252371,MATH 10A,A02,083736,Patchell; Gregory David,22,0,30,8
1656230252371,MATH 10A,A03,083737,Patchell; Gregory David,16,0,30,14
1656230258394,MATH 10B,A01,083207,Lim; Seonhee,0,0,34,34
1656230258394,MATH 10B,A02,083208,Lim; Seonhee,7,0,35,28
1656230258394,MATH 10B,A03,093472,Staff,1,0,34,33
1656230258394,MATH 10B,B01,083739,Sinha; Shubham,11,0,30,19
1656230264438,MATH 18,A01,083743,Cinel; Cameron Alexander,7,0,30,23
1656230264438,MATH 18,A02,083744,Cinel; Cameron Alexander,9,0,30,21
1656230264438,MATH 18,A03,083745,Cinel; Cameron Alexander,5,0,30,25
1656230264438,MATH 18,B01,083748,Rideout; David Porter,1,0,36,35
1656230264438,MATH 18,B02,083749,Rideout; David Porter,0,0,36,36
1656230264438,MATH 18,B03,083750,Rideout; David Porter,0,0,36,36
1656230264438,MATH 18,B04,083751,Rideout; David Porter,0,1,36,36
1656230264438,MATH 18,B05,093473,Rideout; David Porter,0,0,36,36
1656230264438,MATH 18,B06,093474,Rideout; David Porter,3,0,36,33
1656230270465,MATH 20A,A01,083754,Zheng; Zequn,11,0,40,29
1656230276489,MATH 20B,A01,083756,Briones; Jor-el Thomas Caparas,0,0,36,36
1656230276489,MATH 20B,A02,083757,Briones; Jor-el Thomas Caparas,0,0,36,36
1656230276489,MATH 20B,A03,093475,Staff,0,0,36,36
1656230282517,MATH 20C,A01,083760,Briones; Jor-el Thomas Caparas,0,0,35,35
1656230282517,MATH 20C,A02,083761,Briones; Jor-el Thomas Caparas,9,1,35,26
1656230282517,MATH 20C,A03,093476,Staff,0,0,35,35
1656230282517,MATH 20C,B01,083762,Bach; Quang Tran,1,0,30,29
1656230288545,MATH 20D,A01,083765,Tran; Brian Kha,1,0,30,29
1656230288545,MATH 20D,A02,083766,Tran; Brian Kha,0,1,30,30
1656230288545,MATH 20D,A03,083767,Tran; Brian Kha,2,0,30,28
1656230294569,MATH 20E,A01,083771,Ganguly; Soumya,3,0,32,29
1656230294569,MATH 20E,A02,083772,Ganguly; Soumya,0,0,32,32
1656230294569,MATH 20E,B01,083773,Ciotti; Benjamin,16,0,35,19
1656230294569,MATH 20E,B02,083774,Ciotti; Benjamin,15,0,35,20
1656230300597,MATH 103A,A01,083777,Greenfeld; Be'Eri,1,0,36,35
1656230300597,MATH 103A,A02,083778,Greenfeld; Be'Eri,1,0,36,35
1656230300597,MATH 103A,A03,093561,Staff,5,0,36,31
1656230300597,MATH 103A,B01,083779,Greenfeld; Be'Eri,8,0,36,28
1656230300597,MATH 103A,B02,083780,Greenfeld; Be'Eri,1,0,36,35
1656230300597,MATH 103A,B03,093562,Staff,0,0,36,36
1656230306620,MATH 105,A01,085443,Carter; Anne Toulson,5,0,35,30
1656230306620,MATH 105,A02,093477,Staff,14,0,35,21
1656230312649,MATH 109,A01,083213,Ganzberger; Geoffrey Michael,0,0,34,34
1656230312649,MATH 109,A02,083214,Ganzberger; Geoffrey Michael,0,0,34,34
1656230312649,MATH 109,A03,093478,Staff,1,0,34,33
1656230312649,MATH 109,B01,083215,Ganzberger; Geoffrey Michael,4,0,32,28
1656230312649,MATH 109,B02,083216,Ganzberger; Geoffrey Michael,1,0,32,31
1656230312649,MATH 109,B03,093479,Staff,4,0,32,28
1656230318675,MATH 142A,A01,083219,Chow; Bennett,2,0,32,30
1656230318675,MATH 142A,A02,083220,Chow; Bennett,8,0,32,24
1656230318675,MATH 142A,A03,093480,Staff,5,0,32,27
1656230318675,MATH 142A,B03,093481,Staff,3,0,32,29
1656230318675,MATH 142A,B04,093558,Staff,6,0,32,26
1656230318675,MATH 142A,B05,093559,Staff,1,0,32,31
1656230324699,MATH 193A,A01,083224,Rotar; Vladimir,0,1,34,34
1656230324699,MATH 193A,A02,083225,Rotar; Vladimir,0,0,34,34
1656230324699,MATH 193A,A03,083781,Rotar; Vladimir,0,0,34,34
1656230324699,MATH 193A,A04,083782,Rotar; Vladimir,6,0,34,28
1656230324699,MATH 193A,A05,093482,Rotar; Vladimir,0,0,34,34
1656230330726,MATH 197,001,091859,McAuley; Julian John,9999,0,9999,0
1656230330726,MATH 197,002,095566,Kedlaya; Kiran S.,9997,0,9999,2
1656230330726,MATH 197,003,095567,Xiao; Ming,9999,0,9999,0
1656230330726,MATH 197,004,095571,Perols; Johan Lars,9998,0,9999,1
1656230337795,COGS 9,A01,083615,Shannon; Kyle Michael,3,0,75,72
1656230343819,COGS 11,A01,083617,Boyle; Mary E. T.,14,0,48,34
1656230349843,COGS 13,A01,083071,Bastos; Amalia Pinkusfeld,4,0,71,67
1656230355865,COGS 14A,A01,092681,Semenuks; Arturs,0,12,100,100
1656230361889,COGS 14B,A01,083073,Cheng; Tzu-Han,7,0,63,56
1656230367912,COGS 17,A01,092677,Semenuks; Arturs,7,0,81,74
1656230373939,COGS 100,A01,083619,Allen; Michael Gordon,2,0,70,68
1656230379962,COGS 101A,A01,083621,Davis; Joshua Daniel,4,0,68,64
1656230385989,COGS 101B,A01,091572,Allen; Michael Gordon,4,0,65,61
1656230392010,COGS 101C,A01,083625,Delgado; Tania,10,0,35,25
1656230398036,COGS 107A,A01,083627,Boyle; Mary E. T.,0,0,60,60
1656230404058,COGS 118A,A01,083075,Gupta; Anjum,8,0,76,68
1656230410087,CSE 3,A50,083646,Miranda; Gregory Joseph,18,0,50,32
1656230416111,CSE 8A,A50,083650,Miranda; Gregory Joseph,2,2,56,54
1656230422132,CSE 11,A01,083080,Cao; Yingjun,0,49,40,40
1656230428162,CSE 12,A01,083652,Krause-Levy; Sophia Louisa,5,1,120,115
1656230434185,CSE 15L,A01,083654,Morris; Justin Loren,2,0,50,48
1656230434185,CSE 15L,A02,083655,Morris; Justin Loren,4,0,50,46
1656230440212,CSE 20,A01,083657,Tran; Khoa Dang,30,0,80,50
1656230446236,CSE 21,A01,095574,Bach; Quang Tran,23,0,48,25
1656230452262,CSE 30,A01,083084,Eldon; John,2,6,80,78
1656230452262,CSE 30,B01,095061,Bhaskar; Nishant,0,1,50,50
1656230458285,CSE 100,A01,083659,Cao; Yingjun,1,18,70,69
1656230464386,CSE 134B,A01,083661,Powell; Thomas Allan,5,0,100,95
1656230470412,CSE 140,A01,083663,Gungor; Onat,9,0,85,76
1656230476439,CSE 140L,A01,083088,Eldon; John,8,0,100,92
1656230482463,CSE 175,A01,083665,Kumar; Rakesh,0,0,25,25
1656230488485,CSE 190,A00,092507,Dubnov; Shlomo,3,0,20,17
1656230494509,ECE 45,A01,083139,Congero; Spencer William,1,0,75,74
1656230500531,ECE 65,A50,083695,Saad; Andrew S,9,0,30,21
1656230500531,ECE 65,A51,095125,Staff,23,0,26,3
1656230506557,ECE 109,A01,091882,Touri; Behrouz,0,1,70,70
1656230512581,ECE 180,A00,083140,Abi Samra; Nicholas Camill,1,0,30,29
1656230512581,ECE 180,B00,083141,Abi Samra; Nicholas Camill,0,4,30,30
1656230518606,MATH 10A,A01,083735,Patchell; Gregory David,0,0,30,30
1656230518606,MATH 10A,A02,083736,Patchell; Gregory David,22,0,30,8
1656230518606,MATH 10A,A03,083737,Patchell; Gregory David,16,0,30,14
1656230524631,MATH 10B,A01,083207,Lim; Seonhee,0,0,34,34
1656230524631,MATH 10B,A02,083208,Lim; Seonhee,7,0,35,28
1656230524631,MATH 10B,A03,093472,Staff,1,0,34,33
1656230524631,MATH 10B,B01,083739,Sinha; Shubham,11,0,30,19
1656230530653,MATH 18,A01,083743,Cinel; Cameron Alexander,7,0,30,23
1656230530653,MATH 18,A02,083744,Cinel; Cameron Alexander,9,0,30,21
1656230530653,MATH 18,A03,083745,Cinel; Cameron Alexander,5,0,30,25
1656230530653,MATH 18,B01,083748,Rideout; David Porter,1,0,36,35
1656230530653,MATH 18,B02,083749,Rideout; David Porter,0,0,36,36
1656230530653,MATH 18,B03,083750,Rideout; David Porter,0,0,36,36
1656230530653,MATH 18,B04,083751,Rideout; David Porter,0,1,36,36
1656230530653,MATH 18,B05,093473,Rideout; David Porter,0,0,36,36
1656230530653,MATH 18,B06,093474,Rideout; David Porter,3,0,36,33
1656230536677,MATH 20A,A01,083754,Zheng; Zequn,11,0,40,29
1656230542697,MATH 20B,A01,083756,Briones; Jor-el Thomas Caparas,0,0,36,36
1656230542697,MATH 20B,A02,083757,Briones; Jor-el Thomas Caparas,0,0,36,36
1656230542697,MATH 20B,A03,093475,Staff,0,0,36,36
1656230548725,MATH 20C,A01,083760,Briones; Jor-el Thomas Caparas,0,0,35,35
1656230548725,MATH 20C,A02,083761,Briones; Jor-el Thomas Caparas,9,1,35,26
1656230548725,MATH 20C,A03,093476,Staff,0,0,35,35
1656230548725,MATH 20C,B01,083762,Bach; Quang Tran,1,0,30,29
1656230554749,MATH 20D,A01,083765,Tran; Brian Kha,1,0,30,29
1656230554749,MATH 20D,A02,083766,Tran; Brian Kha,0,1,30,30
1656230554749,MATH 20D,A03,083767,Tran; Brian Kha,2,0,30,28
1656230560772,MATH 20E,A01,083771,Ganguly; Soumya,3,0,32,29
1656230560772,MATH 20E,A02,083772,Ganguly; Soumya,0,0,32,32
1656230560772,MATH 20E,B01,083773,Ciotti; Benjamin,16,0,35,19
1656230560772,MATH 20E,B02,083774,Ciotti; Benjamin,15,0,35,20
1656230566801,MATH 103A,A01,083777,Greenfeld; Be'Eri,1,0,36,35
1656230566801,MATH 103A,A02,083778,Greenfeld; Be'Eri,1,0,36,35
1656230566801,MATH 103A,A03,093561,Staff,5,0,36,31
1656230566801,MATH 103A,B01,083779,Greenfeld; Be'Eri,8,0,36,28
1656230566801,MATH 103A,B02,083780,Greenfeld; Be'Eri,1,0,36,35
1656230566801,MATH 103A,B03,093562,Staff,0,0,36,36
1656230572824,MATH 105,A01,085443,Carter; Anne Toulson,5,0,35,30
1656230572824,MATH 105,A02,093477,Staff,14,0,35,21
1656230578852,MATH 109,A01,083213,Ganzberger; Geoffrey Michael,0,0,34,34
1656230578852,MATH 109,A02,083214,Ganzberger; Geoffrey Michael,0,0,34,34
1656230578852,MATH 109,A03,093478,Staff,1,0,34,33
1656230578852,MATH 109,B01,083215,Ganzberger; Geoffrey Michael,4,0,32,28
1656230578852,MATH 109,B02,083216,Ganzberger; Geoffrey Michael,1,0,32,31
1656230578852,MATH 109,B03,093479,Staff,4,0,32,28
1656230584876,MATH 142A,A01,083219,Chow; Bennett,2,0,32,30
1656230584876,MATH 142A,A02,083220,Chow; Bennett,8,0,32,24
1656230584876,MATH 142A,A03,093480,Staff,5,0,32,27
1656230584876,MATH 142A,B03,093481,Staff,3,0,32,29
1656230584876,MATH 142A,B04,093558,Staff,6,0,32,26
1656230584876,MATH 142A,B05,093559,Staff,0,0,32,32
1656230590900,MATH 193A,A01,083224,Rotar; Vladimir,0,1,34,34
1656230590900,MATH 193A,A02,083225,Rotar; Vladimir,0,0,34,34
1656230590900,MATH 193A,A03,083781,Rotar; Vladimir,0,0,34,34
1656230590900,MATH 193A,A04,083782,Rotar; Vladimir,6,0,34,28
1656230590900,MATH 193A,A05,093482,Rotar; Vladimir,0,0,34,34
1656230596935,MATH 197,001,091859,McAuley; Julian John,9999,0,9999,0
1656230596935,MATH 197,002,095566,Kedlaya; Kiran S.,9997,0,9999,2
1656230596935,MATH 197,003,095567,Xiao; Ming,9999,0,9999,0
1656230596935,MATH 197,004,095571,Perols; Johan Lars,9998,0,9999,1
1656230603993,COGS 9,A01,083615,Shannon; Kyle Michael,3,0,75,72
1656230610017,COGS 11,A01,083617,Boyle; Mary E. T.,14,0,48,34
1656230616041,COGS 13,A01,083071,Bastos; Amalia Pinkusfeld,4,0,71,67
1656230622065,COGS 14A,A01,092681,Semenuks; Arturs,0,12,100,100
1656230628093,COGS 14B,A01,083073,Cheng; Tzu-Han,7,0,63,56
1656230634120,COGS 17,A01,092677,Semenuks; Arturs,7,0,81,74
1656230640144,COGS 100,A01,083619,Allen; Michael Gordon,2,0,70,68
1656230646173,COGS 101A,A01,083621,Davis; Joshua Daniel,4,0,68,64
1656230652196,COGS 101B,A01,091572,Allen; Michael Gordon,4,0,65,61
1656230658219,COGS 101C,A01,083625,Delgado; Tania,10,0,35,25
1656230664242,COGS 107A,A01,083627,Boyle; Mary E. T.,0,0,60,60
1656230670265,COGS 118A,A01,083075,Gupta; Anjum,8,0,76,68
1656230676290,CSE 3,A50,083646,Miranda; Gregory Joseph,18,0,50,32
1656230682314,CSE 8A,A50,083650,Miranda; Gregory Joseph,2,2,56,54
1656230688337,CSE 11,A01,083080,Cao; Yingjun,0,49,40,40
1656230694361,CSE 12,A01,083652,Krause-Levy; Sophia Louisa,5,1,120,115
1656230700384,CSE 15L,A01,083654,Morris; Justin Loren,2,0,50,48
1656230700384,CSE 15L,A02,083655,Morris; Justin Loren,4,0,50,46
1656230706411,CSE 20,A01,083657,Tran; Khoa Dang,30,0,80,50
1656230712435,CSE 21,A01,095574,Bach; Quang Tran,23,0,48,25
1656230718456,CSE 30,A01,083084,Eldon; John,2,6,80,78
1656230718456,CSE 30,B01,095061,Bhaskar; Nishant,0,1,50,50
1656230724480,CSE 100,A01,083659,Cao; Yingjun,1,18,70,69
1656230730503,CSE 134B,A01,083661,Powell; Thomas Allan,5,0,100,95
1656230736529,CSE 140,A01,083663,Gungor; Onat,9,0,85,76
1656230742555,CSE 140L,A01,083088,Eldon; John,8,0,100,92
1656230748582,CSE 175,A01,083665,Kumar; Rakesh,0,0,25,25
1656230754606,CSE 190,A00,092507,Dubnov; Shlomo,3,0,20,17
1656230760636,ECE 45,A01,083139,Congero; Spencer William,1,0,75,74
1656230766658,ECE 65,A50,083695,Saad; Andrew S,9,0,30,21
1656230766658,ECE 65,A51,095125,Staff,23,0,26,3
1656230772681,ECE 109,A01,091882,Touri; Behrouz,0,1,70,70
1656230778710,ECE 180,A00,083140,Abi Samra; Nicholas Camill,1,0,30,29
1656230778710,ECE 180,B00,083141,Abi Samra; Nicholas Camill,0,4,30,30
1656230784733,MATH 10A,A01,083735,Patchell; Gregory David,0,0,30,30
1656230784733,MATH 10A,A02,083736,Patchell; Gregory David,22,0,30,8
1656230784733,MATH 10A,A03,083737,Patchell; Gregory David,16,0,30,14
1656230790761,MATH 10B,A01,083207,Lim; Seonhee,0,0,34,34
1656230790761,MATH 10B,A02,083208,Lim; Seonhee,7,0,35,28
1656230790761,MATH 10B,A03,093472,Staff,1,0,34,33
1656230790761,MATH 10B,B01,083739,Sinha; Shubham,11,0,30,19
1656230796798,MATH 18,A01,083743,Cinel; Cameron Alexander,7,0,30,23
1656230796798,MATH 18,A02,083744,Cinel; Cameron Alexander,9,0,30,21
1656230796798,MATH 18,A03,083745,Cinel; Cameron Alexander,5,0,30,25
1656230796798,MATH 18,B01,083748,Rideout; David Porter,1,0,36,35
1656230796798,MATH 18,B02,083749,Rideout; David Porter,0,0,36,36
1656230796798,MATH 18,B03,083750,Rideout; David Porter,0,0,36,36
1656230796798,MATH 18,B04,083751,Rideout; David Porter,0,1,36,36
1656230796798,MATH 18,B05,093473,Rideout; David Porter,0,0,36,36
1656230796798,MATH 18,B06,093474,Rideout; David Porter,3,0,36,33
1656230802822,MATH 20A,A01,083754,Zheng; Zequn,11,0,40,29
1656230808847,MATH 20B,A01,083756,Briones; Jor-el Thomas Caparas,0,0,36,36
1656230808847,MATH 20B,A02,083757,Briones; Jor-el Thomas Caparas,0,0,36,36
1656230808847,MATH 20B,A03,093475,Staff,0,0,36,36
1656230814870,MATH 20C,A01,083760,Briones; Jor-el Thomas Caparas,0,0,35,35
1656230814870,MATH 20C,A02,083761,Briones; Jor-el Thomas Caparas,9,1,35,26
1656230814870,MATH 20C,A03,093476,Staff,0,0,35,35
1656230814870,MATH 20C,B01,083762,Bach; Quang Tran,1,0,30,29
1656230820898,MATH 20D,A01,083765,Tran; Brian Kha,1,0,30,29
1656230820898,MATH 20D,A02,083766,Tran; Brian Kha,0,1,30,30
1656230820898,MATH 20D,A03,083767,Tran; Brian Kha,2,0,30,28
1656230826927,MATH 20E,A01,083771,Ganguly; Soumya,3,0,32,29
1656230826927,MATH 20E,A02,083772,Ganguly; Soumya,0,0,32,32
1656230826927,MATH 20E,B01,083773,Ciotti; Benjamin,16,0,35,19
1656230826927,MATH 20E,B02,083774,Ciotti; Benjamin,15,0,35,20
1656230832957,MATH 103A,A01,083777,Greenfeld; Be'Eri,1,0,36,35
1656230832957,MATH 103A,A02,083778,Greenfeld; Be'Eri,1,0,36,35
1656230832957,MATH 103A,A03,093561,Staff,5,0,36,31
1656230832957,MATH 103A,B01,083779,Greenfeld; Be'Eri,8,0,36,28
1656230832957,MATH 103A,B02,083780,Greenfeld; Be'Eri,1,0,36,35
1656230832957,MATH 103A,B03,093562,Staff,0,0,36,36
1656230838982,MATH 105,A01,085443,Carter; Anne Toulson,5,0,35,30
1656230838982,MATH 105,A02,093477,Staff,14,0,35,21
1656230845006,MATH 109,A01,083213,Ganzberger; Geoffrey Michael,0,0,34,34
1656230845006,MATH 109,A02,083214,Ganzberger; Geoffrey Michael,0,0,34,34
1656230845006,MATH 109,A03,093478,Staff,1,0,34,33
1656230845006,MATH 109,B01,083215,Ganzberger; Geoffrey Michael,4,0,32,28
1656230845006,MATH 109,B02,083216,Ganzberger; Geoffrey Michael,1,0,32,31
1656230845006,MATH 109,B03,093479,Staff,4,0,32,28
1656230851031,MATH 142A,A01,083219,Chow; Bennett,2,0,32,30
1656230851031,MATH 142A,A02,083220,Chow; Bennett,8,0,32,24
1656230851031,MATH 142A,A03,093480,Staff,5,0,32,27
1656230851031,MATH 142A,B03,093481,Staff,3,0,32,29
1656230851031,MATH 142A,B04,093558,Staff,6,0,32,26
1656230851031,MATH 142A,B05,093559,Staff,0,0,32,32
1656230857059,MATH 193A,A01,083224,Rotar; Vladimir,0,1,34,34
1656230857059,MATH 193A,A02,083225,Rotar; Vladimir,0,0,34,34
1656230857059,MATH 193A,A03,083781,Rotar; Vladimir,0,0,34,34
1656230857059,MATH 193A,A04,083782,Rotar; Vladimir,6,0,34,28
1656230857059,MATH 193A,A05,093482,Rotar; Vladimir,0,0,34,34
1656230863081,MATH 197,001,091859,McAuley; Julian John,9999,0,9999,0
1656230863081,MATH 197,002,095566,Kedlaya; Kiran S.,9997,0,9999,2
1656230863081,MATH 197,003,095567,Xiao; Ming,9999,0,9999,0
1656230863081,MATH 197,004,095571,Perols; Johan Lars,9998,0,9999,1
1656230870159,COGS 9,A01,083615,Shannon; Kyle Michael,3,0,75,72
1656230876186,COGS 11,A01,083617,Boyle; Mary E. T.,14,0,48,34
1656230882211,COGS 13,A01,083071,Bastos; Amalia Pinkusfeld,4,0,71,67
1656230888236,COGS 14A,A01,092681,Semenuks; Arturs,0,12,100,100
1656230894260,COGS 14B,A01,083073,Cheng; Tzu-Han,7,0,63,56
1656230900283,COGS 17,A01,092677,Semenuks; Arturs,7,0,81,74
1656230906307,COGS 100,A01,083619,Allen; Michael Gordon,2,0,70,68
1656230912335,COGS 101A,A01,083621,Davis; Joshua Daniel,4,0,68,64
1656230918358,COGS 101B,A01,091572,Allen; Michael Gordon,4,0,65,61
1656230924385,COGS 101C,A01,083625,Delgado; Tania,10,0,35,25
1656230930407,COGS 107A,A01,083627,Boyle; Mary E. T.,0,0,60,60
1656230936429,COGS 118A,A01,083075,Gupta; Anjum,8,0,76,68
1656230942451,CSE 3,A50,083646,Miranda; Gregory Joseph,18,0,50,32
1656230948478,CSE 8A,A50,083650,Miranda; Gregory Joseph,2,2,56,54
1656230954500,CSE 11,A01,083080,Cao; Yingjun,0,49,40,40
1656230960527,CSE 12,A01,083652,Krause-Levy; Sophia Louisa,5,1,120,115
1656230966549,CSE 15L,A01,083654,Morris; Justin Loren,2,0,50,48
1656230966549,CSE 15L,A02,083655,Morris; Justin Loren,4,0,50,46
1656230972572,CSE 20,A01,083657,Tran; Khoa Dang,30,0,80,50
1656230978598,CSE 21,A01,095574,Bach; Quang Tran,23,0,48,25
1656230984620,CSE 30,A01,083084,Eldon; John,2,6,80,78
1656230984620,CSE 30,B01,095061,Bhaskar; Nishant,0,1,50,50
1656230990647,CSE 100,A01,083659,Cao; Yingjun,1,18,70,69
1656230996709,CSE 134B,A01,083661,Powell; Thomas Allan,5,0,100,95
1656231002733,CSE 140,A01,083663,Gungor; Onat,9,0,85,76
1656231008756,CSE 140L,A01,083088,Eldon; John,8,0,100,92
1656231014778,CSE 175,A01,083665,Kumar; Rakesh,0,0,25,25
1656231020804,CSE 190,A00,092507,Dubnov; Shlomo,3,0,20,17
1656231026828,ECE 45,A01,083139,Congero; Spencer William,1,0,75,74
1656231032855,ECE 65,A50,083695,Saad; Andrew S,9,0,30,21
1656231032855,ECE 65,A51,095125,Staff,23,0,26,3
1656231038877,ECE 109,A01,091882,Touri; Behrouz,0,1,70,70
1656231044901,ECE 180,A00,083140,Abi Samra; Nicholas Camill,1,0,30,29
1656231044901,ECE 180,B00,083141,Abi Samra; Nicholas Camill,0,4,30,30
1656231050925,MATH 10A,A01,083735,Patchell; Gregory David,0,0,30,30
1656231050925,MATH 10A,A02,083736,Patchell; Gregory David,22,0,30,8
1656231050925,MATH 10A,A03,083737,Patchell; Gregory David,16,0,30,14
1656231056949,MATH 10B,A01,083207,Lim; Seonhee,0,0,34,34
1656231056949,MATH 10B,A02,083208,Lim; Seonhee,7,0,35,28
1656231056949,MATH 10B,A03,093472,Staff,1,0,34,33
1656231056949,MATH 10B,B01,083739,Sinha; Shubham,11,0,30,19
1656231063062,MATH 18,A01,083743,Cinel; Cameron Alexander,7,0,30,23
1656231063062,MATH 18,A02,083744,Cinel; Cameron Alexander,9,0,30,21
1656231063062,MATH 18,A03,083745,Cinel; Cameron Alexander,5,0,30,25
1656231063062,MATH 18,B01,083748,Rideout; David Porter,1,0,36,35
1656231063062,MATH 18,B02,083749,Rideout; David Porter,0,0,36,36
1656231063062,MATH 18,B03,083750,Rideout; David Porter,0,0,36,36
1656231063062,MATH 18,B04,083751,Rideout; David Porter,0,1,36,36
1656231063062,MATH 18,B05,093473,Rideout; David Porter,0,0,36,36
1656231063062,MATH 18,B06,093474,Rideout; David Porter,3,0,36,33
1656231069094,MATH 20A,A01,083754,Zheng; Zequn,11,0,40,29
1656231075121,MATH 20B,A01,083756,Briones; Jor-el Thomas Caparas,0,0,36,36
1656231075121,MATH 20B,A02,083757,Briones; Jor-el Thomas Caparas,0,0,36,36
1656231075121,MATH 20B,A03,093475,Staff,0,0,36,36
1656231081152,MATH 20C,A01,083760,Briones; Jor-el Thomas Caparas,0,0,35,35
1656231081152,MATH 20C,A02,083761,Briones; Jor-el Thomas Caparas,9,1,35,26
1656231081152,MATH 20C,A03,093476,Staff,0,0,35,35
1656231081152,MATH 20C,B01,083762,Bach; Quang Tran,1,0,30,29
1656231087180,MATH 20D,A01,083765,Tran; Brian Kha,1,0,30,29
1656231087180,MATH 20D,A02,083766,Tran; Brian Kha,0,1,30,30
1656231087180,MATH 20D,A03,083767,Tran; Brian Kha,2,0,30,28
1656231093208,MATH 20E,A01,083771,Ganguly; Soumya,3,0,32,29
1656231093208,MATH 20E,A02,083772,Ganguly; Soumya,0,0,32,32
1656231093208,MATH 20E,B01,083773,Ciotti; Benjamin,16,0,35,19
1656231093208,MATH 20E,B02,083774,Ciotti; Benjamin,15,0,35,20
1656231099233,MATH 103A,A01,083777,Greenfeld; Be'Eri,1,0,36,35
1656231099233,MATH 103A,A02,083778,Greenfeld; Be'Eri,1,0,36,35
1656231099233,MATH 103A,A03,093561,Staff,5,0,36,31
1656231099233,MATH 103A,B01,083779,Greenfeld; Be'Eri,8,0,36,28
1656231099233,MATH 103A,B02,083780,Greenfeld; Be'Eri,1,0,36,35
1656231099233,MATH 103A,B03,093562,Staff,0,0,36,36
1656231105258,MATH 105,A01,085443,Carter; Anne Toulson,5,0,35,30
1656231105258,MATH 105,A02,093477,Staff,14,0,35,21
1656231111287,MATH 109,A01,083213,Ganzberger; Geoffrey Michael,0,0,34,34
1656231111287,MATH 109,A02,083214,Ganzberger; Geoffrey Michael,0,0,34,34
1656231111287,MATH 109,A03,093478,Staff,1,0,34,33
1656231111287,MATH 109,B01,083215,Ganzberger; Geoffrey Michael,4,0,32,28
1656231111287,MATH 109,B02,083216,Ganzberger; Geoffrey Michael,1,0,32,31
1656231111287,MATH 109,B03,093479,Staff,4,0,32,28
1656231117312,MATH 142A,A01,083219,Chow; Bennett,2,0,32,30
1656231117312,MATH 142A,A02,083220,Chow; Bennett,8,0,32,24
1656231117312,MATH 142A,A03,093480,Staff,5,0,32,27
1656231117312,MATH 142A,B03,093481,Staff,3,0,32,29
1656231117312,MATH 142A,B04,093558,Staff,6,0,32,26
1656231117312,MATH 142A,B05,093559,Staff,0,0,32,32
1656231123338,MATH 193A,A01,083224,Rotar; Vladimir,0,1,34,34
1656231123338,MATH 193A,A02,083225,Rotar; Vladimir,0,0,34,34
1656231123338,MATH 193A,A03,083781,Rotar; Vladimir,0,0,34,34
1656231123338,MATH 193A,A04,083782,Rotar; Vladimir,6,0,34,28
1656231123338,MATH 193A,A05,093482,Rotar; Vladimir,0,0,34,34
1656231129360,MATH 197,001,091859,McAuley; Julian John,9999,0,9999,0
1656231129360,MATH 197,002,095566,Kedlaya; Kiran S.,9997,0,9999,2
1656231129360,MATH 197,003,095567,Xiao; Ming,9999,0,9999,0
1656231129360,MATH 197,004,095571,Perols; Johan Lars,9998,0,9999,1
1656231136422,COGS 9,A01,083615,Shannon; Kyle Michael,3,0,75,72
1656231142444,COGS 11,A01,083617,Boyle; Mary E. T.,14,0,48,34
1656231148471,COGS 13,A01,083071,Bastos; Amalia Pinkusfeld,4,0,71,67
1656231154496,COGS 14A,A01,092681,Semenuks; Arturs,0,12,100,100
1656231160518,COGS 14B,A01,083073,Cheng; Tzu-Han,7,0,63,56
1656231166544,COGS 17,A01,092677,Semenuks; Arturs,7,0,81,74
1656231172570,COGS 100,A01,083619,Allen; Michael Gordon,2,0,70,68
1656231178598,COGS 101A,A01,083621,Davis; Joshua Daniel,4,0,68,64
1656231184621,COGS 101B,A01,091572,Allen; Michael Gordon,4,0,65,61
1656231190646,COGS 101C,A01,083625,Delgado; Tania,10,0,35,25
1656231196669,COGS 107A,A01,083627,Boyle; Mary E. T.,0,0,60,60
1656231202692,COGS 118A,A01,083075,Gupta; Anjum,8,0,76,68
1656231208721,CSE 3,A50,083646,Miranda; Gregory Joseph,18,0,50,32
1656231214748,CSE 8A,A50,083650,Miranda; Gregory Joseph,2,2,56,54
1656231220775,CSE 11,A01,083080,Cao; Yingjun,0,49,40,40
1656231226803,CSE 12,A01,083652,Krause-Levy; Sophia Louisa,5,1,120,115
1656231232825,CSE 15L,A01,083654,Morris; Justin Loren,2,0,50,48
1656231232825,CSE 15L,A02,083655,Morris; Justin Loren,4,0,50,46
1656231238849,CSE 20,A01,083657,Tran; Khoa Dang,30,0,80,50
1656231244877,CSE 21,A01,095574,Bach; Quang Tran,23,0,48,25
1656231250901,CSE 30,A01,083084,Eldon; John,2,6,80,78
1656231250901,CSE 30,B01,095061,Bhaskar; Nishant,0,1,50,50
1656231256924,CSE 100,A01,083659,Cao; Yingjun,1,18,70,69
1656231262952,CSE 134B,A01,083661,Powell; Thomas Allan,5,0,100,95
1656231268998,CSE 140,A01,083663,Gungor; Onat,9,0,85,76
1656231275023,CSE 140L,A01,083088,Eldon; John,8,0,100,92
1656231281046,CSE 175,A01,083665,Kumar; Rakesh,0,0,25,25
1656231287072,CSE 190,A00,092507,Dubnov; Shlomo,3,0,20,17
1656231293109,ECE 45,A01,083139,Congero; Spencer William,1,0,75,74
1656231299131,ECE 65,A50,083695,Saad; Andrew S,9,0,30,21
1656231299131,ECE 65,A51,095125,Staff,23,0,26,3
1656231305157,ECE 109,A01,091882,Touri; Behrouz,0,1,70,70
1656231311180,ECE 180,A00,083140,Abi Samra; Nicholas Camill,1,0,30,29
1656231311180,ECE 180,B00,083141,Abi Samra; Nicholas Camill,0,4,30,30
1656231317206,MATH 10A,A01,083735,Patchell; Gregory David,0,0,30,30
1656231317206,MATH 10A,A02,083736,Patchell; Gregory David,22,0,30,8
1656231317206,MATH 10A,A03,083737,Patchell; Gregory David,16,0,30,14
1656231323230,MATH 10B,A01,083207,Lim; Seonhee,0,0,34,34
1656231323230,MATH 10B,A02,083208,Lim; Seonhee,7,0,35,28
1656231323230,MATH 10B,A03,093472,Staff,1,0,34,33
1656231323230,MATH 10B,B01,083739,Sinha; Shubham,11,0,30,19
1656231329256,MATH 18,A01,083743,Cinel; Cameron Alexander,7,0,30,23
1656231329256,MATH 18,A02,083744,Cinel; Cameron Alexander,9,0,30,21
1656231329256,MATH 18,A03,083745,Cinel; Cameron Alexander,5,0,30,25
1656231329256,MATH 18,B01,083748,Rideout; David Porter,1,0,36,35
1656231329256,MATH 18,B02,083749,Rideout; David Porter,0,0,36,36
1656231329256,MATH 18,B03,083750,Rideout; David Porter,0,0,36,36
1656231329256,MATH 18,B04,083751,Rideout; David Porter,0,1,36,36
1656231329256,MATH 18,B05,093473,Rideout; David Porter,0,0,36,36
1656231329256,MATH 18,B06,093474,Rideout; David Porter,3,0,36,33
1656231335282,MATH 20A,A01,083754,Zheng; Zequn,11,0,40,29
1656231341306,MATH 20B,A01,083756,Briones; Jor-el Thomas Caparas,0,0,36,36
1656231341306,MATH 20B,A02,083757,Briones; Jor-el Thomas Caparas,0,0,36,36
1656231341306,MATH 20B,A03,093475,Staff,0,0,36,36
1656231347329,MATH 20C,A01,083760,Briones; Jor-el Thomas Caparas,0,0,35,35
1656231347329,MATH 20C,A02,083761,Briones; Jor-el Thomas Caparas,9,1,35,26
1656231347329,MATH 20C,A03,093476,Staff,0,0,35,35
1656231347329,MATH 20C,B01,083762,Bach; Quang Tran,1,0,30,29
1656231353366,MATH 20D,A01,083765,Tran; Brian Kha,1,0,30,29
1656231353366,MATH 20D,A02,083766,Tran; Brian Kha,0,1,30,30
1656231353366,MATH 20D,A03,083767,Tran; Brian Kha,2,0,30,28
1656231359392,MATH 20E,A01,083771,Ganguly; Soumya,3,0,32,29
1656231359392,MATH 20E,A02,083772,Ganguly; Soumya,0,0,32,32
1656231359392,MATH 20E,B01,083773,Ciotti; Benjamin,16,0,35,19
1656231359392,MATH 20E,B02,083774,Ciotti; Benjamin,15,0,35,20
1656231365416,MATH 103A,A01,083777,Greenfeld; Be'Eri,1,0,36,35
1656231365416,MATH 103A,A02,083778,Greenfeld; Be'Eri,1,0,36,35
1656231365416,MATH 103A,A03,093561,Staff,5,0,36,31
1656231365416,MATH 103A,B01,083779,Greenfeld; Be'Eri,8,0,36,28
1656231365416,MATH 103A,B02,083780,Greenfeld; Be'Eri,1,0,36,35
1656231365416,MATH 103A,B03,093562,Staff,0,0,36,36
1656231371444,MATH 105,A01,085443,Carter; Anne Toulson,5,0,35,30
1656231371444,MATH 105,A02,093477,Staff,14,0,35,21
1656231377471,MATH 109,A01,083213,Ganzberger; Geoffrey Michael,0,0,34,34
1656231377471,MATH 109,A02,083214,Ganzberger; Geoffrey Michael,0,0,34,34
1656231377471,MATH 109,A03,093478,Staff,1,0,34,33
1656231377471,MATH 109,B01,083215,Ganzberger; Geoffrey Michael,4,0,32,28
1656231377471,MATH 109,B02,083216,Ganzberger; Geoffrey Michael,1,0,32,31
1656231377471,MATH 109,B03,093479,Staff,4,0,32,28
1656231383495,MATH 142A,A01,083219,Chow; Bennett,2,0,32,30
1656231383495,MATH 142A,A02,083220,Chow; Bennett,8,0,32,24
1656231383495,MATH 142A,A03,093480,Staff,5,0,32,27
1656231383495,MATH 142A,B03,093481,Staff,3,0,32,29
1656231383495,MATH 142A,B04,093558,Staff,6,0,32,26
1656231383495,MATH 142A,B05,093559,Staff,0,0,32,32
1656231389523,MATH 193A,A01,083224,Rotar; Vladimir,0,1,34,34
1656231389523,MATH 193A,A02,083225,Rotar; Vladimir,0,0,34,34
1656231389523,MATH 193A,A03,083781,Rotar; Vladimir,0,0,34,34
1656231389523,MATH 193A,A04,083782,Rotar; Vladimir,6,0,34,28
1656231389523,MATH 193A,A05,093482,Rotar; Vladimir,0,0,34,34
1656231395556,MATH 197,001,091859,McAuley; Julian John,9999,0,9999,0
1656231395556,MATH 197,002,095566,Kedlaya; Kiran S.,9997,0,9999,2
1656231395556,MATH 197,003,095567,Xiao; Ming,9999,0,9999,0
1656231395556,MATH 197,004,095571,Perols; Johan Lars,9998,0,9999,1
1656231402623,COGS 9,A01,083615,Shannon; Kyle Michael,3,0,75,72
1656231408647,COGS 11,A01,083617,Boyle; Mary E. T.,14,0,48,34
1656231414668,COGS 13,A01,083071,Bastos; Amalia Pinkusfeld,4,0,71,67
1656231420692,COGS 14A,A01,092681,Semenuks; Arturs,0,12,100,100
1656231426719,COGS 14B,A01,083073,Cheng; Tzu-Han,7,0,63,56
1656231432742,COGS 17,A01,092677,Semenuks; Arturs,7,0,81,74
1656231438766,COGS 100,A01,083619,Allen; Michael Gordon,2,0,70,68
1656231444793,COGS 101A,A01,083621,Davis; Joshua Daniel,4,0,68,64
1656231450820,COGS 101B,A01,091572,Allen; Michael Gordon,4,0,65,61
1656231456846,COGS 101C,A01,083625,Delgado; Tania,10,0,35,25
1656231462869,COGS 107A,A01,083627,Boyle; Mary E. T.,0,0,60,60
1656231468895,COGS 118A,A01,083075,Gupta; Anjum,8,0,76,68
1656231474920,CSE 3,A50,083646,Miranda; Gregory Joseph,18,0,50,32
1656231480943,CSE 8A,A50,083650,Miranda; Gregory Joseph,2,2,56,54
1656231486965,CSE 11,A01,083080,Cao; Yingjun,0,49,40,40
1656231492989,CSE 12,A01,083652,Krause-Levy; Sophia Louisa,5,1,120,115
1656231499012,CSE 15L,A01,083654,Morris; Justin Loren,2,0,50,48
1656231499012,CSE 15L,A02,083655,Morris; Justin Loren,4,0,50,46
1656231505036,CSE 20,A01,083657,Tran; Khoa Dang,30,0,80,50
1656231511063,CSE 21,A01,095574,Bach; Quang Tran,23,0,48,25
1656231517089,CSE 30,A01,083084,Eldon; John,2,6,80,78
1656231517089,CSE 30,B01,095061,Bhaskar; Nishant,0,1,50,50
1656231523114,CSE 100,A01,083659,Cao; Yingjun,1,18,70,69
1656231529140,CSE 134B,A01,083661,Powell; Thomas Allan,5,0,100,95
1656231535163,CSE 140,A01,083663,Gungor; Onat,9,0,85,76
1656231541190,CSE 140L,A01,083088,Eldon; John,8,0,100,92
1656231547213,CSE 175,A01,083665,Kumar; Rakesh,0,0,25,25
1656231553236,CSE 190,A00,092507,Dubnov; Shlomo,3,0,20,17
1656231559267,ECE 45,A01,083139,Congero; Spencer William,1,0,75,74
1656231565295,ECE 65,A50,083695,Saad; Andrew S,9,0,30,21
1656231565295,ECE 65,A51,095125,Staff,23,0,26,3
1656231571317,ECE 109,A01,091882,Touri; Behrouz,0,1,70,70
1656231577349,ECE 180,A00,083140,Abi Samra; Nicholas Camill,1,0,30,29
1656231577349,ECE 180,B00,083141,Abi Samra; Nicholas Camill,0,4,30,30
1656231583372,MATH 10A,A01,083735,Patchell; Gregory David,0,0,30,30
1656231583372,MATH 10A,A02,083736,Patchell; Gregory David,22,0,30,8
1656231583372,MATH 10A,A03,083737,Patchell; Gregory David,16,0,30,14
1656231589396,MATH 10B,A01,083207,Lim; Seonhee,0,0,34,34
1656231589396,MATH 10B,A02,083208,Lim; Seonhee,7,0,35,28
1656231589396,MATH 10B,A03,093472,Staff,1,0,34,33
1656231589396,MATH 10B,B01,083739,Sinha; Shubham,11,0,30,19
1656231595425,MATH 18,A01,083743,Cinel; Cameron Alexander,7,0,30,23
1656231595425,MATH 18,A02,083744,Cinel; Cameron Alexander,9,0,30,21
1656231595425,MATH 18,A03,083745,Cinel; Cameron Alexander,5,0,30,25
1656231595425,MATH 18,B01,083748,Rideout; David Porter,1,0,36,35
1656231595425,MATH 18,B02,083749,Rideout; David Porter,0,0,36,36
1656231595425,MATH 18,B03,083750,Rideout; David Porter,0,0,36,36
1656231595425,MATH 18,B04,083751,Rideout; David Porter,0,1,36,36
1656231595425,MATH 18,B05,093473,Rideout; David Porter,0,0,36,36
1656231595425,MATH 18,B06,093474,Rideout; David Porter,3,0,36,33
1656231601450,MATH 20A,A01,083754,Zheng; Zequn,11,0,40,29
1656231607472,MATH 20B,A01,083756,Briones; Jor-el Thomas Caparas,0,0,36,36
1656231607472,MATH 20B,A02,083757,Briones; Jor-el Thomas Caparas,0,0,36,36
1656231607472,MATH 20B,A03,093475,Staff,0,0,36,36
1656231613499,MATH 20C,A01,083760,Briones; Jor-el Thomas Caparas,0,0,35,35
1656231613499,MATH 20C,A02,083761,Briones; Jor-el Thomas Caparas,9,1,35,26
1656231613499,MATH 20C,A03,093476,Staff,0,0,35,35
1656231613499,MATH 20C,B01,083762,Bach; Quang Tran,1,0,30,29
1656231619521,MATH 20D,A01,083765,Tran; Brian Kha,1,0,30,29
1656231619521,MATH 20D,A02,083766,Tran; Brian Kha,0,1,30,30
1656231619521,MATH 20D,A03,083767,Tran; Brian Kha,2,0,30,28
1656231625544,MATH 20E,A01,083771,Ganguly; Soumya,3,0,32,29
1656231625544,MATH 20E,A02,083772,Ganguly; Soumya,0,0,32,32
1656231625544,MATH 20E,B01,083773,Ciotti; Benjamin,16,0,35,19
1656231625544,MATH 20E,B02,083774,Ciotti; Benjamin,15,0,35,20
1656231631573,MATH 103A,A01,083777,Greenfeld; Be'Eri,1,0,36,35
1656231631573,MATH 103A,A02,083778,Greenfeld; Be'Eri,1,0,36,35
1656231631573,MATH 103A,A03,093561,Staff,5,0,36,31
1656231631573,MATH 103A,B01,083779,Greenfeld; Be'Eri,8,0,36,28
1656231631573,MATH 103A,B02,083780,Greenfeld; Be'Eri,1,0,36,35
1656231631573,MATH 103A,B03,093562,Staff,0,0,36,36
1656231637596,MATH 105,A01,085443,Carter; Anne Toulson,5,0,35,30
1656231637596,MATH 105,A02,093477,Staff,14,0,35,21
1656231643619,MATH 109,A01,083213,Ganzberger; Geoffrey Michael,0,0,34,34
1656231643619,MATH 109,A02,083214,Ganzberger; Geoffrey Michael,0,0,34,34
1656231643619,MATH 109,A03,093478,Staff,1,0,34,33
1656231643619,MATH 109,B01,083215,Ganzberger; Geoffrey Michael,4,0,32,28
1656231643619,MATH 109,B02,083216,Ganzberger; Geoffrey Michael,1,0,32,31
1656231643619,MATH 109,B03,093479,Staff,4,0,32,28
1656231649648,MATH 142A,A01,083219,Chow; Bennett,2,0,32,30
1656231649648,MATH 142A,A02,083220,Chow; Bennett,8,0,32,24
1656231649648,MATH 142A,A03,093480,Staff,5,0,32,27
1656231649648,MATH 142A,B03,093481,Staff,3,0,32,29
1656231649648,MATH 142A,B04,093558,Staff,6,0,32,26
1656231649648,MATH 142A,B05,093559,Staff,0,0,32,32
1656231655676,MATH 193A,A01,083224,Rotar; Vladimir,0,1,34,34
1656231655676,MATH 193A,A02,083225,Rotar; Vladimir,0,0,34,34
1656231655676,MATH 193A,A03,083781,Rotar; Vladimir,0,0,34,34
1656231655676,MATH 193A,A04,083782,Rotar; Vladimir,6,0,34,28
1656231655676,MATH 193A,A05,093482,Rotar; Vladimir,0,0,34,34
1656231661780,MATH 197,001,091859,McAuley; Julian John,9999,0,9999,0
1656231661780,MATH 197,002,095566,Kedlaya; Kiran S.,9997,0,9999,2
1656231661780,MATH 197,003,095567,Xiao; Ming,9999,0,9999,0
1656231661780,MATH 197,004,095571,Perols; Johan Lars,9998,0,9999,1
1656231668839,COGS 9,A01,083615,Shannon; Kyle Michael,3,0,75,72
1656231674862,COGS 11,A01,083617,Boyle; Mary E. T.,14,0,48,34
1656231680889,COGS 13,A01,083071,Bastos; Amalia Pinkusfeld,4,0,71,67
1656231686917,COGS 14A,A01,092681,Semenuks; Arturs,0,12,100,100
1656231692940,COGS 14B,A01,083073,Cheng; Tzu-Han,7,0,63,56
1656231698964,COGS 17,A01,092677,Semenuks; Arturs,7,0,81,74
1656231704987,COGS 100,A01,083619,Allen; Michael Gordon,2,0,70,68
1656231711014,COGS 101A,A01,083621,Davis; Joshua Daniel,4,0,68,64
1656231717069,COGS 101B,A01,091572,Allen; Michael Gordon,4,0,65,61
1656231723093,COGS 101C,A01,083625,Delgado; Tania,10,0,35,25
1656231729119,COGS 107A,A01,083627,Boyle; Mary E. T.,0,0,60,60
1656231735141,COGS 118A,A01,083075,Gupta; Anjum,8,0,76,68
1656231741171,CSE 3,A50,083646,Miranda; Gregory Joseph,18,0,50,32
1656231747195,CSE 8A,A50,083650,Miranda; Gregory Joseph,2,2,56,54
1656231753218,CSE 11,A01,083080,Cao; Yingjun,0,49,40,40
1656231759246,CSE 12,A01,083652,Krause-Levy; Sophia Louisa,5,1,120,115
1656231765269,CSE 15L,A01,083654,Morris; Justin Loren,2,0,50,48
1656231765269,CSE 15L,A02,083655,Morris; Justin Loren,4,0,50,46
1656231771292,CSE 20,A01,083657,Tran; Khoa Dang,30,0,80,50
1656231777316,CSE 21,A01,095574,Bach; Quang Tran,23,0,48,25
1656231783344,CSE 30,A01,083084,Eldon; John,2,6,80,78
1656231783344,CSE 30,B01,095061,Bhaskar; Nishant,0,1,50,50
1656231789371,CSE 100,A01,083659,Cao; Yingjun,1,18,70,69
1656231795395,CSE 134B,A01,083661,Powell; Thomas Allan,5,0,100,95
1656231801417,CSE 140,A01,083663,Gungor; Onat,9,0,85,76
1656231807445,CSE 140L,A01,083088,Eldon; John,8,0,100,92
1656231813468,CSE 175,A01,083665,Kumar; Rakesh,0,0,25,25
1656231819490,CSE 190,A00,092507,Dubnov; Shlomo,3,0,20,17
1656231825522,ECE 45,A01,083139,Congero; Spencer William,1,0,75,74
1656231831545,ECE 65,A50,083695,Saad; Andrew S,9,0,30,21
1656231831545,ECE 65,A51,095125,Staff,23,0,26,3
1656231837574,ECE 109,A01,091882,Touri; Behrouz,0,1,70,70
1656231843597,ECE 180,A00,083140,Abi Samra; Nicholas Camill,1,0,30,29
1656231843597,ECE 180,B00,083141,Abi Samra; Nicholas Camill,0,4,30,30
1656231849621,MATH 10A,A01,083735,Patchell; Gregory David,0,0,30,30
1656231849621,MATH 10A,A02,083736,Patchell; Gregory David,22,0,30,8
1656231849621,MATH 10A,A03,083737,Patchell; Gregory David,16,0,30,14
1656231855645,MATH 10B,A01,083207,Lim; Seonhee,0,0,34,34
1656231855645,MATH 10B,A02,083208,Lim; Seonhee,7,0,35,28
1656231855645,MATH 10B,A03,093472,Staff,1,0,34,33
1656231855645,MATH 10B,B01,083739,Sinha; Shubham,11,0,30,19
1656231861669,MATH 18,A01,083743,Cinel; Cameron Alexander,7,0,30,23
1656231861669,MATH 18,A02,083744,Cinel; Cameron Alexander,9,0,30,21
1656231861669,MATH 18,A03,083745,Cinel; Cameron Alexander,5,0,30,25
1656231861669,MATH 18,B01,083748,Rideout; David Porter,1,0,36,35
1656231861669,MATH 18,B02,083749,Rideout; David Porter,0,0,36,36
1656231861669,MATH 18,B03,083750,Rideout; David Porter,0,0,36,36
1656231861669,MATH 18,B04,083751,Rideout; David Porter,0,1,36,36
1656231861669,MATH 18,B05,093473,Rideout; David Porter,0,0,36,36
1656231861669,MATH 18,B06,093474,Rideout; David Porter,3,0,36,33
1656231867695,MATH 20A,A01,083754,Zheng; Zequn,11,0,40,29
1656231873721,MATH 20B,A01,083756,Briones; Jor-el Thomas Caparas,0,0,36,36
1656231873721,MATH 20B,A02,083757,Briones; Jor-el Thomas Caparas,0,0,36,36
1656231873721,MATH 20B,A03,093475,Staff,0,0,36,36
1656231879752,MATH 20C,A01,083760,Briones; Jor-el Thomas Caparas,0,0,35,35
1656231879752,MATH 20C,A02,083761,Briones; Jor-el Thomas Caparas,9,1,35,26
1656231879752,MATH 20C,A03,093476,Staff,0,0,35,35
1656231879752,MATH 20C,B01,083762,Bach; Quang Tran,1,0,30,29
1656231885776,MATH 20D,A01,083765,Tran; Brian Kha,1,0,30,29
1656231885776,MATH 20D,A02,083766,Tran; Brian Kha,0,1,30,30
1656231885776,MATH 20D,A03,083767,Tran; Brian Kha,2,0,30,28
1656231891804,MATH 20E,A01,083771,Ganguly; Soumya,3,0,32,29
1656231891804,MATH 20E,A02,083772,Ganguly; Soumya,0,0,32,32
1656231891804,MATH 20E,B01,083773,Ciotti; Benjamin,16,0,35,19
1656231891804,MATH 20E,B02,083774,Ciotti; Benjamin,15,0,35,20
1656231897828,MATH 103A,A01,083777,Greenfeld; Be'Eri,1,0,36,35
1656231897828,MATH 103A,A02,083778,Greenfeld; Be'Eri,1,0,36,35
1656231897828,MATH 103A,A03,093561,Staff,5,0,36,31
1656231897828,MATH 103A,B01,083779,Greenfeld; Be'Eri,8,0,36,28
1656231897828,MATH 103A,B02,083780,Greenfeld; Be'Eri,1,0,36,35
1656231897828,MATH 103A,B03,093562,Staff,0,0,36,36
1656231903859,MATH 105,A01,085443,Carter; Anne Toulson,5,0,35,30
1656231903859,MATH 105,A02,093477,Staff,14,0,35,21
1656231909883,MATH 109,A01,083213,Ganzberger; Geoffrey Michael,0,0,34,34
1656231909883,MATH 109,A02,083214,Ganzberger; Geoffrey Michael,0,0,34,34
1656231909883,MATH 109,A03,093478,Staff,1,0,34,33
1656231909883,MATH 109,B01,083215,Ganzberger; Geoffrey Michael,4,0,32,28
1656231909883,MATH 109,B02,083216,Ganzberger; Geoffrey Michael,1,0,32,31
1656231909883,MATH 109,B03,093479,Staff,4,0,32,28
1656231915906,MATH 142A,A01,083219,Chow; Bennett,2,0,32,30
1656231915906,MATH 142A,A02,083220,Chow; Bennett,8,0,32,24
1656231915906,MATH 142A,A03,093480,Staff,5,0,32,27
1656231915906,MATH 142A,B03,093481,Staff,3,0,32,29
1656231915906,MATH 142A,B04,093558,Staff,6,0,32,26
1656231915906,MATH 142A,B05,093559,Staff,0,0,32,32
1656231921929,MATH 193A,A01,083224,Rotar; Vladimir,0,1,34,34
1656231921929,MATH 193A,A02,083225,Rotar; Vladimir,0,0,34,34
1656231921929,MATH 193A,A03,083781,Rotar; Vladimir,0,0,34,34
1656231921929,MATH 193A,A04,083782,Rotar; Vladimir,6,0,34,28
1656231921929,MATH 193A,A05,093482,Rotar; Vladimir,0,0,34,34
1656231927956,MATH 197,001,091859,McAuley; Julian John,9999,0,9999,0
1656231927956,MATH 197,002,095566,Kedlaya; Kiran S.,9997,0,9999,2
1656231927956,MATH 197,003,095567,Xiao; Ming,9999,0,9999,0
1656231927956,MATH 197,004,095571,Perols; Johan Lars,9998,0,9999,1
1656231935006,COGS 9,A01,083615,Shannon; Kyle Michael,3,0,75,72
1656231941033,COGS 11,A01,083617,Boyle; Mary E. T.,14,0,48,34
1656231947056,COGS 13,A01,083071,Bastos; Amalia Pinkusfeld,4,0,71,67
1656231953080,COGS 14A,A01,092681,Semenuks; Arturs,0,12,100,100
1656231959104,COGS 14B,A01,083073,Cheng; Tzu-Han,7,0,63,56
1656231965128,COGS 17,A01,092677,Semenuks; Arturs,7,0,81,74
1656231971154,COGS 100,A01,083619,Allen; Michael Gordon,2,0,70,68
1656231977178,COGS 101A,A01,083621,Davis; Joshua Daniel,4,0,68,64
1656231983202,COGS 101B,A01,091572,Allen; Michael Gordon,4,0,65,61
1656231989224,COGS 101C,A01,083625,Delgado; Tania,10,0,35,25
1656231995248,COGS 107A,A01,083627,Boyle; Mary E. T.,0,0,60,60
1656232001277,COGS 118A,A01,083075,Gupta; Anjum,8,0,76,68
1656232007304,CSE 3,A50,083646,Miranda; Gregory Joseph,18,0,50,32
1656232013334,CSE 8A,A50,083650,Miranda; Gregory Joseph,2,2,56,54
1656232019360,CSE 11,A01,083080,Cao; Yingjun,0,49,40,40
1656232025397,CSE 12,A01,083652,Krause-Levy; Sophia Louisa,5,1,120,115
1656232031420,CSE 15L,A01,083654,Morris; Justin Loren,2,0,50,48
1656232031420,CSE 15L,A02,083655,Morris; Justin Loren,4,0,50,46
1656232037441,CSE 20,A01,083657,Tran; Khoa Dang,30,0,80,50
1656232043468,CSE 21,A01,095574,Bach; Quang Tran,23,0,48,25
1656232049495,CSE 30,A01,083084,Eldon; John,2,6,80,78
1656232049495,CSE 30,B01,095061,Bhaskar; Nishant,0,1,50,50
1656232055519,CSE 100,A01,083659,Cao; Yingjun,1,18,70,69
1656232061545,CSE 134B,A01,083661,Powell; Thomas Allan,5,0,100,95
1656232067571,CSE 140,A01,083663,Gungor; Onat,9,0,85,76
1656232073604,CSE 140L,A01,083088,Eldon; John,8,0,100,92
1656232079630,CSE 175,A01,083665,Kumar; Rakesh,0,0,25,25
1656232085654,CSE 190,A00,092507,Dubnov; Shlomo,3,0,20,17
1656232091677,ECE 45,A01,083139,Congero; Spencer William,1,0,75,74
1656232097707,ECE 65,A50,083695,Saad; Andrew S,9,0,30,21
1656232097707,ECE 65,A51,095125,Staff,23,0,26,3
1656232103733,ECE 109,A01,091882,Touri; Behrouz,0,1,70,70
1656232109760,ECE 180,A00,083140,Abi Samra; Nicholas Camill,1,0,30,29
1656232109760,ECE 180,B00,083141,Abi Samra; Nicholas Camill,0,4,30,30
1656232115784,MATH 10A,A01,083735,Patchell; Gregory David,0,0,30,30
1656232115784,MATH 10A,A02,083736,Patchell; Gregory David,22,0,30,8
1656232115784,MATH 10A,A03,083737,Patchell; Gregory David,16,0,30,14
1656232121813,MATH 10B,A01,083207,Lim; Seonhee,0,0,34,34
1656232121813,MATH 10B,A02,083208,Lim; Seonhee,7,0,35,28
1656232121813,MATH 10B,A03,093472,Staff,1,0,34,33
1656232121813,MATH 10B,B01,083739,Sinha; Shubham,11,0,30,19
1656232127844,MATH 18,A01,083743,Cinel; Cameron Alexander,7,0,30,23
1656232127844,MATH 18,A02,083744,Cinel; Cameron Alexander,9,0,30,21
1656232127844,MATH 18,A03,083745,Cinel; Cameron Alexander,5,0,30,25
1656232127844,MATH 18,B01,083748,Rideout; David Porter,1,0,36,35
1656232127844,MATH 18,B02,083749,Rideout; David Porter,0,0,36,36
1656232127844,MATH 18,B03,083750,Rideout; David Porter,0,0,36,36
1656232127844,MATH 18,B04,083751,Rideout; David Porter,0,1,36,36
1656232127844,MATH 18,B05,093473,Rideout; David Porter,0,0,36,36
1656232127844,MATH 18,B06,093474,Rideout; David Porter,3,0,36,33
1656232133867,MATH 20A,A01,083754,Zheng; Zequn,11,0,40,29
1656232139894,MATH 20B,A01,083756,Briones; Jor-el Thomas Caparas,0,0,36,36
1656232139894,MATH 20B,A02,083757,Briones; Jor-el Thomas Caparas,0,0,36,36
1656232139894,MATH 20B,A03,093475,Staff,0,0,36,36
1656232145922,MATH 20C,A01,083760,Briones; Jor-el Thomas Caparas,0,0,35,35
1656232145922,MATH 20C,A02,083761,Briones; Jor-el Thomas Caparas,9,1,35,26
1656232145922,MATH 20C,A03,093476,Staff,0,0,35,35
1656232145922,MATH 20C,B01,083762,Bach; Quang Tran,1,0,30,29
1656232151944,MATH 20D,A01,083765,Tran; Brian Kha,1,0,30,29
1656232151944,MATH 20D,A02,083766,Tran; Brian Kha,0,1,30,30
1656232151944,MATH 20D,A03,083767,Tran; Brian Kha,2,0,30,28
1656232157968,MATH 20E,A01,083771,Ganguly; Soumya,3,0,32,29
1656232157968,MATH 20E,A02,083772,Ganguly; Soumya,0,0,32,32
1656232157968,MATH 20E,B01,083773,Ciotti; Benjamin,16,0,35,19
1656232157968,MATH 20E,B02,083774,Ciotti; Benjamin,15,0,35,20
1656232163992,MATH 103A,A01,083777,Greenfeld; Be'Eri,1,0,36,35
1656232163992,MATH 103A,A02,083778,Greenfeld; Be'Eri,1,0,36,35
1656232163992,MATH 103A,A03,093561,Staff,5,0,36,31
1656232163992,MATH 103A,B01,083779,Greenfeld; Be'Eri,8,0,36,28
1656232163992,MATH 103A,B02,083780,Greenfeld; Be'Eri,1,0,36,35
1656232163992,MATH 103A,B03,093562,Staff,0,0,36,36
1656232170016,MATH 105,A01,085443,Carter; Anne Toulson,5,0,35,30
1656232170016,MATH 105,A02,093477,Staff,14,0,35,21
1656232176043,MATH 109,A01,083213,Ganzberger; Geoffrey Michael,0,0,34,34
1656232176043,MATH 109,A02,083214,Ganzberger; Geoffrey Michael,0,0,34,34
1656232176043,MATH 109,A03,093478,Staff,1,0,34,33
1656232176043,MATH 109,B01,083215,Ganzberger; Geoffrey Michael,4,0,32,28
1656232176043,MATH 109,B02,083216,Ganzberger; Geoffrey Michael,1,0,32,31
1656232176043,MATH 109,B03,093479,Staff,4,0,32,28
1656232182076,MATH 142A,A01,083219,Chow; Bennett,2,0,32,30
1656232182076,MATH 142A,A02,083220,Chow; Bennett,8,0,32,24
1656232182076,MATH 142A,A03,093480,Staff,5,0,32,27
1656232182076,MATH 142A,B03,093481,Staff,3,0,32,29
1656232182076,MATH 142A,B04,093558,Staff,6,0,32,26
1656232182076,MATH 142A,B05,093559,Staff,0,0,32,32
1656232188099,MATH 193A,A01,083224,Rotar; Vladimir,0,1,34,34
1656232188099,MATH 193A,A02,083225,Rotar; Vladimir,0,0,34,34
1656232188099,MATH 193A,A03,083781,Rotar; Vladimir,0,0,34,34
1656232188099,MATH 193A,A04,083782,Rotar; Vladimir,6,0,34,28
1656232188099,MATH 193A,A05,093482,Rotar; Vladimir,0,0,34,34
1656232194123,MATH 197,001,091859,McAuley; Julian John,9999,0,9999,0
1656232194123,MATH 197,002,095566,Kedlaya; Kiran S.,9997,0,9999,2
1656232194123,MATH 197,003,095567,Xiao; Ming,9999,0,9999,0
1656232194123,MATH 197,004,095571,Perols; Johan Lars,9998,0,9999,1
1656232201179,COGS 9,A01,083615,Shannon; Kyle Michael,3,0,75,72
1656232207207,COGS 11,A01,083617,Boyle; Mary E. T.,14,0,48,34
1656232213231,COGS 13,A01,083071,Bastos; Amalia Pinkusfeld,4,0,71,67
1656232219253,COGS 14A,A01,092681,Semenuks; Arturs,0,12,100,100
1656232225279,COGS 14B,A01,083073,Cheng; Tzu-Han,7,0,63,56
1656232231305,COGS 17,A01,092677,Semenuks; Arturs,7,0,81,74
1656232237339,COGS 100,A01,083619,Allen; Michael Gordon,2,0,70,68
1656232243363,COGS 101A,A01,083621,Davis; Joshua Daniel,4,0,68,64
1656232249389,COGS 101B,A01,091572,Allen; Michael Gordon,4,0,65,61
1656232255499,COGS 101C,A01,083625,Delgado; Tania,10,0,35,25
1656232261523,COGS 107A,A01,083627,Boyle; Mary E. T.,0,0,60,60
1656232267544,COGS 118A,A01,083075,Gupta; Anjum,8,0,76,68
1656232273567,CSE 3,A50,083646,Miranda; Gregory Joseph,18,0,50,32
1656232279594,CSE 8A,A50,083650,Miranda; Gregory Joseph,2,2,56,54
1656232285620,CSE 11,A01,083080,Cao; Yingjun,0,49,40,40
1656232291643,CSE 12,A01,083652,Krause-Levy; Sophia Louisa,5,1,120,115
1656232297671,CSE 15L,A01,083654,Morris; Justin Loren,2,0,50,48
1656232297671,CSE 15L,A02,083655,Morris; Justin Loren,4,0,50,46
1656232303694,CSE 20,A01,083657,Tran; Khoa Dang,30,0,80,50
1656232309720,CSE 21,A01,095574,Bach; Quang Tran,23,0,48,25
1656232315745,CSE 30,A01,083084,Eldon; John,2,6,80,78
1656232315745,CSE 30,B01,095061,Bhaskar; Nishant,0,1,50,50
1656232321770,CSE 100,A01,083659,Cao; Yingjun,1,18,70,69
1656232327797,CSE 134B,A01,083661,Powell; Thomas Allan,5,0,100,95
1656232333827,CSE 140,A01,083663,Gungor; Onat,9,0,85,76
1656232339850,CSE 140L,A01,083088,Eldon; John,8,0,100,92
1656232345873,CSE 175,A01,083665,Kumar; Rakesh,0,0,25,25
1656232351896,CSE 190,A00,092507,Dubnov; Shlomo,3,0,20,17
1656232357919,ECE 45,A01,083139,Congero; Spencer William,1,0,75,74
1656232363952,ECE 65,A50,083695,Saad; Andrew S,9,0,30,21
1656232363952,ECE 65,A51,095125,Staff,24,0,26,2
1656232369974,ECE 109,A01,091882,Touri; Behrouz,0,1,70,70
1656232376003,ECE 180,A00,083140,Abi Samra; Nicholas Camill,1,0,30,29
1656232376003,ECE 180,B00,083141,Abi Samra; Nicholas Camill,0,4,30,30
1656232382028,MATH 10A,A01,083735,Patchell; Gregory David,0,0,30,30
1656232382028,MATH 10A,A02,083736,Patchell; Gregory David,22,0,30,8
1656232382028,MATH 10A,A03,083737,Patchell; Gregory David,16,0,30,14
1656232388051,MATH 10B,A01,083207,Lim; Seonhee,0,0,34,34
1656232388051,MATH 10B,A02,083208,Lim; Seonhee,7,0,35,28
1656232388051,MATH 10B,A03,093472,Staff,1,0,34,33
1656232388051,MATH 10B,B01,083739,Sinha; Shubham,11,0,30,19
1656232394076,MATH 18,A01,083743,Cinel; Cameron Alexander,7,0,30,23
1656232394076,MATH 18,A02,083744,Cinel; Cameron Alexander,9,0,30,21
1656232394076,MATH 18,A03,083745,Cinel; Cameron Alexander,5,0,30,25
1656232394076,MATH 18,B01,083748,Rideout; David Porter,1,0,36,35
1656232394076,MATH 18,B02,083749,Rideout; David Porter,0,0,36,36
1656232394076,MATH 18,B03,083750,Rideout; David Porter,0,0,36,36
1656232394076,MATH 18,B04,083751,Rideout; David Porter,0,1,36,36
1656232394076,MATH 18,B05,093473,Rideout; David Porter,0,0,36,36
1656232394076,MATH 18,B06,093474,Rideout; David Porter,3,0,36,33
1656232400099,MATH 20A,A01,083754,Zheng; Zequn,11,0,40,29
1656232406122,MATH 20B,A01,083756,Briones; Jor-el Thomas Caparas,0,0,36,36
1656232406122,MATH 20B,A02,083757,Briones; Jor-el Thomas Caparas,0,0,36,36
1656232406122,MATH 20B,A03,093475,Staff,0,0,36,36
1656232412152,MATH 20C,A01,083760,Briones; Jor-el Thomas Caparas,0,0,35,35
1656232412152,MATH 20C,A02,083761,Briones; Jor-el Thomas Caparas,9,1,35,26
1656232412152,MATH 20C,A03,093476,Staff,0,0,35,35
1656232412152,MATH 20C,B01,083762,Bach; Quang Tran,1,0,30,29
1656232418176,MATH 20D,A01,083765,Tran; Brian Kha,1,0,30,29
1656232418176,MATH 20D,A02,083766,Tran; Brian Kha,0,1,30,30
1656232418176,MATH 20D,A03,083767,Tran; Brian Kha,2,0,30,28
1656232424205,MATH 20E,A01,083771,Ganguly; Soumya,3,0,32,29
1656232424205,MATH 20E,A02,083772,Ganguly; Soumya,0,0,32,32
1656232424205,MATH 20E,B01,083773,Ciotti; Benjamin,16,0,35,19
1656232424205,MATH 20E,B02,083774,Ciotti; Benjamin,15,0,35,20
1656232430231,MATH 103A,A01,083777,Greenfeld; Be'Eri,1,0,36,35
1656232430231,MATH 103A,A02,083778,Greenfeld; Be'Eri,1,0,36,35
1656232430231,MATH 103A,A03,093561,Staff,5,0,36,31
1656232430231,MATH 103A,B01,083779,Greenfeld; Be'Eri,8,0,36,28
1656232430231,MATH 103A,B02,083780,Greenfeld; Be'Eri,1,0,36,35
1656232430231,MATH 103A,B03,093562,Staff,0,0,36,36
1656232446298,MATH 105,A01,085443,Carter; Anne Toulson,5,0,35,30
1656232446298,MATH 105,A02,093477,Staff,14,0,35,21
1656232452326,MATH 109,A01,083213,Ganzberger; Geoffrey Michael,0,0,34,34
1656232452326,MATH 109,A02,083214,Ganzberger; Geoffrey Michael,0,0,34,34
1656232452326,MATH 109,A03,093478,Staff,1,0,34,33
1656232452326,MATH 109,B01,083215,Ganzberger; Geoffrey Michael,4,0,32,28
1656232452326,MATH 109,B02,083216,Ganzberger; Geoffrey Michael,1,0,32,31
1656232452326,MATH 109,B03,093479,Staff,4,0,32,28
1656232458351,MATH 142A,A01,083219,Chow; Bennett,2,0,32,30
1656232458351,MATH 142A,A02,083220,Chow; Bennett,8,0,32,24
1656232458351,MATH 142A,A03,093480,Staff,5,0,32,27
1656232458351,MATH 142A,B03,093481,Staff,3,0,32,29
1656232458351,MATH 142A,B04,093558,Staff,6,0,32,26
1656232458351,MATH 142A,B05,093559,Staff,0,0,32,32
1656232464375,MATH 193A,A01,083224,Rotar; Vladimir,0,1,34,34
1656232464375,MATH 193A,A02,083225,Rotar; Vladimir,0,0,34,34
1656232464375,MATH 193A,A03,083781,Rotar; Vladimir,0,0,34,34
1656232464375,MATH 193A,A04,083782,Rotar; Vladimir,6,0,34,28
1656232464375,MATH 193A,A05,093482,Rotar; Vladimir,0,0,34,34
1656232470402,MATH 197,001,091859,McAuley; Julian John,9999,0,9999,0
1656232470402,MATH 197,002,095566,Kedlaya; Kiran S.,9997,0,9999,2
1656232470402,MATH 197,003,095567,Xiao; Ming,9999,0,9999,0
1656232470402,MATH 197,004,095571,Perols; Johan Lars,9998,0,9999,1
1656232477455,COGS 9,A01,083615,Shannon; Kyle Michael,3,0,75,72
1656232483477,COGS 11,A01,083617,Boyle; Mary E. T.,14,0,48,34
1656232489512,COGS 13,A01,083071,Bastos; Amalia Pinkusfeld,4,0,71,67
1656232495534,COGS 14A,A01,092681,Semenuks; Arturs,0,12,100,100
1656232501557,COGS 14B,A01,083073,Cheng; Tzu-Han,7,0,63,56
1656232507582,COGS 17,A01,092677,Semenuks; Arturs,7,0,81,74
1656232513608,COGS 100,A01,083619,Allen; Michael Gordon,2,0,70,68
1656232519635,COGS 101A,A01,083621,Davis; Joshua Daniel,4,0,68,64
1656232525667,COGS 101B,A01,091572,Allen; Michael Gordon,4,0,65,61
1656232531689,COGS 101C,A01,083625,Delgado; Tania,10,0,35,25
1656232537717,COGS 107A,A01,083627,Boyle; Mary E. T.,0,0,60,60
1656232543740,COGS 118A,A01,083075,Gupta; Anjum,8,0,76,68
1656232549765,CSE 3,A50,083646,Miranda; Gregory Joseph,18,0,50,32
1656232555792,CSE 8A,A50,083650,Miranda; Gregory Joseph,2,2,56,54
1656232561817,CSE 11,A01,083080,Cao; Yingjun,0,49,40,40
1656232567844,CSE 12,A01,083652,Krause-Levy; Sophia Louisa,5,1,120,115
1656232573868,CSE 15L,A01,083654,Morris; Justin Loren,2,0,50,48
1656232573868,CSE 15L,A02,083655,Morris; Justin Loren,4,0,50,46
1656232579899,CSE 20,A01,083657,Tran; Khoa Dang,30,0,80,50
1656232585926,CSE 21,A01,095574,Bach; Quang Tran,23,0,48,25
1656232591958,CSE 30,A01,083084,Eldon; John,2,6,80,78
1656232591958,CSE 30,B01,095061,Bhaskar; Nishant,0,1,50,50
1656232597983,CSE 100,A01,083659,Cao; Yingjun,1,18,70,69
1656232604010,CSE 134B,A01,083661,Powell; Thomas Allan,5,0,100,95
1656232610031,CSE 140,A01,083663,Gungor; Onat,9,0,85,76
1656232616053,CSE 140L,A01,083088,Eldon; John,8,0,100,92
1656232622079,CSE 175,A01,083665,Kumar; Rakesh,0,0,25,25
1656232628102,CSE 190,A00,092507,Dubnov; Shlomo,3,0,20,17
1656232634125,ECE 45,A01,083139,Congero; Spencer William,1,0,75,74
1656232640150,ECE 65,A50,083695,Saad; Andrew S,9,0,30,21
1656232640150,ECE 65,A51,095125,Staff,24,0,26,2
1656232646181,ECE 109,A01,091882,Touri; Behrouz,0,1,70,70
1656232652209,ECE 180,A00,083140,Abi Samra; Nicholas Camill,1,0,30,29
1656232652209,ECE 180,B00,083141,Abi Samra; Nicholas Camill,0,4,30,30
1656232658233,MATH 10A,A01,083735,Patchell; Gregory David,0,0,30,30
1656232658233,MATH 10A,A02,083736,Patchell; Gregory David,22,0,30,8
1656232658233,MATH 10A,A03,083737,Patchell; Gregory David,16,0,30,14
1656232664261,MATH 10B,A01,083207,Lim; Seonhee,0,0,34,34
1656232664261,MATH 10B,A02,083208,Lim; Seonhee,7,0,35,28
1656232664261,MATH 10B,A03,093472,Staff,1,0,34,33
1656232664261,MATH 10B,B01,083739,Sinha; Shubham,11,0,30,19
1656232670286,MATH 18,A01,083743,Cinel; Cameron Alexander,7,0,30,23
1656232670286,MATH 18,A02,083744,Cinel; Cameron Alexander,9,0,30,21
1656232670286,MATH 18,A03,083745,Cinel; Cameron Alexander,5,0,30,25
1656232670286,MATH 18,B01,083748,Rideout; David Porter,1,0,36,35
1656232670286,MATH 18,B02,083749,Rideout; David Porter,0,0,36,36
1656232670286,MATH 18,B03,083750,Rideout; David Porter,0,0,36,36
1656232670286,MATH 18,B04,083751,Rideout; David Porter,0,1,36,36
1656232670286,MATH 18,B05,093473,Rideout; David Porter,0,0,36,36
1656232670286,MATH 18,B06,093474,Rideout; David Porter,3,0,36,33
1656232676313,MATH 20A,A01,083754,Zheng; Zequn,11,0,40,29
1656232682334,MATH 20B,A01,083756,Briones; Jor-el Thomas Caparas,0,0,36,36
1656232682334,MATH 20B,A02,083757,Briones; Jor-el Thomas Caparas,0,0,36,36
1656232682334,MATH 20B,A03,093475,Staff,0,0,36,36
1656232688363,MATH 20C,A01,083760,Briones; Jor-el Thomas Caparas,0,0,35,35
1656232688363,MATH 20C,A02,083761,Briones; Jor-el Thomas Caparas,9,1,35,26
1656232688363,MATH 20C,A03,093476,Staff,0,0,35,35
1656232688363,MATH 20C,B01,083762,Bach; Quang Tran,1,0,30,29
1656232694388,MATH 20D,A01,083765,Tran; Brian Kha,1,0,30,29
1656232694388,MATH 20D,A02,083766,Tran; Brian Kha,0,1,30,30
1656232694388,MATH 20D,A03,083767,Tran; Brian Kha,2,0,30,28
1656232700413,MATH 20E,A01,083771,Ganguly; Soumya,3,0,32,29
1656232700413,MATH 20E,A02,083772,Ganguly; Soumya,0,0,32,32
1656232700413,MATH 20E,B01,083773,Ciotti; Benjamin,16,0,35,19
1656232700413,MATH 20E,B02,083774,Ciotti; Benjamin,15,0,35,20
1656232706441,MATH 103A,A01,083777,Greenfeld; Be'Eri,1,0,36,35
1656232706441,MATH 103A,A02,083778,Greenfeld; Be'Eri,1,0,36,35
1656232706441,MATH 103A,A03,093561,Staff,5,0,36,31
1656232706441,MATH 103A,B01,083779,Greenfeld; Be'Eri,8,0,36,28
1656232706441,MATH 103A,B02,083780,Greenfeld; Be'Eri,1,0,36,35
1656232706441,MATH 103A,B03,093562,Staff,0,0,36,36
1656232712468,MATH 105,A01,085443,Carter; Anne Toulson,5,0,35,30
1656232712468,MATH 105,A02,093477,Staff,14,0,35,21
1656232718492,MATH 109,A01,083213,Ganzberger; Geoffrey Michael,0,0,34,34
1656232718492,MATH 109,A02,083214,Ganzberger; Geoffrey Michael,0,0,34,34
1656232718492,MATH 109,A03,093478,Staff,1,0,34,33
1656232718492,MATH 109,B01,083215,Ganzberger; Geoffrey Michael,4,0,32,28
1656232718492,MATH 109,B02,083216,Ganzberger; Geoffrey Michael,1,0,32,31
1656232718492,MATH 109,B03,093479,Staff,4,0,32,28
1656232724519,MATH 142A,A01,083219,Chow; Bennett,2,0,32,30
1656232724519,MATH 142A,A02,083220,Chow; Bennett,8,0,32,24
1656232724519,MATH 142A,A03,093480,Staff,5,0,32,27
1656232724519,MATH 142A,B03,093481,Staff,3,0,32,29
1656232724519,MATH 142A,B04,093558,Staff,6,0,32,26
1656232724519,MATH 142A,B05,093559,Staff,0,0,32,32
1656232730546,MATH 193A,A01,083224,Rotar; Vladimir,0,1,34,34
1656232730546,MATH 193A,A02,083225,Rotar; Vladimir,0,0,34,34
1656232730546,MATH 193A,A03,083781,Rotar; Vladimir,0,0,34,34
1656232730546,MATH 193A,A04,083782,Rotar; Vladimir,6,0,34,28
1656232730546,MATH 193A,A05,093482,Rotar; Vladimir,0,0,34,34
1656232736567,MATH 197,001,091859,McAuley; Julian John,9999,0,9999,0
1656232736567,MATH 197,002,095566,Kedlaya; Kiran S.,9997,0,9999,2
1656232736567,MATH 197,003,095567,Xiao; Ming,9999,0,9999,0
1656232736567,MATH 197,004,095571,Perols; Johan Lars,9998,0,9999,1
1656232743621,COGS 9,A01,083615,Shannon; Kyle Michael,3,0,75,72
1656232749644,COGS 11,A01,083617,Boyle; Mary E. T.,14,0,48,34
1656232755667,COGS 13,A01,083071,Bastos; Amalia Pinkusfeld,4,0,71,67
1656232761689,COGS 14A,A01,092681,Semenuks; Arturs,0,12,100,100
1656232767714,COGS 14B,A01,083073,Cheng; Tzu-Han,7,0,63,56
1656232773739,COGS 17,A01,092677,Semenuks; Arturs,7,0,81,74
1656232779762,COGS 100,A01,083619,Allen; Michael Gordon,2,0,70,68
1656232785785,COGS 101A,A01,083621,Davis; Joshua Daniel,4,0,68,64
1656232791808,COGS 101B,A01,091572,Allen; Michael Gordon,4,0,65,61
1656232797835,COGS 101C,A01,083625,Delgado; Tania,10,0,35,25
1656232803859,COGS 107A,A01,083627,Boyle; Mary E. T.,0,0,60,60
1656232809883,COGS 118A,A01,083075,Gupta; Anjum,8,0,76,68
1656232815906,CSE 3,A50,083646,Miranda; Gregory Joseph,18,0,50,32
1656232821933,CSE 8A,A50,083650,Miranda; Gregory Joseph,2,2,56,54
1656232827955,CSE 11,A01,083080,Cao; Yingjun,0,49,40,40
1656232833978,CSE 12,A01,083652,Krause-Levy; Sophia Louisa,5,1,120,115
1656232840002,CSE 15L,A01,083654,Morris; Justin Loren,2,0,50,48
1656232840002,CSE 15L,A02,083655,Morris; Justin Loren,4,0,50,46
1656232846025,CSE 20,A01,083657,Tran; Khoa Dang,30,0,80,50
1656232852051,CSE 21,A01,095574,Bach; Quang Tran,23,0,48,25
1656232858076,CSE 30,A01,083084,Eldon; John,2,6,80,78
1656232858076,CSE 30,B01,095061,Bhaskar; Nishant,0,1,50,50
1656232864170,CSE 100,A01,083659,Cao; Yingjun,1,18,70,69
1656232870192,CSE 134B,A01,083661,Powell; Thomas Allan,5,0,100,95
1656232876215,CSE 140,A01,083663,Gungor; Onat,9,0,85,76
1656232882241,CSE 140L,A01,083088,Eldon; John,8,0,100,92
1656232888265,CSE 175,A01,083665,Kumar; Rakesh,0,0,25,25
1656232894287,CSE 190,A00,092507,Dubnov; Shlomo,3,0,20,17
1656232900310,ECE 45,A01,083139,Congero; Spencer William,1,0,75,74
1656232906334,ECE 65,A50,083695,Saad; Andrew S,9,0,30,21
1656232906334,ECE 65,A51,095125,Staff,24,0,26,2
1656232912366,ECE 109,A01,091882,Touri; Behrouz,0,1,70,70
1656232918388,ECE 180,A00,083140,Abi Samra; Nicholas Camill,1,0,30,29
1656232918388,ECE 180,B00,083141,Abi Samra; Nicholas Camill,0,4,30,30
1656232924412,MATH 10A,A01,083735,Patchell; Gregory David,0,0,30,30
1656232924412,MATH 10A,A02,083736,Patchell; Gregory David,22,0,30,8
1656232924412,MATH 10A,A03,083737,Patchell; Gregory David,16,0,30,14
1656232930438,MATH 10B,A01,083207,Lim; Seonhee,0,0,34,34
1656232930438,MATH 10B,A02,083208,Lim; Seonhee,7,0,35,28
1656232930438,MATH 10B,A03,093472,Staff,1,0,34,33
1656232930438,MATH 10B,B01,083739,Sinha; Shubham,11,0,30,19
1656232936460,MATH 18,A01,083743,Cinel; Cameron Alexander,7,0,30,23
1656232936460,MATH 18,A02,083744,Cinel; Cameron Alexander,9,0,30,21
1656232936460,MATH 18,A03,083745,Cinel; Cameron Alexander,5,0,30,25
1656232936460,MATH 18,B01,083748,Rideout; David Porter,1,0,36,35
1656232936460,MATH 18,B02,083749,Rideout; David Porter,0,0,36,36
1656232936460,MATH 18,B03,083750,Rideout; David Porter,0,0,36,36
1656232936460,MATH 18,B04,083751,Rideout; David Porter,0,1,36,36
1656232936460,MATH 18,B05,093473,Rideout; David Porter,0,0,36,36
1656232936460,MATH 18,B06,093474,Rideout; David Porter,3,0,36,33
1656232942485,MATH 20A,A01,083754,Zheng; Zequn,11,0,40,29
1656232948508,MATH 20B,A01,083756,Briones; Jor-el Thomas Caparas,0,0,36,36
1656232948508,MATH 20B,A02,083757,Briones; Jor-el Thomas Caparas,0,0,36,36
1656232948508,MATH 20B,A03,093475,Staff,0,0,36,36
1656232954536,MATH 20C,A01,083760,Briones; Jor-el Thomas Caparas,0,0,35,35
1656232954536,MATH 20C,A02,083761,Briones; Jor-el Thomas Caparas,9,1,35,26
1656232954536,MATH 20C,A03,093476,Staff,0,0,35,35
1656232954536,MATH 20C,B01,083762,Bach; Quang Tran,1,0,30,29
1656232960561,MATH 20D,A01,083765,Tran; Brian Kha,1,0,30,29
1656232960561,MATH 20D,A02,083766,Tran; Brian Kha,0,1,30,30
1656232960561,MATH 20D,A03,083767,Tran; Brian Kha,2,0,30,28
1656232966584,MATH 20E,A01,083771,Ganguly; Soumya,3,0,32,29
1656232966584,MATH 20E,A02,083772,Ganguly; Soumya,0,0,32,32
1656232966584,MATH 20E,B01,083773,Ciotti; Benjamin,16,0,35,19
1656232966584,MATH 20E,B02,083774,Ciotti; Benjamin,15,0,35,20
1656232972607,MATH 103A,A01,083777,Greenfeld; Be'Eri,1,0,36,35
1656232972607,MATH 103A,A02,083778,Greenfeld; Be'Eri,1,0,36,35
1656232972607,MATH 103A,A03,093561,Staff,5,0,36,31
1656232972607,MATH 103A,B01,083779,Greenfeld; Be'Eri,8,0,36,28
1656232972607,MATH 103A,B02,083780,Greenfeld; Be'Eri,1,0,36,35
1656232972607,MATH 103A,B03,093562,Staff,0,0,36,36
1656232978634,MATH 105,A01,085443,Carter; Anne Toulson,5,0,35,30
1656232978634,MATH 105,A02,093477,Staff,14,0,35,21
1656232984658,MATH 109,A01,083213,Ganzberger; Geoffrey Michael,0,0,34,34
1656232984658,MATH 109,A02,083214,Ganzberger; Geoffrey Michael,0,0,34,34
1656232984658,MATH 109,A03,093478,Staff,1,0,34,33
1656232984658,MATH 109,B01,083215,Ganzberger; Geoffrey Michael,4,0,32,28
1656232984658,MATH 109,B02,083216,Ganzberger; Geoffrey Michael,1,0,32,31
1656232984658,MATH 109,B03,093479,Staff,4,0,32,28
1656232990683,MATH 142A,A01,083219,Chow; Bennett,2,0,32,30
1656232990683,MATH 142A,A02,083220,Chow; Bennett,8,0,32,24
1656232990683,MATH 142A,A03,093480,Staff,5,0,32,27
1656232990683,MATH 142A,B03,093481,Staff,3,0,32,29
1656232990683,MATH 142A,B04,093558,Staff,6,0,32,26
1656232990683,MATH 142A,B05,093559,Staff,0,0,32,32
1656232996710,MATH 193A,A01,083224,Rotar; Vladimir,0,1,34,34
1656232996710,MATH 193A,A02,083225,Rotar; Vladimir,0,0,34,34
1656232996710,MATH 193A,A03,083781,Rotar; Vladimir,0,0,34,34
1656232996710,MATH 193A,A04,083782,Rotar; Vladimir,6,0,34,28
1656232996710,MATH 193A,A05,093482,Rotar; Vladimir,0,0,34,34
1656233002737,MATH 197,001,091859,McAuley; Julian John,9999,0,9999,0
1656233002737,MATH 197,002,095566,Kedlaya; Kiran S.,9997,0,9999,2
1656233002737,MATH 197,003,095567,Xiao; Ming,9999,0,9999,0
1656233002737,MATH 197,004,095571,Perols; Johan Lars,9998,0,9999,1
1656233009798,COGS 9,A01,083615,Shannon; Kyle Michael,3,0,75,72
1656233015823,COGS 11,A01,083617,Boyle; Mary E. T.,14,0,48,34
1656233021851,COGS 13,A01,083071,Bastos; Amalia Pinkusfeld,4,0,71,67
1656233027874,COGS 14A,A01,092681,Semenuks; Arturs,1,12,100,99
1656233033901,COGS 14B,A01,083073,Cheng; Tzu-Han,7,0,63,56
1656233039931,COGS 17,A01,092677,Semenuks; Arturs,7,0,81,74
1656233045955,COGS 100,A01,083619,Allen; Michael Gordon,2,0,70,68
1656233051978,COGS 101A,A01,083621,Davis; Joshua Daniel,4,0,68,64
1656233058001,COGS 101B,A01,091572,Allen; Michael Gordon,4,0,65,61
1656233064025,COGS 101C,A01,083625,Delgado; Tania,10,0,35,25
1656233070052,COGS 107A,A01,083627,Boyle; Mary E. T.,0,0,60,60
1656233076075,COGS 118A,A01,083075,Gupta; Anjum,8,0,76,68
1656233082101,CSE 3,A50,083646,Miranda; Gregory Joseph,18,0,50,32
1656233088128,CSE 8A,A50,083650,Miranda; Gregory Joseph,2,2,56,54
1656233094151,CSE 11,A01,083080,Cao; Yingjun,0,49,40,40
1656233100178,CSE 12,A01,083652,Krause-Levy; Sophia Louisa,5,1,120,115
1656233106202,CSE 15L,A01,083654,Morris; Justin Loren,2,0,50,48
1656233106202,CSE 15L,A02,083655,Morris; Justin Loren,4,0,50,46
1656233112226,CSE 20,A01,083657,Tran; Khoa Dang,30,0,80,50
1656233118249,CSE 21,A01,095574,Bach; Quang Tran,23,0,48,25
1656233124271,CSE 30,A01,083084,Eldon; John,2,6,80,78
1656233124271,CSE 30,B01,095061,Bhaskar; Nishant,0,1,50,50
1656233130295,CSE 100,A01,083659,Cao; Yingjun,1,18,70,69
1656233136319,CSE 134B,A01,083661,Powell; Thomas Allan,5,0,100,95
1656233142346,CSE 140,A01,083663,Gungor; Onat,9,0,85,76
1656233148374,CSE 140L,A01,083088,Eldon; John,8,0,100,92
1656233154397,CSE 175,A01,083665,Kumar; Rakesh,0,0,25,25
1656233160424,CSE 190,A00,092507,Dubnov; Shlomo,3,0,20,17
1656233166451,ECE 45,A01,083139,Congero; Spencer William,1,0,75,74
1656233172473,ECE 65,A50,083695,Saad; Andrew S,9,0,30,21
1656233172473,ECE 65,A51,095125,Staff,24,0,26,2
1656233178496,ECE 109,A01,091882,Touri; Behrouz,0,1,70,70
1656233184520,ECE 180,A00,083140,Abi Samra; Nicholas Camill,1,0,30,29
1656233184520,ECE 180,B00,083141,Abi Samra; Nicholas Camill,0,4,30,30
1656233190544,MATH 10A,A01,083735,Patchell; Gregory David,0,0,30,30
1656233190544,MATH 10A,A02,083736,Patchell; Gregory David,22,0,30,8
1656233190544,MATH 10A,A03,083737,Patchell; Gregory David,16,0,30,14
1656233196568,MATH 10B,A01,083207,Lim; Seonhee,0,0,34,34
1656233196568,MATH 10B,A02,083208,Lim; Seonhee,7,0,35,28
1656233196568,MATH 10B,A03,093472,Staff,1,0,34,33
1656233196568,MATH 10B,B01,083739,Sinha; Shubham,11,0,30,19
1656233202600,MATH 18,A01,083743,Cinel; Cameron Alexander,7,0,30,23
1656233202600,MATH 18,A02,083744,Cinel; Cameron Alexander,9,0,30,21
1656233202600,MATH 18,A03,083745,Cinel; Cameron Alexander,5,0,30,25
1656233202600,MATH 18,B01,083748,Rideout; David Porter,1,0,36,35
1656233202600,MATH 18,B02,083749,Rideout; David Porter,0,0,36,36
1656233202600,MATH 18,B03,083750,Rideout; David Porter,0,0,36,36
1656233202600,MATH 18,B04,083751,Rideout; David Porter,0,1,36,36
1656233202600,MATH 18,B05,093473,Rideout; David Porter,0,0,36,36
1656233202600,MATH 18,B06,093474,Rideout; David Porter,3,0,36,33
1656233208623,MATH 20A,A01,083754,Zheng; Zequn,11,0,40,29
1656233214648,MATH 20B,A01,083756,Briones; Jor-el Thomas Caparas,0,0,36,36
1656233214648,MATH 20B,A02,083757,Briones; Jor-el Thomas Caparas,0,0,36,36
1656233214648,MATH 20B,A03,093475,Staff,0,0,36,36
1656233220677,MATH 20C,A01,083760,Briones; Jor-el Thomas Caparas,0,0,35,35
1656233220677,MATH 20C,A02,083761,Briones; Jor-el Thomas Caparas,9,1,35,26
1656233220677,MATH 20C,A03,093476,Staff,0,0,35,35
1656233220677,MATH 20C,B01,083762,Bach; Quang Tran,1,0,30,29
1656233226704,MATH 20D,A01,083765,Tran; Brian Kha,1,0,30,29
1656233226704,MATH 20D,A02,083766,Tran; Brian Kha,0,1,30,30
1656233226704,MATH 20D,A03,083767,Tran; Brian Kha,2,0,30,28
1656233232733,MATH 20E,A01,083771,Ganguly; Soumya,3,0,32,29
1656233232733,MATH 20E,A02,083772,Ganguly; Soumya,0,0,32,32
1656233232733,MATH 20E,B01,083773,Ciotti; Benjamin,16,0,35,19
1656233232733,MATH 20E,B02,083774,Ciotti; Benjamin,15,0,35,20
1656233238757,MATH 103A,A01,083777,Greenfeld; Be'Eri,1,0,36,35
1656233238757,MATH 103A,A02,083778,Greenfeld; Be'Eri,1,0,36,35
1656233238757,MATH 103A,A03,093561,Staff,5,0,36,31
1656233238757,MATH 103A,B01,083779,Greenfeld; Be'Eri,8,0,36,28
1656233238757,MATH 103A,B02,083780,Greenfeld; Be'Eri,1,0,36,35
1656233238757,MATH 103A,B03,093562,Staff,0,0,36,36
1656233244785,MATH 105,A01,085443,Carter; Anne Toulson,5,0,35,30
1656233244785,MATH 105,A02,093477,Staff,14,0,35,21
1656233250813,MATH 109,A01,083213,Ganzberger; Geoffrey Michael,0,0,34,34
1656233250813,MATH 109,A02,083214,Ganzberger; Geoffrey Michael,0,0,34,34
1656233250813,MATH 109,A03,093478,Staff,1,0,34,33
1656233250813,MATH 109,B01,083215,Ganzberger; Geoffrey Michael,4,0,32,28
1656233250813,MATH 109,B02,083216,Ganzberger; Geoffrey Michael,1,0,32,31
1656233250813,MATH 109,B03,093479,Staff,4,0,32,28
1656233256837,MATH 142A,A01,083219,Chow; Bennett,2,0,32,30
1656233256837,MATH 142A,A02,083220,Chow; Bennett,8,0,32,24
1656233256837,MATH 142A,A03,093480,Staff,5,0,32,27
1656233256837,MATH 142A,B03,093481,Staff,3,0,32,29
1656233256837,MATH 142A,B04,093558,Staff,6,0,32,26
1656233256837,MATH 142A,B05,093559,Staff,0,0,32,32
1656233262861,MATH 193A,A01,083224,Rotar; Vladimir,0,1,34,34
1656233262861,MATH 193A,A02,083225,Rotar; Vladimir,0,0,34,34
1656233262861,MATH 193A,A03,083781,Rotar; Vladimir,0,0,34,34
1656233262861,MATH 193A,A04,083782,Rotar; Vladimir,6,0,34,28
1656233262861,MATH 193A,A05,093482,Rotar; Vladimir,0,0,34,34
1656233268885,MATH 197,001,091859,McAuley; Julian John,9999,0,9999,0
1656233268885,MATH 197,002,095566,Kedlaya; Kiran S.,9997,0,9999,2
1656233268885,MATH 197,003,095567,Xiao; Ming,9999,0,9999,0
1656233268885,MATH 197,004,095571,Perols; Johan Lars,9998,0,9999,1
1656233275942,COGS 9,A01,083615,Shannon; Kyle Michael,3,0,75,72
1656233281966,COGS 11,A01,083617,Boyle; Mary E. T.,14,0,48,34
1656233287989,COGS 13,A01,083071,Bastos; Amalia Pinkusfeld,4,0,71,67
1656233294012,COGS 14A,A01,092681,Semenuks; Arturs,1,12,100,99
1656233300038,COGS 14B,A01,083073,Cheng; Tzu-Han,7,0,63,56
1656233306062,COGS 17,A01,092677,Semenuks; Arturs,7,0,81,74
1656233312087,COGS 100,A01,083619,Allen; Michael Gordon,2,0,70,68
1656233318111,COGS 101A,A01,083621,Davis; Joshua Daniel,4,0,68,64
1656233324135,COGS 101B,A01,091572,Allen; Michael Gordon,4,0,65,61
1656233330160,COGS 101C,A01,083625,Delgado; Tania,10,0,35,25
1656233336184,COGS 107A,A01,083627,Boyle; Mary E. T.,0,0,60,60
1656233342208,COGS 118A,A01,083075,Gupta; Anjum,8,0,76,68
1656233348236,CSE 3,A50,083646,Miranda; Gregory Joseph,18,0,50,32
1656233354264,CSE 8A,A50,083650,Miranda; Gregory Joseph,2,2,56,54
1656233360289,CSE 11,A01,083080,Cao; Yingjun,0,49,40,40
1656233366318,CSE 12,A01,083652,Krause-Levy; Sophia Louisa,5,1,120,115
1656233372341,CSE 15L,A01,083654,Morris; Justin Loren,2,0,50,48
1656233372341,CSE 15L,A02,083655,Morris; Justin Loren,4,0,50,46
1656233378370,CSE 20,A01,083657,Tran; Khoa Dang,30,0,80,50
1656233384395,CSE 21,A01,095574,Bach; Quang Tran,23,0,48,25
1656233390426,CSE 30,A01,083084,Eldon; John,2,6,80,78
1656233390426,CSE 30,B01,095061,Bhaskar; Nishant,0,1,50,50
1656233396449,CSE 100,A01,083659,Cao; Yingjun,1,18,70,69
1656233402471,CSE 134B,A01,083661,Powell; Thomas Allan,5,0,100,95
1656233408495,CSE 140,A01,083663,Gungor; Onat,9,0,85,76
1656233414521,CSE 140L,A01,083088,Eldon; John,8,0,100,92
1656233420542,CSE 175,A01,083665,Kumar; Rakesh,0,0,25,25
1656233426586,CSE 190,A00,092507,Dubnov; Shlomo,3,0,20,17
1656233432611,ECE 45,A01,083139,Congero; Spencer William,1,0,75,74
1656233438638,ECE 65,A50,083695,Saad; Andrew S,9,0,30,21
1656233438638,ECE 65,A51,095125,Staff,24,0,26,2
1656233444660,ECE 109,A01,091882,Touri; Behrouz,0,1,70,70
1656233450687,ECE 180,A00,083140,Abi Samra; Nicholas Camill,1,0,30,29
1656233450687,ECE 180,B00,083141,Abi Samra; Nicholas Camill,0,4,30,30
1656233456710,MATH 10A,A01,083735,Patchell; Gregory David,0,0,30,30
1656233456710,MATH 10A,A02,083736,Patchell; Gregory David,22,0,30,8
1656233456710,MATH 10A,A03,083737,Patchell; Gregory David,16,0,30,14
1656233462807,MATH 10B,A01,083207,Lim; Seonhee,0,0,34,34
1656233462807,MATH 10B,A02,083208,Lim; Seonhee,7,0,35,28
1656233462807,MATH 10B,A03,093472,Staff,1,0,34,33
1656233462807,MATH 10B,B01,083739,Sinha; Shubham,11,0,30,19
1656233468837,MATH 18,A01,083743,Cinel; Cameron Alexander,7,0,30,23
1656233468837,MATH 18,A02,083744,Cinel; Cameron Alexander,9,0,30,21
1656233468837,MATH 18,A03,083745,Cinel; Cameron Alexander,5,0,30,25
1656233468837,MATH 18,B01,083748,Rideout; David Porter,1,0,36,35
1656233468837,MATH 18,B02,083749,Rideout; David Porter,0,0,36,36
1656233468837,MATH 18,B03,083750,Rideout; David Porter,0,0,36,36
1656233468837,MATH 18,B04,083751,Rideout; David Porter,0,1,36,36
1656233468837,MATH 18,B05,093473,Rideout; David Porter,0,0,36,36
1656233468837,MATH 18,B06,093474,Rideout; David Porter,3,0,36,33
1656233474860,MATH 20A,A01,083754,Zheng; Zequn,11,0,40,29
1656233480885,MATH 20B,A01,083756,Briones; Jor-el Thomas Caparas,0,0,36,36
1656233480885,MATH 20B,A02,083757,Briones; Jor-el Thomas Caparas,0,0,36,36
1656233480885,MATH 20B,A03,093475,Staff,0,0,36,36
1656233486908,MATH 20C,A01,083760,Briones; Jor-el Thomas Caparas,0,0,35,35
1656233486908,MATH 20C,A02,083761,Briones; Jor-el Thomas Caparas,9,1,35,26
1656233486908,MATH 20C,A03,093476,Staff,0,0,35,35
1656233486908,MATH 20C,B01,083762,Bach; Quang Tran,1,0,30,29
1656233492936,MATH 20D,A01,083765,Tran; Brian Kha,1,0,30,29
1656233492936,MATH 20D,A02,083766,Tran; Brian Kha,0,1,30,30
1656233492936,MATH 20D,A03,083767,Tran; Brian Kha,2,0,30,28
1656233498965,MATH 20E,A01,083771,Ganguly; Soumya,3,0,32,29
1656233498965,MATH 20E,A02,083772,Ganguly; Soumya,0,0,32,32
1656233498965,MATH 20E,B01,083773,Ciotti; Benjamin,16,0,35,19
1656233498965,MATH 20E,B02,083774,Ciotti; Benjamin,15,0,35,20
1656233504993,MATH 103A,A01,083777,Greenfeld; Be'Eri,1,0,36,35
1656233504993,MATH 103A,A02,083778,Greenfeld; Be'Eri,1,0,36,35
1656233504993,MATH 103A,A03,093561,Staff,5,0,36,31
1656233504993,MATH 103A,B01,083779,Greenfeld; Be'Eri,8,0,36,28
1656233504993,MATH 103A,B02,083780,Greenfeld; Be'Eri,1,0,36,35
1656233504993,MATH 103A,B03,093562,Staff,0,0,36,36
1656233511017,MATH 105,A01,085443,Carter; Anne Toulson,5,0,35,30
1656233511017,MATH 105,A02,093477,Staff,14,0,35,21
1656233517046,MATH 109,A01,083213,Ganzberger; Geoffrey Michael,0,0,34,34
1656233517046,MATH 109,A02,083214,Ganzberger; Geoffrey Michael,0,0,34,34
1656233517046,MATH 109,A03,093478,Staff,1,0,34,33
1656233517046,MATH 109,B01,083215,Ganzberger; Geoffrey Michael,4,0,32,28
1656233517046,MATH 109,B02,083216,Ganzberger; Geoffrey Michael,1,0,32,31
1656233517046,MATH 109,B03,093479,Staff,4,0,32,28
1656233523076,MATH 142A,A01,083219,Chow; Bennett,2,0,32,30
1656233523076,MATH 142A,A02,083220,Chow; Bennett,8,0,32,24
1656233523076,MATH 142A,A03,093480,Staff,5,0,32,27
1656233523076,MATH 142A,B03,093481,Staff,3,0,32,29
1656233523076,MATH 142A,B04,093558,Staff,6,0,32,26
1656233523076,MATH 142A,B05,093559,Staff,0,0,32,32
1656233529098,MATH 193A,A01,083224,Rotar; Vladimir,0,1,34,34
1656233529098,MATH 193A,A02,083225,Rotar; Vladimir,0,0,34,34
1656233529098,MATH 193A,A03,083781,Rotar; Vladimir,0,0,34,34
1656233529098,MATH 193A,A04,083782,Rotar; Vladimir,6,0,34,28
1656233529098,MATH 193A,A05,093482,Rotar; Vladimir,0,0,34,34
1656233535121,MATH 197,001,091859,McAuley; Julian John,9999,0,9999,0
1656233535121,MATH 197,002,095566,Kedlaya; Kiran S.,9997,0,9999,2
1656233535121,MATH 197,003,095567,Xiao; Ming,9999,0,9999,0
1656233535121,MATH 197,004,095571,Perols; Johan Lars,9998,0,9999,1
1656233542190,COGS 9,A01,083615,Shannon; Kyle Michael,3,0,75,72
1656233548216,COGS 11,A01,083617,Boyle; Mary E. T.,14,0,48,34
1656233554247,COGS 13,A01,083071,Bastos; Amalia Pinkusfeld,4,0,71,67
1656233560270,COGS 14A,A01,092681,Semenuks; Arturs,1,12,100,99
1656233566294,COGS 14B,A01,083073,Cheng; Tzu-Han,7,0,63,56
1656233572318,COGS 17,A01,092677,Semenuks; Arturs,7,0,81,74
1656233578341,COGS 100,A01,083619,Allen; Michael Gordon,2,0,70,68
1656233584364,COGS 101A,A01,083621,Davis; Joshua Daniel,4,0,68,64
1656233590391,COGS 101B,A01,091572,Allen; Michael Gordon,4,0,65,61
1656233596416,COGS 101C,A01,083625,Delgado; Tania,10,0,35,25
1656233602440,COGS 107A,A01,083627,Boyle; Mary E. T.,0,0,60,60
1656233608463,COGS 118A,A01,083075,Gupta; Anjum,8,0,76,68
1656233614488,CSE 3,A50,083646,Miranda; Gregory Joseph,18,0,50,32
1656233620509,CSE 8A,A50,083650,Miranda; Gregory Joseph,2,2,56,54
1656233626535,CSE 11,A01,083080,Cao; Yingjun,0,49,40,40
1656233632566,CSE 12,A01,083652,Krause-Levy; Sophia Louisa,5,1,120,115
1656233638591,CSE 15L,A01,083654,Morris; Justin Loren,2,0,50,48
1656233638591,CSE 15L,A02,083655,Morris; Justin Loren,4,0,50,46
1656233644615,CSE 20,A01,083657,Tran; Khoa Dang,30,0,80,50
1656233650640,CSE 21,A01,095574,Bach; Quang Tran,23,0,48,25
1656233656666,CSE 30,A01,083084,Eldon; John,2,6,80,78
1656233656666,CSE 30,B01,095061,Bhaskar; Nishant,0,1,50,50
1656233662690,CSE 100,A01,083659,Cao; Yingjun,1,18,70,69
1656233668716,CSE 134B,A01,083661,Powell; Thomas Allan,5,0,100,95
1656233674743,CSE 140,A01,083663,Gungor; Onat,9,0,85,76
1656233680766,CSE 140L,A01,083088,Eldon; John,8,0,100,92
1656233686790,CSE 175,A01,083665,Kumar; Rakesh,0,0,25,25
1656233692813,CSE 190,A00,092507,Dubnov; Shlomo,3,0,20,17
1656233698840,ECE 45,A01,083139,Congero; Spencer William,1,0,75,74
1656233704865,ECE 65,A50,083695,Saad; Andrew S,9,0,30,21
1656233704865,ECE 65,A51,095125,Staff,24,0,26,2
1656233710888,ECE 109,A01,091882,Touri; Behrouz,0,1,70,70
1656233716913,ECE 180,A00,083140,Abi Samra; Nicholas Camill,1,0,30,29
1656233716913,ECE 180,B00,083141,Abi Samra; Nicholas Camill,0,4,30,30
1656233722937,MATH 10A,A01,083735,Patchell; Gregory David,0,0,30,30
1656233722937,MATH 10A,A02,083736,Patchell; Gregory David,22,0,30,8
1656233722937,MATH 10A,A03,083737,Patchell; Gregory David,16,0,30,14
1656233728961,MATH 10B,A01,083207,Lim; Seonhee,0,0,34,34
1656233728961,MATH 10B,A02,083208,Lim; Seonhee,7,0,35,28
1656233728961,MATH 10B,A03,093472,Staff,1,0,34,33
1656233728961,MATH 10B,B01,083739,Sinha; Shubham,11,0,30,19
1656233734992,MATH 18,A01,083743,Cinel; Cameron Alexander,7,0,30,23
1656233734992,MATH 18,A02,083744,Cinel; Cameron Alexander,9,0,30,21
1656233734992,MATH 18,A03,083745,Cinel; Cameron Alexander,5,0,30,25
1656233734992,MATH 18,B01,083748,Rideout; David Porter,1,0,36,35
1656233734992,MATH 18,B02,083749,Rideout; David Porter,0,0,36,36
1656233734992,MATH 18,B03,083750,Rideout; David Porter,0,0,36,36
1656233734992,MATH 18,B04,083751,Rideout; David Porter,0,1,36,36
1656233734992,MATH 18,B05,093473,Rideout; David Porter,0,0,36,36
1656233734992,MATH 18,B06,093474,Rideout; David Porter,3,0,36,33
1656233741016,MATH 20A,A01,083754,Zheng; Zequn,11,0,40,29
1656233747040,MATH 20B,A01,083756,Briones; Jor-el Thomas Caparas,0,0,36,36
1656233747040,MATH 20B,A02,083757,Briones; Jor-el Thomas Caparas,0,0,36,36
1656233747040,MATH 20B,A03,093475,Staff,0,0,36,36
1656233753066,MATH 20C,A01,083760,Briones; Jor-el Thomas Caparas,0,0,35,35
1656233753066,MATH 20C,A02,083761,Briones; Jor-el Thomas Caparas,9,1,35,26
1656233753066,MATH 20C,A03,093476,Staff,0,0,35,35
1656233753066,MATH 20C,B01,083762,Bach; Quang Tran,1,0,30,29
1656233759089,MATH 20D,A01,083765,Tran; Brian Kha,1,0,30,29
1656233759089,MATH 20D,A02,083766,Tran; Brian Kha,0,1,30,30
1656233759089,MATH 20D,A03,083767,Tran; Brian Kha,2,0,30,28
1656233765118,MATH 20E,A01,083771,Ganguly; Soumya,3,0,32,29
1656233765118,MATH 20E,A02,083772,Ganguly; Soumya,0,0,32,32
1656233765118,MATH 20E,B01,083773,Ciotti; Benjamin,16,0,35,19
1656233765118,MATH 20E,B02,083774,Ciotti; Benjamin,15,0,35,20
1656233771141,MATH 103A,A01,083777,Greenfeld; Be'Eri,1,0,36,35
1656233771141,MATH 103A,A02,083778,Greenfeld; Be'Eri,1,0,36,35
1656233771141,MATH 103A,A03,093561,Staff,5,0,36,31
1656233771141,MATH 103A,B01,083779,Greenfeld; Be'Eri,8,0,36,28
1656233771141,MATH 103A,B02,083780,Greenfeld; Be'Eri,1,0,36,35
1656233771141,MATH 103A,B03,093562,Staff,0,0,36,36
1656233777167,MATH 105,A01,085443,Carter; Anne Toulson,5,0,35,30
1656233777167,MATH 105,A02,093477,Staff,14,0,35,21
1656233783195,MATH 109,A01,083213,Ganzberger; Geoffrey Michael,0,0,34,34
1656233783195,MATH 109,A02,083214,Ganzberger; Geoffrey Michael,0,0,34,34
1656233783195,MATH 109,A03,093478,Staff,1,0,34,33
1656233783195,MATH 109,B01,083215,Ganzberger; Geoffrey Michael,4,0,32,28
1656233783195,MATH 109,B02,083216,Ganzberger; Geoffrey Michael,1,0,32,31
1656233783195,MATH 109,B03,093479,Staff,4,0,32,28
1656233789225,MATH 142A,A01,083219,Chow; Bennett,2,0,32,30
1656233789225,MATH 142A,A02,083220,Chow; Bennett,8,0,32,24
1656233789225,MATH 142A,A03,093480,Staff,5,0,32,27
1656233789225,MATH 142A,B03,093481,Staff,3,0,32,29
1656233789225,MATH 142A,B04,093558,Staff,6,0,32,26
1656233789225,MATH 142A,B05,093559,Staff,0,0,32,32
1656233795249,MATH 193A,A01,083224,Rotar; Vladimir,0,1,34,34
1656233795249,MATH 193A,A02,083225,Rotar; Vladimir,0,0,34,34
1656233795249,MATH 193A,A03,083781,Rotar; Vladimir,0,0,34,34
1656233795249,MATH 193A,A04,083782,Rotar; Vladimir,6,0,34,28
1656233795249,MATH 193A,A05,093482,Rotar; Vladimir,0,0,34,34
1656233801276,MATH 197,001,091859,McAuley; Julian John,9999,0,9999,0
1656233801276,MATH 197,002,095566,Kedlaya; Kiran S.,9997,0,9999,2
1656233801276,MATH 197,003,095567,Xiao; Ming,9999,0,9999,0
1656233801276,MATH 197,004,095571,Perols; Johan Lars,9998,0,9999,1
1656233808330,COGS 9,A01,083615,Shannon; Kyle Michael,3,0,75,72
1656233814358,COGS 11,A01,083617,Boyle; Mary E. T.,14,0,48,34
1656233820384,COGS 13,A01,083071,Bastos; Amalia Pinkusfeld,4,0,71,67
1656233826407,COGS 14A,A01,092681,Semenuks; Arturs,1,12,100,99
1656233832431,COGS 14B,A01,083073,Cheng; Tzu-Han,7,0,63,56
1656233838458,COGS 17,A01,092677,Semenuks; Arturs,7,0,81,74
1656233844480,COGS 100,A01,083619,Allen; Michael Gordon,2,0,70,68
1656233850508,COGS 101A,A01,083621,Davis; Joshua Daniel,4,0,68,64
1656233856535,COGS 101B,A01,091572,Allen; Michael Gordon,4,0,65,61
1656233862560,COGS 101C,A01,083625,Delgado; Tania,10,0,35,25
1656233868583,COGS 107A,A01,083627,Boyle; Mary E. T.,0,0,60,60
1656233874607,COGS 118A,A01,083075,Gupta; Anjum,8,0,76,68
1656233880630,CSE 3,A50,083646,Miranda; Gregory Joseph,18,0,50,32
1656233886654,CSE 8A,A50,083650,Miranda; Gregory Joseph,2,2,56,54
1656233892676,CSE 11,A01,083080,Cao; Yingjun,0,49,40,40
1656233898698,CSE 12,A01,083652,Krause-Levy; Sophia Louisa,5,1,120,115
1656233904723,CSE 15L,A01,083654,Morris; Justin Loren,2,0,50,48
1656233904723,CSE 15L,A02,083655,Morris; Justin Loren,4,0,50,46
1656233910746,CSE 20,A01,083657,Tran; Khoa Dang,30,0,80,50
1656233916770,CSE 21,A01,095574,Bach; Quang Tran,23,0,48,25
1656233922798,CSE 30,A01,083084,Eldon; John,2,6,80,78
1656233922798,CSE 30,B01,095061,Bhaskar; Nishant,0,1,50,50
1656233928826,CSE 100,A01,083659,Cao; Yingjun,1,18,70,69
1656233934850,CSE 134B,A01,083661,Powell; Thomas Allan,5,0,100,95
1656233940874,CSE 140,A01,083663,Gungor; Onat,9,0,85,76
1656233946897,CSE 140L,A01,083088,Eldon; John,8,0,100,92
1656233952931,CSE 175,A01,083665,Kumar; Rakesh,0,0,25,25
1656233958955,CSE 190,A00,092507,Dubnov; Shlomo,3,0,20,17
1656233964979,ECE 45,A01,083139,Congero; Spencer William,1,0,75,74
1656233971007,ECE 65,A50,083695,Saad; Andrew S,9,0,30,21
1656233971007,ECE 65,A51,095125,Staff,24,0,26,2
1656233977030,ECE 109,A01,091882,Touri; Behrouz,0,1,70,70
1656233983053,ECE 180,A00,083140,Abi Samra; Nicholas Camill,1,0,30,29
1656233983053,ECE 180,B00,083141,Abi Samra; Nicholas Camill,0,4,30,30
1656233989081,MATH 10A,A01,083735,Patchell; Gregory David,0,0,30,30
1656233989081,MATH 10A,A02,083736,Patchell; Gregory David,22,0,30,8
1656233989081,MATH 10A,A03,083737,Patchell; Gregory David,16,0,30,14
1656233995110,MATH 10B,A01,083207,Lim; Seonhee,0,0,34,34
1656233995110,MATH 10B,A02,083208,Lim; Seonhee,7,0,35,28
1656233995110,MATH 10B,A03,093472,Staff,1,0,34,33
1656233995110,MATH 10B,B01,083739,Sinha; Shubham,11,0,30,19
1656234001132,MATH 18,A01,083743,Cinel; Cameron Alexander,7,0,30,23
1656234001132,MATH 18,A02,083744,Cinel; Cameron Alexander,9,0,30,21
1656234001132,MATH 18,A03,083745,Cinel; Cameron Alexander,5,0,30,25
1656234001132,MATH 18,B01,083748,Rideout; David Porter,1,0,36,35
1656234001132,MATH 18,B02,083749,Rideout; David Porter,0,0,36,36
1656234001132,MATH 18,B03,083750,Rideout; David Porter,0,0,36,36
1656234001132,MATH 18,B04,083751,Rideout; David Porter,0,1,36,36
1656234001132,MATH 18,B05,093473,Rideout; David Porter,0,0,36,36
1656234001132,MATH 18,B06,093474,Rideout; David Porter,3,0,36,33
1656234007154,MATH 20A,A01,083754,Zheng; Zequn,11,0,40,29
1656234013190,MATH 20B,A01,083756,Briones; Jor-el Thomas Caparas,0,0,36,36
1656234013190,MATH 20B,A02,083757,Briones; Jor-el Thomas Caparas,0,0,36,36
1656234013190,MATH 20B,A03,093475,Staff,0,0,36,36
1656234019218,MATH 20C,A01,083760,Briones; Jor-el Thomas Caparas,0,0,35,35
1656234019218,MATH 20C,A02,083761,Briones; Jor-el Thomas Caparas,9,1,35,26
1656234019218,MATH 20C,A03,093476,Staff,0,0,35,35
1656234019218,MATH 20C,B01,083762,Bach; Quang Tran,1,0,30,29
1656234025246,MATH 20D,A01,083765,Tran; Brian Kha,1,0,30,29
1656234025246,MATH 20D,A02,083766,Tran; Brian Kha,0,1,30,30
1656234025246,MATH 20D,A03,083767,Tran; Brian Kha,2,0,30,28
1656234031275,MATH 20E,A01,083771,Ganguly; Soumya,3,0,32,29
1656234031275,MATH 20E,A02,083772,Ganguly; Soumya,0,0,32,32
1656234031275,MATH 20E,B01,083773,Ciotti; Benjamin,16,0,35,19
1656234031275,MATH 20E,B02,083774,Ciotti; Benjamin,15,0,35,20
1656234037299,MATH 103A,A01,083777,Greenfeld; Be'Eri,1,0,36,35
1656234037299,MATH 103A,A02,083778,Greenfeld; Be'Eri,1,0,36,35
1656234037299,MATH 103A,A03,093561,Staff,5,0,36,31
1656234037299,MATH 103A,B01,083779,Greenfeld; Be'Eri,8,0,36,28
1656234037299,MATH 103A,B02,083780,Greenfeld; Be'Eri,1,0,36,35
1656234037299,MATH 103A,B03,093562,Staff,0,0,36,36
1656234043326,MATH 105,A01,085443,Carter; Anne Toulson,5,0,35,30
1656234043326,MATH 105,A02,093477,Staff,14,0,35,21
1656234049351,MATH 109,A01,083213,Ganzberger; Geoffrey Michael,0,0,34,34
1656234049351,MATH 109,A02,083214,Ganzberger; Geoffrey Michael,0,0,34,34
1656234049351,MATH 109,A03,093478,Staff,1,0,34,33
1656234049351,MATH 109,B01,083215,Ganzberger; Geoffrey Michael,4,0,32,28
1656234049351,MATH 109,B02,083216,Ganzberger; Geoffrey Michael,1,0,32,31
1656234049351,MATH 109,B03,093479,Staff,4,0,32,28
1656234055373,MATH 142A,A01,083219,Chow; Bennett,2,0,32,30
1656234055373,MATH 142A,A02,083220,Chow; Bennett,8,0,32,24
1656234055373,MATH 142A,A03,093480,Staff,5,0,32,27
1656234055373,MATH 142A,B03,093481,Staff,3,0,32,29
1656234055373,MATH 142A,B04,093558,Staff,6,0,32,26
1656234055373,MATH 142A,B05,093559,Staff,0,0,32,32
1656234061470,MATH 193A,A01,083224,Rotar; Vladimir,0,1,34,34
1656234061470,MATH 193A,A02,083225,Rotar; Vladimir,0,0,34,34
1656234061470,MATH 193A,A03,083781,Rotar; Vladimir,0,0,34,34
1656234061470,MATH 193A,A04,083782,Rotar; Vladimir,6,0,34,28
1656234061470,MATH 193A,A05,093482,Rotar; Vladimir,0,0,34,34
1656234067492,MATH 197,001,091859,McAuley; Julian John,9999,0,9999,0
1656234067492,MATH 197,002,095566,Kedlaya; Kiran S.,9997,0,9999,2
1656234067492,MATH 197,003,095567,Xiao; Ming,9999,0,9999,0
1656234067492,MATH 197,004,095571,Perols; Johan Lars,9998,0,9999,1
1656234074563,COGS 9,A01,083615,Shannon; Kyle Michael,3,0,75,72
1656234080585,COGS 11,A01,083617,Boyle; Mary E. T.,14,0,48,34
1656234086620,COGS 13,A01,083071,Bastos; Amalia Pinkusfeld,4,0,71,67
1656234092642,COGS 14A,A01,092681,Semenuks; Arturs,1,12,100,99
1656234098666,COGS 14B,A01,083073,Cheng; Tzu-Han,7,0,63,56
1656234104690,COGS 17,A01,092677,Semenuks; Arturs,7,0,81,74
1656234110713,COGS 100,A01,083619,Allen; Michael Gordon,2,0,70,68
1656234116743,COGS 101A,A01,083621,Davis; Joshua Daniel,4,0,68,64
1656234122777,COGS 101B,A01,091572,Allen; Michael Gordon,4,0,65,61
1656234128799,COGS 101C,A01,083625,Delgado; Tania,10,0,35,25
1656234134821,COGS 107A,A01,083627,Boyle; Mary E. T.,0,0,60,60
1656234140843,COGS 118A,A01,083075,Gupta; Anjum,8,0,76,68
1656234146865,CSE 3,A50,083646,Miranda; Gregory Joseph,18,0,50,32
1656234152889,CSE 8A,A50,083650,Miranda; Gregory Joseph,2,2,56,54
1656234158911,CSE 11,A01,083080,Cao; Yingjun,0,49,40,40
1656234164934,CSE 12,A01,083652,Krause-Levy; Sophia Louisa,5,1,120,115
1656234170962,CSE 15L,A01,083654,Morris; Justin Loren,2,0,50,48
1656234170962,CSE 15L,A02,083655,Morris; Justin Loren,4,0,50,46
1656234176989,CSE 20,A01,083657,Tran; Khoa Dang,30,0,80,50
1656234183014,CSE 21,A01,095574,Bach; Quang Tran,23,0,48,25
1656234189038,CSE 30,A01,083084,Eldon; John,2,6,80,78
1656234189038,CSE 30,B01,095061,Bhaskar; Nishant,0,1,50,50
1656234195063,CSE 100,A01,083659,Cao; Yingjun,1,18,70,69
1656234201090,CSE 134B,A01,083661,Powell; Thomas Allan,5,0,100,95
1656234207116,CSE 140,A01,083663,Gungor; Onat,9,0,85,76
1656234213139,CSE 140L,A01,083088,Eldon; John,8,0,100,92
1656234219162,CSE 175,A01,083665,Kumar; Rakesh,0,0,25,25
1656234225185,CSE 190,A00,092507,Dubnov; Shlomo,3,0,20,17
1656234231209,ECE 45,A01,083139,Congero; Spencer William,1,0,75,74
1656234237235,ECE 65,A50,083695,Saad; Andrew S,9,0,30,21
1656234237235,ECE 65,A51,095125,Staff,24,0,26,2
1656234243259,ECE 109,A01,091882,Touri; Behrouz,0,1,70,70
1656234249281,ECE 180,A00,083140,Abi Samra; Nicholas Camill,1,0,30,29
1656234249281,ECE 180,B00,083141,Abi Samra; Nicholas Camill,0,4,30,30
1656234255305,MATH 10A,A01,083735,Patchell; Gregory David,0,0,30,30
1656234255305,MATH 10A,A02,083736,Patchell; Gregory David,22,0,30,8
1656234255305,MATH 10A,A03,083737,Patchell; Gregory David,16,0,30,14
1656234261331,MATH 10B,A01,083207,Lim; Seonhee,0,0,34,34
1656234261331,MATH 10B,A02,083208,Lim; Seonhee,7,0,35,28
1656234261331,MATH 10B,A03,093472,Staff,1,0,34,33
1656234261331,MATH 10B,B01,083739,Sinha; Shubham,11,0,30,19
1656234267355,MATH 18,A01,083743,Cinel; Cameron Alexander,7,0,30,23
1656234267355,MATH 18,A02,083744,Cinel; Cameron Alexander,9,0,30,21
1656234267355,MATH 18,A03,083745,Cinel; Cameron Alexander,5,0,30,25
1656234267355,MATH 18,B01,083748,Rideout; David Porter,1,0,36,35
1656234267355,MATH 18,B02,083749,Rideout; David Porter,0,0,36,36
1656234267355,MATH 18,B03,083750,Rideout; David Porter,0,0,36,36
1656234267355,MATH 18,B04,083751,Rideout; David Porter,0,1,36,36
1656234267355,MATH 18,B05,093473,Rideout; David Porter,0,0,36,36
1656234267355,MATH 18,B06,093474,Rideout; David Porter,3,0,36,33
1656234273381,MATH 20A,A01,083754,Zheng; Zequn,11,0,40,29
1656234279405,MATH 20B,A01,083756,Briones; Jor-el Thomas Caparas,0,0,36,36
1656234279405,MATH 20B,A02,083757,Briones; Jor-el Thomas Caparas,0,0,36,36
1656234279405,MATH 20B,A03,093475,Staff,0,0,36,36
1656234285433,MATH 20C,A01,083760,Briones; Jor-el Thomas Caparas,0,0,35,35
1656234285433,MATH 20C,A02,083761,Briones; Jor-el Thomas Caparas,9,1,35,26
1656234285433,MATH 20C,A03,093476,Staff,0,0,35,35
1656234285433,MATH 20C,B01,083762,Bach; Quang Tran,1,0,30,29
1656234291457,MATH 20D,A01,083765,Tran; Brian Kha,1,0,30,29
1656234291457,MATH 20D,A02,083766,Tran; Brian Kha,0,1,30,30
1656234291457,MATH 20D,A03,083767,Tran; Brian Kha,2,0,30,28
1656234297484,MATH 20E,A01,083771,Ganguly; Soumya,3,0,32,29
1656234297484,MATH 20E,A02,083772,Ganguly; Soumya,0,0,32,32
1656234297484,MATH 20E,B01,083773,Ciotti; Benjamin,16,0,35,19
1656234297484,MATH 20E,B02,083774,Ciotti; Benjamin,15,0,35,20
1656234303508,MATH 103A,A01,083777,Greenfeld; Be'Eri,1,0,36,35
1656234303508,MATH 103A,A02,083778,Greenfeld; Be'Eri,1,0,36,35
1656234303508,MATH 103A,A03,093561,Staff,5,0,36,31
1656234303508,MATH 103A,B01,083779,Greenfeld; Be'Eri,8,0,36,28
1656234303508,MATH 103A,B02,083780,Greenfeld; Be'Eri,1,0,36,35
1656234303508,MATH 103A,B03,093562,Staff,0,0,36,36
1656234309532,MATH 105,A01,085443,Carter; Anne Toulson,5,0,35,30
1656234309532,MATH 105,A02,093477,Staff,14,0,35,21
1656234315561,MATH 109,A01,083213,Ganzberger; Geoffrey Michael,0,0,34,34
1656234315561,MATH 109,A02,083214,Ganzberger; Geoffrey Michael,0,0,34,34
1656234315561,MATH 109,A03,093478,Staff,1,0,34,33
1656234315561,MATH 109,B01,083215,Ganzberger; Geoffrey Michael,4,0,32,28
1656234315561,MATH 109,B02,083216,Ganzberger; Geoffrey Michael,1,0,32,31
1656234315561,MATH 109,B03,093479,Staff,4,0,32,28
1656234321584,MATH 142A,A01,083219,Chow; Bennett,2,0,32,30
1656234321584,MATH 142A,A02,083220,Chow; Bennett,8,0,32,24
1656234321584,MATH 142A,A03,093480,Staff,5,0,32,27
1656234321584,MATH 142A,B03,093481,Staff,3,0,32,29
1656234321584,MATH 142A,B04,093558,Staff,6,0,32,26
1656234321584,MATH 142A,B05,093559,Staff,0,0,32,32
1656234327614,MATH 193A,A01,083224,Rotar; Vladimir,0,1,34,34
1656234327614,MATH 193A,A02,083225,Rotar; Vladimir,0,0,34,34
1656234327614,MATH 193A,A03,083781,Rotar; Vladimir,0,0,34,34
1656234327614,MATH 193A,A04,083782,Rotar; Vladimir,6,0,34,28
1656234327614,MATH 193A,A05,093482,Rotar; Vladimir,0,0,34,34
1656234333638,MATH 197,001,091859,McAuley; Julian John,9999,0,9999,0
1656234333638,MATH 197,002,095566,Kedlaya; Kiran S.,9997,0,9999,2
1656234333638,MATH 197,003,095567,Xiao; Ming,9999,0,9999,0
1656234333638,MATH 197,004,095571,Perols; Johan Lars,9998,0,9999,1
1656234340699,COGS 9,A01,083615,Shannon; Kyle Michael,3,0,75,72
1656234346721,COGS 11,A01,083617,Boyle; Mary E. T.,14,0,48,34
1656234352745,COGS 13,A01,083071,Bastos; Amalia Pinkusfeld,4,0,71,67
1656234358770,COGS 14A,A01,092681,Semenuks; Arturs,1,12,100,99
1656234364794,COGS 14B,A01,083073,Cheng; Tzu-Han,7,0,63,56
1656234370819,COGS 17,A01,092677,Semenuks; Arturs,7,0,81,74
1656234376843,COGS 100,A01,083619,Allen; Michael Gordon,2,0,70,68
1656234382866,COGS 101A,A01,083621,Davis; Joshua Daniel,4,0,68,64
1656234388890,COGS 101B,A01,091572,Allen; Michael Gordon,4,0,65,61
1656234394917,COGS 101C,A01,083625,Delgado; Tania,10,0,35,25
1656234400945,COGS 107A,A01,083627,Boyle; Mary E. T.,0,0,60,60
1656234406971,COGS 118A,A01,083075,Gupta; Anjum,8,0,76,68
1656234413001,CSE 3,A50,083646,Miranda; Gregory Joseph,18,0,50,32
1656234419025,CSE 8A,A50,083650,Miranda; Gregory Joseph,2,2,56,54
1656234425053,CSE 11,A01,083080,Cao; Yingjun,0,49,40,40
1656234431089,CSE 12,A01,083652,Krause-Levy; Sophia Louisa,5,1,120,115
1656234437116,CSE 15L,A01,083654,Morris; Justin Loren,2,0,50,48
1656234437116,CSE 15L,A02,083655,Morris; Justin Loren,4,0,50,46
1656234443140,CSE 20,A01,083657,Tran; Khoa Dang,30,0,80,50
1656234449168,CSE 21,A01,095574,Bach; Quang Tran,23,0,48,25
1656234455195,CSE 30,A01,083084,Eldon; John,2,6,80,78
1656234455195,CSE 30,B01,095061,Bhaskar; Nishant,0,1,50,50
1656234461230,CSE 100,A01,083659,Cao; Yingjun,1,18,70,69
1656234467253,CSE 134B,A01,083661,Powell; Thomas Allan,5,0,100,95
1656234473279,CSE 140,A01,083663,Gungor; Onat,9,0,85,76
1656234479303,CSE 140L,A01,083088,Eldon; John,8,0,100,92
1656234485327,CSE 175,A01,083665,Kumar; Rakesh,0,0,25,25
1656234491355,CSE 190,A00,092507,Dubnov; Shlomo,3,0,20,17
1656234497379,ECE 45,A01,083139,Congero; Spencer William,1,0,75,74
1656234503403,ECE 65,A50,083695,Saad; Andrew S,9,0,30,21
1656234503403,ECE 65,A51,095125,Staff,24,0,26,2
1656234509442,ECE 109,A01,091882,Touri; Behrouz,0,1,70,70
1656234515466,ECE 180,A00,083140,Abi Samra; Nicholas Camill,1,0,30,29
1656234515466,ECE 180,B00,083141,Abi Samra; Nicholas Camill,0,4,30,30
1656234521492,MATH 10A,A01,083735,Patchell; Gregory David,0,0,30,30
1656234521492,MATH 10A,A02,083736,Patchell; Gregory David,22,0,30,8
1656234521492,MATH 10A,A03,083737,Patchell; Gregory David,16,0,30,14
1656234527521,MATH 10B,A01,083207,Lim; Seonhee,0,0,34,34
1656234527521,MATH 10B,A02,083208,Lim; Seonhee,7,0,35,28
1656234527521,MATH 10B,A03,093472,Staff,1,0,34,33
1656234527521,MATH 10B,B01,083739,Sinha; Shubham,11,0,30,19
1656234533553,MATH 18,A01,083743,Cinel; Cameron Alexander,7,0,30,23
1656234533553,MATH 18,A02,083744,Cinel; Cameron Alexander,9,0,30,21
1656234533553,MATH 18,A03,083745,Cinel; Cameron Alexander,5,0,30,25
1656234533553,MATH 18,B01,083748,Rideout; David Porter,1,0,36,35
1656234533553,MATH 18,B02,083749,Rideout; David Porter,0,0,36,36
1656234533553,MATH 18,B03,083750,Rideout; David Porter,0,0,36,36
1656234533553,MATH 18,B04,083751,Rideout; David Porter,0,1,36,36
1656234533553,MATH 18,B05,093473,Rideout; David Porter,0,0,36,36
1656234533553,MATH 18,B06,093474,Rideout; David Porter,3,0,36,33
1656234539577,MATH 20A,A01,083754,Zheng; Zequn,11,0,40,29
1656234545604,MATH 20B,A01,083756,Briones; Jor-el Thomas Caparas,0,0,36,36
1656234545604,MATH 20B,A02,083757,Briones; Jor-el Thomas Caparas,0,0,36,36
1656234545604,MATH 20B,A03,093475,Staff,0,0,36,36
1656234551634,MATH 20C,A01,083760,Briones; Jor-el Thomas Caparas,0,0,35,35
1656234551634,MATH 20C,A02,083761,Briones; Jor-el Thomas Caparas,9,1,35,26
1656234551634,MATH 20C,A03,093476,Staff,0,0,35,35
1656234551634,MATH 20C,B01,083762,Bach; Quang Tran,1,0,30,29
1656234557663,MATH 20D,A01,083765,Tran; Brian Kha,1,0,30,29
1656234557663,MATH 20D,A02,083766,Tran; Brian Kha,0,1,30,30
1656234557663,MATH 20D,A03,083767,Tran; Brian Kha,2,0,30,28
1656234563691,MATH 20E,A01,083771,Ganguly; Soumya,3,0,32,29
1656234563691,MATH 20E,A02,083772,Ganguly; Soumya,0,0,32,32
1656234563691,MATH 20E,B01,083773,Ciotti; Benjamin,16,0,35,19
1656234563691,MATH 20E,B02,083774,Ciotti; Benjamin,15,0,35,20
1656234569716,MATH 103A,A01,083777,Greenfeld; Be'Eri,1,0,36,35
1656234569716,MATH 103A,A02,083778,Greenfeld; Be'Eri,1,0,36,35
1656234569716,MATH 103A,A03,093561,Staff,5,0,36,31
1656234569716,MATH 103A,B01,083779,Greenfeld; Be'Eri,8,0,36,28
1656234569716,MATH 103A,B02,083780,Greenfeld; Be'Eri,1,0,36,35
1656234569716,MATH 103A,B03,093562,Staff,0,0,36,36
1656234575739,MATH 105,A01,085443,Carter; Anne Toulson,5,0,35,30
1656234575739,MATH 105,A02,093477,Staff,14,0,35,21
1656234581767,MATH 109,A01,083213,Ganzberger; Geoffrey Michael,0,0,34,34
1656234581767,MATH 109,A02,083214,Ganzberger; Geoffrey Michael,0,0,34,34
1656234581767,MATH 109,A03,093478,Staff,1,0,34,33
1656234581767,MATH 109,B01,083215,Ganzberger; Geoffrey Michael,4,0,32,28
1656234581767,MATH 109,B02,083216,Ganzberger; Geoffrey Michael,1,0,32,31
1656234581767,MATH 109,B03,093479,Staff,4,0,32,28
1656234587790,MATH 142A,A01,083219,Chow; Bennett,2,0,32,30
1656234587790,MATH 142A,A02,083220,Chow; Bennett,8,0,32,24
1656234587790,MATH 142A,A03,093480,Staff,5,0,32,27
1656234587790,MATH 142A,B03,093481,Staff,3,0,32,29
1656234587790,MATH 142A,B04,093558,Staff,6,0,32,26
1656234587790,MATH 142A,B05,093559,Staff,0,0,32,32
1656234593813,MATH 193A,A01,083224,Rotar; Vladimir,0,1,34,34
1656234593813,MATH 193A,A02,083225,Rotar; Vladimir,0,0,34,34
1656234593813,MATH 193A,A03,083781,Rotar; Vladimir,0,0,34,34
1656234593813,MATH 193A,A04,083782,Rotar; Vladimir,6,0,34,28
1656234593813,MATH 193A,A05,093482,Rotar; Vladimir,0,0,34,34
1656234599835,MATH 197,001,091859,McAuley; Julian John,9999,0,9999,0
1656234599835,MATH 197,002,095566,Kedlaya; Kiran S.,9997,0,9999,2
1656234599835,MATH 197,003,095567,Xiao; Ming,9999,0,9999,0
1656234599835,MATH 197,004,095571,Perols; Johan Lars,9998,0,9999,1
1656234606916,COGS 9,A01,083615,Shannon; Kyle Michael,3,0,75,72
1656234612940,COGS 11,A01,083617,Boyle; Mary E. T.,14,0,48,34
1656234618964,COGS 13,A01,083071,Bastos; Amalia Pinkusfeld,4,0,71,67
1656234624987,COGS 14A,A01,092681,Semenuks; Arturs,1,12,100,99
1656234631010,COGS 14B,A01,083073,Cheng; Tzu-Han,7,0,63,56
1656234637037,COGS 17,A01,092677,Semenuks; Arturs,7,0,81,74
1656234643063,COGS 100,A01,083619,Allen; Michael Gordon,2,0,70,68
1656234649097,COGS 101A,A01,083621,Davis; Joshua Daniel,4,0,68,64
1656234655194,COGS 101B,A01,091572,Allen; Michael Gordon,4,0,65,61
1656234661235,COGS 101C,A01,083625,Delgado; Tania,10,0,35,25
1656234667277,COGS 107A,A01,083627,Boyle; Mary E. T.,0,0,60,60
1656234673301,COGS 118A,A01,083075,Gupta; Anjum,8,0,76,68
1656234679325,CSE 3,A50,083646,Miranda; Gregory Joseph,18,0,50,32
1656234685364,CSE 8A,A50,083650,Miranda; Gregory Joseph,2,2,56,54
1656234691390,CSE 11,A01,083080,Cao; Yingjun,0,49,40,40
1656234697413,CSE 12,A01,083652,Krause-Levy; Sophia Louisa,5,1,120,115
1656234703437,CSE 15L,A01,083654,Morris; Justin Loren,2,0,50,48
1656234703437,CSE 15L,A02,083655,Morris; Justin Loren,4,0,50,46
1656234709463,CSE 20,A01,083657,Tran; Khoa Dang,30,0,80,50
1656234715484,CSE 21,A01,095574,Bach; Quang Tran,23,0,48,25
1656234721511,CSE 30,A01,083084,Eldon; John,2,6,80,78
1656234721511,CSE 30,B01,095061,Bhaskar; Nishant,0,1,50,50
1656234727532,CSE 100,A01,083659,Cao; Yingjun,1,18,70,69
1656234733559,CSE 134B,A01,083661,Powell; Thomas Allan,5,0,100,95
1656234739583,CSE 140,A01,083663,Gungor; Onat,9,0,85,76
1656234745610,CSE 140L,A01,083088,Eldon; John,8,0,100,92
1656234751633,CSE 175,A01,083665,Kumar; Rakesh,0,0,25,25
1656234757655,CSE 190,A00,092507,Dubnov; Shlomo,3,0,20,17
1656234763679,ECE 45,A01,083139,Congero; Spencer William,1,0,75,74
1656234769703,ECE 65,A50,083695,Saad; Andrew S,9,0,30,21
1656234769703,ECE 65,A51,095125,Staff,24,0,26,2
1656234775726,ECE 109,A01,091882,Touri; Behrouz,0,1,70,70
1656234781756,ECE 180,A00,083140,Abi Samra; Nicholas Camill,1,0,30,29
1656234781756,ECE 180,B00,083141,Abi Samra; Nicholas Camill,0,4,30,30
1656234787780,MATH 10A,A01,083735,Patchell; Gregory David,0,0,30,30
1656234787780,MATH 10A,A02,083736,Patchell; Gregory David,22,0,30,8
1656234787780,MATH 10A,A03,083737,Patchell; Gregory David,16,0,30,14
1656234793805,MATH 10B,A01,083207,Lim; Seonhee,0,0,34,34
1656234793805,MATH 10B,A02,083208,Lim; Seonhee,7,0,35,28
1656234793805,MATH 10B,A03,093472,Staff,1,0,34,33
1656234793805,MATH 10B,B01,083739,Sinha; Shubham,11,0,30,19
1656234799831,MATH 18,A01,083743,Cinel; Cameron Alexander,7,0,30,23
1656234799831,MATH 18,A02,083744,Cinel; Cameron Alexander,9,0,30,21
1656234799831,MATH 18,A03,083745,Cinel; Cameron Alexander,5,0,30,25
1656234799831,MATH 18,B01,083748,Rideout; David Porter,1,0,36,35
1656234799831,MATH 18,B02,083749,Rideout; David Porter,0,0,36,36
1656234799831,MATH 18,B03,083750,Rideout; David Porter,0,0,36,36
1656234799831,MATH 18,B04,083751,Rideout; David Porter,0,1,36,36
1656234799831,MATH 18,B05,093473,Rideout; David Porter,0,0,36,36
1656234799831,MATH 18,B06,093474,Rideout; David Porter,3,0,36,33
1656234805858,MATH 20A,A01,083754,Zheng; Zequn,11,0,40,29
1656234811882,MATH 20B,A01,083756,Briones; Jor-el Thomas Caparas,0,0,36,36
1656234811882,MATH 20B,A02,083757,Briones; Jor-el Thomas Caparas,0,0,36,36
1656234811882,MATH 20B,A03,093475,Staff,0,0,36,36
1656234817905,MATH 20C,A01,083760,Briones; Jor-el Thomas Caparas,0,0,35,35
1656234817905,MATH 20C,A02,083761,Briones; Jor-el Thomas Caparas,9,1,35,26
1656234817905,MATH 20C,A03,093476,Staff,0,0,35,35
1656234817905,MATH 20C,B01,083762,Bach; Quang Tran,1,0,30,29
1656234823929,MATH 20D,A01,083765,Tran; Brian Kha,1,0,30,29
1656234823929,MATH 20D,A02,083766,Tran; Brian Kha,0,1,30,30
1656234823929,MATH 20D,A03,083767,Tran; Brian Kha,2,0,30,28
1656234829953,MATH 20E,A01,083771,Ganguly; Soumya,3,0,32,29
1656234829953,MATH 20E,A02,083772,Ganguly; Soumya,0,0,32,32
1656234829953,MATH 20E,B01,083773,Ciotti; Benjamin,16,0,35,19
1656234829953,MATH 20E,B02,083774,Ciotti; Benjamin,15,0,35,20
1656234835981,MATH 103A,A01,083777,Greenfeld; Be'Eri,1,0,36,35
1656234835981,MATH 103A,A02,083778,Greenfeld; Be'Eri,1,0,36,35
1656234835981,MATH 103A,A03,093561,Staff,5,0,36,31
1656234835981,MATH 103A,B01,083779,Greenfeld; Be'Eri,8,0,36,28
1656234835981,MATH 103A,B02,083780,Greenfeld; Be'Eri,1,0,36,35
1656234835981,MATH 103A,B03,093562,Staff,0,0,36,36
1656234842005,MATH 105,A01,085443,Carter; Anne Toulson,5,0,35,30
1656234842005,MATH 105,A02,093477,Staff,14,0,35,21
1656234848048,MATH 109,A01,083213,Ganzberger; Geoffrey Michael,0,0,34,34
1656234848048,MATH 109,A02,083214,Ganzberger; Geoffrey Michael,0,0,34,34
1656234848048,MATH 109,A03,093478,Staff,1,0,34,33
1656234848048,MATH 109,B01,083215,Ganzberger; Geoffrey Michael,4,0,32,28
1656234848048,MATH 109,B02,083216,Ganzberger; Geoffrey Michael,1,0,32,31
1656234848048,MATH 109,B03,093479,Staff,4,0,32,28
1656234854074,MATH 142A,A01,083219,Chow; Bennett,2,0,32,30
1656234854074,MATH 142A,A02,083220,Chow; Bennett,8,0,32,24
1656234854074,MATH 142A,A03,093480,Staff,5,0,32,27
1656234854074,MATH 142A,B03,093481,Staff,3,0,32,29
1656234854074,MATH 142A,B04,093558,Staff,6,0,32,26
1656234854074,MATH 142A,B05,093559,Staff,0,0,32,32
1656234860103,MATH 193A,A01,083224,Rotar; Vladimir,0,1,34,34
1656234860103,MATH 193A,A02,083225,Rotar; Vladimir,0,0,34,34
1656234860103,MATH 193A,A03,083781,Rotar; Vladimir,0,0,34,34
1656234860103,MATH 193A,A04,083782,Rotar; Vladimir,6,0,34,28
1656234860103,MATH 193A,A05,093482,Rotar; Vladimir,0,0,34,34
1656234866129,MATH 197,001,091859,McAuley; Julian John,9999,0,9999,0
1656234866129,MATH 197,002,095566,Kedlaya; Kiran S.,9997,0,9999,2
1656234866129,MATH 197,003,095567,Xiao; Ming,9999,0,9999,0
1656234866129,MATH 197,004,095571,Perols; Johan Lars,9998,0,9999,1
1656234873191,COGS 9,A01,083615,Shannon; Kyle Michael,3,0,75,72
1656234879217,COGS 11,A01,083617,Boyle; Mary E. T.,14,0,48,34
1656234885244,COGS 13,A01,083071,Bastos; Amalia Pinkusfeld,4,0,71,67
1656234891267,COGS 14A,A01,092681,Semenuks; Arturs,1,12,100,99
1656234897290,COGS 14B,A01,083073,Cheng; Tzu-Han,7,0,63,56
1656234903318,COGS 17,A01,092677,Semenuks; Arturs,7,0,81,74
1656234909348,COGS 100,A01,083619,Allen; Michael Gordon,2,0,70,68
1656234915372,COGS 101A,A01,083621,Davis; Joshua Daniel,4,0,68,64
1656234921397,COGS 101B,A01,091572,Allen; Michael Gordon,4,0,65,61
1656234927420,COGS 101C,A01,083625,Delgado; Tania,10,0,35,25
1656234933443,COGS 107A,A01,083627,Boyle; Mary E. T.,0,0,60,60
1656234939467,COGS 118A,A01,083075,Gupta; Anjum,8,0,76,68
1656234945491,CSE 3,A50,083646,Miranda; Gregory Joseph,18,0,50,32
1656234951519,CSE 8A,A50,083650,Miranda; Gregory Joseph,2,2,56,54
1656234957542,CSE 11,A01,083080,Cao; Yingjun,0,49,40,40
1656234963570,CSE 12,A01,083652,Krause-Levy; Sophia Louisa,5,1,120,115
1656234969593,CSE 15L,A01,083654,Morris; Justin Loren,2,0,50,48
1656234969593,CSE 15L,A02,083655,Morris; Justin Loren,4,0,50,46
1656234975615,CSE 20,A01,083657,Tran; Khoa Dang,30,0,80,50
1656234981639,CSE 21,A01,095574,Bach; Quang Tran,23,0,48,25
1656234987667,CSE 30,A01,083084,Eldon; John,2,6,80,78
1656234987667,CSE 30,B01,095061,Bhaskar; Nishant,0,1,50,50
1656234993694,CSE 100,A01,083659,Cao; Yingjun,1,18,70,69
1656234999717,CSE 134B,A01,083661,Powell; Thomas Allan,5,0,100,95
1656235005740,CSE 140,A01,083663,Gungor; Onat,9,0,85,76
1656235011763,CSE 140L,A01,083088,Eldon; John,8,0,100,92
1656235017789,CSE 175,A01,083665,Kumar; Rakesh,0,0,25,25
1656235023816,CSE 190,A00,092507,Dubnov; Shlomo,3,0,20,17
1656235029839,ECE 45,A01,083139,Congero; Spencer William,1,0,75,74
1656235035866,ECE 65,A50,083695,Saad; Andrew S,9,0,30,21
1656235035866,ECE 65,A51,095125,Staff,24,0,26,2
1656235041890,ECE 109,A01,091882,Touri; Behrouz,0,1,70,70
1656235047913,ECE 180,A00,083140,Abi Samra; Nicholas Camill,1,0,30,29
1656235047913,ECE 180,B00,083141,Abi Samra; Nicholas Camill,0,4,30,30
1656235053937,MATH 10A,A01,083735,Patchell; Gregory David,0,0,30,30
1656235053937,MATH 10A,A02,083736,Patchell; Gregory David,22,0,30,8
1656235053937,MATH 10A,A03,083737,Patchell; Gregory David,16,0,30,14
1656235059962,MATH 10B,A01,083207,Lim; Seonhee,0,0,34,34
1656235059962,MATH 10B,A02,083208,Lim; Seonhee,7,0,35,28
1656235059962,MATH 10B,A03,093472,Staff,1,0,34,33
1656235059962,MATH 10B,B01,083739,Sinha; Shubham,11,0,30,19
1656235065987,MATH 18,A01,083743,Cinel; Cameron Alexander,7,0,30,23
1656235065987,MATH 18,A02,083744,Cinel; Cameron Alexander,9,0,30,21
1656235065987,MATH 18,A03,083745,Cinel; Cameron Alexander,5,0,30,25
1656235065987,MATH 18,B01,083748,Rideout; David Porter,1,0,36,35
1656235065987,MATH 18,B02,083749,Rideout; David Porter,0,0,36,36
1656235065987,MATH 18,B03,083750,Rideout; David Porter,0,0,36,36
1656235065987,MATH 18,B04,083751,Rideout; David Porter,0,1,36,36
1656235065987,MATH 18,B05,093473,Rideout; David Porter,0,0,36,36
1656235065987,MATH 18,B06,093474,Rideout; David Porter,3,0,36,33
1656235072011,MATH 20A,A01,083754,Zheng; Zequn,11,0,40,29
1656235078039,MATH 20B,A01,083756,Briones; Jor-el Thomas Caparas,0,0,36,36
1656235078039,MATH 20B,A02,083757,Briones; Jor-el Thomas Caparas,0,0,36,36
1656235078039,MATH 20B,A03,093475,Staff,0,0,36,36
1656235084064,MATH 20C,A01,083760,Briones; Jor-el Thomas Caparas,0,0,35,35
1656235084064,MATH 20C,A02,083761,Briones; Jor-el Thomas Caparas,9,1,35,26
1656235084064,MATH 20C,A03,093476,Staff,0,0,35,35
1656235084064,MATH 20C,B01,083762,Bach; Quang Tran,1,0,30,29
1656235090093,MATH 20D,A01,083765,Tran; Brian Kha,1,0,30,29
1656235090093,MATH 20D,A02,083766,Tran; Brian Kha,0,1,30,30
1656235090093,MATH 20D,A03,083767,Tran; Brian Kha,2,0,30,28
1656235096120,MATH 20E,A01,083771,Ganguly; Soumya,3,0,32,29
1656235096120,MATH 20E,A02,083772,Ganguly; Soumya,0,0,32,32
1656235096120,MATH 20E,B01,083773,Ciotti; Benjamin,16,0,35,19
1656235096120,MATH 20E,B02,083774,Ciotti; Benjamin,15,0,35,20
1656235102144,MATH 103A,A01,083777,Greenfeld; Be'Eri,1,0,36,35
1656235102144,MATH 103A,A02,083778,Greenfeld; Be'Eri,1,0,36,35
1656235102144,MATH 103A,A03,093561,Staff,5,0,36,31
1656235102144,MATH 103A,B01,083779,Greenfeld; Be'Eri,8,0,36,28
1656235102144,MATH 103A,B02,083780,Greenfeld; Be'Eri,1,0,36,35
1656235102144,MATH 103A,B03,093562,Staff,0,0,36,36
1656235108171,MATH 105,A01,085443,Carter; Anne Toulson,5,0,35,30
1656235108171,MATH 105,A02,093477,Staff,14,0,35,21
1656235114199,MATH 109,A01,083213,Ganzberger; Geoffrey Michael,0,0,34,34
1656235114199,MATH 109,A02,083214,Ganzberger; Geoffrey Michael,0,0,34,34
1656235114199,MATH 109,A03,093478,Staff,1,0,34,33
1656235114199,MATH 109,B01,083215,Ganzberger; Geoffrey Michael,4,0,32,28
1656235114199,MATH 109,B02,083216,Ganzberger; Geoffrey Michael,1,0,32,31
1656235114199,MATH 109,B03,093479,Staff,4,0,32,28
1656235120229,MATH 142A,A01,083219,Chow; Bennett,2,0,32,30
1656235120229,MATH 142A,A02,083220,Chow; Bennett,8,0,32,24
1656235120229,MATH 142A,A03,093480,Staff,5,0,32,27
1656235120229,MATH 142A,B03,093481,Staff,3,0,32,29
1656235120229,MATH 142A,B04,093558,Staff,6,0,32,26
1656235120229,MATH 142A,B05,093559,Staff,0,0,32,32
1656235126256,MATH 193A,A01,083224,Rotar; Vladimir,0,1,34,34
1656235126256,MATH 193A,A02,083225,Rotar; Vladimir,0,0,34,34
1656235126256,MATH 193A,A03,083781,Rotar; Vladimir,0,0,34,34
1656235126256,MATH 193A,A04,083782,Rotar; Vladimir,6,0,34,28
1656235126256,MATH 193A,A05,093482,Rotar; Vladimir,0,0,34,34
1656235132280,MATH 197,001,091859,McAuley; Julian John,9999,0,9999,0
1656235132280,MATH 197,002,095566,Kedlaya; Kiran S.,9997,0,9999,2
1656235132280,MATH 197,003,095567,Xiao; Ming,9999,0,9999,0
1656235132280,MATH 197,004,095571,Perols; Johan Lars,9998,0,9999,1
1656235139341,COGS 9,A01,083615,Shannon; Kyle Michael,3,0,75,72
1656235145365,COGS 11,A01,083617,Boyle; Mary E. T.,14,0,48,34
1656235151389,COGS 13,A01,083071,Bastos; Amalia Pinkusfeld,4,0,71,67
1656235157414,COGS 14A,A01,092681,Semenuks; Arturs,1,12,100,99
1656235163440,COGS 14B,A01,083073,Cheng; Tzu-Han,7,0,63,56
1656235169464,COGS 17,A01,092677,Semenuks; Arturs,7,0,81,74
1656235175492,COGS 100,A01,083619,Allen; Michael Gordon,2,0,70,68
1656235181515,COGS 101A,A01,083621,Davis; Joshua Daniel,4,0,68,64
1656235187542,COGS 101B,A01,091572,Allen; Michael Gordon,4,0,65,61
1656235193566,COGS 101C,A01,083625,Delgado; Tania,10,0,35,25
1656235199593,COGS 107A,A01,083627,Boyle; Mary E. T.,0,0,60,60
1656235205617,COGS 118A,A01,083075,Gupta; Anjum,8,0,76,68
1656235211640,CSE 3,A50,083646,Miranda; Gregory Joseph,18,0,50,32
1656235217672,CSE 8A,A50,083650,Miranda; Gregory Joseph,2,2,56,54
1656235223695,CSE 11,A01,083080,Cao; Yingjun,0,49,40,40
1656235229719,CSE 12,A01,083652,Krause-Levy; Sophia Louisa,5,1,120,115
1656235235746,CSE 15L,A01,083654,Morris; Justin Loren,2,0,50,48
1656235235746,CSE 15L,A02,083655,Morris; Justin Loren,4,0,50,46
1656235241777,CSE 20,A01,083657,Tran; Khoa Dang,30,0,80,50
1656235247802,CSE 21,A01,095574,Bach; Quang Tran,23,0,48,25
1656235253897,CSE 30,A01,083084,Eldon; John,2,6,80,78
1656235253897,CSE 30,B01,095061,Bhaskar; Nishant,0,1,50,50
1656235259920,CSE 100,A01,083659,Cao; Yingjun,1,18,70,69
1656235265944,CSE 134B,A01,083661,Powell; Thomas Allan,5,0,100,95
1656235271967,CSE 140,A01,083663,Gungor; Onat,9,0,85,76
1656235277994,CSE 140L,A01,083088,Eldon; John,8,0,100,92
1656235284019,CSE 175,A01,083665,Kumar; Rakesh,0,0,25,25
1656235290052,CSE 190,A00,092507,Dubnov; Shlomo,3,0,20,17
1656235296080,ECE 45,A01,083139,Congero; Spencer William,1,0,75,74
1656235302107,ECE 65,A50,083695,Saad; Andrew S,9,0,30,21
1656235302107,ECE 65,A51,095125,Staff,24,0,26,2
1656235308135,ECE 109,A01,091882,Touri; Behrouz,0,1,70,70
1656235314156,ECE 180,A00,083140,Abi Samra; Nicholas Camill,1,0,30,29
1656235314156,ECE 180,B00,083141,Abi Samra; Nicholas Camill,0,4,30,30
1656235320180,MATH 10A,A01,083735,Patchell; Gregory David,0,0,30,30
1656235320180,MATH 10A,A02,083736,Patchell; Gregory David,22,0,30,8
1656235320180,MATH 10A,A03,083737,Patchell; Gregory David,16,0,30,14
1656235326225,MATH 10B,A01,083207,Lim; Seonhee,0,0,34,34
1656235326225,MATH 10B,A02,083208,Lim; Seonhee,7,0,35,28
1656235326225,MATH 10B,A03,093472,Staff,1,0,34,33
1656235326225,MATH 10B,B01,083739,Sinha; Shubham,11,0,30,19
1656235332251,MATH 18,A01,083743,Cinel; Cameron Alexander,7,0,30,23
1656235332251,MATH 18,A02,083744,Cinel; Cameron Alexander,9,0,30,21
1656235332251,MATH 18,A03,083745,Cinel; Cameron Alexander,5,0,30,25
1656235332251,MATH 18,B01,083748,Rideout; David Porter,1,0,36,35
1656235332251,MATH 18,B02,083749,Rideout; David Porter,0,0,36,36
1656235332251,MATH 18,B03,083750,Rideout; David Porter,0,0,36,36
1656235332251,MATH 18,B04,083751,Rideout; David Porter,0,1,36,36
1656235332251,MATH 18,B05,093473,Rideout; David Porter,0,0,36,36
1656235332251,MATH 18,B06,093474,Rideout; David Porter,3,0,36,33
1656235338275,MATH 20A,A01,083754,Zheng; Zequn,11,0,40,29
1656235344303,MATH 20B,A01,083756,Briones; Jor-el Thomas Caparas,0,0,36,36
1656235344303,MATH 20B,A02,083757,Briones; Jor-el Thomas Caparas,0,0,36,36
1656235344303,MATH 20B,A03,093475,Staff,0,0,36,36
1656235350327,MATH 20C,A01,083760,Briones; Jor-el Thomas Caparas,0,0,35,35
1656235350327,MATH 20C,A02,083761,Briones; Jor-el Thomas Caparas,9,1,35,26
1656235350327,MATH 20C,A03,093476,Staff,0,0,35,35
1656235350327,MATH 20C,B01,083762,Bach; Quang Tran,1,0,30,29
1656235356357,MATH 20D,A01,083765,Tran; Brian Kha,1,0,30,29
1656235356357,MATH 20D,A02,083766,Tran; Brian Kha,0,1,30,30
1656235356357,MATH 20D,A03,083767,Tran; Brian Kha,2,0,30,28
1656235362397,MATH 20E,A01,083771,Ganguly; Soumya,3,0,32,29
1656235362397,MATH 20E,A02,083772,Ganguly; Soumya,0,0,32,32
1656235362397,MATH 20E,B01,083773,Ciotti; Benjamin,16,0,35,19
1656235362397,MATH 20E,B02,083774,Ciotti; Benjamin,15,0,35,20
1656235368428,MATH 103A,A01,083777,Greenfeld; Be'Eri,1,0,36,35
1656235368428,MATH 103A,A02,083778,Greenfeld; Be'Eri,1,0,36,35
1656235368428,MATH 103A,A03,093561,Staff,5,0,36,31
1656235368428,MATH 103A,B01,083779,Greenfeld; Be'Eri,8,0,36,28
1656235368428,MATH 103A,B02,083780,Greenfeld; Be'Eri,1,0,36,35
1656235368428,MATH 103A,B03,093562,Staff,0,0,36,36
1656235374456,MATH 105,A01,085443,Carter; Anne Toulson,5,0,35,30
1656235374456,MATH 105,A02,093477,Staff,14,0,35,21
1656235380480,MATH 109,A01,083213,Ganzberger; Geoffrey Michael,0,0,34,34
1656235380480,MATH 109,A02,083214,Ganzberger; Geoffrey Michael,0,0,34,34
1656235380480,MATH 109,A03,093478,Staff,1,0,34,33
1656235380480,MATH 109,B01,083215,Ganzberger; Geoffrey Michael,4,0,32,28
1656235380480,MATH 109,B02,083216,Ganzberger; Geoffrey Michael,1,0,32,31
1656235380480,MATH 109,B03,093479,Staff,4,0,32,28
1656235386504,MATH 142A,A01,083219,Chow; Bennett,2,0,32,30
1656235386504,MATH 142A,A02,083220,Chow; Bennett,8,0,32,24
1656235386504,MATH 142A,A03,093480,Staff,5,0,32,27
1656235386504,MATH 142A,B03,093481,Staff,3,0,32,29
1656235386504,MATH 142A,B04,093558,Staff,6,0,32,26
1656235386504,MATH 142A,B05,093559,Staff,0,0,32,32
1656235392530,MATH 193A,A01,083224,Rotar; Vladimir,0,1,34,34
1656235392530,MATH 193A,A02,083225,Rotar; Vladimir,0,0,34,34
1656235392530,MATH 193A,A03,083781,Rotar; Vladimir,0,0,34,34
1656235392530,MATH 193A,A04,083782,Rotar; Vladimir,6,0,34,28
1656235392530,MATH 193A,A05,093482,Rotar; Vladimir,0,0,34,34
1656235398553,MATH 197,001,091859,McAuley; Julian John,9999,0,9999,0
1656235398553,MATH 197,002,095566,Kedlaya; Kiran S.,9997,0,9999,2
1656235398553,MATH 197,003,095567,Xiao; Ming,9999,0,9999,0
1656235398553,MATH 197,004,095571,Perols; Johan Lars,9998,0,9999,1
1656235405606,COGS 9,A01,083615,Shannon; Kyle Michael,3,0,75,72
1656235411630,COGS 11,A01,083617,Boyle; Mary E. T.,14,0,48,34
1656235417653,COGS 13,A01,083071,Bastos; Amalia Pinkusfeld,4,0,71,67
1656235423678,COGS 14A,A01,092681,Semenuks; Arturs,1,12,100,99
1656235429702,COGS 14B,A01,083073,Cheng; Tzu-Han,7,0,63,56
1656235435730,COGS 17,A01,092677,Semenuks; Arturs,7,0,81,74
1656235441759,COGS 100,A01,083619,Allen; Michael Gordon,2,0,70,68
1656235447782,COGS 101A,A01,083621,Davis; Joshua Daniel,4,0,68,64
1656235453807,COGS 101B,A01,091572,Allen; Michael Gordon,4,0,65,61
1656235459845,COGS 101C,A01,083625,Delgado; Tania,10,0,35,25
1656235465868,COGS 107A,A01,083627,Boyle; Mary E. T.,0,0,60,60
1656235471894,COGS 118A,A01,083075,Gupta; Anjum,8,0,76,68
1656235477922,CSE 3,A50,083646,Miranda; Gregory Joseph,18,0,50,32
1656235483946,CSE 8A,A50,083650,Miranda; Gregory Joseph,2,2,56,54
1656235489973,CSE 11,A01,083080,Cao; Yingjun,0,49,40,40
1656235496007,CSE 12,A01,083652,Krause-Levy; Sophia Louisa,5,1,120,115
1656235502042,CSE 15L,A01,083654,Morris; Justin Loren,2,0,50,48
1656235502042,CSE 15L,A02,083655,Morris; Justin Loren,4,0,50,46
1656235508080,CSE 20,A01,083657,Tran; Khoa Dang,30,0,80,50
1656235514116,CSE 21,A01,095574,Bach; Quang Tran,23,0,48,25
1656235520155,CSE 30,A01,083084,Eldon; John,2,6,80,78
1656235520155,CSE 30,B01,095061,Bhaskar; Nishant,0,1,50,50
1656235526187,CSE 100,A01,083659,Cao; Yingjun,1,18,70,69
1656235532218,CSE 134B,A01,083661,Powell; Thomas Allan,5,0,100,95
1656235538258,CSE 140,A01,083663,Gungor; Onat,9,0,85,76
1656235544283,CSE 140L,A01,083088,Eldon; John,8,0,100,92
1656235550311,CSE 175,A01,083665,Kumar; Rakesh,0,0,25,25
1656235556339,CSE 190,A00,092507,Dubnov; Shlomo,3,0,20,17
1656235562362,ECE 45,A01,083139,Congero; Spencer William,1,0,75,74
1656235568386,ECE 65,A50,083695,Saad; Andrew S,9,0,30,21
1656235568386,ECE 65,A51,095125,Staff,24,0,26,2
1656235574409,ECE 109,A01,091882,Touri; Behrouz,0,1,70,70
1656235580436,ECE 180,A00,083140,Abi Samra; Nicholas Camill,1,0,30,29
1656235580436,ECE 180,B00,083141,Abi Samra; Nicholas Camill,0,4,30,30
1656235586463,MATH 10A,A01,083735,Patchell; Gregory David,0,0,30,30
1656235586463,MATH 10A,A02,083736,Patchell; Gregory David,22,0,30,8
1656235586463,MATH 10A,A03,083737,Patchell; Gregory David,16,0,30,14
1656235592490,MATH 10B,A01,083207,Lim; Seonhee,0,0,34,34
1656235592490,MATH 10B,A02,083208,Lim; Seonhee,7,0,35,28
1656235592490,MATH 10B,A03,093472,Staff,1,0,34,33
1656235592490,MATH 10B,B01,083739,Sinha; Shubham,11,0,30,19
1656235598525,MATH 18,A01,083743,Cinel; Cameron Alexander,7,0,30,23
1656235598525,MATH 18,A02,083744,Cinel; Cameron Alexander,9,0,30,21
1656235598525,MATH 18,A03,083745,Cinel; Cameron Alexander,5,0,30,25
1656235598525,MATH 18,B01,083748,Rideout; David Porter,1,0,36,35
1656235598525,MATH 18,B02,083749,Rideout; David Porter,0,0,36,36
1656235598525,MATH 18,B03,083750,Rideout; David Porter,0,0,36,36
1656235598525,MATH 18,B04,083751,Rideout; David Porter,0,1,36,36
1656235598525,MATH 18,B05,093473,Rideout; David Porter,0,0,36,36
1656235598525,MATH 18,B06,093474,Rideout; David Porter,3,0,36,33
1656235604550,MATH 20A,A01,083754,Zheng; Zequn,11,0,40,29
1656235610576,MATH 20B,A01,083756,Briones; Jor-el Thomas Caparas,0,0,36,36
1656235610576,MATH 20B,A02,083757,Briones; Jor-el Thomas Caparas,0,0,36,36
1656235610576,MATH 20B,A03,093475,Staff,0,0,36,36
1656235616607,MATH 20C,A01,083760,Briones; Jor-el Thomas Caparas,0,0,35,35
1656235616607,MATH 20C,A02,083761,Briones; Jor-el Thomas Caparas,9,1,35,26
1656235616607,MATH 20C,A03,093476,Staff,0,0,35,35
1656235616607,MATH 20C,B01,083762,Bach; Quang Tran,1,0,30,29
1656235622645,MATH 20D,A01,083765,Tran; Brian Kha,1,0,30,29
1656235622645,MATH 20D,A02,083766,Tran; Brian Kha,0,1,30,30
1656235622645,MATH 20D,A03,083767,Tran; Brian Kha,2,0,30,28
1656235628669,MATH 20E,A01,083771,Ganguly; Soumya,3,0,32,29
1656235628669,MATH 20E,A02,083772,Ganguly; Soumya,0,0,32,32
1656235628669,MATH 20E,B01,083773,Ciotti; Benjamin,16,0,35,19
1656235628669,MATH 20E,B02,083774,Ciotti; Benjamin,15,0,35,20
1656235634702,MATH 103A,A01,083777,Greenfeld; Be'Eri,1,0,36,35
1656235634702,MATH 103A,A02,083778,Greenfeld; Be'Eri,1,0,36,35
1656235634702,MATH 103A,A03,093561,Staff,5,0,36,31
1656235634702,MATH 103A,B01,083779,Greenfeld; Be'Eri,8,0,36,28
1656235634702,MATH 103A,B02,083780,Greenfeld; Be'Eri,1,0,36,35
1656235634702,MATH 103A,B03,093562,Staff,0,0,36,36
1656235640731,MATH 105,A01,085443,Carter; Anne Toulson,5,0,35,30
1656235640731,MATH 105,A02,093477,Staff,14,0,35,21
1656235646765,MATH 109,A01,083213,Ganzberger; Geoffrey Michael,0,0,34,34
1656235646765,MATH 109,A02,083214,Ganzberger; Geoffrey Michael,0,0,34,34
1656235646765,MATH 109,A03,093478,Staff,1,0,34,33
1656235646765,MATH 109,B01,083215,Ganzberger; Geoffrey Michael,4,0,32,28
1656235646765,MATH 109,B02,083216,Ganzberger; Geoffrey Michael,1,0,32,31
1656235646765,MATH 109,B03,093479,Staff,4,0,32,28
1656235652799,MATH 142A,A01,083219,Chow; Bennett,2,0,32,30
1656235652799,MATH 142A,A02,083220,Chow; Bennett,8,0,32,24
1656235652799,MATH 142A,A03,093480,Staff,5,0,32,27
1656235652799,MATH 142A,B03,093481,Staff,3,0,32,29
1656235652799,MATH 142A,B04,093558,Staff,6,0,32,26
1656235652799,MATH 142A,B05,093559,Staff,0,0,32,32
1656235658825,MATH 193A,A01,083224,Rotar; Vladimir,0,1,34,34
1656235658825,MATH 193A,A02,083225,Rotar; Vladimir,0,0,34,34
1656235658825,MATH 193A,A03,083781,Rotar; Vladimir,0,0,34,34
1656235658825,MATH 193A,A04,083782,Rotar; Vladimir,6,0,34,28
1656235658825,MATH 193A,A05,093482,Rotar; Vladimir,0,0,34,34
1656235664850,MATH 197,001,091859,McAuley; Julian John,9999,0,9999,0
1656235664850,MATH 197,002,095566,Kedlaya; Kiran S.,9997,0,9999,2
1656235664850,MATH 197,003,095567,Xiao; Ming,9999,0,9999,0
1656235664850,MATH 197,004,095571,Perols; Johan Lars,9998,0,9999,1
1656235671976,COGS 9,A01,083615,Shannon; Kyle Michael,3,0,75,72
1656235678003,COGS 11,A01,083617,Boyle; Mary E. T.,14,0,48,34
1656235684037,COGS 13,A01,083071,Bastos; Amalia Pinkusfeld,4,0,71,67
1656235690074,COGS 14A,A01,092681,Semenuks; Arturs,1,12,100,99
1656235696101,COGS 14B,A01,083073,Cheng; Tzu-Han,7,0,63,56
1656235702134,COGS 17,A01,092677,Semenuks; Arturs,7,0,81,74
1656235708160,COGS 100,A01,083619,Allen; Michael Gordon,2,0,70,68
1656235714191,COGS 101A,A01,083621,Davis; Joshua Daniel,4,0,68,64
1656235720219,COGS 101B,A01,091572,Allen; Michael Gordon,4,0,65,61
1656235726244,COGS 101C,A01,083625,Delgado; Tania,10,0,35,25
1656235732270,COGS 107A,A01,083627,Boyle; Mary E. T.,0,0,60,60
1656235738295,COGS 118A,A01,083075,Gupta; Anjum,8,0,76,68
1656235744323,CSE 3,A50,083646,Miranda; Gregory Joseph,18,0,50,32
1656235750355,CSE 8A,A50,083650,Miranda; Gregory Joseph,2,2,56,54
1656235756381,CSE 11,A01,083080,Cao; Yingjun,0,49,40,40
1656235762416,CSE 12,A01,083652,Krause-Levy; Sophia Louisa,5,1,120,115
1656235768440,CSE 15L,A01,083654,Morris; Justin Loren,2,0,50,48
1656235768440,CSE 15L,A02,083655,Morris; Justin Loren,4,0,50,46
1656235774465,CSE 20,A01,083657,Tran; Khoa Dang,30,0,80,50
1656235780495,CSE 21,A01,095574,Bach; Quang Tran,23,0,48,25
1656235786531,CSE 30,A01,083084,Eldon; John,2,6,80,78
1656235786531,CSE 30,B01,095061,Bhaskar; Nishant,0,1,50,50
1656235792556,CSE 100,A01,083659,Cao; Yingjun,1,18,70,69
1656235798581,CSE 134B,A01,083661,Powell; Thomas Allan,5,0,100,95
1656235804608,CSE 140,A01,083663,Gungor; Onat,9,0,85,76
1656235810630,CSE 140L,A01,083088,Eldon; John,8,0,100,92
1656235816660,CSE 175,A01,083665,Kumar; Rakesh,0,0,25,25
1656235822685,CSE 190,A00,092507,Dubnov; Shlomo,3,0,20,17
1656235828710,ECE 45,A01,083139,Congero; Spencer William,1,0,75,74
1656235834746,ECE 65,A50,083695,Saad; Andrew S,9,0,30,21
1656235834746,ECE 65,A51,095125,Staff,24,0,26,2
1656235840778,ECE 109,A01,091882,Touri; Behrouz,0,1,70,70
1656235846812,ECE 180,A00,083140,Abi Samra; Nicholas Camill,1,0,30,29
1656235846812,ECE 180,B00,083141,Abi Samra; Nicholas Camill,0,4,30,30
1656235852917,MATH 10A,A01,083735,Patchell; Gregory David,0,0,30,30
1656235852917,MATH 10A,A02,083736,Patchell; Gregory David,22,0,30,8
1656235852917,MATH 10A,A03,083737,Patchell; Gregory David,16,0,30,14
1656235858953,MATH 10B,A01,083207,Lim; Seonhee,0,0,34,34
1656235858953,MATH 10B,A02,083208,Lim; Seonhee,7,0,35,28
1656235858953,MATH 10B,A03,093472,Staff,1,0,34,33
1656235858953,MATH 10B,B01,083739,Sinha; Shubham,11,0,30,19
1656235864996,MATH 18,A01,083743,Cinel; Cameron Alexander,7,0,30,23
1656235864996,MATH 18,A02,083744,Cinel; Cameron Alexander,9,0,30,21
1656235864996,MATH 18,A03,083745,Cinel; Cameron Alexander,5,0,30,25
1656235864996,MATH 18,B01,083748,Rideout; David Porter,1,0,36,35
1656235864996,MATH 18,B02,083749,Rideout; David Porter,0,0,36,36
1656235864996,MATH 18,B03,083750,Rideout; David Porter,0,0,36,36
1656235864996,MATH 18,B04,083751,Rideout; David Porter,0,1,36,36
1656235864996,MATH 18,B05,093473,Rideout; David Porter,0,0,36,36
1656235864996,MATH 18,B06,093474,Rideout; David Porter,3,0,36,33
1656235871034,MATH 20A,A01,083754,Zheng; Zequn,11,0,40,29
1656235877069,MATH 20B,A01,083756,Briones; Jor-el Thomas Caparas,0,0,36,36
1656235877069,MATH 20B,A02,083757,Briones; Jor-el Thomas Caparas,0,0,36,36
1656235877069,MATH 20B,A03,093475,Staff,0,0,36,36
1656235883096,MATH 20C,A01,083760,Briones; Jor-el Thomas Caparas,0,0,35,35
1656235883096,MATH 20C,A02,083761,Briones; Jor-el Thomas Caparas,9,1,35,26
1656235883096,MATH 20C,A03,093476,Staff,0,0,35,35
1656235883096,MATH 20C,B01,083762,Bach; Quang Tran,1,0,30,29
1656235889127,MATH 20D,A01,083765,Tran; Brian Kha,1,0,30,29
1656235889127,MATH 20D,A02,083766,Tran; Brian Kha,0,1,30,30
1656235889127,MATH 20D,A03,083767,Tran; Brian Kha,2,0,30,28
1656235895155,MATH 20E,A01,083771,Ganguly; Soumya,3,0,32,29
1656235895155,MATH 20E,A02,083772,Ganguly; Soumya,0,0,32,32
1656235895155,MATH 20E,B01,083773,Ciotti; Benjamin,16,0,35,19
1656235895155,MATH 20E,B02,083774,Ciotti; Benjamin,15,0,35,20
1656235901183,MATH 103A,A01,083777,Greenfeld; Be'Eri,1,0,36,35
1656235901183,MATH 103A,A02,083778,Greenfeld; Be'Eri,1,0,36,35
1656235901183,MATH 103A,A03,093561,Staff,5,0,36,31
1656235901183,MATH 103A,B01,083779,Greenfeld; Be'Eri,8,0,36,28
1656235901183,MATH 103A,B02,083780,Greenfeld; Be'Eri,1,0,36,35
1656235901183,MATH 103A,B03,093562,Staff,0,0,36,36
1656235907217,MATH 105,A01,085443,Carter; Anne Toulson,5,0,35,30
1656235907217,MATH 105,A02,093477,Staff,14,0,35,21
1656235913257,MATH 109,A01,083213,Ganzberger; Geoffrey Michael,0,0,34,34
1656235913257,MATH 109,A02,083214,Ganzberger; Geoffrey Michael,0,0,34,34
1656235913257,MATH 109,A03,093478,Staff,1,0,34,33
1656235913257,MATH 109,B01,083215,Ganzberger; Geoffrey Michael,4,0,32,28
1656235913257,MATH 109,B02,083216,Ganzberger; Geoffrey Michael,1,0,32,31
1656235913257,MATH 109,B03,093479,Staff,3,0,32,29
1656235919287,MATH 142A,A01,083219,Chow; Bennett,2,0,32,30
1656235919287,MATH 142A,A02,083220,Chow; Bennett,8,0,32,24
1656235919287,MATH 142A,A03,093480,Staff,5,0,32,27
1656235919287,MATH 142A,B03,093481,Staff,3,0,32,29
1656235919287,MATH 142A,B04,093558,Staff,6,0,32,26
1656235919287,MATH 142A,B05,093559,Staff,0,0,32,32
1656235925320,MATH 193A,A01,083224,Rotar; Vladimir,0,1,34,34
1656235925320,MATH 193A,A02,083225,Rotar; Vladimir,0,0,34,34
1656235925320,MATH 193A,A03,083781,Rotar; Vladimir,0,0,34,34
1656235925320,MATH 193A,A04,083782,Rotar; Vladimir,6,0,34,28
1656235925320,MATH 193A,A05,093482,Rotar; Vladimir,0,0,34,34
1656235931345,MATH 197,001,091859,McAuley; Julian John,9999,0,9999,0
1656235931345,MATH 197,002,095566,Kedlaya; Kiran S.,9997,0,9999,2
1656235931345,MATH 197,003,095567,Xiao; Ming,9999,0,9999,0
1656235931345,MATH 197,004,095571,Perols; Johan Lars,9998,0,9999,1
1656235938434,COGS 9,A01,083615,Shannon; Kyle Michael,3,0,75,72
1656235944463,COGS 11,A01,083617,Boyle; Mary E. T.,14,0,48,34
1656235950489,COGS 13,A01,083071,Bastos; Amalia Pinkusfeld,4,0,71,67
1656235956512,COGS 14A,A01,092681,Semenuks; Arturs,1,12,100,99
1656235962538,COGS 14B,A01,083073,Cheng; Tzu-Han,7,0,63,56
1656235968565,COGS 17,A01,092677,Semenuks; Arturs,7,0,81,74
1656235974602,COGS 100,A01,083619,Allen; Michael Gordon,2,0,70,68
1656235980626,COGS 101A,A01,083621,Davis; Joshua Daniel,4,0,68,64
1656235986665,COGS 101B,A01,091572,Allen; Michael Gordon,4,0,65,61
1656235992701,COGS 101C,A01,083625,Delgado; Tania,10,0,35,25
1656235998732,COGS 107A,A01,083627,Boyle; Mary E. T.,0,0,60,60
1656236004764,COGS 118A,A01,083075,Gupta; Anjum,8,0,76,68
1656236010799,CSE 3,A50,083646,Miranda; Gregory Joseph,18,0,50,32
1656236016838,CSE 8A,A50,083650,Miranda; Gregory Joseph,2,2,56,54
1656236022871,CSE 11,A01,083080,Cao; Yingjun,0,49,40,40
1656236028897,CSE 12,A01,083652,Krause-Levy; Sophia Louisa,5,1,120,115
1656236034928,CSE 15L,A01,083654,Morris; Justin Loren,2,0,50,48
1656236034928,CSE 15L,A02,083655,Morris; Justin Loren,4,0,50,46
1656236040961,CSE 20,A01,083657,Tran; Khoa Dang,30,0,80,50
1656236046988,CSE 21,A01,095574,Bach; Quang Tran,23,0,48,25
1656236053027,CSE 30,A01,083084,Eldon; John,2,6,80,78
1656236053027,CSE 30,B01,095061,Bhaskar; Nishant,0,1,50,50
1656236059055,CSE 100,A01,083659,Cao; Yingjun,1,18,70,69
1656236065083,CSE 134B,A01,083661,Powell; Thomas Allan,5,0,100,95
1656236071107,CSE 140,A01,083663,Gungor; Onat,9,0,85,76
1656236077133,CSE 140L,A01,083088,Eldon; John,8,0,100,92
1656236083158,CSE 175,A01,083665,Kumar; Rakesh,0,0,25,25
1656236089191,CSE 190,A00,092507,Dubnov; Shlomo,3,0,20,17
1656236095224,ECE 45,A01,083139,Congero; Spencer William,1,0,75,74
1656236101253,ECE 65,A50,083695,Saad; Andrew S,9,0,30,21
1656236101253,ECE 65,A51,095125,Staff,24,0,26,2
1656236107280,ECE 109,A01,091882,Touri; Behrouz,0,1,70,70
1656236113315,ECE 180,A00,083140,Abi Samra; Nicholas Camill,1,0,30,29
1656236113315,ECE 180,B00,083141,Abi Samra; Nicholas Camill,0,4,30,30
1656236119356,MATH 10A,A01,083735,Patchell; Gregory David,0,0,30,30
1656236119356,MATH 10A,A02,083736,Patchell; Gregory David,22,0,30,8
1656236119356,MATH 10A,A03,083737,Patchell; Gregory David,16,0,30,14
1656236125389,MATH 10B,A01,083207,Lim; Seonhee,0,0,34,34
1656236125389,MATH 10B,A02,083208,Lim; Seonhee,7,0,35,28
1656236125389,MATH 10B,A03,093472,Staff,1,0,34,33
1656236125389,MATH 10B,B01,083739,Sinha; Shubham,11,0,30,19
1656236131418,MATH 18,A01,083743,Cinel; Cameron Alexander,7,0,30,23
1656236131418,MATH 18,A02,083744,Cinel; Cameron Alexander,9,0,30,21
1656236131418,MATH 18,A03,083745,Cinel; Cameron Alexander,5,0,30,25
1656236131418,MATH 18,B01,083748,Rideout; David Porter,1,0,36,35
1656236131418,MATH 18,B02,083749,Rideout; David Porter,0,0,36,36
1656236131418,MATH 18,B03,083750,Rideout; David Porter,0,0,36,36
1656236131418,MATH 18,B04,083751,Rideout; David Porter,0,1,36,36
1656236131418,MATH 18,B05,093473,Rideout; David Porter,0,0,36,36
1656236131418,MATH 18,B06,093474,Rideout; David Porter,3,0,36,33
1656236137447,MATH 20A,A01,083754,Zheng; Zequn,11,0,40,29
1656236143473,MATH 20B,A01,083756,Briones; Jor-el Thomas Caparas,0,0,36,36
1656236143473,MATH 20B,A02,083757,Briones; Jor-el Thomas Caparas,0,0,36,36
1656236143473,MATH 20B,A03,093475,Staff,0,0,36,36
1656236149506,MATH 20C,A01,083760,Briones; Jor-el Thomas Caparas,0,0,35,35
1656236149506,MATH 20C,A02,083761,Briones; Jor-el Thomas Caparas,9,1,35,26
1656236149506,MATH 20C,A03,093476,Staff,0,0,35,35
1656236149506,MATH 20C,B01,083762,Bach; Quang Tran,1,0,30,29
1656236155538,MATH 20D,A01,083765,Tran; Brian Kha,1,0,30,29
1656236155538,MATH 20D,A02,083766,Tran; Brian Kha,0,1,30,30
1656236155538,MATH 20D,A03,083767,Tran; Brian Kha,2,0,30,28
1656236161572,MATH 20E,A01,083771,Ganguly; Soumya,3,0,32,29
1656236161572,MATH 20E,A02,083772,Ganguly; Soumya,0,0,32,32
1656236161572,MATH 20E,B01,083773,Ciotti; Benjamin,16,0,35,19
1656236161572,MATH 20E,B02,083774,Ciotti; Benjamin,15,0,35,20
1656236167603,MATH 103A,A01,083777,Greenfeld; Be'Eri,1,0,36,35
1656236167603,MATH 103A,A02,083778,Greenfeld; Be'Eri,1,0,36,35
1656236167603,MATH 103A,A03,093561,Staff,5,0,36,31
1656236167603,MATH 103A,B01,083779,Greenfeld; Be'Eri,8,0,36,28
1656236167603,MATH 103A,B02,083780,Greenfeld; Be'Eri,1,0,36,35
1656236167603,MATH 103A,B03,093562,Staff,0,0,36,36
1656236173633,MATH 105,A01,085443,Carter; Anne Toulson,5,0,35,30
1656236173633,MATH 105,A02,093477,Staff,14,0,35,21
1656236179668,MATH 109,A01,083213,Ganzberger; Geoffrey Michael,0,0,34,34
1656236179668,MATH 109,A02,083214,Ganzberger; Geoffrey Michael,0,0,34,34
1656236179668,MATH 109,A03,093478,Staff,1,0,34,33
1656236179668,MATH 109,B01,083215,Ganzberger; Geoffrey Michael,4,0,32,28
1656236179668,MATH 109,B02,083216,Ganzberger; Geoffrey Michael,1,0,32,31
1656236179668,MATH 109,B03,093479,Staff,3,0,32,29
1656236185703,MATH 142A,A01,083219,Chow; Bennett,2,0,32,30
1656236185703,MATH 142A,A02,083220,Chow; Bennett,8,0,32,24
1656236185703,MATH 142A,A03,093480,Staff,5,0,32,27
1656236185703,MATH 142A,B03,093481,Staff,3,0,32,29
1656236185703,MATH 142A,B04,093558,Staff,6,0,32,26
1656236185703,MATH 142A,B05,093559,Staff,0,0,32,32
1656236191730,MATH 193A,A01,083224,Rotar; Vladimir,0,1,34,34
1656236191730,MATH 193A,A02,083225,Rotar; Vladimir,0,0,34,34
1656236191730,MATH 193A,A03,083781,Rotar; Vladimir,0,0,34,34
1656236191730,MATH 193A,A04,083782,Rotar; Vladimir,6,0,34,28
1656236191730,MATH 193A,A05,093482,Rotar; Vladimir,0,0,34,34
1656236197756,MATH 197,001,091859,McAuley; Julian John,9999,0,9999,0
1656236197756,MATH 197,002,095566,Kedlaya; Kiran S.,9997,0,9999,2
1656236197756,MATH 197,003,095567,Xiao; Ming,9999,0,9999,0
1656236197756,MATH 197,004,095571,Perols; Johan Lars,9998,0,9999,1
1656236204863,COGS 9,A01,083615,Shannon; Kyle Michael,3,0,75,72
1656236210895,COGS 11,A01,083617,Boyle; Mary E. T.,14,0,48,34
1656236216925,COGS 13,A01,083071,Bastos; Amalia Pinkusfeld,4,0,71,67
1656236222952,COGS 14A,A01,092681,Semenuks; Arturs,1,12,100,99
1656236228983,COGS 14B,A01,083073,Cheng; Tzu-Han,7,0,63,56
1656236235008,COGS 17,A01,092677,Semenuks; Arturs,7,0,81,74
1656236241041,COGS 100,A01,083619,Allen; Michael Gordon,2,0,70,68
1656236247064,COGS 101A,A01,083621,Davis; Joshua Daniel,4,0,68,64
1656236253090,COGS 101B,A01,091572,Allen; Michael Gordon,4,0,65,61
1656236259124,COGS 101C,A01,083625,Delgado; Tania,10,0,35,25
1656236265147,COGS 107A,A01,083627,Boyle; Mary E. T.,0,0,60,60
1656236271172,COGS 118A,A01,083075,Gupta; Anjum,8,0,76,68
1656236277203,CSE 3,A50,083646,Miranda; Gregory Joseph,18,0,50,32
1656236283234,CSE 8A,A50,083650,Miranda; Gregory Joseph,2,2,56,54
1656236289269,CSE 11,A01,083080,Cao; Yingjun,0,49,40,40
1656236295300,CSE 12,A01,083652,Krause-Levy; Sophia Louisa,5,1,120,115
1656236301325,CSE 15L,A01,083654,Morris; Justin Loren,2,0,50,48
1656236301325,CSE 15L,A02,083655,Morris; Justin Loren,4,0,50,46
1656236307358,CSE 20,A01,083657,Tran; Khoa Dang,30,0,80,50
1656236313383,CSE 21,A01,095574,Bach; Quang Tran,23,0,48,25
1656236319420,CSE 30,A01,083084,Eldon; John,2,6,80,78
1656236319420,CSE 30,B01,095061,Bhaskar; Nishant,0,1,50,50
1656236325447,CSE 100,A01,083659,Cao; Yingjun,1,18,70,69
1656236331480,CSE 134B,A01,083661,Powell; Thomas Allan,5,0,100,95
1656236337511,CSE 140,A01,083663,Gungor; Onat,9,0,85,76
1656236343535,CSE 140L,A01,083088,Eldon; John,8,0,100,92
1656236349567,CSE 175,A01,083665,Kumar; Rakesh,0,0,25,25
1656236355593,CSE 190,A00,092507,Dubnov; Shlomo,3,0,20,17
1656236361620,ECE 45,A01,083139,Congero; Spencer William,1,0,75,74
1656236367652,ECE 65,A50,083695,Saad; Andrew S,9,0,30,21
1656236367652,ECE 65,A51,095125,Staff,24,0,26,2
1656236373676,ECE 109,A01,091882,Touri; Behrouz,0,1,70,70
1656236379709,ECE 180,A00,083140,Abi Samra; Nicholas Camill,1,0,30,29
1656236379709,ECE 180,B00,083141,Abi Samra; Nicholas Camill,0,4,30,30
1656236385744,MATH 10A,A01,083735,Patchell; Gregory David,0,0,30,30
1656236385744,MATH 10A,A02,083736,Patchell; Gregory David,22,0,30,8
1656236385744,MATH 10A,A03,083737,Patchell; Gregory David,16,0,30,14
1656236391772,MATH 10B,A01,083207,Lim; Seonhee,0,0,34,34
1656236391772,MATH 10B,A02,083208,Lim; Seonhee,7,0,35,28
1656236391772,MATH 10B,A03,093472,Staff,1,0,34,33
1656236391772,MATH 10B,B01,083739,Sinha; Shubham,11,0,30,19
1656236397814,MATH 18,A01,083743,Cinel; Cameron Alexander,7,0,30,23
1656236397814,MATH 18,A02,083744,Cinel; Cameron Alexander,9,0,30,21
1656236397814,MATH 18,A03,083745,Cinel; Cameron Alexander,5,0,30,25
1656236397814,MATH 18,B01,083748,Rideout; David Porter,1,0,36,35
1656236397814,MATH 18,B02,083749,Rideout; David Porter,0,0,36,36
1656236397814,MATH 18,B03,083750,Rideout; David Porter,0,0,36,36
1656236397814,MATH 18,B04,083751,Rideout; David Porter,0,1,36,36
1656236397814,MATH 18,B05,093473,Rideout; David Porter,0,0,36,36
1656236397814,MATH 18,B06,093474,Rideout; David Porter,3,0,36,33
1656236403847,MATH 20A,A01,083754,Zheng; Zequn,11,0,40,29
1656236409871,MATH 20B,A01,083756,Briones; Jor-el Thomas Caparas,0,0,36,36
1656236409871,MATH 20B,A02,083757,Briones; Jor-el Thomas Caparas,0,0,36,36
1656236409871,MATH 20B,A03,093475,Staff,0,0,36,36
1656236415897,MATH 20C,A01,083760,Briones; Jor-el Thomas Caparas,0,0,35,35
1656236415897,MATH 20C,A02,083761,Briones; Jor-el Thomas Caparas,9,1,35,26
1656236415897,MATH 20C,A03,093476,Staff,0,0,35,35
1656236415897,MATH 20C,B01,083762,Bach; Quang Tran,1,0,30,29
1656236421920,MATH 20D,A01,083765,Tran; Brian Kha,1,0,30,29
1656236421920,MATH 20D,A02,083766,Tran; Brian Kha,0,1,30,30
1656236421920,MATH 20D,A03,083767,Tran; Brian Kha,2,0,30,28
1656236427949,MATH 20E,A01,083771,Ganguly; Soumya,3,0,32,29
1656236427949,MATH 20E,A02,083772,Ganguly; Soumya,0,0,32,32
1656236427949,MATH 20E,B01,083773,Ciotti; Benjamin,16,0,35,19
1656236427949,MATH 20E,B02,083774,Ciotti; Benjamin,15,0,35,20
1656236433988,MATH 103A,A01,083777,Greenfeld; Be'Eri,1,0,36,35
1656236433988,MATH 103A,A02,083778,Greenfeld; Be'Eri,1,0,36,35
1656236433988,MATH 103A,A03,093561,Staff,5,0,36,31
1656236433988,MATH 103A,B01,083779,Greenfeld; Be'Eri,8,0,36,28
1656236433988,MATH 103A,B02,083780,Greenfeld; Be'Eri,1,0,36,35
1656236433988,MATH 103A,B03,093562,Staff,0,0,36,36
1656236440023,MATH 105,A01,085443,Carter; Anne Toulson,5,0,35,30
1656236440023,MATH 105,A02,093477,Staff,14,0,35,21
1656236446056,MATH 109,A01,083213,Ganzberger; Geoffrey Michael,0,0,34,34
1656236446056,MATH 109,A02,083214,Ganzberger; Geoffrey Michael,0,0,34,34
1656236446056,MATH 109,A03,093478,Staff,1,0,34,33
1656236446056,MATH 109,B01,083215,Ganzberger; Geoffrey Michael,4,0,32,28
1656236446056,MATH 109,B02,083216,Ganzberger; Geoffrey Michael,1,0,32,31
1656236446056,MATH 109,B03,093479,Staff,3,0,32,29
1656236452180,MATH 142A,A01,083219,Chow; Bennett,2,0,32,30
1656236452180,MATH 142A,A02,083220,Chow; Bennett,8,0,32,24
1656236452180,MATH 142A,A03,093480,Staff,5,0,32,27
1656236452180,MATH 142A,B03,093481,Staff,3,0,32,29
1656236452180,MATH 142A,B04,093558,Staff,6,0,32,26
1656236452180,MATH 142A,B05,093559,Staff,0,0,32,32
1656236458213,MATH 193A,A01,083224,Rotar; Vladimir,0,1,34,34
1656236458213,MATH 193A,A02,083225,Rotar; Vladimir,0,0,34,34
1656236458213,MATH 193A,A03,083781,Rotar; Vladimir,0,0,34,34
1656236458213,MATH 193A,A04,083782,Rotar; Vladimir,6,0,34,28
1656236458213,MATH 193A,A05,093482,Rotar; Vladimir,0,0,34,34
1656236464248,MATH 197,001,091859,McAuley; Julian John,9999,0,9999,0
1656236464248,MATH 197,002,095566,Kedlaya; Kiran S.,9997,0,9999,2
1656236464248,MATH 197,003,095567,Xiao; Ming,9999,0,9999,0
1656236464248,MATH 197,004,095571,Perols; Johan Lars,9998,0,9999,1
1656236471336,COGS 9,A01,083615,Shannon; Kyle Michael,3,0,75,72
1656236477360,COGS 11,A01,083617,Boyle; Mary E. T.,14,0,48,34
1656236483388,COGS 13,A01,083071,Bastos; Amalia Pinkusfeld,4,0,71,67
1656236489420,COGS 14A,A01,092681,Semenuks; Arturs,1,12,100,99
1656236495450,COGS 14B,A01,083073,Cheng; Tzu-Han,7,0,63,56
1656236501479,COGS 17,A01,092677,Semenuks; Arturs,7,0,81,74
1656236507505,COGS 100,A01,083619,Allen; Michael Gordon,2,0,70,68
1656236513537,COGS 101A,A01,083621,Davis; Joshua Daniel,4,0,68,64
1656236519577,COGS 101B,A01,091572,Allen; Michael Gordon,4,0,65,61
1656236525610,COGS 101C,A01,083625,Delgado; Tania,10,0,35,25
1656236531642,COGS 107A,A01,083627,Boyle; Mary E. T.,0,0,60,60
1656236537668,COGS 118A,A01,083075,Gupta; Anjum,8,0,76,68
1656236543695,CSE 3,A50,083646,Miranda; Gregory Joseph,18,0,50,32
1656236549720,CSE 8A,A50,083650,Miranda; Gregory Joseph,2,2,56,54
1656236555745,CSE 11,A01,083080,Cao; Yingjun,0,49,40,40
1656236561777,CSE 12,A01,083652,Krause-Levy; Sophia Louisa,5,1,120,115
1656236567802,CSE 15L,A01,083654,Morris; Justin Loren,2,0,50,48
1656236567802,CSE 15L,A02,083655,Morris; Justin Loren,4,0,50,46
1656236573829,CSE 20,A01,083657,Tran; Khoa Dang,30,0,80,50
1656236579855,CSE 21,A01,095574,Bach; Quang Tran,23,0,48,25
1656236585895,CSE 30,A01,083084,Eldon; John,2,6,80,78
1656236585895,CSE 30,B01,095061,Bhaskar; Nishant,0,1,50,50
1656236591932,CSE 100,A01,083659,Cao; Yingjun,1,18,70,69
1656236597959,CSE 134B,A01,083661,Powell; Thomas Allan,5,0,100,95
1656236603983,CSE 140,A01,083663,Gungor; Onat,9,0,85,76
1656236610014,CSE 140L,A01,083088,Eldon; John,8,0,100,92
1656236616041,CSE 175,A01,083665,Kumar; Rakesh,0,0,25,25
1656236622068,CSE 190,A00,092507,Dubnov; Shlomo,3,0,20,17
1656236628107,ECE 45,A01,083139,Congero; Spencer William,1,0,75,74
1656236634133,ECE 65,A50,083695,Saad; Andrew S,9,0,30,21
1656236634133,ECE 65,A51,095125,Staff,24,0,26,2
1656236640166,ECE 109,A01,091882,Touri; Behrouz,0,1,70,70
1656236646200,ECE 180,A00,083140,Abi Samra; Nicholas Camill,1,0,30,29
1656236646200,ECE 180,B00,083141,Abi Samra; Nicholas Camill,0,4,30,30
1656236652235,MATH 10A,A01,083735,Patchell; Gregory David,0,0,30,30
1656236652235,MATH 10A,A02,083736,Patchell; Gregory David,22,0,30,8
1656236652235,MATH 10A,A03,083737,Patchell; Gregory David,16,0,30,14
1656236658266,MATH 10B,A01,083207,Lim; Seonhee,0,0,34,34
1656236658266,MATH 10B,A02,083208,Lim; Seonhee,7,0,35,28
1656236658266,MATH 10B,A03,093472,Staff,1,0,34,33
1656236658266,MATH 10B,B01,083739,Sinha; Shubham,11,0,30,19
1656236664293,MATH 18,A01,083743,Cinel; Cameron Alexander,7,0,30,23
1656236664293,MATH 18,A02,083744,Cinel; Cameron Alexander,9,0,30,21
1656236664293,MATH 18,A03,083745,Cinel; Cameron Alexander,5,0,30,25
1656236664293,MATH 18,B01,083748,Rideout; David Porter,1,0,36,35
1656236664293,MATH 18,B02,083749,Rideout; David Porter,0,0,36,36
1656236664293,MATH 18,B03,083750,Rideout; David Porter,0,0,36,36
1656236664293,MATH 18,B04,083751,Rideout; David Porter,0,1,36,36
1656236664293,MATH 18,B05,093473,Rideout; David Porter,0,0,36,36
1656236664293,MATH 18,B06,093474,Rideout; David Porter,3,0,36,33
1656236670323,MATH 20A,A01,083754,Zheng; Zequn,11,0,40,29
1656236676350,MATH 20B,A01,083756,Briones; Jor-el Thomas Caparas,0,0,36,36
1656236676350,MATH 20B,A02,083757,Briones; Jor-el Thomas Caparas,0,0,36,36
1656236676350,MATH 20B,A03,093475,Staff,0,0,36,36
1656236682377,MATH 20C,A01,083760,Briones; Jor-el Thomas Caparas,0,0,35,35
1656236682377,MATH 20C,A02,083761,Briones; Jor-el Thomas Caparas,9,1,35,26
1656236682377,MATH 20C,A03,093476,Staff,0,0,35,35
1656236682377,MATH 20C,B01,083762,Bach; Quang Tran,1,0,30,29
1656236688403,MATH 20D,A01,083765,Tran; Brian Kha,1,0,30,29
1656236688403,MATH 20D,A02,083766,Tran; Brian Kha,0,1,30,30
1656236688403,MATH 20D,A03,083767,Tran; Brian Kha,2,0,30,28
1656236694438,MATH 20E,A01,083771,Ganguly; Soumya,3,0,32,29
1656236694438,MATH 20E,A02,083772,Ganguly; Soumya,0,0,32,32
1656236694438,MATH 20E,B01,083773,Ciotti; Benjamin,16,0,35,19
1656236694438,MATH 20E,B02,083774,Ciotti; Benjamin,15,0,35,20
1656236700468,MATH 103A,A01,083777,Greenfeld; Be'Eri,1,0,36,35
1656236700468,MATH 103A,A02,083778,Greenfeld; Be'Eri,1,0,36,35
1656236700468,MATH 103A,A03,093561,Staff,5,0,36,31
1656236700468,MATH 103A,B01,083779,Greenfeld; Be'Eri,8,0,36,28
1656236700468,MATH 103A,B02,083780,Greenfeld; Be'Eri,1,0,36,35
1656236700468,MATH 103A,B03,093562,Staff,0,0,36,36
1656236706496,MATH 105,A01,085443,Carter; Anne Toulson,5,0,35,30
1656236706496,MATH 105,A02,093477,Staff,14,0,35,21
1656236712522,MATH 109,A01,083213,Ganzberger; Geoffrey Michael,0,0,34,34
1656236712522,MATH 109,A02,083214,Ganzberger; Geoffrey Michael,0,0,34,34
1656236712522,MATH 109,A03,093478,Staff,1,0,34,33
1656236712522,MATH 109,B01,083215,Ganzberger; Geoffrey Michael,4,0,32,28
1656236712522,MATH 109,B02,083216,Ganzberger; Geoffrey Michael,1,0,32,31
1656236712522,MATH 109,B03,093479,Staff,3,0,32,29
1656236718549,MATH 142A,A01,083219,Chow; Bennett,2,0,32,30
1656236718549,MATH 142A,A02,083220,Chow; Bennett,8,0,32,24
1656236718549,MATH 142A,A03,093480,Staff,5,0,32,27
1656236718549,MATH 142A,B03,093481,Staff,3,0,32,29
1656236718549,MATH 142A,B04,093558,Staff,6,0,32,26
1656236718549,MATH 142A,B05,093559,Staff,0,0,32,32
1656236724576,MATH 193A,A01,083224,Rotar; Vladimir,0,1,34,34
1656236724576,MATH 193A,A02,083225,Rotar; Vladimir,0,0,34,34
1656236724576,MATH 193A,A03,083781,Rotar; Vladimir,0,0,34,34
1656236724576,MATH 193A,A04,083782,Rotar; Vladimir,6,0,34,28
1656236724576,MATH 193A,A05,093482,Rotar; Vladimir,0,0,34,34
1656236730602,MATH 197,001,091859,McAuley; Julian John,9999,0,9999,0
1656236730602,MATH 197,002,095566,Kedlaya; Kiran S.,9997,0,9999,2
1656236730602,MATH 197,003,095567,Xiao; Ming,9999,0,9999,0
1656236730602,MATH 197,004,095571,Perols; Johan Lars,9998,0,9999,1
1656236737680,COGS 9,A01,083615,Shannon; Kyle Michael,3,0,75,72
1656236743709,COGS 11,A01,083617,Boyle; Mary E. T.,14,0,48,34
1656236749735,COGS 13,A01,083071,Bastos; Amalia Pinkusfeld,4,0,71,67
1656236755765,COGS 14A,A01,092681,Semenuks; Arturs,1,12,100,99
1656236761796,COGS 14B,A01,083073,Cheng; Tzu-Han,7,0,63,56
1656236767823,COGS 17,A01,092677,Semenuks; Arturs,7,0,81,74
1656236773852,COGS 100,A01,083619,Allen; Michael Gordon,2,0,70,68
1656236779881,COGS 101A,A01,083621,Davis; Joshua Daniel,4,0,68,64
1656236785920,COGS 101B,A01,091572,Allen; Michael Gordon,4,0,65,61
1656236791950,COGS 101C,A01,083625,Delgado; Tania,10,0,35,25
1656236797989,COGS 107A,A01,083627,Boyle; Mary E. T.,0,0,60,60
1656236804014,COGS 118A,A01,083075,Gupta; Anjum,8,0,76,68
1656236810040,CSE 3,A50,083646,Miranda; Gregory Joseph,18,0,50,32
1656236816071,CSE 8A,A50,083650,Miranda; Gregory Joseph,2,2,56,54
1656236822097,CSE 11,A01,083080,Cao; Yingjun,0,49,40,40
1656236828121,CSE 12,A01,083652,Krause-Levy; Sophia Louisa,5,1,120,115
1656236834153,CSE 15L,A01,083654,Morris; Justin Loren,2,0,50,48
1656236834153,CSE 15L,A02,083655,Morris; Justin Loren,4,0,50,46
1656236840178,CSE 20,A01,083657,Tran; Khoa Dang,30,0,80,50
1656236846211,CSE 21,A01,095574,Bach; Quang Tran,23,0,48,25
1656236852238,CSE 30,A01,083084,Eldon; John,2,6,80,78
1656236852238,CSE 30,B01,095061,Bhaskar; Nishant,0,1,50,50
1656236858267,CSE 100,A01,083659,Cao; Yingjun,1,18,70,69
1656236864297,CSE 134B,A01,083661,Powell; Thomas Allan,5,0,100,95
1656236870331,CSE 140,A01,083663,Gungor; Onat,9,0,85,76
1656236876362,CSE 140L,A01,083088,Eldon; John,8,0,100,92
1656236882394,CSE 175,A01,083665,Kumar; Rakesh,0,0,25,25
1656236888418,CSE 190,A00,092507,Dubnov; Shlomo,3,0,20,17
1656236894446,ECE 45,A01,083139,Congero; Spencer William,1,0,75,74
1656236900473,ECE 65,A50,083695,Saad; Andrew S,9,0,30,21
1656236900473,ECE 65,A51,095125,Staff,24,0,26,2
1656236906497,ECE 109,A01,091882,Touri; Behrouz,0,1,70,70
1656236912523,ECE 180,A00,083140,Abi Samra; Nicholas Camill,1,0,30,29
1656236912523,ECE 180,B00,083141,Abi Samra; Nicholas Camill,0,4,30,30
1656236918551,MATH 10A,A01,083735,Patchell; Gregory David,0,0,30,30
1656236918551,MATH 10A,A02,083736,Patchell; Gregory David,22,0,30,8
1656236918551,MATH 10A,A03,083737,Patchell; Gregory David,16,0,30,14
1656236924580,MATH 10B,A01,083207,Lim; Seonhee,0,0,34,34
1656236924580,MATH 10B,A02,083208,Lim; Seonhee,7,0,35,28
1656236924580,MATH 10B,A03,093472,Staff,1,0,34,33
1656236924580,MATH 10B,B01,083739,Sinha; Shubham,11,0,30,19
1656236930609,MATH 18,A01,083743,Cinel; Cameron Alexander,7,0,30,23
1656236930609,MATH 18,A02,083744,Cinel; Cameron Alexander,9,0,30,21
1656236930609,MATH 18,A03,083745,Cinel; Cameron Alexander,5,0,30,25
1656236930609,MATH 18,B01,083748,Rideout; David Porter,1,0,36,35
1656236930609,MATH 18,B02,083749,Rideout; David Porter,0,0,36,36
1656236930609,MATH 18,B03,083750,Rideout; David Porter,0,0,36,36
1656236930609,MATH 18,B04,083751,Rideout; David Porter,0,1,36,36
1656236930609,MATH 18,B05,093473,Rideout; David Porter,0,0,36,36
1656236930609,MATH 18,B06,093474,Rideout; David Porter,3,0,36,33
1656236936633,MATH 20A,A01,083754,Zheng; Zequn,11,0,40,29
1656236942663,MATH 20B,A01,083756,Briones; Jor-el Thomas Caparas,0,0,36,36
1656236942663,MATH 20B,A02,083757,Briones; Jor-el Thomas Caparas,0,0,36,36
1656236942663,MATH 20B,A03,093475,Staff,0,0,36,36
1656236948689,MATH 20C,A01,083760,Briones; Jor-el Thomas Caparas,0,0,35,35
1656236948689,MATH 20C,A02,083761,Briones; Jor-el Thomas Caparas,9,1,35,26
1656236948689,MATH 20C,A03,093476,Staff,0,0,35,35
1656236948689,MATH 20C,B01,083762,Bach; Quang Tran,1,0,30,29
1656236954716,MATH 20D,A01,083765,Tran; Brian Kha,1,0,30,29
1656236954716,MATH 20D,A02,083766,Tran; Brian Kha,0,1,30,30
1656236954716,MATH 20D,A03,083767,Tran; Brian Kha,2,0,30,28
1656236960751,MATH 20E,A01,083771,Ganguly; Soumya,3,0,32,29
1656236960751,MATH 20E,A02,083772,Ganguly; Soumya,0,0,32,32
1656236960751,MATH 20E,B01,083773,Ciotti; Benjamin,16,0,35,19
1656236960751,MATH 20E,B02,083774,Ciotti; Benjamin,15,0,35,20
1656236966788,MATH 103A,A01,083777,Greenfeld; Be'Eri,1,0,36,35
1656236966788,MATH 103A,A02,083778,Greenfeld; Be'Eri,1,0,36,35
1656236966788,MATH 103A,A03,093561,Staff,5,0,36,31
1656236966788,MATH 103A,B01,083779,Greenfeld; Be'Eri,8,0,36,28
1656236966788,MATH 103A,B02,083780,Greenfeld; Be'Eri,1,0,36,35
1656236966788,MATH 103A,B03,093562,Staff,0,0,36,36
1656236972816,MATH 105,A01,085443,Carter; Anne Toulson,5,0,35,30
1656236972816,MATH 105,A02,093477,Staff,14,0,35,21
1656236978843,MATH 109,A01,083213,Ganzberger; Geoffrey Michael,0,0,34,34
1656236978843,MATH 109,A02,083214,Ganzberger; Geoffrey Michael,0,0,34,34
1656236978843,MATH 109,A03,093478,Staff,1,0,34,33
1656236978843,MATH 109,B01,083215,Ganzberger; Geoffrey Michael,4,0,32,28
1656236978843,MATH 109,B02,083216,Ganzberger; Geoffrey Michael,1,0,32,31
1656236978843,MATH 109,B03,093479,Staff,3,0,32,29
1656236984881,MATH 142A,A01,083219,Chow; Bennett,2,0,32,30
1656236984881,MATH 142A,A02,083220,Chow; Bennett,8,0,32,24
1656236984881,MATH 142A,A03,093480,Staff,5,0,32,27
1656236984881,MATH 142A,B03,093481,Staff,3,0,32,29
1656236984881,MATH 142A,B04,093558,Staff,6,0,32,26
1656236984881,MATH 142A,B05,093559,Staff,0,0,32,32
1656236990916,MATH 193A,A01,083224,Rotar; Vladimir,0,1,34,34
1656236990916,MATH 193A,A02,083225,Rotar; Vladimir,0,0,34,34
1656236990916,MATH 193A,A03,083781,Rotar; Vladimir,0,0,34,34
1656236990916,MATH 193A,A04,083782,Rotar; Vladimir,6,0,34,28
1656236990916,MATH 193A,A05,093482,Rotar; Vladimir,0,0,34,34
1656236996941,MATH 197,001,091859,McAuley; Julian John,9999,0,9999,0
1656236996941,MATH 197,002,095566,Kedlaya; Kiran S.,9997,0,9999,2
1656236996941,MATH 197,003,095567,Xiao; Ming,9999,0,9999,0
1656236996941,MATH 197,004,095571,Perols; Johan Lars,9998,0,9999,1
1656237004005,COGS 9,A01,083615,Shannon; Kyle Michael,3,0,75,72
1656237010029,COGS 11,A01,083617,Boyle; Mary E. T.,14,0,48,34
1656237016055,COGS 13,A01,083071,Bastos; Amalia Pinkusfeld,4,0,71,67
1656237022079,COGS 14A,A01,092681,Semenuks; Arturs,1,12,100,99
1656237028104,COGS 14B,A01,083073,Cheng; Tzu-Han,7,0,63,56
1656237034128,COGS 17,A01,092677,Semenuks; Arturs,7,0,81,74
1656237040151,COGS 100,A01,083619,Allen; Michael Gordon,2,0,70,68
1656237046268,COGS 101A,A01,083621,Davis; Joshua Daniel,4,0,68,64
1656237052294,COGS 101B,A01,091572,Allen; Michael Gordon,4,0,65,61
1656237058324,COGS 101C,A01,083625,Delgado; Tania,10,0,35,25
1656237064350,COGS 107A,A01,083627,Boyle; Mary E. T.,0,0,60,60
1656237070375,COGS 118A,A01,083075,Gupta; Anjum,8,0,76,68
1656237076399,CSE 3,A50,083646,Miranda; Gregory Joseph,18,0,50,32
1656237082430,CSE 8A,A50,083650,Miranda; Gregory Joseph,2,2,56,54
1656237088457,CSE 11,A01,083080,Cao; Yingjun,0,49,40,40
1656237094481,CSE 12,A01,083652,Krause-Levy; Sophia Louisa,5,1,120,115
1656237100508,CSE 15L,A01,083654,Morris; Justin Loren,2,0,50,48
1656237100508,CSE 15L,A02,083655,Morris; Justin Loren,4,0,50,46
1656237106538,CSE 20,A01,083657,Tran; Khoa Dang,30,0,80,50
1656237112570,CSE 21,A01,095574,Bach; Quang Tran,23,0,48,25
1656237118596,CSE 30,A01,083084,Eldon; John,2,6,80,78
1656237118596,CSE 30,B01,095061,Bhaskar; Nishant,0,1,50,50
1656237124628,CSE 100,A01,083659,Cao; Yingjun,1,18,70,69
1656237130653,CSE 134B,A01,083661,Powell; Thomas Allan,5,0,100,95
1656237136678,CSE 140,A01,083663,Gungor; Onat,9,0,85,76
1656237142702,CSE 140L,A01,083088,Eldon; John,8,0,100,92
1656237148728,CSE 175,A01,083665,Kumar; Rakesh,0,0,25,25
1656237154753,CSE 190,A00,092507,Dubnov; Shlomo,3,0,20,17
1656237160779,ECE 45,A01,083139,Congero; Spencer William,1,0,75,74
1656237166812,ECE 65,A50,083695,Saad; Andrew S,9,0,30,21
1656237166812,ECE 65,A51,095125,Staff,24,0,26,2
1656237172842,ECE 109,A01,091882,Touri; Behrouz,0,1,70,70
1656237178865,ECE 180,A00,083140,Abi Samra; Nicholas Camill,1,0,30,29
1656237178865,ECE 180,B00,083141,Abi Samra; Nicholas Camill,0,4,30,30
1656237184893,MATH 10A,A01,083735,Patchell; Gregory David,0,0,30,30
1656237184893,MATH 10A,A02,083736,Patchell; Gregory David,22,0,30,8
1656237184893,MATH 10A,A03,083737,Patchell; Gregory David,16,0,30,14
1656237190923,MATH 10B,A01,083207,Lim; Seonhee,0,0,34,34
1656237190923,MATH 10B,A02,083208,Lim; Seonhee,7,0,35,28
1656237190923,MATH 10B,A03,093472,Staff,1,0,34,33
1656237190923,MATH 10B,B01,083739,Sinha; Shubham,11,0,30,19
1656237196962,MATH 18,A01,083743,Cinel; Cameron Alexander,7,0,30,23
1656237196962,MATH 18,A02,083744,Cinel; Cameron Alexander,9,0,30,21
1656237196962,MATH 18,A03,083745,Cinel; Cameron Alexander,5,0,30,25
1656237196962,MATH 18,B01,083748,Rideout; David Porter,1,0,36,35
1656237196962,MATH 18,B02,083749,Rideout; David Porter,0,0,36,36
1656237196962,MATH 18,B03,083750,Rideout; David Porter,0,0,36,36
1656237196962,MATH 18,B04,083751,Rideout; David Porter,0,1,36,36
1656237196962,MATH 18,B05,093473,Rideout; David Porter,0,0,36,36
1656237196962,MATH 18,B06,093474,Rideout; David Porter,3,0,36,33
1656237202993,MATH 20A,A01,083754,Zheng; Zequn,11,0,40,29
1656237209019,MATH 20B,A01,083756,Briones; Jor-el Thomas Caparas,0,0,36,36
1656237209019,MATH 20B,A02,083757,Briones; Jor-el Thomas Caparas,0,0,36,36
1656237209019,MATH 20B,A03,093475,Staff,0,0,36,36
1656237215053,MATH 20C,A01,083760,Briones; Jor-el Thomas Caparas,0,0,35,35
1656237215053,MATH 20C,A02,083761,Briones; Jor-el Thomas Caparas,9,1,35,26
1656237215053,MATH 20C,A03,093476,Staff,0,0,35,35
1656237215053,MATH 20C,B01,083762,Bach; Quang Tran,1,0,30,29
1656237221079,MATH 20D,A01,083765,Tran; Brian Kha,1,0,30,29
1656237221079,MATH 20D,A02,083766,Tran; Brian Kha,0,1,30,30
1656237221079,MATH 20D,A03,083767,Tran; Brian Kha,2,0,30,28
1656237227115,MATH 20E,A01,083771,Ganguly; Soumya,3,0,32,29
1656237227115,MATH 20E,A02,083772,Ganguly; Soumya,0,0,32,32
1656237227115,MATH 20E,B01,083773,Ciotti; Benjamin,16,0,35,19
1656237227115,MATH 20E,B02,083774,Ciotti; Benjamin,15,0,35,20
1656237233154,MATH 103A,A01,083777,Greenfeld; Be'Eri,1,0,36,35
1656237233154,MATH 103A,A02,083778,Greenfeld; Be'Eri,1,0,36,35
1656237233154,MATH 103A,A03,093561,Staff,5,0,36,31
1656237233154,MATH 103A,B01,083779,Greenfeld; Be'Eri,8,0,36,28
1656237233154,MATH 103A,B02,083780,Greenfeld; Be'Eri,1,0,36,35
1656237233154,MATH 103A,B03,093562,Staff,0,0,36,36
1656237239180,MATH 105,A01,085443,Carter; Anne Toulson,5,0,35,30
1656237239180,MATH 105,A02,093477,Staff,14,0,35,21
1656237245214,MATH 109,A01,083213,Ganzberger; Geoffrey Michael,0,0,34,34
1656237245214,MATH 109,A02,083214,Ganzberger; Geoffrey Michael,0,0,34,34
1656237245214,MATH 109,A03,093478,Staff,1,0,34,33
1656237245214,MATH 109,B01,083215,Ganzberger; Geoffrey Michael,4,0,32,28
1656237245214,MATH 109,B02,083216,Ganzberger; Geoffrey Michael,1,0,32,31
1656237245214,MATH 109,B03,093479,Staff,3,0,32,29
1656237251242,MATH 142A,A01,083219,Chow; Bennett,2,0,32,30
1656237251242,MATH 142A,A02,083220,Chow; Bennett,8,0,32,24
1656237251242,MATH 142A,A03,093480,Staff,5,0,32,27
1656237251242,MATH 142A,B03,093481,Staff,3,0,32,29
1656237251242,MATH 142A,B04,093558,Staff,6,0,32,26
1656237251242,MATH 142A,B05,093559,Staff,0,0,32,32
1656237257266,MATH 193A,A01,083224,Rotar; Vladimir,0,1,34,34
1656237257266,MATH 193A,A02,083225,Rotar; Vladimir,0,0,34,34
1656237257266,MATH 193A,A03,083781,Rotar; Vladimir,0,0,34,34
1656237257266,MATH 193A,A04,083782,Rotar; Vladimir,6,0,34,28
1656237257266,MATH 193A,A05,093482,Rotar; Vladimir,0,0,34,34
1656237263297,MATH 197,001,091859,McAuley; Julian John,9999,0,9999,0
1656237263297,MATH 197,002,095566,Kedlaya; Kiran S.,9997,0,9999,2
1656237263297,MATH 197,003,095567,Xiao; Ming,9999,0,9999,0
1656237263297,MATH 197,004,095571,Perols; Johan Lars,9998,0,9999,1
1656237270377,COGS 9,A01,083615,Shannon; Kyle Michael,3,0,75,72
1656237276402,COGS 11,A01,083617,Boyle; Mary E. T.,14,0,48,34
1656237282427,COGS 13,A01,083071,Bastos; Amalia Pinkusfeld,4,0,71,67
1656237288463,COGS 14A,A01,092681,Semenuks; Arturs,1,12,100,99
1656237294489,COGS 14B,A01,083073,Cheng; Tzu-Han,7,0,63,56
1656237300522,COGS 17,A01,092677,Semenuks; Arturs,7,0,81,74
1656237306549,COGS 100,A01,083619,Allen; Michael Gordon,2,0,70,68
1656237312573,COGS 101A,A01,083621,Davis; Joshua Daniel,4,0,68,64
1656237318599,COGS 101B,A01,091572,Allen; Michael Gordon,4,0,65,61
1656237324654,COGS 101C,A01,083625,Delgado; Tania,10,0,35,25
1656237330678,COGS 107A,A01,083627,Boyle; Mary E. T.,0,0,60,60
1656237336701,COGS 118A,A01,083075,Gupta; Anjum,8,0,76,68
1656237342728,CSE 3,A50,083646,Miranda; Gregory Joseph,18,0,50,32
1656237348753,CSE 8A,A50,083650,Miranda; Gregory Joseph,2,2,56,54
1656237354777,CSE 11,A01,083080,Cao; Yingjun,0,49,40,40
1656237360814,CSE 12,A01,083652,Krause-Levy; Sophia Louisa,5,1,120,115
1656237366852,CSE 15L,A01,083654,Morris; Justin Loren,2,0,50,48
1656237366852,CSE 15L,A02,083655,Morris; Justin Loren,4,0,50,46
1656237372877,CSE 20,A01,083657,Tran; Khoa Dang,30,0,80,50
1656237378902,CSE 21,A01,095574,Bach; Quang Tran,23,0,48,25
1656237384928,CSE 30,A01,083084,Eldon; John,2,6,80,78
1656237384928,CSE 30,B01,095061,Bhaskar; Nishant,0,1,50,50
1656237390963,CSE 100,A01,083659,Cao; Yingjun,1,18,70,69
1656237397013,CSE 134B,A01,083661,Powell; Thomas Allan,5,0,100,95
1656237403038,CSE 140,A01,083663,Gungor; Onat,9,0,85,76
1656237409063,CSE 140L,A01,083088,Eldon; John,8,0,100,92
1656237415088,CSE 175,A01,083665,Kumar; Rakesh,0,0,25,25
1656237421123,CSE 190,A00,092507,Dubnov; Shlomo,3,0,20,17
1656237427157,ECE 45,A01,083139,Congero; Spencer William,1,0,75,74
1656237433182,ECE 65,A50,083695,Saad; Andrew S,9,0,30,21
1656237433182,ECE 65,A51,095125,Staff,24,0,26,2
1656237439206,ECE 109,A01,091882,Touri; Behrouz,0,1,70,70
1656237445230,ECE 180,A00,083140,Abi Samra; Nicholas Camill,1,0,30,29
1656237445230,ECE 180,B00,083141,Abi Samra; Nicholas Camill,0,4,30,30
1656237451270,MATH 10A,A01,083735,Patchell; Gregory David,0,0,30,30
1656237451270,MATH 10A,A02,083736,Patchell; Gregory David,22,0,30,8
1656237451270,MATH 10A,A03,083737,Patchell; Gregory David,16,0,30,14
1656237457297,MATH 10B,A01,083207,Lim; Seonhee,0,0,34,34
1656237457297,MATH 10B,A02,083208,Lim; Seonhee,7,0,35,28
1656237457297,MATH 10B,A03,093472,Staff,1,0,34,33
1656237457297,MATH 10B,B01,083739,Sinha; Shubham,11,0,30,19
1656237463337,MATH 18,A01,083743,Cinel; Cameron Alexander,7,0,30,23
1656237463337,MATH 18,A02,083744,Cinel; Cameron Alexander,9,0,30,21
1656237463337,MATH 18,A03,083745,Cinel; Cameron Alexander,5,0,30,25
1656237463337,MATH 18,B01,083748,Rideout; David Porter,1,0,36,35
1656237463337,MATH 18,B02,083749,Rideout; David Porter,0,0,36,36
1656237463337,MATH 18,B03,083750,Rideout; David Porter,0,0,36,36
1656237463337,MATH 18,B04,083751,Rideout; David Porter,0,1,36,36
1656237463337,MATH 18,B05,093473,Rideout; David Porter,0,0,36,36
1656237463337,MATH 18,B06,093474,Rideout; David Porter,3,0,36,33
1656237469371,MATH 20A,A01,083754,Zheng; Zequn,11,0,40,29
1656237475396,MATH 20B,A01,083756,Briones; Jor-el Thomas Caparas,0,0,36,36
1656237475396,MATH 20B,A02,083757,Briones; Jor-el Thomas Caparas,0,0,36,36
1656237475396,MATH 20B,A03,093475,Staff,0,0,36,36
1656237481431,MATH 20C,A01,083760,Briones; Jor-el Thomas Caparas,0,0,35,35
1656237481431,MATH 20C,A02,083761,Briones; Jor-el Thomas Caparas,9,1,35,26
1656237481431,MATH 20C,A03,093476,Staff,0,0,35,35
1656237481431,MATH 20C,B01,083762,Bach; Quang Tran,1,0,30,29
1656237487454,MATH 20D,A01,083765,Tran; Brian Kha,1,0,30,29
1656237487454,MATH 20D,A02,083766,Tran; Brian Kha,0,1,30,30
1656237487454,MATH 20D,A03,083767,Tran; Brian Kha,2,0,30,28
1656237493481,MATH 20E,A01,083771,Ganguly; Soumya,3,0,32,29
1656237493481,MATH 20E,A02,083772,Ganguly; Soumya,0,0,32,32
1656237493481,MATH 20E,B01,083773,Ciotti; Benjamin,16,0,35,19
1656237493481,MATH 20E,B02,083774,Ciotti; Benjamin,15,0,35,20
1656237499518,MATH 103A,A01,083777,Greenfeld; Be'Eri,1,0,36,35
1656237499518,MATH 103A,A02,083778,Greenfeld; Be'Eri,1,0,36,35
1656237499518,MATH 103A,A03,093561,Staff,5,0,36,31
1656237499518,MATH 103A,B01,083779,Greenfeld; Be'Eri,8,0,36,28
1656237499518,MATH 103A,B02,083780,Greenfeld; Be'Eri,1,0,36,35
1656237499518,MATH 103A,B03,093562,Staff,0,0,36,36
1656237505551,MATH 105,A01,085443,Carter; Anne Toulson,5,0,35,30
1656237505551,MATH 105,A02,093477,Staff,14,0,35,21
1656237511590,MATH 109,A01,083213,Ganzberger; Geoffrey Michael,0,0,34,34
1656237511590,MATH 109,A02,083214,Ganzberger; Geoffrey Michael,0,0,34,34
1656237511590,MATH 109,A03,093478,Staff,1,0,34,33
1656237511590,MATH 109,B01,083215,Ganzberger; Geoffrey Michael,4,0,32,28
1656237511590,MATH 109,B02,083216,Ganzberger; Geoffrey Michael,1,0,32,31
1656237511590,MATH 109,B03,093479,Staff,3,0,32,29
1656237517629,MATH 142A,A01,083219,Chow; Bennett,2,0,32,30
1656237517629,MATH 142A,A02,083220,Chow; Bennett,8,0,32,24
1656237517629,MATH 142A,A03,093480,Staff,5,0,32,27
1656237517629,MATH 142A,B03,093481,Staff,3,0,32,29
1656237517629,MATH 142A,B04,093558,Staff,6,0,32,26
1656237517629,MATH 142A,B05,093559,Staff,0,0,32,32
1656237523656,MATH 193A,A01,083224,Rotar; Vladimir,0,1,34,34
1656237523656,MATH 193A,A02,083225,Rotar; Vladimir,0,0,34,34
1656237523656,MATH 193A,A03,083781,Rotar; Vladimir,0,0,34,34
1656237523656,MATH 193A,A04,083782,Rotar; Vladimir,6,0,34,28
1656237523656,MATH 193A,A05,093482,Rotar; Vladimir,0,0,34,34
1656237529690,MATH 197,001,091859,McAuley; Julian John,9999,0,9999,0
1656237529690,MATH 197,002,095566,Kedlaya; Kiran S.,9997,0,9999,2
1656237529690,MATH 197,003,095567,Xiao; Ming,9999,0,9999,0
1656237529690,MATH 197,004,095571,Perols; Johan Lars,9998,0,9999,1
1656237536775,COGS 9,A01,083615,Shannon; Kyle Michael,3,0,75,72
1656237542821,COGS 11,A01,083617,Boyle; Mary E. T.,14,0,48,34
1656237548860,COGS 13,A01,083071,Bastos; Amalia Pinkusfeld,4,0,71,67
1656237554898,COGS 14A,A01,092681,Semenuks; Arturs,1,12,100,99
1656237560921,COGS 14B,A01,083073,Cheng; Tzu-Han,7,0,63,56
1656237566946,COGS 17,A01,092677,Semenuks; Arturs,7,0,81,74
1656237572980,COGS 100,A01,083619,Allen; Michael Gordon,2,0,70,68
1656237579019,COGS 101A,A01,083621,Davis; Joshua Daniel,4,0,68,64
1656237585048,COGS 101B,A01,091572,Allen; Michael Gordon,4,0,65,61
1656237591072,COGS 101C,A01,083625,Delgado; Tania,10,0,35,25
1656237597096,COGS 107A,A01,083627,Boyle; Mary E. T.,0,0,60,60
1656237603126,COGS 118A,A01,083075,Gupta; Anjum,8,0,76,68
1656237609151,CSE 3,A50,083646,Miranda; Gregory Joseph,18,0,50,32
1656237615184,CSE 8A,A50,083650,Miranda; Gregory Joseph,2,2,56,54
1656237621213,CSE 11,A01,083080,Cao; Yingjun,0,49,40,40
1656237627239,CSE 12,A01,083652,Krause-Levy; Sophia Louisa,5,1,120,115
1656237633265,CSE 15L,A01,083654,Morris; Justin Loren,2,0,50,48
1656237633265,CSE 15L,A02,083655,Morris; Justin Loren,4,0,50,46
1656237639290,CSE 20,A01,083657,Tran; Khoa Dang,30,0,80,50
1656237645391,CSE 21,A01,095574,Bach; Quang Tran,23,0,48,25
1656237651423,CSE 30,A01,083084,Eldon; John,2,6,80,78
1656237651423,CSE 30,B01,095061,Bhaskar; Nishant,0,1,50,50
1656237657452,CSE 100,A01,083659,Cao; Yingjun,1,18,70,69
1656237663490,CSE 134B,A01,083661,Powell; Thomas Allan,5,0,100,95
1656237669520,CSE 140,A01,083663,Gungor; Onat,9,0,85,76
1656237675554,CSE 140L,A01,083088,Eldon; John,8,0,100,92
1656237681585,CSE 175,A01,083665,Kumar; Rakesh,0,0,25,25
1656237687614,CSE 190,A00,092507,Dubnov; Shlomo,3,0,20,17
1656237693640,ECE 45,A01,083139,Congero; Spencer William,1,0,75,74
1656237699671,ECE 65,A50,083695,Saad; Andrew S,9,0,30,21
1656237699671,ECE 65,A51,095125,Staff,24,0,26,2
1656237705696,ECE 109,A01,091882,Touri; Behrouz,0,1,70,70
1656237711721,ECE 180,A00,083140,Abi Samra; Nicholas Camill,1,0,30,29
1656237711721,ECE 180,B00,083141,Abi Samra; Nicholas Camill,0,4,30,30
1656237717753,MATH 10A,A01,083735,Patchell; Gregory David,0,0,30,30
1656237717753,MATH 10A,A02,083736,Patchell; Gregory David,22,0,30,8
1656237717753,MATH 10A,A03,083737,Patchell; Gregory David,16,0,30,14
1656237723782,MATH 10B,A01,083207,Lim; Seonhee,0,0,34,34
1656237723782,MATH 10B,A02,083208,Lim; Seonhee,7,0,35,28
1656237723782,MATH 10B,A03,093472,Staff,1,0,34,33
1656237723782,MATH 10B,B01,083739,Sinha; Shubham,11,0,30,19
1656237729823,MATH 18,A01,083743,Cinel; Cameron Alexander,7,0,30,23
1656237729823,MATH 18,A02,083744,Cinel; Cameron Alexander,9,0,30,21
1656237729823,MATH 18,A03,083745,Cinel; Cameron Alexander,5,0,30,25
1656237729823,MATH 18,B01,083748,Rideout; David Porter,1,0,36,35
1656237729823,MATH 18,B02,083749,Rideout; David Porter,0,0,36,36
1656237729823,MATH 18,B03,083750,Rideout; David Porter,0,0,36,36
1656237729823,MATH 18,B04,083751,Rideout; David Porter,0,1,36,36
1656237729823,MATH 18,B05,093473,Rideout; David Porter,0,0,36,36
1656237729823,MATH 18,B06,093474,Rideout; David Porter,3,0,36,33
1656237735848,MATH 20A,A01,083754,Zheng; Zequn,11,0,40,29
1656237741874,MATH 20B,A01,083756,Briones; Jor-el Thomas Caparas,0,0,36,36
1656237741874,MATH 20B,A02,083757,Briones; Jor-el Thomas Caparas,0,0,36,36
1656237741874,MATH 20B,A03,093475,Staff,0,0,36,36
1656237747920,MATH 20C,A01,083760,Briones; Jor-el Thomas Caparas,0,0,35,35
1656237747920,MATH 20C,A02,083761,Briones; Jor-el Thomas Caparas,9,1,35,26
1656237747920,MATH 20C,A03,093476,Staff,0,0,35,35
1656237747920,MATH 20C,B01,083762,Bach; Quang Tran,1,0,30,29
1656237753946,MATH 20D,A01,083765,Tran; Brian Kha,1,0,30,29
1656237753946,MATH 20D,A02,083766,Tran; Brian Kha,0,1,30,30
1656237753946,MATH 20D,A03,083767,Tran; Brian Kha,2,0,30,28
1656237759971,MATH 20E,A01,083771,Ganguly; Soumya,3,0,32,29
1656237759971,MATH 20E,A02,083772,Ganguly; Soumya,0,0,32,32
1656237759971,MATH 20E,B01,083773,Ciotti; Benjamin,16,0,35,19
1656237759971,MATH 20E,B02,083774,Ciotti; Benjamin,15,0,35,20
1656237766003,MATH 103A,A01,083777,Greenfeld; Be'Eri,1,0,36,35
1656237766003,MATH 103A,A02,083778,Greenfeld; Be'Eri,1,0,36,35
1656237766003,MATH 103A,A03,093561,Staff,5,0,36,31
1656237766003,MATH 103A,B01,083779,Greenfeld; Be'Eri,8,0,36,28
1656237766003,MATH 103A,B02,083780,Greenfeld; Be'Eri,1,0,36,35
1656237766003,MATH 103A,B03,093562,Staff,0,0,36,36
1656237772040,MATH 105,A01,085443,Carter; Anne Toulson,5,0,35,30
1656237772040,MATH 105,A02,093477,Staff,14,0,35,21
1656237778066,MATH 109,A01,083213,Ganzberger; Geoffrey Michael,0,0,34,34
1656237778066,MATH 109,A02,083214,Ganzberger; Geoffrey Michael,0,0,34,34
1656237778066,MATH 109,A03,093478,Staff,1,0,34,33
1656237778066,MATH 109,B01,083215,Ganzberger; Geoffrey Michael,4,0,32,28
1656237778066,MATH 109,B02,083216,Ganzberger; Geoffrey Michael,1,0,32,31
1656237778066,MATH 109,B03,093479,Staff,3,0,32,29
1656237784092,MATH 142A,A01,083219,Chow; Bennett,2,0,32,30
1656237784092,MATH 142A,A02,083220,Chow; Bennett,8,0,32,24
1656237784092,MATH 142A,A03,093480,Staff,5,0,32,27
1656237784092,MATH 142A,B03,093481,Staff,3,0,32,29
1656237784092,MATH 142A,B04,093558,Staff,6,0,32,26
1656237784092,MATH 142A,B05,093559,Staff,0,0,32,32
1656237790116,MATH 193A,A01,083224,Rotar; Vladimir,0,1,34,34
1656237790116,MATH 193A,A02,083225,Rotar; Vladimir,0,0,34,34
1656237790116,MATH 193A,A03,083781,Rotar; Vladimir,0,0,34,34
1656237790116,MATH 193A,A04,083782,Rotar; Vladimir,6,0,34,28
1656237790116,MATH 193A,A05,093482,Rotar; Vladimir,0,0,34,34
1656237796140,MATH 197,001,091859,McAuley; Julian John,9999,0,9999,0
1656237796140,MATH 197,002,095566,Kedlaya; Kiran S.,9997,0,9999,2
1656237796140,MATH 197,003,095567,Xiao; Ming,9999,0,9999,0
1656237796140,MATH 197,004,095571,Perols; Johan Lars,9998,0,9999,1
1656237803217,COGS 9,A01,083615,Shannon; Kyle Michael,3,0,75,72
1656237809252,COGS 11,A01,083617,Boyle; Mary E. T.,14,0,48,34
1656237815283,COGS 13,A01,083071,Bastos; Amalia Pinkusfeld,4,0,71,67
1656237821308,COGS 14A,A01,092681,Semenuks; Arturs,1,12,100,99
1656237827336,COGS 14B,A01,083073,Cheng; Tzu-Han,7,0,63,56
1656237833360,COGS 17,A01,092677,Semenuks; Arturs,7,0,81,74
1656237839386,COGS 100,A01,083619,Allen; Michael Gordon,2,0,70,68
1656237845415,COGS 101A,A01,083621,Davis; Joshua Daniel,4,0,68,64
1656237851441,COGS 101B,A01,091572,Allen; Michael Gordon,4,0,65,61
1656237857468,COGS 101C,A01,083625,Delgado; Tania,10,0,35,25
1656237863493,COGS 107A,A01,083627,Boyle; Mary E. T.,0,0,60,60
1656237869519,COGS 118A,A01,083075,Gupta; Anjum,8,0,76,68
1656237875543,CSE 3,A50,083646,Miranda; Gregory Joseph,18,0,50,32
1656237881574,CSE 8A,A50,083650,Miranda; Gregory Joseph,2,2,56,54
1656237887602,CSE 11,A01,083080,Cao; Yingjun,0,49,40,40
1656237893624,CSE 12,A01,083652,Krause-Levy; Sophia Louisa,5,1,120,115
1656237899653,CSE 15L,A01,083654,Morris; Justin Loren,2,0,50,48
1656237899653,CSE 15L,A02,083655,Morris; Justin Loren,4,0,50,46
1656237905682,CSE 20,A01,083657,Tran; Khoa Dang,30,0,80,50
1656237911713,CSE 21,A01,095574,Bach; Quang Tran,23,0,48,25
1656237917740,CSE 30,A01,083084,Eldon; John,2,6,80,78
1656237917740,CSE 30,B01,095061,Bhaskar; Nishant,0,1,50,50
1656237923766,CSE 100,A01,083659,Cao; Yingjun,1,18,70,69
1656237929790,CSE 134B,A01,083661,Powell; Thomas Allan,5,0,100,95
1656237935815,CSE 140,A01,083663,Gungor; Onat,9,0,85,76
1656237941840,CSE 140L,A01,083088,Eldon; John,8,0,100,92
1656237947865,CSE 175,A01,083665,Kumar; Rakesh,0,0,25,25
1656237953895,CSE 190,A00,092507,Dubnov; Shlomo,3,0,20,17
1656237959928,ECE 45,A01,083139,Congero; Spencer William,1,0,75,74
1656237965954,ECE 65,A50,083695,Saad; Andrew S,9,0,30,21
1656237965954,ECE 65,A51,095125,Staff,24,0,26,2
1656237971979,ECE 109,A01,091882,Touri; Behrouz,0,1,70,70
1656237978004,ECE 180,A00,083140,Abi Samra; Nicholas Camill,1,0,30,29
1656237978004,ECE 180,B00,083141,Abi Samra; Nicholas Camill,0,4,30,30
1656237984029,MATH 10A,A01,083735,Patchell; Gregory David,0,0,30,30
1656237984029,MATH 10A,A02,083736,Patchell; Gregory David,22,0,30,8
1656237984029,MATH 10A,A03,083737,Patchell; Gregory David,16,0,30,14
1656237990055,MATH 10B,A01,083207,Lim; Seonhee,0,0,34,34
1656237990055,MATH 10B,A02,083208,Lim; Seonhee,7,0,35,28
1656237990055,MATH 10B,A03,093472,Staff,1,0,34,33
1656237990055,MATH 10B,B01,083739,Sinha; Shubham,11,0,30,19
1656237996099,MATH 18,A01,083743,Cinel; Cameron Alexander,7,0,30,23
1656237996099,MATH 18,A02,083744,Cinel; Cameron Alexander,9,0,30,21
1656237996099,MATH 18,A03,083745,Cinel; Cameron Alexander,5,0,30,25
1656237996099,MATH 18,B01,083748,Rideout; David Porter,1,0,36,35
1656237996099,MATH 18,B02,083749,Rideout; David Porter,0,0,36,36
1656237996099,MATH 18,B03,083750,Rideout; David Porter,0,0,36,36
1656237996099,MATH 18,B04,083751,Rideout; David Porter,0,1,36,36
1656237996099,MATH 18,B05,093473,Rideout; David Porter,0,0,36,36
1656237996099,MATH 18,B06,093474,Rideout; David Porter,3,0,36,33
1656238002130,MATH 20A,A01,083754,Zheng; Zequn,11,0,40,29
1656238008155,MATH 20B,A01,083756,Briones; Jor-el Thomas Caparas,0,0,36,36
1656238008155,MATH 20B,A02,083757,Briones; Jor-el Thomas Caparas,0,0,36,36
1656238008155,MATH 20B,A03,093475,Staff,0,0,36,36
1656238014180,MATH 20C,A01,083760,Briones; Jor-el Thomas Caparas,0,0,35,35
1656238014180,MATH 20C,A02,083761,Briones; Jor-el Thomas Caparas,9,1,35,26
1656238014180,MATH 20C,A03,093476,Staff,0,0,35,35
1656238014180,MATH 20C,B01,083762,Bach; Quang Tran,1,0,30,29
1656238020226,MATH 20D,A01,083765,Tran; Brian Kha,1,0,30,29
1656238020226,MATH 20D,A02,083766,Tran; Brian Kha,0,1,30,30
1656238020226,MATH 20D,A03,083767,Tran; Brian Kha,2,0,30,28
1656238026254,MATH 20E,A01,083771,Ganguly; Soumya,3,0,32,29
1656238026254,MATH 20E,A02,083772,Ganguly; Soumya,0,0,32,32
1656238026254,MATH 20E,B01,083773,Ciotti; Benjamin,16,0,35,19
1656238026254,MATH 20E,B02,083774,Ciotti; Benjamin,15,0,35,20
1656238032286,MATH 103A,A01,083777,Greenfeld; Be'Eri,1,0,36,35
1656238032286,MATH 103A,A02,083778,Greenfeld; Be'Eri,1,0,36,35
1656238032286,MATH 103A,A03,093561,Staff,5,0,36,31
1656238032286,MATH 103A,B01,083779,Greenfeld; Be'Eri,8,0,36,28
1656238032286,MATH 103A,B02,083780,Greenfeld; Be'Eri,1,0,36,35
1656238032286,MATH 103A,B03,093562,Staff,0,0,36,36
1656238038312,MATH 105,A01,085443,Carter; Anne Toulson,5,0,35,30
1656238038312,MATH 105,A02,093477,Staff,14,0,35,21
1656238044338,MATH 109,A01,083213,Ganzberger; Geoffrey Michael,0,0,34,34
1656238044338,MATH 109,A02,083214,Ganzberger; Geoffrey Michael,0,0,34,34
1656238044338,MATH 109,A03,093478,Staff,1,0,34,33
1656238044338,MATH 109,B01,083215,Ganzberger; Geoffrey Michael,4,0,32,28
1656238044338,MATH 109,B02,083216,Ganzberger; Geoffrey Michael,1,0,32,31
1656238044338,MATH 109,B03,093479,Staff,3,0,32,29
1656238050370,MATH 142A,A01,083219,Chow; Bennett,2,0,32,30
1656238050370,MATH 142A,A02,083220,Chow; Bennett,8,0,32,24
1656238050370,MATH 142A,A03,093480,Staff,5,0,32,27
1656238050370,MATH 142A,B03,093481,Staff,3,0,32,29
1656238050370,MATH 142A,B04,093558,Staff,6,0,32,26
1656238050370,MATH 142A,B05,093559,Staff,0,0,32,32
1656238056407,MATH 193A,A01,083224,Rotar; Vladimir,0,1,34,34
1656238056407,MATH 193A,A02,083225,Rotar; Vladimir,0,0,34,34
1656238056407,MATH 193A,A03,083781,Rotar; Vladimir,0,0,34,34
1656238056407,MATH 193A,A04,083782,Rotar; Vladimir,6,0,34,28
1656238056407,MATH 193A,A05,093482,Rotar; Vladimir,0,0,34,34
1656238062434,MATH 197,001,091859,McAuley; Julian John,9999,0,9999,0
1656238062434,MATH 197,002,095566,Kedlaya; Kiran S.,9997,0,9999,2
1656238062434,MATH 197,003,095567,Xiao; Ming,9999,0,9999,0
1656238062434,MATH 197,004,095571,Perols; Johan Lars,9998,0,9999,1
1656238069503,COGS 9,A01,083615,Shannon; Kyle Michael,3,0,75,72
1656238075526,COGS 11,A01,083617,Boyle; Mary E. T.,14,0,48,34
1656238081554,COGS 13,A01,083071,Bastos; Amalia Pinkusfeld,4,0,71,67
1656238087576,COGS 14A,A01,092681,Semenuks; Arturs,1,12,100,99
1656238093602,COGS 14B,A01,083073,Cheng; Tzu-Han,7,0,63,56
1656238099645,COGS 17,A01,092677,Semenuks; Arturs,7,0,81,74
1656238105677,COGS 100,A01,083619,Allen; Michael Gordon,2,0,70,68
1656238111701,COGS 101A,A01,083621,Davis; Joshua Daniel,4,0,68,64
1656238117731,COGS 101B,A01,091572,Allen; Michael Gordon,4,0,65,61
1656238123763,COGS 101C,A01,083625,Delgado; Tania,10,0,35,25
1656238129788,COGS 107A,A01,083627,Boyle; Mary E. T.,0,0,60,60
1656238135826,COGS 118A,A01,083075,Gupta; Anjum,8,0,76,68
1656238141854,CSE 3,A50,083646,Miranda; Gregory Joseph,18,0,50,32
1656238147889,CSE 8A,A50,083650,Miranda; Gregory Joseph,2,2,56,54
1656238153914,CSE 11,A01,083080,Cao; Yingjun,0,49,40,40
1656238159940,CSE 12,A01,083652,Krause-Levy; Sophia Louisa,5,1,120,115
1656238165972,CSE 15L,A01,083654,Morris; Justin Loren,2,0,50,48
1656238165972,CSE 15L,A02,083655,Morris; Justin Loren,4,0,50,46
1656238171997,CSE 20,A01,083657,Tran; Khoa Dang,30,0,80,50
1656238178021,CSE 21,A01,095574,Bach; Quang Tran,23,0,48,25
1656238184047,CSE 30,A01,083084,Eldon; John,2,6,80,78
1656238184047,CSE 30,B01,095061,Bhaskar; Nishant,0,1,50,50
1656238190100,CSE 100,A01,083659,Cao; Yingjun,1,18,70,69
1656238196125,CSE 134B,A01,083661,Powell; Thomas Allan,5,0,100,95
1656238202166,CSE 140,A01,083663,Gungor; Onat,9,0,85,76
1656238208195,CSE 140L,A01,083088,Eldon; John,8,0,100,92
1656238214228,CSE 175,A01,083665,Kumar; Rakesh,0,0,25,25
1656238220263,CSE 190,A00,092507,Dubnov; Shlomo,3,0,20,17
1656238226296,ECE 45,A01,083139,Congero; Spencer William,1,0,75,74
1656238232332,ECE 65,A50,083695,Saad; Andrew S,9,0,30,21
1656238232332,ECE 65,A51,095125,Staff,24,0,26,2
1656238238357,ECE 109,A01,091882,Touri; Behrouz,0,1,70,70
1656238244474,ECE 180,A00,083140,Abi Samra; Nicholas Camill,1,0,30,29
1656238244474,ECE 180,B00,083141,Abi Samra; Nicholas Camill,0,4,30,30
1656238250510,MATH 10A,A01,083735,Patchell; Gregory David,0,0,30,30
1656238250510,MATH 10A,A02,083736,Patchell; Gregory David,22,0,30,8
1656238250510,MATH 10A,A03,083737,Patchell; Gregory David,16,0,30,14
1656238256537,MATH 10B,A01,083207,Lim; Seonhee,0,0,34,34
1656238256537,MATH 10B,A02,083208,Lim; Seonhee,7,0,35,28
1656238256537,MATH 10B,A03,093472,Staff,1,0,34,33
1656238256537,MATH 10B,B01,083739,Sinha; Shubham,11,0,30,19
1656238262567,MATH 18,A01,083743,Cinel; Cameron Alexander,7,0,30,23
1656238262567,MATH 18,A02,083744,Cinel; Cameron Alexander,9,0,30,21
1656238262567,MATH 18,A03,083745,Cinel; Cameron Alexander,5,0,30,25
1656238262567,MATH 18,B01,083748,Rideout; David Porter,1,0,36,35
1656238262567,MATH 18,B02,083749,Rideout; David Porter,0,0,36,36
1656238262567,MATH 18,B03,083750,Rideout; David Porter,0,0,36,36
1656238262567,MATH 18,B04,083751,Rideout; David Porter,0,1,36,36
1656238262567,MATH 18,B05,093473,Rideout; David Porter,0,0,36,36
1656238262567,MATH 18,B06,093474,Rideout; David Porter,3,0,36,33
1656238268592,MATH 20A,A01,083754,Zheng; Zequn,11,0,40,29
1656238274619,MATH 20B,A01,083756,Briones; Jor-el Thomas Caparas,0,0,36,36
1656238274619,MATH 20B,A02,083757,Briones; Jor-el Thomas Caparas,0,0,36,36
1656238274619,MATH 20B,A03,093475,Staff,0,0,36,36
1656238280651,MATH 20C,A01,083760,Briones; Jor-el Thomas Caparas,0,0,35,35
1656238280651,MATH 20C,A02,083761,Briones; Jor-el Thomas Caparas,9,1,35,26
1656238280651,MATH 20C,A03,093476,Staff,0,0,35,35
1656238280651,MATH 20C,B01,083762,Bach; Quang Tran,1,0,30,29
1656238286682,MATH 20D,A01,083765,Tran; Brian Kha,1,0,30,29
1656238286682,MATH 20D,A02,083766,Tran; Brian Kha,0,1,30,30
1656238286682,MATH 20D,A03,083767,Tran; Brian Kha,2,0,30,28
1656238292718,MATH 20E,A01,083771,Ganguly; Soumya,3,0,32,29
1656238292718,MATH 20E,A02,083772,Ganguly; Soumya,0,0,32,32
1656238292718,MATH 20E,B01,083773,Ciotti; Benjamin,16,0,35,19
1656238292718,MATH 20E,B02,083774,Ciotti; Benjamin,15,0,35,20
1656238298745,MATH 103A,A01,083777,Greenfeld; Be'Eri,1,0,36,35
1656238298745,MATH 103A,A02,083778,Greenfeld; Be'Eri,1,0,36,35
1656238298745,MATH 103A,A03,093561,Staff,5,0,36,31
1656238298745,MATH 103A,B01,083779,Greenfeld; Be'Eri,8,0,36,28
1656238298745,MATH 103A,B02,083780,Greenfeld; Be'Eri,1,0,36,35
1656238298745,MATH 103A,B03,093562,Staff,0,0,36,36
1656238304772,MATH 105,A01,085443,Carter; Anne Toulson,5,0,35,30
1656238304772,MATH 105,A02,093477,Staff,14,0,35,21
1656238310805,MATH 109,A01,083213,Ganzberger; Geoffrey Michael,0,0,34,34
1656238310805,MATH 109,A02,083214,Ganzberger; Geoffrey Michael,0,0,34,34
1656238310805,MATH 109,A03,093478,Staff,1,0,34,33
1656238310805,MATH 109,B01,083215,Ganzberger; Geoffrey Michael,4,0,32,28
1656238310805,MATH 109,B02,083216,Ganzberger; Geoffrey Michael,1,0,32,31
1656238310805,MATH 109,B03,093479,Staff,3,0,32,29
1656238316839,MATH 142A,A01,083219,Chow; Bennett,2,0,32,30
1656238316839,MATH 142A,A02,083220,Chow; Bennett,8,0,32,24
1656238316839,MATH 142A,A03,093480,Staff,5,0,32,27
1656238316839,MATH 142A,B03,093481,Staff,3,0,32,29
1656238316839,MATH 142A,B04,093558,Staff,6,0,32,26
1656238316839,MATH 142A,B05,093559,Staff,0,0,32,32
1656238322871,MATH 193A,A01,083224,Rotar; Vladimir,0,1,34,34
1656238322871,MATH 193A,A02,083225,Rotar; Vladimir,0,0,34,34
1656238322871,MATH 193A,A03,083781,Rotar; Vladimir,0,0,34,34
1656238322871,MATH 193A,A04,083782,Rotar; Vladimir,6,0,34,28
1656238322871,MATH 193A,A05,093482,Rotar; Vladimir,0,0,34,34
1656238328899,MATH 197,001,091859,McAuley; Julian John,9999,0,9999,0
1656238328899,MATH 197,002,095566,Kedlaya; Kiran S.,9997,0,9999,2
1656238328899,MATH 197,003,095567,Xiao; Ming,9999,0,9999,0
1656238328899,MATH 197,004,095571,Perols; Johan Lars,9998,0,9999,1
1656238335981,COGS 9,A01,083615,Shannon; Kyle Michael,3,0,75,72
1656238342011,COGS 11,A01,083617,Boyle; Mary E. T.,14,0,48,34
1656238348037,COGS 13,A01,083071,Bastos; Amalia Pinkusfeld,4,0,71,67
1656238354063,COGS 14A,A01,092681,Semenuks; Arturs,1,12,100,99
1656238360085,COGS 14B,A01,083073,Cheng; Tzu-Han,7,0,63,56
1656238366110,COGS 17,A01,092677,Semenuks; Arturs,7,0,81,74
1656238372139,COGS 100,A01,083619,Allen; Michael Gordon,2,0,70,68
1656238378167,COGS 101A,A01,083621,Davis; Joshua Daniel,4,0,68,64
1656238384221,COGS 101B,A01,091572,Allen; Michael Gordon,4,0,65,61
1656238390247,COGS 101C,A01,083625,Delgado; Tania,10,0,35,25
1656238396272,COGS 107A,A01,083627,Boyle; Mary E. T.,0,0,60,60
1656238402294,COGS 118A,A01,083075,Gupta; Anjum,8,0,76,68
1656238408320,CSE 3,A50,083646,Miranda; Gregory Joseph,18,0,50,32
1656238414350,CSE 8A,A50,083650,Miranda; Gregory Joseph,2,2,56,54
1656238420377,CSE 11,A01,083080,Cao; Yingjun,0,49,40,40
1656238426402,CSE 12,A01,083652,Krause-Levy; Sophia Louisa,5,1,120,115
1656238432432,CSE 15L,A01,083654,Morris; Justin Loren,2,0,50,48
1656238432432,CSE 15L,A02,083655,Morris; Justin Loren,4,0,50,46
1656238438464,CSE 20,A01,083657,Tran; Khoa Dang,30,0,80,50
1656238444492,CSE 21,A01,095574,Bach; Quang Tran,23,0,48,25
1656238450518,CSE 30,A01,083084,Eldon; John,2,6,80,78
1656238450518,CSE 30,B01,095061,Bhaskar; Nishant,0,1,50,50
1656238456543,CSE 100,A01,083659,Cao; Yingjun,1,18,70,69
1656238462568,CSE 134B,A01,083661,Powell; Thomas Allan,5,0,100,95
1656238468592,CSE 140,A01,083663,Gungor; Onat,9,0,85,76
1656238474620,CSE 140L,A01,083088,Eldon; John,8,0,100,92
1656238480645,CSE 175,A01,083665,Kumar; Rakesh,0,0,25,25
1656238486679,CSE 190,A00,092507,Dubnov; Shlomo,3,0,20,17
1656238492706,ECE 45,A01,083139,Congero; Spencer William,1,0,75,74
1656238498734,ECE 65,A50,083695,Saad; Andrew S,9,0,30,21
1656238498734,ECE 65,A51,095125,Staff,24,0,26,2
1656238504763,ECE 109,A01,091882,Touri; Behrouz,0,1,70,70
1656238510793,ECE 180,A00,083140,Abi Samra; Nicholas Camill,1,0,30,29
1656238510793,ECE 180,B00,083141,Abi Samra; Nicholas Camill,0,4,30,30
1656238516829,MATH 10A,A01,083735,Patchell; Gregory David,0,0,30,30
1656238516829,MATH 10A,A02,083736,Patchell; Gregory David,22,0,30,8
1656238516829,MATH 10A,A03,083737,Patchell; Gregory David,16,0,30,14
1656238522858,MATH 10B,A01,083207,Lim; Seonhee,0,0,34,34
1656238522858,MATH 10B,A02,083208,Lim; Seonhee,7,0,35,28
1656238522858,MATH 10B,A03,093472,Staff,1,0,34,33
1656238522858,MATH 10B,B01,083739,Sinha; Shubham,11,0,30,19
1656238528897,MATH 18,A01,083743,Cinel; Cameron Alexander,7,0,30,23
1656238528897,MATH 18,A02,083744,Cinel; Cameron Alexander,9,0,30,21
1656238528897,MATH 18,A03,083745,Cinel; Cameron Alexander,5,0,30,25
1656238528897,MATH 18,B01,083748,Rideout; David Porter,1,0,36,35
1656238528897,MATH 18,B02,083749,Rideout; David Porter,0,0,36,36
1656238528897,MATH 18,B03,083750,Rideout; David Porter,0,0,36,36
1656238528897,MATH 18,B04,083751,Rideout; David Porter,0,1,36,36
1656238528897,MATH 18,B05,093473,Rideout; David Porter,0,0,36,36
1656238528897,MATH 18,B06,093474,Rideout; David Porter,3,0,36,33
1656238534921,MATH 20A,A01,083754,Zheng; Zequn,11,0,40,29
1656238540949,MATH 20B,A01,083756,Briones; Jor-el Thomas Caparas,0,0,36,36
1656238540949,MATH 20B,A02,083757,Briones; Jor-el Thomas Caparas,0,0,36,36
1656238540949,MATH 20B,A03,093475,Staff,0,0,36,36
1656238546985,MATH 20C,A01,083760,Briones; Jor-el Thomas Caparas,0,0,35,35
1656238546985,MATH 20C,A02,083761,Briones; Jor-el Thomas Caparas,9,1,35,26
1656238546985,MATH 20C,A03,093476,Staff,0,0,35,35
1656238546985,MATH 20C,B01,083762,Bach; Quang Tran,1,0,30,29
1656238553017,MATH 20D,A01,083765,Tran; Brian Kha,1,0,30,29
1656238553017,MATH 20D,A02,083766,Tran; Brian Kha,0,1,30,30
1656238553017,MATH 20D,A03,083767,Tran; Brian Kha,2,0,30,28
1656238559049,MATH 20E,A01,083771,Ganguly; Soumya,3,0,32,29
1656238559049,MATH 20E,A02,083772,Ganguly; Soumya,0,0,32,32
1656238559049,MATH 20E,B01,083773,Ciotti; Benjamin,16,0,35,19
1656238559049,MATH 20E,B02,083774,Ciotti; Benjamin,15,0,35,20
1656238565077,MATH 103A,A01,083777,Greenfeld; Be'Eri,1,0,36,35
1656238565077,MATH 103A,A02,083778,Greenfeld; Be'Eri,1,0,36,35
1656238565077,MATH 103A,A03,093561,Staff,5,0,36,31
1656238565077,MATH 103A,B01,083779,Greenfeld; Be'Eri,8,0,36,28
1656238565077,MATH 103A,B02,083780,Greenfeld; Be'Eri,1,0,36,35
1656238565077,MATH 103A,B03,093562,Staff,0,0,36,36
1656238571107,MATH 105,A01,085443,Carter; Anne Toulson,5,0,35,30
1656238571107,MATH 105,A02,093477,Staff,14,0,35,21
1656238577149,MATH 109,A01,083213,Ganzberger; Geoffrey Michael,0,0,34,34
1656238577149,MATH 109,A02,083214,Ganzberger; Geoffrey Michael,0,0,34,34
1656238577149,MATH 109,A03,093478,Staff,1,0,34,33
1656238577149,MATH 109,B01,083215,Ganzberger; Geoffrey Michael,4,0,32,28
1656238577149,MATH 109,B02,083216,Ganzberger; Geoffrey Michael,1,0,32,31
1656238577149,MATH 109,B03,093479,Staff,3,0,32,29
1656238583178,MATH 142A,A01,083219,Chow; Bennett,2,0,32,30
1656238583178,MATH 142A,A02,083220,Chow; Bennett,8,0,32,24
1656238583178,MATH 142A,A03,093480,Staff,5,0,32,27
1656238583178,MATH 142A,B03,093481,Staff,3,0,32,29
1656238583178,MATH 142A,B04,093558,Staff,6,0,32,26
1656238583178,MATH 142A,B05,093559,Staff,0,0,32,32
1656238589204,MATH 193A,A01,083224,Rotar; Vladimir,0,1,34,34
1656238589204,MATH 193A,A02,083225,Rotar; Vladimir,0,0,34,34
1656238589204,MATH 193A,A03,083781,Rotar; Vladimir,0,0,34,34
1656238589204,MATH 193A,A04,083782,Rotar; Vladimir,6,0,34,28
1656238589204,MATH 193A,A05,093482,Rotar; Vladimir,0,0,34,34
1656238595232,MATH 197,001,091859,McAuley; Julian John,9999,0,9999,0
1656238595232,MATH 197,002,095566,Kedlaya; Kiran S.,9997,0,9999,2
1656238595232,MATH 197,003,095567,Xiao; Ming,9999,0,9999,0
1656238595232,MATH 197,004,095571,Perols; Johan Lars,9998,0,9999,1
1656238602316,COGS 9,A01,083615,Shannon; Kyle Michael,3,0,75,72
1656238608341,COGS 11,A01,083617,Boyle; Mary E. T.,14,0,48,34
1656238614372,COGS 13,A01,083071,Bastos; Amalia Pinkusfeld,4,0,71,67
1656238620405,COGS 14A,A01,092681,Semenuks; Arturs,1,12,100,99
1656238626437,COGS 14B,A01,083073,Cheng; Tzu-Han,7,0,63,56
1656238632461,COGS 17,A01,092677,Semenuks; Arturs,7,0,81,74
1656238638492,COGS 100,A01,083619,Allen; Michael Gordon,2,0,70,68
1656238644516,COGS 101A,A01,083621,Davis; Joshua Daniel,4,0,68,64
1656238650546,COGS 101B,A01,091572,Allen; Michael Gordon,4,0,65,61
1656238656579,COGS 101C,A01,083625,Delgado; Tania,10,0,35,25
1656238662603,COGS 107A,A01,083627,Boyle; Mary E. T.,0,0,60,60
1656238668628,COGS 118A,A01,083075,Gupta; Anjum,8,0,76,68
1656238674661,CSE 3,A50,083646,Miranda; Gregory Joseph,18,0,50,32
1656238680686,CSE 8A,A50,083650,Miranda; Gregory Joseph,2,2,56,54
1656238686715,CSE 11,A01,083080,Cao; Yingjun,0,49,40,40
1656238692740,CSE 12,A01,083652,Krause-Levy; Sophia Louisa,5,1,120,115
1656238698771,CSE 15L,A01,083654,Morris; Justin Loren,2,0,50,48
1656238698771,CSE 15L,A02,083655,Morris; Justin Loren,4,0,50,46
1656238704801,CSE 20,A01,083657,Tran; Khoa Dang,30,0,80,50
1656238710827,CSE 21,A01,095574,Bach; Quang Tran,23,0,48,25
1656238716854,CSE 30,A01,083084,Eldon; John,2,6,80,78
1656238716854,CSE 30,B01,095061,Bhaskar; Nishant,0,1,50,50
1656238722886,CSE 100,A01,083659,Cao; Yingjun,1,18,70,69
1656238728912,CSE 134B,A01,083661,Powell; Thomas Allan,5,0,100,95
1656238734941,CSE 140,A01,083663,Gungor; Onat,9,0,85,76
1656238740969,CSE 140L,A01,083088,Eldon; John,8,0,100,92
1656238746995,CSE 175,A01,083665,Kumar; Rakesh,0,0,25,25
1656238753019,CSE 190,A00,092507,Dubnov; Shlomo,3,0,20,17
1656238759045,ECE 45,A01,083139,Congero; Spencer William,1,0,75,74
1656238765079,ECE 65,A50,083695,Saad; Andrew S,9,0,30,21
1656238765079,ECE 65,A51,095125,Staff,24,0,26,2
1656238771109,ECE 109,A01,091882,Touri; Behrouz,0,1,70,70
1656238777148,ECE 180,A00,083140,Abi Samra; Nicholas Camill,1,0,30,29
1656238777148,ECE 180,B00,083141,Abi Samra; Nicholas Camill,0,4,30,30
1656238783184,MATH 10A,A01,083735,Patchell; Gregory David,0,0,30,30
1656238783184,MATH 10A,A02,083736,Patchell; Gregory David,22,0,30,8
1656238783184,MATH 10A,A03,083737,Patchell; Gregory David,16,0,30,14
1656238789224,MATH 10B,A01,083207,Lim; Seonhee,0,0,34,34
1656238789224,MATH 10B,A02,083208,Lim; Seonhee,7,0,35,28
1656238789224,MATH 10B,A03,093472,Staff,1,0,34,33
1656238789224,MATH 10B,B01,083739,Sinha; Shubham,11,0,30,19
1656238795255,MATH 18,A01,083743,Cinel; Cameron Alexander,7,0,30,23
1656238795255,MATH 18,A02,083744,Cinel; Cameron Alexander,9,0,30,21
1656238795255,MATH 18,A03,083745,Cinel; Cameron Alexander,5,0,30,25
1656238795255,MATH 18,B01,083748,Rideout; David Porter,1,0,36,35
1656238795255,MATH 18,B02,083749,Rideout; David Porter,0,0,36,36
1656238795255,MATH 18,B03,083750,Rideout; David Porter,0,0,36,36
1656238795255,MATH 18,B04,083751,Rideout; David Porter,0,1,36,36
1656238795255,MATH 18,B05,093473,Rideout; David Porter,0,0,36,36
1656238795255,MATH 18,B06,093474,Rideout; David Porter,3,0,36,33
1656238801279,MATH 20A,A01,083754,Zheng; Zequn,11,0,40,29
1656238807304,MATH 20B,A01,083756,Briones; Jor-el Thomas Caparas,0,0,36,36
1656238807304,MATH 20B,A02,083757,Briones; Jor-el Thomas Caparas,0,0,36,36
1656238807304,MATH 20B,A03,093475,Staff,0,0,36,36
1656238813327,MATH 20C,A01,083760,Briones; Jor-el Thomas Caparas,0,0,35,35
1656238813327,MATH 20C,A02,083761,Briones; Jor-el Thomas Caparas,9,1,35,26
1656238813327,MATH 20C,A03,093476,Staff,0,0,35,35
1656238813327,MATH 20C,B01,083762,Bach; Quang Tran,1,0,30,29
1656238819355,MATH 20D,A01,083765,Tran; Brian Kha,1,0,30,29
1656238819355,MATH 20D,A02,083766,Tran; Brian Kha,0,1,30,30
1656238819355,MATH 20D,A03,083767,Tran; Brian Kha,2,0,30,28
1656238825380,MATH 20E,A01,083771,Ganguly; Soumya,3,0,32,29
1656238825380,MATH 20E,A02,083772,Ganguly; Soumya,0,0,32,32
1656238825380,MATH 20E,B01,083773,Ciotti; Benjamin,16,0,35,19
1656238825380,MATH 20E,B02,083774,Ciotti; Benjamin,15,0,35,20
1656238831419,MATH 103A,A01,083777,Greenfeld; Be'Eri,1,0,36,35
1656238831419,MATH 103A,A02,083778,Greenfeld; Be'Eri,1,0,36,35
1656238831419,MATH 103A,A03,093561,Staff,5,0,36,31
1656238831419,MATH 103A,B01,083779,Greenfeld; Be'Eri,8,0,36,28
1656238831419,MATH 103A,B02,083780,Greenfeld; Be'Eri,1,0,36,35
1656238831419,MATH 103A,B03,093562,Staff,0,0,36,36
1656238837443,MATH 105,A01,085443,Carter; Anne Toulson,5,0,35,30
1656238837443,MATH 105,A02,093477,Staff,14,0,35,21
1656238843556,MATH 109,A01,083213,Ganzberger; Geoffrey Michael,0,0,34,34
1656238843556,MATH 109,A02,083214,Ganzberger; Geoffrey Michael,0,0,34,34
1656238843556,MATH 109,A03,093478,Staff,1,0,34,33
1656238843556,MATH 109,B01,083215,Ganzberger; Geoffrey Michael,4,0,32,28
1656238843556,MATH 109,B02,083216,Ganzberger; Geoffrey Michael,1,0,32,31
1656238843556,MATH 109,B03,093479,Staff,3,0,32,29
1656238849586,MATH 142A,A01,083219,Chow; Bennett,2,0,32,30
1656238849586,MATH 142A,A02,083220,Chow; Bennett,8,0,32,24
1656238849586,MATH 142A,A03,093480,Staff,5,0,32,27
1656238849586,MATH 142A,B03,093481,Staff,3,0,32,29
1656238849586,MATH 142A,B04,093558,Staff,6,0,32,26
1656238849586,MATH 142A,B05,093559,Staff,0,0,32,32
1656238855612,MATH 193A,A01,083224,Rotar; Vladimir,0,1,34,34
1656238855612,MATH 193A,A02,083225,Rotar; Vladimir,0,0,34,34
1656238855612,MATH 193A,A03,083781,Rotar; Vladimir,0,0,34,34
1656238855612,MATH 193A,A04,083782,Rotar; Vladimir,6,0,34,28
1656238855612,MATH 193A,A05,093482,Rotar; Vladimir,0,0,34,34
1656238861639,MATH 197,001,091859,McAuley; Julian John,9999,0,9999,0
1656238861639,MATH 197,002,095566,Kedlaya; Kiran S.,9997,0,9999,2
1656238861639,MATH 197,003,095567,Xiao; Ming,9999,0,9999,0
1656238861639,MATH 197,004,095571,Perols; Johan Lars,9998,0,9999,1
1656238868708,COGS 9,A01,083615,Shannon; Kyle Michael,3,0,75,72
1656238874734,COGS 11,A01,083617,Boyle; Mary E. T.,14,0,48,34
1656238880760,COGS 13,A01,083071,Bastos; Amalia Pinkusfeld,4,0,71,67
1656238886792,COGS 14A,A01,092681,Semenuks; Arturs,1,12,100,99
1656238892817,COGS 14B,A01,083073,Cheng; Tzu-Han,7,0,63,56
1656238898842,COGS 17,A01,092677,Semenuks; Arturs,7,0,81,74
1656238904867,COGS 100,A01,083619,Allen; Michael Gordon,2,0,70,68
1656238910894,COGS 101A,A01,083621,Davis; Joshua Daniel,4,0,68,64
1656238916923,COGS 101B,A01,091572,Allen; Michael Gordon,4,0,65,61
1656238922949,COGS 101C,A01,083625,Delgado; Tania,10,0,35,25
1656238928974,COGS 107A,A01,083627,Boyle; Mary E. T.,0,0,60,60
1656238935000,COGS 118A,A01,083075,Gupta; Anjum,8,0,76,68
1656238941038,CSE 3,A50,083646,Miranda; Gregory Joseph,18,0,50,32
1656238947066,CSE 8A,A50,083650,Miranda; Gregory Joseph,2,2,56,54
1656238953091,CSE 11,A01,083080,Cao; Yingjun,0,49,40,40
1656238959129,CSE 12,A01,083652,Krause-Levy; Sophia Louisa,5,1,120,115
1656238965159,CSE 15L,A01,083654,Morris; Justin Loren,2,0,50,48
1656238965159,CSE 15L,A02,083655,Morris; Justin Loren,4,0,50,46
1656238971184,CSE 20,A01,083657,Tran; Khoa Dang,30,0,80,50
1656238977215,CSE 21,A01,095574,Bach; Quang Tran,23,0,48,25
1656238983252,CSE 30,A01,083084,Eldon; John,2,6,80,78
1656238983252,CSE 30,B01,095061,Bhaskar; Nishant,0,1,50,50
1656238989288,CSE 100,A01,083659,Cao; Yingjun,1,18,70,69
1656238995310,CSE 134B,A01,083661,Powell; Thomas Allan,5,0,100,95
1656239001334,CSE 140,A01,083663,Gungor; Onat,9,0,85,76
1656239007359,CSE 140L,A01,083088,Eldon; John,8,0,100,92
1656239013384,CSE 175,A01,083665,Kumar; Rakesh,0,0,25,25
1656239019411,CSE 190,A00,092507,Dubnov; Shlomo,3,0,20,17
1656239025448,ECE 45,A01,083139,Congero; Spencer William,1,0,75,74
1656239031475,ECE 65,A50,083695,Saad; Andrew S,9,0,30,21
1656239031475,ECE 65,A51,095125,Staff,24,0,26,2
1656239037500,ECE 109,A01,091882,Touri; Behrouz,0,1,70,70
1656239043525,ECE 180,A00,083140,Abi Samra; Nicholas Camill,1,0,30,29
1656239043525,ECE 180,B00,083141,Abi Samra; Nicholas Camill,0,4,30,30
1656239049554,MATH 10A,A01,083735,Patchell; Gregory David,0,0,30,30
1656239049554,MATH 10A,A02,083736,Patchell; Gregory David,22,0,30,8
1656239049554,MATH 10A,A03,083737,Patchell; Gregory David,16,0,30,14
1656239055582,MATH 10B,A01,083207,Lim; Seonhee,0,0,34,34
1656239055582,MATH 10B,A02,083208,Lim; Seonhee,7,0,35,28
1656239055582,MATH 10B,A03,093472,Staff,1,0,34,33
1656239055582,MATH 10B,B01,083739,Sinha; Shubham,11,0,30,19
1656239061621,MATH 18,A01,083743,Cinel; Cameron Alexander,7,0,30,23
1656239061621,MATH 18,A02,083744,Cinel; Cameron Alexander,9,0,30,21
1656239061621,MATH 18,A03,083745,Cinel; Cameron Alexander,5,0,30,25
1656239061621,MATH 18,B01,083748,Rideout; David Porter,1,0,36,35
1656239061621,MATH 18,B02,083749,Rideout; David Porter,0,0,36,36
1656239061621,MATH 18,B03,083750,Rideout; David Porter,0,0,36,36
1656239061621,MATH 18,B04,083751,Rideout; David Porter,0,1,36,36
1656239061621,MATH 18,B05,093473,Rideout; David Porter,0,0,36,36
1656239061621,MATH 18,B06,093474,Rideout; David Porter,3,0,36,33
1656239067645,MATH 20A,A01,083754,Zheng; Zequn,11,0,40,29
1656239073676,MATH 20B,A01,083756,Briones; Jor-el Thomas Caparas,0,0,36,36
1656239073676,MATH 20B,A02,083757,Briones; Jor-el Thomas Caparas,0,0,36,36
1656239073676,MATH 20B,A03,093475,Staff,0,0,36,36
1656239079702,MATH 20C,A01,083760,Briones; Jor-el Thomas Caparas,0,0,35,35
1656239079702,MATH 20C,A02,083761,Briones; Jor-el Thomas Caparas,9,1,35,26
1656239079702,MATH 20C,A03,093476,Staff,0,0,35,35
1656239079702,MATH 20C,B01,083762,Bach; Quang Tran,1,0,30,29
1656239085732,MATH 20D,A01,083765,Tran; Brian Kha,1,0,30,29
1656239085732,MATH 20D,A02,083766,Tran; Brian Kha,0,1,30,30
1656239085732,MATH 20D,A03,083767,Tran; Brian Kha,2,0,30,28
1656239091764,MATH 20E,A01,083771,Ganguly; Soumya,3,0,32,29
1656239091764,MATH 20E,A02,083772,Ganguly; Soumya,0,0,32,32
1656239091764,MATH 20E,B01,083773,Ciotti; Benjamin,16,0,35,19
1656239091764,MATH 20E,B02,083774,Ciotti; Benjamin,15,0,35,20
1656239097792,MATH 103A,A01,083777,Greenfeld; Be'Eri,1,0,36,35
1656239097792,MATH 103A,A02,083778,Greenfeld; Be'Eri,1,0,36,35
1656239097792,MATH 103A,A03,093561,Staff,5,0,36,31
1656239097792,MATH 103A,B01,083779,Greenfeld; Be'Eri,8,0,36,28
1656239097792,MATH 103A,B02,083780,Greenfeld; Be'Eri,1,0,36,35
1656239097792,MATH 103A,B03,093562,Staff,0,0,36,36
1656239103824,MATH 105,A01,085443,Carter; Anne Toulson,5,0,35,30
1656239103824,MATH 105,A02,093477,Staff,14,0,35,21
1656239109849,MATH 109,A01,083213,Ganzberger; Geoffrey Michael,0,0,34,34
1656239109849,MATH 109,A02,083214,Ganzberger; Geoffrey Michael,0,0,34,34
1656239109849,MATH 109,A03,093478,Staff,1,0,34,33
1656239109849,MATH 109,B01,083215,Ganzberger; Geoffrey Michael,4,0,32,28
1656239109849,MATH 109,B02,083216,Ganzberger; Geoffrey Michael,1,0,32,31
1656239109849,MATH 109,B03,093479,Staff,3,0,32,29
1656239115881,MATH 142A,A01,083219,Chow; Bennett,2,0,32,30
1656239115881,MATH 142A,A02,083220,Chow; Bennett,8,0,32,24
1656239115881,MATH 142A,A03,093480,Staff,5,0,32,27
1656239115881,MATH 142A,B03,093481,Staff,3,0,32,29
1656239115881,MATH 142A,B04,093558,Staff,6,0,32,26
1656239115881,MATH 142A,B05,093559,Staff,0,0,32,32
1656239121907,MATH 193A,A01,083224,Rotar; Vladimir,0,1,34,34
1656239121907,MATH 193A,A02,083225,Rotar; Vladimir,0,0,34,34
1656239121907,MATH 193A,A03,083781,Rotar; Vladimir,0,0,34,34
1656239121907,MATH 193A,A04,083782,Rotar; Vladimir,6,0,34,28
1656239121907,MATH 193A,A05,093482,Rotar; Vladimir,0,0,34,34
1656239127937,MATH 197,001,091859,McAuley; Julian John,9999,0,9999,0
1656239127937,MATH 197,002,095566,Kedlaya; Kiran S.,9997,0,9999,2
1656239127937,MATH 197,003,095567,Xiao; Ming,9999,0,9999,0
1656239127937,MATH 197,004,095571,Perols; Johan Lars,9998,0,9999,1
1656239135002,COGS 9,A01,083615,Shannon; Kyle Michael,3,0,75,72
1656239141027,COGS 11,A01,083617,Boyle; Mary E. T.,14,0,48,34
1656239147058,COGS 13,A01,083071,Bastos; Amalia Pinkusfeld,4,0,71,67
1656239153082,COGS 14A,A01,092681,Semenuks; Arturs,1,12,100,99
1656239159110,COGS 14B,A01,083073,Cheng; Tzu-Han,7,0,63,56
1656239165151,COGS 17,A01,092677,Semenuks; Arturs,7,0,81,74
1656239171177,COGS 100,A01,083619,Allen; Michael Gordon,2,0,70,68
1656239177203,COGS 101A,A01,083621,Davis; Joshua Daniel,4,0,68,64
1656239183227,COGS 101B,A01,091572,Allen; Michael Gordon,4,0,65,61
1656239189259,COGS 101C,A01,083625,Delgado; Tania,10,0,35,25
1656239195284,COGS 107A,A01,083627,Boyle; Mary E. T.,0,0,60,60
1656239201308,COGS 118A,A01,083075,Gupta; Anjum,8,0,76,68
1656239207340,CSE 3,A50,083646,Miranda; Gregory Joseph,18,0,50,32
1656239213365,CSE 8A,A50,083650,Miranda; Gregory Joseph,2,2,56,54
1656239219394,CSE 11,A01,083080,Cao; Yingjun,0,49,40,40
1656239225424,CSE 12,A01,083652,Krause-Levy; Sophia Louisa,5,1,120,115
1656239231449,CSE 15L,A01,083654,Morris; Justin Loren,2,0,50,48
1656239231449,CSE 15L,A02,083655,Morris; Justin Loren,4,0,50,46
1656239237480,CSE 20,A01,083657,Tran; Khoa Dang,30,0,80,50
1656239243505,CSE 21,A01,095574,Bach; Quang Tran,23,0,48,25
1656239249534,CSE 30,A01,083084,Eldon; John,2,6,80,78
1656239249534,CSE 30,B01,095061,Bhaskar; Nishant,0,1,50,50
1656239255566,CSE 100,A01,083659,Cao; Yingjun,1,18,70,69
1656239261594,CSE 134B,A01,083661,Powell; Thomas Allan,5,0,100,95
1656239267620,CSE 140,A01,083663,Gungor; Onat,9,0,85,76
1656239273645,CSE 140L,A01,083088,Eldon; John,8,0,100,92
1656239279676,CSE 175,A01,083665,Kumar; Rakesh,0,0,25,25
1656239285699,CSE 190,A00,092507,Dubnov; Shlomo,3,0,20,17
1656239291732,ECE 45,A01,083139,Congero; Spencer William,1,0,75,74
1656239297757,ECE 65,A50,083695,Saad; Andrew S,9,0,30,21
1656239297757,ECE 65,A51,095125,Staff,24,0,26,2
1656239303787,ECE 109,A01,091882,Touri; Behrouz,0,1,70,70
1656239309818,ECE 180,A00,083140,Abi Samra; Nicholas Camill,1,0,30,29
1656239309818,ECE 180,B00,083141,Abi Samra; Nicholas Camill,0,4,30,30
1656239315852,MATH 10A,A01,083735,Patchell; Gregory David,0,0,30,30
1656239315852,MATH 10A,A02,083736,Patchell; Gregory David,22,0,30,8
1656239315852,MATH 10A,A03,083737,Patchell; Gregory David,16,0,30,14
1656239321884,MATH 10B,A01,083207,Lim; Seonhee,0,0,34,34
1656239321884,MATH 10B,A02,083208,Lim; Seonhee,7,0,35,28
1656239321884,MATH 10B,A03,093472,Staff,1,0,34,33
1656239321884,MATH 10B,B01,083739,Sinha; Shubham,11,0,30,19
1656239327911,MATH 18,A01,083743,Cinel; Cameron Alexander,7,0,30,23
1656239327911,MATH 18,A02,083744,Cinel; Cameron Alexander,9,0,30,21
1656239327911,MATH 18,A03,083745,Cinel; Cameron Alexander,5,0,30,25
1656239327911,MATH 18,B01,083748,Rideout; David Porter,1,0,36,35
1656239327911,MATH 18,B02,083749,Rideout; David Porter,0,0,36,36
1656239327911,MATH 18,B03,083750,Rideout; David Porter,0,0,36,36
1656239327911,MATH 18,B04,083751,Rideout; David Porter,0,1,36,36
1656239327911,MATH 18,B05,093473,Rideout; David Porter,0,0,36,36
1656239327911,MATH 18,B06,093474,Rideout; David Porter,3,0,36,33
1656239333933,MATH 20A,A01,083754,Zheng; Zequn,11,0,40,29
1656239339959,MATH 20B,A01,083756,Briones; Jor-el Thomas Caparas,0,0,36,36
1656239339959,MATH 20B,A02,083757,Briones; Jor-el Thomas Caparas,0,0,36,36
1656239339959,MATH 20B,A03,093475,Staff,0,0,36,36
1656239345987,MATH 20C,A01,083760,Briones; Jor-el Thomas Caparas,0,0,35,35
1656239345987,MATH 20C,A02,083761,Briones; Jor-el Thomas Caparas,9,1,35,26
1656239345987,MATH 20C,A03,093476,Staff,0,0,35,35
1656239345987,MATH 20C,B01,083762,Bach; Quang Tran,1,0,30,29
1656239352019,MATH 20D,A01,083765,Tran; Brian Kha,1,0,30,29
1656239352019,MATH 20D,A02,083766,Tran; Brian Kha,0,1,30,30
1656239352019,MATH 20D,A03,083767,Tran; Brian Kha,2,0,30,28
1656239358054,MATH 20E,A01,083771,Ganguly; Soumya,3,0,32,29
1656239358054,MATH 20E,A02,083772,Ganguly; Soumya,0,0,32,32
1656239358054,MATH 20E,B01,083773,Ciotti; Benjamin,16,0,35,19
1656239358054,MATH 20E,B02,083774,Ciotti; Benjamin,15,0,35,20
1656239364088,MATH 103A,A01,083777,Greenfeld; Be'Eri,1,0,36,35
1656239364088,MATH 103A,A02,083778,Greenfeld; Be'Eri,1,0,36,35
1656239364088,MATH 103A,A03,093561,Staff,5,0,36,31
1656239364088,MATH 103A,B01,083779,Greenfeld; Be'Eri,8,0,36,28
1656239364088,MATH 103A,B02,083780,Greenfeld; Be'Eri,1,0,36,35
1656239364088,MATH 103A,B03,093562,Staff,0,0,36,36
1656239370113,MATH 105,A01,085443,Carter; Anne Toulson,5,0,35,30
1656239370113,MATH 105,A02,093477,Staff,14,0,35,21
1656239376139,MATH 109,A01,083213,Ganzberger; Geoffrey Michael,0,0,34,34
1656239376139,MATH 109,A02,083214,Ganzberger; Geoffrey Michael,0,0,34,34
1656239376139,MATH 109,A03,093478,Staff,1,0,34,33
1656239376139,MATH 109,B01,083215,Ganzberger; Geoffrey Michael,4,0,32,28
1656239376139,MATH 109,B02,083216,Ganzberger; Geoffrey Michael,1,0,32,31
1656239376139,MATH 109,B03,093479,Staff,3,0,32,29
1656239382168,MATH 142A,A01,083219,Chow; Bennett,2,0,32,30
1656239382168,MATH 142A,A02,083220,Chow; Bennett,8,0,32,24
1656239382168,MATH 142A,A03,093480,Staff,5,0,32,27
1656239382168,MATH 142A,B03,093481,Staff,3,0,32,29
1656239382168,MATH 142A,B04,093558,Staff,6,0,32,26
1656239382168,MATH 142A,B05,093559,Staff,0,0,32,32
1656239388194,MATH 193A,A01,083224,Rotar; Vladimir,0,1,34,34
1656239388194,MATH 193A,A02,083225,Rotar; Vladimir,0,0,34,34
1656239388194,MATH 193A,A03,083781,Rotar; Vladimir,0,0,34,34
1656239388194,MATH 193A,A04,083782,Rotar; Vladimir,6,0,34,28
1656239388194,MATH 193A,A05,093482,Rotar; Vladimir,0,0,34,34
1656239394219,MATH 197,001,091859,McAuley; Julian John,9999,0,9999,0
1656239394219,MATH 197,002,095566,Kedlaya; Kiran S.,9997,0,9999,2
1656239394219,MATH 197,003,095567,Xiao; Ming,9999,0,9999,0
1656239394219,MATH 197,004,095571,Perols; Johan Lars,9998,0,9999,1
1656239401302,COGS 9,A01,083615,Shannon; Kyle Michael,3,0,75,72
1656239407329,COGS 11,A01,083617,Boyle; Mary E. T.,14,0,48,34
1656239413360,COGS 13,A01,083071,Bastos; Amalia Pinkusfeld,4,0,71,67
1656239419397,COGS 14A,A01,092681,Semenuks; Arturs,1,12,100,99
1656239425422,COGS 14B,A01,083073,Cheng; Tzu-Han,7,0,63,56
1656239431445,COGS 17,A01,092677,Semenuks; Arturs,7,0,81,74
1656239437558,COGS 100,A01,083619,Allen; Michael Gordon,2,0,70,68
1656239443589,COGS 101A,A01,083621,Davis; Joshua Daniel,4,0,68,64
1656239449619,COGS 101B,A01,091572,Allen; Michael Gordon,4,0,65,61
1656239455644,COGS 101C,A01,083625,Delgado; Tania,10,0,35,25
1656239461669,COGS 107A,A01,083627,Boyle; Mary E. T.,0,0,60,60
1656239467692,COGS 118A,A01,083075,Gupta; Anjum,8,0,76,68
1656239473721,CSE 3,A50,083646,Miranda; Gregory Joseph,18,0,50,32
1656239479746,CSE 8A,A50,083650,Miranda; Gregory Joseph,2,2,56,54
1656239485778,CSE 11,A01,083080,Cao; Yingjun,0,49,40,40
1656239491802,CSE 12,A01,083652,Krause-Levy; Sophia Louisa,5,1,120,115
1656239497830,CSE 15L,A01,083654,Morris; Justin Loren,2,0,50,48
1656239497830,CSE 15L,A02,083655,Morris; Justin Loren,4,0,50,46
1656239503854,CSE 20,A01,083657,Tran; Khoa Dang,30,0,80,50
1656239509884,CSE 21,A01,095574,Bach; Quang Tran,23,0,48,25
1656239515911,CSE 30,A01,083084,Eldon; John,2,6,80,78
1656239515911,CSE 30,B01,095061,Bhaskar; Nishant,0,1,50,50
1656239521938,CSE 100,A01,083659,Cao; Yingjun,1,18,70,69
1656239527962,CSE 134B,A01,083661,Powell; Thomas Allan,5,0,100,95
1656239533988,CSE 140,A01,083663,Gungor; Onat,9,0,85,76
1656239540013,CSE 140L,A01,083088,Eldon; John,8,0,100,92
1656239546039,CSE 175,A01,083665,Kumar; Rakesh,0,0,25,25
1656239552071,CSE 190,A00,092507,Dubnov; Shlomo,3,0,20,17
1656239558104,ECE 45,A01,083139,Congero; Spencer William,1,0,75,74
1656239564130,ECE 65,A50,083695,Saad; Andrew S,9,0,30,21
1656239564130,ECE 65,A51,095125,Staff,24,0,26,2
1656239570155,ECE 109,A01,091882,Touri; Behrouz,0,1,70,70
1656239576178,ECE 180,A00,083140,Abi Samra; Nicholas Camill,1,0,30,29
1656239576178,ECE 180,B00,083141,Abi Samra; Nicholas Camill,0,4,30,30
1656239582227,MATH 10A,A01,083735,Patchell; Gregory David,0,0,30,30
1656239582227,MATH 10A,A02,083736,Patchell; Gregory David,22,0,30,8
1656239582227,MATH 10A,A03,083737,Patchell; Gregory David,16,0,30,14
1656239588265,MATH 10B,A01,083207,Lim; Seonhee,0,0,34,34
1656239588265,MATH 10B,A02,083208,Lim; Seonhee,7,0,35,28
1656239588265,MATH 10B,A03,093472,Staff,1,0,34,33
1656239588265,MATH 10B,B01,083739,Sinha; Shubham,11,0,30,19
1656239594295,MATH 18,A01,083743,Cinel; Cameron Alexander,7,0,30,23
1656239594295,MATH 18,A02,083744,Cinel; Cameron Alexander,9,0,30,21
1656239594295,MATH 18,A03,083745,Cinel; Cameron Alexander,5,0,30,25
1656239594295,MATH 18,B01,083748,Rideout; David Porter,1,0,36,35
1656239594295,MATH 18,B02,083749,Rideout; David Porter,0,0,36,36
1656239594295,MATH 18,B03,083750,Rideout; David Porter,0,0,36,36
1656239594295,MATH 18,B04,083751,Rideout; David Porter,0,1,36,36
1656239594295,MATH 18,B05,093473,Rideout; David Porter,0,0,36,36
1656239594295,MATH 18,B06,093474,Rideout; David Porter,3,0,36,33
1656239600320,MATH 20A,A01,083754,Zheng; Zequn,11,0,40,29
1656239606347,MATH 20B,A01,083756,Briones; Jor-el Thomas Caparas,0,0,36,36
1656239606347,MATH 20B,A02,083757,Briones; Jor-el Thomas Caparas,0,0,36,36
1656239606347,MATH 20B,A03,093475,Staff,0,0,36,36
1656239612374,MATH 20C,A01,083760,Briones; Jor-el Thomas Caparas,0,0,35,35
1656239612374,MATH 20C,A02,083761,Briones; Jor-el Thomas Caparas,9,1,35,26
1656239612374,MATH 20C,A03,093476,Staff,0,0,35,35
1656239612374,MATH 20C,B01,083762,Bach; Quang Tran,1,0,30,29
1656239618400,MATH 20D,A01,083765,Tran; Brian Kha,1,0,30,29
1656239618400,MATH 20D,A02,083766,Tran; Brian Kha,0,1,30,30
1656239618400,MATH 20D,A03,083767,Tran; Brian Kha,2,0,30,28
1656239624438,MATH 20E,A01,083771,Ganguly; Soumya,3,0,32,29
1656239624438,MATH 20E,A02,083772,Ganguly; Soumya,0,0,32,32
1656239624438,MATH 20E,B01,083773,Ciotti; Benjamin,16,0,35,19
1656239624438,MATH 20E,B02,083774,Ciotti; Benjamin,15,0,35,20
1656239630465,MATH 103A,A01,083777,Greenfeld; Be'Eri,1,0,36,35
1656239630465,MATH 103A,A02,083778,Greenfeld; Be'Eri,1,0,36,35
1656239630465,MATH 103A,A03,093561,Staff,5,0,36,31
1656239630465,MATH 103A,B01,083779,Greenfeld; Be'Eri,8,0,36,28
1656239630465,MATH 103A,B02,083780,Greenfeld; Be'Eri,1,0,36,35
1656239630465,MATH 103A,B03,093562,Staff,0,0,36,36
1656239636500,MATH 105,A01,085443,Carter; Anne Toulson,5,0,35,30
1656239636500,MATH 105,A02,093477,Staff,14,0,35,21
1656239642528,MATH 109,A01,083213,Ganzberger; Geoffrey Michael,0,0,34,34
1656239642528,MATH 109,A02,083214,Ganzberger; Geoffrey Michael,0,0,34,34
1656239642528,MATH 109,A03,093478,Staff,1,0,34,33
1656239642528,MATH 109,B01,083215,Ganzberger; Geoffrey Michael,4,0,32,28
1656239642528,MATH 109,B02,083216,Ganzberger; Geoffrey Michael,1,0,32,31
1656239642528,MATH 109,B03,093479,Staff,3,0,32,29
1656239648585,MATH 142A,A01,083219,Chow; Bennett,2,0,32,30
1656239648585,MATH 142A,A02,083220,Chow; Bennett,8,0,32,24
1656239648585,MATH 142A,A03,093480,Staff,5,0,32,27
1656239648585,MATH 142A,B03,093481,Staff,3,0,32,29
1656239648585,MATH 142A,B04,093558,Staff,6,0,32,26
1656239648585,MATH 142A,B05,093559,Staff,0,0,32,32
1656239654612,MATH 193A,A01,083224,Rotar; Vladimir,0,1,34,34
1656239654612,MATH 193A,A02,083225,Rotar; Vladimir,0,0,34,34
1656239654612,MATH 193A,A03,083781,Rotar; Vladimir,0,0,34,34
1656239654612,MATH 193A,A04,083782,Rotar; Vladimir,6,0,34,28
1656239654612,MATH 193A,A05,093482,Rotar; Vladimir,0,0,34,34
1656239660640,MATH 197,001,091859,McAuley; Julian John,9999,0,9999,0
1656239660640,MATH 197,002,095566,Kedlaya; Kiran S.,9997,0,9999,2
1656239660640,MATH 197,003,095567,Xiao; Ming,9999,0,9999,0
1656239660640,MATH 197,004,095571,Perols; Johan Lars,9998,0,9999,1
1656239667713,COGS 9,A01,083615,Shannon; Kyle Michael,3,0,75,72
1656239673737,COGS 11,A01,083617,Boyle; Mary E. T.,14,0,48,34
1656239679763,COGS 13,A01,083071,Bastos; Amalia Pinkusfeld,4,0,71,67
1656239685789,COGS 14A,A01,092681,Semenuks; Arturs,1,12,100,99
1656239691819,COGS 14B,A01,083073,Cheng; Tzu-Han,7,0,63,56
1656239697848,COGS 17,A01,092677,Semenuks; Arturs,7,0,81,74
1656239703874,COGS 100,A01,083619,Allen; Michael Gordon,2,0,70,68
1656239709899,COGS 101A,A01,083621,Davis; Joshua Daniel,4,0,68,64
1656239715929,COGS 101B,A01,091572,Allen; Michael Gordon,4,0,65,61
1656239721956,COGS 101C,A01,083625,Delgado; Tania,10,0,35,25
1656239727984,COGS 107A,A01,083627,Boyle; Mary E. T.,0,0,60,60
1656239734010,COGS 118A,A01,083075,Gupta; Anjum,8,0,76,68
1656239740045,CSE 3,A50,083646,Miranda; Gregory Joseph,18,0,50,32
1656239746070,CSE 8A,A50,083650,Miranda; Gregory Joseph,2,2,56,54
1656239752098,CSE 11,A01,083080,Cao; Yingjun,0,49,40,40
1656239758136,CSE 12,A01,083652,Krause-Levy; Sophia Louisa,5,1,120,115
1656239764165,CSE 15L,A01,083654,Morris; Justin Loren,2,0,50,48
1656239764165,CSE 15L,A02,083655,Morris; Justin Loren,4,0,50,46
1656239770192,CSE 20,A01,083657,Tran; Khoa Dang,30,0,80,50
1656239776224,CSE 21,A01,095574,Bach; Quang Tran,23,0,48,25
1656239782250,CSE 30,A01,083084,Eldon; John,2,6,80,78
1656239782250,CSE 30,B01,095061,Bhaskar; Nishant,0,1,50,50
1656239788274,CSE 100,A01,083659,Cao; Yingjun,1,18,70,69
1656239794298,CSE 134B,A01,083661,Powell; Thomas Allan,5,0,100,95
1656239800323,CSE 140,A01,083663,Gungor; Onat,9,0,85,76
1656239806346,CSE 140L,A01,083088,Eldon; John,8,0,100,92
1656239812373,CSE 175,A01,083665,Kumar; Rakesh,0,0,25,25
1656239818400,CSE 190,A00,092507,Dubnov; Shlomo,3,0,20,17
1656239824434,ECE 45,A01,083139,Congero; Spencer William,1,0,75,74
1656239830462,ECE 65,A50,083695,Saad; Andrew S,9,0,30,21
1656239830462,ECE 65,A51,095125,Staff,24,0,26,2
1656239836486,ECE 109,A01,091882,Touri; Behrouz,0,1,70,70
1656239842512,ECE 180,A00,083140,Abi Samra; Nicholas Camill,1,0,30,29
1656239842512,ECE 180,B00,083141,Abi Samra; Nicholas Camill,0,4,30,30
1656239848546,MATH 10A,A01,083735,Patchell; Gregory David,0,0,30,30
1656239848546,MATH 10A,A02,083736,Patchell; Gregory David,22,0,30,8
1656239848546,MATH 10A,A03,083737,Patchell; Gregory David,16,0,30,14
1656239854586,MATH 10B,A01,083207,Lim; Seonhee,0,0,34,34
1656239854586,MATH 10B,A02,083208,Lim; Seonhee,7,0,35,28
1656239854586,MATH 10B,A03,093472,Staff,1,0,34,33
1656239854586,MATH 10B,B01,083739,Sinha; Shubham,11,0,30,19
1656239860615,MATH 18,A01,083743,Cinel; Cameron Alexander,7,0,30,23
1656239860615,MATH 18,A02,083744,Cinel; Cameron Alexander,9,0,30,21
1656239860615,MATH 18,A03,083745,Cinel; Cameron Alexander,5,0,30,25
1656239860615,MATH 18,B01,083748,Rideout; David Porter,1,0,36,35
1656239860615,MATH 18,B02,083749,Rideout; David Porter,0,0,36,36
1656239860615,MATH 18,B03,083750,Rideout; David Porter,0,0,36,36
1656239860615,MATH 18,B04,083751,Rideout; David Porter,0,1,36,36
1656239860615,MATH 18,B05,093473,Rideout; David Porter,0,0,36,36
1656239860615,MATH 18,B06,093474,Rideout; David Porter,3,0,36,33
1656239866641,MATH 20A,A01,083754,Zheng; Zequn,11,0,40,29
1656239872677,MATH 20B,A01,083756,Briones; Jor-el Thomas Caparas,0,0,36,36
1656239872677,MATH 20B,A02,083757,Briones; Jor-el Thomas Caparas,0,0,36,36
1656239872677,MATH 20B,A03,093475,Staff,0,0,36,36
1656239878713,MATH 20C,A01,083760,Briones; Jor-el Thomas Caparas,0,0,35,35
1656239878713,MATH 20C,A02,083761,Briones; Jor-el Thomas Caparas,9,1,35,26
1656239878713,MATH 20C,A03,093476,Staff,0,0,35,35
1656239878713,MATH 20C,B01,083762,Bach; Quang Tran,1,0,30,29
1656239884747,MATH 20D,A01,083765,Tran; Brian Kha,1,0,30,29
1656239884747,MATH 20D,A02,083766,Tran; Brian Kha,0,1,30,30
1656239884747,MATH 20D,A03,083767,Tran; Brian Kha,2,0,30,28
1656239890781,MATH 20E,A01,083771,Ganguly; Soumya,3,0,32,29
1656239890781,MATH 20E,A02,083772,Ganguly; Soumya,0,0,32,32
1656239890781,MATH 20E,B01,083773,Ciotti; Benjamin,16,0,35,19
1656239890781,MATH 20E,B02,083774,Ciotti; Benjamin,15,0,35,20
1656239896822,MATH 103A,A01,083777,Greenfeld; Be'Eri,1,0,36,35
1656239896822,MATH 103A,A02,083778,Greenfeld; Be'Eri,1,0,36,35
1656239896822,MATH 103A,A03,093561,Staff,5,0,36,31
1656239896822,MATH 103A,B01,083779,Greenfeld; Be'Eri,8,0,36,28
1656239896822,MATH 103A,B02,083780,Greenfeld; Be'Eri,1,0,36,35
1656239896822,MATH 103A,B03,093562,Staff,0,0,36,36
1656239902847,MATH 105,A01,085443,Carter; Anne Toulson,5,0,35,30
1656239902847,MATH 105,A02,093477,Staff,14,0,35,21
1656239908883,MATH 109,A01,083213,Ganzberger; Geoffrey Michael,0,0,34,34
1656239908883,MATH 109,A02,083214,Ganzberger; Geoffrey Michael,0,0,34,34
1656239908883,MATH 109,A03,093478,Staff,1,0,34,33
1656239908883,MATH 109,B01,083215,Ganzberger; Geoffrey Michael,4,0,32,28
1656239908883,MATH 109,B02,083216,Ganzberger; Geoffrey Michael,1,0,32,31
1656239908883,MATH 109,B03,093479,Staff,3,0,32,29
1656239914911,MATH 142A,A01,083219,Chow; Bennett,2,0,32,30
1656239914911,MATH 142A,A02,083220,Chow; Bennett,8,0,32,24
1656239914911,MATH 142A,A03,093480,Staff,5,0,32,27
1656239914911,MATH 142A,B03,093481,Staff,3,0,32,29
1656239914911,MATH 142A,B04,093558,Staff,6,0,32,26
1656239914911,MATH 142A,B05,093559,Staff,0,0,32,32
1656239920937,MATH 193A,A01,083224,Rotar; Vladimir,0,1,34,34
1656239920937,MATH 193A,A02,083225,Rotar; Vladimir,0,0,34,34
1656239920937,MATH 193A,A03,083781,Rotar; Vladimir,0,0,34,34
1656239920937,MATH 193A,A04,083782,Rotar; Vladimir,6,0,34,28
1656239920937,MATH 193A,A05,093482,Rotar; Vladimir,0,0,34,34
1656239926960,MATH 197,001,091859,McAuley; Julian John,9999,0,9999,0
1656239926960,MATH 197,002,095566,Kedlaya; Kiran S.,9997,0,9999,2
1656239926960,MATH 197,003,095567,Xiao; Ming,9999,0,9999,0
1656239926960,MATH 197,004,095571,Perols; Johan Lars,9998,0,9999,1
1656239934045,COGS 9,A01,083615,Shannon; Kyle Michael,3,0,75,72
1656239940078,COGS 11,A01,083617,Boyle; Mary E. T.,14,0,48,34
1656239946104,COGS 13,A01,083071,Bastos; Amalia Pinkusfeld,4,0,71,67
1656239952142,COGS 14A,A01,092681,Semenuks; Arturs,1,12,100,99
1656239958180,COGS 14B,A01,083073,Cheng; Tzu-Han,7,0,63,56
1656239964204,COGS 17,A01,092677,Semenuks; Arturs,7,0,81,74
1656239970231,COGS 100,A01,083619,Allen; Michael Gordon,2,0,70,68
1656239976263,COGS 101A,A01,083621,Davis; Joshua Daniel,4,0,68,64
1656239982294,COGS 101B,A01,091572,Allen; Michael Gordon,4,0,65,61
1656239988330,COGS 101C,A01,083625,Delgado; Tania,10,0,35,25
1656239994356,COGS 107A,A01,083627,Boyle; Mary E. T.,0,0,60,60
1656240000379,COGS 118A,A01,083075,Gupta; Anjum,8,0,76,68
1656240006418,CSE 3,A50,083646,Miranda; Gregory Joseph,18,0,50,32
1656240012457,CSE 8A,A50,083650,Miranda; Gregory Joseph,2,2,56,54
1656240018483,CSE 11,A01,083080,Cao; Yingjun,0,49,40,40
1656240024524,CSE 12,A01,083652,Krause-Levy; Sophia Louisa,5,1,120,115
1656240030551,CSE 15L,A01,083654,Morris; Justin Loren,2,0,50,48
1656240030551,CSE 15L,A02,083655,Morris; Justin Loren,4,0,50,46
1656240036657,CSE 20,A01,083657,Tran; Khoa Dang,30,0,80,50
1656240042688,CSE 21,A01,095574,Bach; Quang Tran,23,0,48,25
1656240048742,CSE 30,A01,083084,Eldon; John,2,6,80,78
1656240048742,CSE 30,B01,095061,Bhaskar; Nishant,0,1,50,50
1656240054773,CSE 100,A01,083659,Cao; Yingjun,1,18,70,69
1656240060799,CSE 134B,A01,083661,Powell; Thomas Allan,5,0,100,95
1656240066825,CSE 140,A01,083663,Gungor; Onat,9,0,85,76
1656240072856,CSE 140L,A01,083088,Eldon; John,8,0,100,92
1656240078880,CSE 175,A01,083665,Kumar; Rakesh,0,0,25,25
1656240084911,CSE 190,A00,092507,Dubnov; Shlomo,3,0,20,17
1656240090937,ECE 45,A01,083139,Congero; Spencer William,1,0,75,74
1656240096973,ECE 65,A50,083695,Saad; Andrew S,9,0,30,21
1656240096973,ECE 65,A51,095125,Staff,24,0,26,2
1656240103006,ECE 109,A01,091882,Touri; Behrouz,0,1,70,70
1656240109039,ECE 180,A00,083140,Abi Samra; Nicholas Camill,1,0,30,29
1656240109039,ECE 180,B00,083141,Abi Samra; Nicholas Camill,0,4,30,30
1656240115073,MATH 10A,A01,083735,Patchell; Gregory David,0,0,30,30
1656240115073,MATH 10A,A02,083736,Patchell; Gregory David,22,0,30,8
1656240115073,MATH 10A,A03,083737,Patchell; Gregory David,16,0,30,14
1656240121103,MATH 10B,A01,083207,Lim; Seonhee,0,0,34,34
1656240121103,MATH 10B,A02,083208,Lim; Seonhee,7,0,35,28
1656240121103,MATH 10B,A03,093472,Staff,1,0,34,33
1656240121103,MATH 10B,B01,083739,Sinha; Shubham,11,0,30,19
1656240127151,MATH 18,A01,083743,Cinel; Cameron Alexander,7,0,30,23
1656240127151,MATH 18,A02,083744,Cinel; Cameron Alexander,9,0,30,21
1656240127151,MATH 18,A03,083745,Cinel; Cameron Alexander,5,0,30,25
1656240127151,MATH 18,B01,083748,Rideout; David Porter,1,0,36,35
1656240127151,MATH 18,B02,083749,Rideout; David Porter,0,0,36,36
1656240127151,MATH 18,B03,083750,Rideout; David Porter,0,0,36,36
1656240127151,MATH 18,B04,083751,Rideout; David Porter,0,1,36,36
1656240127151,MATH 18,B05,093473,Rideout; David Porter,0,0,36,36
1656240127151,MATH 18,B06,093474,Rideout; David Porter,3,0,36,33
1656240133176,MATH 20A,A01,083754,Zheng; Zequn,11,0,40,29
1656240139204,MATH 20B,A01,083756,Briones; Jor-el Thomas Caparas,0,0,36,36
1656240139204,MATH 20B,A02,083757,Briones; Jor-el Thomas Caparas,0,0,36,36
1656240139204,MATH 20B,A03,093475,Staff,0,0,36,36
1656240145237,MATH 20C,A01,083760,Briones; Jor-el Thomas Caparas,0,0,35,35
1656240145237,MATH 20C,A02,083761,Briones; Jor-el Thomas Caparas,9,1,35,26
1656240145237,MATH 20C,A03,093476,Staff,0,0,35,35
1656240145237,MATH 20C,B01,083762,Bach; Quang Tran,1,0,30,29
1656240151264,MATH 20D,A01,083765,Tran; Brian Kha,1,0,30,29
1656240151264,MATH 20D,A02,083766,Tran; Brian Kha,0,1,30,30
1656240151264,MATH 20D,A03,083767,Tran; Brian Kha,2,0,30,28
1656240157291,MATH 20E,A01,083771,Ganguly; Soumya,3,0,32,29
1656240157291,MATH 20E,A02,083772,Ganguly; Soumya,0,0,32,32
1656240157291,MATH 20E,B01,083773,Ciotti; Benjamin,16,0,35,19
1656240157291,MATH 20E,B02,083774,Ciotti; Benjamin,15,0,35,20
1656240163324,MATH 103A,A01,083777,Greenfeld; Be'Eri,1,0,36,35
1656240163324,MATH 103A,A02,083778,Greenfeld; Be'Eri,1,0,36,35
1656240163324,MATH 103A,A03,093561,Staff,5,0,36,31
1656240163324,MATH 103A,B01,083779,Greenfeld; Be'Eri,8,0,36,28
1656240163324,MATH 103A,B02,083780,Greenfeld; Be'Eri,1,0,36,35
1656240163324,MATH 103A,B03,093562,Staff,0,0,36,36
1656240169349,MATH 105,A01,085443,Carter; Anne Toulson,5,0,35,30
1656240169349,MATH 105,A02,093477,Staff,14,0,35,21
1656240175377,MATH 109,A01,083213,Ganzberger; Geoffrey Michael,0,0,34,34
1656240175377,MATH 109,A02,083214,Ganzberger; Geoffrey Michael,0,0,34,34
1656240175377,MATH 109,A03,093478,Staff,1,0,34,33
1656240175377,MATH 109,B01,083215,Ganzberger; Geoffrey Michael,4,0,32,28
1656240175377,MATH 109,B02,083216,Ganzberger; Geoffrey Michael,1,0,32,31
1656240175377,MATH 109,B03,093479,Staff,3,0,32,29
1656240181404,MATH 142A,A01,083219,Chow; Bennett,2,0,32,30
1656240181404,MATH 142A,A02,083220,Chow; Bennett,8,0,32,24
1656240181404,MATH 142A,A03,093480,Staff,5,0,32,27
1656240181404,MATH 142A,B03,093481,Staff,3,0,32,29
1656240181404,MATH 142A,B04,093558,Staff,6,0,32,26
1656240181404,MATH 142A,B05,093559,Staff,0,0,32,32
1656240187429,MATH 193A,A01,083224,Rotar; Vladimir,0,1,34,34
1656240187429,MATH 193A,A02,083225,Rotar; Vladimir,0,0,34,34
1656240187429,MATH 193A,A03,083781,Rotar; Vladimir,0,0,34,34
1656240187429,MATH 193A,A04,083782,Rotar; Vladimir,6,0,34,28
1656240187429,MATH 193A,A05,093482,Rotar; Vladimir,0,0,34,34
1656240193455,MATH 197,001,091859,McAuley; Julian John,9999,0,9999,0
1656240193455,MATH 197,002,095566,Kedlaya; Kiran S.,9997,0,9999,2
1656240193455,MATH 197,003,095567,Xiao; Ming,9999,0,9999,0
1656240193455,MATH 197,004,095571,Perols; Johan Lars,9998,0,9999,1
1656240200540,COGS 9,A01,083615,Shannon; Kyle Michael,3,0,75,72
1656240206575,COGS 11,A01,083617,Boyle; Mary E. T.,14,0,48,34
1656240212608,COGS 13,A01,083071,Bastos; Amalia Pinkusfeld,4,0,71,67
1656240218640,COGS 14A,A01,092681,Semenuks; Arturs,1,12,100,99
1656240224666,COGS 14B,A01,083073,Cheng; Tzu-Han,7,0,63,56
1656240230692,COGS 17,A01,092677,Semenuks; Arturs,7,0,81,74
1656240236718,COGS 100,A01,083619,Allen; Michael Gordon,2,0,70,68
1656240242743,COGS 101A,A01,083621,Davis; Joshua Daniel,4,0,68,64
1656240248774,COGS 101B,A01,091572,Allen; Michael Gordon,4,0,65,61
1656240254809,COGS 101C,A01,083625,Delgado; Tania,10,0,35,25
1656240260837,COGS 107A,A01,083627,Boyle; Mary E. T.,0,0,60,60
1656240266863,COGS 118A,A01,083075,Gupta; Anjum,8,0,76,68
1656240272901,CSE 3,A50,083646,Miranda; Gregory Joseph,18,0,50,32
1656240278926,CSE 8A,A50,083650,Miranda; Gregory Joseph,2,2,56,54
1656240284957,CSE 11,A01,083080,Cao; Yingjun,0,49,40,40
1656240290988,CSE 12,A01,083652,Krause-Levy; Sophia Louisa,5,1,120,115
1656240297013,CSE 15L,A01,083654,Morris; Justin Loren,2,0,50,48
1656240297013,CSE 15L,A02,083655,Morris; Justin Loren,4,0,50,46
1656240303036,CSE 20,A01,083657,Tran; Khoa Dang,30,0,80,50
1656240309061,CSE 21,A01,095574,Bach; Quang Tran,23,0,48,25
1656240315097,CSE 30,A01,083084,Eldon; John,2,6,80,78
1656240315097,CSE 30,B01,095061,Bhaskar; Nishant,0,1,50,50
1656240321122,CSE 100,A01,083659,Cao; Yingjun,1,18,70,69
1656240327148,CSE 134B,A01,083661,Powell; Thomas Allan,5,0,100,95
1656240333174,CSE 140,A01,083663,Gungor; Onat,9,0,85,76
1656240339202,CSE 140L,A01,083088,Eldon; John,8,0,100,92
1656240345233,CSE 175,A01,083665,Kumar; Rakesh,0,0,25,25
1656240351264,CSE 190,A00,092507,Dubnov; Shlomo,3,0,20,17
1656240357291,ECE 45,A01,083139,Congero; Spencer William,1,0,75,74
1656240363320,ECE 65,A50,083695,Saad; Andrew S,9,0,30,21
1656240363320,ECE 65,A51,095125,Staff,24,0,26,2
1656240369350,ECE 109,A01,091882,Touri; Behrouz,0,1,70,70
1656240375385,ECE 180,A00,083140,Abi Samra; Nicholas Camill,1,0,30,29
1656240375385,ECE 180,B00,083141,Abi Samra; Nicholas Camill,0,4,30,30
1656240381422,MATH 10A,A01,083735,Patchell; Gregory David,0,0,30,30
1656240381422,MATH 10A,A02,083736,Patchell; Gregory David,22,0,30,8
1656240381422,MATH 10A,A03,083737,Patchell; Gregory David,16,0,30,14
1656240387451,MATH 10B,A01,083207,Lim; Seonhee,0,0,34,34
1656240387451,MATH 10B,A02,083208,Lim; Seonhee,7,0,35,28
1656240387451,MATH 10B,A03,093472,Staff,1,0,34,33
1656240387451,MATH 10B,B01,083739,Sinha; Shubham,11,0,30,19
1656240393480,MATH 18,A01,083743,Cinel; Cameron Alexander,7,0,30,23
1656240393480,MATH 18,A02,083744,Cinel; Cameron Alexander,9,0,30,21
1656240393480,MATH 18,A03,083745,Cinel; Cameron Alexander,5,0,30,25
1656240393480,MATH 18,B01,083748,Rideout; David Porter,1,0,36,35
1656240393480,MATH 18,B02,083749,Rideout; David Porter,0,0,36,36
1656240393480,MATH 18,B03,083750,Rideout; David Porter,0,0,36,36
1656240393480,MATH 18,B04,083751,Rideout; David Porter,0,1,36,36
1656240393480,MATH 18,B05,093473,Rideout; David Porter,0,0,36,36
1656240393480,MATH 18,B06,093474,Rideout; David Porter,3,0,36,33
1656240399505,MATH 20A,A01,083754,Zheng; Zequn,11,0,40,29
1656240405531,MATH 20B,A01,083756,Briones; Jor-el Thomas Caparas,0,0,36,36
1656240405531,MATH 20B,A02,083757,Briones; Jor-el Thomas Caparas,0,0,36,36
1656240405531,MATH 20B,A03,093475,Staff,0,0,36,36
1656240411567,MATH 20C,A01,083760,Briones; Jor-el Thomas Caparas,0,0,35,35
1656240411567,MATH 20C,A02,083761,Briones; Jor-el Thomas Caparas,9,1,35,26
1656240411567,MATH 20C,A03,093476,Staff,0,0,35,35
1656240411567,MATH 20C,B01,083762,Bach; Quang Tran,1,0,30,29
1656240417605,MATH 20D,A01,083765,Tran; Brian Kha,1,0,30,29
1656240417605,MATH 20D,A02,083766,Tran; Brian Kha,0,1,30,30
1656240417605,MATH 20D,A03,083767,Tran; Brian Kha,2,0,30,28
1656240423641,MATH 20E,A01,083771,Ganguly; Soumya,3,0,32,29
1656240423641,MATH 20E,A02,083772,Ganguly; Soumya,0,0,32,32
1656240423641,MATH 20E,B01,083773,Ciotti; Benjamin,16,0,35,19
1656240423641,MATH 20E,B02,083774,Ciotti; Benjamin,15,0,35,20
1656240429680,MATH 103A,A01,083777,Greenfeld; Be'Eri,1,0,36,35
1656240429680,MATH 103A,A02,083778,Greenfeld; Be'Eri,1,0,36,35
1656240429680,MATH 103A,A03,093561,Staff,5,0,36,31
1656240429680,MATH 103A,B01,083779,Greenfeld; Be'Eri,8,0,36,28
1656240429680,MATH 103A,B02,083780,Greenfeld; Be'Eri,1,0,36,35
1656240429680,MATH 103A,B03,093562,Staff,0,0,36,36
1656240435706,MATH 105,A01,085443,Carter; Anne Toulson,5,0,35,30
1656240435706,MATH 105,A02,093477,Staff,14,0,35,21
1656240441730,MATH 109,A01,083213,Ganzberger; Geoffrey Michael,0,0,34,34
1656240441730,MATH 109,A02,083214,Ganzberger; Geoffrey Michael,0,0,34,34
1656240441730,MATH 109,A03,093478,Staff,1,0,34,33
1656240441730,MATH 109,B01,083215,Ganzberger; Geoffrey Michael,4,0,32,28
1656240441730,MATH 109,B02,083216,Ganzberger; Geoffrey Michael,1,0,32,31
1656240441730,MATH 109,B03,093479,Staff,3,0,32,29
1656240447757,MATH 142A,A01,083219,Chow; Bennett,2,0,32,30
1656240447757,MATH 142A,A02,083220,Chow; Bennett,8,0,32,24
1656240447757,MATH 142A,A03,093480,Staff,5,0,32,27
1656240447757,MATH 142A,B03,093481,Staff,3,0,32,29
1656240447757,MATH 142A,B04,093558,Staff,6,0,32,26
1656240447757,MATH 142A,B05,093559,Staff,0,0,32,32
1656240453790,MATH 193A,A01,083224,Rotar; Vladimir,0,1,34,34
1656240453790,MATH 193A,A02,083225,Rotar; Vladimir,0,0,34,34
1656240453790,MATH 193A,A03,083781,Rotar; Vladimir,0,0,34,34
1656240453790,MATH 193A,A04,083782,Rotar; Vladimir,6,0,34,28
1656240453790,MATH 193A,A05,093482,Rotar; Vladimir,0,0,34,34
1656240459820,MATH 197,001,091859,McAuley; Julian John,9999,0,9999,0
1656240459820,MATH 197,002,095566,Kedlaya; Kiran S.,9997,0,9999,2
1656240459820,MATH 197,003,095567,Xiao; Ming,9999,0,9999,0
1656240459820,MATH 197,004,095571,Perols; Johan Lars,9998,0,9999,1
1656240466889,COGS 9,A01,083615,Shannon; Kyle Michael,3,0,75,72
1656240472919,COGS 11,A01,083617,Boyle; Mary E. T.,14,0,48,34
1656240478945,COGS 13,A01,083071,Bastos; Amalia Pinkusfeld,4,0,71,67
1656240484970,COGS 14A,A01,092681,Semenuks; Arturs,1,12,100,99
1656240490995,COGS 14B,A01,083073,Cheng; Tzu-Han,7,0,63,56
1656240497027,COGS 17,A01,092677,Semenuks; Arturs,7,0,81,74
1656240503053,COGS 100,A01,083619,Allen; Michael Gordon,2,0,70,68
1656240509079,COGS 101A,A01,083621,Davis; Joshua Daniel,4,0,68,64
1656240515109,COGS 101B,A01,091572,Allen; Michael Gordon,4,0,65,61
1656240521134,COGS 101C,A01,083625,Delgado; Tania,10,0,35,25
1656240527160,COGS 107A,A01,083627,Boyle; Mary E. T.,0,0,60,60
1656240533184,COGS 118A,A01,083075,Gupta; Anjum,8,0,76,68
1656240539215,CSE 3,A50,083646,Miranda; Gregory Joseph,18,0,50,32
1656240545240,CSE 8A,A50,083650,Miranda; Gregory Joseph,2,2,56,54
1656240551266,CSE 11,A01,083080,Cao; Yingjun,0,49,40,40
1656240557291,CSE 12,A01,083652,Krause-Levy; Sophia Louisa,5,1,120,115
1656240563320,CSE 15L,A01,083654,Morris; Justin Loren,2,0,50,48
1656240563320,CSE 15L,A02,083655,Morris; Justin Loren,4,0,50,46
1656240569347,CSE 20,A01,083657,Tran; Khoa Dang,30,0,80,50
1656240575372,CSE 21,A01,095574,Bach; Quang Tran,23,0,48,25
1656240581397,CSE 30,A01,083084,Eldon; John,2,6,80,78
1656240581397,CSE 30,B01,095061,Bhaskar; Nishant,0,1,50,50
1656240587428,CSE 100,A01,083659,Cao; Yingjun,1,18,70,69
1656240593456,CSE 134B,A01,083661,Powell; Thomas Allan,5,0,100,95
1656240599484,CSE 140,A01,083663,Gungor; Onat,9,0,85,76
1656240605508,CSE 140L,A01,083088,Eldon; John,8,0,100,92
1656240611536,CSE 175,A01,083665,Kumar; Rakesh,0,0,25,25
1656240617558,CSE 190,A00,092507,Dubnov; Shlomo,3,0,20,17
1656240623591,ECE 45,A01,083139,Congero; Spencer William,1,0,75,74
1656240629616,ECE 65,A50,083695,Saad; Andrew S,9,0,30,21
1656240629616,ECE 65,A51,095125,Staff,24,0,26,2
1656240635720,ECE 109,A01,091882,Touri; Behrouz,0,1,70,70
1656240641752,ECE 180,A00,083140,Abi Samra; Nicholas Camill,1,0,30,29
1656240641752,ECE 180,B00,083141,Abi Samra; Nicholas Camill,0,4,30,30
1656240647776,MATH 10A,A01,083735,Patchell; Gregory David,0,0,30,30
1656240647776,MATH 10A,A02,083736,Patchell; Gregory David,22,0,30,8
1656240647776,MATH 10A,A03,083737,Patchell; Gregory David,16,0,30,14
1656240653801,MATH 10B,A01,083207,Lim; Seonhee,0,0,34,34
1656240653801,MATH 10B,A02,083208,Lim; Seonhee,7,0,35,28
1656240653801,MATH 10B,A03,093472,Staff,1,0,34,33
1656240653801,MATH 10B,B01,083739,Sinha; Shubham,11,0,30,19
1656240659829,MATH 18,A01,083743,Cinel; Cameron Alexander,7,0,30,23
1656240659829,MATH 18,A02,083744,Cinel; Cameron Alexander,9,0,30,21
1656240659829,MATH 18,A03,083745,Cinel; Cameron Alexander,5,0,30,25
1656240659829,MATH 18,B01,083748,Rideout; David Porter,1,0,36,35
1656240659829,MATH 18,B02,083749,Rideout; David Porter,0,0,36,36
1656240659829,MATH 18,B03,083750,Rideout; David Porter,0,0,36,36
1656240659829,MATH 18,B04,083751,Rideout; David Porter,0,1,36,36
1656240659829,MATH 18,B05,093473,Rideout; David Porter,0,0,36,36
1656240659829,MATH 18,B06,093474,Rideout; David Porter,3,0,36,33
1656240665854,MATH 20A,A01,083754,Zheng; Zequn,11,0,40,29
1656240671878,MATH 20B,A01,083756,Briones; Jor-el Thomas Caparas,0,0,36,36
1656240671878,MATH 20B,A02,083757,Briones; Jor-el Thomas Caparas,0,0,36,36
1656240671878,MATH 20B,A03,093475,Staff,0,0,36,36
1656240677909,MATH 20C,A01,083760,Briones; Jor-el Thomas Caparas,0,0,35,35
1656240677909,MATH 20C,A02,083761,Briones; Jor-el Thomas Caparas,9,1,35,26
1656240677909,MATH 20C,A03,093476,Staff,0,0,35,35
1656240677909,MATH 20C,B01,083762,Bach; Quang Tran,1,0,30,29
1656240683933,MATH 20D,A01,083765,Tran; Brian Kha,1,0,30,29
1656240683933,MATH 20D,A02,083766,Tran; Brian Kha,0,1,30,30
1656240683933,MATH 20D,A03,083767,Tran; Brian Kha,2,0,30,28
1656240689960,MATH 20E,A01,083771,Ganguly; Soumya,3,0,32,29
1656240689960,MATH 20E,A02,083772,Ganguly; Soumya,0,0,32,32
1656240689960,MATH 20E,B01,083773,Ciotti; Benjamin,16,0,35,19
1656240689960,MATH 20E,B02,083774,Ciotti; Benjamin,15,0,35,20
1656240695987,MATH 103A,A01,083777,Greenfeld; Be'Eri,1,0,36,35
1656240695987,MATH 103A,A02,083778,Greenfeld; Be'Eri,1,0,36,35
1656240695987,MATH 103A,A03,093561,Staff,5,0,36,31
1656240695987,MATH 103A,B01,083779,Greenfeld; Be'Eri,8,0,36,28
1656240695987,MATH 103A,B02,083780,Greenfeld; Be'Eri,1,0,36,35
1656240695987,MATH 103A,B03,093562,Staff,0,0,36,36
1656240702016,MATH 105,A01,085443,Carter; Anne Toulson,5,0,35,30
1656240702016,MATH 105,A02,093477,Staff,14,0,35,21
1656240708042,MATH 109,A01,083213,Ganzberger; Geoffrey Michael,0,0,34,34
1656240708042,MATH 109,A02,083214,Ganzberger; Geoffrey Michael,0,0,34,34
1656240708042,MATH 109,A03,093478,Staff,1,0,34,33
1656240708042,MATH 109,B01,083215,Ganzberger; Geoffrey Michael,4,0,32,28
1656240708042,MATH 109,B02,083216,Ganzberger; Geoffrey Michael,1,0,32,31
1656240708042,MATH 109,B03,093479,Staff,3,0,32,29
1656240714076,MATH 142A,A01,083219,Chow; Bennett,2,0,32,30
1656240714076,MATH 142A,A02,083220,Chow; Bennett,8,0,32,24
1656240714076,MATH 142A,A03,093480,Staff,5,0,32,27
1656240714076,MATH 142A,B03,093481,Staff,3,0,32,29
1656240714076,MATH 142A,B04,093558,Staff,6,0,32,26
1656240714076,MATH 142A,B05,093559,Staff,0,0,32,32
1656240720099,MATH 193A,A01,083224,Rotar; Vladimir,0,1,34,34
1656240720099,MATH 193A,A02,083225,Rotar; Vladimir,0,0,34,34
1656240720099,MATH 193A,A03,083781,Rotar; Vladimir,0,0,34,34
1656240720099,MATH 193A,A04,083782,Rotar; Vladimir,6,0,34,28
1656240720099,MATH 193A,A05,093482,Rotar; Vladimir,0,0,34,34
1656240726128,MATH 197,001,091859,McAuley; Julian John,9999,0,9999,0
1656240726128,MATH 197,002,095566,Kedlaya; Kiran S.,9997,0,9999,2
1656240726128,MATH 197,003,095567,Xiao; Ming,9999,0,9999,0
1656240726128,MATH 197,004,095571,Perols; Johan Lars,9998,0,9999,1
1656240733192,COGS 9,A01,083615,Shannon; Kyle Michael,3,0,75,72
1656240739222,COGS 11,A01,083617,Boyle; Mary E. T.,14,0,48,34
1656240745247,COGS 13,A01,083071,Bastos; Amalia Pinkusfeld,4,0,71,67
1656240751276,COGS 14A,A01,092681,Semenuks; Arturs,1,12,100,99
1656240757304,COGS 14B,A01,083073,Cheng; Tzu-Han,7,0,63,56
1656240763331,COGS 17,A01,092677,Semenuks; Arturs,7,0,81,74
1656240769355,COGS 100,A01,083619,Allen; Michael Gordon,2,0,70,68
1656240775379,COGS 101A,A01,083621,Davis; Joshua Daniel,4,0,68,64
1656240781404,COGS 101B,A01,091572,Allen; Michael Gordon,4,0,65,61
1656240787435,COGS 101C,A01,083625,Delgado; Tania,10,0,35,25
1656240793460,COGS 107A,A01,083627,Boyle; Mary E. T.,0,0,60,60
1656240799483,COGS 118A,A01,083075,Gupta; Anjum,8,0,76,68
1656240805513,CSE 3,A50,083646,Miranda; Gregory Joseph,18,0,50,32
1656240811541,CSE 8A,A50,083650,Miranda; Gregory Joseph,2,2,56,54
1656240817567,CSE 11,A01,083080,Cao; Yingjun,0,49,40,40
1656240823612,CSE 12,A01,083652,Krause-Levy; Sophia Louisa,5,1,120,115
1656240829637,CSE 15L,A01,083654,Morris; Justin Loren,2,0,50,48
1656240829637,CSE 15L,A02,083655,Morris; Justin Loren,4,0,50,46
1656240835660,CSE 20,A01,083657,Tran; Khoa Dang,30,0,80,50
1656240841689,CSE 21,A01,095574,Bach; Quang Tran,23,0,48,25
1656240847714,CSE 30,A01,083084,Eldon; John,2,6,80,78
1656240847714,CSE 30,B01,095061,Bhaskar; Nishant,0,1,50,50
1656240853739,CSE 100,A01,083659,Cao; Yingjun,1,18,70,69
1656240859764,CSE 134B,A01,083661,Powell; Thomas Allan,5,0,100,95
1656240865789,CSE 140,A01,083663,Gungor; Onat,9,0,85,76
1656240871814,CSE 140L,A01,083088,Eldon; John,8,0,100,92
1656240877839,CSE 175,A01,083665,Kumar; Rakesh,0,0,25,25
1656240883880,CSE 190,A00,092507,Dubnov; Shlomo,3,0,20,17
1656240889911,ECE 45,A01,083139,Congero; Spencer William,1,0,75,74
1656240895938,ECE 65,A50,083695,Saad; Andrew S,9,0,30,21
1656240895938,ECE 65,A51,095125,Staff,24,0,26,2
1656240901964,ECE 109,A01,091882,Touri; Behrouz,0,1,70,70
1656240907988,ECE 180,A00,083140,Abi Samra; Nicholas Camill,1,0,30,29
1656240907988,ECE 180,B00,083141,Abi Samra; Nicholas Camill,0,4,30,30
1656240914016,MATH 10A,A01,083735,Patchell; Gregory David,0,0,30,30
1656240914016,MATH 10A,A02,083736,Patchell; Gregory David,22,0,30,8
1656240914016,MATH 10A,A03,083737,Patchell; Gregory David,16,0,30,14
1656240920042,MATH 10B,A01,083207,Lim; Seonhee,0,0,34,34
1656240920042,MATH 10B,A02,083208,Lim; Seonhee,7,0,35,28
1656240920042,MATH 10B,A03,093472,Staff,1,0,34,33
1656240920042,MATH 10B,B01,083739,Sinha; Shubham,11,0,30,19
1656240926084,MATH 18,A01,083743,Cinel; Cameron Alexander,7,0,30,23
1656240926084,MATH 18,A02,083744,Cinel; Cameron Alexander,9,0,30,21
1656240926084,MATH 18,A03,083745,Cinel; Cameron Alexander,5,0,30,25
1656240926084,MATH 18,B01,083748,Rideout; David Porter,1,0,36,35
1656240926084,MATH 18,B02,083749,Rideout; David Porter,0,0,36,36
1656240926084,MATH 18,B03,083750,Rideout; David Porter,0,0,36,36
1656240926084,MATH 18,B04,083751,Rideout; David Porter,0,1,36,36
1656240926084,MATH 18,B05,093473,Rideout; David Porter,0,0,36,36
1656240926084,MATH 18,B06,093474,Rideout; David Porter,3,0,36,33
1656240932110,MATH 20A,A01,083754,Zheng; Zequn,11,0,40,29
1656240938141,MATH 20B,A01,083756,Briones; Jor-el Thomas Caparas,0,0,36,36
1656240938141,MATH 20B,A02,083757,Briones; Jor-el Thomas Caparas,0,0,36,36
1656240938141,MATH 20B,A03,093475,Staff,0,0,36,36
1656240944167,MATH 20C,A01,083760,Briones; Jor-el Thomas Caparas,0,0,35,35
1656240944167,MATH 20C,A02,083761,Briones; Jor-el Thomas Caparas,9,1,35,26
1656240944167,MATH 20C,A03,093476,Staff,0,0,35,35
1656240944167,MATH 20C,B01,083762,Bach; Quang Tran,1,0,30,29
1656240950198,MATH 20D,A01,083765,Tran; Brian Kha,1,0,30,29
1656240950198,MATH 20D,A02,083766,Tran; Brian Kha,0,1,30,30
1656240950198,MATH 20D,A03,083767,Tran; Brian Kha,2,0,30,28
1656240956230,MATH 20E,A01,083771,Ganguly; Soumya,3,0,32,29
1656240956230,MATH 20E,A02,083772,Ganguly; Soumya,0,0,32,32
1656240956230,MATH 20E,B01,083773,Ciotti; Benjamin,16,0,35,19
1656240956230,MATH 20E,B02,083774,Ciotti; Benjamin,15,0,35,20
1656240962266,MATH 103A,A01,083777,Greenfeld; Be'Eri,1,0,36,35
1656240962266,MATH 103A,A02,083778,Greenfeld; Be'Eri,1,0,36,35
1656240962266,MATH 103A,A03,093561,Staff,5,0,36,31
1656240962266,MATH 103A,B01,083779,Greenfeld; Be'Eri,8,0,36,28
1656240962266,MATH 103A,B02,083780,Greenfeld; Be'Eri,1,0,36,35
1656240962266,MATH 103A,B03,093562,Staff,0,0,36,36
1656240968298,MATH 105,A01,085443,Carter; Anne Toulson,5,0,35,30
1656240968298,MATH 105,A02,093477,Staff,14,0,35,21
1656240974331,MATH 109,A01,083213,Ganzberger; Geoffrey Michael,0,0,34,34
1656240974331,MATH 109,A02,083214,Ganzberger; Geoffrey Michael,0,0,34,34
1656240974331,MATH 109,A03,093478,Staff,1,0,34,33
1656240974331,MATH 109,B01,083215,Ganzberger; Geoffrey Michael,4,0,32,28
1656240974331,MATH 109,B02,083216,Ganzberger; Geoffrey Michael,1,0,32,31
1656240974331,MATH 109,B03,093479,Staff,3,0,32,29
1656240980356,MATH 142A,A01,083219,Chow; Bennett,2,0,32,30
1656240980356,MATH 142A,A02,083220,Chow; Bennett,8,0,32,24
1656240980356,MATH 142A,A03,093480,Staff,5,0,32,27
1656240980356,MATH 142A,B03,093481,Staff,3,0,32,29
1656240980356,MATH 142A,B04,093558,Staff,6,0,32,26
1656240980356,MATH 142A,B05,093559,Staff,0,0,32,32
1656240986388,MATH 193A,A01,083224,Rotar; Vladimir,0,1,34,34
1656240986388,MATH 193A,A02,083225,Rotar; Vladimir,0,0,34,34
1656240986388,MATH 193A,A03,083781,Rotar; Vladimir,0,0,34,34
1656240986388,MATH 193A,A04,083782,Rotar; Vladimir,6,0,34,28
1656240986388,MATH 193A,A05,093482,Rotar; Vladimir,0,0,34,34
1656240992412,MATH 197,001,091859,McAuley; Julian John,9999,0,9999,0
1656240992412,MATH 197,002,095566,Kedlaya; Kiran S.,9997,0,9999,2
1656240992412,MATH 197,003,095567,Xiao; Ming,9999,0,9999,0
1656240992412,MATH 197,004,095571,Perols; Johan Lars,9998,0,9999,1
1656240999493,COGS 9,A01,083615,Shannon; Kyle Michael,3,0,75,72
1656241005519,COGS 11,A01,083617,Boyle; Mary E. T.,14,0,48,34
1656241011545,COGS 13,A01,083071,Bastos; Amalia Pinkusfeld,4,0,71,67
1656241017577,COGS 14A,A01,092681,Semenuks; Arturs,1,12,100,99
1656241023630,COGS 14B,A01,083073,Cheng; Tzu-Han,7,0,63,56
1656241029656,COGS 17,A01,092677,Semenuks; Arturs,7,0,81,74
1656241035686,COGS 100,A01,083619,Allen; Michael Gordon,2,0,70,68
1656241041710,COGS 101A,A01,083621,Davis; Joshua Daniel,4,0,68,64
1656241047742,COGS 101B,A01,091572,Allen; Michael Gordon,4,0,65,61
1656241053771,COGS 101C,A01,083625,Delgado; Tania,10,0,35,25
1656241059797,COGS 107A,A01,083627,Boyle; Mary E. T.,0,0,60,60
1656241065822,COGS 118A,A01,083075,Gupta; Anjum,8,0,76,68
1656241071853,CSE 3,A50,083646,Miranda; Gregory Joseph,18,0,50,32
1656241077878,CSE 8A,A50,083650,Miranda; Gregory Joseph,2,2,56,54
1656241083903,CSE 11,A01,083080,Cao; Yingjun,0,49,40,40
1656241089926,CSE 12,A01,083652,Krause-Levy; Sophia Louisa,5,1,120,115
1656241095956,CSE 15L,A01,083654,Morris; Justin Loren,2,0,50,48
1656241095956,CSE 15L,A02,083655,Morris; Justin Loren,4,0,50,46
1656241101984,CSE 20,A01,083657,Tran; Khoa Dang,30,0,80,50
1656241108012,CSE 21,A01,095574,Bach; Quang Tran,23,0,48,25
1656241114045,CSE 30,A01,083084,Eldon; John,2,6,80,78
1656241114045,CSE 30,B01,095061,Bhaskar; Nishant,0,1,50,50
1656241120072,CSE 100,A01,083659,Cao; Yingjun,1,18,70,69
1656241126102,CSE 134B,A01,083661,Powell; Thomas Allan,5,0,100,95
1656241132130,CSE 140,A01,083663,Gungor; Onat,9,0,85,76
1656241138158,CSE 140L,A01,083088,Eldon; John,8,0,100,92
1656241144183,CSE 175,A01,083665,Kumar; Rakesh,0,0,25,25
1656241150206,CSE 190,A00,092507,Dubnov; Shlomo,3,0,20,17
1656241156232,ECE 45,A01,083139,Congero; Spencer William,1,0,75,74
1656241162260,ECE 65,A50,083695,Saad; Andrew S,9,0,30,21
1656241162260,ECE 65,A51,095125,Staff,24,0,26,2
1656241168285,ECE 109,A01,091882,Touri; Behrouz,0,1,70,70
1656241174308,ECE 180,A00,083140,Abi Samra; Nicholas Camill,1,0,30,29
1656241174308,ECE 180,B00,083141,Abi Samra; Nicholas Camill,0,4,30,30
1656241180342,MATH 10A,A01,083735,Patchell; Gregory David,0,0,30,30
1656241180342,MATH 10A,A02,083736,Patchell; Gregory David,22,0,30,8
1656241180342,MATH 10A,A03,083737,Patchell; Gregory David,16,0,30,14
1656241186374,MATH 10B,A01,083207,Lim; Seonhee,0,0,34,34
1656241186374,MATH 10B,A02,083208,Lim; Seonhee,7,0,35,28
1656241186374,MATH 10B,A03,093472,Staff,1,0,34,33
1656241186374,MATH 10B,B01,083739,Sinha; Shubham,11,0,30,19
1656241192401,MATH 18,A01,083743,Cinel; Cameron Alexander,7,0,30,23
1656241192401,MATH 18,A02,083744,Cinel; Cameron Alexander,9,0,30,21
1656241192401,MATH 18,A03,083745,Cinel; Cameron Alexander,5,0,30,25
1656241192401,MATH 18,B01,083748,Rideout; David Porter,1,0,36,35
1656241192401,MATH 18,B02,083749,Rideout; David Porter,0,0,36,36
1656241192401,MATH 18,B03,083750,Rideout; David Porter,0,0,36,36
1656241192401,MATH 18,B04,083751,Rideout; David Porter,0,1,36,36
1656241192401,MATH 18,B05,093473,Rideout; David Porter,0,0,36,36
1656241192401,MATH 18,B06,093474,Rideout; David Porter,3,0,36,33
1656241198424,MATH 20A,A01,083754,Zheng; Zequn,11,0,40,29
1656241204456,MATH 20B,A01,083756,Briones; Jor-el Thomas Caparas,0,0,36,36
1656241204456,MATH 20B,A02,083757,Briones; Jor-el Thomas Caparas,0,0,36,36
1656241204456,MATH 20B,A03,093475,Staff,0,0,36,36
1656241210484,MATH 20C,A01,083760,Briones; Jor-el Thomas Caparas,0,0,35,35
1656241210484,MATH 20C,A02,083761,Briones; Jor-el Thomas Caparas,9,1,35,26
1656241210484,MATH 20C,A03,093476,Staff,0,0,35,35
1656241210484,MATH 20C,B01,083762,Bach; Quang Tran,1,0,30,29
1656241216510,MATH 20D,A01,083765,Tran; Brian Kha,1,0,30,29
1656241216510,MATH 20D,A02,083766,Tran; Brian Kha,0,1,30,30
1656241216510,MATH 20D,A03,083767,Tran; Brian Kha,2,0,30,28
1656241222542,MATH 20E,A01,083771,Ganguly; Soumya,3,0,32,29
1656241222542,MATH 20E,A02,083772,Ganguly; Soumya,0,0,32,32
1656241222542,MATH 20E,B01,083773,Ciotti; Benjamin,16,0,35,19
1656241222542,MATH 20E,B02,083774,Ciotti; Benjamin,15,0,35,20
1656241228573,MATH 103A,A01,083777,Greenfeld; Be'Eri,1,0,36,35
1656241228573,MATH 103A,A02,083778,Greenfeld; Be'Eri,1,0,36,35
1656241228573,MATH 103A,A03,093561,Staff,5,0,36,31
1656241228573,MATH 103A,B01,083779,Greenfeld; Be'Eri,8,0,36,28
1656241228573,MATH 103A,B02,083780,Greenfeld; Be'Eri,1,0,36,35
1656241228573,MATH 103A,B03,093562,Staff,0,0,36,36
1656241234691,MATH 105,A01,085443,Carter; Anne Toulson,5,0,35,30
1656241234691,MATH 105,A02,093477,Staff,14,0,35,21
1656241240723,MATH 109,A01,083213,Ganzberger; Geoffrey Michael,0,0,34,34
1656241240723,MATH 109,A02,083214,Ganzberger; Geoffrey Michael,0,0,34,34
1656241240723,MATH 109,A03,093478,Staff,1,0,34,33
1656241240723,MATH 109,B01,083215,Ganzberger; Geoffrey Michael,4,0,32,28
1656241240723,MATH 109,B02,083216,Ganzberger; Geoffrey Michael,1,0,32,31
1656241240723,MATH 109,B03,093479,Staff,3,0,32,29
1656241246749,MATH 142A,A01,083219,Chow; Bennett,2,0,32,30
1656241246749,MATH 142A,A02,083220,Chow; Bennett,8,0,32,24
1656241246749,MATH 142A,A03,093480,Staff,5,0,32,27
1656241246749,MATH 142A,B03,093481,Staff,3,0,32,29
1656241246749,MATH 142A,B04,093558,Staff,6,0,32,26
1656241246749,MATH 142A,B05,093559,Staff,0,0,32,32
1656241252780,MATH 193A,A01,083224,Rotar; Vladimir,0,1,34,34
1656241252780,MATH 193A,A02,083225,Rotar; Vladimir,0,0,34,34
1656241252780,MATH 193A,A03,083781,Rotar; Vladimir,0,0,34,34
1656241252780,MATH 193A,A04,083782,Rotar; Vladimir,6,0,34,28
1656241252780,MATH 193A,A05,093482,Rotar; Vladimir,0,0,34,34
1656241258810,MATH 197,001,091859,McAuley; Julian John,9999,0,9999,0
1656241258810,MATH 197,002,095566,Kedlaya; Kiran S.,9997,0,9999,2
1656241258810,MATH 197,003,095567,Xiao; Ming,9999,0,9999,0
1656241258810,MATH 197,004,095571,Perols; Johan Lars,9998,0,9999,1
1656241265872,COGS 9,A01,083615,Shannon; Kyle Michael,3,0,75,72
1656241271896,COGS 11,A01,083617,Boyle; Mary E. T.,14,0,48,34
1656241277922,COGS 13,A01,083071,Bastos; Amalia Pinkusfeld,4,0,71,67
1656241283946,COGS 14A,A01,092681,Semenuks; Arturs,1,12,100,99
1656241289974,COGS 14B,A01,083073,Cheng; Tzu-Han,7,0,63,56
1656241295999,COGS 17,A01,092677,Semenuks; Arturs,7,0,81,74
1656241302024,COGS 100,A01,083619,Allen; Michael Gordon,2,0,70,68
1656241308049,COGS 101A,A01,083621,Davis; Joshua Daniel,4,0,68,64
1656241314072,COGS 101B,A01,091572,Allen; Michael Gordon,4,0,65,61
1656241320103,COGS 101C,A01,083625,Delgado; Tania,10,0,35,25
1656241326127,COGS 107A,A01,083627,Boyle; Mary E. T.,0,0,60,60
1656241332152,COGS 118A,A01,083075,Gupta; Anjum,8,0,76,68
1656241338179,CSE 3,A50,083646,Miranda; Gregory Joseph,18,0,50,32
1656241344202,CSE 8A,A50,083650,Miranda; Gregory Joseph,2,2,56,54
1656241350227,CSE 11,A01,083080,Cao; Yingjun,0,49,40,40
1656241356253,CSE 12,A01,083652,Krause-Levy; Sophia Louisa,5,1,120,115
1656241362283,CSE 15L,A01,083654,Morris; Justin Loren,2,0,50,48
1656241362283,CSE 15L,A02,083655,Morris; Justin Loren,4,0,50,46
1656241368314,CSE 20,A01,083657,Tran; Khoa Dang,30,0,80,50
1656241374337,CSE 21,A01,095574,Bach; Quang Tran,23,0,48,25
1656241380364,CSE 30,A01,083084,Eldon; John,2,6,80,78
1656241380364,CSE 30,B01,095061,Bhaskar; Nishant,0,1,50,50
1656241386394,CSE 100,A01,083659,Cao; Yingjun,1,18,70,69
1656241392425,CSE 134B,A01,083661,Powell; Thomas Allan,5,0,100,95
1656241398529,CSE 140,A01,083663,Gungor; Onat,9,0,85,76
1656241404553,CSE 140L,A01,083088,Eldon; John,8,0,100,92
1656241410584,CSE 175,A01,083665,Kumar; Rakesh,0,0,25,25
1656241416610,CSE 190,A00,092507,Dubnov; Shlomo,3,0,20,17
1656241422645,ECE 45,A01,083139,Congero; Spencer William,1,0,75,74
1656241428676,ECE 65,A50,083695,Saad; Andrew S,9,0,30,21
1656241428676,ECE 65,A51,095125,Staff,24,0,26,2
1656241434700,ECE 109,A01,091882,Touri; Behrouz,0,1,70,70
1656241440729,ECE 180,A00,083140,Abi Samra; Nicholas Camill,1,0,30,29
1656241440729,ECE 180,B00,083141,Abi Samra; Nicholas Camill,0,4,30,30
1656241446755,MATH 10A,A01,083735,Patchell; Gregory David,0,0,30,30
1656241446755,MATH 10A,A02,083736,Patchell; Gregory David,22,0,30,8
1656241446755,MATH 10A,A03,083737,Patchell; Gregory David,16,0,30,14
1656241452791,MATH 10B,A01,083207,Lim; Seonhee,0,0,34,34
1656241452791,MATH 10B,A02,083208,Lim; Seonhee,7,0,35,28
1656241452791,MATH 10B,A03,093472,Staff,1,0,34,33
1656241452791,MATH 10B,B01,083739,Sinha; Shubham,11,0,30,19
1656241458818,MATH 18,A01,083743,Cinel; Cameron Alexander,7,0,30,23
1656241458818,MATH 18,A02,083744,Cinel; Cameron Alexander,9,0,30,21
1656241458818,MATH 18,A03,083745,Cinel; Cameron Alexander,5,0,30,25
1656241458818,MATH 18,B01,083748,Rideout; David Porter,1,0,36,35
1656241458818,MATH 18,B02,083749,Rideout; David Porter,0,0,36,36
1656241458818,MATH 18,B03,083750,Rideout; David Porter,0,0,36,36
1656241458818,MATH 18,B04,083751,Rideout; David Porter,0,1,36,36
1656241458818,MATH 18,B05,093473,Rideout; David Porter,0,0,36,36
1656241458818,MATH 18,B06,093474,Rideout; David Porter,3,0,36,33
1656241464841,MATH 20A,A01,083754,Zheng; Zequn,11,0,40,29
1656241470866,MATH 20B,A01,083756,Briones; Jor-el Thomas Caparas,0,0,36,36
1656241470866,MATH 20B,A02,083757,Briones; Jor-el Thomas Caparas,0,0,36,36
1656241470866,MATH 20B,A03,093475,Staff,0,0,36,36
1656241476898,MATH 20C,A01,083760,Briones; Jor-el Thomas Caparas,0,0,35,35
1656241476898,MATH 20C,A02,083761,Briones; Jor-el Thomas Caparas,9,1,35,26
1656241476898,MATH 20C,A03,093476,Staff,0,0,35,35
1656241476898,MATH 20C,B01,083762,Bach; Quang Tran,1,0,30,29
1656241482923,MATH 20D,A01,083765,Tran; Brian Kha,1,0,30,29
1656241482923,MATH 20D,A02,083766,Tran; Brian Kha,0,1,30,30
1656241482923,MATH 20D,A03,083767,Tran; Brian Kha,2,0,30,28
