time,subj_course_id,sec_code,sec_id,prof,available,waitlist,total,enrolled_ct
1656070461599,COGS 9,A01,083615,Shannon; Kyle Michael,4,1,75,71
1656070467643,COGS 11,A01,083617,Boyle; Mary E. T.,16,1,48,32
1656070473674,COGS 13,A01,083071,Bastos; Amalia Pinkusfeld,8,2,71,63
1656070479708,COGS 14A,A01,092681,Semenuks; Arturs,8,23,100,92
1656070485764,COGS 14B,A01,083073,Cheng; Tzu-Han,9,0,63,54
1656070491802,COGS 17,A01,092677,Semenuks; Arturs,13,6,81,68
1656070497839,COGS 100,A01,083619,Allen; Michael Gordon,8,1,70,62
1656070503876,COGS 101A,A01,083621,Davis; Joshua Daniel,7,3,68,61
1656070509918,COGS 101B,A01,091572,Allen; Michael Gordon,7,0,65,58
1656070515950,COGS 101C,A01,083625,Delgado; Tania,11,0,35,24
1656070521981,COGS 107A,A01,083627,Boyle; Mary E. T.,5,2,60,55
1656070528010,COGS 118A,A01,083075,Gupta; Anjum,24,16,76,52
1656070534053,CSE 3,A50,083646,Miranda; Gregory Joseph,20,0,50,30
1656070540086,CSE 8A,A50,083650,Miranda; Gregory Joseph,13,11,56,43
1656070546116,CSE 11,A01,083080,Cao; Yingjun,1,60,40,39
1656070552152,CSE 12,A01,083652,Krause-Levy; Sophia Louisa,14,7,120,106
1656070558179,CSE 15L,A01,083654,Morris; Justin Loren,5,1,50,45
1656070558179,CSE 15L,A02,083655,Morris; Justin Loren,7,0,50,43
1656070564208,CSE 20,A01,083657,Tran; Khoa Dang,31,0,80,49
1656070570272,CSE 21,A01,095574,Bach; Quang Tran,28,0,48,20
1656070576312,CSE 30,A01,083084,Eldon; John,3,10,80,77
1656070576312,CSE 30,B01,095061,Bhaskar; Nishant,4,5,50,46
1656070582346,CSE 100,A01,083659,Cao; Yingjun,2,23,70,68
1656070588374,CSE 134B,A01,083661,Powell; Thomas Allan,11,6,100,89
1656070594413,CSE 140,A01,083663,Gungor; Onat,9,0,85,76
1656070600447,CSE 140L,A01,083088,Eldon; John,8,0,100,92
1656070606478,CSE 175,A01,083665,Kumar; Rakesh,2,0,25,23
1656070612518,CSE 190,A00,092507,Dubnov; Shlomo,3,0,20,17
1656070618547,ECE 45,A01,083139,Congero; Spencer William,5,2,75,70
1656070624578,ECE 65,A50,083695,Saad; Andrew S,8,0,30,22
1656070624578,ECE 65,A51,095125,Staff,23,0,26,3
1656070630606,ECE 109,A01,091882,Touri; Behrouz,5,4,70,65
1656070636635,ECE 180,A00,083140,Abi Samra; Nicholas Camill,1,0,30,29
1656070636635,ECE 180,B00,083141,Abi Samra; Nicholas Camill,2,8,28,26
1656070642693,MATH 10A,A01,083735,Patchell; Gregory David,1,0,30,29
1656070642693,MATH 10A,A02,083736,Patchell; Gregory David,23,0,30,7
1656070642693,MATH 10A,A03,083737,Patchell; Gregory David,16,0,30,14
1656070648725,MATH 10B,A01,083207,Lim; Seonhee,3,1,34,31
1656070648725,MATH 10B,A02,083208,Lim; Seonhee,10,1,35,25
1656070648725,MATH 10B,A03,093472,Staff,4,1,34,30
1656070648725,MATH 10B,B01,083739,Sinha; Shubham,12,0,30,18
1656070654773,MATH 18,A01,083743,Cinel; Cameron Alexander,7,0,30,23
1656070654773,MATH 18,A02,083744,Cinel; Cameron Alexander,12,0,30,18
1656070654773,MATH 18,A03,083745,Cinel; Cameron Alexander,3,0,30,27
1656070654773,MATH 18,B01,083748,Ma; Zilu,1,0,36,35
1656070654773,MATH 18,B02,083749,Ma; Zilu,2,0,36,34
1656070654773,MATH 18,B03,083750,Ma; Zilu,0,0,36,36
1656070654773,MATH 18,B04,083751,Ma; Zilu,1,0,36,35
1656070654773,MATH 18,B05,093473,Staff,3,0,36,33
1656070654773,MATH 18,B06,093474,Staff,4,0,36,32
1656070660802,MATH 20A,A01,083754,Zheng; Zequn,11,0,40,29
1656070666832,MATH 20B,A01,083756,Briones; Jor-el Thomas Caparas,0,0,36,36
1656070666832,MATH 20B,A02,083757,Briones; Jor-el Thomas Caparas,3,0,36,33
1656070666832,MATH 20B,A03,093475,Staff,3,0,36,33
1656070672862,MATH 20C,A01,083760,Briones; Jor-el Thomas Caparas,2,2,35,33
1656070672862,MATH 20C,A02,083761,Briones; Jor-el Thomas Caparas,9,1,35,26
1656070672862,MATH 20C,A03,093476,Staff,1,1,35,34
1656070672862,MATH 20C,B01,083762,Bach; Quang Tran,5,0,30,25
1656070678888,MATH 20D,A01,083765,Tran; Brian Kha,3,0,30,27
1656070678888,MATH 20D,A02,083766,Tran; Brian Kha,0,1,30,30
1656070678888,MATH 20D,A03,083767,Tran; Brian Kha,2,0,30,28
1656070684947,MATH 20E,A01,083771,Ganguly; Soumya,4,1,32,28
1656070684947,MATH 20E,A02,083772,Ganguly; Soumya,2,1,32,30
1656070684947,MATH 20E,B01,083773,Ciotti; Benjamin,15,0,35,20
1656070684947,MATH 20E,B02,083774,Ciotti; Benjamin,15,0,35,20
1656070690979,MATH 103A,A01,083777,Greenfeld; Be'Eri,3,0,36,33
1656070690979,MATH 103A,A02,083778,Greenfeld; Be'Eri,3,0,36,33
1656070690979,MATH 103A,A03,093561,Staff,4,1,36,32
1656070690979,MATH 103A,B01,083779,Greenfeld; Be'Eri,8,1,36,28
1656070690979,MATH 103A,B02,083780,Greenfeld; Be'Eri,1,0,36,35
1656070690979,MATH 103A,B03,093562,Staff,1,0,36,35
1656070697025,MATH 105,A01,085443,Carter; Anne Toulson,4,1,35,31
1656070697025,MATH 105,A02,093477,Staff,12,0,35,23
1656070703055,MATH 109,A01,083213,Ganzberger; Geoffrey Michael,1,1,34,33
1656070703055,MATH 109,A02,083214,Ganzberger; Geoffrey Michael,0,0,34,34
1656070703055,MATH 109,A03,093478,Staff,3,0,34,31
1656070703055,MATH 109,B01,083215,Ganzberger; Geoffrey Michael,4,0,32,28
1656070703055,MATH 109,B02,083216,Ganzberger; Geoffrey Michael,1,0,32,31
1656070703055,MATH 109,B03,093479,Staff,4,0,32,28
1656070709092,MATH 142A,A01,083219,Chow; Bennett,2,0,32,30
1656070709092,MATH 142A,A02,083220,Chow; Bennett,8,0,32,24
1656070709092,MATH 142A,A03,093480,Staff,5,0,32,27
1656070709092,MATH 142A,B03,093481,Staff,5,0,32,27
1656070709092,MATH 142A,B04,093558,Staff,7,0,32,25
1656070709092,MATH 142A,B05,093559,Staff,0,0,32,32
1656070715124,MATH 193A,A01,083224,Rotar; Vladimir,1,2,34,33
1656070715124,MATH 193A,A02,083225,Rotar; Vladimir,3,0,34,31
1656070715124,MATH 193A,A03,083781,Rotar; Vladimir,3,0,34,31
1656070715124,MATH 193A,A04,083782,Rotar; Vladimir,7,0,34,27
1656070715124,MATH 193A,A05,093482,Rotar; Vladimir,1,0,34,33
1656070721155,MATH 197,001,091859,McAuley; Julian John,9999,0,9999,0
1656070721155,MATH 197,002,095566,Kedlaya; Kiran S.,9997,0,9999,2
1656070721155,MATH 197,003,095567,Xiao; Ming,9999,0,9999,0
1656070721155,MATH 197,004,095571,Perols; Johan Lars,9998,0,9999,1
1656070728263,COGS 9,A01,083615,Shannon; Kyle Michael,4,1,75,71
1656070734292,COGS 11,A01,083617,Boyle; Mary E. T.,16,1,48,32
1656070740319,COGS 13,A01,083071,Bastos; Amalia Pinkusfeld,8,2,71,63
1656070746349,COGS 14A,A01,092681,Semenuks; Arturs,8,23,100,92
1656070752382,COGS 14B,A01,083073,Cheng; Tzu-Han,9,0,63,54
1656070758418,COGS 17,A01,092677,Semenuks; Arturs,13,6,81,68
1656070764460,COGS 100,A01,083619,Allen; Michael Gordon,8,1,70,62
1656070770507,COGS 101A,A01,083621,Davis; Joshua Daniel,7,3,68,61
1656070776541,COGS 101B,A01,091572,Allen; Michael Gordon,7,0,65,58
1656070782574,COGS 101C,A01,083625,Delgado; Tania,11,0,35,24
1656070788606,COGS 107A,A01,083627,Boyle; Mary E. T.,5,2,60,55
1656070794665,COGS 118A,A01,083075,Gupta; Anjum,24,16,76,52
1656070800708,CSE 3,A50,083646,Miranda; Gregory Joseph,20,0,50,30
1656070806741,CSE 8A,A50,083650,Miranda; Gregory Joseph,13,11,56,43
1656070812774,CSE 11,A01,083080,Cao; Yingjun,1,60,40,39
1656070818804,CSE 12,A01,083652,Krause-Levy; Sophia Louisa,14,7,120,106
1656070824840,CSE 15L,A01,083654,Morris; Justin Loren,5,1,50,45
1656070824840,CSE 15L,A02,083655,Morris; Justin Loren,7,0,50,43
1656070830875,CSE 20,A01,083657,Tran; Khoa Dang,31,0,80,49
1656070836904,CSE 21,A01,095574,Bach; Quang Tran,28,0,48,20
1656070842932,CSE 30,A01,083084,Eldon; John,3,10,80,77
1656070842932,CSE 30,B01,095061,Bhaskar; Nishant,4,5,50,46
1656070848962,CSE 100,A01,083659,Cao; Yingjun,2,23,70,68
1656070854994,CSE 134B,A01,083661,Powell; Thomas Allan,11,6,100,89
1656070861022,CSE 140,A01,083663,Gungor; Onat,9,0,85,76
1656070867057,CSE 140L,A01,083088,Eldon; John,8,0,100,92
1656070873087,CSE 175,A01,083665,Kumar; Rakesh,2,0,25,23
1656070879115,CSE 190,A00,092507,Dubnov; Shlomo,3,0,20,17
1656070885152,ECE 45,A01,083139,Congero; Spencer William,5,2,75,70
1656070891194,ECE 65,A50,083695,Saad; Andrew S,8,0,30,22
1656070891194,ECE 65,A51,095125,Staff,23,0,26,3
1656070897222,ECE 109,A01,091882,Touri; Behrouz,5,4,70,65
1656070903267,ECE 180,A00,083140,Abi Samra; Nicholas Camill,1,0,30,29
1656070903267,ECE 180,B00,083141,Abi Samra; Nicholas Camill,2,8,28,26
1656070909326,MATH 10A,A01,083735,Patchell; Gregory David,1,0,30,29
1656070909326,MATH 10A,A02,083736,Patchell; Gregory David,23,0,30,7
1656070909326,MATH 10A,A03,083737,Patchell; Gregory David,16,0,30,14
1656070915357,MATH 10B,A01,083207,Lim; Seonhee,3,1,34,31
1656070915357,MATH 10B,A02,083208,Lim; Seonhee,10,1,35,25
1656070915357,MATH 10B,A03,093472,Staff,4,1,34,30
1656070915357,MATH 10B,B01,083739,Sinha; Shubham,12,0,30,18
1656070921396,MATH 18,A01,083743,Cinel; Cameron Alexander,7,0,30,23
1656070921396,MATH 18,A02,083744,Cinel; Cameron Alexander,12,0,30,18
1656070921396,MATH 18,A03,083745,Cinel; Cameron Alexander,3,0,30,27
1656070921396,MATH 18,B01,083748,Ma; Zilu,1,0,36,35
1656070921396,MATH 18,B02,083749,Ma; Zilu,2,0,36,34
1656070921396,MATH 18,B03,083750,Ma; Zilu,0,0,36,36
1656070921396,MATH 18,B04,083751,Ma; Zilu,1,0,36,35
1656070921396,MATH 18,B05,093473,Staff,3,0,36,33
1656070921396,MATH 18,B06,093474,Staff,4,0,36,32
1656070927433,MATH 20A,A01,083754,Zheng; Zequn,11,0,40,29
1656070933471,MATH 20B,A01,083756,Briones; Jor-el Thomas Caparas,0,0,36,36
1656070933471,MATH 20B,A02,083757,Briones; Jor-el Thomas Caparas,3,0,36,33
1656070933471,MATH 20B,A03,093475,Staff,3,0,36,33
1656070939508,MATH 20C,A01,083760,Briones; Jor-el Thomas Caparas,2,2,35,33
1656070939508,MATH 20C,A02,083761,Briones; Jor-el Thomas Caparas,9,1,35,26
1656070939508,MATH 20C,A03,093476,Staff,1,1,35,34
1656070939508,MATH 20C,B01,083762,Bach; Quang Tran,5,0,30,25
1656070945534,MATH 20D,A01,083765,Tran; Brian Kha,3,0,30,27
1656070945534,MATH 20D,A02,083766,Tran; Brian Kha,0,1,30,30
1656070945534,MATH 20D,A03,083767,Tran; Brian Kha,2,0,30,28
1656070951572,MATH 20E,A01,083771,Ganguly; Soumya,4,1,32,28
1656070951572,MATH 20E,A02,083772,Ganguly; Soumya,2,1,32,30
1656070951572,MATH 20E,B01,083773,Ciotti; Benjamin,15,0,35,20
1656070951572,MATH 20E,B02,083774,Ciotti; Benjamin,15,0,35,20
1656070957608,MATH 103A,A01,083777,Greenfeld; Be'Eri,3,0,36,33
1656070957608,MATH 103A,A02,083778,Greenfeld; Be'Eri,3,0,36,33
1656070957608,MATH 103A,A03,093561,Staff,4,1,36,32
1656070957608,MATH 103A,B01,083779,Greenfeld; Be'Eri,8,1,36,28
1656070957608,MATH 103A,B02,083780,Greenfeld; Be'Eri,1,0,36,35
1656070957608,MATH 103A,B03,093562,Staff,1,0,36,35
1656070963636,MATH 105,A01,085443,Carter; Anne Toulson,4,1,35,31
1656070963636,MATH 105,A02,093477,Staff,12,0,35,23
1656070969665,MATH 109,A01,083213,Ganzberger; Geoffrey Michael,1,1,34,33
1656070969665,MATH 109,A02,083214,Ganzberger; Geoffrey Michael,0,0,34,34
1656070969665,MATH 109,A03,093478,Staff,3,0,34,31
1656070969665,MATH 109,B01,083215,Ganzberger; Geoffrey Michael,4,0,32,28
1656070969665,MATH 109,B02,083216,Ganzberger; Geoffrey Michael,1,0,32,31
1656070969665,MATH 109,B03,093479,Staff,4,0,32,28
1656070975696,MATH 142A,A01,083219,Chow; Bennett,2,0,32,30
1656070975696,MATH 142A,A02,083220,Chow; Bennett,8,0,32,24
1656070975696,MATH 142A,A03,093480,Staff,5,0,32,27
1656070975696,MATH 142A,B03,093481,Staff,5,0,32,27
1656070975696,MATH 142A,B04,093558,Staff,7,0,32,25
1656070975696,MATH 142A,B05,093559,Staff,0,0,32,32
1656070981733,MATH 193A,A01,083224,Rotar; Vladimir,1,2,34,33
1656070981733,MATH 193A,A02,083225,Rotar; Vladimir,3,0,34,31
1656070981733,MATH 193A,A03,083781,Rotar; Vladimir,3,0,34,31
1656070981733,MATH 193A,A04,083782,Rotar; Vladimir,7,0,34,27
1656070981733,MATH 193A,A05,093482,Rotar; Vladimir,1,0,34,33
1656070987769,MATH 197,001,091859,McAuley; Julian John,9999,0,9999,0
1656070987769,MATH 197,002,095566,Kedlaya; Kiran S.,9997,0,9999,2
1656070987769,MATH 197,003,095567,Xiao; Ming,9999,0,9999,0
1656070987769,MATH 197,004,095571,Perols; Johan Lars,9998,0,9999,1
1656070994861,COGS 9,A01,083615,Shannon; Kyle Michael,4,1,75,71
1656071000893,COGS 11,A01,083617,Boyle; Mary E. T.,16,1,48,32
1656071006921,COGS 13,A01,083071,Bastos; Amalia Pinkusfeld,8,2,71,63
1656071012953,COGS 14A,A01,092681,Semenuks; Arturs,8,23,100,92
1656071018991,COGS 14B,A01,083073,Cheng; Tzu-Han,9,0,63,54
1656071025048,COGS 17,A01,092677,Semenuks; Arturs,13,6,81,68
1656071031079,COGS 100,A01,083619,Allen; Michael Gordon,8,1,70,62
1656071037175,COGS 101A,A01,083621,Davis; Joshua Daniel,7,3,68,61
1656071043208,COGS 101B,A01,091572,Allen; Michael Gordon,7,0,65,58
1656071049264,COGS 101C,A01,083625,Delgado; Tania,11,0,35,24
1656071055289,COGS 107A,A01,083627,Boyle; Mary E. T.,5,2,60,55
1656071061314,COGS 118A,A01,083075,Gupta; Anjum,24,16,76,52
1656071067350,CSE 3,A50,083646,Miranda; Gregory Joseph,20,0,50,30
1656071073381,CSE 8A,A50,083650,Miranda; Gregory Joseph,13,11,56,43
1656071079420,CSE 11,A01,083080,Cao; Yingjun,1,60,40,39
1656071085452,CSE 12,A01,083652,Krause-Levy; Sophia Louisa,14,7,120,106
1656071091480,CSE 15L,A01,083654,Morris; Justin Loren,5,1,50,45
1656071091480,CSE 15L,A02,083655,Morris; Justin Loren,7,0,50,43
1656071097512,CSE 20,A01,083657,Tran; Khoa Dang,31,0,80,49
1656071103544,CSE 21,A01,095574,Bach; Quang Tran,28,0,48,20
1656071109582,CSE 30,A01,083084,Eldon; John,3,10,80,77
1656071109582,CSE 30,B01,095061,Bhaskar; Nishant,4,5,50,46
1656071115612,CSE 100,A01,083659,Cao; Yingjun,2,23,70,68
1656071121641,CSE 134B,A01,083661,Powell; Thomas Allan,11,6,100,89
1656071127671,CSE 140,A01,083663,Gungor; Onat,9,0,85,76
1656071133700,CSE 140L,A01,083088,Eldon; John,8,0,100,92
1656071139732,CSE 175,A01,083665,Kumar; Rakesh,2,0,25,23
1656071145764,CSE 190,A00,092507,Dubnov; Shlomo,3,0,20,17
1656071151792,ECE 45,A01,083139,Congero; Spencer William,5,2,75,70
1656071157823,ECE 65,A50,083695,Saad; Andrew S,8,0,30,22
1656071157823,ECE 65,A51,095125,Staff,23,0,26,3
1656071163859,ECE 109,A01,091882,Touri; Behrouz,5,4,70,65
1656071169888,ECE 180,A00,083140,Abi Samra; Nicholas Camill,1,0,30,29
1656071169888,ECE 180,B00,083141,Abi Samra; Nicholas Camill,2,8,28,26
1656071175918,MATH 10A,A01,083735,Patchell; Gregory David,1,0,30,29
1656071175918,MATH 10A,A02,083736,Patchell; Gregory David,23,0,30,7
1656071175918,MATH 10A,A03,083737,Patchell; Gregory David,16,0,30,14
1656071181951,MATH 10B,A01,083207,Lim; Seonhee,3,1,34,31
1656071181951,MATH 10B,A02,083208,Lim; Seonhee,10,1,35,25
1656071181951,MATH 10B,A03,093472,Staff,4,1,34,30
1656071181951,MATH 10B,B01,083739,Sinha; Shubham,12,0,30,18
1656071187982,MATH 18,A01,083743,Cinel; Cameron Alexander,7,0,30,23
1656071187982,MATH 18,A02,083744,Cinel; Cameron Alexander,12,0,30,18
1656071187982,MATH 18,A03,083745,Cinel; Cameron Alexander,3,0,30,27
1656071187982,MATH 18,B01,083748,Ma; Zilu,1,0,36,35
1656071187982,MATH 18,B02,083749,Ma; Zilu,2,0,36,34
1656071187982,MATH 18,B03,083750,Ma; Zilu,0,0,36,36
1656071187982,MATH 18,B04,083751,Ma; Zilu,1,0,36,35
1656071187982,MATH 18,B05,093473,Staff,3,0,36,33
1656071187982,MATH 18,B06,093474,Staff,4,0,36,32
1656071194021,MATH 20A,A01,083754,Zheng; Zequn,11,0,40,29
1656071200050,MATH 20B,A01,083756,Briones; Jor-el Thomas Caparas,0,0,36,36
1656071200050,MATH 20B,A02,083757,Briones; Jor-el Thomas Caparas,3,0,36,33
1656071200050,MATH 20B,A03,093475,Staff,3,0,36,33
1656071206096,MATH 20C,A01,083760,Briones; Jor-el Thomas Caparas,2,2,35,33
1656071206096,MATH 20C,A02,083761,Briones; Jor-el Thomas Caparas,9,1,35,26
1656071206096,MATH 20C,A03,093476,Staff,1,1,35,34
1656071206096,MATH 20C,B01,083762,Bach; Quang Tran,5,0,30,25
1656071212123,MATH 20D,A01,083765,Tran; Brian Kha,3,0,30,27
1656071212123,MATH 20D,A02,083766,Tran; Brian Kha,0,1,30,30
1656071212123,MATH 20D,A03,083767,Tran; Brian Kha,2,0,30,28
1656071218158,MATH 20E,A01,083771,Ganguly; Soumya,4,1,32,28
1656071218158,MATH 20E,A02,083772,Ganguly; Soumya,2,1,32,30
1656071218158,MATH 20E,B01,083773,Ciotti; Benjamin,15,0,35,20
1656071218158,MATH 20E,B02,083774,Ciotti; Benjamin,15,0,35,20
1656071224197,MATH 103A,A01,083777,Greenfeld; Be'Eri,3,0,36,33
1656071224197,MATH 103A,A02,083778,Greenfeld; Be'Eri,3,0,36,33
1656071224197,MATH 103A,A03,093561,Staff,4,1,36,32
1656071224197,MATH 103A,B01,083779,Greenfeld; Be'Eri,8,1,36,28
1656071224197,MATH 103A,B02,083780,Greenfeld; Be'Eri,1,0,36,35
1656071224197,MATH 103A,B03,093562,Staff,1,0,36,35
1656071230230,MATH 105,A01,085443,Carter; Anne Toulson,4,1,35,31
1656071230230,MATH 105,A02,093477,Staff,12,0,35,23
1656071236266,MATH 109,A01,083213,Ganzberger; Geoffrey Michael,1,1,34,33
1656071236266,MATH 109,A02,083214,Ganzberger; Geoffrey Michael,0,0,34,34
1656071236266,MATH 109,A03,093478,Staff,3,0,34,31
1656071236266,MATH 109,B01,083215,Ganzberger; Geoffrey Michael,4,0,32,28
1656071236266,MATH 109,B02,083216,Ganzberger; Geoffrey Michael,1,0,32,31
1656071236266,MATH 109,B03,093479,Staff,4,0,32,28
1656071242305,MATH 142A,A01,083219,Chow; Bennett,2,0,32,30
1656071242305,MATH 142A,A02,083220,Chow; Bennett,8,0,32,24
1656071242305,MATH 142A,A03,093480,Staff,5,0,32,27
1656071242305,MATH 142A,B03,093481,Staff,5,0,32,27
1656071242305,MATH 142A,B04,093558,Staff,7,0,32,25
1656071242305,MATH 142A,B05,093559,Staff,0,0,32,32
1656071248345,MATH 193A,A01,083224,Rotar; Vladimir,1,2,34,33
1656071248345,MATH 193A,A02,083225,Rotar; Vladimir,3,0,34,31
1656071248345,MATH 193A,A03,083781,Rotar; Vladimir,3,0,34,31
1656071248345,MATH 193A,A04,083782,Rotar; Vladimir,7,0,34,27
1656071248345,MATH 193A,A05,093482,Rotar; Vladimir,1,0,34,33
1656071254379,MATH 197,001,091859,McAuley; Julian John,9999,0,9999,0
1656071254379,MATH 197,002,095566,Kedlaya; Kiran S.,9997,0,9999,2
1656071254379,MATH 197,003,095567,Xiao; Ming,9999,0,9999,0
1656071254379,MATH 197,004,095571,Perols; Johan Lars,9998,0,9999,1
1656071261449,COGS 9,A01,083615,Shannon; Kyle Michael,4,1,75,71
1656071267487,COGS 11,A01,083617,Boyle; Mary E. T.,16,1,48,32
1656071273516,COGS 13,A01,083071,Bastos; Amalia Pinkusfeld,8,2,71,63
1656071279544,COGS 14A,A01,092681,Semenuks; Arturs,8,23,100,92
1656071285577,COGS 14B,A01,083073,Cheng; Tzu-Han,9,0,63,54
1656071291606,COGS 17,A01,092677,Semenuks; Arturs,13,6,81,68
1656071297641,COGS 100,A01,083619,Allen; Michael Gordon,8,1,70,62
1656071303669,COGS 101A,A01,083621,Davis; Joshua Daniel,7,3,68,61
1656071309714,COGS 101B,A01,091572,Allen; Michael Gordon,7,0,65,58
1656071315745,COGS 101C,A01,083625,Delgado; Tania,11,0,35,24
1656071321777,COGS 107A,A01,083627,Boyle; Mary E. T.,5,2,60,55
1656071327805,COGS 118A,A01,083075,Gupta; Anjum,24,16,76,52
1656071333852,CSE 3,A50,083646,Miranda; Gregory Joseph,20,0,50,30
1656071339898,CSE 8A,A50,083650,Miranda; Gregory Joseph,13,11,56,43
1656071345935,CSE 11,A01,083080,Cao; Yingjun,1,60,40,39
1656071351967,CSE 12,A01,083652,Krause-Levy; Sophia Louisa,14,7,120,106
1656071358000,CSE 15L,A01,083654,Morris; Justin Loren,5,1,50,45
1656071358000,CSE 15L,A02,083655,Morris; Justin Loren,7,0,50,43
1656071364027,CSE 20,A01,083657,Tran; Khoa Dang,31,0,80,49
1656071370062,CSE 21,A01,095574,Bach; Quang Tran,28,0,48,20
1656071376098,CSE 30,A01,083084,Eldon; John,3,10,80,77
1656071376098,CSE 30,B01,095061,Bhaskar; Nishant,4,5,50,46
1656071382151,CSE 100,A01,083659,Cao; Yingjun,2,23,70,68
1656071388183,CSE 134B,A01,083661,Powell; Thomas Allan,11,6,100,89
1656071394215,CSE 140,A01,083663,Gungor; Onat,9,0,85,76
1656071400244,CSE 140L,A01,083088,Eldon; John,8,0,100,92
1656071406272,CSE 175,A01,083665,Kumar; Rakesh,2,0,25,23
1656071412298,CSE 190,A00,092507,Dubnov; Shlomo,3,0,20,17
1656071418337,ECE 45,A01,083139,Congero; Spencer William,5,2,75,70
1656071424372,ECE 65,A50,083695,Saad; Andrew S,8,0,30,22
1656071424372,ECE 65,A51,095125,Staff,23,0,26,3
1656071430405,ECE 109,A01,091882,Touri; Behrouz,5,4,70,65
1656071436433,ECE 180,A00,083140,Abi Samra; Nicholas Camill,1,0,30,29
1656071436433,ECE 180,B00,083141,Abi Samra; Nicholas Camill,2,8,28,26
1656071442462,MATH 10A,A01,083735,Patchell; Gregory David,1,0,30,29
1656071442462,MATH 10A,A02,083736,Patchell; Gregory David,23,0,30,7
1656071442462,MATH 10A,A03,083737,Patchell; Gregory David,16,0,30,14
1656071448497,MATH 10B,A01,083207,Lim; Seonhee,3,1,34,31
1656071448497,MATH 10B,A02,083208,Lim; Seonhee,10,1,35,25
1656071448497,MATH 10B,A03,093472,Staff,4,1,34,30
1656071448497,MATH 10B,B01,083739,Sinha; Shubham,12,0,30,18
1656071454547,MATH 18,A01,083743,Cinel; Cameron Alexander,7,0,30,23
1656071454547,MATH 18,A02,083744,Cinel; Cameron Alexander,12,0,30,18
1656071454547,MATH 18,A03,083745,Cinel; Cameron Alexander,3,0,30,27
1656071454547,MATH 18,B01,083748,Ma; Zilu,1,0,36,35
1656071454547,MATH 18,B02,083749,Ma; Zilu,2,0,36,34
1656071454547,MATH 18,B03,083750,Ma; Zilu,0,0,36,36
1656071454547,MATH 18,B04,083751,Ma; Zilu,1,0,36,35
1656071454547,MATH 18,B05,093473,Staff,3,0,36,33
1656071454547,MATH 18,B06,093474,Staff,4,0,36,32
1656071460573,MATH 20A,A01,083754,Zheng; Zequn,11,0,40,29
1656071466612,MATH 20B,A01,083756,Briones; Jor-el Thomas Caparas,0,0,36,36
1656071466612,MATH 20B,A02,083757,Briones; Jor-el Thomas Caparas,3,0,36,33
1656071466612,MATH 20B,A03,093475,Staff,3,0,36,33
1656071472640,MATH 20C,A01,083760,Briones; Jor-el Thomas Caparas,2,2,35,33
1656071472640,MATH 20C,A02,083761,Briones; Jor-el Thomas Caparas,9,1,35,26
1656071472640,MATH 20C,A03,093476,Staff,1,1,35,34
1656071472640,MATH 20C,B01,083762,Bach; Quang Tran,5,0,30,25
1656071478683,MATH 20D,A01,083765,Tran; Brian Kha,3,0,30,27
1656071478683,MATH 20D,A02,083766,Tran; Brian Kha,0,1,30,30
1656071478683,MATH 20D,A03,083767,Tran; Brian Kha,2,0,30,28
1656071484719,MATH 20E,A01,083771,Ganguly; Soumya,4,1,32,28
1656071484719,MATH 20E,A02,083772,Ganguly; Soumya,2,1,32,30
1656071484719,MATH 20E,B01,083773,Ciotti; Benjamin,15,0,35,20
1656071484719,MATH 20E,B02,083774,Ciotti; Benjamin,15,0,35,20
1656071490748,MATH 103A,A01,083777,Greenfeld; Be'Eri,3,0,36,33
1656071490748,MATH 103A,A02,083778,Greenfeld; Be'Eri,3,0,36,33
1656071490748,MATH 103A,A03,093561,Staff,4,1,36,32
1656071490748,MATH 103A,B01,083779,Greenfeld; Be'Eri,8,1,36,28
1656071490748,MATH 103A,B02,083780,Greenfeld; Be'Eri,1,0,36,35
1656071490748,MATH 103A,B03,093562,Staff,1,0,36,35
1656071496775,MATH 105,A01,085443,Carter; Anne Toulson,4,1,35,31
1656071496775,MATH 105,A02,093477,Staff,12,0,35,23
1656071502809,MATH 109,A01,083213,Ganzberger; Geoffrey Michael,1,1,34,33
1656071502809,MATH 109,A02,083214,Ganzberger; Geoffrey Michael,0,0,34,34
1656071502809,MATH 109,A03,093478,Staff,3,0,34,31
1656071502809,MATH 109,B01,083215,Ganzberger; Geoffrey Michael,4,0,32,28
1656071502809,MATH 109,B02,083216,Ganzberger; Geoffrey Michael,1,0,32,31
1656071502809,MATH 109,B03,093479,Staff,4,0,32,28
1656071508861,MATH 142A,A01,083219,Chow; Bennett,2,0,32,30
1656071508861,MATH 142A,A02,083220,Chow; Bennett,8,0,32,24
1656071508861,MATH 142A,A03,093480,Staff,5,0,32,27
1656071508861,MATH 142A,B03,093481,Staff,5,0,32,27
1656071508861,MATH 142A,B04,093558,Staff,7,0,32,25
1656071508861,MATH 142A,B05,093559,Staff,0,0,32,32
1656071514889,MATH 193A,A01,083224,Rotar; Vladimir,1,2,34,33
1656071514889,MATH 193A,A02,083225,Rotar; Vladimir,3,0,34,31
1656071514889,MATH 193A,A03,083781,Rotar; Vladimir,3,0,34,31
1656071514889,MATH 193A,A04,083782,Rotar; Vladimir,7,0,34,27
1656071514889,MATH 193A,A05,093482,Rotar; Vladimir,1,0,34,33
1656071520917,MATH 197,001,091859,McAuley; Julian John,9999,0,9999,0
1656071520917,MATH 197,002,095566,Kedlaya; Kiran S.,9997,0,9999,2
1656071520917,MATH 197,003,095567,Xiao; Ming,9999,0,9999,0
1656071520917,MATH 197,004,095571,Perols; Johan Lars,9998,0,9999,1
1656071528011,COGS 9,A01,083615,Shannon; Kyle Michael,4,1,75,71
1656071534043,COGS 11,A01,083617,Boyle; Mary E. T.,16,1,48,32
1656071540076,COGS 13,A01,083071,Bastos; Amalia Pinkusfeld,8,2,71,63
1656071546103,COGS 14A,A01,092681,Semenuks; Arturs,8,23,100,92
1656071552134,COGS 14B,A01,083073,Cheng; Tzu-Han,9,0,63,54
1656071558165,COGS 17,A01,092677,Semenuks; Arturs,13,6,81,68
1656071564197,COGS 100,A01,083619,Allen; Michael Gordon,8,1,70,62
1656071570230,COGS 101A,A01,083621,Davis; Joshua Daniel,7,3,68,61
1656071576259,COGS 101B,A01,091572,Allen; Michael Gordon,7,0,65,58
1656071582292,COGS 101C,A01,083625,Delgado; Tania,11,0,35,24
1656071588324,COGS 107A,A01,083627,Boyle; Mary E. T.,5,2,60,55
1656071594371,COGS 118A,A01,083075,Gupta; Anjum,24,16,76,52
1656071600407,CSE 3,A50,083646,Miranda; Gregory Joseph,20,0,50,30
1656071606451,CSE 8A,A50,083650,Miranda; Gregory Joseph,13,11,56,43
1656071612494,CSE 11,A01,083080,Cao; Yingjun,1,60,40,39
1656071618519,CSE 12,A01,083652,Krause-Levy; Sophia Louisa,14,7,120,106
1656071624561,CSE 15L,A01,083654,Morris; Justin Loren,5,1,50,45
1656071624561,CSE 15L,A02,083655,Morris; Justin Loren,7,0,50,43
1656071630592,CSE 20,A01,083657,Tran; Khoa Dang,31,0,80,49
1656071636696,CSE 21,A01,095574,Bach; Quang Tran,28,0,48,20
1656071642757,CSE 30,A01,083084,Eldon; John,3,10,80,77
1656071642757,CSE 30,B01,095061,Bhaskar; Nishant,4,5,50,46
1656071648801,CSE 100,A01,083659,Cao; Yingjun,2,23,70,68
1656071654828,CSE 134B,A01,083661,Powell; Thomas Allan,11,6,100,89
1656071660862,CSE 140,A01,083663,Gungor; Onat,9,0,85,76
1656071666889,CSE 140L,A01,083088,Eldon; John,8,0,100,92
1656071672915,CSE 175,A01,083665,Kumar; Rakesh,2,0,25,23
1656071678947,CSE 190,A00,092507,Dubnov; Shlomo,3,0,20,17
1656071684984,ECE 45,A01,083139,Congero; Spencer William,5,2,75,70
1656071691018,ECE 65,A50,083695,Saad; Andrew S,8,0,30,22
1656071691018,ECE 65,A51,095125,Staff,23,0,26,3
1656071697044,ECE 109,A01,091882,Touri; Behrouz,5,4,70,65
1656071703071,ECE 180,A00,083140,Abi Samra; Nicholas Camill,1,0,30,29
1656071703071,ECE 180,B00,083141,Abi Samra; Nicholas Camill,2,8,28,26
1656071709098,MATH 10A,A01,083735,Patchell; Gregory David,1,0,30,29
1656071709098,MATH 10A,A02,083736,Patchell; Gregory David,23,0,30,7
1656071709098,MATH 10A,A03,083737,Patchell; Gregory David,16,0,30,14
1656071715128,MATH 10B,A01,083207,Lim; Seonhee,3,1,34,31
1656071715128,MATH 10B,A02,083208,Lim; Seonhee,10,1,35,25
1656071715128,MATH 10B,A03,093472,Staff,4,1,34,30
1656071715128,MATH 10B,B01,083739,Sinha; Shubham,12,0,30,18
1656071721172,MATH 18,A01,083743,Cinel; Cameron Alexander,7,0,30,23
1656071721172,MATH 18,A02,083744,Cinel; Cameron Alexander,12,0,30,18
1656071721172,MATH 18,A03,083745,Cinel; Cameron Alexander,3,0,30,27
1656071721172,MATH 18,B01,083748,Ma; Zilu,1,0,36,35
1656071721172,MATH 18,B02,083749,Ma; Zilu,2,0,36,34
1656071721172,MATH 18,B03,083750,Ma; Zilu,0,0,36,36
1656071721172,MATH 18,B04,083751,Ma; Zilu,1,0,36,35
1656071721172,MATH 18,B05,093473,Staff,3,0,36,33
1656071721172,MATH 18,B06,093474,Staff,4,0,36,32
1656071727197,MATH 20A,A01,083754,Zheng; Zequn,11,0,40,29
1656071733226,MATH 20B,A01,083756,Briones; Jor-el Thomas Caparas,0,0,36,36
1656071733226,MATH 20B,A02,083757,Briones; Jor-el Thomas Caparas,3,0,36,33
1656071733226,MATH 20B,A03,093475,Staff,3,0,36,33
1656071739266,MATH 20C,A01,083760,Briones; Jor-el Thomas Caparas,2,2,35,33
1656071739266,MATH 20C,A02,083761,Briones; Jor-el Thomas Caparas,9,1,35,26
1656071739266,MATH 20C,A03,093476,Staff,1,1,35,34
1656071739266,MATH 20C,B01,083762,Bach; Quang Tran,5,0,30,25
1656071745294,MATH 20D,A01,083765,Tran; Brian Kha,3,0,30,27
1656071745294,MATH 20D,A02,083766,Tran; Brian Kha,0,1,30,30
1656071745294,MATH 20D,A03,083767,Tran; Brian Kha,2,0,30,28
1656071751323,MATH 20E,A01,083771,Ganguly; Soumya,4,1,32,28
1656071751323,MATH 20E,A02,083772,Ganguly; Soumya,2,1,32,30
1656071751323,MATH 20E,B01,083773,Ciotti; Benjamin,15,0,35,20
1656071751323,MATH 20E,B02,083774,Ciotti; Benjamin,15,0,35,20
1656071757379,MATH 103A,A01,083777,Greenfeld; Be'Eri,3,0,36,33
1656071757379,MATH 103A,A02,083778,Greenfeld; Be'Eri,3,0,36,33
1656071757379,MATH 103A,A03,093561,Staff,4,1,36,32
1656071757379,MATH 103A,B01,083779,Greenfeld; Be'Eri,8,1,36,28
1656071757379,MATH 103A,B02,083780,Greenfeld; Be'Eri,1,0,36,35
1656071757379,MATH 103A,B03,093562,Staff,1,0,36,35
1656071763411,MATH 105,A01,085443,Carter; Anne Toulson,4,1,35,31
1656071763411,MATH 105,A02,093477,Staff,12,0,35,23
1656071769453,MATH 109,A01,083213,Ganzberger; Geoffrey Michael,1,1,34,33
1656071769453,MATH 109,A02,083214,Ganzberger; Geoffrey Michael,0,0,34,34
1656071769453,MATH 109,A03,093478,Staff,3,0,34,31
1656071769453,MATH 109,B01,083215,Ganzberger; Geoffrey Michael,4,0,32,28
1656071769453,MATH 109,B02,083216,Ganzberger; Geoffrey Michael,1,0,32,31
1656071769453,MATH 109,B03,093479,Staff,4,0,32,28
1656071775483,MATH 142A,A01,083219,Chow; Bennett,2,0,32,30
1656071775483,MATH 142A,A02,083220,Chow; Bennett,8,0,32,24
1656071775483,MATH 142A,A03,093480,Staff,5,0,32,27
1656071775483,MATH 142A,B03,093481,Staff,5,0,32,27
1656071775483,MATH 142A,B04,093558,Staff,7,0,32,25
1656071775483,MATH 142A,B05,093559,Staff,0,0,32,32
1656071781510,MATH 193A,A01,083224,Rotar; Vladimir,1,2,34,33
1656071781510,MATH 193A,A02,083225,Rotar; Vladimir,3,0,34,31
1656071781510,MATH 193A,A03,083781,Rotar; Vladimir,3,0,34,31
1656071781510,MATH 193A,A04,083782,Rotar; Vladimir,7,0,34,27
1656071781510,MATH 193A,A05,093482,Rotar; Vladimir,1,0,34,33
1656071787537,MATH 197,001,091859,McAuley; Julian John,9999,0,9999,0
1656071787537,MATH 197,002,095566,Kedlaya; Kiran S.,9997,0,9999,2
1656071787537,MATH 197,003,095567,Xiao; Ming,9999,0,9999,0
1656071787537,MATH 197,004,095571,Perols; Johan Lars,9998,0,9999,1
1656071794623,COGS 9,A01,083615,Shannon; Kyle Michael,4,1,75,71
1656071800651,COGS 11,A01,083617,Boyle; Mary E. T.,16,1,48,32
1656071806677,COGS 13,A01,083071,Bastos; Amalia Pinkusfeld,8,2,71,63
1656071812704,COGS 14A,A01,092681,Semenuks; Arturs,8,23,100,92
1656071818731,COGS 14B,A01,083073,Cheng; Tzu-Han,9,0,63,54
1656071824773,COGS 17,A01,092677,Semenuks; Arturs,13,6,81,68
1656071830830,COGS 100,A01,083619,Allen; Michael Gordon,8,1,70,62
1656071836858,COGS 101A,A01,083621,Davis; Joshua Daniel,7,3,68,61
1656071842885,COGS 101B,A01,091572,Allen; Michael Gordon,7,0,65,58
1656071848918,COGS 101C,A01,083625,Delgado; Tania,11,0,35,24
1656071854950,COGS 107A,A01,083627,Boyle; Mary E. T.,5,2,60,55
1656071860989,COGS 118A,A01,083075,Gupta; Anjum,24,16,76,52
1656071867017,CSE 3,A50,083646,Miranda; Gregory Joseph,20,0,50,30
1656071873048,CSE 8A,A50,083650,Miranda; Gregory Joseph,13,11,56,43
1656071879080,CSE 11,A01,083080,Cao; Yingjun,1,60,40,39
1656071885117,CSE 12,A01,083652,Krause-Levy; Sophia Louisa,14,7,120,106
1656071891143,CSE 15L,A01,083654,Morris; Justin Loren,5,1,50,45
1656071891143,CSE 15L,A02,083655,Morris; Justin Loren,7,0,50,43
1656071897170,CSE 20,A01,083657,Tran; Khoa Dang,31,0,80,49
1656071903196,CSE 21,A01,095574,Bach; Quang Tran,28,0,48,20
1656071909228,CSE 30,A01,083084,Eldon; John,3,10,80,77
1656071909228,CSE 30,B01,095061,Bhaskar; Nishant,4,5,50,46
1656071915255,CSE 100,A01,083659,Cao; Yingjun,2,23,70,68
1656071921282,CSE 134B,A01,083661,Powell; Thomas Allan,11,6,100,89
1656071927309,CSE 140,A01,083663,Gungor; Onat,9,0,85,76
1656071933337,CSE 140L,A01,083088,Eldon; John,8,0,100,92
1656071939365,CSE 175,A01,083665,Kumar; Rakesh,2,0,25,23
1656071945397,CSE 190,A00,092507,Dubnov; Shlomo,3,0,20,17
1656071951427,ECE 45,A01,083139,Congero; Spencer William,5,2,75,70
1656071957480,ECE 65,A50,083695,Saad; Andrew S,8,0,30,22
1656071957480,ECE 65,A51,095125,Staff,23,0,26,3
1656071963524,ECE 109,A01,091882,Touri; Behrouz,5,4,70,65
1656071969554,ECE 180,A00,083140,Abi Samra; Nicholas Camill,1,0,30,29
1656071969554,ECE 180,B00,083141,Abi Samra; Nicholas Camill,2,8,28,26
1656071975591,MATH 10A,A01,083735,Patchell; Gregory David,1,0,30,29
1656071975591,MATH 10A,A02,083736,Patchell; Gregory David,23,0,30,7
1656071975591,MATH 10A,A03,083737,Patchell; Gregory David,16,0,30,14
1656071981629,MATH 10B,A01,083207,Lim; Seonhee,3,1,34,31
1656071981629,MATH 10B,A02,083208,Lim; Seonhee,10,1,35,25
1656071981629,MATH 10B,A03,093472,Staff,4,1,34,30
1656071981629,MATH 10B,B01,083739,Sinha; Shubham,12,0,30,18
1656071987671,MATH 18,A01,083743,Cinel; Cameron Alexander,7,0,30,23
1656071987671,MATH 18,A02,083744,Cinel; Cameron Alexander,12,0,30,18
1656071987671,MATH 18,A03,083745,Cinel; Cameron Alexander,3,0,30,27
1656071987671,MATH 18,B01,083748,Ma; Zilu,1,0,36,35
1656071987671,MATH 18,B02,083749,Ma; Zilu,2,0,36,34
1656071987671,MATH 18,B03,083750,Ma; Zilu,0,0,36,36
1656071987671,MATH 18,B04,083751,Ma; Zilu,1,0,36,35
1656071987671,MATH 18,B05,093473,Staff,3,0,36,33
1656071987671,MATH 18,B06,093474,Staff,4,0,36,32
1656071993698,MATH 20A,A01,083754,Zheng; Zequn,11,0,40,29
1656071999747,MATH 20B,A01,083756,Briones; Jor-el Thomas Caparas,0,0,36,36
1656071999747,MATH 20B,A02,083757,Briones; Jor-el Thomas Caparas,3,0,36,33
1656071999747,MATH 20B,A03,093475,Staff,3,0,36,33
1656072005779,MATH 20C,A01,083760,Briones; Jor-el Thomas Caparas,2,2,35,33
1656072005779,MATH 20C,A02,083761,Briones; Jor-el Thomas Caparas,9,1,35,26
1656072005779,MATH 20C,A03,093476,Staff,1,1,35,34
1656072005779,MATH 20C,B01,083762,Bach; Quang Tran,5,0,30,25
1656072011810,MATH 20D,A01,083765,Tran; Brian Kha,3,0,30,27
1656072011810,MATH 20D,A02,083766,Tran; Brian Kha,0,1,30,30
1656072011810,MATH 20D,A03,083767,Tran; Brian Kha,2,0,30,28
1656072017854,MATH 20E,A01,083771,Ganguly; Soumya,4,1,32,28
1656072017854,MATH 20E,A02,083772,Ganguly; Soumya,2,1,32,30
1656072017854,MATH 20E,B01,083773,Ciotti; Benjamin,15,0,35,20
1656072017854,MATH 20E,B02,083774,Ciotti; Benjamin,15,0,35,20
1656072023893,MATH 103A,A01,083777,Greenfeld; Be'Eri,3,0,36,33
1656072023893,MATH 103A,A02,083778,Greenfeld; Be'Eri,3,0,36,33
1656072023893,MATH 103A,A03,093561,Staff,4,1,36,32
1656072023893,MATH 103A,B01,083779,Greenfeld; Be'Eri,8,1,36,28
1656072023893,MATH 103A,B02,083780,Greenfeld; Be'Eri,1,0,36,35
1656072023893,MATH 103A,B03,093562,Staff,1,0,36,35
1656072029921,MATH 105,A01,085443,Carter; Anne Toulson,4,1,35,31
1656072029921,MATH 105,A02,093477,Staff,12,0,35,23
1656072035954,MATH 109,A01,083213,Ganzberger; Geoffrey Michael,1,1,34,33
1656072035954,MATH 109,A02,083214,Ganzberger; Geoffrey Michael,0,0,34,34
1656072035954,MATH 109,A03,093478,Staff,3,0,34,31
1656072035954,MATH 109,B01,083215,Ganzberger; Geoffrey Michael,4,0,32,28
1656072035954,MATH 109,B02,083216,Ganzberger; Geoffrey Michael,1,0,32,31
1656072035954,MATH 109,B03,093479,Staff,4,0,32,28
1656072041997,MATH 142A,A01,083219,Chow; Bennett,2,0,32,30
1656072041997,MATH 142A,A02,083220,Chow; Bennett,8,0,32,24
1656072041997,MATH 142A,A03,093480,Staff,5,0,32,27
1656072041997,MATH 142A,B03,093481,Staff,5,0,32,27
1656072041997,MATH 142A,B04,093558,Staff,7,0,32,25
1656072041997,MATH 142A,B05,093559,Staff,0,0,32,32
1656072048022,MATH 193A,A01,083224,Rotar; Vladimir,1,2,34,33
1656072048022,MATH 193A,A02,083225,Rotar; Vladimir,3,0,34,31
1656072048022,MATH 193A,A03,083781,Rotar; Vladimir,3,0,34,31
1656072048022,MATH 193A,A04,083782,Rotar; Vladimir,7,0,34,27
1656072048022,MATH 193A,A05,093482,Rotar; Vladimir,1,0,34,33
1656072054049,MATH 197,001,091859,McAuley; Julian John,9999,0,9999,0
1656072054049,MATH 197,002,095566,Kedlaya; Kiran S.,9997,0,9999,2
1656072054049,MATH 197,003,095567,Xiao; Ming,9999,0,9999,0
1656072054049,MATH 197,004,095571,Perols; Johan Lars,9998,0,9999,1
1656072061109,COGS 9,A01,083615,Shannon; Kyle Michael,4,1,75,71
1656072067157,COGS 11,A01,083617,Boyle; Mary E. T.,16,1,48,32
1656072073184,COGS 13,A01,083071,Bastos; Amalia Pinkusfeld,8,2,71,63
1656072079215,COGS 14A,A01,092681,Semenuks; Arturs,8,23,100,92
1656072085243,COGS 14B,A01,083073,Cheng; Tzu-Han,9,0,63,54
1656072091337,COGS 17,A01,092677,Semenuks; Arturs,13,6,81,68
1656072097363,COGS 100,A01,083619,Allen; Michael Gordon,8,1,70,62
1656072103388,COGS 101A,A01,083621,Davis; Joshua Daniel,7,3,68,61
1656072109412,COGS 101B,A01,091572,Allen; Michael Gordon,7,0,65,58
1656072115447,COGS 101C,A01,083625,Delgado; Tania,11,0,35,24
1656072121482,COGS 107A,A01,083627,Boyle; Mary E. T.,5,2,60,55
1656072127528,COGS 118A,A01,083075,Gupta; Anjum,24,16,76,52
1656072133561,CSE 3,A50,083646,Miranda; Gregory Joseph,20,0,50,30
1656072139586,CSE 8A,A50,083650,Miranda; Gregory Joseph,13,11,56,43
1656072145610,CSE 11,A01,083080,Cao; Yingjun,1,60,40,39
1656072151636,CSE 12,A01,083652,Krause-Levy; Sophia Louisa,14,7,120,106
1656072157676,CSE 15L,A01,083654,Morris; Justin Loren,5,1,50,45
1656072157676,CSE 15L,A02,083655,Morris; Justin Loren,7,0,50,43
1656072163706,CSE 20,A01,083657,Tran; Khoa Dang,31,0,80,49
1656072169737,CSE 21,A01,095574,Bach; Quang Tran,28,0,48,20
1656072175796,CSE 30,A01,083084,Eldon; John,3,10,80,77
1656072175796,CSE 30,B01,095061,Bhaskar; Nishant,4,5,50,46
1656072181822,CSE 100,A01,083659,Cao; Yingjun,2,23,70,68
1656072187850,CSE 134B,A01,083661,Powell; Thomas Allan,11,6,100,89
1656072193881,CSE 140,A01,083663,Gungor; Onat,9,0,85,76
1656072199914,CSE 140L,A01,083088,Eldon; John,8,0,100,92
1656072205943,CSE 175,A01,083665,Kumar; Rakesh,2,0,25,23
1656072211969,CSE 190,A00,092507,Dubnov; Shlomo,3,0,20,17
1656072218013,ECE 45,A01,083139,Congero; Spencer William,5,2,75,70
1656072224048,ECE 65,A50,083695,Saad; Andrew S,8,0,30,22
1656072224048,ECE 65,A51,095125,Staff,23,0,26,3
1656072230078,ECE 109,A01,091882,Touri; Behrouz,5,4,70,65
1656072236200,ECE 180,A00,083140,Abi Samra; Nicholas Camill,1,0,30,29
1656072236200,ECE 180,B00,083141,Abi Samra; Nicholas Camill,2,8,28,26
1656072242235,MATH 10A,A01,083735,Patchell; Gregory David,1,0,30,29
1656072242235,MATH 10A,A02,083736,Patchell; Gregory David,23,0,30,7
1656072242235,MATH 10A,A03,083737,Patchell; Gregory David,16,0,30,14
1656072248272,MATH 10B,A01,083207,Lim; Seonhee,3,1,34,31
1656072248272,MATH 10B,A02,083208,Lim; Seonhee,10,1,35,25
1656072248272,MATH 10B,A03,093472,Staff,4,1,34,30
1656072248272,MATH 10B,B01,083739,Sinha; Shubham,12,0,30,18
1656072254302,MATH 18,A01,083743,Cinel; Cameron Alexander,7,0,30,23
1656072254302,MATH 18,A02,083744,Cinel; Cameron Alexander,12,0,30,18
1656072254302,MATH 18,A03,083745,Cinel; Cameron Alexander,3,0,30,27
1656072254302,MATH 18,B01,083748,Ma; Zilu,1,0,36,35
1656072254302,MATH 18,B02,083749,Ma; Zilu,2,0,36,34
1656072254302,MATH 18,B03,083750,Ma; Zilu,0,0,36,36
1656072254302,MATH 18,B04,083751,Ma; Zilu,1,0,36,35
1656072254302,MATH 18,B05,093473,Staff,3,0,36,33
1656072254302,MATH 18,B06,093474,Staff,4,0,36,32
1656072260328,MATH 20A,A01,083754,Zheng; Zequn,11,0,40,29
1656072266356,MATH 20B,A01,083756,Briones; Jor-el Thomas Caparas,0,0,36,36
1656072266356,MATH 20B,A02,083757,Briones; Jor-el Thomas Caparas,3,0,36,33
1656072266356,MATH 20B,A03,093475,Staff,3,0,36,33
1656072272384,MATH 20C,A01,083760,Briones; Jor-el Thomas Caparas,2,2,35,33
1656072272384,MATH 20C,A02,083761,Briones; Jor-el Thomas Caparas,9,1,35,26
1656072272384,MATH 20C,A03,093476,Staff,1,1,35,34
1656072272384,MATH 20C,B01,083762,Bach; Quang Tran,5,0,30,25
1656072278417,MATH 20D,A01,083765,Tran; Brian Kha,3,0,30,27
1656072278417,MATH 20D,A02,083766,Tran; Brian Kha,0,1,30,30
1656072278417,MATH 20D,A03,083767,Tran; Brian Kha,2,0,30,28
1656072284446,MATH 20E,A01,083771,Ganguly; Soumya,4,1,32,28
1656072284446,MATH 20E,A02,083772,Ganguly; Soumya,2,1,32,30
1656072284446,MATH 20E,B01,083773,Ciotti; Benjamin,15,0,35,20
1656072284446,MATH 20E,B02,083774,Ciotti; Benjamin,15,0,35,20
1656072290477,MATH 103A,A01,083777,Greenfeld; Be'Eri,3,0,36,33
1656072290477,MATH 103A,A02,083778,Greenfeld; Be'Eri,3,0,36,33
1656072290477,MATH 103A,A03,093561,Staff,4,1,36,32
1656072290477,MATH 103A,B01,083779,Greenfeld; Be'Eri,8,1,36,28
1656072290477,MATH 103A,B02,083780,Greenfeld; Be'Eri,1,0,36,35
1656072290477,MATH 103A,B03,093562,Staff,1,0,36,35
1656072296504,MATH 105,A01,085443,Carter; Anne Toulson,4,1,35,31
1656072296504,MATH 105,A02,093477,Staff,12,0,35,23
1656072302532,MATH 109,A01,083213,Ganzberger; Geoffrey Michael,1,1,34,33
1656072302532,MATH 109,A02,083214,Ganzberger; Geoffrey Michael,0,0,34,34
1656072302532,MATH 109,A03,093478,Staff,3,0,34,31
1656072302532,MATH 109,B01,083215,Ganzberger; Geoffrey Michael,4,0,32,28
1656072302532,MATH 109,B02,083216,Ganzberger; Geoffrey Michael,1,0,32,31
1656072302532,MATH 109,B03,093479,Staff,4,0,32,28
1656072308568,MATH 142A,A01,083219,Chow; Bennett,2,0,32,30
1656072308568,MATH 142A,A02,083220,Chow; Bennett,8,0,32,24
1656072308568,MATH 142A,A03,093480,Staff,5,0,32,27
1656072308568,MATH 142A,B03,093481,Staff,5,0,32,27
1656072308568,MATH 142A,B04,093558,Staff,7,0,32,25
1656072308568,MATH 142A,B05,093559,Staff,0,0,32,32
1656072314598,MATH 193A,A01,083224,Rotar; Vladimir,1,2,34,33
1656072314598,MATH 193A,A02,083225,Rotar; Vladimir,3,0,34,31
1656072314598,MATH 193A,A03,083781,Rotar; Vladimir,3,0,34,31
1656072314598,MATH 193A,A04,083782,Rotar; Vladimir,7,0,34,27
1656072314598,MATH 193A,A05,093482,Rotar; Vladimir,1,0,34,33
1656072320626,MATH 197,001,091859,McAuley; Julian John,9999,0,9999,0
1656072320626,MATH 197,002,095566,Kedlaya; Kiran S.,9997,0,9999,2
1656072320626,MATH 197,003,095567,Xiao; Ming,9999,0,9999,0
1656072320626,MATH 197,004,095571,Perols; Johan Lars,9998,0,9999,1
1656072327696,COGS 9,A01,083615,Shannon; Kyle Michael,4,1,75,71
1656072333728,COGS 11,A01,083617,Boyle; Mary E. T.,16,1,48,32
1656072339756,COGS 13,A01,083071,Bastos; Amalia Pinkusfeld,8,2,71,63
1656072345783,COGS 14A,A01,092681,Semenuks; Arturs,8,23,100,92
1656072351810,COGS 14B,A01,083073,Cheng; Tzu-Han,9,0,63,54
1656072357842,COGS 17,A01,092677,Semenuks; Arturs,13,6,81,68
1656072363869,COGS 100,A01,083619,Allen; Michael Gordon,8,1,70,62
1656072369897,COGS 101A,A01,083621,Davis; Joshua Daniel,7,3,68,61
1656072375924,COGS 101B,A01,091572,Allen; Michael Gordon,7,0,65,58
1656072381952,COGS 101C,A01,083625,Delgado; Tania,11,0,35,24
1656072387989,COGS 107A,A01,083627,Boyle; Mary E. T.,5,2,60,55
1656072394020,COGS 118A,A01,083075,Gupta; Anjum,24,16,76,52
1656072400056,CSE 3,A50,083646,Miranda; Gregory Joseph,20,0,50,30
1656072406084,CSE 8A,A50,083650,Miranda; Gregory Joseph,13,11,56,43
1656072412115,CSE 11,A01,083080,Cao; Yingjun,1,60,40,39
1656072418142,CSE 12,A01,083652,Krause-Levy; Sophia Louisa,14,7,120,106
1656072424173,CSE 15L,A01,083654,Morris; Justin Loren,5,1,50,45
1656072424173,CSE 15L,A02,083655,Morris; Justin Loren,7,0,50,43
1656072430207,CSE 20,A01,083657,Tran; Khoa Dang,31,0,80,49
1656072436234,CSE 21,A01,095574,Bach; Quang Tran,28,0,48,20
1656072442271,CSE 30,A01,083084,Eldon; John,3,10,80,77
1656072442271,CSE 30,B01,095061,Bhaskar; Nishant,4,5,50,46
1656072448301,CSE 100,A01,083659,Cao; Yingjun,2,23,70,68
1656072454328,CSE 134B,A01,083661,Powell; Thomas Allan,11,6,100,89
1656072460354,CSE 140,A01,083663,Gungor; Onat,9,0,85,76
1656072466384,CSE 140L,A01,083088,Eldon; John,8,0,100,92
1656072472409,CSE 175,A01,083665,Kumar; Rakesh,2,0,25,23
1656072478441,CSE 190,A00,092507,Dubnov; Shlomo,3,0,20,17
1656072484473,ECE 45,A01,083139,Congero; Spencer William,5,2,75,70
1656072490504,ECE 65,A50,083695,Saad; Andrew S,8,0,30,22
1656072490504,ECE 65,A51,095125,Staff,23,0,26,3
1656072496542,ECE 109,A01,091882,Touri; Behrouz,5,4,70,65
1656072502600,ECE 180,A00,083140,Abi Samra; Nicholas Camill,1,0,30,29
1656072502600,ECE 180,B00,083141,Abi Samra; Nicholas Camill,2,8,28,26
1656072508636,MATH 10A,A01,083735,Patchell; Gregory David,1,0,30,29
1656072508636,MATH 10A,A02,083736,Patchell; Gregory David,23,0,30,7
1656072508636,MATH 10A,A03,083737,Patchell; Gregory David,16,0,30,14
1656072514667,MATH 10B,A01,083207,Lim; Seonhee,3,1,34,31
1656072514667,MATH 10B,A02,083208,Lim; Seonhee,10,1,35,25
1656072514667,MATH 10B,A03,093472,Staff,4,1,34,30
1656072514667,MATH 10B,B01,083739,Sinha; Shubham,12,0,30,18
1656072520699,MATH 18,A01,083743,Cinel; Cameron Alexander,7,0,30,23
1656072520699,MATH 18,A02,083744,Cinel; Cameron Alexander,12,0,30,18
1656072520699,MATH 18,A03,083745,Cinel; Cameron Alexander,3,0,30,27
1656072520699,MATH 18,B01,083748,Ma; Zilu,1,0,36,35
1656072520699,MATH 18,B02,083749,Ma; Zilu,2,0,36,34
1656072520699,MATH 18,B03,083750,Ma; Zilu,0,0,36,36
1656072520699,MATH 18,B04,083751,Ma; Zilu,1,0,36,35
1656072520699,MATH 18,B05,093473,Staff,3,0,36,33
1656072520699,MATH 18,B06,093474,Staff,4,0,36,32
1656072526731,MATH 20A,A01,083754,Zheng; Zequn,11,0,40,29
1656072532761,MATH 20B,A01,083756,Briones; Jor-el Thomas Caparas,0,0,36,36
1656072532761,MATH 20B,A02,083757,Briones; Jor-el Thomas Caparas,3,0,36,33
1656072532761,MATH 20B,A03,093475,Staff,3,0,36,33
1656072538789,MATH 20C,A01,083760,Briones; Jor-el Thomas Caparas,2,2,35,33
1656072538789,MATH 20C,A02,083761,Briones; Jor-el Thomas Caparas,9,1,35,26
1656072538789,MATH 20C,A03,093476,Staff,1,1,35,34
1656072538789,MATH 20C,B01,083762,Bach; Quang Tran,5,0,30,25
1656072544815,MATH 20D,A01,083765,Tran; Brian Kha,3,0,30,27
1656072544815,MATH 20D,A02,083766,Tran; Brian Kha,0,1,30,30
1656072544815,MATH 20D,A03,083767,Tran; Brian Kha,2,0,30,28
1656072550853,MATH 20E,A01,083771,Ganguly; Soumya,4,1,32,28
1656072550853,MATH 20E,A02,083772,Ganguly; Soumya,2,1,32,30
1656072550853,MATH 20E,B01,083773,Ciotti; Benjamin,15,0,35,20
1656072550853,MATH 20E,B02,083774,Ciotti; Benjamin,15,0,35,20
1656072556881,MATH 103A,A01,083777,Greenfeld; Be'Eri,3,0,36,33
1656072556881,MATH 103A,A02,083778,Greenfeld; Be'Eri,3,0,36,33
1656072556881,MATH 103A,A03,093561,Staff,4,1,36,32
1656072556881,MATH 103A,B01,083779,Greenfeld; Be'Eri,8,1,36,28
1656072556881,MATH 103A,B02,083780,Greenfeld; Be'Eri,1,0,36,35
1656072556881,MATH 103A,B03,093562,Staff,1,0,36,35
1656072562914,MATH 105,A01,085443,Carter; Anne Toulson,4,1,35,31
1656072562914,MATH 105,A02,093477,Staff,12,0,35,23
1656072568949,MATH 109,A01,083213,Ganzberger; Geoffrey Michael,1,1,34,33
1656072568949,MATH 109,A02,083214,Ganzberger; Geoffrey Michael,0,0,34,34
1656072568949,MATH 109,A03,093478,Staff,3,0,34,31
1656072568949,MATH 109,B01,083215,Ganzberger; Geoffrey Michael,4,0,32,28
1656072568949,MATH 109,B02,083216,Ganzberger; Geoffrey Michael,1,0,32,31
1656072568949,MATH 109,B03,093479,Staff,4,0,32,28
1656072574995,MATH 142A,A01,083219,Chow; Bennett,2,0,32,30
1656072574995,MATH 142A,A02,083220,Chow; Bennett,8,0,32,24
1656072574995,MATH 142A,A03,093480,Staff,5,0,32,27
1656072574995,MATH 142A,B03,093481,Staff,5,0,32,27
1656072574995,MATH 142A,B04,093558,Staff,7,0,32,25
1656072574995,MATH 142A,B05,093559,Staff,0,0,32,32
1656072581025,MATH 193A,A01,083224,Rotar; Vladimir,1,2,34,33
1656072581025,MATH 193A,A02,083225,Rotar; Vladimir,3,0,34,31
1656072581025,MATH 193A,A03,083781,Rotar; Vladimir,3,0,34,31
1656072581025,MATH 193A,A04,083782,Rotar; Vladimir,7,0,34,27
1656072581025,MATH 193A,A05,093482,Rotar; Vladimir,1,0,34,33
1656072587053,MATH 197,001,091859,McAuley; Julian John,9999,0,9999,0
1656072587053,MATH 197,002,095566,Kedlaya; Kiran S.,9997,0,9999,2
1656072587053,MATH 197,003,095567,Xiao; Ming,9999,0,9999,0
1656072587053,MATH 197,004,095571,Perols; Johan Lars,9998,0,9999,1
1656072594135,COGS 9,A01,083615,Shannon; Kyle Michael,4,1,75,71
1656072600173,COGS 11,A01,083617,Boyle; Mary E. T.,16,1,48,32
1656072606198,COGS 13,A01,083071,Bastos; Amalia Pinkusfeld,8,2,71,63
1656072612225,COGS 14A,A01,092681,Semenuks; Arturs,8,23,100,92
1656072618250,COGS 14B,A01,083073,Cheng; Tzu-Han,9,0,63,54
1656072624277,COGS 17,A01,092677,Semenuks; Arturs,13,6,81,68
1656072630306,COGS 100,A01,083619,Allen; Michael Gordon,8,1,70,62
1656072636340,COGS 101A,A01,083621,Davis; Joshua Daniel,7,3,68,61
1656072642375,COGS 101B,A01,091572,Allen; Michael Gordon,7,0,65,58
1656072648401,COGS 101C,A01,083625,Delgado; Tania,11,0,35,24
1656072654434,COGS 107A,A01,083627,Boyle; Mary E. T.,5,2,60,55
1656072660469,COGS 118A,A01,083075,Gupta; Anjum,24,16,76,52
1656072666498,CSE 3,A50,083646,Miranda; Gregory Joseph,20,0,50,30
1656072672524,CSE 8A,A50,083650,Miranda; Gregory Joseph,13,11,56,43
1656072678552,CSE 11,A01,083080,Cao; Yingjun,1,60,40,39
1656072684581,CSE 12,A01,083652,Krause-Levy; Sophia Louisa,14,7,120,106
1656072690612,CSE 15L,A01,083654,Morris; Justin Loren,5,1,50,45
1656072690612,CSE 15L,A02,083655,Morris; Justin Loren,7,0,50,43
1656072696638,CSE 20,A01,083657,Tran; Khoa Dang,31,0,80,49
1656072702666,CSE 21,A01,095574,Bach; Quang Tran,28,0,48,20
1656072708694,CSE 30,A01,083084,Eldon; John,3,10,80,77
1656072708694,CSE 30,B01,095061,Bhaskar; Nishant,4,5,50,46
1656072714722,CSE 100,A01,083659,Cao; Yingjun,2,23,70,68
1656072720748,CSE 134B,A01,083661,Powell; Thomas Allan,11,6,100,89
1656072726786,CSE 140,A01,083663,Gungor; Onat,9,0,85,76
1656072732817,CSE 140L,A01,083088,Eldon; John,8,0,100,92
1656072738843,CSE 175,A01,083665,Kumar; Rakesh,2,0,25,23
1656072744873,CSE 190,A00,092507,Dubnov; Shlomo,3,0,20,17
1656072750900,ECE 45,A01,083139,Congero; Spencer William,5,2,75,70
1656072756928,ECE 65,A50,083695,Saad; Andrew S,8,0,30,22
1656072756928,ECE 65,A51,095125,Staff,23,0,26,3
1656072762961,ECE 109,A01,091882,Touri; Behrouz,5,4,70,65
1656072768994,ECE 180,A00,083140,Abi Samra; Nicholas Camill,1,0,30,29
1656072768994,ECE 180,B00,083141,Abi Samra; Nicholas Camill,2,8,28,26
1656072775026,MATH 10A,A01,083735,Patchell; Gregory David,1,0,30,29
1656072775026,MATH 10A,A02,083736,Patchell; Gregory David,23,0,30,7
1656072775026,MATH 10A,A03,083737,Patchell; Gregory David,16,0,30,14
1656072781054,MATH 10B,A01,083207,Lim; Seonhee,3,1,34,31
1656072781054,MATH 10B,A02,083208,Lim; Seonhee,10,1,35,25
1656072781054,MATH 10B,A03,093472,Staff,4,1,34,30
1656072781054,MATH 10B,B01,083739,Sinha; Shubham,12,0,30,18
1656072787097,MATH 18,A01,083743,Cinel; Cameron Alexander,7,0,30,23
1656072787097,MATH 18,A02,083744,Cinel; Cameron Alexander,12,0,30,18
1656072787097,MATH 18,A03,083745,Cinel; Cameron Alexander,3,0,30,27
1656072787097,MATH 18,B01,083748,Ma; Zilu,1,0,36,35
1656072787097,MATH 18,B02,083749,Ma; Zilu,2,0,36,34
1656072787097,MATH 18,B03,083750,Ma; Zilu,0,0,36,36
1656072787097,MATH 18,B04,083751,Ma; Zilu,1,0,36,35
1656072787097,MATH 18,B05,093473,Staff,3,0,36,33
1656072787097,MATH 18,B06,093474,Staff,4,0,36,32
1656072793129,MATH 20A,A01,083754,Zheng; Zequn,11,0,40,29
1656072799156,MATH 20B,A01,083756,Briones; Jor-el Thomas Caparas,0,0,36,36
1656072799156,MATH 20B,A02,083757,Briones; Jor-el Thomas Caparas,3,0,36,33
1656072799156,MATH 20B,A03,093475,Staff,3,0,36,33
1656072805190,MATH 20C,A01,083760,Briones; Jor-el Thomas Caparas,2,2,35,33
1656072805190,MATH 20C,A02,083761,Briones; Jor-el Thomas Caparas,9,1,35,26
1656072805190,MATH 20C,A03,093476,Staff,1,1,35,34
1656072805190,MATH 20C,B01,083762,Bach; Quang Tran,5,0,30,25
1656072811218,MATH 20D,A01,083765,Tran; Brian Kha,3,0,30,27
1656072811218,MATH 20D,A02,083766,Tran; Brian Kha,0,1,30,30
1656072811218,MATH 20D,A03,083767,Tran; Brian Kha,2,0,30,28
1656072817252,MATH 20E,A01,083771,Ganguly; Soumya,4,1,32,28
1656072817252,MATH 20E,A02,083772,Ganguly; Soumya,2,1,32,30
1656072817252,MATH 20E,B01,083773,Ciotti; Benjamin,15,0,35,20
1656072817252,MATH 20E,B02,083774,Ciotti; Benjamin,15,0,35,20
1656072823282,MATH 103A,A01,083777,Greenfeld; Be'Eri,3,0,36,33
1656072823282,MATH 103A,A02,083778,Greenfeld; Be'Eri,3,0,36,33
1656072823282,MATH 103A,A03,093561,Staff,4,1,36,32
1656072823282,MATH 103A,B01,083779,Greenfeld; Be'Eri,8,1,36,28
1656072823282,MATH 103A,B02,083780,Greenfeld; Be'Eri,1,0,36,35
1656072823282,MATH 103A,B03,093562,Staff,1,0,36,35
1656072829309,MATH 105,A01,085443,Carter; Anne Toulson,4,1,35,31
1656072829309,MATH 105,A02,093477,Staff,12,0,35,23
1656072835428,MATH 109,A01,083213,Ganzberger; Geoffrey Michael,1,1,34,33
1656072835428,MATH 109,A02,083214,Ganzberger; Geoffrey Michael,0,0,34,34
1656072835428,MATH 109,A03,093478,Staff,3,0,34,31
1656072835428,MATH 109,B01,083215,Ganzberger; Geoffrey Michael,4,0,32,28
1656072835428,MATH 109,B02,083216,Ganzberger; Geoffrey Michael,1,0,32,31
1656072835428,MATH 109,B03,093479,Staff,4,0,32,28
1656072841457,MATH 142A,A01,083219,Chow; Bennett,2,0,32,30
1656072841457,MATH 142A,A02,083220,Chow; Bennett,8,0,32,24
1656072841457,MATH 142A,A03,093480,Staff,5,0,32,27
1656072841457,MATH 142A,B03,093481,Staff,5,0,32,27
1656072841457,MATH 142A,B04,093558,Staff,7,0,32,25
1656072841457,MATH 142A,B05,093559,Staff,0,0,32,32
1656072847488,MATH 193A,A01,083224,Rotar; Vladimir,1,2,34,33
1656072847488,MATH 193A,A02,083225,Rotar; Vladimir,3,0,34,31
1656072847488,MATH 193A,A03,083781,Rotar; Vladimir,3,0,34,31
1656072847488,MATH 193A,A04,083782,Rotar; Vladimir,7,0,34,27
1656072847488,MATH 193A,A05,093482,Rotar; Vladimir,1,0,34,33
1656072853524,MATH 197,001,091859,McAuley; Julian John,9999,0,9999,0
1656072853524,MATH 197,002,095566,Kedlaya; Kiran S.,9997,0,9999,2
1656072853524,MATH 197,003,095567,Xiao; Ming,9999,0,9999,0
1656072853524,MATH 197,004,095571,Perols; Johan Lars,9998,0,9999,1
1656072860605,COGS 9,A01,083615,Shannon; Kyle Michael,4,1,75,71
1656072866631,COGS 11,A01,083617,Boyle; Mary E. T.,16,1,48,32
1656072872663,COGS 13,A01,083071,Bastos; Amalia Pinkusfeld,8,2,71,63
1656072878691,COGS 14A,A01,092681,Semenuks; Arturs,8,23,100,92
1656072884721,COGS 14B,A01,083073,Cheng; Tzu-Han,9,0,63,54
1656072890750,COGS 17,A01,092677,Semenuks; Arturs,13,6,81,68
1656072896778,COGS 100,A01,083619,Allen; Michael Gordon,8,1,70,62
1656072902808,COGS 101A,A01,083621,Davis; Joshua Daniel,7,3,68,61
1656072908833,COGS 101B,A01,091572,Allen; Michael Gordon,7,0,65,58
1656072914859,COGS 101C,A01,083625,Delgado; Tania,11,0,35,24
1656072920888,COGS 107A,A01,083627,Boyle; Mary E. T.,5,2,60,55
1656072926913,COGS 118A,A01,083075,Gupta; Anjum,24,16,76,52
1656072932949,CSE 3,A50,083646,Miranda; Gregory Joseph,20,0,50,30
1656072938980,CSE 8A,A50,083650,Miranda; Gregory Joseph,13,11,56,43
1656072945024,CSE 11,A01,083080,Cao; Yingjun,1,60,40,39
1656072951056,CSE 12,A01,083652,Krause-Levy; Sophia Louisa,14,7,120,106
1656072957083,CSE 15L,A01,083654,Morris; Justin Loren,5,1,50,45
1656072957083,CSE 15L,A02,083655,Morris; Justin Loren,7,0,50,43
1656072963110,CSE 20,A01,083657,Tran; Khoa Dang,31,0,80,49
1656072969136,CSE 21,A01,095574,Bach; Quang Tran,28,0,48,20
1656072975164,CSE 30,A01,083084,Eldon; John,3,10,80,77
1656072975164,CSE 30,B01,095061,Bhaskar; Nishant,4,5,50,46
1656072981199,CSE 100,A01,083659,Cao; Yingjun,2,23,70,68
1656072987225,CSE 134B,A01,083661,Powell; Thomas Allan,11,6,100,89
1656072993263,CSE 140,A01,083663,Gungor; Onat,9,0,85,76
1656072999295,CSE 140L,A01,083088,Eldon; John,8,0,100,92
1656073005329,CSE 175,A01,083665,Kumar; Rakesh,2,0,25,23
1656073011363,CSE 190,A00,092507,Dubnov; Shlomo,3,0,20,17
1656073017390,ECE 45,A01,083139,Congero; Spencer William,5,2,75,70
1656073023424,ECE 65,A50,083695,Saad; Andrew S,8,0,30,22
1656073023424,ECE 65,A51,095125,Staff,23,0,26,3
1656073029462,ECE 109,A01,091882,Touri; Behrouz,5,4,70,65
1656073035490,ECE 180,A00,083140,Abi Samra; Nicholas Camill,1,0,30,29
1656073035490,ECE 180,B00,083141,Abi Samra; Nicholas Camill,2,8,28,26
1656073041527,MATH 10A,A01,083735,Patchell; Gregory David,1,0,30,29
1656073041527,MATH 10A,A02,083736,Patchell; Gregory David,23,0,30,7
1656073041527,MATH 10A,A03,083737,Patchell; Gregory David,16,0,30,14
1656073047556,MATH 10B,A01,083207,Lim; Seonhee,3,1,34,31
1656073047556,MATH 10B,A02,083208,Lim; Seonhee,10,1,35,25
1656073047556,MATH 10B,A03,093472,Staff,4,1,34,30
1656073047556,MATH 10B,B01,083739,Sinha; Shubham,12,0,30,18
1656073053587,MATH 18,A01,083743,Cinel; Cameron Alexander,7,0,30,23
1656073053587,MATH 18,A02,083744,Cinel; Cameron Alexander,12,0,30,18
1656073053587,MATH 18,A03,083745,Cinel; Cameron Alexander,3,0,30,27
1656073053587,MATH 18,B01,083748,Ma; Zilu,1,0,36,35
1656073053587,MATH 18,B02,083749,Ma; Zilu,2,0,36,34
1656073053587,MATH 18,B03,083750,Ma; Zilu,0,0,36,36
1656073053587,MATH 18,B04,083751,Ma; Zilu,1,0,36,35
1656073053587,MATH 18,B05,093473,Staff,3,0,36,33
1656073053587,MATH 18,B06,093474,Staff,4,0,36,32
1656073059620,MATH 20A,A01,083754,Zheng; Zequn,11,0,40,29
1656073065656,MATH 20B,A01,083756,Briones; Jor-el Thomas Caparas,0,0,36,36
1656073065656,MATH 20B,A02,083757,Briones; Jor-el Thomas Caparas,3,0,36,33
1656073065656,MATH 20B,A03,093475,Staff,3,0,36,33
1656073071683,MATH 20C,A01,083760,Briones; Jor-el Thomas Caparas,2,2,35,33
1656073071683,MATH 20C,A02,083761,Briones; Jor-el Thomas Caparas,9,1,35,26
1656073071683,MATH 20C,A03,093476,Staff,1,1,35,34
1656073071683,MATH 20C,B01,083762,Bach; Quang Tran,5,0,30,25
1656073077715,MATH 20D,A01,083765,Tran; Brian Kha,3,0,30,27
1656073077715,MATH 20D,A02,083766,Tran; Brian Kha,0,1,30,30
1656073077715,MATH 20D,A03,083767,Tran; Brian Kha,2,0,30,28
1656073083753,MATH 20E,A01,083771,Ganguly; Soumya,4,1,32,28
1656073083753,MATH 20E,A02,083772,Ganguly; Soumya,2,1,32,30
1656073083753,MATH 20E,B01,083773,Ciotti; Benjamin,15,0,35,20
1656073083753,MATH 20E,B02,083774,Ciotti; Benjamin,15,0,35,20
1656073089781,MATH 103A,A01,083777,Greenfeld; Be'Eri,3,0,36,33
1656073089781,MATH 103A,A02,083778,Greenfeld; Be'Eri,3,0,36,33
1656073089781,MATH 103A,A03,093561,Staff,4,1,36,32
1656073089781,MATH 103A,B01,083779,Greenfeld; Be'Eri,8,1,36,28
1656073089781,MATH 103A,B02,083780,Greenfeld; Be'Eri,1,0,36,35
1656073089781,MATH 103A,B03,093562,Staff,1,0,36,35
1656073095815,MATH 105,A01,085443,Carter; Anne Toulson,4,1,35,31
1656073095815,MATH 105,A02,093477,Staff,12,0,35,23
1656073101855,MATH 109,A01,083213,Ganzberger; Geoffrey Michael,1,1,34,33
1656073101855,MATH 109,A02,083214,Ganzberger; Geoffrey Michael,0,0,34,34
1656073101855,MATH 109,A03,093478,Staff,3,0,34,31
1656073101855,MATH 109,B01,083215,Ganzberger; Geoffrey Michael,4,0,32,28
1656073101855,MATH 109,B02,083216,Ganzberger; Geoffrey Michael,1,0,32,31
1656073101855,MATH 109,B03,093479,Staff,4,0,32,28
1656073107884,MATH 142A,A01,083219,Chow; Bennett,2,0,32,30
1656073107884,MATH 142A,A02,083220,Chow; Bennett,8,0,32,24
1656073107884,MATH 142A,A03,093480,Staff,5,0,32,27
1656073107884,MATH 142A,B03,093481,Staff,5,0,32,27
1656073107884,MATH 142A,B04,093558,Staff,7,0,32,25
1656073107884,MATH 142A,B05,093559,Staff,0,0,32,32
1656073113912,MATH 193A,A01,083224,Rotar; Vladimir,1,2,34,33
1656073113912,MATH 193A,A02,083225,Rotar; Vladimir,3,0,34,31
1656073113912,MATH 193A,A03,083781,Rotar; Vladimir,3,0,34,31
1656073113912,MATH 193A,A04,083782,Rotar; Vladimir,7,0,34,27
1656073113912,MATH 193A,A05,093482,Rotar; Vladimir,1,0,34,33
1656073119947,MATH 197,001,091859,McAuley; Julian John,9999,0,9999,0
1656073119947,MATH 197,002,095566,Kedlaya; Kiran S.,9997,0,9999,2
1656073119947,MATH 197,003,095567,Xiao; Ming,9999,0,9999,0
1656073119947,MATH 197,004,095571,Perols; Johan Lars,9998,0,9999,1
1656073127020,COGS 9,A01,083615,Shannon; Kyle Michael,4,1,75,71
1656073133049,COGS 11,A01,083617,Boyle; Mary E. T.,16,1,48,32
1656073139081,COGS 13,A01,083071,Bastos; Amalia Pinkusfeld,8,2,71,63
1656073145113,COGS 14A,A01,092681,Semenuks; Arturs,8,23,100,92
1656073151139,COGS 14B,A01,083073,Cheng; Tzu-Han,9,0,63,54
1656073157176,COGS 17,A01,092677,Semenuks; Arturs,13,6,81,68
1656073163206,COGS 100,A01,083619,Allen; Michael Gordon,8,1,70,62
1656073169232,COGS 101A,A01,083621,Davis; Joshua Daniel,7,3,68,61
1656073175262,COGS 101B,A01,091572,Allen; Michael Gordon,7,0,65,58
1656073181291,COGS 101C,A01,083625,Delgado; Tania,11,0,35,24
1656073187317,COGS 107A,A01,083627,Boyle; Mary E. T.,5,2,60,55
1656073193348,COGS 118A,A01,083075,Gupta; Anjum,24,16,76,52
1656073199381,CSE 3,A50,083646,Miranda; Gregory Joseph,20,0,50,30
1656073205412,CSE 8A,A50,083650,Miranda; Gregory Joseph,13,11,56,43
1656073211442,CSE 11,A01,083080,Cao; Yingjun,1,60,40,39
1656073217470,CSE 12,A01,083652,Krause-Levy; Sophia Louisa,14,7,120,106
1656073223497,CSE 15L,A01,083654,Morris; Justin Loren,5,1,50,45
1656073223497,CSE 15L,A02,083655,Morris; Justin Loren,7,0,50,43
1656073229526,CSE 20,A01,083657,Tran; Khoa Dang,31,0,80,49
1656073235559,CSE 21,A01,095574,Bach; Quang Tran,28,0,48,20
1656073241585,CSE 30,A01,083084,Eldon; John,3,10,80,77
1656073241585,CSE 30,B01,095061,Bhaskar; Nishant,4,5,50,46
1656073247610,CSE 100,A01,083659,Cao; Yingjun,2,23,70,68
1656073253635,CSE 134B,A01,083661,Powell; Thomas Allan,11,6,100,89
1656073259661,CSE 140,A01,083663,Gungor; Onat,9,0,85,76
1656073265687,CSE 140L,A01,083088,Eldon; John,8,0,100,92
1656073271726,CSE 175,A01,083665,Kumar; Rakesh,2,0,25,23
1656073277752,CSE 190,A00,092507,Dubnov; Shlomo,3,0,20,17
1656073283778,ECE 45,A01,083139,Congero; Spencer William,5,2,75,70
1656073289809,ECE 65,A50,083695,Saad; Andrew S,8,0,30,22
1656073289809,ECE 65,A51,095125,Staff,23,0,26,3
1656073295840,ECE 109,A01,091882,Touri; Behrouz,5,4,70,65
1656073301867,ECE 180,A00,083140,Abi Samra; Nicholas Camill,1,0,30,29
1656073301867,ECE 180,B00,083141,Abi Samra; Nicholas Camill,2,8,28,26
1656073307895,MATH 10A,A01,083735,Patchell; Gregory David,1,0,30,29
1656073307895,MATH 10A,A02,083736,Patchell; Gregory David,23,0,30,7
1656073307895,MATH 10A,A03,083737,Patchell; Gregory David,16,0,30,14
1656073313930,MATH 10B,A01,083207,Lim; Seonhee,3,1,34,31
1656073313930,MATH 10B,A02,083208,Lim; Seonhee,10,1,35,25
1656073313930,MATH 10B,A03,093472,Staff,4,1,34,30
1656073313930,MATH 10B,B01,083739,Sinha; Shubham,12,0,30,18
1656073319965,MATH 18,A01,083743,Cinel; Cameron Alexander,7,0,30,23
1656073319965,MATH 18,A02,083744,Cinel; Cameron Alexander,12,0,30,18
1656073319965,MATH 18,A03,083745,Cinel; Cameron Alexander,3,0,30,27
1656073319965,MATH 18,B01,083748,Ma; Zilu,1,0,36,35
1656073319965,MATH 18,B02,083749,Ma; Zilu,2,0,36,34
1656073319965,MATH 18,B03,083750,Ma; Zilu,0,0,36,36
1656073319965,MATH 18,B04,083751,Ma; Zilu,1,0,36,35
1656073319965,MATH 18,B05,093473,Staff,3,0,36,33
1656073319965,MATH 18,B06,093474,Staff,4,0,36,32
1656073326003,MATH 20A,A01,083754,Zheng; Zequn,11,0,40,29
1656073332028,MATH 20B,A01,083756,Briones; Jor-el Thomas Caparas,0,0,36,36
1656073332028,MATH 20B,A02,083757,Briones; Jor-el Thomas Caparas,3,0,36,33
1656073332028,MATH 20B,A03,093475,Staff,3,0,36,33
1656073338056,MATH 20C,A01,083760,Briones; Jor-el Thomas Caparas,2,2,35,33
1656073338056,MATH 20C,A02,083761,Briones; Jor-el Thomas Caparas,9,1,35,26
1656073338056,MATH 20C,A03,093476,Staff,1,1,35,34
1656073338056,MATH 20C,B01,083762,Bach; Quang Tran,5,0,30,25
1656073344094,MATH 20D,A01,083765,Tran; Brian Kha,3,0,30,27
1656073344094,MATH 20D,A02,083766,Tran; Brian Kha,0,1,30,30
1656073344094,MATH 20D,A03,083767,Tran; Brian Kha,2,0,30,28
1656073350128,MATH 20E,A01,083771,Ganguly; Soumya,4,1,32,28
1656073350128,MATH 20E,A02,083772,Ganguly; Soumya,2,1,32,30
1656073350128,MATH 20E,B01,083773,Ciotti; Benjamin,15,0,35,20
1656073350128,MATH 20E,B02,083774,Ciotti; Benjamin,15,0,35,20
1656073356154,MATH 103A,A01,083777,Greenfeld; Be'Eri,3,0,36,33
1656073356154,MATH 103A,A02,083778,Greenfeld; Be'Eri,3,0,36,33
1656073356154,MATH 103A,A03,093561,Staff,4,1,36,32
1656073356154,MATH 103A,B01,083779,Greenfeld; Be'Eri,8,1,36,28
1656073356154,MATH 103A,B02,083780,Greenfeld; Be'Eri,1,0,36,35
1656073356154,MATH 103A,B03,093562,Staff,1,0,36,35
1656073362185,MATH 105,A01,085443,Carter; Anne Toulson,4,1,35,31
1656073362185,MATH 105,A02,093477,Staff,12,0,35,23
1656073368211,MATH 109,A01,083213,Ganzberger; Geoffrey Michael,1,1,34,33
1656073368211,MATH 109,A02,083214,Ganzberger; Geoffrey Michael,0,0,34,34
1656073368211,MATH 109,A03,093478,Staff,3,0,34,31
1656073368211,MATH 109,B01,083215,Ganzberger; Geoffrey Michael,4,0,32,28
1656073368211,MATH 109,B02,083216,Ganzberger; Geoffrey Michael,1,0,32,31
1656073368211,MATH 109,B03,093479,Staff,4,0,32,28
1656073374238,MATH 142A,A01,083219,Chow; Bennett,2,0,32,30
1656073374238,MATH 142A,A02,083220,Chow; Bennett,8,0,32,24
1656073374238,MATH 142A,A03,093480,Staff,5,0,32,27
1656073374238,MATH 142A,B03,093481,Staff,5,0,32,27
1656073374238,MATH 142A,B04,093558,Staff,7,0,32,25
1656073374238,MATH 142A,B05,093559,Staff,0,0,32,32
1656073380268,MATH 193A,A01,083224,Rotar; Vladimir,1,2,34,33
1656073380268,MATH 193A,A02,083225,Rotar; Vladimir,3,0,34,31
1656073380268,MATH 193A,A03,083781,Rotar; Vladimir,3,0,34,31
1656073380268,MATH 193A,A04,083782,Rotar; Vladimir,7,0,34,27
1656073380268,MATH 193A,A05,093482,Rotar; Vladimir,1,0,34,33
1656073386294,MATH 197,001,091859,McAuley; Julian John,9999,0,9999,0
1656073386294,MATH 197,002,095566,Kedlaya; Kiran S.,9997,0,9999,2
1656073386294,MATH 197,003,095567,Xiao; Ming,9999,0,9999,0
1656073386294,MATH 197,004,095571,Perols; Johan Lars,9998,0,9999,1
1656073393360,COGS 9,A01,083615,Shannon; Kyle Michael,4,1,75,71
1656073399387,COGS 11,A01,083617,Boyle; Mary E. T.,16,1,48,32
1656073405416,COGS 13,A01,083071,Bastos; Amalia Pinkusfeld,8,2,71,63
1656073411440,COGS 14A,A01,092681,Semenuks; Arturs,8,23,100,92
1656073417464,COGS 14B,A01,083073,Cheng; Tzu-Han,9,0,63,54
1656073423490,COGS 17,A01,092677,Semenuks; Arturs,13,6,81,68
1656073429606,COGS 100,A01,083619,Allen; Michael Gordon,8,1,70,62
1656073435631,COGS 101A,A01,083621,Davis; Joshua Daniel,7,3,68,61
1656073441656,COGS 101B,A01,091572,Allen; Michael Gordon,7,0,65,58
1656073447683,COGS 101C,A01,083625,Delgado; Tania,11,0,35,24
1656073453707,COGS 107A,A01,083627,Boyle; Mary E. T.,5,2,60,55
1656073459737,COGS 118A,A01,083075,Gupta; Anjum,24,16,76,52
1656073465763,CSE 3,A50,083646,Miranda; Gregory Joseph,20,0,50,30
1656073471790,CSE 8A,A50,083650,Miranda; Gregory Joseph,13,11,56,43
1656073477825,CSE 11,A01,083080,Cao; Yingjun,1,60,40,39
1656073483855,CSE 12,A01,083652,Krause-Levy; Sophia Louisa,14,7,120,106
1656073489878,CSE 15L,A01,083654,Morris; Justin Loren,5,1,50,45
1656073489878,CSE 15L,A02,083655,Morris; Justin Loren,7,0,50,43
1656073495917,CSE 20,A01,083657,Tran; Khoa Dang,31,0,80,49
1656073501945,CSE 21,A01,095574,Bach; Quang Tran,28,0,48,20
1656073507972,CSE 30,A01,083084,Eldon; John,3,10,80,77
1656073507972,CSE 30,B01,095061,Bhaskar; Nishant,4,5,50,46
1656073513998,CSE 100,A01,083659,Cao; Yingjun,2,23,70,68
1656073520025,CSE 134B,A01,083661,Powell; Thomas Allan,11,6,100,89
1656073526052,CSE 140,A01,083663,Gungor; Onat,9,0,85,76
1656073532079,CSE 140L,A01,083088,Eldon; John,8,0,100,92
1656073538105,CSE 175,A01,083665,Kumar; Rakesh,2,0,25,23
1656073544137,CSE 190,A00,092507,Dubnov; Shlomo,3,0,20,17
1656073550170,ECE 45,A01,083139,Congero; Spencer William,5,2,75,70
1656073556202,ECE 65,A50,083695,Saad; Andrew S,8,0,30,22
1656073556202,ECE 65,A51,095125,Staff,23,0,26,3
1656073562227,ECE 109,A01,091882,Touri; Behrouz,5,4,70,65
1656073568252,ECE 180,A00,083140,Abi Samra; Nicholas Camill,1,0,30,29
1656073568252,ECE 180,B00,083141,Abi Samra; Nicholas Camill,2,8,28,26
1656073574279,MATH 10A,A01,083735,Patchell; Gregory David,1,0,30,29
1656073574279,MATH 10A,A02,083736,Patchell; Gregory David,23,0,30,7
1656073574279,MATH 10A,A03,083737,Patchell; Gregory David,16,0,30,14
1656073580307,MATH 10B,A01,083207,Lim; Seonhee,3,1,34,31
1656073580307,MATH 10B,A02,083208,Lim; Seonhee,10,1,35,25
1656073580307,MATH 10B,A03,093472,Staff,4,1,34,30
1656073580307,MATH 10B,B01,083739,Sinha; Shubham,12,0,30,18
1656073586340,MATH 18,A01,083743,Cinel; Cameron Alexander,7,0,30,23
1656073586340,MATH 18,A02,083744,Cinel; Cameron Alexander,12,0,30,18
1656073586340,MATH 18,A03,083745,Cinel; Cameron Alexander,3,0,30,27
1656073586340,MATH 18,B01,083748,Ma; Zilu,1,0,36,35
1656073586340,MATH 18,B02,083749,Ma; Zilu,2,0,36,34
1656073586340,MATH 18,B03,083750,Ma; Zilu,0,0,36,36
1656073586340,MATH 18,B04,083751,Ma; Zilu,1,0,36,35
1656073586340,MATH 18,B05,093473,Staff,3,0,36,33
1656073586340,MATH 18,B06,093474,Staff,4,0,36,32
1656073592371,MATH 20A,A01,083754,Zheng; Zequn,11,0,40,29
1656073598397,MATH 20B,A01,083756,Briones; Jor-el Thomas Caparas,0,0,36,36
1656073598397,MATH 20B,A02,083757,Briones; Jor-el Thomas Caparas,3,0,36,33
1656073598397,MATH 20B,A03,093475,Staff,3,0,36,33
1656073604423,MATH 20C,A01,083760,Briones; Jor-el Thomas Caparas,2,2,35,33
1656073604423,MATH 20C,A02,083761,Briones; Jor-el Thomas Caparas,9,1,35,26
1656073604423,MATH 20C,A03,093476,Staff,1,1,35,34
1656073604423,MATH 20C,B01,083762,Bach; Quang Tran,5,0,30,25
1656073610459,MATH 20D,A01,083765,Tran; Brian Kha,3,0,30,27
1656073610459,MATH 20D,A02,083766,Tran; Brian Kha,0,1,30,30
1656073610459,MATH 20D,A03,083767,Tran; Brian Kha,2,0,30,28
1656073616486,MATH 20E,A01,083771,Ganguly; Soumya,4,1,32,28
1656073616486,MATH 20E,A02,083772,Ganguly; Soumya,2,1,32,30
1656073616486,MATH 20E,B01,083773,Ciotti; Benjamin,15,0,35,20
1656073616486,MATH 20E,B02,083774,Ciotti; Benjamin,15,0,35,20
1656073622513,MATH 103A,A01,083777,Greenfeld; Be'Eri,3,0,36,33
1656073622513,MATH 103A,A02,083778,Greenfeld; Be'Eri,3,0,36,33
1656073622513,MATH 103A,A03,093561,Staff,4,1,36,32
1656073622513,MATH 103A,B01,083779,Greenfeld; Be'Eri,8,1,36,28
1656073622513,MATH 103A,B02,083780,Greenfeld; Be'Eri,1,0,36,35
1656073622513,MATH 103A,B03,093562,Staff,1,0,36,35
1656073628540,MATH 105,A01,085443,Carter; Anne Toulson,4,1,35,31
1656073628540,MATH 105,A02,093477,Staff,12,0,35,23
1656073634579,MATH 109,A01,083213,Ganzberger; Geoffrey Michael,1,1,34,33
1656073634579,MATH 109,A02,083214,Ganzberger; Geoffrey Michael,0,0,34,34
1656073634579,MATH 109,A03,093478,Staff,3,0,34,31
1656073634579,MATH 109,B01,083215,Ganzberger; Geoffrey Michael,4,0,32,28
1656073634579,MATH 109,B02,083216,Ganzberger; Geoffrey Michael,1,0,32,31
1656073634579,MATH 109,B03,093479,Staff,4,0,32,28
1656073640615,MATH 142A,A01,083219,Chow; Bennett,2,0,32,30
1656073640615,MATH 142A,A02,083220,Chow; Bennett,8,0,32,24
1656073640615,MATH 142A,A03,093480,Staff,5,0,32,27
1656073640615,MATH 142A,B03,093481,Staff,5,0,32,27
1656073640615,MATH 142A,B04,093558,Staff,7,0,32,25
1656073640615,MATH 142A,B05,093559,Staff,0,0,32,32
1656073646646,MATH 193A,A01,083224,Rotar; Vladimir,1,2,34,33
1656073646646,MATH 193A,A02,083225,Rotar; Vladimir,3,0,34,31
1656073646646,MATH 193A,A03,083781,Rotar; Vladimir,3,0,34,31
1656073646646,MATH 193A,A04,083782,Rotar; Vladimir,7,0,34,27
1656073646646,MATH 193A,A05,093482,Rotar; Vladimir,1,0,34,33
1656073652680,MATH 197,001,091859,McAuley; Julian John,9999,0,9999,0
1656073652680,MATH 197,002,095566,Kedlaya; Kiran S.,9997,0,9999,2
1656073652680,MATH 197,003,095567,Xiao; Ming,9999,0,9999,0
1656073652680,MATH 197,004,095571,Perols; Johan Lars,9998,0,9999,1
1656073659753,COGS 9,A01,083615,Shannon; Kyle Michael,4,1,75,71
1656073665782,COGS 11,A01,083617,Boyle; Mary E. T.,16,1,48,32
1656073671816,COGS 13,A01,083071,Bastos; Amalia Pinkusfeld,8,2,71,63
1656073677843,COGS 14A,A01,092681,Semenuks; Arturs,8,23,100,92
1656073683869,COGS 14B,A01,083073,Cheng; Tzu-Han,9,0,63,54
1656073689894,COGS 17,A01,092677,Semenuks; Arturs,13,6,81,68
1656073695921,COGS 100,A01,083619,Allen; Michael Gordon,8,1,70,62
1656073701946,COGS 101A,A01,083621,Davis; Joshua Daniel,7,3,68,61
1656073707974,COGS 101B,A01,091572,Allen; Michael Gordon,7,0,65,58
1656073714011,COGS 101C,A01,083625,Delgado; Tania,11,0,35,24
1656073720037,COGS 107A,A01,083627,Boyle; Mary E. T.,5,2,60,55
1656073726064,COGS 118A,A01,083075,Gupta; Anjum,24,16,76,52
1656073732096,CSE 3,A50,083646,Miranda; Gregory Joseph,20,0,50,30
1656073738126,CSE 8A,A50,083650,Miranda; Gregory Joseph,13,11,56,43
1656073744152,CSE 11,A01,083080,Cao; Yingjun,1,60,40,39
1656073750177,CSE 12,A01,083652,Krause-Levy; Sophia Louisa,14,7,120,106
1656073756207,CSE 15L,A01,083654,Morris; Justin Loren,5,1,50,45
1656073756207,CSE 15L,A02,083655,Morris; Justin Loren,7,0,50,43
1656073762233,CSE 20,A01,083657,Tran; Khoa Dang,31,0,80,49
1656073768262,CSE 21,A01,095574,Bach; Quang Tran,28,0,48,20
1656073774289,CSE 30,A01,083084,Eldon; John,3,10,80,77
1656073774289,CSE 30,B01,095061,Bhaskar; Nishant,4,5,50,46
1656073780314,CSE 100,A01,083659,Cao; Yingjun,2,23,70,68
1656073786339,CSE 134B,A01,083661,Powell; Thomas Allan,11,6,100,89
1656073792364,CSE 140,A01,083663,Gungor; Onat,9,0,85,76
1656073798397,CSE 140L,A01,083088,Eldon; John,8,0,100,92
1656073804434,CSE 175,A01,083665,Kumar; Rakesh,2,0,25,23
1656073810465,CSE 190,A00,092507,Dubnov; Shlomo,3,0,20,17
1656073816503,ECE 45,A01,083139,Congero; Spencer William,5,2,75,70
1656073822537,ECE 65,A50,083695,Saad; Andrew S,8,0,30,22
1656073822537,ECE 65,A51,095125,Staff,23,0,26,3
1656073828563,ECE 109,A01,091882,Touri; Behrouz,5,4,70,65
1656073834601,ECE 180,A00,083140,Abi Samra; Nicholas Camill,1,0,30,29
1656073834601,ECE 180,B00,083141,Abi Samra; Nicholas Camill,2,8,28,26
1656073840634,MATH 10A,A01,083735,Patchell; Gregory David,1,0,30,29
1656073840634,MATH 10A,A02,083736,Patchell; Gregory David,23,0,30,7
1656073840634,MATH 10A,A03,083737,Patchell; Gregory David,16,0,30,14
1656073846673,MATH 10B,A01,083207,Lim; Seonhee,3,1,34,31
1656073846673,MATH 10B,A02,083208,Lim; Seonhee,10,1,35,25
1656073846673,MATH 10B,A03,093472,Staff,4,1,34,30
1656073846673,MATH 10B,B01,083739,Sinha; Shubham,12,0,30,18
1656073852705,MATH 18,A01,083743,Cinel; Cameron Alexander,7,0,30,23
1656073852705,MATH 18,A02,083744,Cinel; Cameron Alexander,12,0,30,18
1656073852705,MATH 18,A03,083745,Cinel; Cameron Alexander,3,0,30,27
1656073852705,MATH 18,B01,083748,Ma; Zilu,1,0,36,35
1656073852705,MATH 18,B02,083749,Ma; Zilu,2,0,36,34
1656073852705,MATH 18,B03,083750,Ma; Zilu,0,0,36,36
1656073852705,MATH 18,B04,083751,Ma; Zilu,1,0,36,35
1656073852705,MATH 18,B05,093473,Staff,3,0,36,33
1656073852705,MATH 18,B06,093474,Staff,4,0,36,32
1656073858736,MATH 20A,A01,083754,Zheng; Zequn,11,0,40,29
1656073864763,MATH 20B,A01,083756,Briones; Jor-el Thomas Caparas,0,0,36,36
1656073864763,MATH 20B,A02,083757,Briones; Jor-el Thomas Caparas,3,0,36,33
1656073864763,MATH 20B,A03,093475,Staff,3,0,36,33
1656073870801,MATH 20C,A01,083760,Briones; Jor-el Thomas Caparas,2,2,35,33
1656073870801,MATH 20C,A02,083761,Briones; Jor-el Thomas Caparas,9,1,35,26
1656073870801,MATH 20C,A03,093476,Staff,1,1,35,34
1656073870801,MATH 20C,B01,083762,Bach; Quang Tran,5,0,30,25
1656073876833,MATH 20D,A01,083765,Tran; Brian Kha,3,0,30,27
1656073876833,MATH 20D,A02,083766,Tran; Brian Kha,0,1,30,30
1656073876833,MATH 20D,A03,083767,Tran; Brian Kha,2,0,30,28
1656073882869,MATH 20E,A01,083771,Ganguly; Soumya,4,1,32,28
1656073882869,MATH 20E,A02,083772,Ganguly; Soumya,2,1,32,30
1656073882869,MATH 20E,B01,083773,Ciotti; Benjamin,15,0,35,20
1656073882869,MATH 20E,B02,083774,Ciotti; Benjamin,15,0,35,20
1656073888900,MATH 103A,A01,083777,Greenfeld; Be'Eri,3,0,36,33
1656073888900,MATH 103A,A02,083778,Greenfeld; Be'Eri,3,0,36,33
1656073888900,MATH 103A,A03,093561,Staff,4,1,36,32
1656073888900,MATH 103A,B01,083779,Greenfeld; Be'Eri,8,1,36,28
1656073888900,MATH 103A,B02,083780,Greenfeld; Be'Eri,1,0,36,35
1656073888900,MATH 103A,B03,093562,Staff,1,0,36,35
1656073894928,MATH 105,A01,085443,Carter; Anne Toulson,4,1,35,31
1656073894928,MATH 105,A02,093477,Staff,12,0,35,23
1656073900956,MATH 109,A01,083213,Ganzberger; Geoffrey Michael,1,1,34,33
1656073900956,MATH 109,A02,083214,Ganzberger; Geoffrey Michael,0,0,34,34
1656073900956,MATH 109,A03,093478,Staff,3,0,34,31
1656073900956,MATH 109,B01,083215,Ganzberger; Geoffrey Michael,4,0,32,28
1656073900956,MATH 109,B02,083216,Ganzberger; Geoffrey Michael,1,0,32,31
1656073900956,MATH 109,B03,093479,Staff,4,0,32,28
1656073906989,MATH 142A,A01,083219,Chow; Bennett,2,0,32,30
1656073906989,MATH 142A,A02,083220,Chow; Bennett,8,0,32,24
1656073906989,MATH 142A,A03,093480,Staff,5,0,32,27
1656073906989,MATH 142A,B03,093481,Staff,5,0,32,27
1656073906989,MATH 142A,B04,093558,Staff,7,0,32,25
1656073906989,MATH 142A,B05,093559,Staff,0,0,32,32
1656073913016,MATH 193A,A01,083224,Rotar; Vladimir,1,2,34,33
1656073913016,MATH 193A,A02,083225,Rotar; Vladimir,3,0,34,31
1656073913016,MATH 193A,A03,083781,Rotar; Vladimir,3,0,34,31
1656073913016,MATH 193A,A04,083782,Rotar; Vladimir,7,0,34,27
1656073913016,MATH 193A,A05,093482,Rotar; Vladimir,1,0,34,33
1656073919043,MATH 197,001,091859,McAuley; Julian John,9999,0,9999,0
1656073919043,MATH 197,002,095566,Kedlaya; Kiran S.,9997,0,9999,2
1656073919043,MATH 197,003,095567,Xiao; Ming,9999,0,9999,0
1656073919043,MATH 197,004,095571,Perols; Johan Lars,9998,0,9999,1
1656073926108,COGS 9,A01,083615,Shannon; Kyle Michael,4,1,75,71
1656073932141,COGS 11,A01,083617,Boyle; Mary E. T.,16,1,48,32
1656073938174,COGS 13,A01,083071,Bastos; Amalia Pinkusfeld,8,2,71,63
1656073944204,COGS 14A,A01,092681,Semenuks; Arturs,8,23,100,92
1656073950230,COGS 14B,A01,083073,Cheng; Tzu-Han,9,0,63,54
1656073956256,COGS 17,A01,092677,Semenuks; Arturs,13,6,81,68
1656073962285,COGS 100,A01,083619,Allen; Michael Gordon,8,1,70,62
1656073968312,COGS 101A,A01,083621,Davis; Joshua Daniel,7,3,68,61
1656073974338,COGS 101B,A01,091572,Allen; Michael Gordon,7,0,65,58
1656073980383,COGS 101C,A01,083625,Delgado; Tania,11,0,35,24
1656073986412,COGS 107A,A01,083627,Boyle; Mary E. T.,5,2,60,55
1656073992442,COGS 118A,A01,083075,Gupta; Anjum,24,16,76,52
1656073998475,CSE 3,A50,083646,Miranda; Gregory Joseph,20,0,50,30
1656074004502,CSE 8A,A50,083650,Miranda; Gregory Joseph,13,11,56,43
1656074010528,CSE 11,A01,083080,Cao; Yingjun,1,60,40,39
1656074016558,CSE 12,A01,083652,Krause-Levy; Sophia Louisa,14,7,120,106
1656074022585,CSE 15L,A01,083654,Morris; Justin Loren,5,1,50,45
1656074022585,CSE 15L,A02,083655,Morris; Justin Loren,7,0,50,43
1656074028688,CSE 20,A01,083657,Tran; Khoa Dang,31,0,80,49
1656074034720,CSE 21,A01,095574,Bach; Quang Tran,28,0,48,20
1656074040747,CSE 30,A01,083084,Eldon; John,3,10,80,77
1656074040747,CSE 30,B01,095061,Bhaskar; Nishant,4,5,50,46
1656074046773,CSE 100,A01,083659,Cao; Yingjun,2,23,70,68
1656074052800,CSE 134B,A01,083661,Powell; Thomas Allan,11,6,100,89
1656074058827,CSE 140,A01,083663,Gungor; Onat,9,0,85,76
1656074064852,CSE 140L,A01,083088,Eldon; John,8,0,100,92
1656074070882,CSE 175,A01,083665,Kumar; Rakesh,2,0,25,23
1656074076911,CSE 190,A00,092507,Dubnov; Shlomo,3,0,20,17
1656074082937,ECE 45,A01,083139,Congero; Spencer William,5,2,75,70
1656074088964,ECE 65,A50,083695,Saad; Andrew S,8,0,30,22
1656074088964,ECE 65,A51,095125,Staff,23,0,26,3
1656074094989,ECE 109,A01,091882,Touri; Behrouz,5,4,70,65
1656074101018,ECE 180,A00,083140,Abi Samra; Nicholas Camill,1,0,30,29
1656074101018,ECE 180,B00,083141,Abi Samra; Nicholas Camill,2,8,28,26
1656074107046,MATH 10A,A01,083735,Patchell; Gregory David,1,0,30,29
1656074107046,MATH 10A,A02,083736,Patchell; Gregory David,23,0,30,7
1656074107046,MATH 10A,A03,083737,Patchell; Gregory David,16,0,30,14
1656074113081,MATH 10B,A01,083207,Lim; Seonhee,3,1,34,31
1656074113081,MATH 10B,A02,083208,Lim; Seonhee,10,1,35,25
1656074113081,MATH 10B,A03,093472,Staff,4,1,34,30
1656074113081,MATH 10B,B01,083739,Sinha; Shubham,12,0,30,18
1656074119120,MATH 18,A01,083743,Cinel; Cameron Alexander,7,0,30,23
1656074119120,MATH 18,A02,083744,Cinel; Cameron Alexander,12,0,30,18
1656074119120,MATH 18,A03,083745,Cinel; Cameron Alexander,3,0,30,27
1656074119120,MATH 18,B01,083748,Ma; Zilu,1,0,36,35
1656074119120,MATH 18,B02,083749,Ma; Zilu,2,0,36,34
1656074119120,MATH 18,B03,083750,Ma; Zilu,0,0,36,36
1656074119120,MATH 18,B04,083751,Ma; Zilu,1,0,36,35
1656074119120,MATH 18,B05,093473,Staff,3,0,36,33
1656074119120,MATH 18,B06,093474,Staff,4,0,36,32
1656074125145,MATH 20A,A01,083754,Zheng; Zequn,11,0,40,29
1656074131170,MATH 20B,A01,083756,Briones; Jor-el Thomas Caparas,0,0,36,36
1656074131170,MATH 20B,A02,083757,Briones; Jor-el Thomas Caparas,3,0,36,33
1656074131170,MATH 20B,A03,093475,Staff,3,0,36,33
1656074137201,MATH 20C,A01,083760,Briones; Jor-el Thomas Caparas,2,2,35,33
1656074137201,MATH 20C,A02,083761,Briones; Jor-el Thomas Caparas,9,1,35,26
1656074137201,MATH 20C,A03,093476,Staff,1,1,35,34
1656074137201,MATH 20C,B01,083762,Bach; Quang Tran,5,0,30,25
1656074143229,MATH 20D,A01,083765,Tran; Brian Kha,3,0,30,27
1656074143229,MATH 20D,A02,083766,Tran; Brian Kha,0,1,30,30
1656074143229,MATH 20D,A03,083767,Tran; Brian Kha,2,0,30,28
1656074149258,MATH 20E,A01,083771,Ganguly; Soumya,4,1,32,28
1656074149258,MATH 20E,A02,083772,Ganguly; Soumya,2,1,32,30
1656074149258,MATH 20E,B01,083773,Ciotti; Benjamin,15,0,35,20
1656074149258,MATH 20E,B02,083774,Ciotti; Benjamin,15,0,35,20
1656074155284,MATH 103A,A01,083777,Greenfeld; Be'Eri,3,0,36,33
1656074155284,MATH 103A,A02,083778,Greenfeld; Be'Eri,3,0,36,33
1656074155284,MATH 103A,A03,093561,Staff,4,1,36,32
1656074155284,MATH 103A,B01,083779,Greenfeld; Be'Eri,8,1,36,28
1656074155284,MATH 103A,B02,083780,Greenfeld; Be'Eri,1,0,36,35
1656074155284,MATH 103A,B03,093562,Staff,1,0,36,35
1656074161311,MATH 105,A01,085443,Carter; Anne Toulson,4,1,35,31
1656074161311,MATH 105,A02,093477,Staff,12,0,35,23
1656074167343,MATH 109,A01,083213,Ganzberger; Geoffrey Michael,1,1,34,33
1656074167343,MATH 109,A02,083214,Ganzberger; Geoffrey Michael,0,0,34,34
1656074167343,MATH 109,A03,093478,Staff,3,0,34,31
1656074167343,MATH 109,B01,083215,Ganzberger; Geoffrey Michael,4,0,32,28
1656074167343,MATH 109,B02,083216,Ganzberger; Geoffrey Michael,1,0,32,31
1656074167343,MATH 109,B03,093479,Staff,4,0,32,28
1656074173370,MATH 142A,A01,083219,Chow; Bennett,2,0,32,30
1656074173370,MATH 142A,A02,083220,Chow; Bennett,8,0,32,24
1656074173370,MATH 142A,A03,093480,Staff,5,0,32,27
1656074173370,MATH 142A,B03,093481,Staff,5,0,32,27
1656074173370,MATH 142A,B04,093558,Staff,7,0,32,25
1656074173370,MATH 142A,B05,093559,Staff,0,0,32,32
1656074179402,MATH 193A,A01,083224,Rotar; Vladimir,1,2,34,33
1656074179402,MATH 193A,A02,083225,Rotar; Vladimir,3,0,34,31
1656074179402,MATH 193A,A03,083781,Rotar; Vladimir,3,0,34,31
1656074179402,MATH 193A,A04,083782,Rotar; Vladimir,7,0,34,27
1656074179402,MATH 193A,A05,093482,Rotar; Vladimir,1,0,34,33
1656074185431,MATH 197,001,091859,McAuley; Julian John,9999,0,9999,0
1656074185431,MATH 197,002,095566,Kedlaya; Kiran S.,9997,0,9999,2
1656074185431,MATH 197,003,095567,Xiao; Ming,9999,0,9999,0
1656074185431,MATH 197,004,095571,Perols; Johan Lars,9998,0,9999,1
1656074192489,COGS 9,A01,083615,Shannon; Kyle Michael,4,1,75,71
1656074198513,COGS 11,A01,083617,Boyle; Mary E. T.,16,1,48,32
1656074204540,COGS 13,A01,083071,Bastos; Amalia Pinkusfeld,8,2,71,63
1656074210571,COGS 14A,A01,092681,Semenuks; Arturs,8,23,100,92
1656074216597,COGS 14B,A01,083073,Cheng; Tzu-Han,9,0,63,54
1656074222622,COGS 17,A01,092677,Semenuks; Arturs,13,6,81,68
1656074228653,COGS 100,A01,083619,Allen; Michael Gordon,8,1,70,62
1656074234678,COGS 101A,A01,083621,Davis; Joshua Daniel,7,3,68,61
1656074240703,COGS 101B,A01,091572,Allen; Michael Gordon,7,0,65,58
1656074246730,COGS 101C,A01,083625,Delgado; Tania,11,0,35,24
1656074252760,COGS 107A,A01,083627,Boyle; Mary E. T.,5,2,60,55
1656074258791,COGS 118A,A01,083075,Gupta; Anjum,24,16,76,52
1656074264819,CSE 3,A50,083646,Miranda; Gregory Joseph,20,0,50,30
1656074270848,CSE 8A,A50,083650,Miranda; Gregory Joseph,13,11,56,43
1656074276874,CSE 11,A01,083080,Cao; Yingjun,1,60,40,39
1656074282902,CSE 12,A01,083652,Krause-Levy; Sophia Louisa,14,7,120,106
1656074288929,CSE 15L,A01,083654,Morris; Justin Loren,5,1,50,45
1656074288929,CSE 15L,A02,083655,Morris; Justin Loren,7,0,50,43
1656074294957,CSE 20,A01,083657,Tran; Khoa Dang,31,0,80,49
1656074300983,CSE 21,A01,095574,Bach; Quang Tran,28,0,48,20
1656074307013,CSE 30,A01,083084,Eldon; John,3,10,80,77
1656074307013,CSE 30,B01,095061,Bhaskar; Nishant,4,5,50,46
1656074313040,CSE 100,A01,083659,Cao; Yingjun,2,23,70,68
1656074319065,CSE 134B,A01,083661,Powell; Thomas Allan,11,6,100,89
1656074325089,CSE 140,A01,083663,Gungor; Onat,9,0,85,76
1656074331115,CSE 140L,A01,083088,Eldon; John,8,0,100,92
1656074337147,CSE 175,A01,083665,Kumar; Rakesh,2,0,25,23
1656074343179,CSE 190,A00,092507,Dubnov; Shlomo,3,0,20,17
1656074349208,ECE 45,A01,083139,Congero; Spencer William,5,2,75,70
1656074355238,ECE 65,A50,083695,Saad; Andrew S,8,0,30,22
1656074355238,ECE 65,A51,095125,Staff,23,0,26,3
1656074361265,ECE 109,A01,091882,Touri; Behrouz,5,4,70,65
1656074367293,ECE 180,A00,083140,Abi Samra; Nicholas Camill,1,0,30,29
1656074367293,ECE 180,B00,083141,Abi Samra; Nicholas Camill,2,8,28,26
1656074373324,MATH 10A,A01,083735,Patchell; Gregory David,1,0,30,29
1656074373324,MATH 10A,A02,083736,Patchell; Gregory David,23,0,30,7
1656074373324,MATH 10A,A03,083737,Patchell; Gregory David,16,0,30,14
1656074379368,MATH 10B,A01,083207,Lim; Seonhee,3,1,34,31
1656074379368,MATH 10B,A02,083208,Lim; Seonhee,10,1,35,25
1656074379368,MATH 10B,A03,093472,Staff,4,1,34,30
1656074379368,MATH 10B,B01,083739,Sinha; Shubham,12,0,30,18
1656074385397,MATH 18,A01,083743,Cinel; Cameron Alexander,7,0,30,23
1656074385397,MATH 18,A02,083744,Cinel; Cameron Alexander,12,0,30,18
1656074385397,MATH 18,A03,083745,Cinel; Cameron Alexander,3,0,30,27
1656074385397,MATH 18,B01,083748,Ma; Zilu,1,0,36,35
1656074385397,MATH 18,B02,083749,Ma; Zilu,2,0,36,34
1656074385397,MATH 18,B03,083750,Ma; Zilu,0,0,36,36
1656074385397,MATH 18,B04,083751,Ma; Zilu,1,0,36,35
1656074385397,MATH 18,B05,093473,Staff,3,0,36,33
1656074385397,MATH 18,B06,093474,Staff,4,0,36,32
1656074391431,MATH 20A,A01,083754,Zheng; Zequn,11,0,40,29
1656074397461,MATH 20B,A01,083756,Briones; Jor-el Thomas Caparas,0,0,36,36
1656074397461,MATH 20B,A02,083757,Briones; Jor-el Thomas Caparas,3,0,36,33
1656074397461,MATH 20B,A03,093475,Staff,3,0,36,33
1656074403493,MATH 20C,A01,083760,Briones; Jor-el Thomas Caparas,2,2,35,33
1656074403493,MATH 20C,A02,083761,Briones; Jor-el Thomas Caparas,9,1,35,26
1656074403493,MATH 20C,A03,093476,Staff,1,1,35,34
1656074403493,MATH 20C,B01,083762,Bach; Quang Tran,5,0,30,25
1656074409526,MATH 20D,A01,083765,Tran; Brian Kha,3,0,30,27
1656074409526,MATH 20D,A02,083766,Tran; Brian Kha,0,1,30,30
1656074409526,MATH 20D,A03,083767,Tran; Brian Kha,2,0,30,28
1656074415568,MATH 20E,A01,083771,Ganguly; Soumya,4,1,32,28
1656074415568,MATH 20E,A02,083772,Ganguly; Soumya,2,1,32,30
1656074415568,MATH 20E,B01,083773,Ciotti; Benjamin,15,0,35,20
1656074415568,MATH 20E,B02,083774,Ciotti; Benjamin,15,0,35,20
1656074421606,MATH 103A,A01,083777,Greenfeld; Be'Eri,3,0,36,33
1656074421606,MATH 103A,A02,083778,Greenfeld; Be'Eri,3,0,36,33
1656074421606,MATH 103A,A03,093561,Staff,4,1,36,32
1656074421606,MATH 103A,B01,083779,Greenfeld; Be'Eri,8,1,36,28
1656074421606,MATH 103A,B02,083780,Greenfeld; Be'Eri,1,0,36,35
1656074421606,MATH 103A,B03,093562,Staff,1,0,36,35
1656074427641,MATH 105,A01,085443,Carter; Anne Toulson,4,1,35,31
1656074427641,MATH 105,A02,093477,Staff,12,0,35,23
1656074433669,MATH 109,A01,083213,Ganzberger; Geoffrey Michael,1,1,34,33
1656074433669,MATH 109,A02,083214,Ganzberger; Geoffrey Michael,0,0,34,34
1656074433669,MATH 109,A03,093478,Staff,3,0,34,31
1656074433669,MATH 109,B01,083215,Ganzberger; Geoffrey Michael,4,0,32,28
1656074433669,MATH 109,B02,083216,Ganzberger; Geoffrey Michael,1,0,32,31
1656074433669,MATH 109,B03,093479,Staff,4,0,32,28
1656074439696,MATH 142A,A01,083219,Chow; Bennett,2,0,32,30
1656074439696,MATH 142A,A02,083220,Chow; Bennett,8,0,32,24
1656074439696,MATH 142A,A03,093480,Staff,5,0,32,27
1656074439696,MATH 142A,B03,093481,Staff,5,0,32,27
1656074439696,MATH 142A,B04,093558,Staff,7,0,32,25
1656074439696,MATH 142A,B05,093559,Staff,0,0,32,32
1656074445721,MATH 193A,A01,083224,Rotar; Vladimir,1,2,34,33
1656074445721,MATH 193A,A02,083225,Rotar; Vladimir,3,0,34,31
1656074445721,MATH 193A,A03,083781,Rotar; Vladimir,3,0,34,31
1656074445721,MATH 193A,A04,083782,Rotar; Vladimir,7,0,34,27
1656074445721,MATH 193A,A05,093482,Rotar; Vladimir,1,0,34,33
1656074451746,MATH 197,001,091859,McAuley; Julian John,9999,0,9999,0
1656074451746,MATH 197,002,095566,Kedlaya; Kiran S.,9997,0,9999,2
1656074451746,MATH 197,003,095567,Xiao; Ming,9999,0,9999,0
1656074451746,MATH 197,004,095571,Perols; Johan Lars,9998,0,9999,1
1656074458826,COGS 9,A01,083615,Shannon; Kyle Michael,4,1,75,71
1656074464854,COGS 11,A01,083617,Boyle; Mary E. T.,16,1,48,32
1656074470879,COGS 13,A01,083071,Bastos; Amalia Pinkusfeld,8,2,71,63
1656074476914,COGS 14A,A01,092681,Semenuks; Arturs,8,23,100,92
1656074482947,COGS 14B,A01,083073,Cheng; Tzu-Han,9,0,63,54
1656074488972,COGS 17,A01,092677,Semenuks; Arturs,13,6,81,68
1656074495002,COGS 100,A01,083619,Allen; Michael Gordon,8,1,70,62
1656074501045,COGS 101A,A01,083621,Davis; Joshua Daniel,7,3,68,61
1656074507071,COGS 101B,A01,091572,Allen; Michael Gordon,7,0,65,58
1656074513099,COGS 101C,A01,083625,Delgado; Tania,11,0,35,24
1656074519124,COGS 107A,A01,083627,Boyle; Mary E. T.,5,2,60,55
1656074525158,COGS 118A,A01,083075,Gupta; Anjum,24,16,76,52
1656074531192,CSE 3,A50,083646,Miranda; Gregory Joseph,20,0,50,30
1656074537226,CSE 8A,A50,083650,Miranda; Gregory Joseph,13,11,56,43
1656074543250,CSE 11,A01,083080,Cao; Yingjun,1,60,40,39
1656074549278,CSE 12,A01,083652,Krause-Levy; Sophia Louisa,14,7,120,106
1656074555303,CSE 15L,A01,083654,Morris; Justin Loren,5,1,50,45
1656074555303,CSE 15L,A02,083655,Morris; Justin Loren,7,0,50,43
1656074561333,CSE 20,A01,083657,Tran; Khoa Dang,31,0,80,49
1656074567359,CSE 21,A01,095574,Bach; Quang Tran,28,0,48,20
1656074573384,CSE 30,A01,083084,Eldon; John,3,10,80,77
1656074573384,CSE 30,B01,095061,Bhaskar; Nishant,4,5,50,46
1656074579426,CSE 100,A01,083659,Cao; Yingjun,2,23,70,68
1656074585459,CSE 134B,A01,083661,Powell; Thomas Allan,11,6,100,89
1656074591489,CSE 140,A01,083663,Gungor; Onat,9,0,85,76
1656074597514,CSE 140L,A01,083088,Eldon; John,8,0,100,92
1656074603540,CSE 175,A01,083665,Kumar; Rakesh,2,0,25,23
1656074609570,CSE 190,A00,092507,Dubnov; Shlomo,3,0,20,17
1656074615605,ECE 45,A01,083139,Congero; Spencer William,5,2,75,70
1656074621632,ECE 65,A50,083695,Saad; Andrew S,8,0,30,22
1656074621632,ECE 65,A51,095125,Staff,23,0,26,3
1656074627749,ECE 109,A01,091882,Touri; Behrouz,5,4,70,65
1656074633780,ECE 180,A00,083140,Abi Samra; Nicholas Camill,1,0,30,29
1656074633780,ECE 180,B00,083141,Abi Samra; Nicholas Camill,2,8,28,26
1656074639809,MATH 10A,A01,083735,Patchell; Gregory David,1,0,30,29
1656074639809,MATH 10A,A02,083736,Patchell; Gregory David,23,0,30,7
1656074639809,MATH 10A,A03,083737,Patchell; Gregory David,16,0,30,14
1656074645860,MATH 10B,A01,083207,Lim; Seonhee,3,1,34,31
1656074645860,MATH 10B,A02,083208,Lim; Seonhee,10,1,35,25
1656074645860,MATH 10B,A03,093472,Staff,4,1,34,30
1656074645860,MATH 10B,B01,083739,Sinha; Shubham,12,0,30,18
1656074651900,MATH 18,A01,083743,Cinel; Cameron Alexander,7,0,30,23
1656074651900,MATH 18,A02,083744,Cinel; Cameron Alexander,12,0,30,18
1656074651900,MATH 18,A03,083745,Cinel; Cameron Alexander,3,0,30,27
1656074651900,MATH 18,B01,083748,Ma; Zilu,1,0,36,35
1656074651900,MATH 18,B02,083749,Ma; Zilu,2,0,36,34
1656074651900,MATH 18,B03,083750,Ma; Zilu,0,0,36,36
1656074651900,MATH 18,B04,083751,Ma; Zilu,1,0,36,35
1656074651900,MATH 18,B05,093473,Staff,3,0,36,33
1656074651900,MATH 18,B06,093474,Staff,4,0,36,32
1656074657924,MATH 20A,A01,083754,Zheng; Zequn,11,0,40,29
1656074663950,MATH 20B,A01,083756,Briones; Jor-el Thomas Caparas,0,0,36,36
1656074663950,MATH 20B,A02,083757,Briones; Jor-el Thomas Caparas,3,0,36,33
1656074663950,MATH 20B,A03,093475,Staff,3,0,36,33
1656074669983,MATH 20C,A01,083760,Briones; Jor-el Thomas Caparas,2,2,35,33
1656074669983,MATH 20C,A02,083761,Briones; Jor-el Thomas Caparas,9,1,35,26
1656074669983,MATH 20C,A03,093476,Staff,1,1,35,34
1656074669983,MATH 20C,B01,083762,Bach; Quang Tran,5,0,30,25
1656074676009,MATH 20D,A01,083765,Tran; Brian Kha,3,0,30,27
1656074676009,MATH 20D,A02,083766,Tran; Brian Kha,0,1,30,30
1656074676009,MATH 20D,A03,083767,Tran; Brian Kha,2,0,30,28
1656074682036,MATH 20E,A01,083771,Ganguly; Soumya,4,1,32,28
1656074682036,MATH 20E,A02,083772,Ganguly; Soumya,2,1,32,30
1656074682036,MATH 20E,B01,083773,Ciotti; Benjamin,15,0,35,20
1656074682036,MATH 20E,B02,083774,Ciotti; Benjamin,15,0,35,20
1656074688064,MATH 103A,A01,083777,Greenfeld; Be'Eri,3,0,36,33
1656074688064,MATH 103A,A02,083778,Greenfeld; Be'Eri,3,0,36,33
1656074688064,MATH 103A,A03,093561,Staff,4,1,36,32
1656074688064,MATH 103A,B01,083779,Greenfeld; Be'Eri,8,1,36,28
1656074688064,MATH 103A,B02,083780,Greenfeld; Be'Eri,1,0,36,35
1656074688064,MATH 103A,B03,093562,Staff,1,0,36,35
1656074694098,MATH 105,A01,085443,Carter; Anne Toulson,4,1,35,31
1656074694098,MATH 105,A02,093477,Staff,12,0,35,23
1656074700124,MATH 109,A01,083213,Ganzberger; Geoffrey Michael,1,1,34,33
1656074700124,MATH 109,A02,083214,Ganzberger; Geoffrey Michael,0,0,34,34
1656074700124,MATH 109,A03,093478,Staff,3,0,34,31
1656074700124,MATH 109,B01,083215,Ganzberger; Geoffrey Michael,4,0,32,28
1656074700124,MATH 109,B02,083216,Ganzberger; Geoffrey Michael,1,0,32,31
1656074700124,MATH 109,B03,093479,Staff,4,0,32,28
1656074706160,MATH 142A,A01,083219,Chow; Bennett,2,0,32,30
1656074706160,MATH 142A,A02,083220,Chow; Bennett,8,0,32,24
1656074706160,MATH 142A,A03,093480,Staff,5,0,32,27
1656074706160,MATH 142A,B03,093481,Staff,5,0,32,27
1656074706160,MATH 142A,B04,093558,Staff,7,0,32,25
1656074706160,MATH 142A,B05,093559,Staff,0,0,32,32
1656074712188,MATH 193A,A01,083224,Rotar; Vladimir,1,2,34,33
1656074712188,MATH 193A,A02,083225,Rotar; Vladimir,3,0,34,31
1656074712188,MATH 193A,A03,083781,Rotar; Vladimir,3,0,34,31
1656074712188,MATH 193A,A04,083782,Rotar; Vladimir,7,0,34,27
1656074712188,MATH 193A,A05,093482,Rotar; Vladimir,1,0,34,33
1656074718218,MATH 197,001,091859,McAuley; Julian John,9999,0,9999,0
1656074718218,MATH 197,002,095566,Kedlaya; Kiran S.,9997,0,9999,2
1656074718218,MATH 197,003,095567,Xiao; Ming,9999,0,9999,0
1656074718218,MATH 197,004,095571,Perols; Johan Lars,9998,0,9999,1
1656074725297,COGS 9,A01,083615,Shannon; Kyle Michael,4,1,75,71
1656074731322,COGS 11,A01,083617,Boyle; Mary E. T.,16,1,48,32
1656074737352,COGS 13,A01,083071,Bastos; Amalia Pinkusfeld,8,2,71,63
1656074743380,COGS 14A,A01,092681,Semenuks; Arturs,8,23,100,92
1656074749410,COGS 14B,A01,083073,Cheng; Tzu-Han,9,0,63,54
1656074755433,COGS 17,A01,092677,Semenuks; Arturs,13,6,81,68
1656074761460,COGS 100,A01,083619,Allen; Michael Gordon,8,1,70,62
1656074767485,COGS 101A,A01,083621,Davis; Joshua Daniel,7,3,68,61
1656074773509,COGS 101B,A01,091572,Allen; Michael Gordon,7,0,65,58
1656074779543,COGS 101C,A01,083625,Delgado; Tania,11,0,35,24
1656074785568,COGS 107A,A01,083627,Boyle; Mary E. T.,5,2,60,55
1656074791600,COGS 118A,A01,083075,Gupta; Anjum,24,16,76,52
1656074797627,CSE 3,A50,083646,Miranda; Gregory Joseph,20,0,50,30
1656074803653,CSE 8A,A50,083650,Miranda; Gregory Joseph,13,11,56,43
1656074809683,CSE 11,A01,083080,Cao; Yingjun,1,60,40,39
1656074815720,CSE 12,A01,083652,Krause-Levy; Sophia Louisa,14,7,120,106
1656074821748,CSE 15L,A01,083654,Morris; Justin Loren,5,1,50,45
1656074821748,CSE 15L,A02,083655,Morris; Justin Loren,7,0,50,43
1656074827778,CSE 20,A01,083657,Tran; Khoa Dang,31,0,80,49
1656074833808,CSE 21,A01,095574,Bach; Quang Tran,28,0,48,20
1656074839835,CSE 30,A01,083084,Eldon; John,3,10,80,77
1656074839835,CSE 30,B01,095061,Bhaskar; Nishant,4,5,50,46
1656074845862,CSE 100,A01,083659,Cao; Yingjun,2,23,70,68
1656074851892,CSE 134B,A01,083661,Powell; Thomas Allan,11,6,100,89
1656074857924,CSE 140,A01,083663,Gungor; Onat,9,0,85,76
1656074863956,CSE 140L,A01,083088,Eldon; John,8,0,100,92
1656074869986,CSE 175,A01,083665,Kumar; Rakesh,2,0,25,23
1656074876016,CSE 190,A00,092507,Dubnov; Shlomo,3,0,20,17
1656074882046,ECE 45,A01,083139,Congero; Spencer William,5,2,75,70
1656074888080,ECE 65,A50,083695,Saad; Andrew S,8,0,30,22
1656074888080,ECE 65,A51,095125,Staff,23,0,26,3
1656074894105,ECE 109,A01,091882,Touri; Behrouz,5,4,70,65
1656074900136,ECE 180,A00,083140,Abi Samra; Nicholas Camill,1,0,30,29
1656074900136,ECE 180,B00,083141,Abi Samra; Nicholas Camill,2,8,28,26
1656074906168,MATH 10A,A01,083735,Patchell; Gregory David,1,0,30,29
1656074906168,MATH 10A,A02,083736,Patchell; Gregory David,23,0,30,7
1656074906168,MATH 10A,A03,083737,Patchell; Gregory David,16,0,30,14
1656074912197,MATH 10B,A01,083207,Lim; Seonhee,3,1,34,31
1656074912197,MATH 10B,A02,083208,Lim; Seonhee,10,1,35,25
1656074912197,MATH 10B,A03,093472,Staff,4,1,34,30
1656074912197,MATH 10B,B01,083739,Sinha; Shubham,12,0,30,18
1656074918227,MATH 18,A01,083743,Cinel; Cameron Alexander,7,0,30,23
1656074918227,MATH 18,A02,083744,Cinel; Cameron Alexander,12,0,30,18
1656074918227,MATH 18,A03,083745,Cinel; Cameron Alexander,3,0,30,27
1656074918227,MATH 18,B01,083748,Ma; Zilu,1,0,36,35
1656074918227,MATH 18,B02,083749,Ma; Zilu,2,0,36,34
1656074918227,MATH 18,B03,083750,Ma; Zilu,0,0,36,36
1656074918227,MATH 18,B04,083751,Ma; Zilu,1,0,36,35
1656074918227,MATH 18,B05,093473,Staff,3,0,36,33
1656074918227,MATH 18,B06,093474,Staff,4,0,36,32
1656074924253,MATH 20A,A01,083754,Zheng; Zequn,11,0,40,29
1656074930282,MATH 20B,A01,083756,Briones; Jor-el Thomas Caparas,0,0,36,36
1656074930282,MATH 20B,A02,083757,Briones; Jor-el Thomas Caparas,3,0,36,33
1656074930282,MATH 20B,A03,093475,Staff,3,0,36,33
1656074936310,MATH 20C,A01,083760,Briones; Jor-el Thomas Caparas,2,2,35,33
1656074936310,MATH 20C,A02,083761,Briones; Jor-el Thomas Caparas,9,1,35,26
1656074936310,MATH 20C,A03,093476,Staff,1,1,35,34
1656074936310,MATH 20C,B01,083762,Bach; Quang Tran,5,0,30,25
1656074942337,MATH 20D,A01,083765,Tran; Brian Kha,3,0,30,27
1656074942337,MATH 20D,A02,083766,Tran; Brian Kha,0,1,30,30
1656074942337,MATH 20D,A03,083767,Tran; Brian Kha,2,0,30,28
1656074948364,MATH 20E,A01,083771,Ganguly; Soumya,4,1,32,28
1656074948364,MATH 20E,A02,083772,Ganguly; Soumya,2,1,32,30
1656074948364,MATH 20E,B01,083773,Ciotti; Benjamin,15,0,35,20
1656074948364,MATH 20E,B02,083774,Ciotti; Benjamin,15,0,35,20
1656074954391,MATH 103A,A01,083777,Greenfeld; Be'Eri,3,0,36,33
1656074954391,MATH 103A,A02,083778,Greenfeld; Be'Eri,3,0,36,33
1656074954391,MATH 103A,A03,093561,Staff,4,1,36,32
1656074954391,MATH 103A,B01,083779,Greenfeld; Be'Eri,8,1,36,28
1656074954391,MATH 103A,B02,083780,Greenfeld; Be'Eri,1,0,36,35
1656074954391,MATH 103A,B03,093562,Staff,1,0,36,35
1656074960418,MATH 105,A01,085443,Carter; Anne Toulson,4,1,35,31
1656074960418,MATH 105,A02,093477,Staff,12,0,35,23
1656074966444,MATH 109,A01,083213,Ganzberger; Geoffrey Michael,1,1,34,33
1656074966444,MATH 109,A02,083214,Ganzberger; Geoffrey Michael,0,0,34,34
1656074966444,MATH 109,A03,093478,Staff,3,0,34,31
1656074966444,MATH 109,B01,083215,Ganzberger; Geoffrey Michael,4,0,32,28
1656074966444,MATH 109,B02,083216,Ganzberger; Geoffrey Michael,1,0,32,31
1656074966444,MATH 109,B03,093479,Staff,4,0,32,28
1656074972472,MATH 142A,A01,083219,Chow; Bennett,2,0,32,30
1656074972472,MATH 142A,A02,083220,Chow; Bennett,8,0,32,24
1656074972472,MATH 142A,A03,093480,Staff,5,0,32,27
1656074972472,MATH 142A,B03,093481,Staff,5,0,32,27
1656074972472,MATH 142A,B04,093558,Staff,7,0,32,25
1656074972472,MATH 142A,B05,093559,Staff,0,0,32,32
1656074978507,MATH 193A,A01,083224,Rotar; Vladimir,1,2,34,33
1656074978507,MATH 193A,A02,083225,Rotar; Vladimir,3,0,34,31
1656074978507,MATH 193A,A03,083781,Rotar; Vladimir,3,0,34,31
1656074978507,MATH 193A,A04,083782,Rotar; Vladimir,7,0,34,27
1656074978507,MATH 193A,A05,093482,Rotar; Vladimir,1,0,34,33
1656074984534,MATH 197,001,091859,McAuley; Julian John,9999,0,9999,0
1656074984534,MATH 197,002,095566,Kedlaya; Kiran S.,9997,0,9999,2
1656074984534,MATH 197,003,095567,Xiao; Ming,9999,0,9999,0
1656074984534,MATH 197,004,095571,Perols; Johan Lars,9998,0,9999,1
1656074991611,COGS 9,A01,083615,Shannon; Kyle Michael,4,1,75,71
1656074997641,COGS 11,A01,083617,Boyle; Mary E. T.,16,1,48,32
1656075003675,COGS 13,A01,083071,Bastos; Amalia Pinkusfeld,8,2,71,63
1656075009698,COGS 14A,A01,092681,Semenuks; Arturs,8,23,100,92
1656075015723,COGS 14B,A01,083073,Cheng; Tzu-Han,9,0,63,54
1656075021749,COGS 17,A01,092677,Semenuks; Arturs,13,6,81,68
1656075027771,COGS 100,A01,083619,Allen; Michael Gordon,8,1,70,62
1656075033802,COGS 101A,A01,083621,Davis; Joshua Daniel,7,3,68,61
1656075039829,COGS 101B,A01,091572,Allen; Michael Gordon,7,0,65,58
1656075045855,COGS 101C,A01,083625,Delgado; Tania,11,0,35,24
1656075051880,COGS 107A,A01,083627,Boyle; Mary E. T.,5,2,60,55
1656075057906,COGS 118A,A01,083075,Gupta; Anjum,24,16,76,52
1656075063944,CSE 3,A50,083646,Miranda; Gregory Joseph,20,0,50,30
1656075069974,CSE 8A,A50,083650,Miranda; Gregory Joseph,13,11,56,43
1656075076007,CSE 11,A01,083080,Cao; Yingjun,1,60,40,39
1656075082034,CSE 12,A01,083652,Krause-Levy; Sophia Louisa,14,7,120,106
1656075088059,CSE 15L,A01,083654,Morris; Justin Loren,5,1,50,45
1656075088059,CSE 15L,A02,083655,Morris; Justin Loren,7,0,50,43
1656075094084,CSE 20,A01,083657,Tran; Khoa Dang,31,0,80,49
1656075100110,CSE 21,A01,095574,Bach; Quang Tran,28,0,48,20
1656075106144,CSE 30,A01,083084,Eldon; John,3,10,80,77
1656075106144,CSE 30,B01,095061,Bhaskar; Nishant,4,5,50,46
1656075112175,CSE 100,A01,083659,Cao; Yingjun,2,23,70,68
1656075118200,CSE 134B,A01,083661,Powell; Thomas Allan,11,6,100,89
1656075124230,CSE 140,A01,083663,Gungor; Onat,9,0,85,76
1656075130255,CSE 140L,A01,083088,Eldon; John,8,0,100,92
1656075136283,CSE 175,A01,083665,Kumar; Rakesh,2,0,25,23
1656075142328,CSE 190,A00,092507,Dubnov; Shlomo,3,0,20,17
1656075148355,ECE 45,A01,083139,Congero; Spencer William,5,2,75,70
1656075154383,ECE 65,A50,083695,Saad; Andrew S,8,0,30,22
1656075154383,ECE 65,A51,095125,Staff,23,0,26,3
1656075160415,ECE 109,A01,091882,Touri; Behrouz,5,4,70,65
1656075166441,ECE 180,A00,083140,Abi Samra; Nicholas Camill,1,0,30,29
1656075166441,ECE 180,B00,083141,Abi Samra; Nicholas Camill,2,8,28,26
1656075172471,MATH 10A,A01,083735,Patchell; Gregory David,1,0,30,29
1656075172471,MATH 10A,A02,083736,Patchell; Gregory David,23,0,30,7
1656075172471,MATH 10A,A03,083737,Patchell; Gregory David,16,0,30,14
1656075178497,MATH 10B,A01,083207,Lim; Seonhee,3,1,34,31
1656075178497,MATH 10B,A02,083208,Lim; Seonhee,10,1,35,25
1656075178497,MATH 10B,A03,093472,Staff,4,1,34,30
1656075178497,MATH 10B,B01,083739,Sinha; Shubham,12,0,30,18
1656075184534,MATH 18,A01,083743,Cinel; Cameron Alexander,7,0,30,23
1656075184534,MATH 18,A02,083744,Cinel; Cameron Alexander,12,0,30,18
1656075184534,MATH 18,A03,083745,Cinel; Cameron Alexander,3,0,30,27
1656075184534,MATH 18,B01,083748,Ma; Zilu,1,0,36,35
1656075184534,MATH 18,B02,083749,Ma; Zilu,2,0,36,34
1656075184534,MATH 18,B03,083750,Ma; Zilu,0,0,36,36
1656075184534,MATH 18,B04,083751,Ma; Zilu,1,0,36,35
1656075184534,MATH 18,B05,093473,Staff,3,0,36,33
1656075184534,MATH 18,B06,093474,Staff,4,0,36,32
1656075190562,MATH 20A,A01,083754,Zheng; Zequn,11,0,40,29
1656075196587,MATH 20B,A01,083756,Briones; Jor-el Thomas Caparas,0,0,36,36
1656075196587,MATH 20B,A02,083757,Briones; Jor-el Thomas Caparas,3,0,36,33
1656075196587,MATH 20B,A03,093475,Staff,3,0,36,33
1656075202618,MATH 20C,A01,083760,Briones; Jor-el Thomas Caparas,2,2,35,33
1656075202618,MATH 20C,A02,083761,Briones; Jor-el Thomas Caparas,9,1,35,26
1656075202618,MATH 20C,A03,093476,Staff,1,1,35,34
1656075202618,MATH 20C,B01,083762,Bach; Quang Tran,5,0,30,25
1656075208642,MATH 20D,A01,083765,Tran; Brian Kha,3,0,30,27
1656075208642,MATH 20D,A02,083766,Tran; Brian Kha,0,1,30,30
1656075208642,MATH 20D,A03,083767,Tran; Brian Kha,2,0,30,28
1656075214685,MATH 20E,A01,083771,Ganguly; Soumya,4,1,32,28
1656075214685,MATH 20E,A02,083772,Ganguly; Soumya,2,1,32,30
1656075214685,MATH 20E,B01,083773,Ciotti; Benjamin,15,0,35,20
1656075214685,MATH 20E,B02,083774,Ciotti; Benjamin,15,0,35,20
1656075220713,MATH 103A,A01,083777,Greenfeld; Be'Eri,3,0,36,33
1656075220713,MATH 103A,A02,083778,Greenfeld; Be'Eri,3,0,36,33
1656075220713,MATH 103A,A03,093561,Staff,4,1,36,32
1656075220713,MATH 103A,B01,083779,Greenfeld; Be'Eri,8,1,36,28
1656075220713,MATH 103A,B02,083780,Greenfeld; Be'Eri,1,0,36,35
1656075220713,MATH 103A,B03,093562,Staff,1,0,36,35
1656075226815,MATH 105,A01,085443,Carter; Anne Toulson,4,1,35,31
1656075226815,MATH 105,A02,093477,Staff,12,0,35,23
1656075232844,MATH 109,A01,083213,Ganzberger; Geoffrey Michael,1,1,34,33
1656075232844,MATH 109,A02,083214,Ganzberger; Geoffrey Michael,0,0,34,34
1656075232844,MATH 109,A03,093478,Staff,3,0,34,31
1656075232844,MATH 109,B01,083215,Ganzberger; Geoffrey Michael,4,0,32,28
1656075232844,MATH 109,B02,083216,Ganzberger; Geoffrey Michael,1,0,32,31
1656075232844,MATH 109,B03,093479,Staff,4,0,32,28
1656075238871,MATH 142A,A01,083219,Chow; Bennett,2,0,32,30
1656075238871,MATH 142A,A02,083220,Chow; Bennett,8,0,32,24
1656075238871,MATH 142A,A03,093480,Staff,5,0,32,27
1656075238871,MATH 142A,B03,093481,Staff,5,0,32,27
1656075238871,MATH 142A,B04,093558,Staff,7,0,32,25
1656075238871,MATH 142A,B05,093559,Staff,0,0,32,32
1656075244903,MATH 193A,A01,083224,Rotar; Vladimir,1,2,34,33
1656075244903,MATH 193A,A02,083225,Rotar; Vladimir,3,0,34,31
1656075244903,MATH 193A,A03,083781,Rotar; Vladimir,3,0,34,31
1656075244903,MATH 193A,A04,083782,Rotar; Vladimir,7,0,34,27
1656075244903,MATH 193A,A05,093482,Rotar; Vladimir,1,0,34,33
1656075250942,MATH 197,001,091859,McAuley; Julian John,9999,0,9999,0
1656075250942,MATH 197,002,095566,Kedlaya; Kiran S.,9997,0,9999,2
1656075250942,MATH 197,003,095567,Xiao; Ming,9999,0,9999,0
1656075250942,MATH 197,004,095571,Perols; Johan Lars,9998,0,9999,1
1656075258028,COGS 9,A01,083615,Shannon; Kyle Michael,4,1,75,71
1656075264057,COGS 11,A01,083617,Boyle; Mary E. T.,16,1,48,32
1656075270090,COGS 13,A01,083071,Bastos; Amalia Pinkusfeld,8,2,71,63
1656075276119,COGS 14A,A01,092681,Semenuks; Arturs,8,23,100,92
1656075282145,COGS 14B,A01,083073,Cheng; Tzu-Han,9,0,63,54
1656075288171,COGS 17,A01,092677,Semenuks; Arturs,13,6,81,68
1656075294201,COGS 100,A01,083619,Allen; Michael Gordon,8,1,70,62
1656075300231,COGS 101A,A01,083621,Davis; Joshua Daniel,7,3,68,61
1656075306257,COGS 101B,A01,091572,Allen; Michael Gordon,7,0,65,58
1656075312288,COGS 101C,A01,083625,Delgado; Tania,11,0,35,24
1656075318311,COGS 107A,A01,083627,Boyle; Mary E. T.,5,2,60,55
1656075324339,COGS 118A,A01,083075,Gupta; Anjum,24,16,76,52
1656075330368,CSE 3,A50,083646,Miranda; Gregory Joseph,20,0,50,30
1656075336399,CSE 8A,A50,083650,Miranda; Gregory Joseph,13,11,56,43
1656075342430,CSE 11,A01,083080,Cao; Yingjun,1,60,40,39
1656075348459,CSE 12,A01,083652,Krause-Levy; Sophia Louisa,14,7,120,106
1656075354491,CSE 15L,A01,083654,Morris; Justin Loren,5,1,50,45
1656075354491,CSE 15L,A02,083655,Morris; Justin Loren,7,0,50,43
1656075360529,CSE 20,A01,083657,Tran; Khoa Dang,31,0,80,49
1656075366554,CSE 21,A01,095574,Bach; Quang Tran,28,0,48,20
1656075372583,CSE 30,A01,083084,Eldon; John,3,10,80,77
1656075372583,CSE 30,B01,095061,Bhaskar; Nishant,4,5,50,46
1656075378615,CSE 100,A01,083659,Cao; Yingjun,2,23,70,68
1656075384638,CSE 134B,A01,083661,Powell; Thomas Allan,11,6,100,89
1656075390668,CSE 140,A01,083663,Gungor; Onat,9,0,85,76
1656075396697,CSE 140L,A01,083088,Eldon; John,8,0,100,92
1656075402727,CSE 175,A01,083665,Kumar; Rakesh,2,0,25,23
1656075408753,CSE 190,A00,092507,Dubnov; Shlomo,3,0,20,17
1656075414789,ECE 45,A01,083139,Congero; Spencer William,5,2,75,70
1656075420816,ECE 65,A50,083695,Saad; Andrew S,8,0,30,22
1656075420816,ECE 65,A51,095125,Staff,23,0,26,3
1656075426842,ECE 109,A01,091882,Touri; Behrouz,5,4,70,65
1656075432868,ECE 180,A00,083140,Abi Samra; Nicholas Camill,1,0,30,29
1656075432868,ECE 180,B00,083141,Abi Samra; Nicholas Camill,2,8,28,26
1656075438903,MATH 10A,A01,083735,Patchell; Gregory David,1,0,30,29
1656075438903,MATH 10A,A02,083736,Patchell; Gregory David,23,0,30,7
1656075438903,MATH 10A,A03,083737,Patchell; Gregory David,16,0,30,14
1656075444941,MATH 10B,A01,083207,Lim; Seonhee,3,1,34,31
1656075444941,MATH 10B,A02,083208,Lim; Seonhee,10,1,35,25
1656075444941,MATH 10B,A03,093472,Staff,4,1,34,30
1656075444941,MATH 10B,B01,083739,Sinha; Shubham,12,0,30,18
1656075450980,MATH 18,A01,083743,Cinel; Cameron Alexander,7,0,30,23
1656075450980,MATH 18,A02,083744,Cinel; Cameron Alexander,12,0,30,18
1656075450980,MATH 18,A03,083745,Cinel; Cameron Alexander,3,0,30,27
1656075450980,MATH 18,B01,083748,Ma; Zilu,1,0,36,35
1656075450980,MATH 18,B02,083749,Ma; Zilu,2,0,36,34
1656075450980,MATH 18,B03,083750,Ma; Zilu,0,0,36,36
1656075450980,MATH 18,B04,083751,Ma; Zilu,1,0,36,35
1656075450980,MATH 18,B05,093473,Staff,3,0,36,33
1656075450980,MATH 18,B06,093474,Staff,4,0,36,32
1656075457005,MATH 20A,A01,083754,Zheng; Zequn,11,0,40,29
1656075463037,MATH 20B,A01,083756,Briones; Jor-el Thomas Caparas,0,0,36,36
1656075463037,MATH 20B,A02,083757,Briones; Jor-el Thomas Caparas,3,0,36,33
1656075463037,MATH 20B,A03,093475,Staff,3,0,36,33
1656075469064,MATH 20C,A01,083760,Briones; Jor-el Thomas Caparas,2,2,35,33
1656075469064,MATH 20C,A02,083761,Briones; Jor-el Thomas Caparas,9,1,35,26
1656075469064,MATH 20C,A03,093476,Staff,1,1,35,34
1656075469064,MATH 20C,B01,083762,Bach; Quang Tran,5,0,30,25
1656075475093,MATH 20D,A01,083765,Tran; Brian Kha,3,0,30,27
1656075475093,MATH 20D,A02,083766,Tran; Brian Kha,0,1,30,30
1656075475093,MATH 20D,A03,083767,Tran; Brian Kha,2,0,30,28
1656075481132,MATH 20E,A01,083771,Ganguly; Soumya,4,1,32,28
1656075481132,MATH 20E,A02,083772,Ganguly; Soumya,2,1,32,30
1656075481132,MATH 20E,B01,083773,Ciotti; Benjamin,15,0,35,20
1656075481132,MATH 20E,B02,083774,Ciotti; Benjamin,15,0,35,20
1656075487167,MATH 103A,A01,083777,Greenfeld; Be'Eri,3,0,36,33
1656075487167,MATH 103A,A02,083778,Greenfeld; Be'Eri,3,0,36,33
1656075487167,MATH 103A,A03,093561,Staff,4,1,36,32
1656075487167,MATH 103A,B01,083779,Greenfeld; Be'Eri,8,1,36,28
1656075487167,MATH 103A,B02,083780,Greenfeld; Be'Eri,1,0,36,35
1656075487167,MATH 103A,B03,093562,Staff,1,0,36,35
1656075493193,MATH 105,A01,085443,Carter; Anne Toulson,4,1,35,31
1656075493193,MATH 105,A02,093477,Staff,12,0,35,23
1656075499229,MATH 109,A01,083213,Ganzberger; Geoffrey Michael,1,1,34,33
1656075499229,MATH 109,A02,083214,Ganzberger; Geoffrey Michael,0,0,34,34
1656075499229,MATH 109,A03,093478,Staff,3,0,34,31
1656075499229,MATH 109,B01,083215,Ganzberger; Geoffrey Michael,4,0,32,28
1656075499229,MATH 109,B02,083216,Ganzberger; Geoffrey Michael,1,0,32,31
1656075499229,MATH 109,B03,093479,Staff,4,0,32,28
1656075505257,MATH 142A,A01,083219,Chow; Bennett,2,0,32,30
1656075505257,MATH 142A,A02,083220,Chow; Bennett,8,0,32,24
1656075505257,MATH 142A,A03,093480,Staff,5,0,32,27
1656075505257,MATH 142A,B03,093481,Staff,5,0,32,27
1656075505257,MATH 142A,B04,093558,Staff,7,0,32,25
1656075505257,MATH 142A,B05,093559,Staff,0,0,32,32
1656075511286,MATH 193A,A01,083224,Rotar; Vladimir,1,2,34,33
1656075511286,MATH 193A,A02,083225,Rotar; Vladimir,3,0,34,31
1656075511286,MATH 193A,A03,083781,Rotar; Vladimir,3,0,34,31
1656075511286,MATH 193A,A04,083782,Rotar; Vladimir,7,0,34,27
1656075511286,MATH 193A,A05,093482,Rotar; Vladimir,1,0,34,33
1656075517310,MATH 197,001,091859,McAuley; Julian John,9999,0,9999,0
1656075517310,MATH 197,002,095566,Kedlaya; Kiran S.,9997,0,9999,2
1656075517310,MATH 197,003,095567,Xiao; Ming,9999,0,9999,0
1656075517310,MATH 197,004,095571,Perols; Johan Lars,9998,0,9999,1
1656075524389,COGS 9,A01,083615,Shannon; Kyle Michael,4,1,75,71
1656075530415,COGS 11,A01,083617,Boyle; Mary E. T.,16,1,48,32
1656075536442,COGS 13,A01,083071,Bastos; Amalia Pinkusfeld,8,2,71,63
1656075542473,COGS 14A,A01,092681,Semenuks; Arturs,8,23,100,92
1656075548503,COGS 14B,A01,083073,Cheng; Tzu-Han,9,0,63,54
1656075554531,COGS 17,A01,092677,Semenuks; Arturs,13,6,81,68
1656075560562,COGS 100,A01,083619,Allen; Michael Gordon,8,1,70,62
1656075566590,COGS 101A,A01,083621,Davis; Joshua Daniel,7,3,68,61
1656075572624,COGS 101B,A01,091572,Allen; Michael Gordon,7,0,65,58
1656075578654,COGS 101C,A01,083625,Delgado; Tania,11,0,35,24
1656075584680,COGS 107A,A01,083627,Boyle; Mary E. T.,5,2,60,55
1656075590711,COGS 118A,A01,083075,Gupta; Anjum,24,16,76,52
1656075596743,CSE 3,A50,083646,Miranda; Gregory Joseph,20,0,50,30
1656075602772,CSE 8A,A50,083650,Miranda; Gregory Joseph,13,11,56,43
1656075608797,CSE 11,A01,083080,Cao; Yingjun,1,60,40,39
1656075614828,CSE 12,A01,083652,Krause-Levy; Sophia Louisa,14,7,120,106
1656075620860,CSE 15L,A01,083654,Morris; Justin Loren,5,1,50,45
1656075620860,CSE 15L,A02,083655,Morris; Justin Loren,7,0,50,43
1656075626888,CSE 20,A01,083657,Tran; Khoa Dang,31,0,80,49
1656075632915,CSE 21,A01,095574,Bach; Quang Tran,28,0,48,20
1656075638950,CSE 30,A01,083084,Eldon; John,3,10,80,77
1656075638950,CSE 30,B01,095061,Bhaskar; Nishant,4,5,50,46
1656075644975,CSE 100,A01,083659,Cao; Yingjun,2,23,70,68
1656075651013,CSE 134B,A01,083661,Powell; Thomas Allan,11,6,100,89
1656075657043,CSE 140,A01,083663,Gungor; Onat,9,0,85,76
1656075663074,CSE 140L,A01,083088,Eldon; John,8,0,100,92
1656075669107,CSE 175,A01,083665,Kumar; Rakesh,2,0,25,23
1656075675132,CSE 190,A00,092507,Dubnov; Shlomo,3,0,20,17
1656075681160,ECE 45,A01,083139,Congero; Spencer William,5,2,75,70
1656075687193,ECE 65,A50,083695,Saad; Andrew S,8,0,30,22
1656075687193,ECE 65,A51,095125,Staff,23,0,26,3
1656075693218,ECE 109,A01,091882,Touri; Behrouz,5,4,70,65
1656075699241,ECE 180,A00,083140,Abi Samra; Nicholas Camill,1,0,30,29
1656075699241,ECE 180,B00,083141,Abi Samra; Nicholas Camill,2,8,28,26
1656075705274,MATH 10A,A01,083735,Patchell; Gregory David,1,0,30,29
1656075705274,MATH 10A,A02,083736,Patchell; Gregory David,23,0,30,7
1656075705274,MATH 10A,A03,083737,Patchell; Gregory David,16,0,30,14
1656075711301,MATH 10B,A01,083207,Lim; Seonhee,3,1,34,31
1656075711301,MATH 10B,A02,083208,Lim; Seonhee,10,1,35,25
1656075711301,MATH 10B,A03,093472,Staff,4,1,34,30
1656075711301,MATH 10B,B01,083739,Sinha; Shubham,12,0,30,18
1656075717327,MATH 18,A01,083743,Cinel; Cameron Alexander,7,0,30,23
1656075717327,MATH 18,A02,083744,Cinel; Cameron Alexander,12,0,30,18
1656075717327,MATH 18,A03,083745,Cinel; Cameron Alexander,3,0,30,27
1656075717327,MATH 18,B01,083748,Ma; Zilu,1,0,36,35
1656075717327,MATH 18,B02,083749,Ma; Zilu,2,0,36,34
1656075717327,MATH 18,B03,083750,Ma; Zilu,0,0,36,36
1656075717327,MATH 18,B04,083751,Ma; Zilu,1,0,36,35
1656075717327,MATH 18,B05,093473,Staff,3,0,36,33
1656075717327,MATH 18,B06,093474,Staff,4,0,36,32
1656075723354,MATH 20A,A01,083754,Zheng; Zequn,11,0,40,29
1656075729379,MATH 20B,A01,083756,Briones; Jor-el Thomas Caparas,0,0,36,36
1656075729379,MATH 20B,A02,083757,Briones; Jor-el Thomas Caparas,2,0,36,34
1656075729379,MATH 20B,A03,093475,Staff,3,0,36,33
1656075735407,MATH 20C,A01,083760,Briones; Jor-el Thomas Caparas,2,2,35,33
1656075735407,MATH 20C,A02,083761,Briones; Jor-el Thomas Caparas,9,1,35,26
1656075735407,MATH 20C,A03,093476,Staff,1,1,35,34
1656075735407,MATH 20C,B01,083762,Bach; Quang Tran,5,0,30,25
1656075741432,MATH 20D,A01,083765,Tran; Brian Kha,3,0,30,27
1656075741432,MATH 20D,A02,083766,Tran; Brian Kha,0,1,30,30
1656075741432,MATH 20D,A03,083767,Tran; Brian Kha,2,0,30,28
1656075747466,MATH 20E,A01,083771,Ganguly; Soumya,4,1,32,28
1656075747466,MATH 20E,A02,083772,Ganguly; Soumya,2,1,32,30
1656075747466,MATH 20E,B01,083773,Ciotti; Benjamin,15,0,35,20
1656075747466,MATH 20E,B02,083774,Ciotti; Benjamin,15,0,35,20
1656075753492,MATH 103A,A01,083777,Greenfeld; Be'Eri,3,0,36,33
1656075753492,MATH 103A,A02,083778,Greenfeld; Be'Eri,3,0,36,33
1656075753492,MATH 103A,A03,093561,Staff,4,1,36,32
1656075753492,MATH 103A,B01,083779,Greenfeld; Be'Eri,8,1,36,28
1656075753492,MATH 103A,B02,083780,Greenfeld; Be'Eri,1,0,36,35
1656075753492,MATH 103A,B03,093562,Staff,1,0,36,35
1656075759521,MATH 105,A01,085443,Carter; Anne Toulson,4,1,35,31
1656075759521,MATH 105,A02,093477,Staff,12,0,35,23
1656075765551,MATH 109,A01,083213,Ganzberger; Geoffrey Michael,1,1,34,33
1656075765551,MATH 109,A02,083214,Ganzberger; Geoffrey Michael,0,0,34,34
1656075765551,MATH 109,A03,093478,Staff,3,0,34,31
1656075765551,MATH 109,B01,083215,Ganzberger; Geoffrey Michael,4,0,32,28
1656075765551,MATH 109,B02,083216,Ganzberger; Geoffrey Michael,1,0,32,31
1656075765551,MATH 109,B03,093479,Staff,4,0,32,28
1656075771584,MATH 142A,A01,083219,Chow; Bennett,2,0,32,30
1656075771584,MATH 142A,A02,083220,Chow; Bennett,8,0,32,24
1656075771584,MATH 142A,A03,093480,Staff,5,0,32,27
1656075771584,MATH 142A,B03,093481,Staff,5,0,32,27
1656075771584,MATH 142A,B04,093558,Staff,7,0,32,25
1656075771584,MATH 142A,B05,093559,Staff,0,0,32,32
1656075777611,MATH 193A,A01,083224,Rotar; Vladimir,1,2,34,33
1656075777611,MATH 193A,A02,083225,Rotar; Vladimir,3,0,34,31
1656075777611,MATH 193A,A03,083781,Rotar; Vladimir,3,0,34,31
1656075777611,MATH 193A,A04,083782,Rotar; Vladimir,7,0,34,27
1656075777611,MATH 193A,A05,093482,Rotar; Vladimir,1,0,34,33
1656075783636,MATH 197,001,091859,McAuley; Julian John,9999,0,9999,0
1656075783636,MATH 197,002,095566,Kedlaya; Kiran S.,9997,0,9999,2
1656075783636,MATH 197,003,095567,Xiao; Ming,9999,0,9999,0
1656075783636,MATH 197,004,095571,Perols; Johan Lars,9998,0,9999,1
1656075790701,COGS 9,A01,083615,Shannon; Kyle Michael,4,1,75,71
1656075796726,COGS 11,A01,083617,Boyle; Mary E. T.,16,1,48,32
1656075802751,COGS 13,A01,083071,Bastos; Amalia Pinkusfeld,8,2,71,63
1656075808777,COGS 14A,A01,092681,Semenuks; Arturs,8,23,100,92
1656075814804,COGS 14B,A01,083073,Cheng; Tzu-Han,9,0,63,54
1656075820905,COGS 17,A01,092677,Semenuks; Arturs,13,6,81,68
1656075826930,COGS 100,A01,083619,Allen; Michael Gordon,8,1,70,62
1656075832962,COGS 101A,A01,083621,Davis; Joshua Daniel,7,3,68,61
1656075838988,COGS 101B,A01,091572,Allen; Michael Gordon,7,0,65,58
1656075845020,COGS 101C,A01,083625,Delgado; Tania,11,0,35,24
1656075851045,COGS 107A,A01,083627,Boyle; Mary E. T.,5,2,60,55
1656075857074,COGS 118A,A01,083075,Gupta; Anjum,24,16,76,52
1656075863109,CSE 3,A50,083646,Miranda; Gregory Joseph,20,0,50,30
1656075869135,CSE 8A,A50,083650,Miranda; Gregory Joseph,13,11,56,43
1656075875164,CSE 11,A01,083080,Cao; Yingjun,1,60,40,39
1656075881206,CSE 12,A01,083652,Krause-Levy; Sophia Louisa,14,7,120,106
1656075887233,CSE 15L,A01,083654,Morris; Justin Loren,5,1,50,45
1656075887233,CSE 15L,A02,083655,Morris; Justin Loren,7,0,50,43
1656075893266,CSE 20,A01,083657,Tran; Khoa Dang,31,0,80,49
1656075899299,CSE 21,A01,095574,Bach; Quang Tran,28,0,48,20
1656075905331,CSE 30,A01,083084,Eldon; John,3,10,80,77
1656075905331,CSE 30,B01,095061,Bhaskar; Nishant,4,5,50,46
1656075911358,CSE 100,A01,083659,Cao; Yingjun,2,23,70,68
1656075917384,CSE 134B,A01,083661,Powell; Thomas Allan,11,6,100,89
1656075923414,CSE 140,A01,083663,Gungor; Onat,9,0,85,76
1656075929441,CSE 140L,A01,083088,Eldon; John,8,0,100,92
1656075935474,CSE 175,A01,083665,Kumar; Rakesh,2,0,25,23
1656075941505,CSE 190,A00,092507,Dubnov; Shlomo,3,0,20,17
1656075947539,ECE 45,A01,083139,Congero; Spencer William,5,2,75,70
1656075953565,ECE 65,A50,083695,Saad; Andrew S,8,0,30,22
1656075953565,ECE 65,A51,095125,Staff,23,0,26,3
1656075959597,ECE 109,A01,091882,Touri; Behrouz,5,4,70,65
1656075965624,ECE 180,A00,083140,Abi Samra; Nicholas Camill,1,0,30,29
1656075965624,ECE 180,B00,083141,Abi Samra; Nicholas Camill,2,8,28,26
1656075971651,MATH 10A,A01,083735,Patchell; Gregory David,1,0,30,29
1656075971651,MATH 10A,A02,083736,Patchell; Gregory David,23,0,30,7
1656075971651,MATH 10A,A03,083737,Patchell; Gregory David,16,0,30,14
1656075977690,MATH 10B,A01,083207,Lim; Seonhee,3,1,34,31
1656075977690,MATH 10B,A02,083208,Lim; Seonhee,10,1,35,25
1656075977690,MATH 10B,A03,093472,Staff,4,1,34,30
1656075977690,MATH 10B,B01,083739,Sinha; Shubham,12,0,30,18
1656075983727,MATH 18,A01,083743,Cinel; Cameron Alexander,7,0,30,23
1656075983727,MATH 18,A02,083744,Cinel; Cameron Alexander,12,0,30,18
1656075983727,MATH 18,A03,083745,Cinel; Cameron Alexander,3,0,30,27
1656075983727,MATH 18,B01,083748,Ma; Zilu,1,0,36,35
1656075983727,MATH 18,B02,083749,Ma; Zilu,2,0,36,34
1656075983727,MATH 18,B03,083750,Ma; Zilu,0,0,36,36
1656075983727,MATH 18,B04,083751,Ma; Zilu,1,0,36,35
1656075983727,MATH 18,B05,093473,Staff,3,0,36,33
1656075983727,MATH 18,B06,093474,Staff,4,0,36,32
1656075989755,MATH 20A,A01,083754,Zheng; Zequn,11,0,40,29
1656075995782,MATH 20B,A01,083756,Briones; Jor-el Thomas Caparas,0,0,36,36
1656075995782,MATH 20B,A02,083757,Briones; Jor-el Thomas Caparas,2,0,36,34
1656075995782,MATH 20B,A03,093475,Staff,3,0,36,33
1656076001816,MATH 20C,A01,083760,Briones; Jor-el Thomas Caparas,2,2,35,33
1656076001816,MATH 20C,A02,083761,Briones; Jor-el Thomas Caparas,9,1,35,26
1656076001816,MATH 20C,A03,093476,Staff,1,1,35,34
1656076001816,MATH 20C,B01,083762,Bach; Quang Tran,5,0,30,25
1656076007840,MATH 20D,A01,083765,Tran; Brian Kha,3,0,30,27
1656076007840,MATH 20D,A02,083766,Tran; Brian Kha,0,1,30,30
1656076007840,MATH 20D,A03,083767,Tran; Brian Kha,2,0,30,28
1656076013869,MATH 20E,A01,083771,Ganguly; Soumya,4,1,32,28
1656076013869,MATH 20E,A02,083772,Ganguly; Soumya,2,1,32,30
1656076013869,MATH 20E,B01,083773,Ciotti; Benjamin,15,0,35,20
1656076013869,MATH 20E,B02,083774,Ciotti; Benjamin,15,0,35,20
1656076019906,MATH 103A,A01,083777,Greenfeld; Be'Eri,3,0,36,33
1656076019906,MATH 103A,A02,083778,Greenfeld; Be'Eri,3,0,36,33
1656076019906,MATH 103A,A03,093561,Staff,4,1,36,32
1656076019906,MATH 103A,B01,083779,Greenfeld; Be'Eri,8,1,36,28
1656076019906,MATH 103A,B02,083780,Greenfeld; Be'Eri,1,0,36,35
1656076019906,MATH 103A,B03,093562,Staff,1,0,36,35
1656076025937,MATH 105,A01,085443,Carter; Anne Toulson,4,1,35,31
1656076025937,MATH 105,A02,093477,Staff,12,0,35,23
1656076031963,MATH 109,A01,083213,Ganzberger; Geoffrey Michael,1,1,34,33
1656076031963,MATH 109,A02,083214,Ganzberger; Geoffrey Michael,0,0,34,34
1656076031963,MATH 109,A03,093478,Staff,3,0,34,31
1656076031963,MATH 109,B01,083215,Ganzberger; Geoffrey Michael,4,0,32,28
1656076031963,MATH 109,B02,083216,Ganzberger; Geoffrey Michael,1,0,32,31
1656076031963,MATH 109,B03,093479,Staff,4,0,32,28
1656076037992,MATH 142A,A01,083219,Chow; Bennett,2,0,32,30
1656076037992,MATH 142A,A02,083220,Chow; Bennett,8,0,32,24
1656076037992,MATH 142A,A03,093480,Staff,5,0,32,27
1656076037992,MATH 142A,B03,093481,Staff,5,0,32,27
1656076037992,MATH 142A,B04,093558,Staff,7,0,32,25
1656076037992,MATH 142A,B05,093559,Staff,0,0,32,32
1656076044015,MATH 193A,A01,083224,Rotar; Vladimir,1,2,34,33
1656076044015,MATH 193A,A02,083225,Rotar; Vladimir,3,0,34,31
1656076044015,MATH 193A,A03,083781,Rotar; Vladimir,3,0,34,31
1656076044015,MATH 193A,A04,083782,Rotar; Vladimir,7,0,34,27
1656076044015,MATH 193A,A05,093482,Rotar; Vladimir,1,0,34,33
1656076050040,MATH 197,001,091859,McAuley; Julian John,9999,0,9999,0
1656076050040,MATH 197,002,095566,Kedlaya; Kiran S.,9997,0,9999,2
1656076050040,MATH 197,003,095567,Xiao; Ming,9999,0,9999,0
1656076050040,MATH 197,004,095571,Perols; Johan Lars,9998,0,9999,1
1656076057106,COGS 9,A01,083615,Shannon; Kyle Michael,4,1,75,71
1656076063130,COGS 11,A01,083617,Boyle; Mary E. T.,16,1,48,32
1656076069154,COGS 13,A01,083071,Bastos; Amalia Pinkusfeld,8,2,71,63
1656076075179,COGS 14A,A01,092681,Semenuks; Arturs,8,23,100,92
1656076081206,COGS 14B,A01,083073,Cheng; Tzu-Han,9,0,63,54
1656076087235,COGS 17,A01,092677,Semenuks; Arturs,13,6,81,68
1656076093266,COGS 100,A01,083619,Allen; Michael Gordon,8,1,70,62
1656076099290,COGS 101A,A01,083621,Davis; Joshua Daniel,7,3,68,61
1656076105321,COGS 101B,A01,091572,Allen; Michael Gordon,7,0,65,58
1656076111350,COGS 101C,A01,083625,Delgado; Tania,11,0,35,24
1656076117379,COGS 107A,A01,083627,Boyle; Mary E. T.,5,2,60,55
1656076123411,COGS 118A,A01,083075,Gupta; Anjum,24,16,76,52
1656076129443,CSE 3,A50,083646,Miranda; Gregory Joseph,20,0,50,30
1656076135468,CSE 8A,A50,083650,Miranda; Gregory Joseph,13,11,56,43
1656076141498,CSE 11,A01,083080,Cao; Yingjun,1,60,40,39
1656076147535,CSE 12,A01,083652,Krause-Levy; Sophia Louisa,14,7,120,106
1656076153566,CSE 15L,A01,083654,Morris; Justin Loren,5,1,50,45
1656076153566,CSE 15L,A02,083655,Morris; Justin Loren,7,0,50,43
1656076159598,CSE 20,A01,083657,Tran; Khoa Dang,31,0,80,49
1656076165624,CSE 21,A01,095574,Bach; Quang Tran,28,0,48,20
1656076171652,CSE 30,A01,083084,Eldon; John,3,10,80,77
1656076171652,CSE 30,B01,095061,Bhaskar; Nishant,4,5,50,46
1656076177679,CSE 100,A01,083659,Cao; Yingjun,2,23,70,68
1656076183708,CSE 134B,A01,083661,Powell; Thomas Allan,11,6,100,89
1656076189737,CSE 140,A01,083663,Gungor; Onat,9,0,85,76
1656076195760,CSE 140L,A01,083088,Eldon; John,8,0,100,92
1656076201785,CSE 175,A01,083665,Kumar; Rakesh,2,0,25,23
1656076207816,CSE 190,A00,092507,Dubnov; Shlomo,3,0,20,17
1656076213848,ECE 45,A01,083139,Congero; Spencer William,5,2,75,70
1656076219875,ECE 65,A50,083695,Saad; Andrew S,8,0,30,22
1656076219875,ECE 65,A51,095125,Staff,23,0,26,3
1656076225912,ECE 109,A01,091882,Touri; Behrouz,5,4,70,65
1656076231944,ECE 180,A00,083140,Abi Samra; Nicholas Camill,1,0,30,29
1656076231944,ECE 180,B00,083141,Abi Samra; Nicholas Camill,2,8,28,26
1656076237970,MATH 10A,A01,083735,Patchell; Gregory David,1,0,30,29
1656076237970,MATH 10A,A02,083736,Patchell; Gregory David,23,0,30,7
1656076237970,MATH 10A,A03,083737,Patchell; Gregory David,16,0,30,14
1656076244003,MATH 10B,A01,083207,Lim; Seonhee,3,1,34,31
1656076244003,MATH 10B,A02,083208,Lim; Seonhee,10,1,35,25
1656076244003,MATH 10B,A03,093472,Staff,4,1,34,30
1656076244003,MATH 10B,B01,083739,Sinha; Shubham,12,0,30,18
1656076250031,MATH 18,A01,083743,Cinel; Cameron Alexander,7,0,30,23
1656076250031,MATH 18,A02,083744,Cinel; Cameron Alexander,12,0,30,18
1656076250031,MATH 18,A03,083745,Cinel; Cameron Alexander,3,0,30,27
1656076250031,MATH 18,B01,083748,Ma; Zilu,1,0,36,35
1656076250031,MATH 18,B02,083749,Ma; Zilu,2,0,36,34
1656076250031,MATH 18,B03,083750,Ma; Zilu,0,0,36,36
1656076250031,MATH 18,B04,083751,Ma; Zilu,1,0,36,35
1656076250031,MATH 18,B05,093473,Staff,3,0,36,33
1656076250031,MATH 18,B06,093474,Staff,4,0,36,32
1656076256056,MATH 20A,A01,083754,Zheng; Zequn,11,0,40,29
1656076262086,MATH 20B,A01,083756,Briones; Jor-el Thomas Caparas,0,0,36,36
1656076262086,MATH 20B,A02,083757,Briones; Jor-el Thomas Caparas,2,0,36,34
1656076262086,MATH 20B,A03,093475,Staff,3,0,36,33
1656076268115,MATH 20C,A01,083760,Briones; Jor-el Thomas Caparas,2,2,35,33
1656076268115,MATH 20C,A02,083761,Briones; Jor-el Thomas Caparas,9,1,35,26
1656076268115,MATH 20C,A03,093476,Staff,1,1,35,34
1656076268115,MATH 20C,B01,083762,Bach; Quang Tran,5,0,30,25
1656076274139,MATH 20D,A01,083765,Tran; Brian Kha,3,0,30,27
1656076274139,MATH 20D,A02,083766,Tran; Brian Kha,0,1,30,30
1656076274139,MATH 20D,A03,083767,Tran; Brian Kha,2,0,30,28
1656076280167,MATH 20E,A01,083771,Ganguly; Soumya,4,1,32,28
1656076280167,MATH 20E,A02,083772,Ganguly; Soumya,2,1,32,30
1656076280167,MATH 20E,B01,083773,Ciotti; Benjamin,15,0,35,20
1656076280167,MATH 20E,B02,083774,Ciotti; Benjamin,15,0,35,20
1656076286196,MATH 103A,A01,083777,Greenfeld; Be'Eri,3,0,36,33
1656076286196,MATH 103A,A02,083778,Greenfeld; Be'Eri,3,0,36,33
1656076286196,MATH 103A,A03,093561,Staff,4,1,36,32
1656076286196,MATH 103A,B01,083779,Greenfeld; Be'Eri,8,1,36,28
1656076286196,MATH 103A,B02,083780,Greenfeld; Be'Eri,1,0,36,35
1656076286196,MATH 103A,B03,093562,Staff,1,0,36,35
1656076292240,MATH 105,A01,085443,Carter; Anne Toulson,4,1,35,31
1656076292240,MATH 105,A02,093477,Staff,12,0,35,23
1656076298264,MATH 109,A01,083213,Ganzberger; Geoffrey Michael,1,1,34,33
1656076298264,MATH 109,A02,083214,Ganzberger; Geoffrey Michael,0,0,34,34
1656076298264,MATH 109,A03,093478,Staff,3,0,34,31
1656076298264,MATH 109,B01,083215,Ganzberger; Geoffrey Michael,4,0,32,28
1656076298264,MATH 109,B02,083216,Ganzberger; Geoffrey Michael,1,0,32,31
1656076298264,MATH 109,B03,093479,Staff,4,0,32,28
1656076304299,MATH 142A,A01,083219,Chow; Bennett,2,0,32,30
1656076304299,MATH 142A,A02,083220,Chow; Bennett,8,0,32,24
1656076304299,MATH 142A,A03,093480,Staff,5,0,32,27
1656076304299,MATH 142A,B03,093481,Staff,5,0,32,27
1656076304299,MATH 142A,B04,093558,Staff,7,0,32,25
1656076304299,MATH 142A,B05,093559,Staff,0,0,32,32
1656076310324,MATH 193A,A01,083224,Rotar; Vladimir,1,2,34,33
1656076310324,MATH 193A,A02,083225,Rotar; Vladimir,3,0,34,31
1656076310324,MATH 193A,A03,083781,Rotar; Vladimir,3,0,34,31
1656076310324,MATH 193A,A04,083782,Rotar; Vladimir,7,0,34,27
1656076310324,MATH 193A,A05,093482,Rotar; Vladimir,1,0,34,33
1656076316370,MATH 197,001,091859,McAuley; Julian John,9999,0,9999,0
1656076316370,MATH 197,002,095566,Kedlaya; Kiran S.,9997,0,9999,2
1656076316370,MATH 197,003,095567,Xiao; Ming,9999,0,9999,0
1656076316370,MATH 197,004,095571,Perols; Johan Lars,9998,0,9999,1
1656076323431,COGS 9,A01,083615,Shannon; Kyle Michael,4,1,75,71
1656076329457,COGS 11,A01,083617,Boyle; Mary E. T.,16,1,48,32
1656076335491,COGS 13,A01,083071,Bastos; Amalia Pinkusfeld,8,2,71,63
1656076341516,COGS 14A,A01,092681,Semenuks; Arturs,8,23,100,92
1656076347542,COGS 14B,A01,083073,Cheng; Tzu-Han,9,0,63,54
1656076353566,COGS 17,A01,092677,Semenuks; Arturs,13,6,81,68
1656076359597,COGS 100,A01,083619,Allen; Michael Gordon,8,1,70,62
1656076365625,COGS 101A,A01,083621,Davis; Joshua Daniel,7,3,68,61
1656076371663,COGS 101B,A01,091572,Allen; Michael Gordon,7,0,65,58
1656076377688,COGS 101C,A01,083625,Delgado; Tania,11,0,35,24
1656076383721,COGS 107A,A01,083627,Boyle; Mary E. T.,5,2,60,55
1656076389750,COGS 118A,A01,083075,Gupta; Anjum,24,16,76,52
1656076395786,CSE 3,A50,083646,Miranda; Gregory Joseph,20,0,50,30
1656076401811,CSE 8A,A50,083650,Miranda; Gregory Joseph,13,11,56,43
1656076407835,CSE 11,A01,083080,Cao; Yingjun,1,60,40,39
1656076413865,CSE 12,A01,083652,Krause-Levy; Sophia Louisa,14,7,120,106
1656076419985,CSE 15L,A01,083654,Morris; Justin Loren,5,1,50,45
1656076419985,CSE 15L,A02,083655,Morris; Justin Loren,7,0,50,43
1656076426009,CSE 20,A01,083657,Tran; Khoa Dang,31,0,80,49
1656076432035,CSE 21,A01,095574,Bach; Quang Tran,28,0,48,20
1656076438063,CSE 30,A01,083084,Eldon; John,3,10,80,77
1656076438063,CSE 30,B01,095061,Bhaskar; Nishant,4,5,50,46
1656076444088,CSE 100,A01,083659,Cao; Yingjun,2,23,70,68
1656076450112,CSE 134B,A01,083661,Powell; Thomas Allan,11,6,100,89
1656076456141,CSE 140,A01,083663,Gungor; Onat,9,0,85,76
1656076462171,CSE 140L,A01,083088,Eldon; John,8,0,100,92
1656076468197,CSE 175,A01,083665,Kumar; Rakesh,2,0,25,23
1656076474224,CSE 190,A00,092507,Dubnov; Shlomo,3,0,20,17
1656076480252,ECE 45,A01,083139,Congero; Spencer William,5,2,75,70
1656076486286,ECE 65,A50,083695,Saad; Andrew S,8,0,30,22
1656076486286,ECE 65,A51,095125,Staff,23,0,26,3
1656076492313,ECE 109,A01,091882,Touri; Behrouz,5,4,70,65
1656076498339,ECE 180,A00,083140,Abi Samra; Nicholas Camill,1,0,30,29
1656076498339,ECE 180,B00,083141,Abi Samra; Nicholas Camill,2,8,28,26
1656076504364,MATH 10A,A01,083735,Patchell; Gregory David,1,0,30,29
1656076504364,MATH 10A,A02,083736,Patchell; Gregory David,23,0,30,7
1656076504364,MATH 10A,A03,083737,Patchell; Gregory David,16,0,30,14
1656076510401,MATH 10B,A01,083207,Lim; Seonhee,3,1,34,31
1656076510401,MATH 10B,A02,083208,Lim; Seonhee,10,1,35,25
1656076510401,MATH 10B,A03,093472,Staff,4,1,34,30
1656076510401,MATH 10B,B01,083739,Sinha; Shubham,12,0,30,18
1656076516427,MATH 18,A01,083743,Cinel; Cameron Alexander,7,0,30,23
1656076516427,MATH 18,A02,083744,Cinel; Cameron Alexander,12,0,30,18
1656076516427,MATH 18,A03,083745,Cinel; Cameron Alexander,3,0,30,27
1656076516427,MATH 18,B01,083748,Ma; Zilu,1,0,36,35
1656076516427,MATH 18,B02,083749,Ma; Zilu,2,0,36,34
1656076516427,MATH 18,B03,083750,Ma; Zilu,0,0,36,36
1656076516427,MATH 18,B04,083751,Ma; Zilu,1,0,36,35
1656076516427,MATH 18,B05,093473,Staff,3,0,36,33
1656076516427,MATH 18,B06,093474,Staff,4,0,36,32
1656076522452,MATH 20A,A01,083754,Zheng; Zequn,11,0,40,29
1656076528477,MATH 20B,A01,083756,Briones; Jor-el Thomas Caparas,0,0,36,36
1656076528477,MATH 20B,A02,083757,Briones; Jor-el Thomas Caparas,2,0,36,34
1656076528477,MATH 20B,A03,093475,Staff,3,0,36,33
1656076534506,MATH 20C,A01,083760,Briones; Jor-el Thomas Caparas,2,2,35,33
1656076534506,MATH 20C,A02,083761,Briones; Jor-el Thomas Caparas,9,1,35,26
1656076534506,MATH 20C,A03,093476,Staff,1,1,35,34
1656076534506,MATH 20C,B01,083762,Bach; Quang Tran,5,0,30,25
1656076540531,MATH 20D,A01,083765,Tran; Brian Kha,3,0,30,27
1656076540531,MATH 20D,A02,083766,Tran; Brian Kha,0,1,30,30
1656076540531,MATH 20D,A03,083767,Tran; Brian Kha,2,0,30,28
1656076546558,MATH 20E,A01,083771,Ganguly; Soumya,4,1,32,28
1656076546558,MATH 20E,A02,083772,Ganguly; Soumya,2,1,32,30
1656076546558,MATH 20E,B01,083773,Ciotti; Benjamin,15,0,35,20
1656076546558,MATH 20E,B02,083774,Ciotti; Benjamin,15,0,35,20
1656076552585,MATH 103A,A01,083777,Greenfeld; Be'Eri,3,0,36,33
1656076552585,MATH 103A,A02,083778,Greenfeld; Be'Eri,3,0,36,33
1656076552585,MATH 103A,A03,093561,Staff,4,1,36,32
1656076552585,MATH 103A,B01,083779,Greenfeld; Be'Eri,8,1,36,28
1656076552585,MATH 103A,B02,083780,Greenfeld; Be'Eri,1,0,36,35
1656076552585,MATH 103A,B03,093562,Staff,1,0,36,35
1656076558613,MATH 105,A01,085443,Carter; Anne Toulson,4,1,35,31
1656076558613,MATH 105,A02,093477,Staff,12,0,35,23
1656076564661,MATH 109,A01,083213,Ganzberger; Geoffrey Michael,1,1,34,33
1656076564661,MATH 109,A02,083214,Ganzberger; Geoffrey Michael,0,0,34,34
1656076564661,MATH 109,A03,093478,Staff,3,0,34,31
1656076564661,MATH 109,B01,083215,Ganzberger; Geoffrey Michael,4,0,32,28
1656076564661,MATH 109,B02,083216,Ganzberger; Geoffrey Michael,1,0,32,31
1656076564661,MATH 109,B03,093479,Staff,4,0,32,28
1656076570692,MATH 142A,A01,083219,Chow; Bennett,2,0,32,30
1656076570692,MATH 142A,A02,083220,Chow; Bennett,8,0,32,24
1656076570692,MATH 142A,A03,093480,Staff,5,0,32,27
1656076570692,MATH 142A,B03,093481,Staff,5,0,32,27
1656076570692,MATH 142A,B04,093558,Staff,7,0,32,25
1656076570692,MATH 142A,B05,093559,Staff,0,0,32,32
1656076576723,MATH 193A,A01,083224,Rotar; Vladimir,1,2,34,33
1656076576723,MATH 193A,A02,083225,Rotar; Vladimir,3,0,34,31
1656076576723,MATH 193A,A03,083781,Rotar; Vladimir,3,0,34,31
1656076576723,MATH 193A,A04,083782,Rotar; Vladimir,7,0,34,27
1656076576723,MATH 193A,A05,093482,Rotar; Vladimir,1,0,34,33
1656076582748,MATH 197,001,091859,McAuley; Julian John,9999,0,9999,0
1656076582748,MATH 197,002,095566,Kedlaya; Kiran S.,9997,0,9999,2
1656076582748,MATH 197,003,095567,Xiao; Ming,9999,0,9999,0
1656076582748,MATH 197,004,095571,Perols; Johan Lars,9998,0,9999,1
1656076589819,COGS 9,A01,083615,Shannon; Kyle Michael,4,1,75,71
1656076595849,COGS 11,A01,083617,Boyle; Mary E. T.,16,1,48,32
1656076601874,COGS 13,A01,083071,Bastos; Amalia Pinkusfeld,8,2,71,63
1656076607904,COGS 14A,A01,092681,Semenuks; Arturs,8,23,100,92
1656076613935,COGS 14B,A01,083073,Cheng; Tzu-Han,9,0,63,54
1656076619967,COGS 17,A01,092677,Semenuks; Arturs,13,6,81,68
1656076625993,COGS 100,A01,083619,Allen; Michael Gordon,8,1,70,62
1656076632018,COGS 101A,A01,083621,Davis; Joshua Daniel,7,3,68,61
1656076638055,COGS 101B,A01,091572,Allen; Michael Gordon,7,0,65,58
1656076644086,COGS 101C,A01,083625,Delgado; Tania,11,0,35,24
1656076650118,COGS 107A,A01,083627,Boyle; Mary E. T.,5,2,60,55
1656076656144,COGS 118A,A01,083075,Gupta; Anjum,24,16,76,52
1656076662180,CSE 3,A50,083646,Miranda; Gregory Joseph,20,0,50,30
1656076668210,CSE 8A,A50,083650,Miranda; Gregory Joseph,13,11,56,43
1656076674232,CSE 11,A01,083080,Cao; Yingjun,1,60,40,39
1656076680260,CSE 12,A01,083652,Krause-Levy; Sophia Louisa,14,7,120,106
1656076686291,CSE 15L,A01,083654,Morris; Justin Loren,5,1,50,45
1656076686291,CSE 15L,A02,083655,Morris; Justin Loren,7,0,50,43
1656076692316,CSE 20,A01,083657,Tran; Khoa Dang,31,0,80,49
1656076698342,CSE 21,A01,095574,Bach; Quang Tran,28,0,48,20
1656076704375,CSE 30,A01,083084,Eldon; John,3,10,80,77
1656076704375,CSE 30,B01,095061,Bhaskar; Nishant,4,5,50,46
1656076710399,CSE 100,A01,083659,Cao; Yingjun,2,23,70,68
1656076716422,CSE 134B,A01,083661,Powell; Thomas Allan,11,6,100,89
1656076722449,CSE 140,A01,083663,Gungor; Onat,9,0,85,76
1656076728478,CSE 140L,A01,083088,Eldon; John,8,0,100,92
1656076734504,CSE 175,A01,083665,Kumar; Rakesh,2,0,25,23
1656076740530,CSE 190,A00,092507,Dubnov; Shlomo,3,0,20,17
1656076746562,ECE 45,A01,083139,Congero; Spencer William,5,2,75,70
1656076752588,ECE 65,A50,083695,Saad; Andrew S,8,0,30,22
1656076752588,ECE 65,A51,095125,Staff,23,0,26,3
1656076758614,ECE 109,A01,091882,Touri; Behrouz,5,4,70,65
1656076764641,ECE 180,A00,083140,Abi Samra; Nicholas Camill,1,0,30,29
1656076764641,ECE 180,B00,083141,Abi Samra; Nicholas Camill,2,8,28,26
1656076770673,MATH 10A,A01,083735,Patchell; Gregory David,1,0,30,29
1656076770673,MATH 10A,A02,083736,Patchell; Gregory David,23,0,30,7
1656076770673,MATH 10A,A03,083737,Patchell; Gregory David,16,0,30,14
1656076776703,MATH 10B,A01,083207,Lim; Seonhee,3,1,34,31
1656076776703,MATH 10B,A02,083208,Lim; Seonhee,10,1,35,25
1656076776703,MATH 10B,A03,093472,Staff,4,1,34,30
1656076776703,MATH 10B,B01,083739,Sinha; Shubham,12,0,30,18
1656076782732,MATH 18,A01,083743,Cinel; Cameron Alexander,7,0,30,23
1656076782732,MATH 18,A02,083744,Cinel; Cameron Alexander,12,0,30,18
1656076782732,MATH 18,A03,083745,Cinel; Cameron Alexander,3,0,30,27
1656076782732,MATH 18,B01,083748,Ma; Zilu,1,0,36,35
1656076782732,MATH 18,B02,083749,Ma; Zilu,2,0,36,34
1656076782732,MATH 18,B03,083750,Ma; Zilu,0,0,36,36
1656076782732,MATH 18,B04,083751,Ma; Zilu,1,0,36,35
1656076782732,MATH 18,B05,093473,Staff,3,0,36,33
1656076782732,MATH 18,B06,093474,Staff,4,0,36,32
1656076788758,MATH 20A,A01,083754,Zheng; Zequn,11,0,40,29
1656076794791,MATH 20B,A01,083756,Briones; Jor-el Thomas Caparas,0,0,36,36
1656076794791,MATH 20B,A02,083757,Briones; Jor-el Thomas Caparas,2,0,36,34
1656076794791,MATH 20B,A03,093475,Staff,3,0,36,33
1656076800818,MATH 20C,A01,083760,Briones; Jor-el Thomas Caparas,2,2,35,33
1656076800818,MATH 20C,A02,083761,Briones; Jor-el Thomas Caparas,9,1,35,26
1656076800818,MATH 20C,A03,093476,Staff,1,1,35,34
1656076800818,MATH 20C,B01,083762,Bach; Quang Tran,5,0,30,25
1656076806843,MATH 20D,A01,083765,Tran; Brian Kha,3,0,30,27
1656076806843,MATH 20D,A02,083766,Tran; Brian Kha,0,1,30,30
1656076806843,MATH 20D,A03,083767,Tran; Brian Kha,2,0,30,28
1656076812870,MATH 20E,A01,083771,Ganguly; Soumya,4,1,32,28
1656076812870,MATH 20E,A02,083772,Ganguly; Soumya,2,1,32,30
1656076812870,MATH 20E,B01,083773,Ciotti; Benjamin,15,0,35,20
1656076812870,MATH 20E,B02,083774,Ciotti; Benjamin,15,0,35,20
1656076818897,MATH 103A,A01,083777,Greenfeld; Be'Eri,3,0,36,33
1656076818897,MATH 103A,A02,083778,Greenfeld; Be'Eri,3,0,36,33
1656076818897,MATH 103A,A03,093561,Staff,4,1,36,32
1656076818897,MATH 103A,B01,083779,Greenfeld; Be'Eri,8,1,36,28
1656076818897,MATH 103A,B02,083780,Greenfeld; Be'Eri,1,0,36,35
1656076818897,MATH 103A,B03,093562,Staff,1,0,36,35
1656076824926,MATH 105,A01,085443,Carter; Anne Toulson,4,1,35,31
1656076824926,MATH 105,A02,093477,Staff,12,0,35,23
1656076830955,MATH 109,A01,083213,Ganzberger; Geoffrey Michael,1,1,34,33
1656076830955,MATH 109,A02,083214,Ganzberger; Geoffrey Michael,0,0,34,34
1656076830955,MATH 109,A03,093478,Staff,3,0,34,31
1656076830955,MATH 109,B01,083215,Ganzberger; Geoffrey Michael,4,0,32,28
1656076830955,MATH 109,B02,083216,Ganzberger; Geoffrey Michael,1,0,32,31
1656076830955,MATH 109,B03,093479,Staff,4,0,32,28
1656076836991,MATH 142A,A01,083219,Chow; Bennett,2,0,32,30
1656076836991,MATH 142A,A02,083220,Chow; Bennett,8,0,32,24
1656076836991,MATH 142A,A03,093480,Staff,5,0,32,27
1656076836991,MATH 142A,B03,093481,Staff,5,0,32,27
1656076836991,MATH 142A,B04,093558,Staff,7,0,32,25
1656076836991,MATH 142A,B05,093559,Staff,0,0,32,32
1656076843019,MATH 193A,A01,083224,Rotar; Vladimir,1,2,34,33
1656076843019,MATH 193A,A02,083225,Rotar; Vladimir,3,0,34,31
1656076843019,MATH 193A,A03,083781,Rotar; Vladimir,3,0,34,31
1656076843019,MATH 193A,A04,083782,Rotar; Vladimir,7,0,34,27
1656076843019,MATH 193A,A05,093482,Rotar; Vladimir,1,0,34,33
1656076849045,MATH 197,001,091859,McAuley; Julian John,9999,0,9999,0
1656076849045,MATH 197,002,095566,Kedlaya; Kiran S.,9997,0,9999,2
1656076849045,MATH 197,003,095567,Xiao; Ming,9999,0,9999,0
1656076849045,MATH 197,004,095571,Perols; Johan Lars,9998,0,9999,1
1656076856147,COGS 9,A01,083615,Shannon; Kyle Michael,4,1,75,71
1656076862199,COGS 11,A01,083617,Boyle; Mary E. T.,16,1,48,32
1656076868224,COGS 13,A01,083071,Bastos; Amalia Pinkusfeld,8,2,71,63
1656076874252,COGS 14A,A01,092681,Semenuks; Arturs,8,23,100,92
1656076880287,COGS 14B,A01,083073,Cheng; Tzu-Han,9,0,63,54
1656076886314,COGS 17,A01,092677,Semenuks; Arturs,13,6,81,68
1656076892347,COGS 100,A01,083619,Allen; Michael Gordon,8,1,70,62
1656076898373,COGS 101A,A01,083621,Davis; Joshua Daniel,7,3,68,61
1656076904399,COGS 101B,A01,091572,Allen; Michael Gordon,7,0,65,58
1656076910433,COGS 101C,A01,083625,Delgado; Tania,11,0,35,24
1656076916458,COGS 107A,A01,083627,Boyle; Mary E. T.,5,2,60,55
1656076922483,COGS 118A,A01,083075,Gupta; Anjum,24,16,76,52
1656076928510,CSE 3,A50,083646,Miranda; Gregory Joseph,20,0,50,30
1656076934536,CSE 8A,A50,083650,Miranda; Gregory Joseph,13,11,56,43
1656076940562,CSE 11,A01,083080,Cao; Yingjun,1,60,40,39
1656076946596,CSE 12,A01,083652,Krause-Levy; Sophia Louisa,14,7,120,106
1656076952622,CSE 15L,A01,083654,Morris; Justin Loren,5,1,50,45
1656076952622,CSE 15L,A02,083655,Morris; Justin Loren,7,0,50,43
1656076958652,CSE 20,A01,083657,Tran; Khoa Dang,31,0,80,49
1656076964691,CSE 21,A01,095574,Bach; Quang Tran,28,0,48,20
1656076970718,CSE 30,A01,083084,Eldon; John,3,10,80,77
1656076970718,CSE 30,B01,095061,Bhaskar; Nishant,4,5,50,46
1656076976745,CSE 100,A01,083659,Cao; Yingjun,2,23,70,68
1656076982777,CSE 134B,A01,083661,Powell; Thomas Allan,11,6,100,89
1656076988803,CSE 140,A01,083663,Gungor; Onat,9,0,85,76
1656076994829,CSE 140L,A01,083088,Eldon; John,8,0,100,92
1656077000854,CSE 175,A01,083665,Kumar; Rakesh,2,0,25,23
1656077006880,CSE 190,A00,092507,Dubnov; Shlomo,3,0,20,17
1656077012915,ECE 45,A01,083139,Congero; Spencer William,5,2,75,70
1656077019045,ECE 65,A50,083695,Saad; Andrew S,8,0,30,22
1656077019045,ECE 65,A51,095125,Staff,23,0,26,3
1656077025073,ECE 109,A01,091882,Touri; Behrouz,5,4,70,65
1656077031099,ECE 180,A00,083140,Abi Samra; Nicholas Camill,1,0,30,29
1656077031099,ECE 180,B00,083141,Abi Samra; Nicholas Camill,2,8,28,26
1656077037138,MATH 10A,A01,083735,Patchell; Gregory David,1,0,30,29
1656077037138,MATH 10A,A02,083736,Patchell; Gregory David,23,0,30,7
1656077037138,MATH 10A,A03,083737,Patchell; Gregory David,16,0,30,14
1656077043168,MATH 10B,A01,083207,Lim; Seonhee,3,1,34,31
1656077043168,MATH 10B,A02,083208,Lim; Seonhee,10,1,35,25
1656077043168,MATH 10B,A03,093472,Staff,4,1,34,30
1656077043168,MATH 10B,B01,083739,Sinha; Shubham,12,0,30,18
1656077049206,MATH 18,A01,083743,Cinel; Cameron Alexander,7,0,30,23
1656077049206,MATH 18,A02,083744,Cinel; Cameron Alexander,12,0,30,18
1656077049206,MATH 18,A03,083745,Cinel; Cameron Alexander,3,0,30,27
1656077049206,MATH 18,B01,083748,Ma; Zilu,1,0,36,35
1656077049206,MATH 18,B02,083749,Ma; Zilu,2,0,36,34
1656077049206,MATH 18,B03,083750,Ma; Zilu,0,0,36,36
1656077049206,MATH 18,B04,083751,Ma; Zilu,1,0,36,35
1656077049206,MATH 18,B05,093473,Staff,3,0,36,33
1656077049206,MATH 18,B06,093474,Staff,4,0,36,32
1656077055239,MATH 20A,A01,083754,Zheng; Zequn,11,0,40,29
1656077061266,MATH 20B,A01,083756,Briones; Jor-el Thomas Caparas,0,0,36,36
1656077061266,MATH 20B,A02,083757,Briones; Jor-el Thomas Caparas,2,0,36,34
1656077061266,MATH 20B,A03,093475,Staff,3,0,36,33
1656077067301,MATH 20C,A01,083760,Briones; Jor-el Thomas Caparas,2,2,35,33
1656077067301,MATH 20C,A02,083761,Briones; Jor-el Thomas Caparas,9,1,35,26
1656077067301,MATH 20C,A03,093476,Staff,1,1,35,34
1656077067301,MATH 20C,B01,083762,Bach; Quang Tran,5,0,30,25
1656077073325,MATH 20D,A01,083765,Tran; Brian Kha,3,0,30,27
1656077073325,MATH 20D,A02,083766,Tran; Brian Kha,0,1,30,30
1656077073325,MATH 20D,A03,083767,Tran; Brian Kha,2,0,30,28
1656077079372,MATH 20E,A01,083771,Ganguly; Soumya,4,1,32,28
1656077079372,MATH 20E,A02,083772,Ganguly; Soumya,2,1,32,30
1656077079372,MATH 20E,B01,083773,Ciotti; Benjamin,15,0,35,20
1656077079372,MATH 20E,B02,083774,Ciotti; Benjamin,15,0,35,20
1656077085400,MATH 103A,A01,083777,Greenfeld; Be'Eri,3,0,36,33
1656077085400,MATH 103A,A02,083778,Greenfeld; Be'Eri,3,0,36,33
1656077085400,MATH 103A,A03,093561,Staff,4,1,36,32
1656077085400,MATH 103A,B01,083779,Greenfeld; Be'Eri,8,1,36,28
1656077085400,MATH 103A,B02,083780,Greenfeld; Be'Eri,1,0,36,35
1656077085400,MATH 103A,B03,093562,Staff,1,0,36,35
1656077091425,MATH 105,A01,085443,Carter; Anne Toulson,4,1,35,31
1656077091425,MATH 105,A02,093477,Staff,12,0,35,23
1656077097456,MATH 109,A01,083213,Ganzberger; Geoffrey Michael,1,1,34,33
1656077097456,MATH 109,A02,083214,Ganzberger; Geoffrey Michael,0,0,34,34
1656077097456,MATH 109,A03,093478,Staff,3,0,34,31
1656077097456,MATH 109,B01,083215,Ganzberger; Geoffrey Michael,4,0,32,28
1656077097456,MATH 109,B02,083216,Ganzberger; Geoffrey Michael,1,0,32,31
1656077097456,MATH 109,B03,093479,Staff,4,0,32,28
1656077103493,MATH 142A,A01,083219,Chow; Bennett,2,0,32,30
1656077103493,MATH 142A,A02,083220,Chow; Bennett,8,0,32,24
1656077103493,MATH 142A,A03,093480,Staff,5,0,32,27
1656077103493,MATH 142A,B03,093481,Staff,5,0,32,27
1656077103493,MATH 142A,B04,093558,Staff,7,0,32,25
1656077103493,MATH 142A,B05,093559,Staff,0,0,32,32
1656077109527,MATH 193A,A01,083224,Rotar; Vladimir,1,2,34,33
1656077109527,MATH 193A,A02,083225,Rotar; Vladimir,3,0,34,31
1656077109527,MATH 193A,A03,083781,Rotar; Vladimir,3,0,34,31
1656077109527,MATH 193A,A04,083782,Rotar; Vladimir,7,0,34,27
1656077109527,MATH 193A,A05,093482,Rotar; Vladimir,1,0,34,33
1656077115554,MATH 197,001,091859,McAuley; Julian John,9999,0,9999,0
1656077115554,MATH 197,002,095566,Kedlaya; Kiran S.,9997,0,9999,2
1656077115554,MATH 197,003,095567,Xiao; Ming,9999,0,9999,0
1656077115554,MATH 197,004,095571,Perols; Johan Lars,9998,0,9999,1
1656077122642,COGS 9,A01,083615,Shannon; Kyle Michael,4,1,75,71
1656077128669,COGS 11,A01,083617,Boyle; Mary E. T.,16,1,48,32
1656077134696,COGS 13,A01,083071,Bastos; Amalia Pinkusfeld,8,2,71,63
1656077140722,COGS 14A,A01,092681,Semenuks; Arturs,8,23,100,92
1656077146749,COGS 14B,A01,083073,Cheng; Tzu-Han,9,0,63,54
1656077152774,COGS 17,A01,092677,Semenuks; Arturs,13,6,81,68
1656077158807,COGS 100,A01,083619,Allen; Michael Gordon,8,1,70,62
1656077164839,COGS 101A,A01,083621,Davis; Joshua Daniel,7,3,68,61
1656077170866,COGS 101B,A01,091572,Allen; Michael Gordon,7,0,65,58
1656077176890,COGS 101C,A01,083625,Delgado; Tania,11,0,35,24
1656077182915,COGS 107A,A01,083627,Boyle; Mary E. T.,5,2,60,55
1656077188947,COGS 118A,A01,083075,Gupta; Anjum,24,16,76,52
1656077194975,CSE 3,A50,083646,Miranda; Gregory Joseph,20,0,50,30
1656077201006,CSE 8A,A50,083650,Miranda; Gregory Joseph,13,11,56,43
1656077207032,CSE 11,A01,083080,Cao; Yingjun,1,60,40,39
1656077213072,CSE 12,A01,083652,Krause-Levy; Sophia Louisa,14,7,120,106
1656077219102,CSE 15L,A01,083654,Morris; Justin Loren,5,1,50,45
1656077219102,CSE 15L,A02,083655,Morris; Justin Loren,7,0,50,43
1656077225134,CSE 20,A01,083657,Tran; Khoa Dang,31,0,80,49
1656077231174,CSE 21,A01,095574,Bach; Quang Tran,28,0,48,20
1656077237198,CSE 30,A01,083084,Eldon; John,3,10,80,77
1656077237198,CSE 30,B01,095061,Bhaskar; Nishant,4,5,50,46
1656077243232,CSE 100,A01,083659,Cao; Yingjun,2,23,70,68
1656077249257,CSE 134B,A01,083661,Powell; Thomas Allan,11,6,100,89
1656077255294,CSE 140,A01,083663,Gungor; Onat,9,0,85,76
1656077261319,CSE 140L,A01,083088,Eldon; John,8,0,100,92
1656077267345,CSE 175,A01,083665,Kumar; Rakesh,2,0,25,23
1656077273378,CSE 190,A00,092507,Dubnov; Shlomo,3,0,20,17
1656077279405,ECE 45,A01,083139,Congero; Spencer William,5,2,75,70
1656077285441,ECE 65,A50,083695,Saad; Andrew S,8,0,30,22
1656077285441,ECE 65,A51,095125,Staff,23,0,26,3
1656077291471,ECE 109,A01,091882,Touri; Behrouz,5,4,70,65
1656077297503,ECE 180,A00,083140,Abi Samra; Nicholas Camill,1,0,30,29
1656077297503,ECE 180,B00,083141,Abi Samra; Nicholas Camill,2,8,28,26
1656077303532,MATH 10A,A01,083735,Patchell; Gregory David,1,0,30,29
1656077303532,MATH 10A,A02,083736,Patchell; Gregory David,23,0,30,7
1656077303532,MATH 10A,A03,083737,Patchell; Gregory David,16,0,30,14
1656077309560,MATH 10B,A01,083207,Lim; Seonhee,3,1,34,31
1656077309560,MATH 10B,A02,083208,Lim; Seonhee,10,1,35,25
1656077309560,MATH 10B,A03,093472,Staff,4,1,34,30
1656077309560,MATH 10B,B01,083739,Sinha; Shubham,12,0,30,18
1656077315587,MATH 18,A01,083743,Cinel; Cameron Alexander,7,0,30,23
1656077315587,MATH 18,A02,083744,Cinel; Cameron Alexander,12,0,30,18
1656077315587,MATH 18,A03,083745,Cinel; Cameron Alexander,3,0,30,27
1656077315587,MATH 18,B01,083748,Ma; Zilu,1,0,36,35
1656077315587,MATH 18,B02,083749,Ma; Zilu,2,0,36,34
1656077315587,MATH 18,B03,083750,Ma; Zilu,0,0,36,36
1656077315587,MATH 18,B04,083751,Ma; Zilu,1,0,36,35
1656077315587,MATH 18,B05,093473,Staff,3,0,36,33
1656077315587,MATH 18,B06,093474,Staff,4,0,36,32
1656077321620,MATH 20A,A01,083754,Zheng; Zequn,11,0,40,29
1656077327647,MATH 20B,A01,083756,Briones; Jor-el Thomas Caparas,0,0,36,36
1656077327647,MATH 20B,A02,083757,Briones; Jor-el Thomas Caparas,2,0,36,34
1656077327647,MATH 20B,A03,093475,Staff,3,0,36,33
1656077333674,MATH 20C,A01,083760,Briones; Jor-el Thomas Caparas,2,2,35,33
1656077333674,MATH 20C,A02,083761,Briones; Jor-el Thomas Caparas,9,1,35,26
1656077333674,MATH 20C,A03,093476,Staff,1,1,35,34
1656077333674,MATH 20C,B01,083762,Bach; Quang Tran,5,0,30,25
1656077339699,MATH 20D,A01,083765,Tran; Brian Kha,3,0,30,27
1656077339699,MATH 20D,A02,083766,Tran; Brian Kha,0,1,30,30
1656077339699,MATH 20D,A03,083767,Tran; Brian Kha,2,0,30,28
1656077345726,MATH 20E,A01,083771,Ganguly; Soumya,4,1,32,28
1656077345726,MATH 20E,A02,083772,Ganguly; Soumya,2,1,32,30
1656077345726,MATH 20E,B01,083773,Ciotti; Benjamin,15,0,35,20
1656077345726,MATH 20E,B02,083774,Ciotti; Benjamin,15,0,35,20
1656077351757,MATH 103A,A01,083777,Greenfeld; Be'Eri,3,0,36,33
1656077351757,MATH 103A,A02,083778,Greenfeld; Be'Eri,3,0,36,33
1656077351757,MATH 103A,A03,093561,Staff,4,1,36,32
1656077351757,MATH 103A,B01,083779,Greenfeld; Be'Eri,8,1,36,28
1656077351757,MATH 103A,B02,083780,Greenfeld; Be'Eri,1,0,36,35
1656077351757,MATH 103A,B03,093562,Staff,1,0,36,35
1656077357782,MATH 105,A01,085443,Carter; Anne Toulson,4,1,35,31
1656077357782,MATH 105,A02,093477,Staff,12,0,35,23
1656077363816,MATH 109,A01,083213,Ganzberger; Geoffrey Michael,1,1,34,33
1656077363816,MATH 109,A02,083214,Ganzberger; Geoffrey Michael,0,0,34,34
1656077363816,MATH 109,A03,093478,Staff,3,0,34,31
1656077363816,MATH 109,B01,083215,Ganzberger; Geoffrey Michael,4,0,32,28
1656077363816,MATH 109,B02,083216,Ganzberger; Geoffrey Michael,1,0,32,31
1656077363816,MATH 109,B03,093479,Staff,4,0,32,28
1656077369855,MATH 142A,A01,083219,Chow; Bennett,2,0,32,30
1656077369855,MATH 142A,A02,083220,Chow; Bennett,8,0,32,24
1656077369855,MATH 142A,A03,093480,Staff,5,0,32,27
1656077369855,MATH 142A,B03,093481,Staff,5,0,32,27
1656077369855,MATH 142A,B04,093558,Staff,7,0,32,25
1656077369855,MATH 142A,B05,093559,Staff,0,0,32,32
1656077375890,MATH 193A,A01,083224,Rotar; Vladimir,1,2,34,33
1656077375890,MATH 193A,A02,083225,Rotar; Vladimir,3,0,34,31
1656077375890,MATH 193A,A03,083781,Rotar; Vladimir,3,0,34,31
1656077375890,MATH 193A,A04,083782,Rotar; Vladimir,7,0,34,27
1656077375890,MATH 193A,A05,093482,Rotar; Vladimir,1,0,34,33
1656077381915,MATH 197,001,091859,McAuley; Julian John,9999,0,9999,0
1656077381915,MATH 197,002,095566,Kedlaya; Kiran S.,9997,0,9999,2
1656077381915,MATH 197,003,095567,Xiao; Ming,9999,0,9999,0
1656077381915,MATH 197,004,095571,Perols; Johan Lars,9998,0,9999,1
1656077388992,COGS 9,A01,083615,Shannon; Kyle Michael,4,1,75,71
1656077395025,COGS 11,A01,083617,Boyle; Mary E. T.,16,1,48,32
1656077401057,COGS 13,A01,083071,Bastos; Amalia Pinkusfeld,8,2,71,63
1656077407083,COGS 14A,A01,092681,Semenuks; Arturs,8,23,100,92
1656077413109,COGS 14B,A01,083073,Cheng; Tzu-Han,9,0,63,54
1656077419133,COGS 17,A01,092677,Semenuks; Arturs,13,6,81,68
1656077425165,COGS 100,A01,083619,Allen; Michael Gordon,8,1,70,62
1656077431199,COGS 101A,A01,083621,Davis; Joshua Daniel,7,3,68,61
1656077437226,COGS 101B,A01,091572,Allen; Michael Gordon,7,0,65,58
1656077443251,COGS 101C,A01,083625,Delgado; Tania,11,0,35,24
1656077449280,COGS 107A,A01,083627,Boyle; Mary E. T.,5,2,60,55
1656077455311,COGS 118A,A01,083075,Gupta; Anjum,24,16,76,52
1656077461348,CSE 3,A50,083646,Miranda; Gregory Joseph,20,0,50,30
1656077467377,CSE 8A,A50,083650,Miranda; Gregory Joseph,13,11,56,43
1656077473406,CSE 11,A01,083080,Cao; Yingjun,1,60,40,39
1656077479433,CSE 12,A01,083652,Krause-Levy; Sophia Louisa,14,7,120,106
1656077485457,CSE 15L,A01,083654,Morris; Justin Loren,5,1,50,45
1656077485457,CSE 15L,A02,083655,Morris; Justin Loren,7,0,50,43
1656077491483,CSE 20,A01,083657,Tran; Khoa Dang,31,0,80,49
1656077497510,CSE 21,A01,095574,Bach; Quang Tran,28,0,48,20
1656077503542,CSE 30,A01,083084,Eldon; John,3,10,80,77
1656077503542,CSE 30,B01,095061,Bhaskar; Nishant,4,5,50,46
1656077509572,CSE 100,A01,083659,Cao; Yingjun,2,23,70,68
1656077515600,CSE 134B,A01,083661,Powell; Thomas Allan,11,6,100,89
1656077521629,CSE 140,A01,083663,Gungor; Onat,9,0,85,76
1656077527652,CSE 140L,A01,083088,Eldon; John,8,0,100,92
1656077533679,CSE 175,A01,083665,Kumar; Rakesh,2,0,25,23
1656077539714,CSE 190,A00,092507,Dubnov; Shlomo,3,0,20,17
1656077545746,ECE 45,A01,083139,Congero; Spencer William,5,2,75,70
1656077551775,ECE 65,A50,083695,Saad; Andrew S,8,0,30,22
1656077551775,ECE 65,A51,095125,Staff,23,0,26,3
1656077557801,ECE 109,A01,091882,Touri; Behrouz,5,4,70,65
1656077563826,ECE 180,A00,083140,Abi Samra; Nicholas Camill,1,0,30,29
1656077563826,ECE 180,B00,083141,Abi Samra; Nicholas Camill,2,8,28,26
1656077569859,MATH 10A,A01,083735,Patchell; Gregory David,1,0,30,29
1656077569859,MATH 10A,A02,083736,Patchell; Gregory David,23,0,30,7
1656077569859,MATH 10A,A03,083737,Patchell; Gregory David,16,0,30,14
1656077575893,MATH 10B,A01,083207,Lim; Seonhee,3,1,34,31
1656077575893,MATH 10B,A02,083208,Lim; Seonhee,10,1,35,25
1656077575893,MATH 10B,A03,093472,Staff,4,1,34,30
1656077575893,MATH 10B,B01,083739,Sinha; Shubham,12,0,30,18
1656077581920,MATH 18,A01,083743,Cinel; Cameron Alexander,7,0,30,23
1656077581920,MATH 18,A02,083744,Cinel; Cameron Alexander,12,0,30,18
1656077581920,MATH 18,A03,083745,Cinel; Cameron Alexander,3,0,30,27
1656077581920,MATH 18,B01,083748,Ma; Zilu,1,0,36,35
1656077581920,MATH 18,B02,083749,Ma; Zilu,2,0,36,34
1656077581920,MATH 18,B03,083750,Ma; Zilu,0,0,36,36
1656077581920,MATH 18,B04,083751,Ma; Zilu,1,0,36,35
1656077581920,MATH 18,B05,093473,Staff,3,0,36,33
1656077581920,MATH 18,B06,093474,Staff,4,0,36,32
1656077587946,MATH 20A,A01,083754,Zheng; Zequn,11,0,40,29
1656077593979,MATH 20B,A01,083756,Briones; Jor-el Thomas Caparas,0,0,36,36
1656077593979,MATH 20B,A02,083757,Briones; Jor-el Thomas Caparas,2,0,36,34
1656077593979,MATH 20B,A03,093475,Staff,3,0,36,33
1656077600013,MATH 20C,A01,083760,Briones; Jor-el Thomas Caparas,2,2,35,33
1656077600013,MATH 20C,A02,083761,Briones; Jor-el Thomas Caparas,9,1,35,26
1656077600013,MATH 20C,A03,093476,Staff,1,1,35,34
1656077600013,MATH 20C,B01,083762,Bach; Quang Tran,5,0,30,25
1656077606046,MATH 20D,A01,083765,Tran; Brian Kha,3,0,30,27
1656077606046,MATH 20D,A02,083766,Tran; Brian Kha,0,1,30,30
1656077606046,MATH 20D,A03,083767,Tran; Brian Kha,2,0,30,28
1656077612076,MATH 20E,A01,083771,Ganguly; Soumya,4,1,32,28
1656077612076,MATH 20E,A02,083772,Ganguly; Soumya,2,1,32,30
1656077612076,MATH 20E,B01,083773,Ciotti; Benjamin,15,0,35,20
1656077612076,MATH 20E,B02,083774,Ciotti; Benjamin,15,0,35,20
1656077618180,MATH 103A,A01,083777,Greenfeld; Be'Eri,3,0,36,33
1656077618180,MATH 103A,A02,083778,Greenfeld; Be'Eri,3,0,36,33
1656077618180,MATH 103A,A03,093561,Staff,4,1,36,32
1656077618180,MATH 103A,B01,083779,Greenfeld; Be'Eri,8,1,36,28
1656077618180,MATH 103A,B02,083780,Greenfeld; Be'Eri,0,0,36,36
1656077618180,MATH 103A,B03,093562,Staff,1,0,36,35
1656077624207,MATH 105,A01,085443,Carter; Anne Toulson,4,1,35,31
1656077624207,MATH 105,A02,093477,Staff,12,0,35,23
1656077630242,MATH 109,A01,083213,Ganzberger; Geoffrey Michael,1,1,34,33
1656077630242,MATH 109,A02,083214,Ganzberger; Geoffrey Michael,0,0,34,34
1656077630242,MATH 109,A03,093478,Staff,3,0,34,31
1656077630242,MATH 109,B01,083215,Ganzberger; Geoffrey Michael,4,0,32,28
1656077630242,MATH 109,B02,083216,Ganzberger; Geoffrey Michael,1,0,32,31
1656077630242,MATH 109,B03,093479,Staff,4,0,32,28
1656077636277,MATH 142A,A01,083219,Chow; Bennett,2,0,32,30
1656077636277,MATH 142A,A02,083220,Chow; Bennett,8,0,32,24
1656077636277,MATH 142A,A03,093480,Staff,5,0,32,27
1656077636277,MATH 142A,B03,093481,Staff,5,0,32,27
1656077636277,MATH 142A,B04,093558,Staff,7,0,32,25
1656077636277,MATH 142A,B05,093559,Staff,0,0,32,32
1656077642303,MATH 193A,A01,083224,Rotar; Vladimir,1,2,34,33
1656077642303,MATH 193A,A02,083225,Rotar; Vladimir,3,0,34,31
1656077642303,MATH 193A,A03,083781,Rotar; Vladimir,3,0,34,31
1656077642303,MATH 193A,A04,083782,Rotar; Vladimir,7,0,34,27
1656077642303,MATH 193A,A05,093482,Rotar; Vladimir,1,0,34,33
1656077648334,MATH 197,001,091859,McAuley; Julian John,9999,0,9999,0
1656077648334,MATH 197,002,095566,Kedlaya; Kiran S.,9997,0,9999,2
1656077648334,MATH 197,003,095567,Xiao; Ming,9999,0,9999,0
1656077648334,MATH 197,004,095571,Perols; Johan Lars,9998,0,9999,1
1656077655401,COGS 9,A01,083615,Shannon; Kyle Michael,4,1,75,71
1656077661427,COGS 11,A01,083617,Boyle; Mary E. T.,16,1,48,32
1656077667454,COGS 13,A01,083071,Bastos; Amalia Pinkusfeld,8,2,71,63
1656077673482,COGS 14A,A01,092681,Semenuks; Arturs,8,23,100,92
1656077679514,COGS 14B,A01,083073,Cheng; Tzu-Han,9,0,63,54
1656077685543,COGS 17,A01,092677,Semenuks; Arturs,13,6,81,68
1656077691569,COGS 100,A01,083619,Allen; Michael Gordon,8,1,70,62
1656077697598,COGS 101A,A01,083621,Davis; Joshua Daniel,7,3,68,61
1656077703625,COGS 101B,A01,091572,Allen; Michael Gordon,7,0,65,58
1656077709658,COGS 101C,A01,083625,Delgado; Tania,11,0,35,24
1656077715689,COGS 107A,A01,083627,Boyle; Mary E. T.,5,2,60,55
1656077721719,COGS 118A,A01,083075,Gupta; Anjum,24,16,76,52
1656077727751,CSE 3,A50,083646,Miranda; Gregory Joseph,20,0,50,30
1656077733776,CSE 8A,A50,083650,Miranda; Gregory Joseph,13,11,56,43
1656077739805,CSE 11,A01,083080,Cao; Yingjun,1,60,40,39
1656077745831,CSE 12,A01,083652,Krause-Levy; Sophia Louisa,14,7,120,106
1656077751860,CSE 15L,A01,083654,Morris; Justin Loren,5,1,50,45
1656077751860,CSE 15L,A02,083655,Morris; Justin Loren,7,0,50,43
1656077757908,CSE 20,A01,083657,Tran; Khoa Dang,31,0,80,49
1656077763933,CSE 21,A01,095574,Bach; Quang Tran,28,0,48,20
1656077769965,CSE 30,A01,083084,Eldon; John,3,10,80,77
1656077769965,CSE 30,B01,095061,Bhaskar; Nishant,4,5,50,46
1656077775992,CSE 100,A01,083659,Cao; Yingjun,2,23,70,68
1656077782023,CSE 134B,A01,083661,Powell; Thomas Allan,11,6,100,89
1656077788052,CSE 140,A01,083663,Gungor; Onat,9,0,85,76
1656077794078,CSE 140L,A01,083088,Eldon; John,8,0,100,92
1656077800109,CSE 175,A01,083665,Kumar; Rakesh,2,0,25,23
1656077806138,CSE 190,A00,092507,Dubnov; Shlomo,3,0,20,17
1656077812165,ECE 45,A01,083139,Congero; Spencer William,5,2,75,70
1656077818201,ECE 65,A50,083695,Saad; Andrew S,8,0,30,22
1656077818201,ECE 65,A51,095125,Staff,23,0,26,3
1656077824236,ECE 109,A01,091882,Touri; Behrouz,5,4,70,65
1656077830265,ECE 180,A00,083140,Abi Samra; Nicholas Camill,1,0,30,29
1656077830265,ECE 180,B00,083141,Abi Samra; Nicholas Camill,2,8,28,26
1656077836298,MATH 10A,A01,083735,Patchell; Gregory David,1,0,30,29
1656077836298,MATH 10A,A02,083736,Patchell; Gregory David,23,0,30,7
1656077836298,MATH 10A,A03,083737,Patchell; Gregory David,16,0,30,14
1656077842337,MATH 10B,A01,083207,Lim; Seonhee,3,1,34,31
1656077842337,MATH 10B,A02,083208,Lim; Seonhee,10,1,35,25
1656077842337,MATH 10B,A03,093472,Staff,4,1,34,30
1656077842337,MATH 10B,B01,083739,Sinha; Shubham,12,0,30,18
1656077848364,MATH 18,A01,083743,Cinel; Cameron Alexander,7,0,30,23
1656077848364,MATH 18,A02,083744,Cinel; Cameron Alexander,12,0,30,18
1656077848364,MATH 18,A03,083745,Cinel; Cameron Alexander,3,0,30,27
1656077848364,MATH 18,B01,083748,Ma; Zilu,1,0,36,35
1656077848364,MATH 18,B02,083749,Ma; Zilu,2,0,36,34
1656077848364,MATH 18,B03,083750,Ma; Zilu,0,0,36,36
1656077848364,MATH 18,B04,083751,Ma; Zilu,1,0,36,35
1656077848364,MATH 18,B05,093473,Staff,3,0,36,33
1656077848364,MATH 18,B06,093474,Staff,4,0,36,32
1656077854389,MATH 20A,A01,083754,Zheng; Zequn,11,0,40,29
1656077860415,MATH 20B,A01,083756,Briones; Jor-el Thomas Caparas,0,0,36,36
1656077860415,MATH 20B,A02,083757,Briones; Jor-el Thomas Caparas,2,0,36,34
1656077860415,MATH 20B,A03,093475,Staff,3,0,36,33
1656077866440,MATH 20C,A01,083760,Briones; Jor-el Thomas Caparas,2,2,35,33
1656077866440,MATH 20C,A02,083761,Briones; Jor-el Thomas Caparas,9,1,35,26
1656077866440,MATH 20C,A03,093476,Staff,1,1,35,34
1656077866440,MATH 20C,B01,083762,Bach; Quang Tran,5,0,30,25
1656077872464,MATH 20D,A01,083765,Tran; Brian Kha,3,0,30,27
1656077872464,MATH 20D,A02,083766,Tran; Brian Kha,0,1,30,30
1656077872464,MATH 20D,A03,083767,Tran; Brian Kha,2,0,30,28
1656077878493,MATH 20E,A01,083771,Ganguly; Soumya,4,1,32,28
1656077878493,MATH 20E,A02,083772,Ganguly; Soumya,2,1,32,30
1656077878493,MATH 20E,B01,083773,Ciotti; Benjamin,15,0,35,20
1656077878493,MATH 20E,B02,083774,Ciotti; Benjamin,15,0,35,20
1656077884526,MATH 103A,A01,083777,Greenfeld; Be'Eri,3,0,36,33
1656077884526,MATH 103A,A02,083778,Greenfeld; Be'Eri,3,0,36,33
1656077884526,MATH 103A,A03,093561,Staff,4,1,36,32
1656077884526,MATH 103A,B01,083779,Greenfeld; Be'Eri,8,1,36,28
1656077884526,MATH 103A,B02,083780,Greenfeld; Be'Eri,0,0,36,36
1656077884526,MATH 103A,B03,093562,Staff,1,0,36,35
1656077890557,MATH 105,A01,085443,Carter; Anne Toulson,4,1,35,31
1656077890557,MATH 105,A02,093477,Staff,11,0,35,24
1656077896590,MATH 109,A01,083213,Ganzberger; Geoffrey Michael,1,1,34,33
1656077896590,MATH 109,A02,083214,Ganzberger; Geoffrey Michael,0,0,34,34
1656077896590,MATH 109,A03,093478,Staff,3,0,34,31
1656077896590,MATH 109,B01,083215,Ganzberger; Geoffrey Michael,4,0,32,28
1656077896590,MATH 109,B02,083216,Ganzberger; Geoffrey Michael,1,0,32,31
1656077896590,MATH 109,B03,093479,Staff,4,0,32,28
1656077902634,MATH 142A,A01,083219,Chow; Bennett,2,0,32,30
1656077902634,MATH 142A,A02,083220,Chow; Bennett,8,0,32,24
1656077902634,MATH 142A,A03,093480,Staff,5,0,32,27
1656077902634,MATH 142A,B03,093481,Staff,4,0,32,28
1656077902634,MATH 142A,B04,093558,Staff,7,0,32,25
1656077902634,MATH 142A,B05,093559,Staff,0,0,32,32
1656077908665,MATH 193A,A01,083224,Rotar; Vladimir,1,2,34,33
1656077908665,MATH 193A,A02,083225,Rotar; Vladimir,3,0,34,31
1656077908665,MATH 193A,A03,083781,Rotar; Vladimir,3,0,34,31
1656077908665,MATH 193A,A04,083782,Rotar; Vladimir,7,0,34,27
1656077908665,MATH 193A,A05,093482,Rotar; Vladimir,1,0,34,33
1656077914697,MATH 197,001,091859,McAuley; Julian John,9999,0,9999,0
1656077914697,MATH 197,002,095566,Kedlaya; Kiran S.,9997,0,9999,2
1656077914697,MATH 197,003,095567,Xiao; Ming,9999,0,9999,0
1656077914697,MATH 197,004,095571,Perols; Johan Lars,9998,0,9999,1
1656077921785,COGS 9,A01,083615,Shannon; Kyle Michael,4,1,75,71
1656077927811,COGS 11,A01,083617,Boyle; Mary E. T.,16,1,48,32
1656077933837,COGS 13,A01,083071,Bastos; Amalia Pinkusfeld,8,2,71,63
1656077939866,COGS 14A,A01,092681,Semenuks; Arturs,8,23,100,92
1656077945891,COGS 14B,A01,083073,Cheng; Tzu-Han,9,0,63,54
1656077951921,COGS 17,A01,092677,Semenuks; Arturs,13,6,81,68
1656077957945,COGS 100,A01,083619,Allen; Michael Gordon,8,1,70,62
1656077963977,COGS 101A,A01,083621,Davis; Joshua Daniel,7,3,68,61
1656077970003,COGS 101B,A01,091572,Allen; Michael Gordon,7,0,65,58
1656077976029,COGS 101C,A01,083625,Delgado; Tania,11,0,35,24
1656077982055,COGS 107A,A01,083627,Boyle; Mary E. T.,5,2,60,55
1656077988080,COGS 118A,A01,083075,Gupta; Anjum,24,16,76,52
1656077994116,CSE 3,A50,083646,Miranda; Gregory Joseph,20,0,50,30
1656078000141,CSE 8A,A50,083650,Miranda; Gregory Joseph,13,11,56,43
1656078006170,CSE 11,A01,083080,Cao; Yingjun,1,60,40,39
1656078012202,CSE 12,A01,083652,Krause-Levy; Sophia Louisa,14,7,120,106
1656078018231,CSE 15L,A01,083654,Morris; Justin Loren,5,1,50,45
1656078018231,CSE 15L,A02,083655,Morris; Justin Loren,7,0,50,43
1656078024258,CSE 20,A01,083657,Tran; Khoa Dang,31,0,80,49
1656078030286,CSE 21,A01,095574,Bach; Quang Tran,28,0,48,20
1656078036312,CSE 30,A01,083084,Eldon; John,3,10,80,77
1656078036312,CSE 30,B01,095061,Bhaskar; Nishant,4,5,50,46
1656078042337,CSE 100,A01,083659,Cao; Yingjun,2,23,70,68
1656078048360,CSE 134B,A01,083661,Powell; Thomas Allan,11,6,100,89
1656078054390,CSE 140,A01,083663,Gungor; Onat,9,0,85,76
1656078060420,CSE 140L,A01,083088,Eldon; John,8,0,100,92
1656078066445,CSE 175,A01,083665,Kumar; Rakesh,2,0,25,23
1656078072477,CSE 190,A00,092507,Dubnov; Shlomo,3,0,20,17
1656078078502,ECE 45,A01,083139,Congero; Spencer William,5,2,75,70
1656078084527,ECE 65,A50,083695,Saad; Andrew S,8,0,30,22
1656078084527,ECE 65,A51,095125,Staff,23,0,26,3
1656078090557,ECE 109,A01,091882,Touri; Behrouz,5,4,70,65
1656078096584,ECE 180,A00,083140,Abi Samra; Nicholas Camill,1,0,30,29
1656078096584,ECE 180,B00,083141,Abi Samra; Nicholas Camill,2,8,28,26
1656078102618,MATH 10A,A01,083735,Patchell; Gregory David,1,0,30,29
1656078102618,MATH 10A,A02,083736,Patchell; Gregory David,23,0,30,7
1656078102618,MATH 10A,A03,083737,Patchell; Gregory David,16,0,30,14
1656078108645,MATH 10B,A01,083207,Lim; Seonhee,3,1,34,31
1656078108645,MATH 10B,A02,083208,Lim; Seonhee,10,1,35,25
1656078108645,MATH 10B,A03,093472,Staff,4,1,34,30
1656078108645,MATH 10B,B01,083739,Sinha; Shubham,12,0,30,18
1656078114683,MATH 18,A01,083743,Cinel; Cameron Alexander,7,0,30,23
1656078114683,MATH 18,A02,083744,Cinel; Cameron Alexander,12,0,30,18
1656078114683,MATH 18,A03,083745,Cinel; Cameron Alexander,3,0,30,27
1656078114683,MATH 18,B01,083748,Ma; Zilu,1,0,36,35
1656078114683,MATH 18,B02,083749,Ma; Zilu,2,0,36,34
1656078114683,MATH 18,B03,083750,Ma; Zilu,0,0,36,36
1656078114683,MATH 18,B04,083751,Ma; Zilu,1,0,36,35
1656078114683,MATH 18,B05,093473,Staff,3,0,36,33
1656078114683,MATH 18,B06,093474,Staff,4,0,36,32
1656078120713,MATH 20A,A01,083754,Zheng; Zequn,11,0,40,29
1656078126745,MATH 20B,A01,083756,Briones; Jor-el Thomas Caparas,0,0,36,36
1656078126745,MATH 20B,A02,083757,Briones; Jor-el Thomas Caparas,2,0,36,34
1656078126745,MATH 20B,A03,093475,Staff,3,0,36,33
1656078132778,MATH 20C,A01,083760,Briones; Jor-el Thomas Caparas,2,2,35,33
1656078132778,MATH 20C,A02,083761,Briones; Jor-el Thomas Caparas,9,1,35,26
1656078132778,MATH 20C,A03,093476,Staff,1,1,35,34
1656078132778,MATH 20C,B01,083762,Bach; Quang Tran,5,0,30,25
1656078138804,MATH 20D,A01,083765,Tran; Brian Kha,3,0,30,27
1656078138804,MATH 20D,A02,083766,Tran; Brian Kha,0,1,30,30
1656078138804,MATH 20D,A03,083767,Tran; Brian Kha,2,0,30,28
1656078144836,MATH 20E,A01,083771,Ganguly; Soumya,4,1,32,28
1656078144836,MATH 20E,A02,083772,Ganguly; Soumya,2,1,32,30
1656078144836,MATH 20E,B01,083773,Ciotti; Benjamin,15,0,35,20
1656078144836,MATH 20E,B02,083774,Ciotti; Benjamin,15,0,35,20
1656078150863,MATH 103A,A01,083777,Greenfeld; Be'Eri,3,0,36,33
1656078150863,MATH 103A,A02,083778,Greenfeld; Be'Eri,3,0,36,33
1656078150863,MATH 103A,A03,093561,Staff,4,1,36,32
1656078150863,MATH 103A,B01,083779,Greenfeld; Be'Eri,8,1,36,28
1656078150863,MATH 103A,B02,083780,Greenfeld; Be'Eri,0,0,36,36
1656078150863,MATH 103A,B03,093562,Staff,1,0,36,35
1656078156889,MATH 105,A01,085443,Carter; Anne Toulson,4,1,35,31
1656078156889,MATH 105,A02,093477,Staff,11,0,35,24
1656078162914,MATH 109,A01,083213,Ganzberger; Geoffrey Michael,1,1,34,33
1656078162914,MATH 109,A02,083214,Ganzberger; Geoffrey Michael,0,0,34,34
1656078162914,MATH 109,A03,093478,Staff,3,0,34,31
1656078162914,MATH 109,B01,083215,Ganzberger; Geoffrey Michael,4,0,32,28
1656078162914,MATH 109,B02,083216,Ganzberger; Geoffrey Michael,1,0,32,31
1656078162914,MATH 109,B03,093479,Staff,4,0,32,28
1656078168942,MATH 142A,A01,083219,Chow; Bennett,2,0,32,30
1656078168942,MATH 142A,A02,083220,Chow; Bennett,8,0,32,24
1656078168942,MATH 142A,A03,093480,Staff,5,0,32,27
1656078168942,MATH 142A,B03,093481,Staff,4,0,32,28
1656078168942,MATH 142A,B04,093558,Staff,7,0,32,25
1656078168942,MATH 142A,B05,093559,Staff,0,0,32,32
1656078174968,MATH 193A,A01,083224,Rotar; Vladimir,1,2,34,33
1656078174968,MATH 193A,A02,083225,Rotar; Vladimir,3,0,34,31
1656078174968,MATH 193A,A03,083781,Rotar; Vladimir,3,0,34,31
1656078174968,MATH 193A,A04,083782,Rotar; Vladimir,7,0,34,27
1656078174968,MATH 193A,A05,093482,Rotar; Vladimir,1,0,34,33
1656078180997,MATH 197,001,091859,McAuley; Julian John,9999,0,9999,0
1656078180997,MATH 197,002,095566,Kedlaya; Kiran S.,9997,0,9999,2
1656078180997,MATH 197,003,095567,Xiao; Ming,9999,0,9999,0
1656078180997,MATH 197,004,095571,Perols; Johan Lars,9998,0,9999,1
1656078188064,COGS 9,A01,083615,Shannon; Kyle Michael,4,1,75,71
1656078194089,COGS 11,A01,083617,Boyle; Mary E. T.,16,1,48,32
1656078200121,COGS 13,A01,083071,Bastos; Amalia Pinkusfeld,8,2,71,63
1656078206154,COGS 14A,A01,092681,Semenuks; Arturs,8,23,100,92
1656078212266,COGS 14B,A01,083073,Cheng; Tzu-Han,9,0,63,54
1656078218295,COGS 17,A01,092677,Semenuks; Arturs,13,6,81,68
1656078224320,COGS 100,A01,083619,Allen; Michael Gordon,8,1,70,62
1656078230351,COGS 101A,A01,083621,Davis; Joshua Daniel,7,3,68,61
1656078236379,COGS 101B,A01,091572,Allen; Michael Gordon,7,0,65,58
1656078242404,COGS 101C,A01,083625,Delgado; Tania,11,0,35,24
1656078248432,COGS 107A,A01,083627,Boyle; Mary E. T.,5,2,60,55
1656078254461,COGS 118A,A01,083075,Gupta; Anjum,24,16,76,52
1656078260488,CSE 3,A50,083646,Miranda; Gregory Joseph,20,0,50,30
1656078266514,CSE 8A,A50,083650,Miranda; Gregory Joseph,13,11,56,43
1656078272543,CSE 11,A01,083080,Cao; Yingjun,1,60,40,39
1656078278569,CSE 12,A01,083652,Krause-Levy; Sophia Louisa,14,7,120,106
1656078284593,CSE 15L,A01,083654,Morris; Justin Loren,5,1,50,45
1656078284593,CSE 15L,A02,083655,Morris; Justin Loren,7,0,50,43
1656078290618,CSE 20,A01,083657,Tran; Khoa Dang,31,0,80,49
1656078296642,CSE 21,A01,095574,Bach; Quang Tran,28,0,48,20
1656078302665,CSE 30,A01,083084,Eldon; John,3,10,80,77
1656078302665,CSE 30,B01,095061,Bhaskar; Nishant,4,5,50,46
1656078308693,CSE 100,A01,083659,Cao; Yingjun,2,23,70,68
1656078314718,CSE 134B,A01,083661,Powell; Thomas Allan,11,6,100,89
1656078320747,CSE 140,A01,083663,Gungor; Onat,9,0,85,76
1656078326773,CSE 140L,A01,083088,Eldon; John,8,0,100,92
1656078332801,CSE 175,A01,083665,Kumar; Rakesh,2,0,25,23
1656078338826,CSE 190,A00,092507,Dubnov; Shlomo,3,0,20,17
1656078344852,ECE 45,A01,083139,Congero; Spencer William,5,2,75,70
1656078350877,ECE 65,A50,083695,Saad; Andrew S,8,0,30,22
1656078350877,ECE 65,A51,095125,Staff,23,0,26,3
1656078356908,ECE 109,A01,091882,Touri; Behrouz,5,4,70,65
1656078362932,ECE 180,A00,083140,Abi Samra; Nicholas Camill,1,0,30,29
1656078362932,ECE 180,B00,083141,Abi Samra; Nicholas Camill,2,8,28,26
1656078368966,MATH 10A,A01,083735,Patchell; Gregory David,1,0,30,29
1656078368966,MATH 10A,A02,083736,Patchell; Gregory David,23,0,30,7
1656078368966,MATH 10A,A03,083737,Patchell; Gregory David,16,0,30,14
1656078374993,MATH 10B,A01,083207,Lim; Seonhee,3,1,34,31
1656078374993,MATH 10B,A02,083208,Lim; Seonhee,10,1,35,25
1656078374993,MATH 10B,A03,093472,Staff,4,1,34,30
1656078374993,MATH 10B,B01,083739,Sinha; Shubham,12,0,30,18
1656078381020,MATH 18,A01,083743,Cinel; Cameron Alexander,7,0,30,23
1656078381020,MATH 18,A02,083744,Cinel; Cameron Alexander,12,0,30,18
1656078381020,MATH 18,A03,083745,Cinel; Cameron Alexander,3,0,30,27
1656078381020,MATH 18,B01,083748,Ma; Zilu,1,0,36,35
1656078381020,MATH 18,B02,083749,Ma; Zilu,2,0,36,34
1656078381020,MATH 18,B03,083750,Ma; Zilu,0,0,36,36
1656078381020,MATH 18,B04,083751,Ma; Zilu,1,0,36,35
1656078381020,MATH 18,B05,093473,Staff,3,0,36,33
1656078381020,MATH 18,B06,093474,Staff,4,0,36,32
1656078387046,MATH 20A,A01,083754,Zheng; Zequn,11,0,40,29
1656078393071,MATH 20B,A01,083756,Briones; Jor-el Thomas Caparas,0,0,36,36
1656078393071,MATH 20B,A02,083757,Briones; Jor-el Thomas Caparas,2,0,36,34
1656078393071,MATH 20B,A03,093475,Staff,3,0,36,33
1656078399096,MATH 20C,A01,083760,Briones; Jor-el Thomas Caparas,2,2,35,33
1656078399096,MATH 20C,A02,083761,Briones; Jor-el Thomas Caparas,9,1,35,26
1656078399096,MATH 20C,A03,093476,Staff,1,1,35,34
1656078399096,MATH 20C,B01,083762,Bach; Quang Tran,4,0,30,26
1656078405125,MATH 20D,A01,083765,Tran; Brian Kha,3,0,30,27
1656078405125,MATH 20D,A02,083766,Tran; Brian Kha,0,1,30,30
1656078405125,MATH 20D,A03,083767,Tran; Brian Kha,2,0,30,28
1656078411150,MATH 20E,A01,083771,Ganguly; Soumya,4,1,32,28
1656078411150,MATH 20E,A02,083772,Ganguly; Soumya,2,1,32,30
1656078411150,MATH 20E,B01,083773,Ciotti; Benjamin,15,0,35,20
1656078411150,MATH 20E,B02,083774,Ciotti; Benjamin,15,0,35,20
1656078417180,MATH 103A,A01,083777,Greenfeld; Be'Eri,3,0,36,33
1656078417180,MATH 103A,A02,083778,Greenfeld; Be'Eri,3,0,36,33
1656078417180,MATH 103A,A03,093561,Staff,4,1,36,32
1656078417180,MATH 103A,B01,083779,Greenfeld; Be'Eri,8,1,36,28
1656078417180,MATH 103A,B02,083780,Greenfeld; Be'Eri,0,0,36,36
1656078417180,MATH 103A,B03,093562,Staff,1,0,36,35
1656078423204,MATH 105,A01,085443,Carter; Anne Toulson,4,1,35,31
1656078423204,MATH 105,A02,093477,Staff,11,0,35,24
1656078429231,MATH 109,A01,083213,Ganzberger; Geoffrey Michael,1,1,34,33
1656078429231,MATH 109,A02,083214,Ganzberger; Geoffrey Michael,0,0,34,34
1656078429231,MATH 109,A03,093478,Staff,3,0,34,31
1656078429231,MATH 109,B01,083215,Ganzberger; Geoffrey Michael,4,0,32,28
1656078429231,MATH 109,B02,083216,Ganzberger; Geoffrey Michael,1,0,32,31
1656078429231,MATH 109,B03,093479,Staff,4,0,32,28
1656078435257,MATH 142A,A01,083219,Chow; Bennett,2,0,32,30
1656078435257,MATH 142A,A02,083220,Chow; Bennett,8,0,32,24
1656078435257,MATH 142A,A03,093480,Staff,5,0,32,27
1656078435257,MATH 142A,B03,093481,Staff,4,0,32,28
1656078435257,MATH 142A,B04,093558,Staff,7,0,32,25
1656078435257,MATH 142A,B05,093559,Staff,0,0,32,32
1656078441289,MATH 193A,A01,083224,Rotar; Vladimir,1,2,34,33
1656078441289,MATH 193A,A02,083225,Rotar; Vladimir,3,0,34,31
1656078441289,MATH 193A,A03,083781,Rotar; Vladimir,3,0,34,31
1656078441289,MATH 193A,A04,083782,Rotar; Vladimir,7,0,34,27
1656078441289,MATH 193A,A05,093482,Rotar; Vladimir,1,0,34,33
1656078447318,MATH 197,001,091859,McAuley; Julian John,9999,0,9999,0
1656078447318,MATH 197,002,095566,Kedlaya; Kiran S.,9997,0,9999,2
1656078447318,MATH 197,003,095567,Xiao; Ming,9999,0,9999,0
1656078447318,MATH 197,004,095571,Perols; Johan Lars,9998,0,9999,1
1656078454380,COGS 9,A01,083615,Shannon; Kyle Michael,4,1,75,71
1656078460405,COGS 11,A01,083617,Boyle; Mary E. T.,16,1,48,32
1656078466432,COGS 13,A01,083071,Bastos; Amalia Pinkusfeld,8,2,71,63
1656078472456,COGS 14A,A01,092681,Semenuks; Arturs,8,23,100,92
1656078478480,COGS 14B,A01,083073,Cheng; Tzu-Han,9,0,63,54
1656078484508,COGS 17,A01,092677,Semenuks; Arturs,13,6,81,68
1656078490531,COGS 100,A01,083619,Allen; Michael Gordon,8,1,70,62
1656078496560,COGS 101A,A01,083621,Davis; Joshua Daniel,7,3,68,61
1656078502582,COGS 101B,A01,091572,Allen; Michael Gordon,7,0,65,58
1656078508612,COGS 101C,A01,083625,Delgado; Tania,11,0,35,24
1656078514636,COGS 107A,A01,083627,Boyle; Mary E. T.,5,2,60,55
1656078520666,COGS 118A,A01,083075,Gupta; Anjum,24,16,76,52
1656078526694,CSE 3,A50,083646,Miranda; Gregory Joseph,20,0,50,30
1656078532724,CSE 8A,A50,083650,Miranda; Gregory Joseph,13,11,56,43
1656078538753,CSE 11,A01,083080,Cao; Yingjun,1,60,40,39
1656078544778,CSE 12,A01,083652,Krause-Levy; Sophia Louisa,14,7,120,106
1656078550804,CSE 15L,A01,083654,Morris; Justin Loren,5,1,50,45
1656078550804,CSE 15L,A02,083655,Morris; Justin Loren,7,0,50,43
1656078556829,CSE 20,A01,083657,Tran; Khoa Dang,31,0,80,49
1656078562859,CSE 21,A01,095574,Bach; Quang Tran,28,0,48,20
1656078568886,CSE 30,A01,083084,Eldon; John,3,10,80,77
1656078568886,CSE 30,B01,095061,Bhaskar; Nishant,4,5,50,46
1656078574909,CSE 100,A01,083659,Cao; Yingjun,2,23,70,68
1656078580939,CSE 134B,A01,083661,Powell; Thomas Allan,11,6,100,89
1656078586964,CSE 140,A01,083663,Gungor; Onat,9,0,85,76
1656078592991,CSE 140L,A01,083088,Eldon; John,8,0,100,92
1656078599015,CSE 175,A01,083665,Kumar; Rakesh,2,0,25,23
1656078605043,CSE 190,A00,092507,Dubnov; Shlomo,3,0,20,17
1656078611086,ECE 45,A01,083139,Congero; Spencer William,5,2,75,70
1656078617115,ECE 65,A50,083695,Saad; Andrew S,8,0,30,22
1656078617115,ECE 65,A51,095125,Staff,23,0,26,3
1656078623143,ECE 109,A01,091882,Touri; Behrouz,5,4,70,65
1656078629172,ECE 180,A00,083140,Abi Samra; Nicholas Camill,1,0,30,29
1656078629172,ECE 180,B00,083141,Abi Samra; Nicholas Camill,2,8,28,26
1656078635197,MATH 10A,A01,083735,Patchell; Gregory David,1,0,30,29
1656078635197,MATH 10A,A02,083736,Patchell; Gregory David,23,0,30,7
1656078635197,MATH 10A,A03,083737,Patchell; Gregory David,16,0,30,14
1656078641229,MATH 10B,A01,083207,Lim; Seonhee,3,1,34,31
1656078641229,MATH 10B,A02,083208,Lim; Seonhee,10,1,35,25
1656078641229,MATH 10B,A03,093472,Staff,4,1,34,30
1656078641229,MATH 10B,B01,083739,Sinha; Shubham,12,0,30,18
1656078647254,MATH 18,A01,083743,Cinel; Cameron Alexander,7,0,30,23
1656078647254,MATH 18,A02,083744,Cinel; Cameron Alexander,12,0,30,18
1656078647254,MATH 18,A03,083745,Cinel; Cameron Alexander,3,0,30,27
1656078647254,MATH 18,B01,083748,Ma; Zilu,1,0,36,35
1656078647254,MATH 18,B02,083749,Ma; Zilu,2,0,36,34
1656078647254,MATH 18,B03,083750,Ma; Zilu,0,0,36,36
1656078647254,MATH 18,B04,083751,Ma; Zilu,1,0,36,35
1656078647254,MATH 18,B05,093473,Staff,3,0,36,33
1656078647254,MATH 18,B06,093474,Staff,4,0,36,32
1656078653279,MATH 20A,A01,083754,Zheng; Zequn,11,0,40,29
1656078659304,MATH 20B,A01,083756,Briones; Jor-el Thomas Caparas,0,0,36,36
1656078659304,MATH 20B,A02,083757,Briones; Jor-el Thomas Caparas,2,0,36,34
1656078659304,MATH 20B,A03,093475,Staff,3,0,36,33
1656078665328,MATH 20C,A01,083760,Briones; Jor-el Thomas Caparas,2,2,35,33
1656078665328,MATH 20C,A02,083761,Briones; Jor-el Thomas Caparas,9,1,35,26
1656078665328,MATH 20C,A03,093476,Staff,1,1,35,34
1656078665328,MATH 20C,B01,083762,Bach; Quang Tran,4,0,30,26
1656078671358,MATH 20D,A01,083765,Tran; Brian Kha,3,0,30,27
1656078671358,MATH 20D,A02,083766,Tran; Brian Kha,0,1,30,30
1656078671358,MATH 20D,A03,083767,Tran; Brian Kha,2,0,30,28
1656078677390,MATH 20E,A01,083771,Ganguly; Soumya,4,1,32,28
1656078677390,MATH 20E,A02,083772,Ganguly; Soumya,2,1,32,30
1656078677390,MATH 20E,B01,083773,Ciotti; Benjamin,15,0,35,20
1656078677390,MATH 20E,B02,083774,Ciotti; Benjamin,15,0,35,20
1656078683422,MATH 103A,A01,083777,Greenfeld; Be'Eri,3,0,36,33
1656078683422,MATH 103A,A02,083778,Greenfeld; Be'Eri,3,0,36,33
1656078683422,MATH 103A,A03,093561,Staff,4,1,36,32
1656078683422,MATH 103A,B01,083779,Greenfeld; Be'Eri,8,1,36,28
1656078683422,MATH 103A,B02,083780,Greenfeld; Be'Eri,0,0,36,36
1656078683422,MATH 103A,B03,093562,Staff,1,0,36,35
1656078689451,MATH 105,A01,085443,Carter; Anne Toulson,4,1,35,31
1656078689451,MATH 105,A02,093477,Staff,11,0,35,24
1656078695482,MATH 109,A01,083213,Ganzberger; Geoffrey Michael,1,1,34,33
1656078695482,MATH 109,A02,083214,Ganzberger; Geoffrey Michael,0,0,34,34
1656078695482,MATH 109,A03,093478,Staff,3,0,34,31
1656078695482,MATH 109,B01,083215,Ganzberger; Geoffrey Michael,4,0,32,28
1656078695482,MATH 109,B02,083216,Ganzberger; Geoffrey Michael,1,0,32,31
1656078695482,MATH 109,B03,093479,Staff,4,0,32,28
1656078701514,MATH 142A,A01,083219,Chow; Bennett,2,0,32,30
1656078701514,MATH 142A,A02,083220,Chow; Bennett,8,0,32,24
1656078701514,MATH 142A,A03,093480,Staff,5,0,32,27
1656078701514,MATH 142A,B03,093481,Staff,4,0,32,28
1656078701514,MATH 142A,B04,093558,Staff,7,0,32,25
1656078701514,MATH 142A,B05,093559,Staff,0,0,32,32
1656078707546,MATH 193A,A01,083224,Rotar; Vladimir,1,2,34,33
1656078707546,MATH 193A,A02,083225,Rotar; Vladimir,3,0,34,31
1656078707546,MATH 193A,A03,083781,Rotar; Vladimir,3,0,34,31
1656078707546,MATH 193A,A04,083782,Rotar; Vladimir,7,0,34,27
1656078707546,MATH 193A,A05,093482,Rotar; Vladimir,1,0,34,33
1656078713570,MATH 197,001,091859,McAuley; Julian John,9999,0,9999,0
1656078713570,MATH 197,002,095566,Kedlaya; Kiran S.,9997,0,9999,2
1656078713570,MATH 197,003,095567,Xiao; Ming,9999,0,9999,0
1656078713570,MATH 197,004,095571,Perols; Johan Lars,9998,0,9999,1
1656078720645,COGS 9,A01,083615,Shannon; Kyle Michael,4,1,75,71
1656078726668,COGS 11,A01,083617,Boyle; Mary E. T.,16,1,48,32
1656078732693,COGS 13,A01,083071,Bastos; Amalia Pinkusfeld,8,2,71,63
1656078738734,COGS 14A,A01,092681,Semenuks; Arturs,8,23,100,92
1656078744758,COGS 14B,A01,083073,Cheng; Tzu-Han,9,0,63,54
1656078750786,COGS 17,A01,092677,Semenuks; Arturs,13,6,81,68
1656078756810,COGS 100,A01,083619,Allen; Michael Gordon,8,1,70,62
1656078762831,COGS 101A,A01,083621,Davis; Joshua Daniel,7,3,68,61
1656078768858,COGS 101B,A01,091572,Allen; Michael Gordon,7,0,65,58
1656078774883,COGS 101C,A01,083625,Delgado; Tania,11,0,35,24
1656078780911,COGS 107A,A01,083627,Boyle; Mary E. T.,5,2,60,55
1656078786943,COGS 118A,A01,083075,Gupta; Anjum,24,16,76,52
1656078792969,CSE 3,A50,083646,Miranda; Gregory Joseph,20,0,50,30
1656078798997,CSE 8A,A50,083650,Miranda; Gregory Joseph,13,11,56,43
1656078805025,CSE 11,A01,083080,Cao; Yingjun,1,60,40,39
1656078811120,CSE 12,A01,083652,Krause-Levy; Sophia Louisa,14,7,120,106
1656078817147,CSE 15L,A01,083654,Morris; Justin Loren,5,1,50,45
1656078817147,CSE 15L,A02,083655,Morris; Justin Loren,7,0,50,43
1656078823172,CSE 20,A01,083657,Tran; Khoa Dang,31,0,80,49
1656078829202,CSE 21,A01,095574,Bach; Quang Tran,28,0,48,20
1656078835232,CSE 30,A01,083084,Eldon; John,3,10,80,77
1656078835232,CSE 30,B01,095061,Bhaskar; Nishant,4,5,50,46
1656078841256,CSE 100,A01,083659,Cao; Yingjun,2,23,70,68
1656078847281,CSE 134B,A01,083661,Powell; Thomas Allan,11,6,100,89
1656078853304,CSE 140,A01,083663,Gungor; Onat,9,0,85,76
1656078859332,CSE 140L,A01,083088,Eldon; John,8,0,100,92
1656078865357,CSE 175,A01,083665,Kumar; Rakesh,2,0,25,23
1656078871383,CSE 190,A00,092507,Dubnov; Shlomo,3,0,20,17
1656078877407,ECE 45,A01,083139,Congero; Spencer William,5,2,75,70
1656078883431,ECE 65,A50,083695,Saad; Andrew S,8,0,30,22
1656078883431,ECE 65,A51,095125,Staff,23,0,26,3
1656078889454,ECE 109,A01,091882,Touri; Behrouz,5,4,70,65
1656078895476,ECE 180,A00,083140,Abi Samra; Nicholas Camill,1,0,30,29
1656078895476,ECE 180,B00,083141,Abi Samra; Nicholas Camill,2,8,28,26
1656078901498,MATH 10A,A01,083735,Patchell; Gregory David,1,0,30,29
1656078901498,MATH 10A,A02,083736,Patchell; Gregory David,23,0,30,7
1656078901498,MATH 10A,A03,083737,Patchell; Gregory David,16,0,30,14
1656078907527,MATH 10B,A01,083207,Lim; Seonhee,3,1,34,31
1656078907527,MATH 10B,A02,083208,Lim; Seonhee,10,1,35,25
1656078907527,MATH 10B,A03,093472,Staff,4,1,34,30
1656078907527,MATH 10B,B01,083739,Sinha; Shubham,12,0,30,18
1656078913551,MATH 18,A01,083743,Cinel; Cameron Alexander,7,0,30,23
1656078913551,MATH 18,A02,083744,Cinel; Cameron Alexander,12,0,30,18
1656078913551,MATH 18,A03,083745,Cinel; Cameron Alexander,3,0,30,27
1656078913551,MATH 18,B01,083748,Ma; Zilu,1,0,36,35
1656078913551,MATH 18,B02,083749,Ma; Zilu,2,0,36,34
1656078913551,MATH 18,B03,083750,Ma; Zilu,0,0,36,36
1656078913551,MATH 18,B04,083751,Ma; Zilu,1,0,36,35
1656078913551,MATH 18,B05,093473,Staff,3,0,36,33
1656078913551,MATH 18,B06,093474,Staff,4,0,36,32
1656078919575,MATH 20A,A01,083754,Zheng; Zequn,11,0,40,29
1656078925604,MATH 20B,A01,083756,Briones; Jor-el Thomas Caparas,0,0,36,36
1656078925604,MATH 20B,A02,083757,Briones; Jor-el Thomas Caparas,2,0,36,34
1656078925604,MATH 20B,A03,093475,Staff,3,0,36,33
1656078931632,MATH 20C,A01,083760,Briones; Jor-el Thomas Caparas,2,2,35,33
1656078931632,MATH 20C,A02,083761,Briones; Jor-el Thomas Caparas,9,1,35,26
1656078931632,MATH 20C,A03,093476,Staff,1,1,35,34
1656078931632,MATH 20C,B01,083762,Bach; Quang Tran,4,0,30,26
1656078937658,MATH 20D,A01,083765,Tran; Brian Kha,3,0,30,27
1656078937658,MATH 20D,A02,083766,Tran; Brian Kha,0,1,30,30
1656078937658,MATH 20D,A03,083767,Tran; Brian Kha,2,0,30,28
1656078943685,MATH 20E,A01,083771,Ganguly; Soumya,4,1,32,28
1656078943685,MATH 20E,A02,083772,Ganguly; Soumya,2,1,32,30
1656078943685,MATH 20E,B01,083773,Ciotti; Benjamin,15,0,35,20
1656078943685,MATH 20E,B02,083774,Ciotti; Benjamin,15,0,35,20
1656078950336,MATH 103A,A01,083777,Greenfeld; Be'Eri,3,0,36,33
1656078950336,MATH 103A,A02,083778,Greenfeld; Be'Eri,3,0,36,33
1656078950336,MATH 103A,A03,093561,Staff,4,1,36,32
1656078950336,MATH 103A,B01,083779,Greenfeld; Be'Eri,8,1,36,28
1656078950336,MATH 103A,B02,083780,Greenfeld; Be'Eri,0,0,36,36
1656078950336,MATH 103A,B03,093562,Staff,1,0,36,35
1656078956371,MATH 105,A01,085443,Carter; Anne Toulson,4,1,35,31
1656078956371,MATH 105,A02,093477,Staff,11,0,35,24
1656078962402,MATH 109,A01,083213,Ganzberger; Geoffrey Michael,1,1,34,33
1656078962402,MATH 109,A02,083214,Ganzberger; Geoffrey Michael,0,0,34,34
1656078962402,MATH 109,A03,093478,Staff,3,0,34,31
1656078962402,MATH 109,B01,083215,Ganzberger; Geoffrey Michael,4,0,32,28
1656078962402,MATH 109,B02,083216,Ganzberger; Geoffrey Michael,1,0,32,31
1656078962402,MATH 109,B03,093479,Staff,4,0,32,28
1656078968433,MATH 142A,A01,083219,Chow; Bennett,2,0,32,30
1656078968433,MATH 142A,A02,083220,Chow; Bennett,8,0,32,24
1656078968433,MATH 142A,A03,093480,Staff,5,0,32,27
1656078968433,MATH 142A,B03,093481,Staff,4,0,32,28
1656078968433,MATH 142A,B04,093558,Staff,7,0,32,25
1656078968433,MATH 142A,B05,093559,Staff,0,0,32,32
1656078974458,MATH 193A,A01,083224,Rotar; Vladimir,1,2,34,33
1656078974458,MATH 193A,A02,083225,Rotar; Vladimir,3,0,34,31
1656078974458,MATH 193A,A03,083781,Rotar; Vladimir,3,0,34,31
1656078974458,MATH 193A,A04,083782,Rotar; Vladimir,7,0,34,27
1656078974458,MATH 193A,A05,093482,Rotar; Vladimir,1,0,34,33
1656078980481,MATH 197,001,091859,McAuley; Julian John,9999,0,9999,0
1656078980481,MATH 197,002,095566,Kedlaya; Kiran S.,9997,0,9999,2
1656078980481,MATH 197,003,095567,Xiao; Ming,9999,0,9999,0
1656078980481,MATH 197,004,095571,Perols; Johan Lars,9998,0,9999,1
1656078987560,COGS 9,A01,083615,Shannon; Kyle Michael,4,1,75,71
1656078993585,COGS 11,A01,083617,Boyle; Mary E. T.,16,1,48,32
1656078999612,COGS 13,A01,083071,Bastos; Amalia Pinkusfeld,8,2,71,63
1656079005641,COGS 14A,A01,092681,Semenuks; Arturs,8,23,100,92
1656079011670,COGS 14B,A01,083073,Cheng; Tzu-Han,9,0,63,54
1656079017695,COGS 17,A01,092677,Semenuks; Arturs,13,6,81,68
1656079023722,COGS 100,A01,083619,Allen; Michael Gordon,8,1,70,62
1656079029752,COGS 101A,A01,083621,Davis; Joshua Daniel,7,3,68,61
1656079035777,COGS 101B,A01,091572,Allen; Michael Gordon,7,0,65,58
1656079041802,COGS 101C,A01,083625,Delgado; Tania,11,0,35,24
1656079047828,COGS 107A,A01,083627,Boyle; Mary E. T.,5,2,60,55
1656079053856,COGS 118A,A01,083075,Gupta; Anjum,24,16,76,52
1656079059882,CSE 3,A50,083646,Miranda; Gregory Joseph,20,0,50,30
1656079065912,CSE 8A,A50,083650,Miranda; Gregory Joseph,13,11,56,43
1656079071942,CSE 11,A01,083080,Cao; Yingjun,1,60,40,39
1656079077967,CSE 12,A01,083652,Krause-Levy; Sophia Louisa,14,7,120,106
1656079083993,CSE 15L,A01,083654,Morris; Justin Loren,5,1,50,45
1656079083993,CSE 15L,A02,083655,Morris; Justin Loren,7,0,50,43
1656079090024,CSE 20,A01,083657,Tran; Khoa Dang,31,0,80,49
1656079096049,CSE 21,A01,095574,Bach; Quang Tran,28,0,48,20
1656079102079,CSE 30,A01,083084,Eldon; John,3,10,80,77
1656079102079,CSE 30,B01,095061,Bhaskar; Nishant,4,5,50,46
1656079108111,CSE 100,A01,083659,Cao; Yingjun,2,23,70,68
1656079114136,CSE 134B,A01,083661,Powell; Thomas Allan,11,6,100,89
1656079120161,CSE 140,A01,083663,Gungor; Onat,9,0,85,76
1656079126192,CSE 140L,A01,083088,Eldon; John,8,0,100,92
1656079132224,CSE 175,A01,083665,Kumar; Rakesh,2,0,25,23
1656079138252,CSE 190,A00,092507,Dubnov; Shlomo,3,0,20,17
1656079144278,ECE 45,A01,083139,Congero; Spencer William,5,2,75,70
1656079150315,ECE 65,A50,083695,Saad; Andrew S,8,0,30,22
1656079150315,ECE 65,A51,095125,Staff,23,0,26,3
1656079156347,ECE 109,A01,091882,Touri; Behrouz,5,4,70,65
1656079162372,ECE 180,A00,083140,Abi Samra; Nicholas Camill,1,0,30,29
1656079162372,ECE 180,B00,083141,Abi Samra; Nicholas Camill,2,8,28,26
1656079168404,MATH 10A,A01,083735,Patchell; Gregory David,1,0,30,29
1656079168404,MATH 10A,A02,083736,Patchell; Gregory David,23,0,30,7
1656079168404,MATH 10A,A03,083737,Patchell; Gregory David,16,0,30,14
1656079174436,MATH 10B,A01,083207,Lim; Seonhee,3,1,34,31
1656079174436,MATH 10B,A02,083208,Lim; Seonhee,10,1,35,25
1656079174436,MATH 10B,A03,093472,Staff,4,1,34,30
1656079174436,MATH 10B,B01,083739,Sinha; Shubham,12,0,30,18
1656079180471,MATH 18,A01,083743,Cinel; Cameron Alexander,7,0,30,23
1656079180471,MATH 18,A02,083744,Cinel; Cameron Alexander,12,0,30,18
1656079180471,MATH 18,A03,083745,Cinel; Cameron Alexander,3,0,30,27
1656079180471,MATH 18,B01,083748,Ma; Zilu,1,0,36,35
1656079180471,MATH 18,B02,083749,Ma; Zilu,2,0,36,34
1656079180471,MATH 18,B03,083750,Ma; Zilu,0,0,36,36
1656079180471,MATH 18,B04,083751,Ma; Zilu,1,0,36,35
1656079180471,MATH 18,B05,093473,Staff,3,0,36,33
1656079180471,MATH 18,B06,093474,Staff,4,0,36,32
1656079186501,MATH 20A,A01,083754,Zheng; Zequn,11,0,40,29
1656079192526,MATH 20B,A01,083756,Briones; Jor-el Thomas Caparas,0,0,36,36
1656079192526,MATH 20B,A02,083757,Briones; Jor-el Thomas Caparas,2,0,36,34
1656079192526,MATH 20B,A03,093475,Staff,3,0,36,33
1656079198549,MATH 20C,A01,083760,Briones; Jor-el Thomas Caparas,2,2,35,33
1656079198549,MATH 20C,A02,083761,Briones; Jor-el Thomas Caparas,9,1,35,26
1656079198549,MATH 20C,A03,093476,Staff,1,1,35,34
1656079198549,MATH 20C,B01,083762,Bach; Quang Tran,4,0,30,26
1656079204581,MATH 20D,A01,083765,Tran; Brian Kha,3,0,30,27
1656079204581,MATH 20D,A02,083766,Tran; Brian Kha,0,1,30,30
1656079204581,MATH 20D,A03,083767,Tran; Brian Kha,2,0,30,28
1656079210615,MATH 20E,A01,083771,Ganguly; Soumya,4,1,32,28
1656079210615,MATH 20E,A02,083772,Ganguly; Soumya,2,1,32,30
1656079210615,MATH 20E,B01,083773,Ciotti; Benjamin,15,0,35,20
1656079210615,MATH 20E,B02,083774,Ciotti; Benjamin,15,0,35,20
1656079216642,MATH 103A,A01,083777,Greenfeld; Be'Eri,3,0,36,33
1656079216642,MATH 103A,A02,083778,Greenfeld; Be'Eri,3,0,36,33
1656079216642,MATH 103A,A03,093561,Staff,4,1,36,32
1656079216642,MATH 103A,B01,083779,Greenfeld; Be'Eri,8,1,36,28
1656079216642,MATH 103A,B02,083780,Greenfeld; Be'Eri,0,0,36,36
1656079216642,MATH 103A,B03,093562,Staff,1,0,36,35
1656079222675,MATH 105,A01,085443,Carter; Anne Toulson,4,1,35,31
1656079222675,MATH 105,A02,093477,Staff,11,0,35,24
1656079228700,MATH 109,A01,083213,Ganzberger; Geoffrey Michael,1,1,34,33
1656079228700,MATH 109,A02,083214,Ganzberger; Geoffrey Michael,0,0,34,34
1656079228700,MATH 109,A03,093478,Staff,3,0,34,31
1656079228700,MATH 109,B01,083215,Ganzberger; Geoffrey Michael,4,0,32,28
1656079228700,MATH 109,B02,083216,Ganzberger; Geoffrey Michael,1,0,32,31
1656079228700,MATH 109,B03,093479,Staff,4,0,32,28
1656079234735,MATH 142A,A01,083219,Chow; Bennett,2,0,32,30
1656079234735,MATH 142A,A02,083220,Chow; Bennett,8,0,32,24
1656079234735,MATH 142A,A03,093480,Staff,5,0,32,27
1656079234735,MATH 142A,B03,093481,Staff,4,0,32,28
1656079234735,MATH 142A,B04,093558,Staff,7,0,32,25
1656079234735,MATH 142A,B05,093559,Staff,0,0,32,32
1656079240761,MATH 193A,A01,083224,Rotar; Vladimir,1,2,34,33
1656079240761,MATH 193A,A02,083225,Rotar; Vladimir,3,0,34,31
1656079240761,MATH 193A,A03,083781,Rotar; Vladimir,3,0,34,31
1656079240761,MATH 193A,A04,083782,Rotar; Vladimir,7,0,34,27
1656079240761,MATH 193A,A05,093482,Rotar; Vladimir,1,0,34,33
1656079246785,MATH 197,001,091859,McAuley; Julian John,9999,0,9999,0
1656079246785,MATH 197,002,095566,Kedlaya; Kiran S.,9997,0,9999,2
1656079246785,MATH 197,003,095567,Xiao; Ming,9999,0,9999,0
1656079246785,MATH 197,004,095571,Perols; Johan Lars,9998,0,9999,1
1656079253843,COGS 9,A01,083615,Shannon; Kyle Michael,4,1,75,71
1656079259871,COGS 11,A01,083617,Boyle; Mary E. T.,16,1,48,32
1656079265919,COGS 13,A01,083071,Bastos; Amalia Pinkusfeld,8,2,71,63
1656079271944,COGS 14A,A01,092681,Semenuks; Arturs,8,23,100,92
1656079277970,COGS 14B,A01,083073,Cheng; Tzu-Han,9,0,63,54
1656079283994,COGS 17,A01,092677,Semenuks; Arturs,13,6,81,68
1656079290019,COGS 100,A01,083619,Allen; Michael Gordon,8,1,70,62
1656079296044,COGS 101A,A01,083621,Davis; Joshua Daniel,7,3,68,61
1656079302072,COGS 101B,A01,091572,Allen; Michael Gordon,7,0,65,58
1656079308097,COGS 101C,A01,083625,Delgado; Tania,11,0,35,24
1656079314133,COGS 107A,A01,083627,Boyle; Mary E. T.,5,2,60,55
1656079320159,COGS 118A,A01,083075,Gupta; Anjum,24,16,76,52
1656079326193,CSE 3,A50,083646,Miranda; Gregory Joseph,20,0,50,30
1656079332217,CSE 8A,A50,083650,Miranda; Gregory Joseph,13,11,56,43
1656079338245,CSE 11,A01,083080,Cao; Yingjun,1,60,40,39
1656079344270,CSE 12,A01,083652,Krause-Levy; Sophia Louisa,14,7,120,106
1656079350299,CSE 15L,A01,083654,Morris; Justin Loren,5,1,50,45
1656079350299,CSE 15L,A02,083655,Morris; Justin Loren,7,0,50,43
1656079356323,CSE 20,A01,083657,Tran; Khoa Dang,31,0,80,49
1656079362349,CSE 21,A01,095574,Bach; Quang Tran,28,0,48,20
1656079368372,CSE 30,A01,083084,Eldon; John,3,10,80,77
1656079368372,CSE 30,B01,095061,Bhaskar; Nishant,4,5,50,46
1656079374397,CSE 100,A01,083659,Cao; Yingjun,2,23,70,68
1656079380420,CSE 134B,A01,083661,Powell; Thomas Allan,11,6,100,89
1656079386444,CSE 140,A01,083663,Gungor; Onat,9,0,85,76
1656079392476,CSE 140L,A01,083088,Eldon; John,8,0,100,92
1656079398497,CSE 175,A01,083665,Kumar; Rakesh,2,0,25,23
1656079404522,CSE 190,A00,092507,Dubnov; Shlomo,3,0,20,17
1656079410635,ECE 45,A01,083139,Congero; Spencer William,5,2,75,70
1656079416679,ECE 65,A50,083695,Saad; Andrew S,8,0,30,22
1656079416679,ECE 65,A51,095125,Staff,23,0,26,3
1656079422705,ECE 109,A01,091882,Touri; Behrouz,5,4,70,65
1656079428734,ECE 180,A00,083140,Abi Samra; Nicholas Camill,1,0,30,29
1656079428734,ECE 180,B00,083141,Abi Samra; Nicholas Camill,2,8,28,26
1656079434762,MATH 10A,A01,083735,Patchell; Gregory David,1,0,30,29
1656079434762,MATH 10A,A02,083736,Patchell; Gregory David,23,0,30,7
1656079434762,MATH 10A,A03,083737,Patchell; Gregory David,16,0,30,14
1656079440797,MATH 10B,A01,083207,Lim; Seonhee,3,1,34,31
1656079440797,MATH 10B,A02,083208,Lim; Seonhee,10,1,35,25
1656079440797,MATH 10B,A03,093472,Staff,4,1,34,30
1656079440797,MATH 10B,B01,083739,Sinha; Shubham,12,0,30,18
1656079446839,MATH 18,A01,083743,Cinel; Cameron Alexander,7,0,30,23
1656079446839,MATH 18,A02,083744,Cinel; Cameron Alexander,12,0,30,18
1656079446839,MATH 18,A03,083745,Cinel; Cameron Alexander,3,0,30,27
1656079446839,MATH 18,B01,083748,Ma; Zilu,1,0,36,35
1656079446839,MATH 18,B02,083749,Ma; Zilu,2,0,36,34
1656079446839,MATH 18,B03,083750,Ma; Zilu,0,0,36,36
1656079446839,MATH 18,B04,083751,Ma; Zilu,1,0,36,35
1656079446839,MATH 18,B05,093473,Staff,3,0,36,33
1656079446839,MATH 18,B06,093474,Staff,4,0,36,32
1656079452871,MATH 20A,A01,083754,Zheng; Zequn,11,0,40,29
1656079458900,MATH 20B,A01,083756,Briones; Jor-el Thomas Caparas,0,0,36,36
1656079458900,MATH 20B,A02,083757,Briones; Jor-el Thomas Caparas,2,0,36,34
1656079458900,MATH 20B,A03,093475,Staff,3,0,36,33
1656079464936,MATH 20C,A01,083760,Briones; Jor-el Thomas Caparas,2,2,35,33
1656079464936,MATH 20C,A02,083761,Briones; Jor-el Thomas Caparas,9,1,35,26
1656079464936,MATH 20C,A03,093476,Staff,1,1,35,34
1656079464936,MATH 20C,B01,083762,Bach; Quang Tran,4,0,30,26
1656079470959,MATH 20D,A01,083765,Tran; Brian Kha,3,0,30,27
1656079470959,MATH 20D,A02,083766,Tran; Brian Kha,0,1,30,30
1656079470959,MATH 20D,A03,083767,Tran; Brian Kha,2,0,30,28
1656079476986,MATH 20E,A01,083771,Ganguly; Soumya,4,1,32,28
1656079476986,MATH 20E,A02,083772,Ganguly; Soumya,2,1,32,30
1656079476986,MATH 20E,B01,083773,Ciotti; Benjamin,15,0,35,20
1656079476986,MATH 20E,B02,083774,Ciotti; Benjamin,15,0,35,20
1656079483025,MATH 103A,A01,083777,Greenfeld; Be'Eri,3,0,36,33
1656079483025,MATH 103A,A02,083778,Greenfeld; Be'Eri,3,0,36,33
1656079483025,MATH 103A,A03,093561,Staff,4,1,36,32
1656079483025,MATH 103A,B01,083779,Greenfeld; Be'Eri,8,1,36,28
1656079483025,MATH 103A,B02,083780,Greenfeld; Be'Eri,0,0,36,36
1656079483025,MATH 103A,B03,093562,Staff,1,0,36,35
1656079489052,MATH 105,A01,085443,Carter; Anne Toulson,4,1,35,31
1656079489052,MATH 105,A02,093477,Staff,11,0,35,24
1656079495082,MATH 109,A01,083213,Ganzberger; Geoffrey Michael,1,1,34,33
1656079495082,MATH 109,A02,083214,Ganzberger; Geoffrey Michael,0,0,34,34
1656079495082,MATH 109,A03,093478,Staff,3,0,34,31
1656079495082,MATH 109,B01,083215,Ganzberger; Geoffrey Michael,4,0,32,28
1656079495082,MATH 109,B02,083216,Ganzberger; Geoffrey Michael,1,0,32,31
1656079495082,MATH 109,B03,093479,Staff,4,0,32,28
1656079501108,MATH 142A,A01,083219,Chow; Bennett,2,0,32,30
1656079501108,MATH 142A,A02,083220,Chow; Bennett,8,0,32,24
1656079501108,MATH 142A,A03,093480,Staff,5,0,32,27
1656079501108,MATH 142A,B03,093481,Staff,4,0,32,28
1656079501108,MATH 142A,B04,093558,Staff,7,0,32,25
1656079501108,MATH 142A,B05,093559,Staff,0,0,32,32
1656079507137,MATH 193A,A01,083224,Rotar; Vladimir,1,2,34,33
1656079507137,MATH 193A,A02,083225,Rotar; Vladimir,3,0,34,31
1656079507137,MATH 193A,A03,083781,Rotar; Vladimir,3,0,34,31
1656079507137,MATH 193A,A04,083782,Rotar; Vladimir,7,0,34,27
1656079507137,MATH 193A,A05,093482,Rotar; Vladimir,1,0,34,33
1656079513164,MATH 197,001,091859,McAuley; Julian John,9999,0,9999,0
1656079513164,MATH 197,002,095566,Kedlaya; Kiran S.,9997,0,9999,2
1656079513164,MATH 197,003,095567,Xiao; Ming,9999,0,9999,0
1656079513164,MATH 197,004,095571,Perols; Johan Lars,9998,0,9999,1
1656079520218,COGS 9,A01,083615,Shannon; Kyle Michael,4,1,75,71
1656079526245,COGS 11,A01,083617,Boyle; Mary E. T.,16,1,48,32
1656079532269,COGS 13,A01,083071,Bastos; Amalia Pinkusfeld,8,2,71,63
1656079538294,COGS 14A,A01,092681,Semenuks; Arturs,8,23,100,92
1656079544322,COGS 14B,A01,083073,Cheng; Tzu-Han,9,0,63,54
1656079550347,COGS 17,A01,092677,Semenuks; Arturs,13,6,81,68
1656079556375,COGS 100,A01,083619,Allen; Michael Gordon,8,1,70,62
1656079562401,COGS 101A,A01,083621,Davis; Joshua Daniel,7,3,68,61
1656079568430,COGS 101B,A01,091572,Allen; Michael Gordon,7,0,65,58
1656079574457,COGS 101C,A01,083625,Delgado; Tania,11,0,35,24
1656079580481,COGS 107A,A01,083627,Boyle; Mary E. T.,5,2,60,55
1656079586505,COGS 118A,A01,083075,Gupta; Anjum,24,16,76,52
1656079592533,CSE 3,A50,083646,Miranda; Gregory Joseph,20,0,50,30
1656079598556,CSE 8A,A50,083650,Miranda; Gregory Joseph,13,11,56,43
1656079604580,CSE 11,A01,083080,Cao; Yingjun,1,60,40,39
1656079610608,CSE 12,A01,083652,Krause-Levy; Sophia Louisa,14,7,120,106
1656079616636,CSE 15L,A01,083654,Morris; Justin Loren,5,1,50,45
1656079616636,CSE 15L,A02,083655,Morris; Justin Loren,7,0,50,43
1656079622660,CSE 20,A01,083657,Tran; Khoa Dang,31,0,80,49
1656079628685,CSE 21,A01,095574,Bach; Quang Tran,28,0,48,20
1656079634709,CSE 30,A01,083084,Eldon; John,3,10,80,77
1656079634709,CSE 30,B01,095061,Bhaskar; Nishant,4,5,50,46
1656079640736,CSE 100,A01,083659,Cao; Yingjun,2,23,70,68
1656079646760,CSE 134B,A01,083661,Powell; Thomas Allan,11,6,100,89
1656079652784,CSE 140,A01,083663,Gungor; Onat,9,0,85,76
1656079658811,CSE 140L,A01,083088,Eldon; John,8,0,100,92
1656079664833,CSE 175,A01,083665,Kumar; Rakesh,2,0,25,23
1656079670856,CSE 190,A00,092507,Dubnov; Shlomo,3,0,20,17
1656079676879,ECE 45,A01,083139,Congero; Spencer William,5,2,75,70
1656079682903,ECE 65,A50,083695,Saad; Andrew S,8,0,30,22
1656079682903,ECE 65,A51,095125,Staff,23,0,26,3
1656079688930,ECE 109,A01,091882,Touri; Behrouz,5,4,70,65
1656079694955,ECE 180,A00,083140,Abi Samra; Nicholas Camill,1,0,30,29
1656079694955,ECE 180,B00,083141,Abi Samra; Nicholas Camill,2,8,28,26
1656079700979,MATH 10A,A01,083735,Patchell; Gregory David,1,0,30,29
1656079700979,MATH 10A,A02,083736,Patchell; Gregory David,23,0,30,7
1656079700979,MATH 10A,A03,083737,Patchell; Gregory David,16,0,30,14
1656079707009,MATH 10B,A01,083207,Lim; Seonhee,3,1,34,31
1656079707009,MATH 10B,A02,083208,Lim; Seonhee,10,1,35,25
1656079707009,MATH 10B,A03,093472,Staff,4,1,34,30
1656079707009,MATH 10B,B01,083739,Sinha; Shubham,12,0,30,18
1656079713034,MATH 18,A01,083743,Cinel; Cameron Alexander,7,0,30,23
1656079713034,MATH 18,A02,083744,Cinel; Cameron Alexander,12,0,30,18
1656079713034,MATH 18,A03,083745,Cinel; Cameron Alexander,3,0,30,27
1656079713034,MATH 18,B01,083748,Ma; Zilu,1,0,36,35
1656079713034,MATH 18,B02,083749,Ma; Zilu,2,0,36,34
1656079713034,MATH 18,B03,083750,Ma; Zilu,0,0,36,36
1656079713034,MATH 18,B04,083751,Ma; Zilu,1,0,36,35
1656079713034,MATH 18,B05,093473,Staff,3,0,36,33
1656079713034,MATH 18,B06,093474,Staff,4,0,36,32
1656079719067,MATH 20A,A01,083754,Zheng; Zequn,11,0,40,29
1656079725091,MATH 20B,A01,083756,Briones; Jor-el Thomas Caparas,0,0,36,36
1656079725091,MATH 20B,A02,083757,Briones; Jor-el Thomas Caparas,2,0,36,34
1656079725091,MATH 20B,A03,093475,Staff,3,0,36,33
1656079731134,MATH 20C,A01,083760,Briones; Jor-el Thomas Caparas,2,2,35,33
1656079731134,MATH 20C,A02,083761,Briones; Jor-el Thomas Caparas,9,1,35,26
1656079731134,MATH 20C,A03,093476,Staff,1,1,35,34
1656079731134,MATH 20C,B01,083762,Bach; Quang Tran,4,0,30,26
1656079737159,MATH 20D,A01,083765,Tran; Brian Kha,3,0,30,27
1656079737159,MATH 20D,A02,083766,Tran; Brian Kha,0,1,30,30
1656079737159,MATH 20D,A03,083767,Tran; Brian Kha,2,0,30,28
1656079743187,MATH 20E,A01,083771,Ganguly; Soumya,4,1,32,28
1656079743187,MATH 20E,A02,083772,Ganguly; Soumya,2,1,32,30
1656079743187,MATH 20E,B01,083773,Ciotti; Benjamin,15,0,35,20
1656079743187,MATH 20E,B02,083774,Ciotti; Benjamin,15,0,35,20
1656079749211,MATH 103A,A01,083777,Greenfeld; Be'Eri,3,0,36,33
1656079749211,MATH 103A,A02,083778,Greenfeld; Be'Eri,3,0,36,33
1656079749211,MATH 103A,A03,093561,Staff,4,1,36,32
1656079749211,MATH 103A,B01,083779,Greenfeld; Be'Eri,8,1,36,28
1656079749211,MATH 103A,B02,083780,Greenfeld; Be'Eri,0,0,36,36
1656079749211,MATH 103A,B03,093562,Staff,1,0,36,35
1656079755238,MATH 105,A01,085443,Carter; Anne Toulson,4,1,35,31
1656079755238,MATH 105,A02,093477,Staff,11,0,35,24
1656079761263,MATH 109,A01,083213,Ganzberger; Geoffrey Michael,1,1,34,33
1656079761263,MATH 109,A02,083214,Ganzberger; Geoffrey Michael,0,0,34,34
1656079761263,MATH 109,A03,093478,Staff,3,0,34,31
1656079761263,MATH 109,B01,083215,Ganzberger; Geoffrey Michael,4,0,32,28
1656079761263,MATH 109,B02,083216,Ganzberger; Geoffrey Michael,1,0,32,31
1656079761263,MATH 109,B03,093479,Staff,4,0,32,28
1656079767295,MATH 142A,A01,083219,Chow; Bennett,2,0,32,30
1656079767295,MATH 142A,A02,083220,Chow; Bennett,8,0,32,24
1656079767295,MATH 142A,A03,093480,Staff,5,0,32,27
1656079767295,MATH 142A,B03,093481,Staff,4,0,32,28
1656079767295,MATH 142A,B04,093558,Staff,7,0,32,25
1656079767295,MATH 142A,B05,093559,Staff,0,0,32,32
1656079773322,MATH 193A,A01,083224,Rotar; Vladimir,1,2,34,33
1656079773322,MATH 193A,A02,083225,Rotar; Vladimir,3,0,34,31
1656079773322,MATH 193A,A03,083781,Rotar; Vladimir,3,0,34,31
1656079773322,MATH 193A,A04,083782,Rotar; Vladimir,7,0,34,27
1656079773322,MATH 193A,A05,093482,Rotar; Vladimir,1,0,34,33
1656079779347,MATH 197,001,091859,McAuley; Julian John,9999,0,9999,0
1656079779347,MATH 197,002,095566,Kedlaya; Kiran S.,9997,0,9999,2
1656079779347,MATH 197,003,095567,Xiao; Ming,9999,0,9999,0
1656079779347,MATH 197,004,095571,Perols; Johan Lars,9998,0,9999,1
1656079786400,COGS 9,A01,083615,Shannon; Kyle Michael,4,1,75,71
1656079792426,COGS 11,A01,083617,Boyle; Mary E. T.,16,1,48,32
1656079798458,COGS 13,A01,083071,Bastos; Amalia Pinkusfeld,8,2,71,63
1656079804482,COGS 14A,A01,092681,Semenuks; Arturs,8,23,100,92
1656079810517,COGS 14B,A01,083073,Cheng; Tzu-Han,9,0,63,54
1656079816539,COGS 17,A01,092677,Semenuks; Arturs,13,6,81,68
1656079822565,COGS 100,A01,083619,Allen; Michael Gordon,8,1,70,62
1656079828594,COGS 101A,A01,083621,Davis; Joshua Daniel,7,3,68,61
1656079834618,COGS 101B,A01,091572,Allen; Michael Gordon,7,0,65,58
1656079840643,COGS 101C,A01,083625,Delgado; Tania,11,0,35,24
1656079846666,COGS 107A,A01,083627,Boyle; Mary E. T.,5,2,60,55
1656079852687,COGS 118A,A01,083075,Gupta; Anjum,24,16,76,52
1656079858714,CSE 3,A50,083646,Miranda; Gregory Joseph,20,0,50,30
1656079864739,CSE 8A,A50,083650,Miranda; Gregory Joseph,13,11,56,43
1656079870764,CSE 11,A01,083080,Cao; Yingjun,1,60,40,39
1656079876791,CSE 12,A01,083652,Krause-Levy; Sophia Louisa,14,7,120,106
1656079882815,CSE 15L,A01,083654,Morris; Justin Loren,5,1,50,45
1656079882815,CSE 15L,A02,083655,Morris; Justin Loren,7,0,50,43
1656079888838,CSE 20,A01,083657,Tran; Khoa Dang,31,0,80,49
1656079894864,CSE 21,A01,095574,Bach; Quang Tran,28,0,48,20
1656079900889,CSE 30,A01,083084,Eldon; John,3,10,80,77
1656079900889,CSE 30,B01,095061,Bhaskar; Nishant,4,5,50,46
1656079906912,CSE 100,A01,083659,Cao; Yingjun,2,23,70,68
1656079912941,CSE 134B,A01,083661,Powell; Thomas Allan,11,6,100,89
1656079918967,CSE 140,A01,083663,Gungor; Onat,9,0,85,76
1656079925008,CSE 140L,A01,083088,Eldon; John,8,0,100,92
1656079931035,CSE 175,A01,083665,Kumar; Rakesh,2,0,25,23
1656079937059,CSE 190,A00,092507,Dubnov; Shlomo,3,0,20,17
1656079943082,ECE 45,A01,083139,Congero; Spencer William,5,2,75,70
1656079949137,ECE 65,A50,083695,Saad; Andrew S,8,0,30,22
1656079949137,ECE 65,A51,095125,Staff,23,0,26,3
1656079955164,ECE 109,A01,091882,Touri; Behrouz,5,4,70,65
1656079961189,ECE 180,A00,083140,Abi Samra; Nicholas Camill,1,0,30,29
1656079961189,ECE 180,B00,083141,Abi Samra; Nicholas Camill,4,8,30,26
1656079967214,MATH 10A,A01,083735,Patchell; Gregory David,1,0,30,29
1656079967214,MATH 10A,A02,083736,Patchell; Gregory David,23,0,30,7
1656079967214,MATH 10A,A03,083737,Patchell; Gregory David,16,0,30,14
1656079973242,MATH 10B,A01,083207,Lim; Seonhee,3,1,34,31
1656079973242,MATH 10B,A02,083208,Lim; Seonhee,10,1,35,25
1656079973242,MATH 10B,A03,093472,Staff,4,1,34,30
1656079973242,MATH 10B,B01,083739,Sinha; Shubham,12,0,30,18
1656079979275,MATH 18,A01,083743,Cinel; Cameron Alexander,7,0,30,23
1656079979275,MATH 18,A02,083744,Cinel; Cameron Alexander,12,0,30,18
1656079979275,MATH 18,A03,083745,Cinel; Cameron Alexander,3,0,30,27
1656079979275,MATH 18,B01,083748,Ma; Zilu,1,0,36,35
1656079979275,MATH 18,B02,083749,Ma; Zilu,2,0,36,34
1656079979275,MATH 18,B03,083750,Ma; Zilu,0,0,36,36
1656079979275,MATH 18,B04,083751,Ma; Zilu,1,0,36,35
1656079979275,MATH 18,B05,093473,Staff,3,0,36,33
1656079979275,MATH 18,B06,093474,Staff,4,0,36,32
1656079985302,MATH 20A,A01,083754,Zheng; Zequn,11,0,40,29
1656079991325,MATH 20B,A01,083756,Briones; Jor-el Thomas Caparas,0,0,36,36
1656079991325,MATH 20B,A02,083757,Briones; Jor-el Thomas Caparas,2,0,36,34
1656079991325,MATH 20B,A03,093475,Staff,3,0,36,33
1656079997354,MATH 20C,A01,083760,Briones; Jor-el Thomas Caparas,2,2,35,33
1656079997354,MATH 20C,A02,083761,Briones; Jor-el Thomas Caparas,9,1,35,26
1656079997354,MATH 20C,A03,093476,Staff,1,1,35,34
1656079997354,MATH 20C,B01,083762,Bach; Quang Tran,4,0,30,26
1656080003381,MATH 20D,A01,083765,Tran; Brian Kha,3,0,30,27
1656080003381,MATH 20D,A02,083766,Tran; Brian Kha,0,1,30,30
1656080003381,MATH 20D,A03,083767,Tran; Brian Kha,2,0,30,28
1656080009503,MATH 20E,A01,083771,Ganguly; Soumya,4,1,32,28
1656080009503,MATH 20E,A02,083772,Ganguly; Soumya,2,1,32,30
1656080009503,MATH 20E,B01,083773,Ciotti; Benjamin,15,0,35,20
1656080009503,MATH 20E,B02,083774,Ciotti; Benjamin,15,0,35,20
1656080015559,MATH 103A,A01,083777,Greenfeld; Be'Eri,3,0,36,33
1656080015559,MATH 103A,A02,083778,Greenfeld; Be'Eri,3,0,36,33
1656080015559,MATH 103A,A03,093561,Staff,4,1,36,32
1656080015559,MATH 103A,B01,083779,Greenfeld; Be'Eri,8,1,36,28
1656080015559,MATH 103A,B02,083780,Greenfeld; Be'Eri,0,0,36,36
1656080015559,MATH 103A,B03,093562,Staff,1,0,36,35
1656080021589,MATH 105,A01,085443,Carter; Anne Toulson,4,1,35,31
1656080021589,MATH 105,A02,093477,Staff,11,0,35,24
1656080027612,MATH 109,A01,083213,Ganzberger; Geoffrey Michael,1,1,34,33
1656080027612,MATH 109,A02,083214,Ganzberger; Geoffrey Michael,0,0,34,34
1656080027612,MATH 109,A03,093478,Staff,3,0,34,31
1656080027612,MATH 109,B01,083215,Ganzberger; Geoffrey Michael,4,0,32,28
1656080027612,MATH 109,B02,083216,Ganzberger; Geoffrey Michael,1,0,32,31
1656080027612,MATH 109,B03,093479,Staff,4,0,32,28
1656080033642,MATH 142A,A01,083219,Chow; Bennett,2,0,32,30
1656080033642,MATH 142A,A02,083220,Chow; Bennett,8,0,32,24
1656080033642,MATH 142A,A03,093480,Staff,5,0,32,27
1656080033642,MATH 142A,B03,093481,Staff,4,0,32,28
1656080033642,MATH 142A,B04,093558,Staff,7,0,32,25
1656080033642,MATH 142A,B05,093559,Staff,0,0,32,32
1656080039673,MATH 193A,A01,083224,Rotar; Vladimir,1,2,34,33
1656080039673,MATH 193A,A02,083225,Rotar; Vladimir,3,0,34,31
1656080039673,MATH 193A,A03,083781,Rotar; Vladimir,3,0,34,31
1656080039673,MATH 193A,A04,083782,Rotar; Vladimir,7,0,34,27
1656080039673,MATH 193A,A05,093482,Rotar; Vladimir,1,0,34,33
1656080045696,MATH 197,001,091859,McAuley; Julian John,9999,0,9999,0
1656080045696,MATH 197,002,095566,Kedlaya; Kiran S.,9997,0,9999,2
1656080045696,MATH 197,003,095567,Xiao; Ming,9999,0,9999,0
1656080045696,MATH 197,004,095571,Perols; Johan Lars,9998,0,9999,1
1656080052766,COGS 9,A01,083615,Shannon; Kyle Michael,4,1,75,71
1656080058792,COGS 11,A01,083617,Boyle; Mary E. T.,16,1,48,32
1656080064815,COGS 13,A01,083071,Bastos; Amalia Pinkusfeld,8,2,71,63
1656080070842,COGS 14A,A01,092681,Semenuks; Arturs,8,23,100,92
1656080076866,COGS 14B,A01,083073,Cheng; Tzu-Han,9,0,63,54
1656080082891,COGS 17,A01,092677,Semenuks; Arturs,13,6,81,68
1656080088920,COGS 100,A01,083619,Allen; Michael Gordon,8,1,70,62
1656080094947,COGS 101A,A01,083621,Davis; Joshua Daniel,7,3,68,61
1656080100975,COGS 101B,A01,091572,Allen; Michael Gordon,7,0,65,58
1656080107012,COGS 101C,A01,083625,Delgado; Tania,11,0,35,24
1656080113039,COGS 107A,A01,083627,Boyle; Mary E. T.,5,2,60,55
1656080119063,COGS 118A,A01,083075,Gupta; Anjum,24,16,76,52
1656080125088,CSE 3,A50,083646,Miranda; Gregory Joseph,20,0,50,30
1656080131116,CSE 8A,A50,083650,Miranda; Gregory Joseph,13,11,56,43
1656080137139,CSE 11,A01,083080,Cao; Yingjun,1,60,40,39
1656080143167,CSE 12,A01,083652,Krause-Levy; Sophia Louisa,14,7,120,106
1656080149191,CSE 15L,A01,083654,Morris; Justin Loren,5,1,50,45
1656080149191,CSE 15L,A02,083655,Morris; Justin Loren,7,0,50,43
1656080155221,CSE 20,A01,083657,Tran; Khoa Dang,31,0,80,49
1656080161246,CSE 21,A01,095574,Bach; Quang Tran,28,0,48,20
1656080167277,CSE 30,A01,083084,Eldon; John,3,10,80,77
1656080167277,CSE 30,B01,095061,Bhaskar; Nishant,4,5,50,46
1656080173300,CSE 100,A01,083659,Cao; Yingjun,2,23,70,68
1656080179325,CSE 134B,A01,083661,Powell; Thomas Allan,11,6,100,89
1656080185351,CSE 140,A01,083663,Gungor; Onat,9,0,85,76
1656080191373,CSE 140L,A01,083088,Eldon; John,8,0,100,92
1656080197400,CSE 175,A01,083665,Kumar; Rakesh,2,0,25,23
1656080203429,CSE 190,A00,092507,Dubnov; Shlomo,3,0,20,17
1656080209454,ECE 45,A01,083139,Congero; Spencer William,5,2,75,70
1656080215484,ECE 65,A50,083695,Saad; Andrew S,8,0,30,22
1656080215484,ECE 65,A51,095125,Staff,23,0,26,3
1656080221505,ECE 109,A01,091882,Touri; Behrouz,5,4,70,65
1656080227532,ECE 180,A00,083140,Abi Samra; Nicholas Camill,1,0,30,29
1656080227532,ECE 180,B00,083141,Abi Samra; Nicholas Camill,4,8,30,26
1656080233561,MATH 10A,A01,083735,Patchell; Gregory David,1,0,30,29
1656080233561,MATH 10A,A02,083736,Patchell; Gregory David,23,0,30,7
1656080233561,MATH 10A,A03,083737,Patchell; Gregory David,16,0,30,14
1656080239588,MATH 10B,A01,083207,Lim; Seonhee,3,1,34,31
1656080239588,MATH 10B,A02,083208,Lim; Seonhee,10,1,35,25
1656080239588,MATH 10B,A03,093472,Staff,4,1,34,30
1656080239588,MATH 10B,B01,083739,Sinha; Shubham,12,0,30,18
1656080245619,MATH 18,A01,083743,Cinel; Cameron Alexander,7,0,30,23
1656080245619,MATH 18,A02,083744,Cinel; Cameron Alexander,12,0,30,18
1656080245619,MATH 18,A03,083745,Cinel; Cameron Alexander,3,0,30,27
1656080245619,MATH 18,B01,083748,Ma; Zilu,1,0,36,35
1656080245619,MATH 18,B02,083749,Ma; Zilu,2,0,36,34
1656080245619,MATH 18,B03,083750,Ma; Zilu,0,0,36,36
1656080245619,MATH 18,B04,083751,Ma; Zilu,1,0,36,35
1656080245619,MATH 18,B05,093473,Staff,3,0,36,33
1656080245619,MATH 18,B06,093474,Staff,4,0,36,32
1656080251644,MATH 20A,A01,083754,Zheng; Zequn,11,0,40,29
1656080257666,MATH 20B,A01,083756,Briones; Jor-el Thomas Caparas,0,0,36,36
1656080257666,MATH 20B,A02,083757,Briones; Jor-el Thomas Caparas,2,0,36,34
1656080257666,MATH 20B,A03,093475,Staff,3,0,36,33
1656080263691,MATH 20C,A01,083760,Briones; Jor-el Thomas Caparas,2,2,35,33
1656080263691,MATH 20C,A02,083761,Briones; Jor-el Thomas Caparas,9,1,35,26
1656080263691,MATH 20C,A03,093476,Staff,1,1,35,34
1656080263691,MATH 20C,B01,083762,Bach; Quang Tran,4,0,30,26
1656080269716,MATH 20D,A01,083765,Tran; Brian Kha,3,0,30,27
1656080269716,MATH 20D,A02,083766,Tran; Brian Kha,0,1,30,30
1656080269716,MATH 20D,A03,083767,Tran; Brian Kha,2,0,30,28
1656080275741,MATH 20E,A01,083771,Ganguly; Soumya,4,1,32,28
1656080275741,MATH 20E,A02,083772,Ganguly; Soumya,2,1,32,30
1656080275741,MATH 20E,B01,083773,Ciotti; Benjamin,15,0,35,20
1656080275741,MATH 20E,B02,083774,Ciotti; Benjamin,15,0,35,20
1656080281766,MATH 103A,A01,083777,Greenfeld; Be'Eri,3,0,36,33
1656080281766,MATH 103A,A02,083778,Greenfeld; Be'Eri,3,0,36,33
1656080281766,MATH 103A,A03,093561,Staff,4,1,36,32
1656080281766,MATH 103A,B01,083779,Greenfeld; Be'Eri,8,1,36,28
1656080281766,MATH 103A,B02,083780,Greenfeld; Be'Eri,0,0,36,36
1656080281766,MATH 103A,B03,093562,Staff,1,0,36,35
1656080287791,MATH 105,A01,085443,Carter; Anne Toulson,4,1,35,31
1656080287791,MATH 105,A02,093477,Staff,11,0,35,24
1656080293825,MATH 109,A01,083213,Ganzberger; Geoffrey Michael,1,1,34,33
1656080293825,MATH 109,A02,083214,Ganzberger; Geoffrey Michael,0,0,34,34
1656080293825,MATH 109,A03,093478,Staff,3,0,34,31
1656080293825,MATH 109,B01,083215,Ganzberger; Geoffrey Michael,4,0,32,28
1656080293825,MATH 109,B02,083216,Ganzberger; Geoffrey Michael,1,0,32,31
1656080293825,MATH 109,B03,093479,Staff,4,0,32,28
1656080299849,MATH 142A,A01,083219,Chow; Bennett,2,0,32,30
1656080299849,MATH 142A,A02,083220,Chow; Bennett,8,0,32,24
1656080299849,MATH 142A,A03,093480,Staff,5,0,32,27
1656080299849,MATH 142A,B03,093481,Staff,4,0,32,28
1656080299849,MATH 142A,B04,093558,Staff,7,0,32,25
1656080299849,MATH 142A,B05,093559,Staff,0,0,32,32
1656080305879,MATH 193A,A01,083224,Rotar; Vladimir,1,2,34,33
1656080305879,MATH 193A,A02,083225,Rotar; Vladimir,3,0,34,31
1656080305879,MATH 193A,A03,083781,Rotar; Vladimir,3,0,34,31
1656080305879,MATH 193A,A04,083782,Rotar; Vladimir,7,0,34,27
1656080305879,MATH 193A,A05,093482,Rotar; Vladimir,1,0,34,33
1656080311903,MATH 197,001,091859,McAuley; Julian John,9999,0,9999,0
1656080311903,MATH 197,002,095566,Kedlaya; Kiran S.,9997,0,9999,2
1656080311903,MATH 197,003,095567,Xiao; Ming,9999,0,9999,0
1656080311903,MATH 197,004,095571,Perols; Johan Lars,9998,0,9999,1
1656080318972,COGS 9,A01,083615,Shannon; Kyle Michael,4,1,75,71
1656080324999,COGS 11,A01,083617,Boyle; Mary E. T.,16,1,48,32
1656080331027,COGS 13,A01,083071,Bastos; Amalia Pinkusfeld,8,2,71,63
1656080337067,COGS 14A,A01,092681,Semenuks; Arturs,8,23,100,92
1656080343091,COGS 14B,A01,083073,Cheng; Tzu-Han,9,0,63,54
1656080349126,COGS 17,A01,092677,Semenuks; Arturs,13,6,81,68
1656080355151,COGS 100,A01,083619,Allen; Michael Gordon,8,1,70,62
1656080361185,COGS 101A,A01,083621,Davis; Joshua Daniel,7,3,68,61
1656080367214,COGS 101B,A01,091572,Allen; Michael Gordon,7,0,65,58
1656080373241,COGS 101C,A01,083625,Delgado; Tania,11,0,35,24
1656080379272,COGS 107A,A01,083627,Boyle; Mary E. T.,5,2,60,55
1656080385298,COGS 118A,A01,083075,Gupta; Anjum,24,16,76,52
1656080391321,CSE 3,A50,083646,Miranda; Gregory Joseph,20,0,50,30
1656080397344,CSE 8A,A50,083650,Miranda; Gregory Joseph,13,11,56,43
1656080403378,CSE 11,A01,083080,Cao; Yingjun,1,60,40,39
1656080409406,CSE 12,A01,083652,Krause-Levy; Sophia Louisa,14,7,120,106
1656080415438,CSE 15L,A01,083654,Morris; Justin Loren,5,1,50,45
1656080415438,CSE 15L,A02,083655,Morris; Justin Loren,7,0,50,43
1656080421462,CSE 20,A01,083657,Tran; Khoa Dang,31,0,80,49
1656080427489,CSE 21,A01,095574,Bach; Quang Tran,28,0,48,20
1656080433514,CSE 30,A01,083084,Eldon; John,3,10,80,77
1656080433514,CSE 30,B01,095061,Bhaskar; Nishant,4,5,50,46
1656080439540,CSE 100,A01,083659,Cao; Yingjun,2,23,70,68
1656080445565,CSE 134B,A01,083661,Powell; Thomas Allan,11,6,100,89
1656080451593,CSE 140,A01,083663,Gungor; Onat,9,0,85,76
1656080457621,CSE 140L,A01,083088,Eldon; John,8,0,100,92
1656080463646,CSE 175,A01,083665,Kumar; Rakesh,2,0,25,23
1656080469670,CSE 190,A00,092507,Dubnov; Shlomo,3,0,20,17
1656080475695,ECE 45,A01,083139,Congero; Spencer William,5,2,75,70
1656080481727,ECE 65,A50,083695,Saad; Andrew S,8,0,30,22
1656080481727,ECE 65,A51,095125,Staff,23,0,26,3
1656080487755,ECE 109,A01,091882,Touri; Behrouz,5,4,70,65
1656080493779,ECE 180,A00,083140,Abi Samra; Nicholas Camill,1,0,30,29
1656080493779,ECE 180,B00,083141,Abi Samra; Nicholas Camill,4,8,30,26
1656080499804,MATH 10A,A01,083735,Patchell; Gregory David,1,0,30,29
1656080499804,MATH 10A,A02,083736,Patchell; Gregory David,23,0,30,7
1656080499804,MATH 10A,A03,083737,Patchell; Gregory David,16,0,30,14
1656080505831,MATH 10B,A01,083207,Lim; Seonhee,3,1,34,31
1656080505831,MATH 10B,A02,083208,Lim; Seonhee,10,1,35,25
1656080505831,MATH 10B,A03,093472,Staff,4,1,34,30
1656080505831,MATH 10B,B01,083739,Sinha; Shubham,12,0,30,18
1656080511856,MATH 18,A01,083743,Cinel; Cameron Alexander,7,0,30,23
1656080511856,MATH 18,A02,083744,Cinel; Cameron Alexander,12,0,30,18
1656080511856,MATH 18,A03,083745,Cinel; Cameron Alexander,3,0,30,27
1656080511856,MATH 18,B01,083748,Ma; Zilu,1,0,36,35
1656080511856,MATH 18,B02,083749,Ma; Zilu,2,0,36,34
1656080511856,MATH 18,B03,083750,Ma; Zilu,0,0,36,36
1656080511856,MATH 18,B04,083751,Ma; Zilu,1,0,36,35
1656080511856,MATH 18,B05,093473,Staff,3,0,36,33
1656080511856,MATH 18,B06,093474,Staff,4,0,36,32
1656080517881,MATH 20A,A01,083754,Zheng; Zequn,11,0,40,29
1656080523906,MATH 20B,A01,083756,Briones; Jor-el Thomas Caparas,0,0,36,36
1656080523906,MATH 20B,A02,083757,Briones; Jor-el Thomas Caparas,2,0,36,34
1656080523906,MATH 20B,A03,093475,Staff,3,0,36,33
1656080529931,MATH 20C,A01,083760,Briones; Jor-el Thomas Caparas,2,2,35,33
1656080529931,MATH 20C,A02,083761,Briones; Jor-el Thomas Caparas,9,1,35,26
1656080529931,MATH 20C,A03,093476,Staff,1,1,35,34
1656080529931,MATH 20C,B01,083762,Bach; Quang Tran,4,0,30,26
1656080535960,MATH 20D,A01,083765,Tran; Brian Kha,3,0,30,27
1656080535960,MATH 20D,A02,083766,Tran; Brian Kha,0,1,30,30
1656080535960,MATH 20D,A03,083767,Tran; Brian Kha,2,0,30,28
1656080541985,MATH 20E,A01,083771,Ganguly; Soumya,4,1,32,28
1656080541985,MATH 20E,A02,083772,Ganguly; Soumya,2,1,32,30
1656080541985,MATH 20E,B01,083773,Ciotti; Benjamin,15,0,35,20
1656080541985,MATH 20E,B02,083774,Ciotti; Benjamin,15,0,35,20
1656080548009,MATH 103A,A01,083777,Greenfeld; Be'Eri,3,0,36,33
1656080548009,MATH 103A,A02,083778,Greenfeld; Be'Eri,3,0,36,33
1656080548009,MATH 103A,A03,093561,Staff,4,1,36,32
1656080548009,MATH 103A,B01,083779,Greenfeld; Be'Eri,8,1,36,28
1656080548009,MATH 103A,B02,083780,Greenfeld; Be'Eri,0,0,36,36
1656080548009,MATH 103A,B03,093562,Staff,1,0,36,35
1656080554037,MATH 105,A01,085443,Carter; Anne Toulson,4,1,35,31
1656080554037,MATH 105,A02,093477,Staff,11,0,35,24
1656080560067,MATH 109,A01,083213,Ganzberger; Geoffrey Michael,1,1,34,33
1656080560067,MATH 109,A02,083214,Ganzberger; Geoffrey Michael,0,0,34,34
1656080560067,MATH 109,A03,093478,Staff,3,0,34,31
1656080560067,MATH 109,B01,083215,Ganzberger; Geoffrey Michael,4,0,32,28
1656080560067,MATH 109,B02,083216,Ganzberger; Geoffrey Michael,1,0,32,31
1656080560067,MATH 109,B03,093479,Staff,4,0,32,28
1656080566105,MATH 142A,A01,083219,Chow; Bennett,2,0,32,30
1656080566105,MATH 142A,A02,083220,Chow; Bennett,8,0,32,24
1656080566105,MATH 142A,A03,093480,Staff,5,0,32,27
1656080566105,MATH 142A,B03,093481,Staff,4,0,32,28
1656080566105,MATH 142A,B04,093558,Staff,7,0,32,25
1656080566105,MATH 142A,B05,093559,Staff,0,0,32,32
1656080572130,MATH 193A,A01,083224,Rotar; Vladimir,1,2,34,33
1656080572130,MATH 193A,A02,083225,Rotar; Vladimir,3,0,34,31
1656080572130,MATH 193A,A03,083781,Rotar; Vladimir,3,0,34,31
1656080572130,MATH 193A,A04,083782,Rotar; Vladimir,7,0,34,27
1656080572130,MATH 193A,A05,093482,Rotar; Vladimir,1,0,34,33
1656080578154,MATH 197,001,091859,McAuley; Julian John,9999,0,9999,0
1656080578154,MATH 197,002,095566,Kedlaya; Kiran S.,9997,0,9999,2
1656080578154,MATH 197,003,095567,Xiao; Ming,9999,0,9999,0
1656080578154,MATH 197,004,095571,Perols; Johan Lars,9998,0,9999,1
1656080585216,COGS 9,A01,083615,Shannon; Kyle Michael,4,1,75,71
1656080591240,COGS 11,A01,083617,Boyle; Mary E. T.,16,1,48,32
1656080597266,COGS 13,A01,083071,Bastos; Amalia Pinkusfeld,8,2,71,63
1656080603363,COGS 14A,A01,092681,Semenuks; Arturs,8,23,100,92
1656080609388,COGS 14B,A01,083073,Cheng; Tzu-Han,9,0,63,54
1656080615410,COGS 17,A01,092677,Semenuks; Arturs,13,6,81,68
1656080621432,COGS 100,A01,083619,Allen; Michael Gordon,8,1,70,62
1656080627458,COGS 101A,A01,083621,Davis; Joshua Daniel,7,3,68,61
1656080633483,COGS 101B,A01,091572,Allen; Michael Gordon,7,0,65,58
1656080639512,COGS 101C,A01,083625,Delgado; Tania,11,0,35,24
1656080645538,COGS 107A,A01,083627,Boyle; Mary E. T.,5,2,60,55
1656080651562,COGS 118A,A01,083075,Gupta; Anjum,24,16,76,52
1656080657590,CSE 3,A50,083646,Miranda; Gregory Joseph,20,0,50,30
1656080663614,CSE 8A,A50,083650,Miranda; Gregory Joseph,13,11,56,43
1656080669638,CSE 11,A01,083080,Cao; Yingjun,1,60,40,39
1656080675664,CSE 12,A01,083652,Krause-Levy; Sophia Louisa,14,7,120,106
1656080681691,CSE 15L,A01,083654,Morris; Justin Loren,5,1,50,45
1656080681691,CSE 15L,A02,083655,Morris; Justin Loren,7,0,50,43
1656080687727,CSE 20,A01,083657,Tran; Khoa Dang,31,0,80,49
1656080693754,CSE 21,A01,095574,Bach; Quang Tran,28,0,48,20
1656080699780,CSE 30,A01,083084,Eldon; John,3,10,80,77
1656080699780,CSE 30,B01,095061,Bhaskar; Nishant,4,5,50,46
1656080705804,CSE 100,A01,083659,Cao; Yingjun,2,23,70,68
1656080711829,CSE 134B,A01,083661,Powell; Thomas Allan,11,6,100,89
1656080717854,CSE 140,A01,083663,Gungor; Onat,9,0,85,76
1656080723881,CSE 140L,A01,083088,Eldon; John,8,0,100,92
1656080729908,CSE 175,A01,083665,Kumar; Rakesh,2,0,25,23
1656080735931,CSE 190,A00,092507,Dubnov; Shlomo,3,0,20,17
1656080741956,ECE 45,A01,083139,Congero; Spencer William,5,2,75,70
1656080747985,ECE 65,A50,083695,Saad; Andrew S,8,0,30,22
1656080747985,ECE 65,A51,095125,Staff,23,0,26,3
1656080754012,ECE 109,A01,091882,Touri; Behrouz,5,4,70,65
1656080760038,ECE 180,A00,083140,Abi Samra; Nicholas Camill,1,0,30,29
1656080760038,ECE 180,B00,083141,Abi Samra; Nicholas Camill,4,8,30,26
1656080766076,MATH 10A,A01,083735,Patchell; Gregory David,1,0,30,29
1656080766076,MATH 10A,A02,083736,Patchell; Gregory David,23,0,30,7
1656080766076,MATH 10A,A03,083737,Patchell; Gregory David,16,0,30,14
1656080772112,MATH 10B,A01,083207,Lim; Seonhee,3,1,34,31
1656080772112,MATH 10B,A02,083208,Lim; Seonhee,10,1,35,25
1656080772112,MATH 10B,A03,093472,Staff,4,1,34,30
1656080772112,MATH 10B,B01,083739,Sinha; Shubham,12,0,30,18
1656080778138,MATH 18,A01,083743,Cinel; Cameron Alexander,7,0,30,23
1656080778138,MATH 18,A02,083744,Cinel; Cameron Alexander,12,0,30,18
1656080778138,MATH 18,A03,083745,Cinel; Cameron Alexander,3,0,30,27
1656080778138,MATH 18,B01,083748,Ma; Zilu,1,0,36,35
1656080778138,MATH 18,B02,083749,Ma; Zilu,2,0,36,34
1656080778138,MATH 18,B03,083750,Ma; Zilu,0,0,36,36
1656080778138,MATH 18,B04,083751,Ma; Zilu,1,0,36,35
1656080778138,MATH 18,B05,093473,Staff,3,0,36,33
1656080778138,MATH 18,B06,093474,Staff,4,0,36,32
1656080784161,MATH 20A,A01,083754,Zheng; Zequn,11,0,40,29
1656080790186,MATH 20B,A01,083756,Briones; Jor-el Thomas Caparas,0,0,36,36
1656080790186,MATH 20B,A02,083757,Briones; Jor-el Thomas Caparas,2,0,36,34
1656080790186,MATH 20B,A03,093475,Staff,3,0,36,33
1656080796226,MATH 20C,A01,083760,Briones; Jor-el Thomas Caparas,2,2,35,33
1656080796226,MATH 20C,A02,083761,Briones; Jor-el Thomas Caparas,9,1,35,26
1656080796226,MATH 20C,A03,093476,Staff,1,1,35,34
1656080796226,MATH 20C,B01,083762,Bach; Quang Tran,4,0,30,26
1656080802251,MATH 20D,A01,083765,Tran; Brian Kha,3,0,30,27
1656080802251,MATH 20D,A02,083766,Tran; Brian Kha,0,1,30,30
1656080802251,MATH 20D,A03,083767,Tran; Brian Kha,2,0,30,28
1656080808285,MATH 20E,A01,083771,Ganguly; Soumya,4,1,32,28
1656080808285,MATH 20E,A02,083772,Ganguly; Soumya,2,1,32,30
1656080808285,MATH 20E,B01,083773,Ciotti; Benjamin,15,0,35,20
1656080808285,MATH 20E,B02,083774,Ciotti; Benjamin,15,0,35,20
1656080814311,MATH 103A,A01,083777,Greenfeld; Be'Eri,3,0,36,33
1656080814311,MATH 103A,A02,083778,Greenfeld; Be'Eri,3,0,36,33
1656080814311,MATH 103A,A03,093561,Staff,4,1,36,32
1656080814311,MATH 103A,B01,083779,Greenfeld; Be'Eri,8,1,36,28
1656080814311,MATH 103A,B02,083780,Greenfeld; Be'Eri,0,0,36,36
1656080814311,MATH 103A,B03,093562,Staff,1,0,36,35
1656080820335,MATH 105,A01,085443,Carter; Anne Toulson,4,1,35,31
1656080820335,MATH 105,A02,093477,Staff,11,0,35,24
1656080826359,MATH 109,A01,083213,Ganzberger; Geoffrey Michael,1,1,34,33
1656080826359,MATH 109,A02,083214,Ganzberger; Geoffrey Michael,0,0,34,34
1656080826359,MATH 109,A03,093478,Staff,3,0,34,31
1656080826359,MATH 109,B01,083215,Ganzberger; Geoffrey Michael,4,0,32,28
1656080826359,MATH 109,B02,083216,Ganzberger; Geoffrey Michael,1,0,32,31
1656080826359,MATH 109,B03,093479,Staff,4,0,32,28
1656080832384,MATH 142A,A01,083219,Chow; Bennett,2,0,32,30
1656080832384,MATH 142A,A02,083220,Chow; Bennett,8,0,32,24
1656080832384,MATH 142A,A03,093480,Staff,5,0,32,27
1656080832384,MATH 142A,B03,093481,Staff,4,0,32,28
1656080832384,MATH 142A,B04,093558,Staff,7,0,32,25
1656080832384,MATH 142A,B05,093559,Staff,0,0,32,32
1656080838410,MATH 193A,A01,083224,Rotar; Vladimir,1,2,34,33
1656080838410,MATH 193A,A02,083225,Rotar; Vladimir,3,0,34,31
1656080838410,MATH 193A,A03,083781,Rotar; Vladimir,3,0,34,31
1656080838410,MATH 193A,A04,083782,Rotar; Vladimir,7,0,34,27
1656080838410,MATH 193A,A05,093482,Rotar; Vladimir,1,0,34,33
1656080844436,MATH 197,001,091859,McAuley; Julian John,9999,0,9999,0
1656080844436,MATH 197,002,095566,Kedlaya; Kiran S.,9997,0,9999,2
1656080844436,MATH 197,003,095567,Xiao; Ming,9999,0,9999,0
1656080844436,MATH 197,004,095571,Perols; Johan Lars,9998,0,9999,1
1656080851502,COGS 9,A01,083615,Shannon; Kyle Michael,4,1,75,71
1656080857526,COGS 11,A01,083617,Boyle; Mary E. T.,16,1,48,32
1656080863554,COGS 13,A01,083071,Bastos; Amalia Pinkusfeld,8,2,71,63
1656080869582,COGS 14A,A01,092681,Semenuks; Arturs,8,23,100,92
1656080875606,COGS 14B,A01,083073,Cheng; Tzu-Han,9,0,63,54
1656080881633,COGS 17,A01,092677,Semenuks; Arturs,13,6,81,68
1656080887655,COGS 100,A01,083619,Allen; Michael Gordon,8,1,70,62
1656080893678,COGS 101A,A01,083621,Davis; Joshua Daniel,7,3,68,61
1656080899705,COGS 101B,A01,091572,Allen; Michael Gordon,7,0,65,58
1656080905731,COGS 101C,A01,083625,Delgado; Tania,11,0,35,24
1656080911760,COGS 107A,A01,083627,Boyle; Mary E. T.,5,2,60,55
1656080917789,COGS 118A,A01,083075,Gupta; Anjum,24,16,76,52
1656080923814,CSE 3,A50,083646,Miranda; Gregory Joseph,20,0,50,30
1656080929839,CSE 8A,A50,083650,Miranda; Gregory Joseph,13,11,56,43
1656080935866,CSE 11,A01,083080,Cao; Yingjun,1,60,40,39
1656080941890,CSE 12,A01,083652,Krause-Levy; Sophia Louisa,14,7,120,106
1656080947916,CSE 15L,A01,083654,Morris; Justin Loren,5,1,50,45
1656080947916,CSE 15L,A02,083655,Morris; Justin Loren,7,0,50,43
1656080953940,CSE 20,A01,083657,Tran; Khoa Dang,31,0,80,49
1656080959967,CSE 21,A01,095574,Bach; Quang Tran,28,0,48,20
1656080965989,CSE 30,A01,083084,Eldon; John,3,10,80,77
1656080965989,CSE 30,B01,095061,Bhaskar; Nishant,4,5,50,46
1656080972013,CSE 100,A01,083659,Cao; Yingjun,2,23,70,68
1656080978037,CSE 134B,A01,083661,Powell; Thomas Allan,11,6,100,89
1656080984059,CSE 140,A01,083663,Gungor; Onat,9,0,85,76
1656080990086,CSE 140L,A01,083088,Eldon; John,8,0,100,92
1656080996112,CSE 175,A01,083665,Kumar; Rakesh,2,0,25,23
1656081002140,CSE 190,A00,092507,Dubnov; Shlomo,3,0,20,17
1656081008169,ECE 45,A01,083139,Congero; Spencer William,5,2,75,70
1656081014194,ECE 65,A50,083695,Saad; Andrew S,8,0,30,22
1656081014194,ECE 65,A51,095125,Staff,23,0,26,3
1656081020218,ECE 109,A01,091882,Touri; Behrouz,5,4,70,65
1656081026241,ECE 180,A00,083140,Abi Samra; Nicholas Camill,1,0,30,29
1656081026241,ECE 180,B00,083141,Abi Samra; Nicholas Camill,4,8,30,26
1656081032265,MATH 10A,A01,083735,Patchell; Gregory David,1,0,30,29
1656081032265,MATH 10A,A02,083736,Patchell; Gregory David,23,0,30,7
1656081032265,MATH 10A,A03,083737,Patchell; Gregory David,16,0,30,14
1656081038296,MATH 10B,A01,083207,Lim; Seonhee,3,1,34,31
1656081038296,MATH 10B,A02,083208,Lim; Seonhee,10,1,35,25
1656081038296,MATH 10B,A03,093472,Staff,4,1,34,30
1656081038296,MATH 10B,B01,083739,Sinha; Shubham,12,0,30,18
1656081044323,MATH 18,A01,083743,Cinel; Cameron Alexander,7,0,30,23
1656081044323,MATH 18,A02,083744,Cinel; Cameron Alexander,12,0,30,18
1656081044323,MATH 18,A03,083745,Cinel; Cameron Alexander,3,0,30,27
1656081044323,MATH 18,B01,083748,Ma; Zilu,1,0,36,35
1656081044323,MATH 18,B02,083749,Ma; Zilu,2,0,36,34
1656081044323,MATH 18,B03,083750,Ma; Zilu,0,0,36,36
1656081044323,MATH 18,B04,083751,Ma; Zilu,1,0,36,35
1656081044323,MATH 18,B05,093473,Staff,3,0,36,33
1656081044323,MATH 18,B06,093474,Staff,4,0,36,32
1656081050345,MATH 20A,A01,083754,Zheng; Zequn,11,0,40,29
1656081056375,MATH 20B,A01,083756,Briones; Jor-el Thomas Caparas,0,0,36,36
1656081056375,MATH 20B,A02,083757,Briones; Jor-el Thomas Caparas,2,0,36,34
1656081056375,MATH 20B,A03,093475,Staff,3,0,36,33
1656081062412,MATH 20C,A01,083760,Briones; Jor-el Thomas Caparas,2,2,35,33
1656081062412,MATH 20C,A02,083761,Briones; Jor-el Thomas Caparas,9,1,35,26
1656081062412,MATH 20C,A03,093476,Staff,1,1,35,34
1656081062412,MATH 20C,B01,083762,Bach; Quang Tran,4,0,30,26
1656081068441,MATH 20D,A01,083765,Tran; Brian Kha,3,0,30,27
1656081068441,MATH 20D,A02,083766,Tran; Brian Kha,0,1,30,30
1656081068441,MATH 20D,A03,083767,Tran; Brian Kha,2,0,30,28
1656081074470,MATH 20E,A01,083771,Ganguly; Soumya,4,1,32,28
1656081074470,MATH 20E,A02,083772,Ganguly; Soumya,2,1,32,30
1656081074470,MATH 20E,B01,083773,Ciotti; Benjamin,15,0,35,20
1656081074470,MATH 20E,B02,083774,Ciotti; Benjamin,15,0,35,20
1656081080493,MATH 103A,A01,083777,Greenfeld; Be'Eri,3,0,36,33
1656081080493,MATH 103A,A02,083778,Greenfeld; Be'Eri,3,0,36,33
1656081080493,MATH 103A,A03,093561,Staff,4,1,36,32
1656081080493,MATH 103A,B01,083779,Greenfeld; Be'Eri,8,1,36,28
1656081080493,MATH 103A,B02,083780,Greenfeld; Be'Eri,0,0,36,36
1656081080493,MATH 103A,B03,093562,Staff,1,0,36,35
1656081086516,MATH 105,A01,085443,Carter; Anne Toulson,4,1,35,31
1656081086516,MATH 105,A02,093477,Staff,11,0,35,24
1656081092546,MATH 109,A01,083213,Ganzberger; Geoffrey Michael,1,1,34,33
1656081092546,MATH 109,A02,083214,Ganzberger; Geoffrey Michael,0,0,34,34
1656081092546,MATH 109,A03,093478,Staff,3,0,34,31
1656081092546,MATH 109,B01,083215,Ganzberger; Geoffrey Michael,4,0,32,28
1656081092546,MATH 109,B02,083216,Ganzberger; Geoffrey Michael,1,0,32,31
1656081092546,MATH 109,B03,093479,Staff,4,0,32,28
1656081098585,MATH 142A,A01,083219,Chow; Bennett,2,0,32,30
1656081098585,MATH 142A,A02,083220,Chow; Bennett,8,0,32,24
1656081098585,MATH 142A,A03,093480,Staff,5,0,32,27
1656081098585,MATH 142A,B03,093481,Staff,4,0,32,28
1656081098585,MATH 142A,B04,093558,Staff,7,0,32,25
1656081098585,MATH 142A,B05,093559,Staff,0,0,32,32
1656081104612,MATH 193A,A01,083224,Rotar; Vladimir,1,2,34,33
1656081104612,MATH 193A,A02,083225,Rotar; Vladimir,3,0,34,31
1656081104612,MATH 193A,A03,083781,Rotar; Vladimir,3,0,34,31
1656081104612,MATH 193A,A04,083782,Rotar; Vladimir,7,0,34,27
1656081104612,MATH 193A,A05,093482,Rotar; Vladimir,1,0,34,33
1656081110640,MATH 197,001,091859,McAuley; Julian John,9999,0,9999,0
1656081110640,MATH 197,002,095566,Kedlaya; Kiran S.,9997,0,9999,2
1656081110640,MATH 197,003,095567,Xiao; Ming,9999,0,9999,0
1656081110640,MATH 197,004,095571,Perols; Johan Lars,9998,0,9999,1
1656081117704,COGS 9,A01,083615,Shannon; Kyle Michael,4,1,75,71
1656081123729,COGS 11,A01,083617,Boyle; Mary E. T.,16,1,48,32
1656081129751,COGS 13,A01,083071,Bastos; Amalia Pinkusfeld,8,2,71,63
1656081135773,COGS 14A,A01,092681,Semenuks; Arturs,8,23,100,92
1656081141803,COGS 14B,A01,083073,Cheng; Tzu-Han,9,0,63,54
1656081147830,COGS 17,A01,092677,Semenuks; Arturs,13,6,81,68
1656081153855,COGS 100,A01,083619,Allen; Michael Gordon,8,1,70,62
1656081159882,COGS 101A,A01,083621,Davis; Joshua Daniel,7,3,68,61
1656081165906,COGS 101B,A01,091572,Allen; Michael Gordon,7,0,65,58
1656081171935,COGS 101C,A01,083625,Delgado; Tania,11,0,35,24
1656081177961,COGS 107A,A01,083627,Boyle; Mary E. T.,5,2,60,55
1656081183988,COGS 118A,A01,083075,Gupta; Anjum,24,16,76,52
1656081190015,CSE 3,A50,083646,Miranda; Gregory Joseph,20,0,50,30
1656081196054,CSE 8A,A50,083650,Miranda; Gregory Joseph,13,11,56,43
1656081202148,CSE 11,A01,083080,Cao; Yingjun,1,60,40,39
1656081208183,CSE 12,A01,083652,Krause-Levy; Sophia Louisa,14,7,120,106
1656081214209,CSE 15L,A01,083654,Morris; Justin Loren,5,1,50,45
1656081214209,CSE 15L,A02,083655,Morris; Justin Loren,7,0,50,43
1656081220235,CSE 20,A01,083657,Tran; Khoa Dang,31,0,80,49
1656081226259,CSE 21,A01,095574,Bach; Quang Tran,28,0,48,20
1656081232286,CSE 30,A01,083084,Eldon; John,3,10,80,77
1656081232286,CSE 30,B01,095061,Bhaskar; Nishant,4,5,50,46
1656081238310,CSE 100,A01,083659,Cao; Yingjun,2,23,70,68
1656081244334,CSE 134B,A01,083661,Powell; Thomas Allan,11,6,100,89
1656081250357,CSE 140,A01,083663,Gungor; Onat,9,0,85,76
1656081256382,CSE 140L,A01,083088,Eldon; John,8,0,100,92
1656081262408,CSE 175,A01,083665,Kumar; Rakesh,2,0,25,23
1656081268430,CSE 190,A00,092507,Dubnov; Shlomo,3,0,20,17
1656081274460,ECE 45,A01,083139,Congero; Spencer William,5,2,75,70
1656081280485,ECE 65,A50,083695,Saad; Andrew S,8,0,30,22
1656081280485,ECE 65,A51,095125,Staff,23,0,26,3
1656081286510,ECE 109,A01,091882,Touri; Behrouz,5,4,70,65
1656081292543,ECE 180,A00,083140,Abi Samra; Nicholas Camill,1,0,30,29
1656081292543,ECE 180,B00,083141,Abi Samra; Nicholas Camill,4,8,30,26
1656081298568,MATH 10A,A01,083735,Patchell; Gregory David,1,0,30,29
1656081298568,MATH 10A,A02,083736,Patchell; Gregory David,23,0,30,7
1656081298568,MATH 10A,A03,083737,Patchell; Gregory David,16,0,30,14
1656081304597,MATH 10B,A01,083207,Lim; Seonhee,3,1,34,31
1656081304597,MATH 10B,A02,083208,Lim; Seonhee,10,1,35,25
1656081304597,MATH 10B,A03,093472,Staff,4,1,34,30
1656081304597,MATH 10B,B01,083739,Sinha; Shubham,12,0,30,18
1656081310628,MATH 18,A01,083743,Cinel; Cameron Alexander,7,0,30,23
1656081310628,MATH 18,A02,083744,Cinel; Cameron Alexander,12,0,30,18
1656081310628,MATH 18,A03,083745,Cinel; Cameron Alexander,3,0,30,27
1656081310628,MATH 18,B01,083748,Ma; Zilu,1,0,36,35
1656081310628,MATH 18,B02,083749,Ma; Zilu,2,0,36,34
1656081310628,MATH 18,B03,083750,Ma; Zilu,0,0,36,36
1656081310628,MATH 18,B04,083751,Ma; Zilu,1,0,36,35
1656081310628,MATH 18,B05,093473,Staff,3,0,36,33
1656081310628,MATH 18,B06,093474,Staff,4,0,36,32
1656081316650,MATH 20A,A01,083754,Zheng; Zequn,11,0,40,29
1656081322677,MATH 20B,A01,083756,Briones; Jor-el Thomas Caparas,0,0,36,36
1656081322677,MATH 20B,A02,083757,Briones; Jor-el Thomas Caparas,2,0,36,34
1656081322677,MATH 20B,A03,093475,Staff,3,0,36,33
1656081328700,MATH 20C,A01,083760,Briones; Jor-el Thomas Caparas,2,2,35,33
1656081328700,MATH 20C,A02,083761,Briones; Jor-el Thomas Caparas,9,1,35,26
1656081328700,MATH 20C,A03,093476,Staff,1,1,35,34
1656081328700,MATH 20C,B01,083762,Bach; Quang Tran,4,0,30,26
1656081334724,MATH 20D,A01,083765,Tran; Brian Kha,3,0,30,27
1656081334724,MATH 20D,A02,083766,Tran; Brian Kha,0,1,30,30
1656081334724,MATH 20D,A03,083767,Tran; Brian Kha,2,0,30,28
1656081340753,MATH 20E,A01,083771,Ganguly; Soumya,4,1,32,28
1656081340753,MATH 20E,A02,083772,Ganguly; Soumya,2,1,32,30
1656081340753,MATH 20E,B01,083773,Ciotti; Benjamin,15,0,35,20
1656081340753,MATH 20E,B02,083774,Ciotti; Benjamin,15,0,35,20
1656081346794,MATH 103A,A01,083777,Greenfeld; Be'Eri,3,0,36,33
1656081346794,MATH 103A,A02,083778,Greenfeld; Be'Eri,3,0,36,33
1656081346794,MATH 103A,A03,093561,Staff,4,1,36,32
1656081346794,MATH 103A,B01,083779,Greenfeld; Be'Eri,8,1,36,28
1656081346794,MATH 103A,B02,083780,Greenfeld; Be'Eri,0,0,36,36
1656081346794,MATH 103A,B03,093562,Staff,1,0,36,35
1656081352826,MATH 105,A01,085443,Carter; Anne Toulson,4,1,35,31
1656081352826,MATH 105,A02,093477,Staff,11,0,35,24
1656081358850,MATH 109,A01,083213,Ganzberger; Geoffrey Michael,1,1,34,33
1656081358850,MATH 109,A02,083214,Ganzberger; Geoffrey Michael,0,0,34,34
1656081358850,MATH 109,A03,093478,Staff,3,0,34,31
1656081358850,MATH 109,B01,083215,Ganzberger; Geoffrey Michael,4,0,32,28
1656081358850,MATH 109,B02,083216,Ganzberger; Geoffrey Michael,1,0,32,31
1656081358850,MATH 109,B03,093479,Staff,4,0,32,28
1656081364882,MATH 142A,A01,083219,Chow; Bennett,2,0,32,30
1656081364882,MATH 142A,A02,083220,Chow; Bennett,8,0,32,24
1656081364882,MATH 142A,A03,093480,Staff,5,0,32,27
1656081364882,MATH 142A,B03,093481,Staff,4,0,32,28
1656081364882,MATH 142A,B04,093558,Staff,7,0,32,25
1656081364882,MATH 142A,B05,093559,Staff,0,0,32,32
1656081370912,MATH 193A,A01,083224,Rotar; Vladimir,1,2,34,33
1656081370912,MATH 193A,A02,083225,Rotar; Vladimir,3,0,34,31
1656081370912,MATH 193A,A03,083781,Rotar; Vladimir,3,0,34,31
1656081370912,MATH 193A,A04,083782,Rotar; Vladimir,7,0,34,27
1656081370912,MATH 193A,A05,093482,Rotar; Vladimir,1,0,34,33
1656081376934,MATH 197,001,091859,McAuley; Julian John,9999,0,9999,0
1656081376934,MATH 197,002,095566,Kedlaya; Kiran S.,9997,0,9999,2
1656081376934,MATH 197,003,095567,Xiao; Ming,9999,0,9999,0
1656081376934,MATH 197,004,095571,Perols; Johan Lars,9998,0,9999,1
1656081384011,COGS 9,A01,083615,Shannon; Kyle Michael,4,1,75,71
1656081390039,COGS 11,A01,083617,Boyle; Mary E. T.,16,1,48,32
1656081396062,COGS 13,A01,083071,Bastos; Amalia Pinkusfeld,8,2,71,63
1656081402090,COGS 14A,A01,092681,Semenuks; Arturs,8,23,100,92
1656081408114,COGS 14B,A01,083073,Cheng; Tzu-Han,9,0,63,54
1656081414149,COGS 17,A01,092677,Semenuks; Arturs,13,6,81,68
1656081420170,COGS 100,A01,083619,Allen; Michael Gordon,8,1,70,62
1656081426204,COGS 101A,A01,083621,Davis; Joshua Daniel,7,3,68,61
1656081432240,COGS 101B,A01,091572,Allen; Michael Gordon,7,0,65,58
1656081438269,COGS 101C,A01,083625,Delgado; Tania,11,0,35,24
1656081444296,COGS 107A,A01,083627,Boyle; Mary E. T.,5,2,60,55
1656081450324,COGS 118A,A01,083075,Gupta; Anjum,24,16,76,52
1656081456349,CSE 3,A50,083646,Miranda; Gregory Joseph,20,0,50,30
1656081462381,CSE 8A,A50,083650,Miranda; Gregory Joseph,13,11,56,43
1656081468409,CSE 11,A01,083080,Cao; Yingjun,1,60,40,39
1656081474432,CSE 12,A01,083652,Krause-Levy; Sophia Louisa,14,7,120,106
1656081480456,CSE 15L,A01,083654,Morris; Justin Loren,5,1,50,45
1656081480456,CSE 15L,A02,083655,Morris; Justin Loren,7,0,50,43
1656081486480,CSE 20,A01,083657,Tran; Khoa Dang,31,0,80,49
1656081492503,CSE 21,A01,095574,Bach; Quang Tran,28,0,48,20
1656081498537,CSE 30,A01,083084,Eldon; John,3,10,80,77
1656081498537,CSE 30,B01,095061,Bhaskar; Nishant,4,5,50,46
1656081504559,CSE 100,A01,083659,Cao; Yingjun,2,23,70,68
1656081510584,CSE 134B,A01,083661,Powell; Thomas Allan,11,6,100,89
1656081516610,CSE 140,A01,083663,Gungor; Onat,9,0,85,76
1656081522636,CSE 140L,A01,083088,Eldon; John,8,0,100,92
1656081528664,CSE 175,A01,083665,Kumar; Rakesh,2,0,25,23
1656081534686,CSE 190,A00,092507,Dubnov; Shlomo,3,0,20,17
1656081540711,ECE 45,A01,083139,Congero; Spencer William,5,2,75,70
1656081546733,ECE 65,A50,083695,Saad; Andrew S,8,0,30,22
1656081546733,ECE 65,A51,095125,Staff,23,0,26,3
1656081552757,ECE 109,A01,091882,Touri; Behrouz,5,4,70,65
1656081558784,ECE 180,A00,083140,Abi Samra; Nicholas Camill,1,0,30,29
1656081558784,ECE 180,B00,083141,Abi Samra; Nicholas Camill,4,8,30,26
1656081564808,MATH 10A,A01,083735,Patchell; Gregory David,1,0,30,29
1656081564808,MATH 10A,A02,083736,Patchell; Gregory David,23,0,30,7
1656081564808,MATH 10A,A03,083737,Patchell; Gregory David,16,0,30,14
1656081570833,MATH 10B,A01,083207,Lim; Seonhee,3,1,34,31
1656081570833,MATH 10B,A02,083208,Lim; Seonhee,10,1,35,25
1656081570833,MATH 10B,A03,093472,Staff,4,1,34,30
1656081570833,MATH 10B,B01,083739,Sinha; Shubham,12,0,30,18
1656081576859,MATH 18,A01,083743,Cinel; Cameron Alexander,7,0,30,23
1656081576859,MATH 18,A02,083744,Cinel; Cameron Alexander,12,0,30,18
1656081576859,MATH 18,A03,083745,Cinel; Cameron Alexander,3,0,30,27
1656081576859,MATH 18,B01,083748,Ma; Zilu,1,0,36,35
1656081576859,MATH 18,B02,083749,Ma; Zilu,2,0,36,34
1656081576859,MATH 18,B03,083750,Ma; Zilu,0,0,36,36
1656081576859,MATH 18,B04,083751,Ma; Zilu,1,0,36,35
1656081576859,MATH 18,B05,093473,Staff,3,0,36,33
1656081576859,MATH 18,B06,093474,Staff,4,0,36,32
1656081582884,MATH 20A,A01,083754,Zheng; Zequn,11,0,40,29
1656081588906,MATH 20B,A01,083756,Briones; Jor-el Thomas Caparas,0,0,36,36
1656081588906,MATH 20B,A02,083757,Briones; Jor-el Thomas Caparas,2,0,36,34
1656081588906,MATH 20B,A03,093475,Staff,3,0,36,33
1656081594931,MATH 20C,A01,083760,Briones; Jor-el Thomas Caparas,2,2,35,33
1656081594931,MATH 20C,A02,083761,Briones; Jor-el Thomas Caparas,9,1,35,26
1656081594931,MATH 20C,A03,093476,Staff,1,1,35,34
1656081594931,MATH 20C,B01,083762,Bach; Quang Tran,4,0,30,26
1656081600954,MATH 20D,A01,083765,Tran; Brian Kha,3,0,30,27
1656081600954,MATH 20D,A02,083766,Tran; Brian Kha,0,1,30,30
1656081600954,MATH 20D,A03,083767,Tran; Brian Kha,2,0,30,28
1656081606997,MATH 20E,A01,083771,Ganguly; Soumya,4,1,32,28
1656081606997,MATH 20E,A02,083772,Ganguly; Soumya,2,1,32,30
1656081606997,MATH 20E,B01,083773,Ciotti; Benjamin,15,0,35,20
1656081606997,MATH 20E,B02,083774,Ciotti; Benjamin,15,0,35,20
1656081613027,MATH 103A,A01,083777,Greenfeld; Be'Eri,3,0,36,33
1656081613027,MATH 103A,A02,083778,Greenfeld; Be'Eri,3,0,36,33
1656081613027,MATH 103A,A03,093561,Staff,4,1,36,32
1656081613027,MATH 103A,B01,083779,Greenfeld; Be'Eri,8,1,36,28
1656081613027,MATH 103A,B02,083780,Greenfeld; Be'Eri,0,0,36,36
1656081613027,MATH 103A,B03,093562,Staff,1,0,36,35
1656081619061,MATH 105,A01,085443,Carter; Anne Toulson,4,1,35,31
1656081619061,MATH 105,A02,093477,Staff,11,0,35,24
1656081625086,MATH 109,A01,083213,Ganzberger; Geoffrey Michael,1,1,34,33
1656081625086,MATH 109,A02,083214,Ganzberger; Geoffrey Michael,0,0,34,34
1656081625086,MATH 109,A03,093478,Staff,3,0,34,31
1656081625086,MATH 109,B01,083215,Ganzberger; Geoffrey Michael,4,0,32,28
1656081625086,MATH 109,B02,083216,Ganzberger; Geoffrey Michael,1,0,32,31
1656081625086,MATH 109,B03,093479,Staff,4,0,32,28
1656081631115,MATH 142A,A01,083219,Chow; Bennett,2,0,32,30
1656081631115,MATH 142A,A02,083220,Chow; Bennett,8,0,32,24
1656081631115,MATH 142A,A03,093480,Staff,5,0,32,27
1656081631115,MATH 142A,B03,093481,Staff,4,0,32,28
1656081631115,MATH 142A,B04,093558,Staff,7,0,32,25
1656081631115,MATH 142A,B05,093559,Staff,0,0,32,32
1656081637146,MATH 193A,A01,083224,Rotar; Vladimir,1,2,34,33
1656081637146,MATH 193A,A02,083225,Rotar; Vladimir,3,0,34,31
1656081637146,MATH 193A,A03,083781,Rotar; Vladimir,3,0,34,31
1656081637146,MATH 193A,A04,083782,Rotar; Vladimir,7,0,34,27
1656081637146,MATH 193A,A05,093482,Rotar; Vladimir,1,0,34,33
1656081643170,MATH 197,001,091859,McAuley; Julian John,9999,0,9999,0
1656081643170,MATH 197,002,095566,Kedlaya; Kiran S.,9997,0,9999,2
1656081643170,MATH 197,003,095567,Xiao; Ming,9999,0,9999,0
1656081643170,MATH 197,004,095571,Perols; Johan Lars,9998,0,9999,1
1656081650230,COGS 9,A01,083615,Shannon; Kyle Michael,4,1,75,71
1656081656251,COGS 11,A01,083617,Boyle; Mary E. T.,16,1,48,32
1656081662284,COGS 13,A01,083071,Bastos; Amalia Pinkusfeld,8,2,71,63
1656081668311,COGS 14A,A01,092681,Semenuks; Arturs,8,23,100,92
1656081674337,COGS 14B,A01,083073,Cheng; Tzu-Han,9,0,63,54
1656081680360,COGS 17,A01,092677,Semenuks; Arturs,13,6,81,68
1656081686389,COGS 100,A01,083619,Allen; Michael Gordon,8,1,70,62
1656081692416,COGS 101A,A01,083621,Davis; Joshua Daniel,7,3,68,61
1656081698441,COGS 101B,A01,091572,Allen; Michael Gordon,7,0,65,58
1656081704465,COGS 101C,A01,083625,Delgado; Tania,11,0,35,24
1656081710489,COGS 107A,A01,083627,Boyle; Mary E. T.,5,2,60,55
1656081716512,COGS 118A,A01,083075,Gupta; Anjum,24,16,76,52
1656081722536,CSE 3,A50,083646,Miranda; Gregory Joseph,20,0,50,30
1656081728561,CSE 8A,A50,083650,Miranda; Gregory Joseph,13,11,56,43
1656081734586,CSE 11,A01,083080,Cao; Yingjun,1,60,40,39
1656081740609,CSE 12,A01,083652,Krause-Levy; Sophia Louisa,14,7,120,106
1656081746633,CSE 15L,A01,083654,Morris; Justin Loren,5,1,50,45
1656081746633,CSE 15L,A02,083655,Morris; Justin Loren,7,0,50,43
1656081752668,CSE 20,A01,083657,Tran; Khoa Dang,31,0,80,49
1656081758692,CSE 21,A01,095574,Bach; Quang Tran,28,0,48,20
1656081764717,CSE 30,A01,083084,Eldon; John,3,10,80,77
1656081764717,CSE 30,B01,095061,Bhaskar; Nishant,4,5,50,46
1656081770741,CSE 100,A01,083659,Cao; Yingjun,2,23,70,68
1656081776766,CSE 134B,A01,083661,Powell; Thomas Allan,11,6,100,89
1656081782790,CSE 140,A01,083663,Gungor; Onat,9,0,85,76
1656081788818,CSE 140L,A01,083088,Eldon; John,8,0,100,92
1656081794841,CSE 175,A01,083665,Kumar; Rakesh,2,0,25,23
1656081800959,CSE 190,A00,092507,Dubnov; Shlomo,3,0,20,17
1656081806983,ECE 45,A01,083139,Congero; Spencer William,5,2,75,70
1656081813008,ECE 65,A50,083695,Saad; Andrew S,8,0,30,22
1656081813008,ECE 65,A51,095125,Staff,23,0,26,3
1656081819031,ECE 109,A01,091882,Touri; Behrouz,5,4,70,65
1656081825068,ECE 180,A00,083140,Abi Samra; Nicholas Camill,1,0,30,29
1656081825068,ECE 180,B00,083141,Abi Samra; Nicholas Camill,4,8,30,26
1656081831103,MATH 10A,A01,083735,Patchell; Gregory David,1,0,30,29
1656081831103,MATH 10A,A02,083736,Patchell; Gregory David,23,0,30,7
1656081831103,MATH 10A,A03,083737,Patchell; Gregory David,16,0,30,14
1656081837132,MATH 10B,A01,083207,Lim; Seonhee,3,1,34,31
1656081837132,MATH 10B,A02,083208,Lim; Seonhee,10,1,35,25
1656081837132,MATH 10B,A03,093472,Staff,4,1,34,30
1656081837132,MATH 10B,B01,083739,Sinha; Shubham,12,0,30,18
1656081843165,MATH 18,A01,083743,Cinel; Cameron Alexander,7,0,30,23
1656081843165,MATH 18,A02,083744,Cinel; Cameron Alexander,12,0,30,18
1656081843165,MATH 18,A03,083745,Cinel; Cameron Alexander,3,0,30,27
1656081843165,MATH 18,B01,083748,Ma; Zilu,1,0,36,35
1656081843165,MATH 18,B02,083749,Ma; Zilu,2,0,36,34
1656081843165,MATH 18,B03,083750,Ma; Zilu,0,0,36,36
1656081843165,MATH 18,B04,083751,Ma; Zilu,1,0,36,35
1656081843165,MATH 18,B05,093473,Staff,3,0,36,33
1656081843165,MATH 18,B06,093474,Staff,4,0,36,32
1656081849190,MATH 20A,A01,083754,Zheng; Zequn,11,0,40,29
1656081855215,MATH 20B,A01,083756,Briones; Jor-el Thomas Caparas,0,0,36,36
1656081855215,MATH 20B,A02,083757,Briones; Jor-el Thomas Caparas,2,0,36,34
1656081855215,MATH 20B,A03,093475,Staff,3,0,36,33
1656081861241,MATH 20C,A01,083760,Briones; Jor-el Thomas Caparas,2,2,35,33
1656081861241,MATH 20C,A02,083761,Briones; Jor-el Thomas Caparas,9,1,35,26
1656081861241,MATH 20C,A03,093476,Staff,1,1,35,34
1656081861241,MATH 20C,B01,083762,Bach; Quang Tran,4,0,30,26
1656081867268,MATH 20D,A01,083765,Tran; Brian Kha,3,0,30,27
1656081867268,MATH 20D,A02,083766,Tran; Brian Kha,0,1,30,30
1656081867268,MATH 20D,A03,083767,Tran; Brian Kha,2,0,30,28
1656081873296,MATH 20E,A01,083771,Ganguly; Soumya,4,1,32,28
1656081873296,MATH 20E,A02,083772,Ganguly; Soumya,2,1,32,30
1656081873296,MATH 20E,B01,083773,Ciotti; Benjamin,15,0,35,20
1656081873296,MATH 20E,B02,083774,Ciotti; Benjamin,15,0,35,20
1656081879329,MATH 103A,A01,083777,Greenfeld; Be'Eri,3,0,36,33
1656081879329,MATH 103A,A02,083778,Greenfeld; Be'Eri,3,0,36,33
1656081879329,MATH 103A,A03,093561,Staff,4,1,36,32
1656081879329,MATH 103A,B01,083779,Greenfeld; Be'Eri,8,1,36,28
1656081879329,MATH 103A,B02,083780,Greenfeld; Be'Eri,0,0,36,36
1656081879329,MATH 103A,B03,093562,Staff,1,0,36,35
1656081885371,MATH 105,A01,085443,Carter; Anne Toulson,4,1,35,31
1656081885371,MATH 105,A02,093477,Staff,11,0,35,24
1656081891398,MATH 109,A01,083213,Ganzberger; Geoffrey Michael,1,1,34,33
1656081891398,MATH 109,A02,083214,Ganzberger; Geoffrey Michael,0,0,34,34
1656081891398,MATH 109,A03,093478,Staff,3,0,34,31
1656081891398,MATH 109,B01,083215,Ganzberger; Geoffrey Michael,4,0,32,28
1656081891398,MATH 109,B02,083216,Ganzberger; Geoffrey Michael,1,0,32,31
1656081891398,MATH 109,B03,093479,Staff,4,0,32,28
1656081897423,MATH 142A,A01,083219,Chow; Bennett,2,0,32,30
1656081897423,MATH 142A,A02,083220,Chow; Bennett,8,0,32,24
1656081897423,MATH 142A,A03,093480,Staff,5,0,32,27
1656081897423,MATH 142A,B03,093481,Staff,4,0,32,28
1656081897423,MATH 142A,B04,093558,Staff,7,0,32,25
1656081897423,MATH 142A,B05,093559,Staff,0,0,32,32
1656081903460,MATH 193A,A01,083224,Rotar; Vladimir,1,2,34,33
1656081903460,MATH 193A,A02,083225,Rotar; Vladimir,3,0,34,31
1656081903460,MATH 193A,A03,083781,Rotar; Vladimir,3,0,34,31
1656081903460,MATH 193A,A04,083782,Rotar; Vladimir,7,0,34,27
1656081903460,MATH 193A,A05,093482,Rotar; Vladimir,1,0,34,33
1656081909483,MATH 197,001,091859,McAuley; Julian John,9999,0,9999,0
1656081909483,MATH 197,002,095566,Kedlaya; Kiran S.,9997,0,9999,2
1656081909483,MATH 197,003,095567,Xiao; Ming,9999,0,9999,0
1656081909483,MATH 197,004,095571,Perols; Johan Lars,9998,0,9999,1
1656081916557,COGS 9,A01,083615,Shannon; Kyle Michael,4,1,75,71
1656081922583,COGS 11,A01,083617,Boyle; Mary E. T.,16,1,48,32
1656081928607,COGS 13,A01,083071,Bastos; Amalia Pinkusfeld,8,2,71,63
1656081934634,COGS 14A,A01,092681,Semenuks; Arturs,8,23,100,92
1656081940659,COGS 14B,A01,083073,Cheng; Tzu-Han,9,0,63,54
1656081946684,COGS 17,A01,092677,Semenuks; Arturs,13,6,81,68
1656081952711,COGS 100,A01,083619,Allen; Michael Gordon,8,1,70,62
1656081958736,COGS 101A,A01,083621,Davis; Joshua Daniel,7,3,68,61
1656081964761,COGS 101B,A01,091572,Allen; Michael Gordon,7,0,65,58
1656081970786,COGS 101C,A01,083625,Delgado; Tania,11,0,35,24
1656081976817,COGS 107A,A01,083627,Boyle; Mary E. T.,5,2,60,55
1656081982845,COGS 118A,A01,083075,Gupta; Anjum,24,16,76,52
1656081988871,CSE 3,A50,083646,Miranda; Gregory Joseph,20,0,50,30
1656081994899,CSE 8A,A50,083650,Miranda; Gregory Joseph,13,11,56,43
1656082000923,CSE 11,A01,083080,Cao; Yingjun,1,60,40,39
1656082006946,CSE 12,A01,083652,Krause-Levy; Sophia Louisa,14,7,120,106
1656082012970,CSE 15L,A01,083654,Morris; Justin Loren,5,1,50,45
1656082012970,CSE 15L,A02,083655,Morris; Justin Loren,7,0,50,43
1656082018993,CSE 20,A01,083657,Tran; Khoa Dang,31,0,80,49
1656082025029,CSE 21,A01,095574,Bach; Quang Tran,28,0,48,20
1656082031058,CSE 30,A01,083084,Eldon; John,3,10,80,77
1656082031058,CSE 30,B01,095061,Bhaskar; Nishant,4,5,50,46
1656082037085,CSE 100,A01,083659,Cao; Yingjun,2,23,70,68
1656082043119,CSE 134B,A01,083661,Powell; Thomas Allan,11,6,100,89
1656082049146,CSE 140,A01,083663,Gungor; Onat,9,0,85,76
1656082055174,CSE 140L,A01,083088,Eldon; John,8,0,100,92
1656082061197,CSE 175,A01,083665,Kumar; Rakesh,2,0,25,23
1656082067223,CSE 190,A00,092507,Dubnov; Shlomo,3,0,20,17
1656082073250,ECE 45,A01,083139,Congero; Spencer William,5,2,75,70
1656082079275,ECE 65,A50,083695,Saad; Andrew S,8,0,30,22
1656082079275,ECE 65,A51,095125,Staff,23,0,26,3
1656082085303,ECE 109,A01,091882,Touri; Behrouz,5,4,70,65
1656082091327,ECE 180,A00,083140,Abi Samra; Nicholas Camill,1,0,30,29
1656082091327,ECE 180,B00,083141,Abi Samra; Nicholas Camill,4,8,30,26
1656082097352,MATH 10A,A01,083735,Patchell; Gregory David,1,0,30,29
1656082097352,MATH 10A,A02,083736,Patchell; Gregory David,23,0,30,7
1656082097352,MATH 10A,A03,083737,Patchell; Gregory David,16,0,30,14
1656082103382,MATH 10B,A01,083207,Lim; Seonhee,3,1,34,31
1656082103382,MATH 10B,A02,083208,Lim; Seonhee,10,1,35,25
1656082103382,MATH 10B,A03,093472,Staff,4,1,34,30
1656082103382,MATH 10B,B01,083739,Sinha; Shubham,12,0,30,18
1656082109407,MATH 18,A01,083743,Cinel; Cameron Alexander,7,0,30,23
1656082109407,MATH 18,A02,083744,Cinel; Cameron Alexander,12,0,30,18
1656082109407,MATH 18,A03,083745,Cinel; Cameron Alexander,3,0,30,27
1656082109407,MATH 18,B01,083748,Ma; Zilu,1,0,36,35
1656082109407,MATH 18,B02,083749,Ma; Zilu,2,0,36,34
1656082109407,MATH 18,B03,083750,Ma; Zilu,0,0,36,36
1656082109407,MATH 18,B04,083751,Ma; Zilu,1,0,36,35
1656082109407,MATH 18,B05,093473,Staff,3,0,36,33
1656082109407,MATH 18,B06,093474,Staff,4,0,36,32
1656082115431,MATH 20A,A01,083754,Zheng; Zequn,11,0,40,29
1656082121459,MATH 20B,A01,083756,Briones; Jor-el Thomas Caparas,0,0,36,36
1656082121459,MATH 20B,A02,083757,Briones; Jor-el Thomas Caparas,2,0,36,34
1656082121459,MATH 20B,A03,093475,Staff,3,0,36,33
1656082127485,MATH 20C,A01,083760,Briones; Jor-el Thomas Caparas,2,2,35,33
1656082127485,MATH 20C,A02,083761,Briones; Jor-el Thomas Caparas,9,1,35,26
1656082127485,MATH 20C,A03,093476,Staff,1,1,35,34
1656082127485,MATH 20C,B01,083762,Bach; Quang Tran,4,0,30,26
1656082133517,MATH 20D,A01,083765,Tran; Brian Kha,3,0,30,27
1656082133517,MATH 20D,A02,083766,Tran; Brian Kha,0,1,30,30
1656082133517,MATH 20D,A03,083767,Tran; Brian Kha,2,0,30,28
1656082139542,MATH 20E,A01,083771,Ganguly; Soumya,4,1,32,28
1656082139542,MATH 20E,A02,083772,Ganguly; Soumya,2,1,32,30
1656082139542,MATH 20E,B01,083773,Ciotti; Benjamin,15,0,35,20
1656082139542,MATH 20E,B02,083774,Ciotti; Benjamin,15,0,35,20
1656082145568,MATH 103A,A01,083777,Greenfeld; Be'Eri,3,0,36,33
1656082145568,MATH 103A,A02,083778,Greenfeld; Be'Eri,3,0,36,33
1656082145568,MATH 103A,A03,093561,Staff,4,1,36,32
1656082145568,MATH 103A,B01,083779,Greenfeld; Be'Eri,8,1,36,28
1656082145568,MATH 103A,B02,083780,Greenfeld; Be'Eri,0,0,36,36
1656082145568,MATH 103A,B03,093562,Staff,1,0,36,35
1656082151596,MATH 105,A01,085443,Carter; Anne Toulson,4,1,35,31
1656082151596,MATH 105,A02,093477,Staff,11,0,35,24
1656082157621,MATH 109,A01,083213,Ganzberger; Geoffrey Michael,1,1,34,33
1656082157621,MATH 109,A02,083214,Ganzberger; Geoffrey Michael,0,0,34,34
1656082157621,MATH 109,A03,093478,Staff,3,0,34,31
1656082157621,MATH 109,B01,083215,Ganzberger; Geoffrey Michael,4,0,32,28
1656082157621,MATH 109,B02,083216,Ganzberger; Geoffrey Michael,1,0,32,31
1656082157621,MATH 109,B03,093479,Staff,4,0,32,28
1656082163651,MATH 142A,A01,083219,Chow; Bennett,2,0,32,30
1656082163651,MATH 142A,A02,083220,Chow; Bennett,8,0,32,24
1656082163651,MATH 142A,A03,093480,Staff,5,0,32,27
1656082163651,MATH 142A,B03,093481,Staff,4,0,32,28
1656082163651,MATH 142A,B04,093558,Staff,7,0,32,25
1656082163651,MATH 142A,B05,093559,Staff,0,0,32,32
1656082169680,MATH 193A,A01,083224,Rotar; Vladimir,1,2,34,33
1656082169680,MATH 193A,A02,083225,Rotar; Vladimir,3,0,34,31
1656082169680,MATH 193A,A03,083781,Rotar; Vladimir,3,0,34,31
1656082169680,MATH 193A,A04,083782,Rotar; Vladimir,7,0,34,27
1656082169680,MATH 193A,A05,093482,Rotar; Vladimir,1,0,34,33
1656082175702,MATH 197,001,091859,McAuley; Julian John,9999,0,9999,0
1656082175702,MATH 197,002,095566,Kedlaya; Kiran S.,9997,0,9999,2
1656082175702,MATH 197,003,095567,Xiao; Ming,9999,0,9999,0
1656082175702,MATH 197,004,095571,Perols; Johan Lars,9998,0,9999,1
1656082182760,COGS 9,A01,083615,Shannon; Kyle Michael,4,1,75,71
1656082188784,COGS 11,A01,083617,Boyle; Mary E. T.,16,1,48,32
1656082194808,COGS 13,A01,083071,Bastos; Amalia Pinkusfeld,8,2,71,63
1656082200830,COGS 14A,A01,092681,Semenuks; Arturs,8,23,100,92
1656082206854,COGS 14B,A01,083073,Cheng; Tzu-Han,9,0,63,54
1656082212879,COGS 17,A01,092677,Semenuks; Arturs,13,6,81,68
1656082218902,COGS 100,A01,083619,Allen; Michael Gordon,8,1,70,62
1656082224927,COGS 101A,A01,083621,Davis; Joshua Daniel,7,3,68,61
1656082230951,COGS 101B,A01,091572,Allen; Michael Gordon,7,0,65,58
1656082236979,COGS 101C,A01,083625,Delgado; Tania,11,0,35,24
1656082243007,COGS 107A,A01,083627,Boyle; Mary E. T.,5,2,60,55
1656082249030,COGS 118A,A01,083075,Gupta; Anjum,24,16,76,52
1656082255053,CSE 3,A50,083646,Miranda; Gregory Joseph,20,0,50,30
1656082261082,CSE 8A,A50,083650,Miranda; Gregory Joseph,13,11,56,43
1656082267108,CSE 11,A01,083080,Cao; Yingjun,1,60,40,39
1656082273132,CSE 12,A01,083652,Krause-Levy; Sophia Louisa,14,7,120,106
1656082279161,CSE 15L,A01,083654,Morris; Justin Loren,5,1,50,45
1656082279161,CSE 15L,A02,083655,Morris; Justin Loren,7,0,50,43
1656082285186,CSE 20,A01,083657,Tran; Khoa Dang,31,0,80,49
1656082291213,CSE 21,A01,095574,Bach; Quang Tran,28,0,48,20
1656082297235,CSE 30,A01,083084,Eldon; John,3,10,80,77
1656082297235,CSE 30,B01,095061,Bhaskar; Nishant,4,5,50,46
1656082303262,CSE 100,A01,083659,Cao; Yingjun,2,23,70,68
1656082309290,CSE 134B,A01,083661,Powell; Thomas Allan,11,6,100,89
1656082315323,CSE 140,A01,083663,Gungor; Onat,9,0,85,76
1656082321350,CSE 140L,A01,083088,Eldon; John,8,0,100,92
1656082327374,CSE 175,A01,083665,Kumar; Rakesh,2,0,25,23
1656082333398,CSE 190,A00,092507,Dubnov; Shlomo,3,0,20,17
1656082339428,ECE 45,A01,083139,Congero; Spencer William,5,2,75,70
1656082345451,ECE 65,A50,083695,Saad; Andrew S,8,0,30,22
1656082345451,ECE 65,A51,095125,Staff,23,0,26,3
1656082351477,ECE 109,A01,091882,Touri; Behrouz,5,4,70,65
1656082357502,ECE 180,A00,083140,Abi Samra; Nicholas Camill,1,0,30,29
1656082357502,ECE 180,B00,083141,Abi Samra; Nicholas Camill,4,8,30,26
1656082363534,MATH 10A,A01,083735,Patchell; Gregory David,1,0,30,29
1656082363534,MATH 10A,A02,083736,Patchell; Gregory David,23,0,30,7
1656082363534,MATH 10A,A03,083737,Patchell; Gregory David,16,0,30,14
1656082369556,MATH 10B,A01,083207,Lim; Seonhee,3,1,34,31
1656082369556,MATH 10B,A02,083208,Lim; Seonhee,10,1,35,25
1656082369556,MATH 10B,A03,093472,Staff,4,1,34,30
1656082369556,MATH 10B,B01,083739,Sinha; Shubham,12,0,30,18
1656082375582,MATH 18,A01,083743,Cinel; Cameron Alexander,7,0,30,23
1656082375582,MATH 18,A02,083744,Cinel; Cameron Alexander,12,0,30,18
1656082375582,MATH 18,A03,083745,Cinel; Cameron Alexander,3,0,30,27
1656082375582,MATH 18,B01,083748,Ma; Zilu,1,0,36,35
1656082375582,MATH 18,B02,083749,Ma; Zilu,2,0,36,34
1656082375582,MATH 18,B03,083750,Ma; Zilu,0,0,36,36
1656082375582,MATH 18,B04,083751,Ma; Zilu,1,0,36,35
1656082375582,MATH 18,B05,093473,Staff,3,0,36,33
1656082375582,MATH 18,B06,093474,Staff,4,0,36,32
1656082381606,MATH 20A,A01,083754,Zheng; Zequn,11,0,40,29
1656082387637,MATH 20B,A01,083756,Briones; Jor-el Thomas Caparas,0,0,36,36
1656082387637,MATH 20B,A02,083757,Briones; Jor-el Thomas Caparas,2,0,36,34
1656082387637,MATH 20B,A03,093475,Staff,3,0,36,33
1656082393666,MATH 20C,A01,083760,Briones; Jor-el Thomas Caparas,2,2,35,33
1656082393666,MATH 20C,A02,083761,Briones; Jor-el Thomas Caparas,9,1,35,26
1656082393666,MATH 20C,A03,093476,Staff,1,1,35,34
1656082393666,MATH 20C,B01,083762,Bach; Quang Tran,4,0,30,26
1656082399768,MATH 20D,A01,083765,Tran; Brian Kha,3,0,30,27
1656082399768,MATH 20D,A02,083766,Tran; Brian Kha,0,1,30,30
1656082399768,MATH 20D,A03,083767,Tran; Brian Kha,2,0,30,28
1656082405818,MATH 20E,A01,083771,Ganguly; Soumya,4,1,32,28
1656082405818,MATH 20E,A02,083772,Ganguly; Soumya,2,1,32,30
1656082405818,MATH 20E,B01,083773,Ciotti; Benjamin,15,0,35,20
1656082405818,MATH 20E,B02,083774,Ciotti; Benjamin,15,0,35,20
1656082411842,MATH 103A,A01,083777,Greenfeld; Be'Eri,3,0,36,33
1656082411842,MATH 103A,A02,083778,Greenfeld; Be'Eri,3,0,36,33
1656082411842,MATH 103A,A03,093561,Staff,4,1,36,32
1656082411842,MATH 103A,B01,083779,Greenfeld; Be'Eri,8,1,36,28
1656082411842,MATH 103A,B02,083780,Greenfeld; Be'Eri,0,0,36,36
1656082411842,MATH 103A,B03,093562,Staff,1,0,36,35
1656082417868,MATH 105,A01,085443,Carter; Anne Toulson,4,1,35,31
1656082417868,MATH 105,A02,093477,Staff,11,0,35,24
1656082423891,MATH 109,A01,083213,Ganzberger; Geoffrey Michael,1,1,34,33
1656082423891,MATH 109,A02,083214,Ganzberger; Geoffrey Michael,0,0,34,34
1656082423891,MATH 109,A03,093478,Staff,3,0,34,31
1656082423891,MATH 109,B01,083215,Ganzberger; Geoffrey Michael,4,0,32,28
1656082423891,MATH 109,B02,083216,Ganzberger; Geoffrey Michael,1,0,32,31
1656082423891,MATH 109,B03,093479,Staff,4,0,32,28
1656082429922,MATH 142A,A01,083219,Chow; Bennett,2,0,32,30
1656082429922,MATH 142A,A02,083220,Chow; Bennett,8,0,32,24
1656082429922,MATH 142A,A03,093480,Staff,5,0,32,27
1656082429922,MATH 142A,B03,093481,Staff,4,0,32,28
1656082429922,MATH 142A,B04,093558,Staff,7,0,32,25
1656082429922,MATH 142A,B05,093559,Staff,0,0,32,32
1656082435950,MATH 193A,A01,083224,Rotar; Vladimir,1,2,34,33
1656082435950,MATH 193A,A02,083225,Rotar; Vladimir,3,0,34,31
1656082435950,MATH 193A,A03,083781,Rotar; Vladimir,3,0,34,31
1656082435950,MATH 193A,A04,083782,Rotar; Vladimir,7,0,34,27
1656082435950,MATH 193A,A05,093482,Rotar; Vladimir,1,0,34,33
1656082441975,MATH 197,001,091859,McAuley; Julian John,9999,0,9999,0
1656082441975,MATH 197,002,095566,Kedlaya; Kiran S.,9997,0,9999,2
1656082441975,MATH 197,003,095567,Xiao; Ming,9999,0,9999,0
1656082441975,MATH 197,004,095571,Perols; Johan Lars,9998,0,9999,1
1656082449027,COGS 9,A01,083615,Shannon; Kyle Michael,4,1,75,71
1656082455050,COGS 11,A01,083617,Boyle; Mary E. T.,16,1,48,32
1656082461083,COGS 13,A01,083071,Bastos; Amalia Pinkusfeld,8,2,71,63
1656082467115,COGS 14A,A01,092681,Semenuks; Arturs,8,23,100,92
1656082473141,COGS 14B,A01,083073,Cheng; Tzu-Han,9,0,63,54
1656082479165,COGS 17,A01,092677,Semenuks; Arturs,13,6,81,68
1656082485191,COGS 100,A01,083619,Allen; Michael Gordon,8,1,70,62
1656082491215,COGS 101A,A01,083621,Davis; Joshua Daniel,7,3,68,61
1656082497247,COGS 101B,A01,091572,Allen; Michael Gordon,7,0,65,58
1656082503272,COGS 101C,A01,083625,Delgado; Tania,11,0,35,24
1656082509303,COGS 107A,A01,083627,Boyle; Mary E. T.,5,2,60,55
1656082515329,COGS 118A,A01,083075,Gupta; Anjum,24,16,76,52
1656082521353,CSE 3,A50,083646,Miranda; Gregory Joseph,20,0,50,30
1656082527377,CSE 8A,A50,083650,Miranda; Gregory Joseph,13,11,56,43
1656082533404,CSE 11,A01,083080,Cao; Yingjun,1,60,40,39
1656082539428,CSE 12,A01,083652,Krause-Levy; Sophia Louisa,14,7,120,106
1656082545458,CSE 15L,A01,083654,Morris; Justin Loren,5,1,50,45
1656082545458,CSE 15L,A02,083655,Morris; Justin Loren,7,0,50,43
1656082551492,CSE 20,A01,083657,Tran; Khoa Dang,31,0,80,49
1656082557515,CSE 21,A01,095574,Bach; Quang Tran,28,0,48,20
1656082563538,CSE 30,A01,083084,Eldon; John,3,10,80,77
1656082563538,CSE 30,B01,095061,Bhaskar; Nishant,4,5,50,46
1656082569566,CSE 100,A01,083659,Cao; Yingjun,2,23,70,68
1656082575590,CSE 134B,A01,083661,Powell; Thomas Allan,11,6,100,89
1656082581614,CSE 140,A01,083663,Gungor; Onat,9,0,85,76
1656082587643,CSE 140L,A01,083088,Eldon; John,8,0,100,92
1656082593668,CSE 175,A01,083665,Kumar; Rakesh,2,0,25,23
1656082599693,CSE 190,A00,092507,Dubnov; Shlomo,3,0,20,17
1656082605719,ECE 45,A01,083139,Congero; Spencer William,5,2,75,70
1656082611742,ECE 65,A50,083695,Saad; Andrew S,8,0,30,22
1656082611742,ECE 65,A51,095125,Staff,23,0,26,3
1656082617771,ECE 109,A01,091882,Touri; Behrouz,5,4,70,65
1656082623798,ECE 180,A00,083140,Abi Samra; Nicholas Camill,1,0,30,29
1656082623798,ECE 180,B00,083141,Abi Samra; Nicholas Camill,4,8,30,26
1656082629826,MATH 10A,A01,083735,Patchell; Gregory David,1,0,30,29
1656082629826,MATH 10A,A02,083736,Patchell; Gregory David,23,0,30,7
1656082629826,MATH 10A,A03,083737,Patchell; Gregory David,16,0,30,14
1656082635850,MATH 10B,A01,083207,Lim; Seonhee,3,1,34,31
1656082635850,MATH 10B,A02,083208,Lim; Seonhee,10,1,35,25
1656082635850,MATH 10B,A03,093472,Staff,4,1,34,30
1656082635850,MATH 10B,B01,083739,Sinha; Shubham,12,0,30,18
1656082641879,MATH 18,A01,083743,Cinel; Cameron Alexander,7,0,30,23
1656082641879,MATH 18,A02,083744,Cinel; Cameron Alexander,12,0,30,18
1656082641879,MATH 18,A03,083745,Cinel; Cameron Alexander,3,0,30,27
1656082641879,MATH 18,B01,083748,Ma; Zilu,1,0,36,35
1656082641879,MATH 18,B02,083749,Ma; Zilu,2,0,36,34
1656082641879,MATH 18,B03,083750,Ma; Zilu,0,0,36,36
1656082641879,MATH 18,B04,083751,Ma; Zilu,1,0,36,35
1656082641879,MATH 18,B05,093473,Staff,3,0,36,33
1656082641879,MATH 18,B06,093474,Staff,4,0,36,32
1656082647906,MATH 20A,A01,083754,Zheng; Zequn,11,0,40,29
1656082653930,MATH 20B,A01,083756,Briones; Jor-el Thomas Caparas,0,0,36,36
1656082653930,MATH 20B,A02,083757,Briones; Jor-el Thomas Caparas,2,0,36,34
1656082653930,MATH 20B,A03,093475,Staff,3,0,36,33
1656082659971,MATH 20C,A01,083760,Briones; Jor-el Thomas Caparas,2,2,35,33
1656082659971,MATH 20C,A02,083761,Briones; Jor-el Thomas Caparas,9,1,35,26
1656082659971,MATH 20C,A03,093476,Staff,1,1,35,34
1656082659971,MATH 20C,B01,083762,Bach; Quang Tran,4,0,30,26
1656082666000,MATH 20D,A01,083765,Tran; Brian Kha,3,0,30,27
1656082666000,MATH 20D,A02,083766,Tran; Brian Kha,0,1,30,30
1656082666000,MATH 20D,A03,083767,Tran; Brian Kha,2,0,30,28
1656082672028,MATH 20E,A01,083771,Ganguly; Soumya,4,1,32,28
1656082672028,MATH 20E,A02,083772,Ganguly; Soumya,2,1,32,30
1656082672028,MATH 20E,B01,083773,Ciotti; Benjamin,15,0,35,20
1656082672028,MATH 20E,B02,083774,Ciotti; Benjamin,15,0,35,20
1656082678059,MATH 103A,A01,083777,Greenfeld; Be'Eri,3,0,36,33
1656082678059,MATH 103A,A02,083778,Greenfeld; Be'Eri,3,0,36,33
1656082678059,MATH 103A,A03,093561,Staff,4,1,36,32
1656082678059,MATH 103A,B01,083779,Greenfeld; Be'Eri,8,1,36,28
1656082678059,MATH 103A,B02,083780,Greenfeld; Be'Eri,0,0,36,36
1656082678059,MATH 103A,B03,093562,Staff,1,0,36,35
1656082684087,MATH 105,A01,085443,Carter; Anne Toulson,4,1,35,31
1656082684087,MATH 105,A02,093477,Staff,11,0,35,24
1656082690111,MATH 109,A01,083213,Ganzberger; Geoffrey Michael,1,1,34,33
1656082690111,MATH 109,A02,083214,Ganzberger; Geoffrey Michael,0,0,34,34
1656082690111,MATH 109,A03,093478,Staff,3,0,34,31
1656082690111,MATH 109,B01,083215,Ganzberger; Geoffrey Michael,4,0,32,28
1656082690111,MATH 109,B02,083216,Ganzberger; Geoffrey Michael,1,0,32,31
1656082690111,MATH 109,B03,093479,Staff,4,0,32,28
1656082696145,MATH 142A,A01,083219,Chow; Bennett,2,0,32,30
1656082696145,MATH 142A,A02,083220,Chow; Bennett,8,0,32,24
1656082696145,MATH 142A,A03,093480,Staff,5,0,32,27
1656082696145,MATH 142A,B03,093481,Staff,4,0,32,28
1656082696145,MATH 142A,B04,093558,Staff,7,0,32,25
1656082696145,MATH 142A,B05,093559,Staff,0,0,32,32
1656082702169,MATH 193A,A01,083224,Rotar; Vladimir,1,2,34,33
1656082702169,MATH 193A,A02,083225,Rotar; Vladimir,3,0,34,31
1656082702169,MATH 193A,A03,083781,Rotar; Vladimir,3,0,34,31
1656082702169,MATH 193A,A04,083782,Rotar; Vladimir,7,0,34,27
1656082702169,MATH 193A,A05,093482,Rotar; Vladimir,1,0,34,33
1656082708199,MATH 197,001,091859,McAuley; Julian John,9999,0,9999,0
1656082708199,MATH 197,002,095566,Kedlaya; Kiran S.,9997,0,9999,2
1656082708199,MATH 197,003,095567,Xiao; Ming,9999,0,9999,0
1656082708199,MATH 197,004,095571,Perols; Johan Lars,9998,0,9999,1
1656082715255,COGS 9,A01,083615,Shannon; Kyle Michael,4,1,75,71
1656082721279,COGS 11,A01,083617,Boyle; Mary E. T.,16,1,48,32
1656082727301,COGS 13,A01,083071,Bastos; Amalia Pinkusfeld,8,2,71,63
1656082733323,COGS 14A,A01,092681,Semenuks; Arturs,8,23,100,92
1656082739348,COGS 14B,A01,083073,Cheng; Tzu-Han,9,0,63,54
1656082745376,COGS 17,A01,092677,Semenuks; Arturs,13,6,81,68
1656082751403,COGS 100,A01,083619,Allen; Michael Gordon,8,1,70,62
1656082757434,COGS 101A,A01,083621,Davis; Joshua Daniel,7,3,68,61
1656082763472,COGS 101B,A01,091572,Allen; Michael Gordon,7,0,65,58
1656082769496,COGS 101C,A01,083625,Delgado; Tania,11,0,35,24
1656082775520,COGS 107A,A01,083627,Boyle; Mary E. T.,5,2,60,55
1656082781547,COGS 118A,A01,083075,Gupta; Anjum,24,16,76,52
1656082787576,CSE 3,A50,083646,Miranda; Gregory Joseph,20,0,50,30
1656082793604,CSE 8A,A50,083650,Miranda; Gregory Joseph,13,11,56,43
1656082799634,CSE 11,A01,083080,Cao; Yingjun,1,60,40,39
1656082805657,CSE 12,A01,083652,Krause-Levy; Sophia Louisa,14,7,120,106
1656082811686,CSE 15L,A01,083654,Morris; Justin Loren,5,1,50,45
1656082811686,CSE 15L,A02,083655,Morris; Justin Loren,7,0,50,43
1656082817708,CSE 20,A01,083657,Tran; Khoa Dang,31,0,80,49
1656082823735,CSE 21,A01,095574,Bach; Quang Tran,28,0,48,20
1656082829763,CSE 30,A01,083084,Eldon; John,3,10,80,77
1656082829763,CSE 30,B01,095061,Bhaskar; Nishant,4,5,50,46
1656082835790,CSE 100,A01,083659,Cao; Yingjun,2,23,70,68
1656082841819,CSE 134B,A01,083661,Powell; Thomas Allan,11,6,100,89
1656082847848,CSE 140,A01,083663,Gungor; Onat,9,0,85,76
1656082853874,CSE 140L,A01,083088,Eldon; John,8,0,100,92
1656082859897,CSE 175,A01,083665,Kumar; Rakesh,2,0,25,23
1656082865922,CSE 190,A00,092507,Dubnov; Shlomo,3,0,20,17
1656082871946,ECE 45,A01,083139,Congero; Spencer William,5,2,75,70
1656082877971,ECE 65,A50,083695,Saad; Andrew S,8,0,30,22
1656082877971,ECE 65,A51,095125,Staff,23,0,26,3
1656082884001,ECE 109,A01,091882,Touri; Behrouz,5,4,70,65
1656082890028,ECE 180,A00,083140,Abi Samra; Nicholas Camill,1,0,30,29
1656082890028,ECE 180,B00,083141,Abi Samra; Nicholas Camill,4,8,30,26
1656082896055,MATH 10A,A01,083735,Patchell; Gregory David,1,0,30,29
1656082896055,MATH 10A,A02,083736,Patchell; Gregory David,23,0,30,7
1656082896055,MATH 10A,A03,083737,Patchell; Gregory David,16,0,30,14
1656082902086,MATH 10B,A01,083207,Lim; Seonhee,3,1,34,31
1656082902086,MATH 10B,A02,083208,Lim; Seonhee,10,1,35,25
1656082902086,MATH 10B,A03,093472,Staff,4,1,34,30
1656082902086,MATH 10B,B01,083739,Sinha; Shubham,12,0,30,18
1656082908117,MATH 18,A01,083743,Cinel; Cameron Alexander,7,0,30,23
1656082908117,MATH 18,A02,083744,Cinel; Cameron Alexander,12,0,30,18
1656082908117,MATH 18,A03,083745,Cinel; Cameron Alexander,3,0,30,27
1656082908117,MATH 18,B01,083748,Ma; Zilu,1,0,36,35
1656082908117,MATH 18,B02,083749,Ma; Zilu,2,0,36,34
1656082908117,MATH 18,B03,083750,Ma; Zilu,0,0,36,36
1656082908117,MATH 18,B04,083751,Ma; Zilu,1,0,36,35
1656082908117,MATH 18,B05,093473,Staff,3,0,36,33
1656082908117,MATH 18,B06,093474,Staff,4,0,36,32
1656082914146,MATH 20A,A01,083754,Zheng; Zequn,11,0,40,29
1656082920178,MATH 20B,A01,083756,Briones; Jor-el Thomas Caparas,0,0,36,36
1656082920178,MATH 20B,A02,083757,Briones; Jor-el Thomas Caparas,2,0,36,34
1656082920178,MATH 20B,A03,093475,Staff,3,0,36,33
1656082926211,MATH 20C,A01,083760,Briones; Jor-el Thomas Caparas,2,2,35,33
1656082926211,MATH 20C,A02,083761,Briones; Jor-el Thomas Caparas,9,1,35,26
1656082926211,MATH 20C,A03,093476,Staff,1,1,35,34
1656082926211,MATH 20C,B01,083762,Bach; Quang Tran,4,0,30,26
1656082932239,MATH 20D,A01,083765,Tran; Brian Kha,3,0,30,27
1656082932239,MATH 20D,A02,083766,Tran; Brian Kha,0,1,30,30
1656082932239,MATH 20D,A03,083767,Tran; Brian Kha,2,0,30,28
1656082938262,MATH 20E,A01,083771,Ganguly; Soumya,4,1,32,28
1656082938262,MATH 20E,A02,083772,Ganguly; Soumya,2,1,32,30
1656082938262,MATH 20E,B01,083773,Ciotti; Benjamin,15,0,35,20
1656082938262,MATH 20E,B02,083774,Ciotti; Benjamin,15,0,35,20
1656082944291,MATH 103A,A01,083777,Greenfeld; Be'Eri,3,0,36,33
1656082944291,MATH 103A,A02,083778,Greenfeld; Be'Eri,3,0,36,33
1656082944291,MATH 103A,A03,093561,Staff,4,1,36,32
1656082944291,MATH 103A,B01,083779,Greenfeld; Be'Eri,8,1,36,28
1656082944291,MATH 103A,B02,083780,Greenfeld; Be'Eri,0,0,36,36
1656082944291,MATH 103A,B03,093562,Staff,1,0,36,35
1656082950317,MATH 105,A01,085443,Carter; Anne Toulson,4,1,35,31
1656082950317,MATH 105,A02,093477,Staff,11,0,35,24
1656082956350,MATH 109,A01,083213,Ganzberger; Geoffrey Michael,1,1,34,33
1656082956350,MATH 109,A02,083214,Ganzberger; Geoffrey Michael,0,0,34,34
1656082956350,MATH 109,A03,093478,Staff,3,0,34,31
1656082956350,MATH 109,B01,083215,Ganzberger; Geoffrey Michael,4,0,32,28
1656082956350,MATH 109,B02,083216,Ganzberger; Geoffrey Michael,1,0,32,31
1656082956350,MATH 109,B03,093479,Staff,4,0,32,28
1656082962374,MATH 142A,A01,083219,Chow; Bennett,2,0,32,30
1656082962374,MATH 142A,A02,083220,Chow; Bennett,8,0,32,24
1656082962374,MATH 142A,A03,093480,Staff,5,0,32,27
1656082962374,MATH 142A,B03,093481,Staff,4,0,32,28
1656082962374,MATH 142A,B04,093558,Staff,7,0,32,25
1656082962374,MATH 142A,B05,093559,Staff,0,0,32,32
1656082968408,MATH 193A,A01,083224,Rotar; Vladimir,1,2,34,33
1656082968408,MATH 193A,A02,083225,Rotar; Vladimir,3,0,34,31
1656082968408,MATH 193A,A03,083781,Rotar; Vladimir,3,0,34,31
1656082968408,MATH 193A,A04,083782,Rotar; Vladimir,7,0,34,27
1656082968408,MATH 193A,A05,093482,Rotar; Vladimir,1,0,34,33
1656082974431,MATH 197,001,091859,McAuley; Julian John,9999,0,9999,0
1656082974431,MATH 197,002,095566,Kedlaya; Kiran S.,9997,0,9999,2
1656082974431,MATH 197,003,095567,Xiao; Ming,9999,0,9999,0
1656082974431,MATH 197,004,095571,Perols; Johan Lars,9998,0,9999,1
1656082981504,COGS 9,A01,083615,Shannon; Kyle Michael,4,1,75,71
1656082987535,COGS 11,A01,083617,Boyle; Mary E. T.,16,1,48,32
1656082993632,COGS 13,A01,083071,Bastos; Amalia Pinkusfeld,8,2,71,63
1656082999657,COGS 14A,A01,092681,Semenuks; Arturs,8,23,100,92
1656083005681,COGS 14B,A01,083073,Cheng; Tzu-Han,9,0,63,54
1656083011709,COGS 17,A01,092677,Semenuks; Arturs,13,6,81,68
1656083017746,COGS 100,A01,083619,Allen; Michael Gordon,8,1,70,62
1656083023775,COGS 101A,A01,083621,Davis; Joshua Daniel,7,3,68,61
1656083029803,COGS 101B,A01,091572,Allen; Michael Gordon,7,0,65,58
1656083035829,COGS 101C,A01,083625,Delgado; Tania,11,0,35,24
1656083041852,COGS 107A,A01,083627,Boyle; Mary E. T.,5,2,60,55
1656083047876,COGS 118A,A01,083075,Gupta; Anjum,24,16,76,52
1656083053904,CSE 3,A50,083646,Miranda; Gregory Joseph,20,0,50,30
1656083059936,CSE 8A,A50,083650,Miranda; Gregory Joseph,13,11,56,43
1656083065966,CSE 11,A01,083080,Cao; Yingjun,1,60,40,39
1656083071993,CSE 12,A01,083652,Krause-Levy; Sophia Louisa,14,7,120,106
1656083078017,CSE 15L,A01,083654,Morris; Justin Loren,5,1,50,45
1656083078017,CSE 15L,A02,083655,Morris; Justin Loren,7,0,50,43
1656083084040,CSE 20,A01,083657,Tran; Khoa Dang,31,0,80,49
1656083090072,CSE 21,A01,095574,Bach; Quang Tran,28,0,48,20
1656083096096,CSE 30,A01,083084,Eldon; John,3,10,80,77
1656083096096,CSE 30,B01,095061,Bhaskar; Nishant,4,5,50,46
1656083102119,CSE 100,A01,083659,Cao; Yingjun,2,23,70,68
1656083108146,CSE 134B,A01,083661,Powell; Thomas Allan,11,6,100,89
1656083114170,CSE 140,A01,083663,Gungor; Onat,9,0,85,76
1656083120196,CSE 140L,A01,083088,Eldon; John,8,0,100,92
1656083126224,CSE 175,A01,083665,Kumar; Rakesh,2,0,25,23
1656083132248,CSE 190,A00,092507,Dubnov; Shlomo,3,0,20,17
1656083138274,ECE 45,A01,083139,Congero; Spencer William,5,2,75,70
1656083144309,ECE 65,A50,083695,Saad; Andrew S,8,0,30,22
1656083144309,ECE 65,A51,095125,Staff,23,0,26,3
1656083150335,ECE 109,A01,091882,Touri; Behrouz,5,4,70,65
1656083156360,ECE 180,A00,083140,Abi Samra; Nicholas Camill,1,0,30,29
1656083156360,ECE 180,B00,083141,Abi Samra; Nicholas Camill,4,8,30,26
1656083162384,MATH 10A,A01,083735,Patchell; Gregory David,1,0,30,29
1656083162384,MATH 10A,A02,083736,Patchell; Gregory David,23,0,30,7
1656083162384,MATH 10A,A03,083737,Patchell; Gregory David,16,0,30,14
1656083168411,MATH 10B,A01,083207,Lim; Seonhee,3,1,34,31
1656083168411,MATH 10B,A02,083208,Lim; Seonhee,10,1,35,25
1656083168411,MATH 10B,A03,093472,Staff,4,1,34,30
1656083168411,MATH 10B,B01,083739,Sinha; Shubham,12,0,30,18
1656083174439,MATH 18,A01,083743,Cinel; Cameron Alexander,7,0,30,23
1656083174439,MATH 18,A02,083744,Cinel; Cameron Alexander,12,0,30,18
1656083174439,MATH 18,A03,083745,Cinel; Cameron Alexander,3,0,30,27
1656083174439,MATH 18,B01,083748,Ma; Zilu,1,0,36,35
1656083174439,MATH 18,B02,083749,Ma; Zilu,2,0,36,34
1656083174439,MATH 18,B03,083750,Ma; Zilu,0,0,36,36
1656083174439,MATH 18,B04,083751,Ma; Zilu,1,0,36,35
1656083174439,MATH 18,B05,093473,Staff,3,0,36,33
1656083174439,MATH 18,B06,093474,Staff,4,0,36,32
1656083180469,MATH 20A,A01,083754,Zheng; Zequn,11,0,40,29
1656083186492,MATH 20B,A01,083756,Briones; Jor-el Thomas Caparas,0,0,36,36
1656083186492,MATH 20B,A02,083757,Briones; Jor-el Thomas Caparas,2,0,36,34
1656083186492,MATH 20B,A03,093475,Staff,3,0,36,33
1656083192517,MATH 20C,A01,083760,Briones; Jor-el Thomas Caparas,2,2,35,33
1656083192517,MATH 20C,A02,083761,Briones; Jor-el Thomas Caparas,9,1,35,26
1656083192517,MATH 20C,A03,093476,Staff,1,1,35,34
1656083192517,MATH 20C,B01,083762,Bach; Quang Tran,4,0,30,26
1656083198539,MATH 20D,A01,083765,Tran; Brian Kha,3,0,30,27
1656083198539,MATH 20D,A02,083766,Tran; Brian Kha,0,1,30,30
1656083198539,MATH 20D,A03,083767,Tran; Brian Kha,2,0,30,28
1656083204570,MATH 20E,A01,083771,Ganguly; Soumya,4,1,32,28
1656083204570,MATH 20E,A02,083772,Ganguly; Soumya,2,1,32,30
1656083204570,MATH 20E,B01,083773,Ciotti; Benjamin,15,0,35,20
1656083204570,MATH 20E,B02,083774,Ciotti; Benjamin,15,0,35,20
1656083210596,MATH 103A,A01,083777,Greenfeld; Be'Eri,3,0,36,33
1656083210596,MATH 103A,A02,083778,Greenfeld; Be'Eri,3,0,36,33
1656083210596,MATH 103A,A03,093561,Staff,4,1,36,32
1656083210596,MATH 103A,B01,083779,Greenfeld; Be'Eri,8,1,36,28
1656083210596,MATH 103A,B02,083780,Greenfeld; Be'Eri,0,0,36,36
1656083210596,MATH 103A,B03,093562,Staff,1,0,36,35
1656083216656,MATH 105,A01,085443,Carter; Anne Toulson,4,1,35,31
1656083216656,MATH 105,A02,093477,Staff,11,0,35,24
1656083222678,MATH 109,A01,083213,Ganzberger; Geoffrey Michael,1,1,34,33
1656083222678,MATH 109,A02,083214,Ganzberger; Geoffrey Michael,0,0,34,34
1656083222678,MATH 109,A03,093478,Staff,3,0,34,31
1656083222678,MATH 109,B01,083215,Ganzberger; Geoffrey Michael,4,0,32,28
1656083222678,MATH 109,B02,083216,Ganzberger; Geoffrey Michael,1,0,32,31
1656083222678,MATH 109,B03,093479,Staff,4,0,32,28
1656083228703,MATH 142A,A01,083219,Chow; Bennett,2,0,32,30
1656083228703,MATH 142A,A02,083220,Chow; Bennett,8,0,32,24
1656083228703,MATH 142A,A03,093480,Staff,5,0,32,27
1656083228703,MATH 142A,B03,093481,Staff,4,0,32,28
1656083228703,MATH 142A,B04,093558,Staff,7,0,32,25
1656083228703,MATH 142A,B05,093559,Staff,0,0,32,32
1656083234732,MATH 193A,A01,083224,Rotar; Vladimir,1,2,34,33
1656083234732,MATH 193A,A02,083225,Rotar; Vladimir,3,0,34,31
1656083234732,MATH 193A,A03,083781,Rotar; Vladimir,3,0,34,31
1656083234732,MATH 193A,A04,083782,Rotar; Vladimir,7,0,34,27
1656083234732,MATH 193A,A05,093482,Rotar; Vladimir,1,0,34,33
1656083240769,MATH 197,001,091859,McAuley; Julian John,9999,0,9999,0
1656083240769,MATH 197,002,095566,Kedlaya; Kiran S.,9997,0,9999,2
1656083240769,MATH 197,003,095567,Xiao; Ming,9999,0,9999,0
1656083240769,MATH 197,004,095571,Perols; Johan Lars,9998,0,9999,1
1656083247837,COGS 9,A01,083615,Shannon; Kyle Michael,4,1,75,71
1656083253861,COGS 11,A01,083617,Boyle; Mary E. T.,16,1,48,32
1656083259888,COGS 13,A01,083071,Bastos; Amalia Pinkusfeld,8,2,71,63
1656083265915,COGS 14A,A01,092681,Semenuks; Arturs,8,23,100,92
1656083271942,COGS 14B,A01,083073,Cheng; Tzu-Han,9,0,63,54
1656083277966,COGS 17,A01,092677,Semenuks; Arturs,13,6,81,68
1656083283993,COGS 100,A01,083619,Allen; Michael Gordon,8,2,70,62
1656083290024,COGS 101A,A01,083621,Davis; Joshua Daniel,7,3,68,61
1656083296046,COGS 101B,A01,091572,Allen; Michael Gordon,7,0,65,58
1656083302073,COGS 101C,A01,083625,Delgado; Tania,11,0,35,24
1656083308096,COGS 107A,A01,083627,Boyle; Mary E. T.,5,2,60,55
1656083314128,COGS 118A,A01,083075,Gupta; Anjum,24,16,76,52
1656083320168,CSE 3,A50,083646,Miranda; Gregory Joseph,20,0,50,30
1656083326196,CSE 8A,A50,083650,Miranda; Gregory Joseph,13,11,56,43
1656083332224,CSE 11,A01,083080,Cao; Yingjun,1,60,40,39
1656083338248,CSE 12,A01,083652,Krause-Levy; Sophia Louisa,14,7,120,106
1656083344269,CSE 15L,A01,083654,Morris; Justin Loren,5,1,50,45
1656083344269,CSE 15L,A02,083655,Morris; Justin Loren,7,0,50,43
1656083350298,CSE 20,A01,083657,Tran; Khoa Dang,31,0,80,49
1656083356322,CSE 21,A01,095574,Bach; Quang Tran,28,0,48,20
1656083362345,CSE 30,A01,083084,Eldon; John,3,10,80,77
1656083362345,CSE 30,B01,095061,Bhaskar; Nishant,4,5,50,46
1656083368369,CSE 100,A01,083659,Cao; Yingjun,2,23,70,68
1656083374392,CSE 134B,A01,083661,Powell; Thomas Allan,11,6,100,89
1656083380415,CSE 140,A01,083663,Gungor; Onat,9,0,85,76
1656083386440,CSE 140L,A01,083088,Eldon; John,8,0,100,92
1656083392465,CSE 175,A01,083665,Kumar; Rakesh,2,0,25,23
1656083398491,CSE 190,A00,092507,Dubnov; Shlomo,3,0,20,17
1656083404517,ECE 45,A01,083139,Congero; Spencer William,5,2,75,70
1656083410550,ECE 65,A50,083695,Saad; Andrew S,8,0,30,22
1656083410550,ECE 65,A51,095125,Staff,23,0,26,3
1656083416572,ECE 109,A01,091882,Touri; Behrouz,5,4,70,65
1656083422601,ECE 180,A00,083140,Abi Samra; Nicholas Camill,1,0,30,29
1656083422601,ECE 180,B00,083141,Abi Samra; Nicholas Camill,4,8,30,26
1656083428624,MATH 10A,A01,083735,Patchell; Gregory David,1,0,30,29
1656083428624,MATH 10A,A02,083736,Patchell; Gregory David,23,0,30,7
1656083428624,MATH 10A,A03,083737,Patchell; Gregory David,16,0,30,14
1656083434651,MATH 10B,A01,083207,Lim; Seonhee,3,1,34,31
1656083434651,MATH 10B,A02,083208,Lim; Seonhee,10,1,35,25
1656083434651,MATH 10B,A03,093472,Staff,4,1,34,30
1656083434651,MATH 10B,B01,083739,Sinha; Shubham,12,0,30,18
1656083440681,MATH 18,A01,083743,Cinel; Cameron Alexander,7,0,30,23
1656083440681,MATH 18,A02,083744,Cinel; Cameron Alexander,12,0,30,18
1656083440681,MATH 18,A03,083745,Cinel; Cameron Alexander,3,0,30,27
1656083440681,MATH 18,B01,083748,Ma; Zilu,1,0,36,35
1656083440681,MATH 18,B02,083749,Ma; Zilu,2,0,36,34
1656083440681,MATH 18,B03,083750,Ma; Zilu,0,0,36,36
1656083440681,MATH 18,B04,083751,Ma; Zilu,1,0,36,35
1656083440681,MATH 18,B05,093473,Staff,3,0,36,33
1656083440681,MATH 18,B06,093474,Staff,4,0,36,32
1656083446704,MATH 20A,A01,083754,Zheng; Zequn,11,0,40,29
1656083452727,MATH 20B,A01,083756,Briones; Jor-el Thomas Caparas,0,0,36,36
1656083452727,MATH 20B,A02,083757,Briones; Jor-el Thomas Caparas,2,0,36,34
1656083452727,MATH 20B,A03,093475,Staff,3,0,36,33
1656083458759,MATH 20C,A01,083760,Briones; Jor-el Thomas Caparas,2,2,35,33
1656083458759,MATH 20C,A02,083761,Briones; Jor-el Thomas Caparas,9,1,35,26
1656083458759,MATH 20C,A03,093476,Staff,1,1,35,34
1656083458759,MATH 20C,B01,083762,Bach; Quang Tran,4,0,30,26
1656083464792,MATH 20D,A01,083765,Tran; Brian Kha,3,0,30,27
1656083464792,MATH 20D,A02,083766,Tran; Brian Kha,0,1,30,30
1656083464792,MATH 20D,A03,083767,Tran; Brian Kha,2,0,30,28
1656083470817,MATH 20E,A01,083771,Ganguly; Soumya,4,1,32,28
1656083470817,MATH 20E,A02,083772,Ganguly; Soumya,2,1,32,30
1656083470817,MATH 20E,B01,083773,Ciotti; Benjamin,15,0,35,20
1656083470817,MATH 20E,B02,083774,Ciotti; Benjamin,15,0,35,20
1656083476843,MATH 103A,A01,083777,Greenfeld; Be'Eri,3,0,36,33
1656083476843,MATH 103A,A02,083778,Greenfeld; Be'Eri,3,0,36,33
1656083476843,MATH 103A,A03,093561,Staff,4,1,36,32
1656083476843,MATH 103A,B01,083779,Greenfeld; Be'Eri,8,1,36,28
1656083476843,MATH 103A,B02,083780,Greenfeld; Be'Eri,0,0,36,36
1656083476843,MATH 103A,B03,093562,Staff,1,0,36,35
1656083482868,MATH 105,A01,085443,Carter; Anne Toulson,4,1,35,31
1656083482868,MATH 105,A02,093477,Staff,11,0,35,24
1656083488891,MATH 109,A01,083213,Ganzberger; Geoffrey Michael,1,1,34,33
1656083488891,MATH 109,A02,083214,Ganzberger; Geoffrey Michael,0,0,34,34
1656083488891,MATH 109,A03,093478,Staff,3,0,34,31
1656083488891,MATH 109,B01,083215,Ganzberger; Geoffrey Michael,4,0,32,28
1656083488891,MATH 109,B02,083216,Ganzberger; Geoffrey Michael,1,0,32,31
1656083488891,MATH 109,B03,093479,Staff,4,0,32,28
1656083494915,MATH 142A,A01,083219,Chow; Bennett,2,0,32,30
1656083494915,MATH 142A,A02,083220,Chow; Bennett,8,0,32,24
1656083494915,MATH 142A,A03,093480,Staff,5,0,32,27
1656083494915,MATH 142A,B03,093481,Staff,4,0,32,28
1656083494915,MATH 142A,B04,093558,Staff,7,0,32,25
1656083494915,MATH 142A,B05,093559,Staff,0,0,32,32
1656083500945,MATH 193A,A01,083224,Rotar; Vladimir,1,2,34,33
1656083500945,MATH 193A,A02,083225,Rotar; Vladimir,3,0,34,31
1656083500945,MATH 193A,A03,083781,Rotar; Vladimir,3,0,34,31
1656083500945,MATH 193A,A04,083782,Rotar; Vladimir,7,0,34,27
1656083500945,MATH 193A,A05,093482,Rotar; Vladimir,1,0,34,33
1656083506969,MATH 197,001,091859,McAuley; Julian John,9999,0,9999,0
1656083506969,MATH 197,002,095566,Kedlaya; Kiran S.,9997,0,9999,2
1656083506969,MATH 197,003,095567,Xiao; Ming,9999,0,9999,0
1656083506969,MATH 197,004,095571,Perols; Johan Lars,9998,0,9999,1
1656083514050,COGS 9,A01,083615,Shannon; Kyle Michael,4,1,75,71
1656083520076,COGS 11,A01,083617,Boyle; Mary E. T.,16,1,48,32
1656083526100,COGS 13,A01,083071,Bastos; Amalia Pinkusfeld,8,2,71,63
1656083532129,COGS 14A,A01,092681,Semenuks; Arturs,8,23,100,92
1656083538153,COGS 14B,A01,083073,Cheng; Tzu-Han,9,0,63,54
1656083544179,COGS 17,A01,092677,Semenuks; Arturs,13,6,81,68
1656083550208,COGS 100,A01,083619,Allen; Michael Gordon,8,2,70,62
1656083556238,COGS 101A,A01,083621,Davis; Joshua Daniel,7,3,68,61
1656083562262,COGS 101B,A01,091572,Allen; Michael Gordon,7,0,65,58
1656083568294,COGS 101C,A01,083625,Delgado; Tania,11,0,35,24
1656083574331,COGS 107A,A01,083627,Boyle; Mary E. T.,5,2,60,55
1656083580354,COGS 118A,A01,083075,Gupta; Anjum,24,16,76,52
1656083586379,CSE 3,A50,083646,Miranda; Gregory Joseph,20,0,50,30
1656083592478,CSE 8A,A50,083650,Miranda; Gregory Joseph,13,11,56,43
1656083598502,CSE 11,A01,083080,Cao; Yingjun,1,60,40,39
1656083604527,CSE 12,A01,083652,Krause-Levy; Sophia Louisa,14,7,120,106
1656083610552,CSE 15L,A01,083654,Morris; Justin Loren,5,1,50,45
1656083610552,CSE 15L,A02,083655,Morris; Justin Loren,7,0,50,43
1656083616579,CSE 20,A01,083657,Tran; Khoa Dang,31,0,80,49
1656083622604,CSE 21,A01,095574,Bach; Quang Tran,28,0,48,20
1656083628631,CSE 30,A01,083084,Eldon; John,3,10,80,77
1656083628631,CSE 30,B01,095061,Bhaskar; Nishant,4,5,50,46
1656083634657,CSE 100,A01,083659,Cao; Yingjun,2,23,70,68
1656083640681,CSE 134B,A01,083661,Powell; Thomas Allan,11,6,100,89
1656083646713,CSE 140,A01,083663,Gungor; Onat,9,0,85,76
1656083652736,CSE 140L,A01,083088,Eldon; John,8,0,100,92
1656083658759,CSE 175,A01,083665,Kumar; Rakesh,2,0,25,23
1656083664785,CSE 190,A00,092507,Dubnov; Shlomo,3,0,20,17
1656083670810,ECE 45,A01,083139,Congero; Spencer William,5,2,75,70
1656083676833,ECE 65,A50,083695,Saad; Andrew S,8,0,30,22
1656083676833,ECE 65,A51,095125,Staff,23,0,26,3
1656083682857,ECE 109,A01,091882,Touri; Behrouz,5,4,70,65
1656083688885,ECE 180,A00,083140,Abi Samra; Nicholas Camill,1,0,30,29
1656083688885,ECE 180,B00,083141,Abi Samra; Nicholas Camill,4,8,30,26
1656083694910,MATH 10A,A01,083735,Patchell; Gregory David,1,0,30,29
1656083694910,MATH 10A,A02,083736,Patchell; Gregory David,23,0,30,7
1656083694910,MATH 10A,A03,083737,Patchell; Gregory David,16,0,30,14
1656083700942,MATH 10B,A01,083207,Lim; Seonhee,3,1,34,31
1656083700942,MATH 10B,A02,083208,Lim; Seonhee,10,1,35,25
1656083700942,MATH 10B,A03,093472,Staff,4,1,34,30
1656083700942,MATH 10B,B01,083739,Sinha; Shubham,12,0,30,18
1656083706973,MATH 18,A01,083743,Cinel; Cameron Alexander,7,0,30,23
1656083706973,MATH 18,A02,083744,Cinel; Cameron Alexander,12,0,30,18
1656083706973,MATH 18,A03,083745,Cinel; Cameron Alexander,3,0,30,27
1656083706973,MATH 18,B01,083748,Ma; Zilu,1,0,36,35
1656083706973,MATH 18,B02,083749,Ma; Zilu,2,0,36,34
1656083706973,MATH 18,B03,083750,Ma; Zilu,0,0,36,36
1656083706973,MATH 18,B04,083751,Ma; Zilu,1,0,36,35
1656083706973,MATH 18,B05,093473,Staff,3,0,36,33
1656083706973,MATH 18,B06,093474,Staff,4,0,36,32
1656083712996,MATH 20A,A01,083754,Zheng; Zequn,11,0,40,29
1656083719039,MATH 20B,A01,083756,Briones; Jor-el Thomas Caparas,0,0,36,36
1656083719039,MATH 20B,A02,083757,Briones; Jor-el Thomas Caparas,2,0,36,34
1656083719039,MATH 20B,A03,093475,Staff,3,0,36,33
1656083725062,MATH 20C,A01,083760,Briones; Jor-el Thomas Caparas,2,2,35,33
1656083725062,MATH 20C,A02,083761,Briones; Jor-el Thomas Caparas,9,1,35,26
1656083725062,MATH 20C,A03,093476,Staff,1,1,35,34
1656083725062,MATH 20C,B01,083762,Bach; Quang Tran,4,0,30,26
1656083731100,MATH 20D,A01,083765,Tran; Brian Kha,3,0,30,27
1656083731100,MATH 20D,A02,083766,Tran; Brian Kha,0,1,30,30
1656083731100,MATH 20D,A03,083767,Tran; Brian Kha,2,0,30,28
1656083737123,MATH 20E,A01,083771,Ganguly; Soumya,4,1,32,28
1656083737123,MATH 20E,A02,083772,Ganguly; Soumya,2,1,32,30
1656083737123,MATH 20E,B01,083773,Ciotti; Benjamin,15,0,35,20
1656083737123,MATH 20E,B02,083774,Ciotti; Benjamin,15,0,35,20
1656083743148,MATH 103A,A01,083777,Greenfeld; Be'Eri,3,0,36,33
1656083743148,MATH 103A,A02,083778,Greenfeld; Be'Eri,3,0,36,33
1656083743148,MATH 103A,A03,093561,Staff,4,1,36,32
1656083743148,MATH 103A,B01,083779,Greenfeld; Be'Eri,8,1,36,28
1656083743148,MATH 103A,B02,083780,Greenfeld; Be'Eri,0,0,36,36
1656083743148,MATH 103A,B03,093562,Staff,1,0,36,35
1656083749197,MATH 105,A01,085443,Carter; Anne Toulson,4,1,35,31
1656083749197,MATH 105,A02,093477,Staff,11,0,35,24
1656083755222,MATH 109,A01,083213,Ganzberger; Geoffrey Michael,1,1,34,33
1656083755222,MATH 109,A02,083214,Ganzberger; Geoffrey Michael,0,0,34,34
1656083755222,MATH 109,A03,093478,Staff,3,0,34,31
1656083755222,MATH 109,B01,083215,Ganzberger; Geoffrey Michael,4,0,32,28
1656083755222,MATH 109,B02,083216,Ganzberger; Geoffrey Michael,1,0,32,31
1656083755222,MATH 109,B03,093479,Staff,4,0,32,28
1656083761251,MATH 142A,A01,083219,Chow; Bennett,2,0,32,30
1656083761251,MATH 142A,A02,083220,Chow; Bennett,8,0,32,24
1656083761251,MATH 142A,A03,093480,Staff,5,0,32,27
1656083761251,MATH 142A,B03,093481,Staff,4,0,32,28
1656083761251,MATH 142A,B04,093558,Staff,7,0,32,25
1656083761251,MATH 142A,B05,093559,Staff,0,0,32,32
1656083767280,MATH 193A,A01,083224,Rotar; Vladimir,1,2,34,33
1656083767280,MATH 193A,A02,083225,Rotar; Vladimir,3,0,34,31
1656083767280,MATH 193A,A03,083781,Rotar; Vladimir,3,0,34,31
1656083767280,MATH 193A,A04,083782,Rotar; Vladimir,7,0,34,27
1656083767280,MATH 193A,A05,093482,Rotar; Vladimir,1,0,34,33
1656083773306,MATH 197,001,091859,McAuley; Julian John,9999,0,9999,0
1656083773306,MATH 197,002,095566,Kedlaya; Kiran S.,9997,0,9999,2
1656083773306,MATH 197,003,095567,Xiao; Ming,9999,0,9999,0
1656083773306,MATH 197,004,095571,Perols; Johan Lars,9998,0,9999,1
1656083780380,COGS 9,A01,083615,Shannon; Kyle Michael,4,1,75,71
1656083786405,COGS 11,A01,083617,Boyle; Mary E. T.,16,1,48,32
1656083792433,COGS 13,A01,083071,Bastos; Amalia Pinkusfeld,8,2,71,63
1656083798459,COGS 14A,A01,092681,Semenuks; Arturs,8,23,100,92
1656083804488,COGS 14B,A01,083073,Cheng; Tzu-Han,9,0,63,54
1656083810510,COGS 17,A01,092677,Semenuks; Arturs,13,6,81,68
1656083816538,COGS 100,A01,083619,Allen; Michael Gordon,8,2,70,62
1656083822562,COGS 101A,A01,083621,Davis; Joshua Daniel,7,3,68,61
1656083828588,COGS 101B,A01,091572,Allen; Michael Gordon,7,0,65,58
1656083834611,COGS 101C,A01,083625,Delgado; Tania,11,0,35,24
1656083840640,COGS 107A,A01,083627,Boyle; Mary E. T.,5,2,60,55
1656083846672,COGS 118A,A01,083075,Gupta; Anjum,24,16,76,52
1656083852696,CSE 3,A50,083646,Miranda; Gregory Joseph,20,0,50,30
1656083858721,CSE 8A,A50,083650,Miranda; Gregory Joseph,13,11,56,43
1656083864747,CSE 11,A01,083080,Cao; Yingjun,1,60,40,39
1656083870776,CSE 12,A01,083652,Krause-Levy; Sophia Louisa,14,7,120,106
1656083876800,CSE 15L,A01,083654,Morris; Justin Loren,5,1,50,45
1656083876800,CSE 15L,A02,083655,Morris; Justin Loren,7,0,50,43
1656083882832,CSE 20,A01,083657,Tran; Khoa Dang,31,0,80,49
1656083888859,CSE 21,A01,095574,Bach; Quang Tran,28,0,48,20
1656083894884,CSE 30,A01,083084,Eldon; John,3,10,80,77
1656083894884,CSE 30,B01,095061,Bhaskar; Nishant,4,5,50,46
1656083900909,CSE 100,A01,083659,Cao; Yingjun,2,23,70,68
1656083906935,CSE 134B,A01,083661,Powell; Thomas Allan,11,6,100,89
1656083912959,CSE 140,A01,083663,Gungor; Onat,9,0,85,76
1656083918983,CSE 140L,A01,083088,Eldon; John,8,0,100,92
1656083925007,CSE 175,A01,083665,Kumar; Rakesh,2,0,25,23
1656083931031,CSE 190,A00,092507,Dubnov; Shlomo,3,0,20,17
1656083937055,ECE 45,A01,083139,Congero; Spencer William,5,2,75,70
1656083943078,ECE 65,A50,083695,Saad; Andrew S,8,0,30,22
1656083943078,ECE 65,A51,095125,Staff,23,0,26,3
1656083949111,ECE 109,A01,091882,Touri; Behrouz,5,4,70,65
1656083955135,ECE 180,A00,083140,Abi Samra; Nicholas Camill,1,0,30,29
1656083955135,ECE 180,B00,083141,Abi Samra; Nicholas Camill,4,8,30,26
1656083961170,MATH 10A,A01,083735,Patchell; Gregory David,1,0,30,29
1656083961170,MATH 10A,A02,083736,Patchell; Gregory David,23,0,30,7
1656083961170,MATH 10A,A03,083737,Patchell; Gregory David,16,0,30,14
1656083967200,MATH 10B,A01,083207,Lim; Seonhee,3,1,34,31
1656083967200,MATH 10B,A02,083208,Lim; Seonhee,10,1,35,25
1656083967200,MATH 10B,A03,093472,Staff,4,1,34,30
1656083967200,MATH 10B,B01,083739,Sinha; Shubham,12,0,30,18
1656083973229,MATH 18,A01,083743,Cinel; Cameron Alexander,7,0,30,23
1656083973229,MATH 18,A02,083744,Cinel; Cameron Alexander,12,0,30,18
1656083973229,MATH 18,A03,083745,Cinel; Cameron Alexander,3,0,30,27
1656083973229,MATH 18,B01,083748,Ma; Zilu,1,0,36,35
1656083973229,MATH 18,B02,083749,Ma; Zilu,2,0,36,34
1656083973229,MATH 18,B03,083750,Ma; Zilu,0,0,36,36
1656083973229,MATH 18,B04,083751,Ma; Zilu,1,0,36,35
1656083973229,MATH 18,B05,093473,Staff,3,0,36,33
1656083973229,MATH 18,B06,093474,Staff,4,0,36,32
1656083979266,MATH 20A,A01,083754,Zheng; Zequn,11,0,40,29
1656083985297,MATH 20B,A01,083756,Briones; Jor-el Thomas Caparas,0,0,36,36
1656083985297,MATH 20B,A02,083757,Briones; Jor-el Thomas Caparas,2,0,36,34
1656083985297,MATH 20B,A03,093475,Staff,3,0,36,33
1656083991321,MATH 20C,A01,083760,Briones; Jor-el Thomas Caparas,2,2,35,33
1656083991321,MATH 20C,A02,083761,Briones; Jor-el Thomas Caparas,9,1,35,26
1656083991321,MATH 20C,A03,093476,Staff,1,1,35,34
1656083991321,MATH 20C,B01,083762,Bach; Quang Tran,4,0,30,26
1656083997345,MATH 20D,A01,083765,Tran; Brian Kha,3,0,30,27
1656083997345,MATH 20D,A02,083766,Tran; Brian Kha,0,1,30,30
1656083997345,MATH 20D,A03,083767,Tran; Brian Kha,2,0,30,28
1656084003370,MATH 20E,A01,083771,Ganguly; Soumya,4,1,32,28
1656084003370,MATH 20E,A02,083772,Ganguly; Soumya,2,1,32,30
1656084003370,MATH 20E,B01,083773,Ciotti; Benjamin,15,0,35,20
1656084003370,MATH 20E,B02,083774,Ciotti; Benjamin,15,0,35,20
1656084009401,MATH 103A,A01,083777,Greenfeld; Be'Eri,3,0,36,33
1656084009401,MATH 103A,A02,083778,Greenfeld; Be'Eri,3,0,36,33
1656084009401,MATH 103A,A03,093561,Staff,4,1,36,32
1656084009401,MATH 103A,B01,083779,Greenfeld; Be'Eri,8,1,36,28
1656084009401,MATH 103A,B02,083780,Greenfeld; Be'Eri,0,0,36,36
1656084009401,MATH 103A,B03,093562,Staff,1,0,36,35
1656084015435,MATH 105,A01,085443,Carter; Anne Toulson,4,1,35,31
1656084015435,MATH 105,A02,093477,Staff,11,0,35,24
1656084021460,MATH 109,A01,083213,Ganzberger; Geoffrey Michael,1,1,34,33
1656084021460,MATH 109,A02,083214,Ganzberger; Geoffrey Michael,0,0,34,34
1656084021460,MATH 109,A03,093478,Staff,3,0,34,31
1656084021460,MATH 109,B01,083215,Ganzberger; Geoffrey Michael,4,0,32,28
1656084021460,MATH 109,B02,083216,Ganzberger; Geoffrey Michael,1,0,32,31
1656084021460,MATH 109,B03,093479,Staff,4,0,32,28
1656084027486,MATH 142A,A01,083219,Chow; Bennett,2,0,32,30
1656084027486,MATH 142A,A02,083220,Chow; Bennett,8,0,32,24
1656084027486,MATH 142A,A03,093480,Staff,5,0,32,27
1656084027486,MATH 142A,B03,093481,Staff,4,0,32,28
1656084027486,MATH 142A,B04,093558,Staff,7,0,32,25
1656084027486,MATH 142A,B05,093559,Staff,0,0,32,32
1656084033508,MATH 193A,A01,083224,Rotar; Vladimir,1,2,34,33
1656084033508,MATH 193A,A02,083225,Rotar; Vladimir,3,0,34,31
1656084033508,MATH 193A,A03,083781,Rotar; Vladimir,3,0,34,31
1656084033508,MATH 193A,A04,083782,Rotar; Vladimir,7,0,34,27
1656084033508,MATH 193A,A05,093482,Rotar; Vladimir,1,0,34,33
1656084039532,MATH 197,001,091859,McAuley; Julian John,9999,0,9999,0
1656084039532,MATH 197,002,095566,Kedlaya; Kiran S.,9997,0,9999,2
1656084039532,MATH 197,003,095567,Xiao; Ming,9999,0,9999,0
1656084039532,MATH 197,004,095571,Perols; Johan Lars,9998,0,9999,1
1656084046588,COGS 9,A01,083615,Shannon; Kyle Michael,4,1,75,71
1656084052615,COGS 11,A01,083617,Boyle; Mary E. T.,16,1,48,32
1656084058637,COGS 13,A01,083071,Bastos; Amalia Pinkusfeld,8,2,71,63
1656084064664,COGS 14A,A01,092681,Semenuks; Arturs,8,23,100,92
1656084070687,COGS 14B,A01,083073,Cheng; Tzu-Han,9,0,63,54
1656084076712,COGS 17,A01,092677,Semenuks; Arturs,13,6,81,68
1656084082735,COGS 100,A01,083619,Allen; Michael Gordon,8,2,70,62
1656084088762,COGS 101A,A01,083621,Davis; Joshua Daniel,7,3,68,61
1656084094785,COGS 101B,A01,091572,Allen; Michael Gordon,7,0,65,58
1656084100807,COGS 101C,A01,083625,Delgado; Tania,11,0,35,24
1656084106834,COGS 107A,A01,083627,Boyle; Mary E. T.,5,2,60,55
1656084112857,COGS 118A,A01,083075,Gupta; Anjum,24,16,76,52
1656084118881,CSE 3,A50,083646,Miranda; Gregory Joseph,20,0,50,30
1656084124915,CSE 8A,A50,083650,Miranda; Gregory Joseph,13,11,56,43
1656084130939,CSE 11,A01,083080,Cao; Yingjun,1,60,40,39
1656084136965,CSE 12,A01,083652,Krause-Levy; Sophia Louisa,14,7,120,106
1656084142993,CSE 15L,A01,083654,Morris; Justin Loren,5,1,50,45
1656084142993,CSE 15L,A02,083655,Morris; Justin Loren,7,0,50,43
1656084149017,CSE 20,A01,083657,Tran; Khoa Dang,31,0,80,49
1656084155044,CSE 21,A01,095574,Bach; Quang Tran,28,0,48,20
1656084161068,CSE 30,A01,083084,Eldon; John,3,10,80,77
1656084161068,CSE 30,B01,095061,Bhaskar; Nishant,4,5,50,46
1656084167096,CSE 100,A01,083659,Cao; Yingjun,2,23,70,68
1656084173124,CSE 134B,A01,083661,Powell; Thomas Allan,11,6,100,89
1656084179147,CSE 140,A01,083663,Gungor; Onat,9,0,85,76
1656084185173,CSE 140L,A01,083088,Eldon; John,8,0,100,92
1656084191296,CSE 175,A01,083665,Kumar; Rakesh,2,0,25,23
1656084197327,CSE 190,A00,092507,Dubnov; Shlomo,3,0,20,17
1656084203362,ECE 45,A01,083139,Congero; Spencer William,5,2,75,70
1656084209389,ECE 65,A50,083695,Saad; Andrew S,8,0,30,22
1656084209389,ECE 65,A51,095125,Staff,23,0,26,3
1656084215413,ECE 109,A01,091882,Touri; Behrouz,5,4,70,65
1656084221445,ECE 180,A00,083140,Abi Samra; Nicholas Camill,1,0,30,29
1656084221445,ECE 180,B00,083141,Abi Samra; Nicholas Camill,4,8,30,26
1656084227474,MATH 10A,A01,083735,Patchell; Gregory David,1,0,30,29
1656084227474,MATH 10A,A02,083736,Patchell; Gregory David,23,0,30,7
1656084227474,MATH 10A,A03,083737,Patchell; Gregory David,16,0,30,14
1656084233508,MATH 10B,A01,083207,Lim; Seonhee,3,1,34,31
1656084233508,MATH 10B,A02,083208,Lim; Seonhee,10,1,35,25
1656084233508,MATH 10B,A03,093472,Staff,4,1,34,30
1656084233508,MATH 10B,B01,083739,Sinha; Shubham,12,0,30,18
1656084239542,MATH 18,A01,083743,Cinel; Cameron Alexander,7,0,30,23
1656084239542,MATH 18,A02,083744,Cinel; Cameron Alexander,12,0,30,18
1656084239542,MATH 18,A03,083745,Cinel; Cameron Alexander,3,0,30,27
1656084239542,MATH 18,B01,083748,Ma; Zilu,1,0,36,35
1656084239542,MATH 18,B02,083749,Ma; Zilu,2,0,36,34
1656084239542,MATH 18,B03,083750,Ma; Zilu,0,0,36,36
1656084239542,MATH 18,B04,083751,Ma; Zilu,1,0,36,35
1656084239542,MATH 18,B05,093473,Staff,3,0,36,33
1656084239542,MATH 18,B06,093474,Staff,4,0,36,32
1656084245567,MATH 20A,A01,083754,Zheng; Zequn,11,0,40,29
1656084251595,MATH 20B,A01,083756,Briones; Jor-el Thomas Caparas,0,0,36,36
1656084251595,MATH 20B,A02,083757,Briones; Jor-el Thomas Caparas,2,0,36,34
1656084251595,MATH 20B,A03,093475,Staff,3,0,36,33
1656084257624,MATH 20C,A01,083760,Briones; Jor-el Thomas Caparas,2,2,35,33
1656084257624,MATH 20C,A02,083761,Briones; Jor-el Thomas Caparas,9,1,35,26
1656084257624,MATH 20C,A03,093476,Staff,1,1,35,34
1656084257624,MATH 20C,B01,083762,Bach; Quang Tran,4,0,30,26
1656084263647,MATH 20D,A01,083765,Tran; Brian Kha,3,0,30,27
1656084263647,MATH 20D,A02,083766,Tran; Brian Kha,0,1,30,30
1656084263647,MATH 20D,A03,083767,Tran; Brian Kha,2,0,30,28
1656084269676,MATH 20E,A01,083771,Ganguly; Soumya,4,1,32,28
1656084269676,MATH 20E,A02,083772,Ganguly; Soumya,2,1,32,30
1656084269676,MATH 20E,B01,083773,Ciotti; Benjamin,15,0,35,20
1656084269676,MATH 20E,B02,083774,Ciotti; Benjamin,15,0,35,20
1656084275708,MATH 103A,A01,083777,Greenfeld; Be'Eri,3,0,36,33
1656084275708,MATH 103A,A02,083778,Greenfeld; Be'Eri,3,0,36,33
1656084275708,MATH 103A,A03,093561,Staff,4,1,36,32
1656084275708,MATH 103A,B01,083779,Greenfeld; Be'Eri,8,1,36,28
1656084275708,MATH 103A,B02,083780,Greenfeld; Be'Eri,0,0,36,36
1656084275708,MATH 103A,B03,093562,Staff,1,0,36,35
1656084281735,MATH 105,A01,085443,Carter; Anne Toulson,4,1,35,31
1656084281735,MATH 105,A02,093477,Staff,11,0,35,24
1656084287765,MATH 109,A01,083213,Ganzberger; Geoffrey Michael,1,1,34,33
1656084287765,MATH 109,A02,083214,Ganzberger; Geoffrey Michael,0,0,34,34
1656084287765,MATH 109,A03,093478,Staff,3,0,34,31
1656084287765,MATH 109,B01,083215,Ganzberger; Geoffrey Michael,4,0,32,28
1656084287765,MATH 109,B02,083216,Ganzberger; Geoffrey Michael,1,0,32,31
1656084287765,MATH 109,B03,093479,Staff,4,0,32,28
1656084293789,MATH 142A,A01,083219,Chow; Bennett,2,0,32,30
1656084293789,MATH 142A,A02,083220,Chow; Bennett,8,0,32,24
1656084293789,MATH 142A,A03,093480,Staff,5,0,32,27
1656084293789,MATH 142A,B03,093481,Staff,4,0,32,28
1656084293789,MATH 142A,B04,093558,Staff,7,0,32,25
1656084293789,MATH 142A,B05,093559,Staff,0,0,32,32
1656084299819,MATH 193A,A01,083224,Rotar; Vladimir,1,2,34,33
1656084299819,MATH 193A,A02,083225,Rotar; Vladimir,3,0,34,31
1656084299819,MATH 193A,A03,083781,Rotar; Vladimir,3,0,34,31
1656084299819,MATH 193A,A04,083782,Rotar; Vladimir,7,0,34,27
1656084299819,MATH 193A,A05,093482,Rotar; Vladimir,1,0,34,33
1656084305841,MATH 197,001,091859,McAuley; Julian John,9999,0,9999,0
1656084305841,MATH 197,002,095566,Kedlaya; Kiran S.,9997,0,9999,2
1656084305841,MATH 197,003,095567,Xiao; Ming,9999,0,9999,0
1656084305841,MATH 197,004,095571,Perols; Johan Lars,9998,0,9999,1
1656084312897,COGS 9,A01,083615,Shannon; Kyle Michael,4,1,75,71
1656084318924,COGS 11,A01,083617,Boyle; Mary E. T.,16,1,48,32
1656084324965,COGS 13,A01,083071,Bastos; Amalia Pinkusfeld,8,2,71,63
1656084330990,COGS 14A,A01,092681,Semenuks; Arturs,8,23,100,92
1656084337013,COGS 14B,A01,083073,Cheng; Tzu-Han,9,0,63,54
1656084343037,COGS 17,A01,092677,Semenuks; Arturs,13,6,81,68
1656084349063,COGS 100,A01,083619,Allen; Michael Gordon,8,2,70,62
1656084355089,COGS 101A,A01,083621,Davis; Joshua Daniel,7,3,68,61
1656084361118,COGS 101B,A01,091572,Allen; Michael Gordon,7,0,65,58
1656084367142,COGS 101C,A01,083625,Delgado; Tania,11,0,35,24
1656084373167,COGS 107A,A01,083627,Boyle; Mary E. T.,5,2,60,55
1656084379191,COGS 118A,A01,083075,Gupta; Anjum,24,16,76,52
1656084385215,CSE 3,A50,083646,Miranda; Gregory Joseph,20,0,50,30
1656084391242,CSE 8A,A50,083650,Miranda; Gregory Joseph,13,11,56,43
1656084397266,CSE 11,A01,083080,Cao; Yingjun,1,60,40,39
1656084403289,CSE 12,A01,083652,Krause-Levy; Sophia Louisa,14,7,120,106
1656084409312,CSE 15L,A01,083654,Morris; Justin Loren,5,1,50,45
1656084409312,CSE 15L,A02,083655,Morris; Justin Loren,7,0,50,43
1656084415337,CSE 20,A01,083657,Tran; Khoa Dang,31,0,80,49
1656084421360,CSE 21,A01,095574,Bach; Quang Tran,28,0,48,20
1656084427391,CSE 30,A01,083084,Eldon; John,3,10,80,77
1656084427391,CSE 30,B01,095061,Bhaskar; Nishant,4,5,50,46
1656084433426,CSE 100,A01,083659,Cao; Yingjun,2,23,70,68
1656084439453,CSE 134B,A01,083661,Powell; Thomas Allan,11,6,100,89
1656084445480,CSE 140,A01,083663,Gungor; Onat,9,0,85,76
1656084451506,CSE 140L,A01,083088,Eldon; John,8,0,100,92
1656084457530,CSE 175,A01,083665,Kumar; Rakesh,2,0,25,23
1656084463556,CSE 190,A00,092507,Dubnov; Shlomo,3,0,20,17
1656084469580,ECE 45,A01,083139,Congero; Spencer William,5,2,75,70
1656084475603,ECE 65,A50,083695,Saad; Andrew S,8,0,30,22
1656084475603,ECE 65,A51,095125,Staff,23,0,26,3
1656084481630,ECE 109,A01,091882,Touri; Behrouz,5,4,70,65
1656084487658,ECE 180,A00,083140,Abi Samra; Nicholas Camill,1,0,30,29
1656084487658,ECE 180,B00,083141,Abi Samra; Nicholas Camill,4,8,30,26
1656084493686,MATH 10A,A01,083735,Patchell; Gregory David,1,0,30,29
1656084493686,MATH 10A,A02,083736,Patchell; Gregory David,23,0,30,7
1656084493686,MATH 10A,A03,083737,Patchell; Gregory David,16,0,30,14
1656084499715,MATH 10B,A01,083207,Lim; Seonhee,3,1,34,31
1656084499715,MATH 10B,A02,083208,Lim; Seonhee,10,1,35,25
1656084499715,MATH 10B,A03,093472,Staff,4,1,34,30
1656084499715,MATH 10B,B01,083739,Sinha; Shubham,12,0,30,18
1656084505744,MATH 18,A01,083743,Cinel; Cameron Alexander,7,0,30,23
1656084505744,MATH 18,A02,083744,Cinel; Cameron Alexander,12,0,30,18
1656084505744,MATH 18,A03,083745,Cinel; Cameron Alexander,3,0,30,27
1656084505744,MATH 18,B01,083748,Ma; Zilu,1,0,36,35
1656084505744,MATH 18,B02,083749,Ma; Zilu,2,0,36,34
1656084505744,MATH 18,B03,083750,Ma; Zilu,0,0,36,36
1656084505744,MATH 18,B04,083751,Ma; Zilu,0,0,36,36
1656084505744,MATH 18,B05,093473,Staff,3,0,36,33
1656084505744,MATH 18,B06,093474,Staff,4,0,36,32
1656084511779,MATH 20A,A01,083754,Zheng; Zequn,11,0,40,29
1656084517804,MATH 20B,A01,083756,Briones; Jor-el Thomas Caparas,0,0,36,36
1656084517804,MATH 20B,A02,083757,Briones; Jor-el Thomas Caparas,2,0,36,34
1656084517804,MATH 20B,A03,093475,Staff,3,0,36,33
1656084523827,MATH 20C,A01,083760,Briones; Jor-el Thomas Caparas,2,2,35,33
1656084523827,MATH 20C,A02,083761,Briones; Jor-el Thomas Caparas,9,1,35,26
1656084523827,MATH 20C,A03,093476,Staff,1,1,35,34
1656084523827,MATH 20C,B01,083762,Bach; Quang Tran,4,0,30,26
1656084529859,MATH 20D,A01,083765,Tran; Brian Kha,3,0,30,27
1656084529859,MATH 20D,A02,083766,Tran; Brian Kha,0,1,30,30
1656084529859,MATH 20D,A03,083767,Tran; Brian Kha,2,0,30,28
1656084535889,MATH 20E,A01,083771,Ganguly; Soumya,4,1,32,28
1656084535889,MATH 20E,A02,083772,Ganguly; Soumya,2,1,32,30
1656084535889,MATH 20E,B01,083773,Ciotti; Benjamin,15,0,35,20
1656084535889,MATH 20E,B02,083774,Ciotti; Benjamin,15,0,35,20
1656084541919,MATH 103A,A01,083777,Greenfeld; Be'Eri,3,0,36,33
1656084541919,MATH 103A,A02,083778,Greenfeld; Be'Eri,3,0,36,33
1656084541919,MATH 103A,A03,093561,Staff,4,1,36,32
1656084541919,MATH 103A,B01,083779,Greenfeld; Be'Eri,8,1,36,28
1656084541919,MATH 103A,B02,083780,Greenfeld; Be'Eri,0,0,36,36
1656084541919,MATH 103A,B03,093562,Staff,1,0,36,35
1656084547943,MATH 105,A01,085443,Carter; Anne Toulson,4,1,35,31
1656084547943,MATH 105,A02,093477,Staff,11,0,35,24
1656084553971,MATH 109,A01,083213,Ganzberger; Geoffrey Michael,1,1,34,33
1656084553971,MATH 109,A02,083214,Ganzberger; Geoffrey Michael,0,0,34,34
1656084553971,MATH 109,A03,093478,Staff,3,0,34,31
1656084553971,MATH 109,B01,083215,Ganzberger; Geoffrey Michael,4,0,32,28
1656084553971,MATH 109,B02,083216,Ganzberger; Geoffrey Michael,1,0,32,31
1656084553971,MATH 109,B03,093479,Staff,4,0,32,28
1656084559996,MATH 142A,A01,083219,Chow; Bennett,2,0,32,30
1656084559996,MATH 142A,A02,083220,Chow; Bennett,8,0,32,24
1656084559996,MATH 142A,A03,093480,Staff,5,0,32,27
1656084559996,MATH 142A,B03,093481,Staff,4,0,32,28
1656084559996,MATH 142A,B04,093558,Staff,7,0,32,25
1656084559996,MATH 142A,B05,093559,Staff,0,0,32,32
1656084566027,MATH 193A,A01,083224,Rotar; Vladimir,1,2,34,33
1656084566027,MATH 193A,A02,083225,Rotar; Vladimir,3,0,34,31
1656084566027,MATH 193A,A03,083781,Rotar; Vladimir,3,0,34,31
1656084566027,MATH 193A,A04,083782,Rotar; Vladimir,7,0,34,27
1656084566027,MATH 193A,A05,093482,Rotar; Vladimir,1,0,34,33
1656084572051,MATH 197,001,091859,McAuley; Julian John,9999,0,9999,0
1656084572051,MATH 197,002,095566,Kedlaya; Kiran S.,9997,0,9999,2
1656084572051,MATH 197,003,095567,Xiao; Ming,9999,0,9999,0
1656084572051,MATH 197,004,095571,Perols; Johan Lars,9998,0,9999,1
1656084579117,COGS 9,A01,083615,Shannon; Kyle Michael,4,1,75,71
1656084585140,COGS 11,A01,083617,Boyle; Mary E. T.,16,1,48,32
1656084591170,COGS 13,A01,083071,Bastos; Amalia Pinkusfeld,8,2,71,63
1656084597196,COGS 14A,A01,092681,Semenuks; Arturs,8,23,100,92
1656084603230,COGS 14B,A01,083073,Cheng; Tzu-Han,8,0,63,55
1656084609258,COGS 17,A01,092677,Semenuks; Arturs,13,6,81,68
1656084615295,COGS 100,A01,083619,Allen; Michael Gordon,8,2,70,62
1656084621321,COGS 101A,A01,083621,Davis; Joshua Daniel,7,3,68,61
1656084627356,COGS 101B,A01,091572,Allen; Michael Gordon,7,0,65,58
1656084633381,COGS 101C,A01,083625,Delgado; Tania,11,0,35,24
1656084639405,COGS 107A,A01,083627,Boyle; Mary E. T.,5,2,60,55
1656084645433,COGS 118A,A01,083075,Gupta; Anjum,24,16,76,52
1656084651465,CSE 3,A50,083646,Miranda; Gregory Joseph,20,0,50,30
1656084657489,CSE 8A,A50,083650,Miranda; Gregory Joseph,13,11,56,43
1656084663512,CSE 11,A01,083080,Cao; Yingjun,1,60,40,39
1656084669536,CSE 12,A01,083652,Krause-Levy; Sophia Louisa,14,7,120,106
1656084675557,CSE 15L,A01,083654,Morris; Justin Loren,5,1,50,45
1656084675557,CSE 15L,A02,083655,Morris; Justin Loren,7,0,50,43
1656084681580,CSE 20,A01,083657,Tran; Khoa Dang,31,0,80,49
1656084687608,CSE 21,A01,095574,Bach; Quang Tran,28,0,48,20
1656084693634,CSE 30,A01,083084,Eldon; John,3,10,80,77
1656084693634,CSE 30,B01,095061,Bhaskar; Nishant,4,5,50,46
1656084699656,CSE 100,A01,083659,Cao; Yingjun,2,23,70,68
1656084705687,CSE 134B,A01,083661,Powell; Thomas Allan,11,6,100,89
1656084711711,CSE 140,A01,083663,Gungor; Onat,9,0,85,76
1656084717734,CSE 140L,A01,083088,Eldon; John,8,0,100,92
1656084723761,CSE 175,A01,083665,Kumar; Rakesh,2,0,25,23
1656084729785,CSE 190,A00,092507,Dubnov; Shlomo,3,0,20,17
1656084735813,ECE 45,A01,083139,Congero; Spencer William,5,2,75,70
1656084741851,ECE 65,A50,083695,Saad; Andrew S,8,0,30,22
1656084741851,ECE 65,A51,095125,Staff,23,0,26,3
1656084747908,ECE 109,A01,091882,Touri; Behrouz,5,4,70,65
1656084753942,ECE 180,A00,083140,Abi Samra; Nicholas Camill,1,0,30,29
1656084753942,ECE 180,B00,083141,Abi Samra; Nicholas Camill,4,8,30,26
1656084759972,MATH 10A,A01,083735,Patchell; Gregory David,1,0,30,29
1656084759972,MATH 10A,A02,083736,Patchell; Gregory David,23,0,30,7
1656084759972,MATH 10A,A03,083737,Patchell; Gregory David,16,0,30,14
1656084765997,MATH 10B,A01,083207,Lim; Seonhee,3,1,34,31
1656084765997,MATH 10B,A02,083208,Lim; Seonhee,10,1,35,25
1656084765997,MATH 10B,A03,093472,Staff,4,1,34,30
1656084765997,MATH 10B,B01,083739,Sinha; Shubham,12,0,30,18
1656084772020,MATH 18,A01,083743,Cinel; Cameron Alexander,7,0,30,23
1656084772020,MATH 18,A02,083744,Cinel; Cameron Alexander,12,0,30,18
1656084772020,MATH 18,A03,083745,Cinel; Cameron Alexander,3,0,30,27
1656084772020,MATH 18,B01,083748,Ma; Zilu,1,0,36,35
1656084772020,MATH 18,B02,083749,Ma; Zilu,2,0,36,34
1656084772020,MATH 18,B03,083750,Ma; Zilu,0,0,36,36
1656084772020,MATH 18,B04,083751,Ma; Zilu,0,0,36,36
1656084772020,MATH 18,B05,093473,Staff,3,0,36,33
1656084772020,MATH 18,B06,093474,Staff,4,0,36,32
1656084778050,MATH 20A,A01,083754,Zheng; Zequn,11,0,40,29
1656084784081,MATH 20B,A01,083756,Briones; Jor-el Thomas Caparas,0,0,36,36
1656084784081,MATH 20B,A02,083757,Briones; Jor-el Thomas Caparas,2,0,36,34
1656084784081,MATH 20B,A03,093475,Staff,3,0,36,33
1656084790204,MATH 20C,A01,083760,Briones; Jor-el Thomas Caparas,2,2,35,33
1656084790204,MATH 20C,A02,083761,Briones; Jor-el Thomas Caparas,9,1,35,26
1656084790204,MATH 20C,A03,093476,Staff,1,1,35,34
1656084790204,MATH 20C,B01,083762,Bach; Quang Tran,4,0,30,26
1656084796235,MATH 20D,A01,083765,Tran; Brian Kha,3,0,30,27
1656084796235,MATH 20D,A02,083766,Tran; Brian Kha,0,1,30,30
1656084796235,MATH 20D,A03,083767,Tran; Brian Kha,2,0,30,28
1656084802265,MATH 20E,A01,083771,Ganguly; Soumya,4,1,32,28
1656084802265,MATH 20E,A02,083772,Ganguly; Soumya,2,1,32,30
1656084802265,MATH 20E,B01,083773,Ciotti; Benjamin,15,0,35,20
1656084802265,MATH 20E,B02,083774,Ciotti; Benjamin,15,0,35,20
1656084808290,MATH 103A,A01,083777,Greenfeld; Be'Eri,3,0,36,33
1656084808290,MATH 103A,A02,083778,Greenfeld; Be'Eri,3,0,36,33
1656084808290,MATH 103A,A03,093561,Staff,4,1,36,32
1656084808290,MATH 103A,B01,083779,Greenfeld; Be'Eri,8,1,36,28
1656084808290,MATH 103A,B02,083780,Greenfeld; Be'Eri,0,0,36,36
1656084808290,MATH 103A,B03,093562,Staff,1,0,36,35
1656084814316,MATH 105,A01,085443,Carter; Anne Toulson,4,1,35,31
1656084814316,MATH 105,A02,093477,Staff,11,0,35,24
1656084820339,MATH 109,A01,083213,Ganzberger; Geoffrey Michael,1,1,34,33
1656084820339,MATH 109,A02,083214,Ganzberger; Geoffrey Michael,0,0,34,34
1656084820339,MATH 109,A03,093478,Staff,3,0,34,31
1656084820339,MATH 109,B01,083215,Ganzberger; Geoffrey Michael,4,0,32,28
1656084820339,MATH 109,B02,083216,Ganzberger; Geoffrey Michael,1,0,32,31
1656084820339,MATH 109,B03,093479,Staff,4,0,32,28
1656084826362,MATH 142A,A01,083219,Chow; Bennett,2,0,32,30
1656084826362,MATH 142A,A02,083220,Chow; Bennett,8,0,32,24
1656084826362,MATH 142A,A03,093480,Staff,5,0,32,27
1656084826362,MATH 142A,B03,093481,Staff,4,0,32,28
1656084826362,MATH 142A,B04,093558,Staff,7,0,32,25
1656084826362,MATH 142A,B05,093559,Staff,0,0,32,32
1656084832391,MATH 193A,A01,083224,Rotar; Vladimir,1,2,34,33
1656084832391,MATH 193A,A02,083225,Rotar; Vladimir,3,0,34,31
1656084832391,MATH 193A,A03,083781,Rotar; Vladimir,3,0,34,31
1656084832391,MATH 193A,A04,083782,Rotar; Vladimir,7,0,34,27
1656084832391,MATH 193A,A05,093482,Rotar; Vladimir,1,0,34,33
1656084838413,MATH 197,001,091859,McAuley; Julian John,9999,0,9999,0
1656084838413,MATH 197,002,095566,Kedlaya; Kiran S.,9997,0,9999,2
1656084838413,MATH 197,003,095567,Xiao; Ming,9999,0,9999,0
1656084838413,MATH 197,004,095571,Perols; Johan Lars,9998,0,9999,1
1656084845480,COGS 9,A01,083615,Shannon; Kyle Michael,4,1,75,71
1656084851507,COGS 11,A01,083617,Boyle; Mary E. T.,16,1,48,32
1656084857534,COGS 13,A01,083071,Bastos; Amalia Pinkusfeld,8,2,71,63
1656084863558,COGS 14A,A01,092681,Semenuks; Arturs,8,23,100,92
1656084869581,COGS 14B,A01,083073,Cheng; Tzu-Han,8,0,63,55
1656084875606,COGS 17,A01,092677,Semenuks; Arturs,13,6,81,68
1656084881631,COGS 100,A01,083619,Allen; Michael Gordon,8,2,70,62
1656084887659,COGS 101A,A01,083621,Davis; Joshua Daniel,7,3,68,61
1656084893681,COGS 101B,A01,091572,Allen; Michael Gordon,7,0,65,58
1656084899706,COGS 101C,A01,083625,Delgado; Tania,11,0,35,24
1656084905728,COGS 107A,A01,083627,Boyle; Mary E. T.,5,2,60,55
1656084911751,COGS 118A,A01,083075,Gupta; Anjum,24,16,76,52
1656084917783,CSE 3,A50,083646,Miranda; Gregory Joseph,20,0,50,30
1656084923819,CSE 8A,A50,083650,Miranda; Gregory Joseph,13,11,56,43
1656084929853,CSE 11,A01,083080,Cao; Yingjun,1,60,40,39
1656084935882,CSE 12,A01,083652,Krause-Levy; Sophia Louisa,14,7,120,106
1656084941909,CSE 15L,A01,083654,Morris; Justin Loren,5,1,50,45
1656084941909,CSE 15L,A02,083655,Morris; Justin Loren,7,0,50,43
1656084947935,CSE 20,A01,083657,Tran; Khoa Dang,31,0,80,49
1656084953964,CSE 21,A01,095574,Bach; Quang Tran,28,0,48,20
1656084959991,CSE 30,A01,083084,Eldon; John,3,10,80,77
1656084959991,CSE 30,B01,095061,Bhaskar; Nishant,4,5,50,46
1656084966025,CSE 100,A01,083659,Cao; Yingjun,2,23,70,68
1656084972066,CSE 134B,A01,083661,Powell; Thomas Allan,11,6,100,89
1656084978091,CSE 140,A01,083663,Gungor; Onat,9,0,85,76
1656084984115,CSE 140L,A01,083088,Eldon; John,8,0,100,92
1656084990150,CSE 175,A01,083665,Kumar; Rakesh,2,0,25,23
1656084996178,CSE 190,A00,092507,Dubnov; Shlomo,3,0,20,17
1656085002210,ECE 45,A01,083139,Congero; Spencer William,5,2,75,70
1656085008233,ECE 65,A50,083695,Saad; Andrew S,8,0,30,22
1656085008233,ECE 65,A51,095125,Staff,23,0,26,3
1656085014256,ECE 109,A01,091882,Touri; Behrouz,5,4,70,65
1656085020280,ECE 180,A00,083140,Abi Samra; Nicholas Camill,1,0,30,29
1656085020280,ECE 180,B00,083141,Abi Samra; Nicholas Camill,4,8,30,26
1656085026303,MATH 10A,A01,083735,Patchell; Gregory David,1,0,30,29
1656085026303,MATH 10A,A02,083736,Patchell; Gregory David,23,0,30,7
1656085026303,MATH 10A,A03,083737,Patchell; Gregory David,16,0,30,14
1656085032328,MATH 10B,A01,083207,Lim; Seonhee,3,1,34,31
1656085032328,MATH 10B,A02,083208,Lim; Seonhee,10,1,35,25
1656085032328,MATH 10B,A03,093472,Staff,4,1,34,30
1656085032328,MATH 10B,B01,083739,Sinha; Shubham,12,0,30,18
1656085038353,MATH 18,A01,083743,Cinel; Cameron Alexander,7,0,30,23
1656085038353,MATH 18,A02,083744,Cinel; Cameron Alexander,12,0,30,18
1656085038353,MATH 18,A03,083745,Cinel; Cameron Alexander,3,0,30,27
1656085038353,MATH 18,B01,083748,Ma; Zilu,1,0,36,35
1656085038353,MATH 18,B02,083749,Ma; Zilu,2,0,36,34
1656085038353,MATH 18,B03,083750,Ma; Zilu,0,0,36,36
1656085038353,MATH 18,B04,083751,Ma; Zilu,0,0,36,36
1656085038353,MATH 18,B05,093473,Staff,3,0,36,33
1656085038353,MATH 18,B06,093474,Staff,4,0,36,32
1656085044387,MATH 20A,A01,083754,Zheng; Zequn,11,0,40,29
1656085050421,MATH 20B,A01,083756,Briones; Jor-el Thomas Caparas,0,0,36,36
1656085050421,MATH 20B,A02,083757,Briones; Jor-el Thomas Caparas,2,0,36,34
1656085050421,MATH 20B,A03,093475,Staff,3,0,36,33
1656085056446,MATH 20C,A01,083760,Briones; Jor-el Thomas Caparas,2,2,35,33
1656085056446,MATH 20C,A02,083761,Briones; Jor-el Thomas Caparas,9,1,35,26
1656085056446,MATH 20C,A03,093476,Staff,1,1,35,34
1656085056446,MATH 20C,B01,083762,Bach; Quang Tran,4,0,30,26
1656085062477,MATH 20D,A01,083765,Tran; Brian Kha,3,0,30,27
1656085062477,MATH 20D,A02,083766,Tran; Brian Kha,0,1,30,30
1656085062477,MATH 20D,A03,083767,Tran; Brian Kha,2,0,30,28
1656085068504,MATH 20E,A01,083771,Ganguly; Soumya,4,1,32,28
1656085068504,MATH 20E,A02,083772,Ganguly; Soumya,2,1,32,30
1656085068504,MATH 20E,B01,083773,Ciotti; Benjamin,15,0,35,20
1656085068504,MATH 20E,B02,083774,Ciotti; Benjamin,15,0,35,20
1656085074528,MATH 103A,A01,083777,Greenfeld; Be'Eri,3,0,36,33
1656085074528,MATH 103A,A02,083778,Greenfeld; Be'Eri,3,0,36,33
1656085074528,MATH 103A,A03,093561,Staff,4,1,36,32
1656085074528,MATH 103A,B01,083779,Greenfeld; Be'Eri,8,1,36,28
1656085074528,MATH 103A,B02,083780,Greenfeld; Be'Eri,0,0,36,36
1656085074528,MATH 103A,B03,093562,Staff,0,0,36,36
1656085080552,MATH 105,A01,085443,Carter; Anne Toulson,4,1,35,31
1656085080552,MATH 105,A02,093477,Staff,11,0,35,24
1656085086585,MATH 109,A01,083213,Ganzberger; Geoffrey Michael,1,1,34,33
1656085086585,MATH 109,A02,083214,Ganzberger; Geoffrey Michael,0,0,34,34
1656085086585,MATH 109,A03,093478,Staff,3,0,34,31
1656085086585,MATH 109,B01,083215,Ganzberger; Geoffrey Michael,4,0,32,28
1656085086585,MATH 109,B02,083216,Ganzberger; Geoffrey Michael,1,0,32,31
1656085086585,MATH 109,B03,093479,Staff,4,0,32,28
1656085092609,MATH 142A,A01,083219,Chow; Bennett,2,0,32,30
1656085092609,MATH 142A,A02,083220,Chow; Bennett,8,0,32,24
1656085092609,MATH 142A,A03,093480,Staff,5,0,32,27
1656085092609,MATH 142A,B03,093481,Staff,4,0,32,28
1656085092609,MATH 142A,B04,093558,Staff,7,0,32,25
1656085092609,MATH 142A,B05,093559,Staff,0,0,32,32
1656085098638,MATH 193A,A01,083224,Rotar; Vladimir,1,2,34,33
1656085098638,MATH 193A,A02,083225,Rotar; Vladimir,3,0,34,31
1656085098638,MATH 193A,A03,083781,Rotar; Vladimir,3,0,34,31
1656085098638,MATH 193A,A04,083782,Rotar; Vladimir,7,0,34,27
1656085098638,MATH 193A,A05,093482,Rotar; Vladimir,1,0,34,33
1656085104661,MATH 197,001,091859,McAuley; Julian John,9999,0,9999,0
1656085104661,MATH 197,002,095566,Kedlaya; Kiran S.,9997,0,9999,2
1656085104661,MATH 197,003,095567,Xiao; Ming,9999,0,9999,0
1656085104661,MATH 197,004,095571,Perols; Johan Lars,9998,0,9999,1
1656085111725,COGS 9,A01,083615,Shannon; Kyle Michael,4,1,75,71
1656085117749,COGS 11,A01,083617,Boyle; Mary E. T.,16,1,48,32
1656085123778,COGS 13,A01,083071,Bastos; Amalia Pinkusfeld,8,2,71,63
1656085129803,COGS 14A,A01,092681,Semenuks; Arturs,8,23,100,92
1656085135831,COGS 14B,A01,083073,Cheng; Tzu-Han,8,0,63,55
1656085141854,COGS 17,A01,092677,Semenuks; Arturs,13,6,81,68
1656085147880,COGS 100,A01,083619,Allen; Michael Gordon,8,2,70,62
1656085153906,COGS 101A,A01,083621,Davis; Joshua Daniel,7,3,68,61
1656085159932,COGS 101B,A01,091572,Allen; Michael Gordon,7,0,65,58
1656085165974,COGS 101C,A01,083625,Delgado; Tania,11,0,35,24
1656085172008,COGS 107A,A01,083627,Boyle; Mary E. T.,5,2,60,55
1656085178034,COGS 118A,A01,083075,Gupta; Anjum,24,16,76,52
1656085184062,CSE 3,A50,083646,Miranda; Gregory Joseph,20,0,50,30
1656085190091,CSE 8A,A50,083650,Miranda; Gregory Joseph,13,11,56,43
1656085196114,CSE 11,A01,083080,Cao; Yingjun,1,60,40,39
1656085202140,CSE 12,A01,083652,Krause-Levy; Sophia Louisa,14,7,120,106
1656085208164,CSE 15L,A01,083654,Morris; Justin Loren,5,1,50,45
1656085208164,CSE 15L,A02,083655,Morris; Justin Loren,7,0,50,43
1656085214190,CSE 20,A01,083657,Tran; Khoa Dang,31,0,80,49
1656085220214,CSE 21,A01,095574,Bach; Quang Tran,28,0,48,20
1656085226247,CSE 30,A01,083084,Eldon; John,3,10,80,77
1656085226247,CSE 30,B01,095061,Bhaskar; Nishant,4,5,50,46
1656085232279,CSE 100,A01,083659,Cao; Yingjun,2,23,70,68
1656085238302,CSE 134B,A01,083661,Powell; Thomas Allan,11,6,100,89
1656085244333,CSE 140,A01,083663,Gungor; Onat,9,0,85,76
1656085250357,CSE 140L,A01,083088,Eldon; John,8,0,100,92
1656085256394,CSE 175,A01,083665,Kumar; Rakesh,2,0,25,23
1656085262421,CSE 190,A00,092507,Dubnov; Shlomo,3,0,20,17
1656085268450,ECE 45,A01,083139,Congero; Spencer William,5,2,75,70
1656085274478,ECE 65,A50,083695,Saad; Andrew S,8,0,30,22
1656085274478,ECE 65,A51,095125,Staff,23,0,26,3
1656085280502,ECE 109,A01,091882,Touri; Behrouz,5,4,70,65
1656085286533,ECE 180,A00,083140,Abi Samra; Nicholas Camill,1,0,30,29
1656085286533,ECE 180,B00,083141,Abi Samra; Nicholas Camill,4,8,30,26
1656085292560,MATH 10A,A01,083735,Patchell; Gregory David,1,0,30,29
1656085292560,MATH 10A,A02,083736,Patchell; Gregory David,23,0,30,7
1656085292560,MATH 10A,A03,083737,Patchell; Gregory David,16,0,30,14
1656085298584,MATH 10B,A01,083207,Lim; Seonhee,3,1,34,31
1656085298584,MATH 10B,A02,083208,Lim; Seonhee,10,1,35,25
1656085298584,MATH 10B,A03,093472,Staff,4,1,34,30
1656085298584,MATH 10B,B01,083739,Sinha; Shubham,12,0,30,18
1656085304609,MATH 18,A01,083743,Cinel; Cameron Alexander,7,0,30,23
1656085304609,MATH 18,A02,083744,Cinel; Cameron Alexander,12,0,30,18
1656085304609,MATH 18,A03,083745,Cinel; Cameron Alexander,3,0,30,27
1656085304609,MATH 18,B01,083748,Ma; Zilu,1,0,36,35
1656085304609,MATH 18,B02,083749,Ma; Zilu,2,0,36,34
1656085304609,MATH 18,B03,083750,Ma; Zilu,0,0,36,36
1656085304609,MATH 18,B04,083751,Ma; Zilu,0,0,36,36
1656085304609,MATH 18,B05,093473,Staff,3,0,36,33
1656085304609,MATH 18,B06,093474,Staff,4,0,36,32
1656085310656,MATH 20A,A01,083754,Zheng; Zequn,11,0,40,29
1656085316682,MATH 20B,A01,083756,Briones; Jor-el Thomas Caparas,0,0,36,36
1656085316682,MATH 20B,A02,083757,Briones; Jor-el Thomas Caparas,2,0,36,34
1656085316682,MATH 20B,A03,093475,Staff,3,0,36,33
1656085322705,MATH 20C,A01,083760,Briones; Jor-el Thomas Caparas,2,2,35,33
1656085322705,MATH 20C,A02,083761,Briones; Jor-el Thomas Caparas,9,1,35,26
1656085322705,MATH 20C,A03,093476,Staff,1,1,35,34
1656085322705,MATH 20C,B01,083762,Bach; Quang Tran,4,0,30,26
1656085328735,MATH 20D,A01,083765,Tran; Brian Kha,3,0,30,27
1656085328735,MATH 20D,A02,083766,Tran; Brian Kha,0,1,30,30
1656085328735,MATH 20D,A03,083767,Tran; Brian Kha,2,0,30,28
1656085334763,MATH 20E,A01,083771,Ganguly; Soumya,4,1,32,28
1656085334763,MATH 20E,A02,083772,Ganguly; Soumya,2,1,32,30
1656085334763,MATH 20E,B01,083773,Ciotti; Benjamin,15,0,35,20
1656085334763,MATH 20E,B02,083774,Ciotti; Benjamin,15,0,35,20
1656085340790,MATH 103A,A01,083777,Greenfeld; Be'Eri,3,0,36,33
1656085340790,MATH 103A,A02,083778,Greenfeld; Be'Eri,3,0,36,33
1656085340790,MATH 103A,A03,093561,Staff,4,1,36,32
1656085340790,MATH 103A,B01,083779,Greenfeld; Be'Eri,8,1,36,28
1656085340790,MATH 103A,B02,083780,Greenfeld; Be'Eri,0,0,36,36
1656085340790,MATH 103A,B03,093562,Staff,0,0,36,36
1656085346817,MATH 105,A01,085443,Carter; Anne Toulson,4,1,35,31
1656085346817,MATH 105,A02,093477,Staff,11,0,35,24
1656085352864,MATH 109,A01,083213,Ganzberger; Geoffrey Michael,1,1,34,33
1656085352864,MATH 109,A02,083214,Ganzberger; Geoffrey Michael,0,0,34,34
1656085352864,MATH 109,A03,093478,Staff,3,0,34,31
1656085352864,MATH 109,B01,083215,Ganzberger; Geoffrey Michael,4,0,32,28
1656085352864,MATH 109,B02,083216,Ganzberger; Geoffrey Michael,1,0,32,31
1656085352864,MATH 109,B03,093479,Staff,4,0,32,28
1656085358893,MATH 142A,A01,083219,Chow; Bennett,2,0,32,30
1656085358893,MATH 142A,A02,083220,Chow; Bennett,8,0,32,24
1656085358893,MATH 142A,A03,093480,Staff,5,0,32,27
1656085358893,MATH 142A,B03,093481,Staff,4,0,32,28
1656085358893,MATH 142A,B04,093558,Staff,7,0,32,25
1656085358893,MATH 142A,B05,093559,Staff,0,0,32,32
1656085364923,MATH 193A,A01,083224,Rotar; Vladimir,1,2,34,33
1656085364923,MATH 193A,A02,083225,Rotar; Vladimir,3,0,34,31
1656085364923,MATH 193A,A03,083781,Rotar; Vladimir,3,0,34,31
1656085364923,MATH 193A,A04,083782,Rotar; Vladimir,7,0,34,27
1656085364923,MATH 193A,A05,093482,Rotar; Vladimir,1,0,34,33
1656085370950,MATH 197,001,091859,McAuley; Julian John,9999,0,9999,0
1656085370950,MATH 197,002,095566,Kedlaya; Kiran S.,9997,0,9999,2
1656085370950,MATH 197,003,095567,Xiao; Ming,9999,0,9999,0
1656085370950,MATH 197,004,095571,Perols; Johan Lars,9998,0,9999,1
1656085378011,COGS 9,A01,083615,Shannon; Kyle Michael,4,1,75,71
1656085384117,COGS 11,A01,083617,Boyle; Mary E. T.,16,1,48,32
1656085390141,COGS 13,A01,083071,Bastos; Amalia Pinkusfeld,8,2,71,63
1656085396165,COGS 14A,A01,092681,Semenuks; Arturs,8,23,100,92
1656085402188,COGS 14B,A01,083073,Cheng; Tzu-Han,8,0,63,55
1656085408214,COGS 17,A01,092677,Semenuks; Arturs,13,6,81,68
1656085414238,COGS 100,A01,083619,Allen; Michael Gordon,8,2,70,62
1656085420264,COGS 101A,A01,083621,Davis; Joshua Daniel,7,3,68,61
1656085426291,COGS 101B,A01,091572,Allen; Michael Gordon,7,0,65,58
1656085432315,COGS 101C,A01,083625,Delgado; Tania,11,0,35,24
1656085438351,COGS 107A,A01,083627,Boyle; Mary E. T.,5,2,60,55
1656085444379,COGS 118A,A01,083075,Gupta; Anjum,24,16,76,52
1656085450408,CSE 3,A50,083646,Miranda; Gregory Joseph,20,0,50,30
1656085456436,CSE 8A,A50,083650,Miranda; Gregory Joseph,13,11,56,43
1656085462462,CSE 11,A01,083080,Cao; Yingjun,1,60,40,39
1656085468484,CSE 12,A01,083652,Krause-Levy; Sophia Louisa,14,7,120,106
1656085474509,CSE 15L,A01,083654,Morris; Justin Loren,5,1,50,45
1656085474509,CSE 15L,A02,083655,Morris; Justin Loren,7,0,50,43
1656085480530,CSE 20,A01,083657,Tran; Khoa Dang,31,0,80,49
1656085486554,CSE 21,A01,095574,Bach; Quang Tran,28,0,48,20
1656085492578,CSE 30,A01,083084,Eldon; John,3,10,80,77
1656085492578,CSE 30,B01,095061,Bhaskar; Nishant,4,5,50,46
1656085498603,CSE 100,A01,083659,Cao; Yingjun,2,23,70,68
1656085504629,CSE 134B,A01,083661,Powell; Thomas Allan,11,6,100,89
1656085510655,CSE 140,A01,083663,Gungor; Onat,9,0,85,76
1656085516690,CSE 140L,A01,083088,Eldon; John,8,0,100,92
1656085522714,CSE 175,A01,083665,Kumar; Rakesh,2,0,25,23
1656085528740,CSE 190,A00,092507,Dubnov; Shlomo,3,0,20,17
1656085534767,ECE 45,A01,083139,Congero; Spencer William,5,2,75,70
1656085540789,ECE 65,A50,083695,Saad; Andrew S,8,0,30,22
1656085540789,ECE 65,A51,095125,Staff,23,0,26,3
1656085546817,ECE 109,A01,091882,Touri; Behrouz,5,4,70,65
1656085552839,ECE 180,A00,083140,Abi Samra; Nicholas Camill,1,0,30,29
1656085552839,ECE 180,B00,083141,Abi Samra; Nicholas Camill,4,8,30,26
1656085558865,MATH 10A,A01,083735,Patchell; Gregory David,1,0,30,29
1656085558865,MATH 10A,A02,083736,Patchell; Gregory David,23,0,30,7
1656085558865,MATH 10A,A03,083737,Patchell; Gregory David,16,0,30,14
1656085564895,MATH 10B,A01,083207,Lim; Seonhee,3,1,34,31
1656085564895,MATH 10B,A02,083208,Lim; Seonhee,10,1,35,25
1656085564895,MATH 10B,A03,093472,Staff,4,1,34,30
1656085564895,MATH 10B,B01,083739,Sinha; Shubham,12,0,30,18
1656085570938,MATH 18,A01,083743,Cinel; Cameron Alexander,7,0,30,23
1656085570938,MATH 18,A02,083744,Cinel; Cameron Alexander,12,0,30,18
1656085570938,MATH 18,A03,083745,Cinel; Cameron Alexander,3,0,30,27
1656085570938,MATH 18,B01,083748,Ma; Zilu,1,0,36,35
1656085570938,MATH 18,B02,083749,Ma; Zilu,2,0,36,34
1656085570938,MATH 18,B03,083750,Ma; Zilu,0,0,36,36
1656085570938,MATH 18,B04,083751,Ma; Zilu,0,0,36,36
1656085570938,MATH 18,B05,093473,Staff,3,0,36,33
1656085570938,MATH 18,B06,093474,Staff,4,0,36,32
1656085576968,MATH 20A,A01,083754,Zheng; Zequn,11,0,40,29
1656085582994,MATH 20B,A01,083756,Briones; Jor-el Thomas Caparas,0,0,36,36
1656085582994,MATH 20B,A02,083757,Briones; Jor-el Thomas Caparas,2,0,36,34
1656085582994,MATH 20B,A03,093475,Staff,3,0,36,33
1656085589028,MATH 20C,A01,083760,Briones; Jor-el Thomas Caparas,2,2,35,33
1656085589028,MATH 20C,A02,083761,Briones; Jor-el Thomas Caparas,9,1,35,26
1656085589028,MATH 20C,A03,093476,Staff,1,1,35,34
1656085589028,MATH 20C,B01,083762,Bach; Quang Tran,4,0,30,26
1656085595052,MATH 20D,A01,083765,Tran; Brian Kha,3,0,30,27
1656085595052,MATH 20D,A02,083766,Tran; Brian Kha,0,1,30,30
1656085595052,MATH 20D,A03,083767,Tran; Brian Kha,2,0,30,28
1656085601075,MATH 20E,A01,083771,Ganguly; Soumya,4,1,32,28
1656085601075,MATH 20E,A02,083772,Ganguly; Soumya,2,1,32,30
1656085601075,MATH 20E,B01,083773,Ciotti; Benjamin,15,0,35,20
1656085601075,MATH 20E,B02,083774,Ciotti; Benjamin,15,0,35,20
1656085607099,MATH 103A,A01,083777,Greenfeld; Be'Eri,3,0,36,33
1656085607099,MATH 103A,A02,083778,Greenfeld; Be'Eri,3,0,36,33
1656085607099,MATH 103A,A03,093561,Staff,4,1,36,32
1656085607099,MATH 103A,B01,083779,Greenfeld; Be'Eri,8,1,36,28
1656085607099,MATH 103A,B02,083780,Greenfeld; Be'Eri,0,0,36,36
1656085607099,MATH 103A,B03,093562,Staff,0,0,36,36
1656085613126,MATH 105,A01,085443,Carter; Anne Toulson,4,1,35,31
1656085613126,MATH 105,A02,093477,Staff,11,0,35,24
1656085619153,MATH 109,A01,083213,Ganzberger; Geoffrey Michael,1,1,34,33
1656085619153,MATH 109,A02,083214,Ganzberger; Geoffrey Michael,0,0,34,34
1656085619153,MATH 109,A03,093478,Staff,3,0,34,31
1656085619153,MATH 109,B01,083215,Ganzberger; Geoffrey Michael,4,0,32,28
1656085619153,MATH 109,B02,083216,Ganzberger; Geoffrey Michael,1,0,32,31
1656085619153,MATH 109,B03,093479,Staff,4,0,32,28
1656085625180,MATH 142A,A01,083219,Chow; Bennett,2,0,32,30
1656085625180,MATH 142A,A02,083220,Chow; Bennett,8,0,32,24
1656085625180,MATH 142A,A03,093480,Staff,5,0,32,27
1656085625180,MATH 142A,B03,093481,Staff,4,0,32,28
1656085625180,MATH 142A,B04,093558,Staff,7,0,32,25
1656085625180,MATH 142A,B05,093559,Staff,0,0,32,32
1656085631209,MATH 193A,A01,083224,Rotar; Vladimir,1,2,34,33
1656085631209,MATH 193A,A02,083225,Rotar; Vladimir,2,0,34,32
1656085631209,MATH 193A,A03,083781,Rotar; Vladimir,3,0,34,31
1656085631209,MATH 193A,A04,083782,Rotar; Vladimir,7,0,34,27
1656085631209,MATH 193A,A05,093482,Rotar; Vladimir,1,0,34,33
1656085637231,MATH 197,001,091859,McAuley; Julian John,9999,0,9999,0
1656085637231,MATH 197,002,095566,Kedlaya; Kiran S.,9997,0,9999,2
1656085637231,MATH 197,003,095567,Xiao; Ming,9999,0,9999,0
1656085637231,MATH 197,004,095571,Perols; Johan Lars,9998,0,9999,1
1656085644284,COGS 9,A01,083615,Shannon; Kyle Michael,4,1,75,71
1656085650312,COGS 11,A01,083617,Boyle; Mary E. T.,16,1,48,32
1656085656341,COGS 13,A01,083071,Bastos; Amalia Pinkusfeld,8,2,71,63
1656085662368,COGS 14A,A01,092681,Semenuks; Arturs,8,23,100,92
1656085668394,COGS 14B,A01,083073,Cheng; Tzu-Han,8,0,63,55
1656085674420,COGS 17,A01,092677,Semenuks; Arturs,13,6,81,68
1656085680449,COGS 100,A01,083619,Allen; Michael Gordon,8,2,70,62
1656085686476,COGS 101A,A01,083621,Davis; Joshua Daniel,7,3,68,61
1656085692506,COGS 101B,A01,091572,Allen; Michael Gordon,7,0,65,58
1656085698657,COGS 101C,A01,083625,Delgado; Tania,11,0,35,24
1656085704683,COGS 107A,A01,083627,Boyle; Mary E. T.,5,2,60,55
1656085710706,COGS 118A,A01,083075,Gupta; Anjum,24,16,76,52
1656085716735,CSE 3,A50,083646,Miranda; Gregory Joseph,20,0,50,30
1656085722772,CSE 8A,A50,083650,Miranda; Gregory Joseph,13,11,56,43
1656085728795,CSE 11,A01,083080,Cao; Yingjun,1,60,40,39
1656085734831,CSE 12,A01,083652,Krause-Levy; Sophia Louisa,14,7,120,106
1656085740855,CSE 15L,A01,083654,Morris; Justin Loren,5,1,50,45
1656085740855,CSE 15L,A02,083655,Morris; Justin Loren,7,0,50,43
1656085746913,CSE 20,A01,083657,Tran; Khoa Dang,31,0,80,49
1656085752936,CSE 21,A01,095574,Bach; Quang Tran,28,0,48,20
1656085758964,CSE 30,A01,083084,Eldon; John,3,10,80,77
1656085758964,CSE 30,B01,095061,Bhaskar; Nishant,4,5,50,46
1656085764993,CSE 100,A01,083659,Cao; Yingjun,2,23,70,68
1656085771017,CSE 134B,A01,083661,Powell; Thomas Allan,11,6,100,89
1656085777040,CSE 140,A01,083663,Gungor; Onat,9,0,85,76
1656085783076,CSE 140L,A01,083088,Eldon; John,8,0,100,92
1656085789112,CSE 175,A01,083665,Kumar; Rakesh,2,0,25,23
1656085795135,CSE 190,A00,092507,Dubnov; Shlomo,3,0,20,17
1656085801162,ECE 45,A01,083139,Congero; Spencer William,5,2,75,70
1656085807186,ECE 65,A50,083695,Saad; Andrew S,8,0,30,22
1656085807186,ECE 65,A51,095125,Staff,23,0,26,3
1656085813218,ECE 109,A01,091882,Touri; Behrouz,5,4,70,65
1656085819248,ECE 180,A00,083140,Abi Samra; Nicholas Camill,1,0,30,29
1656085819248,ECE 180,B00,083141,Abi Samra; Nicholas Camill,4,8,30,26
1656085825273,MATH 10A,A01,083735,Patchell; Gregory David,1,0,30,29
1656085825273,MATH 10A,A02,083736,Patchell; Gregory David,23,0,30,7
1656085825273,MATH 10A,A03,083737,Patchell; Gregory David,16,0,30,14
1656085831303,MATH 10B,A01,083207,Lim; Seonhee,3,1,34,31
1656085831303,MATH 10B,A02,083208,Lim; Seonhee,10,1,35,25
1656085831303,MATH 10B,A03,093472,Staff,4,1,34,30
1656085831303,MATH 10B,B01,083739,Sinha; Shubham,12,0,30,18
1656085837344,MATH 18,A01,083743,Cinel; Cameron Alexander,7,0,30,23
1656085837344,MATH 18,A02,083744,Cinel; Cameron Alexander,12,0,30,18
1656085837344,MATH 18,A03,083745,Cinel; Cameron Alexander,3,0,30,27
1656085837344,MATH 18,B01,083748,Ma; Zilu,1,0,36,35
1656085837344,MATH 18,B02,083749,Ma; Zilu,2,0,36,34
1656085837344,MATH 18,B03,083750,Ma; Zilu,0,0,36,36
1656085837344,MATH 18,B04,083751,Ma; Zilu,0,0,36,36
1656085837344,MATH 18,B05,093473,Staff,3,0,36,33
1656085837344,MATH 18,B06,093474,Staff,4,0,36,32
1656085843380,MATH 20A,A01,083754,Zheng; Zequn,11,0,40,29
1656085849406,MATH 20B,A01,083756,Briones; Jor-el Thomas Caparas,0,0,36,36
1656085849406,MATH 20B,A02,083757,Briones; Jor-el Thomas Caparas,2,0,36,34
1656085849406,MATH 20B,A03,093475,Staff,3,0,36,33
1656085855433,MATH 20C,A01,083760,Briones; Jor-el Thomas Caparas,2,2,35,33
1656085855433,MATH 20C,A02,083761,Briones; Jor-el Thomas Caparas,9,1,35,26
1656085855433,MATH 20C,A03,093476,Staff,1,1,35,34
1656085855433,MATH 20C,B01,083762,Bach; Quang Tran,4,0,30,26
1656085861465,MATH 20D,A01,083765,Tran; Brian Kha,3,0,30,27
1656085861465,MATH 20D,A02,083766,Tran; Brian Kha,0,1,30,30
1656085861465,MATH 20D,A03,083767,Tran; Brian Kha,2,0,30,28
1656085867487,MATH 20E,A01,083771,Ganguly; Soumya,4,1,32,28
1656085867487,MATH 20E,A02,083772,Ganguly; Soumya,2,1,32,30
1656085867487,MATH 20E,B01,083773,Ciotti; Benjamin,15,0,35,20
1656085867487,MATH 20E,B02,083774,Ciotti; Benjamin,15,0,35,20
1656085873510,MATH 103A,A01,083777,Greenfeld; Be'Eri,3,0,36,33
1656085873510,MATH 103A,A02,083778,Greenfeld; Be'Eri,3,0,36,33
1656085873510,MATH 103A,A03,093561,Staff,4,1,36,32
1656085873510,MATH 103A,B01,083779,Greenfeld; Be'Eri,8,1,36,28
1656085873510,MATH 103A,B02,083780,Greenfeld; Be'Eri,0,0,36,36
1656085873510,MATH 103A,B03,093562,Staff,0,0,36,36
1656085879534,MATH 105,A01,085443,Carter; Anne Toulson,4,1,35,31
1656085879534,MATH 105,A02,093477,Staff,11,0,35,24
1656085885558,MATH 109,A01,083213,Ganzberger; Geoffrey Michael,1,1,34,33
1656085885558,MATH 109,A02,083214,Ganzberger; Geoffrey Michael,0,0,34,34
1656085885558,MATH 109,A03,093478,Staff,3,0,34,31
1656085885558,MATH 109,B01,083215,Ganzberger; Geoffrey Michael,4,0,32,28
1656085885558,MATH 109,B02,083216,Ganzberger; Geoffrey Michael,1,0,32,31
1656085885558,MATH 109,B03,093479,Staff,4,0,32,28
1656085891586,MATH 142A,A01,083219,Chow; Bennett,2,0,32,30
1656085891586,MATH 142A,A02,083220,Chow; Bennett,8,0,32,24
1656085891586,MATH 142A,A03,093480,Staff,5,0,32,27
1656085891586,MATH 142A,B03,093481,Staff,4,0,32,28
1656085891586,MATH 142A,B04,093558,Staff,7,0,32,25
1656085891586,MATH 142A,B05,093559,Staff,0,0,32,32
1656085897611,MATH 193A,A01,083224,Rotar; Vladimir,1,2,34,33
1656085897611,MATH 193A,A02,083225,Rotar; Vladimir,2,0,34,32
1656085897611,MATH 193A,A03,083781,Rotar; Vladimir,3,0,34,31
1656085897611,MATH 193A,A04,083782,Rotar; Vladimir,7,0,34,27
1656085897611,MATH 193A,A05,093482,Rotar; Vladimir,1,0,34,33
1656085903635,MATH 197,001,091859,McAuley; Julian John,9999,0,9999,0
1656085903635,MATH 197,002,095566,Kedlaya; Kiran S.,9997,0,9999,2
1656085903635,MATH 197,003,095567,Xiao; Ming,9999,0,9999,0
1656085903635,MATH 197,004,095571,Perols; Johan Lars,9998,0,9999,1
1656085910698,COGS 9,A01,083615,Shannon; Kyle Michael,4,1,75,71
1656085916722,COGS 11,A01,083617,Boyle; Mary E. T.,16,1,48,32
1656085922750,COGS 13,A01,083071,Bastos; Amalia Pinkusfeld,8,2,71,63
1656085928776,COGS 14A,A01,092681,Semenuks; Arturs,8,23,100,92
1656085934806,COGS 14B,A01,083073,Cheng; Tzu-Han,8,0,63,55
1656085940861,COGS 17,A01,092677,Semenuks; Arturs,13,6,81,68
1656085946884,COGS 100,A01,083619,Allen; Michael Gordon,8,2,70,62
1656085952911,COGS 101A,A01,083621,Davis; Joshua Daniel,7,3,68,61
1656085958942,COGS 101B,A01,091572,Allen; Michael Gordon,7,0,65,58
1656085964965,COGS 101C,A01,083625,Delgado; Tania,11,0,35,24
1656085970987,COGS 107A,A01,083627,Boyle; Mary E. T.,5,2,60,55
1656085977011,COGS 118A,A01,083075,Gupta; Anjum,24,16,76,52
1656085983141,CSE 3,A50,083646,Miranda; Gregory Joseph,20,0,50,30
1656085989165,CSE 8A,A50,083650,Miranda; Gregory Joseph,13,11,56,43
1656085995195,CSE 11,A01,083080,Cao; Yingjun,1,60,40,39
1656086001219,CSE 12,A01,083652,Krause-Levy; Sophia Louisa,14,7,120,106
1656086007250,CSE 15L,A01,083654,Morris; Justin Loren,5,1,50,45
1656086007250,CSE 15L,A02,083655,Morris; Justin Loren,7,0,50,43
1656086022924,CSE 20,A01,083657,Tran; Khoa Dang,31,0,80,49
1656086028947,CSE 21,A01,095574,Bach; Quang Tran,28,0,48,20
1656086034973,CSE 30,A01,083084,Eldon; John,3,10,80,77
1656086034973,CSE 30,B01,095061,Bhaskar; Nishant,4,5,50,46
1656086041008,CSE 100,A01,083659,Cao; Yingjun,2,23,70,68
1656086047032,CSE 134B,A01,083661,Powell; Thomas Allan,11,6,100,89
1656086053056,CSE 140,A01,083663,Gungor; Onat,9,0,85,76
1656086059080,CSE 140L,A01,083088,Eldon; John,8,0,100,92
1656086065117,CSE 175,A01,083665,Kumar; Rakesh,2,0,25,23
1656086071139,CSE 190,A00,092507,Dubnov; Shlomo,3,0,20,17
1656086077163,ECE 45,A01,083139,Congero; Spencer William,5,2,75,70
1656086083188,ECE 65,A50,083695,Saad; Andrew S,8,0,30,22
1656086083188,ECE 65,A51,095125,Staff,23,0,26,3
1656086089216,ECE 109,A01,091882,Touri; Behrouz,5,4,70,65
1656086095240,ECE 180,A00,083140,Abi Samra; Nicholas Camill,1,0,30,29
1656086095240,ECE 180,B00,083141,Abi Samra; Nicholas Camill,4,8,30,26
1656086101274,MATH 10A,A01,083735,Patchell; Gregory David,1,0,30,29
1656086101274,MATH 10A,A02,083736,Patchell; Gregory David,23,0,30,7
1656086101274,MATH 10A,A03,083737,Patchell; Gregory David,16,0,30,14
1656086107303,MATH 10B,A01,083207,Lim; Seonhee,3,1,34,31
1656086107303,MATH 10B,A02,083208,Lim; Seonhee,10,1,35,25
1656086107303,MATH 10B,A03,093472,Staff,4,2,34,30
1656086107303,MATH 10B,B01,083739,Sinha; Shubham,12,0,30,18
1656086113336,MATH 18,A01,083743,Cinel; Cameron Alexander,7,0,30,23
1656086113336,MATH 18,A02,083744,Cinel; Cameron Alexander,12,0,30,18
1656086113336,MATH 18,A03,083745,Cinel; Cameron Alexander,3,0,30,27
1656086113336,MATH 18,B01,083748,Ma; Zilu,1,0,36,35
1656086113336,MATH 18,B02,083749,Ma; Zilu,2,0,36,34
1656086113336,MATH 18,B03,083750,Ma; Zilu,0,0,36,36
1656086113336,MATH 18,B04,083751,Ma; Zilu,0,0,36,36
1656086113336,MATH 18,B05,093473,Staff,3,0,36,33
1656086113336,MATH 18,B06,093474,Staff,4,0,36,32
1656086119359,MATH 20A,A01,083754,Zheng; Zequn,11,0,40,29
1656086125385,MATH 20B,A01,083756,Briones; Jor-el Thomas Caparas,0,0,36,36
1656086125385,MATH 20B,A02,083757,Briones; Jor-el Thomas Caparas,2,0,36,34
1656086125385,MATH 20B,A03,093475,Staff,3,0,36,33
1656086131420,MATH 20C,A01,083760,Briones; Jor-el Thomas Caparas,2,2,35,33
1656086131420,MATH 20C,A02,083761,Briones; Jor-el Thomas Caparas,9,1,35,26
1656086131420,MATH 20C,A03,093476,Staff,1,1,35,34
1656086131420,MATH 20C,B01,083762,Bach; Quang Tran,4,0,30,26
1656086137443,MATH 20D,A01,083765,Tran; Brian Kha,3,0,30,27
1656086137443,MATH 20D,A02,083766,Tran; Brian Kha,0,1,30,30
1656086137443,MATH 20D,A03,083767,Tran; Brian Kha,2,0,30,28
1656086143467,MATH 20E,A01,083771,Ganguly; Soumya,4,1,32,28
1656086143467,MATH 20E,A02,083772,Ganguly; Soumya,2,1,32,30
1656086143467,MATH 20E,B01,083773,Ciotti; Benjamin,15,0,35,20
1656086143467,MATH 20E,B02,083774,Ciotti; Benjamin,15,0,35,20
1656086149496,MATH 103A,A01,083777,Greenfeld; Be'Eri,3,0,36,33
1656086149496,MATH 103A,A02,083778,Greenfeld; Be'Eri,3,0,36,33
1656086149496,MATH 103A,A03,093561,Staff,4,1,36,32
1656086149496,MATH 103A,B01,083779,Greenfeld; Be'Eri,8,1,36,28
1656086149496,MATH 103A,B02,083780,Greenfeld; Be'Eri,0,0,36,36
1656086149496,MATH 103A,B03,093562,Staff,0,0,36,36
1656086155525,MATH 105,A01,085443,Carter; Anne Toulson,4,1,35,31
1656086155525,MATH 105,A02,093477,Staff,11,0,35,24
1656086161549,MATH 109,A01,083213,Ganzberger; Geoffrey Michael,1,1,34,33
1656086161549,MATH 109,A02,083214,Ganzberger; Geoffrey Michael,0,0,34,34
1656086161549,MATH 109,A03,093478,Staff,3,0,34,31
1656086161549,MATH 109,B01,083215,Ganzberger; Geoffrey Michael,4,0,32,28
1656086161549,MATH 109,B02,083216,Ganzberger; Geoffrey Michael,1,0,32,31
1656086161549,MATH 109,B03,093479,Staff,4,0,32,28
1656086167578,MATH 142A,A01,083219,Chow; Bennett,2,0,32,30
1656086167578,MATH 142A,A02,083220,Chow; Bennett,8,0,32,24
1656086167578,MATH 142A,A03,093480,Staff,5,0,32,27
1656086167578,MATH 142A,B03,093481,Staff,4,0,32,28
1656086167578,MATH 142A,B04,093558,Staff,7,0,32,25
1656086167578,MATH 142A,B05,093559,Staff,0,0,32,32
1656086173602,MATH 193A,A01,083224,Rotar; Vladimir,1,2,34,33
1656086173602,MATH 193A,A02,083225,Rotar; Vladimir,2,0,34,32
1656086173602,MATH 193A,A03,083781,Rotar; Vladimir,3,0,34,31
1656086173602,MATH 193A,A04,083782,Rotar; Vladimir,7,0,34,27
1656086173602,MATH 193A,A05,093482,Rotar; Vladimir,1,0,34,33
1656086179628,MATH 197,001,091859,McAuley; Julian John,9999,0,9999,0
1656086179628,MATH 197,002,095566,Kedlaya; Kiran S.,9997,0,9999,2
1656086179628,MATH 197,003,095567,Xiao; Ming,9999,0,9999,0
1656086179628,MATH 197,004,095571,Perols; Johan Lars,9998,0,9999,1
1656086186678,COGS 9,A01,083615,Shannon; Kyle Michael,4,1,75,71
1656086192704,COGS 11,A01,083617,Boyle; Mary E. T.,16,1,48,32
1656086198728,COGS 13,A01,083071,Bastos; Amalia Pinkusfeld,8,2,71,63
1656086204756,COGS 14A,A01,092681,Semenuks; Arturs,8,23,100,92
1656086210779,COGS 14B,A01,083073,Cheng; Tzu-Han,8,0,63,55
1656086216809,COGS 17,A01,092677,Semenuks; Arturs,13,6,81,68
1656086222836,COGS 100,A01,083619,Allen; Michael Gordon,8,2,70,62
1656086228860,COGS 101A,A01,083621,Davis; Joshua Daniel,7,3,68,61
1656086234889,COGS 101B,A01,091572,Allen; Michael Gordon,7,0,65,58
1656086240919,COGS 101C,A01,083625,Delgado; Tania,11,0,35,24
1656086246942,COGS 107A,A01,083627,Boyle; Mary E. T.,5,2,60,55
1656086252969,COGS 118A,A01,083075,Gupta; Anjum,24,16,76,52
1656086258992,CSE 3,A50,083646,Miranda; Gregory Joseph,20,0,50,30
1656086265017,CSE 8A,A50,083650,Miranda; Gregory Joseph,13,11,56,43
1656086271042,CSE 11,A01,083080,Cao; Yingjun,1,60,40,39
1656086277074,CSE 12,A01,083652,Krause-Levy; Sophia Louisa,14,7,120,106
1656086283101,CSE 15L,A01,083654,Morris; Justin Loren,5,1,50,45
1656086283101,CSE 15L,A02,083655,Morris; Justin Loren,7,0,50,43
1656086289128,CSE 20,A01,083657,Tran; Khoa Dang,31,0,80,49
1656086295153,CSE 21,A01,095574,Bach; Quang Tran,28,0,48,20
1656086301178,CSE 30,A01,083084,Eldon; John,3,10,80,77
1656086301178,CSE 30,B01,095061,Bhaskar; Nishant,4,5,50,46
1656086307202,CSE 100,A01,083659,Cao; Yingjun,2,23,70,68
1656086313226,CSE 134B,A01,083661,Powell; Thomas Allan,11,6,100,89
1656086319249,CSE 140,A01,083663,Gungor; Onat,9,0,85,76
1656086325276,CSE 140L,A01,083088,Eldon; John,8,0,100,92
1656086331303,CSE 175,A01,083665,Kumar; Rakesh,2,0,25,23
1656086337326,CSE 190,A00,092507,Dubnov; Shlomo,3,0,20,17
1656086343349,ECE 45,A01,083139,Congero; Spencer William,5,2,75,70
1656086349373,ECE 65,A50,083695,Saad; Andrew S,8,0,30,22
1656086349373,ECE 65,A51,095125,Staff,23,0,26,3
1656086355396,ECE 109,A01,091882,Touri; Behrouz,5,4,70,65
1656086361419,ECE 180,A00,083140,Abi Samra; Nicholas Camill,1,0,30,29
1656086361419,ECE 180,B00,083141,Abi Samra; Nicholas Camill,4,8,30,26
1656086367443,MATH 10A,A01,083735,Patchell; Gregory David,1,0,30,29
1656086367443,MATH 10A,A02,083736,Patchell; Gregory David,23,0,30,7
1656086367443,MATH 10A,A03,083737,Patchell; Gregory David,16,0,30,14
1656086373467,MATH 10B,A01,083207,Lim; Seonhee,3,1,34,31
1656086373467,MATH 10B,A02,083208,Lim; Seonhee,10,1,35,25
1656086373467,MATH 10B,A03,093472,Staff,4,2,34,30
1656086373467,MATH 10B,B01,083739,Sinha; Shubham,12,0,30,18
1656086379493,MATH 18,A01,083743,Cinel; Cameron Alexander,7,0,30,23
1656086379493,MATH 18,A02,083744,Cinel; Cameron Alexander,12,0,30,18
1656086379493,MATH 18,A03,083745,Cinel; Cameron Alexander,3,0,30,27
1656086379493,MATH 18,B01,083748,Ma; Zilu,1,0,36,35
1656086379493,MATH 18,B02,083749,Ma; Zilu,2,0,36,34
1656086379493,MATH 18,B03,083750,Ma; Zilu,0,0,36,36
1656086379493,MATH 18,B04,083751,Ma; Zilu,0,0,36,36
1656086379493,MATH 18,B05,093473,Staff,3,0,36,33
1656086379493,MATH 18,B06,093474,Staff,4,0,36,32
1656086385532,MATH 20A,A01,083754,Zheng; Zequn,11,0,40,29
1656086391556,MATH 20B,A01,083756,Briones; Jor-el Thomas Caparas,0,0,36,36
1656086391556,MATH 20B,A02,083757,Briones; Jor-el Thomas Caparas,2,0,36,34
1656086391556,MATH 20B,A03,093475,Staff,3,0,36,33
1656086397582,MATH 20C,A01,083760,Briones; Jor-el Thomas Caparas,2,2,35,33
1656086397582,MATH 20C,A02,083761,Briones; Jor-el Thomas Caparas,9,1,35,26
1656086397582,MATH 20C,A03,093476,Staff,1,1,35,34
1656086397582,MATH 20C,B01,083762,Bach; Quang Tran,4,0,30,26
1656086403607,MATH 20D,A01,083765,Tran; Brian Kha,3,0,30,27
1656086403607,MATH 20D,A02,083766,Tran; Brian Kha,0,1,30,30
1656086403607,MATH 20D,A03,083767,Tran; Brian Kha,2,0,30,28
1656086409631,MATH 20E,A01,083771,Ganguly; Soumya,4,1,32,28
1656086409631,MATH 20E,A02,083772,Ganguly; Soumya,2,1,32,30
1656086409631,MATH 20E,B01,083773,Ciotti; Benjamin,15,0,35,20
1656086409631,MATH 20E,B02,083774,Ciotti; Benjamin,15,0,35,20
1656086415663,MATH 103A,A01,083777,Greenfeld; Be'Eri,3,0,36,33
1656086415663,MATH 103A,A02,083778,Greenfeld; Be'Eri,3,0,36,33
1656086415663,MATH 103A,A03,093561,Staff,4,1,36,32
1656086415663,MATH 103A,B01,083779,Greenfeld; Be'Eri,8,1,36,28
1656086415663,MATH 103A,B02,083780,Greenfeld; Be'Eri,0,0,36,36
1656086415663,MATH 103A,B03,093562,Staff,0,0,36,36
1656086421695,MATH 105,A01,085443,Carter; Anne Toulson,4,1,35,31
1656086421695,MATH 105,A02,093477,Staff,11,0,35,24
1656086427719,MATH 109,A01,083213,Ganzberger; Geoffrey Michael,1,1,34,33
1656086427719,MATH 109,A02,083214,Ganzberger; Geoffrey Michael,0,0,34,34
1656086427719,MATH 109,A03,093478,Staff,3,0,34,31
1656086427719,MATH 109,B01,083215,Ganzberger; Geoffrey Michael,4,0,32,28
1656086427719,MATH 109,B02,083216,Ganzberger; Geoffrey Michael,1,0,32,31
1656086427719,MATH 109,B03,093479,Staff,4,0,32,28
1656086433744,MATH 142A,A01,083219,Chow; Bennett,2,0,32,30
1656086433744,MATH 142A,A02,083220,Chow; Bennett,8,0,32,24
1656086433744,MATH 142A,A03,093480,Staff,5,0,32,27
1656086433744,MATH 142A,B03,093481,Staff,4,0,32,28
1656086433744,MATH 142A,B04,093558,Staff,7,0,32,25
1656086433744,MATH 142A,B05,093559,Staff,0,0,32,32
1656086439769,MATH 193A,A01,083224,Rotar; Vladimir,1,2,34,33
1656086439769,MATH 193A,A02,083225,Rotar; Vladimir,2,0,34,32
1656086439769,MATH 193A,A03,083781,Rotar; Vladimir,3,0,34,31
1656086439769,MATH 193A,A04,083782,Rotar; Vladimir,7,0,34,27
1656086439769,MATH 193A,A05,093482,Rotar; Vladimir,1,0,34,33
1656086445805,MATH 197,001,091859,McAuley; Julian John,9999,0,9999,0
1656086445805,MATH 197,002,095566,Kedlaya; Kiran S.,9997,0,9999,2
1656086445805,MATH 197,003,095567,Xiao; Ming,9999,0,9999,0
1656086445805,MATH 197,004,095571,Perols; Johan Lars,9998,0,9999,1
1656086452869,COGS 9,A01,083615,Shannon; Kyle Michael,4,1,75,71
1656086458892,COGS 11,A01,083617,Boyle; Mary E. T.,16,1,48,32
1656086464920,COGS 13,A01,083071,Bastos; Amalia Pinkusfeld,8,2,71,63
1656086470943,COGS 14A,A01,092681,Semenuks; Arturs,8,23,100,92
1656086476966,COGS 14B,A01,083073,Cheng; Tzu-Han,8,0,63,55
1656086482996,COGS 17,A01,092677,Semenuks; Arturs,13,6,81,68
1656086489025,COGS 100,A01,083619,Allen; Michael Gordon,8,2,70,62
1656086495051,COGS 101A,A01,083621,Davis; Joshua Daniel,7,3,68,61
1656086501079,COGS 101B,A01,091572,Allen; Michael Gordon,7,0,65,58
1656086507105,COGS 101C,A01,083625,Delgado; Tania,11,0,35,24
1656086513129,COGS 107A,A01,083627,Boyle; Mary E. T.,5,2,60,55
1656086519162,COGS 118A,A01,083075,Gupta; Anjum,24,16,76,52
1656086525186,CSE 3,A50,083646,Miranda; Gregory Joseph,20,0,50,30
1656086531210,CSE 8A,A50,083650,Miranda; Gregory Joseph,13,11,56,43
1656086537241,CSE 11,A01,083080,Cao; Yingjun,1,60,40,39
1656086543264,CSE 12,A01,083652,Krause-Levy; Sophia Louisa,14,7,120,106
1656086549291,CSE 15L,A01,083654,Morris; Justin Loren,5,1,50,45
1656086549291,CSE 15L,A02,083655,Morris; Justin Loren,7,0,50,43
1656086555319,CSE 20,A01,083657,Tran; Khoa Dang,31,0,80,49
1656086561345,CSE 21,A01,095574,Bach; Quang Tran,28,0,48,20
1656086567368,CSE 30,A01,083084,Eldon; John,3,10,80,77
1656086567368,CSE 30,B01,095061,Bhaskar; Nishant,4,5,50,46
1656086573396,CSE 100,A01,083659,Cao; Yingjun,2,23,70,68
1656086579422,CSE 134B,A01,083661,Powell; Thomas Allan,11,6,100,89
1656086585463,CSE 140,A01,083663,Gungor; Onat,9,0,85,76
1656086591588,CSE 140L,A01,083088,Eldon; John,8,0,100,92
1656086597614,CSE 175,A01,083665,Kumar; Rakesh,2,0,25,23
1656086603638,CSE 190,A00,092507,Dubnov; Shlomo,3,0,20,17
1656086609663,ECE 45,A01,083139,Congero; Spencer William,5,2,75,70
1656086615688,ECE 65,A50,083695,Saad; Andrew S,8,0,30,22
1656086615688,ECE 65,A51,095125,Staff,23,0,26,3
1656086621710,ECE 109,A01,091882,Touri; Behrouz,5,4,70,65
1656086627741,ECE 180,A00,083140,Abi Samra; Nicholas Camill,1,0,30,29
1656086627741,ECE 180,B00,083141,Abi Samra; Nicholas Camill,4,8,30,26
1656086633768,MATH 10A,A01,083735,Patchell; Gregory David,1,0,30,29
1656086633768,MATH 10A,A02,083736,Patchell; Gregory David,23,0,30,7
1656086633768,MATH 10A,A03,083737,Patchell; Gregory David,16,0,30,14
1656086639792,MATH 10B,A01,083207,Lim; Seonhee,3,1,34,31
1656086639792,MATH 10B,A02,083208,Lim; Seonhee,10,1,35,25
1656086639792,MATH 10B,A03,093472,Staff,4,2,34,30
1656086639792,MATH 10B,B01,083739,Sinha; Shubham,12,0,30,18
1656086645817,MATH 18,A01,083743,Cinel; Cameron Alexander,7,0,30,23
1656086645817,MATH 18,A02,083744,Cinel; Cameron Alexander,12,0,30,18
1656086645817,MATH 18,A03,083745,Cinel; Cameron Alexander,3,0,30,27
1656086645817,MATH 18,B01,083748,Ma; Zilu,1,0,36,35
1656086645817,MATH 18,B02,083749,Ma; Zilu,2,0,36,34
1656086645817,MATH 18,B03,083750,Ma; Zilu,0,0,36,36
1656086645817,MATH 18,B04,083751,Ma; Zilu,0,0,36,36
1656086645817,MATH 18,B05,093473,Staff,3,0,36,33
1656086645817,MATH 18,B06,093474,Staff,4,0,36,32
1656086651844,MATH 20A,A01,083754,Zheng; Zequn,11,0,40,29
1656086657871,MATH 20B,A01,083756,Briones; Jor-el Thomas Caparas,0,0,36,36
1656086657871,MATH 20B,A02,083757,Briones; Jor-el Thomas Caparas,2,0,36,34
1656086657871,MATH 20B,A03,093475,Staff,3,0,36,33
1656086663900,MATH 20C,A01,083760,Briones; Jor-el Thomas Caparas,2,2,35,33
1656086663900,MATH 20C,A02,083761,Briones; Jor-el Thomas Caparas,9,1,35,26
1656086663900,MATH 20C,A03,093476,Staff,1,1,35,34
1656086663900,MATH 20C,B01,083762,Bach; Quang Tran,4,0,30,26
1656086669928,MATH 20D,A01,083765,Tran; Brian Kha,3,0,30,27
1656086669928,MATH 20D,A02,083766,Tran; Brian Kha,0,1,30,30
1656086669928,MATH 20D,A03,083767,Tran; Brian Kha,2,0,30,28
1656086675952,MATH 20E,A01,083771,Ganguly; Soumya,4,1,32,28
1656086675952,MATH 20E,A02,083772,Ganguly; Soumya,2,1,32,30
1656086675952,MATH 20E,B01,083773,Ciotti; Benjamin,15,0,35,20
1656086675952,MATH 20E,B02,083774,Ciotti; Benjamin,15,0,35,20
1656086681975,MATH 103A,A01,083777,Greenfeld; Be'Eri,3,0,36,33
1656086681975,MATH 103A,A02,083778,Greenfeld; Be'Eri,3,0,36,33
1656086681975,MATH 103A,A03,093561,Staff,4,1,36,32
1656086681975,MATH 103A,B01,083779,Greenfeld; Be'Eri,8,1,36,28
1656086681975,MATH 103A,B02,083780,Greenfeld; Be'Eri,0,0,36,36
1656086681975,MATH 103A,B03,093562,Staff,0,0,36,36
1656086687998,MATH 105,A01,085443,Carter; Anne Toulson,4,1,35,31
1656086687998,MATH 105,A02,093477,Staff,11,0,35,24
1656086694021,MATH 109,A01,083213,Ganzberger; Geoffrey Michael,1,1,34,33
1656086694021,MATH 109,A02,083214,Ganzberger; Geoffrey Michael,0,0,34,34
1656086694021,MATH 109,A03,093478,Staff,3,0,34,31
1656086694021,MATH 109,B01,083215,Ganzberger; Geoffrey Michael,4,0,32,28
1656086694021,MATH 109,B02,083216,Ganzberger; Geoffrey Michael,1,0,32,31
1656086694021,MATH 109,B03,093479,Staff,4,0,32,28
1656086700046,MATH 142A,A01,083219,Chow; Bennett,2,0,32,30
1656086700046,MATH 142A,A02,083220,Chow; Bennett,8,0,32,24
1656086700046,MATH 142A,A03,093480,Staff,5,0,32,27
1656086700046,MATH 142A,B03,093481,Staff,4,0,32,28
1656086700046,MATH 142A,B04,093558,Staff,7,0,32,25
1656086700046,MATH 142A,B05,093559,Staff,0,0,32,32
1656086706070,MATH 193A,A01,083224,Rotar; Vladimir,1,2,34,33
1656086706070,MATH 193A,A02,083225,Rotar; Vladimir,2,0,34,32
1656086706070,MATH 193A,A03,083781,Rotar; Vladimir,3,0,34,31
1656086706070,MATH 193A,A04,083782,Rotar; Vladimir,7,0,34,27
1656086706070,MATH 193A,A05,093482,Rotar; Vladimir,1,0,34,33
1656086712101,MATH 197,001,091859,McAuley; Julian John,9999,0,9999,0
1656086712101,MATH 197,002,095566,Kedlaya; Kiran S.,9997,0,9999,2
1656086712101,MATH 197,003,095567,Xiao; Ming,9999,0,9999,0
1656086712101,MATH 197,004,095571,Perols; Johan Lars,9998,0,9999,1
1656086719161,COGS 9,A01,083615,Shannon; Kyle Michael,4,1,75,71
1656086725183,COGS 11,A01,083617,Boyle; Mary E. T.,16,1,48,32
1656086731210,COGS 13,A01,083071,Bastos; Amalia Pinkusfeld,8,2,71,63
1656086737241,COGS 14A,A01,092681,Semenuks; Arturs,8,23,100,92
1656086743282,COGS 14B,A01,083073,Cheng; Tzu-Han,8,0,63,55
1656086749305,COGS 17,A01,092677,Semenuks; Arturs,13,6,81,68
1656086755328,COGS 100,A01,083619,Allen; Michael Gordon,8,2,70,62
1656086761355,COGS 101A,A01,083621,Davis; Joshua Daniel,7,3,68,61
1656086767377,COGS 101B,A01,091572,Allen; Michael Gordon,7,0,65,58
1656086773401,COGS 101C,A01,083625,Delgado; Tania,11,0,35,24
1656086779423,COGS 107A,A01,083627,Boyle; Mary E. T.,5,2,60,55
1656086785450,COGS 118A,A01,083075,Gupta; Anjum,24,16,76,52
1656086791474,CSE 3,A50,083646,Miranda; Gregory Joseph,20,0,50,30
1656086797496,CSE 8A,A50,083650,Miranda; Gregory Joseph,13,11,56,43
1656086803519,CSE 11,A01,083080,Cao; Yingjun,1,60,40,39
1656086809543,CSE 12,A01,083652,Krause-Levy; Sophia Louisa,14,7,120,106
1656086815571,CSE 15L,A01,083654,Morris; Justin Loren,5,1,50,45
1656086815571,CSE 15L,A02,083655,Morris; Justin Loren,7,0,50,43
1656086821596,CSE 20,A01,083657,Tran; Khoa Dang,31,0,80,49
1656086827622,CSE 21,A01,095574,Bach; Quang Tran,28,0,48,20
1656086833646,CSE 30,A01,083084,Eldon; John,3,10,80,77
1656086833646,CSE 30,B01,095061,Bhaskar; Nishant,4,5,50,46
1656086839673,CSE 100,A01,083659,Cao; Yingjun,2,23,70,68
1656086845700,CSE 134B,A01,083661,Powell; Thomas Allan,11,6,100,89
1656086851724,CSE 140,A01,083663,Gungor; Onat,9,0,85,76
1656086857749,CSE 140L,A01,083088,Eldon; John,8,0,100,92
1656086863780,CSE 175,A01,083665,Kumar; Rakesh,2,0,25,23
1656086869807,CSE 190,A00,092507,Dubnov; Shlomo,3,0,20,17
1656086875841,ECE 45,A01,083139,Congero; Spencer William,5,2,75,70
1656086881870,ECE 65,A50,083695,Saad; Andrew S,8,0,30,22
1656086881870,ECE 65,A51,095125,Staff,23,0,26,3
1656086887899,ECE 109,A01,091882,Touri; Behrouz,5,4,70,65
1656086893922,ECE 180,A00,083140,Abi Samra; Nicholas Camill,1,0,30,29
1656086893922,ECE 180,B00,083141,Abi Samra; Nicholas Camill,4,8,30,26
1656086899947,MATH 10A,A01,083735,Patchell; Gregory David,1,0,30,29
1656086899947,MATH 10A,A02,083736,Patchell; Gregory David,23,0,30,7
1656086899947,MATH 10A,A03,083737,Patchell; Gregory David,16,0,30,14
1656086905971,MATH 10B,A01,083207,Lim; Seonhee,3,1,34,31
1656086905971,MATH 10B,A02,083208,Lim; Seonhee,10,1,35,25
1656086905971,MATH 10B,A03,093472,Staff,4,1,34,30
1656086905971,MATH 10B,B01,083739,Sinha; Shubham,12,0,30,18
1656086911996,MATH 18,A01,083743,Cinel; Cameron Alexander,7,0,30,23
1656086911996,MATH 18,A02,083744,Cinel; Cameron Alexander,12,0,30,18
1656086911996,MATH 18,A03,083745,Cinel; Cameron Alexander,3,0,30,27
1656086911996,MATH 18,B01,083748,Ma; Zilu,1,0,36,35
1656086911996,MATH 18,B02,083749,Ma; Zilu,1,0,36,35
1656086911996,MATH 18,B03,083750,Ma; Zilu,0,0,36,36
1656086911996,MATH 18,B04,083751,Ma; Zilu,0,0,36,36
1656086911996,MATH 18,B05,093473,Staff,3,0,36,33
1656086911996,MATH 18,B06,093474,Staff,4,0,36,32
1656086918025,MATH 20A,A01,083754,Zheng; Zequn,11,0,40,29
1656086924049,MATH 20B,A01,083756,Briones; Jor-el Thomas Caparas,0,0,36,36
1656086924049,MATH 20B,A02,083757,Briones; Jor-el Thomas Caparas,2,0,36,34
1656086924049,MATH 20B,A03,093475,Staff,3,0,36,33
1656086930083,MATH 20C,A01,083760,Briones; Jor-el Thomas Caparas,2,2,35,33
1656086930083,MATH 20C,A02,083761,Briones; Jor-el Thomas Caparas,9,1,35,26
1656086930083,MATH 20C,A03,093476,Staff,1,1,35,34
1656086930083,MATH 20C,B01,083762,Bach; Quang Tran,4,0,30,26
1656086936129,MATH 20D,A01,083765,Tran; Brian Kha,3,0,30,27
1656086936129,MATH 20D,A02,083766,Tran; Brian Kha,0,1,30,30
1656086936129,MATH 20D,A03,083767,Tran; Brian Kha,2,0,30,28
1656086942156,MATH 20E,A01,083771,Ganguly; Soumya,4,1,32,28
1656086942156,MATH 20E,A02,083772,Ganguly; Soumya,2,1,32,30
1656086942156,MATH 20E,B01,083773,Ciotti; Benjamin,15,0,35,20
1656086942156,MATH 20E,B02,083774,Ciotti; Benjamin,15,0,35,20
1656086948186,MATH 103A,A01,083777,Greenfeld; Be'Eri,3,0,36,33
1656086948186,MATH 103A,A02,083778,Greenfeld; Be'Eri,3,0,36,33
1656086948186,MATH 103A,A03,093561,Staff,4,1,36,32
1656086948186,MATH 103A,B01,083779,Greenfeld; Be'Eri,8,1,36,28
1656086948186,MATH 103A,B02,083780,Greenfeld; Be'Eri,0,0,36,36
1656086948186,MATH 103A,B03,093562,Staff,0,0,36,36
1656086954211,MATH 105,A01,085443,Carter; Anne Toulson,4,1,35,31
1656086954211,MATH 105,A02,093477,Staff,11,0,35,24
1656086960236,MATH 109,A01,083213,Ganzberger; Geoffrey Michael,1,1,34,33
1656086960236,MATH 109,A02,083214,Ganzberger; Geoffrey Michael,0,0,34,34
1656086960236,MATH 109,A03,093478,Staff,3,0,34,31
1656086960236,MATH 109,B01,083215,Ganzberger; Geoffrey Michael,4,0,32,28
1656086960236,MATH 109,B02,083216,Ganzberger; Geoffrey Michael,1,0,32,31
1656086960236,MATH 109,B03,093479,Staff,4,0,32,28
1656086966261,MATH 142A,A01,083219,Chow; Bennett,2,0,32,30
1656086966261,MATH 142A,A02,083220,Chow; Bennett,8,0,32,24
1656086966261,MATH 142A,A03,093480,Staff,5,0,32,27
1656086966261,MATH 142A,B03,093481,Staff,4,0,32,28
1656086966261,MATH 142A,B04,093558,Staff,7,0,32,25
1656086966261,MATH 142A,B05,093559,Staff,0,0,32,32
1656086972291,MATH 193A,A01,083224,Rotar; Vladimir,1,2,34,33
1656086972291,MATH 193A,A02,083225,Rotar; Vladimir,2,0,34,32
1656086972291,MATH 193A,A03,083781,Rotar; Vladimir,3,0,34,31
1656086972291,MATH 193A,A04,083782,Rotar; Vladimir,7,0,34,27
1656086972291,MATH 193A,A05,093482,Rotar; Vladimir,1,0,34,33
1656086978315,MATH 197,001,091859,McAuley; Julian John,9999,0,9999,0
1656086978315,MATH 197,002,095566,Kedlaya; Kiran S.,9997,0,9999,2
1656086978315,MATH 197,003,095567,Xiao; Ming,9999,0,9999,0
1656086978315,MATH 197,004,095571,Perols; Johan Lars,9998,0,9999,1
1656086985371,COGS 9,A01,083615,Shannon; Kyle Michael,4,1,75,71
1656086991395,COGS 11,A01,083617,Boyle; Mary E. T.,16,1,48,32
1656086997422,COGS 13,A01,083071,Bastos; Amalia Pinkusfeld,8,2,71,63
1656087003451,COGS 14A,A01,092681,Semenuks; Arturs,8,23,100,92
1656087009478,COGS 14B,A01,083073,Cheng; Tzu-Han,8,0,63,55
1656087015509,COGS 17,A01,092677,Semenuks; Arturs,13,6,81,68
1656087021532,COGS 100,A01,083619,Allen; Michael Gordon,8,2,70,62
1656087027556,COGS 101A,A01,083621,Davis; Joshua Daniel,7,3,68,61
1656087033592,COGS 101B,A01,091572,Allen; Michael Gordon,7,0,65,58
1656087039616,COGS 101C,A01,083625,Delgado; Tania,11,0,35,24
1656087045641,COGS 107A,A01,083627,Boyle; Mary E. T.,5,2,60,55
1656087051667,COGS 118A,A01,083075,Gupta; Anjum,24,16,76,52
1656087057697,CSE 3,A50,083646,Miranda; Gregory Joseph,20,0,50,30
1656087063725,CSE 8A,A50,083650,Miranda; Gregory Joseph,13,11,56,43
1656087069750,CSE 11,A01,083080,Cao; Yingjun,1,60,40,39
1656087075772,CSE 12,A01,083652,Krause-Levy; Sophia Louisa,14,7,120,106
1656087081795,CSE 15L,A01,083654,Morris; Justin Loren,5,1,50,45
1656087081795,CSE 15L,A02,083655,Morris; Justin Loren,7,0,50,43
1656087087823,CSE 20,A01,083657,Tran; Khoa Dang,31,0,80,49
1656087093848,CSE 21,A01,095574,Bach; Quang Tran,28,0,48,20
1656087099880,CSE 30,A01,083084,Eldon; John,3,10,80,77
1656087099880,CSE 30,B01,095061,Bhaskar; Nishant,4,5,50,46
1656087105905,CSE 100,A01,083659,Cao; Yingjun,2,23,70,68
1656087111932,CSE 134B,A01,083661,Powell; Thomas Allan,11,6,100,89
1656087117961,CSE 140,A01,083663,Gungor; Onat,9,0,85,76
1656087123989,CSE 140L,A01,083088,Eldon; John,8,0,100,92
1656087130022,CSE 175,A01,083665,Kumar; Rakesh,2,0,25,23
1656087136051,CSE 190,A00,092507,Dubnov; Shlomo,3,0,20,17
1656087142074,ECE 45,A01,083139,Congero; Spencer William,5,2,75,70
1656087148098,ECE 65,A50,083695,Saad; Andrew S,8,0,30,22
1656087148098,ECE 65,A51,095125,Staff,23,0,26,3
1656087154121,ECE 109,A01,091882,Touri; Behrouz,5,4,70,65
1656087160148,ECE 180,A00,083140,Abi Samra; Nicholas Camill,1,0,30,29
1656087160148,ECE 180,B00,083141,Abi Samra; Nicholas Camill,4,8,30,26
1656087166171,MATH 10A,A01,083735,Patchell; Gregory David,1,0,30,29
1656087166171,MATH 10A,A02,083736,Patchell; Gregory David,23,0,30,7
1656087166171,MATH 10A,A03,083737,Patchell; Gregory David,16,0,30,14
1656087172196,MATH 10B,A01,083207,Lim; Seonhee,3,1,34,31
1656087172196,MATH 10B,A02,083208,Lim; Seonhee,10,1,35,25
1656087172196,MATH 10B,A03,093472,Staff,4,1,34,30
1656087172196,MATH 10B,B01,083739,Sinha; Shubham,12,0,30,18
1656087178226,MATH 18,A01,083743,Cinel; Cameron Alexander,7,0,30,23
1656087178226,MATH 18,A02,083744,Cinel; Cameron Alexander,12,0,30,18
1656087178226,MATH 18,A03,083745,Cinel; Cameron Alexander,3,0,30,27
1656087178226,MATH 18,B01,083748,Ma; Zilu,1,0,36,35
1656087178226,MATH 18,B02,083749,Ma; Zilu,1,0,36,35
1656087178226,MATH 18,B03,083750,Ma; Zilu,0,0,36,36
1656087178226,MATH 18,B04,083751,Ma; Zilu,0,0,36,36
1656087178226,MATH 18,B05,093473,Staff,3,0,36,33
1656087178226,MATH 18,B06,093474,Staff,4,0,36,32
1656087184251,MATH 20A,A01,083754,Zheng; Zequn,11,0,40,29
1656087190347,MATH 20B,A01,083756,Briones; Jor-el Thomas Caparas,0,0,36,36
1656087190347,MATH 20B,A02,083757,Briones; Jor-el Thomas Caparas,2,0,36,34
1656087190347,MATH 20B,A03,093475,Staff,3,0,36,33
1656087196376,MATH 20C,A01,083760,Briones; Jor-el Thomas Caparas,2,2,35,33
1656087196376,MATH 20C,A02,083761,Briones; Jor-el Thomas Caparas,9,1,35,26
1656087196376,MATH 20C,A03,093476,Staff,1,1,35,34
1656087196376,MATH 20C,B01,083762,Bach; Quang Tran,4,0,30,26
1656087202399,MATH 20D,A01,083765,Tran; Brian Kha,3,0,30,27
1656087202399,MATH 20D,A02,083766,Tran; Brian Kha,0,1,30,30
1656087202399,MATH 20D,A03,083767,Tran; Brian Kha,2,0,30,28
1656087208428,MATH 20E,A01,083771,Ganguly; Soumya,4,1,32,28
1656087208428,MATH 20E,A02,083772,Ganguly; Soumya,2,1,32,30
1656087208428,MATH 20E,B01,083773,Ciotti; Benjamin,15,0,35,20
1656087208428,MATH 20E,B02,083774,Ciotti; Benjamin,15,0,35,20
1656087214451,MATH 103A,A01,083777,Greenfeld; Be'Eri,3,0,36,33
1656087214451,MATH 103A,A02,083778,Greenfeld; Be'Eri,3,0,36,33
1656087214451,MATH 103A,A03,093561,Staff,4,1,36,32
1656087214451,MATH 103A,B01,083779,Greenfeld; Be'Eri,8,1,36,28
1656087214451,MATH 103A,B02,083780,Greenfeld; Be'Eri,0,0,36,36
1656087214451,MATH 103A,B03,093562,Staff,0,0,36,36
1656087220474,MATH 105,A01,085443,Carter; Anne Toulson,4,1,35,31
1656087220474,MATH 105,A02,093477,Staff,11,0,35,24
1656087226497,MATH 109,A01,083213,Ganzberger; Geoffrey Michael,1,1,34,33
1656087226497,MATH 109,A02,083214,Ganzberger; Geoffrey Michael,0,0,34,34
1656087226497,MATH 109,A03,093478,Staff,3,0,34,31
1656087226497,MATH 109,B01,083215,Ganzberger; Geoffrey Michael,4,0,32,28
1656087226497,MATH 109,B02,083216,Ganzberger; Geoffrey Michael,1,0,32,31
1656087226497,MATH 109,B03,093479,Staff,4,0,32,28
1656087232525,MATH 142A,A01,083219,Chow; Bennett,2,0,32,30
1656087232525,MATH 142A,A02,083220,Chow; Bennett,8,0,32,24
1656087232525,MATH 142A,A03,093480,Staff,5,0,32,27
1656087232525,MATH 142A,B03,093481,Staff,4,0,32,28
1656087232525,MATH 142A,B04,093558,Staff,7,0,32,25
1656087232525,MATH 142A,B05,093559,Staff,0,0,32,32
1656087238553,MATH 193A,A01,083224,Rotar; Vladimir,1,2,34,33
1656087238553,MATH 193A,A02,083225,Rotar; Vladimir,2,0,34,32
1656087238553,MATH 193A,A03,083781,Rotar; Vladimir,3,0,34,31
1656087238553,MATH 193A,A04,083782,Rotar; Vladimir,7,0,34,27
1656087238553,MATH 193A,A05,093482,Rotar; Vladimir,1,0,34,33
1656087244588,MATH 197,001,091859,McAuley; Julian John,9999,0,9999,0
1656087244588,MATH 197,002,095566,Kedlaya; Kiran S.,9997,0,9999,2
1656087244588,MATH 197,003,095567,Xiao; Ming,9999,0,9999,0
1656087244588,MATH 197,004,095571,Perols; Johan Lars,9998,0,9999,1
1656087251653,COGS 9,A01,083615,Shannon; Kyle Michael,4,1,75,71
1656087257680,COGS 11,A01,083617,Boyle; Mary E. T.,16,1,48,32
1656087263702,COGS 13,A01,083071,Bastos; Amalia Pinkusfeld,8,2,71,63
1656087269725,COGS 14A,A01,092681,Semenuks; Arturs,8,23,100,92
1656087275749,COGS 14B,A01,083073,Cheng; Tzu-Han,8,0,63,55
1656087281774,COGS 17,A01,092677,Semenuks; Arturs,13,6,81,68
1656087287806,COGS 100,A01,083619,Allen; Michael Gordon,8,2,70,62
1656087293830,COGS 101A,A01,083621,Davis; Joshua Daniel,7,3,68,61
1656087299869,COGS 101B,A01,091572,Allen; Michael Gordon,7,0,65,58
1656087305905,COGS 101C,A01,083625,Delgado; Tania,11,0,35,24
1656087311929,COGS 107A,A01,083627,Boyle; Mary E. T.,5,2,60,55
1656087317953,COGS 118A,A01,083075,Gupta; Anjum,24,16,76,52
1656087323983,CSE 3,A50,083646,Miranda; Gregory Joseph,20,0,50,30
1656087330008,CSE 8A,A50,083650,Miranda; Gregory Joseph,13,11,56,43
1656087336033,CSE 11,A01,083080,Cao; Yingjun,1,60,40,39
1656087342060,CSE 12,A01,083652,Krause-Levy; Sophia Louisa,14,7,120,106
1656087348084,CSE 15L,A01,083654,Morris; Justin Loren,5,1,50,45
1656087348084,CSE 15L,A02,083655,Morris; Justin Loren,7,0,50,43
1656087354109,CSE 20,A01,083657,Tran; Khoa Dang,31,0,80,49
1656087360132,CSE 21,A01,095574,Bach; Quang Tran,28,0,48,20
1656087366158,CSE 30,A01,083084,Eldon; John,3,10,80,77
1656087366158,CSE 30,B01,095061,Bhaskar; Nishant,4,5,50,46
1656087372183,CSE 100,A01,083659,Cao; Yingjun,2,23,70,68
1656087378212,CSE 134B,A01,083661,Powell; Thomas Allan,11,6,100,89
1656087384236,CSE 140,A01,083663,Gungor; Onat,9,0,85,76
1656087390262,CSE 140L,A01,083088,Eldon; John,8,0,100,92
1656087396298,CSE 175,A01,083665,Kumar; Rakesh,2,0,25,23
1656087402339,CSE 190,A00,092507,Dubnov; Shlomo,3,0,20,17
1656087408363,ECE 45,A01,083139,Congero; Spencer William,5,2,75,70
1656087414387,ECE 65,A50,083695,Saad; Andrew S,8,0,30,22
1656087414387,ECE 65,A51,095125,Staff,23,0,26,3
1656087420412,ECE 109,A01,091882,Touri; Behrouz,5,4,70,65
1656087426435,ECE 180,A00,083140,Abi Samra; Nicholas Camill,1,0,30,29
1656087426435,ECE 180,B00,083141,Abi Samra; Nicholas Camill,4,8,30,26
1656087432464,MATH 10A,A01,083735,Patchell; Gregory David,1,0,30,29
1656087432464,MATH 10A,A02,083736,Patchell; Gregory David,23,0,30,7
1656087432464,MATH 10A,A03,083737,Patchell; Gregory David,16,0,30,14
1656087438493,MATH 10B,A01,083207,Lim; Seonhee,3,1,34,31
1656087438493,MATH 10B,A02,083208,Lim; Seonhee,10,1,35,25
1656087438493,MATH 10B,A03,093472,Staff,4,1,34,30
1656087438493,MATH 10B,B01,083739,Sinha; Shubham,12,0,30,18
1656087444552,MATH 18,A01,083743,Cinel; Cameron Alexander,7,0,30,23
1656087444552,MATH 18,A02,083744,Cinel; Cameron Alexander,12,0,30,18
1656087444552,MATH 18,A03,083745,Cinel; Cameron Alexander,3,0,30,27
1656087444552,MATH 18,B01,083748,Ma; Zilu,1,0,36,35
1656087444552,MATH 18,B02,083749,Ma; Zilu,1,0,36,35
1656087444552,MATH 18,B03,083750,Ma; Zilu,0,0,36,36
1656087444552,MATH 18,B04,083751,Ma; Zilu,0,0,36,36
1656087444552,MATH 18,B05,093473,Staff,3,0,36,33
1656087444552,MATH 18,B06,093474,Staff,4,0,36,32
1656087450576,MATH 20A,A01,083754,Zheng; Zequn,11,0,40,29
1656087456609,MATH 20B,A01,083756,Briones; Jor-el Thomas Caparas,0,0,36,36
1656087456609,MATH 20B,A02,083757,Briones; Jor-el Thomas Caparas,2,0,36,34
1656087456609,MATH 20B,A03,093475,Staff,3,0,36,33
1656087462641,MATH 20C,A01,083760,Briones; Jor-el Thomas Caparas,2,2,35,33
1656087462641,MATH 20C,A02,083761,Briones; Jor-el Thomas Caparas,9,1,35,26
1656087462641,MATH 20C,A03,093476,Staff,1,1,35,34
1656087462641,MATH 20C,B01,083762,Bach; Quang Tran,4,0,30,26
1656087468669,MATH 20D,A01,083765,Tran; Brian Kha,3,0,30,27
1656087468669,MATH 20D,A02,083766,Tran; Brian Kha,0,1,30,30
1656087468669,MATH 20D,A03,083767,Tran; Brian Kha,2,0,30,28
1656087474693,MATH 20E,A01,083771,Ganguly; Soumya,4,1,32,28
1656087474693,MATH 20E,A02,083772,Ganguly; Soumya,2,1,32,30
1656087474693,MATH 20E,B01,083773,Ciotti; Benjamin,15,0,35,20
1656087474693,MATH 20E,B02,083774,Ciotti; Benjamin,15,0,35,20
1656087480722,MATH 103A,A01,083777,Greenfeld; Be'Eri,3,0,36,33
1656087480722,MATH 103A,A02,083778,Greenfeld; Be'Eri,3,0,36,33
1656087480722,MATH 103A,A03,093561,Staff,4,1,36,32
1656087480722,MATH 103A,B01,083779,Greenfeld; Be'Eri,8,1,36,28
1656087480722,MATH 103A,B02,083780,Greenfeld; Be'Eri,0,0,36,36
1656087480722,MATH 103A,B03,093562,Staff,0,0,36,36
1656087486755,MATH 105,A01,085443,Carter; Anne Toulson,4,1,35,31
1656087486755,MATH 105,A02,093477,Staff,11,0,35,24
1656087492786,MATH 109,A01,083213,Ganzberger; Geoffrey Michael,1,1,34,33
1656087492786,MATH 109,A02,083214,Ganzberger; Geoffrey Michael,0,0,34,34
1656087492786,MATH 109,A03,093478,Staff,3,0,34,31
1656087492786,MATH 109,B01,083215,Ganzberger; Geoffrey Michael,4,0,32,28
1656087492786,MATH 109,B02,083216,Ganzberger; Geoffrey Michael,1,0,32,31
1656087492786,MATH 109,B03,093479,Staff,4,0,32,28
1656087498816,MATH 142A,A01,083219,Chow; Bennett,2,0,32,30
1656087498816,MATH 142A,A02,083220,Chow; Bennett,8,0,32,24
1656087498816,MATH 142A,A03,093480,Staff,5,0,32,27
1656087498816,MATH 142A,B03,093481,Staff,4,0,32,28
1656087498816,MATH 142A,B04,093558,Staff,7,0,32,25
1656087498816,MATH 142A,B05,093559,Staff,0,0,32,32
1656087504844,MATH 193A,A01,083224,Rotar; Vladimir,1,2,34,33
1656087504844,MATH 193A,A02,083225,Rotar; Vladimir,2,0,34,32
1656087504844,MATH 193A,A03,083781,Rotar; Vladimir,3,0,34,31
1656087504844,MATH 193A,A04,083782,Rotar; Vladimir,7,0,34,27
1656087504844,MATH 193A,A05,093482,Rotar; Vladimir,1,0,34,33
1656087510879,MATH 197,001,091859,McAuley; Julian John,9999,0,9999,0
1656087510879,MATH 197,002,095566,Kedlaya; Kiran S.,9997,0,9999,2
1656087510879,MATH 197,003,095567,Xiao; Ming,9999,0,9999,0
1656087510879,MATH 197,004,095571,Perols; Johan Lars,9998,0,9999,1
1656087517943,COGS 9,A01,083615,Shannon; Kyle Michael,4,1,75,71
1656087523967,COGS 11,A01,083617,Boyle; Mary E. T.,16,1,48,32
1656087529993,COGS 13,A01,083071,Bastos; Amalia Pinkusfeld,8,2,71,63
1656087536016,COGS 14A,A01,092681,Semenuks; Arturs,8,23,100,92
1656087542039,COGS 14B,A01,083073,Cheng; Tzu-Han,8,0,63,55
1656087548062,COGS 17,A01,092677,Semenuks; Arturs,13,6,81,68
1656087554101,COGS 100,A01,083619,Allen; Michael Gordon,8,2,70,62
1656087560128,COGS 101A,A01,083621,Davis; Joshua Daniel,7,3,68,61
1656087566160,COGS 101B,A01,091572,Allen; Michael Gordon,7,0,65,58
1656087572185,COGS 101C,A01,083625,Delgado; Tania,11,0,35,24
1656087578211,COGS 107A,A01,083627,Boyle; Mary E. T.,5,2,60,55
1656087584236,COGS 118A,A01,083075,Gupta; Anjum,24,16,76,52
1656087590260,CSE 3,A50,083646,Miranda; Gregory Joseph,20,0,50,30
1656087596287,CSE 8A,A50,083650,Miranda; Gregory Joseph,13,11,56,43
1656087602311,CSE 11,A01,083080,Cao; Yingjun,1,60,40,39
1656087608340,CSE 12,A01,083652,Krause-Levy; Sophia Louisa,14,7,120,106
1656087614370,CSE 15L,A01,083654,Morris; Justin Loren,5,1,50,45
1656087614370,CSE 15L,A02,083655,Morris; Justin Loren,7,0,50,43
1656087620397,CSE 20,A01,083657,Tran; Khoa Dang,31,0,80,49
1656087626427,CSE 21,A01,095574,Bach; Quang Tran,28,0,48,20
1656087632455,CSE 30,A01,083084,Eldon; John,3,10,80,77
1656087632455,CSE 30,B01,095061,Bhaskar; Nishant,4,5,50,46
1656087638478,CSE 100,A01,083659,Cao; Yingjun,2,23,70,68
1656087644507,CSE 134B,A01,083661,Powell; Thomas Allan,11,6,100,89
1656087650530,CSE 140,A01,083663,Gungor; Onat,9,0,85,76
1656087656553,CSE 140L,A01,083088,Eldon; John,8,0,100,92
1656087662585,CSE 175,A01,083665,Kumar; Rakesh,2,0,25,23
1656087668621,CSE 190,A00,092507,Dubnov; Shlomo,3,0,20,17
1656087674653,ECE 45,A01,083139,Congero; Spencer William,5,2,75,70
1656087680677,ECE 65,A50,083695,Saad; Andrew S,8,0,30,22
1656087680677,ECE 65,A51,095125,Staff,23,0,26,3
1656087686701,ECE 109,A01,091882,Touri; Behrouz,5,4,70,65
1656087692725,ECE 180,A00,083140,Abi Samra; Nicholas Camill,1,0,30,29
1656087692725,ECE 180,B00,083141,Abi Samra; Nicholas Camill,4,8,30,26
1656087698757,MATH 10A,A01,083735,Patchell; Gregory David,1,0,30,29
1656087698757,MATH 10A,A02,083736,Patchell; Gregory David,23,0,30,7
1656087698757,MATH 10A,A03,083737,Patchell; Gregory David,16,0,30,14
1656087704788,MATH 10B,A01,083207,Lim; Seonhee,3,1,34,31
1656087704788,MATH 10B,A02,083208,Lim; Seonhee,10,2,35,25
1656087704788,MATH 10B,A03,093472,Staff,4,1,34,30
1656087704788,MATH 10B,B01,083739,Sinha; Shubham,12,0,30,18
1656087710817,MATH 18,A01,083743,Cinel; Cameron Alexander,7,0,30,23
1656087710817,MATH 18,A02,083744,Cinel; Cameron Alexander,12,0,30,18
1656087710817,MATH 18,A03,083745,Cinel; Cameron Alexander,3,0,30,27
1656087710817,MATH 18,B01,083748,Ma; Zilu,1,0,36,35
1656087710817,MATH 18,B02,083749,Ma; Zilu,1,0,36,35
1656087710817,MATH 18,B03,083750,Ma; Zilu,0,0,36,36
1656087710817,MATH 18,B04,083751,Ma; Zilu,0,0,36,36
1656087710817,MATH 18,B05,093473,Staff,3,0,36,33
1656087710817,MATH 18,B06,093474,Staff,4,0,36,32
1656087716848,MATH 20A,A01,083754,Zheng; Zequn,11,0,40,29
1656087722875,MATH 20B,A01,083756,Briones; Jor-el Thomas Caparas,0,0,36,36
1656087722875,MATH 20B,A02,083757,Briones; Jor-el Thomas Caparas,2,0,36,34
1656087722875,MATH 20B,A03,093475,Staff,3,0,36,33
1656087728898,MATH 20C,A01,083760,Briones; Jor-el Thomas Caparas,2,2,35,33
1656087728898,MATH 20C,A02,083761,Briones; Jor-el Thomas Caparas,9,1,35,26
1656087728898,MATH 20C,A03,093476,Staff,1,1,35,34
1656087728898,MATH 20C,B01,083762,Bach; Quang Tran,4,0,30,26
1656087734923,MATH 20D,A01,083765,Tran; Brian Kha,3,0,30,27
1656087734923,MATH 20D,A02,083766,Tran; Brian Kha,0,1,30,30
1656087734923,MATH 20D,A03,083767,Tran; Brian Kha,2,0,30,28
1656087740946,MATH 20E,A01,083771,Ganguly; Soumya,4,1,32,28
1656087740946,MATH 20E,A02,083772,Ganguly; Soumya,2,1,32,30
1656087740946,MATH 20E,B01,083773,Ciotti; Benjamin,15,0,35,20
1656087740946,MATH 20E,B02,083774,Ciotti; Benjamin,15,0,35,20
1656087746975,MATH 103A,A01,083777,Greenfeld; Be'Eri,3,0,36,33
1656087746975,MATH 103A,A02,083778,Greenfeld; Be'Eri,3,0,36,33
1656087746975,MATH 103A,A03,093561,Staff,4,1,36,32
1656087746975,MATH 103A,B01,083779,Greenfeld; Be'Eri,8,1,36,28
1656087746975,MATH 103A,B02,083780,Greenfeld; Be'Eri,0,0,36,36
1656087746975,MATH 103A,B03,093562,Staff,0,0,36,36
1656087753002,MATH 105,A01,085443,Carter; Anne Toulson,4,1,35,31
1656087753002,MATH 105,A02,093477,Staff,11,0,35,24
1656087759035,MATH 109,A01,083213,Ganzberger; Geoffrey Michael,1,1,34,33
1656087759035,MATH 109,A02,083214,Ganzberger; Geoffrey Michael,0,0,34,34
1656087759035,MATH 109,A03,093478,Staff,3,0,34,31
1656087759035,MATH 109,B01,083215,Ganzberger; Geoffrey Michael,4,0,32,28
1656087759035,MATH 109,B02,083216,Ganzberger; Geoffrey Michael,1,0,32,31
1656087759035,MATH 109,B03,093479,Staff,4,0,32,28
1656087765064,MATH 142A,A01,083219,Chow; Bennett,2,0,32,30
1656087765064,MATH 142A,A02,083220,Chow; Bennett,8,0,32,24
1656087765064,MATH 142A,A03,093480,Staff,5,0,32,27
1656087765064,MATH 142A,B03,093481,Staff,4,0,32,28
1656087765064,MATH 142A,B04,093558,Staff,7,0,32,25
1656087765064,MATH 142A,B05,093559,Staff,0,0,32,32
1656087771088,MATH 193A,A01,083224,Rotar; Vladimir,1,2,34,33
1656087771088,MATH 193A,A02,083225,Rotar; Vladimir,2,0,34,32
1656087771088,MATH 193A,A03,083781,Rotar; Vladimir,3,0,34,31
1656087771088,MATH 193A,A04,083782,Rotar; Vladimir,7,0,34,27
1656087771088,MATH 193A,A05,093482,Rotar; Vladimir,1,0,34,33
1656087777116,MATH 197,001,091859,McAuley; Julian John,9999,0,9999,0
1656087777116,MATH 197,002,095566,Kedlaya; Kiran S.,9997,0,9999,2
1656087777116,MATH 197,003,095567,Xiao; Ming,9999,0,9999,0
1656087777116,MATH 197,004,095571,Perols; Johan Lars,9998,0,9999,1
1656087784266,COGS 9,A01,083615,Shannon; Kyle Michael,4,1,75,71
1656087790293,COGS 11,A01,083617,Boyle; Mary E. T.,16,1,48,32
1656087796316,COGS 13,A01,083071,Bastos; Amalia Pinkusfeld,8,2,71,63
1656087802350,COGS 14A,A01,092681,Semenuks; Arturs,8,23,100,92
1656087808372,COGS 14B,A01,083073,Cheng; Tzu-Han,8,0,63,55
1656087814396,COGS 17,A01,092677,Semenuks; Arturs,13,6,81,68
1656087820444,COGS 100,A01,083619,Allen; Michael Gordon,8,2,70,62
1656087826468,COGS 101A,A01,083621,Davis; Joshua Daniel,7,3,68,61
1656087832495,COGS 101B,A01,091572,Allen; Michael Gordon,7,0,65,58
1656087838519,COGS 101C,A01,083625,Delgado; Tania,11,0,35,24
1656087844543,COGS 107A,A01,083627,Boyle; Mary E. T.,5,2,60,55
1656087850565,COGS 118A,A01,083075,Gupta; Anjum,24,16,76,52
1656087856591,CSE 3,A50,083646,Miranda; Gregory Joseph,20,0,50,30
1656087862615,CSE 8A,A50,083650,Miranda; Gregory Joseph,13,11,56,43
1656087868637,CSE 11,A01,083080,Cao; Yingjun,1,60,40,39
1656087874665,CSE 12,A01,083652,Krause-Levy; Sophia Louisa,14,7,120,106
1656087880687,CSE 15L,A01,083654,Morris; Justin Loren,5,1,50,45
1656087880687,CSE 15L,A02,083655,Morris; Justin Loren,7,0,50,43
1656087886710,CSE 20,A01,083657,Tran; Khoa Dang,31,0,80,49
1656087892733,CSE 21,A01,095574,Bach; Quang Tran,28,0,48,20
1656087898763,CSE 30,A01,083084,Eldon; John,3,10,80,77
1656087898763,CSE 30,B01,095061,Bhaskar; Nishant,4,5,50,46
1656087904790,CSE 100,A01,083659,Cao; Yingjun,2,23,70,68
1656087910824,CSE 134B,A01,083661,Powell; Thomas Allan,11,6,100,89
1656087916851,CSE 140,A01,083663,Gungor; Onat,9,0,85,76
1656087922876,CSE 140L,A01,083088,Eldon; John,8,0,100,92
1656087928899,CSE 175,A01,083665,Kumar; Rakesh,2,0,25,23
1656087934940,CSE 190,A00,092507,Dubnov; Shlomo,3,0,20,17
1656087940968,ECE 45,A01,083139,Congero; Spencer William,5,2,75,70
1656087946996,ECE 65,A50,083695,Saad; Andrew S,8,0,30,22
1656087946996,ECE 65,A51,095125,Staff,23,0,26,3
1656087953019,ECE 109,A01,091882,Touri; Behrouz,5,4,70,65
1656087959057,ECE 180,A00,083140,Abi Samra; Nicholas Camill,1,0,30,29
1656087959057,ECE 180,B00,083141,Abi Samra; Nicholas Camill,4,8,30,26
1656087965084,MATH 10A,A01,083735,Patchell; Gregory David,1,0,30,29
1656087965084,MATH 10A,A02,083736,Patchell; Gregory David,23,0,30,7
1656087965084,MATH 10A,A03,083737,Patchell; Gregory David,16,0,30,14
1656087971119,MATH 10B,A01,083207,Lim; Seonhee,3,1,34,31
1656087971119,MATH 10B,A02,083208,Lim; Seonhee,10,2,35,25
1656087971119,MATH 10B,A03,093472,Staff,4,1,34,30
1656087971119,MATH 10B,B01,083739,Sinha; Shubham,12,0,30,18
1656087977150,MATH 18,A01,083743,Cinel; Cameron Alexander,7,0,30,23
1656087977150,MATH 18,A02,083744,Cinel; Cameron Alexander,12,0,30,18
1656087977150,MATH 18,A03,083745,Cinel; Cameron Alexander,3,0,30,27
1656087977150,MATH 18,B01,083748,Ma; Zilu,1,0,36,35
1656087977150,MATH 18,B02,083749,Ma; Zilu,1,0,36,35
1656087977150,MATH 18,B03,083750,Ma; Zilu,0,0,36,36
1656087977150,MATH 18,B04,083751,Ma; Zilu,0,0,36,36
1656087977150,MATH 18,B05,093473,Staff,3,0,36,33
1656087977150,MATH 18,B06,093474,Staff,4,0,36,32
1656087983174,MATH 20A,A01,083754,Zheng; Zequn,11,0,40,29
1656087989200,MATH 20B,A01,083756,Briones; Jor-el Thomas Caparas,0,0,36,36
1656087989200,MATH 20B,A02,083757,Briones; Jor-el Thomas Caparas,2,0,36,34
1656087989200,MATH 20B,A03,093475,Staff,3,0,36,33
1656087995234,MATH 20C,A01,083760,Briones; Jor-el Thomas Caparas,2,2,35,33
1656087995234,MATH 20C,A02,083761,Briones; Jor-el Thomas Caparas,9,1,35,26
1656087995234,MATH 20C,A03,093476,Staff,1,1,35,34
1656087995234,MATH 20C,B01,083762,Bach; Quang Tran,4,0,30,26
1656088001266,MATH 20D,A01,083765,Tran; Brian Kha,3,0,30,27
1656088001266,MATH 20D,A02,083766,Tran; Brian Kha,0,1,30,30
1656088001266,MATH 20D,A03,083767,Tran; Brian Kha,2,0,30,28
1656088007296,MATH 20E,A01,083771,Ganguly; Soumya,4,1,32,28
1656088007296,MATH 20E,A02,083772,Ganguly; Soumya,2,1,32,30
1656088007296,MATH 20E,B01,083773,Ciotti; Benjamin,15,0,35,20
1656088007296,MATH 20E,B02,083774,Ciotti; Benjamin,15,0,35,20
1656088013327,MATH 103A,A01,083777,Greenfeld; Be'Eri,3,0,36,33
1656088013327,MATH 103A,A02,083778,Greenfeld; Be'Eri,3,0,36,33
1656088013327,MATH 103A,A03,093561,Staff,4,1,36,32
1656088013327,MATH 103A,B01,083779,Greenfeld; Be'Eri,8,1,36,28
1656088013327,MATH 103A,B02,083780,Greenfeld; Be'Eri,0,0,36,36
1656088013327,MATH 103A,B03,093562,Staff,0,0,36,36
1656088019355,MATH 105,A01,085443,Carter; Anne Toulson,4,1,35,31
1656088019355,MATH 105,A02,093477,Staff,11,0,35,24
1656088025384,MATH 109,A01,083213,Ganzberger; Geoffrey Michael,1,1,34,33
1656088025384,MATH 109,A02,083214,Ganzberger; Geoffrey Michael,0,0,34,34
1656088025384,MATH 109,A03,093478,Staff,3,0,34,31
1656088025384,MATH 109,B01,083215,Ganzberger; Geoffrey Michael,4,0,32,28
1656088025384,MATH 109,B02,083216,Ganzberger; Geoffrey Michael,1,0,32,31
1656088025384,MATH 109,B03,093479,Staff,4,0,32,28
1656088031408,MATH 142A,A01,083219,Chow; Bennett,2,0,32,30
1656088031408,MATH 142A,A02,083220,Chow; Bennett,8,0,32,24
1656088031408,MATH 142A,A03,093480,Staff,5,0,32,27
1656088031408,MATH 142A,B03,093481,Staff,4,0,32,28
1656088031408,MATH 142A,B04,093558,Staff,7,0,32,25
1656088031408,MATH 142A,B05,093559,Staff,0,0,32,32
1656088037436,MATH 193A,A01,083224,Rotar; Vladimir,1,2,34,33
1656088037436,MATH 193A,A02,083225,Rotar; Vladimir,2,0,34,32
1656088037436,MATH 193A,A03,083781,Rotar; Vladimir,3,0,34,31
1656088037436,MATH 193A,A04,083782,Rotar; Vladimir,7,0,34,27
1656088037436,MATH 193A,A05,093482,Rotar; Vladimir,1,0,34,33
1656088043460,MATH 197,001,091859,McAuley; Julian John,9999,0,9999,0
1656088043460,MATH 197,002,095566,Kedlaya; Kiran S.,9997,0,9999,2
1656088043460,MATH 197,003,095567,Xiao; Ming,9999,0,9999,0
1656088043460,MATH 197,004,095571,Perols; Johan Lars,9998,0,9999,1
1656088050517,COGS 9,A01,083615,Shannon; Kyle Michael,4,1,75,71
1656088056542,COGS 11,A01,083617,Boyle; Mary E. T.,16,1,48,32
1656088062566,COGS 13,A01,083071,Bastos; Amalia Pinkusfeld,8,2,71,63
1656088068592,COGS 14A,A01,092681,Semenuks; Arturs,8,23,100,92
1656088074626,COGS 14B,A01,083073,Cheng; Tzu-Han,8,0,63,55
1656088080650,COGS 17,A01,092677,Semenuks; Arturs,13,6,81,68
1656088086678,COGS 100,A01,083619,Allen; Michael Gordon,8,2,70,62
1656088092701,COGS 101A,A01,083621,Davis; Joshua Daniel,7,3,68,61
1656088098725,COGS 101B,A01,091572,Allen; Michael Gordon,7,0,65,58
1656088104755,COGS 101C,A01,083625,Delgado; Tania,11,0,35,24
1656088110781,COGS 107A,A01,083627,Boyle; Mary E. T.,5,2,60,55
1656088116807,COGS 118A,A01,083075,Gupta; Anjum,24,16,76,52
1656088122835,CSE 3,A50,083646,Miranda; Gregory Joseph,20,0,50,30
1656088128863,CSE 8A,A50,083650,Miranda; Gregory Joseph,13,11,56,43
1656088134887,CSE 11,A01,083080,Cao; Yingjun,1,60,40,39
1656088140913,CSE 12,A01,083652,Krause-Levy; Sophia Louisa,14,7,120,106
1656088146941,CSE 15L,A01,083654,Morris; Justin Loren,5,1,50,45
1656088146941,CSE 15L,A02,083655,Morris; Justin Loren,7,0,50,43
1656088152964,CSE 20,A01,083657,Tran; Khoa Dang,31,0,80,49
1656088158995,CSE 21,A01,095574,Bach; Quang Tran,28,0,48,20
1656088165036,CSE 30,A01,083084,Eldon; John,3,10,80,77
1656088165036,CSE 30,B01,095061,Bhaskar; Nishant,4,5,50,46
1656088171059,CSE 100,A01,083659,Cao; Yingjun,2,23,70,68
1656088177088,CSE 134B,A01,083661,Powell; Thomas Allan,11,6,100,89
1656088183115,CSE 140,A01,083663,Gungor; Onat,9,0,85,76
1656088189139,CSE 140L,A01,083088,Eldon; John,8,0,100,92
1656088195161,CSE 175,A01,083665,Kumar; Rakesh,2,0,25,23
1656088201183,CSE 190,A00,092507,Dubnov; Shlomo,3,0,20,17
1656088207206,ECE 45,A01,083139,Congero; Spencer William,5,2,75,70
1656088213233,ECE 65,A50,083695,Saad; Andrew S,8,0,30,22
1656088213233,ECE 65,A51,095125,Staff,23,0,26,3
1656088219267,ECE 109,A01,091882,Touri; Behrouz,5,4,70,65
1656088225302,ECE 180,A00,083140,Abi Samra; Nicholas Camill,1,0,30,29
1656088225302,ECE 180,B00,083141,Abi Samra; Nicholas Camill,4,8,30,26
1656088231326,MATH 10A,A01,083735,Patchell; Gregory David,1,0,30,29
1656088231326,MATH 10A,A02,083736,Patchell; Gregory David,23,0,30,7
1656088231326,MATH 10A,A03,083737,Patchell; Gregory David,16,0,30,14
1656088237356,MATH 10B,A01,083207,Lim; Seonhee,3,1,34,31
1656088237356,MATH 10B,A02,083208,Lim; Seonhee,10,2,35,25
1656088237356,MATH 10B,A03,093472,Staff,4,1,34,30
1656088237356,MATH 10B,B01,083739,Sinha; Shubham,12,0,30,18
1656088243402,MATH 18,A01,083743,Cinel; Cameron Alexander,7,0,30,23
1656088243402,MATH 18,A02,083744,Cinel; Cameron Alexander,12,0,30,18
1656088243402,MATH 18,A03,083745,Cinel; Cameron Alexander,3,0,30,27
1656088243402,MATH 18,B01,083748,Ma; Zilu,1,0,36,35
1656088243402,MATH 18,B02,083749,Ma; Zilu,1,0,36,35
1656088243402,MATH 18,B03,083750,Ma; Zilu,0,0,36,36
1656088243402,MATH 18,B04,083751,Ma; Zilu,0,0,36,36
1656088243402,MATH 18,B05,093473,Staff,3,0,36,33
1656088243402,MATH 18,B06,093474,Staff,4,0,36,32
1656088249433,MATH 20A,A01,083754,Zheng; Zequn,11,0,40,29
1656088255460,MATH 20B,A01,083756,Briones; Jor-el Thomas Caparas,0,0,36,36
1656088255460,MATH 20B,A02,083757,Briones; Jor-el Thomas Caparas,2,0,36,34
1656088255460,MATH 20B,A03,093475,Staff,3,0,36,33
1656088261487,MATH 20C,A01,083760,Briones; Jor-el Thomas Caparas,2,2,35,33
1656088261487,MATH 20C,A02,083761,Briones; Jor-el Thomas Caparas,9,1,35,26
1656088261487,MATH 20C,A03,093476,Staff,1,1,35,34
1656088261487,MATH 20C,B01,083762,Bach; Quang Tran,4,0,30,26
1656088267516,MATH 20D,A01,083765,Tran; Brian Kha,3,0,30,27
1656088267516,MATH 20D,A02,083766,Tran; Brian Kha,0,1,30,30
1656088267516,MATH 20D,A03,083767,Tran; Brian Kha,2,0,30,28
1656088273549,MATH 20E,A01,083771,Ganguly; Soumya,4,1,32,28
1656088273549,MATH 20E,A02,083772,Ganguly; Soumya,2,1,32,30
1656088273549,MATH 20E,B01,083773,Ciotti; Benjamin,15,0,35,20
1656088273549,MATH 20E,B02,083774,Ciotti; Benjamin,15,0,35,20
1656088279583,MATH 103A,A01,083777,Greenfeld; Be'Eri,3,0,36,33
1656088279583,MATH 103A,A02,083778,Greenfeld; Be'Eri,3,0,36,33
1656088279583,MATH 103A,A03,093561,Staff,4,1,36,32
1656088279583,MATH 103A,B01,083779,Greenfeld; Be'Eri,8,1,36,28
1656088279583,MATH 103A,B02,083780,Greenfeld; Be'Eri,0,0,36,36
1656088279583,MATH 103A,B03,093562,Staff,0,0,36,36
1656088285612,MATH 105,A01,085443,Carter; Anne Toulson,4,1,35,31
1656088285612,MATH 105,A02,093477,Staff,11,0,35,24
1656088291636,MATH 109,A01,083213,Ganzberger; Geoffrey Michael,1,1,34,33
1656088291636,MATH 109,A02,083214,Ganzberger; Geoffrey Michael,0,0,34,34
1656088291636,MATH 109,A03,093478,Staff,3,0,34,31
1656088291636,MATH 109,B01,083215,Ganzberger; Geoffrey Michael,4,0,32,28
1656088291636,MATH 109,B02,083216,Ganzberger; Geoffrey Michael,1,0,32,31
1656088291636,MATH 109,B03,093479,Staff,4,0,32,28
1656088297665,MATH 142A,A01,083219,Chow; Bennett,2,0,32,30
1656088297665,MATH 142A,A02,083220,Chow; Bennett,8,0,32,24
1656088297665,MATH 142A,A03,093480,Staff,5,0,32,27
1656088297665,MATH 142A,B03,093481,Staff,4,0,32,28
1656088297665,MATH 142A,B04,093558,Staff,7,0,32,25
1656088297665,MATH 142A,B05,093559,Staff,0,0,32,32
1656088303689,MATH 193A,A01,083224,Rotar; Vladimir,1,2,34,33
1656088303689,MATH 193A,A02,083225,Rotar; Vladimir,2,0,34,32
1656088303689,MATH 193A,A03,083781,Rotar; Vladimir,3,0,34,31
1656088303689,MATH 193A,A04,083782,Rotar; Vladimir,7,0,34,27
1656088303689,MATH 193A,A05,093482,Rotar; Vladimir,1,0,34,33
1656088309722,MATH 197,001,091859,McAuley; Julian John,9999,0,9999,0
1656088309722,MATH 197,002,095566,Kedlaya; Kiran S.,9997,0,9999,2
1656088309722,MATH 197,003,095567,Xiao; Ming,9999,0,9999,0
1656088309722,MATH 197,004,095571,Perols; Johan Lars,9998,0,9999,1
1656088316780,COGS 9,A01,083615,Shannon; Kyle Michael,4,1,75,71
1656088322807,COGS 11,A01,083617,Boyle; Mary E. T.,16,1,48,32
1656088328834,COGS 13,A01,083071,Bastos; Amalia Pinkusfeld,8,2,71,63
1656088334858,COGS 14A,A01,092681,Semenuks; Arturs,8,23,100,92
1656088340885,COGS 14B,A01,083073,Cheng; Tzu-Han,8,0,63,55
1656088346927,COGS 17,A01,092677,Semenuks; Arturs,13,6,81,68
1656088352951,COGS 100,A01,083619,Allen; Michael Gordon,8,2,70,62
1656088358976,COGS 101A,A01,083621,Davis; Joshua Daniel,7,3,68,61
1656088365012,COGS 101B,A01,091572,Allen; Michael Gordon,7,0,65,58
1656088371039,COGS 101C,A01,083625,Delgado; Tania,11,0,35,24
1656088377066,COGS 107A,A01,083627,Boyle; Mary E. T.,5,2,60,55
1656088383194,COGS 118A,A01,083075,Gupta; Anjum,24,16,76,52
1656088389216,CSE 3,A50,083646,Miranda; Gregory Joseph,20,0,50,30
1656088395244,CSE 8A,A50,083650,Miranda; Gregory Joseph,13,11,56,43
1656088401266,CSE 11,A01,083080,Cao; Yingjun,1,60,40,39
1656088407290,CSE 12,A01,083652,Krause-Levy; Sophia Louisa,14,7,120,106
1656088413318,CSE 15L,A01,083654,Morris; Justin Loren,5,1,50,45
1656088413318,CSE 15L,A02,083655,Morris; Justin Loren,7,0,50,43
1656088419345,CSE 20,A01,083657,Tran; Khoa Dang,31,0,80,49
1656088425372,CSE 21,A01,095574,Bach; Quang Tran,28,0,48,20
1656088431396,CSE 30,A01,083084,Eldon; John,3,10,80,77
1656088431396,CSE 30,B01,095061,Bhaskar; Nishant,4,5,50,46
1656088437426,CSE 100,A01,083659,Cao; Yingjun,2,23,70,68
1656088443458,CSE 134B,A01,083661,Powell; Thomas Allan,11,6,100,89
1656088449484,CSE 140,A01,083663,Gungor; Onat,9,0,85,76
1656088455506,CSE 140L,A01,083088,Eldon; John,8,0,100,92
1656088461530,CSE 175,A01,083665,Kumar; Rakesh,2,0,25,23
1656088467555,CSE 190,A00,092507,Dubnov; Shlomo,3,0,20,17
1656088473579,ECE 45,A01,083139,Congero; Spencer William,5,2,75,70
1656088479606,ECE 65,A50,083695,Saad; Andrew S,8,0,30,22
1656088479606,ECE 65,A51,095125,Staff,23,0,26,3
1656088485633,ECE 109,A01,091882,Touri; Behrouz,5,4,70,65
1656088491656,ECE 180,A00,083140,Abi Samra; Nicholas Camill,1,0,30,29
1656088491656,ECE 180,B00,083141,Abi Samra; Nicholas Camill,4,8,30,26
1656088497680,MATH 10A,A01,083735,Patchell; Gregory David,1,0,30,29
1656088497680,MATH 10A,A02,083736,Patchell; Gregory David,23,0,30,7
1656088497680,MATH 10A,A03,083737,Patchell; Gregory David,16,0,30,14
1656088503715,MATH 10B,A01,083207,Lim; Seonhee,3,1,34,31
1656088503715,MATH 10B,A02,083208,Lim; Seonhee,10,2,35,25
1656088503715,MATH 10B,A03,093472,Staff,4,1,34,30
1656088503715,MATH 10B,B01,083739,Sinha; Shubham,12,0,30,18
1656088509745,MATH 18,A01,083743,Cinel; Cameron Alexander,7,0,30,23
1656088509745,MATH 18,A02,083744,Cinel; Cameron Alexander,12,0,30,18
1656088509745,MATH 18,A03,083745,Cinel; Cameron Alexander,3,0,30,27
1656088509745,MATH 18,B01,083748,Ma; Zilu,1,0,36,35
1656088509745,MATH 18,B02,083749,Ma; Zilu,1,0,36,35
1656088509745,MATH 18,B03,083750,Ma; Zilu,0,0,36,36
1656088509745,MATH 18,B04,083751,Ma; Zilu,0,0,36,36
1656088509745,MATH 18,B05,093473,Staff,3,0,36,33
1656088509745,MATH 18,B06,093474,Staff,4,0,36,32
1656088515768,MATH 20A,A01,083754,Zheng; Zequn,11,0,40,29
1656088521791,MATH 20B,A01,083756,Briones; Jor-el Thomas Caparas,0,0,36,36
1656088521791,MATH 20B,A02,083757,Briones; Jor-el Thomas Caparas,2,0,36,34
1656088521791,MATH 20B,A03,093475,Staff,3,0,36,33
1656088527815,MATH 20C,A01,083760,Briones; Jor-el Thomas Caparas,2,2,35,33
1656088527815,MATH 20C,A02,083761,Briones; Jor-el Thomas Caparas,9,1,35,26
1656088527815,MATH 20C,A03,093476,Staff,1,1,35,34
1656088527815,MATH 20C,B01,083762,Bach; Quang Tran,4,0,30,26
1656088533843,MATH 20D,A01,083765,Tran; Brian Kha,3,0,30,27
1656088533843,MATH 20D,A02,083766,Tran; Brian Kha,0,1,30,30
1656088533843,MATH 20D,A03,083767,Tran; Brian Kha,2,0,30,28
1656088539867,MATH 20E,A01,083771,Ganguly; Soumya,4,1,32,28
1656088539867,MATH 20E,A02,083772,Ganguly; Soumya,2,1,32,30
1656088539867,MATH 20E,B01,083773,Ciotti; Benjamin,15,0,35,20
1656088539867,MATH 20E,B02,083774,Ciotti; Benjamin,15,0,35,20
1656088545896,MATH 103A,A01,083777,Greenfeld; Be'Eri,3,0,36,33
1656088545896,MATH 103A,A02,083778,Greenfeld; Be'Eri,3,0,36,33
1656088545896,MATH 103A,A03,093561,Staff,4,1,36,32
1656088545896,MATH 103A,B01,083779,Greenfeld; Be'Eri,8,1,36,28
1656088545896,MATH 103A,B02,083780,Greenfeld; Be'Eri,0,0,36,36
1656088545896,MATH 103A,B03,093562,Staff,0,0,36,36
1656088551919,MATH 105,A01,085443,Carter; Anne Toulson,4,1,35,31
1656088551919,MATH 105,A02,093477,Staff,11,0,35,24
1656088557948,MATH 109,A01,083213,Ganzberger; Geoffrey Michael,1,1,34,33
1656088557948,MATH 109,A02,083214,Ganzberger; Geoffrey Michael,0,0,34,34
1656088557948,MATH 109,A03,093478,Staff,3,0,34,31
1656088557948,MATH 109,B01,083215,Ganzberger; Geoffrey Michael,4,0,32,28
1656088557948,MATH 109,B02,083216,Ganzberger; Geoffrey Michael,1,0,32,31
1656088557948,MATH 109,B03,093479,Staff,4,0,32,28
1656088563980,MATH 142A,A01,083219,Chow; Bennett,2,0,32,30
1656088563980,MATH 142A,A02,083220,Chow; Bennett,8,0,32,24
1656088563980,MATH 142A,A03,093480,Staff,5,0,32,27
1656088563980,MATH 142A,B03,093481,Staff,4,0,32,28
1656088563980,MATH 142A,B04,093558,Staff,7,0,32,25
1656088563980,MATH 142A,B05,093559,Staff,0,0,32,32
1656088570003,MATH 193A,A01,083224,Rotar; Vladimir,1,2,34,33
1656088570003,MATH 193A,A02,083225,Rotar; Vladimir,2,0,34,32
1656088570003,MATH 193A,A03,083781,Rotar; Vladimir,3,0,34,31
1656088570003,MATH 193A,A04,083782,Rotar; Vladimir,7,0,34,27
1656088570003,MATH 193A,A05,093482,Rotar; Vladimir,1,0,34,33
1656088576027,MATH 197,001,091859,McAuley; Julian John,9999,0,9999,0
1656088576027,MATH 197,002,095566,Kedlaya; Kiran S.,9997,0,9999,2
1656088576027,MATH 197,003,095567,Xiao; Ming,9999,0,9999,0
1656088576027,MATH 197,004,095571,Perols; Johan Lars,9998,0,9999,1
1656088583107,COGS 9,A01,083615,Shannon; Kyle Michael,4,1,75,71
1656088589135,COGS 11,A01,083617,Boyle; Mary E. T.,16,1,48,32
1656088595161,COGS 13,A01,083071,Bastos; Amalia Pinkusfeld,8,2,71,63
1656088601194,COGS 14A,A01,092681,Semenuks; Arturs,8,23,100,92
1656088607223,COGS 14B,A01,083073,Cheng; Tzu-Han,8,0,63,55
1656088613248,COGS 17,A01,092677,Semenuks; Arturs,13,6,81,68
1656088619271,COGS 100,A01,083619,Allen; Michael Gordon,8,2,70,62
1656088625300,COGS 101A,A01,083621,Davis; Joshua Daniel,7,3,68,61
1656088631323,COGS 101B,A01,091572,Allen; Michael Gordon,7,0,65,58
1656088637351,COGS 101C,A01,083625,Delgado; Tania,11,0,35,24
1656088643374,COGS 107A,A01,083627,Boyle; Mary E. T.,5,2,60,55
1656088649398,COGS 118A,A01,083075,Gupta; Anjum,24,16,76,52
1656088655426,CSE 3,A50,083646,Miranda; Gregory Joseph,20,0,50,30
1656088661455,CSE 8A,A50,083650,Miranda; Gregory Joseph,13,11,56,43
1656088667482,CSE 11,A01,083080,Cao; Yingjun,1,60,40,39
1656088673504,CSE 12,A01,083652,Krause-Levy; Sophia Louisa,14,7,120,106
1656088679527,CSE 15L,A01,083654,Morris; Justin Loren,5,1,50,45
1656088679527,CSE 15L,A02,083655,Morris; Justin Loren,7,0,50,43
1656088685558,CSE 20,A01,083657,Tran; Khoa Dang,31,0,80,49
1656088691598,CSE 21,A01,095574,Bach; Quang Tran,28,0,48,20
1656088697626,CSE 30,A01,083084,Eldon; John,3,10,80,77
1656088697626,CSE 30,B01,095061,Bhaskar; Nishant,4,5,50,46
1656088703651,CSE 100,A01,083659,Cao; Yingjun,2,23,70,68
1656088709679,CSE 134B,A01,083661,Powell; Thomas Allan,11,6,100,89
1656088715702,CSE 140,A01,083663,Gungor; Onat,9,0,85,76
1656088721726,CSE 140L,A01,083088,Eldon; John,8,0,100,92
1656088727753,CSE 175,A01,083665,Kumar; Rakesh,2,0,25,23
1656088733784,CSE 190,A00,092507,Dubnov; Shlomo,3,0,20,17
1656088739812,ECE 45,A01,083139,Congero; Spencer William,5,2,75,70
1656088745836,ECE 65,A50,083695,Saad; Andrew S,8,0,30,22
1656088745836,ECE 65,A51,095125,Staff,23,0,26,3
1656088751863,ECE 109,A01,091882,Touri; Behrouz,5,4,70,65
1656088757891,ECE 180,A00,083140,Abi Samra; Nicholas Camill,1,0,30,29
1656088757891,ECE 180,B00,083141,Abi Samra; Nicholas Camill,4,8,30,26
1656088763915,MATH 10A,A01,083735,Patchell; Gregory David,1,0,30,29
1656088763915,MATH 10A,A02,083736,Patchell; Gregory David,23,0,30,7
1656088763915,MATH 10A,A03,083737,Patchell; Gregory David,16,0,30,14
1656088769959,MATH 10B,A01,083207,Lim; Seonhee,3,1,34,31
1656088769959,MATH 10B,A02,083208,Lim; Seonhee,10,2,35,25
1656088769959,MATH 10B,A03,093472,Staff,4,1,34,30
1656088769959,MATH 10B,B01,083739,Sinha; Shubham,12,0,30,18
1656088775991,MATH 18,A01,083743,Cinel; Cameron Alexander,7,0,30,23
1656088775991,MATH 18,A02,083744,Cinel; Cameron Alexander,12,0,30,18
1656088775991,MATH 18,A03,083745,Cinel; Cameron Alexander,3,0,30,27
1656088775991,MATH 18,B01,083748,Ma; Zilu,1,0,36,35
1656088775991,MATH 18,B02,083749,Ma; Zilu,1,0,36,35
1656088775991,MATH 18,B03,083750,Ma; Zilu,0,0,36,36
1656088775991,MATH 18,B04,083751,Ma; Zilu,0,0,36,36
1656088775991,MATH 18,B05,093473,Staff,3,0,36,33
1656088775991,MATH 18,B06,093474,Staff,4,0,36,32
1656088782032,MATH 20A,A01,083754,Zheng; Zequn,11,0,40,29
1656088788055,MATH 20B,A01,083756,Briones; Jor-el Thomas Caparas,0,0,36,36
1656088788055,MATH 20B,A02,083757,Briones; Jor-el Thomas Caparas,2,0,36,34
1656088788055,MATH 20B,A03,093475,Staff,3,0,36,33
1656088794080,MATH 20C,A01,083760,Briones; Jor-el Thomas Caparas,2,2,35,33
1656088794080,MATH 20C,A02,083761,Briones; Jor-el Thomas Caparas,9,1,35,26
1656088794080,MATH 20C,A03,093476,Staff,1,1,35,34
1656088794080,MATH 20C,B01,083762,Bach; Quang Tran,4,0,30,26
1656088800115,MATH 20D,A01,083765,Tran; Brian Kha,3,0,30,27
1656088800115,MATH 20D,A02,083766,Tran; Brian Kha,0,1,30,30
1656088800115,MATH 20D,A03,083767,Tran; Brian Kha,2,0,30,28
1656088806154,MATH 20E,A01,083771,Ganguly; Soumya,4,1,32,28
1656088806154,MATH 20E,A02,083772,Ganguly; Soumya,2,1,32,30
1656088806154,MATH 20E,B01,083773,Ciotti; Benjamin,15,0,35,20
1656088806154,MATH 20E,B02,083774,Ciotti; Benjamin,15,0,35,20
1656088812179,MATH 103A,A01,083777,Greenfeld; Be'Eri,3,0,36,33
1656088812179,MATH 103A,A02,083778,Greenfeld; Be'Eri,3,0,36,33
1656088812179,MATH 103A,A03,093561,Staff,4,1,36,32
1656088812179,MATH 103A,B01,083779,Greenfeld; Be'Eri,8,1,36,28
1656088812179,MATH 103A,B02,083780,Greenfeld; Be'Eri,0,0,36,36
1656088812179,MATH 103A,B03,093562,Staff,0,0,36,36
1656088818201,MATH 105,A01,085443,Carter; Anne Toulson,4,1,35,31
1656088818201,MATH 105,A02,093477,Staff,11,0,35,24
1656088824238,MATH 109,A01,083213,Ganzberger; Geoffrey Michael,1,1,34,33
1656088824238,MATH 109,A02,083214,Ganzberger; Geoffrey Michael,0,0,34,34
1656088824238,MATH 109,A03,093478,Staff,3,0,34,31
1656088824238,MATH 109,B01,083215,Ganzberger; Geoffrey Michael,4,0,32,28
1656088824238,MATH 109,B02,083216,Ganzberger; Geoffrey Michael,1,0,32,31
1656088824238,MATH 109,B03,093479,Staff,4,0,32,28
1656088830270,MATH 142A,A01,083219,Chow; Bennett,2,0,32,30
1656088830270,MATH 142A,A02,083220,Chow; Bennett,8,0,32,24
1656088830270,MATH 142A,A03,093480,Staff,5,0,32,27
1656088830270,MATH 142A,B03,093481,Staff,4,0,32,28
1656088830270,MATH 142A,B04,093558,Staff,7,0,32,25
1656088830270,MATH 142A,B05,093559,Staff,0,0,32,32
1656088836299,MATH 193A,A01,083224,Rotar; Vladimir,1,2,34,33
1656088836299,MATH 193A,A02,083225,Rotar; Vladimir,2,0,34,32
1656088836299,MATH 193A,A03,083781,Rotar; Vladimir,3,0,34,31
1656088836299,MATH 193A,A04,083782,Rotar; Vladimir,7,0,34,27
1656088836299,MATH 193A,A05,093482,Rotar; Vladimir,1,0,34,33
1656088842351,MATH 197,001,091859,McAuley; Julian John,9999,0,9999,0
1656088842351,MATH 197,002,095566,Kedlaya; Kiran S.,9997,0,9999,2
1656088842351,MATH 197,003,095567,Xiao; Ming,9999,0,9999,0
1656088842351,MATH 197,004,095571,Perols; Johan Lars,9998,0,9999,1
1656088849415,COGS 9,A01,083615,Shannon; Kyle Michael,4,1,75,71
1656088855438,COGS 11,A01,083617,Boyle; Mary E. T.,16,1,48,32
1656088861471,COGS 13,A01,083071,Bastos; Amalia Pinkusfeld,8,2,71,63
1656088867507,COGS 14A,A01,092681,Semenuks; Arturs,8,23,100,92
1656088873529,COGS 14B,A01,083073,Cheng; Tzu-Han,8,0,63,55
1656088879553,COGS 17,A01,092677,Semenuks; Arturs,13,6,81,68
1656088885584,COGS 100,A01,083619,Allen; Michael Gordon,8,2,70,62
1656088891606,COGS 101A,A01,083621,Davis; Joshua Daniel,7,3,68,61
1656088897628,COGS 101B,A01,091572,Allen; Michael Gordon,7,0,65,58
1656088903652,COGS 101C,A01,083625,Delgado; Tania,11,0,35,24
1656088909675,COGS 107A,A01,083627,Boyle; Mary E. T.,5,2,60,55
1656088915701,COGS 118A,A01,083075,Gupta; Anjum,24,16,76,52
1656088921726,CSE 3,A50,083646,Miranda; Gregory Joseph,20,0,50,30
1656088927749,CSE 8A,A50,083650,Miranda; Gregory Joseph,13,11,56,43
1656088933775,CSE 11,A01,083080,Cao; Yingjun,1,60,40,39
1656088939808,CSE 12,A01,083652,Krause-Levy; Sophia Louisa,14,7,120,106
1656088945831,CSE 15L,A01,083654,Morris; Justin Loren,5,1,50,45
1656088945831,CSE 15L,A02,083655,Morris; Justin Loren,7,0,50,43
1656088951855,CSE 20,A01,083657,Tran; Khoa Dang,31,0,80,49
1656088957880,CSE 21,A01,095574,Bach; Quang Tran,28,0,48,20
1656088963903,CSE 30,A01,083084,Eldon; John,3,10,80,77
1656088963903,CSE 30,B01,095061,Bhaskar; Nishant,4,5,50,46
1656088969928,CSE 100,A01,083659,Cao; Yingjun,2,23,70,68
1656088975962,CSE 134B,A01,083661,Powell; Thomas Allan,11,6,100,89
1656088982082,CSE 140,A01,083663,Gungor; Onat,9,0,85,76
1656088988117,CSE 140L,A01,083088,Eldon; John,8,0,100,92
1656088994143,CSE 175,A01,083665,Kumar; Rakesh,2,0,25,23
1656089000171,CSE 190,A00,092507,Dubnov; Shlomo,3,0,20,17
1656089006200,ECE 45,A01,083139,Congero; Spencer William,5,2,75,70
1656089012224,ECE 65,A50,083695,Saad; Andrew S,8,0,30,22
1656089012224,ECE 65,A51,095125,Staff,23,0,26,3
1656089018248,ECE 109,A01,091882,Touri; Behrouz,5,4,70,65
1656089024276,ECE 180,A00,083140,Abi Samra; Nicholas Camill,1,0,30,29
1656089024276,ECE 180,B00,083141,Abi Samra; Nicholas Camill,4,8,30,26
1656089030315,MATH 10A,A01,083735,Patchell; Gregory David,1,0,30,29
1656089030315,MATH 10A,A02,083736,Patchell; Gregory David,23,0,30,7
1656089030315,MATH 10A,A03,083737,Patchell; Gregory David,16,0,30,14
1656089036339,MATH 10B,A01,083207,Lim; Seonhee,3,1,34,31
1656089036339,MATH 10B,A02,083208,Lim; Seonhee,10,2,35,25
1656089036339,MATH 10B,A03,093472,Staff,4,1,34,30
1656089036339,MATH 10B,B01,083739,Sinha; Shubham,12,0,30,18
1656089042363,MATH 18,A01,083743,Cinel; Cameron Alexander,7,0,30,23
1656089042363,MATH 18,A02,083744,Cinel; Cameron Alexander,12,0,30,18
1656089042363,MATH 18,A03,083745,Cinel; Cameron Alexander,3,0,30,27
1656089042363,MATH 18,B01,083748,Ma; Zilu,1,0,36,35
1656089042363,MATH 18,B02,083749,Ma; Zilu,1,0,36,35
1656089042363,MATH 18,B03,083750,Ma; Zilu,0,0,36,36
1656089042363,MATH 18,B04,083751,Ma; Zilu,0,0,36,36
1656089042363,MATH 18,B05,093473,Staff,3,0,36,33
1656089042363,MATH 18,B06,093474,Staff,4,0,36,32
1656089048387,MATH 20A,A01,083754,Zheng; Zequn,11,0,40,29
1656089054411,MATH 20B,A01,083756,Briones; Jor-el Thomas Caparas,0,0,36,36
1656089054411,MATH 20B,A02,083757,Briones; Jor-el Thomas Caparas,2,0,36,34
1656089054411,MATH 20B,A03,093475,Staff,3,0,36,33
1656089060443,MATH 20C,A01,083760,Briones; Jor-el Thomas Caparas,2,2,35,33
1656089060443,MATH 20C,A02,083761,Briones; Jor-el Thomas Caparas,9,1,35,26
1656089060443,MATH 20C,A03,093476,Staff,1,1,35,34
1656089060443,MATH 20C,B01,083762,Bach; Quang Tran,4,0,30,26
1656089066471,MATH 20D,A01,083765,Tran; Brian Kha,3,0,30,27
1656089066471,MATH 20D,A02,083766,Tran; Brian Kha,0,1,30,30
1656089066471,MATH 20D,A03,083767,Tran; Brian Kha,2,0,30,28
1656089072500,MATH 20E,A01,083771,Ganguly; Soumya,4,1,32,28
1656089072500,MATH 20E,A02,083772,Ganguly; Soumya,2,1,32,30
1656089072500,MATH 20E,B01,083773,Ciotti; Benjamin,15,0,35,20
1656089072500,MATH 20E,B02,083774,Ciotti; Benjamin,15,0,35,20
1656089078525,MATH 103A,A01,083777,Greenfeld; Be'Eri,3,1,36,33
1656089078525,MATH 103A,A02,083778,Greenfeld; Be'Eri,3,0,36,33
1656089078525,MATH 103A,A03,093561,Staff,4,1,36,32
1656089078525,MATH 103A,B01,083779,Greenfeld; Be'Eri,8,1,36,28
1656089078525,MATH 103A,B02,083780,Greenfeld; Be'Eri,0,0,36,36
1656089078525,MATH 103A,B03,093562,Staff,0,0,36,36
1656089084558,MATH 105,A01,085443,Carter; Anne Toulson,4,1,35,31
1656089084558,MATH 105,A02,093477,Staff,11,0,35,24
1656089090590,MATH 109,A01,083213,Ganzberger; Geoffrey Michael,1,1,34,33
1656089090590,MATH 109,A02,083214,Ganzberger; Geoffrey Michael,0,0,34,34
1656089090590,MATH 109,A03,093478,Staff,3,0,34,31
1656089090590,MATH 109,B01,083215,Ganzberger; Geoffrey Michael,4,0,32,28
1656089090590,MATH 109,B02,083216,Ganzberger; Geoffrey Michael,1,0,32,31
1656089090590,MATH 109,B03,093479,Staff,4,0,32,28
1656089096624,MATH 142A,A01,083219,Chow; Bennett,2,0,32,30
1656089096624,MATH 142A,A02,083220,Chow; Bennett,8,0,32,24
1656089096624,MATH 142A,A03,093480,Staff,5,0,32,27
1656089096624,MATH 142A,B03,093481,Staff,4,0,32,28
1656089096624,MATH 142A,B04,093558,Staff,7,0,32,25
1656089096624,MATH 142A,B05,093559,Staff,0,0,32,32
1656089102654,MATH 193A,A01,083224,Rotar; Vladimir,1,2,34,33
1656089102654,MATH 193A,A02,083225,Rotar; Vladimir,2,0,34,32
1656089102654,MATH 193A,A03,083781,Rotar; Vladimir,2,0,34,32
1656089102654,MATH 193A,A04,083782,Rotar; Vladimir,7,0,34,27
1656089102654,MATH 193A,A05,093482,Rotar; Vladimir,1,0,34,33
1656089108676,MATH 197,001,091859,McAuley; Julian John,9999,0,9999,0
1656089108676,MATH 197,002,095566,Kedlaya; Kiran S.,9997,0,9999,2
1656089108676,MATH 197,003,095567,Xiao; Ming,9999,0,9999,0
1656089108676,MATH 197,004,095571,Perols; Johan Lars,9998,0,9999,1
1656089115739,COGS 9,A01,083615,Shannon; Kyle Michael,4,1,75,71
1656089121763,COGS 11,A01,083617,Boyle; Mary E. T.,16,1,48,32
1656089127796,COGS 13,A01,083071,Bastos; Amalia Pinkusfeld,8,2,71,63
1656089133820,COGS 14A,A01,092681,Semenuks; Arturs,8,23,100,92
1656089139844,COGS 14B,A01,083073,Cheng; Tzu-Han,8,0,63,55
1656089145869,COGS 17,A01,092677,Semenuks; Arturs,13,6,81,68
1656089151896,COGS 100,A01,083619,Allen; Michael Gordon,8,2,70,62
1656089157921,COGS 101A,A01,083621,Davis; Joshua Daniel,7,3,68,61
1656089163942,COGS 101B,A01,091572,Allen; Michael Gordon,7,0,65,58
1656089169978,COGS 101C,A01,083625,Delgado; Tania,11,0,35,24
1656089176006,COGS 107A,A01,083627,Boyle; Mary E. T.,5,2,60,55
1656089182028,COGS 118A,A01,083075,Gupta; Anjum,24,16,76,52
1656089188053,CSE 3,A50,083646,Miranda; Gregory Joseph,20,0,50,30
1656089194080,CSE 8A,A50,083650,Miranda; Gregory Joseph,13,11,56,43
1656089200108,CSE 11,A01,083080,Cao; Yingjun,1,60,40,39
1656089206134,CSE 12,A01,083652,Krause-Levy; Sophia Louisa,14,7,120,106
1656089212159,CSE 15L,A01,083654,Morris; Justin Loren,5,1,50,45
1656089212159,CSE 15L,A02,083655,Morris; Justin Loren,7,0,50,43
1656089218196,CSE 20,A01,083657,Tran; Khoa Dang,31,0,80,49
1656089224220,CSE 21,A01,095574,Bach; Quang Tran,28,0,48,20
1656089230254,CSE 30,A01,083084,Eldon; John,3,10,80,77
1656089230254,CSE 30,B01,095061,Bhaskar; Nishant,4,5,50,46
1656089236277,CSE 100,A01,083659,Cao; Yingjun,2,23,70,68
1656089242307,CSE 134B,A01,083661,Powell; Thomas Allan,10,6,100,90
1656089248330,CSE 140,A01,083663,Gungor; Onat,9,0,85,76
1656089254352,CSE 140L,A01,083088,Eldon; John,8,0,100,92
1656089260385,CSE 175,A01,083665,Kumar; Rakesh,2,0,25,23
1656089266413,CSE 190,A00,092507,Dubnov; Shlomo,3,0,20,17
1656089272435,ECE 45,A01,083139,Congero; Spencer William,5,2,75,70
1656089278463,ECE 65,A50,083695,Saad; Andrew S,8,0,30,22
1656089278463,ECE 65,A51,095125,Staff,23,0,26,3
1656089284486,ECE 109,A01,091882,Touri; Behrouz,5,4,70,65
1656089290510,ECE 180,A00,083140,Abi Samra; Nicholas Camill,1,0,30,29
1656089290510,ECE 180,B00,083141,Abi Samra; Nicholas Camill,4,8,30,26
1656089296532,MATH 10A,A01,083735,Patchell; Gregory David,1,0,30,29
1656089296532,MATH 10A,A02,083736,Patchell; Gregory David,23,0,30,7
1656089296532,MATH 10A,A03,083737,Patchell; Gregory David,16,0,30,14
1656089302563,MATH 10B,A01,083207,Lim; Seonhee,3,1,34,31
1656089302563,MATH 10B,A02,083208,Lim; Seonhee,10,2,35,25
1656089302563,MATH 10B,A03,093472,Staff,4,1,34,30
1656089302563,MATH 10B,B01,083739,Sinha; Shubham,12,0,30,18
1656089308588,MATH 18,A01,083743,Cinel; Cameron Alexander,7,0,30,23
1656089308588,MATH 18,A02,083744,Cinel; Cameron Alexander,12,0,30,18
1656089308588,MATH 18,A03,083745,Cinel; Cameron Alexander,3,0,30,27
1656089308588,MATH 18,B01,083748,Ma; Zilu,1,0,36,35
1656089308588,MATH 18,B02,083749,Ma; Zilu,1,0,36,35
1656089308588,MATH 18,B03,083750,Ma; Zilu,0,0,36,36
1656089308588,MATH 18,B04,083751,Ma; Zilu,0,0,36,36
1656089308588,MATH 18,B05,093473,Staff,3,0,36,33
1656089308588,MATH 18,B06,093474,Staff,4,0,36,32
1656089314614,MATH 20A,A01,083754,Zheng; Zequn,11,0,40,29
1656089320638,MATH 20B,A01,083756,Briones; Jor-el Thomas Caparas,0,0,36,36
1656089320638,MATH 20B,A02,083757,Briones; Jor-el Thomas Caparas,2,0,36,34
1656089320638,MATH 20B,A03,093475,Staff,3,0,36,33
1656089326663,MATH 20C,A01,083760,Briones; Jor-el Thomas Caparas,2,2,35,33
1656089326663,MATH 20C,A02,083761,Briones; Jor-el Thomas Caparas,9,1,35,26
1656089326663,MATH 20C,A03,093476,Staff,1,1,35,34
1656089326663,MATH 20C,B01,083762,Bach; Quang Tran,4,0,30,26
1656089332690,MATH 20D,A01,083765,Tran; Brian Kha,3,0,30,27
1656089332690,MATH 20D,A02,083766,Tran; Brian Kha,0,1,30,30
1656089332690,MATH 20D,A03,083767,Tran; Brian Kha,2,0,30,28
1656089338715,MATH 20E,A01,083771,Ganguly; Soumya,4,1,32,28
1656089338715,MATH 20E,A02,083772,Ganguly; Soumya,2,1,32,30
1656089338715,MATH 20E,B01,083773,Ciotti; Benjamin,15,0,35,20
1656089338715,MATH 20E,B02,083774,Ciotti; Benjamin,15,0,35,20
1656089344744,MATH 103A,A01,083777,Greenfeld; Be'Eri,3,0,36,33
1656089344744,MATH 103A,A02,083778,Greenfeld; Be'Eri,3,0,36,33
1656089344744,MATH 103A,A03,093561,Staff,4,1,36,32
1656089344744,MATH 103A,B01,083779,Greenfeld; Be'Eri,8,1,36,28
1656089344744,MATH 103A,B02,083780,Greenfeld; Be'Eri,0,1,36,36
1656089344744,MATH 103A,B03,093562,Staff,0,0,36,36
1656089350770,MATH 105,A01,085443,Carter; Anne Toulson,4,1,35,31
1656089350770,MATH 105,A02,093477,Staff,11,0,35,24
1656089356796,MATH 109,A01,083213,Ganzberger; Geoffrey Michael,1,1,34,33
1656089356796,MATH 109,A02,083214,Ganzberger; Geoffrey Michael,0,0,34,34
1656089356796,MATH 109,A03,093478,Staff,3,0,34,31
1656089356796,MATH 109,B01,083215,Ganzberger; Geoffrey Michael,4,0,32,28
1656089356796,MATH 109,B02,083216,Ganzberger; Geoffrey Michael,1,0,32,31
1656089356796,MATH 109,B03,093479,Staff,4,0,32,28
1656089362828,MATH 142A,A01,083219,Chow; Bennett,2,0,32,30
1656089362828,MATH 142A,A02,083220,Chow; Bennett,8,0,32,24
1656089362828,MATH 142A,A03,093480,Staff,5,0,32,27
1656089362828,MATH 142A,B03,093481,Staff,4,0,32,28
1656089362828,MATH 142A,B04,093558,Staff,7,0,32,25
1656089362828,MATH 142A,B05,093559,Staff,0,0,32,32
1656089368850,MATH 193A,A01,083224,Rotar; Vladimir,1,2,34,33
1656089368850,MATH 193A,A02,083225,Rotar; Vladimir,2,0,34,32
1656089368850,MATH 193A,A03,083781,Rotar; Vladimir,2,0,34,32
1656089368850,MATH 193A,A04,083782,Rotar; Vladimir,7,0,34,27
1656089368850,MATH 193A,A05,093482,Rotar; Vladimir,1,0,34,33
1656089374889,MATH 197,001,091859,McAuley; Julian John,9999,0,9999,0
1656089374889,MATH 197,002,095566,Kedlaya; Kiran S.,9997,0,9999,2
1656089374889,MATH 197,003,095567,Xiao; Ming,9999,0,9999,0
1656089374889,MATH 197,004,095571,Perols; Johan Lars,9998,0,9999,1
1656089381940,COGS 9,A01,083615,Shannon; Kyle Michael,4,1,75,71
1656089387966,COGS 11,A01,083617,Boyle; Mary E. T.,16,1,48,32
1656089393988,COGS 13,A01,083071,Bastos; Amalia Pinkusfeld,8,2,71,63
1656089400014,COGS 14A,A01,092681,Semenuks; Arturs,8,23,100,92
1656089406043,COGS 14B,A01,083073,Cheng; Tzu-Han,8,0,63,55
1656089412073,COGS 17,A01,092677,Semenuks; Arturs,13,6,81,68
1656089418101,COGS 100,A01,083619,Allen; Michael Gordon,8,2,70,62
1656089424131,COGS 101A,A01,083621,Davis; Joshua Daniel,7,3,68,61
1656089430155,COGS 101B,A01,091572,Allen; Michael Gordon,7,0,65,58
1656089436196,COGS 101C,A01,083625,Delgado; Tania,11,0,35,24
1656089442219,COGS 107A,A01,083627,Boyle; Mary E. T.,5,2,60,55
1656089448249,COGS 118A,A01,083075,Gupta; Anjum,24,16,76,52
1656089454284,CSE 3,A50,083646,Miranda; Gregory Joseph,20,0,50,30
1656089460307,CSE 8A,A50,083650,Miranda; Gregory Joseph,13,11,56,43
1656089466334,CSE 11,A01,083080,Cao; Yingjun,1,60,40,39
1656089472374,CSE 12,A01,083652,Krause-Levy; Sophia Louisa,14,7,120,106
1656089478398,CSE 15L,A01,083654,Morris; Justin Loren,5,1,50,45
1656089478398,CSE 15L,A02,083655,Morris; Justin Loren,7,0,50,43
1656089484420,CSE 20,A01,083657,Tran; Khoa Dang,31,0,80,49
1656089490443,CSE 21,A01,095574,Bach; Quang Tran,28,0,48,20
1656089496474,CSE 30,A01,083084,Eldon; John,3,10,80,77
1656089496474,CSE 30,B01,095061,Bhaskar; Nishant,4,5,50,46
1656089502497,CSE 100,A01,083659,Cao; Yingjun,2,23,70,68
1656089508524,CSE 134B,A01,083661,Powell; Thomas Allan,10,6,100,90
1656089514548,CSE 140,A01,083663,Gungor; Onat,9,0,85,76
1656089520574,CSE 140L,A01,083088,Eldon; John,8,0,100,92
1656089526601,CSE 175,A01,083665,Kumar; Rakesh,2,0,25,23
1656089532631,CSE 190,A00,092507,Dubnov; Shlomo,3,0,20,17
1656089538654,ECE 45,A01,083139,Congero; Spencer William,5,2,75,70
1656089544677,ECE 65,A50,083695,Saad; Andrew S,8,0,30,22
1656089544677,ECE 65,A51,095125,Staff,23,0,26,3
1656089550702,ECE 109,A01,091882,Touri; Behrouz,5,4,70,65
1656089556727,ECE 180,A00,083140,Abi Samra; Nicholas Camill,1,0,30,29
1656089556727,ECE 180,B00,083141,Abi Samra; Nicholas Camill,4,8,30,26
1656089562751,MATH 10A,A01,083735,Patchell; Gregory David,1,0,30,29
1656089562751,MATH 10A,A02,083736,Patchell; Gregory David,23,0,30,7
1656089562751,MATH 10A,A03,083737,Patchell; Gregory David,16,0,30,14
1656089568781,MATH 10B,A01,083207,Lim; Seonhee,3,1,34,31
1656089568781,MATH 10B,A02,083208,Lim; Seonhee,10,2,35,25
1656089568781,MATH 10B,A03,093472,Staff,4,1,34,30
1656089568781,MATH 10B,B01,083739,Sinha; Shubham,12,0,30,18
1656089574817,MATH 18,A01,083743,Cinel; Cameron Alexander,7,0,30,23
1656089574817,MATH 18,A02,083744,Cinel; Cameron Alexander,12,0,30,18
1656089574817,MATH 18,A03,083745,Cinel; Cameron Alexander,3,0,30,27
1656089574817,MATH 18,B01,083748,Ma; Zilu,1,0,36,35
1656089574817,MATH 18,B02,083749,Ma; Zilu,1,0,36,35
1656089574817,MATH 18,B03,083750,Ma; Zilu,0,0,36,36
1656089574817,MATH 18,B04,083751,Ma; Zilu,0,0,36,36
1656089574817,MATH 18,B05,093473,Staff,3,0,36,33
1656089574817,MATH 18,B06,093474,Staff,4,0,36,32
1656089580914,MATH 20A,A01,083754,Zheng; Zequn,11,0,40,29
1656089586940,MATH 20B,A01,083756,Briones; Jor-el Thomas Caparas,0,0,36,36
1656089586940,MATH 20B,A02,083757,Briones; Jor-el Thomas Caparas,2,0,36,34
1656089586940,MATH 20B,A03,093475,Staff,3,0,36,33
1656089592970,MATH 20C,A01,083760,Briones; Jor-el Thomas Caparas,2,2,35,33
1656089592970,MATH 20C,A02,083761,Briones; Jor-el Thomas Caparas,9,1,35,26
1656089592970,MATH 20C,A03,093476,Staff,1,1,35,34
1656089592970,MATH 20C,B01,083762,Bach; Quang Tran,4,0,30,26
1656089598998,MATH 20D,A01,083765,Tran; Brian Kha,3,0,30,27
1656089598998,MATH 20D,A02,083766,Tran; Brian Kha,0,1,30,30
1656089598998,MATH 20D,A03,083767,Tran; Brian Kha,2,0,30,28
1656089605032,MATH 20E,A01,083771,Ganguly; Soumya,4,1,32,28
1656089605032,MATH 20E,A02,083772,Ganguly; Soumya,2,1,32,30
1656089605032,MATH 20E,B01,083773,Ciotti; Benjamin,15,0,35,20
1656089605032,MATH 20E,B02,083774,Ciotti; Benjamin,15,0,35,20
1656089611056,MATH 103A,A01,083777,Greenfeld; Be'Eri,3,0,36,33
1656089611056,MATH 103A,A02,083778,Greenfeld; Be'Eri,3,0,36,33
1656089611056,MATH 103A,A03,093561,Staff,4,1,36,32
1656089611056,MATH 103A,B01,083779,Greenfeld; Be'Eri,8,1,36,28
1656089611056,MATH 103A,B02,083780,Greenfeld; Be'Eri,0,1,36,36
1656089611056,MATH 103A,B03,093562,Staff,0,0,36,36
1656089617084,MATH 105,A01,085443,Carter; Anne Toulson,4,1,35,31
1656089617084,MATH 105,A02,093477,Staff,11,0,35,24
1656089623108,MATH 109,A01,083213,Ganzberger; Geoffrey Michael,1,1,34,33
1656089623108,MATH 109,A02,083214,Ganzberger; Geoffrey Michael,0,0,34,34
1656089623108,MATH 109,A03,093478,Staff,3,0,34,31
1656089623108,MATH 109,B01,083215,Ganzberger; Geoffrey Michael,4,0,32,28
1656089623108,MATH 109,B02,083216,Ganzberger; Geoffrey Michael,1,0,32,31
1656089623108,MATH 109,B03,093479,Staff,4,0,32,28
1656089629130,MATH 142A,A01,083219,Chow; Bennett,2,0,32,30
1656089629130,MATH 142A,A02,083220,Chow; Bennett,8,0,32,24
1656089629130,MATH 142A,A03,093480,Staff,5,0,32,27
1656089629130,MATH 142A,B03,093481,Staff,4,0,32,28
1656089629130,MATH 142A,B04,093558,Staff,7,0,32,25
1656089629130,MATH 142A,B05,093559,Staff,0,0,32,32
1656089635160,MATH 193A,A01,083224,Rotar; Vladimir,1,2,34,33
1656089635160,MATH 193A,A02,083225,Rotar; Vladimir,2,0,34,32
1656089635160,MATH 193A,A03,083781,Rotar; Vladimir,2,0,34,32
1656089635160,MATH 193A,A04,083782,Rotar; Vladimir,7,0,34,27
1656089635160,MATH 193A,A05,093482,Rotar; Vladimir,1,0,34,33
1656089641185,MATH 197,001,091859,McAuley; Julian John,9999,0,9999,0
1656089641185,MATH 197,002,095566,Kedlaya; Kiran S.,9997,0,9999,2
1656089641185,MATH 197,003,095567,Xiao; Ming,9999,0,9999,0
1656089641185,MATH 197,004,095571,Perols; Johan Lars,9998,0,9999,1
1656089648251,COGS 9,A01,083615,Shannon; Kyle Michael,4,1,75,71
1656089654275,COGS 11,A01,083617,Boyle; Mary E. T.,16,1,48,32
1656089660298,COGS 13,A01,083071,Bastos; Amalia Pinkusfeld,8,2,71,63
1656089666330,COGS 14A,A01,092681,Semenuks; Arturs,8,23,100,92
1656089672364,COGS 14B,A01,083073,Cheng; Tzu-Han,8,0,63,55
1656089678389,COGS 17,A01,092677,Semenuks; Arturs,13,6,81,68
1656089684413,COGS 100,A01,083619,Allen; Michael Gordon,8,2,70,62
1656089690440,COGS 101A,A01,083621,Davis; Joshua Daniel,7,3,68,61
1656089696467,COGS 101B,A01,091572,Allen; Michael Gordon,7,0,65,58
1656089702491,COGS 101C,A01,083625,Delgado; Tania,11,0,35,24
1656089708514,COGS 107A,A01,083627,Boyle; Mary E. T.,5,2,60,55
1656089714540,COGS 118A,A01,083075,Gupta; Anjum,24,16,76,52
1656089720570,CSE 3,A50,083646,Miranda; Gregory Joseph,20,0,50,30
1656089726597,CSE 8A,A50,083650,Miranda; Gregory Joseph,13,11,56,43
1656089732621,CSE 11,A01,083080,Cao; Yingjun,1,60,40,39
1656089738649,CSE 12,A01,083652,Krause-Levy; Sophia Louisa,14,7,120,106
1656089744673,CSE 15L,A01,083654,Morris; Justin Loren,5,1,50,45
1656089744673,CSE 15L,A02,083655,Morris; Justin Loren,7,0,50,43
1656089750701,CSE 20,A01,083657,Tran; Khoa Dang,31,0,80,49
1656089756736,CSE 21,A01,095574,Bach; Quang Tran,28,0,48,20
1656089762759,CSE 30,A01,083084,Eldon; John,3,10,80,77
1656089762759,CSE 30,B01,095061,Bhaskar; Nishant,4,5,50,46
1656089768781,CSE 100,A01,083659,Cao; Yingjun,2,23,70,68
1656089774819,CSE 134B,A01,083661,Powell; Thomas Allan,10,6,100,90
1656089780842,CSE 140,A01,083663,Gungor; Onat,9,0,85,76
1656089786876,CSE 140L,A01,083088,Eldon; John,8,0,100,92
1656089792901,CSE 175,A01,083665,Kumar; Rakesh,2,0,25,23
1656089798933,CSE 190,A00,092507,Dubnov; Shlomo,3,0,20,17
1656089804960,ECE 45,A01,083139,Congero; Spencer William,5,2,75,70
1656089810986,ECE 65,A50,083695,Saad; Andrew S,8,0,30,22
1656089810986,ECE 65,A51,095125,Staff,23,0,26,3
1656089817012,ECE 109,A01,091882,Touri; Behrouz,5,4,70,65
1656089823038,ECE 180,A00,083140,Abi Samra; Nicholas Camill,1,0,30,29
1656089823038,ECE 180,B00,083141,Abi Samra; Nicholas Camill,4,8,30,26
1656089829070,MATH 10A,A01,083735,Patchell; Gregory David,1,0,30,29
1656089829070,MATH 10A,A02,083736,Patchell; Gregory David,23,0,30,7
1656089829070,MATH 10A,A03,083737,Patchell; Gregory David,16,0,30,14
1656089835092,MATH 10B,A01,083207,Lim; Seonhee,3,1,34,31
1656089835092,MATH 10B,A02,083208,Lim; Seonhee,10,2,35,25
1656089835092,MATH 10B,A03,093472,Staff,4,1,34,30
1656089835092,MATH 10B,B01,083739,Sinha; Shubham,12,0,30,18
1656089841117,MATH 18,A01,083743,Cinel; Cameron Alexander,7,0,30,23
1656089841117,MATH 18,A02,083744,Cinel; Cameron Alexander,12,0,30,18
1656089841117,MATH 18,A03,083745,Cinel; Cameron Alexander,3,0,30,27
1656089841117,MATH 18,B01,083748,Ma; Zilu,1,0,36,35
1656089841117,MATH 18,B02,083749,Ma; Zilu,1,0,36,35
1656089841117,MATH 18,B03,083750,Ma; Zilu,0,0,36,36
1656089841117,MATH 18,B04,083751,Ma; Zilu,0,0,36,36
1656089841117,MATH 18,B05,093473,Staff,3,0,36,33
1656089841117,MATH 18,B06,093474,Staff,4,0,36,32
1656089847158,MATH 20A,A01,083754,Zheng; Zequn,11,0,40,29
1656089853181,MATH 20B,A01,083756,Briones; Jor-el Thomas Caparas,0,0,36,36
1656089853181,MATH 20B,A02,083757,Briones; Jor-el Thomas Caparas,2,0,36,34
1656089853181,MATH 20B,A03,093475,Staff,3,0,36,33
1656089859209,MATH 20C,A01,083760,Briones; Jor-el Thomas Caparas,2,2,35,33
1656089859209,MATH 20C,A02,083761,Briones; Jor-el Thomas Caparas,9,1,35,26
1656089859209,MATH 20C,A03,093476,Staff,1,1,35,34
1656089859209,MATH 20C,B01,083762,Bach; Quang Tran,4,0,30,26
1656089865233,MATH 20D,A01,083765,Tran; Brian Kha,3,0,30,27
1656089865233,MATH 20D,A02,083766,Tran; Brian Kha,0,1,30,30
1656089865233,MATH 20D,A03,083767,Tran; Brian Kha,2,0,30,28
1656089871258,MATH 20E,A01,083771,Ganguly; Soumya,4,1,32,28
1656089871258,MATH 20E,A02,083772,Ganguly; Soumya,2,1,32,30
1656089871258,MATH 20E,B01,083773,Ciotti; Benjamin,15,0,35,20
1656089871258,MATH 20E,B02,083774,Ciotti; Benjamin,15,0,35,20
1656089877282,MATH 103A,A01,083777,Greenfeld; Be'Eri,3,0,36,33
1656089877282,MATH 103A,A02,083778,Greenfeld; Be'Eri,3,0,36,33
1656089877282,MATH 103A,A03,093561,Staff,4,1,36,32
1656089877282,MATH 103A,B01,083779,Greenfeld; Be'Eri,8,1,36,28
1656089877282,MATH 103A,B02,083780,Greenfeld; Be'Eri,0,1,36,36
1656089877282,MATH 103A,B03,093562,Staff,0,0,36,36
1656089883310,MATH 105,A01,085443,Carter; Anne Toulson,4,1,35,31
1656089883310,MATH 105,A02,093477,Staff,11,0,35,24
1656089889336,MATH 109,A01,083213,Ganzberger; Geoffrey Michael,1,1,34,33
1656089889336,MATH 109,A02,083214,Ganzberger; Geoffrey Michael,0,0,34,34
1656089889336,MATH 109,A03,093478,Staff,3,0,34,31
1656089889336,MATH 109,B01,083215,Ganzberger; Geoffrey Michael,4,0,32,28
1656089889336,MATH 109,B02,083216,Ganzberger; Geoffrey Michael,1,0,32,31
1656089889336,MATH 109,B03,093479,Staff,4,0,32,28
1656089895364,MATH 142A,A01,083219,Chow; Bennett,2,0,32,30
1656089895364,MATH 142A,A02,083220,Chow; Bennett,8,0,32,24
1656089895364,MATH 142A,A03,093480,Staff,5,0,32,27
1656089895364,MATH 142A,B03,093481,Staff,4,0,32,28
1656089895364,MATH 142A,B04,093558,Staff,7,0,32,25
1656089895364,MATH 142A,B05,093559,Staff,0,0,32,32
1656089901393,MATH 193A,A01,083224,Rotar; Vladimir,1,2,34,33
1656089901393,MATH 193A,A02,083225,Rotar; Vladimir,2,0,34,32
1656089901393,MATH 193A,A03,083781,Rotar; Vladimir,2,0,34,32
1656089901393,MATH 193A,A04,083782,Rotar; Vladimir,7,0,34,27
1656089901393,MATH 193A,A05,093482,Rotar; Vladimir,1,0,34,33
1656089907423,MATH 197,001,091859,McAuley; Julian John,9999,0,9999,0
1656089907423,MATH 197,002,095566,Kedlaya; Kiran S.,9997,0,9999,2
1656089907423,MATH 197,003,095567,Xiao; Ming,9999,0,9999,0
1656089907423,MATH 197,004,095571,Perols; Johan Lars,9998,0,9999,1
1656089914476,COGS 9,A01,083615,Shannon; Kyle Michael,4,1,75,71
1656089920508,COGS 11,A01,083617,Boyle; Mary E. T.,16,1,48,32
1656089926534,COGS 13,A01,083071,Bastos; Amalia Pinkusfeld,8,2,71,63
1656089932564,COGS 14A,A01,092681,Semenuks; Arturs,8,23,100,92
1656089938601,COGS 14B,A01,083073,Cheng; Tzu-Han,8,0,63,55
1656089944628,COGS 17,A01,092677,Semenuks; Arturs,13,6,81,68
1656089950652,COGS 100,A01,083619,Allen; Michael Gordon,8,2,70,62
1656089956675,COGS 101A,A01,083621,Davis; Joshua Daniel,7,3,68,61
1656089962698,COGS 101B,A01,091572,Allen; Michael Gordon,7,0,65,58
1656089968725,COGS 101C,A01,083625,Delgado; Tania,11,0,35,24
1656089974748,COGS 107A,A01,083627,Boyle; Mary E. T.,5,2,60,55
1656089980775,COGS 118A,A01,083075,Gupta; Anjum,24,16,76,52
1656089986799,CSE 3,A50,083646,Miranda; Gregory Joseph,20,0,50,30
1656089992823,CSE 8A,A50,083650,Miranda; Gregory Joseph,13,11,56,43
1656089998846,CSE 11,A01,083080,Cao; Yingjun,1,60,40,39
1656090004867,CSE 12,A01,083652,Krause-Levy; Sophia Louisa,14,7,120,106
1656090010900,CSE 15L,A01,083654,Morris; Justin Loren,5,1,50,45
1656090010900,CSE 15L,A02,083655,Morris; Justin Loren,7,0,50,43
1656090016921,CSE 20,A01,083657,Tran; Khoa Dang,31,0,80,49
1656090022948,CSE 21,A01,095574,Bach; Quang Tran,28,0,48,20
1656090028975,CSE 30,A01,083084,Eldon; John,3,10,80,77
1656090028975,CSE 30,B01,095061,Bhaskar; Nishant,4,5,50,46
1656090035001,CSE 100,A01,083659,Cao; Yingjun,2,23,70,68
1656090041027,CSE 134B,A01,083661,Powell; Thomas Allan,10,6,100,90
1656090047061,CSE 140,A01,083663,Gungor; Onat,9,0,85,76
1656090053086,CSE 140L,A01,083088,Eldon; John,8,0,100,92
1656090059108,CSE 175,A01,083665,Kumar; Rakesh,2,0,25,23
1656090065136,CSE 190,A00,092507,Dubnov; Shlomo,3,0,20,17
1656090071161,ECE 45,A01,083139,Congero; Spencer William,5,2,75,70
1656090077185,ECE 65,A50,083695,Saad; Andrew S,8,0,30,22
1656090077185,ECE 65,A51,095125,Staff,23,0,26,3
1656090083214,ECE 109,A01,091882,Touri; Behrouz,5,4,70,65
1656090089254,ECE 180,A00,083140,Abi Samra; Nicholas Camill,1,0,30,29
1656090089254,ECE 180,B00,083141,Abi Samra; Nicholas Camill,4,8,30,26
1656090095276,MATH 10A,A01,083735,Patchell; Gregory David,1,0,30,29
1656090095276,MATH 10A,A02,083736,Patchell; Gregory David,23,0,30,7
1656090095276,MATH 10A,A03,083737,Patchell; Gregory David,16,0,30,14
1656090101305,MATH 10B,A01,083207,Lim; Seonhee,3,1,34,31
1656090101305,MATH 10B,A02,083208,Lim; Seonhee,10,2,35,25
1656090101305,MATH 10B,A03,093472,Staff,4,1,34,30
1656090101305,MATH 10B,B01,083739,Sinha; Shubham,12,0,30,18
1656090107336,MATH 18,A01,083743,Cinel; Cameron Alexander,7,0,30,23
1656090107336,MATH 18,A02,083744,Cinel; Cameron Alexander,12,0,30,18
1656090107336,MATH 18,A03,083745,Cinel; Cameron Alexander,3,0,30,27
1656090107336,MATH 18,B01,083748,Ma; Zilu,1,0,36,35
1656090107336,MATH 18,B02,083749,Ma; Zilu,1,0,36,35
1656090107336,MATH 18,B03,083750,Ma; Zilu,0,0,36,36
1656090107336,MATH 18,B04,083751,Ma; Zilu,0,0,36,36
1656090107336,MATH 18,B05,093473,Staff,3,0,36,33
1656090107336,MATH 18,B06,093474,Staff,4,0,36,32
1656090113357,MATH 20A,A01,083754,Zheng; Zequn,11,0,40,29
1656090119388,MATH 20B,A01,083756,Briones; Jor-el Thomas Caparas,0,0,36,36
1656090119388,MATH 20B,A02,083757,Briones; Jor-el Thomas Caparas,2,0,36,34
1656090119388,MATH 20B,A03,093475,Staff,3,0,36,33
1656090125425,MATH 20C,A01,083760,Briones; Jor-el Thomas Caparas,2,2,35,33
1656090125425,MATH 20C,A02,083761,Briones; Jor-el Thomas Caparas,9,1,35,26
1656090125425,MATH 20C,A03,093476,Staff,1,1,35,34
1656090125425,MATH 20C,B01,083762,Bach; Quang Tran,4,0,30,26
1656090131455,MATH 20D,A01,083765,Tran; Brian Kha,3,0,30,27
1656090131455,MATH 20D,A02,083766,Tran; Brian Kha,0,1,30,30
1656090131455,MATH 20D,A03,083767,Tran; Brian Kha,2,0,30,28
1656090137484,MATH 20E,A01,083771,Ganguly; Soumya,4,1,32,28
1656090137484,MATH 20E,A02,083772,Ganguly; Soumya,2,1,32,30
1656090137484,MATH 20E,B01,083773,Ciotti; Benjamin,15,0,35,20
1656090137484,MATH 20E,B02,083774,Ciotti; Benjamin,15,0,35,20
1656090143508,MATH 103A,A01,083777,Greenfeld; Be'Eri,3,0,36,33
1656090143508,MATH 103A,A02,083778,Greenfeld; Be'Eri,3,0,36,33
1656090143508,MATH 103A,A03,093561,Staff,4,1,36,32
1656090143508,MATH 103A,B01,083779,Greenfeld; Be'Eri,8,1,36,28
1656090143508,MATH 103A,B02,083780,Greenfeld; Be'Eri,0,1,36,36
1656090143508,MATH 103A,B03,093562,Staff,0,0,36,36
1656090149544,MATH 105,A01,085443,Carter; Anne Toulson,4,1,35,31
1656090149544,MATH 105,A02,093477,Staff,11,0,35,24
1656090155567,MATH 109,A01,083213,Ganzberger; Geoffrey Michael,1,1,34,33
1656090155567,MATH 109,A02,083214,Ganzberger; Geoffrey Michael,0,0,34,34
1656090155567,MATH 109,A03,093478,Staff,3,0,34,31
1656090155567,MATH 109,B01,083215,Ganzberger; Geoffrey Michael,4,0,32,28
1656090155567,MATH 109,B02,083216,Ganzberger; Geoffrey Michael,1,0,32,31
1656090155567,MATH 109,B03,093479,Staff,4,0,32,28
1656090161619,MATH 142A,A01,083219,Chow; Bennett,2,0,32,30
1656090161619,MATH 142A,A02,083220,Chow; Bennett,8,0,32,24
1656090161619,MATH 142A,A03,093480,Staff,5,0,32,27
1656090161619,MATH 142A,B03,093481,Staff,4,0,32,28
1656090161619,MATH 142A,B04,093558,Staff,7,0,32,25
1656090161619,MATH 142A,B05,093559,Staff,0,0,32,32
1656090167643,MATH 193A,A01,083224,Rotar; Vladimir,1,2,34,33
1656090167643,MATH 193A,A02,083225,Rotar; Vladimir,2,0,34,32
1656090167643,MATH 193A,A03,083781,Rotar; Vladimir,2,0,34,32
1656090167643,MATH 193A,A04,083782,Rotar; Vladimir,7,0,34,27
1656090167643,MATH 193A,A05,093482,Rotar; Vladimir,1,0,34,33
1656090173666,MATH 197,001,091859,McAuley; Julian John,9999,0,9999,0
1656090173666,MATH 197,002,095566,Kedlaya; Kiran S.,9997,0,9999,2
1656090173666,MATH 197,003,095567,Xiao; Ming,9999,0,9999,0
1656090173666,MATH 197,004,095571,Perols; Johan Lars,9998,0,9999,1
1656090180794,COGS 9,A01,083615,Shannon; Kyle Michael,4,1,75,71
1656090186817,COGS 11,A01,083617,Boyle; Mary E. T.,16,1,48,32
1656090192843,COGS 13,A01,083071,Bastos; Amalia Pinkusfeld,8,2,71,63
1656090198867,COGS 14A,A01,092681,Semenuks; Arturs,8,23,100,92
1656090204889,COGS 14B,A01,083073,Cheng; Tzu-Han,8,0,63,55
1656090210913,COGS 17,A01,092677,Semenuks; Arturs,13,6,81,68
1656090216939,COGS 100,A01,083619,Allen; Michael Gordon,8,2,70,62
1656090222967,COGS 101A,A01,083621,Davis; Joshua Daniel,7,3,68,61
1656090228995,COGS 101B,A01,091572,Allen; Michael Gordon,7,0,65,58
1656090235023,COGS 101C,A01,083625,Delgado; Tania,11,0,35,24
1656090241044,COGS 107A,A01,083627,Boyle; Mary E. T.,5,2,60,55
1656090247069,COGS 118A,A01,083075,Gupta; Anjum,24,16,76,52
1656090253104,CSE 3,A50,083646,Miranda; Gregory Joseph,20,0,50,30
1656090259127,CSE 8A,A50,083650,Miranda; Gregory Joseph,13,11,56,43
1656090265157,CSE 11,A01,083080,Cao; Yingjun,1,60,40,39
1656090271182,CSE 12,A01,083652,Krause-Levy; Sophia Louisa,14,7,120,106
1656090277205,CSE 15L,A01,083654,Morris; Justin Loren,5,1,50,45
1656090277205,CSE 15L,A02,083655,Morris; Justin Loren,7,0,50,43
1656090283228,CSE 20,A01,083657,Tran; Khoa Dang,31,0,80,49
1656090289256,CSE 21,A01,095574,Bach; Quang Tran,28,0,48,20
1656090295279,CSE 30,A01,083084,Eldon; John,3,10,80,77
1656090295279,CSE 30,B01,095061,Bhaskar; Nishant,4,5,50,46
1656090301304,CSE 100,A01,083659,Cao; Yingjun,2,23,70,68
1656090307331,CSE 134B,A01,083661,Powell; Thomas Allan,10,6,100,90
1656090313366,CSE 140,A01,083663,Gungor; Onat,9,0,85,76
1656090319390,CSE 140L,A01,083088,Eldon; John,8,0,100,92
1656090325422,CSE 175,A01,083665,Kumar; Rakesh,2,0,25,23
1656090331454,CSE 190,A00,092507,Dubnov; Shlomo,3,0,20,17
1656090337493,ECE 45,A01,083139,Congero; Spencer William,5,2,75,70
1656090343516,ECE 65,A50,083695,Saad; Andrew S,8,0,30,22
1656090343516,ECE 65,A51,095125,Staff,23,0,26,3
1656090349538,ECE 109,A01,091882,Touri; Behrouz,5,4,70,65
1656090355561,ECE 180,A00,083140,Abi Samra; Nicholas Camill,1,0,30,29
1656090355561,ECE 180,B00,083141,Abi Samra; Nicholas Camill,4,8,30,26
1656090361585,MATH 10A,A01,083735,Patchell; Gregory David,1,0,30,29
1656090361585,MATH 10A,A02,083736,Patchell; Gregory David,23,0,30,7
1656090361585,MATH 10A,A03,083737,Patchell; Gregory David,16,0,30,14
1656090367617,MATH 10B,A01,083207,Lim; Seonhee,3,1,34,31
1656090367617,MATH 10B,A02,083208,Lim; Seonhee,10,2,35,25
1656090367617,MATH 10B,A03,093472,Staff,4,1,34,30
1656090367617,MATH 10B,B01,083739,Sinha; Shubham,12,0,30,18
1656090373642,MATH 18,A01,083743,Cinel; Cameron Alexander,7,0,30,23
1656090373642,MATH 18,A02,083744,Cinel; Cameron Alexander,12,0,30,18
1656090373642,MATH 18,A03,083745,Cinel; Cameron Alexander,3,0,30,27
1656090373642,MATH 18,B01,083748,Ma; Zilu,1,0,36,35
1656090373642,MATH 18,B02,083749,Ma; Zilu,1,0,36,35
1656090373642,MATH 18,B03,083750,Ma; Zilu,0,0,36,36
1656090373642,MATH 18,B04,083751,Ma; Zilu,0,0,36,36
1656090373642,MATH 18,B05,093473,Staff,3,0,36,33
1656090373642,MATH 18,B06,093474,Staff,4,0,36,32
1656090379672,MATH 20A,A01,083754,Zheng; Zequn,11,0,40,29
1656090385712,MATH 20B,A01,083756,Briones; Jor-el Thomas Caparas,0,0,36,36
1656090385712,MATH 20B,A02,083757,Briones; Jor-el Thomas Caparas,2,0,36,34
1656090385712,MATH 20B,A03,093475,Staff,3,0,36,33
1656090391741,MATH 20C,A01,083760,Briones; Jor-el Thomas Caparas,2,2,35,33
1656090391741,MATH 20C,A02,083761,Briones; Jor-el Thomas Caparas,9,1,35,26
1656090391741,MATH 20C,A03,093476,Staff,1,1,35,34
1656090391741,MATH 20C,B01,083762,Bach; Quang Tran,4,0,30,26
1656090397766,MATH 20D,A01,083765,Tran; Brian Kha,3,0,30,27
1656090397766,MATH 20D,A02,083766,Tran; Brian Kha,0,1,30,30
1656090397766,MATH 20D,A03,083767,Tran; Brian Kha,2,0,30,28
1656090403797,MATH 20E,A01,083771,Ganguly; Soumya,4,1,32,28
1656090403797,MATH 20E,A02,083772,Ganguly; Soumya,2,1,32,30
1656090403797,MATH 20E,B01,083773,Ciotti; Benjamin,15,0,35,20
1656090403797,MATH 20E,B02,083774,Ciotti; Benjamin,15,0,35,20
1656090409824,MATH 103A,A01,083777,Greenfeld; Be'Eri,3,0,36,33
1656090409824,MATH 103A,A02,083778,Greenfeld; Be'Eri,3,0,36,33
1656090409824,MATH 103A,A03,093561,Staff,4,1,36,32
1656090409824,MATH 103A,B01,083779,Greenfeld; Be'Eri,8,1,36,28
1656090409824,MATH 103A,B02,083780,Greenfeld; Be'Eri,0,1,36,36
1656090409824,MATH 103A,B03,093562,Staff,0,0,36,36
1656090415854,MATH 105,A01,085443,Carter; Anne Toulson,4,1,35,31
1656090415854,MATH 105,A02,093477,Staff,11,0,35,24
1656090421886,MATH 109,A01,083213,Ganzberger; Geoffrey Michael,1,1,34,33
1656090421886,MATH 109,A02,083214,Ganzberger; Geoffrey Michael,0,0,34,34
1656090421886,MATH 109,A03,093478,Staff,3,0,34,31
1656090421886,MATH 109,B01,083215,Ganzberger; Geoffrey Michael,4,0,32,28
1656090421886,MATH 109,B02,083216,Ganzberger; Geoffrey Michael,1,0,32,31
1656090421886,MATH 109,B03,093479,Staff,4,0,32,28
1656090427915,MATH 142A,A01,083219,Chow; Bennett,2,0,32,30
1656090427915,MATH 142A,A02,083220,Chow; Bennett,8,0,32,24
1656090427915,MATH 142A,A03,093480,Staff,5,0,32,27
1656090427915,MATH 142A,B03,093481,Staff,4,0,32,28
1656090427915,MATH 142A,B04,093558,Staff,7,0,32,25
1656090427915,MATH 142A,B05,093559,Staff,0,0,32,32
1656090433948,MATH 193A,A01,083224,Rotar; Vladimir,1,2,34,33
1656090433948,MATH 193A,A02,083225,Rotar; Vladimir,2,0,34,32
1656090433948,MATH 193A,A03,083781,Rotar; Vladimir,2,0,34,32
1656090433948,MATH 193A,A04,083782,Rotar; Vladimir,7,0,34,27
1656090433948,MATH 193A,A05,093482,Rotar; Vladimir,1,0,34,33
1656090439982,MATH 197,001,091859,McAuley; Julian John,9999,0,9999,0
1656090439982,MATH 197,002,095566,Kedlaya; Kiran S.,9997,0,9999,2
1656090439982,MATH 197,003,095567,Xiao; Ming,9999,0,9999,0
1656090439982,MATH 197,004,095571,Perols; Johan Lars,9998,0,9999,1
1656090447044,COGS 9,A01,083615,Shannon; Kyle Michael,4,1,75,71
1656090453074,COGS 11,A01,083617,Boyle; Mary E. T.,16,1,48,32
1656090459098,COGS 13,A01,083071,Bastos; Amalia Pinkusfeld,8,2,71,63
1656090465132,COGS 14A,A01,092681,Semenuks; Arturs,8,23,100,92
1656090471158,COGS 14B,A01,083073,Cheng; Tzu-Han,8,0,63,55
1656090477181,COGS 17,A01,092677,Semenuks; Arturs,13,6,81,68
1656090483212,COGS 100,A01,083619,Allen; Michael Gordon,8,2,70,62
1656090489237,COGS 101A,A01,083621,Davis; Joshua Daniel,7,3,68,61
1656090495260,COGS 101B,A01,091572,Allen; Michael Gordon,7,0,65,58
1656090501284,COGS 101C,A01,083625,Delgado; Tania,11,0,35,24
1656090507312,COGS 107A,A01,083627,Boyle; Mary E. T.,5,2,60,55
1656090513343,COGS 118A,A01,083075,Gupta; Anjum,24,16,76,52
1656090519375,CSE 3,A50,083646,Miranda; Gregory Joseph,20,0,50,30
1656090525398,CSE 8A,A50,083650,Miranda; Gregory Joseph,13,11,56,43
1656090531422,CSE 11,A01,083080,Cao; Yingjun,1,60,40,39
1656090537448,CSE 12,A01,083652,Krause-Levy; Sophia Louisa,14,7,120,106
1656090543494,CSE 15L,A01,083654,Morris; Justin Loren,5,1,50,45
1656090543494,CSE 15L,A02,083655,Morris; Justin Loren,7,0,50,43
1656090549520,CSE 20,A01,083657,Tran; Khoa Dang,31,0,80,49
1656090555542,CSE 21,A01,095574,Bach; Quang Tran,28,0,48,20
1656090561571,CSE 30,A01,083084,Eldon; John,3,10,80,77
1656090561571,CSE 30,B01,095061,Bhaskar; Nishant,4,5,50,46
1656090567596,CSE 100,A01,083659,Cao; Yingjun,2,23,70,68
1656090573622,CSE 134B,A01,083661,Powell; Thomas Allan,10,6,100,90
1656090579646,CSE 140,A01,083663,Gungor; Onat,9,0,85,76
1656090585670,CSE 140L,A01,083088,Eldon; John,8,0,100,92
1656090591694,CSE 175,A01,083665,Kumar; Rakesh,2,0,25,23
1656090597725,CSE 190,A00,092507,Dubnov; Shlomo,3,0,20,17
1656090603751,ECE 45,A01,083139,Congero; Spencer William,5,2,75,70
1656090609778,ECE 65,A50,083695,Saad; Andrew S,8,0,30,22
1656090609778,ECE 65,A51,095125,Staff,23,0,26,3
1656090615802,ECE 109,A01,091882,Touri; Behrouz,5,4,70,65
1656090621831,ECE 180,A00,083140,Abi Samra; Nicholas Camill,1,0,30,29
1656090621831,ECE 180,B00,083141,Abi Samra; Nicholas Camill,4,8,30,26
1656090627855,MATH 10A,A01,083735,Patchell; Gregory David,1,0,30,29
1656090627855,MATH 10A,A02,083736,Patchell; Gregory David,23,0,30,7
1656090627855,MATH 10A,A03,083737,Patchell; Gregory David,16,0,30,14
1656090633884,MATH 10B,A01,083207,Lim; Seonhee,3,1,34,31
1656090633884,MATH 10B,A02,083208,Lim; Seonhee,10,2,35,25
1656090633884,MATH 10B,A03,093472,Staff,4,1,34,30
1656090633884,MATH 10B,B01,083739,Sinha; Shubham,12,0,30,18
1656090639916,MATH 18,A01,083743,Cinel; Cameron Alexander,7,0,30,23
1656090639916,MATH 18,A02,083744,Cinel; Cameron Alexander,12,0,30,18
1656090639916,MATH 18,A03,083745,Cinel; Cameron Alexander,3,0,30,27
1656090639916,MATH 18,B01,083748,Ma; Zilu,1,0,36,35
1656090639916,MATH 18,B02,083749,Ma; Zilu,1,0,36,35
1656090639916,MATH 18,B03,083750,Ma; Zilu,0,0,36,36
1656090639916,MATH 18,B04,083751,Ma; Zilu,0,0,36,36
1656090639916,MATH 18,B05,093473,Staff,3,0,36,33
1656090639916,MATH 18,B06,093474,Staff,4,0,36,32
1656090645941,MATH 20A,A01,083754,Zheng; Zequn,11,0,40,29
1656090651985,MATH 20B,A01,083756,Briones; Jor-el Thomas Caparas,0,0,36,36
1656090651985,MATH 20B,A02,083757,Briones; Jor-el Thomas Caparas,2,0,36,34
1656090651985,MATH 20B,A03,093475,Staff,3,0,36,33
1656090658009,MATH 20C,A01,083760,Briones; Jor-el Thomas Caparas,2,2,35,33
1656090658009,MATH 20C,A02,083761,Briones; Jor-el Thomas Caparas,9,1,35,26
1656090658009,MATH 20C,A03,093476,Staff,1,1,35,34
1656090658009,MATH 20C,B01,083762,Bach; Quang Tran,4,0,30,26
1656090664033,MATH 20D,A01,083765,Tran; Brian Kha,3,0,30,27
1656090664033,MATH 20D,A02,083766,Tran; Brian Kha,0,1,30,30
1656090664033,MATH 20D,A03,083767,Tran; Brian Kha,2,0,30,28
1656090670062,MATH 20E,A01,083771,Ganguly; Soumya,4,1,32,28
1656090670062,MATH 20E,A02,083772,Ganguly; Soumya,2,1,32,30
1656090670062,MATH 20E,B01,083773,Ciotti; Benjamin,15,0,35,20
1656090670062,MATH 20E,B02,083774,Ciotti; Benjamin,15,0,35,20
1656090676090,MATH 103A,A01,083777,Greenfeld; Be'Eri,3,0,36,33
1656090676090,MATH 103A,A02,083778,Greenfeld; Be'Eri,3,0,36,33
1656090676090,MATH 103A,A03,093561,Staff,4,1,36,32
1656090676090,MATH 103A,B01,083779,Greenfeld; Be'Eri,8,1,36,28
1656090676090,MATH 103A,B02,083780,Greenfeld; Be'Eri,0,1,36,36
1656090676090,MATH 103A,B03,093562,Staff,0,0,36,36
1656090682114,MATH 105,A01,085443,Carter; Anne Toulson,4,1,35,31
1656090682114,MATH 105,A02,093477,Staff,11,0,35,24
1656090688137,MATH 109,A01,083213,Ganzberger; Geoffrey Michael,1,1,34,33
1656090688137,MATH 109,A02,083214,Ganzberger; Geoffrey Michael,0,0,34,34
1656090688137,MATH 109,A03,093478,Staff,3,0,34,31
1656090688137,MATH 109,B01,083215,Ganzberger; Geoffrey Michael,4,0,32,28
1656090688137,MATH 109,B02,083216,Ganzberger; Geoffrey Michael,1,0,32,31
1656090688137,MATH 109,B03,093479,Staff,4,0,32,28
1656090694160,MATH 142A,A01,083219,Chow; Bennett,2,0,32,30
1656090694160,MATH 142A,A02,083220,Chow; Bennett,8,0,32,24
1656090694160,MATH 142A,A03,093480,Staff,5,0,32,27
1656090694160,MATH 142A,B03,093481,Staff,4,0,32,28
1656090694160,MATH 142A,B04,093558,Staff,7,0,32,25
1656090694160,MATH 142A,B05,093559,Staff,0,0,32,32
1656090700184,MATH 193A,A01,083224,Rotar; Vladimir,1,2,34,33
1656090700184,MATH 193A,A02,083225,Rotar; Vladimir,2,0,34,32
1656090700184,MATH 193A,A03,083781,Rotar; Vladimir,2,0,34,32
1656090700184,MATH 193A,A04,083782,Rotar; Vladimir,7,0,34,27
1656090700184,MATH 193A,A05,093482,Rotar; Vladimir,1,0,34,33
1656090706209,MATH 197,001,091859,McAuley; Julian John,9999,0,9999,0
1656090706209,MATH 197,002,095566,Kedlaya; Kiran S.,9997,0,9999,2
1656090706209,MATH 197,003,095567,Xiao; Ming,9999,0,9999,0
1656090706209,MATH 197,004,095571,Perols; Johan Lars,9998,0,9999,1
1656090713288,COGS 9,A01,083615,Shannon; Kyle Michael,4,1,75,71
1656090719314,COGS 11,A01,083617,Boyle; Mary E. T.,16,1,48,32
1656090725346,COGS 13,A01,083071,Bastos; Amalia Pinkusfeld,8,2,71,63
1656090731369,COGS 14A,A01,092681,Semenuks; Arturs,8,23,100,92
1656090737393,COGS 14B,A01,083073,Cheng; Tzu-Han,8,0,63,55
1656090743419,COGS 17,A01,092677,Semenuks; Arturs,13,6,81,68
1656090749448,COGS 100,A01,083619,Allen; Michael Gordon,8,2,70,62
1656090755482,COGS 101A,A01,083621,Davis; Joshua Daniel,7,3,68,61
1656090761513,COGS 101B,A01,091572,Allen; Michael Gordon,7,0,65,58
1656090767537,COGS 101C,A01,083625,Delgado; Tania,11,0,35,24
1656090773638,COGS 107A,A01,083627,Boyle; Mary E. T.,5,2,60,55
1656090779665,COGS 118A,A01,083075,Gupta; Anjum,24,16,76,52
1656090785694,CSE 3,A50,083646,Miranda; Gregory Joseph,20,0,50,30
1656090791726,CSE 8A,A50,083650,Miranda; Gregory Joseph,13,11,56,43
1656090797757,CSE 11,A01,083080,Cao; Yingjun,1,60,40,39
1656090803788,CSE 12,A01,083652,Krause-Levy; Sophia Louisa,14,7,120,106
1656090809813,CSE 15L,A01,083654,Morris; Justin Loren,5,1,50,45
1656090809813,CSE 15L,A02,083655,Morris; Justin Loren,7,0,50,43
1656090815836,CSE 20,A01,083657,Tran; Khoa Dang,31,0,80,49
1656090821868,CSE 21,A01,095574,Bach; Quang Tran,28,0,48,20
1656090827891,CSE 30,A01,083084,Eldon; John,3,10,80,77
1656090827891,CSE 30,B01,095061,Bhaskar; Nishant,4,5,50,46
1656090833916,CSE 100,A01,083659,Cao; Yingjun,2,23,70,68
1656090839944,CSE 134B,A01,083661,Powell; Thomas Allan,10,6,100,90
1656090845968,CSE 140,A01,083663,Gungor; Onat,9,0,85,76
1656090851996,CSE 140L,A01,083088,Eldon; John,8,0,100,92
1656090858023,CSE 175,A01,083665,Kumar; Rakesh,2,0,25,23
1656090864047,CSE 190,A00,092507,Dubnov; Shlomo,3,0,20,17
1656090870080,ECE 45,A01,083139,Congero; Spencer William,5,2,75,70
1656090876104,ECE 65,A50,083695,Saad; Andrew S,8,0,30,22
1656090876104,ECE 65,A51,095125,Staff,23,0,26,3
1656090882127,ECE 109,A01,091882,Touri; Behrouz,5,4,70,65
1656090888158,ECE 180,A00,083140,Abi Samra; Nicholas Camill,1,0,30,29
1656090888158,ECE 180,B00,083141,Abi Samra; Nicholas Camill,4,8,30,26
1656090894183,MATH 10A,A01,083735,Patchell; Gregory David,1,0,30,29
1656090894183,MATH 10A,A02,083736,Patchell; Gregory David,23,0,30,7
1656090894183,MATH 10A,A03,083737,Patchell; Gregory David,16,0,30,14
1656090900224,MATH 10B,A01,083207,Lim; Seonhee,3,1,34,31
1656090900224,MATH 10B,A02,083208,Lim; Seonhee,10,2,35,25
1656090900224,MATH 10B,A03,093472,Staff,4,1,34,30
1656090900224,MATH 10B,B01,083739,Sinha; Shubham,12,0,30,18
1656090906255,MATH 18,A01,083743,Cinel; Cameron Alexander,7,0,30,23
1656090906255,MATH 18,A02,083744,Cinel; Cameron Alexander,12,0,30,18
1656090906255,MATH 18,A03,083745,Cinel; Cameron Alexander,3,0,30,27
1656090906255,MATH 18,B01,083748,Ma; Zilu,1,0,36,35
1656090906255,MATH 18,B02,083749,Ma; Zilu,1,0,36,35
1656090906255,MATH 18,B03,083750,Ma; Zilu,0,0,36,36
1656090906255,MATH 18,B04,083751,Ma; Zilu,0,0,36,36
1656090906255,MATH 18,B05,093473,Staff,3,0,36,33
1656090906255,MATH 18,B06,093474,Staff,4,0,36,32
1656090912278,MATH 20A,A01,083754,Zheng; Zequn,11,0,40,29
1656090918301,MATH 20B,A01,083756,Briones; Jor-el Thomas Caparas,0,0,36,36
1656090918301,MATH 20B,A02,083757,Briones; Jor-el Thomas Caparas,2,0,36,34
1656090918301,MATH 20B,A03,093475,Staff,3,0,36,33
1656090924332,MATH 20C,A01,083760,Briones; Jor-el Thomas Caparas,2,2,35,33
1656090924332,MATH 20C,A02,083761,Briones; Jor-el Thomas Caparas,9,1,35,26
1656090924332,MATH 20C,A03,093476,Staff,1,1,35,34
1656090924332,MATH 20C,B01,083762,Bach; Quang Tran,4,0,30,26
1656090930360,MATH 20D,A01,083765,Tran; Brian Kha,3,0,30,27
1656090930360,MATH 20D,A02,083766,Tran; Brian Kha,0,1,30,30
1656090930360,MATH 20D,A03,083767,Tran; Brian Kha,2,0,30,28
1656090936388,MATH 20E,A01,083771,Ganguly; Soumya,4,1,32,28
1656090936388,MATH 20E,A02,083772,Ganguly; Soumya,2,1,32,30
1656090936388,MATH 20E,B01,083773,Ciotti; Benjamin,15,0,35,20
1656090936388,MATH 20E,B02,083774,Ciotti; Benjamin,15,0,35,20
1656090942414,MATH 103A,A01,083777,Greenfeld; Be'Eri,3,0,36,33
1656090942414,MATH 103A,A02,083778,Greenfeld; Be'Eri,3,0,36,33
1656090942414,MATH 103A,A03,093561,Staff,4,1,36,32
1656090942414,MATH 103A,B01,083779,Greenfeld; Be'Eri,8,1,36,28
1656090942414,MATH 103A,B02,083780,Greenfeld; Be'Eri,0,1,36,36
1656090942414,MATH 103A,B03,093562,Staff,0,0,36,36
1656090948457,MATH 105,A01,085443,Carter; Anne Toulson,4,1,35,31
1656090948457,MATH 105,A02,093477,Staff,11,0,35,24
1656090954486,MATH 109,A01,083213,Ganzberger; Geoffrey Michael,1,1,34,33
1656090954486,MATH 109,A02,083214,Ganzberger; Geoffrey Michael,0,0,34,34
1656090954486,MATH 109,A03,093478,Staff,3,0,34,31
1656090954486,MATH 109,B01,083215,Ganzberger; Geoffrey Michael,4,0,32,28
1656090954486,MATH 109,B02,083216,Ganzberger; Geoffrey Michael,1,0,32,31
1656090954486,MATH 109,B03,093479,Staff,4,0,32,28
1656090960522,MATH 142A,A01,083219,Chow; Bennett,2,0,32,30
1656090960522,MATH 142A,A02,083220,Chow; Bennett,8,0,32,24
1656090960522,MATH 142A,A03,093480,Staff,5,0,32,27
1656090960522,MATH 142A,B03,093481,Staff,4,0,32,28
1656090960522,MATH 142A,B04,093558,Staff,7,0,32,25
1656090960522,MATH 142A,B05,093559,Staff,0,0,32,32
1656090966546,MATH 193A,A01,083224,Rotar; Vladimir,1,2,34,33
1656090966546,MATH 193A,A02,083225,Rotar; Vladimir,2,0,34,32
1656090966546,MATH 193A,A03,083781,Rotar; Vladimir,2,0,34,32
1656090966546,MATH 193A,A04,083782,Rotar; Vladimir,7,0,34,27
1656090966546,MATH 193A,A05,093482,Rotar; Vladimir,1,0,34,33
1656090972572,MATH 197,001,091859,McAuley; Julian John,9999,0,9999,0
1656090972572,MATH 197,002,095566,Kedlaya; Kiran S.,9997,0,9999,2
1656090972572,MATH 197,003,095567,Xiao; Ming,9999,0,9999,0
1656090972572,MATH 197,004,095571,Perols; Johan Lars,9998,0,9999,1
1656090979631,COGS 9,A01,083615,Shannon; Kyle Michael,4,1,75,71
1656090985658,COGS 11,A01,083617,Boyle; Mary E. T.,16,1,48,32
1656090991682,COGS 13,A01,083071,Bastos; Amalia Pinkusfeld,8,2,71,63
1656090997705,COGS 14A,A01,092681,Semenuks; Arturs,8,23,100,92
1656091003731,COGS 14B,A01,083073,Cheng; Tzu-Han,8,0,63,55
1656091009761,COGS 17,A01,092677,Semenuks; Arturs,13,6,81,68
1656091015789,COGS 100,A01,083619,Allen; Michael Gordon,8,2,70,62
1656091021813,COGS 101A,A01,083621,Davis; Joshua Daniel,7,3,68,61
1656091027837,COGS 101B,A01,091572,Allen; Michael Gordon,7,0,65,58
1656091033861,COGS 101C,A01,083625,Delgado; Tania,11,0,35,24
1656091039888,COGS 107A,A01,083627,Boyle; Mary E. T.,5,2,60,55
1656091045915,COGS 118A,A01,083075,Gupta; Anjum,24,16,76,52
1656091051943,CSE 3,A50,083646,Miranda; Gregory Joseph,20,0,50,30
1656091057971,CSE 8A,A50,083650,Miranda; Gregory Joseph,13,11,56,43
1656091064003,CSE 11,A01,083080,Cao; Yingjun,1,60,40,39
1656091070031,CSE 12,A01,083652,Krause-Levy; Sophia Louisa,14,7,120,106
1656091076055,CSE 15L,A01,083654,Morris; Justin Loren,5,1,50,45
1656091076055,CSE 15L,A02,083655,Morris; Justin Loren,7,0,50,43
1656091082086,CSE 20,A01,083657,Tran; Khoa Dang,31,0,80,49
1656091088113,CSE 21,A01,095574,Bach; Quang Tran,28,0,48,20
1656091094140,CSE 30,A01,083084,Eldon; John,3,10,80,77
1656091094140,CSE 30,B01,095061,Bhaskar; Nishant,4,5,50,46
1656091100167,CSE 100,A01,083659,Cao; Yingjun,2,23,70,68
1656091106191,CSE 134B,A01,083661,Powell; Thomas Allan,10,6,100,90
1656091112218,CSE 140,A01,083663,Gungor; Onat,9,0,85,76
1656091118244,CSE 140L,A01,083088,Eldon; John,8,0,100,92
1656091124265,CSE 175,A01,083665,Kumar; Rakesh,2,0,25,23
1656091130294,CSE 190,A00,092507,Dubnov; Shlomo,3,0,20,17
1656091136320,ECE 45,A01,083139,Congero; Spencer William,5,2,75,70
1656091142356,ECE 65,A50,083695,Saad; Andrew S,8,0,30,22
1656091142356,ECE 65,A51,095125,Staff,23,0,26,3
1656091148380,ECE 109,A01,091882,Touri; Behrouz,5,4,70,65
1656091154408,ECE 180,A00,083140,Abi Samra; Nicholas Camill,1,0,30,29
1656091154408,ECE 180,B00,083141,Abi Samra; Nicholas Camill,4,8,30,26
1656091160441,MATH 10A,A01,083735,Patchell; Gregory David,1,0,30,29
1656091160441,MATH 10A,A02,083736,Patchell; Gregory David,23,0,30,7
1656091160441,MATH 10A,A03,083737,Patchell; Gregory David,16,0,30,14
1656091166466,MATH 10B,A01,083207,Lim; Seonhee,3,1,34,31
1656091166466,MATH 10B,A02,083208,Lim; Seonhee,10,2,35,25
1656091166466,MATH 10B,A03,093472,Staff,4,1,34,30
1656091166466,MATH 10B,B01,083739,Sinha; Shubham,12,0,30,18
1656091172502,MATH 18,A01,083743,Cinel; Cameron Alexander,7,0,30,23
1656091172502,MATH 18,A02,083744,Cinel; Cameron Alexander,12,0,30,18
1656091172502,MATH 18,A03,083745,Cinel; Cameron Alexander,3,0,30,27
1656091172502,MATH 18,B01,083748,Ma; Zilu,1,0,36,35
1656091172502,MATH 18,B02,083749,Ma; Zilu,1,0,36,35
1656091172502,MATH 18,B03,083750,Ma; Zilu,0,0,36,36
1656091172502,MATH 18,B04,083751,Ma; Zilu,0,0,36,36
1656091172502,MATH 18,B05,093473,Staff,3,0,36,33
1656091172502,MATH 18,B06,093474,Staff,4,0,36,32
1656091178532,MATH 20A,A01,083754,Zheng; Zequn,11,0,40,29
1656091184564,MATH 20B,A01,083756,Briones; Jor-el Thomas Caparas,0,0,36,36
1656091184564,MATH 20B,A02,083757,Briones; Jor-el Thomas Caparas,2,0,36,34
1656091184564,MATH 20B,A03,093475,Staff,3,0,36,33
1656091190592,MATH 20C,A01,083760,Briones; Jor-el Thomas Caparas,2,2,35,33
1656091190592,MATH 20C,A02,083761,Briones; Jor-el Thomas Caparas,9,1,35,26
1656091190592,MATH 20C,A03,093476,Staff,1,1,35,34
1656091190592,MATH 20C,B01,083762,Bach; Quang Tran,4,0,30,26
1656091196616,MATH 20D,A01,083765,Tran; Brian Kha,3,0,30,27
1656091196616,MATH 20D,A02,083766,Tran; Brian Kha,0,1,30,30
1656091196616,MATH 20D,A03,083767,Tran; Brian Kha,2,0,30,28
1656091202645,MATH 20E,A01,083771,Ganguly; Soumya,4,1,32,28
1656091202645,MATH 20E,A02,083772,Ganguly; Soumya,2,1,32,30
1656091202645,MATH 20E,B01,083773,Ciotti; Benjamin,15,0,35,20
1656091202645,MATH 20E,B02,083774,Ciotti; Benjamin,15,0,35,20
1656091208674,MATH 103A,A01,083777,Greenfeld; Be'Eri,3,0,36,33
1656091208674,MATH 103A,A02,083778,Greenfeld; Be'Eri,3,0,36,33
1656091208674,MATH 103A,A03,093561,Staff,4,1,36,32
1656091208674,MATH 103A,B01,083779,Greenfeld; Be'Eri,8,1,36,28
1656091208674,MATH 103A,B02,083780,Greenfeld; Be'Eri,0,1,36,36
1656091208674,MATH 103A,B03,093562,Staff,0,0,36,36
1656091214701,MATH 105,A01,085443,Carter; Anne Toulson,4,1,35,31
1656091214701,MATH 105,A02,093477,Staff,11,0,35,24
1656091220731,MATH 109,A01,083213,Ganzberger; Geoffrey Michael,1,1,34,33
1656091220731,MATH 109,A02,083214,Ganzberger; Geoffrey Michael,0,0,34,34
1656091220731,MATH 109,A03,093478,Staff,3,0,34,31
1656091220731,MATH 109,B01,083215,Ganzberger; Geoffrey Michael,4,0,32,28
1656091220731,MATH 109,B02,083216,Ganzberger; Geoffrey Michael,1,0,32,31
1656091220731,MATH 109,B03,093479,Staff,4,0,32,28
1656091226760,MATH 142A,A01,083219,Chow; Bennett,2,0,32,30
1656091226760,MATH 142A,A02,083220,Chow; Bennett,8,0,32,24
1656091226760,MATH 142A,A03,093480,Staff,5,0,32,27
1656091226760,MATH 142A,B03,093481,Staff,4,0,32,28
1656091226760,MATH 142A,B04,093558,Staff,7,0,32,25
1656091226760,MATH 142A,B05,093559,Staff,0,0,32,32
1656091232785,MATH 193A,A01,083224,Rotar; Vladimir,1,2,34,33
1656091232785,MATH 193A,A02,083225,Rotar; Vladimir,2,0,34,32
1656091232785,MATH 193A,A03,083781,Rotar; Vladimir,2,0,34,32
1656091232785,MATH 193A,A04,083782,Rotar; Vladimir,7,0,34,27
1656091232785,MATH 193A,A05,093482,Rotar; Vladimir,1,0,34,33
1656091238809,MATH 197,001,091859,McAuley; Julian John,9999,0,9999,0
1656091238809,MATH 197,002,095566,Kedlaya; Kiran S.,9997,0,9999,2
1656091238809,MATH 197,003,095567,Xiao; Ming,9999,0,9999,0
1656091238809,MATH 197,004,095571,Perols; Johan Lars,9998,0,9999,1
1656091245869,COGS 9,A01,083615,Shannon; Kyle Michael,4,1,75,71
1656091251893,COGS 11,A01,083617,Boyle; Mary E. T.,16,1,48,32
1656091257917,COGS 13,A01,083071,Bastos; Amalia Pinkusfeld,8,2,71,63
1656091263941,COGS 14A,A01,092681,Semenuks; Arturs,8,23,100,92
1656091269964,COGS 14B,A01,083073,Cheng; Tzu-Han,8,0,63,55
1656091275991,COGS 17,A01,092677,Semenuks; Arturs,13,6,81,68
1656091282013,COGS 100,A01,083619,Allen; Michael Gordon,8,2,70,62
1656091288041,COGS 101A,A01,083621,Davis; Joshua Daniel,7,3,68,61
1656091294067,COGS 101B,A01,091572,Allen; Michael Gordon,7,0,65,58
1656091300090,COGS 101C,A01,083625,Delgado; Tania,11,0,35,24
1656091306112,COGS 107A,A01,083627,Boyle; Mary E. T.,5,2,60,55
1656091312138,COGS 118A,A01,083075,Gupta; Anjum,24,16,76,52
1656091318166,CSE 3,A50,083646,Miranda; Gregory Joseph,20,0,50,30
1656091324192,CSE 8A,A50,083650,Miranda; Gregory Joseph,13,11,56,43
1656091330219,CSE 11,A01,083080,Cao; Yingjun,1,60,40,39
1656091336247,CSE 12,A01,083652,Krause-Levy; Sophia Louisa,14,7,120,106
1656091342269,CSE 15L,A01,083654,Morris; Justin Loren,5,1,50,45
1656091342269,CSE 15L,A02,083655,Morris; Justin Loren,7,0,50,43
1656091348292,CSE 20,A01,083657,Tran; Khoa Dang,31,0,80,49
1656091354316,CSE 21,A01,095574,Bach; Quang Tran,28,0,48,20
1656091360345,CSE 30,A01,083084,Eldon; John,3,10,80,77
1656091360345,CSE 30,B01,095061,Bhaskar; Nishant,4,5,50,46
1656091366368,CSE 100,A01,083659,Cao; Yingjun,2,23,70,68
1656091372467,CSE 134B,A01,083661,Powell; Thomas Allan,10,6,100,90
1656091378491,CSE 140,A01,083663,Gungor; Onat,9,0,85,76
1656091384513,CSE 140L,A01,083088,Eldon; John,8,0,100,92
1656091390536,CSE 175,A01,083665,Kumar; Rakesh,2,0,25,23
1656091396559,CSE 190,A00,092507,Dubnov; Shlomo,3,0,20,17
1656091402585,ECE 45,A01,083139,Congero; Spencer William,5,2,75,70
1656091408622,ECE 65,A50,083695,Saad; Andrew S,8,0,30,22
1656091408622,ECE 65,A51,095125,Staff,23,0,26,3
1656091414647,ECE 109,A01,091882,Touri; Behrouz,5,4,70,65
1656091420670,ECE 180,A00,083140,Abi Samra; Nicholas Camill,1,0,30,29
1656091420670,ECE 180,B00,083141,Abi Samra; Nicholas Camill,4,8,30,26
1656091426697,MATH 10A,A01,083735,Patchell; Gregory David,1,0,30,29
1656091426697,MATH 10A,A02,083736,Patchell; Gregory David,23,0,30,7
1656091426697,MATH 10A,A03,083737,Patchell; Gregory David,16,0,30,14
1656091432722,MATH 10B,A01,083207,Lim; Seonhee,3,1,34,31
1656091432722,MATH 10B,A02,083208,Lim; Seonhee,10,2,35,25
1656091432722,MATH 10B,A03,093472,Staff,4,1,34,30
1656091432722,MATH 10B,B01,083739,Sinha; Shubham,12,0,30,18
1656091438746,MATH 18,A01,083743,Cinel; Cameron Alexander,7,0,30,23
1656091438746,MATH 18,A02,083744,Cinel; Cameron Alexander,12,0,30,18
1656091438746,MATH 18,A03,083745,Cinel; Cameron Alexander,3,0,30,27
1656091438746,MATH 18,B01,083748,Ma; Zilu,1,0,36,35
1656091438746,MATH 18,B02,083749,Ma; Zilu,1,0,36,35
1656091438746,MATH 18,B03,083750,Ma; Zilu,0,0,36,36
1656091438746,MATH 18,B04,083751,Ma; Zilu,0,0,36,36
1656091438746,MATH 18,B05,093473,Staff,3,0,36,33
1656091438746,MATH 18,B06,093474,Staff,4,0,36,32
1656091444782,MATH 20A,A01,083754,Zheng; Zequn,11,0,40,29
1656091450808,MATH 20B,A01,083756,Briones; Jor-el Thomas Caparas,0,0,36,36
1656091450808,MATH 20B,A02,083757,Briones; Jor-el Thomas Caparas,2,0,36,34
1656091450808,MATH 20B,A03,093475,Staff,3,0,36,33
1656091456832,MATH 20C,A01,083760,Briones; Jor-el Thomas Caparas,2,2,35,33
1656091456832,MATH 20C,A02,083761,Briones; Jor-el Thomas Caparas,9,1,35,26
1656091456832,MATH 20C,A03,093476,Staff,1,1,35,34
1656091456832,MATH 20C,B01,083762,Bach; Quang Tran,4,0,30,26
1656091462857,MATH 20D,A01,083765,Tran; Brian Kha,3,0,30,27
1656091462857,MATH 20D,A02,083766,Tran; Brian Kha,0,1,30,30
1656091462857,MATH 20D,A03,083767,Tran; Brian Kha,2,0,30,28
1656091468882,MATH 20E,A01,083771,Ganguly; Soumya,4,1,32,28
1656091468882,MATH 20E,A02,083772,Ganguly; Soumya,2,1,32,30
1656091468882,MATH 20E,B01,083773,Ciotti; Benjamin,15,0,35,20
1656091468882,MATH 20E,B02,083774,Ciotti; Benjamin,15,0,35,20
1656091474906,MATH 103A,A01,083777,Greenfeld; Be'Eri,3,0,36,33
1656091474906,MATH 103A,A02,083778,Greenfeld; Be'Eri,3,0,36,33
1656091474906,MATH 103A,A03,093561,Staff,4,1,36,32
1656091474906,MATH 103A,B01,083779,Greenfeld; Be'Eri,8,1,36,28
1656091474906,MATH 103A,B02,083780,Greenfeld; Be'Eri,0,1,36,36
1656091474906,MATH 103A,B03,093562,Staff,0,0,36,36
1656091480936,MATH 105,A01,085443,Carter; Anne Toulson,4,1,35,31
1656091480936,MATH 105,A02,093477,Staff,11,0,35,24
1656091486960,MATH 109,A01,083213,Ganzberger; Geoffrey Michael,1,1,34,33
1656091486960,MATH 109,A02,083214,Ganzberger; Geoffrey Michael,0,0,34,34
1656091486960,MATH 109,A03,093478,Staff,3,0,34,31
1656091486960,MATH 109,B01,083215,Ganzberger; Geoffrey Michael,4,0,32,28
1656091486960,MATH 109,B02,083216,Ganzberger; Geoffrey Michael,1,0,32,31
1656091486960,MATH 109,B03,093479,Staff,4,0,32,28
1656091492984,MATH 142A,A01,083219,Chow; Bennett,2,0,32,30
1656091492984,MATH 142A,A02,083220,Chow; Bennett,8,0,32,24
1656091492984,MATH 142A,A03,093480,Staff,5,0,32,27
1656091492984,MATH 142A,B03,093481,Staff,4,0,32,28
1656091492984,MATH 142A,B04,093558,Staff,7,0,32,25
1656091492984,MATH 142A,B05,093559,Staff,0,0,32,32
1656091499020,MATH 193A,A01,083224,Rotar; Vladimir,1,2,34,33
1656091499020,MATH 193A,A02,083225,Rotar; Vladimir,2,0,34,32
1656091499020,MATH 193A,A03,083781,Rotar; Vladimir,2,0,34,32
1656091499020,MATH 193A,A04,083782,Rotar; Vladimir,7,0,34,27
1656091499020,MATH 193A,A05,093482,Rotar; Vladimir,1,0,34,33
1656091505041,MATH 197,001,091859,McAuley; Julian John,9999,0,9999,0
1656091505041,MATH 197,002,095566,Kedlaya; Kiran S.,9997,0,9999,2
1656091505041,MATH 197,003,095567,Xiao; Ming,9999,0,9999,0
1656091505041,MATH 197,004,095571,Perols; Johan Lars,9998,0,9999,1
1656091512107,COGS 9,A01,083615,Shannon; Kyle Michael,4,1,75,71
1656091518138,COGS 11,A01,083617,Boyle; Mary E. T.,16,1,48,32
1656091524167,COGS 13,A01,083071,Bastos; Amalia Pinkusfeld,8,2,71,63
1656091530190,COGS 14A,A01,092681,Semenuks; Arturs,8,23,100,92
1656091536216,COGS 14B,A01,083073,Cheng; Tzu-Han,8,0,63,55
1656091542243,COGS 17,A01,092677,Semenuks; Arturs,13,6,81,68
1656091548280,COGS 100,A01,083619,Allen; Michael Gordon,8,2,70,62
1656091554310,COGS 101A,A01,083621,Davis; Joshua Daniel,7,3,68,61
1656091560346,COGS 101B,A01,091572,Allen; Michael Gordon,7,0,65,58
1656091566374,COGS 101C,A01,083625,Delgado; Tania,11,0,35,24
1656091572398,COGS 107A,A01,083627,Boyle; Mary E. T.,5,2,60,55
1656091578426,COGS 118A,A01,083075,Gupta; Anjum,24,16,76,52
1656091584450,CSE 3,A50,083646,Miranda; Gregory Joseph,20,0,50,30
1656091590480,CSE 8A,A50,083650,Miranda; Gregory Joseph,13,11,56,43
1656091596509,CSE 11,A01,083080,Cao; Yingjun,1,60,40,39
1656091602534,CSE 12,A01,083652,Krause-Levy; Sophia Louisa,14,7,120,106
1656091608563,CSE 15L,A01,083654,Morris; Justin Loren,5,1,50,45
1656091608563,CSE 15L,A02,083655,Morris; Justin Loren,7,0,50,43
1656091614586,CSE 20,A01,083657,Tran; Khoa Dang,31,0,80,49
1656091620613,CSE 21,A01,095574,Bach; Quang Tran,28,0,48,20
1656091626637,CSE 30,A01,083084,Eldon; John,3,10,80,77
1656091626637,CSE 30,B01,095061,Bhaskar; Nishant,4,5,50,46
1656091632664,CSE 100,A01,083659,Cao; Yingjun,2,23,70,68
1656091638691,CSE 134B,A01,083661,Powell; Thomas Allan,10,6,100,90
1656091644714,CSE 140,A01,083663,Gungor; Onat,9,0,85,76
1656091650742,CSE 140L,A01,083088,Eldon; John,8,0,100,92
1656091656764,CSE 175,A01,083665,Kumar; Rakesh,2,0,25,23
1656091662787,CSE 190,A00,092507,Dubnov; Shlomo,3,0,20,17
1656091668813,ECE 45,A01,083139,Congero; Spencer William,5,2,75,70
1656091674836,ECE 65,A50,083695,Saad; Andrew S,8,0,30,22
1656091674836,ECE 65,A51,095125,Staff,23,0,26,3
1656091680866,ECE 109,A01,091882,Touri; Behrouz,5,4,70,65
1656091686895,ECE 180,A00,083140,Abi Samra; Nicholas Camill,1,0,30,29
1656091686895,ECE 180,B00,083141,Abi Samra; Nicholas Camill,4,8,30,26
1656091692918,MATH 10A,A01,083735,Patchell; Gregory David,1,0,30,29
1656091692918,MATH 10A,A02,083736,Patchell; Gregory David,23,0,30,7
1656091692918,MATH 10A,A03,083737,Patchell; Gregory David,16,0,30,14
1656091698948,MATH 10B,A01,083207,Lim; Seonhee,3,1,34,31
1656091698948,MATH 10B,A02,083208,Lim; Seonhee,10,2,35,25
1656091698948,MATH 10B,A03,093472,Staff,4,1,34,30
1656091698948,MATH 10B,B01,083739,Sinha; Shubham,12,0,30,18
1656091704981,MATH 18,A01,083743,Cinel; Cameron Alexander,7,0,30,23
1656091704981,MATH 18,A02,083744,Cinel; Cameron Alexander,12,0,30,18
1656091704981,MATH 18,A03,083745,Cinel; Cameron Alexander,3,0,30,27
1656091704981,MATH 18,B01,083748,Ma; Zilu,1,0,36,35
1656091704981,MATH 18,B02,083749,Ma; Zilu,1,0,36,35
1656091704981,MATH 18,B03,083750,Ma; Zilu,0,0,36,36
1656091704981,MATH 18,B04,083751,Ma; Zilu,0,0,36,36
1656091704981,MATH 18,B05,093473,Staff,3,0,36,33
1656091704981,MATH 18,B06,093474,Staff,4,0,36,32
1656091711006,MATH 20A,A01,083754,Zheng; Zequn,11,0,40,29
1656091717036,MATH 20B,A01,083756,Briones; Jor-el Thomas Caparas,0,0,36,36
1656091717036,MATH 20B,A02,083757,Briones; Jor-el Thomas Caparas,2,0,36,34
1656091717036,MATH 20B,A03,093475,Staff,3,0,36,33
1656091723064,MATH 20C,A01,083760,Briones; Jor-el Thomas Caparas,2,2,35,33
1656091723064,MATH 20C,A02,083761,Briones; Jor-el Thomas Caparas,9,1,35,26
1656091723064,MATH 20C,A03,093476,Staff,1,1,35,34
1656091723064,MATH 20C,B01,083762,Bach; Quang Tran,4,0,30,26
1656091729088,MATH 20D,A01,083765,Tran; Brian Kha,3,0,30,27
1656091729088,MATH 20D,A02,083766,Tran; Brian Kha,0,1,30,30
1656091729088,MATH 20D,A03,083767,Tran; Brian Kha,2,0,30,28
1656091735112,MATH 20E,A01,083771,Ganguly; Soumya,4,1,32,28
1656091735112,MATH 20E,A02,083772,Ganguly; Soumya,2,1,32,30
1656091735112,MATH 20E,B01,083773,Ciotti; Benjamin,15,0,35,20
1656091735112,MATH 20E,B02,083774,Ciotti; Benjamin,15,0,35,20
1656091741142,MATH 103A,A01,083777,Greenfeld; Be'Eri,3,0,36,33
1656091741142,MATH 103A,A02,083778,Greenfeld; Be'Eri,3,0,36,33
1656091741142,MATH 103A,A03,093561,Staff,4,1,36,32
1656091741142,MATH 103A,B01,083779,Greenfeld; Be'Eri,8,1,36,28
1656091741142,MATH 103A,B02,083780,Greenfeld; Be'Eri,0,1,36,36
1656091741142,MATH 103A,B03,093562,Staff,0,0,36,36
1656091747167,MATH 105,A01,085443,Carter; Anne Toulson,4,1,35,31
1656091747167,MATH 105,A02,093477,Staff,11,0,35,24
1656091753196,MATH 109,A01,083213,Ganzberger; Geoffrey Michael,1,1,34,33
1656091753196,MATH 109,A02,083214,Ganzberger; Geoffrey Michael,0,0,34,34
1656091753196,MATH 109,A03,093478,Staff,3,0,34,31
1656091753196,MATH 109,B01,083215,Ganzberger; Geoffrey Michael,4,0,32,28
1656091753196,MATH 109,B02,083216,Ganzberger; Geoffrey Michael,1,0,32,31
1656091753196,MATH 109,B03,093479,Staff,4,0,32,28
1656091759221,MATH 142A,A01,083219,Chow; Bennett,2,0,32,30
1656091759221,MATH 142A,A02,083220,Chow; Bennett,8,0,32,24
1656091759221,MATH 142A,A03,093480,Staff,5,0,32,27
1656091759221,MATH 142A,B03,093481,Staff,4,0,32,28
1656091759221,MATH 142A,B04,093558,Staff,7,0,32,25
1656091759221,MATH 142A,B05,093559,Staff,0,0,32,32
1656091765268,MATH 193A,A01,083224,Rotar; Vladimir,1,2,34,33
1656091765268,MATH 193A,A02,083225,Rotar; Vladimir,2,0,34,32
1656091765268,MATH 193A,A03,083781,Rotar; Vladimir,2,0,34,32
1656091765268,MATH 193A,A04,083782,Rotar; Vladimir,7,0,34,27
1656091765268,MATH 193A,A05,093482,Rotar; Vladimir,1,0,34,33
1656091771295,MATH 197,001,091859,McAuley; Julian John,9999,0,9999,0
1656091771295,MATH 197,002,095566,Kedlaya; Kiran S.,9997,0,9999,2
1656091771295,MATH 197,003,095567,Xiao; Ming,9999,0,9999,0
1656091771295,MATH 197,004,095571,Perols; Johan Lars,9998,0,9999,1
1656091778356,COGS 9,A01,083615,Shannon; Kyle Michael,4,1,75,71
1656091784383,COGS 11,A01,083617,Boyle; Mary E. T.,16,1,48,32
1656091790411,COGS 13,A01,083071,Bastos; Amalia Pinkusfeld,8,2,71,63
1656091796437,COGS 14A,A01,092681,Semenuks; Arturs,8,23,100,92
1656091802470,COGS 14B,A01,083073,Cheng; Tzu-Han,8,0,63,55
1656091808498,COGS 17,A01,092677,Semenuks; Arturs,13,6,81,68
1656091814525,COGS 100,A01,083619,Allen; Michael Gordon,8,2,70,62
1656091820547,COGS 101A,A01,083621,Davis; Joshua Daniel,7,3,68,61
1656091826572,COGS 101B,A01,091572,Allen; Michael Gordon,7,0,65,58
1656091832596,COGS 101C,A01,083625,Delgado; Tania,11,0,35,24
1656091838619,COGS 107A,A01,083627,Boyle; Mary E. T.,5,2,60,55
1656091844646,COGS 118A,A01,083075,Gupta; Anjum,24,16,76,52
1656091850668,CSE 3,A50,083646,Miranda; Gregory Joseph,20,0,50,30
1656091856692,CSE 8A,A50,083650,Miranda; Gregory Joseph,13,11,56,43
1656091862726,CSE 11,A01,083080,Cao; Yingjun,1,60,40,39
1656091868750,CSE 12,A01,083652,Krause-Levy; Sophia Louisa,14,7,120,106
1656091874774,CSE 15L,A01,083654,Morris; Justin Loren,5,1,50,45
1656091874774,CSE 15L,A02,083655,Morris; Justin Loren,7,0,50,43
1656091880797,CSE 20,A01,083657,Tran; Khoa Dang,31,0,80,49
1656091886826,CSE 21,A01,095574,Bach; Quang Tran,28,0,48,20
1656091892860,CSE 30,A01,083084,Eldon; John,3,10,80,77
1656091892860,CSE 30,B01,095061,Bhaskar; Nishant,4,5,50,46
1656091898890,CSE 100,A01,083659,Cao; Yingjun,2,23,70,68
1656091904920,CSE 134B,A01,083661,Powell; Thomas Allan,10,6,100,90
1656091910945,CSE 140,A01,083663,Gungor; Onat,9,0,85,76
1656091916968,CSE 140L,A01,083088,Eldon; John,8,0,100,92
1656091922992,CSE 175,A01,083665,Kumar; Rakesh,2,0,25,23
1656091929022,CSE 190,A00,092507,Dubnov; Shlomo,3,0,20,17
1656091935047,ECE 45,A01,083139,Congero; Spencer William,5,2,75,70
1656091941074,ECE 65,A50,083695,Saad; Andrew S,8,0,30,22
1656091941074,ECE 65,A51,095125,Staff,23,0,26,3
1656091947104,ECE 109,A01,091882,Touri; Behrouz,5,4,70,65
1656091953132,ECE 180,A00,083140,Abi Samra; Nicholas Camill,1,0,30,29
1656091953132,ECE 180,B00,083141,Abi Samra; Nicholas Camill,4,8,30,26
1656091959160,MATH 10A,A01,083735,Patchell; Gregory David,1,0,30,29
1656091959160,MATH 10A,A02,083736,Patchell; Gregory David,23,0,30,7
1656091959160,MATH 10A,A03,083737,Patchell; Gregory David,16,0,30,14
1656091965189,MATH 10B,A01,083207,Lim; Seonhee,3,1,34,31
1656091965189,MATH 10B,A02,083208,Lim; Seonhee,10,2,35,25
1656091965189,MATH 10B,A03,093472,Staff,4,1,34,30
1656091965189,MATH 10B,B01,083739,Sinha; Shubham,12,0,30,18
1656091971302,MATH 18,A01,083743,Cinel; Cameron Alexander,7,0,30,23
1656091971302,MATH 18,A02,083744,Cinel; Cameron Alexander,12,0,30,18
1656091971302,MATH 18,A03,083745,Cinel; Cameron Alexander,3,0,30,27
1656091971302,MATH 18,B01,083748,Ma; Zilu,1,0,36,35
1656091971302,MATH 18,B02,083749,Ma; Zilu,1,0,36,35
1656091971302,MATH 18,B03,083750,Ma; Zilu,0,0,36,36
1656091971302,MATH 18,B04,083751,Ma; Zilu,0,0,36,36
1656091971302,MATH 18,B05,093473,Staff,3,0,36,33
1656091971302,MATH 18,B06,093474,Staff,4,0,36,32
1656091977329,MATH 20A,A01,083754,Zheng; Zequn,11,0,40,29
1656091983352,MATH 20B,A01,083756,Briones; Jor-el Thomas Caparas,0,0,36,36
1656091983352,MATH 20B,A02,083757,Briones; Jor-el Thomas Caparas,2,0,36,34
1656091983352,MATH 20B,A03,093475,Staff,3,0,36,33
1656091989377,MATH 20C,A01,083760,Briones; Jor-el Thomas Caparas,2,2,35,33
1656091989377,MATH 20C,A02,083761,Briones; Jor-el Thomas Caparas,9,1,35,26
1656091989377,MATH 20C,A03,093476,Staff,1,1,35,34
1656091989377,MATH 20C,B01,083762,Bach; Quang Tran,4,0,30,26
1656091995405,MATH 20D,A01,083765,Tran; Brian Kha,3,0,30,27
1656091995405,MATH 20D,A02,083766,Tran; Brian Kha,0,1,30,30
1656091995405,MATH 20D,A03,083767,Tran; Brian Kha,2,0,30,28
1656092001433,MATH 20E,A01,083771,Ganguly; Soumya,4,1,32,28
1656092001433,MATH 20E,A02,083772,Ganguly; Soumya,2,1,32,30
1656092001433,MATH 20E,B01,083773,Ciotti; Benjamin,15,0,35,20
1656092001433,MATH 20E,B02,083774,Ciotti; Benjamin,15,0,35,20
1656092007461,MATH 103A,A01,083777,Greenfeld; Be'Eri,3,0,36,33
1656092007461,MATH 103A,A02,083778,Greenfeld; Be'Eri,3,0,36,33
1656092007461,MATH 103A,A03,093561,Staff,4,1,36,32
1656092007461,MATH 103A,B01,083779,Greenfeld; Be'Eri,8,1,36,28
1656092007461,MATH 103A,B02,083780,Greenfeld; Be'Eri,0,1,36,36
1656092007461,MATH 103A,B03,093562,Staff,0,0,36,36
1656092013484,MATH 105,A01,085443,Carter; Anne Toulson,4,1,35,31
1656092013484,MATH 105,A02,093477,Staff,11,0,35,24
1656092019512,MATH 109,A01,083213,Ganzberger; Geoffrey Michael,1,1,34,33
1656092019512,MATH 109,A02,083214,Ganzberger; Geoffrey Michael,0,0,34,34
1656092019512,MATH 109,A03,093478,Staff,3,0,34,31
1656092019512,MATH 109,B01,083215,Ganzberger; Geoffrey Michael,4,0,32,28
1656092019512,MATH 109,B02,083216,Ganzberger; Geoffrey Michael,1,0,32,31
1656092019512,MATH 109,B03,093479,Staff,4,0,32,28
1656092025536,MATH 142A,A01,083219,Chow; Bennett,2,0,32,30
1656092025536,MATH 142A,A02,083220,Chow; Bennett,8,0,32,24
1656092025536,MATH 142A,A03,093480,Staff,5,0,32,27
1656092025536,MATH 142A,B03,093481,Staff,4,0,32,28
1656092025536,MATH 142A,B04,093558,Staff,7,0,32,25
1656092025536,MATH 142A,B05,093559,Staff,0,0,32,32
1656092031560,MATH 193A,A01,083224,Rotar; Vladimir,1,2,34,33
1656092031560,MATH 193A,A02,083225,Rotar; Vladimir,2,0,34,32
1656092031560,MATH 193A,A03,083781,Rotar; Vladimir,2,0,34,32
1656092031560,MATH 193A,A04,083782,Rotar; Vladimir,7,0,34,27
1656092031560,MATH 193A,A05,093482,Rotar; Vladimir,1,0,34,33
1656092037591,MATH 197,001,091859,McAuley; Julian John,9999,0,9999,0
1656092037591,MATH 197,002,095566,Kedlaya; Kiran S.,9997,0,9999,2
1656092037591,MATH 197,003,095567,Xiao; Ming,9999,0,9999,0
1656092037591,MATH 197,004,095571,Perols; Johan Lars,9998,0,9999,1
1656092044655,COGS 9,A01,083615,Shannon; Kyle Michael,4,1,75,71
1656092050682,COGS 11,A01,083617,Boyle; Mary E. T.,16,1,48,32
1656092056709,COGS 13,A01,083071,Bastos; Amalia Pinkusfeld,8,2,71,63
1656092062740,COGS 14A,A01,092681,Semenuks; Arturs,8,23,100,92
1656092068770,COGS 14B,A01,083073,Cheng; Tzu-Han,8,0,63,55
1656092074794,COGS 17,A01,092677,Semenuks; Arturs,13,6,81,68
1656092080816,COGS 100,A01,083619,Allen; Michael Gordon,8,2,70,62
1656092086846,COGS 101A,A01,083621,Davis; Joshua Daniel,7,3,68,61
1656092092872,COGS 101B,A01,091572,Allen; Michael Gordon,7,0,65,58
1656092098896,COGS 101C,A01,083625,Delgado; Tania,11,0,35,24
1656092104921,COGS 107A,A01,083627,Boyle; Mary E. T.,5,2,60,55
1656092110950,COGS 118A,A01,083075,Gupta; Anjum,24,16,76,52
1656092116974,CSE 3,A50,083646,Miranda; Gregory Joseph,20,0,50,30
1656092122997,CSE 8A,A50,083650,Miranda; Gregory Joseph,13,11,56,43
1656092129019,CSE 11,A01,083080,Cao; Yingjun,1,60,40,39
1656092135044,CSE 12,A01,083652,Krause-Levy; Sophia Louisa,14,7,120,106
1656092141073,CSE 15L,A01,083654,Morris; Justin Loren,5,1,50,45
1656092141073,CSE 15L,A02,083655,Morris; Justin Loren,7,0,50,43
1656092147096,CSE 20,A01,083657,Tran; Khoa Dang,31,0,80,49
1656092153120,CSE 21,A01,095574,Bach; Quang Tran,28,0,48,20
1656092159154,CSE 30,A01,083084,Eldon; John,3,10,80,77
1656092159154,CSE 30,B01,095061,Bhaskar; Nishant,4,5,50,46
1656092165187,CSE 100,A01,083659,Cao; Yingjun,2,23,70,68
1656092171209,CSE 134B,A01,083661,Powell; Thomas Allan,10,6,100,90
1656092177236,CSE 140,A01,083663,Gungor; Onat,9,0,85,76
1656092183264,CSE 140L,A01,083088,Eldon; John,8,0,100,92
1656092189287,CSE 175,A01,083665,Kumar; Rakesh,2,0,25,23
1656092195310,CSE 190,A00,092507,Dubnov; Shlomo,3,0,20,17
1656092201336,ECE 45,A01,083139,Congero; Spencer William,5,2,75,70
1656092207360,ECE 65,A50,083695,Saad; Andrew S,8,0,30,22
1656092207360,ECE 65,A51,095125,Staff,23,0,26,3
1656092213388,ECE 109,A01,091882,Touri; Behrouz,5,4,70,65
1656092219415,ECE 180,A00,083140,Abi Samra; Nicholas Camill,1,0,30,29
1656092219415,ECE 180,B00,083141,Abi Samra; Nicholas Camill,4,8,30,26
1656092225446,MATH 10A,A01,083735,Patchell; Gregory David,1,0,30,29
1656092225446,MATH 10A,A02,083736,Patchell; Gregory David,23,0,30,7
1656092225446,MATH 10A,A03,083737,Patchell; Gregory David,16,0,30,14
1656092231483,MATH 10B,A01,083207,Lim; Seonhee,3,1,34,31
1656092231483,MATH 10B,A02,083208,Lim; Seonhee,10,2,35,25
1656092231483,MATH 10B,A03,093472,Staff,4,1,34,30
1656092231483,MATH 10B,B01,083739,Sinha; Shubham,12,0,30,18
1656092237509,MATH 18,A01,083743,Cinel; Cameron Alexander,7,0,30,23
1656092237509,MATH 18,A02,083744,Cinel; Cameron Alexander,12,0,30,18
1656092237509,MATH 18,A03,083745,Cinel; Cameron Alexander,3,0,30,27
1656092237509,MATH 18,B01,083748,Ma; Zilu,1,0,36,35
1656092237509,MATH 18,B02,083749,Ma; Zilu,1,0,36,35
1656092237509,MATH 18,B03,083750,Ma; Zilu,0,0,36,36
1656092237509,MATH 18,B04,083751,Ma; Zilu,0,0,36,36
1656092237509,MATH 18,B05,093473,Staff,3,0,36,33
1656092237509,MATH 18,B06,093474,Staff,4,0,36,32
1656092243531,MATH 20A,A01,083754,Zheng; Zequn,11,0,40,29
1656092249554,MATH 20B,A01,083756,Briones; Jor-el Thomas Caparas,0,0,36,36
1656092249554,MATH 20B,A02,083757,Briones; Jor-el Thomas Caparas,2,0,36,34
1656092249554,MATH 20B,A03,093475,Staff,3,0,36,33
1656092255578,MATH 20C,A01,083760,Briones; Jor-el Thomas Caparas,2,2,35,33
1656092255578,MATH 20C,A02,083761,Briones; Jor-el Thomas Caparas,9,1,35,26
1656092255578,MATH 20C,A03,093476,Staff,1,1,35,34
1656092255578,MATH 20C,B01,083762,Bach; Quang Tran,3,0,30,27
1656092261602,MATH 20D,A01,083765,Tran; Brian Kha,3,0,30,27
1656092261602,MATH 20D,A02,083766,Tran; Brian Kha,0,1,30,30
1656092261602,MATH 20D,A03,083767,Tran; Brian Kha,2,0,30,28
1656092267626,MATH 20E,A01,083771,Ganguly; Soumya,4,1,32,28
1656092267626,MATH 20E,A02,083772,Ganguly; Soumya,2,1,32,30
1656092267626,MATH 20E,B01,083773,Ciotti; Benjamin,15,0,35,20
1656092267626,MATH 20E,B02,083774,Ciotti; Benjamin,15,0,35,20
1656092273651,MATH 103A,A01,083777,Greenfeld; Be'Eri,3,0,36,33
1656092273651,MATH 103A,A02,083778,Greenfeld; Be'Eri,3,0,36,33
1656092273651,MATH 103A,A03,093561,Staff,4,1,36,32
1656092273651,MATH 103A,B01,083779,Greenfeld; Be'Eri,8,1,36,28
1656092273651,MATH 103A,B02,083780,Greenfeld; Be'Eri,0,1,36,36
1656092273651,MATH 103A,B03,093562,Staff,0,0,36,36
1656092279676,MATH 105,A01,085443,Carter; Anne Toulson,4,1,35,31
1656092279676,MATH 105,A02,093477,Staff,11,0,35,24
1656092285701,MATH 109,A01,083213,Ganzberger; Geoffrey Michael,1,1,34,33
1656092285701,MATH 109,A02,083214,Ganzberger; Geoffrey Michael,0,0,34,34
1656092285701,MATH 109,A03,093478,Staff,3,0,34,31
1656092285701,MATH 109,B01,083215,Ganzberger; Geoffrey Michael,4,0,32,28
1656092285701,MATH 109,B02,083216,Ganzberger; Geoffrey Michael,1,0,32,31
1656092285701,MATH 109,B03,093479,Staff,4,0,32,28
1656092291724,MATH 142A,A01,083219,Chow; Bennett,2,0,32,30
1656092291724,MATH 142A,A02,083220,Chow; Bennett,8,0,32,24
1656092291724,MATH 142A,A03,093480,Staff,5,0,32,27
1656092291724,MATH 142A,B03,093481,Staff,4,0,32,28
1656092291724,MATH 142A,B04,093558,Staff,7,0,32,25
1656092291724,MATH 142A,B05,093559,Staff,0,0,32,32
1656092297771,MATH 193A,A01,083224,Rotar; Vladimir,1,2,34,33
1656092297771,MATH 193A,A02,083225,Rotar; Vladimir,2,0,34,32
1656092297771,MATH 193A,A03,083781,Rotar; Vladimir,2,0,34,32
1656092297771,MATH 193A,A04,083782,Rotar; Vladimir,7,0,34,27
1656092297771,MATH 193A,A05,093482,Rotar; Vladimir,1,0,34,33
1656092303795,MATH 197,001,091859,McAuley; Julian John,9999,0,9999,0
1656092303795,MATH 197,002,095566,Kedlaya; Kiran S.,9997,0,9999,2
1656092303795,MATH 197,003,095567,Xiao; Ming,9999,0,9999,0
1656092303795,MATH 197,004,095571,Perols; Johan Lars,9998,0,9999,1
1656092310856,COGS 9,A01,083615,Shannon; Kyle Michael,4,1,75,71
1656092316894,COGS 11,A01,083617,Boyle; Mary E. T.,16,1,48,32
1656092322918,COGS 13,A01,083071,Bastos; Amalia Pinkusfeld,8,2,71,63
1656092328940,COGS 14A,A01,092681,Semenuks; Arturs,8,23,100,92
1656092334964,COGS 14B,A01,083073,Cheng; Tzu-Han,8,0,63,55
1656092340988,COGS 17,A01,092677,Semenuks; Arturs,13,6,81,68
1656092347018,COGS 100,A01,083619,Allen; Michael Gordon,8,2,70,62
1656092353045,COGS 101A,A01,083621,Davis; Joshua Daniel,7,3,68,61
1656092359070,COGS 101B,A01,091572,Allen; Michael Gordon,7,0,65,58
1656092365094,COGS 101C,A01,083625,Delgado; Tania,11,0,35,24
1656092371118,COGS 107A,A01,083627,Boyle; Mary E. T.,5,2,60,55
1656092377145,COGS 118A,A01,083075,Gupta; Anjum,24,16,76,52
1656092383177,CSE 3,A50,083646,Miranda; Gregory Joseph,20,0,50,30
1656092389220,CSE 8A,A50,083650,Miranda; Gregory Joseph,13,11,56,43
1656092395242,CSE 11,A01,083080,Cao; Yingjun,1,60,40,39
1656092401276,CSE 12,A01,083652,Krause-Levy; Sophia Louisa,14,7,120,106
1656092407309,CSE 15L,A01,083654,Morris; Justin Loren,5,1,50,45
1656092407309,CSE 15L,A02,083655,Morris; Justin Loren,7,0,50,43
1656092413335,CSE 20,A01,083657,Tran; Khoa Dang,31,0,80,49
1656092419362,CSE 21,A01,095574,Bach; Quang Tran,28,0,48,20
1656092425398,CSE 30,A01,083084,Eldon; John,3,10,80,77
1656092425398,CSE 30,B01,095061,Bhaskar; Nishant,4,5,50,46
1656092431430,CSE 100,A01,083659,Cao; Yingjun,2,23,70,68
1656092437451,CSE 134B,A01,083661,Powell; Thomas Allan,10,6,100,90
1656092443472,CSE 140,A01,083663,Gungor; Onat,9,0,85,76
1656092449502,CSE 140L,A01,083088,Eldon; John,8,0,100,92
1656092455525,CSE 175,A01,083665,Kumar; Rakesh,2,0,25,23
1656092461555,CSE 190,A00,092507,Dubnov; Shlomo,3,0,20,17
1656092467578,ECE 45,A01,083139,Congero; Spencer William,5,2,75,70
1656092473601,ECE 65,A50,083695,Saad; Andrew S,8,0,30,22
1656092473601,ECE 65,A51,095125,Staff,23,0,26,3
1656092479628,ECE 109,A01,091882,Touri; Behrouz,5,4,70,65
1656092485661,ECE 180,A00,083140,Abi Samra; Nicholas Camill,1,0,30,29
1656092485661,ECE 180,B00,083141,Abi Samra; Nicholas Camill,4,8,30,26
1656092491689,MATH 10A,A01,083735,Patchell; Gregory David,1,0,30,29
1656092491689,MATH 10A,A02,083736,Patchell; Gregory David,23,0,30,7
1656092491689,MATH 10A,A03,083737,Patchell; Gregory David,16,0,30,14
1656092497721,MATH 10B,A01,083207,Lim; Seonhee,3,1,34,31
1656092497721,MATH 10B,A02,083208,Lim; Seonhee,10,2,35,25
1656092497721,MATH 10B,A03,093472,Staff,4,1,34,30
1656092497721,MATH 10B,B01,083739,Sinha; Shubham,12,0,30,18
1656092503745,MATH 18,A01,083743,Cinel; Cameron Alexander,7,0,30,23
1656092503745,MATH 18,A02,083744,Cinel; Cameron Alexander,12,0,30,18
1656092503745,MATH 18,A03,083745,Cinel; Cameron Alexander,3,0,30,27
1656092503745,MATH 18,B01,083748,Ma; Zilu,1,0,36,35
1656092503745,MATH 18,B02,083749,Ma; Zilu,1,0,36,35
1656092503745,MATH 18,B03,083750,Ma; Zilu,0,0,36,36
1656092503745,MATH 18,B04,083751,Ma; Zilu,0,0,36,36
1656092503745,MATH 18,B05,093473,Staff,3,0,36,33
1656092503745,MATH 18,B06,093474,Staff,4,0,36,32
1656092509772,MATH 20A,A01,083754,Zheng; Zequn,11,0,40,29
1656092515801,MATH 20B,A01,083756,Briones; Jor-el Thomas Caparas,0,0,36,36
1656092515801,MATH 20B,A02,083757,Briones; Jor-el Thomas Caparas,2,0,36,34
1656092515801,MATH 20B,A03,093475,Staff,3,0,36,33
1656092521826,MATH 20C,A01,083760,Briones; Jor-el Thomas Caparas,2,2,35,33
1656092521826,MATH 20C,A02,083761,Briones; Jor-el Thomas Caparas,9,1,35,26
1656092521826,MATH 20C,A03,093476,Staff,1,1,35,34
1656092521826,MATH 20C,B01,083762,Bach; Quang Tran,3,0,30,27
1656092527854,MATH 20D,A01,083765,Tran; Brian Kha,3,0,30,27
1656092527854,MATH 20D,A02,083766,Tran; Brian Kha,0,1,30,30
1656092527854,MATH 20D,A03,083767,Tran; Brian Kha,2,0,30,28
1656092533884,MATH 20E,A01,083771,Ganguly; Soumya,4,1,32,28
1656092533884,MATH 20E,A02,083772,Ganguly; Soumya,2,1,32,30
1656092533884,MATH 20E,B01,083773,Ciotti; Benjamin,15,0,35,20
1656092533884,MATH 20E,B02,083774,Ciotti; Benjamin,15,0,35,20
1656092539908,MATH 103A,A01,083777,Greenfeld; Be'Eri,3,0,36,33
1656092539908,MATH 103A,A02,083778,Greenfeld; Be'Eri,3,0,36,33
1656092539908,MATH 103A,A03,093561,Staff,4,1,36,32
1656092539908,MATH 103A,B01,083779,Greenfeld; Be'Eri,8,1,36,28
1656092539908,MATH 103A,B02,083780,Greenfeld; Be'Eri,0,1,36,36
1656092539908,MATH 103A,B03,093562,Staff,0,0,36,36
1656092545933,MATH 105,A01,085443,Carter; Anne Toulson,4,1,35,31
1656092545933,MATH 105,A02,093477,Staff,11,0,35,24
1656092551955,MATH 109,A01,083213,Ganzberger; Geoffrey Michael,1,1,34,33
1656092551955,MATH 109,A02,083214,Ganzberger; Geoffrey Michael,0,0,34,34
1656092551955,MATH 109,A03,093478,Staff,3,0,34,31
1656092551955,MATH 109,B01,083215,Ganzberger; Geoffrey Michael,4,0,32,28
1656092551955,MATH 109,B02,083216,Ganzberger; Geoffrey Michael,1,0,32,31
1656092551955,MATH 109,B03,093479,Staff,4,0,32,28
1656092557992,MATH 142A,A01,083219,Chow; Bennett,2,0,32,30
1656092557992,MATH 142A,A02,083220,Chow; Bennett,8,0,32,24
1656092557992,MATH 142A,A03,093480,Staff,5,0,32,27
1656092557992,MATH 142A,B03,093481,Staff,4,0,32,28
1656092557992,MATH 142A,B04,093558,Staff,7,0,32,25
1656092557992,MATH 142A,B05,093559,Staff,0,0,32,32
1656092564024,MATH 193A,A01,083224,Rotar; Vladimir,1,2,34,33
1656092564024,MATH 193A,A02,083225,Rotar; Vladimir,2,0,34,32
1656092564024,MATH 193A,A03,083781,Rotar; Vladimir,2,0,34,32
1656092564024,MATH 193A,A04,083782,Rotar; Vladimir,7,0,34,27
1656092564024,MATH 193A,A05,093482,Rotar; Vladimir,1,0,34,33
1656092570121,MATH 197,001,091859,McAuley; Julian John,9999,0,9999,0
1656092570121,MATH 197,002,095566,Kedlaya; Kiran S.,9997,0,9999,2
1656092570121,MATH 197,003,095567,Xiao; Ming,9999,0,9999,0
1656092570121,MATH 197,004,095571,Perols; Johan Lars,9998,0,9999,1
1656092577200,COGS 9,A01,083615,Shannon; Kyle Michael,4,1,75,71
1656092583226,COGS 11,A01,083617,Boyle; Mary E. T.,16,1,48,32
1656092589260,COGS 13,A01,083071,Bastos; Amalia Pinkusfeld,8,2,71,63
1656092595283,COGS 14A,A01,092681,Semenuks; Arturs,8,23,100,92
1656092601310,COGS 14B,A01,083073,Cheng; Tzu-Han,8,0,63,55
1656092607349,COGS 17,A01,092677,Semenuks; Arturs,13,6,81,68
1656092613373,COGS 100,A01,083619,Allen; Michael Gordon,8,2,70,62
1656092619396,COGS 101A,A01,083621,Davis; Joshua Daniel,7,3,68,61
1656092625434,COGS 101B,A01,091572,Allen; Michael Gordon,7,0,65,58
1656092631457,COGS 101C,A01,083625,Delgado; Tania,11,0,35,24
1656092637480,COGS 107A,A01,083627,Boyle; Mary E. T.,5,2,60,55
1656092643516,COGS 118A,A01,083075,Gupta; Anjum,24,16,76,52
1656092649540,CSE 3,A50,083646,Miranda; Gregory Joseph,20,0,50,30
1656092655564,CSE 8A,A50,083650,Miranda; Gregory Joseph,13,11,56,43
1656092661592,CSE 11,A01,083080,Cao; Yingjun,1,60,40,39
1656092667618,CSE 12,A01,083652,Krause-Levy; Sophia Louisa,14,7,120,106
1656092673647,CSE 15L,A01,083654,Morris; Justin Loren,5,1,50,45
1656092673647,CSE 15L,A02,083655,Morris; Justin Loren,7,0,50,43
1656092679670,CSE 20,A01,083657,Tran; Khoa Dang,31,0,80,49
1656092685708,CSE 21,A01,095574,Bach; Quang Tran,27,0,48,21
1656092691729,CSE 30,A01,083084,Eldon; John,3,10,80,77
1656092691729,CSE 30,B01,095061,Bhaskar; Nishant,4,5,50,46
1656092697767,CSE 100,A01,083659,Cao; Yingjun,2,23,70,68
1656092703790,CSE 134B,A01,083661,Powell; Thomas Allan,10,6,100,90
1656092709829,CSE 140,A01,083663,Gungor; Onat,9,0,85,76
1656092715853,CSE 140L,A01,083088,Eldon; John,8,0,100,92
1656092721881,CSE 175,A01,083665,Kumar; Rakesh,2,0,25,23
1656092727903,CSE 190,A00,092507,Dubnov; Shlomo,3,0,20,17
1656092733926,ECE 45,A01,083139,Congero; Spencer William,5,2,75,70
1656092739956,ECE 65,A50,083695,Saad; Andrew S,8,0,30,22
1656092739956,ECE 65,A51,095125,Staff,23,0,26,3
1656092745979,ECE 109,A01,091882,Touri; Behrouz,5,4,70,65
1656092752005,ECE 180,A00,083140,Abi Samra; Nicholas Camill,1,0,30,29
1656092752005,ECE 180,B00,083141,Abi Samra; Nicholas Camill,4,8,30,26
1656092758035,MATH 10A,A01,083735,Patchell; Gregory David,1,0,30,29
1656092758035,MATH 10A,A02,083736,Patchell; Gregory David,23,0,30,7
1656092758035,MATH 10A,A03,083737,Patchell; Gregory David,16,0,30,14
1656092764059,MATH 10B,A01,083207,Lim; Seonhee,3,1,34,31
1656092764059,MATH 10B,A02,083208,Lim; Seonhee,10,2,35,25
1656092764059,MATH 10B,A03,093472,Staff,4,1,34,30
1656092764059,MATH 10B,B01,083739,Sinha; Shubham,12,0,30,18
1656092770089,MATH 18,A01,083743,Cinel; Cameron Alexander,7,0,30,23
1656092770089,MATH 18,A02,083744,Cinel; Cameron Alexander,12,0,30,18
1656092770089,MATH 18,A03,083745,Cinel; Cameron Alexander,3,0,30,27
1656092770089,MATH 18,B01,083748,Ma; Zilu,1,0,36,35
1656092770089,MATH 18,B02,083749,Ma; Zilu,1,0,36,35
1656092770089,MATH 18,B03,083750,Ma; Zilu,0,0,36,36
1656092770089,MATH 18,B04,083751,Ma; Zilu,0,0,36,36
1656092770089,MATH 18,B05,093473,Staff,3,0,36,33
1656092770089,MATH 18,B06,093474,Staff,4,0,36,32
1656092776114,MATH 20A,A01,083754,Zheng; Zequn,11,0,40,29
1656092782137,MATH 20B,A01,083756,Briones; Jor-el Thomas Caparas,0,0,36,36
1656092782137,MATH 20B,A02,083757,Briones; Jor-el Thomas Caparas,2,0,36,34
1656092782137,MATH 20B,A03,093475,Staff,3,0,36,33
1656092788161,MATH 20C,A01,083760,Briones; Jor-el Thomas Caparas,2,2,35,33
1656092788161,MATH 20C,A02,083761,Briones; Jor-el Thomas Caparas,9,1,35,26
1656092788161,MATH 20C,A03,093476,Staff,1,1,35,34
1656092788161,MATH 20C,B01,083762,Bach; Quang Tran,3,0,30,27
1656092794194,MATH 20D,A01,083765,Tran; Brian Kha,3,0,30,27
1656092794194,MATH 20D,A02,083766,Tran; Brian Kha,0,1,30,30
1656092794194,MATH 20D,A03,083767,Tran; Brian Kha,2,0,30,28
1656092800222,MATH 20E,A01,083771,Ganguly; Soumya,4,1,32,28
1656092800222,MATH 20E,A02,083772,Ganguly; Soumya,2,1,32,30
1656092800222,MATH 20E,B01,083773,Ciotti; Benjamin,15,0,35,20
1656092800222,MATH 20E,B02,083774,Ciotti; Benjamin,15,0,35,20
1656092806252,MATH 103A,A01,083777,Greenfeld; Be'Eri,3,0,36,33
1656092806252,MATH 103A,A02,083778,Greenfeld; Be'Eri,3,0,36,33
1656092806252,MATH 103A,A03,093561,Staff,4,1,36,32
1656092806252,MATH 103A,B01,083779,Greenfeld; Be'Eri,8,1,36,28
1656092806252,MATH 103A,B02,083780,Greenfeld; Be'Eri,0,1,36,36
1656092806252,MATH 103A,B03,093562,Staff,0,0,36,36
1656092812276,MATH 105,A01,085443,Carter; Anne Toulson,4,1,35,31
1656092812276,MATH 105,A02,093477,Staff,11,0,35,24
1656092818301,MATH 109,A01,083213,Ganzberger; Geoffrey Michael,1,1,34,33
1656092818301,MATH 109,A02,083214,Ganzberger; Geoffrey Michael,0,0,34,34
1656092818301,MATH 109,A03,093478,Staff,3,0,34,31
1656092818301,MATH 109,B01,083215,Ganzberger; Geoffrey Michael,4,0,32,28
1656092818301,MATH 109,B02,083216,Ganzberger; Geoffrey Michael,1,0,32,31
1656092818301,MATH 109,B03,093479,Staff,4,0,32,28
1656092824327,MATH 142A,A01,083219,Chow; Bennett,2,0,32,30
1656092824327,MATH 142A,A02,083220,Chow; Bennett,8,0,32,24
1656092824327,MATH 142A,A03,093480,Staff,5,0,32,27
1656092824327,MATH 142A,B03,093481,Staff,4,0,32,28
1656092824327,MATH 142A,B04,093558,Staff,7,0,32,25
1656092824327,MATH 142A,B05,093559,Staff,0,0,32,32
1656092830351,MATH 193A,A01,083224,Rotar; Vladimir,1,2,34,33
1656092830351,MATH 193A,A02,083225,Rotar; Vladimir,2,0,34,32
1656092830351,MATH 193A,A03,083781,Rotar; Vladimir,2,0,34,32
1656092830351,MATH 193A,A04,083782,Rotar; Vladimir,7,0,34,27
1656092830351,MATH 193A,A05,093482,Rotar; Vladimir,1,0,34,33
1656092836377,MATH 197,001,091859,McAuley; Julian John,9999,0,9999,0
1656092836377,MATH 197,002,095566,Kedlaya; Kiran S.,9997,0,9999,2
1656092836377,MATH 197,003,095567,Xiao; Ming,9999,0,9999,0
1656092836377,MATH 197,004,095571,Perols; Johan Lars,9998,0,9999,1
1656092843431,COGS 9,A01,083615,Shannon; Kyle Michael,4,1,75,71
1656092849457,COGS 11,A01,083617,Boyle; Mary E. T.,16,1,48,32
1656092855490,COGS 13,A01,083071,Bastos; Amalia Pinkusfeld,8,2,71,63
1656092861516,COGS 14A,A01,092681,Semenuks; Arturs,8,23,100,92
1656092867539,COGS 14B,A01,083073,Cheng; Tzu-Han,8,0,63,55
1656092873564,COGS 17,A01,092677,Semenuks; Arturs,13,6,81,68
1656092879593,COGS 100,A01,083619,Allen; Michael Gordon,8,2,70,62
1656092885621,COGS 101A,A01,083621,Davis; Joshua Daniel,7,3,68,61
1656092891648,COGS 101B,A01,091572,Allen; Michael Gordon,7,0,65,58
1656092897674,COGS 101C,A01,083625,Delgado; Tania,11,0,35,24
1656092903696,COGS 107A,A01,083627,Boyle; Mary E. T.,5,2,60,55
1656092909718,COGS 118A,A01,083075,Gupta; Anjum,24,16,76,52
1656092915745,CSE 3,A50,083646,Miranda; Gregory Joseph,20,0,50,30
1656092921769,CSE 8A,A50,083650,Miranda; Gregory Joseph,13,11,56,43
1656092927805,CSE 11,A01,083080,Cao; Yingjun,1,60,40,39
1656092933832,CSE 12,A01,083652,Krause-Levy; Sophia Louisa,14,8,120,106
1656092939864,CSE 15L,A01,083654,Morris; Justin Loren,5,1,50,45
1656092939864,CSE 15L,A02,083655,Morris; Justin Loren,7,1,50,43
1656092945887,CSE 20,A01,083657,Tran; Khoa Dang,31,0,80,49
1656092951910,CSE 21,A01,095574,Bach; Quang Tran,27,0,48,21
1656092957936,CSE 30,A01,083084,Eldon; John,3,10,80,77
1656092957936,CSE 30,B01,095061,Bhaskar; Nishant,4,5,50,46
1656092963959,CSE 100,A01,083659,Cao; Yingjun,2,23,70,68
1656092969986,CSE 134B,A01,083661,Powell; Thomas Allan,10,6,100,90
1656092976022,CSE 140,A01,083663,Gungor; Onat,9,0,85,76
1656092982049,CSE 140L,A01,083088,Eldon; John,8,0,100,92
1656092988072,CSE 175,A01,083665,Kumar; Rakesh,2,0,25,23
1656092994100,CSE 190,A00,092507,Dubnov; Shlomo,3,0,20,17
1656093000124,ECE 45,A01,083139,Congero; Spencer William,5,2,75,70
1656093006197,ECE 65,A50,083695,Saad; Andrew S,8,0,30,22
1656093006197,ECE 65,A51,095125,Staff,23,0,26,3
1656093012237,ECE 109,A01,091882,Touri; Behrouz,6,4,70,64
1656093018261,ECE 180,A00,083140,Abi Samra; Nicholas Camill,1,0,30,29
1656093018261,ECE 180,B00,083141,Abi Samra; Nicholas Camill,4,8,30,26
1656093024290,MATH 10A,A01,083735,Patchell; Gregory David,1,0,30,29
1656093024290,MATH 10A,A02,083736,Patchell; Gregory David,23,0,30,7
1656093024290,MATH 10A,A03,083737,Patchell; Gregory David,16,0,30,14
1656093030313,MATH 10B,A01,083207,Lim; Seonhee,3,1,34,31
1656093030313,MATH 10B,A02,083208,Lim; Seonhee,10,2,35,25
1656093030313,MATH 10B,A03,093472,Staff,4,2,34,30
1656093030313,MATH 10B,B01,083739,Sinha; Shubham,12,0,30,18
1656093036341,MATH 18,A01,083743,Cinel; Cameron Alexander,7,0,30,23
1656093036341,MATH 18,A02,083744,Cinel; Cameron Alexander,11,0,30,19
1656093036341,MATH 18,A03,083745,Cinel; Cameron Alexander,3,0,30,27
1656093036341,MATH 18,B01,083748,Ma; Zilu,1,0,36,35
1656093036341,MATH 18,B02,083749,Ma; Zilu,1,0,36,35
1656093036341,MATH 18,B03,083750,Ma; Zilu,0,0,36,36
1656093036341,MATH 18,B04,083751,Ma; Zilu,0,0,36,36
1656093036341,MATH 18,B05,093473,Staff,3,0,36,33
1656093036341,MATH 18,B06,093474,Staff,4,0,36,32
1656093042365,MATH 20A,A01,083754,Zheng; Zequn,11,0,40,29
1656093048392,MATH 20B,A01,083756,Briones; Jor-el Thomas Caparas,0,0,36,36
1656093048392,MATH 20B,A02,083757,Briones; Jor-el Thomas Caparas,2,0,36,34
1656093048392,MATH 20B,A03,093475,Staff,3,0,36,33
1656093054423,MATH 20C,A01,083760,Briones; Jor-el Thomas Caparas,2,2,35,33
1656093054423,MATH 20C,A02,083761,Briones; Jor-el Thomas Caparas,9,1,35,26
1656093054423,MATH 20C,A03,093476,Staff,1,1,35,34
1656093054423,MATH 20C,B01,083762,Bach; Quang Tran,3,0,30,27
1656093060451,MATH 20D,A01,083765,Tran; Brian Kha,3,0,30,27
1656093060451,MATH 20D,A02,083766,Tran; Brian Kha,0,1,30,30
1656093060451,MATH 20D,A03,083767,Tran; Brian Kha,2,0,30,28
1656093066479,MATH 20E,A01,083771,Ganguly; Soumya,4,1,32,28
1656093066479,MATH 20E,A02,083772,Ganguly; Soumya,2,1,32,30
1656093066479,MATH 20E,B01,083773,Ciotti; Benjamin,15,0,35,20
1656093066479,MATH 20E,B02,083774,Ciotti; Benjamin,15,0,35,20
1656093072503,MATH 103A,A01,083777,Greenfeld; Be'Eri,3,0,36,33
1656093072503,MATH 103A,A02,083778,Greenfeld; Be'Eri,3,0,36,33
1656093072503,MATH 103A,A03,093561,Staff,4,1,36,32
1656093072503,MATH 103A,B01,083779,Greenfeld; Be'Eri,8,1,36,28
1656093072503,MATH 103A,B02,083780,Greenfeld; Be'Eri,0,1,36,36
1656093072503,MATH 103A,B03,093562,Staff,0,0,36,36
1656093078526,MATH 105,A01,085443,Carter; Anne Toulson,4,1,35,31
1656093078526,MATH 105,A02,093477,Staff,11,0,35,24
1656093084559,MATH 109,A01,083213,Ganzberger; Geoffrey Michael,1,1,34,33
1656093084559,MATH 109,A02,083214,Ganzberger; Geoffrey Michael,0,0,34,34
1656093084559,MATH 109,A03,093478,Staff,3,0,34,31
1656093084559,MATH 109,B01,083215,Ganzberger; Geoffrey Michael,4,0,32,28
1656093084559,MATH 109,B02,083216,Ganzberger; Geoffrey Michael,1,0,32,31
1656093084559,MATH 109,B03,093479,Staff,4,0,32,28
1656093090790,MATH 142A,A01,083219,Chow; Bennett,2,0,32,30
1656093090790,MATH 142A,A02,083220,Chow; Bennett,8,0,32,24
1656093090790,MATH 142A,A03,093480,Staff,5,0,32,27
1656093090790,MATH 142A,B03,093481,Staff,4,0,32,28
1656093090790,MATH 142A,B04,093558,Staff,7,0,32,25
1656093090790,MATH 142A,B05,093559,Staff,0,0,32,32
1656093096816,MATH 193A,A01,083224,Rotar; Vladimir,1,2,34,33
1656093096816,MATH 193A,A02,083225,Rotar; Vladimir,2,0,34,32
1656093096816,MATH 193A,A03,083781,Rotar; Vladimir,2,0,34,32
1656093096816,MATH 193A,A04,083782,Rotar; Vladimir,7,0,34,27
1656093096816,MATH 193A,A05,093482,Rotar; Vladimir,1,0,34,33
1656093102848,MATH 197,001,091859,McAuley; Julian John,9999,0,9999,0
1656093102848,MATH 197,002,095566,Kedlaya; Kiran S.,9997,0,9999,2
1656093102848,MATH 197,003,095567,Xiao; Ming,9999,0,9999,0
1656093102848,MATH 197,004,095571,Perols; Johan Lars,9998,0,9999,1
1656093109906,COGS 9,A01,083615,Shannon; Kyle Michael,4,1,75,71
1656093115929,COGS 11,A01,083617,Boyle; Mary E. T.,16,1,48,32
1656093121973,COGS 13,A01,083071,Bastos; Amalia Pinkusfeld,8,2,71,63
1656093128004,COGS 14A,A01,092681,Semenuks; Arturs,8,23,100,92
1656093134028,COGS 14B,A01,083073,Cheng; Tzu-Han,8,0,63,55
1656093140059,COGS 17,A01,092677,Semenuks; Arturs,13,6,81,68
1656093146088,COGS 100,A01,083619,Allen; Michael Gordon,8,2,70,62
1656093152112,COGS 101A,A01,083621,Davis; Joshua Daniel,7,3,68,61
1656093158139,COGS 101B,A01,091572,Allen; Michael Gordon,7,0,65,58
1656093164254,COGS 101C,A01,083625,Delgado; Tania,11,0,35,24
1656093170279,COGS 107A,A01,083627,Boyle; Mary E. T.,5,3,60,55
1656093176310,COGS 118A,A01,083075,Gupta; Anjum,24,16,76,52
1656093182342,CSE 3,A50,083646,Miranda; Gregory Joseph,20,0,50,30
1656093188370,CSE 8A,A50,083650,Miranda; Gregory Joseph,13,13,56,43
1656093194397,CSE 11,A01,083080,Cao; Yingjun,1,60,40,39
1656093200426,CSE 12,A01,083652,Krause-Levy; Sophia Louisa,14,8,120,106
1656093206449,CSE 15L,A01,083654,Morris; Justin Loren,5,1,50,45
1656093206449,CSE 15L,A02,083655,Morris; Justin Loren,7,1,50,43
1656093212472,CSE 20,A01,083657,Tran; Khoa Dang,31,0,80,49
1656093218500,CSE 21,A01,095574,Bach; Quang Tran,26,0,48,22
1656093224527,CSE 30,A01,083084,Eldon; John,3,10,80,77
1656093224527,CSE 30,B01,095061,Bhaskar; Nishant,4,5,50,46
1656093230550,CSE 100,A01,083659,Cao; Yingjun,2,23,70,68
1656093236581,CSE 134B,A01,083661,Powell; Thomas Allan,10,6,100,90
1656093242610,CSE 140,A01,083663,Gungor; Onat,9,0,85,76
1656093248638,CSE 140L,A01,083088,Eldon; John,8,0,100,92
1656093254672,CSE 175,A01,083665,Kumar; Rakesh,1,0,25,24
1656093260710,CSE 190,A00,092507,Dubnov; Shlomo,2,0,20,18
1656093266736,ECE 45,A01,083139,Congero; Spencer William,5,2,75,70
1656093272766,ECE 65,A50,083695,Saad; Andrew S,8,0,30,22
1656093272766,ECE 65,A51,095125,Staff,23,0,26,3
1656093278797,ECE 109,A01,091882,Touri; Behrouz,6,4,70,64
1656093284825,ECE 180,A00,083140,Abi Samra; Nicholas Camill,1,0,30,29
1656093284825,ECE 180,B00,083141,Abi Samra; Nicholas Camill,4,8,30,26
1656093290852,MATH 10A,A01,083735,Patchell; Gregory David,1,0,30,29
1656093290852,MATH 10A,A02,083736,Patchell; Gregory David,23,0,30,7
1656093290852,MATH 10A,A03,083737,Patchell; Gregory David,16,0,30,14
1656093296879,MATH 10B,A01,083207,Lim; Seonhee,3,2,34,31
1656093296879,MATH 10B,A02,083208,Lim; Seonhee,10,2,35,25
1656093296879,MATH 10B,A03,093472,Staff,4,2,34,30
1656093296879,MATH 10B,B01,083739,Sinha; Shubham,12,0,30,18
1656093302916,MATH 18,A01,083743,Cinel; Cameron Alexander,7,0,30,23
1656093302916,MATH 18,A02,083744,Cinel; Cameron Alexander,11,0,30,19
1656093302916,MATH 18,A03,083745,Cinel; Cameron Alexander,3,0,30,27
1656093302916,MATH 18,B01,083748,Ma; Zilu,1,0,36,35
1656093302916,MATH 18,B02,083749,Ma; Zilu,1,0,36,35
1656093302916,MATH 18,B03,083750,Ma; Zilu,0,0,36,36
1656093302916,MATH 18,B04,083751,Ma; Zilu,0,0,36,36
1656093302916,MATH 18,B05,093473,Staff,3,0,36,33
1656093302916,MATH 18,B06,093474,Staff,4,0,36,32
1656093308947,MATH 20A,A01,083754,Zheng; Zequn,11,0,40,29
1656093314977,MATH 20B,A01,083756,Briones; Jor-el Thomas Caparas,0,0,36,36
1656093314977,MATH 20B,A02,083757,Briones; Jor-el Thomas Caparas,2,0,36,34
1656093314977,MATH 20B,A03,093475,Staff,3,0,36,33
1656093321001,MATH 20C,A01,083760,Briones; Jor-el Thomas Caparas,2,2,35,33
1656093321001,MATH 20C,A02,083761,Briones; Jor-el Thomas Caparas,9,1,35,26
1656093321001,MATH 20C,A03,093476,Staff,1,1,35,34
1656093321001,MATH 20C,B01,083762,Bach; Quang Tran,3,0,30,27
1656093327029,MATH 20D,A01,083765,Tran; Brian Kha,3,0,30,27
1656093327029,MATH 20D,A02,083766,Tran; Brian Kha,0,1,30,30
1656093327029,MATH 20D,A03,083767,Tran; Brian Kha,2,0,30,28
1656093333052,MATH 20E,A01,083771,Ganguly; Soumya,4,1,32,28
1656093333052,MATH 20E,A02,083772,Ganguly; Soumya,2,1,32,30
1656093333052,MATH 20E,B01,083773,Ciotti; Benjamin,14,0,35,21
1656093333052,MATH 20E,B02,083774,Ciotti; Benjamin,15,0,35,20
1656093339077,MATH 103A,A01,083777,Greenfeld; Be'Eri,3,0,36,33
1656093339077,MATH 103A,A02,083778,Greenfeld; Be'Eri,3,0,36,33
1656093339077,MATH 103A,A03,093561,Staff,4,1,36,32
1656093339077,MATH 103A,B01,083779,Greenfeld; Be'Eri,8,1,36,28
1656093339077,MATH 103A,B02,083780,Greenfeld; Be'Eri,0,1,36,36
1656093339077,MATH 103A,B03,093562,Staff,0,0,36,36
1656093345104,MATH 105,A01,085443,Carter; Anne Toulson,4,1,35,31
1656093345104,MATH 105,A02,093477,Staff,11,0,35,24
1656093351134,MATH 109,A01,083213,Ganzberger; Geoffrey Michael,1,1,34,33
1656093351134,MATH 109,A02,083214,Ganzberger; Geoffrey Michael,0,0,34,34
1656093351134,MATH 109,A03,093478,Staff,3,0,34,31
1656093351134,MATH 109,B01,083215,Ganzberger; Geoffrey Michael,4,0,32,28
1656093351134,MATH 109,B02,083216,Ganzberger; Geoffrey Michael,1,0,32,31
1656093351134,MATH 109,B03,093479,Staff,4,0,32,28
1656093357162,MATH 142A,A01,083219,Chow; Bennett,2,0,32,30
1656093357162,MATH 142A,A02,083220,Chow; Bennett,8,0,32,24
1656093357162,MATH 142A,A03,093480,Staff,5,0,32,27
1656093357162,MATH 142A,B03,093481,Staff,4,0,32,28
1656093357162,MATH 142A,B04,093558,Staff,7,0,32,25
1656093357162,MATH 142A,B05,093559,Staff,0,0,32,32
1656093363191,MATH 193A,A01,083224,Rotar; Vladimir,1,2,34,33
1656093363191,MATH 193A,A02,083225,Rotar; Vladimir,2,0,34,32
1656093363191,MATH 193A,A03,083781,Rotar; Vladimir,2,0,34,32
1656093363191,MATH 193A,A04,083782,Rotar; Vladimir,7,0,34,27
1656093363191,MATH 193A,A05,093482,Rotar; Vladimir,1,0,34,33
1656093369218,MATH 197,001,091859,McAuley; Julian John,9999,0,9999,0
1656093369218,MATH 197,002,095566,Kedlaya; Kiran S.,9997,0,9999,2
1656093369218,MATH 197,003,095567,Xiao; Ming,9999,0,9999,0
1656093369218,MATH 197,004,095571,Perols; Johan Lars,9998,0,9999,1
1656093376286,COGS 9,A01,083615,Shannon; Kyle Michael,4,1,75,71
1656093382311,COGS 11,A01,083617,Boyle; Mary E. T.,16,2,48,32
1656093388334,COGS 13,A01,083071,Bastos; Amalia Pinkusfeld,8,2,71,63
1656093394360,COGS 14A,A01,092681,Semenuks; Arturs,8,23,100,92
1656093400387,COGS 14B,A01,083073,Cheng; Tzu-Han,7,0,63,56
1656093406410,COGS 17,A01,092677,Semenuks; Arturs,13,6,81,68
1656093412444,COGS 100,A01,083619,Allen; Michael Gordon,8,4,70,62
1656093418471,COGS 101A,A01,083621,Davis; Joshua Daniel,7,3,68,61
1656093424496,COGS 101B,A01,091572,Allen; Michael Gordon,7,0,65,58
1656093430519,COGS 101C,A01,083625,Delgado; Tania,11,0,35,24
1656093436546,COGS 107A,A01,083627,Boyle; Mary E. T.,5,3,60,55
1656093442571,COGS 118A,A01,083075,Gupta; Anjum,24,16,76,52
1656093448600,CSE 3,A50,083646,Miranda; Gregory Joseph,20,0,50,30
1656093454624,CSE 8A,A50,083650,Miranda; Gregory Joseph,13,13,56,43
1656093460648,CSE 11,A01,083080,Cao; Yingjun,1,60,40,39
1656093466674,CSE 12,A01,083652,Krause-Levy; Sophia Louisa,14,8,120,106
1656093472697,CSE 15L,A01,083654,Morris; Justin Loren,5,1,50,45
1656093472697,CSE 15L,A02,083655,Morris; Justin Loren,7,1,50,43
1656093478724,CSE 20,A01,083657,Tran; Khoa Dang,31,0,80,49
1656093484751,CSE 21,A01,095574,Bach; Quang Tran,26,0,48,22
1656093490773,CSE 30,A01,083084,Eldon; John,3,10,80,77
1656093490773,CSE 30,B01,095061,Bhaskar; Nishant,4,5,50,46
1656093496802,CSE 100,A01,083659,Cao; Yingjun,2,23,70,68
1656093502829,CSE 134B,A01,083661,Powell; Thomas Allan,10,6,100,90
1656093508866,CSE 140,A01,083663,Gungor; Onat,9,0,85,76
1656093514893,CSE 140L,A01,083088,Eldon; John,8,0,100,92
1656093520920,CSE 175,A01,083665,Kumar; Rakesh,1,0,25,24
1656093526949,CSE 190,A00,092507,Dubnov; Shlomo,2,0,20,18
1656093532973,ECE 45,A01,083139,Congero; Spencer William,5,2,75,70
1656093539005,ECE 65,A50,083695,Saad; Andrew S,8,0,30,22
1656093539005,ECE 65,A51,095125,Staff,23,0,26,3
1656093545032,ECE 109,A01,091882,Touri; Behrouz,6,4,70,64
1656093551067,ECE 180,A00,083140,Abi Samra; Nicholas Camill,1,0,30,29
1656093551067,ECE 180,B00,083141,Abi Samra; Nicholas Camill,4,8,30,26
1656093557090,MATH 10A,A01,083735,Patchell; Gregory David,1,0,30,29
1656093557090,MATH 10A,A02,083736,Patchell; Gregory David,23,0,30,7
1656093557090,MATH 10A,A03,083737,Patchell; Gregory David,16,0,30,14
1656093563123,MATH 10B,A01,083207,Lim; Seonhee,3,2,34,31
1656093563123,MATH 10B,A02,083208,Lim; Seonhee,10,2,35,25
1656093563123,MATH 10B,A03,093472,Staff,4,2,34,30
1656093563123,MATH 10B,B01,083739,Sinha; Shubham,12,0,30,18
1656093569146,MATH 18,A01,083743,Cinel; Cameron Alexander,7,0,30,23
1656093569146,MATH 18,A02,083744,Cinel; Cameron Alexander,11,0,30,19
1656093569146,MATH 18,A03,083745,Cinel; Cameron Alexander,3,0,30,27
1656093569146,MATH 18,B01,083748,Ma; Zilu,1,0,36,35
1656093569146,MATH 18,B02,083749,Ma; Zilu,1,0,36,35
1656093569146,MATH 18,B03,083750,Ma; Zilu,0,0,36,36
1656093569146,MATH 18,B04,083751,Ma; Zilu,0,0,36,36
1656093569146,MATH 18,B05,093473,Staff,3,0,36,33
1656093569146,MATH 18,B06,093474,Staff,3,0,36,33
1656093575173,MATH 20A,A01,083754,Zheng; Zequn,11,0,40,29
1656093581196,MATH 20B,A01,083756,Briones; Jor-el Thomas Caparas,0,0,36,36
1656093581196,MATH 20B,A02,083757,Briones; Jor-el Thomas Caparas,2,0,36,34
1656093581196,MATH 20B,A03,093475,Staff,3,0,36,33
1656093587222,MATH 20C,A01,083760,Briones; Jor-el Thomas Caparas,2,2,35,33
1656093587222,MATH 20C,A02,083761,Briones; Jor-el Thomas Caparas,9,1,35,26
1656093587222,MATH 20C,A03,093476,Staff,1,1,35,34
1656093587222,MATH 20C,B01,083762,Bach; Quang Tran,3,0,30,27
1656093593264,MATH 20D,A01,083765,Tran; Brian Kha,3,0,30,27
1656093593264,MATH 20D,A02,083766,Tran; Brian Kha,0,1,30,30
1656093593264,MATH 20D,A03,083767,Tran; Brian Kha,2,0,30,28
1656093599292,MATH 20E,A01,083771,Ganguly; Soumya,4,1,32,28
1656093599292,MATH 20E,A02,083772,Ganguly; Soumya,2,1,32,30
1656093599292,MATH 20E,B01,083773,Ciotti; Benjamin,14,0,35,21
1656093599292,MATH 20E,B02,083774,Ciotti; Benjamin,15,0,35,20
1656093605316,MATH 103A,A01,083777,Greenfeld; Be'Eri,3,0,36,33
1656093605316,MATH 103A,A02,083778,Greenfeld; Be'Eri,3,0,36,33
1656093605316,MATH 103A,A03,093561,Staff,4,1,36,32
1656093605316,MATH 103A,B01,083779,Greenfeld; Be'Eri,8,1,36,28
1656093605316,MATH 103A,B02,083780,Greenfeld; Be'Eri,0,1,36,36
1656093605316,MATH 103A,B03,093562,Staff,0,0,36,36
1656093611348,MATH 105,A01,085443,Carter; Anne Toulson,4,1,35,31
1656093611348,MATH 105,A02,093477,Staff,11,0,35,24
1656093617385,MATH 109,A01,083213,Ganzberger; Geoffrey Michael,1,1,34,33
1656093617385,MATH 109,A02,083214,Ganzberger; Geoffrey Michael,0,0,34,34
1656093617385,MATH 109,A03,093478,Staff,3,0,34,31
1656093617385,MATH 109,B01,083215,Ganzberger; Geoffrey Michael,4,0,32,28
1656093617385,MATH 109,B02,083216,Ganzberger; Geoffrey Michael,1,0,32,31
1656093617385,MATH 109,B03,093479,Staff,4,0,32,28
1656093623410,MATH 142A,A01,083219,Chow; Bennett,2,0,32,30
1656093623410,MATH 142A,A02,083220,Chow; Bennett,8,0,32,24
1656093623410,MATH 142A,A03,093480,Staff,5,0,32,27
1656093623410,MATH 142A,B03,093481,Staff,4,0,32,28
1656093623410,MATH 142A,B04,093558,Staff,7,0,32,25
1656093623410,MATH 142A,B05,093559,Staff,0,0,32,32
1656093629434,MATH 193A,A01,083224,Rotar; Vladimir,1,2,34,33
1656093629434,MATH 193A,A02,083225,Rotar; Vladimir,2,0,34,32
1656093629434,MATH 193A,A03,083781,Rotar; Vladimir,2,0,34,32
1656093629434,MATH 193A,A04,083782,Rotar; Vladimir,7,0,34,27
1656093629434,MATH 193A,A05,093482,Rotar; Vladimir,1,0,34,33
1656093635456,MATH 197,001,091859,McAuley; Julian John,9999,0,9999,0
1656093635456,MATH 197,002,095566,Kedlaya; Kiran S.,9997,0,9999,2
1656093635456,MATH 197,003,095567,Xiao; Ming,9999,0,9999,0
1656093635456,MATH 197,004,095571,Perols; Johan Lars,9998,0,9999,1
1656093642533,COGS 9,A01,083615,Shannon; Kyle Michael,4,1,75,71
1656093648561,COGS 11,A01,083617,Boyle; Mary E. T.,16,2,48,32
1656093654584,COGS 13,A01,083071,Bastos; Amalia Pinkusfeld,8,2,71,63
1656093660624,COGS 14A,A01,092681,Semenuks; Arturs,8,23,100,92
1656093666648,COGS 14B,A01,083073,Cheng; Tzu-Han,7,0,63,56
1656093672686,COGS 17,A01,092677,Semenuks; Arturs,13,6,81,68
1656093678718,COGS 100,A01,083619,Allen; Michael Gordon,8,4,70,62
1656093684746,COGS 101A,A01,083621,Davis; Joshua Daniel,7,3,68,61
1656093690777,COGS 101B,A01,091572,Allen; Michael Gordon,7,0,65,58
1656093696815,COGS 101C,A01,083625,Delgado; Tania,11,0,35,24
1656093702858,COGS 107A,A01,083627,Boyle; Mary E. T.,5,4,60,55
1656093708881,COGS 118A,A01,083075,Gupta; Anjum,24,16,76,52
1656093714909,CSE 3,A50,083646,Miranda; Gregory Joseph,20,0,50,30
1656093720935,CSE 8A,A50,083650,Miranda; Gregory Joseph,13,13,56,43
1656093726970,CSE 11,A01,083080,Cao; Yingjun,1,60,40,39
1656093732994,CSE 12,A01,083652,Krause-Levy; Sophia Louisa,14,8,120,106
1656093739019,CSE 15L,A01,083654,Morris; Justin Loren,5,1,50,45
1656093739019,CSE 15L,A02,083655,Morris; Justin Loren,7,1,50,43
1656093745043,CSE 20,A01,083657,Tran; Khoa Dang,31,0,80,49
1656093751070,CSE 21,A01,095574,Bach; Quang Tran,26,0,48,22
1656093757110,CSE 30,A01,083084,Eldon; John,3,11,80,77
1656093757110,CSE 30,B01,095061,Bhaskar; Nishant,4,5,50,46
1656093763223,CSE 100,A01,083659,Cao; Yingjun,2,23,70,68
1656093769247,CSE 134B,A01,083661,Powell; Thomas Allan,10,7,100,90
1656093775273,CSE 140,A01,083663,Gungor; Onat,9,0,85,76
1656093781302,CSE 140L,A01,083088,Eldon; John,8,0,100,92
1656093787324,CSE 175,A01,083665,Kumar; Rakesh,1,0,25,24
1656093793361,CSE 190,A00,092507,Dubnov; Shlomo,2,0,20,18
1656093799399,ECE 45,A01,083139,Congero; Spencer William,5,2,75,70
1656093805423,ECE 65,A50,083695,Saad; Andrew S,8,0,30,22
1656093805423,ECE 65,A51,095125,Staff,23,0,26,3
1656093811445,ECE 109,A01,091882,Touri; Behrouz,6,5,70,64
1656093817473,ECE 180,A00,083140,Abi Samra; Nicholas Camill,1,0,30,29
1656093817473,ECE 180,B00,083141,Abi Samra; Nicholas Camill,4,8,30,26
1656093823500,MATH 10A,A01,083735,Patchell; Gregory David,1,0,30,29
1656093823500,MATH 10A,A02,083736,Patchell; Gregory David,23,0,30,7
1656093823500,MATH 10A,A03,083737,Patchell; Gregory David,16,0,30,14
1656093829539,MATH 10B,A01,083207,Lim; Seonhee,3,2,34,31
1656093829539,MATH 10B,A02,083208,Lim; Seonhee,10,2,35,25
1656093829539,MATH 10B,A03,093472,Staff,4,2,34,30
1656093829539,MATH 10B,B01,083739,Sinha; Shubham,12,0,30,18
1656093835568,MATH 18,A01,083743,Cinel; Cameron Alexander,7,0,30,23
1656093835568,MATH 18,A02,083744,Cinel; Cameron Alexander,11,0,30,19
1656093835568,MATH 18,A03,083745,Cinel; Cameron Alexander,3,0,30,27
1656093835568,MATH 18,B01,083748,Ma; Zilu,1,0,36,35
1656093835568,MATH 18,B02,083749,Ma; Zilu,1,0,36,35
1656093835568,MATH 18,B03,083750,Ma; Zilu,0,0,36,36
1656093835568,MATH 18,B04,083751,Ma; Zilu,0,0,36,36
1656093835568,MATH 18,B05,093473,Staff,3,0,36,33
1656093835568,MATH 18,B06,093474,Staff,3,0,36,33
1656093841597,MATH 20A,A01,083754,Zheng; Zequn,11,0,40,29
1656093847619,MATH 20B,A01,083756,Briones; Jor-el Thomas Caparas,0,0,36,36
1656093847619,MATH 20B,A02,083757,Briones; Jor-el Thomas Caparas,1,0,36,35
1656093847619,MATH 20B,A03,093475,Staff,3,0,36,33
1656093853654,MATH 20C,A01,083760,Briones; Jor-el Thomas Caparas,2,2,35,33
1656093853654,MATH 20C,A02,083761,Briones; Jor-el Thomas Caparas,9,1,35,26
1656093853654,MATH 20C,A03,093476,Staff,1,1,35,34
1656093853654,MATH 20C,B01,083762,Bach; Quang Tran,3,0,30,27
1656093859694,MATH 20D,A01,083765,Tran; Brian Kha,3,0,30,27
1656093859694,MATH 20D,A02,083766,Tran; Brian Kha,0,1,30,30
1656093859694,MATH 20D,A03,083767,Tran; Brian Kha,2,0,30,28
1656093865718,MATH 20E,A01,083771,Ganguly; Soumya,4,1,32,28
1656093865718,MATH 20E,A02,083772,Ganguly; Soumya,2,1,32,30
1656093865718,MATH 20E,B01,083773,Ciotti; Benjamin,14,0,35,21
1656093865718,MATH 20E,B02,083774,Ciotti; Benjamin,15,0,35,20
1656093871746,MATH 103A,A01,083777,Greenfeld; Be'Eri,3,0,36,33
1656093871746,MATH 103A,A02,083778,Greenfeld; Be'Eri,3,0,36,33
1656093871746,MATH 103A,A03,093561,Staff,4,1,36,32
1656093871746,MATH 103A,B01,083779,Greenfeld; Be'Eri,8,1,36,28
1656093871746,MATH 103A,B02,083780,Greenfeld; Be'Eri,0,1,36,36
1656093871746,MATH 103A,B03,093562,Staff,0,0,36,36
1656093877773,MATH 105,A01,085443,Carter; Anne Toulson,4,1,35,31
1656093877773,MATH 105,A02,093477,Staff,10,0,35,25
1656093883797,MATH 109,A01,083213,Ganzberger; Geoffrey Michael,1,1,34,33
1656093883797,MATH 109,A02,083214,Ganzberger; Geoffrey Michael,0,0,34,34
1656093883797,MATH 109,A03,093478,Staff,3,0,34,31
1656093883797,MATH 109,B01,083215,Ganzberger; Geoffrey Michael,4,0,32,28
1656093883797,MATH 109,B02,083216,Ganzberger; Geoffrey Michael,1,0,32,31
1656093883797,MATH 109,B03,093479,Staff,4,0,32,28
1656093889820,MATH 142A,A01,083219,Chow; Bennett,2,0,32,30
1656093889820,MATH 142A,A02,083220,Chow; Bennett,8,0,32,24
1656093889820,MATH 142A,A03,093480,Staff,5,0,32,27
1656093889820,MATH 142A,B03,093481,Staff,4,0,32,28
1656093889820,MATH 142A,B04,093558,Staff,7,0,32,25
1656093889820,MATH 142A,B05,093559,Staff,0,0,32,32
1656093895866,MATH 193A,A01,083224,Rotar; Vladimir,1,2,34,33
1656093895866,MATH 193A,A02,083225,Rotar; Vladimir,2,0,34,32
1656093895866,MATH 193A,A03,083781,Rotar; Vladimir,2,0,34,32
1656093895866,MATH 193A,A04,083782,Rotar; Vladimir,7,0,34,27
1656093895866,MATH 193A,A05,093482,Rotar; Vladimir,1,0,34,33
1656093901896,MATH 197,001,091859,McAuley; Julian John,9999,0,9999,0
1656093901896,MATH 197,002,095566,Kedlaya; Kiran S.,9997,0,9999,2
1656093901896,MATH 197,003,095567,Xiao; Ming,9999,0,9999,0
1656093901896,MATH 197,004,095571,Perols; Johan Lars,9998,0,9999,1
1656093908952,COGS 9,A01,083615,Shannon; Kyle Michael,4,1,75,71
1656093914984,COGS 11,A01,083617,Boyle; Mary E. T.,16,2,48,32
1656093921009,COGS 13,A01,083071,Bastos; Amalia Pinkusfeld,8,2,71,63
1656093927036,COGS 14A,A01,092681,Semenuks; Arturs,8,23,100,92
1656093933066,COGS 14B,A01,083073,Cheng; Tzu-Han,7,0,63,56
1656093939096,COGS 17,A01,092677,Semenuks; Arturs,13,6,81,68
1656093945120,COGS 100,A01,083619,Allen; Michael Gordon,8,4,70,62
1656093951162,COGS 101A,A01,083621,Davis; Joshua Daniel,7,3,68,61
1656093957191,COGS 101B,A01,091572,Allen; Michael Gordon,7,0,65,58
1656093963215,COGS 101C,A01,083625,Delgado; Tania,11,0,35,24
1656093969242,COGS 107A,A01,083627,Boyle; Mary E. T.,5,4,60,55
1656093975266,COGS 118A,A01,083075,Gupta; Anjum,24,16,76,52
1656093981289,CSE 3,A50,083646,Miranda; Gregory Joseph,20,0,50,30
1656093987321,CSE 8A,A50,083650,Miranda; Gregory Joseph,13,13,56,43
1656093993350,CSE 11,A01,083080,Cao; Yingjun,1,60,40,39
1656093999378,CSE 12,A01,083652,Krause-Levy; Sophia Louisa,14,8,120,106
1656094005410,CSE 15L,A01,083654,Morris; Justin Loren,5,1,50,45
1656094005410,CSE 15L,A02,083655,Morris; Justin Loren,7,1,50,43
1656094011436,CSE 20,A01,083657,Tran; Khoa Dang,31,0,80,49
1656094017458,CSE 21,A01,095574,Bach; Quang Tran,26,0,48,22
1656094023487,CSE 30,A01,083084,Eldon; John,3,11,80,77
1656094023487,CSE 30,B01,095061,Bhaskar; Nishant,4,5,50,46
1656094029511,CSE 100,A01,083659,Cao; Yingjun,2,23,70,68
1656094035535,CSE 134B,A01,083661,Powell; Thomas Allan,10,7,100,90
1656094041559,CSE 140,A01,083663,Gungor; Onat,9,0,85,76
1656094047592,CSE 140L,A01,083088,Eldon; John,8,0,100,92
1656094053619,CSE 175,A01,083665,Kumar; Rakesh,1,0,25,24
1656094059651,CSE 190,A00,092507,Dubnov; Shlomo,2,0,20,18
1656094065675,ECE 45,A01,083139,Congero; Spencer William,5,2,75,70
1656094071698,ECE 65,A50,083695,Saad; Andrew S,8,0,30,22
1656094071698,ECE 65,A51,095125,Staff,23,0,26,3
1656094077720,ECE 109,A01,091882,Touri; Behrouz,6,5,70,64
1656094083745,ECE 180,A00,083140,Abi Samra; Nicholas Camill,1,0,30,29
1656094083745,ECE 180,B00,083141,Abi Samra; Nicholas Camill,4,8,30,26
1656094089768,MATH 10A,A01,083735,Patchell; Gregory David,1,0,30,29
1656094089768,MATH 10A,A02,083736,Patchell; Gregory David,23,0,30,7
1656094089768,MATH 10A,A03,083737,Patchell; Gregory David,16,0,30,14
1656094095796,MATH 10B,A01,083207,Lim; Seonhee,3,2,34,31
1656094095796,MATH 10B,A02,083208,Lim; Seonhee,10,2,35,25
1656094095796,MATH 10B,A03,093472,Staff,4,2,34,30
1656094095796,MATH 10B,B01,083739,Sinha; Shubham,12,0,30,18
1656094101825,MATH 18,A01,083743,Cinel; Cameron Alexander,7,0,30,23
1656094101825,MATH 18,A02,083744,Cinel; Cameron Alexander,10,0,30,20
1656094101825,MATH 18,A03,083745,Cinel; Cameron Alexander,3,0,30,27
1656094101825,MATH 18,B01,083748,Ma; Zilu,1,0,36,35
1656094101825,MATH 18,B02,083749,Ma; Zilu,1,0,36,35
1656094101825,MATH 18,B03,083750,Ma; Zilu,0,0,36,36
1656094101825,MATH 18,B04,083751,Ma; Zilu,0,0,36,36
1656094101825,MATH 18,B05,093473,Staff,3,0,36,33
1656094101825,MATH 18,B06,093474,Staff,3,0,36,33
1656094107852,MATH 20A,A01,083754,Zheng; Zequn,11,0,40,29
1656094113879,MATH 20B,A01,083756,Briones; Jor-el Thomas Caparas,0,0,36,36
1656094113879,MATH 20B,A02,083757,Briones; Jor-el Thomas Caparas,1,0,36,35
1656094113879,MATH 20B,A03,093475,Staff,3,0,36,33
1656094119903,MATH 20C,A01,083760,Briones; Jor-el Thomas Caparas,2,2,35,33
1656094119903,MATH 20C,A02,083761,Briones; Jor-el Thomas Caparas,9,1,35,26
1656094119903,MATH 20C,A03,093476,Staff,1,1,35,34
1656094119903,MATH 20C,B01,083762,Bach; Quang Tran,3,0,30,27
1656094125928,MATH 20D,A01,083765,Tran; Brian Kha,3,0,30,27
1656094125928,MATH 20D,A02,083766,Tran; Brian Kha,0,1,30,30
1656094125928,MATH 20D,A03,083767,Tran; Brian Kha,2,0,30,28
1656094131954,MATH 20E,A01,083771,Ganguly; Soumya,4,1,32,28
1656094131954,MATH 20E,A02,083772,Ganguly; Soumya,2,1,32,30
1656094131954,MATH 20E,B01,083773,Ciotti; Benjamin,14,0,35,21
1656094131954,MATH 20E,B02,083774,Ciotti; Benjamin,15,0,35,20
1656094137983,MATH 103A,A01,083777,Greenfeld; Be'Eri,3,0,36,33
1656094137983,MATH 103A,A02,083778,Greenfeld; Be'Eri,3,0,36,33
1656094137983,MATH 103A,A03,093561,Staff,4,1,36,32
1656094137983,MATH 103A,B01,083779,Greenfeld; Be'Eri,8,1,36,28
1656094137983,MATH 103A,B02,083780,Greenfeld; Be'Eri,0,1,36,36
1656094137983,MATH 103A,B03,093562,Staff,0,0,36,36
1656094144006,MATH 105,A01,085443,Carter; Anne Toulson,4,1,35,31
1656094144006,MATH 105,A02,093477,Staff,10,0,35,25
1656094150029,MATH 109,A01,083213,Ganzberger; Geoffrey Michael,1,1,34,33
1656094150029,MATH 109,A02,083214,Ganzberger; Geoffrey Michael,0,0,34,34
1656094150029,MATH 109,A03,093478,Staff,3,0,34,31
1656094150029,MATH 109,B01,083215,Ganzberger; Geoffrey Michael,4,0,32,28
1656094150029,MATH 109,B02,083216,Ganzberger; Geoffrey Michael,1,0,32,31
1656094150029,MATH 109,B03,093479,Staff,4,0,32,28
1656094156057,MATH 142A,A01,083219,Chow; Bennett,2,0,32,30
1656094156057,MATH 142A,A02,083220,Chow; Bennett,8,0,32,24
1656094156057,MATH 142A,A03,093480,Staff,5,0,32,27
1656094156057,MATH 142A,B03,093481,Staff,4,0,32,28
1656094156057,MATH 142A,B04,093558,Staff,7,0,32,25
1656094156057,MATH 142A,B05,093559,Staff,0,0,32,32
1656094162089,MATH 193A,A01,083224,Rotar; Vladimir,1,2,34,33
1656094162089,MATH 193A,A02,083225,Rotar; Vladimir,2,0,34,32
1656094162089,MATH 193A,A03,083781,Rotar; Vladimir,2,0,34,32
1656094162089,MATH 193A,A04,083782,Rotar; Vladimir,7,0,34,27
1656094162089,MATH 193A,A05,093482,Rotar; Vladimir,1,0,34,33
1656094168114,MATH 197,001,091859,McAuley; Julian John,9999,0,9999,0
1656094168114,MATH 197,002,095566,Kedlaya; Kiran S.,9997,0,9999,2
1656094168114,MATH 197,003,095567,Xiao; Ming,9999,0,9999,0
1656094168114,MATH 197,004,095571,Perols; Johan Lars,9998,0,9999,1
1656094175169,COGS 9,A01,083615,Shannon; Kyle Michael,4,1,75,71
1656094181192,COGS 11,A01,083617,Boyle; Mary E. T.,16,2,48,32
1656094187228,COGS 13,A01,083071,Bastos; Amalia Pinkusfeld,8,2,71,63
1656094193254,COGS 14A,A01,092681,Semenuks; Arturs,8,23,100,92
1656094199277,COGS 14B,A01,083073,Cheng; Tzu-Han,7,0,63,56
1656094205306,COGS 17,A01,092677,Semenuks; Arturs,13,6,81,68
1656094211338,COGS 100,A01,083619,Allen; Michael Gordon,8,4,70,62
1656094217366,COGS 101A,A01,083621,Davis; Joshua Daniel,7,3,68,61
1656094223393,COGS 101B,A01,091572,Allen; Michael Gordon,7,0,65,58
1656094229418,COGS 101C,A01,083625,Delgado; Tania,11,0,35,24
1656094235446,COGS 107A,A01,083627,Boyle; Mary E. T.,5,4,60,55
1656094241474,COGS 118A,A01,083075,Gupta; Anjum,24,16,76,52
1656094256403,CSE 3,A50,083646,Miranda; Gregory Joseph,19,0,50,31
1656094262428,CSE 8A,A50,083650,Miranda; Gregory Joseph,13,13,56,43
1656094268454,CSE 11,A01,083080,Cao; Yingjun,1,60,40,39
1656094274480,CSE 12,A01,083652,Krause-Levy; Sophia Louisa,14,8,120,106
1656094280508,CSE 15L,A01,083654,Morris; Justin Loren,5,1,50,45
1656094280508,CSE 15L,A02,083655,Morris; Justin Loren,7,1,50,43
1656094286532,CSE 20,A01,083657,Tran; Khoa Dang,31,0,80,49
1656094292554,CSE 21,A01,095574,Bach; Quang Tran,26,0,48,22
1656094298580,CSE 30,A01,083084,Eldon; John,3,11,80,77
1656094298580,CSE 30,B01,095061,Bhaskar; Nishant,4,5,50,46
1656094304602,CSE 100,A01,083659,Cao; Yingjun,2,23,70,68
1656094310625,CSE 134B,A01,083661,Powell; Thomas Allan,10,7,100,90
1656094316656,CSE 140,A01,083663,Gungor; Onat,9,0,85,76
1656094322680,CSE 140L,A01,083088,Eldon; John,8,0,100,92
1656094328707,CSE 175,A01,083665,Kumar; Rakesh,1,0,25,24
1656094334734,CSE 190,A00,092507,Dubnov; Shlomo,2,0,20,18
1656094340762,ECE 45,A01,083139,Congero; Spencer William,5,2,75,70
1656094346793,ECE 65,A50,083695,Saad; Andrew S,8,0,30,22
1656094346793,ECE 65,A51,095125,Staff,23,0,26,3
1656094352831,ECE 109,A01,091882,Touri; Behrouz,6,5,70,64
1656094358854,ECE 180,A00,083140,Abi Samra; Nicholas Camill,1,0,30,29
1656094358854,ECE 180,B00,083141,Abi Samra; Nicholas Camill,4,8,30,26
1656094364879,MATH 10A,A01,083735,Patchell; Gregory David,1,0,30,29
1656094364879,MATH 10A,A02,083736,Patchell; Gregory David,23,0,30,7
1656094364879,MATH 10A,A03,083737,Patchell; Gregory David,16,0,30,14
1656094370996,MATH 10B,A01,083207,Lim; Seonhee,3,2,34,31
1656094370996,MATH 10B,A02,083208,Lim; Seonhee,10,2,35,25
1656094370996,MATH 10B,A03,093472,Staff,4,2,34,30
1656094370996,MATH 10B,B01,083739,Sinha; Shubham,12,0,30,18
1656094377030,MATH 18,A01,083743,Cinel; Cameron Alexander,7,0,30,23
1656094377030,MATH 18,A02,083744,Cinel; Cameron Alexander,10,0,30,20
1656094377030,MATH 18,A03,083745,Cinel; Cameron Alexander,3,0,30,27
1656094377030,MATH 18,B01,083748,Ma; Zilu,1,0,36,35
1656094377030,MATH 18,B02,083749,Ma; Zilu,1,0,36,35
1656094377030,MATH 18,B03,083750,Ma; Zilu,0,0,36,36
1656094377030,MATH 18,B04,083751,Ma; Zilu,0,0,36,36
1656094377030,MATH 18,B05,093473,Staff,3,0,36,33
1656094377030,MATH 18,B06,093474,Staff,3,0,36,33
1656094383053,MATH 20A,A01,083754,Zheng; Zequn,11,0,40,29
1656094389081,MATH 20B,A01,083756,Briones; Jor-el Thomas Caparas,0,0,36,36
1656094389081,MATH 20B,A02,083757,Briones; Jor-el Thomas Caparas,1,0,36,35
1656094389081,MATH 20B,A03,093475,Staff,3,0,36,33
1656094395128,MATH 20C,A01,083760,Briones; Jor-el Thomas Caparas,2,2,35,33
1656094395128,MATH 20C,A02,083761,Briones; Jor-el Thomas Caparas,9,1,35,26
1656094395128,MATH 20C,A03,093476,Staff,1,1,35,34
1656094395128,MATH 20C,B01,083762,Bach; Quang Tran,3,0,30,27
1656094401152,MATH 20D,A01,083765,Tran; Brian Kha,3,0,30,27
1656094401152,MATH 20D,A02,083766,Tran; Brian Kha,0,1,30,30
1656094401152,MATH 20D,A03,083767,Tran; Brian Kha,2,0,30,28
1656094407182,MATH 20E,A01,083771,Ganguly; Soumya,4,1,32,28
1656094407182,MATH 20E,A02,083772,Ganguly; Soumya,2,1,32,30
1656094407182,MATH 20E,B01,083773,Ciotti; Benjamin,14,0,35,21
1656094407182,MATH 20E,B02,083774,Ciotti; Benjamin,15,0,35,20
1656094413211,MATH 103A,A01,083777,Greenfeld; Be'Eri,3,0,36,33
1656094413211,MATH 103A,A02,083778,Greenfeld; Be'Eri,3,0,36,33
1656094413211,MATH 103A,A03,093561,Staff,4,1,36,32
1656094413211,MATH 103A,B01,083779,Greenfeld; Be'Eri,8,1,36,28
1656094413211,MATH 103A,B02,083780,Greenfeld; Be'Eri,0,1,36,36
1656094413211,MATH 103A,B03,093562,Staff,0,0,36,36
1656094419237,MATH 105,A01,085443,Carter; Anne Toulson,4,1,35,31
1656094419237,MATH 105,A02,093477,Staff,10,0,35,25
1656094425260,MATH 109,A01,083213,Ganzberger; Geoffrey Michael,1,1,34,33
1656094425260,MATH 109,A02,083214,Ganzberger; Geoffrey Michael,0,0,34,34
1656094425260,MATH 109,A03,093478,Staff,3,0,34,31
1656094425260,MATH 109,B01,083215,Ganzberger; Geoffrey Michael,4,0,32,28
1656094425260,MATH 109,B02,083216,Ganzberger; Geoffrey Michael,1,0,32,31
1656094425260,MATH 109,B03,093479,Staff,4,0,32,28
1656094431300,MATH 142A,A01,083219,Chow; Bennett,2,0,32,30
1656094431300,MATH 142A,A02,083220,Chow; Bennett,8,0,32,24
1656094431300,MATH 142A,A03,093480,Staff,5,0,32,27
1656094431300,MATH 142A,B03,093481,Staff,4,0,32,28
1656094431300,MATH 142A,B04,093558,Staff,7,0,32,25
1656094431300,MATH 142A,B05,093559,Staff,0,0,32,32
1656094437337,MATH 193A,A01,083224,Rotar; Vladimir,1,2,34,33
1656094437337,MATH 193A,A02,083225,Rotar; Vladimir,2,0,34,32
1656094437337,MATH 193A,A03,083781,Rotar; Vladimir,2,0,34,32
1656094437337,MATH 193A,A04,083782,Rotar; Vladimir,7,0,34,27
1656094437337,MATH 193A,A05,093482,Rotar; Vladimir,1,0,34,33
1656094443360,MATH 197,001,091859,McAuley; Julian John,9999,0,9999,0
1656094443360,MATH 197,002,095566,Kedlaya; Kiran S.,9997,0,9999,2
1656094443360,MATH 197,003,095567,Xiao; Ming,9999,0,9999,0
1656094443360,MATH 197,004,095571,Perols; Johan Lars,9998,0,9999,1
1656094450424,COGS 9,A01,083615,Shannon; Kyle Michael,4,1,75,71
1656094456465,COGS 11,A01,083617,Boyle; Mary E. T.,16,2,48,32
1656094462487,COGS 13,A01,083071,Bastos; Amalia Pinkusfeld,8,2,71,63
1656094468521,COGS 14A,A01,092681,Semenuks; Arturs,8,24,100,92
1656094474546,COGS 14B,A01,083073,Cheng; Tzu-Han,7,0,63,56
1656094480569,COGS 17,A01,092677,Semenuks; Arturs,13,6,81,68
1656094486592,COGS 100,A01,083619,Allen; Michael Gordon,8,4,70,62
1656094492614,COGS 101A,A01,083621,Davis; Joshua Daniel,7,3,68,61
1656094498648,COGS 101B,A01,091572,Allen; Michael Gordon,7,0,65,58
1656094504675,COGS 101C,A01,083625,Delgado; Tania,11,0,35,24
1656094510706,COGS 107A,A01,083627,Boyle; Mary E. T.,5,4,60,55
1656094516735,COGS 118A,A01,083075,Gupta; Anjum,24,16,76,52
1656094522759,CSE 3,A50,083646,Miranda; Gregory Joseph,19,0,50,31
1656094528786,CSE 8A,A50,083650,Miranda; Gregory Joseph,13,13,56,43
1656094534817,CSE 11,A01,083080,Cao; Yingjun,1,60,40,39
1656094540844,CSE 12,A01,083652,Krause-Levy; Sophia Louisa,14,8,120,106
1656094546875,CSE 15L,A01,083654,Morris; Justin Loren,5,1,50,45
1656094546875,CSE 15L,A02,083655,Morris; Justin Loren,7,1,50,43
1656094552897,CSE 20,A01,083657,Tran; Khoa Dang,31,0,80,49
1656094558926,CSE 21,A01,095574,Bach; Quang Tran,26,0,48,22
1656094564950,CSE 30,A01,083084,Eldon; John,3,11,80,77
1656094564950,CSE 30,B01,095061,Bhaskar; Nishant,4,5,50,46
1656094570973,CSE 100,A01,083659,Cao; Yingjun,2,23,70,68
1656094576998,CSE 134B,A01,083661,Powell; Thomas Allan,10,7,100,90
1656094583026,CSE 140,A01,083663,Gungor; Onat,9,0,85,76
1656094589050,CSE 140L,A01,083088,Eldon; John,8,0,100,92
1656094595080,CSE 175,A01,083665,Kumar; Rakesh,1,0,25,24
1656094601107,CSE 190,A00,092507,Dubnov; Shlomo,2,0,20,18
1656094607134,ECE 45,A01,083139,Congero; Spencer William,5,2,75,70
1656094613163,ECE 65,A50,083695,Saad; Andrew S,8,0,30,22
1656094613163,ECE 65,A51,095125,Staff,23,0,26,3
1656094619189,ECE 109,A01,091882,Touri; Behrouz,6,5,70,64
1656094625218,ECE 180,A00,083140,Abi Samra; Nicholas Camill,1,0,30,29
1656094625218,ECE 180,B00,083141,Abi Samra; Nicholas Camill,4,8,30,26
1656094631242,MATH 10A,A01,083735,Patchell; Gregory David,1,0,30,29
1656094631242,MATH 10A,A02,083736,Patchell; Gregory David,23,0,30,7
1656094631242,MATH 10A,A03,083737,Patchell; Gregory David,16,0,30,14
1656094637270,MATH 10B,A01,083207,Lim; Seonhee,3,2,34,31
1656094637270,MATH 10B,A02,083208,Lim; Seonhee,10,2,35,25
1656094637270,MATH 10B,A03,093472,Staff,4,2,34,30
1656094637270,MATH 10B,B01,083739,Sinha; Shubham,12,0,30,18
1656094643296,MATH 18,A01,083743,Cinel; Cameron Alexander,7,0,30,23
1656094643296,MATH 18,A02,083744,Cinel; Cameron Alexander,10,0,30,20
1656094643296,MATH 18,A03,083745,Cinel; Cameron Alexander,3,0,30,27
1656094643296,MATH 18,B01,083748,Ma; Zilu,0,0,36,36
1656094643296,MATH 18,B02,083749,Ma; Zilu,1,0,36,35
1656094643296,MATH 18,B03,083750,Ma; Zilu,0,0,36,36
1656094643296,MATH 18,B04,083751,Ma; Zilu,0,0,36,36
1656094643296,MATH 18,B05,093473,Staff,3,0,36,33
1656094643296,MATH 18,B06,093474,Staff,3,0,36,33
1656094649318,MATH 20A,A01,083754,Zheng; Zequn,11,0,40,29
1656094655392,MATH 20B,A01,083756,Briones; Jor-el Thomas Caparas,0,0,36,36
1656094655392,MATH 20B,A02,083757,Briones; Jor-el Thomas Caparas,1,0,36,35
1656094655392,MATH 20B,A03,093475,Staff,3,0,36,33
1656094661427,MATH 20C,A01,083760,Briones; Jor-el Thomas Caparas,2,2,35,33
1656094661427,MATH 20C,A02,083761,Briones; Jor-el Thomas Caparas,9,1,35,26
1656094661427,MATH 20C,A03,093476,Staff,1,1,35,34
1656094661427,MATH 20C,B01,083762,Bach; Quang Tran,3,0,30,27
1656094667465,MATH 20D,A01,083765,Tran; Brian Kha,3,0,30,27
1656094667465,MATH 20D,A02,083766,Tran; Brian Kha,0,1,30,30
1656094667465,MATH 20D,A03,083767,Tran; Brian Kha,2,0,30,28
1656094673489,MATH 20E,A01,083771,Ganguly; Soumya,4,1,32,28
1656094673489,MATH 20E,A02,083772,Ganguly; Soumya,2,1,32,30
1656094673489,MATH 20E,B01,083773,Ciotti; Benjamin,14,0,35,21
1656094673489,MATH 20E,B02,083774,Ciotti; Benjamin,15,0,35,20
1656094679518,MATH 103A,A01,083777,Greenfeld; Be'Eri,3,0,36,33
1656094679518,MATH 103A,A02,083778,Greenfeld; Be'Eri,3,0,36,33
1656094679518,MATH 103A,A03,093561,Staff,4,1,36,32
1656094679518,MATH 103A,B01,083779,Greenfeld; Be'Eri,8,1,36,28
1656094679518,MATH 103A,B02,083780,Greenfeld; Be'Eri,0,1,36,36
1656094679518,MATH 103A,B03,093562,Staff,0,0,36,36
1656094685544,MATH 105,A01,085443,Carter; Anne Toulson,4,1,35,31
1656094685544,MATH 105,A02,093477,Staff,10,0,35,25
1656094691567,MATH 109,A01,083213,Ganzberger; Geoffrey Michael,1,1,34,33
1656094691567,MATH 109,A02,083214,Ganzberger; Geoffrey Michael,0,0,34,34
1656094691567,MATH 109,A03,093478,Staff,3,0,34,31
1656094691567,MATH 109,B01,083215,Ganzberger; Geoffrey Michael,4,0,32,28
1656094691567,MATH 109,B02,083216,Ganzberger; Geoffrey Michael,1,0,32,31
1656094691567,MATH 109,B03,093479,Staff,4,0,32,28
1656094697597,MATH 142A,A01,083219,Chow; Bennett,2,0,32,30
1656094697597,MATH 142A,A02,083220,Chow; Bennett,8,0,32,24
1656094697597,MATH 142A,A03,093480,Staff,5,0,32,27
1656094697597,MATH 142A,B03,093481,Staff,4,0,32,28
1656094697597,MATH 142A,B04,093558,Staff,7,0,32,25
1656094697597,MATH 142A,B05,093559,Staff,0,0,32,32
1656094703621,MATH 193A,A01,083224,Rotar; Vladimir,1,2,34,33
1656094703621,MATH 193A,A02,083225,Rotar; Vladimir,2,0,34,32
1656094703621,MATH 193A,A03,083781,Rotar; Vladimir,2,0,34,32
1656094703621,MATH 193A,A04,083782,Rotar; Vladimir,7,0,34,27
1656094703621,MATH 193A,A05,093482,Rotar; Vladimir,1,0,34,33
1656094709645,MATH 197,001,091859,McAuley; Julian John,9999,0,9999,0
1656094709645,MATH 197,002,095566,Kedlaya; Kiran S.,9997,0,9999,2
1656094709645,MATH 197,003,095567,Xiao; Ming,9999,0,9999,0
1656094709645,MATH 197,004,095571,Perols; Johan Lars,9998,0,9999,1
1656094716705,COGS 9,A01,083615,Shannon; Kyle Michael,4,1,75,71
1656094722727,COGS 11,A01,083617,Boyle; Mary E. T.,16,2,48,32
1656094728753,COGS 13,A01,083071,Bastos; Amalia Pinkusfeld,8,3,71,63
1656094734776,COGS 14A,A01,092681,Semenuks; Arturs,8,24,100,92
1656094740800,COGS 14B,A01,083073,Cheng; Tzu-Han,7,0,63,56
1656094746828,COGS 17,A01,092677,Semenuks; Arturs,13,6,81,68
1656094752856,COGS 100,A01,083619,Allen; Michael Gordon,8,4,70,62
1656094758884,COGS 101A,A01,083621,Davis; Joshua Daniel,7,3,68,61
1656094764908,COGS 101B,A01,091572,Allen; Michael Gordon,7,0,65,58
1656094770936,COGS 101C,A01,083625,Delgado; Tania,11,0,35,24
1656094776965,COGS 107A,A01,083627,Boyle; Mary E. T.,5,4,60,55
1656094782989,COGS 118A,A01,083075,Gupta; Anjum,24,16,76,52
1656094789011,CSE 3,A50,083646,Miranda; Gregory Joseph,19,0,50,31
1656094795042,CSE 8A,A50,083650,Miranda; Gregory Joseph,13,13,56,43
1656094801065,CSE 11,A01,083080,Cao; Yingjun,1,60,40,39
1656094807088,CSE 12,A01,083652,Krause-Levy; Sophia Louisa,14,8,120,106
1656094813113,CSE 15L,A01,083654,Morris; Justin Loren,5,1,50,45
1656094813113,CSE 15L,A02,083655,Morris; Justin Loren,7,1,50,43
1656094819136,CSE 20,A01,083657,Tran; Khoa Dang,31,0,80,49
1656094825166,CSE 21,A01,095574,Bach; Quang Tran,26,0,48,22
1656094831197,CSE 30,A01,083084,Eldon; John,3,11,80,77
1656094831197,CSE 30,B01,095061,Bhaskar; Nishant,4,5,50,46
1656094837227,CSE 100,A01,083659,Cao; Yingjun,2,23,70,68
1656094843259,CSE 134B,A01,083661,Powell; Thomas Allan,10,7,100,90
1656094849287,CSE 140,A01,083663,Gungor; Onat,9,0,85,76
1656094855312,CSE 140L,A01,083088,Eldon; John,8,0,100,92
1656094861340,CSE 175,A01,083665,Kumar; Rakesh,1,0,25,24
1656094867363,CSE 190,A00,092507,Dubnov; Shlomo,2,0,20,18
1656094873386,ECE 45,A01,083139,Congero; Spencer William,5,2,75,70
1656094879409,ECE 65,A50,083695,Saad; Andrew S,8,0,30,22
1656094879409,ECE 65,A51,095125,Staff,23,0,26,3
1656094885435,ECE 109,A01,091882,Touri; Behrouz,6,5,70,64
1656094891467,ECE 180,A00,083140,Abi Samra; Nicholas Camill,1,0,30,29
1656094891467,ECE 180,B00,083141,Abi Samra; Nicholas Camill,4,8,30,26
1656094897493,MATH 10A,A01,083735,Patchell; Gregory David,1,0,30,29
1656094897493,MATH 10A,A02,083736,Patchell; Gregory David,23,0,30,7
1656094897493,MATH 10A,A03,083737,Patchell; Gregory David,16,0,30,14
1656094903518,MATH 10B,A01,083207,Lim; Seonhee,3,2,34,31
1656094903518,MATH 10B,A02,083208,Lim; Seonhee,10,2,35,25
1656094903518,MATH 10B,A03,093472,Staff,4,2,34,30
1656094903518,MATH 10B,B01,083739,Sinha; Shubham,12,0,30,18
1656094909542,MATH 18,A01,083743,Cinel; Cameron Alexander,7,0,30,23
1656094909542,MATH 18,A02,083744,Cinel; Cameron Alexander,10,0,30,20
1656094909542,MATH 18,A03,083745,Cinel; Cameron Alexander,3,0,30,27
1656094909542,MATH 18,B01,083748,Ma; Zilu,0,0,36,36
1656094909542,MATH 18,B02,083749,Ma; Zilu,1,0,36,35
1656094909542,MATH 18,B03,083750,Ma; Zilu,0,0,36,36
1656094909542,MATH 18,B04,083751,Ma; Zilu,0,0,36,36
1656094909542,MATH 18,B05,093473,Staff,3,0,36,33
1656094909542,MATH 18,B06,093474,Staff,3,0,36,33
1656094915564,MATH 20A,A01,083754,Zheng; Zequn,11,0,40,29
1656094921588,MATH 20B,A01,083756,Briones; Jor-el Thomas Caparas,0,0,36,36
1656094921588,MATH 20B,A02,083757,Briones; Jor-el Thomas Caparas,1,0,36,35
1656094921588,MATH 20B,A03,093475,Staff,3,0,36,33
1656094927611,MATH 20C,A01,083760,Briones; Jor-el Thomas Caparas,2,2,35,33
1656094927611,MATH 20C,A02,083761,Briones; Jor-el Thomas Caparas,9,1,35,26
1656094927611,MATH 20C,A03,093476,Staff,1,1,35,34
1656094927611,MATH 20C,B01,083762,Bach; Quang Tran,3,0,30,27
1656094933633,MATH 20D,A01,083765,Tran; Brian Kha,3,0,30,27
1656094933633,MATH 20D,A02,083766,Tran; Brian Kha,0,1,30,30
1656094933633,MATH 20D,A03,083767,Tran; Brian Kha,2,0,30,28
1656094939656,MATH 20E,A01,083771,Ganguly; Soumya,4,1,32,28
1656094939656,MATH 20E,A02,083772,Ganguly; Soumya,2,1,32,30
1656094939656,MATH 20E,B01,083773,Ciotti; Benjamin,14,0,35,21
1656094939656,MATH 20E,B02,083774,Ciotti; Benjamin,15,0,35,20
1656094945681,MATH 103A,A01,083777,Greenfeld; Be'Eri,3,0,36,33
1656094945681,MATH 103A,A02,083778,Greenfeld; Be'Eri,3,0,36,33
1656094945681,MATH 103A,A03,093561,Staff,4,1,36,32
1656094945681,MATH 103A,B01,083779,Greenfeld; Be'Eri,8,1,36,28
1656094945681,MATH 103A,B02,083780,Greenfeld; Be'Eri,0,1,36,36
1656094945681,MATH 103A,B03,093562,Staff,0,0,36,36
1656094951704,MATH 105,A01,085443,Carter; Anne Toulson,4,1,35,31
1656094951704,MATH 105,A02,093477,Staff,10,0,35,25
1656094957732,MATH 109,A01,083213,Ganzberger; Geoffrey Michael,1,1,34,33
1656094957732,MATH 109,A02,083214,Ganzberger; Geoffrey Michael,0,0,34,34
1656094957732,MATH 109,A03,093478,Staff,3,0,34,31
1656094957732,MATH 109,B01,083215,Ganzberger; Geoffrey Michael,3,0,32,29
1656094957732,MATH 109,B02,083216,Ganzberger; Geoffrey Michael,1,0,32,31
1656094957732,MATH 109,B03,093479,Staff,4,0,32,28
1656094963762,MATH 142A,A01,083219,Chow; Bennett,2,0,32,30
1656094963762,MATH 142A,A02,083220,Chow; Bennett,8,0,32,24
1656094963762,MATH 142A,A03,093480,Staff,5,0,32,27
1656094963762,MATH 142A,B03,093481,Staff,4,0,32,28
1656094963762,MATH 142A,B04,093558,Staff,7,0,32,25
1656094963762,MATH 142A,B05,093559,Staff,0,0,32,32
1656094969859,MATH 193A,A01,083224,Rotar; Vladimir,1,2,34,33
1656094969859,MATH 193A,A02,083225,Rotar; Vladimir,2,0,34,32
1656094969859,MATH 193A,A03,083781,Rotar; Vladimir,2,0,34,32
1656094969859,MATH 193A,A04,083782,Rotar; Vladimir,7,0,34,27
1656094969859,MATH 193A,A05,093482,Rotar; Vladimir,1,0,34,33
1656094975882,MATH 197,001,091859,McAuley; Julian John,9999,0,9999,0
1656094975882,MATH 197,002,095566,Kedlaya; Kiran S.,9997,0,9999,2
1656094975882,MATH 197,003,095567,Xiao; Ming,9999,0,9999,0
1656094975882,MATH 197,004,095571,Perols; Johan Lars,9998,0,9999,1
1656094982955,COGS 9,A01,083615,Shannon; Kyle Michael,4,1,75,71
1656094988982,COGS 11,A01,083617,Boyle; Mary E. T.,16,2,48,32
1656094995005,COGS 13,A01,083071,Bastos; Amalia Pinkusfeld,8,3,71,63
1656095001031,COGS 14A,A01,092681,Semenuks; Arturs,8,24,100,92
1656095007058,COGS 14B,A01,083073,Cheng; Tzu-Han,7,0,63,56
1656095013086,COGS 17,A01,092677,Semenuks; Arturs,13,6,81,68
1656095019112,COGS 100,A01,083619,Allen; Michael Gordon,8,4,70,62
1656095025145,COGS 101A,A01,083621,Davis; Joshua Daniel,7,3,68,61
1656095031176,COGS 101B,A01,091572,Allen; Michael Gordon,7,0,65,58
1656095037203,COGS 101C,A01,083625,Delgado; Tania,11,0,35,24
1656095043235,COGS 107A,A01,083627,Boyle; Mary E. T.,5,4,60,55
1656095049258,COGS 118A,A01,083075,Gupta; Anjum,24,16,76,52
1656095055283,CSE 3,A50,083646,Miranda; Gregory Joseph,19,0,50,31
1656095061307,CSE 8A,A50,083650,Miranda; Gregory Joseph,13,13,56,43
1656095067340,CSE 11,A01,083080,Cao; Yingjun,1,60,40,39
1656095073367,CSE 12,A01,083652,Krause-Levy; Sophia Louisa,14,8,120,106
1656095079391,CSE 15L,A01,083654,Morris; Justin Loren,5,2,50,45
1656095079391,CSE 15L,A02,083655,Morris; Justin Loren,7,1,50,43
1656095085420,CSE 20,A01,083657,Tran; Khoa Dang,31,0,80,49
1656095091446,CSE 21,A01,095574,Bach; Quang Tran,26,0,48,22
1656095097566,CSE 30,A01,083084,Eldon; John,3,11,80,77
1656095097566,CSE 30,B01,095061,Bhaskar; Nishant,4,5,50,46
1656095103589,CSE 100,A01,083659,Cao; Yingjun,2,23,70,68
1656095109616,CSE 134B,A01,083661,Powell; Thomas Allan,10,7,100,90
1656095115647,CSE 140,A01,083663,Gungor; Onat,9,0,85,76
1656095121670,CSE 140L,A01,083088,Eldon; John,8,0,100,92
1656095127694,CSE 175,A01,083665,Kumar; Rakesh,1,0,25,24
1656095133720,CSE 190,A00,092507,Dubnov; Shlomo,2,0,20,18
1656095139743,ECE 45,A01,083139,Congero; Spencer William,5,2,75,70
1656095145771,ECE 65,A50,083695,Saad; Andrew S,8,0,30,22
1656095145771,ECE 65,A51,095125,Staff,23,0,26,3
1656095151802,ECE 109,A01,091882,Touri; Behrouz,7,5,70,63
1656095157824,ECE 180,A00,083140,Abi Samra; Nicholas Camill,1,0,30,29
1656095157824,ECE 180,B00,083141,Abi Samra; Nicholas Camill,4,8,30,26
1656095163851,MATH 10A,A01,083735,Patchell; Gregory David,1,0,30,29
1656095163851,MATH 10A,A02,083736,Patchell; Gregory David,23,0,30,7
1656095163851,MATH 10A,A03,083737,Patchell; Gregory David,16,0,30,14
1656095169882,MATH 10B,A01,083207,Lim; Seonhee,3,2,34,31
1656095169882,MATH 10B,A02,083208,Lim; Seonhee,10,2,35,25
1656095169882,MATH 10B,A03,093472,Staff,4,2,34,30
1656095169882,MATH 10B,B01,083739,Sinha; Shubham,12,0,30,18
1656095175931,MATH 18,A01,083743,Cinel; Cameron Alexander,7,0,30,23
1656095175931,MATH 18,A02,083744,Cinel; Cameron Alexander,10,0,30,20
1656095175931,MATH 18,A03,083745,Cinel; Cameron Alexander,3,0,30,27
1656095175931,MATH 18,B01,083748,Ma; Zilu,0,0,36,36
1656095175931,MATH 18,B02,083749,Ma; Zilu,1,0,36,35
1656095175931,MATH 18,B03,083750,Ma; Zilu,0,0,36,36
1656095175931,MATH 18,B04,083751,Ma; Zilu,0,0,36,36
1656095175931,MATH 18,B05,093473,Staff,3,0,36,33
1656095175931,MATH 18,B06,093474,Staff,3,0,36,33
1656095181958,MATH 20A,A01,083754,Zheng; Zequn,11,0,40,29
1656095187981,MATH 20B,A01,083756,Briones; Jor-el Thomas Caparas,0,0,36,36
1656095187981,MATH 20B,A02,083757,Briones; Jor-el Thomas Caparas,1,0,36,35
1656095187981,MATH 20B,A03,093475,Staff,3,0,36,33
1656095194015,MATH 20C,A01,083760,Briones; Jor-el Thomas Caparas,2,2,35,33
1656095194015,MATH 20C,A02,083761,Briones; Jor-el Thomas Caparas,9,1,35,26
1656095194015,MATH 20C,A03,093476,Staff,1,1,35,34
1656095194015,MATH 20C,B01,083762,Bach; Quang Tran,3,0,30,27
1656095200039,MATH 20D,A01,083765,Tran; Brian Kha,3,0,30,27
1656095200039,MATH 20D,A02,083766,Tran; Brian Kha,0,1,30,30
1656095200039,MATH 20D,A03,083767,Tran; Brian Kha,2,0,30,28
1656095206063,MATH 20E,A01,083771,Ganguly; Soumya,4,1,32,28
1656095206063,MATH 20E,A02,083772,Ganguly; Soumya,2,1,32,30
1656095206063,MATH 20E,B01,083773,Ciotti; Benjamin,14,0,35,21
1656095206063,MATH 20E,B02,083774,Ciotti; Benjamin,15,0,35,20
1656095212093,MATH 103A,A01,083777,Greenfeld; Be'Eri,3,0,36,33
1656095212093,MATH 103A,A02,083778,Greenfeld; Be'Eri,3,0,36,33
1656095212093,MATH 103A,A03,093561,Staff,4,1,36,32
1656095212093,MATH 103A,B01,083779,Greenfeld; Be'Eri,8,1,36,28
1656095212093,MATH 103A,B02,083780,Greenfeld; Be'Eri,0,1,36,36
1656095212093,MATH 103A,B03,093562,Staff,0,0,36,36
1656095218122,MATH 105,A01,085443,Carter; Anne Toulson,4,1,35,31
1656095218122,MATH 105,A02,093477,Staff,10,0,35,25
1656095224152,MATH 109,A01,083213,Ganzberger; Geoffrey Michael,1,1,34,33
1656095224152,MATH 109,A02,083214,Ganzberger; Geoffrey Michael,0,0,34,34
1656095224152,MATH 109,A03,093478,Staff,3,0,34,31
1656095224152,MATH 109,B01,083215,Ganzberger; Geoffrey Michael,3,0,32,29
1656095224152,MATH 109,B02,083216,Ganzberger; Geoffrey Michael,1,0,32,31
1656095224152,MATH 109,B03,093479,Staff,4,0,32,28
1656095230181,MATH 142A,A01,083219,Chow; Bennett,2,0,32,30
1656095230181,MATH 142A,A02,083220,Chow; Bennett,8,0,32,24
1656095230181,MATH 142A,A03,093480,Staff,5,0,32,27
1656095230181,MATH 142A,B03,093481,Staff,4,0,32,28
1656095230181,MATH 142A,B04,093558,Staff,7,0,32,25
1656095230181,MATH 142A,B05,093559,Staff,0,0,32,32
1656095236205,MATH 193A,A01,083224,Rotar; Vladimir,1,2,34,33
1656095236205,MATH 193A,A02,083225,Rotar; Vladimir,2,0,34,32
1656095236205,MATH 193A,A03,083781,Rotar; Vladimir,2,0,34,32
1656095236205,MATH 193A,A04,083782,Rotar; Vladimir,7,0,34,27
1656095236205,MATH 193A,A05,093482,Rotar; Vladimir,1,0,34,33
1656095242230,MATH 197,001,091859,McAuley; Julian John,9999,0,9999,0
1656095242230,MATH 197,002,095566,Kedlaya; Kiran S.,9997,0,9999,2
1656095242230,MATH 197,003,095567,Xiao; Ming,9999,0,9999,0
1656095242230,MATH 197,004,095571,Perols; Johan Lars,9998,0,9999,1
1656095249282,COGS 9,A01,083615,Shannon; Kyle Michael,4,1,75,71
1656095255304,COGS 11,A01,083617,Boyle; Mary E. T.,16,2,48,32
1656095261329,COGS 13,A01,083071,Bastos; Amalia Pinkusfeld,8,3,71,63
1656095267356,COGS 14A,A01,092681,Semenuks; Arturs,8,24,100,92
1656095273383,COGS 14B,A01,083073,Cheng; Tzu-Han,7,0,63,56
1656095279410,COGS 17,A01,092677,Semenuks; Arturs,13,6,81,68
1656095285433,COGS 100,A01,083619,Allen; Michael Gordon,8,4,70,62
1656095291459,COGS 101A,A01,083621,Davis; Joshua Daniel,7,3,68,61
1656095297487,COGS 101B,A01,091572,Allen; Michael Gordon,7,0,65,58
1656095303517,COGS 101C,A01,083625,Delgado; Tania,11,0,35,24
1656095309544,COGS 107A,A01,083627,Boyle; Mary E. T.,5,4,60,55
1656095315570,COGS 118A,A01,083075,Gupta; Anjum,24,16,76,52
1656095321600,CSE 3,A50,083646,Miranda; Gregory Joseph,18,0,50,32
1656095327624,CSE 8A,A50,083650,Miranda; Gregory Joseph,13,13,56,43
1656095333657,CSE 11,A01,083080,Cao; Yingjun,1,60,40,39
1656095339684,CSE 12,A01,083652,Krause-Levy; Sophia Louisa,14,8,120,106
1656095345719,CSE 15L,A01,083654,Morris; Justin Loren,5,2,50,45
1656095345719,CSE 15L,A02,083655,Morris; Justin Loren,7,1,50,43
1656095351742,CSE 20,A01,083657,Tran; Khoa Dang,31,0,80,49
1656095357770,CSE 21,A01,095574,Bach; Quang Tran,26,0,48,22
1656095363797,CSE 30,A01,083084,Eldon; John,3,11,80,77
1656095363797,CSE 30,B01,095061,Bhaskar; Nishant,4,5,50,46
1656095369824,CSE 100,A01,083659,Cao; Yingjun,2,23,70,68
1656095375851,CSE 134B,A01,083661,Powell; Thomas Allan,10,7,100,90
1656095381888,CSE 140,A01,083663,Gungor; Onat,9,0,85,76
1656095387915,CSE 140L,A01,083088,Eldon; John,8,0,100,92
1656095393937,CSE 175,A01,083665,Kumar; Rakesh,1,0,25,24
1656095399983,CSE 190,A00,092507,Dubnov; Shlomo,2,0,20,18
1656095406006,ECE 45,A01,083139,Congero; Spencer William,5,2,75,70
1656095412040,ECE 65,A50,083695,Saad; Andrew S,8,0,30,22
1656095412040,ECE 65,A51,095125,Staff,23,0,26,3
1656095418067,ECE 109,A01,091882,Touri; Behrouz,7,5,70,63
1656095424091,ECE 180,A00,083140,Abi Samra; Nicholas Camill,1,0,30,29
1656095424091,ECE 180,B00,083141,Abi Samra; Nicholas Camill,4,8,30,26
1656095430120,MATH 10A,A01,083735,Patchell; Gregory David,1,0,30,29
1656095430120,MATH 10A,A02,083736,Patchell; Gregory David,23,0,30,7
1656095430120,MATH 10A,A03,083737,Patchell; Gregory David,16,0,30,14
1656095436145,MATH 10B,A01,083207,Lim; Seonhee,3,2,34,31
1656095436145,MATH 10B,A02,083208,Lim; Seonhee,10,2,35,25
1656095436145,MATH 10B,A03,093472,Staff,4,2,34,30
1656095436145,MATH 10B,B01,083739,Sinha; Shubham,11,0,30,19
1656095442176,MATH 18,A01,083743,Cinel; Cameron Alexander,7,0,30,23
1656095442176,MATH 18,A02,083744,Cinel; Cameron Alexander,10,0,30,20
1656095442176,MATH 18,A03,083745,Cinel; Cameron Alexander,3,0,30,27
1656095442176,MATH 18,B01,083748,Ma; Zilu,0,0,36,36
1656095442176,MATH 18,B02,083749,Ma; Zilu,1,0,36,35
1656095442176,MATH 18,B03,083750,Ma; Zilu,0,0,36,36
1656095442176,MATH 18,B04,083751,Ma; Zilu,0,0,36,36
1656095442176,MATH 18,B05,093473,Staff,3,0,36,33
1656095442176,MATH 18,B06,093474,Staff,3,0,36,33
1656095448200,MATH 20A,A01,083754,Zheng; Zequn,11,0,40,29
1656095454232,MATH 20B,A01,083756,Briones; Jor-el Thomas Caparas,0,0,36,36
1656095454232,MATH 20B,A02,083757,Briones; Jor-el Thomas Caparas,1,0,36,35
1656095454232,MATH 20B,A03,093475,Staff,3,0,36,33
1656095460269,MATH 20C,A01,083760,Briones; Jor-el Thomas Caparas,2,2,35,33
1656095460269,MATH 20C,A02,083761,Briones; Jor-el Thomas Caparas,9,1,35,26
1656095460269,MATH 20C,A03,093476,Staff,1,1,35,34
1656095460269,MATH 20C,B01,083762,Bach; Quang Tran,3,0,30,27
1656095466294,MATH 20D,A01,083765,Tran; Brian Kha,3,0,30,27
1656095466294,MATH 20D,A02,083766,Tran; Brian Kha,0,1,30,30
1656095466294,MATH 20D,A03,083767,Tran; Brian Kha,2,0,30,28
1656095472324,MATH 20E,A01,083771,Ganguly; Soumya,4,1,32,28
1656095472324,MATH 20E,A02,083772,Ganguly; Soumya,2,1,32,30
1656095472324,MATH 20E,B01,083773,Ciotti; Benjamin,14,0,35,21
1656095472324,MATH 20E,B02,083774,Ciotti; Benjamin,15,0,35,20
1656095478356,MATH 103A,A01,083777,Greenfeld; Be'Eri,3,0,36,33
1656095478356,MATH 103A,A02,083778,Greenfeld; Be'Eri,3,0,36,33
1656095478356,MATH 103A,A03,093561,Staff,4,1,36,32
1656095478356,MATH 103A,B01,083779,Greenfeld; Be'Eri,8,1,36,28
1656095478356,MATH 103A,B02,083780,Greenfeld; Be'Eri,0,1,36,36
1656095478356,MATH 103A,B03,093562,Staff,0,0,36,36
1656095484379,MATH 105,A01,085443,Carter; Anne Toulson,4,1,35,31
1656095484379,MATH 105,A02,093477,Staff,10,0,35,25
1656095490414,MATH 109,A01,083213,Ganzberger; Geoffrey Michael,1,1,34,33
1656095490414,MATH 109,A02,083214,Ganzberger; Geoffrey Michael,0,0,34,34
1656095490414,MATH 109,A03,093478,Staff,3,0,34,31
1656095490414,MATH 109,B01,083215,Ganzberger; Geoffrey Michael,3,0,32,29
1656095490414,MATH 109,B02,083216,Ganzberger; Geoffrey Michael,1,0,32,31
1656095490414,MATH 109,B03,093479,Staff,4,0,32,28
1656095496447,MATH 142A,A01,083219,Chow; Bennett,2,0,32,30
1656095496447,MATH 142A,A02,083220,Chow; Bennett,8,0,32,24
1656095496447,MATH 142A,A03,093480,Staff,5,0,32,27
1656095496447,MATH 142A,B03,093481,Staff,4,0,32,28
1656095496447,MATH 142A,B04,093558,Staff,7,0,32,25
1656095496447,MATH 142A,B05,093559,Staff,0,0,32,32
1656095502471,MATH 193A,A01,083224,Rotar; Vladimir,1,2,34,33
1656095502471,MATH 193A,A02,083225,Rotar; Vladimir,2,0,34,32
1656095502471,MATH 193A,A03,083781,Rotar; Vladimir,2,0,34,32
1656095502471,MATH 193A,A04,083782,Rotar; Vladimir,7,0,34,27
1656095502471,MATH 193A,A05,093482,Rotar; Vladimir,1,0,34,33
1656095508508,MATH 197,001,091859,McAuley; Julian John,9999,0,9999,0
1656095508508,MATH 197,002,095566,Kedlaya; Kiran S.,9997,0,9999,2
1656095508508,MATH 197,003,095567,Xiao; Ming,9999,0,9999,0
1656095508508,MATH 197,004,095571,Perols; Johan Lars,9998,0,9999,1
1656095515571,COGS 9,A01,083615,Shannon; Kyle Michael,4,1,75,71
1656095521607,COGS 11,A01,083617,Boyle; Mary E. T.,16,2,48,32
1656095527634,COGS 13,A01,083071,Bastos; Amalia Pinkusfeld,8,3,71,63
1656095533657,COGS 14A,A01,092681,Semenuks; Arturs,8,24,100,92
1656095539685,COGS 14B,A01,083073,Cheng; Tzu-Han,7,0,63,56
1656095545715,COGS 17,A01,092677,Semenuks; Arturs,13,6,81,68
1656095551742,COGS 100,A01,083619,Allen; Michael Gordon,8,4,70,62
1656095557771,COGS 101A,A01,083621,Davis; Joshua Daniel,7,3,68,61
1656095563867,COGS 101B,A01,091572,Allen; Michael Gordon,7,0,65,58
1656095569897,COGS 101C,A01,083625,Delgado; Tania,11,0,35,24
1656095575927,COGS 107A,A01,083627,Boyle; Mary E. T.,5,4,60,55
1656095581950,COGS 118A,A01,083075,Gupta; Anjum,24,16,76,52
1656095587988,CSE 3,A50,083646,Miranda; Gregory Joseph,18,0,50,32
1656095594012,CSE 8A,A50,083650,Miranda; Gregory Joseph,13,13,56,43
1656095600038,CSE 11,A01,083080,Cao; Yingjun,1,60,40,39
1656095606072,CSE 12,A01,083652,Krause-Levy; Sophia Louisa,14,8,120,106
1656095612100,CSE 15L,A01,083654,Morris; Justin Loren,5,2,50,45
1656095612100,CSE 15L,A02,083655,Morris; Justin Loren,7,2,50,43
1656095618126,CSE 20,A01,083657,Tran; Khoa Dang,31,0,80,49
1656095624149,CSE 21,A01,095574,Bach; Quang Tran,26,0,48,22
1656095630180,CSE 30,A01,083084,Eldon; John,3,11,80,77
1656095630180,CSE 30,B01,095061,Bhaskar; Nishant,4,5,50,46
1656095636205,CSE 100,A01,083659,Cao; Yingjun,2,23,70,68
1656095642234,CSE 134B,A01,083661,Powell; Thomas Allan,10,7,100,90
1656095648272,CSE 140,A01,083663,Gungor; Onat,9,0,85,76
1656095654297,CSE 140L,A01,083088,Eldon; John,8,0,100,92
1656095660325,CSE 175,A01,083665,Kumar; Rakesh,1,0,25,24
1656095666351,CSE 190,A00,092507,Dubnov; Shlomo,2,0,20,18
1656095672377,ECE 45,A01,083139,Congero; Spencer William,5,2,75,70
1656095678400,ECE 65,A50,083695,Saad; Andrew S,8,0,30,22
1656095678400,ECE 65,A51,095125,Staff,23,0,26,3
1656095684432,ECE 109,A01,091882,Touri; Behrouz,7,5,70,63
1656095690455,ECE 180,A00,083140,Abi Samra; Nicholas Camill,1,0,30,29
1656095690455,ECE 180,B00,083141,Abi Samra; Nicholas Camill,4,8,30,26
1656095696477,MATH 10A,A01,083735,Patchell; Gregory David,1,0,30,29
1656095696477,MATH 10A,A02,083736,Patchell; Gregory David,23,0,30,7
1656095696477,MATH 10A,A03,083737,Patchell; Gregory David,16,0,30,14
1656095702508,MATH 10B,A01,083207,Lim; Seonhee,3,2,34,31
1656095702508,MATH 10B,A02,083208,Lim; Seonhee,10,2,35,25
1656095702508,MATH 10B,A03,093472,Staff,4,2,34,30
1656095702508,MATH 10B,B01,083739,Sinha; Shubham,11,0,30,19
1656095708531,MATH 18,A01,083743,Cinel; Cameron Alexander,7,0,30,23
1656095708531,MATH 18,A02,083744,Cinel; Cameron Alexander,10,0,30,20
1656095708531,MATH 18,A03,083745,Cinel; Cameron Alexander,3,0,30,27
1656095708531,MATH 18,B01,083748,Ma; Zilu,0,0,36,36
1656095708531,MATH 18,B02,083749,Ma; Zilu,1,0,36,35
1656095708531,MATH 18,B03,083750,Ma; Zilu,0,0,36,36
1656095708531,MATH 18,B04,083751,Ma; Zilu,0,0,36,36
1656095708531,MATH 18,B05,093473,Staff,3,0,36,33
1656095708531,MATH 18,B06,093474,Staff,3,0,36,33
1656095714557,MATH 20A,A01,083754,Zheng; Zequn,11,0,40,29
1656095720579,MATH 20B,A01,083756,Briones; Jor-el Thomas Caparas,0,0,36,36
1656095720579,MATH 20B,A02,083757,Briones; Jor-el Thomas Caparas,1,0,36,35
1656095720579,MATH 20B,A03,093475,Staff,3,0,36,33
1656095726602,MATH 20C,A01,083760,Briones; Jor-el Thomas Caparas,2,2,35,33
1656095726602,MATH 20C,A02,083761,Briones; Jor-el Thomas Caparas,9,1,35,26
1656095726602,MATH 20C,A03,093476,Staff,1,1,35,34
1656095726602,MATH 20C,B01,083762,Bach; Quang Tran,3,0,30,27
1656095732638,MATH 20D,A01,083765,Tran; Brian Kha,3,0,30,27
1656095732638,MATH 20D,A02,083766,Tran; Brian Kha,0,1,30,30
1656095732638,MATH 20D,A03,083767,Tran; Brian Kha,2,0,30,28
1656095738673,MATH 20E,A01,083771,Ganguly; Soumya,4,1,32,28
1656095738673,MATH 20E,A02,083772,Ganguly; Soumya,2,1,32,30
1656095738673,MATH 20E,B01,083773,Ciotti; Benjamin,14,0,35,21
1656095738673,MATH 20E,B02,083774,Ciotti; Benjamin,15,0,35,20
1656095744709,MATH 103A,A01,083777,Greenfeld; Be'Eri,3,0,36,33
1656095744709,MATH 103A,A02,083778,Greenfeld; Be'Eri,3,0,36,33
1656095744709,MATH 103A,A03,093561,Staff,4,1,36,32
1656095744709,MATH 103A,B01,083779,Greenfeld; Be'Eri,8,1,36,28
1656095744709,MATH 103A,B02,083780,Greenfeld; Be'Eri,0,1,36,36
1656095744709,MATH 103A,B03,093562,Staff,0,0,36,36
1656095750738,MATH 105,A01,085443,Carter; Anne Toulson,4,1,35,31
1656095750738,MATH 105,A02,093477,Staff,10,0,35,25
1656095756764,MATH 109,A01,083213,Ganzberger; Geoffrey Michael,1,1,34,33
1656095756764,MATH 109,A02,083214,Ganzberger; Geoffrey Michael,0,0,34,34
1656095756764,MATH 109,A03,093478,Staff,3,0,34,31
1656095756764,MATH 109,B01,083215,Ganzberger; Geoffrey Michael,3,0,32,29
1656095756764,MATH 109,B02,083216,Ganzberger; Geoffrey Michael,1,0,32,31
1656095756764,MATH 109,B03,093479,Staff,4,0,32,28
1656095762805,MATH 142A,A01,083219,Chow; Bennett,2,0,32,30
1656095762805,MATH 142A,A02,083220,Chow; Bennett,8,0,32,24
1656095762805,MATH 142A,A03,093480,Staff,5,0,32,27
1656095762805,MATH 142A,B03,093481,Staff,4,0,32,28
1656095762805,MATH 142A,B04,093558,Staff,7,0,32,25
1656095762805,MATH 142A,B05,093559,Staff,0,0,32,32
1656095768838,MATH 193A,A01,083224,Rotar; Vladimir,1,2,34,33
1656095768838,MATH 193A,A02,083225,Rotar; Vladimir,2,0,34,32
1656095768838,MATH 193A,A03,083781,Rotar; Vladimir,2,0,34,32
1656095768838,MATH 193A,A04,083782,Rotar; Vladimir,6,0,34,28
1656095768838,MATH 193A,A05,093482,Rotar; Vladimir,1,0,34,33
1656095774872,MATH 197,001,091859,McAuley; Julian John,9999,0,9999,0
1656095774872,MATH 197,002,095566,Kedlaya; Kiran S.,9997,0,9999,2
1656095774872,MATH 197,003,095567,Xiao; Ming,9999,0,9999,0
1656095774872,MATH 197,004,095571,Perols; Johan Lars,9998,0,9999,1
1656095781930,COGS 9,A01,083615,Shannon; Kyle Michael,5,1,75,70
1656095787957,COGS 11,A01,083617,Boyle; Mary E. T.,16,2,48,32
1656095793981,COGS 13,A01,083071,Bastos; Amalia Pinkusfeld,8,3,71,63
1656095800008,COGS 14A,A01,092681,Semenuks; Arturs,8,24,100,92
1656095806037,COGS 14B,A01,083073,Cheng; Tzu-Han,7,0,63,56
1656095812063,COGS 17,A01,092677,Semenuks; Arturs,13,6,81,68
1656095818092,COGS 100,A01,083619,Allen; Michael Gordon,7,4,70,63
1656095824115,COGS 101A,A01,083621,Davis; Joshua Daniel,7,3,68,61
1656095830150,COGS 101B,A01,091572,Allen; Michael Gordon,6,0,65,59
1656095836178,COGS 101C,A01,083625,Delgado; Tania,11,0,35,24
1656095842201,COGS 107A,A01,083627,Boyle; Mary E. T.,5,4,60,55
1656095848227,COGS 118A,A01,083075,Gupta; Anjum,24,16,76,52
1656095854256,CSE 3,A50,083646,Miranda; Gregory Joseph,18,0,50,32
1656095860284,CSE 8A,A50,083650,Miranda; Gregory Joseph,13,13,56,43
1656095866312,CSE 11,A01,083080,Cao; Yingjun,1,60,40,39
1656095872334,CSE 12,A01,083652,Krause-Levy; Sophia Louisa,14,8,120,106
1656095878358,CSE 15L,A01,083654,Morris; Justin Loren,5,2,50,45
1656095878358,CSE 15L,A02,083655,Morris; Justin Loren,7,2,50,43
1656095884383,CSE 20,A01,083657,Tran; Khoa Dang,31,0,80,49
1656095890413,CSE 21,A01,095574,Bach; Quang Tran,26,0,48,22
1656095896456,CSE 30,A01,083084,Eldon; John,3,11,80,77
1656095896456,CSE 30,B01,095061,Bhaskar; Nishant,4,5,50,46
1656095902483,CSE 100,A01,083659,Cao; Yingjun,2,23,70,68
1656095908510,CSE 134B,A01,083661,Powell; Thomas Allan,10,7,100,90
1656095914538,CSE 140,A01,083663,Gungor; Onat,9,0,85,76
1656095920573,CSE 140L,A01,083088,Eldon; John,8,0,100,92
1656095926599,CSE 175,A01,083665,Kumar; Rakesh,1,0,25,24
1656095932630,CSE 190,A00,092507,Dubnov; Shlomo,2,0,20,18
1656095938656,ECE 45,A01,083139,Congero; Spencer William,5,2,75,70
1656095944683,ECE 65,A50,083695,Saad; Andrew S,8,0,30,22
1656095944683,ECE 65,A51,095125,Staff,23,0,26,3
1656095950706,ECE 109,A01,091882,Touri; Behrouz,7,5,70,63
1656095956736,ECE 180,A00,083140,Abi Samra; Nicholas Camill,1,0,30,29
1656095956736,ECE 180,B00,083141,Abi Samra; Nicholas Camill,4,8,30,26
1656095962771,MATH 10A,A01,083735,Patchell; Gregory David,0,0,30,30
1656095962771,MATH 10A,A02,083736,Patchell; Gregory David,23,0,30,7
1656095962771,MATH 10A,A03,083737,Patchell; Gregory David,16,0,30,14
1656095968796,MATH 10B,A01,083207,Lim; Seonhee,3,2,34,31
1656095968796,MATH 10B,A02,083208,Lim; Seonhee,10,2,35,25
1656095968796,MATH 10B,A03,093472,Staff,4,2,34,30
1656095968796,MATH 10B,B01,083739,Sinha; Shubham,11,0,30,19
1656095974820,MATH 18,A01,083743,Cinel; Cameron Alexander,7,0,30,23
1656095974820,MATH 18,A02,083744,Cinel; Cameron Alexander,10,0,30,20
1656095974820,MATH 18,A03,083745,Cinel; Cameron Alexander,3,0,30,27
1656095974820,MATH 18,B01,083748,Ma; Zilu,0,0,36,36
1656095974820,MATH 18,B02,083749,Ma; Zilu,1,0,36,35
1656095974820,MATH 18,B03,083750,Ma; Zilu,0,0,36,36
1656095974820,MATH 18,B04,083751,Ma; Zilu,0,0,36,36
1656095974820,MATH 18,B05,093473,Staff,3,0,36,33
1656095974820,MATH 18,B06,093474,Staff,3,0,36,33
1656095980846,MATH 20A,A01,083754,Zheng; Zequn,11,0,40,29
1656095986869,MATH 20B,A01,083756,Briones; Jor-el Thomas Caparas,0,0,36,36
1656095986869,MATH 20B,A02,083757,Briones; Jor-el Thomas Caparas,1,0,36,35
1656095986869,MATH 20B,A03,093475,Staff,3,0,36,33
1656095992903,MATH 20C,A01,083760,Briones; Jor-el Thomas Caparas,2,2,35,33
1656095992903,MATH 20C,A02,083761,Briones; Jor-el Thomas Caparas,9,1,35,26
1656095992903,MATH 20C,A03,093476,Staff,1,1,35,34
1656095992903,MATH 20C,B01,083762,Bach; Quang Tran,3,0,30,27
1656095998927,MATH 20D,A01,083765,Tran; Brian Kha,3,0,30,27
1656095998927,MATH 20D,A02,083766,Tran; Brian Kha,0,1,30,30
1656095998927,MATH 20D,A03,083767,Tran; Brian Kha,2,0,30,28
1656096004957,MATH 20E,A01,083771,Ganguly; Soumya,4,1,32,28
1656096004957,MATH 20E,A02,083772,Ganguly; Soumya,2,1,32,30
1656096004957,MATH 20E,B01,083773,Ciotti; Benjamin,14,0,35,21
1656096004957,MATH 20E,B02,083774,Ciotti; Benjamin,15,0,35,20
1656096010980,MATH 103A,A01,083777,Greenfeld; Be'Eri,3,0,36,33
1656096010980,MATH 103A,A02,083778,Greenfeld; Be'Eri,2,0,36,34
1656096010980,MATH 103A,A03,093561,Staff,4,1,36,32
1656096010980,MATH 103A,B01,083779,Greenfeld; Be'Eri,8,1,36,28
1656096010980,MATH 103A,B02,083780,Greenfeld; Be'Eri,0,1,36,36
1656096010980,MATH 103A,B03,093562,Staff,0,0,36,36
1656096017007,MATH 105,A01,085443,Carter; Anne Toulson,4,1,35,31
1656096017007,MATH 105,A02,093477,Staff,10,0,35,25
1656096023033,MATH 109,A01,083213,Ganzberger; Geoffrey Michael,1,1,34,33
1656096023033,MATH 109,A02,083214,Ganzberger; Geoffrey Michael,0,0,34,34
1656096023033,MATH 109,A03,093478,Staff,3,0,34,31
1656096023033,MATH 109,B01,083215,Ganzberger; Geoffrey Michael,3,0,32,29
1656096023033,MATH 109,B02,083216,Ganzberger; Geoffrey Michael,1,0,32,31
1656096023033,MATH 109,B03,093479,Staff,4,0,32,28
1656096029069,MATH 142A,A01,083219,Chow; Bennett,1,0,32,31
1656096029069,MATH 142A,A02,083220,Chow; Bennett,8,0,32,24
1656096029069,MATH 142A,A03,093480,Staff,5,0,32,27
1656096029069,MATH 142A,B03,093481,Staff,4,0,32,28
1656096029069,MATH 142A,B04,093558,Staff,7,0,32,25
1656096029069,MATH 142A,B05,093559,Staff,0,0,32,32
1656096035097,MATH 193A,A01,083224,Rotar; Vladimir,1,2,34,33
1656096035097,MATH 193A,A02,083225,Rotar; Vladimir,2,0,34,32
1656096035097,MATH 193A,A03,083781,Rotar; Vladimir,2,0,34,32
1656096035097,MATH 193A,A04,083782,Rotar; Vladimir,6,0,34,28
1656096035097,MATH 193A,A05,093482,Rotar; Vladimir,1,0,34,33
1656096041121,MATH 197,001,091859,McAuley; Julian John,9999,0,9999,0
1656096041121,MATH 197,002,095566,Kedlaya; Kiran S.,9997,0,9999,2
1656096041121,MATH 197,003,095567,Xiao; Ming,9999,0,9999,0
1656096041121,MATH 197,004,095571,Perols; Johan Lars,9998,0,9999,1
1656096048181,COGS 9,A01,083615,Shannon; Kyle Michael,5,1,75,70
1656096054209,COGS 11,A01,083617,Boyle; Mary E. T.,16,2,48,32
1656096060244,COGS 13,A01,083071,Bastos; Amalia Pinkusfeld,8,3,71,63
1656096066267,COGS 14A,A01,092681,Semenuks; Arturs,8,24,100,92
1656096072289,COGS 14B,A01,083073,Cheng; Tzu-Han,7,0,63,56
1656096078311,COGS 17,A01,092677,Semenuks; Arturs,13,6,81,68
1656096084347,COGS 100,A01,083619,Allen; Michael Gordon,7,4,70,63
1656096090370,COGS 101A,A01,083621,Davis; Joshua Daniel,7,3,68,61
1656096096396,COGS 101B,A01,091572,Allen; Michael Gordon,6,0,65,59
1656096102422,COGS 101C,A01,083625,Delgado; Tania,11,0,35,24
1656096108446,COGS 107A,A01,083627,Boyle; Mary E. T.,5,4,60,55
1656096114471,COGS 118A,A01,083075,Gupta; Anjum,24,16,76,52
1656096120500,CSE 3,A50,083646,Miranda; Gregory Joseph,18,0,50,32
1656096126527,CSE 8A,A50,083650,Miranda; Gregory Joseph,13,13,56,43
1656096132558,CSE 11,A01,083080,Cao; Yingjun,1,60,40,39
1656096138585,CSE 12,A01,083652,Krause-Levy; Sophia Louisa,14,8,120,106
1656096144620,CSE 15L,A01,083654,Morris; Justin Loren,5,2,50,45
1656096144620,CSE 15L,A02,083655,Morris; Justin Loren,7,2,50,43
1656096150642,CSE 20,A01,083657,Tran; Khoa Dang,31,0,80,49
1656096156669,CSE 21,A01,095574,Bach; Quang Tran,26,0,48,22
1656096162766,CSE 30,A01,083084,Eldon; John,3,11,80,77
1656096162766,CSE 30,B01,095061,Bhaskar; Nishant,4,5,50,46
1656096168790,CSE 100,A01,083659,Cao; Yingjun,2,23,70,68
1656096174812,CSE 134B,A01,083661,Powell; Thomas Allan,10,7,100,90
1656096180834,CSE 140,A01,083663,Gungor; Onat,9,0,85,76
1656096186873,CSE 140L,A01,083088,Eldon; John,8,0,100,92
1656096192896,CSE 175,A01,083665,Kumar; Rakesh,1,0,25,24
1656096198919,CSE 190,A00,092507,Dubnov; Shlomo,2,0,20,18
1656096204946,ECE 45,A01,083139,Congero; Spencer William,5,2,75,70
1656096210969,ECE 65,A50,083695,Saad; Andrew S,8,0,30,22
1656096210969,ECE 65,A51,095125,Staff,23,0,26,3
1656096216993,ECE 109,A01,091882,Touri; Behrouz,7,5,70,63
1656096223019,ECE 180,A00,083140,Abi Samra; Nicholas Camill,1,0,30,29
1656096223019,ECE 180,B00,083141,Abi Samra; Nicholas Camill,4,8,30,26
1656096229045,MATH 10A,A01,083735,Patchell; Gregory David,0,0,30,30
1656096229045,MATH 10A,A02,083736,Patchell; Gregory David,23,0,30,7
1656096229045,MATH 10A,A03,083737,Patchell; Gregory David,16,0,30,14
1656096235070,MATH 10B,A01,083207,Lim; Seonhee,3,2,34,31
1656096235070,MATH 10B,A02,083208,Lim; Seonhee,10,2,35,25
1656096235070,MATH 10B,A03,093472,Staff,4,2,34,30
1656096235070,MATH 10B,B01,083739,Sinha; Shubham,11,0,30,19
1656096241103,MATH 18,A01,083743,Cinel; Cameron Alexander,7,0,30,23
1656096241103,MATH 18,A02,083744,Cinel; Cameron Alexander,10,0,30,20
1656096241103,MATH 18,A03,083745,Cinel; Cameron Alexander,3,0,30,27
1656096241103,MATH 18,B01,083748,Ma; Zilu,0,0,36,36
1656096241103,MATH 18,B02,083749,Ma; Zilu,1,0,36,35
1656096241103,MATH 18,B03,083750,Ma; Zilu,0,0,36,36
1656096241103,MATH 18,B04,083751,Ma; Zilu,0,0,36,36
1656096241103,MATH 18,B05,093473,Staff,3,0,36,33
1656096241103,MATH 18,B06,093474,Staff,3,0,36,33
1656096247127,MATH 20A,A01,083754,Zheng; Zequn,11,0,40,29
1656096253148,MATH 20B,A01,083756,Briones; Jor-el Thomas Caparas,0,0,36,36
1656096253148,MATH 20B,A02,083757,Briones; Jor-el Thomas Caparas,1,0,36,35
1656096253148,MATH 20B,A03,093475,Staff,3,0,36,33
1656096259193,MATH 20C,A01,083760,Briones; Jor-el Thomas Caparas,2,2,35,33
1656096259193,MATH 20C,A02,083761,Briones; Jor-el Thomas Caparas,9,1,35,26
1656096259193,MATH 20C,A03,093476,Staff,1,1,35,34
1656096259193,MATH 20C,B01,083762,Bach; Quang Tran,3,0,30,27
1656096265229,MATH 20D,A01,083765,Tran; Brian Kha,3,0,30,27
1656096265229,MATH 20D,A02,083766,Tran; Brian Kha,0,1,30,30
1656096265229,MATH 20D,A03,083767,Tran; Brian Kha,2,0,30,28
1656096271265,MATH 20E,A01,083771,Ganguly; Soumya,4,1,32,28
1656096271265,MATH 20E,A02,083772,Ganguly; Soumya,2,1,32,30
1656096271265,MATH 20E,B01,083773,Ciotti; Benjamin,14,0,35,21
1656096271265,MATH 20E,B02,083774,Ciotti; Benjamin,15,0,35,20
1656096277294,MATH 103A,A01,083777,Greenfeld; Be'Eri,3,0,36,33
1656096277294,MATH 103A,A02,083778,Greenfeld; Be'Eri,2,0,36,34
1656096277294,MATH 103A,A03,093561,Staff,4,1,36,32
1656096277294,MATH 103A,B01,083779,Greenfeld; Be'Eri,8,1,36,28
1656096277294,MATH 103A,B02,083780,Greenfeld; Be'Eri,0,1,36,36
1656096277294,MATH 103A,B03,093562,Staff,0,0,36,36
1656096283321,MATH 105,A01,085443,Carter; Anne Toulson,4,1,35,31
1656096283321,MATH 105,A02,093477,Staff,10,0,35,25
1656096289357,MATH 109,A01,083213,Ganzberger; Geoffrey Michael,1,1,34,33
1656096289357,MATH 109,A02,083214,Ganzberger; Geoffrey Michael,0,0,34,34
1656096289357,MATH 109,A03,093478,Staff,3,0,34,31
1656096289357,MATH 109,B01,083215,Ganzberger; Geoffrey Michael,3,0,32,29
1656096289357,MATH 109,B02,083216,Ganzberger; Geoffrey Michael,1,0,32,31
1656096289357,MATH 109,B03,093479,Staff,4,0,32,28
1656096295386,MATH 142A,A01,083219,Chow; Bennett,1,0,32,31
1656096295386,MATH 142A,A02,083220,Chow; Bennett,8,0,32,24
1656096295386,MATH 142A,A03,093480,Staff,5,0,32,27
1656096295386,MATH 142A,B03,093481,Staff,4,0,32,28
1656096295386,MATH 142A,B04,093558,Staff,7,0,32,25
1656096295386,MATH 142A,B05,093559,Staff,0,0,32,32
1656096301419,MATH 193A,A01,083224,Rotar; Vladimir,1,2,34,33
1656096301419,MATH 193A,A02,083225,Rotar; Vladimir,2,0,34,32
1656096301419,MATH 193A,A03,083781,Rotar; Vladimir,2,0,34,32
1656096301419,MATH 193A,A04,083782,Rotar; Vladimir,6,0,34,28
1656096301419,MATH 193A,A05,093482,Rotar; Vladimir,1,0,34,33
1656096307444,MATH 197,001,091859,McAuley; Julian John,9999,0,9999,0
1656096307444,MATH 197,002,095566,Kedlaya; Kiran S.,9997,0,9999,2
1656096307444,MATH 197,003,095567,Xiao; Ming,9999,0,9999,0
1656096307444,MATH 197,004,095571,Perols; Johan Lars,9998,0,9999,1
1656096314499,COGS 9,A01,083615,Shannon; Kyle Michael,5,1,75,70
1656096320526,COGS 11,A01,083617,Boyle; Mary E. T.,16,2,48,32
1656096326565,COGS 13,A01,083071,Bastos; Amalia Pinkusfeld,8,3,71,63
1656096333195,COGS 14A,A01,092681,Semenuks; Arturs,8,24,100,92
1656096339222,COGS 14B,A01,083073,Cheng; Tzu-Han,7,0,63,56
1656096345251,COGS 17,A01,092677,Semenuks; Arturs,13,6,81,68
1656096351275,COGS 100,A01,083619,Allen; Michael Gordon,7,4,70,63
1656096357299,COGS 101A,A01,083621,Davis; Joshua Daniel,7,3,68,61
1656096363322,COGS 101B,A01,091572,Allen; Michael Gordon,6,0,65,59
1656096369346,COGS 101C,A01,083625,Delgado; Tania,11,0,35,24
1656096375370,COGS 107A,A01,083627,Boyle; Mary E. T.,5,4,60,55
1656096381395,COGS 118A,A01,083075,Gupta; Anjum,24,16,76,52
1656096387419,CSE 3,A50,083646,Miranda; Gregory Joseph,18,0,50,32
1656096393443,CSE 8A,A50,083650,Miranda; Gregory Joseph,13,13,56,43
1656096399470,CSE 11,A01,083080,Cao; Yingjun,1,60,40,39
1656096405494,CSE 12,A01,083652,Krause-Levy; Sophia Louisa,14,8,120,106
1656096411524,CSE 15L,A01,083654,Morris; Justin Loren,5,2,50,45
1656096411524,CSE 15L,A02,083655,Morris; Justin Loren,7,2,50,43
1656096417564,CSE 20,A01,083657,Tran; Khoa Dang,31,0,80,49
1656096423587,CSE 21,A01,095574,Bach; Quang Tran,26,0,48,22
1656096429615,CSE 30,A01,083084,Eldon; John,3,11,80,77
1656096429615,CSE 30,B01,095061,Bhaskar; Nishant,4,5,50,46
1656096435642,CSE 100,A01,083659,Cao; Yingjun,2,23,70,68
1656096441675,CSE 134B,A01,083661,Powell; Thomas Allan,10,7,100,90
1656096447700,CSE 140,A01,083663,Gungor; Onat,9,0,85,76
1656096453728,CSE 140L,A01,083088,Eldon; John,8,0,100,92
1656096459750,CSE 175,A01,083665,Kumar; Rakesh,1,0,25,24
1656096465773,CSE 190,A00,092507,Dubnov; Shlomo,2,0,20,18
1656096471796,ECE 45,A01,083139,Congero; Spencer William,5,2,75,70
1656096477822,ECE 65,A50,083695,Saad; Andrew S,8,0,30,22
1656096477822,ECE 65,A51,095125,Staff,23,0,26,3
1656096483848,ECE 109,A01,091882,Touri; Behrouz,7,5,70,63
1656096489873,ECE 180,A00,083140,Abi Samra; Nicholas Camill,1,0,30,29
1656096489873,ECE 180,B00,083141,Abi Samra; Nicholas Camill,4,8,30,26
1656096495898,MATH 10A,A01,083735,Patchell; Gregory David,0,0,30,30
1656096495898,MATH 10A,A02,083736,Patchell; Gregory David,23,0,30,7
1656096495898,MATH 10A,A03,083737,Patchell; Gregory David,16,0,30,14
1656096501922,MATH 10B,A01,083207,Lim; Seonhee,3,2,34,31
1656096501922,MATH 10B,A02,083208,Lim; Seonhee,10,2,35,25
1656096501922,MATH 10B,A03,093472,Staff,4,2,34,30
1656096501922,MATH 10B,B01,083739,Sinha; Shubham,11,0,30,19
1656096507953,MATH 18,A01,083743,Cinel; Cameron Alexander,7,0,30,23
1656096507953,MATH 18,A02,083744,Cinel; Cameron Alexander,10,0,30,20
1656096507953,MATH 18,A03,083745,Cinel; Cameron Alexander,3,0,30,27
1656096507953,MATH 18,B01,083748,Ma; Zilu,0,0,36,36
1656096507953,MATH 18,B02,083749,Ma; Zilu,0,0,36,36
1656096507953,MATH 18,B03,083750,Ma; Zilu,0,0,36,36
1656096507953,MATH 18,B04,083751,Ma; Zilu,0,0,36,36
1656096507953,MATH 18,B05,093473,Staff,3,0,36,33
1656096507953,MATH 18,B06,093474,Staff,3,0,36,33
1656096513976,MATH 20A,A01,083754,Zheng; Zequn,11,0,40,29
1656096520022,MATH 20B,A01,083756,Briones; Jor-el Thomas Caparas,0,0,36,36
1656096520022,MATH 20B,A02,083757,Briones; Jor-el Thomas Caparas,1,0,36,35
1656096520022,MATH 20B,A03,093475,Staff,3,0,36,33
1656096526046,MATH 20C,A01,083760,Briones; Jor-el Thomas Caparas,2,2,35,33
1656096526046,MATH 20C,A02,083761,Briones; Jor-el Thomas Caparas,9,1,35,26
1656096526046,MATH 20C,A03,093476,Staff,1,1,35,34
1656096526046,MATH 20C,B01,083762,Bach; Quang Tran,3,0,30,27
1656096532083,MATH 20D,A01,083765,Tran; Brian Kha,3,0,30,27
1656096532083,MATH 20D,A02,083766,Tran; Brian Kha,0,1,30,30
1656096532083,MATH 20D,A03,083767,Tran; Brian Kha,2,0,30,28
1656096538107,MATH 20E,A01,083771,Ganguly; Soumya,4,1,32,28
1656096538107,MATH 20E,A02,083772,Ganguly; Soumya,2,1,32,30
1656096538107,MATH 20E,B01,083773,Ciotti; Benjamin,14,0,35,21
1656096538107,MATH 20E,B02,083774,Ciotti; Benjamin,15,0,35,20
1656096544131,MATH 103A,A01,083777,Greenfeld; Be'Eri,3,0,36,33
1656096544131,MATH 103A,A02,083778,Greenfeld; Be'Eri,2,0,36,34
1656096544131,MATH 103A,A03,093561,Staff,4,1,36,32
1656096544131,MATH 103A,B01,083779,Greenfeld; Be'Eri,8,1,36,28
1656096544131,MATH 103A,B02,083780,Greenfeld; Be'Eri,0,1,36,36
1656096544131,MATH 103A,B03,093562,Staff,0,0,36,36
1656096550167,MATH 105,A01,085443,Carter; Anne Toulson,4,1,35,31
1656096550167,MATH 105,A02,093477,Staff,10,0,35,25
1656096556197,MATH 109,A01,083213,Ganzberger; Geoffrey Michael,1,1,34,33
1656096556197,MATH 109,A02,083214,Ganzberger; Geoffrey Michael,0,0,34,34
1656096556197,MATH 109,A03,093478,Staff,3,0,34,31
1656096556197,MATH 109,B01,083215,Ganzberger; Geoffrey Michael,3,0,32,29
1656096556197,MATH 109,B02,083216,Ganzberger; Geoffrey Michael,1,0,32,31
1656096556197,MATH 109,B03,093479,Staff,4,0,32,28
1656096562220,MATH 142A,A01,083219,Chow; Bennett,1,0,32,31
1656096562220,MATH 142A,A02,083220,Chow; Bennett,8,0,32,24
1656096562220,MATH 142A,A03,093480,Staff,5,0,32,27
1656096562220,MATH 142A,B03,093481,Staff,4,0,32,28
1656096562220,MATH 142A,B04,093558,Staff,7,0,32,25
1656096562220,MATH 142A,B05,093559,Staff,0,0,32,32
1656096568244,MATH 193A,A01,083224,Rotar; Vladimir,1,2,34,33
1656096568244,MATH 193A,A02,083225,Rotar; Vladimir,2,0,34,32
1656096568244,MATH 193A,A03,083781,Rotar; Vladimir,2,0,34,32
1656096568244,MATH 193A,A04,083782,Rotar; Vladimir,6,0,34,28
1656096568244,MATH 193A,A05,093482,Rotar; Vladimir,1,0,34,33
1656096574271,MATH 197,001,091859,McAuley; Julian John,9999,0,9999,0
1656096574271,MATH 197,002,095566,Kedlaya; Kiran S.,9997,0,9999,2
1656096574271,MATH 197,003,095567,Xiao; Ming,9999,0,9999,0
1656096574271,MATH 197,004,095571,Perols; Johan Lars,9998,0,9999,1
1656096581325,COGS 9,A01,083615,Shannon; Kyle Michael,5,1,75,70
1656096587353,COGS 11,A01,083617,Boyle; Mary E. T.,16,2,48,32
1656096593376,COGS 13,A01,083071,Bastos; Amalia Pinkusfeld,8,3,71,63
1656096599402,COGS 14A,A01,092681,Semenuks; Arturs,8,24,100,92
1656096605432,COGS 14B,A01,083073,Cheng; Tzu-Han,7,0,63,56
1656096611455,COGS 17,A01,092677,Semenuks; Arturs,13,6,81,68
1656096617479,COGS 100,A01,083619,Allen; Michael Gordon,7,4,70,63
1656096623506,COGS 101A,A01,083621,Davis; Joshua Daniel,7,3,68,61
1656096629534,COGS 101B,A01,091572,Allen; Michael Gordon,6,0,65,59
1656096635558,COGS 101C,A01,083625,Delgado; Tania,11,0,35,24
1656096641582,COGS 107A,A01,083627,Boyle; Mary E. T.,5,4,60,55
1656096647605,COGS 118A,A01,083075,Gupta; Anjum,24,16,76,52
1656096653629,CSE 3,A50,083646,Miranda; Gregory Joseph,18,0,50,32
1656096659651,CSE 8A,A50,083650,Miranda; Gregory Joseph,13,13,56,43
1656096665674,CSE 11,A01,083080,Cao; Yingjun,1,60,40,39
1656096671697,CSE 12,A01,083652,Krause-Levy; Sophia Louisa,14,8,120,106
1656096677721,CSE 15L,A01,083654,Morris; Justin Loren,5,2,50,45
1656096677721,CSE 15L,A02,083655,Morris; Justin Loren,7,2,50,43
1656096683749,CSE 20,A01,083657,Tran; Khoa Dang,31,0,80,49
1656096689772,CSE 21,A01,095574,Bach; Quang Tran,26,0,48,22
1656096695798,CSE 30,A01,083084,Eldon; John,3,11,80,77
1656096695798,CSE 30,B01,095061,Bhaskar; Nishant,4,5,50,46
1656096701825,CSE 100,A01,083659,Cao; Yingjun,2,23,70,68
1656096707848,CSE 134B,A01,083661,Powell; Thomas Allan,10,7,100,90
1656096713884,CSE 140,A01,083663,Gungor; Onat,9,0,85,76
1656096719906,CSE 140L,A01,083088,Eldon; John,8,0,100,92
1656096725931,CSE 175,A01,083665,Kumar; Rakesh,1,0,25,24
1656096731963,CSE 190,A00,092507,Dubnov; Shlomo,2,0,20,18
1656096737986,ECE 45,A01,083139,Congero; Spencer William,5,2,75,70
1656096744011,ECE 65,A50,083695,Saad; Andrew S,8,0,30,22
1656096744011,ECE 65,A51,095125,Staff,23,0,26,3
1656096750037,ECE 109,A01,091882,Touri; Behrouz,7,5,70,63
1656096756063,ECE 180,A00,083140,Abi Samra; Nicholas Camill,1,0,30,29
1656096756063,ECE 180,B00,083141,Abi Samra; Nicholas Camill,4,8,30,26
1656096762169,MATH 10A,A01,083735,Patchell; Gregory David,0,0,30,30
1656096762169,MATH 10A,A02,083736,Patchell; Gregory David,22,0,30,8
1656096762169,MATH 10A,A03,083737,Patchell; Gregory David,16,0,30,14
1656096768193,MATH 10B,A01,083207,Lim; Seonhee,3,2,34,31
1656096768193,MATH 10B,A02,083208,Lim; Seonhee,10,2,35,25
1656096768193,MATH 10B,A03,093472,Staff,4,2,34,30
1656096768193,MATH 10B,B01,083739,Sinha; Shubham,11,0,30,19
1656096774223,MATH 18,A01,083743,Cinel; Cameron Alexander,7,0,30,23
1656096774223,MATH 18,A02,083744,Cinel; Cameron Alexander,10,0,30,20
1656096774223,MATH 18,A03,083745,Cinel; Cameron Alexander,3,0,30,27
1656096774223,MATH 18,B01,083748,Ma; Zilu,0,0,36,36
1656096774223,MATH 18,B02,083749,Ma; Zilu,0,0,36,36
1656096774223,MATH 18,B03,083750,Ma; Zilu,0,0,36,36
1656096774223,MATH 18,B04,083751,Ma; Zilu,0,0,36,36
1656096774223,MATH 18,B05,093473,Staff,3,0,36,33
1656096774223,MATH 18,B06,093474,Staff,3,0,36,33
1656096780253,MATH 20A,A01,083754,Zheng; Zequn,11,0,40,29
1656096786278,MATH 20B,A01,083756,Briones; Jor-el Thomas Caparas,0,0,36,36
1656096786278,MATH 20B,A02,083757,Briones; Jor-el Thomas Caparas,1,0,36,35
1656096786278,MATH 20B,A03,093475,Staff,3,0,36,33
1656096792309,MATH 20C,A01,083760,Briones; Jor-el Thomas Caparas,2,2,35,33
1656096792309,MATH 20C,A02,083761,Briones; Jor-el Thomas Caparas,9,1,35,26
1656096792309,MATH 20C,A03,093476,Staff,1,1,35,34
1656096792309,MATH 20C,B01,083762,Bach; Quang Tran,3,0,30,27
1656096798330,MATH 20D,A01,083765,Tran; Brian Kha,3,0,30,27
1656096798330,MATH 20D,A02,083766,Tran; Brian Kha,0,1,30,30
1656096798330,MATH 20D,A03,083767,Tran; Brian Kha,2,0,30,28
1656096804356,MATH 20E,A01,083771,Ganguly; Soumya,4,1,32,28
1656096804356,MATH 20E,A02,083772,Ganguly; Soumya,2,1,32,30
1656096804356,MATH 20E,B01,083773,Ciotti; Benjamin,14,0,35,21
1656096804356,MATH 20E,B02,083774,Ciotti; Benjamin,15,0,35,20
1656096810380,MATH 103A,A01,083777,Greenfeld; Be'Eri,3,0,36,33
1656096810380,MATH 103A,A02,083778,Greenfeld; Be'Eri,2,0,36,34
1656096810380,MATH 103A,A03,093561,Staff,4,1,36,32
1656096810380,MATH 103A,B01,083779,Greenfeld; Be'Eri,8,1,36,28
1656096810380,MATH 103A,B02,083780,Greenfeld; Be'Eri,0,1,36,36
1656096810380,MATH 103A,B03,093562,Staff,0,0,36,36
1656096816408,MATH 105,A01,085443,Carter; Anne Toulson,4,1,35,31
1656096816408,MATH 105,A02,093477,Staff,10,0,35,25
1656096822431,MATH 109,A01,083213,Ganzberger; Geoffrey Michael,1,1,34,33
1656096822431,MATH 109,A02,083214,Ganzberger; Geoffrey Michael,0,0,34,34
1656096822431,MATH 109,A03,093478,Staff,3,0,34,31
1656096822431,MATH 109,B01,083215,Ganzberger; Geoffrey Michael,3,0,32,29
1656096822431,MATH 109,B02,083216,Ganzberger; Geoffrey Michael,1,0,32,31
1656096822431,MATH 109,B03,093479,Staff,4,0,32,28
1656096828455,MATH 142A,A01,083219,Chow; Bennett,1,0,32,31
1656096828455,MATH 142A,A02,083220,Chow; Bennett,8,0,32,24
1656096828455,MATH 142A,A03,093480,Staff,5,0,32,27
1656096828455,MATH 142A,B03,093481,Staff,4,0,32,28
1656096828455,MATH 142A,B04,093558,Staff,7,0,32,25
1656096828455,MATH 142A,B05,093559,Staff,0,0,32,32
1656096834491,MATH 193A,A01,083224,Rotar; Vladimir,1,2,34,33
1656096834491,MATH 193A,A02,083225,Rotar; Vladimir,2,0,34,32
1656096834491,MATH 193A,A03,083781,Rotar; Vladimir,2,0,34,32
1656096834491,MATH 193A,A04,083782,Rotar; Vladimir,6,0,34,28
1656096834491,MATH 193A,A05,093482,Rotar; Vladimir,1,0,34,33
1656096840515,MATH 197,001,091859,McAuley; Julian John,9999,0,9999,0
1656096840515,MATH 197,002,095566,Kedlaya; Kiran S.,9997,0,9999,2
1656096840515,MATH 197,003,095567,Xiao; Ming,9999,0,9999,0
1656096840515,MATH 197,004,095571,Perols; Johan Lars,9998,0,9999,1
1656096847599,COGS 9,A01,083615,Shannon; Kyle Michael,5,1,75,70
1656096853620,COGS 11,A01,083617,Boyle; Mary E. T.,16,2,48,32
1656096859646,COGS 13,A01,083071,Bastos; Amalia Pinkusfeld,8,3,71,63
1656096865673,COGS 14A,A01,092681,Semenuks; Arturs,8,24,100,92
1656096871695,COGS 14B,A01,083073,Cheng; Tzu-Han,7,0,63,56
1656096877721,COGS 17,A01,092677,Semenuks; Arturs,13,6,81,68
1656096883749,COGS 100,A01,083619,Allen; Michael Gordon,7,4,70,63
1656096889777,COGS 101A,A01,083621,Davis; Joshua Daniel,7,3,68,61
1656096895804,COGS 101B,A01,091572,Allen; Michael Gordon,6,0,65,59
1656096901828,COGS 101C,A01,083625,Delgado; Tania,11,0,35,24
1656096907859,COGS 107A,A01,083627,Boyle; Mary E. T.,5,4,60,55
1656096913886,COGS 118A,A01,083075,Gupta; Anjum,24,16,76,52
1656096919914,CSE 3,A50,083646,Miranda; Gregory Joseph,18,0,50,32
1656096925939,CSE 8A,A50,083650,Miranda; Gregory Joseph,13,13,56,43
1656096931980,CSE 11,A01,083080,Cao; Yingjun,1,60,40,39
1656096938005,CSE 12,A01,083652,Krause-Levy; Sophia Louisa,14,8,120,106
1656096944031,CSE 15L,A01,083654,Morris; Justin Loren,5,2,50,45
1656096944031,CSE 15L,A02,083655,Morris; Justin Loren,7,2,50,43
1656096950059,CSE 20,A01,083657,Tran; Khoa Dang,31,0,80,49
1656096956085,CSE 21,A01,095574,Bach; Quang Tran,26,0,48,22
1656096962116,CSE 30,A01,083084,Eldon; John,3,11,80,77
1656096962116,CSE 30,B01,095061,Bhaskar; Nishant,4,5,50,46
1656096968139,CSE 100,A01,083659,Cao; Yingjun,2,23,70,68
1656096974169,CSE 134B,A01,083661,Powell; Thomas Allan,10,7,100,90
1656096980192,CSE 140,A01,083663,Gungor; Onat,9,0,85,76
1656096986218,CSE 140L,A01,083088,Eldon; John,8,0,100,92
1656096992240,CSE 175,A01,083665,Kumar; Rakesh,1,0,25,24
1656096998270,CSE 190,A00,092507,Dubnov; Shlomo,2,0,20,18
1656097004297,ECE 45,A01,083139,Congero; Spencer William,5,2,75,70
1656097010324,ECE 65,A50,083695,Saad; Andrew S,8,0,30,22
1656097010324,ECE 65,A51,095125,Staff,23,0,26,3
1656097016352,ECE 109,A01,091882,Touri; Behrouz,7,5,70,63
1656097022389,ECE 180,A00,083140,Abi Samra; Nicholas Camill,1,0,30,29
1656097022389,ECE 180,B00,083141,Abi Samra; Nicholas Camill,4,8,30,26
1656097028415,MATH 10A,A01,083735,Patchell; Gregory David,0,0,30,30
1656097028415,MATH 10A,A02,083736,Patchell; Gregory David,22,0,30,8
1656097028415,MATH 10A,A03,083737,Patchell; Gregory David,16,0,30,14
1656097034439,MATH 10B,A01,083207,Lim; Seonhee,3,2,34,31
1656097034439,MATH 10B,A02,083208,Lim; Seonhee,10,2,35,25
1656097034439,MATH 10B,A03,093472,Staff,4,2,34,30
1656097034439,MATH 10B,B01,083739,Sinha; Shubham,11,0,30,19
1656097040473,MATH 18,A01,083743,Cinel; Cameron Alexander,7,0,30,23
1656097040473,MATH 18,A02,083744,Cinel; Cameron Alexander,10,0,30,20
1656097040473,MATH 18,A03,083745,Cinel; Cameron Alexander,3,0,30,27
1656097040473,MATH 18,B01,083748,Ma; Zilu,0,0,36,36
1656097040473,MATH 18,B02,083749,Ma; Zilu,0,0,36,36
1656097040473,MATH 18,B03,083750,Ma; Zilu,0,0,36,36
1656097040473,MATH 18,B04,083751,Ma; Zilu,0,0,36,36
1656097040473,MATH 18,B05,093473,Staff,3,0,36,33
1656097040473,MATH 18,B06,093474,Staff,3,0,36,33
1656097046497,MATH 20A,A01,083754,Zheng; Zequn,11,0,40,29
1656097052532,MATH 20B,A01,083756,Briones; Jor-el Thomas Caparas,0,0,36,36
1656097052532,MATH 20B,A02,083757,Briones; Jor-el Thomas Caparas,1,0,36,35
1656097052532,MATH 20B,A03,093475,Staff,3,0,36,33
1656097058556,MATH 20C,A01,083760,Briones; Jor-el Thomas Caparas,2,2,35,33
1656097058556,MATH 20C,A02,083761,Briones; Jor-el Thomas Caparas,9,1,35,26
1656097058556,MATH 20C,A03,093476,Staff,1,1,35,34
1656097058556,MATH 20C,B01,083762,Bach; Quang Tran,3,0,30,27
1656097064588,MATH 20D,A01,083765,Tran; Brian Kha,3,0,30,27
1656097064588,MATH 20D,A02,083766,Tran; Brian Kha,0,1,30,30
1656097064588,MATH 20D,A03,083767,Tran; Brian Kha,2,0,30,28
1656097070611,MATH 20E,A01,083771,Ganguly; Soumya,4,1,32,28
1656097070611,MATH 20E,A02,083772,Ganguly; Soumya,2,1,32,30
1656097070611,MATH 20E,B01,083773,Ciotti; Benjamin,14,0,35,21
1656097070611,MATH 20E,B02,083774,Ciotti; Benjamin,15,0,35,20
1656097076642,MATH 103A,A01,083777,Greenfeld; Be'Eri,3,0,36,33
1656097076642,MATH 103A,A02,083778,Greenfeld; Be'Eri,2,0,36,34
1656097076642,MATH 103A,A03,093561,Staff,4,1,36,32
1656097076642,MATH 103A,B01,083779,Greenfeld; Be'Eri,8,1,36,28
1656097076642,MATH 103A,B02,083780,Greenfeld; Be'Eri,0,1,36,36
1656097076642,MATH 103A,B03,093562,Staff,0,0,36,36
1656097082668,MATH 105,A01,085443,Carter; Anne Toulson,4,1,35,31
1656097082668,MATH 105,A02,093477,Staff,10,0,35,25
1656097088699,MATH 109,A01,083213,Ganzberger; Geoffrey Michael,1,1,34,33
1656097088699,MATH 109,A02,083214,Ganzberger; Geoffrey Michael,0,0,34,34
1656097088699,MATH 109,A03,093478,Staff,3,0,34,31
1656097088699,MATH 109,B01,083215,Ganzberger; Geoffrey Michael,3,0,32,29
1656097088699,MATH 109,B02,083216,Ganzberger; Geoffrey Michael,1,0,32,31
1656097088699,MATH 109,B03,093479,Staff,4,0,32,28
1656097094724,MATH 142A,A01,083219,Chow; Bennett,1,0,32,31
1656097094724,MATH 142A,A02,083220,Chow; Bennett,8,0,32,24
1656097094724,MATH 142A,A03,093480,Staff,5,0,32,27
1656097094724,MATH 142A,B03,093481,Staff,4,0,32,28
1656097094724,MATH 142A,B04,093558,Staff,7,0,32,25
1656097094724,MATH 142A,B05,093559,Staff,0,0,32,32
1656097100755,MATH 193A,A01,083224,Rotar; Vladimir,1,2,34,33
1656097100755,MATH 193A,A02,083225,Rotar; Vladimir,2,0,34,32
1656097100755,MATH 193A,A03,083781,Rotar; Vladimir,2,0,34,32
1656097100755,MATH 193A,A04,083782,Rotar; Vladimir,6,0,34,28
1656097100755,MATH 193A,A05,093482,Rotar; Vladimir,1,0,34,33
1656097106784,MATH 197,001,091859,McAuley; Julian John,9999,0,9999,0
1656097106784,MATH 197,002,095566,Kedlaya; Kiran S.,9997,0,9999,2
1656097106784,MATH 197,003,095567,Xiao; Ming,9999,0,9999,0
1656097106784,MATH 197,004,095571,Perols; Johan Lars,9998,0,9999,1
1656097113848,COGS 9,A01,083615,Shannon; Kyle Michael,5,1,75,70
1656097119873,COGS 11,A01,083617,Boyle; Mary E. T.,16,2,48,32
1656097125910,COGS 13,A01,083071,Bastos; Amalia Pinkusfeld,8,3,71,63
1656097131938,COGS 14A,A01,092681,Semenuks; Arturs,8,24,100,92
1656097137974,COGS 14B,A01,083073,Cheng; Tzu-Han,7,0,63,56
1656097143998,COGS 17,A01,092677,Semenuks; Arturs,13,6,81,68
1656097150026,COGS 100,A01,083619,Allen; Michael Gordon,7,4,70,63
1656097156050,COGS 101A,A01,083621,Davis; Joshua Daniel,7,3,68,61
1656097162073,COGS 101B,A01,091572,Allen; Michael Gordon,6,0,65,59
1656097168101,COGS 101C,A01,083625,Delgado; Tania,11,0,35,24
1656097174127,COGS 107A,A01,083627,Boyle; Mary E. T.,5,4,60,55
1656097180152,COGS 118A,A01,083075,Gupta; Anjum,24,16,76,52
1656097186191,CSE 3,A50,083646,Miranda; Gregory Joseph,18,0,50,32
1656097192214,CSE 8A,A50,083650,Miranda; Gregory Joseph,13,13,56,43
1656097198253,CSE 11,A01,083080,Cao; Yingjun,1,60,40,39
1656097204287,CSE 12,A01,083652,Krause-Levy; Sophia Louisa,14,8,120,106
1656097210313,CSE 15L,A01,083654,Morris; Justin Loren,5,2,50,45
1656097210313,CSE 15L,A02,083655,Morris; Justin Loren,7,2,50,43
1656097216340,CSE 20,A01,083657,Tran; Khoa Dang,31,0,80,49
1656097222384,CSE 21,A01,095574,Bach; Quang Tran,26,0,48,22
1656097228409,CSE 30,A01,083084,Eldon; John,3,11,80,77
1656097228409,CSE 30,B01,095061,Bhaskar; Nishant,4,5,50,46
1656097234434,CSE 100,A01,083659,Cao; Yingjun,2,23,70,68
1656097240460,CSE 134B,A01,083661,Powell; Thomas Allan,10,7,100,90
1656097246485,CSE 140,A01,083663,Gungor; Onat,9,0,85,76
1656097252511,CSE 140L,A01,083088,Eldon; John,8,0,100,92
1656097258534,CSE 175,A01,083665,Kumar; Rakesh,1,0,25,24
1656097264558,CSE 190,A00,092507,Dubnov; Shlomo,2,0,20,18
1656097270599,ECE 45,A01,083139,Congero; Spencer William,5,2,75,70
1656097276621,ECE 65,A50,083695,Saad; Andrew S,8,0,30,22
1656097276621,ECE 65,A51,095125,Staff,23,0,26,3
1656097282649,ECE 109,A01,091882,Touri; Behrouz,7,5,70,63
1656097288674,ECE 180,A00,083140,Abi Samra; Nicholas Camill,1,0,30,29
1656097288674,ECE 180,B00,083141,Abi Samra; Nicholas Camill,4,8,30,26
1656097294697,MATH 10A,A01,083735,Patchell; Gregory David,0,0,30,30
1656097294697,MATH 10A,A02,083736,Patchell; Gregory David,22,0,30,8
1656097294697,MATH 10A,A03,083737,Patchell; Gregory David,16,0,30,14
1656097300721,MATH 10B,A01,083207,Lim; Seonhee,3,2,34,31
1656097300721,MATH 10B,A02,083208,Lim; Seonhee,10,2,35,25
1656097300721,MATH 10B,A03,093472,Staff,4,2,34,30
1656097300721,MATH 10B,B01,083739,Sinha; Shubham,12,0,30,18
1656097306754,MATH 18,A01,083743,Cinel; Cameron Alexander,7,0,30,23
1656097306754,MATH 18,A02,083744,Cinel; Cameron Alexander,10,0,30,20
1656097306754,MATH 18,A03,083745,Cinel; Cameron Alexander,3,0,30,27
1656097306754,MATH 18,B01,083748,Ma; Zilu,0,0,36,36
1656097306754,MATH 18,B02,083749,Ma; Zilu,0,0,36,36
1656097306754,MATH 18,B03,083750,Ma; Zilu,0,0,36,36
1656097306754,MATH 18,B04,083751,Ma; Zilu,0,0,36,36
1656097306754,MATH 18,B05,093473,Staff,3,0,36,33
1656097306754,MATH 18,B06,093474,Staff,3,0,36,33
1656097312782,MATH 20A,A01,083754,Zheng; Zequn,11,0,40,29
1656097318805,MATH 20B,A01,083756,Briones; Jor-el Thomas Caparas,0,0,36,36
1656097318805,MATH 20B,A02,083757,Briones; Jor-el Thomas Caparas,1,0,36,35
1656097318805,MATH 20B,A03,093475,Staff,3,0,36,33
1656097324836,MATH 20C,A01,083760,Briones; Jor-el Thomas Caparas,2,2,35,33
1656097324836,MATH 20C,A02,083761,Briones; Jor-el Thomas Caparas,9,1,35,26
1656097324836,MATH 20C,A03,093476,Staff,1,1,35,34
1656097324836,MATH 20C,B01,083762,Bach; Quang Tran,3,0,30,27
1656097330859,MATH 20D,A01,083765,Tran; Brian Kha,3,0,30,27
1656097330859,MATH 20D,A02,083766,Tran; Brian Kha,0,1,30,30
1656097330859,MATH 20D,A03,083767,Tran; Brian Kha,2,0,30,28
1656097336883,MATH 20E,A01,083771,Ganguly; Soumya,4,1,32,28
1656097336883,MATH 20E,A02,083772,Ganguly; Soumya,2,1,32,30
1656097336883,MATH 20E,B01,083773,Ciotti; Benjamin,14,0,35,21
1656097336883,MATH 20E,B02,083774,Ciotti; Benjamin,15,0,35,20
1656097342906,MATH 103A,A01,083777,Greenfeld; Be'Eri,3,0,36,33
1656097342906,MATH 103A,A02,083778,Greenfeld; Be'Eri,2,0,36,34
1656097342906,MATH 103A,A03,093561,Staff,4,1,36,32
1656097342906,MATH 103A,B01,083779,Greenfeld; Be'Eri,8,1,36,28
1656097342906,MATH 103A,B02,083780,Greenfeld; Be'Eri,0,1,36,36
1656097342906,MATH 103A,B03,093562,Staff,0,0,36,36
1656097348935,MATH 105,A01,085443,Carter; Anne Toulson,4,1,35,31
1656097348935,MATH 105,A02,093477,Staff,10,0,35,25
1656097354971,MATH 109,A01,083213,Ganzberger; Geoffrey Michael,1,1,34,33
1656097354971,MATH 109,A02,083214,Ganzberger; Geoffrey Michael,0,0,34,34
1656097354971,MATH 109,A03,093478,Staff,3,0,34,31
1656097354971,MATH 109,B01,083215,Ganzberger; Geoffrey Michael,3,0,32,29
1656097354971,MATH 109,B02,083216,Ganzberger; Geoffrey Michael,1,0,32,31
1656097354971,MATH 109,B03,093479,Staff,4,0,32,28
1656097361089,MATH 142A,A01,083219,Chow; Bennett,1,0,32,31
1656097361089,MATH 142A,A02,083220,Chow; Bennett,8,0,32,24
1656097361089,MATH 142A,A03,093480,Staff,5,0,32,27
1656097361089,MATH 142A,B03,093481,Staff,4,0,32,28
1656097361089,MATH 142A,B04,093558,Staff,7,0,32,25
1656097361089,MATH 142A,B05,093559,Staff,0,0,32,32
1656097367117,MATH 193A,A01,083224,Rotar; Vladimir,1,2,34,33
1656097367117,MATH 193A,A02,083225,Rotar; Vladimir,2,0,34,32
1656097367117,MATH 193A,A03,083781,Rotar; Vladimir,2,0,34,32
1656097367117,MATH 193A,A04,083782,Rotar; Vladimir,6,0,34,28
1656097367117,MATH 193A,A05,093482,Rotar; Vladimir,1,0,34,33
1656097373148,MATH 197,001,091859,McAuley; Julian John,9999,0,9999,0
1656097373148,MATH 197,002,095566,Kedlaya; Kiran S.,9997,0,9999,2
1656097373148,MATH 197,003,095567,Xiao; Ming,9999,0,9999,0
1656097373148,MATH 197,004,095571,Perols; Johan Lars,9998,0,9999,1
1656097380201,COGS 9,A01,083615,Shannon; Kyle Michael,5,1,75,70
1656097386227,COGS 11,A01,083617,Boyle; Mary E. T.,16,2,48,32
1656097392254,COGS 13,A01,083071,Bastos; Amalia Pinkusfeld,8,3,71,63
1656097398280,COGS 14A,A01,092681,Semenuks; Arturs,8,24,100,92
1656097404317,COGS 14B,A01,083073,Cheng; Tzu-Han,7,0,63,56
1656097410350,COGS 17,A01,092677,Semenuks; Arturs,13,6,81,68
1656097416373,COGS 100,A01,083619,Allen; Michael Gordon,7,4,70,63
1656097422401,COGS 101A,A01,083621,Davis; Joshua Daniel,7,3,68,61
1656097428426,COGS 101B,A01,091572,Allen; Michael Gordon,6,0,65,59
1656097434457,COGS 101C,A01,083625,Delgado; Tania,11,0,35,24
1656097440480,COGS 107A,A01,083627,Boyle; Mary E. T.,5,4,60,55
1656097446503,COGS 118A,A01,083075,Gupta; Anjum,24,16,76,52
1656097452539,CSE 3,A50,083646,Miranda; Gregory Joseph,18,0,50,32
1656097458564,CSE 8A,A50,083650,Miranda; Gregory Joseph,13,13,56,43
1656097464587,CSE 11,A01,083080,Cao; Yingjun,1,60,40,39
1656097470610,CSE 12,A01,083652,Krause-Levy; Sophia Louisa,14,8,120,106
1656097476633,CSE 15L,A01,083654,Morris; Justin Loren,5,2,50,45
1656097476633,CSE 15L,A02,083655,Morris; Justin Loren,7,2,50,43
1656097482658,CSE 20,A01,083657,Tran; Khoa Dang,31,0,80,49
1656097488687,CSE 21,A01,095574,Bach; Quang Tran,26,0,48,22
1656097494723,CSE 30,A01,083084,Eldon; John,3,11,80,77
1656097494723,CSE 30,B01,095061,Bhaskar; Nishant,4,5,50,46
1656097500750,CSE 100,A01,083659,Cao; Yingjun,2,23,70,68
1656097506784,CSE 134B,A01,083661,Powell; Thomas Allan,10,7,100,90
1656097512812,CSE 140,A01,083663,Gungor; Onat,9,0,85,76
1656097518838,CSE 140L,A01,083088,Eldon; John,8,0,100,92
1656097524868,CSE 175,A01,083665,Kumar; Rakesh,1,0,25,24
1656097530904,CSE 190,A00,092507,Dubnov; Shlomo,2,0,20,18
1656097536939,ECE 45,A01,083139,Congero; Spencer William,5,2,75,70
1656097542962,ECE 65,A50,083695,Saad; Andrew S,8,0,30,22
1656097542962,ECE 65,A51,095125,Staff,23,0,26,3
1656097549001,ECE 109,A01,091882,Touri; Behrouz,7,5,70,63
1656097555029,ECE 180,A00,083140,Abi Samra; Nicholas Camill,1,0,30,29
1656097555029,ECE 180,B00,083141,Abi Samra; Nicholas Camill,4,8,30,26
1656097561073,MATH 10A,A01,083735,Patchell; Gregory David,0,0,30,30
1656097561073,MATH 10A,A02,083736,Patchell; Gregory David,22,0,30,8
1656097561073,MATH 10A,A03,083737,Patchell; Gregory David,16,0,30,14
1656097567104,MATH 10B,A01,083207,Lim; Seonhee,3,2,34,31
1656097567104,MATH 10B,A02,083208,Lim; Seonhee,10,2,35,25
1656097567104,MATH 10B,A03,093472,Staff,4,2,34,30
1656097567104,MATH 10B,B01,083739,Sinha; Shubham,12,0,30,18
1656097573130,MATH 18,A01,083743,Cinel; Cameron Alexander,7,0,30,23
1656097573130,MATH 18,A02,083744,Cinel; Cameron Alexander,10,0,30,20
1656097573130,MATH 18,A03,083745,Cinel; Cameron Alexander,3,0,30,27
1656097573130,MATH 18,B01,083748,Ma; Zilu,0,0,36,36
1656097573130,MATH 18,B02,083749,Ma; Zilu,0,0,36,36
1656097573130,MATH 18,B03,083750,Ma; Zilu,0,0,36,36
1656097573130,MATH 18,B04,083751,Ma; Zilu,0,0,36,36
1656097573130,MATH 18,B05,093473,Staff,3,0,36,33
1656097573130,MATH 18,B06,093474,Staff,3,0,36,33
1656097579153,MATH 20A,A01,083754,Zheng; Zequn,11,0,40,29
1656097585180,MATH 20B,A01,083756,Briones; Jor-el Thomas Caparas,0,0,36,36
1656097585180,MATH 20B,A02,083757,Briones; Jor-el Thomas Caparas,1,0,36,35
1656097585180,MATH 20B,A03,093475,Staff,3,0,36,33
1656097591217,MATH 20C,A01,083760,Briones; Jor-el Thomas Caparas,2,2,35,33
1656097591217,MATH 20C,A02,083761,Briones; Jor-el Thomas Caparas,9,1,35,26
1656097591217,MATH 20C,A03,093476,Staff,1,1,35,34
1656097591217,MATH 20C,B01,083762,Bach; Quang Tran,3,0,30,27
1656097597244,MATH 20D,A01,083765,Tran; Brian Kha,3,0,30,27
1656097597244,MATH 20D,A02,083766,Tran; Brian Kha,0,1,30,30
1656097597244,MATH 20D,A03,083767,Tran; Brian Kha,2,0,30,28
1656097603267,MATH 20E,A01,083771,Ganguly; Soumya,4,1,32,28
1656097603267,MATH 20E,A02,083772,Ganguly; Soumya,2,1,32,30
1656097603267,MATH 20E,B01,083773,Ciotti; Benjamin,14,0,35,21
1656097603267,MATH 20E,B02,083774,Ciotti; Benjamin,15,0,35,20
1656097609290,MATH 103A,A01,083777,Greenfeld; Be'Eri,3,0,36,33
1656097609290,MATH 103A,A02,083778,Greenfeld; Be'Eri,2,0,36,34
1656097609290,MATH 103A,A03,093561,Staff,4,1,36,32
1656097609290,MATH 103A,B01,083779,Greenfeld; Be'Eri,8,1,36,28
1656097609290,MATH 103A,B02,083780,Greenfeld; Be'Eri,0,1,36,36
1656097609290,MATH 103A,B03,093562,Staff,0,0,36,36
1656097615318,MATH 105,A01,085443,Carter; Anne Toulson,4,1,35,31
1656097615318,MATH 105,A02,093477,Staff,10,0,35,25
1656097621348,MATH 109,A01,083213,Ganzberger; Geoffrey Michael,1,1,34,33
1656097621348,MATH 109,A02,083214,Ganzberger; Geoffrey Michael,0,0,34,34
1656097621348,MATH 109,A03,093478,Staff,3,0,34,31
1656097621348,MATH 109,B01,083215,Ganzberger; Geoffrey Michael,3,0,32,29
1656097621348,MATH 109,B02,083216,Ganzberger; Geoffrey Michael,1,0,32,31
1656097621348,MATH 109,B03,093479,Staff,4,0,32,28
1656097627390,MATH 142A,A01,083219,Chow; Bennett,1,0,32,31
1656097627390,MATH 142A,A02,083220,Chow; Bennett,8,0,32,24
1656097627390,MATH 142A,A03,093480,Staff,5,0,32,27
1656097627390,MATH 142A,B03,093481,Staff,4,0,32,28
1656097627390,MATH 142A,B04,093558,Staff,7,0,32,25
1656097627390,MATH 142A,B05,093559,Staff,0,0,32,32
1656097633422,MATH 193A,A01,083224,Rotar; Vladimir,1,2,34,33
1656097633422,MATH 193A,A02,083225,Rotar; Vladimir,2,0,34,32
1656097633422,MATH 193A,A03,083781,Rotar; Vladimir,2,0,34,32
1656097633422,MATH 193A,A04,083782,Rotar; Vladimir,6,0,34,28
1656097633422,MATH 193A,A05,093482,Rotar; Vladimir,1,0,34,33
1656097639445,MATH 197,001,091859,McAuley; Julian John,9999,0,9999,0
1656097639445,MATH 197,002,095566,Kedlaya; Kiran S.,9997,0,9999,2
1656097639445,MATH 197,003,095567,Xiao; Ming,9999,0,9999,0
1656097639445,MATH 197,004,095571,Perols; Johan Lars,9998,0,9999,1
1656097646509,COGS 9,A01,083615,Shannon; Kyle Michael,5,1,75,70
1656097652534,COGS 11,A01,083617,Boyle; Mary E. T.,16,2,48,32
1656097658562,COGS 13,A01,083071,Bastos; Amalia Pinkusfeld,8,3,71,63
1656097664599,COGS 14A,A01,092681,Semenuks; Arturs,8,24,100,92
1656097670633,COGS 14B,A01,083073,Cheng; Tzu-Han,7,0,63,56
1656097676658,COGS 17,A01,092677,Semenuks; Arturs,13,6,81,68
1656097682687,COGS 100,A01,083619,Allen; Michael Gordon,7,4,70,63
1656097688721,COGS 101A,A01,083621,Davis; Joshua Daniel,7,3,68,61
1656097694750,COGS 101B,A01,091572,Allen; Michael Gordon,6,0,65,59
1656097700784,COGS 101C,A01,083625,Delgado; Tania,11,0,35,24
1656097706807,COGS 107A,A01,083627,Boyle; Mary E. T.,5,4,60,55
1656097712835,COGS 118A,A01,083075,Gupta; Anjum,24,16,76,52
1656097718866,CSE 3,A50,083646,Miranda; Gregory Joseph,18,0,50,32
1656097724890,CSE 8A,A50,083650,Miranda; Gregory Joseph,13,13,56,43
1656097730912,CSE 11,A01,083080,Cao; Yingjun,1,60,40,39
1656097736937,CSE 12,A01,083652,Krause-Levy; Sophia Louisa,14,8,120,106
1656097742970,CSE 15L,A01,083654,Morris; Justin Loren,5,2,50,45
1656097742970,CSE 15L,A02,083655,Morris; Justin Loren,7,2,50,43
1656097748998,CSE 20,A01,083657,Tran; Khoa Dang,31,0,80,49
1656097755021,CSE 21,A01,095574,Bach; Quang Tran,26,0,48,22
1656097761049,CSE 30,A01,083084,Eldon; John,3,11,80,77
1656097761049,CSE 30,B01,095061,Bhaskar; Nishant,4,5,50,46
1656097767086,CSE 100,A01,083659,Cao; Yingjun,2,23,70,68
1656097773113,CSE 134B,A01,083661,Powell; Thomas Allan,10,7,100,90
1656097779140,CSE 140,A01,083663,Gungor; Onat,9,0,85,76
1656097785167,CSE 140L,A01,083088,Eldon; John,8,0,100,92
1656097791195,CSE 175,A01,083665,Kumar; Rakesh,1,0,25,24
1656097797218,CSE 190,A00,092507,Dubnov; Shlomo,2,0,20,18
1656097803245,ECE 45,A01,083139,Congero; Spencer William,5,2,75,70
1656097809269,ECE 65,A50,083695,Saad; Andrew S,8,0,30,22
1656097809269,ECE 65,A51,095125,Staff,23,0,26,3
1656097815297,ECE 109,A01,091882,Touri; Behrouz,7,5,70,63
1656097821326,ECE 180,A00,083140,Abi Samra; Nicholas Camill,1,0,30,29
1656097821326,ECE 180,B00,083141,Abi Samra; Nicholas Camill,4,8,30,26
1656097827358,MATH 10A,A01,083735,Patchell; Gregory David,0,0,30,30
1656097827358,MATH 10A,A02,083736,Patchell; Gregory David,22,0,30,8
1656097827358,MATH 10A,A03,083737,Patchell; Gregory David,16,0,30,14
1656097833382,MATH 10B,A01,083207,Lim; Seonhee,3,2,34,31
1656097833382,MATH 10B,A02,083208,Lim; Seonhee,10,2,35,25
1656097833382,MATH 10B,A03,093472,Staff,4,2,34,30
1656097833382,MATH 10B,B01,083739,Sinha; Shubham,12,0,30,18
1656097839413,MATH 18,A01,083743,Cinel; Cameron Alexander,7,0,30,23
1656097839413,MATH 18,A02,083744,Cinel; Cameron Alexander,10,0,30,20
1656097839413,MATH 18,A03,083745,Cinel; Cameron Alexander,3,0,30,27
1656097839413,MATH 18,B01,083748,Ma; Zilu,0,0,36,36
1656097839413,MATH 18,B02,083749,Ma; Zilu,0,0,36,36
1656097839413,MATH 18,B03,083750,Ma; Zilu,0,0,36,36
1656097839413,MATH 18,B04,083751,Ma; Zilu,0,0,36,36
1656097839413,MATH 18,B05,093473,Staff,3,0,36,33
1656097839413,MATH 18,B06,093474,Staff,3,0,36,33
1656097845442,MATH 20A,A01,083754,Zheng; Zequn,11,0,40,29
1656097851465,MATH 20B,A01,083756,Briones; Jor-el Thomas Caparas,0,0,36,36
1656097851465,MATH 20B,A02,083757,Briones; Jor-el Thomas Caparas,1,0,36,35
1656097851465,MATH 20B,A03,093475,Staff,3,0,36,33
1656097857488,MATH 20C,A01,083760,Briones; Jor-el Thomas Caparas,2,2,35,33
1656097857488,MATH 20C,A02,083761,Briones; Jor-el Thomas Caparas,9,1,35,26
1656097857488,MATH 20C,A03,093476,Staff,1,1,35,34
1656097857488,MATH 20C,B01,083762,Bach; Quang Tran,3,0,30,27
1656097863512,MATH 20D,A01,083765,Tran; Brian Kha,3,0,30,27
1656097863512,MATH 20D,A02,083766,Tran; Brian Kha,0,1,30,30
1656097863512,MATH 20D,A03,083767,Tran; Brian Kha,2,0,30,28
1656097869550,MATH 20E,A01,083771,Ganguly; Soumya,4,1,32,28
1656097869550,MATH 20E,A02,083772,Ganguly; Soumya,2,1,32,30
1656097869550,MATH 20E,B01,083773,Ciotti; Benjamin,14,0,35,21
1656097869550,MATH 20E,B02,083774,Ciotti; Benjamin,15,0,35,20
1656097875594,MATH 103A,A01,083777,Greenfeld; Be'Eri,3,0,36,33
1656097875594,MATH 103A,A02,083778,Greenfeld; Be'Eri,2,0,36,34
1656097875594,MATH 103A,A03,093561,Staff,4,1,36,32
1656097875594,MATH 103A,B01,083779,Greenfeld; Be'Eri,8,1,36,28
1656097875594,MATH 103A,B02,083780,Greenfeld; Be'Eri,0,1,36,36
1656097875594,MATH 103A,B03,093562,Staff,0,0,36,36
1656097881621,MATH 105,A01,085443,Carter; Anne Toulson,4,1,35,31
1656097881621,MATH 105,A02,093477,Staff,10,0,35,25
1656097887655,MATH 109,A01,083213,Ganzberger; Geoffrey Michael,1,1,34,33
1656097887655,MATH 109,A02,083214,Ganzberger; Geoffrey Michael,0,0,34,34
1656097887655,MATH 109,A03,093478,Staff,3,0,34,31
1656097887655,MATH 109,B01,083215,Ganzberger; Geoffrey Michael,3,0,32,29
1656097887655,MATH 109,B02,083216,Ganzberger; Geoffrey Michael,1,0,32,31
1656097887655,MATH 109,B03,093479,Staff,4,0,32,28
1656097893683,MATH 142A,A01,083219,Chow; Bennett,1,0,32,31
1656097893683,MATH 142A,A02,083220,Chow; Bennett,8,0,32,24
1656097893683,MATH 142A,A03,093480,Staff,5,0,32,27
1656097893683,MATH 142A,B03,093481,Staff,4,0,32,28
1656097893683,MATH 142A,B04,093558,Staff,7,0,32,25
1656097893683,MATH 142A,B05,093559,Staff,0,0,32,32
1656097899707,MATH 193A,A01,083224,Rotar; Vladimir,1,2,34,33
1656097899707,MATH 193A,A02,083225,Rotar; Vladimir,2,0,34,32
1656097899707,MATH 193A,A03,083781,Rotar; Vladimir,2,0,34,32
1656097899707,MATH 193A,A04,083782,Rotar; Vladimir,6,0,34,28
1656097899707,MATH 193A,A05,093482,Rotar; Vladimir,1,0,34,33
1656097905730,MATH 197,001,091859,McAuley; Julian John,9999,0,9999,0
1656097905730,MATH 197,002,095566,Kedlaya; Kiran S.,9997,0,9999,2
1656097905730,MATH 197,003,095567,Xiao; Ming,9999,0,9999,0
1656097905730,MATH 197,004,095571,Perols; Johan Lars,9998,0,9999,1
1656097912782,COGS 9,A01,083615,Shannon; Kyle Michael,5,1,75,70
1656097918804,COGS 11,A01,083617,Boyle; Mary E. T.,16,2,48,32
1656097924830,COGS 13,A01,083071,Bastos; Amalia Pinkusfeld,8,3,71,63
1656097930853,COGS 14A,A01,092681,Semenuks; Arturs,8,24,100,92
1656097936877,COGS 14B,A01,083073,Cheng; Tzu-Han,7,0,63,56
1656097942900,COGS 17,A01,092677,Semenuks; Arturs,13,6,81,68
1656097948927,COGS 100,A01,083619,Allen; Michael Gordon,7,4,70,63
1656097955040,COGS 101A,A01,083621,Davis; Joshua Daniel,7,3,68,61
1656097961072,COGS 101B,A01,091572,Allen; Michael Gordon,6,0,65,59
1656097967098,COGS 101C,A01,083625,Delgado; Tania,11,0,35,24
1656097973121,COGS 107A,A01,083627,Boyle; Mary E. T.,5,4,60,55
1656097979149,COGS 118A,A01,083075,Gupta; Anjum,24,16,76,52
1656097985172,CSE 3,A50,083646,Miranda; Gregory Joseph,18,0,50,32
1656097991199,CSE 8A,A50,083650,Miranda; Gregory Joseph,13,13,56,43
1656097997232,CSE 11,A01,083080,Cao; Yingjun,1,60,40,39
1656098003259,CSE 12,A01,083652,Krause-Levy; Sophia Louisa,14,8,120,106
1656098009290,CSE 15L,A01,083654,Morris; Justin Loren,5,2,50,45
1656098009290,CSE 15L,A02,083655,Morris; Justin Loren,7,2,50,43
1656098015320,CSE 20,A01,083657,Tran; Khoa Dang,31,0,80,49
1656098021347,CSE 21,A01,095574,Bach; Quang Tran,26,0,48,22
1656098027370,CSE 30,A01,083084,Eldon; John,3,11,80,77
1656098027370,CSE 30,B01,095061,Bhaskar; Nishant,4,5,50,46
1656098033394,CSE 100,A01,083659,Cao; Yingjun,2,23,70,68
1656098039417,CSE 134B,A01,083661,Powell; Thomas Allan,10,7,100,90
1656098045441,CSE 140,A01,083663,Gungor; Onat,9,0,85,76
1656098051470,CSE 140L,A01,083088,Eldon; John,8,0,100,92
1656098057498,CSE 175,A01,083665,Kumar; Rakesh,1,0,25,24
1656098063522,CSE 190,A00,092507,Dubnov; Shlomo,2,0,20,18
1656098069555,ECE 45,A01,083139,Congero; Spencer William,5,2,75,70
1656098075582,ECE 65,A50,083695,Saad; Andrew S,8,0,30,22
1656098075582,ECE 65,A51,095125,Staff,23,0,26,3
1656098081607,ECE 109,A01,091882,Touri; Behrouz,7,5,70,63
1656098087632,ECE 180,A00,083140,Abi Samra; Nicholas Camill,1,0,30,29
1656098087632,ECE 180,B00,083141,Abi Samra; Nicholas Camill,4,8,30,26
1656098093659,MATH 10A,A01,083735,Patchell; Gregory David,0,0,30,30
1656098093659,MATH 10A,A02,083736,Patchell; Gregory David,22,0,30,8
1656098093659,MATH 10A,A03,083737,Patchell; Gregory David,16,0,30,14
1656098099684,MATH 10B,A01,083207,Lim; Seonhee,3,2,34,31
1656098099684,MATH 10B,A02,083208,Lim; Seonhee,10,2,35,25
1656098099684,MATH 10B,A03,093472,Staff,4,2,34,30
1656098099684,MATH 10B,B01,083739,Sinha; Shubham,12,0,30,18
1656098105708,MATH 18,A01,083743,Cinel; Cameron Alexander,7,0,30,23
1656098105708,MATH 18,A02,083744,Cinel; Cameron Alexander,10,0,30,20
1656098105708,MATH 18,A03,083745,Cinel; Cameron Alexander,3,0,30,27
1656098105708,MATH 18,B01,083748,Ma; Zilu,0,0,36,36
1656098105708,MATH 18,B02,083749,Ma; Zilu,0,0,36,36
1656098105708,MATH 18,B03,083750,Ma; Zilu,0,0,36,36
1656098105708,MATH 18,B04,083751,Ma; Zilu,0,0,36,36
1656098105708,MATH 18,B05,093473,Staff,3,0,36,33
1656098105708,MATH 18,B06,093474,Staff,3,0,36,33
1656098111736,MATH 20A,A01,083754,Zheng; Zequn,11,0,40,29
1656098117763,MATH 20B,A01,083756,Briones; Jor-el Thomas Caparas,0,0,36,36
1656098117763,MATH 20B,A02,083757,Briones; Jor-el Thomas Caparas,1,0,36,35
1656098117763,MATH 20B,A03,093475,Staff,3,0,36,33
1656098123797,MATH 20C,A01,083760,Briones; Jor-el Thomas Caparas,2,2,35,33
1656098123797,MATH 20C,A02,083761,Briones; Jor-el Thomas Caparas,9,1,35,26
1656098123797,MATH 20C,A03,093476,Staff,1,1,35,34
1656098123797,MATH 20C,B01,083762,Bach; Quang Tran,3,0,30,27
1656098129827,MATH 20D,A01,083765,Tran; Brian Kha,3,0,30,27
1656098129827,MATH 20D,A02,083766,Tran; Brian Kha,0,1,30,30
1656098129827,MATH 20D,A03,083767,Tran; Brian Kha,2,0,30,28
1656098135852,MATH 20E,A01,083771,Ganguly; Soumya,4,1,32,28
1656098135852,MATH 20E,A02,083772,Ganguly; Soumya,2,1,32,30
1656098135852,MATH 20E,B01,083773,Ciotti; Benjamin,14,0,35,21
1656098135852,MATH 20E,B02,083774,Ciotti; Benjamin,15,0,35,20
1656098141876,MATH 103A,A01,083777,Greenfeld; Be'Eri,3,0,36,33
1656098141876,MATH 103A,A02,083778,Greenfeld; Be'Eri,2,0,36,34
1656098141876,MATH 103A,A03,093561,Staff,4,1,36,32
1656098141876,MATH 103A,B01,083779,Greenfeld; Be'Eri,8,1,36,28
1656098141876,MATH 103A,B02,083780,Greenfeld; Be'Eri,0,1,36,36
1656098141876,MATH 103A,B03,093562,Staff,0,0,36,36
1656098147902,MATH 105,A01,085443,Carter; Anne Toulson,4,1,35,31
1656098147902,MATH 105,A02,093477,Staff,10,0,35,25
1656098153926,MATH 109,A01,083213,Ganzberger; Geoffrey Michael,1,1,34,33
1656098153926,MATH 109,A02,083214,Ganzberger; Geoffrey Michael,0,0,34,34
1656098153926,MATH 109,A03,093478,Staff,3,0,34,31
1656098153926,MATH 109,B01,083215,Ganzberger; Geoffrey Michael,3,0,32,29
1656098153926,MATH 109,B02,083216,Ganzberger; Geoffrey Michael,1,0,32,31
1656098153926,MATH 109,B03,093479,Staff,4,0,32,28
1656098159950,MATH 142A,A01,083219,Chow; Bennett,1,0,32,31
1656098159950,MATH 142A,A02,083220,Chow; Bennett,8,0,32,24
1656098159950,MATH 142A,A03,093480,Staff,5,0,32,27
1656098159950,MATH 142A,B03,093481,Staff,4,0,32,28
1656098159950,MATH 142A,B04,093558,Staff,7,0,32,25
1656098159950,MATH 142A,B05,093559,Staff,0,0,32,32
1656098165974,MATH 193A,A01,083224,Rotar; Vladimir,1,2,34,33
1656098165974,MATH 193A,A02,083225,Rotar; Vladimir,2,0,34,32
1656098165974,MATH 193A,A03,083781,Rotar; Vladimir,2,0,34,32
1656098165974,MATH 193A,A04,083782,Rotar; Vladimir,6,0,34,28
1656098165974,MATH 193A,A05,093482,Rotar; Vladimir,1,0,34,33
1656098172001,MATH 197,001,091859,McAuley; Julian John,9999,0,9999,0
1656098172001,MATH 197,002,095566,Kedlaya; Kiran S.,9997,0,9999,2
1656098172001,MATH 197,003,095567,Xiao; Ming,9999,0,9999,0
1656098172001,MATH 197,004,095571,Perols; Johan Lars,9998,0,9999,1
1656098179069,COGS 9,A01,083615,Shannon; Kyle Michael,5,1,75,70
1656098185097,COGS 11,A01,083617,Boyle; Mary E. T.,16,2,48,32
1656098191125,COGS 13,A01,083071,Bastos; Amalia Pinkusfeld,8,3,71,63
1656098197154,COGS 14A,A01,092681,Semenuks; Arturs,8,24,100,92
1656098203177,COGS 14B,A01,083073,Cheng; Tzu-Han,7,0,63,56
1656098209207,COGS 17,A01,092677,Semenuks; Arturs,13,6,81,68
1656098215234,COGS 100,A01,083619,Allen; Michael Gordon,7,4,70,63
1656098221264,COGS 101A,A01,083621,Davis; Joshua Daniel,7,3,68,61
1656098227291,COGS 101B,A01,091572,Allen; Michael Gordon,6,0,65,59
1656098233317,COGS 101C,A01,083625,Delgado; Tania,11,0,35,24
1656098239346,COGS 107A,A01,083627,Boyle; Mary E. T.,5,4,60,55
1656098245368,COGS 118A,A01,083075,Gupta; Anjum,24,16,76,52
1656098251394,CSE 3,A50,083646,Miranda; Gregory Joseph,18,0,50,32
1656098257421,CSE 8A,A50,083650,Miranda; Gregory Joseph,13,13,56,43
1656098263447,CSE 11,A01,083080,Cao; Yingjun,1,60,40,39
1656098269473,CSE 12,A01,083652,Krause-Levy; Sophia Louisa,14,8,120,106
1656098275495,CSE 15L,A01,083654,Morris; Justin Loren,5,2,50,45
1656098275495,CSE 15L,A02,083655,Morris; Justin Loren,7,2,50,43
1656098281521,CSE 20,A01,083657,Tran; Khoa Dang,31,0,80,49
1656098287551,CSE 21,A01,095574,Bach; Quang Tran,26,0,48,22
1656098293580,CSE 30,A01,083084,Eldon; John,3,11,80,77
1656098293580,CSE 30,B01,095061,Bhaskar; Nishant,4,5,50,46
1656098299619,CSE 100,A01,083659,Cao; Yingjun,2,23,70,68
1656098305643,CSE 134B,A01,083661,Powell; Thomas Allan,10,7,100,90
1656098311665,CSE 140,A01,083663,Gungor; Onat,9,0,85,76
1656098317687,CSE 140L,A01,083088,Eldon; John,8,0,100,92
1656098323711,CSE 175,A01,083665,Kumar; Rakesh,1,0,25,24
1656098329734,CSE 190,A00,092507,Dubnov; Shlomo,2,0,20,18
1656098335761,ECE 45,A01,083139,Congero; Spencer William,5,2,75,70
1656098341784,ECE 65,A50,083695,Saad; Andrew S,8,0,30,22
1656098341784,ECE 65,A51,095125,Staff,23,0,26,3
1656098347808,ECE 109,A01,091882,Touri; Behrouz,7,5,70,63
1656098353835,ECE 180,A00,083140,Abi Samra; Nicholas Camill,1,0,30,29
1656098353835,ECE 180,B00,083141,Abi Samra; Nicholas Camill,4,8,30,26
1656098359863,MATH 10A,A01,083735,Patchell; Gregory David,0,0,30,30
1656098359863,MATH 10A,A02,083736,Patchell; Gregory David,22,0,30,8
1656098359863,MATH 10A,A03,083737,Patchell; Gregory David,16,0,30,14
1656098365886,MATH 10B,A01,083207,Lim; Seonhee,3,2,34,31
1656098365886,MATH 10B,A02,083208,Lim; Seonhee,10,2,35,25
1656098365886,MATH 10B,A03,093472,Staff,4,2,34,30
1656098365886,MATH 10B,B01,083739,Sinha; Shubham,12,0,30,18
1656098371917,MATH 18,A01,083743,Cinel; Cameron Alexander,7,0,30,23
1656098371917,MATH 18,A02,083744,Cinel; Cameron Alexander,10,0,30,20
1656098371917,MATH 18,A03,083745,Cinel; Cameron Alexander,3,0,30,27
1656098371917,MATH 18,B01,083748,Ma; Zilu,0,0,36,36
1656098371917,MATH 18,B02,083749,Ma; Zilu,0,0,36,36
1656098371917,MATH 18,B03,083750,Ma; Zilu,0,0,36,36
1656098371917,MATH 18,B04,083751,Ma; Zilu,0,0,36,36
1656098371917,MATH 18,B05,093473,Staff,3,0,36,33
1656098371917,MATH 18,B06,093474,Staff,3,0,36,33
1656098377944,MATH 20A,A01,083754,Zheng; Zequn,11,0,40,29
1656098383973,MATH 20B,A01,083756,Briones; Jor-el Thomas Caparas,0,0,36,36
1656098383973,MATH 20B,A02,083757,Briones; Jor-el Thomas Caparas,1,0,36,35
1656098383973,MATH 20B,A03,093475,Staff,3,0,36,33
1656098390002,MATH 20C,A01,083760,Briones; Jor-el Thomas Caparas,2,2,35,33
1656098390002,MATH 20C,A02,083761,Briones; Jor-el Thomas Caparas,9,1,35,26
1656098390002,MATH 20C,A03,093476,Staff,1,1,35,34
1656098390002,MATH 20C,B01,083762,Bach; Quang Tran,2,0,30,28
1656098396031,MATH 20D,A01,083765,Tran; Brian Kha,3,0,30,27
1656098396031,MATH 20D,A02,083766,Tran; Brian Kha,0,1,30,30
1656098396031,MATH 20D,A03,083767,Tran; Brian Kha,2,0,30,28
1656098402061,MATH 20E,A01,083771,Ganguly; Soumya,4,1,32,28
1656098402061,MATH 20E,A02,083772,Ganguly; Soumya,2,1,32,30
1656098402061,MATH 20E,B01,083773,Ciotti; Benjamin,14,0,35,21
1656098402061,MATH 20E,B02,083774,Ciotti; Benjamin,15,0,35,20
1656098408090,MATH 103A,A01,083777,Greenfeld; Be'Eri,3,0,36,33
1656098408090,MATH 103A,A02,083778,Greenfeld; Be'Eri,2,0,36,34
1656098408090,MATH 103A,A03,093561,Staff,4,1,36,32
1656098408090,MATH 103A,B01,083779,Greenfeld; Be'Eri,8,1,36,28
1656098408090,MATH 103A,B02,083780,Greenfeld; Be'Eri,0,1,36,36
1656098408090,MATH 103A,B03,093562,Staff,0,0,36,36
1656098414113,MATH 105,A01,085443,Carter; Anne Toulson,4,1,35,31
1656098414113,MATH 105,A02,093477,Staff,10,0,35,25
1656098420137,MATH 109,A01,083213,Ganzberger; Geoffrey Michael,1,1,34,33
1656098420137,MATH 109,A02,083214,Ganzberger; Geoffrey Michael,0,0,34,34
1656098420137,MATH 109,A03,093478,Staff,3,0,34,31
1656098420137,MATH 109,B01,083215,Ganzberger; Geoffrey Michael,3,0,32,29
1656098420137,MATH 109,B02,083216,Ganzberger; Geoffrey Michael,1,0,32,31
1656098420137,MATH 109,B03,093479,Staff,4,0,32,28
1656098426169,MATH 142A,A01,083219,Chow; Bennett,1,0,32,31
1656098426169,MATH 142A,A02,083220,Chow; Bennett,8,0,32,24
1656098426169,MATH 142A,A03,093480,Staff,5,0,32,27
1656098426169,MATH 142A,B03,093481,Staff,4,0,32,28
1656098426169,MATH 142A,B04,093558,Staff,7,0,32,25
1656098426169,MATH 142A,B05,093559,Staff,0,0,32,32
1656098432195,MATH 193A,A01,083224,Rotar; Vladimir,1,2,34,33
1656098432195,MATH 193A,A02,083225,Rotar; Vladimir,2,0,34,32
1656098432195,MATH 193A,A03,083781,Rotar; Vladimir,2,0,34,32
1656098432195,MATH 193A,A04,083782,Rotar; Vladimir,6,0,34,28
1656098432195,MATH 193A,A05,093482,Rotar; Vladimir,1,0,34,33
1656098438221,MATH 197,001,091859,McAuley; Julian John,9999,0,9999,0
1656098438221,MATH 197,002,095566,Kedlaya; Kiran S.,9997,0,9999,2
1656098438221,MATH 197,003,095567,Xiao; Ming,9999,0,9999,0
1656098438221,MATH 197,004,095571,Perols; Johan Lars,9998,0,9999,1
1656098445291,COGS 9,A01,083615,Shannon; Kyle Michael,5,1,75,70
1656098451317,COGS 11,A01,083617,Boyle; Mary E. T.,16,2,48,32
1656098457343,COGS 13,A01,083071,Bastos; Amalia Pinkusfeld,8,3,71,63
1656098463365,COGS 14A,A01,092681,Semenuks; Arturs,8,24,100,92
1656098469388,COGS 14B,A01,083073,Cheng; Tzu-Han,7,0,63,56
1656098475412,COGS 17,A01,092677,Semenuks; Arturs,13,6,81,68
1656098481434,COGS 100,A01,083619,Allen; Michael Gordon,7,4,70,63
1656098487458,COGS 101A,A01,083621,Davis; Joshua Daniel,7,3,68,61
1656098493480,COGS 101B,A01,091572,Allen; Michael Gordon,6,0,65,59
1656098499503,COGS 101C,A01,083625,Delgado; Tania,11,0,35,24
1656098505529,COGS 107A,A01,083627,Boyle; Mary E. T.,5,4,60,55
1656098511559,COGS 118A,A01,083075,Gupta; Anjum,24,16,76,52
1656098517588,CSE 3,A50,083646,Miranda; Gregory Joseph,18,0,50,32
1656098523611,CSE 8A,A50,083650,Miranda; Gregory Joseph,13,13,56,43
1656098529637,CSE 11,A01,083080,Cao; Yingjun,1,60,40,39
1656098535676,CSE 12,A01,083652,Krause-Levy; Sophia Louisa,14,8,120,106
1656098541703,CSE 15L,A01,083654,Morris; Justin Loren,5,2,50,45
1656098541703,CSE 15L,A02,083655,Morris; Justin Loren,7,2,50,43
1656098547726,CSE 20,A01,083657,Tran; Khoa Dang,31,0,80,49
1656098553841,CSE 21,A01,095574,Bach; Quang Tran,26,0,48,22
1656098559870,CSE 30,A01,083084,Eldon; John,3,11,80,77
1656098559870,CSE 30,B01,095061,Bhaskar; Nishant,4,5,50,46
1656098565898,CSE 100,A01,083659,Cao; Yingjun,2,23,70,68
1656098571921,CSE 134B,A01,083661,Powell; Thomas Allan,10,7,100,90
1656098577944,CSE 140,A01,083663,Gungor; Onat,9,0,85,76
1656098583970,CSE 140L,A01,083088,Eldon; John,8,0,100,92
1656098589993,CSE 175,A01,083665,Kumar; Rakesh,1,0,25,24
1656098596015,CSE 190,A00,092507,Dubnov; Shlomo,2,0,20,18
1656098602043,ECE 45,A01,083139,Congero; Spencer William,5,2,75,70
1656098608064,ECE 65,A50,083695,Saad; Andrew S,8,0,30,22
1656098608064,ECE 65,A51,095125,Staff,23,0,26,3
1656098614092,ECE 109,A01,091882,Touri; Behrouz,7,5,70,63
1656098620120,ECE 180,A00,083140,Abi Samra; Nicholas Camill,1,0,30,29
1656098620120,ECE 180,B00,083141,Abi Samra; Nicholas Camill,4,8,30,26
1656098626148,MATH 10A,A01,083735,Patchell; Gregory David,0,0,30,30
1656098626148,MATH 10A,A02,083736,Patchell; Gregory David,22,0,30,8
1656098626148,MATH 10A,A03,083737,Patchell; Gregory David,16,0,30,14
1656098632172,MATH 10B,A01,083207,Lim; Seonhee,3,2,34,31
1656098632172,MATH 10B,A02,083208,Lim; Seonhee,10,2,35,25
1656098632172,MATH 10B,A03,093472,Staff,4,2,34,30
1656098632172,MATH 10B,B01,083739,Sinha; Shubham,12,0,30,18
1656098638203,MATH 18,A01,083743,Cinel; Cameron Alexander,7,0,30,23
1656098638203,MATH 18,A02,083744,Cinel; Cameron Alexander,10,0,30,20
1656098638203,MATH 18,A03,083745,Cinel; Cameron Alexander,3,0,30,27
1656098638203,MATH 18,B01,083748,Ma; Zilu,0,0,36,36
1656098638203,MATH 18,B02,083749,Ma; Zilu,0,0,36,36
1656098638203,MATH 18,B03,083750,Ma; Zilu,0,0,36,36
1656098638203,MATH 18,B04,083751,Ma; Zilu,0,0,36,36
1656098638203,MATH 18,B05,093473,Staff,3,0,36,33
1656098638203,MATH 18,B06,093474,Staff,3,0,36,33
1656098644231,MATH 20A,A01,083754,Zheng; Zequn,11,0,40,29
1656098650266,MATH 20B,A01,083756,Briones; Jor-el Thomas Caparas,0,0,36,36
1656098650266,MATH 20B,A02,083757,Briones; Jor-el Thomas Caparas,1,0,36,35
1656098650266,MATH 20B,A03,093475,Staff,3,0,36,33
1656098656290,MATH 20C,A01,083760,Briones; Jor-el Thomas Caparas,2,2,35,33
1656098656290,MATH 20C,A02,083761,Briones; Jor-el Thomas Caparas,9,1,35,26
1656098656290,MATH 20C,A03,093476,Staff,1,1,35,34
1656098656290,MATH 20C,B01,083762,Bach; Quang Tran,2,0,30,28
1656098662311,MATH 20D,A01,083765,Tran; Brian Kha,3,0,30,27
1656098662311,MATH 20D,A02,083766,Tran; Brian Kha,0,1,30,30
1656098662311,MATH 20D,A03,083767,Tran; Brian Kha,2,0,30,28
1656098668335,MATH 20E,A01,083771,Ganguly; Soumya,4,1,32,28
1656098668335,MATH 20E,A02,083772,Ganguly; Soumya,2,1,32,30
1656098668335,MATH 20E,B01,083773,Ciotti; Benjamin,14,0,35,21
1656098668335,MATH 20E,B02,083774,Ciotti; Benjamin,15,0,35,20
1656098674358,MATH 103A,A01,083777,Greenfeld; Be'Eri,3,0,36,33
1656098674358,MATH 103A,A02,083778,Greenfeld; Be'Eri,2,0,36,34
1656098674358,MATH 103A,A03,093561,Staff,4,1,36,32
1656098674358,MATH 103A,B01,083779,Greenfeld; Be'Eri,8,1,36,28
1656098674358,MATH 103A,B02,083780,Greenfeld; Be'Eri,0,1,36,36
1656098674358,MATH 103A,B03,093562,Staff,0,0,36,36
1656098680389,MATH 105,A01,085443,Carter; Anne Toulson,4,1,35,31
1656098680389,MATH 105,A02,093477,Staff,10,0,35,25
1656098686413,MATH 109,A01,083213,Ganzberger; Geoffrey Michael,1,1,34,33
1656098686413,MATH 109,A02,083214,Ganzberger; Geoffrey Michael,0,0,34,34
1656098686413,MATH 109,A03,093478,Staff,3,0,34,31
1656098686413,MATH 109,B01,083215,Ganzberger; Geoffrey Michael,3,0,32,29
1656098686413,MATH 109,B02,083216,Ganzberger; Geoffrey Michael,1,0,32,31
1656098686413,MATH 109,B03,093479,Staff,4,0,32,28
1656098692437,MATH 142A,A01,083219,Chow; Bennett,1,0,32,31
1656098692437,MATH 142A,A02,083220,Chow; Bennett,8,0,32,24
1656098692437,MATH 142A,A03,093480,Staff,5,0,32,27
1656098692437,MATH 142A,B03,093481,Staff,4,0,32,28
1656098692437,MATH 142A,B04,093558,Staff,7,0,32,25
1656098692437,MATH 142A,B05,093559,Staff,0,0,32,32
1656098698460,MATH 193A,A01,083224,Rotar; Vladimir,1,2,34,33
1656098698460,MATH 193A,A02,083225,Rotar; Vladimir,2,0,34,32
1656098698460,MATH 193A,A03,083781,Rotar; Vladimir,2,0,34,32
1656098698460,MATH 193A,A04,083782,Rotar; Vladimir,6,0,34,28
1656098698460,MATH 193A,A05,093482,Rotar; Vladimir,1,0,34,33
1656098704493,MATH 197,001,091859,McAuley; Julian John,9999,0,9999,0
1656098704493,MATH 197,002,095566,Kedlaya; Kiran S.,9997,0,9999,2
1656098704493,MATH 197,003,095567,Xiao; Ming,9999,0,9999,0
1656098704493,MATH 197,004,095571,Perols; Johan Lars,9998,0,9999,1
1656098711552,COGS 9,A01,083615,Shannon; Kyle Michael,5,1,75,70
1656098717580,COGS 11,A01,083617,Boyle; Mary E. T.,16,2,48,32
1656098723604,COGS 13,A01,083071,Bastos; Amalia Pinkusfeld,8,3,71,63
1656098729625,COGS 14A,A01,092681,Semenuks; Arturs,8,24,100,92
1656098735654,COGS 14B,A01,083073,Cheng; Tzu-Han,7,0,63,56
1656098741682,COGS 17,A01,092677,Semenuks; Arturs,13,6,81,68
1656098747706,COGS 100,A01,083619,Allen; Michael Gordon,7,4,70,63
1656098753733,COGS 101A,A01,083621,Davis; Joshua Daniel,7,3,68,61
1656098759757,COGS 101B,A01,091572,Allen; Michael Gordon,6,0,65,59
1656098765788,COGS 101C,A01,083625,Delgado; Tania,11,0,35,24
1656098771811,COGS 107A,A01,083627,Boyle; Mary E. T.,5,4,60,55
1656098777844,COGS 118A,A01,083075,Gupta; Anjum,24,16,76,52
1656098783866,CSE 3,A50,083646,Miranda; Gregory Joseph,18,0,50,32
1656098789895,CSE 8A,A50,083650,Miranda; Gregory Joseph,13,13,56,43
1656098795923,CSE 11,A01,083080,Cao; Yingjun,1,60,40,39
1656098801946,CSE 12,A01,083652,Krause-Levy; Sophia Louisa,14,8,120,106
1656098807969,CSE 15L,A01,083654,Morris; Justin Loren,5,2,50,45
1656098807969,CSE 15L,A02,083655,Morris; Justin Loren,7,2,50,43
1656098813998,CSE 20,A01,083657,Tran; Khoa Dang,31,0,80,49
1656098820023,CSE 21,A01,095574,Bach; Quang Tran,26,0,48,22
1656098826054,CSE 30,A01,083084,Eldon; John,3,11,80,77
1656098826054,CSE 30,B01,095061,Bhaskar; Nishant,4,5,50,46
1656098832077,CSE 100,A01,083659,Cao; Yingjun,2,23,70,68
1656098838104,CSE 134B,A01,083661,Powell; Thomas Allan,10,7,100,90
1656098844130,CSE 140,A01,083663,Gungor; Onat,9,0,85,76
1656098850159,CSE 140L,A01,083088,Eldon; John,8,0,100,92
1656098856185,CSE 175,A01,083665,Kumar; Rakesh,1,0,25,24
1656098862221,CSE 190,A00,092507,Dubnov; Shlomo,2,0,20,18
1656098868245,ECE 45,A01,083139,Congero; Spencer William,5,2,75,70
1656098874276,ECE 65,A50,083695,Saad; Andrew S,8,0,30,22
1656098874276,ECE 65,A51,095125,Staff,23,0,26,3
1656098880302,ECE 109,A01,091882,Touri; Behrouz,7,5,70,63
1656098886325,ECE 180,A00,083140,Abi Samra; Nicholas Camill,1,0,30,29
1656098886325,ECE 180,B00,083141,Abi Samra; Nicholas Camill,4,8,30,26
1656098892350,MATH 10A,A01,083735,Patchell; Gregory David,0,0,30,30
1656098892350,MATH 10A,A02,083736,Patchell; Gregory David,22,0,30,8
1656098892350,MATH 10A,A03,083737,Patchell; Gregory David,16,0,30,14
1656098898379,MATH 10B,A01,083207,Lim; Seonhee,3,2,34,31
1656098898379,MATH 10B,A02,083208,Lim; Seonhee,10,2,35,25
1656098898379,MATH 10B,A03,093472,Staff,4,2,34,30
1656098898379,MATH 10B,B01,083739,Sinha; Shubham,12,0,30,18
1656098904410,MATH 18,A01,083743,Cinel; Cameron Alexander,7,0,30,23
1656098904410,MATH 18,A02,083744,Cinel; Cameron Alexander,10,0,30,20
1656098904410,MATH 18,A03,083745,Cinel; Cameron Alexander,3,0,30,27
1656098904410,MATH 18,B01,083748,Ma; Zilu,0,0,36,36
1656098904410,MATH 18,B02,083749,Ma; Zilu,0,0,36,36
1656098904410,MATH 18,B03,083750,Ma; Zilu,0,0,36,36
1656098904410,MATH 18,B04,083751,Ma; Zilu,0,0,36,36
1656098904410,MATH 18,B05,093473,Staff,3,0,36,33
1656098904410,MATH 18,B06,093474,Staff,3,0,36,33
1656098910438,MATH 20A,A01,083754,Zheng; Zequn,11,0,40,29
1656098916462,MATH 20B,A01,083756,Briones; Jor-el Thomas Caparas,0,0,36,36
1656098916462,MATH 20B,A02,083757,Briones; Jor-el Thomas Caparas,1,0,36,35
1656098916462,MATH 20B,A03,093475,Staff,3,0,36,33
1656098922489,MATH 20C,A01,083760,Briones; Jor-el Thomas Caparas,2,2,35,33
1656098922489,MATH 20C,A02,083761,Briones; Jor-el Thomas Caparas,9,1,35,26
1656098922489,MATH 20C,A03,093476,Staff,1,1,35,34
1656098922489,MATH 20C,B01,083762,Bach; Quang Tran,2,0,30,28
1656098928513,MATH 20D,A01,083765,Tran; Brian Kha,3,0,30,27
1656098928513,MATH 20D,A02,083766,Tran; Brian Kha,0,1,30,30
1656098928513,MATH 20D,A03,083767,Tran; Brian Kha,2,0,30,28
1656098934542,MATH 20E,A01,083771,Ganguly; Soumya,4,1,32,28
1656098934542,MATH 20E,A02,083772,Ganguly; Soumya,2,1,32,30
1656098934542,MATH 20E,B01,083773,Ciotti; Benjamin,14,0,35,21
1656098934542,MATH 20E,B02,083774,Ciotti; Benjamin,15,0,35,20
1656098940567,MATH 103A,A01,083777,Greenfeld; Be'Eri,3,0,36,33
1656098940567,MATH 103A,A02,083778,Greenfeld; Be'Eri,2,0,36,34
1656098940567,MATH 103A,A03,093561,Staff,4,1,36,32
1656098940567,MATH 103A,B01,083779,Greenfeld; Be'Eri,8,1,36,28
1656098940567,MATH 103A,B02,083780,Greenfeld; Be'Eri,0,1,36,36
1656098940567,MATH 103A,B03,093562,Staff,0,0,36,36
1656098946589,MATH 105,A01,085443,Carter; Anne Toulson,4,1,35,31
1656098946589,MATH 105,A02,093477,Staff,10,0,35,25
1656098952617,MATH 109,A01,083213,Ganzberger; Geoffrey Michael,1,1,34,33
1656098952617,MATH 109,A02,083214,Ganzberger; Geoffrey Michael,0,0,34,34
1656098952617,MATH 109,A03,093478,Staff,3,0,34,31
1656098952617,MATH 109,B01,083215,Ganzberger; Geoffrey Michael,3,0,32,29
1656098952617,MATH 109,B02,083216,Ganzberger; Geoffrey Michael,1,0,32,31
1656098952617,MATH 109,B03,093479,Staff,4,0,32,28
1656098958653,MATH 142A,A01,083219,Chow; Bennett,1,0,32,31
1656098958653,MATH 142A,A02,083220,Chow; Bennett,8,0,32,24
1656098958653,MATH 142A,A03,093480,Staff,5,0,32,27
1656098958653,MATH 142A,B03,093481,Staff,4,0,32,28
1656098958653,MATH 142A,B04,093558,Staff,6,0,32,26
1656098958653,MATH 142A,B05,093559,Staff,0,0,32,32
1656098964683,MATH 193A,A01,083224,Rotar; Vladimir,1,2,34,33
1656098964683,MATH 193A,A02,083225,Rotar; Vladimir,2,0,34,32
1656098964683,MATH 193A,A03,083781,Rotar; Vladimir,2,0,34,32
1656098964683,MATH 193A,A04,083782,Rotar; Vladimir,6,0,34,28
1656098964683,MATH 193A,A05,093482,Rotar; Vladimir,1,0,34,33
1656098970705,MATH 197,001,091859,McAuley; Julian John,9999,0,9999,0
1656098970705,MATH 197,002,095566,Kedlaya; Kiran S.,9997,0,9999,2
1656098970705,MATH 197,003,095567,Xiao; Ming,9999,0,9999,0
1656098970705,MATH 197,004,095571,Perols; Johan Lars,9998,0,9999,1
1656098977772,COGS 9,A01,083615,Shannon; Kyle Michael,5,1,75,70
1656098983803,COGS 11,A01,083617,Boyle; Mary E. T.,16,2,48,32
1656098989832,COGS 13,A01,083071,Bastos; Amalia Pinkusfeld,8,3,71,63
1656098995856,COGS 14A,A01,092681,Semenuks; Arturs,8,24,100,92
1656099001878,COGS 14B,A01,083073,Cheng; Tzu-Han,7,0,63,56
1656099007915,COGS 17,A01,092677,Semenuks; Arturs,13,6,81,68
1656099013950,COGS 100,A01,083619,Allen; Michael Gordon,7,4,70,63
1656099019972,COGS 101A,A01,083621,Davis; Joshua Daniel,7,3,68,61
1656099026000,COGS 101B,A01,091572,Allen; Michael Gordon,6,0,65,59
1656099032024,COGS 101C,A01,083625,Delgado; Tania,11,0,35,24
1656099038046,COGS 107A,A01,083627,Boyle; Mary E. T.,5,4,60,55
1656099044072,COGS 118A,A01,083075,Gupta; Anjum,24,16,76,52
1656099050100,CSE 3,A50,083646,Miranda; Gregory Joseph,18,0,50,32
1656099056123,CSE 8A,A50,083650,Miranda; Gregory Joseph,13,13,56,43
1656099062149,CSE 11,A01,083080,Cao; Yingjun,1,60,40,39
1656099068172,CSE 12,A01,083652,Krause-Levy; Sophia Louisa,14,8,120,106
1656099074198,CSE 15L,A01,083654,Morris; Justin Loren,5,2,50,45
1656099074198,CSE 15L,A02,083655,Morris; Justin Loren,7,2,50,43
1656099080221,CSE 20,A01,083657,Tran; Khoa Dang,31,0,80,49
1656099086244,CSE 21,A01,095574,Bach; Quang Tran,26,0,48,22
1656099092275,CSE 30,A01,083084,Eldon; John,3,11,80,77
1656099092275,CSE 30,B01,095061,Bhaskar; Nishant,4,5,50,46
1656099098306,CSE 100,A01,083659,Cao; Yingjun,2,23,70,68
1656099104340,CSE 134B,A01,083661,Powell; Thomas Allan,10,7,100,90
1656099110366,CSE 140,A01,083663,Gungor; Onat,9,0,85,76
1656099116387,CSE 140L,A01,083088,Eldon; John,8,0,100,92
1656099122412,CSE 175,A01,083665,Kumar; Rakesh,1,0,25,24
1656099128438,CSE 190,A00,092507,Dubnov; Shlomo,2,0,20,18
1656099134472,ECE 45,A01,083139,Congero; Spencer William,5,2,75,70
1656099140496,ECE 65,A50,083695,Saad; Andrew S,8,0,30,22
1656099140496,ECE 65,A51,095125,Staff,23,0,26,3
1656099146521,ECE 109,A01,091882,Touri; Behrouz,7,5,70,63
1656099152620,ECE 180,A00,083140,Abi Samra; Nicholas Camill,1,0,30,29
1656099152620,ECE 180,B00,083141,Abi Samra; Nicholas Camill,4,8,30,26
1656099158643,MATH 10A,A01,083735,Patchell; Gregory David,0,0,30,30
1656099158643,MATH 10A,A02,083736,Patchell; Gregory David,22,0,30,8
1656099158643,MATH 10A,A03,083737,Patchell; Gregory David,16,0,30,14
1656099164667,MATH 10B,A01,083207,Lim; Seonhee,3,2,34,31
1656099164667,MATH 10B,A02,083208,Lim; Seonhee,10,2,35,25
1656099164667,MATH 10B,A03,093472,Staff,4,2,34,30
1656099164667,MATH 10B,B01,083739,Sinha; Shubham,12,0,30,18
1656099170694,MATH 18,A01,083743,Cinel; Cameron Alexander,7,0,30,23
1656099170694,MATH 18,A02,083744,Cinel; Cameron Alexander,10,0,30,20
1656099170694,MATH 18,A03,083745,Cinel; Cameron Alexander,3,0,30,27
1656099170694,MATH 18,B01,083748,Ma; Zilu,0,0,36,36
1656099170694,MATH 18,B02,083749,Ma; Zilu,0,0,36,36
1656099170694,MATH 18,B03,083750,Ma; Zilu,0,0,36,36
1656099170694,MATH 18,B04,083751,Ma; Zilu,0,0,36,36
1656099170694,MATH 18,B05,093473,Staff,3,0,36,33
1656099170694,MATH 18,B06,093474,Staff,3,0,36,33
1656099176726,MATH 20A,A01,083754,Zheng; Zequn,11,0,40,29
1656099182757,MATH 20B,A01,083756,Briones; Jor-el Thomas Caparas,0,0,36,36
1656099182757,MATH 20B,A02,083757,Briones; Jor-el Thomas Caparas,1,0,36,35
1656099182757,MATH 20B,A03,093475,Staff,3,0,36,33
1656099188782,MATH 20C,A01,083760,Briones; Jor-el Thomas Caparas,2,2,35,33
1656099188782,MATH 20C,A02,083761,Briones; Jor-el Thomas Caparas,9,1,35,26
1656099188782,MATH 20C,A03,093476,Staff,1,1,35,34
1656099188782,MATH 20C,B01,083762,Bach; Quang Tran,2,0,30,28
1656099194812,MATH 20D,A01,083765,Tran; Brian Kha,3,0,30,27
1656099194812,MATH 20D,A02,083766,Tran; Brian Kha,0,1,30,30
1656099194812,MATH 20D,A03,083767,Tran; Brian Kha,2,0,30,28
1656099200839,MATH 20E,A01,083771,Ganguly; Soumya,4,1,32,28
1656099200839,MATH 20E,A02,083772,Ganguly; Soumya,2,1,32,30
1656099200839,MATH 20E,B01,083773,Ciotti; Benjamin,14,0,35,21
1656099200839,MATH 20E,B02,083774,Ciotti; Benjamin,15,0,35,20
1656099206886,MATH 103A,A01,083777,Greenfeld; Be'Eri,3,0,36,33
1656099206886,MATH 103A,A02,083778,Greenfeld; Be'Eri,2,0,36,34
1656099206886,MATH 103A,A03,093561,Staff,4,1,36,32
1656099206886,MATH 103A,B01,083779,Greenfeld; Be'Eri,8,1,36,28
1656099206886,MATH 103A,B02,083780,Greenfeld; Be'Eri,0,1,36,36
1656099206886,MATH 103A,B03,093562,Staff,0,0,36,36
1656099212910,MATH 105,A01,085443,Carter; Anne Toulson,4,1,35,31
1656099212910,MATH 105,A02,093477,Staff,10,0,35,25
1656099218943,MATH 109,A01,083213,Ganzberger; Geoffrey Michael,1,1,34,33
1656099218943,MATH 109,A02,083214,Ganzberger; Geoffrey Michael,0,0,34,34
1656099218943,MATH 109,A03,093478,Staff,3,0,34,31
1656099218943,MATH 109,B01,083215,Ganzberger; Geoffrey Michael,3,0,32,29
1656099218943,MATH 109,B02,083216,Ganzberger; Geoffrey Michael,1,0,32,31
1656099218943,MATH 109,B03,093479,Staff,4,0,32,28
1656099224967,MATH 142A,A01,083219,Chow; Bennett,1,0,32,31
1656099224967,MATH 142A,A02,083220,Chow; Bennett,8,0,32,24
1656099224967,MATH 142A,A03,093480,Staff,5,0,32,27
1656099224967,MATH 142A,B03,093481,Staff,4,0,32,28
1656099224967,MATH 142A,B04,093558,Staff,6,0,32,26
1656099224967,MATH 142A,B05,093559,Staff,0,0,32,32
1656099230996,MATH 193A,A01,083224,Rotar; Vladimir,1,2,34,33
1656099230996,MATH 193A,A02,083225,Rotar; Vladimir,2,0,34,32
1656099230996,MATH 193A,A03,083781,Rotar; Vladimir,2,0,34,32
1656099230996,MATH 193A,A04,083782,Rotar; Vladimir,6,0,34,28
1656099230996,MATH 193A,A05,093482,Rotar; Vladimir,1,0,34,33
1656099237018,MATH 197,001,091859,McAuley; Julian John,9999,0,9999,0
1656099237018,MATH 197,002,095566,Kedlaya; Kiran S.,9997,0,9999,2
1656099237018,MATH 197,003,095567,Xiao; Ming,9999,0,9999,0
1656099237018,MATH 197,004,095571,Perols; Johan Lars,9998,0,9999,1
1656099244070,COGS 9,A01,083615,Shannon; Kyle Michael,5,1,75,70
1656099250094,COGS 11,A01,083617,Boyle; Mary E. T.,16,2,48,32
1656099256118,COGS 13,A01,083071,Bastos; Amalia Pinkusfeld,8,3,71,63
1656099262143,COGS 14A,A01,092681,Semenuks; Arturs,8,24,100,92
1656099268166,COGS 14B,A01,083073,Cheng; Tzu-Han,7,0,63,56
1656099274196,COGS 17,A01,092677,Semenuks; Arturs,13,6,81,68
1656099280220,COGS 100,A01,083619,Allen; Michael Gordon,7,4,70,63
1656099286248,COGS 101A,A01,083621,Davis; Joshua Daniel,7,3,68,61
1656099292274,COGS 101B,A01,091572,Allen; Michael Gordon,6,0,65,59
1656099298304,COGS 101C,A01,083625,Delgado; Tania,11,0,35,24
1656099304330,COGS 107A,A01,083627,Boyle; Mary E. T.,5,4,60,55
1656099310370,COGS 118A,A01,083075,Gupta; Anjum,24,16,76,52
1656099316392,CSE 3,A50,083646,Miranda; Gregory Joseph,18,0,50,32
1656099322415,CSE 8A,A50,083650,Miranda; Gregory Joseph,13,13,56,43
1656099328450,CSE 11,A01,083080,Cao; Yingjun,1,60,40,39
1656099334477,CSE 12,A01,083652,Krause-Levy; Sophia Louisa,14,8,120,106
1656099340505,CSE 15L,A01,083654,Morris; Justin Loren,5,2,50,45
1656099340505,CSE 15L,A02,083655,Morris; Justin Loren,7,2,50,43
1656099346531,CSE 20,A01,083657,Tran; Khoa Dang,31,0,80,49
1656099352552,CSE 21,A01,095574,Bach; Quang Tran,26,0,48,22
1656099358576,CSE 30,A01,083084,Eldon; John,3,11,80,77
1656099358576,CSE 30,B01,095061,Bhaskar; Nishant,4,5,50,46
1656099364600,CSE 100,A01,083659,Cao; Yingjun,2,23,70,68
1656099370630,CSE 134B,A01,083661,Powell; Thomas Allan,10,7,100,90
1656099376658,CSE 140,A01,083663,Gungor; Onat,9,0,85,76
1656099382681,CSE 140L,A01,083088,Eldon; John,8,0,100,92
1656099388705,CSE 175,A01,083665,Kumar; Rakesh,1,0,25,24
1656099394735,CSE 190,A00,092507,Dubnov; Shlomo,2,0,20,18
1656099400764,ECE 45,A01,083139,Congero; Spencer William,5,2,75,70
1656099406796,ECE 65,A50,083695,Saad; Andrew S,8,0,30,22
1656099406796,ECE 65,A51,095125,Staff,23,0,26,3
1656099412821,ECE 109,A01,091882,Touri; Behrouz,7,5,70,63
1656099418845,ECE 180,A00,083140,Abi Samra; Nicholas Camill,1,0,30,29
1656099418845,ECE 180,B00,083141,Abi Samra; Nicholas Camill,4,8,30,26
1656099424873,MATH 10A,A01,083735,Patchell; Gregory David,0,0,30,30
1656099424873,MATH 10A,A02,083736,Patchell; Gregory David,22,0,30,8
1656099424873,MATH 10A,A03,083737,Patchell; Gregory David,16,0,30,14
1656099430896,MATH 10B,A01,083207,Lim; Seonhee,3,2,34,31
1656099430896,MATH 10B,A02,083208,Lim; Seonhee,10,2,35,25
1656099430896,MATH 10B,A03,093472,Staff,4,2,34,30
1656099430896,MATH 10B,B01,083739,Sinha; Shubham,12,0,30,18
1656099436927,MATH 18,A01,083743,Cinel; Cameron Alexander,7,0,30,23
1656099436927,MATH 18,A02,083744,Cinel; Cameron Alexander,10,0,30,20
1656099436927,MATH 18,A03,083745,Cinel; Cameron Alexander,3,0,30,27
1656099436927,MATH 18,B01,083748,Ma; Zilu,0,0,36,36
1656099436927,MATH 18,B02,083749,Ma; Zilu,0,0,36,36
1656099436927,MATH 18,B03,083750,Ma; Zilu,0,0,36,36
1656099436927,MATH 18,B04,083751,Ma; Zilu,0,0,36,36
1656099436927,MATH 18,B05,093473,Staff,3,0,36,33
1656099436927,MATH 18,B06,093474,Staff,3,0,36,33
1656099442953,MATH 20A,A01,083754,Zheng; Zequn,11,0,40,29
1656099448979,MATH 20B,A01,083756,Briones; Jor-el Thomas Caparas,0,0,36,36
1656099448979,MATH 20B,A02,083757,Briones; Jor-el Thomas Caparas,1,0,36,35
1656099448979,MATH 20B,A03,093475,Staff,3,0,36,33
1656099455010,MATH 20C,A01,083760,Briones; Jor-el Thomas Caparas,2,2,35,33
1656099455010,MATH 20C,A02,083761,Briones; Jor-el Thomas Caparas,9,1,35,26
1656099455010,MATH 20C,A03,093476,Staff,1,1,35,34
1656099455010,MATH 20C,B01,083762,Bach; Quang Tran,2,0,30,28
1656099461034,MATH 20D,A01,083765,Tran; Brian Kha,3,0,30,27
1656099461034,MATH 20D,A02,083766,Tran; Brian Kha,0,1,30,30
1656099461034,MATH 20D,A03,083767,Tran; Brian Kha,2,0,30,28
1656099467058,MATH 20E,A01,083771,Ganguly; Soumya,4,1,32,28
1656099467058,MATH 20E,A02,083772,Ganguly; Soumya,2,1,32,30
1656099467058,MATH 20E,B01,083773,Ciotti; Benjamin,14,0,35,21
1656099467058,MATH 20E,B02,083774,Ciotti; Benjamin,15,0,35,20
1656099473083,MATH 103A,A01,083777,Greenfeld; Be'Eri,3,0,36,33
1656099473083,MATH 103A,A02,083778,Greenfeld; Be'Eri,2,0,36,34
1656099473083,MATH 103A,A03,093561,Staff,4,1,36,32
1656099473083,MATH 103A,B01,083779,Greenfeld; Be'Eri,8,1,36,28
1656099473083,MATH 103A,B02,083780,Greenfeld; Be'Eri,0,1,36,36
1656099473083,MATH 103A,B03,093562,Staff,0,0,36,36
1656099479107,MATH 105,A01,085443,Carter; Anne Toulson,4,1,35,31
1656099479107,MATH 105,A02,093477,Staff,10,0,35,25
1656099485132,MATH 109,A01,083213,Ganzberger; Geoffrey Michael,1,1,34,33
1656099485132,MATH 109,A02,083214,Ganzberger; Geoffrey Michael,0,0,34,34
1656099485132,MATH 109,A03,093478,Staff,3,0,34,31
1656099485132,MATH 109,B01,083215,Ganzberger; Geoffrey Michael,3,0,32,29
1656099485132,MATH 109,B02,083216,Ganzberger; Geoffrey Michael,1,0,32,31
1656099485132,MATH 109,B03,093479,Staff,4,0,32,28
1656099491166,MATH 142A,A01,083219,Chow; Bennett,1,0,32,31
1656099491166,MATH 142A,A02,083220,Chow; Bennett,8,0,32,24
1656099491166,MATH 142A,A03,093480,Staff,5,0,32,27
1656099491166,MATH 142A,B03,093481,Staff,4,0,32,28
1656099491166,MATH 142A,B04,093558,Staff,6,0,32,26
1656099491166,MATH 142A,B05,093559,Staff,0,0,32,32
1656099497188,MATH 193A,A01,083224,Rotar; Vladimir,1,2,34,33
1656099497188,MATH 193A,A02,083225,Rotar; Vladimir,2,0,34,32
1656099497188,MATH 193A,A03,083781,Rotar; Vladimir,2,0,34,32
1656099497188,MATH 193A,A04,083782,Rotar; Vladimir,6,0,34,28
1656099497188,MATH 193A,A05,093482,Rotar; Vladimir,1,0,34,33
1656099503211,MATH 197,001,091859,McAuley; Julian John,9999,0,9999,0
1656099503211,MATH 197,002,095566,Kedlaya; Kiran S.,9997,0,9999,2
1656099503211,MATH 197,003,095567,Xiao; Ming,9999,0,9999,0
1656099503211,MATH 197,004,095571,Perols; Johan Lars,9998,0,9999,1
1656099510286,COGS 9,A01,083615,Shannon; Kyle Michael,5,1,75,70
1656099516310,COGS 11,A01,083617,Boyle; Mary E. T.,16,2,48,32
1656099522339,COGS 13,A01,083071,Bastos; Amalia Pinkusfeld,8,3,71,63
1656099528361,COGS 14A,A01,092681,Semenuks; Arturs,8,24,100,92
1656099534388,COGS 14B,A01,083073,Cheng; Tzu-Han,7,0,63,56
1656099540411,COGS 17,A01,092677,Semenuks; Arturs,13,6,81,68
1656099546435,COGS 100,A01,083619,Allen; Michael Gordon,7,4,70,63
1656099552462,COGS 101A,A01,083621,Davis; Joshua Daniel,7,3,68,61
1656099558493,COGS 101B,A01,091572,Allen; Michael Gordon,6,0,65,59
1656099564527,COGS 101C,A01,083625,Delgado; Tania,11,0,35,24
1656099570553,COGS 107A,A01,083627,Boyle; Mary E. T.,5,4,60,55
1656099576577,COGS 118A,A01,083075,Gupta; Anjum,24,16,76,52
1656099582614,CSE 3,A50,083646,Miranda; Gregory Joseph,18,0,50,32
1656099588648,CSE 8A,A50,083650,Miranda; Gregory Joseph,13,13,56,43
1656099594672,CSE 11,A01,083080,Cao; Yingjun,1,60,40,39
1656099600695,CSE 12,A01,083652,Krause-Levy; Sophia Louisa,14,8,120,106
1656099606723,CSE 15L,A01,083654,Morris; Justin Loren,5,2,50,45
1656099606723,CSE 15L,A02,083655,Morris; Justin Loren,7,2,50,43
1656099612747,CSE 20,A01,083657,Tran; Khoa Dang,31,0,80,49
1656099618771,CSE 21,A01,095574,Bach; Quang Tran,26,0,48,22
1656099624797,CSE 30,A01,083084,Eldon; John,3,11,80,77
1656099624797,CSE 30,B01,095061,Bhaskar; Nishant,4,5,50,46
1656099630822,CSE 100,A01,083659,Cao; Yingjun,2,23,70,68
1656099636855,CSE 134B,A01,083661,Powell; Thomas Allan,10,7,100,90
1656099642878,CSE 140,A01,083663,Gungor; Onat,9,0,85,76
1656099648900,CSE 140L,A01,083088,Eldon; John,8,0,100,92
1656099654924,CSE 175,A01,083665,Kumar; Rakesh,1,0,25,24
1656099660951,CSE 190,A00,092507,Dubnov; Shlomo,2,0,20,18
1656099666974,ECE 45,A01,083139,Congero; Spencer William,5,3,75,70
1656099673005,ECE 65,A50,083695,Saad; Andrew S,8,0,30,22
1656099673005,ECE 65,A51,095125,Staff,23,0,26,3
1656099679039,ECE 109,A01,091882,Touri; Behrouz,7,5,70,63
1656099685072,ECE 180,A00,083140,Abi Samra; Nicholas Camill,1,0,30,29
1656099685072,ECE 180,B00,083141,Abi Samra; Nicholas Camill,4,8,30,26
1656099691095,MATH 10A,A01,083735,Patchell; Gregory David,0,0,30,30
1656099691095,MATH 10A,A02,083736,Patchell; Gregory David,22,0,30,8
1656099691095,MATH 10A,A03,083737,Patchell; Gregory David,16,0,30,14
1656099697124,MATH 10B,A01,083207,Lim; Seonhee,3,2,34,31
1656099697124,MATH 10B,A02,083208,Lim; Seonhee,10,2,35,25
1656099697124,MATH 10B,A03,093472,Staff,4,2,34,30
1656099697124,MATH 10B,B01,083739,Sinha; Shubham,12,0,30,18
1656099703148,MATH 18,A01,083743,Cinel; Cameron Alexander,7,0,30,23
1656099703148,MATH 18,A02,083744,Cinel; Cameron Alexander,10,0,30,20
1656099703148,MATH 18,A03,083745,Cinel; Cameron Alexander,3,0,30,27
1656099703148,MATH 18,B01,083748,Ma; Zilu,0,0,36,36
1656099703148,MATH 18,B02,083749,Ma; Zilu,0,0,36,36
1656099703148,MATH 18,B03,083750,Ma; Zilu,0,0,36,36
1656099703148,MATH 18,B04,083751,Ma; Zilu,0,0,36,36
1656099703148,MATH 18,B05,093473,Staff,3,0,36,33
1656099703148,MATH 18,B06,093474,Staff,3,0,36,33
1656099709171,MATH 20A,A01,083754,Zheng; Zequn,11,0,40,29
1656099715195,MATH 20B,A01,083756,Briones; Jor-el Thomas Caparas,0,0,36,36
1656099715195,MATH 20B,A02,083757,Briones; Jor-el Thomas Caparas,1,0,36,35
1656099715195,MATH 20B,A03,093475,Staff,3,0,36,33
1656099721228,MATH 20C,A01,083760,Briones; Jor-el Thomas Caparas,2,2,35,33
1656099721228,MATH 20C,A02,083761,Briones; Jor-el Thomas Caparas,9,1,35,26
1656099721228,MATH 20C,A03,093476,Staff,1,1,35,34
1656099721228,MATH 20C,B01,083762,Bach; Quang Tran,2,0,30,28
1656099727253,MATH 20D,A01,083765,Tran; Brian Kha,3,0,30,27
1656099727253,MATH 20D,A02,083766,Tran; Brian Kha,0,1,30,30
1656099727253,MATH 20D,A03,083767,Tran; Brian Kha,2,0,30,28
1656099733281,MATH 20E,A01,083771,Ganguly; Soumya,4,1,32,28
1656099733281,MATH 20E,A02,083772,Ganguly; Soumya,2,1,32,30
1656099733281,MATH 20E,B01,083773,Ciotti; Benjamin,14,0,35,21
1656099733281,MATH 20E,B02,083774,Ciotti; Benjamin,15,0,35,20
1656099739312,MATH 103A,A01,083777,Greenfeld; Be'Eri,3,0,36,33
1656099739312,MATH 103A,A02,083778,Greenfeld; Be'Eri,2,0,36,34
1656099739312,MATH 103A,A03,093561,Staff,4,1,36,32
1656099739312,MATH 103A,B01,083779,Greenfeld; Be'Eri,8,1,36,28
1656099739312,MATH 103A,B02,083780,Greenfeld; Be'Eri,0,1,36,36
1656099739312,MATH 103A,B03,093562,Staff,0,0,36,36
1656099745336,MATH 105,A01,085443,Carter; Anne Toulson,4,1,35,31
1656099745336,MATH 105,A02,093477,Staff,10,0,35,25
1656099751432,MATH 109,A01,083213,Ganzberger; Geoffrey Michael,1,1,34,33
1656099751432,MATH 109,A02,083214,Ganzberger; Geoffrey Michael,0,0,34,34
1656099751432,MATH 109,A03,093478,Staff,3,0,34,31
1656099751432,MATH 109,B01,083215,Ganzberger; Geoffrey Michael,3,0,32,29
1656099751432,MATH 109,B02,083216,Ganzberger; Geoffrey Michael,1,0,32,31
1656099751432,MATH 109,B03,093479,Staff,4,0,32,28
1656099757460,MATH 142A,A01,083219,Chow; Bennett,1,0,32,31
1656099757460,MATH 142A,A02,083220,Chow; Bennett,8,0,32,24
1656099757460,MATH 142A,A03,093480,Staff,5,0,32,27
1656099757460,MATH 142A,B03,093481,Staff,4,0,32,28
1656099757460,MATH 142A,B04,093558,Staff,6,0,32,26
1656099757460,MATH 142A,B05,093559,Staff,0,0,32,32
1656099763483,MATH 193A,A01,083224,Rotar; Vladimir,1,2,34,33
1656099763483,MATH 193A,A02,083225,Rotar; Vladimir,2,0,34,32
1656099763483,MATH 193A,A03,083781,Rotar; Vladimir,2,0,34,32
1656099763483,MATH 193A,A04,083782,Rotar; Vladimir,6,0,34,28
1656099763483,MATH 193A,A05,093482,Rotar; Vladimir,1,0,34,33
1656099769508,MATH 197,001,091859,McAuley; Julian John,9999,0,9999,0
1656099769508,MATH 197,002,095566,Kedlaya; Kiran S.,9997,0,9999,2
1656099769508,MATH 197,003,095567,Xiao; Ming,9999,0,9999,0
1656099769508,MATH 197,004,095571,Perols; Johan Lars,9998,0,9999,1
1656099776578,COGS 9,A01,083615,Shannon; Kyle Michael,5,1,75,70
1656099782608,COGS 11,A01,083617,Boyle; Mary E. T.,16,3,48,32
1656099788638,COGS 13,A01,083071,Bastos; Amalia Pinkusfeld,8,3,71,63
1656099794667,COGS 14A,A01,092681,Semenuks; Arturs,8,24,100,92
1656099800694,COGS 14B,A01,083073,Cheng; Tzu-Han,7,0,63,56
1656099806718,COGS 17,A01,092677,Semenuks; Arturs,13,6,81,68
1656099812740,COGS 100,A01,083619,Allen; Michael Gordon,7,4,70,63
1656099818776,COGS 101A,A01,083621,Davis; Joshua Daniel,7,3,68,61
1656099824804,COGS 101B,A01,091572,Allen; Michael Gordon,6,0,65,59
1656099830832,COGS 101C,A01,083625,Delgado; Tania,11,0,35,24
1656099836858,COGS 107A,A01,083627,Boyle; Mary E. T.,5,4,60,55
1656099842887,COGS 118A,A01,083075,Gupta; Anjum,24,17,76,52
1656099848911,CSE 3,A50,083646,Miranda; Gregory Joseph,18,0,50,32
1656099854944,CSE 8A,A50,083650,Miranda; Gregory Joseph,13,13,56,43
1656099860971,CSE 11,A01,083080,Cao; Yingjun,1,60,40,39
1656099866995,CSE 12,A01,083652,Krause-Levy; Sophia Louisa,14,8,120,106
1656099873023,CSE 15L,A01,083654,Morris; Justin Loren,5,2,50,45
1656099873023,CSE 15L,A02,083655,Morris; Justin Loren,7,2,50,43
1656099879045,CSE 20,A01,083657,Tran; Khoa Dang,31,0,80,49
1656099885077,CSE 21,A01,095574,Bach; Quang Tran,26,0,48,22
1656099891105,CSE 30,A01,083084,Eldon; John,3,11,80,77
1656099891105,CSE 30,B01,095061,Bhaskar; Nishant,4,5,50,46
1656099897140,CSE 100,A01,083659,Cao; Yingjun,2,23,70,68
1656099903164,CSE 134B,A01,083661,Powell; Thomas Allan,10,7,100,90
1656099909189,CSE 140,A01,083663,Gungor; Onat,9,0,85,76
1656099915211,CSE 140L,A01,083088,Eldon; John,8,0,100,92
1656099921234,CSE 175,A01,083665,Kumar; Rakesh,1,0,25,24
1656099927261,CSE 190,A00,092507,Dubnov; Shlomo,2,0,20,18
1656099933297,ECE 45,A01,083139,Congero; Spencer William,5,3,75,70
1656099939320,ECE 65,A50,083695,Saad; Andrew S,8,0,30,22
1656099939320,ECE 65,A51,095125,Staff,23,0,26,3
1656099945343,ECE 109,A01,091882,Touri; Behrouz,7,5,70,63
1656099951373,ECE 180,A00,083140,Abi Samra; Nicholas Camill,1,0,30,29
1656099951373,ECE 180,B00,083141,Abi Samra; Nicholas Camill,4,8,30,26
1656099957402,MATH 10A,A01,083735,Patchell; Gregory David,0,0,30,30
1656099957402,MATH 10A,A02,083736,Patchell; Gregory David,22,0,30,8
1656099957402,MATH 10A,A03,083737,Patchell; Gregory David,16,0,30,14
1656099963432,MATH 10B,A01,083207,Lim; Seonhee,3,2,34,31
1656099963432,MATH 10B,A02,083208,Lim; Seonhee,10,2,35,25
1656099963432,MATH 10B,A03,093472,Staff,4,2,34,30
1656099963432,MATH 10B,B01,083739,Sinha; Shubham,12,0,30,18
1656099969460,MATH 18,A01,083743,Cinel; Cameron Alexander,7,0,30,23
1656099969460,MATH 18,A02,083744,Cinel; Cameron Alexander,10,0,30,20
1656099969460,MATH 18,A03,083745,Cinel; Cameron Alexander,3,0,30,27
1656099969460,MATH 18,B01,083748,Ma; Zilu,0,0,36,36
1656099969460,MATH 18,B02,083749,Ma; Zilu,0,0,36,36
1656099969460,MATH 18,B03,083750,Ma; Zilu,0,0,36,36
1656099969460,MATH 18,B04,083751,Ma; Zilu,0,0,36,36
1656099969460,MATH 18,B05,093473,Staff,3,0,36,33
1656099969460,MATH 18,B06,093474,Staff,3,0,36,33
1656099975483,MATH 20A,A01,083754,Zheng; Zequn,11,0,40,29
1656099981507,MATH 20B,A01,083756,Briones; Jor-el Thomas Caparas,0,0,36,36
1656099981507,MATH 20B,A02,083757,Briones; Jor-el Thomas Caparas,1,0,36,35
1656099981507,MATH 20B,A03,093475,Staff,3,0,36,33
1656099987532,MATH 20C,A01,083760,Briones; Jor-el Thomas Caparas,2,2,35,33
1656099987532,MATH 20C,A02,083761,Briones; Jor-el Thomas Caparas,9,1,35,26
1656099987532,MATH 20C,A03,093476,Staff,1,1,35,34
1656099987532,MATH 20C,B01,083762,Bach; Quang Tran,2,0,30,28
1656099993565,MATH 20D,A01,083765,Tran; Brian Kha,3,0,30,27
1656099993565,MATH 20D,A02,083766,Tran; Brian Kha,0,1,30,30
1656099993565,MATH 20D,A03,083767,Tran; Brian Kha,2,0,30,28
1656099999596,MATH 20E,A01,083771,Ganguly; Soumya,4,1,32,28
1656099999596,MATH 20E,A02,083772,Ganguly; Soumya,2,1,32,30
1656099999596,MATH 20E,B01,083773,Ciotti; Benjamin,14,0,35,21
1656099999596,MATH 20E,B02,083774,Ciotti; Benjamin,15,0,35,20
1656100005628,MATH 103A,A01,083777,Greenfeld; Be'Eri,3,0,36,33
1656100005628,MATH 103A,A02,083778,Greenfeld; Be'Eri,2,0,36,34
1656100005628,MATH 103A,A03,093561,Staff,4,1,36,32
1656100005628,MATH 103A,B01,083779,Greenfeld; Be'Eri,8,1,36,28
1656100005628,MATH 103A,B02,083780,Greenfeld; Be'Eri,0,1,36,36
1656100005628,MATH 103A,B03,093562,Staff,0,0,36,36
1656100011655,MATH 105,A01,085443,Carter; Anne Toulson,4,1,35,31
1656100011655,MATH 105,A02,093477,Staff,10,0,35,25
1656100017683,MATH 109,A01,083213,Ganzberger; Geoffrey Michael,1,1,34,33
1656100017683,MATH 109,A02,083214,Ganzberger; Geoffrey Michael,0,0,34,34
1656100017683,MATH 109,A03,093478,Staff,3,0,34,31
1656100017683,MATH 109,B01,083215,Ganzberger; Geoffrey Michael,3,0,32,29
1656100017683,MATH 109,B02,083216,Ganzberger; Geoffrey Michael,1,0,32,31
1656100017683,MATH 109,B03,093479,Staff,4,0,32,28
1656100023713,MATH 142A,A01,083219,Chow; Bennett,1,0,32,31
1656100023713,MATH 142A,A02,083220,Chow; Bennett,8,0,32,24
1656100023713,MATH 142A,A03,093480,Staff,5,0,32,27
1656100023713,MATH 142A,B03,093481,Staff,4,0,32,28
1656100023713,MATH 142A,B04,093558,Staff,6,0,32,26
1656100023713,MATH 142A,B05,093559,Staff,0,0,32,32
1656100029741,MATH 193A,A01,083224,Rotar; Vladimir,1,2,34,33
1656100029741,MATH 193A,A02,083225,Rotar; Vladimir,2,0,34,32
1656100029741,MATH 193A,A03,083781,Rotar; Vladimir,2,0,34,32
1656100029741,MATH 193A,A04,083782,Rotar; Vladimir,6,0,34,28
1656100029741,MATH 193A,A05,093482,Rotar; Vladimir,1,0,34,33
1656100035763,MATH 197,001,091859,McAuley; Julian John,9999,0,9999,0
1656100035763,MATH 197,002,095566,Kedlaya; Kiran S.,9997,0,9999,2
1656100035763,MATH 197,003,095567,Xiao; Ming,9999,0,9999,0
1656100035763,MATH 197,004,095571,Perols; Johan Lars,9998,0,9999,1
1656100042826,COGS 9,A01,083615,Shannon; Kyle Michael,5,1,75,70
1656100048863,COGS 11,A01,083617,Boyle; Mary E. T.,16,2,48,32
1656100054886,COGS 13,A01,083071,Bastos; Amalia Pinkusfeld,8,3,71,63
1656100060909,COGS 14A,A01,092681,Semenuks; Arturs,8,24,100,92
1656100066938,COGS 14B,A01,083073,Cheng; Tzu-Han,7,0,63,56
1656100072960,COGS 17,A01,092677,Semenuks; Arturs,13,6,81,68
1656100078984,COGS 100,A01,083619,Allen; Michael Gordon,7,4,70,63
1656100085010,COGS 101A,A01,083621,Davis; Joshua Daniel,7,3,68,61
1656100091038,COGS 101B,A01,091572,Allen; Michael Gordon,6,0,65,59
1656100097067,COGS 101C,A01,083625,Delgado; Tania,11,0,35,24
1656100103098,COGS 107A,A01,083627,Boyle; Mary E. T.,5,4,60,55
1656100109122,COGS 118A,A01,083075,Gupta; Anjum,24,17,76,52
1656100115152,CSE 3,A50,083646,Miranda; Gregory Joseph,18,0,50,32
1656100121175,CSE 8A,A50,083650,Miranda; Gregory Joseph,13,13,56,43
1656100127202,CSE 11,A01,083080,Cao; Yingjun,1,60,40,39
1656100133226,CSE 12,A01,083652,Krause-Levy; Sophia Louisa,14,8,120,106
1656100150730,CSE 15L,A01,083654,Morris; Justin Loren,5,2,50,45
1656100150730,CSE 15L,A02,083655,Morris; Justin Loren,7,2,50,43
1656100156753,CSE 20,A01,083657,Tran; Khoa Dang,31,0,80,49
1656100162780,CSE 21,A01,095574,Bach; Quang Tran,26,0,48,22
1656100168809,CSE 30,A01,083084,Eldon; John,3,11,80,77
1656100168809,CSE 30,B01,095061,Bhaskar; Nishant,4,5,50,46
1656100174837,CSE 100,A01,083659,Cao; Yingjun,2,23,70,68
1656100180863,CSE 134B,A01,083661,Powell; Thomas Allan,10,7,100,90
1656100186890,CSE 140,A01,083663,Gungor; Onat,9,0,85,76
1656100192920,CSE 140L,A01,083088,Eldon; John,8,0,100,92
1656100198948,CSE 175,A01,083665,Kumar; Rakesh,1,0,25,24
1656100204973,CSE 190,A00,092507,Dubnov; Shlomo,2,0,20,18
1656100210997,ECE 45,A01,083139,Congero; Spencer William,5,3,75,70
1656100217028,ECE 65,A50,083695,Saad; Andrew S,8,0,30,22
1656100217028,ECE 65,A51,095125,Staff,23,0,26,3
1656100223056,ECE 109,A01,091882,Touri; Behrouz,7,5,70,63
1656100229080,ECE 180,A00,083140,Abi Samra; Nicholas Camill,1,0,30,29
1656100229080,ECE 180,B00,083141,Abi Samra; Nicholas Camill,4,8,30,26
1656100235104,MATH 10A,A01,083735,Patchell; Gregory David,0,0,30,30
1656100235104,MATH 10A,A02,083736,Patchell; Gregory David,22,0,30,8
1656100235104,MATH 10A,A03,083737,Patchell; Gregory David,16,0,30,14
1656100241129,MATH 10B,A01,083207,Lim; Seonhee,3,2,34,31
1656100241129,MATH 10B,A02,083208,Lim; Seonhee,10,2,35,25
1656100241129,MATH 10B,A03,093472,Staff,4,2,34,30
1656100241129,MATH 10B,B01,083739,Sinha; Shubham,12,0,30,18
1656100247169,MATH 18,A01,083743,Cinel; Cameron Alexander,7,0,30,23
1656100247169,MATH 18,A02,083744,Cinel; Cameron Alexander,10,0,30,20
1656100247169,MATH 18,A03,083745,Cinel; Cameron Alexander,3,0,30,27
1656100247169,MATH 18,B01,083748,Ma; Zilu,0,0,36,36
1656100247169,MATH 18,B02,083749,Ma; Zilu,0,0,36,36
1656100247169,MATH 18,B03,083750,Ma; Zilu,0,0,36,36
1656100247169,MATH 18,B04,083751,Ma; Zilu,0,0,36,36
1656100247169,MATH 18,B05,093473,Staff,3,0,36,33
1656100247169,MATH 18,B06,093474,Staff,3,0,36,33
1656100253204,MATH 20A,A01,083754,Zheng; Zequn,11,0,40,29
1656100259231,MATH 20B,A01,083756,Briones; Jor-el Thomas Caparas,0,0,36,36
1656100259231,MATH 20B,A02,083757,Briones; Jor-el Thomas Caparas,1,0,36,35
1656100259231,MATH 20B,A03,093475,Staff,3,0,36,33
1656100265254,MATH 20C,A01,083760,Briones; Jor-el Thomas Caparas,2,2,35,33
1656100265254,MATH 20C,A02,083761,Briones; Jor-el Thomas Caparas,9,1,35,26
1656100265254,MATH 20C,A03,093476,Staff,1,1,35,34
1656100265254,MATH 20C,B01,083762,Bach; Quang Tran,2,0,30,28
1656100271300,MATH 20D,A01,083765,Tran; Brian Kha,3,0,30,27
1656100271300,MATH 20D,A02,083766,Tran; Brian Kha,0,1,30,30
1656100271300,MATH 20D,A03,083767,Tran; Brian Kha,2,0,30,28
1656100277329,MATH 20E,A01,083771,Ganguly; Soumya,4,1,32,28
1656100277329,MATH 20E,A02,083772,Ganguly; Soumya,2,1,32,30
1656100277329,MATH 20E,B01,083773,Ciotti; Benjamin,14,0,35,21
1656100277329,MATH 20E,B02,083774,Ciotti; Benjamin,15,0,35,20
1656100283360,MATH 103A,A01,083777,Greenfeld; Be'Eri,3,0,36,33
1656100283360,MATH 103A,A02,083778,Greenfeld; Be'Eri,2,0,36,34
1656100283360,MATH 103A,A03,093561,Staff,4,1,36,32
1656100283360,MATH 103A,B01,083779,Greenfeld; Be'Eri,8,1,36,28
1656100283360,MATH 103A,B02,083780,Greenfeld; Be'Eri,0,1,36,36
1656100283360,MATH 103A,B03,093562,Staff,0,0,36,36
1656100289384,MATH 105,A01,085443,Carter; Anne Toulson,4,1,35,31
1656100289384,MATH 105,A02,093477,Staff,10,0,35,25
1656100295420,MATH 109,A01,083213,Ganzberger; Geoffrey Michael,1,1,34,33
1656100295420,MATH 109,A02,083214,Ganzberger; Geoffrey Michael,0,0,34,34
1656100295420,MATH 109,A03,093478,Staff,3,0,34,31
1656100295420,MATH 109,B01,083215,Ganzberger; Geoffrey Michael,3,0,32,29
1656100295420,MATH 109,B02,083216,Ganzberger; Geoffrey Michael,1,0,32,31
1656100295420,MATH 109,B03,093479,Staff,4,0,32,28
1656100301462,MATH 142A,A01,083219,Chow; Bennett,1,0,32,31
1656100301462,MATH 142A,A02,083220,Chow; Bennett,8,0,32,24
1656100301462,MATH 142A,A03,093480,Staff,5,0,32,27
1656100301462,MATH 142A,B03,093481,Staff,4,0,32,28
1656100301462,MATH 142A,B04,093558,Staff,6,0,32,26
1656100301462,MATH 142A,B05,093559,Staff,0,0,32,32
1656100307502,MATH 193A,A01,083224,Rotar; Vladimir,1,2,34,33
1656100307502,MATH 193A,A02,083225,Rotar; Vladimir,2,0,34,32
1656100307502,MATH 193A,A03,083781,Rotar; Vladimir,2,0,34,32
1656100307502,MATH 193A,A04,083782,Rotar; Vladimir,6,0,34,28
1656100307502,MATH 193A,A05,093482,Rotar; Vladimir,1,0,34,33
1656100313525,MATH 197,001,091859,McAuley; Julian John,9999,0,9999,0
1656100313525,MATH 197,002,095566,Kedlaya; Kiran S.,9997,0,9999,2
1656100313525,MATH 197,003,095567,Xiao; Ming,9999,0,9999,0
1656100313525,MATH 197,004,095571,Perols; Johan Lars,9998,0,9999,1
1656100320587,COGS 9,A01,083615,Shannon; Kyle Michael,5,1,75,70
1656100326618,COGS 11,A01,083617,Boyle; Mary E. T.,16,2,48,32
1656100332645,COGS 13,A01,083071,Bastos; Amalia Pinkusfeld,8,3,71,63
1656100338668,COGS 14A,A01,092681,Semenuks; Arturs,8,24,100,92
1656100344693,COGS 14B,A01,083073,Cheng; Tzu-Han,7,0,63,56
1656100350720,COGS 17,A01,092677,Semenuks; Arturs,13,6,81,68
1656100356834,COGS 100,A01,083619,Allen; Michael Gordon,7,4,70,63
1656100362862,COGS 101A,A01,083621,Davis; Joshua Daniel,7,3,68,61
1656100368887,COGS 101B,A01,091572,Allen; Michael Gordon,6,0,65,59
1656100374911,COGS 101C,A01,083625,Delgado; Tania,11,0,35,24
1656100380941,COGS 107A,A01,083627,Boyle; Mary E. T.,5,4,60,55
1656100386965,COGS 118A,A01,083075,Gupta; Anjum,24,17,76,52
1656100392991,CSE 3,A50,083646,Miranda; Gregory Joseph,18,0,50,32
1656100399015,CSE 8A,A50,083650,Miranda; Gregory Joseph,13,13,56,43
1656100405042,CSE 11,A01,083080,Cao; Yingjun,1,60,40,39
1656100411075,CSE 12,A01,083652,Krause-Levy; Sophia Louisa,14,8,120,106
1656100417098,CSE 15L,A01,083654,Morris; Justin Loren,5,2,50,45
1656100417098,CSE 15L,A02,083655,Morris; Justin Loren,7,2,50,43
1656100423122,CSE 20,A01,083657,Tran; Khoa Dang,31,0,80,49
1656100429153,CSE 21,A01,095574,Bach; Quang Tran,26,0,48,22
1656100435186,CSE 30,A01,083084,Eldon; John,3,11,80,77
1656100435186,CSE 30,B01,095061,Bhaskar; Nishant,4,5,50,46
1656100441210,CSE 100,A01,083659,Cao; Yingjun,2,23,70,68
1656100447239,CSE 134B,A01,083661,Powell; Thomas Allan,10,7,100,90
1656100453267,CSE 140,A01,083663,Gungor; Onat,9,0,85,76
1656100459295,CSE 140L,A01,083088,Eldon; John,8,0,100,92
1656100465320,CSE 175,A01,083665,Kumar; Rakesh,1,0,25,24
1656100471342,CSE 190,A00,092507,Dubnov; Shlomo,2,0,20,18
1656100477365,ECE 45,A01,083139,Congero; Spencer William,5,3,75,70
1656100483389,ECE 65,A50,083695,Saad; Andrew S,8,0,30,22
1656100483389,ECE 65,A51,095125,Staff,23,0,26,3
1656100489412,ECE 109,A01,091882,Touri; Behrouz,7,5,70,63
1656100495438,ECE 180,A00,083140,Abi Samra; Nicholas Camill,1,0,30,29
1656100495438,ECE 180,B00,083141,Abi Samra; Nicholas Camill,4,8,30,26
1656100501464,MATH 10A,A01,083735,Patchell; Gregory David,0,0,30,30
1656100501464,MATH 10A,A02,083736,Patchell; Gregory David,22,0,30,8
1656100501464,MATH 10A,A03,083737,Patchell; Gregory David,16,0,30,14
1656100507493,MATH 10B,A01,083207,Lim; Seonhee,3,2,34,31
1656100507493,MATH 10B,A02,083208,Lim; Seonhee,10,2,35,25
1656100507493,MATH 10B,A03,093472,Staff,4,2,34,30
1656100507493,MATH 10B,B01,083739,Sinha; Shubham,12,0,30,18
1656100513522,MATH 18,A01,083743,Cinel; Cameron Alexander,7,0,30,23
1656100513522,MATH 18,A02,083744,Cinel; Cameron Alexander,10,0,30,20
1656100513522,MATH 18,A03,083745,Cinel; Cameron Alexander,3,0,30,27
1656100513522,MATH 18,B01,083748,Ma; Zilu,0,0,36,36
1656100513522,MATH 18,B02,083749,Ma; Zilu,0,0,36,36
1656100513522,MATH 18,B03,083750,Ma; Zilu,0,0,36,36
1656100513522,MATH 18,B04,083751,Ma; Zilu,0,0,36,36
1656100513522,MATH 18,B05,093473,Staff,3,0,36,33
1656100513522,MATH 18,B06,093474,Staff,3,0,36,33
1656100519556,MATH 20A,A01,083754,Zheng; Zequn,11,0,40,29
1656100525597,MATH 20B,A01,083756,Briones; Jor-el Thomas Caparas,0,0,36,36
1656100525597,MATH 20B,A02,083757,Briones; Jor-el Thomas Caparas,1,0,36,35
1656100525597,MATH 20B,A03,093475,Staff,3,0,36,33
1656100531622,MATH 20C,A01,083760,Briones; Jor-el Thomas Caparas,2,2,35,33
1656100531622,MATH 20C,A02,083761,Briones; Jor-el Thomas Caparas,9,1,35,26
1656100531622,MATH 20C,A03,093476,Staff,1,1,35,34
1656100531622,MATH 20C,B01,083762,Bach; Quang Tran,2,0,30,28
1656100537651,MATH 20D,A01,083765,Tran; Brian Kha,3,0,30,27
1656100537651,MATH 20D,A02,083766,Tran; Brian Kha,0,1,30,30
1656100537651,MATH 20D,A03,083767,Tran; Brian Kha,2,0,30,28
1656100543682,MATH 20E,A01,083771,Ganguly; Soumya,4,1,32,28
1656100543682,MATH 20E,A02,083772,Ganguly; Soumya,2,1,32,30
1656100543682,MATH 20E,B01,083773,Ciotti; Benjamin,14,0,35,21
1656100543682,MATH 20E,B02,083774,Ciotti; Benjamin,15,0,35,20
1656100549713,MATH 103A,A01,083777,Greenfeld; Be'Eri,3,0,36,33
1656100549713,MATH 103A,A02,083778,Greenfeld; Be'Eri,2,0,36,34
1656100549713,MATH 103A,A03,093561,Staff,4,1,36,32
1656100549713,MATH 103A,B01,083779,Greenfeld; Be'Eri,8,1,36,28
1656100549713,MATH 103A,B02,083780,Greenfeld; Be'Eri,0,1,36,36
1656100549713,MATH 103A,B03,093562,Staff,0,0,36,36
1656100555736,MATH 105,A01,085443,Carter; Anne Toulson,4,1,35,31
1656100555736,MATH 105,A02,093477,Staff,9,0,35,26
1656100561760,MATH 109,A01,083213,Ganzberger; Geoffrey Michael,1,1,34,33
1656100561760,MATH 109,A02,083214,Ganzberger; Geoffrey Michael,0,0,34,34
1656100561760,MATH 109,A03,093478,Staff,2,0,34,32
1656100561760,MATH 109,B01,083215,Ganzberger; Geoffrey Michael,3,0,32,29
1656100561760,MATH 109,B02,083216,Ganzberger; Geoffrey Michael,1,0,32,31
1656100561760,MATH 109,B03,093479,Staff,4,0,32,28
1656100567808,MATH 142A,A01,083219,Chow; Bennett,1,0,32,31
1656100567808,MATH 142A,A02,083220,Chow; Bennett,8,0,32,24
1656100567808,MATH 142A,A03,093480,Staff,5,0,32,27
1656100567808,MATH 142A,B03,093481,Staff,4,0,32,28
1656100567808,MATH 142A,B04,093558,Staff,6,0,32,26
1656100567808,MATH 142A,B05,093559,Staff,0,0,32,32
1656100573837,MATH 193A,A01,083224,Rotar; Vladimir,1,2,34,33
1656100573837,MATH 193A,A02,083225,Rotar; Vladimir,2,0,34,32
1656100573837,MATH 193A,A03,083781,Rotar; Vladimir,1,0,34,33
1656100573837,MATH 193A,A04,083782,Rotar; Vladimir,6,0,34,28
1656100573837,MATH 193A,A05,093482,Rotar; Vladimir,1,0,34,33
1656100579865,MATH 197,001,091859,McAuley; Julian John,9999,0,9999,0
1656100579865,MATH 197,002,095566,Kedlaya; Kiran S.,9997,0,9999,2
1656100579865,MATH 197,003,095567,Xiao; Ming,9999,0,9999,0
1656100579865,MATH 197,004,095571,Perols; Johan Lars,9998,0,9999,1
1656100586932,COGS 9,A01,083615,Shannon; Kyle Michael,5,1,75,70
1656100592958,COGS 11,A01,083617,Boyle; Mary E. T.,16,2,48,32
1656100598985,COGS 13,A01,083071,Bastos; Amalia Pinkusfeld,8,3,71,63
1656100605016,COGS 14A,A01,092681,Semenuks; Arturs,8,24,100,92
1656100611040,COGS 14B,A01,083073,Cheng; Tzu-Han,7,0,63,56
1656100617065,COGS 17,A01,092677,Semenuks; Arturs,13,6,81,68
1656100623094,COGS 100,A01,083619,Allen; Michael Gordon,7,4,70,63
1656100629117,COGS 101A,A01,083621,Davis; Joshua Daniel,7,3,68,61
1656100635145,COGS 101B,A01,091572,Allen; Michael Gordon,6,0,65,59
1656100641169,COGS 101C,A01,083625,Delgado; Tania,11,0,35,24
1656100647199,COGS 107A,A01,083627,Boyle; Mary E. T.,5,4,60,55
1656100653222,COGS 118A,A01,083075,Gupta; Anjum,24,17,76,52
1656100659251,CSE 3,A50,083646,Miranda; Gregory Joseph,18,0,50,32
1656100665274,CSE 8A,A50,083650,Miranda; Gregory Joseph,13,13,56,43
1656100671299,CSE 11,A01,083080,Cao; Yingjun,1,60,40,39
1656100677331,CSE 12,A01,083652,Krause-Levy; Sophia Louisa,14,8,120,106
1656100683362,CSE 15L,A01,083654,Morris; Justin Loren,5,2,50,45
1656100683362,CSE 15L,A02,083655,Morris; Justin Loren,7,2,50,43
1656100689388,CSE 20,A01,083657,Tran; Khoa Dang,31,0,80,49
1656100695422,CSE 21,A01,095574,Bach; Quang Tran,26,0,48,22
1656100701451,CSE 30,A01,083084,Eldon; John,3,11,80,77
1656100701451,CSE 30,B01,095061,Bhaskar; Nishant,4,5,50,46
1656100707490,CSE 100,A01,083659,Cao; Yingjun,2,23,70,68
1656100713515,CSE 134B,A01,083661,Powell; Thomas Allan,10,7,100,90
1656100719544,CSE 140,A01,083663,Gungor; Onat,9,0,85,76
1656100725584,CSE 140L,A01,083088,Eldon; John,8,0,100,92
1656100731609,CSE 175,A01,083665,Kumar; Rakesh,1,0,25,24
1656100737634,CSE 190,A00,092507,Dubnov; Shlomo,2,0,20,18
1656100743661,ECE 45,A01,083139,Congero; Spencer William,5,3,75,70
1656100749688,ECE 65,A50,083695,Saad; Andrew S,8,0,30,22
1656100749688,ECE 65,A51,095125,Staff,23,0,26,3
1656100755711,ECE 109,A01,091882,Touri; Behrouz,7,6,70,63
1656100761734,ECE 180,A00,083140,Abi Samra; Nicholas Camill,1,0,30,29
1656100761734,ECE 180,B00,083141,Abi Samra; Nicholas Camill,4,8,30,26
1656100767759,MATH 10A,A01,083735,Patchell; Gregory David,0,0,30,30
1656100767759,MATH 10A,A02,083736,Patchell; Gregory David,22,0,30,8
1656100767759,MATH 10A,A03,083737,Patchell; Gregory David,16,0,30,14
1656100773793,MATH 10B,A01,083207,Lim; Seonhee,3,2,34,31
1656100773793,MATH 10B,A02,083208,Lim; Seonhee,10,2,35,25
1656100773793,MATH 10B,A03,093472,Staff,4,2,34,30
1656100773793,MATH 10B,B01,083739,Sinha; Shubham,12,0,30,18
1656100779817,MATH 18,A01,083743,Cinel; Cameron Alexander,7,0,30,23
1656100779817,MATH 18,A02,083744,Cinel; Cameron Alexander,10,0,30,20
1656100779817,MATH 18,A03,083745,Cinel; Cameron Alexander,3,0,30,27
1656100779817,MATH 18,B01,083748,Ma; Zilu,0,0,36,36
1656100779817,MATH 18,B02,083749,Ma; Zilu,0,0,36,36
1656100779817,MATH 18,B03,083750,Ma; Zilu,0,0,36,36
1656100779817,MATH 18,B04,083751,Ma; Zilu,0,0,36,36
1656100779817,MATH 18,B05,093473,Staff,3,0,36,33
1656100779817,MATH 18,B06,093474,Staff,3,0,36,33
1656100785846,MATH 20A,A01,083754,Zheng; Zequn,11,0,40,29
1656100791871,MATH 20B,A01,083756,Briones; Jor-el Thomas Caparas,0,0,36,36
1656100791871,MATH 20B,A02,083757,Briones; Jor-el Thomas Caparas,1,0,36,35
1656100791871,MATH 20B,A03,093475,Staff,3,0,36,33
1656100797900,MATH 20C,A01,083760,Briones; Jor-el Thomas Caparas,2,2,35,33
1656100797900,MATH 20C,A02,083761,Briones; Jor-el Thomas Caparas,9,1,35,26
1656100797900,MATH 20C,A03,093476,Staff,1,1,35,34
1656100797900,MATH 20C,B01,083762,Bach; Quang Tran,1,0,30,29
1656100803928,MATH 20D,A01,083765,Tran; Brian Kha,3,0,30,27
1656100803928,MATH 20D,A02,083766,Tran; Brian Kha,0,1,30,30
1656100803928,MATH 20D,A03,083767,Tran; Brian Kha,2,0,30,28
1656100809950,MATH 20E,A01,083771,Ganguly; Soumya,4,1,32,28
1656100809950,MATH 20E,A02,083772,Ganguly; Soumya,2,1,32,30
1656100809950,MATH 20E,B01,083773,Ciotti; Benjamin,14,0,35,21
1656100809950,MATH 20E,B02,083774,Ciotti; Benjamin,15,0,35,20
1656100815973,MATH 103A,A01,083777,Greenfeld; Be'Eri,3,0,36,33
1656100815973,MATH 103A,A02,083778,Greenfeld; Be'Eri,2,0,36,34
1656100815973,MATH 103A,A03,093561,Staff,4,1,36,32
1656100815973,MATH 103A,B01,083779,Greenfeld; Be'Eri,8,1,36,28
1656100815973,MATH 103A,B02,083780,Greenfeld; Be'Eri,0,1,36,36
1656100815973,MATH 103A,B03,093562,Staff,0,0,36,36
1656100822001,MATH 105,A01,085443,Carter; Anne Toulson,4,1,35,31
1656100822001,MATH 105,A02,093477,Staff,9,0,35,26
1656100828025,MATH 109,A01,083213,Ganzberger; Geoffrey Michael,1,1,34,33
1656100828025,MATH 109,A02,083214,Ganzberger; Geoffrey Michael,0,0,34,34
1656100828025,MATH 109,A03,093478,Staff,2,0,34,32
1656100828025,MATH 109,B01,083215,Ganzberger; Geoffrey Michael,3,0,32,29
1656100828025,MATH 109,B02,083216,Ganzberger; Geoffrey Michael,1,0,32,31
1656100828025,MATH 109,B03,093479,Staff,4,0,32,28
1656100834048,MATH 142A,A01,083219,Chow; Bennett,1,0,32,31
1656100834048,MATH 142A,A02,083220,Chow; Bennett,8,0,32,24
1656100834048,MATH 142A,A03,093480,Staff,5,0,32,27
1656100834048,MATH 142A,B03,093481,Staff,4,0,32,28
1656100834048,MATH 142A,B04,093558,Staff,6,0,32,26
1656100834048,MATH 142A,B05,093559,Staff,0,0,32,32
1656100840078,MATH 193A,A01,083224,Rotar; Vladimir,1,2,34,33
1656100840078,MATH 193A,A02,083225,Rotar; Vladimir,2,0,34,32
1656100840078,MATH 193A,A03,083781,Rotar; Vladimir,1,0,34,33
1656100840078,MATH 193A,A04,083782,Rotar; Vladimir,6,0,34,28
1656100840078,MATH 193A,A05,093482,Rotar; Vladimir,1,0,34,33
1656100846109,MATH 197,001,091859,McAuley; Julian John,9999,0,9999,0
1656100846109,MATH 197,002,095566,Kedlaya; Kiran S.,9997,0,9999,2
1656100846109,MATH 197,003,095567,Xiao; Ming,9999,0,9999,0
1656100846109,MATH 197,004,095571,Perols; Johan Lars,9998,0,9999,1
1656100853165,COGS 9,A01,083615,Shannon; Kyle Michael,5,1,75,70
1656100859202,COGS 11,A01,083617,Boyle; Mary E. T.,16,2,48,32
1656100865236,COGS 13,A01,083071,Bastos; Amalia Pinkusfeld,8,3,71,63
1656100871258,COGS 14A,A01,092681,Semenuks; Arturs,8,24,100,92
1656100877282,COGS 14B,A01,083073,Cheng; Tzu-Han,7,0,63,56
1656100883310,COGS 17,A01,092677,Semenuks; Arturs,13,6,81,68
1656100889340,COGS 100,A01,083619,Allen; Michael Gordon,7,4,70,63
1656100895368,COGS 101A,A01,083621,Davis; Joshua Daniel,7,3,68,61
1656100901400,COGS 101B,A01,091572,Allen; Michael Gordon,6,0,65,59
1656100907422,COGS 101C,A01,083625,Delgado; Tania,11,0,35,24
1656100913449,COGS 107A,A01,083627,Boyle; Mary E. T.,5,4,60,55
1656100919473,COGS 118A,A01,083075,Gupta; Anjum,24,17,76,52
1656100925504,CSE 3,A50,083646,Miranda; Gregory Joseph,18,0,50,32
1656100931527,CSE 8A,A50,083650,Miranda; Gregory Joseph,13,13,56,43
1656100937550,CSE 11,A01,083080,Cao; Yingjun,1,60,40,39
1656100943574,CSE 12,A01,083652,Krause-Levy; Sophia Louisa,14,8,120,106
1656100949601,CSE 15L,A01,083654,Morris; Justin Loren,5,2,50,45
1656100949601,CSE 15L,A02,083655,Morris; Justin Loren,7,2,50,43
1656100955711,CSE 20,A01,083657,Tran; Khoa Dang,31,0,80,49
1656100961739,CSE 21,A01,095574,Bach; Quang Tran,26,0,48,22
1656100967769,CSE 30,A01,083084,Eldon; John,3,11,80,77
1656100967769,CSE 30,B01,095061,Bhaskar; Nishant,4,5,50,46
1656100973795,CSE 100,A01,083659,Cao; Yingjun,2,23,70,68
1656100979824,CSE 134B,A01,083661,Powell; Thomas Allan,10,7,100,90
1656100985851,CSE 140,A01,083663,Gungor; Onat,9,0,85,76
1656100991873,CSE 140L,A01,083088,Eldon; John,8,0,100,92
1656100997896,CSE 175,A01,083665,Kumar; Rakesh,1,0,25,24
1656101003921,CSE 190,A00,092507,Dubnov; Shlomo,2,0,20,18
1656101009953,ECE 45,A01,083139,Congero; Spencer William,5,3,75,70
1656101015986,ECE 65,A50,083695,Saad; Andrew S,8,0,30,22
1656101015986,ECE 65,A51,095125,Staff,23,0,26,3
1656101022013,ECE 109,A01,091882,Touri; Behrouz,7,6,70,63
1656101028043,ECE 180,A00,083140,Abi Samra; Nicholas Camill,1,0,30,29
1656101028043,ECE 180,B00,083141,Abi Samra; Nicholas Camill,4,8,30,26
1656101034066,MATH 10A,A01,083735,Patchell; Gregory David,0,0,30,30
1656101034066,MATH 10A,A02,083736,Patchell; Gregory David,22,0,30,8
1656101034066,MATH 10A,A03,083737,Patchell; Gregory David,16,0,30,14
1656101040093,MATH 10B,A01,083207,Lim; Seonhee,3,3,34,31
1656101040093,MATH 10B,A02,083208,Lim; Seonhee,10,2,35,25
1656101040093,MATH 10B,A03,093472,Staff,4,2,34,30
1656101040093,MATH 10B,B01,083739,Sinha; Shubham,12,0,30,18
1656101046125,MATH 18,A01,083743,Cinel; Cameron Alexander,7,0,30,23
1656101046125,MATH 18,A02,083744,Cinel; Cameron Alexander,10,0,30,20
1656101046125,MATH 18,A03,083745,Cinel; Cameron Alexander,3,0,30,27
1656101046125,MATH 18,B01,083748,Ma; Zilu,0,0,36,36
1656101046125,MATH 18,B02,083749,Ma; Zilu,0,0,36,36
1656101046125,MATH 18,B03,083750,Ma; Zilu,0,0,36,36
1656101046125,MATH 18,B04,083751,Ma; Zilu,0,0,36,36
1656101046125,MATH 18,B05,093473,Staff,3,0,36,33
1656101046125,MATH 18,B06,093474,Staff,3,0,36,33
1656101052158,MATH 20A,A01,083754,Zheng; Zequn,11,0,40,29
1656101058185,MATH 20B,A01,083756,Briones; Jor-el Thomas Caparas,0,0,36,36
1656101058185,MATH 20B,A02,083757,Briones; Jor-el Thomas Caparas,1,0,36,35
1656101058185,MATH 20B,A03,093475,Staff,3,0,36,33
1656101064210,MATH 20C,A01,083760,Briones; Jor-el Thomas Caparas,2,2,35,33
1656101064210,MATH 20C,A02,083761,Briones; Jor-el Thomas Caparas,9,1,35,26
1656101064210,MATH 20C,A03,093476,Staff,1,1,35,34
1656101064210,MATH 20C,B01,083762,Bach; Quang Tran,1,0,30,29
1656101070237,MATH 20D,A01,083765,Tran; Brian Kha,3,0,30,27
1656101070237,MATH 20D,A02,083766,Tran; Brian Kha,0,1,30,30
1656101070237,MATH 20D,A03,083767,Tran; Brian Kha,2,0,30,28
1656101076261,MATH 20E,A01,083771,Ganguly; Soumya,4,1,32,28
1656101076261,MATH 20E,A02,083772,Ganguly; Soumya,2,2,32,30
1656101076261,MATH 20E,B01,083773,Ciotti; Benjamin,14,0,35,21
1656101076261,MATH 20E,B02,083774,Ciotti; Benjamin,15,0,35,20
1656101082297,MATH 103A,A01,083777,Greenfeld; Be'Eri,3,0,36,33
1656101082297,MATH 103A,A02,083778,Greenfeld; Be'Eri,2,0,36,34
1656101082297,MATH 103A,A03,093561,Staff,4,1,36,32
1656101082297,MATH 103A,B01,083779,Greenfeld; Be'Eri,8,1,36,28
1656101082297,MATH 103A,B02,083780,Greenfeld; Be'Eri,0,1,36,36
1656101082297,MATH 103A,B03,093562,Staff,0,0,36,36
1656101088322,MATH 105,A01,085443,Carter; Anne Toulson,4,1,35,31
1656101088322,MATH 105,A02,093477,Staff,9,0,35,26
1656101094344,MATH 109,A01,083213,Ganzberger; Geoffrey Michael,1,1,34,33
1656101094344,MATH 109,A02,083214,Ganzberger; Geoffrey Michael,0,0,34,34
1656101094344,MATH 109,A03,093478,Staff,2,0,34,32
1656101094344,MATH 109,B01,083215,Ganzberger; Geoffrey Michael,3,0,32,29
1656101094344,MATH 109,B02,083216,Ganzberger; Geoffrey Michael,1,0,32,31
1656101094344,MATH 109,B03,093479,Staff,4,0,32,28
1656101100374,MATH 142A,A01,083219,Chow; Bennett,1,0,32,31
1656101100374,MATH 142A,A02,083220,Chow; Bennett,8,0,32,24
1656101100374,MATH 142A,A03,093480,Staff,5,0,32,27
1656101100374,MATH 142A,B03,093481,Staff,4,0,32,28
1656101100374,MATH 142A,B04,093558,Staff,6,0,32,26
1656101100374,MATH 142A,B05,093559,Staff,0,0,32,32
1656101106398,MATH 193A,A01,083224,Rotar; Vladimir,1,2,34,33
1656101106398,MATH 193A,A02,083225,Rotar; Vladimir,2,0,34,32
1656101106398,MATH 193A,A03,083781,Rotar; Vladimir,1,0,34,33
1656101106398,MATH 193A,A04,083782,Rotar; Vladimir,6,0,34,28
1656101106398,MATH 193A,A05,093482,Rotar; Vladimir,1,0,34,33
1656101112421,MATH 197,001,091859,McAuley; Julian John,9999,0,9999,0
1656101112421,MATH 197,002,095566,Kedlaya; Kiran S.,9997,0,9999,2
1656101112421,MATH 197,003,095567,Xiao; Ming,9999,0,9999,0
1656101112421,MATH 197,004,095571,Perols; Johan Lars,9998,0,9999,1
1656101119481,COGS 9,A01,083615,Shannon; Kyle Michael,5,1,75,70
1656101125504,COGS 11,A01,083617,Boyle; Mary E. T.,16,2,48,32
1656101131526,COGS 13,A01,083071,Bastos; Amalia Pinkusfeld,8,3,71,63
1656101137553,COGS 14A,A01,092681,Semenuks; Arturs,8,24,100,92
1656101143580,COGS 14B,A01,083073,Cheng; Tzu-Han,7,0,63,56
1656101149607,COGS 17,A01,092677,Semenuks; Arturs,13,6,81,68
1656101155630,COGS 100,A01,083619,Allen; Michael Gordon,7,4,70,63
1656101161655,COGS 101A,A01,083621,Davis; Joshua Daniel,7,3,68,61
1656101167683,COGS 101B,A01,091572,Allen; Michael Gordon,6,0,65,59
1656101173710,COGS 101C,A01,083625,Delgado; Tania,11,0,35,24
1656101179736,COGS 107A,A01,083627,Boyle; Mary E. T.,5,4,60,55
1656101185759,COGS 118A,A01,083075,Gupta; Anjum,24,17,76,52
1656101191783,CSE 3,A50,083646,Miranda; Gregory Joseph,18,0,50,32
1656101197811,CSE 8A,A50,083650,Miranda; Gregory Joseph,13,13,56,43
1656101203838,CSE 11,A01,083080,Cao; Yingjun,1,60,40,39
1656101209865,CSE 12,A01,083652,Krause-Levy; Sophia Louisa,14,8,120,106
1656101215903,CSE 15L,A01,083654,Morris; Justin Loren,5,2,50,45
1656101215903,CSE 15L,A02,083655,Morris; Justin Loren,7,2,50,43
1656101221937,CSE 20,A01,083657,Tran; Khoa Dang,31,0,80,49
1656101227966,CSE 21,A01,095574,Bach; Quang Tran,26,0,48,22
1656101234001,CSE 30,A01,083084,Eldon; John,3,11,80,77
1656101234001,CSE 30,B01,095061,Bhaskar; Nishant,4,5,50,46
1656101240030,CSE 100,A01,083659,Cao; Yingjun,2,23,70,68
1656101246054,CSE 134B,A01,083661,Powell; Thomas Allan,10,7,100,90
1656101252079,CSE 140,A01,083663,Gungor; Onat,9,0,85,76
1656101258103,CSE 140L,A01,083088,Eldon; John,8,0,100,92
1656101264129,CSE 175,A01,083665,Kumar; Rakesh,1,0,25,24
1656101270153,CSE 190,A00,092507,Dubnov; Shlomo,2,0,20,18
1656101276187,ECE 45,A01,083139,Congero; Spencer William,5,3,75,70
1656101282210,ECE 65,A50,083695,Saad; Andrew S,8,0,30,22
1656101282210,ECE 65,A51,095125,Staff,23,0,26,3
1656101288234,ECE 109,A01,091882,Touri; Behrouz,7,6,70,63
1656101294260,ECE 180,A00,083140,Abi Samra; Nicholas Camill,1,0,30,29
1656101294260,ECE 180,B00,083141,Abi Samra; Nicholas Camill,4,8,30,26
1656101300283,MATH 10A,A01,083735,Patchell; Gregory David,0,0,30,30
1656101300283,MATH 10A,A02,083736,Patchell; Gregory David,22,0,30,8
1656101300283,MATH 10A,A03,083737,Patchell; Gregory David,16,0,30,14
1656101306309,MATH 10B,A01,083207,Lim; Seonhee,3,3,34,31
1656101306309,MATH 10B,A02,083208,Lim; Seonhee,10,2,35,25
1656101306309,MATH 10B,A03,093472,Staff,4,2,34,30
1656101306309,MATH 10B,B01,083739,Sinha; Shubham,12,0,30,18
1656101312333,MATH 18,A01,083743,Cinel; Cameron Alexander,7,0,30,23
1656101312333,MATH 18,A02,083744,Cinel; Cameron Alexander,10,0,30,20
1656101312333,MATH 18,A03,083745,Cinel; Cameron Alexander,3,0,30,27
1656101312333,MATH 18,B01,083748,Ma; Zilu,0,0,36,36
1656101312333,MATH 18,B02,083749,Ma; Zilu,0,0,36,36
1656101312333,MATH 18,B03,083750,Ma; Zilu,0,0,36,36
1656101312333,MATH 18,B04,083751,Ma; Zilu,0,0,36,36
1656101312333,MATH 18,B05,093473,Staff,3,0,36,33
1656101312333,MATH 18,B06,093474,Staff,3,0,36,33
1656101318360,MATH 20A,A01,083754,Zheng; Zequn,11,0,40,29
1656101324389,MATH 20B,A01,083756,Briones; Jor-el Thomas Caparas,0,0,36,36
1656101324389,MATH 20B,A02,083757,Briones; Jor-el Thomas Caparas,1,0,36,35
1656101324389,MATH 20B,A03,093475,Staff,3,0,36,33
1656101330425,MATH 20C,A01,083760,Briones; Jor-el Thomas Caparas,2,2,35,33
1656101330425,MATH 20C,A02,083761,Briones; Jor-el Thomas Caparas,9,1,35,26
1656101330425,MATH 20C,A03,093476,Staff,1,1,35,34
1656101330425,MATH 20C,B01,083762,Bach; Quang Tran,1,0,30,29
1656101336450,MATH 20D,A01,083765,Tran; Brian Kha,3,0,30,27
1656101336450,MATH 20D,A02,083766,Tran; Brian Kha,0,1,30,30
1656101336450,MATH 20D,A03,083767,Tran; Brian Kha,2,0,30,28
1656101342475,MATH 20E,A01,083771,Ganguly; Soumya,4,1,32,28
1656101342475,MATH 20E,A02,083772,Ganguly; Soumya,2,2,32,30
1656101342475,MATH 20E,B01,083773,Ciotti; Benjamin,14,0,35,21
1656101342475,MATH 20E,B02,083774,Ciotti; Benjamin,14,0,35,21
1656101348504,MATH 103A,A01,083777,Greenfeld; Be'Eri,3,0,36,33
1656101348504,MATH 103A,A02,083778,Greenfeld; Be'Eri,2,0,36,34
1656101348504,MATH 103A,A03,093561,Staff,4,1,36,32
1656101348504,MATH 103A,B01,083779,Greenfeld; Be'Eri,8,1,36,28
1656101348504,MATH 103A,B02,083780,Greenfeld; Be'Eri,0,1,36,36
1656101348504,MATH 103A,B03,093562,Staff,0,0,36,36
1656101354531,MATH 105,A01,085443,Carter; Anne Toulson,4,1,35,31
1656101354531,MATH 105,A02,093477,Staff,9,0,35,26
1656101360559,MATH 109,A01,083213,Ganzberger; Geoffrey Michael,1,1,34,33
1656101360559,MATH 109,A02,083214,Ganzberger; Geoffrey Michael,0,0,34,34
1656101360559,MATH 109,A03,093478,Staff,2,0,34,32
1656101360559,MATH 109,B01,083215,Ganzberger; Geoffrey Michael,3,0,32,29
1656101360559,MATH 109,B02,083216,Ganzberger; Geoffrey Michael,1,0,32,31
1656101360559,MATH 109,B03,093479,Staff,4,0,32,28
1656101366589,MATH 142A,A01,083219,Chow; Bennett,1,0,32,31
1656101366589,MATH 142A,A02,083220,Chow; Bennett,8,0,32,24
1656101366589,MATH 142A,A03,093480,Staff,5,0,32,27
1656101366589,MATH 142A,B03,093481,Staff,4,0,32,28
1656101366589,MATH 142A,B04,093558,Staff,6,0,32,26
1656101366589,MATH 142A,B05,093559,Staff,0,0,32,32
1656101372616,MATH 193A,A01,083224,Rotar; Vladimir,1,2,34,33
1656101372616,MATH 193A,A02,083225,Rotar; Vladimir,2,0,34,32
1656101372616,MATH 193A,A03,083781,Rotar; Vladimir,1,0,34,33
1656101372616,MATH 193A,A04,083782,Rotar; Vladimir,6,0,34,28
1656101372616,MATH 193A,A05,093482,Rotar; Vladimir,1,0,34,33
1656101378640,MATH 197,001,091859,McAuley; Julian John,9999,0,9999,0
1656101378640,MATH 197,002,095566,Kedlaya; Kiran S.,9997,0,9999,2
1656101378640,MATH 197,003,095567,Xiao; Ming,9999,0,9999,0
1656101378640,MATH 197,004,095571,Perols; Johan Lars,9998,0,9999,1
1656101385692,COGS 9,A01,083615,Shannon; Kyle Michael,5,1,75,70
1656101391718,COGS 11,A01,083617,Boyle; Mary E. T.,16,2,48,32
1656101397747,COGS 13,A01,083071,Bastos; Amalia Pinkusfeld,8,3,71,63
1656101403770,COGS 14A,A01,092681,Semenuks; Arturs,8,24,100,92
1656101409799,COGS 14B,A01,083073,Cheng; Tzu-Han,7,0,63,56
1656101415827,COGS 17,A01,092677,Semenuks; Arturs,13,6,81,68
1656101421865,COGS 100,A01,083619,Allen; Michael Gordon,7,4,70,63
1656101427892,COGS 101A,A01,083621,Davis; Joshua Daniel,7,3,68,61
1656101433923,COGS 101B,A01,091572,Allen; Michael Gordon,6,0,65,59
1656101439947,COGS 101C,A01,083625,Delgado; Tania,11,0,35,24
1656101445971,COGS 107A,A01,083627,Boyle; Mary E. T.,5,4,60,55
1656101451994,COGS 118A,A01,083075,Gupta; Anjum,24,17,76,52
1656101458017,CSE 3,A50,083646,Miranda; Gregory Joseph,18,0,50,32
1656101464045,CSE 8A,A50,083650,Miranda; Gregory Joseph,13,13,56,43
1656101470070,CSE 11,A01,083080,Cao; Yingjun,1,60,40,39
1656101476099,CSE 12,A01,083652,Krause-Levy; Sophia Louisa,14,8,120,106
1656101482122,CSE 15L,A01,083654,Morris; Justin Loren,5,2,50,45
1656101482122,CSE 15L,A02,083655,Morris; Justin Loren,7,2,50,43
1656101488145,CSE 20,A01,083657,Tran; Khoa Dang,31,0,80,49
1656101494186,CSE 21,A01,095574,Bach; Quang Tran,26,0,48,22
1656101500223,CSE 30,A01,083084,Eldon; John,3,11,80,77
1656101500223,CSE 30,B01,095061,Bhaskar; Nishant,4,5,50,46
1656101506246,CSE 100,A01,083659,Cao; Yingjun,2,23,70,68
1656101512277,CSE 134B,A01,083661,Powell; Thomas Allan,10,7,100,90
1656101518300,CSE 140,A01,083663,Gungor; Onat,9,0,85,76
1656101524329,CSE 140L,A01,083088,Eldon; John,8,0,100,92
1656101530369,CSE 175,A01,083665,Kumar; Rakesh,1,0,25,24
1656101536395,CSE 190,A00,092507,Dubnov; Shlomo,2,0,20,18
1656101542419,ECE 45,A01,083139,Congero; Spencer William,5,3,75,70
1656101548450,ECE 65,A50,083695,Saad; Andrew S,8,0,30,22
1656101548450,ECE 65,A51,095125,Staff,23,0,26,3
1656101554560,ECE 109,A01,091882,Touri; Behrouz,7,6,70,63
1656101560590,ECE 180,A00,083140,Abi Samra; Nicholas Camill,1,0,30,29
1656101560590,ECE 180,B00,083141,Abi Samra; Nicholas Camill,4,8,30,26
1656101566618,MATH 10A,A01,083735,Patchell; Gregory David,0,0,30,30
1656101566618,MATH 10A,A02,083736,Patchell; Gregory David,22,0,30,8
1656101566618,MATH 10A,A03,083737,Patchell; Gregory David,16,0,30,14
1656101572646,MATH 10B,A01,083207,Lim; Seonhee,3,3,34,31
1656101572646,MATH 10B,A02,083208,Lim; Seonhee,10,2,35,25
1656101572646,MATH 10B,A03,093472,Staff,4,2,34,30
1656101572646,MATH 10B,B01,083739,Sinha; Shubham,12,0,30,18
1656101578671,MATH 18,A01,083743,Cinel; Cameron Alexander,7,0,30,23
1656101578671,MATH 18,A02,083744,Cinel; Cameron Alexander,10,0,30,20
1656101578671,MATH 18,A03,083745,Cinel; Cameron Alexander,3,0,30,27
1656101578671,MATH 18,B01,083748,Ma; Zilu,0,0,36,36
1656101578671,MATH 18,B02,083749,Ma; Zilu,0,0,36,36
1656101578671,MATH 18,B03,083750,Ma; Zilu,0,0,36,36
1656101578671,MATH 18,B04,083751,Ma; Zilu,0,0,36,36
1656101578671,MATH 18,B05,093473,Staff,3,0,36,33
1656101578671,MATH 18,B06,093474,Staff,3,0,36,33
1656101584694,MATH 20A,A01,083754,Zheng; Zequn,11,0,40,29
1656101590721,MATH 20B,A01,083756,Briones; Jor-el Thomas Caparas,0,0,36,36
1656101590721,MATH 20B,A02,083757,Briones; Jor-el Thomas Caparas,1,0,36,35
1656101590721,MATH 20B,A03,093475,Staff,3,0,36,33
1656101596756,MATH 20C,A01,083760,Briones; Jor-el Thomas Caparas,2,2,35,33
1656101596756,MATH 20C,A02,083761,Briones; Jor-el Thomas Caparas,9,1,35,26
1656101596756,MATH 20C,A03,093476,Staff,1,1,35,34
1656101596756,MATH 20C,B01,083762,Bach; Quang Tran,1,0,30,29
1656101602781,MATH 20D,A01,083765,Tran; Brian Kha,3,0,30,27
1656101602781,MATH 20D,A02,083766,Tran; Brian Kha,0,1,30,30
1656101602781,MATH 20D,A03,083767,Tran; Brian Kha,2,0,30,28
1656101608829,MATH 20E,A01,083771,Ganguly; Soumya,4,1,32,28
1656101608829,MATH 20E,A02,083772,Ganguly; Soumya,2,2,32,30
1656101608829,MATH 20E,B01,083773,Ciotti; Benjamin,14,0,35,21
1656101608829,MATH 20E,B02,083774,Ciotti; Benjamin,14,0,35,21
1656101614866,MATH 103A,A01,083777,Greenfeld; Be'Eri,3,0,36,33
1656101614866,MATH 103A,A02,083778,Greenfeld; Be'Eri,2,0,36,34
1656101614866,MATH 103A,A03,093561,Staff,4,1,36,32
1656101614866,MATH 103A,B01,083779,Greenfeld; Be'Eri,8,1,36,28
1656101614866,MATH 103A,B02,083780,Greenfeld; Be'Eri,0,1,36,36
1656101614866,MATH 103A,B03,093562,Staff,0,0,36,36
1656101620894,MATH 105,A01,085443,Carter; Anne Toulson,4,1,35,31
1656101620894,MATH 105,A02,093477,Staff,9,0,35,26
1656101626919,MATH 109,A01,083213,Ganzberger; Geoffrey Michael,1,1,34,33
1656101626919,MATH 109,A02,083214,Ganzberger; Geoffrey Michael,0,0,34,34
1656101626919,MATH 109,A03,093478,Staff,2,0,34,32
1656101626919,MATH 109,B01,083215,Ganzberger; Geoffrey Michael,3,0,32,29
1656101626919,MATH 109,B02,083216,Ganzberger; Geoffrey Michael,1,0,32,31
1656101626919,MATH 109,B03,093479,Staff,4,0,32,28
1656101632949,MATH 142A,A01,083219,Chow; Bennett,1,0,32,31
1656101632949,MATH 142A,A02,083220,Chow; Bennett,8,0,32,24
1656101632949,MATH 142A,A03,093480,Staff,5,0,32,27
1656101632949,MATH 142A,B03,093481,Staff,4,0,32,28
1656101632949,MATH 142A,B04,093558,Staff,6,0,32,26
1656101632949,MATH 142A,B05,093559,Staff,0,0,32,32
1656101638971,MATH 193A,A01,083224,Rotar; Vladimir,1,2,34,33
1656101638971,MATH 193A,A02,083225,Rotar; Vladimir,2,0,34,32
1656101638971,MATH 193A,A03,083781,Rotar; Vladimir,1,0,34,33
1656101638971,MATH 193A,A04,083782,Rotar; Vladimir,6,0,34,28
1656101638971,MATH 193A,A05,093482,Rotar; Vladimir,1,0,34,33
1656101644998,MATH 197,001,091859,McAuley; Julian John,9999,0,9999,0
1656101644998,MATH 197,002,095566,Kedlaya; Kiran S.,9997,0,9999,2
1656101644998,MATH 197,003,095567,Xiao; Ming,9999,0,9999,0
1656101644998,MATH 197,004,095571,Perols; Johan Lars,9998,0,9999,1
1656101652070,COGS 9,A01,083615,Shannon; Kyle Michael,5,1,75,70
1656101658100,COGS 11,A01,083617,Boyle; Mary E. T.,16,2,48,32
1656101664124,COGS 13,A01,083071,Bastos; Amalia Pinkusfeld,8,3,71,63
1656101670148,COGS 14A,A01,092681,Semenuks; Arturs,8,24,100,92
1656101676171,COGS 14B,A01,083073,Cheng; Tzu-Han,7,0,63,56
1656101682203,COGS 17,A01,092677,Semenuks; Arturs,13,6,81,68
1656101688226,COGS 100,A01,083619,Allen; Michael Gordon,7,4,70,63
1656101694249,COGS 101A,A01,083621,Davis; Joshua Daniel,7,3,68,61
1656101700277,COGS 101B,A01,091572,Allen; Michael Gordon,6,0,65,59
1656101706303,COGS 101C,A01,083625,Delgado; Tania,11,0,35,24
1656101712330,COGS 107A,A01,083627,Boyle; Mary E. T.,5,4,60,55
1656101718353,COGS 118A,A01,083075,Gupta; Anjum,24,17,76,52
1656101724378,CSE 3,A50,083646,Miranda; Gregory Joseph,18,0,50,32
1656101730401,CSE 8A,A50,083650,Miranda; Gregory Joseph,13,13,56,43
1656101736429,CSE 11,A01,083080,Cao; Yingjun,1,60,40,39
1656101742456,CSE 12,A01,083652,Krause-Levy; Sophia Louisa,14,8,120,106
1656101748480,CSE 15L,A01,083654,Morris; Justin Loren,5,2,50,45
1656101748480,CSE 15L,A02,083655,Morris; Justin Loren,7,2,50,43
1656101754507,CSE 20,A01,083657,Tran; Khoa Dang,31,0,80,49
1656101760532,CSE 21,A01,095574,Bach; Quang Tran,26,0,48,22
1656101766562,CSE 30,A01,083084,Eldon; John,3,11,80,77
1656101766562,CSE 30,B01,095061,Bhaskar; Nishant,4,5,50,46
1656101772588,CSE 100,A01,083659,Cao; Yingjun,2,23,70,68
1656101778622,CSE 134B,A01,083661,Powell; Thomas Allan,10,7,100,90
1656101784645,CSE 140,A01,083663,Gungor; Onat,9,0,85,76
1656101790703,CSE 140L,A01,083088,Eldon; John,8,0,100,92
1656101796724,CSE 175,A01,083665,Kumar; Rakesh,1,0,25,24
1656101802751,CSE 190,A00,092507,Dubnov; Shlomo,2,0,20,18
1656101808775,ECE 45,A01,083139,Congero; Spencer William,5,3,75,70
1656101814798,ECE 65,A50,083695,Saad; Andrew S,8,0,30,22
1656101814798,ECE 65,A51,095125,Staff,23,0,26,3
1656101820826,ECE 109,A01,091882,Touri; Behrouz,7,6,70,63
1656101826859,ECE 180,A00,083140,Abi Samra; Nicholas Camill,1,0,30,29
1656101826859,ECE 180,B00,083141,Abi Samra; Nicholas Camill,4,8,30,26
1656101832881,MATH 10A,A01,083735,Patchell; Gregory David,0,0,30,30
1656101832881,MATH 10A,A02,083736,Patchell; Gregory David,22,0,30,8
1656101832881,MATH 10A,A03,083737,Patchell; Gregory David,16,0,30,14
1656101838913,MATH 10B,A01,083207,Lim; Seonhee,3,3,34,31
1656101838913,MATH 10B,A02,083208,Lim; Seonhee,10,2,35,25
1656101838913,MATH 10B,A03,093472,Staff,4,2,34,30
1656101838913,MATH 10B,B01,083739,Sinha; Shubham,12,0,30,18
1656101844966,MATH 18,A01,083743,Cinel; Cameron Alexander,7,0,30,23
1656101844966,MATH 18,A02,083744,Cinel; Cameron Alexander,10,0,30,20
1656101844966,MATH 18,A03,083745,Cinel; Cameron Alexander,3,0,30,27
1656101844966,MATH 18,B01,083748,Ma; Zilu,0,0,36,36
1656101844966,MATH 18,B02,083749,Ma; Zilu,0,0,36,36
1656101844966,MATH 18,B03,083750,Ma; Zilu,0,0,36,36
1656101844966,MATH 18,B04,083751,Ma; Zilu,0,0,36,36
1656101844966,MATH 18,B05,093473,Staff,3,0,36,33
1656101844966,MATH 18,B06,093474,Staff,3,0,36,33
1656101850991,MATH 20A,A01,083754,Zheng; Zequn,11,0,40,29
1656101857015,MATH 20B,A01,083756,Briones; Jor-el Thomas Caparas,0,0,36,36
1656101857015,MATH 20B,A02,083757,Briones; Jor-el Thomas Caparas,1,0,36,35
1656101857015,MATH 20B,A03,093475,Staff,3,0,36,33
1656101863039,MATH 20C,A01,083760,Briones; Jor-el Thomas Caparas,2,2,35,33
1656101863039,MATH 20C,A02,083761,Briones; Jor-el Thomas Caparas,9,1,35,26
1656101863039,MATH 20C,A03,093476,Staff,1,1,35,34
1656101863039,MATH 20C,B01,083762,Bach; Quang Tran,1,0,30,29
1656101869062,MATH 20D,A01,083765,Tran; Brian Kha,3,0,30,27
1656101869062,MATH 20D,A02,083766,Tran; Brian Kha,0,1,30,30
1656101869062,MATH 20D,A03,083767,Tran; Brian Kha,2,0,30,28
1656101875086,MATH 20E,A01,083771,Ganguly; Soumya,4,1,32,28
1656101875086,MATH 20E,A02,083772,Ganguly; Soumya,2,2,32,30
1656101875086,MATH 20E,B01,083773,Ciotti; Benjamin,14,0,35,21
1656101875086,MATH 20E,B02,083774,Ciotti; Benjamin,14,0,35,21
1656101881110,MATH 103A,A01,083777,Greenfeld; Be'Eri,3,0,36,33
1656101881110,MATH 103A,A02,083778,Greenfeld; Be'Eri,2,0,36,34
1656101881110,MATH 103A,A03,093561,Staff,4,1,36,32
1656101881110,MATH 103A,B01,083779,Greenfeld; Be'Eri,8,1,36,28
1656101881110,MATH 103A,B02,083780,Greenfeld; Be'Eri,0,1,36,36
1656101881110,MATH 103A,B03,093562,Staff,0,0,36,36
1656101887140,MATH 105,A01,085443,Carter; Anne Toulson,4,1,35,31
1656101887140,MATH 105,A02,093477,Staff,9,0,35,26
1656101893168,MATH 109,A01,083213,Ganzberger; Geoffrey Michael,1,1,34,33
1656101893168,MATH 109,A02,083214,Ganzberger; Geoffrey Michael,0,0,34,34
1656101893168,MATH 109,A03,093478,Staff,2,0,34,32
1656101893168,MATH 109,B01,083215,Ganzberger; Geoffrey Michael,3,0,32,29
1656101893168,MATH 109,B02,083216,Ganzberger; Geoffrey Michael,1,0,32,31
1656101893168,MATH 109,B03,093479,Staff,4,0,32,28
1656101899198,MATH 142A,A01,083219,Chow; Bennett,1,0,32,31
1656101899198,MATH 142A,A02,083220,Chow; Bennett,8,0,32,24
1656101899198,MATH 142A,A03,093480,Staff,5,0,32,27
1656101899198,MATH 142A,B03,093481,Staff,4,0,32,28
1656101899198,MATH 142A,B04,093558,Staff,6,0,32,26
1656101899198,MATH 142A,B05,093559,Staff,0,0,32,32
1656101905220,MATH 193A,A01,083224,Rotar; Vladimir,1,2,34,33
1656101905220,MATH 193A,A02,083225,Rotar; Vladimir,2,0,34,32
1656101905220,MATH 193A,A03,083781,Rotar; Vladimir,1,0,34,33
1656101905220,MATH 193A,A04,083782,Rotar; Vladimir,6,0,34,28
1656101905220,MATH 193A,A05,093482,Rotar; Vladimir,1,0,34,33
1656101911242,MATH 197,001,091859,McAuley; Julian John,9999,0,9999,0
1656101911242,MATH 197,002,095566,Kedlaya; Kiran S.,9997,0,9999,2
1656101911242,MATH 197,003,095567,Xiao; Ming,9999,0,9999,0
1656101911242,MATH 197,004,095571,Perols; Johan Lars,9998,0,9999,1
1656101918303,COGS 9,A01,083615,Shannon; Kyle Michael,5,1,75,70
1656101924326,COGS 11,A01,083617,Boyle; Mary E. T.,16,2,48,32
1656101930353,COGS 13,A01,083071,Bastos; Amalia Pinkusfeld,8,3,71,63
1656101936378,COGS 14A,A01,092681,Semenuks; Arturs,8,24,100,92
1656101942405,COGS 14B,A01,083073,Cheng; Tzu-Han,7,0,63,56
1656101948431,COGS 17,A01,092677,Semenuks; Arturs,13,6,81,68
1656101954455,COGS 100,A01,083619,Allen; Michael Gordon,7,4,70,63
1656101960478,COGS 101A,A01,083621,Davis; Joshua Daniel,7,3,68,61
1656101966500,COGS 101B,A01,091572,Allen; Michael Gordon,6,0,65,59
1656101972523,COGS 101C,A01,083625,Delgado; Tania,11,0,35,24
1656101978556,COGS 107A,A01,083627,Boyle; Mary E. T.,5,4,60,55
1656101984578,COGS 118A,A01,083075,Gupta; Anjum,24,17,76,52
1656101990623,CSE 3,A50,083646,Miranda; Gregory Joseph,18,0,50,32
1656101996648,CSE 8A,A50,083650,Miranda; Gregory Joseph,13,13,56,43
1656102002679,CSE 11,A01,083080,Cao; Yingjun,1,60,40,39
1656102008703,CSE 12,A01,083652,Krause-Levy; Sophia Louisa,14,8,120,106
1656102014731,CSE 15L,A01,083654,Morris; Justin Loren,5,2,50,45
1656102014731,CSE 15L,A02,083655,Morris; Justin Loren,7,2,50,43
1656102020754,CSE 20,A01,083657,Tran; Khoa Dang,31,0,80,49
1656102026778,CSE 21,A01,095574,Bach; Quang Tran,26,0,48,22
1656102032804,CSE 30,A01,083084,Eldon; John,3,11,80,77
1656102032804,CSE 30,B01,095061,Bhaskar; Nishant,4,5,50,46
1656102038829,CSE 100,A01,083659,Cao; Yingjun,2,23,70,68
1656102044856,CSE 134B,A01,083661,Powell; Thomas Allan,10,7,100,90
1656102050878,CSE 140,A01,083663,Gungor; Onat,9,0,85,76
1656102056905,CSE 140L,A01,083088,Eldon; John,8,0,100,92
1656102062927,CSE 175,A01,083665,Kumar; Rakesh,1,0,25,24
1656102068953,CSE 190,A00,092507,Dubnov; Shlomo,2,0,20,18
1656102074981,ECE 45,A01,083139,Congero; Spencer William,5,3,75,70
1656102081005,ECE 65,A50,083695,Saad; Andrew S,8,0,30,22
1656102081005,ECE 65,A51,095125,Staff,23,0,26,3
1656102087033,ECE 109,A01,091882,Touri; Behrouz,7,6,70,63
1656102093057,ECE 180,A00,083140,Abi Samra; Nicholas Camill,1,0,30,29
1656102093057,ECE 180,B00,083141,Abi Samra; Nicholas Camill,4,8,30,26
1656102099085,MATH 10A,A01,083735,Patchell; Gregory David,0,0,30,30
1656102099085,MATH 10A,A02,083736,Patchell; Gregory David,22,0,30,8
1656102099085,MATH 10A,A03,083737,Patchell; Gregory David,16,0,30,14
1656102105116,MATH 10B,A01,083207,Lim; Seonhee,3,3,34,31
1656102105116,MATH 10B,A02,083208,Lim; Seonhee,10,2,35,25
1656102105116,MATH 10B,A03,093472,Staff,4,2,34,30
1656102105116,MATH 10B,B01,083739,Sinha; Shubham,12,0,30,18
1656102111147,MATH 18,A01,083743,Cinel; Cameron Alexander,7,0,30,23
1656102111147,MATH 18,A02,083744,Cinel; Cameron Alexander,10,0,30,20
1656102111147,MATH 18,A03,083745,Cinel; Cameron Alexander,3,0,30,27
1656102111147,MATH 18,B01,083748,Ma; Zilu,0,0,36,36
1656102111147,MATH 18,B02,083749,Ma; Zilu,0,0,36,36
1656102111147,MATH 18,B03,083750,Ma; Zilu,0,0,36,36
1656102111147,MATH 18,B04,083751,Ma; Zilu,0,0,36,36
1656102111147,MATH 18,B05,093473,Staff,3,0,36,33
1656102111147,MATH 18,B06,093474,Staff,3,0,36,33
1656102117173,MATH 20A,A01,083754,Zheng; Zequn,11,0,40,29
1656102123204,MATH 20B,A01,083756,Briones; Jor-el Thomas Caparas,0,0,36,36
1656102123204,MATH 20B,A02,083757,Briones; Jor-el Thomas Caparas,1,0,36,35
1656102123204,MATH 20B,A03,093475,Staff,3,0,36,33
1656102129235,MATH 20C,A01,083760,Briones; Jor-el Thomas Caparas,2,2,35,33
1656102129235,MATH 20C,A02,083761,Briones; Jor-el Thomas Caparas,9,1,35,26
1656102129235,MATH 20C,A03,093476,Staff,1,1,35,34
1656102129235,MATH 20C,B01,083762,Bach; Quang Tran,1,0,30,29
1656102135269,MATH 20D,A01,083765,Tran; Brian Kha,3,0,30,27
1656102135269,MATH 20D,A02,083766,Tran; Brian Kha,0,1,30,30
1656102135269,MATH 20D,A03,083767,Tran; Brian Kha,2,0,30,28
1656102141293,MATH 20E,A01,083771,Ganguly; Soumya,4,1,32,28
1656102141293,MATH 20E,A02,083772,Ganguly; Soumya,2,2,32,30
1656102141293,MATH 20E,B01,083773,Ciotti; Benjamin,14,0,35,21
1656102141293,MATH 20E,B02,083774,Ciotti; Benjamin,14,0,35,21
1656102147331,MATH 103A,A01,083777,Greenfeld; Be'Eri,3,0,36,33
1656102147331,MATH 103A,A02,083778,Greenfeld; Be'Eri,2,0,36,34
1656102147331,MATH 103A,A03,093561,Staff,4,1,36,32
1656102147331,MATH 103A,B01,083779,Greenfeld; Be'Eri,8,1,36,28
1656102147331,MATH 103A,B02,083780,Greenfeld; Be'Eri,0,1,36,36
1656102147331,MATH 103A,B03,093562,Staff,0,0,36,36
1656102153447,MATH 105,A01,085443,Carter; Anne Toulson,4,1,35,31
1656102153447,MATH 105,A02,093477,Staff,9,0,35,26
1656102159471,MATH 109,A01,083213,Ganzberger; Geoffrey Michael,1,1,34,33
1656102159471,MATH 109,A02,083214,Ganzberger; Geoffrey Michael,0,0,34,34
1656102159471,MATH 109,A03,093478,Staff,2,0,34,32
1656102159471,MATH 109,B01,083215,Ganzberger; Geoffrey Michael,3,0,32,29
1656102159471,MATH 109,B02,083216,Ganzberger; Geoffrey Michael,1,0,32,31
1656102159471,MATH 109,B03,093479,Staff,4,0,32,28
1656102165504,MATH 142A,A01,083219,Chow; Bennett,1,0,32,31
1656102165504,MATH 142A,A02,083220,Chow; Bennett,8,0,32,24
1656102165504,MATH 142A,A03,093480,Staff,5,0,32,27
1656102165504,MATH 142A,B03,093481,Staff,4,0,32,28
1656102165504,MATH 142A,B04,093558,Staff,6,0,32,26
1656102165504,MATH 142A,B05,093559,Staff,0,0,32,32
1656102171533,MATH 193A,A01,083224,Rotar; Vladimir,1,2,34,33
1656102171533,MATH 193A,A02,083225,Rotar; Vladimir,2,0,34,32
1656102171533,MATH 193A,A03,083781,Rotar; Vladimir,1,0,34,33
1656102171533,MATH 193A,A04,083782,Rotar; Vladimir,6,0,34,28
1656102171533,MATH 193A,A05,093482,Rotar; Vladimir,1,0,34,33
1656102177561,MATH 197,001,091859,McAuley; Julian John,9999,0,9999,0
1656102177561,MATH 197,002,095566,Kedlaya; Kiran S.,9997,0,9999,2
1656102177561,MATH 197,003,095567,Xiao; Ming,9999,0,9999,0
1656102177561,MATH 197,004,095571,Perols; Johan Lars,9998,0,9999,1
1656102184640,COGS 9,A01,083615,Shannon; Kyle Michael,5,1,75,70
1656102190676,COGS 11,A01,083617,Boyle; Mary E. T.,16,2,48,32
1656102196706,COGS 13,A01,083071,Bastos; Amalia Pinkusfeld,8,3,71,63
1656102202733,COGS 14A,A01,092681,Semenuks; Arturs,8,24,100,92
1656102208757,COGS 14B,A01,083073,Cheng; Tzu-Han,7,0,63,56
1656102214786,COGS 17,A01,092677,Semenuks; Arturs,13,6,81,68
1656102220809,COGS 100,A01,083619,Allen; Michael Gordon,7,4,70,63
1656102226835,COGS 101A,A01,083621,Davis; Joshua Daniel,7,3,68,61
1656102232864,COGS 101B,A01,091572,Allen; Michael Gordon,6,0,65,59
1656102238889,COGS 101C,A01,083625,Delgado; Tania,11,0,35,24
1656102244913,COGS 107A,A01,083627,Boyle; Mary E. T.,5,4,60,55
1656102250945,COGS 118A,A01,083075,Gupta; Anjum,24,17,76,52
1656102256975,CSE 3,A50,083646,Miranda; Gregory Joseph,18,0,50,32
1656102262998,CSE 8A,A50,083650,Miranda; Gregory Joseph,13,13,56,43
1656102269026,CSE 11,A01,083080,Cao; Yingjun,1,60,40,39
1656102275048,CSE 12,A01,083652,Krause-Levy; Sophia Louisa,14,8,120,106
1656102281073,CSE 15L,A01,083654,Morris; Justin Loren,5,2,50,45
1656102281073,CSE 15L,A02,083655,Morris; Justin Loren,7,2,50,43
1656102287104,CSE 20,A01,083657,Tran; Khoa Dang,31,0,80,49
1656102293147,CSE 21,A01,095574,Bach; Quang Tran,26,0,48,22
1656102299170,CSE 30,A01,083084,Eldon; John,3,11,80,77
1656102299170,CSE 30,B01,095061,Bhaskar; Nishant,4,5,50,46
1656102305194,CSE 100,A01,083659,Cao; Yingjun,2,23,70,68
1656102311217,CSE 134B,A01,083661,Powell; Thomas Allan,10,7,100,90
1656102317246,CSE 140,A01,083663,Gungor; Onat,9,0,85,76
1656102323269,CSE 140L,A01,083088,Eldon; John,8,0,100,92
1656102329292,CSE 175,A01,083665,Kumar; Rakesh,1,0,25,24
1656102335316,CSE 190,A00,092507,Dubnov; Shlomo,2,0,20,18
1656102341338,ECE 45,A01,083139,Congero; Spencer William,5,3,75,70
1656102347363,ECE 65,A50,083695,Saad; Andrew S,8,0,30,22
1656102347363,ECE 65,A51,095125,Staff,23,0,26,3
1656102353391,ECE 109,A01,091882,Touri; Behrouz,7,6,70,63
1656102359414,ECE 180,A00,083140,Abi Samra; Nicholas Camill,1,0,30,29
1656102359414,ECE 180,B00,083141,Abi Samra; Nicholas Camill,4,8,30,26
1656102365442,MATH 10A,A01,083735,Patchell; Gregory David,0,0,30,30
1656102365442,MATH 10A,A02,083736,Patchell; Gregory David,22,0,30,8
1656102365442,MATH 10A,A03,083737,Patchell; Gregory David,16,0,30,14
1656102371471,MATH 10B,A01,083207,Lim; Seonhee,3,3,34,31
1656102371471,MATH 10B,A02,083208,Lim; Seonhee,10,2,35,25
1656102371471,MATH 10B,A03,093472,Staff,4,2,34,30
1656102371471,MATH 10B,B01,083739,Sinha; Shubham,12,0,30,18
1656102377502,MATH 18,A01,083743,Cinel; Cameron Alexander,7,0,30,23
1656102377502,MATH 18,A02,083744,Cinel; Cameron Alexander,10,0,30,20
1656102377502,MATH 18,A03,083745,Cinel; Cameron Alexander,3,0,30,27
1656102377502,MATH 18,B01,083748,Ma; Zilu,0,0,36,36
1656102377502,MATH 18,B02,083749,Ma; Zilu,0,0,36,36
1656102377502,MATH 18,B03,083750,Ma; Zilu,0,0,36,36
1656102377502,MATH 18,B04,083751,Ma; Zilu,0,0,36,36
1656102377502,MATH 18,B05,093473,Staff,3,0,36,33
1656102377502,MATH 18,B06,093474,Staff,3,0,36,33
1656102383525,MATH 20A,A01,083754,Zheng; Zequn,11,0,40,29
1656102389548,MATH 20B,A01,083756,Briones; Jor-el Thomas Caparas,0,0,36,36
1656102389548,MATH 20B,A02,083757,Briones; Jor-el Thomas Caparas,1,0,36,35
1656102389548,MATH 20B,A03,093475,Staff,3,0,36,33
1656102395577,MATH 20C,A01,083760,Briones; Jor-el Thomas Caparas,2,2,35,33
1656102395577,MATH 20C,A02,083761,Briones; Jor-el Thomas Caparas,9,1,35,26
1656102395577,MATH 20C,A03,093476,Staff,1,1,35,34
1656102395577,MATH 20C,B01,083762,Bach; Quang Tran,1,0,30,29
1656102401601,MATH 20D,A01,083765,Tran; Brian Kha,3,0,30,27
1656102401601,MATH 20D,A02,083766,Tran; Brian Kha,0,1,30,30
1656102401601,MATH 20D,A03,083767,Tran; Brian Kha,2,0,30,28
1656102407625,MATH 20E,A01,083771,Ganguly; Soumya,4,1,32,28
1656102407625,MATH 20E,A02,083772,Ganguly; Soumya,2,2,32,30
1656102407625,MATH 20E,B01,083773,Ciotti; Benjamin,14,0,35,21
1656102407625,MATH 20E,B02,083774,Ciotti; Benjamin,14,0,35,21
1656102413655,MATH 103A,A01,083777,Greenfeld; Be'Eri,3,0,36,33
1656102413655,MATH 103A,A02,083778,Greenfeld; Be'Eri,2,0,36,34
1656102413655,MATH 103A,A03,093561,Staff,4,1,36,32
1656102413655,MATH 103A,B01,083779,Greenfeld; Be'Eri,8,1,36,28
1656102413655,MATH 103A,B02,083780,Greenfeld; Be'Eri,0,1,36,36
1656102413655,MATH 103A,B03,093562,Staff,0,0,36,36
1656102419677,MATH 105,A01,085443,Carter; Anne Toulson,4,1,35,31
1656102419677,MATH 105,A02,093477,Staff,9,0,35,26
1656102425701,MATH 109,A01,083213,Ganzberger; Geoffrey Michael,1,1,34,33
1656102425701,MATH 109,A02,083214,Ganzberger; Geoffrey Michael,0,0,34,34
1656102425701,MATH 109,A03,093478,Staff,2,0,34,32
1656102425701,MATH 109,B01,083215,Ganzberger; Geoffrey Michael,3,0,32,29
1656102425701,MATH 109,B02,083216,Ganzberger; Geoffrey Michael,1,0,32,31
1656102425701,MATH 109,B03,093479,Staff,4,0,32,28
1656102431726,MATH 142A,A01,083219,Chow; Bennett,1,0,32,31
1656102431726,MATH 142A,A02,083220,Chow; Bennett,8,0,32,24
1656102431726,MATH 142A,A03,093480,Staff,5,0,32,27
1656102431726,MATH 142A,B03,093481,Staff,4,0,32,28
1656102431726,MATH 142A,B04,093558,Staff,6,0,32,26
1656102431726,MATH 142A,B05,093559,Staff,0,0,32,32
1656102437756,MATH 193A,A01,083224,Rotar; Vladimir,1,2,34,33
1656102437756,MATH 193A,A02,083225,Rotar; Vladimir,2,0,34,32
1656102437756,MATH 193A,A03,083781,Rotar; Vladimir,1,0,34,33
1656102437756,MATH 193A,A04,083782,Rotar; Vladimir,6,0,34,28
1656102437756,MATH 193A,A05,093482,Rotar; Vladimir,1,0,34,33
1656102443788,MATH 197,001,091859,McAuley; Julian John,9999,0,9999,0
1656102443788,MATH 197,002,095566,Kedlaya; Kiran S.,9997,0,9999,2
1656102443788,MATH 197,003,095567,Xiao; Ming,9999,0,9999,0
1656102443788,MATH 197,004,095571,Perols; Johan Lars,9998,0,9999,1
1656102450843,COGS 9,A01,083615,Shannon; Kyle Michael,5,1,75,70
1656102456867,COGS 11,A01,083617,Boyle; Mary E. T.,16,2,48,32
1656102462890,COGS 13,A01,083071,Bastos; Amalia Pinkusfeld,8,3,71,63
1656102468913,COGS 14A,A01,092681,Semenuks; Arturs,8,24,100,92
1656102474940,COGS 14B,A01,083073,Cheng; Tzu-Han,7,0,63,56
1656102480966,COGS 17,A01,092677,Semenuks; Arturs,13,6,81,68
1656102486992,COGS 100,A01,083619,Allen; Michael Gordon,7,4,70,63
1656102493033,COGS 101A,A01,083621,Davis; Joshua Daniel,7,3,68,61
1656102499054,COGS 101B,A01,091572,Allen; Michael Gordon,6,0,65,59
1656102505092,COGS 101C,A01,083625,Delgado; Tania,11,0,35,24
1656102511115,COGS 107A,A01,083627,Boyle; Mary E. T.,5,4,60,55
1656102517148,COGS 118A,A01,083075,Gupta; Anjum,24,17,76,52
1656102523176,CSE 3,A50,083646,Miranda; Gregory Joseph,18,0,50,32
1656102529201,CSE 8A,A50,083650,Miranda; Gregory Joseph,13,13,56,43
1656102535224,CSE 11,A01,083080,Cao; Yingjun,1,60,40,39
1656102541249,CSE 12,A01,083652,Krause-Levy; Sophia Louisa,14,8,120,106
1656102547271,CSE 15L,A01,083654,Morris; Justin Loren,5,2,50,45
1656102547271,CSE 15L,A02,083655,Morris; Justin Loren,7,2,50,43
1656102553295,CSE 20,A01,083657,Tran; Khoa Dang,31,0,80,49
1656102559328,CSE 21,A01,095574,Bach; Quang Tran,26,0,48,22
1656102565349,CSE 30,A01,083084,Eldon; John,3,11,80,77
1656102565349,CSE 30,B01,095061,Bhaskar; Nishant,4,5,50,46
1656102571371,CSE 100,A01,083659,Cao; Yingjun,2,23,70,68
1656102577400,CSE 134B,A01,083661,Powell; Thomas Allan,10,7,100,90
1656102583436,CSE 140,A01,083663,Gungor; Onat,9,0,85,76
1656102589458,CSE 140L,A01,083088,Eldon; John,8,0,100,92
1656102595499,CSE 175,A01,083665,Kumar; Rakesh,1,0,25,24
1656102601524,CSE 190,A00,092507,Dubnov; Shlomo,2,0,20,18
1656102607545,ECE 45,A01,083139,Congero; Spencer William,5,3,75,70
1656102613569,ECE 65,A50,083695,Saad; Andrew S,8,0,30,22
1656102613569,ECE 65,A51,095125,Staff,23,0,26,3
1656102619611,ECE 109,A01,091882,Touri; Behrouz,7,6,70,63
1656102625635,ECE 180,A00,083140,Abi Samra; Nicholas Camill,1,0,30,29
1656102625635,ECE 180,B00,083141,Abi Samra; Nicholas Camill,4,8,30,26
1656102631663,MATH 10A,A01,083735,Patchell; Gregory David,0,0,30,30
1656102631663,MATH 10A,A02,083736,Patchell; Gregory David,22,0,30,8
1656102631663,MATH 10A,A03,083737,Patchell; Gregory David,16,0,30,14
1656102637694,MATH 10B,A01,083207,Lim; Seonhee,3,3,34,31
1656102637694,MATH 10B,A02,083208,Lim; Seonhee,10,2,35,25
1656102637694,MATH 10B,A03,093472,Staff,4,2,34,30
1656102637694,MATH 10B,B01,083739,Sinha; Shubham,12,0,30,18
1656102643722,MATH 18,A01,083743,Cinel; Cameron Alexander,7,0,30,23
1656102643722,MATH 18,A02,083744,Cinel; Cameron Alexander,10,0,30,20
1656102643722,MATH 18,A03,083745,Cinel; Cameron Alexander,3,0,30,27
1656102643722,MATH 18,B01,083748,Ma; Zilu,0,0,36,36
1656102643722,MATH 18,B02,083749,Ma; Zilu,0,0,36,36
1656102643722,MATH 18,B03,083750,Ma; Zilu,0,0,36,36
1656102643722,MATH 18,B04,083751,Ma; Zilu,0,0,36,36
1656102643722,MATH 18,B05,093473,Staff,3,0,36,33
1656102643722,MATH 18,B06,093474,Staff,3,0,36,33
1656102649754,MATH 20A,A01,083754,Zheng; Zequn,11,0,40,29
1656102655784,MATH 20B,A01,083756,Briones; Jor-el Thomas Caparas,0,0,36,36
1656102655784,MATH 20B,A02,083757,Briones; Jor-el Thomas Caparas,1,0,36,35
1656102655784,MATH 20B,A03,093475,Staff,3,0,36,33
1656102661816,MATH 20C,A01,083760,Briones; Jor-el Thomas Caparas,2,2,35,33
1656102661816,MATH 20C,A02,083761,Briones; Jor-el Thomas Caparas,9,1,35,26
1656102661816,MATH 20C,A03,093476,Staff,1,1,35,34
1656102661816,MATH 20C,B01,083762,Bach; Quang Tran,1,0,30,29
1656102667843,MATH 20D,A01,083765,Tran; Brian Kha,3,0,30,27
1656102667843,MATH 20D,A02,083766,Tran; Brian Kha,0,1,30,30
1656102667843,MATH 20D,A03,083767,Tran; Brian Kha,2,0,30,28
1656102673874,MATH 20E,A01,083771,Ganguly; Soumya,4,1,32,28
1656102673874,MATH 20E,A02,083772,Ganguly; Soumya,2,2,32,30
1656102673874,MATH 20E,B01,083773,Ciotti; Benjamin,14,0,35,21
1656102673874,MATH 20E,B02,083774,Ciotti; Benjamin,14,0,35,21
1656102679915,MATH 103A,A01,083777,Greenfeld; Be'Eri,3,0,36,33
1656102679915,MATH 103A,A02,083778,Greenfeld; Be'Eri,2,0,36,34
1656102679915,MATH 103A,A03,093561,Staff,4,1,36,32
1656102679915,MATH 103A,B01,083779,Greenfeld; Be'Eri,8,1,36,28
1656102679915,MATH 103A,B02,083780,Greenfeld; Be'Eri,0,1,36,36
1656102679915,MATH 103A,B03,093562,Staff,0,0,36,36
1656102685943,MATH 105,A01,085443,Carter; Anne Toulson,4,1,35,31
1656102685943,MATH 105,A02,093477,Staff,9,0,35,26
1656102691977,MATH 109,A01,083213,Ganzberger; Geoffrey Michael,1,1,34,33
1656102691977,MATH 109,A02,083214,Ganzberger; Geoffrey Michael,0,0,34,34
1656102691977,MATH 109,A03,093478,Staff,2,0,34,32
1656102691977,MATH 109,B01,083215,Ganzberger; Geoffrey Michael,3,0,32,29
1656102691977,MATH 109,B02,083216,Ganzberger; Geoffrey Michael,1,0,32,31
1656102691977,MATH 109,B03,093479,Staff,4,0,32,28
1656102698002,MATH 142A,A01,083219,Chow; Bennett,1,0,32,31
1656102698002,MATH 142A,A02,083220,Chow; Bennett,8,0,32,24
1656102698002,MATH 142A,A03,093480,Staff,5,0,32,27
1656102698002,MATH 142A,B03,093481,Staff,4,0,32,28
1656102698002,MATH 142A,B04,093558,Staff,6,0,32,26
1656102698002,MATH 142A,B05,093559,Staff,0,0,32,32
1656102704032,MATH 193A,A01,083224,Rotar; Vladimir,1,2,34,33
1656102704032,MATH 193A,A02,083225,Rotar; Vladimir,2,0,34,32
1656102704032,MATH 193A,A03,083781,Rotar; Vladimir,1,0,34,33
1656102704032,MATH 193A,A04,083782,Rotar; Vladimir,6,0,34,28
1656102704032,MATH 193A,A05,093482,Rotar; Vladimir,1,0,34,33
1656102710059,MATH 197,001,091859,McAuley; Julian John,9999,0,9999,0
1656102710059,MATH 197,002,095566,Kedlaya; Kiran S.,9997,0,9999,2
1656102710059,MATH 197,003,095567,Xiao; Ming,9999,0,9999,0
1656102710059,MATH 197,004,095571,Perols; Johan Lars,9998,0,9999,1
1656102717124,COGS 9,A01,083615,Shannon; Kyle Michael,5,1,75,70
1656102723148,COGS 11,A01,083617,Boyle; Mary E. T.,16,2,48,32
1656102729170,COGS 13,A01,083071,Bastos; Amalia Pinkusfeld,8,3,71,63
1656102735193,COGS 14A,A01,092681,Semenuks; Arturs,8,24,100,92
1656102741230,COGS 14B,A01,083073,Cheng; Tzu-Han,7,0,63,56
1656102747328,COGS 17,A01,092677,Semenuks; Arturs,13,6,81,68
1656102753352,COGS 100,A01,083619,Allen; Michael Gordon,7,4,70,63
1656102759378,COGS 101A,A01,083621,Davis; Joshua Daniel,7,3,68,61
1656102765404,COGS 101B,A01,091572,Allen; Michael Gordon,6,0,65,59
1656102771440,COGS 101C,A01,083625,Delgado; Tania,11,0,35,24
1656102777466,COGS 107A,A01,083627,Boyle; Mary E. T.,5,4,60,55
1656102783489,COGS 118A,A01,083075,Gupta; Anjum,24,17,76,52
1656102789512,CSE 3,A50,083646,Miranda; Gregory Joseph,18,0,50,32
1656102795541,CSE 8A,A50,083650,Miranda; Gregory Joseph,13,13,56,43
1656102801570,CSE 11,A01,083080,Cao; Yingjun,1,60,40,39
1656102807597,CSE 12,A01,083652,Krause-Levy; Sophia Louisa,14,8,120,106
1656102813622,CSE 15L,A01,083654,Morris; Justin Loren,5,2,50,45
1656102813622,CSE 15L,A02,083655,Morris; Justin Loren,7,2,50,43
1656102819653,CSE 20,A01,083657,Tran; Khoa Dang,31,0,80,49
1656102825680,CSE 21,A01,095574,Bach; Quang Tran,26,0,48,22
1656102831708,CSE 30,A01,083084,Eldon; John,3,11,80,77
1656102831708,CSE 30,B01,095061,Bhaskar; Nishant,4,5,50,46
1656102837738,CSE 100,A01,083659,Cao; Yingjun,2,23,70,68
1656102843762,CSE 134B,A01,083661,Powell; Thomas Allan,10,8,100,90
1656102849785,CSE 140,A01,083663,Gungor; Onat,9,0,85,76
1656102855811,CSE 140L,A01,083088,Eldon; John,8,0,100,92
1656102861836,CSE 175,A01,083665,Kumar; Rakesh,1,0,25,24
1656102867860,CSE 190,A00,092507,Dubnov; Shlomo,2,0,20,18
1656102873882,ECE 45,A01,083139,Congero; Spencer William,5,3,75,70
1656102879907,ECE 65,A50,083695,Saad; Andrew S,8,0,30,22
1656102879907,ECE 65,A51,095125,Staff,23,0,26,3
1656102885931,ECE 109,A01,091882,Touri; Behrouz,7,6,70,63
1656102891959,ECE 180,A00,083140,Abi Samra; Nicholas Camill,1,0,30,29
1656102891959,ECE 180,B00,083141,Abi Samra; Nicholas Camill,4,8,30,26
1656102897984,MATH 10A,A01,083735,Patchell; Gregory David,0,0,30,30
1656102897984,MATH 10A,A02,083736,Patchell; Gregory David,22,0,30,8
1656102897984,MATH 10A,A03,083737,Patchell; Gregory David,16,0,30,14
1656102904015,MATH 10B,A01,083207,Lim; Seonhee,3,3,34,31
1656102904015,MATH 10B,A02,083208,Lim; Seonhee,10,2,35,25
1656102904015,MATH 10B,A03,093472,Staff,4,2,34,30
1656102904015,MATH 10B,B01,083739,Sinha; Shubham,12,0,30,18
1656102910041,MATH 18,A01,083743,Cinel; Cameron Alexander,7,0,30,23
1656102910041,MATH 18,A02,083744,Cinel; Cameron Alexander,10,0,30,20
1656102910041,MATH 18,A03,083745,Cinel; Cameron Alexander,3,0,30,27
1656102910041,MATH 18,B01,083748,Ma; Zilu,0,0,36,36
1656102910041,MATH 18,B02,083749,Ma; Zilu,0,0,36,36
1656102910041,MATH 18,B03,083750,Ma; Zilu,0,0,36,36
1656102910041,MATH 18,B04,083751,Ma; Zilu,0,0,36,36
1656102910041,MATH 18,B05,093473,Staff,3,0,36,33
1656102910041,MATH 18,B06,093474,Staff,3,0,36,33
1656102916072,MATH 20A,A01,083754,Zheng; Zequn,11,0,40,29
1656102922104,MATH 20B,A01,083756,Briones; Jor-el Thomas Caparas,0,0,36,36
1656102922104,MATH 20B,A02,083757,Briones; Jor-el Thomas Caparas,1,0,36,35
1656102922104,MATH 20B,A03,093475,Staff,3,0,36,33
1656102928136,MATH 20C,A01,083760,Briones; Jor-el Thomas Caparas,2,2,35,33
1656102928136,MATH 20C,A02,083761,Briones; Jor-el Thomas Caparas,9,1,35,26
1656102928136,MATH 20C,A03,093476,Staff,1,1,35,34
1656102928136,MATH 20C,B01,083762,Bach; Quang Tran,1,0,30,29
1656102934161,MATH 20D,A01,083765,Tran; Brian Kha,3,0,30,27
1656102934161,MATH 20D,A02,083766,Tran; Brian Kha,0,1,30,30
1656102934161,MATH 20D,A03,083767,Tran; Brian Kha,2,0,30,28
1656102940195,MATH 20E,A01,083771,Ganguly; Soumya,4,1,32,28
1656102940195,MATH 20E,A02,083772,Ganguly; Soumya,2,2,32,30
1656102940195,MATH 20E,B01,083773,Ciotti; Benjamin,14,0,35,21
1656102940195,MATH 20E,B02,083774,Ciotti; Benjamin,14,0,35,21
1656102946220,MATH 103A,A01,083777,Greenfeld; Be'Eri,3,0,36,33
1656102946220,MATH 103A,A02,083778,Greenfeld; Be'Eri,2,0,36,34
1656102946220,MATH 103A,A03,093561,Staff,4,1,36,32
1656102946220,MATH 103A,B01,083779,Greenfeld; Be'Eri,8,1,36,28
1656102946220,MATH 103A,B02,083780,Greenfeld; Be'Eri,0,1,36,36
1656102946220,MATH 103A,B03,093562,Staff,0,0,36,36
1656102952244,MATH 105,A01,085443,Carter; Anne Toulson,4,1,35,31
1656102952244,MATH 105,A02,093477,Staff,9,0,35,26
1656102958272,MATH 109,A01,083213,Ganzberger; Geoffrey Michael,1,1,34,33
1656102958272,MATH 109,A02,083214,Ganzberger; Geoffrey Michael,0,0,34,34
1656102958272,MATH 109,A03,093478,Staff,2,0,34,32
1656102958272,MATH 109,B01,083215,Ganzberger; Geoffrey Michael,3,0,32,29
1656102958272,MATH 109,B02,083216,Ganzberger; Geoffrey Michael,1,0,32,31
1656102958272,MATH 109,B03,093479,Staff,4,0,32,28
1656102964294,MATH 142A,A01,083219,Chow; Bennett,1,0,32,31
1656102964294,MATH 142A,A02,083220,Chow; Bennett,8,0,32,24
1656102964294,MATH 142A,A03,093480,Staff,5,0,32,27
1656102964294,MATH 142A,B03,093481,Staff,4,0,32,28
1656102964294,MATH 142A,B04,093558,Staff,6,0,32,26
1656102964294,MATH 142A,B05,093559,Staff,0,0,32,32
1656102970319,MATH 193A,A01,083224,Rotar; Vladimir,1,2,34,33
1656102970319,MATH 193A,A02,083225,Rotar; Vladimir,2,0,34,32
1656102970319,MATH 193A,A03,083781,Rotar; Vladimir,1,0,34,33
1656102970319,MATH 193A,A04,083782,Rotar; Vladimir,6,0,34,28
1656102970319,MATH 193A,A05,093482,Rotar; Vladimir,1,0,34,33
1656102976353,MATH 197,001,091859,McAuley; Julian John,9999,0,9999,0
1656102976353,MATH 197,002,095566,Kedlaya; Kiran S.,9997,0,9999,2
1656102976353,MATH 197,003,095567,Xiao; Ming,9999,0,9999,0
1656102976353,MATH 197,004,095571,Perols; Johan Lars,9998,0,9999,1
1656102983403,COGS 9,A01,083615,Shannon; Kyle Michael,5,1,75,70
1656102989427,COGS 11,A01,083617,Boyle; Mary E. T.,16,2,48,32
1656102995456,COGS 13,A01,083071,Bastos; Amalia Pinkusfeld,8,3,71,63
1656103001483,COGS 14A,A01,092681,Semenuks; Arturs,8,24,100,92
1656103007511,COGS 14B,A01,083073,Cheng; Tzu-Han,7,0,63,56
1656103013534,COGS 17,A01,092677,Semenuks; Arturs,13,6,81,68
1656103019575,COGS 100,A01,083619,Allen; Michael Gordon,7,4,70,63
1656103025614,COGS 101A,A01,083621,Davis; Joshua Daniel,7,3,68,61
1656103031644,COGS 101B,A01,091572,Allen; Michael Gordon,6,0,65,59
1656103037671,COGS 101C,A01,083625,Delgado; Tania,11,0,35,24
1656103043705,COGS 107A,A01,083627,Boyle; Mary E. T.,5,4,60,55
1656103049742,COGS 118A,A01,083075,Gupta; Anjum,24,17,76,52
1656103055769,CSE 3,A50,083646,Miranda; Gregory Joseph,18,0,50,32
1656103061796,CSE 8A,A50,083650,Miranda; Gregory Joseph,13,13,56,43
1656103067823,CSE 11,A01,083080,Cao; Yingjun,1,60,40,39
1656103073846,CSE 12,A01,083652,Krause-Levy; Sophia Louisa,14,8,120,106
1656103079873,CSE 15L,A01,083654,Morris; Justin Loren,5,2,50,45
1656103079873,CSE 15L,A02,083655,Morris; Justin Loren,7,2,50,43
1656103085901,CSE 20,A01,083657,Tran; Khoa Dang,31,0,80,49
1656103091942,CSE 21,A01,095574,Bach; Quang Tran,26,0,48,22
1656103097964,CSE 30,A01,083084,Eldon; John,3,11,80,77
1656103097964,CSE 30,B01,095061,Bhaskar; Nishant,4,5,50,46
1656103103989,CSE 100,A01,083659,Cao; Yingjun,2,23,70,68
1656103110019,CSE 134B,A01,083661,Powell; Thomas Allan,10,8,100,90
1656103116042,CSE 140,A01,083663,Gungor; Onat,9,0,85,76
1656103122068,CSE 140L,A01,083088,Eldon; John,8,0,100,92
1656103128095,CSE 175,A01,083665,Kumar; Rakesh,1,0,25,24
1656103134120,CSE 190,A00,092507,Dubnov; Shlomo,2,0,20,18
1656103140153,ECE 45,A01,083139,Congero; Spencer William,5,3,75,70
1656103146184,ECE 65,A50,083695,Saad; Andrew S,8,0,30,22
1656103146184,ECE 65,A51,095125,Staff,23,0,26,3
1656103152233,ECE 109,A01,091882,Touri; Behrouz,7,6,70,63
1656103158266,ECE 180,A00,083140,Abi Samra; Nicholas Camill,1,0,30,29
1656103158266,ECE 180,B00,083141,Abi Samra; Nicholas Camill,4,8,30,26
1656103164290,MATH 10A,A01,083735,Patchell; Gregory David,0,0,30,30
1656103164290,MATH 10A,A02,083736,Patchell; Gregory David,22,0,30,8
1656103164290,MATH 10A,A03,083737,Patchell; Gregory David,16,0,30,14
1656103170320,MATH 10B,A01,083207,Lim; Seonhee,3,3,34,31
1656103170320,MATH 10B,A02,083208,Lim; Seonhee,10,2,35,25
1656103170320,MATH 10B,A03,093472,Staff,4,2,34,30
1656103170320,MATH 10B,B01,083739,Sinha; Shubham,12,0,30,18
1656103176358,MATH 18,A01,083743,Cinel; Cameron Alexander,7,0,30,23
1656103176358,MATH 18,A02,083744,Cinel; Cameron Alexander,10,0,30,20
1656103176358,MATH 18,A03,083745,Cinel; Cameron Alexander,3,0,30,27
1656103176358,MATH 18,B01,083748,Ma; Zilu,0,0,36,36
1656103176358,MATH 18,B02,083749,Ma; Zilu,0,0,36,36
1656103176358,MATH 18,B03,083750,Ma; Zilu,0,0,36,36
1656103176358,MATH 18,B04,083751,Ma; Zilu,0,0,36,36
1656103176358,MATH 18,B05,093473,Staff,3,0,36,33
1656103176358,MATH 18,B06,093474,Staff,3,0,36,33
1656103182386,MATH 20A,A01,083754,Zheng; Zequn,11,0,40,29
1656103188416,MATH 20B,A01,083756,Briones; Jor-el Thomas Caparas,0,0,36,36
1656103188416,MATH 20B,A02,083757,Briones; Jor-el Thomas Caparas,1,0,36,35
1656103188416,MATH 20B,A03,093475,Staff,3,0,36,33
1656103194440,MATH 20C,A01,083760,Briones; Jor-el Thomas Caparas,2,2,35,33
1656103194440,MATH 20C,A02,083761,Briones; Jor-el Thomas Caparas,9,1,35,26
1656103194440,MATH 20C,A03,093476,Staff,1,1,35,34
1656103194440,MATH 20C,B01,083762,Bach; Quang Tran,1,0,30,29
1656103200463,MATH 20D,A01,083765,Tran; Brian Kha,3,0,30,27
1656103200463,MATH 20D,A02,083766,Tran; Brian Kha,0,1,30,30
1656103200463,MATH 20D,A03,083767,Tran; Brian Kha,2,0,30,28
1656103206503,MATH 20E,A01,083771,Ganguly; Soumya,4,1,32,28
1656103206503,MATH 20E,A02,083772,Ganguly; Soumya,2,2,32,30
1656103206503,MATH 20E,B01,083773,Ciotti; Benjamin,14,0,35,21
1656103206503,MATH 20E,B02,083774,Ciotti; Benjamin,14,0,35,21
1656103212526,MATH 103A,A01,083777,Greenfeld; Be'Eri,3,0,36,33
1656103212526,MATH 103A,A02,083778,Greenfeld; Be'Eri,2,0,36,34
1656103212526,MATH 103A,A03,093561,Staff,4,1,36,32
1656103212526,MATH 103A,B01,083779,Greenfeld; Be'Eri,8,1,36,28
1656103212526,MATH 103A,B02,083780,Greenfeld; Be'Eri,0,1,36,36
1656103212526,MATH 103A,B03,093562,Staff,0,0,36,36
1656103218553,MATH 105,A01,085443,Carter; Anne Toulson,4,1,35,31
1656103218553,MATH 105,A02,093477,Staff,9,0,35,26
1656103224576,MATH 109,A01,083213,Ganzberger; Geoffrey Michael,1,1,34,33
1656103224576,MATH 109,A02,083214,Ganzberger; Geoffrey Michael,0,0,34,34
1656103224576,MATH 109,A03,093478,Staff,2,0,34,32
1656103224576,MATH 109,B01,083215,Ganzberger; Geoffrey Michael,3,0,32,29
1656103224576,MATH 109,B02,083216,Ganzberger; Geoffrey Michael,1,0,32,31
1656103224576,MATH 109,B03,093479,Staff,4,0,32,28
1656103230617,MATH 142A,A01,083219,Chow; Bennett,1,0,32,31
1656103230617,MATH 142A,A02,083220,Chow; Bennett,8,0,32,24
1656103230617,MATH 142A,A03,093480,Staff,5,0,32,27
1656103230617,MATH 142A,B03,093481,Staff,4,0,32,28
1656103230617,MATH 142A,B04,093558,Staff,6,0,32,26
1656103230617,MATH 142A,B05,093559,Staff,0,0,32,32
1656103236658,MATH 193A,A01,083224,Rotar; Vladimir,1,2,34,33
1656103236658,MATH 193A,A02,083225,Rotar; Vladimir,2,0,34,32
1656103236658,MATH 193A,A03,083781,Rotar; Vladimir,1,0,34,33
1656103236658,MATH 193A,A04,083782,Rotar; Vladimir,6,0,34,28
1656103236658,MATH 193A,A05,093482,Rotar; Vladimir,1,0,34,33
1656103242694,MATH 197,001,091859,McAuley; Julian John,9999,0,9999,0
1656103242694,MATH 197,002,095566,Kedlaya; Kiran S.,9997,0,9999,2
1656103242694,MATH 197,003,095567,Xiao; Ming,9999,0,9999,0
1656103242694,MATH 197,004,095571,Perols; Johan Lars,9998,0,9999,1
1656103249760,COGS 9,A01,083615,Shannon; Kyle Michael,5,1,75,70
1656103255789,COGS 11,A01,083617,Boyle; Mary E. T.,16,2,48,32
1656103261816,COGS 13,A01,083071,Bastos; Amalia Pinkusfeld,8,3,71,63
1656103267839,COGS 14A,A01,092681,Semenuks; Arturs,8,24,100,92
1656103273863,COGS 14B,A01,083073,Cheng; Tzu-Han,7,0,63,56
1656103279889,COGS 17,A01,092677,Semenuks; Arturs,13,6,81,68
1656103285912,COGS 100,A01,083619,Allen; Michael Gordon,7,4,70,63
1656103291941,COGS 101A,A01,083621,Davis; Joshua Daniel,7,3,68,61
1656103297965,COGS 101B,A01,091572,Allen; Michael Gordon,6,0,65,59
1656103304003,COGS 101C,A01,083625,Delgado; Tania,11,0,35,24
1656103310041,COGS 107A,A01,083627,Boyle; Mary E. T.,5,4,60,55
1656103316084,COGS 118A,A01,083075,Gupta; Anjum,24,17,76,52
1656103322123,CSE 3,A50,083646,Miranda; Gregory Joseph,18,0,50,32
1656103328148,CSE 8A,A50,083650,Miranda; Gregory Joseph,13,13,56,43
1656103334174,CSE 11,A01,083080,Cao; Yingjun,1,60,40,39
1656103340202,CSE 12,A01,083652,Krause-Levy; Sophia Louisa,14,8,120,106
1656103346328,CSE 15L,A01,083654,Morris; Justin Loren,5,2,50,45
1656103346328,CSE 15L,A02,083655,Morris; Justin Loren,7,2,50,43
1656103352350,CSE 20,A01,083657,Tran; Khoa Dang,31,0,80,49
1656103358374,CSE 21,A01,095574,Bach; Quang Tran,26,0,48,22
1656103364397,CSE 30,A01,083084,Eldon; John,3,11,80,77
1656103364397,CSE 30,B01,095061,Bhaskar; Nishant,4,5,50,46
1656103370420,CSE 100,A01,083659,Cao; Yingjun,2,23,70,68
1656103376449,CSE 134B,A01,083661,Powell; Thomas Allan,10,8,100,90
1656103382475,CSE 140,A01,083663,Gungor; Onat,9,0,85,76
1656103388498,CSE 140L,A01,083088,Eldon; John,8,0,100,92
1656103394521,CSE 175,A01,083665,Kumar; Rakesh,1,0,25,24
1656103400549,CSE 190,A00,092507,Dubnov; Shlomo,2,0,20,18
1656103406576,ECE 45,A01,083139,Congero; Spencer William,5,3,75,70
1656103412602,ECE 65,A50,083695,Saad; Andrew S,8,0,30,22
1656103412602,ECE 65,A51,095125,Staff,23,0,26,3
1656103418629,ECE 109,A01,091882,Touri; Behrouz,7,6,70,63
1656103424653,ECE 180,A00,083140,Abi Samra; Nicholas Camill,1,0,30,29
1656103424653,ECE 180,B00,083141,Abi Samra; Nicholas Camill,4,8,30,26
1656103430677,MATH 10A,A01,083735,Patchell; Gregory David,0,0,30,30
1656103430677,MATH 10A,A02,083736,Patchell; Gregory David,22,0,30,8
1656103430677,MATH 10A,A03,083737,Patchell; Gregory David,16,0,30,14
1656103436708,MATH 10B,A01,083207,Lim; Seonhee,3,3,34,31
1656103436708,MATH 10B,A02,083208,Lim; Seonhee,10,2,35,25
1656103436708,MATH 10B,A03,093472,Staff,4,2,34,30
1656103436708,MATH 10B,B01,083739,Sinha; Shubham,12,0,30,18
1656103442744,MATH 18,A01,083743,Cinel; Cameron Alexander,7,0,30,23
1656103442744,MATH 18,A02,083744,Cinel; Cameron Alexander,10,0,30,20
1656103442744,MATH 18,A03,083745,Cinel; Cameron Alexander,3,0,30,27
1656103442744,MATH 18,B01,083748,Ma; Zilu,0,0,36,36
1656103442744,MATH 18,B02,083749,Ma; Zilu,0,0,36,36
1656103442744,MATH 18,B03,083750,Ma; Zilu,0,0,36,36
1656103442744,MATH 18,B04,083751,Ma; Zilu,0,0,36,36
1656103442744,MATH 18,B05,093473,Staff,3,0,36,33
1656103442744,MATH 18,B06,093474,Staff,3,0,36,33
1656103448770,MATH 20A,A01,083754,Zheng; Zequn,11,0,40,29
1656103454792,MATH 20B,A01,083756,Briones; Jor-el Thomas Caparas,0,0,36,36
1656103454792,MATH 20B,A02,083757,Briones; Jor-el Thomas Caparas,1,0,36,35
1656103454792,MATH 20B,A03,093475,Staff,3,0,36,33
1656103460815,MATH 20C,A01,083760,Briones; Jor-el Thomas Caparas,2,2,35,33
1656103460815,MATH 20C,A02,083761,Briones; Jor-el Thomas Caparas,9,1,35,26
1656103460815,MATH 20C,A03,093476,Staff,1,1,35,34
1656103460815,MATH 20C,B01,083762,Bach; Quang Tran,1,0,30,29
1656103466841,MATH 20D,A01,083765,Tran; Brian Kha,3,0,30,27
1656103466841,MATH 20D,A02,083766,Tran; Brian Kha,0,1,30,30
1656103466841,MATH 20D,A03,083767,Tran; Brian Kha,2,0,30,28
1656103472871,MATH 20E,A01,083771,Ganguly; Soumya,4,1,32,28
1656103472871,MATH 20E,A02,083772,Ganguly; Soumya,2,2,32,30
1656103472871,MATH 20E,B01,083773,Ciotti; Benjamin,14,0,35,21
1656103472871,MATH 20E,B02,083774,Ciotti; Benjamin,14,0,35,21
1656103478900,MATH 103A,A01,083777,Greenfeld; Be'Eri,3,0,36,33
1656103478900,MATH 103A,A02,083778,Greenfeld; Be'Eri,2,0,36,34
1656103478900,MATH 103A,A03,093561,Staff,4,1,36,32
1656103478900,MATH 103A,B01,083779,Greenfeld; Be'Eri,8,1,36,28
1656103478900,MATH 103A,B02,083780,Greenfeld; Be'Eri,0,1,36,36
1656103478900,MATH 103A,B03,093562,Staff,0,0,36,36
1656103484941,MATH 105,A01,085443,Carter; Anne Toulson,4,1,35,31
1656103484941,MATH 105,A02,093477,Staff,9,0,35,26
1656103490972,MATH 109,A01,083213,Ganzberger; Geoffrey Michael,1,1,34,33
1656103490972,MATH 109,A02,083214,Ganzberger; Geoffrey Michael,0,0,34,34
1656103490972,MATH 109,A03,093478,Staff,1,0,34,33
1656103490972,MATH 109,B01,083215,Ganzberger; Geoffrey Michael,3,0,32,29
1656103490972,MATH 109,B02,083216,Ganzberger; Geoffrey Michael,1,0,32,31
1656103490972,MATH 109,B03,093479,Staff,4,0,32,28
1656103497002,MATH 142A,A01,083219,Chow; Bennett,1,0,32,31
1656103497002,MATH 142A,A02,083220,Chow; Bennett,8,0,32,24
1656103497002,MATH 142A,A03,093480,Staff,5,0,32,27
1656103497002,MATH 142A,B03,093481,Staff,4,0,32,28
1656103497002,MATH 142A,B04,093558,Staff,5,0,32,27
1656103497002,MATH 142A,B05,093559,Staff,0,0,32,32
1656103503033,MATH 193A,A01,083224,Rotar; Vladimir,1,2,34,33
1656103503033,MATH 193A,A02,083225,Rotar; Vladimir,2,0,34,32
1656103503033,MATH 193A,A03,083781,Rotar; Vladimir,1,0,34,33
1656103503033,MATH 193A,A04,083782,Rotar; Vladimir,6,0,34,28
1656103503033,MATH 193A,A05,093482,Rotar; Vladimir,1,0,34,33
1656103509063,MATH 197,001,091859,McAuley; Julian John,9999,0,9999,0
1656103509063,MATH 197,002,095566,Kedlaya; Kiran S.,9997,0,9999,2
1656103509063,MATH 197,003,095567,Xiao; Ming,9999,0,9999,0
1656103509063,MATH 197,004,095571,Perols; Johan Lars,9998,0,9999,1
1656103516119,COGS 9,A01,083615,Shannon; Kyle Michael,5,1,75,70
1656103522143,COGS 11,A01,083617,Boyle; Mary E. T.,16,2,48,32
1656103528167,COGS 13,A01,083071,Bastos; Amalia Pinkusfeld,8,3,71,63
1656103534195,COGS 14A,A01,092681,Semenuks; Arturs,8,24,100,92
1656103540229,COGS 14B,A01,083073,Cheng; Tzu-Han,7,0,63,56
1656103546264,COGS 17,A01,092677,Semenuks; Arturs,13,6,81,68
1656103552288,COGS 100,A01,083619,Allen; Michael Gordon,7,4,70,63
1656103558310,COGS 101A,A01,083621,Davis; Joshua Daniel,7,3,68,61
1656103564337,COGS 101B,A01,091572,Allen; Michael Gordon,6,0,65,59
1656103570359,COGS 101C,A01,083625,Delgado; Tania,11,0,35,24
1656103576387,COGS 107A,A01,083627,Boyle; Mary E. T.,5,4,60,55
1656103582415,COGS 118A,A01,083075,Gupta; Anjum,24,17,76,52
1656103588442,CSE 3,A50,083646,Miranda; Gregory Joseph,18,0,50,32
1656103594467,CSE 8A,A50,083650,Miranda; Gregory Joseph,13,13,56,43
1656103600493,CSE 11,A01,083080,Cao; Yingjun,1,60,40,39
1656103606516,CSE 12,A01,083652,Krause-Levy; Sophia Louisa,14,8,120,106
1656103612541,CSE 15L,A01,083654,Morris; Justin Loren,5,2,50,45
1656103612541,CSE 15L,A02,083655,Morris; Justin Loren,7,2,50,43
1656103618564,CSE 20,A01,083657,Tran; Khoa Dang,31,0,80,49
1656103624593,CSE 21,A01,095574,Bach; Quang Tran,26,0,48,22
1656103630618,CSE 30,A01,083084,Eldon; John,3,11,80,77
1656103630618,CSE 30,B01,095061,Bhaskar; Nishant,4,5,50,46
1656103636641,CSE 100,A01,083659,Cao; Yingjun,2,23,70,68
1656103642664,CSE 134B,A01,083661,Powell; Thomas Allan,10,8,100,90
1656103648687,CSE 140,A01,083663,Gungor; Onat,9,0,85,76
1656103654718,CSE 140L,A01,083088,Eldon; John,8,0,100,92
1656103660745,CSE 175,A01,083665,Kumar; Rakesh,1,0,25,24
1656103666769,CSE 190,A00,092507,Dubnov; Shlomo,2,0,20,18
1656103672794,ECE 45,A01,083139,Congero; Spencer William,5,3,75,70
1656103678823,ECE 65,A50,083695,Saad; Andrew S,8,0,30,22
1656103678823,ECE 65,A51,095125,Staff,23,0,26,3
1656103684846,ECE 109,A01,091882,Touri; Behrouz,7,6,70,63
1656103690869,ECE 180,A00,083140,Abi Samra; Nicholas Camill,1,0,30,29
1656103690869,ECE 180,B00,083141,Abi Samra; Nicholas Camill,4,8,30,26
1656103696896,MATH 10A,A01,083735,Patchell; Gregory David,0,0,30,30
1656103696896,MATH 10A,A02,083736,Patchell; Gregory David,22,0,30,8
1656103696896,MATH 10A,A03,083737,Patchell; Gregory David,16,0,30,14
1656103702924,MATH 10B,A01,083207,Lim; Seonhee,3,3,34,31
1656103702924,MATH 10B,A02,083208,Lim; Seonhee,10,2,35,25
1656103702924,MATH 10B,A03,093472,Staff,4,2,34,30
1656103702924,MATH 10B,B01,083739,Sinha; Shubham,12,0,30,18
1656103708955,MATH 18,A01,083743,Cinel; Cameron Alexander,7,0,30,23
1656103708955,MATH 18,A02,083744,Cinel; Cameron Alexander,10,0,30,20
1656103708955,MATH 18,A03,083745,Cinel; Cameron Alexander,3,0,30,27
1656103708955,MATH 18,B01,083748,Ma; Zilu,0,0,36,36
1656103708955,MATH 18,B02,083749,Ma; Zilu,0,0,36,36
1656103708955,MATH 18,B03,083750,Ma; Zilu,0,0,36,36
1656103708955,MATH 18,B04,083751,Ma; Zilu,0,0,36,36
1656103708955,MATH 18,B05,093473,Staff,3,0,36,33
1656103708955,MATH 18,B06,093474,Staff,3,0,36,33
1656103714983,MATH 20A,A01,083754,Zheng; Zequn,11,0,40,29
1656103721023,MATH 20B,A01,083756,Briones; Jor-el Thomas Caparas,0,0,36,36
1656103721023,MATH 20B,A02,083757,Briones; Jor-el Thomas Caparas,1,0,36,35
1656103721023,MATH 20B,A03,093475,Staff,3,0,36,33
1656103727046,MATH 20C,A01,083760,Briones; Jor-el Thomas Caparas,2,2,35,33
1656103727046,MATH 20C,A02,083761,Briones; Jor-el Thomas Caparas,9,1,35,26
1656103727046,MATH 20C,A03,093476,Staff,1,1,35,34
1656103727046,MATH 20C,B01,083762,Bach; Quang Tran,1,0,30,29
1656103733085,MATH 20D,A01,083765,Tran; Brian Kha,3,0,30,27
1656103733085,MATH 20D,A02,083766,Tran; Brian Kha,0,1,30,30
1656103733085,MATH 20D,A03,083767,Tran; Brian Kha,2,0,30,28
1656103739109,MATH 20E,A01,083771,Ganguly; Soumya,4,1,32,28
1656103739109,MATH 20E,A02,083772,Ganguly; Soumya,2,2,32,30
1656103739109,MATH 20E,B01,083773,Ciotti; Benjamin,14,0,35,21
1656103739109,MATH 20E,B02,083774,Ciotti; Benjamin,14,0,35,21
1656103745133,MATH 103A,A01,083777,Greenfeld; Be'Eri,3,0,36,33
1656103745133,MATH 103A,A02,083778,Greenfeld; Be'Eri,2,0,36,34
1656103745133,MATH 103A,A03,093561,Staff,4,1,36,32
1656103745133,MATH 103A,B01,083779,Greenfeld; Be'Eri,8,1,36,28
1656103745133,MATH 103A,B02,083780,Greenfeld; Be'Eri,0,1,36,36
1656103745133,MATH 103A,B03,093562,Staff,0,0,36,36
1656103751160,MATH 105,A01,085443,Carter; Anne Toulson,4,1,35,31
1656103751160,MATH 105,A02,093477,Staff,9,0,35,26
1656103757186,MATH 109,A01,083213,Ganzberger; Geoffrey Michael,1,1,34,33
1656103757186,MATH 109,A02,083214,Ganzberger; Geoffrey Michael,0,0,34,34
1656103757186,MATH 109,A03,093478,Staff,1,0,34,33
1656103757186,MATH 109,B01,083215,Ganzberger; Geoffrey Michael,3,0,32,29
1656103757186,MATH 109,B02,083216,Ganzberger; Geoffrey Michael,1,0,32,31
1656103757186,MATH 109,B03,093479,Staff,4,0,32,28
1656103763210,MATH 142A,A01,083219,Chow; Bennett,1,0,32,31
1656103763210,MATH 142A,A02,083220,Chow; Bennett,8,0,32,24
1656103763210,MATH 142A,A03,093480,Staff,5,0,32,27
1656103763210,MATH 142A,B03,093481,Staff,4,0,32,28
1656103763210,MATH 142A,B04,093558,Staff,5,0,32,27
1656103763210,MATH 142A,B05,093559,Staff,0,0,32,32
1656103769235,MATH 193A,A01,083224,Rotar; Vladimir,1,2,34,33
1656103769235,MATH 193A,A02,083225,Rotar; Vladimir,2,0,34,32
1656103769235,MATH 193A,A03,083781,Rotar; Vladimir,1,0,34,33
1656103769235,MATH 193A,A04,083782,Rotar; Vladimir,6,0,34,28
1656103769235,MATH 193A,A05,093482,Rotar; Vladimir,1,0,34,33
1656103775259,MATH 197,001,091859,McAuley; Julian John,9999,0,9999,0
1656103775259,MATH 197,002,095566,Kedlaya; Kiran S.,9997,0,9999,2
1656103775259,MATH 197,003,095567,Xiao; Ming,9999,0,9999,0
1656103775259,MATH 197,004,095571,Perols; Johan Lars,9998,0,9999,1
1656103782314,COGS 9,A01,083615,Shannon; Kyle Michael,5,1,75,70
1656103788338,COGS 11,A01,083617,Boyle; Mary E. T.,16,2,48,32
1656103794361,COGS 13,A01,083071,Bastos; Amalia Pinkusfeld,8,3,71,63
1656103800386,COGS 14A,A01,092681,Semenuks; Arturs,8,24,100,92
1656103806416,COGS 14B,A01,083073,Cheng; Tzu-Han,7,0,63,56
1656103812442,COGS 17,A01,092677,Semenuks; Arturs,13,6,81,68
1656103818486,COGS 100,A01,083619,Allen; Michael Gordon,7,4,70,63
1656103824515,COGS 101A,A01,083621,Davis; Joshua Daniel,7,3,68,61
1656103830541,COGS 101B,A01,091572,Allen; Michael Gordon,6,0,65,59
1656103836567,COGS 101C,A01,083625,Delgado; Tania,11,0,35,24
1656103842594,COGS 107A,A01,083627,Boyle; Mary E. T.,5,4,60,55
1656103848618,COGS 118A,A01,083075,Gupta; Anjum,24,17,76,52
1656103854645,CSE 3,A50,083646,Miranda; Gregory Joseph,18,0,50,32
1656103860674,CSE 8A,A50,083650,Miranda; Gregory Joseph,13,13,56,43
1656103866696,CSE 11,A01,083080,Cao; Yingjun,1,60,40,39
1656103872719,CSE 12,A01,083652,Krause-Levy; Sophia Louisa,14,8,120,106
1656103878742,CSE 15L,A01,083654,Morris; Justin Loren,5,2,50,45
1656103878742,CSE 15L,A02,083655,Morris; Justin Loren,7,2,50,43
1656103884765,CSE 20,A01,083657,Tran; Khoa Dang,31,0,80,49
1656103890803,CSE 21,A01,095574,Bach; Quang Tran,26,0,48,22
1656103896830,CSE 30,A01,083084,Eldon; John,3,11,80,77
1656103896830,CSE 30,B01,095061,Bhaskar; Nishant,4,5,50,46
1656103902853,CSE 100,A01,083659,Cao; Yingjun,2,23,70,68
1656103908882,CSE 134B,A01,083661,Powell; Thomas Allan,10,8,100,90
1656103914907,CSE 140,A01,083663,Gungor; Onat,9,0,85,76
1656103920932,CSE 140L,A01,083088,Eldon; John,8,0,100,92
1656103926959,CSE 175,A01,083665,Kumar; Rakesh,1,0,25,24
1656103932986,CSE 190,A00,092507,Dubnov; Shlomo,2,0,20,18
1656103939008,ECE 45,A01,083139,Congero; Spencer William,5,3,75,70
1656103945114,ECE 65,A50,083695,Saad; Andrew S,8,0,30,22
1656103945114,ECE 65,A51,095125,Staff,23,0,26,3
1656103951136,ECE 109,A01,091882,Touri; Behrouz,7,6,70,63
1656103957167,ECE 180,A00,083140,Abi Samra; Nicholas Camill,1,0,30,29
1656103957167,ECE 180,B00,083141,Abi Samra; Nicholas Camill,4,8,30,26
1656103963196,MATH 10A,A01,083735,Patchell; Gregory David,0,0,30,30
1656103963196,MATH 10A,A02,083736,Patchell; Gregory David,22,0,30,8
1656103963196,MATH 10A,A03,083737,Patchell; Gregory David,16,0,30,14
1656103969220,MATH 10B,A01,083207,Lim; Seonhee,3,3,34,31
1656103969220,MATH 10B,A02,083208,Lim; Seonhee,10,2,35,25
1656103969220,MATH 10B,A03,093472,Staff,4,2,34,30
1656103969220,MATH 10B,B01,083739,Sinha; Shubham,12,0,30,18
1656103975246,MATH 18,A01,083743,Cinel; Cameron Alexander,7,0,30,23
1656103975246,MATH 18,A02,083744,Cinel; Cameron Alexander,10,0,30,20
1656103975246,MATH 18,A03,083745,Cinel; Cameron Alexander,3,0,30,27
1656103975246,MATH 18,B01,083748,Ma; Zilu,0,0,36,36
1656103975246,MATH 18,B02,083749,Ma; Zilu,0,0,36,36
1656103975246,MATH 18,B03,083750,Ma; Zilu,0,0,36,36
1656103975246,MATH 18,B04,083751,Ma; Zilu,0,0,36,36
1656103975246,MATH 18,B05,093473,Staff,3,0,36,33
1656103975246,MATH 18,B06,093474,Staff,3,0,36,33
1656103981271,MATH 20A,A01,083754,Zheng; Zequn,11,0,40,29
1656103987295,MATH 20B,A01,083756,Briones; Jor-el Thomas Caparas,0,0,36,36
1656103987295,MATH 20B,A02,083757,Briones; Jor-el Thomas Caparas,1,0,36,35
1656103987295,MATH 20B,A03,093475,Staff,3,0,36,33
1656103993319,MATH 20C,A01,083760,Briones; Jor-el Thomas Caparas,2,2,35,33
1656103993319,MATH 20C,A02,083761,Briones; Jor-el Thomas Caparas,9,1,35,26
1656103993319,MATH 20C,A03,093476,Staff,1,1,35,34
1656103993319,MATH 20C,B01,083762,Bach; Quang Tran,1,0,30,29
1656103999342,MATH 20D,A01,083765,Tran; Brian Kha,3,0,30,27
1656103999342,MATH 20D,A02,083766,Tran; Brian Kha,0,1,30,30
1656103999342,MATH 20D,A03,083767,Tran; Brian Kha,2,0,30,28
1656104005370,MATH 20E,A01,083771,Ganguly; Soumya,4,1,32,28
1656104005370,MATH 20E,A02,083772,Ganguly; Soumya,2,2,32,30
1656104005370,MATH 20E,B01,083773,Ciotti; Benjamin,14,0,35,21
1656104005370,MATH 20E,B02,083774,Ciotti; Benjamin,14,0,35,21
1656104011395,MATH 103A,A01,083777,Greenfeld; Be'Eri,3,0,36,33
1656104011395,MATH 103A,A02,083778,Greenfeld; Be'Eri,2,0,36,34
1656104011395,MATH 103A,A03,093561,Staff,4,1,36,32
1656104011395,MATH 103A,B01,083779,Greenfeld; Be'Eri,8,1,36,28
1656104011395,MATH 103A,B02,083780,Greenfeld; Be'Eri,0,1,36,36
1656104011395,MATH 103A,B03,093562,Staff,0,0,36,36
1656104017417,MATH 105,A01,085443,Carter; Anne Toulson,4,1,35,31
1656104017417,MATH 105,A02,093477,Staff,9,0,35,26
1656104023445,MATH 109,A01,083213,Ganzberger; Geoffrey Michael,1,1,34,33
1656104023445,MATH 109,A02,083214,Ganzberger; Geoffrey Michael,0,0,34,34
1656104023445,MATH 109,A03,093478,Staff,1,0,34,33
1656104023445,MATH 109,B01,083215,Ganzberger; Geoffrey Michael,3,0,32,29
1656104023445,MATH 109,B02,083216,Ganzberger; Geoffrey Michael,1,0,32,31
1656104023445,MATH 109,B03,093479,Staff,4,0,32,28
1656104029476,MATH 142A,A01,083219,Chow; Bennett,1,0,32,31
1656104029476,MATH 142A,A02,083220,Chow; Bennett,8,0,32,24
1656104029476,MATH 142A,A03,093480,Staff,5,0,32,27
1656104029476,MATH 142A,B03,093481,Staff,4,0,32,28
1656104029476,MATH 142A,B04,093558,Staff,5,0,32,27
1656104029476,MATH 142A,B05,093559,Staff,0,0,32,32
1656104035504,MATH 193A,A01,083224,Rotar; Vladimir,1,2,34,33
1656104035504,MATH 193A,A02,083225,Rotar; Vladimir,2,0,34,32
1656104035504,MATH 193A,A03,083781,Rotar; Vladimir,1,0,34,33
1656104035504,MATH 193A,A04,083782,Rotar; Vladimir,6,0,34,28
1656104035504,MATH 193A,A05,093482,Rotar; Vladimir,1,0,34,33
1656104041526,MATH 197,001,091859,McAuley; Julian John,9999,0,9999,0
1656104041526,MATH 197,002,095566,Kedlaya; Kiran S.,9997,0,9999,2
1656104041526,MATH 197,003,095567,Xiao; Ming,9999,0,9999,0
1656104041526,MATH 197,004,095571,Perols; Johan Lars,9998,0,9999,1
1656104048593,COGS 9,A01,083615,Shannon; Kyle Michael,5,1,75,70
1656104054618,COGS 11,A01,083617,Boyle; Mary E. T.,16,2,48,32
1656104060642,COGS 13,A01,083071,Bastos; Amalia Pinkusfeld,8,3,71,63
1656104066677,COGS 14A,A01,092681,Semenuks; Arturs,8,24,100,92
1656104072702,COGS 14B,A01,083073,Cheng; Tzu-Han,7,0,63,56
1656104078731,COGS 17,A01,092677,Semenuks; Arturs,13,6,81,68
1656104084752,COGS 100,A01,083619,Allen; Michael Gordon,7,4,70,63
1656104090783,COGS 101A,A01,083621,Davis; Joshua Daniel,7,3,68,61
1656104096805,COGS 101B,A01,091572,Allen; Michael Gordon,6,0,65,59
1656104102841,COGS 101C,A01,083625,Delgado; Tania,11,0,35,24
1656104108866,COGS 107A,A01,083627,Boyle; Mary E. T.,5,4,60,55
1656104114891,COGS 118A,A01,083075,Gupta; Anjum,24,17,76,52
1656104120914,CSE 3,A50,083646,Miranda; Gregory Joseph,18,0,50,32
1656104126937,CSE 8A,A50,083650,Miranda; Gregory Joseph,13,13,56,43
1656104132961,CSE 11,A01,083080,Cao; Yingjun,1,60,40,39
1656104138985,CSE 12,A01,083652,Krause-Levy; Sophia Louisa,14,8,120,106
1656104145019,CSE 15L,A01,083654,Morris; Justin Loren,5,2,50,45
1656104145019,CSE 15L,A02,083655,Morris; Justin Loren,7,2,50,43
1656104151043,CSE 20,A01,083657,Tran; Khoa Dang,31,0,80,49
1656104157076,CSE 21,A01,095574,Bach; Quang Tran,26,0,48,22
1656104163105,CSE 30,A01,083084,Eldon; John,3,11,80,77
1656104163105,CSE 30,B01,095061,Bhaskar; Nishant,4,5,50,46
1656104169143,CSE 100,A01,083659,Cao; Yingjun,2,23,70,68
1656104175178,CSE 134B,A01,083661,Powell; Thomas Allan,10,8,100,90
1656104181201,CSE 140,A01,083663,Gungor; Onat,9,0,85,76
1656104187228,CSE 140L,A01,083088,Eldon; John,8,0,100,92
1656104193250,CSE 175,A01,083665,Kumar; Rakesh,1,0,25,24
1656104199278,CSE 190,A00,092507,Dubnov; Shlomo,2,0,20,18
1656104205306,ECE 45,A01,083139,Congero; Spencer William,5,3,75,70
1656104211329,ECE 65,A50,083695,Saad; Andrew S,8,0,30,22
1656104211329,ECE 65,A51,095125,Staff,23,0,26,3
1656104217351,ECE 109,A01,091882,Touri; Behrouz,7,6,70,63
1656104223374,ECE 180,A00,083140,Abi Samra; Nicholas Camill,1,0,30,29
1656104223374,ECE 180,B00,083141,Abi Samra; Nicholas Camill,4,8,30,26
1656104229401,MATH 10A,A01,083735,Patchell; Gregory David,0,0,30,30
1656104229401,MATH 10A,A02,083736,Patchell; Gregory David,22,0,30,8
1656104229401,MATH 10A,A03,083737,Patchell; Gregory David,16,0,30,14
1656104235433,MATH 10B,A01,083207,Lim; Seonhee,3,3,34,31
1656104235433,MATH 10B,A02,083208,Lim; Seonhee,10,2,35,25
1656104235433,MATH 10B,A03,093472,Staff,4,2,34,30
1656104235433,MATH 10B,B01,083739,Sinha; Shubham,12,0,30,18
1656104241462,MATH 18,A01,083743,Cinel; Cameron Alexander,7,0,30,23
1656104241462,MATH 18,A02,083744,Cinel; Cameron Alexander,10,0,30,20
1656104241462,MATH 18,A03,083745,Cinel; Cameron Alexander,3,0,30,27
1656104241462,MATH 18,B01,083748,Ma; Zilu,0,0,36,36
1656104241462,MATH 18,B02,083749,Ma; Zilu,0,0,36,36
1656104241462,MATH 18,B03,083750,Ma; Zilu,0,0,36,36
1656104241462,MATH 18,B04,083751,Ma; Zilu,0,0,36,36
1656104241462,MATH 18,B05,093473,Staff,3,0,36,33
1656104241462,MATH 18,B06,093474,Staff,3,0,36,33
1656104247487,MATH 20A,A01,083754,Zheng; Zequn,11,0,40,29
1656104253509,MATH 20B,A01,083756,Briones; Jor-el Thomas Caparas,0,0,36,36
1656104253509,MATH 20B,A02,083757,Briones; Jor-el Thomas Caparas,0,0,36,36
1656104253509,MATH 20B,A03,093475,Staff,3,0,36,33
1656104259539,MATH 20C,A01,083760,Briones; Jor-el Thomas Caparas,2,2,35,33
1656104259539,MATH 20C,A02,083761,Briones; Jor-el Thomas Caparas,9,1,35,26
1656104259539,MATH 20C,A03,093476,Staff,1,1,35,34
1656104259539,MATH 20C,B01,083762,Bach; Quang Tran,1,0,30,29
1656104265565,MATH 20D,A01,083765,Tran; Brian Kha,3,0,30,27
1656104265565,MATH 20D,A02,083766,Tran; Brian Kha,0,1,30,30
1656104265565,MATH 20D,A03,083767,Tran; Brian Kha,2,0,30,28
1656104271595,MATH 20E,A01,083771,Ganguly; Soumya,4,1,32,28
1656104271595,MATH 20E,A02,083772,Ganguly; Soumya,2,2,32,30
1656104271595,MATH 20E,B01,083773,Ciotti; Benjamin,14,0,35,21
1656104271595,MATH 20E,B02,083774,Ciotti; Benjamin,14,0,35,21
1656104277625,MATH 103A,A01,083777,Greenfeld; Be'Eri,3,0,36,33
1656104277625,MATH 103A,A02,083778,Greenfeld; Be'Eri,2,0,36,34
1656104277625,MATH 103A,A03,093561,Staff,4,1,36,32
1656104277625,MATH 103A,B01,083779,Greenfeld; Be'Eri,8,1,36,28
1656104277625,MATH 103A,B02,083780,Greenfeld; Be'Eri,0,1,36,36
1656104277625,MATH 103A,B03,093562,Staff,0,0,36,36
1656104283648,MATH 105,A01,085443,Carter; Anne Toulson,4,1,35,31
1656104283648,MATH 105,A02,093477,Staff,9,0,35,26
1656104289678,MATH 109,A01,083213,Ganzberger; Geoffrey Michael,1,1,34,33
1656104289678,MATH 109,A02,083214,Ganzberger; Geoffrey Michael,0,0,34,34
1656104289678,MATH 109,A03,093478,Staff,1,0,34,33
1656104289678,MATH 109,B01,083215,Ganzberger; Geoffrey Michael,3,0,32,29
1656104289678,MATH 109,B02,083216,Ganzberger; Geoffrey Michael,1,0,32,31
1656104289678,MATH 109,B03,093479,Staff,4,0,32,28
1656104295707,MATH 142A,A01,083219,Chow; Bennett,1,0,32,31
1656104295707,MATH 142A,A02,083220,Chow; Bennett,8,0,32,24
1656104295707,MATH 142A,A03,093480,Staff,5,0,32,27
1656104295707,MATH 142A,B03,093481,Staff,4,0,32,28
1656104295707,MATH 142A,B04,093558,Staff,5,0,32,27
1656104295707,MATH 142A,B05,093559,Staff,0,0,32,32
1656104301750,MATH 193A,A01,083224,Rotar; Vladimir,1,2,34,33
1656104301750,MATH 193A,A02,083225,Rotar; Vladimir,2,0,34,32
1656104301750,MATH 193A,A03,083781,Rotar; Vladimir,1,0,34,33
1656104301750,MATH 193A,A04,083782,Rotar; Vladimir,6,0,34,28
1656104301750,MATH 193A,A05,093482,Rotar; Vladimir,1,0,34,33
1656104307774,MATH 197,001,091859,McAuley; Julian John,9999,0,9999,0
1656104307774,MATH 197,002,095566,Kedlaya; Kiran S.,9997,0,9999,2
1656104307774,MATH 197,003,095567,Xiao; Ming,9999,0,9999,0
1656104307774,MATH 197,004,095571,Perols; Johan Lars,9998,0,9999,1
1656104314828,COGS 9,A01,083615,Shannon; Kyle Michael,5,1,75,70
1656104320861,COGS 11,A01,083617,Boyle; Mary E. T.,16,2,48,32
1656104326885,COGS 13,A01,083071,Bastos; Amalia Pinkusfeld,8,3,71,63
1656104332912,COGS 14A,A01,092681,Semenuks; Arturs,8,24,100,92
1656104338941,COGS 14B,A01,083073,Cheng; Tzu-Han,7,0,63,56
1656104344976,COGS 17,A01,092677,Semenuks; Arturs,13,6,81,68
1656104351003,COGS 100,A01,083619,Allen; Michael Gordon,7,4,70,63
1656104357026,COGS 101A,A01,083621,Davis; Joshua Daniel,7,3,68,61
1656104363053,COGS 101B,A01,091572,Allen; Michael Gordon,6,0,65,59
1656104369082,COGS 101C,A01,083625,Delgado; Tania,11,0,35,24
1656104375104,COGS 107A,A01,083627,Boyle; Mary E. T.,5,4,60,55
1656104381128,COGS 118A,A01,083075,Gupta; Anjum,24,17,76,52
1656104387165,CSE 3,A50,083646,Miranda; Gregory Joseph,18,0,50,32
1656104393191,CSE 8A,A50,083650,Miranda; Gregory Joseph,13,13,56,43
1656104399218,CSE 11,A01,083080,Cao; Yingjun,1,60,40,39
1656104405240,CSE 12,A01,083652,Krause-Levy; Sophia Louisa,14,8,120,106
1656104411276,CSE 15L,A01,083654,Morris; Justin Loren,5,2,50,45
1656104411276,CSE 15L,A02,083655,Morris; Justin Loren,7,2,50,43
1656104417300,CSE 20,A01,083657,Tran; Khoa Dang,31,0,80,49
1656104423325,CSE 21,A01,095574,Bach; Quang Tran,26,0,48,22
1656104429353,CSE 30,A01,083084,Eldon; John,3,11,80,77
1656104429353,CSE 30,B01,095061,Bhaskar; Nishant,4,5,50,46
1656104435382,CSE 100,A01,083659,Cao; Yingjun,2,22,70,68
1656104441410,CSE 134B,A01,083661,Powell; Thomas Allan,10,8,100,90
1656104447439,CSE 140,A01,083663,Gungor; Onat,9,0,85,76
1656104453462,CSE 140L,A01,083088,Eldon; John,8,0,100,92
1656104459501,CSE 175,A01,083665,Kumar; Rakesh,1,0,25,24
1656104465529,CSE 190,A00,092507,Dubnov; Shlomo,2,0,20,18
1656104471552,ECE 45,A01,083139,Congero; Spencer William,5,3,75,70
1656104477579,ECE 65,A50,083695,Saad; Andrew S,8,0,30,22
1656104477579,ECE 65,A51,095125,Staff,23,0,26,3
1656104483609,ECE 109,A01,091882,Touri; Behrouz,7,6,70,63
1656104489631,ECE 180,A00,083140,Abi Samra; Nicholas Camill,1,0,30,29
1656104489631,ECE 180,B00,083141,Abi Samra; Nicholas Camill,4,8,30,26
1656104495661,MATH 10A,A01,083735,Patchell; Gregory David,0,0,30,30
1656104495661,MATH 10A,A02,083736,Patchell; Gregory David,22,0,30,8
1656104495661,MATH 10A,A03,083737,Patchell; Gregory David,16,0,30,14
1656104501697,MATH 10B,A01,083207,Lim; Seonhee,3,3,34,31
1656104501697,MATH 10B,A02,083208,Lim; Seonhee,10,2,35,25
1656104501697,MATH 10B,A03,093472,Staff,4,2,34,30
1656104501697,MATH 10B,B01,083739,Sinha; Shubham,12,0,30,18
1656104507730,MATH 18,A01,083743,Cinel; Cameron Alexander,7,0,30,23
1656104507730,MATH 18,A02,083744,Cinel; Cameron Alexander,10,0,30,20
1656104507730,MATH 18,A03,083745,Cinel; Cameron Alexander,3,0,30,27
1656104507730,MATH 18,B01,083748,Ma; Zilu,0,0,36,36
1656104507730,MATH 18,B02,083749,Ma; Zilu,0,0,36,36
1656104507730,MATH 18,B03,083750,Ma; Zilu,0,0,36,36
1656104507730,MATH 18,B04,083751,Ma; Zilu,0,0,36,36
1656104507730,MATH 18,B05,093473,Staff,3,0,36,33
1656104507730,MATH 18,B06,093474,Staff,3,0,36,33
1656104513756,MATH 20A,A01,083754,Zheng; Zequn,11,0,40,29
1656104519779,MATH 20B,A01,083756,Briones; Jor-el Thomas Caparas,0,0,36,36
1656104519779,MATH 20B,A02,083757,Briones; Jor-el Thomas Caparas,0,0,36,36
1656104519779,MATH 20B,A03,093475,Staff,3,0,36,33
1656104525803,MATH 20C,A01,083760,Briones; Jor-el Thomas Caparas,2,2,35,33
1656104525803,MATH 20C,A02,083761,Briones; Jor-el Thomas Caparas,9,1,35,26
1656104525803,MATH 20C,A03,093476,Staff,1,1,35,34
1656104525803,MATH 20C,B01,083762,Bach; Quang Tran,1,0,30,29
1656104531831,MATH 20D,A01,083765,Tran; Brian Kha,3,0,30,27
1656104531831,MATH 20D,A02,083766,Tran; Brian Kha,0,1,30,30
1656104531831,MATH 20D,A03,083767,Tran; Brian Kha,2,0,30,28
1656104537860,MATH 20E,A01,083771,Ganguly; Soumya,4,1,32,28
1656104537860,MATH 20E,A02,083772,Ganguly; Soumya,2,2,32,30
1656104537860,MATH 20E,B01,083773,Ciotti; Benjamin,14,0,35,21
1656104537860,MATH 20E,B02,083774,Ciotti; Benjamin,14,0,35,21
1656104543955,MATH 103A,A01,083777,Greenfeld; Be'Eri,3,0,36,33
1656104543955,MATH 103A,A02,083778,Greenfeld; Be'Eri,2,0,36,34
1656104543955,MATH 103A,A03,093561,Staff,4,1,36,32
1656104543955,MATH 103A,B01,083779,Greenfeld; Be'Eri,8,1,36,28
1656104543955,MATH 103A,B02,083780,Greenfeld; Be'Eri,0,1,36,36
1656104543955,MATH 103A,B03,093562,Staff,0,0,36,36
1656104549978,MATH 105,A01,085443,Carter; Anne Toulson,4,1,35,31
1656104549978,MATH 105,A02,093477,Staff,9,0,35,26
1656104556013,MATH 109,A01,083213,Ganzberger; Geoffrey Michael,1,1,34,33
1656104556013,MATH 109,A02,083214,Ganzberger; Geoffrey Michael,0,0,34,34
1656104556013,MATH 109,A03,093478,Staff,1,0,34,33
1656104556013,MATH 109,B01,083215,Ganzberger; Geoffrey Michael,3,0,32,29
1656104556013,MATH 109,B02,083216,Ganzberger; Geoffrey Michael,1,0,32,31
1656104556013,MATH 109,B03,093479,Staff,4,0,32,28
1656104562038,MATH 142A,A01,083219,Chow; Bennett,1,0,32,31
1656104562038,MATH 142A,A02,083220,Chow; Bennett,8,0,32,24
1656104562038,MATH 142A,A03,093480,Staff,5,0,32,27
1656104562038,MATH 142A,B03,093481,Staff,4,0,32,28
1656104562038,MATH 142A,B04,093558,Staff,5,0,32,27
1656104562038,MATH 142A,B05,093559,Staff,0,0,32,32
1656104568062,MATH 193A,A01,083224,Rotar; Vladimir,1,2,34,33
1656104568062,MATH 193A,A02,083225,Rotar; Vladimir,2,0,34,32
1656104568062,MATH 193A,A03,083781,Rotar; Vladimir,1,0,34,33
1656104568062,MATH 193A,A04,083782,Rotar; Vladimir,6,0,34,28
1656104568062,MATH 193A,A05,093482,Rotar; Vladimir,1,0,34,33
1656104574086,MATH 197,001,091859,McAuley; Julian John,9999,0,9999,0
1656104574086,MATH 197,002,095566,Kedlaya; Kiran S.,9997,0,9999,2
1656104574086,MATH 197,003,095567,Xiao; Ming,9999,0,9999,0
1656104574086,MATH 197,004,095571,Perols; Johan Lars,9998,0,9999,1
1656104581141,COGS 9,A01,083615,Shannon; Kyle Michael,5,1,75,70
1656104587168,COGS 11,A01,083617,Boyle; Mary E. T.,16,2,48,32
1656104593196,COGS 13,A01,083071,Bastos; Amalia Pinkusfeld,8,3,71,63
1656104599219,COGS 14A,A01,092681,Semenuks; Arturs,8,24,100,92
1656104605243,COGS 14B,A01,083073,Cheng; Tzu-Han,7,0,63,56
1656104611272,COGS 17,A01,092677,Semenuks; Arturs,13,6,81,68
1656104617295,COGS 100,A01,083619,Allen; Michael Gordon,7,4,70,63
1656104623328,COGS 101A,A01,083621,Davis; Joshua Daniel,7,3,68,61
1656104629352,COGS 101B,A01,091572,Allen; Michael Gordon,6,0,65,59
1656104635384,COGS 101C,A01,083625,Delgado; Tania,11,0,35,24
1656104641416,COGS 107A,A01,083627,Boyle; Mary E. T.,5,4,60,55
1656104647439,COGS 118A,A01,083075,Gupta; Anjum,24,17,76,52
1656104653462,CSE 3,A50,083646,Miranda; Gregory Joseph,18,0,50,32
1656104659485,CSE 8A,A50,083650,Miranda; Gregory Joseph,13,13,56,43
1656104665510,CSE 11,A01,083080,Cao; Yingjun,1,60,40,39
1656104671536,CSE 12,A01,083652,Krause-Levy; Sophia Louisa,14,8,120,106
1656104677559,CSE 15L,A01,083654,Morris; Justin Loren,5,2,50,45
1656104677559,CSE 15L,A02,083655,Morris; Justin Loren,7,2,50,43
1656104683584,CSE 20,A01,083657,Tran; Khoa Dang,31,0,80,49
1656104689605,CSE 21,A01,095574,Bach; Quang Tran,26,0,48,22
1656104695636,CSE 30,A01,083084,Eldon; John,3,11,80,77
1656104695636,CSE 30,B01,095061,Bhaskar; Nishant,4,5,50,46
1656104701658,CSE 100,A01,083659,Cao; Yingjun,2,22,70,68
1656104707680,CSE 134B,A01,083661,Powell; Thomas Allan,10,8,100,90
1656104713711,CSE 140,A01,083663,Gungor; Onat,9,0,85,76
1656104719756,CSE 140L,A01,083088,Eldon; John,8,0,100,92
1656104725779,CSE 175,A01,083665,Kumar; Rakesh,1,0,25,24
1656104731802,CSE 190,A00,092507,Dubnov; Shlomo,2,0,20,18
1656104737829,ECE 45,A01,083139,Congero; Spencer William,5,3,75,70
1656104743854,ECE 65,A50,083695,Saad; Andrew S,8,0,30,22
1656104743854,ECE 65,A51,095125,Staff,23,0,26,3
1656104749881,ECE 109,A01,091882,Touri; Behrouz,7,6,70,63
1656104755908,ECE 180,A00,083140,Abi Samra; Nicholas Camill,1,0,30,29
1656104755908,ECE 180,B00,083141,Abi Samra; Nicholas Camill,4,8,30,26
1656104761932,MATH 10A,A01,083735,Patchell; Gregory David,0,0,30,30
1656104761932,MATH 10A,A02,083736,Patchell; Gregory David,22,0,30,8
1656104761932,MATH 10A,A03,083737,Patchell; Gregory David,16,0,30,14
1656104767970,MATH 10B,A01,083207,Lim; Seonhee,3,3,34,31
1656104767970,MATH 10B,A02,083208,Lim; Seonhee,10,2,35,25
1656104767970,MATH 10B,A03,093472,Staff,4,2,34,30
1656104767970,MATH 10B,B01,083739,Sinha; Shubham,12,0,30,18
1656104773997,MATH 18,A01,083743,Cinel; Cameron Alexander,7,0,30,23
1656104773997,MATH 18,A02,083744,Cinel; Cameron Alexander,10,0,30,20
1656104773997,MATH 18,A03,083745,Cinel; Cameron Alexander,3,0,30,27
1656104773997,MATH 18,B01,083748,Ma; Zilu,0,0,36,36
1656104773997,MATH 18,B02,083749,Ma; Zilu,0,0,36,36
1656104773997,MATH 18,B03,083750,Ma; Zilu,0,0,36,36
1656104773997,MATH 18,B04,083751,Ma; Zilu,0,0,36,36
1656104773997,MATH 18,B05,093473,Staff,3,0,36,33
1656104773997,MATH 18,B06,093474,Staff,3,0,36,33
1656104780019,MATH 20A,A01,083754,Zheng; Zequn,11,0,40,29
1656104786044,MATH 20B,A01,083756,Briones; Jor-el Thomas Caparas,0,0,36,36
1656104786044,MATH 20B,A02,083757,Briones; Jor-el Thomas Caparas,0,0,36,36
1656104786044,MATH 20B,A03,093475,Staff,3,0,36,33
1656104792073,MATH 20C,A01,083760,Briones; Jor-el Thomas Caparas,2,2,35,33
1656104792073,MATH 20C,A02,083761,Briones; Jor-el Thomas Caparas,9,1,35,26
1656104792073,MATH 20C,A03,093476,Staff,1,1,35,34
1656104792073,MATH 20C,B01,083762,Bach; Quang Tran,1,0,30,29
1656104798112,MATH 20D,A01,083765,Tran; Brian Kha,3,0,30,27
1656104798112,MATH 20D,A02,083766,Tran; Brian Kha,0,1,30,30
1656104798112,MATH 20D,A03,083767,Tran; Brian Kha,2,0,30,28
1656104804137,MATH 20E,A01,083771,Ganguly; Soumya,4,1,32,28
1656104804137,MATH 20E,A02,083772,Ganguly; Soumya,2,2,32,30
1656104804137,MATH 20E,B01,083773,Ciotti; Benjamin,14,0,35,21
1656104804137,MATH 20E,B02,083774,Ciotti; Benjamin,14,0,35,21
1656104810163,MATH 103A,A01,083777,Greenfeld; Be'Eri,3,0,36,33
1656104810163,MATH 103A,A02,083778,Greenfeld; Be'Eri,2,0,36,34
1656104810163,MATH 103A,A03,093561,Staff,4,1,36,32
1656104810163,MATH 103A,B01,083779,Greenfeld; Be'Eri,8,1,36,28
1656104810163,MATH 103A,B02,083780,Greenfeld; Be'Eri,0,1,36,36
1656104810163,MATH 103A,B03,093562,Staff,0,0,36,36
1656104816198,MATH 105,A01,085443,Carter; Anne Toulson,4,1,35,31
1656104816198,MATH 105,A02,093477,Staff,9,0,35,26
1656104822227,MATH 109,A01,083213,Ganzberger; Geoffrey Michael,1,1,34,33
1656104822227,MATH 109,A02,083214,Ganzberger; Geoffrey Michael,0,0,34,34
1656104822227,MATH 109,A03,093478,Staff,1,0,34,33
1656104822227,MATH 109,B01,083215,Ganzberger; Geoffrey Michael,3,0,32,29
1656104822227,MATH 109,B02,083216,Ganzberger; Geoffrey Michael,1,0,32,31
1656104822227,MATH 109,B03,093479,Staff,4,0,32,28
1656104828255,MATH 142A,A01,083219,Chow; Bennett,1,0,32,31
1656104828255,MATH 142A,A02,083220,Chow; Bennett,8,0,32,24
1656104828255,MATH 142A,A03,093480,Staff,5,0,32,27
1656104828255,MATH 142A,B03,093481,Staff,4,0,32,28
1656104828255,MATH 142A,B04,093558,Staff,5,0,32,27
1656104828255,MATH 142A,B05,093559,Staff,0,0,32,32
1656104834279,MATH 193A,A01,083224,Rotar; Vladimir,1,2,34,33
1656104834279,MATH 193A,A02,083225,Rotar; Vladimir,2,0,34,32
1656104834279,MATH 193A,A03,083781,Rotar; Vladimir,1,0,34,33
1656104834279,MATH 193A,A04,083782,Rotar; Vladimir,6,0,34,28
1656104834279,MATH 193A,A05,093482,Rotar; Vladimir,1,0,34,33
1656104840311,MATH 197,001,091859,McAuley; Julian John,9999,0,9999,0
1656104840311,MATH 197,002,095566,Kedlaya; Kiran S.,9997,0,9999,2
1656104840311,MATH 197,003,095567,Xiao; Ming,9999,0,9999,0
1656104840311,MATH 197,004,095571,Perols; Johan Lars,9998,0,9999,1
1656104847373,COGS 9,A01,083615,Shannon; Kyle Michael,5,1,75,70
1656104853413,COGS 11,A01,083617,Boyle; Mary E. T.,16,2,48,32
1656104859441,COGS 13,A01,083071,Bastos; Amalia Pinkusfeld,8,3,71,63
1656104865465,COGS 14A,A01,092681,Semenuks; Arturs,8,24,100,92
1656104871494,COGS 14B,A01,083073,Cheng; Tzu-Han,7,0,63,56
1656104877516,COGS 17,A01,092677,Semenuks; Arturs,13,6,81,68
1656104883541,COGS 100,A01,083619,Allen; Michael Gordon,7,4,70,63
1656104889575,COGS 101A,A01,083621,Davis; Joshua Daniel,7,3,68,61
1656104895602,COGS 101B,A01,091572,Allen; Michael Gordon,6,0,65,59
1656104901626,COGS 101C,A01,083625,Delgado; Tania,11,0,35,24
1656104907660,COGS 107A,A01,083627,Boyle; Mary E. T.,5,4,60,55
1656104913682,COGS 118A,A01,083075,Gupta; Anjum,24,17,76,52
1656104919716,CSE 3,A50,083646,Miranda; Gregory Joseph,18,0,50,32
1656104925750,CSE 8A,A50,083650,Miranda; Gregory Joseph,13,13,56,43
1656104931781,CSE 11,A01,083080,Cao; Yingjun,1,60,40,39
1656104937803,CSE 12,A01,083652,Krause-Levy; Sophia Louisa,14,8,120,106
1656104943830,CSE 15L,A01,083654,Morris; Justin Loren,5,2,50,45
1656104943830,CSE 15L,A02,083655,Morris; Justin Loren,7,2,50,43
1656104949858,CSE 20,A01,083657,Tran; Khoa Dang,31,0,80,49
1656104955884,CSE 21,A01,095574,Bach; Quang Tran,26,0,48,22
1656104961910,CSE 30,A01,083084,Eldon; John,3,11,80,77
1656104961910,CSE 30,B01,095061,Bhaskar; Nishant,4,5,50,46
1656104967936,CSE 100,A01,083659,Cao; Yingjun,2,22,70,68
1656104973962,CSE 134B,A01,083661,Powell; Thomas Allan,10,8,100,90
1656104979994,CSE 140,A01,083663,Gungor; Onat,9,0,85,76
1656104986021,CSE 140L,A01,083088,Eldon; John,8,0,100,92
1656104992044,CSE 175,A01,083665,Kumar; Rakesh,1,0,25,24
1656104998065,CSE 190,A00,092507,Dubnov; Shlomo,2,0,20,18
1656105004093,ECE 45,A01,083139,Congero; Spencer William,5,3,75,70
1656105010127,ECE 65,A50,083695,Saad; Andrew S,8,0,30,22
1656105010127,ECE 65,A51,095125,Staff,23,0,26,3
1656105016155,ECE 109,A01,091882,Touri; Behrouz,7,6,70,63
1656105022182,ECE 180,A00,083140,Abi Samra; Nicholas Camill,1,0,30,29
1656105022182,ECE 180,B00,083141,Abi Samra; Nicholas Camill,4,8,30,26
1656105028206,MATH 10A,A01,083735,Patchell; Gregory David,0,0,30,30
1656105028206,MATH 10A,A02,083736,Patchell; Gregory David,22,0,30,8
1656105028206,MATH 10A,A03,083737,Patchell; Gregory David,16,0,30,14
1656105034235,MATH 10B,A01,083207,Lim; Seonhee,3,3,34,31
1656105034235,MATH 10B,A02,083208,Lim; Seonhee,10,2,35,25
1656105034235,MATH 10B,A03,093472,Staff,4,2,34,30
1656105034235,MATH 10B,B01,083739,Sinha; Shubham,12,0,30,18
1656105040266,MATH 18,A01,083743,Cinel; Cameron Alexander,7,0,30,23
1656105040266,MATH 18,A02,083744,Cinel; Cameron Alexander,10,0,30,20
1656105040266,MATH 18,A03,083745,Cinel; Cameron Alexander,3,0,30,27
1656105040266,MATH 18,B01,083748,Ma; Zilu,0,0,36,36
1656105040266,MATH 18,B02,083749,Ma; Zilu,0,0,36,36
1656105040266,MATH 18,B03,083750,Ma; Zilu,0,0,36,36
1656105040266,MATH 18,B04,083751,Ma; Zilu,0,0,36,36
1656105040266,MATH 18,B05,093473,Staff,3,0,36,33
1656105040266,MATH 18,B06,093474,Staff,3,0,36,33
1656105046288,MATH 20A,A01,083754,Zheng; Zequn,11,0,40,29
1656105052315,MATH 20B,A01,083756,Briones; Jor-el Thomas Caparas,0,0,36,36
1656105052315,MATH 20B,A02,083757,Briones; Jor-el Thomas Caparas,0,0,36,36
1656105052315,MATH 20B,A03,093475,Staff,3,0,36,33
1656105058342,MATH 20C,A01,083760,Briones; Jor-el Thomas Caparas,2,2,35,33
1656105058342,MATH 20C,A02,083761,Briones; Jor-el Thomas Caparas,9,1,35,26
1656105058342,MATH 20C,A03,093476,Staff,1,1,35,34
1656105058342,MATH 20C,B01,083762,Bach; Quang Tran,1,0,30,29
1656105064365,MATH 20D,A01,083765,Tran; Brian Kha,3,0,30,27
1656105064365,MATH 20D,A02,083766,Tran; Brian Kha,0,1,30,30
1656105064365,MATH 20D,A03,083767,Tran; Brian Kha,2,0,30,28
1656105070398,MATH 20E,A01,083771,Ganguly; Soumya,4,1,32,28
1656105070398,MATH 20E,A02,083772,Ganguly; Soumya,2,2,32,30
1656105070398,MATH 20E,B01,083773,Ciotti; Benjamin,14,0,35,21
1656105070398,MATH 20E,B02,083774,Ciotti; Benjamin,14,0,35,21
1656105076433,MATH 103A,A01,083777,Greenfeld; Be'Eri,3,0,36,33
1656105076433,MATH 103A,A02,083778,Greenfeld; Be'Eri,2,0,36,34
1656105076433,MATH 103A,A03,093561,Staff,4,1,36,32
1656105076433,MATH 103A,B01,083779,Greenfeld; Be'Eri,8,1,36,28
1656105076433,MATH 103A,B02,083780,Greenfeld; Be'Eri,0,1,36,36
1656105076433,MATH 103A,B03,093562,Staff,0,0,36,36
1656105082457,MATH 105,A01,085443,Carter; Anne Toulson,4,1,35,31
1656105082457,MATH 105,A02,093477,Staff,9,0,35,26
1656105088486,MATH 109,A01,083213,Ganzberger; Geoffrey Michael,1,1,34,33
1656105088486,MATH 109,A02,083214,Ganzberger; Geoffrey Michael,0,0,34,34
1656105088486,MATH 109,A03,093478,Staff,1,0,34,33
1656105088486,MATH 109,B01,083215,Ganzberger; Geoffrey Michael,3,0,32,29
1656105088486,MATH 109,B02,083216,Ganzberger; Geoffrey Michael,1,0,32,31
1656105088486,MATH 109,B03,093479,Staff,4,0,32,28
1656105094508,MATH 142A,A01,083219,Chow; Bennett,1,0,32,31
1656105094508,MATH 142A,A02,083220,Chow; Bennett,8,0,32,24
1656105094508,MATH 142A,A03,093480,Staff,5,0,32,27
1656105094508,MATH 142A,B03,093481,Staff,4,0,32,28
1656105094508,MATH 142A,B04,093558,Staff,5,0,32,27
1656105094508,MATH 142A,B05,093559,Staff,0,0,32,32
1656105100535,MATH 193A,A01,083224,Rotar; Vladimir,1,2,34,33
1656105100535,MATH 193A,A02,083225,Rotar; Vladimir,1,0,34,33
1656105100535,MATH 193A,A03,083781,Rotar; Vladimir,1,0,34,33
1656105100535,MATH 193A,A04,083782,Rotar; Vladimir,6,0,34,28
1656105100535,MATH 193A,A05,093482,Rotar; Vladimir,1,0,34,33
1656105106558,MATH 197,001,091859,McAuley; Julian John,9999,0,9999,0
1656105106558,MATH 197,002,095566,Kedlaya; Kiran S.,9997,0,9999,2
1656105106558,MATH 197,003,095567,Xiao; Ming,9999,0,9999,0
1656105106558,MATH 197,004,095571,Perols; Johan Lars,9998,0,9999,1
1656105113610,COGS 9,A01,083615,Shannon; Kyle Michael,5,1,75,70
1656105119636,COGS 11,A01,083617,Boyle; Mary E. T.,16,2,48,32
1656105125658,COGS 13,A01,083071,Bastos; Amalia Pinkusfeld,8,3,71,63
1656105131687,COGS 14A,A01,092681,Semenuks; Arturs,8,24,100,92
1656105137804,COGS 14B,A01,083073,Cheng; Tzu-Han,7,0,63,56
1656105143834,COGS 17,A01,092677,Semenuks; Arturs,13,6,81,68
1656105149857,COGS 100,A01,083619,Allen; Michael Gordon,7,4,70,63
1656105155881,COGS 101A,A01,083621,Davis; Joshua Daniel,7,3,68,61
1656105161904,COGS 101B,A01,091572,Allen; Michael Gordon,6,0,65,59
1656105167927,COGS 101C,A01,083625,Delgado; Tania,11,0,35,24
1656105173954,COGS 107A,A01,083627,Boyle; Mary E. T.,5,4,60,55
1656105179978,COGS 118A,A01,083075,Gupta; Anjum,24,17,76,52
1656105186005,CSE 3,A50,083646,Miranda; Gregory Joseph,18,0,50,32
1656105192029,CSE 8A,A50,083650,Miranda; Gregory Joseph,13,13,56,43
1656105198055,CSE 11,A01,083080,Cao; Yingjun,1,60,40,39
1656105204081,CSE 12,A01,083652,Krause-Levy; Sophia Louisa,14,8,120,106
1656105210105,CSE 15L,A01,083654,Morris; Justin Loren,5,2,50,45
1656105210105,CSE 15L,A02,083655,Morris; Justin Loren,7,2,50,43
1656105216136,CSE 20,A01,083657,Tran; Khoa Dang,31,0,80,49
1656105222159,CSE 21,A01,095574,Bach; Quang Tran,26,0,48,22
1656105228198,CSE 30,A01,083084,Eldon; John,3,11,80,77
1656105228198,CSE 30,B01,095061,Bhaskar; Nishant,4,5,50,46
1656105234227,CSE 100,A01,083659,Cao; Yingjun,2,22,70,68
1656105240253,CSE 134B,A01,083661,Powell; Thomas Allan,10,8,100,90
1656105246278,CSE 140,A01,083663,Gungor; Onat,9,0,85,76
1656105252314,CSE 140L,A01,083088,Eldon; John,8,0,100,92
1656105258343,CSE 175,A01,083665,Kumar; Rakesh,1,0,25,24
1656105264374,CSE 190,A00,092507,Dubnov; Shlomo,2,0,20,18
1656105270400,ECE 45,A01,083139,Congero; Spencer William,5,3,75,70
1656105276423,ECE 65,A50,083695,Saad; Andrew S,8,0,30,22
1656105276423,ECE 65,A51,095125,Staff,23,0,26,3
1656105282448,ECE 109,A01,091882,Touri; Behrouz,7,6,70,63
1656105288474,ECE 180,A00,083140,Abi Samra; Nicholas Camill,1,0,30,29
1656105288474,ECE 180,B00,083141,Abi Samra; Nicholas Camill,4,8,30,26
1656105294507,MATH 10A,A01,083735,Patchell; Gregory David,0,0,30,30
1656105294507,MATH 10A,A02,083736,Patchell; Gregory David,22,0,30,8
1656105294507,MATH 10A,A03,083737,Patchell; Gregory David,16,0,30,14
1656105300547,MATH 10B,A01,083207,Lim; Seonhee,3,3,34,31
1656105300547,MATH 10B,A02,083208,Lim; Seonhee,10,2,35,25
1656105300547,MATH 10B,A03,093472,Staff,4,2,34,30
1656105300547,MATH 10B,B01,083739,Sinha; Shubham,12,0,30,18
1656105306570,MATH 18,A01,083743,Cinel; Cameron Alexander,7,0,30,23
1656105306570,MATH 18,A02,083744,Cinel; Cameron Alexander,10,0,30,20
1656105306570,MATH 18,A03,083745,Cinel; Cameron Alexander,3,0,30,27
1656105306570,MATH 18,B01,083748,Ma; Zilu,0,0,36,36
1656105306570,MATH 18,B02,083749,Ma; Zilu,0,0,36,36
1656105306570,MATH 18,B03,083750,Ma; Zilu,0,0,36,36
1656105306570,MATH 18,B04,083751,Ma; Zilu,0,0,36,36
1656105306570,MATH 18,B05,093473,Staff,3,0,36,33
1656105306570,MATH 18,B06,093474,Staff,3,0,36,33
1656105312598,MATH 20A,A01,083754,Zheng; Zequn,11,0,40,29
1656105318622,MATH 20B,A01,083756,Briones; Jor-el Thomas Caparas,0,0,36,36
1656105318622,MATH 20B,A02,083757,Briones; Jor-el Thomas Caparas,0,0,36,36
1656105318622,MATH 20B,A03,093475,Staff,3,0,36,33
1656105324646,MATH 20C,A01,083760,Briones; Jor-el Thomas Caparas,2,2,35,33
1656105324646,MATH 20C,A02,083761,Briones; Jor-el Thomas Caparas,9,1,35,26
1656105324646,MATH 20C,A03,093476,Staff,1,1,35,34
1656105324646,MATH 20C,B01,083762,Bach; Quang Tran,1,0,30,29
1656105330674,MATH 20D,A01,083765,Tran; Brian Kha,3,0,30,27
1656105330674,MATH 20D,A02,083766,Tran; Brian Kha,0,1,30,30
1656105330674,MATH 20D,A03,083767,Tran; Brian Kha,2,0,30,28
1656105336698,MATH 20E,A01,083771,Ganguly; Soumya,4,1,32,28
1656105336698,MATH 20E,A02,083772,Ganguly; Soumya,2,2,32,30
1656105336698,MATH 20E,B01,083773,Ciotti; Benjamin,14,0,35,21
1656105336698,MATH 20E,B02,083774,Ciotti; Benjamin,14,0,35,21
1656105342730,MATH 103A,A01,083777,Greenfeld; Be'Eri,3,0,36,33
1656105342730,MATH 103A,A02,083778,Greenfeld; Be'Eri,2,0,36,34
1656105342730,MATH 103A,A03,093561,Staff,4,1,36,32
1656105342730,MATH 103A,B01,083779,Greenfeld; Be'Eri,8,1,36,28
1656105342730,MATH 103A,B02,083780,Greenfeld; Be'Eri,0,1,36,36
1656105342730,MATH 103A,B03,093562,Staff,0,0,36,36
1656105348760,MATH 105,A01,085443,Carter; Anne Toulson,4,1,35,31
1656105348760,MATH 105,A02,093477,Staff,9,0,35,26
1656105354788,MATH 109,A01,083213,Ganzberger; Geoffrey Michael,1,1,34,33
1656105354788,MATH 109,A02,083214,Ganzberger; Geoffrey Michael,0,0,34,34
1656105354788,MATH 109,A03,093478,Staff,1,0,34,33
1656105354788,MATH 109,B01,083215,Ganzberger; Geoffrey Michael,3,0,32,29
1656105354788,MATH 109,B02,083216,Ganzberger; Geoffrey Michael,1,0,32,31
1656105354788,MATH 109,B03,093479,Staff,4,0,32,28
1656105360822,MATH 142A,A01,083219,Chow; Bennett,1,0,32,31
1656105360822,MATH 142A,A02,083220,Chow; Bennett,8,0,32,24
1656105360822,MATH 142A,A03,093480,Staff,5,0,32,27
1656105360822,MATH 142A,B03,093481,Staff,4,0,32,28
1656105360822,MATH 142A,B04,093558,Staff,5,0,32,27
1656105360822,MATH 142A,B05,093559,Staff,0,0,32,32
1656105366851,MATH 193A,A01,083224,Rotar; Vladimir,1,2,34,33
1656105366851,MATH 193A,A02,083225,Rotar; Vladimir,1,0,34,33
1656105366851,MATH 193A,A03,083781,Rotar; Vladimir,1,0,34,33
1656105366851,MATH 193A,A04,083782,Rotar; Vladimir,6,0,34,28
1656105366851,MATH 193A,A05,093482,Rotar; Vladimir,1,0,34,33
1656105372882,MATH 197,001,091859,McAuley; Julian John,9999,0,9999,0
1656105372882,MATH 197,002,095566,Kedlaya; Kiran S.,9997,0,9999,2
1656105372882,MATH 197,003,095567,Xiao; Ming,9999,0,9999,0
1656105372882,MATH 197,004,095571,Perols; Johan Lars,9998,0,9999,1
1656105379950,COGS 9,A01,083615,Shannon; Kyle Michael,5,1,75,70
1656105385976,COGS 11,A01,083617,Boyle; Mary E. T.,16,2,48,32
1656105392008,COGS 13,A01,083071,Bastos; Amalia Pinkusfeld,8,3,71,63
1656105398034,COGS 14A,A01,092681,Semenuks; Arturs,8,24,100,92
1656105404070,COGS 14B,A01,083073,Cheng; Tzu-Han,7,0,63,56
1656105410111,COGS 17,A01,092677,Semenuks; Arturs,13,6,81,68
1656105416142,COGS 100,A01,083619,Allen; Michael Gordon,7,4,70,63
1656105422176,COGS 101A,A01,083621,Davis; Joshua Daniel,7,3,68,61
1656105428206,COGS 101B,A01,091572,Allen; Michael Gordon,6,0,65,59
1656105434238,COGS 101C,A01,083625,Delgado; Tania,11,0,35,24
1656105440265,COGS 107A,A01,083627,Boyle; Mary E. T.,5,4,60,55
1656105446292,COGS 118A,A01,083075,Gupta; Anjum,24,17,76,52
1656105452321,CSE 3,A50,083646,Miranda; Gregory Joseph,18,0,50,32
1656105458354,CSE 8A,A50,083650,Miranda; Gregory Joseph,13,13,56,43
1656105464377,CSE 11,A01,083080,Cao; Yingjun,1,60,40,39
1656105470401,CSE 12,A01,083652,Krause-Levy; Sophia Louisa,14,8,120,106
1656105476429,CSE 15L,A01,083654,Morris; Justin Loren,5,2,50,45
1656105476429,CSE 15L,A02,083655,Morris; Justin Loren,7,2,50,43
1656105482454,CSE 20,A01,083657,Tran; Khoa Dang,31,0,80,49
1656105488476,CSE 21,A01,095574,Bach; Quang Tran,26,0,48,22
1656105494504,CSE 30,A01,083084,Eldon; John,3,11,80,77
1656105494504,CSE 30,B01,095061,Bhaskar; Nishant,4,5,50,46
1656105500528,CSE 100,A01,083659,Cao; Yingjun,2,22,70,68
1656105506552,CSE 134B,A01,083661,Powell; Thomas Allan,10,8,100,90
1656105512575,CSE 140,A01,083663,Gungor; Onat,9,0,85,76
1656105518605,CSE 140L,A01,083088,Eldon; John,8,0,100,92
1656105524631,CSE 175,A01,083665,Kumar; Rakesh,1,0,25,24
1656105530658,CSE 190,A00,092507,Dubnov; Shlomo,2,0,20,18
1656105536681,ECE 45,A01,083139,Congero; Spencer William,5,3,75,70
1656105542705,ECE 65,A50,083695,Saad; Andrew S,8,0,30,22
1656105542705,ECE 65,A51,095125,Staff,23,0,26,3
1656105548728,ECE 109,A01,091882,Touri; Behrouz,7,6,70,63
1656105554755,ECE 180,A00,083140,Abi Samra; Nicholas Camill,1,0,30,29
1656105554755,ECE 180,B00,083141,Abi Samra; Nicholas Camill,4,8,30,26
1656105560782,MATH 10A,A01,083735,Patchell; Gregory David,0,0,30,30
1656105560782,MATH 10A,A02,083736,Patchell; Gregory David,22,0,30,8
1656105560782,MATH 10A,A03,083737,Patchell; Gregory David,16,0,30,14
1656105566806,MATH 10B,A01,083207,Lim; Seonhee,3,3,34,31
1656105566806,MATH 10B,A02,083208,Lim; Seonhee,10,2,35,25
1656105566806,MATH 10B,A03,093472,Staff,4,2,34,30
1656105566806,MATH 10B,B01,083739,Sinha; Shubham,12,0,30,18
1656105572843,MATH 18,A01,083743,Cinel; Cameron Alexander,7,0,30,23
1656105572843,MATH 18,A02,083744,Cinel; Cameron Alexander,10,0,30,20
1656105572843,MATH 18,A03,083745,Cinel; Cameron Alexander,3,0,30,27
1656105572843,MATH 18,B01,083748,Ma; Zilu,0,0,36,36
1656105572843,MATH 18,B02,083749,Ma; Zilu,0,0,36,36
1656105572843,MATH 18,B03,083750,Ma; Zilu,0,0,36,36
1656105572843,MATH 18,B04,083751,Ma; Zilu,0,0,36,36
1656105572843,MATH 18,B05,093473,Staff,3,0,36,33
1656105572843,MATH 18,B06,093474,Staff,3,0,36,33
1656105578870,MATH 20A,A01,083754,Zheng; Zequn,11,0,40,29
1656105584893,MATH 20B,A01,083756,Briones; Jor-el Thomas Caparas,0,0,36,36
1656105584893,MATH 20B,A02,083757,Briones; Jor-el Thomas Caparas,0,0,36,36
1656105584893,MATH 20B,A03,093475,Staff,3,0,36,33
1656105590917,MATH 20C,A01,083760,Briones; Jor-el Thomas Caparas,2,2,35,33
1656105590917,MATH 20C,A02,083761,Briones; Jor-el Thomas Caparas,9,1,35,26
1656105590917,MATH 20C,A03,093476,Staff,1,1,35,34
1656105590917,MATH 20C,B01,083762,Bach; Quang Tran,1,0,30,29
1656105596947,MATH 20D,A01,083765,Tran; Brian Kha,3,0,30,27
1656105596947,MATH 20D,A02,083766,Tran; Brian Kha,0,1,30,30
1656105596947,MATH 20D,A03,083767,Tran; Brian Kha,2,0,30,28
1656105602974,MATH 20E,A01,083771,Ganguly; Soumya,4,1,32,28
1656105602974,MATH 20E,A02,083772,Ganguly; Soumya,2,2,32,30
1656105602974,MATH 20E,B01,083773,Ciotti; Benjamin,14,0,35,21
1656105602974,MATH 20E,B02,083774,Ciotti; Benjamin,14,0,35,21
1656105608997,MATH 103A,A01,083777,Greenfeld; Be'Eri,3,0,36,33
1656105608997,MATH 103A,A02,083778,Greenfeld; Be'Eri,2,0,36,34
1656105608997,MATH 103A,A03,093561,Staff,4,1,36,32
1656105608997,MATH 103A,B01,083779,Greenfeld; Be'Eri,8,1,36,28
1656105608997,MATH 103A,B02,083780,Greenfeld; Be'Eri,0,1,36,36
1656105608997,MATH 103A,B03,093562,Staff,0,0,36,36
1656105615026,MATH 105,A01,085443,Carter; Anne Toulson,4,1,35,31
1656105615026,MATH 105,A02,093477,Staff,9,0,35,26
1656105621056,MATH 109,A01,083213,Ganzberger; Geoffrey Michael,1,1,34,33
1656105621056,MATH 109,A02,083214,Ganzberger; Geoffrey Michael,0,0,34,34
1656105621056,MATH 109,A03,093478,Staff,1,0,34,33
1656105621056,MATH 109,B01,083215,Ganzberger; Geoffrey Michael,3,0,32,29
1656105621056,MATH 109,B02,083216,Ganzberger; Geoffrey Michael,1,0,32,31
1656105621056,MATH 109,B03,093479,Staff,4,0,32,28
1656105627083,MATH 142A,A01,083219,Chow; Bennett,1,0,32,31
1656105627083,MATH 142A,A02,083220,Chow; Bennett,8,0,32,24
1656105627083,MATH 142A,A03,093480,Staff,5,0,32,27
1656105627083,MATH 142A,B03,093481,Staff,4,0,32,28
1656105627083,MATH 142A,B04,093558,Staff,5,0,32,27
1656105627083,MATH 142A,B05,093559,Staff,0,0,32,32
1656105633113,MATH 193A,A01,083224,Rotar; Vladimir,1,2,34,33
1656105633113,MATH 193A,A02,083225,Rotar; Vladimir,1,0,34,33
1656105633113,MATH 193A,A03,083781,Rotar; Vladimir,1,0,34,33
1656105633113,MATH 193A,A04,083782,Rotar; Vladimir,6,0,34,28
1656105633113,MATH 193A,A05,093482,Rotar; Vladimir,1,0,34,33
1656105639136,MATH 197,001,091859,McAuley; Julian John,9999,0,9999,0
1656105639136,MATH 197,002,095566,Kedlaya; Kiran S.,9997,0,9999,2
1656105639136,MATH 197,003,095567,Xiao; Ming,9999,0,9999,0
1656105639136,MATH 197,004,095571,Perols; Johan Lars,9998,0,9999,1
1656105646196,COGS 9,A01,083615,Shannon; Kyle Michael,5,1,75,70
1656105652218,COGS 11,A01,083617,Boyle; Mary E. T.,16,2,48,32
1656105658253,COGS 13,A01,083071,Bastos; Amalia Pinkusfeld,8,3,71,63
1656105664276,COGS 14A,A01,092681,Semenuks; Arturs,8,24,100,92
1656105670300,COGS 14B,A01,083073,Cheng; Tzu-Han,7,0,63,56
1656105676322,COGS 17,A01,092677,Semenuks; Arturs,13,6,81,68
1656105682345,COGS 100,A01,083619,Allen; Michael Gordon,7,4,70,63
1656105688368,COGS 101A,A01,083621,Davis; Joshua Daniel,7,3,68,61
1656105694394,COGS 101B,A01,091572,Allen; Michael Gordon,6,0,65,59
1656105700423,COGS 101C,A01,083625,Delgado; Tania,11,0,35,24
1656105706445,COGS 107A,A01,083627,Boyle; Mary E. T.,5,4,60,55
1656105712472,COGS 118A,A01,083075,Gupta; Anjum,24,17,76,52
1656105718496,CSE 3,A50,083646,Miranda; Gregory Joseph,18,0,50,32
1656105724523,CSE 8A,A50,083650,Miranda; Gregory Joseph,13,13,56,43
1656105730546,CSE 11,A01,083080,Cao; Yingjun,1,60,40,39
1656105736646,CSE 12,A01,083652,Krause-Levy; Sophia Louisa,14,8,120,106
1656105742669,CSE 15L,A01,083654,Morris; Justin Loren,5,2,50,45
1656105742669,CSE 15L,A02,083655,Morris; Justin Loren,7,2,50,43
1656105748694,CSE 20,A01,083657,Tran; Khoa Dang,31,0,80,49
1656105754719,CSE 21,A01,095574,Bach; Quang Tran,26,0,48,22
1656105760748,CSE 30,A01,083084,Eldon; John,3,11,80,77
1656105760748,CSE 30,B01,095061,Bhaskar; Nishant,4,5,50,46
1656105766771,CSE 100,A01,083659,Cao; Yingjun,2,22,70,68
1656105772799,CSE 134B,A01,083661,Powell; Thomas Allan,10,8,100,90
1656105778826,CSE 140,A01,083663,Gungor; Onat,9,0,85,76
1656105784860,CSE 140L,A01,083088,Eldon; John,8,0,100,92
1656105790883,CSE 175,A01,083665,Kumar; Rakesh,1,0,25,24
1656105796919,CSE 190,A00,092507,Dubnov; Shlomo,2,0,20,18
1656105802946,ECE 45,A01,083139,Congero; Spencer William,5,3,75,70
1656105808978,ECE 65,A50,083695,Saad; Andrew S,8,0,30,22
1656105808978,ECE 65,A51,095125,Staff,23,0,26,3
1656105815012,ECE 109,A01,091882,Touri; Behrouz,7,6,70,63
1656105821036,ECE 180,A00,083140,Abi Samra; Nicholas Camill,1,0,30,29
1656105821036,ECE 180,B00,083141,Abi Samra; Nicholas Camill,4,8,30,26
1656105827063,MATH 10A,A01,083735,Patchell; Gregory David,0,0,30,30
1656105827063,MATH 10A,A02,083736,Patchell; Gregory David,22,0,30,8
1656105827063,MATH 10A,A03,083737,Patchell; Gregory David,16,0,30,14
1656105833087,MATH 10B,A01,083207,Lim; Seonhee,3,3,34,31
1656105833087,MATH 10B,A02,083208,Lim; Seonhee,10,2,35,25
1656105833087,MATH 10B,A03,093472,Staff,4,2,34,30
1656105833087,MATH 10B,B01,083739,Sinha; Shubham,12,0,30,18
1656105839112,MATH 18,A01,083743,Cinel; Cameron Alexander,7,0,30,23
1656105839112,MATH 18,A02,083744,Cinel; Cameron Alexander,10,0,30,20
1656105839112,MATH 18,A03,083745,Cinel; Cameron Alexander,3,0,30,27
1656105839112,MATH 18,B01,083748,Ma; Zilu,0,0,36,36
1656105839112,MATH 18,B02,083749,Ma; Zilu,0,0,36,36
1656105839112,MATH 18,B03,083750,Ma; Zilu,0,0,36,36
1656105839112,MATH 18,B04,083751,Ma; Zilu,0,0,36,36
1656105839112,MATH 18,B05,093473,Staff,3,0,36,33
1656105839112,MATH 18,B06,093474,Staff,3,0,36,33
1656105845135,MATH 20A,A01,083754,Zheng; Zequn,11,0,40,29
1656105851160,MATH 20B,A01,083756,Briones; Jor-el Thomas Caparas,0,0,36,36
1656105851160,MATH 20B,A02,083757,Briones; Jor-el Thomas Caparas,0,0,36,36
1656105851160,MATH 20B,A03,093475,Staff,3,0,36,33
1656105857184,MATH 20C,A01,083760,Briones; Jor-el Thomas Caparas,2,2,35,33
1656105857184,MATH 20C,A02,083761,Briones; Jor-el Thomas Caparas,9,1,35,26
1656105857184,MATH 20C,A03,093476,Staff,1,1,35,34
1656105857184,MATH 20C,B01,083762,Bach; Quang Tran,1,0,30,29
1656105863213,MATH 20D,A01,083765,Tran; Brian Kha,3,0,30,27
1656105863213,MATH 20D,A02,083766,Tran; Brian Kha,0,1,30,30
1656105863213,MATH 20D,A03,083767,Tran; Brian Kha,2,0,30,28
1656105869242,MATH 20E,A01,083771,Ganguly; Soumya,4,1,32,28
1656105869242,MATH 20E,A02,083772,Ganguly; Soumya,2,2,32,30
1656105869242,MATH 20E,B01,083773,Ciotti; Benjamin,14,0,35,21
1656105869242,MATH 20E,B02,083774,Ciotti; Benjamin,14,0,35,21
1656105875271,MATH 103A,A01,083777,Greenfeld; Be'Eri,3,0,36,33
1656105875271,MATH 103A,A02,083778,Greenfeld; Be'Eri,2,0,36,34
1656105875271,MATH 103A,A03,093561,Staff,4,1,36,32
1656105875271,MATH 103A,B01,083779,Greenfeld; Be'Eri,8,1,36,28
1656105875271,MATH 103A,B02,083780,Greenfeld; Be'Eri,0,1,36,36
1656105875271,MATH 103A,B03,093562,Staff,0,0,36,36
1656105881308,MATH 105,A01,085443,Carter; Anne Toulson,4,1,35,31
1656105881308,MATH 105,A02,093477,Staff,9,0,35,26
1656105887335,MATH 109,A01,083213,Ganzberger; Geoffrey Michael,1,1,34,33
1656105887335,MATH 109,A02,083214,Ganzberger; Geoffrey Michael,0,0,34,34
1656105887335,MATH 109,A03,093478,Staff,1,0,34,33
1656105887335,MATH 109,B01,083215,Ganzberger; Geoffrey Michael,3,0,32,29
1656105887335,MATH 109,B02,083216,Ganzberger; Geoffrey Michael,1,0,32,31
1656105887335,MATH 109,B03,093479,Staff,4,0,32,28
1656105893359,MATH 142A,A01,083219,Chow; Bennett,1,0,32,31
1656105893359,MATH 142A,A02,083220,Chow; Bennett,8,0,32,24
1656105893359,MATH 142A,A03,093480,Staff,5,0,32,27
1656105893359,MATH 142A,B03,093481,Staff,4,0,32,28
1656105893359,MATH 142A,B04,093558,Staff,5,0,32,27
1656105893359,MATH 142A,B05,093559,Staff,0,0,32,32
1656105899383,MATH 193A,A01,083224,Rotar; Vladimir,1,2,34,33
1656105899383,MATH 193A,A02,083225,Rotar; Vladimir,1,0,34,33
1656105899383,MATH 193A,A03,083781,Rotar; Vladimir,1,0,34,33
1656105899383,MATH 193A,A04,083782,Rotar; Vladimir,6,0,34,28
1656105899383,MATH 193A,A05,093482,Rotar; Vladimir,1,0,34,33
1656105905407,MATH 197,001,091859,McAuley; Julian John,9999,0,9999,0
1656105905407,MATH 197,002,095566,Kedlaya; Kiran S.,9997,0,9999,2
1656105905407,MATH 197,003,095567,Xiao; Ming,9999,0,9999,0
1656105905407,MATH 197,004,095571,Perols; Johan Lars,9998,0,9999,1
1656105912468,COGS 9,A01,083615,Shannon; Kyle Michael,5,1,75,70
1656105918502,COGS 11,A01,083617,Boyle; Mary E. T.,16,2,48,32
1656105924528,COGS 13,A01,083071,Bastos; Amalia Pinkusfeld,8,3,71,63
1656105930549,COGS 14A,A01,092681,Semenuks; Arturs,8,24,100,92
1656105936573,COGS 14B,A01,083073,Cheng; Tzu-Han,7,0,63,56
1656105942598,COGS 17,A01,092677,Semenuks; Arturs,13,6,81,68
1656105948622,COGS 100,A01,083619,Allen; Michael Gordon,7,4,70,63
1656105954644,COGS 101A,A01,083621,Davis; Joshua Daniel,7,3,68,61
1656105960668,COGS 101B,A01,091572,Allen; Michael Gordon,6,0,65,59
1656105966691,COGS 101C,A01,083625,Delgado; Tania,11,0,35,24
1656105972714,COGS 107A,A01,083627,Boyle; Mary E. T.,5,4,60,55
1656105978742,COGS 118A,A01,083075,Gupta; Anjum,24,17,76,52
1656105984770,CSE 3,A50,083646,Miranda; Gregory Joseph,18,0,50,32
1656105990795,CSE 8A,A50,083650,Miranda; Gregory Joseph,13,13,56,43
1656105996817,CSE 11,A01,083080,Cao; Yingjun,1,60,40,39
1656106002846,CSE 12,A01,083652,Krause-Levy; Sophia Louisa,14,8,120,106
1656106008881,CSE 15L,A01,083654,Morris; Justin Loren,5,2,50,45
1656106008881,CSE 15L,A02,083655,Morris; Justin Loren,7,2,50,43
1656106014911,CSE 20,A01,083657,Tran; Khoa Dang,31,0,80,49
1656106020934,CSE 21,A01,095574,Bach; Quang Tran,26,0,48,22
1656106026957,CSE 30,A01,083084,Eldon; John,3,11,80,77
1656106026957,CSE 30,B01,095061,Bhaskar; Nishant,4,5,50,46
1656106032984,CSE 100,A01,083659,Cao; Yingjun,2,22,70,68
1656106039007,CSE 134B,A01,083661,Powell; Thomas Allan,10,8,100,90
1656106045031,CSE 140,A01,083663,Gungor; Onat,9,0,85,76
1656106051057,CSE 140L,A01,083088,Eldon; John,8,0,100,92
1656106057082,CSE 175,A01,083665,Kumar; Rakesh,1,0,25,24
1656106063105,CSE 190,A00,092507,Dubnov; Shlomo,2,0,20,18
1656106069132,ECE 45,A01,083139,Congero; Spencer William,5,3,75,70
1656106075174,ECE 65,A50,083695,Saad; Andrew S,8,0,30,22
1656106075174,ECE 65,A51,095125,Staff,23,0,26,3
1656106081197,ECE 109,A01,091882,Touri; Behrouz,7,6,70,63
1656106087221,ECE 180,A00,083140,Abi Samra; Nicholas Camill,1,0,30,29
1656106087221,ECE 180,B00,083141,Abi Samra; Nicholas Camill,4,8,30,26
1656106093248,MATH 10A,A01,083735,Patchell; Gregory David,0,0,30,30
1656106093248,MATH 10A,A02,083736,Patchell; Gregory David,22,0,30,8
1656106093248,MATH 10A,A03,083737,Patchell; Gregory David,16,0,30,14
1656106099278,MATH 10B,A01,083207,Lim; Seonhee,3,3,34,31
1656106099278,MATH 10B,A02,083208,Lim; Seonhee,10,2,35,25
1656106099278,MATH 10B,A03,093472,Staff,4,2,34,30
1656106099278,MATH 10B,B01,083739,Sinha; Shubham,12,0,30,18
1656106105313,MATH 18,A01,083743,Cinel; Cameron Alexander,7,0,30,23
1656106105313,MATH 18,A02,083744,Cinel; Cameron Alexander,10,0,30,20
1656106105313,MATH 18,A03,083745,Cinel; Cameron Alexander,3,0,30,27
1656106105313,MATH 18,B01,083748,Ma; Zilu,0,0,36,36
1656106105313,MATH 18,B02,083749,Ma; Zilu,0,0,36,36
1656106105313,MATH 18,B03,083750,Ma; Zilu,0,0,36,36
1656106105313,MATH 18,B04,083751,Ma; Zilu,0,0,36,36
1656106105313,MATH 18,B05,093473,Staff,3,0,36,33
1656106105313,MATH 18,B06,093474,Staff,3,0,36,33
1656106111337,MATH 20A,A01,083754,Zheng; Zequn,11,0,40,29
1656106117369,MATH 20B,A01,083756,Briones; Jor-el Thomas Caparas,0,0,36,36
1656106117369,MATH 20B,A02,083757,Briones; Jor-el Thomas Caparas,0,0,36,36
1656106117369,MATH 20B,A03,093475,Staff,3,0,36,33
1656106123405,MATH 20C,A01,083760,Briones; Jor-el Thomas Caparas,2,2,35,33
1656106123405,MATH 20C,A02,083761,Briones; Jor-el Thomas Caparas,9,1,35,26
1656106123405,MATH 20C,A03,093476,Staff,1,1,35,34
1656106123405,MATH 20C,B01,083762,Bach; Quang Tran,1,0,30,29
1656106129427,MATH 20D,A01,083765,Tran; Brian Kha,3,0,30,27
1656106129427,MATH 20D,A02,083766,Tran; Brian Kha,0,1,30,30
1656106129427,MATH 20D,A03,083767,Tran; Brian Kha,2,0,30,28
1656106135452,MATH 20E,A01,083771,Ganguly; Soumya,4,1,32,28
1656106135452,MATH 20E,A02,083772,Ganguly; Soumya,2,2,32,30
1656106135452,MATH 20E,B01,083773,Ciotti; Benjamin,14,0,35,21
1656106135452,MATH 20E,B02,083774,Ciotti; Benjamin,14,0,35,21
1656106141477,MATH 103A,A01,083777,Greenfeld; Be'Eri,3,0,36,33
1656106141477,MATH 103A,A02,083778,Greenfeld; Be'Eri,2,0,36,34
1656106141477,MATH 103A,A03,093561,Staff,4,1,36,32
1656106141477,MATH 103A,B01,083779,Greenfeld; Be'Eri,8,1,36,28
1656106141477,MATH 103A,B02,083780,Greenfeld; Be'Eri,0,1,36,36
1656106141477,MATH 103A,B03,093562,Staff,0,0,36,36
1656106147518,MATH 105,A01,085443,Carter; Anne Toulson,4,1,35,31
1656106147518,MATH 105,A02,093477,Staff,9,0,35,26
1656106153546,MATH 109,A01,083213,Ganzberger; Geoffrey Michael,1,1,34,33
1656106153546,MATH 109,A02,083214,Ganzberger; Geoffrey Michael,0,0,34,34
1656106153546,MATH 109,A03,093478,Staff,1,0,34,33
1656106153546,MATH 109,B01,083215,Ganzberger; Geoffrey Michael,3,0,32,29
1656106153546,MATH 109,B02,083216,Ganzberger; Geoffrey Michael,1,0,32,31
1656106153546,MATH 109,B03,093479,Staff,4,0,32,28
1656106159569,MATH 142A,A01,083219,Chow; Bennett,1,0,32,31
1656106159569,MATH 142A,A02,083220,Chow; Bennett,8,0,32,24
1656106159569,MATH 142A,A03,093480,Staff,5,0,32,27
1656106159569,MATH 142A,B03,093481,Staff,4,0,32,28
1656106159569,MATH 142A,B04,093558,Staff,5,0,32,27
1656106159569,MATH 142A,B05,093559,Staff,0,0,32,32
1656106165597,MATH 193A,A01,083224,Rotar; Vladimir,1,2,34,33
1656106165597,MATH 193A,A02,083225,Rotar; Vladimir,1,0,34,33
1656106165597,MATH 193A,A03,083781,Rotar; Vladimir,1,0,34,33
1656106165597,MATH 193A,A04,083782,Rotar; Vladimir,6,0,34,28
1656106165597,MATH 193A,A05,093482,Rotar; Vladimir,1,0,34,33
1656106171621,MATH 197,001,091859,McAuley; Julian John,9999,0,9999,0
1656106171621,MATH 197,002,095566,Kedlaya; Kiran S.,9997,0,9999,2
1656106171621,MATH 197,003,095567,Xiao; Ming,9999,0,9999,0
1656106171621,MATH 197,004,095571,Perols; Johan Lars,9998,0,9999,1
1656106178681,COGS 9,A01,083615,Shannon; Kyle Michael,5,1,75,70
1656106184709,COGS 11,A01,083617,Boyle; Mary E. T.,16,2,48,32
1656106190733,COGS 13,A01,083071,Bastos; Amalia Pinkusfeld,8,3,71,63
1656106196759,COGS 14A,A01,092681,Semenuks; Arturs,8,24,100,92
1656106202785,COGS 14B,A01,083073,Cheng; Tzu-Han,7,0,63,56
1656106208814,COGS 17,A01,092677,Semenuks; Arturs,13,6,81,68
1656106214837,COGS 100,A01,083619,Allen; Michael Gordon,7,4,70,63
1656106220860,COGS 101A,A01,083621,Davis; Joshua Daniel,7,3,68,61
1656106226886,COGS 101B,A01,091572,Allen; Michael Gordon,6,0,65,59
1656106232912,COGS 101C,A01,083625,Delgado; Tania,11,0,35,24
1656106238936,COGS 107A,A01,083627,Boyle; Mary E. T.,5,4,60,55
1656106244962,COGS 118A,A01,083075,Gupta; Anjum,24,17,76,52
1656106250986,CSE 3,A50,083646,Miranda; Gregory Joseph,18,0,50,32
1656106257010,CSE 8A,A50,083650,Miranda; Gregory Joseph,13,13,56,43
1656106263033,CSE 11,A01,083080,Cao; Yingjun,1,60,40,39
1656106269057,CSE 12,A01,083652,Krause-Levy; Sophia Louisa,14,8,120,106
1656106275081,CSE 15L,A01,083654,Morris; Justin Loren,5,2,50,45
1656106275081,CSE 15L,A02,083655,Morris; Justin Loren,7,2,50,43
1656106281108,CSE 20,A01,083657,Tran; Khoa Dang,31,0,80,49
1656106287143,CSE 21,A01,095574,Bach; Quang Tran,26,0,48,22
1656106293172,CSE 30,A01,083084,Eldon; John,3,11,80,77
1656106293172,CSE 30,B01,095061,Bhaskar; Nishant,4,5,50,46
1656106299201,CSE 100,A01,083659,Cao; Yingjun,2,22,70,68
1656106305224,CSE 134B,A01,083661,Powell; Thomas Allan,10,8,100,90
1656106311260,CSE 140,A01,083663,Gungor; Onat,9,0,85,76
1656106317286,CSE 140L,A01,083088,Eldon; John,8,0,100,92
1656106323367,CSE 175,A01,083665,Kumar; Rakesh,1,0,25,24
1656106329415,CSE 190,A00,092507,Dubnov; Shlomo,2,0,20,18
1656106335549,ECE 45,A01,083139,Congero; Spencer William,5,3,75,70
1656106341584,ECE 65,A50,083695,Saad; Andrew S,8,0,30,22
1656106341584,ECE 65,A51,095125,Staff,23,0,26,3
1656106347622,ECE 109,A01,091882,Touri; Behrouz,7,7,70,63
1656106353671,ECE 180,A00,083140,Abi Samra; Nicholas Camill,1,0,30,29
1656106353671,ECE 180,B00,083141,Abi Samra; Nicholas Camill,4,8,30,26
1656106359717,MATH 10A,A01,083735,Patchell; Gregory David,0,0,30,30
1656106359717,MATH 10A,A02,083736,Patchell; Gregory David,22,0,30,8
1656106359717,MATH 10A,A03,083737,Patchell; Gregory David,16,0,30,14
1656106365756,MATH 10B,A01,083207,Lim; Seonhee,3,3,34,31
1656106365756,MATH 10B,A02,083208,Lim; Seonhee,10,2,35,25
1656106365756,MATH 10B,A03,093472,Staff,4,2,34,30
1656106365756,MATH 10B,B01,083739,Sinha; Shubham,12,0,30,18
1656106371790,MATH 18,A01,083743,Cinel; Cameron Alexander,7,0,30,23
1656106371790,MATH 18,A02,083744,Cinel; Cameron Alexander,10,0,30,20
1656106371790,MATH 18,A03,083745,Cinel; Cameron Alexander,3,0,30,27
1656106371790,MATH 18,B01,083748,Ma; Zilu,0,0,36,36
1656106371790,MATH 18,B02,083749,Ma; Zilu,0,0,36,36
1656106371790,MATH 18,B03,083750,Ma; Zilu,0,0,36,36
1656106371790,MATH 18,B04,083751,Ma; Zilu,0,0,36,36
1656106371790,MATH 18,B05,093473,Staff,3,0,36,33
1656106371790,MATH 18,B06,093474,Staff,3,0,36,33
1656106377819,MATH 20A,A01,083754,Zheng; Zequn,11,0,40,29
1656106383847,MATH 20B,A01,083756,Briones; Jor-el Thomas Caparas,0,0,36,36
1656106383847,MATH 20B,A02,083757,Briones; Jor-el Thomas Caparas,0,0,36,36
1656106383847,MATH 20B,A03,093475,Staff,3,0,36,33
1656106389876,MATH 20C,A01,083760,Briones; Jor-el Thomas Caparas,2,2,35,33
1656106389876,MATH 20C,A02,083761,Briones; Jor-el Thomas Caparas,9,1,35,26
1656106389876,MATH 20C,A03,093476,Staff,1,1,35,34
1656106389876,MATH 20C,B01,083762,Bach; Quang Tran,1,0,30,29
1656106395912,MATH 20D,A01,083765,Tran; Brian Kha,3,0,30,27
1656106395912,MATH 20D,A02,083766,Tran; Brian Kha,0,1,30,30
1656106395912,MATH 20D,A03,083767,Tran; Brian Kha,2,0,30,28
1656106401949,MATH 20E,A01,083771,Ganguly; Soumya,4,1,32,28
1656106401949,MATH 20E,A02,083772,Ganguly; Soumya,2,2,32,30
1656106401949,MATH 20E,B01,083773,Ciotti; Benjamin,14,0,35,21
1656106401949,MATH 20E,B02,083774,Ciotti; Benjamin,14,0,35,21
1656106407996,MATH 103A,A01,083777,Greenfeld; Be'Eri,3,0,36,33
1656106407996,MATH 103A,A02,083778,Greenfeld; Be'Eri,2,0,36,34
1656106407996,MATH 103A,A03,093561,Staff,4,1,36,32
1656106407996,MATH 103A,B01,083779,Greenfeld; Be'Eri,8,1,36,28
1656106407996,MATH 103A,B02,083780,Greenfeld; Be'Eri,0,1,36,36
1656106407996,MATH 103A,B03,093562,Staff,0,0,36,36
1656106414026,MATH 105,A01,085443,Carter; Anne Toulson,4,1,35,31
1656106414026,MATH 105,A02,093477,Staff,9,0,35,26
1656106420063,MATH 109,A01,083213,Ganzberger; Geoffrey Michael,1,1,34,33
1656106420063,MATH 109,A02,083214,Ganzberger; Geoffrey Michael,0,0,34,34
1656106420063,MATH 109,A03,093478,Staff,1,0,34,33
1656106420063,MATH 109,B01,083215,Ganzberger; Geoffrey Michael,3,0,32,29
1656106420063,MATH 109,B02,083216,Ganzberger; Geoffrey Michael,1,0,32,31
1656106420063,MATH 109,B03,093479,Staff,4,0,32,28
1656106426087,MATH 142A,A01,083219,Chow; Bennett,1,0,32,31
1656106426087,MATH 142A,A02,083220,Chow; Bennett,8,0,32,24
1656106426087,MATH 142A,A03,093480,Staff,5,0,32,27
1656106426087,MATH 142A,B03,093481,Staff,4,0,32,28
1656106426087,MATH 142A,B04,093558,Staff,5,0,32,27
1656106426087,MATH 142A,B05,093559,Staff,0,0,32,32
1656106432126,MATH 193A,A01,083224,Rotar; Vladimir,1,2,34,33
1656106432126,MATH 193A,A02,083225,Rotar; Vladimir,1,0,34,33
1656106432126,MATH 193A,A03,083781,Rotar; Vladimir,1,0,34,33
1656106432126,MATH 193A,A04,083782,Rotar; Vladimir,6,0,34,28
1656106432126,MATH 193A,A05,093482,Rotar; Vladimir,1,0,34,33
1656106438150,MATH 197,001,091859,McAuley; Julian John,9999,0,9999,0
1656106438150,MATH 197,002,095566,Kedlaya; Kiran S.,9997,0,9999,2
1656106438150,MATH 197,003,095567,Xiao; Ming,9999,0,9999,0
1656106438150,MATH 197,004,095571,Perols; Johan Lars,9998,0,9999,1
1656106445216,COGS 9,A01,083615,Shannon; Kyle Michael,5,1,75,70
1656106451255,COGS 11,A01,083617,Boyle; Mary E. T.,16,2,48,32
1656106457302,COGS 13,A01,083071,Bastos; Amalia Pinkusfeld,8,3,71,63
1656106463341,COGS 14A,A01,092681,Semenuks; Arturs,8,24,100,92
1656106469377,COGS 14B,A01,083073,Cheng; Tzu-Han,7,0,63,56
1656106475402,COGS 17,A01,092677,Semenuks; Arturs,13,6,81,68
1656106481426,COGS 100,A01,083619,Allen; Michael Gordon,7,4,70,63
1656106487459,COGS 101A,A01,083621,Davis; Joshua Daniel,7,3,68,61
1656106493482,COGS 101B,A01,091572,Allen; Michael Gordon,6,0,65,59
1656106499505,COGS 101C,A01,083625,Delgado; Tania,11,0,35,24
1656106505531,COGS 107A,A01,083627,Boyle; Mary E. T.,5,4,60,55
1656106511554,COGS 118A,A01,083075,Gupta; Anjum,24,17,76,52
1656106517579,CSE 3,A50,083646,Miranda; Gregory Joseph,18,0,50,32
1656106523604,CSE 8A,A50,083650,Miranda; Gregory Joseph,13,12,56,43
1656106529626,CSE 11,A01,083080,Cao; Yingjun,1,60,40,39
1656106535650,CSE 12,A01,083652,Krause-Levy; Sophia Louisa,14,8,120,106
1656106541674,CSE 15L,A01,083654,Morris; Justin Loren,5,2,50,45
1656106541674,CSE 15L,A02,083655,Morris; Justin Loren,7,2,50,43
1656106547701,CSE 20,A01,083657,Tran; Khoa Dang,31,0,80,49
1656106553725,CSE 21,A01,095574,Bach; Quang Tran,26,0,48,22
1656106559761,CSE 30,A01,083084,Eldon; John,3,11,80,77
1656106559761,CSE 30,B01,095061,Bhaskar; Nishant,4,5,50,46
1656106565789,CSE 100,A01,083659,Cao; Yingjun,2,22,70,68
1656106571821,CSE 134B,A01,083661,Powell; Thomas Allan,10,8,100,90
1656106577846,CSE 140,A01,083663,Gungor; Onat,9,0,85,76
1656106583868,CSE 140L,A01,083088,Eldon; John,8,0,100,92
1656106589892,CSE 175,A01,083665,Kumar; Rakesh,1,0,25,24
1656106595915,CSE 190,A00,092507,Dubnov; Shlomo,2,0,20,18
1656106601939,ECE 45,A01,083139,Congero; Spencer William,5,3,75,70
1656106607963,ECE 65,A50,083695,Saad; Andrew S,8,0,30,22
1656106607963,ECE 65,A51,095125,Staff,23,0,26,3
1656106613988,ECE 109,A01,091882,Touri; Behrouz,7,7,70,63
1656106620011,ECE 180,A00,083140,Abi Samra; Nicholas Camill,1,0,30,29
1656106620011,ECE 180,B00,083141,Abi Samra; Nicholas Camill,4,8,30,26
1656106626034,MATH 10A,A01,083735,Patchell; Gregory David,0,0,30,30
1656106626034,MATH 10A,A02,083736,Patchell; Gregory David,22,0,30,8
1656106626034,MATH 10A,A03,083737,Patchell; Gregory David,16,0,30,14
1656106632058,MATH 10B,A01,083207,Lim; Seonhee,3,3,34,31
1656106632058,MATH 10B,A02,083208,Lim; Seonhee,10,2,35,25
1656106632058,MATH 10B,A03,093472,Staff,4,2,34,30
1656106632058,MATH 10B,B01,083739,Sinha; Shubham,12,0,30,18
1656106638083,MATH 18,A01,083743,Cinel; Cameron Alexander,7,0,30,23
1656106638083,MATH 18,A02,083744,Cinel; Cameron Alexander,11,0,30,19
1656106638083,MATH 18,A03,083745,Cinel; Cameron Alexander,3,0,30,27
1656106638083,MATH 18,B01,083748,Ma; Zilu,0,0,36,36
1656106638083,MATH 18,B02,083749,Ma; Zilu,0,0,36,36
1656106638083,MATH 18,B03,083750,Ma; Zilu,0,0,36,36
1656106638083,MATH 18,B04,083751,Ma; Zilu,0,0,36,36
1656106638083,MATH 18,B05,093473,Staff,2,0,36,34
1656106638083,MATH 18,B06,093474,Staff,3,0,36,33
1656106644105,MATH 20A,A01,083754,Zheng; Zequn,11,0,40,29
1656106650129,MATH 20B,A01,083756,Briones; Jor-el Thomas Caparas,0,0,36,36
1656106650129,MATH 20B,A02,083757,Briones; Jor-el Thomas Caparas,0,0,36,36
1656106650129,MATH 20B,A03,093475,Staff,3,0,36,33
1656106656156,MATH 20C,A01,083760,Briones; Jor-el Thomas Caparas,2,2,35,33
1656106656156,MATH 20C,A02,083761,Briones; Jor-el Thomas Caparas,9,1,35,26
1656106656156,MATH 20C,A03,093476,Staff,1,1,35,34
1656106656156,MATH 20C,B01,083762,Bach; Quang Tran,1,0,30,29
1656106662182,MATH 20D,A01,083765,Tran; Brian Kha,3,0,30,27
1656106662182,MATH 20D,A02,083766,Tran; Brian Kha,0,1,30,30
1656106662182,MATH 20D,A03,083767,Tran; Brian Kha,2,0,30,28
1656106668215,MATH 20E,A01,083771,Ganguly; Soumya,4,1,32,28
1656106668215,MATH 20E,A02,083772,Ganguly; Soumya,2,2,32,30
1656106668215,MATH 20E,B01,083773,Ciotti; Benjamin,14,0,35,21
1656106668215,MATH 20E,B02,083774,Ciotti; Benjamin,14,0,35,21
1656106674259,MATH 103A,A01,083777,Greenfeld; Be'Eri,3,0,36,33
1656106674259,MATH 103A,A02,083778,Greenfeld; Be'Eri,2,0,36,34
1656106674259,MATH 103A,A03,093561,Staff,4,1,36,32
1656106674259,MATH 103A,B01,083779,Greenfeld; Be'Eri,8,1,36,28
1656106674259,MATH 103A,B02,083780,Greenfeld; Be'Eri,0,1,36,36
1656106674259,MATH 103A,B03,093562,Staff,0,0,36,36
1656106680307,MATH 105,A01,085443,Carter; Anne Toulson,4,1,35,31
1656106680307,MATH 105,A02,093477,Staff,9,0,35,26
1656106686331,MATH 109,A01,083213,Ganzberger; Geoffrey Michael,1,1,34,33
1656106686331,MATH 109,A02,083214,Ganzberger; Geoffrey Michael,0,0,34,34
1656106686331,MATH 109,A03,093478,Staff,1,0,34,33
1656106686331,MATH 109,B01,083215,Ganzberger; Geoffrey Michael,3,0,32,29
1656106686331,MATH 109,B02,083216,Ganzberger; Geoffrey Michael,1,0,32,31
1656106686331,MATH 109,B03,093479,Staff,4,0,32,28
1656106692365,MATH 142A,A01,083219,Chow; Bennett,1,0,32,31
1656106692365,MATH 142A,A02,083220,Chow; Bennett,8,0,32,24
1656106692365,MATH 142A,A03,093480,Staff,5,0,32,27
1656106692365,MATH 142A,B03,093481,Staff,4,0,32,28
1656106692365,MATH 142A,B04,093558,Staff,5,0,32,27
1656106692365,MATH 142A,B05,093559,Staff,0,0,32,32
1656106698394,MATH 193A,A01,083224,Rotar; Vladimir,1,2,34,33
1656106698394,MATH 193A,A02,083225,Rotar; Vladimir,1,0,34,33
1656106698394,MATH 193A,A03,083781,Rotar; Vladimir,1,0,34,33
1656106698394,MATH 193A,A04,083782,Rotar; Vladimir,6,0,34,28
1656106698394,MATH 193A,A05,093482,Rotar; Vladimir,1,0,34,33
1656106704419,MATH 197,001,091859,McAuley; Julian John,9999,0,9999,0
1656106704419,MATH 197,002,095566,Kedlaya; Kiran S.,9997,0,9999,2
1656106704419,MATH 197,003,095567,Xiao; Ming,9999,0,9999,0
1656106704419,MATH 197,004,095571,Perols; Johan Lars,9998,0,9999,1
1656106711470,COGS 9,A01,083615,Shannon; Kyle Michael,5,1,75,70
1656106717494,COGS 11,A01,083617,Boyle; Mary E. T.,16,2,48,32
1656106723517,COGS 13,A01,083071,Bastos; Amalia Pinkusfeld,8,3,71,63
1656106729539,COGS 14A,A01,092681,Semenuks; Arturs,8,24,100,92
1656106735563,COGS 14B,A01,083073,Cheng; Tzu-Han,7,0,63,56
1656106741586,COGS 17,A01,092677,Semenuks; Arturs,13,6,81,68
1656106747608,COGS 100,A01,083619,Allen; Michael Gordon,7,4,70,63
1656106753631,COGS 101A,A01,083621,Davis; Joshua Daniel,7,3,68,61
1656106759657,COGS 101B,A01,091572,Allen; Michael Gordon,6,0,65,59
1656106765680,COGS 101C,A01,083625,Delgado; Tania,11,0,35,24
1656106771709,COGS 107A,A01,083627,Boyle; Mary E. T.,5,4,60,55
1656106777736,COGS 118A,A01,083075,Gupta; Anjum,24,17,76,52
1656106783759,CSE 3,A50,083646,Miranda; Gregory Joseph,18,0,50,32
1656106789784,CSE 8A,A50,083650,Miranda; Gregory Joseph,13,12,56,43
1656106795818,CSE 11,A01,083080,Cao; Yingjun,1,60,40,39
1656106801854,CSE 12,A01,083652,Krause-Levy; Sophia Louisa,14,8,120,106
1656106807876,CSE 15L,A01,083654,Morris; Justin Loren,5,2,50,45
1656106807876,CSE 15L,A02,083655,Morris; Justin Loren,7,2,50,43
1656106813900,CSE 20,A01,083657,Tran; Khoa Dang,31,0,80,49
1656106819926,CSE 21,A01,095574,Bach; Quang Tran,26,0,48,22
1656106825951,CSE 30,A01,083084,Eldon; John,3,11,80,77
1656106825951,CSE 30,B01,095061,Bhaskar; Nishant,4,5,50,46
1656106831975,CSE 100,A01,083659,Cao; Yingjun,2,22,70,68
1656106838002,CSE 134B,A01,083661,Powell; Thomas Allan,10,8,100,90
1656106844025,CSE 140,A01,083663,Gungor; Onat,9,0,85,76
1656106850048,CSE 140L,A01,083088,Eldon; John,8,0,100,92
1656106856074,CSE 175,A01,083665,Kumar; Rakesh,1,0,25,24
1656106862100,CSE 190,A00,092507,Dubnov; Shlomo,2,0,20,18
1656106868128,ECE 45,A01,083139,Congero; Spencer William,5,3,75,70
1656106874156,ECE 65,A50,083695,Saad; Andrew S,8,0,30,22
1656106874156,ECE 65,A51,095125,Staff,23,0,26,3
1656106880182,ECE 109,A01,091882,Touri; Behrouz,7,7,70,63
1656106886209,ECE 180,A00,083140,Abi Samra; Nicholas Camill,1,0,30,29
1656106886209,ECE 180,B00,083141,Abi Samra; Nicholas Camill,4,8,30,26
1656106892233,MATH 10A,A01,083735,Patchell; Gregory David,0,0,30,30
1656106892233,MATH 10A,A02,083736,Patchell; Gregory David,22,0,30,8
1656106892233,MATH 10A,A03,083737,Patchell; Gregory David,16,0,30,14
1656106898258,MATH 10B,A01,083207,Lim; Seonhee,3,3,34,31
1656106898258,MATH 10B,A02,083208,Lim; Seonhee,10,2,35,25
1656106898258,MATH 10B,A03,093472,Staff,4,2,34,30
1656106898258,MATH 10B,B01,083739,Sinha; Shubham,12,0,30,18
1656106904290,MATH 18,A01,083743,Cinel; Cameron Alexander,7,0,30,23
1656106904290,MATH 18,A02,083744,Cinel; Cameron Alexander,11,0,30,19
1656106904290,MATH 18,A03,083745,Cinel; Cameron Alexander,3,0,30,27
1656106904290,MATH 18,B01,083748,Ma; Zilu,0,0,36,36
1656106904290,MATH 18,B02,083749,Ma; Zilu,0,0,36,36
1656106904290,MATH 18,B03,083750,Ma; Zilu,0,0,36,36
1656106904290,MATH 18,B04,083751,Ma; Zilu,0,0,36,36
1656106904290,MATH 18,B05,093473,Staff,2,0,36,34
1656106904290,MATH 18,B06,093474,Staff,3,0,36,33
1656106910325,MATH 20A,A01,083754,Zheng; Zequn,11,0,40,29
1656106916350,MATH 20B,A01,083756,Briones; Jor-el Thomas Caparas,0,0,36,36
1656106916350,MATH 20B,A02,083757,Briones; Jor-el Thomas Caparas,0,0,36,36
1656106916350,MATH 20B,A03,093475,Staff,3,0,36,33
1656106922381,MATH 20C,A01,083760,Briones; Jor-el Thomas Caparas,2,2,35,33
1656106922381,MATH 20C,A02,083761,Briones; Jor-el Thomas Caparas,9,1,35,26
1656106922381,MATH 20C,A03,093476,Staff,1,1,35,34
1656106922381,MATH 20C,B01,083762,Bach; Quang Tran,1,0,30,29
1656106928413,MATH 20D,A01,083765,Tran; Brian Kha,3,0,30,27
1656106928413,MATH 20D,A02,083766,Tran; Brian Kha,0,1,30,30
1656106928413,MATH 20D,A03,083767,Tran; Brian Kha,2,0,30,28
1656106934537,MATH 20E,A01,083771,Ganguly; Soumya,4,1,32,28
1656106934537,MATH 20E,A02,083772,Ganguly; Soumya,2,2,32,30
1656106934537,MATH 20E,B01,083773,Ciotti; Benjamin,14,0,35,21
1656106934537,MATH 20E,B02,083774,Ciotti; Benjamin,14,0,35,21
1656106940576,MATH 103A,A01,083777,Greenfeld; Be'Eri,3,0,36,33
1656106940576,MATH 103A,A02,083778,Greenfeld; Be'Eri,2,0,36,34
1656106940576,MATH 103A,A03,093561,Staff,4,1,36,32
1656106940576,MATH 103A,B01,083779,Greenfeld; Be'Eri,8,1,36,28
1656106940576,MATH 103A,B02,083780,Greenfeld; Be'Eri,0,1,36,36
1656106940576,MATH 103A,B03,093562,Staff,0,0,36,36
1656106946604,MATH 105,A01,085443,Carter; Anne Toulson,4,1,35,31
1656106946604,MATH 105,A02,093477,Staff,9,0,35,26
1656106952633,MATH 109,A01,083213,Ganzberger; Geoffrey Michael,1,1,34,33
1656106952633,MATH 109,A02,083214,Ganzberger; Geoffrey Michael,0,0,34,34
1656106952633,MATH 109,A03,093478,Staff,1,0,34,33
1656106952633,MATH 109,B01,083215,Ganzberger; Geoffrey Michael,3,0,32,29
1656106952633,MATH 109,B02,083216,Ganzberger; Geoffrey Michael,1,0,32,31
1656106952633,MATH 109,B03,093479,Staff,4,0,32,28
1656106958667,MATH 142A,A01,083219,Chow; Bennett,1,0,32,31
1656106958667,MATH 142A,A02,083220,Chow; Bennett,8,0,32,24
1656106958667,MATH 142A,A03,093480,Staff,5,0,32,27
1656106958667,MATH 142A,B03,093481,Staff,4,0,32,28
1656106958667,MATH 142A,B04,093558,Staff,5,0,32,27
1656106958667,MATH 142A,B05,093559,Staff,0,0,32,32
1656106964691,MATH 193A,A01,083224,Rotar; Vladimir,1,2,34,33
1656106964691,MATH 193A,A02,083225,Rotar; Vladimir,1,0,34,33
1656106964691,MATH 193A,A03,083781,Rotar; Vladimir,1,0,34,33
1656106964691,MATH 193A,A04,083782,Rotar; Vladimir,6,0,34,28
1656106964691,MATH 193A,A05,093482,Rotar; Vladimir,1,0,34,33
1656106970720,MATH 197,001,091859,McAuley; Julian John,9999,0,9999,0
1656106970720,MATH 197,002,095566,Kedlaya; Kiran S.,9997,0,9999,2
1656106970720,MATH 197,003,095567,Xiao; Ming,9999,0,9999,0
1656106970720,MATH 197,004,095571,Perols; Johan Lars,9998,0,9999,1
1656106977782,COGS 9,A01,083615,Shannon; Kyle Michael,5,1,75,70
1656106983806,COGS 11,A01,083617,Boyle; Mary E. T.,16,2,48,32
1656106989835,COGS 13,A01,083071,Bastos; Amalia Pinkusfeld,8,3,71,63
1656106995862,COGS 14A,A01,092681,Semenuks; Arturs,8,24,100,92
1656107001900,COGS 14B,A01,083073,Cheng; Tzu-Han,7,0,63,56
1656107007923,COGS 17,A01,092677,Semenuks; Arturs,13,6,81,68
1656107013964,COGS 100,A01,083619,Allen; Michael Gordon,7,4,70,63
1656107019993,COGS 101A,A01,083621,Davis; Joshua Daniel,7,3,68,61
1656107026022,COGS 101B,A01,091572,Allen; Michael Gordon,6,0,65,59
1656107032045,COGS 101C,A01,083625,Delgado; Tania,11,0,35,24
1656107038071,COGS 107A,A01,083627,Boyle; Mary E. T.,5,4,60,55
1656107044095,COGS 118A,A01,083075,Gupta; Anjum,24,17,76,52
1656107050120,CSE 3,A50,083646,Miranda; Gregory Joseph,18,0,50,32
1656107056149,CSE 8A,A50,083650,Miranda; Gregory Joseph,13,12,56,43
1656107062173,CSE 11,A01,083080,Cao; Yingjun,1,60,40,39
1656107068197,CSE 12,A01,083652,Krause-Levy; Sophia Louisa,14,8,120,106
1656107074222,CSE 15L,A01,083654,Morris; Justin Loren,5,2,50,45
1656107074222,CSE 15L,A02,083655,Morris; Justin Loren,7,2,50,43
1656107080249,CSE 20,A01,083657,Tran; Khoa Dang,31,0,80,49
1656107086273,CSE 21,A01,095574,Bach; Quang Tran,26,0,48,22
1656107092302,CSE 30,A01,083084,Eldon; John,3,11,80,77
1656107092302,CSE 30,B01,095061,Bhaskar; Nishant,4,5,50,46
1656107098326,CSE 100,A01,083659,Cao; Yingjun,2,22,70,68
1656107104353,CSE 134B,A01,083661,Powell; Thomas Allan,10,8,100,90
1656107110376,CSE 140,A01,083663,Gungor; Onat,9,0,85,76
1656107116399,CSE 140L,A01,083088,Eldon; John,8,0,100,92
1656107122421,CSE 175,A01,083665,Kumar; Rakesh,1,0,25,24
1656107128443,CSE 190,A00,092507,Dubnov; Shlomo,2,0,20,18
1656107134476,ECE 45,A01,083139,Congero; Spencer William,5,3,75,70
1656107140498,ECE 65,A50,083695,Saad; Andrew S,8,0,30,22
1656107140498,ECE 65,A51,095125,Staff,23,0,26,3
1656107146526,ECE 109,A01,091882,Touri; Behrouz,7,7,70,63
1656107152548,ECE 180,A00,083140,Abi Samra; Nicholas Camill,1,0,30,29
1656107152548,ECE 180,B00,083141,Abi Samra; Nicholas Camill,4,8,30,26
1656107158576,MATH 10A,A01,083735,Patchell; Gregory David,0,0,30,30
1656107158576,MATH 10A,A02,083736,Patchell; Gregory David,22,0,30,8
1656107158576,MATH 10A,A03,083737,Patchell; Gregory David,16,0,30,14
1656107164608,MATH 10B,A01,083207,Lim; Seonhee,3,3,34,31
1656107164608,MATH 10B,A02,083208,Lim; Seonhee,10,2,35,25
1656107164608,MATH 10B,A03,093472,Staff,4,2,34,30
1656107164608,MATH 10B,B01,083739,Sinha; Shubham,12,0,30,18
1656107170638,MATH 18,A01,083743,Cinel; Cameron Alexander,7,0,30,23
1656107170638,MATH 18,A02,083744,Cinel; Cameron Alexander,11,0,30,19
1656107170638,MATH 18,A03,083745,Cinel; Cameron Alexander,3,0,30,27
1656107170638,MATH 18,B01,083748,Ma; Zilu,0,0,36,36
1656107170638,MATH 18,B02,083749,Ma; Zilu,0,0,36,36
1656107170638,MATH 18,B03,083750,Ma; Zilu,0,0,36,36
1656107170638,MATH 18,B04,083751,Ma; Zilu,0,0,36,36
1656107170638,MATH 18,B05,093473,Staff,2,0,36,34
1656107170638,MATH 18,B06,093474,Staff,3,0,36,33
1656107176680,MATH 20A,A01,083754,Zheng; Zequn,11,0,40,29
1656107182732,MATH 20B,A01,083756,Briones; Jor-el Thomas Caparas,0,0,36,36
1656107182732,MATH 20B,A02,083757,Briones; Jor-el Thomas Caparas,0,0,36,36
1656107182732,MATH 20B,A03,093475,Staff,3,0,36,33
1656107188755,MATH 20C,A01,083760,Briones; Jor-el Thomas Caparas,2,2,35,33
1656107188755,MATH 20C,A02,083761,Briones; Jor-el Thomas Caparas,9,1,35,26
1656107188755,MATH 20C,A03,093476,Staff,1,1,35,34
1656107188755,MATH 20C,B01,083762,Bach; Quang Tran,1,0,30,29
1656107194781,MATH 20D,A01,083765,Tran; Brian Kha,3,0,30,27
1656107194781,MATH 20D,A02,083766,Tran; Brian Kha,0,1,30,30
1656107194781,MATH 20D,A03,083767,Tran; Brian Kha,2,0,30,28
1656107200809,MATH 20E,A01,083771,Ganguly; Soumya,4,1,32,28
1656107200809,MATH 20E,A02,083772,Ganguly; Soumya,2,2,32,30
1656107200809,MATH 20E,B01,083773,Ciotti; Benjamin,14,0,35,21
1656107200809,MATH 20E,B02,083774,Ciotti; Benjamin,14,0,35,21
1656107206839,MATH 103A,A01,083777,Greenfeld; Be'Eri,3,0,36,33
1656107206839,MATH 103A,A02,083778,Greenfeld; Be'Eri,2,0,36,34
1656107206839,MATH 103A,A03,093561,Staff,4,1,36,32
1656107206839,MATH 103A,B01,083779,Greenfeld; Be'Eri,8,1,36,28
1656107206839,MATH 103A,B02,083780,Greenfeld; Be'Eri,0,1,36,36
1656107206839,MATH 103A,B03,093562,Staff,0,0,36,36
1656107212870,MATH 105,A01,085443,Carter; Anne Toulson,4,1,35,31
1656107212870,MATH 105,A02,093477,Staff,9,0,35,26
1656107218893,MATH 109,A01,083213,Ganzberger; Geoffrey Michael,1,1,34,33
1656107218893,MATH 109,A02,083214,Ganzberger; Geoffrey Michael,0,0,34,34
1656107218893,MATH 109,A03,093478,Staff,1,0,34,33
1656107218893,MATH 109,B01,083215,Ganzberger; Geoffrey Michael,3,0,32,29
1656107218893,MATH 109,B02,083216,Ganzberger; Geoffrey Michael,1,0,32,31
1656107218893,MATH 109,B03,093479,Staff,4,0,32,28
1656107224919,MATH 142A,A01,083219,Chow; Bennett,1,0,32,31
1656107224919,MATH 142A,A02,083220,Chow; Bennett,8,0,32,24
1656107224919,MATH 142A,A03,093480,Staff,5,0,32,27
1656107224919,MATH 142A,B03,093481,Staff,4,0,32,28
1656107224919,MATH 142A,B04,093558,Staff,5,0,32,27
1656107224919,MATH 142A,B05,093559,Staff,0,0,32,32
1656107230967,MATH 193A,A01,083224,Rotar; Vladimir,1,2,34,33
1656107230967,MATH 193A,A02,083225,Rotar; Vladimir,1,0,34,33
1656107230967,MATH 193A,A03,083781,Rotar; Vladimir,1,0,34,33
1656107230967,MATH 193A,A04,083782,Rotar; Vladimir,6,0,34,28
1656107230967,MATH 193A,A05,093482,Rotar; Vladimir,1,0,34,33
1656107236995,MATH 197,001,091859,McAuley; Julian John,9999,0,9999,0
1656107236995,MATH 197,002,095566,Kedlaya; Kiran S.,9997,0,9999,2
1656107236995,MATH 197,003,095567,Xiao; Ming,9999,0,9999,0
1656107236995,MATH 197,004,095571,Perols; Johan Lars,9998,0,9999,1
1656107244062,COGS 9,A01,083615,Shannon; Kyle Michael,5,1,75,70
1656107250085,COGS 11,A01,083617,Boyle; Mary E. T.,16,2,48,32
1656107256106,COGS 13,A01,083071,Bastos; Amalia Pinkusfeld,8,3,71,63
1656107262131,COGS 14A,A01,092681,Semenuks; Arturs,8,24,100,92
1656107268162,COGS 14B,A01,083073,Cheng; Tzu-Han,7,0,63,56
1656107274191,COGS 17,A01,092677,Semenuks; Arturs,13,6,81,68
1656107280227,COGS 100,A01,083619,Allen; Michael Gordon,7,4,70,63
1656107286256,COGS 101A,A01,083621,Davis; Joshua Daniel,7,3,68,61
1656107292291,COGS 101B,A01,091572,Allen; Michael Gordon,6,0,65,59
1656107298316,COGS 101C,A01,083625,Delgado; Tania,11,0,35,24
1656107304344,COGS 107A,A01,083627,Boyle; Mary E. T.,5,4,60,55
1656107310377,COGS 118A,A01,083075,Gupta; Anjum,24,17,76,52
1656107316403,CSE 3,A50,083646,Miranda; Gregory Joseph,18,0,50,32
1656107322435,CSE 8A,A50,083650,Miranda; Gregory Joseph,13,12,56,43
1656107328458,CSE 11,A01,083080,Cao; Yingjun,1,60,40,39
1656107334481,CSE 12,A01,083652,Krause-Levy; Sophia Louisa,14,8,120,106
1656107340517,CSE 15L,A01,083654,Morris; Justin Loren,5,2,50,45
1656107340517,CSE 15L,A02,083655,Morris; Justin Loren,7,2,50,43
1656107346539,CSE 20,A01,083657,Tran; Khoa Dang,31,0,80,49
1656107352567,CSE 21,A01,095574,Bach; Quang Tran,26,0,48,22
1656107358589,CSE 30,A01,083084,Eldon; John,3,11,80,77
1656107358589,CSE 30,B01,095061,Bhaskar; Nishant,4,5,50,46
1656107364614,CSE 100,A01,083659,Cao; Yingjun,2,22,70,68
1656107370649,CSE 134B,A01,083661,Powell; Thomas Allan,10,8,100,90
1656107376686,CSE 140,A01,083663,Gungor; Onat,9,0,85,76
1656107382709,CSE 140L,A01,083088,Eldon; John,8,0,100,92
1656107388740,CSE 175,A01,083665,Kumar; Rakesh,1,0,25,24
1656107394763,CSE 190,A00,092507,Dubnov; Shlomo,2,0,20,18
1656107400791,ECE 45,A01,083139,Congero; Spencer William,5,3,75,70
1656107406824,ECE 65,A50,083695,Saad; Andrew S,8,0,30,22
1656107406824,ECE 65,A51,095125,Staff,23,0,26,3
1656107412855,ECE 109,A01,091882,Touri; Behrouz,7,7,70,63
1656107418885,ECE 180,A00,083140,Abi Samra; Nicholas Camill,1,0,30,29
1656107418885,ECE 180,B00,083141,Abi Samra; Nicholas Camill,4,8,30,26
1656107424908,MATH 10A,A01,083735,Patchell; Gregory David,0,0,30,30
1656107424908,MATH 10A,A02,083736,Patchell; Gregory David,22,0,30,8
1656107424908,MATH 10A,A03,083737,Patchell; Gregory David,16,0,30,14
1656107430941,MATH 10B,A01,083207,Lim; Seonhee,3,3,34,31
1656107430941,MATH 10B,A02,083208,Lim; Seonhee,10,2,35,25
1656107430941,MATH 10B,A03,093472,Staff,4,2,34,30
1656107430941,MATH 10B,B01,083739,Sinha; Shubham,12,0,30,18
1656107436974,MATH 18,A01,083743,Cinel; Cameron Alexander,7,0,30,23
1656107436974,MATH 18,A02,083744,Cinel; Cameron Alexander,11,0,30,19
1656107436974,MATH 18,A03,083745,Cinel; Cameron Alexander,3,0,30,27
1656107436974,MATH 18,B01,083748,Ma; Zilu,0,0,36,36
1656107436974,MATH 18,B02,083749,Ma; Zilu,0,0,36,36
1656107436974,MATH 18,B03,083750,Ma; Zilu,0,0,36,36
1656107436974,MATH 18,B04,083751,Ma; Zilu,0,0,36,36
1656107436974,MATH 18,B05,093473,Staff,2,0,36,34
1656107436974,MATH 18,B06,093474,Staff,3,0,36,33
1656107442997,MATH 20A,A01,083754,Zheng; Zequn,11,0,40,29
1656107449024,MATH 20B,A01,083756,Briones; Jor-el Thomas Caparas,0,0,36,36
1656107449024,MATH 20B,A02,083757,Briones; Jor-el Thomas Caparas,0,0,36,36
1656107449024,MATH 20B,A03,093475,Staff,3,0,36,33
1656107455058,MATH 20C,A01,083760,Briones; Jor-el Thomas Caparas,2,2,35,33
1656107455058,MATH 20C,A02,083761,Briones; Jor-el Thomas Caparas,9,1,35,26
1656107455058,MATH 20C,A03,093476,Staff,1,1,35,34
1656107455058,MATH 20C,B01,083762,Bach; Quang Tran,1,0,30,29
1656107461086,MATH 20D,A01,083765,Tran; Brian Kha,3,0,30,27
1656107461086,MATH 20D,A02,083766,Tran; Brian Kha,0,1,30,30
1656107461086,MATH 20D,A03,083767,Tran; Brian Kha,2,0,30,28
1656107467111,MATH 20E,A01,083771,Ganguly; Soumya,4,1,32,28
1656107467111,MATH 20E,A02,083772,Ganguly; Soumya,2,2,32,30
1656107467111,MATH 20E,B01,083773,Ciotti; Benjamin,14,0,35,21
1656107467111,MATH 20E,B02,083774,Ciotti; Benjamin,14,0,35,21
1656107473135,MATH 103A,A01,083777,Greenfeld; Be'Eri,3,0,36,33
1656107473135,MATH 103A,A02,083778,Greenfeld; Be'Eri,2,0,36,34
1656107473135,MATH 103A,A03,093561,Staff,4,1,36,32
1656107473135,MATH 103A,B01,083779,Greenfeld; Be'Eri,8,1,36,28
1656107473135,MATH 103A,B02,083780,Greenfeld; Be'Eri,0,1,36,36
1656107473135,MATH 103A,B03,093562,Staff,0,0,36,36
1656107479162,MATH 105,A01,085443,Carter; Anne Toulson,4,1,35,31
1656107479162,MATH 105,A02,093477,Staff,9,0,35,26
1656107485188,MATH 109,A01,083213,Ganzberger; Geoffrey Michael,1,1,34,33
1656107485188,MATH 109,A02,083214,Ganzberger; Geoffrey Michael,0,0,34,34
1656107485188,MATH 109,A03,093478,Staff,1,0,34,33
1656107485188,MATH 109,B01,083215,Ganzberger; Geoffrey Michael,3,0,32,29
1656107485188,MATH 109,B02,083216,Ganzberger; Geoffrey Michael,1,0,32,31
1656107485188,MATH 109,B03,093479,Staff,4,0,32,28
1656107491217,MATH 142A,A01,083219,Chow; Bennett,1,0,32,31
1656107491217,MATH 142A,A02,083220,Chow; Bennett,8,0,32,24
1656107491217,MATH 142A,A03,093480,Staff,5,0,32,27
1656107491217,MATH 142A,B03,093481,Staff,4,0,32,28
1656107491217,MATH 142A,B04,093558,Staff,5,0,32,27
1656107491217,MATH 142A,B05,093559,Staff,0,0,32,32
1656107497240,MATH 193A,A01,083224,Rotar; Vladimir,1,2,34,33
1656107497240,MATH 193A,A02,083225,Rotar; Vladimir,1,0,34,33
1656107497240,MATH 193A,A03,083781,Rotar; Vladimir,1,0,34,33
1656107497240,MATH 193A,A04,083782,Rotar; Vladimir,6,0,34,28
1656107497240,MATH 193A,A05,093482,Rotar; Vladimir,1,0,34,33
1656107503267,MATH 197,001,091859,McAuley; Julian John,9999,0,9999,0
1656107503267,MATH 197,002,095566,Kedlaya; Kiran S.,9997,0,9999,2
1656107503267,MATH 197,003,095567,Xiao; Ming,9999,0,9999,0
1656107503267,MATH 197,004,095571,Perols; Johan Lars,9998,0,9999,1
1656107510335,COGS 9,A01,083615,Shannon; Kyle Michael,5,1,75,70
1656107516359,COGS 11,A01,083617,Boyle; Mary E. T.,16,2,48,32
1656107522390,COGS 13,A01,083071,Bastos; Amalia Pinkusfeld,8,3,71,63
1656107528490,COGS 14A,A01,092681,Semenuks; Arturs,8,24,100,92
1656107534516,COGS 14B,A01,083073,Cheng; Tzu-Han,7,0,63,56
1656107540543,COGS 17,A01,092677,Semenuks; Arturs,13,6,81,68
1656107546578,COGS 100,A01,083619,Allen; Michael Gordon,7,4,70,63
1656107552601,COGS 101A,A01,083621,Davis; Joshua Daniel,7,3,68,61
1656107558629,COGS 101B,A01,091572,Allen; Michael Gordon,6,0,65,59
1656107564652,COGS 101C,A01,083625,Delgado; Tania,11,0,35,24
1656107570674,COGS 107A,A01,083627,Boyle; Mary E. T.,5,4,60,55
1656107576700,COGS 118A,A01,083075,Gupta; Anjum,24,17,76,52
1656107582733,CSE 3,A50,083646,Miranda; Gregory Joseph,18,0,50,32
1656107588760,CSE 8A,A50,083650,Miranda; Gregory Joseph,13,12,56,43
1656107594786,CSE 11,A01,083080,Cao; Yingjun,1,60,40,39
1656107600811,CSE 12,A01,083652,Krause-Levy; Sophia Louisa,14,8,120,106
1656107606835,CSE 15L,A01,083654,Morris; Justin Loren,5,2,50,45
1656107606835,CSE 15L,A02,083655,Morris; Justin Loren,7,2,50,43
1656107612859,CSE 20,A01,083657,Tran; Khoa Dang,31,0,80,49
1656107618901,CSE 21,A01,095574,Bach; Quang Tran,26,0,48,22
1656107624933,CSE 30,A01,083084,Eldon; John,3,11,80,77
1656107624933,CSE 30,B01,095061,Bhaskar; Nishant,4,5,50,46
1656107630966,CSE 100,A01,083659,Cao; Yingjun,2,22,70,68
1656107636989,CSE 134B,A01,083661,Powell; Thomas Allan,10,8,100,90
1656107643012,CSE 140,A01,083663,Gungor; Onat,9,0,85,76
1656107649040,CSE 140L,A01,083088,Eldon; John,8,0,100,92
1656107655075,CSE 175,A01,083665,Kumar; Rakesh,1,0,25,24
1656107661100,CSE 190,A00,092507,Dubnov; Shlomo,2,0,20,18
1656107667130,ECE 45,A01,083139,Congero; Spencer William,5,3,75,70
1656107673153,ECE 65,A50,083695,Saad; Andrew S,8,0,30,22
1656107673153,ECE 65,A51,095125,Staff,23,0,26,3
1656107679178,ECE 109,A01,091882,Touri; Behrouz,7,7,70,63
1656107685203,ECE 180,A00,083140,Abi Samra; Nicholas Camill,1,0,30,29
1656107685203,ECE 180,B00,083141,Abi Samra; Nicholas Camill,4,8,30,26
1656107691237,MATH 10A,A01,083735,Patchell; Gregory David,0,0,30,30
1656107691237,MATH 10A,A02,083736,Patchell; Gregory David,22,0,30,8
1656107691237,MATH 10A,A03,083737,Patchell; Gregory David,16,0,30,14
1656107697266,MATH 10B,A01,083207,Lim; Seonhee,3,3,34,31
1656107697266,MATH 10B,A02,083208,Lim; Seonhee,10,2,35,25
1656107697266,MATH 10B,A03,093472,Staff,4,2,34,30
1656107697266,MATH 10B,B01,083739,Sinha; Shubham,12,0,30,18
1656107703298,MATH 18,A01,083743,Cinel; Cameron Alexander,7,0,30,23
1656107703298,MATH 18,A02,083744,Cinel; Cameron Alexander,10,0,30,20
1656107703298,MATH 18,A03,083745,Cinel; Cameron Alexander,3,0,30,27
1656107703298,MATH 18,B01,083748,Ma; Zilu,0,0,36,36
1656107703298,MATH 18,B02,083749,Ma; Zilu,0,0,36,36
1656107703298,MATH 18,B03,083750,Ma; Zilu,0,0,36,36
1656107703298,MATH 18,B04,083751,Ma; Zilu,0,0,36,36
1656107703298,MATH 18,B05,093473,Staff,2,0,36,34
1656107703298,MATH 18,B06,093474,Staff,4,0,36,32
1656107709330,MATH 20A,A01,083754,Zheng; Zequn,11,0,40,29
1656107715356,MATH 20B,A01,083756,Briones; Jor-el Thomas Caparas,0,0,36,36
1656107715356,MATH 20B,A02,083757,Briones; Jor-el Thomas Caparas,0,0,36,36
1656107715356,MATH 20B,A03,093475,Staff,3,0,36,33
1656107721397,MATH 20C,A01,083760,Briones; Jor-el Thomas Caparas,2,2,35,33
1656107721397,MATH 20C,A02,083761,Briones; Jor-el Thomas Caparas,9,1,35,26
1656107721397,MATH 20C,A03,093476,Staff,1,1,35,34
1656107721397,MATH 20C,B01,083762,Bach; Quang Tran,1,0,30,29
1656107727421,MATH 20D,A01,083765,Tran; Brian Kha,3,0,30,27
1656107727421,MATH 20D,A02,083766,Tran; Brian Kha,0,1,30,30
1656107727421,MATH 20D,A03,083767,Tran; Brian Kha,2,0,30,28
1656107733446,MATH 20E,A01,083771,Ganguly; Soumya,4,1,32,28
1656107733446,MATH 20E,A02,083772,Ganguly; Soumya,2,2,32,30
1656107733446,MATH 20E,B01,083773,Ciotti; Benjamin,14,0,35,21
1656107733446,MATH 20E,B02,083774,Ciotti; Benjamin,14,0,35,21
1656107739475,MATH 103A,A01,083777,Greenfeld; Be'Eri,3,0,36,33
1656107739475,MATH 103A,A02,083778,Greenfeld; Be'Eri,2,0,36,34
1656107739475,MATH 103A,A03,093561,Staff,4,1,36,32
1656107739475,MATH 103A,B01,083779,Greenfeld; Be'Eri,8,1,36,28
1656107739475,MATH 103A,B02,083780,Greenfeld; Be'Eri,0,1,36,36
1656107739475,MATH 103A,B03,093562,Staff,0,0,36,36
1656107745503,MATH 105,A01,085443,Carter; Anne Toulson,4,1,35,31
1656107745503,MATH 105,A02,093477,Staff,9,0,35,26
1656107751528,MATH 109,A01,083213,Ganzberger; Geoffrey Michael,1,1,34,33
1656107751528,MATH 109,A02,083214,Ganzberger; Geoffrey Michael,0,0,34,34
1656107751528,MATH 109,A03,093478,Staff,1,0,34,33
1656107751528,MATH 109,B01,083215,Ganzberger; Geoffrey Michael,3,0,32,29
1656107751528,MATH 109,B02,083216,Ganzberger; Geoffrey Michael,1,0,32,31
1656107751528,MATH 109,B03,093479,Staff,4,0,32,28
1656107757562,MATH 142A,A01,083219,Chow; Bennett,1,0,32,31
1656107757562,MATH 142A,A02,083220,Chow; Bennett,8,0,32,24
1656107757562,MATH 142A,A03,093480,Staff,5,0,32,27
1656107757562,MATH 142A,B03,093481,Staff,4,0,32,28
1656107757562,MATH 142A,B04,093558,Staff,5,0,32,27
1656107757562,MATH 142A,B05,093559,Staff,0,0,32,32
1656107763594,MATH 193A,A01,083224,Rotar; Vladimir,1,2,34,33
1656107763594,MATH 193A,A02,083225,Rotar; Vladimir,1,0,34,33
1656107763594,MATH 193A,A03,083781,Rotar; Vladimir,1,0,34,33
1656107763594,MATH 193A,A04,083782,Rotar; Vladimir,6,0,34,28
1656107763594,MATH 193A,A05,093482,Rotar; Vladimir,1,0,34,33
1656107769616,MATH 197,001,091859,McAuley; Julian John,9999,0,9999,0
1656107769616,MATH 197,002,095566,Kedlaya; Kiran S.,9997,0,9999,2
1656107769616,MATH 197,003,095567,Xiao; Ming,9999,0,9999,0
1656107769616,MATH 197,004,095571,Perols; Johan Lars,9998,0,9999,1
1656107776671,COGS 9,A01,083615,Shannon; Kyle Michael,5,1,75,70
1656107782694,COGS 11,A01,083617,Boyle; Mary E. T.,16,2,48,32
1656107788718,COGS 13,A01,083071,Bastos; Amalia Pinkusfeld,8,3,71,63
1656107794745,COGS 14A,A01,092681,Semenuks; Arturs,8,24,100,92
1656107800768,COGS 14B,A01,083073,Cheng; Tzu-Han,7,0,63,56
1656107806791,COGS 17,A01,092677,Semenuks; Arturs,13,6,81,68
1656107812819,COGS 100,A01,083619,Allen; Michael Gordon,7,4,70,63
1656107818847,COGS 101A,A01,083621,Davis; Joshua Daniel,7,3,68,61
1656107824889,COGS 101B,A01,091572,Allen; Michael Gordon,6,0,65,59
1656107830919,COGS 101C,A01,083625,Delgado; Tania,11,0,35,24
1656107836950,COGS 107A,A01,083627,Boyle; Mary E. T.,5,4,60,55
1656107842978,COGS 118A,A01,083075,Gupta; Anjum,24,17,76,52
1656107849001,CSE 3,A50,083646,Miranda; Gregory Joseph,18,0,50,32
1656107855030,CSE 8A,A50,083650,Miranda; Gregory Joseph,13,12,56,43
1656107861056,CSE 11,A01,083080,Cao; Yingjun,1,60,40,39
1656107867080,CSE 12,A01,083652,Krause-Levy; Sophia Louisa,14,8,120,106
1656107873102,CSE 15L,A01,083654,Morris; Justin Loren,5,2,50,45
1656107873102,CSE 15L,A02,083655,Morris; Justin Loren,7,2,50,43
1656107879125,CSE 20,A01,083657,Tran; Khoa Dang,31,0,80,49
1656107885148,CSE 21,A01,095574,Bach; Quang Tran,26,0,48,22
1656107891172,CSE 30,A01,083084,Eldon; John,3,11,80,77
1656107891172,CSE 30,B01,095061,Bhaskar; Nishant,4,5,50,46
1656107897201,CSE 100,A01,083659,Cao; Yingjun,2,22,70,68
1656107903227,CSE 134B,A01,083661,Powell; Thomas Allan,10,8,100,90
1656107909251,CSE 140,A01,083663,Gungor; Onat,9,0,85,76
1656107915273,CSE 140L,A01,083088,Eldon; John,8,0,100,92
1656107921296,CSE 175,A01,083665,Kumar; Rakesh,1,0,25,24
1656107927319,CSE 190,A00,092507,Dubnov; Shlomo,2,0,20,18
1656107933342,ECE 45,A01,083139,Congero; Spencer William,5,3,75,70
1656107939370,ECE 65,A50,083695,Saad; Andrew S,8,0,30,22
1656107939370,ECE 65,A51,095125,Staff,23,0,26,3
1656107945397,ECE 109,A01,091882,Touri; Behrouz,7,7,70,63
1656107951420,ECE 180,A00,083140,Abi Samra; Nicholas Camill,1,0,30,29
1656107951420,ECE 180,B00,083141,Abi Samra; Nicholas Camill,4,8,30,26
1656107957447,MATH 10A,A01,083735,Patchell; Gregory David,0,0,30,30
1656107957447,MATH 10A,A02,083736,Patchell; Gregory David,22,0,30,8
1656107957447,MATH 10A,A03,083737,Patchell; Gregory David,16,0,30,14
1656107963486,MATH 10B,A01,083207,Lim; Seonhee,3,3,34,31
1656107963486,MATH 10B,A02,083208,Lim; Seonhee,10,2,35,25
1656107963486,MATH 10B,A03,093472,Staff,4,2,34,30
1656107963486,MATH 10B,B01,083739,Sinha; Shubham,12,0,30,18
1656107969525,MATH 18,A01,083743,Cinel; Cameron Alexander,7,0,30,23
1656107969525,MATH 18,A02,083744,Cinel; Cameron Alexander,10,0,30,20
1656107969525,MATH 18,A03,083745,Cinel; Cameron Alexander,3,0,30,27
1656107969525,MATH 18,B01,083748,Ma; Zilu,0,0,36,36
1656107969525,MATH 18,B02,083749,Ma; Zilu,0,0,36,36
1656107969525,MATH 18,B03,083750,Ma; Zilu,0,0,36,36
1656107969525,MATH 18,B04,083751,Ma; Zilu,0,0,36,36
1656107969525,MATH 18,B05,093473,Staff,2,0,36,34
1656107969525,MATH 18,B06,093474,Staff,4,0,36,32
1656107975551,MATH 20A,A01,083754,Zheng; Zequn,11,0,40,29
1656107981574,MATH 20B,A01,083756,Briones; Jor-el Thomas Caparas,0,0,36,36
1656107981574,MATH 20B,A02,083757,Briones; Jor-el Thomas Caparas,0,0,36,36
1656107981574,MATH 20B,A03,093475,Staff,3,0,36,33
1656107987598,MATH 20C,A01,083760,Briones; Jor-el Thomas Caparas,2,2,35,33
1656107987598,MATH 20C,A02,083761,Briones; Jor-el Thomas Caparas,9,1,35,26
1656107987598,MATH 20C,A03,093476,Staff,1,1,35,34
1656107987598,MATH 20C,B01,083762,Bach; Quang Tran,1,0,30,29
1656107993632,MATH 20D,A01,083765,Tran; Brian Kha,3,0,30,27
1656107993632,MATH 20D,A02,083766,Tran; Brian Kha,0,1,30,30
1656107993632,MATH 20D,A03,083767,Tran; Brian Kha,2,0,30,28
1656107999656,MATH 20E,A01,083771,Ganguly; Soumya,4,1,32,28
1656107999656,MATH 20E,A02,083772,Ganguly; Soumya,2,2,32,30
1656107999656,MATH 20E,B01,083773,Ciotti; Benjamin,14,0,35,21
1656107999656,MATH 20E,B02,083774,Ciotti; Benjamin,14,0,35,21
1656108005690,MATH 103A,A01,083777,Greenfeld; Be'Eri,3,0,36,33
1656108005690,MATH 103A,A02,083778,Greenfeld; Be'Eri,2,0,36,34
1656108005690,MATH 103A,A03,093561,Staff,4,1,36,32
1656108005690,MATH 103A,B01,083779,Greenfeld; Be'Eri,8,1,36,28
1656108005690,MATH 103A,B02,083780,Greenfeld; Be'Eri,0,1,36,36
1656108005690,MATH 103A,B03,093562,Staff,0,0,36,36
1656108011714,MATH 105,A01,085443,Carter; Anne Toulson,4,1,35,31
1656108011714,MATH 105,A02,093477,Staff,9,0,35,26
1656108017740,MATH 109,A01,083213,Ganzberger; Geoffrey Michael,1,1,34,33
1656108017740,MATH 109,A02,083214,Ganzberger; Geoffrey Michael,0,0,34,34
1656108017740,MATH 109,A03,093478,Staff,1,0,34,33
1656108017740,MATH 109,B01,083215,Ganzberger; Geoffrey Michael,3,0,32,29
1656108017740,MATH 109,B02,083216,Ganzberger; Geoffrey Michael,1,0,32,31
1656108017740,MATH 109,B03,093479,Staff,4,0,32,28
1656108023766,MATH 142A,A01,083219,Chow; Bennett,1,0,32,31
1656108023766,MATH 142A,A02,083220,Chow; Bennett,8,0,32,24
1656108023766,MATH 142A,A03,093480,Staff,5,0,32,27
1656108023766,MATH 142A,B03,093481,Staff,4,0,32,28
1656108023766,MATH 142A,B04,093558,Staff,5,0,32,27
1656108023766,MATH 142A,B05,093559,Staff,0,0,32,32
1656108029793,MATH 193A,A01,083224,Rotar; Vladimir,1,2,34,33
1656108029793,MATH 193A,A02,083225,Rotar; Vladimir,1,0,34,33
1656108029793,MATH 193A,A03,083781,Rotar; Vladimir,1,0,34,33
1656108029793,MATH 193A,A04,083782,Rotar; Vladimir,6,0,34,28
1656108029793,MATH 193A,A05,093482,Rotar; Vladimir,1,0,34,33
1656108035817,MATH 197,001,091859,McAuley; Julian John,9999,0,9999,0
1656108035817,MATH 197,002,095566,Kedlaya; Kiran S.,9997,0,9999,2
1656108035817,MATH 197,003,095567,Xiao; Ming,9999,0,9999,0
1656108035817,MATH 197,004,095571,Perols; Johan Lars,9998,0,9999,1
1656108042893,COGS 9,A01,083615,Shannon; Kyle Michael,5,1,75,70
1656108048919,COGS 11,A01,083617,Boyle; Mary E. T.,16,2,48,32
1656108054951,COGS 13,A01,083071,Bastos; Amalia Pinkusfeld,8,3,71,63
1656108060979,COGS 14A,A01,092681,Semenuks; Arturs,8,24,100,92
1656108067003,COGS 14B,A01,083073,Cheng; Tzu-Han,7,0,63,56
1656108073033,COGS 17,A01,092677,Semenuks; Arturs,13,6,81,68
1656108079056,COGS 100,A01,083619,Allen; Michael Gordon,7,4,70,63
1656108085080,COGS 101A,A01,083621,Davis; Joshua Daniel,7,3,68,61
1656108091109,COGS 101B,A01,091572,Allen; Michael Gordon,6,0,65,59
1656108097135,COGS 101C,A01,083625,Delgado; Tania,11,0,35,24
1656108103163,COGS 107A,A01,083627,Boyle; Mary E. T.,5,4,60,55
1656108109189,COGS 118A,A01,083075,Gupta; Anjum,24,17,76,52
1656108115215,CSE 3,A50,083646,Miranda; Gregory Joseph,18,0,50,32
1656108121246,CSE 8A,A50,083650,Miranda; Gregory Joseph,13,12,56,43
1656108127355,CSE 11,A01,083080,Cao; Yingjun,1,60,40,39
1656108133380,CSE 12,A01,083652,Krause-Levy; Sophia Louisa,14,8,120,106
1656108139405,CSE 15L,A01,083654,Morris; Justin Loren,5,2,50,45
1656108139405,CSE 15L,A02,083655,Morris; Justin Loren,7,2,50,43
1656108145430,CSE 20,A01,083657,Tran; Khoa Dang,31,0,80,49
1656108151452,CSE 21,A01,095574,Bach; Quang Tran,26,0,48,22
1656108157474,CSE 30,A01,083084,Eldon; John,3,11,80,77
1656108157474,CSE 30,B01,095061,Bhaskar; Nishant,4,5,50,46
1656108163497,CSE 100,A01,083659,Cao; Yingjun,2,22,70,68
1656108169522,CSE 134B,A01,083661,Powell; Thomas Allan,10,8,100,90
1656108175545,CSE 140,A01,083663,Gungor; Onat,9,0,85,76
1656108181569,CSE 140L,A01,083088,Eldon; John,8,0,100,92
1656108187594,CSE 175,A01,083665,Kumar; Rakesh,1,0,25,24
1656108193622,CSE 190,A00,092507,Dubnov; Shlomo,2,0,20,18
1656108199646,ECE 45,A01,083139,Congero; Spencer William,5,3,75,70
1656108205672,ECE 65,A50,083695,Saad; Andrew S,8,0,30,22
1656108205672,ECE 65,A51,095125,Staff,23,0,26,3
1656108211697,ECE 109,A01,091882,Touri; Behrouz,7,7,70,63
1656108217721,ECE 180,A00,083140,Abi Samra; Nicholas Camill,1,0,30,29
1656108217721,ECE 180,B00,083141,Abi Samra; Nicholas Camill,4,8,30,26
1656108223756,MATH 10A,A01,083735,Patchell; Gregory David,0,0,30,30
1656108223756,MATH 10A,A02,083736,Patchell; Gregory David,22,0,30,8
1656108223756,MATH 10A,A03,083737,Patchell; Gregory David,16,0,30,14
1656108229783,MATH 10B,A01,083207,Lim; Seonhee,3,3,34,31
1656108229783,MATH 10B,A02,083208,Lim; Seonhee,10,2,35,25
1656108229783,MATH 10B,A03,093472,Staff,4,2,34,30
1656108229783,MATH 10B,B01,083739,Sinha; Shubham,12,0,30,18
1656108235807,MATH 18,A01,083743,Cinel; Cameron Alexander,7,0,30,23
1656108235807,MATH 18,A02,083744,Cinel; Cameron Alexander,10,0,30,20
1656108235807,MATH 18,A03,083745,Cinel; Cameron Alexander,3,0,30,27
1656108235807,MATH 18,B01,083748,Ma; Zilu,0,0,36,36
1656108235807,MATH 18,B02,083749,Ma; Zilu,0,0,36,36
1656108235807,MATH 18,B03,083750,Ma; Zilu,0,0,36,36
1656108235807,MATH 18,B04,083751,Ma; Zilu,0,0,36,36
1656108235807,MATH 18,B05,093473,Staff,2,0,36,34
1656108235807,MATH 18,B06,093474,Staff,4,0,36,32
1656108241829,MATH 20A,A01,083754,Zheng; Zequn,11,0,40,29
1656108247863,MATH 20B,A01,083756,Briones; Jor-el Thomas Caparas,0,0,36,36
1656108247863,MATH 20B,A02,083757,Briones; Jor-el Thomas Caparas,0,0,36,36
1656108247863,MATH 20B,A03,093475,Staff,3,0,36,33
1656108253888,MATH 20C,A01,083760,Briones; Jor-el Thomas Caparas,2,2,35,33
1656108253888,MATH 20C,A02,083761,Briones; Jor-el Thomas Caparas,9,1,35,26
1656108253888,MATH 20C,A03,093476,Staff,1,1,35,34
1656108253888,MATH 20C,B01,083762,Bach; Quang Tran,1,0,30,29
1656108259913,MATH 20D,A01,083765,Tran; Brian Kha,2,0,30,28
1656108259913,MATH 20D,A02,083766,Tran; Brian Kha,0,1,30,30
1656108259913,MATH 20D,A03,083767,Tran; Brian Kha,2,0,30,28
1656108265948,MATH 20E,A01,083771,Ganguly; Soumya,4,1,32,28
1656108265948,MATH 20E,A02,083772,Ganguly; Soumya,2,2,32,30
1656108265948,MATH 20E,B01,083773,Ciotti; Benjamin,14,0,35,21
1656108265948,MATH 20E,B02,083774,Ciotti; Benjamin,14,0,35,21
1656108271977,MATH 103A,A01,083777,Greenfeld; Be'Eri,3,0,36,33
1656108271977,MATH 103A,A02,083778,Greenfeld; Be'Eri,2,0,36,34
1656108271977,MATH 103A,A03,093561,Staff,4,1,36,32
1656108271977,MATH 103A,B01,083779,Greenfeld; Be'Eri,8,1,36,28
1656108271977,MATH 103A,B02,083780,Greenfeld; Be'Eri,0,1,36,36
1656108271977,MATH 103A,B03,093562,Staff,0,0,36,36
1656108278004,MATH 105,A01,085443,Carter; Anne Toulson,4,1,35,31
1656108278004,MATH 105,A02,093477,Staff,9,0,35,26
1656108284034,MATH 109,A01,083213,Ganzberger; Geoffrey Michael,1,1,34,33
1656108284034,MATH 109,A02,083214,Ganzberger; Geoffrey Michael,0,0,34,34
1656108284034,MATH 109,A03,093478,Staff,1,0,34,33
1656108284034,MATH 109,B01,083215,Ganzberger; Geoffrey Michael,3,0,32,29
1656108284034,MATH 109,B02,083216,Ganzberger; Geoffrey Michael,1,0,32,31
1656108284034,MATH 109,B03,093479,Staff,4,0,32,28
1656108290062,MATH 142A,A01,083219,Chow; Bennett,1,0,32,31
1656108290062,MATH 142A,A02,083220,Chow; Bennett,8,0,32,24
1656108290062,MATH 142A,A03,093480,Staff,5,0,32,27
1656108290062,MATH 142A,B03,093481,Staff,4,0,32,28
1656108290062,MATH 142A,B04,093558,Staff,5,0,32,27
1656108290062,MATH 142A,B05,093559,Staff,0,0,32,32
1656108296106,MATH 193A,A01,083224,Rotar; Vladimir,1,2,34,33
1656108296106,MATH 193A,A02,083225,Rotar; Vladimir,1,0,34,33
1656108296106,MATH 193A,A03,083781,Rotar; Vladimir,1,0,34,33
1656108296106,MATH 193A,A04,083782,Rotar; Vladimir,6,0,34,28
1656108296106,MATH 193A,A05,093482,Rotar; Vladimir,1,0,34,33
1656108302147,MATH 197,001,091859,McAuley; Julian John,9999,0,9999,0
1656108302147,MATH 197,002,095566,Kedlaya; Kiran S.,9997,0,9999,2
1656108302147,MATH 197,003,095567,Xiao; Ming,9999,0,9999,0
1656108302147,MATH 197,004,095571,Perols; Johan Lars,9998,0,9999,1
1656108309200,COGS 9,A01,083615,Shannon; Kyle Michael,5,1,75,70
1656108322787,COGS 11,A01,083617,Boyle; Mary E. T.,16,2,48,32
1656108328812,COGS 13,A01,083071,Bastos; Amalia Pinkusfeld,8,3,71,63
1656108334850,COGS 14A,A01,092681,Semenuks; Arturs,8,24,100,92
1656108340881,COGS 14B,A01,083073,Cheng; Tzu-Han,7,0,63,56
1656108346908,COGS 17,A01,092677,Semenuks; Arturs,13,6,81,68
1656108352937,COGS 100,A01,083619,Allen; Michael Gordon,7,4,70,63
1656108358969,COGS 101A,A01,083621,Davis; Joshua Daniel,7,3,68,61
1656108364990,COGS 101B,A01,091572,Allen; Michael Gordon,6,0,65,59
1656108371018,COGS 101C,A01,083625,Delgado; Tania,11,0,35,24
1656108377041,COGS 107A,A01,083627,Boyle; Mary E. T.,5,4,60,55
1656108383072,COGS 118A,A01,083075,Gupta; Anjum,24,17,76,52
1656108389100,CSE 3,A50,083646,Miranda; Gregory Joseph,18,0,50,32
1656108395131,CSE 8A,A50,083650,Miranda; Gregory Joseph,13,12,56,43
1656108401153,CSE 11,A01,083080,Cao; Yingjun,1,60,40,39
1656108407176,CSE 12,A01,083652,Krause-Levy; Sophia Louisa,14,8,120,106
1656108413204,CSE 15L,A01,083654,Morris; Justin Loren,5,2,50,45
1656108413204,CSE 15L,A02,083655,Morris; Justin Loren,7,2,50,43
1656108419245,CSE 20,A01,083657,Tran; Khoa Dang,31,0,80,49
1656108425272,CSE 21,A01,095574,Bach; Quang Tran,26,0,48,22
1656108431299,CSE 30,A01,083084,Eldon; John,3,11,80,77
1656108431299,CSE 30,B01,095061,Bhaskar; Nishant,4,5,50,46
1656108437325,CSE 100,A01,083659,Cao; Yingjun,2,22,70,68
1656108443356,CSE 134B,A01,083661,Powell; Thomas Allan,10,8,100,90
1656108449379,CSE 140,A01,083663,Gungor; Onat,9,0,85,76
1656108455401,CSE 140L,A01,083088,Eldon; John,8,0,100,92
1656108461436,CSE 175,A01,083665,Kumar; Rakesh,0,0,25,25
1656108467459,CSE 190,A00,092507,Dubnov; Shlomo,2,0,20,18
1656108473483,ECE 45,A01,083139,Congero; Spencer William,5,3,75,70
1656108479511,ECE 65,A50,083695,Saad; Andrew S,8,0,30,22
1656108479511,ECE 65,A51,095125,Staff,23,0,26,3
1656108485534,ECE 109,A01,091882,Touri; Behrouz,7,7,70,63
1656108491562,ECE 180,A00,083140,Abi Samra; Nicholas Camill,1,0,30,29
1656108491562,ECE 180,B00,083141,Abi Samra; Nicholas Camill,4,8,30,26
1656108497592,MATH 10A,A01,083735,Patchell; Gregory David,0,0,30,30
1656108497592,MATH 10A,A02,083736,Patchell; Gregory David,22,0,30,8
1656108497592,MATH 10A,A03,083737,Patchell; Gregory David,16,0,30,14
1656108503616,MATH 10B,A01,083207,Lim; Seonhee,3,3,34,31
1656108503616,MATH 10B,A02,083208,Lim; Seonhee,10,2,35,25
1656108503616,MATH 10B,A03,093472,Staff,4,2,34,30
1656108503616,MATH 10B,B01,083739,Sinha; Shubham,12,0,30,18
1656108509640,MATH 18,A01,083743,Cinel; Cameron Alexander,7,0,30,23
1656108509640,MATH 18,A02,083744,Cinel; Cameron Alexander,10,0,30,20
1656108509640,MATH 18,A03,083745,Cinel; Cameron Alexander,3,0,30,27
1656108509640,MATH 18,B01,083748,Ma; Zilu,0,0,36,36
1656108509640,MATH 18,B02,083749,Ma; Zilu,0,0,36,36
1656108509640,MATH 18,B03,083750,Ma; Zilu,0,0,36,36
1656108509640,MATH 18,B04,083751,Ma; Zilu,0,0,36,36
1656108509640,MATH 18,B05,093473,Staff,2,0,36,34
1656108509640,MATH 18,B06,093474,Staff,4,0,36,32
1656108515669,MATH 20A,A01,083754,Zheng; Zequn,11,0,40,29
1656108521701,MATH 20B,A01,083756,Briones; Jor-el Thomas Caparas,0,0,36,36
1656108521701,MATH 20B,A02,083757,Briones; Jor-el Thomas Caparas,0,0,36,36
1656108521701,MATH 20B,A03,093475,Staff,3,0,36,33
1656108527732,MATH 20C,A01,083760,Briones; Jor-el Thomas Caparas,2,2,35,33
1656108527732,MATH 20C,A02,083761,Briones; Jor-el Thomas Caparas,9,1,35,26
1656108527732,MATH 20C,A03,093476,Staff,1,1,35,34
1656108527732,MATH 20C,B01,083762,Bach; Quang Tran,1,0,30,29
1656108533760,MATH 20D,A01,083765,Tran; Brian Kha,2,0,30,28
1656108533760,MATH 20D,A02,083766,Tran; Brian Kha,0,1,30,30
1656108533760,MATH 20D,A03,083767,Tran; Brian Kha,2,0,30,28
1656108539790,MATH 20E,A01,083771,Ganguly; Soumya,4,1,32,28
1656108539790,MATH 20E,A02,083772,Ganguly; Soumya,2,2,32,30
1656108539790,MATH 20E,B01,083773,Ciotti; Benjamin,14,0,35,21
1656108539790,MATH 20E,B02,083774,Ciotti; Benjamin,14,0,35,21
1656108545827,MATH 103A,A01,083777,Greenfeld; Be'Eri,3,0,36,33
1656108545827,MATH 103A,A02,083778,Greenfeld; Be'Eri,2,0,36,34
1656108545827,MATH 103A,A03,093561,Staff,4,1,36,32
1656108545827,MATH 103A,B01,083779,Greenfeld; Be'Eri,8,1,36,28
1656108545827,MATH 103A,B02,083780,Greenfeld; Be'Eri,0,1,36,36
1656108545827,MATH 103A,B03,093562,Staff,0,0,36,36
1656108551851,MATH 105,A01,085443,Carter; Anne Toulson,4,1,35,31
1656108551851,MATH 105,A02,093477,Staff,9,0,35,26
1656108557875,MATH 109,A01,083213,Ganzberger; Geoffrey Michael,1,1,34,33
1656108557875,MATH 109,A02,083214,Ganzberger; Geoffrey Michael,0,0,34,34
1656108557875,MATH 109,A03,093478,Staff,1,0,34,33
1656108557875,MATH 109,B01,083215,Ganzberger; Geoffrey Michael,3,0,32,29
1656108557875,MATH 109,B02,083216,Ganzberger; Geoffrey Michael,1,0,32,31
1656108557875,MATH 109,B03,093479,Staff,4,0,32,28
1656108563899,MATH 142A,A01,083219,Chow; Bennett,1,0,32,31
1656108563899,MATH 142A,A02,083220,Chow; Bennett,8,0,32,24
1656108563899,MATH 142A,A03,093480,Staff,5,0,32,27
1656108563899,MATH 142A,B03,093481,Staff,4,0,32,28
1656108563899,MATH 142A,B04,093558,Staff,5,0,32,27
1656108563899,MATH 142A,B05,093559,Staff,0,0,32,32
1656108569928,MATH 193A,A01,083224,Rotar; Vladimir,1,2,34,33
1656108569928,MATH 193A,A02,083225,Rotar; Vladimir,1,0,34,33
1656108569928,MATH 193A,A03,083781,Rotar; Vladimir,1,0,34,33
1656108569928,MATH 193A,A04,083782,Rotar; Vladimir,6,0,34,28
1656108569928,MATH 193A,A05,093482,Rotar; Vladimir,1,0,34,33
1656108575955,MATH 197,001,091859,McAuley; Julian John,9999,0,9999,0
1656108575955,MATH 197,002,095566,Kedlaya; Kiran S.,9997,0,9999,2
1656108575955,MATH 197,003,095567,Xiao; Ming,9999,0,9999,0
1656108575955,MATH 197,004,095571,Perols; Johan Lars,9998,0,9999,1
1656108583009,COGS 9,A01,083615,Shannon; Kyle Michael,5,1,75,70
1656108589033,COGS 11,A01,083617,Boyle; Mary E. T.,16,2,48,32
1656108595059,COGS 13,A01,083071,Bastos; Amalia Pinkusfeld,8,3,71,63
1656108601084,COGS 14A,A01,092681,Semenuks; Arturs,8,24,100,92
1656108607112,COGS 14B,A01,083073,Cheng; Tzu-Han,7,0,63,56
1656108613135,COGS 17,A01,092677,Semenuks; Arturs,13,6,81,68
1656108619159,COGS 100,A01,083619,Allen; Michael Gordon,7,4,70,63
1656108625181,COGS 101A,A01,083621,Davis; Joshua Daniel,7,3,68,61
1656108631202,COGS 101B,A01,091572,Allen; Michael Gordon,6,0,65,59
1656108637236,COGS 101C,A01,083625,Delgado; Tania,11,0,35,24
1656108643260,COGS 107A,A01,083627,Boyle; Mary E. T.,5,4,60,55
1656108649285,COGS 118A,A01,083075,Gupta; Anjum,24,17,76,52
1656108655314,CSE 3,A50,083646,Miranda; Gregory Joseph,18,0,50,32
1656108661337,CSE 8A,A50,083650,Miranda; Gregory Joseph,13,12,56,43
1656108667364,CSE 11,A01,083080,Cao; Yingjun,1,60,40,39
1656108673391,CSE 12,A01,083652,Krause-Levy; Sophia Louisa,14,8,120,106
1656108679417,CSE 15L,A01,083654,Morris; Justin Loren,5,2,50,45
1656108679417,CSE 15L,A02,083655,Morris; Justin Loren,7,2,50,43
1656108685439,CSE 20,A01,083657,Tran; Khoa Dang,31,0,80,49
1656108691462,CSE 21,A01,095574,Bach; Quang Tran,26,0,48,22
1656108697489,CSE 30,A01,083084,Eldon; John,3,11,80,77
1656108697489,CSE 30,B01,095061,Bhaskar; Nishant,4,5,50,46
1656108703515,CSE 100,A01,083659,Cao; Yingjun,2,22,70,68
1656108709545,CSE 134B,A01,083661,Powell; Thomas Allan,10,8,100,90
1656108715568,CSE 140,A01,083663,Gungor; Onat,9,0,85,76
1656108721596,CSE 140L,A01,083088,Eldon; John,8,0,100,92
1656108727622,CSE 175,A01,083665,Kumar; Rakesh,0,0,25,25
1656108733752,CSE 190,A00,092507,Dubnov; Shlomo,2,0,20,18
1656108739782,ECE 45,A01,083139,Congero; Spencer William,5,3,75,70
1656108745810,ECE 65,A50,083695,Saad; Andrew S,8,0,30,22
1656108745810,ECE 65,A51,095125,Staff,23,0,26,3
1656108751838,ECE 109,A01,091882,Touri; Behrouz,7,7,70,63
1656108757862,ECE 180,A00,083140,Abi Samra; Nicholas Camill,1,0,30,29
1656108757862,ECE 180,B00,083141,Abi Samra; Nicholas Camill,4,8,30,26
1656108763893,MATH 10A,A01,083735,Patchell; Gregory David,0,0,30,30
1656108763893,MATH 10A,A02,083736,Patchell; Gregory David,22,0,30,8
1656108763893,MATH 10A,A03,083737,Patchell; Gregory David,16,0,30,14
1656108769921,MATH 10B,A01,083207,Lim; Seonhee,3,3,34,31
1656108769921,MATH 10B,A02,083208,Lim; Seonhee,10,2,35,25
1656108769921,MATH 10B,A03,093472,Staff,4,2,34,30
1656108769921,MATH 10B,B01,083739,Sinha; Shubham,11,0,30,19
1656108775946,MATH 18,A01,083743,Cinel; Cameron Alexander,7,0,30,23
1656108775946,MATH 18,A02,083744,Cinel; Cameron Alexander,10,0,30,20
1656108775946,MATH 18,A03,083745,Cinel; Cameron Alexander,3,0,30,27
1656108775946,MATH 18,B01,083748,Ma; Zilu,0,0,36,36
1656108775946,MATH 18,B02,083749,Ma; Zilu,0,0,36,36
1656108775946,MATH 18,B03,083750,Ma; Zilu,0,0,36,36
1656108775946,MATH 18,B04,083751,Ma; Zilu,0,0,36,36
1656108775946,MATH 18,B05,093473,Staff,2,0,36,34
1656108775946,MATH 18,B06,093474,Staff,4,0,36,32
1656108781970,MATH 20A,A01,083754,Zheng; Zequn,11,0,40,29
1656108787993,MATH 20B,A01,083756,Briones; Jor-el Thomas Caparas,0,0,36,36
1656108787993,MATH 20B,A02,083757,Briones; Jor-el Thomas Caparas,0,0,36,36
1656108787993,MATH 20B,A03,093475,Staff,2,0,36,34
1656108794025,MATH 20C,A01,083760,Briones; Jor-el Thomas Caparas,2,2,35,33
1656108794025,MATH 20C,A02,083761,Briones; Jor-el Thomas Caparas,9,1,35,26
1656108794025,MATH 20C,A03,093476,Staff,1,1,35,34
1656108794025,MATH 20C,B01,083762,Bach; Quang Tran,1,0,30,29
1656108800049,MATH 20D,A01,083765,Tran; Brian Kha,2,0,30,28
1656108800049,MATH 20D,A02,083766,Tran; Brian Kha,0,1,30,30
1656108800049,MATH 20D,A03,083767,Tran; Brian Kha,2,0,30,28
1656108806077,MATH 20E,A01,083771,Ganguly; Soumya,4,1,32,28
1656108806077,MATH 20E,A02,083772,Ganguly; Soumya,2,2,32,30
1656108806077,MATH 20E,B01,083773,Ciotti; Benjamin,14,0,35,21
1656108806077,MATH 20E,B02,083774,Ciotti; Benjamin,14,0,35,21
1656108812102,MATH 103A,A01,083777,Greenfeld; Be'Eri,3,0,36,33
1656108812102,MATH 103A,A02,083778,Greenfeld; Be'Eri,2,0,36,34
1656108812102,MATH 103A,A03,093561,Staff,4,1,36,32
1656108812102,MATH 103A,B01,083779,Greenfeld; Be'Eri,8,1,36,28
1656108812102,MATH 103A,B02,083780,Greenfeld; Be'Eri,0,1,36,36
1656108812102,MATH 103A,B03,093562,Staff,0,0,36,36
1656108818130,MATH 105,A01,085443,Carter; Anne Toulson,4,1,35,31
1656108818130,MATH 105,A02,093477,Staff,9,0,35,26
1656108824166,MATH 109,A01,083213,Ganzberger; Geoffrey Michael,1,1,34,33
1656108824166,MATH 109,A02,083214,Ganzberger; Geoffrey Michael,0,0,34,34
1656108824166,MATH 109,A03,093478,Staff,1,0,34,33
1656108824166,MATH 109,B01,083215,Ganzberger; Geoffrey Michael,3,0,32,29
1656108824166,MATH 109,B02,083216,Ganzberger; Geoffrey Michael,1,0,32,31
1656108824166,MATH 109,B03,093479,Staff,4,0,32,28
1656108830191,MATH 142A,A01,083219,Chow; Bennett,1,0,32,31
1656108830191,MATH 142A,A02,083220,Chow; Bennett,8,0,32,24
1656108830191,MATH 142A,A03,093480,Staff,5,0,32,27
1656108830191,MATH 142A,B03,093481,Staff,4,0,32,28
1656108830191,MATH 142A,B04,093558,Staff,5,0,32,27
1656108830191,MATH 142A,B05,093559,Staff,0,0,32,32
1656108836235,MATH 193A,A01,083224,Rotar; Vladimir,1,2,34,33
1656108836235,MATH 193A,A02,083225,Rotar; Vladimir,1,0,34,33
1656108836235,MATH 193A,A03,083781,Rotar; Vladimir,1,0,34,33
1656108836235,MATH 193A,A04,083782,Rotar; Vladimir,6,0,34,28
1656108836235,MATH 193A,A05,093482,Rotar; Vladimir,1,0,34,33
1656108842258,MATH 197,001,091859,McAuley; Julian John,9999,0,9999,0
1656108842258,MATH 197,002,095566,Kedlaya; Kiran S.,9997,0,9999,2
1656108842258,MATH 197,003,095567,Xiao; Ming,9999,0,9999,0
1656108842258,MATH 197,004,095571,Perols; Johan Lars,9998,0,9999,1
1656108849314,COGS 9,A01,083615,Shannon; Kyle Michael,5,1,75,70
1656108855341,COGS 11,A01,083617,Boyle; Mary E. T.,16,2,48,32
1656108861363,COGS 13,A01,083071,Bastos; Amalia Pinkusfeld,8,3,71,63
1656108867386,COGS 14A,A01,092681,Semenuks; Arturs,8,24,100,92
1656108873414,COGS 14B,A01,083073,Cheng; Tzu-Han,7,0,63,56
1656108879442,COGS 17,A01,092677,Semenuks; Arturs,13,6,81,68
1656108885468,COGS 100,A01,083619,Allen; Michael Gordon,7,4,70,63
1656108891494,COGS 101A,A01,083621,Davis; Joshua Daniel,7,3,68,61
1656108897522,COGS 101B,A01,091572,Allen; Michael Gordon,6,0,65,59
1656108903544,COGS 101C,A01,083625,Delgado; Tania,11,0,35,24
1656108909571,COGS 107A,A01,083627,Boyle; Mary E. T.,5,4,60,55
1656108915599,COGS 118A,A01,083075,Gupta; Anjum,24,17,76,52
1656108921632,CSE 3,A50,083646,Miranda; Gregory Joseph,18,0,50,32
1656108927660,CSE 8A,A50,083650,Miranda; Gregory Joseph,13,12,56,43
1656108933694,CSE 11,A01,083080,Cao; Yingjun,1,60,40,39
1656108939719,CSE 12,A01,083652,Krause-Levy; Sophia Louisa,14,8,120,106
1656108945744,CSE 15L,A01,083654,Morris; Justin Loren,5,2,50,45
1656108945744,CSE 15L,A02,083655,Morris; Justin Loren,7,2,50,43
1656108951773,CSE 20,A01,083657,Tran; Khoa Dang,31,0,80,49
1656108957797,CSE 21,A01,095574,Bach; Quang Tran,26,0,48,22
1656108963820,CSE 30,A01,083084,Eldon; John,3,11,80,77
1656108963820,CSE 30,B01,095061,Bhaskar; Nishant,4,5,50,46
1656108969849,CSE 100,A01,083659,Cao; Yingjun,2,22,70,68
1656108975875,CSE 134B,A01,083661,Powell; Thomas Allan,10,8,100,90
1656108981910,CSE 140,A01,083663,Gungor; Onat,9,0,85,76
1656108987936,CSE 140L,A01,083088,Eldon; John,8,0,100,92
1656108993959,CSE 175,A01,083665,Kumar; Rakesh,0,0,25,25
1656108999991,CSE 190,A00,092507,Dubnov; Shlomo,2,0,20,18
1656109006018,ECE 45,A01,083139,Congero; Spencer William,5,4,75,70
1656109012041,ECE 65,A50,083695,Saad; Andrew S,8,0,30,22
1656109012041,ECE 65,A51,095125,Staff,23,0,26,3
1656109018074,ECE 109,A01,091882,Touri; Behrouz,7,7,70,63
1656109024098,ECE 180,A00,083140,Abi Samra; Nicholas Camill,1,0,30,29
1656109024098,ECE 180,B00,083141,Abi Samra; Nicholas Camill,4,8,30,26
1656109030125,MATH 10A,A01,083735,Patchell; Gregory David,0,0,30,30
1656109030125,MATH 10A,A02,083736,Patchell; Gregory David,22,0,30,8
1656109030125,MATH 10A,A03,083737,Patchell; Gregory David,16,0,30,14
1656109036150,MATH 10B,A01,083207,Lim; Seonhee,3,3,34,31
1656109036150,MATH 10B,A02,083208,Lim; Seonhee,10,2,35,25
1656109036150,MATH 10B,A03,093472,Staff,4,2,34,30
1656109036150,MATH 10B,B01,083739,Sinha; Shubham,11,0,30,19
1656109042180,MATH 18,A01,083743,Cinel; Cameron Alexander,7,0,30,23
1656109042180,MATH 18,A02,083744,Cinel; Cameron Alexander,10,0,30,20
1656109042180,MATH 18,A03,083745,Cinel; Cameron Alexander,3,0,30,27
1656109042180,MATH 18,B01,083748,Ma; Zilu,0,0,36,36
1656109042180,MATH 18,B02,083749,Ma; Zilu,0,0,36,36
1656109042180,MATH 18,B03,083750,Ma; Zilu,0,0,36,36
1656109042180,MATH 18,B04,083751,Ma; Zilu,0,0,36,36
1656109042180,MATH 18,B05,093473,Staff,2,0,36,34
1656109042180,MATH 18,B06,093474,Staff,4,0,36,32
1656109048207,MATH 20A,A01,083754,Zheng; Zequn,11,0,40,29
1656109054230,MATH 20B,A01,083756,Briones; Jor-el Thomas Caparas,0,0,36,36
1656109054230,MATH 20B,A02,083757,Briones; Jor-el Thomas Caparas,0,0,36,36
1656109054230,MATH 20B,A03,093475,Staff,2,0,36,34
1656109060255,MATH 20C,A01,083760,Briones; Jor-el Thomas Caparas,2,2,35,33
1656109060255,MATH 20C,A02,083761,Briones; Jor-el Thomas Caparas,9,1,35,26
1656109060255,MATH 20C,A03,093476,Staff,1,1,35,34
1656109060255,MATH 20C,B01,083762,Bach; Quang Tran,1,0,30,29
1656109066277,MATH 20D,A01,083765,Tran; Brian Kha,2,0,30,28
1656109066277,MATH 20D,A02,083766,Tran; Brian Kha,0,1,30,30
1656109066277,MATH 20D,A03,083767,Tran; Brian Kha,2,0,30,28
1656109072300,MATH 20E,A01,083771,Ganguly; Soumya,4,1,32,28
1656109072300,MATH 20E,A02,083772,Ganguly; Soumya,2,2,32,30
1656109072300,MATH 20E,B01,083773,Ciotti; Benjamin,14,0,35,21
1656109072300,MATH 20E,B02,083774,Ciotti; Benjamin,14,0,35,21
1656109078324,MATH 103A,A01,083777,Greenfeld; Be'Eri,3,0,36,33
1656109078324,MATH 103A,A02,083778,Greenfeld; Be'Eri,2,0,36,34
1656109078324,MATH 103A,A03,093561,Staff,4,1,36,32
1656109078324,MATH 103A,B01,083779,Greenfeld; Be'Eri,8,1,36,28
1656109078324,MATH 103A,B02,083780,Greenfeld; Be'Eri,0,0,36,36
1656109078324,MATH 103A,B03,093562,Staff,0,0,36,36
1656109084347,MATH 105,A01,085443,Carter; Anne Toulson,4,1,35,31
1656109084347,MATH 105,A02,093477,Staff,9,0,35,26
1656109090378,MATH 109,A01,083213,Ganzberger; Geoffrey Michael,1,1,34,33
1656109090378,MATH 109,A02,083214,Ganzberger; Geoffrey Michael,0,0,34,34
1656109090378,MATH 109,A03,093478,Staff,1,0,34,33
1656109090378,MATH 109,B01,083215,Ganzberger; Geoffrey Michael,3,0,32,29
1656109090378,MATH 109,B02,083216,Ganzberger; Geoffrey Michael,1,0,32,31
1656109090378,MATH 109,B03,093479,Staff,4,0,32,28
1656109096403,MATH 142A,A01,083219,Chow; Bennett,1,0,32,31
1656109096403,MATH 142A,A02,083220,Chow; Bennett,8,0,32,24
1656109096403,MATH 142A,A03,093480,Staff,5,0,32,27
1656109096403,MATH 142A,B03,093481,Staff,4,0,32,28
1656109096403,MATH 142A,B04,093558,Staff,5,0,32,27
1656109096403,MATH 142A,B05,093559,Staff,0,0,32,32
1656109102427,MATH 193A,A01,083224,Rotar; Vladimir,1,2,34,33
1656109102427,MATH 193A,A02,083225,Rotar; Vladimir,1,0,34,33
1656109102427,MATH 193A,A03,083781,Rotar; Vladimir,1,0,34,33
1656109102427,MATH 193A,A04,083782,Rotar; Vladimir,6,0,34,28
1656109102427,MATH 193A,A05,093482,Rotar; Vladimir,1,0,34,33
1656109108452,MATH 197,001,091859,McAuley; Julian John,9999,0,9999,0
1656109108452,MATH 197,002,095566,Kedlaya; Kiran S.,9997,0,9999,2
1656109108452,MATH 197,003,095567,Xiao; Ming,9999,0,9999,0
1656109108452,MATH 197,004,095571,Perols; Johan Lars,9998,0,9999,1
1656109115510,COGS 9,A01,083615,Shannon; Kyle Michael,5,1,75,70
1656109121534,COGS 11,A01,083617,Boyle; Mary E. T.,16,2,48,32
1656109127556,COGS 13,A01,083071,Bastos; Amalia Pinkusfeld,8,3,71,63
1656109133584,COGS 14A,A01,092681,Semenuks; Arturs,8,24,100,92
1656109139613,COGS 14B,A01,083073,Cheng; Tzu-Han,7,0,63,56
1656109145647,COGS 17,A01,092677,Semenuks; Arturs,13,6,81,68
1656109151670,COGS 100,A01,083619,Allen; Michael Gordon,7,4,70,63
1656109157697,COGS 101A,A01,083621,Davis; Joshua Daniel,7,3,68,61
1656109163720,COGS 101B,A01,091572,Allen; Michael Gordon,6,0,65,59
1656109169748,COGS 101C,A01,083625,Delgado; Tania,11,0,35,24
1656109175771,COGS 107A,A01,083627,Boyle; Mary E. T.,5,4,60,55
1656109181798,COGS 118A,A01,083075,Gupta; Anjum,24,17,76,52
1656109187831,CSE 3,A50,083646,Miranda; Gregory Joseph,18,0,50,32
1656109193861,CSE 8A,A50,083650,Miranda; Gregory Joseph,13,12,56,43
1656109199892,CSE 11,A01,083080,Cao; Yingjun,1,60,40,39
1656109205920,CSE 12,A01,083652,Krause-Levy; Sophia Louisa,14,8,120,106
1656109211950,CSE 15L,A01,083654,Morris; Justin Loren,5,2,50,45
1656109211950,CSE 15L,A02,083655,Morris; Justin Loren,7,2,50,43
1656109217975,CSE 20,A01,083657,Tran; Khoa Dang,31,0,80,49
1656109223999,CSE 21,A01,095574,Bach; Quang Tran,26,0,48,22
1656109230025,CSE 30,A01,083084,Eldon; John,3,11,80,77
1656109230025,CSE 30,B01,095061,Bhaskar; Nishant,4,5,50,46
1656109236048,CSE 100,A01,083659,Cao; Yingjun,2,22,70,68
1656109242073,CSE 134B,A01,083661,Powell; Thomas Allan,10,8,100,90
1656109248097,CSE 140,A01,083663,Gungor; Onat,9,0,85,76
1656109254120,CSE 140L,A01,083088,Eldon; John,8,0,100,92
1656109260146,CSE 175,A01,083665,Kumar; Rakesh,0,0,25,25
1656109266173,CSE 190,A00,092507,Dubnov; Shlomo,2,0,20,18
1656109272199,ECE 45,A01,083139,Congero; Spencer William,5,4,75,70
1656109278222,ECE 65,A50,083695,Saad; Andrew S,8,0,30,22
1656109278222,ECE 65,A51,095125,Staff,23,0,26,3
1656109284254,ECE 109,A01,091882,Touri; Behrouz,7,7,70,63
1656109290282,ECE 180,A00,083140,Abi Samra; Nicholas Camill,1,0,30,29
1656109290282,ECE 180,B00,083141,Abi Samra; Nicholas Camill,4,8,30,26
1656109296318,MATH 10A,A01,083735,Patchell; Gregory David,0,0,30,30
1656109296318,MATH 10A,A02,083736,Patchell; Gregory David,22,0,30,8
1656109296318,MATH 10A,A03,083737,Patchell; Gregory David,16,0,30,14
1656109302341,MATH 10B,A01,083207,Lim; Seonhee,3,3,34,31
1656109302341,MATH 10B,A02,083208,Lim; Seonhee,10,2,35,25
1656109302341,MATH 10B,A03,093472,Staff,4,3,34,30
1656109302341,MATH 10B,B01,083739,Sinha; Shubham,12,0,30,18
1656109308368,MATH 18,A01,083743,Cinel; Cameron Alexander,7,0,30,23
1656109308368,MATH 18,A02,083744,Cinel; Cameron Alexander,10,0,30,20
1656109308368,MATH 18,A03,083745,Cinel; Cameron Alexander,3,0,30,27
1656109308368,MATH 18,B01,083748,Ma; Zilu,0,0,36,36
1656109308368,MATH 18,B02,083749,Ma; Zilu,0,0,36,36
1656109308368,MATH 18,B03,083750,Ma; Zilu,0,0,36,36
1656109308368,MATH 18,B04,083751,Ma; Zilu,0,0,36,36
1656109308368,MATH 18,B05,093473,Staff,2,0,36,34
1656109308368,MATH 18,B06,093474,Staff,4,0,36,32
1656109314393,MATH 20A,A01,083754,Zheng; Zequn,11,0,40,29
1656109320421,MATH 20B,A01,083756,Briones; Jor-el Thomas Caparas,0,0,36,36
1656109320421,MATH 20B,A02,083757,Briones; Jor-el Thomas Caparas,0,0,36,36
1656109320421,MATH 20B,A03,093475,Staff,2,0,36,34
1656109326447,MATH 20C,A01,083760,Briones; Jor-el Thomas Caparas,2,2,35,33
1656109326447,MATH 20C,A02,083761,Briones; Jor-el Thomas Caparas,9,1,35,26
1656109326447,MATH 20C,A03,093476,Staff,1,1,35,34
1656109326447,MATH 20C,B01,083762,Bach; Quang Tran,1,0,30,29
1656109332544,MATH 20D,A01,083765,Tran; Brian Kha,2,0,30,28
1656109332544,MATH 20D,A02,083766,Tran; Brian Kha,0,1,30,30
1656109332544,MATH 20D,A03,083767,Tran; Brian Kha,2,0,30,28
1656109338568,MATH 20E,A01,083771,Ganguly; Soumya,4,1,32,28
1656109338568,MATH 20E,A02,083772,Ganguly; Soumya,2,2,32,30
1656109338568,MATH 20E,B01,083773,Ciotti; Benjamin,14,0,35,21
1656109338568,MATH 20E,B02,083774,Ciotti; Benjamin,14,0,35,21
1656109344605,MATH 103A,A01,083777,Greenfeld; Be'Eri,3,0,36,33
1656109344605,MATH 103A,A02,083778,Greenfeld; Be'Eri,2,0,36,34
1656109344605,MATH 103A,A03,093561,Staff,4,1,36,32
1656109344605,MATH 103A,B01,083779,Greenfeld; Be'Eri,8,1,36,28
1656109344605,MATH 103A,B02,083780,Greenfeld; Be'Eri,0,0,36,36
1656109344605,MATH 103A,B03,093562,Staff,0,0,36,36
1656109350633,MATH 105,A01,085443,Carter; Anne Toulson,4,1,35,31
1656109350633,MATH 105,A02,093477,Staff,9,0,35,26
1656109356669,MATH 109,A01,083213,Ganzberger; Geoffrey Michael,1,1,34,33
1656109356669,MATH 109,A02,083214,Ganzberger; Geoffrey Michael,0,0,34,34
1656109356669,MATH 109,A03,093478,Staff,1,0,34,33
1656109356669,MATH 109,B01,083215,Ganzberger; Geoffrey Michael,3,0,32,29
1656109356669,MATH 109,B02,083216,Ganzberger; Geoffrey Michael,1,0,32,31
1656109356669,MATH 109,B03,093479,Staff,4,0,32,28
1656109362704,MATH 142A,A01,083219,Chow; Bennett,1,0,32,31
1656109362704,MATH 142A,A02,083220,Chow; Bennett,8,0,32,24
1656109362704,MATH 142A,A03,093480,Staff,5,0,32,27
1656109362704,MATH 142A,B03,093481,Staff,4,0,32,28
1656109362704,MATH 142A,B04,093558,Staff,5,0,32,27
1656109362704,MATH 142A,B05,093559,Staff,0,0,32,32
1656109368739,MATH 193A,A01,083224,Rotar; Vladimir,1,2,34,33
1656109368739,MATH 193A,A02,083225,Rotar; Vladimir,1,0,34,33
1656109368739,MATH 193A,A03,083781,Rotar; Vladimir,1,0,34,33
1656109368739,MATH 193A,A04,083782,Rotar; Vladimir,6,0,34,28
1656109368739,MATH 193A,A05,093482,Rotar; Vladimir,1,0,34,33
1656109374762,MATH 197,001,091859,McAuley; Julian John,9999,0,9999,0
1656109374762,MATH 197,002,095566,Kedlaya; Kiran S.,9997,0,9999,2
1656109374762,MATH 197,003,095567,Xiao; Ming,9999,0,9999,0
1656109374762,MATH 197,004,095571,Perols; Johan Lars,9998,0,9999,1
1656109381822,COGS 9,A01,083615,Shannon; Kyle Michael,5,1,75,70
1656109387844,COGS 11,A01,083617,Boyle; Mary E. T.,16,2,48,32
1656109393869,COGS 13,A01,083071,Bastos; Amalia Pinkusfeld,8,3,71,63
1656109399897,COGS 14A,A01,092681,Semenuks; Arturs,8,24,100,92
1656109405925,COGS 14B,A01,083073,Cheng; Tzu-Han,7,0,63,56
1656109411950,COGS 17,A01,092677,Semenuks; Arturs,13,6,81,68
1656109417979,COGS 100,A01,083619,Allen; Michael Gordon,7,4,70,63
1656109424008,COGS 101A,A01,083621,Davis; Joshua Daniel,7,3,68,61
1656109430034,COGS 101B,A01,091572,Allen; Michael Gordon,6,0,65,59
1656109436063,COGS 101C,A01,083625,Delgado; Tania,11,0,35,24
1656109442088,COGS 107A,A01,083627,Boyle; Mary E. T.,5,4,60,55
1656109448121,COGS 118A,A01,083075,Gupta; Anjum,24,17,76,52
1656109454150,CSE 3,A50,083646,Miranda; Gregory Joseph,18,0,50,32
1656109460178,CSE 8A,A50,083650,Miranda; Gregory Joseph,13,12,56,43
1656109466210,CSE 11,A01,083080,Cao; Yingjun,1,60,40,39
1656109472233,CSE 12,A01,083652,Krause-Levy; Sophia Louisa,14,8,120,106
1656109478259,CSE 15L,A01,083654,Morris; Justin Loren,5,2,50,45
1656109478259,CSE 15L,A02,083655,Morris; Justin Loren,7,2,50,43
1656109484282,CSE 20,A01,083657,Tran; Khoa Dang,31,0,80,49
1656109490311,CSE 21,A01,095574,Bach; Quang Tran,26,0,48,22
1656109496338,CSE 30,A01,083084,Eldon; John,3,11,80,77
1656109496338,CSE 30,B01,095061,Bhaskar; Nishant,4,5,50,46
1656109502369,CSE 100,A01,083659,Cao; Yingjun,2,22,70,68
1656109508405,CSE 134B,A01,083661,Powell; Thomas Allan,10,8,100,90
1656109514429,CSE 140,A01,083663,Gungor; Onat,9,0,85,76
1656109520469,CSE 140L,A01,083088,Eldon; John,8,0,100,92
1656109526498,CSE 175,A01,083665,Kumar; Rakesh,0,0,25,25
1656109532535,CSE 190,A00,092507,Dubnov; Shlomo,2,0,20,18
1656109538557,ECE 45,A01,083139,Congero; Spencer William,5,4,75,70
1656109544578,ECE 65,A50,083695,Saad; Andrew S,8,0,30,22
1656109544578,ECE 65,A51,095125,Staff,23,0,26,3
1656109550602,ECE 109,A01,091882,Touri; Behrouz,7,7,70,63
1656109556624,ECE 180,A00,083140,Abi Samra; Nicholas Camill,1,0,30,29
1656109556624,ECE 180,B00,083141,Abi Samra; Nicholas Camill,4,8,30,26
1656109562648,MATH 10A,A01,083735,Patchell; Gregory David,0,0,30,30
1656109562648,MATH 10A,A02,083736,Patchell; Gregory David,22,0,30,8
1656109562648,MATH 10A,A03,083737,Patchell; Gregory David,16,0,30,14
1656109568673,MATH 10B,A01,083207,Lim; Seonhee,3,3,34,31
1656109568673,MATH 10B,A02,083208,Lim; Seonhee,10,2,35,25
1656109568673,MATH 10B,A03,093472,Staff,4,3,34,30
1656109568673,MATH 10B,B01,083739,Sinha; Shubham,12,0,30,18
1656109574712,MATH 18,A01,083743,Cinel; Cameron Alexander,7,0,30,23
1656109574712,MATH 18,A02,083744,Cinel; Cameron Alexander,10,0,30,20
1656109574712,MATH 18,A03,083745,Cinel; Cameron Alexander,3,0,30,27
1656109574712,MATH 18,B01,083748,Ma; Zilu,0,0,36,36
1656109574712,MATH 18,B02,083749,Ma; Zilu,0,0,36,36
1656109574712,MATH 18,B03,083750,Ma; Zilu,0,0,36,36
1656109574712,MATH 18,B04,083751,Ma; Zilu,0,0,36,36
1656109574712,MATH 18,B05,093473,Staff,2,0,36,34
1656109574712,MATH 18,B06,093474,Staff,4,0,36,32
1656109580735,MATH 20A,A01,083754,Zheng; Zequn,11,0,40,29
1656109586757,MATH 20B,A01,083756,Briones; Jor-el Thomas Caparas,0,0,36,36
1656109586757,MATH 20B,A02,083757,Briones; Jor-el Thomas Caparas,0,0,36,36
1656109586757,MATH 20B,A03,093475,Staff,2,0,36,34
1656109592782,MATH 20C,A01,083760,Briones; Jor-el Thomas Caparas,2,2,35,33
1656109592782,MATH 20C,A02,083761,Briones; Jor-el Thomas Caparas,9,1,35,26
1656109592782,MATH 20C,A03,093476,Staff,1,1,35,34
1656109592782,MATH 20C,B01,083762,Bach; Quang Tran,1,0,30,29
1656109598806,MATH 20D,A01,083765,Tran; Brian Kha,2,0,30,28
1656109598806,MATH 20D,A02,083766,Tran; Brian Kha,0,1,30,30
1656109598806,MATH 20D,A03,083767,Tran; Brian Kha,2,0,30,28
1656109604831,MATH 20E,A01,083771,Ganguly; Soumya,4,1,32,28
1656109604831,MATH 20E,A02,083772,Ganguly; Soumya,2,2,32,30
1656109604831,MATH 20E,B01,083773,Ciotti; Benjamin,14,0,35,21
1656109604831,MATH 20E,B02,083774,Ciotti; Benjamin,14,0,35,21
1656109610863,MATH 103A,A01,083777,Greenfeld; Be'Eri,2,0,36,34
1656109610863,MATH 103A,A02,083778,Greenfeld; Be'Eri,2,0,36,34
1656109610863,MATH 103A,A03,093561,Staff,4,1,36,32
1656109610863,MATH 103A,B01,083779,Greenfeld; Be'Eri,8,1,36,28
1656109610863,MATH 103A,B02,083780,Greenfeld; Be'Eri,0,0,36,36
1656109610863,MATH 103A,B03,093562,Staff,0,0,36,36
1656109616894,MATH 105,A01,085443,Carter; Anne Toulson,4,1,35,31
1656109616894,MATH 105,A02,093477,Staff,9,0,35,26
1656109622919,MATH 109,A01,083213,Ganzberger; Geoffrey Michael,1,1,34,33
1656109622919,MATH 109,A02,083214,Ganzberger; Geoffrey Michael,0,0,34,34
1656109622919,MATH 109,A03,093478,Staff,1,0,34,33
1656109622919,MATH 109,B01,083215,Ganzberger; Geoffrey Michael,3,0,32,29
1656109622919,MATH 109,B02,083216,Ganzberger; Geoffrey Michael,1,0,32,31
1656109622919,MATH 109,B03,093479,Staff,4,0,32,28
1656109628943,MATH 142A,A01,083219,Chow; Bennett,1,0,32,31
1656109628943,MATH 142A,A02,083220,Chow; Bennett,8,0,32,24
1656109628943,MATH 142A,A03,093480,Staff,5,0,32,27
1656109628943,MATH 142A,B03,093481,Staff,4,0,32,28
1656109628943,MATH 142A,B04,093558,Staff,5,0,32,27
1656109628943,MATH 142A,B05,093559,Staff,0,0,32,32
1656109634980,MATH 193A,A01,083224,Rotar; Vladimir,1,2,34,33
1656109634980,MATH 193A,A02,083225,Rotar; Vladimir,1,0,34,33
1656109634980,MATH 193A,A03,083781,Rotar; Vladimir,1,0,34,33
1656109634980,MATH 193A,A04,083782,Rotar; Vladimir,6,0,34,28
1656109634980,MATH 193A,A05,093482,Rotar; Vladimir,1,0,34,33
1656109641007,MATH 197,001,091859,McAuley; Julian John,9999,0,9999,0
1656109641007,MATH 197,002,095566,Kedlaya; Kiran S.,9997,0,9999,2
1656109641007,MATH 197,003,095567,Xiao; Ming,9999,0,9999,0
1656109641007,MATH 197,004,095571,Perols; Johan Lars,9998,0,9999,1
1656109648083,COGS 9,A01,083615,Shannon; Kyle Michael,5,1,75,70
1656109654107,COGS 11,A01,083617,Boyle; Mary E. T.,16,2,48,32
1656109660136,COGS 13,A01,083071,Bastos; Amalia Pinkusfeld,8,3,71,63
1656109666160,COGS 14A,A01,092681,Semenuks; Arturs,8,24,100,92
1656109672195,COGS 14B,A01,083073,Cheng; Tzu-Han,7,0,63,56
1656109678221,COGS 17,A01,092677,Semenuks; Arturs,13,6,81,68
1656109684245,COGS 100,A01,083619,Allen; Michael Gordon,7,4,70,63
1656109690270,COGS 101A,A01,083621,Davis; Joshua Daniel,7,3,68,61
1656109696293,COGS 101B,A01,091572,Allen; Michael Gordon,6,0,65,59
1656109702319,COGS 101C,A01,083625,Delgado; Tania,11,0,35,24
1656109708340,COGS 107A,A01,083627,Boyle; Mary E. T.,5,4,60,55
1656109714365,COGS 118A,A01,083075,Gupta; Anjum,24,17,76,52
1656109720396,CSE 3,A50,083646,Miranda; Gregory Joseph,18,0,50,32
1656109726419,CSE 8A,A50,083650,Miranda; Gregory Joseph,13,12,56,43
1656109732450,CSE 11,A01,083080,Cao; Yingjun,1,60,40,39
1656109738477,CSE 12,A01,083652,Krause-Levy; Sophia Louisa,14,8,120,106
1656109744525,CSE 15L,A01,083654,Morris; Justin Loren,5,2,50,45
1656109744525,CSE 15L,A02,083655,Morris; Justin Loren,7,2,50,43
1656109750548,CSE 20,A01,083657,Tran; Khoa Dang,31,0,80,49
1656109756580,CSE 21,A01,095574,Bach; Quang Tran,26,0,48,22
1656109762612,CSE 30,A01,083084,Eldon; John,3,11,80,77
1656109762612,CSE 30,B01,095061,Bhaskar; Nishant,4,5,50,46
1656109768639,CSE 100,A01,083659,Cao; Yingjun,2,22,70,68
1656109774666,CSE 134B,A01,083661,Powell; Thomas Allan,10,8,100,90
1656109780689,CSE 140,A01,083663,Gungor; Onat,9,0,85,76
1656109786718,CSE 140L,A01,083088,Eldon; John,8,0,100,92
1656109792741,CSE 175,A01,083665,Kumar; Rakesh,0,0,25,25
1656109798768,CSE 190,A00,092507,Dubnov; Shlomo,2,0,20,18
1656109804809,ECE 45,A01,083139,Congero; Spencer William,5,4,75,70
1656109810834,ECE 65,A50,083695,Saad; Andrew S,8,0,30,22
1656109810834,ECE 65,A51,095125,Staff,23,0,26,3
1656109816858,ECE 109,A01,091882,Touri; Behrouz,7,7,70,63
1656109822893,ECE 180,A00,083140,Abi Samra; Nicholas Camill,1,0,30,29
1656109822893,ECE 180,B00,083141,Abi Samra; Nicholas Camill,4,8,30,26
1656109828918,MATH 10A,A01,083735,Patchell; Gregory David,0,0,30,30
1656109828918,MATH 10A,A02,083736,Patchell; Gregory David,22,0,30,8
1656109828918,MATH 10A,A03,083737,Patchell; Gregory David,16,0,30,14
1656109834941,MATH 10B,A01,083207,Lim; Seonhee,3,3,34,31
1656109834941,MATH 10B,A02,083208,Lim; Seonhee,10,2,35,25
1656109834941,MATH 10B,A03,093472,Staff,4,3,34,30
1656109834941,MATH 10B,B01,083739,Sinha; Shubham,12,0,30,18
1656109840965,MATH 18,A01,083743,Cinel; Cameron Alexander,7,0,30,23
1656109840965,MATH 18,A02,083744,Cinel; Cameron Alexander,10,0,30,20
1656109840965,MATH 18,A03,083745,Cinel; Cameron Alexander,3,0,30,27
1656109840965,MATH 18,B01,083748,Ma; Zilu,0,0,36,36
1656109840965,MATH 18,B02,083749,Ma; Zilu,0,0,36,36
1656109840965,MATH 18,B03,083750,Ma; Zilu,0,0,36,36
1656109840965,MATH 18,B04,083751,Ma; Zilu,0,0,36,36
1656109840965,MATH 18,B05,093473,Staff,2,0,36,34
1656109840965,MATH 18,B06,093474,Staff,4,0,36,32
1656109846992,MATH 20A,A01,083754,Zheng; Zequn,11,0,40,29
1656109853015,MATH 20B,A01,083756,Briones; Jor-el Thomas Caparas,0,0,36,36
1656109853015,MATH 20B,A02,083757,Briones; Jor-el Thomas Caparas,0,0,36,36
1656109853015,MATH 20B,A03,093475,Staff,2,0,36,34
1656109859042,MATH 20C,A01,083760,Briones; Jor-el Thomas Caparas,2,2,35,33
1656109859042,MATH 20C,A02,083761,Briones; Jor-el Thomas Caparas,9,1,35,26
1656109859042,MATH 20C,A03,093476,Staff,1,1,35,34
1656109859042,MATH 20C,B01,083762,Bach; Quang Tran,1,0,30,29
1656109865072,MATH 20D,A01,083765,Tran; Brian Kha,2,0,30,28
1656109865072,MATH 20D,A02,083766,Tran; Brian Kha,0,1,30,30
1656109865072,MATH 20D,A03,083767,Tran; Brian Kha,2,0,30,28
1656109871101,MATH 20E,A01,083771,Ganguly; Soumya,4,1,32,28
1656109871101,MATH 20E,A02,083772,Ganguly; Soumya,2,2,32,30
1656109871101,MATH 20E,B01,083773,Ciotti; Benjamin,14,0,35,21
1656109871101,MATH 20E,B02,083774,Ciotti; Benjamin,14,0,35,21
1656109877124,MATH 103A,A01,083777,Greenfeld; Be'Eri,2,0,36,34
1656109877124,MATH 103A,A02,083778,Greenfeld; Be'Eri,2,0,36,34
1656109877124,MATH 103A,A03,093561,Staff,4,1,36,32
1656109877124,MATH 103A,B01,083779,Greenfeld; Be'Eri,8,1,36,28
1656109877124,MATH 103A,B02,083780,Greenfeld; Be'Eri,0,0,36,36
1656109877124,MATH 103A,B03,093562,Staff,0,0,36,36
1656109883146,MATH 105,A01,085443,Carter; Anne Toulson,4,1,35,31
1656109883146,MATH 105,A02,093477,Staff,9,0,35,26
1656109889183,MATH 109,A01,083213,Ganzberger; Geoffrey Michael,1,1,34,33
1656109889183,MATH 109,A02,083214,Ganzberger; Geoffrey Michael,0,0,34,34
1656109889183,MATH 109,A03,093478,Staff,1,0,34,33
1656109889183,MATH 109,B01,083215,Ganzberger; Geoffrey Michael,3,0,32,29
1656109889183,MATH 109,B02,083216,Ganzberger; Geoffrey Michael,1,0,32,31
1656109889183,MATH 109,B03,093479,Staff,4,0,32,28
1656109895209,MATH 142A,A01,083219,Chow; Bennett,1,0,32,31
1656109895209,MATH 142A,A02,083220,Chow; Bennett,8,0,32,24
1656109895209,MATH 142A,A03,093480,Staff,5,0,32,27
1656109895209,MATH 142A,B03,093481,Staff,4,0,32,28
1656109895209,MATH 142A,B04,093558,Staff,5,0,32,27
1656109895209,MATH 142A,B05,093559,Staff,0,0,32,32
1656109901236,MATH 193A,A01,083224,Rotar; Vladimir,1,2,34,33
1656109901236,MATH 193A,A02,083225,Rotar; Vladimir,1,0,34,33
1656109901236,MATH 193A,A03,083781,Rotar; Vladimir,1,0,34,33
1656109901236,MATH 193A,A04,083782,Rotar; Vladimir,6,0,34,28
1656109901236,MATH 193A,A05,093482,Rotar; Vladimir,1,0,34,33
1656109907259,MATH 197,001,091859,McAuley; Julian John,9999,0,9999,0
1656109907259,MATH 197,002,095566,Kedlaya; Kiran S.,9997,0,9999,2
1656109907259,MATH 197,003,095567,Xiao; Ming,9999,0,9999,0
1656109907259,MATH 197,004,095571,Perols; Johan Lars,9998,0,9999,1
1656109914312,COGS 9,A01,083615,Shannon; Kyle Michael,5,1,75,70
1656109920350,COGS 11,A01,083617,Boyle; Mary E. T.,16,2,48,32
1656109926447,COGS 13,A01,083071,Bastos; Amalia Pinkusfeld,8,3,71,63
1656109932479,COGS 14A,A01,092681,Semenuks; Arturs,8,24,100,92
1656109938514,COGS 14B,A01,083073,Cheng; Tzu-Han,7,0,63,56
1656109944547,COGS 17,A01,092677,Semenuks; Arturs,13,6,81,68
1656109950571,COGS 100,A01,083619,Allen; Michael Gordon,7,4,70,63
1656109956603,COGS 101A,A01,083621,Davis; Joshua Daniel,7,3,68,61
1656109962631,COGS 101B,A01,091572,Allen; Michael Gordon,6,0,65,59
1656109968658,COGS 101C,A01,083625,Delgado; Tania,11,0,35,24
1656109974686,COGS 107A,A01,083627,Boyle; Mary E. T.,5,4,60,55
1656109980708,COGS 118A,A01,083075,Gupta; Anjum,24,17,76,52
1656109986733,CSE 3,A50,083646,Miranda; Gregory Joseph,18,0,50,32
1656109992756,CSE 8A,A50,083650,Miranda; Gregory Joseph,13,12,56,43
1656109998782,CSE 11,A01,083080,Cao; Yingjun,1,60,40,39
1656110004809,CSE 12,A01,083652,Krause-Levy; Sophia Louisa,14,8,120,106
1656110010837,CSE 15L,A01,083654,Morris; Justin Loren,5,2,50,45
1656110010837,CSE 15L,A02,083655,Morris; Justin Loren,7,2,50,43
1656110016859,CSE 20,A01,083657,Tran; Khoa Dang,31,0,80,49
1656110022893,CSE 21,A01,095574,Bach; Quang Tran,26,0,48,22
1656110028920,CSE 30,A01,083084,Eldon; John,3,11,80,77
1656110028920,CSE 30,B01,095061,Bhaskar; Nishant,4,5,50,46
1656110034944,CSE 100,A01,083659,Cao; Yingjun,2,22,70,68
1656110040968,CSE 134B,A01,083661,Powell; Thomas Allan,10,8,100,90
1656110047001,CSE 140,A01,083663,Gungor; Onat,9,0,85,76
1656110053027,CSE 140L,A01,083088,Eldon; John,8,0,100,92
1656110059058,CSE 175,A01,083665,Kumar; Rakesh,0,0,25,25
1656110065080,CSE 190,A00,092507,Dubnov; Shlomo,2,0,20,18
1656110071108,ECE 45,A01,083139,Congero; Spencer William,5,4,75,70
1656110077136,ECE 65,A50,083695,Saad; Andrew S,8,0,30,22
1656110077136,ECE 65,A51,095125,Staff,23,0,26,3
1656110083162,ECE 109,A01,091882,Touri; Behrouz,7,7,70,63
1656110089188,ECE 180,A00,083140,Abi Samra; Nicholas Camill,1,0,30,29
1656110089188,ECE 180,B00,083141,Abi Samra; Nicholas Camill,4,8,30,26
1656110095213,MATH 10A,A01,083735,Patchell; Gregory David,0,0,30,30
1656110095213,MATH 10A,A02,083736,Patchell; Gregory David,22,0,30,8
1656110095213,MATH 10A,A03,083737,Patchell; Gregory David,16,0,30,14
1656110101242,MATH 10B,A01,083207,Lim; Seonhee,3,3,34,31
1656110101242,MATH 10B,A02,083208,Lim; Seonhee,10,2,35,25
1656110101242,MATH 10B,A03,093472,Staff,4,3,34,30
1656110101242,MATH 10B,B01,083739,Sinha; Shubham,12,0,30,18
1656110107276,MATH 18,A01,083743,Cinel; Cameron Alexander,7,0,30,23
1656110107276,MATH 18,A02,083744,Cinel; Cameron Alexander,10,0,30,20
1656110107276,MATH 18,A03,083745,Cinel; Cameron Alexander,3,0,30,27
1656110107276,MATH 18,B01,083748,Ma; Zilu,0,0,36,36
1656110107276,MATH 18,B02,083749,Ma; Zilu,0,0,36,36
1656110107276,MATH 18,B03,083750,Ma; Zilu,0,0,36,36
1656110107276,MATH 18,B04,083751,Ma; Zilu,0,0,36,36
1656110107276,MATH 18,B05,093473,Staff,2,0,36,34
1656110107276,MATH 18,B06,093474,Staff,4,0,36,32
1656110113301,MATH 20A,A01,083754,Zheng; Zequn,11,0,40,29
1656110119329,MATH 20B,A01,083756,Briones; Jor-el Thomas Caparas,0,0,36,36
1656110119329,MATH 20B,A02,083757,Briones; Jor-el Thomas Caparas,0,0,36,36
1656110119329,MATH 20B,A03,093475,Staff,2,0,36,34
1656110125350,MATH 20C,A01,083760,Briones; Jor-el Thomas Caparas,2,2,35,33
1656110125350,MATH 20C,A02,083761,Briones; Jor-el Thomas Caparas,9,1,35,26
1656110125350,MATH 20C,A03,093476,Staff,1,1,35,34
1656110125350,MATH 20C,B01,083762,Bach; Quang Tran,1,0,30,29
1656110131374,MATH 20D,A01,083765,Tran; Brian Kha,2,0,30,28
1656110131374,MATH 20D,A02,083766,Tran; Brian Kha,0,1,30,30
1656110131374,MATH 20D,A03,083767,Tran; Brian Kha,2,0,30,28
1656110137400,MATH 20E,A01,083771,Ganguly; Soumya,4,1,32,28
1656110137400,MATH 20E,A02,083772,Ganguly; Soumya,2,2,32,30
1656110137400,MATH 20E,B01,083773,Ciotti; Benjamin,14,0,35,21
1656110137400,MATH 20E,B02,083774,Ciotti; Benjamin,14,0,35,21
1656110143429,MATH 103A,A01,083777,Greenfeld; Be'Eri,2,0,36,34
1656110143429,MATH 103A,A02,083778,Greenfeld; Be'Eri,2,0,36,34
1656110143429,MATH 103A,A03,093561,Staff,4,1,36,32
1656110143429,MATH 103A,B01,083779,Greenfeld; Be'Eri,8,1,36,28
1656110143429,MATH 103A,B02,083780,Greenfeld; Be'Eri,0,0,36,36
1656110143429,MATH 103A,B03,093562,Staff,0,0,36,36
1656110149454,MATH 105,A01,085443,Carter; Anne Toulson,4,1,35,31
1656110149454,MATH 105,A02,093477,Staff,9,0,35,26
1656110155477,MATH 109,A01,083213,Ganzberger; Geoffrey Michael,1,1,34,33
1656110155477,MATH 109,A02,083214,Ganzberger; Geoffrey Michael,0,0,34,34
1656110155477,MATH 109,A03,093478,Staff,1,0,34,33
1656110155477,MATH 109,B01,083215,Ganzberger; Geoffrey Michael,3,0,32,29
1656110155477,MATH 109,B02,083216,Ganzberger; Geoffrey Michael,1,0,32,31
1656110155477,MATH 109,B03,093479,Staff,4,0,32,28
1656110161504,MATH 142A,A01,083219,Chow; Bennett,1,0,32,31
1656110161504,MATH 142A,A02,083220,Chow; Bennett,8,0,32,24
1656110161504,MATH 142A,A03,093480,Staff,5,0,32,27
1656110161504,MATH 142A,B03,093481,Staff,4,0,32,28
1656110161504,MATH 142A,B04,093558,Staff,5,0,32,27
1656110161504,MATH 142A,B05,093559,Staff,0,0,32,32
1656110167525,MATH 193A,A01,083224,Rotar; Vladimir,1,2,34,33
1656110167525,MATH 193A,A02,083225,Rotar; Vladimir,1,0,34,33
1656110167525,MATH 193A,A03,083781,Rotar; Vladimir,1,0,34,33
1656110167525,MATH 193A,A04,083782,Rotar; Vladimir,6,0,34,28
1656110167525,MATH 193A,A05,093482,Rotar; Vladimir,1,0,34,33
1656110173546,MATH 197,001,091859,McAuley; Julian John,9999,0,9999,0
1656110173546,MATH 197,002,095566,Kedlaya; Kiran S.,9997,0,9999,2
1656110173546,MATH 197,003,095567,Xiao; Ming,9999,0,9999,0
1656110173546,MATH 197,004,095571,Perols; Johan Lars,9998,0,9999,1
1656110180619,COGS 9,A01,083615,Shannon; Kyle Michael,5,1,75,70
1656110186651,COGS 11,A01,083617,Boyle; Mary E. T.,16,2,48,32
1656110192684,COGS 13,A01,083071,Bastos; Amalia Pinkusfeld,8,3,71,63
1656110198707,COGS 14A,A01,092681,Semenuks; Arturs,8,24,100,92
1656110204731,COGS 14B,A01,083073,Cheng; Tzu-Han,7,0,63,56
1656110210763,COGS 17,A01,092677,Semenuks; Arturs,13,6,81,68
1656110216787,COGS 100,A01,083619,Allen; Michael Gordon,7,4,70,63
1656110222815,COGS 101A,A01,083621,Davis; Joshua Daniel,7,3,68,61
1656110228838,COGS 101B,A01,091572,Allen; Michael Gordon,6,0,65,59
1656110234860,COGS 101C,A01,083625,Delgado; Tania,11,0,35,24
1656110240883,COGS 107A,A01,083627,Boyle; Mary E. T.,5,4,60,55
1656110246915,COGS 118A,A01,083075,Gupta; Anjum,24,17,76,52
1656110252939,CSE 3,A50,083646,Miranda; Gregory Joseph,18,0,50,32
1656110258962,CSE 8A,A50,083650,Miranda; Gregory Joseph,13,12,56,43
1656110264986,CSE 11,A01,083080,Cao; Yingjun,1,60,40,39
1656110271012,CSE 12,A01,083652,Krause-Levy; Sophia Louisa,14,8,120,106
1656110277039,CSE 15L,A01,083654,Morris; Justin Loren,5,2,50,45
1656110277039,CSE 15L,A02,083655,Morris; Justin Loren,7,2,50,43
1656110283068,CSE 20,A01,083657,Tran; Khoa Dang,31,0,80,49
1656110289094,CSE 21,A01,095574,Bach; Quang Tran,26,0,48,22
1656110295116,CSE 30,A01,083084,Eldon; John,3,11,80,77
1656110295116,CSE 30,B01,095061,Bhaskar; Nishant,4,5,50,46
1656110301140,CSE 100,A01,083659,Cao; Yingjun,2,22,70,68
1656110307165,CSE 134B,A01,083661,Powell; Thomas Allan,10,8,100,90
1656110313192,CSE 140,A01,083663,Gungor; Onat,9,0,85,76
1656110319219,CSE 140L,A01,083088,Eldon; John,8,0,100,92
1656110325242,CSE 175,A01,083665,Kumar; Rakesh,0,0,25,25
1656110331271,CSE 190,A00,092507,Dubnov; Shlomo,2,0,20,18
1656110337295,ECE 45,A01,083139,Congero; Spencer William,5,4,75,70
1656110343325,ECE 65,A50,083695,Saad; Andrew S,8,0,30,22
1656110343325,ECE 65,A51,095125,Staff,23,0,26,3
1656110349348,ECE 109,A01,091882,Touri; Behrouz,7,7,70,63
1656110355376,ECE 180,A00,083140,Abi Samra; Nicholas Camill,1,0,30,29
1656110355376,ECE 180,B00,083141,Abi Samra; Nicholas Camill,4,8,30,26
1656110361400,MATH 10A,A01,083735,Patchell; Gregory David,0,0,30,30
1656110361400,MATH 10A,A02,083736,Patchell; Gregory David,22,0,30,8
1656110361400,MATH 10A,A03,083737,Patchell; Gregory David,16,0,30,14
1656110367440,MATH 10B,A01,083207,Lim; Seonhee,3,3,34,31
1656110367440,MATH 10B,A02,083208,Lim; Seonhee,10,2,35,25
1656110367440,MATH 10B,A03,093472,Staff,4,3,34,30
1656110367440,MATH 10B,B01,083739,Sinha; Shubham,12,0,30,18
1656110373472,MATH 18,A01,083743,Cinel; Cameron Alexander,7,0,30,23
1656110373472,MATH 18,A02,083744,Cinel; Cameron Alexander,10,0,30,20
1656110373472,MATH 18,A03,083745,Cinel; Cameron Alexander,3,0,30,27
1656110373472,MATH 18,B01,083748,Ma; Zilu,0,0,36,36
1656110373472,MATH 18,B02,083749,Ma; Zilu,0,0,36,36
1656110373472,MATH 18,B03,083750,Ma; Zilu,0,0,36,36
1656110373472,MATH 18,B04,083751,Ma; Zilu,0,0,36,36
1656110373472,MATH 18,B05,093473,Staff,2,0,36,34
1656110373472,MATH 18,B06,093474,Staff,4,0,36,32
1656110379502,MATH 20A,A01,083754,Zheng; Zequn,11,0,40,29
1656110385524,MATH 20B,A01,083756,Briones; Jor-el Thomas Caparas,0,0,36,36
1656110385524,MATH 20B,A02,083757,Briones; Jor-el Thomas Caparas,0,0,36,36
1656110385524,MATH 20B,A03,093475,Staff,2,0,36,34
1656110391547,MATH 20C,A01,083760,Briones; Jor-el Thomas Caparas,2,2,35,33
1656110391547,MATH 20C,A02,083761,Briones; Jor-el Thomas Caparas,9,1,35,26
1656110391547,MATH 20C,A03,093476,Staff,1,1,35,34
1656110391547,MATH 20C,B01,083762,Bach; Quang Tran,1,0,30,29
1656110397572,MATH 20D,A01,083765,Tran; Brian Kha,2,0,30,28
1656110397572,MATH 20D,A02,083766,Tran; Brian Kha,0,1,30,30
1656110397572,MATH 20D,A03,083767,Tran; Brian Kha,2,0,30,28
1656110403594,MATH 20E,A01,083771,Ganguly; Soumya,4,1,32,28
1656110403594,MATH 20E,A02,083772,Ganguly; Soumya,2,2,32,30
1656110403594,MATH 20E,B01,083773,Ciotti; Benjamin,14,0,35,21
1656110403594,MATH 20E,B02,083774,Ciotti; Benjamin,14,0,35,21
1656110409621,MATH 103A,A01,083777,Greenfeld; Be'Eri,2,0,36,34
1656110409621,MATH 103A,A02,083778,Greenfeld; Be'Eri,2,0,36,34
1656110409621,MATH 103A,A03,093561,Staff,4,1,36,32
1656110409621,MATH 103A,B01,083779,Greenfeld; Be'Eri,8,1,36,28
1656110409621,MATH 103A,B02,083780,Greenfeld; Be'Eri,0,0,36,36
1656110409621,MATH 103A,B03,093562,Staff,0,0,36,36
1656110415646,MATH 105,A01,085443,Carter; Anne Toulson,4,1,35,31
1656110415646,MATH 105,A02,093477,Staff,9,0,35,26
1656110421678,MATH 109,A01,083213,Ganzberger; Geoffrey Michael,1,1,34,33
1656110421678,MATH 109,A02,083214,Ganzberger; Geoffrey Michael,0,0,34,34
1656110421678,MATH 109,A03,093478,Staff,1,0,34,33
1656110421678,MATH 109,B01,083215,Ganzberger; Geoffrey Michael,3,0,32,29
1656110421678,MATH 109,B02,083216,Ganzberger; Geoffrey Michael,1,0,32,31
1656110421678,MATH 109,B03,093479,Staff,4,0,32,28
1656110427705,MATH 142A,A01,083219,Chow; Bennett,1,0,32,31
1656110427705,MATH 142A,A02,083220,Chow; Bennett,8,0,32,24
1656110427705,MATH 142A,A03,093480,Staff,5,0,32,27
1656110427705,MATH 142A,B03,093481,Staff,4,0,32,28
1656110427705,MATH 142A,B04,093558,Staff,5,0,32,27
1656110427705,MATH 142A,B05,093559,Staff,0,0,32,32
1656110433739,MATH 193A,A01,083224,Rotar; Vladimir,1,2,34,33
1656110433739,MATH 193A,A02,083225,Rotar; Vladimir,1,0,34,33
1656110433739,MATH 193A,A03,083781,Rotar; Vladimir,1,0,34,33
1656110433739,MATH 193A,A04,083782,Rotar; Vladimir,6,0,34,28
1656110433739,MATH 193A,A05,093482,Rotar; Vladimir,1,0,34,33
1656110439762,MATH 197,001,091859,McAuley; Julian John,9999,0,9999,0
1656110439762,MATH 197,002,095566,Kedlaya; Kiran S.,9997,0,9999,2
1656110439762,MATH 197,003,095567,Xiao; Ming,9999,0,9999,0
1656110439762,MATH 197,004,095571,Perols; Johan Lars,9998,0,9999,1
1656110446831,COGS 9,A01,083615,Shannon; Kyle Michael,5,1,75,70
1656110452860,COGS 11,A01,083617,Boyle; Mary E. T.,16,2,48,32
1656110458883,COGS 13,A01,083071,Bastos; Amalia Pinkusfeld,8,3,71,63
1656110464910,COGS 14A,A01,092681,Semenuks; Arturs,8,24,100,92
1656110470937,COGS 14B,A01,083073,Cheng; Tzu-Han,7,0,63,56
1656110476960,COGS 17,A01,092677,Semenuks; Arturs,13,6,81,68
1656110482987,COGS 100,A01,083619,Allen; Michael Gordon,7,4,70,63
1656110489022,COGS 101A,A01,083621,Davis; Joshua Daniel,7,3,68,61
1656110495058,COGS 101B,A01,091572,Allen; Michael Gordon,6,0,65,59
1656110501090,COGS 101C,A01,083625,Delgado; Tania,11,0,35,24
1656110507113,COGS 107A,A01,083627,Boyle; Mary E. T.,5,4,60,55
1656110513137,COGS 118A,A01,083075,Gupta; Anjum,24,17,76,52
1656110519160,CSE 3,A50,083646,Miranda; Gregory Joseph,18,0,50,32
1656110525276,CSE 8A,A50,083650,Miranda; Gregory Joseph,13,12,56,43
1656110531301,CSE 11,A01,083080,Cao; Yingjun,1,60,40,39
1656110537323,CSE 12,A01,083652,Krause-Levy; Sophia Louisa,14,8,120,106
1656110543350,CSE 15L,A01,083654,Morris; Justin Loren,5,2,50,45
1656110543350,CSE 15L,A02,083655,Morris; Justin Loren,7,2,50,43
1656110549378,CSE 20,A01,083657,Tran; Khoa Dang,31,0,80,49
1656110555400,CSE 21,A01,095574,Bach; Quang Tran,26,0,48,22
1656110561424,CSE 30,A01,083084,Eldon; John,3,11,80,77
1656110561424,CSE 30,B01,095061,Bhaskar; Nishant,4,5,50,46
1656110567451,CSE 100,A01,083659,Cao; Yingjun,2,22,70,68
1656110573474,CSE 134B,A01,083661,Powell; Thomas Allan,10,8,100,90
1656110579496,CSE 140,A01,083663,Gungor; Onat,9,0,85,76
1656110585528,CSE 140L,A01,083088,Eldon; John,8,0,100,92
1656110591552,CSE 175,A01,083665,Kumar; Rakesh,0,0,25,25
1656110597578,CSE 190,A00,092507,Dubnov; Shlomo,2,0,20,18
1656110603601,ECE 45,A01,083139,Congero; Spencer William,5,4,75,70
1656110609625,ECE 65,A50,083695,Saad; Andrew S,8,0,30,22
1656110609625,ECE 65,A51,095125,Staff,23,0,26,3
1656110615656,ECE 109,A01,091882,Touri; Behrouz,7,7,70,63
1656110621683,ECE 180,A00,083140,Abi Samra; Nicholas Camill,1,0,30,29
1656110621683,ECE 180,B00,083141,Abi Samra; Nicholas Camill,4,8,30,26
1656110627709,MATH 10A,A01,083735,Patchell; Gregory David,0,0,30,30
1656110627709,MATH 10A,A02,083736,Patchell; Gregory David,22,0,30,8
1656110627709,MATH 10A,A03,083737,Patchell; Gregory David,16,0,30,14
1656110633730,MATH 10B,A01,083207,Lim; Seonhee,3,3,34,31
1656110633730,MATH 10B,A02,083208,Lim; Seonhee,10,2,35,25
1656110633730,MATH 10B,A03,093472,Staff,4,3,34,30
1656110633730,MATH 10B,B01,083739,Sinha; Shubham,12,0,30,18
1656110639761,MATH 18,A01,083743,Cinel; Cameron Alexander,7,0,30,23
1656110639761,MATH 18,A02,083744,Cinel; Cameron Alexander,10,0,30,20
1656110639761,MATH 18,A03,083745,Cinel; Cameron Alexander,3,0,30,27
1656110639761,MATH 18,B01,083748,Ma; Zilu,0,0,36,36
1656110639761,MATH 18,B02,083749,Ma; Zilu,0,0,36,36
1656110639761,MATH 18,B03,083750,Ma; Zilu,0,0,36,36
1656110639761,MATH 18,B04,083751,Ma; Zilu,0,0,36,36
1656110639761,MATH 18,B05,093473,Staff,2,0,36,34
1656110639761,MATH 18,B06,093474,Staff,4,0,36,32
1656110645789,MATH 20A,A01,083754,Zheng; Zequn,11,0,40,29
1656110651814,MATH 20B,A01,083756,Briones; Jor-el Thomas Caparas,0,0,36,36
1656110651814,MATH 20B,A02,083757,Briones; Jor-el Thomas Caparas,0,0,36,36
1656110651814,MATH 20B,A03,093475,Staff,2,0,36,34
1656110657842,MATH 20C,A01,083760,Briones; Jor-el Thomas Caparas,2,2,35,33
1656110657842,MATH 20C,A02,083761,Briones; Jor-el Thomas Caparas,9,1,35,26
1656110657842,MATH 20C,A03,093476,Staff,1,1,35,34
1656110657842,MATH 20C,B01,083762,Bach; Quang Tran,1,0,30,29
1656110663867,MATH 20D,A01,083765,Tran; Brian Kha,2,0,30,28
1656110663867,MATH 20D,A02,083766,Tran; Brian Kha,0,1,30,30
1656110663867,MATH 20D,A03,083767,Tran; Brian Kha,2,0,30,28
1656110669890,MATH 20E,A01,083771,Ganguly; Soumya,4,1,32,28
1656110669890,MATH 20E,A02,083772,Ganguly; Soumya,2,2,32,30
1656110669890,MATH 20E,B01,083773,Ciotti; Benjamin,14,0,35,21
1656110669890,MATH 20E,B02,083774,Ciotti; Benjamin,14,0,35,21
1656110675918,MATH 103A,A01,083777,Greenfeld; Be'Eri,2,0,36,34
1656110675918,MATH 103A,A02,083778,Greenfeld; Be'Eri,2,0,36,34
1656110675918,MATH 103A,A03,093561,Staff,4,1,36,32
1656110675918,MATH 103A,B01,083779,Greenfeld; Be'Eri,8,1,36,28
1656110675918,MATH 103A,B02,083780,Greenfeld; Be'Eri,0,0,36,36
1656110675918,MATH 103A,B03,093562,Staff,0,0,36,36
1656110681941,MATH 105,A01,085443,Carter; Anne Toulson,4,1,35,31
1656110681941,MATH 105,A02,093477,Staff,9,0,35,26
1656110687964,MATH 109,A01,083213,Ganzberger; Geoffrey Michael,1,1,34,33
1656110687964,MATH 109,A02,083214,Ganzberger; Geoffrey Michael,0,0,34,34
1656110687964,MATH 109,A03,093478,Staff,1,0,34,33
1656110687964,MATH 109,B01,083215,Ganzberger; Geoffrey Michael,3,0,32,29
1656110687964,MATH 109,B02,083216,Ganzberger; Geoffrey Michael,1,0,32,31
1656110687964,MATH 109,B03,093479,Staff,4,0,32,28
1656110693996,MATH 142A,A01,083219,Chow; Bennett,1,0,32,31
1656110693996,MATH 142A,A02,083220,Chow; Bennett,8,0,32,24
1656110693996,MATH 142A,A03,093480,Staff,5,0,32,27
1656110693996,MATH 142A,B03,093481,Staff,4,0,32,28
1656110693996,MATH 142A,B04,093558,Staff,5,0,32,27
1656110693996,MATH 142A,B05,093559,Staff,0,0,32,32
1656110700020,MATH 193A,A01,083224,Rotar; Vladimir,1,2,34,33
1656110700020,MATH 193A,A02,083225,Rotar; Vladimir,1,0,34,33
1656110700020,MATH 193A,A03,083781,Rotar; Vladimir,1,0,34,33
1656110700020,MATH 193A,A04,083782,Rotar; Vladimir,6,0,34,28
1656110700020,MATH 193A,A05,093482,Rotar; Vladimir,1,0,34,33
1656110706047,MATH 197,001,091859,McAuley; Julian John,9999,0,9999,0
1656110706047,MATH 197,002,095566,Kedlaya; Kiran S.,9997,0,9999,2
1656110706047,MATH 197,003,095567,Xiao; Ming,9999,0,9999,0
1656110706047,MATH 197,004,095571,Perols; Johan Lars,9998,0,9999,1
1656110713122,COGS 9,A01,083615,Shannon; Kyle Michael,5,1,75,70
1656110719145,COGS 11,A01,083617,Boyle; Mary E. T.,16,2,48,32
1656110725189,COGS 13,A01,083071,Bastos; Amalia Pinkusfeld,8,3,71,63
1656110731212,COGS 14A,A01,092681,Semenuks; Arturs,8,24,100,92
1656110737239,COGS 14B,A01,083073,Cheng; Tzu-Han,7,0,63,56
1656110743271,COGS 17,A01,092677,Semenuks; Arturs,13,6,81,68
1656110749295,COGS 100,A01,083619,Allen; Michael Gordon,7,4,70,63
1656110755317,COGS 101A,A01,083621,Davis; Joshua Daniel,7,3,68,61
1656110761347,COGS 101B,A01,091572,Allen; Michael Gordon,6,0,65,59
1656110767372,COGS 101C,A01,083625,Delgado; Tania,11,0,35,24
1656110773398,COGS 107A,A01,083627,Boyle; Mary E. T.,5,4,60,55
1656110779419,COGS 118A,A01,083075,Gupta; Anjum,24,17,76,52
1656110785442,CSE 3,A50,083646,Miranda; Gregory Joseph,18,0,50,32
1656110791465,CSE 8A,A50,083650,Miranda; Gregory Joseph,13,12,56,43
1656110797492,CSE 11,A01,083080,Cao; Yingjun,1,59,40,39
1656110803519,CSE 12,A01,083652,Krause-Levy; Sophia Louisa,14,8,120,106
1656110809542,CSE 15L,A01,083654,Morris; Justin Loren,5,2,50,45
1656110809542,CSE 15L,A02,083655,Morris; Justin Loren,7,2,50,43
1656110815568,CSE 20,A01,083657,Tran; Khoa Dang,31,0,80,49
1656110821593,CSE 21,A01,095574,Bach; Quang Tran,26,0,48,22
1656110827620,CSE 30,A01,083084,Eldon; John,3,11,80,77
1656110827620,CSE 30,B01,095061,Bhaskar; Nishant,4,5,50,46
1656110833643,CSE 100,A01,083659,Cao; Yingjun,2,22,70,68
1656110839666,CSE 134B,A01,083661,Powell; Thomas Allan,10,8,100,90
1656110845693,CSE 140,A01,083663,Gungor; Onat,9,0,85,76
1656110851716,CSE 140L,A01,083088,Eldon; John,8,0,100,92
1656110857738,CSE 175,A01,083665,Kumar; Rakesh,0,0,25,25
1656110863765,CSE 190,A00,092507,Dubnov; Shlomo,2,0,20,18
1656110869788,ECE 45,A01,083139,Congero; Spencer William,5,4,75,70
1656110875816,ECE 65,A50,083695,Saad; Andrew S,8,0,30,22
1656110875816,ECE 65,A51,095125,Staff,23,0,26,3
1656110881843,ECE 109,A01,091882,Touri; Behrouz,7,7,70,63
1656110887870,ECE 180,A00,083140,Abi Samra; Nicholas Camill,1,0,30,29
1656110887870,ECE 180,B00,083141,Abi Samra; Nicholas Camill,4,8,30,26
1656110893898,MATH 10A,A01,083735,Patchell; Gregory David,0,0,30,30
1656110893898,MATH 10A,A02,083736,Patchell; Gregory David,22,0,30,8
1656110893898,MATH 10A,A03,083737,Patchell; Gregory David,16,0,30,14
1656110899922,MATH 10B,A01,083207,Lim; Seonhee,3,3,34,31
1656110899922,MATH 10B,A02,083208,Lim; Seonhee,10,2,35,25
1656110899922,MATH 10B,A03,093472,Staff,4,3,34,30
1656110899922,MATH 10B,B01,083739,Sinha; Shubham,12,0,30,18
1656110905954,MATH 18,A01,083743,Cinel; Cameron Alexander,7,0,30,23
1656110905954,MATH 18,A02,083744,Cinel; Cameron Alexander,10,0,30,20
1656110905954,MATH 18,A03,083745,Cinel; Cameron Alexander,3,0,30,27
1656110905954,MATH 18,B01,083748,Ma; Zilu,0,0,36,36
1656110905954,MATH 18,B02,083749,Ma; Zilu,0,0,36,36
1656110905954,MATH 18,B03,083750,Ma; Zilu,0,0,36,36
1656110905954,MATH 18,B04,083751,Ma; Zilu,0,0,36,36
1656110905954,MATH 18,B05,093473,Staff,2,0,36,34
1656110905954,MATH 18,B06,093474,Staff,4,0,36,32
1656110911989,MATH 20A,A01,083754,Zheng; Zequn,11,0,40,29
1656110918013,MATH 20B,A01,083756,Briones; Jor-el Thomas Caparas,0,0,36,36
1656110918013,MATH 20B,A02,083757,Briones; Jor-el Thomas Caparas,0,0,36,36
1656110918013,MATH 20B,A03,093475,Staff,2,0,36,34
1656110924040,MATH 20C,A01,083760,Briones; Jor-el Thomas Caparas,2,2,35,33
1656110924040,MATH 20C,A02,083761,Briones; Jor-el Thomas Caparas,9,1,35,26
1656110924040,MATH 20C,A03,093476,Staff,1,1,35,34
1656110924040,MATH 20C,B01,083762,Bach; Quang Tran,1,0,30,29
1656110930067,MATH 20D,A01,083765,Tran; Brian Kha,2,0,30,28
1656110930067,MATH 20D,A02,083766,Tran; Brian Kha,0,1,30,30
1656110930067,MATH 20D,A03,083767,Tran; Brian Kha,2,0,30,28
1656110936095,MATH 20E,A01,083771,Ganguly; Soumya,4,1,32,28
1656110936095,MATH 20E,A02,083772,Ganguly; Soumya,2,2,32,30
1656110936095,MATH 20E,B01,083773,Ciotti; Benjamin,14,0,35,21
1656110936095,MATH 20E,B02,083774,Ciotti; Benjamin,14,0,35,21
1656110942118,MATH 103A,A01,083777,Greenfeld; Be'Eri,2,0,36,34
1656110942118,MATH 103A,A02,083778,Greenfeld; Be'Eri,2,0,36,34
1656110942118,MATH 103A,A03,093561,Staff,4,1,36,32
1656110942118,MATH 103A,B01,083779,Greenfeld; Be'Eri,8,1,36,28
1656110942118,MATH 103A,B02,083780,Greenfeld; Be'Eri,0,0,36,36
1656110942118,MATH 103A,B03,093562,Staff,0,0,36,36
1656110948140,MATH 105,A01,085443,Carter; Anne Toulson,4,1,35,31
1656110948140,MATH 105,A02,093477,Staff,9,0,35,26
1656110954167,MATH 109,A01,083213,Ganzberger; Geoffrey Michael,1,1,34,33
1656110954167,MATH 109,A02,083214,Ganzberger; Geoffrey Michael,0,0,34,34
1656110954167,MATH 109,A03,093478,Staff,1,0,34,33
1656110954167,MATH 109,B01,083215,Ganzberger; Geoffrey Michael,3,0,32,29
1656110954167,MATH 109,B02,083216,Ganzberger; Geoffrey Michael,1,0,32,31
1656110954167,MATH 109,B03,093479,Staff,4,0,32,28
1656110960195,MATH 142A,A01,083219,Chow; Bennett,1,0,32,31
1656110960195,MATH 142A,A02,083220,Chow; Bennett,8,0,32,24
1656110960195,MATH 142A,A03,093480,Staff,5,0,32,27
1656110960195,MATH 142A,B03,093481,Staff,4,0,32,28
1656110960195,MATH 142A,B04,093558,Staff,5,0,32,27
1656110960195,MATH 142A,B05,093559,Staff,0,0,32,32
1656110966218,MATH 193A,A01,083224,Rotar; Vladimir,1,2,34,33
1656110966218,MATH 193A,A02,083225,Rotar; Vladimir,1,0,34,33
1656110966218,MATH 193A,A03,083781,Rotar; Vladimir,1,0,34,33
1656110966218,MATH 193A,A04,083782,Rotar; Vladimir,6,0,34,28
1656110966218,MATH 193A,A05,093482,Rotar; Vladimir,1,0,34,33
1656110972246,MATH 197,001,091859,McAuley; Julian John,9999,0,9999,0
1656110972246,MATH 197,002,095566,Kedlaya; Kiran S.,9997,0,9999,2
1656110972246,MATH 197,003,095567,Xiao; Ming,9999,0,9999,0
1656110972246,MATH 197,004,095571,Perols; Johan Lars,9998,0,9999,1
1656110979306,COGS 9,A01,083615,Shannon; Kyle Michael,5,1,75,70
1656110985333,COGS 11,A01,083617,Boyle; Mary E. T.,16,2,48,32
1656110991356,COGS 13,A01,083071,Bastos; Amalia Pinkusfeld,8,3,71,63
1656110997384,COGS 14A,A01,092681,Semenuks; Arturs,8,25,100,92
1656111003421,COGS 14B,A01,083073,Cheng; Tzu-Han,7,0,63,56
1656111009444,COGS 17,A01,092677,Semenuks; Arturs,13,6,81,68
1656111015470,COGS 100,A01,083619,Allen; Michael Gordon,7,4,70,63
1656111021494,COGS 101A,A01,083621,Davis; Joshua Daniel,7,3,68,61
1656111027519,COGS 101B,A01,091572,Allen; Michael Gordon,6,0,65,59
1656111033542,COGS 101C,A01,083625,Delgado; Tania,11,0,35,24
1656111039583,COGS 107A,A01,083627,Boyle; Mary E. T.,5,4,60,55
1656111045606,COGS 118A,A01,083075,Gupta; Anjum,24,17,76,52
1656111051634,CSE 3,A50,083646,Miranda; Gregory Joseph,18,0,50,32
1656111057671,CSE 8A,A50,083650,Miranda; Gregory Joseph,13,12,56,43
1656111063700,CSE 11,A01,083080,Cao; Yingjun,1,59,40,39
1656111069722,CSE 12,A01,083652,Krause-Levy; Sophia Louisa,14,8,120,106
1656111075751,CSE 15L,A01,083654,Morris; Justin Loren,5,2,50,45
1656111075751,CSE 15L,A02,083655,Morris; Justin Loren,7,2,50,43
1656111081778,CSE 20,A01,083657,Tran; Khoa Dang,31,0,80,49
1656111087805,CSE 21,A01,095574,Bach; Quang Tran,26,0,48,22
1656111093829,CSE 30,A01,083084,Eldon; John,3,11,80,77
1656111093829,CSE 30,B01,095061,Bhaskar; Nishant,4,5,50,46
1656111099855,CSE 100,A01,083659,Cao; Yingjun,2,22,70,68
1656111105879,CSE 134B,A01,083661,Powell; Thomas Allan,10,8,100,90
1656111111907,CSE 140,A01,083663,Gungor; Onat,9,0,85,76
1656111117931,CSE 140L,A01,083088,Eldon; John,8,0,100,92
1656111124048,CSE 175,A01,083665,Kumar; Rakesh,0,0,25,25
1656111130072,CSE 190,A00,092507,Dubnov; Shlomo,2,0,20,18
1656111136098,ECE 45,A01,083139,Congero; Spencer William,5,4,75,70
1656111142122,ECE 65,A50,083695,Saad; Andrew S,8,0,30,22
1656111142122,ECE 65,A51,095125,Staff,23,0,26,3
1656111148145,ECE 109,A01,091882,Touri; Behrouz,7,7,70,63
1656111154171,ECE 180,A00,083140,Abi Samra; Nicholas Camill,1,0,30,29
1656111154171,ECE 180,B00,083141,Abi Samra; Nicholas Camill,4,8,30,26
1656111160193,MATH 10A,A01,083735,Patchell; Gregory David,0,0,30,30
1656111160193,MATH 10A,A02,083736,Patchell; Gregory David,22,0,30,8
1656111160193,MATH 10A,A03,083737,Patchell; Gregory David,16,0,30,14
1656111166228,MATH 10B,A01,083207,Lim; Seonhee,3,3,34,31
1656111166228,MATH 10B,A02,083208,Lim; Seonhee,10,2,35,25
1656111166228,MATH 10B,A03,093472,Staff,4,3,34,30
1656111166228,MATH 10B,B01,083739,Sinha; Shubham,12,0,30,18
1656111172258,MATH 18,A01,083743,Cinel; Cameron Alexander,7,0,30,23
1656111172258,MATH 18,A02,083744,Cinel; Cameron Alexander,10,0,30,20
1656111172258,MATH 18,A03,083745,Cinel; Cameron Alexander,3,0,30,27
1656111172258,MATH 18,B01,083748,Ma; Zilu,0,0,36,36
1656111172258,MATH 18,B02,083749,Ma; Zilu,0,0,36,36
1656111172258,MATH 18,B03,083750,Ma; Zilu,0,0,36,36
1656111172258,MATH 18,B04,083751,Ma; Zilu,0,0,36,36
1656111172258,MATH 18,B05,093473,Staff,2,0,36,34
1656111172258,MATH 18,B06,093474,Staff,4,0,36,32
1656111178285,MATH 20A,A01,083754,Zheng; Zequn,11,0,40,29
1656111184312,MATH 20B,A01,083756,Briones; Jor-el Thomas Caparas,0,0,36,36
1656111184312,MATH 20B,A02,083757,Briones; Jor-el Thomas Caparas,0,0,36,36
1656111184312,MATH 20B,A03,093475,Staff,2,0,36,34
1656111190342,MATH 20C,A01,083760,Briones; Jor-el Thomas Caparas,2,2,35,33
1656111190342,MATH 20C,A02,083761,Briones; Jor-el Thomas Caparas,9,1,35,26
1656111190342,MATH 20C,A03,093476,Staff,1,1,35,34
1656111190342,MATH 20C,B01,083762,Bach; Quang Tran,1,0,30,29
1656111196365,MATH 20D,A01,083765,Tran; Brian Kha,2,0,30,28
1656111196365,MATH 20D,A02,083766,Tran; Brian Kha,0,1,30,30
1656111196365,MATH 20D,A03,083767,Tran; Brian Kha,2,0,30,28
1656111202393,MATH 20E,A01,083771,Ganguly; Soumya,4,1,32,28
1656111202393,MATH 20E,A02,083772,Ganguly; Soumya,2,2,32,30
1656111202393,MATH 20E,B01,083773,Ciotti; Benjamin,14,0,35,21
1656111202393,MATH 20E,B02,083774,Ciotti; Benjamin,14,0,35,21
1656111208422,MATH 103A,A01,083777,Greenfeld; Be'Eri,2,0,36,34
1656111208422,MATH 103A,A02,083778,Greenfeld; Be'Eri,2,0,36,34
1656111208422,MATH 103A,A03,093561,Staff,4,1,36,32
1656111208422,MATH 103A,B01,083779,Greenfeld; Be'Eri,8,1,36,28
1656111208422,MATH 103A,B02,083780,Greenfeld; Be'Eri,0,0,36,36
1656111208422,MATH 103A,B03,093562,Staff,0,0,36,36
1656111214453,MATH 105,A01,085443,Carter; Anne Toulson,4,1,35,31
1656111214453,MATH 105,A02,093477,Staff,9,0,35,26
1656111220480,MATH 109,A01,083213,Ganzberger; Geoffrey Michael,1,1,34,33
1656111220480,MATH 109,A02,083214,Ganzberger; Geoffrey Michael,0,0,34,34
1656111220480,MATH 109,A03,093478,Staff,1,0,34,33
1656111220480,MATH 109,B01,083215,Ganzberger; Geoffrey Michael,3,0,32,29
1656111220480,MATH 109,B02,083216,Ganzberger; Geoffrey Michael,1,0,32,31
1656111220480,MATH 109,B03,093479,Staff,4,0,32,28
1656111226503,MATH 142A,A01,083219,Chow; Bennett,1,0,32,31
1656111226503,MATH 142A,A02,083220,Chow; Bennett,8,0,32,24
1656111226503,MATH 142A,A03,093480,Staff,5,0,32,27
1656111226503,MATH 142A,B03,093481,Staff,4,0,32,28
1656111226503,MATH 142A,B04,093558,Staff,5,0,32,27
1656111226503,MATH 142A,B05,093559,Staff,0,0,32,32
1656111232531,MATH 193A,A01,083224,Rotar; Vladimir,1,2,34,33
1656111232531,MATH 193A,A02,083225,Rotar; Vladimir,1,0,34,33
1656111232531,MATH 193A,A03,083781,Rotar; Vladimir,1,0,34,33
1656111232531,MATH 193A,A04,083782,Rotar; Vladimir,6,0,34,28
1656111232531,MATH 193A,A05,093482,Rotar; Vladimir,1,0,34,33
1656111238553,MATH 197,001,091859,McAuley; Julian John,9999,0,9999,0
1656111238553,MATH 197,002,095566,Kedlaya; Kiran S.,9997,0,9999,2
1656111238553,MATH 197,003,095567,Xiao; Ming,9999,0,9999,0
1656111238553,MATH 197,004,095571,Perols; Johan Lars,9998,0,9999,1
1656111245609,COGS 9,A01,083615,Shannon; Kyle Michael,5,1,75,70
1656111251635,COGS 11,A01,083617,Boyle; Mary E. T.,16,2,48,32
1656111257659,COGS 13,A01,083071,Bastos; Amalia Pinkusfeld,8,3,71,63
1656111263683,COGS 14A,A01,092681,Semenuks; Arturs,8,25,100,92
1656111269710,COGS 14B,A01,083073,Cheng; Tzu-Han,7,0,63,56
1656111275735,COGS 17,A01,092677,Semenuks; Arturs,13,6,81,68
1656111281757,COGS 100,A01,083619,Allen; Michael Gordon,7,4,70,63
1656111287784,COGS 101A,A01,083621,Davis; Joshua Daniel,7,3,68,61
1656111293810,COGS 101B,A01,091572,Allen; Michael Gordon,6,0,65,59
1656111299835,COGS 101C,A01,083625,Delgado; Tania,11,0,35,24
1656111305859,COGS 107A,A01,083627,Boyle; Mary E. T.,5,4,60,55
1656111311891,COGS 118A,A01,083075,Gupta; Anjum,24,17,76,52
1656111317920,CSE 3,A50,083646,Miranda; Gregory Joseph,18,0,50,32
1656111323943,CSE 8A,A50,083650,Miranda; Gregory Joseph,13,12,56,43
1656111329973,CSE 11,A01,083080,Cao; Yingjun,1,59,40,39
1656111336000,CSE 12,A01,083652,Krause-Levy; Sophia Louisa,14,8,120,106
1656111342025,CSE 15L,A01,083654,Morris; Justin Loren,5,2,50,45
1656111342025,CSE 15L,A02,083655,Morris; Justin Loren,7,2,50,43
1656111348048,CSE 20,A01,083657,Tran; Khoa Dang,31,0,80,49
1656111354075,CSE 21,A01,095574,Bach; Quang Tran,25,0,48,23
1656111360103,CSE 30,A01,083084,Eldon; John,3,11,80,77
1656111360103,CSE 30,B01,095061,Bhaskar; Nishant,4,5,50,46
1656111366132,CSE 100,A01,083659,Cao; Yingjun,2,22,70,68
1656111372175,CSE 134B,A01,083661,Powell; Thomas Allan,10,8,100,90
1656111378210,CSE 140,A01,083663,Gungor; Onat,9,0,85,76
1656111384233,CSE 140L,A01,083088,Eldon; John,8,0,100,92
1656111390257,CSE 175,A01,083665,Kumar; Rakesh,0,0,25,25
1656111396283,CSE 190,A00,092507,Dubnov; Shlomo,2,0,20,18
1656111402307,ECE 45,A01,083139,Congero; Spencer William,5,4,75,70
1656111408331,ECE 65,A50,083695,Saad; Andrew S,8,0,30,22
1656111408331,ECE 65,A51,095125,Staff,23,0,26,3
1656111414357,ECE 109,A01,091882,Touri; Behrouz,7,7,70,63
1656111420389,ECE 180,A00,083140,Abi Samra; Nicholas Camill,1,0,30,29
1656111420389,ECE 180,B00,083141,Abi Samra; Nicholas Camill,4,8,30,26
1656111426416,MATH 10A,A01,083735,Patchell; Gregory David,0,0,30,30
1656111426416,MATH 10A,A02,083736,Patchell; Gregory David,22,0,30,8
1656111426416,MATH 10A,A03,083737,Patchell; Gregory David,16,0,30,14
1656111432447,MATH 10B,A01,083207,Lim; Seonhee,3,3,34,31
1656111432447,MATH 10B,A02,083208,Lim; Seonhee,10,2,35,25
1656111432447,MATH 10B,A03,093472,Staff,4,3,34,30
1656111432447,MATH 10B,B01,083739,Sinha; Shubham,12,0,30,18
1656111438472,MATH 18,A01,083743,Cinel; Cameron Alexander,7,0,30,23
1656111438472,MATH 18,A02,083744,Cinel; Cameron Alexander,10,0,30,20
1656111438472,MATH 18,A03,083745,Cinel; Cameron Alexander,3,0,30,27
1656111438472,MATH 18,B01,083748,Ma; Zilu,0,0,36,36
1656111438472,MATH 18,B02,083749,Ma; Zilu,0,0,36,36
1656111438472,MATH 18,B03,083750,Ma; Zilu,0,0,36,36
1656111438472,MATH 18,B04,083751,Ma; Zilu,0,0,36,36
1656111438472,MATH 18,B05,093473,Staff,2,0,36,34
1656111438472,MATH 18,B06,093474,Staff,4,0,36,32
1656111444495,MATH 20A,A01,083754,Zheng; Zequn,11,0,40,29
1656111450523,MATH 20B,A01,083756,Briones; Jor-el Thomas Caparas,0,0,36,36
1656111450523,MATH 20B,A02,083757,Briones; Jor-el Thomas Caparas,0,0,36,36
1656111450523,MATH 20B,A03,093475,Staff,2,0,36,34
1656111456548,MATH 20C,A01,083760,Briones; Jor-el Thomas Caparas,2,2,35,33
1656111456548,MATH 20C,A02,083761,Briones; Jor-el Thomas Caparas,9,1,35,26
1656111456548,MATH 20C,A03,093476,Staff,1,1,35,34
1656111456548,MATH 20C,B01,083762,Bach; Quang Tran,1,0,30,29
1656111462572,MATH 20D,A01,083765,Tran; Brian Kha,2,0,30,28
1656111462572,MATH 20D,A02,083766,Tran; Brian Kha,0,1,30,30
1656111462572,MATH 20D,A03,083767,Tran; Brian Kha,2,0,30,28
1656111468597,MATH 20E,A01,083771,Ganguly; Soumya,4,1,32,28
1656111468597,MATH 20E,A02,083772,Ganguly; Soumya,2,2,32,30
1656111468597,MATH 20E,B01,083773,Ciotti; Benjamin,14,0,35,21
1656111468597,MATH 20E,B02,083774,Ciotti; Benjamin,14,0,35,21
1656111474628,MATH 103A,A01,083777,Greenfeld; Be'Eri,2,0,36,34
1656111474628,MATH 103A,A02,083778,Greenfeld; Be'Eri,2,0,36,34
1656111474628,MATH 103A,A03,093561,Staff,4,1,36,32
1656111474628,MATH 103A,B01,083779,Greenfeld; Be'Eri,8,1,36,28
1656111474628,MATH 103A,B02,083780,Greenfeld; Be'Eri,0,0,36,36
1656111474628,MATH 103A,B03,093562,Staff,0,0,36,36
1656111480656,MATH 105,A01,085443,Carter; Anne Toulson,4,1,35,31
1656111480656,MATH 105,A02,093477,Staff,9,0,35,26
1656111486679,MATH 109,A01,083213,Ganzberger; Geoffrey Michael,1,1,34,33
1656111486679,MATH 109,A02,083214,Ganzberger; Geoffrey Michael,0,0,34,34
1656111486679,MATH 109,A03,093478,Staff,1,0,34,33
1656111486679,MATH 109,B01,083215,Ganzberger; Geoffrey Michael,3,0,32,29
1656111486679,MATH 109,B02,083216,Ganzberger; Geoffrey Michael,1,0,32,31
1656111486679,MATH 109,B03,093479,Staff,4,0,32,28
1656111492721,MATH 142A,A01,083219,Chow; Bennett,1,0,32,31
1656111492721,MATH 142A,A02,083220,Chow; Bennett,8,0,32,24
1656111492721,MATH 142A,A03,093480,Staff,5,0,32,27
1656111492721,MATH 142A,B03,093481,Staff,4,0,32,28
1656111492721,MATH 142A,B04,093558,Staff,5,0,32,27
1656111492721,MATH 142A,B05,093559,Staff,0,0,32,32
1656111498754,MATH 193A,A01,083224,Rotar; Vladimir,1,2,34,33
1656111498754,MATH 193A,A02,083225,Rotar; Vladimir,1,0,34,33
1656111498754,MATH 193A,A03,083781,Rotar; Vladimir,1,0,34,33
1656111498754,MATH 193A,A04,083782,Rotar; Vladimir,6,0,34,28
1656111498754,MATH 193A,A05,093482,Rotar; Vladimir,1,0,34,33
1656111504779,MATH 197,001,091859,McAuley; Julian John,9999,0,9999,0
1656111504779,MATH 197,002,095566,Kedlaya; Kiran S.,9997,0,9999,2
1656111504779,MATH 197,003,095567,Xiao; Ming,9999,0,9999,0
1656111504779,MATH 197,004,095571,Perols; Johan Lars,9998,0,9999,1
1656111511836,COGS 9,A01,083615,Shannon; Kyle Michael,5,1,75,70
1656111517860,COGS 11,A01,083617,Boyle; Mary E. T.,16,2,48,32
1656111523889,COGS 13,A01,083071,Bastos; Amalia Pinkusfeld,8,3,71,63
1656111529912,COGS 14A,A01,092681,Semenuks; Arturs,8,25,100,92
1656111535942,COGS 14B,A01,083073,Cheng; Tzu-Han,7,0,63,56
1656111541965,COGS 17,A01,092677,Semenuks; Arturs,13,6,81,68
1656111547996,COGS 100,A01,083619,Allen; Michael Gordon,7,4,70,63
1656111554021,COGS 101A,A01,083621,Davis; Joshua Daniel,7,3,68,61
1656111560054,COGS 101B,A01,091572,Allen; Michael Gordon,6,0,65,59
1656111566078,COGS 101C,A01,083625,Delgado; Tania,11,0,35,24
1656111572143,COGS 107A,A01,083627,Boyle; Mary E. T.,5,4,60,55
1656111578172,COGS 118A,A01,083075,Gupta; Anjum,24,17,76,52
1656111584197,CSE 3,A50,083646,Miranda; Gregory Joseph,18,0,50,32
1656111590236,CSE 8A,A50,083650,Miranda; Gregory Joseph,13,12,56,43
1656111596263,CSE 11,A01,083080,Cao; Yingjun,1,59,40,39
1656111602287,CSE 12,A01,083652,Krause-Levy; Sophia Louisa,14,8,120,106
1656111608316,CSE 15L,A01,083654,Morris; Justin Loren,5,2,50,45
1656111608316,CSE 15L,A02,083655,Morris; Justin Loren,7,2,50,43
1656111614342,CSE 20,A01,083657,Tran; Khoa Dang,31,0,80,49
1656111620374,CSE 21,A01,095574,Bach; Quang Tran,25,0,48,23
1656111626399,CSE 30,A01,083084,Eldon; John,3,11,80,77
1656111626399,CSE 30,B01,095061,Bhaskar; Nishant,4,5,50,46
1656111632422,CSE 100,A01,083659,Cao; Yingjun,2,22,70,68
1656111638452,CSE 134B,A01,083661,Powell; Thomas Allan,10,8,100,90
1656111644483,CSE 140,A01,083663,Gungor; Onat,9,0,85,76
1656111650509,CSE 140L,A01,083088,Eldon; John,8,0,100,92
1656111656533,CSE 175,A01,083665,Kumar; Rakesh,0,0,25,25
1656111662569,CSE 190,A00,092507,Dubnov; Shlomo,2,0,20,18
1656111668602,ECE 45,A01,083139,Congero; Spencer William,5,4,75,70
1656111674642,ECE 65,A50,083695,Saad; Andrew S,8,0,30,22
1656111674642,ECE 65,A51,095125,Staff,23,0,26,3
1656111680663,ECE 109,A01,091882,Touri; Behrouz,7,7,70,63
1656111686688,ECE 180,A00,083140,Abi Samra; Nicholas Camill,1,0,30,29
1656111686688,ECE 180,B00,083141,Abi Samra; Nicholas Camill,4,8,30,26
1656111692719,MATH 10A,A01,083735,Patchell; Gregory David,0,0,30,30
1656111692719,MATH 10A,A02,083736,Patchell; Gregory David,22,0,30,8
1656111692719,MATH 10A,A03,083737,Patchell; Gregory David,16,0,30,14
1656111698743,MATH 10B,A01,083207,Lim; Seonhee,3,3,34,31
1656111698743,MATH 10B,A02,083208,Lim; Seonhee,10,2,35,25
1656111698743,MATH 10B,A03,093472,Staff,4,3,34,30
1656111698743,MATH 10B,B01,083739,Sinha; Shubham,12,0,30,18
1656111704768,MATH 18,A01,083743,Cinel; Cameron Alexander,7,0,30,23
1656111704768,MATH 18,A02,083744,Cinel; Cameron Alexander,10,0,30,20
1656111704768,MATH 18,A03,083745,Cinel; Cameron Alexander,3,0,30,27
1656111704768,MATH 18,B01,083748,Ma; Zilu,0,0,36,36
1656111704768,MATH 18,B02,083749,Ma; Zilu,0,0,36,36
1656111704768,MATH 18,B03,083750,Ma; Zilu,0,0,36,36
1656111704768,MATH 18,B04,083751,Ma; Zilu,0,0,36,36
1656111704768,MATH 18,B05,093473,Staff,2,0,36,34
1656111704768,MATH 18,B06,093474,Staff,4,0,36,32
1656111710790,MATH 20A,A01,083754,Zheng; Zequn,11,0,40,29
1656111716821,MATH 20B,A01,083756,Briones; Jor-el Thomas Caparas,0,0,36,36
1656111716821,MATH 20B,A02,083757,Briones; Jor-el Thomas Caparas,0,0,36,36
1656111716821,MATH 20B,A03,093475,Staff,2,0,36,34
1656111722919,MATH 20C,A01,083760,Briones; Jor-el Thomas Caparas,2,2,35,33
1656111722919,MATH 20C,A02,083761,Briones; Jor-el Thomas Caparas,9,1,35,26
1656111722919,MATH 20C,A03,093476,Staff,1,1,35,34
1656111722919,MATH 20C,B01,083762,Bach; Quang Tran,1,0,30,29
1656111728950,MATH 20D,A01,083765,Tran; Brian Kha,2,0,30,28
1656111728950,MATH 20D,A02,083766,Tran; Brian Kha,0,1,30,30
1656111728950,MATH 20D,A03,083767,Tran; Brian Kha,2,0,30,28
1656111734980,MATH 20E,A01,083771,Ganguly; Soumya,4,1,32,28
1656111734980,MATH 20E,A02,083772,Ganguly; Soumya,2,2,32,30
1656111734980,MATH 20E,B01,083773,Ciotti; Benjamin,14,0,35,21
1656111734980,MATH 20E,B02,083774,Ciotti; Benjamin,14,0,35,21
1656111741010,MATH 103A,A01,083777,Greenfeld; Be'Eri,2,0,36,34
1656111741010,MATH 103A,A02,083778,Greenfeld; Be'Eri,2,0,36,34
1656111741010,MATH 103A,A03,093561,Staff,4,1,36,32
1656111741010,MATH 103A,B01,083779,Greenfeld; Be'Eri,8,1,36,28
1656111741010,MATH 103A,B02,083780,Greenfeld; Be'Eri,0,0,36,36
1656111741010,MATH 103A,B03,093562,Staff,0,0,36,36
1656111747032,MATH 105,A01,085443,Carter; Anne Toulson,4,1,35,31
1656111747032,MATH 105,A02,093477,Staff,9,0,35,26
1656111753068,MATH 109,A01,083213,Ganzberger; Geoffrey Michael,1,1,34,33
1656111753068,MATH 109,A02,083214,Ganzberger; Geoffrey Michael,0,0,34,34
1656111753068,MATH 109,A03,093478,Staff,1,0,34,33
1656111753068,MATH 109,B01,083215,Ganzberger; Geoffrey Michael,3,0,32,29
1656111753068,MATH 109,B02,083216,Ganzberger; Geoffrey Michael,1,0,32,31
1656111753068,MATH 109,B03,093479,Staff,4,0,32,28
1656111759103,MATH 142A,A01,083219,Chow; Bennett,1,0,32,31
1656111759103,MATH 142A,A02,083220,Chow; Bennett,8,0,32,24
1656111759103,MATH 142A,A03,093480,Staff,5,0,32,27
1656111759103,MATH 142A,B03,093481,Staff,4,0,32,28
1656111759103,MATH 142A,B04,093558,Staff,5,0,32,27
1656111759103,MATH 142A,B05,093559,Staff,0,0,32,32
1656111765137,MATH 193A,A01,083224,Rotar; Vladimir,1,2,34,33
1656111765137,MATH 193A,A02,083225,Rotar; Vladimir,1,0,34,33
1656111765137,MATH 193A,A03,083781,Rotar; Vladimir,1,0,34,33
1656111765137,MATH 193A,A04,083782,Rotar; Vladimir,6,0,34,28
1656111765137,MATH 193A,A05,093482,Rotar; Vladimir,1,0,34,33
1656111771162,MATH 197,001,091859,McAuley; Julian John,9999,0,9999,0
1656111771162,MATH 197,002,095566,Kedlaya; Kiran S.,9997,0,9999,2
1656111771162,MATH 197,003,095567,Xiao; Ming,9999,0,9999,0
1656111771162,MATH 197,004,095571,Perols; Johan Lars,9998,0,9999,1
1656111778217,COGS 9,A01,083615,Shannon; Kyle Michael,5,1,75,70
1656111784255,COGS 11,A01,083617,Boyle; Mary E. T.,16,2,48,32
1656111790279,COGS 13,A01,083071,Bastos; Amalia Pinkusfeld,8,3,71,63
1656111796305,COGS 14A,A01,092681,Semenuks; Arturs,8,25,100,92
1656111802327,COGS 14B,A01,083073,Cheng; Tzu-Han,7,0,63,56
1656111808352,COGS 17,A01,092677,Semenuks; Arturs,13,6,81,68
1656111814373,COGS 100,A01,083619,Allen; Michael Gordon,7,4,70,63
1656111820400,COGS 101A,A01,083621,Davis; Joshua Daniel,7,3,68,61
1656111826423,COGS 101B,A01,091572,Allen; Michael Gordon,6,0,65,59
1656111832447,COGS 101C,A01,083625,Delgado; Tania,11,0,35,24
1656111838468,COGS 107A,A01,083627,Boyle; Mary E. T.,5,4,60,55
1656111844489,COGS 118A,A01,083075,Gupta; Anjum,24,17,76,52
1656111850517,CSE 3,A50,083646,Miranda; Gregory Joseph,18,0,50,32
1656111856540,CSE 8A,A50,083650,Miranda; Gregory Joseph,13,12,56,43
1656111862566,CSE 11,A01,083080,Cao; Yingjun,1,59,40,39
1656111868589,CSE 12,A01,083652,Krause-Levy; Sophia Louisa,14,8,120,106
1656111874616,CSE 15L,A01,083654,Morris; Justin Loren,5,2,50,45
1656111874616,CSE 15L,A02,083655,Morris; Justin Loren,7,2,50,43
1656111880645,CSE 20,A01,083657,Tran; Khoa Dang,31,0,80,49
1656111886666,CSE 21,A01,095574,Bach; Quang Tran,25,0,48,23
1656111892690,CSE 30,A01,083084,Eldon; John,3,11,80,77
1656111892690,CSE 30,B01,095061,Bhaskar; Nishant,4,5,50,46
1656111898721,CSE 100,A01,083659,Cao; Yingjun,2,22,70,68
1656111904745,CSE 134B,A01,083661,Powell; Thomas Allan,10,8,100,90
1656111910768,CSE 140,A01,083663,Gungor; Onat,9,0,85,76
1656111916796,CSE 140L,A01,083088,Eldon; John,8,0,100,92
1656111922817,CSE 175,A01,083665,Kumar; Rakesh,0,0,25,25
1656111928841,CSE 190,A00,092507,Dubnov; Shlomo,2,0,20,18
1656111934866,ECE 45,A01,083139,Congero; Spencer William,5,4,75,70
1656111940894,ECE 65,A50,083695,Saad; Andrew S,8,0,30,22
1656111940894,ECE 65,A51,095125,Staff,23,0,26,3
1656111946917,ECE 109,A01,091882,Touri; Behrouz,7,7,70,63
1656111952939,ECE 180,A00,083140,Abi Samra; Nicholas Camill,1,0,30,29
1656111952939,ECE 180,B00,083141,Abi Samra; Nicholas Camill,4,8,30,26
1656111958972,MATH 10A,A01,083735,Patchell; Gregory David,0,0,30,30
1656111958972,MATH 10A,A02,083736,Patchell; Gregory David,22,0,30,8
1656111958972,MATH 10A,A03,083737,Patchell; Gregory David,16,0,30,14
1656111964997,MATH 10B,A01,083207,Lim; Seonhee,3,3,34,31
1656111964997,MATH 10B,A02,083208,Lim; Seonhee,10,2,35,25
1656111964997,MATH 10B,A03,093472,Staff,4,3,34,30
1656111964997,MATH 10B,B01,083739,Sinha; Shubham,12,0,30,18
1656111971021,MATH 18,A01,083743,Cinel; Cameron Alexander,7,0,30,23
1656111971021,MATH 18,A02,083744,Cinel; Cameron Alexander,10,0,30,20
1656111971021,MATH 18,A03,083745,Cinel; Cameron Alexander,3,0,30,27
1656111971021,MATH 18,B01,083748,Ma; Zilu,0,0,36,36
1656111971021,MATH 18,B02,083749,Ma; Zilu,0,0,36,36
1656111971021,MATH 18,B03,083750,Ma; Zilu,0,0,36,36
1656111971021,MATH 18,B04,083751,Ma; Zilu,0,0,36,36
1656111971021,MATH 18,B05,093473,Staff,2,0,36,34
1656111971021,MATH 18,B06,093474,Staff,4,0,36,32
1656111977046,MATH 20A,A01,083754,Zheng; Zequn,11,0,40,29
1656111983072,MATH 20B,A01,083756,Briones; Jor-el Thomas Caparas,0,0,36,36
1656111983072,MATH 20B,A02,083757,Briones; Jor-el Thomas Caparas,0,0,36,36
1656111983072,MATH 20B,A03,093475,Staff,2,0,36,34
1656111989100,MATH 20C,A01,083760,Briones; Jor-el Thomas Caparas,2,2,35,33
1656111989100,MATH 20C,A02,083761,Briones; Jor-el Thomas Caparas,9,1,35,26
1656111989100,MATH 20C,A03,093476,Staff,1,1,35,34
1656111989100,MATH 20C,B01,083762,Bach; Quang Tran,1,0,30,29
1656111995131,MATH 20D,A01,083765,Tran; Brian Kha,2,0,30,28
1656111995131,MATH 20D,A02,083766,Tran; Brian Kha,0,1,30,30
1656111995131,MATH 20D,A03,083767,Tran; Brian Kha,2,0,30,28
1656112001161,MATH 20E,A01,083771,Ganguly; Soumya,4,1,32,28
1656112001161,MATH 20E,A02,083772,Ganguly; Soumya,2,2,32,30
1656112001161,MATH 20E,B01,083773,Ciotti; Benjamin,14,0,35,21
1656112001161,MATH 20E,B02,083774,Ciotti; Benjamin,14,0,35,21
1656112007188,MATH 103A,A01,083777,Greenfeld; Be'Eri,2,0,36,34
1656112007188,MATH 103A,A02,083778,Greenfeld; Be'Eri,2,0,36,34
1656112007188,MATH 103A,A03,093561,Staff,4,1,36,32
1656112007188,MATH 103A,B01,083779,Greenfeld; Be'Eri,8,1,36,28
1656112007188,MATH 103A,B02,083780,Greenfeld; Be'Eri,0,0,36,36
1656112007188,MATH 103A,B03,093562,Staff,0,0,36,36
1656112013212,MATH 105,A01,085443,Carter; Anne Toulson,4,1,35,31
1656112013212,MATH 105,A02,093477,Staff,9,0,35,26
1656112019241,MATH 109,A01,083213,Ganzberger; Geoffrey Michael,1,1,34,33
1656112019241,MATH 109,A02,083214,Ganzberger; Geoffrey Michael,0,0,34,34
1656112019241,MATH 109,A03,093478,Staff,1,0,34,33
1656112019241,MATH 109,B01,083215,Ganzberger; Geoffrey Michael,3,0,32,29
1656112019241,MATH 109,B02,083216,Ganzberger; Geoffrey Michael,1,0,32,31
1656112019241,MATH 109,B03,093479,Staff,4,0,32,28
1656112025267,MATH 142A,A01,083219,Chow; Bennett,1,0,32,31
1656112025267,MATH 142A,A02,083220,Chow; Bennett,8,0,32,24
1656112025267,MATH 142A,A03,093480,Staff,5,0,32,27
1656112025267,MATH 142A,B03,093481,Staff,4,0,32,28
1656112025267,MATH 142A,B04,093558,Staff,5,0,32,27
1656112025267,MATH 142A,B05,093559,Staff,0,0,32,32
1656112031295,MATH 193A,A01,083224,Rotar; Vladimir,1,2,34,33
1656112031295,MATH 193A,A02,083225,Rotar; Vladimir,1,0,34,33
1656112031295,MATH 193A,A03,083781,Rotar; Vladimir,1,0,34,33
1656112031295,MATH 193A,A04,083782,Rotar; Vladimir,6,0,34,28
1656112031295,MATH 193A,A05,093482,Rotar; Vladimir,1,0,34,33
1656112037317,MATH 197,001,091859,McAuley; Julian John,9999,0,9999,0
1656112037317,MATH 197,002,095566,Kedlaya; Kiran S.,9997,0,9999,2
1656112037317,MATH 197,003,095567,Xiao; Ming,9999,0,9999,0
1656112037317,MATH 197,004,095571,Perols; Johan Lars,9998,0,9999,1
1656112044422,COGS 9,A01,083615,Shannon; Kyle Michael,5,1,75,70
1656112050445,COGS 11,A01,083617,Boyle; Mary E. T.,16,2,48,32
1656112056472,COGS 13,A01,083071,Bastos; Amalia Pinkusfeld,8,3,71,63
1656112062502,COGS 14A,A01,092681,Semenuks; Arturs,8,25,100,92
1656112068525,COGS 14B,A01,083073,Cheng; Tzu-Han,7,0,63,56
1656112074548,COGS 17,A01,092677,Semenuks; Arturs,13,6,81,68
1656112080572,COGS 100,A01,083619,Allen; Michael Gordon,7,4,70,63
1656112086604,COGS 101A,A01,083621,Davis; Joshua Daniel,7,3,68,61
1656112092637,COGS 101B,A01,091572,Allen; Michael Gordon,6,0,65,59
1656112098660,COGS 101C,A01,083625,Delgado; Tania,11,0,35,24
1656112104687,COGS 107A,A01,083627,Boyle; Mary E. T.,5,4,60,55
1656112110716,COGS 118A,A01,083075,Gupta; Anjum,24,17,76,52
1656112116745,CSE 3,A50,083646,Miranda; Gregory Joseph,18,0,50,32
1656112122768,CSE 8A,A50,083650,Miranda; Gregory Joseph,13,12,56,43
1656112128791,CSE 11,A01,083080,Cao; Yingjun,1,59,40,39
1656112134818,CSE 12,A01,083652,Krause-Levy; Sophia Louisa,14,8,120,106
1656112140846,CSE 15L,A01,083654,Morris; Justin Loren,5,2,50,45
1656112140846,CSE 15L,A02,083655,Morris; Justin Loren,7,2,50,43
1656112146881,CSE 20,A01,083657,Tran; Khoa Dang,31,0,80,49
1656112152906,CSE 21,A01,095574,Bach; Quang Tran,25,0,48,23
1656112158942,CSE 30,A01,083084,Eldon; John,3,11,80,77
1656112158942,CSE 30,B01,095061,Bhaskar; Nishant,4,5,50,46
1656112164968,CSE 100,A01,083659,Cao; Yingjun,2,22,70,68
1656112170996,CSE 134B,A01,083661,Powell; Thomas Allan,10,8,100,90
1656112177035,CSE 140,A01,083663,Gungor; Onat,9,0,85,76
1656112183062,CSE 140L,A01,083088,Eldon; John,8,0,100,92
1656112189095,CSE 175,A01,083665,Kumar; Rakesh,0,0,25,25
1656112195118,CSE 190,A00,092507,Dubnov; Shlomo,2,0,20,18
1656112201151,ECE 45,A01,083139,Congero; Spencer William,5,4,75,70
1656112207172,ECE 65,A50,083695,Saad; Andrew S,8,0,30,22
1656112207172,ECE 65,A51,095125,Staff,23,0,26,3
1656112213195,ECE 109,A01,091882,Touri; Behrouz,7,7,70,63
1656112219218,ECE 180,A00,083140,Abi Samra; Nicholas Camill,1,0,30,29
1656112219218,ECE 180,B00,083141,Abi Samra; Nicholas Camill,4,8,30,26
1656112225243,MATH 10A,A01,083735,Patchell; Gregory David,0,0,30,30
1656112225243,MATH 10A,A02,083736,Patchell; Gregory David,22,0,30,8
1656112225243,MATH 10A,A03,083737,Patchell; Gregory David,16,0,30,14
1656112231278,MATH 10B,A01,083207,Lim; Seonhee,3,3,34,31
1656112231278,MATH 10B,A02,083208,Lim; Seonhee,10,2,35,25
1656112231278,MATH 10B,A03,093472,Staff,4,3,34,30
1656112231278,MATH 10B,B01,083739,Sinha; Shubham,12,0,30,18
1656112237320,MATH 18,A01,083743,Cinel; Cameron Alexander,7,0,30,23
1656112237320,MATH 18,A02,083744,Cinel; Cameron Alexander,10,0,30,20
1656112237320,MATH 18,A03,083745,Cinel; Cameron Alexander,3,0,30,27
1656112237320,MATH 18,B01,083748,Ma; Zilu,0,0,36,36
1656112237320,MATH 18,B02,083749,Ma; Zilu,0,0,36,36
1656112237320,MATH 18,B03,083750,Ma; Zilu,0,0,36,36
1656112237320,MATH 18,B04,083751,Ma; Zilu,0,0,36,36
1656112237320,MATH 18,B05,093473,Staff,2,0,36,34
1656112237320,MATH 18,B06,093474,Staff,4,0,36,32
1656112243342,MATH 20A,A01,083754,Zheng; Zequn,11,0,40,29
1656112249368,MATH 20B,A01,083756,Briones; Jor-el Thomas Caparas,0,0,36,36
1656112249368,MATH 20B,A02,083757,Briones; Jor-el Thomas Caparas,0,0,36,36
1656112249368,MATH 20B,A03,093475,Staff,2,0,36,34
1656112255395,MATH 20C,A01,083760,Briones; Jor-el Thomas Caparas,2,2,35,33
1656112255395,MATH 20C,A02,083761,Briones; Jor-el Thomas Caparas,9,1,35,26
1656112255395,MATH 20C,A03,093476,Staff,1,1,35,34
1656112255395,MATH 20C,B01,083762,Bach; Quang Tran,1,0,30,29
1656112261420,MATH 20D,A01,083765,Tran; Brian Kha,2,0,30,28
1656112261420,MATH 20D,A02,083766,Tran; Brian Kha,0,1,30,30
1656112261420,MATH 20D,A03,083767,Tran; Brian Kha,2,0,30,28
1656112267457,MATH 20E,A01,083771,Ganguly; Soumya,4,1,32,28
1656112267457,MATH 20E,A02,083772,Ganguly; Soumya,2,2,32,30
1656112267457,MATH 20E,B01,083773,Ciotti; Benjamin,14,0,35,21
1656112267457,MATH 20E,B02,083774,Ciotti; Benjamin,14,0,35,21
1656112273483,MATH 103A,A01,083777,Greenfeld; Be'Eri,2,0,36,34
1656112273483,MATH 103A,A02,083778,Greenfeld; Be'Eri,2,0,36,34
1656112273483,MATH 103A,A03,093561,Staff,4,1,36,32
1656112273483,MATH 103A,B01,083779,Greenfeld; Be'Eri,8,1,36,28
1656112273483,MATH 103A,B02,083780,Greenfeld; Be'Eri,0,0,36,36
1656112273483,MATH 103A,B03,093562,Staff,0,0,36,36
1656112279506,MATH 105,A01,085443,Carter; Anne Toulson,4,1,35,31
1656112279506,MATH 105,A02,093477,Staff,9,0,35,26
1656112285532,MATH 109,A01,083213,Ganzberger; Geoffrey Michael,1,1,34,33
1656112285532,MATH 109,A02,083214,Ganzberger; Geoffrey Michael,0,0,34,34
1656112285532,MATH 109,A03,093478,Staff,1,0,34,33
1656112285532,MATH 109,B01,083215,Ganzberger; Geoffrey Michael,3,0,32,29
1656112285532,MATH 109,B02,083216,Ganzberger; Geoffrey Michael,1,0,32,31
1656112285532,MATH 109,B03,093479,Staff,4,0,32,28
1656112291561,MATH 142A,A01,083219,Chow; Bennett,1,0,32,31
1656112291561,MATH 142A,A02,083220,Chow; Bennett,8,0,32,24
1656112291561,MATH 142A,A03,093480,Staff,5,0,32,27
1656112291561,MATH 142A,B03,093481,Staff,4,0,32,28
1656112291561,MATH 142A,B04,093558,Staff,5,0,32,27
1656112291561,MATH 142A,B05,093559,Staff,0,0,32,32
1656112297587,MATH 193A,A01,083224,Rotar; Vladimir,1,2,34,33
1656112297587,MATH 193A,A02,083225,Rotar; Vladimir,1,0,34,33
1656112297587,MATH 193A,A03,083781,Rotar; Vladimir,1,0,34,33
1656112297587,MATH 193A,A04,083782,Rotar; Vladimir,6,0,34,28
1656112297587,MATH 193A,A05,093482,Rotar; Vladimir,1,0,34,33
1656112303610,MATH 197,001,091859,McAuley; Julian John,9999,0,9999,0
1656112303610,MATH 197,002,095566,Kedlaya; Kiran S.,9997,0,9999,2
1656112303610,MATH 197,003,095567,Xiao; Ming,9999,0,9999,0
1656112303610,MATH 197,004,095571,Perols; Johan Lars,9998,0,9999,1
1656112310674,COGS 9,A01,083615,Shannon; Kyle Michael,5,1,75,70
1656112316773,COGS 11,A01,083617,Boyle; Mary E. T.,16,2,48,32
1656112322800,COGS 13,A01,083071,Bastos; Amalia Pinkusfeld,8,3,71,63
1656112328823,COGS 14A,A01,092681,Semenuks; Arturs,8,25,100,92
1656112334846,COGS 14B,A01,083073,Cheng; Tzu-Han,7,0,63,56
1656112340885,COGS 17,A01,092677,Semenuks; Arturs,13,6,81,68
1656112346913,COGS 100,A01,083619,Allen; Michael Gordon,7,4,70,63
1656112352941,COGS 101A,A01,083621,Davis; Joshua Daniel,7,3,68,61
1656112358967,COGS 101B,A01,091572,Allen; Michael Gordon,6,0,65,59
1656112365000,COGS 101C,A01,083625,Delgado; Tania,11,0,35,24
1656112371023,COGS 107A,A01,083627,Boyle; Mary E. T.,5,4,60,55
1656112377045,COGS 118A,A01,083075,Gupta; Anjum,24,17,76,52
1656112383086,CSE 3,A50,083646,Miranda; Gregory Joseph,18,0,50,32
1656112389109,CSE 8A,A50,083650,Miranda; Gregory Joseph,13,12,56,43
1656112395137,CSE 11,A01,083080,Cao; Yingjun,1,59,40,39
1656112401162,CSE 12,A01,083652,Krause-Levy; Sophia Louisa,14,8,120,106
1656112407189,CSE 15L,A01,083654,Morris; Justin Loren,5,2,50,45
1656112407189,CSE 15L,A02,083655,Morris; Justin Loren,7,2,50,43
1656112413214,CSE 20,A01,083657,Tran; Khoa Dang,31,0,80,49
1656112419242,CSE 21,A01,095574,Bach; Quang Tran,25,0,48,23
1656112425266,CSE 30,A01,083084,Eldon; John,3,11,80,77
1656112425266,CSE 30,B01,095061,Bhaskar; Nishant,4,5,50,46
1656112431288,CSE 100,A01,083659,Cao; Yingjun,2,22,70,68
1656112437325,CSE 134B,A01,083661,Powell; Thomas Allan,10,8,100,90
1656112443359,CSE 140,A01,083663,Gungor; Onat,9,0,85,76
1656112449384,CSE 140L,A01,083088,Eldon; John,8,0,100,92
1656112455421,CSE 175,A01,083665,Kumar; Rakesh,0,0,25,25
1656112461449,CSE 190,A00,092507,Dubnov; Shlomo,2,0,20,18
1656112467473,ECE 45,A01,083139,Congero; Spencer William,5,4,75,70
1656112473502,ECE 65,A50,083695,Saad; Andrew S,8,0,30,22
1656112473502,ECE 65,A51,095125,Staff,23,0,26,3
1656112479534,ECE 109,A01,091882,Touri; Behrouz,7,7,70,63
1656112485561,ECE 180,A00,083140,Abi Samra; Nicholas Camill,1,0,30,29
1656112485561,ECE 180,B00,083141,Abi Samra; Nicholas Camill,4,8,30,26
1656112491586,MATH 10A,A01,083735,Patchell; Gregory David,0,0,30,30
1656112491586,MATH 10A,A02,083736,Patchell; Gregory David,22,0,30,8
1656112491586,MATH 10A,A03,083737,Patchell; Gregory David,16,0,30,14
1656112497610,MATH 10B,A01,083207,Lim; Seonhee,3,3,34,31
1656112497610,MATH 10B,A02,083208,Lim; Seonhee,10,2,35,25
1656112497610,MATH 10B,A03,093472,Staff,4,3,34,30
1656112497610,MATH 10B,B01,083739,Sinha; Shubham,12,0,30,18
1656112503635,MATH 18,A01,083743,Cinel; Cameron Alexander,7,0,30,23
1656112503635,MATH 18,A02,083744,Cinel; Cameron Alexander,10,0,30,20
1656112503635,MATH 18,A03,083745,Cinel; Cameron Alexander,3,0,30,27
1656112503635,MATH 18,B01,083748,Staff,0,0,36,36
1656112503635,MATH 18,B02,083749,Staff,0,0,36,36
1656112503635,MATH 18,B03,083750,Staff,0,0,36,36
1656112503635,MATH 18,B04,083751,Staff,0,0,36,36
1656112503635,MATH 18,B05,093473,Staff,2,0,36,34
1656112503635,MATH 18,B06,093474,Staff,4,0,36,32
1656112509662,MATH 20A,A01,083754,Zheng; Zequn,11,0,40,29
1656112515686,MATH 20B,A01,083756,Briones; Jor-el Thomas Caparas,0,0,36,36
1656112515686,MATH 20B,A02,083757,Briones; Jor-el Thomas Caparas,0,0,36,36
1656112515686,MATH 20B,A03,093475,Staff,2,0,36,34
1656112521715,MATH 20C,A01,083760,Briones; Jor-el Thomas Caparas,2,2,35,33
1656112521715,MATH 20C,A02,083761,Briones; Jor-el Thomas Caparas,9,1,35,26
1656112521715,MATH 20C,A03,093476,Staff,1,1,35,34
1656112521715,MATH 20C,B01,083762,Bach; Quang Tran,1,0,30,29
1656112527743,MATH 20D,A01,083765,Tran; Brian Kha,2,0,30,28
1656112527743,MATH 20D,A02,083766,Tran; Brian Kha,0,1,30,30
1656112527743,MATH 20D,A03,083767,Tran; Brian Kha,2,0,30,28
1656112533769,MATH 20E,A01,083771,Ganguly; Soumya,4,1,32,28
1656112533769,MATH 20E,A02,083772,Ganguly; Soumya,2,2,32,30
1656112533769,MATH 20E,B01,083773,Ciotti; Benjamin,14,0,35,21
1656112533769,MATH 20E,B02,083774,Ciotti; Benjamin,14,0,35,21
1656112539798,MATH 103A,A01,083777,Greenfeld; Be'Eri,2,0,36,34
1656112539798,MATH 103A,A02,083778,Greenfeld; Be'Eri,2,0,36,34
1656112539798,MATH 103A,A03,093561,Staff,4,1,36,32
1656112539798,MATH 103A,B01,083779,Greenfeld; Be'Eri,8,1,36,28
1656112539798,MATH 103A,B02,083780,Greenfeld; Be'Eri,0,0,36,36
1656112539798,MATH 103A,B03,093562,Staff,0,0,36,36
1656112545828,MATH 105,A01,085443,Carter; Anne Toulson,4,1,35,31
1656112545828,MATH 105,A02,093477,Staff,9,0,35,26
1656112551859,MATH 109,A01,083213,Ganzberger; Geoffrey Michael,1,1,34,33
1656112551859,MATH 109,A02,083214,Ganzberger; Geoffrey Michael,0,0,34,34
1656112551859,MATH 109,A03,093478,Staff,1,0,34,33
1656112551859,MATH 109,B01,083215,Ganzberger; Geoffrey Michael,3,0,32,29
1656112551859,MATH 109,B02,083216,Ganzberger; Geoffrey Michael,1,0,32,31
1656112551859,MATH 109,B03,093479,Staff,4,0,32,28
1656112557885,MATH 142A,A01,083219,Chow; Bennett,1,0,32,31
1656112557885,MATH 142A,A02,083220,Chow; Bennett,8,0,32,24
1656112557885,MATH 142A,A03,093480,Staff,5,0,32,27
1656112557885,MATH 142A,B03,093481,Staff,4,0,32,28
1656112557885,MATH 142A,B04,093558,Staff,5,0,32,27
1656112557885,MATH 142A,B05,093559,Staff,0,0,32,32
1656112563907,MATH 193A,A01,083224,Rotar; Vladimir,1,2,34,33
1656112563907,MATH 193A,A02,083225,Rotar; Vladimir,1,0,34,33
1656112563907,MATH 193A,A03,083781,Rotar; Vladimir,1,0,34,33
1656112563907,MATH 193A,A04,083782,Rotar; Vladimir,6,0,34,28
1656112563907,MATH 193A,A05,093482,Rotar; Vladimir,1,0,34,33
1656112569936,MATH 197,001,091859,McAuley; Julian John,9999,0,9999,0
1656112569936,MATH 197,002,095566,Kedlaya; Kiran S.,9997,0,9999,2
1656112569936,MATH 197,003,095567,Xiao; Ming,9999,0,9999,0
1656112569936,MATH 197,004,095571,Perols; Johan Lars,9998,0,9999,1
1656112576997,COGS 9,A01,083615,Shannon; Kyle Michael,5,1,75,70
1656112583025,COGS 11,A01,083617,Boyle; Mary E. T.,16,2,48,32
1656112589052,COGS 13,A01,083071,Bastos; Amalia Pinkusfeld,8,3,71,63
1656112595079,COGS 14A,A01,092681,Semenuks; Arturs,8,25,100,92
1656112601106,COGS 14B,A01,083073,Cheng; Tzu-Han,7,0,63,56
1656112607129,COGS 17,A01,092677,Semenuks; Arturs,13,6,81,68
1656112613159,COGS 100,A01,083619,Allen; Michael Gordon,7,4,70,63
1656112619186,COGS 101A,A01,083621,Davis; Joshua Daniel,7,3,68,61
1656112625242,COGS 101B,A01,091572,Allen; Michael Gordon,6,0,65,59
1656112631266,COGS 101C,A01,083625,Delgado; Tania,11,0,35,24
1656112637292,COGS 107A,A01,083627,Boyle; Mary E. T.,5,4,60,55
1656112643335,COGS 118A,A01,083075,Gupta; Anjum,24,17,76,52
1656112649364,CSE 3,A50,083646,Miranda; Gregory Joseph,18,0,50,32
1656112655394,CSE 8A,A50,083650,Miranda; Gregory Joseph,13,12,56,43
1656112661418,CSE 11,A01,083080,Cao; Yingjun,1,59,40,39
1656112667444,CSE 12,A01,083652,Krause-Levy; Sophia Louisa,14,8,120,106
1656112673475,CSE 15L,A01,083654,Morris; Justin Loren,5,2,50,45
1656112673475,CSE 15L,A02,083655,Morris; Justin Loren,7,2,50,43
1656112679502,CSE 20,A01,083657,Tran; Khoa Dang,31,0,80,49
1656112685526,CSE 21,A01,095574,Bach; Quang Tran,25,0,48,23
1656112691563,CSE 30,A01,083084,Eldon; John,3,11,80,77
1656112691563,CSE 30,B01,095061,Bhaskar; Nishant,4,5,50,46
1656112697586,CSE 100,A01,083659,Cao; Yingjun,2,22,70,68
1656112703621,CSE 134B,A01,083661,Powell; Thomas Allan,10,8,100,90
1656112709646,CSE 140,A01,083663,Gungor; Onat,9,0,85,76
1656112715668,CSE 140L,A01,083088,Eldon; John,8,0,100,92
1656112721693,CSE 175,A01,083665,Kumar; Rakesh,0,0,25,25
1656112727719,CSE 190,A00,092507,Dubnov; Shlomo,2,0,20,18
1656112733750,ECE 45,A01,083139,Congero; Spencer William,5,4,75,70
1656112739776,ECE 65,A50,083695,Saad; Andrew S,8,0,30,22
1656112739776,ECE 65,A51,095125,Staff,23,0,26,3
1656112745813,ECE 109,A01,091882,Touri; Behrouz,7,7,70,63
1656112751836,ECE 180,A00,083140,Abi Samra; Nicholas Camill,1,0,30,29
1656112751836,ECE 180,B00,083141,Abi Samra; Nicholas Camill,4,8,30,26
1656112757861,MATH 10A,A01,083735,Patchell; Gregory David,0,0,30,30
1656112757861,MATH 10A,A02,083736,Patchell; Gregory David,22,0,30,8
1656112757861,MATH 10A,A03,083737,Patchell; Gregory David,16,0,30,14
1656112763885,MATH 10B,A01,083207,Lim; Seonhee,3,3,34,31
1656112763885,MATH 10B,A02,083208,Lim; Seonhee,10,2,35,25
1656112763885,MATH 10B,A03,093472,Staff,4,3,34,30
1656112763885,MATH 10B,B01,083739,Sinha; Shubham,12,0,30,18
1656112769920,MATH 18,A01,083743,Cinel; Cameron Alexander,7,0,30,23
1656112769920,MATH 18,A02,083744,Cinel; Cameron Alexander,10,0,30,20
1656112769920,MATH 18,A03,083745,Cinel; Cameron Alexander,3,0,30,27
1656112769920,MATH 18,B01,083748,Staff,0,0,36,36
1656112769920,MATH 18,B02,083749,Staff,0,0,36,36
1656112769920,MATH 18,B03,083750,Staff,0,0,36,36
1656112769920,MATH 18,B04,083751,Staff,0,0,36,36
1656112769920,MATH 18,B05,093473,Staff,2,0,36,34
1656112769920,MATH 18,B06,093474,Staff,4,0,36,32
1656112775952,MATH 20A,A01,083754,Zheng; Zequn,11,0,40,29
1656112781979,MATH 20B,A01,083756,Briones; Jor-el Thomas Caparas,0,0,36,36
1656112781979,MATH 20B,A02,083757,Briones; Jor-el Thomas Caparas,0,0,36,36
1656112781979,MATH 20B,A03,093475,Staff,2,0,36,34
1656112788006,MATH 20C,A01,083760,Briones; Jor-el Thomas Caparas,2,2,35,33
1656112788006,MATH 20C,A02,083761,Briones; Jor-el Thomas Caparas,9,1,35,26
1656112788006,MATH 20C,A03,093476,Staff,1,1,35,34
1656112788006,MATH 20C,B01,083762,Bach; Quang Tran,1,0,30,29
1656112794030,MATH 20D,A01,083765,Tran; Brian Kha,2,0,30,28
1656112794030,MATH 20D,A02,083766,Tran; Brian Kha,0,1,30,30
1656112794030,MATH 20D,A03,083767,Tran; Brian Kha,2,0,30,28
1656112800054,MATH 20E,A01,083771,Ganguly; Soumya,4,1,32,28
1656112800054,MATH 20E,A02,083772,Ganguly; Soumya,2,2,32,30
1656112800054,MATH 20E,B01,083773,Ciotti; Benjamin,14,0,35,21
1656112800054,MATH 20E,B02,083774,Ciotti; Benjamin,14,0,35,21
1656112806097,MATH 103A,A01,083777,Greenfeld; Be'Eri,2,0,36,34
1656112806097,MATH 103A,A02,083778,Greenfeld; Be'Eri,2,0,36,34
1656112806097,MATH 103A,A03,093561,Staff,4,1,36,32
1656112806097,MATH 103A,B01,083779,Greenfeld; Be'Eri,8,1,36,28
1656112806097,MATH 103A,B02,083780,Greenfeld; Be'Eri,0,0,36,36
1656112806097,MATH 103A,B03,093562,Staff,0,0,36,36
1656112812121,MATH 105,A01,085443,Carter; Anne Toulson,4,1,35,31
1656112812121,MATH 105,A02,093477,Staff,9,0,35,26
1656112818150,MATH 109,A01,083213,Ganzberger; Geoffrey Michael,1,1,34,33
1656112818150,MATH 109,A02,083214,Ganzberger; Geoffrey Michael,0,0,34,34
1656112818150,MATH 109,A03,093478,Staff,1,0,34,33
1656112818150,MATH 109,B01,083215,Ganzberger; Geoffrey Michael,3,0,32,29
1656112818150,MATH 109,B02,083216,Ganzberger; Geoffrey Michael,1,0,32,31
1656112818150,MATH 109,B03,093479,Staff,4,0,32,28
1656112824173,MATH 142A,A01,083219,Chow; Bennett,1,0,32,31
1656112824173,MATH 142A,A02,083220,Chow; Bennett,8,0,32,24
1656112824173,MATH 142A,A03,093480,Staff,5,0,32,27
1656112824173,MATH 142A,B03,093481,Staff,4,0,32,28
1656112824173,MATH 142A,B04,093558,Staff,5,0,32,27
1656112824173,MATH 142A,B05,093559,Staff,0,0,32,32
1656112830198,MATH 193A,A01,083224,Rotar; Vladimir,1,2,34,33
1656112830198,MATH 193A,A02,083225,Rotar; Vladimir,1,0,34,33
1656112830198,MATH 193A,A03,083781,Rotar; Vladimir,1,0,34,33
1656112830198,MATH 193A,A04,083782,Rotar; Vladimir,6,0,34,28
1656112830198,MATH 193A,A05,093482,Rotar; Vladimir,1,0,34,33
1656112836221,MATH 197,001,091859,McAuley; Julian John,9999,0,9999,0
1656112836221,MATH 197,002,095566,Kedlaya; Kiran S.,9997,0,9999,2
1656112836221,MATH 197,003,095567,Xiao; Ming,9999,0,9999,0
1656112836221,MATH 197,004,095571,Perols; Johan Lars,9998,0,9999,1
1656112843272,COGS 9,A01,083615,Shannon; Kyle Michael,5,1,75,70
1656112849299,COGS 11,A01,083617,Boyle; Mary E. T.,16,2,48,32
1656112855323,COGS 13,A01,083071,Bastos; Amalia Pinkusfeld,8,3,71,63
1656112861353,COGS 14A,A01,092681,Semenuks; Arturs,8,25,100,92
1656112867382,COGS 14B,A01,083073,Cheng; Tzu-Han,7,0,63,56
1656112873419,COGS 17,A01,092677,Semenuks; Arturs,13,6,81,68
1656112879445,COGS 100,A01,083619,Allen; Michael Gordon,7,4,70,63
1656112885469,COGS 101A,A01,083621,Davis; Joshua Daniel,7,3,68,61
1656112891494,COGS 101B,A01,091572,Allen; Michael Gordon,6,0,65,59
1656112897519,COGS 101C,A01,083625,Delgado; Tania,11,0,35,24
1656112903542,COGS 107A,A01,083627,Boyle; Mary E. T.,5,4,60,55
1656112909568,COGS 118A,A01,083075,Gupta; Anjum,24,17,76,52
1656112915677,CSE 3,A50,083646,Miranda; Gregory Joseph,18,0,50,32
1656112921705,CSE 8A,A50,083650,Miranda; Gregory Joseph,13,12,56,43
1656112927736,CSE 11,A01,083080,Cao; Yingjun,1,59,40,39
1656112933762,CSE 12,A01,083652,Krause-Levy; Sophia Louisa,14,8,120,106
1656112939788,CSE 15L,A01,083654,Morris; Justin Loren,5,2,50,45
1656112939788,CSE 15L,A02,083655,Morris; Justin Loren,7,2,50,43
1656112945811,CSE 20,A01,083657,Tran; Khoa Dang,31,0,80,49
1656112951835,CSE 21,A01,095574,Bach; Quang Tran,25,0,48,23
1656112957864,CSE 30,A01,083084,Eldon; John,3,11,80,77
1656112957864,CSE 30,B01,095061,Bhaskar; Nishant,4,5,50,46
1656112963890,CSE 100,A01,083659,Cao; Yingjun,2,22,70,68
1656112969913,CSE 134B,A01,083661,Powell; Thomas Allan,10,8,100,90
1656112975937,CSE 140,A01,083663,Gungor; Onat,9,0,85,76
1656112981965,CSE 140L,A01,083088,Eldon; John,8,0,100,92
1656112987991,CSE 175,A01,083665,Kumar; Rakesh,0,0,25,25
1656112994017,CSE 190,A00,092507,Dubnov; Shlomo,2,0,20,18
1656113000041,ECE 45,A01,083139,Congero; Spencer William,5,4,75,70
1656113006068,ECE 65,A50,083695,Saad; Andrew S,8,0,30,22
1656113006068,ECE 65,A51,095125,Staff,23,0,26,3
1656113012093,ECE 109,A01,091882,Touri; Behrouz,7,7,70,63
1656113018115,ECE 180,A00,083140,Abi Samra; Nicholas Camill,1,0,30,29
1656113018115,ECE 180,B00,083141,Abi Samra; Nicholas Camill,4,8,30,26
1656113024139,MATH 10A,A01,083735,Patchell; Gregory David,0,0,30,30
1656113024139,MATH 10A,A02,083736,Patchell; Gregory David,22,0,30,8
1656113024139,MATH 10A,A03,083737,Patchell; Gregory David,16,0,30,14
1656113030176,MATH 10B,A01,083207,Lim; Seonhee,3,3,34,31
1656113030176,MATH 10B,A02,083208,Lim; Seonhee,10,2,35,25
1656113030176,MATH 10B,A03,093472,Staff,4,3,34,30
1656113030176,MATH 10B,B01,083739,Sinha; Shubham,12,0,30,18
1656113036202,MATH 18,A01,083743,Cinel; Cameron Alexander,7,0,30,23
1656113036202,MATH 18,A02,083744,Cinel; Cameron Alexander,10,0,30,20
1656113036202,MATH 18,A03,083745,Cinel; Cameron Alexander,3,0,30,27
1656113036202,MATH 18,B01,083748,Staff,0,0,36,36
1656113036202,MATH 18,B02,083749,Staff,0,0,36,36
1656113036202,MATH 18,B03,083750,Staff,0,0,36,36
1656113036202,MATH 18,B04,083751,Staff,0,0,36,36
1656113036202,MATH 18,B05,093473,Staff,2,0,36,34
1656113036202,MATH 18,B06,093474,Staff,4,0,36,32
1656113042230,MATH 20A,A01,083754,Zheng; Zequn,11,0,40,29
1656113048268,MATH 20B,A01,083756,Briones; Jor-el Thomas Caparas,0,0,36,36
1656113048268,MATH 20B,A02,083757,Briones; Jor-el Thomas Caparas,0,0,36,36
1656113048268,MATH 20B,A03,093475,Staff,2,0,36,34
1656113054297,MATH 20C,A01,083760,Briones; Jor-el Thomas Caparas,2,2,35,33
1656113054297,MATH 20C,A02,083761,Briones; Jor-el Thomas Caparas,9,1,35,26
1656113054297,MATH 20C,A03,093476,Staff,1,1,35,34
1656113054297,MATH 20C,B01,083762,Bach; Quang Tran,1,0,30,29
1656113060327,MATH 20D,A01,083765,Tran; Brian Kha,2,0,30,28
1656113060327,MATH 20D,A02,083766,Tran; Brian Kha,0,1,30,30
1656113060327,MATH 20D,A03,083767,Tran; Brian Kha,2,0,30,28
1656113066354,MATH 20E,A01,083771,Ganguly; Soumya,4,1,32,28
1656113066354,MATH 20E,A02,083772,Ganguly; Soumya,2,2,32,30
1656113066354,MATH 20E,B01,083773,Ciotti; Benjamin,14,0,35,21
1656113066354,MATH 20E,B02,083774,Ciotti; Benjamin,14,0,35,21
1656113072379,MATH 103A,A01,083777,Greenfeld; Be'Eri,2,0,36,34
1656113072379,MATH 103A,A02,083778,Greenfeld; Be'Eri,2,0,36,34
1656113072379,MATH 103A,A03,093561,Staff,4,1,36,32
1656113072379,MATH 103A,B01,083779,Greenfeld; Be'Eri,8,1,36,28
1656113072379,MATH 103A,B02,083780,Greenfeld; Be'Eri,0,0,36,36
1656113072379,MATH 103A,B03,093562,Staff,0,0,36,36
1656113078406,MATH 105,A01,085443,Carter; Anne Toulson,4,1,35,31
1656113078406,MATH 105,A02,093477,Staff,9,0,35,26
1656113084435,MATH 109,A01,083213,Ganzberger; Geoffrey Michael,1,1,34,33
1656113084435,MATH 109,A02,083214,Ganzberger; Geoffrey Michael,0,0,34,34
1656113084435,MATH 109,A03,093478,Staff,1,0,34,33
1656113084435,MATH 109,B01,083215,Ganzberger; Geoffrey Michael,3,0,32,29
1656113084435,MATH 109,B02,083216,Ganzberger; Geoffrey Michael,1,0,32,31
1656113084435,MATH 109,B03,093479,Staff,4,0,32,28
1656113090478,MATH 142A,A01,083219,Chow; Bennett,1,0,32,31
1656113090478,MATH 142A,A02,083220,Chow; Bennett,8,0,32,24
1656113090478,MATH 142A,A03,093480,Staff,5,0,32,27
1656113090478,MATH 142A,B03,093481,Staff,4,0,32,28
1656113090478,MATH 142A,B04,093558,Staff,5,0,32,27
1656113090478,MATH 142A,B05,093559,Staff,0,0,32,32
1656113096502,MATH 193A,A01,083224,Rotar; Vladimir,1,2,34,33
1656113096502,MATH 193A,A02,083225,Rotar; Vladimir,1,0,34,33
1656113096502,MATH 193A,A03,083781,Rotar; Vladimir,1,0,34,33
1656113096502,MATH 193A,A04,083782,Rotar; Vladimir,6,0,34,28
1656113096502,MATH 193A,A05,093482,Rotar; Vladimir,1,0,34,33
1656113102527,MATH 197,001,091859,McAuley; Julian John,9999,0,9999,0
1656113102527,MATH 197,002,095566,Kedlaya; Kiran S.,9997,0,9999,2
1656113102527,MATH 197,003,095567,Xiao; Ming,9999,0,9999,0
1656113102527,MATH 197,004,095571,Perols; Johan Lars,9998,0,9999,1
1656113109611,COGS 9,A01,083615,Shannon; Kyle Michael,5,1,75,70
1656113115636,COGS 11,A01,083617,Boyle; Mary E. T.,16,2,48,32
1656113121658,COGS 13,A01,083071,Bastos; Amalia Pinkusfeld,8,3,71,63
1656113127682,COGS 14A,A01,092681,Semenuks; Arturs,8,25,100,92
1656113133709,COGS 14B,A01,083073,Cheng; Tzu-Han,7,0,63,56
1656113139733,COGS 17,A01,092677,Semenuks; Arturs,13,6,81,68
1656113145759,COGS 100,A01,083619,Allen; Michael Gordon,7,4,70,63
1656113151794,COGS 101A,A01,083621,Davis; Joshua Daniel,7,3,68,61
1656113157817,COGS 101B,A01,091572,Allen; Michael Gordon,6,0,65,59
1656113163846,COGS 101C,A01,083625,Delgado; Tania,11,0,35,24
1656113169870,COGS 107A,A01,083627,Boyle; Mary E. T.,5,4,60,55
1656113175893,COGS 118A,A01,083075,Gupta; Anjum,24,17,76,52
1656113181928,CSE 3,A50,083646,Miranda; Gregory Joseph,18,0,50,32
1656113187955,CSE 8A,A50,083650,Miranda; Gregory Joseph,13,12,56,43
1656113193987,CSE 11,A01,083080,Cao; Yingjun,1,59,40,39
1656113200013,CSE 12,A01,083652,Krause-Levy; Sophia Louisa,14,8,120,106
1656113206041,CSE 15L,A01,083654,Morris; Justin Loren,5,2,50,45
1656113206041,CSE 15L,A02,083655,Morris; Justin Loren,7,2,50,43
1656113212077,CSE 20,A01,083657,Tran; Khoa Dang,31,0,80,49
1656113218100,CSE 21,A01,095574,Bach; Quang Tran,25,0,48,23
1656113224125,CSE 30,A01,083084,Eldon; John,3,11,80,77
1656113224125,CSE 30,B01,095061,Bhaskar; Nishant,4,5,50,46
1656113230148,CSE 100,A01,083659,Cao; Yingjun,2,22,70,68
1656113236175,CSE 134B,A01,083661,Powell; Thomas Allan,10,8,100,90
1656113242199,CSE 140,A01,083663,Gungor; Onat,9,0,85,76
1656113248228,CSE 140L,A01,083088,Eldon; John,8,0,100,92
1656113254256,CSE 175,A01,083665,Kumar; Rakesh,0,0,25,25
1656113260279,CSE 190,A00,092507,Dubnov; Shlomo,2,0,20,18
1656113266301,ECE 45,A01,083139,Congero; Spencer William,5,4,75,70
1656113272328,ECE 65,A50,083695,Saad; Andrew S,8,0,30,22
1656113272328,ECE 65,A51,095125,Staff,23,0,26,3
1656113278360,ECE 109,A01,091882,Touri; Behrouz,7,7,70,63
1656113284386,ECE 180,A00,083140,Abi Samra; Nicholas Camill,1,0,30,29
1656113284386,ECE 180,B00,083141,Abi Samra; Nicholas Camill,4,8,30,26
1656113290421,MATH 10A,A01,083735,Patchell; Gregory David,0,0,30,30
1656113290421,MATH 10A,A02,083736,Patchell; Gregory David,22,0,30,8
1656113290421,MATH 10A,A03,083737,Patchell; Gregory David,16,0,30,14
1656113296444,MATH 10B,A01,083207,Lim; Seonhee,3,3,34,31
1656113296444,MATH 10B,A02,083208,Lim; Seonhee,10,2,35,25
1656113296444,MATH 10B,A03,093472,Staff,4,3,34,30
1656113296444,MATH 10B,B01,083739,Sinha; Shubham,12,0,30,18
1656113302489,MATH 18,A01,083743,Cinel; Cameron Alexander,7,0,30,23
1656113302489,MATH 18,A02,083744,Cinel; Cameron Alexander,10,0,30,20
1656113302489,MATH 18,A03,083745,Cinel; Cameron Alexander,3,0,30,27
1656113302489,MATH 18,B01,083748,Staff,0,0,36,36
1656113302489,MATH 18,B02,083749,Staff,0,0,36,36
1656113302489,MATH 18,B03,083750,Staff,0,0,36,36
1656113302489,MATH 18,B04,083751,Staff,0,0,36,36
1656113302489,MATH 18,B05,093473,Staff,2,0,36,34
1656113302489,MATH 18,B06,093474,Staff,4,0,36,32
1656113308510,MATH 20A,A01,083754,Zheng; Zequn,11,0,40,29
1656113314537,MATH 20B,A01,083756,Briones; Jor-el Thomas Caparas,0,0,36,36
1656113314537,MATH 20B,A02,083757,Briones; Jor-el Thomas Caparas,0,0,36,36
1656113314537,MATH 20B,A03,093475,Staff,2,0,36,34
1656113320565,MATH 20C,A01,083760,Briones; Jor-el Thomas Caparas,2,2,35,33
1656113320565,MATH 20C,A02,083761,Briones; Jor-el Thomas Caparas,9,1,35,26
1656113320565,MATH 20C,A03,093476,Staff,1,1,35,34
1656113320565,MATH 20C,B01,083762,Bach; Quang Tran,1,0,30,29
1656113326596,MATH 20D,A01,083765,Tran; Brian Kha,2,0,30,28
1656113326596,MATH 20D,A02,083766,Tran; Brian Kha,0,1,30,30
1656113326596,MATH 20D,A03,083767,Tran; Brian Kha,2,0,30,28
1656113332620,MATH 20E,A01,083771,Ganguly; Soumya,4,1,32,28
1656113332620,MATH 20E,A02,083772,Ganguly; Soumya,2,2,32,30
1656113332620,MATH 20E,B01,083773,Ciotti; Benjamin,14,0,35,21
1656113332620,MATH 20E,B02,083774,Ciotti; Benjamin,14,0,35,21
1656113338643,MATH 103A,A01,083777,Greenfeld; Be'Eri,2,0,36,34
1656113338643,MATH 103A,A02,083778,Greenfeld; Be'Eri,2,0,36,34
1656113338643,MATH 103A,A03,093561,Staff,4,1,36,32
1656113338643,MATH 103A,B01,083779,Greenfeld; Be'Eri,8,1,36,28
1656113338643,MATH 103A,B02,083780,Greenfeld; Be'Eri,0,0,36,36
1656113338643,MATH 103A,B03,093562,Staff,0,0,36,36
1656113344667,MATH 105,A01,085443,Carter; Anne Toulson,4,1,35,31
1656113344667,MATH 105,A02,093477,Staff,9,0,35,26
1656113350692,MATH 109,A01,083213,Ganzberger; Geoffrey Michael,1,1,34,33
1656113350692,MATH 109,A02,083214,Ganzberger; Geoffrey Michael,0,0,34,34
1656113350692,MATH 109,A03,093478,Staff,1,0,34,33
1656113350692,MATH 109,B01,083215,Ganzberger; Geoffrey Michael,3,0,32,29
1656113350692,MATH 109,B02,083216,Ganzberger; Geoffrey Michael,1,0,32,31
1656113350692,MATH 109,B03,093479,Staff,4,0,32,28
1656113356716,MATH 142A,A01,083219,Chow; Bennett,1,0,32,31
1656113356716,MATH 142A,A02,083220,Chow; Bennett,8,0,32,24
1656113356716,MATH 142A,A03,093480,Staff,5,0,32,27
1656113356716,MATH 142A,B03,093481,Staff,4,0,32,28
1656113356716,MATH 142A,B04,093558,Staff,5,0,32,27
1656113356716,MATH 142A,B05,093559,Staff,0,0,32,32
1656113362745,MATH 193A,A01,083224,Rotar; Vladimir,1,2,34,33
1656113362745,MATH 193A,A02,083225,Rotar; Vladimir,1,0,34,33
1656113362745,MATH 193A,A03,083781,Rotar; Vladimir,1,0,34,33
1656113362745,MATH 193A,A04,083782,Rotar; Vladimir,6,0,34,28
1656113362745,MATH 193A,A05,093482,Rotar; Vladimir,1,0,34,33
1656113368771,MATH 197,001,091859,McAuley; Julian John,9999,0,9999,0
1656113368771,MATH 197,002,095566,Kedlaya; Kiran S.,9997,0,9999,2
1656113368771,MATH 197,003,095567,Xiao; Ming,9999,0,9999,0
1656113368771,MATH 197,004,095571,Perols; Johan Lars,9998,0,9999,1
1656113375846,COGS 9,A01,083615,Shannon; Kyle Michael,5,1,75,70
1656113381869,COGS 11,A01,083617,Boyle; Mary E. T.,16,2,48,32
1656113387897,COGS 13,A01,083071,Bastos; Amalia Pinkusfeld,8,3,71,63
1656113393923,COGS 14A,A01,092681,Semenuks; Arturs,8,24,100,92
1656113399945,COGS 14B,A01,083073,Cheng; Tzu-Han,7,0,63,56
1656113405970,COGS 17,A01,092677,Semenuks; Arturs,13,6,81,68
1656113411998,COGS 100,A01,083619,Allen; Michael Gordon,7,4,70,63
1656113418026,COGS 101A,A01,083621,Davis; Joshua Daniel,7,3,68,61
1656113424049,COGS 101B,A01,091572,Allen; Michael Gordon,6,0,65,59
1656113435278,COGS 101C,A01,083625,Delgado; Tania,11,0,35,24
1656113441303,COGS 107A,A01,083627,Boyle; Mary E. T.,5,4,60,55
1656113447340,COGS 118A,A01,083075,Gupta; Anjum,24,17,76,52
1656113453367,CSE 3,A50,083646,Miranda; Gregory Joseph,18,0,50,32
1656113459395,CSE 8A,A50,083650,Miranda; Gregory Joseph,13,12,56,43
1656113465434,CSE 11,A01,083080,Cao; Yingjun,1,59,40,39
1656113471461,CSE 12,A01,083652,Krause-Levy; Sophia Louisa,14,8,120,106
1656113477505,CSE 15L,A01,083654,Morris; Justin Loren,5,2,50,45
1656113477505,CSE 15L,A02,083655,Morris; Justin Loren,7,2,50,43
1656113483526,CSE 20,A01,083657,Tran; Khoa Dang,31,0,80,49
1656113489557,CSE 21,A01,095574,Bach; Quang Tran,25,0,48,23
1656113495582,CSE 30,A01,083084,Eldon; John,3,11,80,77
1656113495582,CSE 30,B01,095061,Bhaskar; Nishant,4,5,50,46
1656113501615,CSE 100,A01,083659,Cao; Yingjun,2,22,70,68
1656113507641,CSE 134B,A01,083661,Powell; Thomas Allan,10,8,100,90
1656113513667,CSE 140,A01,083663,Gungor; Onat,9,0,85,76
1656113519780,CSE 140L,A01,083088,Eldon; John,8,0,100,92
1656113525804,CSE 175,A01,083665,Kumar; Rakesh,0,0,25,25
1656113531841,CSE 190,A00,092507,Dubnov; Shlomo,2,0,20,18
1656113537864,ECE 45,A01,083139,Congero; Spencer William,5,4,75,70
1656113543887,ECE 65,A50,083695,Saad; Andrew S,8,0,30,22
1656113543887,ECE 65,A51,095125,Staff,23,0,26,3
1656113549918,ECE 109,A01,091882,Touri; Behrouz,7,7,70,63
1656113555945,ECE 180,A00,083140,Abi Samra; Nicholas Camill,1,0,30,29
1656113555945,ECE 180,B00,083141,Abi Samra; Nicholas Camill,4,8,30,26
1656113561969,MATH 10A,A01,083735,Patchell; Gregory David,0,0,30,30
1656113561969,MATH 10A,A02,083736,Patchell; Gregory David,22,0,30,8
1656113561969,MATH 10A,A03,083737,Patchell; Gregory David,16,0,30,14
1656113567993,MATH 10B,A01,083207,Lim; Seonhee,3,3,34,31
1656113567993,MATH 10B,A02,083208,Lim; Seonhee,10,2,35,25
1656113567993,MATH 10B,A03,093472,Staff,4,3,34,30
1656113567993,MATH 10B,B01,083739,Sinha; Shubham,12,0,30,18
1656113574016,MATH 18,A01,083743,Cinel; Cameron Alexander,7,0,30,23
1656113574016,MATH 18,A02,083744,Cinel; Cameron Alexander,10,0,30,20
1656113574016,MATH 18,A03,083745,Cinel; Cameron Alexander,3,0,30,27
1656113574016,MATH 18,B01,083748,Staff,0,0,36,36
1656113574016,MATH 18,B02,083749,Staff,0,0,36,36
1656113574016,MATH 18,B03,083750,Staff,0,0,36,36
1656113574016,MATH 18,B04,083751,Staff,0,0,36,36
1656113574016,MATH 18,B05,093473,Staff,2,0,36,34
1656113574016,MATH 18,B06,093474,Staff,4,0,36,32
1656113580043,MATH 20A,A01,083754,Zheng; Zequn,11,0,40,29
1656113586067,MATH 20B,A01,083756,Briones; Jor-el Thomas Caparas,0,0,36,36
1656113586067,MATH 20B,A02,083757,Briones; Jor-el Thomas Caparas,0,0,36,36
1656113586067,MATH 20B,A03,093475,Staff,2,0,36,34
1656113592096,MATH 20C,A01,083760,Briones; Jor-el Thomas Caparas,2,2,35,33
1656113592096,MATH 20C,A02,083761,Briones; Jor-el Thomas Caparas,9,1,35,26
1656113592096,MATH 20C,A03,093476,Staff,1,1,35,34
1656113592096,MATH 20C,B01,083762,Bach; Quang Tran,1,0,30,29
1656113598120,MATH 20D,A01,083765,Tran; Brian Kha,2,0,30,28
1656113598120,MATH 20D,A02,083766,Tran; Brian Kha,0,1,30,30
1656113598120,MATH 20D,A03,083767,Tran; Brian Kha,2,0,30,28
1656113604145,MATH 20E,A01,083771,Ganguly; Soumya,4,1,32,28
1656113604145,MATH 20E,A02,083772,Ganguly; Soumya,2,2,32,30
1656113604145,MATH 20E,B01,083773,Ciotti; Benjamin,14,0,35,21
1656113604145,MATH 20E,B02,083774,Ciotti; Benjamin,14,0,35,21
1656113610170,MATH 103A,A01,083777,Greenfeld; Be'Eri,2,0,36,34
1656113610170,MATH 103A,A02,083778,Greenfeld; Be'Eri,2,0,36,34
1656113610170,MATH 103A,A03,093561,Staff,4,1,36,32
1656113610170,MATH 103A,B01,083779,Greenfeld; Be'Eri,8,1,36,28
1656113610170,MATH 103A,B02,083780,Greenfeld; Be'Eri,0,0,36,36
1656113610170,MATH 103A,B03,093562,Staff,0,0,36,36
1656113616199,MATH 105,A01,085443,Carter; Anne Toulson,4,1,35,31
1656113616199,MATH 105,A02,093477,Staff,9,0,35,26
1656113622223,MATH 109,A01,083213,Ganzberger; Geoffrey Michael,1,1,34,33
1656113622223,MATH 109,A02,083214,Ganzberger; Geoffrey Michael,0,0,34,34
1656113622223,MATH 109,A03,093478,Staff,1,0,34,33
1656113622223,MATH 109,B01,083215,Ganzberger; Geoffrey Michael,3,0,32,29
1656113622223,MATH 109,B02,083216,Ganzberger; Geoffrey Michael,1,0,32,31
1656113622223,MATH 109,B03,093479,Staff,4,0,32,28
1656113628251,MATH 142A,A01,083219,Chow; Bennett,1,0,32,31
1656113628251,MATH 142A,A02,083220,Chow; Bennett,8,0,32,24
1656113628251,MATH 142A,A03,093480,Staff,5,0,32,27
1656113628251,MATH 142A,B03,093481,Staff,4,0,32,28
1656113628251,MATH 142A,B04,093558,Staff,5,0,32,27
1656113628251,MATH 142A,B05,093559,Staff,0,0,32,32
1656113634280,MATH 193A,A01,083224,Rotar; Vladimir,1,2,34,33
1656113634280,MATH 193A,A02,083225,Rotar; Vladimir,1,0,34,33
1656113634280,MATH 193A,A03,083781,Rotar; Vladimir,1,0,34,33
1656113634280,MATH 193A,A04,083782,Rotar; Vladimir,6,0,34,28
1656113634280,MATH 193A,A05,093482,Rotar; Vladimir,1,0,34,33
1656113640310,MATH 197,001,091859,McAuley; Julian John,9999,0,9999,0
1656113640310,MATH 197,002,095566,Kedlaya; Kiran S.,9997,0,9999,2
1656113640310,MATH 197,003,095567,Xiao; Ming,9999,0,9999,0
1656113640310,MATH 197,004,095571,Perols; Johan Lars,9998,0,9999,1
1656113647390,COGS 9,A01,083615,Shannon; Kyle Michael,5,1,75,70
1656113653426,COGS 11,A01,083617,Boyle; Mary E. T.,16,2,48,32
1656113659449,COGS 13,A01,083071,Bastos; Amalia Pinkusfeld,8,3,71,63
1656113665471,COGS 14A,A01,092681,Semenuks; Arturs,8,24,100,92
1656113671494,COGS 14B,A01,083073,Cheng; Tzu-Han,7,0,63,56
1656113677516,COGS 17,A01,092677,Semenuks; Arturs,13,6,81,68
1656113683542,COGS 100,A01,083619,Allen; Michael Gordon,7,4,70,63
1656113689569,COGS 101A,A01,083621,Davis; Joshua Daniel,7,3,68,61
1656113695595,COGS 101B,A01,091572,Allen; Michael Gordon,6,0,65,59
1656113701618,COGS 101C,A01,083625,Delgado; Tania,11,0,35,24
1656113707643,COGS 107A,A01,083627,Boyle; Mary E. T.,5,4,60,55
1656113713666,COGS 118A,A01,083075,Gupta; Anjum,24,17,76,52
1656113719695,CSE 3,A50,083646,Miranda; Gregory Joseph,18,0,50,32
1656113725723,CSE 8A,A50,083650,Miranda; Gregory Joseph,13,12,56,43
1656113731745,CSE 11,A01,083080,Cao; Yingjun,1,59,40,39
1656113737771,CSE 12,A01,083652,Krause-Levy; Sophia Louisa,14,8,120,106
1656113743804,CSE 15L,A01,083654,Morris; Justin Loren,5,2,50,45
1656113743804,CSE 15L,A02,083655,Morris; Justin Loren,7,2,50,43
1656113749828,CSE 20,A01,083657,Tran; Khoa Dang,31,0,80,49
1656113755851,CSE 21,A01,095574,Bach; Quang Tran,25,0,48,23
1656113761881,CSE 30,A01,083084,Eldon; John,3,11,80,77
1656113761881,CSE 30,B01,095061,Bhaskar; Nishant,4,5,50,46
1656113767908,CSE 100,A01,083659,Cao; Yingjun,2,22,70,68
1656113773935,CSE 134B,A01,083661,Powell; Thomas Allan,10,8,100,90
1656113779962,CSE 140,A01,083663,Gungor; Onat,9,0,85,76
1656113785987,CSE 140L,A01,083088,Eldon; John,8,0,100,92
1656113792009,CSE 175,A01,083665,Kumar; Rakesh,0,0,25,25
1656113798031,CSE 190,A00,092507,Dubnov; Shlomo,2,0,20,18
1656113804065,ECE 45,A01,083139,Congero; Spencer William,5,4,75,70
1656113810088,ECE 65,A50,083695,Saad; Andrew S,8,0,30,22
1656113810088,ECE 65,A51,095125,Staff,23,0,26,3
1656113816113,ECE 109,A01,091882,Touri; Behrouz,7,7,70,63
1656113822136,ECE 180,A00,083140,Abi Samra; Nicholas Camill,1,0,30,29
1656113822136,ECE 180,B00,083141,Abi Samra; Nicholas Camill,4,8,30,26
1656113828162,MATH 10A,A01,083735,Patchell; Gregory David,0,0,30,30
1656113828162,MATH 10A,A02,083736,Patchell; Gregory David,22,0,30,8
1656113828162,MATH 10A,A03,083737,Patchell; Gregory David,16,0,30,14
1656113834196,MATH 10B,A01,083207,Lim; Seonhee,3,3,34,31
1656113834196,MATH 10B,A02,083208,Lim; Seonhee,10,2,35,25
1656113834196,MATH 10B,A03,093472,Staff,4,3,34,30
1656113834196,MATH 10B,B01,083739,Sinha; Shubham,12,0,30,18
1656113840225,MATH 18,A01,083743,Cinel; Cameron Alexander,7,0,30,23
1656113840225,MATH 18,A02,083744,Cinel; Cameron Alexander,10,0,30,20
1656113840225,MATH 18,A03,083745,Cinel; Cameron Alexander,3,0,30,27
1656113840225,MATH 18,B01,083748,Staff,0,0,36,36
1656113840225,MATH 18,B02,083749,Staff,0,0,36,36
1656113840225,MATH 18,B03,083750,Staff,0,0,36,36
1656113840225,MATH 18,B04,083751,Staff,0,0,36,36
1656113840225,MATH 18,B05,093473,Staff,2,0,36,34
1656113840225,MATH 18,B06,093474,Staff,4,0,36,32
1656113846248,MATH 20A,A01,083754,Zheng; Zequn,11,0,40,29
1656113852276,MATH 20B,A01,083756,Briones; Jor-el Thomas Caparas,0,0,36,36
1656113852276,MATH 20B,A02,083757,Briones; Jor-el Thomas Caparas,0,0,36,36
1656113852276,MATH 20B,A03,093475,Staff,2,0,36,34
1656113858299,MATH 20C,A01,083760,Briones; Jor-el Thomas Caparas,2,2,35,33
1656113858299,MATH 20C,A02,083761,Briones; Jor-el Thomas Caparas,9,1,35,26
1656113858299,MATH 20C,A03,093476,Staff,1,1,35,34
1656113858299,MATH 20C,B01,083762,Bach; Quang Tran,1,0,30,29
1656113864321,MATH 20D,A01,083765,Tran; Brian Kha,2,0,30,28
1656113864321,MATH 20D,A02,083766,Tran; Brian Kha,0,1,30,30
1656113864321,MATH 20D,A03,083767,Tran; Brian Kha,2,0,30,28
1656113870348,MATH 20E,A01,083771,Ganguly; Soumya,4,1,32,28
1656113870348,MATH 20E,A02,083772,Ganguly; Soumya,2,2,32,30
1656113870348,MATH 20E,B01,083773,Ciotti; Benjamin,14,0,35,21
1656113870348,MATH 20E,B02,083774,Ciotti; Benjamin,14,0,35,21
1656113876371,MATH 103A,A01,083777,Greenfeld; Be'Eri,2,0,36,34
1656113876371,MATH 103A,A02,083778,Greenfeld; Be'Eri,2,0,36,34
1656113876371,MATH 103A,A03,093561,Staff,4,1,36,32
1656113876371,MATH 103A,B01,083779,Greenfeld; Be'Eri,8,1,36,28
1656113876371,MATH 103A,B02,083780,Greenfeld; Be'Eri,0,0,36,36
1656113876371,MATH 103A,B03,093562,Staff,0,0,36,36
1656113882398,MATH 105,A01,085443,Carter; Anne Toulson,4,1,35,31
1656113882398,MATH 105,A02,093477,Staff,9,0,35,26
1656113888423,MATH 109,A01,083213,Ganzberger; Geoffrey Michael,1,1,34,33
1656113888423,MATH 109,A02,083214,Ganzberger; Geoffrey Michael,0,0,34,34
1656113888423,MATH 109,A03,093478,Staff,1,0,34,33
1656113888423,MATH 109,B01,083215,Ganzberger; Geoffrey Michael,3,0,32,29
1656113888423,MATH 109,B02,083216,Ganzberger; Geoffrey Michael,1,0,32,31
1656113888423,MATH 109,B03,093479,Staff,4,0,32,28
1656113894454,MATH 142A,A01,083219,Chow; Bennett,1,0,32,31
1656113894454,MATH 142A,A02,083220,Chow; Bennett,8,0,32,24
1656113894454,MATH 142A,A03,093480,Staff,5,0,32,27
1656113894454,MATH 142A,B03,093481,Staff,4,0,32,28
1656113894454,MATH 142A,B04,093558,Staff,5,0,32,27
1656113894454,MATH 142A,B05,093559,Staff,0,0,32,32
1656113900479,MATH 193A,A01,083224,Rotar; Vladimir,1,2,34,33
1656113900479,MATH 193A,A02,083225,Rotar; Vladimir,1,0,34,33
1656113900479,MATH 193A,A03,083781,Rotar; Vladimir,1,0,34,33
1656113900479,MATH 193A,A04,083782,Rotar; Vladimir,6,0,34,28
1656113900479,MATH 193A,A05,093482,Rotar; Vladimir,1,0,34,33
1656113906501,MATH 197,001,091859,McAuley; Julian John,9999,0,9999,0
1656113906501,MATH 197,002,095566,Kedlaya; Kiran S.,9997,0,9999,2
1656113906501,MATH 197,003,095567,Xiao; Ming,9999,0,9999,0
1656113906501,MATH 197,004,095571,Perols; Johan Lars,9998,0,9999,1
1656113913600,COGS 9,A01,083615,Shannon; Kyle Michael,5,1,75,70
1656113919631,COGS 11,A01,083617,Boyle; Mary E. T.,16,2,48,32
1656113925655,COGS 13,A01,083071,Bastos; Amalia Pinkusfeld,8,3,71,63
1656113931683,COGS 14A,A01,092681,Semenuks; Arturs,8,24,100,92
1656113937707,COGS 14B,A01,083073,Cheng; Tzu-Han,7,0,63,56
1656113943730,COGS 17,A01,092677,Semenuks; Arturs,13,6,81,68
1656113949753,COGS 100,A01,083619,Allen; Michael Gordon,7,4,70,63
1656113955779,COGS 101A,A01,083621,Davis; Joshua Daniel,7,3,68,61
1656113961816,COGS 101B,A01,091572,Allen; Michael Gordon,6,0,65,59
1656113967837,COGS 101C,A01,083625,Delgado; Tania,11,0,35,24
1656113973861,COGS 107A,A01,083627,Boyle; Mary E. T.,5,4,60,55
1656113979884,COGS 118A,A01,083075,Gupta; Anjum,24,17,76,52
1656113985908,CSE 3,A50,083646,Miranda; Gregory Joseph,18,0,50,32
1656113991933,CSE 8A,A50,083650,Miranda; Gregory Joseph,13,12,56,43
1656113997956,CSE 11,A01,083080,Cao; Yingjun,1,59,40,39
1656114003979,CSE 12,A01,083652,Krause-Levy; Sophia Louisa,14,8,120,106
1656114010006,CSE 15L,A01,083654,Morris; Justin Loren,5,2,50,45
1656114010006,CSE 15L,A02,083655,Morris; Justin Loren,7,2,50,43
1656114016029,CSE 20,A01,083657,Tran; Khoa Dang,31,0,80,49
1656114022052,CSE 21,A01,095574,Bach; Quang Tran,25,0,48,23
1656114028079,CSE 30,A01,083084,Eldon; John,3,11,80,77
1656114028079,CSE 30,B01,095061,Bhaskar; Nishant,4,5,50,46
1656114034102,CSE 100,A01,083659,Cao; Yingjun,2,22,70,68
1656114040134,CSE 134B,A01,083661,Powell; Thomas Allan,10,8,100,90
1656114046159,CSE 140,A01,083663,Gungor; Onat,9,0,85,76
1656114052182,CSE 140L,A01,083088,Eldon; John,8,0,100,92
1656114058203,CSE 175,A01,083665,Kumar; Rakesh,0,0,25,25
1656114064226,CSE 190,A00,092507,Dubnov; Shlomo,2,0,20,18
1656114070254,ECE 45,A01,083139,Congero; Spencer William,5,4,75,70
1656114076282,ECE 65,A50,083695,Saad; Andrew S,8,0,30,22
1656114076282,ECE 65,A51,095125,Staff,23,0,26,3
1656114082322,ECE 109,A01,091882,Touri; Behrouz,7,7,70,63
1656114088349,ECE 180,A00,083140,Abi Samra; Nicholas Camill,1,0,30,29
1656114088349,ECE 180,B00,083141,Abi Samra; Nicholas Camill,4,8,30,26
1656114094388,MATH 10A,A01,083735,Patchell; Gregory David,0,0,30,30
1656114094388,MATH 10A,A02,083736,Patchell; Gregory David,22,0,30,8
1656114094388,MATH 10A,A03,083737,Patchell; Gregory David,16,0,30,14
1656114100411,MATH 10B,A01,083207,Lim; Seonhee,3,3,34,31
1656114100411,MATH 10B,A02,083208,Lim; Seonhee,10,2,35,25
1656114100411,MATH 10B,A03,093472,Staff,4,3,34,30
1656114100411,MATH 10B,B01,083739,Sinha; Shubham,12,0,30,18
1656114106441,MATH 18,A01,083743,Cinel; Cameron Alexander,7,0,30,23
1656114106441,MATH 18,A02,083744,Cinel; Cameron Alexander,10,0,30,20
1656114106441,MATH 18,A03,083745,Cinel; Cameron Alexander,3,0,30,27
1656114106441,MATH 18,B01,083748,Staff,0,0,36,36
1656114106441,MATH 18,B02,083749,Staff,0,0,36,36
1656114106441,MATH 18,B03,083750,Staff,0,0,36,36
1656114106441,MATH 18,B04,083751,Staff,0,0,36,36
1656114106441,MATH 18,B05,093473,Staff,2,0,36,34
1656114106441,MATH 18,B06,093474,Staff,4,0,36,32
1656114112464,MATH 20A,A01,083754,Zheng; Zequn,11,0,40,29
1656114118559,MATH 20B,A01,083756,Briones; Jor-el Thomas Caparas,0,0,36,36
1656114118559,MATH 20B,A02,083757,Briones; Jor-el Thomas Caparas,0,0,36,36
1656114118559,MATH 20B,A03,093475,Staff,2,0,36,34
1656114124587,MATH 20C,A01,083760,Briones; Jor-el Thomas Caparas,2,2,35,33
1656114124587,MATH 20C,A02,083761,Briones; Jor-el Thomas Caparas,9,1,35,26
1656114124587,MATH 20C,A03,093476,Staff,1,1,35,34
1656114124587,MATH 20C,B01,083762,Bach; Quang Tran,1,0,30,29
1656114130612,MATH 20D,A01,083765,Tran; Brian Kha,2,0,30,28
1656114130612,MATH 20D,A02,083766,Tran; Brian Kha,0,1,30,30
1656114130612,MATH 20D,A03,083767,Tran; Brian Kha,2,0,30,28
1656114136657,MATH 20E,A01,083771,Ganguly; Soumya,4,1,32,28
1656114136657,MATH 20E,A02,083772,Ganguly; Soumya,2,2,32,30
1656114136657,MATH 20E,B01,083773,Ciotti; Benjamin,14,0,35,21
1656114136657,MATH 20E,B02,083774,Ciotti; Benjamin,14,0,35,21
1656114142689,MATH 103A,A01,083777,Greenfeld; Be'Eri,2,0,36,34
1656114142689,MATH 103A,A02,083778,Greenfeld; Be'Eri,2,0,36,34
1656114142689,MATH 103A,A03,093561,Staff,4,1,36,32
1656114142689,MATH 103A,B01,083779,Greenfeld; Be'Eri,8,1,36,28
1656114142689,MATH 103A,B02,083780,Greenfeld; Be'Eri,0,0,36,36
1656114142689,MATH 103A,B03,093562,Staff,0,0,36,36
1656114148716,MATH 105,A01,085443,Carter; Anne Toulson,4,1,35,31
1656114148716,MATH 105,A02,093477,Staff,9,0,35,26
1656114154740,MATH 109,A01,083213,Ganzberger; Geoffrey Michael,1,1,34,33
1656114154740,MATH 109,A02,083214,Ganzberger; Geoffrey Michael,0,0,34,34
1656114154740,MATH 109,A03,093478,Staff,1,0,34,33
1656114154740,MATH 109,B01,083215,Ganzberger; Geoffrey Michael,3,0,32,29
1656114154740,MATH 109,B02,083216,Ganzberger; Geoffrey Michael,1,0,32,31
1656114154740,MATH 109,B03,093479,Staff,4,0,32,28
1656114160764,MATH 142A,A01,083219,Chow; Bennett,1,0,32,31
1656114160764,MATH 142A,A02,083220,Chow; Bennett,8,0,32,24
1656114160764,MATH 142A,A03,093480,Staff,5,0,32,27
1656114160764,MATH 142A,B03,093481,Staff,4,0,32,28
1656114160764,MATH 142A,B04,093558,Staff,5,0,32,27
1656114160764,MATH 142A,B05,093559,Staff,0,0,32,32
1656114166791,MATH 193A,A01,083224,Rotar; Vladimir,1,2,34,33
1656114166791,MATH 193A,A02,083225,Rotar; Vladimir,1,0,34,33
1656114166791,MATH 193A,A03,083781,Rotar; Vladimir,1,0,34,33
1656114166791,MATH 193A,A04,083782,Rotar; Vladimir,6,0,34,28
1656114166791,MATH 193A,A05,093482,Rotar; Vladimir,1,0,34,33
1656114172817,MATH 197,001,091859,McAuley; Julian John,9999,0,9999,0
1656114172817,MATH 197,002,095566,Kedlaya; Kiran S.,9997,0,9999,2
1656114172817,MATH 197,003,095567,Xiao; Ming,9999,0,9999,0
1656114172817,MATH 197,004,095571,Perols; Johan Lars,9998,0,9999,1
1656114179882,COGS 9,A01,083615,Shannon; Kyle Michael,5,1,75,70
1656114185909,COGS 11,A01,083617,Boyle; Mary E. T.,16,2,48,32
1656114191933,COGS 13,A01,083071,Bastos; Amalia Pinkusfeld,8,3,71,63
1656114197960,COGS 14A,A01,092681,Semenuks; Arturs,8,24,100,92
1656114203986,COGS 14B,A01,083073,Cheng; Tzu-Han,7,0,63,56
1656114210010,COGS 17,A01,092677,Semenuks; Arturs,13,6,81,68
1656114216038,COGS 100,A01,083619,Allen; Michael Gordon,7,4,70,63
1656114222064,COGS 101A,A01,083621,Davis; Joshua Daniel,7,3,68,61
1656114228088,COGS 101B,A01,091572,Allen; Michael Gordon,6,0,65,59
1656114234118,COGS 101C,A01,083625,Delgado; Tania,11,0,35,24
1656114240148,COGS 107A,A01,083627,Boyle; Mary E. T.,5,4,60,55
1656114246176,COGS 118A,A01,083075,Gupta; Anjum,24,17,76,52
1656114252201,CSE 3,A50,083646,Miranda; Gregory Joseph,18,0,50,32
1656114258228,CSE 8A,A50,083650,Miranda; Gregory Joseph,13,12,56,43
1656114264254,CSE 11,A01,083080,Cao; Yingjun,1,59,40,39
1656114270279,CSE 12,A01,083652,Krause-Levy; Sophia Louisa,14,8,120,106
1656114276309,CSE 15L,A01,083654,Morris; Justin Loren,5,2,50,45
1656114276309,CSE 15L,A02,083655,Morris; Justin Loren,7,2,50,43
1656114282335,CSE 20,A01,083657,Tran; Khoa Dang,31,0,80,49
1656114288359,CSE 21,A01,095574,Bach; Quang Tran,25,0,48,23
1656114294391,CSE 30,A01,083084,Eldon; John,3,11,80,77
1656114294391,CSE 30,B01,095061,Bhaskar; Nishant,4,5,50,46
1656114300414,CSE 100,A01,083659,Cao; Yingjun,2,22,70,68
1656114306437,CSE 134B,A01,083661,Powell; Thomas Allan,10,8,100,90
1656114312461,CSE 140,A01,083663,Gungor; Onat,9,0,85,76
1656114318487,CSE 140L,A01,083088,Eldon; John,8,0,100,92
1656114324514,CSE 175,A01,083665,Kumar; Rakesh,0,0,25,25
1656114330537,CSE 190,A00,092507,Dubnov; Shlomo,2,0,20,18
1656114336562,ECE 45,A01,083139,Congero; Spencer William,5,4,75,70
1656114342588,ECE 65,A50,083695,Saad; Andrew S,8,0,30,22
1656114342588,ECE 65,A51,095125,Staff,23,0,26,3
1656114348612,ECE 109,A01,091882,Touri; Behrouz,7,7,70,63
1656114354646,ECE 180,A00,083140,Abi Samra; Nicholas Camill,1,0,30,29
1656114354646,ECE 180,B00,083141,Abi Samra; Nicholas Camill,4,8,30,26
1656114360676,MATH 10A,A01,083735,Patchell; Gregory David,0,0,30,30
1656114360676,MATH 10A,A02,083736,Patchell; Gregory David,22,0,30,8
1656114360676,MATH 10A,A03,083737,Patchell; Gregory David,16,0,30,14
1656114366705,MATH 10B,A01,083207,Lim; Seonhee,3,3,34,31
1656114366705,MATH 10B,A02,083208,Lim; Seonhee,10,2,35,25
1656114366705,MATH 10B,A03,093472,Staff,4,3,34,30
1656114366705,MATH 10B,B01,083739,Sinha; Shubham,12,0,30,18
1656114372730,MATH 18,A01,083743,Cinel; Cameron Alexander,7,0,30,23
1656114372730,MATH 18,A02,083744,Cinel; Cameron Alexander,10,0,30,20
1656114372730,MATH 18,A03,083745,Cinel; Cameron Alexander,3,0,30,27
1656114372730,MATH 18,B01,083748,Staff,0,0,36,36
1656114372730,MATH 18,B02,083749,Staff,0,0,36,36
1656114372730,MATH 18,B03,083750,Staff,0,0,36,36
1656114372730,MATH 18,B04,083751,Staff,0,0,36,36
1656114372730,MATH 18,B05,093473,Staff,2,0,36,34
1656114372730,MATH 18,B06,093474,Staff,4,0,36,32
1656114378754,MATH 20A,A01,083754,Zheng; Zequn,11,0,40,29
1656114384778,MATH 20B,A01,083756,Briones; Jor-el Thomas Caparas,0,0,36,36
1656114384778,MATH 20B,A02,083757,Briones; Jor-el Thomas Caparas,0,0,36,36
1656114384778,MATH 20B,A03,093475,Staff,2,0,36,34
1656114390802,MATH 20C,A01,083760,Briones; Jor-el Thomas Caparas,2,2,35,33
1656114390802,MATH 20C,A02,083761,Briones; Jor-el Thomas Caparas,9,1,35,26
1656114390802,MATH 20C,A03,093476,Staff,1,1,35,34
1656114390802,MATH 20C,B01,083762,Bach; Quang Tran,1,0,30,29
1656114396827,MATH 20D,A01,083765,Tran; Brian Kha,2,0,30,28
1656114396827,MATH 20D,A02,083766,Tran; Brian Kha,0,1,30,30
1656114396827,MATH 20D,A03,083767,Tran; Brian Kha,2,0,30,28
1656114402857,MATH 20E,A01,083771,Ganguly; Soumya,4,1,32,28
1656114402857,MATH 20E,A02,083772,Ganguly; Soumya,2,2,32,30
1656114402857,MATH 20E,B01,083773,Ciotti; Benjamin,14,0,35,21
1656114402857,MATH 20E,B02,083774,Ciotti; Benjamin,14,0,35,21
1656114408885,MATH 103A,A01,083777,Greenfeld; Be'Eri,2,0,36,34
1656114408885,MATH 103A,A02,083778,Greenfeld; Be'Eri,2,0,36,34
1656114408885,MATH 103A,A03,093561,Staff,4,1,36,32
1656114408885,MATH 103A,B01,083779,Greenfeld; Be'Eri,8,1,36,28
1656114408885,MATH 103A,B02,083780,Greenfeld; Be'Eri,0,0,36,36
1656114408885,MATH 103A,B03,093562,Staff,0,0,36,36
1656114414908,MATH 105,A01,085443,Carter; Anne Toulson,4,1,35,31
1656114414908,MATH 105,A02,093477,Staff,9,0,35,26
1656114420932,MATH 109,A01,083213,Ganzberger; Geoffrey Michael,1,1,34,33
1656114420932,MATH 109,A02,083214,Ganzberger; Geoffrey Michael,0,0,34,34
1656114420932,MATH 109,A03,093478,Staff,1,0,34,33
1656114420932,MATH 109,B01,083215,Ganzberger; Geoffrey Michael,3,0,32,29
1656114420932,MATH 109,B02,083216,Ganzberger; Geoffrey Michael,1,0,32,31
1656114420932,MATH 109,B03,093479,Staff,4,0,32,28
1656114426956,MATH 142A,A01,083219,Chow; Bennett,1,0,32,31
1656114426956,MATH 142A,A02,083220,Chow; Bennett,8,0,32,24
1656114426956,MATH 142A,A03,093480,Staff,5,0,32,27
1656114426956,MATH 142A,B03,093481,Staff,4,0,32,28
1656114426956,MATH 142A,B04,093558,Staff,5,0,32,27
1656114426956,MATH 142A,B05,093559,Staff,0,0,32,32
1656114432988,MATH 193A,A01,083224,Rotar; Vladimir,1,2,34,33
1656114432988,MATH 193A,A02,083225,Rotar; Vladimir,1,0,34,33
1656114432988,MATH 193A,A03,083781,Rotar; Vladimir,1,0,34,33
1656114432988,MATH 193A,A04,083782,Rotar; Vladimir,6,0,34,28
1656114432988,MATH 193A,A05,093482,Rotar; Vladimir,1,0,34,33
1656114439014,MATH 197,001,091859,McAuley; Julian John,9999,0,9999,0
1656114439014,MATH 197,002,095566,Kedlaya; Kiran S.,9997,0,9999,2
1656114439014,MATH 197,003,095567,Xiao; Ming,9999,0,9999,0
1656114439014,MATH 197,004,095571,Perols; Johan Lars,9998,0,9999,1
1656114446078,COGS 9,A01,083615,Shannon; Kyle Michael,5,1,75,70
1656114452101,COGS 11,A01,083617,Boyle; Mary E. T.,16,2,48,32
1656114458124,COGS 13,A01,083071,Bastos; Amalia Pinkusfeld,8,3,71,63
1656114464147,COGS 14A,A01,092681,Semenuks; Arturs,8,24,100,92
1656114470171,COGS 14B,A01,083073,Cheng; Tzu-Han,7,0,63,56
1656114476197,COGS 17,A01,092677,Semenuks; Arturs,13,6,81,68
1656114482222,COGS 100,A01,083619,Allen; Michael Gordon,7,4,70,63
1656114488249,COGS 101A,A01,083621,Davis; Joshua Daniel,7,3,68,61
1656114494278,COGS 101B,A01,091572,Allen; Michael Gordon,6,0,65,59
1656114500302,COGS 101C,A01,083625,Delgado; Tania,11,0,35,24
1656114506325,COGS 107A,A01,083627,Boyle; Mary E. T.,5,4,60,55
1656114512351,COGS 118A,A01,083075,Gupta; Anjum,24,17,76,52
1656114518379,CSE 3,A50,083646,Miranda; Gregory Joseph,18,0,50,32
1656114524408,CSE 8A,A50,083650,Miranda; Gregory Joseph,13,12,56,43
1656114530432,CSE 11,A01,083080,Cao; Yingjun,1,59,40,39
1656114536456,CSE 12,A01,083652,Krause-Levy; Sophia Louisa,14,8,120,106
1656114542480,CSE 15L,A01,083654,Morris; Justin Loren,5,2,50,45
1656114542480,CSE 15L,A02,083655,Morris; Justin Loren,7,2,50,43
1656114548506,CSE 20,A01,083657,Tran; Khoa Dang,31,0,80,49
1656114554528,CSE 21,A01,095574,Bach; Quang Tran,25,0,48,23
1656114560552,CSE 30,A01,083084,Eldon; John,3,11,80,77
1656114560552,CSE 30,B01,095061,Bhaskar; Nishant,4,5,50,46
1656114566579,CSE 100,A01,083659,Cao; Yingjun,2,22,70,68
1656114572603,CSE 134B,A01,083661,Powell; Thomas Allan,10,8,100,90
1656114578634,CSE 140,A01,083663,Gungor; Onat,9,0,85,76
1656114584658,CSE 140L,A01,083088,Eldon; John,8,0,100,92
1656114590680,CSE 175,A01,083665,Kumar; Rakesh,0,0,25,25
1656114596706,CSE 190,A00,092507,Dubnov; Shlomo,2,0,20,18
1656114602730,ECE 45,A01,083139,Congero; Spencer William,5,4,75,70
1656114608757,ECE 65,A50,083695,Saad; Andrew S,8,0,30,22
1656114608757,ECE 65,A51,095125,Staff,23,0,26,3
1656114614781,ECE 109,A01,091882,Touri; Behrouz,7,7,70,63
1656114620808,ECE 180,A00,083140,Abi Samra; Nicholas Camill,1,0,30,29
1656114620808,ECE 180,B00,083141,Abi Samra; Nicholas Camill,4,8,30,26
1656114626840,MATH 10A,A01,083735,Patchell; Gregory David,0,0,30,30
1656114626840,MATH 10A,A02,083736,Patchell; Gregory David,22,0,30,8
1656114626840,MATH 10A,A03,083737,Patchell; Gregory David,16,0,30,14
1656114632865,MATH 10B,A01,083207,Lim; Seonhee,3,3,34,31
1656114632865,MATH 10B,A02,083208,Lim; Seonhee,10,2,35,25
1656114632865,MATH 10B,A03,093472,Staff,4,3,34,30
1656114632865,MATH 10B,B01,083739,Sinha; Shubham,12,0,30,18
1656114638888,MATH 18,A01,083743,Cinel; Cameron Alexander,7,0,30,23
1656114638888,MATH 18,A02,083744,Cinel; Cameron Alexander,10,0,30,20
1656114638888,MATH 18,A03,083745,Cinel; Cameron Alexander,3,0,30,27
1656114638888,MATH 18,B01,083748,Staff,0,0,36,36
1656114638888,MATH 18,B02,083749,Staff,0,0,36,36
1656114638888,MATH 18,B03,083750,Staff,0,0,36,36
1656114638888,MATH 18,B04,083751,Staff,0,0,36,36
1656114638888,MATH 18,B05,093473,Staff,2,0,36,34
1656114638888,MATH 18,B06,093474,Staff,4,0,36,32
1656114644917,MATH 20A,A01,083754,Zheng; Zequn,11,0,40,29
1656114650944,MATH 20B,A01,083756,Briones; Jor-el Thomas Caparas,0,0,36,36
1656114650944,MATH 20B,A02,083757,Briones; Jor-el Thomas Caparas,0,0,36,36
1656114650944,MATH 20B,A03,093475,Staff,2,0,36,34
1656114656967,MATH 20C,A01,083760,Briones; Jor-el Thomas Caparas,2,2,35,33
1656114656967,MATH 20C,A02,083761,Briones; Jor-el Thomas Caparas,9,1,35,26
1656114656967,MATH 20C,A03,093476,Staff,1,1,35,34
1656114656967,MATH 20C,B01,083762,Bach; Quang Tran,1,0,30,29
1656114662999,MATH 20D,A01,083765,Tran; Brian Kha,2,0,30,28
1656114662999,MATH 20D,A02,083766,Tran; Brian Kha,0,1,30,30
1656114662999,MATH 20D,A03,083767,Tran; Brian Kha,2,0,30,28
1656114669023,MATH 20E,A01,083771,Ganguly; Soumya,4,1,32,28
1656114669023,MATH 20E,A02,083772,Ganguly; Soumya,2,2,32,30
1656114669023,MATH 20E,B01,083773,Ciotti; Benjamin,14,0,35,21
1656114669023,MATH 20E,B02,083774,Ciotti; Benjamin,14,0,35,21
1656114675047,MATH 103A,A01,083777,Greenfeld; Be'Eri,2,0,36,34
1656114675047,MATH 103A,A02,083778,Greenfeld; Be'Eri,2,0,36,34
1656114675047,MATH 103A,A03,093561,Staff,4,1,36,32
1656114675047,MATH 103A,B01,083779,Greenfeld; Be'Eri,8,1,36,28
1656114675047,MATH 103A,B02,083780,Greenfeld; Be'Eri,0,0,36,36
1656114675047,MATH 103A,B03,093562,Staff,0,0,36,36
1656114681069,MATH 105,A01,085443,Carter; Anne Toulson,4,1,35,31
1656114681069,MATH 105,A02,093477,Staff,9,0,35,26
1656114687099,MATH 109,A01,083213,Ganzberger; Geoffrey Michael,1,1,34,33
1656114687099,MATH 109,A02,083214,Ganzberger; Geoffrey Michael,0,0,34,34
1656114687099,MATH 109,A03,093478,Staff,1,0,34,33
1656114687099,MATH 109,B01,083215,Ganzberger; Geoffrey Michael,3,0,32,29
1656114687099,MATH 109,B02,083216,Ganzberger; Geoffrey Michael,1,0,32,31
1656114687099,MATH 109,B03,093479,Staff,4,0,32,28
1656114693124,MATH 142A,A01,083219,Chow; Bennett,1,0,32,31
1656114693124,MATH 142A,A02,083220,Chow; Bennett,8,0,32,24
1656114693124,MATH 142A,A03,093480,Staff,5,0,32,27
1656114693124,MATH 142A,B03,093481,Staff,4,0,32,28
1656114693124,MATH 142A,B04,093558,Staff,5,0,32,27
1656114693124,MATH 142A,B05,093559,Staff,0,0,32,32
1656114699147,MATH 193A,A01,083224,Rotar; Vladimir,1,2,34,33
1656114699147,MATH 193A,A02,083225,Rotar; Vladimir,1,0,34,33
1656114699147,MATH 193A,A03,083781,Rotar; Vladimir,1,0,34,33
1656114699147,MATH 193A,A04,083782,Rotar; Vladimir,6,0,34,28
1656114699147,MATH 193A,A05,093482,Rotar; Vladimir,1,0,34,33
1656114705171,MATH 197,001,091859,McAuley; Julian John,9999,0,9999,0
1656114705171,MATH 197,002,095566,Kedlaya; Kiran S.,9997,0,9999,2
1656114705171,MATH 197,003,095567,Xiao; Ming,9999,0,9999,0
1656114705171,MATH 197,004,095571,Perols; Johan Lars,9998,0,9999,1
1656114712324,COGS 9,A01,083615,Shannon; Kyle Michael,5,1,75,70
1656114718348,COGS 11,A01,083617,Boyle; Mary E. T.,16,2,48,32
1656114724376,COGS 13,A01,083071,Bastos; Amalia Pinkusfeld,8,3,71,63
1656114730399,COGS 14A,A01,092681,Semenuks; Arturs,8,24,100,92
1656114736425,COGS 14B,A01,083073,Cheng; Tzu-Han,7,0,63,56
1656114742448,COGS 17,A01,092677,Semenuks; Arturs,13,6,81,68
1656114748472,COGS 100,A01,083619,Allen; Michael Gordon,7,4,70,63
1656114754495,COGS 101A,A01,083621,Davis; Joshua Daniel,7,3,68,61
1656114760518,COGS 101B,A01,091572,Allen; Michael Gordon,6,0,65,59
1656114766552,COGS 101C,A01,083625,Delgado; Tania,11,0,35,24
1656114772574,COGS 107A,A01,083627,Boyle; Mary E. T.,5,4,60,55
1656114778597,COGS 118A,A01,083075,Gupta; Anjum,24,17,76,52
1656114784625,CSE 3,A50,083646,Miranda; Gregory Joseph,18,0,50,32
1656114790648,CSE 8A,A50,083650,Miranda; Gregory Joseph,13,12,56,43
1656114796676,CSE 11,A01,083080,Cao; Yingjun,1,59,40,39
1656114802708,CSE 12,A01,083652,Krause-Levy; Sophia Louisa,14,8,120,106
1656114808731,CSE 15L,A01,083654,Morris; Justin Loren,5,2,50,45
1656114808731,CSE 15L,A02,083655,Morris; Justin Loren,7,2,50,43
1656114814755,CSE 20,A01,083657,Tran; Khoa Dang,31,0,80,49
1656114820789,CSE 21,A01,095574,Bach; Quang Tran,25,0,48,23
1656114826814,CSE 30,A01,083084,Eldon; John,3,11,80,77
1656114826814,CSE 30,B01,095061,Bhaskar; Nishant,4,5,50,46
1656114832838,CSE 100,A01,083659,Cao; Yingjun,2,22,70,68
1656114838871,CSE 134B,A01,083661,Powell; Thomas Allan,11,8,100,89
1656114844895,CSE 140,A01,083663,Gungor; Onat,9,0,85,76
1656114850932,CSE 140L,A01,083088,Eldon; John,8,0,100,92
1656114856958,CSE 175,A01,083665,Kumar; Rakesh,0,0,25,25
1656114862981,CSE 190,A00,092507,Dubnov; Shlomo,2,0,20,18
1656114869004,ECE 45,A01,083139,Congero; Spencer William,5,4,75,70
1656114875027,ECE 65,A50,083695,Saad; Andrew S,8,0,30,22
1656114875027,ECE 65,A51,095125,Staff,23,0,26,3
1656114881051,ECE 109,A01,091882,Touri; Behrouz,7,7,70,63
1656114887074,ECE 180,A00,083140,Abi Samra; Nicholas Camill,1,0,30,29
1656114887074,ECE 180,B00,083141,Abi Samra; Nicholas Camill,4,8,30,26
1656114893102,MATH 10A,A01,083735,Patchell; Gregory David,0,0,30,30
1656114893102,MATH 10A,A02,083736,Patchell; Gregory David,22,0,30,8
1656114893102,MATH 10A,A03,083737,Patchell; Gregory David,16,0,30,14
1656114899129,MATH 10B,A01,083207,Lim; Seonhee,3,3,34,31
1656114899129,MATH 10B,A02,083208,Lim; Seonhee,10,2,35,25
1656114899129,MATH 10B,A03,093472,Staff,4,3,34,30
1656114899129,MATH 10B,B01,083739,Sinha; Shubham,12,0,30,18
1656114905153,MATH 18,A01,083743,Cinel; Cameron Alexander,7,0,30,23
1656114905153,MATH 18,A02,083744,Cinel; Cameron Alexander,10,0,30,20
1656114905153,MATH 18,A03,083745,Cinel; Cameron Alexander,3,0,30,27
1656114905153,MATH 18,B01,083748,Staff,0,0,36,36
1656114905153,MATH 18,B02,083749,Staff,0,0,36,36
1656114905153,MATH 18,B03,083750,Staff,0,0,36,36
1656114905153,MATH 18,B04,083751,Staff,0,0,36,36
1656114905153,MATH 18,B05,093473,Staff,2,0,36,34
1656114905153,MATH 18,B06,093474,Staff,4,0,36,32
1656114911176,MATH 20A,A01,083754,Zheng; Zequn,11,0,40,29
1656114917198,MATH 20B,A01,083756,Briones; Jor-el Thomas Caparas,0,0,36,36
1656114917198,MATH 20B,A02,083757,Briones; Jor-el Thomas Caparas,0,0,36,36
1656114917198,MATH 20B,A03,093475,Staff,2,0,36,34
1656114923222,MATH 20C,A01,083760,Briones; Jor-el Thomas Caparas,2,2,35,33
1656114923222,MATH 20C,A02,083761,Briones; Jor-el Thomas Caparas,9,1,35,26
1656114923222,MATH 20C,A03,093476,Staff,1,1,35,34
1656114923222,MATH 20C,B01,083762,Bach; Quang Tran,1,0,30,29
1656114929246,MATH 20D,A01,083765,Tran; Brian Kha,2,0,30,28
1656114929246,MATH 20D,A02,083766,Tran; Brian Kha,0,1,30,30
1656114929246,MATH 20D,A03,083767,Tran; Brian Kha,2,0,30,28
1656114935274,MATH 20E,A01,083771,Ganguly; Soumya,4,1,32,28
1656114935274,MATH 20E,A02,083772,Ganguly; Soumya,2,2,32,30
1656114935274,MATH 20E,B01,083773,Ciotti; Benjamin,14,0,35,21
1656114935274,MATH 20E,B02,083774,Ciotti; Benjamin,14,0,35,21
1656114941296,MATH 103A,A01,083777,Greenfeld; Be'Eri,2,0,36,34
1656114941296,MATH 103A,A02,083778,Greenfeld; Be'Eri,2,0,36,34
1656114941296,MATH 103A,A03,093561,Staff,4,1,36,32
1656114941296,MATH 103A,B01,083779,Greenfeld; Be'Eri,8,1,36,28
1656114941296,MATH 103A,B02,083780,Greenfeld; Be'Eri,0,0,36,36
1656114941296,MATH 103A,B03,093562,Staff,0,0,36,36
1656114947321,MATH 105,A01,085443,Carter; Anne Toulson,4,1,35,31
1656114947321,MATH 105,A02,093477,Staff,9,0,35,26
1656114953350,MATH 109,A01,083213,Ganzberger; Geoffrey Michael,1,1,34,33
1656114953350,MATH 109,A02,083214,Ganzberger; Geoffrey Michael,0,0,34,34
1656114953350,MATH 109,A03,093478,Staff,1,0,34,33
1656114953350,MATH 109,B01,083215,Ganzberger; Geoffrey Michael,3,0,32,29
1656114953350,MATH 109,B02,083216,Ganzberger; Geoffrey Michael,1,0,32,31
1656114953350,MATH 109,B03,093479,Staff,4,0,32,28
1656114959388,MATH 142A,A01,083219,Chow; Bennett,1,0,32,31
1656114959388,MATH 142A,A02,083220,Chow; Bennett,8,0,32,24
1656114959388,MATH 142A,A03,093480,Staff,5,0,32,27
1656114959388,MATH 142A,B03,093481,Staff,4,0,32,28
1656114959388,MATH 142A,B04,093558,Staff,5,0,32,27
1656114959388,MATH 142A,B05,093559,Staff,0,0,32,32
1656114965412,MATH 193A,A01,083224,Rotar; Vladimir,1,2,34,33
1656114965412,MATH 193A,A02,083225,Rotar; Vladimir,1,0,34,33
1656114965412,MATH 193A,A03,083781,Rotar; Vladimir,1,0,34,33
1656114965412,MATH 193A,A04,083782,Rotar; Vladimir,6,0,34,28
1656114965412,MATH 193A,A05,093482,Rotar; Vladimir,1,0,34,33
1656114971435,MATH 197,001,091859,McAuley; Julian John,9999,0,9999,0
1656114971435,MATH 197,002,095566,Kedlaya; Kiran S.,9997,0,9999,2
1656114971435,MATH 197,003,095567,Xiao; Ming,9999,0,9999,0
1656114971435,MATH 197,004,095571,Perols; Johan Lars,9998,0,9999,1
1656114978488,COGS 9,A01,083615,Shannon; Kyle Michael,5,1,75,70
1656114984521,COGS 11,A01,083617,Boyle; Mary E. T.,16,2,48,32
1656114990547,COGS 13,A01,083071,Bastos; Amalia Pinkusfeld,8,3,71,63
1656114996570,COGS 14A,A01,092681,Semenuks; Arturs,8,24,100,92
1656115002599,COGS 14B,A01,083073,Cheng; Tzu-Han,7,0,63,56
1656115008625,COGS 17,A01,092677,Semenuks; Arturs,13,6,81,68
1656115014648,COGS 100,A01,083619,Allen; Michael Gordon,7,4,70,63
1656115020675,COGS 101A,A01,083621,Davis; Joshua Daniel,7,3,68,61
1656115026708,COGS 101B,A01,091572,Allen; Michael Gordon,6,0,65,59
1656115032732,COGS 101C,A01,083625,Delgado; Tania,11,0,35,24
1656115038760,COGS 107A,A01,083627,Boyle; Mary E. T.,5,4,60,55
1656115044784,COGS 118A,A01,083075,Gupta; Anjum,24,17,76,52
1656115050808,CSE 3,A50,083646,Miranda; Gregory Joseph,18,0,50,32
1656115056837,CSE 8A,A50,083650,Miranda; Gregory Joseph,13,12,56,43
1656115062867,CSE 11,A01,083080,Cao; Yingjun,1,59,40,39
1656115068893,CSE 12,A01,083652,Krause-Levy; Sophia Louisa,14,8,120,106
1656115074920,CSE 15L,A01,083654,Morris; Justin Loren,5,2,50,45
1656115074920,CSE 15L,A02,083655,Morris; Justin Loren,7,2,50,43
1656115080944,CSE 20,A01,083657,Tran; Khoa Dang,31,0,80,49
1656115086980,CSE 21,A01,095574,Bach; Quang Tran,25,0,48,23
1656115093004,CSE 30,A01,083084,Eldon; John,3,11,80,77
1656115093004,CSE 30,B01,095061,Bhaskar; Nishant,4,5,50,46
1656115099031,CSE 100,A01,083659,Cao; Yingjun,2,22,70,68
1656115105062,CSE 134B,A01,083661,Powell; Thomas Allan,11,8,100,89
1656115111096,CSE 140,A01,083663,Gungor; Onat,9,0,85,76
1656115117120,CSE 140L,A01,083088,Eldon; John,8,0,100,92
1656115123143,CSE 175,A01,083665,Kumar; Rakesh,0,0,25,25
1656115129171,CSE 190,A00,092507,Dubnov; Shlomo,2,0,20,18
1656115135196,ECE 45,A01,083139,Congero; Spencer William,5,4,75,70
1656115141229,ECE 65,A50,083695,Saad; Andrew S,8,0,30,22
1656115141229,ECE 65,A51,095125,Staff,23,0,26,3
1656115147252,ECE 109,A01,091882,Touri; Behrouz,7,7,70,63
1656115153275,ECE 180,A00,083140,Abi Samra; Nicholas Camill,1,0,30,29
1656115153275,ECE 180,B00,083141,Abi Samra; Nicholas Camill,4,8,30,26
1656115159298,MATH 10A,A01,083735,Patchell; Gregory David,0,0,30,30
1656115159298,MATH 10A,A02,083736,Patchell; Gregory David,22,0,30,8
1656115159298,MATH 10A,A03,083737,Patchell; Gregory David,16,0,30,14
1656115165320,MATH 10B,A01,083207,Lim; Seonhee,3,3,34,31
1656115165320,MATH 10B,A02,083208,Lim; Seonhee,10,2,35,25
1656115165320,MATH 10B,A03,093472,Staff,4,3,34,30
1656115165320,MATH 10B,B01,083739,Sinha; Shubham,12,0,30,18
1656115171343,MATH 18,A01,083743,Cinel; Cameron Alexander,7,0,30,23
1656115171343,MATH 18,A02,083744,Cinel; Cameron Alexander,10,0,30,20
1656115171343,MATH 18,A03,083745,Cinel; Cameron Alexander,3,0,30,27
1656115171343,MATH 18,B01,083748,Staff,0,0,36,36
1656115171343,MATH 18,B02,083749,Staff,0,0,36,36
1656115171343,MATH 18,B03,083750,Staff,0,0,36,36
1656115171343,MATH 18,B04,083751,Staff,0,0,36,36
1656115171343,MATH 18,B05,093473,Staff,2,0,36,34
1656115171343,MATH 18,B06,093474,Staff,4,0,36,32
1656115177374,MATH 20A,A01,083754,Zheng; Zequn,11,0,40,29
1656115183398,MATH 20B,A01,083756,Briones; Jor-el Thomas Caparas,0,0,36,36
1656115183398,MATH 20B,A02,083757,Briones; Jor-el Thomas Caparas,0,0,36,36
1656115183398,MATH 20B,A03,093475,Staff,2,0,36,34
1656115189427,MATH 20C,A01,083760,Briones; Jor-el Thomas Caparas,2,2,35,33
1656115189427,MATH 20C,A02,083761,Briones; Jor-el Thomas Caparas,9,1,35,26
1656115189427,MATH 20C,A03,093476,Staff,1,1,35,34
1656115189427,MATH 20C,B01,083762,Bach; Quang Tran,1,0,30,29
1656115195453,MATH 20D,A01,083765,Tran; Brian Kha,2,0,30,28
1656115195453,MATH 20D,A02,083766,Tran; Brian Kha,0,1,30,30
1656115195453,MATH 20D,A03,083767,Tran; Brian Kha,2,0,30,28
1656115201484,MATH 20E,A01,083771,Ganguly; Soumya,4,1,32,28
1656115201484,MATH 20E,A02,083772,Ganguly; Soumya,2,2,32,30
1656115201484,MATH 20E,B01,083773,Ciotti; Benjamin,14,0,35,21
1656115201484,MATH 20E,B02,083774,Ciotti; Benjamin,14,0,35,21
1656115207513,MATH 103A,A01,083777,Greenfeld; Be'Eri,2,0,36,34
1656115207513,MATH 103A,A02,083778,Greenfeld; Be'Eri,2,0,36,34
1656115207513,MATH 103A,A03,093561,Staff,4,1,36,32
1656115207513,MATH 103A,B01,083779,Greenfeld; Be'Eri,8,1,36,28
1656115207513,MATH 103A,B02,083780,Greenfeld; Be'Eri,0,0,36,36
1656115207513,MATH 103A,B03,093562,Staff,0,0,36,36
1656115213536,MATH 105,A01,085443,Carter; Anne Toulson,4,1,35,31
1656115213536,MATH 105,A02,093477,Staff,9,0,35,26
1656115219561,MATH 109,A01,083213,Ganzberger; Geoffrey Michael,1,1,34,33
1656115219561,MATH 109,A02,083214,Ganzberger; Geoffrey Michael,0,0,34,34
1656115219561,MATH 109,A03,093478,Staff,1,0,34,33
1656115219561,MATH 109,B01,083215,Ganzberger; Geoffrey Michael,3,0,32,29
1656115219561,MATH 109,B02,083216,Ganzberger; Geoffrey Michael,1,0,32,31
1656115219561,MATH 109,B03,093479,Staff,4,0,32,28
1656115225600,MATH 142A,A01,083219,Chow; Bennett,1,0,32,31
1656115225600,MATH 142A,A02,083220,Chow; Bennett,8,0,32,24
1656115225600,MATH 142A,A03,093480,Staff,5,0,32,27
1656115225600,MATH 142A,B03,093481,Staff,4,0,32,28
1656115225600,MATH 142A,B04,093558,Staff,5,0,32,27
1656115225600,MATH 142A,B05,093559,Staff,0,0,32,32
1656115231625,MATH 193A,A01,083224,Rotar; Vladimir,1,2,34,33
1656115231625,MATH 193A,A02,083225,Rotar; Vladimir,1,0,34,33
1656115231625,MATH 193A,A03,083781,Rotar; Vladimir,1,0,34,33
1656115231625,MATH 193A,A04,083782,Rotar; Vladimir,6,0,34,28
1656115231625,MATH 193A,A05,093482,Rotar; Vladimir,1,0,34,33
1656115237648,MATH 197,001,091859,McAuley; Julian John,9999,0,9999,0
1656115237648,MATH 197,002,095566,Kedlaya; Kiran S.,9997,0,9999,2
1656115237648,MATH 197,003,095567,Xiao; Ming,9999,0,9999,0
1656115237648,MATH 197,004,095571,Perols; Johan Lars,9998,0,9999,1
1656115244715,COGS 9,A01,083615,Shannon; Kyle Michael,5,1,75,70
1656115250739,COGS 11,A01,083617,Boyle; Mary E. T.,16,2,48,32
1656115256765,COGS 13,A01,083071,Bastos; Amalia Pinkusfeld,8,3,71,63
1656115262789,COGS 14A,A01,092681,Semenuks; Arturs,8,24,100,92
1656115268813,COGS 14B,A01,083073,Cheng; Tzu-Han,7,0,63,56
1656115274840,COGS 17,A01,092677,Semenuks; Arturs,13,6,81,68
1656115280867,COGS 100,A01,083619,Allen; Michael Gordon,7,4,70,63
1656115286891,COGS 101A,A01,083621,Davis; Joshua Daniel,7,3,68,61
1656115292915,COGS 101B,A01,091572,Allen; Michael Gordon,6,0,65,59
1656115298940,COGS 101C,A01,083625,Delgado; Tania,11,0,35,24
1656115304969,COGS 107A,A01,083627,Boyle; Mary E. T.,5,4,60,55
1656115311087,COGS 118A,A01,083075,Gupta; Anjum,24,17,76,52
1656115317120,CSE 3,A50,083646,Miranda; Gregory Joseph,18,0,50,32
1656115323147,CSE 8A,A50,083650,Miranda; Gregory Joseph,13,12,56,43
1656115329169,CSE 11,A01,083080,Cao; Yingjun,1,59,40,39
1656115335196,CSE 12,A01,083652,Krause-Levy; Sophia Louisa,14,8,120,106
1656115341224,CSE 15L,A01,083654,Morris; Justin Loren,5,2,50,45
1656115341224,CSE 15L,A02,083655,Morris; Justin Loren,7,2,50,43
1656115347247,CSE 20,A01,083657,Tran; Khoa Dang,31,0,80,49
1656115353271,CSE 21,A01,095574,Bach; Quang Tran,25,0,48,23
1656115359294,CSE 30,A01,083084,Eldon; John,3,11,80,77
1656115359294,CSE 30,B01,095061,Bhaskar; Nishant,4,5,50,46
1656115365321,CSE 100,A01,083659,Cao; Yingjun,2,22,70,68
1656115371346,CSE 134B,A01,083661,Powell; Thomas Allan,11,8,100,89
1656115377369,CSE 140,A01,083663,Gungor; Onat,9,0,85,76
1656115383398,CSE 140L,A01,083088,Eldon; John,8,0,100,92
1656115389421,CSE 175,A01,083665,Kumar; Rakesh,0,0,25,25
1656115395453,CSE 190,A00,092507,Dubnov; Shlomo,2,0,20,18
1656115401477,ECE 45,A01,083139,Congero; Spencer William,5,4,75,70
1656115407503,ECE 65,A50,083695,Saad; Andrew S,8,0,30,22
1656115407503,ECE 65,A51,095125,Staff,23,0,26,3
1656115413531,ECE 109,A01,091882,Touri; Behrouz,7,7,70,63
1656115419553,ECE 180,A00,083140,Abi Samra; Nicholas Camill,1,0,30,29
1656115419553,ECE 180,B00,083141,Abi Samra; Nicholas Camill,4,8,30,26
1656115425582,MATH 10A,A01,083735,Patchell; Gregory David,0,0,30,30
1656115425582,MATH 10A,A02,083736,Patchell; Gregory David,22,0,30,8
1656115425582,MATH 10A,A03,083737,Patchell; Gregory David,16,0,30,14
1656115431605,MATH 10B,A01,083207,Lim; Seonhee,3,3,34,31
1656115431605,MATH 10B,A02,083208,Lim; Seonhee,10,2,35,25
1656115431605,MATH 10B,A03,093472,Staff,4,3,34,30
1656115431605,MATH 10B,B01,083739,Sinha; Shubham,12,0,30,18
1656115437631,MATH 18,A01,083743,Cinel; Cameron Alexander,7,0,30,23
1656115437631,MATH 18,A02,083744,Cinel; Cameron Alexander,10,0,30,20
1656115437631,MATH 18,A03,083745,Cinel; Cameron Alexander,3,0,30,27
1656115437631,MATH 18,B01,083748,Staff,0,0,36,36
1656115437631,MATH 18,B02,083749,Staff,0,0,36,36
1656115437631,MATH 18,B03,083750,Staff,0,0,36,36
1656115437631,MATH 18,B04,083751,Staff,0,0,36,36
1656115437631,MATH 18,B05,093473,Staff,2,0,36,34
1656115437631,MATH 18,B06,093474,Staff,4,0,36,32
1656115443662,MATH 20A,A01,083754,Zheng; Zequn,11,0,40,29
1656115449687,MATH 20B,A01,083756,Briones; Jor-el Thomas Caparas,0,0,36,36
1656115449687,MATH 20B,A02,083757,Briones; Jor-el Thomas Caparas,0,0,36,36
1656115449687,MATH 20B,A03,093475,Staff,2,0,36,34
1656115455721,MATH 20C,A01,083760,Briones; Jor-el Thomas Caparas,2,2,35,33
1656115455721,MATH 20C,A02,083761,Briones; Jor-el Thomas Caparas,9,1,35,26
1656115455721,MATH 20C,A03,093476,Staff,1,1,35,34
1656115455721,MATH 20C,B01,083762,Bach; Quang Tran,1,0,30,29
1656115461746,MATH 20D,A01,083765,Tran; Brian Kha,2,0,30,28
1656115461746,MATH 20D,A02,083766,Tran; Brian Kha,0,1,30,30
1656115461746,MATH 20D,A03,083767,Tran; Brian Kha,2,0,30,28
1656115467771,MATH 20E,A01,083771,Ganguly; Soumya,4,1,32,28
1656115467771,MATH 20E,A02,083772,Ganguly; Soumya,2,2,32,30
1656115467771,MATH 20E,B01,083773,Ciotti; Benjamin,14,0,35,21
1656115467771,MATH 20E,B02,083774,Ciotti; Benjamin,14,0,35,21
1656115473801,MATH 103A,A01,083777,Greenfeld; Be'Eri,2,0,36,34
1656115473801,MATH 103A,A02,083778,Greenfeld; Be'Eri,2,0,36,34
1656115473801,MATH 103A,A03,093561,Staff,4,1,36,32
1656115473801,MATH 103A,B01,083779,Greenfeld; Be'Eri,8,1,36,28
1656115473801,MATH 103A,B02,083780,Greenfeld; Be'Eri,0,0,36,36
1656115473801,MATH 103A,B03,093562,Staff,0,0,36,36
1656115479837,MATH 105,A01,085443,Carter; Anne Toulson,4,1,35,31
1656115479837,MATH 105,A02,093477,Staff,9,0,35,26
1656115485861,MATH 109,A01,083213,Ganzberger; Geoffrey Michael,1,1,34,33
1656115485861,MATH 109,A02,083214,Ganzberger; Geoffrey Michael,0,0,34,34
1656115485861,MATH 109,A03,093478,Staff,1,0,34,33
1656115485861,MATH 109,B01,083215,Ganzberger; Geoffrey Michael,3,0,32,29
1656115485861,MATH 109,B02,083216,Ganzberger; Geoffrey Michael,1,0,32,31
1656115485861,MATH 109,B03,093479,Staff,4,0,32,28
1656115491886,MATH 142A,A01,083219,Chow; Bennett,1,0,32,31
1656115491886,MATH 142A,A02,083220,Chow; Bennett,8,0,32,24
1656115491886,MATH 142A,A03,093480,Staff,5,0,32,27
1656115491886,MATH 142A,B03,093481,Staff,4,0,32,28
1656115491886,MATH 142A,B04,093558,Staff,5,0,32,27
1656115491886,MATH 142A,B05,093559,Staff,0,0,32,32
1656115497910,MATH 193A,A01,083224,Rotar; Vladimir,1,2,34,33
1656115497910,MATH 193A,A02,083225,Rotar; Vladimir,1,0,34,33
1656115497910,MATH 193A,A03,083781,Rotar; Vladimir,1,0,34,33
1656115497910,MATH 193A,A04,083782,Rotar; Vladimir,6,0,34,28
1656115497910,MATH 193A,A05,093482,Rotar; Vladimir,1,0,34,33
1656115503939,MATH 197,001,091859,McAuley; Julian John,9999,0,9999,0
1656115503939,MATH 197,002,095566,Kedlaya; Kiran S.,9997,0,9999,2
1656115503939,MATH 197,003,095567,Xiao; Ming,9999,0,9999,0
1656115503939,MATH 197,004,095571,Perols; Johan Lars,9998,0,9999,1
1656115511015,COGS 9,A01,083615,Shannon; Kyle Michael,5,1,75,70
1656115517043,COGS 11,A01,083617,Boyle; Mary E. T.,16,2,48,32
1656115523067,COGS 13,A01,083071,Bastos; Amalia Pinkusfeld,8,3,71,63
1656115529098,COGS 14A,A01,092681,Semenuks; Arturs,8,24,100,92
1656115535126,COGS 14B,A01,083073,Cheng; Tzu-Han,7,0,63,56
1656115541155,COGS 17,A01,092677,Semenuks; Arturs,13,6,81,68
1656115547178,COGS 100,A01,083619,Allen; Michael Gordon,7,5,70,63
1656115553209,COGS 101A,A01,083621,Davis; Joshua Daniel,7,3,68,61
1656115559232,COGS 101B,A01,091572,Allen; Michael Gordon,6,0,65,59
1656115565257,COGS 101C,A01,083625,Delgado; Tania,11,0,35,24
1656115571291,COGS 107A,A01,083627,Boyle; Mary E. T.,5,4,60,55
1656115577315,COGS 118A,A01,083075,Gupta; Anjum,24,17,76,52
1656115583338,CSE 3,A50,083646,Miranda; Gregory Joseph,18,0,50,32
1656115589361,CSE 8A,A50,083650,Miranda; Gregory Joseph,13,12,56,43
1656115595393,CSE 11,A01,083080,Cao; Yingjun,1,59,40,39
1656115601417,CSE 12,A01,083652,Krause-Levy; Sophia Louisa,14,8,120,106
1656115607444,CSE 15L,A01,083654,Morris; Justin Loren,5,2,50,45
1656115607444,CSE 15L,A02,083655,Morris; Justin Loren,7,2,50,43
1656115613472,CSE 20,A01,083657,Tran; Khoa Dang,31,0,80,49
1656115619496,CSE 21,A01,095574,Bach; Quang Tran,25,0,48,23
1656115625519,CSE 30,A01,083084,Eldon; John,3,11,80,77
1656115625519,CSE 30,B01,095061,Bhaskar; Nishant,4,5,50,46
1656115631543,CSE 100,A01,083659,Cao; Yingjun,2,22,70,68
1656115637566,CSE 134B,A01,083661,Powell; Thomas Allan,11,8,100,89
1656115643596,CSE 140,A01,083663,Gungor; Onat,9,0,85,76
1656115649619,CSE 140L,A01,083088,Eldon; John,8,0,100,92
1656115655646,CSE 175,A01,083665,Kumar; Rakesh,0,0,25,25
1656115661676,CSE 190,A00,092507,Dubnov; Shlomo,2,0,20,18
1656115667706,ECE 45,A01,083139,Congero; Spencer William,5,4,75,70
1656115673744,ECE 65,A50,083695,Saad; Andrew S,8,0,30,22
1656115673744,ECE 65,A51,095125,Staff,23,0,26,3
1656115679769,ECE 109,A01,091882,Touri; Behrouz,7,7,70,63
1656115685793,ECE 180,A00,083140,Abi Samra; Nicholas Camill,1,0,30,29
1656115685793,ECE 180,B00,083141,Abi Samra; Nicholas Camill,4,8,30,26
1656115691816,MATH 10A,A01,083735,Patchell; Gregory David,0,0,30,30
1656115691816,MATH 10A,A02,083736,Patchell; Gregory David,22,0,30,8
1656115691816,MATH 10A,A03,083737,Patchell; Gregory David,16,0,30,14
1656115697841,MATH 10B,A01,083207,Lim; Seonhee,3,3,34,31
1656115697841,MATH 10B,A02,083208,Lim; Seonhee,10,2,35,25
1656115697841,MATH 10B,A03,093472,Staff,4,3,34,30
1656115697841,MATH 10B,B01,083739,Sinha; Shubham,12,0,30,18
1656115703866,MATH 18,A01,083743,Cinel; Cameron Alexander,7,0,30,23
1656115703866,MATH 18,A02,083744,Cinel; Cameron Alexander,10,0,30,20
1656115703866,MATH 18,A03,083745,Cinel; Cameron Alexander,3,0,30,27
1656115703866,MATH 18,B01,083748,Rideout; David Porter,0,0,36,36
1656115703866,MATH 18,B02,083749,Rideout; David Porter,0,0,36,36
1656115703866,MATH 18,B03,083750,Rideout; David Porter,0,0,36,36
1656115703866,MATH 18,B04,083751,Rideout; David Porter,0,0,36,36
1656115703866,MATH 18,B05,093473,Rideout; David Porter,2,0,36,34
1656115703866,MATH 18,B06,093474,Rideout; David Porter,4,0,36,32
1656115709890,MATH 20A,A01,083754,Zheng; Zequn,11,0,40,29
1656115715919,MATH 20B,A01,083756,Briones; Jor-el Thomas Caparas,0,0,36,36
1656115715919,MATH 20B,A02,083757,Briones; Jor-el Thomas Caparas,0,0,36,36
1656115715919,MATH 20B,A03,093475,Staff,2,0,36,34
1656115721948,MATH 20C,A01,083760,Briones; Jor-el Thomas Caparas,2,2,35,33
1656115721948,MATH 20C,A02,083761,Briones; Jor-el Thomas Caparas,9,1,35,26
1656115721948,MATH 20C,A03,093476,Staff,1,1,35,34
1656115721948,MATH 20C,B01,083762,Bach; Quang Tran,1,0,30,29
1656115727983,MATH 20D,A01,083765,Tran; Brian Kha,2,0,30,28
1656115727983,MATH 20D,A02,083766,Tran; Brian Kha,0,1,30,30
1656115727983,MATH 20D,A03,083767,Tran; Brian Kha,2,0,30,28
1656115734007,MATH 20E,A01,083771,Ganguly; Soumya,4,1,32,28
1656115734007,MATH 20E,A02,083772,Ganguly; Soumya,2,2,32,30
1656115734007,MATH 20E,B01,083773,Ciotti; Benjamin,14,0,35,21
1656115734007,MATH 20E,B02,083774,Ciotti; Benjamin,14,0,35,21
1656115740032,MATH 103A,A01,083777,Greenfeld; Be'Eri,2,0,36,34
1656115740032,MATH 103A,A02,083778,Greenfeld; Be'Eri,2,0,36,34
1656115740032,MATH 103A,A03,093561,Staff,4,1,36,32
1656115740032,MATH 103A,B01,083779,Greenfeld; Be'Eri,8,1,36,28
1656115740032,MATH 103A,B02,083780,Greenfeld; Be'Eri,0,0,36,36
1656115740032,MATH 103A,B03,093562,Staff,0,0,36,36
1656115746059,MATH 105,A01,085443,Carter; Anne Toulson,4,1,35,31
1656115746059,MATH 105,A02,093477,Staff,9,0,35,26
1656115752083,MATH 109,A01,083213,Ganzberger; Geoffrey Michael,1,1,34,33
1656115752083,MATH 109,A02,083214,Ganzberger; Geoffrey Michael,0,0,34,34
1656115752083,MATH 109,A03,093478,Staff,1,0,34,33
1656115752083,MATH 109,B01,083215,Ganzberger; Geoffrey Michael,3,0,32,29
1656115752083,MATH 109,B02,083216,Ganzberger; Geoffrey Michael,1,0,32,31
1656115752083,MATH 109,B03,093479,Staff,4,0,32,28
1656115758107,MATH 142A,A01,083219,Chow; Bennett,1,0,32,31
1656115758107,MATH 142A,A02,083220,Chow; Bennett,8,0,32,24
1656115758107,MATH 142A,A03,093480,Staff,5,0,32,27
1656115758107,MATH 142A,B03,093481,Staff,4,0,32,28
1656115758107,MATH 142A,B04,093558,Staff,5,0,32,27
1656115758107,MATH 142A,B05,093559,Staff,0,0,32,32
1656115764131,MATH 193A,A01,083224,Rotar; Vladimir,1,2,34,33
1656115764131,MATH 193A,A02,083225,Rotar; Vladimir,1,0,34,33
1656115764131,MATH 193A,A03,083781,Rotar; Vladimir,1,0,34,33
1656115764131,MATH 193A,A04,083782,Rotar; Vladimir,6,0,34,28
1656115764131,MATH 193A,A05,093482,Rotar; Vladimir,1,0,34,33
1656115770160,MATH 197,001,091859,McAuley; Julian John,9999,0,9999,0
1656115770160,MATH 197,002,095566,Kedlaya; Kiran S.,9997,0,9999,2
1656115770160,MATH 197,003,095567,Xiao; Ming,9999,0,9999,0
1656115770160,MATH 197,004,095571,Perols; Johan Lars,9998,0,9999,1
1656115777229,COGS 9,A01,083615,Shannon; Kyle Michael,5,1,75,70
1656115783254,COGS 11,A01,083617,Boyle; Mary E. T.,16,2,48,32
1656115789280,COGS 13,A01,083071,Bastos; Amalia Pinkusfeld,8,3,71,63
1656115795304,COGS 14A,A01,092681,Semenuks; Arturs,8,24,100,92
1656115801330,COGS 14B,A01,083073,Cheng; Tzu-Han,7,0,63,56
1656115807352,COGS 17,A01,092677,Semenuks; Arturs,13,6,81,68
1656115813381,COGS 100,A01,083619,Allen; Michael Gordon,7,5,70,63
1656115819405,COGS 101A,A01,083621,Davis; Joshua Daniel,7,3,68,61
1656115825429,COGS 101B,A01,091572,Allen; Michael Gordon,6,0,65,59
1656115831452,COGS 101C,A01,083625,Delgado; Tania,11,0,35,24
1656115837474,COGS 107A,A01,083627,Boyle; Mary E. T.,5,4,60,55
1656115843497,COGS 118A,A01,083075,Gupta; Anjum,24,17,76,52
1656115849524,CSE 3,A50,083646,Miranda; Gregory Joseph,18,0,50,32
1656115855545,CSE 8A,A50,083650,Miranda; Gregory Joseph,13,12,56,43
1656115861569,CSE 11,A01,083080,Cao; Yingjun,1,59,40,39
1656115867591,CSE 12,A01,083652,Krause-Levy; Sophia Louisa,14,8,120,106
1656115873619,CSE 15L,A01,083654,Morris; Justin Loren,5,2,50,45
1656115873619,CSE 15L,A02,083655,Morris; Justin Loren,7,2,50,43
1656115879644,CSE 20,A01,083657,Tran; Khoa Dang,31,0,80,49
1656115885666,CSE 21,A01,095574,Bach; Quang Tran,25,0,48,23
1656115891695,CSE 30,A01,083084,Eldon; John,3,11,80,77
1656115891695,CSE 30,B01,095061,Bhaskar; Nishant,4,5,50,46
1656115897724,CSE 100,A01,083659,Cao; Yingjun,2,22,70,68
1656115903748,CSE 134B,A01,083661,Powell; Thomas Allan,11,8,100,89
1656115909859,CSE 140,A01,083663,Gungor; Onat,9,0,85,76
1656115915888,CSE 140L,A01,083088,Eldon; John,8,0,100,92
1656115921915,CSE 175,A01,083665,Kumar; Rakesh,0,0,25,25
1656115927936,CSE 190,A00,092507,Dubnov; Shlomo,2,0,20,18
1656115933972,ECE 45,A01,083139,Congero; Spencer William,5,4,75,70
1656115939995,ECE 65,A50,083695,Saad; Andrew S,8,0,30,22
1656115939995,ECE 65,A51,095125,Staff,23,0,26,3
1656115946023,ECE 109,A01,091882,Touri; Behrouz,7,7,70,63
1656115952066,ECE 180,A00,083140,Abi Samra; Nicholas Camill,1,0,30,29
1656115952066,ECE 180,B00,083141,Abi Samra; Nicholas Camill,4,8,30,26
1656115958095,MATH 10A,A01,083735,Patchell; Gregory David,0,0,30,30
1656115958095,MATH 10A,A02,083736,Patchell; Gregory David,22,0,30,8
1656115958095,MATH 10A,A03,083737,Patchell; Gregory David,16,0,30,14
1656115964129,MATH 10B,A01,083207,Lim; Seonhee,3,3,34,31
1656115964129,MATH 10B,A02,083208,Lim; Seonhee,10,2,35,25
1656115964129,MATH 10B,A03,093472,Staff,4,3,34,30
1656115964129,MATH 10B,B01,083739,Sinha; Shubham,12,0,30,18
1656115970155,MATH 18,A01,083743,Cinel; Cameron Alexander,7,0,30,23
1656115970155,MATH 18,A02,083744,Cinel; Cameron Alexander,10,0,30,20
1656115970155,MATH 18,A03,083745,Cinel; Cameron Alexander,3,0,30,27
1656115970155,MATH 18,B01,083748,Rideout; David Porter,0,0,36,36
1656115970155,MATH 18,B02,083749,Rideout; David Porter,0,0,36,36
1656115970155,MATH 18,B03,083750,Rideout; David Porter,0,0,36,36
1656115970155,MATH 18,B04,083751,Rideout; David Porter,0,0,36,36
1656115970155,MATH 18,B05,093473,Rideout; David Porter,2,0,36,34
1656115970155,MATH 18,B06,093474,Rideout; David Porter,4,0,36,32
1656115976184,MATH 20A,A01,083754,Zheng; Zequn,11,0,40,29
1656115982216,MATH 20B,A01,083756,Briones; Jor-el Thomas Caparas,0,0,36,36
1656115982216,MATH 20B,A02,083757,Briones; Jor-el Thomas Caparas,0,0,36,36
1656115982216,MATH 20B,A03,093475,Staff,2,0,36,34
1656115988255,MATH 20C,A01,083760,Briones; Jor-el Thomas Caparas,2,2,35,33
1656115988255,MATH 20C,A02,083761,Briones; Jor-el Thomas Caparas,9,1,35,26
1656115988255,MATH 20C,A03,093476,Staff,1,1,35,34
1656115988255,MATH 20C,B01,083762,Bach; Quang Tran,1,0,30,29
1656115994287,MATH 20D,A01,083765,Tran; Brian Kha,2,0,30,28
1656115994287,MATH 20D,A02,083766,Tran; Brian Kha,0,1,30,30
1656115994287,MATH 20D,A03,083767,Tran; Brian Kha,2,0,30,28
1656116000317,MATH 20E,A01,083771,Ganguly; Soumya,4,1,32,28
1656116000317,MATH 20E,A02,083772,Ganguly; Soumya,2,2,32,30
1656116000317,MATH 20E,B01,083773,Ciotti; Benjamin,14,0,35,21
1656116000317,MATH 20E,B02,083774,Ciotti; Benjamin,14,0,35,21
1656116006350,MATH 103A,A01,083777,Greenfeld; Be'Eri,2,0,36,34
1656116006350,MATH 103A,A02,083778,Greenfeld; Be'Eri,2,0,36,34
1656116006350,MATH 103A,A03,093561,Staff,4,1,36,32
1656116006350,MATH 103A,B01,083779,Greenfeld; Be'Eri,8,1,36,28
1656116006350,MATH 103A,B02,083780,Greenfeld; Be'Eri,0,0,36,36
1656116006350,MATH 103A,B03,093562,Staff,0,0,36,36
1656116012380,MATH 105,A01,085443,Carter; Anne Toulson,4,1,35,31
1656116012380,MATH 105,A02,093477,Staff,9,0,35,26
1656116018421,MATH 109,A01,083213,Ganzberger; Geoffrey Michael,1,1,34,33
1656116018421,MATH 109,A02,083214,Ganzberger; Geoffrey Michael,0,0,34,34
1656116018421,MATH 109,A03,093478,Staff,1,0,34,33
1656116018421,MATH 109,B01,083215,Ganzberger; Geoffrey Michael,3,0,32,29
1656116018421,MATH 109,B02,083216,Ganzberger; Geoffrey Michael,1,0,32,31
1656116018421,MATH 109,B03,093479,Staff,4,0,32,28
1656116024454,MATH 142A,A01,083219,Chow; Bennett,1,0,32,31
1656116024454,MATH 142A,A02,083220,Chow; Bennett,8,0,32,24
1656116024454,MATH 142A,A03,093480,Staff,5,0,32,27
1656116024454,MATH 142A,B03,093481,Staff,4,0,32,28
1656116024454,MATH 142A,B04,093558,Staff,5,0,32,27
1656116024454,MATH 142A,B05,093559,Staff,0,0,32,32
1656116030478,MATH 193A,A01,083224,Rotar; Vladimir,1,2,34,33
1656116030478,MATH 193A,A02,083225,Rotar; Vladimir,1,0,34,33
1656116030478,MATH 193A,A03,083781,Rotar; Vladimir,1,0,34,33
1656116030478,MATH 193A,A04,083782,Rotar; Vladimir,6,0,34,28
1656116030478,MATH 193A,A05,093482,Rotar; Vladimir,1,0,34,33
1656116036502,MATH 197,001,091859,McAuley; Julian John,9999,0,9999,0
1656116036502,MATH 197,002,095566,Kedlaya; Kiran S.,9997,0,9999,2
1656116036502,MATH 197,003,095567,Xiao; Ming,9999,0,9999,0
1656116036502,MATH 197,004,095571,Perols; Johan Lars,9998,0,9999,1
1656116043565,COGS 9,A01,083615,Shannon; Kyle Michael,5,1,75,70
1656116049593,COGS 11,A01,083617,Boyle; Mary E. T.,16,2,48,32
1656116055616,COGS 13,A01,083071,Bastos; Amalia Pinkusfeld,8,3,71,63
1656116061654,COGS 14A,A01,092681,Semenuks; Arturs,8,24,100,92
1656116067678,COGS 14B,A01,083073,Cheng; Tzu-Han,7,0,63,56
1656116073701,COGS 17,A01,092677,Semenuks; Arturs,13,6,81,68
1656116079726,COGS 100,A01,083619,Allen; Michael Gordon,7,5,70,63
1656116085765,COGS 101A,A01,083621,Davis; Joshua Daniel,7,3,68,61
1656116091790,COGS 101B,A01,091572,Allen; Michael Gordon,6,0,65,59
1656116097814,COGS 101C,A01,083625,Delgado; Tania,11,0,35,24
1656116103846,COGS 107A,A01,083627,Boyle; Mary E. T.,5,4,60,55
1656116109869,COGS 118A,A01,083075,Gupta; Anjum,24,17,76,52
1656116115894,CSE 3,A50,083646,Miranda; Gregory Joseph,18,0,50,32
1656116121922,CSE 8A,A50,083650,Miranda; Gregory Joseph,13,12,56,43
1656116127949,CSE 11,A01,083080,Cao; Yingjun,1,59,40,39
1656116133977,CSE 12,A01,083652,Krause-Levy; Sophia Louisa,14,8,120,106
1656116140001,CSE 15L,A01,083654,Morris; Justin Loren,5,2,50,45
1656116140001,CSE 15L,A02,083655,Morris; Justin Loren,7,2,50,43
1656116146027,CSE 20,A01,083657,Tran; Khoa Dang,31,0,80,49
1656116152054,CSE 21,A01,095574,Bach; Quang Tran,25,0,48,23
1656116158083,CSE 30,A01,083084,Eldon; John,3,11,80,77
1656116158083,CSE 30,B01,095061,Bhaskar; Nishant,4,5,50,46
1656116164105,CSE 100,A01,083659,Cao; Yingjun,2,22,70,68
1656116170130,CSE 134B,A01,083661,Powell; Thomas Allan,11,8,100,89
1656116176156,CSE 140,A01,083663,Gungor; Onat,9,0,85,76
1656116182179,CSE 140L,A01,083088,Eldon; John,8,0,100,92
1656116188207,CSE 175,A01,083665,Kumar; Rakesh,0,0,25,25
1656116194234,CSE 190,A00,092507,Dubnov; Shlomo,2,0,20,18
1656116200257,ECE 45,A01,083139,Congero; Spencer William,5,4,75,70
1656116206281,ECE 65,A50,083695,Saad; Andrew S,8,0,30,22
1656116206281,ECE 65,A51,095125,Staff,23,0,26,3
1656116212303,ECE 109,A01,091882,Touri; Behrouz,7,7,70,63
1656116218327,ECE 180,A00,083140,Abi Samra; Nicholas Camill,1,0,30,29
1656116218327,ECE 180,B00,083141,Abi Samra; Nicholas Camill,4,8,30,26
1656116224362,MATH 10A,A01,083735,Patchell; Gregory David,0,0,30,30
1656116224362,MATH 10A,A02,083736,Patchell; Gregory David,22,0,30,8
1656116224362,MATH 10A,A03,083737,Patchell; Gregory David,16,0,30,14
1656116230387,MATH 10B,A01,083207,Lim; Seonhee,3,3,34,31
1656116230387,MATH 10B,A02,083208,Lim; Seonhee,10,2,35,25
1656116230387,MATH 10B,A03,093472,Staff,4,3,34,30
1656116230387,MATH 10B,B01,083739,Sinha; Shubham,12,0,30,18
1656116236413,MATH 18,A01,083743,Cinel; Cameron Alexander,7,0,30,23
1656116236413,MATH 18,A02,083744,Cinel; Cameron Alexander,10,0,30,20
1656116236413,MATH 18,A03,083745,Cinel; Cameron Alexander,3,0,30,27
1656116236413,MATH 18,B01,083748,Rideout; David Porter,0,0,36,36
1656116236413,MATH 18,B02,083749,Rideout; David Porter,0,0,36,36
1656116236413,MATH 18,B03,083750,Rideout; David Porter,0,0,36,36
1656116236413,MATH 18,B04,083751,Rideout; David Porter,0,0,36,36
1656116236413,MATH 18,B05,093473,Rideout; David Porter,2,0,36,34
1656116236413,MATH 18,B06,093474,Rideout; David Porter,4,0,36,32
1656116242435,MATH 20A,A01,083754,Zheng; Zequn,11,0,40,29
1656116248462,MATH 20B,A01,083756,Briones; Jor-el Thomas Caparas,0,0,36,36
1656116248462,MATH 20B,A02,083757,Briones; Jor-el Thomas Caparas,0,0,36,36
1656116248462,MATH 20B,A03,093475,Staff,2,0,36,34
1656116254485,MATH 20C,A01,083760,Briones; Jor-el Thomas Caparas,2,2,35,33
1656116254485,MATH 20C,A02,083761,Briones; Jor-el Thomas Caparas,9,1,35,26
1656116254485,MATH 20C,A03,093476,Staff,1,1,35,34
1656116254485,MATH 20C,B01,083762,Bach; Quang Tran,1,0,30,29
1656116260513,MATH 20D,A01,083765,Tran; Brian Kha,2,0,30,28
1656116260513,MATH 20D,A02,083766,Tran; Brian Kha,0,1,30,30
1656116260513,MATH 20D,A03,083767,Tran; Brian Kha,2,0,30,28
1656116266554,MATH 20E,A01,083771,Ganguly; Soumya,4,1,32,28
1656116266554,MATH 20E,A02,083772,Ganguly; Soumya,2,2,32,30
1656116266554,MATH 20E,B01,083773,Ciotti; Benjamin,14,0,35,21
1656116266554,MATH 20E,B02,083774,Ciotti; Benjamin,14,0,35,21
1656116272583,MATH 103A,A01,083777,Greenfeld; Be'Eri,2,0,36,34
1656116272583,MATH 103A,A02,083778,Greenfeld; Be'Eri,2,0,36,34
1656116272583,MATH 103A,A03,093561,Staff,4,1,36,32
1656116272583,MATH 103A,B01,083779,Greenfeld; Be'Eri,8,1,36,28
1656116272583,MATH 103A,B02,083780,Greenfeld; Be'Eri,0,0,36,36
1656116272583,MATH 103A,B03,093562,Staff,0,0,36,36
1656116278605,MATH 105,A01,085443,Carter; Anne Toulson,4,1,35,31
1656116278605,MATH 105,A02,093477,Staff,9,0,35,26
1656116284637,MATH 109,A01,083213,Ganzberger; Geoffrey Michael,1,1,34,33
1656116284637,MATH 109,A02,083214,Ganzberger; Geoffrey Michael,0,0,34,34
1656116284637,MATH 109,A03,093478,Staff,1,0,34,33
1656116284637,MATH 109,B01,083215,Ganzberger; Geoffrey Michael,3,0,32,29
1656116284637,MATH 109,B02,083216,Ganzberger; Geoffrey Michael,1,0,32,31
1656116284637,MATH 109,B03,093479,Staff,4,0,32,28
1656116290661,MATH 142A,A01,083219,Chow; Bennett,1,0,32,31
1656116290661,MATH 142A,A02,083220,Chow; Bennett,8,0,32,24
1656116290661,MATH 142A,A03,093480,Staff,5,0,32,27
1656116290661,MATH 142A,B03,093481,Staff,4,0,32,28
1656116290661,MATH 142A,B04,093558,Staff,5,0,32,27
1656116290661,MATH 142A,B05,093559,Staff,0,0,32,32
1656116296685,MATH 193A,A01,083224,Rotar; Vladimir,1,2,34,33
1656116296685,MATH 193A,A02,083225,Rotar; Vladimir,1,0,34,33
1656116296685,MATH 193A,A03,083781,Rotar; Vladimir,1,0,34,33
1656116296685,MATH 193A,A04,083782,Rotar; Vladimir,6,0,34,28
1656116296685,MATH 193A,A05,093482,Rotar; Vladimir,1,0,34,33
1656116302718,MATH 197,001,091859,McAuley; Julian John,9999,0,9999,0
1656116302718,MATH 197,002,095566,Kedlaya; Kiran S.,9997,0,9999,2
1656116302718,MATH 197,003,095567,Xiao; Ming,9999,0,9999,0
1656116302718,MATH 197,004,095571,Perols; Johan Lars,9998,0,9999,1
1656116309770,COGS 9,A01,083615,Shannon; Kyle Michael,5,1,75,70
1656116315795,COGS 11,A01,083617,Boyle; Mary E. T.,16,2,48,32
1656116321819,COGS 13,A01,083071,Bastos; Amalia Pinkusfeld,8,3,71,63
1656116327842,COGS 14A,A01,092681,Semenuks; Arturs,8,24,100,92
1656116333870,COGS 14B,A01,083073,Cheng; Tzu-Han,7,0,63,56
1656116339912,COGS 17,A01,092677,Semenuks; Arturs,13,6,81,68
1656116345939,COGS 100,A01,083619,Allen; Michael Gordon,7,5,70,63
1656116351967,COGS 101A,A01,083621,Davis; Joshua Daniel,7,3,68,61
1656116357991,COGS 101B,A01,091572,Allen; Michael Gordon,6,0,65,59
1656116364014,COGS 101C,A01,083625,Delgado; Tania,11,0,35,24
1656116370037,COGS 107A,A01,083627,Boyle; Mary E. T.,5,4,60,55
1656116376063,COGS 118A,A01,083075,Gupta; Anjum,24,17,76,52
1656116382087,CSE 3,A50,083646,Miranda; Gregory Joseph,18,0,50,32
1656116388111,CSE 8A,A50,083650,Miranda; Gregory Joseph,13,12,56,43
1656116394134,CSE 11,A01,083080,Cao; Yingjun,1,59,40,39
1656116400157,CSE 12,A01,083652,Krause-Levy; Sophia Louisa,14,8,120,106
1656116406181,CSE 15L,A01,083654,Morris; Justin Loren,5,2,50,45
1656116406181,CSE 15L,A02,083655,Morris; Justin Loren,7,2,50,43
1656116412205,CSE 20,A01,083657,Tran; Khoa Dang,31,0,80,49
1656116418233,CSE 21,A01,095574,Bach; Quang Tran,25,0,48,23
1656116424257,CSE 30,A01,083084,Eldon; John,3,11,80,77
1656116424257,CSE 30,B01,095061,Bhaskar; Nishant,4,5,50,46
1656116430282,CSE 100,A01,083659,Cao; Yingjun,2,22,70,68
1656116436305,CSE 134B,A01,083661,Powell; Thomas Allan,11,8,100,89
1656116442334,CSE 140,A01,083663,Gungor; Onat,9,0,85,76
1656116448357,CSE 140L,A01,083088,Eldon; John,8,0,100,92
1656116454381,CSE 175,A01,083665,Kumar; Rakesh,0,0,25,25
1656116460406,CSE 190,A00,092507,Dubnov; Shlomo,2,0,20,18
1656116466427,ECE 45,A01,083139,Congero; Spencer William,5,4,75,70
1656116472451,ECE 65,A50,083695,Saad; Andrew S,8,0,30,22
1656116472451,ECE 65,A51,095125,Staff,23,0,26,3
1656116478474,ECE 109,A01,091882,Touri; Behrouz,7,7,70,63
1656116484498,ECE 180,A00,083140,Abi Samra; Nicholas Camill,1,0,30,29
1656116484498,ECE 180,B00,083141,Abi Samra; Nicholas Camill,4,8,30,26
1656116490522,MATH 10A,A01,083735,Patchell; Gregory David,0,0,30,30
1656116490522,MATH 10A,A02,083736,Patchell; Gregory David,22,0,30,8
1656116490522,MATH 10A,A03,083737,Patchell; Gregory David,16,0,30,14
1656116496547,MATH 10B,A01,083207,Lim; Seonhee,3,3,34,31
1656116496547,MATH 10B,A02,083208,Lim; Seonhee,10,2,35,25
1656116496547,MATH 10B,A03,093472,Staff,4,3,34,30
1656116496547,MATH 10B,B01,083739,Sinha; Shubham,12,0,30,18
1656116502580,MATH 18,A01,083743,Cinel; Cameron Alexander,7,0,30,23
1656116502580,MATH 18,A02,083744,Cinel; Cameron Alexander,10,0,30,20
1656116502580,MATH 18,A03,083745,Cinel; Cameron Alexander,3,0,30,27
1656116502580,MATH 18,B01,083748,Rideout; David Porter,0,0,36,36
1656116502580,MATH 18,B02,083749,Rideout; David Porter,0,0,36,36
1656116502580,MATH 18,B03,083750,Rideout; David Porter,0,0,36,36
1656116502580,MATH 18,B04,083751,Rideout; David Porter,0,0,36,36
1656116502580,MATH 18,B05,093473,Rideout; David Porter,2,0,36,34
1656116502580,MATH 18,B06,093474,Rideout; David Porter,4,0,36,32
1656116508689,MATH 20A,A01,083754,Zheng; Zequn,11,0,40,29
1656116514714,MATH 20B,A01,083756,Briones; Jor-el Thomas Caparas,0,0,36,36
1656116514714,MATH 20B,A02,083757,Briones; Jor-el Thomas Caparas,0,0,36,36
1656116514714,MATH 20B,A03,093475,Staff,2,0,36,34
1656116520739,MATH 20C,A01,083760,Briones; Jor-el Thomas Caparas,2,2,35,33
1656116520739,MATH 20C,A02,083761,Briones; Jor-el Thomas Caparas,9,1,35,26
1656116520739,MATH 20C,A03,093476,Staff,1,1,35,34
1656116520739,MATH 20C,B01,083762,Bach; Quang Tran,1,0,30,29
1656116526766,MATH 20D,A01,083765,Tran; Brian Kha,2,0,30,28
1656116526766,MATH 20D,A02,083766,Tran; Brian Kha,0,1,30,30
1656116526766,MATH 20D,A03,083767,Tran; Brian Kha,2,0,30,28
1656116532804,MATH 20E,A01,083771,Ganguly; Soumya,4,1,32,28
1656116532804,MATH 20E,A02,083772,Ganguly; Soumya,2,2,32,30
1656116532804,MATH 20E,B01,083773,Ciotti; Benjamin,14,0,35,21
1656116532804,MATH 20E,B02,083774,Ciotti; Benjamin,14,0,35,21
1656116538826,MATH 103A,A01,083777,Greenfeld; Be'Eri,2,0,36,34
1656116538826,MATH 103A,A02,083778,Greenfeld; Be'Eri,2,0,36,34
1656116538826,MATH 103A,A03,093561,Staff,4,1,36,32
1656116538826,MATH 103A,B01,083779,Greenfeld; Be'Eri,8,1,36,28
1656116538826,MATH 103A,B02,083780,Greenfeld; Be'Eri,0,0,36,36
1656116538826,MATH 103A,B03,093562,Staff,0,0,36,36
1656116544853,MATH 105,A01,085443,Carter; Anne Toulson,4,1,35,31
1656116544853,MATH 105,A02,093477,Staff,9,0,35,26
1656116550881,MATH 109,A01,083213,Ganzberger; Geoffrey Michael,1,1,34,33
1656116550881,MATH 109,A02,083214,Ganzberger; Geoffrey Michael,0,0,34,34
1656116550881,MATH 109,A03,093478,Staff,1,0,34,33
1656116550881,MATH 109,B01,083215,Ganzberger; Geoffrey Michael,3,0,32,29
1656116550881,MATH 109,B02,083216,Ganzberger; Geoffrey Michael,1,0,32,31
1656116550881,MATH 109,B03,093479,Staff,4,0,32,28
1656116556905,MATH 142A,A01,083219,Chow; Bennett,1,0,32,31
1656116556905,MATH 142A,A02,083220,Chow; Bennett,8,0,32,24
1656116556905,MATH 142A,A03,093480,Staff,5,0,32,27
1656116556905,MATH 142A,B03,093481,Staff,4,0,32,28
1656116556905,MATH 142A,B04,093558,Staff,5,0,32,27
1656116556905,MATH 142A,B05,093559,Staff,0,0,32,32
1656116562929,MATH 193A,A01,083224,Rotar; Vladimir,1,2,34,33
1656116562929,MATH 193A,A02,083225,Rotar; Vladimir,1,0,34,33
1656116562929,MATH 193A,A03,083781,Rotar; Vladimir,1,0,34,33
1656116562929,MATH 193A,A04,083782,Rotar; Vladimir,6,0,34,28
1656116562929,MATH 193A,A05,093482,Rotar; Vladimir,1,0,34,33
1656116568954,MATH 197,001,091859,McAuley; Julian John,9999,0,9999,0
1656116568954,MATH 197,002,095566,Kedlaya; Kiran S.,9997,0,9999,2
1656116568954,MATH 197,003,095567,Xiao; Ming,9999,0,9999,0
1656116568954,MATH 197,004,095571,Perols; Johan Lars,9998,0,9999,1
1656116576007,COGS 9,A01,083615,Shannon; Kyle Michael,5,1,75,70
1656116582041,COGS 11,A01,083617,Boyle; Mary E. T.,16,2,48,32
1656116588065,COGS 13,A01,083071,Bastos; Amalia Pinkusfeld,8,3,71,63
1656116594092,COGS 14A,A01,092681,Semenuks; Arturs,8,24,100,92
1656116600120,COGS 14B,A01,083073,Cheng; Tzu-Han,7,0,63,56
1656116606144,COGS 17,A01,092677,Semenuks; Arturs,13,6,81,68
1656116612171,COGS 100,A01,083619,Allen; Michael Gordon,7,5,70,63
1656116618207,COGS 101A,A01,083621,Davis; Joshua Daniel,7,3,68,61
1656116624236,COGS 101B,A01,091572,Allen; Michael Gordon,6,0,65,59
1656116630263,COGS 101C,A01,083625,Delgado; Tania,11,0,35,24
1656116636289,COGS 107A,A01,083627,Boyle; Mary E. T.,5,4,60,55
1656116642320,COGS 118A,A01,083075,Gupta; Anjum,24,17,76,52
1656116648352,CSE 3,A50,083646,Miranda; Gregory Joseph,18,0,50,32
1656116654381,CSE 8A,A50,083650,Miranda; Gregory Joseph,13,12,56,43
1656116660410,CSE 11,A01,083080,Cao; Yingjun,1,59,40,39
1656116666440,CSE 12,A01,083652,Krause-Levy; Sophia Louisa,14,8,120,106
1656116672463,CSE 15L,A01,083654,Morris; Justin Loren,5,2,50,45
1656116672463,CSE 15L,A02,083655,Morris; Justin Loren,7,2,50,43
1656116678487,CSE 20,A01,083657,Tran; Khoa Dang,31,0,80,49
1656116684511,CSE 21,A01,095574,Bach; Quang Tran,25,0,48,23
1656116690535,CSE 30,A01,083084,Eldon; John,3,11,80,77
1656116690535,CSE 30,B01,095061,Bhaskar; Nishant,4,5,50,46
1656116696558,CSE 100,A01,083659,Cao; Yingjun,2,22,70,68
1656116702583,CSE 134B,A01,083661,Powell; Thomas Allan,11,8,100,89
1656116708606,CSE 140,A01,083663,Gungor; Onat,9,0,85,76
1656116714629,CSE 140L,A01,083088,Eldon; John,8,0,100,92
1656116720656,CSE 175,A01,083665,Kumar; Rakesh,0,0,25,25
1656116726683,CSE 190,A00,092507,Dubnov; Shlomo,2,0,20,18
1656116732711,ECE 45,A01,083139,Congero; Spencer William,5,4,75,70
1656116738736,ECE 65,A50,083695,Saad; Andrew S,8,0,30,22
1656116738736,ECE 65,A51,095125,Staff,23,0,26,3
1656116744757,ECE 109,A01,091882,Touri; Behrouz,7,7,70,63
1656116750785,ECE 180,A00,083140,Abi Samra; Nicholas Camill,1,0,30,29
1656116750785,ECE 180,B00,083141,Abi Samra; Nicholas Camill,4,8,30,26
1656116756808,MATH 10A,A01,083735,Patchell; Gregory David,0,0,30,30
1656116756808,MATH 10A,A02,083736,Patchell; Gregory David,22,0,30,8
1656116756808,MATH 10A,A03,083737,Patchell; Gregory David,16,0,30,14
1656116762842,MATH 10B,A01,083207,Lim; Seonhee,3,3,34,31
1656116762842,MATH 10B,A02,083208,Lim; Seonhee,10,2,35,25
1656116762842,MATH 10B,A03,093472,Staff,4,3,34,30
1656116762842,MATH 10B,B01,083739,Sinha; Shubham,12,0,30,18
1656116768867,MATH 18,A01,083743,Cinel; Cameron Alexander,7,0,30,23
1656116768867,MATH 18,A02,083744,Cinel; Cameron Alexander,10,0,30,20
1656116768867,MATH 18,A03,083745,Cinel; Cameron Alexander,3,0,30,27
1656116768867,MATH 18,B01,083748,Rideout; David Porter,0,0,36,36
1656116768867,MATH 18,B02,083749,Rideout; David Porter,0,0,36,36
1656116768867,MATH 18,B03,083750,Rideout; David Porter,0,0,36,36
1656116768867,MATH 18,B04,083751,Rideout; David Porter,0,0,36,36
1656116768867,MATH 18,B05,093473,Rideout; David Porter,2,0,36,34
1656116768867,MATH 18,B06,093474,Rideout; David Porter,4,0,36,32
1656116774891,MATH 20A,A01,083754,Zheng; Zequn,11,0,40,29
1656116780914,MATH 20B,A01,083756,Briones; Jor-el Thomas Caparas,0,0,36,36
1656116780914,MATH 20B,A02,083757,Briones; Jor-el Thomas Caparas,0,0,36,36
1656116780914,MATH 20B,A03,093475,Staff,2,0,36,34
1656116786944,MATH 20C,A01,083760,Briones; Jor-el Thomas Caparas,2,2,35,33
1656116786944,MATH 20C,A02,083761,Briones; Jor-el Thomas Caparas,9,1,35,26
1656116786944,MATH 20C,A03,093476,Staff,1,1,35,34
1656116786944,MATH 20C,B01,083762,Bach; Quang Tran,1,0,30,29
1656116792972,MATH 20D,A01,083765,Tran; Brian Kha,2,0,30,28
1656116792972,MATH 20D,A02,083766,Tran; Brian Kha,0,1,30,30
1656116792972,MATH 20D,A03,083767,Tran; Brian Kha,2,0,30,28
1656116798996,MATH 20E,A01,083771,Ganguly; Soumya,4,1,32,28
1656116798996,MATH 20E,A02,083772,Ganguly; Soumya,2,2,32,30
1656116798996,MATH 20E,B01,083773,Ciotti; Benjamin,14,0,35,21
1656116798996,MATH 20E,B02,083774,Ciotti; Benjamin,14,0,35,21
1656116805028,MATH 103A,A01,083777,Greenfeld; Be'Eri,2,0,36,34
1656116805028,MATH 103A,A02,083778,Greenfeld; Be'Eri,2,0,36,34
1656116805028,MATH 103A,A03,093561,Staff,4,1,36,32
1656116805028,MATH 103A,B01,083779,Greenfeld; Be'Eri,8,1,36,28
1656116805028,MATH 103A,B02,083780,Greenfeld; Be'Eri,0,0,36,36
1656116805028,MATH 103A,B03,093562,Staff,0,0,36,36
1656116811052,MATH 105,A01,085443,Carter; Anne Toulson,4,1,35,31
1656116811052,MATH 105,A02,093477,Staff,9,0,35,26
1656116817076,MATH 109,A01,083213,Ganzberger; Geoffrey Michael,1,1,34,33
1656116817076,MATH 109,A02,083214,Ganzberger; Geoffrey Michael,0,0,34,34
1656116817076,MATH 109,A03,093478,Staff,1,0,34,33
1656116817076,MATH 109,B01,083215,Ganzberger; Geoffrey Michael,3,0,32,29
1656116817076,MATH 109,B02,083216,Ganzberger; Geoffrey Michael,1,0,32,31
1656116817076,MATH 109,B03,093479,Staff,4,0,32,28
1656116823102,MATH 142A,A01,083219,Chow; Bennett,1,0,32,31
1656116823102,MATH 142A,A02,083220,Chow; Bennett,8,0,32,24
1656116823102,MATH 142A,A03,093480,Staff,5,0,32,27
1656116823102,MATH 142A,B03,093481,Staff,4,0,32,28
1656116823102,MATH 142A,B04,093558,Staff,5,0,32,27
1656116823102,MATH 142A,B05,093559,Staff,0,0,32,32
1656116829135,MATH 193A,A01,083224,Rotar; Vladimir,1,2,34,33
1656116829135,MATH 193A,A02,083225,Rotar; Vladimir,1,0,34,33
1656116829135,MATH 193A,A03,083781,Rotar; Vladimir,1,0,34,33
1656116829135,MATH 193A,A04,083782,Rotar; Vladimir,6,0,34,28
1656116829135,MATH 193A,A05,093482,Rotar; Vladimir,1,0,34,33
1656116835157,MATH 197,001,091859,McAuley; Julian John,9999,0,9999,0
1656116835157,MATH 197,002,095566,Kedlaya; Kiran S.,9997,0,9999,2
1656116835157,MATH 197,003,095567,Xiao; Ming,9999,0,9999,0
1656116835157,MATH 197,004,095571,Perols; Johan Lars,9998,0,9999,1
1656116842231,COGS 9,A01,083615,Shannon; Kyle Michael,5,1,75,70
1656116848254,COGS 11,A01,083617,Boyle; Mary E. T.,16,2,48,32
1656116854277,COGS 13,A01,083071,Bastos; Amalia Pinkusfeld,8,3,71,63
1656116860300,COGS 14A,A01,092681,Semenuks; Arturs,8,24,100,92
1656116866326,COGS 14B,A01,083073,Cheng; Tzu-Han,7,0,63,56
1656116872352,COGS 17,A01,092677,Semenuks; Arturs,13,6,81,68
1656116878380,COGS 100,A01,083619,Allen; Michael Gordon,7,5,70,63
1656116884402,COGS 101A,A01,083621,Davis; Joshua Daniel,7,3,68,61
1656116890426,COGS 101B,A01,091572,Allen; Michael Gordon,6,0,65,59
1656116896452,COGS 101C,A01,083625,Delgado; Tania,11,0,35,24
1656116902479,COGS 107A,A01,083627,Boyle; Mary E. T.,5,4,60,55
1656116908503,COGS 118A,A01,083075,Gupta; Anjum,24,17,76,52
1656116914532,CSE 3,A50,083646,Miranda; Gregory Joseph,18,0,50,32
1656116920556,CSE 8A,A50,083650,Miranda; Gregory Joseph,13,12,56,43
1656116926579,CSE 11,A01,083080,Cao; Yingjun,1,59,40,39
1656116932602,CSE 12,A01,083652,Krause-Levy; Sophia Louisa,14,8,120,106
1656116938641,CSE 15L,A01,083654,Morris; Justin Loren,5,2,50,45
1656116938641,CSE 15L,A02,083655,Morris; Justin Loren,7,2,50,43
1656116944675,CSE 20,A01,083657,Tran; Khoa Dang,31,0,80,49
1656116950699,CSE 21,A01,095574,Bach; Quang Tran,25,0,48,23
1656116956733,CSE 30,A01,083084,Eldon; John,3,11,80,77
1656116956733,CSE 30,B01,095061,Bhaskar; Nishant,4,5,50,46
1656116962757,CSE 100,A01,083659,Cao; Yingjun,2,22,70,68
1656116968785,CSE 134B,A01,083661,Powell; Thomas Allan,11,8,100,89
1656116974817,CSE 140,A01,083663,Gungor; Onat,9,0,85,76
1656116980844,CSE 140L,A01,083088,Eldon; John,8,0,100,92
1656116986873,CSE 175,A01,083665,Kumar; Rakesh,0,0,25,25
1656116992898,CSE 190,A00,092507,Dubnov; Shlomo,2,0,20,18
1656116998926,ECE 45,A01,083139,Congero; Spencer William,5,4,75,70
1656117004953,ECE 65,A50,083695,Saad; Andrew S,8,0,30,22
1656117004953,ECE 65,A51,095125,Staff,23,0,26,3
1656117010976,ECE 109,A01,091882,Touri; Behrouz,7,7,70,63
1656117017000,ECE 180,A00,083140,Abi Samra; Nicholas Camill,1,0,30,29
1656117017000,ECE 180,B00,083141,Abi Samra; Nicholas Camill,4,8,30,26
1656117023029,MATH 10A,A01,083735,Patchell; Gregory David,0,0,30,30
1656117023029,MATH 10A,A02,083736,Patchell; Gregory David,22,0,30,8
1656117023029,MATH 10A,A03,083737,Patchell; Gregory David,16,0,30,14
1656117029053,MATH 10B,A01,083207,Lim; Seonhee,3,3,34,31
1656117029053,MATH 10B,A02,083208,Lim; Seonhee,10,2,35,25
1656117029053,MATH 10B,A03,093472,Staff,4,3,34,30
1656117029053,MATH 10B,B01,083739,Sinha; Shubham,12,0,30,18
1656117035078,MATH 18,A01,083743,Cinel; Cameron Alexander,7,0,30,23
1656117035078,MATH 18,A02,083744,Cinel; Cameron Alexander,10,0,30,20
1656117035078,MATH 18,A03,083745,Cinel; Cameron Alexander,3,0,30,27
1656117035078,MATH 18,B01,083748,Rideout; David Porter,0,0,36,36
1656117035078,MATH 18,B02,083749,Rideout; David Porter,0,0,36,36
1656117035078,MATH 18,B03,083750,Rideout; David Porter,0,0,36,36
1656117035078,MATH 18,B04,083751,Rideout; David Porter,0,0,36,36
1656117035078,MATH 18,B05,093473,Rideout; David Porter,2,0,36,34
1656117035078,MATH 18,B06,093474,Rideout; David Porter,4,0,36,32
1656117041124,MATH 20A,A01,083754,Zheng; Zequn,11,0,40,29
1656117047148,MATH 20B,A01,083756,Briones; Jor-el Thomas Caparas,0,0,36,36
1656117047148,MATH 20B,A02,083757,Briones; Jor-el Thomas Caparas,0,0,36,36
1656117047148,MATH 20B,A03,093475,Staff,2,0,36,34
1656117053175,MATH 20C,A01,083760,Briones; Jor-el Thomas Caparas,2,2,35,33
1656117053175,MATH 20C,A02,083761,Briones; Jor-el Thomas Caparas,9,1,35,26
1656117053175,MATH 20C,A03,093476,Staff,1,1,35,34
1656117053175,MATH 20C,B01,083762,Bach; Quang Tran,1,0,30,29
1656117059203,MATH 20D,A01,083765,Tran; Brian Kha,2,0,30,28
1656117059203,MATH 20D,A02,083766,Tran; Brian Kha,0,1,30,30
1656117059203,MATH 20D,A03,083767,Tran; Brian Kha,2,0,30,28
1656117065228,MATH 20E,A01,083771,Ganguly; Soumya,4,1,32,28
1656117065228,MATH 20E,A02,083772,Ganguly; Soumya,2,2,32,30
1656117065228,MATH 20E,B01,083773,Ciotti; Benjamin,14,0,35,21
1656117065228,MATH 20E,B02,083774,Ciotti; Benjamin,14,0,35,21
1656117071258,MATH 103A,A01,083777,Greenfeld; Be'Eri,2,0,36,34
1656117071258,MATH 103A,A02,083778,Greenfeld; Be'Eri,2,0,36,34
1656117071258,MATH 103A,A03,093561,Staff,4,1,36,32
1656117071258,MATH 103A,B01,083779,Greenfeld; Be'Eri,8,1,36,28
1656117071258,MATH 103A,B02,083780,Greenfeld; Be'Eri,0,0,36,36
1656117071258,MATH 103A,B03,093562,Staff,0,0,36,36
1656117077282,MATH 105,A01,085443,Carter; Anne Toulson,4,1,35,31
1656117077282,MATH 105,A02,093477,Staff,9,0,35,26
1656117083311,MATH 109,A01,083213,Ganzberger; Geoffrey Michael,1,1,34,33
1656117083311,MATH 109,A02,083214,Ganzberger; Geoffrey Michael,0,0,34,34
1656117083311,MATH 109,A03,093478,Staff,1,0,34,33
1656117083311,MATH 109,B01,083215,Ganzberger; Geoffrey Michael,3,0,32,29
1656117083311,MATH 109,B02,083216,Ganzberger; Geoffrey Michael,1,0,32,31
1656117083311,MATH 109,B03,093479,Staff,4,0,32,28
1656117089336,MATH 142A,A01,083219,Chow; Bennett,1,0,32,31
1656117089336,MATH 142A,A02,083220,Chow; Bennett,8,0,32,24
1656117089336,MATH 142A,A03,093480,Staff,5,0,32,27
1656117089336,MATH 142A,B03,093481,Staff,4,0,32,28
1656117089336,MATH 142A,B04,093558,Staff,5,0,32,27
1656117089336,MATH 142A,B05,093559,Staff,0,0,32,32
1656117095360,MATH 193A,A01,083224,Rotar; Vladimir,1,2,34,33
1656117095360,MATH 193A,A02,083225,Rotar; Vladimir,1,0,34,33
1656117095360,MATH 193A,A03,083781,Rotar; Vladimir,1,0,34,33
1656117095360,MATH 193A,A04,083782,Rotar; Vladimir,6,0,34,28
1656117095360,MATH 193A,A05,093482,Rotar; Vladimir,1,0,34,33
1656117101387,MATH 197,001,091859,McAuley; Julian John,9999,0,9999,0
1656117101387,MATH 197,002,095566,Kedlaya; Kiran S.,9997,0,9999,2
1656117101387,MATH 197,003,095567,Xiao; Ming,9999,0,9999,0
1656117101387,MATH 197,004,095571,Perols; Johan Lars,9998,0,9999,1
1656117108540,COGS 9,A01,083615,Shannon; Kyle Michael,5,1,75,70
1656117114570,COGS 11,A01,083617,Boyle; Mary E. T.,16,2,48,32
1656117120594,COGS 13,A01,083071,Bastos; Amalia Pinkusfeld,8,3,71,63
1656117126620,COGS 14A,A01,092681,Semenuks; Arturs,8,24,100,92
1656117132649,COGS 14B,A01,083073,Cheng; Tzu-Han,7,0,63,56
1656117138674,COGS 17,A01,092677,Semenuks; Arturs,13,6,81,68
1656117144697,COGS 100,A01,083619,Allen; Michael Gordon,7,5,70,63
1656117150721,COGS 101A,A01,083621,Davis; Joshua Daniel,7,3,68,61
1656117156745,COGS 101B,A01,091572,Allen; Michael Gordon,6,0,65,59
1656117162770,COGS 101C,A01,083625,Delgado; Tania,11,0,35,24
1656117168793,COGS 107A,A01,083627,Boyle; Mary E. T.,5,4,60,55
1656117174817,COGS 118A,A01,083075,Gupta; Anjum,24,17,76,52
1656117180845,CSE 3,A50,083646,Miranda; Gregory Joseph,18,0,50,32
1656117186876,CSE 8A,A50,083650,Miranda; Gregory Joseph,13,12,56,43
1656117192899,CSE 11,A01,083080,Cao; Yingjun,1,59,40,39
1656117198922,CSE 12,A01,083652,Krause-Levy; Sophia Louisa,14,8,120,106
1656117204956,CSE 15L,A01,083654,Morris; Justin Loren,5,2,50,45
1656117204956,CSE 15L,A02,083655,Morris; Justin Loren,7,2,50,43
1656117210984,CSE 20,A01,083657,Tran; Khoa Dang,31,0,80,49
1656117217006,CSE 21,A01,095574,Bach; Quang Tran,25,0,48,23
1656117223030,CSE 30,A01,083084,Eldon; John,3,11,80,77
1656117223030,CSE 30,B01,095061,Bhaskar; Nishant,4,5,50,46
1656117229053,CSE 100,A01,083659,Cao; Yingjun,2,22,70,68
1656117235082,CSE 134B,A01,083661,Powell; Thomas Allan,11,8,100,89
1656117241110,CSE 140,A01,083663,Gungor; Onat,9,0,85,76
1656117247136,CSE 140L,A01,083088,Eldon; John,8,0,100,92
1656117253159,CSE 175,A01,083665,Kumar; Rakesh,0,0,25,25
1656117259188,CSE 190,A00,092507,Dubnov; Shlomo,2,0,20,18
1656117265214,ECE 45,A01,083139,Congero; Spencer William,5,4,75,70
1656117271239,ECE 65,A50,083695,Saad; Andrew S,8,0,30,22
1656117271239,ECE 65,A51,095125,Staff,23,0,26,3
1656117277276,ECE 109,A01,091882,Touri; Behrouz,7,7,70,63
1656117283305,ECE 180,A00,083140,Abi Samra; Nicholas Camill,1,0,30,29
1656117283305,ECE 180,B00,083141,Abi Samra; Nicholas Camill,4,8,30,26
1656117289327,MATH 10A,A01,083735,Patchell; Gregory David,0,0,30,30
1656117289327,MATH 10A,A02,083736,Patchell; Gregory David,22,0,30,8
1656117289327,MATH 10A,A03,083737,Patchell; Gregory David,16,0,30,14
1656117295352,MATH 10B,A01,083207,Lim; Seonhee,3,3,34,31
1656117295352,MATH 10B,A02,083208,Lim; Seonhee,10,2,35,25
1656117295352,MATH 10B,A03,093472,Staff,4,3,34,30
1656117295352,MATH 10B,B01,083739,Sinha; Shubham,12,0,30,18
1656117301385,MATH 18,A01,083743,Cinel; Cameron Alexander,7,0,30,23
1656117301385,MATH 18,A02,083744,Cinel; Cameron Alexander,10,0,30,20
1656117301385,MATH 18,A03,083745,Cinel; Cameron Alexander,3,0,30,27
1656117301385,MATH 18,B01,083748,Rideout; David Porter,0,0,36,36
1656117301385,MATH 18,B02,083749,Rideout; David Porter,0,0,36,36
1656117301385,MATH 18,B03,083750,Rideout; David Porter,0,0,36,36
1656117301385,MATH 18,B04,083751,Rideout; David Porter,0,0,36,36
1656117301385,MATH 18,B05,093473,Rideout; David Porter,2,0,36,34
1656117301385,MATH 18,B06,093474,Rideout; David Porter,4,0,36,32
1656117307418,MATH 20A,A01,083754,Zheng; Zequn,11,0,40,29
1656117313446,MATH 20B,A01,083756,Briones; Jor-el Thomas Caparas,0,0,36,36
1656117313446,MATH 20B,A02,083757,Briones; Jor-el Thomas Caparas,0,0,36,36
1656117313446,MATH 20B,A03,093475,Staff,2,0,36,34
1656117319470,MATH 20C,A01,083760,Briones; Jor-el Thomas Caparas,2,2,35,33
1656117319470,MATH 20C,A02,083761,Briones; Jor-el Thomas Caparas,9,1,35,26
1656117319470,MATH 20C,A03,093476,Staff,1,1,35,34
1656117319470,MATH 20C,B01,083762,Bach; Quang Tran,1,0,30,29
1656117325499,MATH 20D,A01,083765,Tran; Brian Kha,2,0,30,28
1656117325499,MATH 20D,A02,083766,Tran; Brian Kha,0,1,30,30
1656117325499,MATH 20D,A03,083767,Tran; Brian Kha,2,0,30,28
1656117331526,MATH 20E,A01,083771,Ganguly; Soumya,4,1,32,28
1656117331526,MATH 20E,A02,083772,Ganguly; Soumya,2,2,32,30
1656117331526,MATH 20E,B01,083773,Ciotti; Benjamin,14,0,35,21
1656117331526,MATH 20E,B02,083774,Ciotti; Benjamin,14,0,35,21
1656117337548,MATH 103A,A01,083777,Greenfeld; Be'Eri,2,0,36,34
1656117337548,MATH 103A,A02,083778,Greenfeld; Be'Eri,2,0,36,34
1656117337548,MATH 103A,A03,093561,Staff,4,1,36,32
1656117337548,MATH 103A,B01,083779,Greenfeld; Be'Eri,8,1,36,28
1656117337548,MATH 103A,B02,083780,Greenfeld; Be'Eri,0,0,36,36
1656117337548,MATH 103A,B03,093562,Staff,0,0,36,36
1656117343575,MATH 105,A01,085443,Carter; Anne Toulson,4,1,35,31
1656117343575,MATH 105,A02,093477,Staff,9,0,35,26
1656117349612,MATH 109,A01,083213,Ganzberger; Geoffrey Michael,1,1,34,33
1656117349612,MATH 109,A02,083214,Ganzberger; Geoffrey Michael,0,0,34,34
1656117349612,MATH 109,A03,093478,Staff,1,0,34,33
1656117349612,MATH 109,B01,083215,Ganzberger; Geoffrey Michael,3,0,32,29
1656117349612,MATH 109,B02,083216,Ganzberger; Geoffrey Michael,1,0,32,31
1656117349612,MATH 109,B03,093479,Staff,4,0,32,28
1656117355637,MATH 142A,A01,083219,Chow; Bennett,1,0,32,31
1656117355637,MATH 142A,A02,083220,Chow; Bennett,8,0,32,24
1656117355637,MATH 142A,A03,093480,Staff,5,0,32,27
1656117355637,MATH 142A,B03,093481,Staff,4,0,32,28
1656117355637,MATH 142A,B04,093558,Staff,5,0,32,27
1656117355637,MATH 142A,B05,093559,Staff,0,0,32,32
1656117361658,MATH 193A,A01,083224,Rotar; Vladimir,1,2,34,33
1656117361658,MATH 193A,A02,083225,Rotar; Vladimir,1,0,34,33
1656117361658,MATH 193A,A03,083781,Rotar; Vladimir,1,0,34,33
1656117361658,MATH 193A,A04,083782,Rotar; Vladimir,6,0,34,28
1656117361658,MATH 193A,A05,093482,Rotar; Vladimir,1,0,34,33
1656117367686,MATH 197,001,091859,McAuley; Julian John,9999,0,9999,0
1656117367686,MATH 197,002,095566,Kedlaya; Kiran S.,9997,0,9999,2
1656117367686,MATH 197,003,095567,Xiao; Ming,9999,0,9999,0
1656117367686,MATH 197,004,095571,Perols; Johan Lars,9998,0,9999,1
1656117374737,COGS 9,A01,083615,Shannon; Kyle Michael,5,1,75,70
1656117380760,COGS 11,A01,083617,Boyle; Mary E. T.,16,2,48,32
1656117386783,COGS 13,A01,083071,Bastos; Amalia Pinkusfeld,8,3,71,63
1656117392807,COGS 14A,A01,092681,Semenuks; Arturs,8,24,100,92
1656117398830,COGS 14B,A01,083073,Cheng; Tzu-Han,7,0,63,56
1656117404860,COGS 17,A01,092677,Semenuks; Arturs,13,6,81,68
1656117410882,COGS 100,A01,083619,Allen; Michael Gordon,7,5,70,63
1656117416905,COGS 101A,A01,083621,Davis; Joshua Daniel,7,3,68,61
1656117422928,COGS 101B,A01,091572,Allen; Michael Gordon,6,0,65,59
1656117430113,COGS 101C,A01,083625,Delgado; Tania,11,0,35,24
1656117436136,COGS 107A,A01,083627,Boyle; Mary E. T.,5,4,60,55
1656117442157,COGS 118A,A01,083075,Gupta; Anjum,24,17,76,52
1656117448182,CSE 3,A50,083646,Miranda; Gregory Joseph,18,0,50,32
1656117454208,CSE 8A,A50,083650,Miranda; Gregory Joseph,13,12,56,43
1656117460235,CSE 11,A01,083080,Cao; Yingjun,1,59,40,39
1656117466257,CSE 12,A01,083652,Krause-Levy; Sophia Louisa,14,8,120,106
1656117472281,CSE 15L,A01,083654,Morris; Justin Loren,5,2,50,45
1656117472281,CSE 15L,A02,083655,Morris; Justin Loren,7,2,50,43
1656117478306,CSE 20,A01,083657,Tran; Khoa Dang,31,0,80,49
1656117484340,CSE 21,A01,095574,Bach; Quang Tran,25,0,48,23
1656117490362,CSE 30,A01,083084,Eldon; John,3,11,80,77
1656117490362,CSE 30,B01,095061,Bhaskar; Nishant,4,5,50,46
1656117496386,CSE 100,A01,083659,Cao; Yingjun,2,22,70,68
1656117502407,CSE 134B,A01,083661,Powell; Thomas Allan,11,8,100,89
1656117508431,CSE 140,A01,083663,Gungor; Onat,9,0,85,76
1656117514456,CSE 140L,A01,083088,Eldon; John,8,0,100,92
1656117520482,CSE 175,A01,083665,Kumar; Rakesh,0,0,25,25
1656117526506,CSE 190,A00,092507,Dubnov; Shlomo,2,0,20,18
1656117532533,ECE 45,A01,083139,Congero; Spencer William,5,4,75,70
1656117538573,ECE 65,A50,083695,Saad; Andrew S,8,0,30,22
1656117538573,ECE 65,A51,095125,Staff,23,0,26,3
1656117544597,ECE 109,A01,091882,Touri; Behrouz,7,7,70,63
1656117550625,ECE 180,A00,083140,Abi Samra; Nicholas Camill,1,0,30,29
1656117550625,ECE 180,B00,083141,Abi Samra; Nicholas Camill,4,8,30,26
1656117556653,MATH 10A,A01,083735,Patchell; Gregory David,0,0,30,30
1656117556653,MATH 10A,A02,083736,Patchell; Gregory David,22,0,30,8
1656117556653,MATH 10A,A03,083737,Patchell; Gregory David,16,0,30,14
1656117562676,MATH 10B,A01,083207,Lim; Seonhee,3,3,34,31
1656117562676,MATH 10B,A02,083208,Lim; Seonhee,10,2,35,25
1656117562676,MATH 10B,A03,093472,Staff,4,3,34,30
1656117562676,MATH 10B,B01,083739,Sinha; Shubham,12,0,30,18
1656117568699,MATH 18,A01,083743,Cinel; Cameron Alexander,7,0,30,23
1656117568699,MATH 18,A02,083744,Cinel; Cameron Alexander,10,0,30,20
1656117568699,MATH 18,A03,083745,Cinel; Cameron Alexander,3,0,30,27
1656117568699,MATH 18,B01,083748,Rideout; David Porter,0,0,36,36
1656117568699,MATH 18,B02,083749,Rideout; David Porter,0,0,36,36
1656117568699,MATH 18,B03,083750,Rideout; David Porter,0,0,36,36
1656117568699,MATH 18,B04,083751,Rideout; David Porter,0,0,36,36
1656117568699,MATH 18,B05,093473,Rideout; David Porter,2,0,36,34
1656117568699,MATH 18,B06,093474,Rideout; David Porter,4,0,36,32
1656117574727,MATH 20A,A01,083754,Zheng; Zequn,11,0,40,29
1656117580750,MATH 20B,A01,083756,Briones; Jor-el Thomas Caparas,0,0,36,36
1656117580750,MATH 20B,A02,083757,Briones; Jor-el Thomas Caparas,0,0,36,36
1656117580750,MATH 20B,A03,093475,Staff,2,0,36,34
1656117586774,MATH 20C,A01,083760,Briones; Jor-el Thomas Caparas,2,2,35,33
1656117586774,MATH 20C,A02,083761,Briones; Jor-el Thomas Caparas,9,1,35,26
1656117586774,MATH 20C,A03,093476,Staff,1,1,35,34
1656117586774,MATH 20C,B01,083762,Bach; Quang Tran,1,0,30,29
1656117592798,MATH 20D,A01,083765,Tran; Brian Kha,2,0,30,28
1656117592798,MATH 20D,A02,083766,Tran; Brian Kha,0,1,30,30
1656117592798,MATH 20D,A03,083767,Tran; Brian Kha,2,0,30,28
1656117598823,MATH 20E,A01,083771,Ganguly; Soumya,4,1,32,28
1656117598823,MATH 20E,A02,083772,Ganguly; Soumya,2,2,32,30
1656117598823,MATH 20E,B01,083773,Ciotti; Benjamin,14,0,35,21
1656117598823,MATH 20E,B02,083774,Ciotti; Benjamin,14,0,35,21
1656117604852,MATH 103A,A01,083777,Greenfeld; Be'Eri,2,0,36,34
1656117604852,MATH 103A,A02,083778,Greenfeld; Be'Eri,2,0,36,34
1656117604852,MATH 103A,A03,093561,Staff,4,1,36,32
1656117604852,MATH 103A,B01,083779,Greenfeld; Be'Eri,8,1,36,28
1656117604852,MATH 103A,B02,083780,Greenfeld; Be'Eri,0,0,36,36
1656117604852,MATH 103A,B03,093562,Staff,0,0,36,36
1656117610878,MATH 105,A01,085443,Carter; Anne Toulson,4,1,35,31
1656117610878,MATH 105,A02,093477,Staff,9,0,35,26
1656117616907,MATH 109,A01,083213,Ganzberger; Geoffrey Michael,1,1,34,33
1656117616907,MATH 109,A02,083214,Ganzberger; Geoffrey Michael,0,0,34,34
1656117616907,MATH 109,A03,093478,Staff,1,0,34,33
1656117616907,MATH 109,B01,083215,Ganzberger; Geoffrey Michael,3,0,32,29
1656117616907,MATH 109,B02,083216,Ganzberger; Geoffrey Michael,1,0,32,31
1656117616907,MATH 109,B03,093479,Staff,4,0,32,28
1656117622938,MATH 142A,A01,083219,Chow; Bennett,1,0,32,31
1656117622938,MATH 142A,A02,083220,Chow; Bennett,8,0,32,24
1656117622938,MATH 142A,A03,093480,Staff,5,0,32,27
1656117622938,MATH 142A,B03,093481,Staff,4,0,32,28
1656117622938,MATH 142A,B04,093558,Staff,5,0,32,27
1656117622938,MATH 142A,B05,093559,Staff,0,0,32,32
1656117628974,MATH 193A,A01,083224,Rotar; Vladimir,1,2,34,33
1656117628974,MATH 193A,A02,083225,Rotar; Vladimir,1,0,34,33
1656117628974,MATH 193A,A03,083781,Rotar; Vladimir,1,0,34,33
1656117628974,MATH 193A,A04,083782,Rotar; Vladimir,6,0,34,28
1656117628974,MATH 193A,A05,093482,Rotar; Vladimir,1,0,34,33
1656117635001,MATH 197,001,091859,McAuley; Julian John,9999,0,9999,0
1656117635001,MATH 197,002,095566,Kedlaya; Kiran S.,9997,0,9999,2
1656117635001,MATH 197,003,095567,Xiao; Ming,9999,0,9999,0
1656117635001,MATH 197,004,095571,Perols; Johan Lars,9998,0,9999,1
1656117642063,COGS 9,A01,083615,Shannon; Kyle Michael,5,1,75,70
1656117648090,COGS 11,A01,083617,Boyle; Mary E. T.,16,2,48,32
1656117654112,COGS 13,A01,083071,Bastos; Amalia Pinkusfeld,8,3,71,63
1656117660139,COGS 14A,A01,092681,Semenuks; Arturs,8,24,100,92
1656117666162,COGS 14B,A01,083073,Cheng; Tzu-Han,7,0,63,56
1656117672189,COGS 17,A01,092677,Semenuks; Arturs,13,6,81,68
1656117678213,COGS 100,A01,083619,Allen; Michael Gordon,7,5,70,63
1656117684236,COGS 101A,A01,083621,Davis; Joshua Daniel,7,3,68,61
1656117690262,COGS 101B,A01,091572,Allen; Michael Gordon,6,0,65,59
1656117696290,COGS 101C,A01,083625,Delgado; Tania,11,0,35,24
1656117702387,COGS 107A,A01,083627,Boyle; Mary E. T.,5,4,60,55
1656117708410,COGS 118A,A01,083075,Gupta; Anjum,24,17,76,52
1656117714435,CSE 3,A50,083646,Miranda; Gregory Joseph,18,0,50,32
1656117720462,CSE 8A,A50,083650,Miranda; Gregory Joseph,13,12,56,43
1656117726487,CSE 11,A01,083080,Cao; Yingjun,1,59,40,39
1656117732512,CSE 12,A01,083652,Krause-Levy; Sophia Louisa,14,8,120,106
1656117738539,CSE 15L,A01,083654,Morris; Justin Loren,5,2,50,45
1656117738539,CSE 15L,A02,083655,Morris; Justin Loren,7,2,50,43
1656117744561,CSE 20,A01,083657,Tran; Khoa Dang,31,0,80,49
1656117750585,CSE 21,A01,095574,Bach; Quang Tran,25,0,48,23
1656117756607,CSE 30,A01,083084,Eldon; John,3,11,80,77
1656117756607,CSE 30,B01,095061,Bhaskar; Nishant,4,5,50,46
1656117762636,CSE 100,A01,083659,Cao; Yingjun,2,22,70,68
1656117768662,CSE 134B,A01,083661,Powell; Thomas Allan,11,8,100,89
1656117774688,CSE 140,A01,083663,Gungor; Onat,9,0,85,76
1656117780714,CSE 140L,A01,083088,Eldon; John,8,0,100,92
1656117786737,CSE 175,A01,083665,Kumar; Rakesh,0,0,25,25
1656117792761,CSE 190,A00,092507,Dubnov; Shlomo,2,0,20,18
1656117798787,ECE 45,A01,083139,Congero; Spencer William,5,4,75,70
1656117804811,ECE 65,A50,083695,Saad; Andrew S,8,0,30,22
1656117804811,ECE 65,A51,095125,Staff,23,0,26,3
1656117810837,ECE 109,A01,091882,Touri; Behrouz,7,7,70,63
1656117816865,ECE 180,A00,083140,Abi Samra; Nicholas Camill,1,0,30,29
1656117816865,ECE 180,B00,083141,Abi Samra; Nicholas Camill,4,8,30,26
1656117822893,MATH 10A,A01,083735,Patchell; Gregory David,0,0,30,30
1656117822893,MATH 10A,A02,083736,Patchell; Gregory David,22,0,30,8
1656117822893,MATH 10A,A03,083737,Patchell; Gregory David,16,0,30,14
1656117828920,MATH 10B,A01,083207,Lim; Seonhee,3,3,34,31
1656117828920,MATH 10B,A02,083208,Lim; Seonhee,10,2,35,25
1656117828920,MATH 10B,A03,093472,Staff,4,3,34,30
1656117828920,MATH 10B,B01,083739,Sinha; Shubham,12,0,30,18
1656117834948,MATH 18,A01,083743,Cinel; Cameron Alexander,7,0,30,23
1656117834948,MATH 18,A02,083744,Cinel; Cameron Alexander,10,0,30,20
1656117834948,MATH 18,A03,083745,Cinel; Cameron Alexander,3,0,30,27
1656117834948,MATH 18,B01,083748,Rideout; David Porter,0,0,36,36
1656117834948,MATH 18,B02,083749,Rideout; David Porter,0,0,36,36
1656117834948,MATH 18,B03,083750,Rideout; David Porter,0,0,36,36
1656117834948,MATH 18,B04,083751,Rideout; David Porter,0,0,36,36
1656117834948,MATH 18,B05,093473,Rideout; David Porter,2,0,36,34
1656117834948,MATH 18,B06,093474,Rideout; David Porter,4,0,36,32
1656117840974,MATH 20A,A01,083754,Zheng; Zequn,11,0,40,29
1656117846999,MATH 20B,A01,083756,Briones; Jor-el Thomas Caparas,0,0,36,36
1656117846999,MATH 20B,A02,083757,Briones; Jor-el Thomas Caparas,0,0,36,36
1656117846999,MATH 20B,A03,093475,Staff,2,0,36,34
1656117853029,MATH 20C,A01,083760,Briones; Jor-el Thomas Caparas,2,2,35,33
1656117853029,MATH 20C,A02,083761,Briones; Jor-el Thomas Caparas,9,1,35,26
1656117853029,MATH 20C,A03,093476,Staff,1,1,35,34
1656117853029,MATH 20C,B01,083762,Bach; Quang Tran,1,0,30,29
1656117859073,MATH 20D,A01,083765,Tran; Brian Kha,2,0,30,28
1656117859073,MATH 20D,A02,083766,Tran; Brian Kha,0,1,30,30
1656117859073,MATH 20D,A03,083767,Tran; Brian Kha,2,0,30,28
1656117865100,MATH 20E,A01,083771,Ganguly; Soumya,4,1,32,28
1656117865100,MATH 20E,A02,083772,Ganguly; Soumya,2,2,32,30
1656117865100,MATH 20E,B01,083773,Ciotti; Benjamin,14,0,35,21
1656117865100,MATH 20E,B02,083774,Ciotti; Benjamin,14,0,35,21
1656117871125,MATH 103A,A01,083777,Greenfeld; Be'Eri,2,0,36,34
1656117871125,MATH 103A,A02,083778,Greenfeld; Be'Eri,2,0,36,34
1656117871125,MATH 103A,A03,093561,Staff,4,1,36,32
1656117871125,MATH 103A,B01,083779,Greenfeld; Be'Eri,8,1,36,28
1656117871125,MATH 103A,B02,083780,Greenfeld; Be'Eri,0,0,36,36
1656117871125,MATH 103A,B03,093562,Staff,0,0,36,36
1656117877155,MATH 105,A01,085443,Carter; Anne Toulson,4,1,35,31
1656117877155,MATH 105,A02,093477,Staff,9,0,35,26
1656117883181,MATH 109,A01,083213,Ganzberger; Geoffrey Michael,1,1,34,33
1656117883181,MATH 109,A02,083214,Ganzberger; Geoffrey Michael,0,0,34,34
1656117883181,MATH 109,A03,093478,Staff,1,0,34,33
1656117883181,MATH 109,B01,083215,Ganzberger; Geoffrey Michael,3,0,32,29
1656117883181,MATH 109,B02,083216,Ganzberger; Geoffrey Michael,1,0,32,31
1656117883181,MATH 109,B03,093479,Staff,4,0,32,28
1656117889205,MATH 142A,A01,083219,Chow; Bennett,1,0,32,31
1656117889205,MATH 142A,A02,083220,Chow; Bennett,8,0,32,24
1656117889205,MATH 142A,A03,093480,Staff,5,0,32,27
1656117889205,MATH 142A,B03,093481,Staff,4,0,32,28
1656117889205,MATH 142A,B04,093558,Staff,5,0,32,27
1656117889205,MATH 142A,B05,093559,Staff,0,0,32,32
1656117895232,MATH 193A,A01,083224,Rotar; Vladimir,1,2,34,33
1656117895232,MATH 193A,A02,083225,Rotar; Vladimir,1,0,34,33
1656117895232,MATH 193A,A03,083781,Rotar; Vladimir,1,0,34,33
1656117895232,MATH 193A,A04,083782,Rotar; Vladimir,6,0,34,28
1656117895232,MATH 193A,A05,093482,Rotar; Vladimir,1,0,34,33
1656117901256,MATH 197,001,091859,McAuley; Julian John,9999,0,9999,0
1656117901256,MATH 197,002,095566,Kedlaya; Kiran S.,9997,0,9999,2
1656117901256,MATH 197,003,095567,Xiao; Ming,9999,0,9999,0
1656117901256,MATH 197,004,095571,Perols; Johan Lars,9998,0,9999,1
1656117908322,COGS 9,A01,083615,Shannon; Kyle Michael,5,1,75,70
1656117914348,COGS 11,A01,083617,Boyle; Mary E. T.,16,2,48,32
1656117920370,COGS 13,A01,083071,Bastos; Amalia Pinkusfeld,8,3,71,63
1656117926394,COGS 14A,A01,092681,Semenuks; Arturs,8,24,100,92
1656117932419,COGS 14B,A01,083073,Cheng; Tzu-Han,7,0,63,56
1656117938442,COGS 17,A01,092677,Semenuks; Arturs,13,6,81,68
1656117944468,COGS 100,A01,083619,Allen; Michael Gordon,7,5,70,63
1656117950496,COGS 101A,A01,083621,Davis; Joshua Daniel,7,3,68,61
1656117956523,COGS 101B,A01,091572,Allen; Michael Gordon,6,0,65,59
1656117962550,COGS 101C,A01,083625,Delgado; Tania,11,0,35,24
1656117968573,COGS 107A,A01,083627,Boyle; Mary E. T.,5,4,60,55
1656117974600,COGS 118A,A01,083075,Gupta; Anjum,24,17,76,52
1656117980625,CSE 3,A50,083646,Miranda; Gregory Joseph,18,0,50,32
1656117986652,CSE 8A,A50,083650,Miranda; Gregory Joseph,13,12,56,43
1656117992675,CSE 11,A01,083080,Cao; Yingjun,1,59,40,39
1656117998703,CSE 12,A01,083652,Krause-Levy; Sophia Louisa,14,8,120,106
1656118004730,CSE 15L,A01,083654,Morris; Justin Loren,5,2,50,45
1656118004730,CSE 15L,A02,083655,Morris; Justin Loren,7,2,50,43
1656118010753,CSE 20,A01,083657,Tran; Khoa Dang,31,0,80,49
1656118016778,CSE 21,A01,095574,Bach; Quang Tran,25,0,48,23
1656118022802,CSE 30,A01,083084,Eldon; John,3,11,80,77
1656118022802,CSE 30,B01,095061,Bhaskar; Nishant,4,5,50,46
1656118028827,CSE 100,A01,083659,Cao; Yingjun,2,22,70,68
1656118034850,CSE 134B,A01,083661,Powell; Thomas Allan,11,8,100,89
1656118040877,CSE 140,A01,083663,Gungor; Onat,9,0,85,76
1656118046906,CSE 140L,A01,083088,Eldon; John,8,0,100,92
1656118052933,CSE 175,A01,083665,Kumar; Rakesh,0,0,25,25
1656118058964,CSE 190,A00,092507,Dubnov; Shlomo,2,0,20,18
1656118064993,ECE 45,A01,083139,Congero; Spencer William,5,4,75,70
1656118071022,ECE 65,A50,083695,Saad; Andrew S,8,0,30,22
1656118071022,ECE 65,A51,095125,Staff,23,0,26,3
1656118077045,ECE 109,A01,091882,Touri; Behrouz,7,7,70,63
1656118083067,ECE 180,A00,083140,Abi Samra; Nicholas Camill,1,0,30,29
1656118083067,ECE 180,B00,083141,Abi Samra; Nicholas Camill,4,8,30,26
1656118089096,MATH 10A,A01,083735,Patchell; Gregory David,0,0,30,30
1656118089096,MATH 10A,A02,083736,Patchell; Gregory David,22,0,30,8
1656118089096,MATH 10A,A03,083737,Patchell; Gregory David,16,0,30,14
1656118095128,MATH 10B,A01,083207,Lim; Seonhee,3,3,34,31
1656118095128,MATH 10B,A02,083208,Lim; Seonhee,10,2,35,25
1656118095128,MATH 10B,A03,093472,Staff,4,3,34,30
1656118095128,MATH 10B,B01,083739,Sinha; Shubham,12,0,30,18
1656118101165,MATH 18,A01,083743,Cinel; Cameron Alexander,7,0,30,23
1656118101165,MATH 18,A02,083744,Cinel; Cameron Alexander,10,0,30,20
1656118101165,MATH 18,A03,083745,Cinel; Cameron Alexander,3,0,30,27
1656118101165,MATH 18,B01,083748,Rideout; David Porter,0,0,36,36
1656118101165,MATH 18,B02,083749,Rideout; David Porter,0,0,36,36
1656118101165,MATH 18,B03,083750,Rideout; David Porter,0,0,36,36
1656118101165,MATH 18,B04,083751,Rideout; David Porter,0,0,36,36
1656118101165,MATH 18,B05,093473,Rideout; David Porter,2,0,36,34
1656118101165,MATH 18,B06,093474,Rideout; David Porter,4,0,36,32
1656118107194,MATH 20A,A01,083754,Zheng; Zequn,11,0,40,29
1656118113219,MATH 20B,A01,083756,Briones; Jor-el Thomas Caparas,0,0,36,36
1656118113219,MATH 20B,A02,083757,Briones; Jor-el Thomas Caparas,0,0,36,36
1656118113219,MATH 20B,A03,093475,Staff,2,0,36,34
1656118119242,MATH 20C,A01,083760,Briones; Jor-el Thomas Caparas,2,2,35,33
1656118119242,MATH 20C,A02,083761,Briones; Jor-el Thomas Caparas,9,1,35,26
1656118119242,MATH 20C,A03,093476,Staff,1,1,35,34
1656118119242,MATH 20C,B01,083762,Bach; Quang Tran,1,0,30,29
1656118125274,MATH 20D,A01,083765,Tran; Brian Kha,2,0,30,28
1656118125274,MATH 20D,A02,083766,Tran; Brian Kha,0,1,30,30
1656118125274,MATH 20D,A03,083767,Tran; Brian Kha,2,0,30,28
1656118131303,MATH 20E,A01,083771,Ganguly; Soumya,4,1,32,28
1656118131303,MATH 20E,A02,083772,Ganguly; Soumya,2,2,32,30
1656118131303,MATH 20E,B01,083773,Ciotti; Benjamin,14,0,35,21
1656118131303,MATH 20E,B02,083774,Ciotti; Benjamin,14,0,35,21
1656118137330,MATH 103A,A01,083777,Greenfeld; Be'Eri,2,0,36,34
1656118137330,MATH 103A,A02,083778,Greenfeld; Be'Eri,2,0,36,34
1656118137330,MATH 103A,A03,093561,Staff,4,1,36,32
1656118137330,MATH 103A,B01,083779,Greenfeld; Be'Eri,8,1,36,28
1656118137330,MATH 103A,B02,083780,Greenfeld; Be'Eri,0,0,36,36
1656118137330,MATH 103A,B03,093562,Staff,0,0,36,36
1656118143357,MATH 105,A01,085443,Carter; Anne Toulson,4,1,35,31
1656118143357,MATH 105,A02,093477,Staff,9,0,35,26
1656118149387,MATH 109,A01,083213,Ganzberger; Geoffrey Michael,1,1,34,33
1656118149387,MATH 109,A02,083214,Ganzberger; Geoffrey Michael,0,0,34,34
1656118149387,MATH 109,A03,093478,Staff,1,0,34,33
1656118149387,MATH 109,B01,083215,Ganzberger; Geoffrey Michael,3,0,32,29
1656118149387,MATH 109,B02,083216,Ganzberger; Geoffrey Michael,1,0,32,31
1656118149387,MATH 109,B03,093479,Staff,4,0,32,28
1656118155417,MATH 142A,A01,083219,Chow; Bennett,1,0,32,31
1656118155417,MATH 142A,A02,083220,Chow; Bennett,8,0,32,24
1656118155417,MATH 142A,A03,093480,Staff,5,0,32,27
1656118155417,MATH 142A,B03,093481,Staff,4,0,32,28
1656118155417,MATH 142A,B04,093558,Staff,5,0,32,27
1656118155417,MATH 142A,B05,093559,Staff,0,0,32,32
1656118161457,MATH 193A,A01,083224,Rotar; Vladimir,1,2,34,33
1656118161457,MATH 193A,A02,083225,Rotar; Vladimir,1,0,34,33
1656118161457,MATH 193A,A03,083781,Rotar; Vladimir,1,0,34,33
1656118161457,MATH 193A,A04,083782,Rotar; Vladimir,6,0,34,28
1656118161457,MATH 193A,A05,093482,Rotar; Vladimir,1,0,34,33
1656118167483,MATH 197,001,091859,McAuley; Julian John,9999,0,9999,0
1656118167483,MATH 197,002,095566,Kedlaya; Kiran S.,9997,0,9999,2
1656118167483,MATH 197,003,095567,Xiao; Ming,9999,0,9999,0
1656118167483,MATH 197,004,095571,Perols; Johan Lars,9998,0,9999,1
1656118174552,COGS 9,A01,083615,Shannon; Kyle Michael,5,1,75,70
1656118180576,COGS 11,A01,083617,Boyle; Mary E. T.,16,2,48,32
1656118186599,COGS 13,A01,083071,Bastos; Amalia Pinkusfeld,8,3,71,63
1656118192623,COGS 14A,A01,092681,Semenuks; Arturs,8,24,100,92
1656118198650,COGS 14B,A01,083073,Cheng; Tzu-Han,7,0,63,56
1656118204674,COGS 17,A01,092677,Semenuks; Arturs,13,6,81,68
1656118210705,COGS 100,A01,083619,Allen; Michael Gordon,7,5,70,63
1656118216729,COGS 101A,A01,083621,Davis; Joshua Daniel,7,3,68,61
1656118222767,COGS 101B,A01,091572,Allen; Michael Gordon,6,0,65,59
1656118228790,COGS 101C,A01,083625,Delgado; Tania,11,0,35,24
1656118234811,COGS 107A,A01,083627,Boyle; Mary E. T.,5,4,60,55
1656118240835,COGS 118A,A01,083075,Gupta; Anjum,24,17,76,52
1656118246858,CSE 3,A50,083646,Miranda; Gregory Joseph,18,0,50,32
1656118252885,CSE 8A,A50,083650,Miranda; Gregory Joseph,13,12,56,43
1656118258908,CSE 11,A01,083080,Cao; Yingjun,1,59,40,39
1656118264934,CSE 12,A01,083652,Krause-Levy; Sophia Louisa,14,8,120,106
1656118270965,CSE 15L,A01,083654,Morris; Justin Loren,5,2,50,45
1656118270965,CSE 15L,A02,083655,Morris; Justin Loren,7,2,50,43
1656118276990,CSE 20,A01,083657,Tran; Khoa Dang,31,0,80,49
1656118283012,CSE 21,A01,095574,Bach; Quang Tran,25,0,48,23
1656118289036,CSE 30,A01,083084,Eldon; John,3,11,80,77
1656118289036,CSE 30,B01,095061,Bhaskar; Nishant,4,5,50,46
1656118295059,CSE 100,A01,083659,Cao; Yingjun,2,22,70,68
1656118301162,CSE 134B,A01,083661,Powell; Thomas Allan,11,8,100,89
1656118307184,CSE 140,A01,083663,Gungor; Onat,9,0,85,76
1656118313208,CSE 140L,A01,083088,Eldon; John,8,0,100,92
1656118319244,CSE 175,A01,083665,Kumar; Rakesh,0,0,25,25
1656118325271,CSE 190,A00,092507,Dubnov; Shlomo,2,0,20,18
1656118331297,ECE 45,A01,083139,Congero; Spencer William,5,4,75,70
1656118337324,ECE 65,A50,083695,Saad; Andrew S,8,0,30,22
1656118337324,ECE 65,A51,095125,Staff,23,0,26,3
1656118343351,ECE 109,A01,091882,Touri; Behrouz,7,7,70,63
1656118349380,ECE 180,A00,083140,Abi Samra; Nicholas Camill,1,0,30,29
1656118349380,ECE 180,B00,083141,Abi Samra; Nicholas Camill,4,8,30,26
1656118355405,MATH 10A,A01,083735,Patchell; Gregory David,0,0,30,30
1656118355405,MATH 10A,A02,083736,Patchell; Gregory David,22,0,30,8
1656118355405,MATH 10A,A03,083737,Patchell; Gregory David,16,0,30,14
1656118361433,MATH 10B,A01,083207,Lim; Seonhee,3,3,34,31
1656118361433,MATH 10B,A02,083208,Lim; Seonhee,10,2,35,25
1656118361433,MATH 10B,A03,093472,Staff,4,3,34,30
1656118361433,MATH 10B,B01,083739,Sinha; Shubham,12,0,30,18
1656118367458,MATH 18,A01,083743,Cinel; Cameron Alexander,7,0,30,23
1656118367458,MATH 18,A02,083744,Cinel; Cameron Alexander,10,0,30,20
1656118367458,MATH 18,A03,083745,Cinel; Cameron Alexander,3,0,30,27
1656118367458,MATH 18,B01,083748,Rideout; David Porter,0,0,36,36
1656118367458,MATH 18,B02,083749,Rideout; David Porter,0,0,36,36
1656118367458,MATH 18,B03,083750,Rideout; David Porter,0,0,36,36
1656118367458,MATH 18,B04,083751,Rideout; David Porter,0,0,36,36
1656118367458,MATH 18,B05,093473,Rideout; David Porter,2,0,36,34
1656118367458,MATH 18,B06,093474,Rideout; David Porter,4,0,36,32
1656118373483,MATH 20A,A01,083754,Zheng; Zequn,11,0,40,29
1656118379506,MATH 20B,A01,083756,Briones; Jor-el Thomas Caparas,0,0,36,36
1656118379506,MATH 20B,A02,083757,Briones; Jor-el Thomas Caparas,0,0,36,36
1656118379506,MATH 20B,A03,093475,Staff,2,0,36,34
1656118385533,MATH 20C,A01,083760,Briones; Jor-el Thomas Caparas,2,2,35,33
1656118385533,MATH 20C,A02,083761,Briones; Jor-el Thomas Caparas,9,1,35,26
1656118385533,MATH 20C,A03,093476,Staff,1,1,35,34
1656118385533,MATH 20C,B01,083762,Bach; Quang Tran,1,0,30,29
1656118391557,MATH 20D,A01,083765,Tran; Brian Kha,2,0,30,28
1656118391557,MATH 20D,A02,083766,Tran; Brian Kha,0,1,30,30
1656118391557,MATH 20D,A03,083767,Tran; Brian Kha,2,0,30,28
1656118397580,MATH 20E,A01,083771,Ganguly; Soumya,4,1,32,28
1656118397580,MATH 20E,A02,083772,Ganguly; Soumya,2,2,32,30
1656118397580,MATH 20E,B01,083773,Ciotti; Benjamin,14,0,35,21
1656118397580,MATH 20E,B02,083774,Ciotti; Benjamin,14,0,35,21
1656118403610,MATH 103A,A01,083777,Greenfeld; Be'Eri,2,0,36,34
1656118403610,MATH 103A,A02,083778,Greenfeld; Be'Eri,2,0,36,34
1656118403610,MATH 103A,A03,093561,Staff,4,1,36,32
1656118403610,MATH 103A,B01,083779,Greenfeld; Be'Eri,8,1,36,28
1656118403610,MATH 103A,B02,083780,Greenfeld; Be'Eri,0,0,36,36
1656118403610,MATH 103A,B03,093562,Staff,0,0,36,36
1656118409637,MATH 105,A01,085443,Carter; Anne Toulson,4,1,35,31
1656118409637,MATH 105,A02,093477,Staff,9,0,35,26
1656118415666,MATH 109,A01,083213,Ganzberger; Geoffrey Michael,1,1,34,33
1656118415666,MATH 109,A02,083214,Ganzberger; Geoffrey Michael,0,0,34,34
1656118415666,MATH 109,A03,093478,Staff,1,0,34,33
1656118415666,MATH 109,B01,083215,Ganzberger; Geoffrey Michael,3,0,32,29
1656118415666,MATH 109,B02,083216,Ganzberger; Geoffrey Michael,1,0,32,31
1656118415666,MATH 109,B03,093479,Staff,4,0,32,28
1656118421691,MATH 142A,A01,083219,Chow; Bennett,1,0,32,31
1656118421691,MATH 142A,A02,083220,Chow; Bennett,8,0,32,24
1656118421691,MATH 142A,A03,093480,Staff,5,0,32,27
1656118421691,MATH 142A,B03,093481,Staff,4,0,32,28
1656118421691,MATH 142A,B04,093558,Staff,5,0,32,27
1656118421691,MATH 142A,B05,093559,Staff,0,0,32,32
1656118427720,MATH 193A,A01,083224,Rotar; Vladimir,1,2,34,33
1656118427720,MATH 193A,A02,083225,Rotar; Vladimir,1,0,34,33
1656118427720,MATH 193A,A03,083781,Rotar; Vladimir,1,0,34,33
1656118427720,MATH 193A,A04,083782,Rotar; Vladimir,6,0,34,28
1656118427720,MATH 193A,A05,093482,Rotar; Vladimir,1,0,34,33
1656118433747,MATH 197,001,091859,McAuley; Julian John,9999,0,9999,0
1656118433747,MATH 197,002,095566,Kedlaya; Kiran S.,9997,0,9999,2
1656118433747,MATH 197,003,095567,Xiao; Ming,9999,0,9999,0
1656118433747,MATH 197,004,095571,Perols; Johan Lars,9998,0,9999,1
1656118440805,COGS 9,A01,083615,Shannon; Kyle Michael,5,1,75,70
1656118446830,COGS 11,A01,083617,Boyle; Mary E. T.,16,2,48,32
1656118452860,COGS 13,A01,083071,Bastos; Amalia Pinkusfeld,8,3,71,63
1656118458896,COGS 14A,A01,092681,Semenuks; Arturs,8,24,100,92
1656118464919,COGS 14B,A01,083073,Cheng; Tzu-Han,7,0,63,56
1656118470945,COGS 17,A01,092677,Semenuks; Arturs,13,6,81,68
1656118476973,COGS 100,A01,083619,Allen; Michael Gordon,7,5,70,63
1656118483010,COGS 101A,A01,083621,Davis; Joshua Daniel,7,3,68,61
1656118489038,COGS 101B,A01,091572,Allen; Michael Gordon,6,0,65,59
1656118495060,COGS 101C,A01,083625,Delgado; Tania,11,0,35,24
1656118501092,COGS 107A,A01,083627,Boyle; Mary E. T.,5,4,60,55
1656118507117,COGS 118A,A01,083075,Gupta; Anjum,24,17,76,52
1656118513143,CSE 3,A50,083646,Miranda; Gregory Joseph,18,0,50,32
1656118519167,CSE 8A,A50,083650,Miranda; Gregory Joseph,13,12,56,43
1656118525191,CSE 11,A01,083080,Cao; Yingjun,1,59,40,39
1656118531218,CSE 12,A01,083652,Krause-Levy; Sophia Louisa,14,8,120,106
1656118537248,CSE 15L,A01,083654,Morris; Justin Loren,5,2,50,45
1656118537248,CSE 15L,A02,083655,Morris; Justin Loren,7,2,50,43
1656118543271,CSE 20,A01,083657,Tran; Khoa Dang,31,0,80,49
1656118549295,CSE 21,A01,095574,Bach; Quang Tran,25,0,48,23
1656118555318,CSE 30,A01,083084,Eldon; John,3,11,80,77
1656118555318,CSE 30,B01,095061,Bhaskar; Nishant,4,5,50,46
1656118561340,CSE 100,A01,083659,Cao; Yingjun,2,22,70,68
1656118567366,CSE 134B,A01,083661,Powell; Thomas Allan,11,8,100,89
1656118573390,CSE 140,A01,083663,Gungor; Onat,9,0,85,76
1656118579419,CSE 140L,A01,083088,Eldon; John,8,0,100,92
1656118585445,CSE 175,A01,083665,Kumar; Rakesh,0,0,25,25
1656118591469,CSE 190,A00,092507,Dubnov; Shlomo,2,0,20,18
1656118597495,ECE 45,A01,083139,Congero; Spencer William,5,4,75,70
1656118603518,ECE 65,A50,083695,Saad; Andrew S,8,0,30,22
1656118603518,ECE 65,A51,095125,Staff,23,0,26,3
1656118609545,ECE 109,A01,091882,Touri; Behrouz,7,7,70,63
1656118615576,ECE 180,A00,083140,Abi Samra; Nicholas Camill,1,0,30,29
1656118615576,ECE 180,B00,083141,Abi Samra; Nicholas Camill,4,8,30,26
1656118621601,MATH 10A,A01,083735,Patchell; Gregory David,0,0,30,30
1656118621601,MATH 10A,A02,083736,Patchell; Gregory David,22,0,30,8
1656118621601,MATH 10A,A03,083737,Patchell; Gregory David,16,0,30,14
1656118627630,MATH 10B,A01,083207,Lim; Seonhee,3,3,34,31
1656118627630,MATH 10B,A02,083208,Lim; Seonhee,10,2,35,25
1656118627630,MATH 10B,A03,093472,Staff,4,3,34,30
1656118627630,MATH 10B,B01,083739,Sinha; Shubham,12,0,30,18
1656118633665,MATH 18,A01,083743,Cinel; Cameron Alexander,7,0,30,23
1656118633665,MATH 18,A02,083744,Cinel; Cameron Alexander,10,0,30,20
1656118633665,MATH 18,A03,083745,Cinel; Cameron Alexander,3,0,30,27
1656118633665,MATH 18,B01,083748,Rideout; David Porter,0,0,36,36
1656118633665,MATH 18,B02,083749,Rideout; David Porter,0,0,36,36
1656118633665,MATH 18,B03,083750,Rideout; David Porter,0,0,36,36
1656118633665,MATH 18,B04,083751,Rideout; David Porter,0,0,36,36
1656118633665,MATH 18,B05,093473,Rideout; David Porter,2,0,36,34
1656118633665,MATH 18,B06,093474,Rideout; David Porter,4,0,36,32
1656118639688,MATH 20A,A01,083754,Zheng; Zequn,11,0,40,29
1656118645716,MATH 20B,A01,083756,Briones; Jor-el Thomas Caparas,0,0,36,36
1656118645716,MATH 20B,A02,083757,Briones; Jor-el Thomas Caparas,0,0,36,36
1656118645716,MATH 20B,A03,093475,Staff,2,0,36,34
1656118651747,MATH 20C,A01,083760,Briones; Jor-el Thomas Caparas,2,2,35,33
1656118651747,MATH 20C,A02,083761,Briones; Jor-el Thomas Caparas,9,1,35,26
1656118651747,MATH 20C,A03,093476,Staff,1,1,35,34
1656118651747,MATH 20C,B01,083762,Bach; Quang Tran,1,0,30,29
1656118657776,MATH 20D,A01,083765,Tran; Brian Kha,2,0,30,28
1656118657776,MATH 20D,A02,083766,Tran; Brian Kha,0,1,30,30
1656118657776,MATH 20D,A03,083767,Tran; Brian Kha,2,0,30,28
1656118663803,MATH 20E,A01,083771,Ganguly; Soumya,4,1,32,28
1656118663803,MATH 20E,A02,083772,Ganguly; Soumya,2,2,32,30
1656118663803,MATH 20E,B01,083773,Ciotti; Benjamin,14,0,35,21
1656118663803,MATH 20E,B02,083774,Ciotti; Benjamin,14,0,35,21
1656118669826,MATH 103A,A01,083777,Greenfeld; Be'Eri,2,0,36,34
1656118669826,MATH 103A,A02,083778,Greenfeld; Be'Eri,2,0,36,34
1656118669826,MATH 103A,A03,093561,Staff,4,1,36,32
1656118669826,MATH 103A,B01,083779,Greenfeld; Be'Eri,8,1,36,28
1656118669826,MATH 103A,B02,083780,Greenfeld; Be'Eri,0,0,36,36
1656118669826,MATH 103A,B03,093562,Staff,0,0,36,36
1656118675849,MATH 105,A01,085443,Carter; Anne Toulson,4,1,35,31
1656118675849,MATH 105,A02,093477,Staff,9,0,35,26
1656118681874,MATH 109,A01,083213,Ganzberger; Geoffrey Michael,1,1,34,33
1656118681874,MATH 109,A02,083214,Ganzberger; Geoffrey Michael,0,0,34,34
1656118681874,MATH 109,A03,093478,Staff,1,0,34,33
1656118681874,MATH 109,B01,083215,Ganzberger; Geoffrey Michael,3,0,32,29
1656118681874,MATH 109,B02,083216,Ganzberger; Geoffrey Michael,1,0,32,31
1656118681874,MATH 109,B03,093479,Staff,4,0,32,28
1656118687904,MATH 142A,A01,083219,Chow; Bennett,1,0,32,31
1656118687904,MATH 142A,A02,083220,Chow; Bennett,8,0,32,24
1656118687904,MATH 142A,A03,093480,Staff,5,0,32,27
1656118687904,MATH 142A,B03,093481,Staff,4,0,32,28
1656118687904,MATH 142A,B04,093558,Staff,5,0,32,27
1656118687904,MATH 142A,B05,093559,Staff,0,0,32,32
1656118693929,MATH 193A,A01,083224,Rotar; Vladimir,1,2,34,33
1656118693929,MATH 193A,A02,083225,Rotar; Vladimir,1,0,34,33
1656118693929,MATH 193A,A03,083781,Rotar; Vladimir,1,0,34,33
1656118693929,MATH 193A,A04,083782,Rotar; Vladimir,6,0,34,28
1656118693929,MATH 193A,A05,093482,Rotar; Vladimir,1,0,34,33
1656118699956,MATH 197,001,091859,McAuley; Julian John,9999,0,9999,0
1656118699956,MATH 197,002,095566,Kedlaya; Kiran S.,9997,0,9999,2
1656118699956,MATH 197,003,095567,Xiao; Ming,9999,0,9999,0
1656118699956,MATH 197,004,095571,Perols; Johan Lars,9998,0,9999,1
1656118707009,COGS 9,A01,083615,Shannon; Kyle Michael,5,1,75,70
1656118713036,COGS 11,A01,083617,Boyle; Mary E. T.,16,2,48,32
1656118719060,COGS 13,A01,083071,Bastos; Amalia Pinkusfeld,8,3,71,63
1656118725087,COGS 14A,A01,092681,Semenuks; Arturs,8,24,100,92
1656118731114,COGS 14B,A01,083073,Cheng; Tzu-Han,7,0,63,56
1656118737141,COGS 17,A01,092677,Semenuks; Arturs,13,6,81,68
1656118743176,COGS 100,A01,083619,Allen; Michael Gordon,7,5,70,63
1656118749203,COGS 101A,A01,083621,Davis; Joshua Daniel,7,3,68,61
1656118755230,COGS 101B,A01,091572,Allen; Michael Gordon,6,0,65,59
1656118761264,COGS 101C,A01,083625,Delgado; Tania,11,0,35,24
1656118767287,COGS 107A,A01,083627,Boyle; Mary E. T.,5,4,60,55
1656118773314,COGS 118A,A01,083075,Gupta; Anjum,24,17,76,52
1656118779344,CSE 3,A50,083646,Miranda; Gregory Joseph,18,0,50,32
1656118785369,CSE 8A,A50,083650,Miranda; Gregory Joseph,13,12,56,43
1656118791396,CSE 11,A01,083080,Cao; Yingjun,1,59,40,39
1656118797418,CSE 12,A01,083652,Krause-Levy; Sophia Louisa,14,8,120,106
1656118803443,CSE 15L,A01,083654,Morris; Justin Loren,5,2,50,45
1656118803443,CSE 15L,A02,083655,Morris; Justin Loren,7,2,50,43
1656118809471,CSE 20,A01,083657,Tran; Khoa Dang,31,0,80,49
1656118815499,CSE 21,A01,095574,Bach; Quang Tran,25,0,48,23
1656118821528,CSE 30,A01,083084,Eldon; John,3,11,80,77
1656118821528,CSE 30,B01,095061,Bhaskar; Nishant,4,5,50,46
1656118827555,CSE 100,A01,083659,Cao; Yingjun,2,22,70,68
1656118833581,CSE 134B,A01,083661,Powell; Thomas Allan,11,8,100,89
1656118839608,CSE 140,A01,083663,Gungor; Onat,9,0,85,76
1656118845632,CSE 140L,A01,083088,Eldon; John,8,0,100,92
1656118851661,CSE 175,A01,083665,Kumar; Rakesh,0,0,25,25
1656118857687,CSE 190,A00,092507,Dubnov; Shlomo,2,0,20,18
1656118863710,ECE 45,A01,083139,Congero; Spencer William,5,4,75,70
1656118869734,ECE 65,A50,083695,Saad; Andrew S,8,0,30,22
1656118869734,ECE 65,A51,095125,Staff,23,0,26,3
1656118875765,ECE 109,A01,091882,Touri; Behrouz,7,7,70,63
1656118881797,ECE 180,A00,083140,Abi Samra; Nicholas Camill,1,0,30,29
1656118881797,ECE 180,B00,083141,Abi Samra; Nicholas Camill,4,8,30,26
1656118887820,MATH 10A,A01,083735,Patchell; Gregory David,0,0,30,30
1656118887820,MATH 10A,A02,083736,Patchell; Gregory David,22,0,30,8
1656118887820,MATH 10A,A03,083737,Patchell; Gregory David,16,0,30,14
1656118893845,MATH 10B,A01,083207,Lim; Seonhee,3,3,34,31
1656118893845,MATH 10B,A02,083208,Lim; Seonhee,10,2,35,25
1656118893845,MATH 10B,A03,093472,Staff,4,3,34,30
1656118893845,MATH 10B,B01,083739,Sinha; Shubham,12,0,30,18
1656118906379,MATH 18,A01,083743,Cinel; Cameron Alexander,7,0,30,23
1656118906379,MATH 18,A02,083744,Cinel; Cameron Alexander,10,0,30,20
1656118906379,MATH 18,A03,083745,Cinel; Cameron Alexander,3,0,30,27
1656118906379,MATH 18,B01,083748,Rideout; David Porter,0,0,36,36
1656118906379,MATH 18,B02,083749,Rideout; David Porter,0,0,36,36
1656118906379,MATH 18,B03,083750,Rideout; David Porter,0,0,36,36
1656118906379,MATH 18,B04,083751,Rideout; David Porter,0,0,36,36
1656118906379,MATH 18,B05,093473,Rideout; David Porter,2,0,36,34
1656118906379,MATH 18,B06,093474,Rideout; David Porter,4,0,36,32
1656118912410,MATH 20A,A01,083754,Zheng; Zequn,11,0,40,29
1656118918437,MATH 20B,A01,083756,Briones; Jor-el Thomas Caparas,0,0,36,36
1656118918437,MATH 20B,A02,083757,Briones; Jor-el Thomas Caparas,0,0,36,36
1656118918437,MATH 20B,A03,093475,Staff,2,0,36,34
1656118924464,MATH 20C,A01,083760,Briones; Jor-el Thomas Caparas,2,2,35,33
1656118924464,MATH 20C,A02,083761,Briones; Jor-el Thomas Caparas,9,1,35,26
1656118924464,MATH 20C,A03,093476,Staff,1,1,35,34
1656118924464,MATH 20C,B01,083762,Bach; Quang Tran,1,0,30,29
1656118930491,MATH 20D,A01,083765,Tran; Brian Kha,2,0,30,28
1656118930491,MATH 20D,A02,083766,Tran; Brian Kha,0,1,30,30
1656118930491,MATH 20D,A03,083767,Tran; Brian Kha,2,0,30,28
1656118936516,MATH 20E,A01,083771,Ganguly; Soumya,4,1,32,28
1656118936516,MATH 20E,A02,083772,Ganguly; Soumya,2,2,32,30
1656118936516,MATH 20E,B01,083773,Ciotti; Benjamin,14,0,35,21
1656118936516,MATH 20E,B02,083774,Ciotti; Benjamin,14,0,35,21
1656118942539,MATH 103A,A01,083777,Greenfeld; Be'Eri,2,0,36,34
1656118942539,MATH 103A,A02,083778,Greenfeld; Be'Eri,2,0,36,34
1656118942539,MATH 103A,A03,093561,Staff,4,1,36,32
1656118942539,MATH 103A,B01,083779,Greenfeld; Be'Eri,8,1,36,28
1656118942539,MATH 103A,B02,083780,Greenfeld; Be'Eri,0,0,36,36
1656118942539,MATH 103A,B03,093562,Staff,0,0,36,36
1656118948561,MATH 105,A01,085443,Carter; Anne Toulson,4,1,35,31
1656118948561,MATH 105,A02,093477,Staff,9,0,35,26
1656118954590,MATH 109,A01,083213,Ganzberger; Geoffrey Michael,1,1,34,33
1656118954590,MATH 109,A02,083214,Ganzberger; Geoffrey Michael,0,0,34,34
1656118954590,MATH 109,A03,093478,Staff,1,0,34,33
1656118954590,MATH 109,B01,083215,Ganzberger; Geoffrey Michael,3,0,32,29
1656118954590,MATH 109,B02,083216,Ganzberger; Geoffrey Michael,1,0,32,31
1656118954590,MATH 109,B03,093479,Staff,4,0,32,28
1656118960621,MATH 142A,A01,083219,Chow; Bennett,1,0,32,31
1656118960621,MATH 142A,A02,083220,Chow; Bennett,8,0,32,24
1656118960621,MATH 142A,A03,093480,Staff,5,0,32,27
1656118960621,MATH 142A,B03,093481,Staff,4,0,32,28
1656118960621,MATH 142A,B04,093558,Staff,5,0,32,27
1656118960621,MATH 142A,B05,093559,Staff,0,0,32,32
1656118966645,MATH 193A,A01,083224,Rotar; Vladimir,1,2,34,33
1656118966645,MATH 193A,A02,083225,Rotar; Vladimir,1,0,34,33
1656118966645,MATH 193A,A03,083781,Rotar; Vladimir,1,0,34,33
1656118966645,MATH 193A,A04,083782,Rotar; Vladimir,6,0,34,28
1656118966645,MATH 193A,A05,093482,Rotar; Vladimir,1,0,34,33
1656118972668,MATH 197,001,091859,McAuley; Julian John,9999,0,9999,0
1656118972668,MATH 197,002,095566,Kedlaya; Kiran S.,9997,0,9999,2
1656118972668,MATH 197,003,095567,Xiao; Ming,9999,0,9999,0
1656118972668,MATH 197,004,095571,Perols; Johan Lars,9998,0,9999,1
1656118979721,COGS 9,A01,083615,Shannon; Kyle Michael,5,1,75,70
1656118985744,COGS 11,A01,083617,Boyle; Mary E. T.,16,2,48,32
1656118991772,COGS 13,A01,083071,Bastos; Amalia Pinkusfeld,8,3,71,63
1656118997794,COGS 14A,A01,092681,Semenuks; Arturs,8,24,100,92
1656119003817,COGS 14B,A01,083073,Cheng; Tzu-Han,7,0,63,56
1656119009843,COGS 17,A01,092677,Semenuks; Arturs,13,6,81,68
1656119015867,COGS 100,A01,083619,Allen; Michael Gordon,7,5,70,63
1656119021889,COGS 101A,A01,083621,Davis; Joshua Daniel,7,3,68,61
1656119027913,COGS 101B,A01,091572,Allen; Michael Gordon,6,0,65,59
1656119033941,COGS 101C,A01,083625,Delgado; Tania,11,0,35,24
1656119039978,COGS 107A,A01,083627,Boyle; Mary E. T.,5,4,60,55
1656119046002,COGS 118A,A01,083075,Gupta; Anjum,24,17,76,52
1656119052030,CSE 3,A50,083646,Miranda; Gregory Joseph,18,0,50,32
1656119058053,CSE 8A,A50,083650,Miranda; Gregory Joseph,13,12,56,43
1656119064077,CSE 11,A01,083080,Cao; Yingjun,1,59,40,39
1656119070105,CSE 12,A01,083652,Krause-Levy; Sophia Louisa,14,8,120,106
1656119076126,CSE 15L,A01,083654,Morris; Justin Loren,5,2,50,45
1656119076126,CSE 15L,A02,083655,Morris; Justin Loren,7,2,50,43
1656119082150,CSE 20,A01,083657,Tran; Khoa Dang,31,0,80,49
1656119088172,CSE 21,A01,095574,Bach; Quang Tran,25,0,48,23
1656119094196,CSE 30,A01,083084,Eldon; John,3,11,80,77
1656119094196,CSE 30,B01,095061,Bhaskar; Nishant,4,5,50,46
1656119100221,CSE 100,A01,083659,Cao; Yingjun,2,22,70,68
1656119106244,CSE 134B,A01,083661,Powell; Thomas Allan,11,8,100,89
1656119112271,CSE 140,A01,083663,Gungor; Onat,9,0,85,76
1656119118291,CSE 140L,A01,083088,Eldon; John,8,0,100,92
1656119124319,CSE 175,A01,083665,Kumar; Rakesh,0,0,25,25
1656119130346,CSE 190,A00,092507,Dubnov; Shlomo,2,0,20,18
1656119136373,ECE 45,A01,083139,Congero; Spencer William,5,4,75,70
1656119142407,ECE 65,A50,083695,Saad; Andrew S,8,0,30,22
1656119142407,ECE 65,A51,095125,Staff,23,0,26,3
1656119148429,ECE 109,A01,091882,Touri; Behrouz,7,7,70,63
1656119154458,ECE 180,A00,083140,Abi Samra; Nicholas Camill,1,0,30,29
1656119154458,ECE 180,B00,083141,Abi Samra; Nicholas Camill,4,8,30,26
1656119160487,MATH 10A,A01,083735,Patchell; Gregory David,0,0,30,30
1656119160487,MATH 10A,A02,083736,Patchell; Gregory David,22,0,30,8
1656119160487,MATH 10A,A03,083737,Patchell; Gregory David,16,0,30,14
1656119166511,MATH 10B,A01,083207,Lim; Seonhee,3,3,34,31
1656119166511,MATH 10B,A02,083208,Lim; Seonhee,10,2,35,25
1656119166511,MATH 10B,A03,093472,Staff,4,3,34,30
1656119166511,MATH 10B,B01,083739,Sinha; Shubham,12,0,30,18
1656119172544,MATH 18,A01,083743,Cinel; Cameron Alexander,7,0,30,23
1656119172544,MATH 18,A02,083744,Cinel; Cameron Alexander,10,0,30,20
1656119172544,MATH 18,A03,083745,Cinel; Cameron Alexander,3,0,30,27
1656119172544,MATH 18,B01,083748,Rideout; David Porter,0,0,36,36
1656119172544,MATH 18,B02,083749,Rideout; David Porter,0,0,36,36
1656119172544,MATH 18,B03,083750,Rideout; David Porter,0,0,36,36
1656119172544,MATH 18,B04,083751,Rideout; David Porter,0,0,36,36
1656119172544,MATH 18,B05,093473,Rideout; David Porter,2,0,36,34
1656119172544,MATH 18,B06,093474,Rideout; David Porter,4,0,36,32
1656119178573,MATH 20A,A01,083754,Zheng; Zequn,11,0,40,29
1656119184608,MATH 20B,A01,083756,Briones; Jor-el Thomas Caparas,0,0,36,36
1656119184608,MATH 20B,A02,083757,Briones; Jor-el Thomas Caparas,0,0,36,36
1656119184608,MATH 20B,A03,093475,Staff,2,0,36,34
1656119190629,MATH 20C,A01,083760,Briones; Jor-el Thomas Caparas,2,2,35,33
1656119190629,MATH 20C,A02,083761,Briones; Jor-el Thomas Caparas,9,1,35,26
1656119190629,MATH 20C,A03,093476,Staff,1,1,35,34
1656119190629,MATH 20C,B01,083762,Bach; Quang Tran,1,0,30,29
1656119196655,MATH 20D,A01,083765,Tran; Brian Kha,2,0,30,28
1656119196655,MATH 20D,A02,083766,Tran; Brian Kha,0,1,30,30
1656119196655,MATH 20D,A03,083767,Tran; Brian Kha,2,0,30,28
1656119202701,MATH 20E,A01,083771,Ganguly; Soumya,4,1,32,28
1656119202701,MATH 20E,A02,083772,Ganguly; Soumya,2,2,32,30
1656119202701,MATH 20E,B01,083773,Ciotti; Benjamin,14,0,35,21
1656119202701,MATH 20E,B02,083774,Ciotti; Benjamin,14,0,35,21
1656119208726,MATH 103A,A01,083777,Greenfeld; Be'Eri,2,0,36,34
1656119208726,MATH 103A,A02,083778,Greenfeld; Be'Eri,2,0,36,34
1656119208726,MATH 103A,A03,093561,Staff,4,1,36,32
1656119208726,MATH 103A,B01,083779,Greenfeld; Be'Eri,8,1,36,28
1656119208726,MATH 103A,B02,083780,Greenfeld; Be'Eri,0,0,36,36
1656119208726,MATH 103A,B03,093562,Staff,0,0,36,36
1656119214756,MATH 105,A01,085443,Carter; Anne Toulson,4,1,35,31
1656119214756,MATH 105,A02,093477,Staff,9,0,35,26
1656119220781,MATH 109,A01,083213,Ganzberger; Geoffrey Michael,1,1,34,33
1656119220781,MATH 109,A02,083214,Ganzberger; Geoffrey Michael,0,0,34,34
1656119220781,MATH 109,A03,093478,Staff,1,0,34,33
1656119220781,MATH 109,B01,083215,Ganzberger; Geoffrey Michael,3,0,32,29
1656119220781,MATH 109,B02,083216,Ganzberger; Geoffrey Michael,1,0,32,31
1656119220781,MATH 109,B03,093479,Staff,4,0,32,28
1656119226814,MATH 142A,A01,083219,Chow; Bennett,1,0,32,31
1656119226814,MATH 142A,A02,083220,Chow; Bennett,8,0,32,24
1656119226814,MATH 142A,A03,093480,Staff,5,0,32,27
1656119226814,MATH 142A,B03,093481,Staff,4,0,32,28
1656119226814,MATH 142A,B04,093558,Staff,5,0,32,27
1656119226814,MATH 142A,B05,093559,Staff,0,0,32,32
1656119232844,MATH 193A,A01,083224,Rotar; Vladimir,1,2,34,33
1656119232844,MATH 193A,A02,083225,Rotar; Vladimir,1,0,34,33
1656119232844,MATH 193A,A03,083781,Rotar; Vladimir,1,0,34,33
1656119232844,MATH 193A,A04,083782,Rotar; Vladimir,6,0,34,28
1656119232844,MATH 193A,A05,093482,Rotar; Vladimir,1,0,34,33
1656119238868,MATH 197,001,091859,McAuley; Julian John,9999,0,9999,0
1656119238868,MATH 197,002,095566,Kedlaya; Kiran S.,9997,0,9999,2
1656119238868,MATH 197,003,095567,Xiao; Ming,9999,0,9999,0
1656119238868,MATH 197,004,095571,Perols; Johan Lars,9998,0,9999,1
1656119245933,COGS 9,A01,083615,Shannon; Kyle Michael,5,1,75,70
1656119251971,COGS 11,A01,083617,Boyle; Mary E. T.,16,2,48,32
1656119258007,COGS 13,A01,083071,Bastos; Amalia Pinkusfeld,8,3,71,63
1656119264036,COGS 14A,A01,092681,Semenuks; Arturs,8,24,100,92
1656119270061,COGS 14B,A01,083073,Cheng; Tzu-Han,7,0,63,56
1656119276084,COGS 17,A01,092677,Semenuks; Arturs,13,6,81,68
1656119282107,COGS 100,A01,083619,Allen; Michael Gordon,7,5,70,63
1656119288131,COGS 101A,A01,083621,Davis; Joshua Daniel,7,3,68,61
1656119294164,COGS 101B,A01,091572,Allen; Michael Gordon,6,0,65,59
1656119300197,COGS 101C,A01,083625,Delgado; Tania,11,0,35,24
1656119306230,COGS 107A,A01,083627,Boyle; Mary E. T.,5,4,60,55
1656119312263,COGS 118A,A01,083075,Gupta; Anjum,24,17,76,52
1656119318291,CSE 3,A50,083646,Miranda; Gregory Joseph,18,0,50,32
1656119324323,CSE 8A,A50,083650,Miranda; Gregory Joseph,13,12,56,43
1656119330349,CSE 11,A01,083080,Cao; Yingjun,1,59,40,39
1656119336377,CSE 12,A01,083652,Krause-Levy; Sophia Louisa,14,8,120,106
1656119342401,CSE 15L,A01,083654,Morris; Justin Loren,5,2,50,45
1656119342401,CSE 15L,A02,083655,Morris; Justin Loren,7,2,50,43
1656119348423,CSE 20,A01,083657,Tran; Khoa Dang,31,0,80,49
1656119354445,CSE 21,A01,095574,Bach; Quang Tran,25,0,48,23
1656119360470,CSE 30,A01,083084,Eldon; John,3,11,80,77
1656119360470,CSE 30,B01,095061,Bhaskar; Nishant,4,5,50,46
1656119366494,CSE 100,A01,083659,Cao; Yingjun,2,22,70,68
1656119372517,CSE 134B,A01,083661,Powell; Thomas Allan,11,8,100,89
1656119378543,CSE 140,A01,083663,Gungor; Onat,9,0,85,76
1656119384568,CSE 140L,A01,083088,Eldon; John,8,0,100,92
1656119390594,CSE 175,A01,083665,Kumar; Rakesh,0,0,25,25
1656119396617,CSE 190,A00,092507,Dubnov; Shlomo,2,0,20,18
1656119402647,ECE 45,A01,083139,Congero; Spencer William,5,4,75,70
1656119408674,ECE 65,A50,083695,Saad; Andrew S,8,0,30,22
1656119408674,ECE 65,A51,095125,Staff,23,0,26,3
1656119414701,ECE 109,A01,091882,Touri; Behrouz,7,7,70,63
1656119420724,ECE 180,A00,083140,Abi Samra; Nicholas Camill,1,0,30,29
1656119420724,ECE 180,B00,083141,Abi Samra; Nicholas Camill,4,8,30,26
1656119426749,MATH 10A,A01,083735,Patchell; Gregory David,0,0,30,30
1656119426749,MATH 10A,A02,083736,Patchell; Gregory David,22,0,30,8
1656119426749,MATH 10A,A03,083737,Patchell; Gregory David,16,0,30,14
1656119432777,MATH 10B,A01,083207,Lim; Seonhee,3,3,34,31
1656119432777,MATH 10B,A02,083208,Lim; Seonhee,10,2,35,25
1656119432777,MATH 10B,A03,093472,Staff,4,3,34,30
1656119432777,MATH 10B,B01,083739,Sinha; Shubham,12,0,30,18
1656119438837,MATH 18,A01,083743,Cinel; Cameron Alexander,7,0,30,23
1656119438837,MATH 18,A02,083744,Cinel; Cameron Alexander,10,0,30,20
1656119438837,MATH 18,A03,083745,Cinel; Cameron Alexander,3,0,30,27
1656119438837,MATH 18,B01,083748,Rideout; David Porter,0,0,36,36
1656119438837,MATH 18,B02,083749,Rideout; David Porter,0,0,36,36
1656119438837,MATH 18,B03,083750,Rideout; David Porter,0,0,36,36
1656119438837,MATH 18,B04,083751,Rideout; David Porter,0,0,36,36
1656119438837,MATH 18,B05,093473,Rideout; David Porter,2,0,36,34
1656119438837,MATH 18,B06,093474,Rideout; David Porter,4,0,36,32
1656119444860,MATH 20A,A01,083754,Zheng; Zequn,11,0,40,29
1656119450888,MATH 20B,A01,083756,Briones; Jor-el Thomas Caparas,0,0,36,36
1656119450888,MATH 20B,A02,083757,Briones; Jor-el Thomas Caparas,0,0,36,36
1656119450888,MATH 20B,A03,093475,Staff,2,0,36,34
1656119456911,MATH 20C,A01,083760,Briones; Jor-el Thomas Caparas,2,2,35,33
1656119456911,MATH 20C,A02,083761,Briones; Jor-el Thomas Caparas,9,1,35,26
1656119456911,MATH 20C,A03,093476,Staff,1,1,35,34
1656119456911,MATH 20C,B01,083762,Bach; Quang Tran,1,0,30,29
1656119462937,MATH 20D,A01,083765,Tran; Brian Kha,2,0,30,28
1656119462937,MATH 20D,A02,083766,Tran; Brian Kha,0,1,30,30
1656119462937,MATH 20D,A03,083767,Tran; Brian Kha,2,0,30,28
1656119468966,MATH 20E,A01,083771,Ganguly; Soumya,4,1,32,28
1656119468966,MATH 20E,A02,083772,Ganguly; Soumya,2,2,32,30
1656119468966,MATH 20E,B01,083773,Ciotti; Benjamin,14,0,35,21
1656119468966,MATH 20E,B02,083774,Ciotti; Benjamin,14,0,35,21
1656119474994,MATH 103A,A01,083777,Greenfeld; Be'Eri,2,0,36,34
1656119474994,MATH 103A,A02,083778,Greenfeld; Be'Eri,2,0,36,34
1656119474994,MATH 103A,A03,093561,Staff,4,1,36,32
1656119474994,MATH 103A,B01,083779,Greenfeld; Be'Eri,8,1,36,28
1656119474994,MATH 103A,B02,083780,Greenfeld; Be'Eri,0,0,36,36
1656119474994,MATH 103A,B03,093562,Staff,0,0,36,36
1656119481017,MATH 105,A01,085443,Carter; Anne Toulson,4,1,35,31
1656119481017,MATH 105,A02,093477,Staff,9,0,35,26
1656119487045,MATH 109,A01,083213,Ganzberger; Geoffrey Michael,1,1,34,33
1656119487045,MATH 109,A02,083214,Ganzberger; Geoffrey Michael,0,0,34,34
1656119487045,MATH 109,A03,093478,Staff,1,0,34,33
1656119487045,MATH 109,B01,083215,Ganzberger; Geoffrey Michael,3,0,32,29
1656119487045,MATH 109,B02,083216,Ganzberger; Geoffrey Michael,1,0,32,31
1656119487045,MATH 109,B03,093479,Staff,4,0,32,28
1656119493075,MATH 142A,A01,083219,Chow; Bennett,1,0,32,31
1656119493075,MATH 142A,A02,083220,Chow; Bennett,8,0,32,24
1656119493075,MATH 142A,A03,093480,Staff,5,0,32,27
1656119493075,MATH 142A,B03,093481,Staff,4,0,32,28
1656119493075,MATH 142A,B04,093558,Staff,5,0,32,27
1656119493075,MATH 142A,B05,093559,Staff,0,0,32,32
1656119499099,MATH 193A,A01,083224,Rotar; Vladimir,1,2,34,33
1656119499099,MATH 193A,A02,083225,Rotar; Vladimir,1,0,34,33
1656119499099,MATH 193A,A03,083781,Rotar; Vladimir,1,0,34,33
1656119499099,MATH 193A,A04,083782,Rotar; Vladimir,6,0,34,28
1656119499099,MATH 193A,A05,093482,Rotar; Vladimir,1,0,34,33
1656119505194,MATH 197,001,091859,McAuley; Julian John,9999,0,9999,0
1656119505194,MATH 197,002,095566,Kedlaya; Kiran S.,9997,0,9999,2
1656119505194,MATH 197,003,095567,Xiao; Ming,9999,0,9999,0
1656119505194,MATH 197,004,095571,Perols; Johan Lars,9998,0,9999,1
1656119512255,COGS 9,A01,083615,Shannon; Kyle Michael,5,1,75,70
1656119518279,COGS 11,A01,083617,Boyle; Mary E. T.,16,2,48,32
1656119524306,COGS 13,A01,083071,Bastos; Amalia Pinkusfeld,9,3,71,62
1656119530328,COGS 14A,A01,092681,Semenuks; Arturs,8,24,100,92
1656119536353,COGS 14B,A01,083073,Cheng; Tzu-Han,7,0,63,56
1656119542374,COGS 17,A01,092677,Semenuks; Arturs,13,6,81,68
1656119548396,COGS 100,A01,083619,Allen; Michael Gordon,7,5,70,63
1656119554423,COGS 101A,A01,083621,Davis; Joshua Daniel,7,3,68,61
1656119560449,COGS 101B,A01,091572,Allen; Michael Gordon,6,0,65,59
1656119566472,COGS 101C,A01,083625,Delgado; Tania,11,0,35,24
1656119572496,COGS 107A,A01,083627,Boyle; Mary E. T.,5,4,60,55
1656119578533,COGS 118A,A01,083075,Gupta; Anjum,24,17,76,52
1656119584557,CSE 3,A50,083646,Miranda; Gregory Joseph,18,0,50,32
1656119590581,CSE 8A,A50,083650,Miranda; Gregory Joseph,13,12,56,43
1656119596620,CSE 11,A01,083080,Cao; Yingjun,1,59,40,39
1656119602650,CSE 12,A01,083652,Krause-Levy; Sophia Louisa,14,8,120,106
1656119608672,CSE 15L,A01,083654,Morris; Justin Loren,5,2,50,45
1656119608672,CSE 15L,A02,083655,Morris; Justin Loren,7,2,50,43
1656119614696,CSE 20,A01,083657,Tran; Khoa Dang,31,0,80,49
1656119620723,CSE 21,A01,095574,Bach; Quang Tran,25,0,48,23
1656119626750,CSE 30,A01,083084,Eldon; John,3,11,80,77
1656119626750,CSE 30,B01,095061,Bhaskar; Nishant,4,5,50,46
1656119632777,CSE 100,A01,083659,Cao; Yingjun,2,22,70,68
1656119638800,CSE 134B,A01,083661,Powell; Thomas Allan,11,8,100,89
1656119644823,CSE 140,A01,083663,Gungor; Onat,9,0,85,76
1656119650847,CSE 140L,A01,083088,Eldon; John,8,0,100,92
1656119656877,CSE 175,A01,083665,Kumar; Rakesh,0,0,25,25
1656119662901,CSE 190,A00,092507,Dubnov; Shlomo,2,0,20,18
1656119668924,ECE 45,A01,083139,Congero; Spencer William,5,4,75,70
1656119674952,ECE 65,A50,083695,Saad; Andrew S,8,0,30,22
1656119674952,ECE 65,A51,095125,Staff,23,0,26,3
1656119680986,ECE 109,A01,091882,Touri; Behrouz,7,7,70,63
1656119687013,ECE 180,A00,083140,Abi Samra; Nicholas Camill,1,0,30,29
1656119687013,ECE 180,B00,083141,Abi Samra; Nicholas Camill,4,8,30,26
1656119693039,MATH 10A,A01,083735,Patchell; Gregory David,0,0,30,30
1656119693039,MATH 10A,A02,083736,Patchell; Gregory David,22,0,30,8
1656119693039,MATH 10A,A03,083737,Patchell; Gregory David,16,0,30,14
1656119699061,MATH 10B,A01,083207,Lim; Seonhee,3,3,34,31
1656119699061,MATH 10B,A02,083208,Lim; Seonhee,10,2,35,25
1656119699061,MATH 10B,A03,093472,Staff,4,3,34,30
1656119699061,MATH 10B,B01,083739,Sinha; Shubham,12,0,30,18
1656119705091,MATH 18,A01,083743,Cinel; Cameron Alexander,7,0,30,23
1656119705091,MATH 18,A02,083744,Cinel; Cameron Alexander,10,0,30,20
1656119705091,MATH 18,A03,083745,Cinel; Cameron Alexander,3,0,30,27
1656119705091,MATH 18,B01,083748,Rideout; David Porter,0,0,36,36
1656119705091,MATH 18,B02,083749,Rideout; David Porter,0,0,36,36
1656119705091,MATH 18,B03,083750,Rideout; David Porter,0,0,36,36
1656119705091,MATH 18,B04,083751,Rideout; David Porter,0,0,36,36
1656119705091,MATH 18,B05,093473,Rideout; David Porter,2,0,36,34
1656119705091,MATH 18,B06,093474,Rideout; David Porter,4,0,36,32
1656119711115,MATH 20A,A01,083754,Zheng; Zequn,11,0,40,29
1656119717145,MATH 20B,A01,083756,Briones; Jor-el Thomas Caparas,0,0,36,36
1656119717145,MATH 20B,A02,083757,Briones; Jor-el Thomas Caparas,0,0,36,36
1656119717145,MATH 20B,A03,093475,Staff,2,0,36,34
1656119723172,MATH 20C,A01,083760,Briones; Jor-el Thomas Caparas,2,2,35,33
1656119723172,MATH 20C,A02,083761,Briones; Jor-el Thomas Caparas,9,1,35,26
1656119723172,MATH 20C,A03,093476,Staff,1,1,35,34
1656119723172,MATH 20C,B01,083762,Bach; Quang Tran,1,0,30,29
1656119729209,MATH 20D,A01,083765,Tran; Brian Kha,2,0,30,28
1656119729209,MATH 20D,A02,083766,Tran; Brian Kha,0,1,30,30
1656119729209,MATH 20D,A03,083767,Tran; Brian Kha,2,0,30,28
1656119735233,MATH 20E,A01,083771,Ganguly; Soumya,4,1,32,28
1656119735233,MATH 20E,A02,083772,Ganguly; Soumya,2,2,32,30
1656119735233,MATH 20E,B01,083773,Ciotti; Benjamin,14,0,35,21
1656119735233,MATH 20E,B02,083774,Ciotti; Benjamin,14,0,35,21
1656119741261,MATH 103A,A01,083777,Greenfeld; Be'Eri,2,0,36,34
1656119741261,MATH 103A,A02,083778,Greenfeld; Be'Eri,2,0,36,34
1656119741261,MATH 103A,A03,093561,Staff,4,1,36,32
1656119741261,MATH 103A,B01,083779,Greenfeld; Be'Eri,8,1,36,28
1656119741261,MATH 103A,B02,083780,Greenfeld; Be'Eri,0,0,36,36
1656119741261,MATH 103A,B03,093562,Staff,0,0,36,36
1656119747286,MATH 105,A01,085443,Carter; Anne Toulson,4,1,35,31
1656119747286,MATH 105,A02,093477,Staff,9,0,35,26
1656119753309,MATH 109,A01,083213,Ganzberger; Geoffrey Michael,1,1,34,33
1656119753309,MATH 109,A02,083214,Ganzberger; Geoffrey Michael,0,0,34,34
1656119753309,MATH 109,A03,093478,Staff,1,0,34,33
1656119753309,MATH 109,B01,083215,Ganzberger; Geoffrey Michael,3,0,32,29
1656119753309,MATH 109,B02,083216,Ganzberger; Geoffrey Michael,1,0,32,31
1656119753309,MATH 109,B03,093479,Staff,4,0,32,28
1656119759333,MATH 142A,A01,083219,Chow; Bennett,1,0,32,31
1656119759333,MATH 142A,A02,083220,Chow; Bennett,8,0,32,24
1656119759333,MATH 142A,A03,093480,Staff,5,0,32,27
1656119759333,MATH 142A,B03,093481,Staff,4,0,32,28
1656119759333,MATH 142A,B04,093558,Staff,5,0,32,27
1656119759333,MATH 142A,B05,093559,Staff,0,0,32,32
1656119765361,MATH 193A,A01,083224,Rotar; Vladimir,1,2,34,33
1656119765361,MATH 193A,A02,083225,Rotar; Vladimir,1,0,34,33
1656119765361,MATH 193A,A03,083781,Rotar; Vladimir,1,0,34,33
1656119765361,MATH 193A,A04,083782,Rotar; Vladimir,6,0,34,28
1656119765361,MATH 193A,A05,093482,Rotar; Vladimir,1,0,34,33
1656119771385,MATH 197,001,091859,McAuley; Julian John,9999,0,9999,0
1656119771385,MATH 197,002,095566,Kedlaya; Kiran S.,9997,0,9999,2
1656119771385,MATH 197,003,095567,Xiao; Ming,9999,0,9999,0
1656119771385,MATH 197,004,095571,Perols; Johan Lars,9998,0,9999,1
1656119778439,COGS 9,A01,083615,Shannon; Kyle Michael,5,1,75,70
1656119784462,COGS 11,A01,083617,Boyle; Mary E. T.,16,2,48,32
1656119790489,COGS 13,A01,083071,Bastos; Amalia Pinkusfeld,9,3,71,62
1656119796512,COGS 14A,A01,092681,Semenuks; Arturs,8,24,100,92
1656119802540,COGS 14B,A01,083073,Cheng; Tzu-Han,7,0,63,56
1656119808567,COGS 17,A01,092677,Semenuks; Arturs,13,6,81,68
1656119814600,COGS 100,A01,083619,Allen; Michael Gordon,7,5,70,63
1656119820630,COGS 101A,A01,083621,Davis; Joshua Daniel,7,3,68,61
1656119826661,COGS 101B,A01,091572,Allen; Michael Gordon,6,0,65,59
1656119832687,COGS 101C,A01,083625,Delgado; Tania,11,0,35,24
1656119838734,COGS 107A,A01,083627,Boyle; Mary E. T.,5,4,60,55
1656119844758,COGS 118A,A01,083075,Gupta; Anjum,24,17,76,52
1656119850792,CSE 3,A50,083646,Miranda; Gregory Joseph,18,0,50,32
1656119856818,CSE 8A,A50,083650,Miranda; Gregory Joseph,13,12,56,43
1656119862842,CSE 11,A01,083080,Cao; Yingjun,1,59,40,39
1656119868872,CSE 12,A01,083652,Krause-Levy; Sophia Louisa,14,8,120,106
1656119874896,CSE 15L,A01,083654,Morris; Justin Loren,5,2,50,45
1656119874896,CSE 15L,A02,083655,Morris; Justin Loren,7,2,50,43
1656119880920,CSE 20,A01,083657,Tran; Khoa Dang,31,0,80,49
1656119886943,CSE 21,A01,095574,Bach; Quang Tran,25,0,48,23
1656119892967,CSE 30,A01,083084,Eldon; John,3,11,80,77
1656119892967,CSE 30,B01,095061,Bhaskar; Nishant,4,5,50,46
1656119898991,CSE 100,A01,083659,Cao; Yingjun,2,22,70,68
1656119905016,CSE 134B,A01,083661,Powell; Thomas Allan,11,8,100,89
1656119911051,CSE 140,A01,083663,Gungor; Onat,9,0,85,76
1656119917074,CSE 140L,A01,083088,Eldon; John,8,0,100,92
1656119923100,CSE 175,A01,083665,Kumar; Rakesh,0,0,25,25
1656119929130,CSE 190,A00,092507,Dubnov; Shlomo,2,0,20,18
1656119935156,ECE 45,A01,083139,Congero; Spencer William,5,4,75,70
1656119941182,ECE 65,A50,083695,Saad; Andrew S,8,0,30,22
1656119941182,ECE 65,A51,095125,Staff,23,0,26,3
1656119947209,ECE 109,A01,091882,Touri; Behrouz,7,7,70,63
1656119953230,ECE 180,A00,083140,Abi Samra; Nicholas Camill,1,0,30,29
1656119953230,ECE 180,B00,083141,Abi Samra; Nicholas Camill,4,8,30,26
1656119959257,MATH 10A,A01,083735,Patchell; Gregory David,0,0,30,30
1656119959257,MATH 10A,A02,083736,Patchell; Gregory David,22,0,30,8
1656119959257,MATH 10A,A03,083737,Patchell; Gregory David,16,0,30,14
1656119965278,MATH 10B,A01,083207,Lim; Seonhee,3,3,34,31
1656119965278,MATH 10B,A02,083208,Lim; Seonhee,10,2,35,25
1656119965278,MATH 10B,A03,093472,Staff,4,3,34,30
1656119965278,MATH 10B,B01,083739,Sinha; Shubham,12,0,30,18
1656119971304,MATH 18,A01,083743,Cinel; Cameron Alexander,7,0,30,23
1656119971304,MATH 18,A02,083744,Cinel; Cameron Alexander,10,0,30,20
1656119971304,MATH 18,A03,083745,Cinel; Cameron Alexander,3,0,30,27
1656119971304,MATH 18,B01,083748,Rideout; David Porter,0,0,36,36
1656119971304,MATH 18,B02,083749,Rideout; David Porter,0,0,36,36
1656119971304,MATH 18,B03,083750,Rideout; David Porter,0,0,36,36
1656119971304,MATH 18,B04,083751,Rideout; David Porter,0,0,36,36
1656119971304,MATH 18,B05,093473,Rideout; David Porter,2,0,36,34
1656119971304,MATH 18,B06,093474,Rideout; David Porter,4,0,36,32
1656119977326,MATH 20A,A01,083754,Zheng; Zequn,11,0,40,29
1656119983357,MATH 20B,A01,083756,Briones; Jor-el Thomas Caparas,0,0,36,36
1656119983357,MATH 20B,A02,083757,Briones; Jor-el Thomas Caparas,0,0,36,36
1656119983357,MATH 20B,A03,093475,Staff,2,0,36,34
1656119989386,MATH 20C,A01,083760,Briones; Jor-el Thomas Caparas,2,2,35,33
1656119989386,MATH 20C,A02,083761,Briones; Jor-el Thomas Caparas,9,1,35,26
1656119989386,MATH 20C,A03,093476,Staff,1,1,35,34
1656119989386,MATH 20C,B01,083762,Bach; Quang Tran,1,0,30,29
1656119995409,MATH 20D,A01,083765,Tran; Brian Kha,2,0,30,28
1656119995409,MATH 20D,A02,083766,Tran; Brian Kha,0,1,30,30
1656119995409,MATH 20D,A03,083767,Tran; Brian Kha,2,0,30,28
1656120001434,MATH 20E,A01,083771,Ganguly; Soumya,4,1,32,28
1656120001434,MATH 20E,A02,083772,Ganguly; Soumya,2,2,32,30
1656120001434,MATH 20E,B01,083773,Ciotti; Benjamin,14,0,35,21
1656120001434,MATH 20E,B02,083774,Ciotti; Benjamin,14,0,35,21
1656120007457,MATH 103A,A01,083777,Greenfeld; Be'Eri,2,0,36,34
1656120007457,MATH 103A,A02,083778,Greenfeld; Be'Eri,2,0,36,34
1656120007457,MATH 103A,A03,093561,Staff,4,1,36,32
1656120007457,MATH 103A,B01,083779,Greenfeld; Be'Eri,8,1,36,28
1656120007457,MATH 103A,B02,083780,Greenfeld; Be'Eri,0,0,36,36
1656120007457,MATH 103A,B03,093562,Staff,0,0,36,36
1656120013484,MATH 105,A01,085443,Carter; Anne Toulson,4,1,35,31
1656120013484,MATH 105,A02,093477,Staff,9,0,35,26
1656120019506,MATH 109,A01,083213,Ganzberger; Geoffrey Michael,1,1,34,33
1656120019506,MATH 109,A02,083214,Ganzberger; Geoffrey Michael,0,0,34,34
1656120019506,MATH 109,A03,093478,Staff,1,0,34,33
1656120019506,MATH 109,B01,083215,Ganzberger; Geoffrey Michael,3,0,32,29
1656120019506,MATH 109,B02,083216,Ganzberger; Geoffrey Michael,1,0,32,31
1656120019506,MATH 109,B03,093479,Staff,4,0,32,28
1656120025530,MATH 142A,A01,083219,Chow; Bennett,1,0,32,31
1656120025530,MATH 142A,A02,083220,Chow; Bennett,8,0,32,24
1656120025530,MATH 142A,A03,093480,Staff,5,0,32,27
1656120025530,MATH 142A,B03,093481,Staff,4,0,32,28
1656120025530,MATH 142A,B04,093558,Staff,5,0,32,27
1656120025530,MATH 142A,B05,093559,Staff,0,0,32,32
1656120031557,MATH 193A,A01,083224,Rotar; Vladimir,1,2,34,33
1656120031557,MATH 193A,A02,083225,Rotar; Vladimir,1,0,34,33
1656120031557,MATH 193A,A03,083781,Rotar; Vladimir,1,0,34,33
1656120031557,MATH 193A,A04,083782,Rotar; Vladimir,6,0,34,28
1656120031557,MATH 193A,A05,093482,Rotar; Vladimir,1,0,34,33
1656120037582,MATH 197,001,091859,McAuley; Julian John,9999,0,9999,0
1656120037582,MATH 197,002,095566,Kedlaya; Kiran S.,9997,0,9999,2
1656120037582,MATH 197,003,095567,Xiao; Ming,9999,0,9999,0
1656120037582,MATH 197,004,095571,Perols; Johan Lars,9998,0,9999,1
1656120044635,COGS 9,A01,083615,Shannon; Kyle Michael,5,1,75,70
1656120050657,COGS 11,A01,083617,Boyle; Mary E. T.,16,2,48,32
1656120056694,COGS 13,A01,083071,Bastos; Amalia Pinkusfeld,9,3,71,62
1656120062717,COGS 14A,A01,092681,Semenuks; Arturs,8,24,100,92
1656120068745,COGS 14B,A01,083073,Cheng; Tzu-Han,7,0,63,56
1656120074771,COGS 17,A01,092677,Semenuks; Arturs,13,6,81,68
1656120080800,COGS 100,A01,083619,Allen; Michael Gordon,7,5,70,63
1656120086824,COGS 101A,A01,083621,Davis; Joshua Daniel,7,3,68,61
1656120092852,COGS 101B,A01,091572,Allen; Michael Gordon,6,0,65,59
1656120098965,COGS 101C,A01,083625,Delgado; Tania,11,0,35,24
1656120104988,COGS 107A,A01,083627,Boyle; Mary E. T.,5,4,60,55
1656120111022,COGS 118A,A01,083075,Gupta; Anjum,24,17,76,52
1656120117045,CSE 3,A50,083646,Miranda; Gregory Joseph,18,0,50,32
1656120123069,CSE 8A,A50,083650,Miranda; Gregory Joseph,13,12,56,43
1656120129098,CSE 11,A01,083080,Cao; Yingjun,1,59,40,39
1656120135133,CSE 12,A01,083652,Krause-Levy; Sophia Louisa,14,8,120,106
1656120141156,CSE 15L,A01,083654,Morris; Justin Loren,5,2,50,45
1656120141156,CSE 15L,A02,083655,Morris; Justin Loren,7,2,50,43
1656120147180,CSE 20,A01,083657,Tran; Khoa Dang,31,0,80,49
1656120153207,CSE 21,A01,095574,Bach; Quang Tran,25,0,48,23
1656120159230,CSE 30,A01,083084,Eldon; John,3,11,80,77
1656120159230,CSE 30,B01,095061,Bhaskar; Nishant,4,5,50,46
1656120165270,CSE 100,A01,083659,Cao; Yingjun,2,22,70,68
1656120171298,CSE 134B,A01,083661,Powell; Thomas Allan,11,8,100,89
1656120177324,CSE 140,A01,083663,Gungor; Onat,9,0,85,76
1656120183347,CSE 140L,A01,083088,Eldon; John,8,0,100,92
1656120189374,CSE 175,A01,083665,Kumar; Rakesh,0,0,25,25
1656120195401,CSE 190,A00,092507,Dubnov; Shlomo,2,0,20,18
1656120201423,ECE 45,A01,083139,Congero; Spencer William,5,4,75,70
1656120207456,ECE 65,A50,083695,Saad; Andrew S,8,0,30,22
1656120207456,ECE 65,A51,095125,Staff,23,0,26,3
1656120213482,ECE 109,A01,091882,Touri; Behrouz,7,7,70,63
1656120219509,ECE 180,A00,083140,Abi Samra; Nicholas Camill,1,0,30,29
1656120219509,ECE 180,B00,083141,Abi Samra; Nicholas Camill,4,8,30,26
1656120225537,MATH 10A,A01,083735,Patchell; Gregory David,0,0,30,30
1656120225537,MATH 10A,A02,083736,Patchell; Gregory David,22,0,30,8
1656120225537,MATH 10A,A03,083737,Patchell; Gregory David,16,0,30,14
1656120231562,MATH 10B,A01,083207,Lim; Seonhee,3,3,34,31
1656120231562,MATH 10B,A02,083208,Lim; Seonhee,10,2,35,25
1656120231562,MATH 10B,A03,093472,Staff,4,3,34,30
1656120231562,MATH 10B,B01,083739,Sinha; Shubham,12,0,30,18
1656120237586,MATH 18,A01,083743,Cinel; Cameron Alexander,7,0,30,23
1656120237586,MATH 18,A02,083744,Cinel; Cameron Alexander,10,0,30,20
1656120237586,MATH 18,A03,083745,Cinel; Cameron Alexander,3,0,30,27
1656120237586,MATH 18,B01,083748,Rideout; David Porter,0,0,36,36
1656120237586,MATH 18,B02,083749,Rideout; David Porter,0,0,36,36
1656120237586,MATH 18,B03,083750,Rideout; David Porter,0,0,36,36
1656120237586,MATH 18,B04,083751,Rideout; David Porter,0,0,36,36
1656120237586,MATH 18,B05,093473,Rideout; David Porter,2,0,36,34
1656120237586,MATH 18,B06,093474,Rideout; David Porter,4,0,36,32
1656120243614,MATH 20A,A01,083754,Zheng; Zequn,11,0,40,29
1656120249642,MATH 20B,A01,083756,Briones; Jor-el Thomas Caparas,0,0,36,36
1656120249642,MATH 20B,A02,083757,Briones; Jor-el Thomas Caparas,0,0,36,36
1656120249642,MATH 20B,A03,093475,Staff,2,0,36,34
1656120255669,MATH 20C,A01,083760,Briones; Jor-el Thomas Caparas,2,2,35,33
1656120255669,MATH 20C,A02,083761,Briones; Jor-el Thomas Caparas,9,1,35,26
1656120255669,MATH 20C,A03,093476,Staff,1,1,35,34
1656120255669,MATH 20C,B01,083762,Bach; Quang Tran,1,0,30,29
1656120261699,MATH 20D,A01,083765,Tran; Brian Kha,2,0,30,28
1656120261699,MATH 20D,A02,083766,Tran; Brian Kha,0,1,30,30
1656120261699,MATH 20D,A03,083767,Tran; Brian Kha,2,0,30,28
1656120267729,MATH 20E,A01,083771,Ganguly; Soumya,4,1,32,28
1656120267729,MATH 20E,A02,083772,Ganguly; Soumya,2,2,32,30
1656120267729,MATH 20E,B01,083773,Ciotti; Benjamin,14,0,35,21
1656120267729,MATH 20E,B02,083774,Ciotti; Benjamin,14,0,35,21
1656120273751,MATH 103A,A01,083777,Greenfeld; Be'Eri,2,0,36,34
1656120273751,MATH 103A,A02,083778,Greenfeld; Be'Eri,2,0,36,34
1656120273751,MATH 103A,A03,093561,Staff,4,1,36,32
1656120273751,MATH 103A,B01,083779,Greenfeld; Be'Eri,8,1,36,28
1656120273751,MATH 103A,B02,083780,Greenfeld; Be'Eri,0,0,36,36
1656120273751,MATH 103A,B03,093562,Staff,0,0,36,36
1656120279779,MATH 105,A01,085443,Carter; Anne Toulson,4,1,35,31
1656120279779,MATH 105,A02,093477,Staff,9,0,35,26
1656120285803,MATH 109,A01,083213,Ganzberger; Geoffrey Michael,1,1,34,33
1656120285803,MATH 109,A02,083214,Ganzberger; Geoffrey Michael,0,0,34,34
1656120285803,MATH 109,A03,093478,Staff,1,0,34,33
1656120285803,MATH 109,B01,083215,Ganzberger; Geoffrey Michael,3,0,32,29
1656120285803,MATH 109,B02,083216,Ganzberger; Geoffrey Michael,1,0,32,31
1656120285803,MATH 109,B03,093479,Staff,4,0,32,28
1656120291828,MATH 142A,A01,083219,Chow; Bennett,1,0,32,31
1656120291828,MATH 142A,A02,083220,Chow; Bennett,8,0,32,24
1656120291828,MATH 142A,A03,093480,Staff,5,0,32,27
1656120291828,MATH 142A,B03,093481,Staff,4,0,32,28
1656120291828,MATH 142A,B04,093558,Staff,5,0,32,27
1656120291828,MATH 142A,B05,093559,Staff,0,0,32,32
1656120297859,MATH 193A,A01,083224,Rotar; Vladimir,1,2,34,33
1656120297859,MATH 193A,A02,083225,Rotar; Vladimir,1,0,34,33
1656120297859,MATH 193A,A03,083781,Rotar; Vladimir,1,0,34,33
1656120297859,MATH 193A,A04,083782,Rotar; Vladimir,6,0,34,28
1656120297859,MATH 193A,A05,093482,Rotar; Vladimir,1,0,34,33
1656120303887,MATH 197,001,091859,McAuley; Julian John,9999,0,9999,0
1656120303887,MATH 197,002,095566,Kedlaya; Kiran S.,9997,0,9999,2
1656120303887,MATH 197,003,095567,Xiao; Ming,9999,0,9999,0
1656120303887,MATH 197,004,095571,Perols; Johan Lars,9998,0,9999,1
1656120310941,COGS 9,A01,083615,Shannon; Kyle Michael,5,1,75,70
1656120316963,COGS 11,A01,083617,Boyle; Mary E. T.,16,2,48,32
1656120322991,COGS 13,A01,083071,Bastos; Amalia Pinkusfeld,9,3,71,62
1656120329023,COGS 14A,A01,092681,Semenuks; Arturs,8,24,100,92
1656120335047,COGS 14B,A01,083073,Cheng; Tzu-Han,7,0,63,56
1656120341077,COGS 17,A01,092677,Semenuks; Arturs,13,6,81,68
1656120347107,COGS 100,A01,083619,Allen; Michael Gordon,7,5,70,63
1656120353134,COGS 101A,A01,083621,Davis; Joshua Daniel,7,3,68,61
1656120359158,COGS 101B,A01,091572,Allen; Michael Gordon,6,0,65,59
1656120365181,COGS 101C,A01,083625,Delgado; Tania,11,0,35,24
1656120371208,COGS 107A,A01,083627,Boyle; Mary E. T.,5,4,60,55
1656120377232,COGS 118A,A01,083075,Gupta; Anjum,24,17,76,52
1656120383261,CSE 3,A50,083646,Miranda; Gregory Joseph,18,0,50,32
1656120389285,CSE 8A,A50,083650,Miranda; Gregory Joseph,13,12,56,43
1656120395308,CSE 11,A01,083080,Cao; Yingjun,1,59,40,39
1656120401335,CSE 12,A01,083652,Krause-Levy; Sophia Louisa,14,8,120,106
1656120407362,CSE 15L,A01,083654,Morris; Justin Loren,5,2,50,45
1656120407362,CSE 15L,A02,083655,Morris; Justin Loren,7,2,50,43
1656120413392,CSE 20,A01,083657,Tran; Khoa Dang,31,0,80,49
1656120419414,CSE 21,A01,095574,Bach; Quang Tran,25,0,48,23
1656120425439,CSE 30,A01,083084,Eldon; John,3,11,80,77
1656120425439,CSE 30,B01,095061,Bhaskar; Nishant,4,5,50,46
1656120431462,CSE 100,A01,083659,Cao; Yingjun,2,22,70,68
1656120437485,CSE 134B,A01,083661,Powell; Thomas Allan,11,8,100,89
1656120443508,CSE 140,A01,083663,Gungor; Onat,9,0,85,76
1656120449534,CSE 140L,A01,083088,Eldon; John,8,0,100,92
1656120455558,CSE 175,A01,083665,Kumar; Rakesh,0,0,25,25
1656120461581,CSE 190,A00,092507,Dubnov; Shlomo,2,0,20,18
1656120467604,ECE 45,A01,083139,Congero; Spencer William,5,4,75,70
1656120473628,ECE 65,A50,083695,Saad; Andrew S,8,0,30,22
1656120473628,ECE 65,A51,095125,Staff,23,0,26,3
1656120479656,ECE 109,A01,091882,Touri; Behrouz,7,7,70,63
1656120485685,ECE 180,A00,083140,Abi Samra; Nicholas Camill,1,0,30,29
1656120485685,ECE 180,B00,083141,Abi Samra; Nicholas Camill,4,8,30,26
1656120491709,MATH 10A,A01,083735,Patchell; Gregory David,0,0,30,30
1656120491709,MATH 10A,A02,083736,Patchell; Gregory David,22,0,30,8
1656120491709,MATH 10A,A03,083737,Patchell; Gregory David,16,0,30,14
1656120497733,MATH 10B,A01,083207,Lim; Seonhee,3,3,34,31
1656120497733,MATH 10B,A02,083208,Lim; Seonhee,10,2,35,25
1656120497733,MATH 10B,A03,093472,Staff,4,3,34,30
1656120497733,MATH 10B,B01,083739,Sinha; Shubham,12,0,30,18
1656120503758,MATH 18,A01,083743,Cinel; Cameron Alexander,7,0,30,23
1656120503758,MATH 18,A02,083744,Cinel; Cameron Alexander,10,0,30,20
1656120503758,MATH 18,A03,083745,Cinel; Cameron Alexander,3,0,30,27
1656120503758,MATH 18,B01,083748,Rideout; David Porter,0,0,36,36
1656120503758,MATH 18,B02,083749,Rideout; David Porter,0,0,36,36
1656120503758,MATH 18,B03,083750,Rideout; David Porter,0,0,36,36
1656120503758,MATH 18,B04,083751,Rideout; David Porter,0,0,36,36
1656120503758,MATH 18,B05,093473,Rideout; David Porter,2,0,36,34
1656120503758,MATH 18,B06,093474,Rideout; David Porter,4,0,36,32
1656120509783,MATH 20A,A01,083754,Zheng; Zequn,11,0,40,29
1656120515806,MATH 20B,A01,083756,Briones; Jor-el Thomas Caparas,0,0,36,36
1656120515806,MATH 20B,A02,083757,Briones; Jor-el Thomas Caparas,0,0,36,36
1656120515806,MATH 20B,A03,093475,Staff,2,0,36,34
1656120521832,MATH 20C,A01,083760,Briones; Jor-el Thomas Caparas,2,2,35,33
1656120521832,MATH 20C,A02,083761,Briones; Jor-el Thomas Caparas,9,1,35,26
1656120521832,MATH 20C,A03,093476,Staff,1,1,35,34
1656120521832,MATH 20C,B01,083762,Bach; Quang Tran,1,0,30,29
1656120527856,MATH 20D,A01,083765,Tran; Brian Kha,2,0,30,28
1656120527856,MATH 20D,A02,083766,Tran; Brian Kha,0,1,30,30
1656120527856,MATH 20D,A03,083767,Tran; Brian Kha,2,0,30,28
1656120533883,MATH 20E,A01,083771,Ganguly; Soumya,4,1,32,28
1656120533883,MATH 20E,A02,083772,Ganguly; Soumya,2,2,32,30
1656120533883,MATH 20E,B01,083773,Ciotti; Benjamin,14,0,35,21
1656120533883,MATH 20E,B02,083774,Ciotti; Benjamin,14,0,35,21
1656120539908,MATH 103A,A01,083777,Greenfeld; Be'Eri,2,0,36,34
1656120539908,MATH 103A,A02,083778,Greenfeld; Be'Eri,2,0,36,34
1656120539908,MATH 103A,A03,093561,Staff,4,1,36,32
1656120539908,MATH 103A,B01,083779,Greenfeld; Be'Eri,8,1,36,28
1656120539908,MATH 103A,B02,083780,Greenfeld; Be'Eri,0,0,36,36
1656120539908,MATH 103A,B03,093562,Staff,0,0,36,36
1656120545937,MATH 105,A01,085443,Carter; Anne Toulson,4,1,35,31
1656120545937,MATH 105,A02,093477,Staff,9,0,35,26
1656120551961,MATH 109,A01,083213,Ganzberger; Geoffrey Michael,1,1,34,33
1656120551961,MATH 109,A02,083214,Ganzberger; Geoffrey Michael,0,0,34,34
1656120551961,MATH 109,A03,093478,Staff,1,0,34,33
1656120551961,MATH 109,B01,083215,Ganzberger; Geoffrey Michael,3,0,32,29
1656120551961,MATH 109,B02,083216,Ganzberger; Geoffrey Michael,1,0,32,31
1656120551961,MATH 109,B03,093479,Staff,4,0,32,28
1656120557992,MATH 142A,A01,083219,Chow; Bennett,1,0,32,31
1656120557992,MATH 142A,A02,083220,Chow; Bennett,8,0,32,24
1656120557992,MATH 142A,A03,093480,Staff,5,0,32,27
1656120557992,MATH 142A,B03,093481,Staff,4,0,32,28
1656120557992,MATH 142A,B04,093558,Staff,5,0,32,27
1656120557992,MATH 142A,B05,093559,Staff,0,0,32,32
1656120564031,MATH 193A,A01,083224,Rotar; Vladimir,1,2,34,33
1656120564031,MATH 193A,A02,083225,Rotar; Vladimir,1,0,34,33
1656120564031,MATH 193A,A03,083781,Rotar; Vladimir,1,0,34,33
1656120564031,MATH 193A,A04,083782,Rotar; Vladimir,6,0,34,28
1656120564031,MATH 193A,A05,093482,Rotar; Vladimir,1,0,34,33
1656120570056,MATH 197,001,091859,McAuley; Julian John,9999,0,9999,0
1656120570056,MATH 197,002,095566,Kedlaya; Kiran S.,9997,0,9999,2
1656120570056,MATH 197,003,095567,Xiao; Ming,9999,0,9999,0
1656120570056,MATH 197,004,095571,Perols; Johan Lars,9998,0,9999,1
1656120577114,COGS 9,A01,083615,Shannon; Kyle Michael,5,1,75,70
1656120583136,COGS 11,A01,083617,Boyle; Mary E. T.,16,2,48,32
1656120589164,COGS 13,A01,083071,Bastos; Amalia Pinkusfeld,9,3,71,62
1656120595192,COGS 14A,A01,092681,Semenuks; Arturs,8,24,100,92
1656120601218,COGS 14B,A01,083073,Cheng; Tzu-Han,7,0,63,56
1656120607242,COGS 17,A01,092677,Semenuks; Arturs,13,6,81,68
1656120613270,COGS 100,A01,083619,Allen; Michael Gordon,7,5,70,63
1656120619293,COGS 101A,A01,083621,Davis; Joshua Daniel,7,3,68,61
1656120625320,COGS 101B,A01,091572,Allen; Michael Gordon,6,0,65,59
1656120631346,COGS 101C,A01,083625,Delgado; Tania,11,0,35,24
1656120637372,COGS 107A,A01,083627,Boyle; Mary E. T.,5,4,60,55
1656120643398,COGS 118A,A01,083075,Gupta; Anjum,24,17,76,52
1656120649421,CSE 3,A50,083646,Miranda; Gregory Joseph,18,0,50,32
1656120655448,CSE 8A,A50,083650,Miranda; Gregory Joseph,13,12,56,43
1656120661470,CSE 11,A01,083080,Cao; Yingjun,1,59,40,39
1656120667492,CSE 12,A01,083652,Krause-Levy; Sophia Louisa,14,8,120,106
1656120673515,CSE 15L,A01,083654,Morris; Justin Loren,5,2,50,45
1656120673515,CSE 15L,A02,083655,Morris; Justin Loren,7,2,50,43
1656120679542,CSE 20,A01,083657,Tran; Khoa Dang,31,0,80,49
1656120685582,CSE 21,A01,095574,Bach; Quang Tran,25,0,48,23
1656120691610,CSE 30,A01,083084,Eldon; John,3,11,80,77
1656120691610,CSE 30,B01,095061,Bhaskar; Nishant,4,5,50,46
1656120697720,CSE 100,A01,083659,Cao; Yingjun,2,22,70,68
1656120703744,CSE 134B,A01,083661,Powell; Thomas Allan,11,8,100,89
1656120709772,CSE 140,A01,083663,Gungor; Onat,9,0,85,76
1656120715799,CSE 140L,A01,083088,Eldon; John,8,0,100,92
1656120721834,CSE 175,A01,083665,Kumar; Rakesh,0,0,25,25
1656120727860,CSE 190,A00,092507,Dubnov; Shlomo,2,0,20,18
1656120733884,ECE 45,A01,083139,Congero; Spencer William,5,4,75,70
1656120739919,ECE 65,A50,083695,Saad; Andrew S,8,0,30,22
1656120739919,ECE 65,A51,095125,Staff,23,0,26,3
1656120745942,ECE 109,A01,091882,Touri; Behrouz,7,7,70,63
1656120751969,ECE 180,A00,083140,Abi Samra; Nicholas Camill,1,0,30,29
1656120751969,ECE 180,B00,083141,Abi Samra; Nicholas Camill,4,8,30,26
1656120757992,MATH 10A,A01,083735,Patchell; Gregory David,0,0,30,30
1656120757992,MATH 10A,A02,083736,Patchell; Gregory David,22,0,30,8
1656120757992,MATH 10A,A03,083737,Patchell; Gregory David,16,0,30,14
1656120764016,MATH 10B,A01,083207,Lim; Seonhee,3,3,34,31
1656120764016,MATH 10B,A02,083208,Lim; Seonhee,10,2,35,25
1656120764016,MATH 10B,A03,093472,Staff,4,3,34,30
1656120764016,MATH 10B,B01,083739,Sinha; Shubham,12,0,30,18
1656120770042,MATH 18,A01,083743,Cinel; Cameron Alexander,7,0,30,23
1656120770042,MATH 18,A02,083744,Cinel; Cameron Alexander,10,0,30,20
1656120770042,MATH 18,A03,083745,Cinel; Cameron Alexander,3,0,30,27
1656120770042,MATH 18,B01,083748,Rideout; David Porter,0,0,36,36
1656120770042,MATH 18,B02,083749,Rideout; David Porter,0,0,36,36
1656120770042,MATH 18,B03,083750,Rideout; David Porter,0,0,36,36
1656120770042,MATH 18,B04,083751,Rideout; David Porter,0,0,36,36
1656120770042,MATH 18,B05,093473,Rideout; David Porter,2,0,36,34
1656120770042,MATH 18,B06,093474,Rideout; David Porter,4,0,36,32
1656120776066,MATH 20A,A01,083754,Zheng; Zequn,11,0,40,29
1656120782091,MATH 20B,A01,083756,Briones; Jor-el Thomas Caparas,0,0,36,36
1656120782091,MATH 20B,A02,083757,Briones; Jor-el Thomas Caparas,0,0,36,36
1656120782091,MATH 20B,A03,093475,Staff,2,0,36,34
1656120788115,MATH 20C,A01,083760,Briones; Jor-el Thomas Caparas,2,2,35,33
1656120788115,MATH 20C,A02,083761,Briones; Jor-el Thomas Caparas,9,1,35,26
1656120788115,MATH 20C,A03,093476,Staff,1,1,35,34
1656120788115,MATH 20C,B01,083762,Bach; Quang Tran,1,0,30,29
1656120794144,MATH 20D,A01,083765,Tran; Brian Kha,2,0,30,28
1656120794144,MATH 20D,A02,083766,Tran; Brian Kha,0,1,30,30
1656120794144,MATH 20D,A03,083767,Tran; Brian Kha,2,0,30,28
1656120800166,MATH 20E,A01,083771,Ganguly; Soumya,4,1,32,28
1656120800166,MATH 20E,A02,083772,Ganguly; Soumya,2,2,32,30
1656120800166,MATH 20E,B01,083773,Ciotti; Benjamin,14,0,35,21
1656120800166,MATH 20E,B02,083774,Ciotti; Benjamin,14,0,35,21
1656120806196,MATH 103A,A01,083777,Greenfeld; Be'Eri,2,0,36,34
1656120806196,MATH 103A,A02,083778,Greenfeld; Be'Eri,2,0,36,34
1656120806196,MATH 103A,A03,093561,Staff,4,1,36,32
1656120806196,MATH 103A,B01,083779,Greenfeld; Be'Eri,8,1,36,28
1656120806196,MATH 103A,B02,083780,Greenfeld; Be'Eri,0,0,36,36
1656120806196,MATH 103A,B03,093562,Staff,0,0,36,36
1656120812225,MATH 105,A01,085443,Carter; Anne Toulson,4,1,35,31
1656120812225,MATH 105,A02,093477,Staff,9,0,35,26
1656120818252,MATH 109,A01,083213,Ganzberger; Geoffrey Michael,1,1,34,33
1656120818252,MATH 109,A02,083214,Ganzberger; Geoffrey Michael,0,0,34,34
1656120818252,MATH 109,A03,093478,Staff,1,0,34,33
1656120818252,MATH 109,B01,083215,Ganzberger; Geoffrey Michael,3,0,32,29
1656120818252,MATH 109,B02,083216,Ganzberger; Geoffrey Michael,1,0,32,31
1656120818252,MATH 109,B03,093479,Staff,4,0,32,28
1656120824277,MATH 142A,A01,083219,Chow; Bennett,1,0,32,31
1656120824277,MATH 142A,A02,083220,Chow; Bennett,8,0,32,24
1656120824277,MATH 142A,A03,093480,Staff,5,0,32,27
1656120824277,MATH 142A,B03,093481,Staff,4,0,32,28
1656120824277,MATH 142A,B04,093558,Staff,5,0,32,27
1656120824277,MATH 142A,B05,093559,Staff,0,0,32,32
1656120830300,MATH 193A,A01,083224,Rotar; Vladimir,1,2,34,33
1656120830300,MATH 193A,A02,083225,Rotar; Vladimir,1,0,34,33
1656120830300,MATH 193A,A03,083781,Rotar; Vladimir,1,0,34,33
1656120830300,MATH 193A,A04,083782,Rotar; Vladimir,6,0,34,28
1656120830300,MATH 193A,A05,093482,Rotar; Vladimir,1,0,34,33
1656120836328,MATH 197,001,091859,McAuley; Julian John,9999,0,9999,0
1656120836328,MATH 197,002,095566,Kedlaya; Kiran S.,9997,0,9999,2
1656120836328,MATH 197,003,095567,Xiao; Ming,9999,0,9999,0
1656120836328,MATH 197,004,095571,Perols; Johan Lars,9998,0,9999,1
1656120843388,COGS 9,A01,083615,Shannon; Kyle Michael,5,1,75,70
1656120849412,COGS 11,A01,083617,Boyle; Mary E. T.,16,2,48,32
1656120855434,COGS 13,A01,083071,Bastos; Amalia Pinkusfeld,9,3,71,62
1656120861457,COGS 14A,A01,092681,Semenuks; Arturs,8,24,100,92
1656120867480,COGS 14B,A01,083073,Cheng; Tzu-Han,7,0,63,56
1656120873503,COGS 17,A01,092677,Semenuks; Arturs,13,6,81,68
1656120879527,COGS 100,A01,083619,Allen; Michael Gordon,7,5,70,63
1656120885550,COGS 101A,A01,083621,Davis; Joshua Daniel,7,3,68,61
1656120891575,COGS 101B,A01,091572,Allen; Michael Gordon,6,0,65,59
1656120897598,COGS 101C,A01,083625,Delgado; Tania,11,0,35,24
1656120903622,COGS 107A,A01,083627,Boyle; Mary E. T.,5,4,60,55
1656120909646,COGS 118A,A01,083075,Gupta; Anjum,24,17,76,52
1656120915670,CSE 3,A50,083646,Miranda; Gregory Joseph,18,0,50,32
1656120921693,CSE 8A,A50,083650,Miranda; Gregory Joseph,13,12,56,43
1656120927719,CSE 11,A01,083080,Cao; Yingjun,1,59,40,39
1656120933742,CSE 12,A01,083652,Krause-Levy; Sophia Louisa,14,8,120,106
1656120939766,CSE 15L,A01,083654,Morris; Justin Loren,5,2,50,45
1656120939766,CSE 15L,A02,083655,Morris; Justin Loren,7,2,50,43
1656120945790,CSE 20,A01,083657,Tran; Khoa Dang,31,0,80,49
1656120951814,CSE 21,A01,095574,Bach; Quang Tran,25,0,48,23
1656120957846,CSE 30,A01,083084,Eldon; John,3,11,80,77
1656120957846,CSE 30,B01,095061,Bhaskar; Nishant,4,5,50,46
1656120963867,CSE 100,A01,083659,Cao; Yingjun,2,22,70,68
1656120969893,CSE 134B,A01,083661,Powell; Thomas Allan,11,8,100,89
1656120975918,CSE 140,A01,083663,Gungor; Onat,9,0,85,76
1656120981942,CSE 140L,A01,083088,Eldon; John,8,0,100,92
1656120987966,CSE 175,A01,083665,Kumar; Rakesh,0,0,25,25
1656120993994,CSE 190,A00,092507,Dubnov; Shlomo,2,0,20,18
1656121000020,ECE 45,A01,083139,Congero; Spencer William,5,4,75,70
1656121006046,ECE 65,A50,083695,Saad; Andrew S,8,0,30,22
1656121006046,ECE 65,A51,095125,Staff,23,0,26,3
1656121012068,ECE 109,A01,091882,Touri; Behrouz,7,7,70,63
1656121018094,ECE 180,A00,083140,Abi Samra; Nicholas Camill,1,0,30,29
1656121018094,ECE 180,B00,083141,Abi Samra; Nicholas Camill,4,8,30,26
1656121024128,MATH 10A,A01,083735,Patchell; Gregory David,0,0,30,30
1656121024128,MATH 10A,A02,083736,Patchell; Gregory David,22,0,30,8
1656121024128,MATH 10A,A03,083737,Patchell; Gregory David,16,0,30,14
1656121030152,MATH 10B,A01,083207,Lim; Seonhee,3,3,34,31
1656121030152,MATH 10B,A02,083208,Lim; Seonhee,10,3,35,25
1656121030152,MATH 10B,A03,093472,Staff,4,3,34,30
1656121030152,MATH 10B,B01,083739,Sinha; Shubham,12,0,30,18
1656121036177,MATH 18,A01,083743,Cinel; Cameron Alexander,7,0,30,23
1656121036177,MATH 18,A02,083744,Cinel; Cameron Alexander,10,0,30,20
1656121036177,MATH 18,A03,083745,Cinel; Cameron Alexander,3,0,30,27
1656121036177,MATH 18,B01,083748,Rideout; David Porter,0,0,36,36
1656121036177,MATH 18,B02,083749,Rideout; David Porter,0,0,36,36
1656121036177,MATH 18,B03,083750,Rideout; David Porter,0,0,36,36
1656121036177,MATH 18,B04,083751,Rideout; David Porter,0,0,36,36
1656121036177,MATH 18,B05,093473,Rideout; David Porter,2,0,36,34
1656121036177,MATH 18,B06,093474,Rideout; David Porter,4,0,36,32
1656121042199,MATH 20A,A01,083754,Zheng; Zequn,11,0,40,29
1656121048228,MATH 20B,A01,083756,Briones; Jor-el Thomas Caparas,0,0,36,36
1656121048228,MATH 20B,A02,083757,Briones; Jor-el Thomas Caparas,0,0,36,36
1656121048228,MATH 20B,A03,093475,Staff,2,0,36,34
1656121054256,MATH 20C,A01,083760,Briones; Jor-el Thomas Caparas,2,2,35,33
1656121054256,MATH 20C,A02,083761,Briones; Jor-el Thomas Caparas,9,1,35,26
1656121054256,MATH 20C,A03,093476,Staff,1,1,35,34
1656121054256,MATH 20C,B01,083762,Bach; Quang Tran,1,0,30,29
1656121060285,MATH 20D,A01,083765,Tran; Brian Kha,2,0,30,28
1656121060285,MATH 20D,A02,083766,Tran; Brian Kha,0,1,30,30
1656121060285,MATH 20D,A03,083767,Tran; Brian Kha,2,0,30,28
1656121066310,MATH 20E,A01,083771,Ganguly; Soumya,4,1,32,28
1656121066310,MATH 20E,A02,083772,Ganguly; Soumya,2,2,32,30
1656121066310,MATH 20E,B01,083773,Ciotti; Benjamin,14,0,35,21
1656121066310,MATH 20E,B02,083774,Ciotti; Benjamin,14,0,35,21
1656121072356,MATH 103A,A01,083777,Greenfeld; Be'Eri,2,0,36,34
1656121072356,MATH 103A,A02,083778,Greenfeld; Be'Eri,2,0,36,34
1656121072356,MATH 103A,A03,093561,Staff,4,1,36,32
1656121072356,MATH 103A,B01,083779,Greenfeld; Be'Eri,8,1,36,28
1656121072356,MATH 103A,B02,083780,Greenfeld; Be'Eri,0,0,36,36
1656121072356,MATH 103A,B03,093562,Staff,0,0,36,36
1656121078469,MATH 105,A01,085443,Carter; Anne Toulson,4,1,35,31
1656121078469,MATH 105,A02,093477,Staff,9,0,35,26
1656121084493,MATH 109,A01,083213,Ganzberger; Geoffrey Michael,1,1,34,33
1656121084493,MATH 109,A02,083214,Ganzberger; Geoffrey Michael,0,0,34,34
1656121084493,MATH 109,A03,093478,Staff,1,0,34,33
1656121084493,MATH 109,B01,083215,Ganzberger; Geoffrey Michael,3,0,32,29
1656121084493,MATH 109,B02,083216,Ganzberger; Geoffrey Michael,1,0,32,31
1656121084493,MATH 109,B03,093479,Staff,4,0,32,28
1656121090520,MATH 142A,A01,083219,Chow; Bennett,1,0,32,31
1656121090520,MATH 142A,A02,083220,Chow; Bennett,8,0,32,24
1656121090520,MATH 142A,A03,093480,Staff,5,0,32,27
1656121090520,MATH 142A,B03,093481,Staff,4,0,32,28
1656121090520,MATH 142A,B04,093558,Staff,5,0,32,27
1656121090520,MATH 142A,B05,093559,Staff,0,0,32,32
1656121096546,MATH 193A,A01,083224,Rotar; Vladimir,1,2,34,33
1656121096546,MATH 193A,A02,083225,Rotar; Vladimir,1,0,34,33
1656121096546,MATH 193A,A03,083781,Rotar; Vladimir,1,0,34,33
1656121096546,MATH 193A,A04,083782,Rotar; Vladimir,6,0,34,28
1656121096546,MATH 193A,A05,093482,Rotar; Vladimir,1,0,34,33
1656121102582,MATH 197,001,091859,McAuley; Julian John,9999,0,9999,0
1656121102582,MATH 197,002,095566,Kedlaya; Kiran S.,9997,0,9999,2
1656121102582,MATH 197,003,095567,Xiao; Ming,9999,0,9999,0
1656121102582,MATH 197,004,095571,Perols; Johan Lars,9998,0,9999,1
1656121109637,COGS 9,A01,083615,Shannon; Kyle Michael,5,1,75,70
1656121115661,COGS 11,A01,083617,Boyle; Mary E. T.,16,2,48,32
1656121121701,COGS 13,A01,083071,Bastos; Amalia Pinkusfeld,9,3,71,62
1656121127722,COGS 14A,A01,092681,Semenuks; Arturs,8,24,100,92
1656121133751,COGS 14B,A01,083073,Cheng; Tzu-Han,7,0,63,56
1656121139776,COGS 17,A01,092677,Semenuks; Arturs,13,6,81,68
1656121145798,COGS 100,A01,083619,Allen; Michael Gordon,7,5,70,63
1656121151825,COGS 101A,A01,083621,Davis; Joshua Daniel,7,3,68,61
1656121157852,COGS 101B,A01,091572,Allen; Michael Gordon,6,0,65,59
1656121163886,COGS 101C,A01,083625,Delgado; Tania,11,0,35,24
1656121169908,COGS 107A,A01,083627,Boyle; Mary E. T.,5,4,60,55
1656121175931,COGS 118A,A01,083075,Gupta; Anjum,24,17,76,52
1656121181957,CSE 3,A50,083646,Miranda; Gregory Joseph,18,0,50,32
1656121187978,CSE 8A,A50,083650,Miranda; Gregory Joseph,13,12,56,43
1656121194004,CSE 11,A01,083080,Cao; Yingjun,1,59,40,39
1656121200092,CSE 12,A01,083652,Krause-Levy; Sophia Louisa,14,8,120,106
1656121206122,CSE 15L,A01,083654,Morris; Justin Loren,5,2,50,45
1656121206122,CSE 15L,A02,083655,Morris; Justin Loren,7,2,50,43
1656121212146,CSE 20,A01,083657,Tran; Khoa Dang,31,0,80,49
1656121218174,CSE 21,A01,095574,Bach; Quang Tran,25,0,48,23
1656121224197,CSE 30,A01,083084,Eldon; John,3,11,80,77
1656121224197,CSE 30,B01,095061,Bhaskar; Nishant,4,5,50,46
1656121230219,CSE 100,A01,083659,Cao; Yingjun,2,22,70,68
1656121236241,CSE 134B,A01,083661,Powell; Thomas Allan,11,8,100,89
1656121242263,CSE 140,A01,083663,Gungor; Onat,9,0,85,76
1656121248289,CSE 140L,A01,083088,Eldon; John,8,0,100,92
1656121254314,CSE 175,A01,083665,Kumar; Rakesh,0,0,25,25
1656121260337,CSE 190,A00,092507,Dubnov; Shlomo,2,0,20,18
1656121266360,ECE 45,A01,083139,Congero; Spencer William,5,4,75,70
1656121272382,ECE 65,A50,083695,Saad; Andrew S,8,0,30,22
1656121272382,ECE 65,A51,095125,Staff,23,0,26,3
1656121278405,ECE 109,A01,091882,Touri; Behrouz,7,7,70,63
1656121284473,ECE 180,A00,083140,Abi Samra; Nicholas Camill,1,0,30,29
1656121284473,ECE 180,B00,083141,Abi Samra; Nicholas Camill,4,8,30,26
1656121290498,MATH 10A,A01,083735,Patchell; Gregory David,0,0,30,30
1656121290498,MATH 10A,A02,083736,Patchell; Gregory David,22,0,30,8
1656121290498,MATH 10A,A03,083737,Patchell; Gregory David,16,0,30,14
1656121296599,MATH 10B,A01,083207,Lim; Seonhee,3,3,34,31
1656121296599,MATH 10B,A02,083208,Lim; Seonhee,10,3,35,25
1656121296599,MATH 10B,A03,093472,Staff,4,3,34,30
1656121296599,MATH 10B,B01,083739,Sinha; Shubham,12,0,30,18
1656121302630,MATH 18,A01,083743,Cinel; Cameron Alexander,7,0,30,23
1656121302630,MATH 18,A02,083744,Cinel; Cameron Alexander,10,0,30,20
1656121302630,MATH 18,A03,083745,Cinel; Cameron Alexander,3,0,30,27
1656121302630,MATH 18,B01,083748,Rideout; David Porter,0,0,36,36
1656121302630,MATH 18,B02,083749,Rideout; David Porter,0,0,36,36
1656121302630,MATH 18,B03,083750,Rideout; David Porter,0,0,36,36
1656121302630,MATH 18,B04,083751,Rideout; David Porter,0,0,36,36
1656121302630,MATH 18,B05,093473,Rideout; David Porter,2,0,36,34
1656121302630,MATH 18,B06,093474,Rideout; David Porter,4,0,36,32
1656121308657,MATH 20A,A01,083754,Zheng; Zequn,11,0,40,29
1656121314691,MATH 20B,A01,083756,Briones; Jor-el Thomas Caparas,0,0,36,36
1656121314691,MATH 20B,A02,083757,Briones; Jor-el Thomas Caparas,0,0,36,36
1656121314691,MATH 20B,A03,093475,Staff,2,0,36,34
1656121320718,MATH 20C,A01,083760,Briones; Jor-el Thomas Caparas,2,2,35,33
1656121320718,MATH 20C,A02,083761,Briones; Jor-el Thomas Caparas,9,1,35,26
1656121320718,MATH 20C,A03,093476,Staff,1,1,35,34
1656121320718,MATH 20C,B01,083762,Bach; Quang Tran,1,0,30,29
1656121326746,MATH 20D,A01,083765,Tran; Brian Kha,2,0,30,28
1656121326746,MATH 20D,A02,083766,Tran; Brian Kha,0,1,30,30
1656121326746,MATH 20D,A03,083767,Tran; Brian Kha,2,0,30,28
1656121332776,MATH 20E,A01,083771,Ganguly; Soumya,4,1,32,28
1656121332776,MATH 20E,A02,083772,Ganguly; Soumya,2,2,32,30
1656121332776,MATH 20E,B01,083773,Ciotti; Benjamin,14,0,35,21
1656121332776,MATH 20E,B02,083774,Ciotti; Benjamin,14,0,35,21
1656121338800,MATH 103A,A01,083777,Greenfeld; Be'Eri,2,0,36,34
1656121338800,MATH 103A,A02,083778,Greenfeld; Be'Eri,2,0,36,34
1656121338800,MATH 103A,A03,093561,Staff,4,1,36,32
1656121338800,MATH 103A,B01,083779,Greenfeld; Be'Eri,8,1,36,28
1656121338800,MATH 103A,B02,083780,Greenfeld; Be'Eri,0,0,36,36
1656121338800,MATH 103A,B03,093562,Staff,0,0,36,36
1656121344822,MATH 105,A01,085443,Carter; Anne Toulson,4,1,35,31
1656121344822,MATH 105,A02,093477,Staff,9,0,35,26
1656121350850,MATH 109,A01,083213,Ganzberger; Geoffrey Michael,1,1,34,33
1656121350850,MATH 109,A02,083214,Ganzberger; Geoffrey Michael,0,0,34,34
1656121350850,MATH 109,A03,093478,Staff,1,0,34,33
1656121350850,MATH 109,B01,083215,Ganzberger; Geoffrey Michael,3,0,32,29
1656121350850,MATH 109,B02,083216,Ganzberger; Geoffrey Michael,1,0,32,31
1656121350850,MATH 109,B03,093479,Staff,4,0,32,28
1656121356878,MATH 142A,A01,083219,Chow; Bennett,1,0,32,31
1656121356878,MATH 142A,A02,083220,Chow; Bennett,8,0,32,24
1656121356878,MATH 142A,A03,093480,Staff,5,0,32,27
1656121356878,MATH 142A,B03,093481,Staff,4,0,32,28
1656121356878,MATH 142A,B04,093558,Staff,5,0,32,27
1656121356878,MATH 142A,B05,093559,Staff,0,0,32,32
1656121362901,MATH 193A,A01,083224,Rotar; Vladimir,1,2,34,33
1656121362901,MATH 193A,A02,083225,Rotar; Vladimir,1,0,34,33
1656121362901,MATH 193A,A03,083781,Rotar; Vladimir,1,0,34,33
1656121362901,MATH 193A,A04,083782,Rotar; Vladimir,6,0,34,28
1656121362901,MATH 193A,A05,093482,Rotar; Vladimir,1,0,34,33
1656121368925,MATH 197,001,091859,McAuley; Julian John,9999,0,9999,0
1656121368925,MATH 197,002,095566,Kedlaya; Kiran S.,9997,0,9999,2
1656121368925,MATH 197,003,095567,Xiao; Ming,9999,0,9999,0
1656121368925,MATH 197,004,095571,Perols; Johan Lars,9998,0,9999,1
1656121375984,COGS 9,A01,083615,Shannon; Kyle Michael,5,1,75,70
1656121382007,COGS 11,A01,083617,Boyle; Mary E. T.,16,2,48,32
1656121388032,COGS 13,A01,083071,Bastos; Amalia Pinkusfeld,9,3,71,62
1656121394055,COGS 14A,A01,092681,Semenuks; Arturs,8,24,100,92
1656121400086,COGS 14B,A01,083073,Cheng; Tzu-Han,7,0,63,56
1656121406113,COGS 17,A01,092677,Semenuks; Arturs,13,6,81,68
1656121412141,COGS 100,A01,083619,Allen; Michael Gordon,7,5,70,63
1656121418168,COGS 101A,A01,083621,Davis; Joshua Daniel,7,3,68,61
1656121424196,COGS 101B,A01,091572,Allen; Michael Gordon,6,0,65,59
1656121430223,COGS 101C,A01,083625,Delgado; Tania,11,0,35,24
1656121436246,COGS 107A,A01,083627,Boyle; Mary E. T.,5,4,60,55
1656121442271,COGS 118A,A01,083075,Gupta; Anjum,24,17,76,52
1656121448298,CSE 3,A50,083646,Miranda; Gregory Joseph,18,0,50,32
1656121454326,CSE 8A,A50,083650,Miranda; Gregory Joseph,13,12,56,43
1656121460349,CSE 11,A01,083080,Cao; Yingjun,1,59,40,39
1656121466377,CSE 12,A01,083652,Krause-Levy; Sophia Louisa,14,8,120,106
1656121472401,CSE 15L,A01,083654,Morris; Justin Loren,5,2,50,45
1656121472401,CSE 15L,A02,083655,Morris; Justin Loren,7,2,50,43
1656121478424,CSE 20,A01,083657,Tran; Khoa Dang,31,0,80,49
1656121484445,CSE 21,A01,095574,Bach; Quang Tran,25,0,48,23
1656121490472,CSE 30,A01,083084,Eldon; John,3,11,80,77
1656121490472,CSE 30,B01,095061,Bhaskar; Nishant,4,5,50,46
1656121496496,CSE 100,A01,083659,Cao; Yingjun,2,22,70,68
1656121502518,CSE 134B,A01,083661,Powell; Thomas Allan,11,8,100,89
1656121508545,CSE 140,A01,083663,Gungor; Onat,9,0,85,76
1656121514567,CSE 140L,A01,083088,Eldon; John,8,0,100,92
1656121520591,CSE 175,A01,083665,Kumar; Rakesh,0,0,25,25
1656121526613,CSE 190,A00,092507,Dubnov; Shlomo,2,0,20,18
1656121532641,ECE 45,A01,083139,Congero; Spencer William,5,4,75,70
1656121538666,ECE 65,A50,083695,Saad; Andrew S,8,0,30,22
1656121538666,ECE 65,A51,095125,Staff,23,0,26,3
1656121544693,ECE 109,A01,091882,Touri; Behrouz,7,7,70,63
1656121550716,ECE 180,A00,083140,Abi Samra; Nicholas Camill,1,0,30,29
1656121550716,ECE 180,B00,083141,Abi Samra; Nicholas Camill,4,8,30,26
1656121556739,MATH 10A,A01,083735,Patchell; Gregory David,0,0,30,30
1656121556739,MATH 10A,A02,083736,Patchell; Gregory David,22,0,30,8
1656121556739,MATH 10A,A03,083737,Patchell; Gregory David,16,0,30,14
1656121562768,MATH 10B,A01,083207,Lim; Seonhee,3,3,34,31
1656121562768,MATH 10B,A02,083208,Lim; Seonhee,10,3,35,25
1656121562768,MATH 10B,A03,093472,Staff,4,3,34,30
1656121562768,MATH 10B,B01,083739,Sinha; Shubham,12,0,30,18
1656121568797,MATH 18,A01,083743,Cinel; Cameron Alexander,7,0,30,23
1656121568797,MATH 18,A02,083744,Cinel; Cameron Alexander,10,0,30,20
1656121568797,MATH 18,A03,083745,Cinel; Cameron Alexander,3,0,30,27
1656121568797,MATH 18,B01,083748,Rideout; David Porter,0,0,36,36
1656121568797,MATH 18,B02,083749,Rideout; David Porter,0,0,36,36
1656121568797,MATH 18,B03,083750,Rideout; David Porter,0,0,36,36
1656121568797,MATH 18,B04,083751,Rideout; David Porter,0,0,36,36
1656121568797,MATH 18,B05,093473,Rideout; David Porter,2,0,36,34
1656121568797,MATH 18,B06,093474,Rideout; David Porter,4,0,36,32
1656121574821,MATH 20A,A01,083754,Zheng; Zequn,11,0,40,29
1656121580843,MATH 20B,A01,083756,Briones; Jor-el Thomas Caparas,0,0,36,36
1656121580843,MATH 20B,A02,083757,Briones; Jor-el Thomas Caparas,0,0,36,36
1656121580843,MATH 20B,A03,093475,Staff,2,0,36,34
1656121586872,MATH 20C,A01,083760,Briones; Jor-el Thomas Caparas,2,2,35,33
1656121586872,MATH 20C,A02,083761,Briones; Jor-el Thomas Caparas,9,1,35,26
1656121586872,MATH 20C,A03,093476,Staff,1,1,35,34
1656121586872,MATH 20C,B01,083762,Bach; Quang Tran,1,0,30,29
1656121592896,MATH 20D,A01,083765,Tran; Brian Kha,2,0,30,28
1656121592896,MATH 20D,A02,083766,Tran; Brian Kha,0,1,30,30
1656121592896,MATH 20D,A03,083767,Tran; Brian Kha,2,0,30,28
1656121598925,MATH 20E,A01,083771,Ganguly; Soumya,4,1,32,28
1656121598925,MATH 20E,A02,083772,Ganguly; Soumya,2,2,32,30
1656121598925,MATH 20E,B01,083773,Ciotti; Benjamin,14,0,35,21
1656121598925,MATH 20E,B02,083774,Ciotti; Benjamin,14,0,35,21
1656121604950,MATH 103A,A01,083777,Greenfeld; Be'Eri,2,0,36,34
1656121604950,MATH 103A,A02,083778,Greenfeld; Be'Eri,2,0,36,34
1656121604950,MATH 103A,A03,093561,Staff,4,1,36,32
1656121604950,MATH 103A,B01,083779,Greenfeld; Be'Eri,8,1,36,28
1656121604950,MATH 103A,B02,083780,Greenfeld; Be'Eri,0,0,36,36
1656121604950,MATH 103A,B03,093562,Staff,0,0,36,36
1656121610977,MATH 105,A01,085443,Carter; Anne Toulson,4,1,35,31
1656121610977,MATH 105,A02,093477,Staff,9,0,35,26
1656121616999,MATH 109,A01,083213,Ganzberger; Geoffrey Michael,1,1,34,33
1656121616999,MATH 109,A02,083214,Ganzberger; Geoffrey Michael,0,0,34,34
1656121616999,MATH 109,A03,093478,Staff,1,0,34,33
1656121616999,MATH 109,B01,083215,Ganzberger; Geoffrey Michael,3,0,32,29
1656121616999,MATH 109,B02,083216,Ganzberger; Geoffrey Michael,1,0,32,31
1656121616999,MATH 109,B03,093479,Staff,4,0,32,28
1656121623030,MATH 142A,A01,083219,Chow; Bennett,1,0,32,31
1656121623030,MATH 142A,A02,083220,Chow; Bennett,8,0,32,24
1656121623030,MATH 142A,A03,093480,Staff,5,0,32,27
1656121623030,MATH 142A,B03,093481,Staff,4,0,32,28
1656121623030,MATH 142A,B04,093558,Staff,5,0,32,27
1656121623030,MATH 142A,B05,093559,Staff,0,0,32,32
1656121629055,MATH 193A,A01,083224,Rotar; Vladimir,1,2,34,33
1656121629055,MATH 193A,A02,083225,Rotar; Vladimir,1,0,34,33
1656121629055,MATH 193A,A03,083781,Rotar; Vladimir,1,0,34,33
1656121629055,MATH 193A,A04,083782,Rotar; Vladimir,6,0,34,28
1656121629055,MATH 193A,A05,093482,Rotar; Vladimir,1,0,34,33
1656121635080,MATH 197,001,091859,McAuley; Julian John,9999,0,9999,0
1656121635080,MATH 197,002,095566,Kedlaya; Kiran S.,9997,0,9999,2
1656121635080,MATH 197,003,095567,Xiao; Ming,9999,0,9999,0
1656121635080,MATH 197,004,095571,Perols; Johan Lars,9998,0,9999,1
1656121642147,COGS 9,A01,083615,Shannon; Kyle Michael,5,1,75,70
1656121648169,COGS 11,A01,083617,Boyle; Mary E. T.,16,2,48,32
1656121654196,COGS 13,A01,083071,Bastos; Amalia Pinkusfeld,9,3,71,62
1656121660227,COGS 14A,A01,092681,Semenuks; Arturs,8,24,100,92
1656121666255,COGS 14B,A01,083073,Cheng; Tzu-Han,7,0,63,56
1656121672282,COGS 17,A01,092677,Semenuks; Arturs,13,6,81,68
1656121678308,COGS 100,A01,083619,Allen; Michael Gordon,7,5,70,63
1656121684337,COGS 101A,A01,083621,Davis; Joshua Daniel,7,3,68,61
1656121690364,COGS 101B,A01,091572,Allen; Michael Gordon,6,0,65,59
1656121696387,COGS 101C,A01,083625,Delgado; Tania,11,0,35,24
1656121702409,COGS 107A,A01,083627,Boyle; Mary E. T.,5,4,60,55
1656121708430,COGS 118A,A01,083075,Gupta; Anjum,24,17,76,52
1656121714459,CSE 3,A50,083646,Miranda; Gregory Joseph,18,0,50,32
1656121720486,CSE 8A,A50,083650,Miranda; Gregory Joseph,13,12,56,43
1656121726512,CSE 11,A01,083080,Cao; Yingjun,1,59,40,39
1656121732537,CSE 12,A01,083652,Krause-Levy; Sophia Louisa,14,8,120,106
1656121738559,CSE 15L,A01,083654,Morris; Justin Loren,5,2,50,45
1656121738559,CSE 15L,A02,083655,Morris; Justin Loren,7,2,50,43
1656121744585,CSE 20,A01,083657,Tran; Khoa Dang,31,0,80,49
1656121750609,CSE 21,A01,095574,Bach; Quang Tran,25,0,48,23
1656121756637,CSE 30,A01,083084,Eldon; John,3,11,80,77
1656121756637,CSE 30,B01,095061,Bhaskar; Nishant,4,5,50,46
1656121762664,CSE 100,A01,083659,Cao; Yingjun,2,22,70,68
1656121768689,CSE 134B,A01,083661,Powell; Thomas Allan,11,8,100,89
1656121774720,CSE 140,A01,083663,Gungor; Onat,9,0,85,76
1656121780744,CSE 140L,A01,083088,Eldon; John,8,0,100,92
1656121786775,CSE 175,A01,083665,Kumar; Rakesh,0,0,25,25
1656121792801,CSE 190,A00,092507,Dubnov; Shlomo,2,0,20,18
1656121798834,ECE 45,A01,083139,Congero; Spencer William,5,4,75,70
1656121804862,ECE 65,A50,083695,Saad; Andrew S,8,0,30,22
1656121804862,ECE 65,A51,095125,Staff,23,0,26,3
1656121810903,ECE 109,A01,091882,Touri; Behrouz,7,7,70,63
1656121816926,ECE 180,A00,083140,Abi Samra; Nicholas Camill,1,0,30,29
1656121816926,ECE 180,B00,083141,Abi Samra; Nicholas Camill,4,8,30,26
1656121822949,MATH 10A,A01,083735,Patchell; Gregory David,0,0,30,30
1656121822949,MATH 10A,A02,083736,Patchell; Gregory David,22,0,30,8
1656121822949,MATH 10A,A03,083737,Patchell; Gregory David,16,0,30,14
1656121828976,MATH 10B,A01,083207,Lim; Seonhee,3,3,34,31
1656121828976,MATH 10B,A02,083208,Lim; Seonhee,10,3,35,25
1656121828976,MATH 10B,A03,093472,Staff,4,3,34,30
1656121828976,MATH 10B,B01,083739,Sinha; Shubham,12,0,30,18
1656121835004,MATH 18,A01,083743,Cinel; Cameron Alexander,7,0,30,23
1656121835004,MATH 18,A02,083744,Cinel; Cameron Alexander,10,0,30,20
1656121835004,MATH 18,A03,083745,Cinel; Cameron Alexander,3,0,30,27
1656121835004,MATH 18,B01,083748,Rideout; David Porter,0,0,36,36
1656121835004,MATH 18,B02,083749,Rideout; David Porter,0,0,36,36
1656121835004,MATH 18,B03,083750,Rideout; David Porter,0,0,36,36
1656121835004,MATH 18,B04,083751,Rideout; David Porter,0,0,36,36
1656121835004,MATH 18,B05,093473,Rideout; David Porter,2,0,36,34
1656121835004,MATH 18,B06,093474,Rideout; David Porter,4,0,36,32
1656121841027,MATH 20A,A01,083754,Zheng; Zequn,11,0,40,29
1656121847051,MATH 20B,A01,083756,Briones; Jor-el Thomas Caparas,0,0,36,36
1656121847051,MATH 20B,A02,083757,Briones; Jor-el Thomas Caparas,0,0,36,36
1656121847051,MATH 20B,A03,093475,Staff,2,0,36,34
1656121853076,MATH 20C,A01,083760,Briones; Jor-el Thomas Caparas,2,2,35,33
1656121853076,MATH 20C,A02,083761,Briones; Jor-el Thomas Caparas,9,1,35,26
1656121853076,MATH 20C,A03,093476,Staff,1,1,35,34
1656121853076,MATH 20C,B01,083762,Bach; Quang Tran,1,0,30,29
1656121859106,MATH 20D,A01,083765,Tran; Brian Kha,2,0,30,28
1656121859106,MATH 20D,A02,083766,Tran; Brian Kha,0,1,30,30
1656121859106,MATH 20D,A03,083767,Tran; Brian Kha,2,0,30,28
1656121865132,MATH 20E,A01,083771,Ganguly; Soumya,4,1,32,28
1656121865132,MATH 20E,A02,083772,Ganguly; Soumya,2,2,32,30
1656121865132,MATH 20E,B01,083773,Ciotti; Benjamin,14,0,35,21
1656121865132,MATH 20E,B02,083774,Ciotti; Benjamin,14,0,35,21
1656121871170,MATH 103A,A01,083777,Greenfeld; Be'Eri,2,0,36,34
1656121871170,MATH 103A,A02,083778,Greenfeld; Be'Eri,2,0,36,34
1656121871170,MATH 103A,A03,093561,Staff,4,1,36,32
1656121871170,MATH 103A,B01,083779,Greenfeld; Be'Eri,8,1,36,28
1656121871170,MATH 103A,B02,083780,Greenfeld; Be'Eri,0,0,36,36
1656121871170,MATH 103A,B03,093562,Staff,0,0,36,36
1656121877197,MATH 105,A01,085443,Carter; Anne Toulson,4,1,35,31
1656121877197,MATH 105,A02,093477,Staff,9,0,35,26
1656121883221,MATH 109,A01,083213,Ganzberger; Geoffrey Michael,1,1,34,33
1656121883221,MATH 109,A02,083214,Ganzberger; Geoffrey Michael,0,0,34,34
1656121883221,MATH 109,A03,093478,Staff,1,0,34,33
1656121883221,MATH 109,B01,083215,Ganzberger; Geoffrey Michael,3,0,32,29
1656121883221,MATH 109,B02,083216,Ganzberger; Geoffrey Michael,1,0,32,31
1656121883221,MATH 109,B03,093479,Staff,4,0,32,28
1656121889243,MATH 142A,A01,083219,Chow; Bennett,1,0,32,31
1656121889243,MATH 142A,A02,083220,Chow; Bennett,8,0,32,24
1656121889243,MATH 142A,A03,093480,Staff,5,0,32,27
1656121889243,MATH 142A,B03,093481,Staff,4,0,32,28
1656121889243,MATH 142A,B04,093558,Staff,5,0,32,27
1656121889243,MATH 142A,B05,093559,Staff,0,0,32,32
1656121895340,MATH 193A,A01,083224,Rotar; Vladimir,1,2,34,33
1656121895340,MATH 193A,A02,083225,Rotar; Vladimir,1,0,34,33
1656121895340,MATH 193A,A03,083781,Rotar; Vladimir,1,0,34,33
1656121895340,MATH 193A,A04,083782,Rotar; Vladimir,6,0,34,28
1656121895340,MATH 193A,A05,093482,Rotar; Vladimir,1,0,34,33
1656121901370,MATH 197,001,091859,McAuley; Julian John,9999,0,9999,0
1656121901370,MATH 197,002,095566,Kedlaya; Kiran S.,9997,0,9999,2
1656121901370,MATH 197,003,095567,Xiao; Ming,9999,0,9999,0
1656121901370,MATH 197,004,095571,Perols; Johan Lars,9998,0,9999,1
1656121908426,COGS 9,A01,083615,Shannon; Kyle Michael,5,1,75,70
1656121914450,COGS 11,A01,083617,Boyle; Mary E. T.,16,2,48,32
1656121920473,COGS 13,A01,083071,Bastos; Amalia Pinkusfeld,9,3,71,62
1656121926495,COGS 14A,A01,092681,Semenuks; Arturs,8,24,100,92
1656121932521,COGS 14B,A01,083073,Cheng; Tzu-Han,7,0,63,56
1656121938544,COGS 17,A01,092677,Semenuks; Arturs,13,6,81,68
1656121944568,COGS 100,A01,083619,Allen; Michael Gordon,7,5,70,63
1656121950594,COGS 101A,A01,083621,Davis; Joshua Daniel,7,3,68,61
1656121956620,COGS 101B,A01,091572,Allen; Michael Gordon,6,0,65,59
1656121962643,COGS 101C,A01,083625,Delgado; Tania,11,0,35,24
1656121968671,COGS 107A,A01,083627,Boyle; Mary E. T.,5,4,60,55
1656121974693,COGS 118A,A01,083075,Gupta; Anjum,24,17,76,52
1656121980717,CSE 3,A50,083646,Miranda; Gregory Joseph,18,0,50,32
1656121986740,CSE 8A,A50,083650,Miranda; Gregory Joseph,13,12,56,43
1656121992764,CSE 11,A01,083080,Cao; Yingjun,1,59,40,39
1656121998785,CSE 12,A01,083652,Krause-Levy; Sophia Louisa,14,8,120,106
1656122004808,CSE 15L,A01,083654,Morris; Justin Loren,5,2,50,45
1656122004808,CSE 15L,A02,083655,Morris; Justin Loren,7,2,50,43
1656122010834,CSE 20,A01,083657,Tran; Khoa Dang,31,0,80,49
1656122016866,CSE 21,A01,095574,Bach; Quang Tran,25,0,48,23
1656122022889,CSE 30,A01,083084,Eldon; John,3,11,80,77
1656122022889,CSE 30,B01,095061,Bhaskar; Nishant,4,5,50,46
1656122028920,CSE 100,A01,083659,Cao; Yingjun,2,22,70,68
1656122034947,CSE 134B,A01,083661,Powell; Thomas Allan,11,8,100,89
1656122040972,CSE 140,A01,083663,Gungor; Onat,9,0,85,76
1656122046998,CSE 140L,A01,083088,Eldon; John,8,0,100,92
1656122053023,CSE 175,A01,083665,Kumar; Rakesh,0,0,25,25
1656122059049,CSE 190,A00,092507,Dubnov; Shlomo,2,0,20,18
1656122065072,ECE 45,A01,083139,Congero; Spencer William,5,4,75,70
1656122071100,ECE 65,A50,083695,Saad; Andrew S,8,0,30,22
1656122071100,ECE 65,A51,095125,Staff,23,0,26,3
1656122077124,ECE 109,A01,091882,Touri; Behrouz,7,7,70,63
1656122083148,ECE 180,A00,083140,Abi Samra; Nicholas Camill,1,0,30,29
1656122083148,ECE 180,B00,083141,Abi Samra; Nicholas Camill,4,8,30,26
1656122089172,MATH 10A,A01,083735,Patchell; Gregory David,0,0,30,30
1656122089172,MATH 10A,A02,083736,Patchell; Gregory David,22,0,30,8
1656122089172,MATH 10A,A03,083737,Patchell; Gregory David,16,0,30,14
1656122095200,MATH 10B,A01,083207,Lim; Seonhee,3,3,34,31
1656122095200,MATH 10B,A02,083208,Lim; Seonhee,10,3,35,25
1656122095200,MATH 10B,A03,093472,Staff,4,3,34,30
1656122095200,MATH 10B,B01,083739,Sinha; Shubham,12,0,30,18
1656122101224,MATH 18,A01,083743,Cinel; Cameron Alexander,7,0,30,23
1656122101224,MATH 18,A02,083744,Cinel; Cameron Alexander,10,0,30,20
1656122101224,MATH 18,A03,083745,Cinel; Cameron Alexander,3,0,30,27
1656122101224,MATH 18,B01,083748,Rideout; David Porter,0,0,36,36
1656122101224,MATH 18,B02,083749,Rideout; David Porter,0,0,36,36
1656122101224,MATH 18,B03,083750,Rideout; David Porter,0,0,36,36
1656122101224,MATH 18,B04,083751,Rideout; David Porter,0,0,36,36
1656122101224,MATH 18,B05,093473,Rideout; David Porter,2,0,36,34
1656122101224,MATH 18,B06,093474,Rideout; David Porter,4,0,36,32
1656122107247,MATH 20A,A01,083754,Zheng; Zequn,11,0,40,29
1656122113269,MATH 20B,A01,083756,Briones; Jor-el Thomas Caparas,0,0,36,36
1656122113269,MATH 20B,A02,083757,Briones; Jor-el Thomas Caparas,0,0,36,36
1656122113269,MATH 20B,A03,093475,Staff,2,0,36,34
1656122119298,MATH 20C,A01,083760,Briones; Jor-el Thomas Caparas,2,2,35,33
1656122119298,MATH 20C,A02,083761,Briones; Jor-el Thomas Caparas,9,1,35,26
1656122119298,MATH 20C,A03,093476,Staff,1,1,35,34
1656122119298,MATH 20C,B01,083762,Bach; Quang Tran,1,0,30,29
1656122125320,MATH 20D,A01,083765,Tran; Brian Kha,2,0,30,28
1656122125320,MATH 20D,A02,083766,Tran; Brian Kha,0,1,30,30
1656122125320,MATH 20D,A03,083767,Tran; Brian Kha,2,0,30,28
1656122131344,MATH 20E,A01,083771,Ganguly; Soumya,4,1,32,28
1656122131344,MATH 20E,A02,083772,Ganguly; Soumya,2,2,32,30
1656122131344,MATH 20E,B01,083773,Ciotti; Benjamin,14,0,35,21
1656122131344,MATH 20E,B02,083774,Ciotti; Benjamin,14,0,35,21
1656122137367,MATH 103A,A01,083777,Greenfeld; Be'Eri,2,0,36,34
1656122137367,MATH 103A,A02,083778,Greenfeld; Be'Eri,2,0,36,34
1656122137367,MATH 103A,A03,093561,Staff,4,1,36,32
1656122137367,MATH 103A,B01,083779,Greenfeld; Be'Eri,8,1,36,28
1656122137367,MATH 103A,B02,083780,Greenfeld; Be'Eri,0,0,36,36
1656122137367,MATH 103A,B03,093562,Staff,0,0,36,36
1656122143389,MATH 105,A01,085443,Carter; Anne Toulson,4,1,35,31
1656122143389,MATH 105,A02,093477,Staff,9,0,35,26
1656122149418,MATH 109,A01,083213,Ganzberger; Geoffrey Michael,1,1,34,33
1656122149418,MATH 109,A02,083214,Ganzberger; Geoffrey Michael,0,0,34,34
1656122149418,MATH 109,A03,093478,Staff,1,0,34,33
1656122149418,MATH 109,B01,083215,Ganzberger; Geoffrey Michael,3,0,32,29
1656122149418,MATH 109,B02,083216,Ganzberger; Geoffrey Michael,1,0,32,31
1656122149418,MATH 109,B03,093479,Staff,4,0,32,28
1656122155444,MATH 142A,A01,083219,Chow; Bennett,1,0,32,31
1656122155444,MATH 142A,A02,083220,Chow; Bennett,8,0,32,24
1656122155444,MATH 142A,A03,093480,Staff,5,0,32,27
1656122155444,MATH 142A,B03,093481,Staff,4,0,32,28
1656122155444,MATH 142A,B04,093558,Staff,5,0,32,27
1656122155444,MATH 142A,B05,093559,Staff,0,0,32,32
1656122161471,MATH 193A,A01,083224,Rotar; Vladimir,1,2,34,33
1656122161471,MATH 193A,A02,083225,Rotar; Vladimir,1,0,34,33
1656122161471,MATH 193A,A03,083781,Rotar; Vladimir,1,0,34,33
1656122161471,MATH 193A,A04,083782,Rotar; Vladimir,6,0,34,28
1656122161471,MATH 193A,A05,093482,Rotar; Vladimir,1,0,34,33
1656122167493,MATH 197,001,091859,McAuley; Julian John,9999,0,9999,0
1656122167493,MATH 197,002,095566,Kedlaya; Kiran S.,9997,0,9999,2
1656122167493,MATH 197,003,095567,Xiao; Ming,9999,0,9999,0
1656122167493,MATH 197,004,095571,Perols; Johan Lars,9998,0,9999,1
1656122174552,COGS 9,A01,083615,Shannon; Kyle Michael,5,1,75,70
1656122180579,COGS 11,A01,083617,Boyle; Mary E. T.,16,2,48,32
1656122186607,COGS 13,A01,083071,Bastos; Amalia Pinkusfeld,9,3,71,62
1656122192630,COGS 14A,A01,092681,Semenuks; Arturs,8,24,100,92
1656122198654,COGS 14B,A01,083073,Cheng; Tzu-Han,7,0,63,56
1656122204678,COGS 17,A01,092677,Semenuks; Arturs,13,6,81,68
1656122210701,COGS 100,A01,083619,Allen; Michael Gordon,7,5,70,63
1656122216725,COGS 101A,A01,083621,Davis; Joshua Daniel,7,3,68,61
1656122222749,COGS 101B,A01,091572,Allen; Michael Gordon,6,0,65,59
1656122228775,COGS 101C,A01,083625,Delgado; Tania,11,0,35,24
1656122234800,COGS 107A,A01,083627,Boyle; Mary E. T.,5,4,60,55
1656122240824,COGS 118A,A01,083075,Gupta; Anjum,24,17,76,52
1656122246847,CSE 3,A50,083646,Miranda; Gregory Joseph,18,0,50,32
1656122252870,CSE 8A,A50,083650,Miranda; Gregory Joseph,13,12,56,43
1656122258906,CSE 11,A01,083080,Cao; Yingjun,1,59,40,39
1656122264934,CSE 12,A01,083652,Krause-Levy; Sophia Louisa,14,8,120,106
1656122270957,CSE 15L,A01,083654,Morris; Justin Loren,5,2,50,45
1656122270957,CSE 15L,A02,083655,Morris; Justin Loren,7,2,50,43
1656122276982,CSE 20,A01,083657,Tran; Khoa Dang,31,0,80,49
1656122283009,CSE 21,A01,095574,Bach; Quang Tran,25,0,48,23
1656122289034,CSE 30,A01,083084,Eldon; John,3,11,80,77
1656122289034,CSE 30,B01,095061,Bhaskar; Nishant,4,5,50,46
1656122295057,CSE 100,A01,083659,Cao; Yingjun,2,22,70,68
1656122301079,CSE 134B,A01,083661,Powell; Thomas Allan,11,8,100,89
1656122307106,CSE 140,A01,083663,Gungor; Onat,9,0,85,76
1656122313129,CSE 140L,A01,083088,Eldon; John,8,0,100,92
1656122319162,CSE 175,A01,083665,Kumar; Rakesh,0,0,25,25
1656122325188,CSE 190,A00,092507,Dubnov; Shlomo,2,0,20,18
1656122331212,ECE 45,A01,083139,Congero; Spencer William,5,4,75,70
1656122337235,ECE 65,A50,083695,Saad; Andrew S,8,0,30,22
1656122337235,ECE 65,A51,095125,Staff,23,0,26,3
1656122343262,ECE 109,A01,091882,Touri; Behrouz,7,7,70,63
1656122349285,ECE 180,A00,083140,Abi Samra; Nicholas Camill,1,0,30,29
1656122349285,ECE 180,B00,083141,Abi Samra; Nicholas Camill,4,8,30,26
1656122355310,MATH 10A,A01,083735,Patchell; Gregory David,0,0,30,30
1656122355310,MATH 10A,A02,083736,Patchell; Gregory David,22,0,30,8
1656122355310,MATH 10A,A03,083737,Patchell; Gregory David,16,0,30,14
1656122361334,MATH 10B,A01,083207,Lim; Seonhee,3,3,34,31
1656122361334,MATH 10B,A02,083208,Lim; Seonhee,10,3,35,25
1656122361334,MATH 10B,A03,093472,Staff,4,3,34,30
1656122361334,MATH 10B,B01,083739,Sinha; Shubham,12,0,30,18
1656122367369,MATH 18,A01,083743,Cinel; Cameron Alexander,7,0,30,23
1656122367369,MATH 18,A02,083744,Cinel; Cameron Alexander,10,0,30,20
1656122367369,MATH 18,A03,083745,Cinel; Cameron Alexander,3,0,30,27
1656122367369,MATH 18,B01,083748,Rideout; David Porter,0,0,36,36
1656122367369,MATH 18,B02,083749,Rideout; David Porter,0,0,36,36
1656122367369,MATH 18,B03,083750,Rideout; David Porter,0,0,36,36
1656122367369,MATH 18,B04,083751,Rideout; David Porter,0,0,36,36
1656122367369,MATH 18,B05,093473,Rideout; David Porter,2,0,36,34
1656122367369,MATH 18,B06,093474,Rideout; David Porter,4,0,36,32
1656122373393,MATH 20A,A01,083754,Zheng; Zequn,11,0,40,29
1656122379422,MATH 20B,A01,083756,Briones; Jor-el Thomas Caparas,0,0,36,36
1656122379422,MATH 20B,A02,083757,Briones; Jor-el Thomas Caparas,0,0,36,36
1656122379422,MATH 20B,A03,093475,Staff,2,0,36,34
1656122385447,MATH 20C,A01,083760,Briones; Jor-el Thomas Caparas,2,2,35,33
1656122385447,MATH 20C,A02,083761,Briones; Jor-el Thomas Caparas,9,1,35,26
1656122385447,MATH 20C,A03,093476,Staff,1,1,35,34
1656122385447,MATH 20C,B01,083762,Bach; Quang Tran,1,0,30,29
1656122391475,MATH 20D,A01,083765,Tran; Brian Kha,2,0,30,28
1656122391475,MATH 20D,A02,083766,Tran; Brian Kha,0,1,30,30
1656122391475,MATH 20D,A03,083767,Tran; Brian Kha,2,0,30,28
1656122397508,MATH 20E,A01,083771,Ganguly; Soumya,4,1,32,28
1656122397508,MATH 20E,A02,083772,Ganguly; Soumya,2,2,32,30
1656122397508,MATH 20E,B01,083773,Ciotti; Benjamin,14,0,35,21
1656122397508,MATH 20E,B02,083774,Ciotti; Benjamin,14,0,35,21
1656122403533,MATH 103A,A01,083777,Greenfeld; Be'Eri,2,0,36,34
1656122403533,MATH 103A,A02,083778,Greenfeld; Be'Eri,2,0,36,34
1656122403533,MATH 103A,A03,093561,Staff,4,1,36,32
1656122403533,MATH 103A,B01,083779,Greenfeld; Be'Eri,8,1,36,28
1656122403533,MATH 103A,B02,083780,Greenfeld; Be'Eri,0,0,36,36
1656122403533,MATH 103A,B03,093562,Staff,0,0,36,36
1656122409557,MATH 105,A01,085443,Carter; Anne Toulson,4,1,35,31
1656122409557,MATH 105,A02,093477,Staff,9,0,35,26
1656122415586,MATH 109,A01,083213,Ganzberger; Geoffrey Michael,1,1,34,33
1656122415586,MATH 109,A02,083214,Ganzberger; Geoffrey Michael,0,0,34,34
1656122415586,MATH 109,A03,093478,Staff,1,0,34,33
1656122415586,MATH 109,B01,083215,Ganzberger; Geoffrey Michael,3,0,32,29
1656122415586,MATH 109,B02,083216,Ganzberger; Geoffrey Michael,1,0,32,31
1656122415586,MATH 109,B03,093479,Staff,4,0,32,28
1656122421610,MATH 142A,A01,083219,Chow; Bennett,1,0,32,31
1656122421610,MATH 142A,A02,083220,Chow; Bennett,8,0,32,24
1656122421610,MATH 142A,A03,093480,Staff,5,0,32,27
1656122421610,MATH 142A,B03,093481,Staff,4,0,32,28
1656122421610,MATH 142A,B04,093558,Staff,5,0,32,27
1656122421610,MATH 142A,B05,093559,Staff,0,0,32,32
1656122427640,MATH 193A,A01,083224,Rotar; Vladimir,1,2,34,33
1656122427640,MATH 193A,A02,083225,Rotar; Vladimir,1,0,34,33
1656122427640,MATH 193A,A03,083781,Rotar; Vladimir,1,0,34,33
1656122427640,MATH 193A,A04,083782,Rotar; Vladimir,6,0,34,28
1656122427640,MATH 193A,A05,093482,Rotar; Vladimir,1,0,34,33
1656122433670,MATH 197,001,091859,McAuley; Julian John,9999,0,9999,0
1656122433670,MATH 197,002,095566,Kedlaya; Kiran S.,9997,0,9999,2
1656122433670,MATH 197,003,095567,Xiao; Ming,9999,0,9999,0
1656122433670,MATH 197,004,095571,Perols; Johan Lars,9998,0,9999,1
1656122440724,COGS 9,A01,083615,Shannon; Kyle Michael,5,1,75,70
1656122446751,COGS 11,A01,083617,Boyle; Mary E. T.,16,2,48,32
1656122452775,COGS 13,A01,083071,Bastos; Amalia Pinkusfeld,9,3,71,62
1656122458798,COGS 14A,A01,092681,Semenuks; Arturs,8,24,100,92
1656122464823,COGS 14B,A01,083073,Cheng; Tzu-Han,7,0,63,56
1656122470848,COGS 17,A01,092677,Semenuks; Arturs,13,6,81,68
1656122476871,COGS 100,A01,083619,Allen; Michael Gordon,7,5,70,63
1656122482895,COGS 101A,A01,083621,Davis; Joshua Daniel,7,3,68,61
1656122488997,COGS 101B,A01,091572,Allen; Michael Gordon,6,0,65,59
1656122495025,COGS 101C,A01,083625,Delgado; Tania,11,0,35,24
1656122501048,COGS 107A,A01,083627,Boyle; Mary E. T.,5,4,60,55
1656122507086,COGS 118A,A01,083075,Gupta; Anjum,24,17,76,52
1656122513114,CSE 3,A50,083646,Miranda; Gregory Joseph,18,0,50,32
1656122519144,CSE 8A,A50,083650,Miranda; Gregory Joseph,13,12,56,43
1656122525168,CSE 11,A01,083080,Cao; Yingjun,1,59,40,39
1656122531200,CSE 12,A01,083652,Krause-Levy; Sophia Louisa,14,8,120,106
1656122537229,CSE 15L,A01,083654,Morris; Justin Loren,5,2,50,45
1656122537229,CSE 15L,A02,083655,Morris; Justin Loren,7,2,50,43
1656122543253,CSE 20,A01,083657,Tran; Khoa Dang,31,0,80,49
1656122549279,CSE 21,A01,095574,Bach; Quang Tran,25,0,48,23
1656122555303,CSE 30,A01,083084,Eldon; John,3,11,80,77
1656122555303,CSE 30,B01,095061,Bhaskar; Nishant,4,5,50,46
1656122561327,CSE 100,A01,083659,Cao; Yingjun,2,22,70,68
1656122567355,CSE 134B,A01,083661,Powell; Thomas Allan,11,8,100,89
1656122573389,CSE 140,A01,083663,Gungor; Onat,9,0,85,76
1656122579412,CSE 140L,A01,083088,Eldon; John,8,0,100,92
1656122585435,CSE 175,A01,083665,Kumar; Rakesh,0,0,25,25
1656122591460,CSE 190,A00,092507,Dubnov; Shlomo,2,0,20,18
1656122597489,ECE 45,A01,083139,Congero; Spencer William,5,4,75,70
1656122603512,ECE 65,A50,083695,Saad; Andrew S,8,0,30,22
1656122603512,ECE 65,A51,095125,Staff,23,0,26,3
1656122609535,ECE 109,A01,091882,Touri; Behrouz,7,7,70,63
1656122615559,ECE 180,A00,083140,Abi Samra; Nicholas Camill,1,0,30,29
1656122615559,ECE 180,B00,083141,Abi Samra; Nicholas Camill,4,8,30,26
1656122621584,MATH 10A,A01,083735,Patchell; Gregory David,0,0,30,30
1656122621584,MATH 10A,A02,083736,Patchell; Gregory David,22,0,30,8
1656122621584,MATH 10A,A03,083737,Patchell; Gregory David,16,0,30,14
1656122627607,MATH 10B,A01,083207,Lim; Seonhee,3,3,34,31
1656122627607,MATH 10B,A02,083208,Lim; Seonhee,10,3,35,25
1656122627607,MATH 10B,A03,093472,Staff,4,3,34,30
1656122627607,MATH 10B,B01,083739,Sinha; Shubham,12,0,30,18
1656122633632,MATH 18,A01,083743,Cinel; Cameron Alexander,7,0,30,23
1656122633632,MATH 18,A02,083744,Cinel; Cameron Alexander,10,0,30,20
1656122633632,MATH 18,A03,083745,Cinel; Cameron Alexander,3,0,30,27
1656122633632,MATH 18,B01,083748,Rideout; David Porter,0,0,36,36
1656122633632,MATH 18,B02,083749,Rideout; David Porter,0,0,36,36
1656122633632,MATH 18,B03,083750,Rideout; David Porter,0,0,36,36
1656122633632,MATH 18,B04,083751,Rideout; David Porter,0,0,36,36
1656122633632,MATH 18,B05,093473,Rideout; David Porter,2,0,36,34
1656122633632,MATH 18,B06,093474,Rideout; David Porter,4,0,36,32
1656122639655,MATH 20A,A01,083754,Zheng; Zequn,11,0,40,29
1656122645680,MATH 20B,A01,083756,Briones; Jor-el Thomas Caparas,0,0,36,36
1656122645680,MATH 20B,A02,083757,Briones; Jor-el Thomas Caparas,0,0,36,36
1656122645680,MATH 20B,A03,093475,Staff,2,0,36,34
1656122651702,MATH 20C,A01,083760,Briones; Jor-el Thomas Caparas,2,2,35,33
1656122651702,MATH 20C,A02,083761,Briones; Jor-el Thomas Caparas,9,1,35,26
1656122651702,MATH 20C,A03,093476,Staff,1,1,35,34
1656122651702,MATH 20C,B01,083762,Bach; Quang Tran,1,0,30,29
1656122657725,MATH 20D,A01,083765,Tran; Brian Kha,2,0,30,28
1656122657725,MATH 20D,A02,083766,Tran; Brian Kha,0,1,30,30
1656122657725,MATH 20D,A03,083767,Tran; Brian Kha,2,0,30,28
1656122663755,MATH 20E,A01,083771,Ganguly; Soumya,4,1,32,28
1656122663755,MATH 20E,A02,083772,Ganguly; Soumya,2,2,32,30
1656122663755,MATH 20E,B01,083773,Ciotti; Benjamin,14,0,35,21
1656122663755,MATH 20E,B02,083774,Ciotti; Benjamin,14,0,35,21
1656122669779,MATH 103A,A01,083777,Greenfeld; Be'Eri,2,0,36,34
1656122669779,MATH 103A,A02,083778,Greenfeld; Be'Eri,2,0,36,34
1656122669779,MATH 103A,A03,093561,Staff,4,1,36,32
1656122669779,MATH 103A,B01,083779,Greenfeld; Be'Eri,8,1,36,28
1656122669779,MATH 103A,B02,083780,Greenfeld; Be'Eri,0,0,36,36
1656122669779,MATH 103A,B03,093562,Staff,0,0,36,36
1656122675809,MATH 105,A01,085443,Carter; Anne Toulson,4,1,35,31
1656122675809,MATH 105,A02,093477,Staff,9,0,35,26
1656122681836,MATH 109,A01,083213,Ganzberger; Geoffrey Michael,1,1,34,33
1656122681836,MATH 109,A02,083214,Ganzberger; Geoffrey Michael,0,0,34,34
1656122681836,MATH 109,A03,093478,Staff,1,0,34,33
1656122681836,MATH 109,B01,083215,Ganzberger; Geoffrey Michael,3,0,32,29
1656122681836,MATH 109,B02,083216,Ganzberger; Geoffrey Michael,1,0,32,31
1656122681836,MATH 109,B03,093479,Staff,4,0,32,28
1656122687870,MATH 142A,A01,083219,Chow; Bennett,1,0,32,31
1656122687870,MATH 142A,A02,083220,Chow; Bennett,8,0,32,24
1656122687870,MATH 142A,A03,093480,Staff,5,0,32,27
1656122687870,MATH 142A,B03,093481,Staff,4,0,32,28
1656122687870,MATH 142A,B04,093558,Staff,5,0,32,27
1656122687870,MATH 142A,B05,093559,Staff,0,0,32,32
1656122693893,MATH 193A,A01,083224,Rotar; Vladimir,1,2,34,33
1656122693893,MATH 193A,A02,083225,Rotar; Vladimir,1,0,34,33
1656122693893,MATH 193A,A03,083781,Rotar; Vladimir,1,0,34,33
1656122693893,MATH 193A,A04,083782,Rotar; Vladimir,6,0,34,28
1656122693893,MATH 193A,A05,093482,Rotar; Vladimir,1,0,34,33
1656122699919,MATH 197,001,091859,McAuley; Julian John,9999,0,9999,0
1656122699919,MATH 197,002,095566,Kedlaya; Kiran S.,9997,0,9999,2
1656122699919,MATH 197,003,095567,Xiao; Ming,9999,0,9999,0
1656122699919,MATH 197,004,095571,Perols; Johan Lars,9998,0,9999,1
1656122706991,COGS 9,A01,083615,Shannon; Kyle Michael,5,1,75,70
1656122713014,COGS 11,A01,083617,Boyle; Mary E. T.,16,2,48,32
1656122719037,COGS 13,A01,083071,Bastos; Amalia Pinkusfeld,9,3,71,62
1656122725071,COGS 14A,A01,092681,Semenuks; Arturs,8,24,100,92
1656122731098,COGS 14B,A01,083073,Cheng; Tzu-Han,7,0,63,56
1656122737122,COGS 17,A01,092677,Semenuks; Arturs,13,6,81,68
1656122743148,COGS 100,A01,083619,Allen; Michael Gordon,7,5,70,63
1656122749172,COGS 101A,A01,083621,Davis; Joshua Daniel,7,3,68,61
1656122755195,COGS 101B,A01,091572,Allen; Michael Gordon,6,0,65,59
1656122761242,COGS 101C,A01,083625,Delgado; Tania,11,0,35,24
1656122767269,COGS 107A,A01,083627,Boyle; Mary E. T.,5,4,60,55
1656122773293,COGS 118A,A01,083075,Gupta; Anjum,24,17,76,52
1656122779318,CSE 3,A50,083646,Miranda; Gregory Joseph,18,0,50,32
1656122785379,CSE 8A,A50,083650,Miranda; Gregory Joseph,13,12,56,43
1656122791402,CSE 11,A01,083080,Cao; Yingjun,1,59,40,39
1656122797430,CSE 12,A01,083652,Krause-Levy; Sophia Louisa,14,8,120,106
1656122803453,CSE 15L,A01,083654,Morris; Justin Loren,5,2,50,45
1656122803453,CSE 15L,A02,083655,Morris; Justin Loren,7,2,50,43
1656122809475,CSE 20,A01,083657,Tran; Khoa Dang,31,0,80,49
1656122815503,CSE 21,A01,095574,Bach; Quang Tran,25,0,48,23
1656122821528,CSE 30,A01,083084,Eldon; John,3,11,80,77
1656122821528,CSE 30,B01,095061,Bhaskar; Nishant,4,5,50,46
1656122827554,CSE 100,A01,083659,Cao; Yingjun,2,22,70,68
1656122833576,CSE 134B,A01,083661,Powell; Thomas Allan,11,8,100,89
1656122839600,CSE 140,A01,083663,Gungor; Onat,9,0,85,76
1656122845628,CSE 140L,A01,083088,Eldon; John,8,0,100,92
1656122851651,CSE 175,A01,083665,Kumar; Rakesh,0,0,25,25
1656122857677,CSE 190,A00,092507,Dubnov; Shlomo,2,0,20,18
1656122863705,ECE 45,A01,083139,Congero; Spencer William,5,4,75,70
1656122869732,ECE 65,A50,083695,Saad; Andrew S,8,0,30,22
1656122869732,ECE 65,A51,095125,Staff,23,0,26,3
1656122875755,ECE 109,A01,091882,Touri; Behrouz,7,7,70,63
1656122881778,ECE 180,A00,083140,Abi Samra; Nicholas Camill,1,0,30,29
1656122881778,ECE 180,B00,083141,Abi Samra; Nicholas Camill,4,8,30,26
1656122887803,MATH 10A,A01,083735,Patchell; Gregory David,0,0,30,30
1656122887803,MATH 10A,A02,083736,Patchell; Gregory David,22,0,30,8
1656122887803,MATH 10A,A03,083737,Patchell; Gregory David,16,0,30,14
1656122893833,MATH 10B,A01,083207,Lim; Seonhee,3,3,34,31
1656122893833,MATH 10B,A02,083208,Lim; Seonhee,10,3,35,25
1656122893833,MATH 10B,A03,093472,Staff,4,3,34,30
1656122893833,MATH 10B,B01,083739,Sinha; Shubham,11,0,30,19
1656122899862,MATH 18,A01,083743,Cinel; Cameron Alexander,7,0,30,23
1656122899862,MATH 18,A02,083744,Cinel; Cameron Alexander,10,0,30,20
1656122899862,MATH 18,A03,083745,Cinel; Cameron Alexander,3,0,30,27
1656122899862,MATH 18,B01,083748,Rideout; David Porter,0,0,36,36
1656122899862,MATH 18,B02,083749,Rideout; David Porter,0,0,36,36
1656122899862,MATH 18,B03,083750,Rideout; David Porter,0,0,36,36
1656122899862,MATH 18,B04,083751,Rideout; David Porter,0,0,36,36
1656122899862,MATH 18,B05,093473,Rideout; David Porter,2,0,36,34
1656122899862,MATH 18,B06,093474,Rideout; David Porter,4,0,36,32
1656122905899,MATH 20A,A01,083754,Zheng; Zequn,11,0,40,29
1656122911923,MATH 20B,A01,083756,Briones; Jor-el Thomas Caparas,0,0,36,36
1656122911923,MATH 20B,A02,083757,Briones; Jor-el Thomas Caparas,0,0,36,36
1656122911923,MATH 20B,A03,093475,Staff,2,0,36,34
1656122917951,MATH 20C,A01,083760,Briones; Jor-el Thomas Caparas,2,2,35,33
1656122917951,MATH 20C,A02,083761,Briones; Jor-el Thomas Caparas,9,1,35,26
1656122917951,MATH 20C,A03,093476,Staff,1,1,35,34
1656122917951,MATH 20C,B01,083762,Bach; Quang Tran,1,0,30,29
1656122923976,MATH 20D,A01,083765,Tran; Brian Kha,2,0,30,28
1656122923976,MATH 20D,A02,083766,Tran; Brian Kha,0,1,30,30
1656122923976,MATH 20D,A03,083767,Tran; Brian Kha,2,0,30,28
1656122930005,MATH 20E,A01,083771,Ganguly; Soumya,4,1,32,28
1656122930005,MATH 20E,A02,083772,Ganguly; Soumya,2,2,32,30
1656122930005,MATH 20E,B01,083773,Ciotti; Benjamin,14,0,35,21
1656122930005,MATH 20E,B02,083774,Ciotti; Benjamin,14,0,35,21
1656122936035,MATH 103A,A01,083777,Greenfeld; Be'Eri,2,0,36,34
1656122936035,MATH 103A,A02,083778,Greenfeld; Be'Eri,2,0,36,34
1656122936035,MATH 103A,A03,093561,Staff,4,1,36,32
1656122936035,MATH 103A,B01,083779,Greenfeld; Be'Eri,8,1,36,28
1656122936035,MATH 103A,B02,083780,Greenfeld; Be'Eri,0,0,36,36
1656122936035,MATH 103A,B03,093562,Staff,0,0,36,36
1656122942071,MATH 105,A01,085443,Carter; Anne Toulson,4,1,35,31
1656122942071,MATH 105,A02,093477,Staff,9,0,35,26
1656122948102,MATH 109,A01,083213,Ganzberger; Geoffrey Michael,1,1,34,33
1656122948102,MATH 109,A02,083214,Ganzberger; Geoffrey Michael,0,0,34,34
1656122948102,MATH 109,A03,093478,Staff,1,0,34,33
1656122948102,MATH 109,B01,083215,Ganzberger; Geoffrey Michael,3,0,32,29
1656122948102,MATH 109,B02,083216,Ganzberger; Geoffrey Michael,1,0,32,31
1656122948102,MATH 109,B03,093479,Staff,4,0,32,28
1656122954130,MATH 142A,A01,083219,Chow; Bennett,1,0,32,31
1656122954130,MATH 142A,A02,083220,Chow; Bennett,8,0,32,24
1656122954130,MATH 142A,A03,093480,Staff,5,0,32,27
1656122954130,MATH 142A,B03,093481,Staff,4,0,32,28
1656122954130,MATH 142A,B04,093558,Staff,5,0,32,27
1656122954130,MATH 142A,B05,093559,Staff,0,0,32,32
1656122960160,MATH 193A,A01,083224,Rotar; Vladimir,1,2,34,33
1656122960160,MATH 193A,A02,083225,Rotar; Vladimir,1,0,34,33
1656122960160,MATH 193A,A03,083781,Rotar; Vladimir,1,0,34,33
1656122960160,MATH 193A,A04,083782,Rotar; Vladimir,6,0,34,28
1656122960160,MATH 193A,A05,093482,Rotar; Vladimir,1,0,34,33
1656122966191,MATH 197,001,091859,McAuley; Julian John,9999,0,9999,0
1656122966191,MATH 197,002,095566,Kedlaya; Kiran S.,9997,0,9999,2
1656122966191,MATH 197,003,095567,Xiao; Ming,9999,0,9999,0
1656122966191,MATH 197,004,095571,Perols; Johan Lars,9998,0,9999,1
1656122973242,COGS 9,A01,083615,Shannon; Kyle Michael,5,1,75,70
1656122979265,COGS 11,A01,083617,Boyle; Mary E. T.,16,2,48,32
1656122985288,COGS 13,A01,083071,Bastos; Amalia Pinkusfeld,9,3,71,62
1656122991312,COGS 14A,A01,092681,Semenuks; Arturs,8,24,100,92
1656122997345,COGS 14B,A01,083073,Cheng; Tzu-Han,7,0,63,56
1656123003380,COGS 17,A01,092677,Semenuks; Arturs,13,6,81,68
1656123009409,COGS 100,A01,083619,Allen; Michael Gordon,7,5,70,63
1656123015437,COGS 101A,A01,083621,Davis; Joshua Daniel,7,3,68,61
1656123021464,COGS 101B,A01,091572,Allen; Michael Gordon,6,0,65,59
1656123027487,COGS 101C,A01,083625,Delgado; Tania,11,0,35,24
1656123033514,COGS 107A,A01,083627,Boyle; Mary E. T.,5,4,60,55
1656123039537,COGS 118A,A01,083075,Gupta; Anjum,24,17,76,52
1656123045561,CSE 3,A50,083646,Miranda; Gregory Joseph,18,0,50,32
1656123051587,CSE 8A,A50,083650,Miranda; Gregory Joseph,13,13,56,43
1656123057614,CSE 11,A01,083080,Cao; Yingjun,1,59,40,39
1656123063639,CSE 12,A01,083652,Krause-Levy; Sophia Louisa,14,8,120,106
1656123069665,CSE 15L,A01,083654,Morris; Justin Loren,5,2,50,45
1656123069665,CSE 15L,A02,083655,Morris; Justin Loren,7,2,50,43
1656123075689,CSE 20,A01,083657,Tran; Khoa Dang,31,0,80,49
1656123081716,CSE 21,A01,095574,Bach; Quang Tran,25,0,48,23
1656123087827,CSE 30,A01,083084,Eldon; John,3,11,80,77
1656123087827,CSE 30,B01,095061,Bhaskar; Nishant,4,5,50,46
1656123093855,CSE 100,A01,083659,Cao; Yingjun,2,22,70,68
1656123099881,CSE 134B,A01,083661,Powell; Thomas Allan,11,8,100,89
1656123105905,CSE 140,A01,083663,Gungor; Onat,9,0,85,76
1656123111928,CSE 140L,A01,083088,Eldon; John,8,0,100,92
1656123117951,CSE 175,A01,083665,Kumar; Rakesh,0,0,25,25
1656123123981,CSE 190,A00,092507,Dubnov; Shlomo,2,0,20,18
1656123130004,ECE 45,A01,083139,Congero; Spencer William,5,4,75,70
1656123136026,ECE 65,A50,083695,Saad; Andrew S,8,0,30,22
1656123136026,ECE 65,A51,095125,Staff,23,0,26,3
1656123142052,ECE 109,A01,091882,Touri; Behrouz,7,7,70,63
1656123148076,ECE 180,A00,083140,Abi Samra; Nicholas Camill,1,0,30,29
1656123148076,ECE 180,B00,083141,Abi Samra; Nicholas Camill,4,8,30,26
1656123154099,MATH 10A,A01,083735,Patchell; Gregory David,0,0,30,30
1656123154099,MATH 10A,A02,083736,Patchell; Gregory David,22,0,30,8
1656123154099,MATH 10A,A03,083737,Patchell; Gregory David,16,0,30,14
1656123160123,MATH 10B,A01,083207,Lim; Seonhee,3,3,34,31
1656123160123,MATH 10B,A02,083208,Lim; Seonhee,10,3,35,25
1656123160123,MATH 10B,A03,093472,Staff,4,3,34,30
1656123160123,MATH 10B,B01,083739,Sinha; Shubham,11,0,30,19
1656123166147,MATH 18,A01,083743,Cinel; Cameron Alexander,7,0,30,23
1656123166147,MATH 18,A02,083744,Cinel; Cameron Alexander,10,0,30,20
1656123166147,MATH 18,A03,083745,Cinel; Cameron Alexander,3,0,30,27
1656123166147,MATH 18,B01,083748,Rideout; David Porter,0,0,36,36
1656123166147,MATH 18,B02,083749,Rideout; David Porter,0,0,36,36
1656123166147,MATH 18,B03,083750,Rideout; David Porter,0,0,36,36
1656123166147,MATH 18,B04,083751,Rideout; David Porter,0,0,36,36
1656123166147,MATH 18,B05,093473,Rideout; David Porter,2,0,36,34
1656123166147,MATH 18,B06,093474,Rideout; David Porter,4,0,36,32
1656123172172,MATH 20A,A01,083754,Zheng; Zequn,11,0,40,29
1656123178195,MATH 20B,A01,083756,Briones; Jor-el Thomas Caparas,0,0,36,36
1656123178195,MATH 20B,A02,083757,Briones; Jor-el Thomas Caparas,0,0,36,36
1656123178195,MATH 20B,A03,093475,Staff,2,0,36,34
1656123184224,MATH 20C,A01,083760,Briones; Jor-el Thomas Caparas,2,2,35,33
1656123184224,MATH 20C,A02,083761,Briones; Jor-el Thomas Caparas,9,1,35,26
1656123184224,MATH 20C,A03,093476,Staff,1,1,35,34
1656123184224,MATH 20C,B01,083762,Bach; Quang Tran,1,0,30,29
1656123190248,MATH 20D,A01,083765,Tran; Brian Kha,2,0,30,28
1656123190248,MATH 20D,A02,083766,Tran; Brian Kha,0,1,30,30
1656123190248,MATH 20D,A03,083767,Tran; Brian Kha,2,0,30,28
1656123196277,MATH 20E,A01,083771,Ganguly; Soumya,4,1,32,28
1656123196277,MATH 20E,A02,083772,Ganguly; Soumya,2,2,32,30
1656123196277,MATH 20E,B01,083773,Ciotti; Benjamin,14,0,35,21
1656123196277,MATH 20E,B02,083774,Ciotti; Benjamin,14,0,35,21
1656123202307,MATH 103A,A01,083777,Greenfeld; Be'Eri,2,0,36,34
1656123202307,MATH 103A,A02,083778,Greenfeld; Be'Eri,2,0,36,34
1656123202307,MATH 103A,A03,093561,Staff,4,1,36,32
1656123202307,MATH 103A,B01,083779,Greenfeld; Be'Eri,8,1,36,28
1656123202307,MATH 103A,B02,083780,Greenfeld; Be'Eri,0,0,36,36
1656123202307,MATH 103A,B03,093562,Staff,0,0,36,36
1656123208335,MATH 105,A01,085443,Carter; Anne Toulson,4,1,35,31
1656123208335,MATH 105,A02,093477,Staff,9,0,35,26
1656123214358,MATH 109,A01,083213,Ganzberger; Geoffrey Michael,1,1,34,33
1656123214358,MATH 109,A02,083214,Ganzberger; Geoffrey Michael,0,0,34,34
1656123214358,MATH 109,A03,093478,Staff,1,0,34,33
1656123214358,MATH 109,B01,083215,Ganzberger; Geoffrey Michael,3,0,32,29
1656123214358,MATH 109,B02,083216,Ganzberger; Geoffrey Michael,1,0,32,31
1656123214358,MATH 109,B03,093479,Staff,4,0,32,28
1656123220388,MATH 142A,A01,083219,Chow; Bennett,1,0,32,31
1656123220388,MATH 142A,A02,083220,Chow; Bennett,8,0,32,24
1656123220388,MATH 142A,A03,093480,Staff,5,0,32,27
1656123220388,MATH 142A,B03,093481,Staff,4,0,32,28
1656123220388,MATH 142A,B04,093558,Staff,5,0,32,27
1656123220388,MATH 142A,B05,093559,Staff,0,0,32,32
1656123226416,MATH 193A,A01,083224,Rotar; Vladimir,1,2,34,33
1656123226416,MATH 193A,A02,083225,Rotar; Vladimir,1,0,34,33
1656123226416,MATH 193A,A03,083781,Rotar; Vladimir,1,0,34,33
1656123226416,MATH 193A,A04,083782,Rotar; Vladimir,6,0,34,28
1656123226416,MATH 193A,A05,093482,Rotar; Vladimir,1,0,34,33
1656123232448,MATH 197,001,091859,McAuley; Julian John,9999,0,9999,0
1656123232448,MATH 197,002,095566,Kedlaya; Kiran S.,9997,0,9999,2
1656123232448,MATH 197,003,095567,Xiao; Ming,9999,0,9999,0
1656123232448,MATH 197,004,095571,Perols; Johan Lars,9998,0,9999,1
1656123239503,COGS 9,A01,083615,Shannon; Kyle Michael,5,1,75,70
1656123245529,COGS 11,A01,083617,Boyle; Mary E. T.,16,2,48,32
1656123251553,COGS 13,A01,083071,Bastos; Amalia Pinkusfeld,9,3,71,62
1656123257576,COGS 14A,A01,092681,Semenuks; Arturs,8,24,100,92
1656123263600,COGS 14B,A01,083073,Cheng; Tzu-Han,7,0,63,56
1656123269623,COGS 17,A01,092677,Semenuks; Arturs,13,6,81,68
1656123275649,COGS 100,A01,083619,Allen; Michael Gordon,7,5,70,63
1656123281676,COGS 101A,A01,083621,Davis; Joshua Daniel,7,3,68,61
1656123287704,COGS 101B,A01,091572,Allen; Michael Gordon,6,0,65,59
1656123293743,COGS 101C,A01,083625,Delgado; Tania,11,0,35,24
1656123299769,COGS 107A,A01,083627,Boyle; Mary E. T.,5,4,60,55
1656123305795,COGS 118A,A01,083075,Gupta; Anjum,24,17,76,52
1656123311818,CSE 3,A50,083646,Miranda; Gregory Joseph,18,0,50,32
1656123317848,CSE 8A,A50,083650,Miranda; Gregory Joseph,13,13,56,43
1656123323872,CSE 11,A01,083080,Cao; Yingjun,1,59,40,39
1656123329901,CSE 12,A01,083652,Krause-Levy; Sophia Louisa,14,8,120,106
1656123335926,CSE 15L,A01,083654,Morris; Justin Loren,5,2,50,45
1656123335926,CSE 15L,A02,083655,Morris; Justin Loren,7,2,50,43
1656123341954,CSE 20,A01,083657,Tran; Khoa Dang,31,0,80,49
1656123347981,CSE 21,A01,095574,Bach; Quang Tran,25,0,48,23
1656123354005,CSE 30,A01,083084,Eldon; John,3,11,80,77
1656123354005,CSE 30,B01,095061,Bhaskar; Nishant,4,5,50,46
1656123360036,CSE 100,A01,083659,Cao; Yingjun,2,22,70,68
1656123366063,CSE 134B,A01,083661,Powell; Thomas Allan,11,8,100,89
1656123372087,CSE 140,A01,083663,Gungor; Onat,9,0,85,76
1656123378111,CSE 140L,A01,083088,Eldon; John,8,0,100,92
1656123384137,CSE 175,A01,083665,Kumar; Rakesh,0,0,25,25
1656123390161,CSE 190,A00,092507,Dubnov; Shlomo,2,0,20,18
1656123396185,ECE 45,A01,083139,Congero; Spencer William,5,4,75,70
1656123402223,ECE 65,A50,083695,Saad; Andrew S,8,0,30,22
1656123402223,ECE 65,A51,095125,Staff,23,0,26,3
1656123408249,ECE 109,A01,091882,Touri; Behrouz,7,7,70,63
1656123414272,ECE 180,A00,083140,Abi Samra; Nicholas Camill,1,0,30,29
1656123414272,ECE 180,B00,083141,Abi Samra; Nicholas Camill,4,8,30,26
1656123420304,MATH 10A,A01,083735,Patchell; Gregory David,0,0,30,30
1656123420304,MATH 10A,A02,083736,Patchell; Gregory David,22,0,30,8
1656123420304,MATH 10A,A03,083737,Patchell; Gregory David,16,0,30,14
1656123426332,MATH 10B,A01,083207,Lim; Seonhee,3,3,34,31
1656123426332,MATH 10B,A02,083208,Lim; Seonhee,10,3,35,25
1656123426332,MATH 10B,A03,093472,Staff,4,3,34,30
1656123426332,MATH 10B,B01,083739,Sinha; Shubham,11,0,30,19
1656123432356,MATH 18,A01,083743,Cinel; Cameron Alexander,7,0,30,23
1656123432356,MATH 18,A02,083744,Cinel; Cameron Alexander,10,0,30,20
1656123432356,MATH 18,A03,083745,Cinel; Cameron Alexander,3,0,30,27
1656123432356,MATH 18,B01,083748,Rideout; David Porter,0,0,36,36
1656123432356,MATH 18,B02,083749,Rideout; David Porter,0,0,36,36
1656123432356,MATH 18,B03,083750,Rideout; David Porter,0,0,36,36
1656123432356,MATH 18,B04,083751,Rideout; David Porter,0,0,36,36
1656123432356,MATH 18,B05,093473,Rideout; David Porter,2,0,36,34
1656123432356,MATH 18,B06,093474,Rideout; David Porter,4,0,36,32
1656123438384,MATH 20A,A01,083754,Zheng; Zequn,11,0,40,29
1656123444413,MATH 20B,A01,083756,Briones; Jor-el Thomas Caparas,0,0,36,36
1656123444413,MATH 20B,A02,083757,Briones; Jor-el Thomas Caparas,0,0,36,36
1656123444413,MATH 20B,A03,093475,Staff,2,0,36,34
1656123450436,MATH 20C,A01,083760,Briones; Jor-el Thomas Caparas,2,2,35,33
1656123450436,MATH 20C,A02,083761,Briones; Jor-el Thomas Caparas,9,1,35,26
1656123450436,MATH 20C,A03,093476,Staff,1,1,35,34
1656123450436,MATH 20C,B01,083762,Bach; Quang Tran,1,0,30,29
1656123456464,MATH 20D,A01,083765,Tran; Brian Kha,2,0,30,28
1656123456464,MATH 20D,A02,083766,Tran; Brian Kha,0,1,30,30
1656123456464,MATH 20D,A03,083767,Tran; Brian Kha,2,0,30,28
1656123462488,MATH 20E,A01,083771,Ganguly; Soumya,4,1,32,28
1656123462488,MATH 20E,A02,083772,Ganguly; Soumya,2,2,32,30
1656123462488,MATH 20E,B01,083773,Ciotti; Benjamin,14,0,35,21
1656123462488,MATH 20E,B02,083774,Ciotti; Benjamin,14,0,35,21
1656123468518,MATH 103A,A01,083777,Greenfeld; Be'Eri,2,0,36,34
1656123468518,MATH 103A,A02,083778,Greenfeld; Be'Eri,2,0,36,34
1656123468518,MATH 103A,A03,093561,Staff,4,1,36,32
1656123468518,MATH 103A,B01,083779,Greenfeld; Be'Eri,8,1,36,28
1656123468518,MATH 103A,B02,083780,Greenfeld; Be'Eri,0,0,36,36
1656123468518,MATH 103A,B03,093562,Staff,0,0,36,36
1656123474541,MATH 105,A01,085443,Carter; Anne Toulson,4,1,35,31
1656123474541,MATH 105,A02,093477,Staff,9,0,35,26
1656123480564,MATH 109,A01,083213,Ganzberger; Geoffrey Michael,1,1,34,33
1656123480564,MATH 109,A02,083214,Ganzberger; Geoffrey Michael,0,0,34,34
1656123480564,MATH 109,A03,093478,Staff,1,0,34,33
1656123480564,MATH 109,B01,083215,Ganzberger; Geoffrey Michael,3,0,32,29
1656123480564,MATH 109,B02,083216,Ganzberger; Geoffrey Michael,1,0,32,31
1656123480564,MATH 109,B03,093479,Staff,4,0,32,28
1656123486587,MATH 142A,A01,083219,Chow; Bennett,1,0,32,31
1656123486587,MATH 142A,A02,083220,Chow; Bennett,8,0,32,24
1656123486587,MATH 142A,A03,093480,Staff,5,0,32,27
1656123486587,MATH 142A,B03,093481,Staff,4,0,32,28
1656123486587,MATH 142A,B04,093558,Staff,5,0,32,27
1656123486587,MATH 142A,B05,093559,Staff,0,0,32,32
1656123492615,MATH 193A,A01,083224,Rotar; Vladimir,1,2,34,33
1656123492615,MATH 193A,A02,083225,Rotar; Vladimir,1,0,34,33
1656123492615,MATH 193A,A03,083781,Rotar; Vladimir,1,0,34,33
1656123492615,MATH 193A,A04,083782,Rotar; Vladimir,6,0,34,28
1656123492615,MATH 193A,A05,093482,Rotar; Vladimir,1,0,34,33
1656123498639,MATH 197,001,091859,McAuley; Julian John,9999,0,9999,0
1656123498639,MATH 197,002,095566,Kedlaya; Kiran S.,9997,0,9999,2
1656123498639,MATH 197,003,095567,Xiao; Ming,9999,0,9999,0
1656123498639,MATH 197,004,095571,Perols; Johan Lars,9998,0,9999,1
1656123505692,COGS 9,A01,083615,Shannon; Kyle Michael,5,1,75,70
1656123511715,COGS 11,A01,083617,Boyle; Mary E. T.,16,2,48,32
1656123517737,COGS 13,A01,083071,Bastos; Amalia Pinkusfeld,9,3,71,62
1656123523764,COGS 14A,A01,092681,Semenuks; Arturs,8,24,100,92
1656123529787,COGS 14B,A01,083073,Cheng; Tzu-Han,7,0,63,56
1656123535810,COGS 17,A01,092677,Semenuks; Arturs,13,6,81,68
1656123541835,COGS 100,A01,083619,Allen; Michael Gordon,7,5,70,63
1656123547858,COGS 101A,A01,083621,Davis; Joshua Daniel,7,3,68,61
1656123553881,COGS 101B,A01,091572,Allen; Michael Gordon,6,0,65,59
1656123559906,COGS 101C,A01,083625,Delgado; Tania,11,0,35,24
1656123565929,COGS 107A,A01,083627,Boyle; Mary E. T.,5,4,60,55
1656123571957,COGS 118A,A01,083075,Gupta; Anjum,24,17,76,52
1656123577991,CSE 3,A50,083646,Miranda; Gregory Joseph,18,0,50,32
1656123584014,CSE 8A,A50,083650,Miranda; Gregory Joseph,13,13,56,43
1656123590039,CSE 11,A01,083080,Cao; Yingjun,1,59,40,39
1656123596067,CSE 12,A01,083652,Krause-Levy; Sophia Louisa,14,8,120,106
1656123602095,CSE 15L,A01,083654,Morris; Justin Loren,5,2,50,45
1656123602095,CSE 15L,A02,083655,Morris; Justin Loren,7,2,50,43
1656123608124,CSE 20,A01,083657,Tran; Khoa Dang,31,0,80,49
1656123614154,CSE 21,A01,095574,Bach; Quang Tran,25,0,48,23
1656123620183,CSE 30,A01,083084,Eldon; John,3,11,80,77
1656123620183,CSE 30,B01,095061,Bhaskar; Nishant,4,5,50,46
1656123626220,CSE 100,A01,083659,Cao; Yingjun,2,22,70,68
1656123632245,CSE 134B,A01,083661,Powell; Thomas Allan,11,8,100,89
1656123638273,CSE 140,A01,083663,Gungor; Onat,9,0,85,76
1656123644296,CSE 140L,A01,083088,Eldon; John,8,0,100,92
1656123650323,CSE 175,A01,083665,Kumar; Rakesh,0,0,25,25
1656123656350,CSE 190,A00,092507,Dubnov; Shlomo,2,0,20,18
1656123662377,ECE 45,A01,083139,Congero; Spencer William,5,4,75,70
1656123668402,ECE 65,A50,083695,Saad; Andrew S,8,0,30,22
1656123668402,ECE 65,A51,095125,Staff,23,0,26,3
1656123674427,ECE 109,A01,091882,Touri; Behrouz,7,7,70,63
1656123680458,ECE 180,A00,083140,Abi Samra; Nicholas Camill,1,0,30,29
1656123680458,ECE 180,B00,083141,Abi Samra; Nicholas Camill,4,8,30,26
1656123686584,MATH 10A,A01,083735,Patchell; Gregory David,0,0,30,30
1656123686584,MATH 10A,A02,083736,Patchell; Gregory David,22,0,30,8
1656123686584,MATH 10A,A03,083737,Patchell; Gregory David,16,0,30,14
1656123692609,MATH 10B,A01,083207,Lim; Seonhee,3,3,34,31
1656123692609,MATH 10B,A02,083208,Lim; Seonhee,10,3,35,25
1656123692609,MATH 10B,A03,093472,Staff,4,3,34,30
1656123692609,MATH 10B,B01,083739,Sinha; Shubham,11,0,30,19
1656123698662,MATH 18,A01,083743,Cinel; Cameron Alexander,7,0,30,23
1656123698662,MATH 18,A02,083744,Cinel; Cameron Alexander,10,0,30,20
1656123698662,MATH 18,A03,083745,Cinel; Cameron Alexander,3,0,30,27
1656123698662,MATH 18,B01,083748,Rideout; David Porter,0,0,36,36
1656123698662,MATH 18,B02,083749,Rideout; David Porter,0,0,36,36
1656123698662,MATH 18,B03,083750,Rideout; David Porter,0,0,36,36
1656123698662,MATH 18,B04,083751,Rideout; David Porter,0,0,36,36
1656123698662,MATH 18,B05,093473,Rideout; David Porter,2,0,36,34
1656123698662,MATH 18,B06,093474,Rideout; David Porter,4,0,36,32
1656123704685,MATH 20A,A01,083754,Zheng; Zequn,11,0,40,29
1656123710708,MATH 20B,A01,083756,Briones; Jor-el Thomas Caparas,0,0,36,36
1656123710708,MATH 20B,A02,083757,Briones; Jor-el Thomas Caparas,0,0,36,36
1656123710708,MATH 20B,A03,093475,Staff,2,0,36,34
1656123716738,MATH 20C,A01,083760,Briones; Jor-el Thomas Caparas,2,2,35,33
1656123716738,MATH 20C,A02,083761,Briones; Jor-el Thomas Caparas,9,1,35,26
1656123716738,MATH 20C,A03,093476,Staff,1,1,35,34
1656123716738,MATH 20C,B01,083762,Bach; Quang Tran,1,0,30,29
1656123722770,MATH 20D,A01,083765,Tran; Brian Kha,2,0,30,28
1656123722770,MATH 20D,A02,083766,Tran; Brian Kha,0,1,30,30
1656123722770,MATH 20D,A03,083767,Tran; Brian Kha,2,0,30,28
1656123728801,MATH 20E,A01,083771,Ganguly; Soumya,4,1,32,28
1656123728801,MATH 20E,A02,083772,Ganguly; Soumya,2,2,32,30
1656123728801,MATH 20E,B01,083773,Ciotti; Benjamin,14,0,35,21
1656123728801,MATH 20E,B02,083774,Ciotti; Benjamin,14,0,35,21
1656123734823,MATH 103A,A01,083777,Greenfeld; Be'Eri,2,0,36,34
1656123734823,MATH 103A,A02,083778,Greenfeld; Be'Eri,2,0,36,34
1656123734823,MATH 103A,A03,093561,Staff,4,1,36,32
1656123734823,MATH 103A,B01,083779,Greenfeld; Be'Eri,8,1,36,28
1656123734823,MATH 103A,B02,083780,Greenfeld; Be'Eri,0,0,36,36
1656123734823,MATH 103A,B03,093562,Staff,0,0,36,36
1656123740848,MATH 105,A01,085443,Carter; Anne Toulson,4,1,35,31
1656123740848,MATH 105,A02,093477,Staff,9,0,35,26
1656123746872,MATH 109,A01,083213,Ganzberger; Geoffrey Michael,1,1,34,33
1656123746872,MATH 109,A02,083214,Ganzberger; Geoffrey Michael,0,0,34,34
1656123746872,MATH 109,A03,093478,Staff,1,0,34,33
1656123746872,MATH 109,B01,083215,Ganzberger; Geoffrey Michael,3,0,32,29
1656123746872,MATH 109,B02,083216,Ganzberger; Geoffrey Michael,1,0,32,31
1656123746872,MATH 109,B03,093479,Staff,4,0,32,28
1656123752896,MATH 142A,A01,083219,Chow; Bennett,1,0,32,31
1656123752896,MATH 142A,A02,083220,Chow; Bennett,8,0,32,24
1656123752896,MATH 142A,A03,093480,Staff,5,0,32,27
1656123752896,MATH 142A,B03,093481,Staff,4,0,32,28
1656123752896,MATH 142A,B04,093558,Staff,5,0,32,27
1656123752896,MATH 142A,B05,093559,Staff,0,0,32,32
1656123758928,MATH 193A,A01,083224,Rotar; Vladimir,1,2,34,33
1656123758928,MATH 193A,A02,083225,Rotar; Vladimir,1,0,34,33
1656123758928,MATH 193A,A03,083781,Rotar; Vladimir,1,0,34,33
1656123758928,MATH 193A,A04,083782,Rotar; Vladimir,6,0,34,28
1656123758928,MATH 193A,A05,093482,Rotar; Vladimir,1,0,34,33
1656123764965,MATH 197,001,091859,McAuley; Julian John,9999,0,9999,0
1656123764965,MATH 197,002,095566,Kedlaya; Kiran S.,9997,0,9999,2
1656123764965,MATH 197,003,095567,Xiao; Ming,9999,0,9999,0
1656123764965,MATH 197,004,095571,Perols; Johan Lars,9998,0,9999,1
1656123772026,COGS 9,A01,083615,Shannon; Kyle Michael,5,1,75,70
1656123778050,COGS 11,A01,083617,Boyle; Mary E. T.,16,2,48,32
1656123784074,COGS 13,A01,083071,Bastos; Amalia Pinkusfeld,9,3,71,62
1656123790102,COGS 14A,A01,092681,Semenuks; Arturs,8,24,100,92
1656123796124,COGS 14B,A01,083073,Cheng; Tzu-Han,7,0,63,56
1656123802148,COGS 17,A01,092677,Semenuks; Arturs,13,6,81,68
1656123808173,COGS 100,A01,083619,Allen; Michael Gordon,7,5,70,63
1656123814196,COGS 101A,A01,083621,Davis; Joshua Daniel,7,3,68,61
1656123820219,COGS 101B,A01,091572,Allen; Michael Gordon,6,0,65,59
1656123826247,COGS 101C,A01,083625,Delgado; Tania,11,0,35,24
1656123832274,COGS 107A,A01,083627,Boyle; Mary E. T.,5,4,60,55
1656123838301,COGS 118A,A01,083075,Gupta; Anjum,24,17,76,52
1656123844325,CSE 3,A50,083646,Miranda; Gregory Joseph,18,0,50,32
1656123850348,CSE 8A,A50,083650,Miranda; Gregory Joseph,13,13,56,43
1656123856372,CSE 11,A01,083080,Cao; Yingjun,1,59,40,39
1656123862401,CSE 12,A01,083652,Krause-Levy; Sophia Louisa,14,8,120,106
1656123868429,CSE 15L,A01,083654,Morris; Justin Loren,5,2,50,45
1656123868429,CSE 15L,A02,083655,Morris; Justin Loren,7,2,50,43
1656123874451,CSE 20,A01,083657,Tran; Khoa Dang,31,0,80,49
1656123880473,CSE 21,A01,095574,Bach; Quang Tran,25,0,48,23
1656123886498,CSE 30,A01,083084,Eldon; John,3,11,80,77
1656123886498,CSE 30,B01,095061,Bhaskar; Nishant,4,5,50,46
1656123892521,CSE 100,A01,083659,Cao; Yingjun,2,22,70,68
1656123898545,CSE 134B,A01,083661,Powell; Thomas Allan,11,8,100,89
1656123904567,CSE 140,A01,083663,Gungor; Onat,9,0,85,76
1656123910590,CSE 140L,A01,083088,Eldon; John,8,0,100,92
1656123916616,CSE 175,A01,083665,Kumar; Rakesh,0,0,25,25
1656123922639,CSE 190,A00,092507,Dubnov; Shlomo,2,0,20,18
1656123928663,ECE 45,A01,083139,Congero; Spencer William,5,4,75,70
1656123934685,ECE 65,A50,083695,Saad; Andrew S,8,0,30,22
1656123934685,ECE 65,A51,095125,Staff,23,0,26,3
1656123940710,ECE 109,A01,091882,Touri; Behrouz,7,7,70,63
1656123946734,ECE 180,A00,083140,Abi Samra; Nicholas Camill,1,0,30,29
1656123946734,ECE 180,B00,083141,Abi Samra; Nicholas Camill,4,8,30,26
1656123952763,MATH 10A,A01,083735,Patchell; Gregory David,0,0,30,30
1656123952763,MATH 10A,A02,083736,Patchell; Gregory David,22,0,30,8
1656123952763,MATH 10A,A03,083737,Patchell; Gregory David,16,0,30,14
1656123958786,MATH 10B,A01,083207,Lim; Seonhee,3,3,34,31
1656123958786,MATH 10B,A02,083208,Lim; Seonhee,10,3,35,25
1656123958786,MATH 10B,A03,093472,Staff,4,3,34,30
1656123958786,MATH 10B,B01,083739,Sinha; Shubham,11,0,30,19
1656123964818,MATH 18,A01,083743,Cinel; Cameron Alexander,7,0,30,23
1656123964818,MATH 18,A02,083744,Cinel; Cameron Alexander,10,0,30,20
1656123964818,MATH 18,A03,083745,Cinel; Cameron Alexander,3,0,30,27
1656123964818,MATH 18,B01,083748,Rideout; David Porter,0,0,36,36
1656123964818,MATH 18,B02,083749,Rideout; David Porter,0,0,36,36
1656123964818,MATH 18,B03,083750,Rideout; David Porter,0,0,36,36
1656123964818,MATH 18,B04,083751,Rideout; David Porter,0,0,36,36
1656123964818,MATH 18,B05,093473,Rideout; David Porter,2,0,36,34
1656123964818,MATH 18,B06,093474,Rideout; David Porter,4,0,36,32
1656123970851,MATH 20A,A01,083754,Zheng; Zequn,11,0,40,29
1656123976898,MATH 20B,A01,083756,Briones; Jor-el Thomas Caparas,0,0,36,36
1656123976898,MATH 20B,A02,083757,Briones; Jor-el Thomas Caparas,0,0,36,36
1656123976898,MATH 20B,A03,093475,Staff,2,0,36,34
1656123982922,MATH 20C,A01,083760,Briones; Jor-el Thomas Caparas,2,2,35,33
1656123982922,MATH 20C,A02,083761,Briones; Jor-el Thomas Caparas,9,1,35,26
1656123982922,MATH 20C,A03,093476,Staff,1,1,35,34
1656123982922,MATH 20C,B01,083762,Bach; Quang Tran,1,0,30,29
1656123988947,MATH 20D,A01,083765,Tran; Brian Kha,2,0,30,28
1656123988947,MATH 20D,A02,083766,Tran; Brian Kha,0,1,30,30
1656123988947,MATH 20D,A03,083767,Tran; Brian Kha,2,0,30,28
1656123994978,MATH 20E,A01,083771,Ganguly; Soumya,4,1,32,28
1656123994978,MATH 20E,A02,083772,Ganguly; Soumya,2,2,32,30
1656123994978,MATH 20E,B01,083773,Ciotti; Benjamin,14,0,35,21
1656123994978,MATH 20E,B02,083774,Ciotti; Benjamin,14,0,35,21
1656124001010,MATH 103A,A01,083777,Greenfeld; Be'Eri,2,0,36,34
1656124001010,MATH 103A,A02,083778,Greenfeld; Be'Eri,2,0,36,34
1656124001010,MATH 103A,A03,093561,Staff,4,1,36,32
1656124001010,MATH 103A,B01,083779,Greenfeld; Be'Eri,8,1,36,28
1656124001010,MATH 103A,B02,083780,Greenfeld; Be'Eri,0,0,36,36
1656124001010,MATH 103A,B03,093562,Staff,0,0,36,36
1656124007038,MATH 105,A01,085443,Carter; Anne Toulson,4,1,35,31
1656124007038,MATH 105,A02,093477,Staff,9,0,35,26
1656124013068,MATH 109,A01,083213,Ganzberger; Geoffrey Michael,1,1,34,33
1656124013068,MATH 109,A02,083214,Ganzberger; Geoffrey Michael,0,0,34,34
1656124013068,MATH 109,A03,093478,Staff,1,0,34,33
1656124013068,MATH 109,B01,083215,Ganzberger; Geoffrey Michael,3,0,32,29
1656124013068,MATH 109,B02,083216,Ganzberger; Geoffrey Michael,1,0,32,31
1656124013068,MATH 109,B03,093479,Staff,4,0,32,28
1656124019092,MATH 142A,A01,083219,Chow; Bennett,1,0,32,31
1656124019092,MATH 142A,A02,083220,Chow; Bennett,8,0,32,24
1656124019092,MATH 142A,A03,093480,Staff,5,0,32,27
1656124019092,MATH 142A,B03,093481,Staff,4,0,32,28
1656124019092,MATH 142A,B04,093558,Staff,5,0,32,27
1656124019092,MATH 142A,B05,093559,Staff,0,0,32,32
1656124025122,MATH 193A,A01,083224,Rotar; Vladimir,1,2,34,33
1656124025122,MATH 193A,A02,083225,Rotar; Vladimir,1,0,34,33
1656124025122,MATH 193A,A03,083781,Rotar; Vladimir,1,0,34,33
1656124025122,MATH 193A,A04,083782,Rotar; Vladimir,6,0,34,28
1656124025122,MATH 193A,A05,093482,Rotar; Vladimir,1,0,34,33
1656124031145,MATH 197,001,091859,McAuley; Julian John,9999,0,9999,0
1656124031145,MATH 197,002,095566,Kedlaya; Kiran S.,9997,0,9999,2
1656124031145,MATH 197,003,095567,Xiao; Ming,9999,0,9999,0
1656124031145,MATH 197,004,095571,Perols; Johan Lars,9998,0,9999,1
1656124038197,COGS 9,A01,083615,Shannon; Kyle Michael,5,1,75,70
1656124044224,COGS 11,A01,083617,Boyle; Mary E. T.,16,2,48,32
1656124050253,COGS 13,A01,083071,Bastos; Amalia Pinkusfeld,9,3,71,62
1656124056288,COGS 14A,A01,092681,Semenuks; Arturs,8,24,100,92
1656124062318,COGS 14B,A01,083073,Cheng; Tzu-Han,7,0,63,56
1656124068348,COGS 17,A01,092677,Semenuks; Arturs,13,6,81,68
1656124074375,COGS 100,A01,083619,Allen; Michael Gordon,7,5,70,63
1656124080413,COGS 101A,A01,083621,Davis; Joshua Daniel,7,3,68,61
1656124086436,COGS 101B,A01,091572,Allen; Michael Gordon,6,0,65,59
1656124092460,COGS 101C,A01,083625,Delgado; Tania,11,0,35,24
1656124098487,COGS 107A,A01,083627,Boyle; Mary E. T.,5,4,60,55
1656124104511,COGS 118A,A01,083075,Gupta; Anjum,24,17,76,52
1656124110545,CSE 3,A50,083646,Miranda; Gregory Joseph,18,0,50,32
1656124116572,CSE 8A,A50,083650,Miranda; Gregory Joseph,13,13,56,43
1656124122596,CSE 11,A01,083080,Cao; Yingjun,1,59,40,39
1656124128619,CSE 12,A01,083652,Krause-Levy; Sophia Louisa,14,8,120,106
1656124134649,CSE 15L,A01,083654,Morris; Justin Loren,5,2,50,45
1656124134649,CSE 15L,A02,083655,Morris; Justin Loren,7,2,50,43
1656124140673,CSE 20,A01,083657,Tran; Khoa Dang,31,0,80,49
1656124146701,CSE 21,A01,095574,Bach; Quang Tran,25,0,48,23
1656124152724,CSE 30,A01,083084,Eldon; John,3,11,80,77
1656124152724,CSE 30,B01,095061,Bhaskar; Nishant,4,5,50,46
1656124158747,CSE 100,A01,083659,Cao; Yingjun,2,22,70,68
1656124164771,CSE 134B,A01,083661,Powell; Thomas Allan,11,8,100,89
1656124170799,CSE 140,A01,083663,Gungor; Onat,9,0,85,76
1656124176823,CSE 140L,A01,083088,Eldon; John,8,0,100,92
1656124182846,CSE 175,A01,083665,Kumar; Rakesh,0,0,25,25
1656124188870,CSE 190,A00,092507,Dubnov; Shlomo,2,0,20,18
1656124194900,ECE 45,A01,083139,Congero; Spencer William,5,4,75,70
1656124200928,ECE 65,A50,083695,Saad; Andrew S,8,0,30,22
1656124200928,ECE 65,A51,095125,Staff,23,0,26,3
1656124206954,ECE 109,A01,091882,Touri; Behrouz,7,7,70,63
1656124212978,ECE 180,A00,083140,Abi Samra; Nicholas Camill,1,0,30,29
1656124212978,ECE 180,B00,083141,Abi Samra; Nicholas Camill,4,8,30,26
1656124219007,MATH 10A,A01,083735,Patchell; Gregory David,0,0,30,30
1656124219007,MATH 10A,A02,083736,Patchell; Gregory David,22,0,30,8
1656124219007,MATH 10A,A03,083737,Patchell; Gregory David,16,0,30,14
1656124225031,MATH 10B,A01,083207,Lim; Seonhee,3,3,34,31
1656124225031,MATH 10B,A02,083208,Lim; Seonhee,10,3,35,25
1656124225031,MATH 10B,A03,093472,Staff,4,3,34,30
1656124225031,MATH 10B,B01,083739,Sinha; Shubham,11,0,30,19
1656124231064,MATH 18,A01,083743,Cinel; Cameron Alexander,7,0,30,23
1656124231064,MATH 18,A02,083744,Cinel; Cameron Alexander,10,0,30,20
1656124231064,MATH 18,A03,083745,Cinel; Cameron Alexander,3,0,30,27
1656124231064,MATH 18,B01,083748,Rideout; David Porter,0,0,36,36
1656124231064,MATH 18,B02,083749,Rideout; David Porter,0,0,36,36
1656124231064,MATH 18,B03,083750,Rideout; David Porter,0,0,36,36
1656124231064,MATH 18,B04,083751,Rideout; David Porter,0,0,36,36
1656124231064,MATH 18,B05,093473,Rideout; David Porter,2,0,36,34
1656124231064,MATH 18,B06,093474,Rideout; David Porter,4,0,36,32
1656124237088,MATH 20A,A01,083754,Zheng; Zequn,11,0,40,29
1656124243116,MATH 20B,A01,083756,Briones; Jor-el Thomas Caparas,0,0,36,36
1656124243116,MATH 20B,A02,083757,Briones; Jor-el Thomas Caparas,0,0,36,36
1656124243116,MATH 20B,A03,093475,Staff,2,0,36,34
1656124249156,MATH 20C,A01,083760,Briones; Jor-el Thomas Caparas,2,2,35,33
1656124249156,MATH 20C,A02,083761,Briones; Jor-el Thomas Caparas,9,1,35,26
1656124249156,MATH 20C,A03,093476,Staff,1,1,35,34
1656124249156,MATH 20C,B01,083762,Bach; Quang Tran,1,0,30,29
1656124255180,MATH 20D,A01,083765,Tran; Brian Kha,2,0,30,28
1656124255180,MATH 20D,A02,083766,Tran; Brian Kha,0,1,30,30
1656124255180,MATH 20D,A03,083767,Tran; Brian Kha,2,0,30,28
1656124261210,MATH 20E,A01,083771,Ganguly; Soumya,4,1,32,28
1656124261210,MATH 20E,A02,083772,Ganguly; Soumya,2,2,32,30
1656124261210,MATH 20E,B01,083773,Ciotti; Benjamin,14,0,35,21
1656124261210,MATH 20E,B02,083774,Ciotti; Benjamin,14,0,35,21
1656124267260,MATH 103A,A01,083777,Greenfeld; Be'Eri,2,0,36,34
1656124267260,MATH 103A,A02,083778,Greenfeld; Be'Eri,2,0,36,34
1656124267260,MATH 103A,A03,093561,Staff,4,1,36,32
1656124267260,MATH 103A,B01,083779,Greenfeld; Be'Eri,8,1,36,28
1656124267260,MATH 103A,B02,083780,Greenfeld; Be'Eri,0,0,36,36
1656124267260,MATH 103A,B03,093562,Staff,0,0,36,36
1656124273288,MATH 105,A01,085443,Carter; Anne Toulson,4,1,35,31
1656124273288,MATH 105,A02,093477,Staff,9,0,35,26
1656124279311,MATH 109,A01,083213,Ganzberger; Geoffrey Michael,1,1,34,33
1656124279311,MATH 109,A02,083214,Ganzberger; Geoffrey Michael,0,0,34,34
1656124279311,MATH 109,A03,093478,Staff,1,0,34,33
1656124279311,MATH 109,B01,083215,Ganzberger; Geoffrey Michael,3,0,32,29
1656124279311,MATH 109,B02,083216,Ganzberger; Geoffrey Michael,1,0,32,31
1656124279311,MATH 109,B03,093479,Staff,4,0,32,28
1656124285413,MATH 142A,A01,083219,Chow; Bennett,1,0,32,31
1656124285413,MATH 142A,A02,083220,Chow; Bennett,8,0,32,24
1656124285413,MATH 142A,A03,093480,Staff,5,0,32,27
1656124285413,MATH 142A,B03,093481,Staff,4,0,32,28
1656124285413,MATH 142A,B04,093558,Staff,5,0,32,27
1656124285413,MATH 142A,B05,093559,Staff,0,0,32,32
1656124291439,MATH 193A,A01,083224,Rotar; Vladimir,1,2,34,33
1656124291439,MATH 193A,A02,083225,Rotar; Vladimir,1,0,34,33
1656124291439,MATH 193A,A03,083781,Rotar; Vladimir,1,0,34,33
1656124291439,MATH 193A,A04,083782,Rotar; Vladimir,6,0,34,28
1656124291439,MATH 193A,A05,093482,Rotar; Vladimir,1,0,34,33
1656124297464,MATH 197,001,091859,McAuley; Julian John,9999,0,9999,0
1656124297464,MATH 197,002,095566,Kedlaya; Kiran S.,9997,0,9999,2
1656124297464,MATH 197,003,095567,Xiao; Ming,9999,0,9999,0
1656124297464,MATH 197,004,095571,Perols; Johan Lars,9998,0,9999,1
1656124304517,COGS 9,A01,083615,Shannon; Kyle Michael,5,1,75,70
1656124310541,COGS 11,A01,083617,Boyle; Mary E. T.,16,2,48,32
1656124316572,COGS 13,A01,083071,Bastos; Amalia Pinkusfeld,9,3,71,62
1656124322600,COGS 14A,A01,092681,Semenuks; Arturs,8,24,100,92
1656124328627,COGS 14B,A01,083073,Cheng; Tzu-Han,7,0,63,56
1656124334652,COGS 17,A01,092677,Semenuks; Arturs,13,6,81,68
1656124340680,COGS 100,A01,083619,Allen; Michael Gordon,7,5,70,63
1656124346703,COGS 101A,A01,083621,Davis; Joshua Daniel,7,3,68,61
1656124352729,COGS 101B,A01,091572,Allen; Michael Gordon,6,0,65,59
1656124358756,COGS 101C,A01,083625,Delgado; Tania,11,0,35,24
1656124364778,COGS 107A,A01,083627,Boyle; Mary E. T.,5,4,60,55
1656124370802,COGS 118A,A01,083075,Gupta; Anjum,24,17,76,52
1656124376833,CSE 3,A50,083646,Miranda; Gregory Joseph,18,0,50,32
1656124382863,CSE 8A,A50,083650,Miranda; Gregory Joseph,13,13,56,43
1656124388888,CSE 11,A01,083080,Cao; Yingjun,1,59,40,39
1656124394915,CSE 12,A01,083652,Krause-Levy; Sophia Louisa,14,8,120,106
1656124400938,CSE 15L,A01,083654,Morris; Justin Loren,5,2,50,45
1656124400938,CSE 15L,A02,083655,Morris; Justin Loren,7,2,50,43
1656124406969,CSE 20,A01,083657,Tran; Khoa Dang,31,0,80,49
1656124412992,CSE 21,A01,095574,Bach; Quang Tran,25,0,48,23
1656124419020,CSE 30,A01,083084,Eldon; John,3,11,80,77
1656124419020,CSE 30,B01,095061,Bhaskar; Nishant,4,5,50,46
1656124425043,CSE 100,A01,083659,Cao; Yingjun,2,22,70,68
1656124431072,CSE 134B,A01,083661,Powell; Thomas Allan,11,8,100,89
1656124437097,CSE 140,A01,083663,Gungor; Onat,9,0,85,76
1656124443121,CSE 140L,A01,083088,Eldon; John,8,0,100,92
1656124449145,CSE 175,A01,083665,Kumar; Rakesh,0,0,25,25
1656124455172,CSE 190,A00,092507,Dubnov; Shlomo,2,0,20,18
1656124461199,ECE 45,A01,083139,Congero; Spencer William,5,4,75,70
1656124467227,ECE 65,A50,083695,Saad; Andrew S,8,0,30,22
1656124467227,ECE 65,A51,095125,Staff,23,0,26,3
1656124473253,ECE 109,A01,091882,Touri; Behrouz,7,7,70,63
1656124479281,ECE 180,A00,083140,Abi Samra; Nicholas Camill,1,0,30,29
1656124479281,ECE 180,B00,083141,Abi Samra; Nicholas Camill,4,8,30,26
1656124485304,MATH 10A,A01,083735,Patchell; Gregory David,0,0,30,30
1656124485304,MATH 10A,A02,083736,Patchell; Gregory David,22,0,30,8
1656124485304,MATH 10A,A03,083737,Patchell; Gregory David,16,0,30,14
1656124491326,MATH 10B,A01,083207,Lim; Seonhee,3,3,34,31
1656124491326,MATH 10B,A02,083208,Lim; Seonhee,10,3,35,25
1656124491326,MATH 10B,A03,093472,Staff,4,3,34,30
1656124491326,MATH 10B,B01,083739,Sinha; Shubham,11,0,30,19
1656124497360,MATH 18,A01,083743,Cinel; Cameron Alexander,7,0,30,23
1656124497360,MATH 18,A02,083744,Cinel; Cameron Alexander,10,0,30,20
1656124497360,MATH 18,A03,083745,Cinel; Cameron Alexander,3,0,30,27
1656124497360,MATH 18,B01,083748,Rideout; David Porter,0,0,36,36
1656124497360,MATH 18,B02,083749,Rideout; David Porter,0,0,36,36
1656124497360,MATH 18,B03,083750,Rideout; David Porter,0,0,36,36
1656124497360,MATH 18,B04,083751,Rideout; David Porter,0,0,36,36
1656124497360,MATH 18,B05,093473,Rideout; David Porter,2,0,36,34
1656124497360,MATH 18,B06,093474,Rideout; David Porter,4,0,36,32
1656124503383,MATH 20A,A01,083754,Zheng; Zequn,11,0,40,29
1656124509407,MATH 20B,A01,083756,Briones; Jor-el Thomas Caparas,0,0,36,36
1656124509407,MATH 20B,A02,083757,Briones; Jor-el Thomas Caparas,0,0,36,36
1656124509407,MATH 20B,A03,093475,Staff,2,0,36,34
1656124515434,MATH 20C,A01,083760,Briones; Jor-el Thomas Caparas,2,2,35,33
1656124515434,MATH 20C,A02,083761,Briones; Jor-el Thomas Caparas,9,1,35,26
1656124515434,MATH 20C,A03,093476,Staff,1,1,35,34
1656124515434,MATH 20C,B01,083762,Bach; Quang Tran,1,0,30,29
1656124521458,MATH 20D,A01,083765,Tran; Brian Kha,2,0,30,28
1656124521458,MATH 20D,A02,083766,Tran; Brian Kha,0,1,30,30
1656124521458,MATH 20D,A03,083767,Tran; Brian Kha,2,0,30,28
1656124527488,MATH 20E,A01,083771,Ganguly; Soumya,4,1,32,28
1656124527488,MATH 20E,A02,083772,Ganguly; Soumya,2,2,32,30
1656124527488,MATH 20E,B01,083773,Ciotti; Benjamin,14,0,35,21
1656124527488,MATH 20E,B02,083774,Ciotti; Benjamin,14,0,35,21
1656124533513,MATH 103A,A01,083777,Greenfeld; Be'Eri,2,0,36,34
1656124533513,MATH 103A,A02,083778,Greenfeld; Be'Eri,2,0,36,34
1656124533513,MATH 103A,A03,093561,Staff,4,1,36,32
1656124533513,MATH 103A,B01,083779,Greenfeld; Be'Eri,8,1,36,28
1656124533513,MATH 103A,B02,083780,Greenfeld; Be'Eri,0,0,36,36
1656124533513,MATH 103A,B03,093562,Staff,0,0,36,36
1656124539541,MATH 105,A01,085443,Carter; Anne Toulson,4,1,35,31
1656124539541,MATH 105,A02,093477,Staff,9,0,35,26
1656124545571,MATH 109,A01,083213,Ganzberger; Geoffrey Michael,1,1,34,33
1656124545571,MATH 109,A02,083214,Ganzberger; Geoffrey Michael,0,0,34,34
1656124545571,MATH 109,A03,093478,Staff,1,0,34,33
1656124545571,MATH 109,B01,083215,Ganzberger; Geoffrey Michael,3,0,32,29
1656124545571,MATH 109,B02,083216,Ganzberger; Geoffrey Michael,1,0,32,31
1656124545571,MATH 109,B03,093479,Staff,4,0,32,28
1656124551599,MATH 142A,A01,083219,Chow; Bennett,1,0,32,31
1656124551599,MATH 142A,A02,083220,Chow; Bennett,8,0,32,24
1656124551599,MATH 142A,A03,093480,Staff,5,0,32,27
1656124551599,MATH 142A,B03,093481,Staff,4,0,32,28
1656124551599,MATH 142A,B04,093558,Staff,5,0,32,27
1656124551599,MATH 142A,B05,093559,Staff,0,0,32,32
1656124557628,MATH 193A,A01,083224,Rotar; Vladimir,1,2,34,33
1656124557628,MATH 193A,A02,083225,Rotar; Vladimir,1,0,34,33
1656124557628,MATH 193A,A03,083781,Rotar; Vladimir,1,0,34,33
1656124557628,MATH 193A,A04,083782,Rotar; Vladimir,6,0,34,28
1656124557628,MATH 193A,A05,093482,Rotar; Vladimir,1,0,34,33
1656124563653,MATH 197,001,091859,McAuley; Julian John,9999,0,9999,0
1656124563653,MATH 197,002,095566,Kedlaya; Kiran S.,9997,0,9999,2
1656124563653,MATH 197,003,095567,Xiao; Ming,9999,0,9999,0
1656124563653,MATH 197,004,095571,Perols; Johan Lars,9998,0,9999,1
1656124570707,COGS 9,A01,083615,Shannon; Kyle Michael,5,1,75,70
1656124576732,COGS 11,A01,083617,Boyle; Mary E. T.,16,2,48,32
1656124582754,COGS 13,A01,083071,Bastos; Amalia Pinkusfeld,9,3,71,62
1656124588776,COGS 14A,A01,092681,Semenuks; Arturs,8,24,100,92
1656124594799,COGS 14B,A01,083073,Cheng; Tzu-Han,7,0,63,56
1656124600825,COGS 17,A01,092677,Semenuks; Arturs,13,6,81,68
1656124606851,COGS 100,A01,083619,Allen; Michael Gordon,7,5,70,63
1656124612875,COGS 101A,A01,083621,Davis; Joshua Daniel,7,3,68,61
1656124618898,COGS 101B,A01,091572,Allen; Michael Gordon,6,0,65,59
1656124624926,COGS 101C,A01,083625,Delgado; Tania,11,0,35,24
1656124630949,COGS 107A,A01,083627,Boyle; Mary E. T.,5,4,60,55
1656124636998,COGS 118A,A01,083075,Gupta; Anjum,24,17,76,52
1656124643022,CSE 3,A50,083646,Miranda; Gregory Joseph,18,0,50,32
1656124649045,CSE 8A,A50,083650,Miranda; Gregory Joseph,13,13,56,43
1656124655068,CSE 11,A01,083080,Cao; Yingjun,1,58,40,39
1656124661097,CSE 12,A01,083652,Krause-Levy; Sophia Louisa,14,8,120,106
1656124667121,CSE 15L,A01,083654,Morris; Justin Loren,5,2,50,45
1656124667121,CSE 15L,A02,083655,Morris; Justin Loren,7,2,50,43
1656124673163,CSE 20,A01,083657,Tran; Khoa Dang,31,0,80,49
1656124679186,CSE 21,A01,095574,Bach; Quang Tran,25,0,48,23
1656124685219,CSE 30,A01,083084,Eldon; John,3,11,80,77
1656124685219,CSE 30,B01,095061,Bhaskar; Nishant,4,5,50,46
1656124691246,CSE 100,A01,083659,Cao; Yingjun,2,22,70,68
1656124697273,CSE 134B,A01,083661,Powell; Thomas Allan,11,8,100,89
1656124703297,CSE 140,A01,083663,Gungor; Onat,9,0,85,76
1656124709325,CSE 140L,A01,083088,Eldon; John,8,0,100,92
1656124715359,CSE 175,A01,083665,Kumar; Rakesh,0,0,25,25
1656124721382,CSE 190,A00,092507,Dubnov; Shlomo,2,0,20,18
1656124727406,ECE 45,A01,083139,Congero; Spencer William,5,4,75,70
1656124733432,ECE 65,A50,083695,Saad; Andrew S,8,0,30,22
1656124733432,ECE 65,A51,095125,Staff,23,0,26,3
1656124739456,ECE 109,A01,091882,Touri; Behrouz,7,7,70,63
1656124745480,ECE 180,A00,083140,Abi Samra; Nicholas Camill,1,0,30,29
1656124745480,ECE 180,B00,083141,Abi Samra; Nicholas Camill,4,8,30,26
1656124751503,MATH 10A,A01,083735,Patchell; Gregory David,0,0,30,30
1656124751503,MATH 10A,A02,083736,Patchell; Gregory David,22,0,30,8
1656124751503,MATH 10A,A03,083737,Patchell; Gregory David,16,0,30,14
1656124757528,MATH 10B,A01,083207,Lim; Seonhee,3,3,34,31
1656124757528,MATH 10B,A02,083208,Lim; Seonhee,10,3,35,25
1656124757528,MATH 10B,A03,093472,Staff,4,3,34,30
1656124757528,MATH 10B,B01,083739,Sinha; Shubham,11,0,30,19
1656124763559,MATH 18,A01,083743,Cinel; Cameron Alexander,7,0,30,23
1656124763559,MATH 18,A02,083744,Cinel; Cameron Alexander,10,0,30,20
1656124763559,MATH 18,A03,083745,Cinel; Cameron Alexander,3,0,30,27
1656124763559,MATH 18,B01,083748,Rideout; David Porter,0,0,36,36
1656124763559,MATH 18,B02,083749,Rideout; David Porter,0,0,36,36
1656124763559,MATH 18,B03,083750,Rideout; David Porter,0,0,36,36
1656124763559,MATH 18,B04,083751,Rideout; David Porter,0,0,36,36
1656124763559,MATH 18,B05,093473,Rideout; David Porter,2,0,36,34
1656124763559,MATH 18,B06,093474,Rideout; David Porter,4,0,36,32
1656124769583,MATH 20A,A01,083754,Zheng; Zequn,11,0,40,29
1656124775606,MATH 20B,A01,083756,Briones; Jor-el Thomas Caparas,0,0,36,36
1656124775606,MATH 20B,A02,083757,Briones; Jor-el Thomas Caparas,0,0,36,36
1656124775606,MATH 20B,A03,093475,Staff,2,0,36,34
1656124781631,MATH 20C,A01,083760,Briones; Jor-el Thomas Caparas,2,2,35,33
1656124781631,MATH 20C,A02,083761,Briones; Jor-el Thomas Caparas,9,1,35,26
1656124781631,MATH 20C,A03,093476,Staff,1,1,35,34
1656124781631,MATH 20C,B01,083762,Bach; Quang Tran,1,0,30,29
1656124787653,MATH 20D,A01,083765,Tran; Brian Kha,2,0,30,28
1656124787653,MATH 20D,A02,083766,Tran; Brian Kha,0,1,30,30
1656124787653,MATH 20D,A03,083767,Tran; Brian Kha,2,0,30,28
1656124793677,MATH 20E,A01,083771,Ganguly; Soumya,4,1,32,28
1656124793677,MATH 20E,A02,083772,Ganguly; Soumya,2,2,32,30
1656124793677,MATH 20E,B01,083773,Ciotti; Benjamin,14,0,35,21
1656124793677,MATH 20E,B02,083774,Ciotti; Benjamin,14,0,35,21
1656124799701,MATH 103A,A01,083777,Greenfeld; Be'Eri,2,0,36,34
1656124799701,MATH 103A,A02,083778,Greenfeld; Be'Eri,2,0,36,34
1656124799701,MATH 103A,A03,093561,Staff,4,1,36,32
1656124799701,MATH 103A,B01,083779,Greenfeld; Be'Eri,8,1,36,28
1656124799701,MATH 103A,B02,083780,Greenfeld; Be'Eri,0,0,36,36
1656124799701,MATH 103A,B03,093562,Staff,0,0,36,36
1656124805727,MATH 105,A01,085443,Carter; Anne Toulson,4,1,35,31
1656124805727,MATH 105,A02,093477,Staff,9,0,35,26
1656124811749,MATH 109,A01,083213,Ganzberger; Geoffrey Michael,1,1,34,33
1656124811749,MATH 109,A02,083214,Ganzberger; Geoffrey Michael,0,0,34,34
1656124811749,MATH 109,A03,093478,Staff,1,0,34,33
1656124811749,MATH 109,B01,083215,Ganzberger; Geoffrey Michael,3,0,32,29
1656124811749,MATH 109,B02,083216,Ganzberger; Geoffrey Michael,1,0,32,31
1656124811749,MATH 109,B03,093479,Staff,4,0,32,28
1656124817774,MATH 142A,A01,083219,Chow; Bennett,1,0,32,31
1656124817774,MATH 142A,A02,083220,Chow; Bennett,8,0,32,24
1656124817774,MATH 142A,A03,093480,Staff,5,0,32,27
1656124817774,MATH 142A,B03,093481,Staff,4,0,32,28
1656124817774,MATH 142A,B04,093558,Staff,5,0,32,27
1656124817774,MATH 142A,B05,093559,Staff,0,0,32,32
1656124823797,MATH 193A,A01,083224,Rotar; Vladimir,1,2,34,33
1656124823797,MATH 193A,A02,083225,Rotar; Vladimir,1,0,34,33
1656124823797,MATH 193A,A03,083781,Rotar; Vladimir,1,0,34,33
1656124823797,MATH 193A,A04,083782,Rotar; Vladimir,6,0,34,28
1656124823797,MATH 193A,A05,093482,Rotar; Vladimir,1,0,34,33
1656124829824,MATH 197,001,091859,McAuley; Julian John,9999,0,9999,0
1656124829824,MATH 197,002,095566,Kedlaya; Kiran S.,9997,0,9999,2
1656124829824,MATH 197,003,095567,Xiao; Ming,9999,0,9999,0
1656124829824,MATH 197,004,095571,Perols; Johan Lars,9998,0,9999,1
1656124836909,COGS 9,A01,083615,Shannon; Kyle Michael,5,1,75,70
1656124842933,COGS 11,A01,083617,Boyle; Mary E. T.,16,2,48,32
1656124848967,COGS 13,A01,083071,Bastos; Amalia Pinkusfeld,9,3,71,62
1656124854997,COGS 14A,A01,092681,Semenuks; Arturs,8,24,100,92
1656124861023,COGS 14B,A01,083073,Cheng; Tzu-Han,7,0,63,56
1656124867045,COGS 17,A01,092677,Semenuks; Arturs,13,6,81,68
1656124873068,COGS 100,A01,083619,Allen; Michael Gordon,7,5,70,63
1656124879163,COGS 101A,A01,083621,Davis; Joshua Daniel,7,3,68,61
1656124885190,COGS 101B,A01,091572,Allen; Michael Gordon,6,0,65,59
1656124891218,COGS 101C,A01,083625,Delgado; Tania,10,0,35,25
1656124897242,COGS 107A,A01,083627,Boyle; Mary E. T.,5,4,60,55
1656124903263,COGS 118A,A01,083075,Gupta; Anjum,24,17,76,52
1656124909287,CSE 3,A50,083646,Miranda; Gregory Joseph,18,0,50,32
1656124915310,CSE 8A,A50,083650,Miranda; Gregory Joseph,13,13,56,43
1656124921338,CSE 11,A01,083080,Cao; Yingjun,1,58,40,39
1656124927366,CSE 12,A01,083652,Krause-Levy; Sophia Louisa,14,8,120,106
1656124933390,CSE 15L,A01,083654,Morris; Justin Loren,5,2,50,45
1656124933390,CSE 15L,A02,083655,Morris; Justin Loren,7,2,50,43
1656124939413,CSE 20,A01,083657,Tran; Khoa Dang,31,0,80,49
1656124945436,CSE 21,A01,095574,Bach; Quang Tran,25,0,48,23
1656124951463,CSE 30,A01,083084,Eldon; John,3,11,80,77
1656124951463,CSE 30,B01,095061,Bhaskar; Nishant,4,5,50,46
1656124957488,CSE 100,A01,083659,Cao; Yingjun,2,22,70,68
1656124963509,CSE 134B,A01,083661,Powell; Thomas Allan,11,8,100,89
1656124969536,CSE 140,A01,083663,Gungor; Onat,9,0,85,76
1656124975562,CSE 140L,A01,083088,Eldon; John,8,0,100,92
1656124981596,CSE 175,A01,083665,Kumar; Rakesh,0,0,25,25
1656124987618,CSE 190,A00,092507,Dubnov; Shlomo,2,0,20,18
1656124993642,ECE 45,A01,083139,Congero; Spencer William,5,4,75,70
1656124999670,ECE 65,A50,083695,Saad; Andrew S,8,0,30,22
1656124999670,ECE 65,A51,095125,Staff,23,0,26,3
1656125005694,ECE 109,A01,091882,Touri; Behrouz,7,7,70,63
1656125011717,ECE 180,A00,083140,Abi Samra; Nicholas Camill,1,0,30,29
1656125011717,ECE 180,B00,083141,Abi Samra; Nicholas Camill,4,8,30,26
1656125017742,MATH 10A,A01,083735,Patchell; Gregory David,0,0,30,30
1656125017742,MATH 10A,A02,083736,Patchell; Gregory David,22,0,30,8
1656125017742,MATH 10A,A03,083737,Patchell; Gregory David,16,0,30,14
1656125023768,MATH 10B,A01,083207,Lim; Seonhee,3,3,34,31
1656125023768,MATH 10B,A02,083208,Lim; Seonhee,10,3,35,25
1656125023768,MATH 10B,A03,093472,Staff,4,3,34,30
1656125023768,MATH 10B,B01,083739,Sinha; Shubham,11,0,30,19
1656125029799,MATH 18,A01,083743,Cinel; Cameron Alexander,7,0,30,23
1656125029799,MATH 18,A02,083744,Cinel; Cameron Alexander,10,0,30,20
1656125029799,MATH 18,A03,083745,Cinel; Cameron Alexander,3,0,30,27
1656125029799,MATH 18,B01,083748,Rideout; David Porter,0,0,36,36
1656125029799,MATH 18,B02,083749,Rideout; David Porter,0,0,36,36
1656125029799,MATH 18,B03,083750,Rideout; David Porter,0,0,36,36
1656125029799,MATH 18,B04,083751,Rideout; David Porter,0,0,36,36
1656125029799,MATH 18,B05,093473,Rideout; David Porter,2,0,36,34
1656125029799,MATH 18,B06,093474,Rideout; David Porter,4,0,36,32
1656125035825,MATH 20A,A01,083754,Zheng; Zequn,11,0,40,29
1656125041848,MATH 20B,A01,083756,Briones; Jor-el Thomas Caparas,0,0,36,36
1656125041848,MATH 20B,A02,083757,Briones; Jor-el Thomas Caparas,0,0,36,36
1656125041848,MATH 20B,A03,093475,Staff,2,0,36,34
1656125047877,MATH 20C,A01,083760,Briones; Jor-el Thomas Caparas,2,2,35,33
1656125047877,MATH 20C,A02,083761,Briones; Jor-el Thomas Caparas,9,1,35,26
1656125047877,MATH 20C,A03,093476,Staff,1,1,35,34
1656125047877,MATH 20C,B01,083762,Bach; Quang Tran,1,0,30,29
1656125053902,MATH 20D,A01,083765,Tran; Brian Kha,2,0,30,28
1656125053902,MATH 20D,A02,083766,Tran; Brian Kha,0,1,30,30
1656125053902,MATH 20D,A03,083767,Tran; Brian Kha,2,0,30,28
1656125059925,MATH 20E,A01,083771,Ganguly; Soumya,4,1,32,28
1656125059925,MATH 20E,A02,083772,Ganguly; Soumya,2,2,32,30
1656125059925,MATH 20E,B01,083773,Ciotti; Benjamin,14,0,35,21
1656125059925,MATH 20E,B02,083774,Ciotti; Benjamin,14,0,35,21
1656125065955,MATH 103A,A01,083777,Greenfeld; Be'Eri,2,0,36,34
1656125065955,MATH 103A,A02,083778,Greenfeld; Be'Eri,2,0,36,34
1656125065955,MATH 103A,A03,093561,Staff,4,1,36,32
1656125065955,MATH 103A,B01,083779,Greenfeld; Be'Eri,8,1,36,28
1656125065955,MATH 103A,B02,083780,Greenfeld; Be'Eri,0,0,36,36
1656125065955,MATH 103A,B03,093562,Staff,0,0,36,36
1656125071988,MATH 105,A01,085443,Carter; Anne Toulson,4,1,35,31
1656125071988,MATH 105,A02,093477,Staff,9,0,35,26
1656125078013,MATH 109,A01,083213,Ganzberger; Geoffrey Michael,1,1,34,33
1656125078013,MATH 109,A02,083214,Ganzberger; Geoffrey Michael,0,0,34,34
1656125078013,MATH 109,A03,093478,Staff,1,0,34,33
1656125078013,MATH 109,B01,083215,Ganzberger; Geoffrey Michael,3,0,32,29
1656125078013,MATH 109,B02,083216,Ganzberger; Geoffrey Michael,1,0,32,31
1656125078013,MATH 109,B03,093479,Staff,4,0,32,28
1656125084038,MATH 142A,A01,083219,Chow; Bennett,1,0,32,31
1656125084038,MATH 142A,A02,083220,Chow; Bennett,8,0,32,24
1656125084038,MATH 142A,A03,093480,Staff,5,0,32,27
1656125084038,MATH 142A,B03,093481,Staff,4,0,32,28
1656125084038,MATH 142A,B04,093558,Staff,5,0,32,27
1656125084038,MATH 142A,B05,093559,Staff,0,0,32,32
1656125090065,MATH 193A,A01,083224,Rotar; Vladimir,1,2,34,33
1656125090065,MATH 193A,A02,083225,Rotar; Vladimir,1,0,34,33
1656125090065,MATH 193A,A03,083781,Rotar; Vladimir,1,0,34,33
1656125090065,MATH 193A,A04,083782,Rotar; Vladimir,6,0,34,28
1656125090065,MATH 193A,A05,093482,Rotar; Vladimir,1,0,34,33
1656125096097,MATH 197,001,091859,McAuley; Julian John,9999,0,9999,0
1656125096097,MATH 197,002,095566,Kedlaya; Kiran S.,9997,0,9999,2
1656125096097,MATH 197,003,095567,Xiao; Ming,9999,0,9999,0
1656125096097,MATH 197,004,095571,Perols; Johan Lars,9998,0,9999,1
1656125103180,COGS 9,A01,083615,Shannon; Kyle Michael,5,1,75,70
1656125109203,COGS 11,A01,083617,Boyle; Mary E. T.,16,2,48,32
1656125115227,COGS 13,A01,083071,Bastos; Amalia Pinkusfeld,9,3,71,62
1656125121252,COGS 14A,A01,092681,Semenuks; Arturs,8,24,100,92
1656125127276,COGS 14B,A01,083073,Cheng; Tzu-Han,7,0,63,56
1656125133299,COGS 17,A01,092677,Semenuks; Arturs,13,6,81,68
1656125139328,COGS 100,A01,083619,Allen; Michael Gordon,7,5,70,63
1656125145351,COGS 101A,A01,083621,Davis; Joshua Daniel,7,3,68,61
1656125151373,COGS 101B,A01,091572,Allen; Michael Gordon,6,0,65,59
1656125157397,COGS 101C,A01,083625,Delgado; Tania,10,0,35,25
1656125163422,COGS 107A,A01,083627,Boyle; Mary E. T.,5,4,60,55
1656125169448,COGS 118A,A01,083075,Gupta; Anjum,24,17,76,52
1656125175471,CSE 3,A50,083646,Miranda; Gregory Joseph,18,0,50,32
1656125181494,CSE 8A,A50,083650,Miranda; Gregory Joseph,13,13,56,43
1656125187517,CSE 11,A01,083080,Cao; Yingjun,1,58,40,39
1656125193540,CSE 12,A01,083652,Krause-Levy; Sophia Louisa,14,8,120,106
1656125199567,CSE 15L,A01,083654,Morris; Justin Loren,5,2,50,45
1656125199567,CSE 15L,A02,083655,Morris; Justin Loren,7,2,50,43
1656125205590,CSE 20,A01,083657,Tran; Khoa Dang,31,0,80,49
1656125211616,CSE 21,A01,095574,Bach; Quang Tran,25,0,48,23
1656125217684,CSE 30,A01,083084,Eldon; John,3,11,80,77
1656125217684,CSE 30,B01,095061,Bhaskar; Nishant,4,5,50,46
1656125223707,CSE 100,A01,083659,Cao; Yingjun,2,22,70,68
1656125229731,CSE 134B,A01,083661,Powell; Thomas Allan,11,8,100,89
1656125235753,CSE 140,A01,083663,Gungor; Onat,9,0,85,76
1656125241778,CSE 140L,A01,083088,Eldon; John,8,0,100,92
1656125247802,CSE 175,A01,083665,Kumar; Rakesh,0,0,25,25
1656125253833,CSE 190,A00,092507,Dubnov; Shlomo,2,0,20,18
1656125259856,ECE 45,A01,083139,Congero; Spencer William,5,4,75,70
1656125265883,ECE 65,A50,083695,Saad; Andrew S,8,0,30,22
1656125265883,ECE 65,A51,095125,Staff,23,0,26,3
1656125271906,ECE 109,A01,091882,Touri; Behrouz,7,7,70,63
1656125277929,ECE 180,A00,083140,Abi Samra; Nicholas Camill,1,0,30,29
1656125277929,ECE 180,B00,083141,Abi Samra; Nicholas Camill,4,8,30,26
1656125283954,MATH 10A,A01,083735,Patchell; Gregory David,0,0,30,30
1656125283954,MATH 10A,A02,083736,Patchell; Gregory David,22,0,30,8
1656125283954,MATH 10A,A03,083737,Patchell; Gregory David,16,0,30,14
1656125289979,MATH 10B,A01,083207,Lim; Seonhee,3,3,34,31
1656125289979,MATH 10B,A02,083208,Lim; Seonhee,10,3,35,25
1656125289979,MATH 10B,A03,093472,Staff,4,3,34,30
1656125289979,MATH 10B,B01,083739,Sinha; Shubham,11,0,30,19
1656125296004,MATH 18,A01,083743,Cinel; Cameron Alexander,7,0,30,23
1656125296004,MATH 18,A02,083744,Cinel; Cameron Alexander,10,0,30,20
1656125296004,MATH 18,A03,083745,Cinel; Cameron Alexander,3,0,30,27
1656125296004,MATH 18,B01,083748,Rideout; David Porter,0,0,36,36
1656125296004,MATH 18,B02,083749,Rideout; David Porter,0,0,36,36
1656125296004,MATH 18,B03,083750,Rideout; David Porter,0,0,36,36
1656125296004,MATH 18,B04,083751,Rideout; David Porter,0,0,36,36
1656125296004,MATH 18,B05,093473,Rideout; David Porter,2,0,36,34
1656125296004,MATH 18,B06,093474,Rideout; David Porter,4,0,36,32
1656125302032,MATH 20A,A01,083754,Zheng; Zequn,11,0,40,29
1656125308056,MATH 20B,A01,083756,Briones; Jor-el Thomas Caparas,0,0,36,36
1656125308056,MATH 20B,A02,083757,Briones; Jor-el Thomas Caparas,0,0,36,36
1656125308056,MATH 20B,A03,093475,Staff,2,0,36,34
1656125314082,MATH 20C,A01,083760,Briones; Jor-el Thomas Caparas,2,2,35,33
1656125314082,MATH 20C,A02,083761,Briones; Jor-el Thomas Caparas,9,1,35,26
1656125314082,MATH 20C,A03,093476,Staff,1,1,35,34
1656125314082,MATH 20C,B01,083762,Bach; Quang Tran,1,0,30,29
1656125320106,MATH 20D,A01,083765,Tran; Brian Kha,2,0,30,28
1656125320106,MATH 20D,A02,083766,Tran; Brian Kha,0,1,30,30
1656125320106,MATH 20D,A03,083767,Tran; Brian Kha,2,0,30,28
1656125326134,MATH 20E,A01,083771,Ganguly; Soumya,4,1,32,28
1656125326134,MATH 20E,A02,083772,Ganguly; Soumya,2,2,32,30
1656125326134,MATH 20E,B01,083773,Ciotti; Benjamin,14,0,35,21
1656125326134,MATH 20E,B02,083774,Ciotti; Benjamin,14,0,35,21
1656125332158,MATH 103A,A01,083777,Greenfeld; Be'Eri,2,0,36,34
1656125332158,MATH 103A,A02,083778,Greenfeld; Be'Eri,2,0,36,34
1656125332158,MATH 103A,A03,093561,Staff,4,1,36,32
1656125332158,MATH 103A,B01,083779,Greenfeld; Be'Eri,8,1,36,28
1656125332158,MATH 103A,B02,083780,Greenfeld; Be'Eri,0,0,36,36
1656125332158,MATH 103A,B03,093562,Staff,0,0,36,36
1656125338182,MATH 105,A01,085443,Carter; Anne Toulson,4,1,35,31
1656125338182,MATH 105,A02,093477,Staff,9,0,35,26
1656125344207,MATH 109,A01,083213,Ganzberger; Geoffrey Michael,1,1,34,33
1656125344207,MATH 109,A02,083214,Ganzberger; Geoffrey Michael,0,0,34,34
1656125344207,MATH 109,A03,093478,Staff,1,0,34,33
1656125344207,MATH 109,B01,083215,Ganzberger; Geoffrey Michael,3,0,32,29
1656125344207,MATH 109,B02,083216,Ganzberger; Geoffrey Michael,1,0,32,31
1656125344207,MATH 109,B03,093479,Staff,4,0,32,28
1656125350233,MATH 142A,A01,083219,Chow; Bennett,1,0,32,31
1656125350233,MATH 142A,A02,083220,Chow; Bennett,8,0,32,24
1656125350233,MATH 142A,A03,093480,Staff,5,0,32,27
1656125350233,MATH 142A,B03,093481,Staff,4,0,32,28
1656125350233,MATH 142A,B04,093558,Staff,5,0,32,27
1656125350233,MATH 142A,B05,093559,Staff,0,0,32,32
1656125356261,MATH 193A,A01,083224,Rotar; Vladimir,1,2,34,33
1656125356261,MATH 193A,A02,083225,Rotar; Vladimir,1,0,34,33
1656125356261,MATH 193A,A03,083781,Rotar; Vladimir,1,0,34,33
1656125356261,MATH 193A,A04,083782,Rotar; Vladimir,6,0,34,28
1656125356261,MATH 193A,A05,093482,Rotar; Vladimir,1,0,34,33
1656125362291,MATH 197,001,091859,McAuley; Julian John,9999,0,9999,0
1656125362291,MATH 197,002,095566,Kedlaya; Kiran S.,9997,0,9999,2
1656125362291,MATH 197,003,095567,Xiao; Ming,9999,0,9999,0
1656125362291,MATH 197,004,095571,Perols; Johan Lars,9998,0,9999,1
1656125369358,COGS 9,A01,083615,Shannon; Kyle Michael,5,1,75,70
1656125375386,COGS 11,A01,083617,Boyle; Mary E. T.,16,2,48,32
1656125381411,COGS 13,A01,083071,Bastos; Amalia Pinkusfeld,9,3,71,62
1656125387437,COGS 14A,A01,092681,Semenuks; Arturs,8,24,100,92
1656125393465,COGS 14B,A01,083073,Cheng; Tzu-Han,7,0,63,56
1656125399493,COGS 17,A01,092677,Semenuks; Arturs,13,6,81,68
1656125405515,COGS 100,A01,083619,Allen; Michael Gordon,7,5,70,63
1656125411541,COGS 101A,A01,083621,Davis; Joshua Daniel,7,3,68,61
1656125417569,COGS 101B,A01,091572,Allen; Michael Gordon,6,0,65,59
1656125423593,COGS 101C,A01,083625,Delgado; Tania,10,0,35,25
1656125429617,COGS 107A,A01,083627,Boyle; Mary E. T.,5,4,60,55
1656125435641,COGS 118A,A01,083075,Gupta; Anjum,24,17,76,52
1656125441675,CSE 3,A50,083646,Miranda; Gregory Joseph,18,0,50,32
1656125447697,CSE 8A,A50,083650,Miranda; Gregory Joseph,13,13,56,43
1656125453718,CSE 11,A01,083080,Cao; Yingjun,1,58,40,39
1656125459745,CSE 12,A01,083652,Krause-Levy; Sophia Louisa,14,8,120,106
1656125465769,CSE 15L,A01,083654,Morris; Justin Loren,5,2,50,45
1656125465769,CSE 15L,A02,083655,Morris; Justin Loren,7,2,50,43
1656125471796,CSE 20,A01,083657,Tran; Khoa Dang,31,0,80,49
1656125477895,CSE 21,A01,095574,Bach; Quang Tran,25,0,48,23
1656125483926,CSE 30,A01,083084,Eldon; John,3,11,80,77
1656125483926,CSE 30,B01,095061,Bhaskar; Nishant,4,5,50,46
1656125489948,CSE 100,A01,083659,Cao; Yingjun,2,22,70,68
1656125495972,CSE 134B,A01,083661,Powell; Thomas Allan,11,8,100,89
1656125501995,CSE 140,A01,083663,Gungor; Onat,9,0,85,76
1656125508018,CSE 140L,A01,083088,Eldon; John,8,0,100,92
1656125514045,CSE 175,A01,083665,Kumar; Rakesh,0,0,25,25
1656125520073,CSE 190,A00,092507,Dubnov; Shlomo,2,0,20,18
1656125526095,ECE 45,A01,083139,Congero; Spencer William,5,4,75,70
1656125532120,ECE 65,A50,083695,Saad; Andrew S,8,0,30,22
1656125532120,ECE 65,A51,095125,Staff,23,0,26,3
1656125538145,ECE 109,A01,091882,Touri; Behrouz,7,7,70,63
1656125544169,ECE 180,A00,083140,Abi Samra; Nicholas Camill,1,0,30,29
1656125544169,ECE 180,B00,083141,Abi Samra; Nicholas Camill,4,8,30,26
1656125550196,MATH 10A,A01,083735,Patchell; Gregory David,0,0,30,30
1656125550196,MATH 10A,A02,083736,Patchell; Gregory David,22,0,30,8
1656125550196,MATH 10A,A03,083737,Patchell; Gregory David,16,0,30,14
1656125556224,MATH 10B,A01,083207,Lim; Seonhee,3,3,34,31
1656125556224,MATH 10B,A02,083208,Lim; Seonhee,10,3,35,25
1656125556224,MATH 10B,A03,093472,Staff,4,3,34,30
1656125556224,MATH 10B,B01,083739,Sinha; Shubham,11,0,30,19
1656125562247,MATH 18,A01,083743,Cinel; Cameron Alexander,7,0,30,23
1656125562247,MATH 18,A02,083744,Cinel; Cameron Alexander,10,0,30,20
1656125562247,MATH 18,A03,083745,Cinel; Cameron Alexander,3,0,30,27
1656125562247,MATH 18,B01,083748,Rideout; David Porter,0,0,36,36
1656125562247,MATH 18,B02,083749,Rideout; David Porter,0,0,36,36
1656125562247,MATH 18,B03,083750,Rideout; David Porter,0,0,36,36
1656125562247,MATH 18,B04,083751,Rideout; David Porter,0,0,36,36
1656125562247,MATH 18,B05,093473,Rideout; David Porter,2,0,36,34
1656125562247,MATH 18,B06,093474,Rideout; David Porter,4,0,36,32
1656125568270,MATH 20A,A01,083754,Zheng; Zequn,11,0,40,29
1656125574294,MATH 20B,A01,083756,Briones; Jor-el Thomas Caparas,0,0,36,36
1656125574294,MATH 20B,A02,083757,Briones; Jor-el Thomas Caparas,0,0,36,36
1656125574294,MATH 20B,A03,093475,Staff,2,0,36,34
1656125580321,MATH 20C,A01,083760,Briones; Jor-el Thomas Caparas,2,2,35,33
1656125580321,MATH 20C,A02,083761,Briones; Jor-el Thomas Caparas,9,1,35,26
1656125580321,MATH 20C,A03,093476,Staff,1,1,35,34
1656125580321,MATH 20C,B01,083762,Bach; Quang Tran,1,0,30,29
1656125586347,MATH 20D,A01,083765,Tran; Brian Kha,2,0,30,28
1656125586347,MATH 20D,A02,083766,Tran; Brian Kha,0,1,30,30
1656125586347,MATH 20D,A03,083767,Tran; Brian Kha,2,0,30,28
1656125592372,MATH 20E,A01,083771,Ganguly; Soumya,4,1,32,28
1656125592372,MATH 20E,A02,083772,Ganguly; Soumya,2,2,32,30
1656125592372,MATH 20E,B01,083773,Ciotti; Benjamin,14,0,35,21
1656125592372,MATH 20E,B02,083774,Ciotti; Benjamin,14,0,35,21
1656125598394,MATH 103A,A01,083777,Greenfeld; Be'Eri,2,0,36,34
1656125598394,MATH 103A,A02,083778,Greenfeld; Be'Eri,2,0,36,34
1656125598394,MATH 103A,A03,093561,Staff,4,1,36,32
1656125598394,MATH 103A,B01,083779,Greenfeld; Be'Eri,8,1,36,28
1656125598394,MATH 103A,B02,083780,Greenfeld; Be'Eri,0,0,36,36
1656125598394,MATH 103A,B03,093562,Staff,0,0,36,36
1656125604437,MATH 105,A01,085443,Carter; Anne Toulson,4,1,35,31
1656125604437,MATH 105,A02,093477,Staff,9,0,35,26
1656125610462,MATH 109,A01,083213,Ganzberger; Geoffrey Michael,1,1,34,33
1656125610462,MATH 109,A02,083214,Ganzberger; Geoffrey Michael,0,0,34,34
1656125610462,MATH 109,A03,093478,Staff,1,0,34,33
1656125610462,MATH 109,B01,083215,Ganzberger; Geoffrey Michael,3,0,32,29
1656125610462,MATH 109,B02,083216,Ganzberger; Geoffrey Michael,1,0,32,31
1656125610462,MATH 109,B03,093479,Staff,4,0,32,28
1656125616486,MATH 142A,A01,083219,Chow; Bennett,1,0,32,31
1656125616486,MATH 142A,A02,083220,Chow; Bennett,8,0,32,24
1656125616486,MATH 142A,A03,093480,Staff,5,0,32,27
1656125616486,MATH 142A,B03,093481,Staff,4,0,32,28
1656125616486,MATH 142A,B04,093558,Staff,5,0,32,27
1656125616486,MATH 142A,B05,093559,Staff,0,0,32,32
1656125622523,MATH 193A,A01,083224,Rotar; Vladimir,1,2,34,33
1656125622523,MATH 193A,A02,083225,Rotar; Vladimir,1,0,34,33
1656125622523,MATH 193A,A03,083781,Rotar; Vladimir,1,0,34,33
1656125622523,MATH 193A,A04,083782,Rotar; Vladimir,6,0,34,28
1656125622523,MATH 193A,A05,093482,Rotar; Vladimir,1,0,34,33
1656125628555,MATH 197,001,091859,McAuley; Julian John,9999,0,9999,0
1656125628555,MATH 197,002,095566,Kedlaya; Kiran S.,9997,0,9999,2
1656125628555,MATH 197,003,095567,Xiao; Ming,9999,0,9999,0
1656125628555,MATH 197,004,095571,Perols; Johan Lars,9998,0,9999,1
1656125635621,COGS 9,A01,083615,Shannon; Kyle Michael,5,1,75,70
1656125641650,COGS 11,A01,083617,Boyle; Mary E. T.,16,2,48,32
1656125647678,COGS 13,A01,083071,Bastos; Amalia Pinkusfeld,9,3,71,62
1656125653701,COGS 14A,A01,092681,Semenuks; Arturs,8,24,100,92
1656125659745,COGS 14B,A01,083073,Cheng; Tzu-Han,7,0,63,56
1656125665777,COGS 17,A01,092677,Semenuks; Arturs,13,6,81,68
1656125671803,COGS 100,A01,083619,Allen; Michael Gordon,7,5,70,63
1656125677826,COGS 101A,A01,083621,Davis; Joshua Daniel,7,3,68,61
1656125683857,COGS 101B,A01,091572,Allen; Michael Gordon,6,0,65,59
1656125689887,COGS 101C,A01,083625,Delgado; Tania,10,0,35,25
1656125695928,COGS 107A,A01,083627,Boyle; Mary E. T.,5,4,60,55
1656125701957,COGS 118A,A01,083075,Gupta; Anjum,24,17,76,52
1656125707980,CSE 3,A50,083646,Miranda; Gregory Joseph,18,0,50,32
1656125714004,CSE 8A,A50,083650,Miranda; Gregory Joseph,13,13,56,43
1656125720031,CSE 11,A01,083080,Cao; Yingjun,1,58,40,39
1656125726059,CSE 12,A01,083652,Krause-Levy; Sophia Louisa,14,8,120,106
1656125732087,CSE 15L,A01,083654,Morris; Justin Loren,5,2,50,45
1656125732087,CSE 15L,A02,083655,Morris; Justin Loren,7,2,50,43
1656125738111,CSE 20,A01,083657,Tran; Khoa Dang,31,0,80,49
1656125744137,CSE 21,A01,095574,Bach; Quang Tran,25,0,48,23
1656125750169,CSE 30,A01,083084,Eldon; John,3,11,80,77
1656125750169,CSE 30,B01,095061,Bhaskar; Nishant,4,5,50,46
1656125756200,CSE 100,A01,083659,Cao; Yingjun,2,22,70,68
1656125762224,CSE 134B,A01,083661,Powell; Thomas Allan,11,8,100,89
1656125768249,CSE 140,A01,083663,Gungor; Onat,9,0,85,76
1656125774272,CSE 140L,A01,083088,Eldon; John,8,0,100,92
1656125780295,CSE 175,A01,083665,Kumar; Rakesh,0,0,25,25
1656125786321,CSE 190,A00,092507,Dubnov; Shlomo,2,0,20,18
1656125792347,ECE 45,A01,083139,Congero; Spencer William,5,4,75,70
1656125798371,ECE 65,A50,083695,Saad; Andrew S,8,0,30,22
1656125798371,ECE 65,A51,095125,Staff,23,0,26,3
1656125804395,ECE 109,A01,091882,Touri; Behrouz,7,7,70,63
1656125810422,ECE 180,A00,083140,Abi Samra; Nicholas Camill,1,0,30,29
1656125810422,ECE 180,B00,083141,Abi Samra; Nicholas Camill,4,8,30,26
1656125816447,MATH 10A,A01,083735,Patchell; Gregory David,0,0,30,30
1656125816447,MATH 10A,A02,083736,Patchell; Gregory David,22,0,30,8
1656125816447,MATH 10A,A03,083737,Patchell; Gregory David,16,0,30,14
1656125822472,MATH 10B,A01,083207,Lim; Seonhee,3,3,34,31
1656125822472,MATH 10B,A02,083208,Lim; Seonhee,10,3,35,25
1656125822472,MATH 10B,A03,093472,Staff,4,3,34,30
1656125822472,MATH 10B,B01,083739,Sinha; Shubham,11,0,30,19
1656125828495,MATH 18,A01,083743,Cinel; Cameron Alexander,7,0,30,23
1656125828495,MATH 18,A02,083744,Cinel; Cameron Alexander,10,0,30,20
1656125828495,MATH 18,A03,083745,Cinel; Cameron Alexander,3,0,30,27
1656125828495,MATH 18,B01,083748,Rideout; David Porter,0,0,36,36
1656125828495,MATH 18,B02,083749,Rideout; David Porter,0,0,36,36
1656125828495,MATH 18,B03,083750,Rideout; David Porter,0,0,36,36
1656125828495,MATH 18,B04,083751,Rideout; David Porter,0,0,36,36
1656125828495,MATH 18,B05,093473,Rideout; David Porter,2,0,36,34
1656125828495,MATH 18,B06,093474,Rideout; David Porter,4,0,36,32
1656125834518,MATH 20A,A01,083754,Zheng; Zequn,11,0,40,29
1656125840542,MATH 20B,A01,083756,Briones; Jor-el Thomas Caparas,0,0,36,36
1656125840542,MATH 20B,A02,083757,Briones; Jor-el Thomas Caparas,0,0,36,36
1656125840542,MATH 20B,A03,093475,Staff,2,0,36,34
1656125846565,MATH 20C,A01,083760,Briones; Jor-el Thomas Caparas,2,2,35,33
1656125846565,MATH 20C,A02,083761,Briones; Jor-el Thomas Caparas,9,1,35,26
1656125846565,MATH 20C,A03,093476,Staff,1,1,35,34
1656125846565,MATH 20C,B01,083762,Bach; Quang Tran,1,0,30,29
1656125852589,MATH 20D,A01,083765,Tran; Brian Kha,2,0,30,28
1656125852589,MATH 20D,A02,083766,Tran; Brian Kha,0,1,30,30
1656125852589,MATH 20D,A03,083767,Tran; Brian Kha,2,0,30,28
1656125858613,MATH 20E,A01,083771,Ganguly; Soumya,4,1,32,28
1656125858613,MATH 20E,A02,083772,Ganguly; Soumya,2,2,32,30
1656125858613,MATH 20E,B01,083773,Ciotti; Benjamin,14,0,35,21
1656125858613,MATH 20E,B02,083774,Ciotti; Benjamin,14,0,35,21
1656125864637,MATH 103A,A01,083777,Greenfeld; Be'Eri,2,0,36,34
1656125864637,MATH 103A,A02,083778,Greenfeld; Be'Eri,2,0,36,34
1656125864637,MATH 103A,A03,093561,Staff,4,1,36,32
1656125864637,MATH 103A,B01,083779,Greenfeld; Be'Eri,8,1,36,28
1656125864637,MATH 103A,B02,083780,Greenfeld; Be'Eri,0,0,36,36
1656125864637,MATH 103A,B03,093562,Staff,0,0,36,36
1656125870661,MATH 105,A01,085443,Carter; Anne Toulson,4,1,35,31
1656125870661,MATH 105,A02,093477,Staff,9,0,35,26
1656125876685,MATH 109,A01,083213,Ganzberger; Geoffrey Michael,1,1,34,33
1656125876685,MATH 109,A02,083214,Ganzberger; Geoffrey Michael,0,0,34,34
1656125876685,MATH 109,A03,093478,Staff,1,0,34,33
1656125876685,MATH 109,B01,083215,Ganzberger; Geoffrey Michael,3,0,32,29
1656125876685,MATH 109,B02,083216,Ganzberger; Geoffrey Michael,1,0,32,31
1656125876685,MATH 109,B03,093479,Staff,4,0,32,28
1656125882710,MATH 142A,A01,083219,Chow; Bennett,1,0,32,31
1656125882710,MATH 142A,A02,083220,Chow; Bennett,8,0,32,24
1656125882710,MATH 142A,A03,093480,Staff,5,0,32,27
1656125882710,MATH 142A,B03,093481,Staff,4,0,32,28
1656125882710,MATH 142A,B04,093558,Staff,5,0,32,27
1656125882710,MATH 142A,B05,093559,Staff,0,0,32,32
1656125888733,MATH 193A,A01,083224,Rotar; Vladimir,1,2,34,33
1656125888733,MATH 193A,A02,083225,Rotar; Vladimir,1,0,34,33
1656125888733,MATH 193A,A03,083781,Rotar; Vladimir,1,0,34,33
1656125888733,MATH 193A,A04,083782,Rotar; Vladimir,6,0,34,28
1656125888733,MATH 193A,A05,093482,Rotar; Vladimir,1,0,34,33
1656125894756,MATH 197,001,091859,McAuley; Julian John,9999,0,9999,0
1656125894756,MATH 197,002,095566,Kedlaya; Kiran S.,9997,0,9999,2
1656125894756,MATH 197,003,095567,Xiao; Ming,9999,0,9999,0
1656125894756,MATH 197,004,095571,Perols; Johan Lars,9998,0,9999,1
1656125901810,COGS 9,A01,083615,Shannon; Kyle Michael,5,1,75,70
1656125907837,COGS 11,A01,083617,Boyle; Mary E. T.,16,2,48,32
1656125913866,COGS 13,A01,083071,Bastos; Amalia Pinkusfeld,9,3,71,62
1656125919889,COGS 14A,A01,092681,Semenuks; Arturs,8,24,100,92
1656125925913,COGS 14B,A01,083073,Cheng; Tzu-Han,7,0,63,56
1656125931947,COGS 17,A01,092677,Semenuks; Arturs,13,6,81,68
1656125937978,COGS 100,A01,083619,Allen; Michael Gordon,7,5,70,63
1656125944004,COGS 101A,A01,083621,Davis; Joshua Daniel,7,3,68,61
1656125950047,COGS 101B,A01,091572,Allen; Michael Gordon,6,0,65,59
1656125956071,COGS 101C,A01,083625,Delgado; Tania,10,0,35,25
1656125962094,COGS 107A,A01,083627,Boyle; Mary E. T.,5,4,60,55
1656125968125,COGS 118A,A01,083075,Gupta; Anjum,24,17,76,52
1656125974152,CSE 3,A50,083646,Miranda; Gregory Joseph,18,0,50,32
1656125980177,CSE 8A,A50,083650,Miranda; Gregory Joseph,13,13,56,43
1656125986199,CSE 11,A01,083080,Cao; Yingjun,1,58,40,39
1656125992220,CSE 12,A01,083652,Krause-Levy; Sophia Louisa,14,8,120,106
1656125998248,CSE 15L,A01,083654,Morris; Justin Loren,5,2,50,45
1656125998248,CSE 15L,A02,083655,Morris; Justin Loren,7,2,50,43
1656126004272,CSE 20,A01,083657,Tran; Khoa Dang,31,0,80,49
1656126010300,CSE 21,A01,095574,Bach; Quang Tran,25,0,48,23
1656126016322,CSE 30,A01,083084,Eldon; John,3,11,80,77
1656126016322,CSE 30,B01,095061,Bhaskar; Nishant,4,5,50,46
1656126022348,CSE 100,A01,083659,Cao; Yingjun,2,22,70,68
1656126028381,CSE 134B,A01,083661,Powell; Thomas Allan,11,8,100,89
1656126034407,CSE 140,A01,083663,Gungor; Onat,9,0,85,76
1656126040432,CSE 140L,A01,083088,Eldon; John,8,0,100,92
1656126046458,CSE 175,A01,083665,Kumar; Rakesh,0,0,25,25
1656126052494,CSE 190,A00,092507,Dubnov; Shlomo,2,0,20,18
1656126058516,ECE 45,A01,083139,Congero; Spencer William,5,4,75,70
1656126064542,ECE 65,A50,083695,Saad; Andrew S,8,0,30,22
1656126064542,ECE 65,A51,095125,Staff,23,0,26,3
1656126070565,ECE 109,A01,091882,Touri; Behrouz,7,7,70,63
1656126076661,ECE 180,A00,083140,Abi Samra; Nicholas Camill,1,0,30,29
1656126076661,ECE 180,B00,083141,Abi Samra; Nicholas Camill,4,8,30,26
1656126082686,MATH 10A,A01,083735,Patchell; Gregory David,0,0,30,30
1656126082686,MATH 10A,A02,083736,Patchell; Gregory David,22,0,30,8
1656126082686,MATH 10A,A03,083737,Patchell; Gregory David,16,0,30,14
1656126088710,MATH 10B,A01,083207,Lim; Seonhee,3,3,34,31
1656126088710,MATH 10B,A02,083208,Lim; Seonhee,10,3,35,25
1656126088710,MATH 10B,A03,093472,Staff,4,3,34,30
1656126088710,MATH 10B,B01,083739,Sinha; Shubham,11,0,30,19
1656126094742,MATH 18,A01,083743,Cinel; Cameron Alexander,7,0,30,23
1656126094742,MATH 18,A02,083744,Cinel; Cameron Alexander,10,0,30,20
1656126094742,MATH 18,A03,083745,Cinel; Cameron Alexander,3,0,30,27
1656126094742,MATH 18,B01,083748,Rideout; David Porter,0,0,36,36
1656126094742,MATH 18,B02,083749,Rideout; David Porter,0,0,36,36
1656126094742,MATH 18,B03,083750,Rideout; David Porter,0,0,36,36
1656126094742,MATH 18,B04,083751,Rideout; David Porter,0,0,36,36
1656126094742,MATH 18,B05,093473,Rideout; David Porter,2,0,36,34
1656126094742,MATH 18,B06,093474,Rideout; David Porter,4,0,36,32
1656126100769,MATH 20A,A01,083754,Zheng; Zequn,11,0,40,29
1656126106793,MATH 20B,A01,083756,Briones; Jor-el Thomas Caparas,0,0,36,36
1656126106793,MATH 20B,A02,083757,Briones; Jor-el Thomas Caparas,0,0,36,36
1656126106793,MATH 20B,A03,093475,Staff,2,0,36,34
1656126112821,MATH 20C,A01,083760,Briones; Jor-el Thomas Caparas,2,2,35,33
1656126112821,MATH 20C,A02,083761,Briones; Jor-el Thomas Caparas,9,1,35,26
1656126112821,MATH 20C,A03,093476,Staff,1,1,35,34
1656126112821,MATH 20C,B01,083762,Bach; Quang Tran,1,0,30,29
1656126118850,MATH 20D,A01,083765,Tran; Brian Kha,2,0,30,28
1656126118850,MATH 20D,A02,083766,Tran; Brian Kha,0,1,30,30
1656126118850,MATH 20D,A03,083767,Tran; Brian Kha,2,0,30,28
1656126124885,MATH 20E,A01,083771,Ganguly; Soumya,4,1,32,28
1656126124885,MATH 20E,A02,083772,Ganguly; Soumya,2,2,32,30
1656126124885,MATH 20E,B01,083773,Ciotti; Benjamin,14,0,35,21
1656126124885,MATH 20E,B02,083774,Ciotti; Benjamin,14,0,35,21
1656126130914,MATH 103A,A01,083777,Greenfeld; Be'Eri,2,0,36,34
1656126130914,MATH 103A,A02,083778,Greenfeld; Be'Eri,2,0,36,34
1656126130914,MATH 103A,A03,093561,Staff,4,1,36,32
1656126130914,MATH 103A,B01,083779,Greenfeld; Be'Eri,8,1,36,28
1656126130914,MATH 103A,B02,083780,Greenfeld; Be'Eri,0,0,36,36
1656126130914,MATH 103A,B03,093562,Staff,0,0,36,36
1656126136938,MATH 105,A01,085443,Carter; Anne Toulson,4,1,35,31
1656126136938,MATH 105,A02,093477,Staff,9,0,35,26
1656126142961,MATH 109,A01,083213,Ganzberger; Geoffrey Michael,1,1,34,33
1656126142961,MATH 109,A02,083214,Ganzberger; Geoffrey Michael,0,0,34,34
1656126142961,MATH 109,A03,093478,Staff,1,0,34,33
1656126142961,MATH 109,B01,083215,Ganzberger; Geoffrey Michael,3,0,32,29
1656126142961,MATH 109,B02,083216,Ganzberger; Geoffrey Michael,1,0,32,31
1656126142961,MATH 109,B03,093479,Staff,4,0,32,28
1656126148987,MATH 142A,A01,083219,Chow; Bennett,1,0,32,31
1656126148987,MATH 142A,A02,083220,Chow; Bennett,8,0,32,24
1656126148987,MATH 142A,A03,093480,Staff,5,0,32,27
1656126148987,MATH 142A,B03,093481,Staff,4,0,32,28
1656126148987,MATH 142A,B04,093558,Staff,5,0,32,27
1656126148987,MATH 142A,B05,093559,Staff,0,0,32,32
1656126155014,MATH 193A,A01,083224,Rotar; Vladimir,1,2,34,33
1656126155014,MATH 193A,A02,083225,Rotar; Vladimir,1,0,34,33
1656126155014,MATH 193A,A03,083781,Rotar; Vladimir,1,0,34,33
1656126155014,MATH 193A,A04,083782,Rotar; Vladimir,6,0,34,28
1656126155014,MATH 193A,A05,093482,Rotar; Vladimir,1,0,34,33
1656126161042,MATH 197,001,091859,McAuley; Julian John,9999,0,9999,0
1656126161042,MATH 197,002,095566,Kedlaya; Kiran S.,9997,0,9999,2
1656126161042,MATH 197,003,095567,Xiao; Ming,9999,0,9999,0
1656126161042,MATH 197,004,095571,Perols; Johan Lars,9998,0,9999,1
1656126168096,COGS 9,A01,083615,Shannon; Kyle Michael,5,1,75,70
1656126174120,COGS 11,A01,083617,Boyle; Mary E. T.,16,2,48,32
1656126180147,COGS 13,A01,083071,Bastos; Amalia Pinkusfeld,9,3,71,62
1656126186174,COGS 14A,A01,092681,Semenuks; Arturs,8,24,100,92
1656126192201,COGS 14B,A01,083073,Cheng; Tzu-Han,7,0,63,56
1656126198225,COGS 17,A01,092677,Semenuks; Arturs,13,6,81,68
1656126204254,COGS 100,A01,083619,Allen; Michael Gordon,7,5,70,63
1656126210277,COGS 101A,A01,083621,Davis; Joshua Daniel,7,3,68,61
1656126216300,COGS 101B,A01,091572,Allen; Michael Gordon,6,0,65,59
1656126222323,COGS 101C,A01,083625,Delgado; Tania,10,0,35,25
1656126228348,COGS 107A,A01,083627,Boyle; Mary E. T.,5,4,60,55
1656126234376,COGS 118A,A01,083075,Gupta; Anjum,24,17,76,52
1656126240400,CSE 3,A50,083646,Miranda; Gregory Joseph,18,0,50,32
1656126246432,CSE 8A,A50,083650,Miranda; Gregory Joseph,13,13,56,43
1656126252454,CSE 11,A01,083080,Cao; Yingjun,1,58,40,39
1656126258486,CSE 12,A01,083652,Krause-Levy; Sophia Louisa,14,8,120,106
1656126264514,CSE 15L,A01,083654,Morris; Justin Loren,5,2,50,45
1656126264514,CSE 15L,A02,083655,Morris; Justin Loren,7,2,50,43
1656126270537,CSE 20,A01,083657,Tran; Khoa Dang,31,0,80,49
1656126276561,CSE 21,A01,095574,Bach; Quang Tran,25,0,48,23
1656126282599,CSE 30,A01,083084,Eldon; John,3,11,80,77
1656126282599,CSE 30,B01,095061,Bhaskar; Nishant,4,5,50,46
1656126288622,CSE 100,A01,083659,Cao; Yingjun,2,22,70,68
1656126294650,CSE 134B,A01,083661,Powell; Thomas Allan,11,8,100,89
1656126300681,CSE 140,A01,083663,Gungor; Onat,9,0,85,76
1656126306713,CSE 140L,A01,083088,Eldon; John,8,0,100,92
1656126312736,CSE 175,A01,083665,Kumar; Rakesh,0,0,25,25
1656126318760,CSE 190,A00,092507,Dubnov; Shlomo,2,0,20,18
1656126324784,ECE 45,A01,083139,Congero; Spencer William,5,4,75,70
1656126330809,ECE 65,A50,083695,Saad; Andrew S,8,0,30,22
1656126330809,ECE 65,A51,095125,Staff,23,0,26,3
1656126336832,ECE 109,A01,091882,Touri; Behrouz,7,7,70,63
1656126342963,ECE 180,A00,083140,Abi Samra; Nicholas Camill,1,0,30,29
1656126342963,ECE 180,B00,083141,Abi Samra; Nicholas Camill,4,8,30,26
1656126348993,MATH 10A,A01,083735,Patchell; Gregory David,0,0,30,30
1656126348993,MATH 10A,A02,083736,Patchell; Gregory David,22,0,30,8
1656126348993,MATH 10A,A03,083737,Patchell; Gregory David,16,0,30,14
1656126355023,MATH 10B,A01,083207,Lim; Seonhee,3,3,34,31
1656126355023,MATH 10B,A02,083208,Lim; Seonhee,10,3,35,25
1656126355023,MATH 10B,A03,093472,Staff,4,3,34,30
1656126355023,MATH 10B,B01,083739,Sinha; Shubham,11,0,30,19
1656126361048,MATH 18,A01,083743,Cinel; Cameron Alexander,7,0,30,23
1656126361048,MATH 18,A02,083744,Cinel; Cameron Alexander,10,0,30,20
1656126361048,MATH 18,A03,083745,Cinel; Cameron Alexander,3,0,30,27
1656126361048,MATH 18,B01,083748,Rideout; David Porter,0,0,36,36
1656126361048,MATH 18,B02,083749,Rideout; David Porter,0,0,36,36
1656126361048,MATH 18,B03,083750,Rideout; David Porter,0,0,36,36
1656126361048,MATH 18,B04,083751,Rideout; David Porter,0,0,36,36
1656126361048,MATH 18,B05,093473,Rideout; David Porter,2,0,36,34
1656126361048,MATH 18,B06,093474,Rideout; David Porter,4,0,36,32
1656126367087,MATH 20A,A01,083754,Zheng; Zequn,11,0,40,29
1656126373110,MATH 20B,A01,083756,Briones; Jor-el Thomas Caparas,0,0,36,36
1656126373110,MATH 20B,A02,083757,Briones; Jor-el Thomas Caparas,0,0,36,36
1656126373110,MATH 20B,A03,093475,Staff,2,0,36,34
1656126379132,MATH 20C,A01,083760,Briones; Jor-el Thomas Caparas,2,2,35,33
1656126379132,MATH 20C,A02,083761,Briones; Jor-el Thomas Caparas,9,1,35,26
1656126379132,MATH 20C,A03,093476,Staff,1,1,35,34
1656126379132,MATH 20C,B01,083762,Bach; Quang Tran,1,0,30,29
1656126385158,MATH 20D,A01,083765,Tran; Brian Kha,2,0,30,28
1656126385158,MATH 20D,A02,083766,Tran; Brian Kha,0,1,30,30
1656126385158,MATH 20D,A03,083767,Tran; Brian Kha,2,0,30,28
1656126391183,MATH 20E,A01,083771,Ganguly; Soumya,4,1,32,28
1656126391183,MATH 20E,A02,083772,Ganguly; Soumya,2,2,32,30
1656126391183,MATH 20E,B01,083773,Ciotti; Benjamin,14,0,35,21
1656126391183,MATH 20E,B02,083774,Ciotti; Benjamin,14,0,35,21
1656126397208,MATH 103A,A01,083777,Greenfeld; Be'Eri,2,0,36,34
1656126397208,MATH 103A,A02,083778,Greenfeld; Be'Eri,2,0,36,34
1656126397208,MATH 103A,A03,093561,Staff,4,1,36,32
1656126397208,MATH 103A,B01,083779,Greenfeld; Be'Eri,8,1,36,28
1656126397208,MATH 103A,B02,083780,Greenfeld; Be'Eri,0,0,36,36
1656126397208,MATH 103A,B03,093562,Staff,0,0,36,36
1656126403232,MATH 105,A01,085443,Carter; Anne Toulson,4,1,35,31
1656126403232,MATH 105,A02,093477,Staff,9,0,35,26
1656126409255,MATH 109,A01,083213,Ganzberger; Geoffrey Michael,1,1,34,33
1656126409255,MATH 109,A02,083214,Ganzberger; Geoffrey Michael,0,0,34,34
1656126409255,MATH 109,A03,093478,Staff,1,0,34,33
1656126409255,MATH 109,B01,083215,Ganzberger; Geoffrey Michael,3,0,32,29
1656126409255,MATH 109,B02,083216,Ganzberger; Geoffrey Michael,1,0,32,31
1656126409255,MATH 109,B03,093479,Staff,4,0,32,28
1656126415285,MATH 142A,A01,083219,Chow; Bennett,1,0,32,31
1656126415285,MATH 142A,A02,083220,Chow; Bennett,8,0,32,24
1656126415285,MATH 142A,A03,093480,Staff,5,0,32,27
1656126415285,MATH 142A,B03,093481,Staff,4,0,32,28
1656126415285,MATH 142A,B04,093558,Staff,5,0,32,27
1656126415285,MATH 142A,B05,093559,Staff,0,0,32,32
1656126421309,MATH 193A,A01,083224,Rotar; Vladimir,1,2,34,33
1656126421309,MATH 193A,A02,083225,Rotar; Vladimir,1,0,34,33
1656126421309,MATH 193A,A03,083781,Rotar; Vladimir,1,0,34,33
1656126421309,MATH 193A,A04,083782,Rotar; Vladimir,6,0,34,28
1656126421309,MATH 193A,A05,093482,Rotar; Vladimir,1,0,34,33
1656126427330,MATH 197,001,091859,McAuley; Julian John,9999,0,9999,0
1656126427330,MATH 197,002,095566,Kedlaya; Kiran S.,9997,0,9999,2
1656126427330,MATH 197,003,095567,Xiao; Ming,9999,0,9999,0
1656126427330,MATH 197,004,095571,Perols; Johan Lars,9998,0,9999,1
1656126434391,COGS 9,A01,083615,Shannon; Kyle Michael,5,1,75,70
1656126440415,COGS 11,A01,083617,Boyle; Mary E. T.,16,2,48,32
1656126446440,COGS 13,A01,083071,Bastos; Amalia Pinkusfeld,9,3,71,62
1656126452462,COGS 14A,A01,092681,Semenuks; Arturs,8,24,100,92
1656126458485,COGS 14B,A01,083073,Cheng; Tzu-Han,7,0,63,56
1656126464509,COGS 17,A01,092677,Semenuks; Arturs,13,6,81,68
1656126470535,COGS 100,A01,083619,Allen; Michael Gordon,7,5,70,63
1656126476559,COGS 101A,A01,083621,Davis; Joshua Daniel,7,3,68,61
1656126482582,COGS 101B,A01,091572,Allen; Michael Gordon,6,0,65,59
1656126488608,COGS 101C,A01,083625,Delgado; Tania,10,0,35,25
1656126494635,COGS 107A,A01,083627,Boyle; Mary E. T.,5,4,60,55
1656126500658,COGS 118A,A01,083075,Gupta; Anjum,24,17,76,52
1656126506686,CSE 3,A50,083646,Miranda; Gregory Joseph,18,0,50,32
1656126512719,CSE 8A,A50,083650,Miranda; Gregory Joseph,13,13,56,43
1656126518744,CSE 11,A01,083080,Cao; Yingjun,1,58,40,39
1656126524771,CSE 12,A01,083652,Krause-Levy; Sophia Louisa,14,8,120,106
1656126530795,CSE 15L,A01,083654,Morris; Justin Loren,5,2,50,45
1656126530795,CSE 15L,A02,083655,Morris; Justin Loren,7,2,50,43
1656126536827,CSE 20,A01,083657,Tran; Khoa Dang,31,0,80,49
1656126542850,CSE 21,A01,095574,Bach; Quang Tran,25,0,48,23
1656126548873,CSE 30,A01,083084,Eldon; John,3,11,80,77
1656126548873,CSE 30,B01,095061,Bhaskar; Nishant,4,5,50,46
1656126554900,CSE 100,A01,083659,Cao; Yingjun,2,22,70,68
1656126560925,CSE 134B,A01,083661,Powell; Thomas Allan,11,8,100,89
1656126566951,CSE 140,A01,083663,Gungor; Onat,9,0,85,76
1656126572980,CSE 140L,A01,083088,Eldon; John,8,0,100,92
1656126579006,CSE 175,A01,083665,Kumar; Rakesh,0,0,25,25
1656126585032,CSE 190,A00,092507,Dubnov; Shlomo,2,0,20,18
1656126591056,ECE 45,A01,083139,Congero; Spencer William,5,4,75,70
1656126597085,ECE 65,A50,083695,Saad; Andrew S,8,0,30,22
1656126597085,ECE 65,A51,095125,Staff,23,0,26,3
1656126603116,ECE 109,A01,091882,Touri; Behrouz,7,7,70,63
1656126609140,ECE 180,A00,083140,Abi Samra; Nicholas Camill,1,0,30,29
1656126609140,ECE 180,B00,083141,Abi Samra; Nicholas Camill,4,8,30,26
1656126615164,MATH 10A,A01,083735,Patchell; Gregory David,0,0,30,30
1656126615164,MATH 10A,A02,083736,Patchell; Gregory David,22,0,30,8
1656126615164,MATH 10A,A03,083737,Patchell; Gregory David,16,0,30,14
1656126621188,MATH 10B,A01,083207,Lim; Seonhee,3,3,34,31
1656126621188,MATH 10B,A02,083208,Lim; Seonhee,10,3,35,25
1656126621188,MATH 10B,A03,093472,Staff,4,3,34,30
1656126621188,MATH 10B,B01,083739,Sinha; Shubham,11,0,30,19
1656126627213,MATH 18,A01,083743,Cinel; Cameron Alexander,7,0,30,23
1656126627213,MATH 18,A02,083744,Cinel; Cameron Alexander,10,0,30,20
1656126627213,MATH 18,A03,083745,Cinel; Cameron Alexander,3,0,30,27
1656126627213,MATH 18,B01,083748,Rideout; David Porter,0,0,36,36
1656126627213,MATH 18,B02,083749,Rideout; David Porter,0,0,36,36
1656126627213,MATH 18,B03,083750,Rideout; David Porter,0,0,36,36
1656126627213,MATH 18,B04,083751,Rideout; David Porter,0,0,36,36
1656126627213,MATH 18,B05,093473,Rideout; David Porter,2,0,36,34
1656126627213,MATH 18,B06,093474,Rideout; David Porter,4,0,36,32
1656126633237,MATH 20A,A01,083754,Zheng; Zequn,11,0,40,29
1656126639264,MATH 20B,A01,083756,Briones; Jor-el Thomas Caparas,0,0,36,36
1656126639264,MATH 20B,A02,083757,Briones; Jor-el Thomas Caparas,0,0,36,36
1656126639264,MATH 20B,A03,093475,Staff,2,0,36,34
1656126645298,MATH 20C,A01,083760,Briones; Jor-el Thomas Caparas,2,2,35,33
1656126645298,MATH 20C,A02,083761,Briones; Jor-el Thomas Caparas,9,1,35,26
1656126645298,MATH 20C,A03,093476,Staff,1,1,35,34
1656126645298,MATH 20C,B01,083762,Bach; Quang Tran,1,0,30,29
1656126651323,MATH 20D,A01,083765,Tran; Brian Kha,2,0,30,28
1656126651323,MATH 20D,A02,083766,Tran; Brian Kha,0,1,30,30
1656126651323,MATH 20D,A03,083767,Tran; Brian Kha,2,0,30,28
1656126657352,MATH 20E,A01,083771,Ganguly; Soumya,4,1,32,28
1656126657352,MATH 20E,A02,083772,Ganguly; Soumya,2,2,32,30
1656126657352,MATH 20E,B01,083773,Ciotti; Benjamin,14,0,35,21
1656126657352,MATH 20E,B02,083774,Ciotti; Benjamin,14,0,35,21
1656126663386,MATH 103A,A01,083777,Greenfeld; Be'Eri,2,0,36,34
1656126663386,MATH 103A,A02,083778,Greenfeld; Be'Eri,2,0,36,34
1656126663386,MATH 103A,A03,093561,Staff,4,1,36,32
1656126663386,MATH 103A,B01,083779,Greenfeld; Be'Eri,8,1,36,28
1656126663386,MATH 103A,B02,083780,Greenfeld; Be'Eri,0,0,36,36
1656126663386,MATH 103A,B03,093562,Staff,0,0,36,36
1656126669415,MATH 105,A01,085443,Carter; Anne Toulson,4,1,35,31
1656126669415,MATH 105,A02,093477,Staff,9,0,35,26
1656126675527,MATH 109,A01,083213,Ganzberger; Geoffrey Michael,1,1,34,33
1656126675527,MATH 109,A02,083214,Ganzberger; Geoffrey Michael,0,0,34,34
1656126675527,MATH 109,A03,093478,Staff,1,0,34,33
1656126675527,MATH 109,B01,083215,Ganzberger; Geoffrey Michael,3,0,32,29
1656126675527,MATH 109,B02,083216,Ganzberger; Geoffrey Michael,1,0,32,31
1656126675527,MATH 109,B03,093479,Staff,4,0,32,28
1656126681558,MATH 142A,A01,083219,Chow; Bennett,1,0,32,31
1656126681558,MATH 142A,A02,083220,Chow; Bennett,8,0,32,24
1656126681558,MATH 142A,A03,093480,Staff,5,0,32,27
1656126681558,MATH 142A,B03,093481,Staff,4,0,32,28
1656126681558,MATH 142A,B04,093558,Staff,5,0,32,27
1656126681558,MATH 142A,B05,093559,Staff,0,0,32,32
1656126687586,MATH 193A,A01,083224,Rotar; Vladimir,1,2,34,33
1656126687586,MATH 193A,A02,083225,Rotar; Vladimir,1,0,34,33
1656126687586,MATH 193A,A03,083781,Rotar; Vladimir,1,0,34,33
1656126687586,MATH 193A,A04,083782,Rotar; Vladimir,6,0,34,28
1656126687586,MATH 193A,A05,093482,Rotar; Vladimir,1,0,34,33
1656126693609,MATH 197,001,091859,McAuley; Julian John,9999,0,9999,0
1656126693609,MATH 197,002,095566,Kedlaya; Kiran S.,9997,0,9999,2
1656126693609,MATH 197,003,095567,Xiao; Ming,9999,0,9999,0
1656126693609,MATH 197,004,095571,Perols; Johan Lars,9998,0,9999,1
1656126700666,COGS 9,A01,083615,Shannon; Kyle Michael,5,1,75,70
1656126706689,COGS 11,A01,083617,Boyle; Mary E. T.,16,2,48,32
1656126712713,COGS 13,A01,083071,Bastos; Amalia Pinkusfeld,9,3,71,62
1656126718736,COGS 14A,A01,092681,Semenuks; Arturs,8,24,100,92
1656126724764,COGS 14B,A01,083073,Cheng; Tzu-Han,7,0,63,56
1656126730788,COGS 17,A01,092677,Semenuks; Arturs,13,6,81,68
1656126736815,COGS 100,A01,083619,Allen; Michael Gordon,7,5,70,63
1656126742838,COGS 101A,A01,083621,Davis; Joshua Daniel,7,3,68,61
1656126748861,COGS 101B,A01,091572,Allen; Michael Gordon,6,0,65,59
1656126754896,COGS 101C,A01,083625,Delgado; Tania,10,0,35,25
1656126760919,COGS 107A,A01,083627,Boyle; Mary E. T.,5,4,60,55
1656126766954,COGS 118A,A01,083075,Gupta; Anjum,24,17,76,52
1656126772978,CSE 3,A50,083646,Miranda; Gregory Joseph,18,0,50,32
1656126779000,CSE 8A,A50,083650,Miranda; Gregory Joseph,13,13,56,43
1656126785026,CSE 11,A01,083080,Cao; Yingjun,1,58,40,39
1656126791053,CSE 12,A01,083652,Krause-Levy; Sophia Louisa,14,8,120,106
1656126797079,CSE 15L,A01,083654,Morris; Justin Loren,5,2,50,45
1656126797079,CSE 15L,A02,083655,Morris; Justin Loren,7,2,50,43
1656126803107,CSE 20,A01,083657,Tran; Khoa Dang,31,0,80,49
1656126809130,CSE 21,A01,095574,Bach; Quang Tran,25,0,48,23
1656126815159,CSE 30,A01,083084,Eldon; John,3,11,80,77
1656126815159,CSE 30,B01,095061,Bhaskar; Nishant,4,5,50,46
1656126821182,CSE 100,A01,083659,Cao; Yingjun,2,22,70,68
1656126827207,CSE 134B,A01,083661,Powell; Thomas Allan,11,8,100,89
1656126833233,CSE 140,A01,083663,Gungor; Onat,9,0,85,76
1656126839257,CSE 140L,A01,083088,Eldon; John,8,0,100,92
1656126845284,CSE 175,A01,083665,Kumar; Rakesh,0,0,25,25
1656126851315,CSE 190,A00,092507,Dubnov; Shlomo,2,0,20,18
1656126857338,ECE 45,A01,083139,Congero; Spencer William,5,4,75,70
1656126863365,ECE 65,A50,083695,Saad; Andrew S,8,0,30,22
1656126863365,ECE 65,A51,095125,Staff,23,0,26,3
1656126869390,ECE 109,A01,091882,Touri; Behrouz,7,7,70,63
1656126875413,ECE 180,A00,083140,Abi Samra; Nicholas Camill,1,0,30,29
1656126875413,ECE 180,B00,083141,Abi Samra; Nicholas Camill,4,8,30,26
1656126881440,MATH 10A,A01,083735,Patchell; Gregory David,0,0,30,30
1656126881440,MATH 10A,A02,083736,Patchell; Gregory David,22,0,30,8
1656126881440,MATH 10A,A03,083737,Patchell; Gregory David,16,0,30,14
1656126887469,MATH 10B,A01,083207,Lim; Seonhee,3,3,34,31
1656126887469,MATH 10B,A02,083208,Lim; Seonhee,10,3,35,25
1656126887469,MATH 10B,A03,093472,Staff,4,3,34,30
1656126887469,MATH 10B,B01,083739,Sinha; Shubham,11,0,30,19
1656126893495,MATH 18,A01,083743,Cinel; Cameron Alexander,7,0,30,23
1656126893495,MATH 18,A02,083744,Cinel; Cameron Alexander,10,0,30,20
1656126893495,MATH 18,A03,083745,Cinel; Cameron Alexander,3,0,30,27
1656126893495,MATH 18,B01,083748,Rideout; David Porter,0,0,36,36
1656126893495,MATH 18,B02,083749,Rideout; David Porter,0,0,36,36
1656126893495,MATH 18,B03,083750,Rideout; David Porter,0,0,36,36
1656126893495,MATH 18,B04,083751,Rideout; David Porter,0,0,36,36
1656126893495,MATH 18,B05,093473,Rideout; David Porter,2,0,36,34
1656126893495,MATH 18,B06,093474,Rideout; David Porter,4,0,36,32
1656126899523,MATH 20A,A01,083754,Zheng; Zequn,11,0,40,29
1656126905546,MATH 20B,A01,083756,Briones; Jor-el Thomas Caparas,0,0,36,36
1656126905546,MATH 20B,A02,083757,Briones; Jor-el Thomas Caparas,0,0,36,36
1656126905546,MATH 20B,A03,093475,Staff,2,0,36,34
1656126911570,MATH 20C,A01,083760,Briones; Jor-el Thomas Caparas,2,2,35,33
1656126911570,MATH 20C,A02,083761,Briones; Jor-el Thomas Caparas,9,1,35,26
1656126911570,MATH 20C,A03,093476,Staff,1,1,35,34
1656126911570,MATH 20C,B01,083762,Bach; Quang Tran,1,0,30,29
1656126917594,MATH 20D,A01,083765,Tran; Brian Kha,2,0,30,28
1656126917594,MATH 20D,A02,083766,Tran; Brian Kha,0,1,30,30
1656126917594,MATH 20D,A03,083767,Tran; Brian Kha,2,0,30,28
1656126923619,MATH 20E,A01,083771,Ganguly; Soumya,4,1,32,28
1656126923619,MATH 20E,A02,083772,Ganguly; Soumya,2,2,32,30
1656126923619,MATH 20E,B01,083773,Ciotti; Benjamin,14,0,35,21
1656126923619,MATH 20E,B02,083774,Ciotti; Benjamin,14,0,35,21
1656126929644,MATH 103A,A01,083777,Greenfeld; Be'Eri,2,0,36,34
1656126929644,MATH 103A,A02,083778,Greenfeld; Be'Eri,2,0,36,34
1656126929644,MATH 103A,A03,093561,Staff,4,1,36,32
1656126929644,MATH 103A,B01,083779,Greenfeld; Be'Eri,8,1,36,28
1656126929644,MATH 103A,B02,083780,Greenfeld; Be'Eri,0,0,36,36
1656126929644,MATH 103A,B03,093562,Staff,0,0,36,36
1656126935671,MATH 105,A01,085443,Carter; Anne Toulson,4,1,35,31
1656126935671,MATH 105,A02,093477,Staff,9,0,35,26
1656126941700,MATH 109,A01,083213,Ganzberger; Geoffrey Michael,1,1,34,33
1656126941700,MATH 109,A02,083214,Ganzberger; Geoffrey Michael,0,0,34,34
1656126941700,MATH 109,A03,093478,Staff,1,0,34,33
1656126941700,MATH 109,B01,083215,Ganzberger; Geoffrey Michael,3,0,32,29
1656126941700,MATH 109,B02,083216,Ganzberger; Geoffrey Michael,1,0,32,31
1656126941700,MATH 109,B03,093479,Staff,4,0,32,28
1656126947730,MATH 142A,A01,083219,Chow; Bennett,1,0,32,31
1656126947730,MATH 142A,A02,083220,Chow; Bennett,8,0,32,24
1656126947730,MATH 142A,A03,093480,Staff,5,0,32,27
1656126947730,MATH 142A,B03,093481,Staff,4,0,32,28
1656126947730,MATH 142A,B04,093558,Staff,5,0,32,27
1656126947730,MATH 142A,B05,093559,Staff,0,0,32,32
1656126953766,MATH 193A,A01,083224,Rotar; Vladimir,1,2,34,33
1656126953766,MATH 193A,A02,083225,Rotar; Vladimir,1,0,34,33
1656126953766,MATH 193A,A03,083781,Rotar; Vladimir,1,0,34,33
1656126953766,MATH 193A,A04,083782,Rotar; Vladimir,6,0,34,28
1656126953766,MATH 193A,A05,093482,Rotar; Vladimir,1,0,34,33
1656126959796,MATH 197,001,091859,McAuley; Julian John,9999,0,9999,0
1656126959796,MATH 197,002,095566,Kedlaya; Kiran S.,9997,0,9999,2
1656126959796,MATH 197,003,095567,Xiao; Ming,9999,0,9999,0
1656126959796,MATH 197,004,095571,Perols; Johan Lars,9998,0,9999,1
1656126966860,COGS 9,A01,083615,Shannon; Kyle Michael,5,1,75,70
1656126972887,COGS 11,A01,083617,Boyle; Mary E. T.,16,2,48,32
1656126978915,COGS 13,A01,083071,Bastos; Amalia Pinkusfeld,9,3,71,62
1656126984941,COGS 14A,A01,092681,Semenuks; Arturs,8,23,100,92
1656126990963,COGS 14B,A01,083073,Cheng; Tzu-Han,7,0,63,56
1656126996987,COGS 17,A01,092677,Semenuks; Arturs,13,6,81,68
1656127003018,COGS 100,A01,083619,Allen; Michael Gordon,7,5,70,63
1656127009042,COGS 101A,A01,083621,Davis; Joshua Daniel,7,3,68,61
1656127015068,COGS 101B,A01,091572,Allen; Michael Gordon,6,0,65,59
1656127021094,COGS 101C,A01,083625,Delgado; Tania,10,0,35,25
1656127027122,COGS 107A,A01,083627,Boyle; Mary E. T.,5,4,60,55
1656127033146,COGS 118A,A01,083075,Gupta; Anjum,24,17,76,52
1656127039170,CSE 3,A50,083646,Miranda; Gregory Joseph,18,0,50,32
1656127045194,CSE 8A,A50,083650,Miranda; Gregory Joseph,13,13,56,43
1656127051233,CSE 11,A01,083080,Cao; Yingjun,1,58,40,39
1656127057261,CSE 12,A01,083652,Krause-Levy; Sophia Louisa,14,8,120,106
1656127063285,CSE 15L,A01,083654,Morris; Justin Loren,5,2,50,45
1656127063285,CSE 15L,A02,083655,Morris; Justin Loren,7,2,50,43
1656127069313,CSE 20,A01,083657,Tran; Khoa Dang,31,0,80,49
1656127075335,CSE 21,A01,095574,Bach; Quang Tran,25,0,48,23
1656127081358,CSE 30,A01,083084,Eldon; John,3,11,80,77
1656127081358,CSE 30,B01,095061,Bhaskar; Nishant,4,5,50,46
1656127087380,CSE 100,A01,083659,Cao; Yingjun,2,22,70,68
1656127093405,CSE 134B,A01,083661,Powell; Thomas Allan,11,8,100,89
1656127099429,CSE 140,A01,083663,Gungor; Onat,9,0,85,76
1656127105455,CSE 140L,A01,083088,Eldon; John,8,0,100,92
1656127111477,CSE 175,A01,083665,Kumar; Rakesh,0,0,25,25
1656127117502,CSE 190,A00,092507,Dubnov; Shlomo,2,0,20,18
1656127123524,ECE 45,A01,083139,Congero; Spencer William,5,4,75,70
1656127129548,ECE 65,A50,083695,Saad; Andrew S,8,0,30,22
1656127129548,ECE 65,A51,095125,Staff,23,0,26,3
1656127135575,ECE 109,A01,091882,Touri; Behrouz,7,7,70,63
1656127141599,ECE 180,A00,083140,Abi Samra; Nicholas Camill,1,0,30,29
1656127141599,ECE 180,B00,083141,Abi Samra; Nicholas Camill,4,8,30,26
1656127147621,MATH 10A,A01,083735,Patchell; Gregory David,0,0,30,30
1656127147621,MATH 10A,A02,083736,Patchell; Gregory David,22,0,30,8
1656127147621,MATH 10A,A03,083737,Patchell; Gregory David,16,0,30,14
1656127153652,MATH 10B,A01,083207,Lim; Seonhee,3,3,34,31
1656127153652,MATH 10B,A02,083208,Lim; Seonhee,10,3,35,25
1656127153652,MATH 10B,A03,093472,Staff,4,3,34,30
1656127153652,MATH 10B,B01,083739,Sinha; Shubham,11,0,30,19
1656127159676,MATH 18,A01,083743,Cinel; Cameron Alexander,7,0,30,23
1656127159676,MATH 18,A02,083744,Cinel; Cameron Alexander,10,0,30,20
1656127159676,MATH 18,A03,083745,Cinel; Cameron Alexander,3,0,30,27
1656127159676,MATH 18,B01,083748,Rideout; David Porter,0,0,36,36
1656127159676,MATH 18,B02,083749,Rideout; David Porter,0,0,36,36
1656127159676,MATH 18,B03,083750,Rideout; David Porter,0,0,36,36
1656127159676,MATH 18,B04,083751,Rideout; David Porter,0,0,36,36
1656127159676,MATH 18,B05,093473,Rideout; David Porter,2,0,36,34
1656127159676,MATH 18,B06,093474,Rideout; David Porter,4,0,36,32
1656127165706,MATH 20A,A01,083754,Zheng; Zequn,11,0,40,29
1656127171729,MATH 20B,A01,083756,Briones; Jor-el Thomas Caparas,0,0,36,36
1656127171729,MATH 20B,A02,083757,Briones; Jor-el Thomas Caparas,0,0,36,36
1656127171729,MATH 20B,A03,093475,Staff,2,0,36,34
1656127177753,MATH 20C,A01,083760,Briones; Jor-el Thomas Caparas,2,2,35,33
1656127177753,MATH 20C,A02,083761,Briones; Jor-el Thomas Caparas,9,1,35,26
1656127177753,MATH 20C,A03,093476,Staff,1,1,35,34
1656127177753,MATH 20C,B01,083762,Bach; Quang Tran,1,0,30,29
1656127183775,MATH 20D,A01,083765,Tran; Brian Kha,2,0,30,28
1656127183775,MATH 20D,A02,083766,Tran; Brian Kha,0,1,30,30
1656127183775,MATH 20D,A03,083767,Tran; Brian Kha,2,0,30,28
1656127189799,MATH 20E,A01,083771,Ganguly; Soumya,4,1,32,28
1656127189799,MATH 20E,A02,083772,Ganguly; Soumya,2,2,32,30
1656127189799,MATH 20E,B01,083773,Ciotti; Benjamin,14,0,35,21
1656127189799,MATH 20E,B02,083774,Ciotti; Benjamin,14,0,35,21
1656127195823,MATH 103A,A01,083777,Greenfeld; Be'Eri,2,0,36,34
1656127195823,MATH 103A,A02,083778,Greenfeld; Be'Eri,2,0,36,34
1656127195823,MATH 103A,A03,093561,Staff,4,1,36,32
1656127195823,MATH 103A,B01,083779,Greenfeld; Be'Eri,8,1,36,28
1656127195823,MATH 103A,B02,083780,Greenfeld; Be'Eri,0,0,36,36
1656127195823,MATH 103A,B03,093562,Staff,0,0,36,36
1656127201851,MATH 105,A01,085443,Carter; Anne Toulson,4,1,35,31
1656127201851,MATH 105,A02,093477,Staff,9,0,35,26
1656127207881,MATH 109,A01,083213,Ganzberger; Geoffrey Michael,1,1,34,33
1656127207881,MATH 109,A02,083214,Ganzberger; Geoffrey Michael,0,0,34,34
1656127207881,MATH 109,A03,093478,Staff,1,0,34,33
1656127207881,MATH 109,B01,083215,Ganzberger; Geoffrey Michael,3,0,32,29
1656127207881,MATH 109,B02,083216,Ganzberger; Geoffrey Michael,1,0,32,31
1656127207881,MATH 109,B03,093479,Staff,4,0,32,28
1656127213905,MATH 142A,A01,083219,Chow; Bennett,1,0,32,31
1656127213905,MATH 142A,A02,083220,Chow; Bennett,8,0,32,24
1656127213905,MATH 142A,A03,093480,Staff,5,0,32,27
1656127213905,MATH 142A,B03,093481,Staff,4,0,32,28
1656127213905,MATH 142A,B04,093558,Staff,5,0,32,27
1656127213905,MATH 142A,B05,093559,Staff,0,0,32,32
1656127219929,MATH 193A,A01,083224,Rotar; Vladimir,1,2,34,33
1656127219929,MATH 193A,A02,083225,Rotar; Vladimir,1,0,34,33
1656127219929,MATH 193A,A03,083781,Rotar; Vladimir,1,0,34,33
1656127219929,MATH 193A,A04,083782,Rotar; Vladimir,6,0,34,28
1656127219929,MATH 193A,A05,093482,Rotar; Vladimir,1,0,34,33
1656127225955,MATH 197,001,091859,McAuley; Julian John,9999,0,9999,0
1656127225955,MATH 197,002,095566,Kedlaya; Kiran S.,9997,0,9999,2
1656127225955,MATH 197,003,095567,Xiao; Ming,9999,0,9999,0
1656127225955,MATH 197,004,095571,Perols; Johan Lars,9998,0,9999,1
1656127233020,COGS 9,A01,083615,Shannon; Kyle Michael,5,1,75,70
1656127239044,COGS 11,A01,083617,Boyle; Mary E. T.,16,2,48,32
1656127245067,COGS 13,A01,083071,Bastos; Amalia Pinkusfeld,9,3,71,62
1656127251094,COGS 14A,A01,092681,Semenuks; Arturs,8,23,100,92
1656127257117,COGS 14B,A01,083073,Cheng; Tzu-Han,7,0,63,56
1656127263141,COGS 17,A01,092677,Semenuks; Arturs,13,6,81,68
1656127269241,COGS 100,A01,083619,Allen; Michael Gordon,7,5,70,63
1656127275265,COGS 101A,A01,083621,Davis; Joshua Daniel,7,3,68,61
1656127281288,COGS 101B,A01,091572,Allen; Michael Gordon,6,0,65,59
1656127287311,COGS 101C,A01,083625,Delgado; Tania,10,0,35,25
1656127293335,COGS 107A,A01,083627,Boyle; Mary E. T.,5,4,60,55
1656127299361,COGS 118A,A01,083075,Gupta; Anjum,24,17,76,52
1656127305390,CSE 3,A50,083646,Miranda; Gregory Joseph,18,0,50,32
1656127311428,CSE 8A,A50,083650,Miranda; Gregory Joseph,13,13,56,43
1656127317465,CSE 11,A01,083080,Cao; Yingjun,1,58,40,39
1656127323488,CSE 12,A01,083652,Krause-Levy; Sophia Louisa,14,8,120,106
1656127329518,CSE 15L,A01,083654,Morris; Justin Loren,5,2,50,45
1656127329518,CSE 15L,A02,083655,Morris; Justin Loren,7,2,50,43
1656127335545,CSE 20,A01,083657,Tran; Khoa Dang,31,0,80,49
1656127341570,CSE 21,A01,095574,Bach; Quang Tran,25,0,48,23
1656127347594,CSE 30,A01,083084,Eldon; John,3,11,80,77
1656127347594,CSE 30,B01,095061,Bhaskar; Nishant,4,5,50,46
1656127353620,CSE 100,A01,083659,Cao; Yingjun,2,22,70,68
1656127359643,CSE 134B,A01,083661,Powell; Thomas Allan,11,8,100,89
1656127365672,CSE 140,A01,083663,Gungor; Onat,9,0,85,76
1656127378094,CSE 140L,A01,083088,Eldon; John,8,0,100,92
1656127384119,CSE 175,A01,083665,Kumar; Rakesh,0,0,25,25
1656127390144,CSE 190,A00,092507,Dubnov; Shlomo,2,0,20,18
1656127396167,ECE 45,A01,083139,Congero; Spencer William,5,4,75,70
1656127402200,ECE 65,A50,083695,Saad; Andrew S,8,0,30,22
1656127402200,ECE 65,A51,095125,Staff,23,0,26,3
1656127408235,ECE 109,A01,091882,Touri; Behrouz,7,7,70,63
1656127414258,ECE 180,A00,083140,Abi Samra; Nicholas Camill,1,0,30,29
1656127414258,ECE 180,B00,083141,Abi Samra; Nicholas Camill,4,8,30,26
1656127420281,MATH 10A,A01,083735,Patchell; Gregory David,0,0,30,30
1656127420281,MATH 10A,A02,083736,Patchell; Gregory David,22,0,30,8
1656127420281,MATH 10A,A03,083737,Patchell; Gregory David,16,0,30,14
1656127426305,MATH 10B,A01,083207,Lim; Seonhee,3,3,34,31
1656127426305,MATH 10B,A02,083208,Lim; Seonhee,10,3,35,25
1656127426305,MATH 10B,A03,093472,Staff,4,3,34,30
1656127426305,MATH 10B,B01,083739,Sinha; Shubham,11,0,30,19
1656127432337,MATH 18,A01,083743,Cinel; Cameron Alexander,7,0,30,23
1656127432337,MATH 18,A02,083744,Cinel; Cameron Alexander,10,0,30,20
1656127432337,MATH 18,A03,083745,Cinel; Cameron Alexander,3,0,30,27
1656127432337,MATH 18,B01,083748,Rideout; David Porter,0,0,36,36
1656127432337,MATH 18,B02,083749,Rideout; David Porter,0,0,36,36
1656127432337,MATH 18,B03,083750,Rideout; David Porter,0,0,36,36
1656127432337,MATH 18,B04,083751,Rideout; David Porter,0,0,36,36
1656127432337,MATH 18,B05,093473,Rideout; David Porter,2,0,36,34
1656127432337,MATH 18,B06,093474,Rideout; David Porter,4,0,36,32
1656127438359,MATH 20A,A01,083754,Zheng; Zequn,11,0,40,29
1656127444382,MATH 20B,A01,083756,Briones; Jor-el Thomas Caparas,0,0,36,36
1656127444382,MATH 20B,A02,083757,Briones; Jor-el Thomas Caparas,0,0,36,36
1656127444382,MATH 20B,A03,093475,Staff,2,0,36,34
1656127450408,MATH 20C,A01,083760,Briones; Jor-el Thomas Caparas,2,2,35,33
1656127450408,MATH 20C,A02,083761,Briones; Jor-el Thomas Caparas,9,1,35,26
1656127450408,MATH 20C,A03,093476,Staff,1,1,35,34
1656127450408,MATH 20C,B01,083762,Bach; Quang Tran,1,0,30,29
1656127456435,MATH 20D,A01,083765,Tran; Brian Kha,2,0,30,28
1656127456435,MATH 20D,A02,083766,Tran; Brian Kha,0,1,30,30
1656127456435,MATH 20D,A03,083767,Tran; Brian Kha,2,0,30,28
1656127462458,MATH 20E,A01,083771,Ganguly; Soumya,4,1,32,28
1656127462458,MATH 20E,A02,083772,Ganguly; Soumya,2,2,32,30
1656127462458,MATH 20E,B01,083773,Ciotti; Benjamin,14,0,35,21
1656127462458,MATH 20E,B02,083774,Ciotti; Benjamin,14,0,35,21
1656127468481,MATH 103A,A01,083777,Greenfeld; Be'Eri,2,0,36,34
1656127468481,MATH 103A,A02,083778,Greenfeld; Be'Eri,2,0,36,34
1656127468481,MATH 103A,A03,093561,Staff,4,1,36,32
1656127468481,MATH 103A,B01,083779,Greenfeld; Be'Eri,8,1,36,28
1656127468481,MATH 103A,B02,083780,Greenfeld; Be'Eri,0,0,36,36
1656127468481,MATH 103A,B03,093562,Staff,0,0,36,36
1656127474505,MATH 105,A01,085443,Carter; Anne Toulson,4,1,35,31
1656127474505,MATH 105,A02,093477,Staff,9,0,35,26
1656127480528,MATH 109,A01,083213,Ganzberger; Geoffrey Michael,1,1,34,33
1656127480528,MATH 109,A02,083214,Ganzberger; Geoffrey Michael,0,0,34,34
1656127480528,MATH 109,A03,093478,Staff,1,0,34,33
1656127480528,MATH 109,B01,083215,Ganzberger; Geoffrey Michael,3,0,32,29
1656127480528,MATH 109,B02,083216,Ganzberger; Geoffrey Michael,1,0,32,31
1656127480528,MATH 109,B03,093479,Staff,4,0,32,28
1656127486556,MATH 142A,A01,083219,Chow; Bennett,1,0,32,31
1656127486556,MATH 142A,A02,083220,Chow; Bennett,8,0,32,24
1656127486556,MATH 142A,A03,093480,Staff,5,0,32,27
1656127486556,MATH 142A,B03,093481,Staff,4,0,32,28
1656127486556,MATH 142A,B04,093558,Staff,5,0,32,27
1656127486556,MATH 142A,B05,093559,Staff,0,0,32,32
1656127492579,MATH 193A,A01,083224,Rotar; Vladimir,1,2,34,33
1656127492579,MATH 193A,A02,083225,Rotar; Vladimir,0,0,34,34
1656127492579,MATH 193A,A03,083781,Rotar; Vladimir,1,0,34,33
1656127492579,MATH 193A,A04,083782,Rotar; Vladimir,6,0,34,28
1656127492579,MATH 193A,A05,093482,Rotar; Vladimir,1,0,34,33
1656127498602,MATH 197,001,091859,McAuley; Julian John,9999,0,9999,0
1656127498602,MATH 197,002,095566,Kedlaya; Kiran S.,9997,0,9999,2
1656127498602,MATH 197,003,095567,Xiao; Ming,9999,0,9999,0
1656127498602,MATH 197,004,095571,Perols; Johan Lars,9998,0,9999,1
1656127505664,COGS 9,A01,083615,Shannon; Kyle Michael,5,1,75,70
1656127511688,COGS 11,A01,083617,Boyle; Mary E. T.,16,2,48,32
1656127517711,COGS 13,A01,083071,Bastos; Amalia Pinkusfeld,9,3,71,62
1656127523740,COGS 14A,A01,092681,Semenuks; Arturs,8,23,100,92
1656127529763,COGS 14B,A01,083073,Cheng; Tzu-Han,7,0,63,56
1656127535799,COGS 17,A01,092677,Semenuks; Arturs,13,6,81,68
1656127541822,COGS 100,A01,083619,Allen; Michael Gordon,7,5,70,63
1656127547846,COGS 101A,A01,083621,Davis; Joshua Daniel,7,3,68,61
1656127553870,COGS 101B,A01,091572,Allen; Michael Gordon,6,0,65,59
1656127559893,COGS 101C,A01,083625,Delgado; Tania,10,0,35,25
1656127565916,COGS 107A,A01,083627,Boyle; Mary E. T.,5,4,60,55
1656127571944,COGS 118A,A01,083075,Gupta; Anjum,24,17,76,52
1656127577974,CSE 3,A50,083646,Miranda; Gregory Joseph,18,0,50,32
1656127583997,CSE 8A,A50,083650,Miranda; Gregory Joseph,13,13,56,43
1656127590025,CSE 11,A01,083080,Cao; Yingjun,1,58,40,39
1656127596054,CSE 12,A01,083652,Krause-Levy; Sophia Louisa,14,8,120,106
1656127602096,CSE 15L,A01,083654,Morris; Justin Loren,5,2,50,45
1656127602096,CSE 15L,A02,083655,Morris; Justin Loren,7,3,50,43
1656127608123,CSE 20,A01,083657,Tran; Khoa Dang,31,0,80,49
1656127614151,CSE 21,A01,095574,Bach; Quang Tran,25,0,48,23
1656127620185,CSE 30,A01,083084,Eldon; John,3,11,80,77
1656127620185,CSE 30,B01,095061,Bhaskar; Nishant,4,5,50,46
1656127626210,CSE 100,A01,083659,Cao; Yingjun,2,22,70,68
1656127632232,CSE 134B,A01,083661,Powell; Thomas Allan,11,8,100,89
1656127638261,CSE 140,A01,083663,Gungor; Onat,9,0,85,76
1656127644283,CSE 140L,A01,083088,Eldon; John,8,0,100,92
1656127650307,CSE 175,A01,083665,Kumar; Rakesh,0,0,25,25
1656127656334,CSE 190,A00,092507,Dubnov; Shlomo,2,0,20,18
1656127662362,ECE 45,A01,083139,Congero; Spencer William,5,4,75,70
1656127668386,ECE 65,A50,083695,Saad; Andrew S,8,0,30,22
1656127668386,ECE 65,A51,095125,Staff,23,0,26,3
1656127674415,ECE 109,A01,091882,Touri; Behrouz,7,7,70,63
1656127680443,ECE 180,A00,083140,Abi Samra; Nicholas Camill,1,0,30,29
1656127680443,ECE 180,B00,083141,Abi Samra; Nicholas Camill,4,8,30,26
1656127686472,MATH 10A,A01,083735,Patchell; Gregory David,0,0,30,30
1656127686472,MATH 10A,A02,083736,Patchell; Gregory David,22,0,30,8
1656127686472,MATH 10A,A03,083737,Patchell; Gregory David,16,0,30,14
1656127692512,MATH 10B,A01,083207,Lim; Seonhee,3,3,34,31
1656127692512,MATH 10B,A02,083208,Lim; Seonhee,10,3,35,25
1656127692512,MATH 10B,A03,093472,Staff,4,3,34,30
1656127692512,MATH 10B,B01,083739,Sinha; Shubham,11,0,30,19
1656127698544,MATH 18,A01,083743,Cinel; Cameron Alexander,7,0,30,23
1656127698544,MATH 18,A02,083744,Cinel; Cameron Alexander,10,0,30,20
1656127698544,MATH 18,A03,083745,Cinel; Cameron Alexander,3,0,30,27
1656127698544,MATH 18,B01,083748,Rideout; David Porter,0,0,36,36
1656127698544,MATH 18,B02,083749,Rideout; David Porter,0,0,36,36
1656127698544,MATH 18,B03,083750,Rideout; David Porter,0,0,36,36
1656127698544,MATH 18,B04,083751,Rideout; David Porter,0,0,36,36
1656127698544,MATH 18,B05,093473,Rideout; David Porter,2,0,36,34
1656127698544,MATH 18,B06,093474,Rideout; David Porter,4,0,36,32
1656127704566,MATH 20A,A01,083754,Zheng; Zequn,11,0,40,29
1656127710590,MATH 20B,A01,083756,Briones; Jor-el Thomas Caparas,0,0,36,36
1656127710590,MATH 20B,A02,083757,Briones; Jor-el Thomas Caparas,0,0,36,36
1656127710590,MATH 20B,A03,093475,Staff,2,0,36,34
1656127716614,MATH 20C,A01,083760,Briones; Jor-el Thomas Caparas,2,2,35,33
1656127716614,MATH 20C,A02,083761,Briones; Jor-el Thomas Caparas,9,1,35,26
1656127716614,MATH 20C,A03,093476,Staff,1,1,35,34
1656127716614,MATH 20C,B01,083762,Bach; Quang Tran,1,0,30,29
1656127722638,MATH 20D,A01,083765,Tran; Brian Kha,2,0,30,28
1656127722638,MATH 20D,A02,083766,Tran; Brian Kha,0,1,30,30
1656127722638,MATH 20D,A03,083767,Tran; Brian Kha,2,0,30,28
1656127728662,MATH 20E,A01,083771,Ganguly; Soumya,4,1,32,28
1656127728662,MATH 20E,A02,083772,Ganguly; Soumya,2,2,32,30
1656127728662,MATH 20E,B01,083773,Ciotti; Benjamin,14,0,35,21
1656127728662,MATH 20E,B02,083774,Ciotti; Benjamin,14,0,35,21
1656127734686,MATH 103A,A01,083777,Greenfeld; Be'Eri,2,0,36,34
1656127734686,MATH 103A,A02,083778,Greenfeld; Be'Eri,2,0,36,34
1656127734686,MATH 103A,A03,093561,Staff,4,1,36,32
1656127734686,MATH 103A,B01,083779,Greenfeld; Be'Eri,8,1,36,28
1656127734686,MATH 103A,B02,083780,Greenfeld; Be'Eri,0,0,36,36
1656127734686,MATH 103A,B03,093562,Staff,0,0,36,36
1656127740711,MATH 105,A01,085443,Carter; Anne Toulson,4,1,35,31
1656127740711,MATH 105,A02,093477,Staff,9,0,35,26
1656127746734,MATH 109,A01,083213,Ganzberger; Geoffrey Michael,1,1,34,33
1656127746734,MATH 109,A02,083214,Ganzberger; Geoffrey Michael,0,0,34,34
1656127746734,MATH 109,A03,093478,Staff,1,0,34,33
1656127746734,MATH 109,B01,083215,Ganzberger; Geoffrey Michael,3,0,32,29
1656127746734,MATH 109,B02,083216,Ganzberger; Geoffrey Michael,1,0,32,31
1656127746734,MATH 109,B03,093479,Staff,4,0,32,28
1656127752764,MATH 142A,A01,083219,Chow; Bennett,1,0,32,31
1656127752764,MATH 142A,A02,083220,Chow; Bennett,8,0,32,24
1656127752764,MATH 142A,A03,093480,Staff,5,0,32,27
1656127752764,MATH 142A,B03,093481,Staff,4,0,32,28
1656127752764,MATH 142A,B04,093558,Staff,5,0,32,27
1656127752764,MATH 142A,B05,093559,Staff,0,0,32,32
1656127758789,MATH 193A,A01,083224,Rotar; Vladimir,1,2,34,33
1656127758789,MATH 193A,A02,083225,Rotar; Vladimir,0,0,34,34
1656127758789,MATH 193A,A03,083781,Rotar; Vladimir,1,0,34,33
1656127758789,MATH 193A,A04,083782,Rotar; Vladimir,6,0,34,28
1656127758789,MATH 193A,A05,093482,Rotar; Vladimir,1,0,34,33
1656127764812,MATH 197,001,091859,McAuley; Julian John,9999,0,9999,0
1656127764812,MATH 197,002,095566,Kedlaya; Kiran S.,9997,0,9999,2
1656127764812,MATH 197,003,095567,Xiao; Ming,9999,0,9999,0
1656127764812,MATH 197,004,095571,Perols; Johan Lars,9998,0,9999,1
1656127771877,COGS 9,A01,083615,Shannon; Kyle Michael,5,1,75,70
1656127777900,COGS 11,A01,083617,Boyle; Mary E. T.,16,2,48,32
1656127783928,COGS 13,A01,083071,Bastos; Amalia Pinkusfeld,9,3,71,62
1656127789955,COGS 14A,A01,092681,Semenuks; Arturs,8,23,100,92
1656127795977,COGS 14B,A01,083073,Cheng; Tzu-Han,7,0,63,56
1656127802002,COGS 17,A01,092677,Semenuks; Arturs,13,6,81,68
1656127808028,COGS 100,A01,083619,Allen; Michael Gordon,7,5,70,63
1656127814055,COGS 101A,A01,083621,Davis; Joshua Daniel,7,3,68,61
1656127820081,COGS 101B,A01,091572,Allen; Michael Gordon,6,0,65,59
1656127826105,COGS 101C,A01,083625,Delgado; Tania,10,0,35,25
1656127832130,COGS 107A,A01,083627,Boyle; Mary E. T.,5,4,60,55
1656127838155,COGS 118A,A01,083075,Gupta; Anjum,24,17,76,52
1656127844183,CSE 3,A50,083646,Miranda; Gregory Joseph,18,0,50,32
1656127850209,CSE 8A,A50,083650,Miranda; Gregory Joseph,13,13,56,43
1656127856232,CSE 11,A01,083080,Cao; Yingjun,1,58,40,39
1656127862255,CSE 12,A01,083652,Krause-Levy; Sophia Louisa,14,8,120,106
1656127868289,CSE 15L,A01,083654,Morris; Justin Loren,5,2,50,45
1656127868289,CSE 15L,A02,083655,Morris; Justin Loren,7,3,50,43
1656127874390,CSE 20,A01,083657,Tran; Khoa Dang,31,0,80,49
1656127880436,CSE 21,A01,095574,Bach; Quang Tran,25,0,48,23
1656127886460,CSE 30,A01,083084,Eldon; John,3,11,80,77
1656127886460,CSE 30,B01,095061,Bhaskar; Nishant,4,5,50,46
1656127892486,CSE 100,A01,083659,Cao; Yingjun,2,22,70,68
1656127898510,CSE 134B,A01,083661,Powell; Thomas Allan,11,8,100,89
1656127904537,CSE 140,A01,083663,Gungor; Onat,9,0,85,76
1656127910564,CSE 140L,A01,083088,Eldon; John,8,0,100,92
1656127916591,CSE 175,A01,083665,Kumar; Rakesh,0,0,25,25
1656127922619,CSE 190,A00,092507,Dubnov; Shlomo,2,0,20,18
1656127928645,ECE 45,A01,083139,Congero; Spencer William,5,4,75,70
1656127934667,ECE 65,A50,083695,Saad; Andrew S,8,0,30,22
1656127934667,ECE 65,A51,095125,Staff,23,0,26,3
1656127940693,ECE 109,A01,091882,Touri; Behrouz,7,7,70,63
1656127946717,ECE 180,A00,083140,Abi Samra; Nicholas Camill,1,0,30,29
1656127946717,ECE 180,B00,083141,Abi Samra; Nicholas Camill,4,8,30,26
1656127952742,MATH 10A,A01,083735,Patchell; Gregory David,0,0,30,30
1656127952742,MATH 10A,A02,083736,Patchell; Gregory David,22,0,30,8
1656127952742,MATH 10A,A03,083737,Patchell; Gregory David,16,0,30,14
1656127958769,MATH 10B,A01,083207,Lim; Seonhee,3,3,34,31
1656127958769,MATH 10B,A02,083208,Lim; Seonhee,10,3,35,25
1656127958769,MATH 10B,A03,093472,Staff,4,3,34,30
1656127958769,MATH 10B,B01,083739,Sinha; Shubham,11,0,30,19
1656127964809,MATH 18,A01,083743,Cinel; Cameron Alexander,7,0,30,23
1656127964809,MATH 18,A02,083744,Cinel; Cameron Alexander,10,0,30,20
1656127964809,MATH 18,A03,083745,Cinel; Cameron Alexander,3,0,30,27
1656127964809,MATH 18,B01,083748,Rideout; David Porter,0,0,36,36
1656127964809,MATH 18,B02,083749,Rideout; David Porter,0,0,36,36
1656127964809,MATH 18,B03,083750,Rideout; David Porter,0,0,36,36
1656127964809,MATH 18,B04,083751,Rideout; David Porter,0,0,36,36
1656127964809,MATH 18,B05,093473,Rideout; David Porter,2,0,36,34
1656127964809,MATH 18,B06,093474,Rideout; David Porter,4,0,36,32
1656127970832,MATH 20A,A01,083754,Zheng; Zequn,11,0,40,29
1656127976855,MATH 20B,A01,083756,Briones; Jor-el Thomas Caparas,0,0,36,36
1656127976855,MATH 20B,A02,083757,Briones; Jor-el Thomas Caparas,0,0,36,36
1656127976855,MATH 20B,A03,093475,Staff,2,0,36,34
1656127982879,MATH 20C,A01,083760,Briones; Jor-el Thomas Caparas,2,2,35,33
1656127982879,MATH 20C,A02,083761,Briones; Jor-el Thomas Caparas,9,1,35,26
1656127982879,MATH 20C,A03,093476,Staff,1,1,35,34
1656127982879,MATH 20C,B01,083762,Bach; Quang Tran,1,0,30,29
1656127988903,MATH 20D,A01,083765,Tran; Brian Kha,2,0,30,28
1656127988903,MATH 20D,A02,083766,Tran; Brian Kha,0,1,30,30
1656127988903,MATH 20D,A03,083767,Tran; Brian Kha,2,0,30,28
1656127994931,MATH 20E,A01,083771,Ganguly; Soumya,4,1,32,28
1656127994931,MATH 20E,A02,083772,Ganguly; Soumya,2,2,32,30
1656127994931,MATH 20E,B01,083773,Ciotti; Benjamin,14,0,35,21
1656127994931,MATH 20E,B02,083774,Ciotti; Benjamin,14,0,35,21
1656128000954,MATH 103A,A01,083777,Greenfeld; Be'Eri,2,0,36,34
1656128000954,MATH 103A,A02,083778,Greenfeld; Be'Eri,2,0,36,34
1656128000954,MATH 103A,A03,093561,Staff,4,1,36,32
1656128000954,MATH 103A,B01,083779,Greenfeld; Be'Eri,8,1,36,28
1656128000954,MATH 103A,B02,083780,Greenfeld; Be'Eri,0,0,36,36
1656128000954,MATH 103A,B03,093562,Staff,0,0,36,36
1656128006978,MATH 105,A01,085443,Carter; Anne Toulson,4,1,35,31
1656128006978,MATH 105,A02,093477,Staff,9,0,35,26
1656128013004,MATH 109,A01,083213,Ganzberger; Geoffrey Michael,1,1,34,33
1656128013004,MATH 109,A02,083214,Ganzberger; Geoffrey Michael,0,0,34,34
1656128013004,MATH 109,A03,093478,Staff,1,0,34,33
1656128013004,MATH 109,B01,083215,Ganzberger; Geoffrey Michael,3,0,32,29
1656128013004,MATH 109,B02,083216,Ganzberger; Geoffrey Michael,1,0,32,31
1656128013004,MATH 109,B03,093479,Staff,4,0,32,28
1656128019027,MATH 142A,A01,083219,Chow; Bennett,1,0,32,31
1656128019027,MATH 142A,A02,083220,Chow; Bennett,8,0,32,24
1656128019027,MATH 142A,A03,093480,Staff,5,0,32,27
1656128019027,MATH 142A,B03,093481,Staff,4,0,32,28
1656128019027,MATH 142A,B04,093558,Staff,5,0,32,27
1656128019027,MATH 142A,B05,093559,Staff,0,0,32,32
1656128025055,MATH 193A,A01,083224,Rotar; Vladimir,1,2,34,33
1656128025055,MATH 193A,A02,083225,Rotar; Vladimir,0,0,34,34
1656128025055,MATH 193A,A03,083781,Rotar; Vladimir,1,0,34,33
1656128025055,MATH 193A,A04,083782,Rotar; Vladimir,6,0,34,28
1656128025055,MATH 193A,A05,093482,Rotar; Vladimir,1,0,34,33
1656128031079,MATH 197,001,091859,McAuley; Julian John,9999,0,9999,0
1656128031079,MATH 197,002,095566,Kedlaya; Kiran S.,9997,0,9999,2
1656128031079,MATH 197,003,095567,Xiao; Ming,9999,0,9999,0
1656128031079,MATH 197,004,095571,Perols; Johan Lars,9998,0,9999,1
1656128038128,COGS 9,A01,083615,Shannon; Kyle Michael,5,1,75,70
1656128044156,COGS 11,A01,083617,Boyle; Mary E. T.,16,2,48,32
1656128050183,COGS 13,A01,083071,Bastos; Amalia Pinkusfeld,9,3,71,62
1656128056210,COGS 14A,A01,092681,Semenuks; Arturs,8,23,100,92
1656128062236,COGS 14B,A01,083073,Cheng; Tzu-Han,7,0,63,56
1656128068260,COGS 17,A01,092677,Semenuks; Arturs,13,6,81,68
1656128074287,COGS 100,A01,083619,Allen; Michael Gordon,7,5,70,63
1656128080312,COGS 101A,A01,083621,Davis; Joshua Daniel,7,3,68,61
1656128086333,COGS 101B,A01,091572,Allen; Michael Gordon,6,0,65,59
1656128092356,COGS 101C,A01,083625,Delgado; Tania,10,0,35,25
1656128098380,COGS 107A,A01,083627,Boyle; Mary E. T.,5,4,60,55
1656128104404,COGS 118A,A01,083075,Gupta; Anjum,24,17,76,52
1656128110427,CSE 3,A50,083646,Miranda; Gregory Joseph,18,0,50,32
1656128116462,CSE 8A,A50,083650,Miranda; Gregory Joseph,13,13,56,43
1656128122489,CSE 11,A01,083080,Cao; Yingjun,1,58,40,39
1656128128514,CSE 12,A01,083652,Krause-Levy; Sophia Louisa,14,8,120,106
1656128134537,CSE 15L,A01,083654,Morris; Justin Loren,5,2,50,45
1656128134537,CSE 15L,A02,083655,Morris; Justin Loren,7,3,50,43
1656128140562,CSE 20,A01,083657,Tran; Khoa Dang,31,0,80,49
1656128146588,CSE 21,A01,095574,Bach; Quang Tran,25,0,48,23
1656128152617,CSE 30,A01,083084,Eldon; John,3,11,80,77
1656128152617,CSE 30,B01,095061,Bhaskar; Nishant,4,5,50,46
1656128158639,CSE 100,A01,083659,Cao; Yingjun,2,22,70,68
1656128164662,CSE 134B,A01,083661,Powell; Thomas Allan,11,8,100,89
1656128170685,CSE 140,A01,083663,Gungor; Onat,9,0,85,76
1656128176709,CSE 140L,A01,083088,Eldon; John,8,0,100,92
1656128182736,CSE 175,A01,083665,Kumar; Rakesh,0,0,25,25
1656128188761,CSE 190,A00,092507,Dubnov; Shlomo,2,0,20,18
1656128194787,ECE 45,A01,083139,Congero; Spencer William,5,4,75,70
1656128200813,ECE 65,A50,083695,Saad; Andrew S,8,0,30,22
1656128200813,ECE 65,A51,095125,Staff,23,0,26,3
1656128206845,ECE 109,A01,091882,Touri; Behrouz,7,7,70,63
1656128212880,ECE 180,A00,083140,Abi Samra; Nicholas Camill,1,0,30,29
1656128212880,ECE 180,B00,083141,Abi Samra; Nicholas Camill,4,8,30,26
1656128218907,MATH 10A,A01,083735,Patchell; Gregory David,0,0,30,30
1656128218907,MATH 10A,A02,083736,Patchell; Gregory David,22,0,30,8
1656128218907,MATH 10A,A03,083737,Patchell; Gregory David,16,0,30,14
1656128224931,MATH 10B,A01,083207,Lim; Seonhee,3,3,34,31
1656128224931,MATH 10B,A02,083208,Lim; Seonhee,10,3,35,25
1656128224931,MATH 10B,A03,093472,Staff,4,3,34,30
1656128224931,MATH 10B,B01,083739,Sinha; Shubham,11,0,30,19
1656128230962,MATH 18,A01,083743,Cinel; Cameron Alexander,7,0,30,23
1656128230962,MATH 18,A02,083744,Cinel; Cameron Alexander,10,0,30,20
1656128230962,MATH 18,A03,083745,Cinel; Cameron Alexander,3,0,30,27
1656128230962,MATH 18,B01,083748,Rideout; David Porter,0,0,36,36
1656128230962,MATH 18,B02,083749,Rideout; David Porter,0,0,36,36
1656128230962,MATH 18,B03,083750,Rideout; David Porter,0,0,36,36
1656128230962,MATH 18,B04,083751,Rideout; David Porter,0,0,36,36
1656128230962,MATH 18,B05,093473,Rideout; David Porter,2,0,36,34
1656128230962,MATH 18,B06,093474,Rideout; David Porter,4,0,36,32
1656128236985,MATH 20A,A01,083754,Zheng; Zequn,11,0,40,29
1656128243009,MATH 20B,A01,083756,Briones; Jor-el Thomas Caparas,0,0,36,36
1656128243009,MATH 20B,A02,083757,Briones; Jor-el Thomas Caparas,0,0,36,36
1656128243009,MATH 20B,A03,093475,Staff,2,0,36,34
1656128249038,MATH 20C,A01,083760,Briones; Jor-el Thomas Caparas,2,2,35,33
1656128249038,MATH 20C,A02,083761,Briones; Jor-el Thomas Caparas,9,1,35,26
1656128249038,MATH 20C,A03,093476,Staff,1,1,35,34
1656128249038,MATH 20C,B01,083762,Bach; Quang Tran,1,0,30,29
1656128255062,MATH 20D,A01,083765,Tran; Brian Kha,2,0,30,28
1656128255062,MATH 20D,A02,083766,Tran; Brian Kha,0,1,30,30
1656128255062,MATH 20D,A03,083767,Tran; Brian Kha,2,0,30,28
1656128261100,MATH 20E,A01,083771,Ganguly; Soumya,4,1,32,28
1656128261100,MATH 20E,A02,083772,Ganguly; Soumya,2,2,32,30
1656128261100,MATH 20E,B01,083773,Ciotti; Benjamin,14,0,35,21
1656128261100,MATH 20E,B02,083774,Ciotti; Benjamin,14,0,35,21
1656128267125,MATH 103A,A01,083777,Greenfeld; Be'Eri,2,0,36,34
1656128267125,MATH 103A,A02,083778,Greenfeld; Be'Eri,2,0,36,34
1656128267125,MATH 103A,A03,093561,Staff,4,1,36,32
1656128267125,MATH 103A,B01,083779,Greenfeld; Be'Eri,8,1,36,28
1656128267125,MATH 103A,B02,083780,Greenfeld; Be'Eri,0,0,36,36
1656128267125,MATH 103A,B03,093562,Staff,0,0,36,36
1656128273148,MATH 105,A01,085443,Carter; Anne Toulson,4,1,35,31
1656128273148,MATH 105,A02,093477,Staff,9,0,35,26
1656128279177,MATH 109,A01,083213,Ganzberger; Geoffrey Michael,1,1,34,33
1656128279177,MATH 109,A02,083214,Ganzberger; Geoffrey Michael,0,0,34,34
1656128279177,MATH 109,A03,093478,Staff,1,0,34,33
1656128279177,MATH 109,B01,083215,Ganzberger; Geoffrey Michael,3,0,32,29
1656128279177,MATH 109,B02,083216,Ganzberger; Geoffrey Michael,1,0,32,31
1656128279177,MATH 109,B03,093479,Staff,4,0,32,28
1656128285202,MATH 142A,A01,083219,Chow; Bennett,1,0,32,31
1656128285202,MATH 142A,A02,083220,Chow; Bennett,8,0,32,24
1656128285202,MATH 142A,A03,093480,Staff,5,0,32,27
1656128285202,MATH 142A,B03,093481,Staff,4,0,32,28
1656128285202,MATH 142A,B04,093558,Staff,5,0,32,27
1656128285202,MATH 142A,B05,093559,Staff,0,0,32,32
1656128291226,MATH 193A,A01,083224,Rotar; Vladimir,1,2,34,33
1656128291226,MATH 193A,A02,083225,Rotar; Vladimir,0,0,34,34
1656128291226,MATH 193A,A03,083781,Rotar; Vladimir,1,0,34,33
1656128291226,MATH 193A,A04,083782,Rotar; Vladimir,6,0,34,28
1656128291226,MATH 193A,A05,093482,Rotar; Vladimir,1,0,34,33
1656128297250,MATH 197,001,091859,McAuley; Julian John,9999,0,9999,0
1656128297250,MATH 197,002,095566,Kedlaya; Kiran S.,9997,0,9999,2
1656128297250,MATH 197,003,095567,Xiao; Ming,9999,0,9999,0
1656128297250,MATH 197,004,095571,Perols; Johan Lars,9998,0,9999,1
1656128304314,COGS 9,A01,083615,Shannon; Kyle Michael,5,1,75,70
1656128310340,COGS 11,A01,083617,Boyle; Mary E. T.,16,2,48,32
1656128316366,COGS 13,A01,083071,Bastos; Amalia Pinkusfeld,9,3,71,62
1656128322390,COGS 14A,A01,092681,Semenuks; Arturs,8,23,100,92
1656128328419,COGS 14B,A01,083073,Cheng; Tzu-Han,7,0,63,56
1656128334445,COGS 17,A01,092677,Semenuks; Arturs,13,6,81,68
1656128340473,COGS 100,A01,083619,Allen; Michael Gordon,7,5,70,63
1656128346501,COGS 101A,A01,083621,Davis; Joshua Daniel,7,3,68,61
1656128352526,COGS 101B,A01,091572,Allen; Michael Gordon,6,0,65,59
1656128358552,COGS 101C,A01,083625,Delgado; Tania,10,0,35,25
1656128364576,COGS 107A,A01,083627,Boyle; Mary E. T.,5,4,60,55
1656128370599,COGS 118A,A01,083075,Gupta; Anjum,24,17,76,52
1656128376627,CSE 3,A50,083646,Miranda; Gregory Joseph,18,0,50,32
1656128382650,CSE 8A,A50,083650,Miranda; Gregory Joseph,13,13,56,43
1656128388673,CSE 11,A01,083080,Cao; Yingjun,1,58,40,39
1656128394701,CSE 12,A01,083652,Krause-Levy; Sophia Louisa,14,8,120,106
1656128400731,CSE 15L,A01,083654,Morris; Justin Loren,5,2,50,45
1656128400731,CSE 15L,A02,083655,Morris; Justin Loren,7,3,50,43
1656128406754,CSE 20,A01,083657,Tran; Khoa Dang,31,0,80,49
1656128412778,CSE 21,A01,095574,Bach; Quang Tran,25,0,48,23
1656128418801,CSE 30,A01,083084,Eldon; John,3,11,80,77
1656128418801,CSE 30,B01,095061,Bhaskar; Nishant,4,5,50,46
1656128424828,CSE 100,A01,083659,Cao; Yingjun,2,22,70,68
1656128430854,CSE 134B,A01,083661,Powell; Thomas Allan,11,8,100,89
1656128436877,CSE 140,A01,083663,Gungor; Onat,9,0,85,76
1656128442900,CSE 140L,A01,083088,Eldon; John,8,0,100,92
1656128448923,CSE 175,A01,083665,Kumar; Rakesh,0,0,25,25
1656128454949,CSE 190,A00,092507,Dubnov; Shlomo,2,0,20,18
1656128460973,ECE 45,A01,083139,Congero; Spencer William,5,4,75,70
1656128466997,ECE 65,A50,083695,Saad; Andrew S,8,0,30,22
1656128466997,ECE 65,A51,095125,Staff,23,0,26,3
1656128473124,ECE 109,A01,091882,Touri; Behrouz,7,7,70,63
1656128479150,ECE 180,A00,083140,Abi Samra; Nicholas Camill,1,0,30,29
1656128479150,ECE 180,B00,083141,Abi Samra; Nicholas Camill,4,8,30,26
1656128485177,MATH 10A,A01,083735,Patchell; Gregory David,0,0,30,30
1656128485177,MATH 10A,A02,083736,Patchell; Gregory David,22,0,30,8
1656128485177,MATH 10A,A03,083737,Patchell; Gregory David,16,0,30,14
1656128491205,MATH 10B,A01,083207,Lim; Seonhee,3,3,34,31
1656128491205,MATH 10B,A02,083208,Lim; Seonhee,10,3,35,25
1656128491205,MATH 10B,A03,093472,Staff,4,3,34,30
1656128491205,MATH 10B,B01,083739,Sinha; Shubham,11,0,30,19
1656128497229,MATH 18,A01,083743,Cinel; Cameron Alexander,7,0,30,23
1656128497229,MATH 18,A02,083744,Cinel; Cameron Alexander,10,0,30,20
1656128497229,MATH 18,A03,083745,Cinel; Cameron Alexander,3,0,30,27
1656128497229,MATH 18,B01,083748,Rideout; David Porter,0,0,36,36
1656128497229,MATH 18,B02,083749,Rideout; David Porter,0,0,36,36
1656128497229,MATH 18,B03,083750,Rideout; David Porter,0,0,36,36
1656128497229,MATH 18,B04,083751,Rideout; David Porter,0,0,36,36
1656128497229,MATH 18,B05,093473,Rideout; David Porter,2,0,36,34
1656128497229,MATH 18,B06,093474,Rideout; David Porter,4,0,36,32
1656128503253,MATH 20A,A01,083754,Zheng; Zequn,11,0,40,29
1656128509277,MATH 20B,A01,083756,Briones; Jor-el Thomas Caparas,0,0,36,36
1656128509277,MATH 20B,A02,083757,Briones; Jor-el Thomas Caparas,0,0,36,36
1656128509277,MATH 20B,A03,093475,Staff,2,0,36,34
1656128515301,MATH 20C,A01,083760,Briones; Jor-el Thomas Caparas,2,2,35,33
1656128515301,MATH 20C,A02,083761,Briones; Jor-el Thomas Caparas,9,1,35,26
1656128515301,MATH 20C,A03,093476,Staff,1,1,35,34
1656128515301,MATH 20C,B01,083762,Bach; Quang Tran,1,0,30,29
1656128521327,MATH 20D,A01,083765,Tran; Brian Kha,2,0,30,28
1656128521327,MATH 20D,A02,083766,Tran; Brian Kha,0,1,30,30
1656128521327,MATH 20D,A03,083767,Tran; Brian Kha,2,0,30,28
1656128527351,MATH 20E,A01,083771,Ganguly; Soumya,4,1,32,28
1656128527351,MATH 20E,A02,083772,Ganguly; Soumya,2,2,32,30
1656128527351,MATH 20E,B01,083773,Ciotti; Benjamin,14,0,35,21
1656128527351,MATH 20E,B02,083774,Ciotti; Benjamin,14,0,35,21
1656128533375,MATH 103A,A01,083777,Greenfeld; Be'Eri,2,0,36,34
1656128533375,MATH 103A,A02,083778,Greenfeld; Be'Eri,2,0,36,34
1656128533375,MATH 103A,A03,093561,Staff,4,1,36,32
1656128533375,MATH 103A,B01,083779,Greenfeld; Be'Eri,8,1,36,28
1656128533375,MATH 103A,B02,083780,Greenfeld; Be'Eri,0,0,36,36
1656128533375,MATH 103A,B03,093562,Staff,0,0,36,36
1656128539397,MATH 105,A01,085443,Carter; Anne Toulson,4,1,35,31
1656128539397,MATH 105,A02,093477,Staff,9,0,35,26
1656128545423,MATH 109,A01,083213,Ganzberger; Geoffrey Michael,1,1,34,33
1656128545423,MATH 109,A02,083214,Ganzberger; Geoffrey Michael,0,0,34,34
1656128545423,MATH 109,A03,093478,Staff,1,0,34,33
1656128545423,MATH 109,B01,083215,Ganzberger; Geoffrey Michael,3,0,32,29
1656128545423,MATH 109,B02,083216,Ganzberger; Geoffrey Michael,1,0,32,31
1656128545423,MATH 109,B03,093479,Staff,4,0,32,28
1656128551453,MATH 142A,A01,083219,Chow; Bennett,1,0,32,31
1656128551453,MATH 142A,A02,083220,Chow; Bennett,8,0,32,24
1656128551453,MATH 142A,A03,093480,Staff,5,0,32,27
1656128551453,MATH 142A,B03,093481,Staff,4,0,32,28
1656128551453,MATH 142A,B04,093558,Staff,5,0,32,27
1656128551453,MATH 142A,B05,093559,Staff,0,0,32,32
1656128557474,MATH 193A,A01,083224,Rotar; Vladimir,1,2,34,33
1656128557474,MATH 193A,A02,083225,Rotar; Vladimir,0,0,34,34
1656128557474,MATH 193A,A03,083781,Rotar; Vladimir,1,0,34,33
1656128557474,MATH 193A,A04,083782,Rotar; Vladimir,6,0,34,28
1656128557474,MATH 193A,A05,093482,Rotar; Vladimir,1,0,34,33
1656128563499,MATH 197,001,091859,McAuley; Julian John,9999,0,9999,0
1656128563499,MATH 197,002,095566,Kedlaya; Kiran S.,9997,0,9999,2
1656128563499,MATH 197,003,095567,Xiao; Ming,9999,0,9999,0
1656128563499,MATH 197,004,095571,Perols; Johan Lars,9998,0,9999,1
1656128570561,COGS 9,A01,083615,Shannon; Kyle Michael,5,1,75,70
1656128576587,COGS 11,A01,083617,Boyle; Mary E. T.,16,2,48,32
1656128582611,COGS 13,A01,083071,Bastos; Amalia Pinkusfeld,9,3,71,62
1656128588641,COGS 14A,A01,092681,Semenuks; Arturs,8,23,100,92
1656128594670,COGS 14B,A01,083073,Cheng; Tzu-Han,7,0,63,56
1656128600694,COGS 17,A01,092677,Semenuks; Arturs,13,6,81,68
1656128606718,COGS 100,A01,083619,Allen; Michael Gordon,7,5,70,63
1656128612741,COGS 101A,A01,083621,Davis; Joshua Daniel,7,3,68,61
1656128618769,COGS 101B,A01,091572,Allen; Michael Gordon,6,0,65,59
1656128624796,COGS 101C,A01,083625,Delgado; Tania,10,0,35,25
1656128630818,COGS 107A,A01,083627,Boyle; Mary E. T.,5,4,60,55
1656128636845,COGS 118A,A01,083075,Gupta; Anjum,24,17,76,52
1656128642874,CSE 3,A50,083646,Miranda; Gregory Joseph,18,0,50,32
1656128648901,CSE 8A,A50,083650,Miranda; Gregory Joseph,13,13,56,43
1656128654928,CSE 11,A01,083080,Cao; Yingjun,1,58,40,39
1656128660956,CSE 12,A01,083652,Krause-Levy; Sophia Louisa,14,8,120,106
1656128666981,CSE 15L,A01,083654,Morris; Justin Loren,5,2,50,45
1656128666981,CSE 15L,A02,083655,Morris; Justin Loren,7,3,50,43
1656128673005,CSE 20,A01,083657,Tran; Khoa Dang,31,0,80,49
1656128679031,CSE 21,A01,095574,Bach; Quang Tran,25,0,48,23
1656128685067,CSE 30,A01,083084,Eldon; John,3,11,80,77
1656128685067,CSE 30,B01,095061,Bhaskar; Nishant,4,5,50,46
1656128691090,CSE 100,A01,083659,Cao; Yingjun,2,22,70,68
1656128697118,CSE 134B,A01,083661,Powell; Thomas Allan,11,8,100,89
1656128703142,CSE 140,A01,083663,Gungor; Onat,9,0,85,76
1656128709169,CSE 140L,A01,083088,Eldon; John,8,0,100,92
1656128715191,CSE 175,A01,083665,Kumar; Rakesh,0,0,25,25
1656128721217,CSE 190,A00,092507,Dubnov; Shlomo,2,0,20,18
1656128727253,ECE 45,A01,083139,Congero; Spencer William,5,4,75,70
1656128733276,ECE 65,A50,083695,Saad; Andrew S,8,0,30,22
1656128733276,ECE 65,A51,095125,Staff,23,0,26,3
1656128739300,ECE 109,A01,091882,Touri; Behrouz,7,8,70,63
1656128745323,ECE 180,A00,083140,Abi Samra; Nicholas Camill,1,0,30,29
1656128745323,ECE 180,B00,083141,Abi Samra; Nicholas Camill,4,8,30,26
1656128751346,MATH 10A,A01,083735,Patchell; Gregory David,0,0,30,30
1656128751346,MATH 10A,A02,083736,Patchell; Gregory David,22,0,30,8
1656128751346,MATH 10A,A03,083737,Patchell; Gregory David,16,0,30,14
1656128757371,MATH 10B,A01,083207,Lim; Seonhee,3,3,34,31
1656128757371,MATH 10B,A02,083208,Lim; Seonhee,10,3,35,25
1656128757371,MATH 10B,A03,093472,Staff,4,3,34,30
1656128757371,MATH 10B,B01,083739,Sinha; Shubham,11,0,30,19
1656128763408,MATH 18,A01,083743,Cinel; Cameron Alexander,7,0,30,23
1656128763408,MATH 18,A02,083744,Cinel; Cameron Alexander,10,0,30,20
1656128763408,MATH 18,A03,083745,Cinel; Cameron Alexander,3,0,30,27
1656128763408,MATH 18,B01,083748,Rideout; David Porter,0,0,36,36
1656128763408,MATH 18,B02,083749,Rideout; David Porter,0,0,36,36
1656128763408,MATH 18,B03,083750,Rideout; David Porter,0,0,36,36
1656128763408,MATH 18,B04,083751,Rideout; David Porter,0,0,36,36
1656128763408,MATH 18,B05,093473,Rideout; David Porter,2,0,36,34
1656128763408,MATH 18,B06,093474,Rideout; David Porter,4,0,36,32
1656128769433,MATH 20A,A01,083754,Zheng; Zequn,11,0,40,29
1656128775466,MATH 20B,A01,083756,Briones; Jor-el Thomas Caparas,0,0,36,36
1656128775466,MATH 20B,A02,083757,Briones; Jor-el Thomas Caparas,0,0,36,36
1656128775466,MATH 20B,A03,093475,Staff,2,0,36,34
1656128781494,MATH 20C,A01,083760,Briones; Jor-el Thomas Caparas,2,2,35,33
1656128781494,MATH 20C,A02,083761,Briones; Jor-el Thomas Caparas,9,1,35,26
1656128781494,MATH 20C,A03,093476,Staff,1,1,35,34
1656128781494,MATH 20C,B01,083762,Bach; Quang Tran,1,0,30,29
1656128787524,MATH 20D,A01,083765,Tran; Brian Kha,2,0,30,28
1656128787524,MATH 20D,A02,083766,Tran; Brian Kha,0,1,30,30
1656128787524,MATH 20D,A03,083767,Tran; Brian Kha,2,0,30,28
1656128793552,MATH 20E,A01,083771,Ganguly; Soumya,4,1,32,28
1656128793552,MATH 20E,A02,083772,Ganguly; Soumya,2,2,32,30
1656128793552,MATH 20E,B01,083773,Ciotti; Benjamin,14,0,35,21
1656128793552,MATH 20E,B02,083774,Ciotti; Benjamin,14,0,35,21
1656128799580,MATH 103A,A01,083777,Greenfeld; Be'Eri,2,0,36,34
1656128799580,MATH 103A,A02,083778,Greenfeld; Be'Eri,2,0,36,34
1656128799580,MATH 103A,A03,093561,Staff,4,1,36,32
1656128799580,MATH 103A,B01,083779,Greenfeld; Be'Eri,8,1,36,28
1656128799580,MATH 103A,B02,083780,Greenfeld; Be'Eri,0,0,36,36
1656128799580,MATH 103A,B03,093562,Staff,0,0,36,36
1656128805604,MATH 105,A01,085443,Carter; Anne Toulson,4,1,35,31
1656128805604,MATH 105,A02,093477,Staff,9,0,35,26
1656128811633,MATH 109,A01,083213,Ganzberger; Geoffrey Michael,1,1,34,33
1656128811633,MATH 109,A02,083214,Ganzberger; Geoffrey Michael,0,0,34,34
1656128811633,MATH 109,A03,093478,Staff,1,0,34,33
1656128811633,MATH 109,B01,083215,Ganzberger; Geoffrey Michael,3,0,32,29
1656128811633,MATH 109,B02,083216,Ganzberger; Geoffrey Michael,1,0,32,31
1656128811633,MATH 109,B03,093479,Staff,4,0,32,28
1656128817657,MATH 142A,A01,083219,Chow; Bennett,1,0,32,31
1656128817657,MATH 142A,A02,083220,Chow; Bennett,8,0,32,24
1656128817657,MATH 142A,A03,093480,Staff,5,0,32,27
1656128817657,MATH 142A,B03,093481,Staff,4,0,32,28
1656128817657,MATH 142A,B04,093558,Staff,5,0,32,27
1656128817657,MATH 142A,B05,093559,Staff,0,0,32,32
1656128823681,MATH 193A,A01,083224,Rotar; Vladimir,1,2,34,33
1656128823681,MATH 193A,A02,083225,Rotar; Vladimir,0,0,34,34
1656128823681,MATH 193A,A03,083781,Rotar; Vladimir,1,0,34,33
1656128823681,MATH 193A,A04,083782,Rotar; Vladimir,6,0,34,28
1656128823681,MATH 193A,A05,093482,Rotar; Vladimir,1,0,34,33
1656128829711,MATH 197,001,091859,McAuley; Julian John,9999,0,9999,0
1656128829711,MATH 197,002,095566,Kedlaya; Kiran S.,9997,0,9999,2
1656128829711,MATH 197,003,095567,Xiao; Ming,9999,0,9999,0
1656128829711,MATH 197,004,095571,Perols; Johan Lars,9998,0,9999,1
1656128836765,COGS 9,A01,083615,Shannon; Kyle Michael,5,1,75,70
1656128842788,COGS 11,A01,083617,Boyle; Mary E. T.,16,2,48,32
1656128848814,COGS 13,A01,083071,Bastos; Amalia Pinkusfeld,9,3,71,62
1656128854838,COGS 14A,A01,092681,Semenuks; Arturs,8,23,100,92
1656128860861,COGS 14B,A01,083073,Cheng; Tzu-Han,7,0,63,56
1656128866885,COGS 17,A01,092677,Semenuks; Arturs,13,6,81,68
1656128872908,COGS 100,A01,083619,Allen; Michael Gordon,7,5,70,63
1656128878932,COGS 101A,A01,083621,Davis; Joshua Daniel,7,3,68,61
1656128884956,COGS 101B,A01,091572,Allen; Michael Gordon,6,0,65,59
1656128890984,COGS 101C,A01,083625,Delgado; Tania,10,0,35,25
1656128897010,COGS 107A,A01,083627,Boyle; Mary E. T.,5,4,60,55
1656128903033,COGS 118A,A01,083075,Gupta; Anjum,24,17,76,52
1656128909055,CSE 3,A50,083646,Miranda; Gregory Joseph,18,0,50,32
1656128915079,CSE 8A,A50,083650,Miranda; Gregory Joseph,13,13,56,43
1656128921102,CSE 11,A01,083080,Cao; Yingjun,1,58,40,39
1656128927125,CSE 12,A01,083652,Krause-Levy; Sophia Louisa,14,8,120,106
1656128933148,CSE 15L,A01,083654,Morris; Justin Loren,5,2,50,45
1656128933148,CSE 15L,A02,083655,Morris; Justin Loren,7,3,50,43
1656128939179,CSE 20,A01,083657,Tran; Khoa Dang,31,0,80,49
1656128945207,CSE 21,A01,095574,Bach; Quang Tran,25,0,48,23
1656128951233,CSE 30,A01,083084,Eldon; John,3,11,80,77
1656128951233,CSE 30,B01,095061,Bhaskar; Nishant,4,6,50,46
1656128957260,CSE 100,A01,083659,Cao; Yingjun,2,22,70,68
1656128963287,CSE 134B,A01,083661,Powell; Thomas Allan,11,8,100,89
1656128969313,CSE 140,A01,083663,Gungor; Onat,9,0,85,76
1656128975338,CSE 140L,A01,083088,Eldon; John,8,0,100,92
1656128981365,CSE 175,A01,083665,Kumar; Rakesh,0,0,25,25
1656128987390,CSE 190,A00,092507,Dubnov; Shlomo,2,0,20,18
1656128993414,ECE 45,A01,083139,Congero; Spencer William,5,4,75,70
1656128999444,ECE 65,A50,083695,Saad; Andrew S,8,0,30,22
1656128999444,ECE 65,A51,095125,Staff,23,0,26,3
1656129005469,ECE 109,A01,091882,Touri; Behrouz,7,8,70,63
1656129011493,ECE 180,A00,083140,Abi Samra; Nicholas Camill,1,0,30,29
1656129011493,ECE 180,B00,083141,Abi Samra; Nicholas Camill,4,8,30,26
1656129017515,MATH 10A,A01,083735,Patchell; Gregory David,0,0,30,30
1656129017515,MATH 10A,A02,083736,Patchell; Gregory David,22,0,30,8
1656129017515,MATH 10A,A03,083737,Patchell; Gregory David,16,0,30,14
1656129023544,MATH 10B,A01,083207,Lim; Seonhee,3,3,34,31
1656129023544,MATH 10B,A02,083208,Lim; Seonhee,10,3,35,25
1656129023544,MATH 10B,A03,093472,Staff,4,3,34,30
1656129023544,MATH 10B,B01,083739,Sinha; Shubham,11,0,30,19
1656129029575,MATH 18,A01,083743,Cinel; Cameron Alexander,7,0,30,23
1656129029575,MATH 18,A02,083744,Cinel; Cameron Alexander,10,0,30,20
1656129029575,MATH 18,A03,083745,Cinel; Cameron Alexander,3,0,30,27
1656129029575,MATH 18,B01,083748,Rideout; David Porter,0,0,36,36
1656129029575,MATH 18,B02,083749,Rideout; David Porter,0,0,36,36
1656129029575,MATH 18,B03,083750,Rideout; David Porter,0,0,36,36
1656129029575,MATH 18,B04,083751,Rideout; David Porter,0,0,36,36
1656129029575,MATH 18,B05,093473,Rideout; David Porter,2,0,36,34
1656129029575,MATH 18,B06,093474,Rideout; David Porter,4,0,36,32
1656129035603,MATH 20A,A01,083754,Zheng; Zequn,11,0,40,29
1656129041626,MATH 20B,A01,083756,Briones; Jor-el Thomas Caparas,0,0,36,36
1656129041626,MATH 20B,A02,083757,Briones; Jor-el Thomas Caparas,0,0,36,36
1656129041626,MATH 20B,A03,093475,Staff,2,0,36,34
1656129047650,MATH 20C,A01,083760,Briones; Jor-el Thomas Caparas,2,2,35,33
1656129047650,MATH 20C,A02,083761,Briones; Jor-el Thomas Caparas,9,1,35,26
1656129047650,MATH 20C,A03,093476,Staff,1,1,35,34
1656129047650,MATH 20C,B01,083762,Bach; Quang Tran,1,0,30,29
1656129053675,MATH 20D,A01,083765,Tran; Brian Kha,2,0,30,28
1656129053675,MATH 20D,A02,083766,Tran; Brian Kha,0,1,30,30
1656129053675,MATH 20D,A03,083767,Tran; Brian Kha,2,0,30,28
1656129059703,MATH 20E,A01,083771,Ganguly; Soumya,4,1,32,28
1656129059703,MATH 20E,A02,083772,Ganguly; Soumya,2,2,32,30
1656129059703,MATH 20E,B01,083773,Ciotti; Benjamin,14,0,35,21
1656129059703,MATH 20E,B02,083774,Ciotti; Benjamin,14,0,35,21
1656129065736,MATH 103A,A01,083777,Greenfeld; Be'Eri,2,0,36,34
1656129065736,MATH 103A,A02,083778,Greenfeld; Be'Eri,2,0,36,34
1656129065736,MATH 103A,A03,093561,Staff,4,1,36,32
1656129065736,MATH 103A,B01,083779,Greenfeld; Be'Eri,8,1,36,28
1656129065736,MATH 103A,B02,083780,Greenfeld; Be'Eri,0,0,36,36
1656129065736,MATH 103A,B03,093562,Staff,0,0,36,36
1656129071830,MATH 105,A01,085443,Carter; Anne Toulson,4,1,35,31
1656129071830,MATH 105,A02,093477,Staff,9,0,35,26
1656129077866,MATH 109,A01,083213,Ganzberger; Geoffrey Michael,1,1,34,33
1656129077866,MATH 109,A02,083214,Ganzberger; Geoffrey Michael,0,0,34,34
1656129077866,MATH 109,A03,093478,Staff,1,0,34,33
1656129077866,MATH 109,B01,083215,Ganzberger; Geoffrey Michael,3,0,32,29
1656129077866,MATH 109,B02,083216,Ganzberger; Geoffrey Michael,1,0,32,31
1656129077866,MATH 109,B03,093479,Staff,4,0,32,28
1656129083891,MATH 142A,A01,083219,Chow; Bennett,1,0,32,31
1656129083891,MATH 142A,A02,083220,Chow; Bennett,8,0,32,24
1656129083891,MATH 142A,A03,093480,Staff,5,0,32,27
1656129083891,MATH 142A,B03,093481,Staff,4,0,32,28
1656129083891,MATH 142A,B04,093558,Staff,5,0,32,27
1656129083891,MATH 142A,B05,093559,Staff,0,0,32,32
1656129089914,MATH 193A,A01,083224,Rotar; Vladimir,1,2,34,33
1656129089914,MATH 193A,A02,083225,Rotar; Vladimir,0,0,34,34
1656129089914,MATH 193A,A03,083781,Rotar; Vladimir,1,0,34,33
1656129089914,MATH 193A,A04,083782,Rotar; Vladimir,6,0,34,28
1656129089914,MATH 193A,A05,093482,Rotar; Vladimir,1,0,34,33
1656129095938,MATH 197,001,091859,McAuley; Julian John,9999,0,9999,0
1656129095938,MATH 197,002,095566,Kedlaya; Kiran S.,9997,0,9999,2
1656129095938,MATH 197,003,095567,Xiao; Ming,9999,0,9999,0
1656129095938,MATH 197,004,095571,Perols; Johan Lars,9998,0,9999,1
1656129102991,COGS 9,A01,083615,Shannon; Kyle Michael,5,1,75,70
1656129109017,COGS 11,A01,083617,Boyle; Mary E. T.,16,2,48,32
1656129115047,COGS 13,A01,083071,Bastos; Amalia Pinkusfeld,9,3,71,62
1656129121071,COGS 14A,A01,092681,Semenuks; Arturs,8,23,100,92
1656129127098,COGS 14B,A01,083073,Cheng; Tzu-Han,7,0,63,56
1656129133129,COGS 17,A01,092677,Semenuks; Arturs,13,6,81,68
1656129139162,COGS 100,A01,083619,Allen; Michael Gordon,7,5,70,63
1656129145188,COGS 101A,A01,083621,Davis; Joshua Daniel,7,3,68,61
1656129151215,COGS 101B,A01,091572,Allen; Michael Gordon,6,0,65,59
1656129157242,COGS 101C,A01,083625,Delgado; Tania,10,0,35,25
1656129163264,COGS 107A,A01,083627,Boyle; Mary E. T.,5,4,60,55
1656129169292,COGS 118A,A01,083075,Gupta; Anjum,24,17,76,52
1656129175318,CSE 3,A50,083646,Miranda; Gregory Joseph,18,0,50,32
1656129181343,CSE 8A,A50,083650,Miranda; Gregory Joseph,13,13,56,43
1656129187365,CSE 11,A01,083080,Cao; Yingjun,1,58,40,39
1656129193387,CSE 12,A01,083652,Krause-Levy; Sophia Louisa,14,8,120,106
1656129199410,CSE 15L,A01,083654,Morris; Justin Loren,5,2,50,45
1656129199410,CSE 15L,A02,083655,Morris; Justin Loren,7,3,50,43
1656129205433,CSE 20,A01,083657,Tran; Khoa Dang,31,0,80,49
1656129211458,CSE 21,A01,095574,Bach; Quang Tran,25,0,48,23
1656129217483,CSE 30,A01,083084,Eldon; John,3,11,80,77
1656129217483,CSE 30,B01,095061,Bhaskar; Nishant,4,6,50,46
1656129223508,CSE 100,A01,083659,Cao; Yingjun,2,22,70,68
1656129229533,CSE 134B,A01,083661,Powell; Thomas Allan,11,8,100,89
1656129235559,CSE 140,A01,083663,Gungor; Onat,9,0,85,76
1656129241587,CSE 140L,A01,083088,Eldon; John,8,0,100,92
1656129247612,CSE 175,A01,083665,Kumar; Rakesh,0,0,25,25
1656129253635,CSE 190,A00,092507,Dubnov; Shlomo,2,0,20,18
1656129259662,ECE 45,A01,083139,Congero; Spencer William,5,4,75,70
1656129265695,ECE 65,A50,083695,Saad; Andrew S,8,0,30,22
1656129265695,ECE 65,A51,095125,Staff,23,0,26,3
1656129271738,ECE 109,A01,091882,Touri; Behrouz,7,8,70,63
1656129277765,ECE 180,A00,083140,Abi Samra; Nicholas Camill,1,0,30,29
1656129277765,ECE 180,B00,083141,Abi Samra; Nicholas Camill,4,8,30,26
1656129283792,MATH 10A,A01,083735,Patchell; Gregory David,0,0,30,30
1656129283792,MATH 10A,A02,083736,Patchell; Gregory David,22,0,30,8
1656129283792,MATH 10A,A03,083737,Patchell; Gregory David,16,0,30,14
1656129289820,MATH 10B,A01,083207,Lim; Seonhee,3,3,34,31
1656129289820,MATH 10B,A02,083208,Lim; Seonhee,10,3,35,25
1656129289820,MATH 10B,A03,093472,Staff,4,3,34,30
1656129289820,MATH 10B,B01,083739,Sinha; Shubham,11,0,30,19
1656129295858,MATH 18,A01,083743,Cinel; Cameron Alexander,7,0,30,23
1656129295858,MATH 18,A02,083744,Cinel; Cameron Alexander,10,0,30,20
1656129295858,MATH 18,A03,083745,Cinel; Cameron Alexander,3,0,30,27
1656129295858,MATH 18,B01,083748,Rideout; David Porter,0,0,36,36
1656129295858,MATH 18,B02,083749,Rideout; David Porter,0,0,36,36
1656129295858,MATH 18,B03,083750,Rideout; David Porter,0,0,36,36
1656129295858,MATH 18,B04,083751,Rideout; David Porter,0,0,36,36
1656129295858,MATH 18,B05,093473,Rideout; David Porter,2,0,36,34
1656129295858,MATH 18,B06,093474,Rideout; David Porter,4,0,36,32
1656129301884,MATH 20A,A01,083754,Zheng; Zequn,11,0,40,29
1656129307908,MATH 20B,A01,083756,Briones; Jor-el Thomas Caparas,0,0,36,36
1656129307908,MATH 20B,A02,083757,Briones; Jor-el Thomas Caparas,0,0,36,36
1656129307908,MATH 20B,A03,093475,Staff,2,0,36,34
1656129313936,MATH 20C,A01,083760,Briones; Jor-el Thomas Caparas,2,2,35,33
1656129313936,MATH 20C,A02,083761,Briones; Jor-el Thomas Caparas,9,1,35,26
1656129313936,MATH 20C,A03,093476,Staff,1,1,35,34
1656129313936,MATH 20C,B01,083762,Bach; Quang Tran,1,0,30,29
1656129319963,MATH 20D,A01,083765,Tran; Brian Kha,2,0,30,28
1656129319963,MATH 20D,A02,083766,Tran; Brian Kha,0,1,30,30
1656129319963,MATH 20D,A03,083767,Tran; Brian Kha,2,0,30,28
1656129325994,MATH 20E,A01,083771,Ganguly; Soumya,5,1,32,27
1656129325994,MATH 20E,A02,083772,Ganguly; Soumya,2,2,32,30
1656129325994,MATH 20E,B01,083773,Ciotti; Benjamin,14,0,35,21
1656129325994,MATH 20E,B02,083774,Ciotti; Benjamin,14,0,35,21
1656129332029,MATH 103A,A01,083777,Greenfeld; Be'Eri,2,0,36,34
1656129332029,MATH 103A,A02,083778,Greenfeld; Be'Eri,2,0,36,34
1656129332029,MATH 103A,A03,093561,Staff,4,1,36,32
1656129332029,MATH 103A,B01,083779,Greenfeld; Be'Eri,8,1,36,28
1656129332029,MATH 103A,B02,083780,Greenfeld; Be'Eri,0,1,36,36
1656129332029,MATH 103A,B03,093562,Staff,0,0,36,36
1656129338066,MATH 105,A01,085443,Carter; Anne Toulson,4,1,35,31
1656129338066,MATH 105,A02,093477,Staff,9,0,35,26
1656129344104,MATH 109,A01,083213,Ganzberger; Geoffrey Michael,1,1,34,33
1656129344104,MATH 109,A02,083214,Ganzberger; Geoffrey Michael,0,0,34,34
1656129344104,MATH 109,A03,093478,Staff,1,0,34,33
1656129344104,MATH 109,B01,083215,Ganzberger; Geoffrey Michael,3,0,32,29
1656129344104,MATH 109,B02,083216,Ganzberger; Geoffrey Michael,1,0,32,31
1656129344104,MATH 109,B03,093479,Staff,4,0,32,28
1656129350129,MATH 142A,A01,083219,Chow; Bennett,1,0,32,31
1656129350129,MATH 142A,A02,083220,Chow; Bennett,8,0,32,24
1656129350129,MATH 142A,A03,093480,Staff,5,0,32,27
1656129350129,MATH 142A,B03,093481,Staff,4,0,32,28
1656129350129,MATH 142A,B04,093558,Staff,5,0,32,27
1656129350129,MATH 142A,B05,093559,Staff,0,0,32,32
1656129356157,MATH 193A,A01,083224,Rotar; Vladimir,1,2,34,33
1656129356157,MATH 193A,A02,083225,Rotar; Vladimir,0,0,34,34
1656129356157,MATH 193A,A03,083781,Rotar; Vladimir,1,0,34,33
1656129356157,MATH 193A,A04,083782,Rotar; Vladimir,6,0,34,28
1656129356157,MATH 193A,A05,093482,Rotar; Vladimir,1,0,34,33
1656129362182,MATH 197,001,091859,McAuley; Julian John,9999,0,9999,0
1656129362182,MATH 197,002,095566,Kedlaya; Kiran S.,9997,0,9999,2
1656129362182,MATH 197,003,095567,Xiao; Ming,9999,0,9999,0
1656129362182,MATH 197,004,095571,Perols; Johan Lars,9998,0,9999,1
1656129369242,COGS 9,A01,083615,Shannon; Kyle Michael,5,1,75,70
1656129375274,COGS 11,A01,083617,Boyle; Mary E. T.,16,2,48,32
1656129381300,COGS 13,A01,083071,Bastos; Amalia Pinkusfeld,9,3,71,62
1656129387323,COGS 14A,A01,092681,Semenuks; Arturs,8,23,100,92
1656129393347,COGS 14B,A01,083073,Cheng; Tzu-Han,7,0,63,56
1656129399370,COGS 17,A01,092677,Semenuks; Arturs,13,6,81,68
1656129405398,COGS 100,A01,083619,Allen; Michael Gordon,7,5,70,63
1656129411419,COGS 101A,A01,083621,Davis; Joshua Daniel,7,3,68,61
1656129417447,COGS 101B,A01,091572,Allen; Michael Gordon,6,0,65,59
1656129423473,COGS 101C,A01,083625,Delgado; Tania,10,0,35,25
1656129429496,COGS 107A,A01,083627,Boyle; Mary E. T.,5,4,60,55
1656129435518,COGS 118A,A01,083075,Gupta; Anjum,24,17,76,52
1656129441542,CSE 3,A50,083646,Miranda; Gregory Joseph,18,0,50,32
1656129447566,CSE 8A,A50,083650,Miranda; Gregory Joseph,13,13,56,43
1656129453593,CSE 11,A01,083080,Cao; Yingjun,1,58,40,39
1656129459616,CSE 12,A01,083652,Krause-Levy; Sophia Louisa,14,8,120,106
1656129465643,CSE 15L,A01,083654,Morris; Justin Loren,5,2,50,45
1656129465643,CSE 15L,A02,083655,Morris; Justin Loren,7,3,50,43
1656129471669,CSE 20,A01,083657,Tran; Khoa Dang,31,0,80,49
1656129477691,CSE 21,A01,095574,Bach; Quang Tran,25,0,48,23
1656129483719,CSE 30,A01,083084,Eldon; John,3,11,80,77
1656129483719,CSE 30,B01,095061,Bhaskar; Nishant,4,6,50,46
1656129489746,CSE 100,A01,083659,Cao; Yingjun,2,22,70,68
1656129495771,CSE 134B,A01,083661,Powell; Thomas Allan,11,8,100,89
1656129501795,CSE 140,A01,083663,Gungor; Onat,9,0,85,76
1656129507816,CSE 140L,A01,083088,Eldon; John,8,0,100,92
1656129513843,CSE 175,A01,083665,Kumar; Rakesh,0,0,25,25
1656129519864,CSE 190,A00,092507,Dubnov; Shlomo,2,0,20,18
1656129525889,ECE 45,A01,083139,Congero; Spencer William,5,4,75,70
1656129531917,ECE 65,A50,083695,Saad; Andrew S,8,0,30,22
1656129531917,ECE 65,A51,095125,Staff,23,0,26,3
1656129537940,ECE 109,A01,091882,Touri; Behrouz,7,8,70,63
1656129543966,ECE 180,A00,083140,Abi Samra; Nicholas Camill,1,0,30,29
1656129543966,ECE 180,B00,083141,Abi Samra; Nicholas Camill,4,8,30,26
1656129549992,MATH 10A,A01,083735,Patchell; Gregory David,0,0,30,30
1656129549992,MATH 10A,A02,083736,Patchell; Gregory David,22,0,30,8
1656129549992,MATH 10A,A03,083737,Patchell; Gregory David,16,0,30,14
1656129556015,MATH 10B,A01,083207,Lim; Seonhee,3,3,34,31
1656129556015,MATH 10B,A02,083208,Lim; Seonhee,10,3,35,25
1656129556015,MATH 10B,A03,093472,Staff,4,3,34,30
1656129556015,MATH 10B,B01,083739,Sinha; Shubham,11,0,30,19
1656129562054,MATH 18,A01,083743,Cinel; Cameron Alexander,7,0,30,23
1656129562054,MATH 18,A02,083744,Cinel; Cameron Alexander,10,0,30,20
1656129562054,MATH 18,A03,083745,Cinel; Cameron Alexander,3,0,30,27
1656129562054,MATH 18,B01,083748,Rideout; David Porter,0,0,36,36
1656129562054,MATH 18,B02,083749,Rideout; David Porter,0,0,36,36
1656129562054,MATH 18,B03,083750,Rideout; David Porter,0,0,36,36
1656129562054,MATH 18,B04,083751,Rideout; David Porter,0,0,36,36
1656129562054,MATH 18,B05,093473,Rideout; David Porter,2,0,36,34
1656129562054,MATH 18,B06,093474,Rideout; David Porter,4,0,36,32
1656129568078,MATH 20A,A01,083754,Zheng; Zequn,11,0,40,29
1656129574106,MATH 20B,A01,083756,Briones; Jor-el Thomas Caparas,0,0,36,36
1656129574106,MATH 20B,A02,083757,Briones; Jor-el Thomas Caparas,0,0,36,36
1656129574106,MATH 20B,A03,093475,Staff,2,0,36,34
1656129580130,MATH 20C,A01,083760,Briones; Jor-el Thomas Caparas,2,2,35,33
1656129580130,MATH 20C,A02,083761,Briones; Jor-el Thomas Caparas,9,1,35,26
1656129580130,MATH 20C,A03,093476,Staff,1,1,35,34
1656129580130,MATH 20C,B01,083762,Bach; Quang Tran,1,0,30,29
1656129586159,MATH 20D,A01,083765,Tran; Brian Kha,2,0,30,28
1656129586159,MATH 20D,A02,083766,Tran; Brian Kha,0,1,30,30
1656129586159,MATH 20D,A03,083767,Tran; Brian Kha,2,0,30,28
1656129592189,MATH 20E,A01,083771,Ganguly; Soumya,5,1,32,27
1656129592189,MATH 20E,A02,083772,Ganguly; Soumya,2,2,32,30
1656129592189,MATH 20E,B01,083773,Ciotti; Benjamin,14,0,35,21
1656129592189,MATH 20E,B02,083774,Ciotti; Benjamin,14,0,35,21
1656129598216,MATH 103A,A01,083777,Greenfeld; Be'Eri,2,0,36,34
1656129598216,MATH 103A,A02,083778,Greenfeld; Be'Eri,2,0,36,34
1656129598216,MATH 103A,A03,093561,Staff,4,1,36,32
1656129598216,MATH 103A,B01,083779,Greenfeld; Be'Eri,8,1,36,28
1656129598216,MATH 103A,B02,083780,Greenfeld; Be'Eri,0,1,36,36
1656129598216,MATH 103A,B03,093562,Staff,0,0,36,36
1656129604239,MATH 105,A01,085443,Carter; Anne Toulson,4,1,35,31
1656129604239,MATH 105,A02,093477,Staff,9,0,35,26
1656129610268,MATH 109,A01,083213,Ganzberger; Geoffrey Michael,1,1,34,33
1656129610268,MATH 109,A02,083214,Ganzberger; Geoffrey Michael,0,0,34,34
1656129610268,MATH 109,A03,093478,Staff,1,0,34,33
1656129610268,MATH 109,B01,083215,Ganzberger; Geoffrey Michael,3,0,32,29
1656129610268,MATH 109,B02,083216,Ganzberger; Geoffrey Michael,1,0,32,31
1656129610268,MATH 109,B03,093479,Staff,4,0,32,28
1656129616294,MATH 142A,A01,083219,Chow; Bennett,1,0,32,31
1656129616294,MATH 142A,A02,083220,Chow; Bennett,8,0,32,24
1656129616294,MATH 142A,A03,093480,Staff,5,0,32,27
1656129616294,MATH 142A,B03,093481,Staff,4,0,32,28
1656129616294,MATH 142A,B04,093558,Staff,5,0,32,27
1656129616294,MATH 142A,B05,093559,Staff,0,0,32,32
1656129622317,MATH 193A,A01,083224,Rotar; Vladimir,1,2,34,33
1656129622317,MATH 193A,A02,083225,Rotar; Vladimir,0,0,34,34
1656129622317,MATH 193A,A03,083781,Rotar; Vladimir,1,0,34,33
1656129622317,MATH 193A,A04,083782,Rotar; Vladimir,6,0,34,28
1656129622317,MATH 193A,A05,093482,Rotar; Vladimir,1,0,34,33
1656129628338,MATH 197,001,091859,McAuley; Julian John,9999,0,9999,0
1656129628338,MATH 197,002,095566,Kedlaya; Kiran S.,9997,0,9999,2
1656129628338,MATH 197,003,095567,Xiao; Ming,9999,0,9999,0
1656129628338,MATH 197,004,095571,Perols; Johan Lars,9998,0,9999,1
1656129635388,COGS 9,A01,083615,Shannon; Kyle Michael,5,1,75,70
1656129641415,COGS 11,A01,083617,Boyle; Mary E. T.,16,2,48,32
1656129647439,COGS 13,A01,083071,Bastos; Amalia Pinkusfeld,9,3,71,62
1656129653463,COGS 14A,A01,092681,Semenuks; Arturs,8,23,100,92
1656129659533,COGS 14B,A01,083073,Cheng; Tzu-Han,7,0,63,56
1656129665631,COGS 17,A01,092677,Semenuks; Arturs,13,6,81,68
1656129671655,COGS 100,A01,083619,Allen; Michael Gordon,7,5,70,63
1656129677679,COGS 101A,A01,083621,Davis; Joshua Daniel,7,3,68,61
1656129683705,COGS 101B,A01,091572,Allen; Michael Gordon,6,0,65,59
1656129689731,COGS 101C,A01,083625,Delgado; Tania,10,0,35,25
1656129695754,COGS 107A,A01,083627,Boyle; Mary E. T.,5,4,60,55
1656129701779,COGS 118A,A01,083075,Gupta; Anjum,24,17,76,52
1656129707821,CSE 3,A50,083646,Miranda; Gregory Joseph,18,0,50,32
1656129713845,CSE 8A,A50,083650,Miranda; Gregory Joseph,13,13,56,43
1656129719869,CSE 11,A01,083080,Cao; Yingjun,1,58,40,39
1656129725896,CSE 12,A01,083652,Krause-Levy; Sophia Louisa,14,8,120,106
1656129731923,CSE 15L,A01,083654,Morris; Justin Loren,5,2,50,45
1656129731923,CSE 15L,A02,083655,Morris; Justin Loren,7,3,50,43
1656129737947,CSE 20,A01,083657,Tran; Khoa Dang,31,0,80,49
1656129743976,CSE 21,A01,095574,Bach; Quang Tran,25,0,48,23
1656129750002,CSE 30,A01,083084,Eldon; John,3,11,80,77
1656129750002,CSE 30,B01,095061,Bhaskar; Nishant,4,6,50,46
1656129756025,CSE 100,A01,083659,Cao; Yingjun,2,22,70,68
1656129762060,CSE 134B,A01,083661,Powell; Thomas Allan,11,8,100,89
1656129768085,CSE 140,A01,083663,Gungor; Onat,9,0,85,76
1656129774116,CSE 140L,A01,083088,Eldon; John,8,0,100,92
1656129780139,CSE 175,A01,083665,Kumar; Rakesh,0,0,25,25
1656129786163,CSE 190,A00,092507,Dubnov; Shlomo,2,0,20,18
1656129792185,ECE 45,A01,083139,Congero; Spencer William,5,4,75,70
1656129798212,ECE 65,A50,083695,Saad; Andrew S,8,0,30,22
1656129798212,ECE 65,A51,095125,Staff,23,0,26,3
1656129804238,ECE 109,A01,091882,Touri; Behrouz,7,8,70,63
1656129810261,ECE 180,A00,083140,Abi Samra; Nicholas Camill,1,0,30,29
1656129810261,ECE 180,B00,083141,Abi Samra; Nicholas Camill,4,8,30,26
1656129816286,MATH 10A,A01,083735,Patchell; Gregory David,0,0,30,30
1656129816286,MATH 10A,A02,083736,Patchell; Gregory David,22,0,30,8
1656129816286,MATH 10A,A03,083737,Patchell; Gregory David,16,0,30,14
1656129822312,MATH 10B,A01,083207,Lim; Seonhee,3,3,34,31
1656129822312,MATH 10B,A02,083208,Lim; Seonhee,10,3,35,25
1656129822312,MATH 10B,A03,093472,Staff,4,3,34,30
1656129822312,MATH 10B,B01,083739,Sinha; Shubham,11,0,30,19
1656129828338,MATH 18,A01,083743,Cinel; Cameron Alexander,7,0,30,23
1656129828338,MATH 18,A02,083744,Cinel; Cameron Alexander,10,0,30,20
1656129828338,MATH 18,A03,083745,Cinel; Cameron Alexander,3,0,30,27
1656129828338,MATH 18,B01,083748,Rideout; David Porter,0,0,36,36
1656129828338,MATH 18,B02,083749,Rideout; David Porter,0,0,36,36
1656129828338,MATH 18,B03,083750,Rideout; David Porter,0,0,36,36
1656129828338,MATH 18,B04,083751,Rideout; David Porter,0,0,36,36
1656129828338,MATH 18,B05,093473,Rideout; David Porter,2,0,36,34
1656129828338,MATH 18,B06,093474,Rideout; David Porter,4,0,36,32
1656129834364,MATH 20A,A01,083754,Zheng; Zequn,11,0,40,29
1656129840385,MATH 20B,A01,083756,Briones; Jor-el Thomas Caparas,0,0,36,36
1656129840385,MATH 20B,A02,083757,Briones; Jor-el Thomas Caparas,0,0,36,36
1656129840385,MATH 20B,A03,093475,Staff,2,0,36,34
1656129846420,MATH 20C,A01,083760,Briones; Jor-el Thomas Caparas,2,2,35,33
1656129846420,MATH 20C,A02,083761,Briones; Jor-el Thomas Caparas,9,1,35,26
1656129846420,MATH 20C,A03,093476,Staff,1,1,35,34
1656129846420,MATH 20C,B01,083762,Bach; Quang Tran,1,0,30,29
1656129852450,MATH 20D,A01,083765,Tran; Brian Kha,2,0,30,28
1656129852450,MATH 20D,A02,083766,Tran; Brian Kha,0,1,30,30
1656129852450,MATH 20D,A03,083767,Tran; Brian Kha,2,0,30,28
1656129858473,MATH 20E,A01,083771,Ganguly; Soumya,5,1,32,27
1656129858473,MATH 20E,A02,083772,Ganguly; Soumya,2,2,32,30
1656129858473,MATH 20E,B01,083773,Ciotti; Benjamin,14,0,35,21
1656129858473,MATH 20E,B02,083774,Ciotti; Benjamin,14,0,35,21
1656129864496,MATH 103A,A01,083777,Greenfeld; Be'Eri,2,0,36,34
1656129864496,MATH 103A,A02,083778,Greenfeld; Be'Eri,2,0,36,34
1656129864496,MATH 103A,A03,093561,Staff,4,1,36,32
1656129864496,MATH 103A,B01,083779,Greenfeld; Be'Eri,8,1,36,28
1656129864496,MATH 103A,B02,083780,Greenfeld; Be'Eri,0,1,36,36
1656129864496,MATH 103A,B03,093562,Staff,0,0,36,36
1656129870520,MATH 105,A01,085443,Carter; Anne Toulson,4,1,35,31
1656129870520,MATH 105,A02,093477,Staff,9,0,35,26
1656129876544,MATH 109,A01,083213,Ganzberger; Geoffrey Michael,1,1,34,33
1656129876544,MATH 109,A02,083214,Ganzberger; Geoffrey Michael,0,0,34,34
1656129876544,MATH 109,A03,093478,Staff,1,0,34,33
1656129876544,MATH 109,B01,083215,Ganzberger; Geoffrey Michael,3,0,32,29
1656129876544,MATH 109,B02,083216,Ganzberger; Geoffrey Michael,1,0,32,31
1656129876544,MATH 109,B03,093479,Staff,4,0,32,28
1656129882567,MATH 142A,A01,083219,Chow; Bennett,1,0,32,31
1656129882567,MATH 142A,A02,083220,Chow; Bennett,8,0,32,24
1656129882567,MATH 142A,A03,093480,Staff,5,0,32,27
1656129882567,MATH 142A,B03,093481,Staff,4,0,32,28
1656129882567,MATH 142A,B04,093558,Staff,5,0,32,27
1656129882567,MATH 142A,B05,093559,Staff,0,0,32,32
1656129888593,MATH 193A,A01,083224,Rotar; Vladimir,1,2,34,33
1656129888593,MATH 193A,A02,083225,Rotar; Vladimir,0,0,34,34
1656129888593,MATH 193A,A03,083781,Rotar; Vladimir,1,0,34,33
1656129888593,MATH 193A,A04,083782,Rotar; Vladimir,6,0,34,28
1656129888593,MATH 193A,A05,093482,Rotar; Vladimir,1,0,34,33
1656129894620,MATH 197,001,091859,McAuley; Julian John,9999,0,9999,0
1656129894620,MATH 197,002,095566,Kedlaya; Kiran S.,9997,0,9999,2
1656129894620,MATH 197,003,095567,Xiao; Ming,9999,0,9999,0
1656129894620,MATH 197,004,095571,Perols; Johan Lars,9998,0,9999,1
1656129901676,COGS 9,A01,083615,Shannon; Kyle Michael,5,1,75,70
1656129907698,COGS 11,A01,083617,Boyle; Mary E. T.,16,2,48,32
1656129913725,COGS 13,A01,083071,Bastos; Amalia Pinkusfeld,9,3,71,62
1656129919754,COGS 14A,A01,092681,Semenuks; Arturs,8,23,100,92
1656129925776,COGS 14B,A01,083073,Cheng; Tzu-Han,7,0,63,56
1656129931805,COGS 17,A01,092677,Semenuks; Arturs,13,6,81,68
1656129937826,COGS 100,A01,083619,Allen; Michael Gordon,7,5,70,63
1656129943853,COGS 101A,A01,083621,Davis; Joshua Daniel,7,3,68,61
1656129949878,COGS 101B,A01,091572,Allen; Michael Gordon,6,0,65,59
1656129955903,COGS 101C,A01,083625,Delgado; Tania,10,0,35,25
1656129961930,COGS 107A,A01,083627,Boyle; Mary E. T.,5,4,60,55
1656129967957,COGS 118A,A01,083075,Gupta; Anjum,24,17,76,52
1656129973988,CSE 3,A50,083646,Miranda; Gregory Joseph,18,0,50,32
1656129980012,CSE 8A,A50,083650,Miranda; Gregory Joseph,13,13,56,43
1656129986040,CSE 11,A01,083080,Cao; Yingjun,1,58,40,39
1656129992064,CSE 12,A01,083652,Krause-Levy; Sophia Louisa,14,8,120,106
1656129998087,CSE 15L,A01,083654,Morris; Justin Loren,5,2,50,45
1656129998087,CSE 15L,A02,083655,Morris; Justin Loren,7,3,50,43
1656130004114,CSE 20,A01,083657,Tran; Khoa Dang,31,0,80,49
1656130010144,CSE 21,A01,095574,Bach; Quang Tran,25,0,48,23
1656130016171,CSE 30,A01,083084,Eldon; John,3,11,80,77
1656130016171,CSE 30,B01,095061,Bhaskar; Nishant,4,6,50,46
1656130022195,CSE 100,A01,083659,Cao; Yingjun,2,22,70,68
1656130028223,CSE 134B,A01,083661,Powell; Thomas Allan,11,8,100,89
1656130034249,CSE 140,A01,083663,Gungor; Onat,9,0,85,76
1656130040281,CSE 140L,A01,083088,Eldon; John,8,0,100,92
1656130046309,CSE 175,A01,083665,Kumar; Rakesh,0,0,25,25
1656130052336,CSE 190,A00,092507,Dubnov; Shlomo,2,0,20,18
1656130058364,ECE 45,A01,083139,Congero; Spencer William,5,4,75,70
1656130064400,ECE 65,A50,083695,Saad; Andrew S,8,0,30,22
1656130064400,ECE 65,A51,095125,Staff,23,0,26,3
1656130070423,ECE 109,A01,091882,Touri; Behrouz,7,8,70,63
1656130076447,ECE 180,A00,083140,Abi Samra; Nicholas Camill,1,0,30,29
1656130076447,ECE 180,B00,083141,Abi Samra; Nicholas Camill,4,8,30,26
1656130082474,MATH 10A,A01,083735,Patchell; Gregory David,0,0,30,30
1656130082474,MATH 10A,A02,083736,Patchell; Gregory David,22,0,30,8
1656130082474,MATH 10A,A03,083737,Patchell; Gregory David,16,0,30,14
1656130088501,MATH 10B,A01,083207,Lim; Seonhee,3,3,34,31
1656130088501,MATH 10B,A02,083208,Lim; Seonhee,10,3,35,25
1656130088501,MATH 10B,A03,093472,Staff,4,3,34,30
1656130088501,MATH 10B,B01,083739,Sinha; Shubham,11,0,30,19
1656130094525,MATH 18,A01,083743,Cinel; Cameron Alexander,7,0,30,23
1656130094525,MATH 18,A02,083744,Cinel; Cameron Alexander,10,0,30,20
1656130094525,MATH 18,A03,083745,Cinel; Cameron Alexander,3,0,30,27
1656130094525,MATH 18,B01,083748,Rideout; David Porter,0,0,36,36
1656130094525,MATH 18,B02,083749,Rideout; David Porter,0,0,36,36
1656130094525,MATH 18,B03,083750,Rideout; David Porter,0,0,36,36
1656130094525,MATH 18,B04,083751,Rideout; David Porter,0,0,36,36
1656130094525,MATH 18,B05,093473,Rideout; David Porter,2,0,36,34
1656130094525,MATH 18,B06,093474,Rideout; David Porter,4,0,36,32
1656130100551,MATH 20A,A01,083754,Zheng; Zequn,11,0,40,29
1656130106579,MATH 20B,A01,083756,Briones; Jor-el Thomas Caparas,0,0,36,36
1656130106579,MATH 20B,A02,083757,Briones; Jor-el Thomas Caparas,0,0,36,36
1656130106579,MATH 20B,A03,093475,Staff,2,0,36,34
1656130112604,MATH 20C,A01,083760,Briones; Jor-el Thomas Caparas,2,2,35,33
1656130112604,MATH 20C,A02,083761,Briones; Jor-el Thomas Caparas,9,1,35,26
1656130112604,MATH 20C,A03,093476,Staff,1,1,35,34
1656130112604,MATH 20C,B01,083762,Bach; Quang Tran,1,0,30,29
1656130118628,MATH 20D,A01,083765,Tran; Brian Kha,2,0,30,28
1656130118628,MATH 20D,A02,083766,Tran; Brian Kha,0,1,30,30
1656130118628,MATH 20D,A03,083767,Tran; Brian Kha,2,0,30,28
1656130124657,MATH 20E,A01,083771,Ganguly; Soumya,5,1,32,27
1656130124657,MATH 20E,A02,083772,Ganguly; Soumya,2,2,32,30
1656130124657,MATH 20E,B01,083773,Ciotti; Benjamin,14,0,35,21
1656130124657,MATH 20E,B02,083774,Ciotti; Benjamin,14,0,35,21
1656130130691,MATH 103A,A01,083777,Greenfeld; Be'Eri,2,0,36,34
1656130130691,MATH 103A,A02,083778,Greenfeld; Be'Eri,2,0,36,34
1656130130691,MATH 103A,A03,093561,Staff,4,1,36,32
1656130130691,MATH 103A,B01,083779,Greenfeld; Be'Eri,8,1,36,28
1656130130691,MATH 103A,B02,083780,Greenfeld; Be'Eri,0,1,36,36
1656130130691,MATH 103A,B03,093562,Staff,0,0,36,36
1656130136720,MATH 105,A01,085443,Carter; Anne Toulson,4,1,35,31
1656130136720,MATH 105,A02,093477,Staff,9,0,35,26
1656130142752,MATH 109,A01,083213,Ganzberger; Geoffrey Michael,1,1,34,33
1656130142752,MATH 109,A02,083214,Ganzberger; Geoffrey Michael,0,0,34,34
1656130142752,MATH 109,A03,093478,Staff,1,0,34,33
1656130142752,MATH 109,B01,083215,Ganzberger; Geoffrey Michael,3,0,32,29
1656130142752,MATH 109,B02,083216,Ganzberger; Geoffrey Michael,1,0,32,31
1656130142752,MATH 109,B03,093479,Staff,4,0,32,28
1656130148776,MATH 142A,A01,083219,Chow; Bennett,1,0,32,31
1656130148776,MATH 142A,A02,083220,Chow; Bennett,8,0,32,24
1656130148776,MATH 142A,A03,093480,Staff,5,0,32,27
1656130148776,MATH 142A,B03,093481,Staff,4,0,32,28
1656130148776,MATH 142A,B04,093558,Staff,5,0,32,27
1656130148776,MATH 142A,B05,093559,Staff,0,0,32,32
1656130154800,MATH 193A,A01,083224,Rotar; Vladimir,1,2,34,33
1656130154800,MATH 193A,A02,083225,Rotar; Vladimir,0,0,34,34
1656130154800,MATH 193A,A03,083781,Rotar; Vladimir,1,0,34,33
1656130154800,MATH 193A,A04,083782,Rotar; Vladimir,6,0,34,28
1656130154800,MATH 193A,A05,093482,Rotar; Vladimir,1,0,34,33
1656130160823,MATH 197,001,091859,McAuley; Julian John,9999,0,9999,0
1656130160823,MATH 197,002,095566,Kedlaya; Kiran S.,9997,0,9999,2
1656130160823,MATH 197,003,095567,Xiao; Ming,9999,0,9999,0
1656130160823,MATH 197,004,095571,Perols; Johan Lars,9998,0,9999,1
1656130167890,COGS 9,A01,083615,Shannon; Kyle Michael,5,1,75,70
1656130173916,COGS 11,A01,083617,Boyle; Mary E. T.,16,2,48,32
1656130179946,COGS 13,A01,083071,Bastos; Amalia Pinkusfeld,9,3,71,62
1656130185973,COGS 14A,A01,092681,Semenuks; Arturs,8,23,100,92
1656130192000,COGS 14B,A01,083073,Cheng; Tzu-Han,7,0,63,56
1656130198022,COGS 17,A01,092677,Semenuks; Arturs,13,6,81,68
1656130204055,COGS 100,A01,083619,Allen; Michael Gordon,7,5,70,63
1656130210078,COGS 101A,A01,083621,Davis; Joshua Daniel,7,3,68,61
1656130216107,COGS 101B,A01,091572,Allen; Michael Gordon,6,0,65,59
1656130222135,COGS 101C,A01,083625,Delgado; Tania,10,0,35,25
1656130228159,COGS 107A,A01,083627,Boyle; Mary E. T.,5,4,60,55
1656130234182,COGS 118A,A01,083075,Gupta; Anjum,24,17,76,52
1656130240205,CSE 3,A50,083646,Miranda; Gregory Joseph,18,0,50,32
1656130246228,CSE 8A,A50,083650,Miranda; Gregory Joseph,13,13,56,43
1656130252252,CSE 11,A01,083080,Cao; Yingjun,1,58,40,39
1656130258291,CSE 12,A01,083652,Krause-Levy; Sophia Louisa,14,8,120,106
1656130264390,CSE 15L,A01,083654,Morris; Justin Loren,5,2,50,45
1656130264390,CSE 15L,A02,083655,Morris; Justin Loren,7,3,50,43
1656130270425,CSE 20,A01,083657,Tran; Khoa Dang,31,0,80,49
1656130276447,CSE 21,A01,095574,Bach; Quang Tran,25,0,48,23
1656130282475,CSE 30,A01,083084,Eldon; John,3,11,80,77
1656130282475,CSE 30,B01,095061,Bhaskar; Nishant,4,6,50,46
1656130288497,CSE 100,A01,083659,Cao; Yingjun,2,22,70,68
1656130294522,CSE 134B,A01,083661,Powell; Thomas Allan,11,8,100,89
1656130300544,CSE 140,A01,083663,Gungor; Onat,9,0,85,76
1656130306565,CSE 140L,A01,083088,Eldon; John,8,0,100,92
1656130312592,CSE 175,A01,083665,Kumar; Rakesh,0,0,25,25
1656130318613,CSE 190,A00,092507,Dubnov; Shlomo,2,0,20,18
1656130324636,ECE 45,A01,083139,Congero; Spencer William,5,4,75,70
1656130330659,ECE 65,A50,083695,Saad; Andrew S,8,0,30,22
1656130330659,ECE 65,A51,095125,Staff,23,0,26,3
1656130336682,ECE 109,A01,091882,Touri; Behrouz,7,8,70,63
1656130342706,ECE 180,A00,083140,Abi Samra; Nicholas Camill,1,0,30,29
1656130342706,ECE 180,B00,083141,Abi Samra; Nicholas Camill,4,8,30,26
1656130348732,MATH 10A,A01,083735,Patchell; Gregory David,0,0,30,30
1656130348732,MATH 10A,A02,083736,Patchell; Gregory David,22,0,30,8
1656130348732,MATH 10A,A03,083737,Patchell; Gregory David,16,0,30,14
1656130354759,MATH 10B,A01,083207,Lim; Seonhee,3,3,34,31
1656130354759,MATH 10B,A02,083208,Lim; Seonhee,10,3,35,25
1656130354759,MATH 10B,A03,093472,Staff,4,3,34,30
1656130354759,MATH 10B,B01,083739,Sinha; Shubham,11,0,30,19
1656130360790,MATH 18,A01,083743,Cinel; Cameron Alexander,7,0,30,23
1656130360790,MATH 18,A02,083744,Cinel; Cameron Alexander,10,0,30,20
1656130360790,MATH 18,A03,083745,Cinel; Cameron Alexander,3,0,30,27
1656130360790,MATH 18,B01,083748,Rideout; David Porter,0,0,36,36
1656130360790,MATH 18,B02,083749,Rideout; David Porter,0,0,36,36
1656130360790,MATH 18,B03,083750,Rideout; David Porter,0,0,36,36
1656130360790,MATH 18,B04,083751,Rideout; David Porter,0,0,36,36
1656130360790,MATH 18,B05,093473,Rideout; David Porter,2,0,36,34
1656130360790,MATH 18,B06,093474,Rideout; David Porter,4,0,36,32
1656130366814,MATH 20A,A01,083754,Zheng; Zequn,11,0,40,29
1656130372840,MATH 20B,A01,083756,Briones; Jor-el Thomas Caparas,0,0,36,36
1656130372840,MATH 20B,A02,083757,Briones; Jor-el Thomas Caparas,0,0,36,36
1656130372840,MATH 20B,A03,093475,Staff,2,0,36,34
1656130378867,MATH 20C,A01,083760,Briones; Jor-el Thomas Caparas,2,2,35,33
1656130378867,MATH 20C,A02,083761,Briones; Jor-el Thomas Caparas,9,1,35,26
1656130378867,MATH 20C,A03,093476,Staff,1,1,35,34
1656130378867,MATH 20C,B01,083762,Bach; Quang Tran,1,0,30,29
1656130384892,MATH 20D,A01,083765,Tran; Brian Kha,2,0,30,28
1656130384892,MATH 20D,A02,083766,Tran; Brian Kha,0,1,30,30
1656130384892,MATH 20D,A03,083767,Tran; Brian Kha,2,0,30,28
1656130390920,MATH 20E,A01,083771,Ganguly; Soumya,5,1,32,27
1656130390920,MATH 20E,A02,083772,Ganguly; Soumya,2,2,32,30
1656130390920,MATH 20E,B01,083773,Ciotti; Benjamin,14,0,35,21
1656130390920,MATH 20E,B02,083774,Ciotti; Benjamin,14,0,35,21
1656130396945,MATH 103A,A01,083777,Greenfeld; Be'Eri,2,0,36,34
1656130396945,MATH 103A,A02,083778,Greenfeld; Be'Eri,2,0,36,34
1656130396945,MATH 103A,A03,093561,Staff,4,1,36,32
1656130396945,MATH 103A,B01,083779,Greenfeld; Be'Eri,8,1,36,28
1656130396945,MATH 103A,B02,083780,Greenfeld; Be'Eri,0,1,36,36
1656130396945,MATH 103A,B03,093562,Staff,0,0,36,36
1656130402972,MATH 105,A01,085443,Carter; Anne Toulson,4,1,35,31
1656130402972,MATH 105,A02,093477,Staff,9,0,35,26
1656130408995,MATH 109,A01,083213,Ganzberger; Geoffrey Michael,1,1,34,33
1656130408995,MATH 109,A02,083214,Ganzberger; Geoffrey Michael,0,0,34,34
1656130408995,MATH 109,A03,093478,Staff,1,0,34,33
1656130408995,MATH 109,B01,083215,Ganzberger; Geoffrey Michael,3,0,32,29
1656130408995,MATH 109,B02,083216,Ganzberger; Geoffrey Michael,1,0,32,31
1656130408995,MATH 109,B03,093479,Staff,4,0,32,28
1656130415019,MATH 142A,A01,083219,Chow; Bennett,1,0,32,31
1656130415019,MATH 142A,A02,083220,Chow; Bennett,8,0,32,24
1656130415019,MATH 142A,A03,093480,Staff,5,0,32,27
1656130415019,MATH 142A,B03,093481,Staff,4,0,32,28
1656130415019,MATH 142A,B04,093558,Staff,5,0,32,27
1656130415019,MATH 142A,B05,093559,Staff,0,0,32,32
1656130421043,MATH 193A,A01,083224,Rotar; Vladimir,1,2,34,33
1656130421043,MATH 193A,A02,083225,Rotar; Vladimir,0,0,34,34
1656130421043,MATH 193A,A03,083781,Rotar; Vladimir,1,0,34,33
1656130421043,MATH 193A,A04,083782,Rotar; Vladimir,6,0,34,28
1656130421043,MATH 193A,A05,093482,Rotar; Vladimir,1,0,34,33
1656130427066,MATH 197,001,091859,McAuley; Julian John,9999,0,9999,0
1656130427066,MATH 197,002,095566,Kedlaya; Kiran S.,9997,0,9999,2
1656130427066,MATH 197,003,095567,Xiao; Ming,9999,0,9999,0
1656130427066,MATH 197,004,095571,Perols; Johan Lars,9998,0,9999,1
1656130434155,COGS 9,A01,083615,Shannon; Kyle Michael,5,1,75,70
1656130440182,COGS 11,A01,083617,Boyle; Mary E. T.,16,2,48,32
1656130446220,COGS 13,A01,083071,Bastos; Amalia Pinkusfeld,9,3,71,62
1656130452247,COGS 14A,A01,092681,Semenuks; Arturs,8,23,100,92
1656130458273,COGS 14B,A01,083073,Cheng; Tzu-Han,7,0,63,56
1656130464297,COGS 17,A01,092677,Semenuks; Arturs,13,6,81,68
1656130470320,COGS 100,A01,083619,Allen; Michael Gordon,7,5,70,63
1656130476345,COGS 101A,A01,083621,Davis; Joshua Daniel,7,4,68,61
1656130482367,COGS 101B,A01,091572,Allen; Michael Gordon,6,0,65,59
1656130488391,COGS 101C,A01,083625,Delgado; Tania,10,0,35,25
1656130494414,COGS 107A,A01,083627,Boyle; Mary E. T.,5,4,60,55
1656130500439,COGS 118A,A01,083075,Gupta; Anjum,24,17,76,52
1656130506477,CSE 3,A50,083646,Miranda; Gregory Joseph,18,0,50,32
1656130512510,CSE 8A,A50,083650,Miranda; Gregory Joseph,13,13,56,43
1656130518534,CSE 11,A01,083080,Cao; Yingjun,2,58,40,38
1656130524568,CSE 12,A01,083652,Krause-Levy; Sophia Louisa,14,8,120,106
1656130530595,CSE 15L,A01,083654,Morris; Justin Loren,5,2,50,45
1656130530595,CSE 15L,A02,083655,Morris; Justin Loren,7,3,50,43
1656130536620,CSE 20,A01,083657,Tran; Khoa Dang,31,0,80,49
1656130542645,CSE 21,A01,095574,Bach; Quang Tran,25,0,48,23
1656130548673,CSE 30,A01,083084,Eldon; John,3,11,80,77
1656130548673,CSE 30,B01,095061,Bhaskar; Nishant,4,6,50,46
1656130554701,CSE 100,A01,083659,Cao; Yingjun,2,22,70,68
1656130560727,CSE 134B,A01,083661,Powell; Thomas Allan,11,8,100,89
1656130566762,CSE 140,A01,083663,Gungor; Onat,9,0,85,76
1656130572789,CSE 140L,A01,083088,Eldon; John,8,0,100,92
1656130578813,CSE 175,A01,083665,Kumar; Rakesh,0,0,25,25
1656130584839,CSE 190,A00,092507,Dubnov; Shlomo,2,0,20,18
1656130590864,ECE 45,A01,083139,Congero; Spencer William,5,4,75,70
1656130596895,ECE 65,A50,083695,Saad; Andrew S,8,0,30,22
1656130596895,ECE 65,A51,095125,Staff,23,0,26,3
1656130602923,ECE 109,A01,091882,Touri; Behrouz,7,8,70,63
1656130608948,ECE 180,A00,083140,Abi Samra; Nicholas Camill,1,0,30,29
1656130608948,ECE 180,B00,083141,Abi Samra; Nicholas Camill,4,8,30,26
1656130614971,MATH 10A,A01,083735,Patchell; Gregory David,0,0,30,30
1656130614971,MATH 10A,A02,083736,Patchell; Gregory David,22,0,30,8
1656130614971,MATH 10A,A03,083737,Patchell; Gregory David,16,0,30,14
1656130620996,MATH 10B,A01,083207,Lim; Seonhee,3,3,34,31
1656130620996,MATH 10B,A02,083208,Lim; Seonhee,10,3,35,25
1656130620996,MATH 10B,A03,093472,Staff,4,3,34,30
1656130620996,MATH 10B,B01,083739,Sinha; Shubham,11,0,30,19
1656130627022,MATH 18,A01,083743,Cinel; Cameron Alexander,7,0,30,23
1656130627022,MATH 18,A02,083744,Cinel; Cameron Alexander,10,0,30,20
1656130627022,MATH 18,A03,083745,Cinel; Cameron Alexander,3,0,30,27
1656130627022,MATH 18,B01,083748,Rideout; David Porter,0,0,36,36
1656130627022,MATH 18,B02,083749,Rideout; David Porter,0,0,36,36
1656130627022,MATH 18,B03,083750,Rideout; David Porter,0,0,36,36
1656130627022,MATH 18,B04,083751,Rideout; David Porter,0,0,36,36
1656130627022,MATH 18,B05,093473,Rideout; David Porter,2,0,36,34
1656130627022,MATH 18,B06,093474,Rideout; David Porter,4,0,36,32
1656130633051,MATH 20A,A01,083754,Zheng; Zequn,11,0,40,29
1656130639084,MATH 20B,A01,083756,Briones; Jor-el Thomas Caparas,0,0,36,36
1656130639084,MATH 20B,A02,083757,Briones; Jor-el Thomas Caparas,0,0,36,36
1656130639084,MATH 20B,A03,093475,Staff,2,0,36,34
1656130645113,MATH 20C,A01,083760,Briones; Jor-el Thomas Caparas,2,2,35,33
1656130645113,MATH 20C,A02,083761,Briones; Jor-el Thomas Caparas,9,1,35,26
1656130645113,MATH 20C,A03,093476,Staff,1,1,35,34
1656130645113,MATH 20C,B01,083762,Bach; Quang Tran,1,0,30,29
1656130651141,MATH 20D,A01,083765,Tran; Brian Kha,2,0,30,28
1656130651141,MATH 20D,A02,083766,Tran; Brian Kha,0,1,30,30
1656130651141,MATH 20D,A03,083767,Tran; Brian Kha,2,0,30,28
1656130657175,MATH 20E,A01,083771,Ganguly; Soumya,5,1,32,27
1656130657175,MATH 20E,A02,083772,Ganguly; Soumya,2,2,32,30
1656130657175,MATH 20E,B01,083773,Ciotti; Benjamin,14,0,35,21
1656130657175,MATH 20E,B02,083774,Ciotti; Benjamin,14,0,35,21
1656130663199,MATH 103A,A01,083777,Greenfeld; Be'Eri,2,0,36,34
1656130663199,MATH 103A,A02,083778,Greenfeld; Be'Eri,2,0,36,34
1656130663199,MATH 103A,A03,093561,Staff,4,1,36,32
1656130663199,MATH 103A,B01,083779,Greenfeld; Be'Eri,8,1,36,28
1656130663199,MATH 103A,B02,083780,Greenfeld; Be'Eri,0,1,36,36
1656130663199,MATH 103A,B03,093562,Staff,0,0,36,36
1656130669223,MATH 105,A01,085443,Carter; Anne Toulson,4,1,35,31
1656130669223,MATH 105,A02,093477,Staff,9,0,35,26
1656130675252,MATH 109,A01,083213,Ganzberger; Geoffrey Michael,1,1,34,33
1656130675252,MATH 109,A02,083214,Ganzberger; Geoffrey Michael,0,0,34,34
1656130675252,MATH 109,A03,093478,Staff,1,0,34,33
1656130675252,MATH 109,B01,083215,Ganzberger; Geoffrey Michael,3,0,32,29
1656130675252,MATH 109,B02,083216,Ganzberger; Geoffrey Michael,1,0,32,31
1656130675252,MATH 109,B03,093479,Staff,4,0,32,28
1656130681276,MATH 142A,A01,083219,Chow; Bennett,1,0,32,31
1656130681276,MATH 142A,A02,083220,Chow; Bennett,8,0,32,24
1656130681276,MATH 142A,A03,093480,Staff,5,0,32,27
1656130681276,MATH 142A,B03,093481,Staff,4,0,32,28
1656130681276,MATH 142A,B04,093558,Staff,5,0,32,27
1656130681276,MATH 142A,B05,093559,Staff,0,0,32,32
1656130687301,MATH 193A,A01,083224,Rotar; Vladimir,1,2,34,33
1656130687301,MATH 193A,A02,083225,Rotar; Vladimir,0,0,34,34
1656130687301,MATH 193A,A03,083781,Rotar; Vladimir,1,0,34,33
1656130687301,MATH 193A,A04,083782,Rotar; Vladimir,6,0,34,28
1656130687301,MATH 193A,A05,093482,Rotar; Vladimir,1,0,34,33
1656130693327,MATH 197,001,091859,McAuley; Julian John,9999,0,9999,0
1656130693327,MATH 197,002,095566,Kedlaya; Kiran S.,9997,0,9999,2
1656130693327,MATH 197,003,095567,Xiao; Ming,9999,0,9999,0
1656130693327,MATH 197,004,095571,Perols; Johan Lars,9998,0,9999,1
1656130700390,COGS 9,A01,083615,Shannon; Kyle Michael,5,1,75,70
1656130706412,COGS 11,A01,083617,Boyle; Mary E. T.,16,2,48,32
1656130712436,COGS 13,A01,083071,Bastos; Amalia Pinkusfeld,9,3,71,62
1656130718463,COGS 14A,A01,092681,Semenuks; Arturs,8,23,100,92
1656130724487,COGS 14B,A01,083073,Cheng; Tzu-Han,7,0,63,56
1656130730512,COGS 17,A01,092677,Semenuks; Arturs,13,6,81,68
1656130736561,COGS 100,A01,083619,Allen; Michael Gordon,7,5,70,63
1656130742591,COGS 101A,A01,083621,Davis; Joshua Daniel,7,4,68,61
1656130748621,COGS 101B,A01,091572,Allen; Michael Gordon,6,0,65,59
1656130754643,COGS 101C,A01,083625,Delgado; Tania,10,0,35,25
1656130760671,COGS 107A,A01,083627,Boyle; Mary E. T.,5,4,60,55
1656130766692,COGS 118A,A01,083075,Gupta; Anjum,24,17,76,52
1656130772717,CSE 3,A50,083646,Miranda; Gregory Joseph,18,0,50,32
1656130778743,CSE 8A,A50,083650,Miranda; Gregory Joseph,13,13,56,43
1656130784769,CSE 11,A01,083080,Cao; Yingjun,2,58,40,38
1656130790793,CSE 12,A01,083652,Krause-Levy; Sophia Louisa,14,8,120,106
1656130796819,CSE 15L,A01,083654,Morris; Justin Loren,5,2,50,45
1656130796819,CSE 15L,A02,083655,Morris; Justin Loren,7,3,50,43
1656130802842,CSE 20,A01,083657,Tran; Khoa Dang,31,0,80,49
1656130808865,CSE 21,A01,095574,Bach; Quang Tran,25,0,48,23
1656130814889,CSE 30,A01,083084,Eldon; John,3,11,80,77
1656130814889,CSE 30,B01,095061,Bhaskar; Nishant,4,6,50,46
1656130820916,CSE 100,A01,083659,Cao; Yingjun,2,22,70,68
1656130826943,CSE 134B,A01,083661,Powell; Thomas Allan,11,8,100,89
1656130832966,CSE 140,A01,083663,Gungor; Onat,9,0,85,76
1656130838988,CSE 140L,A01,083088,Eldon; John,8,0,100,92
1656130845015,CSE 175,A01,083665,Kumar; Rakesh,0,0,25,25
1656130851040,CSE 190,A00,092507,Dubnov; Shlomo,2,0,20,18
1656130857064,ECE 45,A01,083139,Congero; Spencer William,5,4,75,70
1656130863165,ECE 65,A50,083695,Saad; Andrew S,8,0,30,22
1656130863165,ECE 65,A51,095125,Staff,23,0,26,3
1656130869191,ECE 109,A01,091882,Touri; Behrouz,7,8,70,63
1656130875215,ECE 180,A00,083140,Abi Samra; Nicholas Camill,1,0,30,29
1656130875215,ECE 180,B00,083141,Abi Samra; Nicholas Camill,4,8,30,26
1656130881243,MATH 10A,A01,083735,Patchell; Gregory David,0,0,30,30
1656130881243,MATH 10A,A02,083736,Patchell; Gregory David,22,0,30,8
1656130881243,MATH 10A,A03,083737,Patchell; Gregory David,16,0,30,14
1656130887267,MATH 10B,A01,083207,Lim; Seonhee,3,3,34,31
1656130887267,MATH 10B,A02,083208,Lim; Seonhee,10,3,35,25
1656130887267,MATH 10B,A03,093472,Staff,4,3,34,30
1656130887267,MATH 10B,B01,083739,Sinha; Shubham,11,0,30,19
1656130893291,MATH 18,A01,083743,Cinel; Cameron Alexander,7,0,30,23
1656130893291,MATH 18,A02,083744,Cinel; Cameron Alexander,10,0,30,20
1656130893291,MATH 18,A03,083745,Cinel; Cameron Alexander,3,0,30,27
1656130893291,MATH 18,B01,083748,Rideout; David Porter,0,0,36,36
1656130893291,MATH 18,B02,083749,Rideout; David Porter,0,0,36,36
1656130893291,MATH 18,B03,083750,Rideout; David Porter,0,0,36,36
1656130893291,MATH 18,B04,083751,Rideout; David Porter,0,0,36,36
1656130893291,MATH 18,B05,093473,Rideout; David Porter,2,0,36,34
1656130893291,MATH 18,B06,093474,Rideout; David Porter,4,0,36,32
1656130899324,MATH 20A,A01,083754,Zheng; Zequn,11,0,40,29
1656130905349,MATH 20B,A01,083756,Briones; Jor-el Thomas Caparas,0,0,36,36
1656130905349,MATH 20B,A02,083757,Briones; Jor-el Thomas Caparas,0,0,36,36
1656130905349,MATH 20B,A03,093475,Staff,2,0,36,34
1656130911372,MATH 20C,A01,083760,Briones; Jor-el Thomas Caparas,2,2,35,33
1656130911372,MATH 20C,A02,083761,Briones; Jor-el Thomas Caparas,9,1,35,26
1656130911372,MATH 20C,A03,093476,Staff,1,1,35,34
1656130911372,MATH 20C,B01,083762,Bach; Quang Tran,1,0,30,29
1656130917407,MATH 20D,A01,083765,Tran; Brian Kha,2,0,30,28
1656130917407,MATH 20D,A02,083766,Tran; Brian Kha,0,1,30,30
1656130917407,MATH 20D,A03,083767,Tran; Brian Kha,2,0,30,28
1656130923441,MATH 20E,A01,083771,Ganguly; Soumya,5,1,32,27
1656130923441,MATH 20E,A02,083772,Ganguly; Soumya,3,2,32,29
1656130923441,MATH 20E,B01,083773,Ciotti; Benjamin,14,0,35,21
1656130923441,MATH 20E,B02,083774,Ciotti; Benjamin,14,0,35,21
1656130929471,MATH 103A,A01,083777,Greenfeld; Be'Eri,2,0,36,34
1656130929471,MATH 103A,A02,083778,Greenfeld; Be'Eri,1,0,36,35
1656130929471,MATH 103A,A03,093561,Staff,4,1,36,32
1656130929471,MATH 103A,B01,083779,Greenfeld; Be'Eri,8,1,36,28
1656130929471,MATH 103A,B02,083780,Greenfeld; Be'Eri,0,0,36,36
1656130929471,MATH 103A,B03,093562,Staff,0,0,36,36
1656130935494,MATH 105,A01,085443,Carter; Anne Toulson,4,1,35,31
1656130935494,MATH 105,A02,093477,Staff,9,0,35,26
1656130941527,MATH 109,A01,083213,Ganzberger; Geoffrey Michael,1,1,34,33
1656130941527,MATH 109,A02,083214,Ganzberger; Geoffrey Michael,0,0,34,34
1656130941527,MATH 109,A03,093478,Staff,1,0,34,33
1656130941527,MATH 109,B01,083215,Ganzberger; Geoffrey Michael,3,0,32,29
1656130941527,MATH 109,B02,083216,Ganzberger; Geoffrey Michael,1,0,32,31
1656130941527,MATH 109,B03,093479,Staff,4,0,32,28
1656130947552,MATH 142A,A01,083219,Chow; Bennett,1,0,32,31
1656130947552,MATH 142A,A02,083220,Chow; Bennett,8,0,32,24
1656130947552,MATH 142A,A03,093480,Staff,5,0,32,27
1656130947552,MATH 142A,B03,093481,Staff,4,0,32,28
1656130947552,MATH 142A,B04,093558,Staff,5,0,32,27
1656130947552,MATH 142A,B05,093559,Staff,0,0,32,32
1656130953580,MATH 193A,A01,083224,Rotar; Vladimir,1,2,34,33
1656130953580,MATH 193A,A02,083225,Rotar; Vladimir,0,0,34,34
1656130953580,MATH 193A,A03,083781,Rotar; Vladimir,1,0,34,33
1656130953580,MATH 193A,A04,083782,Rotar; Vladimir,6,0,34,28
1656130953580,MATH 193A,A05,093482,Rotar; Vladimir,1,0,34,33
1656130959603,MATH 197,001,091859,McAuley; Julian John,9999,0,9999,0
1656130959603,MATH 197,002,095566,Kedlaya; Kiran S.,9997,0,9999,2
1656130959603,MATH 197,003,095567,Xiao; Ming,9999,0,9999,0
1656130959603,MATH 197,004,095571,Perols; Johan Lars,9998,0,9999,1
1656130966674,COGS 9,A01,083615,Shannon; Kyle Michael,5,1,75,70
1656130972701,COGS 11,A01,083617,Boyle; Mary E. T.,16,2,48,32
1656130978727,COGS 13,A01,083071,Bastos; Amalia Pinkusfeld,9,3,71,62
1656130984755,COGS 14A,A01,092681,Semenuks; Arturs,8,23,100,92
1656130990787,COGS 14B,A01,083073,Cheng; Tzu-Han,7,0,63,56
1656130996811,COGS 17,A01,092677,Semenuks; Arturs,13,6,81,68
1656131002833,COGS 100,A01,083619,Allen; Michael Gordon,7,5,70,63
1656131008859,COGS 101A,A01,083621,Davis; Joshua Daniel,7,4,68,61
1656131014886,COGS 101B,A01,091572,Allen; Michael Gordon,6,0,65,59
1656131020914,COGS 101C,A01,083625,Delgado; Tania,10,0,35,25
1656131026939,COGS 107A,A01,083627,Boyle; Mary E. T.,5,4,60,55
1656131032973,COGS 118A,A01,083075,Gupta; Anjum,24,17,76,52
1656131039001,CSE 3,A50,083646,Miranda; Gregory Joseph,18,0,50,32
1656131045027,CSE 8A,A50,083650,Miranda; Gregory Joseph,13,13,56,43
1656131051052,CSE 11,A01,083080,Cao; Yingjun,2,58,40,38
1656131057077,CSE 12,A01,083652,Krause-Levy; Sophia Louisa,14,8,120,106
1656131063101,CSE 15L,A01,083654,Morris; Justin Loren,5,2,50,45
1656131063101,CSE 15L,A02,083655,Morris; Justin Loren,7,3,50,43
1656131069128,CSE 20,A01,083657,Tran; Khoa Dang,31,0,80,49
1656131075156,CSE 21,A01,095574,Bach; Quang Tran,25,0,48,23
1656131081181,CSE 30,A01,083084,Eldon; John,3,11,80,77
1656131081181,CSE 30,B01,095061,Bhaskar; Nishant,4,6,50,46
1656131087206,CSE 100,A01,083659,Cao; Yingjun,2,22,70,68
1656131093235,CSE 134B,A01,083661,Powell; Thomas Allan,11,8,100,89
1656131099266,CSE 140,A01,083663,Gungor; Onat,9,0,85,76
1656131105290,CSE 140L,A01,083088,Eldon; John,8,0,100,92
1656131111313,CSE 175,A01,083665,Kumar; Rakesh,0,0,25,25
1656131117336,CSE 190,A00,092507,Dubnov; Shlomo,2,0,20,18
1656131123367,ECE 45,A01,083139,Congero; Spencer William,5,4,75,70
1656131129393,ECE 65,A50,083695,Saad; Andrew S,8,0,30,22
1656131129393,ECE 65,A51,095125,Staff,23,0,26,3
1656131135435,ECE 109,A01,091882,Touri; Behrouz,7,8,70,63
1656131141459,ECE 180,A00,083140,Abi Samra; Nicholas Camill,1,0,30,29
1656131141459,ECE 180,B00,083141,Abi Samra; Nicholas Camill,4,8,30,26
1656131147487,MATH 10A,A01,083735,Patchell; Gregory David,0,0,30,30
1656131147487,MATH 10A,A02,083736,Patchell; Gregory David,22,0,30,8
1656131147487,MATH 10A,A03,083737,Patchell; Gregory David,16,0,30,14
1656131153517,MATH 10B,A01,083207,Lim; Seonhee,3,3,34,31
1656131153517,MATH 10B,A02,083208,Lim; Seonhee,10,3,35,25
1656131153517,MATH 10B,A03,093472,Staff,4,3,34,30
1656131153517,MATH 10B,B01,083739,Sinha; Shubham,11,0,30,19
1656131159548,MATH 18,A01,083743,Cinel; Cameron Alexander,7,0,30,23
1656131159548,MATH 18,A02,083744,Cinel; Cameron Alexander,10,0,30,20
1656131159548,MATH 18,A03,083745,Cinel; Cameron Alexander,3,0,30,27
1656131159548,MATH 18,B01,083748,Rideout; David Porter,0,0,36,36
1656131159548,MATH 18,B02,083749,Rideout; David Porter,0,0,36,36
1656131159548,MATH 18,B03,083750,Rideout; David Porter,0,0,36,36
1656131159548,MATH 18,B04,083751,Rideout; David Porter,0,0,36,36
1656131159548,MATH 18,B05,093473,Rideout; David Porter,2,0,36,34
1656131159548,MATH 18,B06,093474,Rideout; David Porter,4,0,36,32
1656131165577,MATH 20A,A01,083754,Zheng; Zequn,11,0,40,29
1656131171601,MATH 20B,A01,083756,Briones; Jor-el Thomas Caparas,0,0,36,36
1656131171601,MATH 20B,A02,083757,Briones; Jor-el Thomas Caparas,0,0,36,36
1656131171601,MATH 20B,A03,093475,Staff,2,0,36,34
1656131177635,MATH 20C,A01,083760,Briones; Jor-el Thomas Caparas,2,2,35,33
1656131177635,MATH 20C,A02,083761,Briones; Jor-el Thomas Caparas,9,1,35,26
1656131177635,MATH 20C,A03,093476,Staff,1,1,35,34
1656131177635,MATH 20C,B01,083762,Bach; Quang Tran,1,0,30,29
1656131183663,MATH 20D,A01,083765,Tran; Brian Kha,2,0,30,28
1656131183663,MATH 20D,A02,083766,Tran; Brian Kha,0,1,30,30
1656131183663,MATH 20D,A03,083767,Tran; Brian Kha,2,0,30,28
1656131189688,MATH 20E,A01,083771,Ganguly; Soumya,5,1,32,27
1656131189688,MATH 20E,A02,083772,Ganguly; Soumya,3,2,32,29
1656131189688,MATH 20E,B01,083773,Ciotti; Benjamin,14,0,35,21
1656131189688,MATH 20E,B02,083774,Ciotti; Benjamin,14,0,35,21
1656131195720,MATH 103A,A01,083777,Greenfeld; Be'Eri,2,0,36,34
1656131195720,MATH 103A,A02,083778,Greenfeld; Be'Eri,1,0,36,35
1656131195720,MATH 103A,A03,093561,Staff,4,1,36,32
1656131195720,MATH 103A,B01,083779,Greenfeld; Be'Eri,8,1,36,28
1656131195720,MATH 103A,B02,083780,Greenfeld; Be'Eri,0,0,36,36
1656131195720,MATH 103A,B03,093562,Staff,0,0,36,36
1656131201743,MATH 105,A01,085443,Carter; Anne Toulson,4,1,35,31
1656131201743,MATH 105,A02,093477,Staff,9,0,35,26
1656131207773,MATH 109,A01,083213,Ganzberger; Geoffrey Michael,1,1,34,33
1656131207773,MATH 109,A02,083214,Ganzberger; Geoffrey Michael,0,0,34,34
1656131207773,MATH 109,A03,093478,Staff,1,0,34,33
1656131207773,MATH 109,B01,083215,Ganzberger; Geoffrey Michael,3,0,32,29
1656131207773,MATH 109,B02,083216,Ganzberger; Geoffrey Michael,1,0,32,31
1656131207773,MATH 109,B03,093479,Staff,4,0,32,28
1656131213804,MATH 142A,A01,083219,Chow; Bennett,1,0,32,31
1656131213804,MATH 142A,A02,083220,Chow; Bennett,8,0,32,24
1656131213804,MATH 142A,A03,093480,Staff,5,0,32,27
1656131213804,MATH 142A,B03,093481,Staff,4,0,32,28
1656131213804,MATH 142A,B04,093558,Staff,5,0,32,27
1656131213804,MATH 142A,B05,093559,Staff,0,0,32,32
1656131219828,MATH 193A,A01,083224,Rotar; Vladimir,1,2,34,33
1656131219828,MATH 193A,A02,083225,Rotar; Vladimir,0,0,34,34
1656131219828,MATH 193A,A03,083781,Rotar; Vladimir,1,0,34,33
1656131219828,MATH 193A,A04,083782,Rotar; Vladimir,6,0,34,28
1656131219828,MATH 193A,A05,093482,Rotar; Vladimir,1,0,34,33
1656131225859,MATH 197,001,091859,McAuley; Julian John,9999,0,9999,0
1656131225859,MATH 197,002,095566,Kedlaya; Kiran S.,9997,0,9999,2
1656131225859,MATH 197,003,095567,Xiao; Ming,9999,0,9999,0
1656131225859,MATH 197,004,095571,Perols; Johan Lars,9998,0,9999,1
1656131232930,COGS 9,A01,083615,Shannon; Kyle Michael,5,1,75,70
1656131238956,COGS 11,A01,083617,Boyle; Mary E. T.,16,2,48,32
1656131244983,COGS 13,A01,083071,Bastos; Amalia Pinkusfeld,9,3,71,62
1656131251007,COGS 14A,A01,092681,Semenuks; Arturs,8,23,100,92
1656131257112,COGS 14B,A01,083073,Cheng; Tzu-Han,7,0,63,56
1656131263139,COGS 17,A01,092677,Semenuks; Arturs,13,6,81,68
1656131269164,COGS 100,A01,083619,Allen; Michael Gordon,7,5,70,63
1656131275188,COGS 101A,A01,083621,Davis; Joshua Daniel,7,4,68,61
1656131281212,COGS 101B,A01,091572,Allen; Michael Gordon,6,0,65,59
1656131287235,COGS 101C,A01,083625,Delgado; Tania,10,0,35,25
1656131293264,COGS 107A,A01,083627,Boyle; Mary E. T.,5,4,60,55
1656131299288,COGS 118A,A01,083075,Gupta; Anjum,24,17,76,52
1656131305314,CSE 3,A50,083646,Miranda; Gregory Joseph,18,0,50,32
1656131311336,CSE 8A,A50,083650,Miranda; Gregory Joseph,13,13,56,43
1656131317359,CSE 11,A01,083080,Cao; Yingjun,2,58,40,38
1656131323383,CSE 12,A01,083652,Krause-Levy; Sophia Louisa,14,8,120,106
1656131329412,CSE 15L,A01,083654,Morris; Justin Loren,5,2,50,45
1656131329412,CSE 15L,A02,083655,Morris; Justin Loren,7,3,50,43
1656131335439,CSE 20,A01,083657,Tran; Khoa Dang,31,0,80,49
1656131341465,CSE 21,A01,095574,Bach; Quang Tran,25,0,48,23
1656131347495,CSE 30,A01,083084,Eldon; John,3,11,80,77
1656131347495,CSE 30,B01,095061,Bhaskar; Nishant,4,6,50,46
1656131353519,CSE 100,A01,083659,Cao; Yingjun,2,22,70,68
1656131359544,CSE 134B,A01,083661,Powell; Thomas Allan,11,8,100,89
1656131365571,CSE 140,A01,083663,Gungor; Onat,9,0,85,76
1656131371593,CSE 140L,A01,083088,Eldon; John,8,0,100,92
1656131377617,CSE 175,A01,083665,Kumar; Rakesh,0,0,25,25
1656131383639,CSE 190,A00,092507,Dubnov; Shlomo,2,0,20,18
1656131389663,ECE 45,A01,083139,Congero; Spencer William,5,4,75,70
1656131395686,ECE 65,A50,083695,Saad; Andrew S,8,0,30,22
1656131395686,ECE 65,A51,095125,Staff,23,0,26,3
1656131401707,ECE 109,A01,091882,Touri; Behrouz,7,8,70,63
1656131407731,ECE 180,A00,083140,Abi Samra; Nicholas Camill,1,0,30,29
1656131407731,ECE 180,B00,083141,Abi Samra; Nicholas Camill,4,8,30,26
1656131413758,MATH 10A,A01,083735,Patchell; Gregory David,0,0,30,30
1656131413758,MATH 10A,A02,083736,Patchell; Gregory David,22,0,30,8
1656131413758,MATH 10A,A03,083737,Patchell; Gregory David,16,0,30,14
1656131419782,MATH 10B,A01,083207,Lim; Seonhee,3,3,34,31
1656131419782,MATH 10B,A02,083208,Lim; Seonhee,10,3,35,25
1656131419782,MATH 10B,A03,093472,Staff,4,3,34,30
1656131419782,MATH 10B,B01,083739,Sinha; Shubham,11,0,30,19
1656131425807,MATH 18,A01,083743,Cinel; Cameron Alexander,7,0,30,23
1656131425807,MATH 18,A02,083744,Cinel; Cameron Alexander,10,0,30,20
1656131425807,MATH 18,A03,083745,Cinel; Cameron Alexander,3,0,30,27
1656131425807,MATH 18,B01,083748,Rideout; David Porter,0,0,36,36
1656131425807,MATH 18,B02,083749,Rideout; David Porter,0,0,36,36
1656131425807,MATH 18,B03,083750,Rideout; David Porter,0,0,36,36
1656131425807,MATH 18,B04,083751,Rideout; David Porter,0,0,36,36
1656131425807,MATH 18,B05,093473,Rideout; David Porter,2,0,36,34
1656131425807,MATH 18,B06,093474,Rideout; David Porter,4,0,36,32
1656131431830,MATH 20A,A01,083754,Zheng; Zequn,11,0,40,29
1656131437858,MATH 20B,A01,083756,Briones; Jor-el Thomas Caparas,0,0,36,36
1656131437858,MATH 20B,A02,083757,Briones; Jor-el Thomas Caparas,0,0,36,36
1656131437858,MATH 20B,A03,093475,Staff,2,0,36,34
1656131443887,MATH 20C,A01,083760,Briones; Jor-el Thomas Caparas,2,2,35,33
1656131443887,MATH 20C,A02,083761,Briones; Jor-el Thomas Caparas,9,1,35,26
1656131443887,MATH 20C,A03,093476,Staff,1,1,35,34
1656131443887,MATH 20C,B01,083762,Bach; Quang Tran,1,0,30,29
1656131449915,MATH 20D,A01,083765,Tran; Brian Kha,2,0,30,28
1656131449915,MATH 20D,A02,083766,Tran; Brian Kha,0,1,30,30
1656131449915,MATH 20D,A03,083767,Tran; Brian Kha,2,0,30,28
1656131455947,MATH 20E,A01,083771,Ganguly; Soumya,5,1,32,27
1656131455947,MATH 20E,A02,083772,Ganguly; Soumya,3,2,32,29
1656131455947,MATH 20E,B01,083773,Ciotti; Benjamin,14,0,35,21
1656131455947,MATH 20E,B02,083774,Ciotti; Benjamin,14,0,35,21
1656131462057,MATH 103A,A01,083777,Greenfeld; Be'Eri,2,0,36,34
1656131462057,MATH 103A,A02,083778,Greenfeld; Be'Eri,1,0,36,35
1656131462057,MATH 103A,A03,093561,Staff,4,1,36,32
1656131462057,MATH 103A,B01,083779,Greenfeld; Be'Eri,8,1,36,28
1656131462057,MATH 103A,B02,083780,Greenfeld; Be'Eri,0,0,36,36
1656131462057,MATH 103A,B03,093562,Staff,0,0,36,36
1656131468080,MATH 105,A01,085443,Carter; Anne Toulson,4,1,35,31
1656131468080,MATH 105,A02,093477,Staff,9,0,35,26
1656131474105,MATH 109,A01,083213,Ganzberger; Geoffrey Michael,1,1,34,33
1656131474105,MATH 109,A02,083214,Ganzberger; Geoffrey Michael,0,0,34,34
1656131474105,MATH 109,A03,093478,Staff,1,0,34,33
1656131474105,MATH 109,B01,083215,Ganzberger; Geoffrey Michael,3,0,32,29
1656131474105,MATH 109,B02,083216,Ganzberger; Geoffrey Michael,1,0,32,31
1656131474105,MATH 109,B03,093479,Staff,4,0,32,28
1656131480129,MATH 142A,A01,083219,Chow; Bennett,1,0,32,31
1656131480129,MATH 142A,A02,083220,Chow; Bennett,8,0,32,24
1656131480129,MATH 142A,A03,093480,Staff,5,0,32,27
1656131480129,MATH 142A,B03,093481,Staff,4,0,32,28
1656131480129,MATH 142A,B04,093558,Staff,5,0,32,27
1656131480129,MATH 142A,B05,093559,Staff,0,0,32,32
1656131486158,MATH 193A,A01,083224,Rotar; Vladimir,1,2,34,33
1656131486158,MATH 193A,A02,083225,Rotar; Vladimir,0,0,34,34
1656131486158,MATH 193A,A03,083781,Rotar; Vladimir,1,0,34,33
1656131486158,MATH 193A,A04,083782,Rotar; Vladimir,6,0,34,28
1656131486158,MATH 193A,A05,093482,Rotar; Vladimir,1,0,34,33
1656131492183,MATH 197,001,091859,McAuley; Julian John,9999,0,9999,0
1656131492183,MATH 197,002,095566,Kedlaya; Kiran S.,9997,0,9999,2
1656131492183,MATH 197,003,095567,Xiao; Ming,9999,0,9999,0
1656131492183,MATH 197,004,095571,Perols; Johan Lars,9998,0,9999,1
1656131499240,COGS 9,A01,083615,Shannon; Kyle Michael,5,1,75,70
1656131505264,COGS 11,A01,083617,Boyle; Mary E. T.,16,2,48,32
1656131511288,COGS 13,A01,083071,Bastos; Amalia Pinkusfeld,9,3,71,62
1656131517315,COGS 14A,A01,092681,Semenuks; Arturs,8,23,100,92
1656131523342,COGS 14B,A01,083073,Cheng; Tzu-Han,7,0,63,56
1656131529370,COGS 17,A01,092677,Semenuks; Arturs,13,6,81,68
1656131535397,COGS 100,A01,083619,Allen; Michael Gordon,7,5,70,63
1656131541421,COGS 101A,A01,083621,Davis; Joshua Daniel,7,4,68,61
1656131547448,COGS 101B,A01,091572,Allen; Michael Gordon,6,0,65,59
1656131553476,COGS 101C,A01,083625,Delgado; Tania,10,0,35,25
1656131559502,COGS 107A,A01,083627,Boyle; Mary E. T.,5,4,60,55
1656131565529,COGS 118A,A01,083075,Gupta; Anjum,24,17,76,52
1656131571553,CSE 3,A50,083646,Miranda; Gregory Joseph,18,0,50,32
1656131577577,CSE 8A,A50,083650,Miranda; Gregory Joseph,13,13,56,43
1656131583601,CSE 11,A01,083080,Cao; Yingjun,2,58,40,38
1656131589624,CSE 12,A01,083652,Krause-Levy; Sophia Louisa,14,8,120,106
1656131595648,CSE 15L,A01,083654,Morris; Justin Loren,5,2,50,45
1656131595648,CSE 15L,A02,083655,Morris; Justin Loren,7,3,50,43
1656131601672,CSE 20,A01,083657,Tran; Khoa Dang,31,0,80,49
1656131607698,CSE 21,A01,095574,Bach; Quang Tran,25,0,48,23
1656131613725,CSE 30,A01,083084,Eldon; John,3,11,80,77
1656131613725,CSE 30,B01,095061,Bhaskar; Nishant,4,6,50,46
1656131619757,CSE 100,A01,083659,Cao; Yingjun,2,22,70,68
1656131625780,CSE 134B,A01,083661,Powell; Thomas Allan,11,8,100,89
1656131631808,CSE 140,A01,083663,Gungor; Onat,9,0,85,76
1656131637832,CSE 140L,A01,083088,Eldon; John,8,0,100,92
1656131643856,CSE 175,A01,083665,Kumar; Rakesh,0,0,25,25
1656131649879,CSE 190,A00,092507,Dubnov; Shlomo,2,0,20,18
1656131655904,ECE 45,A01,083139,Congero; Spencer William,5,4,75,70
1656131661927,ECE 65,A50,083695,Saad; Andrew S,8,0,30,22
1656131661927,ECE 65,A51,095125,Staff,23,0,26,3
1656131667957,ECE 109,A01,091882,Touri; Behrouz,7,8,70,63
1656131673980,ECE 180,A00,083140,Abi Samra; Nicholas Camill,1,0,30,29
1656131673980,ECE 180,B00,083141,Abi Samra; Nicholas Camill,4,8,30,26
1656131680005,MATH 10A,A01,083735,Patchell; Gregory David,0,0,30,30
1656131680005,MATH 10A,A02,083736,Patchell; Gregory David,22,0,30,8
1656131680005,MATH 10A,A03,083737,Patchell; Gregory David,16,0,30,14
1656131686030,MATH 10B,A01,083207,Lim; Seonhee,3,3,34,31
1656131686030,MATH 10B,A02,083208,Lim; Seonhee,10,3,35,25
1656131686030,MATH 10B,A03,093472,Staff,4,3,34,30
1656131686030,MATH 10B,B01,083739,Sinha; Shubham,11,0,30,19
1656131692061,MATH 18,A01,083743,Cinel; Cameron Alexander,7,0,30,23
1656131692061,MATH 18,A02,083744,Cinel; Cameron Alexander,10,0,30,20
1656131692061,MATH 18,A03,083745,Cinel; Cameron Alexander,3,0,30,27
1656131692061,MATH 18,B01,083748,Rideout; David Porter,0,0,36,36
1656131692061,MATH 18,B02,083749,Rideout; David Porter,0,0,36,36
1656131692061,MATH 18,B03,083750,Rideout; David Porter,0,0,36,36
1656131692061,MATH 18,B04,083751,Rideout; David Porter,0,0,36,36
1656131692061,MATH 18,B05,093473,Rideout; David Porter,2,0,36,34
1656131692061,MATH 18,B06,093474,Rideout; David Porter,4,0,36,32
1656131698084,MATH 20A,A01,083754,Zheng; Zequn,11,0,40,29
1656131704114,MATH 20B,A01,083756,Briones; Jor-el Thomas Caparas,0,0,36,36
1656131704114,MATH 20B,A02,083757,Briones; Jor-el Thomas Caparas,0,0,36,36
1656131704114,MATH 20B,A03,093475,Staff,2,0,36,34
1656131710144,MATH 20C,A01,083760,Briones; Jor-el Thomas Caparas,2,2,35,33
1656131710144,MATH 20C,A02,083761,Briones; Jor-el Thomas Caparas,9,1,35,26
1656131710144,MATH 20C,A03,093476,Staff,1,1,35,34
1656131710144,MATH 20C,B01,083762,Bach; Quang Tran,1,0,30,29
1656131716169,MATH 20D,A01,083765,Tran; Brian Kha,2,0,30,28
1656131716169,MATH 20D,A02,083766,Tran; Brian Kha,0,1,30,30
1656131716169,MATH 20D,A03,083767,Tran; Brian Kha,2,0,30,28
1656131722199,MATH 20E,A01,083771,Ganguly; Soumya,5,1,32,27
1656131722199,MATH 20E,A02,083772,Ganguly; Soumya,3,2,32,29
1656131722199,MATH 20E,B01,083773,Ciotti; Benjamin,14,0,35,21
1656131722199,MATH 20E,B02,083774,Ciotti; Benjamin,14,0,35,21
1656131728224,MATH 103A,A01,083777,Greenfeld; Be'Eri,2,0,36,34
1656131728224,MATH 103A,A02,083778,Greenfeld; Be'Eri,1,0,36,35
1656131728224,MATH 103A,A03,093561,Staff,4,1,36,32
1656131728224,MATH 103A,B01,083779,Greenfeld; Be'Eri,8,1,36,28
1656131728224,MATH 103A,B02,083780,Greenfeld; Be'Eri,0,0,36,36
1656131728224,MATH 103A,B03,093562,Staff,0,0,36,36
1656131734246,MATH 105,A01,085443,Carter; Anne Toulson,4,1,35,31
1656131734246,MATH 105,A02,093477,Staff,9,0,35,26
1656131740271,MATH 109,A01,083213,Ganzberger; Geoffrey Michael,1,1,34,33
1656131740271,MATH 109,A02,083214,Ganzberger; Geoffrey Michael,0,0,34,34
1656131740271,MATH 109,A03,093478,Staff,1,0,34,33
1656131740271,MATH 109,B01,083215,Ganzberger; Geoffrey Michael,3,0,32,29
1656131740271,MATH 109,B02,083216,Ganzberger; Geoffrey Michael,1,0,32,31
1656131740271,MATH 109,B03,093479,Staff,4,0,32,28
1656131746305,MATH 142A,A01,083219,Chow; Bennett,1,0,32,31
1656131746305,MATH 142A,A02,083220,Chow; Bennett,8,0,32,24
1656131746305,MATH 142A,A03,093480,Staff,5,0,32,27
1656131746305,MATH 142A,B03,093481,Staff,4,0,32,28
1656131746305,MATH 142A,B04,093558,Staff,5,0,32,27
1656131746305,MATH 142A,B05,093559,Staff,0,0,32,32
1656131752349,MATH 193A,A01,083224,Rotar; Vladimir,1,2,34,33
1656131752349,MATH 193A,A02,083225,Rotar; Vladimir,0,0,34,34
1656131752349,MATH 193A,A03,083781,Rotar; Vladimir,1,0,34,33
1656131752349,MATH 193A,A04,083782,Rotar; Vladimir,6,0,34,28
1656131752349,MATH 193A,A05,093482,Rotar; Vladimir,1,0,34,33
1656131758377,MATH 197,001,091859,McAuley; Julian John,9999,0,9999,0
1656131758377,MATH 197,002,095566,Kedlaya; Kiran S.,9997,0,9999,2
1656131758377,MATH 197,003,095567,Xiao; Ming,9999,0,9999,0
1656131758377,MATH 197,004,095571,Perols; Johan Lars,9998,0,9999,1
1656131765434,COGS 9,A01,083615,Shannon; Kyle Michael,5,1,75,70
1656131771464,COGS 11,A01,083617,Boyle; Mary E. T.,16,2,48,32
1656131777500,COGS 13,A01,083071,Bastos; Amalia Pinkusfeld,9,3,71,62
1656131783524,COGS 14A,A01,092681,Semenuks; Arturs,8,23,100,92
1656131789558,COGS 14B,A01,083073,Cheng; Tzu-Han,7,0,63,56
1656131795586,COGS 17,A01,092677,Semenuks; Arturs,13,6,81,68
1656131801619,COGS 100,A01,083619,Allen; Michael Gordon,7,5,70,63
1656131807642,COGS 101A,A01,083621,Davis; Joshua Daniel,7,4,68,61
1656131813669,COGS 101B,A01,091572,Allen; Michael Gordon,6,0,65,59
1656131819696,COGS 101C,A01,083625,Delgado; Tania,10,0,35,25
1656131825719,COGS 107A,A01,083627,Boyle; Mary E. T.,5,4,60,55
1656131831746,COGS 118A,A01,083075,Gupta; Anjum,24,17,76,52
1656131837771,CSE 3,A50,083646,Miranda; Gregory Joseph,18,0,50,32
1656131843794,CSE 8A,A50,083650,Miranda; Gregory Joseph,13,13,56,43
1656131849816,CSE 11,A01,083080,Cao; Yingjun,2,58,40,38
1656131855848,CSE 12,A01,083652,Krause-Levy; Sophia Louisa,14,8,120,106
1656131861870,CSE 15L,A01,083654,Morris; Justin Loren,5,2,50,45
1656131861870,CSE 15L,A02,083655,Morris; Justin Loren,7,3,50,43
1656131867903,CSE 20,A01,083657,Tran; Khoa Dang,31,0,80,49
1656131873926,CSE 21,A01,095574,Bach; Quang Tran,25,0,48,23
1656131879949,CSE 30,A01,083084,Eldon; John,3,11,80,77
1656131879949,CSE 30,B01,095061,Bhaskar; Nishant,4,6,50,46
1656131885973,CSE 100,A01,083659,Cao; Yingjun,2,22,70,68
1656131891996,CSE 134B,A01,083661,Powell; Thomas Allan,11,8,100,89
1656131898019,CSE 140,A01,083663,Gungor; Onat,9,0,85,76
1656131904043,CSE 140L,A01,083088,Eldon; John,8,0,100,92
1656131910069,CSE 175,A01,083665,Kumar; Rakesh,0,0,25,25
1656131916096,CSE 190,A00,092507,Dubnov; Shlomo,2,0,20,18
1656131922120,ECE 45,A01,083139,Congero; Spencer William,5,4,75,70
1656131928149,ECE 65,A50,083695,Saad; Andrew S,8,0,30,22
1656131928149,ECE 65,A51,095125,Staff,23,0,26,3
1656131934176,ECE 109,A01,091882,Touri; Behrouz,7,8,70,63
1656131940200,ECE 180,A00,083140,Abi Samra; Nicholas Camill,1,0,30,29
1656131940200,ECE 180,B00,083141,Abi Samra; Nicholas Camill,4,8,30,26
1656131946233,MATH 10A,A01,083735,Patchell; Gregory David,0,0,30,30
1656131946233,MATH 10A,A02,083736,Patchell; Gregory David,22,0,30,8
1656131946233,MATH 10A,A03,083737,Patchell; Gregory David,16,0,30,14
1656131952259,MATH 10B,A01,083207,Lim; Seonhee,3,3,34,31
1656131952259,MATH 10B,A02,083208,Lim; Seonhee,10,3,35,25
1656131952259,MATH 10B,A03,093472,Staff,4,3,34,30
1656131952259,MATH 10B,B01,083739,Sinha; Shubham,11,0,30,19
1656131958283,MATH 18,A01,083743,Cinel; Cameron Alexander,7,0,30,23
1656131958283,MATH 18,A02,083744,Cinel; Cameron Alexander,10,0,30,20
1656131958283,MATH 18,A03,083745,Cinel; Cameron Alexander,3,0,30,27
1656131958283,MATH 18,B01,083748,Rideout; David Porter,0,0,36,36
1656131958283,MATH 18,B02,083749,Rideout; David Porter,0,0,36,36
1656131958283,MATH 18,B03,083750,Rideout; David Porter,0,0,36,36
1656131958283,MATH 18,B04,083751,Rideout; David Porter,0,0,36,36
1656131958283,MATH 18,B05,093473,Rideout; David Porter,2,0,36,34
1656131958283,MATH 18,B06,093474,Rideout; David Porter,4,0,36,32
1656131964310,MATH 20A,A01,083754,Zheng; Zequn,11,0,40,29
1656131970333,MATH 20B,A01,083756,Briones; Jor-el Thomas Caparas,0,0,36,36
1656131970333,MATH 20B,A02,083757,Briones; Jor-el Thomas Caparas,0,0,36,36
1656131970333,MATH 20B,A03,093475,Staff,2,0,36,34
1656131976357,MATH 20C,A01,083760,Briones; Jor-el Thomas Caparas,2,2,35,33
1656131976357,MATH 20C,A02,083761,Briones; Jor-el Thomas Caparas,9,1,35,26
1656131976357,MATH 20C,A03,093476,Staff,1,1,35,34
1656131976357,MATH 20C,B01,083762,Bach; Quang Tran,1,0,30,29
1656131982381,MATH 20D,A01,083765,Tran; Brian Kha,2,0,30,28
1656131982381,MATH 20D,A02,083766,Tran; Brian Kha,0,1,30,30
1656131982381,MATH 20D,A03,083767,Tran; Brian Kha,2,0,30,28
1656131988412,MATH 20E,A01,083771,Ganguly; Soumya,5,1,32,27
1656131988412,MATH 20E,A02,083772,Ganguly; Soumya,3,2,32,29
1656131988412,MATH 20E,B01,083773,Ciotti; Benjamin,14,0,35,21
1656131988412,MATH 20E,B02,083774,Ciotti; Benjamin,14,0,35,21
1656131994441,MATH 103A,A01,083777,Greenfeld; Be'Eri,2,0,36,34
1656131994441,MATH 103A,A02,083778,Greenfeld; Be'Eri,1,0,36,35
1656131994441,MATH 103A,A03,093561,Staff,4,1,36,32
1656131994441,MATH 103A,B01,083779,Greenfeld; Be'Eri,8,1,36,28
1656131994441,MATH 103A,B02,083780,Greenfeld; Be'Eri,0,0,36,36
1656131994441,MATH 103A,B03,093562,Staff,0,0,36,36
1656132000466,MATH 105,A01,085443,Carter; Anne Toulson,4,1,35,31
1656132000466,MATH 105,A02,093477,Staff,9,0,35,26
1656132006495,MATH 109,A01,083213,Ganzberger; Geoffrey Michael,1,1,34,33
1656132006495,MATH 109,A02,083214,Ganzberger; Geoffrey Michael,0,0,34,34
1656132006495,MATH 109,A03,093478,Staff,1,0,34,33
1656132006495,MATH 109,B01,083215,Ganzberger; Geoffrey Michael,3,0,32,29
1656132006495,MATH 109,B02,083216,Ganzberger; Geoffrey Michael,1,0,32,31
1656132006495,MATH 109,B03,093479,Staff,4,0,32,28
1656132012519,MATH 142A,A01,083219,Chow; Bennett,1,0,32,31
1656132012519,MATH 142A,A02,083220,Chow; Bennett,8,0,32,24
1656132012519,MATH 142A,A03,093480,Staff,5,0,32,27
1656132012519,MATH 142A,B03,093481,Staff,4,0,32,28
1656132012519,MATH 142A,B04,093558,Staff,5,0,32,27
1656132012519,MATH 142A,B05,093559,Staff,0,0,32,32
1656132018548,MATH 193A,A01,083224,Rotar; Vladimir,1,2,34,33
1656132018548,MATH 193A,A02,083225,Rotar; Vladimir,0,0,34,34
1656132018548,MATH 193A,A03,083781,Rotar; Vladimir,1,0,34,33
1656132018548,MATH 193A,A04,083782,Rotar; Vladimir,6,0,34,28
1656132018548,MATH 193A,A05,093482,Rotar; Vladimir,1,0,34,33
1656132024590,MATH 197,001,091859,McAuley; Julian John,9999,0,9999,0
1656132024590,MATH 197,002,095566,Kedlaya; Kiran S.,9997,0,9999,2
1656132024590,MATH 197,003,095567,Xiao; Ming,9999,0,9999,0
1656132024590,MATH 197,004,095571,Perols; Johan Lars,9998,0,9999,1
1656132031642,COGS 9,A01,083615,Shannon; Kyle Michael,5,1,75,70
1656132037668,COGS 11,A01,083617,Boyle; Mary E. T.,16,2,48,32
1656132043691,COGS 13,A01,083071,Bastos; Amalia Pinkusfeld,9,3,71,62
1656132049718,COGS 14A,A01,092681,Semenuks; Arturs,8,23,100,92
1656132055813,COGS 14B,A01,083073,Cheng; Tzu-Han,7,0,63,56
1656132061840,COGS 17,A01,092677,Semenuks; Arturs,13,6,81,68
1656132067870,COGS 100,A01,083619,Allen; Michael Gordon,7,5,70,63
1656132073898,COGS 101A,A01,083621,Davis; Joshua Daniel,7,4,68,61
1656132079924,COGS 101B,A01,091572,Allen; Michael Gordon,6,0,65,59
1656132085951,COGS 101C,A01,083625,Delgado; Tania,10,0,35,25
1656132091974,COGS 107A,A01,083627,Boyle; Mary E. T.,5,4,60,55
1656132097998,COGS 118A,A01,083075,Gupta; Anjum,24,17,76,52
1656132104022,CSE 3,A50,083646,Miranda; Gregory Joseph,18,0,50,32
1656132110047,CSE 8A,A50,083650,Miranda; Gregory Joseph,13,13,56,43
1656132116070,CSE 11,A01,083080,Cao; Yingjun,2,58,40,38
1656132122093,CSE 12,A01,083652,Krause-Levy; Sophia Louisa,14,8,120,106
1656132128121,CSE 15L,A01,083654,Morris; Justin Loren,5,2,50,45
1656132128121,CSE 15L,A02,083655,Morris; Justin Loren,7,3,50,43
1656132134144,CSE 20,A01,083657,Tran; Khoa Dang,31,0,80,49
1656132140178,CSE 21,A01,095574,Bach; Quang Tran,25,0,48,23
1656132146206,CSE 30,A01,083084,Eldon; John,3,11,80,77
1656132146206,CSE 30,B01,095061,Bhaskar; Nishant,4,6,50,46
1656132152244,CSE 100,A01,083659,Cao; Yingjun,2,22,70,68
1656132158268,CSE 134B,A01,083661,Powell; Thomas Allan,11,8,100,89
1656132164291,CSE 140,A01,083663,Gungor; Onat,9,0,85,76
1656132170325,CSE 140L,A01,083088,Eldon; John,8,0,100,92
1656132176348,CSE 175,A01,083665,Kumar; Rakesh,0,0,25,25
1656132182372,CSE 190,A00,092507,Dubnov; Shlomo,2,0,20,18
1656132188399,ECE 45,A01,083139,Congero; Spencer William,5,4,75,70
1656132194423,ECE 65,A50,083695,Saad; Andrew S,8,0,30,22
1656132194423,ECE 65,A51,095125,Staff,23,0,26,3
1656132200447,ECE 109,A01,091882,Touri; Behrouz,7,8,70,63
1656132206471,ECE 180,A00,083140,Abi Samra; Nicholas Camill,1,0,30,29
1656132206471,ECE 180,B00,083141,Abi Samra; Nicholas Camill,4,8,30,26
1656132212504,MATH 10A,A01,083735,Patchell; Gregory David,0,0,30,30
1656132212504,MATH 10A,A02,083736,Patchell; Gregory David,22,0,30,8
1656132212504,MATH 10A,A03,083737,Patchell; Gregory David,16,0,30,14
1656132218532,MATH 10B,A01,083207,Lim; Seonhee,3,3,34,31
1656132218532,MATH 10B,A02,083208,Lim; Seonhee,10,3,35,25
1656132218532,MATH 10B,A03,093472,Staff,4,3,34,30
1656132218532,MATH 10B,B01,083739,Sinha; Shubham,11,0,30,19
1656132224563,MATH 18,A01,083743,Cinel; Cameron Alexander,7,0,30,23
1656132224563,MATH 18,A02,083744,Cinel; Cameron Alexander,10,0,30,20
1656132224563,MATH 18,A03,083745,Cinel; Cameron Alexander,3,0,30,27
1656132224563,MATH 18,B01,083748,Rideout; David Porter,0,0,36,36
1656132224563,MATH 18,B02,083749,Rideout; David Porter,0,0,36,36
1656132224563,MATH 18,B03,083750,Rideout; David Porter,0,0,36,36
1656132224563,MATH 18,B04,083751,Rideout; David Porter,0,0,36,36
1656132224563,MATH 18,B05,093473,Rideout; David Porter,2,0,36,34
1656132224563,MATH 18,B06,093474,Rideout; David Porter,4,0,36,32
1656132230588,MATH 20A,A01,083754,Zheng; Zequn,11,0,40,29
1656132236610,MATH 20B,A01,083756,Briones; Jor-el Thomas Caparas,0,0,36,36
1656132236610,MATH 20B,A02,083757,Briones; Jor-el Thomas Caparas,0,0,36,36
1656132236610,MATH 20B,A03,093475,Staff,2,0,36,34
1656132242639,MATH 20C,A01,083760,Briones; Jor-el Thomas Caparas,2,2,35,33
1656132242639,MATH 20C,A02,083761,Briones; Jor-el Thomas Caparas,9,1,35,26
1656132242639,MATH 20C,A03,093476,Staff,1,1,35,34
1656132242639,MATH 20C,B01,083762,Bach; Quang Tran,1,0,30,29
1656132248663,MATH 20D,A01,083765,Tran; Brian Kha,2,0,30,28
1656132248663,MATH 20D,A02,083766,Tran; Brian Kha,0,1,30,30
1656132248663,MATH 20D,A03,083767,Tran; Brian Kha,2,0,30,28
1656132254695,MATH 20E,A01,083771,Ganguly; Soumya,5,1,32,27
1656132254695,MATH 20E,A02,083772,Ganguly; Soumya,3,2,32,29
1656132254695,MATH 20E,B01,083773,Ciotti; Benjamin,14,0,35,21
1656132254695,MATH 20E,B02,083774,Ciotti; Benjamin,14,0,35,21
1656132260719,MATH 103A,A01,083777,Greenfeld; Be'Eri,2,0,36,34
1656132260719,MATH 103A,A02,083778,Greenfeld; Be'Eri,1,0,36,35
1656132260719,MATH 103A,A03,093561,Staff,4,1,36,32
1656132260719,MATH 103A,B01,083779,Greenfeld; Be'Eri,8,1,36,28
1656132260719,MATH 103A,B02,083780,Greenfeld; Be'Eri,0,0,36,36
1656132260719,MATH 103A,B03,093562,Staff,0,0,36,36
1656132266742,MATH 105,A01,085443,Carter; Anne Toulson,4,1,35,31
1656132266742,MATH 105,A02,093477,Staff,9,0,35,26
1656132272771,MATH 109,A01,083213,Ganzberger; Geoffrey Michael,1,1,34,33
1656132272771,MATH 109,A02,083214,Ganzberger; Geoffrey Michael,0,0,34,34
1656132272771,MATH 109,A03,093478,Staff,1,0,34,33
1656132272771,MATH 109,B01,083215,Ganzberger; Geoffrey Michael,3,0,32,29
1656132272771,MATH 109,B02,083216,Ganzberger; Geoffrey Michael,1,0,32,31
1656132272771,MATH 109,B03,093479,Staff,4,0,32,28
1656132278800,MATH 142A,A01,083219,Chow; Bennett,1,0,32,31
1656132278800,MATH 142A,A02,083220,Chow; Bennett,8,0,32,24
1656132278800,MATH 142A,A03,093480,Staff,5,0,32,27
1656132278800,MATH 142A,B03,093481,Staff,4,0,32,28
1656132278800,MATH 142A,B04,093558,Staff,5,0,32,27
1656132278800,MATH 142A,B05,093559,Staff,0,0,32,32
1656132284838,MATH 193A,A01,083224,Rotar; Vladimir,1,2,34,33
1656132284838,MATH 193A,A02,083225,Rotar; Vladimir,0,0,34,34
1656132284838,MATH 193A,A03,083781,Rotar; Vladimir,1,0,34,33
1656132284838,MATH 193A,A04,083782,Rotar; Vladimir,6,0,34,28
1656132284838,MATH 193A,A05,093482,Rotar; Vladimir,1,0,34,33
1656132290863,MATH 197,001,091859,McAuley; Julian John,9999,0,9999,0
1656132290863,MATH 197,002,095566,Kedlaya; Kiran S.,9997,0,9999,2
1656132290863,MATH 197,003,095567,Xiao; Ming,9999,0,9999,0
1656132290863,MATH 197,004,095571,Perols; Johan Lars,9998,0,9999,1
1656132297917,COGS 9,A01,083615,Shannon; Kyle Michael,5,1,75,70
1656132303940,COGS 11,A01,083617,Boyle; Mary E. T.,16,2,48,32
1656132309963,COGS 13,A01,083071,Bastos; Amalia Pinkusfeld,9,3,71,62
1656132315990,COGS 14A,A01,092681,Semenuks; Arturs,8,23,100,92
1656132322014,COGS 14B,A01,083073,Cheng; Tzu-Han,7,0,63,56
1656132328038,COGS 17,A01,092677,Semenuks; Arturs,13,6,81,68
1656132334062,COGS 100,A01,083619,Allen; Michael Gordon,7,5,70,63
1656132340089,COGS 101A,A01,083621,Davis; Joshua Daniel,7,4,68,61
1656132346113,COGS 101B,A01,091572,Allen; Michael Gordon,6,0,65,59
1656132352135,COGS 101C,A01,083625,Delgado; Tania,10,0,35,25
1656132358162,COGS 107A,A01,083627,Boyle; Mary E. T.,5,4,60,55
1656132364183,COGS 118A,A01,083075,Gupta; Anjum,24,17,76,52
1656132370206,CSE 3,A50,083646,Miranda; Gregory Joseph,18,0,50,32
1656132376232,CSE 8A,A50,083650,Miranda; Gregory Joseph,13,13,56,43
1656132382256,CSE 11,A01,083080,Cao; Yingjun,2,58,40,38
1656132388281,CSE 12,A01,083652,Krause-Levy; Sophia Louisa,14,8,120,106
1656132394310,CSE 15L,A01,083654,Morris; Justin Loren,5,2,50,45
1656132394310,CSE 15L,A02,083655,Morris; Justin Loren,7,3,50,43
1656132400332,CSE 20,A01,083657,Tran; Khoa Dang,31,0,80,49
1656132406360,CSE 21,A01,095574,Bach; Quang Tran,25,0,48,23
1656132412381,CSE 30,A01,083084,Eldon; John,3,11,80,77
1656132412381,CSE 30,B01,095061,Bhaskar; Nishant,4,6,50,46
1656132418406,CSE 100,A01,083659,Cao; Yingjun,2,22,70,68
1656132424429,CSE 134B,A01,083661,Powell; Thomas Allan,11,8,100,89
1656132430451,CSE 140,A01,083663,Gungor; Onat,9,0,85,76
1656132436478,CSE 140L,A01,083088,Eldon; John,8,0,100,92
1656132442500,CSE 175,A01,083665,Kumar; Rakesh,0,0,25,25
1656132448522,CSE 190,A00,092507,Dubnov; Shlomo,2,0,20,18
1656132454548,ECE 45,A01,083139,Congero; Spencer William,5,4,75,70
1656132460571,ECE 65,A50,083695,Saad; Andrew S,8,0,30,22
1656132460571,ECE 65,A51,095125,Staff,23,0,26,3
1656132466596,ECE 109,A01,091882,Touri; Behrouz,7,8,70,63
1656132472633,ECE 180,A00,083140,Abi Samra; Nicholas Camill,1,0,30,29
1656132472633,ECE 180,B00,083141,Abi Samra; Nicholas Camill,4,8,30,26
1656132478665,MATH 10A,A01,083735,Patchell; Gregory David,0,0,30,30
1656132478665,MATH 10A,A02,083736,Patchell; Gregory David,22,0,30,8
1656132478665,MATH 10A,A03,083737,Patchell; Gregory David,16,0,30,14
1656132484693,MATH 10B,A01,083207,Lim; Seonhee,3,3,34,31
1656132484693,MATH 10B,A02,083208,Lim; Seonhee,10,3,35,25
1656132484693,MATH 10B,A03,093472,Staff,4,3,34,30
1656132484693,MATH 10B,B01,083739,Sinha; Shubham,11,0,30,19
1656132490716,MATH 18,A01,083743,Cinel; Cameron Alexander,7,0,30,23
1656132490716,MATH 18,A02,083744,Cinel; Cameron Alexander,10,0,30,20
1656132490716,MATH 18,A03,083745,Cinel; Cameron Alexander,3,0,30,27
1656132490716,MATH 18,B01,083748,Rideout; David Porter,0,0,36,36
1656132490716,MATH 18,B02,083749,Rideout; David Porter,0,0,36,36
1656132490716,MATH 18,B03,083750,Rideout; David Porter,0,0,36,36
1656132490716,MATH 18,B04,083751,Rideout; David Porter,0,0,36,36
1656132490716,MATH 18,B05,093473,Rideout; David Porter,2,0,36,34
1656132490716,MATH 18,B06,093474,Rideout; David Porter,4,0,36,32
1656132496743,MATH 20A,A01,083754,Zheng; Zequn,11,0,40,29
1656132502768,MATH 20B,A01,083756,Briones; Jor-el Thomas Caparas,0,0,36,36
1656132502768,MATH 20B,A02,083757,Briones; Jor-el Thomas Caparas,0,0,36,36
1656132502768,MATH 20B,A03,093475,Staff,2,0,36,34
1656132508791,MATH 20C,A01,083760,Briones; Jor-el Thomas Caparas,2,2,35,33
1656132508791,MATH 20C,A02,083761,Briones; Jor-el Thomas Caparas,9,1,35,26
1656132508791,MATH 20C,A03,093476,Staff,1,1,35,34
1656132508791,MATH 20C,B01,083762,Bach; Quang Tran,1,0,30,29
1656132514820,MATH 20D,A01,083765,Tran; Brian Kha,2,0,30,28
1656132514820,MATH 20D,A02,083766,Tran; Brian Kha,0,1,30,30
1656132514820,MATH 20D,A03,083767,Tran; Brian Kha,2,0,30,28
1656132520850,MATH 20E,A01,083771,Ganguly; Soumya,5,1,32,27
1656132520850,MATH 20E,A02,083772,Ganguly; Soumya,3,2,32,29
1656132520850,MATH 20E,B01,083773,Ciotti; Benjamin,14,0,35,21
1656132520850,MATH 20E,B02,083774,Ciotti; Benjamin,14,0,35,21
1656132526874,MATH 103A,A01,083777,Greenfeld; Be'Eri,2,0,36,34
1656132526874,MATH 103A,A02,083778,Greenfeld; Be'Eri,1,0,36,35
1656132526874,MATH 103A,A03,093561,Staff,4,1,36,32
1656132526874,MATH 103A,B01,083779,Greenfeld; Be'Eri,8,1,36,28
1656132526874,MATH 103A,B02,083780,Greenfeld; Be'Eri,0,0,36,36
1656132526874,MATH 103A,B03,093562,Staff,0,0,36,36
1656132532898,MATH 105,A01,085443,Carter; Anne Toulson,4,1,35,31
1656132532898,MATH 105,A02,093477,Staff,9,0,35,26
1656132538923,MATH 109,A01,083213,Ganzberger; Geoffrey Michael,1,1,34,33
1656132538923,MATH 109,A02,083214,Ganzberger; Geoffrey Michael,0,0,34,34
1656132538923,MATH 109,A03,093478,Staff,1,0,34,33
1656132538923,MATH 109,B01,083215,Ganzberger; Geoffrey Michael,3,0,32,29
1656132538923,MATH 109,B02,083216,Ganzberger; Geoffrey Michael,1,0,32,31
1656132538923,MATH 109,B03,093479,Staff,4,0,32,28
1656132544951,MATH 142A,A01,083219,Chow; Bennett,1,0,32,31
1656132544951,MATH 142A,A02,083220,Chow; Bennett,8,0,32,24
1656132544951,MATH 142A,A03,093480,Staff,5,0,32,27
1656132544951,MATH 142A,B03,093481,Staff,4,0,32,28
1656132544951,MATH 142A,B04,093558,Staff,5,0,32,27
1656132544951,MATH 142A,B05,093559,Staff,0,0,32,32
1656132550981,MATH 193A,A01,083224,Rotar; Vladimir,1,2,34,33
1656132550981,MATH 193A,A02,083225,Rotar; Vladimir,0,0,34,34
1656132550981,MATH 193A,A03,083781,Rotar; Vladimir,1,0,34,33
1656132550981,MATH 193A,A04,083782,Rotar; Vladimir,6,0,34,28
1656132550981,MATH 193A,A05,093482,Rotar; Vladimir,1,0,34,33
1656132557015,MATH 197,001,091859,McAuley; Julian John,9999,0,9999,0
1656132557015,MATH 197,002,095566,Kedlaya; Kiran S.,9997,0,9999,2
1656132557015,MATH 197,003,095567,Xiao; Ming,9999,0,9999,0
1656132557015,MATH 197,004,095571,Perols; Johan Lars,9998,0,9999,1
1656132564066,COGS 9,A01,083615,Shannon; Kyle Michael,5,1,75,70
1656132570093,COGS 11,A01,083617,Boyle; Mary E. T.,16,2,48,32
1656132576117,COGS 13,A01,083071,Bastos; Amalia Pinkusfeld,9,3,71,62
1656132582140,COGS 14A,A01,092681,Semenuks; Arturs,8,23,100,92
1656132588169,COGS 14B,A01,083073,Cheng; Tzu-Han,7,0,63,56
1656132594192,COGS 17,A01,092677,Semenuks; Arturs,13,6,81,68
1656132600220,COGS 100,A01,083619,Allen; Michael Gordon,7,5,70,63
1656132606244,COGS 101A,A01,083621,Davis; Joshua Daniel,7,4,68,61
1656132612268,COGS 101B,A01,091572,Allen; Michael Gordon,6,0,65,59
1656132618296,COGS 101C,A01,083625,Delgado; Tania,10,0,35,25
1656132624319,COGS 107A,A01,083627,Boyle; Mary E. T.,5,4,60,55
1656132630342,COGS 118A,A01,083075,Gupta; Anjum,24,17,76,52
1656132636370,CSE 3,A50,083646,Miranda; Gregory Joseph,18,0,50,32
1656132642398,CSE 8A,A50,083650,Miranda; Gregory Joseph,13,13,56,43
1656132648424,CSE 11,A01,083080,Cao; Yingjun,2,58,40,38
1656132654523,CSE 12,A01,083652,Krause-Levy; Sophia Louisa,14,8,120,106
1656132660550,CSE 15L,A01,083654,Morris; Justin Loren,5,2,50,45
1656132660550,CSE 15L,A02,083655,Morris; Justin Loren,7,3,50,43
1656132666576,CSE 20,A01,083657,Tran; Khoa Dang,31,0,80,49
1656132672602,CSE 21,A01,095574,Bach; Quang Tran,25,0,48,23
1656132678630,CSE 30,A01,083084,Eldon; John,3,11,80,77
1656132678630,CSE 30,B01,095061,Bhaskar; Nishant,4,6,50,46
1656132684653,CSE 100,A01,083659,Cao; Yingjun,2,22,70,68
1656132690675,CSE 134B,A01,083661,Powell; Thomas Allan,11,8,100,89
1656132696703,CSE 140,A01,083663,Gungor; Onat,9,0,85,76
1656132702729,CSE 140L,A01,083088,Eldon; John,8,0,100,92
1656132708766,CSE 175,A01,083665,Kumar; Rakesh,0,0,25,25
1656132714793,CSE 190,A00,092507,Dubnov; Shlomo,2,0,20,18
1656132720823,ECE 45,A01,083139,Congero; Spencer William,5,4,75,70
1656132726858,ECE 65,A50,083695,Saad; Andrew S,8,0,30,22
1656132726858,ECE 65,A51,095125,Staff,23,0,26,3
1656132732885,ECE 109,A01,091882,Touri; Behrouz,7,8,70,63
1656132738913,ECE 180,A00,083140,Abi Samra; Nicholas Camill,1,0,30,29
1656132738913,ECE 180,B00,083141,Abi Samra; Nicholas Camill,4,8,30,26
1656132744937,MATH 10A,A01,083735,Patchell; Gregory David,0,0,30,30
1656132744937,MATH 10A,A02,083736,Patchell; Gregory David,22,0,30,8
1656132744937,MATH 10A,A03,083737,Patchell; Gregory David,16,0,30,14
1656132750962,MATH 10B,A01,083207,Lim; Seonhee,3,3,34,31
1656132750962,MATH 10B,A02,083208,Lim; Seonhee,10,3,35,25
1656132750962,MATH 10B,A03,093472,Staff,4,3,34,30
1656132750962,MATH 10B,B01,083739,Sinha; Shubham,11,0,30,19
1656132756993,MATH 18,A01,083743,Cinel; Cameron Alexander,7,0,30,23
1656132756993,MATH 18,A02,083744,Cinel; Cameron Alexander,10,0,30,20
1656132756993,MATH 18,A03,083745,Cinel; Cameron Alexander,3,0,30,27
1656132756993,MATH 18,B01,083748,Rideout; David Porter,0,0,36,36
1656132756993,MATH 18,B02,083749,Rideout; David Porter,0,0,36,36
1656132756993,MATH 18,B03,083750,Rideout; David Porter,0,0,36,36
1656132756993,MATH 18,B04,083751,Rideout; David Porter,0,0,36,36
1656132756993,MATH 18,B05,093473,Rideout; David Porter,2,0,36,34
1656132756993,MATH 18,B06,093474,Rideout; David Porter,4,0,36,32
1656132763019,MATH 20A,A01,083754,Zheng; Zequn,11,0,40,29
1656132769046,MATH 20B,A01,083756,Briones; Jor-el Thomas Caparas,0,0,36,36
1656132769046,MATH 20B,A02,083757,Briones; Jor-el Thomas Caparas,0,0,36,36
1656132769046,MATH 20B,A03,093475,Staff,2,0,36,34
1656132775070,MATH 20C,A01,083760,Briones; Jor-el Thomas Caparas,2,2,35,33
1656132775070,MATH 20C,A02,083761,Briones; Jor-el Thomas Caparas,9,1,35,26
1656132775070,MATH 20C,A03,093476,Staff,1,1,35,34
1656132775070,MATH 20C,B01,083762,Bach; Quang Tran,1,0,30,29
1656132781093,MATH 20D,A01,083765,Tran; Brian Kha,2,0,30,28
1656132781093,MATH 20D,A02,083766,Tran; Brian Kha,0,1,30,30
1656132781093,MATH 20D,A03,083767,Tran; Brian Kha,2,0,30,28
1656132787122,MATH 20E,A01,083771,Ganguly; Soumya,5,1,32,27
1656132787122,MATH 20E,A02,083772,Ganguly; Soumya,3,2,32,29
1656132787122,MATH 20E,B01,083773,Ciotti; Benjamin,14,0,35,21
1656132787122,MATH 20E,B02,083774,Ciotti; Benjamin,14,0,35,21
1656132793154,MATH 103A,A01,083777,Greenfeld; Be'Eri,2,0,36,34
1656132793154,MATH 103A,A02,083778,Greenfeld; Be'Eri,1,0,36,35
1656132793154,MATH 103A,A03,093561,Staff,4,1,36,32
1656132793154,MATH 103A,B01,083779,Greenfeld; Be'Eri,8,1,36,28
1656132793154,MATH 103A,B02,083780,Greenfeld; Be'Eri,0,0,36,36
1656132793154,MATH 103A,B03,093562,Staff,0,0,36,36
1656132799181,MATH 105,A01,085443,Carter; Anne Toulson,4,1,35,31
1656132799181,MATH 105,A02,093477,Staff,9,0,35,26
1656132805205,MATH 109,A01,083213,Ganzberger; Geoffrey Michael,1,1,34,33
1656132805205,MATH 109,A02,083214,Ganzberger; Geoffrey Michael,0,0,34,34
1656132805205,MATH 109,A03,093478,Staff,1,0,34,33
1656132805205,MATH 109,B01,083215,Ganzberger; Geoffrey Michael,3,0,32,29
1656132805205,MATH 109,B02,083216,Ganzberger; Geoffrey Michael,1,0,32,31
1656132805205,MATH 109,B03,093479,Staff,4,0,32,28
1656132811234,MATH 142A,A01,083219,Chow; Bennett,1,0,32,31
1656132811234,MATH 142A,A02,083220,Chow; Bennett,8,0,32,24
1656132811234,MATH 142A,A03,093480,Staff,5,0,32,27
1656132811234,MATH 142A,B03,093481,Staff,4,0,32,28
1656132811234,MATH 142A,B04,093558,Staff,5,0,32,27
1656132811234,MATH 142A,B05,093559,Staff,0,0,32,32
1656132817297,MATH 193A,A01,083224,Rotar; Vladimir,1,2,34,33
1656132817297,MATH 193A,A02,083225,Rotar; Vladimir,0,0,34,34
1656132817297,MATH 193A,A03,083781,Rotar; Vladimir,1,0,34,33
1656132817297,MATH 193A,A04,083782,Rotar; Vladimir,6,0,34,28
1656132817297,MATH 193A,A05,093482,Rotar; Vladimir,1,0,34,33
1656132823320,MATH 197,001,091859,McAuley; Julian John,9999,0,9999,0
1656132823320,MATH 197,002,095566,Kedlaya; Kiran S.,9997,0,9999,2
1656132823320,MATH 197,003,095567,Xiao; Ming,9999,0,9999,0
1656132823320,MATH 197,004,095571,Perols; Johan Lars,9998,0,9999,1
1656132830379,COGS 9,A01,083615,Shannon; Kyle Michael,5,1,75,70
1656132836406,COGS 11,A01,083617,Boyle; Mary E. T.,16,2,48,32
1656132842434,COGS 13,A01,083071,Bastos; Amalia Pinkusfeld,9,3,71,62
1656132848456,COGS 14A,A01,092681,Semenuks; Arturs,8,23,100,92
1656132854480,COGS 14B,A01,083073,Cheng; Tzu-Han,7,0,63,56
1656132860507,COGS 17,A01,092677,Semenuks; Arturs,13,6,81,68
1656132866530,COGS 100,A01,083619,Allen; Michael Gordon,7,5,70,63
1656132872557,COGS 101A,A01,083621,Davis; Joshua Daniel,7,4,68,61
1656132878581,COGS 101B,A01,091572,Allen; Michael Gordon,6,0,65,59
1656132884623,COGS 101C,A01,083625,Delgado; Tania,10,0,35,25
1656132890647,COGS 107A,A01,083627,Boyle; Mary E. T.,5,4,60,55
1656132896670,COGS 118A,A01,083075,Gupta; Anjum,24,17,76,52
1656132902703,CSE 3,A50,083646,Miranda; Gregory Joseph,18,0,50,32
1656132908725,CSE 8A,A50,083650,Miranda; Gregory Joseph,13,13,56,43
1656132914749,CSE 11,A01,083080,Cao; Yingjun,2,58,40,38
1656132920775,CSE 12,A01,083652,Krause-Levy; Sophia Louisa,14,8,120,106
1656132926802,CSE 15L,A01,083654,Morris; Justin Loren,5,2,50,45
1656132926802,CSE 15L,A02,083655,Morris; Justin Loren,7,3,50,43
1656132932830,CSE 20,A01,083657,Tran; Khoa Dang,31,0,80,49
1656132938853,CSE 21,A01,095574,Bach; Quang Tran,25,0,48,23
1656132944877,CSE 30,A01,083084,Eldon; John,3,11,80,77
1656132944877,CSE 30,B01,095061,Bhaskar; Nishant,4,6,50,46
1656132950899,CSE 100,A01,083659,Cao; Yingjun,2,22,70,68
1656132956922,CSE 134B,A01,083661,Powell; Thomas Allan,11,8,100,89
1656132962945,CSE 140,A01,083663,Gungor; Onat,9,0,85,76
1656132968972,CSE 140L,A01,083088,Eldon; John,8,0,100,92
1656132974994,CSE 175,A01,083665,Kumar; Rakesh,0,0,25,25
1656132981020,CSE 190,A00,092507,Dubnov; Shlomo,2,0,20,18
1656132987047,ECE 45,A01,083139,Congero; Spencer William,5,4,75,70
1656132993071,ECE 65,A50,083695,Saad; Andrew S,8,0,30,22
1656132993071,ECE 65,A51,095125,Staff,23,0,26,3
1656132999097,ECE 109,A01,091882,Touri; Behrouz,7,8,70,63
1656133005121,ECE 180,A00,083140,Abi Samra; Nicholas Camill,1,0,30,29
1656133005121,ECE 180,B00,083141,Abi Samra; Nicholas Camill,4,8,30,26
1656133011149,MATH 10A,A01,083735,Patchell; Gregory David,0,0,30,30
1656133011149,MATH 10A,A02,083736,Patchell; Gregory David,22,0,30,8
1656133011149,MATH 10A,A03,083737,Patchell; Gregory David,16,0,30,14
1656133017177,MATH 10B,A01,083207,Lim; Seonhee,3,3,34,31
1656133017177,MATH 10B,A02,083208,Lim; Seonhee,10,3,35,25
1656133017177,MATH 10B,A03,093472,Staff,4,3,34,30
1656133017177,MATH 10B,B01,083739,Sinha; Shubham,11,0,30,19
1656133023219,MATH 18,A01,083743,Cinel; Cameron Alexander,7,0,30,23
1656133023219,MATH 18,A02,083744,Cinel; Cameron Alexander,10,0,30,20
1656133023219,MATH 18,A03,083745,Cinel; Cameron Alexander,3,0,30,27
1656133023219,MATH 18,B01,083748,Rideout; David Porter,0,0,36,36
1656133023219,MATH 18,B02,083749,Rideout; David Porter,0,0,36,36
1656133023219,MATH 18,B03,083750,Rideout; David Porter,0,0,36,36
1656133023219,MATH 18,B04,083751,Rideout; David Porter,0,0,36,36
1656133023219,MATH 18,B05,093473,Rideout; David Porter,2,0,36,34
1656133023219,MATH 18,B06,093474,Rideout; David Porter,4,0,36,32
1656133029242,MATH 20A,A01,083754,Zheng; Zequn,11,0,40,29
1656133035271,MATH 20B,A01,083756,Briones; Jor-el Thomas Caparas,0,0,36,36
1656133035271,MATH 20B,A02,083757,Briones; Jor-el Thomas Caparas,0,0,36,36
1656133035271,MATH 20B,A03,093475,Staff,2,0,36,34
1656133041295,MATH 20C,A01,083760,Briones; Jor-el Thomas Caparas,2,2,35,33
1656133041295,MATH 20C,A02,083761,Briones; Jor-el Thomas Caparas,9,1,35,26
1656133041295,MATH 20C,A03,093476,Staff,1,1,35,34
1656133041295,MATH 20C,B01,083762,Bach; Quang Tran,1,0,30,29
1656133047325,MATH 20D,A01,083765,Tran; Brian Kha,2,0,30,28
1656133047325,MATH 20D,A02,083766,Tran; Brian Kha,0,1,30,30
1656133047325,MATH 20D,A03,083767,Tran; Brian Kha,2,0,30,28
1656133053347,MATH 20E,A01,083771,Ganguly; Soumya,5,1,32,27
1656133053347,MATH 20E,A02,083772,Ganguly; Soumya,3,2,32,29
1656133053347,MATH 20E,B01,083773,Ciotti; Benjamin,14,0,35,21
1656133053347,MATH 20E,B02,083774,Ciotti; Benjamin,14,0,35,21
1656133059375,MATH 103A,A01,083777,Greenfeld; Be'Eri,2,0,36,34
1656133059375,MATH 103A,A02,083778,Greenfeld; Be'Eri,1,0,36,35
1656133059375,MATH 103A,A03,093561,Staff,4,1,36,32
1656133059375,MATH 103A,B01,083779,Greenfeld; Be'Eri,8,1,36,28
1656133059375,MATH 103A,B02,083780,Greenfeld; Be'Eri,0,0,36,36
1656133059375,MATH 103A,B03,093562,Staff,0,0,36,36
1656133065415,MATH 105,A01,085443,Carter; Anne Toulson,4,1,35,31
1656133065415,MATH 105,A02,093477,Staff,9,0,35,26
1656133071445,MATH 109,A01,083213,Ganzberger; Geoffrey Michael,1,1,34,33
1656133071445,MATH 109,A02,083214,Ganzberger; Geoffrey Michael,0,0,34,34
1656133071445,MATH 109,A03,093478,Staff,1,0,34,33
1656133071445,MATH 109,B01,083215,Ganzberger; Geoffrey Michael,3,0,32,29
1656133071445,MATH 109,B02,083216,Ganzberger; Geoffrey Michael,1,0,32,31
1656133071445,MATH 109,B03,093479,Staff,4,0,32,28
1656133077470,MATH 142A,A01,083219,Chow; Bennett,1,0,32,31
1656133077470,MATH 142A,A02,083220,Chow; Bennett,8,0,32,24
1656133077470,MATH 142A,A03,093480,Staff,5,0,32,27
1656133077470,MATH 142A,B03,093481,Staff,4,0,32,28
1656133077470,MATH 142A,B04,093558,Staff,5,0,32,27
1656133077470,MATH 142A,B05,093559,Staff,0,0,32,32
1656133083500,MATH 193A,A01,083224,Rotar; Vladimir,1,2,34,33
1656133083500,MATH 193A,A02,083225,Rotar; Vladimir,0,0,34,34
1656133083500,MATH 193A,A03,083781,Rotar; Vladimir,1,0,34,33
1656133083500,MATH 193A,A04,083782,Rotar; Vladimir,6,0,34,28
1656133083500,MATH 193A,A05,093482,Rotar; Vladimir,1,0,34,33
1656133089523,MATH 197,001,091859,McAuley; Julian John,9999,0,9999,0
1656133089523,MATH 197,002,095566,Kedlaya; Kiran S.,9997,0,9999,2
1656133089523,MATH 197,003,095567,Xiao; Ming,9999,0,9999,0
1656133089523,MATH 197,004,095571,Perols; Johan Lars,9998,0,9999,1
1656133096585,COGS 9,A01,083615,Shannon; Kyle Michael,5,1,75,70
1656133102609,COGS 11,A01,083617,Boyle; Mary E. T.,16,2,48,32
1656133108633,COGS 13,A01,083071,Bastos; Amalia Pinkusfeld,9,3,71,62
1656133114656,COGS 14A,A01,092681,Semenuks; Arturs,8,23,100,92
1656133120678,COGS 14B,A01,083073,Cheng; Tzu-Han,7,0,63,56
1656133126701,COGS 17,A01,092677,Semenuks; Arturs,13,6,81,68
1656133132731,COGS 100,A01,083619,Allen; Michael Gordon,7,5,70,63
1656133138755,COGS 101A,A01,083621,Davis; Joshua Daniel,7,4,68,61
1656133144778,COGS 101B,A01,091572,Allen; Michael Gordon,6,0,65,59
1656133150807,COGS 101C,A01,083625,Delgado; Tania,10,0,35,25
1656133156830,COGS 107A,A01,083627,Boyle; Mary E. T.,5,4,60,55
1656133162855,COGS 118A,A01,083075,Gupta; Anjum,24,17,76,52
1656133168878,CSE 3,A50,083646,Miranda; Gregory Joseph,18,0,50,32
1656133174906,CSE 8A,A50,083650,Miranda; Gregory Joseph,13,13,56,43
1656133180929,CSE 11,A01,083080,Cao; Yingjun,2,58,40,38
1656133186953,CSE 12,A01,083652,Krause-Levy; Sophia Louisa,14,8,120,106
1656133192976,CSE 15L,A01,083654,Morris; Justin Loren,5,2,50,45
1656133192976,CSE 15L,A02,083655,Morris; Justin Loren,7,3,50,43
1656133199000,CSE 20,A01,083657,Tran; Khoa Dang,31,0,80,49
1656133205023,CSE 21,A01,095574,Bach; Quang Tran,25,0,48,23
1656133211051,CSE 30,A01,083084,Eldon; John,3,11,80,77
1656133211051,CSE 30,B01,095061,Bhaskar; Nishant,4,6,50,46
1656133217073,CSE 100,A01,083659,Cao; Yingjun,2,22,70,68
1656133223095,CSE 134B,A01,083661,Powell; Thomas Allan,11,8,100,89
1656133229116,CSE 140,A01,083663,Gungor; Onat,9,0,85,76
1656133235152,CSE 140L,A01,083088,Eldon; John,8,0,100,92
1656133241174,CSE 175,A01,083665,Kumar; Rakesh,0,0,25,25
1656133247200,CSE 190,A00,092507,Dubnov; Shlomo,2,0,20,18
1656133253317,ECE 45,A01,083139,Congero; Spencer William,5,4,75,70
1656133259340,ECE 65,A50,083695,Saad; Andrew S,8,0,30,22
1656133259340,ECE 65,A51,095125,Staff,23,0,26,3
1656133265370,ECE 109,A01,091882,Touri; Behrouz,7,8,70,63
1656133271394,ECE 180,A00,083140,Abi Samra; Nicholas Camill,1,0,30,29
1656133271394,ECE 180,B00,083141,Abi Samra; Nicholas Camill,4,8,30,26
1656133277418,MATH 10A,A01,083735,Patchell; Gregory David,0,0,30,30
1656133277418,MATH 10A,A02,083736,Patchell; Gregory David,22,0,30,8
1656133277418,MATH 10A,A03,083737,Patchell; Gregory David,16,0,30,14
1656133283440,MATH 10B,A01,083207,Lim; Seonhee,3,3,34,31
1656133283440,MATH 10B,A02,083208,Lim; Seonhee,10,3,35,25
1656133283440,MATH 10B,A03,093472,Staff,4,3,34,30
1656133283440,MATH 10B,B01,083739,Sinha; Shubham,11,0,30,19
1656133289471,MATH 18,A01,083743,Cinel; Cameron Alexander,7,0,30,23
1656133289471,MATH 18,A02,083744,Cinel; Cameron Alexander,10,0,30,20
1656133289471,MATH 18,A03,083745,Cinel; Cameron Alexander,3,0,30,27
1656133289471,MATH 18,B01,083748,Rideout; David Porter,0,0,36,36
1656133289471,MATH 18,B02,083749,Rideout; David Porter,0,0,36,36
1656133289471,MATH 18,B03,083750,Rideout; David Porter,0,0,36,36
1656133289471,MATH 18,B04,083751,Rideout; David Porter,0,0,36,36
1656133289471,MATH 18,B05,093473,Rideout; David Porter,2,0,36,34
1656133289471,MATH 18,B06,093474,Rideout; David Porter,4,0,36,32
1656133295494,MATH 20A,A01,083754,Zheng; Zequn,11,0,40,29
1656133301518,MATH 20B,A01,083756,Briones; Jor-el Thomas Caparas,0,0,36,36
1656133301518,MATH 20B,A02,083757,Briones; Jor-el Thomas Caparas,0,0,36,36
1656133301518,MATH 20B,A03,093475,Staff,2,0,36,34
1656133307543,MATH 20C,A01,083760,Briones; Jor-el Thomas Caparas,2,2,35,33
1656133307543,MATH 20C,A02,083761,Briones; Jor-el Thomas Caparas,9,1,35,26
1656133307543,MATH 20C,A03,093476,Staff,1,1,35,34
1656133307543,MATH 20C,B01,083762,Bach; Quang Tran,1,0,30,29
1656133313566,MATH 20D,A01,083765,Tran; Brian Kha,2,0,30,28
1656133313566,MATH 20D,A02,083766,Tran; Brian Kha,0,1,30,30
1656133313566,MATH 20D,A03,083767,Tran; Brian Kha,2,0,30,28
1656133319607,MATH 20E,A01,083771,Ganguly; Soumya,5,1,32,27
1656133319607,MATH 20E,A02,083772,Ganguly; Soumya,3,2,32,29
1656133319607,MATH 20E,B01,083773,Ciotti; Benjamin,14,0,35,21
1656133319607,MATH 20E,B02,083774,Ciotti; Benjamin,14,0,35,21
1656133325632,MATH 103A,A01,083777,Greenfeld; Be'Eri,2,0,36,34
1656133325632,MATH 103A,A02,083778,Greenfeld; Be'Eri,1,0,36,35
1656133325632,MATH 103A,A03,093561,Staff,4,1,36,32
1656133325632,MATH 103A,B01,083779,Greenfeld; Be'Eri,8,1,36,28
1656133325632,MATH 103A,B02,083780,Greenfeld; Be'Eri,0,0,36,36
1656133325632,MATH 103A,B03,093562,Staff,0,0,36,36
1656133331657,MATH 105,A01,085443,Carter; Anne Toulson,4,1,35,31
1656133331657,MATH 105,A02,093477,Staff,9,0,35,26
1656133337687,MATH 109,A01,083213,Ganzberger; Geoffrey Michael,1,1,34,33
1656133337687,MATH 109,A02,083214,Ganzberger; Geoffrey Michael,0,0,34,34
1656133337687,MATH 109,A03,093478,Staff,1,0,34,33
1656133337687,MATH 109,B01,083215,Ganzberger; Geoffrey Michael,3,0,32,29
1656133337687,MATH 109,B02,083216,Ganzberger; Geoffrey Michael,1,0,32,31
1656133337687,MATH 109,B03,093479,Staff,4,0,32,28
1656133343711,MATH 142A,A01,083219,Chow; Bennett,1,0,32,31
1656133343711,MATH 142A,A02,083220,Chow; Bennett,8,0,32,24
1656133343711,MATH 142A,A03,093480,Staff,5,0,32,27
1656133343711,MATH 142A,B03,093481,Staff,4,0,32,28
1656133343711,MATH 142A,B04,093558,Staff,5,0,32,27
1656133343711,MATH 142A,B05,093559,Staff,0,0,32,32
1656133349734,MATH 193A,A01,083224,Rotar; Vladimir,1,2,34,33
1656133349734,MATH 193A,A02,083225,Rotar; Vladimir,0,0,34,34
1656133349734,MATH 193A,A03,083781,Rotar; Vladimir,1,0,34,33
1656133349734,MATH 193A,A04,083782,Rotar; Vladimir,6,0,34,28
1656133349734,MATH 193A,A05,093482,Rotar; Vladimir,1,0,34,33
1656133355758,MATH 197,001,091859,McAuley; Julian John,9999,0,9999,0
1656133355758,MATH 197,002,095566,Kedlaya; Kiran S.,9997,0,9999,2
1656133355758,MATH 197,003,095567,Xiao; Ming,9999,0,9999,0
1656133355758,MATH 197,004,095571,Perols; Johan Lars,9998,0,9999,1
1656133362832,COGS 9,A01,083615,Shannon; Kyle Michael,5,1,75,70
1656133368858,COGS 11,A01,083617,Boyle; Mary E. T.,16,2,48,32
1656133374883,COGS 13,A01,083071,Bastos; Amalia Pinkusfeld,9,3,71,62
1656133380908,COGS 14A,A01,092681,Semenuks; Arturs,8,23,100,92
1656133386936,COGS 14B,A01,083073,Cheng; Tzu-Han,7,0,63,56
1656133392969,COGS 17,A01,092677,Semenuks; Arturs,13,6,81,68
1656133399000,COGS 100,A01,083619,Allen; Michael Gordon,7,5,70,63
1656133405026,COGS 101A,A01,083621,Davis; Joshua Daniel,7,4,68,61
1656133411053,COGS 101B,A01,091572,Allen; Michael Gordon,6,0,65,59
1656133417076,COGS 101C,A01,083625,Delgado; Tania,10,0,35,25
1656133423104,COGS 107A,A01,083627,Boyle; Mary E. T.,5,4,60,55
1656133429126,COGS 118A,A01,083075,Gupta; Anjum,24,17,76,52
1656133435149,CSE 3,A50,083646,Miranda; Gregory Joseph,18,0,50,32
1656133441178,CSE 8A,A50,083650,Miranda; Gregory Joseph,13,13,56,43
1656133447200,CSE 11,A01,083080,Cao; Yingjun,2,58,40,38
1656133453226,CSE 12,A01,083652,Krause-Levy; Sophia Louisa,14,8,120,106
1656133459250,CSE 15L,A01,083654,Morris; Justin Loren,5,2,50,45
1656133459250,CSE 15L,A02,083655,Morris; Justin Loren,7,3,50,43
1656133465280,CSE 20,A01,083657,Tran; Khoa Dang,31,0,80,49
1656133471305,CSE 21,A01,095574,Bach; Quang Tran,25,0,48,23
1656133477330,CSE 30,A01,083084,Eldon; John,3,11,80,77
1656133477330,CSE 30,B01,095061,Bhaskar; Nishant,4,6,50,46
1656133483355,CSE 100,A01,083659,Cao; Yingjun,2,22,70,68
1656133489378,CSE 134B,A01,083661,Powell; Thomas Allan,11,8,100,89
1656133495400,CSE 140,A01,083663,Gungor; Onat,9,0,85,76
1656133501427,CSE 140L,A01,083088,Eldon; John,8,0,100,92
1656133507451,CSE 175,A01,083665,Kumar; Rakesh,0,0,25,25
1656133513475,CSE 190,A00,092507,Dubnov; Shlomo,2,0,20,18
1656133519498,ECE 45,A01,083139,Congero; Spencer William,5,4,75,70
1656133525520,ECE 65,A50,083695,Saad; Andrew S,8,0,30,22
1656133525520,ECE 65,A51,095125,Staff,23,0,26,3
1656133531543,ECE 109,A01,091882,Touri; Behrouz,7,8,70,63
1656133537569,ECE 180,A00,083140,Abi Samra; Nicholas Camill,1,0,30,29
1656133537569,ECE 180,B00,083141,Abi Samra; Nicholas Camill,4,8,30,26
1656133543592,MATH 10A,A01,083735,Patchell; Gregory David,0,0,30,30
1656133543592,MATH 10A,A02,083736,Patchell; Gregory David,22,0,30,8
1656133543592,MATH 10A,A03,083737,Patchell; Gregory David,16,0,30,14
1656133549615,MATH 10B,A01,083207,Lim; Seonhee,3,3,34,31
1656133549615,MATH 10B,A02,083208,Lim; Seonhee,10,3,35,25
1656133549615,MATH 10B,A03,093472,Staff,4,3,34,30
1656133549615,MATH 10B,B01,083739,Sinha; Shubham,11,0,30,19
1656133555638,MATH 18,A01,083743,Cinel; Cameron Alexander,7,0,30,23
1656133555638,MATH 18,A02,083744,Cinel; Cameron Alexander,10,0,30,20
1656133555638,MATH 18,A03,083745,Cinel; Cameron Alexander,3,0,30,27
1656133555638,MATH 18,B01,083748,Rideout; David Porter,0,0,36,36
1656133555638,MATH 18,B02,083749,Rideout; David Porter,0,0,36,36
1656133555638,MATH 18,B03,083750,Rideout; David Porter,0,0,36,36
1656133555638,MATH 18,B04,083751,Rideout; David Porter,0,0,36,36
1656133555638,MATH 18,B05,093473,Rideout; David Porter,2,0,36,34
1656133555638,MATH 18,B06,093474,Rideout; David Porter,4,0,36,32
1656133561662,MATH 20A,A01,083754,Zheng; Zequn,11,0,40,29
1656133567691,MATH 20B,A01,083756,Briones; Jor-el Thomas Caparas,0,0,36,36
1656133567691,MATH 20B,A02,083757,Briones; Jor-el Thomas Caparas,0,0,36,36
1656133567691,MATH 20B,A03,093475,Staff,2,0,36,34
1656133573718,MATH 20C,A01,083760,Briones; Jor-el Thomas Caparas,2,2,35,33
1656133573718,MATH 20C,A02,083761,Briones; Jor-el Thomas Caparas,9,1,35,26
1656133573718,MATH 20C,A03,093476,Staff,1,1,35,34
1656133573718,MATH 20C,B01,083762,Bach; Quang Tran,1,0,30,29
1656133579742,MATH 20D,A01,083765,Tran; Brian Kha,2,0,30,28
1656133579742,MATH 20D,A02,083766,Tran; Brian Kha,0,1,30,30
1656133579742,MATH 20D,A03,083767,Tran; Brian Kha,2,0,30,28
1656133585765,MATH 20E,A01,083771,Ganguly; Soumya,5,1,32,27
1656133585765,MATH 20E,A02,083772,Ganguly; Soumya,3,2,32,29
1656133585765,MATH 20E,B01,083773,Ciotti; Benjamin,14,0,35,21
1656133585765,MATH 20E,B02,083774,Ciotti; Benjamin,14,0,35,21
1656133591795,MATH 103A,A01,083777,Greenfeld; Be'Eri,2,0,36,34
1656133591795,MATH 103A,A02,083778,Greenfeld; Be'Eri,1,0,36,35
1656133591795,MATH 103A,A03,093561,Staff,4,1,36,32
1656133591795,MATH 103A,B01,083779,Greenfeld; Be'Eri,8,1,36,28
1656133591795,MATH 103A,B02,083780,Greenfeld; Be'Eri,0,0,36,36
1656133591795,MATH 103A,B03,093562,Staff,0,0,36,36
1656133597824,MATH 105,A01,085443,Carter; Anne Toulson,4,1,35,31
1656133597824,MATH 105,A02,093477,Staff,9,0,35,26
1656133603859,MATH 109,A01,083213,Ganzberger; Geoffrey Michael,1,1,34,33
1656133603859,MATH 109,A02,083214,Ganzberger; Geoffrey Michael,0,0,34,34
1656133603859,MATH 109,A03,093478,Staff,1,0,34,33
1656133603859,MATH 109,B01,083215,Ganzberger; Geoffrey Michael,3,0,32,29
1656133603859,MATH 109,B02,083216,Ganzberger; Geoffrey Michael,1,0,32,31
1656133603859,MATH 109,B03,093479,Staff,4,0,32,28
1656133609891,MATH 142A,A01,083219,Chow; Bennett,1,0,32,31
1656133609891,MATH 142A,A02,083220,Chow; Bennett,8,0,32,24
1656133609891,MATH 142A,A03,093480,Staff,5,0,32,27
1656133609891,MATH 142A,B03,093481,Staff,4,0,32,28
1656133609891,MATH 142A,B04,093558,Staff,5,0,32,27
1656133609891,MATH 142A,B05,093559,Staff,0,0,32,32
1656133615915,MATH 193A,A01,083224,Rotar; Vladimir,1,2,34,33
1656133615915,MATH 193A,A02,083225,Rotar; Vladimir,0,0,34,34
1656133615915,MATH 193A,A03,083781,Rotar; Vladimir,1,0,34,33
1656133615915,MATH 193A,A04,083782,Rotar; Vladimir,6,0,34,28
1656133615915,MATH 193A,A05,093482,Rotar; Vladimir,1,0,34,33
1656133621938,MATH 197,001,091859,McAuley; Julian John,9999,0,9999,0
1656133621938,MATH 197,002,095566,Kedlaya; Kiran S.,9997,0,9999,2
1656133621938,MATH 197,003,095567,Xiao; Ming,9999,0,9999,0
1656133621938,MATH 197,004,095571,Perols; Johan Lars,9998,0,9999,1
1656133629000,COGS 9,A01,083615,Shannon; Kyle Michael,5,1,75,70
1656133635028,COGS 11,A01,083617,Boyle; Mary E. T.,16,2,48,32
1656133641056,COGS 13,A01,083071,Bastos; Amalia Pinkusfeld,9,3,71,62
1656133647084,COGS 14A,A01,092681,Semenuks; Arturs,8,23,100,92
1656133653110,COGS 14B,A01,083073,Cheng; Tzu-Han,7,0,63,56
1656133659140,COGS 17,A01,092677,Semenuks; Arturs,13,6,81,68
1656133665162,COGS 100,A01,083619,Allen; Michael Gordon,7,5,70,63
1656133671190,COGS 101A,A01,083621,Davis; Joshua Daniel,7,4,68,61
1656133677213,COGS 101B,A01,091572,Allen; Michael Gordon,6,0,65,59
1656133683236,COGS 101C,A01,083625,Delgado; Tania,10,0,35,25
1656133689260,COGS 107A,A01,083627,Boyle; Mary E. T.,5,4,60,55
1656133695282,COGS 118A,A01,083075,Gupta; Anjum,24,17,76,52
1656133701305,CSE 3,A50,083646,Miranda; Gregory Joseph,18,0,50,32
1656133707329,CSE 8A,A50,083650,Miranda; Gregory Joseph,13,13,56,43
1656133713352,CSE 11,A01,083080,Cao; Yingjun,2,58,40,38
1656133719379,CSE 12,A01,083652,Krause-Levy; Sophia Louisa,14,8,120,106
1656133725409,CSE 15L,A01,083654,Morris; Justin Loren,5,2,50,45
1656133725409,CSE 15L,A02,083655,Morris; Justin Loren,7,3,50,43
1656133731436,CSE 20,A01,083657,Tran; Khoa Dang,31,0,80,49
1656133737467,CSE 21,A01,095574,Bach; Quang Tran,25,0,48,23
1656133743503,CSE 30,A01,083084,Eldon; John,3,11,80,77
1656133743503,CSE 30,B01,095061,Bhaskar; Nishant,4,6,50,46
1656133749537,CSE 100,A01,083659,Cao; Yingjun,2,22,70,68
1656133755561,CSE 134B,A01,083661,Powell; Thomas Allan,11,8,100,89
1656133761588,CSE 140,A01,083663,Gungor; Onat,9,0,85,76
1656133767612,CSE 140L,A01,083088,Eldon; John,8,0,100,92
1656133773635,CSE 175,A01,083665,Kumar; Rakesh,0,0,25,25
1656133779667,CSE 190,A00,092507,Dubnov; Shlomo,2,0,20,18
1656133785696,ECE 45,A01,083139,Congero; Spencer William,5,4,75,70
1656133791719,ECE 65,A50,083695,Saad; Andrew S,8,0,30,22
1656133791719,ECE 65,A51,095125,Staff,23,0,26,3
1656133797742,ECE 109,A01,091882,Touri; Behrouz,7,8,70,63
1656133803766,ECE 180,A00,083140,Abi Samra; Nicholas Camill,1,0,30,29
1656133803766,ECE 180,B00,083141,Abi Samra; Nicholas Camill,4,8,30,26
1656133809789,MATH 10A,A01,083735,Patchell; Gregory David,0,0,30,30
1656133809789,MATH 10A,A02,083736,Patchell; Gregory David,22,0,30,8
1656133809789,MATH 10A,A03,083737,Patchell; Gregory David,16,0,30,14
1656133815818,MATH 10B,A01,083207,Lim; Seonhee,3,3,34,31
1656133815818,MATH 10B,A02,083208,Lim; Seonhee,10,3,35,25
1656133815818,MATH 10B,A03,093472,Staff,4,3,34,30
1656133815818,MATH 10B,B01,083739,Sinha; Shubham,11,0,30,19
1656133821849,MATH 18,A01,083743,Cinel; Cameron Alexander,7,0,30,23
1656133821849,MATH 18,A02,083744,Cinel; Cameron Alexander,10,0,30,20
1656133821849,MATH 18,A03,083745,Cinel; Cameron Alexander,3,0,30,27
1656133821849,MATH 18,B01,083748,Rideout; David Porter,0,0,36,36
1656133821849,MATH 18,B02,083749,Rideout; David Porter,0,0,36,36
1656133821849,MATH 18,B03,083750,Rideout; David Porter,0,0,36,36
1656133821849,MATH 18,B04,083751,Rideout; David Porter,0,0,36,36
1656133821849,MATH 18,B05,093473,Rideout; David Porter,2,0,36,34
1656133821849,MATH 18,B06,093474,Rideout; David Porter,4,0,36,32
1656133827877,MATH 20A,A01,083754,Zheng; Zequn,11,0,40,29
1656133833903,MATH 20B,A01,083756,Briones; Jor-el Thomas Caparas,0,0,36,36
1656133833903,MATH 20B,A02,083757,Briones; Jor-el Thomas Caparas,0,0,36,36
1656133833903,MATH 20B,A03,093475,Staff,2,0,36,34
1656133839939,MATH 20C,A01,083760,Briones; Jor-el Thomas Caparas,2,2,35,33
1656133839939,MATH 20C,A02,083761,Briones; Jor-el Thomas Caparas,9,1,35,26
1656133839939,MATH 20C,A03,093476,Staff,1,1,35,34
1656133839939,MATH 20C,B01,083762,Bach; Quang Tran,1,0,30,29
1656133845967,MATH 20D,A01,083765,Tran; Brian Kha,2,0,30,28
1656133845967,MATH 20D,A02,083766,Tran; Brian Kha,0,1,30,30
1656133845967,MATH 20D,A03,083767,Tran; Brian Kha,2,0,30,28
1656133852073,MATH 20E,A01,083771,Ganguly; Soumya,5,1,32,27
1656133852073,MATH 20E,A02,083772,Ganguly; Soumya,3,2,32,29
1656133852073,MATH 20E,B01,083773,Ciotti; Benjamin,14,0,35,21
1656133852073,MATH 20E,B02,083774,Ciotti; Benjamin,14,0,35,21
1656133858102,MATH 103A,A01,083777,Greenfeld; Be'Eri,2,0,36,34
1656133858102,MATH 103A,A02,083778,Greenfeld; Be'Eri,1,0,36,35
1656133858102,MATH 103A,A03,093561,Staff,4,1,36,32
1656133858102,MATH 103A,B01,083779,Greenfeld; Be'Eri,8,1,36,28
1656133858102,MATH 103A,B02,083780,Greenfeld; Be'Eri,0,0,36,36
1656133858102,MATH 103A,B03,093562,Staff,0,0,36,36
1656133864127,MATH 105,A01,085443,Carter; Anne Toulson,4,1,35,31
1656133864127,MATH 105,A02,093477,Staff,9,0,35,26
1656133870159,MATH 109,A01,083213,Ganzberger; Geoffrey Michael,1,1,34,33
1656133870159,MATH 109,A02,083214,Ganzberger; Geoffrey Michael,0,0,34,34
1656133870159,MATH 109,A03,093478,Staff,1,0,34,33
1656133870159,MATH 109,B01,083215,Ganzberger; Geoffrey Michael,3,0,32,29
1656133870159,MATH 109,B02,083216,Ganzberger; Geoffrey Michael,1,0,32,31
1656133870159,MATH 109,B03,093479,Staff,4,0,32,28
1656133876187,MATH 142A,A01,083219,Chow; Bennett,1,0,32,31
1656133876187,MATH 142A,A02,083220,Chow; Bennett,8,0,32,24
1656133876187,MATH 142A,A03,093480,Staff,5,0,32,27
1656133876187,MATH 142A,B03,093481,Staff,4,0,32,28
1656133876187,MATH 142A,B04,093558,Staff,5,0,32,27
1656133876187,MATH 142A,B05,093559,Staff,0,0,32,32
1656133882212,MATH 193A,A01,083224,Rotar; Vladimir,1,2,34,33
1656133882212,MATH 193A,A02,083225,Rotar; Vladimir,0,0,34,34
1656133882212,MATH 193A,A03,083781,Rotar; Vladimir,1,0,34,33
1656133882212,MATH 193A,A04,083782,Rotar; Vladimir,6,0,34,28
1656133882212,MATH 193A,A05,093482,Rotar; Vladimir,1,0,34,33
1656133888236,MATH 197,001,091859,McAuley; Julian John,9999,0,9999,0
1656133888236,MATH 197,002,095566,Kedlaya; Kiran S.,9997,0,9999,2
1656133888236,MATH 197,003,095567,Xiao; Ming,9999,0,9999,0
1656133888236,MATH 197,004,095571,Perols; Johan Lars,9998,0,9999,1
1656133895292,COGS 9,A01,083615,Shannon; Kyle Michael,5,1,75,70
1656133901317,COGS 11,A01,083617,Boyle; Mary E. T.,16,2,48,32
1656133907340,COGS 13,A01,083071,Bastos; Amalia Pinkusfeld,9,3,71,62
1656133913364,COGS 14A,A01,092681,Semenuks; Arturs,8,23,100,92
1656133919394,COGS 14B,A01,083073,Cheng; Tzu-Han,7,0,63,56
1656133925418,COGS 17,A01,092677,Semenuks; Arturs,13,6,81,68
1656133931457,COGS 100,A01,083619,Allen; Michael Gordon,7,5,70,63
1656133937483,COGS 101A,A01,083621,Davis; Joshua Daniel,7,4,68,61
1656133943513,COGS 101B,A01,091572,Allen; Michael Gordon,6,0,65,59
1656133949537,COGS 101C,A01,083625,Delgado; Tania,10,0,35,25
1656133955561,COGS 107A,A01,083627,Boyle; Mary E. T.,5,4,60,55
1656133961585,COGS 118A,A01,083075,Gupta; Anjum,24,17,76,52
1656133967608,CSE 3,A50,083646,Miranda; Gregory Joseph,18,0,50,32
1656133973632,CSE 8A,A50,083650,Miranda; Gregory Joseph,13,13,56,43
1656133979656,CSE 11,A01,083080,Cao; Yingjun,2,58,40,38
1656133985684,CSE 12,A01,083652,Krause-Levy; Sophia Louisa,14,8,120,106
1656133991708,CSE 15L,A01,083654,Morris; Justin Loren,5,2,50,45
1656133991708,CSE 15L,A02,083655,Morris; Justin Loren,7,3,50,43
1656133997732,CSE 20,A01,083657,Tran; Khoa Dang,31,0,80,49
1656134003753,CSE 21,A01,095574,Bach; Quang Tran,25,0,48,23
1656134009777,CSE 30,A01,083084,Eldon; John,3,11,80,77
1656134009777,CSE 30,B01,095061,Bhaskar; Nishant,4,6,50,46
1656134015801,CSE 100,A01,083659,Cao; Yingjun,2,22,70,68
1656134021823,CSE 134B,A01,083661,Powell; Thomas Allan,11,8,100,89
1656134027847,CSE 140,A01,083663,Gungor; Onat,9,0,85,76
1656134033873,CSE 140L,A01,083088,Eldon; John,8,0,100,92
1656134039896,CSE 175,A01,083665,Kumar; Rakesh,0,0,25,25
1656134045929,CSE 190,A00,092507,Dubnov; Shlomo,2,0,20,18
1656134051952,ECE 45,A01,083139,Congero; Spencer William,5,4,75,70
1656134057978,ECE 65,A50,083695,Saad; Andrew S,8,0,30,22
1656134057978,ECE 65,A51,095125,Staff,23,0,26,3
1656134064002,ECE 109,A01,091882,Touri; Behrouz,7,8,70,63
1656134070027,ECE 180,A00,083140,Abi Samra; Nicholas Camill,1,0,30,29
1656134070027,ECE 180,B00,083141,Abi Samra; Nicholas Camill,4,8,30,26
1656134076052,MATH 10A,A01,083735,Patchell; Gregory David,0,0,30,30
1656134076052,MATH 10A,A02,083736,Patchell; Gregory David,22,0,30,8
1656134076052,MATH 10A,A03,083737,Patchell; Gregory David,16,0,30,14
1656134082089,MATH 10B,A01,083207,Lim; Seonhee,3,3,34,31
1656134082089,MATH 10B,A02,083208,Lim; Seonhee,10,3,35,25
1656134082089,MATH 10B,A03,093472,Staff,4,3,34,30
1656134082089,MATH 10B,B01,083739,Sinha; Shubham,11,0,30,19
1656134088115,MATH 18,A01,083743,Cinel; Cameron Alexander,7,0,30,23
1656134088115,MATH 18,A02,083744,Cinel; Cameron Alexander,10,0,30,20
1656134088115,MATH 18,A03,083745,Cinel; Cameron Alexander,3,0,30,27
1656134088115,MATH 18,B01,083748,Rideout; David Porter,0,0,36,36
1656134088115,MATH 18,B02,083749,Rideout; David Porter,0,0,36,36
1656134088115,MATH 18,B03,083750,Rideout; David Porter,0,0,36,36
1656134088115,MATH 18,B04,083751,Rideout; David Porter,0,0,36,36
1656134088115,MATH 18,B05,093473,Rideout; David Porter,2,0,36,34
1656134088115,MATH 18,B06,093474,Rideout; David Porter,4,0,36,32
1656134094141,MATH 20A,A01,083754,Zheng; Zequn,11,0,40,29
1656134100171,MATH 20B,A01,083756,Briones; Jor-el Thomas Caparas,0,0,36,36
1656134100171,MATH 20B,A02,083757,Briones; Jor-el Thomas Caparas,0,0,36,36
1656134100171,MATH 20B,A03,093475,Staff,2,0,36,34
1656134106193,MATH 20C,A01,083760,Briones; Jor-el Thomas Caparas,2,2,35,33
1656134106193,MATH 20C,A02,083761,Briones; Jor-el Thomas Caparas,9,1,35,26
1656134106193,MATH 20C,A03,093476,Staff,1,1,35,34
1656134106193,MATH 20C,B01,083762,Bach; Quang Tran,1,0,30,29
1656134112218,MATH 20D,A01,083765,Tran; Brian Kha,2,0,30,28
1656134112218,MATH 20D,A02,083766,Tran; Brian Kha,0,1,30,30
1656134112218,MATH 20D,A03,083767,Tran; Brian Kha,2,0,30,28
1656134118247,MATH 20E,A01,083771,Ganguly; Soumya,5,1,32,27
1656134118247,MATH 20E,A02,083772,Ganguly; Soumya,3,2,32,29
1656134118247,MATH 20E,B01,083773,Ciotti; Benjamin,14,0,35,21
1656134118247,MATH 20E,B02,083774,Ciotti; Benjamin,14,0,35,21
1656134124276,MATH 103A,A01,083777,Greenfeld; Be'Eri,2,0,36,34
1656134124276,MATH 103A,A02,083778,Greenfeld; Be'Eri,1,0,36,35
1656134124276,MATH 103A,A03,093561,Staff,4,1,36,32
1656134124276,MATH 103A,B01,083779,Greenfeld; Be'Eri,8,1,36,28
1656134124276,MATH 103A,B02,083780,Greenfeld; Be'Eri,0,0,36,36
1656134124276,MATH 103A,B03,093562,Staff,0,0,36,36
1656134130302,MATH 105,A01,085443,Carter; Anne Toulson,4,1,35,31
1656134130302,MATH 105,A02,093477,Staff,9,0,35,26
1656134136332,MATH 109,A01,083213,Ganzberger; Geoffrey Michael,1,1,34,33
1656134136332,MATH 109,A02,083214,Ganzberger; Geoffrey Michael,0,0,34,34
1656134136332,MATH 109,A03,093478,Staff,1,0,34,33
1656134136332,MATH 109,B01,083215,Ganzberger; Geoffrey Michael,3,0,32,29
1656134136332,MATH 109,B02,083216,Ganzberger; Geoffrey Michael,1,0,32,31
1656134136332,MATH 109,B03,093479,Staff,4,0,32,28
1656134142361,MATH 142A,A01,083219,Chow; Bennett,1,0,32,31
1656134142361,MATH 142A,A02,083220,Chow; Bennett,8,0,32,24
1656134142361,MATH 142A,A03,093480,Staff,5,0,32,27
1656134142361,MATH 142A,B03,093481,Staff,4,0,32,28
1656134142361,MATH 142A,B04,093558,Staff,5,0,32,27
1656134142361,MATH 142A,B05,093559,Staff,0,0,32,32
1656134148384,MATH 193A,A01,083224,Rotar; Vladimir,1,2,34,33
1656134148384,MATH 193A,A02,083225,Rotar; Vladimir,0,0,34,34
1656134148384,MATH 193A,A03,083781,Rotar; Vladimir,0,0,34,34
1656134148384,MATH 193A,A04,083782,Rotar; Vladimir,6,0,34,28
1656134148384,MATH 193A,A05,093482,Rotar; Vladimir,1,0,34,33
1656134154410,MATH 197,001,091859,McAuley; Julian John,9999,0,9999,0
1656134154410,MATH 197,002,095566,Kedlaya; Kiran S.,9997,0,9999,2
1656134154410,MATH 197,003,095567,Xiao; Ming,9999,0,9999,0
1656134154410,MATH 197,004,095571,Perols; Johan Lars,9998,0,9999,1
1656134161473,COGS 9,A01,083615,Shannon; Kyle Michael,5,1,75,70
1656134167498,COGS 11,A01,083617,Boyle; Mary E. T.,16,2,48,32
1656134173525,COGS 13,A01,083071,Bastos; Amalia Pinkusfeld,9,3,71,62
1656134179551,COGS 14A,A01,092681,Semenuks; Arturs,8,23,100,92
1656134185573,COGS 14B,A01,083073,Cheng; Tzu-Han,7,0,63,56
1656134191596,COGS 17,A01,092677,Semenuks; Arturs,13,6,81,68
1656134197618,COGS 100,A01,083619,Allen; Michael Gordon,7,5,70,63
1656134203642,COGS 101A,A01,083621,Davis; Joshua Daniel,7,4,68,61
1656134209670,COGS 101B,A01,091572,Allen; Michael Gordon,6,0,65,59
1656134215701,COGS 101C,A01,083625,Delgado; Tania,10,0,35,25
1656134221724,COGS 107A,A01,083627,Boyle; Mary E. T.,5,4,60,55
1656134227757,COGS 118A,A01,083075,Gupta; Anjum,24,17,76,52
1656134233787,CSE 3,A50,083646,Miranda; Gregory Joseph,18,0,50,32
1656134239815,CSE 8A,A50,083650,Miranda; Gregory Joseph,13,13,56,43
1656134245843,CSE 11,A01,083080,Cao; Yingjun,2,58,40,38
1656134251865,CSE 12,A01,083652,Krause-Levy; Sophia Louisa,14,8,120,106
1656134257889,CSE 15L,A01,083654,Morris; Justin Loren,5,2,50,45
1656134257889,CSE 15L,A02,083655,Morris; Justin Loren,7,3,50,43
1656134263916,CSE 20,A01,083657,Tran; Khoa Dang,31,0,80,49
1656134269941,CSE 21,A01,095574,Bach; Quang Tran,25,0,48,23
1656134275973,CSE 30,A01,083084,Eldon; John,3,11,80,77
1656134275973,CSE 30,B01,095061,Bhaskar; Nishant,4,6,50,46
1656134281997,CSE 100,A01,083659,Cao; Yingjun,2,22,70,68
1656134288021,CSE 134B,A01,083661,Powell; Thomas Allan,11,8,100,89
1656134294049,CSE 140,A01,083663,Gungor; Onat,10,0,85,75
1656134300072,CSE 140L,A01,083088,Eldon; John,8,0,100,92
1656134306098,CSE 175,A01,083665,Kumar; Rakesh,0,0,25,25
1656134312120,CSE 190,A00,092507,Dubnov; Shlomo,2,0,20,18
1656134318144,ECE 45,A01,083139,Congero; Spencer William,5,4,75,70
1656134324168,ECE 65,A50,083695,Saad; Andrew S,8,0,30,22
1656134324168,ECE 65,A51,095125,Staff,23,0,26,3
1656134330196,ECE 109,A01,091882,Touri; Behrouz,7,8,70,63
1656134336225,ECE 180,A00,083140,Abi Samra; Nicholas Camill,1,0,30,29
1656134336225,ECE 180,B00,083141,Abi Samra; Nicholas Camill,4,8,30,26
1656134342253,MATH 10A,A01,083735,Patchell; Gregory David,0,0,30,30
1656134342253,MATH 10A,A02,083736,Patchell; Gregory David,22,0,30,8
1656134342253,MATH 10A,A03,083737,Patchell; Gregory David,16,0,30,14
1656134348282,MATH 10B,A01,083207,Lim; Seonhee,3,3,34,31
1656134348282,MATH 10B,A02,083208,Lim; Seonhee,10,3,35,25
1656134348282,MATH 10B,A03,093472,Staff,4,3,34,30
1656134348282,MATH 10B,B01,083739,Sinha; Shubham,11,0,30,19
1656134354308,MATH 18,A01,083743,Cinel; Cameron Alexander,7,0,30,23
1656134354308,MATH 18,A02,083744,Cinel; Cameron Alexander,10,0,30,20
1656134354308,MATH 18,A03,083745,Cinel; Cameron Alexander,3,0,30,27
1656134354308,MATH 18,B01,083748,Rideout; David Porter,0,0,36,36
1656134354308,MATH 18,B02,083749,Rideout; David Porter,0,0,36,36
1656134354308,MATH 18,B03,083750,Rideout; David Porter,0,0,36,36
1656134354308,MATH 18,B04,083751,Rideout; David Porter,0,0,36,36
1656134354308,MATH 18,B05,093473,Rideout; David Porter,2,0,36,34
1656134354308,MATH 18,B06,093474,Rideout; David Porter,4,0,36,32
1656134360330,MATH 20A,A01,083754,Zheng; Zequn,11,0,40,29
1656134366358,MATH 20B,A01,083756,Briones; Jor-el Thomas Caparas,0,0,36,36
1656134366358,MATH 20B,A02,083757,Briones; Jor-el Thomas Caparas,0,0,36,36
1656134366358,MATH 20B,A03,093475,Staff,2,0,36,34
1656134372387,MATH 20C,A01,083760,Briones; Jor-el Thomas Caparas,2,2,35,33
1656134372387,MATH 20C,A02,083761,Briones; Jor-el Thomas Caparas,9,1,35,26
1656134372387,MATH 20C,A03,093476,Staff,1,1,35,34
1656134372387,MATH 20C,B01,083762,Bach; Quang Tran,1,0,30,29
1656134378420,MATH 20D,A01,083765,Tran; Brian Kha,2,0,30,28
1656134378420,MATH 20D,A02,083766,Tran; Brian Kha,0,1,30,30
1656134378420,MATH 20D,A03,083767,Tran; Brian Kha,2,0,30,28
1656134384456,MATH 20E,A01,083771,Ganguly; Soumya,5,1,32,27
1656134384456,MATH 20E,A02,083772,Ganguly; Soumya,3,2,32,29
1656134384456,MATH 20E,B01,083773,Ciotti; Benjamin,14,0,35,21
1656134384456,MATH 20E,B02,083774,Ciotti; Benjamin,14,0,35,21
1656134390487,MATH 103A,A01,083777,Greenfeld; Be'Eri,2,0,36,34
1656134390487,MATH 103A,A02,083778,Greenfeld; Be'Eri,1,0,36,35
1656134390487,MATH 103A,A03,093561,Staff,4,1,36,32
1656134390487,MATH 103A,B01,083779,Greenfeld; Be'Eri,8,1,36,28
1656134390487,MATH 103A,B02,083780,Greenfeld; Be'Eri,0,0,36,36
1656134390487,MATH 103A,B03,093562,Staff,0,0,36,36
1656134396517,MATH 105,A01,085443,Carter; Anne Toulson,4,1,35,31
1656134396517,MATH 105,A02,093477,Staff,9,0,35,26
1656134402546,MATH 109,A01,083213,Ganzberger; Geoffrey Michael,1,1,34,33
1656134402546,MATH 109,A02,083214,Ganzberger; Geoffrey Michael,0,0,34,34
1656134402546,MATH 109,A03,093478,Staff,1,0,34,33
1656134402546,MATH 109,B01,083215,Ganzberger; Geoffrey Michael,3,0,32,29
1656134402546,MATH 109,B02,083216,Ganzberger; Geoffrey Michael,1,0,32,31
1656134402546,MATH 109,B03,093479,Staff,4,0,32,28
1656134408575,MATH 142A,A01,083219,Chow; Bennett,1,0,32,31
1656134408575,MATH 142A,A02,083220,Chow; Bennett,8,0,32,24
1656134408575,MATH 142A,A03,093480,Staff,5,0,32,27
1656134408575,MATH 142A,B03,093481,Staff,4,0,32,28
1656134408575,MATH 142A,B04,093558,Staff,5,0,32,27
1656134408575,MATH 142A,B05,093559,Staff,0,0,32,32
1656134414599,MATH 193A,A01,083224,Rotar; Vladimir,1,2,34,33
1656134414599,MATH 193A,A02,083225,Rotar; Vladimir,0,0,34,34
1656134414599,MATH 193A,A03,083781,Rotar; Vladimir,0,0,34,34
1656134414599,MATH 193A,A04,083782,Rotar; Vladimir,6,0,34,28
1656134414599,MATH 193A,A05,093482,Rotar; Vladimir,1,0,34,33
1656134420624,MATH 197,001,091859,McAuley; Julian John,9999,0,9999,0
1656134420624,MATH 197,002,095566,Kedlaya; Kiran S.,9997,0,9999,2
1656134420624,MATH 197,003,095567,Xiao; Ming,9999,0,9999,0
1656134420624,MATH 197,004,095571,Perols; Johan Lars,9998,0,9999,1
1656134427680,COGS 9,A01,083615,Shannon; Kyle Michael,5,1,75,70
1656134433707,COGS 11,A01,083617,Boyle; Mary E. T.,16,2,48,32
1656134439734,COGS 13,A01,083071,Bastos; Amalia Pinkusfeld,9,3,71,62
1656134445830,COGS 14A,A01,092681,Semenuks; Arturs,8,23,100,92
1656134451868,COGS 14B,A01,083073,Cheng; Tzu-Han,7,0,63,56
1656134457894,COGS 17,A01,092677,Semenuks; Arturs,13,6,81,68
1656134463921,COGS 100,A01,083619,Allen; Michael Gordon,7,5,70,63
1656134469945,COGS 101A,A01,083621,Davis; Joshua Daniel,7,4,68,61
1656134475968,COGS 101B,A01,091572,Allen; Michael Gordon,6,0,65,59
1656134481991,COGS 101C,A01,083625,Delgado; Tania,10,0,35,25
1656134488018,COGS 107A,A01,083627,Boyle; Mary E. T.,5,4,60,55
1656134494042,COGS 118A,A01,083075,Gupta; Anjum,24,17,76,52
1656134500066,CSE 3,A50,083646,Miranda; Gregory Joseph,18,0,50,32
1656134506095,CSE 8A,A50,083650,Miranda; Gregory Joseph,13,13,56,43
1656134512121,CSE 11,A01,083080,Cao; Yingjun,2,58,40,38
1656134518148,CSE 12,A01,083652,Krause-Levy; Sophia Louisa,14,8,120,106
1656134524172,CSE 15L,A01,083654,Morris; Justin Loren,5,2,50,45
1656134524172,CSE 15L,A02,083655,Morris; Justin Loren,7,3,50,43
1656134530199,CSE 20,A01,083657,Tran; Khoa Dang,31,0,80,49
1656134536226,CSE 21,A01,095574,Bach; Quang Tran,25,0,48,23
1656134542250,CSE 30,A01,083084,Eldon; John,3,11,80,77
1656134542250,CSE 30,B01,095061,Bhaskar; Nishant,4,6,50,46
1656134548273,CSE 100,A01,083659,Cao; Yingjun,2,22,70,68
1656134554296,CSE 134B,A01,083661,Powell; Thomas Allan,11,8,100,89
1656134560319,CSE 140,A01,083663,Gungor; Onat,10,0,85,75
1656134566346,CSE 140L,A01,083088,Eldon; John,8,0,100,92
1656134572369,CSE 175,A01,083665,Kumar; Rakesh,0,0,25,25
1656134578391,CSE 190,A00,092507,Dubnov; Shlomo,2,0,20,18
1656134584415,ECE 45,A01,083139,Congero; Spencer William,5,4,75,70
1656134590449,ECE 65,A50,083695,Saad; Andrew S,8,0,30,22
1656134590449,ECE 65,A51,095125,Staff,23,0,26,3
1656134596474,ECE 109,A01,091882,Touri; Behrouz,7,8,70,63
1656134602505,ECE 180,A00,083140,Abi Samra; Nicholas Camill,1,0,30,29
1656134602505,ECE 180,B00,083141,Abi Samra; Nicholas Camill,4,8,30,26
1656134608529,MATH 10A,A01,083735,Patchell; Gregory David,0,0,30,30
1656134608529,MATH 10A,A02,083736,Patchell; Gregory David,22,0,30,8
1656134608529,MATH 10A,A03,083737,Patchell; Gregory David,16,0,30,14
1656134614570,MATH 10B,A01,083207,Lim; Seonhee,3,3,34,31
1656134614570,MATH 10B,A02,083208,Lim; Seonhee,10,3,35,25
1656134614570,MATH 10B,A03,093472,Staff,4,3,34,30
1656134614570,MATH 10B,B01,083739,Sinha; Shubham,11,0,30,19
1656134620593,MATH 18,A01,083743,Cinel; Cameron Alexander,7,0,30,23
1656134620593,MATH 18,A02,083744,Cinel; Cameron Alexander,10,0,30,20
1656134620593,MATH 18,A03,083745,Cinel; Cameron Alexander,3,0,30,27
1656134620593,MATH 18,B01,083748,Rideout; David Porter,0,0,36,36
1656134620593,MATH 18,B02,083749,Rideout; David Porter,0,0,36,36
1656134620593,MATH 18,B03,083750,Rideout; David Porter,0,0,36,36
1656134620593,MATH 18,B04,083751,Rideout; David Porter,0,0,36,36
1656134620593,MATH 18,B05,093473,Rideout; David Porter,2,0,36,34
1656134620593,MATH 18,B06,093474,Rideout; David Porter,4,0,36,32
1656134626624,MATH 20A,A01,083754,Zheng; Zequn,11,0,40,29
1656134632652,MATH 20B,A01,083756,Briones; Jor-el Thomas Caparas,0,0,36,36
1656134632652,MATH 20B,A02,083757,Briones; Jor-el Thomas Caparas,0,0,36,36
1656134632652,MATH 20B,A03,093475,Staff,2,0,36,34
1656134638688,MATH 20C,A01,083760,Briones; Jor-el Thomas Caparas,2,2,35,33
1656134638688,MATH 20C,A02,083761,Briones; Jor-el Thomas Caparas,9,1,35,26
1656134638688,MATH 20C,A03,093476,Staff,1,1,35,34
1656134638688,MATH 20C,B01,083762,Bach; Quang Tran,1,0,30,29
1656134644711,MATH 20D,A01,083765,Tran; Brian Kha,2,0,30,28
1656134644711,MATH 20D,A02,083766,Tran; Brian Kha,0,1,30,30
1656134644711,MATH 20D,A03,083767,Tran; Brian Kha,2,0,30,28
1656134650737,MATH 20E,A01,083771,Ganguly; Soumya,5,1,32,27
1656134650737,MATH 20E,A02,083772,Ganguly; Soumya,3,2,32,29
1656134650737,MATH 20E,B01,083773,Ciotti; Benjamin,14,0,35,21
1656134650737,MATH 20E,B02,083774,Ciotti; Benjamin,14,0,35,21
1656134656762,MATH 103A,A01,083777,Greenfeld; Be'Eri,2,0,36,34
1656134656762,MATH 103A,A02,083778,Greenfeld; Be'Eri,1,0,36,35
1656134656762,MATH 103A,A03,093561,Staff,4,1,36,32
1656134656762,MATH 103A,B01,083779,Greenfeld; Be'Eri,8,1,36,28
1656134656762,MATH 103A,B02,083780,Greenfeld; Be'Eri,0,0,36,36
1656134656762,MATH 103A,B03,093562,Staff,0,0,36,36
1656134662787,MATH 105,A01,085443,Carter; Anne Toulson,4,1,35,31
1656134662787,MATH 105,A02,093477,Staff,9,0,35,26
1656134668813,MATH 109,A01,083213,Ganzberger; Geoffrey Michael,1,1,34,33
1656134668813,MATH 109,A02,083214,Ganzberger; Geoffrey Michael,0,0,34,34
1656134668813,MATH 109,A03,093478,Staff,1,0,34,33
1656134668813,MATH 109,B01,083215,Ganzberger; Geoffrey Michael,3,0,32,29
1656134668813,MATH 109,B02,083216,Ganzberger; Geoffrey Michael,1,0,32,31
1656134668813,MATH 109,B03,093479,Staff,4,0,32,28
1656134674836,MATH 142A,A01,083219,Chow; Bennett,1,0,32,31
1656134674836,MATH 142A,A02,083220,Chow; Bennett,8,0,32,24
1656134674836,MATH 142A,A03,093480,Staff,5,0,32,27
1656134674836,MATH 142A,B03,093481,Staff,4,0,32,28
1656134674836,MATH 142A,B04,093558,Staff,5,0,32,27
1656134674836,MATH 142A,B05,093559,Staff,0,0,32,32
1656134680864,MATH 193A,A01,083224,Rotar; Vladimir,1,2,34,33
1656134680864,MATH 193A,A02,083225,Rotar; Vladimir,0,0,34,34
1656134680864,MATH 193A,A03,083781,Rotar; Vladimir,0,0,34,34
1656134680864,MATH 193A,A04,083782,Rotar; Vladimir,6,0,34,28
1656134680864,MATH 193A,A05,093482,Rotar; Vladimir,1,0,34,33
1656134686888,MATH 197,001,091859,McAuley; Julian John,9999,0,9999,0
1656134686888,MATH 197,002,095566,Kedlaya; Kiran S.,9997,0,9999,2
1656134686888,MATH 197,003,095567,Xiao; Ming,9999,0,9999,0
1656134686888,MATH 197,004,095571,Perols; Johan Lars,9998,0,9999,1
1656134693944,COGS 9,A01,083615,Shannon; Kyle Michael,5,1,75,70
1656134699967,COGS 11,A01,083617,Boyle; Mary E. T.,16,2,48,32
1656134705992,COGS 13,A01,083071,Bastos; Amalia Pinkusfeld,9,3,71,62
1656134712016,COGS 14A,A01,092681,Semenuks; Arturs,8,23,100,92
1656134718042,COGS 14B,A01,083073,Cheng; Tzu-Han,7,0,63,56
1656134724066,COGS 17,A01,092677,Semenuks; Arturs,13,6,81,68
1656134730089,COGS 100,A01,083619,Allen; Michael Gordon,7,5,70,63
1656134736121,COGS 101A,A01,083621,Davis; Joshua Daniel,7,4,68,61
1656134742148,COGS 101B,A01,091572,Allen; Michael Gordon,6,0,65,59
1656134748174,COGS 101C,A01,083625,Delgado; Tania,10,0,35,25
1656134754202,COGS 107A,A01,083627,Boyle; Mary E. T.,5,4,60,55
1656134760230,COGS 118A,A01,083075,Gupta; Anjum,24,17,76,52
1656134766258,CSE 3,A50,083646,Miranda; Gregory Joseph,18,0,50,32
1656134772282,CSE 8A,A50,083650,Miranda; Gregory Joseph,13,13,56,43
1656134778305,CSE 11,A01,083080,Cao; Yingjun,2,58,40,38
1656134784338,CSE 12,A01,083652,Krause-Levy; Sophia Louisa,14,8,120,106
1656134790362,CSE 15L,A01,083654,Morris; Justin Loren,5,2,50,45
1656134790362,CSE 15L,A02,083655,Morris; Justin Loren,7,3,50,43
1656134796385,CSE 20,A01,083657,Tran; Khoa Dang,31,0,80,49
1656134802413,CSE 21,A01,095574,Bach; Quang Tran,25,0,48,23
1656134808443,CSE 30,A01,083084,Eldon; John,3,11,80,77
1656134808443,CSE 30,B01,095061,Bhaskar; Nishant,4,6,50,46
1656134814465,CSE 100,A01,083659,Cao; Yingjun,2,22,70,68
1656134820504,CSE 134B,A01,083661,Powell; Thomas Allan,10,7,100,90
1656134826528,CSE 140,A01,083663,Gungor; Onat,10,0,85,75
1656134832559,CSE 140L,A01,083088,Eldon; John,8,0,100,92
1656134838586,CSE 175,A01,083665,Kumar; Rakesh,0,0,25,25
1656134844612,CSE 190,A00,092507,Dubnov; Shlomo,2,0,20,18
1656134850638,ECE 45,A01,083139,Congero; Spencer William,5,4,75,70
1656134856669,ECE 65,A50,083695,Saad; Andrew S,8,0,30,22
1656134856669,ECE 65,A51,095125,Staff,23,0,26,3
1656134862693,ECE 109,A01,091882,Touri; Behrouz,7,8,70,63
1656134868728,ECE 180,A00,083140,Abi Samra; Nicholas Camill,1,0,30,29
1656134868728,ECE 180,B00,083141,Abi Samra; Nicholas Camill,4,8,30,26
1656134874750,MATH 10A,A01,083735,Patchell; Gregory David,0,0,30,30
1656134874750,MATH 10A,A02,083736,Patchell; Gregory David,22,0,30,8
1656134874750,MATH 10A,A03,083737,Patchell; Gregory David,16,0,30,14
1656134880775,MATH 10B,A01,083207,Lim; Seonhee,0,0,34,34
1656134880775,MATH 10B,A02,083208,Lim; Seonhee,7,0,35,28
1656134880775,MATH 10B,A03,093472,Staff,1,0,34,33
1656134880775,MATH 10B,B01,083739,Sinha; Shubham,11,0,30,19
1656134886802,MATH 18,A01,083743,Cinel; Cameron Alexander,7,0,30,23
1656134886802,MATH 18,A02,083744,Cinel; Cameron Alexander,10,0,30,20
1656134886802,MATH 18,A03,083745,Cinel; Cameron Alexander,3,0,30,27
1656134886802,MATH 18,B01,083748,Rideout; David Porter,0,0,36,36
1656134886802,MATH 18,B02,083749,Rideout; David Porter,0,0,36,36
1656134886802,MATH 18,B03,083750,Rideout; David Porter,0,0,36,36
1656134886802,MATH 18,B04,083751,Rideout; David Porter,0,0,36,36
1656134886802,MATH 18,B05,093473,Rideout; David Porter,2,0,36,34
1656134886802,MATH 18,B06,093474,Rideout; David Porter,4,0,36,32
1656134892825,MATH 20A,A01,083754,Zheng; Zequn,11,0,40,29
1656134898849,MATH 20B,A01,083756,Briones; Jor-el Thomas Caparas,0,0,36,36
1656134898849,MATH 20B,A02,083757,Briones; Jor-el Thomas Caparas,0,0,36,36
1656134898849,MATH 20B,A03,093475,Staff,2,0,36,34
1656134904874,MATH 20C,A01,083760,Briones; Jor-el Thomas Caparas,1,0,35,34
1656134904874,MATH 20C,A02,083761,Briones; Jor-el Thomas Caparas,9,1,35,26
1656134904874,MATH 20C,A03,093476,Staff,0,0,35,35
1656134904874,MATH 20C,B01,083762,Bach; Quang Tran,1,0,30,29
1656134910908,MATH 20D,A01,083765,Tran; Brian Kha,2,0,30,28
1656134910908,MATH 20D,A02,083766,Tran; Brian Kha,0,1,30,30
1656134910908,MATH 20D,A03,083767,Tran; Brian Kha,2,0,30,28
1656134916937,MATH 20E,A01,083771,Ganguly; Soumya,4,0,32,28
1656134916937,MATH 20E,A02,083772,Ganguly; Soumya,1,0,32,31
1656134916937,MATH 20E,B01,083773,Ciotti; Benjamin,14,0,35,21
1656134916937,MATH 20E,B02,083774,Ciotti; Benjamin,14,0,35,21
1656134922961,MATH 103A,A01,083777,Greenfeld; Be'Eri,2,0,36,34
1656134922961,MATH 103A,A02,083778,Greenfeld; Be'Eri,1,0,36,35
1656134922961,MATH 103A,A03,093561,Staff,3,0,36,33
1656134922961,MATH 103A,B01,083779,Greenfeld; Be'Eri,8,1,36,28
1656134922961,MATH 103A,B02,083780,Greenfeld; Be'Eri,0,0,36,36
1656134922961,MATH 103A,B03,093562,Staff,0,0,36,36
1656134928991,MATH 105,A01,085443,Carter; Anne Toulson,4,1,35,31
1656134928991,MATH 105,A02,093477,Staff,9,0,35,26
1656134935017,MATH 109,A01,083213,Ganzberger; Geoffrey Michael,0,0,34,34
1656134935017,MATH 109,A02,083214,Ganzberger; Geoffrey Michael,0,0,34,34
1656134935017,MATH 109,A03,093478,Staff,1,0,34,33
1656134935017,MATH 109,B01,083215,Ganzberger; Geoffrey Michael,3,0,32,29
1656134935017,MATH 109,B02,083216,Ganzberger; Geoffrey Michael,1,0,32,31
1656134935017,MATH 109,B03,093479,Staff,4,0,32,28
1656134941044,MATH 142A,A01,083219,Chow; Bennett,1,0,32,31
1656134941044,MATH 142A,A02,083220,Chow; Bennett,8,0,32,24
1656134941044,MATH 142A,A03,093480,Staff,5,0,32,27
1656134941044,MATH 142A,B03,093481,Staff,4,0,32,28
1656134941044,MATH 142A,B04,093558,Staff,5,0,32,27
1656134941044,MATH 142A,B05,093559,Staff,0,0,32,32
1656134947073,MATH 193A,A01,083224,Rotar; Vladimir,0,1,34,34
1656134947073,MATH 193A,A02,083225,Rotar; Vladimir,0,0,34,34
1656134947073,MATH 193A,A03,083781,Rotar; Vladimir,0,0,34,34
1656134947073,MATH 193A,A04,083782,Rotar; Vladimir,6,0,34,28
1656134947073,MATH 193A,A05,093482,Rotar; Vladimir,1,0,34,33
1656134953097,MATH 197,001,091859,McAuley; Julian John,9999,0,9999,0
1656134953097,MATH 197,002,095566,Kedlaya; Kiran S.,9997,0,9999,2
1656134953097,MATH 197,003,095567,Xiao; Ming,9999,0,9999,0
1656134953097,MATH 197,004,095571,Perols; Johan Lars,9998,0,9999,1
1656134960156,COGS 9,A01,083615,Shannon; Kyle Michael,4,0,75,71
1656134966180,COGS 11,A01,083617,Boyle; Mary E. T.,15,1,48,33
1656134972206,COGS 13,A01,083071,Bastos; Amalia Pinkusfeld,9,3,71,62
1656134978232,COGS 14A,A01,092681,Semenuks; Arturs,7,22,100,93
1656134984254,COGS 14B,A01,083073,Cheng; Tzu-Han,7,0,63,56
1656134990284,COGS 17,A01,092677,Semenuks; Arturs,10,3,81,71
1656134996308,COGS 100,A01,083619,Allen; Michael Gordon,5,3,70,65
1656135002336,COGS 101A,A01,083621,Davis; Joshua Daniel,5,2,68,63
1656135008364,COGS 101B,A01,091572,Allen; Michael Gordon,6,0,65,59
1656135014392,COGS 101C,A01,083625,Delgado; Tania,10,0,35,25
1656135020419,COGS 107A,A01,083627,Boyle; Mary E. T.,3,2,60,57
1656135026445,COGS 118A,A01,083075,Gupta; Anjum,10,3,76,66
1656135032479,CSE 3,A50,083646,Miranda; Gregory Joseph,18,0,50,32
1656135038508,CSE 8A,A50,083650,Miranda; Gregory Joseph,6,6,56,50
1656135044624,CSE 11,A01,083080,Cao; Yingjun,1,56,40,39
1656135050650,CSE 12,A01,083652,Krause-Levy; Sophia Louisa,9,3,120,111
1656135056673,CSE 15L,A01,083654,Morris; Justin Loren,4,1,50,46
1656135056673,CSE 15L,A02,083655,Morris; Justin Loren,6,2,50,44
1656135062727,CSE 20,A01,083657,Tran; Khoa Dang,31,0,80,49
1656135068750,CSE 21,A01,095574,Bach; Quang Tran,25,0,48,23
1656135074774,CSE 30,A01,083084,Eldon; John,3,10,80,77
1656135074774,CSE 30,B01,095061,Bhaskar; Nishant,2,3,50,48
1656135080797,CSE 100,A01,083659,Cao; Yingjun,2,20,70,68
1656135086822,CSE 134B,A01,083661,Powell; Thomas Allan,4,1,100,96
1656135092852,CSE 140,A01,083663,Gungor; Onat,10,0,85,75
1656135098883,CSE 140L,A01,083088,Eldon; John,8,0,100,92
1656135104910,CSE 175,A01,083665,Kumar; Rakesh,0,0,25,25
1656135110933,CSE 190,A00,092507,Dubnov; Shlomo,2,0,20,18
1656135116967,ECE 45,A01,083139,Congero; Spencer William,3,1,75,72
1656135122999,ECE 65,A50,083695,Saad; Andrew S,8,0,30,22
1656135122999,ECE 65,A51,095125,Staff,23,0,26,3
1656135129022,ECE 109,A01,091882,Touri; Behrouz,0,1,70,70
1656135135047,ECE 180,A00,083140,Abi Samra; Nicholas Camill,1,0,30,29
1656135135047,ECE 180,B00,083141,Abi Samra; Nicholas Camill,0,4,30,30
1656135141071,MATH 10A,A01,083735,Patchell; Gregory David,0,0,30,30
1656135141071,MATH 10A,A02,083736,Patchell; Gregory David,22,0,30,8
1656135141071,MATH 10A,A03,083737,Patchell; Gregory David,16,0,30,14
1656135147097,MATH 10B,A01,083207,Lim; Seonhee,0,0,34,34
1656135147097,MATH 10B,A02,083208,Lim; Seonhee,7,0,35,28
1656135147097,MATH 10B,A03,093472,Staff,1,0,34,33
1656135147097,MATH 10B,B01,083739,Sinha; Shubham,11,0,30,19
1656135153122,MATH 18,A01,083743,Cinel; Cameron Alexander,7,0,30,23
1656135153122,MATH 18,A02,083744,Cinel; Cameron Alexander,10,0,30,20
1656135153122,MATH 18,A03,083745,Cinel; Cameron Alexander,3,0,30,27
1656135153122,MATH 18,B01,083748,Rideout; David Porter,0,0,36,36
1656135153122,MATH 18,B02,083749,Rideout; David Porter,0,0,36,36
1656135153122,MATH 18,B03,083750,Rideout; David Porter,0,0,36,36
1656135153122,MATH 18,B04,083751,Rideout; David Porter,0,0,36,36
1656135153122,MATH 18,B05,093473,Rideout; David Porter,2,0,36,34
1656135153122,MATH 18,B06,093474,Rideout; David Porter,4,0,36,32
1656135159150,MATH 20A,A01,083754,Zheng; Zequn,11,0,40,29
1656135165173,MATH 20B,A01,083756,Briones; Jor-el Thomas Caparas,0,0,36,36
1656135165173,MATH 20B,A02,083757,Briones; Jor-el Thomas Caparas,0,0,36,36
1656135165173,MATH 20B,A03,093475,Staff,2,0,36,34
1656135171208,MATH 20C,A01,083760,Briones; Jor-el Thomas Caparas,1,0,35,34
1656135171208,MATH 20C,A02,083761,Briones; Jor-el Thomas Caparas,9,1,35,26
1656135171208,MATH 20C,A03,093476,Staff,0,0,35,35
1656135171208,MATH 20C,B01,083762,Bach; Quang Tran,1,0,30,29
1656135177233,MATH 20D,A01,083765,Tran; Brian Kha,2,0,30,28
1656135177233,MATH 20D,A02,083766,Tran; Brian Kha,0,1,30,30
1656135177233,MATH 20D,A03,083767,Tran; Brian Kha,2,0,30,28
1656135183262,MATH 20E,A01,083771,Ganguly; Soumya,4,0,32,28
1656135183262,MATH 20E,A02,083772,Ganguly; Soumya,1,0,32,31
1656135183262,MATH 20E,B01,083773,Ciotti; Benjamin,14,0,35,21
1656135183262,MATH 20E,B02,083774,Ciotti; Benjamin,14,0,35,21
1656135189287,MATH 103A,A01,083777,Greenfeld; Be'Eri,1,0,36,35
1656135189287,MATH 103A,A02,083778,Greenfeld; Be'Eri,1,0,36,35
1656135189287,MATH 103A,A03,093561,Staff,3,0,36,33
1656135189287,MATH 103A,B01,083779,Greenfeld; Be'Eri,8,1,36,28
1656135189287,MATH 103A,B02,083780,Greenfeld; Be'Eri,0,0,36,36
1656135189287,MATH 103A,B03,093562,Staff,0,0,36,36
1656135195311,MATH 105,A01,085443,Carter; Anne Toulson,4,1,35,31
1656135195311,MATH 105,A02,093477,Staff,9,0,35,26
1656135201336,MATH 109,A01,083213,Ganzberger; Geoffrey Michael,0,0,34,34
1656135201336,MATH 109,A02,083214,Ganzberger; Geoffrey Michael,0,0,34,34
1656135201336,MATH 109,A03,093478,Staff,1,0,34,33
1656135201336,MATH 109,B01,083215,Ganzberger; Geoffrey Michael,3,0,32,29
1656135201336,MATH 109,B02,083216,Ganzberger; Geoffrey Michael,1,0,32,31
1656135201336,MATH 109,B03,093479,Staff,4,0,32,28
1656135207365,MATH 142A,A01,083219,Chow; Bennett,1,0,32,31
1656135207365,MATH 142A,A02,083220,Chow; Bennett,8,0,32,24
1656135207365,MATH 142A,A03,093480,Staff,5,0,32,27
1656135207365,MATH 142A,B03,093481,Staff,4,0,32,28
1656135207365,MATH 142A,B04,093558,Staff,5,0,32,27
1656135207365,MATH 142A,B05,093559,Staff,0,0,32,32
1656135213390,MATH 193A,A01,083224,Rotar; Vladimir,0,1,34,34
1656135213390,MATH 193A,A02,083225,Rotar; Vladimir,0,0,34,34
1656135213390,MATH 193A,A03,083781,Rotar; Vladimir,0,0,34,34
1656135213390,MATH 193A,A04,083782,Rotar; Vladimir,6,0,34,28
1656135213390,MATH 193A,A05,093482,Rotar; Vladimir,1,0,34,33
1656135219413,MATH 197,001,091859,McAuley; Julian John,9999,0,9999,0
1656135219413,MATH 197,002,095566,Kedlaya; Kiran S.,9997,0,9999,2
1656135219413,MATH 197,003,095567,Xiao; Ming,9999,0,9999,0
1656135219413,MATH 197,004,095571,Perols; Johan Lars,9998,0,9999,1
1656135226489,COGS 9,A01,083615,Shannon; Kyle Michael,4,0,75,71
1656135232511,COGS 11,A01,083617,Boyle; Mary E. T.,14,0,48,34
1656135238534,COGS 13,A01,083071,Bastos; Amalia Pinkusfeld,6,0,71,65
1656135244566,COGS 14A,A01,092681,Semenuks; Arturs,3,15,100,97
1656135250589,COGS 14B,A01,083073,Cheng; Tzu-Han,7,0,63,56
1656135256616,COGS 17,A01,092677,Semenuks; Arturs,8,0,81,73
1656135262640,COGS 100,A01,083619,Allen; Michael Gordon,3,0,70,67
1656135268666,COGS 101A,A01,083621,Davis; Joshua Daniel,3,0,68,65
1656135274694,COGS 101B,A01,091572,Allen; Michael Gordon,6,0,65,59
1656135280720,COGS 101C,A01,083625,Delgado; Tania,10,0,35,25
1656135286750,COGS 107A,A01,083627,Boyle; Mary E. T.,1,0,60,59
1656135292774,COGS 118A,A01,083075,Gupta; Anjum,7,0,76,69
1656135298801,CSE 3,A50,083646,Miranda; Gregory Joseph,18,0,50,32
1656135304831,CSE 8A,A50,083650,Miranda; Gregory Joseph,2,2,56,54
1656135310859,CSE 11,A01,083080,Cao; Yingjun,1,54,40,39
1656135316883,CSE 12,A01,083652,Krause-Levy; Sophia Louisa,7,1,120,113
1656135322907,CSE 15L,A01,083654,Morris; Justin Loren,3,0,50,47
1656135322907,CSE 15L,A02,083655,Morris; Justin Loren,4,0,50,46
1656135328937,CSE 20,A01,083657,Tran; Khoa Dang,31,0,80,49
1656135334964,CSE 21,A01,095574,Bach; Quang Tran,25,0,48,23
1656135340988,CSE 30,A01,083084,Eldon; John,2,8,80,78
1656135340988,CSE 30,B01,095061,Bhaskar; Nishant,1,2,50,49
1656135347014,CSE 100,A01,083659,Cao; Yingjun,2,20,70,68
1656135353042,CSE 134B,A01,083661,Powell; Thomas Allan,3,0,100,97
1656135359073,CSE 140,A01,083663,Gungor; Onat,10,0,85,75
1656135365099,CSE 140L,A01,083088,Eldon; John,8,0,100,92
1656135371126,CSE 175,A01,083665,Kumar; Rakesh,0,0,25,25
1656135377160,CSE 190,A00,092507,Dubnov; Shlomo,2,0,20,18
1656135383184,ECE 45,A01,083139,Congero; Spencer William,2,0,75,73
1656135389207,ECE 65,A50,083695,Saad; Andrew S,8,0,30,22
1656135389207,ECE 65,A51,095125,Staff,23,0,26,3
1656135395239,ECE 109,A01,091882,Touri; Behrouz,0,1,70,70
1656135401264,ECE 180,A00,083140,Abi Samra; Nicholas Camill,1,0,30,29
1656135401264,ECE 180,B00,083141,Abi Samra; Nicholas Camill,0,4,30,30
1656135407292,MATH 10A,A01,083735,Patchell; Gregory David,0,0,30,30
1656135407292,MATH 10A,A02,083736,Patchell; Gregory David,22,0,30,8
1656135407292,MATH 10A,A03,083737,Patchell; Gregory David,16,0,30,14
1656135413322,MATH 10B,A01,083207,Lim; Seonhee,0,0,34,34
1656135413322,MATH 10B,A02,083208,Lim; Seonhee,7,0,35,28
1656135413322,MATH 10B,A03,093472,Staff,1,0,34,33
1656135413322,MATH 10B,B01,083739,Sinha; Shubham,11,0,30,19
1656135419353,MATH 18,A01,083743,Cinel; Cameron Alexander,7,0,30,23
1656135419353,MATH 18,A02,083744,Cinel; Cameron Alexander,10,0,30,20
1656135419353,MATH 18,A03,083745,Cinel; Cameron Alexander,3,0,30,27
1656135419353,MATH 18,B01,083748,Rideout; David Porter,0,0,36,36
1656135419353,MATH 18,B02,083749,Rideout; David Porter,0,0,36,36
1656135419353,MATH 18,B03,083750,Rideout; David Porter,0,0,36,36
1656135419353,MATH 18,B04,083751,Rideout; David Porter,0,0,36,36
1656135419353,MATH 18,B05,093473,Rideout; David Porter,2,0,36,34
1656135419353,MATH 18,B06,093474,Rideout; David Porter,4,0,36,32
1656135425375,MATH 20A,A01,083754,Zheng; Zequn,11,0,40,29
1656135431400,MATH 20B,A01,083756,Briones; Jor-el Thomas Caparas,0,0,36,36
1656135431400,MATH 20B,A02,083757,Briones; Jor-el Thomas Caparas,0,0,36,36
1656135431400,MATH 20B,A03,093475,Staff,2,0,36,34
1656135437428,MATH 20C,A01,083760,Briones; Jor-el Thomas Caparas,1,0,35,34
1656135437428,MATH 20C,A02,083761,Briones; Jor-el Thomas Caparas,9,1,35,26
1656135437428,MATH 20C,A03,093476,Staff,0,0,35,35
1656135437428,MATH 20C,B01,083762,Bach; Quang Tran,1,0,30,29
1656135443453,MATH 20D,A01,083765,Tran; Brian Kha,2,0,30,28
1656135443453,MATH 20D,A02,083766,Tran; Brian Kha,0,1,30,30
1656135443453,MATH 20D,A03,083767,Tran; Brian Kha,2,0,30,28
1656135449481,MATH 20E,A01,083771,Ganguly; Soumya,4,0,32,28
1656135449481,MATH 20E,A02,083772,Ganguly; Soumya,1,0,32,31
1656135449481,MATH 20E,B01,083773,Ciotti; Benjamin,14,0,35,21
1656135449481,MATH 20E,B02,083774,Ciotti; Benjamin,14,0,35,21
1656135455510,MATH 103A,A01,083777,Greenfeld; Be'Eri,1,0,36,35
1656135455510,MATH 103A,A02,083778,Greenfeld; Be'Eri,1,0,36,35
1656135455510,MATH 103A,A03,093561,Staff,3,0,36,33
1656135455510,MATH 103A,B01,083779,Greenfeld; Be'Eri,8,1,36,28
1656135455510,MATH 103A,B02,083780,Greenfeld; Be'Eri,0,0,36,36
1656135455510,MATH 103A,B03,093562,Staff,0,0,36,36
1656135461535,MATH 105,A01,085443,Carter; Anne Toulson,4,1,35,31
1656135461535,MATH 105,A02,093477,Staff,9,0,35,26
1656135467559,MATH 109,A01,083213,Ganzberger; Geoffrey Michael,0,0,34,34
1656135467559,MATH 109,A02,083214,Ganzberger; Geoffrey Michael,0,0,34,34
1656135467559,MATH 109,A03,093478,Staff,1,0,34,33
1656135467559,MATH 109,B01,083215,Ganzberger; Geoffrey Michael,3,0,32,29
1656135467559,MATH 109,B02,083216,Ganzberger; Geoffrey Michael,1,0,32,31
1656135467559,MATH 109,B03,093479,Staff,4,0,32,28
1656135473584,MATH 142A,A01,083219,Chow; Bennett,1,0,32,31
1656135473584,MATH 142A,A02,083220,Chow; Bennett,8,0,32,24
1656135473584,MATH 142A,A03,093480,Staff,5,0,32,27
1656135473584,MATH 142A,B03,093481,Staff,4,0,32,28
1656135473584,MATH 142A,B04,093558,Staff,5,0,32,27
1656135473584,MATH 142A,B05,093559,Staff,0,0,32,32
1656135479617,MATH 193A,A01,083224,Rotar; Vladimir,0,1,34,34
1656135479617,MATH 193A,A02,083225,Rotar; Vladimir,0,0,34,34
1656135479617,MATH 193A,A03,083781,Rotar; Vladimir,0,0,34,34
1656135479617,MATH 193A,A04,083782,Rotar; Vladimir,6,0,34,28
1656135479617,MATH 193A,A05,093482,Rotar; Vladimir,1,0,34,33
1656135485641,MATH 197,001,091859,McAuley; Julian John,9999,0,9999,0
1656135485641,MATH 197,002,095566,Kedlaya; Kiran S.,9997,0,9999,2
1656135485641,MATH 197,003,095567,Xiao; Ming,9999,0,9999,0
1656135485641,MATH 197,004,095571,Perols; Johan Lars,9998,0,9999,1
1656135492700,COGS 9,A01,083615,Shannon; Kyle Michael,4,0,75,71
1656135498723,COGS 11,A01,083617,Boyle; Mary E. T.,15,0,48,33
1656135504747,COGS 13,A01,083071,Bastos; Amalia Pinkusfeld,6,0,71,65
1656135510775,COGS 14A,A01,092681,Semenuks; Arturs,3,15,100,97
1656135516803,COGS 14B,A01,083073,Cheng; Tzu-Han,7,0,63,56
1656135522826,COGS 17,A01,092677,Semenuks; Arturs,8,0,81,73
1656135528854,COGS 100,A01,083619,Allen; Michael Gordon,3,0,70,67
1656135534892,COGS 101A,A01,083621,Davis; Joshua Daniel,3,0,68,65
1656135540915,COGS 101B,A01,091572,Allen; Michael Gordon,6,0,65,59
1656135546947,COGS 101C,A01,083625,Delgado; Tania,10,0,35,25
1656135552973,COGS 107A,A01,083627,Boyle; Mary E. T.,1,0,60,59
1656135559000,COGS 118A,A01,083075,Gupta; Anjum,7,0,76,69
1656135565032,CSE 3,A50,083646,Miranda; Gregory Joseph,18,0,50,32
1656135571055,CSE 8A,A50,083650,Miranda; Gregory Joseph,2,2,56,54
1656135577076,CSE 11,A01,083080,Cao; Yingjun,1,54,40,39
1656135583101,CSE 12,A01,083652,Krause-Levy; Sophia Louisa,7,1,120,113
1656135589129,CSE 15L,A01,083654,Morris; Justin Loren,3,0,50,47
1656135589129,CSE 15L,A02,083655,Morris; Justin Loren,4,0,50,46
1656135595153,CSE 20,A01,083657,Tran; Khoa Dang,31,0,80,49
1656135601188,CSE 21,A01,095574,Bach; Quang Tran,25,0,48,23
1656135607215,CSE 30,A01,083084,Eldon; John,2,8,80,78
1656135607215,CSE 30,B01,095061,Bhaskar; Nishant,1,2,50,49
1656135613238,CSE 100,A01,083659,Cao; Yingjun,2,20,70,68
1656135619265,CSE 134B,A01,083661,Powell; Thomas Allan,3,0,100,97
1656135625293,CSE 140,A01,083663,Gungor; Onat,10,0,85,75
1656135631316,CSE 140L,A01,083088,Eldon; John,8,0,100,92
1656135637338,CSE 175,A01,083665,Kumar; Rakesh,0,0,25,25
1656135643435,CSE 190,A00,092507,Dubnov; Shlomo,2,0,20,18
1656135649460,ECE 45,A01,083139,Congero; Spencer William,2,0,75,73
1656135655484,ECE 65,A50,083695,Saad; Andrew S,8,0,30,22
1656135655484,ECE 65,A51,095125,Staff,23,0,26,3
1656135661510,ECE 109,A01,091882,Touri; Behrouz,0,1,70,70
1656135667533,ECE 180,A00,083140,Abi Samra; Nicholas Camill,1,0,30,29
1656135667533,ECE 180,B00,083141,Abi Samra; Nicholas Camill,0,4,30,30
1656135673556,MATH 10A,A01,083735,Patchell; Gregory David,0,0,30,30
1656135673556,MATH 10A,A02,083736,Patchell; Gregory David,22,0,30,8
1656135673556,MATH 10A,A03,083737,Patchell; Gregory David,16,0,30,14
1656135679579,MATH 10B,A01,083207,Lim; Seonhee,0,0,34,34
1656135679579,MATH 10B,A02,083208,Lim; Seonhee,7,0,35,28
1656135679579,MATH 10B,A03,093472,Staff,1,0,34,33
1656135679579,MATH 10B,B01,083739,Sinha; Shubham,11,0,30,19
1656135685610,MATH 18,A01,083743,Cinel; Cameron Alexander,7,0,30,23
1656135685610,MATH 18,A02,083744,Cinel; Cameron Alexander,10,0,30,20
1656135685610,MATH 18,A03,083745,Cinel; Cameron Alexander,4,0,30,26
1656135685610,MATH 18,B01,083748,Rideout; David Porter,0,0,36,36
1656135685610,MATH 18,B02,083749,Rideout; David Porter,0,0,36,36
1656135685610,MATH 18,B03,083750,Rideout; David Porter,0,0,36,36
1656135685610,MATH 18,B04,083751,Rideout; David Porter,0,0,36,36
1656135685610,MATH 18,B05,093473,Rideout; David Porter,2,0,36,34
1656135685610,MATH 18,B06,093474,Rideout; David Porter,4,0,36,32
1656135691637,MATH 20A,A01,083754,Zheng; Zequn,11,0,40,29
1656135697661,MATH 20B,A01,083756,Briones; Jor-el Thomas Caparas,0,0,36,36
1656135697661,MATH 20B,A02,083757,Briones; Jor-el Thomas Caparas,0,0,36,36
1656135697661,MATH 20B,A03,093475,Staff,2,0,36,34
1656135703690,MATH 20C,A01,083760,Briones; Jor-el Thomas Caparas,0,0,35,35
1656135703690,MATH 20C,A02,083761,Briones; Jor-el Thomas Caparas,9,1,35,26
1656135703690,MATH 20C,A03,093476,Staff,0,0,35,35
1656135703690,MATH 20C,B01,083762,Bach; Quang Tran,1,0,30,29
1656135709719,MATH 20D,A01,083765,Tran; Brian Kha,2,0,30,28
1656135709719,MATH 20D,A02,083766,Tran; Brian Kha,0,1,30,30
1656135709719,MATH 20D,A03,083767,Tran; Brian Kha,2,0,30,28
1656135715743,MATH 20E,A01,083771,Ganguly; Soumya,4,0,32,28
1656135715743,MATH 20E,A02,083772,Ganguly; Soumya,1,0,32,31
1656135715743,MATH 20E,B01,083773,Ciotti; Benjamin,14,0,35,21
1656135715743,MATH 20E,B02,083774,Ciotti; Benjamin,14,0,35,21
1656135721768,MATH 103A,A01,083777,Greenfeld; Be'Eri,1,0,36,35
1656135721768,MATH 103A,A02,083778,Greenfeld; Be'Eri,1,0,36,35
1656135721768,MATH 103A,A03,093561,Staff,3,0,36,33
1656135721768,MATH 103A,B01,083779,Greenfeld; Be'Eri,8,1,36,28
1656135721768,MATH 103A,B02,083780,Greenfeld; Be'Eri,0,0,36,36
1656135721768,MATH 103A,B03,093562,Staff,0,0,36,36
1656135727799,MATH 105,A01,085443,Carter; Anne Toulson,4,1,35,31
1656135727799,MATH 105,A02,093477,Staff,9,0,35,26
1656135733824,MATH 109,A01,083213,Ganzberger; Geoffrey Michael,0,0,34,34
1656135733824,MATH 109,A02,083214,Ganzberger; Geoffrey Michael,0,0,34,34
1656135733824,MATH 109,A03,093478,Staff,1,0,34,33
1656135733824,MATH 109,B01,083215,Ganzberger; Geoffrey Michael,3,0,32,29
1656135733824,MATH 109,B02,083216,Ganzberger; Geoffrey Michael,1,0,32,31
1656135733824,MATH 109,B03,093479,Staff,4,0,32,28
1656135739849,MATH 142A,A01,083219,Chow; Bennett,1,0,32,31
1656135739849,MATH 142A,A02,083220,Chow; Bennett,8,0,32,24
1656135739849,MATH 142A,A03,093480,Staff,5,0,32,27
1656135739849,MATH 142A,B03,093481,Staff,4,0,32,28
1656135739849,MATH 142A,B04,093558,Staff,5,0,32,27
1656135739849,MATH 142A,B05,093559,Staff,0,0,32,32
1656135745873,MATH 193A,A01,083224,Rotar; Vladimir,0,1,34,34
1656135745873,MATH 193A,A02,083225,Rotar; Vladimir,0,0,34,34
1656135745873,MATH 193A,A03,083781,Rotar; Vladimir,0,0,34,34
1656135745873,MATH 193A,A04,083782,Rotar; Vladimir,6,0,34,28
1656135745873,MATH 193A,A05,093482,Rotar; Vladimir,1,0,34,33
1656135751899,MATH 197,001,091859,McAuley; Julian John,9999,0,9999,0
1656135751899,MATH 197,002,095566,Kedlaya; Kiran S.,9997,0,9999,2
1656135751899,MATH 197,003,095567,Xiao; Ming,9999,0,9999,0
1656135751899,MATH 197,004,095571,Perols; Johan Lars,9998,0,9999,1
1656135758963,COGS 9,A01,083615,Shannon; Kyle Michael,4,0,75,71
1656135764991,COGS 11,A01,083617,Boyle; Mary E. T.,15,0,48,33
1656135771015,COGS 13,A01,083071,Bastos; Amalia Pinkusfeld,6,0,71,65
1656135777050,COGS 14A,A01,092681,Semenuks; Arturs,3,15,100,97
1656135783073,COGS 14B,A01,083073,Cheng; Tzu-Han,7,0,63,56
1656135789111,COGS 17,A01,092677,Semenuks; Arturs,8,0,81,73
1656135795135,COGS 100,A01,083619,Allen; Michael Gordon,3,0,70,67
1656135801164,COGS 101A,A01,083621,Davis; Joshua Daniel,3,0,68,65
1656135807188,COGS 101B,A01,091572,Allen; Michael Gordon,6,0,65,59
1656135813216,COGS 101C,A01,083625,Delgado; Tania,10,0,35,25
1656135819243,COGS 107A,A01,083627,Boyle; Mary E. T.,1,0,60,59
1656135825267,COGS 118A,A01,083075,Gupta; Anjum,7,0,76,69
1656135831291,CSE 3,A50,083646,Miranda; Gregory Joseph,18,0,50,32
1656135837316,CSE 8A,A50,083650,Miranda; Gregory Joseph,2,2,56,54
1656135850806,CSE 11,A01,083080,Cao; Yingjun,1,54,40,39
1656135856835,CSE 12,A01,083652,Krause-Levy; Sophia Louisa,7,1,120,113
1656135862864,CSE 15L,A01,083654,Morris; Justin Loren,3,0,50,47
1656135862864,CSE 15L,A02,083655,Morris; Justin Loren,4,0,50,46
1656135868890,CSE 20,A01,083657,Tran; Khoa Dang,31,0,80,49
1656135874918,CSE 21,A01,095574,Bach; Quang Tran,25,0,48,23
1656135880944,CSE 30,A01,083084,Eldon; John,2,8,80,78
1656135880944,CSE 30,B01,095061,Bhaskar; Nishant,1,2,50,49
1656135886967,CSE 100,A01,083659,Cao; Yingjun,2,20,70,68
1656135892990,CSE 134B,A01,083661,Powell; Thomas Allan,3,0,100,97
1656135899013,CSE 140,A01,083663,Gungor; Onat,10,0,85,75
1656135905036,CSE 140L,A01,083088,Eldon; John,8,0,100,92
1656135911073,CSE 175,A01,083665,Kumar; Rakesh,0,0,25,25
1656135917101,CSE 190,A00,092507,Dubnov; Shlomo,2,0,20,18
1656135923125,ECE 45,A01,083139,Congero; Spencer William,2,0,75,73
1656135929149,ECE 65,A50,083695,Saad; Andrew S,8,0,30,22
1656135929149,ECE 65,A51,095125,Staff,23,0,26,3
1656135935175,ECE 109,A01,091882,Touri; Behrouz,0,1,70,70
1656135941202,ECE 180,A00,083140,Abi Samra; Nicholas Camill,1,0,30,29
1656135941202,ECE 180,B00,083141,Abi Samra; Nicholas Camill,0,4,30,30
1656135947226,MATH 10A,A01,083735,Patchell; Gregory David,0,0,30,30
1656135947226,MATH 10A,A02,083736,Patchell; Gregory David,22,0,30,8
1656135947226,MATH 10A,A03,083737,Patchell; Gregory David,16,0,30,14
1656135953248,MATH 10B,A01,083207,Lim; Seonhee,0,0,34,34
1656135953248,MATH 10B,A02,083208,Lim; Seonhee,7,0,35,28
1656135953248,MATH 10B,A03,093472,Staff,1,0,34,33
1656135953248,MATH 10B,B01,083739,Sinha; Shubham,11,0,30,19
1656135959285,MATH 18,A01,083743,Cinel; Cameron Alexander,7,0,30,23
1656135959285,MATH 18,A02,083744,Cinel; Cameron Alexander,10,0,30,20
1656135959285,MATH 18,A03,083745,Cinel; Cameron Alexander,4,0,30,26
1656135959285,MATH 18,B01,083748,Rideout; David Porter,0,0,36,36
1656135959285,MATH 18,B02,083749,Rideout; David Porter,0,0,36,36
1656135959285,MATH 18,B03,083750,Rideout; David Porter,0,0,36,36
1656135959285,MATH 18,B04,083751,Rideout; David Porter,0,0,36,36
1656135959285,MATH 18,B05,093473,Rideout; David Porter,2,0,36,34
1656135959285,MATH 18,B06,093474,Rideout; David Porter,4,0,36,32
1656135965307,MATH 20A,A01,083754,Zheng; Zequn,11,0,40,29
1656135971330,MATH 20B,A01,083756,Briones; Jor-el Thomas Caparas,0,0,36,36
1656135971330,MATH 20B,A02,083757,Briones; Jor-el Thomas Caparas,0,0,36,36
1656135971330,MATH 20B,A03,093475,Staff,2,0,36,34
1656135977355,MATH 20C,A01,083760,Briones; Jor-el Thomas Caparas,0,0,35,35
1656135977355,MATH 20C,A02,083761,Briones; Jor-el Thomas Caparas,9,1,35,26
1656135977355,MATH 20C,A03,093476,Staff,0,0,35,35
1656135977355,MATH 20C,B01,083762,Bach; Quang Tran,1,0,30,29
1656135983383,MATH 20D,A01,083765,Tran; Brian Kha,2,0,30,28
1656135983383,MATH 20D,A02,083766,Tran; Brian Kha,0,1,30,30
1656135983383,MATH 20D,A03,083767,Tran; Brian Kha,2,0,30,28
1656135989411,MATH 20E,A01,083771,Ganguly; Soumya,4,0,32,28
1656135989411,MATH 20E,A02,083772,Ganguly; Soumya,1,0,32,31
1656135989411,MATH 20E,B01,083773,Ciotti; Benjamin,14,0,35,21
1656135989411,MATH 20E,B02,083774,Ciotti; Benjamin,14,0,35,21
1656135995442,MATH 103A,A01,083777,Greenfeld; Be'Eri,1,0,36,35
1656135995442,MATH 103A,A02,083778,Greenfeld; Be'Eri,1,0,36,35
1656135995442,MATH 103A,A03,093561,Staff,3,0,36,33
1656135995442,MATH 103A,B01,083779,Greenfeld; Be'Eri,8,1,36,28
1656135995442,MATH 103A,B02,083780,Greenfeld; Be'Eri,0,0,36,36
1656135995442,MATH 103A,B03,093562,Staff,0,0,36,36
1656136001470,MATH 105,A01,085443,Carter; Anne Toulson,4,1,35,31
1656136001470,MATH 105,A02,093477,Staff,9,0,35,26
1656136007505,MATH 109,A01,083213,Ganzberger; Geoffrey Michael,0,0,34,34
1656136007505,MATH 109,A02,083214,Ganzberger; Geoffrey Michael,0,0,34,34
1656136007505,MATH 109,A03,093478,Staff,1,0,34,33
1656136007505,MATH 109,B01,083215,Ganzberger; Geoffrey Michael,3,0,32,29
1656136007505,MATH 109,B02,083216,Ganzberger; Geoffrey Michael,1,0,32,31
1656136007505,MATH 109,B03,093479,Staff,4,0,32,28
1656136013534,MATH 142A,A01,083219,Chow; Bennett,1,0,32,31
1656136013534,MATH 142A,A02,083220,Chow; Bennett,8,0,32,24
1656136013534,MATH 142A,A03,093480,Staff,5,0,32,27
1656136013534,MATH 142A,B03,093481,Staff,4,0,32,28
1656136013534,MATH 142A,B04,093558,Staff,5,0,32,27
1656136013534,MATH 142A,B05,093559,Staff,0,0,32,32
1656136019557,MATH 193A,A01,083224,Rotar; Vladimir,0,1,34,34
1656136019557,MATH 193A,A02,083225,Rotar; Vladimir,0,0,34,34
1656136019557,MATH 193A,A03,083781,Rotar; Vladimir,0,0,34,34
1656136019557,MATH 193A,A04,083782,Rotar; Vladimir,6,0,34,28
1656136019557,MATH 193A,A05,093482,Rotar; Vladimir,1,0,34,33
1656136025592,MATH 197,001,091859,McAuley; Julian John,9999,0,9999,0
1656136025592,MATH 197,002,095566,Kedlaya; Kiran S.,9997,0,9999,2
1656136025592,MATH 197,003,095567,Xiao; Ming,9999,0,9999,0
1656136025592,MATH 197,004,095571,Perols; Johan Lars,9998,0,9999,1
1656136032642,COGS 9,A01,083615,Shannon; Kyle Michael,4,0,75,71
1656136038673,COGS 11,A01,083617,Boyle; Mary E. T.,15,0,48,33
1656136044696,COGS 13,A01,083071,Bastos; Amalia Pinkusfeld,6,0,71,65
1656136050728,COGS 14A,A01,092681,Semenuks; Arturs,4,15,100,96
1656136056753,COGS 14B,A01,083073,Cheng; Tzu-Han,7,0,63,56
1656136062787,COGS 17,A01,092677,Semenuks; Arturs,8,0,81,73
1656136068810,COGS 100,A01,083619,Allen; Michael Gordon,3,0,70,67
1656136074832,COGS 101A,A01,083621,Davis; Joshua Daniel,3,0,68,65
1656136080861,COGS 101B,A01,091572,Allen; Michael Gordon,6,0,65,59
1656136086895,COGS 101C,A01,083625,Delgado; Tania,10,0,35,25
1656136092919,COGS 107A,A01,083627,Boyle; Mary E. T.,1,0,60,59
1656136098943,COGS 118A,A01,083075,Gupta; Anjum,7,0,76,69
1656136104973,CSE 3,A50,083646,Miranda; Gregory Joseph,18,0,50,32
1656136110997,CSE 8A,A50,083650,Miranda; Gregory Joseph,2,2,56,54
1656136117020,CSE 11,A01,083080,Cao; Yingjun,1,54,40,39
1656136123042,CSE 12,A01,083652,Krause-Levy; Sophia Louisa,7,1,120,113
1656136129065,CSE 15L,A01,083654,Morris; Justin Loren,3,0,50,47
1656136129065,CSE 15L,A02,083655,Morris; Justin Loren,4,0,50,46
1656136135089,CSE 20,A01,083657,Tran; Khoa Dang,31,0,80,49
1656136141112,CSE 21,A01,095574,Bach; Quang Tran,25,0,48,23
1656136147145,CSE 30,A01,083084,Eldon; John,2,8,80,78
1656136147145,CSE 30,B01,095061,Bhaskar; Nishant,1,2,50,49
1656136153169,CSE 100,A01,083659,Cao; Yingjun,2,20,70,68
1656136159195,CSE 134B,A01,083661,Powell; Thomas Allan,3,0,100,97
1656136165219,CSE 140,A01,083663,Gungor; Onat,10,0,85,75
1656136171243,CSE 140L,A01,083088,Eldon; John,8,0,100,92
1656136177276,CSE 175,A01,083665,Kumar; Rakesh,0,0,25,25
1656136183299,CSE 190,A00,092507,Dubnov; Shlomo,2,0,20,18
1656136189322,ECE 45,A01,083139,Congero; Spencer William,2,0,75,73
1656136195344,ECE 65,A50,083695,Saad; Andrew S,8,0,30,22
1656136195344,ECE 65,A51,095125,Staff,23,0,26,3
1656136201367,ECE 109,A01,091882,Touri; Behrouz,0,1,70,70
1656136207388,ECE 180,A00,083140,Abi Samra; Nicholas Camill,1,0,30,29
1656136207388,ECE 180,B00,083141,Abi Samra; Nicholas Camill,0,4,30,30
1656136213411,MATH 10A,A01,083735,Patchell; Gregory David,0,0,30,30
1656136213411,MATH 10A,A02,083736,Patchell; Gregory David,22,0,30,8
1656136213411,MATH 10A,A03,083737,Patchell; Gregory David,16,0,30,14
1656136219436,MATH 10B,A01,083207,Lim; Seonhee,0,0,34,34
1656136219436,MATH 10B,A02,083208,Lim; Seonhee,7,0,35,28
1656136219436,MATH 10B,A03,093472,Staff,1,0,34,33
1656136219436,MATH 10B,B01,083739,Sinha; Shubham,11,0,30,19
1656136225459,MATH 18,A01,083743,Cinel; Cameron Alexander,7,0,30,23
1656136225459,MATH 18,A02,083744,Cinel; Cameron Alexander,10,0,30,20
1656136225459,MATH 18,A03,083745,Cinel; Cameron Alexander,4,0,30,26
1656136225459,MATH 18,B01,083748,Rideout; David Porter,0,0,36,36
1656136225459,MATH 18,B02,083749,Rideout; David Porter,0,0,36,36
1656136225459,MATH 18,B03,083750,Rideout; David Porter,0,0,36,36
1656136225459,MATH 18,B04,083751,Rideout; David Porter,0,0,36,36
1656136225459,MATH 18,B05,093473,Rideout; David Porter,2,0,36,34
1656136225459,MATH 18,B06,093474,Rideout; David Porter,4,0,36,32
1656136231482,MATH 20A,A01,083754,Zheng; Zequn,11,0,40,29
1656136237508,MATH 20B,A01,083756,Briones; Jor-el Thomas Caparas,0,0,36,36
1656136237508,MATH 20B,A02,083757,Briones; Jor-el Thomas Caparas,0,0,36,36
1656136237508,MATH 20B,A03,093475,Staff,2,0,36,34
1656136243534,MATH 20C,A01,083760,Briones; Jor-el Thomas Caparas,0,0,35,35
1656136243534,MATH 20C,A02,083761,Briones; Jor-el Thomas Caparas,9,1,35,26
1656136243534,MATH 20C,A03,093476,Staff,0,0,35,35
1656136243534,MATH 20C,B01,083762,Bach; Quang Tran,1,0,30,29
1656136249629,MATH 20D,A01,083765,Tran; Brian Kha,2,0,30,28
1656136249629,MATH 20D,A02,083766,Tran; Brian Kha,0,1,30,30
1656136249629,MATH 20D,A03,083767,Tran; Brian Kha,2,0,30,28
1656136255658,MATH 20E,A01,083771,Ganguly; Soumya,4,0,32,28
1656136255658,MATH 20E,A02,083772,Ganguly; Soumya,1,0,32,31
1656136255658,MATH 20E,B01,083773,Ciotti; Benjamin,14,0,35,21
1656136255658,MATH 20E,B02,083774,Ciotti; Benjamin,14,0,35,21
1656136261687,MATH 103A,A01,083777,Greenfeld; Be'Eri,1,0,36,35
1656136261687,MATH 103A,A02,083778,Greenfeld; Be'Eri,1,0,36,35
1656136261687,MATH 103A,A03,093561,Staff,3,0,36,33
1656136261687,MATH 103A,B01,083779,Greenfeld; Be'Eri,8,1,36,28
1656136261687,MATH 103A,B02,083780,Greenfeld; Be'Eri,0,0,36,36
1656136261687,MATH 103A,B03,093562,Staff,0,0,36,36
1656136267709,MATH 105,A01,085443,Carter; Anne Toulson,4,1,35,31
1656136267709,MATH 105,A02,093477,Staff,9,0,35,26
1656136273737,MATH 109,A01,083213,Ganzberger; Geoffrey Michael,0,0,34,34
1656136273737,MATH 109,A02,083214,Ganzberger; Geoffrey Michael,0,0,34,34
1656136273737,MATH 109,A03,093478,Staff,1,0,34,33
1656136273737,MATH 109,B01,083215,Ganzberger; Geoffrey Michael,3,0,32,29
1656136273737,MATH 109,B02,083216,Ganzberger; Geoffrey Michael,1,0,32,31
1656136273737,MATH 109,B03,093479,Staff,4,0,32,28
1656136279760,MATH 142A,A01,083219,Chow; Bennett,1,0,32,31
1656136279760,MATH 142A,A02,083220,Chow; Bennett,8,0,32,24
1656136279760,MATH 142A,A03,093480,Staff,5,0,32,27
1656136279760,MATH 142A,B03,093481,Staff,4,0,32,28
1656136279760,MATH 142A,B04,093558,Staff,5,0,32,27
1656136279760,MATH 142A,B05,093559,Staff,0,0,32,32
1656136285790,MATH 193A,A01,083224,Rotar; Vladimir,0,1,34,34
1656136285790,MATH 193A,A02,083225,Rotar; Vladimir,0,0,34,34
1656136285790,MATH 193A,A03,083781,Rotar; Vladimir,0,0,34,34
1656136285790,MATH 193A,A04,083782,Rotar; Vladimir,6,0,34,28
1656136285790,MATH 193A,A05,093482,Rotar; Vladimir,1,0,34,33
1656136291814,MATH 197,001,091859,McAuley; Julian John,9999,0,9999,0
1656136291814,MATH 197,002,095566,Kedlaya; Kiran S.,9997,0,9999,2
1656136291814,MATH 197,003,095567,Xiao; Ming,9999,0,9999,0
1656136291814,MATH 197,004,095571,Perols; Johan Lars,9998,0,9999,1
1656136298870,COGS 9,A01,083615,Shannon; Kyle Michael,4,0,75,71
1656136304899,COGS 11,A01,083617,Boyle; Mary E. T.,15,0,48,33
1656136310921,COGS 13,A01,083071,Bastos; Amalia Pinkusfeld,6,0,71,65
1656136316944,COGS 14A,A01,092681,Semenuks; Arturs,4,15,100,96
1656136322965,COGS 14B,A01,083073,Cheng; Tzu-Han,7,0,63,56
1656136328993,COGS 17,A01,092677,Semenuks; Arturs,8,0,81,73
1656136335016,COGS 100,A01,083619,Allen; Michael Gordon,3,0,70,67
1656136341039,COGS 101A,A01,083621,Davis; Joshua Daniel,3,0,68,65
1656136347062,COGS 101B,A01,091572,Allen; Michael Gordon,6,0,65,59
1656136353084,COGS 101C,A01,083625,Delgado; Tania,10,0,35,25
1656136359110,COGS 107A,A01,083627,Boyle; Mary E. T.,1,0,60,59
1656136365133,COGS 118A,A01,083075,Gupta; Anjum,7,0,76,69
1656136371155,CSE 3,A50,083646,Miranda; Gregory Joseph,18,0,50,32
1656136377184,CSE 8A,A50,083650,Miranda; Gregory Joseph,2,2,56,54
1656136383210,CSE 11,A01,083080,Cao; Yingjun,1,54,40,39
1656136389236,CSE 12,A01,083652,Krause-Levy; Sophia Louisa,7,1,120,113
1656136395264,CSE 15L,A01,083654,Morris; Justin Loren,3,0,50,47
1656136395264,CSE 15L,A02,083655,Morris; Justin Loren,4,0,50,46
1656136401288,CSE 20,A01,083657,Tran; Khoa Dang,31,0,80,49
1656136407318,CSE 21,A01,095574,Bach; Quang Tran,25,0,48,23
1656136413345,CSE 30,A01,083084,Eldon; John,2,8,80,78
1656136413345,CSE 30,B01,095061,Bhaskar; Nishant,1,2,50,49
1656136419367,CSE 100,A01,083659,Cao; Yingjun,2,20,70,68
1656136425389,CSE 134B,A01,083661,Powell; Thomas Allan,3,0,100,97
1656136431412,CSE 140,A01,083663,Gungor; Onat,10,0,85,75
1656136437444,CSE 140L,A01,083088,Eldon; John,8,0,100,92
1656136443475,CSE 175,A01,083665,Kumar; Rakesh,0,0,25,25
1656136449514,CSE 190,A00,092507,Dubnov; Shlomo,2,0,20,18
1656136455541,ECE 45,A01,083139,Congero; Spencer William,1,0,75,74
1656136461570,ECE 65,A50,083695,Saad; Andrew S,8,0,30,22
1656136461570,ECE 65,A51,095125,Staff,23,0,26,3
1656136467595,ECE 109,A01,091882,Touri; Behrouz,0,1,70,70
1656136473618,ECE 180,A00,083140,Abi Samra; Nicholas Camill,1,0,30,29
1656136473618,ECE 180,B00,083141,Abi Samra; Nicholas Camill,0,4,30,30
1656136479651,MATH 10A,A01,083735,Patchell; Gregory David,0,0,30,30
1656136479651,MATH 10A,A02,083736,Patchell; Gregory David,22,0,30,8
1656136479651,MATH 10A,A03,083737,Patchell; Gregory David,16,0,30,14
1656136485675,MATH 10B,A01,083207,Lim; Seonhee,0,0,34,34
1656136485675,MATH 10B,A02,083208,Lim; Seonhee,7,0,35,28
1656136485675,MATH 10B,A03,093472,Staff,1,0,34,33
1656136485675,MATH 10B,B01,083739,Sinha; Shubham,11,0,30,19
1656136491706,MATH 18,A01,083743,Cinel; Cameron Alexander,7,0,30,23
1656136491706,MATH 18,A02,083744,Cinel; Cameron Alexander,10,0,30,20
1656136491706,MATH 18,A03,083745,Cinel; Cameron Alexander,4,0,30,26
1656136491706,MATH 18,B01,083748,Rideout; David Porter,0,0,36,36
1656136491706,MATH 18,B02,083749,Rideout; David Porter,0,0,36,36
1656136491706,MATH 18,B03,083750,Rideout; David Porter,0,0,36,36
1656136491706,MATH 18,B04,083751,Rideout; David Porter,0,0,36,36
1656136491706,MATH 18,B05,093473,Rideout; David Porter,2,0,36,34
1656136491706,MATH 18,B06,093474,Rideout; David Porter,4,0,36,32
1656136497733,MATH 20A,A01,083754,Zheng; Zequn,11,0,40,29
1656136503758,MATH 20B,A01,083756,Briones; Jor-el Thomas Caparas,0,0,36,36
1656136503758,MATH 20B,A02,083757,Briones; Jor-el Thomas Caparas,0,0,36,36
1656136503758,MATH 20B,A03,093475,Staff,2,0,36,34
1656136509787,MATH 20C,A01,083760,Briones; Jor-el Thomas Caparas,0,0,35,35
1656136509787,MATH 20C,A02,083761,Briones; Jor-el Thomas Caparas,9,1,35,26
1656136509787,MATH 20C,A03,093476,Staff,0,0,35,35
1656136509787,MATH 20C,B01,083762,Bach; Quang Tran,1,0,30,29
1656136515818,MATH 20D,A01,083765,Tran; Brian Kha,2,0,30,28
1656136515818,MATH 20D,A02,083766,Tran; Brian Kha,0,1,30,30
1656136515818,MATH 20D,A03,083767,Tran; Brian Kha,2,0,30,28
1656136521842,MATH 20E,A01,083771,Ganguly; Soumya,4,0,32,28
1656136521842,MATH 20E,A02,083772,Ganguly; Soumya,1,0,32,31
1656136521842,MATH 20E,B01,083773,Ciotti; Benjamin,14,0,35,21
1656136521842,MATH 20E,B02,083774,Ciotti; Benjamin,14,0,35,21
1656136527866,MATH 103A,A01,083777,Greenfeld; Be'Eri,1,0,36,35
1656136527866,MATH 103A,A02,083778,Greenfeld; Be'Eri,1,0,36,35
1656136527866,MATH 103A,A03,093561,Staff,3,0,36,33
1656136527866,MATH 103A,B01,083779,Greenfeld; Be'Eri,8,1,36,28
1656136527866,MATH 103A,B02,083780,Greenfeld; Be'Eri,0,0,36,36
1656136527866,MATH 103A,B03,093562,Staff,0,0,36,36
1656136533889,MATH 105,A01,085443,Carter; Anne Toulson,4,1,35,31
1656136533889,MATH 105,A02,093477,Staff,9,0,35,26
1656136539930,MATH 109,A01,083213,Ganzberger; Geoffrey Michael,0,0,34,34
1656136539930,MATH 109,A02,083214,Ganzberger; Geoffrey Michael,0,0,34,34
1656136539930,MATH 109,A03,093478,Staff,1,0,34,33
1656136539930,MATH 109,B01,083215,Ganzberger; Geoffrey Michael,3,0,32,29
1656136539930,MATH 109,B02,083216,Ganzberger; Geoffrey Michael,1,0,32,31
1656136539930,MATH 109,B03,093479,Staff,4,0,32,28
1656136545958,MATH 142A,A01,083219,Chow; Bennett,1,0,32,31
1656136545958,MATH 142A,A02,083220,Chow; Bennett,8,0,32,24
1656136545958,MATH 142A,A03,093480,Staff,5,0,32,27
1656136545958,MATH 142A,B03,093481,Staff,4,0,32,28
1656136545958,MATH 142A,B04,093558,Staff,6,0,32,26
1656136545958,MATH 142A,B05,093559,Staff,0,0,32,32
1656136551986,MATH 193A,A01,083224,Rotar; Vladimir,0,1,34,34
1656136551986,MATH 193A,A02,083225,Rotar; Vladimir,0,0,34,34
1656136551986,MATH 193A,A03,083781,Rotar; Vladimir,0,0,34,34
1656136551986,MATH 193A,A04,083782,Rotar; Vladimir,6,0,34,28
1656136551986,MATH 193A,A05,093482,Rotar; Vladimir,1,0,34,33
1656136558008,MATH 197,001,091859,McAuley; Julian John,9999,0,9999,0
1656136558008,MATH 197,002,095566,Kedlaya; Kiran S.,9997,0,9999,2
1656136558008,MATH 197,003,095567,Xiao; Ming,9999,0,9999,0
1656136558008,MATH 197,004,095571,Perols; Johan Lars,9998,0,9999,1
1656136565070,COGS 9,A01,083615,Shannon; Kyle Michael,4,0,75,71
1656136571094,COGS 11,A01,083617,Boyle; Mary E. T.,15,0,48,33
1656136577120,COGS 13,A01,083071,Bastos; Amalia Pinkusfeld,6,0,71,65
1656136583145,COGS 14A,A01,092681,Semenuks; Arturs,4,15,100,96
1656136589173,COGS 14B,A01,083073,Cheng; Tzu-Han,7,0,63,56
1656136595199,COGS 17,A01,092677,Semenuks; Arturs,8,0,81,73
1656136601222,COGS 100,A01,083619,Allen; Michael Gordon,3,0,70,67
1656136607247,COGS 101A,A01,083621,Davis; Joshua Daniel,3,0,68,65
1656136613273,COGS 101B,A01,091572,Allen; Michael Gordon,6,0,65,59
1656136619299,COGS 101C,A01,083625,Delgado; Tania,10,0,35,25
1656136625333,COGS 107A,A01,083627,Boyle; Mary E. T.,1,0,60,59
1656136631355,COGS 118A,A01,083075,Gupta; Anjum,7,0,76,69
1656136637379,CSE 3,A50,083646,Miranda; Gregory Joseph,18,0,50,32
1656136643407,CSE 8A,A50,083650,Miranda; Gregory Joseph,2,2,56,54
1656136649439,CSE 11,A01,083080,Cao; Yingjun,1,54,40,39
1656136655465,CSE 12,A01,083652,Krause-Levy; Sophia Louisa,7,1,120,113
1656136661489,CSE 15L,A01,083654,Morris; Justin Loren,3,0,50,47
1656136661489,CSE 15L,A02,083655,Morris; Justin Loren,4,0,50,46
1656136667514,CSE 20,A01,083657,Tran; Khoa Dang,31,0,80,49
1656136673538,CSE 21,A01,095574,Bach; Quang Tran,25,0,48,23
1656136679578,CSE 30,A01,083084,Eldon; John,2,8,80,78
1656136679578,CSE 30,B01,095061,Bhaskar; Nishant,1,2,50,49
1656136685601,CSE 100,A01,083659,Cao; Yingjun,2,20,70,68
1656136691625,CSE 134B,A01,083661,Powell; Thomas Allan,3,0,100,97
1656136697649,CSE 140,A01,083663,Gungor; Onat,9,0,85,76
1656136703675,CSE 140L,A01,083088,Eldon; John,8,0,100,92
1656136709702,CSE 175,A01,083665,Kumar; Rakesh,0,0,25,25
1656136715728,CSE 190,A00,092507,Dubnov; Shlomo,2,0,20,18
1656136721754,ECE 45,A01,083139,Congero; Spencer William,1,0,75,74
1656136727781,ECE 65,A50,083695,Saad; Andrew S,8,0,30,22
1656136727781,ECE 65,A51,095125,Staff,23,0,26,3
1656136733803,ECE 109,A01,091882,Touri; Behrouz,0,1,70,70
1656136739833,ECE 180,A00,083140,Abi Samra; Nicholas Camill,1,0,30,29
1656136739833,ECE 180,B00,083141,Abi Samra; Nicholas Camill,0,4,30,30
1656136745860,MATH 10A,A01,083735,Patchell; Gregory David,0,0,30,30
1656136745860,MATH 10A,A02,083736,Patchell; Gregory David,22,0,30,8
1656136745860,MATH 10A,A03,083737,Patchell; Gregory David,16,0,30,14
1656136751883,MATH 10B,A01,083207,Lim; Seonhee,0,0,34,34
1656136751883,MATH 10B,A02,083208,Lim; Seonhee,7,0,35,28
1656136751883,MATH 10B,A03,093472,Staff,1,0,34,33
1656136751883,MATH 10B,B01,083739,Sinha; Shubham,11,0,30,19
1656136757908,MATH 18,A01,083743,Cinel; Cameron Alexander,7,0,30,23
1656136757908,MATH 18,A02,083744,Cinel; Cameron Alexander,10,0,30,20
1656136757908,MATH 18,A03,083745,Cinel; Cameron Alexander,4,0,30,26
1656136757908,MATH 18,B01,083748,Rideout; David Porter,0,0,36,36
1656136757908,MATH 18,B02,083749,Rideout; David Porter,0,0,36,36
1656136757908,MATH 18,B03,083750,Rideout; David Porter,0,0,36,36
1656136757908,MATH 18,B04,083751,Rideout; David Porter,0,0,36,36
1656136757908,MATH 18,B05,093473,Rideout; David Porter,2,0,36,34
1656136757908,MATH 18,B06,093474,Rideout; David Porter,4,0,36,32
1656136763934,MATH 20A,A01,083754,Zheng; Zequn,11,0,40,29
1656136769970,MATH 20B,A01,083756,Briones; Jor-el Thomas Caparas,0,0,36,36
1656136769970,MATH 20B,A02,083757,Briones; Jor-el Thomas Caparas,0,0,36,36
1656136769970,MATH 20B,A03,093475,Staff,2,0,36,34
1656136775997,MATH 20C,A01,083760,Briones; Jor-el Thomas Caparas,0,0,35,35
1656136775997,MATH 20C,A02,083761,Briones; Jor-el Thomas Caparas,9,1,35,26
1656136775997,MATH 20C,A03,093476,Staff,0,0,35,35
1656136775997,MATH 20C,B01,083762,Bach; Quang Tran,1,0,30,29
1656136782025,MATH 20D,A01,083765,Tran; Brian Kha,2,0,30,28
1656136782025,MATH 20D,A02,083766,Tran; Brian Kha,0,1,30,30
1656136782025,MATH 20D,A03,083767,Tran; Brian Kha,2,0,30,28
1656136788051,MATH 20E,A01,083771,Ganguly; Soumya,4,0,32,28
1656136788051,MATH 20E,A02,083772,Ganguly; Soumya,1,0,32,31
1656136788051,MATH 20E,B01,083773,Ciotti; Benjamin,14,0,35,21
1656136788051,MATH 20E,B02,083774,Ciotti; Benjamin,14,0,35,21
1656136794080,MATH 103A,A01,083777,Greenfeld; Be'Eri,1,0,36,35
1656136794080,MATH 103A,A02,083778,Greenfeld; Be'Eri,1,0,36,35
1656136794080,MATH 103A,A03,093561,Staff,3,0,36,33
1656136794080,MATH 103A,B01,083779,Greenfeld; Be'Eri,8,1,36,28
1656136794080,MATH 103A,B02,083780,Greenfeld; Be'Eri,0,0,36,36
1656136794080,MATH 103A,B03,093562,Staff,0,0,36,36
1656136800103,MATH 105,A01,085443,Carter; Anne Toulson,4,1,35,31
1656136800103,MATH 105,A02,093477,Staff,9,0,35,26
1656136806126,MATH 109,A01,083213,Ganzberger; Geoffrey Michael,0,0,34,34
1656136806126,MATH 109,A02,083214,Ganzberger; Geoffrey Michael,0,0,34,34
1656136806126,MATH 109,A03,093478,Staff,1,0,34,33
1656136806126,MATH 109,B01,083215,Ganzberger; Geoffrey Michael,3,0,32,29
1656136806126,MATH 109,B02,083216,Ganzberger; Geoffrey Michael,1,0,32,31
1656136806126,MATH 109,B03,093479,Staff,4,0,32,28
1656136812150,MATH 142A,A01,083219,Chow; Bennett,1,0,32,31
1656136812150,MATH 142A,A02,083220,Chow; Bennett,8,0,32,24
1656136812150,MATH 142A,A03,093480,Staff,5,0,32,27
1656136812150,MATH 142A,B03,093481,Staff,4,0,32,28
1656136812150,MATH 142A,B04,093558,Staff,6,0,32,26
1656136812150,MATH 142A,B05,093559,Staff,0,0,32,32
1656136818177,MATH 193A,A01,083224,Rotar; Vladimir,0,1,34,34
1656136818177,MATH 193A,A02,083225,Rotar; Vladimir,0,0,34,34
1656136818177,MATH 193A,A03,083781,Rotar; Vladimir,0,0,34,34
1656136818177,MATH 193A,A04,083782,Rotar; Vladimir,6,0,34,28
1656136818177,MATH 193A,A05,093482,Rotar; Vladimir,1,0,34,33
1656136824208,MATH 197,001,091859,McAuley; Julian John,9999,0,9999,0
1656136824208,MATH 197,002,095566,Kedlaya; Kiran S.,9997,0,9999,2
1656136824208,MATH 197,003,095567,Xiao; Ming,9999,0,9999,0
1656136824208,MATH 197,004,095571,Perols; Johan Lars,9998,0,9999,1
1656136831263,COGS 9,A01,083615,Shannon; Kyle Michael,4,0,75,71
1656136837292,COGS 11,A01,083617,Boyle; Mary E. T.,15,0,48,33
1656136843395,COGS 13,A01,083071,Bastos; Amalia Pinkusfeld,6,0,71,65
1656136849423,COGS 14A,A01,092681,Semenuks; Arturs,4,15,100,96
1656136855451,COGS 14B,A01,083073,Cheng; Tzu-Han,7,0,63,56
1656136861478,COGS 17,A01,092677,Semenuks; Arturs,8,0,81,73
1656136867503,COGS 100,A01,083619,Allen; Michael Gordon,3,0,70,67
1656136873526,COGS 101A,A01,083621,Davis; Joshua Daniel,3,0,68,65
1656136879555,COGS 101B,A01,091572,Allen; Michael Gordon,6,0,65,59
1656136885583,COGS 101C,A01,083625,Delgado; Tania,10,0,35,25
1656136891610,COGS 107A,A01,083627,Boyle; Mary E. T.,1,0,60,59
1656136897634,COGS 118A,A01,083075,Gupta; Anjum,7,0,76,69
1656136903662,CSE 3,A50,083646,Miranda; Gregory Joseph,18,0,50,32
1656136909701,CSE 8A,A50,083650,Miranda; Gregory Joseph,2,2,56,54
1656136915732,CSE 11,A01,083080,Cao; Yingjun,1,54,40,39
1656136921755,CSE 12,A01,083652,Krause-Levy; Sophia Louisa,7,1,120,113
1656136927781,CSE 15L,A01,083654,Morris; Justin Loren,3,0,50,47
1656136927781,CSE 15L,A02,083655,Morris; Justin Loren,4,0,50,46
1656136933809,CSE 20,A01,083657,Tran; Khoa Dang,31,0,80,49
1656136939839,CSE 21,A01,095574,Bach; Quang Tran,25,0,48,23
1656136945864,CSE 30,A01,083084,Eldon; John,2,8,80,78
1656136945864,CSE 30,B01,095061,Bhaskar; Nishant,1,2,50,49
1656136951887,CSE 100,A01,083659,Cao; Yingjun,2,20,70,68
1656136957911,CSE 134B,A01,083661,Powell; Thomas Allan,3,0,100,97
1656136963938,CSE 140,A01,083663,Gungor; Onat,9,0,85,76
1656136969962,CSE 140L,A01,083088,Eldon; John,8,0,100,92
1656136976004,CSE 175,A01,083665,Kumar; Rakesh,0,0,25,25
1656136982032,CSE 190,A00,092507,Dubnov; Shlomo,2,0,20,18
1656136988061,ECE 45,A01,083139,Congero; Spencer William,1,0,75,74
1656136994089,ECE 65,A50,083695,Saad; Andrew S,8,0,30,22
1656136994089,ECE 65,A51,095125,Staff,23,0,26,3
1656137000113,ECE 109,A01,091882,Touri; Behrouz,0,1,70,70
1656137006136,ECE 180,A00,083140,Abi Samra; Nicholas Camill,1,0,30,29
1656137006136,ECE 180,B00,083141,Abi Samra; Nicholas Camill,0,4,30,30
1656137012187,MATH 10A,A01,083735,Patchell; Gregory David,0,0,30,30
1656137012187,MATH 10A,A02,083736,Patchell; Gregory David,22,0,30,8
1656137012187,MATH 10A,A03,083737,Patchell; Gregory David,16,0,30,14
1656137018213,MATH 10B,A01,083207,Lim; Seonhee,0,0,34,34
1656137018213,MATH 10B,A02,083208,Lim; Seonhee,7,0,35,28
1656137018213,MATH 10B,A03,093472,Staff,1,0,34,33
1656137018213,MATH 10B,B01,083739,Sinha; Shubham,11,0,30,19
1656137024240,MATH 18,A01,083743,Cinel; Cameron Alexander,7,0,30,23
1656137024240,MATH 18,A02,083744,Cinel; Cameron Alexander,10,0,30,20
1656137024240,MATH 18,A03,083745,Cinel; Cameron Alexander,4,0,30,26
1656137024240,MATH 18,B01,083748,Rideout; David Porter,0,0,36,36
1656137024240,MATH 18,B02,083749,Rideout; David Porter,0,0,36,36
1656137024240,MATH 18,B03,083750,Rideout; David Porter,0,0,36,36
1656137024240,MATH 18,B04,083751,Rideout; David Porter,0,0,36,36
1656137024240,MATH 18,B05,093473,Rideout; David Porter,2,0,36,34
1656137024240,MATH 18,B06,093474,Rideout; David Porter,4,0,36,32
1656137030268,MATH 20A,A01,083754,Zheng; Zequn,11,0,40,29
1656137036297,MATH 20B,A01,083756,Briones; Jor-el Thomas Caparas,0,0,36,36
1656137036297,MATH 20B,A02,083757,Briones; Jor-el Thomas Caparas,0,0,36,36
1656137036297,MATH 20B,A03,093475,Staff,2,0,36,34
1656137042321,MATH 20C,A01,083760,Briones; Jor-el Thomas Caparas,0,0,35,35
1656137042321,MATH 20C,A02,083761,Briones; Jor-el Thomas Caparas,9,1,35,26
1656137042321,MATH 20C,A03,093476,Staff,0,0,35,35
1656137042321,MATH 20C,B01,083762,Bach; Quang Tran,1,0,30,29
1656137048351,MATH 20D,A01,083765,Tran; Brian Kha,2,0,30,28
1656137048351,MATH 20D,A02,083766,Tran; Brian Kha,0,1,30,30
1656137048351,MATH 20D,A03,083767,Tran; Brian Kha,2,0,30,28
1656137054377,MATH 20E,A01,083771,Ganguly; Soumya,4,0,32,28
1656137054377,MATH 20E,A02,083772,Ganguly; Soumya,1,0,32,31
1656137054377,MATH 20E,B01,083773,Ciotti; Benjamin,14,0,35,21
1656137054377,MATH 20E,B02,083774,Ciotti; Benjamin,14,0,35,21
1656137060411,MATH 103A,A01,083777,Greenfeld; Be'Eri,1,0,36,35
1656137060411,MATH 103A,A02,083778,Greenfeld; Be'Eri,1,0,36,35
1656137060411,MATH 103A,A03,093561,Staff,3,0,36,33
1656137060411,MATH 103A,B01,083779,Greenfeld; Be'Eri,8,1,36,28
1656137060411,MATH 103A,B02,083780,Greenfeld; Be'Eri,0,0,36,36
1656137060411,MATH 103A,B03,093562,Staff,0,0,36,36
1656137066434,MATH 105,A01,085443,Carter; Anne Toulson,4,1,35,31
1656137066434,MATH 105,A02,093477,Staff,9,0,35,26
1656137072468,MATH 109,A01,083213,Ganzberger; Geoffrey Michael,0,0,34,34
1656137072468,MATH 109,A02,083214,Ganzberger; Geoffrey Michael,0,0,34,34
1656137072468,MATH 109,A03,093478,Staff,1,0,34,33
1656137072468,MATH 109,B01,083215,Ganzberger; Geoffrey Michael,3,0,32,29
1656137072468,MATH 109,B02,083216,Ganzberger; Geoffrey Michael,1,0,32,31
1656137072468,MATH 109,B03,093479,Staff,4,0,32,28
1656137078494,MATH 142A,A01,083219,Chow; Bennett,1,0,32,31
1656137078494,MATH 142A,A02,083220,Chow; Bennett,8,0,32,24
1656137078494,MATH 142A,A03,093480,Staff,5,0,32,27
1656137078494,MATH 142A,B03,093481,Staff,4,0,32,28
1656137078494,MATH 142A,B04,093558,Staff,6,0,32,26
1656137078494,MATH 142A,B05,093559,Staff,0,0,32,32
1656137084518,MATH 193A,A01,083224,Rotar; Vladimir,0,1,34,34
1656137084518,MATH 193A,A02,083225,Rotar; Vladimir,0,0,34,34
1656137084518,MATH 193A,A03,083781,Rotar; Vladimir,0,0,34,34
1656137084518,MATH 193A,A04,083782,Rotar; Vladimir,6,0,34,28
1656137084518,MATH 193A,A05,093482,Rotar; Vladimir,1,0,34,33
1656137090541,MATH 197,001,091859,McAuley; Julian John,9999,0,9999,0
1656137090541,MATH 197,002,095566,Kedlaya; Kiran S.,9997,0,9999,2
1656137090541,MATH 197,003,095567,Xiao; Ming,9999,0,9999,0
1656137090541,MATH 197,004,095571,Perols; Johan Lars,9998,0,9999,1
1656137097612,COGS 9,A01,083615,Shannon; Kyle Michael,4,0,75,71
1656137103637,COGS 11,A01,083617,Boyle; Mary E. T.,15,0,48,33
1656137109661,COGS 13,A01,083071,Bastos; Amalia Pinkusfeld,6,0,71,65
1656137115685,COGS 14A,A01,092681,Semenuks; Arturs,4,15,100,96
1656137121709,COGS 14B,A01,083073,Cheng; Tzu-Han,7,0,63,56
1656137127732,COGS 17,A01,092677,Semenuks; Arturs,8,0,81,73
1656137133756,COGS 100,A01,083619,Allen; Michael Gordon,3,0,70,67
1656137139779,COGS 101A,A01,083621,Davis; Joshua Daniel,3,0,68,65
1656137145806,COGS 101B,A01,091572,Allen; Michael Gordon,6,0,65,59
1656137151836,COGS 101C,A01,083625,Delgado; Tania,10,0,35,25
1656137157862,COGS 107A,A01,083627,Boyle; Mary E. T.,1,0,60,59
1656137163884,COGS 118A,A01,083075,Gupta; Anjum,7,0,76,69
1656137169908,CSE 3,A50,083646,Miranda; Gregory Joseph,18,0,50,32
1656137175936,CSE 8A,A50,083650,Miranda; Gregory Joseph,2,2,56,54
1656137181960,CSE 11,A01,083080,Cao; Yingjun,1,54,40,39
1656137187984,CSE 12,A01,083652,Krause-Levy; Sophia Louisa,7,1,120,113
1656137194013,CSE 15L,A01,083654,Morris; Justin Loren,3,0,50,47
1656137194013,CSE 15L,A02,083655,Morris; Justin Loren,4,0,50,46
1656137200037,CSE 20,A01,083657,Tran; Khoa Dang,31,0,80,49
1656137206063,CSE 21,A01,095574,Bach; Quang Tran,25,0,48,23
1656137212090,CSE 30,A01,083084,Eldon; John,2,8,80,78
1656137212090,CSE 30,B01,095061,Bhaskar; Nishant,1,2,50,49
1656137218117,CSE 100,A01,083659,Cao; Yingjun,2,20,70,68
1656137224139,CSE 134B,A01,083661,Powell; Thomas Allan,3,0,100,97
1656137230166,CSE 140,A01,083663,Gungor; Onat,9,0,85,76
1656137236190,CSE 140L,A01,083088,Eldon; John,8,0,100,92
1656137242215,CSE 175,A01,083665,Kumar; Rakesh,0,0,25,25
1656137248239,CSE 190,A00,092507,Dubnov; Shlomo,2,0,20,18
1656137254262,ECE 45,A01,083139,Congero; Spencer William,1,0,75,74
1656137260285,ECE 65,A50,083695,Saad; Andrew S,8,0,30,22
1656137260285,ECE 65,A51,095125,Staff,23,0,26,3
1656137266313,ECE 109,A01,091882,Touri; Behrouz,0,1,70,70
1656137272339,ECE 180,A00,083140,Abi Samra; Nicholas Camill,1,0,30,29
1656137272339,ECE 180,B00,083141,Abi Samra; Nicholas Camill,0,4,30,30
1656137278365,MATH 10A,A01,083735,Patchell; Gregory David,0,0,30,30
1656137278365,MATH 10A,A02,083736,Patchell; Gregory David,22,0,30,8
1656137278365,MATH 10A,A03,083737,Patchell; Gregory David,16,0,30,14
1656137284388,MATH 10B,A01,083207,Lim; Seonhee,0,0,34,34
1656137284388,MATH 10B,A02,083208,Lim; Seonhee,7,0,35,28
1656137284388,MATH 10B,A03,093472,Staff,1,0,34,33
1656137284388,MATH 10B,B01,083739,Sinha; Shubham,11,0,30,19
1656137290428,MATH 18,A01,083743,Cinel; Cameron Alexander,7,0,30,23
1656137290428,MATH 18,A02,083744,Cinel; Cameron Alexander,10,0,30,20
1656137290428,MATH 18,A03,083745,Cinel; Cameron Alexander,4,0,30,26
1656137290428,MATH 18,B01,083748,Rideout; David Porter,0,0,36,36
1656137290428,MATH 18,B02,083749,Rideout; David Porter,0,0,36,36
1656137290428,MATH 18,B03,083750,Rideout; David Porter,0,0,36,36
1656137290428,MATH 18,B04,083751,Rideout; David Porter,0,0,36,36
1656137290428,MATH 18,B05,093473,Rideout; David Porter,2,0,36,34
1656137290428,MATH 18,B06,093474,Rideout; David Porter,4,0,36,32
1656137296454,MATH 20A,A01,083754,Zheng; Zequn,11,0,40,29
1656137302477,MATH 20B,A01,083756,Briones; Jor-el Thomas Caparas,0,0,36,36
1656137302477,MATH 20B,A02,083757,Briones; Jor-el Thomas Caparas,0,0,36,36
1656137302477,MATH 20B,A03,093475,Staff,2,0,36,34
1656137308500,MATH 20C,A01,083760,Briones; Jor-el Thomas Caparas,0,0,35,35
1656137308500,MATH 20C,A02,083761,Briones; Jor-el Thomas Caparas,9,1,35,26
1656137308500,MATH 20C,A03,093476,Staff,0,0,35,35
1656137308500,MATH 20C,B01,083762,Bach; Quang Tran,1,0,30,29
1656137314528,MATH 20D,A01,083765,Tran; Brian Kha,2,0,30,28
1656137314528,MATH 20D,A02,083766,Tran; Brian Kha,0,1,30,30
1656137314528,MATH 20D,A03,083767,Tran; Brian Kha,2,0,30,28
1656137320553,MATH 20E,A01,083771,Ganguly; Soumya,4,0,32,28
1656137320553,MATH 20E,A02,083772,Ganguly; Soumya,1,0,32,31
1656137320553,MATH 20E,B01,083773,Ciotti; Benjamin,14,0,35,21
1656137320553,MATH 20E,B02,083774,Ciotti; Benjamin,14,0,35,21
1656137326614,MATH 103A,A01,083777,Greenfeld; Be'Eri,1,0,36,35
1656137326614,MATH 103A,A02,083778,Greenfeld; Be'Eri,1,0,36,35
1656137326614,MATH 103A,A03,093561,Staff,3,0,36,33
1656137326614,MATH 103A,B01,083779,Greenfeld; Be'Eri,8,1,36,28
1656137326614,MATH 103A,B02,083780,Greenfeld; Be'Eri,0,0,36,36
1656137326614,MATH 103A,B03,093562,Staff,0,0,36,36
1656137332637,MATH 105,A01,085443,Carter; Anne Toulson,4,1,35,31
1656137332637,MATH 105,A02,093477,Staff,9,0,35,26
1656137338664,MATH 109,A01,083213,Ganzberger; Geoffrey Michael,0,0,34,34
1656137338664,MATH 109,A02,083214,Ganzberger; Geoffrey Michael,0,0,34,34
1656137338664,MATH 109,A03,093478,Staff,1,0,34,33
1656137338664,MATH 109,B01,083215,Ganzberger; Geoffrey Michael,3,0,32,29
1656137338664,MATH 109,B02,083216,Ganzberger; Geoffrey Michael,1,0,32,31
1656137338664,MATH 109,B03,093479,Staff,4,0,32,28
1656137344688,MATH 142A,A01,083219,Chow; Bennett,1,0,32,31
1656137344688,MATH 142A,A02,083220,Chow; Bennett,8,0,32,24
1656137344688,MATH 142A,A03,093480,Staff,5,0,32,27
1656137344688,MATH 142A,B03,093481,Staff,4,0,32,28
1656137344688,MATH 142A,B04,093558,Staff,6,0,32,26
1656137344688,MATH 142A,B05,093559,Staff,0,0,32,32
1656137350718,MATH 193A,A01,083224,Rotar; Vladimir,0,1,34,34
1656137350718,MATH 193A,A02,083225,Rotar; Vladimir,0,0,34,34
1656137350718,MATH 193A,A03,083781,Rotar; Vladimir,0,0,34,34
1656137350718,MATH 193A,A04,083782,Rotar; Vladimir,6,0,34,28
1656137350718,MATH 193A,A05,093482,Rotar; Vladimir,1,0,34,33
1656137356745,MATH 197,001,091859,McAuley; Julian John,9999,0,9999,0
1656137356745,MATH 197,002,095566,Kedlaya; Kiran S.,9997,0,9999,2
1656137356745,MATH 197,003,095567,Xiao; Ming,9999,0,9999,0
1656137356745,MATH 197,004,095571,Perols; Johan Lars,9998,0,9999,1
1656137363795,COGS 9,A01,083615,Shannon; Kyle Michael,4,0,75,71
1656137369820,COGS 11,A01,083617,Boyle; Mary E. T.,15,0,48,33
1656137375849,COGS 13,A01,083071,Bastos; Amalia Pinkusfeld,6,0,71,65
1656137381876,COGS 14A,A01,092681,Semenuks; Arturs,4,15,100,96
1656137387903,COGS 14B,A01,083073,Cheng; Tzu-Han,7,0,63,56
1656137393926,COGS 17,A01,092677,Semenuks; Arturs,8,0,81,73
1656137399948,COGS 100,A01,083619,Allen; Michael Gordon,3,0,70,67
1656137405982,COGS 101A,A01,083621,Davis; Joshua Daniel,3,0,68,65
1656137412009,COGS 101B,A01,091572,Allen; Michael Gordon,6,0,65,59
1656137418033,COGS 101C,A01,083625,Delgado; Tania,10,0,35,25
1656137424063,COGS 107A,A01,083627,Boyle; Mary E. T.,1,0,60,59
1656137430090,COGS 118A,A01,083075,Gupta; Anjum,7,0,76,69
1656137436119,CSE 3,A50,083646,Miranda; Gregory Joseph,18,0,50,32
1656137442228,CSE 8A,A50,083650,Miranda; Gregory Joseph,2,2,56,54
1656137448250,CSE 11,A01,083080,Cao; Yingjun,1,54,40,39
1656137454278,CSE 12,A01,083652,Krause-Levy; Sophia Louisa,7,1,120,113
1656137460309,CSE 15L,A01,083654,Morris; Justin Loren,3,0,50,47
1656137460309,CSE 15L,A02,083655,Morris; Justin Loren,4,0,50,46
1656137466333,CSE 20,A01,083657,Tran; Khoa Dang,31,0,80,49
1656137472360,CSE 21,A01,095574,Bach; Quang Tran,25,0,48,23
1656137478385,CSE 30,A01,083084,Eldon; John,2,8,80,78
1656137478385,CSE 30,B01,095061,Bhaskar; Nishant,1,2,50,49
1656137484414,CSE 100,A01,083659,Cao; Yingjun,2,20,70,68
1656137490452,CSE 134B,A01,083661,Powell; Thomas Allan,3,0,100,97
1656137496475,CSE 140,A01,083663,Gungor; Onat,9,0,85,76
1656137502499,CSE 140L,A01,083088,Eldon; John,8,0,100,92
1656137508523,CSE 175,A01,083665,Kumar; Rakesh,0,0,25,25
1656137514553,CSE 190,A00,092507,Dubnov; Shlomo,2,0,20,18
1656137520576,ECE 45,A01,083139,Congero; Spencer William,1,0,75,74
1656137526599,ECE 65,A50,083695,Saad; Andrew S,8,0,30,22
1656137526599,ECE 65,A51,095125,Staff,23,0,26,3
1656137532624,ECE 109,A01,091882,Touri; Behrouz,0,1,70,70
1656137538653,ECE 180,A00,083140,Abi Samra; Nicholas Camill,1,0,30,29
1656137538653,ECE 180,B00,083141,Abi Samra; Nicholas Camill,0,4,30,30
1656137544676,MATH 10A,A01,083735,Patchell; Gregory David,0,0,30,30
1656137544676,MATH 10A,A02,083736,Patchell; Gregory David,22,0,30,8
1656137544676,MATH 10A,A03,083737,Patchell; Gregory David,16,0,30,14
1656137550703,MATH 10B,A01,083207,Lim; Seonhee,0,0,34,34
1656137550703,MATH 10B,A02,083208,Lim; Seonhee,7,0,35,28
1656137550703,MATH 10B,A03,093472,Staff,1,0,34,33
1656137550703,MATH 10B,B01,083739,Sinha; Shubham,11,0,30,19
1656137556734,MATH 18,A01,083743,Cinel; Cameron Alexander,7,0,30,23
1656137556734,MATH 18,A02,083744,Cinel; Cameron Alexander,10,0,30,20
1656137556734,MATH 18,A03,083745,Cinel; Cameron Alexander,4,0,30,26
1656137556734,MATH 18,B01,083748,Rideout; David Porter,0,0,36,36
1656137556734,MATH 18,B02,083749,Rideout; David Porter,0,0,36,36
1656137556734,MATH 18,B03,083750,Rideout; David Porter,0,0,36,36
1656137556734,MATH 18,B04,083751,Rideout; David Porter,0,0,36,36
1656137556734,MATH 18,B05,093473,Rideout; David Porter,2,0,36,34
1656137556734,MATH 18,B06,093474,Rideout; David Porter,4,0,36,32
1656137562758,MATH 20A,A01,083754,Zheng; Zequn,11,0,40,29
1656137568786,MATH 20B,A01,083756,Briones; Jor-el Thomas Caparas,0,0,36,36
1656137568786,MATH 20B,A02,083757,Briones; Jor-el Thomas Caparas,0,0,36,36
1656137568786,MATH 20B,A03,093475,Staff,2,0,36,34
1656137574815,MATH 20C,A01,083760,Briones; Jor-el Thomas Caparas,0,0,35,35
1656137574815,MATH 20C,A02,083761,Briones; Jor-el Thomas Caparas,9,1,35,26
1656137574815,MATH 20C,A03,093476,Staff,0,0,35,35
1656137574815,MATH 20C,B01,083762,Bach; Quang Tran,1,0,30,29
1656137580843,MATH 20D,A01,083765,Tran; Brian Kha,2,0,30,28
1656137580843,MATH 20D,A02,083766,Tran; Brian Kha,0,1,30,30
1656137580843,MATH 20D,A03,083767,Tran; Brian Kha,2,0,30,28
1656137586876,MATH 20E,A01,083771,Ganguly; Soumya,4,0,32,28
1656137586876,MATH 20E,A02,083772,Ganguly; Soumya,1,0,32,31
1656137586876,MATH 20E,B01,083773,Ciotti; Benjamin,14,0,35,21
1656137586876,MATH 20E,B02,083774,Ciotti; Benjamin,14,0,35,21
1656137592909,MATH 103A,A01,083777,Greenfeld; Be'Eri,1,0,36,35
1656137592909,MATH 103A,A02,083778,Greenfeld; Be'Eri,1,0,36,35
1656137592909,MATH 103A,A03,093561,Staff,3,0,36,33
1656137592909,MATH 103A,B01,083779,Greenfeld; Be'Eri,8,1,36,28
1656137592909,MATH 103A,B02,083780,Greenfeld; Be'Eri,0,0,36,36
1656137592909,MATH 103A,B03,093562,Staff,0,0,36,36
1656137598933,MATH 105,A01,085443,Carter; Anne Toulson,4,1,35,31
1656137598933,MATH 105,A02,093477,Staff,10,0,35,25
1656137604964,MATH 109,A01,083213,Ganzberger; Geoffrey Michael,0,0,34,34
1656137604964,MATH 109,A02,083214,Ganzberger; Geoffrey Michael,0,0,34,34
1656137604964,MATH 109,A03,093478,Staff,1,0,34,33
1656137604964,MATH 109,B01,083215,Ganzberger; Geoffrey Michael,4,0,32,28
1656137604964,MATH 109,B02,083216,Ganzberger; Geoffrey Michael,1,0,32,31
1656137604964,MATH 109,B03,093479,Staff,4,0,32,28
1656137610991,MATH 142A,A01,083219,Chow; Bennett,1,0,32,31
1656137610991,MATH 142A,A02,083220,Chow; Bennett,8,0,32,24
1656137610991,MATH 142A,A03,093480,Staff,5,0,32,27
1656137610991,MATH 142A,B03,093481,Staff,4,0,32,28
1656137610991,MATH 142A,B04,093558,Staff,6,0,32,26
1656137610991,MATH 142A,B05,093559,Staff,0,0,32,32
1656137617015,MATH 193A,A01,083224,Rotar; Vladimir,0,1,34,34
1656137617015,MATH 193A,A02,083225,Rotar; Vladimir,0,0,34,34
1656137617015,MATH 193A,A03,083781,Rotar; Vladimir,0,0,34,34
1656137617015,MATH 193A,A04,083782,Rotar; Vladimir,6,0,34,28
1656137617015,MATH 193A,A05,093482,Rotar; Vladimir,1,0,34,33
1656137623044,MATH 197,001,091859,McAuley; Julian John,9999,0,9999,0
1656137623044,MATH 197,002,095566,Kedlaya; Kiran S.,9997,0,9999,2
1656137623044,MATH 197,003,095567,Xiao; Ming,9999,0,9999,0
1656137623044,MATH 197,004,095571,Perols; Johan Lars,9998,0,9999,1
1656137630109,COGS 9,A01,083615,Shannon; Kyle Michael,4,0,75,71
1656137636135,COGS 11,A01,083617,Boyle; Mary E. T.,15,0,48,33
1656137642160,COGS 13,A01,083071,Bastos; Amalia Pinkusfeld,6,0,71,65
1656137648183,COGS 14A,A01,092681,Semenuks; Arturs,4,15,100,96
1656137654206,COGS 14B,A01,083073,Cheng; Tzu-Han,7,0,63,56
1656137660230,COGS 17,A01,092677,Semenuks; Arturs,8,0,81,73
1656137666259,COGS 100,A01,083619,Allen; Michael Gordon,3,0,70,67
1656137672283,COGS 101A,A01,083621,Davis; Joshua Daniel,3,0,68,65
1656137678311,COGS 101B,A01,091572,Allen; Michael Gordon,6,0,65,59
1656137684339,COGS 101C,A01,083625,Delgado; Tania,10,0,35,25
1656137690366,COGS 107A,A01,083627,Boyle; Mary E. T.,1,0,60,59
1656137696392,COGS 118A,A01,083075,Gupta; Anjum,7,0,76,69
1656137702418,CSE 3,A50,083646,Miranda; Gregory Joseph,18,0,50,32
1656137708440,CSE 8A,A50,083650,Miranda; Gregory Joseph,2,2,56,54
1656137714463,CSE 11,A01,083080,Cao; Yingjun,1,54,40,39
1656137720488,CSE 12,A01,083652,Krause-Levy; Sophia Louisa,7,1,120,113
1656137726521,CSE 15L,A01,083654,Morris; Justin Loren,3,0,50,47
1656137726521,CSE 15L,A02,083655,Morris; Justin Loren,4,0,50,46
1656137732548,CSE 20,A01,083657,Tran; Khoa Dang,31,0,80,49
1656137738572,CSE 21,A01,095574,Bach; Quang Tran,25,0,48,23
1656137744599,CSE 30,A01,083084,Eldon; John,2,8,80,78
1656137744599,CSE 30,B01,095061,Bhaskar; Nishant,1,2,50,49
1656137750626,CSE 100,A01,083659,Cao; Yingjun,2,20,70,68
1656137756651,CSE 134B,A01,083661,Powell; Thomas Allan,3,0,100,97
1656137762675,CSE 140,A01,083663,Gungor; Onat,9,0,85,76
1656137768701,CSE 140L,A01,083088,Eldon; John,8,0,100,92
1656137774724,CSE 175,A01,083665,Kumar; Rakesh,0,0,25,25
1656137780747,CSE 190,A00,092507,Dubnov; Shlomo,2,0,20,18
1656137786775,ECE 45,A01,083139,Congero; Spencer William,1,0,75,74
1656137792799,ECE 65,A50,083695,Saad; Andrew S,8,0,30,22
1656137792799,ECE 65,A51,095125,Staff,23,0,26,3
1656137798826,ECE 109,A01,091882,Touri; Behrouz,0,1,70,70
1656137804849,ECE 180,A00,083140,Abi Samra; Nicholas Camill,1,0,30,29
1656137804849,ECE 180,B00,083141,Abi Samra; Nicholas Camill,0,4,30,30
1656137810873,MATH 10A,A01,083735,Patchell; Gregory David,0,0,30,30
1656137810873,MATH 10A,A02,083736,Patchell; Gregory David,22,0,30,8
1656137810873,MATH 10A,A03,083737,Patchell; Gregory David,16,0,30,14
1656137816897,MATH 10B,A01,083207,Lim; Seonhee,0,0,34,34
1656137816897,MATH 10B,A02,083208,Lim; Seonhee,7,0,35,28
1656137816897,MATH 10B,A03,093472,Staff,1,0,34,33
1656137816897,MATH 10B,B01,083739,Sinha; Shubham,11,0,30,19
1656137822929,MATH 18,A01,083743,Cinel; Cameron Alexander,7,0,30,23
1656137822929,MATH 18,A02,083744,Cinel; Cameron Alexander,10,0,30,20
1656137822929,MATH 18,A03,083745,Cinel; Cameron Alexander,4,0,30,26
1656137822929,MATH 18,B01,083748,Rideout; David Porter,0,0,36,36
1656137822929,MATH 18,B02,083749,Rideout; David Porter,0,0,36,36
1656137822929,MATH 18,B03,083750,Rideout; David Porter,0,0,36,36
1656137822929,MATH 18,B04,083751,Rideout; David Porter,0,0,36,36
1656137822929,MATH 18,B05,093473,Rideout; David Porter,2,0,36,34
1656137822929,MATH 18,B06,093474,Rideout; David Porter,4,0,36,32
1656137828955,MATH 20A,A01,083754,Zheng; Zequn,11,0,40,29
1656137834977,MATH 20B,A01,083756,Briones; Jor-el Thomas Caparas,0,0,36,36
1656137834977,MATH 20B,A02,083757,Briones; Jor-el Thomas Caparas,0,0,36,36
1656137834977,MATH 20B,A03,093475,Staff,2,0,36,34
1656137841002,MATH 20C,A01,083760,Briones; Jor-el Thomas Caparas,0,0,35,35
1656137841002,MATH 20C,A02,083761,Briones; Jor-el Thomas Caparas,9,1,35,26
1656137841002,MATH 20C,A03,093476,Staff,0,0,35,35
1656137841002,MATH 20C,B01,083762,Bach; Quang Tran,1,0,30,29
1656137847027,MATH 20D,A01,083765,Tran; Brian Kha,2,0,30,28
1656137847027,MATH 20D,A02,083766,Tran; Brian Kha,0,1,30,30
1656137847027,MATH 20D,A03,083767,Tran; Brian Kha,2,0,30,28
1656137853051,MATH 20E,A01,083771,Ganguly; Soumya,4,0,32,28
1656137853051,MATH 20E,A02,083772,Ganguly; Soumya,0,0,32,32
1656137853051,MATH 20E,B01,083773,Ciotti; Benjamin,15,0,35,20
1656137853051,MATH 20E,B02,083774,Ciotti; Benjamin,14,0,35,21
1656137859089,MATH 103A,A01,083777,Greenfeld; Be'Eri,1,0,36,35
1656137859089,MATH 103A,A02,083778,Greenfeld; Be'Eri,1,0,36,35
1656137859089,MATH 103A,A03,093561,Staff,3,0,36,33
1656137859089,MATH 103A,B01,083779,Greenfeld; Be'Eri,8,1,36,28
1656137859089,MATH 103A,B02,083780,Greenfeld; Be'Eri,0,0,36,36
1656137859089,MATH 103A,B03,093562,Staff,0,0,36,36
1656137865116,MATH 105,A01,085443,Carter; Anne Toulson,4,1,35,31
1656137865116,MATH 105,A02,093477,Staff,10,0,35,25
1656137871140,MATH 109,A01,083213,Ganzberger; Geoffrey Michael,0,0,34,34
1656137871140,MATH 109,A02,083214,Ganzberger; Geoffrey Michael,0,0,34,34
1656137871140,MATH 109,A03,093478,Staff,1,0,34,33
1656137871140,MATH 109,B01,083215,Ganzberger; Geoffrey Michael,4,0,32,28
1656137871140,MATH 109,B02,083216,Ganzberger; Geoffrey Michael,1,0,32,31
1656137871140,MATH 109,B03,093479,Staff,4,0,32,28
1656137877165,MATH 142A,A01,083219,Chow; Bennett,1,0,32,31
1656137877165,MATH 142A,A02,083220,Chow; Bennett,8,0,32,24
1656137877165,MATH 142A,A03,093480,Staff,5,0,32,27
1656137877165,MATH 142A,B03,093481,Staff,4,0,32,28
1656137877165,MATH 142A,B04,093558,Staff,6,0,32,26
1656137877165,MATH 142A,B05,093559,Staff,0,0,32,32
1656137883190,MATH 193A,A01,083224,Rotar; Vladimir,0,1,34,34
1656137883190,MATH 193A,A02,083225,Rotar; Vladimir,0,0,34,34
1656137883190,MATH 193A,A03,083781,Rotar; Vladimir,0,0,34,34
1656137883190,MATH 193A,A04,083782,Rotar; Vladimir,6,0,34,28
1656137883190,MATH 193A,A05,093482,Rotar; Vladimir,1,0,34,33
1656137889216,MATH 197,001,091859,McAuley; Julian John,9999,0,9999,0
1656137889216,MATH 197,002,095566,Kedlaya; Kiran S.,9997,0,9999,2
1656137889216,MATH 197,003,095567,Xiao; Ming,9999,0,9999,0
1656137889216,MATH 197,004,095571,Perols; Johan Lars,9998,0,9999,1
1656137896267,COGS 9,A01,083615,Shannon; Kyle Michael,4,0,75,71
1656137902288,COGS 11,A01,083617,Boyle; Mary E. T.,15,0,48,33
1656137908326,COGS 13,A01,083071,Bastos; Amalia Pinkusfeld,6,0,71,65
1656137914353,COGS 14A,A01,092681,Semenuks; Arturs,4,15,100,96
1656137920383,COGS 14B,A01,083073,Cheng; Tzu-Han,7,0,63,56
1656137926411,COGS 17,A01,092677,Semenuks; Arturs,8,0,81,73
1656137932436,COGS 100,A01,083619,Allen; Michael Gordon,3,0,70,67
1656137938458,COGS 101A,A01,083621,Davis; Joshua Daniel,3,0,68,65
1656137944480,COGS 101B,A01,091572,Allen; Michael Gordon,6,0,65,59
1656137950504,COGS 101C,A01,083625,Delgado; Tania,10,0,35,25
1656137956524,COGS 107A,A01,083627,Boyle; Mary E. T.,1,0,60,59
1656137962547,COGS 118A,A01,083075,Gupta; Anjum,7,0,76,69
1656137968575,CSE 3,A50,083646,Miranda; Gregory Joseph,18,0,50,32
1656137974603,CSE 8A,A50,083650,Miranda; Gregory Joseph,2,2,56,54
1656137980632,CSE 11,A01,083080,Cao; Yingjun,1,54,40,39
1656137986655,CSE 12,A01,083652,Krause-Levy; Sophia Louisa,7,1,120,113
1656137992679,CSE 15L,A01,083654,Morris; Justin Loren,3,0,50,47
1656137992679,CSE 15L,A02,083655,Morris; Justin Loren,4,0,50,46
1656137998705,CSE 20,A01,083657,Tran; Khoa Dang,31,0,80,49
1656138004733,CSE 21,A01,095574,Bach; Quang Tran,25,0,48,23
1656138010755,CSE 30,A01,083084,Eldon; John,2,8,80,78
1656138010755,CSE 30,B01,095061,Bhaskar; Nishant,1,2,50,49
1656138016790,CSE 100,A01,083659,Cao; Yingjun,2,20,70,68
1656138022817,CSE 134B,A01,083661,Powell; Thomas Allan,3,0,100,97
1656138028842,CSE 140,A01,083663,Gungor; Onat,9,0,85,76
1656138034867,CSE 140L,A01,083088,Eldon; John,8,0,100,92
1656138041021,CSE 175,A01,083665,Kumar; Rakesh,0,0,25,25
1656138047044,CSE 190,A00,092507,Dubnov; Shlomo,2,0,20,18
1656138053071,ECE 45,A01,083139,Congero; Spencer William,1,0,75,74
1656138059095,ECE 65,A50,083695,Saad; Andrew S,8,0,30,22
1656138059095,ECE 65,A51,095125,Staff,23,0,26,3
1656138065125,ECE 109,A01,091882,Touri; Behrouz,0,1,70,70
1656138071159,ECE 180,A00,083140,Abi Samra; Nicholas Camill,1,0,30,29
1656138071159,ECE 180,B00,083141,Abi Samra; Nicholas Camill,0,4,30,30
1656138077184,MATH 10A,A01,083735,Patchell; Gregory David,0,0,30,30
1656138077184,MATH 10A,A02,083736,Patchell; Gregory David,22,0,30,8
1656138077184,MATH 10A,A03,083737,Patchell; Gregory David,16,0,30,14
1656138083208,MATH 10B,A01,083207,Lim; Seonhee,0,0,34,34
1656138083208,MATH 10B,A02,083208,Lim; Seonhee,7,0,35,28
1656138083208,MATH 10B,A03,093472,Staff,1,0,34,33
1656138083208,MATH 10B,B01,083739,Sinha; Shubham,11,0,30,19
1656138089235,MATH 18,A01,083743,Cinel; Cameron Alexander,7,0,30,23
1656138089235,MATH 18,A02,083744,Cinel; Cameron Alexander,10,0,30,20
1656138089235,MATH 18,A03,083745,Cinel; Cameron Alexander,4,0,30,26
1656138089235,MATH 18,B01,083748,Rideout; David Porter,0,0,36,36
1656138089235,MATH 18,B02,083749,Rideout; David Porter,0,0,36,36
1656138089235,MATH 18,B03,083750,Rideout; David Porter,0,0,36,36
1656138089235,MATH 18,B04,083751,Rideout; David Porter,0,0,36,36
1656138089235,MATH 18,B05,093473,Rideout; David Porter,2,0,36,34
1656138089235,MATH 18,B06,093474,Rideout; David Porter,4,0,36,32
1656138095258,MATH 20A,A01,083754,Zheng; Zequn,11,0,40,29
1656138101286,MATH 20B,A01,083756,Briones; Jor-el Thomas Caparas,0,0,36,36
1656138101286,MATH 20B,A02,083757,Briones; Jor-el Thomas Caparas,0,0,36,36
1656138101286,MATH 20B,A03,093475,Staff,2,0,36,34
1656138107314,MATH 20C,A01,083760,Briones; Jor-el Thomas Caparas,0,0,35,35
1656138107314,MATH 20C,A02,083761,Briones; Jor-el Thomas Caparas,9,1,35,26
1656138107314,MATH 20C,A03,093476,Staff,0,0,35,35
1656138107314,MATH 20C,B01,083762,Bach; Quang Tran,1,0,30,29
1656138113340,MATH 20D,A01,083765,Tran; Brian Kha,2,0,30,28
1656138113340,MATH 20D,A02,083766,Tran; Brian Kha,0,1,30,30
1656138113340,MATH 20D,A03,083767,Tran; Brian Kha,2,0,30,28
1656138119364,MATH 20E,A01,083771,Ganguly; Soumya,4,0,32,28
1656138119364,MATH 20E,A02,083772,Ganguly; Soumya,0,0,32,32
1656138119364,MATH 20E,B01,083773,Ciotti; Benjamin,15,0,35,20
1656138119364,MATH 20E,B02,083774,Ciotti; Benjamin,14,0,35,21
1656138125392,MATH 103A,A01,083777,Greenfeld; Be'Eri,1,0,36,35
1656138125392,MATH 103A,A02,083778,Greenfeld; Be'Eri,1,0,36,35
1656138125392,MATH 103A,A03,093561,Staff,3,0,36,33
1656138125392,MATH 103A,B01,083779,Greenfeld; Be'Eri,8,1,36,28
1656138125392,MATH 103A,B02,083780,Greenfeld; Be'Eri,0,0,36,36
1656138125392,MATH 103A,B03,093562,Staff,0,0,36,36
1656138131416,MATH 105,A01,085443,Carter; Anne Toulson,4,1,35,31
1656138131416,MATH 105,A02,093477,Staff,10,0,35,25
1656138137441,MATH 109,A01,083213,Ganzberger; Geoffrey Michael,0,0,34,34
1656138137441,MATH 109,A02,083214,Ganzberger; Geoffrey Michael,0,0,34,34
1656138137441,MATH 109,A03,093478,Staff,1,0,34,33
1656138137441,MATH 109,B01,083215,Ganzberger; Geoffrey Michael,4,0,32,28
1656138137441,MATH 109,B02,083216,Ganzberger; Geoffrey Michael,1,0,32,31
1656138137441,MATH 109,B03,093479,Staff,4,0,32,28
1656138143469,MATH 142A,A01,083219,Chow; Bennett,1,0,32,31
1656138143469,MATH 142A,A02,083220,Chow; Bennett,8,0,32,24
1656138143469,MATH 142A,A03,093480,Staff,5,0,32,27
1656138143469,MATH 142A,B03,093481,Staff,4,0,32,28
1656138143469,MATH 142A,B04,093558,Staff,6,0,32,26
1656138143469,MATH 142A,B05,093559,Staff,0,0,32,32
1656138149503,MATH 193A,A01,083224,Rotar; Vladimir,0,1,34,34
1656138149503,MATH 193A,A02,083225,Rotar; Vladimir,0,0,34,34
1656138149503,MATH 193A,A03,083781,Rotar; Vladimir,0,0,34,34
1656138149503,MATH 193A,A04,083782,Rotar; Vladimir,6,0,34,28
1656138149503,MATH 193A,A05,093482,Rotar; Vladimir,1,0,34,33
1656138155526,MATH 197,001,091859,McAuley; Julian John,9999,0,9999,0
1656138155526,MATH 197,002,095566,Kedlaya; Kiran S.,9997,0,9999,2
1656138155526,MATH 197,003,095567,Xiao; Ming,9999,0,9999,0
1656138155526,MATH 197,004,095571,Perols; Johan Lars,9998,0,9999,1
1656138162593,COGS 9,A01,083615,Shannon; Kyle Michael,4,0,75,71
1656138168627,COGS 11,A01,083617,Boyle; Mary E. T.,15,0,48,33
1656138174663,COGS 13,A01,083071,Bastos; Amalia Pinkusfeld,6,0,71,65
1656138180686,COGS 14A,A01,092681,Semenuks; Arturs,4,15,100,96
1656138186711,COGS 14B,A01,083073,Cheng; Tzu-Han,7,0,63,56
1656138192735,COGS 17,A01,092677,Semenuks; Arturs,8,0,81,73
1656138198761,COGS 100,A01,083619,Allen; Michael Gordon,3,0,70,67
1656138204788,COGS 101A,A01,083621,Davis; Joshua Daniel,3,0,68,65
1656138210812,COGS 101B,A01,091572,Allen; Michael Gordon,6,0,65,59
1656138216840,COGS 101C,A01,083625,Delgado; Tania,10,0,35,25
1656138222879,COGS 107A,A01,083627,Boyle; Mary E. T.,1,0,60,59
1656138228903,COGS 118A,A01,083075,Gupta; Anjum,7,0,76,69
1656138234932,CSE 3,A50,083646,Miranda; Gregory Joseph,18,0,50,32
1656138240961,CSE 8A,A50,083650,Miranda; Gregory Joseph,2,2,56,54
1656138246989,CSE 11,A01,083080,Cao; Yingjun,1,54,40,39
1656138253012,CSE 12,A01,083652,Krause-Levy; Sophia Louisa,7,1,120,113
1656138259036,CSE 15L,A01,083654,Morris; Justin Loren,3,0,50,47
1656138259036,CSE 15L,A02,083655,Morris; Justin Loren,4,0,50,46
1656138265063,CSE 20,A01,083657,Tran; Khoa Dang,31,0,80,49
1656138271091,CSE 21,A01,095574,Bach; Quang Tran,25,0,48,23
1656138277118,CSE 30,A01,083084,Eldon; John,2,8,80,78
1656138277118,CSE 30,B01,095061,Bhaskar; Nishant,1,2,50,49
1656138283143,CSE 100,A01,083659,Cao; Yingjun,2,20,70,68
1656138289171,CSE 134B,A01,083661,Powell; Thomas Allan,3,0,100,97
1656138295194,CSE 140,A01,083663,Gungor; Onat,9,0,85,76
1656138301219,CSE 140L,A01,083088,Eldon; John,8,0,100,92
1656138307253,CSE 175,A01,083665,Kumar; Rakesh,0,0,25,25
1656138313280,CSE 190,A00,092507,Dubnov; Shlomo,2,0,20,18
1656138319304,ECE 45,A01,083139,Congero; Spencer William,1,0,75,74
1656138325328,ECE 65,A50,083695,Saad; Andrew S,8,0,30,22
1656138325328,ECE 65,A51,095125,Staff,23,0,26,3
1656138331359,ECE 109,A01,091882,Touri; Behrouz,0,1,70,70
1656138337390,ECE 180,A00,083140,Abi Samra; Nicholas Camill,1,0,30,29
1656138337390,ECE 180,B00,083141,Abi Samra; Nicholas Camill,0,4,30,30
1656138343413,MATH 10A,A01,083735,Patchell; Gregory David,0,0,30,30
1656138343413,MATH 10A,A02,083736,Patchell; Gregory David,22,0,30,8
1656138343413,MATH 10A,A03,083737,Patchell; Gregory David,16,0,30,14
1656138349436,MATH 10B,A01,083207,Lim; Seonhee,0,0,34,34
1656138349436,MATH 10B,A02,083208,Lim; Seonhee,7,0,35,28
1656138349436,MATH 10B,A03,093472,Staff,1,0,34,33
1656138349436,MATH 10B,B01,083739,Sinha; Shubham,11,0,30,19
1656138355460,MATH 18,A01,083743,Cinel; Cameron Alexander,7,0,30,23
1656138355460,MATH 18,A02,083744,Cinel; Cameron Alexander,10,0,30,20
1656138355460,MATH 18,A03,083745,Cinel; Cameron Alexander,4,0,30,26
1656138355460,MATH 18,B01,083748,Rideout; David Porter,0,0,36,36
1656138355460,MATH 18,B02,083749,Rideout; David Porter,0,0,36,36
1656138355460,MATH 18,B03,083750,Rideout; David Porter,0,0,36,36
1656138355460,MATH 18,B04,083751,Rideout; David Porter,0,0,36,36
1656138355460,MATH 18,B05,093473,Rideout; David Porter,2,0,36,34
1656138355460,MATH 18,B06,093474,Rideout; David Porter,4,0,36,32
1656138361484,MATH 20A,A01,083754,Zheng; Zequn,11,0,40,29
1656138367513,MATH 20B,A01,083756,Briones; Jor-el Thomas Caparas,0,0,36,36
1656138367513,MATH 20B,A02,083757,Briones; Jor-el Thomas Caparas,0,0,36,36
1656138367513,MATH 20B,A03,093475,Staff,2,0,36,34
1656138373544,MATH 20C,A01,083760,Briones; Jor-el Thomas Caparas,0,0,35,35
1656138373544,MATH 20C,A02,083761,Briones; Jor-el Thomas Caparas,9,1,35,26
1656138373544,MATH 20C,A03,093476,Staff,0,0,35,35
1656138373544,MATH 20C,B01,083762,Bach; Quang Tran,1,0,30,29
1656138379570,MATH 20D,A01,083765,Tran; Brian Kha,2,0,30,28
1656138379570,MATH 20D,A02,083766,Tran; Brian Kha,0,1,30,30
1656138379570,MATH 20D,A03,083767,Tran; Brian Kha,2,0,30,28
1656138385599,MATH 20E,A01,083771,Ganguly; Soumya,4,0,32,28
1656138385599,MATH 20E,A02,083772,Ganguly; Soumya,0,0,32,32
1656138385599,MATH 20E,B01,083773,Ciotti; Benjamin,15,0,35,20
1656138385599,MATH 20E,B02,083774,Ciotti; Benjamin,14,0,35,21
1656138391631,MATH 103A,A01,083777,Greenfeld; Be'Eri,1,0,36,35
1656138391631,MATH 103A,A02,083778,Greenfeld; Be'Eri,1,0,36,35
1656138391631,MATH 103A,A03,093561,Staff,4,0,36,32
1656138391631,MATH 103A,B01,083779,Greenfeld; Be'Eri,8,1,36,28
1656138391631,MATH 103A,B02,083780,Greenfeld; Be'Eri,0,0,36,36
1656138391631,MATH 103A,B03,093562,Staff,0,0,36,36
1656138397654,MATH 105,A01,085443,Carter; Anne Toulson,4,1,35,31
1656138397654,MATH 105,A02,093477,Staff,10,0,35,25
1656138403682,MATH 109,A01,083213,Ganzberger; Geoffrey Michael,0,0,34,34
1656138403682,MATH 109,A02,083214,Ganzberger; Geoffrey Michael,0,0,34,34
1656138403682,MATH 109,A03,093478,Staff,1,0,34,33
1656138403682,MATH 109,B01,083215,Ganzberger; Geoffrey Michael,4,0,32,28
1656138403682,MATH 109,B02,083216,Ganzberger; Geoffrey Michael,1,0,32,31
1656138403682,MATH 109,B03,093479,Staff,4,0,32,28
1656138409704,MATH 142A,A01,083219,Chow; Bennett,1,0,32,31
1656138409704,MATH 142A,A02,083220,Chow; Bennett,8,0,32,24
1656138409704,MATH 142A,A03,093480,Staff,5,0,32,27
1656138409704,MATH 142A,B03,093481,Staff,4,0,32,28
1656138409704,MATH 142A,B04,093558,Staff,6,0,32,26
1656138409704,MATH 142A,B05,093559,Staff,0,0,32,32
1656138415734,MATH 193A,A01,083224,Rotar; Vladimir,0,1,34,34
1656138415734,MATH 193A,A02,083225,Rotar; Vladimir,0,0,34,34
1656138415734,MATH 193A,A03,083781,Rotar; Vladimir,0,0,34,34
1656138415734,MATH 193A,A04,083782,Rotar; Vladimir,6,0,34,28
1656138415734,MATH 193A,A05,093482,Rotar; Vladimir,1,0,34,33
1656138421761,MATH 197,001,091859,McAuley; Julian John,9999,0,9999,0
1656138421761,MATH 197,002,095566,Kedlaya; Kiran S.,9997,0,9999,2
1656138421761,MATH 197,003,095567,Xiao; Ming,9999,0,9999,0
1656138421761,MATH 197,004,095571,Perols; Johan Lars,9998,0,9999,1
1656138428823,COGS 9,A01,083615,Shannon; Kyle Michael,4,0,75,71
1656138434851,COGS 11,A01,083617,Boyle; Mary E. T.,15,0,48,33
1656138440880,COGS 13,A01,083071,Bastos; Amalia Pinkusfeld,6,0,71,65
1656138446909,COGS 14A,A01,092681,Semenuks; Arturs,4,15,100,96
1656138452937,COGS 14B,A01,083073,Cheng; Tzu-Han,7,0,63,56
1656138458960,COGS 17,A01,092677,Semenuks; Arturs,8,0,81,73
1656138464984,COGS 100,A01,083619,Allen; Michael Gordon,3,0,70,67
1656138471010,COGS 101A,A01,083621,Davis; Joshua Daniel,3,0,68,65
1656138477033,COGS 101B,A01,091572,Allen; Michael Gordon,6,0,65,59
1656138483062,COGS 101C,A01,083625,Delgado; Tania,10,0,35,25
1656138489089,COGS 107A,A01,083627,Boyle; Mary E. T.,1,0,60,59
1656138495111,COGS 118A,A01,083075,Gupta; Anjum,7,0,76,69
1656138501139,CSE 3,A50,083646,Miranda; Gregory Joseph,17,0,50,33
1656138507172,CSE 8A,A50,083650,Miranda; Gregory Joseph,2,2,56,54
1656138513198,CSE 11,A01,083080,Cao; Yingjun,1,54,40,39
1656138519222,CSE 12,A01,083652,Krause-Levy; Sophia Louisa,7,1,120,113
1656138525258,CSE 15L,A01,083654,Morris; Justin Loren,3,0,50,47
1656138525258,CSE 15L,A02,083655,Morris; Justin Loren,4,0,50,46
1656138531287,CSE 20,A01,083657,Tran; Khoa Dang,31,0,80,49
1656138537322,CSE 21,A01,095574,Bach; Quang Tran,25,0,48,23
1656138543350,CSE 30,A01,083084,Eldon; John,2,8,80,78
1656138543350,CSE 30,B01,095061,Bhaskar; Nishant,1,2,50,49
1656138549376,CSE 100,A01,083659,Cao; Yingjun,2,20,70,68
1656138555399,CSE 134B,A01,083661,Powell; Thomas Allan,3,0,100,97
1656138561422,CSE 140,A01,083663,Gungor; Onat,9,0,85,76
1656138567448,CSE 140L,A01,083088,Eldon; John,8,0,100,92
1656138573479,CSE 175,A01,083665,Kumar; Rakesh,0,0,25,25
1656138579514,CSE 190,A00,092507,Dubnov; Shlomo,2,0,20,18
1656138585543,ECE 45,A01,083139,Congero; Spencer William,1,0,75,74
1656138591571,ECE 65,A50,083695,Saad; Andrew S,8,0,30,22
1656138591571,ECE 65,A51,095125,Staff,23,0,26,3
1656138597595,ECE 109,A01,091882,Touri; Behrouz,0,1,70,70
1656138603623,ECE 180,A00,083140,Abi Samra; Nicholas Camill,1,0,30,29
1656138603623,ECE 180,B00,083141,Abi Samra; Nicholas Camill,0,4,30,30
1656138609653,MATH 10A,A01,083735,Patchell; Gregory David,0,0,30,30
1656138609653,MATH 10A,A02,083736,Patchell; Gregory David,22,0,30,8
1656138609653,MATH 10A,A03,083737,Patchell; Gregory David,16,0,30,14
1656138615677,MATH 10B,A01,083207,Lim; Seonhee,0,0,34,34
1656138615677,MATH 10B,A02,083208,Lim; Seonhee,7,0,35,28
1656138615677,MATH 10B,A03,093472,Staff,1,0,34,33
1656138615677,MATH 10B,B01,083739,Sinha; Shubham,11,0,30,19
1656138621709,MATH 18,A01,083743,Cinel; Cameron Alexander,7,0,30,23
1656138621709,MATH 18,A02,083744,Cinel; Cameron Alexander,10,0,30,20
1656138621709,MATH 18,A03,083745,Cinel; Cameron Alexander,4,0,30,26
1656138621709,MATH 18,B01,083748,Rideout; David Porter,0,0,36,36
1656138621709,MATH 18,B02,083749,Rideout; David Porter,0,0,36,36
1656138621709,MATH 18,B03,083750,Rideout; David Porter,0,0,36,36
1656138621709,MATH 18,B04,083751,Rideout; David Porter,0,0,36,36
1656138621709,MATH 18,B05,093473,Rideout; David Porter,1,0,36,35
1656138621709,MATH 18,B06,093474,Rideout; David Porter,4,0,36,32
1656138627732,MATH 20A,A01,083754,Zheng; Zequn,11,0,40,29
1656138633759,MATH 20B,A01,083756,Briones; Jor-el Thomas Caparas,0,0,36,36
1656138633759,MATH 20B,A02,083757,Briones; Jor-el Thomas Caparas,0,0,36,36
1656138633759,MATH 20B,A03,093475,Staff,2,0,36,34
1656138639862,MATH 20C,A01,083760,Briones; Jor-el Thomas Caparas,0,0,35,35
1656138639862,MATH 20C,A02,083761,Briones; Jor-el Thomas Caparas,9,1,35,26
1656138639862,MATH 20C,A03,093476,Staff,0,0,35,35
1656138639862,MATH 20C,B01,083762,Bach; Quang Tran,1,0,30,29
1656138645892,MATH 20D,A01,083765,Tran; Brian Kha,2,0,30,28
1656138645892,MATH 20D,A02,083766,Tran; Brian Kha,0,1,30,30
1656138645892,MATH 20D,A03,083767,Tran; Brian Kha,2,0,30,28
1656138651915,MATH 20E,A01,083771,Ganguly; Soumya,4,0,32,28
1656138651915,MATH 20E,A02,083772,Ganguly; Soumya,0,0,32,32
1656138651915,MATH 20E,B01,083773,Ciotti; Benjamin,15,0,35,20
1656138651915,MATH 20E,B02,083774,Ciotti; Benjamin,14,0,35,21
1656138657938,MATH 103A,A01,083777,Greenfeld; Be'Eri,1,0,36,35
1656138657938,MATH 103A,A02,083778,Greenfeld; Be'Eri,1,0,36,35
1656138657938,MATH 103A,A03,093561,Staff,4,0,36,32
1656138657938,MATH 103A,B01,083779,Greenfeld; Be'Eri,8,1,36,28
1656138657938,MATH 103A,B02,083780,Greenfeld; Be'Eri,0,0,36,36
1656138657938,MATH 103A,B03,093562,Staff,0,0,36,36
1656138663964,MATH 105,A01,085443,Carter; Anne Toulson,4,1,35,31
1656138663964,MATH 105,A02,093477,Staff,11,0,35,24
1656138669988,MATH 109,A01,083213,Ganzberger; Geoffrey Michael,0,0,34,34
1656138669988,MATH 109,A02,083214,Ganzberger; Geoffrey Michael,0,0,34,34
1656138669988,MATH 109,A03,093478,Staff,1,0,34,33
1656138669988,MATH 109,B01,083215,Ganzberger; Geoffrey Michael,4,0,32,28
1656138669988,MATH 109,B02,083216,Ganzberger; Geoffrey Michael,1,0,32,31
1656138669988,MATH 109,B03,093479,Staff,4,0,32,28
1656138676012,MATH 142A,A01,083219,Chow; Bennett,1,0,32,31
1656138676012,MATH 142A,A02,083220,Chow; Bennett,8,0,32,24
1656138676012,MATH 142A,A03,093480,Staff,5,0,32,27
1656138676012,MATH 142A,B03,093481,Staff,4,0,32,28
1656138676012,MATH 142A,B04,093558,Staff,6,0,32,26
1656138676012,MATH 142A,B05,093559,Staff,0,0,32,32
1656138682042,MATH 193A,A01,083224,Rotar; Vladimir,0,1,34,34
1656138682042,MATH 193A,A02,083225,Rotar; Vladimir,0,0,34,34
1656138682042,MATH 193A,A03,083781,Rotar; Vladimir,0,0,34,34
1656138682042,MATH 193A,A04,083782,Rotar; Vladimir,6,0,34,28
1656138682042,MATH 193A,A05,093482,Rotar; Vladimir,1,0,34,33
1656138688065,MATH 197,001,091859,McAuley; Julian John,9999,0,9999,0
1656138688065,MATH 197,002,095566,Kedlaya; Kiran S.,9997,0,9999,2
1656138688065,MATH 197,003,095567,Xiao; Ming,9999,0,9999,0
1656138688065,MATH 197,004,095571,Perols; Johan Lars,9998,0,9999,1
1656138695121,COGS 9,A01,083615,Shannon; Kyle Michael,4,0,75,71
1656138701147,COGS 11,A01,083617,Boyle; Mary E. T.,15,0,48,33
1656138707189,COGS 13,A01,083071,Bastos; Amalia Pinkusfeld,6,0,71,65
1656138713219,COGS 14A,A01,092681,Semenuks; Arturs,4,15,100,96
1656138719243,COGS 14B,A01,083073,Cheng; Tzu-Han,7,0,63,56
1656138725268,COGS 17,A01,092677,Semenuks; Arturs,8,0,81,73
1656138731294,COGS 100,A01,083619,Allen; Michael Gordon,3,0,70,67
1656138737319,COGS 101A,A01,083621,Davis; Joshua Daniel,3,0,68,65
1656138743343,COGS 101B,A01,091572,Allen; Michael Gordon,6,0,65,59
1656138749372,COGS 101C,A01,083625,Delgado; Tania,10,0,35,25
1656138755401,COGS 107A,A01,083627,Boyle; Mary E. T.,1,0,60,59
1656138761426,COGS 118A,A01,083075,Gupta; Anjum,7,0,76,69
1656138767450,CSE 3,A50,083646,Miranda; Gregory Joseph,17,0,50,33
1656138773478,CSE 8A,A50,083650,Miranda; Gregory Joseph,2,2,56,54
1656138779505,CSE 11,A01,083080,Cao; Yingjun,1,54,40,39
1656138785528,CSE 12,A01,083652,Krause-Levy; Sophia Louisa,7,1,120,113
1656138791554,CSE 15L,A01,083654,Morris; Justin Loren,3,0,50,47
1656138791554,CSE 15L,A02,083655,Morris; Justin Loren,4,0,50,46
1656138797582,CSE 20,A01,083657,Tran; Khoa Dang,31,0,80,49
1656138803609,CSE 21,A01,095574,Bach; Quang Tran,25,0,48,23
1656138809636,CSE 30,A01,083084,Eldon; John,2,8,80,78
1656138809636,CSE 30,B01,095061,Bhaskar; Nishant,1,2,50,49
1656138815658,CSE 100,A01,083659,Cao; Yingjun,2,20,70,68
1656138821682,CSE 134B,A01,083661,Powell; Thomas Allan,3,0,100,97
1656138827710,CSE 140,A01,083663,Gungor; Onat,9,0,85,76
1656138833733,CSE 140L,A01,083088,Eldon; John,8,0,100,92
1656138839758,CSE 175,A01,083665,Kumar; Rakesh,0,0,25,25
1656138845793,CSE 190,A00,092507,Dubnov; Shlomo,2,0,20,18
1656138851820,ECE 45,A01,083139,Congero; Spencer William,1,0,75,74
1656138857844,ECE 65,A50,083695,Saad; Andrew S,8,0,30,22
1656138857844,ECE 65,A51,095125,Staff,23,0,26,3
1656138863869,ECE 109,A01,091882,Touri; Behrouz,0,1,70,70
1656138869900,ECE 180,A00,083140,Abi Samra; Nicholas Camill,1,0,30,29
1656138869900,ECE 180,B00,083141,Abi Samra; Nicholas Camill,0,4,30,30
1656138875935,MATH 10A,A01,083735,Patchell; Gregory David,0,0,30,30
1656138875935,MATH 10A,A02,083736,Patchell; Gregory David,22,0,30,8
1656138875935,MATH 10A,A03,083737,Patchell; Gregory David,16,0,30,14
1656138881964,MATH 10B,A01,083207,Lim; Seonhee,0,0,34,34
1656138881964,MATH 10B,A02,083208,Lim; Seonhee,7,0,35,28
1656138881964,MATH 10B,A03,093472,Staff,1,0,34,33
1656138881964,MATH 10B,B01,083739,Sinha; Shubham,11,0,30,19
1656138887993,MATH 18,A01,083743,Cinel; Cameron Alexander,7,0,30,23
1656138887993,MATH 18,A02,083744,Cinel; Cameron Alexander,10,0,30,20
1656138887993,MATH 18,A03,083745,Cinel; Cameron Alexander,4,0,30,26
1656138887993,MATH 18,B01,083748,Rideout; David Porter,0,0,36,36
1656138887993,MATH 18,B02,083749,Rideout; David Porter,0,0,36,36
1656138887993,MATH 18,B03,083750,Rideout; David Porter,0,0,36,36
1656138887993,MATH 18,B04,083751,Rideout; David Porter,0,0,36,36
1656138887993,MATH 18,B05,093473,Rideout; David Porter,1,0,36,35
1656138887993,MATH 18,B06,093474,Rideout; David Porter,4,0,36,32
1656138894031,MATH 20A,A01,083754,Zheng; Zequn,11,0,40,29
1656138900071,MATH 20B,A01,083756,Briones; Jor-el Thomas Caparas,0,0,36,36
1656138900071,MATH 20B,A02,083757,Briones; Jor-el Thomas Caparas,0,0,36,36
1656138900071,MATH 20B,A03,093475,Staff,2,0,36,34
1656138906094,MATH 20C,A01,083760,Briones; Jor-el Thomas Caparas,0,0,35,35
1656138906094,MATH 20C,A02,083761,Briones; Jor-el Thomas Caparas,9,1,35,26
1656138906094,MATH 20C,A03,093476,Staff,0,0,35,35
1656138906094,MATH 20C,B01,083762,Bach; Quang Tran,1,0,30,29
1656138912118,MATH 20D,A01,083765,Tran; Brian Kha,2,0,30,28
1656138912118,MATH 20D,A02,083766,Tran; Brian Kha,0,1,30,30
1656138912118,MATH 20D,A03,083767,Tran; Brian Kha,2,0,30,28
1656138918141,MATH 20E,A01,083771,Ganguly; Soumya,4,0,32,28
1656138918141,MATH 20E,A02,083772,Ganguly; Soumya,0,0,32,32
1656138918141,MATH 20E,B01,083773,Ciotti; Benjamin,15,0,35,20
1656138918141,MATH 20E,B02,083774,Ciotti; Benjamin,14,0,35,21
1656138924166,MATH 103A,A01,083777,Greenfeld; Be'Eri,1,0,36,35
1656138924166,MATH 103A,A02,083778,Greenfeld; Be'Eri,1,0,36,35
1656138924166,MATH 103A,A03,093561,Staff,4,0,36,32
1656138924166,MATH 103A,B01,083779,Greenfeld; Be'Eri,8,1,36,28
1656138924166,MATH 103A,B02,083780,Greenfeld; Be'Eri,0,0,36,36
1656138924166,MATH 103A,B03,093562,Staff,0,0,36,36
1656138930194,MATH 105,A01,085443,Carter; Anne Toulson,4,1,35,31
1656138930194,MATH 105,A02,093477,Staff,11,0,35,24
1656138936222,MATH 109,A01,083213,Ganzberger; Geoffrey Michael,0,0,34,34
1656138936222,MATH 109,A02,083214,Ganzberger; Geoffrey Michael,0,0,34,34
1656138936222,MATH 109,A03,093478,Staff,1,0,34,33
1656138936222,MATH 109,B01,083215,Ganzberger; Geoffrey Michael,4,0,32,28
1656138936222,MATH 109,B02,083216,Ganzberger; Geoffrey Michael,1,0,32,31
1656138936222,MATH 109,B03,093479,Staff,4,0,32,28
1656138942252,MATH 142A,A01,083219,Chow; Bennett,1,0,32,31
1656138942252,MATH 142A,A02,083220,Chow; Bennett,8,0,32,24
1656138942252,MATH 142A,A03,093480,Staff,5,0,32,27
1656138942252,MATH 142A,B03,093481,Staff,4,0,32,28
1656138942252,MATH 142A,B04,093558,Staff,6,0,32,26
1656138942252,MATH 142A,B05,093559,Staff,0,0,32,32
1656138948277,MATH 193A,A01,083224,Rotar; Vladimir,0,1,34,34
1656138948277,MATH 193A,A02,083225,Rotar; Vladimir,0,0,34,34
1656138948277,MATH 193A,A03,083781,Rotar; Vladimir,0,0,34,34
1656138948277,MATH 193A,A04,083782,Rotar; Vladimir,6,0,34,28
1656138948277,MATH 193A,A05,093482,Rotar; Vladimir,1,0,34,33
1656138954303,MATH 197,001,091859,McAuley; Julian John,9999,0,9999,0
1656138954303,MATH 197,002,095566,Kedlaya; Kiran S.,9997,0,9999,2
1656138954303,MATH 197,003,095567,Xiao; Ming,9999,0,9999,0
1656138954303,MATH 197,004,095571,Perols; Johan Lars,9998,0,9999,1
1656138961355,COGS 9,A01,083615,Shannon; Kyle Michael,4,0,75,71
1656138967383,COGS 11,A01,083617,Boyle; Mary E. T.,16,0,48,32
1656138973406,COGS 13,A01,083071,Bastos; Amalia Pinkusfeld,6,0,71,65
1656138979432,COGS 14A,A01,092681,Semenuks; Arturs,4,15,100,96
1656138985454,COGS 14B,A01,083073,Cheng; Tzu-Han,7,0,63,56
1656138991481,COGS 17,A01,092677,Semenuks; Arturs,8,0,81,73
1656138997514,COGS 100,A01,083619,Allen; Michael Gordon,3,0,70,67
1656139003537,COGS 101A,A01,083621,Davis; Joshua Daniel,3,0,68,65
1656139009565,COGS 101B,A01,091572,Allen; Michael Gordon,6,0,65,59
1656139015591,COGS 101C,A01,083625,Delgado; Tania,10,0,35,25
1656139021618,COGS 107A,A01,083627,Boyle; Mary E. T.,1,0,60,59
1656139027646,COGS 118A,A01,083075,Gupta; Anjum,7,0,76,69
1656139033685,CSE 3,A50,083646,Miranda; Gregory Joseph,17,0,50,33
1656139039711,CSE 8A,A50,083650,Miranda; Gregory Joseph,2,2,56,54
1656139045733,CSE 11,A01,083080,Cao; Yingjun,1,54,40,39
1656139051763,CSE 12,A01,083652,Krause-Levy; Sophia Louisa,7,2,120,113
1656139057791,CSE 15L,A01,083654,Morris; Justin Loren,2,0,50,48
1656139057791,CSE 15L,A02,083655,Morris; Justin Loren,4,0,50,46
1656139063815,CSE 20,A01,083657,Tran; Khoa Dang,31,0,80,49
1656139069837,CSE 21,A01,095574,Bach; Quang Tran,25,0,48,23
1656139075861,CSE 30,A01,083084,Eldon; John,2,8,80,78
1656139075861,CSE 30,B01,095061,Bhaskar; Nishant,1,2,50,49
1656139081889,CSE 100,A01,083659,Cao; Yingjun,2,20,70,68
1656139087916,CSE 134B,A01,083661,Powell; Thomas Allan,3,0,100,97
1656139093941,CSE 140,A01,083663,Gungor; Onat,9,0,85,76
1656139099965,CSE 140L,A01,083088,Eldon; John,8,0,100,92
1656139105990,CSE 175,A01,083665,Kumar; Rakesh,0,0,25,25
1656139112016,CSE 190,A00,092507,Dubnov; Shlomo,2,0,20,18
1656139118053,ECE 45,A01,083139,Congero; Spencer William,1,0,75,74
1656139124078,ECE 65,A50,083695,Saad; Andrew S,8,0,30,22
1656139124078,ECE 65,A51,095125,Staff,23,0,26,3
1656139130106,ECE 109,A01,091882,Touri; Behrouz,0,1,70,70
1656139136129,ECE 180,A00,083140,Abi Samra; Nicholas Camill,1,0,30,29
1656139136129,ECE 180,B00,083141,Abi Samra; Nicholas Camill,0,4,30,30
1656139142157,MATH 10A,A01,083735,Patchell; Gregory David,0,0,30,30
1656139142157,MATH 10A,A02,083736,Patchell; Gregory David,22,0,30,8
1656139142157,MATH 10A,A03,083737,Patchell; Gregory David,16,0,30,14
1656139148186,MATH 10B,A01,083207,Lim; Seonhee,0,0,34,34
1656139148186,MATH 10B,A02,083208,Lim; Seonhee,7,0,35,28
1656139148186,MATH 10B,A03,093472,Staff,1,0,34,33
1656139148186,MATH 10B,B01,083739,Sinha; Shubham,11,0,30,19
1656139154218,MATH 18,A01,083743,Cinel; Cameron Alexander,7,0,30,23
1656139154218,MATH 18,A02,083744,Cinel; Cameron Alexander,10,0,30,20
1656139154218,MATH 18,A03,083745,Cinel; Cameron Alexander,4,0,30,26
1656139154218,MATH 18,B01,083748,Rideout; David Porter,0,0,36,36
1656139154218,MATH 18,B02,083749,Rideout; David Porter,0,0,36,36
1656139154218,MATH 18,B03,083750,Rideout; David Porter,0,0,36,36
1656139154218,MATH 18,B04,083751,Rideout; David Porter,0,0,36,36
1656139154218,MATH 18,B05,093473,Rideout; David Porter,1,0,36,35
1656139154218,MATH 18,B06,093474,Rideout; David Porter,4,0,36,32
1656139160246,MATH 20A,A01,083754,Zheng; Zequn,11,0,40,29
1656139166269,MATH 20B,A01,083756,Briones; Jor-el Thomas Caparas,0,0,36,36
1656139166269,MATH 20B,A02,083757,Briones; Jor-el Thomas Caparas,0,0,36,36
1656139166269,MATH 20B,A03,093475,Staff,2,0,36,34
1656139172294,MATH 20C,A01,083760,Briones; Jor-el Thomas Caparas,0,0,35,35
1656139172294,MATH 20C,A02,083761,Briones; Jor-el Thomas Caparas,9,1,35,26
1656139172294,MATH 20C,A03,093476,Staff,0,0,35,35
1656139172294,MATH 20C,B01,083762,Bach; Quang Tran,1,0,30,29
1656139178318,MATH 20D,A01,083765,Tran; Brian Kha,2,0,30,28
1656139178318,MATH 20D,A02,083766,Tran; Brian Kha,0,1,30,30
1656139178318,MATH 20D,A03,083767,Tran; Brian Kha,2,0,30,28
1656139184351,MATH 20E,A01,083771,Ganguly; Soumya,4,0,32,28
1656139184351,MATH 20E,A02,083772,Ganguly; Soumya,0,0,32,32
1656139184351,MATH 20E,B01,083773,Ciotti; Benjamin,15,0,35,20
1656139184351,MATH 20E,B02,083774,Ciotti; Benjamin,14,0,35,21
1656139190380,MATH 103A,A01,083777,Greenfeld; Be'Eri,1,0,36,35
1656139190380,MATH 103A,A02,083778,Greenfeld; Be'Eri,1,0,36,35
1656139190380,MATH 103A,A03,093561,Staff,4,0,36,32
1656139190380,MATH 103A,B01,083779,Greenfeld; Be'Eri,8,1,36,28
1656139190380,MATH 103A,B02,083780,Greenfeld; Be'Eri,0,0,36,36
1656139190380,MATH 103A,B03,093562,Staff,0,0,36,36
1656139196409,MATH 105,A01,085443,Carter; Anne Toulson,4,1,35,31
1656139196409,MATH 105,A02,093477,Staff,11,0,35,24
1656139202433,MATH 109,A01,083213,Ganzberger; Geoffrey Michael,0,0,34,34
1656139202433,MATH 109,A02,083214,Ganzberger; Geoffrey Michael,0,0,34,34
1656139202433,MATH 109,A03,093478,Staff,1,0,34,33
1656139202433,MATH 109,B01,083215,Ganzberger; Geoffrey Michael,4,0,32,28
1656139202433,MATH 109,B02,083216,Ganzberger; Geoffrey Michael,1,0,32,31
1656139202433,MATH 109,B03,093479,Staff,4,0,32,28
1656139208457,MATH 142A,A01,083219,Chow; Bennett,1,0,32,31
1656139208457,MATH 142A,A02,083220,Chow; Bennett,8,0,32,24
1656139208457,MATH 142A,A03,093480,Staff,5,0,32,27
1656139208457,MATH 142A,B03,093481,Staff,4,0,32,28
1656139208457,MATH 142A,B04,093558,Staff,6,0,32,26
1656139208457,MATH 142A,B05,093559,Staff,0,0,32,32
1656139214482,MATH 193A,A01,083224,Rotar; Vladimir,0,1,34,34
1656139214482,MATH 193A,A02,083225,Rotar; Vladimir,0,0,34,34
1656139214482,MATH 193A,A03,083781,Rotar; Vladimir,0,0,34,34
1656139214482,MATH 193A,A04,083782,Rotar; Vladimir,6,0,34,28
1656139214482,MATH 193A,A05,093482,Rotar; Vladimir,1,0,34,33
1656139220506,MATH 197,001,091859,McAuley; Julian John,9999,0,9999,0
1656139220506,MATH 197,002,095566,Kedlaya; Kiran S.,9997,0,9999,2
1656139220506,MATH 197,003,095567,Xiao; Ming,9999,0,9999,0
1656139220506,MATH 197,004,095571,Perols; Johan Lars,9998,0,9999,1
1656139227561,COGS 9,A01,083615,Shannon; Kyle Michael,4,0,75,71
1656139233672,COGS 11,A01,083617,Boyle; Mary E. T.,16,0,48,32
1656139239697,COGS 13,A01,083071,Bastos; Amalia Pinkusfeld,6,0,71,65
1656139245723,COGS 14A,A01,092681,Semenuks; Arturs,4,15,100,96
1656139251748,COGS 14B,A01,083073,Cheng; Tzu-Han,7,0,63,56
1656139257776,COGS 17,A01,092677,Semenuks; Arturs,8,0,81,73
1656139263803,COGS 100,A01,083619,Allen; Michael Gordon,3,0,70,67
1656139269835,COGS 101A,A01,083621,Davis; Joshua Daniel,3,0,68,65
1656139275857,COGS 101B,A01,091572,Allen; Michael Gordon,6,0,65,59
1656139281879,COGS 101C,A01,083625,Delgado; Tania,10,0,35,25
1656139287903,COGS 107A,A01,083627,Boyle; Mary E. T.,1,0,60,59
1656139293926,COGS 118A,A01,083075,Gupta; Anjum,7,0,76,69
1656139299951,CSE 3,A50,083646,Miranda; Gregory Joseph,17,0,50,33
1656139305979,CSE 8A,A50,083650,Miranda; Gregory Joseph,2,3,56,54
1656139312003,CSE 11,A01,083080,Cao; Yingjun,1,54,40,39
1656139318026,CSE 12,A01,083652,Krause-Levy; Sophia Louisa,7,2,120,113
1656139324050,CSE 15L,A01,083654,Morris; Justin Loren,2,0,50,48
1656139324050,CSE 15L,A02,083655,Morris; Justin Loren,4,0,50,46
1656139330074,CSE 20,A01,083657,Tran; Khoa Dang,31,0,80,49
1656139336098,CSE 21,A01,095574,Bach; Quang Tran,25,0,48,23
1656139342121,CSE 30,A01,083084,Eldon; John,2,8,80,78
1656139342121,CSE 30,B01,095061,Bhaskar; Nishant,1,2,50,49
1656139348143,CSE 100,A01,083659,Cao; Yingjun,2,20,70,68
1656139354170,CSE 134B,A01,083661,Powell; Thomas Allan,3,0,100,97
1656139360194,CSE 140,A01,083663,Gungor; Onat,9,0,85,76
1656139366221,CSE 140L,A01,083088,Eldon; John,8,0,100,92
1656139372242,CSE 175,A01,083665,Kumar; Rakesh,0,0,25,25
1656139378265,CSE 190,A00,092507,Dubnov; Shlomo,2,0,20,18
1656139384289,ECE 45,A01,083139,Congero; Spencer William,1,0,75,74
1656139390313,ECE 65,A50,083695,Saad; Andrew S,8,0,30,22
1656139390313,ECE 65,A51,095125,Staff,23,0,26,3
1656139396350,ECE 109,A01,091882,Touri; Behrouz,0,1,70,70
1656139402376,ECE 180,A00,083140,Abi Samra; Nicholas Camill,1,0,30,29
1656139402376,ECE 180,B00,083141,Abi Samra; Nicholas Camill,0,4,30,30
1656139408404,MATH 10A,A01,083735,Patchell; Gregory David,0,0,30,30
1656139408404,MATH 10A,A02,083736,Patchell; Gregory David,22,0,30,8
1656139408404,MATH 10A,A03,083737,Patchell; Gregory David,16,0,30,14
1656139414429,MATH 10B,A01,083207,Lim; Seonhee,0,0,34,34
1656139414429,MATH 10B,A02,083208,Lim; Seonhee,7,0,35,28
1656139414429,MATH 10B,A03,093472,Staff,1,0,34,33
1656139414429,MATH 10B,B01,083739,Sinha; Shubham,11,0,30,19
1656139420454,MATH 18,A01,083743,Cinel; Cameron Alexander,7,0,30,23
1656139420454,MATH 18,A02,083744,Cinel; Cameron Alexander,10,0,30,20
1656139420454,MATH 18,A03,083745,Cinel; Cameron Alexander,4,0,30,26
1656139420454,MATH 18,B01,083748,Rideout; David Porter,0,0,36,36
1656139420454,MATH 18,B02,083749,Rideout; David Porter,0,0,36,36
1656139420454,MATH 18,B03,083750,Rideout; David Porter,0,0,36,36
1656139420454,MATH 18,B04,083751,Rideout; David Porter,0,0,36,36
1656139420454,MATH 18,B05,093473,Rideout; David Porter,1,0,36,35
1656139420454,MATH 18,B06,093474,Rideout; David Porter,4,0,36,32
1656139426476,MATH 20A,A01,083754,Zheng; Zequn,11,0,40,29
1656139432502,MATH 20B,A01,083756,Briones; Jor-el Thomas Caparas,0,0,36,36
1656139432502,MATH 20B,A02,083757,Briones; Jor-el Thomas Caparas,0,0,36,36
1656139432502,MATH 20B,A03,093475,Staff,2,0,36,34
1656139438526,MATH 20C,A01,083760,Briones; Jor-el Thomas Caparas,0,0,35,35
1656139438526,MATH 20C,A02,083761,Briones; Jor-el Thomas Caparas,9,1,35,26
1656139438526,MATH 20C,A03,093476,Staff,0,0,35,35
1656139438526,MATH 20C,B01,083762,Bach; Quang Tran,1,0,30,29
1656139444550,MATH 20D,A01,083765,Tran; Brian Kha,2,0,30,28
1656139444550,MATH 20D,A02,083766,Tran; Brian Kha,0,1,30,30
1656139444550,MATH 20D,A03,083767,Tran; Brian Kha,2,0,30,28
1656139450585,MATH 20E,A01,083771,Ganguly; Soumya,4,0,32,28
1656139450585,MATH 20E,A02,083772,Ganguly; Soumya,0,0,32,32
1656139450585,MATH 20E,B01,083773,Ciotti; Benjamin,15,0,35,20
1656139450585,MATH 20E,B02,083774,Ciotti; Benjamin,14,0,35,21
1656139456610,MATH 103A,A01,083777,Greenfeld; Be'Eri,1,0,36,35
1656139456610,MATH 103A,A02,083778,Greenfeld; Be'Eri,1,0,36,35
1656139456610,MATH 103A,A03,093561,Staff,4,0,36,32
1656139456610,MATH 103A,B01,083779,Greenfeld; Be'Eri,8,1,36,28
1656139456610,MATH 103A,B02,083780,Greenfeld; Be'Eri,0,0,36,36
1656139456610,MATH 103A,B03,093562,Staff,0,0,36,36
1656139462633,MATH 105,A01,085443,Carter; Anne Toulson,4,1,35,31
1656139462633,MATH 105,A02,093477,Staff,11,0,35,24
1656139468656,MATH 109,A01,083213,Ganzberger; Geoffrey Michael,0,0,34,34
1656139468656,MATH 109,A02,083214,Ganzberger; Geoffrey Michael,0,0,34,34
1656139468656,MATH 109,A03,093478,Staff,1,0,34,33
1656139468656,MATH 109,B01,083215,Ganzberger; Geoffrey Michael,4,0,32,28
1656139468656,MATH 109,B02,083216,Ganzberger; Geoffrey Michael,1,0,32,31
1656139468656,MATH 109,B03,093479,Staff,4,0,32,28
1656139474681,MATH 142A,A01,083219,Chow; Bennett,1,0,32,31
1656139474681,MATH 142A,A02,083220,Chow; Bennett,8,0,32,24
1656139474681,MATH 142A,A03,093480,Staff,5,0,32,27
1656139474681,MATH 142A,B03,093481,Staff,4,0,32,28
1656139474681,MATH 142A,B04,093558,Staff,6,0,32,26
1656139474681,MATH 142A,B05,093559,Staff,0,0,32,32
1656139480715,MATH 193A,A01,083224,Rotar; Vladimir,0,1,34,34
1656139480715,MATH 193A,A02,083225,Rotar; Vladimir,0,0,34,34
1656139480715,MATH 193A,A03,083781,Rotar; Vladimir,0,0,34,34
1656139480715,MATH 193A,A04,083782,Rotar; Vladimir,6,0,34,28
1656139480715,MATH 193A,A05,093482,Rotar; Vladimir,1,0,34,33
1656139486739,MATH 197,001,091859,McAuley; Julian John,9999,0,9999,0
1656139486739,MATH 197,002,095566,Kedlaya; Kiran S.,9997,0,9999,2
1656139486739,MATH 197,003,095567,Xiao; Ming,9999,0,9999,0
1656139486739,MATH 197,004,095571,Perols; Johan Lars,9998,0,9999,1
1656139493792,COGS 9,A01,083615,Shannon; Kyle Michael,4,0,75,71
1656139499819,COGS 11,A01,083617,Boyle; Mary E. T.,16,0,48,32
1656139505841,COGS 13,A01,083071,Bastos; Amalia Pinkusfeld,6,0,71,65
1656139511865,COGS 14A,A01,092681,Semenuks; Arturs,4,15,100,96
1656139517889,COGS 14B,A01,083073,Cheng; Tzu-Han,7,0,63,56
1656139523914,COGS 17,A01,092677,Semenuks; Arturs,8,0,81,73
1656139529939,COGS 100,A01,083619,Allen; Michael Gordon,3,0,70,67
1656139535962,COGS 101A,A01,083621,Davis; Joshua Daniel,3,0,68,65
1656139541992,COGS 101B,A01,091572,Allen; Michael Gordon,6,0,65,59
1656139548018,COGS 101C,A01,083625,Delgado; Tania,10,0,35,25
1656139554042,COGS 107A,A01,083627,Boyle; Mary E. T.,1,0,60,59
1656139560064,COGS 118A,A01,083075,Gupta; Anjum,7,0,76,69
1656139566089,CSE 3,A50,083646,Miranda; Gregory Joseph,17,0,50,33
1656139572117,CSE 8A,A50,083650,Miranda; Gregory Joseph,2,3,56,54
1656139578143,CSE 11,A01,083080,Cao; Yingjun,1,54,40,39
1656139584167,CSE 12,A01,083652,Krause-Levy; Sophia Louisa,7,2,120,113
1656139590190,CSE 15L,A01,083654,Morris; Justin Loren,2,0,50,48
1656139590190,CSE 15L,A02,083655,Morris; Justin Loren,4,0,50,46
1656139596217,CSE 20,A01,083657,Tran; Khoa Dang,31,0,80,49
1656139602240,CSE 21,A01,095574,Bach; Quang Tran,25,0,48,23
1656139608263,CSE 30,A01,083084,Eldon; John,2,8,80,78
1656139608263,CSE 30,B01,095061,Bhaskar; Nishant,1,2,50,49
1656139614295,CSE 100,A01,083659,Cao; Yingjun,2,20,70,68
1656139620320,CSE 134B,A01,083661,Powell; Thomas Allan,3,0,100,97
1656139626342,CSE 140,A01,083663,Gungor; Onat,9,0,85,76
1656139632366,CSE 140L,A01,083088,Eldon; John,8,0,100,92
1656139638393,CSE 175,A01,083665,Kumar; Rakesh,0,0,25,25
1656139644416,CSE 190,A00,092507,Dubnov; Shlomo,2,0,20,18
1656139650449,ECE 45,A01,083139,Congero; Spencer William,1,0,75,74
1656139656477,ECE 65,A50,083695,Saad; Andrew S,8,0,30,22
1656139656477,ECE 65,A51,095125,Staff,23,0,26,3
1656139662508,ECE 109,A01,091882,Touri; Behrouz,0,1,70,70
1656139668532,ECE 180,A00,083140,Abi Samra; Nicholas Camill,1,0,30,29
1656139668532,ECE 180,B00,083141,Abi Samra; Nicholas Camill,0,4,30,30
1656139674560,MATH 10A,A01,083735,Patchell; Gregory David,0,0,30,30
1656139674560,MATH 10A,A02,083736,Patchell; Gregory David,22,0,30,8
1656139674560,MATH 10A,A03,083737,Patchell; Gregory David,16,0,30,14
1656139680589,MATH 10B,A01,083207,Lim; Seonhee,0,0,34,34
1656139680589,MATH 10B,A02,083208,Lim; Seonhee,7,0,35,28
1656139680589,MATH 10B,A03,093472,Staff,1,0,34,33
1656139680589,MATH 10B,B01,083739,Sinha; Shubham,11,0,30,19
1656139686622,MATH 18,A01,083743,Cinel; Cameron Alexander,7,0,30,23
1656139686622,MATH 18,A02,083744,Cinel; Cameron Alexander,10,0,30,20
1656139686622,MATH 18,A03,083745,Cinel; Cameron Alexander,4,0,30,26
1656139686622,MATH 18,B01,083748,Rideout; David Porter,0,0,36,36
1656139686622,MATH 18,B02,083749,Rideout; David Porter,0,0,36,36
1656139686622,MATH 18,B03,083750,Rideout; David Porter,0,0,36,36
1656139686622,MATH 18,B04,083751,Rideout; David Porter,0,0,36,36
1656139686622,MATH 18,B05,093473,Rideout; David Porter,1,0,36,35
1656139686622,MATH 18,B06,093474,Rideout; David Porter,4,0,36,32
1656139692645,MATH 20A,A01,083754,Zheng; Zequn,11,0,40,29
1656139698673,MATH 20B,A01,083756,Briones; Jor-el Thomas Caparas,0,0,36,36
1656139698673,MATH 20B,A02,083757,Briones; Jor-el Thomas Caparas,0,0,36,36
1656139698673,MATH 20B,A03,093475,Staff,2,0,36,34
1656139704701,MATH 20C,A01,083760,Briones; Jor-el Thomas Caparas,0,0,35,35
1656139704701,MATH 20C,A02,083761,Briones; Jor-el Thomas Caparas,9,1,35,26
1656139704701,MATH 20C,A03,093476,Staff,0,0,35,35
1656139704701,MATH 20C,B01,083762,Bach; Quang Tran,1,0,30,29
1656139710724,MATH 20D,A01,083765,Tran; Brian Kha,2,0,30,28
1656139710724,MATH 20D,A02,083766,Tran; Brian Kha,0,1,30,30
1656139710724,MATH 20D,A03,083767,Tran; Brian Kha,2,0,30,28
1656139716749,MATH 20E,A01,083771,Ganguly; Soumya,4,0,32,28
1656139716749,MATH 20E,A02,083772,Ganguly; Soumya,0,0,32,32
1656139716749,MATH 20E,B01,083773,Ciotti; Benjamin,15,0,35,20
1656139716749,MATH 20E,B02,083774,Ciotti; Benjamin,14,0,35,21
1656139722773,MATH 103A,A01,083777,Greenfeld; Be'Eri,1,0,36,35
1656139722773,MATH 103A,A02,083778,Greenfeld; Be'Eri,1,0,36,35
1656139722773,MATH 103A,A03,093561,Staff,4,0,36,32
1656139722773,MATH 103A,B01,083779,Greenfeld; Be'Eri,8,1,36,28
1656139722773,MATH 103A,B02,083780,Greenfeld; Be'Eri,1,0,36,35
1656139722773,MATH 103A,B03,093562,Staff,0,0,36,36
1656139728795,MATH 105,A01,085443,Carter; Anne Toulson,4,1,35,31
1656139728795,MATH 105,A02,093477,Staff,11,0,35,24
1656139734821,MATH 109,A01,083213,Ganzberger; Geoffrey Michael,0,0,34,34
1656139734821,MATH 109,A02,083214,Ganzberger; Geoffrey Michael,0,0,34,34
1656139734821,MATH 109,A03,093478,Staff,1,0,34,33
1656139734821,MATH 109,B01,083215,Ganzberger; Geoffrey Michael,4,0,32,28
1656139734821,MATH 109,B02,083216,Ganzberger; Geoffrey Michael,1,0,32,31
1656139734821,MATH 109,B03,093479,Staff,4,0,32,28
1656139740853,MATH 142A,A01,083219,Chow; Bennett,1,0,32,31
1656139740853,MATH 142A,A02,083220,Chow; Bennett,8,0,32,24
1656139740853,MATH 142A,A03,093480,Staff,5,0,32,27
1656139740853,MATH 142A,B03,093481,Staff,4,0,32,28
1656139740853,MATH 142A,B04,093558,Staff,6,0,32,26
1656139740853,MATH 142A,B05,093559,Staff,0,0,32,32
1656139746889,MATH 193A,A01,083224,Rotar; Vladimir,0,1,34,34
1656139746889,MATH 193A,A02,083225,Rotar; Vladimir,0,0,34,34
1656139746889,MATH 193A,A03,083781,Rotar; Vladimir,0,0,34,34
1656139746889,MATH 193A,A04,083782,Rotar; Vladimir,6,0,34,28
1656139746889,MATH 193A,A05,093482,Rotar; Vladimir,1,0,34,33
1656139752914,MATH 197,001,091859,McAuley; Julian John,9999,0,9999,0
1656139752914,MATH 197,002,095566,Kedlaya; Kiran S.,9997,0,9999,2
1656139752914,MATH 197,003,095567,Xiao; Ming,9999,0,9999,0
1656139752914,MATH 197,004,095571,Perols; Johan Lars,9998,0,9999,1
1656139759969,COGS 9,A01,083615,Shannon; Kyle Michael,4,0,75,71
1656139765997,COGS 11,A01,083617,Boyle; Mary E. T.,16,0,48,32
1656139772025,COGS 13,A01,083071,Bastos; Amalia Pinkusfeld,6,0,71,65
1656139778051,COGS 14A,A01,092681,Semenuks; Arturs,4,15,100,96
1656139784078,COGS 14B,A01,083073,Cheng; Tzu-Han,7,0,63,56
1656139790101,COGS 17,A01,092677,Semenuks; Arturs,8,0,81,73
1656139796125,COGS 100,A01,083619,Allen; Michael Gordon,3,0,70,67
1656139802149,COGS 101A,A01,083621,Davis; Joshua Daniel,3,0,68,65
1656139808175,COGS 101B,A01,091572,Allen; Michael Gordon,6,0,65,59
1656139814199,COGS 101C,A01,083625,Delgado; Tania,10,0,35,25
1656139820227,COGS 107A,A01,083627,Boyle; Mary E. T.,1,0,60,59
1656139826249,COGS 118A,A01,083075,Gupta; Anjum,7,0,76,69
1656139832378,CSE 3,A50,083646,Miranda; Gregory Joseph,17,0,50,33
1656139838411,CSE 8A,A50,083650,Miranda; Gregory Joseph,2,3,56,54
1656139844438,CSE 11,A01,083080,Cao; Yingjun,1,53,40,39
1656139850462,CSE 12,A01,083652,Krause-Levy; Sophia Louisa,7,2,120,113
1656139856489,CSE 15L,A01,083654,Morris; Justin Loren,2,0,50,48
1656139856489,CSE 15L,A02,083655,Morris; Justin Loren,4,0,50,46
1656139862523,CSE 20,A01,083657,Tran; Khoa Dang,31,0,80,49
1656139868550,CSE 21,A01,095574,Bach; Quang Tran,25,0,48,23
1656139874578,CSE 30,A01,083084,Eldon; John,2,8,80,78
1656139874578,CSE 30,B01,095061,Bhaskar; Nishant,1,2,50,49
1656139880603,CSE 100,A01,083659,Cao; Yingjun,2,20,70,68
1656139886626,CSE 134B,A01,083661,Powell; Thomas Allan,3,0,100,97
1656139892652,CSE 140,A01,083663,Gungor; Onat,9,0,85,76
1656139898679,CSE 140L,A01,083088,Eldon; John,8,0,100,92
1656139904706,CSE 175,A01,083665,Kumar; Rakesh,0,0,25,25
1656139910730,CSE 190,A00,092507,Dubnov; Shlomo,2,0,20,18
1656139916754,ECE 45,A01,083139,Congero; Spencer William,1,0,75,74
1656139922780,ECE 65,A50,083695,Saad; Andrew S,8,0,30,22
1656139922780,ECE 65,A51,095125,Staff,23,0,26,3
1656139928802,ECE 109,A01,091882,Touri; Behrouz,0,1,70,70
1656139934832,ECE 180,A00,083140,Abi Samra; Nicholas Camill,1,0,30,29
1656139934832,ECE 180,B00,083141,Abi Samra; Nicholas Camill,0,4,30,30
1656139940860,MATH 10A,A01,083735,Patchell; Gregory David,0,0,30,30
1656139940860,MATH 10A,A02,083736,Patchell; Gregory David,22,0,30,8
1656139940860,MATH 10A,A03,083737,Patchell; Gregory David,16,0,30,14
1656139946883,MATH 10B,A01,083207,Lim; Seonhee,0,0,34,34
1656139946883,MATH 10B,A02,083208,Lim; Seonhee,7,0,35,28
1656139946883,MATH 10B,A03,093472,Staff,1,0,34,33
1656139946883,MATH 10B,B01,083739,Sinha; Shubham,11,0,30,19
1656139952913,MATH 18,A01,083743,Cinel; Cameron Alexander,7,0,30,23
1656139952913,MATH 18,A02,083744,Cinel; Cameron Alexander,10,0,30,20
1656139952913,MATH 18,A03,083745,Cinel; Cameron Alexander,4,0,30,26
1656139952913,MATH 18,B01,083748,Rideout; David Porter,0,0,36,36
1656139952913,MATH 18,B02,083749,Rideout; David Porter,0,0,36,36
1656139952913,MATH 18,B03,083750,Rideout; David Porter,0,0,36,36
1656139952913,MATH 18,B04,083751,Rideout; David Porter,0,0,36,36
1656139952913,MATH 18,B05,093473,Rideout; David Porter,1,0,36,35
1656139952913,MATH 18,B06,093474,Rideout; David Porter,4,0,36,32
1656139958940,MATH 20A,A01,083754,Zheng; Zequn,11,0,40,29
1656139964968,MATH 20B,A01,083756,Briones; Jor-el Thomas Caparas,0,0,36,36
1656139964968,MATH 20B,A02,083757,Briones; Jor-el Thomas Caparas,0,0,36,36
1656139964968,MATH 20B,A03,093475,Staff,2,0,36,34
1656139970993,MATH 20C,A01,083760,Briones; Jor-el Thomas Caparas,0,0,35,35
1656139970993,MATH 20C,A02,083761,Briones; Jor-el Thomas Caparas,9,1,35,26
1656139970993,MATH 20C,A03,093476,Staff,0,0,35,35
1656139970993,MATH 20C,B01,083762,Bach; Quang Tran,1,0,30,29
1656139977017,MATH 20D,A01,083765,Tran; Brian Kha,2,0,30,28
1656139977017,MATH 20D,A02,083766,Tran; Brian Kha,0,1,30,30
1656139977017,MATH 20D,A03,083767,Tran; Brian Kha,2,0,30,28
1656139983047,MATH 20E,A01,083771,Ganguly; Soumya,4,0,32,28
1656139983047,MATH 20E,A02,083772,Ganguly; Soumya,0,0,32,32
1656139983047,MATH 20E,B01,083773,Ciotti; Benjamin,15,0,35,20
1656139983047,MATH 20E,B02,083774,Ciotti; Benjamin,14,0,35,21
1656139989073,MATH 103A,A01,083777,Greenfeld; Be'Eri,1,0,36,35
1656139989073,MATH 103A,A02,083778,Greenfeld; Be'Eri,1,0,36,35
1656139989073,MATH 103A,A03,093561,Staff,4,0,36,32
1656139989073,MATH 103A,B01,083779,Greenfeld; Be'Eri,8,1,36,28
1656139989073,MATH 103A,B02,083780,Greenfeld; Be'Eri,1,0,36,35
1656139989073,MATH 103A,B03,093562,Staff,0,0,36,36
1656139995107,MATH 105,A01,085443,Carter; Anne Toulson,4,1,35,31
1656139995107,MATH 105,A02,093477,Staff,11,0,35,24
1656140001136,MATH 109,A01,083213,Ganzberger; Geoffrey Michael,0,0,34,34
1656140001136,MATH 109,A02,083214,Ganzberger; Geoffrey Michael,0,0,34,34
1656140001136,MATH 109,A03,093478,Staff,1,0,34,33
1656140001136,MATH 109,B01,083215,Ganzberger; Geoffrey Michael,4,0,32,28
1656140001136,MATH 109,B02,083216,Ganzberger; Geoffrey Michael,1,0,32,31
1656140001136,MATH 109,B03,093479,Staff,4,0,32,28
1656140007165,MATH 142A,A01,083219,Chow; Bennett,1,0,32,31
1656140007165,MATH 142A,A02,083220,Chow; Bennett,8,0,32,24
1656140007165,MATH 142A,A03,093480,Staff,5,0,32,27
1656140007165,MATH 142A,B03,093481,Staff,4,0,32,28
1656140007165,MATH 142A,B04,093558,Staff,6,0,32,26
1656140007165,MATH 142A,B05,093559,Staff,0,0,32,32
1656140013190,MATH 193A,A01,083224,Rotar; Vladimir,0,1,34,34
1656140013190,MATH 193A,A02,083225,Rotar; Vladimir,0,0,34,34
1656140013190,MATH 193A,A03,083781,Rotar; Vladimir,0,0,34,34
1656140013190,MATH 193A,A04,083782,Rotar; Vladimir,6,0,34,28
1656140013190,MATH 193A,A05,093482,Rotar; Vladimir,1,0,34,33
1656140019213,MATH 197,001,091859,McAuley; Julian John,9999,0,9999,0
1656140019213,MATH 197,002,095566,Kedlaya; Kiran S.,9997,0,9999,2
1656140019213,MATH 197,003,095567,Xiao; Ming,9999,0,9999,0
1656140019213,MATH 197,004,095571,Perols; Johan Lars,9998,0,9999,1
1656140026265,COGS 9,A01,083615,Shannon; Kyle Michael,4,0,75,71
1656140032293,COGS 11,A01,083617,Boyle; Mary E. T.,15,0,48,33
1656140038316,COGS 13,A01,083071,Bastos; Amalia Pinkusfeld,6,0,71,65
1656140044342,COGS 14A,A01,092681,Semenuks; Arturs,4,15,100,96
1656140050368,COGS 14B,A01,083073,Cheng; Tzu-Han,7,0,63,56
1656140056395,COGS 17,A01,092677,Semenuks; Arturs,8,0,81,73
1656140062430,COGS 100,A01,083619,Allen; Michael Gordon,3,0,70,67
1656140068452,COGS 101A,A01,083621,Davis; Joshua Daniel,3,0,68,65
1656140074480,COGS 101B,A01,091572,Allen; Michael Gordon,6,0,65,59
1656140080506,COGS 101C,A01,083625,Delgado; Tania,10,0,35,25
1656140086530,COGS 107A,A01,083627,Boyle; Mary E. T.,1,0,60,59
1656140092552,COGS 118A,A01,083075,Gupta; Anjum,7,0,76,69
1656140098575,CSE 3,A50,083646,Miranda; Gregory Joseph,18,0,50,32
1656140104598,CSE 8A,A50,083650,Miranda; Gregory Joseph,2,3,56,54
1656140110622,CSE 11,A01,083080,Cao; Yingjun,1,53,40,39
1656140116646,CSE 12,A01,083652,Krause-Levy; Sophia Louisa,7,2,120,113
1656140122673,CSE 15L,A01,083654,Morris; Justin Loren,2,0,50,48
1656140122673,CSE 15L,A02,083655,Morris; Justin Loren,4,0,50,46
1656140128701,CSE 20,A01,083657,Tran; Khoa Dang,31,0,80,49
1656140134728,CSE 21,A01,095574,Bach; Quang Tran,25,0,48,23
1656140140756,CSE 30,A01,083084,Eldon; John,2,8,80,78
1656140140756,CSE 30,B01,095061,Bhaskar; Nishant,1,2,50,49
1656140146782,CSE 100,A01,083659,Cao; Yingjun,2,20,70,68
1656140152805,CSE 134B,A01,083661,Powell; Thomas Allan,3,0,100,97
1656140158830,CSE 140,A01,083663,Gungor; Onat,9,0,85,76
1656140164855,CSE 140L,A01,083088,Eldon; John,8,0,100,92
1656140170881,CSE 175,A01,083665,Kumar; Rakesh,0,0,25,25
1656140176919,CSE 190,A00,092507,Dubnov; Shlomo,2,0,20,18
1656140182943,ECE 45,A01,083139,Congero; Spencer William,1,0,75,74
1656140188972,ECE 65,A50,083695,Saad; Andrew S,8,0,30,22
1656140188972,ECE 65,A51,095125,Staff,23,0,26,3
1656140195001,ECE 109,A01,091882,Touri; Behrouz,0,1,70,70
1656140201025,ECE 180,A00,083140,Abi Samra; Nicholas Camill,1,0,30,29
1656140201025,ECE 180,B00,083141,Abi Samra; Nicholas Camill,0,4,30,30
1656140207053,MATH 10A,A01,083735,Patchell; Gregory David,0,0,30,30
1656140207053,MATH 10A,A02,083736,Patchell; Gregory David,22,0,30,8
1656140207053,MATH 10A,A03,083737,Patchell; Gregory David,16,0,30,14
1656140213076,MATH 10B,A01,083207,Lim; Seonhee,0,0,34,34
1656140213076,MATH 10B,A02,083208,Lim; Seonhee,7,0,35,28
1656140213076,MATH 10B,A03,093472,Staff,1,0,34,33
1656140213076,MATH 10B,B01,083739,Sinha; Shubham,11,0,30,19
1656140219104,MATH 18,A01,083743,Cinel; Cameron Alexander,7,0,30,23
1656140219104,MATH 18,A02,083744,Cinel; Cameron Alexander,10,0,30,20
1656140219104,MATH 18,A03,083745,Cinel; Cameron Alexander,4,0,30,26
1656140219104,MATH 18,B01,083748,Rideout; David Porter,0,0,36,36
1656140219104,MATH 18,B02,083749,Rideout; David Porter,0,0,36,36
1656140219104,MATH 18,B03,083750,Rideout; David Porter,0,0,36,36
1656140219104,MATH 18,B04,083751,Rideout; David Porter,0,0,36,36
1656140219104,MATH 18,B05,093473,Rideout; David Porter,1,0,36,35
1656140219104,MATH 18,B06,093474,Rideout; David Porter,4,0,36,32
1656140225129,MATH 20A,A01,083754,Zheng; Zequn,11,0,40,29
1656140231162,MATH 20B,A01,083756,Briones; Jor-el Thomas Caparas,0,0,36,36
1656140231162,MATH 20B,A02,083757,Briones; Jor-el Thomas Caparas,0,0,36,36
1656140231162,MATH 20B,A03,093475,Staff,2,0,36,34
1656140237204,MATH 20C,A01,083760,Briones; Jor-el Thomas Caparas,0,0,35,35
1656140237204,MATH 20C,A02,083761,Briones; Jor-el Thomas Caparas,9,1,35,26
1656140237204,MATH 20C,A03,093476,Staff,0,0,35,35
1656140237204,MATH 20C,B01,083762,Bach; Quang Tran,1,0,30,29
1656140243236,MATH 20D,A01,083765,Tran; Brian Kha,2,0,30,28
1656140243236,MATH 20D,A02,083766,Tran; Brian Kha,0,1,30,30
1656140243236,MATH 20D,A03,083767,Tran; Brian Kha,2,0,30,28
1656140249265,MATH 20E,A01,083771,Ganguly; Soumya,4,0,32,28
1656140249265,MATH 20E,A02,083772,Ganguly; Soumya,0,0,32,32
1656140249265,MATH 20E,B01,083773,Ciotti; Benjamin,15,0,35,20
1656140249265,MATH 20E,B02,083774,Ciotti; Benjamin,14,0,35,21
1656140255289,MATH 103A,A01,083777,Greenfeld; Be'Eri,1,0,36,35
1656140255289,MATH 103A,A02,083778,Greenfeld; Be'Eri,1,0,36,35
1656140255289,MATH 103A,A03,093561,Staff,4,0,36,32
1656140255289,MATH 103A,B01,083779,Greenfeld; Be'Eri,8,1,36,28
1656140255289,MATH 103A,B02,083780,Greenfeld; Be'Eri,1,0,36,35
1656140255289,MATH 103A,B03,093562,Staff,0,0,36,36
1656140261313,MATH 105,A01,085443,Carter; Anne Toulson,4,1,35,31
1656140261313,MATH 105,A02,093477,Staff,11,0,35,24
1656140267336,MATH 109,A01,083213,Ganzberger; Geoffrey Michael,0,0,34,34
1656140267336,MATH 109,A02,083214,Ganzberger; Geoffrey Michael,0,0,34,34
1656140267336,MATH 109,A03,093478,Staff,1,0,34,33
1656140267336,MATH 109,B01,083215,Ganzberger; Geoffrey Michael,4,0,32,28
1656140267336,MATH 109,B02,083216,Ganzberger; Geoffrey Michael,1,0,32,31
1656140267336,MATH 109,B03,093479,Staff,4,0,32,28
1656140273361,MATH 142A,A01,083219,Chow; Bennett,1,0,32,31
1656140273361,MATH 142A,A02,083220,Chow; Bennett,8,0,32,24
1656140273361,MATH 142A,A03,093480,Staff,5,0,32,27
1656140273361,MATH 142A,B03,093481,Staff,4,0,32,28
1656140273361,MATH 142A,B04,093558,Staff,6,0,32,26
1656140273361,MATH 142A,B05,093559,Staff,0,0,32,32
1656140279384,MATH 193A,A01,083224,Rotar; Vladimir,0,1,34,34
1656140279384,MATH 193A,A02,083225,Rotar; Vladimir,0,0,34,34
1656140279384,MATH 193A,A03,083781,Rotar; Vladimir,0,0,34,34
1656140279384,MATH 193A,A04,083782,Rotar; Vladimir,6,0,34,28
1656140279384,MATH 193A,A05,093482,Rotar; Vladimir,1,0,34,33
1656140285409,MATH 197,001,091859,McAuley; Julian John,9999,0,9999,0
1656140285409,MATH 197,002,095566,Kedlaya; Kiran S.,9997,0,9999,2
1656140285409,MATH 197,003,095567,Xiao; Ming,9999,0,9999,0
1656140285409,MATH 197,004,095571,Perols; Johan Lars,9998,0,9999,1
1656140292472,COGS 9,A01,083615,Shannon; Kyle Michael,4,0,75,71
1656140298495,COGS 11,A01,083617,Boyle; Mary E. T.,15,0,48,33
1656140304520,COGS 13,A01,083071,Bastos; Amalia Pinkusfeld,6,0,71,65
1656140310548,COGS 14A,A01,092681,Semenuks; Arturs,4,15,100,96
1656140316571,COGS 14B,A01,083073,Cheng; Tzu-Han,7,0,63,56
1656140322594,COGS 17,A01,092677,Semenuks; Arturs,8,0,81,73
1656140328617,COGS 100,A01,083619,Allen; Michael Gordon,3,0,70,67
1656140334641,COGS 101A,A01,083621,Davis; Joshua Daniel,3,0,68,65
1656140340668,COGS 101B,A01,091572,Allen; Michael Gordon,6,0,65,59
1656140346699,COGS 101C,A01,083625,Delgado; Tania,10,0,35,25
1656140352724,COGS 107A,A01,083627,Boyle; Mary E. T.,1,0,60,59
1656140358751,COGS 118A,A01,083075,Gupta; Anjum,7,0,76,69
1656140364782,CSE 3,A50,083646,Miranda; Gregory Joseph,18,0,50,32
1656140370811,CSE 8A,A50,083650,Miranda; Gregory Joseph,2,3,56,54
1656140376835,CSE 11,A01,083080,Cao; Yingjun,1,53,40,39
1656140382861,CSE 12,A01,083652,Krause-Levy; Sophia Louisa,7,2,120,113
1656140388884,CSE 15L,A01,083654,Morris; Justin Loren,2,0,50,48
1656140388884,CSE 15L,A02,083655,Morris; Justin Loren,4,0,50,46
1656140394923,CSE 20,A01,083657,Tran; Khoa Dang,31,0,80,49
1656140400947,CSE 21,A01,095574,Bach; Quang Tran,25,0,48,23
1656140406971,CSE 30,A01,083084,Eldon; John,2,8,80,78
1656140406971,CSE 30,B01,095061,Bhaskar; Nishant,1,2,50,49
1656140412998,CSE 100,A01,083659,Cao; Yingjun,2,20,70,68
1656140419023,CSE 134B,A01,083661,Powell; Thomas Allan,3,0,100,97
1656140425058,CSE 140,A01,083663,Gungor; Onat,9,0,85,76
1656140431157,CSE 140L,A01,083088,Eldon; John,8,0,100,92
1656140437181,CSE 175,A01,083665,Kumar; Rakesh,0,0,25,25
1656140443206,CSE 190,A00,092507,Dubnov; Shlomo,2,0,20,18
1656140449241,ECE 45,A01,083139,Congero; Spencer William,1,0,75,74
1656140455263,ECE 65,A50,083695,Saad; Andrew S,8,0,30,22
1656140455263,ECE 65,A51,095125,Staff,23,0,26,3
1656140461288,ECE 109,A01,091882,Touri; Behrouz,0,1,70,70
1656140467312,ECE 180,A00,083140,Abi Samra; Nicholas Camill,1,0,30,29
1656140467312,ECE 180,B00,083141,Abi Samra; Nicholas Camill,0,4,30,30
1656140473343,MATH 10A,A01,083735,Patchell; Gregory David,0,0,30,30
1656140473343,MATH 10A,A02,083736,Patchell; Gregory David,22,0,30,8
1656140473343,MATH 10A,A03,083737,Patchell; Gregory David,16,0,30,14
1656140479374,MATH 10B,A01,083207,Lim; Seonhee,0,0,34,34
1656140479374,MATH 10B,A02,083208,Lim; Seonhee,7,0,35,28
1656140479374,MATH 10B,A03,093472,Staff,1,0,34,33
1656140479374,MATH 10B,B01,083739,Sinha; Shubham,11,0,30,19
1656140485402,MATH 18,A01,083743,Cinel; Cameron Alexander,7,0,30,23
1656140485402,MATH 18,A02,083744,Cinel; Cameron Alexander,10,0,30,20
1656140485402,MATH 18,A03,083745,Cinel; Cameron Alexander,4,0,30,26
1656140485402,MATH 18,B01,083748,Rideout; David Porter,0,0,36,36
1656140485402,MATH 18,B02,083749,Rideout; David Porter,0,0,36,36
1656140485402,MATH 18,B03,083750,Rideout; David Porter,0,0,36,36
1656140485402,MATH 18,B04,083751,Rideout; David Porter,0,0,36,36
1656140485402,MATH 18,B05,093473,Rideout; David Porter,1,0,36,35
1656140485402,MATH 18,B06,093474,Rideout; David Porter,4,0,36,32
1656140491433,MATH 20A,A01,083754,Zheng; Zequn,11,0,40,29
1656140497455,MATH 20B,A01,083756,Briones; Jor-el Thomas Caparas,0,0,36,36
1656140497455,MATH 20B,A02,083757,Briones; Jor-el Thomas Caparas,0,0,36,36
1656140497455,MATH 20B,A03,093475,Staff,2,0,36,34
1656140503492,MATH 20C,A01,083760,Briones; Jor-el Thomas Caparas,0,0,35,35
1656140503492,MATH 20C,A02,083761,Briones; Jor-el Thomas Caparas,9,1,35,26
1656140503492,MATH 20C,A03,093476,Staff,0,0,35,35
1656140503492,MATH 20C,B01,083762,Bach; Quang Tran,1,0,30,29
1656140509526,MATH 20D,A01,083765,Tran; Brian Kha,2,0,30,28
1656140509526,MATH 20D,A02,083766,Tran; Brian Kha,0,1,30,30
1656140509526,MATH 20D,A03,083767,Tran; Brian Kha,2,0,30,28
1656140515550,MATH 20E,A01,083771,Ganguly; Soumya,4,0,32,28
1656140515550,MATH 20E,A02,083772,Ganguly; Soumya,0,0,32,32
1656140515550,MATH 20E,B01,083773,Ciotti; Benjamin,15,0,35,20
1656140515550,MATH 20E,B02,083774,Ciotti; Benjamin,14,0,35,21
1656140521583,MATH 103A,A01,083777,Greenfeld; Be'Eri,1,0,36,35
1656140521583,MATH 103A,A02,083778,Greenfeld; Be'Eri,1,0,36,35
1656140521583,MATH 103A,A03,093561,Staff,4,0,36,32
1656140521583,MATH 103A,B01,083779,Greenfeld; Be'Eri,8,1,36,28
1656140521583,MATH 103A,B02,083780,Greenfeld; Be'Eri,1,0,36,35
1656140521583,MATH 103A,B03,093562,Staff,0,0,36,36
1656140527614,MATH 105,A01,085443,Carter; Anne Toulson,4,1,35,31
1656140527614,MATH 105,A02,093477,Staff,11,0,35,24
1656140533647,MATH 109,A01,083213,Ganzberger; Geoffrey Michael,0,0,34,34
1656140533647,MATH 109,A02,083214,Ganzberger; Geoffrey Michael,0,0,34,34
1656140533647,MATH 109,A03,093478,Staff,1,0,34,33
1656140533647,MATH 109,B01,083215,Ganzberger; Geoffrey Michael,4,0,32,28
1656140533647,MATH 109,B02,083216,Ganzberger; Geoffrey Michael,1,0,32,31
1656140533647,MATH 109,B03,093479,Staff,4,0,32,28
1656140539671,MATH 142A,A01,083219,Chow; Bennett,1,0,32,31
1656140539671,MATH 142A,A02,083220,Chow; Bennett,8,0,32,24
1656140539671,MATH 142A,A03,093480,Staff,5,0,32,27
1656140539671,MATH 142A,B03,093481,Staff,4,0,32,28
1656140539671,MATH 142A,B04,093558,Staff,6,0,32,26
1656140539671,MATH 142A,B05,093559,Staff,0,0,32,32
1656140545695,MATH 193A,A01,083224,Rotar; Vladimir,0,1,34,34
1656140545695,MATH 193A,A02,083225,Rotar; Vladimir,0,0,34,34
1656140545695,MATH 193A,A03,083781,Rotar; Vladimir,0,0,34,34
1656140545695,MATH 193A,A04,083782,Rotar; Vladimir,6,0,34,28
1656140545695,MATH 193A,A05,093482,Rotar; Vladimir,1,0,34,33
1656140551736,MATH 197,001,091859,McAuley; Julian John,9999,0,9999,0
1656140551736,MATH 197,002,095566,Kedlaya; Kiran S.,9997,0,9999,2
1656140551736,MATH 197,003,095567,Xiao; Ming,9999,0,9999,0
1656140551736,MATH 197,004,095571,Perols; Johan Lars,9998,0,9999,1
1656140558812,COGS 9,A01,083615,Shannon; Kyle Michael,4,0,75,71
1656140564835,COGS 11,A01,083617,Boyle; Mary E. T.,15,0,48,33
1656140570866,COGS 13,A01,083071,Bastos; Amalia Pinkusfeld,6,0,71,65
1656140576896,COGS 14A,A01,092681,Semenuks; Arturs,4,15,100,96
1656140582919,COGS 14B,A01,083073,Cheng; Tzu-Han,7,0,63,56
1656140588942,COGS 17,A01,092677,Semenuks; Arturs,8,0,81,73
1656140594980,COGS 100,A01,083619,Allen; Michael Gordon,3,0,70,67
1656140601010,COGS 101A,A01,083621,Davis; Joshua Daniel,3,0,68,65
1656140607034,COGS 101B,A01,091572,Allen; Michael Gordon,6,0,65,59
1656140613061,COGS 101C,A01,083625,Delgado; Tania,10,0,35,25
1656140619092,COGS 107A,A01,083627,Boyle; Mary E. T.,1,0,60,59
1656140625117,COGS 118A,A01,083075,Gupta; Anjum,7,0,76,69
1656140631143,CSE 3,A50,083646,Miranda; Gregory Joseph,18,0,50,32
1656140637168,CSE 8A,A50,083650,Miranda; Gregory Joseph,2,3,56,54
1656140643193,CSE 11,A01,083080,Cao; Yingjun,1,54,40,39
1656140649219,CSE 12,A01,083652,Krause-Levy; Sophia Louisa,7,2,120,113
1656140655249,CSE 15L,A01,083654,Morris; Justin Loren,2,0,50,48
1656140655249,CSE 15L,A02,083655,Morris; Justin Loren,4,0,50,46
1656140661282,CSE 20,A01,083657,Tran; Khoa Dang,31,0,80,49
1656140667305,CSE 21,A01,095574,Bach; Quang Tran,25,0,48,23
1656140673334,CSE 30,A01,083084,Eldon; John,2,8,80,78
1656140673334,CSE 30,B01,095061,Bhaskar; Nishant,1,2,50,49
1656140679362,CSE 100,A01,083659,Cao; Yingjun,2,20,70,68
1656140685387,CSE 134B,A01,083661,Powell; Thomas Allan,3,0,100,97
1656140691411,CSE 140,A01,083663,Gungor; Onat,9,0,85,76
1656140697440,CSE 140L,A01,083088,Eldon; John,8,0,100,92
1656140703468,CSE 175,A01,083665,Kumar; Rakesh,0,0,25,25
1656140709503,CSE 190,A00,092507,Dubnov; Shlomo,2,0,20,18
1656140715527,ECE 45,A01,083139,Congero; Spencer William,1,0,75,74
1656140721557,ECE 65,A50,083695,Saad; Andrew S,8,0,30,22
1656140721557,ECE 65,A51,095125,Staff,23,0,26,3
1656140727581,ECE 109,A01,091882,Touri; Behrouz,0,1,70,70
1656140733605,ECE 180,A00,083140,Abi Samra; Nicholas Camill,1,0,30,29
1656140733605,ECE 180,B00,083141,Abi Samra; Nicholas Camill,0,4,30,30
1656140739630,MATH 10A,A01,083735,Patchell; Gregory David,0,0,30,30
1656140739630,MATH 10A,A02,083736,Patchell; Gregory David,22,0,30,8
1656140739630,MATH 10A,A03,083737,Patchell; Gregory David,16,0,30,14
1656140745658,MATH 10B,A01,083207,Lim; Seonhee,0,0,34,34
1656140745658,MATH 10B,A02,083208,Lim; Seonhee,7,0,35,28
1656140745658,MATH 10B,A03,093472,Staff,1,0,34,33
1656140745658,MATH 10B,B01,083739,Sinha; Shubham,11,0,30,19
1656140751688,MATH 18,A01,083743,Cinel; Cameron Alexander,7,0,30,23
1656140751688,MATH 18,A02,083744,Cinel; Cameron Alexander,10,0,30,20
1656140751688,MATH 18,A03,083745,Cinel; Cameron Alexander,4,0,30,26
1656140751688,MATH 18,B01,083748,Rideout; David Porter,0,0,36,36
1656140751688,MATH 18,B02,083749,Rideout; David Porter,0,0,36,36
1656140751688,MATH 18,B03,083750,Rideout; David Porter,0,0,36,36
1656140751688,MATH 18,B04,083751,Rideout; David Porter,0,0,36,36
1656140751688,MATH 18,B05,093473,Rideout; David Porter,1,0,36,35
1656140751688,MATH 18,B06,093474,Rideout; David Porter,4,0,36,32
1656140757712,MATH 20A,A01,083754,Zheng; Zequn,11,0,40,29
1656140763746,MATH 20B,A01,083756,Briones; Jor-el Thomas Caparas,0,0,36,36
1656140763746,MATH 20B,A02,083757,Briones; Jor-el Thomas Caparas,0,0,36,36
1656140763746,MATH 20B,A03,093475,Staff,2,0,36,34
1656140769778,MATH 20C,A01,083760,Briones; Jor-el Thomas Caparas,0,0,35,35
1656140769778,MATH 20C,A02,083761,Briones; Jor-el Thomas Caparas,9,1,35,26
1656140769778,MATH 20C,A03,093476,Staff,0,0,35,35
1656140769778,MATH 20C,B01,083762,Bach; Quang Tran,1,0,30,29
1656140775803,MATH 20D,A01,083765,Tran; Brian Kha,2,0,30,28
1656140775803,MATH 20D,A02,083766,Tran; Brian Kha,0,1,30,30
1656140775803,MATH 20D,A03,083767,Tran; Brian Kha,2,0,30,28
1656140781838,MATH 20E,A01,083771,Ganguly; Soumya,4,0,32,28
1656140781838,MATH 20E,A02,083772,Ganguly; Soumya,0,0,32,32
1656140781838,MATH 20E,B01,083773,Ciotti; Benjamin,15,0,35,20
1656140781838,MATH 20E,B02,083774,Ciotti; Benjamin,14,0,35,21
1656140787872,MATH 103A,A01,083777,Greenfeld; Be'Eri,1,0,36,35
1656140787872,MATH 103A,A02,083778,Greenfeld; Be'Eri,1,0,36,35
1656140787872,MATH 103A,A03,093561,Staff,4,0,36,32
1656140787872,MATH 103A,B01,083779,Greenfeld; Be'Eri,8,1,36,28
1656140787872,MATH 103A,B02,083780,Greenfeld; Be'Eri,1,0,36,35
1656140787872,MATH 103A,B03,093562,Staff,0,0,36,36
1656140793902,MATH 105,A01,085443,Carter; Anne Toulson,4,1,35,31
1656140793902,MATH 105,A02,093477,Staff,11,0,35,24
1656140799933,MATH 109,A01,083213,Ganzberger; Geoffrey Michael,0,0,34,34
1656140799933,MATH 109,A02,083214,Ganzberger; Geoffrey Michael,0,0,34,34
1656140799933,MATH 109,A03,093478,Staff,1,0,34,33
1656140799933,MATH 109,B01,083215,Ganzberger; Geoffrey Michael,4,0,32,28
1656140799933,MATH 109,B02,083216,Ganzberger; Geoffrey Michael,1,0,32,31
1656140799933,MATH 109,B03,093479,Staff,4,0,32,28
1656140805960,MATH 142A,A01,083219,Chow; Bennett,1,0,32,31
1656140805960,MATH 142A,A02,083220,Chow; Bennett,8,0,32,24
1656140805960,MATH 142A,A03,093480,Staff,5,0,32,27
1656140805960,MATH 142A,B03,093481,Staff,4,0,32,28
1656140805960,MATH 142A,B04,093558,Staff,6,0,32,26
1656140805960,MATH 142A,B05,093559,Staff,0,0,32,32
1656140811985,MATH 193A,A01,083224,Rotar; Vladimir,0,1,34,34
1656140811985,MATH 193A,A02,083225,Rotar; Vladimir,0,0,34,34
1656140811985,MATH 193A,A03,083781,Rotar; Vladimir,0,0,34,34
1656140811985,MATH 193A,A04,083782,Rotar; Vladimir,6,0,34,28
1656140811985,MATH 193A,A05,093482,Rotar; Vladimir,1,0,34,33
1656140818008,MATH 197,001,091859,McAuley; Julian John,9999,0,9999,0
1656140818008,MATH 197,002,095566,Kedlaya; Kiran S.,9997,0,9999,2
1656140818008,MATH 197,003,095567,Xiao; Ming,9999,0,9999,0
1656140818008,MATH 197,004,095571,Perols; Johan Lars,9998,0,9999,1
1656140825062,COGS 9,A01,083615,Shannon; Kyle Michael,4,0,75,71
1656140831088,COGS 11,A01,083617,Boyle; Mary E. T.,15,0,48,33
1656140837113,COGS 13,A01,083071,Bastos; Amalia Pinkusfeld,6,0,71,65
1656140843138,COGS 14A,A01,092681,Semenuks; Arturs,4,15,100,96
1656140849165,COGS 14B,A01,083073,Cheng; Tzu-Han,7,0,63,56
1656140855194,COGS 17,A01,092677,Semenuks; Arturs,8,0,81,73
1656140861219,COGS 100,A01,083619,Allen; Michael Gordon,3,0,70,67
1656140867249,COGS 101A,A01,083621,Davis; Joshua Daniel,3,0,68,65
1656140873273,COGS 101B,A01,091572,Allen; Michael Gordon,6,0,65,59
1656140879296,COGS 101C,A01,083625,Delgado; Tania,10,0,35,25
1656140885322,COGS 107A,A01,083627,Boyle; Mary E. T.,1,0,60,59
1656140891352,COGS 118A,A01,083075,Gupta; Anjum,7,0,76,69
1656140897385,CSE 3,A50,083646,Miranda; Gregory Joseph,18,0,50,32
1656140903418,CSE 8A,A50,083650,Miranda; Gregory Joseph,2,3,56,54
1656140909447,CSE 11,A01,083080,Cao; Yingjun,1,54,40,39
1656140915472,CSE 12,A01,083652,Krause-Levy; Sophia Louisa,7,2,120,113
1656140921498,CSE 15L,A01,083654,Morris; Justin Loren,2,0,50,48
1656140921498,CSE 15L,A02,083655,Morris; Justin Loren,4,0,50,46
1656140927520,CSE 20,A01,083657,Tran; Khoa Dang,31,0,80,49
1656140933544,CSE 21,A01,095574,Bach; Quang Tran,25,0,48,23
1656140939572,CSE 30,A01,083084,Eldon; John,2,8,80,78
1656140939572,CSE 30,B01,095061,Bhaskar; Nishant,1,2,50,49
1656140945596,CSE 100,A01,083659,Cao; Yingjun,2,20,70,68
1656140951625,CSE 134B,A01,083661,Powell; Thomas Allan,3,0,100,97
1656140957649,CSE 140,A01,083663,Gungor; Onat,9,0,85,76
1656140963677,CSE 140L,A01,083088,Eldon; John,8,0,100,92
1656140969700,CSE 175,A01,083665,Kumar; Rakesh,0,0,25,25
1656140975729,CSE 190,A00,092507,Dubnov; Shlomo,2,0,20,18
1656140981754,ECE 45,A01,083139,Congero; Spencer William,1,0,75,74
1656140987784,ECE 65,A50,083695,Saad; Andrew S,8,0,30,22
1656140987784,ECE 65,A51,095125,Staff,23,0,26,3
1656140993807,ECE 109,A01,091882,Touri; Behrouz,0,1,70,70
1656140999836,ECE 180,A00,083140,Abi Samra; Nicholas Camill,1,0,30,29
1656140999836,ECE 180,B00,083141,Abi Samra; Nicholas Camill,0,4,30,30
1656141005860,MATH 10A,A01,083735,Patchell; Gregory David,0,0,30,30
1656141005860,MATH 10A,A02,083736,Patchell; Gregory David,22,0,30,8
1656141005860,MATH 10A,A03,083737,Patchell; Gregory David,16,0,30,14
1656141011892,MATH 10B,A01,083207,Lim; Seonhee,0,0,34,34
1656141011892,MATH 10B,A02,083208,Lim; Seonhee,7,0,35,28
1656141011892,MATH 10B,A03,093472,Staff,1,0,34,33
1656141011892,MATH 10B,B01,083739,Sinha; Shubham,11,0,30,19
1656141017918,MATH 18,A01,083743,Cinel; Cameron Alexander,7,0,30,23
1656141017918,MATH 18,A02,083744,Cinel; Cameron Alexander,10,0,30,20
1656141017918,MATH 18,A03,083745,Cinel; Cameron Alexander,4,0,30,26
1656141017918,MATH 18,B01,083748,Rideout; David Porter,0,0,36,36
1656141017918,MATH 18,B02,083749,Rideout; David Porter,0,0,36,36
1656141017918,MATH 18,B03,083750,Rideout; David Porter,0,0,36,36
1656141017918,MATH 18,B04,083751,Rideout; David Porter,0,0,36,36
1656141017918,MATH 18,B05,093473,Rideout; David Porter,1,0,36,35
1656141017918,MATH 18,B06,093474,Rideout; David Porter,4,0,36,32
1656141023946,MATH 20A,A01,083754,Zheng; Zequn,11,0,40,29
1656141030058,MATH 20B,A01,083756,Briones; Jor-el Thomas Caparas,0,0,36,36
1656141030058,MATH 20B,A02,083757,Briones; Jor-el Thomas Caparas,0,0,36,36
1656141030058,MATH 20B,A03,093475,Staff,2,0,36,34
1656141036086,MATH 20C,A01,083760,Briones; Jor-el Thomas Caparas,0,0,35,35
1656141036086,MATH 20C,A02,083761,Briones; Jor-el Thomas Caparas,9,1,35,26
1656141036086,MATH 20C,A03,093476,Staff,0,0,35,35
1656141036086,MATH 20C,B01,083762,Bach; Quang Tran,1,0,30,29
1656141042111,MATH 20D,A01,083765,Tran; Brian Kha,2,0,30,28
1656141042111,MATH 20D,A02,083766,Tran; Brian Kha,0,1,30,30
1656141042111,MATH 20D,A03,083767,Tran; Brian Kha,2,0,30,28
1656141048136,MATH 20E,A01,083771,Ganguly; Soumya,4,0,32,28
1656141048136,MATH 20E,A02,083772,Ganguly; Soumya,0,0,32,32
1656141048136,MATH 20E,B01,083773,Ciotti; Benjamin,15,0,35,20
1656141048136,MATH 20E,B02,083774,Ciotti; Benjamin,14,0,35,21
1656141054162,MATH 103A,A01,083777,Greenfeld; Be'Eri,1,0,36,35
1656141054162,MATH 103A,A02,083778,Greenfeld; Be'Eri,1,0,36,35
1656141054162,MATH 103A,A03,093561,Staff,4,0,36,32
1656141054162,MATH 103A,B01,083779,Greenfeld; Be'Eri,8,1,36,28
1656141054162,MATH 103A,B02,083780,Greenfeld; Be'Eri,1,0,36,35
1656141054162,MATH 103A,B03,093562,Staff,0,0,36,36
1656141060191,MATH 105,A01,085443,Carter; Anne Toulson,4,1,35,31
1656141060191,MATH 105,A02,093477,Staff,11,0,35,24
1656141066240,MATH 109,A01,083213,Ganzberger; Geoffrey Michael,0,0,34,34
1656141066240,MATH 109,A02,083214,Ganzberger; Geoffrey Michael,0,0,34,34
1656141066240,MATH 109,A03,093478,Staff,1,0,34,33
1656141066240,MATH 109,B01,083215,Ganzberger; Geoffrey Michael,4,0,32,28
1656141066240,MATH 109,B02,083216,Ganzberger; Geoffrey Michael,1,0,32,31
1656141066240,MATH 109,B03,093479,Staff,4,0,32,28
1656141072288,MATH 142A,A01,083219,Chow; Bennett,1,0,32,31
1656141072288,MATH 142A,A02,083220,Chow; Bennett,8,0,32,24
1656141072288,MATH 142A,A03,093480,Staff,5,0,32,27
1656141072288,MATH 142A,B03,093481,Staff,4,0,32,28
1656141072288,MATH 142A,B04,093558,Staff,6,0,32,26
1656141072288,MATH 142A,B05,093559,Staff,0,0,32,32
1656141078327,MATH 193A,A01,083224,Rotar; Vladimir,0,1,34,34
1656141078327,MATH 193A,A02,083225,Rotar; Vladimir,0,0,34,34
1656141078327,MATH 193A,A03,083781,Rotar; Vladimir,0,0,34,34
1656141078327,MATH 193A,A04,083782,Rotar; Vladimir,6,0,34,28
1656141078327,MATH 193A,A05,093482,Rotar; Vladimir,1,0,34,33
1656141084363,MATH 197,001,091859,McAuley; Julian John,9999,0,9999,0
1656141084363,MATH 197,002,095566,Kedlaya; Kiran S.,9997,0,9999,2
1656141084363,MATH 197,003,095567,Xiao; Ming,9999,0,9999,0
1656141084363,MATH 197,004,095571,Perols; Johan Lars,9998,0,9999,1
1656141091627,COGS 9,A01,083615,Shannon; Kyle Michael,4,0,75,71
1656141097655,COGS 11,A01,083617,Boyle; Mary E. T.,15,0,48,33
1656141103730,COGS 13,A01,083071,Bastos; Amalia Pinkusfeld,6,0,71,65
1656141109755,COGS 14A,A01,092681,Semenuks; Arturs,4,15,100,96
1656141115781,COGS 14B,A01,083073,Cheng; Tzu-Han,7,0,63,56
1656141121860,COGS 17,A01,092677,Semenuks; Arturs,8,0,81,73
1656141127904,COGS 100,A01,083619,Allen; Michael Gordon,3,0,70,67
1656141133977,COGS 101A,A01,083621,Davis; Joshua Daniel,3,0,68,65
1656141140003,COGS 101B,A01,091572,Allen; Michael Gordon,6,0,65,59
1656141146028,COGS 101C,A01,083625,Delgado; Tania,10,0,35,25
1656141152052,COGS 107A,A01,083627,Boyle; Mary E. T.,1,0,60,59
1656141158106,COGS 118A,A01,083075,Gupta; Anjum,7,0,76,69
1656141164131,CSE 3,A50,083646,Miranda; Gregory Joseph,18,0,50,32
1656141170167,CSE 8A,A50,083650,Miranda; Gregory Joseph,2,3,56,54
1656141176201,CSE 11,A01,083080,Cao; Yingjun,1,54,40,39
1656141182255,CSE 12,A01,083652,Krause-Levy; Sophia Louisa,7,2,120,113
1656141188287,CSE 15L,A01,083654,Morris; Justin Loren,2,0,50,48
1656141188287,CSE 15L,A02,083655,Morris; Justin Loren,4,0,50,46
1656141194312,CSE 20,A01,083657,Tran; Khoa Dang,31,0,80,49
1656141200337,CSE 21,A01,095574,Bach; Quang Tran,25,0,48,23
1656141206361,CSE 30,A01,083084,Eldon; John,2,8,80,78
1656141206361,CSE 30,B01,095061,Bhaskar; Nishant,1,2,50,49
1656141212384,CSE 100,A01,083659,Cao; Yingjun,2,20,70,68
1656141218415,CSE 134B,A01,083661,Powell; Thomas Allan,3,0,100,97
1656141224440,CSE 140,A01,083663,Gungor; Onat,9,0,85,76
1656141230465,CSE 140L,A01,083088,Eldon; John,8,0,100,92
1656141236489,CSE 175,A01,083665,Kumar; Rakesh,0,0,25,25
1656141242512,CSE 190,A00,092507,Dubnov; Shlomo,2,0,20,18
1656141248541,ECE 45,A01,083139,Congero; Spencer William,1,0,75,74
1656141254568,ECE 65,A50,083695,Saad; Andrew S,8,0,30,22
1656141254568,ECE 65,A51,095125,Staff,23,0,26,3
1656141260592,ECE 109,A01,091882,Touri; Behrouz,0,1,70,70
1656141266617,ECE 180,A00,083140,Abi Samra; Nicholas Camill,1,0,30,29
1656141266617,ECE 180,B00,083141,Abi Samra; Nicholas Camill,0,4,30,30
1656141272647,MATH 10A,A01,083735,Patchell; Gregory David,0,0,30,30
1656141272647,MATH 10A,A02,083736,Patchell; Gregory David,22,0,30,8
1656141272647,MATH 10A,A03,083737,Patchell; Gregory David,16,0,30,14
1656141278672,MATH 10B,A01,083207,Lim; Seonhee,0,0,34,34
1656141278672,MATH 10B,A02,083208,Lim; Seonhee,7,0,35,28
1656141278672,MATH 10B,A03,093472,Staff,1,0,34,33
1656141278672,MATH 10B,B01,083739,Sinha; Shubham,11,0,30,19
1656141284699,MATH 18,A01,083743,Cinel; Cameron Alexander,7,0,30,23
1656141284699,MATH 18,A02,083744,Cinel; Cameron Alexander,10,0,30,20
1656141284699,MATH 18,A03,083745,Cinel; Cameron Alexander,4,0,30,26
1656141284699,MATH 18,B01,083748,Rideout; David Porter,0,0,36,36
1656141284699,MATH 18,B02,083749,Rideout; David Porter,0,0,36,36
1656141284699,MATH 18,B03,083750,Rideout; David Porter,0,0,36,36
1656141284699,MATH 18,B04,083751,Rideout; David Porter,0,0,36,36
1656141284699,MATH 18,B05,093473,Rideout; David Porter,1,0,36,35
1656141284699,MATH 18,B06,093474,Rideout; David Porter,4,0,36,32
1656141290725,MATH 20A,A01,083754,Zheng; Zequn,11,0,40,29
1656141296750,MATH 20B,A01,083756,Briones; Jor-el Thomas Caparas,0,0,36,36
1656141296750,MATH 20B,A02,083757,Briones; Jor-el Thomas Caparas,0,0,36,36
1656141296750,MATH 20B,A03,093475,Staff,2,0,36,34
1656141302776,MATH 20C,A01,083760,Briones; Jor-el Thomas Caparas,0,0,35,35
1656141302776,MATH 20C,A02,083761,Briones; Jor-el Thomas Caparas,9,1,35,26
1656141302776,MATH 20C,A03,093476,Staff,0,0,35,35
1656141302776,MATH 20C,B01,083762,Bach; Quang Tran,1,0,30,29
1656141308811,MATH 20D,A01,083765,Tran; Brian Kha,2,0,30,28
1656141308811,MATH 20D,A02,083766,Tran; Brian Kha,0,1,30,30
1656141308811,MATH 20D,A03,083767,Tran; Brian Kha,2,0,30,28
1656141314843,MATH 20E,A01,083771,Ganguly; Soumya,4,0,32,28
1656141314843,MATH 20E,A02,083772,Ganguly; Soumya,0,0,32,32
1656141314843,MATH 20E,B01,083773,Ciotti; Benjamin,15,0,35,20
1656141314843,MATH 20E,B02,083774,Ciotti; Benjamin,14,0,35,21
1656141320877,MATH 103A,A01,083777,Greenfeld; Be'Eri,1,0,36,35
1656141320877,MATH 103A,A02,083778,Greenfeld; Be'Eri,1,0,36,35
1656141320877,MATH 103A,A03,093561,Staff,4,0,36,32
1656141320877,MATH 103A,B01,083779,Greenfeld; Be'Eri,8,1,36,28
1656141320877,MATH 103A,B02,083780,Greenfeld; Be'Eri,1,0,36,35
1656141320877,MATH 103A,B03,093562,Staff,0,0,36,36
1656141326913,MATH 105,A01,085443,Carter; Anne Toulson,4,1,35,31
1656141326913,MATH 105,A02,093477,Staff,11,0,35,24
1656141332947,MATH 109,A01,083213,Ganzberger; Geoffrey Michael,0,0,34,34
1656141332947,MATH 109,A02,083214,Ganzberger; Geoffrey Michael,0,0,34,34
1656141332947,MATH 109,A03,093478,Staff,1,0,34,33
1656141332947,MATH 109,B01,083215,Ganzberger; Geoffrey Michael,4,0,32,28
1656141332947,MATH 109,B02,083216,Ganzberger; Geoffrey Michael,1,0,32,31
1656141332947,MATH 109,B03,093479,Staff,4,0,32,28
1656141338990,MATH 142A,A01,083219,Chow; Bennett,1,0,32,31
1656141338990,MATH 142A,A02,083220,Chow; Bennett,8,0,32,24
1656141338990,MATH 142A,A03,093480,Staff,5,0,32,27
1656141338990,MATH 142A,B03,093481,Staff,4,0,32,28
1656141338990,MATH 142A,B04,093558,Staff,6,0,32,26
1656141338990,MATH 142A,B05,093559,Staff,0,0,32,32
1656141345020,MATH 193A,A01,083224,Rotar; Vladimir,0,1,34,34
1656141345020,MATH 193A,A02,083225,Rotar; Vladimir,0,0,34,34
1656141345020,MATH 193A,A03,083781,Rotar; Vladimir,0,0,34,34
1656141345020,MATH 193A,A04,083782,Rotar; Vladimir,6,0,34,28
1656141345020,MATH 193A,A05,093482,Rotar; Vladimir,1,0,34,33
1656141351045,MATH 197,001,091859,McAuley; Julian John,9999,0,9999,0
1656141351045,MATH 197,002,095566,Kedlaya; Kiran S.,9997,0,9999,2
1656141351045,MATH 197,003,095567,Xiao; Ming,9999,0,9999,0
1656141351045,MATH 197,004,095571,Perols; Johan Lars,9998,0,9999,1
1656141358107,COGS 9,A01,083615,Shannon; Kyle Michael,4,0,75,71
1656141364149,COGS 11,A01,083617,Boyle; Mary E. T.,15,0,48,33
1656141370174,COGS 13,A01,083071,Bastos; Amalia Pinkusfeld,6,0,71,65
1656141376203,COGS 14A,A01,092681,Semenuks; Arturs,4,15,100,96
1656141382228,COGS 14B,A01,083073,Cheng; Tzu-Han,7,0,63,56
1656141388261,COGS 17,A01,092677,Semenuks; Arturs,8,0,81,73
1656141394285,COGS 100,A01,083619,Allen; Michael Gordon,3,0,70,67
1656141400310,COGS 101A,A01,083621,Davis; Joshua Daniel,3,0,68,65
1656141406346,COGS 101B,A01,091572,Allen; Michael Gordon,6,0,65,59
1656141412371,COGS 101C,A01,083625,Delgado; Tania,10,0,35,25
1656141418396,COGS 107A,A01,083627,Boyle; Mary E. T.,1,0,60,59
1656141424423,COGS 118A,A01,083075,Gupta; Anjum,7,0,76,69
1656141430453,CSE 3,A50,083646,Miranda; Gregory Joseph,18,0,50,32
1656141436482,CSE 8A,A50,083650,Miranda; Gregory Joseph,2,3,56,54
1656141442505,CSE 11,A01,083080,Cao; Yingjun,1,54,40,39
1656141448535,CSE 12,A01,083652,Krause-Levy; Sophia Louisa,7,2,120,113
1656141454562,CSE 15L,A01,083654,Morris; Justin Loren,2,0,50,48
1656141454562,CSE 15L,A02,083655,Morris; Justin Loren,4,0,50,46
1656141460586,CSE 20,A01,083657,Tran; Khoa Dang,31,0,80,49
1656141466614,CSE 21,A01,095574,Bach; Quang Tran,25,0,48,23
1656141472637,CSE 30,A01,083084,Eldon; John,2,8,80,78
1656141472637,CSE 30,B01,095061,Bhaskar; Nishant,1,2,50,49
1656141478661,CSE 100,A01,083659,Cao; Yingjun,2,20,70,68
1656141484692,CSE 134B,A01,083661,Powell; Thomas Allan,3,0,100,97
1656141490716,CSE 140,A01,083663,Gungor; Onat,9,0,85,76
1656141496745,CSE 140L,A01,083088,Eldon; John,8,0,100,92
1656141502773,CSE 175,A01,083665,Kumar; Rakesh,0,0,25,25
1656141508798,CSE 190,A00,092507,Dubnov; Shlomo,2,0,20,18
1656141514826,ECE 45,A01,083139,Congero; Spencer William,1,0,75,74
1656141520851,ECE 65,A50,083695,Saad; Andrew S,8,0,30,22
1656141520851,ECE 65,A51,095125,Staff,23,0,26,3
1656141526881,ECE 109,A01,091882,Touri; Behrouz,0,1,70,70
1656141532907,ECE 180,A00,083140,Abi Samra; Nicholas Camill,1,0,30,29
1656141532907,ECE 180,B00,083141,Abi Samra; Nicholas Camill,0,4,30,30
1656141538940,MATH 10A,A01,083735,Patchell; Gregory David,0,0,30,30
1656141538940,MATH 10A,A02,083736,Patchell; Gregory David,22,0,30,8
1656141538940,MATH 10A,A03,083737,Patchell; Gregory David,16,0,30,14
1656141544965,MATH 10B,A01,083207,Lim; Seonhee,0,0,34,34
1656141544965,MATH 10B,A02,083208,Lim; Seonhee,7,0,35,28
1656141544965,MATH 10B,A03,093472,Staff,1,0,34,33
1656141544965,MATH 10B,B01,083739,Sinha; Shubham,11,0,30,19
1656141550992,MATH 18,A01,083743,Cinel; Cameron Alexander,7,0,30,23
1656141550992,MATH 18,A02,083744,Cinel; Cameron Alexander,10,0,30,20
1656141550992,MATH 18,A03,083745,Cinel; Cameron Alexander,4,0,30,26
1656141550992,MATH 18,B01,083748,Rideout; David Porter,0,0,36,36
1656141550992,MATH 18,B02,083749,Rideout; David Porter,0,0,36,36
1656141550992,MATH 18,B03,083750,Rideout; David Porter,0,0,36,36
1656141550992,MATH 18,B04,083751,Rideout; David Porter,0,0,36,36
1656141550992,MATH 18,B05,093473,Rideout; David Porter,1,0,36,35
1656141550992,MATH 18,B06,093474,Rideout; David Porter,4,0,36,32
1656141557015,MATH 20A,A01,083754,Zheng; Zequn,11,0,40,29
1656141563042,MATH 20B,A01,083756,Briones; Jor-el Thomas Caparas,0,0,36,36
1656141563042,MATH 20B,A02,083757,Briones; Jor-el Thomas Caparas,0,0,36,36
1656141563042,MATH 20B,A03,093475,Staff,2,0,36,34
1656141569071,MATH 20C,A01,083760,Briones; Jor-el Thomas Caparas,0,0,35,35
1656141569071,MATH 20C,A02,083761,Briones; Jor-el Thomas Caparas,9,1,35,26
1656141569071,MATH 20C,A03,093476,Staff,0,0,35,35
1656141569071,MATH 20C,B01,083762,Bach; Quang Tran,1,0,30,29
1656141575103,MATH 20D,A01,083765,Tran; Brian Kha,2,0,30,28
1656141575103,MATH 20D,A02,083766,Tran; Brian Kha,0,1,30,30
1656141575103,MATH 20D,A03,083767,Tran; Brian Kha,2,0,30,28
1656141581143,MATH 20E,A01,083771,Ganguly; Soumya,4,0,32,28
1656141581143,MATH 20E,A02,083772,Ganguly; Soumya,0,0,32,32
1656141581143,MATH 20E,B01,083773,Ciotti; Benjamin,15,0,35,20
1656141581143,MATH 20E,B02,083774,Ciotti; Benjamin,14,0,35,21
1656141587169,MATH 103A,A01,083777,Greenfeld; Be'Eri,1,0,36,35
1656141587169,MATH 103A,A02,083778,Greenfeld; Be'Eri,1,0,36,35
1656141587169,MATH 103A,A03,093561,Staff,4,0,36,32
1656141587169,MATH 103A,B01,083779,Greenfeld; Be'Eri,8,1,36,28
1656141587169,MATH 103A,B02,083780,Greenfeld; Be'Eri,1,0,36,35
1656141587169,MATH 103A,B03,093562,Staff,0,0,36,36
1656141593194,MATH 105,A01,085443,Carter; Anne Toulson,4,1,35,31
1656141593194,MATH 105,A02,093477,Staff,11,0,35,24
1656141599224,MATH 109,A01,083213,Ganzberger; Geoffrey Michael,0,0,34,34
1656141599224,MATH 109,A02,083214,Ganzberger; Geoffrey Michael,0,0,34,34
1656141599224,MATH 109,A03,093478,Staff,1,0,34,33
1656141599224,MATH 109,B01,083215,Ganzberger; Geoffrey Michael,4,0,32,28
1656141599224,MATH 109,B02,083216,Ganzberger; Geoffrey Michael,1,0,32,31
1656141599224,MATH 109,B03,093479,Staff,4,0,32,28
1656141605250,MATH 142A,A01,083219,Chow; Bennett,1,0,32,31
1656141605250,MATH 142A,A02,083220,Chow; Bennett,8,0,32,24
1656141605250,MATH 142A,A03,093480,Staff,5,0,32,27
1656141605250,MATH 142A,B03,093481,Staff,4,0,32,28
1656141605250,MATH 142A,B04,093558,Staff,6,0,32,26
1656141605250,MATH 142A,B05,093559,Staff,0,0,32,32
1656141611284,MATH 193A,A01,083224,Rotar; Vladimir,0,1,34,34
1656141611284,MATH 193A,A02,083225,Rotar; Vladimir,0,0,34,34
1656141611284,MATH 193A,A03,083781,Rotar; Vladimir,0,0,34,34
1656141611284,MATH 193A,A04,083782,Rotar; Vladimir,6,0,34,28
1656141611284,MATH 193A,A05,093482,Rotar; Vladimir,1,0,34,33
1656141617321,MATH 197,001,091859,McAuley; Julian John,9999,0,9999,0
1656141617321,MATH 197,002,095566,Kedlaya; Kiran S.,9997,0,9999,2
1656141617321,MATH 197,003,095567,Xiao; Ming,9999,0,9999,0
1656141617321,MATH 197,004,095571,Perols; Johan Lars,9998,0,9999,1
1656141624492,COGS 9,A01,083615,Shannon; Kyle Michael,4,0,75,71
1656141630517,COGS 11,A01,083617,Boyle; Mary E. T.,15,0,48,33
1656141636543,COGS 13,A01,083071,Bastos; Amalia Pinkusfeld,6,0,71,65
1656141642573,COGS 14A,A01,092681,Semenuks; Arturs,4,15,100,96
1656141648597,COGS 14B,A01,083073,Cheng; Tzu-Han,7,0,63,56
1656141654620,COGS 17,A01,092677,Semenuks; Arturs,8,0,81,73
1656141660644,COGS 100,A01,083619,Allen; Michael Gordon,3,0,70,67
1656141666669,COGS 101A,A01,083621,Davis; Joshua Daniel,3,0,68,65
1656141672694,COGS 101B,A01,091572,Allen; Michael Gordon,6,0,65,59
1656141678723,COGS 101C,A01,083625,Delgado; Tania,10,0,35,25
1656141684747,COGS 107A,A01,083627,Boyle; Mary E. T.,1,0,60,59
1656141690774,COGS 118A,A01,083075,Gupta; Anjum,7,0,76,69
1656141696805,CSE 3,A50,083646,Miranda; Gregory Joseph,18,0,50,32
1656141702830,CSE 8A,A50,083650,Miranda; Gregory Joseph,3,3,56,53
1656141708858,CSE 11,A01,083080,Cao; Yingjun,1,54,40,39
1656141714888,CSE 12,A01,083652,Krause-Levy; Sophia Louisa,7,2,120,113
1656141720916,CSE 15L,A01,083654,Morris; Justin Loren,2,0,50,48
1656141720916,CSE 15L,A02,083655,Morris; Justin Loren,4,0,50,46
1656141726948,CSE 20,A01,083657,Tran; Khoa Dang,31,0,80,49
1656141732979,CSE 21,A01,095574,Bach; Quang Tran,25,0,48,23
1656141739010,CSE 30,A01,083084,Eldon; John,2,8,80,78
1656141739010,CSE 30,B01,095061,Bhaskar; Nishant,1,2,50,49
1656141745035,CSE 100,A01,083659,Cao; Yingjun,2,20,70,68
1656141751065,CSE 134B,A01,083661,Powell; Thomas Allan,3,0,100,97
1656141757090,CSE 140,A01,083663,Gungor; Onat,9,0,85,76
1656141763114,CSE 140L,A01,083088,Eldon; John,8,0,100,92
1656141769141,CSE 175,A01,083665,Kumar; Rakesh,0,0,25,25
1656141775166,CSE 190,A00,092507,Dubnov; Shlomo,2,0,20,18
1656141781191,ECE 45,A01,083139,Congero; Spencer William,1,0,75,74
1656141787218,ECE 65,A50,083695,Saad; Andrew S,8,0,30,22
1656141787218,ECE 65,A51,095125,Staff,23,0,26,3
1656141793248,ECE 109,A01,091882,Touri; Behrouz,0,1,70,70
1656141799273,ECE 180,A00,083140,Abi Samra; Nicholas Camill,1,0,30,29
1656141799273,ECE 180,B00,083141,Abi Samra; Nicholas Camill,0,4,30,30
1656141805301,MATH 10A,A01,083735,Patchell; Gregory David,0,0,30,30
1656141805301,MATH 10A,A02,083736,Patchell; Gregory David,22,0,30,8
1656141805301,MATH 10A,A03,083737,Patchell; Gregory David,16,0,30,14
1656141811338,MATH 10B,A01,083207,Lim; Seonhee,0,0,34,34
1656141811338,MATH 10B,A02,083208,Lim; Seonhee,7,0,35,28
1656141811338,MATH 10B,A03,093472,Staff,1,0,34,33
1656141811338,MATH 10B,B01,083739,Sinha; Shubham,11,0,30,19
1656141817365,MATH 18,A01,083743,Cinel; Cameron Alexander,7,0,30,23
1656141817365,MATH 18,A02,083744,Cinel; Cameron Alexander,10,0,30,20
1656141817365,MATH 18,A03,083745,Cinel; Cameron Alexander,4,0,30,26
1656141817365,MATH 18,B01,083748,Rideout; David Porter,0,0,36,36
1656141817365,MATH 18,B02,083749,Rideout; David Porter,0,0,36,36
1656141817365,MATH 18,B03,083750,Rideout; David Porter,0,0,36,36
1656141817365,MATH 18,B04,083751,Rideout; David Porter,0,0,36,36
1656141817365,MATH 18,B05,093473,Rideout; David Porter,1,0,36,35
1656141817365,MATH 18,B06,093474,Rideout; David Porter,4,0,36,32
1656141823388,MATH 20A,A01,083754,Zheng; Zequn,11,0,40,29
1656141829415,MATH 20B,A01,083756,Briones; Jor-el Thomas Caparas,0,0,36,36
1656141829415,MATH 20B,A02,083757,Briones; Jor-el Thomas Caparas,0,0,36,36
1656141829415,MATH 20B,A03,093475,Staff,2,0,36,34
1656141835438,MATH 20C,A01,083760,Briones; Jor-el Thomas Caparas,0,0,35,35
1656141835438,MATH 20C,A02,083761,Briones; Jor-el Thomas Caparas,9,1,35,26
1656141835438,MATH 20C,A03,093476,Staff,0,0,35,35
1656141835438,MATH 20C,B01,083762,Bach; Quang Tran,1,0,30,29
1656141841469,MATH 20D,A01,083765,Tran; Brian Kha,2,0,30,28
1656141841469,MATH 20D,A02,083766,Tran; Brian Kha,0,1,30,30
1656141841469,MATH 20D,A03,083767,Tran; Brian Kha,2,0,30,28
1656141847497,MATH 20E,A01,083771,Ganguly; Soumya,4,0,32,28
1656141847497,MATH 20E,A02,083772,Ganguly; Soumya,0,0,32,32
1656141847497,MATH 20E,B01,083773,Ciotti; Benjamin,15,0,35,20
1656141847497,MATH 20E,B02,083774,Ciotti; Benjamin,14,0,35,21
1656141853521,MATH 103A,A01,083777,Greenfeld; Be'Eri,1,0,36,35
1656141853521,MATH 103A,A02,083778,Greenfeld; Be'Eri,1,0,36,35
1656141853521,MATH 103A,A03,093561,Staff,4,0,36,32
1656141853521,MATH 103A,B01,083779,Greenfeld; Be'Eri,8,1,36,28
1656141853521,MATH 103A,B02,083780,Greenfeld; Be'Eri,1,0,36,35
1656141853521,MATH 103A,B03,093562,Staff,0,0,36,36
1656141859556,MATH 105,A01,085443,Carter; Anne Toulson,4,1,35,31
1656141859556,MATH 105,A02,093477,Staff,11,0,35,24
1656141865611,MATH 109,A01,083213,Ganzberger; Geoffrey Michael,0,0,34,34
1656141865611,MATH 109,A02,083214,Ganzberger; Geoffrey Michael,0,0,34,34
1656141865611,MATH 109,A03,093478,Staff,1,0,34,33
1656141865611,MATH 109,B01,083215,Ganzberger; Geoffrey Michael,4,0,32,28
1656141865611,MATH 109,B02,083216,Ganzberger; Geoffrey Michael,1,0,32,31
1656141865611,MATH 109,B03,093479,Staff,4,0,32,28
1656141871643,MATH 142A,A01,083219,Chow; Bennett,1,0,32,31
1656141871643,MATH 142A,A02,083220,Chow; Bennett,8,0,32,24
1656141871643,MATH 142A,A03,093480,Staff,5,0,32,27
1656141871643,MATH 142A,B03,093481,Staff,4,0,32,28
1656141871643,MATH 142A,B04,093558,Staff,6,0,32,26
1656141871643,MATH 142A,B05,093559,Staff,0,0,32,32
1656141877672,MATH 193A,A01,083224,Rotar; Vladimir,0,1,34,34
1656141877672,MATH 193A,A02,083225,Rotar; Vladimir,0,0,34,34
1656141877672,MATH 193A,A03,083781,Rotar; Vladimir,0,0,34,34
1656141877672,MATH 193A,A04,083782,Rotar; Vladimir,6,0,34,28
1656141877672,MATH 193A,A05,093482,Rotar; Vladimir,1,0,34,33
1656141883703,MATH 197,001,091859,McAuley; Julian John,9999,0,9999,0
1656141883703,MATH 197,002,095566,Kedlaya; Kiran S.,9997,0,9999,2
1656141883703,MATH 197,003,095567,Xiao; Ming,9999,0,9999,0
1656141883703,MATH 197,004,095571,Perols; Johan Lars,9998,0,9999,1
1656141890758,COGS 9,A01,083615,Shannon; Kyle Michael,4,0,75,71
1656141896790,COGS 11,A01,083617,Boyle; Mary E. T.,15,0,48,33
1656141902818,COGS 13,A01,083071,Bastos; Amalia Pinkusfeld,6,0,71,65
1656141908846,COGS 14A,A01,092681,Semenuks; Arturs,4,15,100,96
1656141914869,COGS 14B,A01,083073,Cheng; Tzu-Han,7,0,63,56
1656141920894,COGS 17,A01,092677,Semenuks; Arturs,8,0,81,73
1656141926919,COGS 100,A01,083619,Allen; Michael Gordon,3,0,70,67
1656141932943,COGS 101A,A01,083621,Davis; Joshua Daniel,3,0,68,65
1656141938969,COGS 101B,A01,091572,Allen; Michael Gordon,6,0,65,59
1656141944997,COGS 101C,A01,083625,Delgado; Tania,10,0,35,25
1656141951025,COGS 107A,A01,083627,Boyle; Mary E. T.,1,0,60,59
1656141957049,COGS 118A,A01,083075,Gupta; Anjum,7,0,76,69
1656141963074,CSE 3,A50,083646,Miranda; Gregory Joseph,18,0,50,32
1656141969099,CSE 8A,A50,083650,Miranda; Gregory Joseph,3,3,56,53
1656141975122,CSE 11,A01,083080,Cao; Yingjun,1,54,40,39
1656141981159,CSE 12,A01,083652,Krause-Levy; Sophia Louisa,7,2,120,113
1656141987187,CSE 15L,A01,083654,Morris; Justin Loren,2,0,50,48
1656141987187,CSE 15L,A02,083655,Morris; Justin Loren,4,0,50,46
1656141993212,CSE 20,A01,083657,Tran; Khoa Dang,31,0,80,49
1656141999240,CSE 21,A01,095574,Bach; Quang Tran,25,0,48,23
1656142005265,CSE 30,A01,083084,Eldon; John,2,8,80,78
1656142005265,CSE 30,B01,095061,Bhaskar; Nishant,1,2,50,49
1656142011299,CSE 100,A01,083659,Cao; Yingjun,2,20,70,68
1656142017325,CSE 134B,A01,083661,Powell; Thomas Allan,3,0,100,97
1656142023354,CSE 140,A01,083663,Gungor; Onat,9,0,85,76
1656142029389,CSE 140L,A01,083088,Eldon; John,8,0,100,92
1656142035416,CSE 175,A01,083665,Kumar; Rakesh,0,0,25,25
1656142041444,CSE 190,A00,092507,Dubnov; Shlomo,2,0,20,18
1656142047468,ECE 45,A01,083139,Congero; Spencer William,1,0,75,74
1656142053498,ECE 65,A50,083695,Saad; Andrew S,8,0,30,22
1656142053498,ECE 65,A51,095125,Staff,23,0,26,3
1656142059522,ECE 109,A01,091882,Touri; Behrouz,0,1,70,70
1656142065548,ECE 180,A00,083140,Abi Samra; Nicholas Camill,1,0,30,29
1656142065548,ECE 180,B00,083141,Abi Samra; Nicholas Camill,0,4,30,30
1656142071574,MATH 10A,A01,083735,Patchell; Gregory David,0,0,30,30
1656142071574,MATH 10A,A02,083736,Patchell; Gregory David,22,0,30,8
1656142071574,MATH 10A,A03,083737,Patchell; Gregory David,16,0,30,14
1656142077598,MATH 10B,A01,083207,Lim; Seonhee,0,0,34,34
1656142077598,MATH 10B,A02,083208,Lim; Seonhee,7,0,35,28
1656142077598,MATH 10B,A03,093472,Staff,1,0,34,33
1656142077598,MATH 10B,B01,083739,Sinha; Shubham,11,0,30,19
1656142083632,MATH 18,A01,083743,Cinel; Cameron Alexander,7,0,30,23
1656142083632,MATH 18,A02,083744,Cinel; Cameron Alexander,10,0,30,20
1656142083632,MATH 18,A03,083745,Cinel; Cameron Alexander,4,0,30,26
1656142083632,MATH 18,B01,083748,Rideout; David Porter,0,0,36,36
1656142083632,MATH 18,B02,083749,Rideout; David Porter,0,0,36,36
1656142083632,MATH 18,B03,083750,Rideout; David Porter,0,0,36,36
1656142083632,MATH 18,B04,083751,Rideout; David Porter,0,0,36,36
1656142083632,MATH 18,B05,093473,Rideout; David Porter,1,0,36,35
1656142083632,MATH 18,B06,093474,Rideout; David Porter,4,0,36,32
1656142089657,MATH 20A,A01,083754,Zheng; Zequn,11,0,40,29
1656142095686,MATH 20B,A01,083756,Briones; Jor-el Thomas Caparas,0,0,36,36
1656142095686,MATH 20B,A02,083757,Briones; Jor-el Thomas Caparas,0,0,36,36
1656142095686,MATH 20B,A03,093475,Staff,2,0,36,34
1656142101715,MATH 20C,A01,083760,Briones; Jor-el Thomas Caparas,0,0,35,35
1656142101715,MATH 20C,A02,083761,Briones; Jor-el Thomas Caparas,9,1,35,26
1656142101715,MATH 20C,A03,093476,Staff,0,0,35,35
1656142101715,MATH 20C,B01,083762,Bach; Quang Tran,1,0,30,29
1656142107740,MATH 20D,A01,083765,Tran; Brian Kha,2,0,30,28
1656142107740,MATH 20D,A02,083766,Tran; Brian Kha,0,1,30,30
1656142107740,MATH 20D,A03,083767,Tran; Brian Kha,2,0,30,28
1656142113771,MATH 20E,A01,083771,Ganguly; Soumya,4,0,32,28
1656142113771,MATH 20E,A02,083772,Ganguly; Soumya,0,0,32,32
1656142113771,MATH 20E,B01,083773,Ciotti; Benjamin,15,0,35,20
1656142113771,MATH 20E,B02,083774,Ciotti; Benjamin,14,0,35,21
1656142119803,MATH 103A,A01,083777,Greenfeld; Be'Eri,1,0,36,35
1656142119803,MATH 103A,A02,083778,Greenfeld; Be'Eri,1,0,36,35
1656142119803,MATH 103A,A03,093561,Staff,4,0,36,32
1656142119803,MATH 103A,B01,083779,Greenfeld; Be'Eri,8,1,36,28
1656142119803,MATH 103A,B02,083780,Greenfeld; Be'Eri,1,0,36,35
1656142119803,MATH 103A,B03,093562,Staff,0,0,36,36
1656142125828,MATH 105,A01,085443,Carter; Anne Toulson,4,1,35,31
1656142125828,MATH 105,A02,093477,Staff,11,0,35,24
1656142131856,MATH 109,A01,083213,Ganzberger; Geoffrey Michael,0,0,34,34
1656142131856,MATH 109,A02,083214,Ganzberger; Geoffrey Michael,0,0,34,34
1656142131856,MATH 109,A03,093478,Staff,1,0,34,33
1656142131856,MATH 109,B01,083215,Ganzberger; Geoffrey Michael,4,0,32,28
1656142131856,MATH 109,B02,083216,Ganzberger; Geoffrey Michael,1,0,32,31
1656142131856,MATH 109,B03,093479,Staff,4,0,32,28
1656142137881,MATH 142A,A01,083219,Chow; Bennett,1,0,32,31
1656142137881,MATH 142A,A02,083220,Chow; Bennett,8,0,32,24
1656142137881,MATH 142A,A03,093480,Staff,5,0,32,27
1656142137881,MATH 142A,B03,093481,Staff,4,0,32,28
1656142137881,MATH 142A,B04,093558,Staff,6,0,32,26
1656142137881,MATH 142A,B05,093559,Staff,0,0,32,32
1656142143906,MATH 193A,A01,083224,Rotar; Vladimir,0,1,34,34
1656142143906,MATH 193A,A02,083225,Rotar; Vladimir,0,0,34,34
1656142143906,MATH 193A,A03,083781,Rotar; Vladimir,0,0,34,34
1656142143906,MATH 193A,A04,083782,Rotar; Vladimir,6,0,34,28
1656142143906,MATH 193A,A05,093482,Rotar; Vladimir,1,0,34,33
1656142149935,MATH 197,001,091859,McAuley; Julian John,9999,0,9999,0
1656142149935,MATH 197,002,095566,Kedlaya; Kiran S.,9997,0,9999,2
1656142149935,MATH 197,003,095567,Xiao; Ming,9999,0,9999,0
1656142149935,MATH 197,004,095571,Perols; Johan Lars,9998,0,9999,1
1656142157013,COGS 9,A01,083615,Shannon; Kyle Michael,4,0,75,71
1656142163036,COGS 11,A01,083617,Boyle; Mary E. T.,15,0,48,33
1656142169062,COGS 13,A01,083071,Bastos; Amalia Pinkusfeld,6,0,71,65
1656142175087,COGS 14A,A01,092681,Semenuks; Arturs,4,15,100,96
1656142181110,COGS 14B,A01,083073,Cheng; Tzu-Han,7,0,63,56
1656142187138,COGS 17,A01,092677,Semenuks; Arturs,8,0,81,73
1656142193161,COGS 100,A01,083619,Allen; Michael Gordon,3,0,70,67
1656142199190,COGS 101A,A01,083621,Davis; Joshua Daniel,3,0,68,65
1656142205214,COGS 101B,A01,091572,Allen; Michael Gordon,6,0,65,59
1656142211238,COGS 101C,A01,083625,Delgado; Tania,10,0,35,25
1656142217261,COGS 107A,A01,083627,Boyle; Mary E. T.,1,0,60,59
1656142223372,COGS 118A,A01,083075,Gupta; Anjum,7,0,76,69
1656142229401,CSE 3,A50,083646,Miranda; Gregory Joseph,18,0,50,32
1656142235428,CSE 8A,A50,083650,Miranda; Gregory Joseph,3,3,56,53
1656142241456,CSE 11,A01,083080,Cao; Yingjun,1,54,40,39
1656142247482,CSE 12,A01,083652,Krause-Levy; Sophia Louisa,7,2,120,113
1656142253504,CSE 15L,A01,083654,Morris; Justin Loren,2,0,50,48
1656142253504,CSE 15L,A02,083655,Morris; Justin Loren,4,0,50,46
1656142259535,CSE 20,A01,083657,Tran; Khoa Dang,31,0,80,49
1656142265561,CSE 21,A01,095574,Bach; Quang Tran,25,0,48,23
1656142271592,CSE 30,A01,083084,Eldon; John,2,8,80,78
1656142271592,CSE 30,B01,095061,Bhaskar; Nishant,1,2,50,49
1656142277618,CSE 100,A01,083659,Cao; Yingjun,2,20,70,68
1656142283642,CSE 134B,A01,083661,Powell; Thomas Allan,3,0,100,97
1656142289667,CSE 140,A01,083663,Gungor; Onat,9,0,85,76
1656142295695,CSE 140L,A01,083088,Eldon; John,8,0,100,92
1656142301719,CSE 175,A01,083665,Kumar; Rakesh,0,0,25,25
1656142307744,CSE 190,A00,092507,Dubnov; Shlomo,2,0,20,18
1656142313771,ECE 45,A01,083139,Congero; Spencer William,1,0,75,74
1656142319804,ECE 65,A50,083695,Saad; Andrew S,8,0,30,22
1656142319804,ECE 65,A51,095125,Staff,23,0,26,3
1656142325833,ECE 109,A01,091882,Touri; Behrouz,0,1,70,70
1656142331892,ECE 180,A00,083140,Abi Samra; Nicholas Camill,1,0,30,29
1656142331892,ECE 180,B00,083141,Abi Samra; Nicholas Camill,0,4,30,30
1656142337918,MATH 10A,A01,083735,Patchell; Gregory David,0,0,30,30
1656142337918,MATH 10A,A02,083736,Patchell; Gregory David,22,0,30,8
1656142337918,MATH 10A,A03,083737,Patchell; Gregory David,16,0,30,14
1656142343961,MATH 10B,A01,083207,Lim; Seonhee,0,0,34,34
1656142343961,MATH 10B,A02,083208,Lim; Seonhee,7,0,35,28
1656142343961,MATH 10B,A03,093472,Staff,1,0,34,33
1656142343961,MATH 10B,B01,083739,Sinha; Shubham,11,0,30,19
1656142349987,MATH 18,A01,083743,Cinel; Cameron Alexander,7,0,30,23
1656142349987,MATH 18,A02,083744,Cinel; Cameron Alexander,10,0,30,20
1656142349987,MATH 18,A03,083745,Cinel; Cameron Alexander,4,0,30,26
1656142349987,MATH 18,B01,083748,Rideout; David Porter,0,0,36,36
1656142349987,MATH 18,B02,083749,Rideout; David Porter,0,0,36,36
1656142349987,MATH 18,B03,083750,Rideout; David Porter,0,0,36,36
1656142349987,MATH 18,B04,083751,Rideout; David Porter,0,0,36,36
1656142349987,MATH 18,B05,093473,Rideout; David Porter,1,0,36,35
1656142349987,MATH 18,B06,093474,Rideout; David Porter,4,0,36,32
1656142356015,MATH 20A,A01,083754,Zheng; Zequn,11,0,40,29
1656142362139,MATH 20B,A01,083756,Briones; Jor-el Thomas Caparas,0,0,36,36
1656142362139,MATH 20B,A02,083757,Briones; Jor-el Thomas Caparas,0,0,36,36
1656142362139,MATH 20B,A03,093475,Staff,2,0,36,34
1656142368177,MATH 20C,A01,083760,Briones; Jor-el Thomas Caparas,0,0,35,35
1656142368177,MATH 20C,A02,083761,Briones; Jor-el Thomas Caparas,9,1,35,26
1656142368177,MATH 20C,A03,093476,Staff,0,0,35,35
1656142368177,MATH 20C,B01,083762,Bach; Quang Tran,1,0,30,29
1656142374201,MATH 20D,A01,083765,Tran; Brian Kha,2,0,30,28
1656142374201,MATH 20D,A02,083766,Tran; Brian Kha,0,1,30,30
1656142374201,MATH 20D,A03,083767,Tran; Brian Kha,2,0,30,28
1656142380242,MATH 20E,A01,083771,Ganguly; Soumya,4,0,32,28
1656142380242,MATH 20E,A02,083772,Ganguly; Soumya,0,0,32,32
1656142380242,MATH 20E,B01,083773,Ciotti; Benjamin,15,0,35,20
1656142380242,MATH 20E,B02,083774,Ciotti; Benjamin,14,0,35,21
1656142386272,MATH 103A,A01,083777,Greenfeld; Be'Eri,1,0,36,35
1656142386272,MATH 103A,A02,083778,Greenfeld; Be'Eri,1,0,36,35
1656142386272,MATH 103A,A03,093561,Staff,4,0,36,32
1656142386272,MATH 103A,B01,083779,Greenfeld; Be'Eri,8,1,36,28
1656142386272,MATH 103A,B02,083780,Greenfeld; Be'Eri,1,0,36,35
1656142386272,MATH 103A,B03,093562,Staff,0,0,36,36
1656142392303,MATH 105,A01,085443,Carter; Anne Toulson,4,1,35,31
1656142392303,MATH 105,A02,093477,Staff,11,0,35,24
1656142398328,MATH 109,A01,083213,Ganzberger; Geoffrey Michael,0,0,34,34
1656142398328,MATH 109,A02,083214,Ganzberger; Geoffrey Michael,0,0,34,34
1656142398328,MATH 109,A03,093478,Staff,1,0,34,33
1656142398328,MATH 109,B01,083215,Ganzberger; Geoffrey Michael,4,0,32,28
1656142398328,MATH 109,B02,083216,Ganzberger; Geoffrey Michael,1,0,32,31
1656142398328,MATH 109,B03,093479,Staff,4,0,32,28
1656142404366,MATH 142A,A01,083219,Chow; Bennett,1,0,32,31
1656142404366,MATH 142A,A02,083220,Chow; Bennett,8,0,32,24
1656142404366,MATH 142A,A03,093480,Staff,5,0,32,27
1656142404366,MATH 142A,B03,093481,Staff,4,0,32,28
1656142404366,MATH 142A,B04,093558,Staff,6,0,32,26
1656142404366,MATH 142A,B05,093559,Staff,0,0,32,32
1656142410410,MATH 193A,A01,083224,Rotar; Vladimir,0,1,34,34
1656142410410,MATH 193A,A02,083225,Rotar; Vladimir,0,0,34,34
1656142410410,MATH 193A,A03,083781,Rotar; Vladimir,0,0,34,34
1656142410410,MATH 193A,A04,083782,Rotar; Vladimir,6,0,34,28
1656142410410,MATH 193A,A05,093482,Rotar; Vladimir,1,0,34,33
1656142416442,MATH 197,001,091859,McAuley; Julian John,9999,0,9999,0
1656142416442,MATH 197,002,095566,Kedlaya; Kiran S.,9997,0,9999,2
1656142416442,MATH 197,003,095567,Xiao; Ming,9999,0,9999,0
1656142416442,MATH 197,004,095571,Perols; Johan Lars,9998,0,9999,1
1656142423500,COGS 9,A01,083615,Shannon; Kyle Michael,4,0,75,71
1656142429531,COGS 11,A01,083617,Boyle; Mary E. T.,15,0,48,33
1656142435556,COGS 13,A01,083071,Bastos; Amalia Pinkusfeld,6,0,71,65
1656142441584,COGS 14A,A01,092681,Semenuks; Arturs,4,15,100,96
1656142447608,COGS 14B,A01,083073,Cheng; Tzu-Han,7,0,63,56
1656142453640,COGS 17,A01,092677,Semenuks; Arturs,8,0,81,73
1656142459664,COGS 100,A01,083619,Allen; Michael Gordon,3,0,70,67
1656142465691,COGS 101A,A01,083621,Davis; Joshua Daniel,3,0,68,65
1656142471720,COGS 101B,A01,091572,Allen; Michael Gordon,6,0,65,59
1656142477745,COGS 101C,A01,083625,Delgado; Tania,10,0,35,25
1656142483773,COGS 107A,A01,083627,Boyle; Mary E. T.,1,0,60,59
1656142489803,COGS 118A,A01,083075,Gupta; Anjum,7,0,76,69
1656142495830,CSE 3,A50,083646,Miranda; Gregory Joseph,18,0,50,32
1656142501857,CSE 8A,A50,083650,Miranda; Gregory Joseph,3,3,56,53
1656142507887,CSE 11,A01,083080,Cao; Yingjun,1,54,40,39
1656142513912,CSE 12,A01,083652,Krause-Levy; Sophia Louisa,7,2,120,113
1656142519950,CSE 15L,A01,083654,Morris; Justin Loren,2,0,50,48
1656142519950,CSE 15L,A02,083655,Morris; Justin Loren,4,0,50,46
1656142525981,CSE 20,A01,083657,Tran; Khoa Dang,31,0,80,49
1656142532016,CSE 21,A01,095574,Bach; Quang Tran,25,0,48,23
1656142538046,CSE 30,A01,083084,Eldon; John,2,8,80,78
1656142538046,CSE 30,B01,095061,Bhaskar; Nishant,1,2,50,49
1656142544079,CSE 100,A01,083659,Cao; Yingjun,2,20,70,68
1656142550103,CSE 134B,A01,083661,Powell; Thomas Allan,3,0,100,97
1656142556131,CSE 140,A01,083663,Gungor; Onat,9,0,85,76
1656142562157,CSE 140L,A01,083088,Eldon; John,8,0,100,92
1656142568180,CSE 175,A01,083665,Kumar; Rakesh,0,0,25,25
1656142574206,CSE 190,A00,092507,Dubnov; Shlomo,2,0,20,18
1656142580237,ECE 45,A01,083139,Congero; Spencer William,1,0,75,74
1656142586265,ECE 65,A50,083695,Saad; Andrew S,8,0,30,22
1656142586265,ECE 65,A51,095125,Staff,23,0,26,3
1656142592290,ECE 109,A01,091882,Touri; Behrouz,0,1,70,70
1656142598318,ECE 180,A00,083140,Abi Samra; Nicholas Camill,1,0,30,29
1656142598318,ECE 180,B00,083141,Abi Samra; Nicholas Camill,0,4,30,30
1656142604351,MATH 10A,A01,083735,Patchell; Gregory David,0,0,30,30
1656142604351,MATH 10A,A02,083736,Patchell; Gregory David,22,0,30,8
1656142604351,MATH 10A,A03,083737,Patchell; Gregory David,16,0,30,14
1656142610379,MATH 10B,A01,083207,Lim; Seonhee,0,0,34,34
1656142610379,MATH 10B,A02,083208,Lim; Seonhee,7,0,35,28
1656142610379,MATH 10B,A03,093472,Staff,1,0,34,33
1656142610379,MATH 10B,B01,083739,Sinha; Shubham,11,0,30,19
1656142616407,MATH 18,A01,083743,Cinel; Cameron Alexander,7,0,30,23
1656142616407,MATH 18,A02,083744,Cinel; Cameron Alexander,10,0,30,20
1656142616407,MATH 18,A03,083745,Cinel; Cameron Alexander,4,0,30,26
1656142616407,MATH 18,B01,083748,Rideout; David Porter,0,0,36,36
1656142616407,MATH 18,B02,083749,Rideout; David Porter,0,0,36,36
1656142616407,MATH 18,B03,083750,Rideout; David Porter,0,0,36,36
1656142616407,MATH 18,B04,083751,Rideout; David Porter,0,0,36,36
1656142616407,MATH 18,B05,093473,Rideout; David Porter,1,0,36,35
1656142616407,MATH 18,B06,093474,Rideout; David Porter,4,0,36,32
1656142622435,MATH 20A,A01,083754,Zheng; Zequn,11,0,40,29
1656142628468,MATH 20B,A01,083756,Briones; Jor-el Thomas Caparas,0,0,36,36
1656142628468,MATH 20B,A02,083757,Briones; Jor-el Thomas Caparas,0,0,36,36
1656142628468,MATH 20B,A03,093475,Staff,2,0,36,34
1656142634500,MATH 20C,A01,083760,Briones; Jor-el Thomas Caparas,0,0,35,35
1656142634500,MATH 20C,A02,083761,Briones; Jor-el Thomas Caparas,9,1,35,26
1656142634500,MATH 20C,A03,093476,Staff,0,0,35,35
1656142634500,MATH 20C,B01,083762,Bach; Quang Tran,1,0,30,29
1656142640525,MATH 20D,A01,083765,Tran; Brian Kha,2,0,30,28
1656142640525,MATH 20D,A02,083766,Tran; Brian Kha,0,1,30,30
1656142640525,MATH 20D,A03,083767,Tran; Brian Kha,2,0,30,28
1656142646553,MATH 20E,A01,083771,Ganguly; Soumya,4,0,32,28
1656142646553,MATH 20E,A02,083772,Ganguly; Soumya,0,0,32,32
1656142646553,MATH 20E,B01,083773,Ciotti; Benjamin,15,0,35,20
1656142646553,MATH 20E,B02,083774,Ciotti; Benjamin,14,0,35,21
1656142652597,MATH 103A,A01,083777,Greenfeld; Be'Eri,1,0,36,35
1656142652597,MATH 103A,A02,083778,Greenfeld; Be'Eri,1,0,36,35
1656142652597,MATH 103A,A03,093561,Staff,4,0,36,32
1656142652597,MATH 103A,B01,083779,Greenfeld; Be'Eri,8,1,36,28
1656142652597,MATH 103A,B02,083780,Greenfeld; Be'Eri,1,0,36,35
1656142652597,MATH 103A,B03,093562,Staff,0,0,36,36
1656142658632,MATH 105,A01,085443,Carter; Anne Toulson,4,1,35,31
1656142658632,MATH 105,A02,093477,Staff,11,0,35,24
1656142664663,MATH 109,A01,083213,Ganzberger; Geoffrey Michael,0,0,34,34
1656142664663,MATH 109,A02,083214,Ganzberger; Geoffrey Michael,0,0,34,34
1656142664663,MATH 109,A03,093478,Staff,1,0,34,33
1656142664663,MATH 109,B01,083215,Ganzberger; Geoffrey Michael,4,0,32,28
1656142664663,MATH 109,B02,083216,Ganzberger; Geoffrey Michael,1,0,32,31
1656142664663,MATH 109,B03,093479,Staff,4,0,32,28
1656142670696,MATH 142A,A01,083219,Chow; Bennett,1,0,32,31
1656142670696,MATH 142A,A02,083220,Chow; Bennett,8,0,32,24
1656142670696,MATH 142A,A03,093480,Staff,5,0,32,27
1656142670696,MATH 142A,B03,093481,Staff,4,0,32,28
1656142670696,MATH 142A,B04,093558,Staff,6,0,32,26
1656142670696,MATH 142A,B05,093559,Staff,0,0,32,32
1656142676729,MATH 193A,A01,083224,Rotar; Vladimir,0,1,34,34
1656142676729,MATH 193A,A02,083225,Rotar; Vladimir,0,0,34,34
1656142676729,MATH 193A,A03,083781,Rotar; Vladimir,0,0,34,34
1656142676729,MATH 193A,A04,083782,Rotar; Vladimir,6,0,34,28
1656142676729,MATH 193A,A05,093482,Rotar; Vladimir,1,0,34,33
1656142682756,MATH 197,001,091859,McAuley; Julian John,9999,0,9999,0
1656142682756,MATH 197,002,095566,Kedlaya; Kiran S.,9997,0,9999,2
1656142682756,MATH 197,003,095567,Xiao; Ming,9999,0,9999,0
1656142682756,MATH 197,004,095571,Perols; Johan Lars,9998,0,9999,1
1656142689836,COGS 9,A01,083615,Shannon; Kyle Michael,4,0,75,71
1656142695863,COGS 11,A01,083617,Boyle; Mary E. T.,15,0,48,33
1656142701889,COGS 13,A01,083071,Bastos; Amalia Pinkusfeld,6,0,71,65
1656142707916,COGS 14A,A01,092681,Semenuks; Arturs,4,15,100,96
1656142713941,COGS 14B,A01,083073,Cheng; Tzu-Han,7,0,63,56
1656142719966,COGS 17,A01,092677,Semenuks; Arturs,8,0,81,73
1656142725996,COGS 100,A01,083619,Allen; Michael Gordon,3,0,70,67
1656142732020,COGS 101A,A01,083621,Davis; Joshua Daniel,3,0,68,65
1656142738051,COGS 101B,A01,091572,Allen; Michael Gordon,6,0,65,59
1656142744076,COGS 101C,A01,083625,Delgado; Tania,10,0,35,25
1656142750105,COGS 107A,A01,083627,Boyle; Mary E. T.,1,0,60,59
1656142756133,COGS 118A,A01,083075,Gupta; Anjum,7,0,76,69
1656142762158,CSE 3,A50,083646,Miranda; Gregory Joseph,18,0,50,32
1656142768182,CSE 8A,A50,083650,Miranda; Gregory Joseph,3,3,56,53
1656142774206,CSE 11,A01,083080,Cao; Yingjun,1,54,40,39
1656142780231,CSE 12,A01,083652,Krause-Levy; Sophia Louisa,7,2,120,113
1656142786257,CSE 15L,A01,083654,Morris; Justin Loren,2,0,50,48
1656142786257,CSE 15L,A02,083655,Morris; Justin Loren,4,0,50,46
1656142792287,CSE 20,A01,083657,Tran; Khoa Dang,31,0,80,49
1656142798312,CSE 21,A01,095574,Bach; Quang Tran,25,0,48,23
1656142804362,CSE 30,A01,083084,Eldon; John,2,8,80,78
1656142804362,CSE 30,B01,095061,Bhaskar; Nishant,1,2,50,49
1656142810401,CSE 100,A01,083659,Cao; Yingjun,2,20,70,68
1656142816431,CSE 134B,A01,083661,Powell; Thomas Allan,3,0,100,97
1656142822543,CSE 140,A01,083663,Gungor; Onat,9,0,85,76
1656142828570,CSE 140L,A01,083088,Eldon; John,8,0,100,92
1656142834601,CSE 175,A01,083665,Kumar; Rakesh,0,0,25,25
1656142840631,CSE 190,A00,092507,Dubnov; Shlomo,2,0,20,18
1656142846668,ECE 45,A01,083139,Congero; Spencer William,1,0,75,74
1656142852695,ECE 65,A50,083695,Saad; Andrew S,8,0,30,22
1656142852695,ECE 65,A51,095125,Staff,23,0,26,3
1656142858725,ECE 109,A01,091882,Touri; Behrouz,0,1,70,70
1656142864748,ECE 180,A00,083140,Abi Samra; Nicholas Camill,1,0,30,29
1656142864748,ECE 180,B00,083141,Abi Samra; Nicholas Camill,0,4,30,30
1656142870775,MATH 10A,A01,083735,Patchell; Gregory David,0,0,30,30
1656142870775,MATH 10A,A02,083736,Patchell; Gregory David,22,0,30,8
1656142870775,MATH 10A,A03,083737,Patchell; Gregory David,16,0,30,14
1656142876810,MATH 10B,A01,083207,Lim; Seonhee,0,0,34,34
1656142876810,MATH 10B,A02,083208,Lim; Seonhee,7,0,35,28
1656142876810,MATH 10B,A03,093472,Staff,1,0,34,33
1656142876810,MATH 10B,B01,083739,Sinha; Shubham,11,0,30,19
1656142882846,MATH 18,A01,083743,Cinel; Cameron Alexander,7,0,30,23
1656142882846,MATH 18,A02,083744,Cinel; Cameron Alexander,10,0,30,20
1656142882846,MATH 18,A03,083745,Cinel; Cameron Alexander,4,0,30,26
1656142882846,MATH 18,B01,083748,Rideout; David Porter,0,0,36,36
1656142882846,MATH 18,B02,083749,Rideout; David Porter,0,0,36,36
1656142882846,MATH 18,B03,083750,Rideout; David Porter,0,0,36,36
1656142882846,MATH 18,B04,083751,Rideout; David Porter,0,0,36,36
1656142882846,MATH 18,B05,093473,Rideout; David Porter,1,0,36,35
1656142882846,MATH 18,B06,093474,Rideout; David Porter,4,0,36,32
1656142888875,MATH 20A,A01,083754,Zheng; Zequn,11,0,40,29
1656142894908,MATH 20B,A01,083756,Briones; Jor-el Thomas Caparas,0,0,36,36
1656142894908,MATH 20B,A02,083757,Briones; Jor-el Thomas Caparas,0,0,36,36
1656142894908,MATH 20B,A03,093475,Staff,2,0,36,34
1656142900934,MATH 20C,A01,083760,Briones; Jor-el Thomas Caparas,0,0,35,35
1656142900934,MATH 20C,A02,083761,Briones; Jor-el Thomas Caparas,9,1,35,26
1656142900934,MATH 20C,A03,093476,Staff,0,0,35,35
1656142900934,MATH 20C,B01,083762,Bach; Quang Tran,1,0,30,29
1656142906966,MATH 20D,A01,083765,Tran; Brian Kha,2,0,30,28
1656142906966,MATH 20D,A02,083766,Tran; Brian Kha,0,1,30,30
1656142906966,MATH 20D,A03,083767,Tran; Brian Kha,2,0,30,28
1656142912992,MATH 20E,A01,083771,Ganguly; Soumya,4,0,32,28
1656142912992,MATH 20E,A02,083772,Ganguly; Soumya,0,0,32,32
1656142912992,MATH 20E,B01,083773,Ciotti; Benjamin,15,0,35,20
1656142912992,MATH 20E,B02,083774,Ciotti; Benjamin,14,0,35,21
1656142919019,MATH 103A,A01,083777,Greenfeld; Be'Eri,1,0,36,35
1656142919019,MATH 103A,A02,083778,Greenfeld; Be'Eri,1,0,36,35
1656142919019,MATH 103A,A03,093561,Staff,4,0,36,32
1656142919019,MATH 103A,B01,083779,Greenfeld; Be'Eri,8,1,36,28
1656142919019,MATH 103A,B02,083780,Greenfeld; Be'Eri,1,0,36,35
1656142919019,MATH 103A,B03,093562,Staff,0,0,36,36
1656142925045,MATH 105,A01,085443,Carter; Anne Toulson,4,1,35,31
1656142925045,MATH 105,A02,093477,Staff,11,0,35,24
1656142931079,MATH 109,A01,083213,Ganzberger; Geoffrey Michael,0,0,34,34
1656142931079,MATH 109,A02,083214,Ganzberger; Geoffrey Michael,0,0,34,34
1656142931079,MATH 109,A03,093478,Staff,1,0,34,33
1656142931079,MATH 109,B01,083215,Ganzberger; Geoffrey Michael,4,0,32,28
1656142931079,MATH 109,B02,083216,Ganzberger; Geoffrey Michael,1,0,32,31
1656142931079,MATH 109,B03,093479,Staff,4,0,32,28
1656142937106,MATH 142A,A01,083219,Chow; Bennett,1,0,32,31
1656142937106,MATH 142A,A02,083220,Chow; Bennett,8,0,32,24
1656142937106,MATH 142A,A03,093480,Staff,5,0,32,27
1656142937106,MATH 142A,B03,093481,Staff,4,0,32,28
1656142937106,MATH 142A,B04,093558,Staff,6,0,32,26
1656142937106,MATH 142A,B05,093559,Staff,0,0,32,32
1656142943135,MATH 193A,A01,083224,Rotar; Vladimir,0,1,34,34
1656142943135,MATH 193A,A02,083225,Rotar; Vladimir,0,0,34,34
1656142943135,MATH 193A,A03,083781,Rotar; Vladimir,0,0,34,34
1656142943135,MATH 193A,A04,083782,Rotar; Vladimir,6,0,34,28
1656142943135,MATH 193A,A05,093482,Rotar; Vladimir,1,0,34,33
1656142949168,MATH 197,001,091859,McAuley; Julian John,9999,0,9999,0
1656142949168,MATH 197,002,095566,Kedlaya; Kiran S.,9997,0,9999,2
1656142949168,MATH 197,003,095567,Xiao; Ming,9999,0,9999,0
1656142949168,MATH 197,004,095571,Perols; Johan Lars,9998,0,9999,1
1656142956233,COGS 9,A01,083615,Shannon; Kyle Michael,4,0,75,71
1656142962272,COGS 11,A01,083617,Boyle; Mary E. T.,15,0,48,33
1656142968301,COGS 13,A01,083071,Bastos; Amalia Pinkusfeld,6,0,71,65
1656142974329,COGS 14A,A01,092681,Semenuks; Arturs,4,15,100,96
1656142980356,COGS 14B,A01,083073,Cheng; Tzu-Han,7,0,63,56
1656142986378,COGS 17,A01,092677,Semenuks; Arturs,8,0,81,73
1656142992413,COGS 100,A01,083619,Allen; Michael Gordon,3,0,70,67
1656142998443,COGS 101A,A01,083621,Davis; Joshua Daniel,3,0,68,65
1656143004472,COGS 101B,A01,091572,Allen; Michael Gordon,6,0,65,59
1656143010496,COGS 101C,A01,083625,Delgado; Tania,10,0,35,25
1656143016524,COGS 107A,A01,083627,Boyle; Mary E. T.,1,0,60,59
1656143022554,COGS 118A,A01,083075,Gupta; Anjum,7,0,76,69
1656143028580,CSE 3,A50,083646,Miranda; Gregory Joseph,18,0,50,32
1656143034609,CSE 8A,A50,083650,Miranda; Gregory Joseph,3,3,56,53
1656143040636,CSE 11,A01,083080,Cao; Yingjun,1,54,40,39
1656143046665,CSE 12,A01,083652,Krause-Levy; Sophia Louisa,7,2,120,113
1656143052694,CSE 15L,A01,083654,Morris; Justin Loren,2,0,50,48
1656143052694,CSE 15L,A02,083655,Morris; Justin Loren,4,0,50,46
1656143058724,CSE 20,A01,083657,Tran; Khoa Dang,31,0,80,49
1656143064750,CSE 21,A01,095574,Bach; Quang Tran,25,0,48,23
1656143070781,CSE 30,A01,083084,Eldon; John,2,8,80,78
1656143070781,CSE 30,B01,095061,Bhaskar; Nishant,1,2,50,49
1656143076807,CSE 100,A01,083659,Cao; Yingjun,2,20,70,68
1656143082832,CSE 134B,A01,083661,Powell; Thomas Allan,3,0,100,97
1656143088868,CSE 140,A01,083663,Gungor; Onat,9,0,85,76
1656143094892,CSE 140L,A01,083088,Eldon; John,8,0,100,92
1656143100923,CSE 175,A01,083665,Kumar; Rakesh,0,0,25,25
1656143106969,CSE 190,A00,092507,Dubnov; Shlomo,2,0,20,18
1656143113004,ECE 45,A01,083139,Congero; Spencer William,1,0,75,74
1656143119038,ECE 65,A50,083695,Saad; Andrew S,8,0,30,22
1656143119038,ECE 65,A51,095125,Staff,23,0,26,3
1656143125067,ECE 109,A01,091882,Touri; Behrouz,0,1,70,70
1656143131097,ECE 180,A00,083140,Abi Samra; Nicholas Camill,1,0,30,29
1656143131097,ECE 180,B00,083141,Abi Samra; Nicholas Camill,0,4,30,30
1656143137131,MATH 10A,A01,083735,Patchell; Gregory David,0,0,30,30
1656143137131,MATH 10A,A02,083736,Patchell; Gregory David,22,0,30,8
1656143137131,MATH 10A,A03,083737,Patchell; Gregory David,16,0,30,14
1656143143162,MATH 10B,A01,083207,Lim; Seonhee,0,0,34,34
1656143143162,MATH 10B,A02,083208,Lim; Seonhee,7,0,35,28
1656143143162,MATH 10B,A03,093472,Staff,1,0,34,33
1656143143162,MATH 10B,B01,083739,Sinha; Shubham,11,0,30,19
1656143149202,MATH 18,A01,083743,Cinel; Cameron Alexander,7,0,30,23
1656143149202,MATH 18,A02,083744,Cinel; Cameron Alexander,10,0,30,20
1656143149202,MATH 18,A03,083745,Cinel; Cameron Alexander,4,0,30,26
1656143149202,MATH 18,B01,083748,Rideout; David Porter,0,0,36,36
1656143149202,MATH 18,B02,083749,Rideout; David Porter,0,0,36,36
1656143149202,MATH 18,B03,083750,Rideout; David Porter,0,0,36,36
1656143149202,MATH 18,B04,083751,Rideout; David Porter,0,0,36,36
1656143149202,MATH 18,B05,093473,Rideout; David Porter,1,0,36,35
1656143149202,MATH 18,B06,093474,Rideout; David Porter,4,0,36,32
1656143155228,MATH 20A,A01,083754,Zheng; Zequn,11,0,40,29
1656143161255,MATH 20B,A01,083756,Briones; Jor-el Thomas Caparas,0,0,36,36
1656143161255,MATH 20B,A02,083757,Briones; Jor-el Thomas Caparas,0,0,36,36
1656143161255,MATH 20B,A03,093475,Staff,2,0,36,34
1656143167283,MATH 20C,A01,083760,Briones; Jor-el Thomas Caparas,0,0,35,35
1656143167283,MATH 20C,A02,083761,Briones; Jor-el Thomas Caparas,9,1,35,26
1656143167283,MATH 20C,A03,093476,Staff,0,0,35,35
1656143167283,MATH 20C,B01,083762,Bach; Quang Tran,1,0,30,29
1656143173308,MATH 20D,A01,083765,Tran; Brian Kha,2,0,30,28
1656143173308,MATH 20D,A02,083766,Tran; Brian Kha,0,1,30,30
1656143173308,MATH 20D,A03,083767,Tran; Brian Kha,2,0,30,28
1656143179334,MATH 20E,A01,083771,Ganguly; Soumya,4,0,32,28
1656143179334,MATH 20E,A02,083772,Ganguly; Soumya,0,0,32,32
1656143179334,MATH 20E,B01,083773,Ciotti; Benjamin,15,0,35,20
1656143179334,MATH 20E,B02,083774,Ciotti; Benjamin,14,0,35,21
1656143185370,MATH 103A,A01,083777,Greenfeld; Be'Eri,1,0,36,35
1656143185370,MATH 103A,A02,083778,Greenfeld; Be'Eri,1,0,36,35
1656143185370,MATH 103A,A03,093561,Staff,4,0,36,32
1656143185370,MATH 103A,B01,083779,Greenfeld; Be'Eri,8,1,36,28
1656143185370,MATH 103A,B02,083780,Greenfeld; Be'Eri,1,0,36,35
1656143185370,MATH 103A,B03,093562,Staff,0,0,36,36
1656143191394,MATH 105,A01,085443,Carter; Anne Toulson,4,1,35,31
1656143191394,MATH 105,A02,093477,Staff,11,0,35,24
1656143197420,MATH 109,A01,083213,Ganzberger; Geoffrey Michael,0,0,34,34
1656143197420,MATH 109,A02,083214,Ganzberger; Geoffrey Michael,0,0,34,34
1656143197420,MATH 109,A03,093478,Staff,1,0,34,33
1656143197420,MATH 109,B01,083215,Ganzberger; Geoffrey Michael,4,0,32,28
1656143197420,MATH 109,B02,083216,Ganzberger; Geoffrey Michael,1,0,32,31
1656143197420,MATH 109,B03,093479,Staff,4,0,32,28
1656143203450,MATH 142A,A01,083219,Chow; Bennett,1,0,32,31
1656143203450,MATH 142A,A02,083220,Chow; Bennett,8,0,32,24
1656143203450,MATH 142A,A03,093480,Staff,5,0,32,27
1656143203450,MATH 142A,B03,093481,Staff,4,0,32,28
1656143203450,MATH 142A,B04,093558,Staff,6,0,32,26
1656143203450,MATH 142A,B05,093559,Staff,0,0,32,32
1656143209482,MATH 193A,A01,083224,Rotar; Vladimir,0,1,34,34
1656143209482,MATH 193A,A02,083225,Rotar; Vladimir,0,0,34,34
1656143209482,MATH 193A,A03,083781,Rotar; Vladimir,0,0,34,34
1656143209482,MATH 193A,A04,083782,Rotar; Vladimir,6,0,34,28
1656143209482,MATH 193A,A05,093482,Rotar; Vladimir,1,0,34,33
1656143215516,MATH 197,001,091859,McAuley; Julian John,9999,0,9999,0
1656143215516,MATH 197,002,095566,Kedlaya; Kiran S.,9997,0,9999,2
1656143215516,MATH 197,003,095567,Xiao; Ming,9999,0,9999,0
1656143215516,MATH 197,004,095571,Perols; Johan Lars,9998,0,9999,1
1656143222609,COGS 9,A01,083615,Shannon; Kyle Michael,4,0,75,71
1656143228633,COGS 11,A01,083617,Boyle; Mary E. T.,15,0,48,33
1656143234668,COGS 13,A01,083071,Bastos; Amalia Pinkusfeld,6,0,71,65
1656143240693,COGS 14A,A01,092681,Semenuks; Arturs,4,15,100,96
1656143246718,COGS 14B,A01,083073,Cheng; Tzu-Han,7,0,63,56
1656143252743,COGS 17,A01,092677,Semenuks; Arturs,8,0,81,73
1656143258776,COGS 100,A01,083619,Allen; Michael Gordon,3,0,70,67
1656143264813,COGS 101A,A01,083621,Davis; Joshua Daniel,3,0,68,65
1656143270847,COGS 101B,A01,091572,Allen; Michael Gordon,6,0,65,59
1656143276880,COGS 101C,A01,083625,Delgado; Tania,10,0,35,25
1656143282907,COGS 107A,A01,083627,Boyle; Mary E. T.,1,0,60,59
1656143288937,COGS 118A,A01,083075,Gupta; Anjum,7,0,76,69
1656143294962,CSE 3,A50,083646,Miranda; Gregory Joseph,18,0,50,32
1656143300993,CSE 8A,A50,083650,Miranda; Gregory Joseph,3,3,56,53
1656143307019,CSE 11,A01,083080,Cao; Yingjun,1,54,40,39
1656143313045,CSE 12,A01,083652,Krause-Levy; Sophia Louisa,7,2,120,113
1656143319071,CSE 15L,A01,083654,Morris; Justin Loren,2,0,50,48
1656143319071,CSE 15L,A02,083655,Morris; Justin Loren,4,0,50,46
1656143325097,CSE 20,A01,083657,Tran; Khoa Dang,31,0,80,49
1656143331122,CSE 21,A01,095574,Bach; Quang Tran,25,0,48,23
1656143337154,CSE 30,A01,083084,Eldon; John,2,8,80,78
1656143337154,CSE 30,B01,095061,Bhaskar; Nishant,1,2,50,49
1656143343183,CSE 100,A01,083659,Cao; Yingjun,2,20,70,68
1656143349210,CSE 134B,A01,083661,Powell; Thomas Allan,3,0,100,97
1656143355236,CSE 140,A01,083663,Gungor; Onat,9,0,85,76
1656143361263,CSE 140L,A01,083088,Eldon; John,8,0,100,92
1656143367290,CSE 175,A01,083665,Kumar; Rakesh,0,0,25,25
1656143373315,CSE 190,A00,092507,Dubnov; Shlomo,2,0,20,18
1656143379341,ECE 45,A01,083139,Congero; Spencer William,1,0,75,74
1656143385382,ECE 65,A50,083695,Saad; Andrew S,8,0,30,22
1656143385382,ECE 65,A51,095125,Staff,23,0,26,3
1656143391412,ECE 109,A01,091882,Touri; Behrouz,0,1,70,70
1656143397440,ECE 180,A00,083140,Abi Samra; Nicholas Camill,1,0,30,29
1656143397440,ECE 180,B00,083141,Abi Samra; Nicholas Camill,0,4,30,30
1656143403477,MATH 10A,A01,083735,Patchell; Gregory David,0,0,30,30
1656143403477,MATH 10A,A02,083736,Patchell; Gregory David,22,0,30,8
1656143403477,MATH 10A,A03,083737,Patchell; Gregory David,16,0,30,14
1656143409508,MATH 10B,A01,083207,Lim; Seonhee,0,0,34,34
1656143409508,MATH 10B,A02,083208,Lim; Seonhee,7,0,35,28
1656143409508,MATH 10B,A03,093472,Staff,1,0,34,33
1656143409508,MATH 10B,B01,083739,Sinha; Shubham,11,0,30,19
1656143415553,MATH 18,A01,083743,Cinel; Cameron Alexander,7,0,30,23
1656143415553,MATH 18,A02,083744,Cinel; Cameron Alexander,10,0,30,20
1656143415553,MATH 18,A03,083745,Cinel; Cameron Alexander,4,0,30,26
1656143415553,MATH 18,B01,083748,Rideout; David Porter,0,0,36,36
1656143415553,MATH 18,B02,083749,Rideout; David Porter,0,0,36,36
1656143415553,MATH 18,B03,083750,Rideout; David Porter,0,0,36,36
1656143415553,MATH 18,B04,083751,Rideout; David Porter,0,0,36,36
1656143415553,MATH 18,B05,093473,Rideout; David Porter,1,0,36,35
1656143415553,MATH 18,B06,093474,Rideout; David Porter,4,0,36,32
1656143421650,MATH 20A,A01,083754,Zheng; Zequn,11,0,40,29
1656143427682,MATH 20B,A01,083756,Briones; Jor-el Thomas Caparas,0,0,36,36
1656143427682,MATH 20B,A02,083757,Briones; Jor-el Thomas Caparas,0,0,36,36
1656143427682,MATH 20B,A03,093475,Staff,2,0,36,34
1656143433716,MATH 20C,A01,083760,Briones; Jor-el Thomas Caparas,0,0,35,35
1656143433716,MATH 20C,A02,083761,Briones; Jor-el Thomas Caparas,9,1,35,26
1656143433716,MATH 20C,A03,093476,Staff,0,0,35,35
1656143433716,MATH 20C,B01,083762,Bach; Quang Tran,1,0,30,29
1656143439748,MATH 20D,A01,083765,Tran; Brian Kha,2,0,30,28
1656143439748,MATH 20D,A02,083766,Tran; Brian Kha,0,1,30,30
1656143439748,MATH 20D,A03,083767,Tran; Brian Kha,2,0,30,28
1656143445776,MATH 20E,A01,083771,Ganguly; Soumya,4,0,32,28
1656143445776,MATH 20E,A02,083772,Ganguly; Soumya,0,0,32,32
1656143445776,MATH 20E,B01,083773,Ciotti; Benjamin,15,0,35,20
1656143445776,MATH 20E,B02,083774,Ciotti; Benjamin,14,0,35,21
1656143451814,MATH 103A,A01,083777,Greenfeld; Be'Eri,1,0,36,35
1656143451814,MATH 103A,A02,083778,Greenfeld; Be'Eri,1,0,36,35
1656143451814,MATH 103A,A03,093561,Staff,4,0,36,32
1656143451814,MATH 103A,B01,083779,Greenfeld; Be'Eri,8,1,36,28
1656143451814,MATH 103A,B02,083780,Greenfeld; Be'Eri,1,0,36,35
1656143451814,MATH 103A,B03,093562,Staff,0,0,36,36
1656143457848,MATH 105,A01,085443,Carter; Anne Toulson,4,1,35,31
1656143457848,MATH 105,A02,093477,Staff,11,0,35,24
1656143463881,MATH 109,A01,083213,Ganzberger; Geoffrey Michael,0,0,34,34
1656143463881,MATH 109,A02,083214,Ganzberger; Geoffrey Michael,0,0,34,34
1656143463881,MATH 109,A03,093478,Staff,1,0,34,33
1656143463881,MATH 109,B01,083215,Ganzberger; Geoffrey Michael,4,0,32,28
1656143463881,MATH 109,B02,083216,Ganzberger; Geoffrey Michael,1,0,32,31
1656143463881,MATH 109,B03,093479,Staff,4,0,32,28
1656143469909,MATH 142A,A01,083219,Chow; Bennett,1,0,32,31
1656143469909,MATH 142A,A02,083220,Chow; Bennett,8,0,32,24
1656143469909,MATH 142A,A03,093480,Staff,5,0,32,27
1656143469909,MATH 142A,B03,093481,Staff,4,0,32,28
1656143469909,MATH 142A,B04,093558,Staff,6,0,32,26
1656143469909,MATH 142A,B05,093559,Staff,0,0,32,32
1656143475943,MATH 193A,A01,083224,Rotar; Vladimir,0,1,34,34
1656143475943,MATH 193A,A02,083225,Rotar; Vladimir,0,0,34,34
1656143475943,MATH 193A,A03,083781,Rotar; Vladimir,0,0,34,34
1656143475943,MATH 193A,A04,083782,Rotar; Vladimir,6,0,34,28
1656143475943,MATH 193A,A05,093482,Rotar; Vladimir,1,0,34,33
1656143481967,MATH 197,001,091859,McAuley; Julian John,9999,0,9999,0
1656143481967,MATH 197,002,095566,Kedlaya; Kiran S.,9997,0,9999,2
1656143481967,MATH 197,003,095567,Xiao; Ming,9999,0,9999,0
1656143481967,MATH 197,004,095571,Perols; Johan Lars,9998,0,9999,1
1656143489029,COGS 9,A01,083615,Shannon; Kyle Michael,4,0,75,71
1656143495054,COGS 11,A01,083617,Boyle; Mary E. T.,15,0,48,33
1656143501091,COGS 13,A01,083071,Bastos; Amalia Pinkusfeld,6,0,71,65
1656143507116,COGS 14A,A01,092681,Semenuks; Arturs,4,15,100,96
1656143513142,COGS 14B,A01,083073,Cheng; Tzu-Han,7,0,63,56
1656143519169,COGS 17,A01,092677,Semenuks; Arturs,8,0,81,73
1656143525200,COGS 100,A01,083619,Allen; Michael Gordon,3,0,70,67
1656143531224,COGS 101A,A01,083621,Davis; Joshua Daniel,3,0,68,65
1656143537254,COGS 101B,A01,091572,Allen; Michael Gordon,6,0,65,59
1656143543278,COGS 101C,A01,083625,Delgado; Tania,10,0,35,25
1656143549314,COGS 107A,A01,083627,Boyle; Mary E. T.,1,0,60,59
1656143555343,COGS 118A,A01,083075,Gupta; Anjum,7,0,76,69
1656143561369,CSE 3,A50,083646,Miranda; Gregory Joseph,18,0,50,32
1656143567400,CSE 8A,A50,083650,Miranda; Gregory Joseph,3,3,56,53
1656143573424,CSE 11,A01,083080,Cao; Yingjun,1,54,40,39
1656143579453,CSE 12,A01,083652,Krause-Levy; Sophia Louisa,7,2,120,113
1656143585485,CSE 15L,A01,083654,Morris; Justin Loren,2,0,50,48
1656143585485,CSE 15L,A02,083655,Morris; Justin Loren,4,0,50,46
1656143591508,CSE 20,A01,083657,Tran; Khoa Dang,31,0,80,49
1656143597537,CSE 21,A01,095574,Bach; Quang Tran,25,0,48,23
1656143603571,CSE 30,A01,083084,Eldon; John,2,8,80,78
1656143603571,CSE 30,B01,095061,Bhaskar; Nishant,1,2,50,49
1656143609596,CSE 100,A01,083659,Cao; Yingjun,2,20,70,68
1656143615622,CSE 134B,A01,083661,Powell; Thomas Allan,3,0,100,97
1656143621651,CSE 140,A01,083663,Gungor; Onat,9,0,85,76
1656143627683,CSE 140L,A01,083088,Eldon; John,8,0,100,92
1656143633707,CSE 175,A01,083665,Kumar; Rakesh,0,0,25,25
1656143639732,CSE 190,A00,092507,Dubnov; Shlomo,2,0,20,18
1656143645757,ECE 45,A01,083139,Congero; Spencer William,1,0,75,74
1656143651787,ECE 65,A50,083695,Saad; Andrew S,8,0,30,22
1656143651787,ECE 65,A51,095125,Staff,23,0,26,3
1656143657813,ECE 109,A01,091882,Touri; Behrouz,0,1,70,70
1656143663841,ECE 180,A00,083140,Abi Samra; Nicholas Camill,1,0,30,29
1656143663841,ECE 180,B00,083141,Abi Samra; Nicholas Camill,0,4,30,30
1656143669874,MATH 10A,A01,083735,Patchell; Gregory David,0,0,30,30
1656143669874,MATH 10A,A02,083736,Patchell; Gregory David,22,0,30,8
1656143669874,MATH 10A,A03,083737,Patchell; Gregory David,16,0,30,14
1656143675911,MATH 10B,A01,083207,Lim; Seonhee,0,0,34,34
1656143675911,MATH 10B,A02,083208,Lim; Seonhee,7,0,35,28
1656143675911,MATH 10B,A03,093472,Staff,1,0,34,33
1656143675911,MATH 10B,B01,083739,Sinha; Shubham,11,0,30,19
1656143681938,MATH 18,A01,083743,Cinel; Cameron Alexander,7,0,30,23
1656143681938,MATH 18,A02,083744,Cinel; Cameron Alexander,10,0,30,20
1656143681938,MATH 18,A03,083745,Cinel; Cameron Alexander,4,0,30,26
1656143681938,MATH 18,B01,083748,Rideout; David Porter,0,0,36,36
1656143681938,MATH 18,B02,083749,Rideout; David Porter,0,0,36,36
1656143681938,MATH 18,B03,083750,Rideout; David Porter,0,0,36,36
1656143681938,MATH 18,B04,083751,Rideout; David Porter,0,0,36,36
1656143681938,MATH 18,B05,093473,Rideout; David Porter,1,0,36,35
1656143681938,MATH 18,B06,093474,Rideout; David Porter,4,0,36,32
1656143687963,MATH 20A,A01,083754,Zheng; Zequn,11,0,40,29
1656143693988,MATH 20B,A01,083756,Briones; Jor-el Thomas Caparas,0,0,36,36
1656143693988,MATH 20B,A02,083757,Briones; Jor-el Thomas Caparas,0,0,36,36
1656143693988,MATH 20B,A03,093475,Staff,2,0,36,34
1656143700016,MATH 20C,A01,083760,Briones; Jor-el Thomas Caparas,0,0,35,35
1656143700016,MATH 20C,A02,083761,Briones; Jor-el Thomas Caparas,9,1,35,26
1656143700016,MATH 20C,A03,093476,Staff,0,0,35,35
1656143700016,MATH 20C,B01,083762,Bach; Quang Tran,1,0,30,29
1656143706043,MATH 20D,A01,083765,Tran; Brian Kha,2,0,30,28
1656143706043,MATH 20D,A02,083766,Tran; Brian Kha,0,1,30,30
1656143706043,MATH 20D,A03,083767,Tran; Brian Kha,2,0,30,28
1656143712074,MATH 20E,A01,083771,Ganguly; Soumya,4,0,32,28
1656143712074,MATH 20E,A02,083772,Ganguly; Soumya,0,0,32,32
1656143712074,MATH 20E,B01,083773,Ciotti; Benjamin,15,0,35,20
1656143712074,MATH 20E,B02,083774,Ciotti; Benjamin,14,0,35,21
1656143718110,MATH 103A,A01,083777,Greenfeld; Be'Eri,1,0,36,35
1656143718110,MATH 103A,A02,083778,Greenfeld; Be'Eri,1,0,36,35
1656143718110,MATH 103A,A03,093561,Staff,4,0,36,32
1656143718110,MATH 103A,B01,083779,Greenfeld; Be'Eri,8,1,36,28
1656143718110,MATH 103A,B02,083780,Greenfeld; Be'Eri,1,0,36,35
1656143718110,MATH 103A,B03,093562,Staff,0,0,36,36
1656143724134,MATH 105,A01,085443,Carter; Anne Toulson,4,1,35,31
1656143724134,MATH 105,A02,093477,Staff,11,0,35,24
1656143730165,MATH 109,A01,083213,Ganzberger; Geoffrey Michael,0,0,34,34
1656143730165,MATH 109,A02,083214,Ganzberger; Geoffrey Michael,0,0,34,34
1656143730165,MATH 109,A03,093478,Staff,1,0,34,33
1656143730165,MATH 109,B01,083215,Ganzberger; Geoffrey Michael,4,0,32,28
1656143730165,MATH 109,B02,083216,Ganzberger; Geoffrey Michael,1,0,32,31
1656143730165,MATH 109,B03,093479,Staff,4,0,32,28
1656143736191,MATH 142A,A01,083219,Chow; Bennett,1,0,32,31
1656143736191,MATH 142A,A02,083220,Chow; Bennett,8,0,32,24
1656143736191,MATH 142A,A03,093480,Staff,5,0,32,27
1656143736191,MATH 142A,B03,093481,Staff,4,0,32,28
1656143736191,MATH 142A,B04,093558,Staff,6,0,32,26
1656143736191,MATH 142A,B05,093559,Staff,0,0,32,32
1656143742216,MATH 193A,A01,083224,Rotar; Vladimir,0,1,34,34
1656143742216,MATH 193A,A02,083225,Rotar; Vladimir,0,0,34,34
1656143742216,MATH 193A,A03,083781,Rotar; Vladimir,0,0,34,34
1656143742216,MATH 193A,A04,083782,Rotar; Vladimir,6,0,34,28
1656143742216,MATH 193A,A05,093482,Rotar; Vladimir,1,0,34,33
1656143748240,MATH 197,001,091859,McAuley; Julian John,9999,0,9999,0
1656143748240,MATH 197,002,095566,Kedlaya; Kiran S.,9997,0,9999,2
1656143748240,MATH 197,003,095567,Xiao; Ming,9999,0,9999,0
1656143748240,MATH 197,004,095571,Perols; Johan Lars,9998,0,9999,1
1656143755317,COGS 9,A01,083615,Shannon; Kyle Michael,4,0,75,71
1656143761345,COGS 11,A01,083617,Boyle; Mary E. T.,15,0,48,33
1656143767370,COGS 13,A01,083071,Bastos; Amalia Pinkusfeld,6,0,71,65
1656143773402,COGS 14A,A01,092681,Semenuks; Arturs,4,15,100,96
1656143779430,COGS 14B,A01,083073,Cheng; Tzu-Han,7,0,63,56
1656143785455,COGS 17,A01,092677,Semenuks; Arturs,8,0,81,73
1656143791479,COGS 100,A01,083619,Allen; Michael Gordon,3,0,70,67
1656143797502,COGS 101A,A01,083621,Davis; Joshua Daniel,3,0,68,65
1656143803531,COGS 101B,A01,091572,Allen; Michael Gordon,6,0,65,59
1656143809561,COGS 101C,A01,083625,Delgado; Tania,10,0,35,25
1656143815585,COGS 107A,A01,083627,Boyle; Mary E. T.,1,0,60,59
1656143821608,COGS 118A,A01,083075,Gupta; Anjum,7,0,76,69
1656143827633,CSE 3,A50,083646,Miranda; Gregory Joseph,18,0,50,32
1656143833675,CSE 8A,A50,083650,Miranda; Gregory Joseph,3,3,56,53
1656143839701,CSE 11,A01,083080,Cao; Yingjun,1,54,40,39
1656143845737,CSE 12,A01,083652,Krause-Levy; Sophia Louisa,7,2,120,113
1656143851767,CSE 15L,A01,083654,Morris; Justin Loren,2,0,50,48
1656143851767,CSE 15L,A02,083655,Morris; Justin Loren,4,0,50,46
1656143857790,CSE 20,A01,083657,Tran; Khoa Dang,31,0,80,49
1656143863814,CSE 21,A01,095574,Bach; Quang Tran,25,0,48,23
1656143869840,CSE 30,A01,083084,Eldon; John,2,8,80,78
1656143869840,CSE 30,B01,095061,Bhaskar; Nishant,1,2,50,49
1656143875864,CSE 100,A01,083659,Cao; Yingjun,2,20,70,68
1656143881894,CSE 134B,A01,083661,Powell; Thomas Allan,3,0,100,97
1656143887920,CSE 140,A01,083663,Gungor; Onat,9,0,85,76
1656143893944,CSE 140L,A01,083088,Eldon; John,8,0,100,92
1656143899967,CSE 175,A01,083665,Kumar; Rakesh,0,0,25,25
1656143906004,CSE 190,A00,092507,Dubnov; Shlomo,3,0,20,17
1656143912030,ECE 45,A01,083139,Congero; Spencer William,1,0,75,74
1656143918062,ECE 65,A50,083695,Saad; Andrew S,8,0,30,22
1656143918062,ECE 65,A51,095125,Staff,23,0,26,3
1656143924090,ECE 109,A01,091882,Touri; Behrouz,0,1,70,70
1656143930115,ECE 180,A00,083140,Abi Samra; Nicholas Camill,1,0,30,29
1656143930115,ECE 180,B00,083141,Abi Samra; Nicholas Camill,0,4,30,30
1656143936145,MATH 10A,A01,083735,Patchell; Gregory David,0,0,30,30
1656143936145,MATH 10A,A02,083736,Patchell; Gregory David,22,0,30,8
1656143936145,MATH 10A,A03,083737,Patchell; Gregory David,16,0,30,14
1656143942180,MATH 10B,A01,083207,Lim; Seonhee,0,0,34,34
1656143942180,MATH 10B,A02,083208,Lim; Seonhee,7,0,35,28
1656143942180,MATH 10B,A03,093472,Staff,1,0,34,33
1656143942180,MATH 10B,B01,083739,Sinha; Shubham,11,0,30,19
1656143948206,MATH 18,A01,083743,Cinel; Cameron Alexander,7,0,30,23
1656143948206,MATH 18,A02,083744,Cinel; Cameron Alexander,10,0,30,20
1656143948206,MATH 18,A03,083745,Cinel; Cameron Alexander,4,0,30,26
1656143948206,MATH 18,B01,083748,Rideout; David Porter,0,0,36,36
1656143948206,MATH 18,B02,083749,Rideout; David Porter,0,0,36,36
1656143948206,MATH 18,B03,083750,Rideout; David Porter,0,0,36,36
1656143948206,MATH 18,B04,083751,Rideout; David Porter,0,0,36,36
1656143948206,MATH 18,B05,093473,Rideout; David Porter,1,0,36,35
1656143948206,MATH 18,B06,093474,Rideout; David Porter,4,0,36,32
1656143954229,MATH 20A,A01,083754,Zheng; Zequn,11,0,40,29
1656143960259,MATH 20B,A01,083756,Briones; Jor-el Thomas Caparas,0,0,36,36
1656143960259,MATH 20B,A02,083757,Briones; Jor-el Thomas Caparas,0,0,36,36
1656143960259,MATH 20B,A03,093475,Staff,2,0,36,34
1656143966287,MATH 20C,A01,083760,Briones; Jor-el Thomas Caparas,0,0,35,35
1656143966287,MATH 20C,A02,083761,Briones; Jor-el Thomas Caparas,9,1,35,26
1656143966287,MATH 20C,A03,093476,Staff,0,0,35,35
1656143966287,MATH 20C,B01,083762,Bach; Quang Tran,1,0,30,29
1656143972312,MATH 20D,A01,083765,Tran; Brian Kha,2,0,30,28
1656143972312,MATH 20D,A02,083766,Tran; Brian Kha,0,1,30,30
1656143972312,MATH 20D,A03,083767,Tran; Brian Kha,2,0,30,28
1656143978342,MATH 20E,A01,083771,Ganguly; Soumya,4,0,32,28
1656143978342,MATH 20E,A02,083772,Ganguly; Soumya,0,0,32,32
1656143978342,MATH 20E,B01,083773,Ciotti; Benjamin,15,0,35,20
1656143978342,MATH 20E,B02,083774,Ciotti; Benjamin,14,0,35,21
1656143984372,MATH 103A,A01,083777,Greenfeld; Be'Eri,1,0,36,35
1656143984372,MATH 103A,A02,083778,Greenfeld; Be'Eri,1,0,36,35
1656143984372,MATH 103A,A03,093561,Staff,4,0,36,32
1656143984372,MATH 103A,B01,083779,Greenfeld; Be'Eri,8,1,36,28
1656143984372,MATH 103A,B02,083780,Greenfeld; Be'Eri,1,0,36,35
1656143984372,MATH 103A,B03,093562,Staff,0,0,36,36
1656143990396,MATH 105,A01,085443,Carter; Anne Toulson,4,1,35,31
1656143990396,MATH 105,A02,093477,Staff,11,0,35,24
1656143996421,MATH 109,A01,083213,Ganzberger; Geoffrey Michael,0,0,34,34
1656143996421,MATH 109,A02,083214,Ganzberger; Geoffrey Michael,0,0,34,34
1656143996421,MATH 109,A03,093478,Staff,1,0,34,33
1656143996421,MATH 109,B01,083215,Ganzberger; Geoffrey Michael,4,0,32,28
1656143996421,MATH 109,B02,083216,Ganzberger; Geoffrey Michael,1,0,32,31
1656143996421,MATH 109,B03,093479,Staff,4,0,32,28
1656144002446,MATH 142A,A01,083219,Chow; Bennett,1,0,32,31
1656144002446,MATH 142A,A02,083220,Chow; Bennett,8,0,32,24
1656144002446,MATH 142A,A03,093480,Staff,5,0,32,27
1656144002446,MATH 142A,B03,093481,Staff,4,0,32,28
1656144002446,MATH 142A,B04,093558,Staff,6,0,32,26
1656144002446,MATH 142A,B05,093559,Staff,0,0,32,32
1656144008481,MATH 193A,A01,083224,Rotar; Vladimir,0,1,34,34
1656144008481,MATH 193A,A02,083225,Rotar; Vladimir,0,0,34,34
1656144008481,MATH 193A,A03,083781,Rotar; Vladimir,0,0,34,34
1656144008481,MATH 193A,A04,083782,Rotar; Vladimir,6,0,34,28
1656144008481,MATH 193A,A05,093482,Rotar; Vladimir,1,0,34,33
1656144014508,MATH 197,001,091859,McAuley; Julian John,9999,0,9999,0
1656144014508,MATH 197,002,095566,Kedlaya; Kiran S.,9997,0,9999,2
1656144014508,MATH 197,003,095567,Xiao; Ming,9999,0,9999,0
1656144014508,MATH 197,004,095571,Perols; Johan Lars,9998,0,9999,1
1656144021662,COGS 9,A01,083615,Shannon; Kyle Michael,4,0,75,71
1656144027685,COGS 11,A01,083617,Boyle; Mary E. T.,15,0,48,33
1656144033715,COGS 13,A01,083071,Bastos; Amalia Pinkusfeld,6,0,71,65
1656144039738,COGS 14A,A01,092681,Semenuks; Arturs,4,15,100,96
1656144045762,COGS 14B,A01,083073,Cheng; Tzu-Han,7,0,63,56
1656144051797,COGS 17,A01,092677,Semenuks; Arturs,8,0,81,73
1656144057821,COGS 100,A01,083619,Allen; Michael Gordon,3,0,70,67
1656144063846,COGS 101A,A01,083621,Davis; Joshua Daniel,3,0,68,65
1656144069868,COGS 101B,A01,091572,Allen; Michael Gordon,6,0,65,59
1656144082870,COGS 101C,A01,083625,Delgado; Tania,10,0,35,25
1656144088896,COGS 107A,A01,083627,Boyle; Mary E. T.,1,0,60,59
1656144094923,COGS 118A,A01,083075,Gupta; Anjum,7,0,76,69
1656144100948,CSE 3,A50,083646,Miranda; Gregory Joseph,18,0,50,32
1656144106977,CSE 8A,A50,083650,Miranda; Gregory Joseph,3,3,56,53
1656144113000,CSE 11,A01,083080,Cao; Yingjun,1,54,40,39
1656144119024,CSE 12,A01,083652,Krause-Levy; Sophia Louisa,7,2,120,113
1656144125048,CSE 15L,A01,083654,Morris; Justin Loren,2,0,50,48
1656144125048,CSE 15L,A02,083655,Morris; Justin Loren,4,0,50,46
1656144131081,CSE 20,A01,083657,Tran; Khoa Dang,31,0,80,49
1656144137107,CSE 21,A01,095574,Bach; Quang Tran,25,0,48,23
1656144143135,CSE 30,A01,083084,Eldon; John,2,8,80,78
1656144143135,CSE 30,B01,095061,Bhaskar; Nishant,1,2,50,49
1656144149161,CSE 100,A01,083659,Cao; Yingjun,2,20,70,68
1656144155188,CSE 134B,A01,083661,Powell; Thomas Allan,3,0,100,97
1656144161217,CSE 140,A01,083663,Gungor; Onat,9,0,85,76
1656144167250,CSE 140L,A01,083088,Eldon; John,8,0,100,92
1656144173279,CSE 175,A01,083665,Kumar; Rakesh,0,0,25,25
1656144179304,CSE 190,A00,092507,Dubnov; Shlomo,3,0,20,17
1656144185337,ECE 45,A01,083139,Congero; Spencer William,1,0,75,74
1656144191370,ECE 65,A50,083695,Saad; Andrew S,8,0,30,22
1656144191370,ECE 65,A51,095125,Staff,23,0,26,3
1656144197397,ECE 109,A01,091882,Touri; Behrouz,0,1,70,70
1656144203422,ECE 180,A00,083140,Abi Samra; Nicholas Camill,1,0,30,29
1656144203422,ECE 180,B00,083141,Abi Samra; Nicholas Camill,0,4,30,30
1656144209453,MATH 10A,A01,083735,Patchell; Gregory David,0,0,30,30
1656144209453,MATH 10A,A02,083736,Patchell; Gregory David,22,0,30,8
1656144209453,MATH 10A,A03,083737,Patchell; Gregory David,16,0,30,14
1656144215482,MATH 10B,A01,083207,Lim; Seonhee,0,0,34,34
1656144215482,MATH 10B,A02,083208,Lim; Seonhee,7,0,35,28
1656144215482,MATH 10B,A03,093472,Staff,1,0,34,33
1656144215482,MATH 10B,B01,083739,Sinha; Shubham,11,0,30,19
1656144221522,MATH 18,A01,083743,Cinel; Cameron Alexander,7,0,30,23
1656144221522,MATH 18,A02,083744,Cinel; Cameron Alexander,10,0,30,20
1656144221522,MATH 18,A03,083745,Cinel; Cameron Alexander,4,0,30,26
1656144221522,MATH 18,B01,083748,Rideout; David Porter,0,0,36,36
1656144221522,MATH 18,B02,083749,Rideout; David Porter,0,0,36,36
1656144221522,MATH 18,B03,083750,Rideout; David Porter,0,0,36,36
1656144221522,MATH 18,B04,083751,Rideout; David Porter,0,0,36,36
1656144221522,MATH 18,B05,093473,Rideout; David Porter,1,0,36,35
1656144221522,MATH 18,B06,093474,Rideout; David Porter,4,0,36,32
1656144227553,MATH 20A,A01,083754,Zheng; Zequn,11,0,40,29
1656144233580,MATH 20B,A01,083756,Briones; Jor-el Thomas Caparas,0,0,36,36
1656144233580,MATH 20B,A02,083757,Briones; Jor-el Thomas Caparas,0,0,36,36
1656144233580,MATH 20B,A03,093475,Staff,2,0,36,34
1656144239606,MATH 20C,A01,083760,Briones; Jor-el Thomas Caparas,0,0,35,35
1656144239606,MATH 20C,A02,083761,Briones; Jor-el Thomas Caparas,9,1,35,26
1656144239606,MATH 20C,A03,093476,Staff,0,0,35,35
1656144239606,MATH 20C,B01,083762,Bach; Quang Tran,1,0,30,29
1656144245641,MATH 20D,A01,083765,Tran; Brian Kha,2,0,30,28
1656144245641,MATH 20D,A02,083766,Tran; Brian Kha,0,1,30,30
1656144245641,MATH 20D,A03,083767,Tran; Brian Kha,2,0,30,28
1656144251676,MATH 20E,A01,083771,Ganguly; Soumya,4,0,32,28
1656144251676,MATH 20E,A02,083772,Ganguly; Soumya,0,0,32,32
1656144251676,MATH 20E,B01,083773,Ciotti; Benjamin,15,0,35,20
1656144251676,MATH 20E,B02,083774,Ciotti; Benjamin,14,0,35,21
1656144257713,MATH 103A,A01,083777,Greenfeld; Be'Eri,1,0,36,35
1656144257713,MATH 103A,A02,083778,Greenfeld; Be'Eri,1,0,36,35
1656144257713,MATH 103A,A03,093561,Staff,4,0,36,32
1656144257713,MATH 103A,B01,083779,Greenfeld; Be'Eri,8,1,36,28
1656144257713,MATH 103A,B02,083780,Greenfeld; Be'Eri,1,0,36,35
1656144257713,MATH 103A,B03,093562,Staff,0,0,36,36
1656144263741,MATH 105,A01,085443,Carter; Anne Toulson,4,1,35,31
1656144263741,MATH 105,A02,093477,Staff,11,0,35,24
1656144269768,MATH 109,A01,083213,Ganzberger; Geoffrey Michael,0,0,34,34
1656144269768,MATH 109,A02,083214,Ganzberger; Geoffrey Michael,0,0,34,34
1656144269768,MATH 109,A03,093478,Staff,1,0,34,33
1656144269768,MATH 109,B01,083215,Ganzberger; Geoffrey Michael,4,0,32,28
1656144269768,MATH 109,B02,083216,Ganzberger; Geoffrey Michael,1,0,32,31
1656144269768,MATH 109,B03,093479,Staff,4,0,32,28
1656144275796,MATH 142A,A01,083219,Chow; Bennett,1,0,32,31
1656144275796,MATH 142A,A02,083220,Chow; Bennett,8,0,32,24
1656144275796,MATH 142A,A03,093480,Staff,5,0,32,27
1656144275796,MATH 142A,B03,093481,Staff,4,0,32,28
1656144275796,MATH 142A,B04,093558,Staff,6,0,32,26
1656144275796,MATH 142A,B05,093559,Staff,0,0,32,32
1656144281822,MATH 193A,A01,083224,Rotar; Vladimir,0,1,34,34
1656144281822,MATH 193A,A02,083225,Rotar; Vladimir,0,0,34,34
1656144281822,MATH 193A,A03,083781,Rotar; Vladimir,0,0,34,34
1656144281822,MATH 193A,A04,083782,Rotar; Vladimir,6,0,34,28
1656144281822,MATH 193A,A05,093482,Rotar; Vladimir,1,0,34,33
1656144287852,MATH 197,001,091859,McAuley; Julian John,9999,0,9999,0
1656144287852,MATH 197,002,095566,Kedlaya; Kiran S.,9997,0,9999,2
1656144287852,MATH 197,003,095567,Xiao; Ming,9999,0,9999,0
1656144287852,MATH 197,004,095571,Perols; Johan Lars,9998,0,9999,1
1656144294911,COGS 9,A01,083615,Shannon; Kyle Michael,4,0,75,71
1656144300935,COGS 11,A01,083617,Boyle; Mary E. T.,15,0,48,33
1656144306961,COGS 13,A01,083071,Bastos; Amalia Pinkusfeld,6,0,71,65
1656144312994,COGS 14A,A01,092681,Semenuks; Arturs,4,15,100,96
1656144319028,COGS 14B,A01,083073,Cheng; Tzu-Han,7,0,63,56
1656144325053,COGS 17,A01,092677,Semenuks; Arturs,8,0,81,73
1656144331082,COGS 100,A01,083619,Allen; Michael Gordon,3,0,70,67
1656144337109,COGS 101A,A01,083621,Davis; Joshua Daniel,3,0,68,65
1656144343132,COGS 101B,A01,091572,Allen; Michael Gordon,6,0,65,59
1656144349167,COGS 101C,A01,083625,Delgado; Tania,10,0,35,25
1656144355197,COGS 107A,A01,083627,Boyle; Mary E. T.,0,0,60,60
1656144361239,COGS 118A,A01,083075,Gupta; Anjum,7,0,76,69
1656144367265,CSE 3,A50,083646,Miranda; Gregory Joseph,18,0,50,32
1656144373298,CSE 8A,A50,083650,Miranda; Gregory Joseph,3,3,56,53
1656144379322,CSE 11,A01,083080,Cao; Yingjun,1,54,40,39
1656144385353,CSE 12,A01,083652,Krause-Levy; Sophia Louisa,7,2,120,113
1656144391385,CSE 15L,A01,083654,Morris; Justin Loren,2,0,50,48
1656144391385,CSE 15L,A02,083655,Morris; Justin Loren,4,0,50,46
1656144397418,CSE 20,A01,083657,Tran; Khoa Dang,31,0,80,49
1656144403448,CSE 21,A01,095574,Bach; Quang Tran,25,0,48,23
1656144409482,CSE 30,A01,083084,Eldon; John,2,8,80,78
1656144409482,CSE 30,B01,095061,Bhaskar; Nishant,1,2,50,49
1656144415510,CSE 100,A01,083659,Cao; Yingjun,2,20,70,68
1656144421547,CSE 134B,A01,083661,Powell; Thomas Allan,3,0,100,97
1656144427570,CSE 140,A01,083663,Gungor; Onat,9,0,85,76
1656144433596,CSE 140L,A01,083088,Eldon; John,8,0,100,92
1656144439629,CSE 175,A01,083665,Kumar; Rakesh,0,0,25,25
1656144445654,CSE 190,A00,092507,Dubnov; Shlomo,3,0,20,17
1656144451678,ECE 45,A01,083139,Congero; Spencer William,1,0,75,74
1656144457703,ECE 65,A50,083695,Saad; Andrew S,8,0,30,22
1656144457703,ECE 65,A51,095125,Staff,23,0,26,3
1656144463738,ECE 109,A01,091882,Touri; Behrouz,0,1,70,70
1656144469766,ECE 180,A00,083140,Abi Samra; Nicholas Camill,1,0,30,29
1656144469766,ECE 180,B00,083141,Abi Samra; Nicholas Camill,0,4,30,30
1656144475790,MATH 10A,A01,083735,Patchell; Gregory David,0,0,30,30
1656144475790,MATH 10A,A02,083736,Patchell; Gregory David,22,0,30,8
1656144475790,MATH 10A,A03,083737,Patchell; Gregory David,16,0,30,14
1656144481825,MATH 10B,A01,083207,Lim; Seonhee,0,0,34,34
1656144481825,MATH 10B,A02,083208,Lim; Seonhee,7,0,35,28
1656144481825,MATH 10B,A03,093472,Staff,1,0,34,33
1656144481825,MATH 10B,B01,083739,Sinha; Shubham,11,0,30,19
1656144487869,MATH 18,A01,083743,Cinel; Cameron Alexander,7,0,30,23
1656144487869,MATH 18,A02,083744,Cinel; Cameron Alexander,10,0,30,20
1656144487869,MATH 18,A03,083745,Cinel; Cameron Alexander,4,0,30,26
1656144487869,MATH 18,B01,083748,Rideout; David Porter,0,0,36,36
1656144487869,MATH 18,B02,083749,Rideout; David Porter,0,0,36,36
1656144487869,MATH 18,B03,083750,Rideout; David Porter,0,0,36,36
1656144487869,MATH 18,B04,083751,Rideout; David Porter,0,0,36,36
1656144487869,MATH 18,B05,093473,Rideout; David Porter,1,0,36,35
1656144487869,MATH 18,B06,093474,Rideout; David Porter,4,0,36,32
1656144493892,MATH 20A,A01,083754,Zheng; Zequn,11,0,40,29
1656144499916,MATH 20B,A01,083756,Briones; Jor-el Thomas Caparas,0,0,36,36
1656144499916,MATH 20B,A02,083757,Briones; Jor-el Thomas Caparas,0,0,36,36
1656144499916,MATH 20B,A03,093475,Staff,2,0,36,34
1656144505941,MATH 20C,A01,083760,Briones; Jor-el Thomas Caparas,0,0,35,35
1656144505941,MATH 20C,A02,083761,Briones; Jor-el Thomas Caparas,9,1,35,26
1656144505941,MATH 20C,A03,093476,Staff,0,0,35,35
1656144505941,MATH 20C,B01,083762,Bach; Quang Tran,1,0,30,29
1656144511966,MATH 20D,A01,083765,Tran; Brian Kha,2,0,30,28
1656144511966,MATH 20D,A02,083766,Tran; Brian Kha,0,1,30,30
1656144511966,MATH 20D,A03,083767,Tran; Brian Kha,2,0,30,28
1656144517989,MATH 20E,A01,083771,Ganguly; Soumya,4,0,32,28
1656144517989,MATH 20E,A02,083772,Ganguly; Soumya,0,0,32,32
1656144517989,MATH 20E,B01,083773,Ciotti; Benjamin,15,0,35,20
1656144517989,MATH 20E,B02,083774,Ciotti; Benjamin,14,0,35,21
1656144524023,MATH 103A,A01,083777,Greenfeld; Be'Eri,1,0,36,35
1656144524023,MATH 103A,A02,083778,Greenfeld; Be'Eri,1,0,36,35
1656144524023,MATH 103A,A03,093561,Staff,4,0,36,32
1656144524023,MATH 103A,B01,083779,Greenfeld; Be'Eri,8,1,36,28
1656144524023,MATH 103A,B02,083780,Greenfeld; Be'Eri,1,0,36,35
1656144524023,MATH 103A,B03,093562,Staff,0,0,36,36
1656144530050,MATH 105,A01,085443,Carter; Anne Toulson,4,1,35,31
1656144530050,MATH 105,A02,093477,Staff,11,0,35,24
1656144536088,MATH 109,A01,083213,Ganzberger; Geoffrey Michael,0,0,34,34
1656144536088,MATH 109,A02,083214,Ganzberger; Geoffrey Michael,0,0,34,34
1656144536088,MATH 109,A03,093478,Staff,1,0,34,33
1656144536088,MATH 109,B01,083215,Ganzberger; Geoffrey Michael,4,0,32,28
1656144536088,MATH 109,B02,083216,Ganzberger; Geoffrey Michael,1,0,32,31
1656144536088,MATH 109,B03,093479,Staff,4,0,32,28
1656144542113,MATH 142A,A01,083219,Chow; Bennett,1,0,32,31
1656144542113,MATH 142A,A02,083220,Chow; Bennett,8,0,32,24
1656144542113,MATH 142A,A03,093480,Staff,5,0,32,27
1656144542113,MATH 142A,B03,093481,Staff,4,0,32,28
1656144542113,MATH 142A,B04,093558,Staff,6,0,32,26
1656144542113,MATH 142A,B05,093559,Staff,0,0,32,32
1656144548140,MATH 193A,A01,083224,Rotar; Vladimir,0,1,34,34
1656144548140,MATH 193A,A02,083225,Rotar; Vladimir,0,0,34,34
1656144548140,MATH 193A,A03,083781,Rotar; Vladimir,0,0,34,34
1656144548140,MATH 193A,A04,083782,Rotar; Vladimir,6,0,34,28
1656144548140,MATH 193A,A05,093482,Rotar; Vladimir,1,0,34,33
1656144554165,MATH 197,001,091859,McAuley; Julian John,9999,0,9999,0
1656144554165,MATH 197,002,095566,Kedlaya; Kiran S.,9997,0,9999,2
1656144554165,MATH 197,003,095567,Xiao; Ming,9999,0,9999,0
1656144554165,MATH 197,004,095571,Perols; Johan Lars,9998,0,9999,1
1656144561236,COGS 9,A01,083615,Shannon; Kyle Michael,4,0,75,71
1656144567260,COGS 11,A01,083617,Boyle; Mary E. T.,15,0,48,33
1656144573285,COGS 13,A01,083071,Bastos; Amalia Pinkusfeld,6,0,71,65
1656144579311,COGS 14A,A01,092681,Semenuks; Arturs,4,15,100,96
1656144585334,COGS 14B,A01,083073,Cheng; Tzu-Han,7,0,63,56
1656144591362,COGS 17,A01,092677,Semenuks; Arturs,8,0,81,73
1656144597388,COGS 100,A01,083619,Allen; Michael Gordon,3,0,70,67
1656144603421,COGS 101A,A01,083621,Davis; Joshua Daniel,3,0,68,65
1656144609449,COGS 101B,A01,091572,Allen; Michael Gordon,6,0,65,59
1656144615472,COGS 101C,A01,083625,Delgado; Tania,10,0,35,25
1656144621576,COGS 107A,A01,083627,Boyle; Mary E. T.,0,0,60,60
1656144627606,COGS 118A,A01,083075,Gupta; Anjum,7,0,76,69
1656144633630,CSE 3,A50,083646,Miranda; Gregory Joseph,18,0,50,32
1656144639653,CSE 8A,A50,083650,Miranda; Gregory Joseph,3,3,56,53
1656144645677,CSE 11,A01,083080,Cao; Yingjun,1,54,40,39
1656144651701,CSE 12,A01,083652,Krause-Levy; Sophia Louisa,7,2,120,113
1656144657725,CSE 15L,A01,083654,Morris; Justin Loren,2,0,50,48
1656144657725,CSE 15L,A02,083655,Morris; Justin Loren,4,0,50,46
1656144663755,CSE 20,A01,083657,Tran; Khoa Dang,31,0,80,49
1656144669784,CSE 21,A01,095574,Bach; Quang Tran,25,0,48,23
1656144675806,CSE 30,A01,083084,Eldon; John,2,8,80,78
1656144675806,CSE 30,B01,095061,Bhaskar; Nishant,1,2,50,49
1656144681830,CSE 100,A01,083659,Cao; Yingjun,2,20,70,68
1656144687855,CSE 134B,A01,083661,Powell; Thomas Allan,3,0,100,97
1656144693878,CSE 140,A01,083663,Gungor; Onat,9,0,85,76
1656144699911,CSE 140L,A01,083088,Eldon; John,8,0,100,92
1656144705936,CSE 175,A01,083665,Kumar; Rakesh,0,0,25,25
1656144711964,CSE 190,A00,092507,Dubnov; Shlomo,3,0,20,17
1656144717991,ECE 45,A01,083139,Congero; Spencer William,1,0,75,74
1656144724018,ECE 65,A50,083695,Saad; Andrew S,8,0,30,22
1656144724018,ECE 65,A51,095125,Staff,23,0,26,3
1656144730042,ECE 109,A01,091882,Touri; Behrouz,0,1,70,70
1656144736069,ECE 180,A00,083140,Abi Samra; Nicholas Camill,1,0,30,29
1656144736069,ECE 180,B00,083141,Abi Samra; Nicholas Camill,0,4,30,30
1656144742099,MATH 10A,A01,083735,Patchell; Gregory David,0,0,30,30
1656144742099,MATH 10A,A02,083736,Patchell; Gregory David,22,0,30,8
1656144742099,MATH 10A,A03,083737,Patchell; Gregory David,16,0,30,14
1656144748127,MATH 10B,A01,083207,Lim; Seonhee,0,0,34,34
1656144748127,MATH 10B,A02,083208,Lim; Seonhee,7,0,35,28
1656144748127,MATH 10B,A03,093472,Staff,1,0,34,33
1656144748127,MATH 10B,B01,083739,Sinha; Shubham,11,0,30,19
1656144754157,MATH 18,A01,083743,Cinel; Cameron Alexander,7,0,30,23
1656144754157,MATH 18,A02,083744,Cinel; Cameron Alexander,10,0,30,20
1656144754157,MATH 18,A03,083745,Cinel; Cameron Alexander,4,0,30,26
1656144754157,MATH 18,B01,083748,Rideout; David Porter,0,0,36,36
1656144754157,MATH 18,B02,083749,Rideout; David Porter,0,0,36,36
1656144754157,MATH 18,B03,083750,Rideout; David Porter,0,0,36,36
1656144754157,MATH 18,B04,083751,Rideout; David Porter,0,0,36,36
1656144754157,MATH 18,B05,093473,Rideout; David Porter,1,0,36,35
1656144754157,MATH 18,B06,093474,Rideout; David Porter,4,0,36,32
1656144760186,MATH 20A,A01,083754,Zheng; Zequn,11,0,40,29
1656144766213,MATH 20B,A01,083756,Briones; Jor-el Thomas Caparas,0,0,36,36
1656144766213,MATH 20B,A02,083757,Briones; Jor-el Thomas Caparas,0,0,36,36
1656144766213,MATH 20B,A03,093475,Staff,2,0,36,34
1656144772238,MATH 20C,A01,083760,Briones; Jor-el Thomas Caparas,0,0,35,35
1656144772238,MATH 20C,A02,083761,Briones; Jor-el Thomas Caparas,9,1,35,26
1656144772238,MATH 20C,A03,093476,Staff,0,0,35,35
1656144772238,MATH 20C,B01,083762,Bach; Quang Tran,1,0,30,29
1656144778264,MATH 20D,A01,083765,Tran; Brian Kha,2,0,30,28
1656144778264,MATH 20D,A02,083766,Tran; Brian Kha,0,1,30,30
1656144778264,MATH 20D,A03,083767,Tran; Brian Kha,2,0,30,28
1656144784291,MATH 20E,A01,083771,Ganguly; Soumya,4,0,32,28
1656144784291,MATH 20E,A02,083772,Ganguly; Soumya,0,0,32,32
1656144784291,MATH 20E,B01,083773,Ciotti; Benjamin,15,0,35,20
1656144784291,MATH 20E,B02,083774,Ciotti; Benjamin,14,0,35,21
1656144790319,MATH 103A,A01,083777,Greenfeld; Be'Eri,1,0,36,35
1656144790319,MATH 103A,A02,083778,Greenfeld; Be'Eri,1,0,36,35
1656144790319,MATH 103A,A03,093561,Staff,4,0,36,32
1656144790319,MATH 103A,B01,083779,Greenfeld; Be'Eri,8,1,36,28
1656144790319,MATH 103A,B02,083780,Greenfeld; Be'Eri,1,0,36,35
1656144790319,MATH 103A,B03,093562,Staff,0,0,36,36
1656144796350,MATH 105,A01,085443,Carter; Anne Toulson,4,1,35,31
1656144796350,MATH 105,A02,093477,Staff,11,0,35,24
1656144802375,MATH 109,A01,083213,Ganzberger; Geoffrey Michael,0,0,34,34
1656144802375,MATH 109,A02,083214,Ganzberger; Geoffrey Michael,0,0,34,34
1656144802375,MATH 109,A03,093478,Staff,1,0,34,33
1656144802375,MATH 109,B01,083215,Ganzberger; Geoffrey Michael,4,0,32,28
1656144802375,MATH 109,B02,083216,Ganzberger; Geoffrey Michael,1,0,32,31
1656144802375,MATH 109,B03,093479,Staff,4,0,32,28
1656144808401,MATH 142A,A01,083219,Chow; Bennett,1,0,32,31
1656144808401,MATH 142A,A02,083220,Chow; Bennett,8,0,32,24
1656144808401,MATH 142A,A03,093480,Staff,5,0,32,27
1656144808401,MATH 142A,B03,093481,Staff,4,0,32,28
1656144808401,MATH 142A,B04,093558,Staff,6,0,32,26
1656144808401,MATH 142A,B05,093559,Staff,0,0,32,32
1656144814426,MATH 193A,A01,083224,Rotar; Vladimir,0,1,34,34
1656144814426,MATH 193A,A02,083225,Rotar; Vladimir,0,0,34,34
1656144814426,MATH 193A,A03,083781,Rotar; Vladimir,0,0,34,34
1656144814426,MATH 193A,A04,083782,Rotar; Vladimir,6,0,34,28
1656144814426,MATH 193A,A05,093482,Rotar; Vladimir,1,0,34,33
1656144820455,MATH 197,001,091859,McAuley; Julian John,9999,0,9999,0
1656144820455,MATH 197,002,095566,Kedlaya; Kiran S.,9997,0,9999,2
1656144820455,MATH 197,003,095567,Xiao; Ming,9999,0,9999,0
1656144820455,MATH 197,004,095571,Perols; Johan Lars,9998,0,9999,1
1656144827530,COGS 9,A01,083615,Shannon; Kyle Michael,4,0,75,71
1656144833555,COGS 11,A01,083617,Boyle; Mary E. T.,15,0,48,33
1656144839580,COGS 13,A01,083071,Bastos; Amalia Pinkusfeld,6,0,71,65
1656144845610,COGS 14A,A01,092681,Semenuks; Arturs,4,15,100,96
1656144851634,COGS 14B,A01,083073,Cheng; Tzu-Han,7,0,63,56
1656144857660,COGS 17,A01,092677,Semenuks; Arturs,8,0,81,73
1656144863688,COGS 100,A01,083619,Allen; Michael Gordon,3,0,70,67
1656144869713,COGS 101A,A01,083621,Davis; Joshua Daniel,3,0,68,65
1656144875737,COGS 101B,A01,091572,Allen; Michael Gordon,6,0,65,59
1656144881761,COGS 101C,A01,083625,Delgado; Tania,10,0,35,25
1656144887785,COGS 107A,A01,083627,Boyle; Mary E. T.,0,0,60,60
1656144893812,COGS 118A,A01,083075,Gupta; Anjum,7,0,76,69
1656144899837,CSE 3,A50,083646,Miranda; Gregory Joseph,18,0,50,32
1656144905866,CSE 8A,A50,083650,Miranda; Gregory Joseph,3,3,56,53
1656144911896,CSE 11,A01,083080,Cao; Yingjun,1,54,40,39
1656144917926,CSE 12,A01,083652,Krause-Levy; Sophia Louisa,7,2,120,113
1656144923953,CSE 15L,A01,083654,Morris; Justin Loren,2,0,50,48
1656144923953,CSE 15L,A02,083655,Morris; Justin Loren,4,0,50,46
1656144929977,CSE 20,A01,083657,Tran; Khoa Dang,31,0,80,49
1656144936005,CSE 21,A01,095574,Bach; Quang Tran,25,0,48,23
1656144942037,CSE 30,A01,083084,Eldon; John,2,8,80,78
1656144942037,CSE 30,B01,095061,Bhaskar; Nishant,1,2,50,49
1656144948065,CSE 100,A01,083659,Cao; Yingjun,2,20,70,68
1656144954092,CSE 134B,A01,083661,Powell; Thomas Allan,3,0,100,97
1656144960124,CSE 140,A01,083663,Gungor; Onat,9,0,85,76
1656144966147,CSE 140L,A01,083088,Eldon; John,8,0,100,92
1656144972177,CSE 175,A01,083665,Kumar; Rakesh,0,0,25,25
1656144978203,CSE 190,A00,092507,Dubnov; Shlomo,3,0,20,17
1656144984239,ECE 45,A01,083139,Congero; Spencer William,1,0,75,74
1656144990267,ECE 65,A50,083695,Saad; Andrew S,8,0,30,22
1656144990267,ECE 65,A51,095125,Staff,23,0,26,3
1656144996293,ECE 109,A01,091882,Touri; Behrouz,0,1,70,70
1656145002320,ECE 180,A00,083140,Abi Samra; Nicholas Camill,1,0,30,29
1656145002320,ECE 180,B00,083141,Abi Samra; Nicholas Camill,0,4,30,30
1656145008351,MATH 10A,A01,083735,Patchell; Gregory David,0,0,30,30
1656145008351,MATH 10A,A02,083736,Patchell; Gregory David,22,0,30,8
1656145008351,MATH 10A,A03,083737,Patchell; Gregory David,16,0,30,14
1656145014375,MATH 10B,A01,083207,Lim; Seonhee,0,0,34,34
1656145014375,MATH 10B,A02,083208,Lim; Seonhee,7,0,35,28
1656145014375,MATH 10B,A03,093472,Staff,1,0,34,33
1656145014375,MATH 10B,B01,083739,Sinha; Shubham,9,0,30,21
1656145020403,MATH 18,A01,083743,Cinel; Cameron Alexander,7,0,30,23
1656145020403,MATH 18,A02,083744,Cinel; Cameron Alexander,10,0,30,20
1656145020403,MATH 18,A03,083745,Cinel; Cameron Alexander,4,0,30,26
1656145020403,MATH 18,B01,083748,Rideout; David Porter,0,0,36,36
1656145020403,MATH 18,B02,083749,Rideout; David Porter,0,0,36,36
1656145020403,MATH 18,B03,083750,Rideout; David Porter,0,0,36,36
1656145020403,MATH 18,B04,083751,Rideout; David Porter,0,0,36,36
1656145020403,MATH 18,B05,093473,Rideout; David Porter,1,0,36,35
1656145020403,MATH 18,B06,093474,Rideout; David Porter,4,0,36,32
1656145026432,MATH 20A,A01,083754,Zheng; Zequn,11,0,40,29
1656145032458,MATH 20B,A01,083756,Briones; Jor-el Thomas Caparas,0,0,36,36
1656145032458,MATH 20B,A02,083757,Briones; Jor-el Thomas Caparas,0,0,36,36
1656145032458,MATH 20B,A03,093475,Staff,2,0,36,34
1656145038484,MATH 20C,A01,083760,Briones; Jor-el Thomas Caparas,0,0,35,35
1656145038484,MATH 20C,A02,083761,Briones; Jor-el Thomas Caparas,9,1,35,26
1656145038484,MATH 20C,A03,093476,Staff,0,0,35,35
1656145038484,MATH 20C,B01,083762,Bach; Quang Tran,1,0,30,29
1656145044551,MATH 20D,A01,083765,Tran; Brian Kha,2,0,30,28
1656145044551,MATH 20D,A02,083766,Tran; Brian Kha,0,1,30,30
1656145044551,MATH 20D,A03,083767,Tran; Brian Kha,2,0,30,28
1656145050596,MATH 20E,A01,083771,Ganguly; Soumya,4,0,32,28
1656145050596,MATH 20E,A02,083772,Ganguly; Soumya,0,0,32,32
1656145050596,MATH 20E,B01,083773,Ciotti; Benjamin,15,0,35,20
1656145050596,MATH 20E,B02,083774,Ciotti; Benjamin,14,0,35,21
1656145056624,MATH 103A,A01,083777,Greenfeld; Be'Eri,1,0,36,35
1656145056624,MATH 103A,A02,083778,Greenfeld; Be'Eri,1,0,36,35
1656145056624,MATH 103A,A03,093561,Staff,4,0,36,32
1656145056624,MATH 103A,B01,083779,Greenfeld; Be'Eri,8,1,36,28
1656145056624,MATH 103A,B02,083780,Greenfeld; Be'Eri,1,0,36,35
1656145056624,MATH 103A,B03,093562,Staff,0,0,36,36
1656145062650,MATH 105,A01,085443,Carter; Anne Toulson,4,1,35,31
1656145062650,MATH 105,A02,093477,Staff,11,0,35,24
1656145068676,MATH 109,A01,083213,Ganzberger; Geoffrey Michael,0,0,34,34
1656145068676,MATH 109,A02,083214,Ganzberger; Geoffrey Michael,0,0,34,34
1656145068676,MATH 109,A03,093478,Staff,1,0,34,33
1656145068676,MATH 109,B01,083215,Ganzberger; Geoffrey Michael,4,0,32,28
1656145068676,MATH 109,B02,083216,Ganzberger; Geoffrey Michael,1,0,32,31
1656145068676,MATH 109,B03,093479,Staff,4,0,32,28
1656145074701,MATH 142A,A01,083219,Chow; Bennett,1,0,32,31
1656145074701,MATH 142A,A02,083220,Chow; Bennett,8,0,32,24
1656145074701,MATH 142A,A03,093480,Staff,5,0,32,27
1656145074701,MATH 142A,B03,093481,Staff,4,0,32,28
1656145074701,MATH 142A,B04,093558,Staff,6,0,32,26
1656145074701,MATH 142A,B05,093559,Staff,0,0,32,32
1656145080726,MATH 193A,A01,083224,Rotar; Vladimir,0,1,34,34
1656145080726,MATH 193A,A02,083225,Rotar; Vladimir,0,0,34,34
1656145080726,MATH 193A,A03,083781,Rotar; Vladimir,0,0,34,34
1656145080726,MATH 193A,A04,083782,Rotar; Vladimir,6,0,34,28
1656145080726,MATH 193A,A05,093482,Rotar; Vladimir,1,0,34,33
1656145086753,MATH 197,001,091859,McAuley; Julian John,9999,0,9999,0
1656145086753,MATH 197,002,095566,Kedlaya; Kiran S.,9997,0,9999,2
1656145086753,MATH 197,003,095567,Xiao; Ming,9999,0,9999,0
1656145086753,MATH 197,004,095571,Perols; Johan Lars,9998,0,9999,1
1656145093843,COGS 9,A01,083615,Shannon; Kyle Michael,4,0,75,71
1656145099874,COGS 11,A01,083617,Boyle; Mary E. T.,15,0,48,33
1656145105911,COGS 13,A01,083071,Bastos; Amalia Pinkusfeld,6,0,71,65
1656145111944,COGS 14A,A01,092681,Semenuks; Arturs,4,15,100,96
1656145117968,COGS 14B,A01,083073,Cheng; Tzu-Han,7,0,63,56
1656145123997,COGS 17,A01,092677,Semenuks; Arturs,8,0,81,73
1656145130021,COGS 100,A01,083619,Allen; Michael Gordon,3,0,70,67
1656145136045,COGS 101A,A01,083621,Davis; Joshua Daniel,3,0,68,65
1656145142072,COGS 101B,A01,091572,Allen; Michael Gordon,6,0,65,59
1656145148101,COGS 101C,A01,083625,Delgado; Tania,10,0,35,25
1656145154125,COGS 107A,A01,083627,Boyle; Mary E. T.,0,0,60,60
1656145160149,COGS 118A,A01,083075,Gupta; Anjum,7,0,76,69
1656145166173,CSE 3,A50,083646,Miranda; Gregory Joseph,18,0,50,32
1656145172201,CSE 8A,A50,083650,Miranda; Gregory Joseph,3,3,56,53
1656145178229,CSE 11,A01,083080,Cao; Yingjun,1,54,40,39
1656145184254,CSE 12,A01,083652,Krause-Levy; Sophia Louisa,7,2,120,113
1656145190281,CSE 15L,A01,083654,Morris; Justin Loren,2,0,50,48
1656145190281,CSE 15L,A02,083655,Morris; Justin Loren,4,0,50,46
1656145196304,CSE 20,A01,083657,Tran; Khoa Dang,31,0,80,49
1656145202328,CSE 21,A01,095574,Bach; Quang Tran,25,0,48,23
1656145208357,CSE 30,A01,083084,Eldon; John,2,8,80,78
1656145208357,CSE 30,B01,095061,Bhaskar; Nishant,1,2,50,49
1656145214388,CSE 100,A01,083659,Cao; Yingjun,2,20,70,68
1656145220489,CSE 134B,A01,083661,Powell; Thomas Allan,3,0,100,97
1656145226522,CSE 140,A01,083663,Gungor; Onat,9,0,85,76
1656145232556,CSE 140L,A01,083088,Eldon; John,8,0,100,92
1656145238583,CSE 175,A01,083665,Kumar; Rakesh,0,0,25,25
1656145244610,CSE 190,A00,092507,Dubnov; Shlomo,3,0,20,17
1656145250637,ECE 45,A01,083139,Congero; Spencer William,1,0,75,74
1656145256660,ECE 65,A50,083695,Saad; Andrew S,8,0,30,22
1656145256660,ECE 65,A51,095125,Staff,23,0,26,3
1656145262686,ECE 109,A01,091882,Touri; Behrouz,0,1,70,70
1656145268714,ECE 180,A00,083140,Abi Samra; Nicholas Camill,1,0,30,29
1656145268714,ECE 180,B00,083141,Abi Samra; Nicholas Camill,0,4,30,30
1656145274737,MATH 10A,A01,083735,Patchell; Gregory David,0,0,30,30
1656145274737,MATH 10A,A02,083736,Patchell; Gregory David,22,0,30,8
1656145274737,MATH 10A,A03,083737,Patchell; Gregory David,16,0,30,14
1656145280764,MATH 10B,A01,083207,Lim; Seonhee,0,0,34,34
1656145280764,MATH 10B,A02,083208,Lim; Seonhee,7,0,35,28
1656145280764,MATH 10B,A03,093472,Staff,1,0,34,33
1656145280764,MATH 10B,B01,083739,Sinha; Shubham,10,0,30,20
1656145286793,MATH 18,A01,083743,Cinel; Cameron Alexander,7,0,30,23
1656145286793,MATH 18,A02,083744,Cinel; Cameron Alexander,10,0,30,20
1656145286793,MATH 18,A03,083745,Cinel; Cameron Alexander,4,0,30,26
1656145286793,MATH 18,B01,083748,Rideout; David Porter,0,0,36,36
1656145286793,MATH 18,B02,083749,Rideout; David Porter,0,0,36,36
1656145286793,MATH 18,B03,083750,Rideout; David Porter,0,0,36,36
1656145286793,MATH 18,B04,083751,Rideout; David Porter,0,0,36,36
1656145286793,MATH 18,B05,093473,Rideout; David Porter,1,0,36,35
1656145286793,MATH 18,B06,093474,Rideout; David Porter,4,0,36,32
1656145292817,MATH 20A,A01,083754,Zheng; Zequn,11,0,40,29
1656145298847,MATH 20B,A01,083756,Briones; Jor-el Thomas Caparas,0,0,36,36
1656145298847,MATH 20B,A02,083757,Briones; Jor-el Thomas Caparas,0,0,36,36
1656145298847,MATH 20B,A03,093475,Staff,2,0,36,34
1656145304875,MATH 20C,A01,083760,Briones; Jor-el Thomas Caparas,0,0,35,35
1656145304875,MATH 20C,A02,083761,Briones; Jor-el Thomas Caparas,9,1,35,26
1656145304875,MATH 20C,A03,093476,Staff,0,0,35,35
1656145304875,MATH 20C,B01,083762,Bach; Quang Tran,1,0,30,29
1656145310904,MATH 20D,A01,083765,Tran; Brian Kha,2,0,30,28
1656145310904,MATH 20D,A02,083766,Tran; Brian Kha,0,1,30,30
1656145310904,MATH 20D,A03,083767,Tran; Brian Kha,2,0,30,28
1656145316935,MATH 20E,A01,083771,Ganguly; Soumya,4,0,32,28
1656145316935,MATH 20E,A02,083772,Ganguly; Soumya,0,0,32,32
1656145316935,MATH 20E,B01,083773,Ciotti; Benjamin,15,0,35,20
1656145316935,MATH 20E,B02,083774,Ciotti; Benjamin,14,0,35,21
1656145322959,MATH 103A,A01,083777,Greenfeld; Be'Eri,1,0,36,35
1656145322959,MATH 103A,A02,083778,Greenfeld; Be'Eri,1,0,36,35
1656145322959,MATH 103A,A03,093561,Staff,4,0,36,32
1656145322959,MATH 103A,B01,083779,Greenfeld; Be'Eri,8,1,36,28
1656145322959,MATH 103A,B02,083780,Greenfeld; Be'Eri,1,0,36,35
1656145322959,MATH 103A,B03,093562,Staff,0,0,36,36
1656145328983,MATH 105,A01,085443,Carter; Anne Toulson,4,1,35,31
1656145328983,MATH 105,A02,093477,Staff,11,0,35,24
1656145335010,MATH 109,A01,083213,Ganzberger; Geoffrey Michael,0,0,34,34
1656145335010,MATH 109,A02,083214,Ganzberger; Geoffrey Michael,0,0,34,34
1656145335010,MATH 109,A03,093478,Staff,1,0,34,33
1656145335010,MATH 109,B01,083215,Ganzberger; Geoffrey Michael,4,0,32,28
1656145335010,MATH 109,B02,083216,Ganzberger; Geoffrey Michael,1,0,32,31
1656145335010,MATH 109,B03,093479,Staff,4,0,32,28
1656145341039,MATH 142A,A01,083219,Chow; Bennett,1,0,32,31
1656145341039,MATH 142A,A02,083220,Chow; Bennett,8,0,32,24
1656145341039,MATH 142A,A03,093480,Staff,5,0,32,27
1656145341039,MATH 142A,B03,093481,Staff,4,0,32,28
1656145341039,MATH 142A,B04,093558,Staff,6,0,32,26
1656145341039,MATH 142A,B05,093559,Staff,0,0,32,32
1656145347071,MATH 193A,A01,083224,Rotar; Vladimir,0,1,34,34
1656145347071,MATH 193A,A02,083225,Rotar; Vladimir,0,0,34,34
1656145347071,MATH 193A,A03,083781,Rotar; Vladimir,0,0,34,34
1656145347071,MATH 193A,A04,083782,Rotar; Vladimir,6,0,34,28
1656145347071,MATH 193A,A05,093482,Rotar; Vladimir,1,0,34,33
1656145353097,MATH 197,001,091859,McAuley; Julian John,9999,0,9999,0
1656145353097,MATH 197,002,095566,Kedlaya; Kiran S.,9997,0,9999,2
1656145353097,MATH 197,003,095567,Xiao; Ming,9999,0,9999,0
1656145353097,MATH 197,004,095571,Perols; Johan Lars,9998,0,9999,1
1656145360168,COGS 9,A01,083615,Shannon; Kyle Michael,4,0,75,71
1656145366201,COGS 11,A01,083617,Boyle; Mary E. T.,15,0,48,33
1656145372227,COGS 13,A01,083071,Bastos; Amalia Pinkusfeld,6,0,71,65
1656145378254,COGS 14A,A01,092681,Semenuks; Arturs,4,15,100,96
1656145384278,COGS 14B,A01,083073,Cheng; Tzu-Han,7,0,63,56
1656145390301,COGS 17,A01,092677,Semenuks; Arturs,8,0,81,73
1656145396324,COGS 100,A01,083619,Allen; Michael Gordon,3,0,70,67
1656145402349,COGS 101A,A01,083621,Davis; Joshua Daniel,3,0,68,65
1656145408373,COGS 101B,A01,091572,Allen; Michael Gordon,6,0,65,59
1656145414398,COGS 101C,A01,083625,Delgado; Tania,10,0,35,25
1656145420423,COGS 107A,A01,083627,Boyle; Mary E. T.,0,0,60,60
1656145426449,COGS 118A,A01,083075,Gupta; Anjum,7,0,76,69
1656145432473,CSE 3,A50,083646,Miranda; Gregory Joseph,18,0,50,32
1656145438503,CSE 8A,A50,083650,Miranda; Gregory Joseph,3,3,56,53
1656145444525,CSE 11,A01,083080,Cao; Yingjun,1,54,40,39
1656145450566,CSE 12,A01,083652,Krause-Levy; Sophia Louisa,7,2,120,113
1656145456591,CSE 15L,A01,083654,Morris; Justin Loren,2,0,50,48
1656145456591,CSE 15L,A02,083655,Morris; Justin Loren,4,0,50,46
1656145462615,CSE 20,A01,083657,Tran; Khoa Dang,31,0,80,49
1656145468640,CSE 21,A01,095574,Bach; Quang Tran,25,0,48,23
1656145474672,CSE 30,A01,083084,Eldon; John,2,8,80,78
1656145474672,CSE 30,B01,095061,Bhaskar; Nishant,1,2,50,49
1656145480696,CSE 100,A01,083659,Cao; Yingjun,2,20,70,68
1656145486727,CSE 134B,A01,083661,Powell; Thomas Allan,3,0,100,97
1656145492755,CSE 140,A01,083663,Gungor; Onat,9,0,85,76
1656145498781,CSE 140L,A01,083088,Eldon; John,8,0,100,92
1656145504807,CSE 175,A01,083665,Kumar; Rakesh,0,0,25,25
1656145510832,CSE 190,A00,092507,Dubnov; Shlomo,3,0,20,17
1656145516871,ECE 45,A01,083139,Congero; Spencer William,1,0,75,74
1656145522896,ECE 65,A50,083695,Saad; Andrew S,8,0,30,22
1656145522896,ECE 65,A51,095125,Staff,23,0,26,3
1656145528931,ECE 109,A01,091882,Touri; Behrouz,0,1,70,70
1656145534956,ECE 180,A00,083140,Abi Samra; Nicholas Camill,1,0,30,29
1656145534956,ECE 180,B00,083141,Abi Samra; Nicholas Camill,0,4,30,30
1656145540993,MATH 10A,A01,083735,Patchell; Gregory David,0,0,30,30
1656145540993,MATH 10A,A02,083736,Patchell; Gregory David,22,0,30,8
1656145540993,MATH 10A,A03,083737,Patchell; Gregory David,16,0,30,14
1656145547020,MATH 10B,A01,083207,Lim; Seonhee,0,0,34,34
1656145547020,MATH 10B,A02,083208,Lim; Seonhee,7,0,35,28
1656145547020,MATH 10B,A03,093472,Staff,1,0,34,33
1656145547020,MATH 10B,B01,083739,Sinha; Shubham,10,0,30,20
1656145553057,MATH 18,A01,083743,Cinel; Cameron Alexander,7,0,30,23
1656145553057,MATH 18,A02,083744,Cinel; Cameron Alexander,10,0,30,20
1656145553057,MATH 18,A03,083745,Cinel; Cameron Alexander,4,0,30,26
1656145553057,MATH 18,B01,083748,Rideout; David Porter,0,0,36,36
1656145553057,MATH 18,B02,083749,Rideout; David Porter,0,0,36,36
1656145553057,MATH 18,B03,083750,Rideout; David Porter,0,0,36,36
1656145553057,MATH 18,B04,083751,Rideout; David Porter,0,0,36,36
1656145553057,MATH 18,B05,093473,Rideout; David Porter,1,0,36,35
1656145553057,MATH 18,B06,093474,Rideout; David Porter,4,0,36,32
1656145559091,MATH 20A,A01,083754,Zheng; Zequn,11,0,40,29
1656145565118,MATH 20B,A01,083756,Briones; Jor-el Thomas Caparas,0,0,36,36
1656145565118,MATH 20B,A02,083757,Briones; Jor-el Thomas Caparas,0,0,36,36
1656145565118,MATH 20B,A03,093475,Staff,2,0,36,34
1656145571152,MATH 20C,A01,083760,Briones; Jor-el Thomas Caparas,0,0,35,35
1656145571152,MATH 20C,A02,083761,Briones; Jor-el Thomas Caparas,9,1,35,26
1656145571152,MATH 20C,A03,093476,Staff,0,0,35,35
1656145571152,MATH 20C,B01,083762,Bach; Quang Tran,1,0,30,29
1656145577178,MATH 20D,A01,083765,Tran; Brian Kha,2,0,30,28
1656145577178,MATH 20D,A02,083766,Tran; Brian Kha,0,1,30,30
1656145577178,MATH 20D,A03,083767,Tran; Brian Kha,2,0,30,28
1656145583204,MATH 20E,A01,083771,Ganguly; Soumya,4,0,32,28
1656145583204,MATH 20E,A02,083772,Ganguly; Soumya,0,0,32,32
1656145583204,MATH 20E,B01,083773,Ciotti; Benjamin,15,0,35,20
1656145583204,MATH 20E,B02,083774,Ciotti; Benjamin,14,0,35,21
1656145589243,MATH 103A,A01,083777,Greenfeld; Be'Eri,1,0,36,35
1656145589243,MATH 103A,A02,083778,Greenfeld; Be'Eri,1,0,36,35
1656145589243,MATH 103A,A03,093561,Staff,4,0,36,32
1656145589243,MATH 103A,B01,083779,Greenfeld; Be'Eri,8,1,36,28
1656145589243,MATH 103A,B02,083780,Greenfeld; Be'Eri,1,0,36,35
1656145589243,MATH 103A,B03,093562,Staff,0,0,36,36
1656145595272,MATH 105,A01,085443,Carter; Anne Toulson,4,1,35,31
1656145595272,MATH 105,A02,093477,Staff,11,0,35,24
1656145601298,MATH 109,A01,083213,Ganzberger; Geoffrey Michael,0,0,34,34
1656145601298,MATH 109,A02,083214,Ganzberger; Geoffrey Michael,0,0,34,34
1656145601298,MATH 109,A03,093478,Staff,1,0,34,33
1656145601298,MATH 109,B01,083215,Ganzberger; Geoffrey Michael,4,0,32,28
1656145601298,MATH 109,B02,083216,Ganzberger; Geoffrey Michael,1,0,32,31
1656145601298,MATH 109,B03,093479,Staff,4,0,32,28
1656145607330,MATH 142A,A01,083219,Chow; Bennett,1,0,32,31
1656145607330,MATH 142A,A02,083220,Chow; Bennett,8,0,32,24
1656145607330,MATH 142A,A03,093480,Staff,5,0,32,27
1656145607330,MATH 142A,B03,093481,Staff,4,0,32,28
1656145607330,MATH 142A,B04,093558,Staff,6,0,32,26
1656145607330,MATH 142A,B05,093559,Staff,0,0,32,32
1656145613355,MATH 193A,A01,083224,Rotar; Vladimir,0,1,34,34
1656145613355,MATH 193A,A02,083225,Rotar; Vladimir,0,0,34,34
1656145613355,MATH 193A,A03,083781,Rotar; Vladimir,0,0,34,34
1656145613355,MATH 193A,A04,083782,Rotar; Vladimir,6,0,34,28
1656145613355,MATH 193A,A05,093482,Rotar; Vladimir,1,0,34,33
1656145619385,MATH 197,001,091859,McAuley; Julian John,9999,0,9999,0
1656145619385,MATH 197,002,095566,Kedlaya; Kiran S.,9997,0,9999,2
1656145619385,MATH 197,003,095567,Xiao; Ming,9999,0,9999,0
1656145619385,MATH 197,004,095571,Perols; Johan Lars,9998,0,9999,1
1656145626462,COGS 9,A01,083615,Shannon; Kyle Michael,4,0,75,71
1656145632490,COGS 11,A01,083617,Boyle; Mary E. T.,15,0,48,33
1656145638513,COGS 13,A01,083071,Bastos; Amalia Pinkusfeld,6,0,71,65
1656145644550,COGS 14A,A01,092681,Semenuks; Arturs,4,15,100,96
1656145650574,COGS 14B,A01,083073,Cheng; Tzu-Han,7,0,63,56
1656145656600,COGS 17,A01,092677,Semenuks; Arturs,8,0,81,73
1656145662627,COGS 100,A01,083619,Allen; Michael Gordon,3,0,70,67
1656145668652,COGS 101A,A01,083621,Davis; Joshua Daniel,3,0,68,65
1656145674680,COGS 101B,A01,091572,Allen; Michael Gordon,6,0,65,59
1656145680712,COGS 101C,A01,083625,Delgado; Tania,10,0,35,25
1656145686743,COGS 107A,A01,083627,Boyle; Mary E. T.,0,0,60,60
1656145692770,COGS 118A,A01,083075,Gupta; Anjum,7,0,76,69
1656145698796,CSE 3,A50,083646,Miranda; Gregory Joseph,18,0,50,32
1656145704835,CSE 8A,A50,083650,Miranda; Gregory Joseph,3,3,56,53
1656145710862,CSE 11,A01,083080,Cao; Yingjun,1,54,40,39
1656145716901,CSE 12,A01,083652,Krause-Levy; Sophia Louisa,7,2,120,113
1656145722926,CSE 15L,A01,083654,Morris; Justin Loren,2,0,50,48
1656145722926,CSE 15L,A02,083655,Morris; Justin Loren,4,0,50,46
1656145728955,CSE 20,A01,083657,Tran; Khoa Dang,31,0,80,49
1656145734979,CSE 21,A01,095574,Bach; Quang Tran,25,0,48,23
1656145741010,CSE 30,A01,083084,Eldon; John,2,8,80,78
1656145741010,CSE 30,B01,095061,Bhaskar; Nishant,1,2,50,49
1656145747034,CSE 100,A01,083659,Cao; Yingjun,2,20,70,68
1656145753057,CSE 134B,A01,083661,Powell; Thomas Allan,3,0,100,97
1656145759084,CSE 140,A01,083663,Gungor; Onat,9,0,85,76
1656145765109,CSE 140L,A01,083088,Eldon; John,8,0,100,92
1656145771151,CSE 175,A01,083665,Kumar; Rakesh,0,0,25,25
1656145777178,CSE 190,A00,092507,Dubnov; Shlomo,3,0,20,17
1656145783208,ECE 45,A01,083139,Congero; Spencer William,1,0,75,74
1656145789233,ECE 65,A50,083695,Saad; Andrew S,8,0,30,22
1656145789233,ECE 65,A51,095125,Staff,23,0,26,3
1656145795262,ECE 109,A01,091882,Touri; Behrouz,0,1,70,70
1656145801291,ECE 180,A00,083140,Abi Samra; Nicholas Camill,1,0,30,29
1656145801291,ECE 180,B00,083141,Abi Samra; Nicholas Camill,0,4,30,30
1656145807321,MATH 10A,A01,083735,Patchell; Gregory David,0,0,30,30
1656145807321,MATH 10A,A02,083736,Patchell; Gregory David,22,0,30,8
1656145807321,MATH 10A,A03,083737,Patchell; Gregory David,16,0,30,14
1656145813348,MATH 10B,A01,083207,Lim; Seonhee,0,0,34,34
1656145813348,MATH 10B,A02,083208,Lim; Seonhee,7,0,35,28
1656145813348,MATH 10B,A03,093472,Staff,1,0,34,33
1656145813348,MATH 10B,B01,083739,Sinha; Shubham,10,0,30,20
1656145819515,MATH 18,A01,083743,Cinel; Cameron Alexander,7,0,30,23
1656145819515,MATH 18,A02,083744,Cinel; Cameron Alexander,10,0,30,20
1656145819515,MATH 18,A03,083745,Cinel; Cameron Alexander,4,0,30,26
1656145819515,MATH 18,B01,083748,Rideout; David Porter,0,0,36,36
1656145819515,MATH 18,B02,083749,Rideout; David Porter,0,0,36,36
1656145819515,MATH 18,B03,083750,Rideout; David Porter,0,0,36,36
1656145819515,MATH 18,B04,083751,Rideout; David Porter,0,0,36,36
1656145819515,MATH 18,B05,093473,Rideout; David Porter,1,0,36,35
1656145819515,MATH 18,B06,093474,Rideout; David Porter,4,0,36,32
1656145825539,MATH 20A,A01,083754,Zheng; Zequn,11,0,40,29
1656145831570,MATH 20B,A01,083756,Briones; Jor-el Thomas Caparas,0,0,36,36
1656145831570,MATH 20B,A02,083757,Briones; Jor-el Thomas Caparas,0,0,36,36
1656145831570,MATH 20B,A03,093475,Staff,2,0,36,34
1656145837593,MATH 20C,A01,083760,Briones; Jor-el Thomas Caparas,0,0,35,35
1656145837593,MATH 20C,A02,083761,Briones; Jor-el Thomas Caparas,9,1,35,26
1656145837593,MATH 20C,A03,093476,Staff,0,0,35,35
1656145837593,MATH 20C,B01,083762,Bach; Quang Tran,1,0,30,29
1656145843617,MATH 20D,A01,083765,Tran; Brian Kha,2,0,30,28
1656145843617,MATH 20D,A02,083766,Tran; Brian Kha,0,1,30,30
1656145843617,MATH 20D,A03,083767,Tran; Brian Kha,2,0,30,28
1656145849643,MATH 20E,A01,083771,Ganguly; Soumya,4,0,32,28
1656145849643,MATH 20E,A02,083772,Ganguly; Soumya,0,0,32,32
1656145849643,MATH 20E,B01,083773,Ciotti; Benjamin,15,0,35,20
1656145849643,MATH 20E,B02,083774,Ciotti; Benjamin,14,0,35,21
1656145855676,MATH 103A,A01,083777,Greenfeld; Be'Eri,1,0,36,35
1656145855676,MATH 103A,A02,083778,Greenfeld; Be'Eri,1,0,36,35
1656145855676,MATH 103A,A03,093561,Staff,4,0,36,32
1656145855676,MATH 103A,B01,083779,Greenfeld; Be'Eri,8,1,36,28
1656145855676,MATH 103A,B02,083780,Greenfeld; Be'Eri,1,0,36,35
1656145855676,MATH 103A,B03,093562,Staff,0,0,36,36
1656145861708,MATH 105,A01,085443,Carter; Anne Toulson,4,1,35,31
1656145861708,MATH 105,A02,093477,Staff,11,0,35,24
1656145867732,MATH 109,A01,083213,Ganzberger; Geoffrey Michael,0,0,34,34
1656145867732,MATH 109,A02,083214,Ganzberger; Geoffrey Michael,0,0,34,34
1656145867732,MATH 109,A03,093478,Staff,1,0,34,33
1656145867732,MATH 109,B01,083215,Ganzberger; Geoffrey Michael,4,0,32,28
1656145867732,MATH 109,B02,083216,Ganzberger; Geoffrey Michael,1,0,32,31
1656145867732,MATH 109,B03,093479,Staff,4,0,32,28
1656145873758,MATH 142A,A01,083219,Chow; Bennett,1,0,32,31
1656145873758,MATH 142A,A02,083220,Chow; Bennett,8,0,32,24
1656145873758,MATH 142A,A03,093480,Staff,5,0,32,27
1656145873758,MATH 142A,B03,093481,Staff,4,0,32,28
1656145873758,MATH 142A,B04,093558,Staff,6,0,32,26
1656145873758,MATH 142A,B05,093559,Staff,0,0,32,32
1656145879787,MATH 193A,A01,083224,Rotar; Vladimir,0,1,34,34
1656145879787,MATH 193A,A02,083225,Rotar; Vladimir,0,0,34,34
1656145879787,MATH 193A,A03,083781,Rotar; Vladimir,0,0,34,34
1656145879787,MATH 193A,A04,083782,Rotar; Vladimir,6,0,34,28
1656145879787,MATH 193A,A05,093482,Rotar; Vladimir,1,0,34,33
1656145885821,MATH 197,001,091859,McAuley; Julian John,9999,0,9999,0
1656145885821,MATH 197,002,095566,Kedlaya; Kiran S.,9997,0,9999,2
1656145885821,MATH 197,003,095567,Xiao; Ming,9999,0,9999,0
1656145885821,MATH 197,004,095571,Perols; Johan Lars,9998,0,9999,1
1656145892901,COGS 9,A01,083615,Shannon; Kyle Michael,4,0,75,71
1656145898926,COGS 11,A01,083617,Boyle; Mary E. T.,15,0,48,33
1656145904955,COGS 13,A01,083071,Bastos; Amalia Pinkusfeld,6,0,71,65
1656145910981,COGS 14A,A01,092681,Semenuks; Arturs,4,15,100,96
1656145917006,COGS 14B,A01,083073,Cheng; Tzu-Han,7,0,63,56
1656145923029,COGS 17,A01,092677,Semenuks; Arturs,8,0,81,73
1656145929053,COGS 100,A01,083619,Allen; Michael Gordon,3,0,70,67
1656145935076,COGS 101A,A01,083621,Davis; Joshua Daniel,3,0,68,65
1656145941101,COGS 101B,A01,091572,Allen; Michael Gordon,6,0,65,59
1656145947131,COGS 101C,A01,083625,Delgado; Tania,10,0,35,25
1656145953156,COGS 107A,A01,083627,Boyle; Mary E. T.,0,0,60,60
1656145959180,COGS 118A,A01,083075,Gupta; Anjum,7,0,76,69
1656145965206,CSE 3,A50,083646,Miranda; Gregory Joseph,18,0,50,32
1656145971230,CSE 8A,A50,083650,Miranda; Gregory Joseph,3,3,56,53
1656145977259,CSE 11,A01,083080,Cao; Yingjun,1,54,40,39
1656145983289,CSE 12,A01,083652,Krause-Levy; Sophia Louisa,7,2,120,113
1656145989313,CSE 15L,A01,083654,Morris; Justin Loren,2,0,50,48
1656145989313,CSE 15L,A02,083655,Morris; Justin Loren,4,0,50,46
1656145995338,CSE 20,A01,083657,Tran; Khoa Dang,31,0,80,49
1656146001363,CSE 21,A01,095574,Bach; Quang Tran,25,0,48,23
1656146007391,CSE 30,A01,083084,Eldon; John,2,8,80,78
1656146007391,CSE 30,B01,095061,Bhaskar; Nishant,1,2,50,49
1656146013419,CSE 100,A01,083659,Cao; Yingjun,2,20,70,68
1656146019444,CSE 134B,A01,083661,Powell; Thomas Allan,3,0,100,97
1656146025467,CSE 140,A01,083663,Gungor; Onat,9,0,85,76
1656146031490,CSE 140L,A01,083088,Eldon; John,8,0,100,92
1656146037517,CSE 175,A01,083665,Kumar; Rakesh,0,0,25,25
1656146043541,CSE 190,A00,092507,Dubnov; Shlomo,3,0,20,17
1656146049566,ECE 45,A01,083139,Congero; Spencer William,1,0,75,74
1656146055595,ECE 65,A50,083695,Saad; Andrew S,8,0,30,22
1656146055595,ECE 65,A51,095125,Staff,23,0,26,3
1656146061619,ECE 109,A01,091882,Touri; Behrouz,0,1,70,70
1656146067649,ECE 180,A00,083140,Abi Samra; Nicholas Camill,1,0,30,29
1656146067649,ECE 180,B00,083141,Abi Samra; Nicholas Camill,0,4,30,30
1656146073688,MATH 10A,A01,083735,Patchell; Gregory David,0,0,30,30
1656146073688,MATH 10A,A02,083736,Patchell; Gregory David,22,0,30,8
1656146073688,MATH 10A,A03,083737,Patchell; Gregory David,16,0,30,14
1656146079714,MATH 10B,A01,083207,Lim; Seonhee,0,0,34,34
1656146079714,MATH 10B,A02,083208,Lim; Seonhee,7,0,35,28
1656146079714,MATH 10B,A03,093472,Staff,1,0,34,33
1656146079714,MATH 10B,B01,083739,Sinha; Shubham,10,0,30,20
1656146085743,MATH 18,A01,083743,Cinel; Cameron Alexander,7,0,30,23
1656146085743,MATH 18,A02,083744,Cinel; Cameron Alexander,10,0,30,20
1656146085743,MATH 18,A03,083745,Cinel; Cameron Alexander,4,0,30,26
1656146085743,MATH 18,B01,083748,Rideout; David Porter,0,0,36,36
1656146085743,MATH 18,B02,083749,Rideout; David Porter,0,0,36,36
1656146085743,MATH 18,B03,083750,Rideout; David Porter,0,0,36,36
1656146085743,MATH 18,B04,083751,Rideout; David Porter,0,0,36,36
1656146085743,MATH 18,B05,093473,Rideout; David Porter,1,0,36,35
1656146085743,MATH 18,B06,093474,Rideout; David Porter,4,0,36,32
1656146091772,MATH 20A,A01,083754,Zheng; Zequn,11,0,40,29
1656146097797,MATH 20B,A01,083756,Briones; Jor-el Thomas Caparas,0,0,36,36
1656146097797,MATH 20B,A02,083757,Briones; Jor-el Thomas Caparas,0,0,36,36
1656146097797,MATH 20B,A03,093475,Staff,2,0,36,34
1656146103825,MATH 20C,A01,083760,Briones; Jor-el Thomas Caparas,0,0,35,35
1656146103825,MATH 20C,A02,083761,Briones; Jor-el Thomas Caparas,9,1,35,26
1656146103825,MATH 20C,A03,093476,Staff,0,0,35,35
1656146103825,MATH 20C,B01,083762,Bach; Quang Tran,1,0,30,29
1656146109850,MATH 20D,A01,083765,Tran; Brian Kha,2,0,30,28
1656146109850,MATH 20D,A02,083766,Tran; Brian Kha,0,1,30,30
1656146109850,MATH 20D,A03,083767,Tran; Brian Kha,2,0,30,28
1656146115877,MATH 20E,A01,083771,Ganguly; Soumya,4,0,32,28
1656146115877,MATH 20E,A02,083772,Ganguly; Soumya,0,0,32,32
1656146115877,MATH 20E,B01,083773,Ciotti; Benjamin,15,0,35,20
1656146115877,MATH 20E,B02,083774,Ciotti; Benjamin,14,0,35,21
1656146121908,MATH 103A,A01,083777,Greenfeld; Be'Eri,1,0,36,35
1656146121908,MATH 103A,A02,083778,Greenfeld; Be'Eri,1,0,36,35
1656146121908,MATH 103A,A03,093561,Staff,4,0,36,32
1656146121908,MATH 103A,B01,083779,Greenfeld; Be'Eri,8,1,36,28
1656146121908,MATH 103A,B02,083780,Greenfeld; Be'Eri,1,0,36,35
1656146121908,MATH 103A,B03,093562,Staff,0,0,36,36
1656146127935,MATH 105,A01,085443,Carter; Anne Toulson,4,1,35,31
1656146127935,MATH 105,A02,093477,Staff,11,0,35,24
1656146133966,MATH 109,A01,083213,Ganzberger; Geoffrey Michael,0,0,34,34
1656146133966,MATH 109,A02,083214,Ganzberger; Geoffrey Michael,0,0,34,34
1656146133966,MATH 109,A03,093478,Staff,1,0,34,33
1656146133966,MATH 109,B01,083215,Ganzberger; Geoffrey Michael,4,0,32,28
1656146133966,MATH 109,B02,083216,Ganzberger; Geoffrey Michael,1,0,32,31
1656146133966,MATH 109,B03,093479,Staff,4,0,32,28
1656146139994,MATH 142A,A01,083219,Chow; Bennett,1,0,32,31
1656146139994,MATH 142A,A02,083220,Chow; Bennett,8,0,32,24
1656146139994,MATH 142A,A03,093480,Staff,5,0,32,27
1656146139994,MATH 142A,B03,093481,Staff,4,0,32,28
1656146139994,MATH 142A,B04,093558,Staff,6,0,32,26
1656146139994,MATH 142A,B05,093559,Staff,0,0,32,32
1656146146025,MATH 193A,A01,083224,Rotar; Vladimir,0,1,34,34
1656146146025,MATH 193A,A02,083225,Rotar; Vladimir,0,0,34,34
1656146146025,MATH 193A,A03,083781,Rotar; Vladimir,0,0,34,34
1656146146025,MATH 193A,A04,083782,Rotar; Vladimir,6,0,34,28
1656146146025,MATH 193A,A05,093482,Rotar; Vladimir,1,0,34,33
1656146152050,MATH 197,001,091859,McAuley; Julian John,9999,0,9999,0
1656146152050,MATH 197,002,095566,Kedlaya; Kiran S.,9997,0,9999,2
1656146152050,MATH 197,003,095567,Xiao; Ming,9999,0,9999,0
1656146152050,MATH 197,004,095571,Perols; Johan Lars,9998,0,9999,1
1656146159104,COGS 9,A01,083615,Shannon; Kyle Michael,4,0,75,71
1656146165135,COGS 11,A01,083617,Boyle; Mary E. T.,15,0,48,33
1656146171167,COGS 13,A01,083071,Bastos; Amalia Pinkusfeld,6,0,71,65
1656146177198,COGS 14A,A01,092681,Semenuks; Arturs,4,15,100,96
1656146183223,COGS 14B,A01,083073,Cheng; Tzu-Han,7,0,63,56
1656146189247,COGS 17,A01,092677,Semenuks; Arturs,8,0,81,73
1656146195275,COGS 100,A01,083619,Allen; Michael Gordon,3,0,70,67
1656146201304,COGS 101A,A01,083621,Davis; Joshua Daniel,3,0,68,65
1656146207333,COGS 101B,A01,091572,Allen; Michael Gordon,6,0,65,59
1656146213361,COGS 101C,A01,083625,Delgado; Tania,10,0,35,25
1656146219388,COGS 107A,A01,083627,Boyle; Mary E. T.,0,0,60,60
1656146225412,COGS 118A,A01,083075,Gupta; Anjum,7,0,76,69
1656146231441,CSE 3,A50,083646,Miranda; Gregory Joseph,18,0,50,32
1656146237475,CSE 8A,A50,083650,Miranda; Gregory Joseph,3,3,56,53
1656146243500,CSE 11,A01,083080,Cao; Yingjun,1,54,40,39
1656146249523,CSE 12,A01,083652,Krause-Levy; Sophia Louisa,7,2,120,113
1656146255553,CSE 15L,A01,083654,Morris; Justin Loren,2,0,50,48
1656146255553,CSE 15L,A02,083655,Morris; Justin Loren,4,0,50,46
1656146261576,CSE 20,A01,083657,Tran; Khoa Dang,31,0,80,49
1656146267610,CSE 21,A01,095574,Bach; Quang Tran,25,0,48,23
1656146273639,CSE 30,A01,083084,Eldon; John,2,8,80,78
1656146273639,CSE 30,B01,095061,Bhaskar; Nishant,1,2,50,49
1656146279663,CSE 100,A01,083659,Cao; Yingjun,2,20,70,68
1656146285690,CSE 134B,A01,083661,Powell; Thomas Allan,3,0,100,97
1656146291717,CSE 140,A01,083663,Gungor; Onat,9,0,85,76
1656146297741,CSE 140L,A01,083088,Eldon; John,8,0,100,92
1656146303764,CSE 175,A01,083665,Kumar; Rakesh,0,0,25,25
1656146309788,CSE 190,A00,092507,Dubnov; Shlomo,3,0,20,17
1656146315813,ECE 45,A01,083139,Congero; Spencer William,1,0,75,74
1656146321835,ECE 65,A50,083695,Saad; Andrew S,8,0,30,22
1656146321835,ECE 65,A51,095125,Staff,23,0,26,3
1656146327859,ECE 109,A01,091882,Touri; Behrouz,0,1,70,70
1656146333886,ECE 180,A00,083140,Abi Samra; Nicholas Camill,1,0,30,29
1656146333886,ECE 180,B00,083141,Abi Samra; Nicholas Camill,0,4,30,30
1656146339914,MATH 10A,A01,083735,Patchell; Gregory David,0,0,30,30
1656146339914,MATH 10A,A02,083736,Patchell; Gregory David,22,0,30,8
1656146339914,MATH 10A,A03,083737,Patchell; Gregory David,16,0,30,14
1656146345939,MATH 10B,A01,083207,Lim; Seonhee,0,0,34,34
1656146345939,MATH 10B,A02,083208,Lim; Seonhee,7,0,35,28
1656146345939,MATH 10B,A03,093472,Staff,1,0,34,33
1656146345939,MATH 10B,B01,083739,Sinha; Shubham,10,0,30,20
1656146351966,MATH 18,A01,083743,Cinel; Cameron Alexander,7,0,30,23
1656146351966,MATH 18,A02,083744,Cinel; Cameron Alexander,10,0,30,20
1656146351966,MATH 18,A03,083745,Cinel; Cameron Alexander,4,0,30,26
1656146351966,MATH 18,B01,083748,Rideout; David Porter,0,0,36,36
1656146351966,MATH 18,B02,083749,Rideout; David Porter,0,0,36,36
1656146351966,MATH 18,B03,083750,Rideout; David Porter,0,0,36,36
1656146351966,MATH 18,B04,083751,Rideout; David Porter,0,0,36,36
1656146351966,MATH 18,B05,093473,Rideout; David Porter,1,0,36,35
1656146351966,MATH 18,B06,093474,Rideout; David Porter,4,0,36,32
1656146357989,MATH 20A,A01,083754,Zheng; Zequn,11,0,40,29
1656146364014,MATH 20B,A01,083756,Briones; Jor-el Thomas Caparas,0,0,36,36
1656146364014,MATH 20B,A02,083757,Briones; Jor-el Thomas Caparas,0,0,36,36
1656146364014,MATH 20B,A03,093475,Staff,2,0,36,34
1656146370042,MATH 20C,A01,083760,Briones; Jor-el Thomas Caparas,0,0,35,35
1656146370042,MATH 20C,A02,083761,Briones; Jor-el Thomas Caparas,9,1,35,26
1656146370042,MATH 20C,A03,093476,Staff,0,0,35,35
1656146370042,MATH 20C,B01,083762,Bach; Quang Tran,1,0,30,29
1656146376068,MATH 20D,A01,083765,Tran; Brian Kha,2,0,30,28
1656146376068,MATH 20D,A02,083766,Tran; Brian Kha,0,1,30,30
1656146376068,MATH 20D,A03,083767,Tran; Brian Kha,2,0,30,28
1656146382104,MATH 20E,A01,083771,Ganguly; Soumya,4,0,32,28
1656146382104,MATH 20E,A02,083772,Ganguly; Soumya,0,0,32,32
1656146382104,MATH 20E,B01,083773,Ciotti; Benjamin,15,0,35,20
1656146382104,MATH 20E,B02,083774,Ciotti; Benjamin,14,0,35,21
1656146388134,MATH 103A,A01,083777,Greenfeld; Be'Eri,1,0,36,35
1656146388134,MATH 103A,A02,083778,Greenfeld; Be'Eri,1,0,36,35
1656146388134,MATH 103A,A03,093561,Staff,4,0,36,32
1656146388134,MATH 103A,B01,083779,Greenfeld; Be'Eri,8,1,36,28
1656146388134,MATH 103A,B02,083780,Greenfeld; Be'Eri,1,0,36,35
1656146388134,MATH 103A,B03,093562,Staff,0,0,36,36
1656146394159,MATH 105,A01,085443,Carter; Anne Toulson,4,1,35,31
1656146394159,MATH 105,A02,093477,Staff,11,0,35,24
1656146400184,MATH 109,A01,083213,Ganzberger; Geoffrey Michael,0,0,34,34
1656146400184,MATH 109,A02,083214,Ganzberger; Geoffrey Michael,0,0,34,34
1656146400184,MATH 109,A03,093478,Staff,1,0,34,33
1656146400184,MATH 109,B01,083215,Ganzberger; Geoffrey Michael,4,0,32,28
1656146400184,MATH 109,B02,083216,Ganzberger; Geoffrey Michael,1,0,32,31
1656146400184,MATH 109,B03,093479,Staff,4,0,32,28
1656146406215,MATH 142A,A01,083219,Chow; Bennett,1,0,32,31
1656146406215,MATH 142A,A02,083220,Chow; Bennett,8,0,32,24
1656146406215,MATH 142A,A03,093480,Staff,5,0,32,27
1656146406215,MATH 142A,B03,093481,Staff,4,0,32,28
1656146406215,MATH 142A,B04,093558,Staff,6,0,32,26
1656146406215,MATH 142A,B05,093559,Staff,0,0,32,32
1656146412250,MATH 193A,A01,083224,Rotar; Vladimir,0,1,34,34
1656146412250,MATH 193A,A02,083225,Rotar; Vladimir,0,0,34,34
1656146412250,MATH 193A,A03,083781,Rotar; Vladimir,0,0,34,34
1656146412250,MATH 193A,A04,083782,Rotar; Vladimir,6,0,34,28
1656146412250,MATH 193A,A05,093482,Rotar; Vladimir,1,0,34,33
1656146418447,MATH 197,001,091859,McAuley; Julian John,9999,0,9999,0
1656146418447,MATH 197,002,095566,Kedlaya; Kiran S.,9997,0,9999,2
1656146418447,MATH 197,003,095567,Xiao; Ming,9999,0,9999,0
1656146418447,MATH 197,004,095571,Perols; Johan Lars,9998,0,9999,1
1656146425523,COGS 9,A01,083615,Shannon; Kyle Michael,4,0,75,71
1656146431548,COGS 11,A01,083617,Boyle; Mary E. T.,15,0,48,33
1656146437575,COGS 13,A01,083071,Bastos; Amalia Pinkusfeld,6,0,71,65
1656146443599,COGS 14A,A01,092681,Semenuks; Arturs,4,15,100,96
1656146449627,COGS 14B,A01,083073,Cheng; Tzu-Han,7,0,63,56
1656146455651,COGS 17,A01,092677,Semenuks; Arturs,8,0,81,73
1656146461675,COGS 100,A01,083619,Allen; Michael Gordon,3,0,70,67
1656146467701,COGS 101A,A01,083621,Davis; Joshua Daniel,3,0,68,65
1656146473730,COGS 101B,A01,091572,Allen; Michael Gordon,6,0,65,59
1656146479755,COGS 101C,A01,083625,Delgado; Tania,10,0,35,25
1656146485791,COGS 107A,A01,083627,Boyle; Mary E. T.,0,0,60,60
1656146491815,COGS 118A,A01,083075,Gupta; Anjum,7,0,76,69
1656146497849,CSE 3,A50,083646,Miranda; Gregory Joseph,18,0,50,32
1656146503874,CSE 8A,A50,083650,Miranda; Gregory Joseph,3,3,56,53
1656146509900,CSE 11,A01,083080,Cao; Yingjun,1,54,40,39
1656146515925,CSE 12,A01,083652,Krause-Levy; Sophia Louisa,7,2,120,113
1656146521950,CSE 15L,A01,083654,Morris; Justin Loren,2,0,50,48
1656146521950,CSE 15L,A02,083655,Morris; Justin Loren,4,0,50,46
1656146527983,CSE 20,A01,083657,Tran; Khoa Dang,31,0,80,49
1656146534016,CSE 21,A01,095574,Bach; Quang Tran,25,0,48,23
1656146540041,CSE 30,A01,083084,Eldon; John,2,8,80,78
1656146540041,CSE 30,B01,095061,Bhaskar; Nishant,1,2,50,49
1656146546068,CSE 100,A01,083659,Cao; Yingjun,2,20,70,68
1656146552093,CSE 134B,A01,083661,Powell; Thomas Allan,3,0,100,97
1656146558122,CSE 140,A01,083663,Gungor; Onat,9,0,85,76
1656146564147,CSE 140L,A01,083088,Eldon; John,8,0,100,92
1656146570172,CSE 175,A01,083665,Kumar; Rakesh,0,0,25,25
1656146576197,CSE 190,A00,092507,Dubnov; Shlomo,3,0,20,17
1656146582224,ECE 45,A01,083139,Congero; Spencer William,1,0,75,74
1656146588251,ECE 65,A50,083695,Saad; Andrew S,8,0,30,22
1656146588251,ECE 65,A51,095125,Staff,23,0,26,3
1656146594276,ECE 109,A01,091882,Touri; Behrouz,0,1,70,70
1656146600306,ECE 180,A00,083140,Abi Samra; Nicholas Camill,1,0,30,29
1656146600306,ECE 180,B00,083141,Abi Samra; Nicholas Camill,0,4,30,30
1656146606332,MATH 10A,A01,083735,Patchell; Gregory David,0,0,30,30
1656146606332,MATH 10A,A02,083736,Patchell; Gregory David,22,0,30,8
1656146606332,MATH 10A,A03,083737,Patchell; Gregory David,16,0,30,14
1656146612369,MATH 10B,A01,083207,Lim; Seonhee,0,0,34,34
1656146612369,MATH 10B,A02,083208,Lim; Seonhee,7,0,35,28
1656146612369,MATH 10B,A03,093472,Staff,1,0,34,33
1656146612369,MATH 10B,B01,083739,Sinha; Shubham,10,0,30,20
1656146618406,MATH 18,A01,083743,Cinel; Cameron Alexander,7,0,30,23
1656146618406,MATH 18,A02,083744,Cinel; Cameron Alexander,10,0,30,20
1656146618406,MATH 18,A03,083745,Cinel; Cameron Alexander,4,0,30,26
1656146618406,MATH 18,B01,083748,Rideout; David Porter,0,0,36,36
1656146618406,MATH 18,B02,083749,Rideout; David Porter,0,0,36,36
1656146618406,MATH 18,B03,083750,Rideout; David Porter,0,0,36,36
1656146618406,MATH 18,B04,083751,Rideout; David Porter,0,0,36,36
1656146618406,MATH 18,B05,093473,Rideout; David Porter,1,0,36,35
1656146618406,MATH 18,B06,093474,Rideout; David Porter,4,0,36,32
1656146624433,MATH 20A,A01,083754,Zheng; Zequn,11,0,40,29
1656146630465,MATH 20B,A01,083756,Briones; Jor-el Thomas Caparas,0,0,36,36
1656146630465,MATH 20B,A02,083757,Briones; Jor-el Thomas Caparas,0,0,36,36
1656146630465,MATH 20B,A03,093475,Staff,2,0,36,34
1656146636498,MATH 20C,A01,083760,Briones; Jor-el Thomas Caparas,0,0,35,35
1656146636498,MATH 20C,A02,083761,Briones; Jor-el Thomas Caparas,9,1,35,26
1656146636498,MATH 20C,A03,093476,Staff,0,0,35,35
1656146636498,MATH 20C,B01,083762,Bach; Quang Tran,1,0,30,29
1656146642524,MATH 20D,A01,083765,Tran; Brian Kha,2,0,30,28
1656146642524,MATH 20D,A02,083766,Tran; Brian Kha,0,1,30,30
1656146642524,MATH 20D,A03,083767,Tran; Brian Kha,2,0,30,28
1656146648550,MATH 20E,A01,083771,Ganguly; Soumya,4,0,32,28
1656146648550,MATH 20E,A02,083772,Ganguly; Soumya,0,0,32,32
1656146648550,MATH 20E,B01,083773,Ciotti; Benjamin,15,0,35,20
1656146648550,MATH 20E,B02,083774,Ciotti; Benjamin,14,0,35,21
1656146654575,MATH 103A,A01,083777,Greenfeld; Be'Eri,1,0,36,35
1656146654575,MATH 103A,A02,083778,Greenfeld; Be'Eri,1,0,36,35
1656146654575,MATH 103A,A03,093561,Staff,4,0,36,32
1656146654575,MATH 103A,B01,083779,Greenfeld; Be'Eri,8,1,36,28
1656146654575,MATH 103A,B02,083780,Greenfeld; Be'Eri,1,0,36,35
1656146654575,MATH 103A,B03,093562,Staff,0,0,36,36
1656146660607,MATH 105,A01,085443,Carter; Anne Toulson,4,1,35,31
1656146660607,MATH 105,A02,093477,Staff,11,0,35,24
1656146666637,MATH 109,A01,083213,Ganzberger; Geoffrey Michael,0,0,34,34
1656146666637,MATH 109,A02,083214,Ganzberger; Geoffrey Michael,0,0,34,34
1656146666637,MATH 109,A03,093478,Staff,1,0,34,33
1656146666637,MATH 109,B01,083215,Ganzberger; Geoffrey Michael,4,0,32,28
1656146666637,MATH 109,B02,083216,Ganzberger; Geoffrey Michael,1,0,32,31
1656146666637,MATH 109,B03,093479,Staff,4,0,32,28
1656146672669,MATH 142A,A01,083219,Chow; Bennett,1,0,32,31
1656146672669,MATH 142A,A02,083220,Chow; Bennett,8,0,32,24
1656146672669,MATH 142A,A03,093480,Staff,5,0,32,27
1656146672669,MATH 142A,B03,093481,Staff,4,0,32,28
1656146672669,MATH 142A,B04,093558,Staff,6,0,32,26
1656146672669,MATH 142A,B05,093559,Staff,0,0,32,32
1656146678695,MATH 193A,A01,083224,Rotar; Vladimir,0,1,34,34
1656146678695,MATH 193A,A02,083225,Rotar; Vladimir,0,0,34,34
1656146678695,MATH 193A,A03,083781,Rotar; Vladimir,0,0,34,34
1656146678695,MATH 193A,A04,083782,Rotar; Vladimir,6,0,34,28
1656146678695,MATH 193A,A05,093482,Rotar; Vladimir,1,0,34,33
1656146684721,MATH 197,001,091859,McAuley; Julian John,9999,0,9999,0
1656146684721,MATH 197,002,095566,Kedlaya; Kiran S.,9997,0,9999,2
1656146684721,MATH 197,003,095567,Xiao; Ming,9999,0,9999,0
1656146684721,MATH 197,004,095571,Perols; Johan Lars,9998,0,9999,1
1656146691798,COGS 9,A01,083615,Shannon; Kyle Michael,4,0,75,71
1656146697825,COGS 11,A01,083617,Boyle; Mary E. T.,15,0,48,33
1656146703855,COGS 13,A01,083071,Bastos; Amalia Pinkusfeld,6,0,71,65
1656146709880,COGS 14A,A01,092681,Semenuks; Arturs,4,15,100,96
1656146715908,COGS 14B,A01,083073,Cheng; Tzu-Han,7,0,63,56
1656146721933,COGS 17,A01,092677,Semenuks; Arturs,8,0,81,73
1656146727959,COGS 100,A01,083619,Allen; Michael Gordon,3,0,70,67
1656146733982,COGS 101A,A01,083621,Davis; Joshua Daniel,3,0,68,65
1656146740010,COGS 101B,A01,091572,Allen; Michael Gordon,6,0,65,59
1656146746036,COGS 101C,A01,083625,Delgado; Tania,10,0,35,25
1656146752063,COGS 107A,A01,083627,Boyle; Mary E. T.,0,0,60,60
1656146758087,COGS 118A,A01,083075,Gupta; Anjum,7,0,76,69
1656146764114,CSE 3,A50,083646,Miranda; Gregory Joseph,18,0,50,32
1656146770139,CSE 8A,A50,083650,Miranda; Gregory Joseph,3,3,56,53
1656146776163,CSE 11,A01,083080,Cao; Yingjun,1,54,40,39
1656146782193,CSE 12,A01,083652,Krause-Levy; Sophia Louisa,7,2,120,113
1656146788219,CSE 15L,A01,083654,Morris; Justin Loren,2,0,50,48
1656146788219,CSE 15L,A02,083655,Morris; Justin Loren,4,0,50,46
1656146794244,CSE 20,A01,083657,Tran; Khoa Dang,31,0,80,49
1656146800269,CSE 21,A01,095574,Bach; Quang Tran,25,0,48,23
1656146806304,CSE 30,A01,083084,Eldon; John,2,8,80,78
1656146806304,CSE 30,B01,095061,Bhaskar; Nishant,1,2,50,49
1656146812329,CSE 100,A01,083659,Cao; Yingjun,2,20,70,68
1656146818353,CSE 134B,A01,083661,Powell; Thomas Allan,3,0,100,97
1656146824379,CSE 140,A01,083663,Gungor; Onat,9,0,85,76
1656146830406,CSE 140L,A01,083088,Eldon; John,8,0,100,92
1656146836432,CSE 175,A01,083665,Kumar; Rakesh,0,0,25,25
1656146842456,CSE 190,A00,092507,Dubnov; Shlomo,3,0,20,17
1656146848482,ECE 45,A01,083139,Congero; Spencer William,1,0,75,74
1656146854514,ECE 65,A50,083695,Saad; Andrew S,8,0,30,22
1656146854514,ECE 65,A51,095125,Staff,23,0,26,3
1656146860537,ECE 109,A01,091882,Touri; Behrouz,0,1,70,70
1656146866569,ECE 180,A00,083140,Abi Samra; Nicholas Camill,1,0,30,29
1656146866569,ECE 180,B00,083141,Abi Samra; Nicholas Camill,0,4,30,30
1656146872602,MATH 10A,A01,083735,Patchell; Gregory David,0,0,30,30
1656146872602,MATH 10A,A02,083736,Patchell; Gregory David,22,0,30,8
1656146872602,MATH 10A,A03,083737,Patchell; Gregory David,16,0,30,14
1656146878632,MATH 10B,A01,083207,Lim; Seonhee,0,0,34,34
1656146878632,MATH 10B,A02,083208,Lim; Seonhee,7,0,35,28
1656146878632,MATH 10B,A03,093472,Staff,1,0,34,33
1656146878632,MATH 10B,B01,083739,Sinha; Shubham,10,0,30,20
1656146884665,MATH 18,A01,083743,Cinel; Cameron Alexander,7,0,30,23
1656146884665,MATH 18,A02,083744,Cinel; Cameron Alexander,10,0,30,20
1656146884665,MATH 18,A03,083745,Cinel; Cameron Alexander,4,0,30,26
1656146884665,MATH 18,B01,083748,Rideout; David Porter,0,0,36,36
1656146884665,MATH 18,B02,083749,Rideout; David Porter,0,0,36,36
1656146884665,MATH 18,B03,083750,Rideout; David Porter,0,0,36,36
1656146884665,MATH 18,B04,083751,Rideout; David Porter,0,0,36,36
1656146884665,MATH 18,B05,093473,Rideout; David Porter,1,0,36,35
1656146884665,MATH 18,B06,093474,Rideout; David Porter,4,0,36,32
1656146890692,MATH 20A,A01,083754,Zheng; Zequn,11,0,40,29
1656146896719,MATH 20B,A01,083756,Briones; Jor-el Thomas Caparas,0,0,36,36
1656146896719,MATH 20B,A02,083757,Briones; Jor-el Thomas Caparas,0,0,36,36
1656146896719,MATH 20B,A03,093475,Staff,2,0,36,34
1656146902748,MATH 20C,A01,083760,Briones; Jor-el Thomas Caparas,0,0,35,35
1656146902748,MATH 20C,A02,083761,Briones; Jor-el Thomas Caparas,9,1,35,26
1656146902748,MATH 20C,A03,093476,Staff,0,0,35,35
1656146902748,MATH 20C,B01,083762,Bach; Quang Tran,1,0,30,29
1656146908773,MATH 20D,A01,083765,Tran; Brian Kha,2,0,30,28
1656146908773,MATH 20D,A02,083766,Tran; Brian Kha,0,1,30,30
1656146908773,MATH 20D,A03,083767,Tran; Brian Kha,2,0,30,28
1656146914800,MATH 20E,A01,083771,Ganguly; Soumya,4,0,32,28
1656146914800,MATH 20E,A02,083772,Ganguly; Soumya,0,0,32,32
1656146914800,MATH 20E,B01,083773,Ciotti; Benjamin,15,0,35,20
1656146914800,MATH 20E,B02,083774,Ciotti; Benjamin,14,0,35,21
1656146920827,MATH 103A,A01,083777,Greenfeld; Be'Eri,1,0,36,35
1656146920827,MATH 103A,A02,083778,Greenfeld; Be'Eri,1,0,36,35
1656146920827,MATH 103A,A03,093561,Staff,4,0,36,32
1656146920827,MATH 103A,B01,083779,Greenfeld; Be'Eri,8,1,36,28
1656146920827,MATH 103A,B02,083780,Greenfeld; Be'Eri,1,0,36,35
1656146920827,MATH 103A,B03,093562,Staff,0,0,36,36
1656146926855,MATH 105,A01,085443,Carter; Anne Toulson,4,1,35,31
1656146926855,MATH 105,A02,093477,Staff,11,0,35,24
1656146932886,MATH 109,A01,083213,Ganzberger; Geoffrey Michael,0,0,34,34
1656146932886,MATH 109,A02,083214,Ganzberger; Geoffrey Michael,0,0,34,34
1656146932886,MATH 109,A03,093478,Staff,1,0,34,33
1656146932886,MATH 109,B01,083215,Ganzberger; Geoffrey Michael,4,0,32,28
1656146932886,MATH 109,B02,083216,Ganzberger; Geoffrey Michael,1,0,32,31
1656146932886,MATH 109,B03,093479,Staff,4,0,32,28
1656146938918,MATH 142A,A01,083219,Chow; Bennett,1,0,32,31
1656146938918,MATH 142A,A02,083220,Chow; Bennett,8,0,32,24
1656146938918,MATH 142A,A03,093480,Staff,5,0,32,27
1656146938918,MATH 142A,B03,093481,Staff,4,0,32,28
1656146938918,MATH 142A,B04,093558,Staff,6,0,32,26
1656146938918,MATH 142A,B05,093559,Staff,0,0,32,32
1656146944950,MATH 193A,A01,083224,Rotar; Vladimir,0,1,34,34
1656146944950,MATH 193A,A02,083225,Rotar; Vladimir,0,0,34,34
1656146944950,MATH 193A,A03,083781,Rotar; Vladimir,0,0,34,34
1656146944950,MATH 193A,A04,083782,Rotar; Vladimir,6,0,34,28
1656146944950,MATH 193A,A05,093482,Rotar; Vladimir,1,0,34,33
1656146950977,MATH 197,001,091859,McAuley; Julian John,9999,0,9999,0
1656146950977,MATH 197,002,095566,Kedlaya; Kiran S.,9997,0,9999,2
1656146950977,MATH 197,003,095567,Xiao; Ming,9999,0,9999,0
1656146950977,MATH 197,004,095571,Perols; Johan Lars,9998,0,9999,1
1656146958041,COGS 9,A01,083615,Shannon; Kyle Michael,4,0,75,71
1656146964069,COGS 11,A01,083617,Boyle; Mary E. T.,15,0,48,33
1656146970109,COGS 13,A01,083071,Bastos; Amalia Pinkusfeld,6,0,71,65
1656146976138,COGS 14A,A01,092681,Semenuks; Arturs,4,15,100,96
1656146982162,COGS 14B,A01,083073,Cheng; Tzu-Han,7,0,63,56
1656146988191,COGS 17,A01,092677,Semenuks; Arturs,8,0,81,73
1656146994216,COGS 100,A01,083619,Allen; Michael Gordon,3,0,70,67
1656147000241,COGS 101A,A01,083621,Davis; Joshua Daniel,3,0,68,65
1656147006265,COGS 101B,A01,091572,Allen; Michael Gordon,6,0,65,59
1656147012385,COGS 101C,A01,083625,Delgado; Tania,10,0,35,25
1656147018407,COGS 107A,A01,083627,Boyle; Mary E. T.,0,0,60,60
1656147024432,COGS 118A,A01,083075,Gupta; Anjum,7,0,76,69
1656147030463,CSE 3,A50,083646,Miranda; Gregory Joseph,18,0,50,32
1656147036492,CSE 8A,A50,083650,Miranda; Gregory Joseph,3,3,56,53
1656147042515,CSE 11,A01,083080,Cao; Yingjun,1,54,40,39
1656147048542,CSE 12,A01,083652,Krause-Levy; Sophia Louisa,7,2,120,113
1656147054570,CSE 15L,A01,083654,Morris; Justin Loren,2,0,50,48
1656147054570,CSE 15L,A02,083655,Morris; Justin Loren,4,0,50,46
1656147060598,CSE 20,A01,083657,Tran; Khoa Dang,31,0,80,49
1656147066624,CSE 21,A01,095574,Bach; Quang Tran,25,0,48,23
1656147072651,CSE 30,A01,083084,Eldon; John,2,8,80,78
1656147072651,CSE 30,B01,095061,Bhaskar; Nishant,1,2,50,49
1656147078680,CSE 100,A01,083659,Cao; Yingjun,2,20,70,68
1656147084709,CSE 134B,A01,083661,Powell; Thomas Allan,3,0,100,97
1656147090737,CSE 140,A01,083663,Gungor; Onat,9,0,85,76
1656147096762,CSE 140L,A01,083088,Eldon; John,8,0,100,92
1656147102787,CSE 175,A01,083665,Kumar; Rakesh,0,0,25,25
1656147108810,CSE 190,A00,092507,Dubnov; Shlomo,3,0,20,17
1656147114835,ECE 45,A01,083139,Congero; Spencer William,1,0,75,74
1656147120867,ECE 65,A50,083695,Saad; Andrew S,8,0,30,22
1656147120867,ECE 65,A51,095125,Staff,23,0,26,3
1656147126916,ECE 109,A01,091882,Touri; Behrouz,0,1,70,70
1656147132943,ECE 180,A00,083140,Abi Samra; Nicholas Camill,1,0,30,29
1656147132943,ECE 180,B00,083141,Abi Samra; Nicholas Camill,0,4,30,30
1656147138975,MATH 10A,A01,083735,Patchell; Gregory David,0,0,30,30
1656147138975,MATH 10A,A02,083736,Patchell; Gregory David,22,0,30,8
1656147138975,MATH 10A,A03,083737,Patchell; Gregory David,16,0,30,14
1656147145007,MATH 10B,A01,083207,Lim; Seonhee,0,0,34,34
1656147145007,MATH 10B,A02,083208,Lim; Seonhee,7,0,35,28
1656147145007,MATH 10B,A03,093472,Staff,1,0,34,33
1656147145007,MATH 10B,B01,083739,Sinha; Shubham,10,0,30,20
1656147151041,MATH 18,A01,083743,Cinel; Cameron Alexander,7,0,30,23
1656147151041,MATH 18,A02,083744,Cinel; Cameron Alexander,10,0,30,20
1656147151041,MATH 18,A03,083745,Cinel; Cameron Alexander,4,0,30,26
1656147151041,MATH 18,B01,083748,Rideout; David Porter,0,0,36,36
1656147151041,MATH 18,B02,083749,Rideout; David Porter,0,0,36,36
1656147151041,MATH 18,B03,083750,Rideout; David Porter,0,0,36,36
1656147151041,MATH 18,B04,083751,Rideout; David Porter,0,0,36,36
1656147151041,MATH 18,B05,093473,Rideout; David Porter,1,0,36,35
1656147151041,MATH 18,B06,093474,Rideout; David Porter,4,0,36,32
1656147157069,MATH 20A,A01,083754,Zheng; Zequn,11,0,40,29
1656147163093,MATH 20B,A01,083756,Briones; Jor-el Thomas Caparas,0,0,36,36
1656147163093,MATH 20B,A02,083757,Briones; Jor-el Thomas Caparas,0,0,36,36
1656147163093,MATH 20B,A03,093475,Staff,2,0,36,34
1656147169124,MATH 20C,A01,083760,Briones; Jor-el Thomas Caparas,0,0,35,35
1656147169124,MATH 20C,A02,083761,Briones; Jor-el Thomas Caparas,9,1,35,26
1656147169124,MATH 20C,A03,093476,Staff,0,0,35,35
1656147169124,MATH 20C,B01,083762,Bach; Quang Tran,1,0,30,29
1656147175149,MATH 20D,A01,083765,Tran; Brian Kha,2,0,30,28
1656147175149,MATH 20D,A02,083766,Tran; Brian Kha,0,1,30,30
1656147175149,MATH 20D,A03,083767,Tran; Brian Kha,2,0,30,28
1656147181178,MATH 20E,A01,083771,Ganguly; Soumya,4,0,32,28
1656147181178,MATH 20E,A02,083772,Ganguly; Soumya,0,0,32,32
1656147181178,MATH 20E,B01,083773,Ciotti; Benjamin,15,0,35,20
1656147181178,MATH 20E,B02,083774,Ciotti; Benjamin,14,0,35,21
1656147187210,MATH 103A,A01,083777,Greenfeld; Be'Eri,1,0,36,35
1656147187210,MATH 103A,A02,083778,Greenfeld; Be'Eri,1,0,36,35
1656147187210,MATH 103A,A03,093561,Staff,4,0,36,32
1656147187210,MATH 103A,B01,083779,Greenfeld; Be'Eri,8,1,36,28
1656147187210,MATH 103A,B02,083780,Greenfeld; Be'Eri,1,0,36,35
1656147187210,MATH 103A,B03,093562,Staff,0,0,36,36
1656147193234,MATH 105,A01,085443,Carter; Anne Toulson,4,1,35,31
1656147193234,MATH 105,A02,093477,Staff,11,0,35,24
1656147199265,MATH 109,A01,083213,Ganzberger; Geoffrey Michael,0,0,34,34
1656147199265,MATH 109,A02,083214,Ganzberger; Geoffrey Michael,0,0,34,34
1656147199265,MATH 109,A03,093478,Staff,1,0,34,33
1656147199265,MATH 109,B01,083215,Ganzberger; Geoffrey Michael,4,0,32,28
1656147199265,MATH 109,B02,083216,Ganzberger; Geoffrey Michael,1,0,32,31
1656147199265,MATH 109,B03,093479,Staff,4,0,32,28
1656147205291,MATH 142A,A01,083219,Chow; Bennett,1,0,32,31
1656147205291,MATH 142A,A02,083220,Chow; Bennett,8,0,32,24
1656147205291,MATH 142A,A03,093480,Staff,5,0,32,27
1656147205291,MATH 142A,B03,093481,Staff,4,0,32,28
1656147205291,MATH 142A,B04,093558,Staff,6,0,32,26
1656147205291,MATH 142A,B05,093559,Staff,0,0,32,32
1656147211321,MATH 193A,A01,083224,Rotar; Vladimir,0,1,34,34
1656147211321,MATH 193A,A02,083225,Rotar; Vladimir,0,0,34,34
1656147211321,MATH 193A,A03,083781,Rotar; Vladimir,0,0,34,34
1656147211321,MATH 193A,A04,083782,Rotar; Vladimir,6,0,34,28
1656147211321,MATH 193A,A05,093482,Rotar; Vladimir,1,0,34,33
1656147217348,MATH 197,001,091859,McAuley; Julian John,9999,0,9999,0
1656147217348,MATH 197,002,095566,Kedlaya; Kiran S.,9997,0,9999,2
1656147217348,MATH 197,003,095567,Xiao; Ming,9999,0,9999,0
1656147217348,MATH 197,004,095571,Perols; Johan Lars,9998,0,9999,1
1656147224415,COGS 9,A01,083615,Shannon; Kyle Michael,4,0,75,71
1656147230439,COGS 11,A01,083617,Boyle; Mary E. T.,15,0,48,33
1656147236467,COGS 13,A01,083071,Bastos; Amalia Pinkusfeld,6,0,71,65
1656147242490,COGS 14A,A01,092681,Semenuks; Arturs,4,15,100,96
1656147248514,COGS 14B,A01,083073,Cheng; Tzu-Han,7,0,63,56
1656147254541,COGS 17,A01,092677,Semenuks; Arturs,8,0,81,73
1656147260564,COGS 100,A01,083619,Allen; Michael Gordon,3,0,70,67
1656147266587,COGS 101A,A01,083621,Davis; Joshua Daniel,3,0,68,65
1656147272611,COGS 101B,A01,091572,Allen; Michael Gordon,6,0,65,59
1656147278634,COGS 101C,A01,083625,Delgado; Tania,10,0,35,25
1656147284656,COGS 107A,A01,083627,Boyle; Mary E. T.,0,0,60,60
1656147290683,COGS 118A,A01,083075,Gupta; Anjum,7,0,76,69
1656147296712,CSE 3,A50,083646,Miranda; Gregory Joseph,18,0,50,32
1656147302747,CSE 8A,A50,083650,Miranda; Gregory Joseph,3,3,56,53
1656147308771,CSE 11,A01,083080,Cao; Yingjun,1,54,40,39
1656147314794,CSE 12,A01,083652,Krause-Levy; Sophia Louisa,7,2,120,113
1656147320819,CSE 15L,A01,083654,Morris; Justin Loren,2,0,50,48
1656147320819,CSE 15L,A02,083655,Morris; Justin Loren,4,0,50,46
1656147326843,CSE 20,A01,083657,Tran; Khoa Dang,31,0,80,49
1656147332876,CSE 21,A01,095574,Bach; Quang Tran,25,0,48,23
1656147338906,CSE 30,A01,083084,Eldon; John,2,8,80,78
1656147338906,CSE 30,B01,095061,Bhaskar; Nishant,1,2,50,49
1656147344937,CSE 100,A01,083659,Cao; Yingjun,2,20,70,68
1656147350964,CSE 134B,A01,083661,Powell; Thomas Allan,3,0,100,97
1656147356993,CSE 140,A01,083663,Gungor; Onat,9,0,85,76
1656147363018,CSE 140L,A01,083088,Eldon; John,8,0,100,92
1656147369049,CSE 175,A01,083665,Kumar; Rakesh,0,0,25,25
1656147375075,CSE 190,A00,092507,Dubnov; Shlomo,3,0,20,17
1656147381099,ECE 45,A01,083139,Congero; Spencer William,1,0,75,74
1656147387129,ECE 65,A50,083695,Saad; Andrew S,8,0,30,22
1656147387129,ECE 65,A51,095125,Staff,23,0,26,3
1656147393151,ECE 109,A01,091882,Touri; Behrouz,0,1,70,70
1656147399176,ECE 180,A00,083140,Abi Samra; Nicholas Camill,1,0,30,29
1656147399176,ECE 180,B00,083141,Abi Samra; Nicholas Camill,0,4,30,30
1656147405199,MATH 10A,A01,083735,Patchell; Gregory David,0,0,30,30
1656147405199,MATH 10A,A02,083736,Patchell; Gregory David,22,0,30,8
1656147405199,MATH 10A,A03,083737,Patchell; Gregory David,16,0,30,14
1656147411222,MATH 10B,A01,083207,Lim; Seonhee,0,0,34,34
1656147411222,MATH 10B,A02,083208,Lim; Seonhee,7,0,35,28
1656147411222,MATH 10B,A03,093472,Staff,1,0,34,33
1656147411222,MATH 10B,B01,083739,Sinha; Shubham,10,0,30,20
1656147417248,MATH 18,A01,083743,Cinel; Cameron Alexander,7,0,30,23
1656147417248,MATH 18,A02,083744,Cinel; Cameron Alexander,10,0,30,20
1656147417248,MATH 18,A03,083745,Cinel; Cameron Alexander,4,0,30,26
1656147417248,MATH 18,B01,083748,Rideout; David Porter,0,0,36,36
1656147417248,MATH 18,B02,083749,Rideout; David Porter,0,0,36,36
1656147417248,MATH 18,B03,083750,Rideout; David Porter,0,0,36,36
1656147417248,MATH 18,B04,083751,Rideout; David Porter,0,0,36,36
1656147417248,MATH 18,B05,093473,Rideout; David Porter,1,0,36,35
1656147417248,MATH 18,B06,093474,Rideout; David Porter,4,0,36,32
1656147423273,MATH 20A,A01,083754,Zheng; Zequn,11,0,40,29
1656147429299,MATH 20B,A01,083756,Briones; Jor-el Thomas Caparas,0,0,36,36
1656147429299,MATH 20B,A02,083757,Briones; Jor-el Thomas Caparas,0,0,36,36
1656147429299,MATH 20B,A03,093475,Staff,2,0,36,34
1656147435322,MATH 20C,A01,083760,Briones; Jor-el Thomas Caparas,0,0,35,35
1656147435322,MATH 20C,A02,083761,Briones; Jor-el Thomas Caparas,9,1,35,26
1656147435322,MATH 20C,A03,093476,Staff,0,0,35,35
1656147435322,MATH 20C,B01,083762,Bach; Quang Tran,1,0,30,29
1656147441364,MATH 20D,A01,083765,Tran; Brian Kha,2,0,30,28
1656147441364,MATH 20D,A02,083766,Tran; Brian Kha,0,1,30,30
1656147441364,MATH 20D,A03,083767,Tran; Brian Kha,2,0,30,28
1656147447395,MATH 20E,A01,083771,Ganguly; Soumya,4,0,32,28
1656147447395,MATH 20E,A02,083772,Ganguly; Soumya,0,0,32,32
1656147447395,MATH 20E,B01,083773,Ciotti; Benjamin,15,0,35,20
1656147447395,MATH 20E,B02,083774,Ciotti; Benjamin,14,0,35,21
1656147453419,MATH 103A,A01,083777,Greenfeld; Be'Eri,1,0,36,35
1656147453419,MATH 103A,A02,083778,Greenfeld; Be'Eri,1,0,36,35
1656147453419,MATH 103A,A03,093561,Staff,4,0,36,32
1656147453419,MATH 103A,B01,083779,Greenfeld; Be'Eri,8,1,36,28
1656147453419,MATH 103A,B02,083780,Greenfeld; Be'Eri,1,0,36,35
1656147453419,MATH 103A,B03,093562,Staff,0,0,36,36
1656147459447,MATH 105,A01,085443,Carter; Anne Toulson,4,1,35,31
1656147459447,MATH 105,A02,093477,Staff,11,0,35,24
1656147465478,MATH 109,A01,083213,Ganzberger; Geoffrey Michael,0,0,34,34
1656147465478,MATH 109,A02,083214,Ganzberger; Geoffrey Michael,0,0,34,34
1656147465478,MATH 109,A03,093478,Staff,1,0,34,33
1656147465478,MATH 109,B01,083215,Ganzberger; Geoffrey Michael,4,0,32,28
1656147465478,MATH 109,B02,083216,Ganzberger; Geoffrey Michael,1,0,32,31
1656147465478,MATH 109,B03,093479,Staff,4,0,32,28
1656147471515,MATH 142A,A01,083219,Chow; Bennett,1,0,32,31
1656147471515,MATH 142A,A02,083220,Chow; Bennett,8,0,32,24
1656147471515,MATH 142A,A03,093480,Staff,5,0,32,27
1656147471515,MATH 142A,B03,093481,Staff,4,0,32,28
1656147471515,MATH 142A,B04,093558,Staff,6,0,32,26
1656147471515,MATH 142A,B05,093559,Staff,0,0,32,32
1656147477540,MATH 193A,A01,083224,Rotar; Vladimir,0,1,34,34
1656147477540,MATH 193A,A02,083225,Rotar; Vladimir,0,0,34,34
1656147477540,MATH 193A,A03,083781,Rotar; Vladimir,0,0,34,34
1656147477540,MATH 193A,A04,083782,Rotar; Vladimir,6,0,34,28
1656147477540,MATH 193A,A05,093482,Rotar; Vladimir,1,0,34,33
1656147483565,MATH 197,001,091859,McAuley; Julian John,9999,0,9999,0
1656147483565,MATH 197,002,095566,Kedlaya; Kiran S.,9997,0,9999,2
1656147483565,MATH 197,003,095567,Xiao; Ming,9999,0,9999,0
1656147483565,MATH 197,004,095571,Perols; Johan Lars,9998,0,9999,1
1656147490628,COGS 9,A01,083615,Shannon; Kyle Michael,4,0,75,71
1656147496657,COGS 11,A01,083617,Boyle; Mary E. T.,15,0,48,33
1656147502680,COGS 13,A01,083071,Bastos; Amalia Pinkusfeld,6,0,71,65
1656147508708,COGS 14A,A01,092681,Semenuks; Arturs,4,15,100,96
1656147514735,COGS 14B,A01,083073,Cheng; Tzu-Han,7,0,63,56
1656147520758,COGS 17,A01,092677,Semenuks; Arturs,8,0,81,73
1656147526782,COGS 100,A01,083619,Allen; Michael Gordon,3,0,70,67
1656147532810,COGS 101A,A01,083621,Davis; Joshua Daniel,3,0,68,65
1656147538834,COGS 101B,A01,091572,Allen; Michael Gordon,6,0,65,59
1656147544865,COGS 101C,A01,083625,Delgado; Tania,10,0,35,25
1656147550889,COGS 107A,A01,083627,Boyle; Mary E. T.,0,0,60,60
1656147556916,COGS 118A,A01,083075,Gupta; Anjum,7,0,76,69
1656147562942,CSE 3,A50,083646,Miranda; Gregory Joseph,18,0,50,32
1656147568969,CSE 8A,A50,083650,Miranda; Gregory Joseph,3,3,56,53
1656147574996,CSE 11,A01,083080,Cao; Yingjun,1,54,40,39
1656147581024,CSE 12,A01,083652,Krause-Levy; Sophia Louisa,7,2,120,113
1656147587052,CSE 15L,A01,083654,Morris; Justin Loren,2,0,50,48
1656147587052,CSE 15L,A02,083655,Morris; Justin Loren,4,0,50,46
1656147593077,CSE 20,A01,083657,Tran; Khoa Dang,31,0,80,49
1656147599101,CSE 21,A01,095574,Bach; Quang Tran,25,0,48,23
1656147605133,CSE 30,A01,083084,Eldon; John,2,8,80,78
1656147605133,CSE 30,B01,095061,Bhaskar; Nishant,1,2,50,49
1656147611231,CSE 100,A01,083659,Cao; Yingjun,2,20,70,68
1656147617254,CSE 134B,A01,083661,Powell; Thomas Allan,3,0,100,97
1656147623284,CSE 140,A01,083663,Gungor; Onat,9,0,85,76
1656147629307,CSE 140L,A01,083088,Eldon; John,8,0,100,92
1656147635333,CSE 175,A01,083665,Kumar; Rakesh,0,0,25,25
1656147641361,CSE 190,A00,092507,Dubnov; Shlomo,3,0,20,17
1656147647384,ECE 45,A01,083139,Congero; Spencer William,1,0,75,74
1656147653407,ECE 65,A50,083695,Saad; Andrew S,8,0,30,22
1656147653407,ECE 65,A51,095125,Staff,23,0,26,3
1656147659452,ECE 109,A01,091882,Touri; Behrouz,0,1,70,70
1656147665476,ECE 180,A00,083140,Abi Samra; Nicholas Camill,1,0,30,29
1656147665476,ECE 180,B00,083141,Abi Samra; Nicholas Camill,0,4,30,30
1656147671506,MATH 10A,A01,083735,Patchell; Gregory David,0,0,30,30
1656147671506,MATH 10A,A02,083736,Patchell; Gregory David,22,0,30,8
1656147671506,MATH 10A,A03,083737,Patchell; Gregory David,16,0,30,14
1656147677534,MATH 10B,A01,083207,Lim; Seonhee,0,0,34,34
1656147677534,MATH 10B,A02,083208,Lim; Seonhee,7,0,35,28
1656147677534,MATH 10B,A03,093472,Staff,1,0,34,33
1656147677534,MATH 10B,B01,083739,Sinha; Shubham,10,0,30,20
1656147683568,MATH 18,A01,083743,Cinel; Cameron Alexander,7,0,30,23
1656147683568,MATH 18,A02,083744,Cinel; Cameron Alexander,10,0,30,20
1656147683568,MATH 18,A03,083745,Cinel; Cameron Alexander,4,0,30,26
1656147683568,MATH 18,B01,083748,Rideout; David Porter,0,0,36,36
1656147683568,MATH 18,B02,083749,Rideout; David Porter,0,0,36,36
1656147683568,MATH 18,B03,083750,Rideout; David Porter,0,0,36,36
1656147683568,MATH 18,B04,083751,Rideout; David Porter,0,0,36,36
1656147683568,MATH 18,B05,093473,Rideout; David Porter,1,0,36,35
1656147683568,MATH 18,B06,093474,Rideout; David Porter,4,0,36,32
1656147689590,MATH 20A,A01,083754,Zheng; Zequn,11,0,40,29
1656147695614,MATH 20B,A01,083756,Briones; Jor-el Thomas Caparas,0,0,36,36
1656147695614,MATH 20B,A02,083757,Briones; Jor-el Thomas Caparas,0,0,36,36
1656147695614,MATH 20B,A03,093475,Staff,2,0,36,34
1656147701638,MATH 20C,A01,083760,Briones; Jor-el Thomas Caparas,0,0,35,35
1656147701638,MATH 20C,A02,083761,Briones; Jor-el Thomas Caparas,9,1,35,26
1656147701638,MATH 20C,A03,093476,Staff,0,0,35,35
1656147701638,MATH 20C,B01,083762,Bach; Quang Tran,1,0,30,29
1656147707665,MATH 20D,A01,083765,Tran; Brian Kha,2,0,30,28
1656147707665,MATH 20D,A02,083766,Tran; Brian Kha,0,1,30,30
1656147707665,MATH 20D,A03,083767,Tran; Brian Kha,2,0,30,28
1656147713691,MATH 20E,A01,083771,Ganguly; Soumya,4,0,32,28
1656147713691,MATH 20E,A02,083772,Ganguly; Soumya,0,0,32,32
1656147713691,MATH 20E,B01,083773,Ciotti; Benjamin,15,0,35,20
1656147713691,MATH 20E,B02,083774,Ciotti; Benjamin,14,0,35,21
1656147719714,MATH 103A,A01,083777,Greenfeld; Be'Eri,1,0,36,35
1656147719714,MATH 103A,A02,083778,Greenfeld; Be'Eri,1,0,36,35
1656147719714,MATH 103A,A03,093561,Staff,4,0,36,32
1656147719714,MATH 103A,B01,083779,Greenfeld; Be'Eri,8,1,36,28
1656147719714,MATH 103A,B02,083780,Greenfeld; Be'Eri,1,0,36,35
1656147719714,MATH 103A,B03,093562,Staff,0,0,36,36
1656147725738,MATH 105,A01,085443,Carter; Anne Toulson,4,1,35,31
1656147725738,MATH 105,A02,093477,Staff,11,0,35,24
1656147731766,MATH 109,A01,083213,Ganzberger; Geoffrey Michael,0,0,34,34
1656147731766,MATH 109,A02,083214,Ganzberger; Geoffrey Michael,0,0,34,34
1656147731766,MATH 109,A03,093478,Staff,1,0,34,33
1656147731766,MATH 109,B01,083215,Ganzberger; Geoffrey Michael,4,0,32,28
1656147731766,MATH 109,B02,083216,Ganzberger; Geoffrey Michael,1,0,32,31
1656147731766,MATH 109,B03,093479,Staff,4,0,32,28
1656147737802,MATH 142A,A01,083219,Chow; Bennett,1,0,32,31
1656147737802,MATH 142A,A02,083220,Chow; Bennett,8,0,32,24
1656147737802,MATH 142A,A03,093480,Staff,5,0,32,27
1656147737802,MATH 142A,B03,093481,Staff,4,0,32,28
1656147737802,MATH 142A,B04,093558,Staff,6,0,32,26
1656147737802,MATH 142A,B05,093559,Staff,0,0,32,32
1656147743835,MATH 193A,A01,083224,Rotar; Vladimir,0,1,34,34
1656147743835,MATH 193A,A02,083225,Rotar; Vladimir,0,0,34,34
1656147743835,MATH 193A,A03,083781,Rotar; Vladimir,0,0,34,34
1656147743835,MATH 193A,A04,083782,Rotar; Vladimir,6,0,34,28
1656147743835,MATH 193A,A05,093482,Rotar; Vladimir,1,0,34,33
1656147749866,MATH 197,001,091859,McAuley; Julian John,9999,0,9999,0
1656147749866,MATH 197,002,095566,Kedlaya; Kiran S.,9997,0,9999,2
1656147749866,MATH 197,003,095567,Xiao; Ming,9999,0,9999,0
1656147749866,MATH 197,004,095571,Perols; Johan Lars,9998,0,9999,1
1656147756931,COGS 9,A01,083615,Shannon; Kyle Michael,4,0,75,71
1656147762953,COGS 11,A01,083617,Boyle; Mary E. T.,15,0,48,33
1656147768981,COGS 13,A01,083071,Bastos; Amalia Pinkusfeld,6,0,71,65
1656147775005,COGS 14A,A01,092681,Semenuks; Arturs,4,15,100,96
1656147781033,COGS 14B,A01,083073,Cheng; Tzu-Han,7,0,63,56
1656147787059,COGS 17,A01,092677,Semenuks; Arturs,8,0,81,73
1656147793088,COGS 100,A01,083619,Allen; Michael Gordon,3,0,70,67
1656147799117,COGS 101A,A01,083621,Davis; Joshua Daniel,3,0,68,65
1656147805140,COGS 101B,A01,091572,Allen; Michael Gordon,6,0,65,59
1656147811166,COGS 101C,A01,083625,Delgado; Tania,10,0,35,25
1656147817190,COGS 107A,A01,083627,Boyle; Mary E. T.,0,0,60,60
1656147823213,COGS 118A,A01,083075,Gupta; Anjum,7,0,76,69
1656147829244,CSE 3,A50,083646,Miranda; Gregory Joseph,18,0,50,32
1656147835267,CSE 8A,A50,083650,Miranda; Gregory Joseph,3,3,56,53
1656147841293,CSE 11,A01,083080,Cao; Yingjun,1,54,40,39
1656147847319,CSE 12,A01,083652,Krause-Levy; Sophia Louisa,7,2,120,113
1656147853345,CSE 15L,A01,083654,Morris; Justin Loren,2,0,50,48
1656147853345,CSE 15L,A02,083655,Morris; Justin Loren,4,0,50,46
1656147859368,CSE 20,A01,083657,Tran; Khoa Dang,31,0,80,49
1656147865391,CSE 21,A01,095574,Bach; Quang Tran,25,0,48,23
1656147871416,CSE 30,A01,083084,Eldon; John,2,8,80,78
1656147871416,CSE 30,B01,095061,Bhaskar; Nishant,1,2,50,49
1656147877441,CSE 100,A01,083659,Cao; Yingjun,2,20,70,68
1656147883471,CSE 134B,A01,083661,Powell; Thomas Allan,3,0,100,97
1656147889502,CSE 140,A01,083663,Gungor; Onat,9,0,85,76
1656147895525,CSE 140L,A01,083088,Eldon; John,8,0,100,92
1656147901549,CSE 175,A01,083665,Kumar; Rakesh,0,0,25,25
1656147907571,CSE 190,A00,092507,Dubnov; Shlomo,3,0,20,17
1656147913599,ECE 45,A01,083139,Congero; Spencer William,1,0,75,74
1656147919624,ECE 65,A50,083695,Saad; Andrew S,8,0,30,22
1656147919624,ECE 65,A51,095125,Staff,23,0,26,3
1656147925654,ECE 109,A01,091882,Touri; Behrouz,0,1,70,70
1656147931686,ECE 180,A00,083140,Abi Samra; Nicholas Camill,1,0,30,29
1656147931686,ECE 180,B00,083141,Abi Samra; Nicholas Camill,0,4,30,30
1656147937712,MATH 10A,A01,083735,Patchell; Gregory David,0,0,30,30
1656147937712,MATH 10A,A02,083736,Patchell; Gregory David,22,0,30,8
1656147937712,MATH 10A,A03,083737,Patchell; Gregory David,16,0,30,14
1656147943748,MATH 10B,A01,083207,Lim; Seonhee,0,0,34,34
1656147943748,MATH 10B,A02,083208,Lim; Seonhee,7,0,35,28
1656147943748,MATH 10B,A03,093472,Staff,1,0,34,33
1656147943748,MATH 10B,B01,083739,Sinha; Shubham,10,0,30,20
1656147949776,MATH 18,A01,083743,Cinel; Cameron Alexander,7,0,30,23
1656147949776,MATH 18,A02,083744,Cinel; Cameron Alexander,10,0,30,20
1656147949776,MATH 18,A03,083745,Cinel; Cameron Alexander,4,0,30,26
1656147949776,MATH 18,B01,083748,Rideout; David Porter,0,0,36,36
1656147949776,MATH 18,B02,083749,Rideout; David Porter,0,0,36,36
1656147949776,MATH 18,B03,083750,Rideout; David Porter,0,0,36,36
1656147949776,MATH 18,B04,083751,Rideout; David Porter,0,0,36,36
1656147949776,MATH 18,B05,093473,Rideout; David Porter,1,0,36,35
1656147949776,MATH 18,B06,093474,Rideout; David Porter,4,0,36,32
1656147955803,MATH 20A,A01,083754,Zheng; Zequn,11,0,40,29
1656147961828,MATH 20B,A01,083756,Briones; Jor-el Thomas Caparas,0,0,36,36
1656147961828,MATH 20B,A02,083757,Briones; Jor-el Thomas Caparas,0,0,36,36
1656147961828,MATH 20B,A03,093475,Staff,2,0,36,34
1656147967857,MATH 20C,A01,083760,Briones; Jor-el Thomas Caparas,0,0,35,35
1656147967857,MATH 20C,A02,083761,Briones; Jor-el Thomas Caparas,9,1,35,26
1656147967857,MATH 20C,A03,093476,Staff,0,0,35,35
1656147967857,MATH 20C,B01,083762,Bach; Quang Tran,1,0,30,29
1656147973889,MATH 20D,A01,083765,Tran; Brian Kha,2,0,30,28
1656147973889,MATH 20D,A02,083766,Tran; Brian Kha,0,1,30,30
1656147973889,MATH 20D,A03,083767,Tran; Brian Kha,2,0,30,28
1656147979915,MATH 20E,A01,083771,Ganguly; Soumya,4,0,32,28
1656147979915,MATH 20E,A02,083772,Ganguly; Soumya,0,0,32,32
1656147979915,MATH 20E,B01,083773,Ciotti; Benjamin,15,0,35,20
1656147979915,MATH 20E,B02,083774,Ciotti; Benjamin,14,0,35,21
1656147985941,MATH 103A,A01,083777,Greenfeld; Be'Eri,1,0,36,35
1656147985941,MATH 103A,A02,083778,Greenfeld; Be'Eri,1,0,36,35
1656147985941,MATH 103A,A03,093561,Staff,4,0,36,32
1656147985941,MATH 103A,B01,083779,Greenfeld; Be'Eri,8,1,36,28
1656147985941,MATH 103A,B02,083780,Greenfeld; Be'Eri,1,0,36,35
1656147985941,MATH 103A,B03,093562,Staff,0,0,36,36
1656147991968,MATH 105,A01,085443,Carter; Anne Toulson,4,1,35,31
1656147991968,MATH 105,A02,093477,Staff,11,0,35,24
1656147997999,MATH 109,A01,083213,Ganzberger; Geoffrey Michael,0,0,34,34
1656147997999,MATH 109,A02,083214,Ganzberger; Geoffrey Michael,0,0,34,34
1656147997999,MATH 109,A03,093478,Staff,1,0,34,33
1656147997999,MATH 109,B01,083215,Ganzberger; Geoffrey Michael,4,0,32,28
1656147997999,MATH 109,B02,083216,Ganzberger; Geoffrey Michael,1,0,32,31
1656147997999,MATH 109,B03,093479,Staff,4,0,32,28
1656148004024,MATH 142A,A01,083219,Chow; Bennett,1,0,32,31
1656148004024,MATH 142A,A02,083220,Chow; Bennett,8,0,32,24
1656148004024,MATH 142A,A03,093480,Staff,5,0,32,27
1656148004024,MATH 142A,B03,093481,Staff,4,0,32,28
1656148004024,MATH 142A,B04,093558,Staff,6,0,32,26
1656148004024,MATH 142A,B05,093559,Staff,0,0,32,32
1656148010049,MATH 193A,A01,083224,Rotar; Vladimir,0,1,34,34
1656148010049,MATH 193A,A02,083225,Rotar; Vladimir,0,0,34,34
1656148010049,MATH 193A,A03,083781,Rotar; Vladimir,0,0,34,34
1656148010049,MATH 193A,A04,083782,Rotar; Vladimir,6,0,34,28
1656148010049,MATH 193A,A05,093482,Rotar; Vladimir,1,0,34,33
1656148016077,MATH 197,001,091859,McAuley; Julian John,9999,0,9999,0
1656148016077,MATH 197,002,095566,Kedlaya; Kiran S.,9997,0,9999,2
1656148016077,MATH 197,003,095567,Xiao; Ming,9999,0,9999,0
1656148016077,MATH 197,004,095571,Perols; Johan Lars,9998,0,9999,1
1656148023134,COGS 9,A01,083615,Shannon; Kyle Michael,4,0,75,71
1656148029161,COGS 11,A01,083617,Boyle; Mary E. T.,15,0,48,33
1656148035185,COGS 13,A01,083071,Bastos; Amalia Pinkusfeld,6,0,71,65
1656148041212,COGS 14A,A01,092681,Semenuks; Arturs,4,15,100,96
1656148047242,COGS 14B,A01,083073,Cheng; Tzu-Han,7,0,63,56
1656148053268,COGS 17,A01,092677,Semenuks; Arturs,8,0,81,73
1656148059296,COGS 100,A01,083619,Allen; Michael Gordon,3,0,70,67
1656148065323,COGS 101A,A01,083621,Davis; Joshua Daniel,3,0,68,65
1656148071350,COGS 101B,A01,091572,Allen; Michael Gordon,6,0,65,59
1656148077378,COGS 101C,A01,083625,Delgado; Tania,10,0,35,25
1656148083401,COGS 107A,A01,083627,Boyle; Mary E. T.,0,0,60,60
1656148089428,COGS 118A,A01,083075,Gupta; Anjum,7,0,76,69
1656148095456,CSE 3,A50,083646,Miranda; Gregory Joseph,18,0,50,32
1656148101488,CSE 8A,A50,083650,Miranda; Gregory Joseph,3,3,56,53
1656148107512,CSE 11,A01,083080,Cao; Yingjun,1,54,40,39
1656148113537,CSE 12,A01,083652,Krause-Levy; Sophia Louisa,7,2,120,113
1656148119561,CSE 15L,A01,083654,Morris; Justin Loren,2,0,50,48
1656148119561,CSE 15L,A02,083655,Morris; Justin Loren,4,0,50,46
1656148125586,CSE 20,A01,083657,Tran; Khoa Dang,31,0,80,49
1656148131612,CSE 21,A01,095574,Bach; Quang Tran,25,0,48,23
1656148137636,CSE 30,A01,083084,Eldon; John,2,8,80,78
1656148137636,CSE 30,B01,095061,Bhaskar; Nishant,1,2,50,49
1656148143659,CSE 100,A01,083659,Cao; Yingjun,2,20,70,68
1656148149684,CSE 134B,A01,083661,Powell; Thomas Allan,3,0,100,97
1656148155707,CSE 140,A01,083663,Gungor; Onat,9,0,85,76
1656148161731,CSE 140L,A01,083088,Eldon; John,8,0,100,92
1656148167757,CSE 175,A01,083665,Kumar; Rakesh,0,0,25,25
1656148173784,CSE 190,A00,092507,Dubnov; Shlomo,3,0,20,17
1656148179813,ECE 45,A01,083139,Congero; Spencer William,1,0,75,74
1656148185839,ECE 65,A50,083695,Saad; Andrew S,8,0,30,22
1656148185839,ECE 65,A51,095125,Staff,23,0,26,3
1656148191863,ECE 109,A01,091882,Touri; Behrouz,0,1,70,70
1656148197887,ECE 180,A00,083140,Abi Samra; Nicholas Camill,1,0,30,29
1656148197887,ECE 180,B00,083141,Abi Samra; Nicholas Camill,0,4,30,30
1656148203912,MATH 10A,A01,083735,Patchell; Gregory David,0,0,30,30
1656148203912,MATH 10A,A02,083736,Patchell; Gregory David,22,0,30,8
1656148203912,MATH 10A,A03,083737,Patchell; Gregory David,16,0,30,14
1656148210010,MATH 10B,A01,083207,Lim; Seonhee,0,0,34,34
1656148210010,MATH 10B,A02,083208,Lim; Seonhee,7,0,35,28
1656148210010,MATH 10B,A03,093472,Staff,1,0,34,33
1656148210010,MATH 10B,B01,083739,Sinha; Shubham,10,0,30,20
1656148216035,MATH 18,A01,083743,Cinel; Cameron Alexander,7,0,30,23
1656148216035,MATH 18,A02,083744,Cinel; Cameron Alexander,10,0,30,20
1656148216035,MATH 18,A03,083745,Cinel; Cameron Alexander,4,0,30,26
1656148216035,MATH 18,B01,083748,Rideout; David Porter,0,0,36,36
1656148216035,MATH 18,B02,083749,Rideout; David Porter,0,0,36,36
1656148216035,MATH 18,B03,083750,Rideout; David Porter,0,0,36,36
1656148216035,MATH 18,B04,083751,Rideout; David Porter,0,0,36,36
1656148216035,MATH 18,B05,093473,Rideout; David Porter,1,0,36,35
1656148216035,MATH 18,B06,093474,Rideout; David Porter,4,0,36,32
1656148222058,MATH 20A,A01,083754,Zheng; Zequn,11,0,40,29
1656148228082,MATH 20B,A01,083756,Briones; Jor-el Thomas Caparas,0,0,36,36
1656148228082,MATH 20B,A02,083757,Briones; Jor-el Thomas Caparas,0,0,36,36
1656148228082,MATH 20B,A03,093475,Staff,2,0,36,34
1656148234106,MATH 20C,A01,083760,Briones; Jor-el Thomas Caparas,0,0,35,35
1656148234106,MATH 20C,A02,083761,Briones; Jor-el Thomas Caparas,9,1,35,26
1656148234106,MATH 20C,A03,093476,Staff,0,0,35,35
1656148234106,MATH 20C,B01,083762,Bach; Quang Tran,1,0,30,29
1656148240134,MATH 20D,A01,083765,Tran; Brian Kha,2,0,30,28
1656148240134,MATH 20D,A02,083766,Tran; Brian Kha,0,1,30,30
1656148240134,MATH 20D,A03,083767,Tran; Brian Kha,2,0,30,28
1656148246158,MATH 20E,A01,083771,Ganguly; Soumya,4,0,32,28
1656148246158,MATH 20E,A02,083772,Ganguly; Soumya,0,0,32,32
1656148246158,MATH 20E,B01,083773,Ciotti; Benjamin,15,0,35,20
1656148246158,MATH 20E,B02,083774,Ciotti; Benjamin,14,0,35,21
1656148252188,MATH 103A,A01,083777,Greenfeld; Be'Eri,1,0,36,35
1656148252188,MATH 103A,A02,083778,Greenfeld; Be'Eri,1,0,36,35
1656148252188,MATH 103A,A03,093561,Staff,4,0,36,32
1656148252188,MATH 103A,B01,083779,Greenfeld; Be'Eri,8,1,36,28
1656148252188,MATH 103A,B02,083780,Greenfeld; Be'Eri,1,0,36,35
1656148252188,MATH 103A,B03,093562,Staff,0,0,36,36
1656148258213,MATH 105,A01,085443,Carter; Anne Toulson,4,1,35,31
1656148258213,MATH 105,A02,093477,Staff,11,0,35,24
1656148264245,MATH 109,A01,083213,Ganzberger; Geoffrey Michael,0,0,34,34
1656148264245,MATH 109,A02,083214,Ganzberger; Geoffrey Michael,0,0,34,34
1656148264245,MATH 109,A03,093478,Staff,1,0,34,33
1656148264245,MATH 109,B01,083215,Ganzberger; Geoffrey Michael,4,0,32,28
1656148264245,MATH 109,B02,083216,Ganzberger; Geoffrey Michael,1,0,32,31
1656148264245,MATH 109,B03,093479,Staff,4,0,32,28
1656148270276,MATH 142A,A01,083219,Chow; Bennett,1,0,32,31
1656148270276,MATH 142A,A02,083220,Chow; Bennett,8,0,32,24
1656148270276,MATH 142A,A03,093480,Staff,5,0,32,27
1656148270276,MATH 142A,B03,093481,Staff,4,0,32,28
1656148270276,MATH 142A,B04,093558,Staff,6,0,32,26
1656148270276,MATH 142A,B05,093559,Staff,0,0,32,32
1656148276305,MATH 193A,A01,083224,Rotar; Vladimir,0,1,34,34
1656148276305,MATH 193A,A02,083225,Rotar; Vladimir,0,0,34,34
1656148276305,MATH 193A,A03,083781,Rotar; Vladimir,0,0,34,34
1656148276305,MATH 193A,A04,083782,Rotar; Vladimir,6,0,34,28
1656148276305,MATH 193A,A05,093482,Rotar; Vladimir,1,0,34,33
1656148282334,MATH 197,001,091859,McAuley; Julian John,9999,0,9999,0
1656148282334,MATH 197,002,095566,Kedlaya; Kiran S.,9997,0,9999,2
1656148282334,MATH 197,003,095567,Xiao; Ming,9999,0,9999,0
1656148282334,MATH 197,004,095571,Perols; Johan Lars,9998,0,9999,1
1656148289410,COGS 9,A01,083615,Shannon; Kyle Michael,4,0,75,71
1656148295434,COGS 11,A01,083617,Boyle; Mary E. T.,15,0,48,33
1656148301462,COGS 13,A01,083071,Bastos; Amalia Pinkusfeld,6,0,71,65
1656148307490,COGS 14A,A01,092681,Semenuks; Arturs,4,15,100,96
1656148313518,COGS 14B,A01,083073,Cheng; Tzu-Han,7,0,63,56
1656148319546,COGS 17,A01,092677,Semenuks; Arturs,8,0,81,73
1656148325572,COGS 100,A01,083619,Allen; Michael Gordon,3,0,70,67
1656148331597,COGS 101A,A01,083621,Davis; Joshua Daniel,3,0,68,65
1656148337621,COGS 101B,A01,091572,Allen; Michael Gordon,6,0,65,59
1656148343645,COGS 101C,A01,083625,Delgado; Tania,10,0,35,25
1656148349670,COGS 107A,A01,083627,Boyle; Mary E. T.,0,0,60,60
1656148355697,COGS 118A,A01,083075,Gupta; Anjum,7,0,76,69
1656148361725,CSE 3,A50,083646,Miranda; Gregory Joseph,18,0,50,32
1656148367748,CSE 8A,A50,083650,Miranda; Gregory Joseph,3,3,56,53
1656148373772,CSE 11,A01,083080,Cao; Yingjun,1,54,40,39
1656148379797,CSE 12,A01,083652,Krause-Levy; Sophia Louisa,7,2,120,113
1656148385820,CSE 15L,A01,083654,Morris; Justin Loren,2,0,50,48
1656148385820,CSE 15L,A02,083655,Morris; Justin Loren,4,0,50,46
1656148391844,CSE 20,A01,083657,Tran; Khoa Dang,31,0,80,49
1656148397871,CSE 21,A01,095574,Bach; Quang Tran,25,0,48,23
1656148403895,CSE 30,A01,083084,Eldon; John,2,8,80,78
1656148403895,CSE 30,B01,095061,Bhaskar; Nishant,1,2,50,49
1656148409923,CSE 100,A01,083659,Cao; Yingjun,2,20,70,68
1656148415948,CSE 134B,A01,083661,Powell; Thomas Allan,3,0,100,97
1656148421973,CSE 140,A01,083663,Gungor; Onat,9,0,85,76
1656148428007,CSE 140L,A01,083088,Eldon; John,8,0,100,92
1656148434030,CSE 175,A01,083665,Kumar; Rakesh,0,0,25,25
1656148440054,CSE 190,A00,092507,Dubnov; Shlomo,3,0,20,17
1656148446078,ECE 45,A01,083139,Congero; Spencer William,1,0,75,74
1656148452107,ECE 65,A50,083695,Saad; Andrew S,8,0,30,22
1656148452107,ECE 65,A51,095125,Staff,23,0,26,3
1656148458131,ECE 109,A01,091882,Touri; Behrouz,0,1,70,70
1656148464160,ECE 180,A00,083140,Abi Samra; Nicholas Camill,1,0,30,29
1656148464160,ECE 180,B00,083141,Abi Samra; Nicholas Camill,0,4,30,30
1656148470186,MATH 10A,A01,083735,Patchell; Gregory David,0,0,30,30
1656148470186,MATH 10A,A02,083736,Patchell; Gregory David,22,0,30,8
1656148470186,MATH 10A,A03,083737,Patchell; Gregory David,16,0,30,14
1656148476214,MATH 10B,A01,083207,Lim; Seonhee,0,0,34,34
1656148476214,MATH 10B,A02,083208,Lim; Seonhee,7,0,35,28
1656148476214,MATH 10B,A03,093472,Staff,1,0,34,33
1656148476214,MATH 10B,B01,083739,Sinha; Shubham,10,0,30,20
1656148482239,MATH 18,A01,083743,Cinel; Cameron Alexander,7,0,30,23
1656148482239,MATH 18,A02,083744,Cinel; Cameron Alexander,10,0,30,20
1656148482239,MATH 18,A03,083745,Cinel; Cameron Alexander,4,0,30,26
1656148482239,MATH 18,B01,083748,Rideout; David Porter,0,0,36,36
1656148482239,MATH 18,B02,083749,Rideout; David Porter,0,0,36,36
1656148482239,MATH 18,B03,083750,Rideout; David Porter,0,0,36,36
1656148482239,MATH 18,B04,083751,Rideout; David Porter,0,0,36,36
1656148482239,MATH 18,B05,093473,Rideout; David Porter,1,0,36,35
1656148482239,MATH 18,B06,093474,Rideout; David Porter,4,0,36,32
1656148488269,MATH 20A,A01,083754,Zheng; Zequn,11,0,40,29
1656148494292,MATH 20B,A01,083756,Briones; Jor-el Thomas Caparas,0,0,36,36
1656148494292,MATH 20B,A02,083757,Briones; Jor-el Thomas Caparas,0,0,36,36
1656148494292,MATH 20B,A03,093475,Staff,2,0,36,34
1656148500317,MATH 20C,A01,083760,Briones; Jor-el Thomas Caparas,0,0,35,35
1656148500317,MATH 20C,A02,083761,Briones; Jor-el Thomas Caparas,9,1,35,26
1656148500317,MATH 20C,A03,093476,Staff,0,0,35,35
1656148500317,MATH 20C,B01,083762,Bach; Quang Tran,1,0,30,29
1656148506340,MATH 20D,A01,083765,Tran; Brian Kha,2,0,30,28
1656148506340,MATH 20D,A02,083766,Tran; Brian Kha,0,1,30,30
1656148506340,MATH 20D,A03,083767,Tran; Brian Kha,2,0,30,28
1656148512366,MATH 20E,A01,083771,Ganguly; Soumya,4,0,32,28
1656148512366,MATH 20E,A02,083772,Ganguly; Soumya,0,0,32,32
1656148512366,MATH 20E,B01,083773,Ciotti; Benjamin,15,0,35,20
1656148512366,MATH 20E,B02,083774,Ciotti; Benjamin,14,0,35,21
1656148518390,MATH 103A,A01,083777,Greenfeld; Be'Eri,1,0,36,35
1656148518390,MATH 103A,A02,083778,Greenfeld; Be'Eri,1,0,36,35
1656148518390,MATH 103A,A03,093561,Staff,4,0,36,32
1656148518390,MATH 103A,B01,083779,Greenfeld; Be'Eri,8,1,36,28
1656148518390,MATH 103A,B02,083780,Greenfeld; Be'Eri,1,0,36,35
1656148518390,MATH 103A,B03,093562,Staff,0,0,36,36
1656148524418,MATH 105,A01,085443,Carter; Anne Toulson,4,1,35,31
1656148524418,MATH 105,A02,093477,Staff,11,0,35,24
1656148530443,MATH 109,A01,083213,Ganzberger; Geoffrey Michael,0,0,34,34
1656148530443,MATH 109,A02,083214,Ganzberger; Geoffrey Michael,0,0,34,34
1656148530443,MATH 109,A03,093478,Staff,1,0,34,33
1656148530443,MATH 109,B01,083215,Ganzberger; Geoffrey Michael,4,0,32,28
1656148530443,MATH 109,B02,083216,Ganzberger; Geoffrey Michael,1,0,32,31
1656148530443,MATH 109,B03,093479,Staff,4,0,32,28
1656148536474,MATH 142A,A01,083219,Chow; Bennett,1,0,32,31
1656148536474,MATH 142A,A02,083220,Chow; Bennett,8,0,32,24
1656148536474,MATH 142A,A03,093480,Staff,5,0,32,27
1656148536474,MATH 142A,B03,093481,Staff,4,0,32,28
1656148536474,MATH 142A,B04,093558,Staff,6,0,32,26
1656148536474,MATH 142A,B05,093559,Staff,0,0,32,32
1656148542503,MATH 193A,A01,083224,Rotar; Vladimir,0,1,34,34
1656148542503,MATH 193A,A02,083225,Rotar; Vladimir,0,0,34,34
1656148542503,MATH 193A,A03,083781,Rotar; Vladimir,0,0,34,34
1656148542503,MATH 193A,A04,083782,Rotar; Vladimir,6,0,34,28
1656148542503,MATH 193A,A05,093482,Rotar; Vladimir,1,0,34,33
1656148548527,MATH 197,001,091859,McAuley; Julian John,9999,0,9999,0
1656148548527,MATH 197,002,095566,Kedlaya; Kiran S.,9997,0,9999,2
1656148548527,MATH 197,003,095567,Xiao; Ming,9999,0,9999,0
1656148548527,MATH 197,004,095571,Perols; Johan Lars,9998,0,9999,1
1656148555586,COGS 9,A01,083615,Shannon; Kyle Michael,4,0,75,71
1656148561613,COGS 11,A01,083617,Boyle; Mary E. T.,15,0,48,33
1656148567635,COGS 13,A01,083071,Bastos; Amalia Pinkusfeld,6,0,71,65
1656148573662,COGS 14A,A01,092681,Semenuks; Arturs,4,15,100,96
1656148579687,COGS 14B,A01,083073,Cheng; Tzu-Han,7,0,63,56
1656148585709,COGS 17,A01,092677,Semenuks; Arturs,8,0,81,73
1656148591733,COGS 100,A01,083619,Allen; Michael Gordon,3,0,70,67
1656148597760,COGS 101A,A01,083621,Davis; Joshua Daniel,3,0,68,65
1656148603787,COGS 101B,A01,091572,Allen; Michael Gordon,6,0,65,59
1656148609811,COGS 101C,A01,083625,Delgado; Tania,10,0,35,25
1656148615833,COGS 107A,A01,083627,Boyle; Mary E. T.,0,0,60,60
1656148621857,COGS 118A,A01,083075,Gupta; Anjum,7,0,76,69
1656148627888,CSE 3,A50,083646,Miranda; Gregory Joseph,18,0,50,32
1656148633912,CSE 8A,A50,083650,Miranda; Gregory Joseph,3,3,56,53
1656148639936,CSE 11,A01,083080,Cao; Yingjun,1,54,40,39
1656148645974,CSE 12,A01,083652,Krause-Levy; Sophia Louisa,7,2,120,113
1656148652010,CSE 15L,A01,083654,Morris; Justin Loren,2,0,50,48
1656148652010,CSE 15L,A02,083655,Morris; Justin Loren,4,0,50,46
1656148658037,CSE 20,A01,083657,Tran; Khoa Dang,31,0,80,49
1656148664070,CSE 21,A01,095574,Bach; Quang Tran,25,0,48,23
1656148670093,CSE 30,A01,083084,Eldon; John,2,8,80,78
1656148670093,CSE 30,B01,095061,Bhaskar; Nishant,1,2,50,49
1656148676117,CSE 100,A01,083659,Cao; Yingjun,2,20,70,68
1656148682140,CSE 134B,A01,083661,Powell; Thomas Allan,3,0,100,97
1656148688163,CSE 140,A01,083663,Gungor; Onat,9,0,85,76
1656148694189,CSE 140L,A01,083088,Eldon; John,8,0,100,92
1656148700216,CSE 175,A01,083665,Kumar; Rakesh,0,0,25,25
1656148706243,CSE 190,A00,092507,Dubnov; Shlomo,3,0,20,17
1656148712270,ECE 45,A01,083139,Congero; Spencer William,1,0,75,74
1656148718299,ECE 65,A50,083695,Saad; Andrew S,8,0,30,22
1656148718299,ECE 65,A51,095125,Staff,23,0,26,3
1656148724321,ECE 109,A01,091882,Touri; Behrouz,0,1,70,70
1656148730345,ECE 180,A00,083140,Abi Samra; Nicholas Camill,1,0,30,29
1656148730345,ECE 180,B00,083141,Abi Samra; Nicholas Camill,0,4,30,30
1656148736386,MATH 10A,A01,083735,Patchell; Gregory David,0,0,30,30
1656148736386,MATH 10A,A02,083736,Patchell; Gregory David,22,0,30,8
1656148736386,MATH 10A,A03,083737,Patchell; Gregory David,16,0,30,14
1656148742411,MATH 10B,A01,083207,Lim; Seonhee,0,0,34,34
1656148742411,MATH 10B,A02,083208,Lim; Seonhee,7,0,35,28
1656148742411,MATH 10B,A03,093472,Staff,1,0,34,33
1656148742411,MATH 10B,B01,083739,Sinha; Shubham,10,0,30,20
1656148748434,MATH 18,A01,083743,Cinel; Cameron Alexander,7,0,30,23
1656148748434,MATH 18,A02,083744,Cinel; Cameron Alexander,10,0,30,20
1656148748434,MATH 18,A03,083745,Cinel; Cameron Alexander,4,0,30,26
1656148748434,MATH 18,B01,083748,Rideout; David Porter,0,0,36,36
1656148748434,MATH 18,B02,083749,Rideout; David Porter,0,0,36,36
1656148748434,MATH 18,B03,083750,Rideout; David Porter,0,0,36,36
1656148748434,MATH 18,B04,083751,Rideout; David Porter,0,0,36,36
1656148748434,MATH 18,B05,093473,Rideout; David Porter,1,0,36,35
1656148748434,MATH 18,B06,093474,Rideout; David Porter,4,0,36,32
1656148754461,MATH 20A,A01,083754,Zheng; Zequn,11,0,40,29
1656148760484,MATH 20B,A01,083756,Briones; Jor-el Thomas Caparas,0,0,36,36
1656148760484,MATH 20B,A02,083757,Briones; Jor-el Thomas Caparas,0,0,36,36
1656148760484,MATH 20B,A03,093475,Staff,2,0,36,34
1656148766518,MATH 20C,A01,083760,Briones; Jor-el Thomas Caparas,0,0,35,35
1656148766518,MATH 20C,A02,083761,Briones; Jor-el Thomas Caparas,9,1,35,26
1656148766518,MATH 20C,A03,093476,Staff,0,0,35,35
1656148766518,MATH 20C,B01,083762,Bach; Quang Tran,1,0,30,29
1656148772543,MATH 20D,A01,083765,Tran; Brian Kha,2,0,30,28
1656148772543,MATH 20D,A02,083766,Tran; Brian Kha,0,1,30,30
1656148772543,MATH 20D,A03,083767,Tran; Brian Kha,2,0,30,28
1656148778568,MATH 20E,A01,083771,Ganguly; Soumya,4,0,32,28
1656148778568,MATH 20E,A02,083772,Ganguly; Soumya,0,0,32,32
1656148778568,MATH 20E,B01,083773,Ciotti; Benjamin,15,0,35,20
1656148778568,MATH 20E,B02,083774,Ciotti; Benjamin,14,0,35,21
1656148784593,MATH 103A,A01,083777,Greenfeld; Be'Eri,1,0,36,35
1656148784593,MATH 103A,A02,083778,Greenfeld; Be'Eri,1,0,36,35
1656148784593,MATH 103A,A03,093561,Staff,4,0,36,32
1656148784593,MATH 103A,B01,083779,Greenfeld; Be'Eri,8,1,36,28
1656148784593,MATH 103A,B02,083780,Greenfeld; Be'Eri,1,0,36,35
1656148784593,MATH 103A,B03,093562,Staff,0,0,36,36
1656148790617,MATH 105,A01,085443,Carter; Anne Toulson,4,1,35,31
1656148790617,MATH 105,A02,093477,Staff,11,0,35,24
1656148796651,MATH 109,A01,083213,Ganzberger; Geoffrey Michael,0,0,34,34
1656148796651,MATH 109,A02,083214,Ganzberger; Geoffrey Michael,0,0,34,34
1656148796651,MATH 109,A03,093478,Staff,1,0,34,33
1656148796651,MATH 109,B01,083215,Ganzberger; Geoffrey Michael,4,0,32,28
1656148796651,MATH 109,B02,083216,Ganzberger; Geoffrey Michael,1,0,32,31
1656148796651,MATH 109,B03,093479,Staff,4,0,32,28
1656148802680,MATH 142A,A01,083219,Chow; Bennett,1,0,32,31
1656148802680,MATH 142A,A02,083220,Chow; Bennett,8,0,32,24
1656148802680,MATH 142A,A03,093480,Staff,5,0,32,27
1656148802680,MATH 142A,B03,093481,Staff,4,0,32,28
1656148802680,MATH 142A,B04,093558,Staff,6,0,32,26
1656148802680,MATH 142A,B05,093559,Staff,0,0,32,32
1656148808776,MATH 193A,A01,083224,Rotar; Vladimir,0,1,34,34
1656148808776,MATH 193A,A02,083225,Rotar; Vladimir,0,0,34,34
1656148808776,MATH 193A,A03,083781,Rotar; Vladimir,0,0,34,34
1656148808776,MATH 193A,A04,083782,Rotar; Vladimir,6,0,34,28
1656148808776,MATH 193A,A05,093482,Rotar; Vladimir,1,0,34,33
1656148814799,MATH 197,001,091859,McAuley; Julian John,9999,0,9999,0
1656148814799,MATH 197,002,095566,Kedlaya; Kiran S.,9997,0,9999,2
1656148814799,MATH 197,003,095567,Xiao; Ming,9999,0,9999,0
1656148814799,MATH 197,004,095571,Perols; Johan Lars,9998,0,9999,1
1656148821871,COGS 9,A01,083615,Shannon; Kyle Michael,4,0,75,71
1656148827894,COGS 11,A01,083617,Boyle; Mary E. T.,15,0,48,33
1656148833921,COGS 13,A01,083071,Bastos; Amalia Pinkusfeld,6,0,71,65
1656148839946,COGS 14A,A01,092681,Semenuks; Arturs,4,15,100,96
1656148845969,COGS 14B,A01,083073,Cheng; Tzu-Han,7,0,63,56
1656148851994,COGS 17,A01,092677,Semenuks; Arturs,8,0,81,73
1656148858017,COGS 100,A01,083619,Allen; Michael Gordon,3,0,70,67
1656148864045,COGS 101A,A01,083621,Davis; Joshua Daniel,3,0,68,65
1656148870069,COGS 101B,A01,091572,Allen; Michael Gordon,6,0,65,59
1656148876093,COGS 101C,A01,083625,Delgado; Tania,10,0,35,25
1656148882116,COGS 107A,A01,083627,Boyle; Mary E. T.,0,0,60,60
1656148888145,COGS 118A,A01,083075,Gupta; Anjum,7,0,76,69
1656148894170,CSE 3,A50,083646,Miranda; Gregory Joseph,18,0,50,32
1656148900194,CSE 8A,A50,083650,Miranda; Gregory Joseph,3,3,56,53
1656148906226,CSE 11,A01,083080,Cao; Yingjun,1,54,40,39
1656148912251,CSE 12,A01,083652,Krause-Levy; Sophia Louisa,7,2,120,113
1656148918274,CSE 15L,A01,083654,Morris; Justin Loren,2,0,50,48
1656148918274,CSE 15L,A02,083655,Morris; Justin Loren,4,0,50,46
1656148924318,CSE 20,A01,083657,Tran; Khoa Dang,31,0,80,49
1656148930341,CSE 21,A01,095574,Bach; Quang Tran,25,0,48,23
1656148936366,CSE 30,A01,083084,Eldon; John,2,8,80,78
1656148936366,CSE 30,B01,095061,Bhaskar; Nishant,1,2,50,49
1656148942395,CSE 100,A01,083659,Cao; Yingjun,2,20,70,68
1656148948419,CSE 134B,A01,083661,Powell; Thomas Allan,3,0,100,97
1656148954442,CSE 140,A01,083663,Gungor; Onat,9,0,85,76
1656148960465,CSE 140L,A01,083088,Eldon; John,8,0,100,92
1656148966491,CSE 175,A01,083665,Kumar; Rakesh,0,0,25,25
1656148972518,CSE 190,A00,092507,Dubnov; Shlomo,3,0,20,17
1656148978543,ECE 45,A01,083139,Congero; Spencer William,1,0,75,74
1656148984572,ECE 65,A50,083695,Saad; Andrew S,8,0,30,22
1656148984572,ECE 65,A51,095125,Staff,23,0,26,3
1656148990595,ECE 109,A01,091882,Touri; Behrouz,0,1,70,70
1656148996621,ECE 180,A00,083140,Abi Samra; Nicholas Camill,1,0,30,29
1656148996621,ECE 180,B00,083141,Abi Samra; Nicholas Camill,0,4,30,30
1656149002646,MATH 10A,A01,083735,Patchell; Gregory David,0,0,30,30
1656149002646,MATH 10A,A02,083736,Patchell; Gregory David,22,0,30,8
1656149002646,MATH 10A,A03,083737,Patchell; Gregory David,16,0,30,14
1656149008684,MATH 10B,A01,083207,Lim; Seonhee,0,0,34,34
1656149008684,MATH 10B,A02,083208,Lim; Seonhee,7,0,35,28
1656149008684,MATH 10B,A03,093472,Staff,1,0,34,33
1656149008684,MATH 10B,B01,083739,Sinha; Shubham,10,0,30,20
1656149014710,MATH 18,A01,083743,Cinel; Cameron Alexander,7,0,30,23
1656149014710,MATH 18,A02,083744,Cinel; Cameron Alexander,10,0,30,20
1656149014710,MATH 18,A03,083745,Cinel; Cameron Alexander,4,0,30,26
1656149014710,MATH 18,B01,083748,Rideout; David Porter,0,0,36,36
1656149014710,MATH 18,B02,083749,Rideout; David Porter,0,0,36,36
1656149014710,MATH 18,B03,083750,Rideout; David Porter,0,0,36,36
1656149014710,MATH 18,B04,083751,Rideout; David Porter,0,0,36,36
1656149014710,MATH 18,B05,093473,Rideout; David Porter,1,0,36,35
1656149014710,MATH 18,B06,093474,Rideout; David Porter,4,0,36,32
1656149020737,MATH 20A,A01,083754,Zheng; Zequn,11,0,40,29
1656149026767,MATH 20B,A01,083756,Briones; Jor-el Thomas Caparas,0,0,36,36
1656149026767,MATH 20B,A02,083757,Briones; Jor-el Thomas Caparas,0,0,36,36
1656149026767,MATH 20B,A03,093475,Staff,2,0,36,34
1656149032797,MATH 20C,A01,083760,Briones; Jor-el Thomas Caparas,0,0,35,35
1656149032797,MATH 20C,A02,083761,Briones; Jor-el Thomas Caparas,9,1,35,26
1656149032797,MATH 20C,A03,093476,Staff,0,0,35,35
1656149032797,MATH 20C,B01,083762,Bach; Quang Tran,1,0,30,29
1656149038825,MATH 20D,A01,083765,Tran; Brian Kha,2,0,30,28
1656149038825,MATH 20D,A02,083766,Tran; Brian Kha,0,1,30,30
1656149038825,MATH 20D,A03,083767,Tran; Brian Kha,2,0,30,28
1656149044849,MATH 20E,A01,083771,Ganguly; Soumya,4,0,32,28
1656149044849,MATH 20E,A02,083772,Ganguly; Soumya,0,0,32,32
1656149044849,MATH 20E,B01,083773,Ciotti; Benjamin,15,0,35,20
1656149044849,MATH 20E,B02,083774,Ciotti; Benjamin,14,0,35,21
1656149050881,MATH 103A,A01,083777,Greenfeld; Be'Eri,1,0,36,35
1656149050881,MATH 103A,A02,083778,Greenfeld; Be'Eri,1,0,36,35
1656149050881,MATH 103A,A03,093561,Staff,4,0,36,32
1656149050881,MATH 103A,B01,083779,Greenfeld; Be'Eri,8,1,36,28
1656149050881,MATH 103A,B02,083780,Greenfeld; Be'Eri,1,0,36,35
1656149050881,MATH 103A,B03,093562,Staff,0,0,36,36
1656149056910,MATH 105,A01,085443,Carter; Anne Toulson,4,1,35,31
1656149056910,MATH 105,A02,093477,Staff,11,0,35,24
1656149062934,MATH 109,A01,083213,Ganzberger; Geoffrey Michael,0,0,34,34
1656149062934,MATH 109,A02,083214,Ganzberger; Geoffrey Michael,0,0,34,34
1656149062934,MATH 109,A03,093478,Staff,1,0,34,33
1656149062934,MATH 109,B01,083215,Ganzberger; Geoffrey Michael,4,0,32,28
1656149062934,MATH 109,B02,083216,Ganzberger; Geoffrey Michael,1,0,32,31
1656149062934,MATH 109,B03,093479,Staff,4,0,32,28
1656149068963,MATH 142A,A01,083219,Chow; Bennett,1,0,32,31
1656149068963,MATH 142A,A02,083220,Chow; Bennett,8,0,32,24
1656149068963,MATH 142A,A03,093480,Staff,5,0,32,27
1656149068963,MATH 142A,B03,093481,Staff,4,0,32,28
1656149068963,MATH 142A,B04,093558,Staff,6,0,32,26
1656149068963,MATH 142A,B05,093559,Staff,0,0,32,32
1656149074992,MATH 193A,A01,083224,Rotar; Vladimir,0,1,34,34
1656149074992,MATH 193A,A02,083225,Rotar; Vladimir,0,0,34,34
1656149074992,MATH 193A,A03,083781,Rotar; Vladimir,0,0,34,34
1656149074992,MATH 193A,A04,083782,Rotar; Vladimir,6,0,34,28
1656149074992,MATH 193A,A05,093482,Rotar; Vladimir,1,0,34,33
1656149081017,MATH 197,001,091859,McAuley; Julian John,9999,0,9999,0
1656149081017,MATH 197,002,095566,Kedlaya; Kiran S.,9997,0,9999,2
1656149081017,MATH 197,003,095567,Xiao; Ming,9999,0,9999,0
1656149081017,MATH 197,004,095571,Perols; Johan Lars,9998,0,9999,1
1656149088071,COGS 9,A01,083615,Shannon; Kyle Michael,4,0,75,71
1656149094097,COGS 11,A01,083617,Boyle; Mary E. T.,15,0,48,33
1656149100121,COGS 13,A01,083071,Bastos; Amalia Pinkusfeld,6,0,71,65
1656149106149,COGS 14A,A01,092681,Semenuks; Arturs,4,15,100,96
1656149112177,COGS 14B,A01,083073,Cheng; Tzu-Han,7,0,63,56
1656149118202,COGS 17,A01,092677,Semenuks; Arturs,8,0,81,73
1656149124230,COGS 100,A01,083619,Allen; Michael Gordon,3,0,70,67
1656149130254,COGS 101A,A01,083621,Davis; Joshua Daniel,3,0,68,65
1656149136278,COGS 101B,A01,091572,Allen; Michael Gordon,6,0,65,59
1656149142302,COGS 101C,A01,083625,Delgado; Tania,10,0,35,25
1656149148332,COGS 107A,A01,083627,Boyle; Mary E. T.,0,0,60,60
1656149154355,COGS 118A,A01,083075,Gupta; Anjum,7,0,76,69
1656149160382,CSE 3,A50,083646,Miranda; Gregory Joseph,18,0,50,32
1656149166406,CSE 8A,A50,083650,Miranda; Gregory Joseph,3,3,56,53
1656149172440,CSE 11,A01,083080,Cao; Yingjun,1,54,40,39
1656149178464,CSE 12,A01,083652,Krause-Levy; Sophia Louisa,7,2,120,113
1656149184488,CSE 15L,A01,083654,Morris; Justin Loren,2,0,50,48
1656149184488,CSE 15L,A02,083655,Morris; Justin Loren,4,0,50,46
1656149190515,CSE 20,A01,083657,Tran; Khoa Dang,31,0,80,49
1656149196543,CSE 21,A01,095574,Bach; Quang Tran,25,0,48,23
1656149202571,CSE 30,A01,083084,Eldon; John,2,8,80,78
1656149202571,CSE 30,B01,095061,Bhaskar; Nishant,1,2,50,49
1656149208594,CSE 100,A01,083659,Cao; Yingjun,2,20,70,68
1656149214619,CSE 134B,A01,083661,Powell; Thomas Allan,3,0,100,97
1656149220645,CSE 140,A01,083663,Gungor; Onat,9,0,85,76
1656149226669,CSE 140L,A01,083088,Eldon; John,8,0,100,92
1656149232694,CSE 175,A01,083665,Kumar; Rakesh,0,0,25,25
1656149238721,CSE 190,A00,092507,Dubnov; Shlomo,3,0,20,17
1656149244746,ECE 45,A01,083139,Congero; Spencer William,1,0,75,74
1656149250774,ECE 65,A50,083695,Saad; Andrew S,8,0,30,22
1656149250774,ECE 65,A51,095125,Staff,23,0,26,3
1656149256803,ECE 109,A01,091882,Touri; Behrouz,0,1,70,70
1656149262827,ECE 180,A00,083140,Abi Samra; Nicholas Camill,1,0,30,29
1656149262827,ECE 180,B00,083141,Abi Samra; Nicholas Camill,0,4,30,30
1656149268851,MATH 10A,A01,083735,Patchell; Gregory David,0,0,30,30
1656149268851,MATH 10A,A02,083736,Patchell; Gregory David,22,0,30,8
1656149268851,MATH 10A,A03,083737,Patchell; Gregory David,16,0,30,14
1656149274881,MATH 10B,A01,083207,Lim; Seonhee,0,0,34,34
1656149274881,MATH 10B,A02,083208,Lim; Seonhee,7,0,35,28
1656149274881,MATH 10B,A03,093472,Staff,1,0,34,33
1656149274881,MATH 10B,B01,083739,Sinha; Shubham,10,0,30,20
1656149280908,MATH 18,A01,083743,Cinel; Cameron Alexander,7,0,30,23
1656149280908,MATH 18,A02,083744,Cinel; Cameron Alexander,10,0,30,20
1656149280908,MATH 18,A03,083745,Cinel; Cameron Alexander,4,0,30,26
1656149280908,MATH 18,B01,083748,Rideout; David Porter,0,0,36,36
1656149280908,MATH 18,B02,083749,Rideout; David Porter,0,0,36,36
1656149280908,MATH 18,B03,083750,Rideout; David Porter,0,0,36,36
1656149280908,MATH 18,B04,083751,Rideout; David Porter,0,0,36,36
1656149280908,MATH 18,B05,093473,Rideout; David Porter,1,0,36,35
1656149280908,MATH 18,B06,093474,Rideout; David Porter,4,0,36,32
1656149286934,MATH 20A,A01,083754,Zheng; Zequn,11,0,40,29
1656149292960,MATH 20B,A01,083756,Briones; Jor-el Thomas Caparas,0,0,36,36
1656149292960,MATH 20B,A02,083757,Briones; Jor-el Thomas Caparas,0,0,36,36
1656149292960,MATH 20B,A03,093475,Staff,2,0,36,34
1656149298993,MATH 20C,A01,083760,Briones; Jor-el Thomas Caparas,0,0,35,35
1656149298993,MATH 20C,A02,083761,Briones; Jor-el Thomas Caparas,9,1,35,26
1656149298993,MATH 20C,A03,093476,Staff,0,0,35,35
1656149298993,MATH 20C,B01,083762,Bach; Quang Tran,1,0,30,29
1656149305020,MATH 20D,A01,083765,Tran; Brian Kha,2,0,30,28
1656149305020,MATH 20D,A02,083766,Tran; Brian Kha,0,1,30,30
1656149305020,MATH 20D,A03,083767,Tran; Brian Kha,2,0,30,28
1656149311047,MATH 20E,A01,083771,Ganguly; Soumya,4,0,32,28
1656149311047,MATH 20E,A02,083772,Ganguly; Soumya,0,0,32,32
1656149311047,MATH 20E,B01,083773,Ciotti; Benjamin,15,0,35,20
1656149311047,MATH 20E,B02,083774,Ciotti; Benjamin,14,0,35,21
1656149317081,MATH 103A,A01,083777,Greenfeld; Be'Eri,1,0,36,35
1656149317081,MATH 103A,A02,083778,Greenfeld; Be'Eri,1,0,36,35
1656149317081,MATH 103A,A03,093561,Staff,4,0,36,32
1656149317081,MATH 103A,B01,083779,Greenfeld; Be'Eri,8,1,36,28
1656149317081,MATH 103A,B02,083780,Greenfeld; Be'Eri,1,0,36,35
1656149317081,MATH 103A,B03,093562,Staff,0,0,36,36
1656149323111,MATH 105,A01,085443,Carter; Anne Toulson,4,1,35,31
1656149323111,MATH 105,A02,093477,Staff,11,0,35,24
1656149329134,MATH 109,A01,083213,Ganzberger; Geoffrey Michael,0,0,34,34
1656149329134,MATH 109,A02,083214,Ganzberger; Geoffrey Michael,0,0,34,34
1656149329134,MATH 109,A03,093478,Staff,1,0,34,33
1656149329134,MATH 109,B01,083215,Ganzberger; Geoffrey Michael,4,0,32,28
1656149329134,MATH 109,B02,083216,Ganzberger; Geoffrey Michael,1,0,32,31
1656149329134,MATH 109,B03,093479,Staff,4,0,32,28
1656149335167,MATH 142A,A01,083219,Chow; Bennett,1,0,32,31
1656149335167,MATH 142A,A02,083220,Chow; Bennett,8,0,32,24
1656149335167,MATH 142A,A03,093480,Staff,5,0,32,27
1656149335167,MATH 142A,B03,093481,Staff,4,0,32,28
1656149335167,MATH 142A,B04,093558,Staff,6,0,32,26
1656149335167,MATH 142A,B05,093559,Staff,0,0,32,32
1656149341198,MATH 193A,A01,083224,Rotar; Vladimir,0,1,34,34
1656149341198,MATH 193A,A02,083225,Rotar; Vladimir,0,0,34,34
1656149341198,MATH 193A,A03,083781,Rotar; Vladimir,0,0,34,34
1656149341198,MATH 193A,A04,083782,Rotar; Vladimir,6,0,34,28
1656149341198,MATH 193A,A05,093482,Rotar; Vladimir,1,0,34,33
1656149347227,MATH 197,001,091859,McAuley; Julian John,9999,0,9999,0
1656149347227,MATH 197,002,095566,Kedlaya; Kiran S.,9997,0,9999,2
1656149347227,MATH 197,003,095567,Xiao; Ming,9999,0,9999,0
1656149347227,MATH 197,004,095571,Perols; Johan Lars,9998,0,9999,1
1656149354310,COGS 9,A01,083615,Shannon; Kyle Michael,4,0,75,71
1656149360338,COGS 11,A01,083617,Boyle; Mary E. T.,15,0,48,33
1656149366367,COGS 13,A01,083071,Bastos; Amalia Pinkusfeld,6,0,71,65
1656149372392,COGS 14A,A01,092681,Semenuks; Arturs,4,15,100,96
1656149378419,COGS 14B,A01,083073,Cheng; Tzu-Han,7,0,63,56
1656149384443,COGS 17,A01,092677,Semenuks; Arturs,8,0,81,73
1656149390470,COGS 100,A01,083619,Allen; Michael Gordon,3,0,70,67
1656149396500,COGS 101A,A01,083621,Davis; Joshua Daniel,3,0,68,65
1656149402629,COGS 101B,A01,091572,Allen; Michael Gordon,6,0,65,59
1656149408651,COGS 101C,A01,083625,Delgado; Tania,10,0,35,25
1656149414678,COGS 107A,A01,083627,Boyle; Mary E. T.,0,0,60,60
1656149420703,COGS 118A,A01,083075,Gupta; Anjum,7,0,76,69
1656149426729,CSE 3,A50,083646,Miranda; Gregory Joseph,18,0,50,32
1656149432755,CSE 8A,A50,083650,Miranda; Gregory Joseph,3,3,56,53
1656149438787,CSE 11,A01,083080,Cao; Yingjun,1,54,40,39
1656149444816,CSE 12,A01,083652,Krause-Levy; Sophia Louisa,7,2,120,113
1656149450843,CSE 15L,A01,083654,Morris; Justin Loren,2,0,50,48
1656149450843,CSE 15L,A02,083655,Morris; Justin Loren,4,0,50,46
1656149456873,CSE 20,A01,083657,Tran; Khoa Dang,31,0,80,49
1656149462896,CSE 21,A01,095574,Bach; Quang Tran,25,0,48,23
1656149468921,CSE 30,A01,083084,Eldon; John,2,8,80,78
1656149468921,CSE 30,B01,095061,Bhaskar; Nishant,1,2,50,49
1656149474946,CSE 100,A01,083659,Cao; Yingjun,2,20,70,68
1656149480970,CSE 134B,A01,083661,Powell; Thomas Allan,3,0,100,97
1656149486993,CSE 140,A01,083663,Gungor; Onat,9,0,85,76
1656149493023,CSE 140L,A01,083088,Eldon; John,8,0,100,92
1656149499049,CSE 175,A01,083665,Kumar; Rakesh,0,0,25,25
1656149505073,CSE 190,A00,092507,Dubnov; Shlomo,3,0,20,17
1656149511097,ECE 45,A01,083139,Congero; Spencer William,1,0,75,74
1656149517126,ECE 65,A50,083695,Saad; Andrew S,8,0,30,22
1656149517126,ECE 65,A51,095125,Staff,23,0,26,3
1656149523154,ECE 109,A01,091882,Touri; Behrouz,0,1,70,70
1656149529178,ECE 180,A00,083140,Abi Samra; Nicholas Camill,1,0,30,29
1656149529178,ECE 180,B00,083141,Abi Samra; Nicholas Camill,0,4,30,30
1656149535209,MATH 10A,A01,083735,Patchell; Gregory David,0,0,30,30
1656149535209,MATH 10A,A02,083736,Patchell; Gregory David,22,0,30,8
1656149535209,MATH 10A,A03,083737,Patchell; Gregory David,16,0,30,14
1656149541234,MATH 10B,A01,083207,Lim; Seonhee,0,0,34,34
1656149541234,MATH 10B,A02,083208,Lim; Seonhee,7,0,35,28
1656149541234,MATH 10B,A03,093472,Staff,1,0,34,33
1656149541234,MATH 10B,B01,083739,Sinha; Shubham,10,0,30,20
1656149547268,MATH 18,A01,083743,Cinel; Cameron Alexander,7,0,30,23
1656149547268,MATH 18,A02,083744,Cinel; Cameron Alexander,10,0,30,20
1656149547268,MATH 18,A03,083745,Cinel; Cameron Alexander,4,0,30,26
1656149547268,MATH 18,B01,083748,Rideout; David Porter,0,0,36,36
1656149547268,MATH 18,B02,083749,Rideout; David Porter,0,0,36,36
1656149547268,MATH 18,B03,083750,Rideout; David Porter,0,0,36,36
1656149547268,MATH 18,B04,083751,Rideout; David Porter,0,0,36,36
1656149547268,MATH 18,B05,093473,Rideout; David Porter,1,0,36,35
1656149547268,MATH 18,B06,093474,Rideout; David Porter,4,0,36,32
1656149553292,MATH 20A,A01,083754,Zheng; Zequn,11,0,40,29
1656149559321,MATH 20B,A01,083756,Briones; Jor-el Thomas Caparas,0,0,36,36
1656149559321,MATH 20B,A02,083757,Briones; Jor-el Thomas Caparas,0,0,36,36
1656149559321,MATH 20B,A03,093475,Staff,2,0,36,34
1656149565356,MATH 20C,A01,083760,Briones; Jor-el Thomas Caparas,0,0,35,35
1656149565356,MATH 20C,A02,083761,Briones; Jor-el Thomas Caparas,9,1,35,26
1656149565356,MATH 20C,A03,093476,Staff,0,0,35,35
1656149565356,MATH 20C,B01,083762,Bach; Quang Tran,1,0,30,29
1656149571385,MATH 20D,A01,083765,Tran; Brian Kha,2,0,30,28
1656149571385,MATH 20D,A02,083766,Tran; Brian Kha,0,1,30,30
1656149571385,MATH 20D,A03,083767,Tran; Brian Kha,2,0,30,28
1656149577410,MATH 20E,A01,083771,Ganguly; Soumya,4,0,32,28
1656149577410,MATH 20E,A02,083772,Ganguly; Soumya,0,0,32,32
1656149577410,MATH 20E,B01,083773,Ciotti; Benjamin,15,0,35,20
1656149577410,MATH 20E,B02,083774,Ciotti; Benjamin,14,0,35,21
1656149583434,MATH 103A,A01,083777,Greenfeld; Be'Eri,1,0,36,35
1656149583434,MATH 103A,A02,083778,Greenfeld; Be'Eri,1,0,36,35
1656149583434,MATH 103A,A03,093561,Staff,4,0,36,32
1656149583434,MATH 103A,B01,083779,Greenfeld; Be'Eri,8,1,36,28
1656149583434,MATH 103A,B02,083780,Greenfeld; Be'Eri,1,0,36,35
1656149583434,MATH 103A,B03,093562,Staff,0,0,36,36
1656149589462,MATH 105,A01,085443,Carter; Anne Toulson,4,1,35,31
1656149589462,MATH 105,A02,093477,Staff,11,0,35,24
1656149595484,MATH 109,A01,083213,Ganzberger; Geoffrey Michael,0,0,34,34
1656149595484,MATH 109,A02,083214,Ganzberger; Geoffrey Michael,0,0,34,34
1656149595484,MATH 109,A03,093478,Staff,1,0,34,33
1656149595484,MATH 109,B01,083215,Ganzberger; Geoffrey Michael,4,0,32,28
1656149595484,MATH 109,B02,083216,Ganzberger; Geoffrey Michael,1,0,32,31
1656149595484,MATH 109,B03,093479,Staff,4,0,32,28
1656149601512,MATH 142A,A01,083219,Chow; Bennett,1,0,32,31
1656149601512,MATH 142A,A02,083220,Chow; Bennett,8,0,32,24
1656149601512,MATH 142A,A03,093480,Staff,5,0,32,27
1656149601512,MATH 142A,B03,093481,Staff,4,0,32,28
1656149601512,MATH 142A,B04,093558,Staff,6,0,32,26
1656149601512,MATH 142A,B05,093559,Staff,0,0,32,32
1656149607537,MATH 193A,A01,083224,Rotar; Vladimir,0,1,34,34
1656149607537,MATH 193A,A02,083225,Rotar; Vladimir,0,0,34,34
1656149607537,MATH 193A,A03,083781,Rotar; Vladimir,0,0,34,34
1656149607537,MATH 193A,A04,083782,Rotar; Vladimir,6,0,34,28
1656149607537,MATH 193A,A05,093482,Rotar; Vladimir,1,0,34,33
1656149613565,MATH 197,001,091859,McAuley; Julian John,9999,0,9999,0
1656149613565,MATH 197,002,095566,Kedlaya; Kiran S.,9997,0,9999,2
1656149613565,MATH 197,003,095567,Xiao; Ming,9999,0,9999,0
1656149613565,MATH 197,004,095571,Perols; Johan Lars,9998,0,9999,1
1656149620630,COGS 9,A01,083615,Shannon; Kyle Michael,4,0,75,71
1656149626652,COGS 11,A01,083617,Boyle; Mary E. T.,15,0,48,33
1656149632677,COGS 13,A01,083071,Bastos; Amalia Pinkusfeld,6,0,71,65
1656149638702,COGS 14A,A01,092681,Semenuks; Arturs,4,15,100,96
1656149644730,COGS 14B,A01,083073,Cheng; Tzu-Han,7,0,63,56
1656149650753,COGS 17,A01,092677,Semenuks; Arturs,8,0,81,73
1656149656775,COGS 100,A01,083619,Allen; Michael Gordon,3,0,70,67
1656149662800,COGS 101A,A01,083621,Davis; Joshua Daniel,3,0,68,65
1656149668827,COGS 101B,A01,091572,Allen; Michael Gordon,6,0,65,59
1656149674850,COGS 101C,A01,083625,Delgado; Tania,10,0,35,25
1656149680874,COGS 107A,A01,083627,Boyle; Mary E. T.,0,0,60,60
1656149686900,COGS 118A,A01,083075,Gupta; Anjum,7,0,76,69
1656149692930,CSE 3,A50,083646,Miranda; Gregory Joseph,18,0,50,32
1656149698955,CSE 8A,A50,083650,Miranda; Gregory Joseph,3,3,56,53
1656149704986,CSE 11,A01,083080,Cao; Yingjun,1,54,40,39
1656149711012,CSE 12,A01,083652,Krause-Levy; Sophia Louisa,7,2,120,113
1656149717036,CSE 15L,A01,083654,Morris; Justin Loren,2,0,50,48
1656149717036,CSE 15L,A02,083655,Morris; Justin Loren,4,0,50,46
1656149723063,CSE 20,A01,083657,Tran; Khoa Dang,31,0,80,49
1656149729091,CSE 21,A01,095574,Bach; Quang Tran,25,0,48,23
1656149735120,CSE 30,A01,083084,Eldon; John,2,8,80,78
1656149735120,CSE 30,B01,095061,Bhaskar; Nishant,1,2,50,49
1656149741143,CSE 100,A01,083659,Cao; Yingjun,2,20,70,68
1656149747169,CSE 134B,A01,083661,Powell; Thomas Allan,3,0,100,97
1656149753197,CSE 140,A01,083663,Gungor; Onat,9,0,85,76
1656149759221,CSE 140L,A01,083088,Eldon; John,8,0,100,92
1656149765245,CSE 175,A01,083665,Kumar; Rakesh,0,0,25,25
1656149771268,CSE 190,A00,092507,Dubnov; Shlomo,3,0,20,17
1656149777296,ECE 45,A01,083139,Congero; Spencer William,1,0,75,74
1656149783324,ECE 65,A50,083695,Saad; Andrew S,8,0,30,22
1656149783324,ECE 65,A51,095125,Staff,23,0,26,3
1656149789346,ECE 109,A01,091882,Touri; Behrouz,0,1,70,70
1656149795376,ECE 180,A00,083140,Abi Samra; Nicholas Camill,1,0,30,29
1656149795376,ECE 180,B00,083141,Abi Samra; Nicholas Camill,0,4,30,30
1656149801403,MATH 10A,A01,083735,Patchell; Gregory David,0,0,30,30
1656149801403,MATH 10A,A02,083736,Patchell; Gregory David,22,0,30,8
1656149801403,MATH 10A,A03,083737,Patchell; Gregory David,16,0,30,14
1656149807433,MATH 10B,A01,083207,Lim; Seonhee,0,0,34,34
1656149807433,MATH 10B,A02,083208,Lim; Seonhee,7,0,35,28
1656149807433,MATH 10B,A03,093472,Staff,1,0,34,33
1656149807433,MATH 10B,B01,083739,Sinha; Shubham,10,0,30,20
1656149813465,MATH 18,A01,083743,Cinel; Cameron Alexander,7,0,30,23
1656149813465,MATH 18,A02,083744,Cinel; Cameron Alexander,10,0,30,20
1656149813465,MATH 18,A03,083745,Cinel; Cameron Alexander,4,0,30,26
1656149813465,MATH 18,B01,083748,Rideout; David Porter,0,0,36,36
1656149813465,MATH 18,B02,083749,Rideout; David Porter,0,0,36,36
1656149813465,MATH 18,B03,083750,Rideout; David Porter,0,0,36,36
1656149813465,MATH 18,B04,083751,Rideout; David Porter,0,0,36,36
1656149813465,MATH 18,B05,093473,Rideout; David Porter,1,0,36,35
1656149813465,MATH 18,B06,093474,Rideout; David Porter,4,0,36,32
1656149819508,MATH 20A,A01,083754,Zheng; Zequn,11,0,40,29
1656149825543,MATH 20B,A01,083756,Briones; Jor-el Thomas Caparas,0,0,36,36
1656149825543,MATH 20B,A02,083757,Briones; Jor-el Thomas Caparas,0,0,36,36
1656149825543,MATH 20B,A03,093475,Staff,2,0,36,34
1656149831573,MATH 20C,A01,083760,Briones; Jor-el Thomas Caparas,0,0,35,35
1656149831573,MATH 20C,A02,083761,Briones; Jor-el Thomas Caparas,9,1,35,26
1656149831573,MATH 20C,A03,093476,Staff,0,0,35,35
1656149831573,MATH 20C,B01,083762,Bach; Quang Tran,1,0,30,29
1656149837599,MATH 20D,A01,083765,Tran; Brian Kha,2,0,30,28
1656149837599,MATH 20D,A02,083766,Tran; Brian Kha,0,1,30,30
1656149837599,MATH 20D,A03,083767,Tran; Brian Kha,2,0,30,28
1656149843624,MATH 20E,A01,083771,Ganguly; Soumya,4,0,32,28
1656149843624,MATH 20E,A02,083772,Ganguly; Soumya,0,0,32,32
1656149843624,MATH 20E,B01,083773,Ciotti; Benjamin,15,0,35,20
1656149843624,MATH 20E,B02,083774,Ciotti; Benjamin,14,0,35,21
1656149849655,MATH 103A,A01,083777,Greenfeld; Be'Eri,1,0,36,35
1656149849655,MATH 103A,A02,083778,Greenfeld; Be'Eri,1,0,36,35
1656149849655,MATH 103A,A03,093561,Staff,4,0,36,32
1656149849655,MATH 103A,B01,083779,Greenfeld; Be'Eri,8,1,36,28
1656149849655,MATH 103A,B02,083780,Greenfeld; Be'Eri,1,0,36,35
1656149849655,MATH 103A,B03,093562,Staff,0,0,36,36
1656149855680,MATH 105,A01,085443,Carter; Anne Toulson,4,1,35,31
1656149855680,MATH 105,A02,093477,Staff,11,0,35,24
1656149861707,MATH 109,A01,083213,Ganzberger; Geoffrey Michael,0,0,34,34
1656149861707,MATH 109,A02,083214,Ganzberger; Geoffrey Michael,0,0,34,34
1656149861707,MATH 109,A03,093478,Staff,1,0,34,33
1656149861707,MATH 109,B01,083215,Ganzberger; Geoffrey Michael,4,0,32,28
1656149861707,MATH 109,B02,083216,Ganzberger; Geoffrey Michael,1,0,32,31
1656149861707,MATH 109,B03,093479,Staff,4,0,32,28
1656149867734,MATH 142A,A01,083219,Chow; Bennett,1,0,32,31
1656149867734,MATH 142A,A02,083220,Chow; Bennett,8,0,32,24
1656149867734,MATH 142A,A03,093480,Staff,5,0,32,27
1656149867734,MATH 142A,B03,093481,Staff,4,0,32,28
1656149867734,MATH 142A,B04,093558,Staff,6,0,32,26
1656149867734,MATH 142A,B05,093559,Staff,0,0,32,32
1656149873758,MATH 193A,A01,083224,Rotar; Vladimir,0,1,34,34
1656149873758,MATH 193A,A02,083225,Rotar; Vladimir,0,0,34,34
1656149873758,MATH 193A,A03,083781,Rotar; Vladimir,0,0,34,34
1656149873758,MATH 193A,A04,083782,Rotar; Vladimir,6,0,34,28
1656149873758,MATH 193A,A05,093482,Rotar; Vladimir,1,0,34,33
1656149879782,MATH 197,001,091859,McAuley; Julian John,9999,0,9999,0
1656149879782,MATH 197,002,095566,Kedlaya; Kiran S.,9997,0,9999,2
1656149879782,MATH 197,003,095567,Xiao; Ming,9999,0,9999,0
1656149879782,MATH 197,004,095571,Perols; Johan Lars,9998,0,9999,1
1656149886851,COGS 9,A01,083615,Shannon; Kyle Michael,4,0,75,71
1656149892879,COGS 11,A01,083617,Boyle; Mary E. T.,15,0,48,33
1656149898901,COGS 13,A01,083071,Bastos; Amalia Pinkusfeld,6,0,71,65
1656149904924,COGS 14A,A01,092681,Semenuks; Arturs,4,15,100,96
1656149910947,COGS 14B,A01,083073,Cheng; Tzu-Han,7,0,63,56
1656149916975,COGS 17,A01,092677,Semenuks; Arturs,8,0,81,73
1656149922999,COGS 100,A01,083619,Allen; Michael Gordon,3,0,70,67
1656149929024,COGS 101A,A01,083621,Davis; Joshua Daniel,3,0,68,65
1656149935045,COGS 101B,A01,091572,Allen; Michael Gordon,6,0,65,59
1656149941069,COGS 101C,A01,083625,Delgado; Tania,10,0,35,25
1656149947097,COGS 107A,A01,083627,Boyle; Mary E. T.,0,0,60,60
1656149953121,COGS 118A,A01,083075,Gupta; Anjum,7,0,76,69
1656149959146,CSE 3,A50,083646,Miranda; Gregory Joseph,18,0,50,32
1656149965175,CSE 8A,A50,083650,Miranda; Gregory Joseph,3,3,56,53
1656149971199,CSE 11,A01,083080,Cao; Yingjun,1,54,40,39
1656149977225,CSE 12,A01,083652,Krause-Levy; Sophia Louisa,7,2,120,113
1656149983249,CSE 15L,A01,083654,Morris; Justin Loren,2,0,50,48
1656149983249,CSE 15L,A02,083655,Morris; Justin Loren,4,0,50,46
1656149989273,CSE 20,A01,083657,Tran; Khoa Dang,31,0,80,49
1656149995299,CSE 21,A01,095574,Bach; Quang Tran,25,0,48,23
1656150001422,CSE 30,A01,083084,Eldon; John,2,8,80,78
1656150001422,CSE 30,B01,095061,Bhaskar; Nishant,1,2,50,49
1656150007443,CSE 100,A01,083659,Cao; Yingjun,2,20,70,68
1656150013466,CSE 134B,A01,083661,Powell; Thomas Allan,3,0,100,97
1656150019488,CSE 140,A01,083663,Gungor; Onat,9,0,85,76
1656150025514,CSE 140L,A01,083088,Eldon; John,8,0,100,92
1656150031536,CSE 175,A01,083665,Kumar; Rakesh,0,0,25,25
1656150037559,CSE 190,A00,092507,Dubnov; Shlomo,3,0,20,17
1656150043582,ECE 45,A01,083139,Congero; Spencer William,1,0,75,74
1656150049607,ECE 65,A50,083695,Saad; Andrew S,8,0,30,22
1656150049607,ECE 65,A51,095125,Staff,23,0,26,3
1656150055628,ECE 109,A01,091882,Touri; Behrouz,0,1,70,70
1656150061657,ECE 180,A00,083140,Abi Samra; Nicholas Camill,1,0,30,29
1656150061657,ECE 180,B00,083141,Abi Samra; Nicholas Camill,0,4,30,30
1656150067680,MATH 10A,A01,083735,Patchell; Gregory David,0,0,30,30
1656150067680,MATH 10A,A02,083736,Patchell; Gregory David,22,0,30,8
1656150067680,MATH 10A,A03,083737,Patchell; Gregory David,16,0,30,14
1656150073714,MATH 10B,A01,083207,Lim; Seonhee,0,0,34,34
1656150073714,MATH 10B,A02,083208,Lim; Seonhee,7,0,35,28
1656150073714,MATH 10B,A03,093472,Staff,1,0,34,33
1656150073714,MATH 10B,B01,083739,Sinha; Shubham,10,0,30,20
1656150079740,MATH 18,A01,083743,Cinel; Cameron Alexander,7,0,30,23
1656150079740,MATH 18,A02,083744,Cinel; Cameron Alexander,10,0,30,20
1656150079740,MATH 18,A03,083745,Cinel; Cameron Alexander,4,0,30,26
1656150079740,MATH 18,B01,083748,Rideout; David Porter,0,0,36,36
1656150079740,MATH 18,B02,083749,Rideout; David Porter,0,0,36,36
1656150079740,MATH 18,B03,083750,Rideout; David Porter,0,0,36,36
1656150079740,MATH 18,B04,083751,Rideout; David Porter,0,0,36,36
1656150079740,MATH 18,B05,093473,Rideout; David Porter,1,0,36,35
1656150079740,MATH 18,B06,093474,Rideout; David Porter,4,0,36,32
1656150085778,MATH 20A,A01,083754,Zheng; Zequn,11,0,40,29
1656150091803,MATH 20B,A01,083756,Briones; Jor-el Thomas Caparas,0,0,36,36
1656150091803,MATH 20B,A02,083757,Briones; Jor-el Thomas Caparas,0,0,36,36
1656150091803,MATH 20B,A03,093475,Staff,2,0,36,34
1656150097827,MATH 20C,A01,083760,Briones; Jor-el Thomas Caparas,0,0,35,35
1656150097827,MATH 20C,A02,083761,Briones; Jor-el Thomas Caparas,9,1,35,26
1656150097827,MATH 20C,A03,093476,Staff,0,0,35,35
1656150097827,MATH 20C,B01,083762,Bach; Quang Tran,1,0,30,29
1656150103855,MATH 20D,A01,083765,Tran; Brian Kha,2,0,30,28
1656150103855,MATH 20D,A02,083766,Tran; Brian Kha,0,1,30,30
1656150103855,MATH 20D,A03,083767,Tran; Brian Kha,2,0,30,28
1656150109879,MATH 20E,A01,083771,Ganguly; Soumya,4,0,32,28
1656150109879,MATH 20E,A02,083772,Ganguly; Soumya,0,0,32,32
1656150109879,MATH 20E,B01,083773,Ciotti; Benjamin,15,0,35,20
1656150109879,MATH 20E,B02,083774,Ciotti; Benjamin,15,0,35,20
1656150115904,MATH 103A,A01,083777,Greenfeld; Be'Eri,1,0,36,35
1656150115904,MATH 103A,A02,083778,Greenfeld; Be'Eri,1,0,36,35
1656150115904,MATH 103A,A03,093561,Staff,4,0,36,32
1656150115904,MATH 103A,B01,083779,Greenfeld; Be'Eri,8,1,36,28
1656150115904,MATH 103A,B02,083780,Greenfeld; Be'Eri,1,0,36,35
1656150115904,MATH 103A,B03,093562,Staff,0,0,36,36
1656150121931,MATH 105,A01,085443,Carter; Anne Toulson,4,1,35,31
1656150121931,MATH 105,A02,093477,Staff,11,0,35,24
1656150127954,MATH 109,A01,083213,Ganzberger; Geoffrey Michael,0,0,34,34
1656150127954,MATH 109,A02,083214,Ganzberger; Geoffrey Michael,0,0,34,34
1656150127954,MATH 109,A03,093478,Staff,1,0,34,33
1656150127954,MATH 109,B01,083215,Ganzberger; Geoffrey Michael,4,0,32,28
1656150127954,MATH 109,B02,083216,Ganzberger; Geoffrey Michael,1,0,32,31
1656150127954,MATH 109,B03,093479,Staff,4,0,32,28
1656150133978,MATH 142A,A01,083219,Chow; Bennett,1,0,32,31
1656150133978,MATH 142A,A02,083220,Chow; Bennett,8,0,32,24
1656150133978,MATH 142A,A03,093480,Staff,5,0,32,27
1656150133978,MATH 142A,B03,093481,Staff,4,0,32,28
1656150133978,MATH 142A,B04,093558,Staff,6,0,32,26
1656150133978,MATH 142A,B05,093559,Staff,0,0,32,32
1656150140002,MATH 193A,A01,083224,Rotar; Vladimir,0,1,34,34
1656150140002,MATH 193A,A02,083225,Rotar; Vladimir,0,0,34,34
1656150140002,MATH 193A,A03,083781,Rotar; Vladimir,0,0,34,34
1656150140002,MATH 193A,A04,083782,Rotar; Vladimir,6,0,34,28
1656150140002,MATH 193A,A05,093482,Rotar; Vladimir,1,0,34,33
1656150146027,MATH 197,001,091859,McAuley; Julian John,9999,0,9999,0
1656150146027,MATH 197,002,095566,Kedlaya; Kiran S.,9997,0,9999,2
1656150146027,MATH 197,003,095567,Xiao; Ming,9999,0,9999,0
1656150146027,MATH 197,004,095571,Perols; Johan Lars,9998,0,9999,1
1656150153083,COGS 9,A01,083615,Shannon; Kyle Michael,4,0,75,71
1656150159123,COGS 11,A01,083617,Boyle; Mary E. T.,15,0,48,33
1656150165148,COGS 13,A01,083071,Bastos; Amalia Pinkusfeld,6,0,71,65
1656150171175,COGS 14A,A01,092681,Semenuks; Arturs,4,15,100,96
1656150177203,COGS 14B,A01,083073,Cheng; Tzu-Han,7,0,63,56
1656150183226,COGS 17,A01,092677,Semenuks; Arturs,8,0,81,73
1656150189249,COGS 100,A01,083619,Allen; Michael Gordon,3,0,70,67
1656150195274,COGS 101A,A01,083621,Davis; Joshua Daniel,3,0,68,65
1656150201298,COGS 101B,A01,091572,Allen; Michael Gordon,6,0,65,59
1656150207322,COGS 101C,A01,083625,Delgado; Tania,10,0,35,25
1656150213350,COGS 107A,A01,083627,Boyle; Mary E. T.,0,0,60,60
1656150219374,COGS 118A,A01,083075,Gupta; Anjum,7,0,76,69
1656150225399,CSE 3,A50,083646,Miranda; Gregory Joseph,18,0,50,32
1656150231422,CSE 8A,A50,083650,Miranda; Gregory Joseph,3,3,56,53
1656150237446,CSE 11,A01,083080,Cao; Yingjun,1,54,40,39
1656150243475,CSE 12,A01,083652,Krause-Levy; Sophia Louisa,7,2,120,113
1656150249500,CSE 15L,A01,083654,Morris; Justin Loren,2,0,50,48
1656150249500,CSE 15L,A02,083655,Morris; Justin Loren,4,0,50,46
1656150255524,CSE 20,A01,083657,Tran; Khoa Dang,31,0,80,49
1656150261552,CSE 21,A01,095574,Bach; Quang Tran,25,0,48,23
1656150267576,CSE 30,A01,083084,Eldon; John,2,8,80,78
1656150267576,CSE 30,B01,095061,Bhaskar; Nishant,1,2,50,49
1656150273599,CSE 100,A01,083659,Cao; Yingjun,2,20,70,68
1656150279627,CSE 134B,A01,083661,Powell; Thomas Allan,3,0,100,97
1656150285650,CSE 140,A01,083663,Gungor; Onat,9,0,85,76
1656150291673,CSE 140L,A01,083088,Eldon; John,8,0,100,92
1656150297710,CSE 175,A01,083665,Kumar; Rakesh,0,0,25,25
1656150303732,CSE 190,A00,092507,Dubnov; Shlomo,3,0,20,17
1656150309757,ECE 45,A01,083139,Congero; Spencer William,1,0,75,74
1656150315781,ECE 65,A50,083695,Saad; Andrew S,8,0,30,22
1656150315781,ECE 65,A51,095125,Staff,23,0,26,3
1656150321805,ECE 109,A01,091882,Touri; Behrouz,0,1,70,70
1656150327828,ECE 180,A00,083140,Abi Samra; Nicholas Camill,1,0,30,29
1656150327828,ECE 180,B00,083141,Abi Samra; Nicholas Camill,0,4,30,30
1656150333853,MATH 10A,A01,083735,Patchell; Gregory David,0,0,30,30
1656150333853,MATH 10A,A02,083736,Patchell; Gregory David,22,0,30,8
1656150333853,MATH 10A,A03,083737,Patchell; Gregory David,16,0,30,14
1656150339878,MATH 10B,A01,083207,Lim; Seonhee,0,0,34,34
1656150339878,MATH 10B,A02,083208,Lim; Seonhee,7,0,35,28
1656150339878,MATH 10B,A03,093472,Staff,1,0,34,33
1656150339878,MATH 10B,B01,083739,Sinha; Shubham,10,0,30,20
1656150345911,MATH 18,A01,083743,Cinel; Cameron Alexander,7,0,30,23
1656150345911,MATH 18,A02,083744,Cinel; Cameron Alexander,10,0,30,20
1656150345911,MATH 18,A03,083745,Cinel; Cameron Alexander,4,0,30,26
1656150345911,MATH 18,B01,083748,Rideout; David Porter,0,0,36,36
1656150345911,MATH 18,B02,083749,Rideout; David Porter,0,0,36,36
1656150345911,MATH 18,B03,083750,Rideout; David Porter,0,0,36,36
1656150345911,MATH 18,B04,083751,Rideout; David Porter,0,0,36,36
1656150345911,MATH 18,B05,093473,Rideout; David Porter,1,0,36,35
1656150345911,MATH 18,B06,093474,Rideout; David Porter,4,0,36,32
1656150351944,MATH 20A,A01,083754,Zheng; Zequn,11,0,40,29
1656150357973,MATH 20B,A01,083756,Briones; Jor-el Thomas Caparas,0,0,36,36
1656150357973,MATH 20B,A02,083757,Briones; Jor-el Thomas Caparas,0,0,36,36
1656150357973,MATH 20B,A03,093475,Staff,2,0,36,34
1656150363996,MATH 20C,A01,083760,Briones; Jor-el Thomas Caparas,0,0,35,35
1656150363996,MATH 20C,A02,083761,Briones; Jor-el Thomas Caparas,9,1,35,26
1656150363996,MATH 20C,A03,093476,Staff,0,0,35,35
1656150363996,MATH 20C,B01,083762,Bach; Quang Tran,1,0,30,29
1656150370021,MATH 20D,A01,083765,Tran; Brian Kha,2,0,30,28
1656150370021,MATH 20D,A02,083766,Tran; Brian Kha,0,1,30,30
1656150370021,MATH 20D,A03,083767,Tran; Brian Kha,2,0,30,28
1656150376048,MATH 20E,A01,083771,Ganguly; Soumya,4,0,32,28
1656150376048,MATH 20E,A02,083772,Ganguly; Soumya,0,0,32,32
1656150376048,MATH 20E,B01,083773,Ciotti; Benjamin,15,0,35,20
1656150376048,MATH 20E,B02,083774,Ciotti; Benjamin,15,0,35,20
1656150382078,MATH 103A,A01,083777,Greenfeld; Be'Eri,1,0,36,35
1656150382078,MATH 103A,A02,083778,Greenfeld; Be'Eri,1,0,36,35
1656150382078,MATH 103A,A03,093561,Staff,4,0,36,32
1656150382078,MATH 103A,B01,083779,Greenfeld; Be'Eri,8,1,36,28
1656150382078,MATH 103A,B02,083780,Greenfeld; Be'Eri,1,0,36,35
1656150382078,MATH 103A,B03,093562,Staff,0,0,36,36
1656150388107,MATH 105,A01,085443,Carter; Anne Toulson,4,1,35,31
1656150388107,MATH 105,A02,093477,Staff,11,0,35,24
1656150394136,MATH 109,A01,083213,Ganzberger; Geoffrey Michael,0,0,34,34
1656150394136,MATH 109,A02,083214,Ganzberger; Geoffrey Michael,0,0,34,34
1656150394136,MATH 109,A03,093478,Staff,1,0,34,33
1656150394136,MATH 109,B01,083215,Ganzberger; Geoffrey Michael,4,0,32,28
1656150394136,MATH 109,B02,083216,Ganzberger; Geoffrey Michael,1,0,32,31
1656150394136,MATH 109,B03,093479,Staff,4,0,32,28
1656150400166,MATH 142A,A01,083219,Chow; Bennett,1,0,32,31
1656150400166,MATH 142A,A02,083220,Chow; Bennett,8,0,32,24
1656150400166,MATH 142A,A03,093480,Staff,5,0,32,27
1656150400166,MATH 142A,B03,093481,Staff,4,0,32,28
1656150400166,MATH 142A,B04,093558,Staff,6,0,32,26
1656150400166,MATH 142A,B05,093559,Staff,0,0,32,32
1656150406195,MATH 193A,A01,083224,Rotar; Vladimir,0,1,34,34
1656150406195,MATH 193A,A02,083225,Rotar; Vladimir,0,0,34,34
1656150406195,MATH 193A,A03,083781,Rotar; Vladimir,0,0,34,34
1656150406195,MATH 193A,A04,083782,Rotar; Vladimir,6,0,34,28
1656150406195,MATH 193A,A05,093482,Rotar; Vladimir,1,0,34,33
1656150412219,MATH 197,001,091859,McAuley; Julian John,9999,0,9999,0
1656150412219,MATH 197,002,095566,Kedlaya; Kiran S.,9997,0,9999,2
1656150412219,MATH 197,003,095567,Xiao; Ming,9999,0,9999,0
1656150412219,MATH 197,004,095571,Perols; Johan Lars,9998,0,9999,1
1656150419287,COGS 9,A01,083615,Shannon; Kyle Michael,4,0,75,71
1656150425311,COGS 11,A01,083617,Boyle; Mary E. T.,15,0,48,33
1656150431335,COGS 13,A01,083071,Bastos; Amalia Pinkusfeld,6,0,71,65
1656150437359,COGS 14A,A01,092681,Semenuks; Arturs,4,15,100,96
1656150443383,COGS 14B,A01,083073,Cheng; Tzu-Han,7,0,63,56
1656150449407,COGS 17,A01,092677,Semenuks; Arturs,8,0,81,73
1656150455432,COGS 100,A01,083619,Allen; Michael Gordon,3,0,70,67
1656150461455,COGS 101A,A01,083621,Davis; Joshua Daniel,3,0,68,65
1656150467478,COGS 101B,A01,091572,Allen; Michael Gordon,6,0,65,59
1656150473501,COGS 101C,A01,083625,Delgado; Tania,10,0,35,25
1656150479527,COGS 107A,A01,083627,Boyle; Mary E. T.,0,0,60,60
1656150485552,COGS 118A,A01,083075,Gupta; Anjum,7,0,76,69
1656150491580,CSE 3,A50,083646,Miranda; Gregory Joseph,18,0,50,32
1656150497608,CSE 8A,A50,083650,Miranda; Gregory Joseph,3,3,56,53
1656150503631,CSE 11,A01,083080,Cao; Yingjun,1,54,40,39
1656150509657,CSE 12,A01,083652,Krause-Levy; Sophia Louisa,7,2,120,113
1656150515681,CSE 15L,A01,083654,Morris; Justin Loren,2,0,50,48
1656150515681,CSE 15L,A02,083655,Morris; Justin Loren,4,0,50,46
1656150521708,CSE 20,A01,083657,Tran; Khoa Dang,31,0,80,49
1656150527732,CSE 21,A01,095574,Bach; Quang Tran,25,0,48,23
1656150533761,CSE 30,A01,083084,Eldon; John,2,8,80,78
1656150533761,CSE 30,B01,095061,Bhaskar; Nishant,1,2,50,49
1656150539784,CSE 100,A01,083659,Cao; Yingjun,2,20,70,68
1656150545811,CSE 134B,A01,083661,Powell; Thomas Allan,3,0,100,97
1656150551835,CSE 140,A01,083663,Gungor; Onat,9,0,85,76
1656150557880,CSE 140L,A01,083088,Eldon; John,8,0,100,92
1656150563904,CSE 175,A01,083665,Kumar; Rakesh,0,0,25,25
1656150569930,CSE 190,A00,092507,Dubnov; Shlomo,3,0,20,17
1656150575954,ECE 45,A01,083139,Congero; Spencer William,1,0,75,74
1656150581978,ECE 65,A50,083695,Saad; Andrew S,8,0,30,22
1656150581978,ECE 65,A51,095125,Staff,23,0,26,3
1656150588002,ECE 109,A01,091882,Touri; Behrouz,0,1,70,70
1656150594026,ECE 180,A00,083140,Abi Samra; Nicholas Camill,1,0,30,29
1656150594026,ECE 180,B00,083141,Abi Samra; Nicholas Camill,0,4,30,30
1656150600145,MATH 10A,A01,083735,Patchell; Gregory David,0,0,30,30
1656150600145,MATH 10A,A02,083736,Patchell; Gregory David,22,0,30,8
1656150600145,MATH 10A,A03,083737,Patchell; Gregory David,16,0,30,14
1656150606173,MATH 10B,A01,083207,Lim; Seonhee,0,0,34,34
1656150606173,MATH 10B,A02,083208,Lim; Seonhee,7,0,35,28
1656150606173,MATH 10B,A03,093472,Staff,1,0,34,33
1656150606173,MATH 10B,B01,083739,Sinha; Shubham,10,0,30,20
1656150612205,MATH 18,A01,083743,Cinel; Cameron Alexander,7,0,30,23
1656150612205,MATH 18,A02,083744,Cinel; Cameron Alexander,10,0,30,20
1656150612205,MATH 18,A03,083745,Cinel; Cameron Alexander,4,0,30,26
1656150612205,MATH 18,B01,083748,Rideout; David Porter,0,0,36,36
1656150612205,MATH 18,B02,083749,Rideout; David Porter,0,0,36,36
1656150612205,MATH 18,B03,083750,Rideout; David Porter,0,0,36,36
1656150612205,MATH 18,B04,083751,Rideout; David Porter,0,0,36,36
1656150612205,MATH 18,B05,093473,Rideout; David Porter,1,0,36,35
1656150612205,MATH 18,B06,093474,Rideout; David Porter,4,0,36,32
1656150618230,MATH 20A,A01,083754,Zheng; Zequn,11,0,40,29
1656150624251,MATH 20B,A01,083756,Briones; Jor-el Thomas Caparas,0,0,36,36
1656150624251,MATH 20B,A02,083757,Briones; Jor-el Thomas Caparas,0,0,36,36
1656150624251,MATH 20B,A03,093475,Staff,2,0,36,34
1656150630276,MATH 20C,A01,083760,Briones; Jor-el Thomas Caparas,0,0,35,35
1656150630276,MATH 20C,A02,083761,Briones; Jor-el Thomas Caparas,9,1,35,26
1656150630276,MATH 20C,A03,093476,Staff,0,0,35,35
1656150630276,MATH 20C,B01,083762,Bach; Quang Tran,1,0,30,29
1656150636300,MATH 20D,A01,083765,Tran; Brian Kha,2,0,30,28
1656150636300,MATH 20D,A02,083766,Tran; Brian Kha,0,1,30,30
1656150636300,MATH 20D,A03,083767,Tran; Brian Kha,2,0,30,28
1656150642329,MATH 20E,A01,083771,Ganguly; Soumya,4,0,32,28
1656150642329,MATH 20E,A02,083772,Ganguly; Soumya,0,0,32,32
1656150642329,MATH 20E,B01,083773,Ciotti; Benjamin,15,0,35,20
1656150642329,MATH 20E,B02,083774,Ciotti; Benjamin,15,0,35,20
1656150648359,MATH 103A,A01,083777,Greenfeld; Be'Eri,1,0,36,35
1656150648359,MATH 103A,A02,083778,Greenfeld; Be'Eri,1,0,36,35
1656150648359,MATH 103A,A03,093561,Staff,4,0,36,32
1656150648359,MATH 103A,B01,083779,Greenfeld; Be'Eri,8,1,36,28
1656150648359,MATH 103A,B02,083780,Greenfeld; Be'Eri,1,0,36,35
1656150648359,MATH 103A,B03,093562,Staff,0,0,36,36
1656150654382,MATH 105,A01,085443,Carter; Anne Toulson,4,1,35,31
1656150654382,MATH 105,A02,093477,Staff,11,0,35,24
1656150660408,MATH 109,A01,083213,Ganzberger; Geoffrey Michael,0,0,34,34
1656150660408,MATH 109,A02,083214,Ganzberger; Geoffrey Michael,0,0,34,34
1656150660408,MATH 109,A03,093478,Staff,1,0,34,33
1656150660408,MATH 109,B01,083215,Ganzberger; Geoffrey Michael,4,0,32,28
1656150660408,MATH 109,B02,083216,Ganzberger; Geoffrey Michael,1,0,32,31
1656150660408,MATH 109,B03,093479,Staff,4,0,32,28
1656150666436,MATH 142A,A01,083219,Chow; Bennett,1,0,32,31
1656150666436,MATH 142A,A02,083220,Chow; Bennett,8,0,32,24
1656150666436,MATH 142A,A03,093480,Staff,5,0,32,27
1656150666436,MATH 142A,B03,093481,Staff,4,0,32,28
1656150666436,MATH 142A,B04,093558,Staff,6,0,32,26
1656150666436,MATH 142A,B05,093559,Staff,0,0,32,32
1656150672464,MATH 193A,A01,083224,Rotar; Vladimir,0,1,34,34
1656150672464,MATH 193A,A02,083225,Rotar; Vladimir,0,0,34,34
1656150672464,MATH 193A,A03,083781,Rotar; Vladimir,0,0,34,34
1656150672464,MATH 193A,A04,083782,Rotar; Vladimir,6,0,34,28
1656150672464,MATH 193A,A05,093482,Rotar; Vladimir,1,0,34,33
1656150678491,MATH 197,001,091859,McAuley; Julian John,9999,0,9999,0
1656150678491,MATH 197,002,095566,Kedlaya; Kiran S.,9997,0,9999,2
1656150678491,MATH 197,003,095567,Xiao; Ming,9999,0,9999,0
1656150678491,MATH 197,004,095571,Perols; Johan Lars,9998,0,9999,1
1656150685554,COGS 9,A01,083615,Shannon; Kyle Michael,4,0,75,71
1656150691577,COGS 11,A01,083617,Boyle; Mary E. T.,15,0,48,33
1656150697599,COGS 13,A01,083071,Bastos; Amalia Pinkusfeld,6,0,71,65
1656150703624,COGS 14A,A01,092681,Semenuks; Arturs,4,15,100,96
1656150709647,COGS 14B,A01,083073,Cheng; Tzu-Han,7,0,63,56
1656150715669,COGS 17,A01,092677,Semenuks; Arturs,8,0,81,73
1656150721697,COGS 100,A01,083619,Allen; Michael Gordon,3,0,70,67
1656150727721,COGS 101A,A01,083621,Davis; Joshua Daniel,3,0,68,65
1656150733745,COGS 101B,A01,091572,Allen; Michael Gordon,6,0,65,59
1656150739771,COGS 101C,A01,083625,Delgado; Tania,10,0,35,25
1656150745799,COGS 107A,A01,083627,Boyle; Mary E. T.,0,0,60,60
1656150751822,COGS 118A,A01,083075,Gupta; Anjum,7,0,76,69
1656150757846,CSE 3,A50,083646,Miranda; Gregory Joseph,18,0,50,32
1656150763869,CSE 8A,A50,083650,Miranda; Gregory Joseph,3,3,56,53
1656150769898,CSE 11,A01,083080,Cao; Yingjun,1,54,40,39
1656150775927,CSE 12,A01,083652,Krause-Levy; Sophia Louisa,7,2,120,113
1656150781952,CSE 15L,A01,083654,Morris; Justin Loren,2,0,50,48
1656150781952,CSE 15L,A02,083655,Morris; Justin Loren,4,0,50,46
1656150787979,CSE 20,A01,083657,Tran; Khoa Dang,31,0,80,49
1656150794007,CSE 21,A01,095574,Bach; Quang Tran,25,0,48,23
1656150800037,CSE 30,A01,083084,Eldon; John,2,8,80,78
1656150800037,CSE 30,B01,095061,Bhaskar; Nishant,1,2,50,49
1656150806061,CSE 100,A01,083659,Cao; Yingjun,2,20,70,68
1656150812085,CSE 134B,A01,083661,Powell; Thomas Allan,3,0,100,97
1656150818109,CSE 140,A01,083663,Gungor; Onat,9,0,85,76
1656150824137,CSE 140L,A01,083088,Eldon; John,8,0,100,92
1656150830161,CSE 175,A01,083665,Kumar; Rakesh,0,0,25,25
1656150836188,CSE 190,A00,092507,Dubnov; Shlomo,3,0,20,17
1656150842217,ECE 45,A01,083139,Congero; Spencer William,1,0,75,74
1656150848245,ECE 65,A50,083695,Saad; Andrew S,8,0,30,22
1656150848245,ECE 65,A51,095125,Staff,23,0,26,3
1656150854268,ECE 109,A01,091882,Touri; Behrouz,0,1,70,70
1656150860291,ECE 180,A00,083140,Abi Samra; Nicholas Camill,1,0,30,29
1656150860291,ECE 180,B00,083141,Abi Samra; Nicholas Camill,0,4,30,30
1656150866315,MATH 10A,A01,083735,Patchell; Gregory David,0,0,30,30
1656150866315,MATH 10A,A02,083736,Patchell; Gregory David,22,0,30,8
1656150866315,MATH 10A,A03,083737,Patchell; Gregory David,16,0,30,14
1656150872339,MATH 10B,A01,083207,Lim; Seonhee,0,0,34,34
1656150872339,MATH 10B,A02,083208,Lim; Seonhee,7,0,35,28
1656150872339,MATH 10B,A03,093472,Staff,1,0,34,33
1656150872339,MATH 10B,B01,083739,Sinha; Shubham,10,0,30,20
1656150878364,MATH 18,A01,083743,Cinel; Cameron Alexander,7,0,30,23
1656150878364,MATH 18,A02,083744,Cinel; Cameron Alexander,10,0,30,20
1656150878364,MATH 18,A03,083745,Cinel; Cameron Alexander,4,0,30,26
1656150878364,MATH 18,B01,083748,Rideout; David Porter,0,0,36,36
1656150878364,MATH 18,B02,083749,Rideout; David Porter,0,0,36,36
1656150878364,MATH 18,B03,083750,Rideout; David Porter,0,0,36,36
1656150878364,MATH 18,B04,083751,Rideout; David Porter,0,0,36,36
1656150878364,MATH 18,B05,093473,Rideout; David Porter,1,0,36,35
1656150878364,MATH 18,B06,093474,Rideout; David Porter,4,0,36,32
1656150884391,MATH 20A,A01,083754,Zheng; Zequn,11,0,40,29
1656150890419,MATH 20B,A01,083756,Briones; Jor-el Thomas Caparas,0,0,36,36
1656150890419,MATH 20B,A02,083757,Briones; Jor-el Thomas Caparas,0,0,36,36
1656150890419,MATH 20B,A03,093475,Staff,2,0,36,34
1656150896445,MATH 20C,A01,083760,Briones; Jor-el Thomas Caparas,0,0,35,35
1656150896445,MATH 20C,A02,083761,Briones; Jor-el Thomas Caparas,9,1,35,26
1656150896445,MATH 20C,A03,093476,Staff,0,0,35,35
1656150896445,MATH 20C,B01,083762,Bach; Quang Tran,1,0,30,29
1656150902469,MATH 20D,A01,083765,Tran; Brian Kha,2,0,30,28
1656150902469,MATH 20D,A02,083766,Tran; Brian Kha,0,1,30,30
1656150902469,MATH 20D,A03,083767,Tran; Brian Kha,2,0,30,28
1656150908498,MATH 20E,A01,083771,Ganguly; Soumya,4,0,32,28
1656150908498,MATH 20E,A02,083772,Ganguly; Soumya,0,0,32,32
1656150908498,MATH 20E,B01,083773,Ciotti; Benjamin,15,0,35,20
1656150908498,MATH 20E,B02,083774,Ciotti; Benjamin,15,0,35,20
1656150914521,MATH 103A,A01,083777,Greenfeld; Be'Eri,1,0,36,35
1656150914521,MATH 103A,A02,083778,Greenfeld; Be'Eri,1,0,36,35
1656150914521,MATH 103A,A03,093561,Staff,4,0,36,32
1656150914521,MATH 103A,B01,083779,Greenfeld; Be'Eri,8,1,36,28
1656150914521,MATH 103A,B02,083780,Greenfeld; Be'Eri,1,0,36,35
1656150914521,MATH 103A,B03,093562,Staff,0,0,36,36
1656150920546,MATH 105,A01,085443,Carter; Anne Toulson,4,1,35,31
1656150920546,MATH 105,A02,093477,Staff,11,0,35,24
1656150926575,MATH 109,A01,083213,Ganzberger; Geoffrey Michael,0,0,34,34
1656150926575,MATH 109,A02,083214,Ganzberger; Geoffrey Michael,0,0,34,34
1656150926575,MATH 109,A03,093478,Staff,1,0,34,33
1656150926575,MATH 109,B01,083215,Ganzberger; Geoffrey Michael,4,0,32,28
1656150926575,MATH 109,B02,083216,Ganzberger; Geoffrey Michael,1,0,32,31
1656150926575,MATH 109,B03,093479,Staff,4,0,32,28
1656150932601,MATH 142A,A01,083219,Chow; Bennett,1,0,32,31
1656150932601,MATH 142A,A02,083220,Chow; Bennett,8,0,32,24
1656150932601,MATH 142A,A03,093480,Staff,5,0,32,27
1656150932601,MATH 142A,B03,093481,Staff,4,0,32,28
1656150932601,MATH 142A,B04,093558,Staff,6,0,32,26
1656150932601,MATH 142A,B05,093559,Staff,0,0,32,32
1656150938625,MATH 193A,A01,083224,Rotar; Vladimir,0,1,34,34
1656150938625,MATH 193A,A02,083225,Rotar; Vladimir,0,0,34,34
1656150938625,MATH 193A,A03,083781,Rotar; Vladimir,0,0,34,34
1656150938625,MATH 193A,A04,083782,Rotar; Vladimir,6,0,34,28
1656150938625,MATH 193A,A05,093482,Rotar; Vladimir,1,0,34,33
1656150944651,MATH 197,001,091859,McAuley; Julian John,9999,0,9999,0
1656150944651,MATH 197,002,095566,Kedlaya; Kiran S.,9997,0,9999,2
1656150944651,MATH 197,003,095567,Xiao; Ming,9999,0,9999,0
1656150944651,MATH 197,004,095571,Perols; Johan Lars,9998,0,9999,1
1656150951702,COGS 9,A01,083615,Shannon; Kyle Michael,4,0,75,71
1656150957726,COGS 11,A01,083617,Boyle; Mary E. T.,15,0,48,33
1656150963752,COGS 13,A01,083071,Bastos; Amalia Pinkusfeld,6,0,71,65
1656150969781,COGS 14A,A01,092681,Semenuks; Arturs,4,15,100,96
1656150975804,COGS 14B,A01,083073,Cheng; Tzu-Han,7,0,63,56
1656150981832,COGS 17,A01,092677,Semenuks; Arturs,8,0,81,73
1656150987860,COGS 100,A01,083619,Allen; Michael Gordon,2,0,70,68
1656150993883,COGS 101A,A01,083621,Davis; Joshua Daniel,3,0,68,65
1656150999912,COGS 101B,A01,091572,Allen; Michael Gordon,6,0,65,59
1656151005935,COGS 101C,A01,083625,Delgado; Tania,10,0,35,25
1656151011959,COGS 107A,A01,083627,Boyle; Mary E. T.,0,0,60,60
1656151017988,COGS 118A,A01,083075,Gupta; Anjum,7,0,76,69
1656151024012,CSE 3,A50,083646,Miranda; Gregory Joseph,18,0,50,32
1656151030036,CSE 8A,A50,083650,Miranda; Gregory Joseph,3,3,56,53
1656151036064,CSE 11,A01,083080,Cao; Yingjun,1,54,40,39
1656151042088,CSE 12,A01,083652,Krause-Levy; Sophia Louisa,7,2,120,113
1656151048127,CSE 15L,A01,083654,Morris; Justin Loren,2,0,50,48
1656151048127,CSE 15L,A02,083655,Morris; Justin Loren,4,0,50,46
1656151054152,CSE 20,A01,083657,Tran; Khoa Dang,31,0,80,49
1656151060177,CSE 21,A01,095574,Bach; Quang Tran,25,0,48,23
1656151066202,CSE 30,A01,083084,Eldon; John,2,8,80,78
1656151066202,CSE 30,B01,095061,Bhaskar; Nishant,1,2,50,49
1656151072226,CSE 100,A01,083659,Cao; Yingjun,2,20,70,68
1656151078254,CSE 134B,A01,083661,Powell; Thomas Allan,3,0,100,97
1656151084282,CSE 140,A01,083663,Gungor; Onat,9,0,85,76
1656151090310,CSE 140L,A01,083088,Eldon; John,8,0,100,92
1656151096339,CSE 175,A01,083665,Kumar; Rakesh,0,0,25,25
1656151102363,CSE 190,A00,092507,Dubnov; Shlomo,3,0,20,17
1656151108390,ECE 45,A01,083139,Congero; Spencer William,1,0,75,74
1656151114413,ECE 65,A50,083695,Saad; Andrew S,8,0,30,22
1656151114413,ECE 65,A51,095125,Staff,23,0,26,3
1656151120439,ECE 109,A01,091882,Touri; Behrouz,0,1,70,70
1656151126465,ECE 180,A00,083140,Abi Samra; Nicholas Camill,1,0,30,29
1656151126465,ECE 180,B00,083141,Abi Samra; Nicholas Camill,0,4,30,30
1656151132493,MATH 10A,A01,083735,Patchell; Gregory David,0,0,30,30
1656151132493,MATH 10A,A02,083736,Patchell; Gregory David,22,0,30,8
1656151132493,MATH 10A,A03,083737,Patchell; Gregory David,16,0,30,14
1656151138521,MATH 10B,A01,083207,Lim; Seonhee,0,0,34,34
1656151138521,MATH 10B,A02,083208,Lim; Seonhee,7,0,35,28
1656151138521,MATH 10B,A03,093472,Staff,1,0,34,33
1656151138521,MATH 10B,B01,083739,Sinha; Shubham,10,0,30,20
1656151144551,MATH 18,A01,083743,Cinel; Cameron Alexander,7,0,30,23
1656151144551,MATH 18,A02,083744,Cinel; Cameron Alexander,10,0,30,20
1656151144551,MATH 18,A03,083745,Cinel; Cameron Alexander,4,0,30,26
1656151144551,MATH 18,B01,083748,Rideout; David Porter,0,0,36,36
1656151144551,MATH 18,B02,083749,Rideout; David Porter,0,0,36,36
1656151144551,MATH 18,B03,083750,Rideout; David Porter,0,0,36,36
1656151144551,MATH 18,B04,083751,Rideout; David Porter,0,0,36,36
1656151144551,MATH 18,B05,093473,Rideout; David Porter,1,0,36,35
1656151144551,MATH 18,B06,093474,Rideout; David Porter,4,0,36,32
1656151150576,MATH 20A,A01,083754,Zheng; Zequn,11,0,40,29
1656151156600,MATH 20B,A01,083756,Briones; Jor-el Thomas Caparas,0,0,36,36
1656151156600,MATH 20B,A02,083757,Briones; Jor-el Thomas Caparas,0,0,36,36
1656151156600,MATH 20B,A03,093475,Staff,2,0,36,34
1656151162624,MATH 20C,A01,083760,Briones; Jor-el Thomas Caparas,0,0,35,35
1656151162624,MATH 20C,A02,083761,Briones; Jor-el Thomas Caparas,9,1,35,26
1656151162624,MATH 20C,A03,093476,Staff,0,0,35,35
1656151162624,MATH 20C,B01,083762,Bach; Quang Tran,1,0,30,29
1656151168648,MATH 20D,A01,083765,Tran; Brian Kha,2,0,30,28
1656151168648,MATH 20D,A02,083766,Tran; Brian Kha,0,1,30,30
1656151168648,MATH 20D,A03,083767,Tran; Brian Kha,2,0,30,28
1656151174673,MATH 20E,A01,083771,Ganguly; Soumya,4,0,32,28
1656151174673,MATH 20E,A02,083772,Ganguly; Soumya,0,0,32,32
1656151174673,MATH 20E,B01,083773,Ciotti; Benjamin,15,0,35,20
1656151174673,MATH 20E,B02,083774,Ciotti; Benjamin,15,0,35,20
1656151180704,MATH 103A,A01,083777,Greenfeld; Be'Eri,1,0,36,35
1656151180704,MATH 103A,A02,083778,Greenfeld; Be'Eri,1,0,36,35
1656151180704,MATH 103A,A03,093561,Staff,4,0,36,32
1656151180704,MATH 103A,B01,083779,Greenfeld; Be'Eri,8,1,36,28
1656151180704,MATH 103A,B02,083780,Greenfeld; Be'Eri,1,0,36,35
1656151180704,MATH 103A,B03,093562,Staff,0,0,36,36
1656151186731,MATH 105,A01,085443,Carter; Anne Toulson,4,1,35,31
1656151186731,MATH 105,A02,093477,Staff,11,0,35,24
1656151192757,MATH 109,A01,083213,Ganzberger; Geoffrey Michael,0,0,34,34
1656151192757,MATH 109,A02,083214,Ganzberger; Geoffrey Michael,0,0,34,34
1656151192757,MATH 109,A03,093478,Staff,1,0,34,33
1656151192757,MATH 109,B01,083215,Ganzberger; Geoffrey Michael,4,0,32,28
1656151192757,MATH 109,B02,083216,Ganzberger; Geoffrey Michael,1,0,32,31
1656151192757,MATH 109,B03,093479,Staff,4,0,32,28
1656151198883,MATH 142A,A01,083219,Chow; Bennett,1,0,32,31
1656151198883,MATH 142A,A02,083220,Chow; Bennett,8,0,32,24
1656151198883,MATH 142A,A03,093480,Staff,5,0,32,27
1656151198883,MATH 142A,B03,093481,Staff,4,0,32,28
1656151198883,MATH 142A,B04,093558,Staff,6,0,32,26
1656151198883,MATH 142A,B05,093559,Staff,0,0,32,32
1656151204917,MATH 193A,A01,083224,Rotar; Vladimir,0,1,34,34
1656151204917,MATH 193A,A02,083225,Rotar; Vladimir,0,0,34,34
1656151204917,MATH 193A,A03,083781,Rotar; Vladimir,0,0,34,34
1656151204917,MATH 193A,A04,083782,Rotar; Vladimir,6,0,34,28
1656151204917,MATH 193A,A05,093482,Rotar; Vladimir,1,0,34,33
1656151210945,MATH 197,001,091859,McAuley; Julian John,9999,0,9999,0
1656151210945,MATH 197,002,095566,Kedlaya; Kiran S.,9997,0,9999,2
1656151210945,MATH 197,003,095567,Xiao; Ming,9999,0,9999,0
1656151210945,MATH 197,004,095571,Perols; Johan Lars,9998,0,9999,1
1656151217998,COGS 9,A01,083615,Shannon; Kyle Michael,4,0,75,71
1656151224022,COGS 11,A01,083617,Boyle; Mary E. T.,15,0,48,33
1656151230050,COGS 13,A01,083071,Bastos; Amalia Pinkusfeld,6,0,71,65
1656151236076,COGS 14A,A01,092681,Semenuks; Arturs,4,15,100,96
1656151242104,COGS 14B,A01,083073,Cheng; Tzu-Han,7,0,63,56
1656151248132,COGS 17,A01,092677,Semenuks; Arturs,8,0,81,73
1656151254159,COGS 100,A01,083619,Allen; Michael Gordon,2,0,70,68
1656151260182,COGS 101A,A01,083621,Davis; Joshua Daniel,3,0,68,65
1656151266207,COGS 101B,A01,091572,Allen; Michael Gordon,6,0,65,59
1656151272235,COGS 101C,A01,083625,Delgado; Tania,10,0,35,25
1656151278259,COGS 107A,A01,083627,Boyle; Mary E. T.,0,0,60,60
1656151284282,COGS 118A,A01,083075,Gupta; Anjum,7,0,76,69
1656151290311,CSE 3,A50,083646,Miranda; Gregory Joseph,18,0,50,32
1656151296339,CSE 8A,A50,083650,Miranda; Gregory Joseph,3,3,56,53
1656151302366,CSE 11,A01,083080,Cao; Yingjun,1,54,40,39
1656151308391,CSE 12,A01,083652,Krause-Levy; Sophia Louisa,7,2,120,113
1656151314415,CSE 15L,A01,083654,Morris; Justin Loren,2,0,50,48
1656151314415,CSE 15L,A02,083655,Morris; Justin Loren,4,0,50,46
1656151320438,CSE 20,A01,083657,Tran; Khoa Dang,31,0,80,49
1656151326462,CSE 21,A01,095574,Bach; Quang Tran,25,0,48,23
1656151332492,CSE 30,A01,083084,Eldon; John,2,8,80,78
1656151332492,CSE 30,B01,095061,Bhaskar; Nishant,1,2,50,49
1656151338520,CSE 100,A01,083659,Cao; Yingjun,2,20,70,68
1656151344545,CSE 134B,A01,083661,Powell; Thomas Allan,3,0,100,97
1656151350570,CSE 140,A01,083663,Gungor; Onat,9,0,85,76
1656151356594,CSE 140L,A01,083088,Eldon; John,8,0,100,92
1656151362617,CSE 175,A01,083665,Kumar; Rakesh,0,0,25,25
1656151368644,CSE 190,A00,092507,Dubnov; Shlomo,3,0,20,17
1656151374667,ECE 45,A01,083139,Congero; Spencer William,1,0,75,74
1656151380690,ECE 65,A50,083695,Saad; Andrew S,8,0,30,22
1656151380690,ECE 65,A51,095125,Staff,23,0,26,3
1656151386714,ECE 109,A01,091882,Touri; Behrouz,0,1,70,70
1656151392742,ECE 180,A00,083140,Abi Samra; Nicholas Camill,1,0,30,29
1656151392742,ECE 180,B00,083141,Abi Samra; Nicholas Camill,0,4,30,30
1656151398765,MATH 10A,A01,083735,Patchell; Gregory David,0,0,30,30
1656151398765,MATH 10A,A02,083736,Patchell; Gregory David,22,0,30,8
1656151398765,MATH 10A,A03,083737,Patchell; Gregory David,16,0,30,14
1656151404790,MATH 10B,A01,083207,Lim; Seonhee,0,0,34,34
1656151404790,MATH 10B,A02,083208,Lim; Seonhee,7,0,35,28
1656151404790,MATH 10B,A03,093472,Staff,1,0,34,33
1656151404790,MATH 10B,B01,083739,Sinha; Shubham,10,0,30,20
1656151410815,MATH 18,A01,083743,Cinel; Cameron Alexander,7,0,30,23
1656151410815,MATH 18,A02,083744,Cinel; Cameron Alexander,10,0,30,20
1656151410815,MATH 18,A03,083745,Cinel; Cameron Alexander,4,0,30,26
1656151410815,MATH 18,B01,083748,Rideout; David Porter,0,0,36,36
1656151410815,MATH 18,B02,083749,Rideout; David Porter,0,0,36,36
1656151410815,MATH 18,B03,083750,Rideout; David Porter,0,0,36,36
1656151410815,MATH 18,B04,083751,Rideout; David Porter,0,0,36,36
1656151410815,MATH 18,B05,093473,Rideout; David Porter,1,0,36,35
1656151410815,MATH 18,B06,093474,Rideout; David Porter,4,0,36,32
1656151416838,MATH 20A,A01,083754,Zheng; Zequn,11,0,40,29
1656151422860,MATH 20B,A01,083756,Briones; Jor-el Thomas Caparas,0,0,36,36
1656151422860,MATH 20B,A02,083757,Briones; Jor-el Thomas Caparas,0,0,36,36
1656151422860,MATH 20B,A03,093475,Staff,2,0,36,34
1656151428888,MATH 20C,A01,083760,Briones; Jor-el Thomas Caparas,0,0,35,35
1656151428888,MATH 20C,A02,083761,Briones; Jor-el Thomas Caparas,9,1,35,26
1656151428888,MATH 20C,A03,093476,Staff,0,0,35,35
1656151428888,MATH 20C,B01,083762,Bach; Quang Tran,1,0,30,29
1656151434916,MATH 20D,A01,083765,Tran; Brian Kha,2,0,30,28
1656151434916,MATH 20D,A02,083766,Tran; Brian Kha,0,1,30,30
1656151434916,MATH 20D,A03,083767,Tran; Brian Kha,2,0,30,28
1656151440943,MATH 20E,A01,083771,Ganguly; Soumya,4,0,32,28
1656151440943,MATH 20E,A02,083772,Ganguly; Soumya,0,0,32,32
1656151440943,MATH 20E,B01,083773,Ciotti; Benjamin,15,0,35,20
1656151440943,MATH 20E,B02,083774,Ciotti; Benjamin,15,0,35,20
1656151446967,MATH 103A,A01,083777,Greenfeld; Be'Eri,1,0,36,35
1656151446967,MATH 103A,A02,083778,Greenfeld; Be'Eri,1,0,36,35
1656151446967,MATH 103A,A03,093561,Staff,4,0,36,32
1656151446967,MATH 103A,B01,083779,Greenfeld; Be'Eri,8,1,36,28
1656151446967,MATH 103A,B02,083780,Greenfeld; Be'Eri,1,0,36,35
1656151446967,MATH 103A,B03,093562,Staff,0,0,36,36
1656151452991,MATH 105,A01,085443,Carter; Anne Toulson,4,1,35,31
1656151452991,MATH 105,A02,093477,Staff,11,0,35,24
1656151459014,MATH 109,A01,083213,Ganzberger; Geoffrey Michael,0,0,34,34
1656151459014,MATH 109,A02,083214,Ganzberger; Geoffrey Michael,0,0,34,34
1656151459014,MATH 109,A03,093478,Staff,1,0,34,33
1656151459014,MATH 109,B01,083215,Ganzberger; Geoffrey Michael,4,0,32,28
1656151459014,MATH 109,B02,083216,Ganzberger; Geoffrey Michael,1,0,32,31
1656151459014,MATH 109,B03,093479,Staff,4,0,32,28
1656151465038,MATH 142A,A01,083219,Chow; Bennett,1,0,32,31
1656151465038,MATH 142A,A02,083220,Chow; Bennett,8,0,32,24
1656151465038,MATH 142A,A03,093480,Staff,5,0,32,27
1656151465038,MATH 142A,B03,093481,Staff,4,0,32,28
1656151465038,MATH 142A,B04,093558,Staff,6,0,32,26
1656151465038,MATH 142A,B05,093559,Staff,0,0,32,32
1656151471060,MATH 193A,A01,083224,Rotar; Vladimir,0,1,34,34
1656151471060,MATH 193A,A02,083225,Rotar; Vladimir,0,0,34,34
1656151471060,MATH 193A,A03,083781,Rotar; Vladimir,0,0,34,34
1656151471060,MATH 193A,A04,083782,Rotar; Vladimir,6,0,34,28
1656151471060,MATH 193A,A05,093482,Rotar; Vladimir,1,0,34,33
1656151477084,MATH 197,001,091859,McAuley; Julian John,9999,0,9999,0
1656151477084,MATH 197,002,095566,Kedlaya; Kiran S.,9997,0,9999,2
1656151477084,MATH 197,003,095567,Xiao; Ming,9999,0,9999,0
1656151477084,MATH 197,004,095571,Perols; Johan Lars,9998,0,9999,1
1656151484138,COGS 9,A01,083615,Shannon; Kyle Michael,4,0,75,71
1656151490165,COGS 11,A01,083617,Boyle; Mary E. T.,15,0,48,33
1656151496189,COGS 13,A01,083071,Bastos; Amalia Pinkusfeld,6,0,71,65
1656151502218,COGS 14A,A01,092681,Semenuks; Arturs,4,15,100,96
1656151508241,COGS 14B,A01,083073,Cheng; Tzu-Han,7,0,63,56
1656151514269,COGS 17,A01,092677,Semenuks; Arturs,8,0,81,73
1656151520297,COGS 100,A01,083619,Allen; Michael Gordon,2,0,70,68
1656151526325,COGS 101A,A01,083621,Davis; Joshua Daniel,3,0,68,65
1656151532352,COGS 101B,A01,091572,Allen; Michael Gordon,6,0,65,59
1656151538376,COGS 101C,A01,083625,Delgado; Tania,10,0,35,25
1656151544399,COGS 107A,A01,083627,Boyle; Mary E. T.,0,0,60,60
1656151550426,COGS 118A,A01,083075,Gupta; Anjum,7,0,76,69
1656151556450,CSE 3,A50,083646,Miranda; Gregory Joseph,18,0,50,32
1656151562474,CSE 8A,A50,083650,Miranda; Gregory Joseph,3,3,56,53
1656151568508,CSE 11,A01,083080,Cao; Yingjun,1,54,40,39
1656151574533,CSE 12,A01,083652,Krause-Levy; Sophia Louisa,7,2,120,113
1656151580559,CSE 15L,A01,083654,Morris; Justin Loren,2,0,50,48
1656151580559,CSE 15L,A02,083655,Morris; Justin Loren,4,0,50,46
1656151586583,CSE 20,A01,083657,Tran; Khoa Dang,31,0,80,49
1656151592609,CSE 21,A01,095574,Bach; Quang Tran,25,0,48,23
1656151598633,CSE 30,A01,083084,Eldon; John,2,8,80,78
1656151598633,CSE 30,B01,095061,Bhaskar; Nishant,1,2,50,49
1656151604660,CSE 100,A01,083659,Cao; Yingjun,2,20,70,68
1656151610694,CSE 134B,A01,083661,Powell; Thomas Allan,3,0,100,97
1656151616718,CSE 140,A01,083663,Gungor; Onat,9,0,85,76
1656151622742,CSE 140L,A01,083088,Eldon; John,8,0,100,92
1656151628765,CSE 175,A01,083665,Kumar; Rakesh,0,0,25,25
1656151634788,CSE 190,A00,092507,Dubnov; Shlomo,3,0,20,17
1656151640813,ECE 45,A01,083139,Congero; Spencer William,1,0,75,74
1656151646836,ECE 65,A50,083695,Saad; Andrew S,8,0,30,22
1656151646836,ECE 65,A51,095125,Staff,23,0,26,3
1656151652858,ECE 109,A01,091882,Touri; Behrouz,0,1,70,70
1656151658885,ECE 180,A00,083140,Abi Samra; Nicholas Camill,1,0,30,29
1656151658885,ECE 180,B00,083141,Abi Samra; Nicholas Camill,0,4,30,30
1656151664917,MATH 10A,A01,083735,Patchell; Gregory David,0,0,30,30
1656151664917,MATH 10A,A02,083736,Patchell; Gregory David,22,0,30,8
1656151664917,MATH 10A,A03,083737,Patchell; Gregory David,16,0,30,14
1656151670940,MATH 10B,A01,083207,Lim; Seonhee,0,0,34,34
1656151670940,MATH 10B,A02,083208,Lim; Seonhee,7,0,35,28
1656151670940,MATH 10B,A03,093472,Staff,1,0,34,33
1656151670940,MATH 10B,B01,083739,Sinha; Shubham,10,0,30,20
1656151676965,MATH 18,A01,083743,Cinel; Cameron Alexander,7,0,30,23
1656151676965,MATH 18,A02,083744,Cinel; Cameron Alexander,10,0,30,20
1656151676965,MATH 18,A03,083745,Cinel; Cameron Alexander,4,0,30,26
1656151676965,MATH 18,B01,083748,Rideout; David Porter,0,0,36,36
1656151676965,MATH 18,B02,083749,Rideout; David Porter,0,0,36,36
1656151676965,MATH 18,B03,083750,Rideout; David Porter,0,0,36,36
1656151676965,MATH 18,B04,083751,Rideout; David Porter,0,0,36,36
1656151676965,MATH 18,B05,093473,Rideout; David Porter,1,0,36,35
1656151676965,MATH 18,B06,093474,Rideout; David Porter,4,0,36,32
1656151682989,MATH 20A,A01,083754,Zheng; Zequn,11,0,40,29
1656151689015,MATH 20B,A01,083756,Briones; Jor-el Thomas Caparas,0,0,36,36
1656151689015,MATH 20B,A02,083757,Briones; Jor-el Thomas Caparas,0,0,36,36
1656151689015,MATH 20B,A03,093475,Staff,2,0,36,34
1656151695044,MATH 20C,A01,083760,Briones; Jor-el Thomas Caparas,0,0,35,35
1656151695044,MATH 20C,A02,083761,Briones; Jor-el Thomas Caparas,9,1,35,26
1656151695044,MATH 20C,A03,093476,Staff,0,0,35,35
1656151695044,MATH 20C,B01,083762,Bach; Quang Tran,1,0,30,29
1656151701068,MATH 20D,A01,083765,Tran; Brian Kha,2,0,30,28
1656151701068,MATH 20D,A02,083766,Tran; Brian Kha,0,1,30,30
1656151701068,MATH 20D,A03,083767,Tran; Brian Kha,2,0,30,28
1656151707093,MATH 20E,A01,083771,Ganguly; Soumya,4,0,32,28
1656151707093,MATH 20E,A02,083772,Ganguly; Soumya,0,0,32,32
1656151707093,MATH 20E,B01,083773,Ciotti; Benjamin,15,0,35,20
1656151707093,MATH 20E,B02,083774,Ciotti; Benjamin,15,0,35,20
1656151713119,MATH 103A,A01,083777,Greenfeld; Be'Eri,1,0,36,35
1656151713119,MATH 103A,A02,083778,Greenfeld; Be'Eri,1,0,36,35
1656151713119,MATH 103A,A03,093561,Staff,4,0,36,32
1656151713119,MATH 103A,B01,083779,Greenfeld; Be'Eri,8,1,36,28
1656151713119,MATH 103A,B02,083780,Greenfeld; Be'Eri,1,0,36,35
1656151713119,MATH 103A,B03,093562,Staff,0,0,36,36
1656151719147,MATH 105,A01,085443,Carter; Anne Toulson,4,1,35,31
1656151719147,MATH 105,A02,093477,Staff,11,0,35,24
1656151725176,MATH 109,A01,083213,Ganzberger; Geoffrey Michael,0,0,34,34
1656151725176,MATH 109,A02,083214,Ganzberger; Geoffrey Michael,0,0,34,34
1656151725176,MATH 109,A03,093478,Staff,1,0,34,33
1656151725176,MATH 109,B01,083215,Ganzberger; Geoffrey Michael,4,0,32,28
1656151725176,MATH 109,B02,083216,Ganzberger; Geoffrey Michael,1,0,32,31
1656151725176,MATH 109,B03,093479,Staff,4,0,32,28
1656151731205,MATH 142A,A01,083219,Chow; Bennett,1,0,32,31
1656151731205,MATH 142A,A02,083220,Chow; Bennett,8,0,32,24
1656151731205,MATH 142A,A03,093480,Staff,5,0,32,27
1656151731205,MATH 142A,B03,093481,Staff,4,0,32,28
1656151731205,MATH 142A,B04,093558,Staff,6,0,32,26
1656151731205,MATH 142A,B05,093559,Staff,0,0,32,32
1656151737230,MATH 193A,A01,083224,Rotar; Vladimir,0,1,34,34
1656151737230,MATH 193A,A02,083225,Rotar; Vladimir,0,0,34,34
1656151737230,MATH 193A,A03,083781,Rotar; Vladimir,0,0,34,34
1656151737230,MATH 193A,A04,083782,Rotar; Vladimir,6,0,34,28
1656151737230,MATH 193A,A05,093482,Rotar; Vladimir,1,0,34,33
1656151743257,MATH 197,001,091859,McAuley; Julian John,9999,0,9999,0
1656151743257,MATH 197,002,095566,Kedlaya; Kiran S.,9997,0,9999,2
1656151743257,MATH 197,003,095567,Xiao; Ming,9999,0,9999,0
1656151743257,MATH 197,004,095571,Perols; Johan Lars,9998,0,9999,1
1656151750310,COGS 9,A01,083615,Shannon; Kyle Michael,4,0,75,71
1656151756337,COGS 11,A01,083617,Boyle; Mary E. T.,15,0,48,33
1656151762360,COGS 13,A01,083071,Bastos; Amalia Pinkusfeld,6,0,71,65
1656151768382,COGS 14A,A01,092681,Semenuks; Arturs,4,15,100,96
1656151774406,COGS 14B,A01,083073,Cheng; Tzu-Han,7,0,63,56
1656151780430,COGS 17,A01,092677,Semenuks; Arturs,8,0,81,73
1656151786456,COGS 100,A01,083619,Allen; Michael Gordon,2,0,70,68
1656151792570,COGS 101A,A01,083621,Davis; Joshua Daniel,3,0,68,65
1656151798597,COGS 101B,A01,091572,Allen; Michael Gordon,6,0,65,59
1656151804624,COGS 101C,A01,083625,Delgado; Tania,10,0,35,25
1656151810650,COGS 107A,A01,083627,Boyle; Mary E. T.,0,0,60,60
1656151816673,COGS 118A,A01,083075,Gupta; Anjum,7,0,76,69
1656151822698,CSE 3,A50,083646,Miranda; Gregory Joseph,18,0,50,32
1656151828722,CSE 8A,A50,083650,Miranda; Gregory Joseph,3,3,56,53
1656151834747,CSE 11,A01,083080,Cao; Yingjun,1,54,40,39
1656151840774,CSE 12,A01,083652,Krause-Levy; Sophia Louisa,7,2,120,113
1656151846798,CSE 15L,A01,083654,Morris; Justin Loren,2,0,50,48
1656151846798,CSE 15L,A02,083655,Morris; Justin Loren,4,0,50,46
1656151852821,CSE 20,A01,083657,Tran; Khoa Dang,31,0,80,49
1656151858850,CSE 21,A01,095574,Bach; Quang Tran,25,0,48,23
1656151864876,CSE 30,A01,083084,Eldon; John,2,8,80,78
1656151864876,CSE 30,B01,095061,Bhaskar; Nishant,1,2,50,49
1656151870905,CSE 100,A01,083659,Cao; Yingjun,2,20,70,68
1656151876928,CSE 134B,A01,083661,Powell; Thomas Allan,3,0,100,97
1656151882955,CSE 140,A01,083663,Gungor; Onat,9,0,85,76
1656151888978,CSE 140L,A01,083088,Eldon; John,8,0,100,92
1656151895001,CSE 175,A01,083665,Kumar; Rakesh,0,0,25,25
1656151901027,CSE 190,A00,092507,Dubnov; Shlomo,3,0,20,17
1656151907050,ECE 45,A01,083139,Congero; Spencer William,1,0,75,74
1656151913074,ECE 65,A50,083695,Saad; Andrew S,8,0,30,22
1656151913074,ECE 65,A51,095125,Staff,23,0,26,3
1656151919101,ECE 109,A01,091882,Touri; Behrouz,0,1,70,70
1656151925123,ECE 180,A00,083140,Abi Samra; Nicholas Camill,1,0,30,29
1656151925123,ECE 180,B00,083141,Abi Samra; Nicholas Camill,0,4,30,30
1656151931148,MATH 10A,A01,083735,Patchell; Gregory David,0,0,30,30
1656151931148,MATH 10A,A02,083736,Patchell; Gregory David,22,0,30,8
1656151931148,MATH 10A,A03,083737,Patchell; Gregory David,16,0,30,14
1656151937173,MATH 10B,A01,083207,Lim; Seonhee,0,0,34,34
1656151937173,MATH 10B,A02,083208,Lim; Seonhee,7,0,35,28
1656151937173,MATH 10B,A03,093472,Staff,1,0,34,33
1656151937173,MATH 10B,B01,083739,Sinha; Shubham,10,0,30,20
1656151943198,MATH 18,A01,083743,Cinel; Cameron Alexander,7,0,30,23
1656151943198,MATH 18,A02,083744,Cinel; Cameron Alexander,10,0,30,20
1656151943198,MATH 18,A03,083745,Cinel; Cameron Alexander,4,0,30,26
1656151943198,MATH 18,B01,083748,Rideout; David Porter,0,0,36,36
1656151943198,MATH 18,B02,083749,Rideout; David Porter,0,0,36,36
1656151943198,MATH 18,B03,083750,Rideout; David Porter,0,0,36,36
1656151943198,MATH 18,B04,083751,Rideout; David Porter,0,0,36,36
1656151943198,MATH 18,B05,093473,Rideout; David Porter,1,0,36,35
1656151943198,MATH 18,B06,093474,Rideout; David Porter,4,0,36,32
1656151949221,MATH 20A,A01,083754,Zheng; Zequn,11,0,40,29
1656151955245,MATH 20B,A01,083756,Briones; Jor-el Thomas Caparas,0,0,36,36
1656151955245,MATH 20B,A02,083757,Briones; Jor-el Thomas Caparas,0,0,36,36
1656151955245,MATH 20B,A03,093475,Staff,2,0,36,34
1656151961270,MATH 20C,A01,083760,Briones; Jor-el Thomas Caparas,0,0,35,35
1656151961270,MATH 20C,A02,083761,Briones; Jor-el Thomas Caparas,9,1,35,26
1656151961270,MATH 20C,A03,093476,Staff,0,0,35,35
1656151961270,MATH 20C,B01,083762,Bach; Quang Tran,1,0,30,29
1656151967295,MATH 20D,A01,083765,Tran; Brian Kha,2,0,30,28
1656151967295,MATH 20D,A02,083766,Tran; Brian Kha,0,1,30,30
1656151967295,MATH 20D,A03,083767,Tran; Brian Kha,2,0,30,28
1656151973317,MATH 20E,A01,083771,Ganguly; Soumya,4,0,32,28
1656151973317,MATH 20E,A02,083772,Ganguly; Soumya,0,0,32,32
1656151973317,MATH 20E,B01,083773,Ciotti; Benjamin,15,0,35,20
1656151973317,MATH 20E,B02,083774,Ciotti; Benjamin,15,0,35,20
1656151979353,MATH 103A,A01,083777,Greenfeld; Be'Eri,1,0,36,35
1656151979353,MATH 103A,A02,083778,Greenfeld; Be'Eri,1,0,36,35
1656151979353,MATH 103A,A03,093561,Staff,4,0,36,32
1656151979353,MATH 103A,B01,083779,Greenfeld; Be'Eri,8,1,36,28
1656151979353,MATH 103A,B02,083780,Greenfeld; Be'Eri,1,0,36,35
1656151979353,MATH 103A,B03,093562,Staff,0,0,36,36
1656151985377,MATH 105,A01,085443,Carter; Anne Toulson,4,1,35,31
1656151985377,MATH 105,A02,093477,Staff,11,0,35,24
1656151991404,MATH 109,A01,083213,Ganzberger; Geoffrey Michael,0,0,34,34
1656151991404,MATH 109,A02,083214,Ganzberger; Geoffrey Michael,0,0,34,34
1656151991404,MATH 109,A03,093478,Staff,1,0,34,33
1656151991404,MATH 109,B01,083215,Ganzberger; Geoffrey Michael,4,0,32,28
1656151991404,MATH 109,B02,083216,Ganzberger; Geoffrey Michael,1,0,32,31
1656151991404,MATH 109,B03,093479,Staff,4,0,32,28
1656151997433,MATH 142A,A01,083219,Chow; Bennett,1,0,32,31
1656151997433,MATH 142A,A02,083220,Chow; Bennett,8,0,32,24
1656151997433,MATH 142A,A03,093480,Staff,5,0,32,27
1656151997433,MATH 142A,B03,093481,Staff,4,0,32,28
1656151997433,MATH 142A,B04,093558,Staff,6,0,32,26
1656151997433,MATH 142A,B05,093559,Staff,0,0,32,32
1656152003461,MATH 193A,A01,083224,Rotar; Vladimir,0,1,34,34
1656152003461,MATH 193A,A02,083225,Rotar; Vladimir,0,0,34,34
1656152003461,MATH 193A,A03,083781,Rotar; Vladimir,0,0,34,34
1656152003461,MATH 193A,A04,083782,Rotar; Vladimir,6,0,34,28
1656152003461,MATH 193A,A05,093482,Rotar; Vladimir,1,0,34,33
1656152009483,MATH 197,001,091859,McAuley; Julian John,9999,0,9999,0
1656152009483,MATH 197,002,095566,Kedlaya; Kiran S.,9997,0,9999,2
1656152009483,MATH 197,003,095567,Xiao; Ming,9999,0,9999,0
1656152009483,MATH 197,004,095571,Perols; Johan Lars,9998,0,9999,1
1656152016547,COGS 9,A01,083615,Shannon; Kyle Michael,4,0,75,71
1656152022575,COGS 11,A01,083617,Boyle; Mary E. T.,15,0,48,33
1656152028605,COGS 13,A01,083071,Bastos; Amalia Pinkusfeld,6,0,71,65
1656152034631,COGS 14A,A01,092681,Semenuks; Arturs,4,15,100,96
1656152040660,COGS 14B,A01,083073,Cheng; Tzu-Han,7,0,63,56
1656152046682,COGS 17,A01,092677,Semenuks; Arturs,8,0,81,73
1656152052708,COGS 100,A01,083619,Allen; Michael Gordon,2,0,70,68
1656152058735,COGS 101A,A01,083621,Davis; Joshua Daniel,3,0,68,65
1656152064763,COGS 101B,A01,091572,Allen; Michael Gordon,6,0,65,59
1656152070789,COGS 101C,A01,083625,Delgado; Tania,10,0,35,25
1656152076818,COGS 107A,A01,083627,Boyle; Mary E. T.,0,0,60,60
1656152082845,COGS 118A,A01,083075,Gupta; Anjum,7,0,76,69
1656152088873,CSE 3,A50,083646,Miranda; Gregory Joseph,18,0,50,32
1656152094897,CSE 8A,A50,083650,Miranda; Gregory Joseph,3,3,56,53
1656152100919,CSE 11,A01,083080,Cao; Yingjun,1,54,40,39
1656152106943,CSE 12,A01,083652,Krause-Levy; Sophia Louisa,7,2,120,113
1656152112969,CSE 15L,A01,083654,Morris; Justin Loren,2,0,50,48
1656152112969,CSE 15L,A02,083655,Morris; Justin Loren,4,0,50,46
1656152118991,CSE 20,A01,083657,Tran; Khoa Dang,31,0,80,49
1656152125015,CSE 21,A01,095574,Bach; Quang Tran,25,0,48,23
1656152131043,CSE 30,A01,083084,Eldon; John,2,8,80,78
1656152131043,CSE 30,B01,095061,Bhaskar; Nishant,1,2,50,49
1656152137066,CSE 100,A01,083659,Cao; Yingjun,2,20,70,68
1656152143096,CSE 134B,A01,083661,Powell; Thomas Allan,3,0,100,97
1656152149129,CSE 140,A01,083663,Gungor; Onat,9,0,85,76
1656152155153,CSE 140L,A01,083088,Eldon; John,8,0,100,92
1656152161178,CSE 175,A01,083665,Kumar; Rakesh,0,0,25,25
1656152167205,CSE 190,A00,092507,Dubnov; Shlomo,3,0,20,17
1656152173230,ECE 45,A01,083139,Congero; Spencer William,1,0,75,74
1656152179256,ECE 65,A50,083695,Saad; Andrew S,8,0,30,22
1656152179256,ECE 65,A51,095125,Staff,23,0,26,3
1656152185282,ECE 109,A01,091882,Touri; Behrouz,0,1,70,70
1656152191305,ECE 180,A00,083140,Abi Samra; Nicholas Camill,1,0,30,29
1656152191305,ECE 180,B00,083141,Abi Samra; Nicholas Camill,0,4,30,30
1656152197330,MATH 10A,A01,083735,Patchell; Gregory David,0,0,30,30
1656152197330,MATH 10A,A02,083736,Patchell; Gregory David,22,0,30,8
1656152197330,MATH 10A,A03,083737,Patchell; Gregory David,16,0,30,14
1656152203354,MATH 10B,A01,083207,Lim; Seonhee,0,0,34,34
1656152203354,MATH 10B,A02,083208,Lim; Seonhee,7,0,35,28
1656152203354,MATH 10B,A03,093472,Staff,1,0,34,33
1656152203354,MATH 10B,B01,083739,Sinha; Shubham,10,0,30,20
1656152209377,MATH 18,A01,083743,Cinel; Cameron Alexander,7,0,30,23
1656152209377,MATH 18,A02,083744,Cinel; Cameron Alexander,10,0,30,20
1656152209377,MATH 18,A03,083745,Cinel; Cameron Alexander,4,0,30,26
1656152209377,MATH 18,B01,083748,Rideout; David Porter,0,0,36,36
1656152209377,MATH 18,B02,083749,Rideout; David Porter,0,0,36,36
1656152209377,MATH 18,B03,083750,Rideout; David Porter,0,0,36,36
1656152209377,MATH 18,B04,083751,Rideout; David Porter,0,0,36,36
1656152209377,MATH 18,B05,093473,Rideout; David Porter,1,0,36,35
1656152209377,MATH 18,B06,093474,Rideout; David Porter,4,0,36,32
1656152215399,MATH 20A,A01,083754,Zheng; Zequn,11,0,40,29
1656152221424,MATH 20B,A01,083756,Briones; Jor-el Thomas Caparas,0,0,36,36
1656152221424,MATH 20B,A02,083757,Briones; Jor-el Thomas Caparas,0,0,36,36
1656152221424,MATH 20B,A03,093475,Staff,2,0,36,34
1656152227446,MATH 20C,A01,083760,Briones; Jor-el Thomas Caparas,0,0,35,35
1656152227446,MATH 20C,A02,083761,Briones; Jor-el Thomas Caparas,9,1,35,26
1656152227446,MATH 20C,A03,093476,Staff,0,0,35,35
1656152227446,MATH 20C,B01,083762,Bach; Quang Tran,1,0,30,29
1656152233473,MATH 20D,A01,083765,Tran; Brian Kha,2,0,30,28
1656152233473,MATH 20D,A02,083766,Tran; Brian Kha,0,1,30,30
1656152233473,MATH 20D,A03,083767,Tran; Brian Kha,2,0,30,28
1656152239501,MATH 20E,A01,083771,Ganguly; Soumya,4,0,32,28
1656152239501,MATH 20E,A02,083772,Ganguly; Soumya,0,0,32,32
1656152239501,MATH 20E,B01,083773,Ciotti; Benjamin,15,0,35,20
1656152239501,MATH 20E,B02,083774,Ciotti; Benjamin,15,0,35,20
1656152245525,MATH 103A,A01,083777,Greenfeld; Be'Eri,1,0,36,35
1656152245525,MATH 103A,A02,083778,Greenfeld; Be'Eri,1,0,36,35
1656152245525,MATH 103A,A03,093561,Staff,4,0,36,32
1656152245525,MATH 103A,B01,083779,Greenfeld; Be'Eri,8,1,36,28
1656152245525,MATH 103A,B02,083780,Greenfeld; Be'Eri,1,0,36,35
1656152245525,MATH 103A,B03,093562,Staff,0,0,36,36
1656152251547,MATH 105,A01,085443,Carter; Anne Toulson,4,1,35,31
1656152251547,MATH 105,A02,093477,Staff,11,0,35,24
1656152257570,MATH 109,A01,083213,Ganzberger; Geoffrey Michael,0,0,34,34
1656152257570,MATH 109,A02,083214,Ganzberger; Geoffrey Michael,0,0,34,34
1656152257570,MATH 109,A03,093478,Staff,1,0,34,33
1656152257570,MATH 109,B01,083215,Ganzberger; Geoffrey Michael,4,0,32,28
1656152257570,MATH 109,B02,083216,Ganzberger; Geoffrey Michael,1,0,32,31
1656152257570,MATH 109,B03,093479,Staff,4,0,32,28
1656152263595,MATH 142A,A01,083219,Chow; Bennett,1,0,32,31
1656152263595,MATH 142A,A02,083220,Chow; Bennett,8,0,32,24
1656152263595,MATH 142A,A03,093480,Staff,5,0,32,27
1656152263595,MATH 142A,B03,093481,Staff,4,0,32,28
1656152263595,MATH 142A,B04,093558,Staff,6,0,32,26
1656152263595,MATH 142A,B05,093559,Staff,0,0,32,32
1656152269631,MATH 193A,A01,083224,Rotar; Vladimir,0,1,34,34
1656152269631,MATH 193A,A02,083225,Rotar; Vladimir,0,0,34,34
1656152269631,MATH 193A,A03,083781,Rotar; Vladimir,0,0,34,34
1656152269631,MATH 193A,A04,083782,Rotar; Vladimir,6,0,34,28
1656152269631,MATH 193A,A05,093482,Rotar; Vladimir,1,0,34,33
1656152275654,MATH 197,001,091859,McAuley; Julian John,9999,0,9999,0
1656152275654,MATH 197,002,095566,Kedlaya; Kiran S.,9997,0,9999,2
1656152275654,MATH 197,003,095567,Xiao; Ming,9999,0,9999,0
1656152275654,MATH 197,004,095571,Perols; Johan Lars,9998,0,9999,1
1656152282705,COGS 9,A01,083615,Shannon; Kyle Michael,4,0,75,71
1656152288732,COGS 11,A01,083617,Boyle; Mary E. T.,15,0,48,33
1656152294759,COGS 13,A01,083071,Bastos; Amalia Pinkusfeld,6,0,71,65
1656152300782,COGS 14A,A01,092681,Semenuks; Arturs,4,15,100,96
1656152306804,COGS 14B,A01,083073,Cheng; Tzu-Han,7,0,63,56
1656152312828,COGS 17,A01,092677,Semenuks; Arturs,8,0,81,73
1656152318855,COGS 100,A01,083619,Allen; Michael Gordon,2,0,70,68
1656152324882,COGS 101A,A01,083621,Davis; Joshua Daniel,3,0,68,65
1656152330907,COGS 101B,A01,091572,Allen; Michael Gordon,6,0,65,59
1656152336934,COGS 101C,A01,083625,Delgado; Tania,10,0,35,25
1656152342961,COGS 107A,A01,083627,Boyle; Mary E. T.,0,0,60,60
1656152348987,COGS 118A,A01,083075,Gupta; Anjum,7,0,76,69
1656152355014,CSE 3,A50,083646,Miranda; Gregory Joseph,18,0,50,32
1656152361038,CSE 8A,A50,083650,Miranda; Gregory Joseph,3,3,56,53
1656152367065,CSE 11,A01,083080,Cao; Yingjun,1,54,40,39
1656152373093,CSE 12,A01,083652,Krause-Levy; Sophia Louisa,7,2,120,113
1656152379133,CSE 15L,A01,083654,Morris; Justin Loren,2,0,50,48
1656152379133,CSE 15L,A02,083655,Morris; Justin Loren,4,0,50,46
1656152385160,CSE 20,A01,083657,Tran; Khoa Dang,31,0,80,49
1656152391272,CSE 21,A01,095574,Bach; Quang Tran,25,0,48,23
1656152397295,CSE 30,A01,083084,Eldon; John,2,8,80,78
1656152397295,CSE 30,B01,095061,Bhaskar; Nishant,1,2,50,49
1656152403324,CSE 100,A01,083659,Cao; Yingjun,2,20,70,68
1656152409345,CSE 134B,A01,083661,Powell; Thomas Allan,3,0,100,97
1656152415371,CSE 140,A01,083663,Gungor; Onat,9,0,85,76
1656152421397,CSE 140L,A01,083088,Eldon; John,8,0,100,92
1656152427419,CSE 175,A01,083665,Kumar; Rakesh,0,0,25,25
1656152433444,CSE 190,A00,092507,Dubnov; Shlomo,3,0,20,17
1656152439468,ECE 45,A01,083139,Congero; Spencer William,1,0,75,74
1656152445491,ECE 65,A50,083695,Saad; Andrew S,8,0,30,22
1656152445491,ECE 65,A51,095125,Staff,23,0,26,3
1656152451527,ECE 109,A01,091882,Touri; Behrouz,0,1,70,70
1656152457550,ECE 180,A00,083140,Abi Samra; Nicholas Camill,1,0,30,29
1656152457550,ECE 180,B00,083141,Abi Samra; Nicholas Camill,0,4,30,30
1656152463574,MATH 10A,A01,083735,Patchell; Gregory David,0,0,30,30
1656152463574,MATH 10A,A02,083736,Patchell; Gregory David,22,0,30,8
1656152463574,MATH 10A,A03,083737,Patchell; Gregory David,16,0,30,14
1656152469599,MATH 10B,A01,083207,Lim; Seonhee,0,0,34,34
1656152469599,MATH 10B,A02,083208,Lim; Seonhee,7,0,35,28
1656152469599,MATH 10B,A03,093472,Staff,1,0,34,33
1656152469599,MATH 10B,B01,083739,Sinha; Shubham,10,0,30,20
1656152475630,MATH 18,A01,083743,Cinel; Cameron Alexander,7,0,30,23
1656152475630,MATH 18,A02,083744,Cinel; Cameron Alexander,10,0,30,20
1656152475630,MATH 18,A03,083745,Cinel; Cameron Alexander,4,0,30,26
1656152475630,MATH 18,B01,083748,Rideout; David Porter,0,0,36,36
1656152475630,MATH 18,B02,083749,Rideout; David Porter,0,0,36,36
1656152475630,MATH 18,B03,083750,Rideout; David Porter,0,0,36,36
1656152475630,MATH 18,B04,083751,Rideout; David Porter,0,0,36,36
1656152475630,MATH 18,B05,093473,Rideout; David Porter,1,0,36,35
1656152475630,MATH 18,B06,093474,Rideout; David Porter,4,0,36,32
1656152481657,MATH 20A,A01,083754,Zheng; Zequn,11,0,40,29
1656152487681,MATH 20B,A01,083756,Briones; Jor-el Thomas Caparas,0,0,36,36
1656152487681,MATH 20B,A02,083757,Briones; Jor-el Thomas Caparas,0,0,36,36
1656152487681,MATH 20B,A03,093475,Staff,2,0,36,34
1656152493712,MATH 20C,A01,083760,Briones; Jor-el Thomas Caparas,0,0,35,35
1656152493712,MATH 20C,A02,083761,Briones; Jor-el Thomas Caparas,9,1,35,26
1656152493712,MATH 20C,A03,093476,Staff,0,0,35,35
1656152493712,MATH 20C,B01,083762,Bach; Quang Tran,1,0,30,29
1656152499735,MATH 20D,A01,083765,Tran; Brian Kha,2,0,30,28
1656152499735,MATH 20D,A02,083766,Tran; Brian Kha,0,1,30,30
1656152499735,MATH 20D,A03,083767,Tran; Brian Kha,2,0,30,28
1656152505763,MATH 20E,A01,083771,Ganguly; Soumya,4,0,32,28
1656152505763,MATH 20E,A02,083772,Ganguly; Soumya,0,0,32,32
1656152505763,MATH 20E,B01,083773,Ciotti; Benjamin,15,0,35,20
1656152505763,MATH 20E,B02,083774,Ciotti; Benjamin,15,0,35,20
1656152511787,MATH 103A,A01,083777,Greenfeld; Be'Eri,1,0,36,35
1656152511787,MATH 103A,A02,083778,Greenfeld; Be'Eri,1,0,36,35
1656152511787,MATH 103A,A03,093561,Staff,4,0,36,32
1656152511787,MATH 103A,B01,083779,Greenfeld; Be'Eri,8,1,36,28
1656152511787,MATH 103A,B02,083780,Greenfeld; Be'Eri,1,0,36,35
1656152511787,MATH 103A,B03,093562,Staff,0,0,36,36
1656152517815,MATH 105,A01,085443,Carter; Anne Toulson,4,1,35,31
1656152517815,MATH 105,A02,093477,Staff,11,0,35,24
1656152523845,MATH 109,A01,083213,Ganzberger; Geoffrey Michael,0,0,34,34
1656152523845,MATH 109,A02,083214,Ganzberger; Geoffrey Michael,0,0,34,34
1656152523845,MATH 109,A03,093478,Staff,1,0,34,33
1656152523845,MATH 109,B01,083215,Ganzberger; Geoffrey Michael,4,0,32,28
1656152523845,MATH 109,B02,083216,Ganzberger; Geoffrey Michael,1,0,32,31
1656152523845,MATH 109,B03,093479,Staff,4,0,32,28
1656152529871,MATH 142A,A01,083219,Chow; Bennett,1,0,32,31
1656152529871,MATH 142A,A02,083220,Chow; Bennett,8,0,32,24
1656152529871,MATH 142A,A03,093480,Staff,5,0,32,27
1656152529871,MATH 142A,B03,093481,Staff,4,0,32,28
1656152529871,MATH 142A,B04,093558,Staff,6,0,32,26
1656152529871,MATH 142A,B05,093559,Staff,0,0,32,32
1656152535899,MATH 193A,A01,083224,Rotar; Vladimir,0,1,34,34
1656152535899,MATH 193A,A02,083225,Rotar; Vladimir,0,0,34,34
1656152535899,MATH 193A,A03,083781,Rotar; Vladimir,0,0,34,34
1656152535899,MATH 193A,A04,083782,Rotar; Vladimir,6,0,34,28
1656152535899,MATH 193A,A05,093482,Rotar; Vladimir,1,0,34,33
1656152541929,MATH 197,001,091859,McAuley; Julian John,9999,0,9999,0
1656152541929,MATH 197,002,095566,Kedlaya; Kiran S.,9997,0,9999,2
1656152541929,MATH 197,003,095567,Xiao; Ming,9999,0,9999,0
1656152541929,MATH 197,004,095571,Perols; Johan Lars,9998,0,9999,1
1656152548978,COGS 9,A01,083615,Shannon; Kyle Michael,4,0,75,71
1656152555002,COGS 11,A01,083617,Boyle; Mary E. T.,14,0,48,34
1656152561024,COGS 13,A01,083071,Bastos; Amalia Pinkusfeld,6,0,71,65
1656152567048,COGS 14A,A01,092681,Semenuks; Arturs,4,15,100,96
1656152573072,COGS 14B,A01,083073,Cheng; Tzu-Han,7,0,63,56
1656152579095,COGS 17,A01,092677,Semenuks; Arturs,8,0,81,73
1656152585118,COGS 100,A01,083619,Allen; Michael Gordon,2,0,70,68
1656152591143,COGS 101A,A01,083621,Davis; Joshua Daniel,3,0,68,65
1656152597168,COGS 101B,A01,091572,Allen; Michael Gordon,6,0,65,59
1656152603196,COGS 101C,A01,083625,Delgado; Tania,10,0,35,25
1656152609219,COGS 107A,A01,083627,Boyle; Mary E. T.,0,0,60,60
1656152615246,COGS 118A,A01,083075,Gupta; Anjum,7,0,76,69
1656152621270,CSE 3,A50,083646,Miranda; Gregory Joseph,18,0,50,32
1656152627298,CSE 8A,A50,083650,Miranda; Gregory Joseph,3,3,56,53
1656152633337,CSE 11,A01,083080,Cao; Yingjun,1,54,40,39
1656152639364,CSE 12,A01,083652,Krause-Levy; Sophia Louisa,7,2,120,113
1656152645392,CSE 15L,A01,083654,Morris; Justin Loren,2,0,50,48
1656152645392,CSE 15L,A02,083655,Morris; Justin Loren,4,0,50,46
1656152651415,CSE 20,A01,083657,Tran; Khoa Dang,31,0,80,49
1656152657441,CSE 21,A01,095574,Bach; Quang Tran,25,0,48,23
1656152663465,CSE 30,A01,083084,Eldon; John,2,8,80,78
1656152663465,CSE 30,B01,095061,Bhaskar; Nishant,1,2,50,49
1656152669492,CSE 100,A01,083659,Cao; Yingjun,2,20,70,68
1656152675516,CSE 134B,A01,083661,Powell; Thomas Allan,3,0,100,97
1656152681542,CSE 140,A01,083663,Gungor; Onat,9,0,85,76
1656152687566,CSE 140L,A01,083088,Eldon; John,8,0,100,92
1656152693594,CSE 175,A01,083665,Kumar; Rakesh,0,0,25,25
1656152699617,CSE 190,A00,092507,Dubnov; Shlomo,3,0,20,17
1656152705641,ECE 45,A01,083139,Congero; Spencer William,1,0,75,74
1656152711667,ECE 65,A50,083695,Saad; Andrew S,8,0,30,22
1656152711667,ECE 65,A51,095125,Staff,23,0,26,3
1656152717693,ECE 109,A01,091882,Touri; Behrouz,0,1,70,70
1656152723721,ECE 180,A00,083140,Abi Samra; Nicholas Camill,1,0,30,29
1656152723721,ECE 180,B00,083141,Abi Samra; Nicholas Camill,0,4,30,30
1656152729751,MATH 10A,A01,083735,Patchell; Gregory David,0,0,30,30
1656152729751,MATH 10A,A02,083736,Patchell; Gregory David,22,0,30,8
1656152729751,MATH 10A,A03,083737,Patchell; Gregory David,16,0,30,14
1656152735776,MATH 10B,A01,083207,Lim; Seonhee,0,0,34,34
1656152735776,MATH 10B,A02,083208,Lim; Seonhee,7,0,35,28
1656152735776,MATH 10B,A03,093472,Staff,1,0,34,33
1656152735776,MATH 10B,B01,083739,Sinha; Shubham,10,0,30,20
1656152741806,MATH 18,A01,083743,Cinel; Cameron Alexander,7,0,30,23
1656152741806,MATH 18,A02,083744,Cinel; Cameron Alexander,10,0,30,20
1656152741806,MATH 18,A03,083745,Cinel; Cameron Alexander,4,0,30,26
1656152741806,MATH 18,B01,083748,Rideout; David Porter,0,0,36,36
1656152741806,MATH 18,B02,083749,Rideout; David Porter,0,0,36,36
1656152741806,MATH 18,B03,083750,Rideout; David Porter,0,0,36,36
1656152741806,MATH 18,B04,083751,Rideout; David Porter,0,0,36,36
1656152741806,MATH 18,B05,093473,Rideout; David Porter,1,0,36,35
1656152741806,MATH 18,B06,093474,Rideout; David Porter,4,0,36,32
1656152747832,MATH 20A,A01,083754,Zheng; Zequn,11,0,40,29
1656152753860,MATH 20B,A01,083756,Briones; Jor-el Thomas Caparas,0,0,36,36
1656152753860,MATH 20B,A02,083757,Briones; Jor-el Thomas Caparas,0,0,36,36
1656152753860,MATH 20B,A03,093475,Staff,2,0,36,34
1656152759883,MATH 20C,A01,083760,Briones; Jor-el Thomas Caparas,0,0,35,35
1656152759883,MATH 20C,A02,083761,Briones; Jor-el Thomas Caparas,9,1,35,26
1656152759883,MATH 20C,A03,093476,Staff,0,0,35,35
1656152759883,MATH 20C,B01,083762,Bach; Quang Tran,1,0,30,29
1656152765912,MATH 20D,A01,083765,Tran; Brian Kha,2,0,30,28
1656152765912,MATH 20D,A02,083766,Tran; Brian Kha,0,1,30,30
1656152765912,MATH 20D,A03,083767,Tran; Brian Kha,2,0,30,28
1656152771936,MATH 20E,A01,083771,Ganguly; Soumya,4,0,32,28
1656152771936,MATH 20E,A02,083772,Ganguly; Soumya,0,0,32,32
1656152771936,MATH 20E,B01,083773,Ciotti; Benjamin,15,0,35,20
1656152771936,MATH 20E,B02,083774,Ciotti; Benjamin,15,0,35,20
1656152777966,MATH 103A,A01,083777,Greenfeld; Be'Eri,1,0,36,35
1656152777966,MATH 103A,A02,083778,Greenfeld; Be'Eri,1,0,36,35
1656152777966,MATH 103A,A03,093561,Staff,4,0,36,32
1656152777966,MATH 103A,B01,083779,Greenfeld; Be'Eri,8,1,36,28
1656152777966,MATH 103A,B02,083780,Greenfeld; Be'Eri,1,0,36,35
1656152777966,MATH 103A,B03,093562,Staff,0,0,36,36
1656152783993,MATH 105,A01,085443,Carter; Anne Toulson,4,1,35,31
1656152783993,MATH 105,A02,093477,Staff,11,0,35,24
1656152790022,MATH 109,A01,083213,Ganzberger; Geoffrey Michael,0,0,34,34
1656152790022,MATH 109,A02,083214,Ganzberger; Geoffrey Michael,0,0,34,34
1656152790022,MATH 109,A03,093478,Staff,1,0,34,33
1656152790022,MATH 109,B01,083215,Ganzberger; Geoffrey Michael,4,0,32,28
1656152790022,MATH 109,B02,083216,Ganzberger; Geoffrey Michael,1,0,32,31
1656152790022,MATH 109,B03,093479,Staff,4,0,32,28
1656152796051,MATH 142A,A01,083219,Chow; Bennett,1,0,32,31
1656152796051,MATH 142A,A02,083220,Chow; Bennett,8,0,32,24
1656152796051,MATH 142A,A03,093480,Staff,5,0,32,27
1656152796051,MATH 142A,B03,093481,Staff,4,0,32,28
1656152796051,MATH 142A,B04,093558,Staff,6,0,32,26
1656152796051,MATH 142A,B05,093559,Staff,0,0,32,32
1656152802076,MATH 193A,A01,083224,Rotar; Vladimir,0,1,34,34
1656152802076,MATH 193A,A02,083225,Rotar; Vladimir,0,0,34,34
1656152802076,MATH 193A,A03,083781,Rotar; Vladimir,0,0,34,34
1656152802076,MATH 193A,A04,083782,Rotar; Vladimir,6,0,34,28
1656152802076,MATH 193A,A05,093482,Rotar; Vladimir,1,0,34,33
1656152808102,MATH 197,001,091859,McAuley; Julian John,9999,0,9999,0
1656152808102,MATH 197,002,095566,Kedlaya; Kiran S.,9997,0,9999,2
1656152808102,MATH 197,003,095567,Xiao; Ming,9999,0,9999,0
1656152808102,MATH 197,004,095571,Perols; Johan Lars,9998,0,9999,1
1656152815173,COGS 9,A01,083615,Shannon; Kyle Michael,4,0,75,71
1656152821197,COGS 11,A01,083617,Boyle; Mary E. T.,14,0,48,34
1656152827224,COGS 13,A01,083071,Bastos; Amalia Pinkusfeld,6,0,71,65
1656152833247,COGS 14A,A01,092681,Semenuks; Arturs,4,15,100,96
1656152839271,COGS 14B,A01,083073,Cheng; Tzu-Han,7,0,63,56
1656152845297,COGS 17,A01,092677,Semenuks; Arturs,8,0,81,73
1656152851324,COGS 100,A01,083619,Allen; Michael Gordon,2,0,70,68
1656152857345,COGS 101A,A01,083621,Davis; Joshua Daniel,3,0,68,65
1656152863373,COGS 101B,A01,091572,Allen; Michael Gordon,6,0,65,59
1656152869395,COGS 101C,A01,083625,Delgado; Tania,10,0,35,25
1656152875417,COGS 107A,A01,083627,Boyle; Mary E. T.,0,0,60,60
1656152881442,COGS 118A,A01,083075,Gupta; Anjum,7,0,76,69
1656152887465,CSE 3,A50,083646,Miranda; Gregory Joseph,18,0,50,32
1656152893492,CSE 8A,A50,083650,Miranda; Gregory Joseph,3,3,56,53
1656152899519,CSE 11,A01,083080,Cao; Yingjun,1,54,40,39
1656152905542,CSE 12,A01,083652,Krause-Levy; Sophia Louisa,7,2,120,113
1656152911569,CSE 15L,A01,083654,Morris; Justin Loren,2,0,50,48
1656152911569,CSE 15L,A02,083655,Morris; Justin Loren,4,0,50,46
1656152917591,CSE 20,A01,083657,Tran; Khoa Dang,31,0,80,49
1656152923615,CSE 21,A01,095574,Bach; Quang Tran,25,0,48,23
1656152929639,CSE 30,A01,083084,Eldon; John,2,8,80,78
1656152929639,CSE 30,B01,095061,Bhaskar; Nishant,1,2,50,49
1656152935666,CSE 100,A01,083659,Cao; Yingjun,2,20,70,68
1656152941693,CSE 134B,A01,083661,Powell; Thomas Allan,3,0,100,97
1656152947721,CSE 140,A01,083663,Gungor; Onat,9,0,85,76
1656152953745,CSE 140L,A01,083088,Eldon; John,8,0,100,92
1656152959768,CSE 175,A01,083665,Kumar; Rakesh,0,0,25,25
1656152965795,CSE 190,A00,092507,Dubnov; Shlomo,3,0,20,17
1656152971822,ECE 45,A01,083139,Congero; Spencer William,1,0,75,74
1656152977844,ECE 65,A50,083695,Saad; Andrew S,8,0,30,22
1656152977844,ECE 65,A51,095125,Staff,23,0,26,3
1656152983866,ECE 109,A01,091882,Touri; Behrouz,0,1,70,70
1656152989960,ECE 180,A00,083140,Abi Samra; Nicholas Camill,1,0,30,29
1656152989960,ECE 180,B00,083141,Abi Samra; Nicholas Camill,0,4,30,30
1656152995982,MATH 10A,A01,083735,Patchell; Gregory David,0,0,30,30
1656152995982,MATH 10A,A02,083736,Patchell; Gregory David,22,0,30,8
1656152995982,MATH 10A,A03,083737,Patchell; Gregory David,16,0,30,14
1656153002012,MATH 10B,A01,083207,Lim; Seonhee,0,0,34,34
1656153002012,MATH 10B,A02,083208,Lim; Seonhee,7,0,35,28
1656153002012,MATH 10B,A03,093472,Staff,1,0,34,33
1656153002012,MATH 10B,B01,083739,Sinha; Shubham,10,0,30,20
1656153008036,MATH 18,A01,083743,Cinel; Cameron Alexander,7,0,30,23
1656153008036,MATH 18,A02,083744,Cinel; Cameron Alexander,10,0,30,20
1656153008036,MATH 18,A03,083745,Cinel; Cameron Alexander,4,0,30,26
1656153008036,MATH 18,B01,083748,Rideout; David Porter,0,0,36,36
1656153008036,MATH 18,B02,083749,Rideout; David Porter,0,0,36,36
1656153008036,MATH 18,B03,083750,Rideout; David Porter,0,0,36,36
1656153008036,MATH 18,B04,083751,Rideout; David Porter,0,0,36,36
1656153008036,MATH 18,B05,093473,Rideout; David Porter,1,0,36,35
1656153008036,MATH 18,B06,093474,Rideout; David Porter,4,0,36,32
1656153014063,MATH 20A,A01,083754,Zheng; Zequn,11,0,40,29
1656153020085,MATH 20B,A01,083756,Briones; Jor-el Thomas Caparas,0,0,36,36
1656153020085,MATH 20B,A02,083757,Briones; Jor-el Thomas Caparas,0,0,36,36
1656153020085,MATH 20B,A03,093475,Staff,2,0,36,34
1656153026108,MATH 20C,A01,083760,Briones; Jor-el Thomas Caparas,0,0,35,35
1656153026108,MATH 20C,A02,083761,Briones; Jor-el Thomas Caparas,9,1,35,26
1656153026108,MATH 20C,A03,093476,Staff,0,0,35,35
1656153026108,MATH 20C,B01,083762,Bach; Quang Tran,1,0,30,29
1656153032137,MATH 20D,A01,083765,Tran; Brian Kha,2,0,30,28
1656153032137,MATH 20D,A02,083766,Tran; Brian Kha,0,1,30,30
1656153032137,MATH 20D,A03,083767,Tran; Brian Kha,2,0,30,28
1656153038162,MATH 20E,A01,083771,Ganguly; Soumya,4,0,32,28
1656153038162,MATH 20E,A02,083772,Ganguly; Soumya,0,0,32,32
1656153038162,MATH 20E,B01,083773,Ciotti; Benjamin,15,0,35,20
1656153038162,MATH 20E,B02,083774,Ciotti; Benjamin,15,0,35,20
1656153044186,MATH 103A,A01,083777,Greenfeld; Be'Eri,1,0,36,35
1656153044186,MATH 103A,A02,083778,Greenfeld; Be'Eri,1,0,36,35
1656153044186,MATH 103A,A03,093561,Staff,4,0,36,32
1656153044186,MATH 103A,B01,083779,Greenfeld; Be'Eri,8,1,36,28
1656153044186,MATH 103A,B02,083780,Greenfeld; Be'Eri,1,0,36,35
1656153044186,MATH 103A,B03,093562,Staff,0,0,36,36
1656153050208,MATH 105,A01,085443,Carter; Anne Toulson,4,1,35,31
1656153050208,MATH 105,A02,093477,Staff,11,0,35,24
1656153056236,MATH 109,A01,083213,Ganzberger; Geoffrey Michael,0,0,34,34
1656153056236,MATH 109,A02,083214,Ganzberger; Geoffrey Michael,0,0,34,34
1656153056236,MATH 109,A03,093478,Staff,1,0,34,33
1656153056236,MATH 109,B01,083215,Ganzberger; Geoffrey Michael,4,0,32,28
1656153056236,MATH 109,B02,083216,Ganzberger; Geoffrey Michael,1,0,32,31
1656153056236,MATH 109,B03,093479,Staff,4,0,32,28
1656153062267,MATH 142A,A01,083219,Chow; Bennett,1,0,32,31
1656153062267,MATH 142A,A02,083220,Chow; Bennett,8,0,32,24
1656153062267,MATH 142A,A03,093480,Staff,5,0,32,27
1656153062267,MATH 142A,B03,093481,Staff,4,0,32,28
1656153062267,MATH 142A,B04,093558,Staff,6,0,32,26
1656153062267,MATH 142A,B05,093559,Staff,0,0,32,32
1656153068291,MATH 193A,A01,083224,Rotar; Vladimir,0,1,34,34
1656153068291,MATH 193A,A02,083225,Rotar; Vladimir,0,0,34,34
1656153068291,MATH 193A,A03,083781,Rotar; Vladimir,0,0,34,34
1656153068291,MATH 193A,A04,083782,Rotar; Vladimir,6,0,34,28
1656153068291,MATH 193A,A05,093482,Rotar; Vladimir,1,0,34,33
1656153074313,MATH 197,001,091859,McAuley; Julian John,9999,0,9999,0
1656153074313,MATH 197,002,095566,Kedlaya; Kiran S.,9997,0,9999,2
1656153074313,MATH 197,003,095567,Xiao; Ming,9999,0,9999,0
1656153074313,MATH 197,004,095571,Perols; Johan Lars,9998,0,9999,1
1656153081376,COGS 9,A01,083615,Shannon; Kyle Michael,4,0,75,71
1656153087406,COGS 11,A01,083617,Boyle; Mary E. T.,14,0,48,34
1656153093434,COGS 13,A01,083071,Bastos; Amalia Pinkusfeld,6,0,71,65
1656153099458,COGS 14A,A01,092681,Semenuks; Arturs,4,15,100,96
1656153105487,COGS 14B,A01,083073,Cheng; Tzu-Han,7,0,63,56
1656153111516,COGS 17,A01,092677,Semenuks; Arturs,8,0,81,73
1656153117544,COGS 100,A01,083619,Allen; Michael Gordon,2,0,70,68
1656153123570,COGS 101A,A01,083621,Davis; Joshua Daniel,3,0,68,65
1656153129593,COGS 101B,A01,091572,Allen; Michael Gordon,6,0,65,59
1656153135617,COGS 101C,A01,083625,Delgado; Tania,10,0,35,25
1656153141644,COGS 107A,A01,083627,Boyle; Mary E. T.,0,0,60,60
1656153147667,COGS 118A,A01,083075,Gupta; Anjum,7,0,76,69
1656153153693,CSE 3,A50,083646,Miranda; Gregory Joseph,18,0,50,32
1656153159717,CSE 8A,A50,083650,Miranda; Gregory Joseph,3,3,56,53
1656153165745,CSE 11,A01,083080,Cao; Yingjun,1,54,40,39
1656153171768,CSE 12,A01,083652,Krause-Levy; Sophia Louisa,7,2,120,113
1656153177805,CSE 15L,A01,083654,Morris; Justin Loren,2,0,50,48
1656153177805,CSE 15L,A02,083655,Morris; Justin Loren,4,0,50,46
1656153183829,CSE 20,A01,083657,Tran; Khoa Dang,31,0,80,49
1656153189852,CSE 21,A01,095574,Bach; Quang Tran,25,0,48,23
1656153195883,CSE 30,A01,083084,Eldon; John,2,8,80,78
1656153195883,CSE 30,B01,095061,Bhaskar; Nishant,1,2,50,49
1656153201926,CSE 100,A01,083659,Cao; Yingjun,2,20,70,68
1656153207950,CSE 134B,A01,083661,Powell; Thomas Allan,3,0,100,97
1656153213974,CSE 140,A01,083663,Gungor; Onat,9,0,85,76
1656153219998,CSE 140L,A01,083088,Eldon; John,8,0,100,92
1656153226021,CSE 175,A01,083665,Kumar; Rakesh,0,0,25,25
1656153232049,CSE 190,A00,092507,Dubnov; Shlomo,3,0,20,17
1656153238077,ECE 45,A01,083139,Congero; Spencer William,1,0,75,74
1656153244104,ECE 65,A50,083695,Saad; Andrew S,8,0,30,22
1656153244104,ECE 65,A51,095125,Staff,23,0,26,3
1656153250133,ECE 109,A01,091882,Touri; Behrouz,0,1,70,70
1656153256159,ECE 180,A00,083140,Abi Samra; Nicholas Camill,1,0,30,29
1656153256159,ECE 180,B00,083141,Abi Samra; Nicholas Camill,0,4,30,30
1656153262191,MATH 10A,A01,083735,Patchell; Gregory David,0,0,30,30
1656153262191,MATH 10A,A02,083736,Patchell; Gregory David,22,0,30,8
1656153262191,MATH 10A,A03,083737,Patchell; Gregory David,16,0,30,14
1656153268221,MATH 10B,A01,083207,Lim; Seonhee,0,0,34,34
1656153268221,MATH 10B,A02,083208,Lim; Seonhee,7,0,35,28
1656153268221,MATH 10B,A03,093472,Staff,1,0,34,33
1656153268221,MATH 10B,B01,083739,Sinha; Shubham,10,0,30,20
1656153274251,MATH 18,A01,083743,Cinel; Cameron Alexander,7,0,30,23
1656153274251,MATH 18,A02,083744,Cinel; Cameron Alexander,10,0,30,20
1656153274251,MATH 18,A03,083745,Cinel; Cameron Alexander,4,0,30,26
1656153274251,MATH 18,B01,083748,Rideout; David Porter,0,0,36,36
1656153274251,MATH 18,B02,083749,Rideout; David Porter,0,0,36,36
1656153274251,MATH 18,B03,083750,Rideout; David Porter,0,0,36,36
1656153274251,MATH 18,B04,083751,Rideout; David Porter,0,0,36,36
1656153274251,MATH 18,B05,093473,Rideout; David Porter,1,0,36,35
1656153274251,MATH 18,B06,093474,Rideout; David Porter,4,0,36,32
1656153280277,MATH 20A,A01,083754,Zheng; Zequn,11,0,40,29
1656153286300,MATH 20B,A01,083756,Briones; Jor-el Thomas Caparas,0,0,36,36
1656153286300,MATH 20B,A02,083757,Briones; Jor-el Thomas Caparas,0,0,36,36
1656153286300,MATH 20B,A03,093475,Staff,2,0,36,34
1656153292325,MATH 20C,A01,083760,Briones; Jor-el Thomas Caparas,0,0,35,35
1656153292325,MATH 20C,A02,083761,Briones; Jor-el Thomas Caparas,9,1,35,26
1656153292325,MATH 20C,A03,093476,Staff,0,0,35,35
1656153292325,MATH 20C,B01,083762,Bach; Quang Tran,1,0,30,29
1656153298348,MATH 20D,A01,083765,Tran; Brian Kha,2,0,30,28
1656153298348,MATH 20D,A02,083766,Tran; Brian Kha,0,1,30,30
1656153298348,MATH 20D,A03,083767,Tran; Brian Kha,2,0,30,28
1656153304373,MATH 20E,A01,083771,Ganguly; Soumya,4,0,32,28
1656153304373,MATH 20E,A02,083772,Ganguly; Soumya,0,0,32,32
1656153304373,MATH 20E,B01,083773,Ciotti; Benjamin,15,0,35,20
1656153304373,MATH 20E,B02,083774,Ciotti; Benjamin,15,0,35,20
1656153310404,MATH 103A,A01,083777,Greenfeld; Be'Eri,1,0,36,35
1656153310404,MATH 103A,A02,083778,Greenfeld; Be'Eri,1,0,36,35
1656153310404,MATH 103A,A03,093561,Staff,4,0,36,32
1656153310404,MATH 103A,B01,083779,Greenfeld; Be'Eri,8,1,36,28
1656153310404,MATH 103A,B02,083780,Greenfeld; Be'Eri,1,0,36,35
1656153310404,MATH 103A,B03,093562,Staff,0,0,36,36
1656153316427,MATH 105,A01,085443,Carter; Anne Toulson,4,1,35,31
1656153316427,MATH 105,A02,093477,Staff,11,0,35,24
1656153322451,MATH 109,A01,083213,Ganzberger; Geoffrey Michael,0,0,34,34
1656153322451,MATH 109,A02,083214,Ganzberger; Geoffrey Michael,0,0,34,34
1656153322451,MATH 109,A03,093478,Staff,1,0,34,33
1656153322451,MATH 109,B01,083215,Ganzberger; Geoffrey Michael,4,0,32,28
1656153322451,MATH 109,B02,083216,Ganzberger; Geoffrey Michael,1,0,32,31
1656153322451,MATH 109,B03,093479,Staff,4,0,32,28
1656153328479,MATH 142A,A01,083219,Chow; Bennett,1,0,32,31
1656153328479,MATH 142A,A02,083220,Chow; Bennett,8,0,32,24
1656153328479,MATH 142A,A03,093480,Staff,5,0,32,27
1656153328479,MATH 142A,B03,093481,Staff,4,0,32,28
1656153328479,MATH 142A,B04,093558,Staff,6,0,32,26
1656153328479,MATH 142A,B05,093559,Staff,0,0,32,32
1656153334502,MATH 193A,A01,083224,Rotar; Vladimir,0,1,34,34
1656153334502,MATH 193A,A02,083225,Rotar; Vladimir,0,0,34,34
1656153334502,MATH 193A,A03,083781,Rotar; Vladimir,0,0,34,34
1656153334502,MATH 193A,A04,083782,Rotar; Vladimir,6,0,34,28
1656153334502,MATH 193A,A05,093482,Rotar; Vladimir,1,0,34,33
1656153340525,MATH 197,001,091859,McAuley; Julian John,9999,0,9999,0
1656153340525,MATH 197,002,095566,Kedlaya; Kiran S.,9997,0,9999,2
1656153340525,MATH 197,003,095567,Xiao; Ming,9999,0,9999,0
1656153340525,MATH 197,004,095571,Perols; Johan Lars,9998,0,9999,1
1656153347583,COGS 9,A01,083615,Shannon; Kyle Michael,4,0,75,71
1656153353610,COGS 11,A01,083617,Boyle; Mary E. T.,14,0,48,34
1656153359634,COGS 13,A01,083071,Bastos; Amalia Pinkusfeld,6,0,71,65
1656153365670,COGS 14A,A01,092681,Semenuks; Arturs,4,15,100,96
1656153371694,COGS 14B,A01,083073,Cheng; Tzu-Han,7,0,63,56
1656153377722,COGS 17,A01,092677,Semenuks; Arturs,8,0,81,73
1656153383745,COGS 100,A01,083619,Allen; Michael Gordon,2,0,70,68
1656153389772,COGS 101A,A01,083621,Davis; Joshua Daniel,3,0,68,65
1656153395797,COGS 101B,A01,091572,Allen; Michael Gordon,6,0,65,59
1656153401825,COGS 101C,A01,083625,Delgado; Tania,10,0,35,25
1656153407850,COGS 107A,A01,083627,Boyle; Mary E. T.,0,0,60,60
1656153413873,COGS 118A,A01,083075,Gupta; Anjum,7,0,76,69
1656153419900,CSE 3,A50,083646,Miranda; Gregory Joseph,18,0,50,32
1656153425924,CSE 8A,A50,083650,Miranda; Gregory Joseph,3,3,56,53
1656153431945,CSE 11,A01,083080,Cao; Yingjun,1,54,40,39
1656153437969,CSE 12,A01,083652,Krause-Levy; Sophia Louisa,7,2,120,113
1656153443997,CSE 15L,A01,083654,Morris; Justin Loren,2,0,50,48
1656153443997,CSE 15L,A02,083655,Morris; Justin Loren,4,0,50,46
1656153450022,CSE 20,A01,083657,Tran; Khoa Dang,31,0,80,49
1656153456044,CSE 21,A01,095574,Bach; Quang Tran,25,0,48,23
1656153462072,CSE 30,A01,083084,Eldon; John,2,8,80,78
1656153462072,CSE 30,B01,095061,Bhaskar; Nishant,1,2,50,49
1656153468101,CSE 100,A01,083659,Cao; Yingjun,2,20,70,68
1656153474128,CSE 134B,A01,083661,Powell; Thomas Allan,3,0,100,97
1656153480157,CSE 140,A01,083663,Gungor; Onat,9,0,85,76
1656153486184,CSE 140L,A01,083088,Eldon; John,8,0,100,92
1656153492207,CSE 175,A01,083665,Kumar; Rakesh,0,0,25,25
1656153498234,CSE 190,A00,092507,Dubnov; Shlomo,3,0,20,17
1656153504261,ECE 45,A01,083139,Congero; Spencer William,1,0,75,74
1656153510283,ECE 65,A50,083695,Saad; Andrew S,8,0,30,22
1656153510283,ECE 65,A51,095125,Staff,23,0,26,3
1656153516310,ECE 109,A01,091882,Touri; Behrouz,0,1,70,70
1656153522334,ECE 180,A00,083140,Abi Samra; Nicholas Camill,1,0,30,29
1656153522334,ECE 180,B00,083141,Abi Samra; Nicholas Camill,0,4,30,30
1656153528366,MATH 10A,A01,083735,Patchell; Gregory David,0,0,30,30
1656153528366,MATH 10A,A02,083736,Patchell; Gregory David,22,0,30,8
1656153528366,MATH 10A,A03,083737,Patchell; Gregory David,16,0,30,14
1656153534393,MATH 10B,A01,083207,Lim; Seonhee,0,0,34,34
1656153534393,MATH 10B,A02,083208,Lim; Seonhee,7,0,35,28
1656153534393,MATH 10B,A03,093472,Staff,1,0,34,33
1656153534393,MATH 10B,B01,083739,Sinha; Shubham,10,0,30,20
1656153540418,MATH 18,A01,083743,Cinel; Cameron Alexander,7,0,30,23
1656153540418,MATH 18,A02,083744,Cinel; Cameron Alexander,10,0,30,20
1656153540418,MATH 18,A03,083745,Cinel; Cameron Alexander,4,0,30,26
1656153540418,MATH 18,B01,083748,Rideout; David Porter,0,0,36,36
1656153540418,MATH 18,B02,083749,Rideout; David Porter,0,0,36,36
1656153540418,MATH 18,B03,083750,Rideout; David Porter,0,0,36,36
1656153540418,MATH 18,B04,083751,Rideout; David Porter,0,0,36,36
1656153540418,MATH 18,B05,093473,Rideout; David Porter,1,0,36,35
1656153540418,MATH 18,B06,093474,Rideout; David Porter,4,0,36,32
1656153546442,MATH 20A,A01,083754,Zheng; Zequn,11,0,40,29
1656153552470,MATH 20B,A01,083756,Briones; Jor-el Thomas Caparas,0,0,36,36
1656153552470,MATH 20B,A02,083757,Briones; Jor-el Thomas Caparas,0,0,36,36
1656153552470,MATH 20B,A03,093475,Staff,2,0,36,34
1656153558493,MATH 20C,A01,083760,Briones; Jor-el Thomas Caparas,0,0,35,35
1656153558493,MATH 20C,A02,083761,Briones; Jor-el Thomas Caparas,9,1,35,26
1656153558493,MATH 20C,A03,093476,Staff,0,0,35,35
1656153558493,MATH 20C,B01,083762,Bach; Quang Tran,1,0,30,29
1656153564517,MATH 20D,A01,083765,Tran; Brian Kha,2,0,30,28
1656153564517,MATH 20D,A02,083766,Tran; Brian Kha,0,1,30,30
1656153564517,MATH 20D,A03,083767,Tran; Brian Kha,2,0,30,28
1656153570542,MATH 20E,A01,083771,Ganguly; Soumya,4,0,32,28
1656153570542,MATH 20E,A02,083772,Ganguly; Soumya,0,0,32,32
1656153570542,MATH 20E,B01,083773,Ciotti; Benjamin,15,0,35,20
1656153570542,MATH 20E,B02,083774,Ciotti; Benjamin,15,0,35,20
1656153576572,MATH 103A,A01,083777,Greenfeld; Be'Eri,1,0,36,35
1656153576572,MATH 103A,A02,083778,Greenfeld; Be'Eri,1,0,36,35
1656153576572,MATH 103A,A03,093561,Staff,4,0,36,32
1656153576572,MATH 103A,B01,083779,Greenfeld; Be'Eri,8,1,36,28
1656153576572,MATH 103A,B02,083780,Greenfeld; Be'Eri,1,0,36,35
1656153576572,MATH 103A,B03,093562,Staff,0,0,36,36
1656153582602,MATH 105,A01,085443,Carter; Anne Toulson,4,1,35,31
1656153582602,MATH 105,A02,093477,Staff,11,0,35,24
1656153588697,MATH 109,A01,083213,Ganzberger; Geoffrey Michael,0,0,34,34
1656153588697,MATH 109,A02,083214,Ganzberger; Geoffrey Michael,0,0,34,34
1656153588697,MATH 109,A03,093478,Staff,1,0,34,33
1656153588697,MATH 109,B01,083215,Ganzberger; Geoffrey Michael,4,0,32,28
1656153588697,MATH 109,B02,083216,Ganzberger; Geoffrey Michael,1,0,32,31
1656153588697,MATH 109,B03,093479,Staff,4,0,32,28
1656153594728,MATH 142A,A01,083219,Chow; Bennett,1,0,32,31
1656153594728,MATH 142A,A02,083220,Chow; Bennett,8,0,32,24
1656153594728,MATH 142A,A03,093480,Staff,5,0,32,27
1656153594728,MATH 142A,B03,093481,Staff,4,0,32,28
1656153594728,MATH 142A,B04,093558,Staff,6,0,32,26
1656153594728,MATH 142A,B05,093559,Staff,0,0,32,32
1656153600751,MATH 193A,A01,083224,Rotar; Vladimir,0,1,34,34
1656153600751,MATH 193A,A02,083225,Rotar; Vladimir,0,0,34,34
1656153600751,MATH 193A,A03,083781,Rotar; Vladimir,0,0,34,34
1656153600751,MATH 193A,A04,083782,Rotar; Vladimir,6,0,34,28
1656153600751,MATH 193A,A05,093482,Rotar; Vladimir,1,0,34,33
1656153606779,MATH 197,001,091859,McAuley; Julian John,9999,0,9999,0
1656153606779,MATH 197,002,095566,Kedlaya; Kiran S.,9997,0,9999,2
1656153606779,MATH 197,003,095567,Xiao; Ming,9999,0,9999,0
1656153606779,MATH 197,004,095571,Perols; Johan Lars,9998,0,9999,1
1656153613849,COGS 9,A01,083615,Shannon; Kyle Michael,4,0,75,71
1656153619874,COGS 11,A01,083617,Boyle; Mary E. T.,14,0,48,34
1656153625897,COGS 13,A01,083071,Bastos; Amalia Pinkusfeld,6,0,71,65
1656153631920,COGS 14A,A01,092681,Semenuks; Arturs,4,15,100,96
1656153637957,COGS 14B,A01,083073,Cheng; Tzu-Han,7,0,63,56
1656153643980,COGS 17,A01,092677,Semenuks; Arturs,8,0,81,73
1656153650007,COGS 100,A01,083619,Allen; Michael Gordon,2,0,70,68
1656153656039,COGS 101A,A01,083621,Davis; Joshua Daniel,3,0,68,65
1656153662064,COGS 101B,A01,091572,Allen; Michael Gordon,6,0,65,59
1656153668089,COGS 101C,A01,083625,Delgado; Tania,10,0,35,25
1656153674112,COGS 107A,A01,083627,Boyle; Mary E. T.,0,0,60,60
1656153680134,COGS 118A,A01,083075,Gupta; Anjum,7,0,76,69
1656153686158,CSE 3,A50,083646,Miranda; Gregory Joseph,18,0,50,32
1656153692185,CSE 8A,A50,083650,Miranda; Gregory Joseph,3,3,56,53
1656153698211,CSE 11,A01,083080,Cao; Yingjun,1,54,40,39
1656153704237,CSE 12,A01,083652,Krause-Levy; Sophia Louisa,7,2,120,113
1656153710267,CSE 15L,A01,083654,Morris; Justin Loren,2,0,50,48
1656153710267,CSE 15L,A02,083655,Morris; Justin Loren,4,0,50,46
1656153716296,CSE 20,A01,083657,Tran; Khoa Dang,31,0,80,49
1656153722320,CSE 21,A01,095574,Bach; Quang Tran,25,0,48,23
1656153728357,CSE 30,A01,083084,Eldon; John,2,8,80,78
1656153728357,CSE 30,B01,095061,Bhaskar; Nishant,1,2,50,49
1656153734384,CSE 100,A01,083659,Cao; Yingjun,2,20,70,68
1656153740414,CSE 134B,A01,083661,Powell; Thomas Allan,3,0,100,97
1656153746442,CSE 140,A01,083663,Gungor; Onat,9,0,85,76
1656153752467,CSE 140L,A01,083088,Eldon; John,8,0,100,92
1656153758494,CSE 175,A01,083665,Kumar; Rakesh,0,0,25,25
1656153764518,CSE 190,A00,092507,Dubnov; Shlomo,3,0,20,17
1656153770540,ECE 45,A01,083139,Congero; Spencer William,1,0,75,74
1656153776564,ECE 65,A50,083695,Saad; Andrew S,8,0,30,22
1656153776564,ECE 65,A51,095125,Staff,23,0,26,3
1656153782595,ECE 109,A01,091882,Touri; Behrouz,0,1,70,70
1656153788623,ECE 180,A00,083140,Abi Samra; Nicholas Camill,1,0,30,29
1656153788623,ECE 180,B00,083141,Abi Samra; Nicholas Camill,0,4,30,30
1656153794658,MATH 10A,A01,083735,Patchell; Gregory David,0,0,30,30
1656153794658,MATH 10A,A02,083736,Patchell; Gregory David,22,0,30,8
1656153794658,MATH 10A,A03,083737,Patchell; Gregory David,16,0,30,14
1656153800684,MATH 10B,A01,083207,Lim; Seonhee,0,0,34,34
1656153800684,MATH 10B,A02,083208,Lim; Seonhee,7,0,35,28
1656153800684,MATH 10B,A03,093472,Staff,1,0,34,33
1656153800684,MATH 10B,B01,083739,Sinha; Shubham,10,0,30,20
1656153806712,MATH 18,A01,083743,Cinel; Cameron Alexander,7,0,30,23
1656153806712,MATH 18,A02,083744,Cinel; Cameron Alexander,10,0,30,20
1656153806712,MATH 18,A03,083745,Cinel; Cameron Alexander,4,0,30,26
1656153806712,MATH 18,B01,083748,Rideout; David Porter,0,0,36,36
1656153806712,MATH 18,B02,083749,Rideout; David Porter,0,0,36,36
1656153806712,MATH 18,B03,083750,Rideout; David Porter,0,0,36,36
1656153806712,MATH 18,B04,083751,Rideout; David Porter,0,0,36,36
1656153806712,MATH 18,B05,093473,Rideout; David Porter,1,0,36,35
1656153806712,MATH 18,B06,093474,Rideout; David Porter,4,0,36,32
1656153812742,MATH 20A,A01,083754,Zheng; Zequn,11,0,40,29
1656153818774,MATH 20B,A01,083756,Briones; Jor-el Thomas Caparas,0,0,36,36
1656153818774,MATH 20B,A02,083757,Briones; Jor-el Thomas Caparas,0,0,36,36
1656153818774,MATH 20B,A03,093475,Staff,2,0,36,34
1656153824802,MATH 20C,A01,083760,Briones; Jor-el Thomas Caparas,0,0,35,35
1656153824802,MATH 20C,A02,083761,Briones; Jor-el Thomas Caparas,9,1,35,26
1656153824802,MATH 20C,A03,093476,Staff,0,0,35,35
1656153824802,MATH 20C,B01,083762,Bach; Quang Tran,1,0,30,29
1656153830827,MATH 20D,A01,083765,Tran; Brian Kha,2,0,30,28
1656153830827,MATH 20D,A02,083766,Tran; Brian Kha,0,1,30,30
1656153830827,MATH 20D,A03,083767,Tran; Brian Kha,2,0,30,28
1656153836864,MATH 20E,A01,083771,Ganguly; Soumya,4,0,32,28
1656153836864,MATH 20E,A02,083772,Ganguly; Soumya,0,0,32,32
1656153836864,MATH 20E,B01,083773,Ciotti; Benjamin,15,0,35,20
1656153836864,MATH 20E,B02,083774,Ciotti; Benjamin,15,0,35,20
1656153842898,MATH 103A,A01,083777,Greenfeld; Be'Eri,1,0,36,35
1656153842898,MATH 103A,A02,083778,Greenfeld; Be'Eri,1,0,36,35
1656153842898,MATH 103A,A03,093561,Staff,4,0,36,32
1656153842898,MATH 103A,B01,083779,Greenfeld; Be'Eri,8,1,36,28
1656153842898,MATH 103A,B02,083780,Greenfeld; Be'Eri,1,0,36,35
1656153842898,MATH 103A,B03,093562,Staff,0,0,36,36
1656153848922,MATH 105,A01,085443,Carter; Anne Toulson,4,1,35,31
1656153848922,MATH 105,A02,093477,Staff,11,0,35,24
1656153854959,MATH 109,A01,083213,Ganzberger; Geoffrey Michael,0,0,34,34
1656153854959,MATH 109,A02,083214,Ganzberger; Geoffrey Michael,0,0,34,34
1656153854959,MATH 109,A03,093478,Staff,1,0,34,33
1656153854959,MATH 109,B01,083215,Ganzberger; Geoffrey Michael,4,0,32,28
1656153854959,MATH 109,B02,083216,Ganzberger; Geoffrey Michael,1,0,32,31
1656153854959,MATH 109,B03,093479,Staff,4,0,32,28
1656153860985,MATH 142A,A01,083219,Chow; Bennett,1,0,32,31
1656153860985,MATH 142A,A02,083220,Chow; Bennett,8,0,32,24
1656153860985,MATH 142A,A03,093480,Staff,5,0,32,27
1656153860985,MATH 142A,B03,093481,Staff,4,0,32,28
1656153860985,MATH 142A,B04,093558,Staff,6,0,32,26
1656153860985,MATH 142A,B05,093559,Staff,0,0,32,32
1656153867014,MATH 193A,A01,083224,Rotar; Vladimir,0,1,34,34
1656153867014,MATH 193A,A02,083225,Rotar; Vladimir,0,0,34,34
1656153867014,MATH 193A,A03,083781,Rotar; Vladimir,0,0,34,34
1656153867014,MATH 193A,A04,083782,Rotar; Vladimir,6,0,34,28
1656153867014,MATH 193A,A05,093482,Rotar; Vladimir,1,0,34,33
1656153873042,MATH 197,001,091859,McAuley; Julian John,9999,0,9999,0
1656153873042,MATH 197,002,095566,Kedlaya; Kiran S.,9997,0,9999,2
1656153873042,MATH 197,003,095567,Xiao; Ming,9999,0,9999,0
1656153873042,MATH 197,004,095571,Perols; Johan Lars,9998,0,9999,1
1656153880101,COGS 9,A01,083615,Shannon; Kyle Michael,4,0,75,71
1656153886129,COGS 11,A01,083617,Boyle; Mary E. T.,14,0,48,34
1656153892152,COGS 13,A01,083071,Bastos; Amalia Pinkusfeld,6,0,71,65
1656153898177,COGS 14A,A01,092681,Semenuks; Arturs,4,15,100,96
1656153904211,COGS 14B,A01,083073,Cheng; Tzu-Han,7,0,63,56
1656153910235,COGS 17,A01,092677,Semenuks; Arturs,8,0,81,73
1656153916264,COGS 100,A01,083619,Allen; Michael Gordon,2,0,70,68
1656153922287,COGS 101A,A01,083621,Davis; Joshua Daniel,3,0,68,65
1656153928317,COGS 101B,A01,091572,Allen; Michael Gordon,6,0,65,59
1656153934342,COGS 101C,A01,083625,Delgado; Tania,10,0,35,25
1656153940367,COGS 107A,A01,083627,Boyle; Mary E. T.,0,0,60,60
1656153946395,COGS 118A,A01,083075,Gupta; Anjum,7,0,76,69
1656153952420,CSE 3,A50,083646,Miranda; Gregory Joseph,18,0,50,32
1656153958447,CSE 8A,A50,083650,Miranda; Gregory Joseph,3,3,56,53
1656153964471,CSE 11,A01,083080,Cao; Yingjun,1,54,40,39
1656153970498,CSE 12,A01,083652,Krause-Levy; Sophia Louisa,7,2,120,113
1656153976524,CSE 15L,A01,083654,Morris; Justin Loren,2,0,50,48
1656153976524,CSE 15L,A02,083655,Morris; Justin Loren,4,0,50,46
1656153982547,CSE 20,A01,083657,Tran; Khoa Dang,31,0,80,49
1656153988570,CSE 21,A01,095574,Bach; Quang Tran,25,0,48,23
1656153994594,CSE 30,A01,083084,Eldon; John,2,8,80,78
1656153994594,CSE 30,B01,095061,Bhaskar; Nishant,1,2,50,49
1656154000619,CSE 100,A01,083659,Cao; Yingjun,2,20,70,68
1656154006641,CSE 134B,A01,083661,Powell; Thomas Allan,3,0,100,97
1656154012670,CSE 140,A01,083663,Gungor; Onat,9,0,85,76
1656154018695,CSE 140L,A01,083088,Eldon; John,8,0,100,92
1656154024718,CSE 175,A01,083665,Kumar; Rakesh,0,0,25,25
1656154030741,CSE 190,A00,092507,Dubnov; Shlomo,3,0,20,17
1656154036771,ECE 45,A01,083139,Congero; Spencer William,1,0,75,74
1656154042794,ECE 65,A50,083695,Saad; Andrew S,8,0,30,22
1656154042794,ECE 65,A51,095125,Staff,23,0,26,3
1656154048819,ECE 109,A01,091882,Touri; Behrouz,0,1,70,70
1656154054844,ECE 180,A00,083140,Abi Samra; Nicholas Camill,1,0,30,29
1656154054844,ECE 180,B00,083141,Abi Samra; Nicholas Camill,0,4,30,30
1656154060873,MATH 10A,A01,083735,Patchell; Gregory David,0,0,30,30
1656154060873,MATH 10A,A02,083736,Patchell; Gregory David,22,0,30,8
1656154060873,MATH 10A,A03,083737,Patchell; Gregory David,16,0,30,14
1656154066907,MATH 10B,A01,083207,Lim; Seonhee,0,0,34,34
1656154066907,MATH 10B,A02,083208,Lim; Seonhee,7,0,35,28
1656154066907,MATH 10B,A03,093472,Staff,1,0,34,33
1656154066907,MATH 10B,B01,083739,Sinha; Shubham,10,0,30,20
1656154072939,MATH 18,A01,083743,Cinel; Cameron Alexander,7,0,30,23
1656154072939,MATH 18,A02,083744,Cinel; Cameron Alexander,10,0,30,20
1656154072939,MATH 18,A03,083745,Cinel; Cameron Alexander,4,0,30,26
1656154072939,MATH 18,B01,083748,Rideout; David Porter,0,0,36,36
1656154072939,MATH 18,B02,083749,Rideout; David Porter,0,0,36,36
1656154072939,MATH 18,B03,083750,Rideout; David Porter,0,0,36,36
1656154072939,MATH 18,B04,083751,Rideout; David Porter,0,0,36,36
1656154072939,MATH 18,B05,093473,Rideout; David Porter,1,0,36,35
1656154072939,MATH 18,B06,093474,Rideout; David Porter,4,0,36,32
1656154078964,MATH 20A,A01,083754,Zheng; Zequn,11,0,40,29
1656154084987,MATH 20B,A01,083756,Briones; Jor-el Thomas Caparas,0,0,36,36
1656154084987,MATH 20B,A02,083757,Briones; Jor-el Thomas Caparas,0,0,36,36
1656154084987,MATH 20B,A03,093475,Staff,2,0,36,34
1656154091010,MATH 20C,A01,083760,Briones; Jor-el Thomas Caparas,0,0,35,35
1656154091010,MATH 20C,A02,083761,Briones; Jor-el Thomas Caparas,9,1,35,26
1656154091010,MATH 20C,A03,093476,Staff,0,0,35,35
1656154091010,MATH 20C,B01,083762,Bach; Quang Tran,1,0,30,29
1656154097034,MATH 20D,A01,083765,Tran; Brian Kha,2,0,30,28
1656154097034,MATH 20D,A02,083766,Tran; Brian Kha,0,1,30,30
1656154097034,MATH 20D,A03,083767,Tran; Brian Kha,2,0,30,28
1656154103067,MATH 20E,A01,083771,Ganguly; Soumya,4,0,32,28
1656154103067,MATH 20E,A02,083772,Ganguly; Soumya,0,0,32,32
1656154103067,MATH 20E,B01,083773,Ciotti; Benjamin,15,0,35,20
1656154103067,MATH 20E,B02,083774,Ciotti; Benjamin,15,0,35,20
1656154109100,MATH 103A,A01,083777,Greenfeld; Be'Eri,1,0,36,35
1656154109100,MATH 103A,A02,083778,Greenfeld; Be'Eri,1,0,36,35
1656154109100,MATH 103A,A03,093561,Staff,4,0,36,32
1656154109100,MATH 103A,B01,083779,Greenfeld; Be'Eri,8,1,36,28
1656154109100,MATH 103A,B02,083780,Greenfeld; Be'Eri,1,0,36,35
1656154109100,MATH 103A,B03,093562,Staff,0,0,36,36
1656154115131,MATH 105,A01,085443,Carter; Anne Toulson,4,1,35,31
1656154115131,MATH 105,A02,093477,Staff,11,0,35,24
1656154121159,MATH 109,A01,083213,Ganzberger; Geoffrey Michael,0,0,34,34
1656154121159,MATH 109,A02,083214,Ganzberger; Geoffrey Michael,0,0,34,34
1656154121159,MATH 109,A03,093478,Staff,1,0,34,33
1656154121159,MATH 109,B01,083215,Ganzberger; Geoffrey Michael,4,0,32,28
1656154121159,MATH 109,B02,083216,Ganzberger; Geoffrey Michael,1,0,32,31
1656154121159,MATH 109,B03,093479,Staff,4,0,32,28
1656154127189,MATH 142A,A01,083219,Chow; Bennett,1,0,32,31
1656154127189,MATH 142A,A02,083220,Chow; Bennett,8,0,32,24
1656154127189,MATH 142A,A03,093480,Staff,5,0,32,27
1656154127189,MATH 142A,B03,093481,Staff,4,0,32,28
1656154127189,MATH 142A,B04,093558,Staff,6,0,32,26
1656154127189,MATH 142A,B05,093559,Staff,0,0,32,32
1656154133212,MATH 193A,A01,083224,Rotar; Vladimir,0,1,34,34
1656154133212,MATH 193A,A02,083225,Rotar; Vladimir,0,0,34,34
1656154133212,MATH 193A,A03,083781,Rotar; Vladimir,0,0,34,34
1656154133212,MATH 193A,A04,083782,Rotar; Vladimir,6,0,34,28
1656154133212,MATH 193A,A05,093482,Rotar; Vladimir,1,0,34,33
1656154139239,MATH 197,001,091859,McAuley; Julian John,9999,0,9999,0
1656154139239,MATH 197,002,095566,Kedlaya; Kiran S.,9997,0,9999,2
1656154139239,MATH 197,003,095567,Xiao; Ming,9999,0,9999,0
1656154139239,MATH 197,004,095571,Perols; Johan Lars,9998,0,9999,1
1656154146309,COGS 9,A01,083615,Shannon; Kyle Michael,4,0,75,71
1656154152333,COGS 11,A01,083617,Boyle; Mary E. T.,14,0,48,34
1656154158357,COGS 13,A01,083071,Bastos; Amalia Pinkusfeld,6,0,71,65
1656154164381,COGS 14A,A01,092681,Semenuks; Arturs,4,15,100,96
1656154170406,COGS 14B,A01,083073,Cheng; Tzu-Han,7,0,63,56
1656154176428,COGS 17,A01,092677,Semenuks; Arturs,8,0,81,73
1656154182540,COGS 100,A01,083619,Allen; Michael Gordon,2,0,70,68
1656154188568,COGS 101A,A01,083621,Davis; Joshua Daniel,3,0,68,65
1656154194592,COGS 101B,A01,091572,Allen; Michael Gordon,6,0,65,59
1656154200615,COGS 101C,A01,083625,Delgado; Tania,10,0,35,25
1656154206638,COGS 107A,A01,083627,Boyle; Mary E. T.,0,0,60,60
1656154212663,COGS 118A,A01,083075,Gupta; Anjum,7,0,76,69
1656154218689,CSE 3,A50,083646,Miranda; Gregory Joseph,18,0,50,32
1656154224716,CSE 8A,A50,083650,Miranda; Gregory Joseph,3,3,56,53
1656154230744,CSE 11,A01,083080,Cao; Yingjun,1,54,40,39
1656154236767,CSE 12,A01,083652,Krause-Levy; Sophia Louisa,7,2,120,113
1656154242798,CSE 15L,A01,083654,Morris; Justin Loren,2,0,50,48
1656154242798,CSE 15L,A02,083655,Morris; Justin Loren,4,0,50,46
1656154248822,CSE 20,A01,083657,Tran; Khoa Dang,31,0,80,49
1656154254848,CSE 21,A01,095574,Bach; Quang Tran,25,0,48,23
1656154260881,CSE 30,A01,083084,Eldon; John,2,8,80,78
1656154260881,CSE 30,B01,095061,Bhaskar; Nishant,1,2,50,49
1656154266910,CSE 100,A01,083659,Cao; Yingjun,2,20,70,68
1656154272935,CSE 134B,A01,083661,Powell; Thomas Allan,3,0,100,97
1656154278963,CSE 140,A01,083663,Gungor; Onat,9,0,85,76
1656154284987,CSE 140L,A01,083088,Eldon; John,8,0,100,92
1656154291011,CSE 175,A01,083665,Kumar; Rakesh,0,0,25,25
1656154297035,CSE 190,A00,092507,Dubnov; Shlomo,3,0,20,17
1656154303062,ECE 45,A01,083139,Congero; Spencer William,1,0,75,74
1656154309095,ECE 65,A50,083695,Saad; Andrew S,8,0,30,22
1656154309095,ECE 65,A51,095125,Staff,23,0,26,3
1656154315119,ECE 109,A01,091882,Touri; Behrouz,0,1,70,70
1656154321148,ECE 180,A00,083140,Abi Samra; Nicholas Camill,1,0,30,29
1656154321148,ECE 180,B00,083141,Abi Samra; Nicholas Camill,0,4,30,30
1656154327181,MATH 10A,A01,083735,Patchell; Gregory David,0,0,30,30
1656154327181,MATH 10A,A02,083736,Patchell; Gregory David,22,0,30,8
1656154327181,MATH 10A,A03,083737,Patchell; Gregory David,16,0,30,14
1656154333209,MATH 10B,A01,083207,Lim; Seonhee,0,0,34,34
1656154333209,MATH 10B,A02,083208,Lim; Seonhee,7,0,35,28
1656154333209,MATH 10B,A03,093472,Staff,1,0,34,33
1656154333209,MATH 10B,B01,083739,Sinha; Shubham,10,0,30,20
1656154339247,MATH 18,A01,083743,Cinel; Cameron Alexander,7,0,30,23
1656154339247,MATH 18,A02,083744,Cinel; Cameron Alexander,10,0,30,20
1656154339247,MATH 18,A03,083745,Cinel; Cameron Alexander,4,0,30,26
1656154339247,MATH 18,B01,083748,Rideout; David Porter,0,0,36,36
1656154339247,MATH 18,B02,083749,Rideout; David Porter,0,0,36,36
1656154339247,MATH 18,B03,083750,Rideout; David Porter,0,0,36,36
1656154339247,MATH 18,B04,083751,Rideout; David Porter,0,0,36,36
1656154339247,MATH 18,B05,093473,Rideout; David Porter,1,0,36,35
1656154339247,MATH 18,B06,093474,Rideout; David Porter,4,0,36,32
1656154345277,MATH 20A,A01,083754,Zheng; Zequn,11,0,40,29
1656154351311,MATH 20B,A01,083756,Briones; Jor-el Thomas Caparas,0,0,36,36
1656154351311,MATH 20B,A02,083757,Briones; Jor-el Thomas Caparas,0,0,36,36
1656154351311,MATH 20B,A03,093475,Staff,2,0,36,34
1656154357340,MATH 20C,A01,083760,Briones; Jor-el Thomas Caparas,0,0,35,35
1656154357340,MATH 20C,A02,083761,Briones; Jor-el Thomas Caparas,9,1,35,26
1656154357340,MATH 20C,A03,093476,Staff,0,0,35,35
1656154357340,MATH 20C,B01,083762,Bach; Quang Tran,1,0,30,29
1656154363365,MATH 20D,A01,083765,Tran; Brian Kha,2,0,30,28
1656154363365,MATH 20D,A02,083766,Tran; Brian Kha,0,1,30,30
1656154363365,MATH 20D,A03,083767,Tran; Brian Kha,2,0,30,28
1656154369399,MATH 20E,A01,083771,Ganguly; Soumya,4,0,32,28
1656154369399,MATH 20E,A02,083772,Ganguly; Soumya,0,0,32,32
1656154369399,MATH 20E,B01,083773,Ciotti; Benjamin,15,0,35,20
1656154369399,MATH 20E,B02,083774,Ciotti; Benjamin,15,0,35,20
1656154375431,MATH 103A,A01,083777,Greenfeld; Be'Eri,1,0,36,35
1656154375431,MATH 103A,A02,083778,Greenfeld; Be'Eri,1,0,36,35
1656154375431,MATH 103A,A03,093561,Staff,4,0,36,32
1656154375431,MATH 103A,B01,083779,Greenfeld; Be'Eri,8,1,36,28
1656154375431,MATH 103A,B02,083780,Greenfeld; Be'Eri,1,0,36,35
1656154375431,MATH 103A,B03,093562,Staff,0,0,36,36
1656154381458,MATH 105,A01,085443,Carter; Anne Toulson,4,1,35,31
1656154381458,MATH 105,A02,093477,Staff,11,0,35,24
1656154387486,MATH 109,A01,083213,Ganzberger; Geoffrey Michael,0,0,34,34
1656154387486,MATH 109,A02,083214,Ganzberger; Geoffrey Michael,0,0,34,34
1656154387486,MATH 109,A03,093478,Staff,1,0,34,33
1656154387486,MATH 109,B01,083215,Ganzberger; Geoffrey Michael,4,0,32,28
1656154387486,MATH 109,B02,083216,Ganzberger; Geoffrey Michael,1,0,32,31
1656154387486,MATH 109,B03,093479,Staff,4,0,32,28
1656154393518,MATH 142A,A01,083219,Chow; Bennett,1,0,32,31
1656154393518,MATH 142A,A02,083220,Chow; Bennett,8,0,32,24
1656154393518,MATH 142A,A03,093480,Staff,5,0,32,27
1656154393518,MATH 142A,B03,093481,Staff,4,0,32,28
1656154393518,MATH 142A,B04,093558,Staff,6,0,32,26
1656154393518,MATH 142A,B05,093559,Staff,0,0,32,32
1656154399548,MATH 193A,A01,083224,Rotar; Vladimir,0,1,34,34
1656154399548,MATH 193A,A02,083225,Rotar; Vladimir,0,0,34,34
1656154399548,MATH 193A,A03,083781,Rotar; Vladimir,0,0,34,34
1656154399548,MATH 193A,A04,083782,Rotar; Vladimir,6,0,34,28
1656154399548,MATH 193A,A05,093482,Rotar; Vladimir,1,0,34,33
1656154405579,MATH 197,001,091859,McAuley; Julian John,9999,0,9999,0
1656154405579,MATH 197,002,095566,Kedlaya; Kiran S.,9997,0,9999,2
1656154405579,MATH 197,003,095567,Xiao; Ming,9999,0,9999,0
1656154405579,MATH 197,004,095571,Perols; Johan Lars,9998,0,9999,1
1656154412649,COGS 9,A01,083615,Shannon; Kyle Michael,4,0,75,71
1656154418674,COGS 11,A01,083617,Boyle; Mary E. T.,14,0,48,34
1656154424699,COGS 13,A01,083071,Bastos; Amalia Pinkusfeld,6,0,71,65
1656154430729,COGS 14A,A01,092681,Semenuks; Arturs,4,15,100,96
1656154436759,COGS 14B,A01,083073,Cheng; Tzu-Han,7,0,63,56
1656154442784,COGS 17,A01,092677,Semenuks; Arturs,8,0,81,73
1656154448819,COGS 100,A01,083619,Allen; Michael Gordon,2,0,70,68
1656154454843,COGS 101A,A01,083621,Davis; Joshua Daniel,3,0,68,65
1656154460873,COGS 101B,A01,091572,Allen; Michael Gordon,6,0,65,59
1656154466905,COGS 101C,A01,083625,Delgado; Tania,10,0,35,25
1656154472932,COGS 107A,A01,083627,Boyle; Mary E. T.,0,0,60,60
1656154478957,COGS 118A,A01,083075,Gupta; Anjum,7,0,76,69
1656154484984,CSE 3,A50,083646,Miranda; Gregory Joseph,18,0,50,32
1656154491010,CSE 8A,A50,083650,Miranda; Gregory Joseph,3,3,56,53
1656154497039,CSE 11,A01,083080,Cao; Yingjun,1,54,40,39
1656154503070,CSE 12,A01,083652,Krause-Levy; Sophia Louisa,7,2,120,113
1656154509099,CSE 15L,A01,083654,Morris; Justin Loren,2,0,50,48
1656154509099,CSE 15L,A02,083655,Morris; Justin Loren,4,0,50,46
1656154515128,CSE 20,A01,083657,Tran; Khoa Dang,31,0,80,49
1656154521152,CSE 21,A01,095574,Bach; Quang Tran,25,0,48,23
1656154527176,CSE 30,A01,083084,Eldon; John,2,8,80,78
1656154527176,CSE 30,B01,095061,Bhaskar; Nishant,1,2,50,49
1656154533203,CSE 100,A01,083659,Cao; Yingjun,2,20,70,68
1656154539243,CSE 134B,A01,083661,Powell; Thomas Allan,3,0,100,97
1656154545268,CSE 140,A01,083663,Gungor; Onat,9,0,85,76
1656154551295,CSE 140L,A01,083088,Eldon; John,8,0,100,92
1656154557323,CSE 175,A01,083665,Kumar; Rakesh,0,0,25,25
1656154563356,CSE 190,A00,092507,Dubnov; Shlomo,3,0,20,17
1656154569386,ECE 45,A01,083139,Congero; Spencer William,1,0,75,74
1656154575418,ECE 65,A50,083695,Saad; Andrew S,8,0,30,22
1656154575418,ECE 65,A51,095125,Staff,23,0,26,3
1656154581443,ECE 109,A01,091882,Touri; Behrouz,0,1,70,70
1656154587472,ECE 180,A00,083140,Abi Samra; Nicholas Camill,1,0,30,29
1656154587472,ECE 180,B00,083141,Abi Samra; Nicholas Camill,0,4,30,30
1656154593505,MATH 10A,A01,083735,Patchell; Gregory David,0,0,30,30
1656154593505,MATH 10A,A02,083736,Patchell; Gregory David,22,0,30,8
1656154593505,MATH 10A,A03,083737,Patchell; Gregory David,16,0,30,14
1656154599544,MATH 10B,A01,083207,Lim; Seonhee,0,0,34,34
1656154599544,MATH 10B,A02,083208,Lim; Seonhee,7,0,35,28
1656154599544,MATH 10B,A03,093472,Staff,1,0,34,33
1656154599544,MATH 10B,B01,083739,Sinha; Shubham,10,0,30,20
1656154605573,MATH 18,A01,083743,Cinel; Cameron Alexander,7,0,30,23
1656154605573,MATH 18,A02,083744,Cinel; Cameron Alexander,10,0,30,20
1656154605573,MATH 18,A03,083745,Cinel; Cameron Alexander,4,0,30,26
1656154605573,MATH 18,B01,083748,Rideout; David Porter,0,0,36,36
1656154605573,MATH 18,B02,083749,Rideout; David Porter,0,0,36,36
1656154605573,MATH 18,B03,083750,Rideout; David Porter,0,0,36,36
1656154605573,MATH 18,B04,083751,Rideout; David Porter,0,0,36,36
1656154605573,MATH 18,B05,093473,Rideout; David Porter,1,0,36,35
1656154605573,MATH 18,B06,093474,Rideout; David Porter,4,0,36,32
1656154611598,MATH 20A,A01,083754,Zheng; Zequn,11,0,40,29
1656154617623,MATH 20B,A01,083756,Briones; Jor-el Thomas Caparas,0,0,36,36
1656154617623,MATH 20B,A02,083757,Briones; Jor-el Thomas Caparas,0,0,36,36
1656154617623,MATH 20B,A03,093475,Staff,2,0,36,34
1656154623658,MATH 20C,A01,083760,Briones; Jor-el Thomas Caparas,0,0,35,35
1656154623658,MATH 20C,A02,083761,Briones; Jor-el Thomas Caparas,9,1,35,26
1656154623658,MATH 20C,A03,093476,Staff,0,0,35,35
1656154623658,MATH 20C,B01,083762,Bach; Quang Tran,1,0,30,29
1656154629683,MATH 20D,A01,083765,Tran; Brian Kha,2,0,30,28
1656154629683,MATH 20D,A02,083766,Tran; Brian Kha,0,1,30,30
1656154629683,MATH 20D,A03,083767,Tran; Brian Kha,2,0,30,28
1656154635712,MATH 20E,A01,083771,Ganguly; Soumya,4,0,32,28
1656154635712,MATH 20E,A02,083772,Ganguly; Soumya,0,0,32,32
1656154635712,MATH 20E,B01,083773,Ciotti; Benjamin,15,0,35,20
1656154635712,MATH 20E,B02,083774,Ciotti; Benjamin,15,0,35,20
1656154641747,MATH 103A,A01,083777,Greenfeld; Be'Eri,1,0,36,35
1656154641747,MATH 103A,A02,083778,Greenfeld; Be'Eri,1,0,36,35
1656154641747,MATH 103A,A03,093561,Staff,4,0,36,32
1656154641747,MATH 103A,B01,083779,Greenfeld; Be'Eri,8,1,36,28
1656154641747,MATH 103A,B02,083780,Greenfeld; Be'Eri,1,0,36,35
1656154641747,MATH 103A,B03,093562,Staff,0,0,36,36
1656154647808,MATH 105,A01,085443,Carter; Anne Toulson,4,1,35,31
1656154647808,MATH 105,A02,093477,Staff,11,0,35,24
1656154653834,MATH 109,A01,083213,Ganzberger; Geoffrey Michael,0,0,34,34
1656154653834,MATH 109,A02,083214,Ganzberger; Geoffrey Michael,0,0,34,34
1656154653834,MATH 109,A03,093478,Staff,1,0,34,33
1656154653834,MATH 109,B01,083215,Ganzberger; Geoffrey Michael,4,0,32,28
1656154653834,MATH 109,B02,083216,Ganzberger; Geoffrey Michael,1,0,32,31
1656154653834,MATH 109,B03,093479,Staff,4,0,32,28
1656154659863,MATH 142A,A01,083219,Chow; Bennett,1,0,32,31
1656154659863,MATH 142A,A02,083220,Chow; Bennett,8,0,32,24
1656154659863,MATH 142A,A03,093480,Staff,5,0,32,27
1656154659863,MATH 142A,B03,093481,Staff,4,0,32,28
1656154659863,MATH 142A,B04,093558,Staff,6,0,32,26
1656154659863,MATH 142A,B05,093559,Staff,0,0,32,32
1656154665897,MATH 193A,A01,083224,Rotar; Vladimir,0,1,34,34
1656154665897,MATH 193A,A02,083225,Rotar; Vladimir,0,0,34,34
1656154665897,MATH 193A,A03,083781,Rotar; Vladimir,0,0,34,34
1656154665897,MATH 193A,A04,083782,Rotar; Vladimir,6,0,34,28
1656154665897,MATH 193A,A05,093482,Rotar; Vladimir,1,0,34,33
1656154671926,MATH 197,001,091859,McAuley; Julian John,9999,0,9999,0
1656154671926,MATH 197,002,095566,Kedlaya; Kiran S.,9997,0,9999,2
1656154671926,MATH 197,003,095567,Xiao; Ming,9999,0,9999,0
1656154671926,MATH 197,004,095571,Perols; Johan Lars,9998,0,9999,1
1656154679015,COGS 9,A01,083615,Shannon; Kyle Michael,4,0,75,71
1656154685045,COGS 11,A01,083617,Boyle; Mary E. T.,14,0,48,34
1656154691075,COGS 13,A01,083071,Bastos; Amalia Pinkusfeld,6,0,71,65
1656154697108,COGS 14A,A01,092681,Semenuks; Arturs,4,15,100,96
1656154703144,COGS 14B,A01,083073,Cheng; Tzu-Han,7,0,63,56
1656154709168,COGS 17,A01,092677,Semenuks; Arturs,8,0,81,73
1656154715191,COGS 100,A01,083619,Allen; Michael Gordon,2,0,70,68
1656154721218,COGS 101A,A01,083621,Davis; Joshua Daniel,3,0,68,65
1656154727246,COGS 101B,A01,091572,Allen; Michael Gordon,6,0,65,59
1656154733271,COGS 101C,A01,083625,Delgado; Tania,10,0,35,25
1656154739300,COGS 107A,A01,083627,Boyle; Mary E. T.,0,0,60,60
1656154745331,COGS 118A,A01,083075,Gupta; Anjum,7,0,76,69
1656154751360,CSE 3,A50,083646,Miranda; Gregory Joseph,18,0,50,32
1656154757386,CSE 8A,A50,083650,Miranda; Gregory Joseph,3,3,56,53
1656154763416,CSE 11,A01,083080,Cao; Yingjun,1,54,40,39
1656154769447,CSE 12,A01,083652,Krause-Levy; Sophia Louisa,7,2,120,113
1656154775477,CSE 15L,A01,083654,Morris; Justin Loren,2,0,50,48
1656154775477,CSE 15L,A02,083655,Morris; Justin Loren,4,0,50,46
1656154781583,CSE 20,A01,083657,Tran; Khoa Dang,31,0,80,49
1656154787613,CSE 21,A01,095574,Bach; Quang Tran,25,0,48,23
1656154793649,CSE 30,A01,083084,Eldon; John,2,8,80,78
1656154793649,CSE 30,B01,095061,Bhaskar; Nishant,1,2,50,49
1656154799676,CSE 100,A01,083659,Cao; Yingjun,2,20,70,68
1656154805702,CSE 134B,A01,083661,Powell; Thomas Allan,3,0,100,97
1656154811725,CSE 140,A01,083663,Gungor; Onat,9,0,85,76
1656154817757,CSE 140L,A01,083088,Eldon; John,8,0,100,92
1656154823788,CSE 175,A01,083665,Kumar; Rakesh,0,0,25,25
1656154829818,CSE 190,A00,092507,Dubnov; Shlomo,3,0,20,17
1656154835855,ECE 45,A01,083139,Congero; Spencer William,1,0,75,74
1656154841886,ECE 65,A50,083695,Saad; Andrew S,8,0,30,22
1656154841886,ECE 65,A51,095125,Staff,23,0,26,3
1656154847917,ECE 109,A01,091882,Touri; Behrouz,0,1,70,70
1656154853947,ECE 180,A00,083140,Abi Samra; Nicholas Camill,1,0,30,29
1656154853947,ECE 180,B00,083141,Abi Samra; Nicholas Camill,0,4,30,30
1656154859994,MATH 10A,A01,083735,Patchell; Gregory David,0,0,30,30
1656154859994,MATH 10A,A02,083736,Patchell; Gregory David,22,0,30,8
1656154859994,MATH 10A,A03,083737,Patchell; Gregory David,16,0,30,14
1656154866031,MATH 10B,A01,083207,Lim; Seonhee,0,0,34,34
1656154866031,MATH 10B,A02,083208,Lim; Seonhee,7,0,35,28
1656154866031,MATH 10B,A03,093472,Staff,1,0,34,33
1656154866031,MATH 10B,B01,083739,Sinha; Shubham,10,0,30,20
1656154872072,MATH 18,A01,083743,Cinel; Cameron Alexander,7,0,30,23
1656154872072,MATH 18,A02,083744,Cinel; Cameron Alexander,10,0,30,20
1656154872072,MATH 18,A03,083745,Cinel; Cameron Alexander,4,0,30,26
1656154872072,MATH 18,B01,083748,Rideout; David Porter,0,0,36,36
1656154872072,MATH 18,B02,083749,Rideout; David Porter,0,0,36,36
1656154872072,MATH 18,B03,083750,Rideout; David Porter,0,0,36,36
1656154872072,MATH 18,B04,083751,Rideout; David Porter,0,0,36,36
1656154872072,MATH 18,B05,093473,Rideout; David Porter,1,0,36,35
1656154872072,MATH 18,B06,093474,Rideout; David Porter,4,0,36,32
1656154878097,MATH 20A,A01,083754,Zheng; Zequn,11,0,40,29
1656154884127,MATH 20B,A01,083756,Briones; Jor-el Thomas Caparas,0,0,36,36
1656154884127,MATH 20B,A02,083757,Briones; Jor-el Thomas Caparas,0,0,36,36
1656154884127,MATH 20B,A03,093475,Staff,2,0,36,34
1656154890161,MATH 20C,A01,083760,Briones; Jor-el Thomas Caparas,0,0,35,35
1656154890161,MATH 20C,A02,083761,Briones; Jor-el Thomas Caparas,9,1,35,26
1656154890161,MATH 20C,A03,093476,Staff,0,0,35,35
1656154890161,MATH 20C,B01,083762,Bach; Quang Tran,1,0,30,29
1656154896209,MATH 20D,A01,083765,Tran; Brian Kha,2,0,30,28
1656154896209,MATH 20D,A02,083766,Tran; Brian Kha,0,1,30,30
1656154896209,MATH 20D,A03,083767,Tran; Brian Kha,2,0,30,28
1656154902235,MATH 20E,A01,083771,Ganguly; Soumya,4,0,32,28
1656154902235,MATH 20E,A02,083772,Ganguly; Soumya,0,0,32,32
1656154902235,MATH 20E,B01,083773,Ciotti; Benjamin,15,0,35,20
1656154902235,MATH 20E,B02,083774,Ciotti; Benjamin,15,0,35,20
1656154908272,MATH 103A,A01,083777,Greenfeld; Be'Eri,1,0,36,35
1656154908272,MATH 103A,A02,083778,Greenfeld; Be'Eri,1,0,36,35
1656154908272,MATH 103A,A03,093561,Staff,4,0,36,32
1656154908272,MATH 103A,B01,083779,Greenfeld; Be'Eri,8,1,36,28
1656154908272,MATH 103A,B02,083780,Greenfeld; Be'Eri,1,0,36,35
1656154908272,MATH 103A,B03,093562,Staff,0,0,36,36
1656154914298,MATH 105,A01,085443,Carter; Anne Toulson,5,1,35,30
1656154914298,MATH 105,A02,093477,Staff,11,0,35,24
1656154920323,MATH 109,A01,083213,Ganzberger; Geoffrey Michael,0,0,34,34
1656154920323,MATH 109,A02,083214,Ganzberger; Geoffrey Michael,0,0,34,34
1656154920323,MATH 109,A03,093478,Staff,1,0,34,33
1656154920323,MATH 109,B01,083215,Ganzberger; Geoffrey Michael,4,0,32,28
1656154920323,MATH 109,B02,083216,Ganzberger; Geoffrey Michael,1,0,32,31
1656154920323,MATH 109,B03,093479,Staff,4,0,32,28
1656154926358,MATH 142A,A01,083219,Chow; Bennett,1,0,32,31
1656154926358,MATH 142A,A02,083220,Chow; Bennett,8,0,32,24
1656154926358,MATH 142A,A03,093480,Staff,5,0,32,27
1656154926358,MATH 142A,B03,093481,Staff,4,0,32,28
1656154926358,MATH 142A,B04,093558,Staff,6,0,32,26
1656154926358,MATH 142A,B05,093559,Staff,0,0,32,32
1656154932384,MATH 193A,A01,083224,Rotar; Vladimir,0,1,34,34
1656154932384,MATH 193A,A02,083225,Rotar; Vladimir,0,0,34,34
1656154932384,MATH 193A,A03,083781,Rotar; Vladimir,0,0,34,34
1656154932384,MATH 193A,A04,083782,Rotar; Vladimir,6,0,34,28
1656154932384,MATH 193A,A05,093482,Rotar; Vladimir,1,0,34,33
1656154938410,MATH 197,001,091859,McAuley; Julian John,9999,0,9999,0
1656154938410,MATH 197,002,095566,Kedlaya; Kiran S.,9997,0,9999,2
1656154938410,MATH 197,003,095567,Xiao; Ming,9999,0,9999,0
1656154938410,MATH 197,004,095571,Perols; Johan Lars,9998,0,9999,1
1656154945484,COGS 9,A01,083615,Shannon; Kyle Michael,4,0,75,71
1656154951505,COGS 11,A01,083617,Boyle; Mary E. T.,14,0,48,34
1656154957529,COGS 13,A01,083071,Bastos; Amalia Pinkusfeld,6,0,71,65
1656154963553,COGS 14A,A01,092681,Semenuks; Arturs,4,15,100,96
1656154969577,COGS 14B,A01,083073,Cheng; Tzu-Han,7,0,63,56
1656154975600,COGS 17,A01,092677,Semenuks; Arturs,8,0,81,73
1656154981626,COGS 100,A01,083619,Allen; Michael Gordon,2,0,70,68
1656154987662,COGS 101A,A01,083621,Davis; Joshua Daniel,3,0,68,65
1656154993690,COGS 101B,A01,091572,Allen; Michael Gordon,6,0,65,59
1656154999719,COGS 101C,A01,083625,Delgado; Tania,10,0,35,25
1656155005743,COGS 107A,A01,083627,Boyle; Mary E. T.,0,0,60,60
1656155011767,COGS 118A,A01,083075,Gupta; Anjum,7,0,76,69
1656155017793,CSE 3,A50,083646,Miranda; Gregory Joseph,18,0,50,32
1656155023891,CSE 8A,A50,083650,Miranda; Gregory Joseph,3,3,56,53
1656155029922,CSE 11,A01,083080,Cao; Yingjun,1,54,40,39
1656155035948,CSE 12,A01,083652,Krause-Levy; Sophia Louisa,7,2,120,113
1656155041979,CSE 15L,A01,083654,Morris; Justin Loren,2,0,50,48
1656155041979,CSE 15L,A02,083655,Morris; Justin Loren,4,0,50,46
1656155048008,CSE 20,A01,083657,Tran; Khoa Dang,31,0,80,49
1656155054035,CSE 21,A01,095574,Bach; Quang Tran,25,0,48,23
1656155060073,CSE 30,A01,083084,Eldon; John,2,8,80,78
1656155060073,CSE 30,B01,095061,Bhaskar; Nishant,1,2,50,49
1656155066111,CSE 100,A01,083659,Cao; Yingjun,2,20,70,68
1656155072137,CSE 134B,A01,083661,Powell; Thomas Allan,3,0,100,97
1656155078164,CSE 140,A01,083663,Gungor; Onat,9,0,85,76
1656155084187,CSE 140L,A01,083088,Eldon; John,8,0,100,92
1656155090219,CSE 175,A01,083665,Kumar; Rakesh,0,0,25,25
1656155096245,CSE 190,A00,092507,Dubnov; Shlomo,3,0,20,17
1656155102282,ECE 45,A01,083139,Congero; Spencer William,1,0,75,74
1656155108311,ECE 65,A50,083695,Saad; Andrew S,8,0,30,22
1656155108311,ECE 65,A51,095125,Staff,23,0,26,3
1656155114341,ECE 109,A01,091882,Touri; Behrouz,0,1,70,70
1656155120366,ECE 180,A00,083140,Abi Samra; Nicholas Camill,1,0,30,29
1656155120366,ECE 180,B00,083141,Abi Samra; Nicholas Camill,0,4,30,30
1656155126399,MATH 10A,A01,083735,Patchell; Gregory David,0,0,30,30
1656155126399,MATH 10A,A02,083736,Patchell; Gregory David,22,0,30,8
1656155126399,MATH 10A,A03,083737,Patchell; Gregory David,16,0,30,14
1656155132430,MATH 10B,A01,083207,Lim; Seonhee,0,0,34,34
1656155132430,MATH 10B,A02,083208,Lim; Seonhee,7,0,35,28
1656155132430,MATH 10B,A03,093472,Staff,1,0,34,33
1656155132430,MATH 10B,B01,083739,Sinha; Shubham,10,0,30,20
