time,subj_course_id,sec_code,sec_id,prof,available,waitlist,total,enrolled_ct
1650182892468,COGS 9,A01,083615,Staff,0,14,60,60
1650182898496,COGS 11,A01,083617,Boyle; Mary E. T.,24,0,40,16
1650182904524,COGS 13,A01,083071,Staff,0,30,40,40
1650182910550,COGS 14A,A01,092681,Staff,0,12,100,100
1650182916575,COGS 14B,A01,083073,Cheng; Tzu-Han,0,7,50,50
1650182922599,COGS 17,A01,092677,Staff,34,0,75,41
1650182928622,COGS 100,A01,083619,Staff,0,20,60,60
1650182934647,COGS 101A,A01,083621,Davis; Joshua Daniel,0,21,60,60
1650182940676,COGS 101B,A01,091572,Staff,6,0,60,54
1650182946703,COGS 101C,A01,083625,Delgado; Tania,20,0,30,10
1650182952727,COGS 107A,A01,083627,Boyle; Mary E. T.,0,7,60,60
1650182958749,COGS 118A,A01,083075,Staff,16,0,60,44
1650182964776,CSE 3,A50,083646,Miranda; Gregory Joseph,22,0,38,16
1650182964776,CSE 3,A51,083647,Miranda; Gregory Joseph,37,0,37,0
1650182970799,CSE 8A,A50,083650,Miranda; Gregory Joseph,0,17,40,40
1650182976828,CSE 11,A01,083080,Cao; Yingjun,0,68,40,40
1650182982852,CSE 12,A01,083652,Staff,0,5,100,100
1650182988876,CSE 15L,A01,083654,Staff,0,0,50,50
1650182988876,CSE 15L,A02,083655,Staff,8,0,50,42
1650182994903,CSE 20,A01,083657,Staff,53,0,80,27
1650183000927,CSE 30,A01,083084,Eldon; John,0,67,40,40
1650183006952,CSE 100,A01,083659,Cao; Yingjun,0,63,50,50
1650183012980,CSE 134B,A01,083661,Powell; Thomas Allan,0,27,65,65
1650183019004,CSE 140,A01,083663,Staff,1,0,75,74
1650183025032,CSE 140L,A01,083088,Eldon; John,0,4,75,75
1650183031056,CSE 175,A01,083665,Kumar; Rakesh,8,0,25,17
1650183037083,CSE 190,A00,092507,Dubnov; Shlomo,14,0,20,6
1650183043108,ECE 45,A01,083139,Staff,0,13,40,40
1650183049133,ECE 65,A50,083695,Staff,0,5,30,30
1650183055156,ECE 109,A01,091882,Touri; Behrouz,47,0,70,23
1650183061181,ECE 180,A00,083140,Abi Samra; Nicholas Camill,24,0,30,6
1650183061181,ECE 180,B00,083141,Abi Samra; Nicholas Camill,8,0,30,22
1650183067209,MATH 10A,A01,083735,Patchell; Gregory David,11,0,30,19
1650183067209,MATH 10A,A02,083736,Patchell; Gregory David,28,0,30,2
1650183067209,MATH 10A,A03,083737,Patchell; Gregory David,26,0,30,4
1650183073235,MATH 10B,A01,083207,Staff,0,5,30,30
1650183073235,MATH 10B,A02,083208,Staff,0,5,30,30
1650183073235,MATH 10B,B01,083739,Staff,17,0,30,13
1650183073235,MATH 10B,B02,083740,Staff,29,0,30,1
1650183079269,MATH 18,A01,083743,Staff,10,0,30,20
1650183079269,MATH 18,A02,083744,Staff,28,0,30,2
1650183079269,MATH 18,A03,083745,Staff,23,0,30,7
1650183079269,MATH 18,A04,083746,Staff,27,0,30,3
1650183079269,MATH 18,B01,083748,Staff,0,10,30,30
1650183079269,MATH 18,B02,083749,Staff,0,7,30,30
1650183079269,MATH 18,B03,083750,Staff,0,7,30,30
1650183079269,MATH 18,B04,083751,Staff,0,7,30,30
1650183085294,MATH 20A,A01,083754,Staff,26,0,40,14
1650183091320,MATH 20B,A01,083756,Staff,0,6,30,30
1650183091320,MATH 20B,A02,083757,Staff,0,5,30,30
1650183097355,MATH 20C,A01,083760,Staff,0,12,30,30
1650183097355,MATH 20C,A02,083761,Staff,0,12,30,30
1650183097355,MATH 20C,B01,083762,Staff,14,0,30,16
1650183097355,MATH 20C,B02,083763,Staff,28,0,30,2
1650183103380,MATH 20D,A01,083765,Staff,1,2,30,29
1650183103380,MATH 20D,A02,083766,Staff,10,0,30,20
1650183103380,MATH 20D,A03,083767,Staff,28,0,30,2
1650183109408,MATH 20E,A01,083771,Staff,8,0,30,22
1650183109408,MATH 20E,A02,083772,Staff,20,0,30,10
1650183109408,MATH 20E,B01,083773,Staff,0,0,30,30
1650183109408,MATH 20E,B02,083774,Staff,12,0,30,18
1650183115432,MATH 103A,A01,083777,Staff,0,9,30,30
1650183115432,MATH 103A,A02,083778,Staff,0,10,30,30
1650183115432,MATH 103A,B01,083779,Staff,0,9,30,30
1650183115432,MATH 103A,B02,083780,Staff,0,9,30,30
1650183121455,MATH 105,A01,085443,Staff,0,17,30,30
1650183127493,MATH 109,A01,083213,Anzaldo; Leesa B,0,3,30,30
1650183127493,MATH 109,A02,083214,Anzaldo; Leesa B,0,6,30,30
1650183127493,MATH 109,B01,083215,Anzaldo; Leesa B,0,4,30,30
1650183127493,MATH 109,B02,083216,Anzaldo; Leesa B,0,4,30,30
1650183133521,MATH 142A,A01,083219,Chow; Bennett,0,12,30,30
1650183133521,MATH 142A,A02,083220,Chow; Bennett,0,11,30,30
1650183133521,MATH 142A,B01,083221,Chow; Bennett,0,11,30,30
1650183133521,MATH 142A,B02,083222,Chow; Bennett,0,12,30,30
1650183139549,MATH 193A,A01,083224,Staff,0,4,30,30
1650183139549,MATH 193A,A02,083225,Staff,0,4,30,30
1650183139549,MATH 193A,A03,083781,Staff,0,1,30,30
1650183139549,MATH 193A,A04,083782,Staff,0,1,30,30
1650183145577,MATH 197,001,091859,McAuley; Julian John,9998,0,9999,1
1650183151630,COGS 9,A01,083615,Staff,0,14,60,60
1650183157655,COGS 11,A01,083617,Boyle; Mary E. T.,24,0,40,16
1650183163683,COGS 13,A01,083071,Staff,0,30,40,40
1650183169705,COGS 14A,A01,092681,Staff,0,12,100,100
1650183175730,COGS 14B,A01,083073,Cheng; Tzu-Han,0,7,50,50
1650183181754,COGS 17,A01,092677,Staff,34,0,75,41
1650183187778,COGS 100,A01,083619,Staff,0,20,60,60
1650183193806,COGS 101A,A01,083621,Davis; Joshua Daniel,0,21,60,60
1650183199833,COGS 101B,A01,091572,Staff,6,0,60,54
1650183205858,COGS 101C,A01,083625,Delgado; Tania,20,0,30,10
1650183211882,COGS 107A,A01,083627,Boyle; Mary E. T.,0,7,60,60
1650183217908,COGS 118A,A01,083075,Staff,16,0,60,44
1650183223933,CSE 3,A50,083646,Miranda; Gregory Joseph,22,0,38,16
1650183223933,CSE 3,A51,083647,Miranda; Gregory Joseph,37,0,37,0
1650183229955,CSE 8A,A50,083650,Miranda; Gregory Joseph,0,17,40,40
1650183235982,CSE 11,A01,083080,Cao; Yingjun,0,68,40,40
1650183242009,CSE 12,A01,083652,Staff,0,5,100,100
1650183248036,CSE 15L,A01,083654,Staff,0,0,50,50
1650183248036,CSE 15L,A02,083655,Staff,8,0,50,42
1650183254062,CSE 20,A01,083657,Staff,53,0,80,27
1650183260085,CSE 30,A01,083084,Eldon; John,0,67,40,40
1650183266110,CSE 100,A01,083659,Cao; Yingjun,0,63,50,50
1650183272136,CSE 134B,A01,083661,Powell; Thomas Allan,0,27,65,65
1650183278160,CSE 140,A01,083663,Staff,1,0,75,74
1650183284184,CSE 140L,A01,083088,Eldon; John,0,4,75,75
1650183290208,CSE 175,A01,083665,Kumar; Rakesh,8,0,25,17
1650183296236,CSE 190,A00,092507,Dubnov; Shlomo,14,0,20,6
1650183302260,ECE 45,A01,083139,Staff,0,13,40,40
1650183308286,ECE 65,A50,083695,Staff,0,5,30,30
1650183314312,ECE 109,A01,091882,Touri; Behrouz,47,0,70,23
1650183320339,ECE 180,A00,083140,Abi Samra; Nicholas Camill,24,0,30,6
1650183320339,ECE 180,B00,083141,Abi Samra; Nicholas Camill,8,0,30,22
1650183326365,MATH 10A,A01,083735,Patchell; Gregory David,11,0,30,19
1650183326365,MATH 10A,A02,083736,Patchell; Gregory David,28,0,30,2
1650183326365,MATH 10A,A03,083737,Patchell; Gregory David,26,0,30,4
1650183332396,MATH 10B,A01,083207,Staff,0,5,30,30
1650183332396,MATH 10B,A02,083208,Staff,0,5,30,30
1650183332396,MATH 10B,B01,083739,Staff,17,0,30,13
1650183332396,MATH 10B,B02,083740,Staff,29,0,30,1
1650183338422,MATH 18,A01,083743,Staff,10,0,30,20
1650183338422,MATH 18,A02,083744,Staff,28,0,30,2
1650183338422,MATH 18,A03,083745,Staff,23,0,30,7
1650183338422,MATH 18,A04,083746,Staff,27,0,30,3
1650183338422,MATH 18,B01,083748,Staff,0,10,30,30
1650183338422,MATH 18,B02,083749,Staff,0,7,30,30
1650183338422,MATH 18,B03,083750,Staff,0,7,30,30
1650183338422,MATH 18,B04,083751,Staff,0,7,30,30
1650183344447,MATH 20A,A01,083754,Staff,26,0,40,14
1650183350474,MATH 20B,A01,083756,Staff,0,6,30,30
1650183350474,MATH 20B,A02,083757,Staff,0,5,30,30
1650183356503,MATH 20C,A01,083760,Staff,0,12,30,30
1650183356503,MATH 20C,A02,083761,Staff,0,12,30,30
1650183356503,MATH 20C,B01,083762,Staff,14,0,30,16
1650183356503,MATH 20C,B02,083763,Staff,28,0,30,2
1650183362531,MATH 20D,A01,083765,Staff,1,2,30,29
1650183362531,MATH 20D,A02,083766,Staff,10,0,30,20
1650183362531,MATH 20D,A03,083767,Staff,28,0,30,2
1650183368560,MATH 20E,A01,083771,Staff,8,0,30,22
1650183368560,MATH 20E,A02,083772,Staff,20,0,30,10
1650183368560,MATH 20E,B01,083773,Staff,0,0,30,30
1650183368560,MATH 20E,B02,083774,Staff,12,0,30,18
1650183374585,MATH 103A,A01,083777,Staff,0,9,30,30
1650183374585,MATH 103A,A02,083778,Staff,0,10,30,30
1650183374585,MATH 103A,B01,083779,Staff,0,9,30,30
1650183374585,MATH 103A,B02,083780,Staff,0,9,30,30
1650183380610,MATH 105,A01,085443,Staff,0,17,30,30
1650183386635,MATH 109,A01,083213,Anzaldo; Leesa B,0,3,30,30
1650183386635,MATH 109,A02,083214,Anzaldo; Leesa B,0,6,30,30
1650183386635,MATH 109,B01,083215,Anzaldo; Leesa B,0,4,30,30
1650183386635,MATH 109,B02,083216,Anzaldo; Leesa B,0,4,30,30
1650183392665,MATH 142A,A01,083219,Chow; Bennett,0,12,30,30
1650183392665,MATH 142A,A02,083220,Chow; Bennett,0,11,30,30
1650183392665,MATH 142A,B01,083221,Chow; Bennett,0,11,30,30
1650183392665,MATH 142A,B02,083222,Chow; Bennett,0,12,30,30
1650183398702,MATH 193A,A01,083224,Staff,0,4,30,30
1650183398702,MATH 193A,A02,083225,Staff,0,4,30,30
1650183398702,MATH 193A,A03,083781,Staff,0,1,30,30
1650183398702,MATH 193A,A04,083782,Staff,0,1,30,30
1650183404727,MATH 197,001,091859,McAuley; Julian John,9998,0,9999,1
1650183410786,COGS 9,A01,083615,Staff,0,14,60,60
1650183416810,COGS 11,A01,083617,Boyle; Mary E. T.,24,0,40,16
1650183422836,COGS 13,A01,083071,Staff,0,30,40,40
1650183428864,COGS 14A,A01,092681,Staff,0,12,100,100
1650183434892,COGS 14B,A01,083073,Cheng; Tzu-Han,0,7,50,50
1650183440916,COGS 17,A01,092677,Staff,34,0,75,41
1650183446950,COGS 100,A01,083619,Staff,0,20,60,60
1650183452978,COGS 101A,A01,083621,Davis; Joshua Daniel,0,21,60,60
1650183459003,COGS 101B,A01,091572,Staff,6,0,60,54
1650183465125,COGS 101C,A01,083625,Delgado; Tania,20,0,30,10
1650183471150,COGS 107A,A01,083627,Boyle; Mary E. T.,0,7,60,60
1650183477175,COGS 118A,A01,083075,Staff,16,0,60,44
1650183483204,CSE 3,A50,083646,Miranda; Gregory Joseph,22,0,38,16
1650183483204,CSE 3,A51,083647,Miranda; Gregory Joseph,37,0,37,0
1650183489229,CSE 8A,A50,083650,Miranda; Gregory Joseph,0,17,40,40
1650183495257,CSE 11,A01,083080,Cao; Yingjun,0,68,40,40
1650183501283,CSE 12,A01,083652,Staff,0,5,100,100
1650183507315,CSE 15L,A01,083654,Staff,0,0,50,50
1650183507315,CSE 15L,A02,083655,Staff,8,0,50,42
1650183513343,CSE 20,A01,083657,Staff,53,0,80,27
1650183519369,CSE 30,A01,083084,Eldon; John,0,67,40,40
1650183525397,CSE 100,A01,083659,Cao; Yingjun,0,63,50,50
1650183531421,CSE 134B,A01,083661,Powell; Thomas Allan,0,27,65,65
1650183537446,CSE 140,A01,083663,Staff,1,0,75,74
1650183543470,CSE 140L,A01,083088,Eldon; John,0,4,75,75
1650183549491,CSE 175,A01,083665,Kumar; Rakesh,8,0,25,17
1650183555519,CSE 190,A00,092507,Dubnov; Shlomo,14,0,20,6
1650183561554,ECE 45,A01,083139,Staff,0,13,40,40
1650183567579,ECE 65,A50,083695,Staff,0,5,30,30
1650183573602,ECE 109,A01,091882,Touri; Behrouz,47,0,70,23
1650183579629,ECE 180,A00,083140,Abi Samra; Nicholas Camill,24,0,30,6
1650183579629,ECE 180,B00,083141,Abi Samra; Nicholas Camill,8,0,30,22
1650183585653,MATH 10A,A01,083735,Patchell; Gregory David,11,0,30,19
1650183585653,MATH 10A,A02,083736,Patchell; Gregory David,28,0,30,2
1650183585653,MATH 10A,A03,083737,Patchell; Gregory David,26,0,30,4
1650183591677,MATH 10B,A01,083207,Staff,0,5,30,30
1650183591677,MATH 10B,A02,083208,Staff,0,5,30,30
1650183591677,MATH 10B,B01,083739,Staff,17,0,30,13
1650183591677,MATH 10B,B02,083740,Staff,29,0,30,1
1650183597703,MATH 18,A01,083743,Staff,10,0,30,20
1650183597703,MATH 18,A02,083744,Staff,28,0,30,2
1650183597703,MATH 18,A03,083745,Staff,23,0,30,7
1650183597703,MATH 18,A04,083746,Staff,27,0,30,3
1650183597703,MATH 18,B01,083748,Staff,0,10,30,30
1650183597703,MATH 18,B02,083749,Staff,0,7,30,30
1650183597703,MATH 18,B03,083750,Staff,0,7,30,30
1650183597703,MATH 18,B04,083751,Staff,0,7,30,30
1650183603730,MATH 20A,A01,083754,Staff,26,0,40,14
1650183609753,MATH 20B,A01,083756,Staff,0,6,30,30
1650183609753,MATH 20B,A02,083757,Staff,0,5,30,30
1650183615779,MATH 20C,A01,083760,Staff,0,12,30,30
1650183615779,MATH 20C,A02,083761,Staff,0,12,30,30
1650183615779,MATH 20C,B01,083762,Staff,14,0,30,16
1650183615779,MATH 20C,B02,083763,Staff,28,0,30,2
1650183621803,MATH 20D,A01,083765,Staff,1,2,30,29
1650183621803,MATH 20D,A02,083766,Staff,10,0,30,20
1650183621803,MATH 20D,A03,083767,Staff,28,0,30,2
1650183627827,MATH 20E,A01,083771,Staff,8,0,30,22
1650183627827,MATH 20E,A02,083772,Staff,20,0,30,10
1650183627827,MATH 20E,B01,083773,Staff,0,0,30,30
1650183627827,MATH 20E,B02,083774,Staff,12,0,30,18
1650183633852,MATH 103A,A01,083777,Staff,0,9,30,30
1650183633852,MATH 103A,A02,083778,Staff,0,10,30,30
1650183633852,MATH 103A,B01,083779,Staff,0,9,30,30
1650183633852,MATH 103A,B02,083780,Staff,0,9,30,30
1650183639877,MATH 105,A01,085443,Staff,0,17,30,30
1650183645903,MATH 109,A01,083213,Anzaldo; Leesa B,0,3,30,30
1650183645903,MATH 109,A02,083214,Anzaldo; Leesa B,0,6,30,30
1650183645903,MATH 109,B01,083215,Anzaldo; Leesa B,0,4,30,30
1650183645903,MATH 109,B02,083216,Anzaldo; Leesa B,0,4,30,30
1650183651927,MATH 142A,A01,083219,Chow; Bennett,0,12,30,30
1650183651927,MATH 142A,A02,083220,Chow; Bennett,0,11,30,30
1650183651927,MATH 142A,B01,083221,Chow; Bennett,0,11,30,30
1650183651927,MATH 142A,B02,083222,Chow; Bennett,0,12,30,30
1650183657955,MATH 193A,A01,083224,Staff,0,4,30,30
1650183657955,MATH 193A,A02,083225,Staff,0,4,30,30
1650183657955,MATH 193A,A03,083781,Staff,0,1,30,30
1650183657955,MATH 193A,A04,083782,Staff,0,1,30,30
1650183663978,MATH 197,001,091859,McAuley; Julian John,9998,0,9999,1
1650183670030,COGS 9,A01,083615,Staff,0,14,60,60
1650183676056,COGS 11,A01,083617,Boyle; Mary E. T.,24,0,40,16
1650183682083,COGS 13,A01,083071,Staff,0,30,40,40
1650183688106,COGS 14A,A01,092681,Staff,0,12,100,100
1650183694138,COGS 14B,A01,083073,Cheng; Tzu-Han,0,7,50,50
1650183700165,COGS 17,A01,092677,Staff,34,0,75,41
1650183706191,COGS 100,A01,083619,Staff,0,20,60,60
1650183712216,COGS 101A,A01,083621,Davis; Joshua Daniel,0,21,60,60
1650183718240,COGS 101B,A01,091572,Staff,6,0,60,54
1650183724268,COGS 101C,A01,083625,Delgado; Tania,20,0,30,10
1650183730292,COGS 107A,A01,083627,Boyle; Mary E. T.,0,7,60,60
1650183736320,COGS 118A,A01,083075,Staff,16,0,60,44
1650183742352,CSE 3,A50,083646,Miranda; Gregory Joseph,22,0,38,16
1650183742352,CSE 3,A51,083647,Miranda; Gregory Joseph,37,0,37,0
1650183748376,CSE 8A,A50,083650,Miranda; Gregory Joseph,0,17,40,40
1650183754408,CSE 11,A01,083080,Cao; Yingjun,0,68,40,40
1650183760432,CSE 12,A01,083652,Staff,0,5,100,100
1650183766459,CSE 15L,A01,083654,Staff,0,0,50,50
1650183766459,CSE 15L,A02,083655,Staff,8,0,50,42
1650183772502,CSE 20,A01,083657,Staff,53,0,80,27
1650183778554,CSE 30,A01,083084,Eldon; John,0,67,40,40
1650183784585,CSE 100,A01,083659,Cao; Yingjun,0,63,50,50
1650183790613,CSE 134B,A01,083661,Powell; Thomas Allan,0,27,65,65
1650183796640,CSE 140,A01,083663,Staff,1,0,75,74
1650183802680,CSE 140L,A01,083088,Eldon; John,0,4,75,75
1650183808703,CSE 175,A01,083665,Kumar; Rakesh,8,0,25,17
1650183814733,CSE 190,A00,092507,Dubnov; Shlomo,14,0,20,6
1650183820762,ECE 45,A01,083139,Staff,0,13,40,40
1650183826789,ECE 65,A50,083695,Staff,0,5,30,30
1650183832819,ECE 109,A01,091882,Touri; Behrouz,47,0,70,23
1650183838849,ECE 180,A00,083140,Abi Samra; Nicholas Camill,24,0,30,6
1650183838849,ECE 180,B00,083141,Abi Samra; Nicholas Camill,8,0,30,22
1650183844878,MATH 10A,A01,083735,Patchell; Gregory David,11,0,30,19
1650183844878,MATH 10A,A02,083736,Patchell; Gregory David,28,0,30,2
1650183844878,MATH 10A,A03,083737,Patchell; Gregory David,26,0,30,4
1650183850904,MATH 10B,A01,083207,Staff,0,5,30,30
1650183850904,MATH 10B,A02,083208,Staff,0,5,30,30
1650183850904,MATH 10B,B01,083739,Staff,17,0,30,13
1650183850904,MATH 10B,B02,083740,Staff,29,0,30,1
1650183856933,MATH 18,A01,083743,Staff,10,0,30,20
1650183856933,MATH 18,A02,083744,Staff,28,0,30,2
1650183856933,MATH 18,A03,083745,Staff,23,0,30,7
1650183856933,MATH 18,A04,083746,Staff,27,0,30,3
1650183856933,MATH 18,B01,083748,Staff,0,10,30,30
1650183856933,MATH 18,B02,083749,Staff,0,7,30,30
1650183856933,MATH 18,B03,083750,Staff,0,7,30,30
1650183856933,MATH 18,B04,083751,Staff,0,7,30,30
1650183862958,MATH 20A,A01,083754,Staff,26,0,40,14
1650183868987,MATH 20B,A01,083756,Staff,0,6,30,30
1650183868987,MATH 20B,A02,083757,Staff,0,5,30,30
1650183875011,MATH 20C,A01,083760,Staff,0,12,30,30
1650183875011,MATH 20C,A02,083761,Staff,0,12,30,30
1650183875011,MATH 20C,B01,083762,Staff,14,0,30,16
1650183875011,MATH 20C,B02,083763,Staff,28,0,30,2
1650183881038,MATH 20D,A01,083765,Staff,1,2,30,29
1650183881038,MATH 20D,A02,083766,Staff,10,0,30,20
1650183881038,MATH 20D,A03,083767,Staff,28,0,30,2
1650183887063,MATH 20E,A01,083771,Staff,8,0,30,22
1650183887063,MATH 20E,A02,083772,Staff,20,0,30,10
1650183887063,MATH 20E,B01,083773,Staff,0,0,30,30
1650183887063,MATH 20E,B02,083774,Staff,12,0,30,18
1650183893087,MATH 103A,A01,083777,Staff,0,9,30,30
1650183893087,MATH 103A,A02,083778,Staff,0,10,30,30
1650183893087,MATH 103A,B01,083779,Staff,0,9,30,30
1650183893087,MATH 103A,B02,083780,Staff,0,9,30,30
1650183899110,MATH 105,A01,085443,Staff,0,17,30,30
1650183905140,MATH 109,A01,083213,Anzaldo; Leesa B,0,3,30,30
1650183905140,MATH 109,A02,083214,Anzaldo; Leesa B,0,6,30,30
1650183905140,MATH 109,B01,083215,Anzaldo; Leesa B,0,4,30,30
1650183905140,MATH 109,B02,083216,Anzaldo; Leesa B,0,4,30,30
1650183911169,MATH 142A,A01,083219,Chow; Bennett,0,12,30,30
1650183911169,MATH 142A,A02,083220,Chow; Bennett,0,11,30,30
1650183911169,MATH 142A,B01,083221,Chow; Bennett,0,11,30,30
1650183911169,MATH 142A,B02,083222,Chow; Bennett,0,12,30,30
1650183917195,MATH 193A,A01,083224,Staff,0,4,30,30
1650183917195,MATH 193A,A02,083225,Staff,0,4,30,30
1650183917195,MATH 193A,A03,083781,Staff,0,1,30,30
1650183917195,MATH 193A,A04,083782,Staff,0,1,30,30
1650183923220,MATH 197,001,091859,McAuley; Julian John,9998,0,9999,1
1650183929293,COGS 9,A01,083615,Staff,0,14,60,60
1650183935320,COGS 11,A01,083617,Boyle; Mary E. T.,24,0,40,16
1650183941347,COGS 13,A01,083071,Staff,0,30,40,40
1650183947372,COGS 14A,A01,092681,Staff,0,12,100,100
1650183953396,COGS 14B,A01,083073,Cheng; Tzu-Han,0,7,50,50
1650183959419,COGS 17,A01,092677,Staff,34,0,75,41
1650183965444,COGS 100,A01,083619,Staff,0,20,60,60
1650183971473,COGS 101A,A01,083621,Davis; Joshua Daniel,0,21,60,60
1650183977498,COGS 101B,A01,091572,Staff,6,0,60,54
1650183983523,COGS 101C,A01,083625,Delgado; Tania,20,0,30,10
1650183989551,COGS 107A,A01,083627,Boyle; Mary E. T.,0,7,60,60
1650183995575,COGS 118A,A01,083075,Staff,16,0,60,44
1650184001607,CSE 3,A50,083646,Miranda; Gregory Joseph,22,0,38,16
1650184001607,CSE 3,A51,083647,Miranda; Gregory Joseph,37,0,37,0
1650184007635,CSE 8A,A50,083650,Miranda; Gregory Joseph,0,17,40,40
1650184013657,CSE 11,A01,083080,Cao; Yingjun,0,68,40,40
1650184019685,CSE 12,A01,083652,Staff,0,5,100,100
1650184025709,CSE 15L,A01,083654,Staff,0,0,50,50
1650184025709,CSE 15L,A02,083655,Staff,8,0,50,42
1650184031737,CSE 20,A01,083657,Staff,53,0,80,27
1650184037766,CSE 30,A01,083084,Eldon; John,0,67,40,40
1650184043792,CSE 100,A01,083659,Cao; Yingjun,0,63,50,50
1650184049832,CSE 134B,A01,083661,Powell; Thomas Allan,0,27,65,65
1650184055856,CSE 140,A01,083663,Staff,1,0,75,74
1650184061969,CSE 140L,A01,083088,Eldon; John,0,4,75,75
1650184067997,CSE 175,A01,083665,Kumar; Rakesh,8,0,25,17
1650184074030,CSE 190,A00,092507,Dubnov; Shlomo,14,0,20,6
1650184080055,ECE 45,A01,083139,Staff,0,13,40,40
1650184086084,ECE 65,A50,083695,Staff,0,5,30,30
1650184092110,ECE 109,A01,091882,Touri; Behrouz,47,0,70,23
1650184098135,ECE 180,A00,083140,Abi Samra; Nicholas Camill,24,0,30,6
1650184098135,ECE 180,B00,083141,Abi Samra; Nicholas Camill,8,0,30,22
1650184104169,MATH 10A,A01,083735,Patchell; Gregory David,11,0,30,19
1650184104169,MATH 10A,A02,083736,Patchell; Gregory David,28,0,30,2
1650184104169,MATH 10A,A03,083737,Patchell; Gregory David,26,0,30,4
1650184110204,MATH 10B,A01,083207,Staff,0,5,30,30
1650184110204,MATH 10B,A02,083208,Staff,0,5,30,30
1650184110204,MATH 10B,B01,083739,Staff,17,0,30,13
1650184110204,MATH 10B,B02,083740,Staff,29,0,30,1
1650184116237,MATH 18,A01,083743,Staff,10,0,30,20
1650184116237,MATH 18,A02,083744,Staff,28,0,30,2
1650184116237,MATH 18,A03,083745,Staff,23,0,30,7
1650184116237,MATH 18,A04,083746,Staff,27,0,30,3
1650184116237,MATH 18,B01,083748,Staff,0,10,30,30
1650184116237,MATH 18,B02,083749,Staff,0,7,30,30
1650184116237,MATH 18,B03,083750,Staff,0,7,30,30
1650184116237,MATH 18,B04,083751,Staff,0,7,30,30
1650184122267,MATH 20A,A01,083754,Staff,26,0,40,14
1650184128293,MATH 20B,A01,083756,Staff,0,6,30,30
1650184128293,MATH 20B,A02,083757,Staff,0,5,30,30
1650184134320,MATH 20C,A01,083760,Staff,0,12,30,30
1650184134320,MATH 20C,A02,083761,Staff,0,12,30,30
1650184134320,MATH 20C,B01,083762,Staff,14,0,30,16
1650184134320,MATH 20C,B02,083763,Staff,28,0,30,2
1650184140347,MATH 20D,A01,083765,Staff,1,2,30,29
1650184140347,MATH 20D,A02,083766,Staff,10,0,30,20
1650184140347,MATH 20D,A03,083767,Staff,28,0,30,2
1650184146378,MATH 20E,A01,083771,Staff,8,0,30,22
1650184146378,MATH 20E,A02,083772,Staff,20,0,30,10
1650184146378,MATH 20E,B01,083773,Staff,0,0,30,30
1650184146378,MATH 20E,B02,083774,Staff,12,0,30,18
1650184152403,MATH 103A,A01,083777,Staff,0,9,30,30
1650184152403,MATH 103A,A02,083778,Staff,0,10,30,30
1650184152403,MATH 103A,B01,083779,Staff,0,9,30,30
1650184152403,MATH 103A,B02,083780,Staff,0,9,30,30
1650184158441,MATH 105,A01,085443,Staff,0,17,30,30
1650184164471,MATH 109,A01,083213,Anzaldo; Leesa B,0,3,30,30
1650184164471,MATH 109,A02,083214,Anzaldo; Leesa B,0,6,30,30
1650184164471,MATH 109,B01,083215,Anzaldo; Leesa B,0,4,30,30
1650184164471,MATH 109,B02,083216,Anzaldo; Leesa B,0,4,30,30
1650184170502,MATH 142A,A01,083219,Chow; Bennett,0,12,30,30
1650184170502,MATH 142A,A02,083220,Chow; Bennett,0,11,30,30
1650184170502,MATH 142A,B01,083221,Chow; Bennett,0,11,30,30
1650184170502,MATH 142A,B02,083222,Chow; Bennett,0,12,30,30
1650184176525,MATH 193A,A01,083224,Staff,0,4,30,30
1650184176525,MATH 193A,A02,083225,Staff,0,4,30,30
1650184176525,MATH 193A,A03,083781,Staff,0,1,30,30
1650184176525,MATH 193A,A04,083782,Staff,0,1,30,30
1650184182551,MATH 197,001,091859,McAuley; Julian John,9998,0,9999,1
1650184188617,COGS 9,A01,083615,Staff,0,14,60,60
1650184194640,COGS 11,A01,083617,Boyle; Mary E. T.,24,0,40,16
1650184200664,COGS 13,A01,083071,Staff,0,30,40,40
1650184206712,COGS 14A,A01,092681,Staff,0,12,100,100
1650184212735,COGS 14B,A01,083073,Cheng; Tzu-Han,0,7,50,50
1650184218759,COGS 17,A01,092677,Staff,34,0,75,41
1650184224788,COGS 100,A01,083619,Staff,0,20,60,60
1650184230818,COGS 101A,A01,083621,Davis; Joshua Daniel,0,21,60,60
1650184236859,COGS 101B,A01,091572,Staff,6,0,60,54
1650184242885,COGS 101C,A01,083625,Delgado; Tania,20,0,30,10
1650184248917,COGS 107A,A01,083627,Boyle; Mary E. T.,0,7,60,60
1650184254943,COGS 118A,A01,083075,Staff,16,0,60,44
1650184260978,CSE 3,A50,083646,Miranda; Gregory Joseph,22,0,38,16
1650184260978,CSE 3,A51,083647,Miranda; Gregory Joseph,37,0,37,0
1650184267005,CSE 8A,A50,083650,Miranda; Gregory Joseph,0,17,40,40
1650184273041,CSE 11,A01,083080,Cao; Yingjun,0,68,40,40
1650184279067,CSE 12,A01,083652,Staff,0,5,100,100
1650184285097,CSE 15L,A01,083654,Staff,0,0,50,50
1650184285097,CSE 15L,A02,083655,Staff,8,0,50,42
1650184291132,CSE 20,A01,083657,Staff,53,0,80,27
1650184297157,CSE 30,A01,083084,Eldon; John,0,67,40,40
1650184303210,CSE 100,A01,083659,Cao; Yingjun,0,63,50,50
1650184309237,CSE 134B,A01,083661,Powell; Thomas Allan,0,27,65,65
1650184315266,CSE 140,A01,083663,Staff,1,0,75,74
1650184321291,CSE 140L,A01,083088,Eldon; John,0,4,75,75
1650184327324,CSE 175,A01,083665,Kumar; Rakesh,8,0,25,17
1650184333351,CSE 190,A00,092507,Dubnov; Shlomo,14,0,20,6
1650184339379,ECE 45,A01,083139,Staff,0,13,40,40
1650184345412,ECE 65,A50,083695,Staff,0,5,30,30
1650184351448,ECE 109,A01,091882,Touri; Behrouz,47,0,70,23
1650184357482,ECE 180,A00,083140,Abi Samra; Nicholas Camill,24,0,30,6
1650184357482,ECE 180,B00,083141,Abi Samra; Nicholas Camill,8,0,30,22
1650184363511,MATH 10A,A01,083735,Patchell; Gregory David,11,0,30,19
1650184363511,MATH 10A,A02,083736,Patchell; Gregory David,28,0,30,2
1650184363511,MATH 10A,A03,083737,Patchell; Gregory David,26,0,30,4
1650184369542,MATH 10B,A01,083207,Staff,0,5,30,30
1650184369542,MATH 10B,A02,083208,Staff,0,5,30,30
1650184369542,MATH 10B,B01,083739,Staff,17,0,30,13
1650184369542,MATH 10B,B02,083740,Staff,29,0,30,1
1650184375571,MATH 18,A01,083743,Staff,10,0,30,20
1650184375571,MATH 18,A02,083744,Staff,28,0,30,2
1650184375571,MATH 18,A03,083745,Staff,23,0,30,7
1650184375571,MATH 18,A04,083746,Staff,27,0,30,3
1650184375571,MATH 18,B01,083748,Staff,0,10,30,30
1650184375571,MATH 18,B02,083749,Staff,0,7,30,30
1650184375571,MATH 18,B03,083750,Staff,0,7,30,30
1650184375571,MATH 18,B04,083751,Staff,0,7,30,30
1650184381598,MATH 20A,A01,083754,Staff,26,0,40,14
1650184387628,MATH 20B,A01,083756,Staff,0,6,30,30
1650184387628,MATH 20B,A02,083757,Staff,0,5,30,30
1650184393667,MATH 20C,A01,083760,Staff,0,12,30,30
1650184393667,MATH 20C,A02,083761,Staff,0,12,30,30
1650184393667,MATH 20C,B01,083762,Staff,14,0,30,16
1650184393667,MATH 20C,B02,083763,Staff,28,0,30,2
1650184399703,MATH 20D,A01,083765,Staff,1,2,30,29
1650184399703,MATH 20D,A02,083766,Staff,10,0,30,20
1650184399703,MATH 20D,A03,083767,Staff,28,0,30,2
1650184405734,MATH 20E,A01,083771,Staff,8,0,30,22
1650184405734,MATH 20E,A02,083772,Staff,20,0,30,10
1650184405734,MATH 20E,B01,083773,Staff,0,0,30,30
1650184405734,MATH 20E,B02,083774,Staff,12,0,30,18
1650184411768,MATH 103A,A01,083777,Staff,0,9,30,30
1650184411768,MATH 103A,A02,083778,Staff,0,10,30,30
1650184411768,MATH 103A,B01,083779,Staff,0,9,30,30
1650184411768,MATH 103A,B02,083780,Staff,0,9,30,30
1650184417793,MATH 105,A01,085443,Staff,0,17,30,30
1650184423824,MATH 109,A01,083213,Anzaldo; Leesa B,0,3,30,30
1650184423824,MATH 109,A02,083214,Anzaldo; Leesa B,0,6,30,30
1650184423824,MATH 109,B01,083215,Anzaldo; Leesa B,0,4,30,30
1650184423824,MATH 109,B02,083216,Anzaldo; Leesa B,0,4,30,30
1650184429851,MATH 142A,A01,083219,Chow; Bennett,0,12,30,30
1650184429851,MATH 142A,A02,083220,Chow; Bennett,0,11,30,30
1650184429851,MATH 142A,B01,083221,Chow; Bennett,0,11,30,30
1650184429851,MATH 142A,B02,083222,Chow; Bennett,0,12,30,30
1650184435882,MATH 193A,A01,083224,Staff,0,4,30,30
1650184435882,MATH 193A,A02,083225,Staff,0,4,30,30
1650184435882,MATH 193A,A03,083781,Staff,0,1,30,30
1650184435882,MATH 193A,A04,083782,Staff,0,1,30,30
1650184441909,MATH 197,001,091859,McAuley; Julian John,9998,0,9999,1
1650184447995,COGS 9,A01,083615,Staff,0,14,60,60
1650184454022,COGS 11,A01,083617,Boyle; Mary E. T.,24,0,40,16
1650184460047,COGS 13,A01,083071,Staff,0,30,40,40
1650184466078,COGS 14A,A01,092681,Staff,0,12,100,100
1650184472106,COGS 14B,A01,083073,Cheng; Tzu-Han,0,7,50,50
1650184478132,COGS 17,A01,092677,Staff,34,0,75,41
1650184484157,COGS 100,A01,083619,Staff,0,20,60,60
1650184490183,COGS 101A,A01,083621,Davis; Joshua Daniel,0,21,60,60
1650184496212,COGS 101B,A01,091572,Staff,6,0,60,54
1650184502247,COGS 101C,A01,083625,Delgado; Tania,20,0,30,10
1650184508275,COGS 107A,A01,083627,Boyle; Mary E. T.,0,7,60,60
1650184514300,COGS 118A,A01,083075,Staff,16,0,60,44
1650184520332,CSE 3,A50,083646,Miranda; Gregory Joseph,22,0,38,16
1650184520332,CSE 3,A51,083647,Miranda; Gregory Joseph,37,0,37,0
1650184526370,CSE 8A,A50,083650,Miranda; Gregory Joseph,0,17,40,40
1650184532394,CSE 11,A01,083080,Cao; Yingjun,0,68,40,40
1650184538420,CSE 12,A01,083652,Staff,0,5,100,100
1650184544445,CSE 15L,A01,083654,Staff,0,0,50,50
1650184544445,CSE 15L,A02,083655,Staff,8,0,50,42
1650184550473,CSE 20,A01,083657,Staff,53,0,80,27
1650184556512,CSE 30,A01,083084,Eldon; John,0,67,40,40
1650184562538,CSE 100,A01,083659,Cao; Yingjun,0,63,50,50
1650184568562,CSE 134B,A01,083661,Powell; Thomas Allan,0,27,65,65
1650184574587,CSE 140,A01,083663,Staff,1,0,75,74
1650184580613,CSE 140L,A01,083088,Eldon; John,0,4,75,75
1650184586638,CSE 175,A01,083665,Kumar; Rakesh,8,0,25,17
1650184592664,CSE 190,A00,092507,Dubnov; Shlomo,14,0,20,6
1650184598693,ECE 45,A01,083139,Staff,0,13,40,40
1650184604722,ECE 65,A50,083695,Staff,0,5,30,30
1650184610748,ECE 109,A01,091882,Touri; Behrouz,47,0,70,23
1650184616774,ECE 180,A00,083140,Abi Samra; Nicholas Camill,24,0,30,6
1650184616774,ECE 180,B00,083141,Abi Samra; Nicholas Camill,8,0,30,22
1650184622800,MATH 10A,A01,083735,Patchell; Gregory David,11,0,30,19
1650184622800,MATH 10A,A02,083736,Patchell; Gregory David,28,0,30,2
1650184622800,MATH 10A,A03,083737,Patchell; Gregory David,26,0,30,4
1650184628825,MATH 10B,A01,083207,Staff,0,5,30,30
1650184628825,MATH 10B,A02,083208,Staff,0,5,30,30
1650184628825,MATH 10B,B01,083739,Staff,17,0,30,13
1650184628825,MATH 10B,B02,083740,Staff,29,0,30,1
1650184634863,MATH 18,A01,083743,Staff,10,0,30,20
1650184634863,MATH 18,A02,083744,Staff,28,0,30,2
1650184634863,MATH 18,A03,083745,Staff,23,0,30,7
1650184634863,MATH 18,A04,083746,Staff,27,0,30,3
1650184634863,MATH 18,B01,083748,Staff,0,10,30,30
1650184634863,MATH 18,B02,083749,Staff,0,7,30,30
1650184634863,MATH 18,B03,083750,Staff,0,7,30,30
1650184634863,MATH 18,B04,083751,Staff,0,7,30,30
1650184640887,MATH 20A,A01,083754,Staff,26,0,40,14
1650184646914,MATH 20B,A01,083756,Staff,0,6,30,30
1650184646914,MATH 20B,A02,083757,Staff,0,5,30,30
1650184652947,MATH 20C,A01,083760,Staff,0,12,30,30
1650184652947,MATH 20C,A02,083761,Staff,0,12,30,30
1650184652947,MATH 20C,B01,083762,Staff,14,0,30,16
1650184652947,MATH 20C,B02,083763,Staff,28,0,30,2
1650184659059,MATH 20D,A01,083765,Staff,1,2,30,29
1650184659059,MATH 20D,A02,083766,Staff,10,0,30,20
1650184659059,MATH 20D,A03,083767,Staff,28,0,30,2
1650184665085,MATH 20E,A01,083771,Staff,8,0,30,22
1650184665085,MATH 20E,A02,083772,Staff,20,0,30,10
1650184665085,MATH 20E,B01,083773,Staff,0,0,30,30
1650184665085,MATH 20E,B02,083774,Staff,12,0,30,18
1650184671113,MATH 103A,A01,083777,Staff,0,9,30,30
1650184671113,MATH 103A,A02,083778,Staff,0,10,30,30
1650184671113,MATH 103A,B01,083779,Staff,0,9,30,30
1650184671113,MATH 103A,B02,083780,Staff,0,9,30,30
1650184677140,MATH 105,A01,085443,Staff,0,17,30,30
1650184683167,MATH 109,A01,083213,Anzaldo; Leesa B,0,3,30,30
1650184683167,MATH 109,A02,083214,Anzaldo; Leesa B,0,6,30,30
1650184683167,MATH 109,B01,083215,Anzaldo; Leesa B,0,4,30,30
1650184683167,MATH 109,B02,083216,Anzaldo; Leesa B,0,4,30,30
1650184689194,MATH 142A,A01,083219,Chow; Bennett,0,12,30,30
1650184689194,MATH 142A,A02,083220,Chow; Bennett,0,11,30,30
1650184689194,MATH 142A,B01,083221,Chow; Bennett,0,11,30,30
1650184689194,MATH 142A,B02,083222,Chow; Bennett,0,12,30,30
1650184695225,MATH 193A,A01,083224,Staff,0,3,30,30
1650184695225,MATH 193A,A02,083225,Staff,0,4,30,30
1650184695225,MATH 193A,A03,083781,Staff,0,2,30,30
1650184695225,MATH 193A,A04,083782,Staff,0,1,30,30
1650184701252,MATH 197,001,091859,McAuley; Julian John,9998,0,9999,1
1650184707329,COGS 9,A01,083615,Staff,0,14,60,60
1650184713368,COGS 11,A01,083617,Boyle; Mary E. T.,24,0,40,16
1650184719399,COGS 13,A01,083071,Staff,0,30,40,40
1650184725433,COGS 14A,A01,092681,Staff,0,12,100,100
1650184731458,COGS 14B,A01,083073,Cheng; Tzu-Han,0,7,50,50
1650184737487,COGS 17,A01,092677,Staff,34,0,75,41
1650184743512,COGS 100,A01,083619,Staff,0,20,60,60
1650184749541,COGS 101A,A01,083621,Davis; Joshua Daniel,0,21,60,60
1650184755570,COGS 101B,A01,091572,Staff,6,0,60,54
1650184761596,COGS 101C,A01,083625,Delgado; Tania,20,0,30,10
1650184767622,COGS 107A,A01,083627,Boyle; Mary E. T.,0,7,60,60
1650184773649,COGS 118A,A01,083075,Staff,16,0,60,44
1650184779682,CSE 3,A50,083646,Miranda; Gregory Joseph,22,0,38,16
1650184779682,CSE 3,A51,083647,Miranda; Gregory Joseph,37,0,37,0
1650184785708,CSE 8A,A50,083650,Miranda; Gregory Joseph,0,17,40,40
1650184791734,CSE 11,A01,083080,Cao; Yingjun,0,68,40,40
1650184797763,CSE 12,A01,083652,Staff,0,5,100,100
1650184803788,CSE 15L,A01,083654,Staff,0,0,50,50
1650184803788,CSE 15L,A02,083655,Staff,8,0,50,42
1650184809815,CSE 20,A01,083657,Staff,53,0,80,27
1650184815842,CSE 30,A01,083084,Eldon; John,0,67,40,40
1650184821868,CSE 100,A01,083659,Cao; Yingjun,0,63,50,50
1650184827900,CSE 134B,A01,083661,Powell; Thomas Allan,0,27,65,65
1650184833927,CSE 140,A01,083663,Staff,1,0,75,74
1650184839953,CSE 140L,A01,083088,Eldon; John,0,4,75,75
1650184845985,CSE 175,A01,083665,Kumar; Rakesh,8,0,25,17
1650184852017,CSE 190,A00,092507,Dubnov; Shlomo,14,0,20,6
1650184858042,ECE 45,A01,083139,Staff,0,13,40,40
1650184864076,ECE 65,A50,083695,Staff,0,5,30,30
1650184870108,ECE 109,A01,091882,Touri; Behrouz,47,0,70,23
1650184876134,ECE 180,A00,083140,Abi Samra; Nicholas Camill,24,0,30,6
1650184876134,ECE 180,B00,083141,Abi Samra; Nicholas Camill,8,0,30,22
1650184882172,MATH 10A,A01,083735,Patchell; Gregory David,11,0,30,19
1650184882172,MATH 10A,A02,083736,Patchell; Gregory David,28,0,30,2
1650184882172,MATH 10A,A03,083737,Patchell; Gregory David,26,0,30,4
1650184888197,MATH 10B,A01,083207,Staff,0,5,30,30
1650184888197,MATH 10B,A02,083208,Staff,0,5,30,30
1650184888197,MATH 10B,B01,083739,Staff,17,0,30,13
1650184888197,MATH 10B,B02,083740,Staff,29,0,30,1
1650184894224,MATH 18,A01,083743,Staff,10,0,30,20
1650184894224,MATH 18,A02,083744,Staff,28,0,30,2
1650184894224,MATH 18,A03,083745,Staff,23,0,30,7
1650184894224,MATH 18,A04,083746,Staff,27,0,30,3
1650184894224,MATH 18,B01,083748,Staff,0,10,30,30
1650184894224,MATH 18,B02,083749,Staff,0,7,30,30
1650184894224,MATH 18,B03,083750,Staff,0,7,30,30
1650184894224,MATH 18,B04,083751,Staff,0,7,30,30
1650184900248,MATH 20A,A01,083754,Staff,26,0,40,14
1650184906282,MATH 20B,A01,083756,Staff,0,6,30,30
1650184906282,MATH 20B,A02,083757,Staff,0,5,30,30
1650184912317,MATH 20C,A01,083760,Staff,0,12,30,30
1650184912317,MATH 20C,A02,083761,Staff,0,12,30,30
1650184912317,MATH 20C,B01,083762,Staff,14,0,30,16
1650184912317,MATH 20C,B02,083763,Staff,28,0,30,2
1650184918341,MATH 20D,A01,083765,Staff,1,2,30,29
1650184918341,MATH 20D,A02,083766,Staff,10,0,30,20
1650184918341,MATH 20D,A03,083767,Staff,28,0,30,2
1650184924366,MATH 20E,A01,083771,Staff,8,0,30,22
1650184924366,MATH 20E,A02,083772,Staff,20,0,30,10
1650184924366,MATH 20E,B01,083773,Staff,0,0,30,30
1650184924366,MATH 20E,B02,083774,Staff,12,0,30,18
1650184930400,MATH 103A,A01,083777,Staff,0,9,30,30
1650184930400,MATH 103A,A02,083778,Staff,0,10,30,30
1650184930400,MATH 103A,B01,083779,Staff,0,9,30,30
1650184930400,MATH 103A,B02,083780,Staff,0,9,30,30
1650184936425,MATH 105,A01,085443,Staff,0,17,30,30
1650184942460,MATH 109,A01,083213,Anzaldo; Leesa B,0,3,30,30
1650184942460,MATH 109,A02,083214,Anzaldo; Leesa B,0,6,30,30
1650184942460,MATH 109,B01,083215,Anzaldo; Leesa B,0,4,30,30
1650184942460,MATH 109,B02,083216,Anzaldo; Leesa B,0,4,30,30
1650184948484,MATH 142A,A01,083219,Chow; Bennett,0,12,30,30
1650184948484,MATH 142A,A02,083220,Chow; Bennett,0,11,30,30
1650184948484,MATH 142A,B01,083221,Chow; Bennett,0,11,30,30
1650184948484,MATH 142A,B02,083222,Chow; Bennett,0,12,30,30
1650184954510,MATH 193A,A01,083224,Staff,0,3,30,30
1650184954510,MATH 193A,A02,083225,Staff,0,4,30,30
1650184954510,MATH 193A,A03,083781,Staff,0,2,30,30
1650184954510,MATH 193A,A04,083782,Staff,0,1,30,30
1650184960537,MATH 197,001,091859,McAuley; Julian John,9998,0,9999,1
1650184966604,COGS 9,A01,083615,Staff,0,14,60,60
1650184972631,COGS 11,A01,083617,Boyle; Mary E. T.,24,0,40,16
1650184978657,COGS 13,A01,083071,Staff,0,30,40,40
1650184984685,COGS 14A,A01,092681,Staff,0,12,100,100
1650184990713,COGS 14B,A01,083073,Cheng; Tzu-Han,0,7,50,50
1650184996736,COGS 17,A01,092677,Staff,34,0,75,41
1650185002761,COGS 100,A01,083619,Staff,0,20,60,60
1650185008785,COGS 101A,A01,083621,Davis; Joshua Daniel,0,21,60,60
1650185014811,COGS 101B,A01,091572,Staff,6,0,60,54
1650185020837,COGS 101C,A01,083625,Delgado; Tania,20,0,30,10
1650185026866,COGS 107A,A01,083627,Boyle; Mary E. T.,0,7,60,60
1650185032889,COGS 118A,A01,083075,Staff,16,0,60,44
1650185038914,CSE 3,A50,083646,Miranda; Gregory Joseph,22,0,38,16
1650185038914,CSE 3,A51,083647,Miranda; Gregory Joseph,37,0,37,0
1650185044942,CSE 8A,A50,083650,Miranda; Gregory Joseph,0,17,40,40
1650185050987,CSE 11,A01,083080,Cao; Yingjun,0,68,40,40
1650185057015,CSE 12,A01,083652,Staff,0,5,100,100
1650185063044,CSE 15L,A01,083654,Staff,0,0,50,50
1650185063044,CSE 15L,A02,083655,Staff,8,0,50,42
1650185069068,CSE 20,A01,083657,Staff,53,0,80,27
1650185075093,CSE 30,A01,083084,Eldon; John,0,67,40,40
1650185081123,CSE 100,A01,083659,Cao; Yingjun,0,63,50,50
1650185087151,CSE 134B,A01,083661,Powell; Thomas Allan,0,27,65,65
1650185093176,CSE 140,A01,083663,Staff,1,0,75,74
1650185099202,CSE 140L,A01,083088,Eldon; John,0,4,75,75
1650185105227,CSE 175,A01,083665,Kumar; Rakesh,8,0,25,17
1650185111252,CSE 190,A00,092507,Dubnov; Shlomo,14,0,20,6
1650185117278,ECE 45,A01,083139,Staff,0,13,40,40
1650185123307,ECE 65,A50,083695,Staff,0,5,30,30
1650185129333,ECE 109,A01,091882,Touri; Behrouz,47,0,70,23
1650185135357,ECE 180,A00,083140,Abi Samra; Nicholas Camill,24,0,30,6
1650185135357,ECE 180,B00,083141,Abi Samra; Nicholas Camill,8,0,30,22
1650185141388,MATH 10A,A01,083735,Patchell; Gregory David,11,0,30,19
1650185141388,MATH 10A,A02,083736,Patchell; Gregory David,28,0,30,2
1650185141388,MATH 10A,A03,083737,Patchell; Gregory David,26,0,30,4
1650185147417,MATH 10B,A01,083207,Staff,0,5,30,30
1650185147417,MATH 10B,A02,083208,Staff,0,5,30,30
1650185147417,MATH 10B,B01,083739,Staff,17,0,30,13
1650185147417,MATH 10B,B02,083740,Staff,29,0,30,1
1650185153451,MATH 18,A01,083743,Staff,10,0,30,20
1650185153451,MATH 18,A02,083744,Staff,28,0,30,2
1650185153451,MATH 18,A03,083745,Staff,23,0,30,7
1650185153451,MATH 18,A04,083746,Staff,27,0,30,3
1650185153451,MATH 18,B01,083748,Staff,0,10,30,30
1650185153451,MATH 18,B02,083749,Staff,0,7,30,30
1650185153451,MATH 18,B03,083750,Staff,0,7,30,30
1650185153451,MATH 18,B04,083751,Staff,0,7,30,30
1650185159484,MATH 20A,A01,083754,Staff,26,0,40,14
1650185165507,MATH 20B,A01,083756,Staff,0,6,30,30
1650185165507,MATH 20B,A02,083757,Staff,0,5,30,30
1650185171536,MATH 20C,A01,083760,Staff,0,12,30,30
1650185171536,MATH 20C,A02,083761,Staff,0,12,30,30
1650185171536,MATH 20C,B01,083762,Staff,14,0,30,16
1650185171536,MATH 20C,B02,083763,Staff,28,0,30,2
1650185177561,MATH 20D,A01,083765,Staff,1,2,30,29
1650185177561,MATH 20D,A02,083766,Staff,10,0,30,20
1650185177561,MATH 20D,A03,083767,Staff,28,0,30,2
1650185183591,MATH 20E,A01,083771,Staff,8,0,30,22
1650185183591,MATH 20E,A02,083772,Staff,20,0,30,10
1650185183591,MATH 20E,B01,083773,Staff,0,0,30,30
1650185183591,MATH 20E,B02,083774,Staff,12,0,30,18
1650185189617,MATH 103A,A01,083777,Staff,0,9,30,30
1650185189617,MATH 103A,A02,083778,Staff,0,10,30,30
1650185189617,MATH 103A,B01,083779,Staff,0,9,30,30
1650185189617,MATH 103A,B02,083780,Staff,0,9,30,30
1650185195641,MATH 105,A01,085443,Staff,0,17,30,30
1650185201668,MATH 109,A01,083213,Anzaldo; Leesa B,0,3,30,30
1650185201668,MATH 109,A02,083214,Anzaldo; Leesa B,0,6,30,30
1650185201668,MATH 109,B01,083215,Anzaldo; Leesa B,0,4,30,30
1650185201668,MATH 109,B02,083216,Anzaldo; Leesa B,0,4,30,30
1650185207696,MATH 142A,A01,083219,Chow; Bennett,0,12,30,30
1650185207696,MATH 142A,A02,083220,Chow; Bennett,0,11,30,30
1650185207696,MATH 142A,B01,083221,Chow; Bennett,0,11,30,30
1650185207696,MATH 142A,B02,083222,Chow; Bennett,0,12,30,30
1650185213724,MATH 193A,A01,083224,Staff,0,3,30,30
1650185213724,MATH 193A,A02,083225,Staff,0,4,30,30
1650185213724,MATH 193A,A03,083781,Staff,0,2,30,30
1650185213724,MATH 193A,A04,083782,Staff,0,1,30,30
1650185219748,MATH 197,001,091859,McAuley; Julian John,9998,0,9999,1
1650185225821,COGS 9,A01,083615,Staff,0,14,60,60
1650185231852,COGS 11,A01,083617,Boyle; Mary E. T.,24,0,40,16
1650185237887,COGS 13,A01,083071,Staff,0,30,40,40
1650185243915,COGS 14A,A01,092681,Staff,0,12,100,100
1650185250026,COGS 14B,A01,083073,Cheng; Tzu-Han,0,7,50,50
1650185256051,COGS 17,A01,092677,Staff,34,0,75,41
1650185262083,COGS 100,A01,083619,Staff,0,20,60,60
1650185268113,COGS 101A,A01,083621,Davis; Joshua Daniel,0,21,60,60
1650185274141,COGS 101B,A01,091572,Staff,6,0,60,54
1650185280167,COGS 101C,A01,083625,Delgado; Tania,20,0,30,10
1650185286191,COGS 107A,A01,083627,Boyle; Mary E. T.,0,7,60,60
1650185292216,COGS 118A,A01,083075,Staff,16,0,60,44
1650185298240,CSE 3,A50,083646,Miranda; Gregory Joseph,22,0,38,16
1650185298240,CSE 3,A51,083647,Miranda; Gregory Joseph,37,0,37,0
1650185304269,CSE 8A,A50,083650,Miranda; Gregory Joseph,0,17,40,40
1650185310298,CSE 11,A01,083080,Cao; Yingjun,0,68,40,40
1650185316321,CSE 12,A01,083652,Staff,0,5,100,100
1650185322352,CSE 15L,A01,083654,Staff,0,0,50,50
1650185322352,CSE 15L,A02,083655,Staff,8,0,50,42
1650185328380,CSE 20,A01,083657,Staff,53,0,80,27
1650185334411,CSE 30,A01,083084,Eldon; John,0,67,40,40
1650185340441,CSE 100,A01,083659,Cao; Yingjun,0,63,50,50
1650185346467,CSE 134B,A01,083661,Powell; Thomas Allan,0,27,65,65
1650185352490,CSE 140,A01,083663,Staff,1,0,75,74
1650185358514,CSE 140L,A01,083088,Eldon; John,0,4,75,75
1650185364539,CSE 175,A01,083665,Kumar; Rakesh,8,0,25,17
1650185370572,CSE 190,A00,092507,Dubnov; Shlomo,14,0,20,6
1650185376601,ECE 45,A01,083139,Staff,0,13,40,40
1650185382624,ECE 65,A50,083695,Staff,0,5,30,30
1650185388648,ECE 109,A01,091882,Touri; Behrouz,47,0,70,23
1650185394673,ECE 180,A00,083140,Abi Samra; Nicholas Camill,24,0,30,6
1650185394673,ECE 180,B00,083141,Abi Samra; Nicholas Camill,8,0,30,22
1650185400700,MATH 10A,A01,083735,Patchell; Gregory David,11,0,30,19
1650185400700,MATH 10A,A02,083736,Patchell; Gregory David,28,0,30,2
1650185400700,MATH 10A,A03,083737,Patchell; Gregory David,26,0,30,4
1650185406725,MATH 10B,A01,083207,Staff,0,5,30,30
1650185406725,MATH 10B,A02,083208,Staff,0,5,30,30
1650185406725,MATH 10B,B01,083739,Staff,17,0,30,13
1650185406725,MATH 10B,B02,083740,Staff,29,0,30,1
1650185412752,MATH 18,A01,083743,Staff,10,0,30,20
1650185412752,MATH 18,A02,083744,Staff,28,0,30,2
1650185412752,MATH 18,A03,083745,Staff,23,0,30,7
1650185412752,MATH 18,A04,083746,Staff,27,0,30,3
1650185412752,MATH 18,B01,083748,Staff,0,10,30,30
1650185412752,MATH 18,B02,083749,Staff,0,7,30,30
1650185412752,MATH 18,B03,083750,Staff,0,7,30,30
1650185412752,MATH 18,B04,083751,Staff,0,7,30,30
1650185418775,MATH 20A,A01,083754,Staff,26,0,40,14
1650185424804,MATH 20B,A01,083756,Staff,0,6,30,30
1650185424804,MATH 20B,A02,083757,Staff,0,5,30,30
1650185430830,MATH 20C,A01,083760,Staff,0,12,30,30
1650185430830,MATH 20C,A02,083761,Staff,0,12,30,30
1650185430830,MATH 20C,B01,083762,Staff,14,0,30,16
1650185430830,MATH 20C,B02,083763,Staff,28,0,30,2
1650185436860,MATH 20D,A01,083765,Staff,1,2,30,29
1650185436860,MATH 20D,A02,083766,Staff,10,0,30,20
1650185436860,MATH 20D,A03,083767,Staff,28,0,30,2
1650185442886,MATH 20E,A01,083771,Staff,8,0,30,22
1650185442886,MATH 20E,A02,083772,Staff,20,0,30,10
1650185442886,MATH 20E,B01,083773,Staff,0,0,30,30
1650185442886,MATH 20E,B02,083774,Staff,12,0,30,18
1650185448912,MATH 103A,A01,083777,Staff,0,9,30,30
1650185448912,MATH 103A,A02,083778,Staff,0,10,30,30
1650185448912,MATH 103A,B01,083779,Staff,0,9,30,30
1650185448912,MATH 103A,B02,083780,Staff,0,9,30,30
1650185454936,MATH 105,A01,085443,Staff,0,17,30,30
1650185460966,MATH 109,A01,083213,Anzaldo; Leesa B,0,3,30,30
1650185460966,MATH 109,A02,083214,Anzaldo; Leesa B,0,6,30,30
1650185460966,MATH 109,B01,083215,Anzaldo; Leesa B,0,4,30,30
1650185460966,MATH 109,B02,083216,Anzaldo; Leesa B,0,4,30,30
1650185466990,MATH 142A,A01,083219,Chow; Bennett,0,12,30,30
1650185466990,MATH 142A,A02,083220,Chow; Bennett,0,11,30,30
1650185466990,MATH 142A,B01,083221,Chow; Bennett,0,11,30,30
1650185466990,MATH 142A,B02,083222,Chow; Bennett,0,12,30,30
1650185473015,MATH 193A,A01,083224,Staff,0,4,30,30
1650185473015,MATH 193A,A02,083225,Staff,0,4,30,30
1650185473015,MATH 193A,A03,083781,Staff,0,2,30,30
1650185473015,MATH 193A,A04,083782,Staff,0,1,30,30
1650185479040,MATH 197,001,091859,McAuley; Julian John,9998,0,9999,1
1650185485112,COGS 9,A01,083615,Staff,0,14,60,60
1650185491140,COGS 11,A01,083617,Boyle; Mary E. T.,24,0,40,16
1650185497165,COGS 13,A01,083071,Staff,0,30,40,40
1650185503190,COGS 14A,A01,092681,Staff,0,12,100,100
1650185509220,COGS 14B,A01,083073,Cheng; Tzu-Han,0,7,50,50
1650185515245,COGS 17,A01,092677,Staff,34,0,75,41
1650185521270,COGS 100,A01,083619,Staff,0,20,60,60
1650185527304,COGS 101A,A01,083621,Davis; Joshua Daniel,0,21,60,60
1650185533328,COGS 101B,A01,091572,Staff,6,0,60,54
1650185539352,COGS 101C,A01,083625,Delgado; Tania,20,0,30,10
1650185545378,COGS 107A,A01,083627,Boyle; Mary E. T.,0,7,60,60
1650185551410,COGS 118A,A01,083075,Staff,16,0,60,44
1650185557459,CSE 3,A50,083646,Miranda; Gregory Joseph,22,0,38,16
1650185557459,CSE 3,A51,083647,Miranda; Gregory Joseph,37,0,37,0
1650185563502,CSE 8A,A50,083650,Miranda; Gregory Joseph,0,17,40,40
1650185569525,CSE 11,A01,083080,Cao; Yingjun,0,68,40,40
1650185575551,CSE 12,A01,083652,Staff,0,5,100,100
1650185581578,CSE 15L,A01,083654,Staff,0,0,50,50
1650185581578,CSE 15L,A02,083655,Staff,8,0,50,42
1650185587601,CSE 20,A01,083657,Staff,53,0,80,27
1650185593629,CSE 30,A01,083084,Eldon; John,0,67,40,40
1650185599655,CSE 100,A01,083659,Cao; Yingjun,0,63,50,50
1650185605685,CSE 134B,A01,083661,Powell; Thomas Allan,0,27,65,65
1650185611708,CSE 140,A01,083663,Staff,1,0,75,74
1650185617737,CSE 140L,A01,083088,Eldon; John,0,4,75,75
1650185623770,CSE 175,A01,083665,Kumar; Rakesh,8,0,25,17
1650185629797,CSE 190,A00,092507,Dubnov; Shlomo,14,0,20,6
1650185635821,ECE 45,A01,083139,Staff,0,13,40,40
1650185641847,ECE 65,A50,083695,Staff,0,5,30,30
1650185647883,ECE 109,A01,091882,Touri; Behrouz,47,0,70,23
1650185653915,ECE 180,A00,083140,Abi Samra; Nicholas Camill,24,0,30,6
1650185653915,ECE 180,B00,083141,Abi Samra; Nicholas Camill,8,0,30,22
1650185659942,MATH 10A,A01,083735,Patchell; Gregory David,11,0,30,19
1650185659942,MATH 10A,A02,083736,Patchell; Gregory David,28,0,30,2
1650185659942,MATH 10A,A03,083737,Patchell; Gregory David,26,0,30,4
1650185665977,MATH 10B,A01,083207,Staff,0,5,30,30
1650185665977,MATH 10B,A02,083208,Staff,0,5,30,30
1650185665977,MATH 10B,B01,083739,Staff,17,0,30,13
1650185665977,MATH 10B,B02,083740,Staff,29,0,30,1
1650185672007,MATH 18,A01,083743,Staff,10,0,30,20
1650185672007,MATH 18,A02,083744,Staff,28,0,30,2
1650185672007,MATH 18,A03,083745,Staff,23,0,30,7
1650185672007,MATH 18,A04,083746,Staff,27,0,30,3
1650185672007,MATH 18,B01,083748,Staff,0,10,30,30
1650185672007,MATH 18,B02,083749,Staff,0,7,30,30
1650185672007,MATH 18,B03,083750,Staff,0,7,30,30
1650185672007,MATH 18,B04,083751,Staff,0,7,30,30
1650185678030,MATH 20A,A01,083754,Staff,26,0,40,14
1650185684057,MATH 20B,A01,083756,Staff,0,6,30,30
1650185684057,MATH 20B,A02,083757,Staff,0,5,30,30
1650185690082,MATH 20C,A01,083760,Staff,0,12,30,30
1650185690082,MATH 20C,A02,083761,Staff,0,12,30,30
1650185690082,MATH 20C,B01,083762,Staff,14,0,30,16
1650185690082,MATH 20C,B02,083763,Staff,28,0,30,2
1650185696107,MATH 20D,A01,083765,Staff,1,2,30,29
1650185696107,MATH 20D,A02,083766,Staff,10,0,30,20
1650185696107,MATH 20D,A03,083767,Staff,28,0,30,2
1650185702139,MATH 20E,A01,083771,Staff,8,0,30,22
1650185702139,MATH 20E,A02,083772,Staff,20,0,30,10
1650185702139,MATH 20E,B01,083773,Staff,0,0,30,30
1650185702139,MATH 20E,B02,083774,Staff,12,0,30,18
1650185708171,MATH 103A,A01,083777,Staff,0,9,30,30
1650185708171,MATH 103A,A02,083778,Staff,0,10,30,30
1650185708171,MATH 103A,B01,083779,Staff,0,9,30,30
1650185708171,MATH 103A,B02,083780,Staff,0,9,30,30
1650185714202,MATH 105,A01,085443,Staff,0,17,30,30
1650185720241,MATH 109,A01,083213,Anzaldo; Leesa B,0,3,30,30
1650185720241,MATH 109,A02,083214,Anzaldo; Leesa B,0,6,30,30
1650185720241,MATH 109,B01,083215,Anzaldo; Leesa B,0,4,30,30
1650185720241,MATH 109,B02,083216,Anzaldo; Leesa B,0,4,30,30
1650185726267,MATH 142A,A01,083219,Chow; Bennett,0,12,30,30
1650185726267,MATH 142A,A02,083220,Chow; Bennett,0,11,30,30
1650185726267,MATH 142A,B01,083221,Chow; Bennett,0,11,30,30
1650185726267,MATH 142A,B02,083222,Chow; Bennett,0,12,30,30
1650185732293,MATH 193A,A01,083224,Staff,0,4,30,30
1650185732293,MATH 193A,A02,083225,Staff,0,4,30,30
1650185732293,MATH 193A,A03,083781,Staff,0,2,30,30
1650185732293,MATH 193A,A04,083782,Staff,0,1,30,30
1650185738322,MATH 197,001,091859,McAuley; Julian John,9998,0,9999,1
1650185744392,COGS 9,A01,083615,Staff,0,14,60,60
1650185750422,COGS 11,A01,083617,Boyle; Mary E. T.,24,0,40,16
1650185756455,COGS 13,A01,083071,Staff,0,30,40,40
1650185762495,COGS 14A,A01,092681,Staff,0,12,100,100
1650185768520,COGS 14B,A01,083073,Cheng; Tzu-Han,0,7,50,50
1650185774542,COGS 17,A01,092677,Staff,34,0,75,41
1650185780568,COGS 100,A01,083619,Staff,0,20,60,60
1650185786599,COGS 101A,A01,083621,Davis; Joshua Daniel,0,21,60,60
1650185792630,COGS 101B,A01,091572,Staff,6,0,60,54
1650185798659,COGS 101C,A01,083625,Delgado; Tania,20,0,30,10
1650185804695,COGS 107A,A01,083627,Boyle; Mary E. T.,0,7,60,60
1650185810719,COGS 118A,A01,083075,Staff,16,0,60,44
1650185816755,CSE 3,A50,083646,Miranda; Gregory Joseph,22,0,38,16
1650185816755,CSE 3,A51,083647,Miranda; Gregory Joseph,37,0,37,0
1650185822786,CSE 8A,A50,083650,Miranda; Gregory Joseph,0,17,40,40
1650185828811,CSE 11,A01,083080,Cao; Yingjun,0,68,40,40
1650185834834,CSE 12,A01,083652,Staff,0,5,100,100
1650185840858,CSE 15L,A01,083654,Staff,0,0,50,50
1650185840858,CSE 15L,A02,083655,Staff,8,0,50,42
1650185846971,CSE 20,A01,083657,Staff,53,0,80,27
1650185852996,CSE 30,A01,083084,Eldon; John,0,67,40,40
1650185859028,CSE 100,A01,083659,Cao; Yingjun,0,63,50,50
1650185865055,CSE 134B,A01,083661,Powell; Thomas Allan,0,27,65,65
1650185871079,CSE 140,A01,083663,Staff,1,0,75,74
1650185877105,CSE 140L,A01,083088,Eldon; John,0,4,75,75
1650185883131,CSE 175,A01,083665,Kumar; Rakesh,8,0,25,17
1650185889157,CSE 190,A00,092507,Dubnov; Shlomo,14,0,20,6
1650185895184,ECE 45,A01,083139,Staff,0,13,40,40
1650185901213,ECE 65,A50,083695,Staff,0,5,30,30
1650185907246,ECE 109,A01,091882,Touri; Behrouz,47,0,70,23
1650185913270,ECE 180,A00,083140,Abi Samra; Nicholas Camill,24,0,30,6
1650185913270,ECE 180,B00,083141,Abi Samra; Nicholas Camill,8,0,30,22
1650185919311,MATH 10A,A01,083735,Patchell; Gregory David,11,0,30,19
1650185919311,MATH 10A,A02,083736,Patchell; Gregory David,28,0,30,2
1650185919311,MATH 10A,A03,083737,Patchell; Gregory David,26,0,30,4
1650185925341,MATH 10B,A01,083207,Staff,0,5,30,30
1650185925341,MATH 10B,A02,083208,Staff,0,5,30,30
1650185925341,MATH 10B,B01,083739,Staff,17,0,30,13
1650185925341,MATH 10B,B02,083740,Staff,29,0,30,1
1650185931380,MATH 18,A01,083743,Staff,10,0,30,20
1650185931380,MATH 18,A02,083744,Staff,28,0,30,2
1650185931380,MATH 18,A03,083745,Staff,23,0,30,7
1650185931380,MATH 18,A04,083746,Staff,27,0,30,3
1650185931380,MATH 18,B01,083748,Staff,0,10,30,30
1650185931380,MATH 18,B02,083749,Staff,0,7,30,30
1650185931380,MATH 18,B03,083750,Staff,0,7,30,30
1650185931380,MATH 18,B04,083751,Staff,0,7,30,30
1650185937410,MATH 20A,A01,083754,Staff,26,0,40,14
1650185943440,MATH 20B,A01,083756,Staff,0,6,30,30
1650185943440,MATH 20B,A02,083757,Staff,0,5,30,30
1650185949470,MATH 20C,A01,083760,Staff,0,12,30,30
1650185949470,MATH 20C,A02,083761,Staff,0,12,30,30
1650185949470,MATH 20C,B01,083762,Staff,14,0,30,16
1650185949470,MATH 20C,B02,083763,Staff,28,0,30,2
1650185955496,MATH 20D,A01,083765,Staff,1,2,30,29
1650185955496,MATH 20D,A02,083766,Staff,10,0,30,20
1650185955496,MATH 20D,A03,083767,Staff,28,0,30,2
1650185961520,MATH 20E,A01,083771,Staff,8,0,30,22
1650185961520,MATH 20E,A02,083772,Staff,20,0,30,10
1650185961520,MATH 20E,B01,083773,Staff,0,0,30,30
1650185961520,MATH 20E,B02,083774,Staff,12,0,30,18
1650185967551,MATH 103A,A01,083777,Staff,0,9,30,30
1650185967551,MATH 103A,A02,083778,Staff,0,10,30,30
1650185967551,MATH 103A,B01,083779,Staff,0,9,30,30
1650185967551,MATH 103A,B02,083780,Staff,0,9,30,30
1650185973576,MATH 105,A01,085443,Staff,0,17,30,30
1650185979600,MATH 109,A01,083213,Anzaldo; Leesa B,0,3,30,30
1650185979600,MATH 109,A02,083214,Anzaldo; Leesa B,0,6,30,30
1650185979600,MATH 109,B01,083215,Anzaldo; Leesa B,0,4,30,30
1650185979600,MATH 109,B02,083216,Anzaldo; Leesa B,0,4,30,30
1650185985627,MATH 142A,A01,083219,Chow; Bennett,0,12,30,30
1650185985627,MATH 142A,A02,083220,Chow; Bennett,0,11,30,30
1650185985627,MATH 142A,B01,083221,Chow; Bennett,0,11,30,30
1650185985627,MATH 142A,B02,083222,Chow; Bennett,0,12,30,30
1650185991652,MATH 193A,A01,083224,Staff,0,4,30,30
1650185991652,MATH 193A,A02,083225,Staff,0,4,30,30
1650185991652,MATH 193A,A03,083781,Staff,0,2,30,30
1650185991652,MATH 193A,A04,083782,Staff,0,1,30,30
1650185997676,MATH 197,001,091859,McAuley; Julian John,9998,0,9999,1
1650186003759,COGS 9,A01,083615,Staff,0,14,60,60
1650186009785,COGS 11,A01,083617,Boyle; Mary E. T.,24,0,40,16
1650186015810,COGS 13,A01,083071,Staff,0,30,40,40
1650186021835,COGS 14A,A01,092681,Staff,0,12,100,100
1650186027864,COGS 14B,A01,083073,Cheng; Tzu-Han,0,7,50,50
1650186033892,COGS 17,A01,092677,Staff,34,0,75,41
1650186039918,COGS 100,A01,083619,Staff,0,20,60,60
1650186045948,COGS 101A,A01,083621,Davis; Joshua Daniel,0,21,60,60
1650186051979,COGS 101B,A01,091572,Staff,6,0,60,54
1650186058012,COGS 101C,A01,083625,Delgado; Tania,20,0,30,10
1650186064037,COGS 107A,A01,083627,Boyle; Mary E. T.,0,7,60,60
1650186070073,COGS 118A,A01,083075,Staff,16,0,60,44
1650186076102,CSE 3,A50,083646,Miranda; Gregory Joseph,22,0,38,16
1650186076102,CSE 3,A51,083647,Miranda; Gregory Joseph,37,0,37,0
1650186082138,CSE 8A,A50,083650,Miranda; Gregory Joseph,0,17,40,40
1650186088161,CSE 11,A01,083080,Cao; Yingjun,0,68,40,40
1650186094190,CSE 12,A01,083652,Staff,0,5,100,100
1650186100215,CSE 15L,A01,083654,Staff,0,0,50,50
1650186100215,CSE 15L,A02,083655,Staff,8,0,50,42
1650186106240,CSE 20,A01,083657,Staff,53,0,80,27
1650186112271,CSE 30,A01,083084,Eldon; John,0,67,40,40
1650186118306,CSE 100,A01,083659,Cao; Yingjun,0,63,50,50
1650186124332,CSE 134B,A01,083661,Powell; Thomas Allan,0,27,65,65
1650186130357,CSE 140,A01,083663,Staff,1,0,75,74
1650186136382,CSE 140L,A01,083088,Eldon; John,0,4,75,75
1650186142414,CSE 175,A01,083665,Kumar; Rakesh,8,0,25,17
1650186148440,CSE 190,A00,092507,Dubnov; Shlomo,14,0,20,6
1650186154464,ECE 45,A01,083139,Staff,0,13,40,40
1650186160496,ECE 65,A50,083695,Staff,0,5,30,30
1650186166523,ECE 109,A01,091882,Touri; Behrouz,47,0,70,23
1650186172551,ECE 180,A00,083140,Abi Samra; Nicholas Camill,24,0,30,6
1650186172551,ECE 180,B00,083141,Abi Samra; Nicholas Camill,8,0,30,22
1650186178575,MATH 10A,A01,083735,Patchell; Gregory David,11,0,30,19
1650186178575,MATH 10A,A02,083736,Patchell; Gregory David,28,0,30,2
1650186178575,MATH 10A,A03,083737,Patchell; Gregory David,26,0,30,4
1650186184605,MATH 10B,A01,083207,Staff,0,5,30,30
1650186184605,MATH 10B,A02,083208,Staff,0,5,30,30
1650186184605,MATH 10B,B01,083739,Staff,17,0,30,13
1650186184605,MATH 10B,B02,083740,Staff,29,0,30,1
1650186190635,MATH 18,A01,083743,Staff,10,0,30,20
1650186190635,MATH 18,A02,083744,Staff,28,0,30,2
1650186190635,MATH 18,A03,083745,Staff,23,0,30,7
1650186190635,MATH 18,A04,083746,Staff,27,0,30,3
1650186190635,MATH 18,B01,083748,Staff,0,10,30,30
1650186190635,MATH 18,B02,083749,Staff,0,7,30,30
1650186190635,MATH 18,B03,083750,Staff,0,7,30,30
1650186190635,MATH 18,B04,083751,Staff,0,7,30,30
1650186196659,MATH 20A,A01,083754,Staff,26,0,40,14
1650186202694,MATH 20B,A01,083756,Staff,0,6,30,30
1650186202694,MATH 20B,A02,083757,Staff,0,6,30,30
1650186208720,MATH 20C,A01,083760,Staff,0,12,30,30
1650186208720,MATH 20C,A02,083761,Staff,0,12,30,30
1650186208720,MATH 20C,B01,083762,Staff,14,0,30,16
1650186208720,MATH 20C,B02,083763,Staff,28,0,30,2
1650186214748,MATH 20D,A01,083765,Staff,1,2,30,29
1650186214748,MATH 20D,A02,083766,Staff,10,0,30,20
1650186214748,MATH 20D,A03,083767,Staff,28,0,30,2
1650186220775,MATH 20E,A01,083771,Staff,8,0,30,22
1650186220775,MATH 20E,A02,083772,Staff,20,0,30,10
1650186220775,MATH 20E,B01,083773,Staff,0,0,30,30
1650186220775,MATH 20E,B02,083774,Staff,12,0,30,18
1650186226806,MATH 103A,A01,083777,Staff,0,9,30,30
1650186226806,MATH 103A,A02,083778,Staff,0,10,30,30
1650186226806,MATH 103A,B01,083779,Staff,0,9,30,30
1650186226806,MATH 103A,B02,083780,Staff,0,9,30,30
1650186232834,MATH 105,A01,085443,Staff,0,17,30,30
1650186238866,MATH 109,A01,083213,Anzaldo; Leesa B,0,3,30,30
1650186238866,MATH 109,A02,083214,Anzaldo; Leesa B,0,6,30,30
1650186238866,MATH 109,B01,083215,Anzaldo; Leesa B,0,4,30,30
1650186238866,MATH 109,B02,083216,Anzaldo; Leesa B,0,4,30,30
1650186244896,MATH 142A,A01,083219,Chow; Bennett,0,12,30,30
1650186244896,MATH 142A,A02,083220,Chow; Bennett,0,11,30,30
1650186244896,MATH 142A,B01,083221,Chow; Bennett,0,11,30,30
1650186244896,MATH 142A,B02,083222,Chow; Bennett,0,12,30,30
1650186250926,MATH 193A,A01,083224,Staff,0,4,30,30
1650186250926,MATH 193A,A02,083225,Staff,0,4,30,30
1650186250926,MATH 193A,A03,083781,Staff,0,2,30,30
1650186250926,MATH 193A,A04,083782,Staff,0,1,30,30
1650186256956,MATH 197,001,091859,McAuley; Julian John,9998,0,9999,1
1650186263027,COGS 9,A01,083615,Staff,0,14,60,60
1650186269052,COGS 11,A01,083617,Boyle; Mary E. T.,24,0,40,16
1650186275077,COGS 13,A01,083071,Staff,0,30,40,40
1650186281104,COGS 14A,A01,092681,Staff,0,12,100,100
1650186287129,COGS 14B,A01,083073,Cheng; Tzu-Han,0,7,50,50
1650186293154,COGS 17,A01,092677,Staff,34,0,75,41
1650186299185,COGS 100,A01,083619,Staff,0,20,60,60
1650186305215,COGS 101A,A01,083621,Davis; Joshua Daniel,0,21,60,60
1650186311242,COGS 101B,A01,091572,Staff,6,0,60,54
1650186317272,COGS 101C,A01,083625,Delgado; Tania,20,0,30,10
1650186323301,COGS 107A,A01,083627,Boyle; Mary E. T.,0,7,60,60
1650186329332,COGS 118A,A01,083075,Staff,16,0,60,44
1650186335359,CSE 3,A50,083646,Miranda; Gregory Joseph,22,0,38,16
1650186335359,CSE 3,A51,083647,Miranda; Gregory Joseph,37,0,37,0
1650186341387,CSE 8A,A50,083650,Miranda; Gregory Joseph,0,17,40,40
1650186347418,CSE 11,A01,083080,Cao; Yingjun,0,68,40,40
1650186353445,CSE 12,A01,083652,Staff,0,5,100,100
1650186359469,CSE 15L,A01,083654,Staff,0,0,50,50
1650186359469,CSE 15L,A02,083655,Staff,8,0,50,42
1650186365495,CSE 20,A01,083657,Staff,53,0,80,27
1650186371523,CSE 30,A01,083084,Eldon; John,0,67,40,40
1650186377554,CSE 100,A01,083659,Cao; Yingjun,0,63,50,50
1650186383579,CSE 134B,A01,083661,Powell; Thomas Allan,0,27,65,65
1650186389607,CSE 140,A01,083663,Staff,1,0,75,74
1650186395636,CSE 140L,A01,083088,Eldon; John,0,4,75,75
1650186401667,CSE 175,A01,083665,Kumar; Rakesh,8,0,25,17
1650186407699,CSE 190,A00,092507,Dubnov; Shlomo,14,0,20,6
1650186413724,ECE 45,A01,083139,Staff,0,13,40,40
1650186419750,ECE 65,A50,083695,Staff,0,5,30,30
1650186425777,ECE 109,A01,091882,Touri; Behrouz,47,0,70,23
1650186431806,ECE 180,A00,083140,Abi Samra; Nicholas Camill,24,0,30,6
1650186431806,ECE 180,B00,083141,Abi Samra; Nicholas Camill,8,0,30,22
1650186437835,MATH 10A,A01,083735,Patchell; Gregory David,11,0,30,19
1650186437835,MATH 10A,A02,083736,Patchell; Gregory David,28,0,30,2
1650186437835,MATH 10A,A03,083737,Patchell; Gregory David,26,0,30,4
1650186443950,MATH 10B,A01,083207,Staff,0,5,30,30
1650186443950,MATH 10B,A02,083208,Staff,0,5,30,30
1650186443950,MATH 10B,B01,083739,Staff,17,0,30,13
1650186443950,MATH 10B,B02,083740,Staff,29,0,30,1
1650186449979,MATH 18,A01,083743,Staff,10,0,30,20
1650186449979,MATH 18,A02,083744,Staff,28,0,30,2
1650186449979,MATH 18,A03,083745,Staff,23,0,30,7
1650186449979,MATH 18,A04,083746,Staff,27,0,30,3
1650186449979,MATH 18,B01,083748,Staff,0,10,30,30
1650186449979,MATH 18,B02,083749,Staff,0,7,30,30
1650186449979,MATH 18,B03,083750,Staff,0,7,30,30
1650186449979,MATH 18,B04,083751,Staff,0,7,30,30
1650186456002,MATH 20A,A01,083754,Staff,26,0,40,14
1650186462026,MATH 20B,A01,083756,Staff,0,6,30,30
1650186462026,MATH 20B,A02,083757,Staff,0,6,30,30
1650186468050,MATH 20C,A01,083760,Staff,0,12,30,30
1650186468050,MATH 20C,A02,083761,Staff,0,12,30,30
1650186468050,MATH 20C,B01,083762,Staff,14,0,30,16
1650186468050,MATH 20C,B02,083763,Staff,28,0,30,2
1650186474074,MATH 20D,A01,083765,Staff,1,2,30,29
1650186474074,MATH 20D,A02,083766,Staff,10,0,30,20
1650186474074,MATH 20D,A03,083767,Staff,28,0,30,2
1650186480106,MATH 20E,A01,083771,Staff,8,0,30,22
1650186480106,MATH 20E,A02,083772,Staff,20,0,30,10
1650186480106,MATH 20E,B01,083773,Staff,0,0,30,30
1650186480106,MATH 20E,B02,083774,Staff,12,0,30,18
1650186486132,MATH 103A,A01,083777,Staff,0,9,30,30
1650186486132,MATH 103A,A02,083778,Staff,0,10,30,30
1650186486132,MATH 103A,B01,083779,Staff,0,9,30,30
1650186486132,MATH 103A,B02,083780,Staff,0,9,30,30
1650186492165,MATH 105,A01,085443,Staff,0,17,30,30
1650186498194,MATH 109,A01,083213,Anzaldo; Leesa B,0,3,30,30
1650186498194,MATH 109,A02,083214,Anzaldo; Leesa B,0,6,30,30
1650186498194,MATH 109,B01,083215,Anzaldo; Leesa B,0,4,30,30
1650186498194,MATH 109,B02,083216,Anzaldo; Leesa B,0,4,30,30
1650186504223,MATH 142A,A01,083219,Chow; Bennett,0,12,30,30
1650186504223,MATH 142A,A02,083220,Chow; Bennett,0,11,30,30
1650186504223,MATH 142A,B01,083221,Chow; Bennett,0,11,30,30
1650186504223,MATH 142A,B02,083222,Chow; Bennett,0,12,30,30
1650186510249,MATH 193A,A01,083224,Staff,0,4,30,30
1650186510249,MATH 193A,A02,083225,Staff,0,4,30,30
1650186510249,MATH 193A,A03,083781,Staff,0,2,30,30
1650186510249,MATH 193A,A04,083782,Staff,0,1,30,30
1650186516277,MATH 197,001,091859,McAuley; Julian John,9998,0,9999,1
1650186522349,COGS 9,A01,083615,Staff,0,14,60,60
1650186528377,COGS 11,A01,083617,Boyle; Mary E. T.,24,0,40,16
1650186534403,COGS 13,A01,083071,Staff,0,30,40,40
1650186540427,COGS 14A,A01,092681,Staff,0,12,100,100
1650186546458,COGS 14B,A01,083073,Cheng; Tzu-Han,0,7,50,50
1650186552483,COGS 17,A01,092677,Staff,34,0,75,41
1650186558509,COGS 100,A01,083619,Staff,0,20,60,60
1650186564533,COGS 101A,A01,083621,Davis; Joshua Daniel,0,21,60,60
1650186570565,COGS 101B,A01,091572,Staff,6,0,60,54
1650186576599,COGS 101C,A01,083625,Delgado; Tania,20,0,30,10
1650186582626,COGS 107A,A01,083627,Boyle; Mary E. T.,0,7,60,60
1650186588650,COGS 118A,A01,083075,Staff,16,0,60,44
1650186594682,CSE 3,A50,083646,Miranda; Gregory Joseph,22,0,38,16
1650186594682,CSE 3,A51,083647,Miranda; Gregory Joseph,37,0,37,0
1650186600711,CSE 8A,A50,083650,Miranda; Gregory Joseph,0,17,40,40
1650186606739,CSE 11,A01,083080,Cao; Yingjun,0,68,40,40
1650186612764,CSE 12,A01,083652,Staff,0,5,100,100
1650186618791,CSE 15L,A01,083654,Staff,0,0,50,50
1650186618791,CSE 15L,A02,083655,Staff,8,0,50,42
1650186624817,CSE 20,A01,083657,Staff,53,0,80,27
1650186630844,CSE 30,A01,083084,Eldon; John,0,69,40,40
1650186636871,CSE 100,A01,083659,Cao; Yingjun,0,63,50,50
1650186642904,CSE 134B,A01,083661,Powell; Thomas Allan,0,27,65,65
1650186648933,CSE 140,A01,083663,Staff,1,0,75,74
1650186654964,CSE 140L,A01,083088,Eldon; John,0,4,75,75
1650186660996,CSE 175,A01,083665,Kumar; Rakesh,8,0,25,17
1650186667022,CSE 190,A00,092507,Dubnov; Shlomo,14,0,20,6
1650186673046,ECE 45,A01,083139,Staff,0,13,40,40
1650186679071,ECE 65,A50,083695,Staff,0,5,30,30
1650186685102,ECE 109,A01,091882,Touri; Behrouz,47,0,70,23
1650186691133,ECE 180,A00,083140,Abi Samra; Nicholas Camill,24,0,30,6
1650186691133,ECE 180,B00,083141,Abi Samra; Nicholas Camill,8,0,30,22
1650186697167,MATH 10A,A01,083735,Patchell; Gregory David,11,0,30,19
1650186697167,MATH 10A,A02,083736,Patchell; Gregory David,28,0,30,2
1650186697167,MATH 10A,A03,083737,Patchell; Gregory David,26,0,30,4
1650186703202,MATH 10B,A01,083207,Staff,0,5,30,30
1650186703202,MATH 10B,A02,083208,Staff,0,5,30,30
1650186703202,MATH 10B,B01,083739,Staff,17,0,30,13
1650186703202,MATH 10B,B02,083740,Staff,29,0,30,1
1650186709236,MATH 18,A01,083743,Staff,9,0,30,21
1650186709236,MATH 18,A02,083744,Staff,28,0,30,2
1650186709236,MATH 18,A03,083745,Staff,23,0,30,7
1650186709236,MATH 18,A04,083746,Staff,27,0,30,3
1650186709236,MATH 18,B01,083748,Staff,0,10,30,30
1650186709236,MATH 18,B02,083749,Staff,0,7,30,30
1650186709236,MATH 18,B03,083750,Staff,0,7,30,30
1650186709236,MATH 18,B04,083751,Staff,0,7,30,30
1650186715261,MATH 20A,A01,083754,Staff,26,0,40,14
1650186721292,MATH 20B,A01,083756,Staff,0,6,30,30
1650186721292,MATH 20B,A02,083757,Staff,0,6,30,30
1650186727322,MATH 20C,A01,083760,Staff,0,12,30,30
1650186727322,MATH 20C,A02,083761,Staff,0,12,30,30
1650186727322,MATH 20C,B01,083762,Staff,14,0,30,16
1650186727322,MATH 20C,B02,083763,Staff,28,0,30,2
1650186733346,MATH 20D,A01,083765,Staff,1,2,30,29
1650186733346,MATH 20D,A02,083766,Staff,10,0,30,20
1650186733346,MATH 20D,A03,083767,Staff,28,0,30,2
1650186739382,MATH 20E,A01,083771,Staff,8,0,30,22
1650186739382,MATH 20E,A02,083772,Staff,20,0,30,10
1650186739382,MATH 20E,B01,083773,Staff,0,0,30,30
1650186739382,MATH 20E,B02,083774,Staff,12,0,30,18
1650186745410,MATH 103A,A01,083777,Staff,0,9,30,30
1650186745410,MATH 103A,A02,083778,Staff,0,10,30,30
1650186745410,MATH 103A,B01,083779,Staff,0,9,30,30
1650186745410,MATH 103A,B02,083780,Staff,0,9,30,30
1650186751436,MATH 105,A01,085443,Staff,0,17,30,30
1650186757462,MATH 109,A01,083213,Anzaldo; Leesa B,0,3,30,30
1650186757462,MATH 109,A02,083214,Anzaldo; Leesa B,0,6,30,30
1650186757462,MATH 109,B01,083215,Anzaldo; Leesa B,0,4,30,30
1650186757462,MATH 109,B02,083216,Anzaldo; Leesa B,0,4,30,30
1650186763493,MATH 142A,A01,083219,Chow; Bennett,0,12,30,30
1650186763493,MATH 142A,A02,083220,Chow; Bennett,0,11,30,30
1650186763493,MATH 142A,B01,083221,Chow; Bennett,0,11,30,30
1650186763493,MATH 142A,B02,083222,Chow; Bennett,0,12,30,30
1650186769518,MATH 193A,A01,083224,Staff,0,4,30,30
1650186769518,MATH 193A,A02,083225,Staff,0,4,30,30
1650186769518,MATH 193A,A03,083781,Staff,0,2,30,30
1650186769518,MATH 193A,A04,083782,Staff,0,1,30,30
1650186775550,MATH 197,001,091859,McAuley; Julian John,9998,0,9999,1
1650186781614,COGS 9,A01,083615,Staff,0,14,60,60
1650186787643,COGS 11,A01,083617,Boyle; Mary E. T.,24,0,40,16
1650186793701,COGS 13,A01,083071,Staff,0,30,40,40
1650186799726,COGS 14A,A01,092681,Staff,0,12,100,100
1650186805754,COGS 14B,A01,083073,Cheng; Tzu-Han,0,7,50,50
1650186811783,COGS 17,A01,092677,Staff,34,0,75,41
1650186817807,COGS 100,A01,083619,Staff,0,20,60,60
1650186823832,COGS 101A,A01,083621,Davis; Joshua Daniel,0,21,60,60
1650186829862,COGS 101B,A01,091572,Staff,6,0,60,54
1650186835889,COGS 101C,A01,083625,Delgado; Tania,20,0,30,10
1650186841912,COGS 107A,A01,083627,Boyle; Mary E. T.,0,7,60,60
1650186847937,COGS 118A,A01,083075,Staff,16,0,60,44
1650186853965,CSE 3,A50,083646,Miranda; Gregory Joseph,22,0,38,16
1650186853965,CSE 3,A51,083647,Miranda; Gregory Joseph,37,0,37,0
1650186859992,CSE 8A,A50,083650,Miranda; Gregory Joseph,0,17,40,40
1650186866016,CSE 11,A01,083080,Cao; Yingjun,0,68,40,40
1650186872039,CSE 12,A01,083652,Staff,0,5,100,100
1650186878064,CSE 15L,A01,083654,Staff,0,0,50,50
1650186878064,CSE 15L,A02,083655,Staff,8,0,50,42
1650186884093,CSE 20,A01,083657,Staff,53,0,80,27
1650186890118,CSE 30,A01,083084,Eldon; John,0,69,40,40
1650186896152,CSE 100,A01,083659,Cao; Yingjun,0,63,50,50
1650186902181,CSE 134B,A01,083661,Powell; Thomas Allan,0,27,65,65
1650186908204,CSE 140,A01,083663,Staff,1,0,75,74
1650186914230,CSE 140L,A01,083088,Eldon; John,0,4,75,75
1650186920260,CSE 175,A01,083665,Kumar; Rakesh,8,0,25,17
1650186926292,CSE 190,A00,092507,Dubnov; Shlomo,14,0,20,6
1650186932320,ECE 45,A01,083139,Staff,0,13,40,40
1650186938346,ECE 65,A50,083695,Staff,0,5,30,30
1650186944377,ECE 109,A01,091882,Touri; Behrouz,47,0,70,23
1650186950402,ECE 180,A00,083140,Abi Samra; Nicholas Camill,24,0,30,6
1650186950402,ECE 180,B00,083141,Abi Samra; Nicholas Camill,8,0,30,22
1650186956436,MATH 10A,A01,083735,Patchell; Gregory David,11,0,30,19
1650186956436,MATH 10A,A02,083736,Patchell; Gregory David,28,0,30,2
1650186956436,MATH 10A,A03,083737,Patchell; Gregory David,26,0,30,4
1650186962462,MATH 10B,A01,083207,Staff,0,5,30,30
1650186962462,MATH 10B,A02,083208,Staff,0,5,30,30
1650186962462,MATH 10B,B01,083739,Staff,17,0,30,13
1650186962462,MATH 10B,B02,083740,Staff,29,0,30,1
1650186968493,MATH 18,A01,083743,Staff,8,0,30,22
1650186968493,MATH 18,A02,083744,Staff,28,0,30,2
1650186968493,MATH 18,A03,083745,Staff,23,0,30,7
1650186968493,MATH 18,A04,083746,Staff,27,0,30,3
1650186968493,MATH 18,B01,083748,Staff,0,10,30,30
1650186968493,MATH 18,B02,083749,Staff,0,7,30,30
1650186968493,MATH 18,B03,083750,Staff,0,7,30,30
1650186968493,MATH 18,B04,083751,Staff,0,7,30,30
1650186974518,MATH 20A,A01,083754,Staff,26,0,40,14
1650186980542,MATH 20B,A01,083756,Staff,0,6,30,30
1650186980542,MATH 20B,A02,083757,Staff,0,6,30,30
1650186986567,MATH 20C,A01,083760,Staff,0,12,30,30
1650186986567,MATH 20C,A02,083761,Staff,0,12,30,30
1650186986567,MATH 20C,B01,083762,Staff,14,0,30,16
1650186986567,MATH 20C,B02,083763,Staff,28,0,30,2
1650186992594,MATH 20D,A01,083765,Staff,1,2,30,29
1650186992594,MATH 20D,A02,083766,Staff,10,0,30,20
1650186992594,MATH 20D,A03,083767,Staff,28,0,30,2
1650186998626,MATH 20E,A01,083771,Staff,8,0,30,22
1650186998626,MATH 20E,A02,083772,Staff,20,0,30,10
1650186998626,MATH 20E,B01,083773,Staff,0,0,30,30
1650186998626,MATH 20E,B02,083774,Staff,12,0,30,18
1650187004650,MATH 103A,A01,083777,Staff,0,9,30,30
1650187004650,MATH 103A,A02,083778,Staff,0,10,30,30
1650187004650,MATH 103A,B01,083779,Staff,0,9,30,30
1650187004650,MATH 103A,B02,083780,Staff,0,9,30,30
1650187010679,MATH 105,A01,085443,Staff,0,17,30,30
1650187016708,MATH 109,A01,083213,Anzaldo; Leesa B,0,3,30,30
1650187016708,MATH 109,A02,083214,Anzaldo; Leesa B,0,6,30,30
1650187016708,MATH 109,B01,083215,Anzaldo; Leesa B,0,4,30,30
1650187016708,MATH 109,B02,083216,Anzaldo; Leesa B,0,4,30,30
1650187022733,MATH 142A,A01,083219,Chow; Bennett,0,12,30,30
1650187022733,MATH 142A,A02,083220,Chow; Bennett,0,11,30,30
1650187022733,MATH 142A,B01,083221,Chow; Bennett,0,11,30,30
1650187022733,MATH 142A,B02,083222,Chow; Bennett,0,12,30,30
1650187028757,MATH 193A,A01,083224,Staff,0,4,30,30
1650187028757,MATH 193A,A02,083225,Staff,0,4,30,30
1650187028757,MATH 193A,A03,083781,Staff,0,2,30,30
1650187028757,MATH 193A,A04,083782,Staff,0,1,30,30
1650187034782,MATH 197,001,091859,McAuley; Julian John,9998,0,9999,1
1650187040941,COGS 9,A01,083615,Staff,0,14,60,60
1650187046972,COGS 11,A01,083617,Boyle; Mary E. T.,24,0,40,16
1650187052998,COGS 13,A01,083071,Staff,0,30,40,40
1650187059027,COGS 14A,A01,092681,Staff,0,12,100,100
1650187065054,COGS 14B,A01,083073,Cheng; Tzu-Han,0,7,50,50
1650187071081,COGS 17,A01,092677,Staff,34,0,75,41
1650187077107,COGS 100,A01,083619,Staff,0,20,60,60
1650187083133,COGS 101A,A01,083621,Davis; Joshua Daniel,0,21,60,60
1650187089158,COGS 101B,A01,091572,Staff,6,0,60,54
1650187095188,COGS 101C,A01,083625,Delgado; Tania,20,0,30,10
1650187101212,COGS 107A,A01,083627,Boyle; Mary E. T.,0,7,60,60
1650187107238,COGS 118A,A01,083075,Staff,16,0,60,44
1650187113262,CSE 3,A50,083646,Miranda; Gregory Joseph,22,0,38,16
1650187113262,CSE 3,A51,083647,Miranda; Gregory Joseph,37,0,37,0
1650187119288,CSE 8A,A50,083650,Miranda; Gregory Joseph,0,17,40,40
1650187125312,CSE 11,A01,083080,Cao; Yingjun,0,68,40,40
1650187131346,CSE 12,A01,083652,Staff,0,5,100,100
1650187137376,CSE 15L,A01,083654,Staff,0,0,50,50
1650187137376,CSE 15L,A02,083655,Staff,8,0,50,42
1650187143399,CSE 20,A01,083657,Staff,53,0,80,27
1650187149423,CSE 30,A01,083084,Eldon; John,0,69,40,40
1650187155449,CSE 100,A01,083659,Cao; Yingjun,0,63,50,50
1650187161480,CSE 134B,A01,083661,Powell; Thomas Allan,0,27,65,65
1650187167504,CSE 140,A01,083663,Staff,1,0,75,74
1650187173528,CSE 140L,A01,083088,Eldon; John,0,4,75,75
1650187179557,CSE 175,A01,083665,Kumar; Rakesh,8,0,25,17
1650187185588,CSE 190,A00,092507,Dubnov; Shlomo,14,0,20,6
1650187191614,ECE 45,A01,083139,Staff,0,13,40,40
1650187197641,ECE 65,A50,083695,Staff,0,5,30,30
1650187203673,ECE 109,A01,091882,Touri; Behrouz,47,0,70,23
1650187209697,ECE 180,A00,083140,Abi Samra; Nicholas Camill,24,0,30,6
1650187209697,ECE 180,B00,083141,Abi Samra; Nicholas Camill,8,0,30,22
1650187215733,MATH 10A,A01,083735,Patchell; Gregory David,11,0,30,19
1650187215733,MATH 10A,A02,083736,Patchell; Gregory David,28,0,30,2
1650187215733,MATH 10A,A03,083737,Patchell; Gregory David,26,0,30,4
1650187221761,MATH 10B,A01,083207,Staff,0,5,30,30
1650187221761,MATH 10B,A02,083208,Staff,0,5,30,30
1650187221761,MATH 10B,B01,083739,Staff,17,0,30,13
1650187221761,MATH 10B,B02,083740,Staff,29,0,30,1
1650187227787,MATH 18,A01,083743,Staff,8,0,30,22
1650187227787,MATH 18,A02,083744,Staff,28,0,30,2
1650187227787,MATH 18,A03,083745,Staff,23,0,30,7
1650187227787,MATH 18,A04,083746,Staff,27,0,30,3
1650187227787,MATH 18,B01,083748,Staff,0,10,30,30
1650187227787,MATH 18,B02,083749,Staff,0,7,30,30
1650187227787,MATH 18,B03,083750,Staff,0,7,30,30
1650187227787,MATH 18,B04,083751,Staff,0,7,30,30
1650187233815,MATH 20A,A01,083754,Staff,26,0,40,14
1650187239842,MATH 20B,A01,083756,Staff,0,6,30,30
1650187239842,MATH 20B,A02,083757,Staff,0,6,30,30
1650187245867,MATH 20C,A01,083760,Staff,0,12,30,30
1650187245867,MATH 20C,A02,083761,Staff,0,12,30,30
1650187245867,MATH 20C,B01,083762,Staff,14,0,30,16
1650187245867,MATH 20C,B02,083763,Staff,28,0,30,2
1650187251892,MATH 20D,A01,083765,Staff,1,2,30,29
1650187251892,MATH 20D,A02,083766,Staff,10,0,30,20
1650187251892,MATH 20D,A03,083767,Staff,28,0,30,2
1650187257918,MATH 20E,A01,083771,Staff,8,0,30,22
1650187257918,MATH 20E,A02,083772,Staff,20,0,30,10
1650187257918,MATH 20E,B01,083773,Staff,0,0,30,30
1650187257918,MATH 20E,B02,083774,Staff,12,0,30,18
1650187263943,MATH 103A,A01,083777,Staff,0,9,30,30
1650187263943,MATH 103A,A02,083778,Staff,0,10,30,30
1650187263943,MATH 103A,B01,083779,Staff,0,9,30,30
1650187263943,MATH 103A,B02,083780,Staff,0,9,30,30
1650187269967,MATH 105,A01,085443,Staff,0,17,30,30
1650187275991,MATH 109,A01,083213,Anzaldo; Leesa B,0,3,30,30
1650187275991,MATH 109,A02,083214,Anzaldo; Leesa B,0,6,30,30
1650187275991,MATH 109,B01,083215,Anzaldo; Leesa B,0,4,30,30
1650187275991,MATH 109,B02,083216,Anzaldo; Leesa B,0,4,30,30
1650187282017,MATH 142A,A01,083219,Chow; Bennett,0,12,30,30
1650187282017,MATH 142A,A02,083220,Chow; Bennett,0,11,30,30
1650187282017,MATH 142A,B01,083221,Chow; Bennett,0,11,30,30
1650187282017,MATH 142A,B02,083222,Chow; Bennett,0,12,30,30
1650187288041,MATH 193A,A01,083224,Staff,0,4,30,30
1650187288041,MATH 193A,A02,083225,Staff,0,4,30,30
1650187288041,MATH 193A,A03,083781,Staff,0,2,30,30
1650187288041,MATH 193A,A04,083782,Staff,0,1,30,30
1650187294065,MATH 197,001,091859,McAuley; Julian John,9998,0,9999,1
1650187300129,COGS 9,A01,083615,Staff,0,14,60,60
1650187306154,COGS 11,A01,083617,Boyle; Mary E. T.,24,0,40,16
1650187312179,COGS 13,A01,083071,Staff,0,30,40,40
1650187318205,COGS 14A,A01,092681,Staff,0,12,100,100
1650187324228,COGS 14B,A01,083073,Cheng; Tzu-Han,0,7,50,50
1650187330253,COGS 17,A01,092677,Staff,34,0,75,41
1650187336278,COGS 100,A01,083619,Staff,0,20,60,60
1650187342303,COGS 101A,A01,083621,Davis; Joshua Daniel,0,21,60,60
1650187348327,COGS 101B,A01,091572,Staff,6,0,60,54
1650187354355,COGS 101C,A01,083625,Delgado; Tania,20,0,30,10
1650187360377,COGS 107A,A01,083627,Boyle; Mary E. T.,0,7,60,60
1650187366400,COGS 118A,A01,083075,Staff,16,0,60,44
1650187372423,CSE 3,A50,083646,Miranda; Gregory Joseph,22,0,38,16
1650187372423,CSE 3,A51,083647,Miranda; Gregory Joseph,37,0,37,0
1650187378449,CSE 8A,A50,083650,Miranda; Gregory Joseph,0,17,40,40
1650187384473,CSE 11,A01,083080,Cao; Yingjun,0,68,40,40
1650187390496,CSE 12,A01,083652,Staff,0,5,100,100
1650187396520,CSE 15L,A01,083654,Staff,0,0,50,50
1650187396520,CSE 15L,A02,083655,Staff,8,0,50,42
1650187402543,CSE 20,A01,083657,Staff,53,0,80,27
1650187408571,CSE 30,A01,083084,Eldon; John,0,69,40,40
1650187414597,CSE 100,A01,083659,Cao; Yingjun,0,63,50,50
1650187420623,CSE 134B,A01,083661,Powell; Thomas Allan,0,27,65,65
1650187426655,CSE 140,A01,083663,Staff,1,0,75,74
1650187432681,CSE 140L,A01,083088,Eldon; John,0,4,75,75
1650187438706,CSE 175,A01,083665,Kumar; Rakesh,8,0,25,17
1650187444734,CSE 190,A00,092507,Dubnov; Shlomo,14,0,20,6
1650187450762,ECE 45,A01,083139,Staff,0,13,40,40
1650187456790,ECE 65,A50,083695,Staff,0,5,30,30
1650187462815,ECE 109,A01,091882,Touri; Behrouz,47,0,70,23
1650187468838,ECE 180,A00,083140,Abi Samra; Nicholas Camill,24,0,30,6
1650187468838,ECE 180,B00,083141,Abi Samra; Nicholas Camill,8,0,30,22
1650187474863,MATH 10A,A01,083735,Patchell; Gregory David,11,0,30,19
1650187474863,MATH 10A,A02,083736,Patchell; Gregory David,28,0,30,2
1650187474863,MATH 10A,A03,083737,Patchell; Gregory David,26,0,30,4
1650187480889,MATH 10B,A01,083207,Staff,0,5,30,30
1650187480889,MATH 10B,A02,083208,Staff,0,5,30,30
1650187480889,MATH 10B,B01,083739,Staff,17,0,30,13
1650187480889,MATH 10B,B02,083740,Staff,29,0,30,1
1650187486916,MATH 18,A01,083743,Staff,8,0,30,22
1650187486916,MATH 18,A02,083744,Staff,28,0,30,2
1650187486916,MATH 18,A03,083745,Staff,23,0,30,7
1650187486916,MATH 18,A04,083746,Staff,27,0,30,3
1650187486916,MATH 18,B01,083748,Staff,0,10,30,30
1650187486916,MATH 18,B02,083749,Staff,0,7,30,30
1650187486916,MATH 18,B03,083750,Staff,0,7,30,30
1650187486916,MATH 18,B04,083751,Staff,0,7,30,30
1650187492941,MATH 20A,A01,083754,Staff,26,0,40,14
1650187498966,MATH 20B,A01,083756,Staff,0,6,30,30
1650187498966,MATH 20B,A02,083757,Staff,0,6,30,30
1650187504992,MATH 20C,A01,083760,Staff,0,12,30,30
1650187504992,MATH 20C,A02,083761,Staff,0,12,30,30
1650187504992,MATH 20C,B01,083762,Staff,14,0,30,16
1650187504992,MATH 20C,B02,083763,Staff,28,0,30,2
1650187511020,MATH 20D,A01,083765,Staff,1,2,30,29
1650187511020,MATH 20D,A02,083766,Staff,10,0,30,20
1650187511020,MATH 20D,A03,083767,Staff,28,0,30,2
1650187517049,MATH 20E,A01,083771,Staff,8,0,30,22
1650187517049,MATH 20E,A02,083772,Staff,20,0,30,10
1650187517049,MATH 20E,B01,083773,Staff,0,0,30,30
1650187517049,MATH 20E,B02,083774,Staff,12,0,30,18
1650187523074,MATH 103A,A01,083777,Staff,0,9,30,30
1650187523074,MATH 103A,A02,083778,Staff,0,10,30,30
1650187523074,MATH 103A,B01,083779,Staff,0,9,30,30
1650187523074,MATH 103A,B02,083780,Staff,0,9,30,30
1650187529099,MATH 105,A01,085443,Staff,0,17,30,30
1650187535136,MATH 109,A01,083213,Anzaldo; Leesa B,0,3,30,30
1650187535136,MATH 109,A02,083214,Anzaldo; Leesa B,0,6,30,30
1650187535136,MATH 109,B01,083215,Anzaldo; Leesa B,0,4,30,30
1650187535136,MATH 109,B02,083216,Anzaldo; Leesa B,0,4,30,30
1650187541163,MATH 142A,A01,083219,Chow; Bennett,0,12,30,30
1650187541163,MATH 142A,A02,083220,Chow; Bennett,0,11,30,30
1650187541163,MATH 142A,B01,083221,Chow; Bennett,0,11,30,30
1650187541163,MATH 142A,B02,083222,Chow; Bennett,0,12,30,30
1650187547187,MATH 193A,A01,083224,Staff,0,4,30,30
1650187547187,MATH 193A,A02,083225,Staff,0,4,30,30
1650187547187,MATH 193A,A03,083781,Staff,0,2,30,30
1650187547187,MATH 193A,A04,083782,Staff,0,1,30,30
1650187553210,MATH 197,001,091859,McAuley; Julian John,9998,0,9999,1
1650187559266,COGS 9,A01,083615,Staff,0,14,60,60
1650187565291,COGS 11,A01,083617,Boyle; Mary E. T.,24,0,40,16
1650187571316,COGS 13,A01,083071,Staff,0,30,40,40
1650187577340,COGS 14A,A01,092681,Staff,0,12,100,100
1650187583368,COGS 14B,A01,083073,Cheng; Tzu-Han,0,7,50,50
1650187589395,COGS 17,A01,092677,Staff,34,0,75,41
1650187595423,COGS 100,A01,083619,Staff,0,20,60,60
1650187601451,COGS 101A,A01,083621,Davis; Joshua Daniel,0,21,60,60
1650187607479,COGS 101B,A01,091572,Staff,6,0,60,54
1650187613505,COGS 101C,A01,083625,Delgado; Tania,20,0,30,10
1650187619529,COGS 107A,A01,083627,Boyle; Mary E. T.,0,7,60,60
1650187625555,COGS 118A,A01,083075,Staff,16,0,60,44
1650187631669,CSE 3,A50,083646,Miranda; Gregory Joseph,22,0,38,16
1650187631669,CSE 3,A51,083647,Miranda; Gregory Joseph,37,0,37,0
1650187637694,CSE 8A,A50,083650,Miranda; Gregory Joseph,0,17,40,40
1650187643723,CSE 11,A01,083080,Cao; Yingjun,0,68,40,40
1650187649751,CSE 12,A01,083652,Staff,0,5,100,100
1650187655783,CSE 15L,A01,083654,Staff,0,0,50,50
1650187655783,CSE 15L,A02,083655,Staff,8,0,50,42
1650187661806,CSE 20,A01,083657,Staff,53,0,80,27
1650187667832,CSE 30,A01,083084,Eldon; John,0,69,40,40
1650187673857,CSE 100,A01,083659,Cao; Yingjun,0,63,50,50
1650187679885,CSE 134B,A01,083661,Powell; Thomas Allan,0,27,65,65
1650187685910,CSE 140,A01,083663,Staff,1,0,75,74
1650187691938,CSE 140L,A01,083088,Eldon; John,0,4,75,75
1650187697962,CSE 175,A01,083665,Kumar; Rakesh,8,0,25,17
1650187703988,CSE 190,A00,092507,Dubnov; Shlomo,14,0,20,6
1650187710015,ECE 45,A01,083139,Staff,0,13,40,40
1650187716040,ECE 65,A50,083695,Staff,0,5,30,30
1650187722069,ECE 109,A01,091882,Touri; Behrouz,47,0,70,23
1650187728093,ECE 180,A00,083140,Abi Samra; Nicholas Camill,24,0,30,6
1650187728093,ECE 180,B00,083141,Abi Samra; Nicholas Camill,8,0,30,22
1650187734119,MATH 10A,A01,083735,Patchell; Gregory David,11,0,30,19
1650187734119,MATH 10A,A02,083736,Patchell; Gregory David,28,0,30,2
1650187734119,MATH 10A,A03,083737,Patchell; Gregory David,26,0,30,4
1650187740151,MATH 10B,A01,083207,Staff,0,5,30,30
1650187740151,MATH 10B,A02,083208,Staff,0,5,30,30
1650187740151,MATH 10B,B01,083739,Staff,17,0,30,13
1650187740151,MATH 10B,B02,083740,Staff,29,0,30,1
1650187746178,MATH 18,A01,083743,Staff,8,0,30,22
1650187746178,MATH 18,A02,083744,Staff,28,0,30,2
1650187746178,MATH 18,A03,083745,Staff,23,0,30,7
1650187746178,MATH 18,A04,083746,Staff,27,0,30,3
1650187746178,MATH 18,B01,083748,Staff,0,10,30,30
1650187746178,MATH 18,B02,083749,Staff,0,7,30,30
1650187746178,MATH 18,B03,083750,Staff,0,7,30,30
1650187746178,MATH 18,B04,083751,Staff,0,7,30,30
1650187752199,MATH 20A,A01,083754,Staff,26,0,40,14
1650187758223,MATH 20B,A01,083756,Staff,0,6,30,30
1650187758223,MATH 20B,A02,083757,Staff,0,6,30,30
1650187764251,MATH 20C,A01,083760,Staff,0,12,30,30
1650187764251,MATH 20C,A02,083761,Staff,0,12,30,30
1650187764251,MATH 20C,B01,083762,Staff,14,0,30,16
1650187764251,MATH 20C,B02,083763,Staff,28,0,30,2
1650187770276,MATH 20D,A01,083765,Staff,1,2,30,29
1650187770276,MATH 20D,A02,083766,Staff,10,0,30,20
1650187770276,MATH 20D,A03,083767,Staff,28,0,30,2
1650187776308,MATH 20E,A01,083771,Staff,8,0,30,22
1650187776308,MATH 20E,A02,083772,Staff,20,0,30,10
1650187776308,MATH 20E,B01,083773,Staff,0,0,30,30
1650187776308,MATH 20E,B02,083774,Staff,12,0,30,18
1650187782336,MATH 103A,A01,083777,Staff,0,9,30,30
1650187782336,MATH 103A,A02,083778,Staff,0,10,30,30
1650187782336,MATH 103A,B01,083779,Staff,0,9,30,30
1650187782336,MATH 103A,B02,083780,Staff,0,9,30,30
1650187788362,MATH 105,A01,085443,Staff,0,17,30,30
1650187794392,MATH 109,A01,083213,Anzaldo; Leesa B,0,3,30,30
1650187794392,MATH 109,A02,083214,Anzaldo; Leesa B,0,6,30,30
1650187794392,MATH 109,B01,083215,Anzaldo; Leesa B,0,4,30,30
1650187794392,MATH 109,B02,083216,Anzaldo; Leesa B,0,4,30,30
1650187800421,MATH 142A,A01,083219,Chow; Bennett,0,12,30,30
1650187800421,MATH 142A,A02,083220,Chow; Bennett,0,11,30,30
1650187800421,MATH 142A,B01,083221,Chow; Bennett,0,11,30,30
1650187800421,MATH 142A,B02,083222,Chow; Bennett,0,12,30,30
1650187806445,MATH 193A,A01,083224,Staff,0,4,30,30
1650187806445,MATH 193A,A02,083225,Staff,0,4,30,30
1650187806445,MATH 193A,A03,083781,Staff,0,2,30,30
1650187806445,MATH 193A,A04,083782,Staff,0,1,30,30
1650187812470,MATH 197,001,091859,McAuley; Julian John,9998,0,9999,1
1650187818528,COGS 9,A01,083615,Staff,0,14,60,60
1650187824555,COGS 11,A01,083617,Boyle; Mary E. T.,24,0,40,16
1650187830583,COGS 13,A01,083071,Staff,0,30,40,40
1650187836606,COGS 14A,A01,092681,Staff,0,12,100,100
1650187842629,COGS 14B,A01,083073,Cheng; Tzu-Han,0,7,50,50
1650187848652,COGS 17,A01,092677,Staff,34,0,75,41
1650187854687,COGS 100,A01,083619,Staff,0,20,60,60
1650187860712,COGS 101A,A01,083621,Davis; Joshua Daniel,0,21,60,60
1650187866741,COGS 101B,A01,091572,Staff,6,0,60,54
1650187872769,COGS 101C,A01,083625,Delgado; Tania,20,0,30,10
1650187878794,COGS 107A,A01,083627,Boyle; Mary E. T.,0,7,60,60
1650187884818,COGS 118A,A01,083075,Staff,16,0,60,44
1650187890847,CSE 3,A50,083646,Miranda; Gregory Joseph,22,0,38,16
1650187890847,CSE 3,A51,083647,Miranda; Gregory Joseph,37,0,37,0
1650187896871,CSE 8A,A50,083650,Miranda; Gregory Joseph,0,17,40,40
1650187902895,CSE 11,A01,083080,Cao; Yingjun,0,68,40,40
1650187908926,CSE 12,A01,083652,Staff,0,5,100,100
1650187914954,CSE 15L,A01,083654,Staff,0,0,50,50
1650187914954,CSE 15L,A02,083655,Staff,8,0,50,42
1650187920981,CSE 20,A01,083657,Staff,53,0,80,27
1650187927005,CSE 30,A01,083084,Eldon; John,0,69,40,40
1650187933038,CSE 100,A01,083659,Cao; Yingjun,0,63,50,50
1650187939061,CSE 134B,A01,083661,Powell; Thomas Allan,0,27,65,65
1650187945089,CSE 140,A01,083663,Staff,1,0,75,74
1650187951119,CSE 140L,A01,083088,Eldon; John,0,4,75,75
1650187957142,CSE 175,A01,083665,Kumar; Rakesh,8,0,25,17
1650187963169,CSE 190,A00,092507,Dubnov; Shlomo,14,0,20,6
1650187969196,ECE 45,A01,083139,Staff,0,13,40,40
1650187975221,ECE 65,A50,083695,Staff,0,5,30,30
1650187981248,ECE 109,A01,091882,Touri; Behrouz,47,0,70,23
1650187987271,ECE 180,A00,083140,Abi Samra; Nicholas Camill,24,0,30,6
1650187987271,ECE 180,B00,083141,Abi Samra; Nicholas Camill,8,0,30,22
1650187993295,MATH 10A,A01,083735,Patchell; Gregory David,11,0,30,19
1650187993295,MATH 10A,A02,083736,Patchell; Gregory David,28,0,30,2
1650187993295,MATH 10A,A03,083737,Patchell; Gregory David,26,0,30,4
1650187999320,MATH 10B,A01,083207,Staff,0,5,30,30
1650187999320,MATH 10B,A02,083208,Staff,0,5,30,30
1650187999320,MATH 10B,B01,083739,Staff,17,0,30,13
1650187999320,MATH 10B,B02,083740,Staff,29,0,30,1
1650188005349,MATH 18,A01,083743,Staff,8,0,30,22
1650188005349,MATH 18,A02,083744,Staff,28,0,30,2
1650188005349,MATH 18,A03,083745,Staff,23,0,30,7
1650188005349,MATH 18,A04,083746,Staff,27,0,30,3
1650188005349,MATH 18,B01,083748,Staff,0,10,30,30
1650188005349,MATH 18,B02,083749,Staff,0,7,30,30
1650188005349,MATH 18,B03,083750,Staff,0,7,30,30
1650188005349,MATH 18,B04,083751,Staff,0,7,30,30
1650188011371,MATH 20A,A01,083754,Staff,26,0,40,14
1650188017395,MATH 20B,A01,083756,Staff,0,6,30,30
1650188017395,MATH 20B,A02,083757,Staff,0,6,30,30
1650188023423,MATH 20C,A01,083760,Staff,0,12,30,30
1650188023423,MATH 20C,A02,083761,Staff,0,12,30,30
1650188023423,MATH 20C,B01,083762,Staff,14,0,30,16
1650188023423,MATH 20C,B02,083763,Staff,28,0,30,2
1650188029447,MATH 20D,A01,083765,Staff,1,2,30,29
1650188029447,MATH 20D,A02,083766,Staff,10,0,30,20
1650188029447,MATH 20D,A03,083767,Staff,28,0,30,2
1650188035475,MATH 20E,A01,083771,Staff,8,0,30,22
1650188035475,MATH 20E,A02,083772,Staff,20,0,30,10
1650188035475,MATH 20E,B01,083773,Staff,0,0,30,30
1650188035475,MATH 20E,B02,083774,Staff,12,0,30,18
1650188041506,MATH 103A,A01,083777,Staff,0,9,30,30
1650188041506,MATH 103A,A02,083778,Staff,0,10,30,30
1650188041506,MATH 103A,B01,083779,Staff,0,9,30,30
1650188041506,MATH 103A,B02,083780,Staff,0,9,30,30
1650188047533,MATH 105,A01,085443,Staff,0,17,30,30
1650188053562,MATH 109,A01,083213,Anzaldo; Leesa B,0,3,30,30
1650188053562,MATH 109,A02,083214,Anzaldo; Leesa B,0,6,30,30
1650188053562,MATH 109,B01,083215,Anzaldo; Leesa B,0,4,30,30
1650188053562,MATH 109,B02,083216,Anzaldo; Leesa B,0,4,30,30
1650188059587,MATH 142A,A01,083219,Chow; Bennett,0,12,30,30
1650188059587,MATH 142A,A02,083220,Chow; Bennett,0,11,30,30
1650188059587,MATH 142A,B01,083221,Chow; Bennett,0,11,30,30
1650188059587,MATH 142A,B02,083222,Chow; Bennett,0,12,30,30
1650188065613,MATH 193A,A01,083224,Staff,0,4,30,30
1650188065613,MATH 193A,A02,083225,Staff,0,4,30,30
1650188065613,MATH 193A,A03,083781,Staff,0,2,30,30
1650188065613,MATH 193A,A04,083782,Staff,0,1,30,30
1650188071640,MATH 197,001,091859,McAuley; Julian John,9998,0,9999,1
1650188077709,COGS 9,A01,083615,Staff,0,14,60,60
1650188083733,COGS 11,A01,083617,Boyle; Mary E. T.,24,0,40,16
1650188089760,COGS 13,A01,083071,Staff,0,30,40,40
1650188095787,COGS 14A,A01,092681,Staff,0,12,100,100
1650188101829,COGS 14B,A01,083073,Cheng; Tzu-Han,0,7,50,50
1650188107852,COGS 17,A01,092677,Staff,34,0,75,41
1650188113876,COGS 100,A01,083619,Staff,0,20,60,60
1650188119905,COGS 101A,A01,083621,Davis; Joshua Daniel,0,21,60,60
1650188125932,COGS 101B,A01,091572,Staff,6,0,60,54
1650188131958,COGS 101C,A01,083625,Delgado; Tania,20,0,30,10
1650188137985,COGS 107A,A01,083627,Boyle; Mary E. T.,0,7,60,60
1650188144008,COGS 118A,A01,083075,Staff,16,0,60,44
1650188150032,CSE 3,A50,083646,Miranda; Gregory Joseph,22,0,38,16
1650188150032,CSE 3,A51,083647,Miranda; Gregory Joseph,37,0,37,0
1650188156059,CSE 8A,A50,083650,Miranda; Gregory Joseph,0,17,40,40
1650188162083,CSE 11,A01,083080,Cao; Yingjun,0,68,40,40
1650188168107,CSE 12,A01,083652,Staff,0,5,100,100
1650188174134,CSE 15L,A01,083654,Staff,0,0,50,50
1650188174134,CSE 15L,A02,083655,Staff,8,0,50,42
1650188180158,CSE 20,A01,083657,Staff,53,0,80,27
1650188186184,CSE 30,A01,083084,Eldon; John,0,69,40,40
1650188192209,CSE 100,A01,083659,Cao; Yingjun,0,63,50,50
1650188198232,CSE 134B,A01,083661,Powell; Thomas Allan,0,27,65,65
1650188204256,CSE 140,A01,083663,Staff,1,0,75,74
1650188210281,CSE 140L,A01,083088,Eldon; John,0,4,75,75
1650188216308,CSE 175,A01,083665,Kumar; Rakesh,8,0,25,17
1650188222334,CSE 190,A00,092507,Dubnov; Shlomo,14,0,20,6
1650188228480,ECE 45,A01,083139,Staff,0,13,40,40
1650188234504,ECE 65,A50,083695,Staff,0,5,30,30
1650188240543,ECE 109,A01,091882,Touri; Behrouz,47,0,70,23
1650188246581,ECE 180,A00,083140,Abi Samra; Nicholas Camill,24,0,30,6
1650188246581,ECE 180,B00,083141,Abi Samra; Nicholas Camill,8,0,30,22
1650188252607,MATH 10A,A01,083735,Patchell; Gregory David,11,0,30,19
1650188252607,MATH 10A,A02,083736,Patchell; Gregory David,28,0,30,2
1650188252607,MATH 10A,A03,083737,Patchell; Gregory David,26,0,30,4
1650188258632,MATH 10B,A01,083207,Staff,0,5,30,30
1650188258632,MATH 10B,A02,083208,Staff,0,5,30,30
1650188258632,MATH 10B,B01,083739,Staff,17,0,30,13
1650188258632,MATH 10B,B02,083740,Staff,29,0,30,1
1650188264677,MATH 18,A01,083743,Staff,8,0,30,22
1650188264677,MATH 18,A02,083744,Staff,28,0,30,2
1650188264677,MATH 18,A03,083745,Staff,23,0,30,7
1650188264677,MATH 18,A04,083746,Staff,27,0,30,3
1650188264677,MATH 18,B01,083748,Staff,0,10,30,30
1650188264677,MATH 18,B02,083749,Staff,0,7,30,30
1650188264677,MATH 18,B03,083750,Staff,0,7,30,30
1650188264677,MATH 18,B04,083751,Staff,0,7,30,30
1650188270704,MATH 20A,A01,083754,Staff,26,0,40,14
1650188276728,MATH 20B,A01,083756,Staff,0,6,30,30
1650188276728,MATH 20B,A02,083757,Staff,0,6,30,30
1650188282761,MATH 20C,A01,083760,Staff,0,12,30,30
1650188282761,MATH 20C,A02,083761,Staff,0,12,30,30
1650188282761,MATH 20C,B01,083762,Staff,14,0,30,16
1650188282761,MATH 20C,B02,083763,Staff,28,0,30,2
1650188288790,MATH 20D,A01,083765,Staff,1,2,30,29
1650188288790,MATH 20D,A02,083766,Staff,10,0,30,20
1650188288790,MATH 20D,A03,083767,Staff,28,0,30,2
1650188294826,MATH 20E,A01,083771,Staff,8,0,30,22
1650188294826,MATH 20E,A02,083772,Staff,20,0,30,10
1650188294826,MATH 20E,B01,083773,Staff,0,0,30,30
1650188294826,MATH 20E,B02,083774,Staff,12,0,30,18
1650188300852,MATH 103A,A01,083777,Staff,0,9,30,30
1650188300852,MATH 103A,A02,083778,Staff,0,10,30,30
1650188300852,MATH 103A,B01,083779,Staff,0,9,30,30
1650188300852,MATH 103A,B02,083780,Staff,0,9,30,30
1650188306874,MATH 105,A01,085443,Staff,0,17,30,30
1650188312897,MATH 109,A01,083213,Anzaldo; Leesa B,0,3,30,30
1650188312897,MATH 109,A02,083214,Anzaldo; Leesa B,0,6,30,30
1650188312897,MATH 109,B01,083215,Anzaldo; Leesa B,0,4,30,30
1650188312897,MATH 109,B02,083216,Anzaldo; Leesa B,0,4,30,30
1650188318925,MATH 142A,A01,083219,Chow; Bennett,0,12,30,30
1650188318925,MATH 142A,A02,083220,Chow; Bennett,0,11,30,30
1650188318925,MATH 142A,B01,083221,Chow; Bennett,0,11,30,30
1650188318925,MATH 142A,B02,083222,Chow; Bennett,0,12,30,30
1650188324950,MATH 193A,A01,083224,Staff,0,4,30,30
1650188324950,MATH 193A,A02,083225,Staff,0,4,30,30
1650188324950,MATH 193A,A03,083781,Staff,0,2,30,30
1650188324950,MATH 193A,A04,083782,Staff,0,1,30,30
1650188330978,MATH 197,001,091859,McAuley; Julian John,9998,0,9999,1
1650188337031,COGS 9,A01,083615,Staff,0,14,60,60
1650188343056,COGS 11,A01,083617,Boyle; Mary E. T.,24,0,40,16
1650188349080,COGS 13,A01,083071,Staff,0,30,40,40
1650188355104,COGS 14A,A01,092681,Staff,0,12,100,100
1650188361132,COGS 14B,A01,083073,Cheng; Tzu-Han,0,7,50,50
1650188367157,COGS 17,A01,092677,Staff,34,0,75,41
1650188373183,COGS 100,A01,083619,Staff,0,20,60,60
1650188379206,COGS 101A,A01,083621,Davis; Joshua Daniel,0,21,60,60
1650188385231,COGS 101B,A01,091572,Staff,6,0,60,54
1650188391254,COGS 101C,A01,083625,Delgado; Tania,20,0,30,10
1650188397277,COGS 107A,A01,083627,Boyle; Mary E. T.,0,7,60,60
1650188403302,COGS 118A,A01,083075,Staff,16,0,60,44
1650188409324,CSE 3,A50,083646,Miranda; Gregory Joseph,22,0,38,16
1650188409324,CSE 3,A51,083647,Miranda; Gregory Joseph,37,0,37,0
1650188415352,CSE 8A,A50,083650,Miranda; Gregory Joseph,0,17,40,40
1650188421378,CSE 11,A01,083080,Cao; Yingjun,0,68,40,40
1650188427402,CSE 12,A01,083652,Staff,0,5,100,100
1650188433423,CSE 15L,A01,083654,Staff,0,0,50,50
1650188433423,CSE 15L,A02,083655,Staff,8,0,50,42
1650188439449,CSE 20,A01,083657,Staff,53,0,80,27
1650188445475,CSE 30,A01,083084,Eldon; John,0,69,40,40
1650188451576,CSE 100,A01,083659,Cao; Yingjun,0,63,50,50
1650188457600,CSE 134B,A01,083661,Powell; Thomas Allan,0,27,65,65
1650188463626,CSE 140,A01,083663,Staff,1,0,75,74
1650188469650,CSE 140L,A01,083088,Eldon; John,0,4,75,75
1650188475680,CSE 175,A01,083665,Kumar; Rakesh,8,0,25,17
1650188481706,CSE 190,A00,092507,Dubnov; Shlomo,14,0,20,6
1650188487730,ECE 45,A01,083139,Staff,0,13,40,40
1650188493775,ECE 65,A50,083695,Staff,0,5,30,30
1650188499802,ECE 109,A01,091882,Touri; Behrouz,47,0,70,23
1650188505826,ECE 180,A00,083140,Abi Samra; Nicholas Camill,24,0,30,6
1650188505826,ECE 180,B00,083141,Abi Samra; Nicholas Camill,8,0,30,22
1650188511855,MATH 10A,A01,083735,Patchell; Gregory David,11,0,30,19
1650188511855,MATH 10A,A02,083736,Patchell; Gregory David,28,0,30,2
1650188511855,MATH 10A,A03,083737,Patchell; Gregory David,26,0,30,4
1650188517879,MATH 10B,A01,083207,Staff,0,5,30,30
1650188517879,MATH 10B,A02,083208,Staff,0,5,30,30
1650188517879,MATH 10B,B01,083739,Staff,17,0,30,13
1650188517879,MATH 10B,B02,083740,Staff,29,0,30,1
1650188523910,MATH 18,A01,083743,Staff,8,0,30,22
1650188523910,MATH 18,A02,083744,Staff,28,0,30,2
1650188523910,MATH 18,A03,083745,Staff,23,0,30,7
1650188523910,MATH 18,A04,083746,Staff,27,0,30,3
1650188523910,MATH 18,B01,083748,Staff,0,10,30,30
1650188523910,MATH 18,B02,083749,Staff,0,7,30,30
1650188523910,MATH 18,B03,083750,Staff,0,7,30,30
1650188523910,MATH 18,B04,083751,Staff,0,8,30,30
1650188529935,MATH 20A,A01,083754,Staff,26,0,40,14
1650188535958,MATH 20B,A01,083756,Staff,0,6,30,30
1650188535958,MATH 20B,A02,083757,Staff,0,6,30,30
1650188541982,MATH 20C,A01,083760,Staff,0,12,30,30
1650188541982,MATH 20C,A02,083761,Staff,0,12,30,30
1650188541982,MATH 20C,B01,083762,Staff,14,0,30,16
1650188541982,MATH 20C,B02,083763,Staff,28,0,30,2
1650188548006,MATH 20D,A01,083765,Staff,1,2,30,29
1650188548006,MATH 20D,A02,083766,Staff,10,0,30,20
1650188548006,MATH 20D,A03,083767,Staff,28,0,30,2
1650188554030,MATH 20E,A01,083771,Staff,8,0,30,22
1650188554030,MATH 20E,A02,083772,Staff,20,0,30,10
1650188554030,MATH 20E,B01,083773,Staff,0,0,30,30
1650188554030,MATH 20E,B02,083774,Staff,12,0,30,18
1650188560055,MATH 103A,A01,083777,Staff,0,9,30,30
1650188560055,MATH 103A,A02,083778,Staff,0,10,30,30
1650188560055,MATH 103A,B01,083779,Staff,0,9,30,30
1650188560055,MATH 103A,B02,083780,Staff,0,9,30,30
1650188566083,MATH 105,A01,085443,Staff,0,17,30,30
1650188572105,MATH 109,A01,083213,Anzaldo; Leesa B,0,3,30,30
1650188572105,MATH 109,A02,083214,Anzaldo; Leesa B,0,6,30,30
1650188572105,MATH 109,B01,083215,Anzaldo; Leesa B,0,4,30,30
1650188572105,MATH 109,B02,083216,Anzaldo; Leesa B,0,4,30,30
1650188578142,MATH 142A,A01,083219,Chow; Bennett,0,12,30,30
1650188578142,MATH 142A,A02,083220,Chow; Bennett,0,11,30,30
1650188578142,MATH 142A,B01,083221,Chow; Bennett,0,11,30,30
1650188578142,MATH 142A,B02,083222,Chow; Bennett,0,12,30,30
1650188584169,MATH 193A,A01,083224,Staff,0,4,30,30
1650188584169,MATH 193A,A02,083225,Staff,0,4,30,30
1650188584169,MATH 193A,A03,083781,Staff,0,2,30,30
1650188584169,MATH 193A,A04,083782,Staff,0,1,30,30
1650188590193,MATH 197,001,091859,McAuley; Julian John,9998,0,9999,1
1650188596244,COGS 9,A01,083615,Staff,0,14,60,60
1650188602269,COGS 11,A01,083617,Boyle; Mary E. T.,24,0,40,16
1650188608293,COGS 13,A01,083071,Staff,0,30,40,40
1650188614316,COGS 14A,A01,092681,Staff,0,12,100,100
1650188620341,COGS 14B,A01,083073,Cheng; Tzu-Han,0,7,50,50
1650188626365,COGS 17,A01,092677,Staff,34,0,75,41
1650188632393,COGS 100,A01,083619,Staff,0,20,60,60
1650188638419,COGS 101A,A01,083621,Davis; Joshua Daniel,0,21,60,60
1650188644444,COGS 101B,A01,091572,Staff,6,0,60,54
1650188650468,COGS 101C,A01,083625,Delgado; Tania,20,0,30,10
1650188656496,COGS 107A,A01,083627,Boyle; Mary E. T.,0,7,60,60
1650188662518,COGS 118A,A01,083075,Staff,16,0,60,44
1650188668543,CSE 3,A50,083646,Miranda; Gregory Joseph,22,0,38,16
1650188668543,CSE 3,A51,083647,Miranda; Gregory Joseph,37,0,37,0
1650188674566,CSE 8A,A50,083650,Miranda; Gregory Joseph,0,17,40,40
1650188680590,CSE 11,A01,083080,Cao; Yingjun,0,68,40,40
1650188686616,CSE 12,A01,083652,Staff,0,5,100,100
1650188692644,CSE 15L,A01,083654,Staff,0,0,50,50
1650188692644,CSE 15L,A02,083655,Staff,8,0,50,42
1650188698669,CSE 20,A01,083657,Staff,53,0,80,27
1650188704692,CSE 30,A01,083084,Eldon; John,0,69,40,40
1650188710719,CSE 100,A01,083659,Cao; Yingjun,0,63,50,50
1650188716747,CSE 134B,A01,083661,Powell; Thomas Allan,0,27,65,65
1650188722774,CSE 140,A01,083663,Staff,1,0,75,74
1650188728802,CSE 140L,A01,083088,Eldon; John,0,4,75,75
1650188734830,CSE 175,A01,083665,Kumar; Rakesh,8,0,25,17
1650188740853,CSE 190,A00,092507,Dubnov; Shlomo,14,0,20,6
1650188746892,ECE 45,A01,083139,Staff,0,13,40,40
1650188752919,ECE 65,A50,083695,Staff,0,5,30,30
1650188758945,ECE 109,A01,091882,Touri; Behrouz,47,0,70,23
1650188764972,ECE 180,A00,083140,Abi Samra; Nicholas Camill,24,0,30,6
1650188764972,ECE 180,B00,083141,Abi Samra; Nicholas Camill,8,0,30,22
1650188771001,MATH 10A,A01,083735,Patchell; Gregory David,11,0,30,19
1650188771001,MATH 10A,A02,083736,Patchell; Gregory David,28,0,30,2
1650188771001,MATH 10A,A03,083737,Patchell; Gregory David,26,0,30,4
1650188777030,MATH 10B,A01,083207,Staff,0,5,30,30
1650188777030,MATH 10B,A02,083208,Staff,0,5,30,30
1650188777030,MATH 10B,B01,083739,Staff,17,0,30,13
1650188777030,MATH 10B,B02,083740,Staff,29,0,30,1
1650188783055,MATH 18,A01,083743,Staff,8,0,30,22
1650188783055,MATH 18,A02,083744,Staff,28,0,30,2
1650188783055,MATH 18,A03,083745,Staff,23,0,30,7
1650188783055,MATH 18,A04,083746,Staff,27,0,30,3
1650188783055,MATH 18,B01,083748,Staff,0,10,30,30
1650188783055,MATH 18,B02,083749,Staff,0,7,30,30
1650188783055,MATH 18,B03,083750,Staff,0,7,30,30
1650188783055,MATH 18,B04,083751,Staff,0,8,30,30
1650188789078,MATH 20A,A01,083754,Staff,26,0,40,14
1650188795101,MATH 20B,A01,083756,Staff,0,6,30,30
1650188795101,MATH 20B,A02,083757,Staff,0,6,30,30
1650188801126,MATH 20C,A01,083760,Staff,0,12,30,30
1650188801126,MATH 20C,A02,083761,Staff,0,12,30,30
1650188801126,MATH 20C,B01,083762,Staff,14,0,30,16
1650188801126,MATH 20C,B02,083763,Staff,28,0,30,2
1650188807150,MATH 20D,A01,083765,Staff,1,2,30,29
1650188807150,MATH 20D,A02,083766,Staff,10,0,30,20
1650188807150,MATH 20D,A03,083767,Staff,28,0,30,2
1650188813179,MATH 20E,A01,083771,Staff,8,0,30,22
1650188813179,MATH 20E,A02,083772,Staff,20,0,30,10
1650188813179,MATH 20E,B01,083773,Staff,0,0,30,30
1650188813179,MATH 20E,B02,083774,Staff,12,0,30,18
1650188819203,MATH 103A,A01,083777,Staff,0,9,30,30
1650188819203,MATH 103A,A02,083778,Staff,0,10,30,30
1650188819203,MATH 103A,B01,083779,Staff,0,9,30,30
1650188819203,MATH 103A,B02,083780,Staff,0,9,30,30
1650188825318,MATH 105,A01,085443,Staff,0,17,30,30
1650188831348,MATH 109,A01,083213,Anzaldo; Leesa B,0,3,30,30
1650188831348,MATH 109,A02,083214,Anzaldo; Leesa B,0,6,30,30
1650188831348,MATH 109,B01,083215,Anzaldo; Leesa B,0,4,30,30
1650188831348,MATH 109,B02,083216,Anzaldo; Leesa B,0,4,30,30
1650188837374,MATH 142A,A01,083219,Chow; Bennett,0,12,30,30
1650188837374,MATH 142A,A02,083220,Chow; Bennett,0,11,30,30
1650188837374,MATH 142A,B01,083221,Chow; Bennett,0,11,30,30
1650188837374,MATH 142A,B02,083222,Chow; Bennett,0,12,30,30
1650188843403,MATH 193A,A01,083224,Staff,0,4,30,30
1650188843403,MATH 193A,A02,083225,Staff,0,4,30,30
1650188843403,MATH 193A,A03,083781,Staff,0,2,30,30
1650188843403,MATH 193A,A04,083782,Staff,0,1,30,30
1650188849428,MATH 197,001,091859,McAuley; Julian John,9998,0,9999,1
1650188855486,COGS 9,A01,083615,Staff,0,14,60,60
1650188861511,COGS 11,A01,083617,Boyle; Mary E. T.,24,0,40,16
1650188867536,COGS 13,A01,083071,Staff,0,30,40,40
1650188873561,COGS 14A,A01,092681,Staff,0,12,100,100
1650188879586,COGS 14B,A01,083073,Cheng; Tzu-Han,0,7,50,50
1650188885610,COGS 17,A01,092677,Staff,35,0,75,40
1650188891637,COGS 100,A01,083619,Staff,0,20,60,60
1650188897660,COGS 101A,A01,083621,Davis; Joshua Daniel,0,21,60,60
1650188903686,COGS 101B,A01,091572,Staff,6,0,60,54
1650188909715,COGS 101C,A01,083625,Delgado; Tania,20,0,30,10
1650188915742,COGS 107A,A01,083627,Boyle; Mary E. T.,0,7,60,60
1650188921764,COGS 118A,A01,083075,Staff,16,0,60,44
1650188927796,CSE 3,A50,083646,Miranda; Gregory Joseph,22,0,38,16
1650188927796,CSE 3,A51,083647,Miranda; Gregory Joseph,37,0,37,0
1650188933820,CSE 8A,A50,083650,Miranda; Gregory Joseph,0,17,40,40
1650188939843,CSE 11,A01,083080,Cao; Yingjun,0,68,40,40
1650188945875,CSE 12,A01,083652,Staff,0,5,100,100
1650188951900,CSE 15L,A01,083654,Staff,0,0,50,50
1650188951900,CSE 15L,A02,083655,Staff,8,0,50,42
1650188957928,CSE 20,A01,083657,Staff,53,0,80,27
1650188963962,CSE 30,A01,083084,Eldon; John,0,69,40,40
1650188969987,CSE 100,A01,083659,Cao; Yingjun,0,63,50,50
1650188976011,CSE 134B,A01,083661,Powell; Thomas Allan,0,27,65,65
1650188982034,CSE 140,A01,083663,Staff,1,0,75,74
1650188988058,CSE 140L,A01,083088,Eldon; John,0,4,75,75
1650188994085,CSE 175,A01,083665,Kumar; Rakesh,8,0,25,17
1650189000114,CSE 190,A00,092507,Dubnov; Shlomo,14,0,20,6
1650189006137,ECE 45,A01,083139,Staff,0,13,40,40
1650189012164,ECE 65,A50,083695,Staff,0,5,30,30
1650189018189,ECE 109,A01,091882,Touri; Behrouz,47,0,70,23
1650189024215,ECE 180,A00,083140,Abi Samra; Nicholas Camill,24,0,30,6
1650189024215,ECE 180,B00,083141,Abi Samra; Nicholas Camill,8,0,30,22
1650189030239,MATH 10A,A01,083735,Patchell; Gregory David,11,0,30,19
1650189030239,MATH 10A,A02,083736,Patchell; Gregory David,28,0,30,2
1650189030239,MATH 10A,A03,083737,Patchell; Gregory David,26,0,30,4
1650189036268,MATH 10B,A01,083207,Staff,0,5,30,30
1650189036268,MATH 10B,A02,083208,Staff,0,5,30,30
1650189036268,MATH 10B,B01,083739,Staff,17,0,30,13
1650189036268,MATH 10B,B02,083740,Staff,29,0,30,1
1650189042309,MATH 18,A01,083743,Staff,8,0,30,22
1650189042309,MATH 18,A02,083744,Staff,28,0,30,2
1650189042309,MATH 18,A03,083745,Staff,23,0,30,7
1650189042309,MATH 18,A04,083746,Staff,27,0,30,3
1650189042309,MATH 18,B01,083748,Staff,0,10,30,30
1650189042309,MATH 18,B02,083749,Staff,0,7,30,30
1650189042309,MATH 18,B03,083750,Staff,0,7,30,30
1650189042309,MATH 18,B04,083751,Staff,0,8,30,30
1650189048335,MATH 20A,A01,083754,Staff,26,0,40,14
1650189054372,MATH 20B,A01,083756,Staff,0,6,30,30
1650189054372,MATH 20B,A02,083757,Staff,0,6,30,30
1650189060400,MATH 20C,A01,083760,Staff,0,12,30,30
1650189060400,MATH 20C,A02,083761,Staff,0,12,30,30
1650189060400,MATH 20C,B01,083762,Staff,14,0,30,16
1650189060400,MATH 20C,B02,083763,Staff,28,0,30,2
1650189066443,MATH 20D,A01,083765,Staff,1,2,30,29
1650189066443,MATH 20D,A02,083766,Staff,10,0,30,20
1650189066443,MATH 20D,A03,083767,Staff,28,0,30,2
1650189072466,MATH 20E,A01,083771,Staff,8,0,30,22
1650189072466,MATH 20E,A02,083772,Staff,20,0,30,10
1650189072466,MATH 20E,B01,083773,Staff,0,0,30,30
1650189072466,MATH 20E,B02,083774,Staff,12,0,30,18
1650189078489,MATH 103A,A01,083777,Staff,0,9,30,30
1650189078489,MATH 103A,A02,083778,Staff,0,10,30,30
1650189078489,MATH 103A,B01,083779,Staff,0,9,30,30
1650189078489,MATH 103A,B02,083780,Staff,0,9,30,30
1650189084513,MATH 105,A01,085443,Staff,0,17,30,30
1650189090537,MATH 109,A01,083213,Anzaldo; Leesa B,0,3,30,30
1650189090537,MATH 109,A02,083214,Anzaldo; Leesa B,0,6,30,30
1650189090537,MATH 109,B01,083215,Anzaldo; Leesa B,0,4,30,30
1650189090537,MATH 109,B02,083216,Anzaldo; Leesa B,0,4,30,30
1650189096572,MATH 142A,A01,083219,Chow; Bennett,0,12,30,30
1650189096572,MATH 142A,A02,083220,Chow; Bennett,0,11,30,30
1650189096572,MATH 142A,B01,083221,Chow; Bennett,0,11,30,30
1650189096572,MATH 142A,B02,083222,Chow; Bennett,0,12,30,30
1650189102595,MATH 193A,A01,083224,Staff,0,4,30,30
1650189102595,MATH 193A,A02,083225,Staff,0,4,30,30
1650189102595,MATH 193A,A03,083781,Staff,0,2,30,30
1650189102595,MATH 193A,A04,083782,Staff,0,1,30,30
1650189108620,MATH 197,001,091859,McAuley; Julian John,9998,0,9999,1
1650189114683,COGS 9,A01,083615,Staff,0,14,60,60
1650189120710,COGS 11,A01,083617,Boyle; Mary E. T.,24,0,40,16
1650189126733,COGS 13,A01,083071,Staff,0,30,40,40
1650189132756,COGS 14A,A01,092681,Staff,0,12,100,100
1650189138781,COGS 14B,A01,083073,Cheng; Tzu-Han,0,7,50,50
1650189144816,COGS 17,A01,092677,Staff,35,0,75,40
1650189150842,COGS 100,A01,083619,Staff,0,20,60,60
1650189156870,COGS 101A,A01,083621,Davis; Joshua Daniel,0,21,60,60
1650189162895,COGS 101B,A01,091572,Staff,6,0,60,54
1650189168919,COGS 101C,A01,083625,Delgado; Tania,20,0,30,10
1650189174947,COGS 107A,A01,083627,Boyle; Mary E. T.,0,7,60,60
1650189180973,COGS 118A,A01,083075,Staff,16,0,60,44
1650189186998,CSE 3,A50,083646,Miranda; Gregory Joseph,22,0,38,16
1650189186998,CSE 3,A51,083647,Miranda; Gregory Joseph,37,0,37,0
1650189193027,CSE 8A,A50,083650,Miranda; Gregory Joseph,0,17,40,40
1650189199066,CSE 11,A01,083080,Cao; Yingjun,0,68,40,40
1650189205093,CSE 12,A01,083652,Staff,0,5,100,100
1650189211118,CSE 15L,A01,083654,Staff,0,0,50,50
1650189211118,CSE 15L,A02,083655,Staff,8,0,50,42
1650189217143,CSE 20,A01,083657,Staff,53,0,80,27
1650189223170,CSE 30,A01,083084,Eldon; John,0,69,40,40
1650189229198,CSE 100,A01,083659,Cao; Yingjun,0,63,50,50
1650189235222,CSE 134B,A01,083661,Powell; Thomas Allan,0,27,65,65
1650189241245,CSE 140,A01,083663,Staff,1,0,75,74
1650189247269,CSE 140L,A01,083088,Eldon; John,0,4,75,75
1650189253292,CSE 175,A01,083665,Kumar; Rakesh,8,0,25,17
1650189259320,CSE 190,A00,092507,Dubnov; Shlomo,14,0,20,6
1650189265344,ECE 45,A01,083139,Staff,0,13,40,40
1650189271373,ECE 65,A50,083695,Staff,0,5,30,30
1650189277400,ECE 109,A01,091882,Touri; Behrouz,47,0,70,23
1650189283431,ECE 180,A00,083140,Abi Samra; Nicholas Camill,24,0,30,6
1650189283431,ECE 180,B00,083141,Abi Samra; Nicholas Camill,8,0,30,22
1650189289455,MATH 10A,A01,083735,Patchell; Gregory David,11,0,30,19
1650189289455,MATH 10A,A02,083736,Patchell; Gregory David,28,0,30,2
1650189289455,MATH 10A,A03,083737,Patchell; Gregory David,26,0,30,4
1650189295483,MATH 10B,A01,083207,Staff,0,5,30,30
1650189295483,MATH 10B,A02,083208,Staff,0,5,30,30
1650189295483,MATH 10B,B01,083739,Staff,17,0,30,13
1650189295483,MATH 10B,B02,083740,Staff,29,0,30,1
1650189301521,MATH 18,A01,083743,Staff,8,0,30,22
1650189301521,MATH 18,A02,083744,Staff,28,0,30,2
1650189301521,MATH 18,A03,083745,Staff,23,0,30,7
1650189301521,MATH 18,A04,083746,Staff,27,0,30,3
1650189301521,MATH 18,B01,083748,Staff,0,10,30,30
1650189301521,MATH 18,B02,083749,Staff,0,7,30,30
1650189301521,MATH 18,B03,083750,Staff,0,7,30,30
1650189301521,MATH 18,B04,083751,Staff,0,8,30,30
1650189307547,MATH 20A,A01,083754,Staff,26,0,40,14
1650189313573,MATH 20B,A01,083756,Staff,0,6,30,30
1650189313573,MATH 20B,A02,083757,Staff,0,6,30,30
1650189319599,MATH 20C,A01,083760,Staff,0,12,30,30
1650189319599,MATH 20C,A02,083761,Staff,0,12,30,30
1650189319599,MATH 20C,B01,083762,Staff,14,0,30,16
1650189319599,MATH 20C,B02,083763,Staff,28,0,30,2
1650189325631,MATH 20D,A01,083765,Staff,1,2,30,29
1650189325631,MATH 20D,A02,083766,Staff,10,0,30,20
1650189325631,MATH 20D,A03,083767,Staff,28,0,30,2
1650189331656,MATH 20E,A01,083771,Staff,8,0,30,22
1650189331656,MATH 20E,A02,083772,Staff,20,0,30,10
1650189331656,MATH 20E,B01,083773,Staff,0,0,30,30
1650189331656,MATH 20E,B02,083774,Staff,12,0,30,18
1650189337684,MATH 103A,A01,083777,Staff,0,9,30,30
1650189337684,MATH 103A,A02,083778,Staff,0,10,30,30
1650189337684,MATH 103A,B01,083779,Staff,0,9,30,30
1650189337684,MATH 103A,B02,083780,Staff,0,9,30,30
1650189343708,MATH 105,A01,085443,Staff,0,17,30,30
1650189349733,MATH 109,A01,083213,Anzaldo; Leesa B,0,3,30,30
1650189349733,MATH 109,A02,083214,Anzaldo; Leesa B,0,6,30,30
1650189349733,MATH 109,B01,083215,Anzaldo; Leesa B,0,4,30,30
1650189349733,MATH 109,B02,083216,Anzaldo; Leesa B,0,4,30,30
1650189355757,MATH 142A,A01,083219,Chow; Bennett,0,12,30,30
1650189355757,MATH 142A,A02,083220,Chow; Bennett,0,11,30,30
1650189355757,MATH 142A,B01,083221,Chow; Bennett,0,11,30,30
1650189355757,MATH 142A,B02,083222,Chow; Bennett,0,12,30,30
1650189361784,MATH 193A,A01,083224,Staff,0,4,30,30
1650189361784,MATH 193A,A02,083225,Staff,0,4,30,30
1650189361784,MATH 193A,A03,083781,Staff,0,2,30,30
1650189361784,MATH 193A,A04,083782,Staff,0,1,30,30
1650189367811,MATH 197,001,091859,McAuley; Julian John,9998,0,9999,1
1650189373865,COGS 9,A01,083615,Staff,0,14,60,60
1650189379888,COGS 11,A01,083617,Boyle; Mary E. T.,24,0,40,16
1650189385915,COGS 13,A01,083071,Staff,0,30,40,40
1650189391943,COGS 14A,A01,092681,Staff,0,12,100,100
1650189397971,COGS 14B,A01,083073,Cheng; Tzu-Han,0,7,50,50
1650189403995,COGS 17,A01,092677,Staff,35,0,75,40
1650189410023,COGS 100,A01,083619,Staff,0,20,60,60
1650189416137,COGS 101A,A01,083621,Davis; Joshua Daniel,0,21,60,60
1650189422160,COGS 101B,A01,091572,Staff,6,0,60,54
1650189428188,COGS 101C,A01,083625,Delgado; Tania,20,0,30,10
1650189434212,COGS 107A,A01,083627,Boyle; Mary E. T.,0,7,60,60
1650189440239,COGS 118A,A01,083075,Staff,16,0,60,44
1650189446262,CSE 3,A50,083646,Miranda; Gregory Joseph,22,0,38,16
1650189446262,CSE 3,A51,083647,Miranda; Gregory Joseph,37,0,37,0
1650189452291,CSE 8A,A50,083650,Miranda; Gregory Joseph,0,17,40,40
1650189458317,CSE 11,A01,083080,Cao; Yingjun,0,68,40,40
1650189464345,CSE 12,A01,083652,Staff,0,5,100,100
1650189470369,CSE 15L,A01,083654,Staff,0,0,50,50
1650189470369,CSE 15L,A02,083655,Staff,8,0,50,42
1650189476393,CSE 20,A01,083657,Staff,53,0,80,27
1650189482417,CSE 30,A01,083084,Eldon; John,0,69,40,40
1650189488442,CSE 100,A01,083659,Cao; Yingjun,0,63,50,50
1650189494466,CSE 134B,A01,083661,Powell; Thomas Allan,0,27,65,65
1650189500488,CSE 140,A01,083663,Staff,1,0,75,74
1650189506514,CSE 140L,A01,083088,Eldon; John,0,4,75,75
1650189512541,CSE 175,A01,083665,Kumar; Rakesh,8,0,25,17
1650189518569,CSE 190,A00,092507,Dubnov; Shlomo,14,0,20,6
1650189524599,ECE 45,A01,083139,Staff,0,13,40,40
1650189530623,ECE 65,A50,083695,Staff,0,5,30,30
1650189536648,ECE 109,A01,091882,Touri; Behrouz,47,0,70,23
1650189542672,ECE 180,A00,083140,Abi Samra; Nicholas Camill,24,0,30,6
1650189542672,ECE 180,B00,083141,Abi Samra; Nicholas Camill,8,0,30,22
1650189548700,MATH 10A,A01,083735,Patchell; Gregory David,11,0,30,19
1650189548700,MATH 10A,A02,083736,Patchell; Gregory David,28,0,30,2
1650189548700,MATH 10A,A03,083737,Patchell; Gregory David,26,0,30,4
1650189554732,MATH 10B,A01,083207,Staff,0,5,30,30
1650189554732,MATH 10B,A02,083208,Staff,0,5,30,30
1650189554732,MATH 10B,B01,083739,Staff,17,0,30,13
1650189554732,MATH 10B,B02,083740,Staff,29,0,30,1
1650189560762,MATH 18,A01,083743,Staff,8,0,30,22
1650189560762,MATH 18,A02,083744,Staff,28,0,30,2
1650189560762,MATH 18,A03,083745,Staff,23,0,30,7
1650189560762,MATH 18,A04,083746,Staff,27,0,30,3
1650189560762,MATH 18,B01,083748,Staff,0,10,30,30
1650189560762,MATH 18,B02,083749,Staff,0,7,30,30
1650189560762,MATH 18,B03,083750,Staff,0,7,30,30
1650189560762,MATH 18,B04,083751,Staff,0,8,30,30
1650189566789,MATH 20A,A01,083754,Staff,26,0,40,14
1650189572813,MATH 20B,A01,083756,Staff,0,6,30,30
1650189572813,MATH 20B,A02,083757,Staff,0,6,30,30
1650189578837,MATH 20C,A01,083760,Staff,0,12,30,30
1650189578837,MATH 20C,A02,083761,Staff,0,12,30,30
1650189578837,MATH 20C,B01,083762,Staff,14,0,30,16
1650189578837,MATH 20C,B02,083763,Staff,28,0,30,2
1650189584860,MATH 20D,A01,083765,Staff,1,2,30,29
1650189584860,MATH 20D,A02,083766,Staff,10,0,30,20
1650189584860,MATH 20D,A03,083767,Staff,28,0,30,2
1650189590895,MATH 20E,A01,083771,Staff,8,0,30,22
1650189590895,MATH 20E,A02,083772,Staff,20,0,30,10
1650189590895,MATH 20E,B01,083773,Staff,0,0,30,30
1650189590895,MATH 20E,B02,083774,Staff,12,0,30,18
1650189596920,MATH 103A,A01,083777,Staff,0,9,30,30
1650189596920,MATH 103A,A02,083778,Staff,0,10,30,30
1650189596920,MATH 103A,B01,083779,Staff,0,9,30,30
1650189596920,MATH 103A,B02,083780,Staff,0,9,30,30
1650189602954,MATH 105,A01,085443,Staff,0,17,30,30
1650189608978,MATH 109,A01,083213,Anzaldo; Leesa B,0,3,30,30
1650189608978,MATH 109,A02,083214,Anzaldo; Leesa B,0,6,30,30
1650189608978,MATH 109,B01,083215,Anzaldo; Leesa B,0,4,30,30
1650189608978,MATH 109,B02,083216,Anzaldo; Leesa B,0,4,30,30
1650189615002,MATH 142A,A01,083219,Chow; Bennett,0,12,30,30
1650189615002,MATH 142A,A02,083220,Chow; Bennett,0,11,30,30
1650189615002,MATH 142A,B01,083221,Chow; Bennett,0,11,30,30
1650189615002,MATH 142A,B02,083222,Chow; Bennett,0,12,30,30
1650189621037,MATH 193A,A01,083224,Staff,0,4,30,30
1650189621037,MATH 193A,A02,083225,Staff,0,4,30,30
1650189621037,MATH 193A,A03,083781,Staff,0,2,30,30
1650189621037,MATH 193A,A04,083782,Staff,0,1,30,30
1650189627067,MATH 197,001,091859,McAuley; Julian John,9998,0,9999,1
1650189633120,COGS 9,A01,083615,Staff,0,14,60,60
1650189639146,COGS 11,A01,083617,Boyle; Mary E. T.,24,0,40,16
1650189645169,COGS 13,A01,083071,Staff,0,30,40,40
1650189651193,COGS 14A,A01,092681,Staff,0,12,100,100
1650189657223,COGS 14B,A01,083073,Cheng; Tzu-Han,0,7,50,50
1650189663249,COGS 17,A01,092677,Staff,35,0,75,40
1650189669276,COGS 100,A01,083619,Staff,0,20,60,60
1650189675301,COGS 101A,A01,083621,Davis; Joshua Daniel,0,21,60,60
1650189681331,COGS 101B,A01,091572,Staff,6,0,60,54
1650189687355,COGS 101C,A01,083625,Delgado; Tania,20,0,30,10
1650189693385,COGS 107A,A01,083627,Boyle; Mary E. T.,0,7,60,60
1650189699411,COGS 118A,A01,083075,Staff,16,0,60,44
1650189705440,CSE 3,A50,083646,Miranda; Gregory Joseph,22,0,38,16
1650189705440,CSE 3,A51,083647,Miranda; Gregory Joseph,37,0,37,0
1650189711464,CSE 8A,A50,083650,Miranda; Gregory Joseph,0,17,40,40
1650189717516,CSE 11,A01,083080,Cao; Yingjun,0,68,40,40
1650189723544,CSE 12,A01,083652,Staff,0,5,100,100
1650189729571,CSE 15L,A01,083654,Staff,0,0,50,50
1650189729571,CSE 15L,A02,083655,Staff,8,0,50,42
1650189735595,CSE 20,A01,083657,Staff,53,0,80,27
1650189741623,CSE 30,A01,083084,Eldon; John,0,69,40,40
1650189747647,CSE 100,A01,083659,Cao; Yingjun,0,63,50,50
1650189753682,CSE 134B,A01,083661,Powell; Thomas Allan,0,27,65,65
1650189759708,CSE 140,A01,083663,Staff,1,0,75,74
1650189765733,CSE 140L,A01,083088,Eldon; John,0,4,75,75
1650189771757,CSE 175,A01,083665,Kumar; Rakesh,8,0,25,17
1650189777783,CSE 190,A00,092507,Dubnov; Shlomo,14,0,20,6
1650189783806,ECE 45,A01,083139,Staff,0,13,40,40
1650189789832,ECE 65,A50,083695,Staff,0,5,30,30
1650189795855,ECE 109,A01,091882,Touri; Behrouz,47,0,70,23
1650189801881,ECE 180,A00,083140,Abi Samra; Nicholas Camill,24,0,30,6
1650189801881,ECE 180,B00,083141,Abi Samra; Nicholas Camill,8,0,30,22
1650189807905,MATH 10A,A01,083735,Patchell; Gregory David,11,0,30,19
1650189807905,MATH 10A,A02,083736,Patchell; Gregory David,28,0,30,2
1650189807905,MATH 10A,A03,083737,Patchell; Gregory David,26,0,30,4
1650189813933,MATH 10B,A01,083207,Staff,0,5,30,30
1650189813933,MATH 10B,A02,083208,Staff,0,5,30,30
1650189813933,MATH 10B,B01,083739,Staff,17,0,30,13
1650189813933,MATH 10B,B02,083740,Staff,29,0,30,1
1650189819956,MATH 18,A01,083743,Staff,8,0,30,22
1650189819956,MATH 18,A02,083744,Staff,28,0,30,2
1650189819956,MATH 18,A03,083745,Staff,23,0,30,7
1650189819956,MATH 18,A04,083746,Staff,27,0,30,3
1650189819956,MATH 18,B01,083748,Staff,0,10,30,30
1650189819956,MATH 18,B02,083749,Staff,0,7,30,30
1650189819956,MATH 18,B03,083750,Staff,0,7,30,30
1650189819956,MATH 18,B04,083751,Staff,0,8,30,30
1650189825983,MATH 20A,A01,083754,Staff,26,0,40,14
1650189832008,MATH 20B,A01,083756,Staff,0,6,30,30
1650189832008,MATH 20B,A02,083757,Staff,0,6,30,30
1650189838033,MATH 20C,A01,083760,Staff,0,12,30,30
1650189838033,MATH 20C,A02,083761,Staff,0,12,30,30
1650189838033,MATH 20C,B01,083762,Staff,14,0,30,16
1650189838033,MATH 20C,B02,083763,Staff,28,0,30,2
1650189844056,MATH 20D,A01,083765,Staff,1,2,30,29
1650189844056,MATH 20D,A02,083766,Staff,10,0,30,20
1650189844056,MATH 20D,A03,083767,Staff,28,0,30,2
1650189850085,MATH 20E,A01,083771,Staff,8,0,30,22
1650189850085,MATH 20E,A02,083772,Staff,20,0,30,10
1650189850085,MATH 20E,B01,083773,Staff,0,0,30,30
1650189850085,MATH 20E,B02,083774,Staff,12,0,30,18
1650189856111,MATH 103A,A01,083777,Staff,0,9,30,30
1650189856111,MATH 103A,A02,083778,Staff,0,10,30,30
1650189856111,MATH 103A,B01,083779,Staff,0,9,30,30
1650189856111,MATH 103A,B02,083780,Staff,0,9,30,30
1650189862138,MATH 105,A01,085443,Staff,0,17,30,30
1650189868163,MATH 109,A01,083213,Anzaldo; Leesa B,0,3,30,30
1650189868163,MATH 109,A02,083214,Anzaldo; Leesa B,0,6,30,30
1650189868163,MATH 109,B01,083215,Anzaldo; Leesa B,0,4,30,30
1650189868163,MATH 109,B02,083216,Anzaldo; Leesa B,0,4,30,30
1650189874188,MATH 142A,A01,083219,Chow; Bennett,0,12,30,30
1650189874188,MATH 142A,A02,083220,Chow; Bennett,0,11,30,30
1650189874188,MATH 142A,B01,083221,Chow; Bennett,0,11,30,30
1650189874188,MATH 142A,B02,083222,Chow; Bennett,0,12,30,30
1650189880215,MATH 193A,A01,083224,Staff,0,4,30,30
1650189880215,MATH 193A,A02,083225,Staff,0,4,30,30
1650189880215,MATH 193A,A03,083781,Staff,0,2,30,30
1650189880215,MATH 193A,A04,083782,Staff,0,1,30,30
1650189886241,MATH 197,001,091859,McAuley; Julian John,9998,0,9999,1
1650189892302,COGS 9,A01,083615,Staff,0,14,60,60
1650189898326,COGS 11,A01,083617,Boyle; Mary E. T.,24,0,40,16
1650189904357,COGS 13,A01,083071,Staff,0,30,40,40
1650189910385,COGS 14A,A01,092681,Staff,0,12,100,100
1650189916413,COGS 14B,A01,083073,Cheng; Tzu-Han,0,7,50,50
1650189922438,COGS 17,A01,092677,Staff,35,0,75,40
1650189928464,COGS 100,A01,083619,Staff,0,20,60,60
1650189934506,COGS 101A,A01,083621,Davis; Joshua Daniel,0,21,60,60
1650189940534,COGS 101B,A01,091572,Staff,6,0,60,54
1650189946561,COGS 101C,A01,083625,Delgado; Tania,20,0,30,10
1650189952590,COGS 107A,A01,083627,Boyle; Mary E. T.,0,7,60,60
1650189958618,COGS 118A,A01,083075,Staff,16,0,60,44
1650189964644,CSE 3,A50,083646,Miranda; Gregory Joseph,22,0,38,16
1650189964644,CSE 3,A51,083647,Miranda; Gregory Joseph,37,0,37,0
1650189970670,CSE 8A,A50,083650,Miranda; Gregory Joseph,0,17,40,40
1650189976699,CSE 11,A01,083080,Cao; Yingjun,0,68,40,40
1650189982724,CSE 12,A01,083652,Staff,0,5,100,100
1650189988750,CSE 15L,A01,083654,Staff,0,0,50,50
1650189988750,CSE 15L,A02,083655,Staff,8,0,50,42
1650189994775,CSE 20,A01,083657,Staff,53,0,80,27
1650190000806,CSE 30,A01,083084,Eldon; John,0,69,40,40
1650190006855,CSE 100,A01,083659,Cao; Yingjun,0,63,50,50
1650190012968,CSE 134B,A01,083661,Powell; Thomas Allan,0,27,65,65
1650190018993,CSE 140,A01,083663,Staff,1,0,75,74
1650190025017,CSE 140L,A01,083088,Eldon; John,0,4,75,75
1650190031062,CSE 175,A01,083665,Kumar; Rakesh,8,0,25,17
1650190037093,CSE 190,A00,092507,Dubnov; Shlomo,14,0,20,6
1650190043118,ECE 45,A01,083139,Staff,0,13,40,40
1650190049151,ECE 65,A50,083695,Staff,0,5,30,30
1650190055189,ECE 109,A01,091882,Touri; Behrouz,47,0,70,23
1650190061220,ECE 180,A00,083140,Abi Samra; Nicholas Camill,24,0,30,6
1650190061220,ECE 180,B00,083141,Abi Samra; Nicholas Camill,8,0,30,22
1650190067248,MATH 10A,A01,083735,Patchell; Gregory David,11,0,30,19
1650190067248,MATH 10A,A02,083736,Patchell; Gregory David,28,0,30,2
1650190067248,MATH 10A,A03,083737,Patchell; Gregory David,26,0,30,4
1650190073274,MATH 10B,A01,083207,Staff,0,5,30,30
1650190073274,MATH 10B,A02,083208,Staff,0,5,30,30
1650190073274,MATH 10B,B01,083739,Staff,17,0,30,13
1650190073274,MATH 10B,B02,083740,Staff,29,0,30,1
1650190079300,MATH 18,A01,083743,Staff,8,0,30,22
1650190079300,MATH 18,A02,083744,Staff,28,0,30,2
1650190079300,MATH 18,A03,083745,Staff,23,0,30,7
1650190079300,MATH 18,A04,083746,Staff,27,0,30,3
1650190079300,MATH 18,B01,083748,Staff,0,10,30,30
1650190079300,MATH 18,B02,083749,Staff,0,7,30,30
1650190079300,MATH 18,B03,083750,Staff,0,7,30,30
1650190079300,MATH 18,B04,083751,Staff,0,8,30,30
1650190085330,MATH 20A,A01,083754,Staff,26,0,40,14
1650190091558,MATH 20B,A01,083756,Staff,0,6,30,30
1650190091558,MATH 20B,A02,083757,Staff,0,6,30,30
1650190097602,MATH 20C,A01,083760,Staff,0,12,30,30
1650190097602,MATH 20C,A02,083761,Staff,0,12,30,30
1650190097602,MATH 20C,B01,083762,Staff,14,0,30,16
1650190097602,MATH 20C,B02,083763,Staff,28,0,30,2
1650190103627,MATH 20D,A01,083765,Staff,1,2,30,29
1650190103627,MATH 20D,A02,083766,Staff,10,0,30,20
1650190103627,MATH 20D,A03,083767,Staff,28,0,30,2
1650190109653,MATH 20E,A01,083771,Staff,8,0,30,22
1650190109653,MATH 20E,A02,083772,Staff,20,0,30,10
1650190109653,MATH 20E,B01,083773,Staff,0,0,30,30
1650190109653,MATH 20E,B02,083774,Staff,12,0,30,18
1650190115680,MATH 103A,A01,083777,Staff,0,9,30,30
1650190115680,MATH 103A,A02,083778,Staff,0,10,30,30
1650190115680,MATH 103A,B01,083779,Staff,0,9,30,30
1650190115680,MATH 103A,B02,083780,Staff,0,9,30,30
1650190121702,MATH 105,A01,085443,Staff,0,17,30,30
1650190127741,MATH 109,A01,083213,Anzaldo; Leesa B,0,3,30,30
1650190127741,MATH 109,A02,083214,Anzaldo; Leesa B,0,6,30,30
1650190127741,MATH 109,B01,083215,Anzaldo; Leesa B,0,4,30,30
1650190127741,MATH 109,B02,083216,Anzaldo; Leesa B,0,4,30,30
1650190133772,MATH 142A,A01,083219,Chow; Bennett,0,12,30,30
1650190133772,MATH 142A,A02,083220,Chow; Bennett,0,11,30,30
1650190133772,MATH 142A,B01,083221,Chow; Bennett,0,11,30,30
1650190133772,MATH 142A,B02,083222,Chow; Bennett,0,12,30,30
1650190139798,MATH 193A,A01,083224,Staff,0,4,30,30
1650190139798,MATH 193A,A02,083225,Staff,0,4,30,30
1650190139798,MATH 193A,A03,083781,Staff,0,2,30,30
1650190139798,MATH 193A,A04,083782,Staff,0,1,30,30
1650190145823,MATH 197,001,091859,McAuley; Julian John,9998,0,9999,1
1650190151882,COGS 9,A01,083615,Staff,0,14,60,60
1650190157906,COGS 11,A01,083617,Boyle; Mary E. T.,24,0,40,16
1650190163934,COGS 13,A01,083071,Staff,0,30,40,40
1650190169958,COGS 14A,A01,092681,Staff,0,12,100,100
1650190175982,COGS 14B,A01,083073,Cheng; Tzu-Han,0,7,50,50
1650190182007,COGS 17,A01,092677,Staff,35,0,75,40
1650190188035,COGS 100,A01,083619,Staff,0,20,60,60
1650190194063,COGS 101A,A01,083621,Davis; Joshua Daniel,0,21,60,60
1650190200096,COGS 101B,A01,091572,Staff,6,0,60,54
1650190206120,COGS 101C,A01,083625,Delgado; Tania,20,0,30,10
1650190212147,COGS 107A,A01,083627,Boyle; Mary E. T.,0,7,60,60
1650190218173,COGS 118A,A01,083075,Staff,16,0,60,44
1650190224203,CSE 3,A50,083646,Miranda; Gregory Joseph,22,0,38,16
1650190224203,CSE 3,A51,083647,Miranda; Gregory Joseph,37,0,37,0
1650190230226,CSE 8A,A50,083650,Miranda; Gregory Joseph,0,17,40,40
1650190236250,CSE 11,A01,083080,Cao; Yingjun,0,68,40,40
1650190242274,CSE 12,A01,083652,Staff,0,5,100,100
1650190248298,CSE 15L,A01,083654,Staff,0,0,50,50
1650190248298,CSE 15L,A02,083655,Staff,8,0,50,42
1650190254333,CSE 20,A01,083657,Staff,53,0,80,27
1650190260360,CSE 30,A01,083084,Eldon; John,0,69,40,40
1650190266383,CSE 100,A01,083659,Cao; Yingjun,0,63,50,50
1650190272413,CSE 134B,A01,083661,Powell; Thomas Allan,0,27,65,65
1650190278438,CSE 140,A01,083663,Staff,1,0,75,74
1650190284475,CSE 140L,A01,083088,Eldon; John,0,4,75,75
1650190290499,CSE 175,A01,083665,Kumar; Rakesh,8,0,25,17
1650190296522,CSE 190,A00,092507,Dubnov; Shlomo,14,0,20,6
1650190302548,ECE 45,A01,083139,Staff,0,13,40,40
1650190308576,ECE 65,A50,083695,Staff,0,5,30,30
1650190314598,ECE 109,A01,091882,Touri; Behrouz,47,0,70,23
1650190320626,ECE 180,A00,083140,Abi Samra; Nicholas Camill,24,0,30,6
1650190320626,ECE 180,B00,083141,Abi Samra; Nicholas Camill,8,0,30,22
1650190326651,MATH 10A,A01,083735,Patchell; Gregory David,11,0,30,19
1650190326651,MATH 10A,A02,083736,Patchell; Gregory David,28,0,30,2
1650190326651,MATH 10A,A03,083737,Patchell; Gregory David,26,0,30,4
1650190332674,MATH 10B,A01,083207,Staff,0,5,30,30
1650190332674,MATH 10B,A02,083208,Staff,0,5,30,30
1650190332674,MATH 10B,B01,083739,Staff,17,0,30,13
1650190332674,MATH 10B,B02,083740,Staff,29,0,30,1
1650190338706,MATH 18,A01,083743,Staff,8,0,30,22
1650190338706,MATH 18,A02,083744,Staff,28,0,30,2
1650190338706,MATH 18,A03,083745,Staff,23,0,30,7
1650190338706,MATH 18,A04,083746,Staff,27,0,30,3
1650190338706,MATH 18,B01,083748,Staff,0,10,30,30
1650190338706,MATH 18,B02,083749,Staff,0,7,30,30
1650190338706,MATH 18,B03,083750,Staff,0,7,30,30
1650190338706,MATH 18,B04,083751,Staff,0,8,30,30
1650190344728,MATH 20A,A01,083754,Staff,26,0,40,14
1650190350756,MATH 20B,A01,083756,Staff,0,6,30,30
1650190350756,MATH 20B,A02,083757,Staff,0,6,30,30
1650190356780,MATH 20C,A01,083760,Staff,0,12,30,30
1650190356780,MATH 20C,A02,083761,Staff,0,12,30,30
1650190356780,MATH 20C,B01,083762,Staff,14,0,30,16
1650190356780,MATH 20C,B02,083763,Staff,28,0,30,2
1650190362808,MATH 20D,A01,083765,Staff,1,2,30,29
1650190362808,MATH 20D,A02,083766,Staff,10,0,30,20
1650190362808,MATH 20D,A03,083767,Staff,28,0,30,2
1650190368839,MATH 20E,A01,083771,Staff,8,0,30,22
1650190368839,MATH 20E,A02,083772,Staff,20,0,30,10
1650190368839,MATH 20E,B01,083773,Staff,0,0,30,30
1650190368839,MATH 20E,B02,083774,Staff,12,0,30,18
1650190374869,MATH 103A,A01,083777,Staff,0,9,30,30
1650190374869,MATH 103A,A02,083778,Staff,0,10,30,30
1650190374869,MATH 103A,B01,083779,Staff,0,9,30,30
1650190374869,MATH 103A,B02,083780,Staff,0,9,30,30
1650190380898,MATH 105,A01,085443,Staff,0,17,30,30
1650190386926,MATH 109,A01,083213,Anzaldo; Leesa B,0,3,30,30
1650190386926,MATH 109,A02,083214,Anzaldo; Leesa B,0,6,30,30
1650190386926,MATH 109,B01,083215,Anzaldo; Leesa B,0,4,30,30
1650190386926,MATH 109,B02,083216,Anzaldo; Leesa B,0,4,30,30
1650190392954,MATH 142A,A01,083219,Chow; Bennett,0,12,30,30
1650190392954,MATH 142A,A02,083220,Chow; Bennett,0,11,30,30
1650190392954,MATH 142A,B01,083221,Chow; Bennett,0,11,30,30
1650190392954,MATH 142A,B02,083222,Chow; Bennett,0,12,30,30
1650190398979,MATH 193A,A01,083224,Staff,0,4,30,30
1650190398979,MATH 193A,A02,083225,Staff,0,4,30,30
1650190398979,MATH 193A,A03,083781,Staff,0,2,30,30
1650190398979,MATH 193A,A04,083782,Staff,0,1,30,30
1650190405004,MATH 197,001,091859,McAuley; Julian John,9998,0,9999,1
1650190411061,COGS 9,A01,083615,Staff,0,14,60,60
1650190417085,COGS 11,A01,083617,Boyle; Mary E. T.,24,0,40,16
1650190423109,COGS 13,A01,083071,Staff,0,30,40,40
1650190429133,COGS 14A,A01,092681,Staff,0,12,100,100
1650190435160,COGS 14B,A01,083073,Cheng; Tzu-Han,0,7,50,50
1650190441184,COGS 17,A01,092677,Staff,35,0,75,40
1650190447216,COGS 100,A01,083619,Staff,0,20,60,60
1650190453240,COGS 101A,A01,083621,Davis; Joshua Daniel,0,21,60,60
1650190459264,COGS 101B,A01,091572,Staff,6,0,60,54
1650190465293,COGS 101C,A01,083625,Delgado; Tania,20,0,30,10
1650190471318,COGS 107A,A01,083627,Boyle; Mary E. T.,0,7,60,60
1650190477343,COGS 118A,A01,083075,Staff,16,0,60,44
1650190483369,CSE 3,A50,083646,Miranda; Gregory Joseph,22,0,38,16
1650190483369,CSE 3,A51,083647,Miranda; Gregory Joseph,37,0,37,0
1650190489407,CSE 8A,A50,083650,Miranda; Gregory Joseph,0,17,40,40
1650190495435,CSE 11,A01,083080,Cao; Yingjun,0,68,40,40
1650190501460,CSE 12,A01,083652,Staff,0,7,100,100
1650190507484,CSE 15L,A01,083654,Staff,0,0,50,50
1650190507484,CSE 15L,A02,083655,Staff,6,0,50,44
1650190513507,CSE 20,A01,083657,Staff,53,0,80,27
1650190519538,CSE 30,A01,083084,Eldon; John,0,69,40,40
1650190525562,CSE 100,A01,083659,Cao; Yingjun,0,63,50,50
1650190531585,CSE 134B,A01,083661,Powell; Thomas Allan,0,27,65,65
1650190537610,CSE 140,A01,083663,Staff,1,0,75,74
1650190543632,CSE 140L,A01,083088,Eldon; John,0,4,75,75
1650190549658,CSE 175,A01,083665,Kumar; Rakesh,8,0,25,17
1650190555684,CSE 190,A00,092507,Dubnov; Shlomo,14,0,20,6
1650190561709,ECE 45,A01,083139,Staff,0,13,40,40
1650190567734,ECE 65,A50,083695,Staff,0,5,30,30
1650190573758,ECE 109,A01,091882,Touri; Behrouz,47,0,70,23
1650190579797,ECE 180,A00,083140,Abi Samra; Nicholas Camill,24,0,30,6
1650190579797,ECE 180,B00,083141,Abi Samra; Nicholas Camill,8,0,30,22
1650190585824,MATH 10A,A01,083735,Patchell; Gregory David,11,0,30,19
1650190585824,MATH 10A,A02,083736,Patchell; Gregory David,28,0,30,2
1650190585824,MATH 10A,A03,083737,Patchell; Gregory David,26,0,30,4
1650190591853,MATH 10B,A01,083207,Staff,0,5,30,30
1650190591853,MATH 10B,A02,083208,Staff,0,5,30,30
1650190591853,MATH 10B,B01,083739,Staff,17,0,30,13
1650190591853,MATH 10B,B02,083740,Staff,29,0,30,1
1650190597880,MATH 18,A01,083743,Staff,8,0,30,22
1650190597880,MATH 18,A02,083744,Staff,28,0,30,2
1650190597880,MATH 18,A03,083745,Staff,23,0,30,7
1650190597880,MATH 18,A04,083746,Staff,27,0,30,3
1650190597880,MATH 18,B01,083748,Staff,0,10,30,30
1650190597880,MATH 18,B02,083749,Staff,0,7,30,30
1650190597880,MATH 18,B03,083750,Staff,0,7,30,30
1650190597880,MATH 18,B04,083751,Staff,0,8,30,30
1650190603902,MATH 20A,A01,083754,Staff,26,0,40,14
1650190610026,MATH 20B,A01,083756,Staff,0,6,30,30
1650190610026,MATH 20B,A02,083757,Staff,0,6,30,30
1650190616051,MATH 20C,A01,083760,Staff,0,12,30,30
1650190616051,MATH 20C,A02,083761,Staff,0,12,30,30
1650190616051,MATH 20C,B01,083762,Staff,14,0,30,16
1650190616051,MATH 20C,B02,083763,Staff,28,0,30,2
1650190622074,MATH 20D,A01,083765,Staff,1,2,30,29
1650190622074,MATH 20D,A02,083766,Staff,10,0,30,20
1650190622074,MATH 20D,A03,083767,Staff,28,0,30,2
1650190628099,MATH 20E,A01,083771,Staff,8,0,30,22
1650190628099,MATH 20E,A02,083772,Staff,20,0,30,10
1650190628099,MATH 20E,B01,083773,Staff,0,0,30,30
1650190628099,MATH 20E,B02,083774,Staff,12,0,30,18
1650190634124,MATH 103A,A01,083777,Staff,0,9,30,30
1650190634124,MATH 103A,A02,083778,Staff,0,10,30,30
1650190634124,MATH 103A,B01,083779,Staff,0,9,30,30
1650190634124,MATH 103A,B02,083780,Staff,0,9,30,30
1650190640154,MATH 105,A01,085443,Staff,0,17,30,30
1650190646185,MATH 109,A01,083213,Anzaldo; Leesa B,0,3,30,30
1650190646185,MATH 109,A02,083214,Anzaldo; Leesa B,0,6,30,30
1650190646185,MATH 109,B01,083215,Anzaldo; Leesa B,0,4,30,30
1650190646185,MATH 109,B02,083216,Anzaldo; Leesa B,0,4,30,30
1650190652210,MATH 142A,A01,083219,Chow; Bennett,0,12,30,30
1650190652210,MATH 142A,A02,083220,Chow; Bennett,0,11,30,30
1650190652210,MATH 142A,B01,083221,Chow; Bennett,0,11,30,30
1650190652210,MATH 142A,B02,083222,Chow; Bennett,0,12,30,30
1650190658233,MATH 193A,A01,083224,Staff,0,4,30,30
1650190658233,MATH 193A,A02,083225,Staff,0,4,30,30
1650190658233,MATH 193A,A03,083781,Staff,0,2,30,30
1650190658233,MATH 193A,A04,083782,Staff,0,1,30,30
1650190664256,MATH 197,001,091859,McAuley; Julian John,9998,0,9999,1
1650190670317,COGS 9,A01,083615,Staff,0,14,60,60
1650190676346,COGS 11,A01,083617,Boyle; Mary E. T.,24,0,40,16
1650190682375,COGS 13,A01,083071,Staff,0,30,40,40
1650190688402,COGS 14A,A01,092681,Staff,0,12,100,100
1650190694431,COGS 14B,A01,083073,Cheng; Tzu-Han,0,7,50,50
1650190700455,COGS 17,A01,092677,Staff,35,0,75,40
1650190706480,COGS 100,A01,083619,Staff,0,20,60,60
1650190712509,COGS 101A,A01,083621,Davis; Joshua Daniel,0,21,60,60
1650190718532,COGS 101B,A01,091572,Staff,6,0,60,54
1650190724557,COGS 101C,A01,083625,Delgado; Tania,20,0,30,10
1650190730587,COGS 107A,A01,083627,Boyle; Mary E. T.,0,7,60,60
1650190736610,COGS 118A,A01,083075,Staff,16,0,60,44
1650190742640,CSE 3,A50,083646,Miranda; Gregory Joseph,22,0,38,16
1650190742640,CSE 3,A51,083647,Miranda; Gregory Joseph,37,0,37,0
1650190748669,CSE 8A,A50,083650,Miranda; Gregory Joseph,0,17,40,40
1650190754694,CSE 11,A01,083080,Cao; Yingjun,0,68,40,40
1650190760719,CSE 12,A01,083652,Staff,0,7,100,100
1650190766741,CSE 15L,A01,083654,Staff,0,0,50,50
1650190766741,CSE 15L,A02,083655,Staff,6,0,50,44
1650190772763,CSE 20,A01,083657,Staff,53,0,80,27
1650190778788,CSE 30,A01,083084,Eldon; John,0,69,40,40
1650190784824,CSE 100,A01,083659,Cao; Yingjun,0,63,50,50
1650190790847,CSE 134B,A01,083661,Powell; Thomas Allan,0,27,65,65
1650190796871,CSE 140,A01,083663,Staff,1,0,75,74
1650190802912,CSE 140L,A01,083088,Eldon; John,0,4,75,75
1650190808935,CSE 175,A01,083665,Kumar; Rakesh,8,0,25,17
1650190814958,CSE 190,A00,092507,Dubnov; Shlomo,14,0,20,6
1650190820982,ECE 45,A01,083139,Staff,0,13,40,40
1650190827006,ECE 65,A50,083695,Staff,0,5,30,30
1650190833033,ECE 109,A01,091882,Touri; Behrouz,47,0,70,23
1650190839061,ECE 180,A00,083140,Abi Samra; Nicholas Camill,24,0,30,6
1650190839061,ECE 180,B00,083141,Abi Samra; Nicholas Camill,8,0,30,22
1650190845090,MATH 10A,A01,083735,Patchell; Gregory David,11,0,30,19
1650190845090,MATH 10A,A02,083736,Patchell; Gregory David,28,0,30,2
1650190845090,MATH 10A,A03,083737,Patchell; Gregory David,26,0,30,4
1650190851114,MATH 10B,A01,083207,Staff,0,5,30,30
1650190851114,MATH 10B,A02,083208,Staff,0,5,30,30
1650190851114,MATH 10B,B01,083739,Staff,17,0,30,13
1650190851114,MATH 10B,B02,083740,Staff,29,0,30,1
1650190857146,MATH 18,A01,083743,Staff,8,0,30,22
1650190857146,MATH 18,A02,083744,Staff,28,0,30,2
1650190857146,MATH 18,A03,083745,Staff,23,0,30,7
1650190857146,MATH 18,A04,083746,Staff,27,0,30,3
1650190857146,MATH 18,B01,083748,Staff,0,10,30,30
1650190857146,MATH 18,B02,083749,Staff,0,7,30,30
1650190857146,MATH 18,B03,083750,Staff,0,7,30,30
1650190857146,MATH 18,B04,083751,Staff,0,8,30,30
1650190863172,MATH 20A,A01,083754,Staff,26,0,40,14
1650190869200,MATH 20B,A01,083756,Staff,0,6,30,30
1650190869200,MATH 20B,A02,083757,Staff,0,6,30,30
1650190875227,MATH 20C,A01,083760,Staff,0,12,30,30
1650190875227,MATH 20C,A02,083761,Staff,0,12,30,30
1650190875227,MATH 20C,B01,083762,Staff,14,0,30,16
1650190875227,MATH 20C,B02,083763,Staff,28,0,30,2
1650190881251,MATH 20D,A01,083765,Staff,1,2,30,29
1650190881251,MATH 20D,A02,083766,Staff,10,0,30,20
1650190881251,MATH 20D,A03,083767,Staff,28,0,30,2
1650190887277,MATH 20E,A01,083771,Staff,8,0,30,22
1650190887277,MATH 20E,A02,083772,Staff,20,0,30,10
1650190887277,MATH 20E,B01,083773,Staff,0,0,30,30
1650190887277,MATH 20E,B02,083774,Staff,12,0,30,18
1650190893302,MATH 103A,A01,083777,Staff,0,9,30,30
1650190893302,MATH 103A,A02,083778,Staff,0,10,30,30
1650190893302,MATH 103A,B01,083779,Staff,0,9,30,30
1650190893302,MATH 103A,B02,083780,Staff,0,9,30,30
1650190899331,MATH 105,A01,085443,Staff,0,17,30,30
1650190905358,MATH 109,A01,083213,Anzaldo; Leesa B,0,3,30,30
1650190905358,MATH 109,A02,083214,Anzaldo; Leesa B,0,6,30,30
1650190905358,MATH 109,B01,083215,Anzaldo; Leesa B,0,4,30,30
1650190905358,MATH 109,B02,083216,Anzaldo; Leesa B,0,4,30,30
1650190911382,MATH 142A,A01,083219,Chow; Bennett,0,12,30,30
1650190911382,MATH 142A,A02,083220,Chow; Bennett,0,11,30,30
1650190911382,MATH 142A,B01,083221,Chow; Bennett,0,11,30,30
1650190911382,MATH 142A,B02,083222,Chow; Bennett,0,12,30,30
1650190917413,MATH 193A,A01,083224,Staff,0,4,30,30
1650190917413,MATH 193A,A02,083225,Staff,0,4,30,30
1650190917413,MATH 193A,A03,083781,Staff,0,2,30,30
1650190917413,MATH 193A,A04,083782,Staff,0,1,30,30
1650190923440,MATH 197,001,091859,McAuley; Julian John,9998,0,9999,1
1650190929497,COGS 9,A01,083615,Staff,0,14,60,60
1650190935521,COGS 11,A01,083617,Boyle; Mary E. T.,24,0,40,16
1650190941543,COGS 13,A01,083071,Staff,0,30,40,40
1650190947566,COGS 14A,A01,092681,Staff,0,12,100,100
1650190953590,COGS 14B,A01,083073,Cheng; Tzu-Han,0,7,50,50
1650190959616,COGS 17,A01,092677,Staff,35,0,75,40
1650190965640,COGS 100,A01,083619,Staff,0,20,60,60
1650190971663,COGS 101A,A01,083621,Davis; Joshua Daniel,0,21,60,60
1650190977687,COGS 101B,A01,091572,Staff,6,0,60,54
1650190983717,COGS 101C,A01,083625,Delgado; Tania,20,0,30,10
1650190989741,COGS 107A,A01,083627,Boyle; Mary E. T.,0,7,60,60
1650190995768,COGS 118A,A01,083075,Staff,16,0,60,44
1650191001796,CSE 3,A50,083646,Miranda; Gregory Joseph,22,0,38,16
1650191001796,CSE 3,A51,083647,Miranda; Gregory Joseph,37,0,37,0
1650191007820,CSE 8A,A50,083650,Miranda; Gregory Joseph,0,17,40,40
1650191013845,CSE 11,A01,083080,Cao; Yingjun,0,68,40,40
1650191019869,CSE 12,A01,083652,Staff,0,7,100,100
1650191025896,CSE 15L,A01,083654,Staff,0,0,50,50
1650191025896,CSE 15L,A02,083655,Staff,6,0,50,44
1650191031921,CSE 20,A01,083657,Staff,53,0,80,27
1650191037947,CSE 30,A01,083084,Eldon; John,0,69,40,40
1650191043975,CSE 100,A01,083659,Cao; Yingjun,0,63,50,50
1650191050001,CSE 134B,A01,083661,Powell; Thomas Allan,0,27,65,65
1650191056026,CSE 140,A01,083663,Staff,1,0,75,74
1650191062050,CSE 140L,A01,083088,Eldon; John,0,4,75,75
1650191068077,CSE 175,A01,083665,Kumar; Rakesh,8,0,25,17
1650191074101,CSE 190,A00,092507,Dubnov; Shlomo,14,0,20,6
1650191080124,ECE 45,A01,083139,Staff,0,13,40,40
1650191086148,ECE 65,A50,083695,Staff,0,5,30,30
1650191092176,ECE 109,A01,091882,Touri; Behrouz,47,0,70,23
1650191098204,ECE 180,A00,083140,Abi Samra; Nicholas Camill,24,0,30,6
1650191098204,ECE 180,B00,083141,Abi Samra; Nicholas Camill,8,0,30,22
1650191104232,MATH 10A,A01,083735,Patchell; Gregory David,11,0,30,19
1650191104232,MATH 10A,A02,083736,Patchell; Gregory David,28,0,30,2
1650191104232,MATH 10A,A03,083737,Patchell; Gregory David,26,0,30,4
1650191110256,MATH 10B,A01,083207,Staff,0,5,30,30
1650191110256,MATH 10B,A02,083208,Staff,0,5,30,30
1650191110256,MATH 10B,B01,083739,Staff,17,0,30,13
1650191110256,MATH 10B,B02,083740,Staff,29,0,30,1
1650191116285,MATH 18,A01,083743,Staff,8,0,30,22
1650191116285,MATH 18,A02,083744,Staff,28,0,30,2
1650191116285,MATH 18,A03,083745,Staff,23,0,30,7
1650191116285,MATH 18,A04,083746,Staff,27,0,30,3
1650191116285,MATH 18,B01,083748,Staff,0,10,30,30
1650191116285,MATH 18,B02,083749,Staff,0,7,30,30
1650191116285,MATH 18,B03,083750,Staff,0,7,30,30
1650191116285,MATH 18,B04,083751,Staff,0,8,30,30
1650191122310,MATH 20A,A01,083754,Staff,26,0,40,14
1650191128335,MATH 20B,A01,083756,Staff,0,6,30,30
1650191128335,MATH 20B,A02,083757,Staff,0,6,30,30
1650191134358,MATH 20C,A01,083760,Staff,0,12,30,30
1650191134358,MATH 20C,A02,083761,Staff,0,12,30,30
1650191134358,MATH 20C,B01,083762,Staff,14,0,30,16
1650191134358,MATH 20C,B02,083763,Staff,28,0,30,2
1650191140381,MATH 20D,A01,083765,Staff,1,2,30,29
1650191140381,MATH 20D,A02,083766,Staff,10,0,30,20
1650191140381,MATH 20D,A03,083767,Staff,28,0,30,2
1650191146409,MATH 20E,A01,083771,Staff,8,0,30,22
1650191146409,MATH 20E,A02,083772,Staff,20,0,30,10
1650191146409,MATH 20E,B01,083773,Staff,0,0,30,30
1650191146409,MATH 20E,B02,083774,Staff,12,0,30,18
1650191152437,MATH 103A,A01,083777,Staff,0,9,30,30
1650191152437,MATH 103A,A02,083778,Staff,0,10,30,30
1650191152437,MATH 103A,B01,083779,Staff,0,9,30,30
1650191152437,MATH 103A,B02,083780,Staff,0,9,30,30
1650191158460,MATH 105,A01,085443,Staff,0,17,30,30
1650191164484,MATH 109,A01,083213,Anzaldo; Leesa B,0,3,30,30
1650191164484,MATH 109,A02,083214,Anzaldo; Leesa B,0,6,30,30
1650191164484,MATH 109,B01,083215,Anzaldo; Leesa B,0,4,30,30
1650191164484,MATH 109,B02,083216,Anzaldo; Leesa B,0,4,30,30
1650191170516,MATH 142A,A01,083219,Chow; Bennett,0,12,30,30
1650191170516,MATH 142A,A02,083220,Chow; Bennett,0,11,30,30
1650191170516,MATH 142A,B01,083221,Chow; Bennett,0,11,30,30
1650191170516,MATH 142A,B02,083222,Chow; Bennett,0,12,30,30
1650191176543,MATH 193A,A01,083224,Staff,0,4,30,30
1650191176543,MATH 193A,A02,083225,Staff,0,4,30,30
1650191176543,MATH 193A,A03,083781,Staff,0,2,30,30
1650191176543,MATH 193A,A04,083782,Staff,0,1,30,30
1650191182566,MATH 197,001,091859,McAuley; Julian John,9998,0,9999,1
1650191188621,COGS 9,A01,083615,Staff,0,14,60,60
1650191194645,COGS 11,A01,083617,Boyle; Mary E. T.,24,0,40,16
1650191200762,COGS 13,A01,083071,Staff,0,30,40,40
1650191206789,COGS 14A,A01,092681,Staff,0,12,100,100
1650191212816,COGS 14B,A01,083073,Cheng; Tzu-Han,0,7,50,50
1650191218840,COGS 17,A01,092677,Staff,35,0,75,40
1650191224865,COGS 100,A01,083619,Staff,0,20,60,60
1650191230890,COGS 101A,A01,083621,Davis; Joshua Daniel,0,21,60,60
1650191236917,COGS 101B,A01,091572,Staff,6,0,60,54
1650191242946,COGS 101C,A01,083625,Delgado; Tania,20,0,30,10
1650191248970,COGS 107A,A01,083627,Boyle; Mary E. T.,0,7,60,60
1650191254994,COGS 118A,A01,083075,Staff,16,0,60,44
1650191261031,CSE 3,A50,083646,Miranda; Gregory Joseph,22,0,38,16
1650191261031,CSE 3,A51,083647,Miranda; Gregory Joseph,37,0,37,0
1650191267057,CSE 8A,A50,083650,Miranda; Gregory Joseph,0,17,40,40
1650191273084,CSE 11,A01,083080,Cao; Yingjun,0,68,40,40
1650191279107,CSE 12,A01,083652,Staff,0,7,100,100
1650191285131,CSE 15L,A01,083654,Staff,0,0,50,50
1650191285131,CSE 15L,A02,083655,Staff,6,0,50,44
1650191291156,CSE 20,A01,083657,Staff,53,0,80,27
1650191297178,CSE 30,A01,083084,Eldon; John,0,69,40,40
1650191303200,CSE 100,A01,083659,Cao; Yingjun,0,63,50,50
1650191309224,CSE 134B,A01,083661,Powell; Thomas Allan,0,27,65,65
1650191315248,CSE 140,A01,083663,Staff,1,0,75,74
1650191321275,CSE 140L,A01,083088,Eldon; John,0,4,75,75
1650191327299,CSE 175,A01,083665,Kumar; Rakesh,8,0,25,17
1650191333322,CSE 190,A00,092507,Dubnov; Shlomo,14,0,20,6
1650191339346,ECE 45,A01,083139,Staff,0,13,40,40
1650191345369,ECE 65,A50,083695,Staff,0,5,30,30
1650191351397,ECE 109,A01,091882,Touri; Behrouz,47,0,70,23
1650191357421,ECE 180,A00,083140,Abi Samra; Nicholas Camill,24,0,30,6
1650191357421,ECE 180,B00,083141,Abi Samra; Nicholas Camill,8,0,30,22
1650191363452,MATH 10A,A01,083735,Patchell; Gregory David,11,0,30,19
1650191363452,MATH 10A,A02,083736,Patchell; Gregory David,28,0,30,2
1650191363452,MATH 10A,A03,083737,Patchell; Gregory David,26,0,30,4
1650191369478,MATH 10B,A01,083207,Staff,0,5,30,30
1650191369478,MATH 10B,A02,083208,Staff,0,5,30,30
1650191369478,MATH 10B,B01,083739,Staff,17,0,30,13
1650191369478,MATH 10B,B02,083740,Staff,29,0,30,1
1650191375503,MATH 18,A01,083743,Staff,8,0,30,22
1650191375503,MATH 18,A02,083744,Staff,28,0,30,2
1650191375503,MATH 18,A03,083745,Staff,23,0,30,7
1650191375503,MATH 18,A04,083746,Staff,27,0,30,3
1650191375503,MATH 18,B01,083748,Staff,0,10,30,30
1650191375503,MATH 18,B02,083749,Staff,0,7,30,30
1650191375503,MATH 18,B03,083750,Staff,0,7,30,30
1650191375503,MATH 18,B04,083751,Staff,0,8,30,30
1650191381530,MATH 20A,A01,083754,Staff,26,0,40,14
1650191387558,MATH 20B,A01,083756,Staff,0,6,30,30
1650191387558,MATH 20B,A02,083757,Staff,0,6,30,30
1650191393581,MATH 20C,A01,083760,Staff,0,12,30,30
1650191393581,MATH 20C,A02,083761,Staff,0,12,30,30
1650191393581,MATH 20C,B01,083762,Staff,14,0,30,16
1650191393581,MATH 20C,B02,083763,Staff,28,0,30,2
1650191399608,MATH 20D,A01,083765,Staff,1,2,30,29
1650191399608,MATH 20D,A02,083766,Staff,10,0,30,20
1650191399608,MATH 20D,A03,083767,Staff,28,0,30,2
1650191405632,MATH 20E,A01,083771,Staff,8,0,30,22
1650191405632,MATH 20E,A02,083772,Staff,20,0,30,10
1650191405632,MATH 20E,B01,083773,Staff,0,0,30,30
1650191405632,MATH 20E,B02,083774,Staff,12,0,30,18
1650191411659,MATH 103A,A01,083777,Staff,0,9,30,30
1650191411659,MATH 103A,A02,083778,Staff,0,10,30,30
1650191411659,MATH 103A,B01,083779,Staff,0,9,30,30
1650191411659,MATH 103A,B02,083780,Staff,0,9,30,30
1650191417682,MATH 105,A01,085443,Staff,0,17,30,30
1650191423706,MATH 109,A01,083213,Anzaldo; Leesa B,0,3,30,30
1650191423706,MATH 109,A02,083214,Anzaldo; Leesa B,0,6,30,30
1650191423706,MATH 109,B01,083215,Anzaldo; Leesa B,0,4,30,30
1650191423706,MATH 109,B02,083216,Anzaldo; Leesa B,0,4,30,30
1650191429730,MATH 142A,A01,083219,Chow; Bennett,0,12,30,30
1650191429730,MATH 142A,A02,083220,Chow; Bennett,0,11,30,30
1650191429730,MATH 142A,B01,083221,Chow; Bennett,0,11,30,30
1650191429730,MATH 142A,B02,083222,Chow; Bennett,0,12,30,30
1650191435759,MATH 193A,A01,083224,Staff,0,4,30,30
1650191435759,MATH 193A,A02,083225,Staff,0,4,30,30
1650191435759,MATH 193A,A03,083781,Staff,0,2,30,30
1650191435759,MATH 193A,A04,083782,Staff,0,1,30,30
1650191441789,MATH 197,001,091859,McAuley; Julian John,9998,0,9999,1
1650191447853,COGS 9,A01,083615,Staff,0,14,60,60
1650191453879,COGS 11,A01,083617,Boyle; Mary E. T.,24,0,40,16
1650191459904,COGS 13,A01,083071,Staff,0,30,40,40
1650191465929,COGS 14A,A01,092681,Staff,0,12,100,100
1650191471953,COGS 14B,A01,083073,Cheng; Tzu-Han,0,7,50,50
1650191477979,COGS 17,A01,092677,Staff,35,0,75,40
1650191484007,COGS 100,A01,083619,Staff,0,20,60,60
1650191490034,COGS 101A,A01,083621,Davis; Joshua Daniel,0,21,60,60
1650191496063,COGS 101B,A01,091572,Staff,6,0,60,54
1650191502091,COGS 101C,A01,083625,Delgado; Tania,20,0,30,10
1650191508115,COGS 107A,A01,083627,Boyle; Mary E. T.,0,7,60,60
1650191514144,COGS 118A,A01,083075,Staff,16,0,60,44
1650191520169,CSE 3,A50,083646,Miranda; Gregory Joseph,22,0,38,16
1650191520169,CSE 3,A51,083647,Miranda; Gregory Joseph,37,0,37,0
1650191526208,CSE 8A,A50,083650,Miranda; Gregory Joseph,0,17,40,40
1650191532231,CSE 11,A01,083080,Cao; Yingjun,0,68,40,40
1650191538254,CSE 12,A01,083652,Staff,0,7,100,100
1650191544280,CSE 15L,A01,083654,Staff,0,0,50,50
1650191544280,CSE 15L,A02,083655,Staff,6,0,50,44
1650191550304,CSE 20,A01,083657,Staff,53,0,80,27
1650191556328,CSE 30,A01,083084,Eldon; John,0,69,40,40
1650191562358,CSE 100,A01,083659,Cao; Yingjun,0,63,50,50
1650191568382,CSE 134B,A01,083661,Powell; Thomas Allan,0,27,65,65
1650191574406,CSE 140,A01,083663,Staff,1,0,75,74
1650191580432,CSE 140L,A01,083088,Eldon; John,0,4,75,75
1650191586464,CSE 175,A01,083665,Kumar; Rakesh,8,0,25,17
1650191592487,CSE 190,A00,092507,Dubnov; Shlomo,14,0,20,6
1650191598512,ECE 45,A01,083139,Staff,0,13,40,40
1650191604535,ECE 65,A50,083695,Staff,0,5,30,30
1650191610575,ECE 109,A01,091882,Touri; Behrouz,47,0,70,23
1650191616607,ECE 180,A00,083140,Abi Samra; Nicholas Camill,24,0,30,6
1650191616607,ECE 180,B00,083141,Abi Samra; Nicholas Camill,8,0,30,22
1650191622640,MATH 10A,A01,083735,Patchell; Gregory David,11,0,30,19
1650191622640,MATH 10A,A02,083736,Patchell; Gregory David,28,0,30,2
1650191622640,MATH 10A,A03,083737,Patchell; Gregory David,26,0,30,4
1650191628663,MATH 10B,A01,083207,Staff,0,5,30,30
1650191628663,MATH 10B,A02,083208,Staff,0,5,30,30
1650191628663,MATH 10B,B01,083739,Staff,17,0,30,13
1650191628663,MATH 10B,B02,083740,Staff,29,0,30,1
1650191634690,MATH 18,A01,083743,Staff,8,0,30,22
1650191634690,MATH 18,A02,083744,Staff,28,0,30,2
1650191634690,MATH 18,A03,083745,Staff,23,0,30,7
1650191634690,MATH 18,A04,083746,Staff,27,0,30,3
1650191634690,MATH 18,B01,083748,Staff,0,10,30,30
1650191634690,MATH 18,B02,083749,Staff,0,7,30,30
1650191634690,MATH 18,B03,083750,Staff,0,7,30,30
1650191634690,MATH 18,B04,083751,Staff,0,8,30,30
1650191640728,MATH 20A,A01,083754,Staff,26,0,40,14
1650191646754,MATH 20B,A01,083756,Staff,0,6,30,30
1650191646754,MATH 20B,A02,083757,Staff,0,6,30,30
1650191652783,MATH 20C,A01,083760,Staff,0,12,30,30
1650191652783,MATH 20C,A02,083761,Staff,0,12,30,30
1650191652783,MATH 20C,B01,083762,Staff,14,0,30,16
1650191652783,MATH 20C,B02,083763,Staff,28,0,30,2
1650191658815,MATH 20D,A01,083765,Staff,1,2,30,29
1650191658815,MATH 20D,A02,083766,Staff,10,0,30,20
1650191658815,MATH 20D,A03,083767,Staff,28,0,30,2
1650191664841,MATH 20E,A01,083771,Staff,8,0,30,22
1650191664841,MATH 20E,A02,083772,Staff,20,0,30,10
1650191664841,MATH 20E,B01,083773,Staff,0,0,30,30
1650191664841,MATH 20E,B02,083774,Staff,12,0,30,18
1650191670866,MATH 103A,A01,083777,Staff,0,9,30,30
1650191670866,MATH 103A,A02,083778,Staff,0,10,30,30
1650191670866,MATH 103A,B01,083779,Staff,0,9,30,30
1650191670866,MATH 103A,B02,083780,Staff,0,9,30,30
1650191676892,MATH 105,A01,085443,Staff,0,17,30,30
1650191682926,MATH 109,A01,083213,Anzaldo; Leesa B,0,3,30,30
1650191682926,MATH 109,A02,083214,Anzaldo; Leesa B,0,6,30,30
1650191682926,MATH 109,B01,083215,Anzaldo; Leesa B,0,4,30,30
1650191682926,MATH 109,B02,083216,Anzaldo; Leesa B,0,4,30,30
1650191688956,MATH 142A,A01,083219,Chow; Bennett,0,12,30,30
1650191688956,MATH 142A,A02,083220,Chow; Bennett,0,11,30,30
1650191688956,MATH 142A,B01,083221,Chow; Bennett,0,11,30,30
1650191688956,MATH 142A,B02,083222,Chow; Bennett,0,12,30,30
1650191694982,MATH 193A,A01,083224,Staff,0,4,30,30
1650191694982,MATH 193A,A02,083225,Staff,0,4,30,30
1650191694982,MATH 193A,A03,083781,Staff,0,2,30,30
1650191694982,MATH 193A,A04,083782,Staff,0,1,30,30
1650191701011,MATH 197,001,091859,McAuley; Julian John,9998,0,9999,1
1650191707084,COGS 9,A01,083615,Staff,0,14,60,60
1650191713110,COGS 11,A01,083617,Boyle; Mary E. T.,24,0,40,16
1650191719141,COGS 13,A01,083071,Staff,0,30,40,40
1650191725167,COGS 14A,A01,092681,Staff,0,12,100,100
1650191731194,COGS 14B,A01,083073,Cheng; Tzu-Han,0,7,50,50
1650191737220,COGS 17,A01,092677,Staff,35,0,75,40
1650191743243,COGS 100,A01,083619,Staff,0,20,60,60
1650191749275,COGS 101A,A01,083621,Davis; Joshua Daniel,0,21,60,60
1650191755304,COGS 101B,A01,091572,Staff,6,0,60,54
1650191761329,COGS 101C,A01,083625,Delgado; Tania,20,0,30,10
1650191767355,COGS 107A,A01,083627,Boyle; Mary E. T.,0,7,60,60
1650191773378,COGS 118A,A01,083075,Staff,16,0,60,44
1650191779403,CSE 3,A50,083646,Miranda; Gregory Joseph,22,0,38,16
1650191779403,CSE 3,A51,083647,Miranda; Gregory Joseph,37,0,37,0
1650191785428,CSE 8A,A50,083650,Miranda; Gregory Joseph,0,17,40,40
1650191791451,CSE 11,A01,083080,Cao; Yingjun,0,68,40,40
1650191797588,CSE 12,A01,083652,Staff,0,7,100,100
1650191803616,CSE 15L,A01,083654,Staff,0,0,50,50
1650191803616,CSE 15L,A02,083655,Staff,6,0,50,44
1650191809639,CSE 20,A01,083657,Staff,53,0,80,27
1650191815668,CSE 30,A01,083084,Eldon; John,0,69,40,40
1650191821703,CSE 100,A01,083659,Cao; Yingjun,0,63,50,50
1650191827744,CSE 134B,A01,083661,Powell; Thomas Allan,0,27,65,65
1650191833775,CSE 140,A01,083663,Staff,1,0,75,74
1650191839812,CSE 140L,A01,083088,Eldon; John,0,4,75,75
1650191845855,CSE 175,A01,083665,Kumar; Rakesh,8,0,25,17
1650191851882,CSE 190,A00,092507,Dubnov; Shlomo,14,0,20,6
1650191857919,ECE 45,A01,083139,Staff,0,13,40,40
1650191863947,ECE 65,A50,083695,Staff,0,5,30,30
1650191869990,ECE 109,A01,091882,Touri; Behrouz,47,0,70,23
1650191876020,ECE 180,A00,083140,Abi Samra; Nicholas Camill,24,0,30,6
1650191876020,ECE 180,B00,083141,Abi Samra; Nicholas Camill,8,0,30,22
1650191882057,MATH 10A,A01,083735,Patchell; Gregory David,11,0,30,19
1650191882057,MATH 10A,A02,083736,Patchell; Gregory David,28,0,30,2
1650191882057,MATH 10A,A03,083737,Patchell; Gregory David,26,0,30,4
1650191888092,MATH 10B,A01,083207,Staff,0,5,30,30
1650191888092,MATH 10B,A02,083208,Staff,0,5,30,30
1650191888092,MATH 10B,B01,083739,Staff,17,0,30,13
1650191888092,MATH 10B,B02,083740,Staff,29,0,30,1
1650191894122,MATH 18,A01,083743,Staff,8,0,30,22
1650191894122,MATH 18,A02,083744,Staff,28,0,30,2
1650191894122,MATH 18,A03,083745,Staff,23,0,30,7
1650191894122,MATH 18,A04,083746,Staff,27,0,30,3
1650191894122,MATH 18,B01,083748,Staff,0,10,30,30
1650191894122,MATH 18,B02,083749,Staff,0,7,30,30
1650191894122,MATH 18,B03,083750,Staff,0,7,30,30
1650191894122,MATH 18,B04,083751,Staff,0,8,30,30
1650191900158,MATH 20A,A01,083754,Staff,26,0,40,14
1650191906182,MATH 20B,A01,083756,Staff,0,6,30,30
1650191906182,MATH 20B,A02,083757,Staff,0,6,30,30
1650191912212,MATH 20C,A01,083760,Staff,0,12,30,30
1650191912212,MATH 20C,A02,083761,Staff,0,12,30,30
1650191912212,MATH 20C,B01,083762,Staff,14,0,30,16
1650191912212,MATH 20C,B02,083763,Staff,28,0,30,2
1650191918252,MATH 20D,A01,083765,Staff,1,2,30,29
1650191918252,MATH 20D,A02,083766,Staff,10,0,30,20
1650191918252,MATH 20D,A03,083767,Staff,28,0,30,2
1650191924277,MATH 20E,A01,083771,Staff,8,0,30,22
1650191924277,MATH 20E,A02,083772,Staff,20,0,30,10
1650191924277,MATH 20E,B01,083773,Staff,0,0,30,30
1650191924277,MATH 20E,B02,083774,Staff,12,0,30,18
1650191930308,MATH 103A,A01,083777,Staff,0,9,30,30
1650191930308,MATH 103A,A02,083778,Staff,0,10,30,30
1650191930308,MATH 103A,B01,083779,Staff,0,9,30,30
1650191930308,MATH 103A,B02,083780,Staff,0,9,30,30
1650191936333,MATH 105,A01,085443,Staff,0,17,30,30
1650191942363,MATH 109,A01,083213,Anzaldo; Leesa B,0,3,30,30
1650191942363,MATH 109,A02,083214,Anzaldo; Leesa B,0,6,30,30
1650191942363,MATH 109,B01,083215,Anzaldo; Leesa B,0,4,30,30
1650191942363,MATH 109,B02,083216,Anzaldo; Leesa B,0,4,30,30
1650191948393,MATH 142A,A01,083219,Chow; Bennett,0,12,30,30
1650191948393,MATH 142A,A02,083220,Chow; Bennett,0,11,30,30
1650191948393,MATH 142A,B01,083221,Chow; Bennett,0,11,30,30
1650191948393,MATH 142A,B02,083222,Chow; Bennett,0,12,30,30
1650191954421,MATH 193A,A01,083224,Staff,0,4,30,30
1650191954421,MATH 193A,A02,083225,Staff,0,4,30,30
1650191954421,MATH 193A,A03,083781,Staff,0,2,30,30
1650191954421,MATH 193A,A04,083782,Staff,0,1,30,30
1650191960447,MATH 197,001,091859,McAuley; Julian John,9998,0,9999,1
1650191966516,COGS 9,A01,083615,Staff,0,14,60,60
1650191972540,COGS 11,A01,083617,Boyle; Mary E. T.,24,0,40,16
1650191978566,COGS 13,A01,083071,Staff,0,30,40,40
1650191984590,COGS 14A,A01,092681,Staff,0,12,100,100
1650191990614,COGS 14B,A01,083073,Cheng; Tzu-Han,0,7,50,50
1650191996637,COGS 17,A01,092677,Staff,35,0,75,40
1650192002662,COGS 100,A01,083619,Staff,0,20,60,60
1650192008687,COGS 101A,A01,083621,Davis; Joshua Daniel,0,21,60,60
1650192014712,COGS 101B,A01,091572,Staff,6,0,60,54
1650192020742,COGS 101C,A01,083625,Delgado; Tania,20,0,30,10
1650192026767,COGS 107A,A01,083627,Boyle; Mary E. T.,0,7,60,60
1650192032793,COGS 118A,A01,083075,Staff,16,0,60,44
1650192038830,CSE 3,A50,083646,Miranda; Gregory Joseph,22,0,38,16
1650192038830,CSE 3,A51,083647,Miranda; Gregory Joseph,37,0,37,0
1650192044859,CSE 8A,A50,083650,Miranda; Gregory Joseph,0,17,40,40
1650192050886,CSE 11,A01,083080,Cao; Yingjun,0,68,40,40
1650192056910,CSE 12,A01,083652,Staff,0,7,100,100
1650192062933,CSE 15L,A01,083654,Staff,0,0,50,50
1650192062933,CSE 15L,A02,083655,Staff,6,0,50,44
1650192068957,CSE 20,A01,083657,Staff,53,0,80,27
1650192074985,CSE 30,A01,083084,Eldon; John,0,69,40,40
1650192081009,CSE 100,A01,083659,Cao; Yingjun,0,63,50,50
1650192087042,CSE 134B,A01,083661,Powell; Thomas Allan,0,27,65,65
1650192093067,CSE 140,A01,083663,Staff,1,0,75,74
1650192099093,CSE 140L,A01,083088,Eldon; John,0,4,75,75
1650192105117,CSE 175,A01,083665,Kumar; Rakesh,8,0,25,17
1650192111141,CSE 190,A00,092507,Dubnov; Shlomo,14,0,20,6
1650192117170,ECE 45,A01,083139,Staff,0,13,40,40
1650192123193,ECE 65,A50,083695,Staff,0,5,30,30
1650192129217,ECE 109,A01,091882,Touri; Behrouz,47,0,70,23
1650192135240,ECE 180,A00,083140,Abi Samra; Nicholas Camill,24,0,30,6
1650192135240,ECE 180,B00,083141,Abi Samra; Nicholas Camill,8,0,30,22
1650192141273,MATH 10A,A01,083735,Patchell; Gregory David,11,0,30,19
1650192141273,MATH 10A,A02,083736,Patchell; Gregory David,28,0,30,2
1650192141273,MATH 10A,A03,083737,Patchell; Gregory David,26,0,30,4
1650192147300,MATH 10B,A01,083207,Staff,0,5,30,30
1650192147300,MATH 10B,A02,083208,Staff,0,5,30,30
1650192147300,MATH 10B,B01,083739,Staff,17,0,30,13
1650192147300,MATH 10B,B02,083740,Staff,29,0,30,1
1650192153335,MATH 18,A01,083743,Staff,8,0,30,22
1650192153335,MATH 18,A02,083744,Staff,28,0,30,2
1650192153335,MATH 18,A03,083745,Staff,23,0,30,7
1650192153335,MATH 18,A04,083746,Staff,27,0,30,3
1650192153335,MATH 18,B01,083748,Staff,0,10,30,30
1650192153335,MATH 18,B02,083749,Staff,0,7,30,30
1650192153335,MATH 18,B03,083750,Staff,0,7,30,30
1650192153335,MATH 18,B04,083751,Staff,0,8,30,30
1650192159359,MATH 20A,A01,083754,Staff,26,0,40,14
1650192165384,MATH 20B,A01,083756,Staff,0,6,30,30
1650192165384,MATH 20B,A02,083757,Staff,0,6,30,30
1650192171407,MATH 20C,A01,083760,Staff,0,12,30,30
1650192171407,MATH 20C,A02,083761,Staff,0,12,30,30
1650192171407,MATH 20C,B01,083762,Staff,14,0,30,16
1650192171407,MATH 20C,B02,083763,Staff,28,0,30,2
1650192177433,MATH 20D,A01,083765,Staff,1,2,30,29
1650192177433,MATH 20D,A02,083766,Staff,10,0,30,20
1650192177433,MATH 20D,A03,083767,Staff,28,0,30,2
1650192183459,MATH 20E,A01,083771,Staff,8,0,30,22
1650192183459,MATH 20E,A02,083772,Staff,20,0,30,10
1650192183459,MATH 20E,B01,083773,Staff,0,0,30,30
1650192183459,MATH 20E,B02,083774,Staff,12,0,30,18
1650192189484,MATH 103A,A01,083777,Staff,0,9,30,30
1650192189484,MATH 103A,A02,083778,Staff,0,10,30,30
1650192189484,MATH 103A,B01,083779,Staff,0,9,30,30
1650192189484,MATH 103A,B02,083780,Staff,0,9,30,30
1650192195506,MATH 105,A01,085443,Staff,0,17,30,30
1650192201536,MATH 109,A01,083213,Anzaldo; Leesa B,0,3,30,30
1650192201536,MATH 109,A02,083214,Anzaldo; Leesa B,0,6,30,30
1650192201536,MATH 109,B01,083215,Anzaldo; Leesa B,0,4,30,30
1650192201536,MATH 109,B02,083216,Anzaldo; Leesa B,0,4,30,30
1650192207560,MATH 142A,A01,083219,Chow; Bennett,0,12,30,30
1650192207560,MATH 142A,A02,083220,Chow; Bennett,0,11,30,30
1650192207560,MATH 142A,B01,083221,Chow; Bennett,0,11,30,30
1650192207560,MATH 142A,B02,083222,Chow; Bennett,0,12,30,30
1650192213583,MATH 193A,A01,083224,Staff,0,4,30,30
1650192213583,MATH 193A,A02,083225,Staff,0,4,30,30
1650192213583,MATH 193A,A03,083781,Staff,0,2,30,30
1650192213583,MATH 193A,A04,083782,Staff,0,1,30,30
1650192219605,MATH 197,001,091859,McAuley; Julian John,9998,0,9999,1
1650192225666,COGS 9,A01,083615,Staff,0,14,60,60
1650192231690,COGS 11,A01,083617,Boyle; Mary E. T.,24,0,40,16
1650192237713,COGS 13,A01,083071,Staff,0,30,40,40
1650192243738,COGS 14A,A01,092681,Staff,0,12,100,100
1650192249764,COGS 14B,A01,083073,Cheng; Tzu-Han,0,7,50,50
1650192255790,COGS 17,A01,092677,Staff,35,0,75,40
1650192261822,COGS 100,A01,083619,Staff,0,20,60,60
1650192267851,COGS 101A,A01,083621,Davis; Joshua Daniel,0,21,60,60
1650192273875,COGS 101B,A01,091572,Staff,6,0,60,54
1650192279904,COGS 101C,A01,083625,Delgado; Tania,20,0,30,10
1650192285931,COGS 107A,A01,083627,Boyle; Mary E. T.,0,7,60,60
1650192291954,COGS 118A,A01,083075,Staff,16,0,60,44
1650192297980,CSE 3,A50,083646,Miranda; Gregory Joseph,22,0,38,16
1650192297980,CSE 3,A51,083647,Miranda; Gregory Joseph,37,0,37,0
1650192304004,CSE 8A,A50,083650,Miranda; Gregory Joseph,0,17,40,40
1650192310034,CSE 11,A01,083080,Cao; Yingjun,0,68,40,40
1650192316057,CSE 12,A01,083652,Staff,0,7,100,100
1650192322082,CSE 15L,A01,083654,Staff,0,0,50,50
1650192322082,CSE 15L,A02,083655,Staff,6,0,50,44
1650192328109,CSE 20,A01,083657,Staff,53,0,80,27
1650192334135,CSE 30,A01,083084,Eldon; John,0,69,40,40
1650192340159,CSE 100,A01,083659,Cao; Yingjun,0,63,50,50
1650192346183,CSE 134B,A01,083661,Powell; Thomas Allan,0,27,65,65
1650192352210,CSE 140,A01,083663,Staff,1,0,75,74
1650192358237,CSE 140L,A01,083088,Eldon; John,0,4,75,75
1650192364273,CSE 175,A01,083665,Kumar; Rakesh,8,0,25,17
1650192370298,CSE 190,A00,092507,Dubnov; Shlomo,14,0,20,6
1650192376325,ECE 45,A01,083139,Staff,0,13,40,40
1650192382360,ECE 65,A50,083695,Staff,0,5,30,30
1650192388384,ECE 109,A01,091882,Touri; Behrouz,47,0,70,23
1650192394500,ECE 180,A00,083140,Abi Samra; Nicholas Camill,24,0,30,6
1650192394500,ECE 180,B00,083141,Abi Samra; Nicholas Camill,8,0,30,22
1650192400527,MATH 10A,A01,083735,Patchell; Gregory David,11,0,30,19
1650192400527,MATH 10A,A02,083736,Patchell; Gregory David,28,0,30,2
1650192400527,MATH 10A,A03,083737,Patchell; Gregory David,26,0,30,4
1650192406559,MATH 10B,A01,083207,Staff,0,5,30,30
1650192406559,MATH 10B,A02,083208,Staff,0,5,30,30
1650192406559,MATH 10B,B01,083739,Staff,17,0,30,13
1650192406559,MATH 10B,B02,083740,Staff,29,0,30,1
1650192412587,MATH 18,A01,083743,Staff,8,0,30,22
1650192412587,MATH 18,A02,083744,Staff,28,0,30,2
1650192412587,MATH 18,A03,083745,Staff,23,0,30,7
1650192412587,MATH 18,A04,083746,Staff,27,0,30,3
1650192412587,MATH 18,B01,083748,Staff,0,10,30,30
1650192412587,MATH 18,B02,083749,Staff,0,7,30,30
1650192412587,MATH 18,B03,083750,Staff,0,7,30,30
1650192412587,MATH 18,B04,083751,Staff,0,8,30,30
1650192418611,MATH 20A,A01,083754,Staff,26,0,40,14
1650192424637,MATH 20B,A01,083756,Staff,0,6,30,30
1650192424637,MATH 20B,A02,083757,Staff,0,6,30,30
1650192430660,MATH 20C,A01,083760,Staff,0,12,30,30
1650192430660,MATH 20C,A02,083761,Staff,0,12,30,30
1650192430660,MATH 20C,B01,083762,Staff,14,0,30,16
1650192430660,MATH 20C,B02,083763,Staff,28,0,30,2
1650192436684,MATH 20D,A01,083765,Staff,1,2,30,29
1650192436684,MATH 20D,A02,083766,Staff,10,0,30,20
1650192436684,MATH 20D,A03,083767,Staff,28,0,30,2
1650192442710,MATH 20E,A01,083771,Staff,8,0,30,22
1650192442710,MATH 20E,A02,083772,Staff,20,0,30,10
1650192442710,MATH 20E,B01,083773,Staff,0,0,30,30
1650192442710,MATH 20E,B02,083774,Staff,12,0,30,18
1650192448741,MATH 103A,A01,083777,Staff,0,9,30,30
1650192448741,MATH 103A,A02,083778,Staff,0,10,30,30
1650192448741,MATH 103A,B01,083779,Staff,0,9,30,30
1650192448741,MATH 103A,B02,083780,Staff,0,9,30,30
1650192454765,MATH 105,A01,085443,Staff,0,17,30,30
1650192460796,MATH 109,A01,083213,Anzaldo; Leesa B,0,3,30,30
1650192460796,MATH 109,A02,083214,Anzaldo; Leesa B,0,6,30,30
1650192460796,MATH 109,B01,083215,Anzaldo; Leesa B,0,4,30,30
1650192460796,MATH 109,B02,083216,Anzaldo; Leesa B,0,4,30,30
1650192466821,MATH 142A,A01,083219,Chow; Bennett,0,12,30,30
1650192466821,MATH 142A,A02,083220,Chow; Bennett,0,11,30,30
1650192466821,MATH 142A,B01,083221,Chow; Bennett,0,11,30,30
1650192466821,MATH 142A,B02,083222,Chow; Bennett,0,12,30,30
1650192472846,MATH 193A,A01,083224,Staff,0,4,30,30
1650192472846,MATH 193A,A02,083225,Staff,0,4,30,30
1650192472846,MATH 193A,A03,083781,Staff,0,2,30,30
1650192472846,MATH 193A,A04,083782,Staff,0,1,30,30
1650192478873,MATH 197,001,091859,McAuley; Julian John,9998,0,9999,1
1650192484940,COGS 9,A01,083615,Staff,0,14,60,60
1650192490962,COGS 11,A01,083617,Boyle; Mary E. T.,24,0,40,16
1650192496989,COGS 13,A01,083071,Staff,0,30,40,40
1650192503013,COGS 14A,A01,092681,Staff,0,12,100,100
1650192509041,COGS 14B,A01,083073,Cheng; Tzu-Han,0,7,50,50
1650192515064,COGS 17,A01,092677,Staff,35,0,75,40
1650192521088,COGS 100,A01,083619,Staff,0,20,60,60
1650192527113,COGS 101A,A01,083621,Davis; Joshua Daniel,0,21,60,60
1650192533136,COGS 101B,A01,091572,Staff,6,0,60,54
1650192539162,COGS 101C,A01,083625,Delgado; Tania,20,0,30,10
1650192545187,COGS 107A,A01,083627,Boyle; Mary E. T.,0,7,60,60
1650192551212,COGS 118A,A01,083075,Staff,16,0,60,44
1650192557245,CSE 3,A50,083646,Miranda; Gregory Joseph,22,0,38,16
1650192557245,CSE 3,A51,083647,Miranda; Gregory Joseph,37,0,37,0
1650192563273,CSE 8A,A50,083650,Miranda; Gregory Joseph,0,17,40,40
1650192569302,CSE 11,A01,083080,Cao; Yingjun,0,68,40,40
1650192575327,CSE 12,A01,083652,Staff,0,7,100,100
1650192581349,CSE 15L,A01,083654,Staff,0,0,50,50
1650192581349,CSE 15L,A02,083655,Staff,6,0,50,44
1650192587375,CSE 20,A01,083657,Staff,53,0,80,27
1650192593401,CSE 30,A01,083084,Eldon; John,0,69,40,40
1650192599425,CSE 100,A01,083659,Cao; Yingjun,0,63,50,50
1650192605450,CSE 134B,A01,083661,Powell; Thomas Allan,0,27,65,65
1650192611473,CSE 140,A01,083663,Staff,1,0,75,74
1650192617506,CSE 140L,A01,083088,Eldon; John,0,4,75,75
1650192623531,CSE 175,A01,083665,Kumar; Rakesh,8,0,25,17
1650192629562,CSE 190,A00,092507,Dubnov; Shlomo,14,0,20,6
1650192635585,ECE 45,A01,083139,Staff,0,13,40,40
1650192641612,ECE 65,A50,083695,Staff,0,5,30,30
1650192647637,ECE 109,A01,091882,Touri; Behrouz,47,0,70,23
1650192653665,ECE 180,A00,083140,Abi Samra; Nicholas Camill,24,0,30,6
1650192653665,ECE 180,B00,083141,Abi Samra; Nicholas Camill,8,0,30,22
1650192659690,MATH 10A,A01,083735,Patchell; Gregory David,11,0,30,19
1650192659690,MATH 10A,A02,083736,Patchell; Gregory David,28,0,30,2
1650192659690,MATH 10A,A03,083737,Patchell; Gregory David,26,0,30,4
1650192665717,MATH 10B,A01,083207,Staff,0,5,30,30
1650192665717,MATH 10B,A02,083208,Staff,0,5,30,30
1650192665717,MATH 10B,B01,083739,Staff,17,0,30,13
1650192665717,MATH 10B,B02,083740,Staff,29,0,30,1
1650192671744,MATH 18,A01,083743,Staff,8,0,30,22
1650192671744,MATH 18,A02,083744,Staff,28,0,30,2
1650192671744,MATH 18,A03,083745,Staff,23,0,30,7
1650192671744,MATH 18,A04,083746,Staff,27,0,30,3
1650192671744,MATH 18,B01,083748,Staff,0,10,30,30
1650192671744,MATH 18,B02,083749,Staff,0,7,30,30
1650192671744,MATH 18,B03,083750,Staff,0,7,30,30
1650192671744,MATH 18,B04,083751,Staff,0,8,30,30
1650192677767,MATH 20A,A01,083754,Staff,26,0,40,14
1650192683803,MATH 20B,A01,083756,Staff,0,6,30,30
1650192683803,MATH 20B,A02,083757,Staff,0,6,30,30
1650192689829,MATH 20C,A01,083760,Staff,0,12,30,30
1650192689829,MATH 20C,A02,083761,Staff,0,12,30,30
1650192689829,MATH 20C,B01,083762,Staff,14,0,30,16
1650192689829,MATH 20C,B02,083763,Staff,28,0,30,2
1650192695854,MATH 20D,A01,083765,Staff,1,2,30,29
1650192695854,MATH 20D,A02,083766,Staff,10,0,30,20
1650192695854,MATH 20D,A03,083767,Staff,28,0,30,2
1650192701885,MATH 20E,A01,083771,Staff,8,0,30,22
1650192701885,MATH 20E,A02,083772,Staff,20,0,30,10
1650192701885,MATH 20E,B01,083773,Staff,0,0,30,30
1650192701885,MATH 20E,B02,083774,Staff,12,0,30,18
1650192707915,MATH 103A,A01,083777,Staff,0,9,30,30
1650192707915,MATH 103A,A02,083778,Staff,0,10,30,30
1650192707915,MATH 103A,B01,083779,Staff,0,9,30,30
1650192707915,MATH 103A,B02,083780,Staff,0,9,30,30
1650192713946,MATH 105,A01,085443,Staff,0,17,30,30
1650192719979,MATH 109,A01,083213,Anzaldo; Leesa B,0,3,30,30
1650192719979,MATH 109,A02,083214,Anzaldo; Leesa B,0,6,30,30
1650192719979,MATH 109,B01,083215,Anzaldo; Leesa B,0,4,30,30
1650192719979,MATH 109,B02,083216,Anzaldo; Leesa B,0,4,30,30
1650192726013,MATH 142A,A01,083219,Chow; Bennett,0,12,30,30
1650192726013,MATH 142A,A02,083220,Chow; Bennett,0,11,30,30
1650192726013,MATH 142A,B01,083221,Chow; Bennett,0,11,30,30
1650192726013,MATH 142A,B02,083222,Chow; Bennett,0,12,30,30
1650192732043,MATH 193A,A01,083224,Staff,0,4,30,30
1650192732043,MATH 193A,A02,083225,Staff,0,4,30,30
1650192732043,MATH 193A,A03,083781,Staff,0,2,30,30
1650192732043,MATH 193A,A04,083782,Staff,0,1,30,30
1650192738071,MATH 197,001,091859,McAuley; Julian John,9998,0,9999,1
1650192744146,COGS 9,A01,083615,Staff,0,14,60,60
1650192750171,COGS 11,A01,083617,Boyle; Mary E. T.,24,0,40,16
1650192756207,COGS 13,A01,083071,Staff,0,30,40,40
1650192762231,COGS 14A,A01,092681,Staff,0,12,100,100
1650192768256,COGS 14B,A01,083073,Cheng; Tzu-Han,0,7,50,50
1650192774285,COGS 17,A01,092677,Staff,35,0,75,40
1650192780317,COGS 100,A01,083619,Staff,0,20,60,60
1650192786341,COGS 101A,A01,083621,Davis; Joshua Daniel,0,21,60,60
1650192792367,COGS 101B,A01,091572,Staff,6,0,60,54
1650192798396,COGS 101C,A01,083625,Delgado; Tania,20,0,30,10
1650192804421,COGS 107A,A01,083627,Boyle; Mary E. T.,0,7,60,60
1650192810448,COGS 118A,A01,083075,Staff,16,0,60,44
1650192816483,CSE 3,A50,083646,Miranda; Gregory Joseph,22,0,38,16
1650192816483,CSE 3,A51,083647,Miranda; Gregory Joseph,37,0,37,0
1650192822505,CSE 8A,A50,083650,Miranda; Gregory Joseph,0,17,40,40
1650192828530,CSE 11,A01,083080,Cao; Yingjun,0,68,40,40
1650192834565,CSE 12,A01,083652,Staff,0,7,100,100
1650192840606,CSE 15L,A01,083654,Staff,0,0,50,50
1650192840606,CSE 15L,A02,083655,Staff,6,0,50,44
1650192846635,CSE 20,A01,083657,Staff,53,0,80,27
1650192852662,CSE 30,A01,083084,Eldon; John,0,69,40,40
1650192858687,CSE 100,A01,083659,Cao; Yingjun,0,63,50,50
1650192864716,CSE 134B,A01,083661,Powell; Thomas Allan,0,27,65,65
1650192870740,CSE 140,A01,083663,Staff,1,0,75,74
1650192876778,CSE 140L,A01,083088,Eldon; John,0,4,75,75
1650192882803,CSE 175,A01,083665,Kumar; Rakesh,8,0,25,17
1650192888828,CSE 190,A00,092507,Dubnov; Shlomo,14,0,20,6
1650192894853,ECE 45,A01,083139,Staff,0,13,40,40
1650192900878,ECE 65,A50,083695,Staff,0,5,30,30
1650192906904,ECE 109,A01,091882,Touri; Behrouz,47,0,70,23
1650192912930,ECE 180,A00,083140,Abi Samra; Nicholas Camill,24,0,30,6
1650192912930,ECE 180,B00,083141,Abi Samra; Nicholas Camill,8,0,30,22
1650192918971,MATH 10A,A01,083735,Patchell; Gregory David,11,0,30,19
1650192918971,MATH 10A,A02,083736,Patchell; Gregory David,28,0,30,2
1650192918971,MATH 10A,A03,083737,Patchell; Gregory David,26,0,30,4
1650192925002,MATH 10B,A01,083207,Staff,0,5,30,30
1650192925002,MATH 10B,A02,083208,Staff,0,5,30,30
1650192925002,MATH 10B,B01,083739,Staff,17,0,30,13
1650192925002,MATH 10B,B02,083740,Staff,29,0,30,1
1650192931038,MATH 18,A01,083743,Staff,8,0,30,22
1650192931038,MATH 18,A02,083744,Staff,28,0,30,2
1650192931038,MATH 18,A03,083745,Staff,23,0,30,7
1650192931038,MATH 18,A04,083746,Staff,27,0,30,3
1650192931038,MATH 18,B01,083748,Staff,0,10,30,30
1650192931038,MATH 18,B02,083749,Staff,0,7,30,30
1650192931038,MATH 18,B03,083750,Staff,0,7,30,30
1650192931038,MATH 18,B04,083751,Staff,0,8,30,30
1650192937065,MATH 20A,A01,083754,Staff,26,0,40,14
1650192943090,MATH 20B,A01,083756,Staff,0,6,30,30
1650192943090,MATH 20B,A02,083757,Staff,0,6,30,30
1650192949117,MATH 20C,A01,083760,Staff,0,12,30,30
1650192949117,MATH 20C,A02,083761,Staff,0,12,30,30
1650192949117,MATH 20C,B01,083762,Staff,14,0,30,16
1650192949117,MATH 20C,B02,083763,Staff,28,0,30,2
1650192955141,MATH 20D,A01,083765,Staff,1,2,30,29
1650192955141,MATH 20D,A02,083766,Staff,10,0,30,20
1650192955141,MATH 20D,A03,083767,Staff,28,0,30,2
1650192961164,MATH 20E,A01,083771,Staff,8,0,30,22
1650192961164,MATH 20E,A02,083772,Staff,20,0,30,10
1650192961164,MATH 20E,B01,083773,Staff,0,0,30,30
1650192961164,MATH 20E,B02,083774,Staff,12,0,30,18
1650192967187,MATH 103A,A01,083777,Staff,0,9,30,30
1650192967187,MATH 103A,A02,083778,Staff,0,10,30,30
1650192967187,MATH 103A,B01,083779,Staff,0,9,30,30
1650192967187,MATH 103A,B02,083780,Staff,0,9,30,30
1650192973216,MATH 105,A01,085443,Staff,0,17,30,30
1650192979252,MATH 109,A01,083213,Anzaldo; Leesa B,0,3,30,30
1650192979252,MATH 109,A02,083214,Anzaldo; Leesa B,0,6,30,30
1650192979252,MATH 109,B01,083215,Anzaldo; Leesa B,0,4,30,30
1650192979252,MATH 109,B02,083216,Anzaldo; Leesa B,0,4,30,30
1650192985279,MATH 142A,A01,083219,Chow; Bennett,0,12,30,30
1650192985279,MATH 142A,A02,083220,Chow; Bennett,0,11,30,30
1650192985279,MATH 142A,B01,083221,Chow; Bennett,0,11,30,30
1650192985279,MATH 142A,B02,083222,Chow; Bennett,0,12,30,30
1650192991389,MATH 193A,A01,083224,Staff,0,4,30,30
1650192991389,MATH 193A,A02,083225,Staff,0,4,30,30
1650192991389,MATH 193A,A03,083781,Staff,0,2,30,30
1650192991389,MATH 193A,A04,083782,Staff,0,1,30,30
1650192997412,MATH 197,001,091859,McAuley; Julian John,9998,0,9999,1
1650193003476,COGS 9,A01,083615,Staff,0,14,60,60
1650193009506,COGS 11,A01,083617,Boyle; Mary E. T.,24,0,40,16
1650193015531,COGS 13,A01,083071,Staff,0,30,40,40
1650193021561,COGS 14A,A01,092681,Staff,0,12,100,100
1650193027587,COGS 14B,A01,083073,Cheng; Tzu-Han,0,7,50,50
1650193033610,COGS 17,A01,092677,Staff,35,0,75,40
1650193039635,COGS 100,A01,083619,Staff,0,20,60,60
1650193045678,COGS 101A,A01,083621,Davis; Joshua Daniel,0,21,60,60
1650193051703,COGS 101B,A01,091572,Staff,6,0,60,54
1650193057727,COGS 101C,A01,083625,Delgado; Tania,20,0,30,10
1650193063756,COGS 107A,A01,083627,Boyle; Mary E. T.,0,7,60,60
1650193069781,COGS 118A,A01,083075,Staff,16,0,60,44
1650193075813,CSE 3,A50,083646,Miranda; Gregory Joseph,22,0,38,16
1650193075813,CSE 3,A51,083647,Miranda; Gregory Joseph,37,0,37,0
1650193081837,CSE 8A,A50,083650,Miranda; Gregory Joseph,0,17,40,40
1650193087867,CSE 11,A01,083080,Cao; Yingjun,0,68,40,40
1650193093891,CSE 12,A01,083652,Staff,0,7,100,100
1650193099918,CSE 15L,A01,083654,Staff,0,0,50,50
1650193099918,CSE 15L,A02,083655,Staff,6,0,50,44
1650193105941,CSE 20,A01,083657,Staff,53,0,80,27
1650193111965,CSE 30,A01,083084,Eldon; John,0,69,40,40
1650193117991,CSE 100,A01,083659,Cao; Yingjun,0,63,50,50
1650193124019,CSE 134B,A01,083661,Powell; Thomas Allan,0,27,65,65
1650193130042,CSE 140,A01,083663,Staff,1,0,75,74
1650193136069,CSE 140L,A01,083088,Eldon; John,0,4,75,75
1650193142094,CSE 175,A01,083665,Kumar; Rakesh,8,0,25,17
1650193148119,CSE 190,A00,092507,Dubnov; Shlomo,14,0,20,6
1650193154143,ECE 45,A01,083139,Staff,0,13,40,40
1650193160168,ECE 65,A50,083695,Staff,0,5,30,30
1650193166196,ECE 109,A01,091882,Touri; Behrouz,47,0,70,23
1650193172220,ECE 180,A00,083140,Abi Samra; Nicholas Camill,24,0,30,6
1650193172220,ECE 180,B00,083141,Abi Samra; Nicholas Camill,8,0,30,22
1650193178251,MATH 10A,A01,083735,Patchell; Gregory David,11,0,30,19
1650193178251,MATH 10A,A02,083736,Patchell; Gregory David,28,0,30,2
1650193178251,MATH 10A,A03,083737,Patchell; Gregory David,26,0,30,4
1650193184280,MATH 10B,A01,083207,Staff,0,5,30,30
1650193184280,MATH 10B,A02,083208,Staff,0,5,30,30
1650193184280,MATH 10B,B01,083739,Staff,17,0,30,13
1650193184280,MATH 10B,B02,083740,Staff,29,0,30,1
1650193190316,MATH 18,A01,083743,Staff,8,0,30,22
1650193190316,MATH 18,A02,083744,Staff,28,0,30,2
1650193190316,MATH 18,A03,083745,Staff,23,0,30,7
1650193190316,MATH 18,A04,083746,Staff,27,0,30,3
1650193190316,MATH 18,B01,083748,Staff,0,10,30,30
1650193190316,MATH 18,B02,083749,Staff,0,7,30,30
1650193190316,MATH 18,B03,083750,Staff,0,7,30,30
1650193190316,MATH 18,B04,083751,Staff,0,8,30,30
1650193196340,MATH 20A,A01,083754,Staff,26,0,40,14
1650193202364,MATH 20B,A01,083756,Staff,0,6,30,30
1650193202364,MATH 20B,A02,083757,Staff,0,6,30,30
1650193208393,MATH 20C,A01,083760,Staff,0,12,30,30
1650193208393,MATH 20C,A02,083761,Staff,0,12,30,30
1650193208393,MATH 20C,B01,083762,Staff,14,0,30,16
1650193208393,MATH 20C,B02,083763,Staff,28,0,30,2
1650193214419,MATH 20D,A01,083765,Staff,1,2,30,29
1650193214419,MATH 20D,A02,083766,Staff,10,0,30,20
1650193214419,MATH 20D,A03,083767,Staff,28,0,30,2
1650193220444,MATH 20E,A01,083771,Staff,8,0,30,22
1650193220444,MATH 20E,A02,083772,Staff,20,0,30,10
1650193220444,MATH 20E,B01,083773,Staff,0,0,30,30
1650193220444,MATH 20E,B02,083774,Staff,12,0,30,18
1650193226468,MATH 103A,A01,083777,Staff,0,9,30,30
1650193226468,MATH 103A,A02,083778,Staff,0,10,30,30
1650193226468,MATH 103A,B01,083779,Staff,0,9,30,30
1650193226468,MATH 103A,B02,083780,Staff,0,9,30,30
1650193232493,MATH 105,A01,085443,Staff,0,17,30,30
1650193238517,MATH 109,A01,083213,Anzaldo; Leesa B,0,3,30,30
1650193238517,MATH 109,A02,083214,Anzaldo; Leesa B,0,6,30,30
1650193238517,MATH 109,B01,083215,Anzaldo; Leesa B,0,4,30,30
1650193238517,MATH 109,B02,083216,Anzaldo; Leesa B,0,4,30,30
1650193244541,MATH 142A,A01,083219,Chow; Bennett,0,12,30,30
1650193244541,MATH 142A,A02,083220,Chow; Bennett,0,11,30,30
1650193244541,MATH 142A,B01,083221,Chow; Bennett,0,11,30,30
1650193244541,MATH 142A,B02,083222,Chow; Bennett,0,12,30,30
1650193250572,MATH 193A,A01,083224,Staff,0,4,30,30
1650193250572,MATH 193A,A02,083225,Staff,0,4,30,30
1650193250572,MATH 193A,A03,083781,Staff,0,2,30,30
1650193250572,MATH 193A,A04,083782,Staff,0,1,30,30
1650193256595,MATH 197,001,091859,McAuley; Julian John,9998,0,9999,1
1650193262674,COGS 9,A01,083615,Staff,0,14,60,60
1650193268699,COGS 11,A01,083617,Boyle; Mary E. T.,24,0,40,16
1650193274724,COGS 13,A01,083071,Staff,0,30,40,40
1650193280762,COGS 14A,A01,092681,Staff,0,12,100,100
1650193286792,COGS 14B,A01,083073,Cheng; Tzu-Han,0,7,50,50
1650193292817,COGS 17,A01,092677,Staff,35,0,75,40
1650193298845,COGS 100,A01,083619,Staff,0,20,60,60
1650193304874,COGS 101A,A01,083621,Davis; Joshua Daniel,0,21,60,60
1650193310903,COGS 101B,A01,091572,Staff,6,0,60,54
1650193316928,COGS 101C,A01,083625,Delgado; Tania,20,0,30,10
1650193322951,COGS 107A,A01,083627,Boyle; Mary E. T.,0,7,60,60
1650193328974,COGS 118A,A01,083075,Staff,16,0,60,44
1650193335001,CSE 3,A50,083646,Miranda; Gregory Joseph,22,0,38,16
1650193335001,CSE 3,A51,083647,Miranda; Gregory Joseph,37,0,37,0
1650193341042,CSE 8A,A50,083650,Miranda; Gregory Joseph,0,17,40,40
1650193347067,CSE 11,A01,083080,Cao; Yingjun,0,68,40,40
1650193353091,CSE 12,A01,083652,Staff,0,7,100,100
1650193359115,CSE 15L,A01,083654,Staff,0,0,50,50
1650193359115,CSE 15L,A02,083655,Staff,6,0,50,44
1650193365142,CSE 20,A01,083657,Staff,53,0,80,27
1650193371165,CSE 30,A01,083084,Eldon; John,0,69,40,40
1650193377189,CSE 100,A01,083659,Cao; Yingjun,0,63,50,50
1650193383222,CSE 134B,A01,083661,Powell; Thomas Allan,0,27,65,65
1650193389243,CSE 140,A01,083663,Staff,1,0,75,74
1650193395344,CSE 140L,A01,083088,Eldon; John,0,4,75,75
1650193401370,CSE 175,A01,083665,Kumar; Rakesh,8,0,25,17
1650193407394,CSE 190,A00,092507,Dubnov; Shlomo,14,0,20,6
1650193413430,ECE 45,A01,083139,Staff,0,13,40,40
1650193419462,ECE 65,A50,083695,Staff,0,5,30,30
1650193425495,ECE 109,A01,091882,Touri; Behrouz,47,0,70,23
1650193431528,ECE 180,A00,083140,Abi Samra; Nicholas Camill,24,0,30,6
1650193431528,ECE 180,B00,083141,Abi Samra; Nicholas Camill,8,0,30,22
1650193437554,MATH 10A,A01,083735,Patchell; Gregory David,11,0,30,19
1650193437554,MATH 10A,A02,083736,Patchell; Gregory David,28,0,30,2
1650193437554,MATH 10A,A03,083737,Patchell; Gregory David,26,0,30,4
1650193443580,MATH 10B,A01,083207,Staff,0,5,30,30
1650193443580,MATH 10B,A02,083208,Staff,0,5,30,30
1650193443580,MATH 10B,B01,083739,Staff,17,0,30,13
1650193443580,MATH 10B,B02,083740,Staff,29,0,30,1
1650193449606,MATH 18,A01,083743,Staff,8,0,30,22
1650193449606,MATH 18,A02,083744,Staff,28,0,30,2
1650193449606,MATH 18,A03,083745,Staff,23,0,30,7
1650193449606,MATH 18,A04,083746,Staff,27,0,30,3
1650193449606,MATH 18,B01,083748,Staff,0,10,30,30
1650193449606,MATH 18,B02,083749,Staff,0,7,30,30
1650193449606,MATH 18,B03,083750,Staff,0,7,30,30
1650193449606,MATH 18,B04,083751,Staff,0,8,30,30
1650193455630,MATH 20A,A01,083754,Staff,26,0,40,14
1650193461659,MATH 20B,A01,083756,Staff,0,6,30,30
1650193461659,MATH 20B,A02,083757,Staff,0,6,30,30
1650193467683,MATH 20C,A01,083760,Staff,0,12,30,30
1650193467683,MATH 20C,A02,083761,Staff,0,12,30,30
1650193467683,MATH 20C,B01,083762,Staff,14,0,30,16
1650193467683,MATH 20C,B02,083763,Staff,28,0,30,2
1650193473707,MATH 20D,A01,083765,Staff,1,2,30,29
1650193473707,MATH 20D,A02,083766,Staff,10,0,30,20
1650193473707,MATH 20D,A03,083767,Staff,28,0,30,2
1650193479737,MATH 20E,A01,083771,Staff,8,0,30,22
1650193479737,MATH 20E,A02,083772,Staff,20,0,30,10
1650193479737,MATH 20E,B01,083773,Staff,0,0,30,30
1650193479737,MATH 20E,B02,083774,Staff,12,0,30,18
1650193485769,MATH 103A,A01,083777,Staff,0,9,30,30
1650193485769,MATH 103A,A02,083778,Staff,0,10,30,30
1650193485769,MATH 103A,B01,083779,Staff,0,9,30,30
1650193485769,MATH 103A,B02,083780,Staff,0,9,30,30
1650193491794,MATH 105,A01,085443,Staff,0,17,30,30
1650193497824,MATH 109,A01,083213,Anzaldo; Leesa B,0,3,30,30
1650193497824,MATH 109,A02,083214,Anzaldo; Leesa B,0,6,30,30
1650193497824,MATH 109,B01,083215,Anzaldo; Leesa B,0,4,30,30
1650193497824,MATH 109,B02,083216,Anzaldo; Leesa B,0,4,30,30
1650193503852,MATH 142A,A01,083219,Chow; Bennett,0,12,30,30
1650193503852,MATH 142A,A02,083220,Chow; Bennett,0,11,30,30
1650193503852,MATH 142A,B01,083221,Chow; Bennett,0,11,30,30
1650193503852,MATH 142A,B02,083222,Chow; Bennett,0,12,30,30
1650193509882,MATH 193A,A01,083224,Staff,0,4,30,30
1650193509882,MATH 193A,A02,083225,Staff,0,4,30,30
1650193509882,MATH 193A,A03,083781,Staff,0,2,30,30
1650193509882,MATH 193A,A04,083782,Staff,0,1,30,30
1650193515905,MATH 197,001,091859,McAuley; Julian John,9998,0,9999,1
1650193521988,COGS 9,A01,083615,Staff,0,14,60,60
1650193528017,COGS 11,A01,083617,Boyle; Mary E. T.,24,0,40,16
1650193534044,COGS 13,A01,083071,Staff,0,30,40,40
1650193540070,COGS 14A,A01,092681,Staff,0,12,100,100
1650193546097,COGS 14B,A01,083073,Cheng; Tzu-Han,0,7,50,50
1650193552122,COGS 17,A01,092677,Staff,35,0,75,40
1650193558149,COGS 100,A01,083619,Staff,0,20,60,60
1650193564178,COGS 101A,A01,083621,Davis; Joshua Daniel,0,21,60,60
1650193570206,COGS 101B,A01,091572,Staff,6,0,60,54
1650193576236,COGS 101C,A01,083625,Delgado; Tania,20,0,30,10
1650193582262,COGS 107A,A01,083627,Boyle; Mary E. T.,0,7,60,60
1650193588287,COGS 118A,A01,083075,Staff,16,0,60,44
1650193594312,CSE 3,A50,083646,Miranda; Gregory Joseph,22,0,38,16
1650193594312,CSE 3,A51,083647,Miranda; Gregory Joseph,37,0,37,0
1650193600340,CSE 8A,A50,083650,Miranda; Gregory Joseph,0,17,40,40
1650193606364,CSE 11,A01,083080,Cao; Yingjun,0,68,40,40
1650193612389,CSE 12,A01,083652,Staff,0,7,100,100
1650193618417,CSE 15L,A01,083654,Staff,0,0,50,50
1650193618417,CSE 15L,A02,083655,Staff,6,0,50,44
1650193624447,CSE 20,A01,083657,Staff,53,0,80,27
1650193630472,CSE 30,A01,083084,Eldon; John,0,69,40,40
1650193636497,CSE 100,A01,083659,Cao; Yingjun,0,63,50,50
1650193642525,CSE 134B,A01,083661,Powell; Thomas Allan,0,27,65,65
1650193648552,CSE 140,A01,083663,Staff,1,0,75,74
1650193654576,CSE 140L,A01,083088,Eldon; John,0,4,75,75
1650193660604,CSE 175,A01,083665,Kumar; Rakesh,8,0,25,17
1650193666630,CSE 190,A00,092507,Dubnov; Shlomo,14,0,20,6
1650193672654,ECE 45,A01,083139,Staff,0,13,40,40
1650193678685,ECE 65,A50,083695,Staff,0,5,30,30
1650193684715,ECE 109,A01,091882,Touri; Behrouz,47,0,70,23
1650193690739,ECE 180,A00,083140,Abi Samra; Nicholas Camill,24,0,30,6
1650193690739,ECE 180,B00,083141,Abi Samra; Nicholas Camill,8,0,30,22
1650193696767,MATH 10A,A01,083735,Patchell; Gregory David,11,0,30,19
1650193696767,MATH 10A,A02,083736,Patchell; Gregory David,28,0,30,2
1650193696767,MATH 10A,A03,083737,Patchell; Gregory David,26,0,30,4
1650193702793,MATH 10B,A01,083207,Staff,0,5,30,30
1650193702793,MATH 10B,A02,083208,Staff,0,5,30,30
1650193702793,MATH 10B,B01,083739,Staff,17,0,30,13
1650193702793,MATH 10B,B02,083740,Staff,29,0,30,1
1650193708828,MATH 18,A01,083743,Staff,8,0,30,22
1650193708828,MATH 18,A02,083744,Staff,28,0,30,2
1650193708828,MATH 18,A03,083745,Staff,23,0,30,7
1650193708828,MATH 18,A04,083746,Staff,27,0,30,3
1650193708828,MATH 18,B01,083748,Staff,0,10,30,30
1650193708828,MATH 18,B02,083749,Staff,0,7,30,30
1650193708828,MATH 18,B03,083750,Staff,0,7,30,30
1650193708828,MATH 18,B04,083751,Staff,0,8,30,30
1650193714856,MATH 20A,A01,083754,Staff,26,0,40,14
1650193720887,MATH 20B,A01,083756,Staff,0,6,30,30
1650193720887,MATH 20B,A02,083757,Staff,0,6,30,30
1650193726918,MATH 20C,A01,083760,Staff,0,12,30,30
1650193726918,MATH 20C,A02,083761,Staff,0,12,30,30
1650193726918,MATH 20C,B01,083762,Staff,14,0,30,16
1650193726918,MATH 20C,B02,083763,Staff,28,0,30,2
1650193732942,MATH 20D,A01,083765,Staff,1,2,30,29
1650193732942,MATH 20D,A02,083766,Staff,10,0,30,20
1650193732942,MATH 20D,A03,083767,Staff,28,0,30,2
1650193738968,MATH 20E,A01,083771,Staff,8,0,30,22
1650193738968,MATH 20E,A02,083772,Staff,20,0,30,10
1650193738968,MATH 20E,B01,083773,Staff,0,0,30,30
1650193738968,MATH 20E,B02,083774,Staff,12,0,30,18
1650193745002,MATH 103A,A01,083777,Staff,0,9,30,30
1650193745002,MATH 103A,A02,083778,Staff,0,10,30,30
1650193745002,MATH 103A,B01,083779,Staff,0,9,30,30
1650193745002,MATH 103A,B02,083780,Staff,0,9,30,30
1650193751032,MATH 105,A01,085443,Staff,0,17,30,30
1650193757064,MATH 109,A01,083213,Anzaldo; Leesa B,0,3,30,30
1650193757064,MATH 109,A02,083214,Anzaldo; Leesa B,0,6,30,30
1650193757064,MATH 109,B01,083215,Anzaldo; Leesa B,0,4,30,30
1650193757064,MATH 109,B02,083216,Anzaldo; Leesa B,0,4,30,30
1650193763093,MATH 142A,A01,083219,Chow; Bennett,0,12,30,30
1650193763093,MATH 142A,A02,083220,Chow; Bennett,0,11,30,30
1650193763093,MATH 142A,B01,083221,Chow; Bennett,0,11,30,30
1650193763093,MATH 142A,B02,083222,Chow; Bennett,0,12,30,30
1650193769118,MATH 193A,A01,083224,Staff,0,4,30,30
1650193769118,MATH 193A,A02,083225,Staff,0,4,30,30
1650193769118,MATH 193A,A03,083781,Staff,0,2,30,30
1650193769118,MATH 193A,A04,083782,Staff,0,1,30,30
1650193775144,MATH 197,001,091859,McAuley; Julian John,9998,0,9999,1
1650193781244,COGS 9,A01,083615,Staff,0,14,60,60
1650193787272,COGS 11,A01,083617,Boyle; Mary E. T.,24,0,40,16
1650193793297,COGS 13,A01,083071,Staff,0,30,40,40
1650193799333,COGS 14A,A01,092681,Staff,0,12,100,100
1650193805357,COGS 14B,A01,083073,Cheng; Tzu-Han,0,7,50,50
1650193811379,COGS 17,A01,092677,Staff,35,0,75,40
1650193817404,COGS 100,A01,083619,Staff,0,20,60,60
1650193823450,COGS 101A,A01,083621,Davis; Joshua Daniel,0,21,60,60
1650193829488,COGS 101B,A01,091572,Staff,6,0,60,54
1650193835518,COGS 101C,A01,083625,Delgado; Tania,20,0,30,10
1650193841546,COGS 107A,A01,083627,Boyle; Mary E. T.,0,7,60,60
1650193847590,COGS 118A,A01,083075,Staff,16,0,60,44
1650193853617,CSE 3,A50,083646,Miranda; Gregory Joseph,22,0,38,16
1650193853617,CSE 3,A51,083647,Miranda; Gregory Joseph,37,0,37,0
1650193859644,CSE 8A,A50,083650,Miranda; Gregory Joseph,0,17,40,40
1650193865671,CSE 11,A01,083080,Cao; Yingjun,0,68,40,40
1650193871696,CSE 12,A01,083652,Staff,0,7,100,100
1650193877720,CSE 15L,A01,083654,Staff,0,0,50,50
1650193877720,CSE 15L,A02,083655,Staff,6,0,50,44
1650193883751,CSE 20,A01,083657,Staff,53,0,80,27
1650193889782,CSE 30,A01,083084,Eldon; John,0,69,40,40
