time,subj_course_id,sec_code,sec_id,prof,available,waitlist,total,enrolled_ct
1651058793939,COGS 9,A01,083615,Staff,0,20,60,60
1651058799965,COGS 11,A01,083617,Boyle; Mary E. T.,13,0,40,27
1651058805992,COGS 13,A01,083071,Staff,0,40,40,40
1651058812018,COGS 14A,A01,092681,Staff,0,40,100,100
1651058818045,COGS 14B,A01,083073,Cheng; Tzu-Han,0,13,50,50
1651058824080,COGS 17,A01,092677,Staff,9,0,75,66
1651058830113,COGS 100,A01,083619,Staff,0,30,60,60
1651058836146,COGS 101A,A01,083621,Davis; Joshua Daniel,0,29,60,60
1651058842180,COGS 101B,A01,091572,Staff,0,7,60,60
1651058848213,COGS 101C,A01,083625,Delgado; Tania,14,0,30,16
1651058854244,COGS 107A,A01,083627,Boyle; Mary E. T.,0,17,60,60
1651058860271,COGS 118A,A01,083075,Staff,0,10,60,60
1651058866304,CSE 3,A50,083646,Miranda; Gregory Joseph,15,0,38,23
1651058866304,CSE 3,A51,083647,Miranda; Gregory Joseph,36,0,37,1
1651058872345,CSE 8A,A50,083650,Miranda; Gregory Joseph,0,31,40,40
1651058878371,CSE 11,A01,083080,Cao; Yingjun,1,97,40,39
1651058884401,CSE 12,A01,083652,Staff,0,26,100,100
1651058890425,CSE 15L,A01,083654,Staff,0,3,50,50
1651058890425,CSE 15L,A02,083655,Staff,0,3,50,50
1651058896456,CSE 20,A01,083657,Staff,46,0,80,34
1651058902486,CSE 30,A01,083084,Eldon; John,0,38,80,80
1651058908512,CSE 100,A01,083659,Cao; Yingjun,0,72,50,50
1651058914541,CSE 134B,A01,083661,Powell; Thomas Allan,0,38,65,65
1651058920572,CSE 140,A01,083663,Staff,0,15,75,75
1651058926599,CSE 140L,A01,083088,Eldon; John,3,0,100,97
1651058932632,CSE 175,A01,083665,Kumar; Rakesh,0,0,25,25
1651058938658,CSE 190,A00,092507,Dubnov; Shlomo,9,0,20,11
1651058944687,ECE 45,A01,083139,Staff,0,7,60,60
1651058950719,ECE 65,A50,083695,Staff,0,7,30,30
1651058956753,ECE 109,A01,091882,Touri; Behrouz,33,0,70,37
1651058962779,ECE 180,A00,083140,Abi Samra; Nicholas Camill,17,0,30,13
1651058962779,ECE 180,B00,083141,Abi Samra; Nicholas Camill,0,0,30,30
1651058968812,MATH 10A,A01,083735,Patchell; Gregory David,0,0,30,30
1651058968812,MATH 10A,A02,083736,Patchell; Gregory David,27,0,30,3
1651058968812,MATH 10A,A03,083737,Patchell; Gregory David,23,0,30,7
1651058974845,MATH 10B,A01,083207,Staff,0,7,30,30
1651058974845,MATH 10B,A02,083208,Staff,0,6,30,30
1651058974845,MATH 10B,B01,083739,Staff,8,0,30,22
1651058974845,MATH 10B,B02,083740,Staff,28,0,30,2
1651058980872,MATH 18,A01,083743,Staff,0,0,30,30
1651058980872,MATH 18,A02,083744,Staff,23,0,30,7
1651058980872,MATH 18,A03,083745,Staff,19,0,30,11
1651058980872,MATH 18,A04,083746,Staff,26,0,30,4
1651058980872,MATH 18,B01,083748,Staff,0,16,30,30
1651058980872,MATH 18,B02,083749,Staff,0,14,30,30
1651058980872,MATH 18,B03,083750,Staff,0,14,30,30
1651058980872,MATH 18,B04,083751,Staff,0,13,30,30
1651058986895,MATH 20A,A01,083754,Staff,18,0,40,22
1651058992925,MATH 20B,A01,083756,Staff,0,14,30,30
1651058992925,MATH 20B,A02,083757,Staff,0,11,30,30
1651058998957,MATH 20C,A01,083760,Staff,0,16,30,30
1651058998957,MATH 20C,A02,083761,Staff,0,15,30,30
1651058998957,MATH 20C,B01,083762,Staff,8,0,30,22
1651058998957,MATH 20C,B02,083763,Staff,28,0,30,2
1651059004982,MATH 20D,A01,083765,Staff,3,1,30,27
1651059004982,MATH 20D,A02,083766,Staff,1,0,30,29
1651059004982,MATH 20D,A03,083767,Staff,22,0,30,8
1651059011011,MATH 20E,A01,083771,Staff,2,0,30,28
1651059011011,MATH 20E,A02,083772,Staff,10,0,30,20
1651059011011,MATH 20E,B01,083773,Staff,0,0,30,30
1651059011011,MATH 20E,B02,083774,Staff,0,0,30,30
1651059017043,MATH 103A,A01,083777,Staff,0,17,30,30
1651059017043,MATH 103A,A02,083778,Staff,0,16,30,30
1651059017043,MATH 103A,B01,083779,Staff,0,15,30,30
1651059017043,MATH 103A,B02,083780,Staff,0,13,30,30
1651059023068,MATH 105,A01,085443,Staff,0,23,30,30
1651059029100,MATH 109,A01,083213,Anzaldo; Leesa B,0,7,30,30
1651059029100,MATH 109,A02,083214,Anzaldo; Leesa B,0,7,30,30
1651059029100,MATH 109,B01,083215,Anzaldo; Leesa B,0,8,30,30
1651059029100,MATH 109,B02,083216,Anzaldo; Leesa B,0,8,30,30
1651059035141,MATH 142A,A01,083219,Chow; Bennett,0,15,30,30
1651059035141,MATH 142A,A02,083220,Chow; Bennett,0,15,30,30
1651059035141,MATH 142A,B01,083221,Chow; Bennett,0,16,30,30
1651059035141,MATH 142A,B02,083222,Chow; Bennett,0,14,30,30
1651059041173,MATH 193A,A01,083224,Staff,0,8,30,30
1651059041173,MATH 193A,A02,083225,Staff,0,7,30,30
1651059041173,MATH 193A,A03,083781,Staff,0,7,30,30
1651059041173,MATH 193A,A04,083782,Staff,0,7,30,30
1651059047204,MATH 197,001,091859,McAuley; Julian John,9998,0,9999,1
1651059053274,COGS 9,A01,083615,Staff,0,20,60,60
1651059059298,COGS 11,A01,083617,Boyle; Mary E. T.,13,0,40,27
1651059065327,COGS 13,A01,083071,Staff,0,40,40,40
1651059071349,COGS 14A,A01,092681,Staff,0,40,100,100
1651059077375,COGS 14B,A01,083073,Cheng; Tzu-Han,0,13,50,50
1651059083403,COGS 17,A01,092677,Staff,9,0,75,66
1651059089434,COGS 100,A01,083619,Staff,0,30,60,60
1651059095460,COGS 101A,A01,083621,Davis; Joshua Daniel,0,29,60,60
1651059101486,COGS 101B,A01,091572,Staff,0,7,60,60
1651059107508,COGS 101C,A01,083625,Delgado; Tania,14,0,30,16
1651059113535,COGS 107A,A01,083627,Boyle; Mary E. T.,0,17,60,60
1651059119570,COGS 118A,A01,083075,Staff,0,10,60,60
1651059125601,CSE 3,A50,083646,Miranda; Gregory Joseph,15,0,38,23
1651059125601,CSE 3,A51,083647,Miranda; Gregory Joseph,36,0,37,1
1651059131625,CSE 8A,A50,083650,Miranda; Gregory Joseph,0,31,40,40
1651059137649,CSE 11,A01,083080,Cao; Yingjun,1,97,40,39
1651059143677,CSE 12,A01,083652,Staff,0,26,100,100
1651059149703,CSE 15L,A01,083654,Staff,0,3,50,50
1651059149703,CSE 15L,A02,083655,Staff,0,3,50,50
1651059155728,CSE 20,A01,083657,Staff,46,0,80,34
1651059161754,CSE 30,A01,083084,Eldon; John,0,38,80,80
1651059167785,CSE 100,A01,083659,Cao; Yingjun,0,72,50,50
1651059173811,CSE 134B,A01,083661,Powell; Thomas Allan,0,38,65,65
1651059179837,CSE 140,A01,083663,Staff,0,15,75,75
1651059185870,CSE 140L,A01,083088,Eldon; John,3,0,100,97
1651059191899,CSE 175,A01,083665,Kumar; Rakesh,0,0,25,25
1651059197923,CSE 190,A00,092507,Dubnov; Shlomo,9,0,20,11
1651059203949,ECE 45,A01,083139,Staff,0,7,60,60
1651059209975,ECE 65,A50,083695,Staff,0,7,30,30
1651059216001,ECE 109,A01,091882,Touri; Behrouz,33,0,70,37
1651059222031,ECE 180,A00,083140,Abi Samra; Nicholas Camill,17,0,30,13
1651059222031,ECE 180,B00,083141,Abi Samra; Nicholas Camill,0,0,30,30
1651059228058,MATH 10A,A01,083735,Patchell; Gregory David,0,0,30,30
1651059228058,MATH 10A,A02,083736,Patchell; Gregory David,27,0,30,3
1651059228058,MATH 10A,A03,083737,Patchell; Gregory David,23,0,30,7
1651059234087,MATH 10B,A01,083207,Staff,0,7,30,30
1651059234087,MATH 10B,A02,083208,Staff,0,6,30,30
1651059234087,MATH 10B,B01,083739,Staff,8,0,30,22
1651059234087,MATH 10B,B02,083740,Staff,28,0,30,2
1651059240117,MATH 18,A01,083743,Staff,0,0,30,30
1651059240117,MATH 18,A02,083744,Staff,23,0,30,7
1651059240117,MATH 18,A03,083745,Staff,19,0,30,11
1651059240117,MATH 18,A04,083746,Staff,26,0,30,4
1651059240117,MATH 18,B01,083748,Staff,0,16,30,30
1651059240117,MATH 18,B02,083749,Staff,0,14,30,30
1651059240117,MATH 18,B03,083750,Staff,0,14,30,30
1651059240117,MATH 18,B04,083751,Staff,0,13,30,30
1651059246139,MATH 20A,A01,083754,Staff,18,0,40,22
1651059252171,MATH 20B,A01,083756,Staff,0,14,30,30
1651059252171,MATH 20B,A02,083757,Staff,0,11,30,30
1651059258201,MATH 20C,A01,083760,Staff,0,16,30,30
1651059258201,MATH 20C,A02,083761,Staff,0,15,30,30
1651059258201,MATH 20C,B01,083762,Staff,8,0,30,22
1651059258201,MATH 20C,B02,083763,Staff,28,0,30,2
1651059264224,MATH 20D,A01,083765,Staff,3,1,30,27
1651059264224,MATH 20D,A02,083766,Staff,1,0,30,29
1651059264224,MATH 20D,A03,083767,Staff,22,0,30,8
1651059270259,MATH 20E,A01,083771,Staff,2,0,30,28
1651059270259,MATH 20E,A02,083772,Staff,10,0,30,20
1651059270259,MATH 20E,B01,083773,Staff,0,0,30,30
1651059270259,MATH 20E,B02,083774,Staff,0,0,30,30
1651059276291,MATH 103A,A01,083777,Staff,0,17,30,30
1651059276291,MATH 103A,A02,083778,Staff,0,16,30,30
1651059276291,MATH 103A,B01,083779,Staff,0,15,30,30
1651059276291,MATH 103A,B02,083780,Staff,0,13,30,30
1651059282322,MATH 105,A01,085443,Staff,0,23,30,30
1651059288347,MATH 109,A01,083213,Anzaldo; Leesa B,0,7,30,30
1651059288347,MATH 109,A02,083214,Anzaldo; Leesa B,0,7,30,30
1651059288347,MATH 109,B01,083215,Anzaldo; Leesa B,0,8,30,30
1651059288347,MATH 109,B02,083216,Anzaldo; Leesa B,0,8,30,30
1651059294379,MATH 142A,A01,083219,Chow; Bennett,0,15,30,30
1651059294379,MATH 142A,A02,083220,Chow; Bennett,0,15,30,30
1651059294379,MATH 142A,B01,083221,Chow; Bennett,0,16,30,30
1651059294379,MATH 142A,B02,083222,Chow; Bennett,0,14,30,30
1651059300405,MATH 193A,A01,083224,Staff,0,8,30,30
1651059300405,MATH 193A,A02,083225,Staff,0,7,30,30
1651059300405,MATH 193A,A03,083781,Staff,0,7,30,30
1651059300405,MATH 193A,A04,083782,Staff,0,7,30,30
1651059306434,MATH 197,001,091859,McAuley; Julian John,9998,0,9999,1
1651059312491,COGS 9,A01,083615,Staff,0,20,60,60
1651059318517,COGS 11,A01,083617,Boyle; Mary E. T.,13,0,40,27
1651059324546,COGS 13,A01,083071,Staff,0,40,40,40
1651059330574,COGS 14A,A01,092681,Staff,0,40,100,100
1651059336600,COGS 14B,A01,083073,Cheng; Tzu-Han,0,13,50,50
1651059342629,COGS 17,A01,092677,Staff,9,0,75,66
1651059348667,COGS 100,A01,083619,Staff,0,30,60,60
1651059354699,COGS 101A,A01,083621,Davis; Joshua Daniel,0,29,60,60
1651059360723,COGS 101B,A01,091572,Staff,0,7,60,60
1651059366840,COGS 101C,A01,083625,Delgado; Tania,14,0,30,16
1651059372876,COGS 107A,A01,083627,Boyle; Mary E. T.,0,17,60,60
1651059384746,COGS 118A,A01,083075,Staff,0,10,60,60
1651059390779,CSE 3,A50,083646,Miranda; Gregory Joseph,15,0,38,23
1651059390779,CSE 3,A51,083647,Miranda; Gregory Joseph,36,0,37,1
1651059405335,CSE 8A,A50,083650,Miranda; Gregory Joseph,0,31,40,40
1651059411364,CSE 11,A01,083080,Cao; Yingjun,1,97,40,39
1651059426240,CSE 12,A01,083652,Staff,0,26,100,100
1651059432266,CSE 15L,A01,083654,Staff,0,3,50,50
1651059432266,CSE 15L,A02,083655,Staff,0,3,50,50
1651059446937,CSE 20,A01,083657,Staff,46,0,80,34
1651059452963,CSE 30,A01,083084,Eldon; John,0,38,80,80
1651059467488,CSE 100,A01,083659,Cao; Yingjun,0,72,50,50
1651059473517,CSE 134B,A01,083661,Powell; Thomas Allan,0,38,65,65
1651059488298,CSE 140,A01,083663,Staff,0,15,75,75
1651059494325,CSE 140L,A01,083088,Eldon; John,3,0,100,97
1651059508992,CSE 175,A01,083665,Kumar; Rakesh,0,0,25,25
1651059515015,CSE 190,A00,092507,Dubnov; Shlomo,9,0,20,11
1651059521804,ECE 45,A01,083139,Staff,0,7,60,60
1651059527836,ECE 65,A50,083695,Staff,0,7,30,30
1651059533866,ECE 109,A01,091882,Touri; Behrouz,33,0,70,37
1651059539944,ECE 180,A00,083140,Abi Samra; Nicholas Camill,17,0,30,13
1651059539944,ECE 180,B00,083141,Abi Samra; Nicholas Camill,0,0,30,30
1651059545982,MATH 10A,A01,083735,Patchell; Gregory David,0,0,30,30
1651059545982,MATH 10A,A02,083736,Patchell; Gregory David,27,0,30,3
1651059545982,MATH 10A,A03,083737,Patchell; Gregory David,23,0,30,7
1651059552011,MATH 10B,A01,083207,Staff,0,7,30,30
1651059552011,MATH 10B,A02,083208,Staff,0,6,30,30
1651059552011,MATH 10B,B01,083739,Staff,8,0,30,22
1651059552011,MATH 10B,B02,083740,Staff,28,0,30,2
1651059558041,MATH 18,A01,083743,Staff,0,0,30,30
1651059558041,MATH 18,A02,083744,Staff,23,0,30,7
1651059558041,MATH 18,A03,083745,Staff,19,0,30,11
1651059558041,MATH 18,A04,083746,Staff,26,0,30,4
1651059558041,MATH 18,B01,083748,Staff,0,16,30,30
1651059558041,MATH 18,B02,083749,Staff,0,14,30,30
1651059558041,MATH 18,B03,083750,Staff,0,14,30,30
1651059558041,MATH 18,B04,083751,Staff,0,13,30,30
1651059564068,MATH 20A,A01,083754,Staff,18,0,40,22
1651059570100,MATH 20B,A01,083756,Staff,0,14,30,30
1651059570100,MATH 20B,A02,083757,Staff,0,11,30,30
1651059576130,MATH 20C,A01,083760,Staff,0,16,30,30
1651059576130,MATH 20C,A02,083761,Staff,0,15,30,30
1651059576130,MATH 20C,B01,083762,Staff,8,0,30,22
1651059576130,MATH 20C,B02,083763,Staff,28,0,30,2
1651059582161,MATH 20D,A01,083765,Staff,3,1,30,27
1651059582161,MATH 20D,A02,083766,Staff,1,0,30,29
1651059582161,MATH 20D,A03,083767,Staff,22,0,30,8
1651059588197,MATH 20E,A01,083771,Staff,2,0,30,28
1651059588197,MATH 20E,A02,083772,Staff,10,0,30,20
1651059588197,MATH 20E,B01,083773,Staff,0,0,30,30
1651059588197,MATH 20E,B02,083774,Staff,0,0,30,30
1651059594226,MATH 103A,A01,083777,Staff,0,17,30,30
1651059594226,MATH 103A,A02,083778,Staff,0,16,30,30
1651059594226,MATH 103A,B01,083779,Staff,0,15,30,30
1651059594226,MATH 103A,B02,083780,Staff,0,13,30,30
1651059600258,MATH 105,A01,085443,Staff,0,23,30,30
1651059606292,MATH 109,A01,083213,Anzaldo; Leesa B,0,7,30,30
1651059606292,MATH 109,A02,083214,Anzaldo; Leesa B,0,7,30,30
1651059606292,MATH 109,B01,083215,Anzaldo; Leesa B,0,8,30,30
1651059606292,MATH 109,B02,083216,Anzaldo; Leesa B,0,8,30,30
1651059612318,MATH 142A,A01,083219,Chow; Bennett,0,15,30,30
1651059612318,MATH 142A,A02,083220,Chow; Bennett,0,15,30,30
1651059612318,MATH 142A,B01,083221,Chow; Bennett,0,16,30,30
1651059612318,MATH 142A,B02,083222,Chow; Bennett,0,14,30,30
1651059618344,MATH 193A,A01,083224,Staff,0,8,30,30
1651059618344,MATH 193A,A02,083225,Staff,0,7,30,30
1651059618344,MATH 193A,A03,083781,Staff,0,7,30,30
1651059618344,MATH 193A,A04,083782,Staff,0,7,30,30
1651059624374,MATH 197,001,091859,McAuley; Julian John,9998,0,9999,1
1651059630436,COGS 9,A01,083615,Staff,0,20,60,60
1651059636461,COGS 11,A01,083617,Boyle; Mary E. T.,13,0,40,27
1651059642494,COGS 13,A01,083071,Staff,0,40,40,40
1651059648520,COGS 14A,A01,092681,Staff,0,40,100,100
1651059654547,COGS 14B,A01,083073,Cheng; Tzu-Han,0,13,50,50
1651059660579,COGS 17,A01,092677,Staff,9,0,75,66
1651059666606,COGS 100,A01,083619,Staff,0,30,60,60
1651059672635,COGS 101A,A01,083621,Davis; Joshua Daniel,0,29,60,60
1651059678658,COGS 101B,A01,091572,Staff,0,7,60,60
1651059684690,COGS 101C,A01,083625,Delgado; Tania,14,0,30,16
1651059690722,COGS 107A,A01,083627,Boyle; Mary E. T.,0,17,60,60
1651059696751,COGS 118A,A01,083075,Staff,0,10,60,60
1651059702779,CSE 3,A50,083646,Miranda; Gregory Joseph,15,0,38,23
1651059702779,CSE 3,A51,083647,Miranda; Gregory Joseph,36,0,37,1
1651059708804,CSE 8A,A50,083650,Miranda; Gregory Joseph,0,31,40,40
1651059714831,CSE 11,A01,083080,Cao; Yingjun,1,97,40,39
1651059720858,CSE 12,A01,083652,Staff,0,26,100,100
1651059726883,CSE 15L,A01,083654,Staff,0,3,50,50
1651059726883,CSE 15L,A02,083655,Staff,0,3,50,50
1651059732908,CSE 20,A01,083657,Staff,46,0,80,34
1651059738938,CSE 30,A01,083084,Eldon; John,0,38,80,80
1651059744966,CSE 100,A01,083659,Cao; Yingjun,0,72,50,50
1651059750995,CSE 134B,A01,083661,Powell; Thomas Allan,0,38,65,65
1651059757020,CSE 140,A01,083663,Staff,0,15,75,75
1651059763044,CSE 140L,A01,083088,Eldon; John,3,0,100,97
1651059769071,CSE 175,A01,083665,Kumar; Rakesh,0,0,25,25
1651059775100,CSE 190,A00,092507,Dubnov; Shlomo,9,0,20,11
1651059781126,ECE 45,A01,083139,Staff,0,7,60,60
1651059787156,ECE 65,A50,083695,Staff,0,7,30,30
1651059793183,ECE 109,A01,091882,Touri; Behrouz,33,0,70,37
1651059799211,ECE 180,A00,083140,Abi Samra; Nicholas Camill,17,0,30,13
1651059799211,ECE 180,B00,083141,Abi Samra; Nicholas Camill,0,0,30,30
1651059805239,MATH 10A,A01,083735,Patchell; Gregory David,0,0,30,30
1651059805239,MATH 10A,A02,083736,Patchell; Gregory David,27,0,30,3
1651059805239,MATH 10A,A03,083737,Patchell; Gregory David,23,0,30,7
1651059811270,MATH 10B,A01,083207,Staff,0,7,30,30
1651059811270,MATH 10B,A02,083208,Staff,0,6,30,30
1651059811270,MATH 10B,B01,083739,Staff,8,0,30,22
1651059811270,MATH 10B,B02,083740,Staff,28,0,30,2
1651059817307,MATH 18,A01,083743,Staff,0,0,30,30
1651059817307,MATH 18,A02,083744,Staff,23,0,30,7
1651059817307,MATH 18,A03,083745,Staff,19,0,30,11
1651059817307,MATH 18,A04,083746,Staff,26,0,30,4
1651059817307,MATH 18,B01,083748,Staff,0,16,30,30
1651059817307,MATH 18,B02,083749,Staff,0,14,30,30
1651059817307,MATH 18,B03,083750,Staff,0,14,30,30
1651059817307,MATH 18,B04,083751,Staff,0,13,30,30
1651059823338,MATH 20A,A01,083754,Staff,18,0,40,22
1651059829375,MATH 20B,A01,083756,Staff,0,14,30,30
1651059829375,MATH 20B,A02,083757,Staff,0,11,30,30
1651059835402,MATH 20C,A01,083760,Staff,0,16,30,30
1651059835402,MATH 20C,A02,083761,Staff,0,15,30,30
1651059835402,MATH 20C,B01,083762,Staff,8,0,30,22
1651059835402,MATH 20C,B02,083763,Staff,28,0,30,2
1651059841429,MATH 20D,A01,083765,Staff,3,1,30,27
1651059841429,MATH 20D,A02,083766,Staff,1,0,30,29
1651059841429,MATH 20D,A03,083767,Staff,22,0,30,8
1651059847457,MATH 20E,A01,083771,Staff,2,0,30,28
1651059847457,MATH 20E,A02,083772,Staff,10,0,30,20
1651059847457,MATH 20E,B01,083773,Staff,0,0,30,30
1651059847457,MATH 20E,B02,083774,Staff,0,0,30,30
1651059853481,MATH 103A,A01,083777,Staff,0,17,30,30
1651059853481,MATH 103A,A02,083778,Staff,0,16,30,30
1651059853481,MATH 103A,B01,083779,Staff,0,15,30,30
1651059853481,MATH 103A,B02,083780,Staff,0,13,30,30
1651059859507,MATH 105,A01,085443,Staff,0,23,30,30
1651059871332,MATH 109,A01,083213,Anzaldo; Leesa B,0,7,30,30
1651059871332,MATH 109,A02,083214,Anzaldo; Leesa B,0,7,30,30
1651059871332,MATH 109,B01,083215,Anzaldo; Leesa B,0,8,30,30
1651059871332,MATH 109,B02,083216,Anzaldo; Leesa B,0,8,30,30
1651059877360,MATH 142A,A01,083219,Chow; Bennett,0,15,30,30
1651059877360,MATH 142A,A02,083220,Chow; Bennett,0,15,30,30
1651059877360,MATH 142A,B01,083221,Chow; Bennett,0,16,30,30
1651059877360,MATH 142A,B02,083222,Chow; Bennett,0,14,30,30
1651059885557,MATH 193A,A01,083224,Staff,0,8,30,30
1651059885557,MATH 193A,A02,083225,Staff,0,7,30,30
1651059885557,MATH 193A,A03,083781,Staff,0,7,30,30
1651059885557,MATH 193A,A04,083782,Staff,0,7,30,30
1651059891588,MATH 197,001,091859,McAuley; Julian John,9998,0,9999,1
1651059897656,COGS 9,A01,083615,Staff,0,20,60,60
1651059903682,COGS 11,A01,083617,Boyle; Mary E. T.,13,0,40,27
1651059909708,COGS 13,A01,083071,Staff,0,40,40,40
1651059915736,COGS 14A,A01,092681,Staff,0,40,100,100
1651059921763,COGS 14B,A01,083073,Cheng; Tzu-Han,0,13,50,50
1651059927788,COGS 17,A01,092677,Staff,9,0,75,66
1651059933814,COGS 100,A01,083619,Staff,0,30,60,60
1651059939846,COGS 101A,A01,083621,Davis; Joshua Daniel,0,29,60,60
1651059945876,COGS 101B,A01,091572,Staff,0,7,60,60
1651059951902,COGS 101C,A01,083625,Delgado; Tania,14,0,30,16
1651059957927,COGS 107A,A01,083627,Boyle; Mary E. T.,0,17,60,60
1651059963957,COGS 118A,A01,083075,Staff,0,10,60,60
1651059969998,CSE 3,A50,083646,Miranda; Gregory Joseph,15,0,38,23
1651059969998,CSE 3,A51,083647,Miranda; Gregory Joseph,36,0,37,1
1651059976033,CSE 8A,A50,083650,Miranda; Gregory Joseph,0,31,40,40
1651059982067,CSE 11,A01,083080,Cao; Yingjun,1,97,40,39
1651059988093,CSE 12,A01,083652,Staff,0,26,100,100
1651059994120,CSE 15L,A01,083654,Staff,0,3,50,50
1651059994120,CSE 15L,A02,083655,Staff,0,3,50,50
1651060000146,CSE 20,A01,083657,Staff,46,0,80,34
1651060006177,CSE 30,A01,083084,Eldon; John,0,38,80,80
1651060012208,CSE 100,A01,083659,Cao; Yingjun,0,72,50,50
1651060018239,CSE 134B,A01,083661,Powell; Thomas Allan,0,38,65,65
1651060024269,CSE 140,A01,083663,Staff,0,15,75,75
1651060030385,CSE 140L,A01,083088,Eldon; John,3,0,100,97
1651060036417,CSE 175,A01,083665,Kumar; Rakesh,0,0,25,25
1651060042442,CSE 190,A00,092507,Dubnov; Shlomo,9,0,20,11
1651060048472,ECE 45,A01,083139,Staff,0,7,60,60
1651060054508,ECE 65,A50,083695,Staff,0,7,30,30
1651060060533,ECE 109,A01,091882,Touri; Behrouz,33,0,70,37
1651060066564,ECE 180,A00,083140,Abi Samra; Nicholas Camill,17,0,30,13
1651060066564,ECE 180,B00,083141,Abi Samra; Nicholas Camill,0,0,30,30
1651060072592,MATH 10A,A01,083735,Patchell; Gregory David,0,0,30,30
1651060072592,MATH 10A,A02,083736,Patchell; Gregory David,27,0,30,3
1651060072592,MATH 10A,A03,083737,Patchell; Gregory David,23,0,30,7
1651060078620,MATH 10B,A01,083207,Staff,0,7,30,30
1651060078620,MATH 10B,A02,083208,Staff,0,6,30,30
1651060078620,MATH 10B,B01,083739,Staff,8,0,30,22
1651060078620,MATH 10B,B02,083740,Staff,28,0,30,2
1651060084654,MATH 18,A01,083743,Staff,0,0,30,30
1651060084654,MATH 18,A02,083744,Staff,23,0,30,7
1651060084654,MATH 18,A03,083745,Staff,19,0,30,11
1651060084654,MATH 18,A04,083746,Staff,26,0,30,4
1651060084654,MATH 18,B01,083748,Staff,0,16,30,30
1651060084654,MATH 18,B02,083749,Staff,0,14,30,30
1651060084654,MATH 18,B03,083750,Staff,0,14,30,30
1651060084654,MATH 18,B04,083751,Staff,0,13,30,30
1651060090679,MATH 20A,A01,083754,Staff,18,0,40,22
1651060096709,MATH 20B,A01,083756,Staff,0,14,30,30
1651060096709,MATH 20B,A02,083757,Staff,0,11,30,30
1651060102736,MATH 20C,A01,083760,Staff,0,16,30,30
1651060102736,MATH 20C,A02,083761,Staff,0,15,30,30
1651060102736,MATH 20C,B01,083762,Staff,8,0,30,22
1651060102736,MATH 20C,B02,083763,Staff,28,0,30,2
1651060108760,MATH 20D,A01,083765,Staff,3,1,30,27
1651060108760,MATH 20D,A02,083766,Staff,1,0,30,29
1651060108760,MATH 20D,A03,083767,Staff,22,0,30,8
1651060114784,MATH 20E,A01,083771,Staff,2,0,30,28
1651060114784,MATH 20E,A02,083772,Staff,10,0,30,20
1651060114784,MATH 20E,B01,083773,Staff,0,0,30,30
1651060114784,MATH 20E,B02,083774,Staff,0,0,30,30
1651060120817,MATH 103A,A01,083777,Staff,0,17,30,30
1651060120817,MATH 103A,A02,083778,Staff,0,16,30,30
1651060120817,MATH 103A,B01,083779,Staff,0,15,30,30
1651060120817,MATH 103A,B02,083780,Staff,0,13,30,30
1651060126845,MATH 105,A01,085443,Staff,0,23,30,30
1651060132877,MATH 109,A01,083213,Anzaldo; Leesa B,0,7,30,30
1651060132877,MATH 109,A02,083214,Anzaldo; Leesa B,0,7,30,30
1651060132877,MATH 109,B01,083215,Anzaldo; Leesa B,0,8,30,30
1651060132877,MATH 109,B02,083216,Anzaldo; Leesa B,0,8,30,30
1651060138909,MATH 142A,A01,083219,Chow; Bennett,0,15,30,30
1651060138909,MATH 142A,A02,083220,Chow; Bennett,0,15,30,30
1651060138909,MATH 142A,B01,083221,Chow; Bennett,0,16,30,30
1651060138909,MATH 142A,B02,083222,Chow; Bennett,0,14,30,30
1651060144936,MATH 193A,A01,083224,Staff,0,8,30,30
1651060144936,MATH 193A,A02,083225,Staff,0,7,30,30
1651060144936,MATH 193A,A03,083781,Staff,0,7,30,30
1651060144936,MATH 193A,A04,083782,Staff,0,7,30,30
1651060150959,MATH 197,001,091859,McAuley; Julian John,9998,0,9999,1
1651060157037,COGS 9,A01,083615,Staff,0,20,60,60
1651060163063,COGS 11,A01,083617,Boyle; Mary E. T.,13,0,40,27
1651060169093,COGS 13,A01,083071,Staff,0,40,40,40
1651060175123,COGS 14A,A01,092681,Staff,0,40,100,100
1651060181152,COGS 14B,A01,083073,Cheng; Tzu-Han,0,13,50,50
1651060187182,COGS 17,A01,092677,Staff,9,0,75,66
1651060193209,COGS 100,A01,083619,Staff,0,30,60,60
1651060199234,COGS 101A,A01,083621,Davis; Joshua Daniel,0,29,60,60
1651060205258,COGS 101B,A01,091572,Staff,0,7,60,60
1651060211288,COGS 101C,A01,083625,Delgado; Tania,14,0,30,16
1651060217313,COGS 107A,A01,083627,Boyle; Mary E. T.,0,17,60,60
1651060223342,COGS 118A,A01,083075,Staff,0,10,60,60
1651060229375,CSE 3,A50,083646,Miranda; Gregory Joseph,15,0,38,23
1651060229375,CSE 3,A51,083647,Miranda; Gregory Joseph,36,0,37,1
1651060235403,CSE 8A,A50,083650,Miranda; Gregory Joseph,0,31,40,40
1651060241433,CSE 11,A01,083080,Cao; Yingjun,1,97,40,39
1651060247464,CSE 12,A01,083652,Staff,0,26,100,100
1651060253491,CSE 15L,A01,083654,Staff,0,3,50,50
1651060253491,CSE 15L,A02,083655,Staff,0,3,50,50
1651060259519,CSE 20,A01,083657,Staff,46,0,80,34
1651060265546,CSE 30,A01,083084,Eldon; John,0,38,80,80
1651060271574,CSE 100,A01,083659,Cao; Yingjun,0,72,50,50
1651060277620,CSE 134B,A01,083661,Powell; Thomas Allan,0,38,65,65
1651060283647,CSE 140,A01,083663,Staff,0,15,75,75
1651060289671,CSE 140L,A01,083088,Eldon; John,3,0,100,97
1651060295698,CSE 175,A01,083665,Kumar; Rakesh,0,0,25,25
1651060301723,CSE 190,A00,092507,Dubnov; Shlomo,9,0,20,11
1651060307746,ECE 45,A01,083139,Staff,0,7,60,60
1651060313774,ECE 65,A50,083695,Staff,0,7,30,30
1651060319801,ECE 109,A01,091882,Touri; Behrouz,33,0,70,37
1651060325836,ECE 180,A00,083140,Abi Samra; Nicholas Camill,17,0,30,13
1651060325836,ECE 180,B00,083141,Abi Samra; Nicholas Camill,0,0,30,30
1651060331861,MATH 10A,A01,083735,Patchell; Gregory David,0,0,30,30
1651060331861,MATH 10A,A02,083736,Patchell; Gregory David,27,0,30,3
1651060331861,MATH 10A,A03,083737,Patchell; Gregory David,23,0,30,7
1651060337891,MATH 10B,A01,083207,Staff,0,7,30,30
1651060337891,MATH 10B,A02,083208,Staff,0,6,30,30
1651060337891,MATH 10B,B01,083739,Staff,8,0,30,22
1651060337891,MATH 10B,B02,083740,Staff,28,0,30,2
1651060343921,MATH 18,A01,083743,Staff,0,0,30,30
1651060343921,MATH 18,A02,083744,Staff,23,0,30,7
1651060343921,MATH 18,A03,083745,Staff,19,0,30,11
1651060343921,MATH 18,A04,083746,Staff,26,0,30,4
1651060343921,MATH 18,B01,083748,Staff,0,16,30,30
1651060343921,MATH 18,B02,083749,Staff,0,14,30,30
1651060343921,MATH 18,B03,083750,Staff,0,14,30,30
1651060343921,MATH 18,B04,083751,Staff,0,13,30,30
1651060349949,MATH 20A,A01,083754,Staff,18,0,40,22
1651060355981,MATH 20B,A01,083756,Staff,0,14,30,30
1651060355981,MATH 20B,A02,083757,Staff,0,11,30,30
1651060362007,MATH 20C,A01,083760,Staff,0,16,30,30
1651060362007,MATH 20C,A02,083761,Staff,0,15,30,30
1651060362007,MATH 20C,B01,083762,Staff,8,0,30,22
1651060362007,MATH 20C,B02,083763,Staff,28,0,30,2
1651060368033,MATH 20D,A01,083765,Staff,3,1,30,27
1651060368033,MATH 20D,A02,083766,Staff,1,0,30,29
1651060368033,MATH 20D,A03,083767,Staff,22,0,30,8
1651060374066,MATH 20E,A01,083771,Staff,2,0,30,28
1651060374066,MATH 20E,A02,083772,Staff,10,0,30,20
1651060374066,MATH 20E,B01,083773,Staff,0,0,30,30
1651060374066,MATH 20E,B02,083774,Staff,0,0,30,30
1651060380099,MATH 103A,A01,083777,Staff,0,17,30,30
1651060380099,MATH 103A,A02,083778,Staff,0,16,30,30
1651060380099,MATH 103A,B01,083779,Staff,0,15,30,30
1651060380099,MATH 103A,B02,083780,Staff,0,13,30,30
1651060386125,MATH 105,A01,085443,Staff,0,23,30,30
1651060392155,MATH 109,A01,083213,Anzaldo; Leesa B,0,7,30,30
1651060392155,MATH 109,A02,083214,Anzaldo; Leesa B,0,7,30,30
1651060392155,MATH 109,B01,083215,Anzaldo; Leesa B,0,8,30,30
1651060392155,MATH 109,B02,083216,Anzaldo; Leesa B,0,8,30,30
1651060398180,MATH 142A,A01,083219,Chow; Bennett,0,15,30,30
1651060398180,MATH 142A,A02,083220,Chow; Bennett,0,15,30,30
1651060398180,MATH 142A,B01,083221,Chow; Bennett,0,16,30,30
1651060398180,MATH 142A,B02,083222,Chow; Bennett,0,14,30,30
1651060404204,MATH 193A,A01,083224,Staff,0,8,30,30
1651060404204,MATH 193A,A02,083225,Staff,0,7,30,30
1651060404204,MATH 193A,A03,083781,Staff,0,7,30,30
1651060404204,MATH 193A,A04,083782,Staff,0,7,30,30
1651060410230,MATH 197,001,091859,McAuley; Julian John,9998,0,9999,1
1651060416292,COGS 9,A01,083615,Staff,0,20,60,60
1651060422318,COGS 11,A01,083617,Boyle; Mary E. T.,13,0,40,27
1651060428345,COGS 13,A01,083071,Staff,0,40,40,40
1651060434375,COGS 14A,A01,092681,Staff,0,40,100,100
1651060440402,COGS 14B,A01,083073,Cheng; Tzu-Han,0,13,50,50
1651060446427,COGS 17,A01,092677,Staff,9,0,75,66
1651060452455,COGS 100,A01,083619,Staff,0,30,60,60
1651060458485,COGS 101A,A01,083621,Davis; Joshua Daniel,0,29,60,60
1651060464511,COGS 101B,A01,091572,Staff,0,7,60,60
1651060470535,COGS 101C,A01,083625,Delgado; Tania,14,0,30,16
1651060476564,COGS 107A,A01,083627,Boyle; Mary E. T.,0,17,60,60
1651060482591,COGS 118A,A01,083075,Staff,0,10,60,60
1651060488616,CSE 3,A50,083646,Miranda; Gregory Joseph,15,0,38,23
1651060488616,CSE 3,A51,083647,Miranda; Gregory Joseph,36,0,37,1
1651060494642,CSE 8A,A50,083650,Miranda; Gregory Joseph,0,31,40,40
1651060500667,CSE 11,A01,083080,Cao; Yingjun,1,97,40,39
1651060506691,CSE 12,A01,083652,Staff,0,26,100,100
1651060512716,CSE 15L,A01,083654,Staff,0,3,50,50
1651060512716,CSE 15L,A02,083655,Staff,0,3,50,50
1651060518745,CSE 20,A01,083657,Staff,45,0,80,35
1651060524770,CSE 30,A01,083084,Eldon; John,0,38,80,80
1651060530802,CSE 100,A01,083659,Cao; Yingjun,0,72,50,50
1651060536827,CSE 134B,A01,083661,Powell; Thomas Allan,0,38,65,65
1651060542854,CSE 140,A01,083663,Staff,0,15,75,75
1651060548879,CSE 140L,A01,083088,Eldon; John,3,0,100,97
1651060554905,CSE 175,A01,083665,Kumar; Rakesh,0,0,25,25
1651060560931,CSE 190,A00,092507,Dubnov; Shlomo,9,0,20,11
1651060566955,ECE 45,A01,083139,Staff,0,7,60,60
1651060572984,ECE 65,A50,083695,Staff,0,7,30,30
1651060579011,ECE 109,A01,091882,Touri; Behrouz,33,0,70,37
1651060585039,ECE 180,A00,083140,Abi Samra; Nicholas Camill,17,0,30,13
1651060585039,ECE 180,B00,083141,Abi Samra; Nicholas Camill,0,0,30,30
1651060591070,MATH 10A,A01,083735,Patchell; Gregory David,0,0,30,30
1651060591070,MATH 10A,A02,083736,Patchell; Gregory David,27,0,30,3
1651060591070,MATH 10A,A03,083737,Patchell; Gregory David,23,0,30,7
1651060597099,MATH 10B,A01,083207,Staff,0,7,30,30
1651060597099,MATH 10B,A02,083208,Staff,0,6,30,30
1651060597099,MATH 10B,B01,083739,Staff,8,0,30,22
1651060597099,MATH 10B,B02,083740,Staff,28,0,30,2
1651060603134,MATH 18,A01,083743,Staff,0,0,30,30
1651060603134,MATH 18,A02,083744,Staff,23,0,30,7
1651060603134,MATH 18,A03,083745,Staff,19,0,30,11
1651060603134,MATH 18,A04,083746,Staff,26,0,30,4
1651060603134,MATH 18,B01,083748,Staff,0,16,30,30
1651060603134,MATH 18,B02,083749,Staff,0,14,30,30
1651060603134,MATH 18,B03,083750,Staff,0,14,30,30
1651060603134,MATH 18,B04,083751,Staff,0,13,30,30
1651060609161,MATH 20A,A01,083754,Staff,18,0,40,22
1651060615189,MATH 20B,A01,083756,Staff,0,14,30,30
1651060615189,MATH 20B,A02,083757,Staff,0,11,30,30
1651060621225,MATH 20C,A01,083760,Staff,0,16,30,30
1651060621225,MATH 20C,A02,083761,Staff,0,15,30,30
1651060621225,MATH 20C,B01,083762,Staff,8,0,30,22
1651060621225,MATH 20C,B02,083763,Staff,28,0,30,2
1651060627344,MATH 20D,A01,083765,Staff,3,1,30,27
1651060627344,MATH 20D,A02,083766,Staff,1,0,30,29
1651060627344,MATH 20D,A03,083767,Staff,22,0,30,8
1651060633371,MATH 20E,A01,083771,Staff,2,0,30,28
1651060633371,MATH 20E,A02,083772,Staff,10,0,30,20
1651060633371,MATH 20E,B01,083773,Staff,0,0,30,30
1651060633371,MATH 20E,B02,083774,Staff,0,0,30,30
1651060639402,MATH 103A,A01,083777,Staff,0,17,30,30
1651060639402,MATH 103A,A02,083778,Staff,0,16,30,30
1651060639402,MATH 103A,B01,083779,Staff,0,15,30,30
1651060639402,MATH 103A,B02,083780,Staff,0,13,30,30
1651060645427,MATH 105,A01,085443,Staff,0,23,30,30
1651060651453,MATH 109,A01,083213,Anzaldo; Leesa B,0,7,30,30
1651060651453,MATH 109,A02,083214,Anzaldo; Leesa B,0,7,30,30
1651060651453,MATH 109,B01,083215,Anzaldo; Leesa B,0,8,30,30
1651060651453,MATH 109,B02,083216,Anzaldo; Leesa B,0,8,30,30
1651060657478,MATH 142A,A01,083219,Chow; Bennett,0,15,30,30
1651060657478,MATH 142A,A02,083220,Chow; Bennett,0,15,30,30
1651060657478,MATH 142A,B01,083221,Chow; Bennett,0,16,30,30
1651060657478,MATH 142A,B02,083222,Chow; Bennett,0,14,30,30
1651060663501,MATH 193A,A01,083224,Staff,0,8,30,30
1651060663501,MATH 193A,A02,083225,Staff,0,7,30,30
1651060663501,MATH 193A,A03,083781,Staff,0,7,30,30
1651060663501,MATH 193A,A04,083782,Staff,0,7,30,30
1651060669525,MATH 197,001,091859,McAuley; Julian John,9998,0,9999,1
1651060675590,COGS 9,A01,083615,Staff,0,20,60,60
1651060681615,COGS 11,A01,083617,Boyle; Mary E. T.,13,0,40,27
1651060687641,COGS 13,A01,083071,Staff,0,40,40,40
1651060693666,COGS 14A,A01,092681,Staff,0,40,100,100
1651060699696,COGS 14B,A01,083073,Cheng; Tzu-Han,0,13,50,50
1651060705722,COGS 17,A01,092677,Staff,9,0,75,66
1651060711746,COGS 100,A01,083619,Staff,0,30,60,60
1651060717773,COGS 101A,A01,083621,Davis; Joshua Daniel,0,29,60,60
1651060723802,COGS 101B,A01,091572,Staff,0,7,60,60
1651060729826,COGS 101C,A01,083625,Delgado; Tania,14,0,30,16
1651060735853,COGS 107A,A01,083627,Boyle; Mary E. T.,0,17,60,60
1651060741881,COGS 118A,A01,083075,Staff,0,10,60,60
1651060747916,CSE 3,A50,083646,Miranda; Gregory Joseph,15,0,38,23
1651060747916,CSE 3,A51,083647,Miranda; Gregory Joseph,36,0,37,1
1651060753940,CSE 8A,A50,083650,Miranda; Gregory Joseph,0,31,40,40
1651060759966,CSE 11,A01,083080,Cao; Yingjun,1,97,40,39
1651060765994,CSE 12,A01,083652,Staff,0,26,100,100
1651060772021,CSE 15L,A01,083654,Staff,0,3,50,50
1651060772021,CSE 15L,A02,083655,Staff,0,3,50,50
1651060778051,CSE 20,A01,083657,Staff,45,0,80,35
1651060784081,CSE 30,A01,083084,Eldon; John,0,38,80,80
1651060790110,CSE 100,A01,083659,Cao; Yingjun,0,72,50,50
1651060796138,CSE 134B,A01,083661,Powell; Thomas Allan,0,38,65,65
1651060802164,CSE 140,A01,083663,Staff,0,15,75,75
1651060808193,CSE 140L,A01,083088,Eldon; John,3,0,100,97
1651060814225,CSE 175,A01,083665,Kumar; Rakesh,0,0,25,25
1651060820256,CSE 190,A00,092507,Dubnov; Shlomo,9,0,20,11
1651060826283,ECE 45,A01,083139,Staff,0,7,60,60
1651060832306,ECE 65,A50,083695,Staff,0,7,30,30
1651060838333,ECE 109,A01,091882,Touri; Behrouz,33,0,70,37
1651060844369,ECE 180,A00,083140,Abi Samra; Nicholas Camill,17,0,30,13
1651060844369,ECE 180,B00,083141,Abi Samra; Nicholas Camill,0,0,30,30
1651060850396,MATH 10A,A01,083735,Patchell; Gregory David,0,0,30,30
1651060850396,MATH 10A,A02,083736,Patchell; Gregory David,27,0,30,3
1651060850396,MATH 10A,A03,083737,Patchell; Gregory David,23,0,30,7
1651060856429,MATH 10B,A01,083207,Staff,0,7,30,30
1651060856429,MATH 10B,A02,083208,Staff,0,6,30,30
1651060856429,MATH 10B,B01,083739,Staff,8,0,30,22
1651060856429,MATH 10B,B02,083740,Staff,28,0,30,2
1651060862454,MATH 18,A01,083743,Staff,0,0,30,30
1651060862454,MATH 18,A02,083744,Staff,23,0,30,7
1651060862454,MATH 18,A03,083745,Staff,19,0,30,11
1651060862454,MATH 18,A04,083746,Staff,26,0,30,4
1651060862454,MATH 18,B01,083748,Staff,0,16,30,30
1651060862454,MATH 18,B02,083749,Staff,0,14,30,30
1651060862454,MATH 18,B03,083750,Staff,0,14,30,30
1651060862454,MATH 18,B04,083751,Staff,0,13,30,30
1651060868488,MATH 20A,A01,083754,Staff,18,0,40,22
1651060874534,MATH 20B,A01,083756,Staff,0,14,30,30
1651060874534,MATH 20B,A02,083757,Staff,0,11,30,30
1651060880688,MATH 20C,A01,083760,Staff,0,16,30,30
1651060880688,MATH 20C,A02,083761,Staff,0,15,30,30
1651060880688,MATH 20C,B01,083762,Staff,8,0,30,22
1651060880688,MATH 20C,B02,083763,Staff,28,0,30,2
1651060886713,MATH 20D,A01,083765,Staff,3,1,30,27
1651060886713,MATH 20D,A02,083766,Staff,1,0,30,29
1651060886713,MATH 20D,A03,083767,Staff,22,0,30,8
1651060892827,MATH 20E,A01,083771,Staff,2,0,30,28
1651060892827,MATH 20E,A02,083772,Staff,10,0,30,20
1651060892827,MATH 20E,B01,083773,Staff,0,0,30,30
1651060892827,MATH 20E,B02,083774,Staff,0,0,30,30
1651060898857,MATH 103A,A01,083777,Staff,0,17,30,30
1651060898857,MATH 103A,A02,083778,Staff,0,16,30,30
1651060898857,MATH 103A,B01,083779,Staff,0,15,30,30
1651060898857,MATH 103A,B02,083780,Staff,0,13,30,30
1651060904882,MATH 105,A01,085443,Staff,0,23,30,30
1651060910913,MATH 109,A01,083213,Anzaldo; Leesa B,0,7,30,30
1651060910913,MATH 109,A02,083214,Anzaldo; Leesa B,0,7,30,30
1651060910913,MATH 109,B01,083215,Anzaldo; Leesa B,0,8,30,30
1651060910913,MATH 109,B02,083216,Anzaldo; Leesa B,0,8,30,30
1651060916945,MATH 142A,A01,083219,Chow; Bennett,0,15,30,30
1651060916945,MATH 142A,A02,083220,Chow; Bennett,0,15,30,30
1651060916945,MATH 142A,B01,083221,Chow; Bennett,0,16,30,30
1651060916945,MATH 142A,B02,083222,Chow; Bennett,0,14,30,30
1651060922976,MATH 193A,A01,083224,Staff,0,8,30,30
1651060922976,MATH 193A,A02,083225,Staff,0,7,30,30
1651060922976,MATH 193A,A03,083781,Staff,0,7,30,30
1651060922976,MATH 193A,A04,083782,Staff,0,7,30,30
1651060929009,MATH 197,001,091859,McAuley; Julian John,9998,0,9999,1
1651060935079,COGS 9,A01,083615,Staff,0,20,60,60
1651060941105,COGS 11,A01,083617,Boyle; Mary E. T.,13,0,40,27
1651060947135,COGS 13,A01,083071,Staff,0,40,40,40
1651060953161,COGS 14A,A01,092681,Staff,0,40,100,100
1651060959188,COGS 14B,A01,083073,Cheng; Tzu-Han,0,13,50,50
1651060965214,COGS 17,A01,092677,Staff,9,0,75,66
1651060971242,COGS 100,A01,083619,Staff,0,30,60,60
1651060977271,COGS 101A,A01,083621,Davis; Joshua Daniel,0,29,60,60
1651060983294,COGS 101B,A01,091572,Staff,0,7,60,60
1651060989320,COGS 101C,A01,083625,Delgado; Tania,14,0,30,16
1651060995343,COGS 107A,A01,083627,Boyle; Mary E. T.,0,17,60,60
1651061001371,COGS 118A,A01,083075,Staff,0,10,60,60
1651061007395,CSE 3,A50,083646,Miranda; Gregory Joseph,15,0,38,23
1651061007395,CSE 3,A51,083647,Miranda; Gregory Joseph,36,0,37,1
1651061013423,CSE 8A,A50,083650,Miranda; Gregory Joseph,0,31,40,40
1651061019450,CSE 11,A01,083080,Cao; Yingjun,1,97,40,39
1651061025476,CSE 12,A01,083652,Staff,0,26,100,100
1651061031501,CSE 15L,A01,083654,Staff,0,3,50,50
1651061031501,CSE 15L,A02,083655,Staff,0,3,50,50
1651061037526,CSE 20,A01,083657,Staff,45,0,80,35
1651061043553,CSE 30,A01,083084,Eldon; John,0,38,80,80
1651061049577,CSE 100,A01,083659,Cao; Yingjun,0,72,50,50
1651061055600,CSE 134B,A01,083661,Powell; Thomas Allan,0,38,65,65
1651061061622,CSE 140,A01,083663,Staff,0,15,75,75
1651061067648,CSE 140L,A01,083088,Eldon; John,3,0,100,97
1651061073672,CSE 175,A01,083665,Kumar; Rakesh,0,0,25,25
1651061079697,CSE 190,A00,092507,Dubnov; Shlomo,9,0,20,11
1651061085722,ECE 45,A01,083139,Staff,0,7,60,60
1651061091751,ECE 65,A50,083695,Staff,0,7,30,30
1651061097782,ECE 109,A01,091882,Touri; Behrouz,33,0,70,37
1651061103808,ECE 180,A00,083140,Abi Samra; Nicholas Camill,17,0,30,13
1651061103808,ECE 180,B00,083141,Abi Samra; Nicholas Camill,0,0,30,30
1651061109840,MATH 10A,A01,083735,Patchell; Gregory David,0,0,30,30
1651061109840,MATH 10A,A02,083736,Patchell; Gregory David,27,0,30,3
1651061109840,MATH 10A,A03,083737,Patchell; Gregory David,23,0,30,7
1651061115870,MATH 10B,A01,083207,Staff,0,7,30,30
1651061115870,MATH 10B,A02,083208,Staff,0,6,30,30
1651061115870,MATH 10B,B01,083739,Staff,8,0,30,22
1651061115870,MATH 10B,B02,083740,Staff,28,0,30,2
1651061121905,MATH 18,A01,083743,Staff,0,0,30,30
1651061121905,MATH 18,A02,083744,Staff,23,0,30,7
1651061121905,MATH 18,A03,083745,Staff,19,0,30,11
1651061121905,MATH 18,A04,083746,Staff,26,0,30,4
1651061121905,MATH 18,B01,083748,Staff,0,16,30,30
1651061121905,MATH 18,B02,083749,Staff,0,14,30,30
1651061121905,MATH 18,B03,083750,Staff,0,14,30,30
1651061121905,MATH 18,B04,083751,Staff,0,13,30,30
1651061127928,MATH 20A,A01,083754,Staff,18,0,40,22
1651061133952,MATH 20B,A01,083756,Staff,0,14,30,30
1651061133952,MATH 20B,A02,083757,Staff,0,11,30,30
1651061139978,MATH 20C,A01,083760,Staff,0,16,30,30
1651061139978,MATH 20C,A02,083761,Staff,0,15,30,30
1651061139978,MATH 20C,B01,083762,Staff,8,0,30,22
1651061139978,MATH 20C,B02,083763,Staff,28,0,30,2
1651061146004,MATH 20D,A01,083765,Staff,3,1,30,27
1651061146004,MATH 20D,A02,083766,Staff,1,0,30,29
1651061146004,MATH 20D,A03,083767,Staff,22,0,30,8
1651061152034,MATH 20E,A01,083771,Staff,2,0,30,28
1651061152034,MATH 20E,A02,083772,Staff,10,0,30,20
1651061152034,MATH 20E,B01,083773,Staff,0,0,30,30
1651061152034,MATH 20E,B02,083774,Staff,0,0,30,30
1651061158071,MATH 103A,A01,083777,Staff,0,17,30,30
1651061158071,MATH 103A,A02,083778,Staff,0,16,30,30
1651061158071,MATH 103A,B01,083779,Staff,0,15,30,30
1651061158071,MATH 103A,B02,083780,Staff,0,13,30,30
1651061164095,MATH 105,A01,085443,Staff,0,23,30,30
1651061170125,MATH 109,A01,083213,Anzaldo; Leesa B,0,7,30,30
1651061170125,MATH 109,A02,083214,Anzaldo; Leesa B,0,7,30,30
1651061170125,MATH 109,B01,083215,Anzaldo; Leesa B,0,8,30,30
1651061170125,MATH 109,B02,083216,Anzaldo; Leesa B,0,8,30,30
1651061176152,MATH 142A,A01,083219,Chow; Bennett,0,15,30,30
1651061176152,MATH 142A,A02,083220,Chow; Bennett,0,15,30,30
1651061176152,MATH 142A,B01,083221,Chow; Bennett,0,16,30,30
1651061176152,MATH 142A,B02,083222,Chow; Bennett,0,14,30,30
1651061182180,MATH 193A,A01,083224,Staff,0,8,30,30
1651061182180,MATH 193A,A02,083225,Staff,0,7,30,30
1651061182180,MATH 193A,A03,083781,Staff,0,7,30,30
1651061182180,MATH 193A,A04,083782,Staff,0,7,30,30
1651061188203,MATH 197,001,091859,McAuley; Julian John,9998,0,9999,1
1651061194265,COGS 9,A01,083615,Staff,0,20,60,60
1651061200290,COGS 11,A01,083617,Boyle; Mary E. T.,13,0,40,27
1651061206319,COGS 13,A01,083071,Staff,0,40,40,40
1651061212347,COGS 14A,A01,092681,Staff,0,40,100,100
1651061218488,COGS 14B,A01,083073,Cheng; Tzu-Han,0,13,50,50
1651061224522,COGS 17,A01,092677,Staff,9,0,75,66
1651061230554,COGS 100,A01,083619,Staff,0,30,60,60
1651061236616,COGS 101A,A01,083621,Davis; Joshua Daniel,0,29,60,60
1651061242678,COGS 101B,A01,091572,Staff,0,7,60,60
1651061248719,COGS 101C,A01,083625,Delgado; Tania,14,0,30,16
1651061254759,COGS 107A,A01,083627,Boyle; Mary E. T.,0,17,60,60
1651061260803,COGS 118A,A01,083075,Staff,0,10,60,60
1651061266856,CSE 3,A50,083646,Miranda; Gregory Joseph,15,0,38,23
1651061266856,CSE 3,A51,083647,Miranda; Gregory Joseph,36,0,37,1
1651061272905,CSE 8A,A50,083650,Miranda; Gregory Joseph,0,31,40,40
1651061278955,CSE 11,A01,083080,Cao; Yingjun,1,97,40,39
1651061284990,CSE 12,A01,083652,Staff,0,27,100,100
1651061291028,CSE 15L,A01,083654,Staff,0,4,50,50
1651061291028,CSE 15L,A02,083655,Staff,0,3,50,50
1651061297076,CSE 20,A01,083657,Staff,45,0,80,35
1651061303101,CSE 30,A01,083084,Eldon; John,0,38,80,80
1651061309148,CSE 100,A01,083659,Cao; Yingjun,0,72,50,50
1651061315172,CSE 134B,A01,083661,Powell; Thomas Allan,0,38,65,65
1651061321200,CSE 140,A01,083663,Staff,0,15,75,75
1651061327228,CSE 140L,A01,083088,Eldon; John,3,0,100,97
1651061333259,CSE 175,A01,083665,Kumar; Rakesh,0,0,25,25
1651061339289,CSE 190,A00,092507,Dubnov; Shlomo,9,0,20,11
1651061345316,ECE 45,A01,083139,Staff,0,7,60,60
1651061351341,ECE 65,A50,083695,Staff,0,7,30,30
1651061357372,ECE 109,A01,091882,Touri; Behrouz,33,0,70,37
1651061363402,ECE 180,A00,083140,Abi Samra; Nicholas Camill,17,0,30,13
1651061363402,ECE 180,B00,083141,Abi Samra; Nicholas Camill,0,0,30,30
1651061369431,MATH 10A,A01,083735,Patchell; Gregory David,0,0,30,30
1651061369431,MATH 10A,A02,083736,Patchell; Gregory David,27,0,30,3
1651061369431,MATH 10A,A03,083737,Patchell; Gregory David,23,0,30,7
1651061375458,MATH 10B,A01,083207,Staff,0,7,30,30
1651061375458,MATH 10B,A02,083208,Staff,0,6,30,30
1651061375458,MATH 10B,B01,083739,Staff,8,0,30,22
1651061375458,MATH 10B,B02,083740,Staff,28,0,30,2
1651061381495,MATH 18,A01,083743,Staff,0,0,30,30
1651061381495,MATH 18,A02,083744,Staff,23,0,30,7
1651061381495,MATH 18,A03,083745,Staff,19,0,30,11
1651061381495,MATH 18,A04,083746,Staff,26,0,30,4
1651061381495,MATH 18,B01,083748,Staff,0,16,30,30
1651061381495,MATH 18,B02,083749,Staff,0,14,30,30
1651061381495,MATH 18,B03,083750,Staff,0,14,30,30
1651061381495,MATH 18,B04,083751,Staff,0,13,30,30
1651061387522,MATH 20A,A01,083754,Staff,18,0,40,22
1651061393546,MATH 20B,A01,083756,Staff,0,14,30,30
1651061393546,MATH 20B,A02,083757,Staff,0,11,30,30
1651061399571,MATH 20C,A01,083760,Staff,0,16,30,30
1651061399571,MATH 20C,A02,083761,Staff,0,15,30,30
1651061399571,MATH 20C,B01,083762,Staff,8,0,30,22
1651061399571,MATH 20C,B02,083763,Staff,28,0,30,2
1651061405598,MATH 20D,A01,083765,Staff,3,1,30,27
1651061405598,MATH 20D,A02,083766,Staff,1,0,30,29
1651061405598,MATH 20D,A03,083767,Staff,22,0,30,8
1651061411628,MATH 20E,A01,083771,Staff,2,0,30,28
1651061411628,MATH 20E,A02,083772,Staff,10,0,30,20
1651061411628,MATH 20E,B01,083773,Staff,0,0,30,30
1651061411628,MATH 20E,B02,083774,Staff,0,0,30,30
1651061417656,MATH 103A,A01,083777,Staff,0,17,30,30
1651061417656,MATH 103A,A02,083778,Staff,0,16,30,30
1651061417656,MATH 103A,B01,083779,Staff,0,15,30,30
1651061417656,MATH 103A,B02,083780,Staff,0,13,30,30
1651061423693,MATH 105,A01,085443,Staff,0,23,30,30
1651061429724,MATH 109,A01,083213,Anzaldo; Leesa B,0,7,30,30
1651061429724,MATH 109,A02,083214,Anzaldo; Leesa B,0,7,30,30
1651061429724,MATH 109,B01,083215,Anzaldo; Leesa B,0,8,30,30
1651061429724,MATH 109,B02,083216,Anzaldo; Leesa B,0,8,30,30
1651061435754,MATH 142A,A01,083219,Chow; Bennett,0,15,30,30
1651061435754,MATH 142A,A02,083220,Chow; Bennett,0,15,30,30
1651061435754,MATH 142A,B01,083221,Chow; Bennett,0,16,30,30
1651061435754,MATH 142A,B02,083222,Chow; Bennett,0,14,30,30
1651061441786,MATH 193A,A01,083224,Staff,0,8,30,30
1651061441786,MATH 193A,A02,083225,Staff,0,7,30,30
1651061441786,MATH 193A,A03,083781,Staff,0,7,30,30
1651061441786,MATH 193A,A04,083782,Staff,0,7,30,30
1651061447816,MATH 197,001,091859,McAuley; Julian John,9998,0,9999,1
1651061453919,COGS 9,A01,083615,Staff,0,20,60,60
1651061459949,COGS 11,A01,083617,Boyle; Mary E. T.,13,0,40,27
1651061465979,COGS 13,A01,083071,Staff,0,40,40,40
1651061472004,COGS 14A,A01,092681,Staff,0,40,100,100
1651061478028,COGS 14B,A01,083073,Cheng; Tzu-Han,0,13,50,50
1651061484057,COGS 17,A01,092677,Staff,9,0,75,66
1651061490086,COGS 100,A01,083619,Staff,0,30,60,60
1651061496116,COGS 101A,A01,083621,Davis; Joshua Daniel,0,29,60,60
1651061502142,COGS 101B,A01,091572,Staff,0,7,60,60
1651061508165,COGS 101C,A01,083625,Delgado; Tania,14,0,30,16
1651061514196,COGS 107A,A01,083627,Boyle; Mary E. T.,0,17,60,60
1651061520224,COGS 118A,A01,083075,Staff,0,10,60,60
1651061526250,CSE 3,A50,083646,Miranda; Gregory Joseph,15,0,38,23
1651061526250,CSE 3,A51,083647,Miranda; Gregory Joseph,36,0,37,1
1651061532278,CSE 8A,A50,083650,Miranda; Gregory Joseph,0,31,40,40
1651061538306,CSE 11,A01,083080,Cao; Yingjun,1,97,40,39
1651061544339,CSE 12,A01,083652,Staff,0,27,100,100
1651061550367,CSE 15L,A01,083654,Staff,0,4,50,50
1651061550367,CSE 15L,A02,083655,Staff,0,3,50,50
1651061556392,CSE 20,A01,083657,Staff,45,0,80,35
1651061562425,CSE 30,A01,083084,Eldon; John,0,38,80,80
1651061568454,CSE 100,A01,083659,Cao; Yingjun,0,72,50,50
1651061574484,CSE 134B,A01,083661,Powell; Thomas Allan,0,38,65,65
1651061580510,CSE 140,A01,083663,Staff,0,15,75,75
1651061586541,CSE 140L,A01,083088,Eldon; John,3,0,100,97
1651061592575,CSE 175,A01,083665,Kumar; Rakesh,0,0,25,25
1651061598601,CSE 190,A00,092507,Dubnov; Shlomo,9,0,20,11
1651061604627,ECE 45,A01,083139,Staff,0,7,60,60
1651061610652,ECE 65,A50,083695,Staff,0,7,30,30
1651061616677,ECE 109,A01,091882,Touri; Behrouz,33,0,70,37
1651061622707,ECE 180,A00,083140,Abi Samra; Nicholas Camill,17,0,30,13
1651061622707,ECE 180,B00,083141,Abi Samra; Nicholas Camill,0,0,30,30
1651061628735,MATH 10A,A01,083735,Patchell; Gregory David,0,0,30,30
1651061628735,MATH 10A,A02,083736,Patchell; Gregory David,27,0,30,3
1651061628735,MATH 10A,A03,083737,Patchell; Gregory David,23,0,30,7
1651061634769,MATH 10B,A01,083207,Staff,0,7,30,30
1651061634769,MATH 10B,A02,083208,Staff,0,6,30,30
1651061634769,MATH 10B,B01,083739,Staff,8,0,30,22
1651061634769,MATH 10B,B02,083740,Staff,28,0,30,2
1651061640800,MATH 18,A01,083743,Staff,0,0,30,30
1651061640800,MATH 18,A02,083744,Staff,23,0,30,7
1651061640800,MATH 18,A03,083745,Staff,19,0,30,11
1651061640800,MATH 18,A04,083746,Staff,26,0,30,4
1651061640800,MATH 18,B01,083748,Staff,0,16,30,30
1651061640800,MATH 18,B02,083749,Staff,0,14,30,30
1651061640800,MATH 18,B03,083750,Staff,0,14,30,30
1651061640800,MATH 18,B04,083751,Staff,0,13,30,30
1651061646824,MATH 20A,A01,083754,Staff,18,0,40,22
1651061652864,MATH 20B,A01,083756,Staff,0,14,30,30
1651061652864,MATH 20B,A02,083757,Staff,0,11,30,30
1651061658887,MATH 20C,A01,083760,Staff,0,16,30,30
1651061658887,MATH 20C,A02,083761,Staff,0,15,30,30
1651061658887,MATH 20C,B01,083762,Staff,8,0,30,22
1651061658887,MATH 20C,B02,083763,Staff,28,0,30,2
1651061664916,MATH 20D,A01,083765,Staff,3,1,30,27
1651061664916,MATH 20D,A02,083766,Staff,1,0,30,29
1651061664916,MATH 20D,A03,083767,Staff,22,0,30,8
1651061670942,MATH 20E,A01,083771,Staff,2,0,30,28
1651061670942,MATH 20E,A02,083772,Staff,10,0,30,20
1651061670942,MATH 20E,B01,083773,Staff,0,0,30,30
1651061670942,MATH 20E,B02,083774,Staff,0,0,30,30
1651061676975,MATH 103A,A01,083777,Staff,0,17,30,30
1651061676975,MATH 103A,A02,083778,Staff,0,16,30,30
1651061676975,MATH 103A,B01,083779,Staff,0,15,30,30
1651061676975,MATH 103A,B02,083780,Staff,0,13,30,30
1651061683005,MATH 105,A01,085443,Staff,0,23,30,30
1651061689032,MATH 109,A01,083213,Anzaldo; Leesa B,0,7,30,30
1651061689032,MATH 109,A02,083214,Anzaldo; Leesa B,0,7,30,30
1651061689032,MATH 109,B01,083215,Anzaldo; Leesa B,0,8,30,30
1651061689032,MATH 109,B02,083216,Anzaldo; Leesa B,0,8,30,30
1651061695067,MATH 142A,A01,083219,Chow; Bennett,0,15,30,30
1651061695067,MATH 142A,A02,083220,Chow; Bennett,0,15,30,30
1651061695067,MATH 142A,B01,083221,Chow; Bennett,0,16,30,30
1651061695067,MATH 142A,B02,083222,Chow; Bennett,0,14,30,30
1651061701096,MATH 193A,A01,083224,Staff,0,8,30,30
1651061701096,MATH 193A,A02,083225,Staff,0,7,30,30
1651061701096,MATH 193A,A03,083781,Staff,0,7,30,30
1651061701096,MATH 193A,A04,083782,Staff,0,7,30,30
1651061707130,MATH 197,001,091859,McAuley; Julian John,9998,0,9999,1
1651061713215,COGS 9,A01,083615,Staff,0,20,60,60
1651061719247,COGS 11,A01,083617,Boyle; Mary E. T.,13,0,40,27
1651061725272,COGS 13,A01,083071,Staff,0,40,40,40
1651061731296,COGS 14A,A01,092681,Staff,0,40,100,100
1651061737328,COGS 14B,A01,083073,Cheng; Tzu-Han,0,13,50,50
1651061743358,COGS 17,A01,092677,Staff,9,0,75,66
1651061749392,COGS 100,A01,083619,Staff,0,30,60,60
1651061755427,COGS 101A,A01,083621,Davis; Joshua Daniel,0,29,60,60
1651061761453,COGS 101B,A01,091572,Staff,0,7,60,60
1651061767483,COGS 101C,A01,083625,Delgado; Tania,14,0,30,16
1651061773518,COGS 107A,A01,083627,Boyle; Mary E. T.,0,17,60,60
1651061779544,COGS 118A,A01,083075,Staff,0,10,60,60
1651061785578,CSE 3,A50,083646,Miranda; Gregory Joseph,15,0,38,23
1651061785578,CSE 3,A51,083647,Miranda; Gregory Joseph,36,0,37,1
1651061791603,CSE 8A,A50,083650,Miranda; Gregory Joseph,0,31,40,40
1651061797629,CSE 11,A01,083080,Cao; Yingjun,1,97,40,39
1651061803663,CSE 12,A01,083652,Staff,0,27,100,100
1651061809689,CSE 15L,A01,083654,Staff,0,4,50,50
1651061809689,CSE 15L,A02,083655,Staff,0,3,50,50
1651061815803,CSE 20,A01,083657,Staff,45,0,80,35
1651061821836,CSE 30,A01,083084,Eldon; John,0,38,80,80
1651061827863,CSE 100,A01,083659,Cao; Yingjun,0,72,50,50
1651061833888,CSE 134B,A01,083661,Powell; Thomas Allan,0,38,65,65
1651061839914,CSE 140,A01,083663,Staff,0,15,75,75
1651061845938,CSE 140L,A01,083088,Eldon; John,3,0,100,97
1651061851961,CSE 175,A01,083665,Kumar; Rakesh,0,0,25,25
1651061857987,CSE 190,A00,092507,Dubnov; Shlomo,9,0,20,11
1651061864010,ECE 45,A01,083139,Staff,0,7,60,60
1651061870037,ECE 65,A50,083695,Staff,0,7,30,30
1651061876061,ECE 109,A01,091882,Touri; Behrouz,33,0,70,37
1651061882096,ECE 180,A00,083140,Abi Samra; Nicholas Camill,17,0,30,13
1651061882096,ECE 180,B00,083141,Abi Samra; Nicholas Camill,0,0,30,30
1651061888129,MATH 10A,A01,083735,Patchell; Gregory David,0,0,30,30
1651061888129,MATH 10A,A02,083736,Patchell; Gregory David,27,0,30,3
1651061888129,MATH 10A,A03,083737,Patchell; Gregory David,23,0,30,7
1651061894158,MATH 10B,A01,083207,Staff,0,7,30,30
1651061894158,MATH 10B,A02,083208,Staff,0,6,30,30
1651061894158,MATH 10B,B01,083739,Staff,8,0,30,22
1651061894158,MATH 10B,B02,083740,Staff,28,0,30,2
1651061900193,MATH 18,A01,083743,Staff,0,0,30,30
1651061900193,MATH 18,A02,083744,Staff,23,0,30,7
1651061900193,MATH 18,A03,083745,Staff,19,0,30,11
1651061900193,MATH 18,A04,083746,Staff,26,0,30,4
1651061900193,MATH 18,B01,083748,Staff,0,16,30,30
1651061900193,MATH 18,B02,083749,Staff,0,14,30,30
1651061900193,MATH 18,B03,083750,Staff,0,14,30,30
1651061900193,MATH 18,B04,083751,Staff,0,13,30,30
1651061906219,MATH 20A,A01,083754,Staff,18,0,40,22
1651061912244,MATH 20B,A01,083756,Staff,0,14,30,30
1651061912244,MATH 20B,A02,083757,Staff,0,11,30,30
1651061918268,MATH 20C,A01,083760,Staff,0,16,30,30
1651061918268,MATH 20C,A02,083761,Staff,0,15,30,30
1651061918268,MATH 20C,B01,083762,Staff,8,0,30,22
1651061918268,MATH 20C,B02,083763,Staff,28,0,30,2
1651061924292,MATH 20D,A01,083765,Staff,3,1,30,27
1651061924292,MATH 20D,A02,083766,Staff,1,0,30,29
1651061924292,MATH 20D,A03,083767,Staff,22,0,30,8
1651061930319,MATH 20E,A01,083771,Staff,2,0,30,28
1651061930319,MATH 20E,A02,083772,Staff,10,0,30,20
1651061930319,MATH 20E,B01,083773,Staff,0,0,30,30
1651061930319,MATH 20E,B02,083774,Staff,0,0,30,30
1651061936343,MATH 103A,A01,083777,Staff,0,17,30,30
1651061936343,MATH 103A,A02,083778,Staff,0,16,30,30
1651061936343,MATH 103A,B01,083779,Staff,0,15,30,30
1651061936343,MATH 103A,B02,083780,Staff,0,13,30,30
1651061942369,MATH 105,A01,085443,Staff,0,23,30,30
1651061948397,MATH 109,A01,083213,Anzaldo; Leesa B,0,7,30,30
1651061948397,MATH 109,A02,083214,Anzaldo; Leesa B,0,7,30,30
1651061948397,MATH 109,B01,083215,Anzaldo; Leesa B,0,8,30,30
1651061948397,MATH 109,B02,083216,Anzaldo; Leesa B,0,8,30,30
1651061954425,MATH 142A,A01,083219,Chow; Bennett,0,15,30,30
1651061954425,MATH 142A,A02,083220,Chow; Bennett,0,15,30,30
1651061954425,MATH 142A,B01,083221,Chow; Bennett,0,16,30,30
1651061954425,MATH 142A,B02,083222,Chow; Bennett,0,14,30,30
1651061960453,MATH 193A,A01,083224,Staff,0,8,30,30
1651061960453,MATH 193A,A02,083225,Staff,0,7,30,30
1651061960453,MATH 193A,A03,083781,Staff,0,7,30,30
1651061960453,MATH 193A,A04,083782,Staff,0,7,30,30
1651061966481,MATH 197,001,091859,McAuley; Julian John,9998,0,9999,1
1651061972534,COGS 9,A01,083615,Staff,0,20,60,60
1651061978562,COGS 11,A01,083617,Boyle; Mary E. T.,13,0,40,27
1651061984588,COGS 13,A01,083071,Staff,0,40,40,40
1651061990615,COGS 14A,A01,092681,Staff,0,40,100,100
1651061996640,COGS 14B,A01,083073,Cheng; Tzu-Han,0,13,50,50
1651062002665,COGS 17,A01,092677,Staff,9,0,75,66
1651062008691,COGS 100,A01,083619,Staff,0,30,60,60
1651062014714,COGS 101A,A01,083621,Davis; Joshua Daniel,0,29,60,60
1651062020741,COGS 101B,A01,091572,Staff,0,7,60,60
1651062026769,COGS 101C,A01,083625,Delgado; Tania,14,0,30,16
1651062032798,COGS 107A,A01,083627,Boyle; Mary E. T.,0,17,60,60
1651062038823,COGS 118A,A01,083075,Staff,0,10,60,60
1651062044861,CSE 3,A50,083646,Miranda; Gregory Joseph,15,0,38,23
1651062044861,CSE 3,A51,083647,Miranda; Gregory Joseph,36,0,37,1
1651062050904,CSE 8A,A50,083650,Miranda; Gregory Joseph,0,31,40,40
1651062056935,CSE 11,A01,083080,Cao; Yingjun,1,97,40,39
1651062062960,CSE 12,A01,083652,Staff,0,27,100,100
1651062068988,CSE 15L,A01,083654,Staff,0,4,50,50
1651062068988,CSE 15L,A02,083655,Staff,0,3,50,50
1651062075017,CSE 20,A01,083657,Staff,45,0,80,35
1651062081047,CSE 30,A01,083084,Eldon; John,0,38,80,80
1651062087077,CSE 100,A01,083659,Cao; Yingjun,0,72,50,50
1651062093109,CSE 134B,A01,083661,Powell; Thomas Allan,0,38,65,65
1651062099133,CSE 140,A01,083663,Staff,0,15,75,75
1651062105162,CSE 140L,A01,083088,Eldon; John,3,0,100,97
1651062111186,CSE 175,A01,083665,Kumar; Rakesh,0,0,25,25
1651062117215,CSE 190,A00,092507,Dubnov; Shlomo,9,0,20,11
1651062123245,ECE 45,A01,083139,Staff,0,7,60,60
1651062129271,ECE 65,A50,083695,Staff,0,7,30,30
1651062135300,ECE 109,A01,091882,Touri; Behrouz,33,0,70,37
1651062141330,ECE 180,A00,083140,Abi Samra; Nicholas Camill,17,0,30,13
1651062141330,ECE 180,B00,083141,Abi Samra; Nicholas Camill,0,0,30,30
1651062147360,MATH 10A,A01,083735,Patchell; Gregory David,0,0,30,30
1651062147360,MATH 10A,A02,083736,Patchell; Gregory David,27,0,30,3
1651062147360,MATH 10A,A03,083737,Patchell; Gregory David,23,0,30,7
1651062153384,MATH 10B,A01,083207,Staff,0,7,30,30
1651062153384,MATH 10B,A02,083208,Staff,0,6,30,30
1651062153384,MATH 10B,B01,083739,Staff,8,0,30,22
1651062153384,MATH 10B,B02,083740,Staff,28,0,30,2
1651062159411,MATH 18,A01,083743,Staff,0,0,30,30
1651062159411,MATH 18,A02,083744,Staff,23,0,30,7
1651062159411,MATH 18,A03,083745,Staff,19,0,30,11
1651062159411,MATH 18,A04,083746,Staff,26,0,30,4
1651062159411,MATH 18,B01,083748,Staff,0,16,30,30
1651062159411,MATH 18,B02,083749,Staff,0,14,30,30
1651062159411,MATH 18,B03,083750,Staff,0,14,30,30
1651062159411,MATH 18,B04,083751,Staff,0,13,30,30
1651062165438,MATH 20A,A01,083754,Staff,18,0,40,22
1651062171463,MATH 20B,A01,083756,Staff,0,14,30,30
1651062171463,MATH 20B,A02,083757,Staff,0,11,30,30
1651062177494,MATH 20C,A01,083760,Staff,0,16,30,30
1651062177494,MATH 20C,A02,083761,Staff,0,15,30,30
1651062177494,MATH 20C,B01,083762,Staff,8,0,30,22
1651062177494,MATH 20C,B02,083763,Staff,28,0,30,2
1651062183524,MATH 20D,A01,083765,Staff,3,1,30,27
1651062183524,MATH 20D,A02,083766,Staff,1,0,30,29
1651062183524,MATH 20D,A03,083767,Staff,22,0,30,8
1651062189552,MATH 20E,A01,083771,Staff,2,0,30,28
1651062189552,MATH 20E,A02,083772,Staff,10,0,30,20
1651062189552,MATH 20E,B01,083773,Staff,0,0,30,30
1651062189552,MATH 20E,B02,083774,Staff,0,0,30,30
1651062195589,MATH 103A,A01,083777,Staff,0,17,30,30
1651062195589,MATH 103A,A02,083778,Staff,0,16,30,30
1651062195589,MATH 103A,B01,083779,Staff,0,15,30,30
1651062195589,MATH 103A,B02,083780,Staff,0,13,30,30
1651062201616,MATH 105,A01,085443,Staff,0,23,30,30
1651062207644,MATH 109,A01,083213,Anzaldo; Leesa B,0,7,30,30
1651062207644,MATH 109,A02,083214,Anzaldo; Leesa B,0,7,30,30
1651062207644,MATH 109,B01,083215,Anzaldo; Leesa B,0,8,30,30
1651062207644,MATH 109,B02,083216,Anzaldo; Leesa B,0,8,30,30
1651062213669,MATH 142A,A01,083219,Chow; Bennett,0,15,30,30
1651062213669,MATH 142A,A02,083220,Chow; Bennett,0,15,30,30
1651062213669,MATH 142A,B01,083221,Chow; Bennett,0,16,30,30
1651062213669,MATH 142A,B02,083222,Chow; Bennett,0,14,30,30
1651062219693,MATH 193A,A01,083224,Staff,0,8,30,30
1651062219693,MATH 193A,A02,083225,Staff,0,7,30,30
1651062219693,MATH 193A,A03,083781,Staff,0,7,30,30
1651062219693,MATH 193A,A04,083782,Staff,0,7,30,30
1651062225717,MATH 197,001,091859,McAuley; Julian John,9998,0,9999,1
1651062231792,COGS 9,A01,083615,Staff,0,20,60,60
1651062237818,COGS 11,A01,083617,Boyle; Mary E. T.,13,0,40,27
1651062243842,COGS 13,A01,083071,Staff,0,40,40,40
1651062249867,COGS 14A,A01,092681,Staff,0,40,100,100
1651062255896,COGS 14B,A01,083073,Cheng; Tzu-Han,0,13,50,50
1651062261927,COGS 17,A01,092677,Staff,9,0,75,66
1651062267956,COGS 100,A01,083619,Staff,0,30,60,60
1651062273982,COGS 101A,A01,083621,Davis; Joshua Daniel,0,29,60,60
1651062280009,COGS 101B,A01,091572,Staff,0,7,60,60
1651062286035,COGS 101C,A01,083625,Delgado; Tania,14,0,30,16
1651062292063,COGS 107A,A01,083627,Boyle; Mary E. T.,0,17,60,60
1651062298092,COGS 118A,A01,083075,Staff,0,10,60,60
1651062304123,CSE 3,A50,083646,Miranda; Gregory Joseph,15,0,38,23
1651062304123,CSE 3,A51,083647,Miranda; Gregory Joseph,36,0,37,1
1651062310147,CSE 8A,A50,083650,Miranda; Gregory Joseph,0,31,40,40
1651062316172,CSE 11,A01,083080,Cao; Yingjun,1,97,40,39
1651062322196,CSE 12,A01,083652,Staff,0,27,100,100
1651062328220,CSE 15L,A01,083654,Staff,0,4,50,50
1651062328220,CSE 15L,A02,083655,Staff,0,3,50,50
1651062334248,CSE 20,A01,083657,Staff,45,0,80,35
1651062340279,CSE 30,A01,083084,Eldon; John,0,38,80,80
1651062346305,CSE 100,A01,083659,Cao; Yingjun,0,72,50,50
1651062352335,CSE 134B,A01,083661,Powell; Thomas Allan,0,38,65,65
1651062358362,CSE 140,A01,083663,Staff,0,15,75,75
1651062364394,CSE 140L,A01,083088,Eldon; John,3,0,100,97
1651062370419,CSE 175,A01,083665,Kumar; Rakesh,0,0,25,25
1651062376443,CSE 190,A00,092507,Dubnov; Shlomo,9,0,20,11
1651062382471,ECE 45,A01,083139,Staff,0,7,60,60
1651062388502,ECE 65,A50,083695,Staff,0,7,30,30
1651062394546,ECE 109,A01,091882,Touri; Behrouz,33,0,70,37
1651062400591,ECE 180,A00,083140,Abi Samra; Nicholas Camill,17,0,30,13
1651062400591,ECE 180,B00,083141,Abi Samra; Nicholas Camill,0,0,30,30
1651062406623,MATH 10A,A01,083735,Patchell; Gregory David,0,0,30,30
1651062406623,MATH 10A,A02,083736,Patchell; Gregory David,27,0,30,3
1651062406623,MATH 10A,A03,083737,Patchell; Gregory David,22,0,30,8
1651062412748,MATH 10B,A01,083207,Staff,0,7,30,30
1651062412748,MATH 10B,A02,083208,Staff,0,6,30,30
1651062412748,MATH 10B,B01,083739,Staff,8,0,30,22
1651062412748,MATH 10B,B02,083740,Staff,28,0,30,2
1651062418783,MATH 18,A01,083743,Staff,0,0,30,30
1651062418783,MATH 18,A02,083744,Staff,23,0,30,7
1651062418783,MATH 18,A03,083745,Staff,19,0,30,11
1651062418783,MATH 18,A04,083746,Staff,26,0,30,4
1651062418783,MATH 18,B01,083748,Staff,0,16,30,30
1651062418783,MATH 18,B02,083749,Staff,0,14,30,30
1651062418783,MATH 18,B03,083750,Staff,0,14,30,30
1651062418783,MATH 18,B04,083751,Staff,0,13,30,30
1651062424808,MATH 20A,A01,083754,Staff,18,0,40,22
1651062430835,MATH 20B,A01,083756,Staff,0,14,30,30
1651062430835,MATH 20B,A02,083757,Staff,0,11,30,30
1651062436864,MATH 20C,A01,083760,Staff,0,16,30,30
1651062436864,MATH 20C,A02,083761,Staff,0,15,30,30
1651062436864,MATH 20C,B01,083762,Staff,8,0,30,22
1651062436864,MATH 20C,B02,083763,Staff,28,0,30,2
1651062442888,MATH 20D,A01,083765,Staff,3,1,30,27
1651062442888,MATH 20D,A02,083766,Staff,1,0,30,29
1651062442888,MATH 20D,A03,083767,Staff,22,0,30,8
1651062448915,MATH 20E,A01,083771,Staff,2,0,30,28
1651062448915,MATH 20E,A02,083772,Staff,10,0,30,20
1651062448915,MATH 20E,B01,083773,Staff,0,0,30,30
1651062448915,MATH 20E,B02,083774,Staff,0,0,30,30
1651062454939,MATH 103A,A01,083777,Staff,0,17,30,30
1651062454939,MATH 103A,A02,083778,Staff,0,16,30,30
1651062454939,MATH 103A,B01,083779,Staff,0,15,30,30
1651062454939,MATH 103A,B02,083780,Staff,0,13,30,30
1651062460963,MATH 105,A01,085443,Staff,0,23,30,30
1651062466993,MATH 109,A01,083213,Anzaldo; Leesa B,0,7,30,30
1651062466993,MATH 109,A02,083214,Anzaldo; Leesa B,0,7,30,30
1651062466993,MATH 109,B01,083215,Anzaldo; Leesa B,0,8,30,30
1651062466993,MATH 109,B02,083216,Anzaldo; Leesa B,0,8,30,30
1651062473021,MATH 142A,A01,083219,Chow; Bennett,0,15,30,30
1651062473021,MATH 142A,A02,083220,Chow; Bennett,0,15,30,30
1651062473021,MATH 142A,B01,083221,Chow; Bennett,0,16,30,30
1651062473021,MATH 142A,B02,083222,Chow; Bennett,0,14,30,30
1651062479049,MATH 193A,A01,083224,Staff,0,8,30,30
1651062479049,MATH 193A,A02,083225,Staff,0,7,30,30
1651062479049,MATH 193A,A03,083781,Staff,0,7,30,30
1651062479049,MATH 193A,A04,083782,Staff,0,7,30,30
1651062485077,MATH 197,001,091859,McAuley; Julian John,9998,0,9999,1
1651062491135,COGS 9,A01,083615,Staff,0,20,60,60
1651062497163,COGS 11,A01,083617,Boyle; Mary E. T.,13,0,40,27
1651062503192,COGS 13,A01,083071,Staff,0,40,40,40
1651062509216,COGS 14A,A01,092681,Staff,0,40,100,100
1651062515246,COGS 14B,A01,083073,Cheng; Tzu-Han,0,13,50,50
1651062521271,COGS 17,A01,092677,Staff,9,0,75,66
1651062527296,COGS 100,A01,083619,Staff,0,30,60,60
1651062533319,COGS 101A,A01,083621,Davis; Joshua Daniel,0,29,60,60
1651062539349,COGS 101B,A01,091572,Staff,0,7,60,60
1651062545378,COGS 101C,A01,083625,Delgado; Tania,14,0,30,16
1651062551406,COGS 107A,A01,083627,Boyle; Mary E. T.,0,17,60,60
1651062557435,COGS 118A,A01,083075,Staff,0,10,60,60
1651062563463,CSE 3,A50,083646,Miranda; Gregory Joseph,15,0,38,23
1651062563463,CSE 3,A51,083647,Miranda; Gregory Joseph,36,0,37,1
1651062569492,CSE 8A,A50,083650,Miranda; Gregory Joseph,0,31,40,40
1651062575523,CSE 11,A01,083080,Cao; Yingjun,1,97,40,39
1651062581544,CSE 12,A01,083652,Staff,0,27,100,100
1651062587569,CSE 15L,A01,083654,Staff,0,4,50,50
1651062587569,CSE 15L,A02,083655,Staff,0,3,50,50
1651062593595,CSE 20,A01,083657,Staff,45,0,80,35
1651062599645,CSE 30,A01,083084,Eldon; John,0,38,80,80
1651062605676,CSE 100,A01,083659,Cao; Yingjun,0,72,50,50
1651062611707,CSE 134B,A01,083661,Powell; Thomas Allan,0,38,65,65
1651062617733,CSE 140,A01,083663,Staff,0,15,75,75
1651062623765,CSE 140L,A01,083088,Eldon; John,3,0,100,97
1651062629802,CSE 175,A01,083665,Kumar; Rakesh,0,0,25,25
1651062635832,CSE 190,A00,092507,Dubnov; Shlomo,9,0,20,11
1651062641857,ECE 45,A01,083139,Staff,0,7,60,60
1651062647880,ECE 65,A50,083695,Staff,0,7,30,30
1651062653905,ECE 109,A01,091882,Touri; Behrouz,33,0,70,37
1651062659931,ECE 180,A00,083140,Abi Samra; Nicholas Camill,17,0,30,13
1651062659931,ECE 180,B00,083141,Abi Samra; Nicholas Camill,0,0,30,30
1651062665958,MATH 10A,A01,083735,Patchell; Gregory David,0,0,30,30
1651062665958,MATH 10A,A02,083736,Patchell; Gregory David,27,0,30,3
1651062665958,MATH 10A,A03,083737,Patchell; Gregory David,22,0,30,8
1651062671987,MATH 10B,A01,083207,Staff,0,7,30,30
1651062671987,MATH 10B,A02,083208,Staff,0,6,30,30
1651062671987,MATH 10B,B01,083739,Staff,8,0,30,22
1651062671987,MATH 10B,B02,083740,Staff,28,0,30,2
1651062678010,MATH 18,A01,083743,Staff,0,0,30,30
1651062678010,MATH 18,A02,083744,Staff,23,0,30,7
1651062678010,MATH 18,A03,083745,Staff,19,0,30,11
1651062678010,MATH 18,A04,083746,Staff,26,0,30,4
1651062678010,MATH 18,B01,083748,Staff,0,16,30,30
1651062678010,MATH 18,B02,083749,Staff,0,14,30,30
1651062678010,MATH 18,B03,083750,Staff,0,14,30,30
1651062678010,MATH 18,B04,083751,Staff,0,13,30,30
1651062684038,MATH 20A,A01,083754,Staff,18,0,40,22
1651062690063,MATH 20B,A01,083756,Staff,0,14,30,30
1651062690063,MATH 20B,A02,083757,Staff,0,11,30,30
1651062696099,MATH 20C,A01,083760,Staff,0,16,30,30
1651062696099,MATH 20C,A02,083761,Staff,0,15,30,30
1651062696099,MATH 20C,B01,083762,Staff,8,0,30,22
1651062696099,MATH 20C,B02,083763,Staff,28,0,30,2
1651062702124,MATH 20D,A01,083765,Staff,3,1,30,27
1651062702124,MATH 20D,A02,083766,Staff,1,0,30,29
1651062702124,MATH 20D,A03,083767,Staff,22,0,30,8
1651062708148,MATH 20E,A01,083771,Staff,2,0,30,28
1651062708148,MATH 20E,A02,083772,Staff,10,0,30,20
1651062708148,MATH 20E,B01,083773,Staff,0,0,30,30
1651062708148,MATH 20E,B02,083774,Staff,0,0,30,30
1651062714172,MATH 103A,A01,083777,Staff,0,17,30,30
1651062714172,MATH 103A,A02,083778,Staff,0,16,30,30
1651062714172,MATH 103A,B01,083779,Staff,0,15,30,30
1651062714172,MATH 103A,B02,083780,Staff,0,13,30,30
1651062720198,MATH 105,A01,085443,Staff,0,23,30,30
1651062726234,MATH 109,A01,083213,Anzaldo; Leesa B,0,7,30,30
1651062726234,MATH 109,A02,083214,Anzaldo; Leesa B,0,7,30,30
1651062726234,MATH 109,B01,083215,Anzaldo; Leesa B,0,8,30,30
1651062726234,MATH 109,B02,083216,Anzaldo; Leesa B,0,8,30,30
1651062732266,MATH 142A,A01,083219,Chow; Bennett,0,15,30,30
1651062732266,MATH 142A,A02,083220,Chow; Bennett,0,15,30,30
1651062732266,MATH 142A,B01,083221,Chow; Bennett,0,16,30,30
1651062732266,MATH 142A,B02,083222,Chow; Bennett,0,14,30,30
1651062738292,MATH 193A,A01,083224,Staff,0,8,30,30
1651062738292,MATH 193A,A02,083225,Staff,0,7,30,30
1651062738292,MATH 193A,A03,083781,Staff,0,7,30,30
1651062738292,MATH 193A,A04,083782,Staff,0,7,30,30
1651062744314,MATH 197,001,091859,McAuley; Julian John,9998,0,9999,1
1651062750379,COGS 9,A01,083615,Staff,0,20,60,60
1651062756410,COGS 11,A01,083617,Boyle; Mary E. T.,13,0,40,27
1651062762435,COGS 13,A01,083071,Staff,0,40,40,40
1651062768459,COGS 14A,A01,092681,Staff,0,40,100,100
1651062774483,COGS 14B,A01,083073,Cheng; Tzu-Han,0,13,50,50
1651062780516,COGS 17,A01,092677,Staff,9,0,75,66
1651062786544,COGS 100,A01,083619,Staff,0,30,60,60
1651062792570,COGS 101A,A01,083621,Davis; Joshua Daniel,0,29,60,60
1651062798595,COGS 101B,A01,091572,Staff,0,7,60,60
1651062804625,COGS 101C,A01,083625,Delgado; Tania,14,0,30,16
1651062810648,COGS 107A,A01,083627,Boyle; Mary E. T.,0,17,60,60
1651062816672,COGS 118A,A01,083075,Staff,0,10,60,60
1651062822699,CSE 3,A50,083646,Miranda; Gregory Joseph,15,0,38,23
1651062822699,CSE 3,A51,083647,Miranda; Gregory Joseph,36,0,37,1
1651062828726,CSE 8A,A50,083650,Miranda; Gregory Joseph,0,31,40,40
1651062834754,CSE 11,A01,083080,Cao; Yingjun,1,97,40,39
1651062840779,CSE 12,A01,083652,Staff,0,27,100,100
1651062846805,CSE 15L,A01,083654,Staff,0,4,50,50
1651062846805,CSE 15L,A02,083655,Staff,0,3,50,50
1651062852833,CSE 20,A01,083657,Staff,45,0,80,35
1651062858861,CSE 30,A01,083084,Eldon; John,0,38,80,80
1651062864887,CSE 100,A01,083659,Cao; Yingjun,0,72,50,50
1651062870915,CSE 134B,A01,083661,Powell; Thomas Allan,0,38,65,65
1651062876940,CSE 140,A01,083663,Staff,0,15,75,75
1651062882964,CSE 140L,A01,083088,Eldon; John,3,0,100,97
1651062888999,CSE 175,A01,083665,Kumar; Rakesh,0,0,25,25
1651062895024,CSE 190,A00,092507,Dubnov; Shlomo,9,0,20,11
1651062901055,ECE 45,A01,083139,Staff,0,7,60,60
1651062907080,ECE 65,A50,083695,Staff,0,7,30,30
1651062913110,ECE 109,A01,091882,Touri; Behrouz,33,0,70,37
1651062919133,ECE 180,A00,083140,Abi Samra; Nicholas Camill,17,0,30,13
1651062919133,ECE 180,B00,083141,Abi Samra; Nicholas Camill,0,0,30,30
1651062925162,MATH 10A,A01,083735,Patchell; Gregory David,0,0,30,30
1651062925162,MATH 10A,A02,083736,Patchell; Gregory David,27,0,30,3
1651062925162,MATH 10A,A03,083737,Patchell; Gregory David,22,0,30,8
1651062931187,MATH 10B,A01,083207,Staff,0,7,30,30
1651062931187,MATH 10B,A02,083208,Staff,0,6,30,30
1651062931187,MATH 10B,B01,083739,Staff,8,0,30,22
1651062931187,MATH 10B,B02,083740,Staff,28,0,30,2
1651062937217,MATH 18,A01,083743,Staff,0,0,30,30
1651062937217,MATH 18,A02,083744,Staff,23,0,30,7
1651062937217,MATH 18,A03,083745,Staff,19,0,30,11
1651062937217,MATH 18,A04,083746,Staff,26,0,30,4
1651062937217,MATH 18,B01,083748,Staff,0,16,30,30
1651062937217,MATH 18,B02,083749,Staff,0,14,30,30
1651062937217,MATH 18,B03,083750,Staff,0,14,30,30
1651062937217,MATH 18,B04,083751,Staff,0,13,30,30
1651062943245,MATH 20A,A01,083754,Staff,18,0,40,22
1651062949269,MATH 20B,A01,083756,Staff,0,14,30,30
1651062949269,MATH 20B,A02,083757,Staff,0,11,30,30
1651062955312,MATH 20C,A01,083760,Staff,0,16,30,30
1651062955312,MATH 20C,A02,083761,Staff,0,15,30,30
1651062955312,MATH 20C,B01,083762,Staff,8,0,30,22
1651062955312,MATH 20C,B02,083763,Staff,28,0,30,2
1651062961340,MATH 20D,A01,083765,Staff,3,1,30,27
1651062961340,MATH 20D,A02,083766,Staff,1,0,30,29
1651062961340,MATH 20D,A03,083767,Staff,22,0,30,8
1651062967365,MATH 20E,A01,083771,Staff,2,0,30,28
1651062967365,MATH 20E,A02,083772,Staff,10,0,30,20
1651062967365,MATH 20E,B01,083773,Staff,0,0,30,30
1651062967365,MATH 20E,B02,083774,Staff,0,0,30,30
1651062973390,MATH 103A,A01,083777,Staff,0,17,30,30
1651062973390,MATH 103A,A02,083778,Staff,0,16,30,30
1651062973390,MATH 103A,B01,083779,Staff,0,15,30,30
1651062973390,MATH 103A,B02,083780,Staff,0,13,30,30
1651062979419,MATH 105,A01,085443,Staff,0,23,30,30
1651062985445,MATH 109,A01,083213,Anzaldo; Leesa B,0,7,30,30
1651062985445,MATH 109,A02,083214,Anzaldo; Leesa B,0,7,30,30
1651062985445,MATH 109,B01,083215,Anzaldo; Leesa B,0,8,30,30
1651062985445,MATH 109,B02,083216,Anzaldo; Leesa B,0,8,30,30
1651062991473,MATH 142A,A01,083219,Chow; Bennett,0,15,30,30
1651062991473,MATH 142A,A02,083220,Chow; Bennett,0,15,30,30
1651062991473,MATH 142A,B01,083221,Chow; Bennett,0,16,30,30
1651062991473,MATH 142A,B02,083222,Chow; Bennett,0,14,30,30
1651062997502,MATH 193A,A01,083224,Staff,0,8,30,30
1651062997502,MATH 193A,A02,083225,Staff,0,7,30,30
1651062997502,MATH 193A,A03,083781,Staff,0,7,30,30
1651062997502,MATH 193A,A04,083782,Staff,0,7,30,30
1651063003526,MATH 197,001,091859,McAuley; Julian John,9998,0,9999,1
1651063009701,COGS 9,A01,083615,Staff,0,20,60,60
1651063015729,COGS 11,A01,083617,Boyle; Mary E. T.,13,0,40,27
1651063021756,COGS 13,A01,083071,Staff,0,40,40,40
1651063027783,COGS 14A,A01,092681,Staff,0,40,100,100
1651063033816,COGS 14B,A01,083073,Cheng; Tzu-Han,0,13,50,50
1651063039841,COGS 17,A01,092677,Staff,9,0,75,66
1651063045878,COGS 100,A01,083619,Staff,0,30,60,60
1651063051911,COGS 101A,A01,083621,Davis; Joshua Daniel,0,29,60,60
1651063057943,COGS 101B,A01,091572,Staff,0,7,60,60
1651063063971,COGS 101C,A01,083625,Delgado; Tania,14,0,30,16
1651063069995,COGS 107A,A01,083627,Boyle; Mary E. T.,0,17,60,60
1651063076025,COGS 118A,A01,083075,Staff,0,10,60,60
1651063082063,CSE 3,A50,083646,Miranda; Gregory Joseph,15,0,38,23
1651063082063,CSE 3,A51,083647,Miranda; Gregory Joseph,36,0,37,1
1651063088093,CSE 8A,A50,083650,Miranda; Gregory Joseph,0,31,40,40
1651063094123,CSE 11,A01,083080,Cao; Yingjun,1,97,40,39
1651063100148,CSE 12,A01,083652,Staff,0,27,100,100
1651063106176,CSE 15L,A01,083654,Staff,0,4,50,50
1651063106176,CSE 15L,A02,083655,Staff,0,3,50,50
1651063112205,CSE 20,A01,083657,Staff,46,0,80,34
1651063118230,CSE 30,A01,083084,Eldon; John,0,38,80,80
1651063124256,CSE 100,A01,083659,Cao; Yingjun,0,72,50,50
1651063130283,CSE 134B,A01,083661,Powell; Thomas Allan,0,38,65,65
1651063136309,CSE 140,A01,083663,Staff,0,15,75,75
1651063142333,CSE 140L,A01,083088,Eldon; John,3,0,100,97
1651063148363,CSE 175,A01,083665,Kumar; Rakesh,0,0,25,25
1651063154390,CSE 190,A00,092507,Dubnov; Shlomo,9,0,20,11
1651063160422,ECE 45,A01,083139,Staff,0,7,60,60
1651063166458,ECE 65,A50,083695,Staff,0,7,30,30
1651063172487,ECE 109,A01,091882,Touri; Behrouz,33,0,70,37
1651063178510,ECE 180,A00,083140,Abi Samra; Nicholas Camill,17,0,30,13
1651063178510,ECE 180,B00,083141,Abi Samra; Nicholas Camill,0,0,30,30
1651063184539,MATH 10A,A01,083735,Patchell; Gregory David,0,0,30,30
1651063184539,MATH 10A,A02,083736,Patchell; Gregory David,27,0,30,3
1651063184539,MATH 10A,A03,083737,Patchell; Gregory David,22,0,30,8
1651063190564,MATH 10B,A01,083207,Staff,0,7,30,30
1651063190564,MATH 10B,A02,083208,Staff,0,6,30,30
1651063190564,MATH 10B,B01,083739,Staff,8,0,30,22
1651063190564,MATH 10B,B02,083740,Staff,28,0,30,2
1651063196598,MATH 18,A01,083743,Staff,0,0,30,30
1651063196598,MATH 18,A02,083744,Staff,23,0,30,7
1651063196598,MATH 18,A03,083745,Staff,19,0,30,11
1651063196598,MATH 18,A04,083746,Staff,26,0,30,4
1651063196598,MATH 18,B01,083748,Staff,0,16,30,30
1651063196598,MATH 18,B02,083749,Staff,0,14,30,30
1651063196598,MATH 18,B03,083750,Staff,0,14,30,30
1651063196598,MATH 18,B04,083751,Staff,0,13,30,30
1651063202626,MATH 20A,A01,083754,Staff,18,0,40,22
1651063208652,MATH 20B,A01,083756,Staff,0,14,30,30
1651063208652,MATH 20B,A02,083757,Staff,0,11,30,30
1651063214677,MATH 20C,A01,083760,Staff,0,16,30,30
1651063214677,MATH 20C,A02,083761,Staff,0,15,30,30
1651063214677,MATH 20C,B01,083762,Staff,8,0,30,22
1651063214677,MATH 20C,B02,083763,Staff,28,0,30,2
1651063220701,MATH 20D,A01,083765,Staff,3,1,30,27
1651063220701,MATH 20D,A02,083766,Staff,1,0,30,29
1651063220701,MATH 20D,A03,083767,Staff,22,0,30,8
1651063226728,MATH 20E,A01,083771,Staff,2,0,30,28
1651063226728,MATH 20E,A02,083772,Staff,10,0,30,20
1651063226728,MATH 20E,B01,083773,Staff,0,0,30,30
1651063226728,MATH 20E,B02,083774,Staff,0,0,30,30
1651063232754,MATH 103A,A01,083777,Staff,0,17,30,30
1651063232754,MATH 103A,A02,083778,Staff,0,16,30,30
1651063232754,MATH 103A,B01,083779,Staff,0,15,30,30
1651063232754,MATH 103A,B02,083780,Staff,0,13,30,30
1651063238781,MATH 105,A01,085443,Staff,0,23,30,30
1651063244823,MATH 109,A01,083213,Anzaldo; Leesa B,0,7,30,30
1651063244823,MATH 109,A02,083214,Anzaldo; Leesa B,0,7,30,30
1651063244823,MATH 109,B01,083215,Anzaldo; Leesa B,0,8,30,30
1651063244823,MATH 109,B02,083216,Anzaldo; Leesa B,0,8,30,30
1651063250849,MATH 142A,A01,083219,Chow; Bennett,0,15,30,30
1651063250849,MATH 142A,A02,083220,Chow; Bennett,0,15,30,30
1651063250849,MATH 142A,B01,083221,Chow; Bennett,0,16,30,30
1651063250849,MATH 142A,B02,083222,Chow; Bennett,0,14,30,30
1651063256877,MATH 193A,A01,083224,Staff,0,8,30,30
1651063256877,MATH 193A,A02,083225,Staff,0,7,30,30
1651063256877,MATH 193A,A03,083781,Staff,0,7,30,30
1651063256877,MATH 193A,A04,083782,Staff,0,7,30,30
1651063262906,MATH 197,001,091859,McAuley; Julian John,9998,0,9999,1
1651063268971,COGS 9,A01,083615,Staff,0,20,60,60
1651063274993,COGS 11,A01,083617,Boyle; Mary E. T.,13,0,40,27
1651063281019,COGS 13,A01,083071,Staff,0,40,40,40
1651063287048,COGS 14A,A01,092681,Staff,0,40,100,100
1651063293074,COGS 14B,A01,083073,Cheng; Tzu-Han,0,13,50,50
1651063299097,COGS 17,A01,092677,Staff,9,0,75,66
1651063305124,COGS 100,A01,083619,Staff,0,30,60,60
1651063311160,COGS 101A,A01,083621,Davis; Joshua Daniel,0,29,60,60
1651063317185,COGS 101B,A01,091572,Staff,0,7,60,60
1651063323216,COGS 101C,A01,083625,Delgado; Tania,14,0,30,16
1651063329245,COGS 107A,A01,083627,Boyle; Mary E. T.,0,17,60,60
1651063335270,COGS 118A,A01,083075,Staff,0,10,60,60
1651063341298,CSE 3,A50,083646,Miranda; Gregory Joseph,15,0,38,23
1651063341298,CSE 3,A51,083647,Miranda; Gregory Joseph,36,0,37,1
1651063347328,CSE 8A,A50,083650,Miranda; Gregory Joseph,0,31,40,40
1651063353355,CSE 11,A01,083080,Cao; Yingjun,1,97,40,39
1651063359378,CSE 12,A01,083652,Staff,0,27,100,100
1651063365403,CSE 15L,A01,083654,Staff,0,4,50,50
1651063365403,CSE 15L,A02,083655,Staff,0,3,50,50
1651063371428,CSE 20,A01,083657,Staff,46,0,80,34
1651063377457,CSE 30,A01,083084,Eldon; John,0,38,80,80
1651063383486,CSE 100,A01,083659,Cao; Yingjun,0,72,50,50
1651063389512,CSE 134B,A01,083661,Powell; Thomas Allan,0,38,65,65
1651063395535,CSE 140,A01,083663,Staff,0,15,75,75
1651063401564,CSE 140L,A01,083088,Eldon; John,3,0,100,97
1651063407595,CSE 175,A01,083665,Kumar; Rakesh,0,0,25,25
1651063413620,CSE 190,A00,092507,Dubnov; Shlomo,9,0,20,11
1651063419643,ECE 45,A01,083139,Staff,0,7,60,60
1651063425667,ECE 65,A50,083695,Staff,0,7,30,30
1651063431691,ECE 109,A01,091882,Touri; Behrouz,33,0,70,37
1651063437718,ECE 180,A00,083140,Abi Samra; Nicholas Camill,17,0,30,13
1651063437718,ECE 180,B00,083141,Abi Samra; Nicholas Camill,0,0,30,30
1651063443743,MATH 10A,A01,083735,Patchell; Gregory David,0,0,30,30
1651063443743,MATH 10A,A02,083736,Patchell; Gregory David,27,0,30,3
1651063443743,MATH 10A,A03,083737,Patchell; Gregory David,22,0,30,8
1651063449769,MATH 10B,A01,083207,Staff,0,7,30,30
1651063449769,MATH 10B,A02,083208,Staff,0,6,30,30
1651063449769,MATH 10B,B01,083739,Staff,8,0,30,22
1651063449769,MATH 10B,B02,083740,Staff,28,0,30,2
1651063455813,MATH 18,A01,083743,Staff,0,0,30,30
1651063455813,MATH 18,A02,083744,Staff,23,0,30,7
1651063455813,MATH 18,A03,083745,Staff,19,0,30,11
1651063455813,MATH 18,A04,083746,Staff,26,0,30,4
1651063455813,MATH 18,B01,083748,Staff,0,16,30,30
1651063455813,MATH 18,B02,083749,Staff,0,14,30,30
1651063455813,MATH 18,B03,083750,Staff,0,14,30,30
1651063455813,MATH 18,B04,083751,Staff,0,13,30,30
1651063461838,MATH 20A,A01,083754,Staff,18,0,40,22
1651063467865,MATH 20B,A01,083756,Staff,0,14,30,30
1651063467865,MATH 20B,A02,083757,Staff,0,11,30,30
1651063473896,MATH 20C,A01,083760,Staff,0,16,30,30
1651063473896,MATH 20C,A02,083761,Staff,0,15,30,30
1651063473896,MATH 20C,B01,083762,Staff,8,0,30,22
1651063473896,MATH 20C,B02,083763,Staff,28,0,30,2
1651063479925,MATH 20D,A01,083765,Staff,3,1,30,27
1651063479925,MATH 20D,A02,083766,Staff,1,0,30,29
1651063479925,MATH 20D,A03,083767,Staff,22,0,30,8
1651063485948,MATH 20E,A01,083771,Staff,2,0,30,28
1651063485948,MATH 20E,A02,083772,Staff,10,0,30,20
1651063485948,MATH 20E,B01,083773,Staff,0,0,30,30
1651063485948,MATH 20E,B02,083774,Staff,0,0,30,30
1651063491977,MATH 103A,A01,083777,Staff,0,17,30,30
1651063491977,MATH 103A,A02,083778,Staff,0,16,30,30
1651063491977,MATH 103A,B01,083779,Staff,0,15,30,30
1651063491977,MATH 103A,B02,083780,Staff,0,13,30,30
1651063498001,MATH 105,A01,085443,Staff,0,23,30,30
1651063504030,MATH 109,A01,083213,Anzaldo; Leesa B,0,7,30,30
1651063504030,MATH 109,A02,083214,Anzaldo; Leesa B,0,7,30,30
1651063504030,MATH 109,B01,083215,Anzaldo; Leesa B,0,8,30,30
1651063504030,MATH 109,B02,083216,Anzaldo; Leesa B,0,8,30,30
1651063510061,MATH 142A,A01,083219,Chow; Bennett,0,15,30,30
1651063510061,MATH 142A,A02,083220,Chow; Bennett,0,15,30,30
1651063510061,MATH 142A,B01,083221,Chow; Bennett,0,16,30,30
1651063510061,MATH 142A,B02,083222,Chow; Bennett,0,14,30,30
1651063516093,MATH 193A,A01,083224,Staff,0,8,30,30
1651063516093,MATH 193A,A02,083225,Staff,0,7,30,30
1651063516093,MATH 193A,A03,083781,Staff,0,7,30,30
1651063516093,MATH 193A,A04,083782,Staff,0,7,30,30
1651063522124,MATH 197,001,091859,McAuley; Julian John,9998,0,9999,1
1651063528183,COGS 9,A01,083615,Staff,0,20,60,60
1651063534207,COGS 11,A01,083617,Boyle; Mary E. T.,13,0,40,27
1651063540234,COGS 13,A01,083071,Staff,0,40,40,40
1651063546263,COGS 14A,A01,092681,Staff,0,40,100,100
1651063552290,COGS 14B,A01,083073,Cheng; Tzu-Han,0,13,50,50
1651063558316,COGS 17,A01,092677,Staff,9,0,75,66
1651063564342,COGS 100,A01,083619,Staff,0,30,60,60
1651063570371,COGS 101A,A01,083621,Davis; Joshua Daniel,0,29,60,60
1651063576396,COGS 101B,A01,091572,Staff,0,7,60,60
1651063582419,COGS 101C,A01,083625,Delgado; Tania,14,0,30,16
1651063588449,COGS 107A,A01,083627,Boyle; Mary E. T.,0,17,60,60
1651063594473,COGS 118A,A01,083075,Staff,0,10,60,60
1651063600588,CSE 3,A50,083646,Miranda; Gregory Joseph,15,0,38,23
1651063600588,CSE 3,A51,083647,Miranda; Gregory Joseph,36,0,37,1
1651063606614,CSE 8A,A50,083650,Miranda; Gregory Joseph,0,31,40,40
1651063612645,CSE 11,A01,083080,Cao; Yingjun,1,97,40,39
1651063618674,CSE 12,A01,083652,Staff,0,27,100,100
1651063624702,CSE 15L,A01,083654,Staff,0,3,50,50
1651063624702,CSE 15L,A02,083655,Staff,0,3,50,50
1651063630730,CSE 20,A01,083657,Staff,46,0,80,34
1651063636757,CSE 30,A01,083084,Eldon; John,0,38,80,80
1651063642787,CSE 100,A01,083659,Cao; Yingjun,0,72,50,50
1651063648816,CSE 134B,A01,083661,Powell; Thomas Allan,0,38,65,65
1651063654845,CSE 140,A01,083663,Staff,0,15,75,75
1651063660870,CSE 140L,A01,083088,Eldon; John,3,0,100,97
1651063666898,CSE 175,A01,083665,Kumar; Rakesh,0,0,25,25
1651063672925,CSE 190,A00,092507,Dubnov; Shlomo,9,0,20,11
1651063678951,ECE 45,A01,083139,Staff,0,7,60,60
1651063684980,ECE 65,A50,083695,Staff,0,7,30,30
1651063691006,ECE 109,A01,091882,Touri; Behrouz,33,0,70,37
1651063697030,ECE 180,A00,083140,Abi Samra; Nicholas Camill,17,0,30,13
1651063697030,ECE 180,B00,083141,Abi Samra; Nicholas Camill,0,0,30,30
1651063703055,MATH 10A,A01,083735,Patchell; Gregory David,0,0,30,30
1651063703055,MATH 10A,A02,083736,Patchell; Gregory David,27,0,30,3
1651063703055,MATH 10A,A03,083737,Patchell; Gregory David,22,0,30,8
1651063709085,MATH 10B,A01,083207,Staff,0,7,30,30
1651063709085,MATH 10B,A02,083208,Staff,0,6,30,30
1651063709085,MATH 10B,B01,083739,Staff,8,0,30,22
1651063709085,MATH 10B,B02,083740,Staff,28,0,30,2
1651063715115,MATH 18,A01,083743,Staff,0,0,30,30
1651063715115,MATH 18,A02,083744,Staff,23,0,30,7
1651063715115,MATH 18,A03,083745,Staff,19,0,30,11
1651063715115,MATH 18,A04,083746,Staff,26,0,30,4
1651063715115,MATH 18,B01,083748,Staff,0,16,30,30
1651063715115,MATH 18,B02,083749,Staff,0,14,30,30
1651063715115,MATH 18,B03,083750,Staff,0,14,30,30
1651063715115,MATH 18,B04,083751,Staff,0,13,30,30
1651063721145,MATH 20A,A01,083754,Staff,18,0,40,22
1651063727169,MATH 20B,A01,083756,Staff,0,14,30,30
1651063727169,MATH 20B,A02,083757,Staff,0,11,30,30
1651063733199,MATH 20C,A01,083760,Staff,0,16,30,30
1651063733199,MATH 20C,A02,083761,Staff,0,15,30,30
1651063733199,MATH 20C,B01,083762,Staff,8,0,30,22
1651063733199,MATH 20C,B02,083763,Staff,28,0,30,2
1651063739226,MATH 20D,A01,083765,Staff,3,1,30,27
1651063739226,MATH 20D,A02,083766,Staff,1,0,30,29
1651063739226,MATH 20D,A03,083767,Staff,22,0,30,8
1651063745252,MATH 20E,A01,083771,Staff,2,0,30,28
1651063745252,MATH 20E,A02,083772,Staff,10,0,30,20
1651063745252,MATH 20E,B01,083773,Staff,0,0,30,30
1651063745252,MATH 20E,B02,083774,Staff,0,0,30,30
1651063751278,MATH 103A,A01,083777,Staff,0,17,30,30
1651063751278,MATH 103A,A02,083778,Staff,0,16,30,30
1651063751278,MATH 103A,B01,083779,Staff,0,15,30,30
1651063751278,MATH 103A,B02,083780,Staff,0,14,30,30
1651063757309,MATH 105,A01,085443,Staff,0,23,30,30
1651063763335,MATH 109,A01,083213,Anzaldo; Leesa B,0,7,30,30
1651063763335,MATH 109,A02,083214,Anzaldo; Leesa B,0,7,30,30
1651063763335,MATH 109,B01,083215,Anzaldo; Leesa B,0,8,30,30
1651063763335,MATH 109,B02,083216,Anzaldo; Leesa B,0,8,30,30
1651063769360,MATH 142A,A01,083219,Chow; Bennett,0,15,30,30
1651063769360,MATH 142A,A02,083220,Chow; Bennett,0,15,30,30
1651063769360,MATH 142A,B01,083221,Chow; Bennett,0,16,30,30
1651063769360,MATH 142A,B02,083222,Chow; Bennett,0,15,30,30
1651063775394,MATH 193A,A01,083224,Staff,0,8,30,30
1651063775394,MATH 193A,A02,083225,Staff,0,7,30,30
1651063775394,MATH 193A,A03,083781,Staff,0,7,30,30
1651063775394,MATH 193A,A04,083782,Staff,0,7,30,30
1651063781424,MATH 197,001,091859,McAuley; Julian John,9998,0,9999,1
1651063787490,COGS 9,A01,083615,Staff,0,20,60,60
1651063793517,COGS 11,A01,083617,Boyle; Mary E. T.,13,0,40,27
1651063799540,COGS 13,A01,083071,Staff,0,40,40,40
1651063805565,COGS 14A,A01,092681,Staff,0,40,100,100
1651063811589,COGS 14B,A01,083073,Cheng; Tzu-Han,0,13,50,50
1651063817615,COGS 17,A01,092677,Staff,9,0,75,66
1651063823640,COGS 100,A01,083619,Staff,0,30,60,60
1651063829670,COGS 101A,A01,083621,Davis; Joshua Daniel,0,29,60,60
1651063835694,COGS 101B,A01,091572,Staff,0,7,60,60
1651063841724,COGS 101C,A01,083625,Delgado; Tania,14,0,30,16
1651063847745,COGS 107A,A01,083627,Boyle; Mary E. T.,0,17,60,60
1651063853774,COGS 118A,A01,083075,Staff,0,10,60,60
1651063859806,CSE 3,A50,083646,Miranda; Gregory Joseph,15,0,38,23
1651063859806,CSE 3,A51,083647,Miranda; Gregory Joseph,36,0,37,1
1651063865829,CSE 8A,A50,083650,Miranda; Gregory Joseph,0,31,40,40
1651063871854,CSE 11,A01,083080,Cao; Yingjun,1,97,40,39
1651063877879,CSE 12,A01,083652,Staff,0,27,100,100
1651063883907,CSE 15L,A01,083654,Staff,0,3,50,50
1651063883907,CSE 15L,A02,083655,Staff,0,3,50,50
1651063889932,CSE 20,A01,083657,Staff,46,0,80,34
1651063895959,CSE 30,A01,083084,Eldon; John,0,38,80,80
1651063901984,CSE 100,A01,083659,Cao; Yingjun,0,72,50,50
1651063908008,CSE 134B,A01,083661,Powell; Thomas Allan,0,38,65,65
1651063914033,CSE 140,A01,083663,Staff,0,15,75,75
1651063920058,CSE 140L,A01,083088,Eldon; John,3,0,100,97
1651063926091,CSE 175,A01,083665,Kumar; Rakesh,0,0,25,25
1651063932121,CSE 190,A00,092507,Dubnov; Shlomo,9,0,20,11
1651063938149,ECE 45,A01,083139,Staff,0,7,60,60
1651063944175,ECE 65,A50,083695,Staff,0,7,30,30
1651063950200,ECE 109,A01,091882,Touri; Behrouz,33,0,70,37
1651063956226,ECE 180,A00,083140,Abi Samra; Nicholas Camill,17,0,30,13
1651063956226,ECE 180,B00,083141,Abi Samra; Nicholas Camill,0,0,30,30
1651063962272,MATH 10A,A01,083735,Patchell; Gregory David,0,0,30,30
1651063962272,MATH 10A,A02,083736,Patchell; Gregory David,27,0,30,3
1651063962272,MATH 10A,A03,083737,Patchell; Gregory David,22,0,30,8
1651063968299,MATH 10B,A01,083207,Staff,0,7,30,30
1651063968299,MATH 10B,A02,083208,Staff,0,6,30,30
1651063968299,MATH 10B,B01,083739,Staff,8,0,30,22
1651063968299,MATH 10B,B02,083740,Staff,28,0,30,2
1651063974325,MATH 18,A01,083743,Staff,0,0,30,30
1651063974325,MATH 18,A02,083744,Staff,23,0,30,7
1651063974325,MATH 18,A03,083745,Staff,19,0,30,11
1651063974325,MATH 18,A04,083746,Staff,26,0,30,4
1651063974325,MATH 18,B01,083748,Staff,0,16,30,30
1651063974325,MATH 18,B02,083749,Staff,0,14,30,30
1651063974325,MATH 18,B03,083750,Staff,0,14,30,30
1651063974325,MATH 18,B04,083751,Staff,0,13,30,30
1651063980354,MATH 20A,A01,083754,Staff,18,0,40,22
1651063986383,MATH 20B,A01,083756,Staff,0,14,30,30
1651063986383,MATH 20B,A02,083757,Staff,0,11,30,30
1651063992406,MATH 20C,A01,083760,Staff,0,16,30,30
1651063992406,MATH 20C,A02,083761,Staff,0,15,30,30
1651063992406,MATH 20C,B01,083762,Staff,8,0,30,22
1651063992406,MATH 20C,B02,083763,Staff,28,0,30,2
1651063998429,MATH 20D,A01,083765,Staff,3,1,30,27
1651063998429,MATH 20D,A02,083766,Staff,1,0,30,29
1651063998429,MATH 20D,A03,083767,Staff,22,0,30,8
1651064004455,MATH 20E,A01,083771,Staff,2,0,30,28
1651064004455,MATH 20E,A02,083772,Staff,10,0,30,20
1651064004455,MATH 20E,B01,083773,Staff,0,0,30,30
1651064004455,MATH 20E,B02,083774,Staff,0,0,30,30
1651064010487,MATH 103A,A01,083777,Staff,0,17,30,30
1651064010487,MATH 103A,A02,083778,Staff,0,16,30,30
1651064010487,MATH 103A,B01,083779,Staff,0,15,30,30
1651064010487,MATH 103A,B02,083780,Staff,0,14,30,30
1651064016512,MATH 105,A01,085443,Staff,0,23,30,30
1651064022536,MATH 109,A01,083213,Anzaldo; Leesa B,0,7,30,30
1651064022536,MATH 109,A02,083214,Anzaldo; Leesa B,0,7,30,30
1651064022536,MATH 109,B01,083215,Anzaldo; Leesa B,0,8,30,30
1651064022536,MATH 109,B02,083216,Anzaldo; Leesa B,0,8,30,30
1651064028564,MATH 142A,A01,083219,Chow; Bennett,0,15,30,30
1651064028564,MATH 142A,A02,083220,Chow; Bennett,0,15,30,30
1651064028564,MATH 142A,B01,083221,Chow; Bennett,0,16,30,30
1651064028564,MATH 142A,B02,083222,Chow; Bennett,0,15,30,30
1651064034591,MATH 193A,A01,083224,Staff,0,8,30,30
1651064034591,MATH 193A,A02,083225,Staff,0,7,30,30
1651064034591,MATH 193A,A03,083781,Staff,0,7,30,30
1651064034591,MATH 193A,A04,083782,Staff,0,7,30,30
1651064040615,MATH 197,001,091859,McAuley; Julian John,9998,0,9999,1
1651064046678,COGS 9,A01,083615,Staff,0,20,60,60
1651064052707,COGS 11,A01,083617,Boyle; Mary E. T.,13,0,40,27
1651064058731,COGS 13,A01,083071,Staff,0,40,40,40
1651064064756,COGS 14A,A01,092681,Staff,0,40,100,100
1651064070784,COGS 14B,A01,083073,Cheng; Tzu-Han,0,13,50,50
1651064076809,COGS 17,A01,092677,Staff,9,0,75,66
1651064082834,COGS 100,A01,083619,Staff,0,30,60,60
1651064088857,COGS 101A,A01,083621,Davis; Joshua Daniel,0,29,60,60
1651064094881,COGS 101B,A01,091572,Staff,0,7,60,60
1651064100915,COGS 101C,A01,083625,Delgado; Tania,14,0,30,16
1651064106948,COGS 107A,A01,083627,Boyle; Mary E. T.,0,17,60,60
1651064112973,COGS 118A,A01,083075,Staff,0,10,60,60
1651064118998,CSE 3,A50,083646,Miranda; Gregory Joseph,15,0,38,23
1651064118998,CSE 3,A51,083647,Miranda; Gregory Joseph,36,0,37,1
1651064125023,CSE 8A,A50,083650,Miranda; Gregory Joseph,0,31,40,40
1651064131051,CSE 11,A01,083080,Cao; Yingjun,1,97,40,39
1651064137078,CSE 12,A01,083652,Staff,0,27,100,100
1651064143102,CSE 15L,A01,083654,Staff,0,3,50,50
1651064143102,CSE 15L,A02,083655,Staff,0,3,50,50
1651064149127,CSE 20,A01,083657,Staff,46,0,80,34
1651064155155,CSE 30,A01,083084,Eldon; John,0,38,80,80
1651064161179,CSE 100,A01,083659,Cao; Yingjun,0,72,50,50
1651064167203,CSE 134B,A01,083661,Powell; Thomas Allan,0,38,65,65
1651064173227,CSE 140,A01,083663,Staff,0,15,75,75
1651064179253,CSE 140L,A01,083088,Eldon; John,3,0,100,97
1651064185277,CSE 175,A01,083665,Kumar; Rakesh,0,0,25,25
1651064191302,CSE 190,A00,092507,Dubnov; Shlomo,9,0,20,11
1651064197421,ECE 45,A01,083139,Staff,0,7,60,60
1651064203446,ECE 65,A50,083695,Staff,0,7,30,30
1651064209468,ECE 109,A01,091882,Touri; Behrouz,33,0,70,37
1651064215496,ECE 180,A00,083140,Abi Samra; Nicholas Camill,17,0,30,13
1651064215496,ECE 180,B00,083141,Abi Samra; Nicholas Camill,0,0,30,30
1651064221521,MATH 10A,A01,083735,Patchell; Gregory David,0,0,30,30
1651064221521,MATH 10A,A02,083736,Patchell; Gregory David,27,0,30,3
1651064221521,MATH 10A,A03,083737,Patchell; Gregory David,22,0,30,8
1651064227545,MATH 10B,A01,083207,Staff,0,7,30,30
1651064227545,MATH 10B,A02,083208,Staff,0,6,30,30
1651064227545,MATH 10B,B01,083739,Staff,8,0,30,22
1651064227545,MATH 10B,B02,083740,Staff,28,0,30,2
1651064233574,MATH 18,A01,083743,Staff,0,0,30,30
1651064233574,MATH 18,A02,083744,Staff,23,0,30,7
1651064233574,MATH 18,A03,083745,Staff,19,0,30,11
1651064233574,MATH 18,A04,083746,Staff,26,0,30,4
1651064233574,MATH 18,B01,083748,Staff,0,16,30,30
1651064233574,MATH 18,B02,083749,Staff,0,14,30,30
1651064233574,MATH 18,B03,083750,Staff,0,14,30,30
1651064233574,MATH 18,B04,083751,Staff,0,13,30,30
1651064239602,MATH 20A,A01,083754,Staff,18,0,40,22
1651064245625,MATH 20B,A01,083756,Staff,0,14,30,30
1651064245625,MATH 20B,A02,083757,Staff,0,11,30,30
1651064251650,MATH 20C,A01,083760,Staff,0,16,30,30
1651064251650,MATH 20C,A02,083761,Staff,0,15,30,30
1651064251650,MATH 20C,B01,083762,Staff,8,0,30,22
1651064251650,MATH 20C,B02,083763,Staff,28,0,30,2
1651064257677,MATH 20D,A01,083765,Staff,3,1,30,27
1651064257677,MATH 20D,A02,083766,Staff,1,0,30,29
1651064257677,MATH 20D,A03,083767,Staff,22,0,30,8
1651064263703,MATH 20E,A01,083771,Staff,2,0,30,28
1651064263703,MATH 20E,A02,083772,Staff,10,0,30,20
1651064263703,MATH 20E,B01,083773,Staff,0,0,30,30
1651064263703,MATH 20E,B02,083774,Staff,0,0,30,30
1651064269731,MATH 103A,A01,083777,Staff,0,17,30,30
1651064269731,MATH 103A,A02,083778,Staff,0,16,30,30
1651064269731,MATH 103A,B01,083779,Staff,0,15,30,30
1651064269731,MATH 103A,B02,083780,Staff,0,14,30,30
1651064275758,MATH 105,A01,085443,Staff,0,23,30,30
1651064281789,MATH 109,A01,083213,Anzaldo; Leesa B,0,7,30,30
1651064281789,MATH 109,A02,083214,Anzaldo; Leesa B,0,7,30,30
1651064281789,MATH 109,B01,083215,Anzaldo; Leesa B,0,8,30,30
1651064281789,MATH 109,B02,083216,Anzaldo; Leesa B,0,8,30,30
1651064287815,MATH 142A,A01,083219,Chow; Bennett,0,15,30,30
1651064287815,MATH 142A,A02,083220,Chow; Bennett,0,15,30,30
1651064287815,MATH 142A,B01,083221,Chow; Bennett,0,16,30,30
1651064287815,MATH 142A,B02,083222,Chow; Bennett,0,15,30,30
1651064293838,MATH 193A,A01,083224,Staff,0,8,30,30
1651064293838,MATH 193A,A02,083225,Staff,0,7,30,30
1651064293838,MATH 193A,A03,083781,Staff,0,7,30,30
1651064293838,MATH 193A,A04,083782,Staff,0,7,30,30
1651064299862,MATH 197,001,091859,McAuley; Julian John,9998,0,9999,1
1651064305926,COGS 9,A01,083615,Staff,0,20,60,60
1651064311953,COGS 11,A01,083617,Boyle; Mary E. T.,13,0,40,27
1651064317976,COGS 13,A01,083071,Staff,0,40,40,40
1651064324001,COGS 14A,A01,092681,Staff,0,40,100,100
1651064330027,COGS 14B,A01,083073,Cheng; Tzu-Han,0,13,50,50
1651064336053,COGS 17,A01,092677,Staff,9,0,75,66
1651064342077,COGS 100,A01,083619,Staff,0,30,60,60
1651064348121,COGS 101A,A01,083621,Davis; Joshua Daniel,0,29,60,60
1651064354152,COGS 101B,A01,091572,Staff,0,7,60,60
1651064360176,COGS 101C,A01,083625,Delgado; Tania,14,0,30,16
1651064366207,COGS 107A,A01,083627,Boyle; Mary E. T.,0,17,60,60
1651064372236,COGS 118A,A01,083075,Staff,0,10,60,60
1651064378263,CSE 3,A50,083646,Miranda; Gregory Joseph,15,0,38,23
1651064378263,CSE 3,A51,083647,Miranda; Gregory Joseph,36,0,37,1
1651064384296,CSE 8A,A50,083650,Miranda; Gregory Joseph,0,31,40,40
1651064390323,CSE 11,A01,083080,Cao; Yingjun,1,97,40,39
1651064396345,CSE 12,A01,083652,Staff,0,27,100,100
1651064402370,CSE 15L,A01,083654,Staff,0,3,50,50
1651064402370,CSE 15L,A02,083655,Staff,0,3,50,50
1651064408397,CSE 20,A01,083657,Staff,46,0,80,34
1651064414430,CSE 30,A01,083084,Eldon; John,0,38,80,80
1651064420455,CSE 100,A01,083659,Cao; Yingjun,0,72,50,50
1651064426483,CSE 134B,A01,083661,Powell; Thomas Allan,0,38,65,65
1651064432508,CSE 140,A01,083663,Staff,0,15,75,75
1651064438542,CSE 140L,A01,083088,Eldon; John,3,0,100,97
1651064444566,CSE 175,A01,083665,Kumar; Rakesh,0,0,25,25
1651064450593,CSE 190,A00,092507,Dubnov; Shlomo,9,0,20,11
1651064456619,ECE 45,A01,083139,Staff,0,7,60,60
1651064462648,ECE 65,A50,083695,Staff,0,7,30,30
1651064468678,ECE 109,A01,091882,Touri; Behrouz,33,0,70,37
1651064474705,ECE 180,A00,083140,Abi Samra; Nicholas Camill,17,0,30,13
1651064474705,ECE 180,B00,083141,Abi Samra; Nicholas Camill,0,0,30,30
1651064480732,MATH 10A,A01,083735,Patchell; Gregory David,0,0,30,30
1651064480732,MATH 10A,A02,083736,Patchell; Gregory David,27,0,30,3
1651064480732,MATH 10A,A03,083737,Patchell; Gregory David,22,0,30,8
1651064486758,MATH 10B,A01,083207,Staff,0,7,30,30
1651064486758,MATH 10B,A02,083208,Staff,0,6,30,30
1651064486758,MATH 10B,B01,083739,Staff,8,0,30,22
1651064486758,MATH 10B,B02,083740,Staff,28,0,30,2
1651064492786,MATH 18,A01,083743,Staff,0,0,30,30
1651064492786,MATH 18,A02,083744,Staff,23,0,30,7
1651064492786,MATH 18,A03,083745,Staff,19,0,30,11
1651064492786,MATH 18,A04,083746,Staff,26,0,30,4
1651064492786,MATH 18,B01,083748,Staff,0,16,30,30
1651064492786,MATH 18,B02,083749,Staff,0,14,30,30
1651064492786,MATH 18,B03,083750,Staff,0,14,30,30
1651064492786,MATH 18,B04,083751,Staff,0,13,30,30
1651064498811,MATH 20A,A01,083754,Staff,18,0,40,22
1651064504841,MATH 20B,A01,083756,Staff,0,14,30,30
1651064504841,MATH 20B,A02,083757,Staff,0,11,30,30
1651064510870,MATH 20C,A01,083760,Staff,0,16,30,30
1651064510870,MATH 20C,A02,083761,Staff,0,15,30,30
1651064510870,MATH 20C,B01,083762,Staff,8,0,30,22
1651064510870,MATH 20C,B02,083763,Staff,28,0,30,2
1651064516893,MATH 20D,A01,083765,Staff,3,1,30,27
1651064516893,MATH 20D,A02,083766,Staff,1,0,30,29
1651064516893,MATH 20D,A03,083767,Staff,22,0,30,8
1651064522922,MATH 20E,A01,083771,Staff,2,0,30,28
1651064522922,MATH 20E,A02,083772,Staff,10,0,30,20
1651064522922,MATH 20E,B01,083773,Staff,0,0,30,30
1651064522922,MATH 20E,B02,083774,Staff,0,0,30,30
1651064528950,MATH 103A,A01,083777,Staff,0,17,30,30
1651064528950,MATH 103A,A02,083778,Staff,0,16,30,30
1651064528950,MATH 103A,B01,083779,Staff,0,15,30,30
1651064528950,MATH 103A,B02,083780,Staff,0,14,30,30
1651064534985,MATH 105,A01,085443,Staff,0,23,30,30
1651064541012,MATH 109,A01,083213,Anzaldo; Leesa B,0,7,30,30
1651064541012,MATH 109,A02,083214,Anzaldo; Leesa B,0,7,30,30
1651064541012,MATH 109,B01,083215,Anzaldo; Leesa B,0,8,30,30
1651064541012,MATH 109,B02,083216,Anzaldo; Leesa B,0,8,30,30
1651064547041,MATH 142A,A01,083219,Chow; Bennett,0,15,30,30
1651064547041,MATH 142A,A02,083220,Chow; Bennett,0,15,30,30
1651064547041,MATH 142A,B01,083221,Chow; Bennett,0,16,30,30
1651064547041,MATH 142A,B02,083222,Chow; Bennett,0,15,30,30
1651064553073,MATH 193A,A01,083224,Staff,0,8,30,30
1651064553073,MATH 193A,A02,083225,Staff,0,7,30,30
1651064553073,MATH 193A,A03,083781,Staff,0,7,30,30
1651064553073,MATH 193A,A04,083782,Staff,0,7,30,30
1651064559098,MATH 197,001,091859,McAuley; Julian John,9998,0,9999,1
1651064565151,COGS 9,A01,083615,Staff,0,20,60,60
1651064571176,COGS 11,A01,083617,Boyle; Mary E. T.,13,0,40,27
1651064577202,COGS 13,A01,083071,Staff,0,40,40,40
1651064583230,COGS 14A,A01,092681,Staff,0,40,100,100
1651064589256,COGS 14B,A01,083073,Cheng; Tzu-Han,0,13,50,50
1651064595280,COGS 17,A01,092677,Staff,9,0,75,66
1651064601305,COGS 100,A01,083619,Staff,0,30,60,60
1651064607332,COGS 101A,A01,083621,Davis; Joshua Daniel,0,29,60,60
1651064613356,COGS 101B,A01,091572,Staff,0,7,60,60
1651064619382,COGS 101C,A01,083625,Delgado; Tania,14,0,30,16
1651064625411,COGS 107A,A01,083627,Boyle; Mary E. T.,0,17,60,60
1651064631438,COGS 118A,A01,083075,Staff,0,10,60,60
1651064637471,CSE 3,A50,083646,Miranda; Gregory Joseph,15,0,38,23
1651064637471,CSE 3,A51,083647,Miranda; Gregory Joseph,36,0,37,1
1651064643495,CSE 8A,A50,083650,Miranda; Gregory Joseph,0,31,40,40
1651064649519,CSE 11,A01,083080,Cao; Yingjun,1,97,40,39
1651064655545,CSE 12,A01,083652,Staff,0,27,100,100
1651064661572,CSE 15L,A01,083654,Staff,0,3,50,50
1651064661572,CSE 15L,A02,083655,Staff,0,3,50,50
1651064667595,CSE 20,A01,083657,Staff,46,0,80,34
1651064673631,CSE 30,A01,083084,Eldon; John,0,38,80,80
1651064679662,CSE 100,A01,083659,Cao; Yingjun,0,72,50,50
1651064685687,CSE 134B,A01,083661,Powell; Thomas Allan,0,38,65,65
1651064691713,CSE 140,A01,083663,Staff,0,15,75,75
1651064697739,CSE 140L,A01,083088,Eldon; John,3,0,100,97
1651064703765,CSE 175,A01,083665,Kumar; Rakesh,0,0,25,25
1651064709790,CSE 190,A00,092507,Dubnov; Shlomo,9,0,20,11
1651064715824,ECE 45,A01,083139,Staff,0,7,60,60
1651064721859,ECE 65,A50,083695,Staff,0,7,30,30
1651064727884,ECE 109,A01,091882,Touri; Behrouz,33,0,70,37
1651064733915,ECE 180,A00,083140,Abi Samra; Nicholas Camill,17,0,30,13
1651064733915,ECE 180,B00,083141,Abi Samra; Nicholas Camill,0,0,30,30
1651064739953,MATH 10A,A01,083735,Patchell; Gregory David,0,0,30,30
1651064739953,MATH 10A,A02,083736,Patchell; Gregory David,27,0,30,3
1651064739953,MATH 10A,A03,083737,Patchell; Gregory David,22,0,30,8
1651064745979,MATH 10B,A01,083207,Staff,0,7,30,30
1651064745979,MATH 10B,A02,083208,Staff,0,6,30,30
1651064745979,MATH 10B,B01,083739,Staff,8,0,30,22
1651064745979,MATH 10B,B02,083740,Staff,28,0,30,2
1651064752009,MATH 18,A01,083743,Staff,0,0,30,30
1651064752009,MATH 18,A02,083744,Staff,23,0,30,7
1651064752009,MATH 18,A03,083745,Staff,19,0,30,11
1651064752009,MATH 18,A04,083746,Staff,26,0,30,4
1651064752009,MATH 18,B01,083748,Staff,0,16,30,30
1651064752009,MATH 18,B02,083749,Staff,0,14,30,30
1651064752009,MATH 18,B03,083750,Staff,0,14,30,30
1651064752009,MATH 18,B04,083751,Staff,0,13,30,30
1651064758035,MATH 20A,A01,083754,Staff,18,0,40,22
1651064764063,MATH 20B,A01,083756,Staff,0,14,30,30
1651064764063,MATH 20B,A02,083757,Staff,0,11,30,30
1651064770089,MATH 20C,A01,083760,Staff,0,16,30,30
1651064770089,MATH 20C,A02,083761,Staff,0,15,30,30
1651064770089,MATH 20C,B01,083762,Staff,8,0,30,22
1651064770089,MATH 20C,B02,083763,Staff,28,0,30,2
1651064776115,MATH 20D,A01,083765,Staff,3,1,30,27
1651064776115,MATH 20D,A02,083766,Staff,1,0,30,29
1651064776115,MATH 20D,A03,083767,Staff,22,0,30,8
1651064782146,MATH 20E,A01,083771,Staff,2,0,30,28
1651064782146,MATH 20E,A02,083772,Staff,10,0,30,20
1651064782146,MATH 20E,B01,083773,Staff,0,0,30,30
1651064782146,MATH 20E,B02,083774,Staff,0,0,30,30
1651064788170,MATH 103A,A01,083777,Staff,0,17,30,30
1651064788170,MATH 103A,A02,083778,Staff,0,16,30,30
1651064788170,MATH 103A,B01,083779,Staff,0,15,30,30
1651064788170,MATH 103A,B02,083780,Staff,0,14,30,30
1651064794293,MATH 105,A01,085443,Staff,0,23,30,30
1651064800320,MATH 109,A01,083213,Anzaldo; Leesa B,0,7,30,30
1651064800320,MATH 109,A02,083214,Anzaldo; Leesa B,0,7,30,30
1651064800320,MATH 109,B01,083215,Anzaldo; Leesa B,0,8,30,30
1651064800320,MATH 109,B02,083216,Anzaldo; Leesa B,0,8,30,30
1651064806351,MATH 142A,A01,083219,Chow; Bennett,0,15,30,30
1651064806351,MATH 142A,A02,083220,Chow; Bennett,0,15,30,30
1651064806351,MATH 142A,B01,083221,Chow; Bennett,0,16,30,30
1651064806351,MATH 142A,B02,083222,Chow; Bennett,0,15,30,30
1651064812380,MATH 193A,A01,083224,Staff,0,8,30,30
1651064812380,MATH 193A,A02,083225,Staff,0,7,30,30
1651064812380,MATH 193A,A03,083781,Staff,0,7,30,30
1651064812380,MATH 193A,A04,083782,Staff,0,7,30,30
1651064818408,MATH 197,001,091859,McAuley; Julian John,9998,0,9999,1
1651064824481,COGS 9,A01,083615,Staff,0,20,60,60
1651064830505,COGS 11,A01,083617,Boyle; Mary E. T.,13,0,40,27
1651064836530,COGS 13,A01,083071,Staff,0,40,40,40
1651064842559,COGS 14A,A01,092681,Staff,0,40,100,100
1651064848585,COGS 14B,A01,083073,Cheng; Tzu-Han,0,13,50,50
1651064854607,COGS 17,A01,092677,Staff,9,0,75,66
1651064860636,COGS 100,A01,083619,Staff,0,30,60,60
1651064866663,COGS 101A,A01,083621,Davis; Joshua Daniel,0,29,60,60
1651064872691,COGS 101B,A01,091572,Staff,0,7,60,60
1651064878714,COGS 101C,A01,083625,Delgado; Tania,14,0,30,16
1651064884739,COGS 107A,A01,083627,Boyle; Mary E. T.,0,17,60,60
1651064890767,COGS 118A,A01,083075,Staff,0,10,60,60
1651064896792,CSE 3,A50,083646,Miranda; Gregory Joseph,15,0,38,23
1651064896792,CSE 3,A51,083647,Miranda; Gregory Joseph,36,0,37,1
1651064902821,CSE 8A,A50,083650,Miranda; Gregory Joseph,0,31,40,40
1651064908849,CSE 11,A01,083080,Cao; Yingjun,1,97,40,39
1651064914877,CSE 12,A01,083652,Staff,0,27,100,100
1651064920905,CSE 15L,A01,083654,Staff,0,3,50,50
1651064920905,CSE 15L,A02,083655,Staff,0,3,50,50
1651064926929,CSE 20,A01,083657,Staff,46,0,80,34
1651064932964,CSE 30,A01,083084,Eldon; John,0,38,80,80
1651064938988,CSE 100,A01,083659,Cao; Yingjun,0,72,50,50
1651064945014,CSE 134B,A01,083661,Powell; Thomas Allan,0,38,65,65
1651064951047,CSE 140,A01,083663,Staff,0,15,75,75
1651064957073,CSE 140L,A01,083088,Eldon; John,3,0,100,97
1651064963100,CSE 175,A01,083665,Kumar; Rakesh,0,0,25,25
1651064969130,CSE 190,A00,092507,Dubnov; Shlomo,9,0,20,11
1651064975160,ECE 45,A01,083139,Staff,0,7,60,60
1651064981195,ECE 65,A50,083695,Staff,0,7,30,30
1651064987226,ECE 109,A01,091882,Touri; Behrouz,33,0,70,37
1651064993249,ECE 180,A00,083140,Abi Samra; Nicholas Camill,17,0,30,13
1651064993249,ECE 180,B00,083141,Abi Samra; Nicholas Camill,0,0,30,30
1651064999279,MATH 10A,A01,083735,Patchell; Gregory David,0,0,30,30
1651064999279,MATH 10A,A02,083736,Patchell; Gregory David,27,0,30,3
1651064999279,MATH 10A,A03,083737,Patchell; Gregory David,22,0,30,8
1651065005303,MATH 10B,A01,083207,Staff,0,7,30,30
1651065005303,MATH 10B,A02,083208,Staff,0,6,30,30
1651065005303,MATH 10B,B01,083739,Staff,8,0,30,22
1651065005303,MATH 10B,B02,083740,Staff,28,0,30,2
1651065011330,MATH 18,A01,083743,Staff,0,0,30,30
1651065011330,MATH 18,A02,083744,Staff,23,0,30,7
1651065011330,MATH 18,A03,083745,Staff,19,0,30,11
1651065011330,MATH 18,A04,083746,Staff,26,0,30,4
1651065011330,MATH 18,B01,083748,Staff,0,16,30,30
1651065011330,MATH 18,B02,083749,Staff,0,14,30,30
1651065011330,MATH 18,B03,083750,Staff,0,14,30,30
1651065011330,MATH 18,B04,083751,Staff,0,13,30,30
1651065017356,MATH 20A,A01,083754,Staff,18,0,40,22
1651065023381,MATH 20B,A01,083756,Staff,0,14,30,30
1651065023381,MATH 20B,A02,083757,Staff,0,11,30,30
1651065029405,MATH 20C,A01,083760,Staff,0,16,30,30
1651065029405,MATH 20C,A02,083761,Staff,0,15,30,30
1651065029405,MATH 20C,B01,083762,Staff,8,0,30,22
1651065029405,MATH 20C,B02,083763,Staff,28,0,30,2
1651065035433,MATH 20D,A01,083765,Staff,3,1,30,27
1651065035433,MATH 20D,A02,083766,Staff,1,0,30,29
1651065035433,MATH 20D,A03,083767,Staff,22,0,30,8
1651065041457,MATH 20E,A01,083771,Staff,2,0,30,28
1651065041457,MATH 20E,A02,083772,Staff,10,0,30,20
1651065041457,MATH 20E,B01,083773,Staff,0,0,30,30
1651065041457,MATH 20E,B02,083774,Staff,0,0,30,30
1651065047493,MATH 103A,A01,083777,Staff,0,17,30,30
1651065047493,MATH 103A,A02,083778,Staff,0,16,30,30
1651065047493,MATH 103A,B01,083779,Staff,0,15,30,30
1651065047493,MATH 103A,B02,083780,Staff,0,14,30,30
1651065053517,MATH 105,A01,085443,Staff,0,23,30,30
1651065059543,MATH 109,A01,083213,Anzaldo; Leesa B,0,7,30,30
1651065059543,MATH 109,A02,083214,Anzaldo; Leesa B,0,7,30,30
1651065059543,MATH 109,B01,083215,Anzaldo; Leesa B,0,8,30,30
1651065059543,MATH 109,B02,083216,Anzaldo; Leesa B,0,8,30,30
1651065065568,MATH 142A,A01,083219,Chow; Bennett,0,15,30,30
1651065065568,MATH 142A,A02,083220,Chow; Bennett,0,15,30,30
1651065065568,MATH 142A,B01,083221,Chow; Bennett,0,16,30,30
1651065065568,MATH 142A,B02,083222,Chow; Bennett,0,15,30,30
1651065071592,MATH 193A,A01,083224,Staff,0,8,30,30
1651065071592,MATH 193A,A02,083225,Staff,0,7,30,30
1651065071592,MATH 193A,A03,083781,Staff,0,7,30,30
1651065071592,MATH 193A,A04,083782,Staff,0,7,30,30
1651065077619,MATH 197,001,091859,McAuley; Julian John,9998,0,9999,1
1651065083699,COGS 9,A01,083615,Staff,0,20,60,60
1651065089722,COGS 11,A01,083617,Boyle; Mary E. T.,13,0,40,27
1651065095746,COGS 13,A01,083071,Staff,0,40,40,40
1651065101772,COGS 14A,A01,092681,Staff,0,40,100,100
1651065107807,COGS 14B,A01,083073,Cheng; Tzu-Han,0,13,50,50
1651065113836,COGS 17,A01,092677,Staff,9,0,75,66
1651065119865,COGS 100,A01,083619,Staff,0,30,60,60
1651065125908,COGS 101A,A01,083621,Davis; Joshua Daniel,0,29,60,60
1651065131933,COGS 101B,A01,091572,Staff,0,7,60,60
1651065137959,COGS 101C,A01,083625,Delgado; Tania,14,0,30,16
1651065143984,COGS 107A,A01,083627,Boyle; Mary E. T.,0,17,60,60
1651065150008,COGS 118A,A01,083075,Staff,0,10,60,60
1651065156037,CSE 3,A50,083646,Miranda; Gregory Joseph,15,0,38,23
1651065156037,CSE 3,A51,083647,Miranda; Gregory Joseph,36,0,37,1
1651065162064,CSE 8A,A50,083650,Miranda; Gregory Joseph,0,31,40,40
1651065168087,CSE 11,A01,083080,Cao; Yingjun,1,97,40,39
1651065174116,CSE 12,A01,083652,Staff,0,27,100,100
1651065180142,CSE 15L,A01,083654,Staff,0,3,50,50
1651065180142,CSE 15L,A02,083655,Staff,0,3,50,50
1651065186166,CSE 20,A01,083657,Staff,46,0,80,34
1651065192197,CSE 30,A01,083084,Eldon; John,0,38,80,80
1651065198223,CSE 100,A01,083659,Cao; Yingjun,0,72,50,50
1651065204248,CSE 134B,A01,083661,Powell; Thomas Allan,0,38,65,65
1651065210272,CSE 140,A01,083663,Staff,0,15,75,75
1651065216297,CSE 140L,A01,083088,Eldon; John,3,0,100,97
1651065222321,CSE 175,A01,083665,Kumar; Rakesh,0,0,25,25
1651065228346,CSE 190,A00,092507,Dubnov; Shlomo,9,0,20,11
1651065234374,ECE 45,A01,083139,Staff,0,7,60,60
1651065240406,ECE 65,A50,083695,Staff,0,7,30,30
1651065246443,ECE 109,A01,091882,Touri; Behrouz,33,0,70,37
1651065252472,ECE 180,A00,083140,Abi Samra; Nicholas Camill,17,0,30,13
1651065252472,ECE 180,B00,083141,Abi Samra; Nicholas Camill,0,0,30,30
1651065258498,MATH 10A,A01,083735,Patchell; Gregory David,0,0,30,30
1651065258498,MATH 10A,A02,083736,Patchell; Gregory David,27,0,30,3
1651065258498,MATH 10A,A03,083737,Patchell; Gregory David,22,0,30,8
1651065264522,MATH 10B,A01,083207,Staff,0,7,30,30
1651065264522,MATH 10B,A02,083208,Staff,0,6,30,30
1651065264522,MATH 10B,B01,083739,Staff,8,0,30,22
1651065264522,MATH 10B,B02,083740,Staff,28,0,30,2
1651065270548,MATH 18,A01,083743,Staff,0,0,30,30
1651065270548,MATH 18,A02,083744,Staff,23,0,30,7
1651065270548,MATH 18,A03,083745,Staff,19,0,30,11
1651065270548,MATH 18,A04,083746,Staff,26,0,30,4
1651065270548,MATH 18,B01,083748,Staff,0,16,30,30
1651065270548,MATH 18,B02,083749,Staff,0,14,30,30
1651065270548,MATH 18,B03,083750,Staff,0,14,30,30
1651065270548,MATH 18,B04,083751,Staff,0,13,30,30
1651065276574,MATH 20A,A01,083754,Staff,18,0,40,22
1651065282602,MATH 20B,A01,083756,Staff,0,14,30,30
1651065282602,MATH 20B,A02,083757,Staff,0,11,30,30
1651065288628,MATH 20C,A01,083760,Staff,0,16,30,30
1651065288628,MATH 20C,A02,083761,Staff,0,15,30,30
1651065288628,MATH 20C,B01,083762,Staff,8,0,30,22
1651065288628,MATH 20C,B02,083763,Staff,28,0,30,2
1651065294655,MATH 20D,A01,083765,Staff,3,1,30,27
1651065294655,MATH 20D,A02,083766,Staff,1,0,30,29
1651065294655,MATH 20D,A03,083767,Staff,22,0,30,8
1651065300679,MATH 20E,A01,083771,Staff,2,0,30,28
1651065300679,MATH 20E,A02,083772,Staff,10,0,30,20
1651065300679,MATH 20E,B01,083773,Staff,0,0,30,30
1651065300679,MATH 20E,B02,083774,Staff,0,0,30,30
1651065306707,MATH 103A,A01,083777,Staff,0,17,30,30
1651065306707,MATH 103A,A02,083778,Staff,0,16,30,30
1651065306707,MATH 103A,B01,083779,Staff,0,15,30,30
1651065306707,MATH 103A,B02,083780,Staff,0,14,30,30
1651065312730,MATH 105,A01,085443,Staff,0,23,30,30
1651065318755,MATH 109,A01,083213,Anzaldo; Leesa B,0,7,30,30
1651065318755,MATH 109,A02,083214,Anzaldo; Leesa B,0,7,30,30
1651065318755,MATH 109,B01,083215,Anzaldo; Leesa B,0,8,30,30
1651065318755,MATH 109,B02,083216,Anzaldo; Leesa B,0,8,30,30
1651065324781,MATH 142A,A01,083219,Chow; Bennett,0,15,30,30
1651065324781,MATH 142A,A02,083220,Chow; Bennett,0,15,30,30
1651065324781,MATH 142A,B01,083221,Chow; Bennett,0,16,30,30
1651065324781,MATH 142A,B02,083222,Chow; Bennett,0,15,30,30
1651065330811,MATH 193A,A01,083224,Staff,0,8,30,30
1651065330811,MATH 193A,A02,083225,Staff,0,7,30,30
1651065330811,MATH 193A,A03,083781,Staff,0,7,30,30
1651065330811,MATH 193A,A04,083782,Staff,0,7,30,30
1651065336835,MATH 197,001,091859,McAuley; Julian John,9998,0,9999,1
1651065342904,COGS 9,A01,083615,Staff,0,20,60,60
1651065348928,COGS 11,A01,083617,Boyle; Mary E. T.,13,0,40,27
1651065354963,COGS 13,A01,083071,Staff,0,40,40,40
1651065360988,COGS 14A,A01,092681,Staff,0,40,100,100
1651065367016,COGS 14B,A01,083073,Cheng; Tzu-Han,0,13,50,50
1651065373042,COGS 17,A01,092677,Staff,9,0,75,66
1651065379068,COGS 100,A01,083619,Staff,0,30,60,60
1651065385169,COGS 101A,A01,083621,Davis; Joshua Daniel,0,29,60,60
1651065391195,COGS 101B,A01,091572,Staff,0,7,60,60
1651065397218,COGS 101C,A01,083625,Delgado; Tania,14,0,30,16
1651065403246,COGS 107A,A01,083627,Boyle; Mary E. T.,0,17,60,60
1651065409270,COGS 118A,A01,083075,Staff,0,10,60,60
1651065415300,CSE 3,A50,083646,Miranda; Gregory Joseph,15,0,38,23
1651065415300,CSE 3,A51,083647,Miranda; Gregory Joseph,36,0,37,1
1651065421333,CSE 8A,A50,083650,Miranda; Gregory Joseph,0,31,40,40
1651065427361,CSE 11,A01,083080,Cao; Yingjun,1,97,40,39
1651065433389,CSE 12,A01,083652,Staff,0,27,100,100
1651065439412,CSE 15L,A01,083654,Staff,0,3,50,50
1651065439412,CSE 15L,A02,083655,Staff,0,3,50,50
1651065445437,CSE 20,A01,083657,Staff,46,0,80,34
1651065451463,CSE 30,A01,083084,Eldon; John,0,38,80,80
1651065457486,CSE 100,A01,083659,Cao; Yingjun,0,72,50,50
1651065463515,CSE 134B,A01,083661,Powell; Thomas Allan,0,38,65,65
1651065469539,CSE 140,A01,083663,Staff,0,15,75,75
1651065475568,CSE 140L,A01,083088,Eldon; John,3,0,100,97
1651065481596,CSE 175,A01,083665,Kumar; Rakesh,0,0,25,25
1651065487628,CSE 190,A00,092507,Dubnov; Shlomo,9,0,20,11
1651065493652,ECE 45,A01,083139,Staff,0,7,60,60
1651065499678,ECE 65,A50,083695,Staff,0,7,30,30
1651065505702,ECE 109,A01,091882,Touri; Behrouz,33,0,70,37
1651065511726,ECE 180,A00,083140,Abi Samra; Nicholas Camill,17,0,30,13
1651065511726,ECE 180,B00,083141,Abi Samra; Nicholas Camill,0,0,30,30
1651065517751,MATH 10A,A01,083735,Patchell; Gregory David,0,0,30,30
1651065517751,MATH 10A,A02,083736,Patchell; Gregory David,27,0,30,3
1651065517751,MATH 10A,A03,083737,Patchell; Gregory David,22,0,30,8
1651065523777,MATH 10B,A01,083207,Staff,0,7,30,30
1651065523777,MATH 10B,A02,083208,Staff,0,6,30,30
1651065523777,MATH 10B,B01,083739,Staff,8,0,30,22
1651065523777,MATH 10B,B02,083740,Staff,28,0,30,2
1651065529810,MATH 18,A01,083743,Staff,0,0,30,30
1651065529810,MATH 18,A02,083744,Staff,23,0,30,7
1651065529810,MATH 18,A03,083745,Staff,19,0,30,11
1651065529810,MATH 18,A04,083746,Staff,26,0,30,4
1651065529810,MATH 18,B01,083748,Staff,0,16,30,30
1651065529810,MATH 18,B02,083749,Staff,0,14,30,30
1651065529810,MATH 18,B03,083750,Staff,0,14,30,30
1651065529810,MATH 18,B04,083751,Staff,0,13,30,30
1651065535836,MATH 20A,A01,083754,Staff,18,0,40,22
1651065541861,MATH 20B,A01,083756,Staff,0,14,30,30
1651065541861,MATH 20B,A02,083757,Staff,0,11,30,30
1651065547891,MATH 20C,A01,083760,Staff,0,16,30,30
1651065547891,MATH 20C,A02,083761,Staff,0,15,30,30
1651065547891,MATH 20C,B01,083762,Staff,8,0,30,22
1651065547891,MATH 20C,B02,083763,Staff,28,0,30,2
1651065553917,MATH 20D,A01,083765,Staff,3,1,30,27
1651065553917,MATH 20D,A02,083766,Staff,1,0,30,29
1651065553917,MATH 20D,A03,083767,Staff,22,0,30,8
1651065559942,MATH 20E,A01,083771,Staff,2,0,30,28
1651065559942,MATH 20E,A02,083772,Staff,10,0,30,20
1651065559942,MATH 20E,B01,083773,Staff,0,0,30,30
1651065559942,MATH 20E,B02,083774,Staff,0,0,30,30
1651065565967,MATH 103A,A01,083777,Staff,0,17,30,30
1651065565967,MATH 103A,A02,083778,Staff,0,16,30,30
1651065565967,MATH 103A,B01,083779,Staff,0,15,30,30
1651065565967,MATH 103A,B02,083780,Staff,0,14,30,30
1651065571997,MATH 105,A01,085443,Staff,0,23,30,30
1651065578026,MATH 109,A01,083213,Anzaldo; Leesa B,0,7,30,30
1651065578026,MATH 109,A02,083214,Anzaldo; Leesa B,0,7,30,30
1651065578026,MATH 109,B01,083215,Anzaldo; Leesa B,0,8,30,30
1651065578026,MATH 109,B02,083216,Anzaldo; Leesa B,0,8,30,30
1651065584054,MATH 142A,A01,083219,Chow; Bennett,0,15,30,30
1651065584054,MATH 142A,A02,083220,Chow; Bennett,0,15,30,30
1651065584054,MATH 142A,B01,083221,Chow; Bennett,0,16,30,30
1651065584054,MATH 142A,B02,083222,Chow; Bennett,0,15,30,30
1651065590080,MATH 193A,A01,083224,Staff,0,8,30,30
1651065590080,MATH 193A,A02,083225,Staff,0,7,30,30
1651065590080,MATH 193A,A03,083781,Staff,0,7,30,30
1651065590080,MATH 193A,A04,083782,Staff,0,7,30,30
1651065596103,MATH 197,001,091859,McAuley; Julian John,9998,0,9999,1
1651065602156,COGS 9,A01,083615,Staff,0,20,60,60
1651065608191,COGS 11,A01,083617,Boyle; Mary E. T.,13,0,40,27
1651065614215,COGS 13,A01,083071,Staff,0,40,40,40
1651065620239,COGS 14A,A01,092681,Staff,0,40,100,100
1651065626267,COGS 14B,A01,083073,Cheng; Tzu-Han,0,13,50,50
1651065632289,COGS 17,A01,092677,Staff,9,0,75,66
1651065638312,COGS 100,A01,083619,Staff,0,30,60,60
1651065644336,COGS 101A,A01,083621,Davis; Joshua Daniel,0,29,60,60
1651065650363,COGS 101B,A01,091572,Staff,0,7,60,60
1651065656387,COGS 101C,A01,083625,Delgado; Tania,14,0,30,16
1651065662415,COGS 107A,A01,083627,Boyle; Mary E. T.,0,17,60,60
1651065668439,COGS 118A,A01,083075,Staff,0,10,60,60
1651065674463,CSE 3,A50,083646,Miranda; Gregory Joseph,15,0,38,23
1651065674463,CSE 3,A51,083647,Miranda; Gregory Joseph,36,0,37,1
1651065680515,CSE 8A,A50,083650,Miranda; Gregory Joseph,0,31,40,40
1651065686538,CSE 11,A01,083080,Cao; Yingjun,1,97,40,39
1651065692564,CSE 12,A01,083652,Staff,0,27,100,100
1651065698587,CSE 15L,A01,083654,Staff,0,3,50,50
1651065698587,CSE 15L,A02,083655,Staff,0,3,50,50
1651065704610,CSE 20,A01,083657,Staff,46,0,80,34
1651065710634,CSE 30,A01,083084,Eldon; John,0,38,80,80
1651065716658,CSE 100,A01,083659,Cao; Yingjun,0,72,50,50
1651065722683,CSE 134B,A01,083661,Powell; Thomas Allan,0,38,65,65
1651065728711,CSE 140,A01,083663,Staff,0,15,75,75
1651065734737,CSE 140L,A01,083088,Eldon; John,3,0,100,97
1651065740770,CSE 175,A01,083665,Kumar; Rakesh,0,0,25,25
1651065746795,CSE 190,A00,092507,Dubnov; Shlomo,9,0,20,11
1651065752819,ECE 45,A01,083139,Staff,0,7,60,60
1651065758844,ECE 65,A50,083695,Staff,0,7,30,30
1651065764868,ECE 109,A01,091882,Touri; Behrouz,33,0,70,37
1651065770892,ECE 180,A00,083140,Abi Samra; Nicholas Camill,17,0,30,13
1651065770892,ECE 180,B00,083141,Abi Samra; Nicholas Camill,0,0,30,30
1651065776916,MATH 10A,A01,083735,Patchell; Gregory David,0,0,30,30
1651065776916,MATH 10A,A02,083736,Patchell; Gregory David,27,0,30,3
1651065776916,MATH 10A,A03,083737,Patchell; Gregory David,22,0,30,8
1651065782941,MATH 10B,A01,083207,Staff,0,7,30,30
1651065782941,MATH 10B,A02,083208,Staff,0,6,30,30
1651065782941,MATH 10B,B01,083739,Staff,8,0,30,22
1651065782941,MATH 10B,B02,083740,Staff,28,0,30,2
1651065788970,MATH 18,A01,083743,Staff,0,0,30,30
1651065788970,MATH 18,A02,083744,Staff,23,0,30,7
1651065788970,MATH 18,A03,083745,Staff,19,0,30,11
1651065788970,MATH 18,A04,083746,Staff,26,0,30,4
1651065788970,MATH 18,B01,083748,Staff,0,16,30,30
1651065788970,MATH 18,B02,083749,Staff,0,14,30,30
1651065788970,MATH 18,B03,083750,Staff,0,14,30,30
1651065788970,MATH 18,B04,083751,Staff,0,13,30,30
1651065794995,MATH 20A,A01,083754,Staff,18,0,40,22
1651065801020,MATH 20B,A01,083756,Staff,0,14,30,30
1651065801020,MATH 20B,A02,083757,Staff,0,11,30,30
1651065807045,MATH 20C,A01,083760,Staff,0,16,30,30
1651065807045,MATH 20C,A02,083761,Staff,0,15,30,30
1651065807045,MATH 20C,B01,083762,Staff,8,0,30,22
1651065807045,MATH 20C,B02,083763,Staff,28,0,30,2
1651065813072,MATH 20D,A01,083765,Staff,3,1,30,27
1651065813072,MATH 20D,A02,083766,Staff,1,0,30,29
1651065813072,MATH 20D,A03,083767,Staff,22,0,30,8
1651065819101,MATH 20E,A01,083771,Staff,2,0,30,28
1651065819101,MATH 20E,A02,083772,Staff,10,0,30,20
1651065819101,MATH 20E,B01,083773,Staff,0,0,30,30
1651065819101,MATH 20E,B02,083774,Staff,0,0,30,30
1651065825135,MATH 103A,A01,083777,Staff,0,17,30,30
1651065825135,MATH 103A,A02,083778,Staff,0,16,30,30
1651065825135,MATH 103A,B01,083779,Staff,0,15,30,30
1651065825135,MATH 103A,B02,083780,Staff,0,14,30,30
1651065831158,MATH 105,A01,085443,Staff,0,23,30,30
1651065837187,MATH 109,A01,083213,Anzaldo; Leesa B,0,7,30,30
1651065837187,MATH 109,A02,083214,Anzaldo; Leesa B,0,7,30,30
1651065837187,MATH 109,B01,083215,Anzaldo; Leesa B,0,8,30,30
1651065837187,MATH 109,B02,083216,Anzaldo; Leesa B,0,8,30,30
1651065843210,MATH 142A,A01,083219,Chow; Bennett,0,15,30,30
1651065843210,MATH 142A,A02,083220,Chow; Bennett,0,15,30,30
1651065843210,MATH 142A,B01,083221,Chow; Bennett,0,16,30,30
1651065843210,MATH 142A,B02,083222,Chow; Bennett,0,15,30,30
1651065849238,MATH 193A,A01,083224,Staff,0,8,30,30
1651065849238,MATH 193A,A02,083225,Staff,0,7,30,30
1651065849238,MATH 193A,A03,083781,Staff,0,7,30,30
1651065849238,MATH 193A,A04,083782,Staff,0,7,30,30
1651065855262,MATH 197,001,091859,McAuley; Julian John,9998,0,9999,1
1651065861329,COGS 9,A01,083615,Staff,0,20,60,60
1651065867351,COGS 11,A01,083617,Boyle; Mary E. T.,13,0,40,27
1651065873374,COGS 13,A01,083071,Staff,0,40,40,40
1651065879399,COGS 14A,A01,092681,Staff,0,40,100,100
1651065885424,COGS 14B,A01,083073,Cheng; Tzu-Han,0,13,50,50
1651065891451,COGS 17,A01,092677,Staff,9,0,75,66
1651065897476,COGS 100,A01,083619,Staff,0,30,60,60
1651065903502,COGS 101A,A01,083621,Davis; Joshua Daniel,0,29,60,60
1651065909529,COGS 101B,A01,091572,Staff,0,7,60,60
1651065915559,COGS 101C,A01,083625,Delgado; Tania,14,0,30,16
1651065921584,COGS 107A,A01,083627,Boyle; Mary E. T.,0,17,60,60
1651065927609,COGS 118A,A01,083075,Staff,0,10,60,60
1651065933633,CSE 3,A50,083646,Miranda; Gregory Joseph,15,0,38,23
1651065933633,CSE 3,A51,083647,Miranda; Gregory Joseph,36,0,37,1
1651065939655,CSE 8A,A50,083650,Miranda; Gregory Joseph,0,31,40,40
1651065945678,CSE 11,A01,083080,Cao; Yingjun,1,97,40,39
1651065951700,CSE 12,A01,083652,Staff,0,27,100,100
1651065957722,CSE 15L,A01,083654,Staff,0,3,50,50
1651065957722,CSE 15L,A02,083655,Staff,0,3,50,50
1651065963745,CSE 20,A01,083657,Staff,46,0,80,34
1651065969771,CSE 30,A01,083084,Eldon; John,0,38,80,80
1651065975796,CSE 100,A01,083659,Cao; Yingjun,0,72,50,50
1651065981900,CSE 134B,A01,083661,Powell; Thomas Allan,0,38,65,65
1651065987922,CSE 140,A01,083663,Staff,0,15,75,75
1651065993946,CSE 140L,A01,083088,Eldon; John,3,0,100,97
1651065999972,CSE 175,A01,083665,Kumar; Rakesh,0,0,25,25
1651066005997,CSE 190,A00,092507,Dubnov; Shlomo,9,0,20,11
1651066012034,ECE 45,A01,083139,Staff,0,7,60,60
1651066018061,ECE 65,A50,083695,Staff,0,7,30,30
1651066024083,ECE 109,A01,091882,Touri; Behrouz,33,0,70,37
1651066030108,ECE 180,A00,083140,Abi Samra; Nicholas Camill,17,0,30,13
1651066030108,ECE 180,B00,083141,Abi Samra; Nicholas Camill,0,0,30,30
1651066036132,MATH 10A,A01,083735,Patchell; Gregory David,0,0,30,30
1651066036132,MATH 10A,A02,083736,Patchell; Gregory David,27,0,30,3
1651066036132,MATH 10A,A03,083737,Patchell; Gregory David,22,0,30,8
1651066042160,MATH 10B,A01,083207,Staff,0,7,30,30
1651066042160,MATH 10B,A02,083208,Staff,0,6,30,30
1651066042160,MATH 10B,B01,083739,Staff,8,0,30,22
1651066042160,MATH 10B,B02,083740,Staff,28,0,30,2
1651066048186,MATH 18,A01,083743,Staff,0,0,30,30
1651066048186,MATH 18,A02,083744,Staff,23,0,30,7
1651066048186,MATH 18,A03,083745,Staff,19,0,30,11
1651066048186,MATH 18,A04,083746,Staff,26,0,30,4
1651066048186,MATH 18,B01,083748,Staff,0,16,30,30
1651066048186,MATH 18,B02,083749,Staff,0,14,30,30
1651066048186,MATH 18,B03,083750,Staff,0,14,30,30
1651066048186,MATH 18,B04,083751,Staff,0,13,30,30
1651066054210,MATH 20A,A01,083754,Staff,18,0,40,22
1651066060234,MATH 20B,A01,083756,Staff,0,14,30,30
1651066060234,MATH 20B,A02,083757,Staff,0,11,30,30
1651066066259,MATH 20C,A01,083760,Staff,0,16,30,30
1651066066259,MATH 20C,A02,083761,Staff,0,15,30,30
1651066066259,MATH 20C,B01,083762,Staff,8,0,30,22
1651066066259,MATH 20C,B02,083763,Staff,28,0,30,2
1651066072284,MATH 20D,A01,083765,Staff,3,1,30,27
1651066072284,MATH 20D,A02,083766,Staff,1,0,30,29
1651066072284,MATH 20D,A03,083767,Staff,22,0,30,8
1651066078306,MATH 20E,A01,083771,Staff,2,0,30,28
1651066078306,MATH 20E,A02,083772,Staff,10,0,30,20
1651066078306,MATH 20E,B01,083773,Staff,0,0,30,30
1651066078306,MATH 20E,B02,083774,Staff,0,0,30,30
1651066084330,MATH 103A,A01,083777,Staff,0,17,30,30
1651066084330,MATH 103A,A02,083778,Staff,0,16,30,30
1651066084330,MATH 103A,B01,083779,Staff,0,15,30,30
1651066084330,MATH 103A,B02,083780,Staff,0,14,30,30
1651066090357,MATH 105,A01,085443,Staff,0,23,30,30
1651066096380,MATH 109,A01,083213,Anzaldo; Leesa B,0,7,30,30
1651066096380,MATH 109,A02,083214,Anzaldo; Leesa B,0,7,30,30
1651066096380,MATH 109,B01,083215,Anzaldo; Leesa B,0,8,30,30
1651066096380,MATH 109,B02,083216,Anzaldo; Leesa B,0,8,30,30
1651066102407,MATH 142A,A01,083219,Chow; Bennett,0,15,30,30
1651066102407,MATH 142A,A02,083220,Chow; Bennett,0,15,30,30
1651066102407,MATH 142A,B01,083221,Chow; Bennett,0,16,30,30
1651066102407,MATH 142A,B02,083222,Chow; Bennett,0,15,30,30
1651066108433,MATH 193A,A01,083224,Staff,0,8,30,30
1651066108433,MATH 193A,A02,083225,Staff,0,7,30,30
1651066108433,MATH 193A,A03,083781,Staff,0,7,30,30
1651066108433,MATH 193A,A04,083782,Staff,0,7,30,30
1651066114459,MATH 197,001,091859,McAuley; Julian John,9998,0,9999,1
1651066120508,COGS 9,A01,083615,Staff,0,20,60,60
1651066126537,COGS 11,A01,083617,Boyle; Mary E. T.,13,0,40,27
1651066132560,COGS 13,A01,083071,Staff,0,40,40,40
1651066138585,COGS 14A,A01,092681,Staff,0,40,100,100
1651066144606,COGS 14B,A01,083073,Cheng; Tzu-Han,0,13,50,50
1651066150627,COGS 17,A01,092677,Staff,9,0,75,66
1651066156649,COGS 100,A01,083619,Staff,0,30,60,60
1651066162677,COGS 101A,A01,083621,Davis; Joshua Daniel,0,29,60,60
1651066168700,COGS 101B,A01,091572,Staff,0,7,60,60
1651066174750,COGS 101C,A01,083625,Delgado; Tania,14,0,30,16
1651066180774,COGS 107A,A01,083627,Boyle; Mary E. T.,0,17,60,60
1651066186797,COGS 118A,A01,083075,Staff,0,10,60,60
1651066192824,CSE 3,A50,083646,Miranda; Gregory Joseph,15,0,38,23
1651066192824,CSE 3,A51,083647,Miranda; Gregory Joseph,36,0,37,1
1651066198848,CSE 8A,A50,083650,Miranda; Gregory Joseph,0,31,40,40
1651066204873,CSE 11,A01,083080,Cao; Yingjun,1,97,40,39
1651066210897,CSE 12,A01,083652,Staff,0,27,100,100
1651066216921,CSE 15L,A01,083654,Staff,0,3,50,50
1651066216921,CSE 15L,A02,083655,Staff,0,3,50,50
1651066222946,CSE 20,A01,083657,Staff,46,0,80,34
1651066228969,CSE 30,A01,083084,Eldon; John,0,38,80,80
1651066234993,CSE 100,A01,083659,Cao; Yingjun,0,72,50,50
1651066241016,CSE 134B,A01,083661,Powell; Thomas Allan,0,38,65,65
1651066247043,CSE 140,A01,083663,Staff,0,15,75,75
1651066253067,CSE 140L,A01,083088,Eldon; John,3,0,100,97
1651066259095,CSE 175,A01,083665,Kumar; Rakesh,0,0,25,25
1651066265119,CSE 190,A00,092507,Dubnov; Shlomo,9,0,20,11
1651066271149,ECE 45,A01,083139,Staff,0,7,60,60
1651066277173,ECE 65,A50,083695,Staff,0,7,30,30
1651066283196,ECE 109,A01,091882,Touri; Behrouz,33,0,70,37
1651066289219,ECE 180,A00,083140,Abi Samra; Nicholas Camill,17,0,30,13
1651066289219,ECE 180,B00,083141,Abi Samra; Nicholas Camill,0,0,30,30
1651066295245,MATH 10A,A01,083735,Patchell; Gregory David,0,0,30,30
1651066295245,MATH 10A,A02,083736,Patchell; Gregory David,27,0,30,3
1651066295245,MATH 10A,A03,083737,Patchell; Gregory David,22,0,30,8
1651066301269,MATH 10B,A01,083207,Staff,0,7,30,30
1651066301269,MATH 10B,A02,083208,Staff,0,6,30,30
1651066301269,MATH 10B,B01,083739,Staff,8,0,30,22
1651066301269,MATH 10B,B02,083740,Staff,28,0,30,2
1651066307299,MATH 18,A01,083743,Staff,0,0,30,30
1651066307299,MATH 18,A02,083744,Staff,23,0,30,7
1651066307299,MATH 18,A03,083745,Staff,19,0,30,11
1651066307299,MATH 18,A04,083746,Staff,26,0,30,4
1651066307299,MATH 18,B01,083748,Staff,0,16,30,30
1651066307299,MATH 18,B02,083749,Staff,0,14,30,30
1651066307299,MATH 18,B03,083750,Staff,0,14,30,30
1651066307299,MATH 18,B04,083751,Staff,0,13,30,30
1651066313326,MATH 20A,A01,083754,Staff,18,0,40,22
1651066319351,MATH 20B,A01,083756,Staff,0,14,30,30
1651066319351,MATH 20B,A02,083757,Staff,0,11,30,30
1651066325382,MATH 20C,A01,083760,Staff,0,16,30,30
1651066325382,MATH 20C,A02,083761,Staff,0,15,30,30
1651066325382,MATH 20C,B01,083762,Staff,8,0,30,22
1651066325382,MATH 20C,B02,083763,Staff,28,0,30,2
1651066337796,MATH 20D,A01,083765,Staff,3,1,30,27
1651066337796,MATH 20D,A02,083766,Staff,1,0,30,29
1651066337796,MATH 20D,A03,083767,Staff,22,0,30,8
1651066343830,MATH 20E,A01,083771,Staff,2,0,30,28
1651066343830,MATH 20E,A02,083772,Staff,10,0,30,20
1651066343830,MATH 20E,B01,083773,Staff,0,0,30,30
1651066343830,MATH 20E,B02,083774,Staff,0,0,30,30
1651066349856,MATH 103A,A01,083777,Staff,0,17,30,30
1651066349856,MATH 103A,A02,083778,Staff,0,16,30,30
1651066349856,MATH 103A,B01,083779,Staff,0,15,30,30
1651066349856,MATH 103A,B02,083780,Staff,0,14,30,30
1651066355881,MATH 105,A01,085443,Staff,0,23,30,30
1651066361906,MATH 109,A01,083213,Anzaldo; Leesa B,0,7,30,30
1651066361906,MATH 109,A02,083214,Anzaldo; Leesa B,0,7,30,30
1651066361906,MATH 109,B01,083215,Anzaldo; Leesa B,0,8,30,30
1651066361906,MATH 109,B02,083216,Anzaldo; Leesa B,0,8,30,30
1651066367931,MATH 142A,A01,083219,Chow; Bennett,0,15,30,30
1651066367931,MATH 142A,A02,083220,Chow; Bennett,0,15,30,30
1651066367931,MATH 142A,B01,083221,Chow; Bennett,0,16,30,30
1651066367931,MATH 142A,B02,083222,Chow; Bennett,0,15,30,30
1651066373986,MATH 193A,A01,083224,Staff,0,8,30,30
1651066373986,MATH 193A,A02,083225,Staff,0,7,30,30
1651066373986,MATH 193A,A03,083781,Staff,0,7,30,30
1651066373986,MATH 193A,A04,083782,Staff,0,7,30,30
1651066380012,MATH 197,001,091859,McAuley; Julian John,9998,0,9999,1
1651066386079,COGS 9,A01,083615,Staff,0,20,60,60
1651066392104,COGS 11,A01,083617,Boyle; Mary E. T.,13,0,40,27
1651066398133,COGS 13,A01,083071,Staff,0,40,40,40
1651066404159,COGS 14A,A01,092681,Staff,0,40,100,100
1651066410184,COGS 14B,A01,083073,Cheng; Tzu-Han,0,13,50,50
1651066416208,COGS 17,A01,092677,Staff,9,0,75,66
1651066422233,COGS 100,A01,083619,Staff,0,30,60,60
1651066428261,COGS 101A,A01,083621,Davis; Joshua Daniel,0,29,60,60
1651066434285,COGS 101B,A01,091572,Staff,0,7,60,60
1651066440314,COGS 101C,A01,083625,Delgado; Tania,14,0,30,16
1651066446343,COGS 107A,A01,083627,Boyle; Mary E. T.,0,17,60,60
1651066452366,COGS 118A,A01,083075,Staff,0,10,60,60
1651066458394,CSE 3,A50,083646,Miranda; Gregory Joseph,15,0,38,23
1651066458394,CSE 3,A51,083647,Miranda; Gregory Joseph,36,0,37,1
1651066464417,CSE 8A,A50,083650,Miranda; Gregory Joseph,0,31,40,40
1651066470441,CSE 11,A01,083080,Cao; Yingjun,1,97,40,39
1651066476463,CSE 12,A01,083652,Staff,0,27,100,100
1651066482494,CSE 15L,A01,083654,Staff,0,3,50,50
1651066482494,CSE 15L,A02,083655,Staff,0,3,50,50
1651066488521,CSE 20,A01,083657,Staff,46,0,80,34
1651066494548,CSE 30,A01,083084,Eldon; John,0,38,80,80
1651066500587,CSE 100,A01,083659,Cao; Yingjun,0,72,50,50
1651066506620,CSE 134B,A01,083661,Powell; Thomas Allan,0,38,65,65
1651066512644,CSE 140,A01,083663,Staff,0,15,75,75
1651066518676,CSE 140L,A01,083088,Eldon; John,3,0,100,97
1651066524708,CSE 175,A01,083665,Kumar; Rakesh,0,0,25,25
1651066530731,CSE 190,A00,092507,Dubnov; Shlomo,9,0,20,11
1651066536758,ECE 45,A01,083139,Staff,0,7,60,60
1651066542780,ECE 65,A50,083695,Staff,0,7,30,30
1651066548807,ECE 109,A01,091882,Touri; Behrouz,33,0,70,37
1651066554843,ECE 180,A00,083140,Abi Samra; Nicholas Camill,17,0,30,13
1651066554843,ECE 180,B00,083141,Abi Samra; Nicholas Camill,0,0,30,30
1651066560866,MATH 10A,A01,083735,Patchell; Gregory David,0,0,30,30
1651066560866,MATH 10A,A02,083736,Patchell; Gregory David,27,0,30,3
1651066560866,MATH 10A,A03,083737,Patchell; Gregory David,22,0,30,8
1651066566892,MATH 10B,A01,083207,Staff,0,7,30,30
1651066566892,MATH 10B,A02,083208,Staff,0,6,30,30
1651066566892,MATH 10B,B01,083739,Staff,8,0,30,22
1651066566892,MATH 10B,B02,083740,Staff,28,0,30,2
1651066572916,MATH 18,A01,083743,Staff,0,0,30,30
1651066572916,MATH 18,A02,083744,Staff,23,0,30,7
1651066572916,MATH 18,A03,083745,Staff,19,0,30,11
1651066572916,MATH 18,A04,083746,Staff,26,0,30,4
1651066572916,MATH 18,B01,083748,Staff,0,16,30,30
1651066572916,MATH 18,B02,083749,Staff,0,14,30,30
1651066572916,MATH 18,B03,083750,Staff,0,14,30,30
1651066572916,MATH 18,B04,083751,Staff,0,13,30,30
1651066578940,MATH 20A,A01,083754,Staff,18,0,40,22
1651066585063,MATH 20B,A01,083756,Staff,0,14,30,30
1651066585063,MATH 20B,A02,083757,Staff,0,11,30,30
1651066591085,MATH 20C,A01,083760,Staff,0,16,30,30
1651066591085,MATH 20C,A02,083761,Staff,0,15,30,30
1651066591085,MATH 20C,B01,083762,Staff,8,0,30,22
1651066591085,MATH 20C,B02,083763,Staff,28,0,30,2
1651066597109,MATH 20D,A01,083765,Staff,3,1,30,27
1651066597109,MATH 20D,A02,083766,Staff,1,0,30,29
1651066597109,MATH 20D,A03,083767,Staff,22,0,30,8
1651066603133,MATH 20E,A01,083771,Staff,2,0,30,28
1651066603133,MATH 20E,A02,083772,Staff,10,0,30,20
1651066603133,MATH 20E,B01,083773,Staff,0,0,30,30
1651066603133,MATH 20E,B02,083774,Staff,0,0,30,30
1651066609156,MATH 103A,A01,083777,Staff,0,17,30,30
1651066609156,MATH 103A,A02,083778,Staff,0,16,30,30
1651066609156,MATH 103A,B01,083779,Staff,0,15,30,30
1651066609156,MATH 103A,B02,083780,Staff,0,14,30,30
1651066615180,MATH 105,A01,085443,Staff,0,23,30,30
1651066621210,MATH 109,A01,083213,Anzaldo; Leesa B,0,7,30,30
1651066621210,MATH 109,A02,083214,Anzaldo; Leesa B,0,7,30,30
1651066621210,MATH 109,B01,083215,Anzaldo; Leesa B,0,8,30,30
1651066621210,MATH 109,B02,083216,Anzaldo; Leesa B,0,8,30,30
1651066627233,MATH 142A,A01,083219,Chow; Bennett,0,15,30,30
1651066627233,MATH 142A,A02,083220,Chow; Bennett,0,15,30,30
1651066627233,MATH 142A,B01,083221,Chow; Bennett,0,16,30,30
1651066627233,MATH 142A,B02,083222,Chow; Bennett,0,15,30,30
1651066633262,MATH 193A,A01,083224,Staff,0,8,30,30
1651066633262,MATH 193A,A02,083225,Staff,0,7,30,30
1651066633262,MATH 193A,A03,083781,Staff,0,7,30,30
1651066633262,MATH 193A,A04,083782,Staff,0,7,30,30
1651066639287,MATH 197,001,091859,McAuley; Julian John,9998,0,9999,1
1651066645345,COGS 9,A01,083615,Staff,0,20,60,60
1651066651373,COGS 11,A01,083617,Boyle; Mary E. T.,13,0,40,27
1651066657406,COGS 13,A01,083071,Staff,0,40,40,40
1651066663432,COGS 14A,A01,092681,Staff,0,40,100,100
1651066669459,COGS 14B,A01,083073,Cheng; Tzu-Han,0,13,50,50
1651066675497,COGS 17,A01,092677,Staff,9,0,75,66
1651066681519,COGS 100,A01,083619,Staff,0,30,60,60
1651066687546,COGS 101A,A01,083621,Davis; Joshua Daniel,0,29,60,60
1651066693568,COGS 101B,A01,091572,Staff,0,7,60,60
1651066699596,COGS 101C,A01,083625,Delgado; Tania,14,0,30,16
1651066705622,COGS 107A,A01,083627,Boyle; Mary E. T.,0,17,60,60
1651066711650,COGS 118A,A01,083075,Staff,0,10,60,60
1651066717688,CSE 3,A50,083646,Miranda; Gregory Joseph,15,0,38,23
1651066717688,CSE 3,A51,083647,Miranda; Gregory Joseph,36,0,37,1
1651066723716,CSE 8A,A50,083650,Miranda; Gregory Joseph,0,31,40,40
1651066729742,CSE 11,A01,083080,Cao; Yingjun,1,97,40,39
1651066735766,CSE 12,A01,083652,Staff,0,27,100,100
1651066741797,CSE 15L,A01,083654,Staff,0,3,50,50
1651066741797,CSE 15L,A02,083655,Staff,0,3,50,50
1651066747825,CSE 20,A01,083657,Staff,46,0,80,34
1651066753851,CSE 30,A01,083084,Eldon; John,0,38,80,80
1651066759875,CSE 100,A01,083659,Cao; Yingjun,0,72,50,50
1651066765898,CSE 134B,A01,083661,Powell; Thomas Allan,0,38,65,65
1651066771925,CSE 140,A01,083663,Staff,0,15,75,75
1651066777949,CSE 140L,A01,083088,Eldon; John,3,0,100,97
1651066783972,CSE 175,A01,083665,Kumar; Rakesh,0,0,25,25
1651066790000,CSE 190,A00,092507,Dubnov; Shlomo,9,0,20,11
1651066796032,ECE 45,A01,083139,Staff,0,7,60,60
1651066802060,ECE 65,A50,083695,Staff,0,7,30,30
1651066808083,ECE 109,A01,091882,Touri; Behrouz,33,0,70,37
1651066814105,ECE 180,A00,083140,Abi Samra; Nicholas Camill,17,0,30,13
1651066814105,ECE 180,B00,083141,Abi Samra; Nicholas Camill,0,0,30,30
1651066820129,MATH 10A,A01,083735,Patchell; Gregory David,0,0,30,30
1651066820129,MATH 10A,A02,083736,Patchell; Gregory David,27,0,30,3
1651066820129,MATH 10A,A03,083737,Patchell; Gregory David,22,0,30,8
1651066826155,MATH 10B,A01,083207,Staff,0,7,30,30
1651066826155,MATH 10B,A02,083208,Staff,0,6,30,30
1651066826155,MATH 10B,B01,083739,Staff,8,0,30,22
1651066826155,MATH 10B,B02,083740,Staff,28,0,30,2
1651066832180,MATH 18,A01,083743,Staff,0,0,30,30
1651066832180,MATH 18,A02,083744,Staff,23,0,30,7
1651066832180,MATH 18,A03,083745,Staff,19,0,30,11
1651066832180,MATH 18,A04,083746,Staff,26,0,30,4
1651066832180,MATH 18,B01,083748,Staff,0,16,30,30
1651066832180,MATH 18,B02,083749,Staff,0,14,30,30
1651066832180,MATH 18,B03,083750,Staff,0,14,30,30
1651066832180,MATH 18,B04,083751,Staff,0,13,30,30
1651066838211,MATH 20A,A01,083754,Staff,18,0,40,22
1651066844241,MATH 20B,A01,083756,Staff,0,14,30,30
1651066844241,MATH 20B,A02,083757,Staff,0,11,30,30
1651066850269,MATH 20C,A01,083760,Staff,0,16,30,30
1651066850269,MATH 20C,A02,083761,Staff,0,15,30,30
1651066850269,MATH 20C,B01,083762,Staff,8,0,30,22
1651066850269,MATH 20C,B02,083763,Staff,28,0,30,2
1651066856294,MATH 20D,A01,083765,Staff,3,1,30,27
1651066856294,MATH 20D,A02,083766,Staff,1,0,30,29
1651066856294,MATH 20D,A03,083767,Staff,22,0,30,8
1651066862323,MATH 20E,A01,083771,Staff,2,0,30,28
1651066862323,MATH 20E,A02,083772,Staff,10,0,30,20
1651066862323,MATH 20E,B01,083773,Staff,0,0,30,30
1651066862323,MATH 20E,B02,083774,Staff,0,0,30,30
1651066868352,MATH 103A,A01,083777,Staff,0,17,30,30
1651066868352,MATH 103A,A02,083778,Staff,0,16,30,30
1651066868352,MATH 103A,B01,083779,Staff,0,15,30,30
1651066868352,MATH 103A,B02,083780,Staff,0,14,30,30
1651066874374,MATH 105,A01,085443,Staff,0,23,30,30
1651066880405,MATH 109,A01,083213,Anzaldo; Leesa B,0,7,30,30
1651066880405,MATH 109,A02,083214,Anzaldo; Leesa B,0,7,30,30
1651066880405,MATH 109,B01,083215,Anzaldo; Leesa B,0,8,30,30
1651066880405,MATH 109,B02,083216,Anzaldo; Leesa B,0,8,30,30
1651066886445,MATH 142A,A01,083219,Chow; Bennett,0,15,30,30
1651066886445,MATH 142A,A02,083220,Chow; Bennett,0,15,30,30
1651066886445,MATH 142A,B01,083221,Chow; Bennett,0,16,30,30
1651066886445,MATH 142A,B02,083222,Chow; Bennett,0,15,30,30
1651066892469,MATH 193A,A01,083224,Staff,0,8,30,30
1651066892469,MATH 193A,A02,083225,Staff,0,7,30,30
1651066892469,MATH 193A,A03,083781,Staff,0,7,30,30
1651066892469,MATH 193A,A04,083782,Staff,0,7,30,30
1651066898491,MATH 197,001,091859,McAuley; Julian John,9998,0,9999,1
1651066904542,COGS 9,A01,083615,Staff,0,20,60,60
1651066910568,COGS 11,A01,083617,Boyle; Mary E. T.,13,0,40,27
1651066916595,COGS 13,A01,083071,Staff,0,40,40,40
1651066922620,COGS 14A,A01,092681,Staff,0,40,100,100
1651066928644,COGS 14B,A01,083073,Cheng; Tzu-Han,0,13,50,50
1651066934670,COGS 17,A01,092677,Staff,9,0,75,66
1651066940708,COGS 100,A01,083619,Staff,0,30,60,60
1651066946735,COGS 101A,A01,083621,Davis; Joshua Daniel,0,29,60,60
1651066952762,COGS 101B,A01,091572,Staff,0,7,60,60
1651066958790,COGS 101C,A01,083625,Delgado; Tania,14,0,30,16
1651066964817,COGS 107A,A01,083627,Boyle; Mary E. T.,0,17,60,60
1651066970841,COGS 118A,A01,083075,Staff,0,10,60,60
1651066976865,CSE 3,A50,083646,Miranda; Gregory Joseph,15,0,38,23
1651066976865,CSE 3,A51,083647,Miranda; Gregory Joseph,36,0,37,1
1651066982890,CSE 8A,A50,083650,Miranda; Gregory Joseph,0,31,40,40
1651066988915,CSE 11,A01,083080,Cao; Yingjun,1,97,40,39
1651066994938,CSE 12,A01,083652,Staff,0,27,100,100
1651067000967,CSE 15L,A01,083654,Staff,0,3,50,50
1651067000967,CSE 15L,A02,083655,Staff,0,3,50,50
1651067006993,CSE 20,A01,083657,Staff,46,0,80,34
1651067013020,CSE 30,A01,083084,Eldon; John,0,38,80,80
1651067019069,CSE 100,A01,083659,Cao; Yingjun,0,72,50,50
1651067025093,CSE 134B,A01,083661,Powell; Thomas Allan,0,38,65,65
1651067031119,CSE 140,A01,083663,Staff,0,15,75,75
1651067037142,CSE 140L,A01,083088,Eldon; John,3,0,100,97
1651067043166,CSE 175,A01,083665,Kumar; Rakesh,0,0,25,25
1651067049191,CSE 190,A00,092507,Dubnov; Shlomo,9,0,20,11
1651067055214,ECE 45,A01,083139,Staff,0,7,60,60
1651067061239,ECE 65,A50,083695,Staff,0,7,30,30
1651067067264,ECE 109,A01,091882,Touri; Behrouz,33,0,70,37
1651067073288,ECE 180,A00,083140,Abi Samra; Nicholas Camill,17,0,30,13
1651067073288,ECE 180,B00,083141,Abi Samra; Nicholas Camill,0,0,30,30
1651067079323,MATH 10A,A01,083735,Patchell; Gregory David,0,0,30,30
1651067079323,MATH 10A,A02,083736,Patchell; Gregory David,27,0,30,3
1651067079323,MATH 10A,A03,083737,Patchell; Gregory David,22,0,30,8
1651067085347,MATH 10B,A01,083207,Staff,0,7,30,30
1651067085347,MATH 10B,A02,083208,Staff,0,6,30,30
1651067085347,MATH 10B,B01,083739,Staff,8,0,30,22
1651067085347,MATH 10B,B02,083740,Staff,28,0,30,2
1651067091372,MATH 18,A01,083743,Staff,0,0,30,30
1651067091372,MATH 18,A02,083744,Staff,23,0,30,7
1651067091372,MATH 18,A03,083745,Staff,19,0,30,11
1651067091372,MATH 18,A04,083746,Staff,26,0,30,4
1651067091372,MATH 18,B01,083748,Staff,0,16,30,30
1651067091372,MATH 18,B02,083749,Staff,0,14,30,30
1651067091372,MATH 18,B03,083750,Staff,0,14,30,30
1651067091372,MATH 18,B04,083751,Staff,0,13,30,30
1651067097398,MATH 20A,A01,083754,Staff,18,0,40,22
1651067103424,MATH 20B,A01,083756,Staff,0,14,30,30
1651067103424,MATH 20B,A02,083757,Staff,0,11,30,30
1651067109451,MATH 20C,A01,083760,Staff,0,16,30,30
1651067109451,MATH 20C,A02,083761,Staff,0,15,30,30
1651067109451,MATH 20C,B01,083762,Staff,8,0,30,22
1651067109451,MATH 20C,B02,083763,Staff,28,0,30,2
1651067115475,MATH 20D,A01,083765,Staff,3,1,30,27
1651067115475,MATH 20D,A02,083766,Staff,1,0,30,29
1651067115475,MATH 20D,A03,083767,Staff,22,0,30,8
1651067121507,MATH 20E,A01,083771,Staff,2,0,30,28
1651067121507,MATH 20E,A02,083772,Staff,10,0,30,20
1651067121507,MATH 20E,B01,083773,Staff,0,0,30,30
1651067121507,MATH 20E,B02,083774,Staff,0,0,30,30
1651067127530,MATH 103A,A01,083777,Staff,0,17,30,30
1651067127530,MATH 103A,A02,083778,Staff,0,16,30,30
1651067127530,MATH 103A,B01,083779,Staff,0,15,30,30
1651067127530,MATH 103A,B02,083780,Staff,0,14,30,30
1651067133553,MATH 105,A01,085443,Staff,0,23,30,30
1651067139575,MATH 109,A01,083213,Anzaldo; Leesa B,0,7,30,30
1651067139575,MATH 109,A02,083214,Anzaldo; Leesa B,0,7,30,30
1651067139575,MATH 109,B01,083215,Anzaldo; Leesa B,0,8,30,30
1651067139575,MATH 109,B02,083216,Anzaldo; Leesa B,0,8,30,30
1651067145596,MATH 142A,A01,083219,Chow; Bennett,0,15,30,30
1651067145596,MATH 142A,A02,083220,Chow; Bennett,0,15,30,30
1651067145596,MATH 142A,B01,083221,Chow; Bennett,0,16,30,30
1651067145596,MATH 142A,B02,083222,Chow; Bennett,0,15,30,30
1651067151622,MATH 193A,A01,083224,Staff,0,8,30,30
1651067151622,MATH 193A,A02,083225,Staff,0,7,30,30
1651067151622,MATH 193A,A03,083781,Staff,0,7,30,30
1651067151622,MATH 193A,A04,083782,Staff,0,7,30,30
1651067157645,MATH 197,001,091859,McAuley; Julian John,9998,0,9999,1
1651067163704,COGS 9,A01,083615,Staff,0,20,60,60
1651067169729,COGS 11,A01,083617,Boyle; Mary E. T.,13,0,40,27
1651067175830,COGS 13,A01,083071,Staff,0,40,40,40
1651067181856,COGS 14A,A01,092681,Staff,0,40,100,100
1651067187888,COGS 14B,A01,083073,Cheng; Tzu-Han,0,13,50,50
1651067193911,COGS 17,A01,092677,Staff,9,0,75,66
1651067199935,COGS 100,A01,083619,Staff,0,30,60,60
1651067205960,COGS 101A,A01,083621,Davis; Joshua Daniel,0,29,60,60
1651067211981,COGS 101B,A01,091572,Staff,0,7,60,60
1651067218006,COGS 101C,A01,083625,Delgado; Tania,14,0,30,16
1651067224032,COGS 107A,A01,083627,Boyle; Mary E. T.,0,17,60,60
1651067230068,COGS 118A,A01,083075,Staff,0,10,60,60
1651067236097,CSE 3,A50,083646,Miranda; Gregory Joseph,15,0,38,23
1651067236097,CSE 3,A51,083647,Miranda; Gregory Joseph,36,0,37,1
1651067242124,CSE 8A,A50,083650,Miranda; Gregory Joseph,0,31,40,40
1651067248150,CSE 11,A01,083080,Cao; Yingjun,1,97,40,39
1651067254175,CSE 12,A01,083652,Staff,0,27,100,100
1651067260201,CSE 15L,A01,083654,Staff,0,3,50,50
1651067260201,CSE 15L,A02,083655,Staff,0,3,50,50
1651067266224,CSE 20,A01,083657,Staff,46,0,80,34
1651067272251,CSE 30,A01,083084,Eldon; John,0,38,80,80
1651067278278,CSE 100,A01,083659,Cao; Yingjun,0,72,50,50
1651067284305,CSE 134B,A01,083661,Powell; Thomas Allan,0,38,65,65
1651067290332,CSE 140,A01,083663,Staff,0,15,75,75
1651067296368,CSE 140L,A01,083088,Eldon; John,3,0,100,97
1651067302406,CSE 175,A01,083665,Kumar; Rakesh,0,0,25,25
1651067308429,CSE 190,A00,092507,Dubnov; Shlomo,9,0,20,11
1651067314456,ECE 45,A01,083139,Staff,0,7,60,60
1651067320482,ECE 65,A50,083695,Staff,0,7,30,30
1651067326508,ECE 109,A01,091882,Touri; Behrouz,33,0,70,37
1651067332532,ECE 180,A00,083140,Abi Samra; Nicholas Camill,17,0,30,13
1651067332532,ECE 180,B00,083141,Abi Samra; Nicholas Camill,0,0,30,30
1651067338556,MATH 10A,A01,083735,Patchell; Gregory David,0,0,30,30
1651067338556,MATH 10A,A02,083736,Patchell; Gregory David,27,0,30,3
1651067338556,MATH 10A,A03,083737,Patchell; Gregory David,22,0,30,8
1651067344584,MATH 10B,A01,083207,Staff,0,7,30,30
1651067344584,MATH 10B,A02,083208,Staff,0,6,30,30
1651067344584,MATH 10B,B01,083739,Staff,8,0,30,22
1651067344584,MATH 10B,B02,083740,Staff,28,0,30,2
1651067350612,MATH 18,A01,083743,Staff,0,0,30,30
1651067350612,MATH 18,A02,083744,Staff,23,0,30,7
1651067350612,MATH 18,A03,083745,Staff,19,0,30,11
1651067350612,MATH 18,A04,083746,Staff,26,0,30,4
1651067350612,MATH 18,B01,083748,Staff,0,16,30,30
1651067350612,MATH 18,B02,083749,Staff,0,14,30,30
1651067350612,MATH 18,B03,083750,Staff,0,14,30,30
1651067350612,MATH 18,B04,083751,Staff,0,13,30,30
1651067356636,MATH 20A,A01,083754,Staff,18,0,40,22
1651067362659,MATH 20B,A01,083756,Staff,0,14,30,30
1651067362659,MATH 20B,A02,083757,Staff,0,11,30,30
1651067368687,MATH 20C,A01,083760,Staff,0,16,30,30
1651067368687,MATH 20C,A02,083761,Staff,0,15,30,30
1651067368687,MATH 20C,B01,083762,Staff,8,0,30,22
1651067368687,MATH 20C,B02,083763,Staff,28,0,30,2
1651067374712,MATH 20D,A01,083765,Staff,3,1,30,27
1651067374712,MATH 20D,A02,083766,Staff,1,0,30,29
1651067374712,MATH 20D,A03,083767,Staff,22,0,30,8
1651067380738,MATH 20E,A01,083771,Staff,2,0,30,28
1651067380738,MATH 20E,A02,083772,Staff,10,0,30,20
1651067380738,MATH 20E,B01,083773,Staff,0,0,30,30
1651067380738,MATH 20E,B02,083774,Staff,0,0,30,30
1651067386763,MATH 103A,A01,083777,Staff,0,17,30,30
1651067386763,MATH 103A,A02,083778,Staff,0,16,30,30
1651067386763,MATH 103A,B01,083779,Staff,0,15,30,30
1651067386763,MATH 103A,B02,083780,Staff,0,14,30,30
1651067392790,MATH 105,A01,085443,Staff,0,23,30,30
1651067398817,MATH 109,A01,083213,Anzaldo; Leesa B,0,7,30,30
1651067398817,MATH 109,A02,083214,Anzaldo; Leesa B,0,7,30,30
1651067398817,MATH 109,B01,083215,Anzaldo; Leesa B,0,8,30,30
1651067398817,MATH 109,B02,083216,Anzaldo; Leesa B,0,8,30,30
1651067404845,MATH 142A,A01,083219,Chow; Bennett,0,15,30,30
1651067404845,MATH 142A,A02,083220,Chow; Bennett,0,15,30,30
1651067404845,MATH 142A,B01,083221,Chow; Bennett,0,16,30,30
1651067404845,MATH 142A,B02,083222,Chow; Bennett,0,15,30,30
1651067410869,MATH 193A,A01,083224,Staff,0,8,30,30
1651067410869,MATH 193A,A02,083225,Staff,0,7,30,30
1651067410869,MATH 193A,A03,083781,Staff,0,7,30,30
1651067410869,MATH 193A,A04,083782,Staff,0,7,30,30
1651067416893,MATH 197,001,091859,McAuley; Julian John,9998,0,9999,1
1651067422949,COGS 9,A01,083615,Staff,0,20,60,60
1651067428970,COGS 11,A01,083617,Boyle; Mary E. T.,13,0,40,27
1651067434994,COGS 13,A01,083071,Staff,0,40,40,40
1651067441018,COGS 14A,A01,092681,Staff,0,40,100,100
1651067447041,COGS 14B,A01,083073,Cheng; Tzu-Han,0,13,50,50
1651067453067,COGS 17,A01,092677,Staff,9,0,75,66
1651067459092,COGS 100,A01,083619,Staff,0,30,60,60
1651067465116,COGS 101A,A01,083621,Davis; Joshua Daniel,0,29,60,60
1651067471142,COGS 101B,A01,091572,Staff,0,7,60,60
1651067477165,COGS 101C,A01,083625,Delgado; Tania,14,0,30,16
1651067483193,COGS 107A,A01,083627,Boyle; Mary E. T.,0,17,60,60
1651067489219,COGS 118A,A01,083075,Staff,0,10,60,60
1651067495242,CSE 3,A50,083646,Miranda; Gregory Joseph,15,0,38,23
1651067495242,CSE 3,A51,083647,Miranda; Gregory Joseph,36,0,37,1
1651067501271,CSE 8A,A50,083650,Miranda; Gregory Joseph,0,31,40,40
1651067507298,CSE 11,A01,083080,Cao; Yingjun,1,97,40,39
1651067513319,CSE 12,A01,083652,Staff,0,27,100,100
1651067519348,CSE 15L,A01,083654,Staff,0,3,50,50
1651067519348,CSE 15L,A02,083655,Staff,0,3,50,50
1651067525373,CSE 20,A01,083657,Staff,46,0,80,34
1651067531395,CSE 30,A01,083084,Eldon; John,0,38,80,80
1651067537427,CSE 100,A01,083659,Cao; Yingjun,0,72,50,50
1651067543460,CSE 134B,A01,083661,Powell; Thomas Allan,0,38,65,65
1651067549490,CSE 140,A01,083663,Staff,0,15,75,75
1651067555517,CSE 140L,A01,083088,Eldon; John,3,0,100,97
1651067561539,CSE 175,A01,083665,Kumar; Rakesh,0,0,25,25
1651067567563,CSE 190,A00,092507,Dubnov; Shlomo,9,0,20,11
1651067573585,ECE 45,A01,083139,Staff,0,7,60,60
1651067579610,ECE 65,A50,083695,Staff,0,7,30,30
1651067585637,ECE 109,A01,091882,Touri; Behrouz,33,0,70,37
1651067591664,ECE 180,A00,083140,Abi Samra; Nicholas Camill,17,0,30,13
1651067591664,ECE 180,B00,083141,Abi Samra; Nicholas Camill,0,0,30,30
1651067597689,MATH 10A,A01,083735,Patchell; Gregory David,0,0,30,30
1651067597689,MATH 10A,A02,083736,Patchell; Gregory David,27,0,30,3
1651067597689,MATH 10A,A03,083737,Patchell; Gregory David,22,0,30,8
1651067603718,MATH 10B,A01,083207,Staff,0,7,30,30
1651067603718,MATH 10B,A02,083208,Staff,0,6,30,30
1651067603718,MATH 10B,B01,083739,Staff,8,0,30,22
1651067603718,MATH 10B,B02,083740,Staff,28,0,30,2
1651067609749,MATH 18,A01,083743,Staff,0,0,30,30
1651067609749,MATH 18,A02,083744,Staff,23,0,30,7
1651067609749,MATH 18,A03,083745,Staff,19,0,30,11
1651067609749,MATH 18,A04,083746,Staff,26,0,30,4
1651067609749,MATH 18,B01,083748,Staff,0,16,30,30
1651067609749,MATH 18,B02,083749,Staff,0,14,30,30
1651067609749,MATH 18,B03,083750,Staff,0,14,30,30
1651067609749,MATH 18,B04,083751,Staff,0,13,30,30
1651067615776,MATH 20A,A01,083754,Staff,18,0,40,22
1651067621804,MATH 20B,A01,083756,Staff,0,14,30,30
1651067621804,MATH 20B,A02,083757,Staff,0,11,30,30
1651067627828,MATH 20C,A01,083760,Staff,0,16,30,30
1651067627828,MATH 20C,A02,083761,Staff,0,15,30,30
1651067627828,MATH 20C,B01,083762,Staff,8,0,30,22
1651067627828,MATH 20C,B02,083763,Staff,28,0,30,2
1651067633852,MATH 20D,A01,083765,Staff,3,1,30,27
1651067633852,MATH 20D,A02,083766,Staff,1,0,30,29
1651067633852,MATH 20D,A03,083767,Staff,22,0,30,8
1651067639877,MATH 20E,A01,083771,Staff,2,0,30,28
1651067639877,MATH 20E,A02,083772,Staff,10,0,30,20
1651067639877,MATH 20E,B01,083773,Staff,0,0,30,30
1651067639877,MATH 20E,B02,083774,Staff,0,0,30,30
1651067645902,MATH 103A,A01,083777,Staff,0,17,30,30
1651067645902,MATH 103A,A02,083778,Staff,0,16,30,30
1651067645902,MATH 103A,B01,083779,Staff,0,15,30,30
1651067645902,MATH 103A,B02,083780,Staff,0,14,30,30
1651067651929,MATH 105,A01,085443,Staff,0,23,30,30
1651067657952,MATH 109,A01,083213,Anzaldo; Leesa B,0,7,30,30
1651067657952,MATH 109,A02,083214,Anzaldo; Leesa B,0,7,30,30
1651067657952,MATH 109,B01,083215,Anzaldo; Leesa B,0,8,30,30
1651067657952,MATH 109,B02,083216,Anzaldo; Leesa B,0,8,30,30
1651067663975,MATH 142A,A01,083219,Chow; Bennett,0,15,30,30
1651067663975,MATH 142A,A02,083220,Chow; Bennett,0,15,30,30
1651067663975,MATH 142A,B01,083221,Chow; Bennett,0,16,30,30
1651067663975,MATH 142A,B02,083222,Chow; Bennett,0,15,30,30
1651067669998,MATH 193A,A01,083224,Staff,0,8,30,30
1651067669998,MATH 193A,A02,083225,Staff,0,7,30,30
1651067669998,MATH 193A,A03,083781,Staff,0,7,30,30
1651067669998,MATH 193A,A04,083782,Staff,0,7,30,30
1651067676021,MATH 197,001,091859,McAuley; Julian John,9998,0,9999,1
1651067682075,COGS 9,A01,083615,Staff,0,20,60,60
1651067688099,COGS 11,A01,083617,Boyle; Mary E. T.,13,0,40,27
1651067694122,COGS 13,A01,083071,Staff,0,40,40,40
1651067700147,COGS 14A,A01,092681,Staff,0,40,100,100
1651067706170,COGS 14B,A01,083073,Cheng; Tzu-Han,0,13,50,50
1651067712194,COGS 17,A01,092677,Staff,9,0,75,66
1651067718218,COGS 100,A01,083619,Staff,0,30,60,60
1651067724247,COGS 101A,A01,083621,Davis; Joshua Daniel,0,29,60,60
1651067730274,COGS 101B,A01,091572,Staff,0,7,60,60
1651067736302,COGS 101C,A01,083625,Delgado; Tania,14,0,30,16
1651067742326,COGS 107A,A01,083627,Boyle; Mary E. T.,0,17,60,60
1651067748350,COGS 118A,A01,083075,Staff,0,10,60,60
1651067754375,CSE 3,A50,083646,Miranda; Gregory Joseph,15,0,38,23
1651067754375,CSE 3,A51,083647,Miranda; Gregory Joseph,36,0,37,1
1651067760399,CSE 8A,A50,083650,Miranda; Gregory Joseph,0,31,40,40
1651067766422,CSE 11,A01,083080,Cao; Yingjun,1,97,40,39
1651067772539,CSE 12,A01,083652,Staff,0,27,100,100
1651067778562,CSE 15L,A01,083654,Staff,0,3,50,50
1651067778562,CSE 15L,A02,083655,Staff,0,3,50,50
1651067784589,CSE 20,A01,083657,Staff,46,0,80,34
1651067790615,CSE 30,A01,083084,Eldon; John,0,38,80,80
1651067796640,CSE 100,A01,083659,Cao; Yingjun,0,72,50,50
1651067802669,CSE 134B,A01,083661,Powell; Thomas Allan,0,38,65,65
1651067808692,CSE 140,A01,083663,Staff,0,15,75,75
1651067814716,CSE 140L,A01,083088,Eldon; John,3,0,100,97
1651067820741,CSE 175,A01,083665,Kumar; Rakesh,0,0,25,25
1651067826768,CSE 190,A00,092507,Dubnov; Shlomo,9,0,20,11
1651067832795,ECE 45,A01,083139,Staff,0,7,60,60
1651067838817,ECE 65,A50,083695,Staff,0,7,30,30
1651067844841,ECE 109,A01,091882,Touri; Behrouz,33,0,70,37
1651067850868,ECE 180,A00,083140,Abi Samra; Nicholas Camill,17,0,30,13
1651067850868,ECE 180,B00,083141,Abi Samra; Nicholas Camill,0,0,30,30
1651067856897,MATH 10A,A01,083735,Patchell; Gregory David,0,0,30,30
1651067856897,MATH 10A,A02,083736,Patchell; Gregory David,27,0,30,3
1651067856897,MATH 10A,A03,083737,Patchell; Gregory David,22,0,30,8
1651067862923,MATH 10B,A01,083207,Staff,0,7,30,30
1651067862923,MATH 10B,A02,083208,Staff,0,6,30,30
1651067862923,MATH 10B,B01,083739,Staff,8,0,30,22
1651067862923,MATH 10B,B02,083740,Staff,28,0,30,2
1651067868950,MATH 18,A01,083743,Staff,0,0,30,30
1651067868950,MATH 18,A02,083744,Staff,23,0,30,7
1651067868950,MATH 18,A03,083745,Staff,19,0,30,11
1651067868950,MATH 18,A04,083746,Staff,26,0,30,4
1651067868950,MATH 18,B01,083748,Staff,0,16,30,30
1651067868950,MATH 18,B02,083749,Staff,0,14,30,30
1651067868950,MATH 18,B03,083750,Staff,0,14,30,30
1651067868950,MATH 18,B04,083751,Staff,0,13,30,30
1651067874974,MATH 20A,A01,083754,Staff,18,0,40,22
1651067881007,MATH 20B,A01,083756,Staff,0,14,30,30
1651067881007,MATH 20B,A02,083757,Staff,0,11,30,30
1651067887035,MATH 20C,A01,083760,Staff,0,16,30,30
1651067887035,MATH 20C,A02,083761,Staff,0,15,30,30
1651067887035,MATH 20C,B01,083762,Staff,8,0,30,22
1651067887035,MATH 20C,B02,083763,Staff,28,0,30,2
1651067893063,MATH 20D,A01,083765,Staff,3,1,30,27
1651067893063,MATH 20D,A02,083766,Staff,1,0,30,29
1651067893063,MATH 20D,A03,083767,Staff,22,0,30,8
1651067899091,MATH 20E,A01,083771,Staff,2,0,30,28
1651067899091,MATH 20E,A02,083772,Staff,10,0,30,20
1651067899091,MATH 20E,B01,083773,Staff,0,0,30,30
1651067899091,MATH 20E,B02,083774,Staff,0,0,30,30
1651067905116,MATH 103A,A01,083777,Staff,0,17,30,30
1651067905116,MATH 103A,A02,083778,Staff,0,16,30,30
1651067905116,MATH 103A,B01,083779,Staff,0,15,30,30
1651067905116,MATH 103A,B02,083780,Staff,0,14,30,30
1651067911138,MATH 105,A01,085443,Staff,0,23,30,30
1651067917163,MATH 109,A01,083213,Anzaldo; Leesa B,0,7,30,30
1651067917163,MATH 109,A02,083214,Anzaldo; Leesa B,0,7,30,30
1651067917163,MATH 109,B01,083215,Anzaldo; Leesa B,0,8,30,30
1651067917163,MATH 109,B02,083216,Anzaldo; Leesa B,0,8,30,30
1651067923187,MATH 142A,A01,083219,Chow; Bennett,0,15,30,30
1651067923187,MATH 142A,A02,083220,Chow; Bennett,0,15,30,30
1651067923187,MATH 142A,B01,083221,Chow; Bennett,0,16,30,30
1651067923187,MATH 142A,B02,083222,Chow; Bennett,0,15,30,30
1651067929214,MATH 193A,A01,083224,Staff,0,8,30,30
1651067929214,MATH 193A,A02,083225,Staff,0,7,30,30
1651067929214,MATH 193A,A03,083781,Staff,0,7,30,30
1651067929214,MATH 193A,A04,083782,Staff,0,7,30,30
1651067935241,MATH 197,001,091859,McAuley; Julian John,9998,0,9999,1
1651067941305,COGS 9,A01,083615,Staff,0,20,60,60
1651067947332,COGS 11,A01,083617,Boyle; Mary E. T.,13,0,40,27
1651067953361,COGS 13,A01,083071,Staff,0,40,40,40
1651067959387,COGS 14A,A01,092681,Staff,0,40,100,100
1651067965412,COGS 14B,A01,083073,Cheng; Tzu-Han,0,13,50,50
1651067971437,COGS 17,A01,092677,Staff,9,0,75,66
1651067977462,COGS 100,A01,083619,Staff,0,30,60,60
1651067983487,COGS 101A,A01,083621,Davis; Joshua Daniel,0,29,60,60
1651067989510,COGS 101B,A01,091572,Staff,0,7,60,60
1651067995534,COGS 101C,A01,083625,Delgado; Tania,14,0,30,16
1651068001564,COGS 107A,A01,083627,Boyle; Mary E. T.,0,17,60,60
1651068007593,COGS 118A,A01,083075,Staff,0,10,60,60
1651068013617,CSE 3,A50,083646,Miranda; Gregory Joseph,15,0,38,23
1651068013617,CSE 3,A51,083647,Miranda; Gregory Joseph,36,0,37,1
1651068019646,CSE 8A,A50,083650,Miranda; Gregory Joseph,0,31,40,40
1651068025670,CSE 11,A01,083080,Cao; Yingjun,1,97,40,39
1651068031696,CSE 12,A01,083652,Staff,0,27,100,100
1651068037720,CSE 15L,A01,083654,Staff,0,3,50,50
1651068037720,CSE 15L,A02,083655,Staff,0,3,50,50
1651068043745,CSE 20,A01,083657,Staff,46,0,80,34
1651068049770,CSE 30,A01,083084,Eldon; John,0,38,80,80
1651068055798,CSE 100,A01,083659,Cao; Yingjun,0,72,50,50
1651068061826,CSE 134B,A01,083661,Powell; Thomas Allan,0,38,65,65
1651068067857,CSE 140,A01,083663,Staff,0,15,75,75
1651068073881,CSE 140L,A01,083088,Eldon; John,3,0,100,97
1651068079908,CSE 175,A01,083665,Kumar; Rakesh,0,0,25,25
1651068085949,CSE 190,A00,092507,Dubnov; Shlomo,9,0,20,11
1651068091978,ECE 45,A01,083139,Staff,0,7,60,60
1651068098004,ECE 65,A50,083695,Staff,0,7,30,30
1651068104031,ECE 109,A01,091882,Touri; Behrouz,33,0,70,37
1651068110056,ECE 180,A00,083140,Abi Samra; Nicholas Camill,17,0,30,13
1651068110056,ECE 180,B00,083141,Abi Samra; Nicholas Camill,0,0,30,30
1651068116090,MATH 10A,A01,083735,Patchell; Gregory David,0,0,30,30
1651068116090,MATH 10A,A02,083736,Patchell; Gregory David,27,0,30,3
1651068116090,MATH 10A,A03,083737,Patchell; Gregory David,22,0,30,8
1651068122113,MATH 10B,A01,083207,Staff,0,7,30,30
1651068122113,MATH 10B,A02,083208,Staff,0,6,30,30
1651068122113,MATH 10B,B01,083739,Staff,8,0,30,22
1651068122113,MATH 10B,B02,083740,Staff,28,0,30,2
1651068128192,MATH 18,A01,083743,Staff,0,0,30,30
1651068128192,MATH 18,A02,083744,Staff,23,0,30,7
1651068128192,MATH 18,A03,083745,Staff,19,0,30,11
1651068128192,MATH 18,A04,083746,Staff,26,0,30,4
1651068128192,MATH 18,B01,083748,Staff,0,16,30,30
1651068128192,MATH 18,B02,083749,Staff,0,14,30,30
1651068128192,MATH 18,B03,083750,Staff,0,14,30,30
1651068128192,MATH 18,B04,083751,Staff,0,13,30,30
1651068134221,MATH 20A,A01,083754,Staff,18,0,40,22
1651068140244,MATH 20B,A01,083756,Staff,0,14,30,30
1651068140244,MATH 20B,A02,083757,Staff,0,11,30,30
1651068146274,MATH 20C,A01,083760,Staff,0,16,30,30
1651068146274,MATH 20C,A02,083761,Staff,0,15,30,30
1651068146274,MATH 20C,B01,083762,Staff,8,0,30,22
1651068146274,MATH 20C,B02,083763,Staff,28,0,30,2
1651068152310,MATH 20D,A01,083765,Staff,3,1,30,27
1651068152310,MATH 20D,A02,083766,Staff,1,0,30,29
1651068152310,MATH 20D,A03,083767,Staff,22,0,30,8
1651068158339,MATH 20E,A01,083771,Staff,2,0,30,28
1651068158339,MATH 20E,A02,083772,Staff,10,0,30,20
1651068158339,MATH 20E,B01,083773,Staff,0,0,30,30
1651068158339,MATH 20E,B02,083774,Staff,0,0,30,30
1651068164368,MATH 103A,A01,083777,Staff,0,17,30,30
1651068164368,MATH 103A,A02,083778,Staff,0,16,30,30
1651068164368,MATH 103A,B01,083779,Staff,0,15,30,30
1651068164368,MATH 103A,B02,083780,Staff,0,14,30,30
1651068170398,MATH 105,A01,085443,Staff,0,23,30,30
1651068176421,MATH 109,A01,083213,Anzaldo; Leesa B,0,7,30,30
1651068176421,MATH 109,A02,083214,Anzaldo; Leesa B,0,7,30,30
1651068176421,MATH 109,B01,083215,Anzaldo; Leesa B,0,8,30,30
1651068176421,MATH 109,B02,083216,Anzaldo; Leesa B,0,8,30,30
1651068182447,MATH 142A,A01,083219,Chow; Bennett,0,15,30,30
1651068182447,MATH 142A,A02,083220,Chow; Bennett,0,15,30,30
1651068182447,MATH 142A,B01,083221,Chow; Bennett,0,16,30,30
1651068182447,MATH 142A,B02,083222,Chow; Bennett,0,15,30,30
1651068188484,MATH 193A,A01,083224,Staff,0,8,30,30
1651068188484,MATH 193A,A02,083225,Staff,0,7,30,30
1651068188484,MATH 193A,A03,083781,Staff,0,7,30,30
1651068188484,MATH 193A,A04,083782,Staff,0,7,30,30
1651068194508,MATH 197,001,091859,McAuley; Julian John,9998,0,9999,1
1651068200575,COGS 9,A01,083615,Staff,0,20,60,60
1651068206598,COGS 11,A01,083617,Boyle; Mary E. T.,13,0,40,27
1651068212622,COGS 13,A01,083071,Staff,0,40,40,40
1651068218647,COGS 14A,A01,092681,Staff,0,40,100,100
1651068224673,COGS 14B,A01,083073,Cheng; Tzu-Han,0,13,50,50
1651068230698,COGS 17,A01,092677,Staff,9,0,75,66
1651068236725,COGS 100,A01,083619,Staff,0,30,60,60
1651068242757,COGS 101A,A01,083621,Davis; Joshua Daniel,0,29,60,60
1651068248783,COGS 101B,A01,091572,Staff,0,7,60,60
1651068254807,COGS 101C,A01,083625,Delgado; Tania,14,0,30,16
1651068260832,COGS 107A,A01,083627,Boyle; Mary E. T.,0,17,60,60
1651068266860,COGS 118A,A01,083075,Staff,0,10,60,60
1651068272884,CSE 3,A50,083646,Miranda; Gregory Joseph,15,0,38,23
1651068272884,CSE 3,A51,083647,Miranda; Gregory Joseph,36,0,37,1
1651068278911,CSE 8A,A50,083650,Miranda; Gregory Joseph,0,31,40,40
1651068284939,CSE 11,A01,083080,Cao; Yingjun,1,97,40,39
1651068290965,CSE 12,A01,083652,Staff,0,27,100,100
1651068296996,CSE 15L,A01,083654,Staff,0,3,50,50
1651068296996,CSE 15L,A02,083655,Staff,0,3,50,50
1651068303021,CSE 20,A01,083657,Staff,46,0,80,34
1651068309046,CSE 30,A01,083084,Eldon; John,0,38,80,80
1651068315077,CSE 100,A01,083659,Cao; Yingjun,0,72,50,50
1651068321105,CSE 134B,A01,083661,Powell; Thomas Allan,0,38,65,65
1651068327128,CSE 140,A01,083663,Staff,0,15,75,75
1651068333165,CSE 140L,A01,083088,Eldon; John,3,0,100,97
1651068339189,CSE 175,A01,083665,Kumar; Rakesh,0,0,25,25
1651068345216,CSE 190,A00,092507,Dubnov; Shlomo,9,0,20,11
1651068351250,ECE 45,A01,083139,Staff,0,7,60,60
1651068357289,ECE 65,A50,083695,Staff,0,7,30,30
1651068363317,ECE 109,A01,091882,Touri; Behrouz,33,0,70,37
1651068369449,ECE 180,A00,083140,Abi Samra; Nicholas Camill,17,0,30,13
1651068369449,ECE 180,B00,083141,Abi Samra; Nicholas Camill,0,0,30,30
1651068375472,MATH 10A,A01,083735,Patchell; Gregory David,0,0,30,30
1651068375472,MATH 10A,A02,083736,Patchell; Gregory David,27,0,30,3
1651068375472,MATH 10A,A03,083737,Patchell; Gregory David,22,0,30,8
1651068381495,MATH 10B,A01,083207,Staff,0,7,30,30
1651068381495,MATH 10B,A02,083208,Staff,0,6,30,30
1651068381495,MATH 10B,B01,083739,Staff,8,0,30,22
1651068381495,MATH 10B,B02,083740,Staff,28,0,30,2
1651068387525,MATH 18,A01,083743,Staff,0,0,30,30
1651068387525,MATH 18,A02,083744,Staff,23,0,30,7
1651068387525,MATH 18,A03,083745,Staff,19,0,30,11
1651068387525,MATH 18,A04,083746,Staff,26,0,30,4
1651068387525,MATH 18,B01,083748,Staff,0,16,30,30
1651068387525,MATH 18,B02,083749,Staff,0,14,30,30
1651068387525,MATH 18,B03,083750,Staff,0,14,30,30
1651068387525,MATH 18,B04,083751,Staff,0,13,30,30
1651068393552,MATH 20A,A01,083754,Staff,18,0,40,22
1651068399575,MATH 20B,A01,083756,Staff,0,14,30,30
1651068399575,MATH 20B,A02,083757,Staff,0,11,30,30
1651068405603,MATH 20C,A01,083760,Staff,0,16,30,30
1651068405603,MATH 20C,A02,083761,Staff,0,15,30,30
1651068405603,MATH 20C,B01,083762,Staff,8,0,30,22
1651068405603,MATH 20C,B02,083763,Staff,28,0,30,2
1651068411635,MATH 20D,A01,083765,Staff,3,1,30,27
1651068411635,MATH 20D,A02,083766,Staff,1,0,30,29
1651068411635,MATH 20D,A03,083767,Staff,22,0,30,8
1651068417659,MATH 20E,A01,083771,Staff,2,0,30,28
1651068417659,MATH 20E,A02,083772,Staff,10,0,30,20
1651068417659,MATH 20E,B01,083773,Staff,0,0,30,30
1651068417659,MATH 20E,B02,083774,Staff,0,0,30,30
1651068423688,MATH 103A,A01,083777,Staff,0,17,30,30
1651068423688,MATH 103A,A02,083778,Staff,0,16,30,30
1651068423688,MATH 103A,B01,083779,Staff,0,15,30,30
1651068423688,MATH 103A,B02,083780,Staff,0,14,30,30
1651068429711,MATH 105,A01,085443,Staff,0,23,30,30
1651068435739,MATH 109,A01,083213,Anzaldo; Leesa B,0,7,30,30
1651068435739,MATH 109,A02,083214,Anzaldo; Leesa B,0,7,30,30
1651068435739,MATH 109,B01,083215,Anzaldo; Leesa B,0,8,30,30
1651068435739,MATH 109,B02,083216,Anzaldo; Leesa B,0,8,30,30
1651068441769,MATH 142A,A01,083219,Chow; Bennett,0,15,30,30
1651068441769,MATH 142A,A02,083220,Chow; Bennett,0,15,30,30
1651068441769,MATH 142A,B01,083221,Chow; Bennett,0,16,30,30
1651068441769,MATH 142A,B02,083222,Chow; Bennett,0,15,30,30
1651068447796,MATH 193A,A01,083224,Staff,0,8,30,30
1651068447796,MATH 193A,A02,083225,Staff,0,7,30,30
1651068447796,MATH 193A,A03,083781,Staff,0,7,30,30
1651068447796,MATH 193A,A04,083782,Staff,0,7,30,30
1651068453821,MATH 197,001,091859,McAuley; Julian John,9998,0,9999,1
1651068459879,COGS 9,A01,083615,Staff,0,20,60,60
1651068465905,COGS 11,A01,083617,Boyle; Mary E. T.,13,0,40,27
1651068471929,COGS 13,A01,083071,Staff,0,40,40,40
1651068477955,COGS 14A,A01,092681,Staff,0,40,100,100
1651068483986,COGS 14B,A01,083073,Cheng; Tzu-Han,0,13,50,50
1651068490056,COGS 17,A01,092677,Staff,9,0,75,66
1651068496080,COGS 100,A01,083619,Staff,0,30,60,60
1651068502104,COGS 101A,A01,083621,Davis; Joshua Daniel,0,29,60,60
1651068508130,COGS 101B,A01,091572,Staff,0,7,60,60
1651068514157,COGS 101C,A01,083625,Delgado; Tania,14,0,30,16
1651068520197,COGS 107A,A01,083627,Boyle; Mary E. T.,0,17,60,60
1651068526222,COGS 118A,A01,083075,Staff,0,10,60,60
1651068532247,CSE 3,A50,083646,Miranda; Gregory Joseph,15,0,38,23
1651068532247,CSE 3,A51,083647,Miranda; Gregory Joseph,36,0,37,1
1651068538272,CSE 8A,A50,083650,Miranda; Gregory Joseph,0,31,40,40
1651068544296,CSE 11,A01,083080,Cao; Yingjun,1,97,40,39
1651068550318,CSE 12,A01,083652,Staff,0,27,100,100
1651068556355,CSE 15L,A01,083654,Staff,0,3,50,50
1651068556355,CSE 15L,A02,083655,Staff,0,3,50,50
1651068562381,CSE 20,A01,083657,Staff,46,0,80,34
1651068568404,CSE 30,A01,083084,Eldon; John,0,38,80,80
1651068574432,CSE 100,A01,083659,Cao; Yingjun,0,72,50,50
1651068580456,CSE 134B,A01,083661,Powell; Thomas Allan,0,38,65,65
1651068586480,CSE 140,A01,083663,Staff,0,15,75,75
1651068592502,CSE 140L,A01,083088,Eldon; John,3,0,100,97
1651068598525,CSE 175,A01,083665,Kumar; Rakesh,0,0,25,25
1651068604547,CSE 190,A00,092507,Dubnov; Shlomo,9,0,20,11
1651068610573,ECE 45,A01,083139,Staff,0,7,60,60
1651068616597,ECE 65,A50,083695,Staff,0,7,30,30
1651068622624,ECE 109,A01,091882,Touri; Behrouz,33,0,70,37
1651068628650,ECE 180,A00,083140,Abi Samra; Nicholas Camill,17,0,30,13
1651068628650,ECE 180,B00,083141,Abi Samra; Nicholas Camill,0,0,30,30
1651068634679,MATH 10A,A01,083735,Patchell; Gregory David,0,0,30,30
1651068634679,MATH 10A,A02,083736,Patchell; Gregory David,27,0,30,3
1651068634679,MATH 10A,A03,083737,Patchell; Gregory David,22,0,30,8
1651068640704,MATH 10B,A01,083207,Staff,0,7,30,30
1651068640704,MATH 10B,A02,083208,Staff,0,6,30,30
1651068640704,MATH 10B,B01,083739,Staff,8,0,30,22
1651068640704,MATH 10B,B02,083740,Staff,28,0,30,2
1651068646734,MATH 18,A01,083743,Staff,0,0,30,30
1651068646734,MATH 18,A02,083744,Staff,23,0,30,7
1651068646734,MATH 18,A03,083745,Staff,19,0,30,11
1651068646734,MATH 18,A04,083746,Staff,26,0,30,4
1651068646734,MATH 18,B01,083748,Staff,0,16,30,30
1651068646734,MATH 18,B02,083749,Staff,0,14,30,30
1651068646734,MATH 18,B03,083750,Staff,0,14,30,30
1651068646734,MATH 18,B04,083751,Staff,0,13,30,30
1651068652760,MATH 20A,A01,083754,Staff,18,0,40,22
1651068658792,MATH 20B,A01,083756,Staff,0,14,30,30
1651068658792,MATH 20B,A02,083757,Staff,0,11,30,30
1651068664827,MATH 20C,A01,083760,Staff,0,16,30,30
1651068664827,MATH 20C,A02,083761,Staff,0,15,30,30
1651068664827,MATH 20C,B01,083762,Staff,8,0,30,22
1651068664827,MATH 20C,B02,083763,Staff,28,0,30,2
1651068670856,MATH 20D,A01,083765,Staff,3,1,30,27
1651068670856,MATH 20D,A02,083766,Staff,1,0,30,29
1651068670856,MATH 20D,A03,083767,Staff,22,0,30,8
1651068676880,MATH 20E,A01,083771,Staff,2,0,30,28
1651068676880,MATH 20E,A02,083772,Staff,10,0,30,20
1651068676880,MATH 20E,B01,083773,Staff,0,0,30,30
1651068676880,MATH 20E,B02,083774,Staff,0,0,30,30
1651068682905,MATH 103A,A01,083777,Staff,0,17,30,30
1651068682905,MATH 103A,A02,083778,Staff,0,16,30,30
1651068682905,MATH 103A,B01,083779,Staff,0,15,30,30
1651068682905,MATH 103A,B02,083780,Staff,0,14,30,30
1651068688928,MATH 105,A01,085443,Staff,0,23,30,30
1651068694957,MATH 109,A01,083213,Anzaldo; Leesa B,0,7,30,30
1651068694957,MATH 109,A02,083214,Anzaldo; Leesa B,0,7,30,30
1651068694957,MATH 109,B01,083215,Anzaldo; Leesa B,0,8,30,30
1651068694957,MATH 109,B02,083216,Anzaldo; Leesa B,0,8,30,30
1651068700982,MATH 142A,A01,083219,Chow; Bennett,0,15,30,30
1651068700982,MATH 142A,A02,083220,Chow; Bennett,0,15,30,30
1651068700982,MATH 142A,B01,083221,Chow; Bennett,0,16,30,30
1651068700982,MATH 142A,B02,083222,Chow; Bennett,0,15,30,30
1651068707020,MATH 193A,A01,083224,Staff,0,8,30,30
1651068707020,MATH 193A,A02,083225,Staff,0,7,30,30
1651068707020,MATH 193A,A03,083781,Staff,0,7,30,30
1651068707020,MATH 193A,A04,083782,Staff,0,7,30,30
1651068713044,MATH 197,001,091859,McAuley; Julian John,9998,0,9999,1
1651068719103,COGS 9,A01,083615,Staff,0,20,60,60
1651068725127,COGS 11,A01,083617,Boyle; Mary E. T.,13,0,40,27
1651068731151,COGS 13,A01,083071,Staff,0,40,40,40
1651068737175,COGS 14A,A01,092681,Staff,0,40,100,100
1651068743199,COGS 14B,A01,083073,Cheng; Tzu-Han,0,13,50,50
1651068749224,COGS 17,A01,092677,Staff,9,0,75,66
1651068755249,COGS 100,A01,083619,Staff,0,30,60,60
1651068761274,COGS 101A,A01,083621,Davis; Joshua Daniel,0,29,60,60
1651068767298,COGS 101B,A01,091572,Staff,0,7,60,60
1651068773327,COGS 101C,A01,083625,Delgado; Tania,14,0,30,16
1651068779353,COGS 107A,A01,083627,Boyle; Mary E. T.,0,17,60,60
1651068785376,COGS 118A,A01,083075,Staff,0,10,60,60
1651068791401,CSE 3,A50,083646,Miranda; Gregory Joseph,15,0,38,23
1651068791401,CSE 3,A51,083647,Miranda; Gregory Joseph,36,0,37,1
1651068797425,CSE 8A,A50,083650,Miranda; Gregory Joseph,0,31,40,40
1651068803447,CSE 11,A01,083080,Cao; Yingjun,1,97,40,39
1651068809472,CSE 12,A01,083652,Staff,0,27,100,100
1651068815496,CSE 15L,A01,083654,Staff,0,3,50,50
1651068815496,CSE 15L,A02,083655,Staff,0,3,50,50
1651068821518,CSE 20,A01,083657,Staff,46,0,80,34
1651068827543,CSE 30,A01,083084,Eldon; John,0,38,80,80
1651068833566,CSE 100,A01,083659,Cao; Yingjun,0,72,50,50
1651068839599,CSE 134B,A01,083661,Powell; Thomas Allan,0,38,65,65
1651068845625,CSE 140,A01,083663,Staff,0,15,75,75
1651068851647,CSE 140L,A01,083088,Eldon; John,3,0,100,97
1651068857674,CSE 175,A01,083665,Kumar; Rakesh,0,0,25,25
1651068863702,CSE 190,A00,092507,Dubnov; Shlomo,9,0,20,11
1651068869729,ECE 45,A01,083139,Staff,0,7,60,60
1651068875758,ECE 65,A50,083695,Staff,0,7,30,30
1651068881781,ECE 109,A01,091882,Touri; Behrouz,33,0,70,37
1651068887810,ECE 180,A00,083140,Abi Samra; Nicholas Camill,17,0,30,13
1651068887810,ECE 180,B00,083141,Abi Samra; Nicholas Camill,0,0,30,30
1651068893849,MATH 10A,A01,083735,Patchell; Gregory David,0,0,30,30
1651068893849,MATH 10A,A02,083736,Patchell; Gregory David,27,0,30,3
1651068893849,MATH 10A,A03,083737,Patchell; Gregory David,22,0,30,8
1651068899872,MATH 10B,A01,083207,Staff,0,7,30,30
1651068899872,MATH 10B,A02,083208,Staff,0,6,30,30
1651068899872,MATH 10B,B01,083739,Staff,8,0,30,22
1651068899872,MATH 10B,B02,083740,Staff,28,0,30,2
1651068905906,MATH 18,A01,083743,Staff,0,0,30,30
1651068905906,MATH 18,A02,083744,Staff,23,0,30,7
1651068905906,MATH 18,A03,083745,Staff,19,0,30,11
1651068905906,MATH 18,A04,083746,Staff,26,0,30,4
1651068905906,MATH 18,B01,083748,Staff,0,16,30,30
1651068905906,MATH 18,B02,083749,Staff,0,14,30,30
1651068905906,MATH 18,B03,083750,Staff,0,14,30,30
1651068905906,MATH 18,B04,083751,Staff,0,13,30,30
1651068911933,MATH 20A,A01,083754,Staff,18,0,40,22
1651068917958,MATH 20B,A01,083756,Staff,0,14,30,30
1651068917958,MATH 20B,A02,083757,Staff,0,11,30,30
1651068923995,MATH 20C,A01,083760,Staff,0,16,30,30
1651068923995,MATH 20C,A02,083761,Staff,0,15,30,30
1651068923995,MATH 20C,B01,083762,Staff,8,0,30,22
1651068923995,MATH 20C,B02,083763,Staff,28,0,30,2
1651068930020,MATH 20D,A01,083765,Staff,3,1,30,27
1651068930020,MATH 20D,A02,083766,Staff,1,0,30,29
1651068930020,MATH 20D,A03,083767,Staff,22,0,30,8
1651068936043,MATH 20E,A01,083771,Staff,2,0,30,28
1651068936043,MATH 20E,A02,083772,Staff,10,0,30,20
1651068936043,MATH 20E,B01,083773,Staff,0,0,30,30
1651068936043,MATH 20E,B02,083774,Staff,0,0,30,30
1651068942071,MATH 103A,A01,083777,Staff,0,17,30,30
1651068942071,MATH 103A,A02,083778,Staff,0,16,30,30
1651068942071,MATH 103A,B01,083779,Staff,0,15,30,30
1651068942071,MATH 103A,B02,083780,Staff,0,14,30,30
1651068948094,MATH 105,A01,085443,Staff,0,23,30,30
1651068954131,MATH 109,A01,083213,Anzaldo; Leesa B,0,7,30,30
1651068954131,MATH 109,A02,083214,Anzaldo; Leesa B,0,7,30,30
1651068954131,MATH 109,B01,083215,Anzaldo; Leesa B,0,8,30,30
1651068954131,MATH 109,B02,083216,Anzaldo; Leesa B,0,8,30,30
1651068960160,MATH 142A,A01,083219,Chow; Bennett,0,15,30,30
1651068960160,MATH 142A,A02,083220,Chow; Bennett,0,15,30,30
1651068960160,MATH 142A,B01,083221,Chow; Bennett,0,16,30,30
1651068960160,MATH 142A,B02,083222,Chow; Bennett,0,15,30,30
1651068966274,MATH 193A,A01,083224,Staff,0,8,30,30
1651068966274,MATH 193A,A02,083225,Staff,0,7,30,30
1651068966274,MATH 193A,A03,083781,Staff,0,7,30,30
1651068966274,MATH 193A,A04,083782,Staff,0,7,30,30
1651068972298,MATH 197,001,091859,McAuley; Julian John,9998,0,9999,1
1651068978353,COGS 9,A01,083615,Staff,0,20,60,60
1651068984379,COGS 11,A01,083617,Boyle; Mary E. T.,13,0,40,27
1651068990403,COGS 13,A01,083071,Staff,0,40,40,40
1651068996430,COGS 14A,A01,092681,Staff,0,40,100,100
1651069002454,COGS 14B,A01,083073,Cheng; Tzu-Han,0,13,50,50
1651069008494,COGS 17,A01,092677,Staff,9,0,75,66
1651069014518,COGS 100,A01,083619,Staff,0,30,60,60
1651069020550,COGS 101A,A01,083621,Davis; Joshua Daniel,0,29,60,60
1651069026574,COGS 101B,A01,091572,Staff,0,7,60,60
1651069032610,COGS 101C,A01,083625,Delgado; Tania,14,0,30,16
1651069038632,COGS 107A,A01,083627,Boyle; Mary E. T.,0,17,60,60
1651069044656,COGS 118A,A01,083075,Staff,0,10,60,60
1651069050682,CSE 3,A50,083646,Miranda; Gregory Joseph,15,0,38,23
1651069050682,CSE 3,A51,083647,Miranda; Gregory Joseph,36,0,37,1
1651069056709,CSE 8A,A50,083650,Miranda; Gregory Joseph,0,31,40,40
1651069062737,CSE 11,A01,083080,Cao; Yingjun,1,97,40,39
1651069068761,CSE 12,A01,083652,Staff,0,27,100,100
1651069074788,CSE 15L,A01,083654,Staff,0,3,50,50
1651069074788,CSE 15L,A02,083655,Staff,0,3,50,50
1651069080811,CSE 20,A01,083657,Staff,46,0,80,34
1651069086836,CSE 30,A01,083084,Eldon; John,0,38,80,80
1651069092861,CSE 100,A01,083659,Cao; Yingjun,0,72,50,50
1651069098884,CSE 134B,A01,083661,Powell; Thomas Allan,0,38,65,65
1651069104910,CSE 140,A01,083663,Staff,0,15,75,75
1651069110940,CSE 140L,A01,083088,Eldon; John,3,0,100,97
1651069116963,CSE 175,A01,083665,Kumar; Rakesh,0,0,25,25
1651069122987,CSE 190,A00,092507,Dubnov; Shlomo,9,0,20,11
1651069129013,ECE 45,A01,083139,Staff,0,7,60,60
1651069135036,ECE 65,A50,083695,Staff,0,7,30,30
1651069141062,ECE 109,A01,091882,Touri; Behrouz,33,0,70,37
1651069147089,ECE 180,A00,083140,Abi Samra; Nicholas Camill,17,0,30,13
1651069147089,ECE 180,B00,083141,Abi Samra; Nicholas Camill,0,0,30,30
1651069153124,MATH 10A,A01,083735,Patchell; Gregory David,0,0,30,30
1651069153124,MATH 10A,A02,083736,Patchell; Gregory David,27,0,30,3
1651069153124,MATH 10A,A03,083737,Patchell; Gregory David,22,0,30,8
1651069159148,MATH 10B,A01,083207,Staff,0,7,30,30
1651069159148,MATH 10B,A02,083208,Staff,0,6,30,30
1651069159148,MATH 10B,B01,083739,Staff,8,0,30,22
1651069159148,MATH 10B,B02,083740,Staff,28,0,30,2
1651069165175,MATH 18,A01,083743,Staff,0,0,30,30
1651069165175,MATH 18,A02,083744,Staff,23,0,30,7
1651069165175,MATH 18,A03,083745,Staff,19,0,30,11
1651069165175,MATH 18,A04,083746,Staff,26,0,30,4
1651069165175,MATH 18,B01,083748,Staff,0,16,30,30
1651069165175,MATH 18,B02,083749,Staff,0,14,30,30
1651069165175,MATH 18,B03,083750,Staff,0,14,30,30
1651069165175,MATH 18,B04,083751,Staff,0,13,30,30
1651069171201,MATH 20A,A01,083754,Staff,18,0,40,22
1651069177225,MATH 20B,A01,083756,Staff,0,14,30,30
1651069177225,MATH 20B,A02,083757,Staff,0,11,30,30
1651069183249,MATH 20C,A01,083760,Staff,0,16,30,30
1651069183249,MATH 20C,A02,083761,Staff,0,15,30,30
1651069183249,MATH 20C,B01,083762,Staff,8,0,30,22
1651069183249,MATH 20C,B02,083763,Staff,28,0,30,2
1651069189277,MATH 20D,A01,083765,Staff,3,1,30,27
1651069189277,MATH 20D,A02,083766,Staff,1,0,30,29
1651069189277,MATH 20D,A03,083767,Staff,22,0,30,8
1651069195302,MATH 20E,A01,083771,Staff,2,0,30,28
1651069195302,MATH 20E,A02,083772,Staff,10,0,30,20
1651069195302,MATH 20E,B01,083773,Staff,0,0,30,30
1651069195302,MATH 20E,B02,083774,Staff,0,0,30,30
1651069201344,MATH 103A,A01,083777,Staff,0,17,30,30
1651069201344,MATH 103A,A02,083778,Staff,0,16,30,30
1651069201344,MATH 103A,B01,083779,Staff,0,15,30,30
1651069201344,MATH 103A,B02,083780,Staff,0,14,30,30
1651069207372,MATH 105,A01,085443,Staff,0,23,30,30
1651069213397,MATH 109,A01,083213,Anzaldo; Leesa B,0,7,30,30
1651069213397,MATH 109,A02,083214,Anzaldo; Leesa B,0,7,30,30
1651069213397,MATH 109,B01,083215,Anzaldo; Leesa B,0,8,30,30
1651069213397,MATH 109,B02,083216,Anzaldo; Leesa B,0,8,30,30
1651069219427,MATH 142A,A01,083219,Chow; Bennett,0,15,30,30
1651069219427,MATH 142A,A02,083220,Chow; Bennett,0,15,30,30
1651069219427,MATH 142A,B01,083221,Chow; Bennett,0,16,30,30
1651069219427,MATH 142A,B02,083222,Chow; Bennett,0,15,30,30
1651069225451,MATH 193A,A01,083224,Staff,0,8,30,30
1651069225451,MATH 193A,A02,083225,Staff,0,7,30,30
1651069225451,MATH 193A,A03,083781,Staff,0,7,30,30
1651069225451,MATH 193A,A04,083782,Staff,0,7,30,30
1651069231477,MATH 197,001,091859,McAuley; Julian John,9998,0,9999,1
1651069237537,COGS 9,A01,083615,Staff,0,20,60,60
1651069243566,COGS 11,A01,083617,Boyle; Mary E. T.,13,0,40,27
1651069249594,COGS 13,A01,083071,Staff,0,40,40,40
1651069255619,COGS 14A,A01,092681,Staff,0,40,100,100
1651069261643,COGS 14B,A01,083073,Cheng; Tzu-Han,0,13,50,50
1651069267670,COGS 17,A01,092677,Staff,9,0,75,66
1651069273693,COGS 100,A01,083619,Staff,0,30,60,60
1651069279717,COGS 101A,A01,083621,Davis; Joshua Daniel,0,29,60,60
1651069285739,COGS 101B,A01,091572,Staff,0,7,60,60
1651069291764,COGS 101C,A01,083625,Delgado; Tania,14,0,30,16
1651069297788,COGS 107A,A01,083627,Boyle; Mary E. T.,0,17,60,60
1651069303815,COGS 118A,A01,083075,Staff,0,10,60,60
1651069309841,CSE 3,A50,083646,Miranda; Gregory Joseph,15,0,38,23
1651069309841,CSE 3,A51,083647,Miranda; Gregory Joseph,36,0,37,1
1651069315864,CSE 8A,A50,083650,Miranda; Gregory Joseph,0,31,40,40
1651069321890,CSE 11,A01,083080,Cao; Yingjun,1,97,40,39
1651069327918,CSE 12,A01,083652,Staff,0,27,100,100
1651069333944,CSE 15L,A01,083654,Staff,0,3,50,50
1651069333944,CSE 15L,A02,083655,Staff,0,3,50,50
1651069339967,CSE 20,A01,083657,Staff,46,0,80,34
1651069345993,CSE 30,A01,083084,Eldon; John,0,38,80,80
1651069352018,CSE 100,A01,083659,Cao; Yingjun,0,72,50,50
1651069358059,CSE 134B,A01,083661,Powell; Thomas Allan,0,38,65,65
1651069364087,CSE 140,A01,083663,Staff,0,15,75,75
1651069370113,CSE 140L,A01,083088,Eldon; John,3,0,100,97
1651069376139,CSE 175,A01,083665,Kumar; Rakesh,0,0,25,25
1651069382163,CSE 190,A00,092507,Dubnov; Shlomo,9,0,20,11
1651069388185,ECE 45,A01,083139,Staff,0,7,60,60
1651069394208,ECE 65,A50,083695,Staff,0,7,30,30
1651069400231,ECE 109,A01,091882,Touri; Behrouz,33,0,70,37
1651069406256,ECE 180,A00,083140,Abi Samra; Nicholas Camill,17,0,30,13
1651069406256,ECE 180,B00,083141,Abi Samra; Nicholas Camill,0,0,30,30
1651069412280,MATH 10A,A01,083735,Patchell; Gregory David,0,0,30,30
1651069412280,MATH 10A,A02,083736,Patchell; Gregory David,27,0,30,3
1651069412280,MATH 10A,A03,083737,Patchell; Gregory David,22,0,30,8
1651069418308,MATH 10B,A01,083207,Staff,0,7,30,30
1651069418308,MATH 10B,A02,083208,Staff,0,6,30,30
1651069418308,MATH 10B,B01,083739,Staff,8,0,30,22
1651069418308,MATH 10B,B02,083740,Staff,28,0,30,2
1651069424332,MATH 18,A01,083743,Staff,0,0,30,30
1651069424332,MATH 18,A02,083744,Staff,23,0,30,7
1651069424332,MATH 18,A03,083745,Staff,19,0,30,11
1651069424332,MATH 18,A04,083746,Staff,26,0,30,4
1651069424332,MATH 18,B01,083748,Staff,0,16,30,30
1651069424332,MATH 18,B02,083749,Staff,0,14,30,30
1651069424332,MATH 18,B03,083750,Staff,0,14,30,30
1651069424332,MATH 18,B04,083751,Staff,0,13,30,30
1651069430356,MATH 20A,A01,083754,Staff,18,0,40,22
1651069436383,MATH 20B,A01,083756,Staff,0,14,30,30
1651069436383,MATH 20B,A02,083757,Staff,0,11,30,30
1651069442411,MATH 20C,A01,083760,Staff,0,16,30,30
1651069442411,MATH 20C,A02,083761,Staff,0,15,30,30
1651069442411,MATH 20C,B01,083762,Staff,8,0,30,22
1651069442411,MATH 20C,B02,083763,Staff,28,0,30,2
1651069448434,MATH 20D,A01,083765,Staff,3,1,30,27
1651069448434,MATH 20D,A02,083766,Staff,1,0,30,29
1651069448434,MATH 20D,A03,083767,Staff,22,0,30,8
1651069454457,MATH 20E,A01,083771,Staff,2,0,30,28
1651069454457,MATH 20E,A02,083772,Staff,10,0,30,20
1651069454457,MATH 20E,B01,083773,Staff,0,0,30,30
1651069454457,MATH 20E,B02,083774,Staff,0,0,30,30
1651069460481,MATH 103A,A01,083777,Staff,0,17,30,30
1651069460481,MATH 103A,A02,083778,Staff,0,16,30,30
1651069460481,MATH 103A,B01,083779,Staff,0,15,30,30
1651069460481,MATH 103A,B02,083780,Staff,0,14,30,30
1651069466508,MATH 105,A01,085443,Staff,0,23,30,30
1651069472533,MATH 109,A01,083213,Anzaldo; Leesa B,0,7,30,30
1651069472533,MATH 109,A02,083214,Anzaldo; Leesa B,0,7,30,30
1651069472533,MATH 109,B01,083215,Anzaldo; Leesa B,0,8,30,30
1651069472533,MATH 109,B02,083216,Anzaldo; Leesa B,0,8,30,30
1651069478561,MATH 142A,A01,083219,Chow; Bennett,0,15,30,30
1651069478561,MATH 142A,A02,083220,Chow; Bennett,0,15,30,30
1651069478561,MATH 142A,B01,083221,Chow; Bennett,0,16,30,30
1651069478561,MATH 142A,B02,083222,Chow; Bennett,0,15,30,30
1651069484584,MATH 193A,A01,083224,Staff,0,8,30,30
1651069484584,MATH 193A,A02,083225,Staff,0,7,30,30
1651069484584,MATH 193A,A03,083781,Staff,0,7,30,30
1651069484584,MATH 193A,A04,083782,Staff,0,7,30,30
1651069490611,MATH 197,001,091859,McAuley; Julian John,9998,0,9999,1
1651069496683,COGS 9,A01,083615,Staff,0,20,60,60
1651069502709,COGS 11,A01,083617,Boyle; Mary E. T.,13,0,40,27
1651069508734,COGS 13,A01,083071,Staff,0,40,40,40
1651069514758,COGS 14A,A01,092681,Staff,0,40,100,100
1651069520786,COGS 14B,A01,083073,Cheng; Tzu-Han,0,13,50,50
1651069526811,COGS 17,A01,092677,Staff,9,0,75,66
1651069532834,COGS 100,A01,083619,Staff,0,30,60,60
1651069538857,COGS 101A,A01,083621,Davis; Joshua Daniel,0,29,60,60
1651069544882,COGS 101B,A01,091572,Staff,0,7,60,60
1651069550908,COGS 101C,A01,083625,Delgado; Tania,14,0,30,16
1651069557011,COGS 107A,A01,083627,Boyle; Mary E. T.,0,17,60,60
1651069563035,COGS 118A,A01,083075,Staff,0,10,60,60
1651069569058,CSE 3,A50,083646,Miranda; Gregory Joseph,15,0,38,23
1651069569058,CSE 3,A51,083647,Miranda; Gregory Joseph,36,0,37,1
1651069575087,CSE 8A,A50,083650,Miranda; Gregory Joseph,0,31,40,40
1651069581111,CSE 11,A01,083080,Cao; Yingjun,1,97,40,39
1651069587134,CSE 12,A01,083652,Staff,0,27,100,100
1651069593161,CSE 15L,A01,083654,Staff,0,3,50,50
1651069593161,CSE 15L,A02,083655,Staff,0,3,50,50
1651069599187,CSE 20,A01,083657,Staff,46,0,80,34
1651069605211,CSE 30,A01,083084,Eldon; John,0,38,80,80
1651069611234,CSE 100,A01,083659,Cao; Yingjun,0,72,50,50
1651069617264,CSE 134B,A01,083661,Powell; Thomas Allan,0,38,65,65
1651069623289,CSE 140,A01,083663,Staff,0,15,75,75
1651069629316,CSE 140L,A01,083088,Eldon; John,3,0,100,97
1651069635338,CSE 175,A01,083665,Kumar; Rakesh,0,0,25,25
1651069641366,CSE 190,A00,092507,Dubnov; Shlomo,9,0,20,11
1651069647419,ECE 45,A01,083139,Staff,0,7,60,60
1651069653445,ECE 65,A50,083695,Staff,0,7,30,30
1651069659470,ECE 109,A01,091882,Touri; Behrouz,33,0,70,37
1651069665493,ECE 180,A00,083140,Abi Samra; Nicholas Camill,17,0,30,13
1651069665493,ECE 180,B00,083141,Abi Samra; Nicholas Camill,0,0,30,30
1651069671518,MATH 10A,A01,083735,Patchell; Gregory David,0,0,30,30
1651069671518,MATH 10A,A02,083736,Patchell; Gregory David,27,0,30,3
1651069671518,MATH 10A,A03,083737,Patchell; Gregory David,22,0,30,8
1651069677544,MATH 10B,A01,083207,Staff,0,7,30,30
1651069677544,MATH 10B,A02,083208,Staff,0,6,30,30
1651069677544,MATH 10B,B01,083739,Staff,8,0,30,22
1651069677544,MATH 10B,B02,083740,Staff,28,0,30,2
1651069683572,MATH 18,A01,083743,Staff,0,0,30,30
1651069683572,MATH 18,A02,083744,Staff,23,0,30,7
1651069683572,MATH 18,A03,083745,Staff,19,0,30,11
1651069683572,MATH 18,A04,083746,Staff,26,0,30,4
1651069683572,MATH 18,B01,083748,Staff,0,16,30,30
1651069683572,MATH 18,B02,083749,Staff,0,14,30,30
1651069683572,MATH 18,B03,083750,Staff,0,14,30,30
1651069683572,MATH 18,B04,083751,Staff,0,13,30,30
1651069689599,MATH 20A,A01,083754,Staff,18,0,40,22
1651069695623,MATH 20B,A01,083756,Staff,0,14,30,30
1651069695623,MATH 20B,A02,083757,Staff,0,11,30,30
1651069701650,MATH 20C,A01,083760,Staff,0,16,30,30
1651069701650,MATH 20C,A02,083761,Staff,0,15,30,30
1651069701650,MATH 20C,B01,083762,Staff,8,0,30,22
1651069701650,MATH 20C,B02,083763,Staff,28,0,30,2
1651069707681,MATH 20D,A01,083765,Staff,3,1,30,27
1651069707681,MATH 20D,A02,083766,Staff,1,0,30,29
1651069707681,MATH 20D,A03,083767,Staff,22,0,30,8
1651069713714,MATH 20E,A01,083771,Staff,2,0,30,28
1651069713714,MATH 20E,A02,083772,Staff,10,0,30,20
1651069713714,MATH 20E,B01,083773,Staff,0,0,30,30
1651069713714,MATH 20E,B02,083774,Staff,0,0,30,30
1651069719742,MATH 103A,A01,083777,Staff,0,17,30,30
1651069719742,MATH 103A,A02,083778,Staff,0,16,30,30
1651069719742,MATH 103A,B01,083779,Staff,0,15,30,30
1651069719742,MATH 103A,B02,083780,Staff,0,14,30,30
1651069725765,MATH 105,A01,085443,Staff,0,23,30,30
1651069731789,MATH 109,A01,083213,Anzaldo; Leesa B,0,7,30,30
1651069731789,MATH 109,A02,083214,Anzaldo; Leesa B,0,7,30,30
1651069731789,MATH 109,B01,083215,Anzaldo; Leesa B,0,8,30,30
1651069731789,MATH 109,B02,083216,Anzaldo; Leesa B,0,8,30,30
1651069737814,MATH 142A,A01,083219,Chow; Bennett,0,15,30,30
1651069737814,MATH 142A,A02,083220,Chow; Bennett,0,15,30,30
1651069737814,MATH 142A,B01,083221,Chow; Bennett,0,16,30,30
1651069737814,MATH 142A,B02,083222,Chow; Bennett,0,15,30,30
1651069743839,MATH 193A,A01,083224,Staff,0,8,30,30
1651069743839,MATH 193A,A02,083225,Staff,0,7,30,30
1651069743839,MATH 193A,A03,083781,Staff,0,7,30,30
1651069743839,MATH 193A,A04,083782,Staff,0,7,30,30
1651069749871,MATH 197,001,091859,McAuley; Julian John,9998,0,9999,1
1651069755926,COGS 9,A01,083615,Staff,0,20,60,60
1651069761950,COGS 11,A01,083617,Boyle; Mary E. T.,13,0,40,27
1651069767973,COGS 13,A01,083071,Staff,0,40,40,40
1651069773996,COGS 14A,A01,092681,Staff,0,40,100,100
1651069780021,COGS 14B,A01,083073,Cheng; Tzu-Han,0,13,50,50
1651069786049,COGS 17,A01,092677,Staff,9,0,75,66
1651069792076,COGS 100,A01,083619,Staff,0,30,60,60
1651069798100,COGS 101A,A01,083621,Davis; Joshua Daniel,0,29,60,60
1651069804127,COGS 101B,A01,091572,Staff,0,7,60,60
1651069810155,COGS 101C,A01,083625,Delgado; Tania,14,0,30,16
1651069816181,COGS 107A,A01,083627,Boyle; Mary E. T.,0,17,60,60
1651069822204,COGS 118A,A01,083075,Staff,0,10,60,60
1651069828228,CSE 3,A50,083646,Miranda; Gregory Joseph,15,0,38,23
1651069828228,CSE 3,A51,083647,Miranda; Gregory Joseph,36,0,37,1
1651069834250,CSE 8A,A50,083650,Miranda; Gregory Joseph,0,31,40,40
1651069840282,CSE 11,A01,083080,Cao; Yingjun,1,97,40,39
1651069846307,CSE 12,A01,083652,Staff,0,27,100,100
1651069852338,CSE 15L,A01,083654,Staff,0,3,50,50
1651069852338,CSE 15L,A02,083655,Staff,0,3,50,50
1651069858378,CSE 20,A01,083657,Staff,46,0,80,34
1651069864406,CSE 30,A01,083084,Eldon; John,0,38,80,80
1651069870430,CSE 100,A01,083659,Cao; Yingjun,0,72,50,50
1651069876456,CSE 134B,A01,083661,Powell; Thomas Allan,0,38,65,65
1651069882480,CSE 140,A01,083663,Staff,0,15,75,75
1651069888503,CSE 140L,A01,083088,Eldon; John,3,0,100,97
1651069894530,CSE 175,A01,083665,Kumar; Rakesh,0,0,25,25
1651069900553,CSE 190,A00,092507,Dubnov; Shlomo,9,0,20,11
1651069906577,ECE 45,A01,083139,Staff,0,7,60,60
1651069912604,ECE 65,A50,083695,Staff,0,7,30,30
1651069918628,ECE 109,A01,091882,Touri; Behrouz,33,0,70,37
1651069924650,ECE 180,A00,083140,Abi Samra; Nicholas Camill,17,0,30,13
1651069924650,ECE 180,B00,083141,Abi Samra; Nicholas Camill,0,0,30,30
1651069930674,MATH 10A,A01,083735,Patchell; Gregory David,0,0,30,30
1651069930674,MATH 10A,A02,083736,Patchell; Gregory David,27,0,30,3
1651069930674,MATH 10A,A03,083737,Patchell; Gregory David,22,0,30,8
1651069936700,MATH 10B,A01,083207,Staff,0,7,30,30
1651069936700,MATH 10B,A02,083208,Staff,0,6,30,30
1651069936700,MATH 10B,B01,083739,Staff,8,0,30,22
1651069936700,MATH 10B,B02,083740,Staff,28,0,30,2
1651069942727,MATH 18,A01,083743,Staff,0,0,30,30
1651069942727,MATH 18,A02,083744,Staff,23,0,30,7
1651069942727,MATH 18,A03,083745,Staff,19,0,30,11
1651069942727,MATH 18,A04,083746,Staff,26,0,30,4
1651069942727,MATH 18,B01,083748,Staff,0,16,30,30
1651069942727,MATH 18,B02,083749,Staff,0,14,30,30
1651069942727,MATH 18,B03,083750,Staff,0,14,30,30
1651069942727,MATH 18,B04,083751,Staff,0,13,30,30
1651069948750,MATH 20A,A01,083754,Staff,18,0,40,22
1651069954774,MATH 20B,A01,083756,Staff,0,14,30,30
1651069954774,MATH 20B,A02,083757,Staff,0,11,30,30
1651069960802,MATH 20C,A01,083760,Staff,0,16,30,30
1651069960802,MATH 20C,A02,083761,Staff,0,15,30,30
1651069960802,MATH 20C,B01,083762,Staff,8,0,30,22
1651069960802,MATH 20C,B02,083763,Staff,28,0,30,2
1651069966828,MATH 20D,A01,083765,Staff,3,1,30,27
1651069966828,MATH 20D,A02,083766,Staff,1,0,30,29
1651069966828,MATH 20D,A03,083767,Staff,22,0,30,8
1651069972852,MATH 20E,A01,083771,Staff,2,0,30,28
1651069972852,MATH 20E,A02,083772,Staff,10,0,30,20
1651069972852,MATH 20E,B01,083773,Staff,0,0,30,30
1651069972852,MATH 20E,B02,083774,Staff,0,0,30,30
1651069978878,MATH 103A,A01,083777,Staff,0,17,30,30
1651069978878,MATH 103A,A02,083778,Staff,0,16,30,30
1651069978878,MATH 103A,B01,083779,Staff,0,15,30,30
1651069978878,MATH 103A,B02,083780,Staff,0,14,30,30
1651069984907,MATH 105,A01,085443,Staff,0,23,30,30
1651069990935,MATH 109,A01,083213,Anzaldo; Leesa B,0,7,30,30
1651069990935,MATH 109,A02,083214,Anzaldo; Leesa B,0,7,30,30
1651069990935,MATH 109,B01,083215,Anzaldo; Leesa B,0,8,30,30
1651069990935,MATH 109,B02,083216,Anzaldo; Leesa B,0,8,30,30
1651069996960,MATH 142A,A01,083219,Chow; Bennett,0,15,30,30
1651069996960,MATH 142A,A02,083220,Chow; Bennett,0,15,30,30
1651069996960,MATH 142A,B01,083221,Chow; Bennett,0,16,30,30
1651069996960,MATH 142A,B02,083222,Chow; Bennett,0,15,30,30
1651070002986,MATH 193A,A01,083224,Staff,0,8,30,30
1651070002986,MATH 193A,A02,083225,Staff,0,7,30,30
1651070002986,MATH 193A,A03,083781,Staff,0,7,30,30
1651070002986,MATH 193A,A04,083782,Staff,0,7,30,30
1651070009008,MATH 197,001,091859,McAuley; Julian John,9998,0,9999,1
1651070015059,COGS 9,A01,083615,Staff,0,20,60,60
1651070021086,COGS 11,A01,083617,Boyle; Mary E. T.,13,0,40,27
1651070027116,COGS 13,A01,083071,Staff,0,40,40,40
1651070033143,COGS 14A,A01,092681,Staff,0,40,100,100
1651070039167,COGS 14B,A01,083073,Cheng; Tzu-Han,0,13,50,50
1651070045192,COGS 17,A01,092677,Staff,9,0,75,66
1651070051219,COGS 100,A01,083619,Staff,0,30,60,60
1651070057251,COGS 101A,A01,083621,Davis; Joshua Daniel,0,29,60,60
1651070063275,COGS 101B,A01,091572,Staff,0,7,60,60
1651070069297,COGS 101C,A01,083625,Delgado; Tania,14,0,30,16
1651070075323,COGS 107A,A01,083627,Boyle; Mary E. T.,0,17,60,60
1651070081351,COGS 118A,A01,083075,Staff,0,10,60,60
1651070087380,CSE 3,A50,083646,Miranda; Gregory Joseph,15,0,38,23
1651070087380,CSE 3,A51,083647,Miranda; Gregory Joseph,36,0,37,1
1651070093401,CSE 8A,A50,083650,Miranda; Gregory Joseph,0,31,40,40
1651070099426,CSE 11,A01,083080,Cao; Yingjun,1,97,40,39
1651070105460,CSE 12,A01,083652,Staff,0,27,100,100
1651070111484,CSE 15L,A01,083654,Staff,0,3,50,50
1651070111484,CSE 15L,A02,083655,Staff,0,3,50,50
1651070117509,CSE 20,A01,083657,Staff,46,0,80,34
1651070123546,CSE 30,A01,083084,Eldon; John,0,38,80,80
1651070129570,CSE 100,A01,083659,Cao; Yingjun,0,72,50,50
1651070135592,CSE 134B,A01,083661,Powell; Thomas Allan,0,38,65,65
1651070141617,CSE 140,A01,083663,Staff,0,15,75,75
1651070147647,CSE 140L,A01,083088,Eldon; John,3,0,100,97
1651070153748,CSE 175,A01,083665,Kumar; Rakesh,0,0,25,25
1651070159778,CSE 190,A00,092507,Dubnov; Shlomo,9,0,20,11
1651070165804,ECE 45,A01,083139,Staff,0,7,60,60
1651070171829,ECE 65,A50,083695,Staff,0,7,30,30
1651070177855,ECE 109,A01,091882,Touri; Behrouz,33,0,70,37
1651070183878,ECE 180,A00,083140,Abi Samra; Nicholas Camill,17,0,30,13
1651070183878,ECE 180,B00,083141,Abi Samra; Nicholas Camill,0,0,30,30
1651070189912,MATH 10A,A01,083735,Patchell; Gregory David,0,0,30,30
1651070189912,MATH 10A,A02,083736,Patchell; Gregory David,27,0,30,3
1651070189912,MATH 10A,A03,083737,Patchell; Gregory David,22,0,30,8
1651070195938,MATH 10B,A01,083207,Staff,0,7,30,30
1651070195938,MATH 10B,A02,083208,Staff,0,6,30,30
1651070195938,MATH 10B,B01,083739,Staff,8,0,30,22
1651070195938,MATH 10B,B02,083740,Staff,28,0,30,2
1651070201963,MATH 18,A01,083743,Staff,0,0,30,30
1651070201963,MATH 18,A02,083744,Staff,23,0,30,7
1651070201963,MATH 18,A03,083745,Staff,19,0,30,11
1651070201963,MATH 18,A04,083746,Staff,26,0,30,4
1651070201963,MATH 18,B01,083748,Staff,0,16,30,30
1651070201963,MATH 18,B02,083749,Staff,0,14,30,30
1651070201963,MATH 18,B03,083750,Staff,0,14,30,30
1651070201963,MATH 18,B04,083751,Staff,0,13,30,30
1651070207988,MATH 20A,A01,083754,Staff,18,0,40,22
1651070214028,MATH 20B,A01,083756,Staff,0,14,30,30
1651070214028,MATH 20B,A02,083757,Staff,0,11,30,30
1651070220053,MATH 20C,A01,083760,Staff,0,16,30,30
1651070220053,MATH 20C,A02,083761,Staff,0,15,30,30
1651070220053,MATH 20C,B01,083762,Staff,8,0,30,22
1651070220053,MATH 20C,B02,083763,Staff,28,0,30,2
1651070226077,MATH 20D,A01,083765,Staff,3,1,30,27
1651070226077,MATH 20D,A02,083766,Staff,1,0,30,29
1651070226077,MATH 20D,A03,083767,Staff,22,0,30,8
1651070232102,MATH 20E,A01,083771,Staff,2,0,30,28
1651070232102,MATH 20E,A02,083772,Staff,10,0,30,20
1651070232102,MATH 20E,B01,083773,Staff,0,0,30,30
1651070232102,MATH 20E,B02,083774,Staff,0,0,30,30
1651070238126,MATH 103A,A01,083777,Staff,0,17,30,30
1651070238126,MATH 103A,A02,083778,Staff,0,16,30,30
1651070238126,MATH 103A,B01,083779,Staff,0,15,30,30
1651070238126,MATH 103A,B02,083780,Staff,0,14,30,30
1651070244148,MATH 105,A01,085443,Staff,0,23,30,30
1651070250174,MATH 109,A01,083213,Anzaldo; Leesa B,0,7,30,30
1651070250174,MATH 109,A02,083214,Anzaldo; Leesa B,0,7,30,30
1651070250174,MATH 109,B01,083215,Anzaldo; Leesa B,0,8,30,30
1651070250174,MATH 109,B02,083216,Anzaldo; Leesa B,0,8,30,30
1651070256199,MATH 142A,A01,083219,Chow; Bennett,0,15,30,30
1651070256199,MATH 142A,A02,083220,Chow; Bennett,0,15,30,30
1651070256199,MATH 142A,B01,083221,Chow; Bennett,0,16,30,30
1651070256199,MATH 142A,B02,083222,Chow; Bennett,0,15,30,30
1651070262224,MATH 193A,A01,083224,Staff,0,8,30,30
1651070262224,MATH 193A,A02,083225,Staff,0,7,30,30
1651070262224,MATH 193A,A03,083781,Staff,0,7,30,30
1651070262224,MATH 193A,A04,083782,Staff,0,7,30,30
1651070268247,MATH 197,001,091859,McAuley; Julian John,9998,0,9999,1
1651070274299,COGS 9,A01,083615,Staff,0,20,60,60
1651070280322,COGS 11,A01,083617,Boyle; Mary E. T.,13,0,40,27
1651070286349,COGS 13,A01,083071,Staff,0,40,40,40
1651070292374,COGS 14A,A01,092681,Staff,0,40,100,100
1651070298396,COGS 14B,A01,083073,Cheng; Tzu-Han,0,13,50,50
1651070304424,COGS 17,A01,092677,Staff,9,0,75,66
1651070310461,COGS 100,A01,083619,Staff,0,30,60,60
1651070316489,COGS 101A,A01,083621,Davis; Joshua Daniel,0,29,60,60
1651070322522,COGS 101B,A01,091572,Staff,0,7,60,60
1651070328548,COGS 101C,A01,083625,Delgado; Tania,14,0,30,16
1651070334574,COGS 107A,A01,083627,Boyle; Mary E. T.,0,17,60,60
1651070340607,COGS 118A,A01,083075,Staff,0,10,60,60
1651070346636,CSE 3,A50,083646,Miranda; Gregory Joseph,15,0,38,23
1651070346636,CSE 3,A51,083647,Miranda; Gregory Joseph,36,0,37,1
1651070352659,CSE 8A,A50,083650,Miranda; Gregory Joseph,0,31,40,40
1651070358682,CSE 11,A01,083080,Cao; Yingjun,1,97,40,39
1651070364707,CSE 12,A01,083652,Staff,0,27,100,100
1651070370737,CSE 15L,A01,083654,Staff,0,3,50,50
1651070370737,CSE 15L,A02,083655,Staff,0,3,50,50
1651070376763,CSE 20,A01,083657,Staff,46,0,80,34
1651070382789,CSE 30,A01,083084,Eldon; John,0,38,80,80
1651070388825,CSE 100,A01,083659,Cao; Yingjun,0,72,50,50
1651070394854,CSE 134B,A01,083661,Powell; Thomas Allan,0,38,65,65
1651070400883,CSE 140,A01,083663,Staff,0,15,75,75
1651070406905,CSE 140L,A01,083088,Eldon; John,3,0,100,97
1651070412932,CSE 175,A01,083665,Kumar; Rakesh,0,0,25,25
1651070418956,CSE 190,A00,092507,Dubnov; Shlomo,9,0,20,11
1651070424991,ECE 45,A01,083139,Staff,0,7,60,60
1651070431019,ECE 65,A50,083695,Staff,0,7,30,30
1651070437046,ECE 109,A01,091882,Touri; Behrouz,33,0,70,37
1651070443069,ECE 180,A00,083140,Abi Samra; Nicholas Camill,17,0,30,13
1651070443069,ECE 180,B00,083141,Abi Samra; Nicholas Camill,0,0,30,30
1651070449097,MATH 10A,A01,083735,Patchell; Gregory David,0,0,30,30
1651070449097,MATH 10A,A02,083736,Patchell; Gregory David,27,0,30,3
1651070449097,MATH 10A,A03,083737,Patchell; Gregory David,22,0,30,8
1651070455121,MATH 10B,A01,083207,Staff,0,7,30,30
1651070455121,MATH 10B,A02,083208,Staff,0,6,30,30
1651070455121,MATH 10B,B01,083739,Staff,8,0,30,22
1651070455121,MATH 10B,B02,083740,Staff,28,0,30,2
1651070461154,MATH 18,A01,083743,Staff,0,0,30,30
1651070461154,MATH 18,A02,083744,Staff,23,0,30,7
1651070461154,MATH 18,A03,083745,Staff,19,0,30,11
1651070461154,MATH 18,A04,083746,Staff,26,0,30,4
1651070461154,MATH 18,B01,083748,Staff,0,16,30,30
1651070461154,MATH 18,B02,083749,Staff,0,14,30,30
1651070461154,MATH 18,B03,083750,Staff,0,14,30,30
1651070461154,MATH 18,B04,083751,Staff,0,13,30,30
1651070467179,MATH 20A,A01,083754,Staff,18,0,40,22
1651070473220,MATH 20B,A01,083756,Staff,0,14,30,30
1651070473220,MATH 20B,A02,083757,Staff,0,11,30,30
1651070479249,MATH 20C,A01,083760,Staff,0,16,30,30
1651070479249,MATH 20C,A02,083761,Staff,0,15,30,30
1651070479249,MATH 20C,B01,083762,Staff,8,0,30,22
1651070479249,MATH 20C,B02,083763,Staff,28,0,30,2
1651070485284,MATH 20D,A01,083765,Staff,3,1,30,27
1651070485284,MATH 20D,A02,083766,Staff,1,0,30,29
1651070485284,MATH 20D,A03,083767,Staff,22,0,30,8
1651070491312,MATH 20E,A01,083771,Staff,2,0,30,28
1651070491312,MATH 20E,A02,083772,Staff,10,0,30,20
1651070491312,MATH 20E,B01,083773,Staff,0,0,30,30
1651070491312,MATH 20E,B02,083774,Staff,0,0,30,30
1651070497336,MATH 103A,A01,083777,Staff,0,17,30,30
1651070497336,MATH 103A,A02,083778,Staff,0,16,30,30
1651070497336,MATH 103A,B01,083779,Staff,0,15,30,30
1651070497336,MATH 103A,B02,083780,Staff,0,14,30,30
1651070503359,MATH 105,A01,085443,Staff,0,23,30,30
1651070509384,MATH 109,A01,083213,Anzaldo; Leesa B,0,7,30,30
1651070509384,MATH 109,A02,083214,Anzaldo; Leesa B,0,7,30,30
1651070509384,MATH 109,B01,083215,Anzaldo; Leesa B,0,8,30,30
1651070509384,MATH 109,B02,083216,Anzaldo; Leesa B,0,8,30,30
1651070515408,MATH 142A,A01,083219,Chow; Bennett,0,15,30,30
1651070515408,MATH 142A,A02,083220,Chow; Bennett,0,15,30,30
1651070515408,MATH 142A,B01,083221,Chow; Bennett,0,16,30,30
1651070515408,MATH 142A,B02,083222,Chow; Bennett,0,15,30,30
1651070521432,MATH 193A,A01,083224,Staff,0,8,30,30
1651070521432,MATH 193A,A02,083225,Staff,0,7,30,30
1651070521432,MATH 193A,A03,083781,Staff,0,7,30,30
1651070521432,MATH 193A,A04,083782,Staff,0,7,30,30
1651070527466,MATH 197,001,091859,McAuley; Julian John,9998,0,9999,1
1651070533537,COGS 9,A01,083615,Staff,0,20,60,60
1651070539561,COGS 11,A01,083617,Boyle; Mary E. T.,13,0,40,27
1651070545585,COGS 13,A01,083071,Staff,0,40,40,40
1651070551611,COGS 14A,A01,092681,Staff,0,40,100,100
1651070557639,COGS 14B,A01,083073,Cheng; Tzu-Han,0,13,50,50
1651070563661,COGS 17,A01,092677,Staff,9,0,75,66
1651070569688,COGS 100,A01,083619,Staff,0,30,60,60
1651070575717,COGS 101A,A01,083621,Davis; Joshua Daniel,0,29,60,60
1651070581750,COGS 101B,A01,091572,Staff,0,7,60,60
1651070587773,COGS 101C,A01,083625,Delgado; Tania,14,0,30,16
1651070593801,COGS 107A,A01,083627,Boyle; Mary E. T.,0,17,60,60
1651070599837,COGS 118A,A01,083075,Staff,0,10,60,60
1651070605862,CSE 3,A50,083646,Miranda; Gregory Joseph,15,0,38,23
1651070605862,CSE 3,A51,083647,Miranda; Gregory Joseph,36,0,37,1
1651070611887,CSE 8A,A50,083650,Miranda; Gregory Joseph,0,31,40,40
1651070617912,CSE 11,A01,083080,Cao; Yingjun,1,97,40,39
1651070623937,CSE 12,A01,083652,Staff,0,27,100,100
1651070629959,CSE 15L,A01,083654,Staff,0,3,50,50
1651070629959,CSE 15L,A02,083655,Staff,0,3,50,50
1651070635981,CSE 20,A01,083657,Staff,46,0,80,34
1651070642009,CSE 30,A01,083084,Eldon; John,0,38,80,80
1651070648037,CSE 100,A01,083659,Cao; Yingjun,0,72,50,50
1651070654063,CSE 134B,A01,083661,Powell; Thomas Allan,0,38,65,65
1651070660085,CSE 140,A01,083663,Staff,0,15,75,75
1651070666117,CSE 140L,A01,083088,Eldon; John,3,0,100,97
1651070672143,CSE 175,A01,083665,Kumar; Rakesh,0,0,25,25
1651070678169,CSE 190,A00,092507,Dubnov; Shlomo,9,0,20,11
1651070684193,ECE 45,A01,083139,Staff,0,7,60,60
1651070690229,ECE 65,A50,083695,Staff,0,7,30,30
1651070696259,ECE 109,A01,091882,Touri; Behrouz,33,0,70,37
1651070702283,ECE 180,A00,083140,Abi Samra; Nicholas Camill,17,0,30,13
1651070702283,ECE 180,B00,083141,Abi Samra; Nicholas Camill,0,0,30,30
1651070708310,MATH 10A,A01,083735,Patchell; Gregory David,0,0,30,30
1651070708310,MATH 10A,A02,083736,Patchell; Gregory David,27,0,30,3
1651070708310,MATH 10A,A03,083737,Patchell; Gregory David,22,0,30,8
1651070714332,MATH 10B,A01,083207,Staff,0,7,30,30
1651070714332,MATH 10B,A02,083208,Staff,0,6,30,30
1651070714332,MATH 10B,B01,083739,Staff,8,0,30,22
1651070714332,MATH 10B,B02,083740,Staff,28,0,30,2
1651070720374,MATH 18,A01,083743,Staff,0,0,30,30
1651070720374,MATH 18,A02,083744,Staff,23,0,30,7
1651070720374,MATH 18,A03,083745,Staff,19,0,30,11
1651070720374,MATH 18,A04,083746,Staff,26,0,30,4
1651070720374,MATH 18,B01,083748,Staff,0,16,30,30
1651070720374,MATH 18,B02,083749,Staff,0,14,30,30
1651070720374,MATH 18,B03,083750,Staff,0,14,30,30
1651070720374,MATH 18,B04,083751,Staff,0,13,30,30
1651070726395,MATH 20A,A01,083754,Staff,18,0,40,22
1651070732423,MATH 20B,A01,083756,Staff,0,14,30,30
1651070732423,MATH 20B,A02,083757,Staff,0,11,30,30
1651070738450,MATH 20C,A01,083760,Staff,0,16,30,30
1651070738450,MATH 20C,A02,083761,Staff,0,15,30,30
1651070738450,MATH 20C,B01,083762,Staff,8,0,30,22
1651070738450,MATH 20C,B02,083763,Staff,28,0,30,2
1651070744484,MATH 20D,A01,083765,Staff,3,1,30,27
1651070744484,MATH 20D,A02,083766,Staff,1,0,30,29
1651070744484,MATH 20D,A03,083767,Staff,22,0,30,8
1651070750579,MATH 20E,A01,083771,Staff,2,0,30,28
1651070750579,MATH 20E,A02,083772,Staff,10,0,30,20
1651070750579,MATH 20E,B01,083773,Staff,0,0,30,30
1651070750579,MATH 20E,B02,083774,Staff,0,0,30,30
1651070756607,MATH 103A,A01,083777,Staff,0,17,30,30
1651070756607,MATH 103A,A02,083778,Staff,0,16,30,30
1651070756607,MATH 103A,B01,083779,Staff,0,15,30,30
1651070756607,MATH 103A,B02,083780,Staff,0,14,30,30
1651070762630,MATH 105,A01,085443,Staff,0,23,30,30
1651070768659,MATH 109,A01,083213,Anzaldo; Leesa B,0,7,30,30
1651070768659,MATH 109,A02,083214,Anzaldo; Leesa B,0,7,30,30
1651070768659,MATH 109,B01,083215,Anzaldo; Leesa B,0,8,30,30
1651070768659,MATH 109,B02,083216,Anzaldo; Leesa B,0,8,30,30
1651070774686,MATH 142A,A01,083219,Chow; Bennett,0,15,30,30
1651070774686,MATH 142A,A02,083220,Chow; Bennett,0,15,30,30
1651070774686,MATH 142A,B01,083221,Chow; Bennett,0,16,30,30
1651070774686,MATH 142A,B02,083222,Chow; Bennett,0,15,30,30
1651070780710,MATH 193A,A01,083224,Staff,0,8,30,30
1651070780710,MATH 193A,A02,083225,Staff,0,7,30,30
1651070780710,MATH 193A,A03,083781,Staff,0,7,30,30
1651070780710,MATH 193A,A04,083782,Staff,0,7,30,30
1651070786734,MATH 197,001,091859,McAuley; Julian John,9998,0,9999,1
1651070792810,COGS 9,A01,083615,Staff,0,20,60,60
1651070798841,COGS 11,A01,083617,Boyle; Mary E. T.,13,0,40,27
1651070804869,COGS 13,A01,083071,Staff,0,40,40,40
1651070810892,COGS 14A,A01,092681,Staff,0,40,100,100
1651070816918,COGS 14B,A01,083073,Cheng; Tzu-Han,0,13,50,50
1651070822946,COGS 17,A01,092677,Staff,9,0,75,66
1651070828970,COGS 100,A01,083619,Staff,0,30,60,60
1651070834997,COGS 101A,A01,083621,Davis; Joshua Daniel,0,29,60,60
1651070841021,COGS 101B,A01,091572,Staff,0,7,60,60
1651070847043,COGS 101C,A01,083625,Delgado; Tania,14,0,30,16
1651070853064,COGS 107A,A01,083627,Boyle; Mary E. T.,0,17,60,60
1651070859087,COGS 118A,A01,083075,Staff,0,10,60,60
1651070865111,CSE 3,A50,083646,Miranda; Gregory Joseph,15,0,38,23
1651070865111,CSE 3,A51,083647,Miranda; Gregory Joseph,36,0,37,1
1651070871138,CSE 8A,A50,083650,Miranda; Gregory Joseph,0,31,40,40
1651070877161,CSE 11,A01,083080,Cao; Yingjun,1,97,40,39
1651070883188,CSE 12,A01,083652,Staff,0,27,100,100
1651070889212,CSE 15L,A01,083654,Staff,0,3,50,50
1651070889212,CSE 15L,A02,083655,Staff,0,3,50,50
1651070895235,CSE 20,A01,083657,Staff,46,0,80,34
1651070901261,CSE 30,A01,083084,Eldon; John,0,38,80,80
1651070907284,CSE 100,A01,083659,Cao; Yingjun,0,72,50,50
1651070913307,CSE 134B,A01,083661,Powell; Thomas Allan,0,38,65,65
1651070919333,CSE 140,A01,083663,Staff,0,15,75,75
1651070925368,CSE 140L,A01,083088,Eldon; John,3,0,100,97
1651070931394,CSE 175,A01,083665,Kumar; Rakesh,0,0,25,25
1651070937420,CSE 190,A00,092507,Dubnov; Shlomo,9,0,20,11
1651070943442,ECE 45,A01,083139,Staff,0,7,60,60
1651070949469,ECE 65,A50,083695,Staff,0,7,30,30
1651070955495,ECE 109,A01,091882,Touri; Behrouz,33,0,70,37
1651070961520,ECE 180,A00,083140,Abi Samra; Nicholas Camill,17,0,30,13
1651070961520,ECE 180,B00,083141,Abi Samra; Nicholas Camill,0,0,30,30
1651070967549,MATH 10A,A01,083735,Patchell; Gregory David,0,0,30,30
1651070967549,MATH 10A,A02,083736,Patchell; Gregory David,27,0,30,3
1651070967549,MATH 10A,A03,083737,Patchell; Gregory David,22,0,30,8
1651070973573,MATH 10B,A01,083207,Staff,0,7,30,30
1651070973573,MATH 10B,A02,083208,Staff,0,6,30,30
1651070973573,MATH 10B,B01,083739,Staff,8,0,30,22
1651070973573,MATH 10B,B02,083740,Staff,28,0,30,2
1651070979598,MATH 18,A01,083743,Staff,0,0,30,30
1651070979598,MATH 18,A02,083744,Staff,23,0,30,7
1651070979598,MATH 18,A03,083745,Staff,19,0,30,11
1651070979598,MATH 18,A04,083746,Staff,26,0,30,4
1651070979598,MATH 18,B01,083748,Staff,0,16,30,30
1651070979598,MATH 18,B02,083749,Staff,0,14,30,30
1651070979598,MATH 18,B03,083750,Staff,0,14,30,30
1651070979598,MATH 18,B04,083751,Staff,0,13,30,30
1651070985622,MATH 20A,A01,083754,Staff,18,0,40,22
1651070991650,MATH 20B,A01,083756,Staff,0,14,30,30
1651070991650,MATH 20B,A02,083757,Staff,0,11,30,30
1651070997678,MATH 20C,A01,083760,Staff,0,16,30,30
1651070997678,MATH 20C,A02,083761,Staff,0,15,30,30
1651070997678,MATH 20C,B01,083762,Staff,8,0,30,22
1651070997678,MATH 20C,B02,083763,Staff,28,0,30,2
1651071003706,MATH 20D,A01,083765,Staff,3,1,30,27
1651071003706,MATH 20D,A02,083766,Staff,1,0,30,29
1651071003706,MATH 20D,A03,083767,Staff,22,0,30,8
1651071009737,MATH 20E,A01,083771,Staff,2,0,30,28
1651071009737,MATH 20E,A02,083772,Staff,10,0,30,20
1651071009737,MATH 20E,B01,083773,Staff,0,0,30,30
1651071009737,MATH 20E,B02,083774,Staff,0,0,30,30
1651071015765,MATH 103A,A01,083777,Staff,0,17,30,30
1651071015765,MATH 103A,A02,083778,Staff,0,16,30,30
1651071015765,MATH 103A,B01,083779,Staff,0,15,30,30
1651071015765,MATH 103A,B02,083780,Staff,0,14,30,30
1651071021788,MATH 105,A01,085443,Staff,0,23,30,30
1651071027815,MATH 109,A01,083213,Anzaldo; Leesa B,0,7,30,30
1651071027815,MATH 109,A02,083214,Anzaldo; Leesa B,0,7,30,30
1651071027815,MATH 109,B01,083215,Anzaldo; Leesa B,0,8,30,30
1651071027815,MATH 109,B02,083216,Anzaldo; Leesa B,0,8,30,30
1651071033839,MATH 142A,A01,083219,Chow; Bennett,0,15,30,30
1651071033839,MATH 142A,A02,083220,Chow; Bennett,0,15,30,30
1651071033839,MATH 142A,B01,083221,Chow; Bennett,0,16,30,30
1651071033839,MATH 142A,B02,083222,Chow; Bennett,0,15,30,30
1651071039866,MATH 193A,A01,083224,Staff,0,8,30,30
1651071039866,MATH 193A,A02,083225,Staff,0,7,30,30
1651071039866,MATH 193A,A03,083781,Staff,0,7,30,30
1651071039866,MATH 193A,A04,083782,Staff,0,7,30,30
1651071045889,MATH 197,001,091859,McAuley; Julian John,9998,0,9999,1
1651071051942,COGS 9,A01,083615,Staff,0,20,60,60
1651071057968,COGS 11,A01,083617,Boyle; Mary E. T.,13,0,40,27
1651071063997,COGS 13,A01,083071,Staff,0,40,40,40
1651071070023,COGS 14A,A01,092681,Staff,0,40,100,100
1651071076055,COGS 14B,A01,083073,Cheng; Tzu-Han,0,13,50,50
1651071082080,COGS 17,A01,092677,Staff,9,0,75,66
1651071088104,COGS 100,A01,083619,Staff,0,30,60,60
1651071094130,COGS 101A,A01,083621,Davis; Joshua Daniel,0,29,60,60
1651071100157,COGS 101B,A01,091572,Staff,0,7,60,60
1651071106181,COGS 101C,A01,083625,Delgado; Tania,14,0,30,16
1651071112205,COGS 107A,A01,083627,Boyle; Mary E. T.,0,17,60,60
1651071118228,COGS 118A,A01,083075,Staff,0,10,60,60
1651071124255,CSE 3,A50,083646,Miranda; Gregory Joseph,15,0,38,23
1651071124255,CSE 3,A51,083647,Miranda; Gregory Joseph,36,0,37,1
1651071130279,CSE 8A,A50,083650,Miranda; Gregory Joseph,0,31,40,40
1651071136301,CSE 11,A01,083080,Cao; Yingjun,1,97,40,39
1651071142324,CSE 12,A01,083652,Staff,0,27,100,100
1651071148348,CSE 15L,A01,083654,Staff,0,3,50,50
1651071148348,CSE 15L,A02,083655,Staff,0,3,50,50
1651071154369,CSE 20,A01,083657,Staff,46,0,80,34
1651071160394,CSE 30,A01,083084,Eldon; John,0,38,80,80
1651071166427,CSE 100,A01,083659,Cao; Yingjun,0,72,50,50
1651071172448,CSE 134B,A01,083661,Powell; Thomas Allan,0,38,65,65
1651071178474,CSE 140,A01,083663,Staff,0,15,75,75
1651071184497,CSE 140L,A01,083088,Eldon; John,3,0,100,97
1651071190538,CSE 175,A01,083665,Kumar; Rakesh,0,0,25,25
1651071196562,CSE 190,A00,092507,Dubnov; Shlomo,9,0,20,11
1651071202584,ECE 45,A01,083139,Staff,0,7,60,60
1651071208619,ECE 65,A50,083695,Staff,0,7,30,30
1651071214644,ECE 109,A01,091882,Touri; Behrouz,33,0,70,37
1651071220671,ECE 180,A00,083140,Abi Samra; Nicholas Camill,17,0,30,13
1651071220671,ECE 180,B00,083141,Abi Samra; Nicholas Camill,0,0,30,30
1651071226705,MATH 10A,A01,083735,Patchell; Gregory David,0,0,30,30
1651071226705,MATH 10A,A02,083736,Patchell; Gregory David,27,0,30,3
1651071226705,MATH 10A,A03,083737,Patchell; Gregory David,22,0,30,8
1651071232764,MATH 10B,A01,083207,Staff,0,7,30,30
1651071232764,MATH 10B,A02,083208,Staff,0,6,30,30
1651071232764,MATH 10B,B01,083739,Staff,8,0,30,22
1651071232764,MATH 10B,B02,083740,Staff,28,0,30,2
1651071238789,MATH 18,A01,083743,Staff,0,0,30,30
1651071238789,MATH 18,A02,083744,Staff,23,0,30,7
1651071238789,MATH 18,A03,083745,Staff,19,0,30,11
1651071238789,MATH 18,A04,083746,Staff,26,0,30,4
1651071238789,MATH 18,B01,083748,Staff,0,16,30,30
1651071238789,MATH 18,B02,083749,Staff,0,14,30,30
1651071238789,MATH 18,B03,083750,Staff,0,14,30,30
1651071238789,MATH 18,B04,083751,Staff,0,13,30,30
1651071244811,MATH 20A,A01,083754,Staff,18,0,40,22
1651071250838,MATH 20B,A01,083756,Staff,0,14,30,30
1651071250838,MATH 20B,A02,083757,Staff,0,11,30,30
1651071256862,MATH 20C,A01,083760,Staff,0,16,30,30
1651071256862,MATH 20C,A02,083761,Staff,0,15,30,30
1651071256862,MATH 20C,B01,083762,Staff,8,0,30,22
1651071256862,MATH 20C,B02,083763,Staff,28,0,30,2
1651071262890,MATH 20D,A01,083765,Staff,3,1,30,27
1651071262890,MATH 20D,A02,083766,Staff,1,0,30,29
1651071262890,MATH 20D,A03,083767,Staff,22,0,30,8
1651071268913,MATH 20E,A01,083771,Staff,2,0,30,28
1651071268913,MATH 20E,A02,083772,Staff,10,0,30,20
1651071268913,MATH 20E,B01,083773,Staff,0,0,30,30
1651071268913,MATH 20E,B02,083774,Staff,0,0,30,30
1651071274943,MATH 103A,A01,083777,Staff,0,17,30,30
1651071274943,MATH 103A,A02,083778,Staff,0,16,30,30
1651071274943,MATH 103A,B01,083779,Staff,0,15,30,30
1651071274943,MATH 103A,B02,083780,Staff,0,14,30,30
1651071280970,MATH 105,A01,085443,Staff,0,23,30,30
1651071286995,MATH 109,A01,083213,Anzaldo; Leesa B,0,7,30,30
1651071286995,MATH 109,A02,083214,Anzaldo; Leesa B,0,7,30,30
1651071286995,MATH 109,B01,083215,Anzaldo; Leesa B,0,8,30,30
1651071286995,MATH 109,B02,083216,Anzaldo; Leesa B,0,8,30,30
1651071293024,MATH 142A,A01,083219,Chow; Bennett,0,15,30,30
1651071293024,MATH 142A,A02,083220,Chow; Bennett,0,15,30,30
1651071293024,MATH 142A,B01,083221,Chow; Bennett,0,16,30,30
1651071293024,MATH 142A,B02,083222,Chow; Bennett,0,15,30,30
1651071299060,MATH 193A,A01,083224,Staff,0,8,30,30
1651071299060,MATH 193A,A02,083225,Staff,0,7,30,30
1651071299060,MATH 193A,A03,083781,Staff,0,7,30,30
1651071299060,MATH 193A,A04,083782,Staff,0,7,30,30
1651071305084,MATH 197,001,091859,McAuley; Julian John,9998,0,9999,1
1651071311142,COGS 9,A01,083615,Staff,0,20,60,60
1651071317168,COGS 11,A01,083617,Boyle; Mary E. T.,13,0,40,27
1651071323192,COGS 13,A01,083071,Staff,0,40,40,40
1651071329214,COGS 14A,A01,092681,Staff,0,40,100,100
1651071335237,COGS 14B,A01,083073,Cheng; Tzu-Han,0,13,50,50
1651071341342,COGS 17,A01,092677,Staff,9,0,75,66
1651071347367,COGS 100,A01,083619,Staff,0,30,60,60
1651071353394,COGS 101A,A01,083621,Davis; Joshua Daniel,0,29,60,60
1651071359417,COGS 101B,A01,091572,Staff,0,7,60,60
1651071365444,COGS 101C,A01,083625,Delgado; Tania,14,0,30,16
1651071371466,COGS 107A,A01,083627,Boyle; Mary E. T.,0,17,60,60
1651071377489,COGS 118A,A01,083075,Staff,0,10,60,60
1651071383515,CSE 3,A50,083646,Miranda; Gregory Joseph,15,0,38,23
1651071383515,CSE 3,A51,083647,Miranda; Gregory Joseph,36,0,37,1
1651071389540,CSE 8A,A50,083650,Miranda; Gregory Joseph,0,31,40,40
1651071395573,CSE 11,A01,083080,Cao; Yingjun,1,97,40,39
1651071401606,CSE 12,A01,083652,Staff,0,27,100,100
1651071407630,CSE 15L,A01,083654,Staff,0,3,50,50
1651071407630,CSE 15L,A02,083655,Staff,0,3,50,50
1651071413653,CSE 20,A01,083657,Staff,46,0,80,34
1651071419679,CSE 30,A01,083084,Eldon; John,0,38,80,80
1651071425708,CSE 100,A01,083659,Cao; Yingjun,0,72,50,50
1651071431734,CSE 134B,A01,083661,Powell; Thomas Allan,0,38,65,65
1651071437761,CSE 140,A01,083663,Staff,0,15,75,75
1651071443789,CSE 140L,A01,083088,Eldon; John,3,0,100,97
1651071449823,CSE 175,A01,083665,Kumar; Rakesh,0,0,25,25
1651071455846,CSE 190,A00,092507,Dubnov; Shlomo,9,0,20,11
1651071461869,ECE 45,A01,083139,Staff,0,7,60,60
1651071467895,ECE 65,A50,083695,Staff,0,7,30,30
1651071473921,ECE 109,A01,091882,Touri; Behrouz,33,0,70,37
1651071479944,ECE 180,A00,083140,Abi Samra; Nicholas Camill,17,0,30,13
1651071479944,ECE 180,B00,083141,Abi Samra; Nicholas Camill,0,0,30,30
1651071485968,MATH 10A,A01,083735,Patchell; Gregory David,0,0,30,30
1651071485968,MATH 10A,A02,083736,Patchell; Gregory David,27,0,30,3
1651071485968,MATH 10A,A03,083737,Patchell; Gregory David,22,0,30,8
1651071491998,MATH 10B,A01,083207,Staff,0,7,30,30
1651071491998,MATH 10B,A02,083208,Staff,0,6,30,30
1651071491998,MATH 10B,B01,083739,Staff,8,0,30,22
1651071491998,MATH 10B,B02,083740,Staff,28,0,30,2
1651071498022,MATH 18,A01,083743,Staff,0,0,30,30
1651071498022,MATH 18,A02,083744,Staff,23,0,30,7
1651071498022,MATH 18,A03,083745,Staff,19,0,30,11
1651071498022,MATH 18,A04,083746,Staff,26,0,30,4
1651071498022,MATH 18,B01,083748,Staff,0,16,30,30
1651071498022,MATH 18,B02,083749,Staff,0,14,30,30
1651071498022,MATH 18,B03,083750,Staff,0,14,30,30
1651071498022,MATH 18,B04,083751,Staff,0,13,30,30
1651071504049,MATH 20A,A01,083754,Staff,18,0,40,22
1651071510073,MATH 20B,A01,083756,Staff,0,14,30,30
1651071510073,MATH 20B,A02,083757,Staff,0,11,30,30
1651071516102,MATH 20C,A01,083760,Staff,0,16,30,30
1651071516102,MATH 20C,A02,083761,Staff,0,15,30,30
1651071516102,MATH 20C,B01,083762,Staff,8,0,30,22
1651071516102,MATH 20C,B02,083763,Staff,28,0,30,2
1651071522130,MATH 20D,A01,083765,Staff,3,1,30,27
1651071522130,MATH 20D,A02,083766,Staff,1,0,30,29
1651071522130,MATH 20D,A03,083767,Staff,22,0,30,8
1651071528181,MATH 20E,A01,083771,Staff,2,0,30,28
1651071528181,MATH 20E,A02,083772,Staff,10,0,30,20
1651071528181,MATH 20E,B01,083773,Staff,0,0,30,30
1651071528181,MATH 20E,B02,083774,Staff,0,0,30,30
1651071534204,MATH 103A,A01,083777,Staff,0,17,30,30
1651071534204,MATH 103A,A02,083778,Staff,0,16,30,30
1651071534204,MATH 103A,B01,083779,Staff,0,15,30,30
1651071534204,MATH 103A,B02,083780,Staff,0,14,30,30
1651071540230,MATH 105,A01,085443,Staff,0,23,30,30
1651071546258,MATH 109,A01,083213,Anzaldo; Leesa B,0,7,30,30
1651071546258,MATH 109,A02,083214,Anzaldo; Leesa B,0,7,30,30
1651071546258,MATH 109,B01,083215,Anzaldo; Leesa B,0,8,30,30
1651071546258,MATH 109,B02,083216,Anzaldo; Leesa B,0,8,30,30
1651071552283,MATH 142A,A01,083219,Chow; Bennett,0,15,30,30
1651071552283,MATH 142A,A02,083220,Chow; Bennett,0,15,30,30
1651071552283,MATH 142A,B01,083221,Chow; Bennett,0,16,30,30
1651071552283,MATH 142A,B02,083222,Chow; Bennett,0,15,30,30
1651071558306,MATH 193A,A01,083224,Staff,0,8,30,30
1651071558306,MATH 193A,A02,083225,Staff,0,7,30,30
1651071558306,MATH 193A,A03,083781,Staff,0,7,30,30
1651071558306,MATH 193A,A04,083782,Staff,0,7,30,30
1651071564327,MATH 197,001,091859,McAuley; Julian John,9998,0,9999,1
1651071570387,COGS 9,A01,083615,Staff,0,20,60,60
1651071576415,COGS 11,A01,083617,Boyle; Mary E. T.,13,0,40,27
1651071582439,COGS 13,A01,083071,Staff,0,40,40,40
1651071588462,COGS 14A,A01,092681,Staff,0,40,100,100
1651071594484,COGS 14B,A01,083073,Cheng; Tzu-Han,0,13,50,50
1651071600517,COGS 17,A01,092677,Staff,9,0,75,66
1651071606542,COGS 100,A01,083619,Staff,0,30,60,60
1651071612570,COGS 101A,A01,083621,Davis; Joshua Daniel,0,29,60,60
1651071618593,COGS 101B,A01,091572,Staff,0,7,60,60
1651071624617,COGS 101C,A01,083625,Delgado; Tania,14,0,30,16
1651071630643,COGS 107A,A01,083627,Boyle; Mary E. T.,0,17,60,60
1651071636676,COGS 118A,A01,083075,Staff,0,10,60,60
1651071642704,CSE 3,A50,083646,Miranda; Gregory Joseph,15,0,38,23
1651071642704,CSE 3,A51,083647,Miranda; Gregory Joseph,36,0,37,1
1651071648725,CSE 8A,A50,083650,Miranda; Gregory Joseph,0,31,40,40
1651071654749,CSE 11,A01,083080,Cao; Yingjun,1,97,40,39
1651071660780,CSE 12,A01,083652,Staff,0,27,100,100
1651071666849,CSE 15L,A01,083654,Staff,0,3,50,50
1651071666849,CSE 15L,A02,083655,Staff,0,3,50,50
1651071672873,CSE 20,A01,083657,Staff,46,0,80,34
1651071678896,CSE 30,A01,083084,Eldon; John,0,38,80,80
1651071684919,CSE 100,A01,083659,Cao; Yingjun,0,72,50,50
1651071690947,CSE 134B,A01,083661,Powell; Thomas Allan,0,38,65,65
1651071696986,CSE 140,A01,083663,Staff,0,15,75,75
1651071703010,CSE 140L,A01,083088,Eldon; John,3,0,100,97
1651071709034,CSE 175,A01,083665,Kumar; Rakesh,0,0,25,25
1651071715057,CSE 190,A00,092507,Dubnov; Shlomo,9,0,20,11
1651071721085,ECE 45,A01,083139,Staff,0,7,60,60
1651071727111,ECE 65,A50,083695,Staff,0,7,30,30
1651071733135,ECE 109,A01,091882,Touri; Behrouz,33,0,70,37
1651071739159,ECE 180,A00,083140,Abi Samra; Nicholas Camill,17,0,30,13
1651071739159,ECE 180,B00,083141,Abi Samra; Nicholas Camill,0,0,30,30
1651071745187,MATH 10A,A01,083735,Patchell; Gregory David,0,0,30,30
1651071745187,MATH 10A,A02,083736,Patchell; Gregory David,27,0,30,3
1651071745187,MATH 10A,A03,083737,Patchell; Gregory David,22,0,30,8
1651071751211,MATH 10B,A01,083207,Staff,0,7,30,30
1651071751211,MATH 10B,A02,083208,Staff,0,6,30,30
1651071751211,MATH 10B,B01,083739,Staff,8,0,30,22
1651071751211,MATH 10B,B02,083740,Staff,28,0,30,2
1651071757241,MATH 18,A01,083743,Staff,0,0,30,30
1651071757241,MATH 18,A02,083744,Staff,23,0,30,7
1651071757241,MATH 18,A03,083745,Staff,19,0,30,11
1651071757241,MATH 18,A04,083746,Staff,26,0,30,4
1651071757241,MATH 18,B01,083748,Staff,0,16,30,30
1651071757241,MATH 18,B02,083749,Staff,0,14,30,30
1651071757241,MATH 18,B03,083750,Staff,0,14,30,30
1651071757241,MATH 18,B04,083751,Staff,0,13,30,30
1651071763268,MATH 20A,A01,083754,Staff,18,0,40,22
1651071769291,MATH 20B,A01,083756,Staff,0,14,30,30
1651071769291,MATH 20B,A02,083757,Staff,0,11,30,30
1651071775320,MATH 20C,A01,083760,Staff,0,16,30,30
1651071775320,MATH 20C,A02,083761,Staff,0,15,30,30
1651071775320,MATH 20C,B01,083762,Staff,8,0,30,22
1651071775320,MATH 20C,B02,083763,Staff,28,0,30,2
1651071781347,MATH 20D,A01,083765,Staff,3,1,30,27
1651071781347,MATH 20D,A02,083766,Staff,1,0,30,29
1651071781347,MATH 20D,A03,083767,Staff,22,0,30,8
1651071787370,MATH 20E,A01,083771,Staff,2,0,30,28
1651071787370,MATH 20E,A02,083772,Staff,10,0,30,20
1651071787370,MATH 20E,B01,083773,Staff,0,0,30,30
1651071787370,MATH 20E,B02,083774,Staff,0,0,30,30
1651071793398,MATH 103A,A01,083777,Staff,0,17,30,30
1651071793398,MATH 103A,A02,083778,Staff,0,16,30,30
1651071793398,MATH 103A,B01,083779,Staff,0,15,30,30
1651071793398,MATH 103A,B02,083780,Staff,0,14,30,30
1651071799423,MATH 105,A01,085443,Staff,0,23,30,30
1651071805456,MATH 109,A01,083213,Anzaldo; Leesa B,0,7,30,30
1651071805456,MATH 109,A02,083214,Anzaldo; Leesa B,0,7,30,30
1651071805456,MATH 109,B01,083215,Anzaldo; Leesa B,0,8,30,30
1651071805456,MATH 109,B02,083216,Anzaldo; Leesa B,0,8,30,30
1651071811480,MATH 142A,A01,083219,Chow; Bennett,0,15,30,30
1651071811480,MATH 142A,A02,083220,Chow; Bennett,0,15,30,30
1651071811480,MATH 142A,B01,083221,Chow; Bennett,0,16,30,30
1651071811480,MATH 142A,B02,083222,Chow; Bennett,0,15,30,30
1651071817505,MATH 193A,A01,083224,Staff,0,8,30,30
1651071817505,MATH 193A,A02,083225,Staff,0,7,30,30
1651071817505,MATH 193A,A03,083781,Staff,0,7,30,30
1651071817505,MATH 193A,A04,083782,Staff,0,7,30,30
1651071823529,MATH 197,001,091859,McAuley; Julian John,9998,0,9999,1
1651071829579,COGS 9,A01,083615,Staff,0,20,60,60
1651071835601,COGS 11,A01,083617,Boyle; Mary E. T.,13,0,40,27
1651071841624,COGS 13,A01,083071,Staff,0,40,40,40
1651071847651,COGS 14A,A01,092681,Staff,0,40,100,100
1651071853679,COGS 14B,A01,083073,Cheng; Tzu-Han,0,13,50,50
1651071859701,COGS 17,A01,092677,Staff,9,0,75,66
1651071865727,COGS 100,A01,083619,Staff,0,30,60,60
1651071871750,COGS 101A,A01,083621,Davis; Joshua Daniel,0,29,60,60
1651071877774,COGS 101B,A01,091572,Staff,0,7,60,60
1651071883810,COGS 101C,A01,083625,Delgado; Tania,14,0,30,16
1651071889833,COGS 107A,A01,083627,Boyle; Mary E. T.,0,17,60,60
1651071895862,COGS 118A,A01,083075,Staff,0,10,60,60
1651071901886,CSE 3,A50,083646,Miranda; Gregory Joseph,15,0,38,23
1651071901886,CSE 3,A51,083647,Miranda; Gregory Joseph,36,0,37,1
1651071907909,CSE 8A,A50,083650,Miranda; Gregory Joseph,0,31,40,40
1651071913933,CSE 11,A01,083080,Cao; Yingjun,1,97,40,39
1651071919957,CSE 12,A01,083652,Staff,0,27,100,100
1651071925981,CSE 15L,A01,083654,Staff,0,3,50,50
1651071925981,CSE 15L,A02,083655,Staff,0,3,50,50
1651071932022,CSE 20,A01,083657,Staff,46,0,80,34
1651071938119,CSE 30,A01,083084,Eldon; John,0,38,80,80
1651071944157,CSE 100,A01,083659,Cao; Yingjun,0,72,50,50
1651071950228,CSE 134B,A01,083661,Powell; Thomas Allan,0,38,65,65
1651071956250,CSE 140,A01,083663,Staff,0,15,75,75
1651071962273,CSE 140L,A01,083088,Eldon; John,3,0,100,97
1651071968300,CSE 175,A01,083665,Kumar; Rakesh,0,0,25,25
1651071974341,CSE 190,A00,092507,Dubnov; Shlomo,9,0,20,11
1651071980362,ECE 45,A01,083139,Staff,0,7,60,60
1651071986388,ECE 65,A50,083695,Staff,0,7,30,30
1651071992428,ECE 109,A01,091882,Touri; Behrouz,33,0,70,37
1651071998461,ECE 180,A00,083140,Abi Samra; Nicholas Camill,17,0,30,13
1651071998461,ECE 180,B00,083141,Abi Samra; Nicholas Camill,0,0,30,30
1651072004483,MATH 10A,A01,083735,Patchell; Gregory David,0,0,30,30
1651072004483,MATH 10A,A02,083736,Patchell; Gregory David,27,0,30,3
1651072004483,MATH 10A,A03,083737,Patchell; Gregory David,22,0,30,8
1651072010511,MATH 10B,A01,083207,Staff,0,7,30,30
1651072010511,MATH 10B,A02,083208,Staff,0,6,30,30
1651072010511,MATH 10B,B01,083739,Staff,8,0,30,22
1651072010511,MATH 10B,B02,083740,Staff,28,0,30,2
1651072016541,MATH 18,A01,083743,Staff,0,0,30,30
1651072016541,MATH 18,A02,083744,Staff,23,0,30,7
1651072016541,MATH 18,A03,083745,Staff,19,0,30,11
1651072016541,MATH 18,A04,083746,Staff,26,0,30,4
1651072016541,MATH 18,B01,083748,Staff,0,16,30,30
1651072016541,MATH 18,B02,083749,Staff,0,14,30,30
1651072016541,MATH 18,B03,083750,Staff,0,14,30,30
1651072016541,MATH 18,B04,083751,Staff,0,13,30,30
1651072022563,MATH 20A,A01,083754,Staff,18,0,40,22
1651072028590,MATH 20B,A01,083756,Staff,0,14,30,30
1651072028590,MATH 20B,A02,083757,Staff,0,11,30,30
1651072034614,MATH 20C,A01,083760,Staff,0,16,30,30
1651072034614,MATH 20C,A02,083761,Staff,0,15,30,30
1651072034614,MATH 20C,B01,083762,Staff,8,0,30,22
1651072034614,MATH 20C,B02,083763,Staff,28,0,30,2
1651072040641,MATH 20D,A01,083765,Staff,3,1,30,27
1651072040641,MATH 20D,A02,083766,Staff,1,0,30,29
1651072040641,MATH 20D,A03,083767,Staff,22,0,30,8
1651072046664,MATH 20E,A01,083771,Staff,2,0,30,28
1651072046664,MATH 20E,A02,083772,Staff,10,0,30,20
1651072046664,MATH 20E,B01,083773,Staff,0,0,30,30
1651072046664,MATH 20E,B02,083774,Staff,0,0,30,30
1651072052688,MATH 103A,A01,083777,Staff,0,17,30,30
1651072052688,MATH 103A,A02,083778,Staff,0,16,30,30
1651072052688,MATH 103A,B01,083779,Staff,0,15,30,30
1651072052688,MATH 103A,B02,083780,Staff,0,14,30,30
1651072058725,MATH 105,A01,085443,Staff,0,23,30,30
1651072064767,MATH 109,A01,083213,Anzaldo; Leesa B,0,7,30,30
1651072064767,MATH 109,A02,083214,Anzaldo; Leesa B,0,7,30,30
1651072064767,MATH 109,B01,083215,Anzaldo; Leesa B,0,8,30,30
1651072064767,MATH 109,B02,083216,Anzaldo; Leesa B,0,8,30,30
1651072070800,MATH 142A,A01,083219,Chow; Bennett,0,15,30,30
1651072070800,MATH 142A,A02,083220,Chow; Bennett,0,15,30,30
1651072070800,MATH 142A,B01,083221,Chow; Bennett,0,16,30,30
1651072070800,MATH 142A,B02,083222,Chow; Bennett,0,15,30,30
1651072076825,MATH 193A,A01,083224,Staff,0,8,30,30
1651072076825,MATH 193A,A02,083225,Staff,0,7,30,30
1651072076825,MATH 193A,A03,083781,Staff,0,7,30,30
1651072076825,MATH 193A,A04,083782,Staff,0,7,30,30
1651072082848,MATH 197,001,091859,McAuley; Julian John,9998,0,9999,1
1651072088899,COGS 9,A01,083615,Staff,0,20,60,60
1651072094924,COGS 11,A01,083617,Boyle; Mary E. T.,13,0,40,27
1651072100948,COGS 13,A01,083071,Staff,0,40,40,40
1651072106981,COGS 14A,A01,092681,Staff,0,40,100,100
1651072113004,COGS 14B,A01,083073,Cheng; Tzu-Han,0,13,50,50
1651072119030,COGS 17,A01,092677,Staff,9,0,75,66
1651072125054,COGS 100,A01,083619,Staff,0,30,60,60
1651072131077,COGS 101A,A01,083621,Davis; Joshua Daniel,0,29,60,60
1651072137105,COGS 101B,A01,091572,Staff,0,7,60,60
1651072143128,COGS 101C,A01,083625,Delgado; Tania,14,0,30,16
1651072149149,COGS 107A,A01,083627,Boyle; Mary E. T.,0,17,60,60
1651072155175,COGS 118A,A01,083075,Staff,0,10,60,60
1651072161202,CSE 3,A50,083646,Miranda; Gregory Joseph,15,0,38,23
1651072161202,CSE 3,A51,083647,Miranda; Gregory Joseph,36,0,37,1
1651072167229,CSE 8A,A50,083650,Miranda; Gregory Joseph,0,31,40,40
1651072173261,CSE 11,A01,083080,Cao; Yingjun,1,97,40,39
1651072179287,CSE 12,A01,083652,Staff,0,27,100,100
1651072185314,CSE 15L,A01,083654,Staff,0,3,50,50
1651072185314,CSE 15L,A02,083655,Staff,0,3,50,50
1651072191341,CSE 20,A01,083657,Staff,46,0,80,34
1651072197364,CSE 30,A01,083084,Eldon; John,0,38,80,80
1651072203391,CSE 100,A01,083659,Cao; Yingjun,0,72,50,50
1651072209419,CSE 134B,A01,083661,Powell; Thomas Allan,0,38,65,65
1651072215450,CSE 140,A01,083663,Staff,0,15,75,75
1651072221482,CSE 140L,A01,083088,Eldon; John,3,0,100,97
1651072227504,CSE 175,A01,083665,Kumar; Rakesh,0,0,25,25
1651072233530,CSE 190,A00,092507,Dubnov; Shlomo,9,0,20,11
1651072239557,ECE 45,A01,083139,Staff,0,7,60,60
1651072245582,ECE 65,A50,083695,Staff,0,7,30,30
1651072251619,ECE 109,A01,091882,Touri; Behrouz,33,0,70,37
1651072257643,ECE 180,A00,083140,Abi Samra; Nicholas Camill,17,0,30,13
1651072257643,ECE 180,B00,083141,Abi Samra; Nicholas Camill,0,0,30,30
1651072263679,MATH 10A,A01,083735,Patchell; Gregory David,0,0,30,30
1651072263679,MATH 10A,A02,083736,Patchell; Gregory David,27,0,30,3
1651072263679,MATH 10A,A03,083737,Patchell; Gregory David,22,0,30,8
1651072269707,MATH 10B,A01,083207,Staff,0,7,30,30
1651072269707,MATH 10B,A02,083208,Staff,0,6,30,30
1651072269707,MATH 10B,B01,083739,Staff,8,0,30,22
1651072269707,MATH 10B,B02,083740,Staff,28,0,30,2
1651072275733,MATH 18,A01,083743,Staff,0,0,30,30
1651072275733,MATH 18,A02,083744,Staff,23,0,30,7
1651072275733,MATH 18,A03,083745,Staff,19,0,30,11
1651072275733,MATH 18,A04,083746,Staff,26,0,30,4
1651072275733,MATH 18,B01,083748,Staff,0,16,30,30
1651072275733,MATH 18,B02,083749,Staff,0,14,30,30
1651072275733,MATH 18,B03,083750,Staff,0,14,30,30
1651072275733,MATH 18,B04,083751,Staff,0,13,30,30
1651072281758,MATH 20A,A01,083754,Staff,18,0,40,22
1651072287785,MATH 20B,A01,083756,Staff,0,14,30,30
1651072287785,MATH 20B,A02,083757,Staff,0,11,30,30
1651072293808,MATH 20C,A01,083760,Staff,0,16,30,30
1651072293808,MATH 20C,A02,083761,Staff,0,15,30,30
1651072293808,MATH 20C,B01,083762,Staff,8,0,30,22
1651072293808,MATH 20C,B02,083763,Staff,28,0,30,2
1651072299836,MATH 20D,A01,083765,Staff,3,1,30,27
1651072299836,MATH 20D,A02,083766,Staff,1,0,30,29
1651072299836,MATH 20D,A03,083767,Staff,22,0,30,8
1651072305863,MATH 20E,A01,083771,Staff,2,0,30,28
1651072305863,MATH 20E,A02,083772,Staff,10,0,30,20
1651072305863,MATH 20E,B01,083773,Staff,0,0,30,30
1651072305863,MATH 20E,B02,083774,Staff,0,0,30,30
1651072311892,MATH 103A,A01,083777,Staff,0,17,30,30
1651072311892,MATH 103A,A02,083778,Staff,0,16,30,30
1651072311892,MATH 103A,B01,083779,Staff,0,15,30,30
1651072311892,MATH 103A,B02,083780,Staff,0,14,30,30
1651072317918,MATH 105,A01,085443,Staff,0,23,30,30
1651072323948,MATH 109,A01,083213,Anzaldo; Leesa B,0,7,30,30
1651072323948,MATH 109,A02,083214,Anzaldo; Leesa B,0,7,30,30
1651072323948,MATH 109,B01,083215,Anzaldo; Leesa B,0,8,30,30
1651072323948,MATH 109,B02,083216,Anzaldo; Leesa B,0,8,30,30
1651072329977,MATH 142A,A01,083219,Chow; Bennett,0,15,30,30
1651072329977,MATH 142A,A02,083220,Chow; Bennett,0,15,30,30
1651072329977,MATH 142A,B01,083221,Chow; Bennett,0,16,30,30
1651072329977,MATH 142A,B02,083222,Chow; Bennett,0,15,30,30
1651072336003,MATH 193A,A01,083224,Staff,0,8,30,30
1651072336003,MATH 193A,A02,083225,Staff,0,7,30,30
1651072336003,MATH 193A,A03,083781,Staff,0,7,30,30
1651072336003,MATH 193A,A04,083782,Staff,0,7,30,30
1651072342028,MATH 197,001,091859,McAuley; Julian John,9998,0,9999,1
1651072348091,COGS 9,A01,083615,Staff,0,20,60,60
1651072354115,COGS 11,A01,083617,Boyle; Mary E. T.,13,0,40,27
1651072360143,COGS 13,A01,083071,Staff,0,40,40,40
1651072366165,COGS 14A,A01,092681,Staff,0,40,100,100
1651072372192,COGS 14B,A01,083073,Cheng; Tzu-Han,0,13,50,50
1651072378225,COGS 17,A01,092677,Staff,9,0,75,66
1651072384252,COGS 100,A01,083619,Staff,0,30,60,60
1651072390300,COGS 101A,A01,083621,Davis; Joshua Daniel,0,29,60,60
1651072396325,COGS 101B,A01,091572,Staff,0,7,60,60
1651072402351,COGS 101C,A01,083625,Delgado; Tania,14,0,30,16
1651072408386,COGS 107A,A01,083627,Boyle; Mary E. T.,0,17,60,60
1651072414410,COGS 118A,A01,083075,Staff,0,10,60,60
1651072420436,CSE 3,A50,083646,Miranda; Gregory Joseph,15,0,38,23
1651072420436,CSE 3,A51,083647,Miranda; Gregory Joseph,36,0,37,1
1651072426474,CSE 8A,A50,083650,Miranda; Gregory Joseph,0,31,40,40
1651072432515,CSE 11,A01,083080,Cao; Yingjun,1,97,40,39
1651072438541,CSE 12,A01,083652,Staff,0,27,100,100
1651072444577,CSE 15L,A01,083654,Staff,0,3,50,50
1651072444577,CSE 15L,A02,083655,Staff,0,3,50,50
1651072450601,CSE 20,A01,083657,Staff,46,0,80,34
1651072456636,CSE 30,A01,083084,Eldon; John,0,38,80,80
1651072462663,CSE 100,A01,083659,Cao; Yingjun,0,72,50,50
1651072468691,CSE 134B,A01,083661,Powell; Thomas Allan,0,38,65,65
1651072474719,CSE 140,A01,083663,Staff,0,15,75,75
1651072480744,CSE 140L,A01,083088,Eldon; John,3,0,100,97
1651072486771,CSE 175,A01,083665,Kumar; Rakesh,0,0,25,25
1651072492795,CSE 190,A00,092507,Dubnov; Shlomo,9,0,20,11
1651072498818,ECE 45,A01,083139,Staff,0,7,60,60
1651072504852,ECE 65,A50,083695,Staff,0,7,30,30
1651072510878,ECE 109,A01,091882,Touri; Behrouz,33,0,70,37
1651072516906,ECE 180,A00,083140,Abi Samra; Nicholas Camill,17,0,30,13
1651072516906,ECE 180,B00,083141,Abi Samra; Nicholas Camill,0,0,30,30
1651072522936,MATH 10A,A01,083735,Patchell; Gregory David,0,0,30,30
1651072522936,MATH 10A,A02,083736,Patchell; Gregory David,27,0,30,3
1651072522936,MATH 10A,A03,083737,Patchell; Gregory David,22,0,30,8
1651072528976,MATH 10B,A01,083207,Staff,0,7,30,30
1651072528976,MATH 10B,A02,083208,Staff,0,6,30,30
1651072528976,MATH 10B,B01,083739,Staff,8,0,30,22
1651072528976,MATH 10B,B02,083740,Staff,28,0,30,2
1651072535079,MATH 18,A01,083743,Staff,0,0,30,30
1651072535079,MATH 18,A02,083744,Staff,23,0,30,7
1651072535079,MATH 18,A03,083745,Staff,19,0,30,11
1651072535079,MATH 18,A04,083746,Staff,26,0,30,4
1651072535079,MATH 18,B01,083748,Staff,0,16,30,30
1651072535079,MATH 18,B02,083749,Staff,0,14,30,30
1651072535079,MATH 18,B03,083750,Staff,0,14,30,30
1651072535079,MATH 18,B04,083751,Staff,0,13,30,30
1651072541109,MATH 20A,A01,083754,Staff,18,0,40,22
1651072547133,MATH 20B,A01,083756,Staff,0,14,30,30
1651072547133,MATH 20B,A02,083757,Staff,0,11,30,30
1651072553162,MATH 20C,A01,083760,Staff,0,16,30,30
1651072553162,MATH 20C,A02,083761,Staff,0,15,30,30
1651072553162,MATH 20C,B01,083762,Staff,8,0,30,22
1651072553162,MATH 20C,B02,083763,Staff,28,0,30,2
1651072559187,MATH 20D,A01,083765,Staff,3,1,30,27
1651072559187,MATH 20D,A02,083766,Staff,1,0,30,29
1651072559187,MATH 20D,A03,083767,Staff,22,0,30,8
1651072565214,MATH 20E,A01,083771,Staff,2,0,30,28
1651072565214,MATH 20E,A02,083772,Staff,10,0,30,20
1651072565214,MATH 20E,B01,083773,Staff,0,0,30,30
1651072565214,MATH 20E,B02,083774,Staff,0,0,30,30
1651072571244,MATH 103A,A01,083777,Staff,0,17,30,30
1651072571244,MATH 103A,A02,083778,Staff,0,16,30,30
1651072571244,MATH 103A,B01,083779,Staff,0,15,30,30
1651072571244,MATH 103A,B02,083780,Staff,0,14,30,30
1651072577288,MATH 105,A01,085443,Staff,0,23,30,30
1651072583312,MATH 109,A01,083213,Anzaldo; Leesa B,0,7,30,30
1651072583312,MATH 109,A02,083214,Anzaldo; Leesa B,0,7,30,30
1651072583312,MATH 109,B01,083215,Anzaldo; Leesa B,0,8,30,30
1651072583312,MATH 109,B02,083216,Anzaldo; Leesa B,0,8,30,30
1651072589334,MATH 142A,A01,083219,Chow; Bennett,0,15,30,30
1651072589334,MATH 142A,A02,083220,Chow; Bennett,0,15,30,30
1651072589334,MATH 142A,B01,083221,Chow; Bennett,0,16,30,30
1651072589334,MATH 142A,B02,083222,Chow; Bennett,0,15,30,30
1651072595358,MATH 193A,A01,083224,Staff,0,8,30,30
1651072595358,MATH 193A,A02,083225,Staff,0,7,30,30
1651072595358,MATH 193A,A03,083781,Staff,0,7,30,30
1651072595358,MATH 193A,A04,083782,Staff,0,7,30,30
1651072601379,MATH 197,001,091859,McAuley; Julian John,9998,0,9999,1
1651072607433,COGS 9,A01,083615,Staff,0,20,60,60
1651072613462,COGS 11,A01,083617,Boyle; Mary E. T.,13,0,40,27
1651072619498,COGS 13,A01,083071,Staff,0,40,40,40
1651072625523,COGS 14A,A01,092681,Staff,0,40,100,100
1651072631545,COGS 14B,A01,083073,Cheng; Tzu-Han,0,13,50,50
1651072637568,COGS 17,A01,092677,Staff,9,0,75,66
1651072643593,COGS 100,A01,083619,Staff,0,30,60,60
1651072649614,COGS 101A,A01,083621,Davis; Joshua Daniel,0,29,60,60
1651072655649,COGS 101B,A01,091572,Staff,0,7,60,60
1651072661671,COGS 101C,A01,083625,Delgado; Tania,14,0,30,16
1651072667712,COGS 107A,A01,083627,Boyle; Mary E. T.,0,17,60,60
1651072673739,COGS 118A,A01,083075,Staff,0,10,60,60
1651072679764,CSE 3,A50,083646,Miranda; Gregory Joseph,15,0,38,23
1651072679764,CSE 3,A51,083647,Miranda; Gregory Joseph,36,0,37,1
1651072685803,CSE 8A,A50,083650,Miranda; Gregory Joseph,0,31,40,40
1651072691830,CSE 11,A01,083080,Cao; Yingjun,1,97,40,39
1651072697859,CSE 12,A01,083652,Staff,0,27,100,100
1651072703887,CSE 15L,A01,083654,Staff,0,3,50,50
1651072703887,CSE 15L,A02,083655,Staff,0,3,50,50
1651072709911,CSE 20,A01,083657,Staff,46,0,80,34
1651072715943,CSE 30,A01,083084,Eldon; John,0,38,80,80
1651072721973,CSE 100,A01,083659,Cao; Yingjun,0,72,50,50
1651072727998,CSE 134B,A01,083661,Powell; Thomas Allan,0,38,65,65
1651072734021,CSE 140,A01,083663,Staff,0,15,75,75
1651072740049,CSE 140L,A01,083088,Eldon; John,3,0,100,97
1651072746075,CSE 175,A01,083665,Kumar; Rakesh,0,0,25,25
1651072752098,CSE 190,A00,092507,Dubnov; Shlomo,9,0,20,11
1651072758131,ECE 45,A01,083139,Staff,0,7,60,60
1651072764153,ECE 65,A50,083695,Staff,0,7,30,30
1651072770177,ECE 109,A01,091882,Touri; Behrouz,33,0,70,37
1651072776204,ECE 180,A00,083140,Abi Samra; Nicholas Camill,17,0,30,13
1651072776204,ECE 180,B00,083141,Abi Samra; Nicholas Camill,0,0,30,30
1651072782228,MATH 10A,A01,083735,Patchell; Gregory David,0,0,30,30
1651072782228,MATH 10A,A02,083736,Patchell; Gregory David,27,0,30,3
1651072782228,MATH 10A,A03,083737,Patchell; Gregory David,22,0,30,8
1651072788251,MATH 10B,A01,083207,Staff,0,7,30,30
1651072788251,MATH 10B,A02,083208,Staff,0,6,30,30
1651072788251,MATH 10B,B01,083739,Staff,8,0,30,22
1651072788251,MATH 10B,B02,083740,Staff,28,0,30,2
1651072794281,MATH 18,A01,083743,Staff,0,0,30,30
1651072794281,MATH 18,A02,083744,Staff,23,0,30,7
1651072794281,MATH 18,A03,083745,Staff,19,0,30,11
1651072794281,MATH 18,A04,083746,Staff,26,0,30,4
1651072794281,MATH 18,B01,083748,Staff,0,16,30,30
1651072794281,MATH 18,B02,083749,Staff,0,14,30,30
1651072794281,MATH 18,B03,083750,Staff,0,14,30,30
1651072794281,MATH 18,B04,083751,Staff,0,13,30,30
1651072800311,MATH 20A,A01,083754,Staff,18,0,40,22
1651072806337,MATH 20B,A01,083756,Staff,0,14,30,30
1651072806337,MATH 20B,A02,083757,Staff,0,11,30,30
1651072812369,MATH 20C,A01,083760,Staff,0,16,30,30
1651072812369,MATH 20C,A02,083761,Staff,0,15,30,30
1651072812369,MATH 20C,B01,083762,Staff,8,0,30,22
1651072812369,MATH 20C,B02,083763,Staff,28,0,30,2
1651072818396,MATH 20D,A01,083765,Staff,3,1,30,27
1651072818396,MATH 20D,A02,083766,Staff,1,0,30,29
1651072818396,MATH 20D,A03,083767,Staff,22,0,30,8
1651072824424,MATH 20E,A01,083771,Staff,2,0,30,28
1651072824424,MATH 20E,A02,083772,Staff,10,0,30,20
1651072824424,MATH 20E,B01,083773,Staff,0,0,30,30
1651072824424,MATH 20E,B02,083774,Staff,0,0,30,30
1651072830452,MATH 103A,A01,083777,Staff,0,17,30,30
1651072830452,MATH 103A,A02,083778,Staff,0,16,30,30
1651072830452,MATH 103A,B01,083779,Staff,0,15,30,30
1651072830452,MATH 103A,B02,083780,Staff,0,14,30,30
1651072836479,MATH 105,A01,085443,Staff,0,23,30,30
1651072842514,MATH 109,A01,083213,Anzaldo; Leesa B,0,7,30,30
1651072842514,MATH 109,A02,083214,Anzaldo; Leesa B,0,7,30,30
1651072842514,MATH 109,B01,083215,Anzaldo; Leesa B,0,8,30,30
1651072842514,MATH 109,B02,083216,Anzaldo; Leesa B,0,8,30,30
1651072848536,MATH 142A,A01,083219,Chow; Bennett,0,15,30,30
1651072848536,MATH 142A,A02,083220,Chow; Bennett,0,15,30,30
1651072848536,MATH 142A,B01,083221,Chow; Bennett,0,16,30,30
1651072848536,MATH 142A,B02,083222,Chow; Bennett,0,15,30,30
1651072854560,MATH 193A,A01,083224,Staff,0,8,30,30
1651072854560,MATH 193A,A02,083225,Staff,0,7,30,30
1651072854560,MATH 193A,A03,083781,Staff,0,7,30,30
1651072854560,MATH 193A,A04,083782,Staff,0,7,30,30
1651072860592,MATH 197,001,091859,McAuley; Julian John,9998,0,9999,1
1651072866646,COGS 9,A01,083615,Staff,0,20,60,60
1651072872672,COGS 11,A01,083617,Boyle; Mary E. T.,13,0,40,27
1651072878700,COGS 13,A01,083071,Staff,0,40,40,40
1651072884726,COGS 14A,A01,092681,Staff,0,40,100,100
1651072890751,COGS 14B,A01,083073,Cheng; Tzu-Han,0,13,50,50
1651072896796,COGS 17,A01,092677,Staff,9,0,75,66
1651072902821,COGS 100,A01,083619,Staff,0,30,60,60
1651072908847,COGS 101A,A01,083621,Davis; Joshua Daniel,0,29,60,60
1651072914876,COGS 101B,A01,091572,Staff,0,7,60,60
1651072920902,COGS 101C,A01,083625,Delgado; Tania,14,0,30,16
1651072926930,COGS 107A,A01,083627,Boyle; Mary E. T.,0,17,60,60
1651072932957,COGS 118A,A01,083075,Staff,0,10,60,60
1651072938989,CSE 3,A50,083646,Miranda; Gregory Joseph,15,0,38,23
1651072938989,CSE 3,A51,083647,Miranda; Gregory Joseph,36,0,37,1
1651072945015,CSE 8A,A50,083650,Miranda; Gregory Joseph,0,31,40,40
1651072951038,CSE 11,A01,083080,Cao; Yingjun,1,97,40,39
1651072957063,CSE 12,A01,083652,Staff,0,27,100,100
1651072963088,CSE 15L,A01,083654,Staff,0,3,50,50
1651072963088,CSE 15L,A02,083655,Staff,0,3,50,50
1651072969116,CSE 20,A01,083657,Staff,46,0,80,34
1651072975146,CSE 30,A01,083084,Eldon; John,0,38,80,80
1651072981178,CSE 100,A01,083659,Cao; Yingjun,0,72,50,50
1651072987203,CSE 134B,A01,083661,Powell; Thomas Allan,0,38,65,65
1651072993230,CSE 140,A01,083663,Staff,0,15,75,75
1651072999260,CSE 140L,A01,083088,Eldon; John,3,0,100,97
1651073005283,CSE 175,A01,083665,Kumar; Rakesh,0,0,25,25
1651073011310,CSE 190,A00,092507,Dubnov; Shlomo,9,0,20,11
1651073017335,ECE 45,A01,083139,Staff,0,7,60,60
1651073023370,ECE 65,A50,083695,Staff,0,7,30,30
1651073029399,ECE 109,A01,091882,Touri; Behrouz,33,0,70,37
1651073035425,ECE 180,A00,083140,Abi Samra; Nicholas Camill,17,0,30,13
1651073035425,ECE 180,B00,083141,Abi Samra; Nicholas Camill,0,0,30,30
1651073041456,MATH 10A,A01,083735,Patchell; Gregory David,0,0,30,30
1651073041456,MATH 10A,A02,083736,Patchell; Gregory David,27,0,30,3
1651073041456,MATH 10A,A03,083737,Patchell; Gregory David,22,0,30,8
1651073047483,MATH 10B,A01,083207,Staff,0,7,30,30
1651073047483,MATH 10B,A02,083208,Staff,0,6,30,30
1651073047483,MATH 10B,B01,083739,Staff,8,0,30,22
1651073047483,MATH 10B,B02,083740,Staff,28,0,30,2
1651073053513,MATH 18,A01,083743,Staff,0,0,30,30
1651073053513,MATH 18,A02,083744,Staff,23,0,30,7
1651073053513,MATH 18,A03,083745,Staff,19,0,30,11
1651073053513,MATH 18,A04,083746,Staff,26,0,30,4
1651073053513,MATH 18,B01,083748,Staff,0,16,30,30
1651073053513,MATH 18,B02,083749,Staff,0,14,30,30
1651073053513,MATH 18,B03,083750,Staff,0,14,30,30
1651073053513,MATH 18,B04,083751,Staff,0,13,30,30
1651073059539,MATH 20A,A01,083754,Staff,18,0,40,22
1651073065562,MATH 20B,A01,083756,Staff,0,14,30,30
1651073065562,MATH 20B,A02,083757,Staff,0,11,30,30
1651073071596,MATH 20C,A01,083760,Staff,0,16,30,30
1651073071596,MATH 20C,A02,083761,Staff,0,15,30,30
1651073071596,MATH 20C,B01,083762,Staff,8,0,30,22
1651073071596,MATH 20C,B02,083763,Staff,28,0,30,2
1651073077620,MATH 20D,A01,083765,Staff,3,1,30,27
1651073077620,MATH 20D,A02,083766,Staff,1,0,30,29
1651073077620,MATH 20D,A03,083767,Staff,22,0,30,8
1651073083650,MATH 20E,A01,083771,Staff,2,0,30,28
1651073083650,MATH 20E,A02,083772,Staff,10,0,30,20
1651073083650,MATH 20E,B01,083773,Staff,0,0,30,30
1651073083650,MATH 20E,B02,083774,Staff,0,0,30,30
1651073089674,MATH 103A,A01,083777,Staff,0,17,30,30
1651073089674,MATH 103A,A02,083778,Staff,0,16,30,30
1651073089674,MATH 103A,B01,083779,Staff,0,15,30,30
1651073089674,MATH 103A,B02,083780,Staff,0,14,30,30
1651073095699,MATH 105,A01,085443,Staff,0,23,30,30
1651073101725,MATH 109,A01,083213,Anzaldo; Leesa B,0,7,30,30
1651073101725,MATH 109,A02,083214,Anzaldo; Leesa B,0,7,30,30
1651073101725,MATH 109,B01,083215,Anzaldo; Leesa B,0,8,30,30
1651073101725,MATH 109,B02,083216,Anzaldo; Leesa B,0,8,30,30
1651073107757,MATH 142A,A01,083219,Chow; Bennett,0,15,30,30
1651073107757,MATH 142A,A02,083220,Chow; Bennett,0,15,30,30
1651073107757,MATH 142A,B01,083221,Chow; Bennett,0,16,30,30
1651073107757,MATH 142A,B02,083222,Chow; Bennett,0,15,30,30
1651073113792,MATH 193A,A01,083224,Staff,0,8,30,30
1651073113792,MATH 193A,A02,083225,Staff,0,7,30,30
1651073113792,MATH 193A,A03,083781,Staff,0,7,30,30
1651073113792,MATH 193A,A04,083782,Staff,0,7,30,30
1651073119825,MATH 197,001,091859,McAuley; Julian John,9998,0,9999,1
1651073125961,COGS 9,A01,083615,Staff,0,20,60,60
1651073131990,COGS 11,A01,083617,Boyle; Mary E. T.,13,0,40,27
1651073138014,COGS 13,A01,083071,Staff,0,40,40,40
1651073144043,COGS 14A,A01,092681,Staff,0,40,100,100
1651073150068,COGS 14B,A01,083073,Cheng; Tzu-Han,0,13,50,50
1651073156091,COGS 17,A01,092677,Staff,9,0,75,66
1651073162120,COGS 100,A01,083619,Staff,0,30,60,60
1651073168165,COGS 101A,A01,083621,Davis; Joshua Daniel,0,29,60,60
1651073174191,COGS 101B,A01,091572,Staff,0,7,60,60
1651073180215,COGS 101C,A01,083625,Delgado; Tania,14,0,30,16
1651073186236,COGS 107A,A01,083627,Boyle; Mary E. T.,0,17,60,60
1651073192270,COGS 118A,A01,083075,Staff,0,10,60,60
1651073198297,CSE 3,A50,083646,Miranda; Gregory Joseph,15,0,38,23
1651073198297,CSE 3,A51,083647,Miranda; Gregory Joseph,36,0,37,1
1651073204320,CSE 8A,A50,083650,Miranda; Gregory Joseph,0,31,40,40
1651073210347,CSE 11,A01,083080,Cao; Yingjun,1,97,40,39
1651073216371,CSE 12,A01,083652,Staff,0,27,100,100
1651073222394,CSE 15L,A01,083654,Staff,0,3,50,50
1651073222394,CSE 15L,A02,083655,Staff,0,3,50,50
1651073228430,CSE 20,A01,083657,Staff,46,0,80,34
1651073234454,CSE 30,A01,083084,Eldon; John,0,38,80,80
1651073240489,CSE 100,A01,083659,Cao; Yingjun,0,72,50,50
1651073246517,CSE 134B,A01,083661,Powell; Thomas Allan,0,38,65,65
1651073252541,CSE 140,A01,083663,Staff,0,15,75,75
1651073258565,CSE 140L,A01,083088,Eldon; John,3,0,100,97
1651073264588,CSE 175,A01,083665,Kumar; Rakesh,0,0,25,25
1651073270615,CSE 190,A00,092507,Dubnov; Shlomo,9,0,20,11
1651073276639,ECE 45,A01,083139,Staff,0,7,60,60
1651073282663,ECE 65,A50,083695,Staff,0,7,30,30
1651073288688,ECE 109,A01,091882,Touri; Behrouz,33,0,70,37
1651073294714,ECE 180,A00,083140,Abi Samra; Nicholas Camill,17,0,30,13
1651073294714,ECE 180,B00,083141,Abi Samra; Nicholas Camill,0,0,30,30
1651073300749,MATH 10A,A01,083735,Patchell; Gregory David,0,0,30,30
1651073300749,MATH 10A,A02,083736,Patchell; Gregory David,27,0,30,3
1651073300749,MATH 10A,A03,083737,Patchell; Gregory David,22,0,30,8
1651073306780,MATH 10B,A01,083207,Staff,0,7,30,30
1651073306780,MATH 10B,A02,083208,Staff,0,6,30,30
1651073306780,MATH 10B,B01,083739,Staff,8,0,30,22
1651073306780,MATH 10B,B02,083740,Staff,28,0,30,2
1651073312846,MATH 18,A01,083743,Staff,0,0,30,30
1651073312846,MATH 18,A02,083744,Staff,23,0,30,7
1651073312846,MATH 18,A03,083745,Staff,19,0,30,11
1651073312846,MATH 18,A04,083746,Staff,26,0,30,4
1651073312846,MATH 18,B01,083748,Staff,0,16,30,30
1651073312846,MATH 18,B02,083749,Staff,0,14,30,30
1651073312846,MATH 18,B03,083750,Staff,0,14,30,30
1651073312846,MATH 18,B04,083751,Staff,0,13,30,30
1651073318873,MATH 20A,A01,083754,Staff,18,0,40,22
1651073324901,MATH 20B,A01,083756,Staff,0,14,30,30
1651073324901,MATH 20B,A02,083757,Staff,0,11,30,30
1651073330932,MATH 20C,A01,083760,Staff,0,16,30,30
1651073330932,MATH 20C,A02,083761,Staff,0,15,30,30
1651073330932,MATH 20C,B01,083762,Staff,8,0,30,22
1651073330932,MATH 20C,B02,083763,Staff,28,0,30,2
1651073336955,MATH 20D,A01,083765,Staff,3,1,30,27
1651073336955,MATH 20D,A02,083766,Staff,1,0,30,29
1651073336955,MATH 20D,A03,083767,Staff,22,0,30,8
1651073342987,MATH 20E,A01,083771,Staff,2,0,30,28
1651073342987,MATH 20E,A02,083772,Staff,10,0,30,20
1651073342987,MATH 20E,B01,083773,Staff,0,0,30,30
1651073342987,MATH 20E,B02,083774,Staff,0,0,30,30
1651073349025,MATH 103A,A01,083777,Staff,0,17,30,30
1651073349025,MATH 103A,A02,083778,Staff,0,16,30,30
1651073349025,MATH 103A,B01,083779,Staff,0,15,30,30
1651073349025,MATH 103A,B02,083780,Staff,0,14,30,30
1651073355053,MATH 105,A01,085443,Staff,0,23,30,30
1651073361079,MATH 109,A01,083213,Anzaldo; Leesa B,0,7,30,30
1651073361079,MATH 109,A02,083214,Anzaldo; Leesa B,0,7,30,30
1651073361079,MATH 109,B01,083215,Anzaldo; Leesa B,0,8,30,30
1651073361079,MATH 109,B02,083216,Anzaldo; Leesa B,0,8,30,30
1651073367109,MATH 142A,A01,083219,Chow; Bennett,0,15,30,30
1651073367109,MATH 142A,A02,083220,Chow; Bennett,0,15,30,30
1651073367109,MATH 142A,B01,083221,Chow; Bennett,0,16,30,30
1651073367109,MATH 142A,B02,083222,Chow; Bennett,0,15,30,30
1651073373134,MATH 193A,A01,083224,Staff,0,8,30,30
1651073373134,MATH 193A,A02,083225,Staff,0,7,30,30
1651073373134,MATH 193A,A03,083781,Staff,0,7,30,30
1651073373134,MATH 193A,A04,083782,Staff,0,7,30,30
1651073379157,MATH 197,001,091859,McAuley; Julian John,9998,0,9999,1
1651073385215,COGS 9,A01,083615,Staff,0,20,60,60
1651073391239,COGS 11,A01,083617,Boyle; Mary E. T.,13,0,40,27
1651073397271,COGS 13,A01,083071,Staff,0,40,40,40
1651073403300,COGS 14A,A01,092681,Staff,0,40,100,100
1651073409327,COGS 14B,A01,083073,Cheng; Tzu-Han,0,13,50,50
1651073415355,COGS 17,A01,092677,Staff,9,0,75,66
1651073421378,COGS 100,A01,083619,Staff,0,30,60,60
1651073427403,COGS 101A,A01,083621,Davis; Joshua Daniel,0,29,60,60
1651073433446,COGS 101B,A01,091572,Staff,0,7,60,60
1651073439473,COGS 101C,A01,083625,Delgado; Tania,14,0,30,16
1651073445499,COGS 107A,A01,083627,Boyle; Mary E. T.,0,17,60,60
1651073451523,COGS 118A,A01,083075,Staff,0,10,60,60
1651073457552,CSE 3,A50,083646,Miranda; Gregory Joseph,15,0,38,23
1651073457552,CSE 3,A51,083647,Miranda; Gregory Joseph,36,0,37,1
1651073463576,CSE 8A,A50,083650,Miranda; Gregory Joseph,0,31,40,40
1651073469601,CSE 11,A01,083080,Cao; Yingjun,1,97,40,39
1651073475638,CSE 12,A01,083652,Staff,0,27,100,100
1651073481659,CSE 15L,A01,083654,Staff,0,3,50,50
1651073481659,CSE 15L,A02,083655,Staff,0,3,50,50
1651073487683,CSE 20,A01,083657,Staff,46,0,80,34
1651073493723,CSE 30,A01,083084,Eldon; John,0,38,80,80
1651073499744,CSE 100,A01,083659,Cao; Yingjun,0,72,50,50
1651073505769,CSE 134B,A01,083661,Powell; Thomas Allan,0,38,65,65
1651073511793,CSE 140,A01,083663,Staff,0,15,75,75
1651073517817,CSE 140L,A01,083088,Eldon; John,3,0,100,97
1651073523844,CSE 175,A01,083665,Kumar; Rakesh,0,0,25,25
1651073529874,CSE 190,A00,092507,Dubnov; Shlomo,9,0,20,11
1651073535900,ECE 45,A01,083139,Staff,0,7,60,60
1651073541926,ECE 65,A50,083695,Staff,0,7,30,30
1651073547948,ECE 109,A01,091882,Touri; Behrouz,33,0,70,37
1651073553972,ECE 180,A00,083140,Abi Samra; Nicholas Camill,17,0,30,13
1651073553972,ECE 180,B00,083141,Abi Samra; Nicholas Camill,0,0,30,30
1651073560014,MATH 10A,A01,083735,Patchell; Gregory David,0,0,30,30
1651073560014,MATH 10A,A02,083736,Patchell; Gregory David,27,0,30,3
1651073560014,MATH 10A,A03,083737,Patchell; Gregory David,22,0,30,8
1651073566043,MATH 10B,A01,083207,Staff,0,7,30,30
1651073566043,MATH 10B,A02,083208,Staff,0,6,30,30
1651073566043,MATH 10B,B01,083739,Staff,8,0,30,22
1651073566043,MATH 10B,B02,083740,Staff,28,0,30,2
1651073572072,MATH 18,A01,083743,Staff,0,0,30,30
1651073572072,MATH 18,A02,083744,Staff,23,0,30,7
1651073572072,MATH 18,A03,083745,Staff,19,0,30,11
1651073572072,MATH 18,A04,083746,Staff,26,0,30,4
1651073572072,MATH 18,B01,083748,Staff,0,16,30,30
1651073572072,MATH 18,B02,083749,Staff,0,14,30,30
1651073572072,MATH 18,B03,083750,Staff,0,14,30,30
1651073572072,MATH 18,B04,083751,Staff,0,13,30,30
1651073578098,MATH 20A,A01,083754,Staff,18,0,40,22
1651073584126,MATH 20B,A01,083756,Staff,0,14,30,30
1651073584126,MATH 20B,A02,083757,Staff,0,11,30,30
1651073590148,MATH 20C,A01,083760,Staff,0,16,30,30
1651073590148,MATH 20C,A02,083761,Staff,0,15,30,30
1651073590148,MATH 20C,B01,083762,Staff,8,0,30,22
1651073590148,MATH 20C,B02,083763,Staff,28,0,30,2
1651073596171,MATH 20D,A01,083765,Staff,3,1,30,27
1651073596171,MATH 20D,A02,083766,Staff,1,0,30,29
1651073596171,MATH 20D,A03,083767,Staff,22,0,30,8
1651073602202,MATH 20E,A01,083771,Staff,2,0,30,28
1651073602202,MATH 20E,A02,083772,Staff,10,0,30,20
1651073602202,MATH 20E,B01,083773,Staff,0,0,30,30
1651073602202,MATH 20E,B02,083774,Staff,0,0,30,30
1651073608225,MATH 103A,A01,083777,Staff,0,17,30,30
1651073608225,MATH 103A,A02,083778,Staff,0,16,30,30
1651073608225,MATH 103A,B01,083779,Staff,0,15,30,30
1651073608225,MATH 103A,B02,083780,Staff,0,14,30,30
1651073614250,MATH 105,A01,085443,Staff,0,23,30,30
1651073620274,MATH 109,A01,083213,Anzaldo; Leesa B,0,7,30,30
1651073620274,MATH 109,A02,083214,Anzaldo; Leesa B,0,7,30,30
1651073620274,MATH 109,B01,083215,Anzaldo; Leesa B,0,8,30,30
1651073620274,MATH 109,B02,083216,Anzaldo; Leesa B,0,8,30,30
1651073626298,MATH 142A,A01,083219,Chow; Bennett,0,15,30,30
1651073626298,MATH 142A,A02,083220,Chow; Bennett,0,15,30,30
1651073626298,MATH 142A,B01,083221,Chow; Bennett,0,16,30,30
1651073626298,MATH 142A,B02,083222,Chow; Bennett,0,15,30,30
1651073632324,MATH 193A,A01,083224,Staff,0,8,30,30
1651073632324,MATH 193A,A02,083225,Staff,0,7,30,30
1651073632324,MATH 193A,A03,083781,Staff,0,7,30,30
1651073632324,MATH 193A,A04,083782,Staff,0,7,30,30
1651073638356,MATH 197,001,091859,McAuley; Julian John,9998,0,9999,1
1651073644415,COGS 9,A01,083615,Staff,0,20,60,60
1651073650444,COGS 11,A01,083617,Boyle; Mary E. T.,13,0,40,27
1651073656470,COGS 13,A01,083071,Staff,0,40,40,40
1651073662496,COGS 14A,A01,092681,Staff,0,40,100,100
1651073668523,COGS 14B,A01,083073,Cheng; Tzu-Han,0,13,50,50
1651073674552,COGS 17,A01,092677,Staff,9,0,75,66
1651073680583,COGS 100,A01,083619,Staff,0,30,60,60
1651073686605,COGS 101A,A01,083621,Davis; Joshua Daniel,0,29,60,60
1651073692630,COGS 101B,A01,091572,Staff,0,7,60,60
1651073698657,COGS 101C,A01,083625,Delgado; Tania,14,0,30,16
1651073704686,COGS 107A,A01,083627,Boyle; Mary E. T.,0,17,60,60
1651073710709,COGS 118A,A01,083075,Staff,0,10,60,60
1651073716735,CSE 3,A50,083646,Miranda; Gregory Joseph,15,0,38,23
1651073716735,CSE 3,A51,083647,Miranda; Gregory Joseph,36,0,37,1
1651073722836,CSE 8A,A50,083650,Miranda; Gregory Joseph,0,31,40,40
1651073728859,CSE 11,A01,083080,Cao; Yingjun,1,97,40,39
1651073734884,CSE 12,A01,083652,Staff,0,27,100,100
1651073740907,CSE 15L,A01,083654,Staff,0,3,50,50
1651073740907,CSE 15L,A02,083655,Staff,0,3,50,50
1651073746933,CSE 20,A01,083657,Staff,46,0,80,34
1651073752956,CSE 30,A01,083084,Eldon; John,0,38,80,80
1651073758987,CSE 100,A01,083659,Cao; Yingjun,0,72,50,50
1651073765010,CSE 134B,A01,083661,Powell; Thomas Allan,0,38,65,65
1651073771036,CSE 140,A01,083663,Staff,0,15,75,75
1651073777062,CSE 140L,A01,083088,Eldon; John,3,0,100,97
1651073783088,CSE 175,A01,083665,Kumar; Rakesh,0,0,25,25
1651073789111,CSE 190,A00,092507,Dubnov; Shlomo,9,0,20,11
1651073795145,ECE 45,A01,083139,Staff,0,7,60,60
1651073801171,ECE 65,A50,083695,Staff,0,7,30,30
1651073807206,ECE 109,A01,091882,Touri; Behrouz,33,0,70,37
1651073813228,ECE 180,A00,083140,Abi Samra; Nicholas Camill,17,0,30,13
1651073813228,ECE 180,B00,083141,Abi Samra; Nicholas Camill,0,0,30,30
1651073819251,MATH 10A,A01,083735,Patchell; Gregory David,0,0,30,30
1651073819251,MATH 10A,A02,083736,Patchell; Gregory David,27,0,30,3
1651073819251,MATH 10A,A03,083737,Patchell; Gregory David,22,0,30,8
1651073825279,MATH 10B,A01,083207,Staff,0,7,30,30
1651073825279,MATH 10B,A02,083208,Staff,0,6,30,30
1651073825279,MATH 10B,B01,083739,Staff,8,0,30,22
1651073825279,MATH 10B,B02,083740,Staff,28,0,30,2
1651073831303,MATH 18,A01,083743,Staff,0,0,30,30
1651073831303,MATH 18,A02,083744,Staff,23,0,30,7
1651073831303,MATH 18,A03,083745,Staff,19,0,30,11
1651073831303,MATH 18,A04,083746,Staff,26,0,30,4
1651073831303,MATH 18,B01,083748,Staff,0,16,30,30
1651073831303,MATH 18,B02,083749,Staff,0,14,30,30
1651073831303,MATH 18,B03,083750,Staff,0,14,30,30
1651073831303,MATH 18,B04,083751,Staff,0,13,30,30
1651073837335,MATH 20A,A01,083754,Staff,18,0,40,22
1651073843366,MATH 20B,A01,083756,Staff,0,14,30,30
1651073843366,MATH 20B,A02,083757,Staff,0,11,30,30
1651073849402,MATH 20C,A01,083760,Staff,0,16,30,30
1651073849402,MATH 20C,A02,083761,Staff,0,15,30,30
1651073849402,MATH 20C,B01,083762,Staff,8,0,30,22
1651073849402,MATH 20C,B02,083763,Staff,28,0,30,2
1651073855438,MATH 20D,A01,083765,Staff,3,1,30,27
1651073855438,MATH 20D,A02,083766,Staff,1,0,30,29
1651073855438,MATH 20D,A03,083767,Staff,22,0,30,8
1651073861459,MATH 20E,A01,083771,Staff,2,0,30,28
1651073861459,MATH 20E,A02,083772,Staff,10,0,30,20
1651073861459,MATH 20E,B01,083773,Staff,0,0,30,30
1651073861459,MATH 20E,B02,083774,Staff,0,0,30,30
1651073867490,MATH 103A,A01,083777,Staff,0,17,30,30
1651073867490,MATH 103A,A02,083778,Staff,0,16,30,30
1651073867490,MATH 103A,B01,083779,Staff,0,15,30,30
1651073867490,MATH 103A,B02,083780,Staff,0,14,30,30
1651073873514,MATH 105,A01,085443,Staff,0,23,30,30
1651073879538,MATH 109,A01,083213,Anzaldo; Leesa B,0,7,30,30
1651073879538,MATH 109,A02,083214,Anzaldo; Leesa B,0,7,30,30
1651073879538,MATH 109,B01,083215,Anzaldo; Leesa B,0,8,30,30
1651073879538,MATH 109,B02,083216,Anzaldo; Leesa B,0,8,30,30
1651073885568,MATH 142A,A01,083219,Chow; Bennett,0,15,30,30
1651073885568,MATH 142A,A02,083220,Chow; Bennett,0,15,30,30
1651073885568,MATH 142A,B01,083221,Chow; Bennett,0,16,30,30
1651073885568,MATH 142A,B02,083222,Chow; Bennett,0,15,30,30
1651073891589,MATH 193A,A01,083224,Staff,0,8,30,30
1651073891589,MATH 193A,A02,083225,Staff,0,7,30,30
1651073891589,MATH 193A,A03,083781,Staff,0,7,30,30
1651073891589,MATH 193A,A04,083782,Staff,0,7,30,30
1651073897615,MATH 197,001,091859,McAuley; Julian John,9998,0,9999,1
1651073903670,COGS 9,A01,083615,Staff,0,20,60,60
1651073909695,COGS 11,A01,083617,Boyle; Mary E. T.,13,0,40,27
1651073915719,COGS 13,A01,083071,Staff,0,40,40,40
1651073921743,COGS 14A,A01,092681,Staff,0,40,100,100
1651073927770,COGS 14B,A01,083073,Cheng; Tzu-Han,0,13,50,50
1651073933797,COGS 17,A01,092677,Staff,9,0,75,66
1651073939820,COGS 100,A01,083619,Staff,0,30,60,60
1651073945842,COGS 101A,A01,083621,Davis; Joshua Daniel,0,29,60,60
1651073951870,COGS 101B,A01,091572,Staff,0,7,60,60
1651073957902,COGS 101C,A01,083625,Delgado; Tania,14,0,30,16
1651073963938,COGS 107A,A01,083627,Boyle; Mary E. T.,0,17,60,60
1651073969970,COGS 118A,A01,083075,Staff,0,10,60,60
1651073975999,CSE 3,A50,083646,Miranda; Gregory Joseph,15,0,38,23
1651073975999,CSE 3,A51,083647,Miranda; Gregory Joseph,36,0,37,1
1651073982045,CSE 8A,A50,083650,Miranda; Gregory Joseph,0,31,40,40
1651073988068,CSE 11,A01,083080,Cao; Yingjun,1,97,40,39
1651073994093,CSE 12,A01,083652,Staff,0,27,100,100
1651074000116,CSE 15L,A01,083654,Staff,0,3,50,50
1651074000116,CSE 15L,A02,083655,Staff,0,3,50,50
1651074006138,CSE 20,A01,083657,Staff,46,0,80,34
1651074012164,CSE 30,A01,083084,Eldon; John,0,38,80,80
1651074018189,CSE 100,A01,083659,Cao; Yingjun,0,72,50,50
1651074024215,CSE 134B,A01,083661,Powell; Thomas Allan,0,38,65,65
1651074030247,CSE 140,A01,083663,Staff,0,15,75,75
1651074036272,CSE 140L,A01,083088,Eldon; John,3,0,100,97
1651074042294,CSE 175,A01,083665,Kumar; Rakesh,0,0,25,25
1651074048317,CSE 190,A00,092507,Dubnov; Shlomo,9,0,20,11
1651074054340,ECE 45,A01,083139,Staff,0,7,60,60
1651074060364,ECE 65,A50,083695,Staff,0,7,30,30
1651074066386,ECE 109,A01,091882,Touri; Behrouz,33,0,70,37
1651074072412,ECE 180,A00,083140,Abi Samra; Nicholas Camill,17,0,30,13
1651074072412,ECE 180,B00,083141,Abi Samra; Nicholas Camill,0,0,30,30
1651074078440,MATH 10A,A01,083735,Patchell; Gregory David,0,0,30,30
1651074078440,MATH 10A,A02,083736,Patchell; Gregory David,27,0,30,3
1651074078440,MATH 10A,A03,083737,Patchell; Gregory David,22,0,30,8
1651074084476,MATH 10B,A01,083207,Staff,0,7,30,30
1651074084476,MATH 10B,A02,083208,Staff,0,6,30,30
1651074084476,MATH 10B,B01,083739,Staff,8,0,30,22
1651074084476,MATH 10B,B02,083740,Staff,28,0,30,2
1651074090502,MATH 18,A01,083743,Staff,0,0,30,30
1651074090502,MATH 18,A02,083744,Staff,23,0,30,7
1651074090502,MATH 18,A03,083745,Staff,19,0,30,11
1651074090502,MATH 18,A04,083746,Staff,26,0,30,4
1651074090502,MATH 18,B01,083748,Staff,0,16,30,30
1651074090502,MATH 18,B02,083749,Staff,0,14,30,30
1651074090502,MATH 18,B03,083750,Staff,0,14,30,30
1651074090502,MATH 18,B04,083751,Staff,0,13,30,30
1651074096537,MATH 20A,A01,083754,Staff,18,0,40,22
1651074102561,MATH 20B,A01,083756,Staff,0,14,30,30
1651074102561,MATH 20B,A02,083757,Staff,0,11,30,30
1651074108589,MATH 20C,A01,083760,Staff,0,16,30,30
1651074108589,MATH 20C,A02,083761,Staff,0,15,30,30
1651074108589,MATH 20C,B01,083762,Staff,8,0,30,22
1651074108589,MATH 20C,B02,083763,Staff,28,0,30,2
1651074114614,MATH 20D,A01,083765,Staff,3,1,30,27
1651074114614,MATH 20D,A02,083766,Staff,1,0,30,29
1651074114614,MATH 20D,A03,083767,Staff,22,0,30,8
1651074120645,MATH 20E,A01,083771,Staff,2,0,30,28
1651074120645,MATH 20E,A02,083772,Staff,10,0,30,20
1651074120645,MATH 20E,B01,083773,Staff,0,0,30,30
1651074120645,MATH 20E,B02,083774,Staff,0,0,30,30
1651074126669,MATH 103A,A01,083777,Staff,0,17,30,30
1651074126669,MATH 103A,A02,083778,Staff,0,16,30,30
1651074126669,MATH 103A,B01,083779,Staff,0,15,30,30
1651074126669,MATH 103A,B02,083780,Staff,0,14,30,30
1651074132695,MATH 105,A01,085443,Staff,0,23,30,30
1651074138718,MATH 109,A01,083213,Anzaldo; Leesa B,0,7,30,30
1651074138718,MATH 109,A02,083214,Anzaldo; Leesa B,0,7,30,30
1651074138718,MATH 109,B01,083215,Anzaldo; Leesa B,0,8,30,30
1651074138718,MATH 109,B02,083216,Anzaldo; Leesa B,0,8,30,30
1651074144742,MATH 142A,A01,083219,Chow; Bennett,0,15,30,30
1651074144742,MATH 142A,A02,083220,Chow; Bennett,0,15,30,30
1651074144742,MATH 142A,B01,083221,Chow; Bennett,0,16,30,30
1651074144742,MATH 142A,B02,083222,Chow; Bennett,0,15,30,30
1651074150767,MATH 193A,A01,083224,Staff,0,8,30,30
1651074150767,MATH 193A,A02,083225,Staff,0,7,30,30
1651074150767,MATH 193A,A03,083781,Staff,0,7,30,30
1651074150767,MATH 193A,A04,083782,Staff,0,7,30,30
1651074156789,MATH 197,001,091859,McAuley; Julian John,9998,0,9999,1
1651074162846,COGS 9,A01,083615,Staff,0,20,60,60
1651074168884,COGS 11,A01,083617,Boyle; Mary E. T.,13,0,40,27
1651074174908,COGS 13,A01,083071,Staff,0,40,40,40
1651074180931,COGS 14A,A01,092681,Staff,0,40,100,100
1651074186955,COGS 14B,A01,083073,Cheng; Tzu-Han,0,13,50,50
1651074192981,COGS 17,A01,092677,Staff,9,0,75,66
1651074199016,COGS 100,A01,083619,Staff,0,30,60,60
1651074205046,COGS 101A,A01,083621,Davis; Joshua Daniel,0,29,60,60
1651074211070,COGS 101B,A01,091572,Staff,0,7,60,60
1651074217108,COGS 101C,A01,083625,Delgado; Tania,14,0,30,16
1651074223134,COGS 107A,A01,083627,Boyle; Mary E. T.,0,17,60,60
1651074229159,COGS 118A,A01,083075,Staff,0,10,60,60
1651074235204,CSE 3,A50,083646,Miranda; Gregory Joseph,15,0,38,23
1651074235204,CSE 3,A51,083647,Miranda; Gregory Joseph,36,0,37,1
1651074241233,CSE 8A,A50,083650,Miranda; Gregory Joseph,0,31,40,40
1651074247274,CSE 11,A01,083080,Cao; Yingjun,1,97,40,39
1651074253299,CSE 12,A01,083652,Staff,0,27,100,100
1651074259334,CSE 15L,A01,083654,Staff,0,3,50,50
1651074259334,CSE 15L,A02,083655,Staff,0,3,50,50
1651074265360,CSE 20,A01,083657,Staff,46,0,80,34
1651074271386,CSE 30,A01,083084,Eldon; John,0,38,80,80
1651074277409,CSE 100,A01,083659,Cao; Yingjun,0,72,50,50
1651074283435,CSE 134B,A01,083661,Powell; Thomas Allan,0,38,65,65
1651074289459,CSE 140,A01,083663,Staff,0,15,75,75
1651074295486,CSE 140L,A01,083088,Eldon; John,3,0,100,97
1651074301518,CSE 175,A01,083665,Kumar; Rakesh,0,0,25,25
1651074307545,CSE 190,A00,092507,Dubnov; Shlomo,9,0,20,11
1651074313570,ECE 45,A01,083139,Staff,0,7,60,60
1651074319690,ECE 65,A50,083695,Staff,0,7,30,30
1651074325715,ECE 109,A01,091882,Touri; Behrouz,33,0,70,37
1651074331740,ECE 180,A00,083140,Abi Samra; Nicholas Camill,17,0,30,13
1651074331740,ECE 180,B00,083141,Abi Samra; Nicholas Camill,0,0,30,30
1651074337766,MATH 10A,A01,083735,Patchell; Gregory David,0,0,30,30
1651074337766,MATH 10A,A02,083736,Patchell; Gregory David,27,0,30,3
1651074337766,MATH 10A,A03,083737,Patchell; Gregory David,22,0,30,8
1651074343789,MATH 10B,A01,083207,Staff,0,7,30,30
1651074343789,MATH 10B,A02,083208,Staff,0,6,30,30
1651074343789,MATH 10B,B01,083739,Staff,8,0,30,22
1651074343789,MATH 10B,B02,083740,Staff,28,0,30,2
1651074349814,MATH 18,A01,083743,Staff,0,0,30,30
1651074349814,MATH 18,A02,083744,Staff,23,0,30,7
1651074349814,MATH 18,A03,083745,Staff,19,0,30,11
1651074349814,MATH 18,A04,083746,Staff,26,0,30,4
1651074349814,MATH 18,B01,083748,Staff,0,16,30,30
1651074349814,MATH 18,B02,083749,Staff,0,14,30,30
1651074349814,MATH 18,B03,083750,Staff,0,14,30,30
1651074349814,MATH 18,B04,083751,Staff,0,13,30,30
1651074355838,MATH 20A,A01,083754,Staff,18,0,40,22
1651074361864,MATH 20B,A01,083756,Staff,0,14,30,30
1651074361864,MATH 20B,A02,083757,Staff,0,11,30,30
1651074367893,MATH 20C,A01,083760,Staff,0,16,30,30
1651074367893,MATH 20C,A02,083761,Staff,0,15,30,30
1651074367893,MATH 20C,B01,083762,Staff,8,0,30,22
1651074367893,MATH 20C,B02,083763,Staff,28,0,30,2
1651074373926,MATH 20D,A01,083765,Staff,3,1,30,27
1651074373926,MATH 20D,A02,083766,Staff,1,0,30,29
1651074373926,MATH 20D,A03,083767,Staff,22,0,30,8
1651074379952,MATH 20E,A01,083771,Staff,2,0,30,28
1651074379952,MATH 20E,A02,083772,Staff,10,0,30,20
1651074379952,MATH 20E,B01,083773,Staff,0,0,30,30
1651074379952,MATH 20E,B02,083774,Staff,0,0,30,30
1651074385981,MATH 103A,A01,083777,Staff,0,17,30,30
1651074385981,MATH 103A,A02,083778,Staff,0,16,30,30
1651074385981,MATH 103A,B01,083779,Staff,0,15,30,30
1651074385981,MATH 103A,B02,083780,Staff,0,14,30,30
1651074392019,MATH 105,A01,085443,Staff,0,23,30,30
1651074398045,MATH 109,A01,083213,Anzaldo; Leesa B,0,7,30,30
1651074398045,MATH 109,A02,083214,Anzaldo; Leesa B,0,7,30,30
1651074398045,MATH 109,B01,083215,Anzaldo; Leesa B,0,8,30,30
1651074398045,MATH 109,B02,083216,Anzaldo; Leesa B,0,8,30,30
1651074404074,MATH 142A,A01,083219,Chow; Bennett,0,15,30,30
1651074404074,MATH 142A,A02,083220,Chow; Bennett,0,15,30,30
1651074404074,MATH 142A,B01,083221,Chow; Bennett,0,16,30,30
1651074404074,MATH 142A,B02,083222,Chow; Bennett,0,15,30,30
1651074410099,MATH 193A,A01,083224,Staff,0,8,30,30
1651074410099,MATH 193A,A02,083225,Staff,0,7,30,30
1651074410099,MATH 193A,A03,083781,Staff,0,7,30,30
1651074410099,MATH 193A,A04,083782,Staff,0,7,30,30
1651074416123,MATH 197,001,091859,McAuley; Julian John,9998,0,9999,1
1651074422182,COGS 9,A01,083615,Staff,0,20,60,60
1651074428204,COGS 11,A01,083617,Boyle; Mary E. T.,13,0,40,27
1651074434228,COGS 13,A01,083071,Staff,0,40,40,40
1651074440251,COGS 14A,A01,092681,Staff,0,40,100,100
1651074446274,COGS 14B,A01,083073,Cheng; Tzu-Han,0,13,50,50
1651074452310,COGS 17,A01,092677,Staff,9,0,75,66
1651074458333,COGS 100,A01,083619,Staff,0,30,60,60
1651074464360,COGS 101A,A01,083621,Davis; Joshua Daniel,0,29,60,60
1651074470383,COGS 101B,A01,091572,Staff,0,7,60,60
1651074476404,COGS 101C,A01,083625,Delgado; Tania,14,0,30,16
1651074482426,COGS 107A,A01,083627,Boyle; Mary E. T.,0,17,60,60
1651074488449,COGS 118A,A01,083075,Staff,0,10,60,60
1651074494476,CSE 3,A50,083646,Miranda; Gregory Joseph,15,0,38,23
1651074494476,CSE 3,A51,083647,Miranda; Gregory Joseph,36,0,37,1
1651074500500,CSE 8A,A50,083650,Miranda; Gregory Joseph,0,31,40,40
1651074506522,CSE 11,A01,083080,Cao; Yingjun,1,97,40,39
1651074512550,CSE 12,A01,083652,Staff,0,27,100,100
1651074518577,CSE 15L,A01,083654,Staff,0,3,50,50
1651074518577,CSE 15L,A02,083655,Staff,0,3,50,50
1651074524611,CSE 20,A01,083657,Staff,46,0,80,34
1651074530637,CSE 30,A01,083084,Eldon; John,0,38,80,80
1651074536664,CSE 100,A01,083659,Cao; Yingjun,0,72,50,50
1651074542697,CSE 134B,A01,083661,Powell; Thomas Allan,0,38,65,65
1651074548721,CSE 140,A01,083663,Staff,0,15,75,75
1651074554755,CSE 140L,A01,083088,Eldon; John,3,0,100,97
1651074560779,CSE 175,A01,083665,Kumar; Rakesh,0,0,25,25
1651074566802,CSE 190,A00,092507,Dubnov; Shlomo,9,0,20,11
1651074572831,ECE 45,A01,083139,Staff,0,7,60,60
1651074578855,ECE 65,A50,083695,Staff,0,7,30,30
1651074584892,ECE 109,A01,091882,Touri; Behrouz,33,0,70,37
1651074590919,ECE 180,A00,083140,Abi Samra; Nicholas Camill,17,0,30,13
1651074590919,ECE 180,B00,083141,Abi Samra; Nicholas Camill,0,0,30,30
1651074596946,MATH 10A,A01,083735,Patchell; Gregory David,0,0,30,30
1651074596946,MATH 10A,A02,083736,Patchell; Gregory David,27,0,30,3
1651074596946,MATH 10A,A03,083737,Patchell; Gregory David,22,0,30,8
1651074602973,MATH 10B,A01,083207,Staff,0,7,30,30
1651074602973,MATH 10B,A02,083208,Staff,0,6,30,30
1651074602973,MATH 10B,B01,083739,Staff,8,0,30,22
1651074602973,MATH 10B,B02,083740,Staff,28,0,30,2
1651074609016,MATH 18,A01,083743,Staff,0,0,30,30
1651074609016,MATH 18,A02,083744,Staff,23,0,30,7
1651074609016,MATH 18,A03,083745,Staff,19,0,30,11
1651074609016,MATH 18,A04,083746,Staff,26,0,30,4
1651074609016,MATH 18,B01,083748,Staff,0,16,30,30
1651074609016,MATH 18,B02,083749,Staff,0,14,30,30
1651074609016,MATH 18,B03,083750,Staff,0,14,30,30
1651074609016,MATH 18,B04,083751,Staff,0,13,30,30
1651074615051,MATH 20A,A01,083754,Staff,18,0,40,22
1651074621080,MATH 20B,A01,083756,Staff,0,14,30,30
1651074621080,MATH 20B,A02,083757,Staff,0,11,30,30
1651074627105,MATH 20C,A01,083760,Staff,0,16,30,30
1651074627105,MATH 20C,A02,083761,Staff,0,15,30,30
1651074627105,MATH 20C,B01,083762,Staff,8,0,30,22
1651074627105,MATH 20C,B02,083763,Staff,28,0,30,2
1651074633136,MATH 20D,A01,083765,Staff,3,1,30,27
1651074633136,MATH 20D,A02,083766,Staff,1,0,30,29
1651074633136,MATH 20D,A03,083767,Staff,22,0,30,8
1651074639164,MATH 20E,A01,083771,Staff,2,0,30,28
1651074639164,MATH 20E,A02,083772,Staff,10,0,30,20
1651074639164,MATH 20E,B01,083773,Staff,0,0,30,30
1651074639164,MATH 20E,B02,083774,Staff,0,0,30,30
1651074645193,MATH 103A,A01,083777,Staff,0,17,30,30
1651074645193,MATH 103A,A02,083778,Staff,0,16,30,30
1651074645193,MATH 103A,B01,083779,Staff,0,15,30,30
1651074645193,MATH 103A,B02,083780,Staff,0,14,30,30
1651074651218,MATH 105,A01,085443,Staff,0,23,30,30
1651074657247,MATH 109,A01,083213,Anzaldo; Leesa B,0,7,30,30
1651074657247,MATH 109,A02,083214,Anzaldo; Leesa B,0,7,30,30
1651074657247,MATH 109,B01,083215,Anzaldo; Leesa B,0,8,30,30
1651074657247,MATH 109,B02,083216,Anzaldo; Leesa B,0,8,30,30
1651074663276,MATH 142A,A01,083219,Chow; Bennett,0,15,30,30
1651074663276,MATH 142A,A02,083220,Chow; Bennett,0,15,30,30
1651074663276,MATH 142A,B01,083221,Chow; Bennett,0,16,30,30
1651074663276,MATH 142A,B02,083222,Chow; Bennett,0,15,30,30
1651074669299,MATH 193A,A01,083224,Staff,0,8,30,30
1651074669299,MATH 193A,A02,083225,Staff,0,7,30,30
1651074669299,MATH 193A,A03,083781,Staff,0,7,30,30
1651074669299,MATH 193A,A04,083782,Staff,0,7,30,30
1651074675323,MATH 197,001,091859,McAuley; Julian John,9998,0,9999,1
1651074681382,COGS 9,A01,083615,Staff,0,20,60,60
1651074687404,COGS 11,A01,083617,Boyle; Mary E. T.,13,0,40,27
1651074693431,COGS 13,A01,083071,Staff,0,40,40,40
1651074699455,COGS 14A,A01,092681,Staff,0,40,100,100
1651074705477,COGS 14B,A01,083073,Cheng; Tzu-Han,0,13,50,50
1651074711501,COGS 17,A01,092677,Staff,9,0,75,66
1651074717528,COGS 100,A01,083619,Staff,0,30,60,60
1651074723556,COGS 101A,A01,083621,Davis; Joshua Daniel,0,29,60,60
1651074729578,COGS 101B,A01,091572,Staff,0,7,60,60
1651074735608,COGS 101C,A01,083625,Delgado; Tania,14,0,30,16
1651074741630,COGS 107A,A01,083627,Boyle; Mary E. T.,0,17,60,60
1651074747652,COGS 118A,A01,083075,Staff,0,10,60,60
1651074753682,CSE 3,A50,083646,Miranda; Gregory Joseph,15,0,38,23
1651074753682,CSE 3,A51,083647,Miranda; Gregory Joseph,36,0,37,1
1651074759708,CSE 8A,A50,083650,Miranda; Gregory Joseph,0,31,40,40
1651074765754,CSE 11,A01,083080,Cao; Yingjun,1,97,40,39
1651074771778,CSE 12,A01,083652,Staff,0,27,100,100
1651074777802,CSE 15L,A01,083654,Staff,0,3,50,50
1651074777802,CSE 15L,A02,083655,Staff,0,3,50,50
1651074783826,CSE 20,A01,083657,Staff,46,0,80,34
1651074789852,CSE 30,A01,083084,Eldon; John,0,38,80,80
1651074795878,CSE 100,A01,083659,Cao; Yingjun,0,72,50,50
1651074801906,CSE 134B,A01,083661,Powell; Thomas Allan,0,38,65,65
1651074807932,CSE 140,A01,083663,Staff,0,15,75,75
1651074813985,CSE 140L,A01,083088,Eldon; John,3,0,100,97
1651074820011,CSE 175,A01,083665,Kumar; Rakesh,0,0,25,25
1651074826033,CSE 190,A00,092507,Dubnov; Shlomo,9,0,20,11
1651074832057,ECE 45,A01,083139,Staff,0,7,60,60
1651074838086,ECE 65,A50,083695,Staff,0,7,30,30
1651074844119,ECE 109,A01,091882,Touri; Behrouz,33,0,70,37
1651074850143,ECE 180,A00,083140,Abi Samra; Nicholas Camill,17,0,30,13
1651074850143,ECE 180,B00,083141,Abi Samra; Nicholas Camill,0,0,30,30
1651074856182,MATH 10A,A01,083735,Patchell; Gregory David,0,0,30,30
1651074856182,MATH 10A,A02,083736,Patchell; Gregory David,27,0,30,3
1651074856182,MATH 10A,A03,083737,Patchell; Gregory David,22,0,30,8
1651074862205,MATH 10B,A01,083207,Staff,0,7,30,30
1651074862205,MATH 10B,A02,083208,Staff,0,6,30,30
1651074862205,MATH 10B,B01,083739,Staff,8,0,30,22
1651074862205,MATH 10B,B02,083740,Staff,28,0,30,2
1651074868228,MATH 18,A01,083743,Staff,0,0,30,30
1651074868228,MATH 18,A02,083744,Staff,23,0,30,7
1651074868228,MATH 18,A03,083745,Staff,19,0,30,11
1651074868228,MATH 18,A04,083746,Staff,26,0,30,4
1651074868228,MATH 18,B01,083748,Staff,0,16,30,30
1651074868228,MATH 18,B02,083749,Staff,0,14,30,30
1651074868228,MATH 18,B03,083750,Staff,0,14,30,30
1651074868228,MATH 18,B04,083751,Staff,0,13,30,30
1651074874251,MATH 20A,A01,083754,Staff,18,0,40,22
1651074880275,MATH 20B,A01,083756,Staff,0,14,30,30
1651074880275,MATH 20B,A02,083757,Staff,0,11,30,30
1651074886299,MATH 20C,A01,083760,Staff,0,16,30,30
1651074886299,MATH 20C,A02,083761,Staff,0,15,30,30
1651074886299,MATH 20C,B01,083762,Staff,8,0,30,22
1651074886299,MATH 20C,B02,083763,Staff,28,0,30,2
1651074892322,MATH 20D,A01,083765,Staff,3,1,30,27
1651074892322,MATH 20D,A02,083766,Staff,1,0,30,29
1651074892322,MATH 20D,A03,083767,Staff,22,0,30,8
1651074898358,MATH 20E,A01,083771,Staff,2,0,30,28
1651074898358,MATH 20E,A02,083772,Staff,10,0,30,20
1651074898358,MATH 20E,B01,083773,Staff,0,0,30,30
1651074898358,MATH 20E,B02,083774,Staff,0,0,30,30
1651074904381,MATH 103A,A01,083777,Staff,0,17,30,30
1651074904381,MATH 103A,A02,083778,Staff,0,16,30,30
1651074904381,MATH 103A,B01,083779,Staff,0,15,30,30
1651074904381,MATH 103A,B02,083780,Staff,0,14,30,30
1651074910409,MATH 105,A01,085443,Staff,0,23,30,30
1651074916509,MATH 109,A01,083213,Anzaldo; Leesa B,0,7,30,30
1651074916509,MATH 109,A02,083214,Anzaldo; Leesa B,0,7,30,30
1651074916509,MATH 109,B01,083215,Anzaldo; Leesa B,0,8,30,30
1651074916509,MATH 109,B02,083216,Anzaldo; Leesa B,0,8,30,30
1651074922532,MATH 142A,A01,083219,Chow; Bennett,0,15,30,30
1651074922532,MATH 142A,A02,083220,Chow; Bennett,0,15,30,30
1651074922532,MATH 142A,B01,083221,Chow; Bennett,0,16,30,30
1651074922532,MATH 142A,B02,083222,Chow; Bennett,0,15,30,30
1651074928556,MATH 193A,A01,083224,Staff,0,8,30,30
1651074928556,MATH 193A,A02,083225,Staff,0,7,30,30
1651074928556,MATH 193A,A03,083781,Staff,0,7,30,30
1651074928556,MATH 193A,A04,083782,Staff,0,7,30,30
1651074934586,MATH 197,001,091859,McAuley; Julian John,9998,0,9999,1
1651074940650,COGS 9,A01,083615,Staff,0,20,60,60
1651074946682,COGS 11,A01,083617,Boyle; Mary E. T.,13,0,40,27
1651074952708,COGS 13,A01,083071,Staff,0,40,40,40
1651074958752,COGS 14A,A01,092681,Staff,0,40,100,100
1651074964775,COGS 14B,A01,083073,Cheng; Tzu-Han,0,13,50,50
1651074970799,COGS 17,A01,092677,Staff,9,0,75,66
1651074976821,COGS 100,A01,083619,Staff,0,30,60,60
1651074982843,COGS 101A,A01,083621,Davis; Joshua Daniel,0,29,60,60
1651074988868,COGS 101B,A01,091572,Staff,0,7,60,60
1651074994889,COGS 101C,A01,083625,Delgado; Tania,14,0,30,16
1651075000912,COGS 107A,A01,083627,Boyle; Mary E. T.,0,17,60,60
1651075006945,COGS 118A,A01,083075,Staff,0,10,60,60
1651075012970,CSE 3,A50,083646,Miranda; Gregory Joseph,15,0,38,23
1651075012970,CSE 3,A51,083647,Miranda; Gregory Joseph,36,0,37,1
1651075018992,CSE 8A,A50,083650,Miranda; Gregory Joseph,0,31,40,40
1651075025014,CSE 11,A01,083080,Cao; Yingjun,1,97,40,39
1651075031047,CSE 12,A01,083652,Staff,0,27,100,100
1651075037073,CSE 15L,A01,083654,Staff,0,3,50,50
1651075037073,CSE 15L,A02,083655,Staff,0,3,50,50
1651075043095,CSE 20,A01,083657,Staff,46,0,80,34
1651075049117,CSE 30,A01,083084,Eldon; John,0,38,80,80
1651075055149,CSE 100,A01,083659,Cao; Yingjun,0,72,50,50
1651075061175,CSE 134B,A01,083661,Powell; Thomas Allan,0,38,65,65
1651075067198,CSE 140,A01,083663,Staff,0,15,75,75
1651075073228,CSE 140L,A01,083088,Eldon; John,3,0,100,97
1651075079251,CSE 175,A01,083665,Kumar; Rakesh,0,0,25,25
1651075085275,CSE 190,A00,092507,Dubnov; Shlomo,9,0,20,11
1651075091304,ECE 45,A01,083139,Staff,0,7,60,60
1651075097330,ECE 65,A50,083695,Staff,0,7,30,30
1651075103355,ECE 109,A01,091882,Touri; Behrouz,33,0,70,37
1651075109377,ECE 180,A00,083140,Abi Samra; Nicholas Camill,17,0,30,13
1651075109377,ECE 180,B00,083141,Abi Samra; Nicholas Camill,0,0,30,30
1651075115402,MATH 10A,A01,083735,Patchell; Gregory David,0,0,30,30
1651075115402,MATH 10A,A02,083736,Patchell; Gregory David,27,0,30,3
1651075115402,MATH 10A,A03,083737,Patchell; Gregory David,22,0,30,8
1651075121431,MATH 10B,A01,083207,Staff,0,7,30,30
1651075121431,MATH 10B,A02,083208,Staff,0,6,30,30
1651075121431,MATH 10B,B01,083739,Staff,8,0,30,22
1651075121431,MATH 10B,B02,083740,Staff,28,0,30,2
1651075127461,MATH 18,A01,083743,Staff,0,0,30,30
1651075127461,MATH 18,A02,083744,Staff,23,0,30,7
1651075127461,MATH 18,A03,083745,Staff,19,0,30,11
1651075127461,MATH 18,A04,083746,Staff,26,0,30,4
1651075127461,MATH 18,B01,083748,Staff,0,16,30,30
1651075127461,MATH 18,B02,083749,Staff,0,14,30,30
1651075127461,MATH 18,B03,083750,Staff,0,14,30,30
1651075127461,MATH 18,B04,083751,Staff,0,13,30,30
1651075133485,MATH 20A,A01,083754,Staff,18,0,40,22
1651075139514,MATH 20B,A01,083756,Staff,0,14,30,30
1651075139514,MATH 20B,A02,083757,Staff,0,11,30,30
1651075145538,MATH 20C,A01,083760,Staff,0,16,30,30
1651075145538,MATH 20C,A02,083761,Staff,0,15,30,30
1651075145538,MATH 20C,B01,083762,Staff,8,0,30,22
1651075145538,MATH 20C,B02,083763,Staff,28,0,30,2
1651075151564,MATH 20D,A01,083765,Staff,3,1,30,27
1651075151564,MATH 20D,A02,083766,Staff,1,0,30,29
1651075151564,MATH 20D,A03,083767,Staff,22,0,30,8
1651075157589,MATH 20E,A01,083771,Staff,2,0,30,28
1651075157589,MATH 20E,A02,083772,Staff,10,0,30,20
1651075157589,MATH 20E,B01,083773,Staff,0,0,30,30
1651075157589,MATH 20E,B02,083774,Staff,0,0,30,30
1651075163616,MATH 103A,A01,083777,Staff,0,17,30,30
1651075163616,MATH 103A,A02,083778,Staff,0,16,30,30
1651075163616,MATH 103A,B01,083779,Staff,0,15,30,30
1651075163616,MATH 103A,B02,083780,Staff,0,14,30,30
1651075169637,MATH 105,A01,085443,Staff,0,23,30,30
1651075175669,MATH 109,A01,083213,Anzaldo; Leesa B,0,7,30,30
1651075175669,MATH 109,A02,083214,Anzaldo; Leesa B,0,7,30,30
1651075175669,MATH 109,B01,083215,Anzaldo; Leesa B,0,8,30,30
1651075175669,MATH 109,B02,083216,Anzaldo; Leesa B,0,8,30,30
1651075181693,MATH 142A,A01,083219,Chow; Bennett,0,15,30,30
1651075181693,MATH 142A,A02,083220,Chow; Bennett,0,15,30,30
1651075181693,MATH 142A,B01,083221,Chow; Bennett,0,16,30,30
1651075181693,MATH 142A,B02,083222,Chow; Bennett,0,15,30,30
1651075187724,MATH 193A,A01,083224,Staff,0,8,30,30
1651075187724,MATH 193A,A02,083225,Staff,0,7,30,30
1651075187724,MATH 193A,A03,083781,Staff,0,7,30,30
1651075187724,MATH 193A,A04,083782,Staff,0,7,30,30
1651075193749,MATH 197,001,091859,McAuley; Julian John,9998,0,9999,1
1651075199806,COGS 9,A01,083615,Staff,0,20,60,60
1651075205839,COGS 11,A01,083617,Boyle; Mary E. T.,13,0,40,27
1651075211879,COGS 13,A01,083071,Staff,0,40,40,40
1651075217906,COGS 14A,A01,092681,Staff,0,40,100,100
1651075223932,COGS 14B,A01,083073,Cheng; Tzu-Han,0,13,50,50
1651075229956,COGS 17,A01,092677,Staff,9,0,75,66
1651075235980,COGS 100,A01,083619,Staff,0,30,60,60
1651075242002,COGS 101A,A01,083621,Davis; Joshua Daniel,0,29,60,60
1651075248026,COGS 101B,A01,091572,Staff,0,7,60,60
1651075254054,COGS 101C,A01,083625,Delgado; Tania,14,0,30,16
1651075260087,COGS 107A,A01,083627,Boyle; Mary E. T.,0,17,60,60
1651075266114,COGS 118A,A01,083075,Staff,0,10,60,60
1651075272138,CSE 3,A50,083646,Miranda; Gregory Joseph,15,0,38,23
1651075272138,CSE 3,A51,083647,Miranda; Gregory Joseph,36,0,37,1
1651075278163,CSE 8A,A50,083650,Miranda; Gregory Joseph,0,31,40,40
1651075284193,CSE 11,A01,083080,Cao; Yingjun,1,97,40,39
1651075290216,CSE 12,A01,083652,Staff,0,27,100,100
1651075296246,CSE 15L,A01,083654,Staff,0,3,50,50
1651075296246,CSE 15L,A02,083655,Staff,0,3,50,50
1651075302289,CSE 20,A01,083657,Staff,46,0,80,34
1651075308312,CSE 30,A01,083084,Eldon; John,0,38,80,80
1651075314337,CSE 100,A01,083659,Cao; Yingjun,0,72,50,50
1651075320363,CSE 134B,A01,083661,Powell; Thomas Allan,0,38,65,65
1651075326387,CSE 140,A01,083663,Staff,0,15,75,75
1651075332411,CSE 140L,A01,083088,Eldon; John,3,0,100,97
1651075338439,CSE 175,A01,083665,Kumar; Rakesh,0,0,25,25
1651075344467,CSE 190,A00,092507,Dubnov; Shlomo,9,0,20,11
1651075350501,ECE 45,A01,083139,Staff,0,7,60,60
1651075356524,ECE 65,A50,083695,Staff,0,7,30,30
1651075362547,ECE 109,A01,091882,Touri; Behrouz,33,0,70,37
1651075368574,ECE 180,A00,083140,Abi Samra; Nicholas Camill,17,0,30,13
1651075368574,ECE 180,B00,083141,Abi Samra; Nicholas Camill,0,0,30,30
1651075374602,MATH 10A,A01,083735,Patchell; Gregory David,0,0,30,30
1651075374602,MATH 10A,A02,083736,Patchell; Gregory David,27,0,30,3
1651075374602,MATH 10A,A03,083737,Patchell; Gregory David,22,0,30,8
1651075380626,MATH 10B,A01,083207,Staff,0,7,30,30
1651075380626,MATH 10B,A02,083208,Staff,0,6,30,30
1651075380626,MATH 10B,B01,083739,Staff,8,0,30,22
1651075380626,MATH 10B,B02,083740,Staff,28,0,30,2
1651075386658,MATH 18,A01,083743,Staff,0,0,30,30
1651075386658,MATH 18,A02,083744,Staff,23,0,30,7
1651075386658,MATH 18,A03,083745,Staff,19,0,30,11
1651075386658,MATH 18,A04,083746,Staff,26,0,30,4
1651075386658,MATH 18,B01,083748,Staff,0,16,30,30
1651075386658,MATH 18,B02,083749,Staff,0,14,30,30
1651075386658,MATH 18,B03,083750,Staff,0,14,30,30
1651075386658,MATH 18,B04,083751,Staff,0,13,30,30
1651075392692,MATH 20A,A01,083754,Staff,18,0,40,22
1651075398720,MATH 20B,A01,083756,Staff,0,14,30,30
1651075398720,MATH 20B,A02,083757,Staff,0,11,30,30
1651075404744,MATH 20C,A01,083760,Staff,0,16,30,30
1651075404744,MATH 20C,A02,083761,Staff,0,15,30,30
1651075404744,MATH 20C,B01,083762,Staff,8,0,30,22
1651075404744,MATH 20C,B02,083763,Staff,28,0,30,2
1651075410773,MATH 20D,A01,083765,Staff,3,1,30,27
1651075410773,MATH 20D,A02,083766,Staff,1,0,30,29
1651075410773,MATH 20D,A03,083767,Staff,22,0,30,8
1651075416797,MATH 20E,A01,083771,Staff,2,0,30,28
1651075416797,MATH 20E,A02,083772,Staff,10,0,30,20
1651075416797,MATH 20E,B01,083773,Staff,0,0,30,30
1651075416797,MATH 20E,B02,083774,Staff,0,0,30,30
1651075422829,MATH 103A,A01,083777,Staff,0,17,30,30
1651075422829,MATH 103A,A02,083778,Staff,0,16,30,30
1651075422829,MATH 103A,B01,083779,Staff,0,15,30,30
1651075422829,MATH 103A,B02,083780,Staff,0,14,30,30
1651075428863,MATH 105,A01,085443,Staff,0,23,30,30
1651075434892,MATH 109,A01,083213,Anzaldo; Leesa B,0,7,30,30
1651075434892,MATH 109,A02,083214,Anzaldo; Leesa B,0,7,30,30
1651075434892,MATH 109,B01,083215,Anzaldo; Leesa B,0,8,30,30
1651075434892,MATH 109,B02,083216,Anzaldo; Leesa B,0,8,30,30
1651075440919,MATH 142A,A01,083219,Chow; Bennett,0,15,30,30
1651075440919,MATH 142A,A02,083220,Chow; Bennett,0,15,30,30
1651075440919,MATH 142A,B01,083221,Chow; Bennett,0,16,30,30
1651075440919,MATH 142A,B02,083222,Chow; Bennett,0,15,30,30
1651075446947,MATH 193A,A01,083224,Staff,0,8,30,30
1651075446947,MATH 193A,A02,083225,Staff,0,7,30,30
1651075446947,MATH 193A,A03,083781,Staff,0,7,30,30
1651075446947,MATH 193A,A04,083782,Staff,0,7,30,30
1651075452971,MATH 197,001,091859,McAuley; Julian John,9998,0,9999,1
1651075459028,COGS 9,A01,083615,Staff,0,20,60,60
1651075465055,COGS 11,A01,083617,Boyle; Mary E. T.,13,0,40,27
1651075471079,COGS 13,A01,083071,Staff,0,40,40,40
1651075477103,COGS 14A,A01,092681,Staff,0,40,100,100
1651075483127,COGS 14B,A01,083073,Cheng; Tzu-Han,0,13,50,50
1651075489151,COGS 17,A01,092677,Staff,9,0,75,66
1651075495179,COGS 100,A01,083619,Staff,0,30,60,60
1651075501201,COGS 101A,A01,083621,Davis; Joshua Daniel,0,29,60,60
1651075507313,COGS 101B,A01,091572,Staff,0,7,60,60
1651075513338,COGS 101C,A01,083625,Delgado; Tania,14,0,30,16
1651075519363,COGS 107A,A01,083627,Boyle; Mary E. T.,0,17,60,60
1651075525389,COGS 118A,A01,083075,Staff,0,10,60,60
1651075531416,CSE 3,A50,083646,Miranda; Gregory Joseph,15,0,38,23
1651075531416,CSE 3,A51,083647,Miranda; Gregory Joseph,36,0,37,1
1651075537441,CSE 8A,A50,083650,Miranda; Gregory Joseph,0,31,40,40
1651075543468,CSE 11,A01,083080,Cao; Yingjun,1,97,40,39
1651075549491,CSE 12,A01,083652,Staff,0,27,100,100
1651075555526,CSE 15L,A01,083654,Staff,0,3,50,50
1651075555526,CSE 15L,A02,083655,Staff,0,3,50,50
1651075561553,CSE 20,A01,083657,Staff,46,0,80,34
1651075567579,CSE 30,A01,083084,Eldon; John,0,38,80,80
1651075573609,CSE 100,A01,083659,Cao; Yingjun,0,72,50,50
1651075579636,CSE 134B,A01,083661,Powell; Thomas Allan,0,38,65,65
1651075585666,CSE 140,A01,083663,Staff,0,15,75,75
1651075591691,CSE 140L,A01,083088,Eldon; John,3,0,100,97
1651075597721,CSE 175,A01,083665,Kumar; Rakesh,0,0,25,25
1651075603745,CSE 190,A00,092507,Dubnov; Shlomo,9,0,20,11
1651075609779,ECE 45,A01,083139,Staff,0,7,60,60
1651075615804,ECE 65,A50,083695,Staff,0,7,30,30
1651075621834,ECE 109,A01,091882,Touri; Behrouz,33,0,70,37
1651075627862,ECE 180,A00,083140,Abi Samra; Nicholas Camill,17,0,30,13
1651075627862,ECE 180,B00,083141,Abi Samra; Nicholas Camill,0,0,30,30
1651075633886,MATH 10A,A01,083735,Patchell; Gregory David,0,0,30,30
1651075633886,MATH 10A,A02,083736,Patchell; Gregory David,27,0,30,3
1651075633886,MATH 10A,A03,083737,Patchell; Gregory David,22,0,30,8
1651075639922,MATH 10B,A01,083207,Staff,0,7,30,30
1651075639922,MATH 10B,A02,083208,Staff,0,6,30,30
1651075639922,MATH 10B,B01,083739,Staff,8,0,30,22
1651075639922,MATH 10B,B02,083740,Staff,28,0,30,2
1651075645951,MATH 18,A01,083743,Staff,0,0,30,30
1651075645951,MATH 18,A02,083744,Staff,23,0,30,7
1651075645951,MATH 18,A03,083745,Staff,19,0,30,11
1651075645951,MATH 18,A04,083746,Staff,26,0,30,4
1651075645951,MATH 18,B01,083748,Staff,0,16,30,30
1651075645951,MATH 18,B02,083749,Staff,0,14,30,30
1651075645951,MATH 18,B03,083750,Staff,0,14,30,30
1651075645951,MATH 18,B04,083751,Staff,0,13,30,30
1651075651975,MATH 20A,A01,083754,Staff,18,0,40,22
1651075658003,MATH 20B,A01,083756,Staff,0,14,30,30
1651075658003,MATH 20B,A02,083757,Staff,0,11,30,30
1651075664031,MATH 20C,A01,083760,Staff,0,16,30,30
1651075664031,MATH 20C,A02,083761,Staff,0,15,30,30
1651075664031,MATH 20C,B01,083762,Staff,8,0,30,22
1651075664031,MATH 20C,B02,083763,Staff,28,0,30,2
1651075670066,MATH 20D,A01,083765,Staff,3,1,30,27
1651075670066,MATH 20D,A02,083766,Staff,1,0,30,29
1651075670066,MATH 20D,A03,083767,Staff,22,0,30,8
1651075676090,MATH 20E,A01,083771,Staff,2,0,30,28
1651075676090,MATH 20E,A02,083772,Staff,10,0,30,20
1651075676090,MATH 20E,B01,083773,Staff,0,0,30,30
1651075676090,MATH 20E,B02,083774,Staff,0,0,30,30
1651075682114,MATH 103A,A01,083777,Staff,0,17,30,30
1651075682114,MATH 103A,A02,083778,Staff,0,16,30,30
1651075682114,MATH 103A,B01,083779,Staff,0,15,30,30
1651075682114,MATH 103A,B02,083780,Staff,0,14,30,30
1651075688140,MATH 105,A01,085443,Staff,0,23,30,30
1651075694171,MATH 109,A01,083213,Anzaldo; Leesa B,0,7,30,30
1651075694171,MATH 109,A02,083214,Anzaldo; Leesa B,0,7,30,30
1651075694171,MATH 109,B01,083215,Anzaldo; Leesa B,0,8,30,30
1651075694171,MATH 109,B02,083216,Anzaldo; Leesa B,0,8,30,30
1651075700199,MATH 142A,A01,083219,Chow; Bennett,0,15,30,30
1651075700199,MATH 142A,A02,083220,Chow; Bennett,0,15,30,30
1651075700199,MATH 142A,B01,083221,Chow; Bennett,0,16,30,30
1651075700199,MATH 142A,B02,083222,Chow; Bennett,0,15,30,30
1651075706223,MATH 193A,A01,083224,Staff,0,8,30,30
1651075706223,MATH 193A,A02,083225,Staff,0,7,30,30
1651075706223,MATH 193A,A03,083781,Staff,0,7,30,30
1651075706223,MATH 193A,A04,083782,Staff,0,7,30,30
1651075712246,MATH 197,001,091859,McAuley; Julian John,9998,0,9999,1
1651075718302,COGS 9,A01,083615,Staff,0,20,60,60
1651075724325,COGS 11,A01,083617,Boyle; Mary E. T.,13,0,40,27
1651075730353,COGS 13,A01,083071,Staff,0,40,40,40
1651075736379,COGS 14A,A01,092681,Staff,0,40,100,100
1651075742402,COGS 14B,A01,083073,Cheng; Tzu-Han,0,13,50,50
1651075748426,COGS 17,A01,092677,Staff,9,0,75,66
1651075754449,COGS 100,A01,083619,Staff,0,30,60,60
1651075760479,COGS 101A,A01,083621,Davis; Joshua Daniel,0,29,60,60
1651075766511,COGS 101B,A01,091572,Staff,0,7,60,60
1651075772533,COGS 101C,A01,083625,Delgado; Tania,14,0,30,16
1651075778564,COGS 107A,A01,083627,Boyle; Mary E. T.,0,17,60,60
1651075784590,COGS 118A,A01,083075,Staff,0,10,60,60
1651075790614,CSE 3,A50,083646,Miranda; Gregory Joseph,15,0,38,23
1651075790614,CSE 3,A51,083647,Miranda; Gregory Joseph,36,0,37,1
1651075796642,CSE 8A,A50,083650,Miranda; Gregory Joseph,0,31,40,40
1651075802679,CSE 11,A01,083080,Cao; Yingjun,1,97,40,39
1651075808707,CSE 12,A01,083652,Staff,0,27,100,100
1651075814748,CSE 15L,A01,083654,Staff,0,3,50,50
1651075814748,CSE 15L,A02,083655,Staff,0,3,50,50
1651075820773,CSE 20,A01,083657,Staff,46,0,80,34
1651075826799,CSE 30,A01,083084,Eldon; John,0,38,80,80
1651075832825,CSE 100,A01,083659,Cao; Yingjun,0,72,50,50
1651075838855,CSE 134B,A01,083661,Powell; Thomas Allan,0,38,65,65
1651075844888,CSE 140,A01,083663,Staff,0,15,75,75
1651075850914,CSE 140L,A01,083088,Eldon; John,3,0,100,97
1651075856937,CSE 175,A01,083665,Kumar; Rakesh,0,0,25,25
1651075862963,CSE 190,A00,092507,Dubnov; Shlomo,9,0,20,11
1651075868990,ECE 45,A01,083139,Staff,0,7,60,60
1651075875014,ECE 65,A50,083695,Staff,0,7,30,30
1651075881039,ECE 109,A01,091882,Touri; Behrouz,33,0,70,37
1651075887063,ECE 180,A00,083140,Abi Samra; Nicholas Camill,17,0,30,13
1651075887063,ECE 180,B00,083141,Abi Samra; Nicholas Camill,0,0,30,30
1651075893086,MATH 10A,A01,083735,Patchell; Gregory David,0,0,30,30
1651075893086,MATH 10A,A02,083736,Patchell; Gregory David,27,0,30,3
1651075893086,MATH 10A,A03,083737,Patchell; Gregory David,22,0,30,8
1651075899110,MATH 10B,A01,083207,Staff,0,7,30,30
1651075899110,MATH 10B,A02,083208,Staff,0,6,30,30
1651075899110,MATH 10B,B01,083739,Staff,8,0,30,22
1651075899110,MATH 10B,B02,083740,Staff,28,0,30,2
1651075905146,MATH 18,A01,083743,Staff,0,0,30,30
1651075905146,MATH 18,A02,083744,Staff,23,0,30,7
1651075905146,MATH 18,A03,083745,Staff,19,0,30,11
1651075905146,MATH 18,A04,083746,Staff,26,0,30,4
1651075905146,MATH 18,B01,083748,Staff,0,16,30,30
1651075905146,MATH 18,B02,083749,Staff,0,14,30,30
1651075905146,MATH 18,B03,083750,Staff,0,14,30,30
1651075905146,MATH 18,B04,083751,Staff,0,13,30,30
1651075911171,MATH 20A,A01,083754,Staff,18,0,40,22
1651075917198,MATH 20B,A01,083756,Staff,0,14,30,30
1651075917198,MATH 20B,A02,083757,Staff,0,11,30,30
1651075923226,MATH 20C,A01,083760,Staff,0,16,30,30
1651075923226,MATH 20C,A02,083761,Staff,0,15,30,30
1651075923226,MATH 20C,B01,083762,Staff,7,0,30,23
1651075923226,MATH 20C,B02,083763,Staff,28,0,30,2
1651075929253,MATH 20D,A01,083765,Staff,3,1,30,27
1651075929253,MATH 20D,A02,083766,Staff,1,0,30,29
1651075929253,MATH 20D,A03,083767,Staff,22,0,30,8
1651075935276,MATH 20E,A01,083771,Staff,2,0,30,28
1651075935276,MATH 20E,A02,083772,Staff,10,0,30,20
1651075935276,MATH 20E,B01,083773,Staff,0,0,30,30
1651075935276,MATH 20E,B02,083774,Staff,0,0,30,30
1651075941304,MATH 103A,A01,083777,Staff,0,17,30,30
1651075941304,MATH 103A,A02,083778,Staff,0,16,30,30
1651075941304,MATH 103A,B01,083779,Staff,0,15,30,30
1651075941304,MATH 103A,B02,083780,Staff,0,14,30,30
1651075947333,MATH 105,A01,085443,Staff,0,23,30,30
1651075953360,MATH 109,A01,083213,Anzaldo; Leesa B,0,7,30,30
1651075953360,MATH 109,A02,083214,Anzaldo; Leesa B,0,7,30,30
1651075953360,MATH 109,B01,083215,Anzaldo; Leesa B,0,8,30,30
1651075953360,MATH 109,B02,083216,Anzaldo; Leesa B,0,8,30,30
1651075959389,MATH 142A,A01,083219,Chow; Bennett,0,15,30,30
1651075959389,MATH 142A,A02,083220,Chow; Bennett,0,15,30,30
1651075959389,MATH 142A,B01,083221,Chow; Bennett,0,16,30,30
1651075959389,MATH 142A,B02,083222,Chow; Bennett,0,15,30,30
1651075965416,MATH 193A,A01,083224,Staff,0,8,30,30
1651075965416,MATH 193A,A02,083225,Staff,0,7,30,30
1651075965416,MATH 193A,A03,083781,Staff,0,7,30,30
1651075965416,MATH 193A,A04,083782,Staff,0,7,30,30
1651075971439,MATH 197,001,091859,McAuley; Julian John,9998,0,9999,1
1651075977500,COGS 9,A01,083615,Staff,0,20,60,60
1651075983530,COGS 11,A01,083617,Boyle; Mary E. T.,13,0,40,27
1651075989556,COGS 13,A01,083071,Staff,0,40,40,40
1651075995578,COGS 14A,A01,092681,Staff,0,40,100,100
1651076001601,COGS 14B,A01,083073,Cheng; Tzu-Han,0,14,50,50
1651076007626,COGS 17,A01,092677,Staff,9,0,75,66
1651076013655,COGS 100,A01,083619,Staff,0,30,60,60
1651076019678,COGS 101A,A01,083621,Davis; Joshua Daniel,0,29,60,60
1651076025702,COGS 101B,A01,091572,Staff,0,7,60,60
1651076031743,COGS 101C,A01,083625,Delgado; Tania,13,0,30,17
1651076037771,COGS 107A,A01,083627,Boyle; Mary E. T.,0,17,60,60
1651076043798,COGS 118A,A01,083075,Staff,0,10,60,60
1651076049825,CSE 3,A50,083646,Miranda; Gregory Joseph,15,0,38,23
1651076049825,CSE 3,A51,083647,Miranda; Gregory Joseph,36,0,37,1
1651076055854,CSE 8A,A50,083650,Miranda; Gregory Joseph,0,31,40,40
1651076061884,CSE 11,A01,083080,Cao; Yingjun,1,97,40,39
1651076067910,CSE 12,A01,083652,Staff,0,27,100,100
1651076073932,CSE 15L,A01,083654,Staff,0,3,50,50
1651076073932,CSE 15L,A02,083655,Staff,0,3,50,50
1651076079954,CSE 20,A01,083657,Staff,46,0,80,34
1651076085978,CSE 30,A01,083084,Eldon; John,0,38,80,80
1651076092003,CSE 100,A01,083659,Cao; Yingjun,0,72,50,50
1651076098027,CSE 134B,A01,083661,Powell; Thomas Allan,0,38,65,65
1651076104172,CSE 140,A01,083663,Staff,0,15,75,75
1651076110198,CSE 140L,A01,083088,Eldon; John,3,0,100,97
1651076116223,CSE 175,A01,083665,Kumar; Rakesh,0,0,25,25
1651076122254,CSE 190,A00,092507,Dubnov; Shlomo,9,0,20,11
1651076128278,ECE 45,A01,083139,Staff,0,7,60,60
1651076134305,ECE 65,A50,083695,Staff,0,7,30,30
1651076140331,ECE 109,A01,091882,Touri; Behrouz,33,0,70,37
1651076146366,ECE 180,A00,083140,Abi Samra; Nicholas Camill,17,0,30,13
1651076146366,ECE 180,B00,083141,Abi Samra; Nicholas Camill,0,0,30,30
1651076152393,MATH 10A,A01,083735,Patchell; Gregory David,0,0,30,30
1651076152393,MATH 10A,A02,083736,Patchell; Gregory David,27,0,30,3
1651076152393,MATH 10A,A03,083737,Patchell; Gregory David,22,0,30,8
1651076158419,MATH 10B,A01,083207,Staff,0,7,30,30
1651076158419,MATH 10B,A02,083208,Staff,0,6,30,30
1651076158419,MATH 10B,B01,083739,Staff,8,0,30,22
1651076158419,MATH 10B,B02,083740,Staff,28,0,30,2
1651076164446,MATH 18,A01,083743,Staff,0,0,30,30
1651076164446,MATH 18,A02,083744,Staff,23,0,30,7
1651076164446,MATH 18,A03,083745,Staff,19,0,30,11
1651076164446,MATH 18,A04,083746,Staff,26,0,30,4
1651076164446,MATH 18,B01,083748,Staff,0,16,30,30
1651076164446,MATH 18,B02,083749,Staff,0,14,30,30
1651076164446,MATH 18,B03,083750,Staff,0,14,30,30
1651076164446,MATH 18,B04,083751,Staff,0,13,30,30
1651076170469,MATH 20A,A01,083754,Staff,18,0,40,22
1651076176505,MATH 20B,A01,083756,Staff,0,14,30,30
1651076176505,MATH 20B,A02,083757,Staff,0,11,30,30
1651076182533,MATH 20C,A01,083760,Staff,0,16,30,30
1651076182533,MATH 20C,A02,083761,Staff,0,15,30,30
1651076182533,MATH 20C,B01,083762,Staff,7,0,30,23
1651076182533,MATH 20C,B02,083763,Staff,28,0,30,2
1651076188564,MATH 20D,A01,083765,Staff,3,1,30,27
1651076188564,MATH 20D,A02,083766,Staff,1,0,30,29
1651076188564,MATH 20D,A03,083767,Staff,22,0,30,8
1651076194592,MATH 20E,A01,083771,Staff,2,0,30,28
1651076194592,MATH 20E,A02,083772,Staff,10,0,30,20
1651076194592,MATH 20E,B01,083773,Staff,0,0,30,30
1651076194592,MATH 20E,B02,083774,Staff,0,0,30,30
1651076200616,MATH 103A,A01,083777,Staff,0,17,30,30
1651076200616,MATH 103A,A02,083778,Staff,0,16,30,30
1651076200616,MATH 103A,B01,083779,Staff,0,15,30,30
1651076200616,MATH 103A,B02,083780,Staff,0,14,30,30
1651076206642,MATH 105,A01,085443,Staff,0,23,30,30
1651076212672,MATH 109,A01,083213,Anzaldo; Leesa B,0,7,30,30
1651076212672,MATH 109,A02,083214,Anzaldo; Leesa B,0,7,30,30
1651076212672,MATH 109,B01,083215,Anzaldo; Leesa B,0,8,30,30
1651076212672,MATH 109,B02,083216,Anzaldo; Leesa B,0,8,30,30
1651076218698,MATH 142A,A01,083219,Chow; Bennett,0,15,30,30
1651076218698,MATH 142A,A02,083220,Chow; Bennett,0,15,30,30
1651076218698,MATH 142A,B01,083221,Chow; Bennett,0,16,30,30
1651076218698,MATH 142A,B02,083222,Chow; Bennett,0,15,30,30
1651076224724,MATH 193A,A01,083224,Staff,0,8,30,30
1651076224724,MATH 193A,A02,083225,Staff,0,7,30,30
1651076224724,MATH 193A,A03,083781,Staff,0,7,30,30
1651076224724,MATH 193A,A04,083782,Staff,0,7,30,30
1651076230748,MATH 197,001,091859,McAuley; Julian John,9998,0,9999,1
1651076236795,COGS 9,A01,083615,Staff,0,20,60,60
1651076242819,COGS 11,A01,083617,Boyle; Mary E. T.,13,0,40,27
1651076248851,COGS 13,A01,083071,Staff,0,40,40,40
1651076254878,COGS 14A,A01,092681,Staff,0,40,100,100
1651076260902,COGS 14B,A01,083073,Cheng; Tzu-Han,0,14,50,50
1651076266925,COGS 17,A01,092677,Staff,9,0,75,66
1651076272951,COGS 100,A01,083619,Staff,0,30,60,60
1651076278978,COGS 101A,A01,083621,Davis; Joshua Daniel,0,29,60,60
1651076285004,COGS 101B,A01,091572,Staff,0,7,60,60
1651076291026,COGS 101C,A01,083625,Delgado; Tania,13,0,30,17
1651076297056,COGS 107A,A01,083627,Boyle; Mary E. T.,0,17,60,60
1651076303085,COGS 118A,A01,083075,Staff,0,10,60,60
1651076309109,CSE 3,A50,083646,Miranda; Gregory Joseph,15,0,38,23
1651076309109,CSE 3,A51,083647,Miranda; Gregory Joseph,36,0,37,1
1651076315141,CSE 8A,A50,083650,Miranda; Gregory Joseph,0,31,40,40
1651076321167,CSE 11,A01,083080,Cao; Yingjun,1,97,40,39
1651076327191,CSE 12,A01,083652,Staff,0,27,100,100
1651076333219,CSE 15L,A01,083654,Staff,0,3,50,50
1651076333219,CSE 15L,A02,083655,Staff,0,3,50,50
1651076339244,CSE 20,A01,083657,Staff,46,0,80,34
1651076345268,CSE 30,A01,083084,Eldon; John,0,38,80,80
1651076351294,CSE 100,A01,083659,Cao; Yingjun,0,72,50,50
1651076357315,CSE 134B,A01,083661,Powell; Thomas Allan,0,38,65,65
1651076363342,CSE 140,A01,083663,Staff,0,15,75,75
1651076369372,CSE 140L,A01,083088,Eldon; John,3,0,100,97
1651076375394,CSE 175,A01,083665,Kumar; Rakesh,0,0,25,25
1651076381422,CSE 190,A00,092507,Dubnov; Shlomo,9,0,20,11
1651076387447,ECE 45,A01,083139,Staff,0,7,60,60
1651076393473,ECE 65,A50,083695,Staff,0,7,30,30
1651076399499,ECE 109,A01,091882,Touri; Behrouz,33,0,70,37
1651076405525,ECE 180,A00,083140,Abi Samra; Nicholas Camill,17,0,30,13
1651076405525,ECE 180,B00,083141,Abi Samra; Nicholas Camill,0,0,30,30
1651076411546,MATH 10A,A01,083735,Patchell; Gregory David,0,0,30,30
1651076411546,MATH 10A,A02,083736,Patchell; Gregory David,27,0,30,3
1651076411546,MATH 10A,A03,083737,Patchell; Gregory David,22,0,30,8
1651076417574,MATH 10B,A01,083207,Staff,0,7,30,30
1651076417574,MATH 10B,A02,083208,Staff,0,6,30,30
1651076417574,MATH 10B,B01,083739,Staff,8,0,30,22
1651076417574,MATH 10B,B02,083740,Staff,28,0,30,2
1651076423600,MATH 18,A01,083743,Staff,0,0,30,30
1651076423600,MATH 18,A02,083744,Staff,23,0,30,7
1651076423600,MATH 18,A03,083745,Staff,19,0,30,11
1651076423600,MATH 18,A04,083746,Staff,26,0,30,4
1651076423600,MATH 18,B01,083748,Staff,0,16,30,30
1651076423600,MATH 18,B02,083749,Staff,0,14,30,30
1651076423600,MATH 18,B03,083750,Staff,0,14,30,30
1651076423600,MATH 18,B04,083751,Staff,0,13,30,30
1651076429626,MATH 20A,A01,083754,Staff,18,0,40,22
1651076435657,MATH 20B,A01,083756,Staff,0,14,30,30
1651076435657,MATH 20B,A02,083757,Staff,0,11,30,30
1651076441684,MATH 20C,A01,083760,Staff,0,16,30,30
1651076441684,MATH 20C,A02,083761,Staff,0,15,30,30
1651076441684,MATH 20C,B01,083762,Staff,7,0,30,23
1651076441684,MATH 20C,B02,083763,Staff,28,0,30,2
1651076447709,MATH 20D,A01,083765,Staff,3,1,30,27
1651076447709,MATH 20D,A02,083766,Staff,1,0,30,29
1651076447709,MATH 20D,A03,083767,Staff,22,0,30,8
1651076453736,MATH 20E,A01,083771,Staff,2,0,30,28
1651076453736,MATH 20E,A02,083772,Staff,10,0,30,20
1651076453736,MATH 20E,B01,083773,Staff,0,0,30,30
1651076453736,MATH 20E,B02,083774,Staff,0,0,30,30
1651076459764,MATH 103A,A01,083777,Staff,0,17,30,30
1651076459764,MATH 103A,A02,083778,Staff,0,16,30,30
1651076459764,MATH 103A,B01,083779,Staff,0,15,30,30
1651076459764,MATH 103A,B02,083780,Staff,0,14,30,30
1651076465791,MATH 105,A01,085443,Staff,0,23,30,30
1651076471820,MATH 109,A01,083213,Anzaldo; Leesa B,0,7,30,30
1651076471820,MATH 109,A02,083214,Anzaldo; Leesa B,0,7,30,30
1651076471820,MATH 109,B01,083215,Anzaldo; Leesa B,0,8,30,30
1651076471820,MATH 109,B02,083216,Anzaldo; Leesa B,0,8,30,30
1651076477846,MATH 142A,A01,083219,Chow; Bennett,0,15,30,30
1651076477846,MATH 142A,A02,083220,Chow; Bennett,0,15,30,30
1651076477846,MATH 142A,B01,083221,Chow; Bennett,0,16,30,30
1651076477846,MATH 142A,B02,083222,Chow; Bennett,0,15,30,30
1651076483871,MATH 193A,A01,083224,Staff,0,8,30,30
1651076483871,MATH 193A,A02,083225,Staff,0,7,30,30
1651076483871,MATH 193A,A03,083781,Staff,0,7,30,30
1651076483871,MATH 193A,A04,083782,Staff,0,7,30,30
1651076489906,MATH 197,001,091859,McAuley; Julian John,9998,0,9999,1
1651076495959,COGS 9,A01,083615,Staff,0,20,60,60
1651076501986,COGS 11,A01,083617,Boyle; Mary E. T.,13,0,40,27
1651076508014,COGS 13,A01,083071,Staff,0,40,40,40
1651076514040,COGS 14A,A01,092681,Staff,0,40,100,100
1651076520077,COGS 14B,A01,083073,Cheng; Tzu-Han,0,14,50,50
1651076526100,COGS 17,A01,092677,Staff,9,0,75,66
1651076532125,COGS 100,A01,083619,Staff,0,30,60,60
1651076538147,COGS 101A,A01,083621,Davis; Joshua Daniel,0,29,60,60
1651076544170,COGS 101B,A01,091572,Staff,0,7,60,60
1651076550197,COGS 101C,A01,083625,Delgado; Tania,13,0,30,17
1651076556230,COGS 107A,A01,083627,Boyle; Mary E. T.,0,17,60,60
1651076562255,COGS 118A,A01,083075,Staff,0,10,60,60
1651076568280,CSE 3,A50,083646,Miranda; Gregory Joseph,15,0,38,23
1651076568280,CSE 3,A51,083647,Miranda; Gregory Joseph,36,0,37,1
1651076574314,CSE 8A,A50,083650,Miranda; Gregory Joseph,0,31,40,40
1651076580352,CSE 11,A01,083080,Cao; Yingjun,1,97,40,39
1651076586376,CSE 12,A01,083652,Staff,0,27,100,100
1651076592407,CSE 15L,A01,083654,Staff,0,3,50,50
1651076592407,CSE 15L,A02,083655,Staff,0,3,50,50
1651076598433,CSE 20,A01,083657,Staff,46,0,80,34
1651076604457,CSE 30,A01,083084,Eldon; John,0,38,80,80
1651076610489,CSE 100,A01,083659,Cao; Yingjun,0,72,50,50
1651076616512,CSE 134B,A01,083661,Powell; Thomas Allan,0,38,65,65
1651076622537,CSE 140,A01,083663,Staff,0,15,75,75
1651076628560,CSE 140L,A01,083088,Eldon; John,3,0,100,97
1651076634585,CSE 175,A01,083665,Kumar; Rakesh,0,0,25,25
1651076640616,CSE 190,A00,092507,Dubnov; Shlomo,9,0,20,11
1651076646639,ECE 45,A01,083139,Staff,0,7,60,60
1651076652665,ECE 65,A50,083695,Staff,0,7,30,30
1651076658689,ECE 109,A01,091882,Touri; Behrouz,33,0,70,37
1651076664717,ECE 180,A00,083140,Abi Samra; Nicholas Camill,17,0,30,13
1651076664717,ECE 180,B00,083141,Abi Samra; Nicholas Camill,0,0,30,30
1651076670741,MATH 10A,A01,083735,Patchell; Gregory David,0,0,30,30
1651076670741,MATH 10A,A02,083736,Patchell; Gregory David,27,0,30,3
1651076670741,MATH 10A,A03,083737,Patchell; Gregory David,22,0,30,8
1651076676764,MATH 10B,A01,083207,Staff,0,7,30,30
1651076676764,MATH 10B,A02,083208,Staff,0,6,30,30
1651076676764,MATH 10B,B01,083739,Staff,8,0,30,22
1651076676764,MATH 10B,B02,083740,Staff,28,0,30,2
1651076682789,MATH 18,A01,083743,Staff,0,0,30,30
1651076682789,MATH 18,A02,083744,Staff,23,0,30,7
1651076682789,MATH 18,A03,083745,Staff,19,0,30,11
1651076682789,MATH 18,A04,083746,Staff,26,0,30,4
1651076682789,MATH 18,B01,083748,Staff,0,16,30,30
1651076682789,MATH 18,B02,083749,Staff,0,14,30,30
1651076682789,MATH 18,B03,083750,Staff,0,14,30,30
1651076682789,MATH 18,B04,083751,Staff,0,13,30,30
1651076688813,MATH 20A,A01,083754,Staff,18,0,40,22
1651076694842,MATH 20B,A01,083756,Staff,0,14,30,30
1651076694842,MATH 20B,A02,083757,Staff,0,11,30,30
1651076700954,MATH 20C,A01,083760,Staff,0,16,30,30
1651076700954,MATH 20C,A02,083761,Staff,0,15,30,30
1651076700954,MATH 20C,B01,083762,Staff,7,0,30,23
1651076700954,MATH 20C,B02,083763,Staff,28,0,30,2
1651076706980,MATH 20D,A01,083765,Staff,3,1,30,27
1651076706980,MATH 20D,A02,083766,Staff,1,0,30,29
1651076706980,MATH 20D,A03,083767,Staff,22,0,30,8
1651076713008,MATH 20E,A01,083771,Staff,2,0,30,28
1651076713008,MATH 20E,A02,083772,Staff,10,0,30,20
1651076713008,MATH 20E,B01,083773,Staff,0,0,30,30
1651076713008,MATH 20E,B02,083774,Staff,0,0,30,30
1651076719035,MATH 103A,A01,083777,Staff,0,17,30,30
1651076719035,MATH 103A,A02,083778,Staff,0,16,30,30
1651076719035,MATH 103A,B01,083779,Staff,0,15,30,30
1651076719035,MATH 103A,B02,083780,Staff,0,14,30,30
1651076725059,MATH 105,A01,085443,Staff,0,23,30,30
1651076731083,MATH 109,A01,083213,Anzaldo; Leesa B,0,7,30,30
1651076731083,MATH 109,A02,083214,Anzaldo; Leesa B,0,7,30,30
1651076731083,MATH 109,B01,083215,Anzaldo; Leesa B,0,8,30,30
1651076731083,MATH 109,B02,083216,Anzaldo; Leesa B,0,8,30,30
1651076737106,MATH 142A,A01,083219,Chow; Bennett,0,15,30,30
1651076737106,MATH 142A,A02,083220,Chow; Bennett,0,15,30,30
1651076737106,MATH 142A,B01,083221,Chow; Bennett,0,16,30,30
1651076737106,MATH 142A,B02,083222,Chow; Bennett,0,15,30,30
1651076743130,MATH 193A,A01,083224,Staff,0,8,30,30
1651076743130,MATH 193A,A02,083225,Staff,0,7,30,30
1651076743130,MATH 193A,A03,083781,Staff,0,7,30,30
1651076743130,MATH 193A,A04,083782,Staff,0,7,30,30
1651076749162,MATH 197,001,091859,McAuley; Julian John,9998,0,9999,1
1651076755228,COGS 9,A01,083615,Staff,0,20,60,60
1651076761262,COGS 11,A01,083617,Boyle; Mary E. T.,13,0,40,27
1651076767284,COGS 13,A01,083071,Staff,0,40,40,40
1651076773309,COGS 14A,A01,092681,Staff,0,40,100,100
1651076779339,COGS 14B,A01,083073,Cheng; Tzu-Han,0,14,50,50
1651076785362,COGS 17,A01,092677,Staff,9,0,75,66
1651076791391,COGS 100,A01,083619,Staff,0,30,60,60
1651076797417,COGS 101A,A01,083621,Davis; Joshua Daniel,0,29,60,60
1651076803447,COGS 101B,A01,091572,Staff,0,7,60,60
1651076809470,COGS 101C,A01,083625,Delgado; Tania,13,0,30,17
1651076815500,COGS 107A,A01,083627,Boyle; Mary E. T.,0,17,60,60
1651076821525,COGS 118A,A01,083075,Staff,0,10,60,60
1651076827547,CSE 3,A50,083646,Miranda; Gregory Joseph,15,0,38,23
1651076827547,CSE 3,A51,083647,Miranda; Gregory Joseph,36,0,37,1
1651076833579,CSE 8A,A50,083650,Miranda; Gregory Joseph,0,31,40,40
1651076839613,CSE 11,A01,083080,Cao; Yingjun,1,97,40,39
1651076845636,CSE 12,A01,083652,Staff,0,27,100,100
1651076851663,CSE 15L,A01,083654,Staff,0,3,50,50
1651076851663,CSE 15L,A02,083655,Staff,0,3,50,50
1651076857685,CSE 20,A01,083657,Staff,46,0,80,34
1651076863707,CSE 30,A01,083084,Eldon; John,0,38,80,80
1651076869731,CSE 100,A01,083659,Cao; Yingjun,0,72,50,50
1651076875759,CSE 134B,A01,083661,Powell; Thomas Allan,0,38,65,65
1651076881798,CSE 140,A01,083663,Staff,0,15,75,75
1651076887824,CSE 140L,A01,083088,Eldon; John,3,0,100,97
1651076893850,CSE 175,A01,083665,Kumar; Rakesh,0,0,25,25
1651076899877,CSE 190,A00,092507,Dubnov; Shlomo,9,0,20,11
1651076905904,ECE 45,A01,083139,Staff,0,7,60,60
1651076911927,ECE 65,A50,083695,Staff,0,7,30,30
1651076917963,ECE 109,A01,091882,Touri; Behrouz,33,0,70,37
1651076923989,ECE 180,A00,083140,Abi Samra; Nicholas Camill,17,0,30,13
1651076923989,ECE 180,B00,083141,Abi Samra; Nicholas Camill,0,0,30,30
1651076930018,MATH 10A,A01,083735,Patchell; Gregory David,0,0,30,30
1651076930018,MATH 10A,A02,083736,Patchell; Gregory David,27,0,30,3
1651076930018,MATH 10A,A03,083737,Patchell; Gregory David,22,0,30,8
1651076936041,MATH 10B,A01,083207,Staff,0,7,30,30
1651076936041,MATH 10B,A02,083208,Staff,0,6,30,30
1651076936041,MATH 10B,B01,083739,Staff,8,0,30,22
1651076936041,MATH 10B,B02,083740,Staff,28,0,30,2
1651076942073,MATH 18,A01,083743,Staff,0,0,30,30
1651076942073,MATH 18,A02,083744,Staff,23,0,30,7
1651076942073,MATH 18,A03,083745,Staff,19,0,30,11
1651076942073,MATH 18,A04,083746,Staff,26,0,30,4
1651076942073,MATH 18,B01,083748,Staff,0,16,30,30
1651076942073,MATH 18,B02,083749,Staff,0,14,30,30
1651076942073,MATH 18,B03,083750,Staff,0,14,30,30
1651076942073,MATH 18,B04,083751,Staff,0,13,30,30
1651076948102,MATH 20A,A01,083754,Staff,18,0,40,22
1651076954133,MATH 20B,A01,083756,Staff,0,14,30,30
1651076954133,MATH 20B,A02,083757,Staff,0,11,30,30
1651076968414,MATH 20C,A01,083760,Staff,0,16,30,30
1651076968414,MATH 20C,A02,083761,Staff,0,15,30,30
1651076968414,MATH 20C,B01,083762,Staff,7,0,30,23
1651076968414,MATH 20C,B02,083763,Staff,28,0,30,2
1651076974440,MATH 20D,A01,083765,Staff,3,1,30,27
1651076974440,MATH 20D,A02,083766,Staff,1,0,30,29
1651076974440,MATH 20D,A03,083767,Staff,22,0,30,8
1651076980464,MATH 20E,A01,083771,Staff,2,0,30,28
1651076980464,MATH 20E,A02,083772,Staff,10,0,30,20
1651076980464,MATH 20E,B01,083773,Staff,0,0,30,30
1651076980464,MATH 20E,B02,083774,Staff,0,0,30,30
1651076986488,MATH 103A,A01,083777,Staff,0,17,30,30
1651076986488,MATH 103A,A02,083778,Staff,0,16,30,30
1651076986488,MATH 103A,B01,083779,Staff,0,15,30,30
1651076986488,MATH 103A,B02,083780,Staff,0,14,30,30
1651076992510,MATH 105,A01,085443,Staff,0,23,30,30
1651076998533,MATH 109,A01,083213,Anzaldo; Leesa B,0,7,30,30
1651076998533,MATH 109,A02,083214,Anzaldo; Leesa B,0,7,30,30
1651076998533,MATH 109,B01,083215,Anzaldo; Leesa B,0,8,30,30
1651076998533,MATH 109,B02,083216,Anzaldo; Leesa B,0,8,30,30
1651077004557,MATH 142A,A01,083219,Chow; Bennett,0,15,30,30
1651077004557,MATH 142A,A02,083220,Chow; Bennett,0,15,30,30
1651077004557,MATH 142A,B01,083221,Chow; Bennett,0,16,30,30
1651077004557,MATH 142A,B02,083222,Chow; Bennett,0,15,30,30
1651077010584,MATH 193A,A01,083224,Staff,0,8,30,30
1651077010584,MATH 193A,A02,083225,Staff,0,7,30,30
1651077010584,MATH 193A,A03,083781,Staff,0,7,30,30
1651077010584,MATH 193A,A04,083782,Staff,0,7,30,30
1651077016609,MATH 197,001,091859,McAuley; Julian John,9998,0,9999,1
1651077022679,COGS 9,A01,083615,Staff,0,20,60,60
1651077028705,COGS 11,A01,083617,Boyle; Mary E. T.,13,0,40,27
1651077034728,COGS 13,A01,083071,Staff,0,40,40,40
1651077040758,COGS 14A,A01,092681,Staff,0,40,100,100
1651077046781,COGS 14B,A01,083073,Cheng; Tzu-Han,0,14,50,50
1651077052808,COGS 17,A01,092677,Staff,9,0,75,66
1651077058842,COGS 100,A01,083619,Staff,0,30,60,60
1651077064865,COGS 101A,A01,083621,Davis; Joshua Daniel,0,29,60,60
1651077070888,COGS 101B,A01,091572,Staff,0,7,60,60
1651077076917,COGS 101C,A01,083625,Delgado; Tania,13,0,30,17
1651077082940,COGS 107A,A01,083627,Boyle; Mary E. T.,0,17,60,60
1651077088966,COGS 118A,A01,083075,Staff,0,10,60,60
1651077094994,CSE 3,A50,083646,Miranda; Gregory Joseph,15,0,38,23
1651077094994,CSE 3,A51,083647,Miranda; Gregory Joseph,36,0,37,1
1651077101020,CSE 8A,A50,083650,Miranda; Gregory Joseph,0,31,40,40
1651077107055,CSE 11,A01,083080,Cao; Yingjun,1,97,40,39
1651077113085,CSE 12,A01,083652,Staff,0,27,100,100
1651077119109,CSE 15L,A01,083654,Staff,0,3,50,50
1651077119109,CSE 15L,A02,083655,Staff,0,3,50,50
1651077125135,CSE 20,A01,083657,Staff,46,0,80,34
1651077131162,CSE 30,A01,083084,Eldon; John,0,38,80,80
1651077137196,CSE 100,A01,083659,Cao; Yingjun,0,72,50,50
1651077143218,CSE 134B,A01,083661,Powell; Thomas Allan,0,38,65,65
1651077149243,CSE 140,A01,083663,Staff,0,15,75,75
1651077155267,CSE 140L,A01,083088,Eldon; John,3,0,100,97
1651077161290,CSE 175,A01,083665,Kumar; Rakesh,0,0,25,25
1651077167317,CSE 190,A00,092507,Dubnov; Shlomo,9,0,20,11
1651077173350,ECE 45,A01,083139,Staff,0,7,60,60
1651077179373,ECE 65,A50,083695,Staff,0,7,30,30
1651077185399,ECE 109,A01,091882,Touri; Behrouz,33,0,70,37
1651077191426,ECE 180,A00,083140,Abi Samra; Nicholas Camill,17,0,30,13
1651077191426,ECE 180,B00,083141,Abi Samra; Nicholas Camill,0,0,30,30
1651077197462,MATH 10A,A01,083735,Patchell; Gregory David,0,0,30,30
1651077197462,MATH 10A,A02,083736,Patchell; Gregory David,27,0,30,3
1651077197462,MATH 10A,A03,083737,Patchell; Gregory David,22,0,30,8
1651077203485,MATH 10B,A01,083207,Staff,0,7,30,30
1651077203485,MATH 10B,A02,083208,Staff,0,6,30,30
1651077203485,MATH 10B,B01,083739,Staff,8,0,30,22
1651077203485,MATH 10B,B02,083740,Staff,28,0,30,2
1651077209519,MATH 18,A01,083743,Staff,0,0,30,30
1651077209519,MATH 18,A02,083744,Staff,23,0,30,7
1651077209519,MATH 18,A03,083745,Staff,19,0,30,11
1651077209519,MATH 18,A04,083746,Staff,26,0,30,4
1651077209519,MATH 18,B01,083748,Staff,0,16,30,30
1651077209519,MATH 18,B02,083749,Staff,0,14,30,30
1651077209519,MATH 18,B03,083750,Staff,0,14,30,30
1651077209519,MATH 18,B04,083751,Staff,0,13,30,30
1651077215548,MATH 20A,A01,083754,Staff,18,0,40,22
1651077221578,MATH 20B,A01,083756,Staff,0,14,30,30
1651077221578,MATH 20B,A02,083757,Staff,0,11,30,30
1651077227613,MATH 20C,A01,083760,Staff,0,16,30,30
1651077227613,MATH 20C,A02,083761,Staff,0,15,30,30
1651077227613,MATH 20C,B01,083762,Staff,7,0,30,23
1651077227613,MATH 20C,B02,083763,Staff,28,0,30,2
1651077233644,MATH 20D,A01,083765,Staff,3,1,30,27
1651077233644,MATH 20D,A02,083766,Staff,1,0,30,29
1651077233644,MATH 20D,A03,083767,Staff,22,0,30,8
1651077239671,MATH 20E,A01,083771,Staff,2,0,30,28
1651077239671,MATH 20E,A02,083772,Staff,10,0,30,20
1651077239671,MATH 20E,B01,083773,Staff,0,0,30,30
1651077239671,MATH 20E,B02,083774,Staff,0,0,30,30
1651077245703,MATH 103A,A01,083777,Staff,0,17,30,30
1651077245703,MATH 103A,A02,083778,Staff,0,16,30,30
1651077245703,MATH 103A,B01,083779,Staff,0,15,30,30
1651077245703,MATH 103A,B02,083780,Staff,0,14,30,30
1651077251729,MATH 105,A01,085443,Staff,0,23,30,30
1651077257753,MATH 109,A01,083213,Anzaldo; Leesa B,0,7,30,30
1651077257753,MATH 109,A02,083214,Anzaldo; Leesa B,0,7,30,30
1651077257753,MATH 109,B01,083215,Anzaldo; Leesa B,0,8,30,30
1651077257753,MATH 109,B02,083216,Anzaldo; Leesa B,0,8,30,30
1651077263779,MATH 142A,A01,083219,Chow; Bennett,0,15,30,30
1651077263779,MATH 142A,A02,083220,Chow; Bennett,0,15,30,30
1651077263779,MATH 142A,B01,083221,Chow; Bennett,0,16,30,30
1651077263779,MATH 142A,B02,083222,Chow; Bennett,0,15,30,30
1651077269805,MATH 193A,A01,083224,Staff,0,8,30,30
1651077269805,MATH 193A,A02,083225,Staff,0,7,30,30
1651077269805,MATH 193A,A03,083781,Staff,0,7,30,30
1651077269805,MATH 193A,A04,083782,Staff,0,7,30,30
1651077275829,MATH 197,001,091859,McAuley; Julian John,9998,0,9999,1
1651077281887,COGS 9,A01,083615,Staff,0,20,60,60
1651077287910,COGS 11,A01,083617,Boyle; Mary E. T.,13,0,40,27
1651077293942,COGS 13,A01,083071,Staff,0,39,40,40
1651077300040,COGS 14A,A01,092681,Staff,0,40,100,100
1651077306068,COGS 14B,A01,083073,Cheng; Tzu-Han,0,14,50,50
1651077312092,COGS 17,A01,092677,Staff,9,0,75,66
1651077318145,COGS 100,A01,083619,Staff,0,30,60,60
1651077324170,COGS 101A,A01,083621,Davis; Joshua Daniel,0,29,60,60
1651077330195,COGS 101B,A01,091572,Staff,0,8,60,60
1651077336219,COGS 101C,A01,083625,Delgado; Tania,13,0,30,17
1651077342243,COGS 107A,A01,083627,Boyle; Mary E. T.,0,17,60,60
1651077348266,COGS 118A,A01,083075,Staff,0,10,60,60
1651077354290,CSE 3,A50,083646,Miranda; Gregory Joseph,15,0,38,23
1651077354290,CSE 3,A51,083647,Miranda; Gregory Joseph,36,0,37,1
1651077360324,CSE 8A,A50,083650,Miranda; Gregory Joseph,0,31,40,40
1651077366347,CSE 11,A01,083080,Cao; Yingjun,1,97,40,39
1651077372373,CSE 12,A01,083652,Staff,0,27,100,100
1651077378407,CSE 15L,A01,083654,Staff,0,3,50,50
1651077378407,CSE 15L,A02,083655,Staff,0,3,50,50
1651077384433,CSE 20,A01,083657,Staff,46,0,80,34
1651077390457,CSE 30,A01,083084,Eldon; John,0,38,80,80
1651077396479,CSE 100,A01,083659,Cao; Yingjun,0,72,50,50
1651077402505,CSE 134B,A01,083661,Powell; Thomas Allan,0,38,65,65
1651077408530,CSE 140,A01,083663,Staff,0,15,75,75
1651077414552,CSE 140L,A01,083088,Eldon; John,3,0,100,97
1651077420581,CSE 175,A01,083665,Kumar; Rakesh,0,0,25,25
1651077426616,CSE 190,A00,092507,Dubnov; Shlomo,9,0,20,11
1651077432641,ECE 45,A01,083139,Staff,0,7,60,60
1651077438673,ECE 65,A50,083695,Staff,0,7,30,30
1651077444695,ECE 109,A01,091882,Touri; Behrouz,33,0,70,37
1651077450722,ECE 180,A00,083140,Abi Samra; Nicholas Camill,17,0,30,13
1651077450722,ECE 180,B00,083141,Abi Samra; Nicholas Camill,0,0,30,30
1651077456746,MATH 10A,A01,083735,Patchell; Gregory David,0,0,30,30
1651077456746,MATH 10A,A02,083736,Patchell; Gregory David,27,0,30,3
1651077456746,MATH 10A,A03,083737,Patchell; Gregory David,22,0,30,8
1651077462769,MATH 10B,A01,083207,Staff,0,7,30,30
1651077462769,MATH 10B,A02,083208,Staff,0,6,30,30
1651077462769,MATH 10B,B01,083739,Staff,8,0,30,22
1651077462769,MATH 10B,B02,083740,Staff,28,0,30,2
1651077468805,MATH 18,A01,083743,Staff,0,0,30,30
1651077468805,MATH 18,A02,083744,Staff,23,0,30,7
1651077468805,MATH 18,A03,083745,Staff,19,0,30,11
1651077468805,MATH 18,A04,083746,Staff,26,0,30,4
1651077468805,MATH 18,B01,083748,Staff,0,16,30,30
1651077468805,MATH 18,B02,083749,Staff,0,14,30,30
1651077468805,MATH 18,B03,083750,Staff,0,14,30,30
1651077468805,MATH 18,B04,083751,Staff,0,13,30,30
1651077474841,MATH 20A,A01,083754,Staff,18,0,40,22
1651077480864,MATH 20B,A01,083756,Staff,0,14,30,30
1651077480864,MATH 20B,A02,083757,Staff,0,11,30,30
1651077486887,MATH 20C,A01,083760,Staff,0,16,30,30
1651077486887,MATH 20C,A02,083761,Staff,0,15,30,30
1651077486887,MATH 20C,B01,083762,Staff,7,0,30,23
1651077486887,MATH 20C,B02,083763,Staff,28,0,30,2
1651077492912,MATH 20D,A01,083765,Staff,3,1,30,27
1651077492912,MATH 20D,A02,083766,Staff,1,0,30,29
1651077492912,MATH 20D,A03,083767,Staff,22,0,30,8
1651077498934,MATH 20E,A01,083771,Staff,2,0,30,28
1651077498934,MATH 20E,A02,083772,Staff,10,0,30,20
1651077498934,MATH 20E,B01,083773,Staff,0,0,30,30
1651077498934,MATH 20E,B02,083774,Staff,0,0,30,30
1651077504957,MATH 103A,A01,083777,Staff,0,17,30,30
1651077504957,MATH 103A,A02,083778,Staff,0,16,30,30
1651077504957,MATH 103A,B01,083779,Staff,0,15,30,30
1651077504957,MATH 103A,B02,083780,Staff,0,14,30,30
1651077510984,MATH 105,A01,085443,Staff,0,23,30,30
1651077517008,MATH 109,A01,083213,Anzaldo; Leesa B,0,7,30,30
1651077517008,MATH 109,A02,083214,Anzaldo; Leesa B,0,7,30,30
1651077517008,MATH 109,B01,083215,Anzaldo; Leesa B,0,8,30,30
1651077517008,MATH 109,B02,083216,Anzaldo; Leesa B,0,8,30,30
1651077523032,MATH 142A,A01,083219,Chow; Bennett,0,15,30,30
1651077523032,MATH 142A,A02,083220,Chow; Bennett,0,15,30,30
1651077523032,MATH 142A,B01,083221,Chow; Bennett,0,16,30,30
1651077523032,MATH 142A,B02,083222,Chow; Bennett,0,15,30,30
1651077529056,MATH 193A,A01,083224,Staff,0,8,30,30
1651077529056,MATH 193A,A02,083225,Staff,0,7,30,30
1651077529056,MATH 193A,A03,083781,Staff,0,7,30,30
1651077529056,MATH 193A,A04,083782,Staff,0,7,30,30
1651077535078,MATH 197,001,091859,McAuley; Julian John,9998,0,9999,1
1651077541133,COGS 9,A01,083615,Staff,0,20,60,60
1651077547162,COGS 11,A01,083617,Boyle; Mary E. T.,13,0,40,27
1651077553186,COGS 13,A01,083071,Staff,0,39,40,40
1651077559212,COGS 14A,A01,092681,Staff,0,39,100,100
1651077565236,COGS 14B,A01,083073,Cheng; Tzu-Han,0,14,50,50
1651077571270,COGS 17,A01,092677,Staff,9,0,75,66
1651077577295,COGS 100,A01,083619,Staff,0,30,60,60
1651077583322,COGS 101A,A01,083621,Davis; Joshua Daniel,0,29,60,60
1651077589348,COGS 101B,A01,091572,Staff,0,8,60,60
1651077595374,COGS 101C,A01,083625,Delgado; Tania,13,0,30,17
1651077601406,COGS 107A,A01,083627,Boyle; Mary E. T.,0,17,60,60
1651077607432,COGS 118A,A01,083075,Staff,0,10,60,60
1651077613457,CSE 3,A50,083646,Miranda; Gregory Joseph,15,0,38,23
1651077613457,CSE 3,A51,083647,Miranda; Gregory Joseph,36,0,37,1
1651077619484,CSE 8A,A50,083650,Miranda; Gregory Joseph,0,31,40,40
1651077625510,CSE 11,A01,083080,Cao; Yingjun,1,97,40,39
1651077631536,CSE 12,A01,083652,Staff,0,27,100,100
1651077637560,CSE 15L,A01,083654,Staff,0,3,50,50
1651077637560,CSE 15L,A02,083655,Staff,0,3,50,50
1651077643587,CSE 20,A01,083657,Staff,46,0,80,34
1651077649617,CSE 30,A01,083084,Eldon; John,0,38,80,80
1651077655643,CSE 100,A01,083659,Cao; Yingjun,0,72,50,50
1651077661676,CSE 134B,A01,083661,Powell; Thomas Allan,0,38,65,65
1651077667705,CSE 140,A01,083663,Staff,0,15,75,75
1651077673729,CSE 140L,A01,083088,Eldon; John,3,0,100,97
1651077679755,CSE 175,A01,083665,Kumar; Rakesh,0,0,25,25
1651077685779,CSE 190,A00,092507,Dubnov; Shlomo,9,0,20,11
1651077691802,ECE 45,A01,083139,Staff,0,7,60,60
1651077697827,ECE 65,A50,083695,Staff,0,7,30,30
1651077703855,ECE 109,A01,091882,Touri; Behrouz,33,0,70,37
1651077709878,ECE 180,A00,083140,Abi Samra; Nicholas Camill,17,0,30,13
1651077709878,ECE 180,B00,083141,Abi Samra; Nicholas Camill,0,0,30,30
1651077715902,MATH 10A,A01,083735,Patchell; Gregory David,0,0,30,30
1651077715902,MATH 10A,A02,083736,Patchell; Gregory David,27,0,30,3
1651077715902,MATH 10A,A03,083737,Patchell; Gregory David,22,0,30,8
1651077721925,MATH 10B,A01,083207,Staff,0,7,30,30
1651077721925,MATH 10B,A02,083208,Staff,0,6,30,30
1651077721925,MATH 10B,B01,083739,Staff,8,0,30,22
1651077721925,MATH 10B,B02,083740,Staff,28,0,30,2
1651077727952,MATH 18,A01,083743,Staff,0,0,30,30
1651077727952,MATH 18,A02,083744,Staff,23,0,30,7
1651077727952,MATH 18,A03,083745,Staff,19,0,30,11
1651077727952,MATH 18,A04,083746,Staff,26,0,30,4
1651077727952,MATH 18,B01,083748,Staff,0,16,30,30
1651077727952,MATH 18,B02,083749,Staff,0,14,30,30
1651077727952,MATH 18,B03,083750,Staff,0,14,30,30
1651077727952,MATH 18,B04,083751,Staff,0,13,30,30
1651077733979,MATH 20A,A01,083754,Staff,18,0,40,22
1651077740003,MATH 20B,A01,083756,Staff,0,14,30,30
1651077740003,MATH 20B,A02,083757,Staff,0,11,30,30
1651077746031,MATH 20C,A01,083760,Staff,0,16,30,30
1651077746031,MATH 20C,A02,083761,Staff,0,15,30,30
1651077746031,MATH 20C,B01,083762,Staff,7,0,30,23
1651077746031,MATH 20C,B02,083763,Staff,28,0,30,2
1651077752057,MATH 20D,A01,083765,Staff,3,1,30,27
1651077752057,MATH 20D,A02,083766,Staff,1,0,30,29
1651077752057,MATH 20D,A03,083767,Staff,22,0,30,8
1651077758087,MATH 20E,A01,083771,Staff,2,0,30,28
1651077758087,MATH 20E,A02,083772,Staff,10,0,30,20
1651077758087,MATH 20E,B01,083773,Staff,0,0,30,30
1651077758087,MATH 20E,B02,083774,Staff,0,0,30,30
1651077764118,MATH 103A,A01,083777,Staff,0,17,30,30
1651077764118,MATH 103A,A02,083778,Staff,0,16,30,30
1651077764118,MATH 103A,B01,083779,Staff,0,15,30,30
1651077764118,MATH 103A,B02,083780,Staff,0,14,30,30
1651077770143,MATH 105,A01,085443,Staff,0,23,30,30
1651077776183,MATH 109,A01,083213,Anzaldo; Leesa B,0,7,30,30
1651077776183,MATH 109,A02,083214,Anzaldo; Leesa B,0,7,30,30
1651077776183,MATH 109,B01,083215,Anzaldo; Leesa B,0,8,30,30
1651077776183,MATH 109,B02,083216,Anzaldo; Leesa B,0,8,30,30
1651077782225,MATH 142A,A01,083219,Chow; Bennett,0,15,30,30
1651077782225,MATH 142A,A02,083220,Chow; Bennett,0,15,30,30
1651077782225,MATH 142A,B01,083221,Chow; Bennett,0,16,30,30
1651077782225,MATH 142A,B02,083222,Chow; Bennett,0,15,30,30
1651077788259,MATH 193A,A01,083224,Staff,0,8,30,30
1651077788259,MATH 193A,A02,083225,Staff,0,7,30,30
1651077788259,MATH 193A,A03,083781,Staff,0,7,30,30
1651077788259,MATH 193A,A04,083782,Staff,0,7,30,30
1651077794281,MATH 197,001,091859,McAuley; Julian John,9998,0,9999,1
1651077800339,COGS 9,A01,083615,Staff,0,20,60,60
1651077806379,COGS 11,A01,083617,Boyle; Mary E. T.,13,0,40,27
1651077812401,COGS 13,A01,083071,Staff,0,39,40,40
1651077818423,COGS 14A,A01,092681,Staff,0,39,100,100
1651077824446,COGS 14B,A01,083073,Cheng; Tzu-Han,0,14,50,50
1651077830473,COGS 17,A01,092677,Staff,9,0,75,66
1651077836495,COGS 100,A01,083619,Staff,0,30,60,60
1651077842527,COGS 101A,A01,083621,Davis; Joshua Daniel,0,29,60,60
1651077848549,COGS 101B,A01,091572,Staff,0,8,60,60
1651077854590,COGS 101C,A01,083625,Delgado; Tania,13,0,30,17
1651077860613,COGS 107A,A01,083627,Boyle; Mary E. T.,0,17,60,60
1651077866634,COGS 118A,A01,083075,Staff,0,10,60,60
1651077872663,CSE 3,A50,083646,Miranda; Gregory Joseph,15,0,38,23
1651077872663,CSE 3,A51,083647,Miranda; Gregory Joseph,36,0,37,1
1651077878687,CSE 8A,A50,083650,Miranda; Gregory Joseph,0,31,40,40
1651077884711,CSE 11,A01,083080,Cao; Yingjun,1,97,40,39
1651077890755,CSE 12,A01,083652,Staff,0,27,100,100
1651077896870,CSE 15L,A01,083654,Staff,0,3,50,50
1651077896870,CSE 15L,A02,083655,Staff,0,3,50,50
1651077902901,CSE 20,A01,083657,Staff,46,0,80,34
1651077908926,CSE 30,A01,083084,Eldon; John,0,38,80,80
1651077914951,CSE 100,A01,083659,Cao; Yingjun,0,72,50,50
1651077920974,CSE 134B,A01,083661,Powell; Thomas Allan,0,38,65,65
1651077926999,CSE 140,A01,083663,Staff,0,15,75,75
1651077933040,CSE 140L,A01,083088,Eldon; John,3,0,100,97
1651077939075,CSE 175,A01,083665,Kumar; Rakesh,0,0,25,25
1651077945101,CSE 190,A00,092507,Dubnov; Shlomo,9,0,20,11
1651077951123,ECE 45,A01,083139,Staff,0,7,60,60
1651077957157,ECE 65,A50,083695,Staff,0,7,30,30
1651077963181,ECE 109,A01,091882,Touri; Behrouz,33,0,70,37
1651077969205,ECE 180,A00,083140,Abi Samra; Nicholas Camill,17,0,30,13
1651077969205,ECE 180,B00,083141,Abi Samra; Nicholas Camill,0,0,30,30
1651077975229,MATH 10A,A01,083735,Patchell; Gregory David,0,0,30,30
1651077975229,MATH 10A,A02,083736,Patchell; Gregory David,27,0,30,3
1651077975229,MATH 10A,A03,083737,Patchell; Gregory David,22,0,30,8
1651077981258,MATH 10B,A01,083207,Staff,0,7,30,30
1651077981258,MATH 10B,A02,083208,Staff,0,6,30,30
1651077981258,MATH 10B,B01,083739,Staff,8,0,30,22
1651077981258,MATH 10B,B02,083740,Staff,28,0,30,2
1651077987290,MATH 18,A01,083743,Staff,0,0,30,30
1651077987290,MATH 18,A02,083744,Staff,23,0,30,7
1651077987290,MATH 18,A03,083745,Staff,19,0,30,11
1651077987290,MATH 18,A04,083746,Staff,26,0,30,4
1651077987290,MATH 18,B01,083748,Staff,0,16,30,30
1651077987290,MATH 18,B02,083749,Staff,0,14,30,30
1651077987290,MATH 18,B03,083750,Staff,0,14,30,30
1651077987290,MATH 18,B04,083751,Staff,0,13,30,30
1651077993313,MATH 20A,A01,083754,Staff,18,0,40,22
1651077999339,MATH 20B,A01,083756,Staff,0,14,30,30
1651077999339,MATH 20B,A02,083757,Staff,0,11,30,30
1651078005369,MATH 20C,A01,083760,Staff,0,16,30,30
1651078005369,MATH 20C,A02,083761,Staff,0,15,30,30
1651078005369,MATH 20C,B01,083762,Staff,7,0,30,23
1651078005369,MATH 20C,B02,083763,Staff,28,0,30,2
1651078011393,MATH 20D,A01,083765,Staff,3,1,30,27
1651078011393,MATH 20D,A02,083766,Staff,1,0,30,29
1651078011393,MATH 20D,A03,083767,Staff,22,0,30,8
1651078017421,MATH 20E,A01,083771,Staff,2,0,30,28
1651078017421,MATH 20E,A02,083772,Staff,10,0,30,20
1651078017421,MATH 20E,B01,083773,Staff,0,0,30,30
1651078017421,MATH 20E,B02,083774,Staff,0,0,30,30
1651078023445,MATH 103A,A01,083777,Staff,0,17,30,30
1651078023445,MATH 103A,A02,083778,Staff,0,16,30,30
1651078023445,MATH 103A,B01,083779,Staff,0,15,30,30
1651078023445,MATH 103A,B02,083780,Staff,0,14,30,30
1651078029467,MATH 105,A01,085443,Staff,0,23,30,30
1651078035498,MATH 109,A01,083213,Anzaldo; Leesa B,0,7,30,30
1651078035498,MATH 109,A02,083214,Anzaldo; Leesa B,0,7,30,30
1651078035498,MATH 109,B01,083215,Anzaldo; Leesa B,0,8,30,30
1651078035498,MATH 109,B02,083216,Anzaldo; Leesa B,0,8,30,30
1651078041522,MATH 142A,A01,083219,Chow; Bennett,0,15,30,30
1651078041522,MATH 142A,A02,083220,Chow; Bennett,0,15,30,30
1651078041522,MATH 142A,B01,083221,Chow; Bennett,0,16,30,30
1651078041522,MATH 142A,B02,083222,Chow; Bennett,0,15,30,30
1651078047545,MATH 193A,A01,083224,Staff,0,9,30,30
1651078047545,MATH 193A,A02,083225,Staff,0,7,30,30
1651078047545,MATH 193A,A03,083781,Staff,0,7,30,30
1651078047545,MATH 193A,A04,083782,Staff,0,7,30,30
1651078053568,MATH 197,001,091859,McAuley; Julian John,9998,0,9999,1
1651078059644,COGS 9,A01,083615,Staff,0,20,60,60
1651078065681,COGS 11,A01,083617,Boyle; Mary E. T.,13,0,40,27
1651078071708,COGS 13,A01,083071,Staff,0,39,40,40
1651078077743,COGS 14A,A01,092681,Staff,0,39,100,100
1651078083776,COGS 14B,A01,083073,Cheng; Tzu-Han,0,14,50,50
1651078089799,COGS 17,A01,092677,Staff,9,0,75,66
1651078095833,COGS 100,A01,083619,Staff,0,30,60,60
1651078101858,COGS 101A,A01,083621,Davis; Joshua Daniel,0,29,60,60
1651078107881,COGS 101B,A01,091572,Staff,0,8,60,60
1651078113907,COGS 101C,A01,083625,Delgado; Tania,13,0,30,17
1651078119934,COGS 107A,A01,083627,Boyle; Mary E. T.,0,17,60,60
1651078125957,COGS 118A,A01,083075,Staff,0,10,60,60
1651078131985,CSE 3,A50,083646,Miranda; Gregory Joseph,15,0,38,23
1651078131985,CSE 3,A51,083647,Miranda; Gregory Joseph,36,0,37,1
1651078138020,CSE 8A,A50,083650,Miranda; Gregory Joseph,0,31,40,40
1651078144044,CSE 11,A01,083080,Cao; Yingjun,1,97,40,39
1651078150078,CSE 12,A01,083652,Staff,0,27,100,100
1651078156112,CSE 15L,A01,083654,Staff,0,3,50,50
1651078156112,CSE 15L,A02,083655,Staff,0,3,50,50
1651078162150,CSE 20,A01,083657,Staff,46,0,80,34
1651078168180,CSE 30,A01,083084,Eldon; John,0,38,80,80
1651078174207,CSE 100,A01,083659,Cao; Yingjun,0,72,50,50
1651078180235,CSE 134B,A01,083661,Powell; Thomas Allan,0,38,65,65
1651078186275,CSE 140,A01,083663,Staff,0,15,75,75
1651078192303,CSE 140L,A01,083088,Eldon; John,3,0,100,97
1651078198328,CSE 175,A01,083665,Kumar; Rakesh,0,0,25,25
1651078204358,CSE 190,A00,092507,Dubnov; Shlomo,9,0,20,11
1651078210385,ECE 45,A01,083139,Staff,0,7,60,60
1651078216410,ECE 65,A50,083695,Staff,0,7,30,30
1651078222434,ECE 109,A01,091882,Touri; Behrouz,33,0,70,37
1651078228467,ECE 180,A00,083140,Abi Samra; Nicholas Camill,17,0,30,13
1651078228467,ECE 180,B00,083141,Abi Samra; Nicholas Camill,0,0,30,30
1651078234493,MATH 10A,A01,083735,Patchell; Gregory David,0,0,30,30
1651078234493,MATH 10A,A02,083736,Patchell; Gregory David,27,0,30,3
1651078234493,MATH 10A,A03,083737,Patchell; Gregory David,22,0,30,8
1651078240520,MATH 10B,A01,083207,Staff,0,7,30,30
1651078240520,MATH 10B,A02,083208,Staff,0,6,30,30
1651078240520,MATH 10B,B01,083739,Staff,8,0,30,22
1651078240520,MATH 10B,B02,083740,Staff,28,0,30,2
1651078246544,MATH 18,A01,083743,Staff,0,0,30,30
1651078246544,MATH 18,A02,083744,Staff,23,0,30,7
1651078246544,MATH 18,A03,083745,Staff,19,0,30,11
1651078246544,MATH 18,A04,083746,Staff,26,0,30,4
1651078246544,MATH 18,B01,083748,Staff,0,16,30,30
1651078246544,MATH 18,B02,083749,Staff,0,14,30,30
1651078246544,MATH 18,B03,083750,Staff,0,14,30,30
1651078246544,MATH 18,B04,083751,Staff,0,13,30,30
1651078252590,MATH 20A,A01,083754,Staff,18,0,40,22
1651078258618,MATH 20B,A01,083756,Staff,0,14,30,30
1651078258618,MATH 20B,A02,083757,Staff,0,11,30,30
1651078264642,MATH 20C,A01,083760,Staff,0,16,30,30
1651078264642,MATH 20C,A02,083761,Staff,0,15,30,30
1651078264642,MATH 20C,B01,083762,Staff,7,0,30,23
1651078264642,MATH 20C,B02,083763,Staff,28,0,30,2
1651078270663,MATH 20D,A01,083765,Staff,3,1,30,27
1651078270663,MATH 20D,A02,083766,Staff,1,0,30,29
1651078270663,MATH 20D,A03,083767,Staff,22,0,30,8
1651078276690,MATH 20E,A01,083771,Staff,2,0,30,28
1651078276690,MATH 20E,A02,083772,Staff,10,0,30,20
1651078276690,MATH 20E,B01,083773,Staff,0,0,30,30
1651078276690,MATH 20E,B02,083774,Staff,0,0,30,30
1651078282725,MATH 103A,A01,083777,Staff,0,17,30,30
1651078282725,MATH 103A,A02,083778,Staff,0,16,30,30
1651078282725,MATH 103A,B01,083779,Staff,0,15,30,30
1651078282725,MATH 103A,B02,083780,Staff,0,14,30,30
1651078288752,MATH 105,A01,085443,Staff,0,23,30,30
1651078294776,MATH 109,A01,083213,Anzaldo; Leesa B,0,7,30,30
1651078294776,MATH 109,A02,083214,Anzaldo; Leesa B,0,7,30,30
1651078294776,MATH 109,B01,083215,Anzaldo; Leesa B,0,8,30,30
1651078294776,MATH 109,B02,083216,Anzaldo; Leesa B,0,8,30,30
1651078300801,MATH 142A,A01,083219,Chow; Bennett,0,15,30,30
1651078300801,MATH 142A,A02,083220,Chow; Bennett,0,15,30,30
1651078300801,MATH 142A,B01,083221,Chow; Bennett,0,16,30,30
1651078300801,MATH 142A,B02,083222,Chow; Bennett,0,15,30,30
1651078306827,MATH 193A,A01,083224,Staff,0,9,30,30
1651078306827,MATH 193A,A02,083225,Staff,0,7,30,30
1651078306827,MATH 193A,A03,083781,Staff,0,7,30,30
1651078306827,MATH 193A,A04,083782,Staff,0,7,30,30
1651078312850,MATH 197,001,091859,McAuley; Julian John,9998,0,9999,1
1651078318913,COGS 9,A01,083615,Staff,0,20,60,60
1651078324945,COGS 11,A01,083617,Boyle; Mary E. T.,13,0,40,27
1651078330970,COGS 13,A01,083071,Staff,0,39,40,40
1651078337006,COGS 14A,A01,092681,Staff,0,39,100,100
1651078343031,COGS 14B,A01,083073,Cheng; Tzu-Han,0,14,50,50
1651078349066,COGS 17,A01,092677,Staff,9,0,75,66
1651078355098,COGS 100,A01,083619,Staff,0,30,60,60
1651078361132,COGS 101A,A01,083621,Davis; Joshua Daniel,0,29,60,60
1651078367155,COGS 101B,A01,091572,Staff,0,8,60,60
1651078373182,COGS 101C,A01,083625,Delgado; Tania,13,0,30,17
1651078379209,COGS 107A,A01,083627,Boyle; Mary E. T.,0,17,60,60
1651078385232,COGS 118A,A01,083075,Staff,0,10,60,60
1651078391258,CSE 3,A50,083646,Miranda; Gregory Joseph,15,0,38,23
1651078391258,CSE 3,A51,083647,Miranda; Gregory Joseph,36,0,37,1
1651078397287,CSE 8A,A50,083650,Miranda; Gregory Joseph,0,31,40,40
1651078403314,CSE 11,A01,083080,Cao; Yingjun,1,98,40,39
1651078409339,CSE 12,A01,083652,Staff,0,27,100,100
1651078415361,CSE 15L,A01,083654,Staff,0,3,50,50
1651078415361,CSE 15L,A02,083655,Staff,0,3,50,50
1651078421385,CSE 20,A01,083657,Staff,46,0,80,34
1651078427414,CSE 30,A01,083084,Eldon; John,0,38,80,80
1651078433455,CSE 100,A01,083659,Cao; Yingjun,0,72,50,50
1651078439480,CSE 134B,A01,083661,Powell; Thomas Allan,0,38,65,65
1651078445505,CSE 140,A01,083663,Staff,0,15,75,75
1651078451527,CSE 140L,A01,083088,Eldon; John,3,0,100,97
1651078457552,CSE 175,A01,083665,Kumar; Rakesh,0,0,25,25
1651078463574,CSE 190,A00,092507,Dubnov; Shlomo,9,0,20,11
1651078469597,ECE 45,A01,083139,Staff,0,7,60,60
1651078475624,ECE 65,A50,083695,Staff,0,7,30,30
1651078481650,ECE 109,A01,091882,Touri; Behrouz,33,0,70,37
1651078487676,ECE 180,A00,083140,Abi Samra; Nicholas Camill,17,0,30,13
1651078487676,ECE 180,B00,083141,Abi Samra; Nicholas Camill,0,0,30,30
1651078493831,MATH 10A,A01,083735,Patchell; Gregory David,0,0,30,30
1651078493831,MATH 10A,A02,083736,Patchell; Gregory David,27,0,30,3
1651078493831,MATH 10A,A03,083737,Patchell; Gregory David,22,0,30,8
1651078499857,MATH 10B,A01,083207,Staff,0,7,30,30
1651078499857,MATH 10B,A02,083208,Staff,0,6,30,30
1651078499857,MATH 10B,B01,083739,Staff,8,0,30,22
1651078499857,MATH 10B,B02,083740,Staff,28,0,30,2
1651078505882,MATH 18,A01,083743,Staff,0,0,30,30
1651078505882,MATH 18,A02,083744,Staff,23,0,30,7
1651078505882,MATH 18,A03,083745,Staff,19,0,30,11
1651078505882,MATH 18,A04,083746,Staff,26,0,30,4
1651078505882,MATH 18,B01,083748,Staff,0,16,30,30
1651078505882,MATH 18,B02,083749,Staff,0,14,30,30
1651078505882,MATH 18,B03,083750,Staff,0,14,30,30
1651078505882,MATH 18,B04,083751,Staff,0,13,30,30
1651078511906,MATH 20A,A01,083754,Staff,18,0,40,22
1651078517931,MATH 20B,A01,083756,Staff,0,14,30,30
1651078517931,MATH 20B,A02,083757,Staff,0,11,30,30
1651078523968,MATH 20C,A01,083760,Staff,0,16,30,30
1651078523968,MATH 20C,A02,083761,Staff,0,15,30,30
1651078523968,MATH 20C,B01,083762,Staff,7,0,30,23
1651078523968,MATH 20C,B02,083763,Staff,28,0,30,2
1651078529992,MATH 20D,A01,083765,Staff,3,1,30,27
1651078529992,MATH 20D,A02,083766,Staff,1,0,30,29
1651078529992,MATH 20D,A03,083767,Staff,22,0,30,8
1651078536019,MATH 20E,A01,083771,Staff,2,0,30,28
1651078536019,MATH 20E,A02,083772,Staff,10,0,30,20
1651078536019,MATH 20E,B01,083773,Staff,0,0,30,30
1651078536019,MATH 20E,B02,083774,Staff,0,0,30,30
1651078542049,MATH 103A,A01,083777,Staff,0,17,30,30
1651078542049,MATH 103A,A02,083778,Staff,0,16,30,30
1651078542049,MATH 103A,B01,083779,Staff,0,15,30,30
1651078542049,MATH 103A,B02,083780,Staff,0,14,30,30
1651078548073,MATH 105,A01,085443,Staff,0,23,30,30
1651078554100,MATH 109,A01,083213,Anzaldo; Leesa B,0,7,30,30
1651078554100,MATH 109,A02,083214,Anzaldo; Leesa B,0,7,30,30
1651078554100,MATH 109,B01,083215,Anzaldo; Leesa B,0,8,30,30
1651078554100,MATH 109,B02,083216,Anzaldo; Leesa B,0,8,30,30
1651078560132,MATH 142A,A01,083219,Chow; Bennett,0,15,30,30
1651078560132,MATH 142A,A02,083220,Chow; Bennett,0,15,30,30
1651078560132,MATH 142A,B01,083221,Chow; Bennett,0,16,30,30
1651078560132,MATH 142A,B02,083222,Chow; Bennett,0,15,30,30
1651078566156,MATH 193A,A01,083224,Staff,0,9,30,30
1651078566156,MATH 193A,A02,083225,Staff,0,7,30,30
1651078566156,MATH 193A,A03,083781,Staff,0,7,30,30
1651078566156,MATH 193A,A04,083782,Staff,0,7,30,30
1651078572178,MATH 197,001,091859,McAuley; Julian John,9998,0,9999,1
1651078578228,COGS 9,A01,083615,Staff,0,20,60,60
1651078584255,COGS 11,A01,083617,Boyle; Mary E. T.,13,0,40,27
1651078590282,COGS 13,A01,083071,Staff,0,39,40,40
1651078596306,COGS 14A,A01,092681,Staff,0,39,100,100
1651078602330,COGS 14B,A01,083073,Cheng; Tzu-Han,0,14,50,50
1651078608356,COGS 17,A01,092677,Staff,9,0,75,66
1651078614381,COGS 100,A01,083619,Staff,0,30,60,60
1651078620407,COGS 101A,A01,083621,Davis; Joshua Daniel,0,29,60,60
1651078626431,COGS 101B,A01,091572,Staff,0,8,60,60
1651078632453,COGS 101C,A01,083625,Delgado; Tania,13,0,30,17
1651078638476,COGS 107A,A01,083627,Boyle; Mary E. T.,0,17,60,60
1651078644506,COGS 118A,A01,083075,Staff,0,10,60,60
1651078650534,CSE 3,A50,083646,Miranda; Gregory Joseph,15,0,38,23
1651078650534,CSE 3,A51,083647,Miranda; Gregory Joseph,36,0,37,1
1651078656574,CSE 8A,A50,083650,Miranda; Gregory Joseph,0,31,40,40
1651078662606,CSE 11,A01,083080,Cao; Yingjun,1,98,40,39
1651078668631,CSE 12,A01,083652,Staff,0,27,100,100
1651078674657,CSE 15L,A01,083654,Staff,0,3,50,50
1651078674657,CSE 15L,A02,083655,Staff,0,3,50,50
1651078680683,CSE 20,A01,083657,Staff,46,0,80,34
1651078686706,CSE 30,A01,083084,Eldon; John,0,38,80,80
1651078692732,CSE 100,A01,083659,Cao; Yingjun,0,72,50,50
1651078698765,CSE 134B,A01,083661,Powell; Thomas Allan,0,38,65,65
1651078704787,CSE 140,A01,083663,Staff,0,15,75,75
1651078710816,CSE 140L,A01,083088,Eldon; John,3,0,100,97
1651078716840,CSE 175,A01,083665,Kumar; Rakesh,0,0,25,25
1651078722864,CSE 190,A00,092507,Dubnov; Shlomo,9,0,20,11
1651078728887,ECE 45,A01,083139,Staff,0,7,60,60
1651078734910,ECE 65,A50,083695,Staff,0,7,30,30
1651078740939,ECE 109,A01,091882,Touri; Behrouz,33,0,70,37
1651078746966,ECE 180,A00,083140,Abi Samra; Nicholas Camill,17,0,30,13
1651078746966,ECE 180,B00,083141,Abi Samra; Nicholas Camill,0,0,30,30
1651078752989,MATH 10A,A01,083735,Patchell; Gregory David,0,0,30,30
1651078752989,MATH 10A,A02,083736,Patchell; Gregory David,27,0,30,3
1651078752989,MATH 10A,A03,083737,Patchell; Gregory David,22,0,30,8
1651078759021,MATH 10B,A01,083207,Staff,0,7,30,30
1651078759021,MATH 10B,A02,083208,Staff,0,6,30,30
1651078759021,MATH 10B,B01,083739,Staff,8,0,30,22
1651078759021,MATH 10B,B02,083740,Staff,28,0,30,2
1651078765045,MATH 18,A01,083743,Staff,0,0,30,30
1651078765045,MATH 18,A02,083744,Staff,23,0,30,7
1651078765045,MATH 18,A03,083745,Staff,19,0,30,11
1651078765045,MATH 18,A04,083746,Staff,26,0,30,4
1651078765045,MATH 18,B01,083748,Staff,0,16,30,30
1651078765045,MATH 18,B02,083749,Staff,0,14,30,30
1651078765045,MATH 18,B03,083750,Staff,0,14,30,30
1651078765045,MATH 18,B04,083751,Staff,0,13,30,30
1651078771069,MATH 20A,A01,083754,Staff,18,0,40,22
1651078777093,MATH 20B,A01,083756,Staff,0,14,30,30
1651078777093,MATH 20B,A02,083757,Staff,0,11,30,30
1651078783116,MATH 20C,A01,083760,Staff,0,16,30,30
1651078783116,MATH 20C,A02,083761,Staff,0,15,30,30
1651078783116,MATH 20C,B01,083762,Staff,7,0,30,23
1651078783116,MATH 20C,B02,083763,Staff,28,0,30,2
1651078789143,MATH 20D,A01,083765,Staff,3,1,30,27
1651078789143,MATH 20D,A02,083766,Staff,1,0,30,29
1651078789143,MATH 20D,A03,083767,Staff,22,0,30,8
1651078795169,MATH 20E,A01,083771,Staff,2,0,30,28
1651078795169,MATH 20E,A02,083772,Staff,10,0,30,20
1651078795169,MATH 20E,B01,083773,Staff,0,0,30,30
1651078795169,MATH 20E,B02,083774,Staff,0,0,30,30
1651078801198,MATH 103A,A01,083777,Staff,0,17,30,30
1651078801198,MATH 103A,A02,083778,Staff,0,16,30,30
1651078801198,MATH 103A,B01,083779,Staff,0,15,30,30
1651078801198,MATH 103A,B02,083780,Staff,0,14,30,30
1651078807220,MATH 105,A01,085443,Staff,0,23,30,30
1651078813248,MATH 109,A01,083213,Anzaldo; Leesa B,0,7,30,30
1651078813248,MATH 109,A02,083214,Anzaldo; Leesa B,0,7,30,30
1651078813248,MATH 109,B01,083215,Anzaldo; Leesa B,0,8,30,30
1651078813248,MATH 109,B02,083216,Anzaldo; Leesa B,0,8,30,30
1651078819272,MATH 142A,A01,083219,Chow; Bennett,0,15,30,30
1651078819272,MATH 142A,A02,083220,Chow; Bennett,0,15,30,30
1651078819272,MATH 142A,B01,083221,Chow; Bennett,0,16,30,30
1651078819272,MATH 142A,B02,083222,Chow; Bennett,0,15,30,30
1651078825300,MATH 193A,A01,083224,Staff,0,9,30,30
1651078825300,MATH 193A,A02,083225,Staff,0,7,30,30
1651078825300,MATH 193A,A03,083781,Staff,0,7,30,30
1651078825300,MATH 193A,A04,083782,Staff,0,7,30,30
1651078831326,MATH 197,001,091859,McAuley; Julian John,9998,0,9999,1
1651078837377,COGS 9,A01,083615,Staff,0,20,60,60
1651078843401,COGS 11,A01,083617,Boyle; Mary E. T.,13,0,40,27
1651078849422,COGS 13,A01,083071,Staff,0,39,40,40
1651078855444,COGS 14A,A01,092681,Staff,0,39,100,100
1651078861477,COGS 14B,A01,083073,Cheng; Tzu-Han,0,14,50,50
1651078867498,COGS 17,A01,092677,Staff,9,0,75,66
1651078873528,COGS 100,A01,083619,Staff,0,30,60,60
1651078879556,COGS 101A,A01,083621,Davis; Joshua Daniel,0,29,60,60
1651078885586,COGS 101B,A01,091572,Staff,0,8,60,60
1651078891610,COGS 101C,A01,083625,Delgado; Tania,13,0,30,17
1651078897647,COGS 107A,A01,083627,Boyle; Mary E. T.,0,17,60,60
1651078903676,COGS 118A,A01,083075,Staff,0,10,60,60
1651078909707,CSE 3,A50,083646,Miranda; Gregory Joseph,15,0,38,23
1651078909707,CSE 3,A51,083647,Miranda; Gregory Joseph,36,0,37,1
1651078915735,CSE 8A,A50,083650,Miranda; Gregory Joseph,0,31,40,40
1651078921762,CSE 11,A01,083080,Cao; Yingjun,1,98,40,39
1651078927789,CSE 12,A01,083652,Staff,0,27,100,100
1651078933815,CSE 15L,A01,083654,Staff,0,3,50,50
1651078933815,CSE 15L,A02,083655,Staff,0,3,50,50
1651078939850,CSE 20,A01,083657,Staff,46,0,80,34
1651078945879,CSE 30,A01,083084,Eldon; John,0,38,80,80
1651078951900,CSE 100,A01,083659,Cao; Yingjun,0,72,50,50
1651078957934,CSE 134B,A01,083661,Powell; Thomas Allan,0,38,65,65
1651078963961,CSE 140,A01,083663,Staff,0,15,75,75
1651078969994,CSE 140L,A01,083088,Eldon; John,3,0,100,97
1651078976018,CSE 175,A01,083665,Kumar; Rakesh,0,0,25,25
1651078982049,CSE 190,A00,092507,Dubnov; Shlomo,9,0,20,11
1651078988081,ECE 45,A01,083139,Staff,0,7,60,60
1651078994104,ECE 65,A50,083695,Staff,0,7,30,30
1651079000126,ECE 109,A01,091882,Touri; Behrouz,33,0,70,37
1651079006153,ECE 180,A00,083140,Abi Samra; Nicholas Camill,17,0,30,13
1651079006153,ECE 180,B00,083141,Abi Samra; Nicholas Camill,0,0,30,30
1651079012189,MATH 10A,A01,083735,Patchell; Gregory David,0,0,30,30
1651079012189,MATH 10A,A02,083736,Patchell; Gregory David,27,0,30,3
1651079012189,MATH 10A,A03,083737,Patchell; Gregory David,22,0,30,8
1651079018216,MATH 10B,A01,083207,Staff,0,7,30,30
1651079018216,MATH 10B,A02,083208,Staff,0,6,30,30
1651079018216,MATH 10B,B01,083739,Staff,8,0,30,22
1651079018216,MATH 10B,B02,083740,Staff,28,0,30,2
1651079024244,MATH 18,A01,083743,Staff,0,0,30,30
1651079024244,MATH 18,A02,083744,Staff,23,0,30,7
1651079024244,MATH 18,A03,083745,Staff,19,0,30,11
1651079024244,MATH 18,A04,083746,Staff,26,0,30,4
1651079024244,MATH 18,B01,083748,Staff,0,16,30,30
1651079024244,MATH 18,B02,083749,Staff,0,14,30,30
1651079024244,MATH 18,B03,083750,Staff,0,14,30,30
1651079024244,MATH 18,B04,083751,Staff,0,13,30,30
1651079030271,MATH 20A,A01,083754,Staff,18,0,40,22
1651079036301,MATH 20B,A01,083756,Staff,0,14,30,30
1651079036301,MATH 20B,A02,083757,Staff,0,11,30,30
1651079042332,MATH 20C,A01,083760,Staff,0,16,30,30
1651079042332,MATH 20C,A02,083761,Staff,0,15,30,30
1651079042332,MATH 20C,B01,083762,Staff,7,0,30,23
1651079042332,MATH 20C,B02,083763,Staff,28,0,30,2
1651079048367,MATH 20D,A01,083765,Staff,3,1,30,27
1651079048367,MATH 20D,A02,083766,Staff,1,0,30,29
1651079048367,MATH 20D,A03,083767,Staff,22,0,30,8
1651079054390,MATH 20E,A01,083771,Staff,2,0,30,28
1651079054390,MATH 20E,A02,083772,Staff,10,0,30,20
1651079054390,MATH 20E,B01,083773,Staff,0,0,30,30
1651079054390,MATH 20E,B02,083774,Staff,0,0,30,30
1651079060416,MATH 103A,A01,083777,Staff,0,17,30,30
1651079060416,MATH 103A,A02,083778,Staff,0,16,30,30
1651079060416,MATH 103A,B01,083779,Staff,0,15,30,30
1651079060416,MATH 103A,B02,083780,Staff,0,14,30,30
1651079066440,MATH 105,A01,085443,Staff,0,23,30,30
1651079072466,MATH 109,A01,083213,Anzaldo; Leesa B,0,7,30,30
1651079072466,MATH 109,A02,083214,Anzaldo; Leesa B,0,7,30,30
1651079072466,MATH 109,B01,083215,Anzaldo; Leesa B,0,8,30,30
1651079072466,MATH 109,B02,083216,Anzaldo; Leesa B,0,8,30,30
1651079078495,MATH 142A,A01,083219,Chow; Bennett,0,15,30,30
1651079078495,MATH 142A,A02,083220,Chow; Bennett,0,15,30,30
1651079078495,MATH 142A,B01,083221,Chow; Bennett,0,16,30,30
1651079078495,MATH 142A,B02,083222,Chow; Bennett,0,15,30,30
1651079084522,MATH 193A,A01,083224,Staff,0,9,30,30
1651079084522,MATH 193A,A02,083225,Staff,0,7,30,30
1651079084522,MATH 193A,A03,083781,Staff,0,7,30,30
1651079084522,MATH 193A,A04,083782,Staff,0,7,30,30
1651079090620,MATH 197,001,091859,McAuley; Julian John,9998,0,9999,1
1651079096688,COGS 9,A01,083615,Staff,0,20,60,60
1651079102711,COGS 11,A01,083617,Boyle; Mary E. T.,13,0,40,27
1651079108747,COGS 13,A01,083071,Staff,0,39,40,40
1651079114770,COGS 14A,A01,092681,Staff,0,39,100,100
1651079120797,COGS 14B,A01,083073,Cheng; Tzu-Han,0,14,50,50
1651079126822,COGS 17,A01,092677,Staff,9,0,75,66
1651079132844,COGS 100,A01,083619,Staff,0,30,60,60
1651079138872,COGS 101A,A01,083621,Davis; Joshua Daniel,0,29,60,60
1651079144901,COGS 101B,A01,091572,Staff,0,8,60,60
1651079150928,COGS 101C,A01,083625,Delgado; Tania,13,0,30,17
1651079156951,COGS 107A,A01,083627,Boyle; Mary E. T.,0,17,60,60
1651079162978,COGS 118A,A01,083075,Staff,0,10,60,60
1651079169003,CSE 3,A50,083646,Miranda; Gregory Joseph,15,0,38,23
1651079169003,CSE 3,A51,083647,Miranda; Gregory Joseph,36,0,37,1
1651079175025,CSE 8A,A50,083650,Miranda; Gregory Joseph,0,31,40,40
1651079181047,CSE 11,A01,083080,Cao; Yingjun,1,98,40,39
1651079187070,CSE 12,A01,083652,Staff,0,27,100,100
1651079193096,CSE 15L,A01,083654,Staff,0,3,50,50
1651079193096,CSE 15L,A02,083655,Staff,0,3,50,50
1651079199121,CSE 20,A01,083657,Staff,46,0,80,34
1651079205144,CSE 30,A01,083084,Eldon; John,0,38,80,80
1651079211172,CSE 100,A01,083659,Cao; Yingjun,0,72,50,50
1651079217195,CSE 134B,A01,083661,Powell; Thomas Allan,0,38,65,65
1651079223219,CSE 140,A01,083663,Staff,0,15,75,75
1651079229242,CSE 140L,A01,083088,Eldon; John,3,0,100,97
1651079235270,CSE 175,A01,083665,Kumar; Rakesh,0,0,25,25
1651079241297,CSE 190,A00,092507,Dubnov; Shlomo,9,0,20,11
1651079247322,ECE 45,A01,083139,Staff,0,7,60,60
1651079253348,ECE 65,A50,083695,Staff,0,7,30,30
1651079259373,ECE 109,A01,091882,Touri; Behrouz,33,0,70,37
1651079265399,ECE 180,A00,083140,Abi Samra; Nicholas Camill,17,0,30,13
1651079265399,ECE 180,B00,083141,Abi Samra; Nicholas Camill,0,0,30,30
1651079271427,MATH 10A,A01,083735,Patchell; Gregory David,0,0,30,30
1651079271427,MATH 10A,A02,083736,Patchell; Gregory David,27,0,30,3
1651079271427,MATH 10A,A03,083737,Patchell; Gregory David,22,0,30,8
1651079277453,MATH 10B,A01,083207,Staff,0,7,30,30
1651079277453,MATH 10B,A02,083208,Staff,0,6,30,30
1651079277453,MATH 10B,B01,083739,Staff,8,0,30,22
1651079277453,MATH 10B,B02,083740,Staff,28,0,30,2
1651079283480,MATH 18,A01,083743,Staff,0,0,30,30
1651079283480,MATH 18,A02,083744,Staff,23,0,30,7
1651079283480,MATH 18,A03,083745,Staff,19,0,30,11
1651079283480,MATH 18,A04,083746,Staff,26,0,30,4
1651079283480,MATH 18,B01,083748,Staff,0,16,30,30
1651079283480,MATH 18,B02,083749,Staff,0,14,30,30
1651079283480,MATH 18,B03,083750,Staff,0,14,30,30
1651079283480,MATH 18,B04,083751,Staff,0,13,30,30
1651079289503,MATH 20A,A01,083754,Staff,18,0,40,22
1651079295534,MATH 20B,A01,083756,Staff,0,14,30,30
1651079295534,MATH 20B,A02,083757,Staff,0,11,30,30
1651079301561,MATH 20C,A01,083760,Staff,0,16,30,30
1651079301561,MATH 20C,A02,083761,Staff,0,15,30,30
1651079301561,MATH 20C,B01,083762,Staff,7,0,30,23
1651079301561,MATH 20C,B02,083763,Staff,28,0,30,2
1651079307584,MATH 20D,A01,083765,Staff,3,1,30,27
1651079307584,MATH 20D,A02,083766,Staff,1,0,30,29
1651079307584,MATH 20D,A03,083767,Staff,22,0,30,8
1651079313614,MATH 20E,A01,083771,Staff,2,0,30,28
1651079313614,MATH 20E,A02,083772,Staff,10,0,30,20
1651079313614,MATH 20E,B01,083773,Staff,0,0,30,30
1651079313614,MATH 20E,B02,083774,Staff,0,0,30,30
1651079319645,MATH 103A,A01,083777,Staff,0,17,30,30
1651079319645,MATH 103A,A02,083778,Staff,0,16,30,30
1651079319645,MATH 103A,B01,083779,Staff,0,15,30,30
1651079319645,MATH 103A,B02,083780,Staff,0,14,30,30
1651079325675,MATH 105,A01,085443,Staff,0,23,30,30
1651079331699,MATH 109,A01,083213,Anzaldo; Leesa B,0,7,30,30
1651079331699,MATH 109,A02,083214,Anzaldo; Leesa B,0,7,30,30
1651079331699,MATH 109,B01,083215,Anzaldo; Leesa B,0,8,30,30
1651079331699,MATH 109,B02,083216,Anzaldo; Leesa B,0,8,30,30
1651079337722,MATH 142A,A01,083219,Chow; Bennett,0,15,30,30
1651079337722,MATH 142A,A02,083220,Chow; Bennett,0,15,30,30
1651079337722,MATH 142A,B01,083221,Chow; Bennett,0,16,30,30
1651079337722,MATH 142A,B02,083222,Chow; Bennett,0,15,30,30
1651079343746,MATH 193A,A01,083224,Staff,0,9,30,30
1651079343746,MATH 193A,A02,083225,Staff,0,7,30,30
1651079343746,MATH 193A,A03,083781,Staff,0,7,30,30
1651079343746,MATH 193A,A04,083782,Staff,0,7,30,30
1651079349768,MATH 197,001,091859,McAuley; Julian John,9998,0,9999,1
1651079355831,COGS 9,A01,083615,Staff,0,20,60,60
1651079361869,COGS 11,A01,083617,Boyle; Mary E. T.,13,0,40,27
1651079367904,COGS 13,A01,083071,Staff,0,39,40,40
1651079373935,COGS 14A,A01,092681,Staff,0,39,100,100
1651079379961,COGS 14B,A01,083073,Cheng; Tzu-Han,0,14,50,50
1651079385985,COGS 17,A01,092677,Staff,9,0,75,66
1651079392011,COGS 100,A01,083619,Staff,0,30,60,60
1651079398033,COGS 101A,A01,083621,Davis; Joshua Daniel,0,29,60,60
1651079404061,COGS 101B,A01,091572,Staff,0,8,60,60
1651079410087,COGS 101C,A01,083625,Delgado; Tania,13,0,30,17
1651079416131,COGS 107A,A01,083627,Boyle; Mary E. T.,0,17,60,60
1651079422155,COGS 118A,A01,083075,Staff,0,10,60,60
1651079428179,CSE 3,A50,083646,Miranda; Gregory Joseph,15,0,38,23
1651079428179,CSE 3,A51,083647,Miranda; Gregory Joseph,36,0,37,1
1651079434219,CSE 8A,A50,083650,Miranda; Gregory Joseph,0,31,40,40
1651079440245,CSE 11,A01,083080,Cao; Yingjun,1,98,40,39
1651079446270,CSE 12,A01,083652,Staff,0,27,100,100
1651079452293,CSE 15L,A01,083654,Staff,0,3,50,50
1651079452293,CSE 15L,A02,083655,Staff,0,3,50,50
1651079458320,CSE 20,A01,083657,Staff,46,0,80,34
1651079464352,CSE 30,A01,083084,Eldon; John,0,38,80,80
1651079470378,CSE 100,A01,083659,Cao; Yingjun,0,72,50,50
1651079476409,CSE 134B,A01,083661,Powell; Thomas Allan,0,38,65,65
1651079482432,CSE 140,A01,083663,Staff,0,15,75,75
1651079488455,CSE 140L,A01,083088,Eldon; John,3,0,100,97
1651079494477,CSE 175,A01,083665,Kumar; Rakesh,0,0,25,25
1651079500501,CSE 190,A00,092507,Dubnov; Shlomo,9,0,20,11
1651079506528,ECE 45,A01,083139,Staff,0,7,60,60
1651079512555,ECE 65,A50,083695,Staff,0,7,30,30
1651079518578,ECE 109,A01,091882,Touri; Behrouz,33,0,70,37
1651079524613,ECE 180,A00,083140,Abi Samra; Nicholas Camill,17,0,30,13
1651079524613,ECE 180,B00,083141,Abi Samra; Nicholas Camill,0,0,30,30
1651079530644,MATH 10A,A01,083735,Patchell; Gregory David,0,0,30,30
1651079530644,MATH 10A,A02,083736,Patchell; Gregory David,27,0,30,3
1651079530644,MATH 10A,A03,083737,Patchell; Gregory David,22,0,30,8
1651079536674,MATH 10B,A01,083207,Staff,0,7,30,30
1651079536674,MATH 10B,A02,083208,Staff,0,6,30,30
1651079536674,MATH 10B,B01,083739,Staff,8,0,30,22
1651079536674,MATH 10B,B02,083740,Staff,28,0,30,2
1651079542702,MATH 18,A01,083743,Staff,0,0,30,30
1651079542702,MATH 18,A02,083744,Staff,23,0,30,7
1651079542702,MATH 18,A03,083745,Staff,19,0,30,11
1651079542702,MATH 18,A04,083746,Staff,26,0,30,4
1651079542702,MATH 18,B01,083748,Staff,0,16,30,30
1651079542702,MATH 18,B02,083749,Staff,0,14,30,30
1651079542702,MATH 18,B03,083750,Staff,0,14,30,30
1651079542702,MATH 18,B04,083751,Staff,0,13,30,30
1651079548727,MATH 20A,A01,083754,Staff,18,0,40,22
1651079554748,MATH 20B,A01,083756,Staff,0,14,30,30
1651079554748,MATH 20B,A02,083757,Staff,0,11,30,30
1651079560772,MATH 20C,A01,083760,Staff,0,16,30,30
1651079560772,MATH 20C,A02,083761,Staff,0,15,30,30
1651079560772,MATH 20C,B01,083762,Staff,7,0,30,23
1651079560772,MATH 20C,B02,083763,Staff,28,0,30,2
1651079566798,MATH 20D,A01,083765,Staff,3,1,30,27
1651079566798,MATH 20D,A02,083766,Staff,1,0,30,29
1651079566798,MATH 20D,A03,083767,Staff,22,0,30,8
1651079572821,MATH 20E,A01,083771,Staff,2,0,30,28
1651079572821,MATH 20E,A02,083772,Staff,10,0,30,20
1651079572821,MATH 20E,B01,083773,Staff,0,0,30,30
1651079572821,MATH 20E,B02,083774,Staff,0,0,30,30
1651079578846,MATH 103A,A01,083777,Staff,0,17,30,30
1651079578846,MATH 103A,A02,083778,Staff,0,16,30,30
1651079578846,MATH 103A,B01,083779,Staff,0,15,30,30
1651079578846,MATH 103A,B02,083780,Staff,0,14,30,30
1651079584875,MATH 105,A01,085443,Staff,0,23,30,30
1651079590897,MATH 109,A01,083213,Anzaldo; Leesa B,0,7,30,30
1651079590897,MATH 109,A02,083214,Anzaldo; Leesa B,0,7,30,30
1651079590897,MATH 109,B01,083215,Anzaldo; Leesa B,0,8,30,30
1651079590897,MATH 109,B02,083216,Anzaldo; Leesa B,0,8,30,30
1651079596929,MATH 142A,A01,083219,Chow; Bennett,0,15,30,30
1651079596929,MATH 142A,A02,083220,Chow; Bennett,0,15,30,30
1651079596929,MATH 142A,B01,083221,Chow; Bennett,0,16,30,30
1651079596929,MATH 142A,B02,083222,Chow; Bennett,0,15,30,30
1651079602963,MATH 193A,A01,083224,Staff,0,9,30,30
1651079602963,MATH 193A,A02,083225,Staff,0,7,30,30
1651079602963,MATH 193A,A03,083781,Staff,0,7,30,30
1651079602963,MATH 193A,A04,083782,Staff,0,7,30,30
1651079608996,MATH 197,001,091859,McAuley; Julian John,9998,0,9999,1
1651079615051,COGS 9,A01,083615,Staff,0,20,60,60
1651079621077,COGS 11,A01,083617,Boyle; Mary E. T.,13,0,40,27
1651079627103,COGS 13,A01,083071,Staff,0,39,40,40
1651079633127,COGS 14A,A01,092681,Staff,0,39,100,100
1651079639153,COGS 14B,A01,083073,Cheng; Tzu-Han,0,14,50,50
1651079645182,COGS 17,A01,092677,Staff,9,0,75,66
1651079651205,COGS 100,A01,083619,Staff,0,30,60,60
1651079657232,COGS 101A,A01,083621,Davis; Joshua Daniel,0,29,60,60
1651079663265,COGS 101B,A01,091572,Staff,0,8,60,60
1651079669296,COGS 101C,A01,083625,Delgado; Tania,13,0,30,17
1651079675334,COGS 107A,A01,083627,Boyle; Mary E. T.,0,17,60,60
1651079681479,COGS 118A,A01,083075,Staff,0,10,60,60
1651079687502,CSE 3,A50,083646,Miranda; Gregory Joseph,15,0,38,23
1651079687502,CSE 3,A51,083647,Miranda; Gregory Joseph,36,0,37,1
1651079693528,CSE 8A,A50,083650,Miranda; Gregory Joseph,0,31,40,40
1651079699554,CSE 11,A01,083080,Cao; Yingjun,1,98,40,39
1651079705580,CSE 12,A01,083652,Staff,0,27,100,100
1651079711605,CSE 15L,A01,083654,Staff,0,3,50,50
1651079711605,CSE 15L,A02,083655,Staff,0,3,50,50
1651079717630,CSE 20,A01,083657,Staff,46,0,80,34
1651079723657,CSE 30,A01,083084,Eldon; John,0,38,80,80
1651079729686,CSE 100,A01,083659,Cao; Yingjun,0,72,50,50
1651079735719,CSE 134B,A01,083661,Powell; Thomas Allan,0,38,65,65
1651079741758,CSE 140,A01,083663,Staff,0,15,75,75
1651079747790,CSE 140L,A01,083088,Eldon; John,3,0,100,97
1651079753825,CSE 175,A01,083665,Kumar; Rakesh,0,0,25,25
1651079759858,CSE 190,A00,092507,Dubnov; Shlomo,9,0,20,11
1651079765882,ECE 45,A01,083139,Staff,0,7,60,60
1651079771907,ECE 65,A50,083695,Staff,0,7,30,30
1651079777932,ECE 109,A01,091882,Touri; Behrouz,33,0,70,37
1651079783963,ECE 180,A00,083140,Abi Samra; Nicholas Camill,17,0,30,13
1651079783963,ECE 180,B00,083141,Abi Samra; Nicholas Camill,0,0,30,30
1651079790009,MATH 10A,A01,083735,Patchell; Gregory David,0,0,30,30
1651079790009,MATH 10A,A02,083736,Patchell; Gregory David,27,0,30,3
1651079790009,MATH 10A,A03,083737,Patchell; Gregory David,22,0,30,8
1651079796043,MATH 10B,A01,083207,Staff,0,7,30,30
1651079796043,MATH 10B,A02,083208,Staff,0,6,30,30
1651079796043,MATH 10B,B01,083739,Staff,8,0,30,22
1651079796043,MATH 10B,B02,083740,Staff,28,0,30,2
1651079802070,MATH 18,A01,083743,Staff,0,0,30,30
1651079802070,MATH 18,A02,083744,Staff,23,0,30,7
1651079802070,MATH 18,A03,083745,Staff,19,0,30,11
1651079802070,MATH 18,A04,083746,Staff,26,0,30,4
1651079802070,MATH 18,B01,083748,Staff,0,16,30,30
1651079802070,MATH 18,B02,083749,Staff,0,14,30,30
1651079802070,MATH 18,B03,083750,Staff,0,14,30,30
1651079802070,MATH 18,B04,083751,Staff,0,13,30,30
1651079808102,MATH 20A,A01,083754,Staff,18,0,40,22
1651079814124,MATH 20B,A01,083756,Staff,0,14,30,30
1651079814124,MATH 20B,A02,083757,Staff,0,11,30,30
1651079820149,MATH 20C,A01,083760,Staff,0,16,30,30
1651079820149,MATH 20C,A02,083761,Staff,0,15,30,30
1651079820149,MATH 20C,B01,083762,Staff,7,0,30,23
1651079820149,MATH 20C,B02,083763,Staff,28,0,30,2
1651079826187,MATH 20D,A01,083765,Staff,3,1,30,27
1651079826187,MATH 20D,A02,083766,Staff,1,0,30,29
1651079826187,MATH 20D,A03,083767,Staff,22,0,30,8
1651079832210,MATH 20E,A01,083771,Staff,2,0,30,28
1651079832210,MATH 20E,A02,083772,Staff,10,0,30,20
1651079832210,MATH 20E,B01,083773,Staff,0,0,30,30
1651079832210,MATH 20E,B02,083774,Staff,0,0,30,30
1651079838238,MATH 103A,A01,083777,Staff,0,17,30,30
1651079838238,MATH 103A,A02,083778,Staff,0,16,30,30
1651079838238,MATH 103A,B01,083779,Staff,0,15,30,30
1651079838238,MATH 103A,B02,083780,Staff,0,14,30,30
1651079844262,MATH 105,A01,085443,Staff,0,23,30,30
1651079850308,MATH 109,A01,083213,Anzaldo; Leesa B,0,7,30,30
1651079850308,MATH 109,A02,083214,Anzaldo; Leesa B,0,7,30,30
1651079850308,MATH 109,B01,083215,Anzaldo; Leesa B,0,8,30,30
1651079850308,MATH 109,B02,083216,Anzaldo; Leesa B,0,8,30,30
1651079856351,MATH 142A,A01,083219,Chow; Bennett,0,15,30,30
1651079856351,MATH 142A,A02,083220,Chow; Bennett,0,15,30,30
1651079856351,MATH 142A,B01,083221,Chow; Bennett,0,16,30,30
1651079856351,MATH 142A,B02,083222,Chow; Bennett,0,15,30,30
1651079862377,MATH 193A,A01,083224,Staff,0,9,30,30
1651079862377,MATH 193A,A02,083225,Staff,0,7,30,30
1651079862377,MATH 193A,A03,083781,Staff,0,7,30,30
1651079862377,MATH 193A,A04,083782,Staff,0,7,30,30
1651079868399,MATH 197,001,091859,McAuley; Julian John,9998,0,9999,1
1651079874462,COGS 9,A01,083615,Staff,0,20,60,60
1651079880492,COGS 11,A01,083617,Boyle; Mary E. T.,13,0,40,27
1651079886523,COGS 13,A01,083071,Staff,0,39,40,40
1651079892548,COGS 14A,A01,092681,Staff,0,39,100,100
1651079898588,COGS 14B,A01,083073,Cheng; Tzu-Han,0,14,50,50
1651079904611,COGS 17,A01,092677,Staff,9,0,75,66
1651079910634,COGS 100,A01,083619,Staff,0,30,60,60
1651079916673,COGS 101A,A01,083621,Davis; Joshua Daniel,0,29,60,60
1651079922696,COGS 101B,A01,091572,Staff,0,8,60,60
1651079928728,COGS 101C,A01,083625,Delgado; Tania,13,0,30,17
1651079934751,COGS 107A,A01,083627,Boyle; Mary E. T.,0,17,60,60
1651079940774,COGS 118A,A01,083075,Staff,0,10,60,60
1651079946800,CSE 3,A50,083646,Miranda; Gregory Joseph,15,0,38,23
1651079946800,CSE 3,A51,083647,Miranda; Gregory Joseph,36,0,37,1
1651079952823,CSE 8A,A50,083650,Miranda; Gregory Joseph,0,31,40,40
1651079958846,CSE 11,A01,083080,Cao; Yingjun,1,98,40,39
1651079964880,CSE 12,A01,083652,Staff,0,27,100,100
1651079970912,CSE 15L,A01,083654,Staff,0,3,50,50
1651079970912,CSE 15L,A02,083655,Staff,0,3,50,50
1651079976936,CSE 20,A01,083657,Staff,46,0,80,34
1651079982962,CSE 30,A01,083084,Eldon; John,0,38,80,80
1651079988994,CSE 100,A01,083659,Cao; Yingjun,0,72,50,50
1651079995018,CSE 134B,A01,083661,Powell; Thomas Allan,0,38,65,65
1651080001046,CSE 140,A01,083663,Staff,0,15,75,75
1651080007070,CSE 140L,A01,083088,Eldon; John,3,0,100,97
1651080013097,CSE 175,A01,083665,Kumar; Rakesh,0,0,25,25
1651080019122,CSE 190,A00,092507,Dubnov; Shlomo,9,0,20,11
1651080025147,ECE 45,A01,083139,Staff,0,7,60,60
1651080031178,ECE 65,A50,083695,Staff,0,7,30,30
1651080037205,ECE 109,A01,091882,Touri; Behrouz,33,0,70,37
1651080043239,ECE 180,A00,083140,Abi Samra; Nicholas Camill,17,0,30,13
1651080043239,ECE 180,B00,083141,Abi Samra; Nicholas Camill,0,0,30,30
1651080049277,MATH 10A,A01,083735,Patchell; Gregory David,0,0,30,30
1651080049277,MATH 10A,A02,083736,Patchell; Gregory David,27,0,30,3
1651080049277,MATH 10A,A03,083737,Patchell; Gregory David,22,0,30,8
1651080055301,MATH 10B,A01,083207,Staff,0,7,30,30
1651080055301,MATH 10B,A02,083208,Staff,0,6,30,30
1651080055301,MATH 10B,B01,083739,Staff,8,0,30,22
1651080055301,MATH 10B,B02,083740,Staff,28,0,30,2
1651080061329,MATH 18,A01,083743,Staff,0,0,30,30
1651080061329,MATH 18,A02,083744,Staff,23,0,30,7
1651080061329,MATH 18,A03,083745,Staff,19,0,30,11
1651080061329,MATH 18,A04,083746,Staff,26,0,30,4
1651080061329,MATH 18,B01,083748,Staff,0,16,30,30
1651080061329,MATH 18,B02,083749,Staff,0,14,30,30
1651080061329,MATH 18,B03,083750,Staff,0,14,30,30
1651080061329,MATH 18,B04,083751,Staff,0,13,30,30
1651080067366,MATH 20A,A01,083754,Staff,18,0,40,22
1651080073414,MATH 20B,A01,083756,Staff,0,14,30,30
1651080073414,MATH 20B,A02,083757,Staff,0,11,30,30
1651080079461,MATH 20C,A01,083760,Staff,0,16,30,30
1651080079461,MATH 20C,A02,083761,Staff,0,15,30,30
1651080079461,MATH 20C,B01,083762,Staff,7,0,30,23
1651080079461,MATH 20C,B02,083763,Staff,27,0,30,3
1651080085488,MATH 20D,A01,083765,Staff,3,1,30,27
1651080085488,MATH 20D,A02,083766,Staff,1,0,30,29
1651080085488,MATH 20D,A03,083767,Staff,22,0,30,8
1651080091516,MATH 20E,A01,083771,Staff,2,0,30,28
1651080091516,MATH 20E,A02,083772,Staff,10,0,30,20
1651080091516,MATH 20E,B01,083773,Staff,0,0,30,30
1651080091516,MATH 20E,B02,083774,Staff,0,0,30,30
1651080097544,MATH 103A,A01,083777,Staff,0,17,30,30
1651080097544,MATH 103A,A02,083778,Staff,0,16,30,30
1651080097544,MATH 103A,B01,083779,Staff,0,15,30,30
1651080097544,MATH 103A,B02,083780,Staff,0,14,30,30
1651080103580,MATH 105,A01,085443,Staff,0,23,30,30
1651080109620,MATH 109,A01,083213,Anzaldo; Leesa B,0,7,30,30
1651080109620,MATH 109,A02,083214,Anzaldo; Leesa B,0,7,30,30
1651080109620,MATH 109,B01,083215,Anzaldo; Leesa B,0,8,30,30
1651080109620,MATH 109,B02,083216,Anzaldo; Leesa B,0,8,30,30
1651080115647,MATH 142A,A01,083219,Chow; Bennett,0,15,30,30
1651080115647,MATH 142A,A02,083220,Chow; Bennett,0,15,30,30
1651080115647,MATH 142A,B01,083221,Chow; Bennett,0,16,30,30
1651080115647,MATH 142A,B02,083222,Chow; Bennett,0,15,30,30
1651080121672,MATH 193A,A01,083224,Staff,0,9,30,30
1651080121672,MATH 193A,A02,083225,Staff,0,7,30,30
1651080121672,MATH 193A,A03,083781,Staff,0,7,30,30
1651080121672,MATH 193A,A04,083782,Staff,0,7,30,30
1651080127703,MATH 197,001,091859,McAuley; Julian John,9998,0,9999,1
1651080133772,COGS 9,A01,083615,Staff,0,20,60,60
1651080139799,COGS 11,A01,083617,Boyle; Mary E. T.,13,0,40,27
1651080145823,COGS 13,A01,083071,Staff,0,39,40,40
1651080151855,COGS 14A,A01,092681,Staff,0,39,100,100
1651080157883,COGS 14B,A01,083073,Cheng; Tzu-Han,0,14,50,50
1651080163907,COGS 17,A01,092677,Staff,9,0,75,66
1651080169931,COGS 100,A01,083619,Staff,0,30,60,60
1651080175955,COGS 101A,A01,083621,Davis; Joshua Daniel,0,29,60,60
1651080181988,COGS 101B,A01,091572,Staff,0,8,60,60
1651080188022,COGS 101C,A01,083625,Delgado; Tania,13,0,30,17
1651080194045,COGS 107A,A01,083627,Boyle; Mary E. T.,0,17,60,60
1651080200074,COGS 118A,A01,083075,Staff,0,10,60,60
1651080206096,CSE 3,A50,083646,Miranda; Gregory Joseph,15,0,38,23
1651080206096,CSE 3,A51,083647,Miranda; Gregory Joseph,36,0,37,1
1651080212129,CSE 8A,A50,083650,Miranda; Gregory Joseph,0,31,40,40
1651080218152,CSE 11,A01,083080,Cao; Yingjun,1,98,40,39
1651080224176,CSE 12,A01,083652,Staff,0,27,100,100
1651080230203,CSE 15L,A01,083654,Staff,0,3,50,50
1651080230203,CSE 15L,A02,083655,Staff,0,3,50,50
1651080236229,CSE 20,A01,083657,Staff,46,0,80,34
1651080242252,CSE 30,A01,083084,Eldon; John,0,38,80,80
1651080248277,CSE 100,A01,083659,Cao; Yingjun,0,72,50,50
1651080254303,CSE 134B,A01,083661,Powell; Thomas Allan,0,38,65,65
1651080260335,CSE 140,A01,083663,Staff,0,15,75,75
1651080266374,CSE 140L,A01,083088,Eldon; John,3,0,100,97
1651080272398,CSE 175,A01,083665,Kumar; Rakesh,0,0,25,25
1651080278510,CSE 190,A00,092507,Dubnov; Shlomo,9,0,20,11
1651080284545,ECE 45,A01,083139,Staff,0,7,60,60
1651080290575,ECE 65,A50,083695,Staff,0,7,30,30
1651080296603,ECE 109,A01,091882,Touri; Behrouz,33,0,70,37
1651080302628,ECE 180,A00,083140,Abi Samra; Nicholas Camill,17,0,30,13
1651080302628,ECE 180,B00,083141,Abi Samra; Nicholas Camill,0,0,30,30
1651080308655,MATH 10A,A01,083735,Patchell; Gregory David,0,0,30,30
1651080308655,MATH 10A,A02,083736,Patchell; Gregory David,27,0,30,3
1651080308655,MATH 10A,A03,083737,Patchell; Gregory David,22,0,30,8
1651080314679,MATH 10B,A01,083207,Staff,0,7,30,30
1651080314679,MATH 10B,A02,083208,Staff,0,6,30,30
1651080314679,MATH 10B,B01,083739,Staff,8,0,30,22
1651080314679,MATH 10B,B02,083740,Staff,28,0,30,2
1651080320711,MATH 18,A01,083743,Staff,0,0,30,30
1651080320711,MATH 18,A02,083744,Staff,23,0,30,7
1651080320711,MATH 18,A03,083745,Staff,18,0,30,12
1651080320711,MATH 18,A04,083746,Staff,26,0,30,4
1651080320711,MATH 18,B01,083748,Staff,0,16,30,30
1651080320711,MATH 18,B02,083749,Staff,0,14,30,30
1651080320711,MATH 18,B03,083750,Staff,0,14,30,30
1651080320711,MATH 18,B04,083751,Staff,0,13,30,30
1651080326738,MATH 20A,A01,083754,Staff,18,0,40,22
1651080332770,MATH 20B,A01,083756,Staff,0,14,30,30
1651080332770,MATH 20B,A02,083757,Staff,0,11,30,30
1651080338798,MATH 20C,A01,083760,Staff,0,16,30,30
1651080338798,MATH 20C,A02,083761,Staff,0,15,30,30
1651080338798,MATH 20C,B01,083762,Staff,7,0,30,23
1651080338798,MATH 20C,B02,083763,Staff,27,0,30,3
1651080344821,MATH 20D,A01,083765,Staff,3,1,30,27
1651080344821,MATH 20D,A02,083766,Staff,1,0,30,29
1651080344821,MATH 20D,A03,083767,Staff,22,0,30,8
1651080350848,MATH 20E,A01,083771,Staff,2,0,30,28
1651080350848,MATH 20E,A02,083772,Staff,10,0,30,20
1651080350848,MATH 20E,B01,083773,Staff,0,0,30,30
1651080350848,MATH 20E,B02,083774,Staff,0,0,30,30
1651080356872,MATH 103A,A01,083777,Staff,0,17,30,30
1651080356872,MATH 103A,A02,083778,Staff,0,16,30,30
1651080356872,MATH 103A,B01,083779,Staff,0,15,30,30
1651080356872,MATH 103A,B02,083780,Staff,0,14,30,30
1651080362898,MATH 105,A01,085443,Staff,0,23,30,30
1651080368931,MATH 109,A01,083213,Anzaldo; Leesa B,0,7,30,30
1651080368931,MATH 109,A02,083214,Anzaldo; Leesa B,0,7,30,30
1651080368931,MATH 109,B01,083215,Anzaldo; Leesa B,0,8,30,30
1651080368931,MATH 109,B02,083216,Anzaldo; Leesa B,0,8,30,30
1651080374956,MATH 142A,A01,083219,Chow; Bennett,0,15,30,30
1651080374956,MATH 142A,A02,083220,Chow; Bennett,0,15,30,30
1651080374956,MATH 142A,B01,083221,Chow; Bennett,0,16,30,30
1651080374956,MATH 142A,B02,083222,Chow; Bennett,0,15,30,30
1651080380986,MATH 193A,A01,083224,Staff,0,9,30,30
1651080380986,MATH 193A,A02,083225,Staff,0,7,30,30
1651080380986,MATH 193A,A03,083781,Staff,0,7,30,30
1651080380986,MATH 193A,A04,083782,Staff,0,7,30,30
1651080387011,MATH 197,001,091859,McAuley; Julian John,9998,0,9999,1
1651080393067,COGS 9,A01,083615,Staff,0,20,60,60
1651080399107,COGS 11,A01,083617,Boyle; Mary E. T.,13,0,40,27
1651080405142,COGS 13,A01,083071,Staff,0,39,40,40
1651080411188,COGS 14A,A01,092681,Staff,0,39,100,100
1651080417213,COGS 14B,A01,083073,Cheng; Tzu-Han,0,14,50,50
1651080423246,COGS 17,A01,092677,Staff,9,0,75,66
1651080429276,COGS 100,A01,083619,Staff,0,30,60,60
1651080435313,COGS 101A,A01,083621,Davis; Joshua Daniel,0,29,60,60
1651080441339,COGS 101B,A01,091572,Staff,0,8,60,60
1651080447368,COGS 101C,A01,083625,Delgado; Tania,13,0,30,17
1651080453393,COGS 107A,A01,083627,Boyle; Mary E. T.,0,17,60,60
1651080459419,COGS 118A,A01,083075,Staff,0,10,60,60
1651080465447,CSE 3,A50,083646,Miranda; Gregory Joseph,15,0,38,23
1651080465447,CSE 3,A51,083647,Miranda; Gregory Joseph,36,0,37,1
1651080471482,CSE 8A,A50,083650,Miranda; Gregory Joseph,0,31,40,40
1651080477508,CSE 11,A01,083080,Cao; Yingjun,1,98,40,39
1651080483532,CSE 12,A01,083652,Staff,0,27,100,100
1651080489554,CSE 15L,A01,083654,Staff,0,3,50,50
1651080489554,CSE 15L,A02,083655,Staff,0,3,50,50
1651080495582,CSE 20,A01,083657,Staff,46,0,80,34
1651080501606,CSE 30,A01,083084,Eldon; John,0,38,80,80
1651080507637,CSE 100,A01,083659,Cao; Yingjun,0,72,50,50
1651080513661,CSE 134B,A01,083661,Powell; Thomas Allan,0,38,65,65
1651080519697,CSE 140,A01,083663,Staff,0,15,75,75
1651080525725,CSE 140L,A01,083088,Eldon; John,3,0,100,97
1651080531756,CSE 175,A01,083665,Kumar; Rakesh,0,0,25,25
1651080537778,CSE 190,A00,092507,Dubnov; Shlomo,9,0,20,11
1651080543817,ECE 45,A01,083139,Staff,0,7,60,60
1651080549843,ECE 65,A50,083695,Staff,0,7,30,30
1651080555875,ECE 109,A01,091882,Touri; Behrouz,33,0,70,37
1651080561901,ECE 180,A00,083140,Abi Samra; Nicholas Camill,17,0,30,13
1651080561901,ECE 180,B00,083141,Abi Samra; Nicholas Camill,0,0,30,30
1651080567925,MATH 10A,A01,083735,Patchell; Gregory David,0,0,30,30
1651080567925,MATH 10A,A02,083736,Patchell; Gregory David,27,0,30,3
1651080567925,MATH 10A,A03,083737,Patchell; Gregory David,22,0,30,8
1651080573957,MATH 10B,A01,083207,Staff,0,7,30,30
1651080573957,MATH 10B,A02,083208,Staff,0,6,30,30
1651080573957,MATH 10B,B01,083739,Staff,8,0,30,22
1651080573957,MATH 10B,B02,083740,Staff,28,0,30,2
1651080579988,MATH 18,A01,083743,Staff,0,0,30,30
1651080579988,MATH 18,A02,083744,Staff,23,0,30,7
1651080579988,MATH 18,A03,083745,Staff,19,0,30,11
1651080579988,MATH 18,A04,083746,Staff,26,0,30,4
1651080579988,MATH 18,B01,083748,Staff,0,16,30,30
1651080579988,MATH 18,B02,083749,Staff,0,14,30,30
1651080579988,MATH 18,B03,083750,Staff,0,14,30,30
1651080579988,MATH 18,B04,083751,Staff,0,13,30,30
1651080586022,MATH 20A,A01,083754,Staff,18,0,40,22
1651080592049,MATH 20B,A01,083756,Staff,0,14,30,30
1651080592049,MATH 20B,A02,083757,Staff,0,11,30,30
1651080598072,MATH 20C,A01,083760,Staff,0,16,30,30
1651080598072,MATH 20C,A02,083761,Staff,0,15,30,30
1651080598072,MATH 20C,B01,083762,Staff,7,0,30,23
1651080598072,MATH 20C,B02,083763,Staff,27,0,30,3
1651080604099,MATH 20D,A01,083765,Staff,3,1,30,27
1651080604099,MATH 20D,A02,083766,Staff,1,0,30,29
1651080604099,MATH 20D,A03,083767,Staff,22,0,30,8
1651080610126,MATH 20E,A01,083771,Staff,2,0,30,28
1651080610126,MATH 20E,A02,083772,Staff,10,0,30,20
1651080610126,MATH 20E,B01,083773,Staff,0,0,30,30
1651080610126,MATH 20E,B02,083774,Staff,0,0,30,30
1651080616155,MATH 103A,A01,083777,Staff,0,17,30,30
1651080616155,MATH 103A,A02,083778,Staff,0,16,30,30
1651080616155,MATH 103A,B01,083779,Staff,0,15,30,30
1651080616155,MATH 103A,B02,083780,Staff,0,14,30,30
1651080622178,MATH 105,A01,085443,Staff,0,23,30,30
1651080628213,MATH 109,A01,083213,Anzaldo; Leesa B,0,7,30,30
1651080628213,MATH 109,A02,083214,Anzaldo; Leesa B,0,7,30,30
1651080628213,MATH 109,B01,083215,Anzaldo; Leesa B,0,8,30,30
1651080628213,MATH 109,B02,083216,Anzaldo; Leesa B,0,8,30,30
1651080634235,MATH 142A,A01,083219,Chow; Bennett,0,15,30,30
1651080634235,MATH 142A,A02,083220,Chow; Bennett,0,15,30,30
1651080634235,MATH 142A,B01,083221,Chow; Bennett,0,16,30,30
1651080634235,MATH 142A,B02,083222,Chow; Bennett,0,15,30,30
1651080640257,MATH 193A,A01,083224,Staff,0,9,30,30
1651080640257,MATH 193A,A02,083225,Staff,0,7,30,30
1651080640257,MATH 193A,A03,083781,Staff,0,7,30,30
1651080640257,MATH 193A,A04,083782,Staff,0,7,30,30
1651080646280,MATH 197,001,091859,McAuley; Julian John,9998,0,9999,1
1651080652337,COGS 9,A01,083615,Staff,0,20,60,60
1651080658359,COGS 11,A01,083617,Boyle; Mary E. T.,13,0,40,27
1651080664381,COGS 13,A01,083071,Staff,0,39,40,40
1651080670414,COGS 14A,A01,092681,Staff,0,39,100,100
1651080676452,COGS 14B,A01,083073,Cheng; Tzu-Han,0,13,50,50
1651080682475,COGS 17,A01,092677,Staff,9,0,75,66
1651080688515,COGS 100,A01,083619,Staff,0,30,60,60
1651080694536,COGS 101A,A01,083621,Davis; Joshua Daniel,0,29,60,60
1651080700569,COGS 101B,A01,091572,Staff,0,8,60,60
1651080706598,COGS 101C,A01,083625,Delgado; Tania,13,0,30,17
1651080712619,COGS 107A,A01,083627,Boyle; Mary E. T.,0,17,60,60
1651080718645,COGS 118A,A01,083075,Staff,0,10,60,60
1651080724667,CSE 3,A50,083646,Miranda; Gregory Joseph,15,0,38,23
1651080724667,CSE 3,A51,083647,Miranda; Gregory Joseph,36,0,37,1
1651080730692,CSE 8A,A50,083650,Miranda; Gregory Joseph,0,31,40,40
1651080736731,CSE 11,A01,083080,Cao; Yingjun,1,98,40,39
1651080742768,CSE 12,A01,083652,Staff,0,27,100,100
1651080748797,CSE 15L,A01,083654,Staff,0,3,50,50
1651080748797,CSE 15L,A02,083655,Staff,0,3,50,50
1651080754821,CSE 20,A01,083657,Staff,46,0,80,34
1651080760864,CSE 30,A01,083084,Eldon; John,0,38,80,80
1651080766886,CSE 100,A01,083659,Cao; Yingjun,0,72,50,50
1651080772919,CSE 134B,A01,083661,Powell; Thomas Allan,0,38,65,65
1651080778942,CSE 140,A01,083663,Staff,0,15,75,75
1651080784974,CSE 140L,A01,083088,Eldon; John,3,0,100,97
1651080790997,CSE 175,A01,083665,Kumar; Rakesh,0,0,25,25
1651080797024,CSE 190,A00,092507,Dubnov; Shlomo,9,0,20,11
1651080803046,ECE 45,A01,083139,Staff,0,7,60,60
1651080809072,ECE 65,A50,083695,Staff,0,7,30,30
1651080815101,ECE 109,A01,091882,Touri; Behrouz,33,0,70,37
1651080821123,ECE 180,A00,083140,Abi Samra; Nicholas Camill,17,0,30,13
1651080821123,ECE 180,B00,083141,Abi Samra; Nicholas Camill,0,0,30,30
1651080827146,MATH 10A,A01,083735,Patchell; Gregory David,0,0,30,30
1651080827146,MATH 10A,A02,083736,Patchell; Gregory David,27,0,30,3
1651080827146,MATH 10A,A03,083737,Patchell; Gregory David,22,0,30,8
1651080833174,MATH 10B,A01,083207,Staff,0,7,30,30
1651080833174,MATH 10B,A02,083208,Staff,0,6,30,30
1651080833174,MATH 10B,B01,083739,Staff,8,0,30,22
1651080833174,MATH 10B,B02,083740,Staff,28,0,30,2
1651080839204,MATH 18,A01,083743,Staff,0,0,30,30
1651080839204,MATH 18,A02,083744,Staff,23,0,30,7
1651080839204,MATH 18,A03,083745,Staff,19,0,30,11
1651080839204,MATH 18,A04,083746,Staff,26,0,30,4
1651080839204,MATH 18,B01,083748,Staff,0,16,30,30
1651080839204,MATH 18,B02,083749,Staff,0,14,30,30
1651080839204,MATH 18,B03,083750,Staff,0,14,30,30
1651080839204,MATH 18,B04,083751,Staff,0,13,30,30
1651080845231,MATH 20A,A01,083754,Staff,18,0,40,22
1651080851258,MATH 20B,A01,083756,Staff,0,14,30,30
1651080851258,MATH 20B,A02,083757,Staff,0,11,30,30
1651080857289,MATH 20C,A01,083760,Staff,0,16,30,30
1651080857289,MATH 20C,A02,083761,Staff,0,15,30,30
1651080857289,MATH 20C,B01,083762,Staff,7,0,30,23
1651080857289,MATH 20C,B02,083763,Staff,27,0,30,3
1651080863313,MATH 20D,A01,083765,Staff,3,1,30,27
1651080863313,MATH 20D,A02,083766,Staff,1,0,30,29
1651080863313,MATH 20D,A03,083767,Staff,22,0,30,8
1651080869339,MATH 20E,A01,083771,Staff,2,0,30,28
1651080869339,MATH 20E,A02,083772,Staff,10,0,30,20
1651080869339,MATH 20E,B01,083773,Staff,0,0,30,30
1651080869339,MATH 20E,B02,083774,Staff,0,0,30,30
1651080875458,MATH 103A,A01,083777,Staff,0,17,30,30
1651080875458,MATH 103A,A02,083778,Staff,0,16,30,30
1651080875458,MATH 103A,B01,083779,Staff,0,15,30,30
1651080875458,MATH 103A,B02,083780,Staff,0,14,30,30
1651080881480,MATH 105,A01,085443,Staff,0,23,30,30
1651080887513,MATH 109,A01,083213,Anzaldo; Leesa B,0,7,30,30
1651080887513,MATH 109,A02,083214,Anzaldo; Leesa B,0,7,30,30
1651080887513,MATH 109,B01,083215,Anzaldo; Leesa B,0,8,30,30
1651080887513,MATH 109,B02,083216,Anzaldo; Leesa B,0,8,30,30
1651080893539,MATH 142A,A01,083219,Chow; Bennett,0,15,30,30
1651080893539,MATH 142A,A02,083220,Chow; Bennett,0,15,30,30
1651080893539,MATH 142A,B01,083221,Chow; Bennett,0,16,30,30
1651080893539,MATH 142A,B02,083222,Chow; Bennett,0,15,30,30
1651080899577,MATH 193A,A01,083224,Staff,0,9,30,30
1651080899577,MATH 193A,A02,083225,Staff,0,7,30,30
1651080899577,MATH 193A,A03,083781,Staff,0,7,30,30
1651080899577,MATH 193A,A04,083782,Staff,0,7,30,30
1651080905601,MATH 197,001,091859,McAuley; Julian John,9998,0,9999,1
1651080911660,COGS 9,A01,083615,Staff,0,20,60,60
1651080917683,COGS 11,A01,083617,Boyle; Mary E. T.,13,0,40,27
1651080923722,COGS 13,A01,083071,Staff,0,39,40,40
1651080929744,COGS 14A,A01,092681,Staff,0,39,100,100
1651080935771,COGS 14B,A01,083073,Cheng; Tzu-Han,0,13,50,50
1651080941797,COGS 17,A01,092677,Staff,9,0,75,66
1651080947821,COGS 100,A01,083619,Staff,0,30,60,60
1651080953847,COGS 101A,A01,083621,Davis; Joshua Daniel,0,29,60,60
1651080959872,COGS 101B,A01,091572,Staff,0,8,60,60
1651080965910,COGS 101C,A01,083625,Delgado; Tania,13,0,30,17
1651080971935,COGS 107A,A01,083627,Boyle; Mary E. T.,0,17,60,60
1651080977963,COGS 118A,A01,083075,Staff,0,10,60,60
1651080983987,CSE 3,A50,083646,Miranda; Gregory Joseph,15,0,38,23
1651080983987,CSE 3,A51,083647,Miranda; Gregory Joseph,36,0,37,1
1651080990009,CSE 8A,A50,083650,Miranda; Gregory Joseph,0,31,40,40
1651080996040,CSE 11,A01,083080,Cao; Yingjun,1,98,40,39
1651081002065,CSE 12,A01,083652,Staff,0,27,100,100
1651081008095,CSE 15L,A01,083654,Staff,0,3,50,50
1651081008095,CSE 15L,A02,083655,Staff,0,3,50,50
1651081014122,CSE 20,A01,083657,Staff,46,0,80,34
1651081020150,CSE 30,A01,083084,Eldon; John,0,38,80,80
1651081026183,CSE 100,A01,083659,Cao; Yingjun,0,72,50,50
1651081032211,CSE 134B,A01,083661,Powell; Thomas Allan,0,38,65,65
1651081038236,CSE 140,A01,083663,Staff,0,15,75,75
1651081044262,CSE 140L,A01,083088,Eldon; John,3,0,100,97
1651081050288,CSE 175,A01,083665,Kumar; Rakesh,0,0,25,25
1651081056308,CSE 190,A00,092507,Dubnov; Shlomo,9,0,20,11
1651081062332,ECE 45,A01,083139,Staff,0,7,60,60
1651081068363,ECE 65,A50,083695,Staff,0,7,30,30
1651081074389,ECE 109,A01,091882,Touri; Behrouz,33,0,70,37
1651081080416,ECE 180,A00,083140,Abi Samra; Nicholas Camill,17,0,30,13
1651081080416,ECE 180,B00,083141,Abi Samra; Nicholas Camill,0,0,30,30
1651081086440,MATH 10A,A01,083735,Patchell; Gregory David,0,0,30,30
1651081086440,MATH 10A,A02,083736,Patchell; Gregory David,27,0,30,3
1651081086440,MATH 10A,A03,083737,Patchell; Gregory David,22,0,30,8
1651081092462,MATH 10B,A01,083207,Staff,0,7,30,30
1651081092462,MATH 10B,A02,083208,Staff,0,6,30,30
1651081092462,MATH 10B,B01,083739,Staff,8,0,30,22
1651081092462,MATH 10B,B02,083740,Staff,28,0,30,2
1651081098497,MATH 18,A01,083743,Staff,0,0,30,30
1651081098497,MATH 18,A02,083744,Staff,23,0,30,7
1651081098497,MATH 18,A03,083745,Staff,19,0,30,11
1651081098497,MATH 18,A04,083746,Staff,26,0,30,4
1651081098497,MATH 18,B01,083748,Staff,0,16,30,30
1651081098497,MATH 18,B02,083749,Staff,0,14,30,30
1651081098497,MATH 18,B03,083750,Staff,0,14,30,30
1651081098497,MATH 18,B04,083751,Staff,0,13,30,30
1651081104525,MATH 20A,A01,083754,Staff,18,0,40,22
1651081110548,MATH 20B,A01,083756,Staff,0,14,30,30
1651081110548,MATH 20B,A02,083757,Staff,0,11,30,30
1651081116582,MATH 20C,A01,083760,Staff,0,16,30,30
1651081116582,MATH 20C,A02,083761,Staff,0,15,30,30
1651081116582,MATH 20C,B01,083762,Staff,7,0,30,23
1651081116582,MATH 20C,B02,083763,Staff,27,0,30,3
1651081122611,MATH 20D,A01,083765,Staff,3,1,30,27
1651081122611,MATH 20D,A02,083766,Staff,1,0,30,29
1651081122611,MATH 20D,A03,083767,Staff,22,0,30,8
1651081128635,MATH 20E,A01,083771,Staff,2,0,30,28
1651081128635,MATH 20E,A02,083772,Staff,10,0,30,20
1651081128635,MATH 20E,B01,083773,Staff,0,0,30,30
1651081128635,MATH 20E,B02,083774,Staff,0,0,30,30
1651081134666,MATH 103A,A01,083777,Staff,0,17,30,30
1651081134666,MATH 103A,A02,083778,Staff,0,16,30,30
1651081134666,MATH 103A,B01,083779,Staff,0,15,30,30
1651081134666,MATH 103A,B02,083780,Staff,0,14,30,30
1651081140693,MATH 105,A01,085443,Staff,0,23,30,30
1651081146722,MATH 109,A01,083213,Anzaldo; Leesa B,0,7,30,30
1651081146722,MATH 109,A02,083214,Anzaldo; Leesa B,0,7,30,30
1651081146722,MATH 109,B01,083215,Anzaldo; Leesa B,0,8,30,30
1651081146722,MATH 109,B02,083216,Anzaldo; Leesa B,0,8,30,30
1651081152751,MATH 142A,A01,083219,Chow; Bennett,0,15,30,30
1651081152751,MATH 142A,A02,083220,Chow; Bennett,0,15,30,30
1651081152751,MATH 142A,B01,083221,Chow; Bennett,0,16,30,30
1651081152751,MATH 142A,B02,083222,Chow; Bennett,0,15,30,30
1651081158775,MATH 193A,A01,083224,Staff,0,9,30,30
1651081158775,MATH 193A,A02,083225,Staff,0,7,30,30
1651081158775,MATH 193A,A03,083781,Staff,0,7,30,30
1651081158775,MATH 193A,A04,083782,Staff,0,7,30,30
1651081164797,MATH 197,001,091859,McAuley; Julian John,9998,0,9999,1
1651081170887,COGS 9,A01,083615,Staff,0,20,60,60
1651081176920,COGS 11,A01,083617,Boyle; Mary E. T.,13,0,40,27
1651081182943,COGS 13,A01,083071,Staff,0,39,40,40
1651081188966,COGS 14A,A01,092681,Staff,0,39,100,100
1651081194995,COGS 14B,A01,083073,Cheng; Tzu-Han,0,13,50,50
1651081201024,COGS 17,A01,092677,Staff,9,0,75,66
1651081207049,COGS 100,A01,083619,Staff,0,30,60,60
1651081213085,COGS 101A,A01,083621,Davis; Joshua Daniel,0,29,60,60
1651081219115,COGS 101B,A01,091572,Staff,0,8,60,60
1651081225138,COGS 101C,A01,083625,Delgado; Tania,13,0,30,17
1651081231164,COGS 107A,A01,083627,Boyle; Mary E. T.,0,17,60,60
1651081237190,COGS 118A,A01,083075,Staff,0,10,60,60
1651081243217,CSE 3,A50,083646,Miranda; Gregory Joseph,15,0,38,23
1651081243217,CSE 3,A51,083647,Miranda; Gregory Joseph,36,0,37,1
1651081249247,CSE 8A,A50,083650,Miranda; Gregory Joseph,0,31,40,40
1651081255278,CSE 11,A01,083080,Cao; Yingjun,1,98,40,39
1651081261303,CSE 12,A01,083652,Staff,0,27,100,100
1651081267346,CSE 15L,A01,083654,Staff,0,3,50,50
1651081267346,CSE 15L,A02,083655,Staff,0,3,50,50
1651081273371,CSE 20,A01,083657,Staff,46,0,80,34
1651081279397,CSE 30,A01,083084,Eldon; John,0,38,80,80
1651081285431,CSE 100,A01,083659,Cao; Yingjun,0,72,50,50
1651081291458,CSE 134B,A01,083661,Powell; Thomas Allan,0,38,65,65
1651081297483,CSE 140,A01,083663,Staff,0,15,75,75
1651081303508,CSE 140L,A01,083088,Eldon; John,3,0,100,97
1651081309531,CSE 175,A01,083665,Kumar; Rakesh,0,0,25,25
1651081315558,CSE 190,A00,092507,Dubnov; Shlomo,9,0,20,11
1651081321585,ECE 45,A01,083139,Staff,0,7,60,60
1651081327609,ECE 65,A50,083695,Staff,0,7,30,30
1651081333647,ECE 109,A01,091882,Touri; Behrouz,33,0,70,37
1651081339677,ECE 180,A00,083140,Abi Samra; Nicholas Camill,17,0,30,13
1651081339677,ECE 180,B00,083141,Abi Samra; Nicholas Camill,0,0,30,30
1651081345701,MATH 10A,A01,083735,Patchell; Gregory David,0,0,30,30
1651081345701,MATH 10A,A02,083736,Patchell; Gregory David,27,0,30,3
1651081345701,MATH 10A,A03,083737,Patchell; Gregory David,22,0,30,8
1651081351731,MATH 10B,A01,083207,Staff,0,7,30,30
1651081351731,MATH 10B,A02,083208,Staff,0,6,30,30
1651081351731,MATH 10B,B01,083739,Staff,8,0,30,22
1651081351731,MATH 10B,B02,083740,Staff,28,0,30,2
1651081357756,MATH 18,A01,083743,Staff,0,0,30,30
1651081357756,MATH 18,A02,083744,Staff,23,0,30,7
1651081357756,MATH 18,A03,083745,Staff,19,0,30,11
1651081357756,MATH 18,A04,083746,Staff,26,0,30,4
1651081357756,MATH 18,B01,083748,Staff,0,16,30,30
1651081357756,MATH 18,B02,083749,Staff,0,14,30,30
1651081357756,MATH 18,B03,083750,Staff,0,14,30,30
1651081357756,MATH 18,B04,083751,Staff,0,13,30,30
1651081363778,MATH 20A,A01,083754,Staff,18,0,40,22
1651081369799,MATH 20B,A01,083756,Staff,0,14,30,30
1651081369799,MATH 20B,A02,083757,Staff,0,11,30,30
1651081375829,MATH 20C,A01,083760,Staff,0,16,30,30
1651081375829,MATH 20C,A02,083761,Staff,0,15,30,30
1651081375829,MATH 20C,B01,083762,Staff,7,0,30,23
1651081375829,MATH 20C,B02,083763,Staff,27,0,30,3
1651081381853,MATH 20D,A01,083765,Staff,3,1,30,27
1651081381853,MATH 20D,A02,083766,Staff,1,0,30,29
1651081381853,MATH 20D,A03,083767,Staff,22,0,30,8
1651081387878,MATH 20E,A01,083771,Staff,2,0,30,28
1651081387878,MATH 20E,A02,083772,Staff,10,0,30,20
1651081387878,MATH 20E,B01,083773,Staff,0,0,30,30
1651081387878,MATH 20E,B02,083774,Staff,0,0,30,30
1651081393902,MATH 103A,A01,083777,Staff,0,17,30,30
1651081393902,MATH 103A,A02,083778,Staff,0,16,30,30
1651081393902,MATH 103A,B01,083779,Staff,0,15,30,30
1651081393902,MATH 103A,B02,083780,Staff,0,14,30,30
1651081399926,MATH 105,A01,085443,Staff,0,23,30,30
1651081405957,MATH 109,A01,083213,Anzaldo; Leesa B,0,7,30,30
1651081405957,MATH 109,A02,083214,Anzaldo; Leesa B,0,7,30,30
1651081405957,MATH 109,B01,083215,Anzaldo; Leesa B,0,8,30,30
1651081405957,MATH 109,B02,083216,Anzaldo; Leesa B,0,8,30,30
1651081411986,MATH 142A,A01,083219,Chow; Bennett,0,15,30,30
1651081411986,MATH 142A,A02,083220,Chow; Bennett,0,15,30,30
1651081411986,MATH 142A,B01,083221,Chow; Bennett,0,16,30,30
1651081411986,MATH 142A,B02,083222,Chow; Bennett,0,15,30,30
1651081418009,MATH 193A,A01,083224,Staff,0,9,30,30
1651081418009,MATH 193A,A02,083225,Staff,0,7,30,30
1651081418009,MATH 193A,A03,083781,Staff,0,7,30,30
1651081418009,MATH 193A,A04,083782,Staff,0,7,30,30
1651081424035,MATH 197,001,091859,McAuley; Julian John,9998,0,9999,1
1651081430085,COGS 9,A01,083615,Staff,0,20,60,60
1651081436108,COGS 11,A01,083617,Boyle; Mary E. T.,13,0,40,27
1651081442135,COGS 13,A01,083071,Staff,0,39,40,40
1651081448160,COGS 14A,A01,092681,Staff,0,39,100,100
1651081454185,COGS 14B,A01,083073,Cheng; Tzu-Han,0,13,50,50
1651081460216,COGS 17,A01,092677,Staff,9,0,75,66
1651081466318,COGS 100,A01,083619,Staff,0,30,60,60
1651081472349,COGS 101A,A01,083621,Davis; Joshua Daniel,0,29,60,60
1651081478386,COGS 101B,A01,091572,Staff,0,8,60,60
1651081484408,COGS 101C,A01,083625,Delgado; Tania,13,0,30,17
1651081490430,COGS 107A,A01,083627,Boyle; Mary E. T.,0,17,60,60
1651081496462,COGS 118A,A01,083075,Staff,0,10,60,60
1651081502483,CSE 3,A50,083646,Miranda; Gregory Joseph,15,0,38,23
1651081502483,CSE 3,A51,083647,Miranda; Gregory Joseph,36,0,37,1
1651081508507,CSE 8A,A50,083650,Miranda; Gregory Joseph,0,31,40,40
1651081514533,CSE 11,A01,083080,Cao; Yingjun,1,98,40,39
1651081520558,CSE 12,A01,083652,Staff,0,27,100,100
1651081526588,CSE 15L,A01,083654,Staff,0,3,50,50
1651081526588,CSE 15L,A02,083655,Staff,0,3,50,50
1651081532614,CSE 20,A01,083657,Staff,46,0,80,34
1651081538635,CSE 30,A01,083084,Eldon; John,0,38,80,80
1651081544659,CSE 100,A01,083659,Cao; Yingjun,0,72,50,50
1651081550692,CSE 134B,A01,083661,Powell; Thomas Allan,0,38,65,65
1651081556717,CSE 140,A01,083663,Staff,0,15,75,75
1651081562741,CSE 140L,A01,083088,Eldon; John,3,0,100,97
1651081568765,CSE 175,A01,083665,Kumar; Rakesh,0,0,25,25
1651081574792,CSE 190,A00,092507,Dubnov; Shlomo,9,0,20,11
1651081580824,ECE 45,A01,083139,Staff,0,7,60,60
1651081586856,ECE 65,A50,083695,Staff,0,7,30,30
1651081592890,ECE 109,A01,091882,Touri; Behrouz,33,0,70,37
1651081598916,ECE 180,A00,083140,Abi Samra; Nicholas Camill,17,0,30,13
1651081598916,ECE 180,B00,083141,Abi Samra; Nicholas Camill,0,0,30,30
1651081604944,MATH 10A,A01,083735,Patchell; Gregory David,0,0,30,30
1651081604944,MATH 10A,A02,083736,Patchell; Gregory David,27,0,30,3
1651081604944,MATH 10A,A03,083737,Patchell; Gregory David,22,0,30,8
1651081610984,MATH 10B,A01,083207,Staff,0,7,30,30
1651081610984,MATH 10B,A02,083208,Staff,0,6,30,30
1651081610984,MATH 10B,B01,083739,Staff,8,0,30,22
1651081610984,MATH 10B,B02,083740,Staff,28,0,30,2
1651081617021,MATH 18,A01,083743,Staff,0,0,30,30
1651081617021,MATH 18,A02,083744,Staff,23,0,30,7
1651081617021,MATH 18,A03,083745,Staff,19,0,30,11
1651081617021,MATH 18,A04,083746,Staff,26,0,30,4
1651081617021,MATH 18,B01,083748,Staff,0,16,30,30
1651081617021,MATH 18,B02,083749,Staff,0,14,30,30
1651081617021,MATH 18,B03,083750,Staff,0,14,30,30
1651081617021,MATH 18,B04,083751,Staff,0,13,30,30
1651081623050,MATH 20A,A01,083754,Staff,18,0,40,22
1651081629078,MATH 20B,A01,083756,Staff,0,14,30,30
1651081629078,MATH 20B,A02,083757,Staff,0,11,30,30
1651081635105,MATH 20C,A01,083760,Staff,0,16,30,30
1651081635105,MATH 20C,A02,083761,Staff,0,15,30,30
1651081635105,MATH 20C,B01,083762,Staff,7,0,30,23
1651081635105,MATH 20C,B02,083763,Staff,27,0,30,3
1651081641131,MATH 20D,A01,083765,Staff,3,1,30,27
1651081641131,MATH 20D,A02,083766,Staff,1,0,30,29
1651081641131,MATH 20D,A03,083767,Staff,22,0,30,8
1651081647156,MATH 20E,A01,083771,Staff,2,0,30,28
1651081647156,MATH 20E,A02,083772,Staff,10,0,30,20
1651081647156,MATH 20E,B01,083773,Staff,0,0,30,30
1651081647156,MATH 20E,B02,083774,Staff,0,0,30,30
1651081653182,MATH 103A,A01,083777,Staff,0,17,30,30
1651081653182,MATH 103A,A02,083778,Staff,0,16,30,30
1651081653182,MATH 103A,B01,083779,Staff,0,15,30,30
1651081653182,MATH 103A,B02,083780,Staff,0,14,30,30
1651081659209,MATH 105,A01,085443,Staff,0,23,30,30
1651081665236,MATH 109,A01,083213,Anzaldo; Leesa B,0,7,30,30
1651081665236,MATH 109,A02,083214,Anzaldo; Leesa B,0,7,30,30
1651081665236,MATH 109,B01,083215,Anzaldo; Leesa B,0,8,30,30
1651081665236,MATH 109,B02,083216,Anzaldo; Leesa B,0,8,30,30
1651081671261,MATH 142A,A01,083219,Chow; Bennett,0,15,30,30
1651081671261,MATH 142A,A02,083220,Chow; Bennett,0,15,30,30
1651081671261,MATH 142A,B01,083221,Chow; Bennett,0,16,30,30
1651081671261,MATH 142A,B02,083222,Chow; Bennett,0,15,30,30
1651081677289,MATH 193A,A01,083224,Staff,0,9,30,30
1651081677289,MATH 193A,A02,083225,Staff,0,7,30,30
1651081677289,MATH 193A,A03,083781,Staff,0,7,30,30
1651081677289,MATH 193A,A04,083782,Staff,0,7,30,30
1651081683318,MATH 197,001,091859,McAuley; Julian John,9998,0,9999,1
1651081689376,COGS 9,A01,083615,Staff,0,20,60,60
1651081695399,COGS 11,A01,083617,Boyle; Mary E. T.,13,0,40,27
1651081701432,COGS 13,A01,083071,Staff,0,39,40,40
1651081707473,COGS 14A,A01,092681,Staff,0,39,100,100
1651081713510,COGS 14B,A01,083073,Cheng; Tzu-Han,0,13,50,50
1651081719532,COGS 17,A01,092677,Staff,9,0,75,66
1651081725560,COGS 100,A01,083619,Staff,0,30,60,60
1651081731583,COGS 101A,A01,083621,Davis; Joshua Daniel,0,29,60,60
1651081737609,COGS 101B,A01,091572,Staff,0,8,60,60
1651081743632,COGS 101C,A01,083625,Delgado; Tania,13,0,30,17
1651081749666,COGS 107A,A01,083627,Boyle; Mary E. T.,0,17,60,60
1651081755692,COGS 118A,A01,083075,Staff,0,10,60,60
1651081761724,CSE 3,A50,083646,Miranda; Gregory Joseph,15,0,38,23
1651081761724,CSE 3,A51,083647,Miranda; Gregory Joseph,36,0,37,1
1651081767748,CSE 8A,A50,083650,Miranda; Gregory Joseph,0,31,40,40
1651081773771,CSE 11,A01,083080,Cao; Yingjun,1,98,40,39
1651081779796,CSE 12,A01,083652,Staff,0,27,100,100
1651081785823,CSE 15L,A01,083654,Staff,0,3,50,50
1651081785823,CSE 15L,A02,083655,Staff,0,3,50,50
1651081791855,CSE 20,A01,083657,Staff,46,0,80,34
1651081797897,CSE 30,A01,083084,Eldon; John,0,38,80,80
1651081803921,CSE 100,A01,083659,Cao; Yingjun,0,72,50,50
1651081809953,CSE 134B,A01,083661,Powell; Thomas Allan,0,38,65,65
1651081815979,CSE 140,A01,083663,Staff,0,15,75,75
1651081822015,CSE 140L,A01,083088,Eldon; John,3,0,100,97
1651081828041,CSE 175,A01,083665,Kumar; Rakesh,0,0,25,25
1651081834065,CSE 190,A00,092507,Dubnov; Shlomo,9,0,20,11
1651081840091,ECE 45,A01,083139,Staff,0,7,60,60
1651081846117,ECE 65,A50,083695,Staff,0,7,30,30
1651081852138,ECE 109,A01,091882,Touri; Behrouz,33,0,70,37
1651081858168,ECE 180,A00,083140,Abi Samra; Nicholas Camill,17,0,30,13
1651081858168,ECE 180,B00,083141,Abi Samra; Nicholas Camill,0,0,30,30
1651081864205,MATH 10A,A01,083735,Patchell; Gregory David,0,0,30,30
1651081864205,MATH 10A,A02,083736,Patchell; Gregory David,27,0,30,3
1651081864205,MATH 10A,A03,083737,Patchell; Gregory David,22,0,30,8
1651081870233,MATH 10B,A01,083207,Staff,0,7,30,30
1651081870233,MATH 10B,A02,083208,Staff,0,6,30,30
1651081870233,MATH 10B,B01,083739,Staff,8,0,30,22
1651081870233,MATH 10B,B02,083740,Staff,28,0,30,2
1651081876261,MATH 18,A01,083743,Staff,0,0,30,30
1651081876261,MATH 18,A02,083744,Staff,23,0,30,7
1651081876261,MATH 18,A03,083745,Staff,19,0,30,11
1651081876261,MATH 18,A04,083746,Staff,26,0,30,4
1651081876261,MATH 18,B01,083748,Staff,0,16,30,30
1651081876261,MATH 18,B02,083749,Staff,0,14,30,30
1651081876261,MATH 18,B03,083750,Staff,0,14,30,30
1651081876261,MATH 18,B04,083751,Staff,0,13,30,30
1651081882288,MATH 20A,A01,083754,Staff,18,0,40,22
1651081888315,MATH 20B,A01,083756,Staff,0,14,30,30
1651081888315,MATH 20B,A02,083757,Staff,0,11,30,30
1651081894339,MATH 20C,A01,083760,Staff,0,16,30,30
1651081894339,MATH 20C,A02,083761,Staff,0,15,30,30
1651081894339,MATH 20C,B01,083762,Staff,7,0,30,23
1651081894339,MATH 20C,B02,083763,Staff,27,0,30,3
1651081900361,MATH 20D,A01,083765,Staff,3,1,30,27
1651081900361,MATH 20D,A02,083766,Staff,1,0,30,29
1651081900361,MATH 20D,A03,083767,Staff,22,0,30,8
1651081906389,MATH 20E,A01,083771,Staff,2,0,30,28
1651081906389,MATH 20E,A02,083772,Staff,10,0,30,20
1651081906389,MATH 20E,B01,083773,Staff,0,0,30,30
1651081906389,MATH 20E,B02,083774,Staff,0,0,30,30
1651081912412,MATH 103A,A01,083777,Staff,0,17,30,30
1651081912412,MATH 103A,A02,083778,Staff,0,17,30,30
1651081912412,MATH 103A,B01,083779,Staff,0,15,30,30
1651081912412,MATH 103A,B02,083780,Staff,0,14,30,30
1651081918446,MATH 105,A01,085443,Staff,0,23,30,30
1651081924473,MATH 109,A01,083213,Anzaldo; Leesa B,0,7,30,30
1651081924473,MATH 109,A02,083214,Anzaldo; Leesa B,0,7,30,30
1651081924473,MATH 109,B01,083215,Anzaldo; Leesa B,0,8,30,30
1651081924473,MATH 109,B02,083216,Anzaldo; Leesa B,0,8,30,30
1651081930501,MATH 142A,A01,083219,Chow; Bennett,0,15,30,30
1651081930501,MATH 142A,A02,083220,Chow; Bennett,0,15,30,30
1651081930501,MATH 142A,B01,083221,Chow; Bennett,0,16,30,30
1651081930501,MATH 142A,B02,083222,Chow; Bennett,0,15,30,30
1651081936528,MATH 193A,A01,083224,Staff,0,9,30,30
1651081936528,MATH 193A,A02,083225,Staff,0,7,30,30
1651081936528,MATH 193A,A03,083781,Staff,0,7,30,30
1651081936528,MATH 193A,A04,083782,Staff,0,7,30,30
1651081942555,MATH 197,001,091859,McAuley; Julian John,9998,0,9999,1
1651081948618,COGS 9,A01,083615,Staff,0,20,60,60
1651081954642,COGS 11,A01,083617,Boyle; Mary E. T.,13,0,40,27
1651081960665,COGS 13,A01,083071,Staff,0,39,40,40
1651081966690,COGS 14A,A01,092681,Staff,0,39,100,100
1651081972712,COGS 14B,A01,083073,Cheng; Tzu-Han,0,13,50,50
1651081978744,COGS 17,A01,092677,Staff,9,0,75,66
1651081984783,COGS 100,A01,083619,Staff,0,30,60,60
1651081990809,COGS 101A,A01,083621,Davis; Joshua Daniel,0,29,60,60
1651081996834,COGS 101B,A01,091572,Staff,0,8,60,60
1651082002858,COGS 101C,A01,083625,Delgado; Tania,13,0,30,17
1651082008884,COGS 107A,A01,083627,Boyle; Mary E. T.,0,17,60,60
1651082014907,COGS 118A,A01,083075,Staff,0,10,60,60
1651082020930,CSE 3,A50,083646,Miranda; Gregory Joseph,15,0,38,23
1651082020930,CSE 3,A51,083647,Miranda; Gregory Joseph,36,0,37,1
1651082026952,CSE 8A,A50,083650,Miranda; Gregory Joseph,0,31,40,40
1651082032976,CSE 11,A01,083080,Cao; Yingjun,1,98,40,39
1651082039004,CSE 12,A01,083652,Staff,0,27,100,100
1651082045031,CSE 15L,A01,083654,Staff,0,3,50,50
1651082045031,CSE 15L,A02,083655,Staff,0,3,50,50
1651082051058,CSE 20,A01,083657,Staff,46,0,80,34
1651082057082,CSE 30,A01,083084,Eldon; John,0,38,80,80
1651082063189,CSE 100,A01,083659,Cao; Yingjun,0,72,50,50
1651082069217,CSE 134B,A01,083661,Powell; Thomas Allan,0,38,65,65
1651082075244,CSE 140,A01,083663,Staff,0,15,75,75
1651082081268,CSE 140L,A01,083088,Eldon; John,3,0,100,97
1651082087295,CSE 175,A01,083665,Kumar; Rakesh,0,0,25,25
1651082093328,CSE 190,A00,092507,Dubnov; Shlomo,9,0,20,11
1651082100353,ECE 45,A01,083139,Staff,0,7,60,60
1651082106412,ECE 65,A50,083695,Staff,0,7,30,30
1651082112435,ECE 109,A01,091882,Touri; Behrouz,33,0,70,37
1651082118458,ECE 180,A00,083140,Abi Samra; Nicholas Camill,17,0,30,13
1651082118458,ECE 180,B00,083141,Abi Samra; Nicholas Camill,0,0,30,30
1651082124483,MATH 10A,A01,083735,Patchell; Gregory David,0,0,30,30
1651082124483,MATH 10A,A02,083736,Patchell; Gregory David,27,0,30,3
1651082124483,MATH 10A,A03,083737,Patchell; Gregory David,22,0,30,8
1651082130505,MATH 10B,A01,083207,Staff,0,7,30,30
1651082130505,MATH 10B,A02,083208,Staff,0,6,30,30
1651082130505,MATH 10B,B01,083739,Staff,8,0,30,22
1651082130505,MATH 10B,B02,083740,Staff,28,0,30,2
1651082136530,MATH 18,A01,083743,Staff,0,0,30,30
1651082136530,MATH 18,A02,083744,Staff,23,0,30,7
1651082136530,MATH 18,A03,083745,Staff,19,0,30,11
1651082136530,MATH 18,A04,083746,Staff,26,0,30,4
1651082136530,MATH 18,B01,083748,Staff,0,16,30,30
1651082136530,MATH 18,B02,083749,Staff,0,14,30,30
1651082136530,MATH 18,B03,083750,Staff,0,14,30,30
1651082136530,MATH 18,B04,083751,Staff,0,13,30,30
1651082142561,MATH 20A,A01,083754,Staff,18,0,40,22
1651082148585,MATH 20B,A01,083756,Staff,0,14,30,30
1651082148585,MATH 20B,A02,083757,Staff,0,11,30,30
1651082154608,MATH 20C,A01,083760,Staff,0,16,30,30
1651082154608,MATH 20C,A02,083761,Staff,0,15,30,30
1651082154608,MATH 20C,B01,083762,Staff,7,0,30,23
1651082154608,MATH 20C,B02,083763,Staff,27,0,30,3
1651082160632,MATH 20D,A01,083765,Staff,3,1,30,27
1651082160632,MATH 20D,A02,083766,Staff,1,0,30,29
1651082160632,MATH 20D,A03,083767,Staff,22,0,30,8
1651082166656,MATH 20E,A01,083771,Staff,2,0,30,28
1651082166656,MATH 20E,A02,083772,Staff,10,0,30,20
1651082166656,MATH 20E,B01,083773,Staff,0,0,30,30
1651082166656,MATH 20E,B02,083774,Staff,0,0,30,30
1651082172679,MATH 103A,A01,083777,Staff,0,17,30,30
1651082172679,MATH 103A,A02,083778,Staff,0,17,30,30
1651082172679,MATH 103A,B01,083779,Staff,0,15,30,30
1651082172679,MATH 103A,B02,083780,Staff,0,14,30,30
1651082178704,MATH 105,A01,085443,Staff,0,23,30,30
1651082184733,MATH 109,A01,083213,Anzaldo; Leesa B,0,7,30,30
1651082184733,MATH 109,A02,083214,Anzaldo; Leesa B,0,7,30,30
1651082184733,MATH 109,B01,083215,Anzaldo; Leesa B,0,8,30,30
1651082184733,MATH 109,B02,083216,Anzaldo; Leesa B,0,8,30,30
1651082190760,MATH 142A,A01,083219,Chow; Bennett,0,15,30,30
1651082190760,MATH 142A,A02,083220,Chow; Bennett,0,15,30,30
1651082190760,MATH 142A,B01,083221,Chow; Bennett,0,16,30,30
1651082190760,MATH 142A,B02,083222,Chow; Bennett,0,15,30,30
1651082196783,MATH 193A,A01,083224,Staff,0,9,30,30
1651082196783,MATH 193A,A02,083225,Staff,0,7,30,30
1651082196783,MATH 193A,A03,083781,Staff,0,7,30,30
1651082196783,MATH 193A,A04,083782,Staff,0,7,30,30
1651082202806,MATH 197,001,091859,McAuley; Julian John,9998,0,9999,1
1651082208869,COGS 9,A01,083615,Staff,0,20,60,60
1651082214896,COGS 11,A01,083617,Boyle; Mary E. T.,13,0,40,27
1651082220937,COGS 13,A01,083071,Staff,0,39,40,40
1651082226963,COGS 14A,A01,092681,Staff,0,39,100,100
1651082232993,COGS 14B,A01,083073,Cheng; Tzu-Han,0,13,50,50
1651082239024,COGS 17,A01,092677,Staff,9,0,75,66
1651082245048,COGS 100,A01,083619,Staff,0,30,60,60
1651082251074,COGS 101A,A01,083621,Davis; Joshua Daniel,0,29,60,60
1651082257104,COGS 101B,A01,091572,Staff,0,8,60,60
1651082263129,COGS 101C,A01,083625,Delgado; Tania,13,0,30,17
1651082269156,COGS 107A,A01,083627,Boyle; Mary E. T.,0,17,60,60
1651082275187,COGS 118A,A01,083075,Staff,0,10,60,60
1651082281215,CSE 3,A50,083646,Miranda; Gregory Joseph,15,0,38,23
1651082281215,CSE 3,A51,083647,Miranda; Gregory Joseph,36,0,37,1
1651082287239,CSE 8A,A50,083650,Miranda; Gregory Joseph,0,31,40,40
1651082293261,CSE 11,A01,083080,Cao; Yingjun,1,98,40,39
1651082299300,CSE 12,A01,083652,Staff,0,27,100,100
1651082305330,CSE 15L,A01,083654,Staff,0,3,50,50
1651082305330,CSE 15L,A02,083655,Staff,0,3,50,50
1651082311355,CSE 20,A01,083657,Staff,46,0,80,34
1651082317379,CSE 30,A01,083084,Eldon; John,0,38,80,80
1651082323408,CSE 100,A01,083659,Cao; Yingjun,0,72,50,50
1651082329431,CSE 134B,A01,083661,Powell; Thomas Allan,0,38,65,65
1651082335453,CSE 140,A01,083663,Staff,0,15,75,75
1651082341480,CSE 140L,A01,083088,Eldon; John,3,0,100,97
1651082347507,CSE 175,A01,083665,Kumar; Rakesh,0,0,25,25
1651082353533,CSE 190,A00,092507,Dubnov; Shlomo,9,0,20,11
1651082359561,ECE 45,A01,083139,Staff,0,7,60,60
1651082365585,ECE 65,A50,083695,Staff,0,7,30,30
1651082371620,ECE 109,A01,091882,Touri; Behrouz,33,0,70,37
1651082377654,ECE 180,A00,083140,Abi Samra; Nicholas Camill,17,0,30,13
1651082377654,ECE 180,B00,083141,Abi Samra; Nicholas Camill,0,0,30,30
1651082383676,MATH 10A,A01,083735,Patchell; Gregory David,0,0,30,30
1651082383676,MATH 10A,A02,083736,Patchell; Gregory David,27,0,30,3
1651082383676,MATH 10A,A03,083737,Patchell; Gregory David,22,0,30,8
1651082389703,MATH 10B,A01,083207,Staff,0,7,30,30
1651082389703,MATH 10B,A02,083208,Staff,0,6,30,30
1651082389703,MATH 10B,B01,083739,Staff,8,0,30,22
1651082389703,MATH 10B,B02,083740,Staff,28,0,30,2
1651082395728,MATH 18,A01,083743,Staff,0,0,30,30
1651082395728,MATH 18,A02,083744,Staff,23,0,30,7
1651082395728,MATH 18,A03,083745,Staff,19,0,30,11
1651082395728,MATH 18,A04,083746,Staff,26,0,30,4
1651082395728,MATH 18,B01,083748,Staff,0,16,30,30
1651082395728,MATH 18,B02,083749,Staff,0,14,30,30
1651082395728,MATH 18,B03,083750,Staff,0,14,30,30
1651082395728,MATH 18,B04,083751,Staff,0,13,30,30
1651082401754,MATH 20A,A01,083754,Staff,18,0,40,22
1651082407779,MATH 20B,A01,083756,Staff,0,14,30,30
1651082407779,MATH 20B,A02,083757,Staff,0,11,30,30
1651082413811,MATH 20C,A01,083760,Staff,0,16,30,30
1651082413811,MATH 20C,A02,083761,Staff,0,15,30,30
1651082413811,MATH 20C,B01,083762,Staff,7,0,30,23
1651082413811,MATH 20C,B02,083763,Staff,27,0,30,3
1651082419834,MATH 20D,A01,083765,Staff,3,1,30,27
1651082419834,MATH 20D,A02,083766,Staff,1,0,30,29
1651082419834,MATH 20D,A03,083767,Staff,22,0,30,8
1651082425859,MATH 20E,A01,083771,Staff,2,0,30,28
1651082425859,MATH 20E,A02,083772,Staff,10,0,30,20
1651082425859,MATH 20E,B01,083773,Staff,0,0,30,30
1651082425859,MATH 20E,B02,083774,Staff,0,0,30,30
1651082431882,MATH 103A,A01,083777,Staff,0,17,30,30
1651082431882,MATH 103A,A02,083778,Staff,0,17,30,30
1651082431882,MATH 103A,B01,083779,Staff,0,15,30,30
1651082431882,MATH 103A,B02,083780,Staff,0,14,30,30
1651082437907,MATH 105,A01,085443,Staff,0,23,30,30
1651082443932,MATH 109,A01,083213,Anzaldo; Leesa B,0,7,30,30
1651082443932,MATH 109,A02,083214,Anzaldo; Leesa B,0,7,30,30
1651082443932,MATH 109,B01,083215,Anzaldo; Leesa B,0,8,30,30
1651082443932,MATH 109,B02,083216,Anzaldo; Leesa B,0,8,30,30
1651082449957,MATH 142A,A01,083219,Chow; Bennett,0,15,30,30
1651082449957,MATH 142A,A02,083220,Chow; Bennett,0,15,30,30
1651082449957,MATH 142A,B01,083221,Chow; Bennett,0,16,30,30
1651082449957,MATH 142A,B02,083222,Chow; Bennett,0,15,30,30
1651082455985,MATH 193A,A01,083224,Staff,0,9,30,30
1651082455985,MATH 193A,A02,083225,Staff,0,7,30,30
1651082455985,MATH 193A,A03,083781,Staff,0,7,30,30
1651082455985,MATH 193A,A04,083782,Staff,0,7,30,30
1651082462008,MATH 197,001,091859,McAuley; Julian John,9998,0,9999,1
1651082468080,COGS 9,A01,083615,Staff,0,20,60,60
1651082474105,COGS 11,A01,083617,Boyle; Mary E. T.,13,0,40,27
1651082480138,COGS 13,A01,083071,Staff,0,39,40,40
1651082486163,COGS 14A,A01,092681,Staff,0,39,100,100
1651082492189,COGS 14B,A01,083073,Cheng; Tzu-Han,0,13,50,50
1651082498214,COGS 17,A01,092677,Staff,9,0,75,66
1651082504241,COGS 100,A01,083619,Staff,0,30,60,60
1651082510268,COGS 101A,A01,083621,Davis; Joshua Daniel,0,29,60,60
1651082516294,COGS 101B,A01,091572,Staff,0,8,60,60
1651082522325,COGS 101C,A01,083625,Delgado; Tania,13,0,30,17
1651082528349,COGS 107A,A01,083627,Boyle; Mary E. T.,0,17,60,60
1651082534372,COGS 118A,A01,083075,Staff,0,10,60,60
1651082540396,CSE 3,A50,083646,Miranda; Gregory Joseph,15,0,38,23
1651082540396,CSE 3,A51,083647,Miranda; Gregory Joseph,36,0,37,1
1651082546425,CSE 8A,A50,083650,Miranda; Gregory Joseph,0,31,40,40
1651082552452,CSE 11,A01,083080,Cao; Yingjun,1,98,40,39
1651082558479,CSE 12,A01,083652,Staff,0,27,100,100
1651082564502,CSE 15L,A01,083654,Staff,0,3,50,50
1651082564502,CSE 15L,A02,083655,Staff,0,3,50,50
1651082570534,CSE 20,A01,083657,Staff,46,0,80,34
1651082576561,CSE 30,A01,083084,Eldon; John,0,38,80,80
1651082582590,CSE 100,A01,083659,Cao; Yingjun,0,72,50,50
1651082588621,CSE 134B,A01,083661,Powell; Thomas Allan,0,38,65,65
1651082594644,CSE 140,A01,083663,Staff,0,15,75,75
1651082600679,CSE 140L,A01,083088,Eldon; John,3,0,100,97
1651082606705,CSE 175,A01,083665,Kumar; Rakesh,0,0,25,25
1651082612727,CSE 190,A00,092507,Dubnov; Shlomo,9,0,20,11
1651082618761,ECE 45,A01,083139,Staff,0,7,60,60
1651082624788,ECE 65,A50,083695,Staff,0,7,30,30
1651082630820,ECE 109,A01,091882,Touri; Behrouz,33,0,70,37
1651082636865,ECE 180,A00,083140,Abi Samra; Nicholas Camill,17,0,30,13
1651082636865,ECE 180,B00,083141,Abi Samra; Nicholas Camill,0,0,30,30
1651082642889,MATH 10A,A01,083735,Patchell; Gregory David,0,0,30,30
1651082642889,MATH 10A,A02,083736,Patchell; Gregory David,27,0,30,3
1651082642889,MATH 10A,A03,083737,Patchell; Gregory David,22,0,30,8
1651082648922,MATH 10B,A01,083207,Staff,0,7,30,30
1651082648922,MATH 10B,A02,083208,Staff,0,6,30,30
1651082648922,MATH 10B,B01,083739,Staff,8,0,30,22
1651082648922,MATH 10B,B02,083740,Staff,28,0,30,2
1651082654948,MATH 18,A01,083743,Staff,0,0,30,30
1651082654948,MATH 18,A02,083744,Staff,23,0,30,7
1651082654948,MATH 18,A03,083745,Staff,19,0,30,11
1651082654948,MATH 18,A04,083746,Staff,26,0,30,4
1651082654948,MATH 18,B01,083748,Staff,0,16,30,30
1651082654948,MATH 18,B02,083749,Staff,0,14,30,30
1651082654948,MATH 18,B03,083750,Staff,0,14,30,30
1651082654948,MATH 18,B04,083751,Staff,0,13,30,30
1651082661059,MATH 20A,A01,083754,Staff,18,0,40,22
1651082667092,MATH 20B,A01,083756,Staff,0,14,30,30
1651082667092,MATH 20B,A02,083757,Staff,0,11,30,30
1651082673121,MATH 20C,A01,083760,Staff,0,16,30,30
1651082673121,MATH 20C,A02,083761,Staff,0,15,30,30
1651082673121,MATH 20C,B01,083762,Staff,7,0,30,23
1651082673121,MATH 20C,B02,083763,Staff,27,0,30,3
1651082679148,MATH 20D,A01,083765,Staff,3,1,30,27
1651082679148,MATH 20D,A02,083766,Staff,1,0,30,29
1651082679148,MATH 20D,A03,083767,Staff,22,0,30,8
1651082685175,MATH 20E,A01,083771,Staff,2,0,30,28
1651082685175,MATH 20E,A02,083772,Staff,10,0,30,20
1651082685175,MATH 20E,B01,083773,Staff,0,0,30,30
1651082685175,MATH 20E,B02,083774,Staff,0,0,30,30
1651082691203,MATH 103A,A01,083777,Staff,0,17,30,30
1651082691203,MATH 103A,A02,083778,Staff,0,17,30,30
1651082691203,MATH 103A,B01,083779,Staff,0,15,30,30
1651082691203,MATH 103A,B02,083780,Staff,0,14,30,30
1651082697225,MATH 105,A01,085443,Staff,0,24,30,30
1651082703248,MATH 109,A01,083213,Anzaldo; Leesa B,0,7,30,30
1651082703248,MATH 109,A02,083214,Anzaldo; Leesa B,0,7,30,30
1651082703248,MATH 109,B01,083215,Anzaldo; Leesa B,0,8,30,30
1651082703248,MATH 109,B02,083216,Anzaldo; Leesa B,0,8,30,30
1651082709276,MATH 142A,A01,083219,Chow; Bennett,0,15,30,30
1651082709276,MATH 142A,A02,083220,Chow; Bennett,0,15,30,30
1651082709276,MATH 142A,B01,083221,Chow; Bennett,0,16,30,30
1651082709276,MATH 142A,B02,083222,Chow; Bennett,0,15,30,30
1651082715300,MATH 193A,A01,083224,Staff,0,9,30,30
1651082715300,MATH 193A,A02,083225,Staff,0,7,30,30
1651082715300,MATH 193A,A03,083781,Staff,0,7,30,30
1651082715300,MATH 193A,A04,083782,Staff,0,7,30,30
1651082721331,MATH 197,001,091859,McAuley; Julian John,9998,0,9999,1
1651082727398,COGS 9,A01,083615,Staff,0,20,60,60
1651082733433,COGS 11,A01,083617,Boyle; Mary E. T.,13,0,40,27
1651082739460,COGS 13,A01,083071,Staff,0,38,40,40
1651082745483,COGS 14A,A01,092681,Staff,0,39,100,100
1651082751510,COGS 14B,A01,083073,Cheng; Tzu-Han,0,13,50,50
1651082757534,COGS 17,A01,092677,Staff,9,0,75,66
1651082763556,COGS 100,A01,083619,Staff,0,30,60,60
1651082769583,COGS 101A,A01,083621,Davis; Joshua Daniel,0,29,60,60
1651082775607,COGS 101B,A01,091572,Staff,0,8,60,60
1651082781631,COGS 101C,A01,083625,Delgado; Tania,13,0,30,17
1651082787661,COGS 107A,A01,083627,Boyle; Mary E. T.,0,17,60,60
1651082793690,COGS 118A,A01,083075,Staff,0,10,60,60
1651082799730,CSE 3,A50,083646,Miranda; Gregory Joseph,15,0,38,23
1651082799730,CSE 3,A51,083647,Miranda; Gregory Joseph,36,0,37,1
1651082805753,CSE 8A,A50,083650,Miranda; Gregory Joseph,0,31,40,40
1651082811776,CSE 11,A01,083080,Cao; Yingjun,1,98,40,39
1651082817799,CSE 12,A01,083652,Staff,0,27,100,100
1651082823839,CSE 15L,A01,083654,Staff,0,3,50,50
1651082823839,CSE 15L,A02,083655,Staff,0,3,50,50
1651082829862,CSE 20,A01,083657,Staff,46,0,80,34
1651082835886,CSE 30,A01,083084,Eldon; John,0,38,80,80
1651082841920,CSE 100,A01,083659,Cao; Yingjun,0,72,50,50
1651082847942,CSE 134B,A01,083661,Powell; Thomas Allan,0,38,65,65
1651082853969,CSE 140,A01,083663,Staff,0,15,75,75
1651082859993,CSE 140L,A01,083088,Eldon; John,3,0,100,97
1651082866015,CSE 175,A01,083665,Kumar; Rakesh,0,0,25,25
1651082872043,CSE 190,A00,092507,Dubnov; Shlomo,9,0,20,11
1651082878068,ECE 45,A01,083139,Staff,0,7,60,60
1651082884095,ECE 65,A50,083695,Staff,0,7,30,30
1651082890127,ECE 109,A01,091882,Touri; Behrouz,33,0,70,37
1651082896153,ECE 180,A00,083140,Abi Samra; Nicholas Camill,17,0,30,13
1651082896153,ECE 180,B00,083141,Abi Samra; Nicholas Camill,0,0,30,30
1651082902179,MATH 10A,A01,083735,Patchell; Gregory David,0,0,30,30
1651082902179,MATH 10A,A02,083736,Patchell; Gregory David,27,0,30,3
1651082902179,MATH 10A,A03,083737,Patchell; Gregory David,22,0,30,8
1651082908203,MATH 10B,A01,083207,Staff,0,7,30,30
1651082908203,MATH 10B,A02,083208,Staff,0,6,30,30
1651082908203,MATH 10B,B01,083739,Staff,8,0,30,22
1651082908203,MATH 10B,B02,083740,Staff,28,0,30,2
1651082914241,MATH 18,A01,083743,Staff,0,0,30,30
1651082914241,MATH 18,A02,083744,Staff,23,0,30,7
1651082914241,MATH 18,A03,083745,Staff,19,0,30,11
1651082914241,MATH 18,A04,083746,Staff,26,0,30,4
1651082914241,MATH 18,B01,083748,Staff,0,16,30,30
1651082914241,MATH 18,B02,083749,Staff,0,14,30,30
1651082914241,MATH 18,B03,083750,Staff,0,14,30,30
1651082914241,MATH 18,B04,083751,Staff,0,13,30,30
1651082920264,MATH 20A,A01,083754,Staff,18,0,40,22
1651082926294,MATH 20B,A01,083756,Staff,0,14,30,30
1651082926294,MATH 20B,A02,083757,Staff,0,11,30,30
1651082932320,MATH 20C,A01,083760,Staff,0,16,30,30
1651082932320,MATH 20C,A02,083761,Staff,0,15,30,30
1651082932320,MATH 20C,B01,083762,Staff,7,0,30,23
1651082932320,MATH 20C,B02,083763,Staff,27,0,30,3
1651082938352,MATH 20D,A01,083765,Staff,3,1,30,27
1651082938352,MATH 20D,A02,083766,Staff,1,0,30,29
1651082938352,MATH 20D,A03,083767,Staff,22,0,30,8
1651082944385,MATH 20E,A01,083771,Staff,2,0,30,28
1651082944385,MATH 20E,A02,083772,Staff,10,0,30,20
1651082944385,MATH 20E,B01,083773,Staff,0,0,30,30
1651082944385,MATH 20E,B02,083774,Staff,0,0,30,30
1651082950425,MATH 103A,A01,083777,Staff,0,17,30,30
1651082950425,MATH 103A,A02,083778,Staff,0,17,30,30
1651082950425,MATH 103A,B01,083779,Staff,0,15,30,30
1651082950425,MATH 103A,B02,083780,Staff,0,14,30,30
1651082956448,MATH 105,A01,085443,Staff,0,24,30,30
1651082962472,MATH 109,A01,083213,Anzaldo; Leesa B,0,7,30,30
1651082962472,MATH 109,A02,083214,Anzaldo; Leesa B,0,7,30,30
1651082962472,MATH 109,B01,083215,Anzaldo; Leesa B,0,8,30,30
1651082962472,MATH 109,B02,083216,Anzaldo; Leesa B,0,8,30,30
1651082968500,MATH 142A,A01,083219,Chow; Bennett,0,15,30,30
1651082968500,MATH 142A,A02,083220,Chow; Bennett,0,15,30,30
1651082968500,MATH 142A,B01,083221,Chow; Bennett,0,16,30,30
1651082968500,MATH 142A,B02,083222,Chow; Bennett,0,15,30,30
1651082974542,MATH 193A,A01,083224,Staff,0,9,30,30
1651082974542,MATH 193A,A02,083225,Staff,0,7,30,30
1651082974542,MATH 193A,A03,083781,Staff,0,7,30,30
1651082974542,MATH 193A,A04,083782,Staff,0,7,30,30
1651082980566,MATH 197,001,091859,McAuley; Julian John,9998,0,9999,1
1651082986627,COGS 9,A01,083615,Staff,0,20,60,60
1651082992657,COGS 11,A01,083617,Boyle; Mary E. T.,13,0,40,27
1651082998680,COGS 13,A01,083071,Staff,0,38,40,40
1651083004703,COGS 14A,A01,092681,Staff,0,39,100,100
1651083010744,COGS 14B,A01,083073,Cheng; Tzu-Han,0,13,50,50
1651083016770,COGS 17,A01,092677,Staff,9,0,75,66
1651083022794,COGS 100,A01,083619,Staff,0,30,60,60
1651083028817,COGS 101A,A01,083621,Davis; Joshua Daniel,0,29,60,60
1651083034842,COGS 101B,A01,091572,Staff,0,8,60,60
1651083040865,COGS 101C,A01,083625,Delgado; Tania,13,0,30,17
1651083046894,COGS 107A,A01,083627,Boyle; Mary E. T.,0,17,60,60
1651083052918,COGS 118A,A01,083075,Staff,0,10,60,60
1651083058946,CSE 3,A50,083646,Miranda; Gregory Joseph,15,0,38,23
1651083058946,CSE 3,A51,083647,Miranda; Gregory Joseph,36,0,37,1
1651083064969,CSE 8A,A50,083650,Miranda; Gregory Joseph,0,31,40,40
1651083070995,CSE 11,A01,083080,Cao; Yingjun,1,98,40,39
1651083077019,CSE 12,A01,083652,Staff,0,27,100,100
1651083083042,CSE 15L,A01,083654,Staff,0,3,50,50
1651083083042,CSE 15L,A02,083655,Staff,0,3,50,50
1651083089075,CSE 20,A01,083657,Staff,46,0,80,34
1651083095099,CSE 30,A01,083084,Eldon; John,0,38,80,80
1651083101123,CSE 100,A01,083659,Cao; Yingjun,0,72,50,50
1651083107148,CSE 134B,A01,083661,Powell; Thomas Allan,0,38,65,65
1651083113178,CSE 140,A01,083663,Staff,0,15,75,75
1651083119211,CSE 140L,A01,083088,Eldon; John,3,0,100,97
1651083125234,CSE 175,A01,083665,Kumar; Rakesh,0,0,25,25
1651083131278,CSE 190,A00,092507,Dubnov; Shlomo,9,0,20,11
1651083137301,ECE 45,A01,083139,Staff,0,7,60,60
1651083143326,ECE 65,A50,083695,Staff,0,7,30,30
1651083149355,ECE 109,A01,091882,Touri; Behrouz,33,0,70,37
1651083155380,ECE 180,A00,083140,Abi Samra; Nicholas Camill,17,0,30,13
1651083155380,ECE 180,B00,083141,Abi Samra; Nicholas Camill,0,0,30,30
1651083161403,MATH 10A,A01,083735,Patchell; Gregory David,0,0,30,30
1651083161403,MATH 10A,A02,083736,Patchell; Gregory David,27,0,30,3
1651083161403,MATH 10A,A03,083737,Patchell; Gregory David,22,0,30,8
1651083167428,MATH 10B,A01,083207,Staff,0,7,30,30
1651083167428,MATH 10B,A02,083208,Staff,0,6,30,30
1651083167428,MATH 10B,B01,083739,Staff,8,0,30,22
1651083167428,MATH 10B,B02,083740,Staff,28,0,30,2
1651083173454,MATH 18,A01,083743,Staff,0,0,30,30
1651083173454,MATH 18,A02,083744,Staff,23,0,30,7
1651083173454,MATH 18,A03,083745,Staff,19,0,30,11
1651083173454,MATH 18,A04,083746,Staff,26,0,30,4
1651083173454,MATH 18,B01,083748,Staff,0,16,30,30
1651083173454,MATH 18,B02,083749,Staff,0,14,30,30
1651083173454,MATH 18,B03,083750,Staff,0,14,30,30
1651083173454,MATH 18,B04,083751,Staff,0,13,30,30
1651083179480,MATH 20A,A01,083754,Staff,18,0,40,22
1651083185504,MATH 20B,A01,083756,Staff,0,14,30,30
1651083185504,MATH 20B,A02,083757,Staff,0,11,30,30
1651083191529,MATH 20C,A01,083760,Staff,0,16,30,30
1651083191529,MATH 20C,A02,083761,Staff,0,15,30,30
1651083191529,MATH 20C,B01,083762,Staff,7,0,30,23
1651083191529,MATH 20C,B02,083763,Staff,27,0,30,3
1651083197556,MATH 20D,A01,083765,Staff,3,1,30,27
1651083197556,MATH 20D,A02,083766,Staff,1,0,30,29
1651083197556,MATH 20D,A03,083767,Staff,22,0,30,8
1651083203583,MATH 20E,A01,083771,Staff,2,0,30,28
1651083203583,MATH 20E,A02,083772,Staff,10,0,30,20
1651083203583,MATH 20E,B01,083773,Staff,0,0,30,30
1651083203583,MATH 20E,B02,083774,Staff,0,0,30,30
1651083209606,MATH 103A,A01,083777,Staff,0,17,30,30
1651083209606,MATH 103A,A02,083778,Staff,0,17,30,30
1651083209606,MATH 103A,B01,083779,Staff,0,15,30,30
1651083209606,MATH 103A,B02,083780,Staff,0,14,30,30
1651083215629,MATH 105,A01,085443,Staff,0,24,30,30
1651083221652,MATH 109,A01,083213,Anzaldo; Leesa B,0,7,30,30
1651083221652,MATH 109,A02,083214,Anzaldo; Leesa B,0,7,30,30
1651083221652,MATH 109,B01,083215,Anzaldo; Leesa B,0,8,30,30
1651083221652,MATH 109,B02,083216,Anzaldo; Leesa B,0,8,30,30
1651083227677,MATH 142A,A01,083219,Chow; Bennett,0,15,30,30
1651083227677,MATH 142A,A02,083220,Chow; Bennett,0,15,30,30
1651083227677,MATH 142A,B01,083221,Chow; Bennett,0,16,30,30
1651083227677,MATH 142A,B02,083222,Chow; Bennett,0,15,30,30
1651083233710,MATH 193A,A01,083224,Staff,0,9,30,30
1651083233710,MATH 193A,A02,083225,Staff,0,7,30,30
1651083233710,MATH 193A,A03,083781,Staff,0,7,30,30
1651083233710,MATH 193A,A04,083782,Staff,0,7,30,30
1651083239734,MATH 197,001,091859,McAuley; Julian John,9998,0,9999,1
1651083245801,COGS 9,A01,083615,Staff,0,20,60,60
1651083251925,COGS 11,A01,083617,Boyle; Mary E. T.,13,0,40,27
1651083257950,COGS 13,A01,083071,Staff,0,38,40,40
1651083263987,COGS 14A,A01,092681,Staff,0,39,100,100
1651083270009,COGS 14B,A01,083073,Cheng; Tzu-Han,0,13,50,50
1651083276035,COGS 17,A01,092677,Staff,9,0,75,66
1651083282077,COGS 100,A01,083619,Staff,0,30,60,60
1651083288104,COGS 101A,A01,083621,Davis; Joshua Daniel,0,29,60,60
1651083294145,COGS 101B,A01,091572,Staff,0,8,60,60
1651083300171,COGS 101C,A01,083625,Delgado; Tania,13,0,30,17
1651083306195,COGS 107A,A01,083627,Boyle; Mary E. T.,0,17,60,60
1651083312217,COGS 118A,A01,083075,Staff,0,10,60,60
1651083318247,CSE 3,A50,083646,Miranda; Gregory Joseph,15,0,38,23
1651083318247,CSE 3,A51,083647,Miranda; Gregory Joseph,36,0,37,1
1651083324269,CSE 8A,A50,083650,Miranda; Gregory Joseph,0,31,40,40
1651083330292,CSE 11,A01,083080,Cao; Yingjun,1,98,40,39
1651083336330,CSE 12,A01,083652,Staff,0,27,100,100
1651083342354,CSE 15L,A01,083654,Staff,0,3,50,50
1651083342354,CSE 15L,A02,083655,Staff,0,3,50,50
1651083348377,CSE 20,A01,083657,Staff,46,0,80,34
1651083354409,CSE 30,A01,083084,Eldon; John,0,38,80,80
1651083360433,CSE 100,A01,083659,Cao; Yingjun,0,72,50,50
1651083366458,CSE 134B,A01,083661,Powell; Thomas Allan,0,38,65,65
1651083372485,CSE 140,A01,083663,Staff,0,15,75,75
1651083378518,CSE 140L,A01,083088,Eldon; John,3,0,100,97
1651083384555,CSE 175,A01,083665,Kumar; Rakesh,0,0,25,25
1651083390579,CSE 190,A00,092507,Dubnov; Shlomo,9,0,20,11
1651083396603,ECE 45,A01,083139,Staff,0,7,60,60
1651083402630,ECE 65,A50,083695,Staff,0,7,30,30
1651083408654,ECE 109,A01,091882,Touri; Behrouz,33,0,70,37
1651083414696,ECE 180,A00,083140,Abi Samra; Nicholas Camill,17,0,30,13
1651083414696,ECE 180,B00,083141,Abi Samra; Nicholas Camill,0,0,30,30
1651083420719,MATH 10A,A01,083735,Patchell; Gregory David,0,0,30,30
1651083420719,MATH 10A,A02,083736,Patchell; Gregory David,27,0,30,3
1651083420719,MATH 10A,A03,083737,Patchell; Gregory David,22,0,30,8
1651083426747,MATH 10B,A01,083207,Staff,0,7,30,30
1651083426747,MATH 10B,A02,083208,Staff,0,6,30,30
1651083426747,MATH 10B,B01,083739,Staff,8,0,30,22
1651083426747,MATH 10B,B02,083740,Staff,28,0,30,2
1651083432789,MATH 18,A01,083743,Staff,0,0,30,30
1651083432789,MATH 18,A02,083744,Staff,23,0,30,7
1651083432789,MATH 18,A03,083745,Staff,19,0,30,11
1651083432789,MATH 18,A04,083746,Staff,26,0,30,4
1651083432789,MATH 18,B01,083748,Staff,0,16,30,30
1651083432789,MATH 18,B02,083749,Staff,0,14,30,30
1651083432789,MATH 18,B03,083750,Staff,0,14,30,30
1651083432789,MATH 18,B04,083751,Staff,0,13,30,30
1651083438811,MATH 20A,A01,083754,Staff,18,0,40,22
1651083444836,MATH 20B,A01,083756,Staff,0,14,30,30
1651083444836,MATH 20B,A02,083757,Staff,0,11,30,30
1651083450867,MATH 20C,A01,083760,Staff,0,16,30,30
1651083450867,MATH 20C,A02,083761,Staff,0,15,30,30
1651083450867,MATH 20C,B01,083762,Staff,7,0,30,23
1651083450867,MATH 20C,B02,083763,Staff,27,0,30,3
1651083456891,MATH 20D,A01,083765,Staff,3,1,30,27
1651083456891,MATH 20D,A02,083766,Staff,1,0,30,29
1651083456891,MATH 20D,A03,083767,Staff,22,0,30,8
1651083462917,MATH 20E,A01,083771,Staff,2,0,30,28
1651083462917,MATH 20E,A02,083772,Staff,10,0,30,20
1651083462917,MATH 20E,B01,083773,Staff,0,0,30,30
1651083462917,MATH 20E,B02,083774,Staff,0,0,30,30
1651083468940,MATH 103A,A01,083777,Staff,0,17,30,30
1651083468940,MATH 103A,A02,083778,Staff,0,17,30,30
1651083468940,MATH 103A,B01,083779,Staff,0,15,30,30
1651083468940,MATH 103A,B02,083780,Staff,0,14,30,30
1651083474963,MATH 105,A01,085443,Staff,0,24,30,30
1651083480991,MATH 109,A01,083213,Anzaldo; Leesa B,0,7,30,30
1651083480991,MATH 109,A02,083214,Anzaldo; Leesa B,0,7,30,30
1651083480991,MATH 109,B01,083215,Anzaldo; Leesa B,0,8,30,30
1651083480991,MATH 109,B02,083216,Anzaldo; Leesa B,0,8,30,30
1651083487021,MATH 142A,A01,083219,Chow; Bennett,0,15,30,30
1651083487021,MATH 142A,A02,083220,Chow; Bennett,0,15,30,30
1651083487021,MATH 142A,B01,083221,Chow; Bennett,0,16,30,30
1651083487021,MATH 142A,B02,083222,Chow; Bennett,0,15,30,30
1651083493044,MATH 193A,A01,083224,Staff,0,9,30,30
1651083493044,MATH 193A,A02,083225,Staff,0,7,30,30
1651083493044,MATH 193A,A03,083781,Staff,0,7,30,30
1651083493044,MATH 193A,A04,083782,Staff,0,7,30,30
1651083499069,MATH 197,001,091859,McAuley; Julian John,9998,0,9999,1
1651083505130,COGS 9,A01,083615,Staff,0,20,60,60
1651083511169,COGS 11,A01,083617,Boyle; Mary E. T.,13,0,40,27
1651083517199,COGS 13,A01,083071,Staff,0,38,40,40
1651083523221,COGS 14A,A01,092681,Staff,0,39,100,100
1651083529254,COGS 14B,A01,083073,Cheng; Tzu-Han,0,13,50,50
1651083535282,COGS 17,A01,092677,Staff,9,0,75,66
1651083541315,COGS 100,A01,083619,Staff,0,30,60,60
1651083547350,COGS 101A,A01,083621,Davis; Joshua Daniel,0,29,60,60
1651083553377,COGS 101B,A01,091572,Staff,0,8,60,60
1651083559415,COGS 101C,A01,083625,Delgado; Tania,13,0,30,17
1651083565449,COGS 107A,A01,083627,Boyle; Mary E. T.,0,17,60,60
1651083571475,COGS 118A,A01,083075,Staff,0,10,60,60
1651083577499,CSE 3,A50,083646,Miranda; Gregory Joseph,15,0,38,23
1651083577499,CSE 3,A51,083647,Miranda; Gregory Joseph,36,0,37,1
1651083583522,CSE 8A,A50,083650,Miranda; Gregory Joseph,0,31,40,40
1651083589552,CSE 11,A01,083080,Cao; Yingjun,1,98,40,39
1651083595584,CSE 12,A01,083652,Staff,0,27,100,100
1651083601607,CSE 15L,A01,083654,Staff,0,3,50,50
1651083601607,CSE 15L,A02,083655,Staff,0,3,50,50
1651083607633,CSE 20,A01,083657,Staff,46,0,80,34
1651083613656,CSE 30,A01,083084,Eldon; John,0,38,80,80
1651083619683,CSE 100,A01,083659,Cao; Yingjun,0,72,50,50
1651083625707,CSE 134B,A01,083661,Powell; Thomas Allan,0,38,65,65
1651083631735,CSE 140,A01,083663,Staff,0,15,75,75
1651083637758,CSE 140L,A01,083088,Eldon; John,3,0,100,97
1651083643786,CSE 175,A01,083665,Kumar; Rakesh,0,0,25,25
1651083649823,CSE 190,A00,092507,Dubnov; Shlomo,9,0,20,11
1651083655848,ECE 45,A01,083139,Staff,0,7,60,60
1651083661875,ECE 65,A50,083695,Staff,0,7,30,30
1651083667901,ECE 109,A01,091882,Touri; Behrouz,33,0,70,37
1651083673938,ECE 180,A00,083140,Abi Samra; Nicholas Camill,17,0,30,13
1651083673938,ECE 180,B00,083141,Abi Samra; Nicholas Camill,0,0,30,30
1651083679973,MATH 10A,A01,083735,Patchell; Gregory David,0,0,30,30
1651083679973,MATH 10A,A02,083736,Patchell; Gregory David,27,0,30,3
1651083679973,MATH 10A,A03,083737,Patchell; Gregory David,22,0,30,8
1651083686004,MATH 10B,A01,083207,Staff,0,7,30,30
1651083686004,MATH 10B,A02,083208,Staff,0,6,30,30
1651083686004,MATH 10B,B01,083739,Staff,8,0,30,22
1651083686004,MATH 10B,B02,083740,Staff,28,0,30,2
1651083692033,MATH 18,A01,083743,Staff,0,0,30,30
1651083692033,MATH 18,A02,083744,Staff,23,0,30,7
1651083692033,MATH 18,A03,083745,Staff,19,0,30,11
1651083692033,MATH 18,A04,083746,Staff,26,0,30,4
1651083692033,MATH 18,B01,083748,Staff,0,16,30,30
1651083692033,MATH 18,B02,083749,Staff,0,14,30,30
1651083692033,MATH 18,B03,083750,Staff,0,14,30,30
1651083692033,MATH 18,B04,083751,Staff,0,13,30,30
1651083698059,MATH 20A,A01,083754,Staff,18,0,40,22
1651083704083,MATH 20B,A01,083756,Staff,0,14,30,30
1651083704083,MATH 20B,A02,083757,Staff,0,11,30,30
1651083710107,MATH 20C,A01,083760,Staff,0,16,30,30
1651083710107,MATH 20C,A02,083761,Staff,0,15,30,30
1651083710107,MATH 20C,B01,083762,Staff,7,0,30,23
1651083710107,MATH 20C,B02,083763,Staff,27,0,30,3
1651083716140,MATH 20D,A01,083765,Staff,3,1,30,27
1651083716140,MATH 20D,A02,083766,Staff,1,0,30,29
1651083716140,MATH 20D,A03,083767,Staff,22,0,30,8
1651083722164,MATH 20E,A01,083771,Staff,2,0,30,28
1651083722164,MATH 20E,A02,083772,Staff,10,0,30,20
1651083722164,MATH 20E,B01,083773,Staff,0,0,30,30
1651083722164,MATH 20E,B02,083774,Staff,0,0,30,30
1651083728198,MATH 103A,A01,083777,Staff,0,17,30,30
1651083728198,MATH 103A,A02,083778,Staff,0,17,30,30
1651083728198,MATH 103A,B01,083779,Staff,0,15,30,30
1651083728198,MATH 103A,B02,083780,Staff,0,14,30,30
1651083734235,MATH 105,A01,085443,Staff,0,24,30,30
1651083740259,MATH 109,A01,083213,Anzaldo; Leesa B,0,7,30,30
1651083740259,MATH 109,A02,083214,Anzaldo; Leesa B,0,7,30,30
1651083740259,MATH 109,B01,083215,Anzaldo; Leesa B,0,8,30,30
1651083740259,MATH 109,B02,083216,Anzaldo; Leesa B,0,8,30,30
1651083746289,MATH 142A,A01,083219,Chow; Bennett,0,15,30,30
1651083746289,MATH 142A,A02,083220,Chow; Bennett,0,15,30,30
1651083746289,MATH 142A,B01,083221,Chow; Bennett,0,16,30,30
1651083746289,MATH 142A,B02,083222,Chow; Bennett,0,15,30,30
1651083752316,MATH 193A,A01,083224,Staff,0,9,30,30
1651083752316,MATH 193A,A02,083225,Staff,0,7,30,30
1651083752316,MATH 193A,A03,083781,Staff,0,7,30,30
1651083752316,MATH 193A,A04,083782,Staff,0,7,30,30
1651083758338,MATH 197,001,091859,McAuley; Julian John,9998,0,9999,1
1651083764389,COGS 9,A01,083615,Staff,0,20,60,60
1651083770414,COGS 11,A01,083617,Boyle; Mary E. T.,13,0,40,27
1651083776436,COGS 13,A01,083071,Staff,0,38,40,40
1651083782464,COGS 14A,A01,092681,Staff,0,39,100,100
1651083788487,COGS 14B,A01,083073,Cheng; Tzu-Han,0,13,50,50
1651083794512,COGS 17,A01,092677,Staff,9,0,75,66
1651083800541,COGS 100,A01,083619,Staff,0,30,60,60
1651083806567,COGS 101A,A01,083621,Davis; Joshua Daniel,0,29,60,60
1651083812589,COGS 101B,A01,091572,Staff,0,8,60,60
1651083818616,COGS 101C,A01,083625,Delgado; Tania,13,0,30,17
1651083824638,COGS 107A,A01,083627,Boyle; Mary E. T.,0,17,60,60
1651083830664,COGS 118A,A01,083075,Staff,0,10,60,60
1651083836689,CSE 3,A50,083646,Miranda; Gregory Joseph,15,0,38,23
1651083836689,CSE 3,A51,083647,Miranda; Gregory Joseph,36,0,37,1
1651083842716,CSE 8A,A50,083650,Miranda; Gregory Joseph,0,31,40,40
1651083848864,CSE 11,A01,083080,Cao; Yingjun,1,98,40,39
1651083854898,CSE 12,A01,083652,Staff,0,27,100,100
1651083860928,CSE 15L,A01,083654,Staff,0,3,50,50
1651083860928,CSE 15L,A02,083655,Staff,0,3,50,50
1651083866951,CSE 20,A01,083657,Staff,46,0,80,34
1651083872982,CSE 30,A01,083084,Eldon; John,0,38,80,80
1651083879012,CSE 100,A01,083659,Cao; Yingjun,0,72,50,50
1651083885046,CSE 134B,A01,083661,Powell; Thomas Allan,0,38,65,65
1651083891085,CSE 140,A01,083663,Staff,0,15,75,75
1651083897124,CSE 140L,A01,083088,Eldon; John,3,0,100,97
1651083903149,CSE 175,A01,083665,Kumar; Rakesh,0,0,25,25
1651083909173,CSE 190,A00,092507,Dubnov; Shlomo,9,0,20,11
1651083915195,ECE 45,A01,083139,Staff,0,7,60,60
1651083921221,ECE 65,A50,083695,Staff,0,7,30,30
1651083927251,ECE 109,A01,091882,Touri; Behrouz,33,0,70,37
1651083933275,ECE 180,A00,083140,Abi Samra; Nicholas Camill,17,0,30,13
1651083933275,ECE 180,B00,083141,Abi Samra; Nicholas Camill,0,0,30,30
1651083939309,MATH 10A,A01,083735,Patchell; Gregory David,0,0,30,30
1651083939309,MATH 10A,A02,083736,Patchell; Gregory David,27,0,30,3
1651083939309,MATH 10A,A03,083737,Patchell; Gregory David,22,0,30,8
1651083945337,MATH 10B,A01,083207,Staff,0,7,30,30
1651083945337,MATH 10B,A02,083208,Staff,0,6,30,30
1651083945337,MATH 10B,B01,083739,Staff,8,0,30,22
1651083945337,MATH 10B,B02,083740,Staff,28,0,30,2
1651083951361,MATH 18,A01,083743,Staff,0,0,30,30
1651083951361,MATH 18,A02,083744,Staff,23,0,30,7
1651083951361,MATH 18,A03,083745,Staff,19,0,30,11
1651083951361,MATH 18,A04,083746,Staff,26,0,30,4
1651083951361,MATH 18,B01,083748,Staff,0,16,30,30
1651083951361,MATH 18,B02,083749,Staff,0,14,30,30
1651083951361,MATH 18,B03,083750,Staff,0,14,30,30
1651083951361,MATH 18,B04,083751,Staff,0,13,30,30
1651083957385,MATH 20A,A01,083754,Staff,18,0,40,22
1651083963418,MATH 20B,A01,083756,Staff,0,14,30,30
1651083963418,MATH 20B,A02,083757,Staff,0,11,30,30
1651083969441,MATH 20C,A01,083760,Staff,0,16,30,30
1651083969441,MATH 20C,A02,083761,Staff,0,15,30,30
1651083969441,MATH 20C,B01,083762,Staff,7,0,30,23
1651083969441,MATH 20C,B02,083763,Staff,27,0,30,3
1651083975465,MATH 20D,A01,083765,Staff,3,1,30,27
1651083975465,MATH 20D,A02,083766,Staff,1,0,30,29
1651083975465,MATH 20D,A03,083767,Staff,22,0,30,8
1651083981500,MATH 20E,A01,083771,Staff,2,0,30,28
1651083981500,MATH 20E,A02,083772,Staff,10,0,30,20
1651083981500,MATH 20E,B01,083773,Staff,0,0,30,30
1651083981500,MATH 20E,B02,083774,Staff,0,0,30,30
1651083987529,MATH 103A,A01,083777,Staff,0,17,30,30
1651083987529,MATH 103A,A02,083778,Staff,0,17,30,30
1651083987529,MATH 103A,B01,083779,Staff,0,15,30,30
1651083987529,MATH 103A,B02,083780,Staff,0,14,30,30
1651083993561,MATH 105,A01,085443,Staff,0,24,30,30
1651083999599,MATH 109,A01,083213,Anzaldo; Leesa B,0,7,30,30
1651083999599,MATH 109,A02,083214,Anzaldo; Leesa B,0,7,30,30
1651083999599,MATH 109,B01,083215,Anzaldo; Leesa B,0,8,30,30
1651083999599,MATH 109,B02,083216,Anzaldo; Leesa B,0,8,30,30
1651084005627,MATH 142A,A01,083219,Chow; Bennett,0,15,30,30
1651084005627,MATH 142A,A02,083220,Chow; Bennett,0,15,30,30
1651084005627,MATH 142A,B01,083221,Chow; Bennett,0,16,30,30
1651084005627,MATH 142A,B02,083222,Chow; Bennett,0,15,30,30
1651084011650,MATH 193A,A01,083224,Staff,0,9,30,30
1651084011650,MATH 193A,A02,083225,Staff,0,7,30,30
1651084011650,MATH 193A,A03,083781,Staff,0,7,30,30
1651084011650,MATH 193A,A04,083782,Staff,0,7,30,30
1651084017676,MATH 197,001,091859,McAuley; Julian John,9998,0,9999,1
1651084023736,COGS 9,A01,083615,Staff,0,20,60,60
1651084029762,COGS 11,A01,083617,Boyle; Mary E. T.,13,0,40,27
1651084035785,COGS 13,A01,083071,Staff,0,38,40,40
1651084041809,COGS 14A,A01,092681,Staff,0,39,100,100
1651084047833,COGS 14B,A01,083073,Cheng; Tzu-Han,0,13,50,50
1651084053860,COGS 17,A01,092677,Staff,9,0,75,66
1651084059883,COGS 100,A01,083619,Staff,0,30,60,60
1651084065907,COGS 101A,A01,083621,Davis; Joshua Daniel,0,29,60,60
1651084071949,COGS 101B,A01,091572,Staff,0,8,60,60
1651084077978,COGS 101C,A01,083625,Delgado; Tania,13,0,30,17
1651084084006,COGS 107A,A01,083627,Boyle; Mary E. T.,0,17,60,60
1651084090032,COGS 118A,A01,083075,Staff,0,10,60,60
1651084096060,CSE 3,A50,083646,Miranda; Gregory Joseph,15,0,38,23
1651084096060,CSE 3,A51,083647,Miranda; Gregory Joseph,36,0,37,1
1651084102084,CSE 8A,A50,083650,Miranda; Gregory Joseph,0,31,40,40
1651084108108,CSE 11,A01,083080,Cao; Yingjun,1,98,40,39
1651084114132,CSE 12,A01,083652,Staff,0,27,100,100
1651084120158,CSE 15L,A01,083654,Staff,0,3,50,50
1651084120158,CSE 15L,A02,083655,Staff,0,3,50,50
1651084126183,CSE 20,A01,083657,Staff,46,0,80,34
1651084132216,CSE 30,A01,083084,Eldon; John,0,38,80,80
1651084138241,CSE 100,A01,083659,Cao; Yingjun,0,72,50,50
1651084144265,CSE 134B,A01,083661,Powell; Thomas Allan,0,38,65,65
1651084150289,CSE 140,A01,083663,Staff,0,15,75,75
1651084156320,CSE 140L,A01,083088,Eldon; John,3,0,100,97
1651084162347,CSE 175,A01,083665,Kumar; Rakesh,0,0,25,25
1651084168369,CSE 190,A00,092507,Dubnov; Shlomo,9,0,20,11
1651084174395,ECE 45,A01,083139,Staff,0,7,60,60
1651084180425,ECE 65,A50,083695,Staff,0,7,30,30
1651084186449,ECE 109,A01,091882,Touri; Behrouz,33,0,70,37
1651084192473,ECE 180,A00,083140,Abi Samra; Nicholas Camill,17,0,30,13
1651084192473,ECE 180,B00,083141,Abi Samra; Nicholas Camill,0,0,30,30
1651084198496,MATH 10A,A01,083735,Patchell; Gregory David,0,0,30,30
1651084198496,MATH 10A,A02,083736,Patchell; Gregory David,27,0,30,3
1651084198496,MATH 10A,A03,083737,Patchell; Gregory David,22,0,30,8
1651084204533,MATH 10B,A01,083207,Staff,0,7,30,30
1651084204533,MATH 10B,A02,083208,Staff,0,6,30,30
1651084204533,MATH 10B,B01,083739,Staff,8,0,30,22
1651084204533,MATH 10B,B02,083740,Staff,28,0,30,2
1651084210563,MATH 18,A01,083743,Staff,0,0,30,30
1651084210563,MATH 18,A02,083744,Staff,23,0,30,7
1651084210563,MATH 18,A03,083745,Staff,19,0,30,11
1651084210563,MATH 18,A04,083746,Staff,26,0,30,4
1651084210563,MATH 18,B01,083748,Staff,0,16,30,30
1651084210563,MATH 18,B02,083749,Staff,0,14,30,30
1651084210563,MATH 18,B03,083750,Staff,0,14,30,30
1651084210563,MATH 18,B04,083751,Staff,0,13,30,30
1651084216605,MATH 20A,A01,083754,Staff,18,0,40,22
1651084222629,MATH 20B,A01,083756,Staff,0,14,30,30
1651084222629,MATH 20B,A02,083757,Staff,0,11,30,30
1651084228657,MATH 20C,A01,083760,Staff,0,16,30,30
1651084228657,MATH 20C,A02,083761,Staff,0,15,30,30
1651084228657,MATH 20C,B01,083762,Staff,7,0,30,23
1651084228657,MATH 20C,B02,083763,Staff,27,0,30,3
1651084234685,MATH 20D,A01,083765,Staff,3,1,30,27
1651084234685,MATH 20D,A02,083766,Staff,1,0,30,29
1651084234685,MATH 20D,A03,083767,Staff,22,0,30,8
1651084240721,MATH 20E,A01,083771,Staff,2,0,30,28
1651084240721,MATH 20E,A02,083772,Staff,10,0,30,20
1651084240721,MATH 20E,B01,083773,Staff,0,0,30,30
1651084240721,MATH 20E,B02,083774,Staff,0,0,30,30
1651084246744,MATH 103A,A01,083777,Staff,0,17,30,30
1651084246744,MATH 103A,A02,083778,Staff,0,17,30,30
1651084246744,MATH 103A,B01,083779,Staff,0,15,30,30
1651084246744,MATH 103A,B02,083780,Staff,0,14,30,30
1651084252773,MATH 105,A01,085443,Staff,0,24,30,30
1651084258806,MATH 109,A01,083213,Anzaldo; Leesa B,0,7,30,30
1651084258806,MATH 109,A02,083214,Anzaldo; Leesa B,0,7,30,30
1651084258806,MATH 109,B01,083215,Anzaldo; Leesa B,0,8,30,30
1651084258806,MATH 109,B02,083216,Anzaldo; Leesa B,0,8,30,30
1651084264835,MATH 142A,A01,083219,Chow; Bennett,0,15,30,30
1651084264835,MATH 142A,A02,083220,Chow; Bennett,0,15,30,30
1651084264835,MATH 142A,B01,083221,Chow; Bennett,0,16,30,30
1651084264835,MATH 142A,B02,083222,Chow; Bennett,0,15,30,30
1651084270868,MATH 193A,A01,083224,Staff,0,9,30,30
1651084270868,MATH 193A,A02,083225,Staff,0,7,30,30
1651084270868,MATH 193A,A03,083781,Staff,0,7,30,30
1651084270868,MATH 193A,A04,083782,Staff,0,7,30,30
1651084276895,MATH 197,001,091859,McAuley; Julian John,9998,0,9999,1
1651084282954,COGS 9,A01,083615,Staff,0,20,60,60
1651084288981,COGS 11,A01,083617,Boyle; Mary E. T.,13,0,40,27
1651084295007,COGS 13,A01,083071,Staff,0,38,40,40
1651084301034,COGS 14A,A01,092681,Staff,0,39,100,100
1651084307061,COGS 14B,A01,083073,Cheng; Tzu-Han,0,13,50,50
1651084313092,COGS 17,A01,092677,Staff,9,0,75,66
1651084319120,COGS 100,A01,083619,Staff,0,30,60,60
1651084325143,COGS 101A,A01,083621,Davis; Joshua Daniel,0,29,60,60
1651084331164,COGS 101B,A01,091572,Staff,0,8,60,60
1651084337192,COGS 101C,A01,083625,Delgado; Tania,13,0,30,17
1651084343216,COGS 107A,A01,083627,Boyle; Mary E. T.,0,17,60,60
1651084349240,COGS 118A,A01,083075,Staff,0,10,60,60
1651084355271,CSE 3,A50,083646,Miranda; Gregory Joseph,15,0,38,23
1651084355271,CSE 3,A51,083647,Miranda; Gregory Joseph,36,0,37,1
1651084361305,CSE 8A,A50,083650,Miranda; Gregory Joseph,0,31,40,40
1651084367337,CSE 11,A01,083080,Cao; Yingjun,1,98,40,39
1651084373359,CSE 12,A01,083652,Staff,0,27,100,100
1651084379383,CSE 15L,A01,083654,Staff,0,3,50,50
1651084379383,CSE 15L,A02,083655,Staff,0,3,50,50
1651084385405,CSE 20,A01,083657,Staff,46,0,80,34
1651084391426,CSE 30,A01,083084,Eldon; John,0,38,80,80
1651084397456,CSE 100,A01,083659,Cao; Yingjun,0,72,50,50
1651084403481,CSE 134B,A01,083661,Powell; Thomas Allan,0,38,65,65
1651084409504,CSE 140,A01,083663,Staff,0,15,75,75
1651084415527,CSE 140L,A01,083088,Eldon; John,3,0,100,97
1651084421548,CSE 175,A01,083665,Kumar; Rakesh,0,0,25,25
1651084427579,CSE 190,A00,092507,Dubnov; Shlomo,9,0,20,11
1651084433611,ECE 45,A01,083139,Staff,0,7,60,60
1651084439639,ECE 65,A50,083695,Staff,0,7,30,30
1651084445759,ECE 109,A01,091882,Touri; Behrouz,33,0,70,37
1651084451784,ECE 180,A00,083140,Abi Samra; Nicholas Camill,17,0,30,13
1651084451784,ECE 180,B00,083141,Abi Samra; Nicholas Camill,0,0,30,30
1651084457817,MATH 10A,A01,083735,Patchell; Gregory David,0,0,30,30
1651084457817,MATH 10A,A02,083736,Patchell; Gregory David,27,0,30,3
1651084457817,MATH 10A,A03,083737,Patchell; Gregory David,22,0,30,8
1651084463838,MATH 10B,A01,083207,Staff,0,7,30,30
1651084463838,MATH 10B,A02,083208,Staff,0,6,30,30
1651084463838,MATH 10B,B01,083739,Staff,8,0,30,22
1651084463838,MATH 10B,B02,083740,Staff,28,0,30,2
1651084469867,MATH 18,A01,083743,Staff,0,0,30,30
1651084469867,MATH 18,A02,083744,Staff,23,0,30,7
1651084469867,MATH 18,A03,083745,Staff,19,0,30,11
1651084469867,MATH 18,A04,083746,Staff,26,0,30,4
1651084469867,MATH 18,B01,083748,Staff,0,16,30,30
1651084469867,MATH 18,B02,083749,Staff,0,14,30,30
1651084469867,MATH 18,B03,083750,Staff,0,14,30,30
1651084469867,MATH 18,B04,083751,Staff,0,13,30,30
1651084475892,MATH 20A,A01,083754,Staff,18,0,40,22
1651084481924,MATH 20B,A01,083756,Staff,0,14,30,30
1651084481924,MATH 20B,A02,083757,Staff,0,11,30,30
1651084487946,MATH 20C,A01,083760,Staff,0,16,30,30
1651084487946,MATH 20C,A02,083761,Staff,0,15,30,30
1651084487946,MATH 20C,B01,083762,Staff,7,0,30,23
1651084487946,MATH 20C,B02,083763,Staff,27,0,30,3
1651084493983,MATH 20D,A01,083765,Staff,3,1,30,27
1651084493983,MATH 20D,A02,083766,Staff,1,0,30,29
1651084493983,MATH 20D,A03,083767,Staff,22,0,30,8
1651084500007,MATH 20E,A01,083771,Staff,2,0,30,28
1651084500007,MATH 20E,A02,083772,Staff,10,0,30,20
1651084500007,MATH 20E,B01,083773,Staff,0,0,30,30
1651084500007,MATH 20E,B02,083774,Staff,0,0,30,30
1651084506036,MATH 103A,A01,083777,Staff,0,17,30,30
1651084506036,MATH 103A,A02,083778,Staff,0,17,30,30
1651084506036,MATH 103A,B01,083779,Staff,0,15,30,30
1651084506036,MATH 103A,B02,083780,Staff,0,14,30,30
1651084512063,MATH 105,A01,085443,Staff,0,24,30,30
1651084518094,MATH 109,A01,083213,Anzaldo; Leesa B,0,7,30,30
1651084518094,MATH 109,A02,083214,Anzaldo; Leesa B,0,7,30,30
1651084518094,MATH 109,B01,083215,Anzaldo; Leesa B,0,8,30,30
1651084518094,MATH 109,B02,083216,Anzaldo; Leesa B,0,8,30,30
1651084524121,MATH 142A,A01,083219,Chow; Bennett,0,15,30,30
1651084524121,MATH 142A,A02,083220,Chow; Bennett,0,15,30,30
1651084524121,MATH 142A,B01,083221,Chow; Bennett,0,16,30,30
1651084524121,MATH 142A,B02,083222,Chow; Bennett,0,15,30,30
1651084530148,MATH 193A,A01,083224,Staff,0,9,30,30
1651084530148,MATH 193A,A02,083225,Staff,0,7,30,30
1651084530148,MATH 193A,A03,083781,Staff,0,7,30,30
1651084530148,MATH 193A,A04,083782,Staff,0,7,30,30
1651084536170,MATH 197,001,091859,McAuley; Julian John,9998,0,9999,1
1651084542224,COGS 9,A01,083615,Staff,0,20,60,60
1651084548246,COGS 11,A01,083617,Boyle; Mary E. T.,13,0,40,27
1651084554272,COGS 13,A01,083071,Staff,0,38,40,40
1651084560309,COGS 14A,A01,092681,Staff,0,39,100,100
1651084566330,COGS 14B,A01,083073,Cheng; Tzu-Han,0,13,50,50
1651084572356,COGS 17,A01,092677,Staff,9,0,75,66
1651084578392,COGS 100,A01,083619,Staff,0,30,60,60
1651084584414,COGS 101A,A01,083621,Davis; Joshua Daniel,0,29,60,60
1651084590447,COGS 101B,A01,091572,Staff,0,8,60,60
1651084596471,COGS 101C,A01,083625,Delgado; Tania,13,0,30,17
1651084602499,COGS 107A,A01,083627,Boyle; Mary E. T.,0,17,60,60
1651084608521,COGS 118A,A01,083075,Staff,0,10,60,60
1651084614550,CSE 3,A50,083646,Miranda; Gregory Joseph,15,0,38,23
1651084614550,CSE 3,A51,083647,Miranda; Gregory Joseph,36,0,37,1
1651084620589,CSE 8A,A50,083650,Miranda; Gregory Joseph,0,31,40,40
1651084626612,CSE 11,A01,083080,Cao; Yingjun,1,98,40,39
1651084632643,CSE 12,A01,083652,Staff,0,27,100,100
1651084638669,CSE 15L,A01,083654,Staff,0,3,50,50
1651084638669,CSE 15L,A02,083655,Staff,0,3,50,50
1651084644691,CSE 20,A01,083657,Staff,46,0,80,34
1651084650715,CSE 30,A01,083084,Eldon; John,0,38,80,80
1651084656748,CSE 100,A01,083659,Cao; Yingjun,0,72,50,50
1651084662770,CSE 134B,A01,083661,Powell; Thomas Allan,0,38,65,65
1651084668797,CSE 140,A01,083663,Staff,0,15,75,75
1651084674820,CSE 140L,A01,083088,Eldon; John,3,0,100,97
1651084680845,CSE 175,A01,083665,Kumar; Rakesh,0,0,25,25
1651084686869,CSE 190,A00,092507,Dubnov; Shlomo,9,0,20,11
1651084692892,ECE 45,A01,083139,Staff,0,7,60,60
1651084698918,ECE 65,A50,083695,Staff,0,7,30,30
1651084704945,ECE 109,A01,091882,Touri; Behrouz,33,0,70,37
1651084710969,ECE 180,A00,083140,Abi Samra; Nicholas Camill,17,0,30,13
1651084710969,ECE 180,B00,083141,Abi Samra; Nicholas Camill,0,0,30,30
1651084716991,MATH 10A,A01,083735,Patchell; Gregory David,0,0,30,30
1651084716991,MATH 10A,A02,083736,Patchell; Gregory David,27,0,30,3
1651084716991,MATH 10A,A03,083737,Patchell; Gregory David,22,0,30,8
1651084723020,MATH 10B,A01,083207,Staff,0,7,30,30
1651084723020,MATH 10B,A02,083208,Staff,0,6,30,30
1651084723020,MATH 10B,B01,083739,Staff,8,0,30,22
1651084723020,MATH 10B,B02,083740,Staff,28,0,30,2
1651084729050,MATH 18,A01,083743,Staff,0,0,30,30
1651084729050,MATH 18,A02,083744,Staff,23,0,30,7
1651084729050,MATH 18,A03,083745,Staff,19,0,30,11
1651084729050,MATH 18,A04,083746,Staff,26,0,30,4
1651084729050,MATH 18,B01,083748,Staff,0,16,30,30
1651084729050,MATH 18,B02,083749,Staff,0,14,30,30
1651084729050,MATH 18,B03,083750,Staff,0,14,30,30
1651084729050,MATH 18,B04,083751,Staff,0,13,30,30
1651084735085,MATH 20A,A01,083754,Staff,18,0,40,22
1651084741112,MATH 20B,A01,083756,Staff,0,14,30,30
1651084741112,MATH 20B,A02,083757,Staff,0,11,30,30
1651084747135,MATH 20C,A01,083760,Staff,0,16,30,30
1651084747135,MATH 20C,A02,083761,Staff,0,15,30,30
1651084747135,MATH 20C,B01,083762,Staff,7,0,30,23
1651084747135,MATH 20C,B02,083763,Staff,27,0,30,3
1651084753159,MATH 20D,A01,083765,Staff,3,1,30,27
1651084753159,MATH 20D,A02,083766,Staff,1,0,30,29
1651084753159,MATH 20D,A03,083767,Staff,22,0,30,8
1651084759181,MATH 20E,A01,083771,Staff,2,0,30,28
1651084759181,MATH 20E,A02,083772,Staff,10,0,30,20
1651084759181,MATH 20E,B01,083773,Staff,0,0,30,30
1651084759181,MATH 20E,B02,083774,Staff,0,0,30,30
1651084765205,MATH 103A,A01,083777,Staff,0,17,30,30
1651084765205,MATH 103A,A02,083778,Staff,0,17,30,30
1651084765205,MATH 103A,B01,083779,Staff,0,15,30,30
1651084765205,MATH 103A,B02,083780,Staff,0,14,30,30
1651084781555,MATH 105,A01,085443,Staff,0,24,30,30
1651084787582,MATH 109,A01,083213,Anzaldo; Leesa B,0,7,30,30
1651084787582,MATH 109,A02,083214,Anzaldo; Leesa B,0,7,30,30
1651084787582,MATH 109,B01,083215,Anzaldo; Leesa B,0,8,30,30
1651084787582,MATH 109,B02,083216,Anzaldo; Leesa B,0,8,30,30
1651084793606,MATH 142A,A01,083219,Chow; Bennett,0,15,30,30
1651084793606,MATH 142A,A02,083220,Chow; Bennett,0,15,30,30
1651084793606,MATH 142A,B01,083221,Chow; Bennett,0,16,30,30
1651084793606,MATH 142A,B02,083222,Chow; Bennett,0,15,30,30
1651084799632,MATH 193A,A01,083224,Staff,0,9,30,30
1651084799632,MATH 193A,A02,083225,Staff,0,7,30,30
1651084799632,MATH 193A,A03,083781,Staff,0,7,30,30
1651084799632,MATH 193A,A04,083782,Staff,0,7,30,30
1651084805671,MATH 197,001,091859,McAuley; Julian John,9998,0,9999,1
1651084811751,COGS 9,A01,083615,Staff,0,20,60,60
1651084817774,COGS 11,A01,083617,Boyle; Mary E. T.,13,0,40,27
1651084823800,COGS 13,A01,083071,Staff,0,38,40,40
1651084829836,COGS 14A,A01,092681,Staff,0,39,100,100
1651084835859,COGS 14B,A01,083073,Cheng; Tzu-Han,0,13,50,50
1651084841887,COGS 17,A01,092677,Staff,9,0,75,66
1651084847921,COGS 100,A01,083619,Staff,0,30,60,60
1651084853953,COGS 101A,A01,083621,Davis; Joshua Daniel,0,29,60,60
1651084859988,COGS 101B,A01,091572,Staff,0,8,60,60
1651084866016,COGS 101C,A01,083625,Delgado; Tania,13,0,30,17
1651084872048,COGS 107A,A01,083627,Boyle; Mary E. T.,0,17,60,60
1651084878072,COGS 118A,A01,083075,Staff,0,10,60,60
1651084884100,CSE 3,A50,083646,Miranda; Gregory Joseph,15,0,38,23
1651084884100,CSE 3,A51,083647,Miranda; Gregory Joseph,36,0,37,1
1651084890129,CSE 8A,A50,083650,Miranda; Gregory Joseph,0,31,40,40
1651084896151,CSE 11,A01,083080,Cao; Yingjun,1,98,40,39
1651084902175,CSE 12,A01,083652,Staff,0,27,100,100
1651084908198,CSE 15L,A01,083654,Staff,0,3,50,50
1651084908198,CSE 15L,A02,083655,Staff,0,3,50,50
1651084914221,CSE 20,A01,083657,Staff,46,0,80,34
1651084920252,CSE 30,A01,083084,Eldon; John,0,38,80,80
1651084926277,CSE 100,A01,083659,Cao; Yingjun,0,72,50,50
1651084932302,CSE 134B,A01,083661,Powell; Thomas Allan,0,38,65,65
1651084938328,CSE 140,A01,083663,Staff,0,15,75,75
1651084944351,CSE 140L,A01,083088,Eldon; John,3,0,100,97
1651084950374,CSE 175,A01,083665,Kumar; Rakesh,0,0,25,25
1651084956399,CSE 190,A00,092507,Dubnov; Shlomo,9,0,20,11
1651084962430,ECE 45,A01,083139,Staff,0,7,60,60
1651084968455,ECE 65,A50,083695,Staff,0,7,30,30
1651084974493,ECE 109,A01,091882,Touri; Behrouz,33,0,70,37
1651084980513,ECE 180,A00,083140,Abi Samra; Nicholas Camill,17,0,30,13
1651084980513,ECE 180,B00,083141,Abi Samra; Nicholas Camill,0,0,30,30
1651084986556,MATH 10A,A01,083735,Patchell; Gregory David,0,0,30,30
1651084986556,MATH 10A,A02,083736,Patchell; Gregory David,27,0,30,3
1651084986556,MATH 10A,A03,083737,Patchell; Gregory David,22,0,30,8
1651084992580,MATH 10B,A01,083207,Staff,0,7,30,30
1651084992580,MATH 10B,A02,083208,Staff,0,6,30,30
1651084992580,MATH 10B,B01,083739,Staff,8,0,30,22
1651084992580,MATH 10B,B02,083740,Staff,28,0,30,2
1651084998603,MATH 18,A01,083743,Staff,0,0,30,30
1651084998603,MATH 18,A02,083744,Staff,23,0,30,7
1651084998603,MATH 18,A03,083745,Staff,19,0,30,11
1651084998603,MATH 18,A04,083746,Staff,26,0,30,4
1651084998603,MATH 18,B01,083748,Staff,0,16,30,30
1651084998603,MATH 18,B02,083749,Staff,0,14,30,30
1651084998603,MATH 18,B03,083750,Staff,0,14,30,30
1651084998603,MATH 18,B04,083751,Staff,0,13,30,30
1651085004630,MATH 20A,A01,083754,Staff,18,0,40,22
1651085010659,MATH 20B,A01,083756,Staff,0,14,30,30
1651085010659,MATH 20B,A02,083757,Staff,0,11,30,30
1651085016693,MATH 20C,A01,083760,Staff,0,16,30,30
1651085016693,MATH 20C,A02,083761,Staff,0,15,30,30
1651085016693,MATH 20C,B01,083762,Staff,7,0,30,23
1651085016693,MATH 20C,B02,083763,Staff,27,0,30,3
1651085022718,MATH 20D,A01,083765,Staff,3,1,30,27
1651085022718,MATH 20D,A02,083766,Staff,1,0,30,29
1651085022718,MATH 20D,A03,083767,Staff,22,0,30,8
1651085028743,MATH 20E,A01,083771,Staff,2,0,30,28
1651085028743,MATH 20E,A02,083772,Staff,10,0,30,20
1651085028743,MATH 20E,B01,083773,Staff,0,0,30,30
1651085028743,MATH 20E,B02,083774,Staff,0,0,30,30
1651085034767,MATH 103A,A01,083777,Staff,0,17,30,30
1651085034767,MATH 103A,A02,083778,Staff,0,17,30,30
1651085034767,MATH 103A,B01,083779,Staff,0,15,30,30
1651085034767,MATH 103A,B02,083780,Staff,0,14,30,30
1651085040790,MATH 105,A01,085443,Staff,0,24,30,30
1651085046908,MATH 109,A01,083213,Anzaldo; Leesa B,0,7,30,30
1651085046908,MATH 109,A02,083214,Anzaldo; Leesa B,0,7,30,30
1651085046908,MATH 109,B01,083215,Anzaldo; Leesa B,0,8,30,30
1651085046908,MATH 109,B02,083216,Anzaldo; Leesa B,0,8,30,30
1651085052950,MATH 142A,A01,083219,Chow; Bennett,0,15,30,30
1651085052950,MATH 142A,A02,083220,Chow; Bennett,0,15,30,30
1651085052950,MATH 142A,B01,083221,Chow; Bennett,0,16,30,30
1651085052950,MATH 142A,B02,083222,Chow; Bennett,0,15,30,30
1651085058977,MATH 193A,A01,083224,Staff,0,9,30,30
1651085058977,MATH 193A,A02,083225,Staff,0,7,30,30
1651085058977,MATH 193A,A03,083781,Staff,0,7,30,30
1651085058977,MATH 193A,A04,083782,Staff,0,7,30,30
1651085065006,MATH 197,001,091859,McAuley; Julian John,9998,0,9999,1
1651085071057,COGS 9,A01,083615,Staff,0,20,60,60
1651085077087,COGS 11,A01,083617,Boyle; Mary E. T.,13,0,40,27
1651085083119,COGS 13,A01,083071,Staff,0,38,40,40
1651085089143,COGS 14A,A01,092681,Staff,0,39,100,100
1651085095166,COGS 14B,A01,083073,Cheng; Tzu-Han,0,13,50,50
1651085101196,COGS 17,A01,092677,Staff,9,0,75,66
1651085107217,COGS 100,A01,083619,Staff,0,30,60,60
1651085113240,COGS 101A,A01,083621,Davis; Joshua Daniel,0,29,60,60
1651085119268,COGS 101B,A01,091572,Staff,0,8,60,60
1651085125300,COGS 101C,A01,083625,Delgado; Tania,13,0,30,17
1651085131330,COGS 107A,A01,083627,Boyle; Mary E. T.,0,17,60,60
1651085137353,COGS 118A,A01,083075,Staff,0,10,60,60
1651085143380,CSE 3,A50,083646,Miranda; Gregory Joseph,15,0,38,23
1651085143380,CSE 3,A51,083647,Miranda; Gregory Joseph,36,0,37,1
1651085149404,CSE 8A,A50,083650,Miranda; Gregory Joseph,0,31,40,40
1651085155426,CSE 11,A01,083080,Cao; Yingjun,1,98,40,39
1651085161451,CSE 12,A01,083652,Staff,0,27,100,100
1651085167481,CSE 15L,A01,083654,Staff,0,3,50,50
1651085167481,CSE 15L,A02,083655,Staff,0,3,50,50
1651085173505,CSE 20,A01,083657,Staff,46,0,80,34
1651085179529,CSE 30,A01,083084,Eldon; John,0,38,80,80
1651085185557,CSE 100,A01,083659,Cao; Yingjun,0,72,50,50
1651085191580,CSE 134B,A01,083661,Powell; Thomas Allan,0,38,65,65
1651085197607,CSE 140,A01,083663,Staff,0,15,75,75
1651085203637,CSE 140L,A01,083088,Eldon; John,3,0,100,97
1651085209667,CSE 175,A01,083665,Kumar; Rakesh,0,0,25,25
1651085215690,CSE 190,A00,092507,Dubnov; Shlomo,9,0,20,11
1651085221715,ECE 45,A01,083139,Staff,0,7,60,60
1651085227738,ECE 65,A50,083695,Staff,0,7,30,30
1651085233761,ECE 109,A01,091882,Touri; Behrouz,33,0,70,37
1651085239784,ECE 180,A00,083140,Abi Samra; Nicholas Camill,17,0,30,13
1651085239784,ECE 180,B00,083141,Abi Samra; Nicholas Camill,0,0,30,30
1651085245812,MATH 10A,A01,083735,Patchell; Gregory David,0,0,30,30
1651085245812,MATH 10A,A02,083736,Patchell; Gregory David,27,0,30,3
1651085245812,MATH 10A,A03,083737,Patchell; Gregory David,22,0,30,8
1651085251835,MATH 10B,A01,083207,Staff,0,7,30,30
1651085251835,MATH 10B,A02,083208,Staff,0,6,30,30
1651085251835,MATH 10B,B01,083739,Staff,8,0,30,22
1651085251835,MATH 10B,B02,083740,Staff,28,0,30,2
1651085257871,MATH 18,A01,083743,Staff,0,0,30,30
1651085257871,MATH 18,A02,083744,Staff,23,0,30,7
1651085257871,MATH 18,A03,083745,Staff,19,0,30,11
1651085257871,MATH 18,A04,083746,Staff,26,0,30,4
1651085257871,MATH 18,B01,083748,Staff,0,16,30,30
1651085257871,MATH 18,B02,083749,Staff,0,14,30,30
1651085257871,MATH 18,B03,083750,Staff,0,14,30,30
1651085257871,MATH 18,B04,083751,Staff,0,13,30,30
1651085263893,MATH 20A,A01,083754,Staff,18,0,40,22
1651085269916,MATH 20B,A01,083756,Staff,0,14,30,30
1651085269916,MATH 20B,A02,083757,Staff,0,11,30,30
1651085275944,MATH 20C,A01,083760,Staff,0,16,30,30
1651085275944,MATH 20C,A02,083761,Staff,0,15,30,30
1651085275944,MATH 20C,B01,083762,Staff,7,0,30,23
1651085275944,MATH 20C,B02,083763,Staff,27,0,30,3
1651085281971,MATH 20D,A01,083765,Staff,3,1,30,27
1651085281971,MATH 20D,A02,083766,Staff,1,0,30,29
1651085281971,MATH 20D,A03,083767,Staff,22,0,30,8
1651085287995,MATH 20E,A01,083771,Staff,2,0,30,28
1651085287995,MATH 20E,A02,083772,Staff,10,0,30,20
1651085287995,MATH 20E,B01,083773,Staff,0,0,30,30
1651085287995,MATH 20E,B02,083774,Staff,0,0,30,30
1651085294020,MATH 103A,A01,083777,Staff,0,17,30,30
1651085294020,MATH 103A,A02,083778,Staff,0,17,30,30
1651085294020,MATH 103A,B01,083779,Staff,0,15,30,30
1651085294020,MATH 103A,B02,083780,Staff,0,14,30,30
1651085300042,MATH 105,A01,085443,Staff,0,24,30,30
1651085306066,MATH 109,A01,083213,Anzaldo; Leesa B,0,7,30,30
1651085306066,MATH 109,A02,083214,Anzaldo; Leesa B,0,7,30,30
1651085306066,MATH 109,B01,083215,Anzaldo; Leesa B,0,8,30,30
1651085306066,MATH 109,B02,083216,Anzaldo; Leesa B,0,8,30,30
1651085312093,MATH 142A,A01,083219,Chow; Bennett,0,15,30,30
1651085312093,MATH 142A,A02,083220,Chow; Bennett,0,15,30,30
1651085312093,MATH 142A,B01,083221,Chow; Bennett,0,16,30,30
1651085312093,MATH 142A,B02,083222,Chow; Bennett,0,15,30,30
1651085318118,MATH 193A,A01,083224,Staff,0,9,30,30
1651085318118,MATH 193A,A02,083225,Staff,0,7,30,30
1651085318118,MATH 193A,A03,083781,Staff,0,7,30,30
1651085318118,MATH 193A,A04,083782,Staff,0,7,30,30
1651085324142,MATH 197,001,091859,McAuley; Julian John,9998,0,9999,1
1651085330201,COGS 9,A01,083615,Staff,0,20,60,60
1651085336231,COGS 11,A01,083617,Boyle; Mary E. T.,13,0,40,27
1651085342264,COGS 13,A01,083071,Staff,0,38,40,40
1651085348297,COGS 14A,A01,092681,Staff,0,39,100,100
1651085354320,COGS 14B,A01,083073,Cheng; Tzu-Han,0,13,50,50
1651085360345,COGS 17,A01,092677,Staff,9,0,75,66
1651085366372,COGS 100,A01,083619,Staff,0,30,60,60
1651085372400,COGS 101A,A01,083621,Davis; Joshua Daniel,0,29,60,60
1651085378425,COGS 101B,A01,091572,Staff,0,8,60,60
1651085384449,COGS 101C,A01,083625,Delgado; Tania,13,0,30,17
1651085390473,COGS 107A,A01,083627,Boyle; Mary E. T.,0,17,60,60
1651085396503,COGS 118A,A01,083075,Staff,0,10,60,60
1651085402531,CSE 3,A50,083646,Miranda; Gregory Joseph,15,0,38,23
1651085402531,CSE 3,A51,083647,Miranda; Gregory Joseph,36,0,37,1
1651085408560,CSE 8A,A50,083650,Miranda; Gregory Joseph,0,31,40,40
1651085414586,CSE 11,A01,083080,Cao; Yingjun,1,98,40,39
1651085420612,CSE 12,A01,083652,Staff,0,27,100,100
1651085426636,CSE 15L,A01,083654,Staff,0,3,50,50
1651085426636,CSE 15L,A02,083655,Staff,0,3,50,50
1651085432660,CSE 20,A01,083657,Staff,46,0,80,34
1651085438686,CSE 30,A01,083084,Eldon; John,0,38,80,80
1651085444712,CSE 100,A01,083659,Cao; Yingjun,0,72,50,50
1651085450741,CSE 134B,A01,083661,Powell; Thomas Allan,0,38,65,65
1651085456765,CSE 140,A01,083663,Staff,0,15,75,75
1651085462789,CSE 140L,A01,083088,Eldon; John,3,0,100,97
1651085468815,CSE 175,A01,083665,Kumar; Rakesh,0,0,25,25
1651085474848,CSE 190,A00,092507,Dubnov; Shlomo,9,0,20,11
1651085480871,ECE 45,A01,083139,Staff,0,7,60,60
1651085486899,ECE 65,A50,083695,Staff,0,7,30,30
1651085492940,ECE 109,A01,091882,Touri; Behrouz,33,0,70,37
1651085498965,ECE 180,A00,083140,Abi Samra; Nicholas Camill,17,0,30,13
1651085498965,ECE 180,B00,083141,Abi Samra; Nicholas Camill,0,0,30,30
1651085504990,MATH 10A,A01,083735,Patchell; Gregory David,0,0,30,30
1651085504990,MATH 10A,A02,083736,Patchell; Gregory David,27,0,30,3
1651085504990,MATH 10A,A03,083737,Patchell; Gregory David,22,0,30,8
1651085511019,MATH 10B,A01,083207,Staff,0,7,30,30
1651085511019,MATH 10B,A02,083208,Staff,0,6,30,30
1651085511019,MATH 10B,B01,083739,Staff,8,0,30,22
1651085511019,MATH 10B,B02,083740,Staff,28,0,30,2
1651085517057,MATH 18,A01,083743,Staff,0,0,30,30
1651085517057,MATH 18,A02,083744,Staff,23,0,30,7
1651085517057,MATH 18,A03,083745,Staff,19,0,30,11
1651085517057,MATH 18,A04,083746,Staff,26,0,30,4
1651085517057,MATH 18,B01,083748,Staff,0,16,30,30
1651085517057,MATH 18,B02,083749,Staff,0,14,30,30
1651085517057,MATH 18,B03,083750,Staff,0,14,30,30
1651085517057,MATH 18,B04,083751,Staff,0,13,30,30
1651085523087,MATH 20A,A01,083754,Staff,18,0,40,22
1651085529111,MATH 20B,A01,083756,Staff,0,14,30,30
1651085529111,MATH 20B,A02,083757,Staff,0,11,30,30
1651085535136,MATH 20C,A01,083760,Staff,0,16,30,30
1651085535136,MATH 20C,A02,083761,Staff,0,15,30,30
1651085535136,MATH 20C,B01,083762,Staff,7,0,30,23
1651085535136,MATH 20C,B02,083763,Staff,27,0,30,3
1651085541172,MATH 20D,A01,083765,Staff,3,1,30,27
1651085541172,MATH 20D,A02,083766,Staff,1,0,30,29
1651085541172,MATH 20D,A03,083767,Staff,22,0,30,8
1651085547196,MATH 20E,A01,083771,Staff,2,0,30,28
1651085547196,MATH 20E,A02,083772,Staff,10,0,30,20
1651085547196,MATH 20E,B01,083773,Staff,0,0,30,30
1651085547196,MATH 20E,B02,083774,Staff,0,0,30,30
1651085553249,MATH 103A,A01,083777,Staff,0,17,30,30
1651085553249,MATH 103A,A02,083778,Staff,0,17,30,30
1651085553249,MATH 103A,B01,083779,Staff,0,15,30,30
1651085553249,MATH 103A,B02,083780,Staff,0,14,30,30
1651085559271,MATH 105,A01,085443,Staff,0,24,30,30
1651085565300,MATH 109,A01,083213,Anzaldo; Leesa B,0,7,30,30
1651085565300,MATH 109,A02,083214,Anzaldo; Leesa B,0,7,30,30
1651085565300,MATH 109,B01,083215,Anzaldo; Leesa B,0,8,30,30
1651085565300,MATH 109,B02,083216,Anzaldo; Leesa B,0,8,30,30
1651085571327,MATH 142A,A01,083219,Chow; Bennett,0,15,30,30
1651085571327,MATH 142A,A02,083220,Chow; Bennett,0,15,30,30
1651085571327,MATH 142A,B01,083221,Chow; Bennett,0,16,30,30
1651085571327,MATH 142A,B02,083222,Chow; Bennett,0,15,30,30
1651085577359,MATH 193A,A01,083224,Staff,0,9,30,30
1651085577359,MATH 193A,A02,083225,Staff,0,7,30,30
1651085577359,MATH 193A,A03,083781,Staff,0,7,30,30
1651085577359,MATH 193A,A04,083782,Staff,0,7,30,30
1651085583382,MATH 197,001,091859,McAuley; Julian John,9998,0,9999,1
1651085589442,COGS 9,A01,083615,Staff,0,20,60,60
1651085595467,COGS 11,A01,083617,Boyle; Mary E. T.,13,0,40,27
1651085601489,COGS 13,A01,083071,Staff,0,38,40,40
1651085607524,COGS 14A,A01,092681,Staff,0,39,100,100
1651085613572,COGS 14B,A01,083073,Cheng; Tzu-Han,0,13,50,50
1651085619594,COGS 17,A01,092677,Staff,9,0,75,66
1651085625622,COGS 100,A01,083619,Staff,0,30,60,60
1651085631650,COGS 101A,A01,083621,Davis; Joshua Daniel,0,29,60,60
1651085637749,COGS 101B,A01,091572,Staff,0,8,60,60
1651085643778,COGS 101C,A01,083625,Delgado; Tania,13,0,30,17
1651085649804,COGS 107A,A01,083627,Boyle; Mary E. T.,0,17,60,60
1651085655828,COGS 118A,A01,083075,Staff,0,10,60,60
1651085661854,CSE 3,A50,083646,Miranda; Gregory Joseph,15,0,38,23
1651085661854,CSE 3,A51,083647,Miranda; Gregory Joseph,36,0,37,1
1651085667877,CSE 8A,A50,083650,Miranda; Gregory Joseph,0,31,40,40
1651085673899,CSE 11,A01,083080,Cao; Yingjun,1,98,40,39
1651085679933,CSE 12,A01,083652,Staff,0,27,100,100
1651085685961,CSE 15L,A01,083654,Staff,0,3,50,50
1651085685961,CSE 15L,A02,083655,Staff,0,3,50,50
1651085691987,CSE 20,A01,083657,Staff,46,0,80,34
1651085698009,CSE 30,A01,083084,Eldon; John,0,38,80,80
1651085704032,CSE 100,A01,083659,Cao; Yingjun,0,72,50,50
1651085710054,CSE 134B,A01,083661,Powell; Thomas Allan,0,38,65,65
1651085716077,CSE 140,A01,083663,Staff,0,15,75,75
1651085722101,CSE 140L,A01,083088,Eldon; John,3,0,100,97
1651085728124,CSE 175,A01,083665,Kumar; Rakesh,0,0,25,25
1651085734149,CSE 190,A00,092507,Dubnov; Shlomo,9,0,20,11
1651085740178,ECE 45,A01,083139,Staff,0,7,60,60
1651085746204,ECE 65,A50,083695,Staff,0,7,30,30
1651085752231,ECE 109,A01,091882,Touri; Behrouz,33,0,70,37
1651085758254,ECE 180,A00,083140,Abi Samra; Nicholas Camill,17,0,30,13
1651085758254,ECE 180,B00,083141,Abi Samra; Nicholas Camill,0,0,30,30
1651085764278,MATH 10A,A01,083735,Patchell; Gregory David,0,0,30,30
1651085764278,MATH 10A,A02,083736,Patchell; Gregory David,27,0,30,3
1651085764278,MATH 10A,A03,083737,Patchell; Gregory David,22,0,30,8
1651085770313,MATH 10B,A01,083207,Staff,0,7,30,30
1651085770313,MATH 10B,A02,083208,Staff,0,6,30,30
1651085770313,MATH 10B,B01,083739,Staff,8,0,30,22
1651085770313,MATH 10B,B02,083740,Staff,28,0,30,2
1651085776359,MATH 18,A01,083743,Staff,0,0,30,30
1651085776359,MATH 18,A02,083744,Staff,23,0,30,7
1651085776359,MATH 18,A03,083745,Staff,19,0,30,11
1651085776359,MATH 18,A04,083746,Staff,26,0,30,4
1651085776359,MATH 18,B01,083748,Staff,0,16,30,30
1651085776359,MATH 18,B02,083749,Staff,0,14,30,30
1651085776359,MATH 18,B03,083750,Staff,0,14,30,30
1651085776359,MATH 18,B04,083751,Staff,0,13,30,30
1651085782395,MATH 20A,A01,083754,Staff,18,0,40,22
1651085788418,MATH 20B,A01,083756,Staff,0,14,30,30
1651085788418,MATH 20B,A02,083757,Staff,0,11,30,30
1651085794454,MATH 20C,A01,083760,Staff,0,16,30,30
1651085794454,MATH 20C,A02,083761,Staff,0,15,30,30
1651085794454,MATH 20C,B01,083762,Staff,7,0,30,23
1651085794454,MATH 20C,B02,083763,Staff,27,0,30,3
1651085800478,MATH 20D,A01,083765,Staff,3,1,30,27
1651085800478,MATH 20D,A02,083766,Staff,1,0,30,29
1651085800478,MATH 20D,A03,083767,Staff,22,0,30,8
1651085806504,MATH 20E,A01,083771,Staff,2,0,30,28
1651085806504,MATH 20E,A02,083772,Staff,10,0,30,20
1651085806504,MATH 20E,B01,083773,Staff,0,0,30,30
1651085806504,MATH 20E,B02,083774,Staff,0,0,30,30
1651085812527,MATH 103A,A01,083777,Staff,0,17,30,30
1651085812527,MATH 103A,A02,083778,Staff,0,17,30,30
1651085812527,MATH 103A,B01,083779,Staff,0,15,30,30
1651085812527,MATH 103A,B02,083780,Staff,0,14,30,30
1651085818563,MATH 105,A01,085443,Staff,0,24,30,30
1651085824588,MATH 109,A01,083213,Anzaldo; Leesa B,0,7,30,30
1651085824588,MATH 109,A02,083214,Anzaldo; Leesa B,0,7,30,30
1651085824588,MATH 109,B01,083215,Anzaldo; Leesa B,0,8,30,30
1651085824588,MATH 109,B02,083216,Anzaldo; Leesa B,0,8,30,30
1651085830611,MATH 142A,A01,083219,Chow; Bennett,0,15,30,30
1651085830611,MATH 142A,A02,083220,Chow; Bennett,0,15,30,30
1651085830611,MATH 142A,B01,083221,Chow; Bennett,0,16,30,30
1651085830611,MATH 142A,B02,083222,Chow; Bennett,0,15,30,30
1651085836646,MATH 193A,A01,083224,Staff,0,9,30,30
1651085836646,MATH 193A,A02,083225,Staff,0,7,30,30
1651085836646,MATH 193A,A03,083781,Staff,0,7,30,30
1651085836646,MATH 193A,A04,083782,Staff,0,7,30,30
1651085842671,MATH 197,001,091859,McAuley; Julian John,9998,0,9999,1
1651085848747,COGS 9,A01,083615,Staff,0,20,60,60
1651085854774,COGS 11,A01,083617,Boyle; Mary E. T.,13,0,40,27
1651085860805,COGS 13,A01,083071,Staff,0,38,40,40
1651085866829,COGS 14A,A01,092681,Staff,0,39,100,100
1651085872852,COGS 14B,A01,083073,Cheng; Tzu-Han,0,13,50,50
1651085878878,COGS 17,A01,092677,Staff,9,0,75,66
1651085884900,COGS 100,A01,083619,Staff,0,30,60,60
1651085890931,COGS 101A,A01,083621,Davis; Joshua Daniel,0,29,60,60
1651085896953,COGS 101B,A01,091572,Staff,0,8,60,60
1651085902977,COGS 101C,A01,083625,Delgado; Tania,13,0,30,17
1651085909006,COGS 107A,A01,083627,Boyle; Mary E. T.,0,17,60,60
1651085915029,COGS 118A,A01,083075,Staff,0,10,60,60
1651085921056,CSE 3,A50,083646,Miranda; Gregory Joseph,15,0,38,23
1651085921056,CSE 3,A51,083647,Miranda; Gregory Joseph,36,0,37,1
1651085927078,CSE 8A,A50,083650,Miranda; Gregory Joseph,0,31,40,40
1651085933101,CSE 11,A01,083080,Cao; Yingjun,1,98,40,39
1651085939127,CSE 12,A01,083652,Staff,0,27,100,100
1651085945156,CSE 15L,A01,083654,Staff,0,3,50,50
1651085945156,CSE 15L,A02,083655,Staff,0,3,50,50
1651085951184,CSE 20,A01,083657,Staff,46,0,80,34
1651085957207,CSE 30,A01,083084,Eldon; John,0,38,80,80
1651085963230,CSE 100,A01,083659,Cao; Yingjun,0,72,50,50
1651085969254,CSE 134B,A01,083661,Powell; Thomas Allan,0,38,65,65
1651085975293,CSE 140,A01,083663,Staff,0,15,75,75
1651085981316,CSE 140L,A01,083088,Eldon; John,3,0,100,97
1651085987341,CSE 175,A01,083665,Kumar; Rakesh,0,0,25,25
1651085993367,CSE 190,A00,092507,Dubnov; Shlomo,9,0,20,11
1651085999392,ECE 45,A01,083139,Staff,0,7,60,60
1651086005414,ECE 65,A50,083695,Staff,0,7,30,30
1651086011447,ECE 109,A01,091882,Touri; Behrouz,33,0,70,37
1651086017481,ECE 180,A00,083140,Abi Samra; Nicholas Camill,17,0,30,13
1651086017481,ECE 180,B00,083141,Abi Samra; Nicholas Camill,0,0,30,30
1651086023504,MATH 10A,A01,083735,Patchell; Gregory David,0,0,30,30
1651086023504,MATH 10A,A02,083736,Patchell; Gregory David,27,0,30,3
1651086023504,MATH 10A,A03,083737,Patchell; Gregory David,22,0,30,8
1651086029527,MATH 10B,A01,083207,Staff,0,7,30,30
1651086029527,MATH 10B,A02,083208,Staff,0,6,30,30
1651086029527,MATH 10B,B01,083739,Staff,8,0,30,22
1651086029527,MATH 10B,B02,083740,Staff,28,0,30,2
1651086035568,MATH 18,A01,083743,Staff,0,0,30,30
1651086035568,MATH 18,A02,083744,Staff,23,0,30,7
1651086035568,MATH 18,A03,083745,Staff,19,0,30,11
1651086035568,MATH 18,A04,083746,Staff,26,0,30,4
1651086035568,MATH 18,B01,083748,Staff,0,16,30,30
1651086035568,MATH 18,B02,083749,Staff,0,14,30,30
1651086035568,MATH 18,B03,083750,Staff,0,14,30,30
1651086035568,MATH 18,B04,083751,Staff,0,13,30,30
1651086041589,MATH 20A,A01,083754,Staff,18,0,40,22
1651086047617,MATH 20B,A01,083756,Staff,0,14,30,30
1651086047617,MATH 20B,A02,083757,Staff,0,11,30,30
1651086053644,MATH 20C,A01,083760,Staff,0,16,30,30
1651086053644,MATH 20C,A02,083761,Staff,0,15,30,30
1651086053644,MATH 20C,B01,083762,Staff,7,0,30,23
1651086053644,MATH 20C,B02,083763,Staff,27,0,30,3
1651086059669,MATH 20D,A01,083765,Staff,3,1,30,27
1651086059669,MATH 20D,A02,083766,Staff,1,0,30,29
1651086059669,MATH 20D,A03,083767,Staff,22,0,30,8
1651086065696,MATH 20E,A01,083771,Staff,2,0,30,28
1651086065696,MATH 20E,A02,083772,Staff,10,0,30,20
1651086065696,MATH 20E,B01,083773,Staff,0,0,30,30
1651086065696,MATH 20E,B02,083774,Staff,0,0,30,30
1651086071719,MATH 103A,A01,083777,Staff,0,17,30,30
1651086071719,MATH 103A,A02,083778,Staff,0,17,30,30
1651086071719,MATH 103A,B01,083779,Staff,0,15,30,30
1651086071719,MATH 103A,B02,083780,Staff,0,14,30,30
1651086077755,MATH 105,A01,085443,Staff,0,24,30,30
1651086083799,MATH 109,A01,083213,Anzaldo; Leesa B,0,7,30,30
1651086083799,MATH 109,A02,083214,Anzaldo; Leesa B,0,7,30,30
1651086083799,MATH 109,B01,083215,Anzaldo; Leesa B,0,8,30,30
1651086083799,MATH 109,B02,083216,Anzaldo; Leesa B,0,8,30,30
1651086089824,MATH 142A,A01,083219,Chow; Bennett,0,15,30,30
1651086089824,MATH 142A,A02,083220,Chow; Bennett,0,15,30,30
1651086089824,MATH 142A,B01,083221,Chow; Bennett,0,16,30,30
1651086089824,MATH 142A,B02,083222,Chow; Bennett,0,15,30,30
1651086095847,MATH 193A,A01,083224,Staff,0,9,30,30
1651086095847,MATH 193A,A02,083225,Staff,0,7,30,30
1651086095847,MATH 193A,A03,083781,Staff,0,7,30,30
1651086095847,MATH 193A,A04,083782,Staff,0,7,30,30
1651086101872,MATH 197,001,091859,McAuley; Julian John,9998,0,9999,1
1651086107930,COGS 9,A01,083615,Staff,0,20,60,60
1651086113953,COGS 11,A01,083617,Boyle; Mary E. T.,13,0,40,27
1651086119979,COGS 13,A01,083071,Staff,0,38,40,40
1651086126022,COGS 14A,A01,092681,Staff,0,39,100,100
1651086132048,COGS 14B,A01,083073,Cheng; Tzu-Han,0,13,50,50
1651086138072,COGS 17,A01,092677,Staff,9,0,75,66
1651086144095,COGS 100,A01,083619,Staff,0,30,60,60
1651086150119,COGS 101A,A01,083621,Davis; Joshua Daniel,0,29,60,60
1651086156143,COGS 101B,A01,091572,Staff,0,8,60,60
1651086162178,COGS 101C,A01,083625,Delgado; Tania,13,0,30,17
1651086168204,COGS 107A,A01,083627,Boyle; Mary E. T.,0,17,60,60
1651086174230,COGS 118A,A01,083075,Staff,0,10,60,60
1651086180273,CSE 3,A50,083646,Miranda; Gregory Joseph,15,0,38,23
1651086180273,CSE 3,A51,083647,Miranda; Gregory Joseph,36,0,37,1
1651086186308,CSE 8A,A50,083650,Miranda; Gregory Joseph,0,31,40,40
1651086192352,CSE 11,A01,083080,Cao; Yingjun,1,98,40,39
1651086198420,CSE 12,A01,083652,Staff,0,27,100,100
1651086204443,CSE 15L,A01,083654,Staff,0,3,50,50
1651086204443,CSE 15L,A02,083655,Staff,0,3,50,50
1651086210497,CSE 20,A01,083657,Staff,46,0,80,34
1651086216523,CSE 30,A01,083084,Eldon; John,0,38,80,80
1651086222547,CSE 100,A01,083659,Cao; Yingjun,0,72,50,50
1651086228586,CSE 134B,A01,083661,Powell; Thomas Allan,0,38,65,65
1651086234708,CSE 140,A01,083663,Staff,0,15,75,75
1651086240735,CSE 140L,A01,083088,Eldon; John,3,0,100,97
1651086246761,CSE 175,A01,083665,Kumar; Rakesh,0,0,25,25
1651086252782,CSE 190,A00,092507,Dubnov; Shlomo,9,0,20,11
1651086258820,ECE 45,A01,083139,Staff,0,7,60,60
1651086264843,ECE 65,A50,083695,Staff,0,7,30,30
1651086270876,ECE 109,A01,091882,Touri; Behrouz,33,0,70,37
1651086276902,ECE 180,A00,083140,Abi Samra; Nicholas Camill,17,0,30,13
1651086276902,ECE 180,B00,083141,Abi Samra; Nicholas Camill,0,0,30,30
1651086282925,MATH 10A,A01,083735,Patchell; Gregory David,0,0,30,30
1651086282925,MATH 10A,A02,083736,Patchell; Gregory David,27,0,30,3
1651086282925,MATH 10A,A03,083737,Patchell; Gregory David,22,0,30,8
1651086288950,MATH 10B,A01,083207,Staff,0,7,30,30
1651086288950,MATH 10B,A02,083208,Staff,0,6,30,30
1651086288950,MATH 10B,B01,083739,Staff,8,0,30,22
1651086288950,MATH 10B,B02,083740,Staff,28,0,30,2
1651086294986,MATH 18,A01,083743,Staff,0,0,30,30
1651086294986,MATH 18,A02,083744,Staff,23,0,30,7
1651086294986,MATH 18,A03,083745,Staff,19,0,30,11
1651086294986,MATH 18,A04,083746,Staff,26,0,30,4
1651086294986,MATH 18,B01,083748,Staff,0,16,30,30
1651086294986,MATH 18,B02,083749,Staff,0,14,30,30
1651086294986,MATH 18,B03,083750,Staff,0,14,30,30
1651086294986,MATH 18,B04,083751,Staff,0,13,30,30
1651086301009,MATH 20A,A01,083754,Staff,18,0,40,22
1651086307031,MATH 20B,A01,083756,Staff,0,14,30,30
1651086307031,MATH 20B,A02,083757,Staff,0,11,30,30
1651086313060,MATH 20C,A01,083760,Staff,0,16,30,30
1651086313060,MATH 20C,A02,083761,Staff,0,15,30,30
1651086313060,MATH 20C,B01,083762,Staff,7,0,30,23
1651086313060,MATH 20C,B02,083763,Staff,27,0,30,3
1651086319083,MATH 20D,A01,083765,Staff,3,1,30,27
1651086319083,MATH 20D,A02,083766,Staff,1,0,30,29
1651086319083,MATH 20D,A03,083767,Staff,22,0,30,8
1651086325116,MATH 20E,A01,083771,Staff,2,0,30,28
1651086325116,MATH 20E,A02,083772,Staff,10,0,30,20
1651086325116,MATH 20E,B01,083773,Staff,0,0,30,30
1651086325116,MATH 20E,B02,083774,Staff,0,0,30,30
1651086331144,MATH 103A,A01,083777,Staff,0,17,30,30
1651086331144,MATH 103A,A02,083778,Staff,0,17,30,30
1651086331144,MATH 103A,B01,083779,Staff,0,15,30,30
1651086331144,MATH 103A,B02,083780,Staff,0,14,30,30
1651086337169,MATH 105,A01,085443,Staff,0,24,30,30
1651086343190,MATH 109,A01,083213,Anzaldo; Leesa B,0,7,30,30
1651086343190,MATH 109,A02,083214,Anzaldo; Leesa B,0,7,30,30
1651086343190,MATH 109,B01,083215,Anzaldo; Leesa B,0,8,30,30
1651086343190,MATH 109,B02,083216,Anzaldo; Leesa B,0,8,30,30
1651086349220,MATH 142A,A01,083219,Chow; Bennett,0,15,30,30
1651086349220,MATH 142A,A02,083220,Chow; Bennett,0,15,30,30
1651086349220,MATH 142A,B01,083221,Chow; Bennett,0,16,30,30
1651086349220,MATH 142A,B02,083222,Chow; Bennett,0,15,30,30
1651086355246,MATH 193A,A01,083224,Staff,0,9,30,30
1651086355246,MATH 193A,A02,083225,Staff,0,7,30,30
1651086355246,MATH 193A,A03,083781,Staff,0,7,30,30
1651086355246,MATH 193A,A04,083782,Staff,0,7,30,30
1651086361268,MATH 197,001,091859,McAuley; Julian John,9998,0,9999,1
1651086367346,COGS 9,A01,083615,Staff,0,20,60,60
1651086373370,COGS 11,A01,083617,Boyle; Mary E. T.,13,0,40,27
1651086379393,COGS 13,A01,083071,Staff,0,38,40,40
1651086385421,COGS 14A,A01,092681,Staff,0,39,100,100
1651086391446,COGS 14B,A01,083073,Cheng; Tzu-Han,0,13,50,50
1651086397468,COGS 17,A01,092677,Staff,9,0,75,66
1651086403493,COGS 100,A01,083619,Staff,0,30,60,60
1651086409517,COGS 101A,A01,083621,Davis; Joshua Daniel,0,29,60,60
1651086415544,COGS 101B,A01,091572,Staff,0,8,60,60
1651086421566,COGS 101C,A01,083625,Delgado; Tania,13,0,30,17
1651086427601,COGS 107A,A01,083627,Boyle; Mary E. T.,0,17,60,60
1651086433625,COGS 118A,A01,083075,Staff,0,10,60,60
1651086439648,CSE 3,A50,083646,Miranda; Gregory Joseph,15,0,38,23
1651086439648,CSE 3,A51,083647,Miranda; Gregory Joseph,36,0,37,1
1651086445676,CSE 8A,A50,083650,Miranda; Gregory Joseph,0,31,40,40
1651086451699,CSE 11,A01,083080,Cao; Yingjun,1,98,40,39
1651086457721,CSE 12,A01,083652,Staff,0,27,100,100
1651086463750,CSE 15L,A01,083654,Staff,0,3,50,50
1651086463750,CSE 15L,A02,083655,Staff,0,3,50,50
1651086469778,CSE 20,A01,083657,Staff,46,0,80,34
1651086475800,CSE 30,A01,083084,Eldon; John,0,38,80,80
1651086481828,CSE 100,A01,083659,Cao; Yingjun,0,72,50,50
1651086487850,CSE 134B,A01,083661,Powell; Thomas Allan,0,38,65,65
1651086493879,CSE 140,A01,083663,Staff,0,15,75,75
1651086499905,CSE 140L,A01,083088,Eldon; John,3,0,100,97
1651086505928,CSE 175,A01,083665,Kumar; Rakesh,0,0,25,25
1651086511955,CSE 190,A00,092507,Dubnov; Shlomo,9,0,20,11
1651086517978,ECE 45,A01,083139,Staff,0,7,60,60
1651086524009,ECE 65,A50,083695,Staff,0,7,30,30
1651086530034,ECE 109,A01,091882,Touri; Behrouz,33,0,70,37
1651086536060,ECE 180,A00,083140,Abi Samra; Nicholas Camill,17,0,30,13
1651086536060,ECE 180,B00,083141,Abi Samra; Nicholas Camill,0,0,30,30
1651086542084,MATH 10A,A01,083735,Patchell; Gregory David,0,0,30,30
1651086542084,MATH 10A,A02,083736,Patchell; Gregory David,27,0,30,3
1651086542084,MATH 10A,A03,083737,Patchell; Gregory David,22,0,30,8
1651086548113,MATH 10B,A01,083207,Staff,0,7,30,30
1651086548113,MATH 10B,A02,083208,Staff,0,6,30,30
1651086548113,MATH 10B,B01,083739,Staff,8,0,30,22
1651086548113,MATH 10B,B02,083740,Staff,28,0,30,2
1651086554141,MATH 18,A01,083743,Staff,0,0,30,30
1651086554141,MATH 18,A02,083744,Staff,23,0,30,7
1651086554141,MATH 18,A03,083745,Staff,19,0,30,11
1651086554141,MATH 18,A04,083746,Staff,26,0,30,4
1651086554141,MATH 18,B01,083748,Staff,0,16,30,30
1651086554141,MATH 18,B02,083749,Staff,0,14,30,30
1651086554141,MATH 18,B03,083750,Staff,0,14,30,30
1651086554141,MATH 18,B04,083751,Staff,0,13,30,30
1651086560166,MATH 20A,A01,083754,Staff,18,0,40,22
1651086566195,MATH 20B,A01,083756,Staff,0,14,30,30
1651086566195,MATH 20B,A02,083757,Staff,0,11,30,30
1651086572218,MATH 20C,A01,083760,Staff,0,16,30,30
1651086572218,MATH 20C,A02,083761,Staff,0,15,30,30
1651086572218,MATH 20C,B01,083762,Staff,7,0,30,23
1651086572218,MATH 20C,B02,083763,Staff,27,0,30,3
1651086578243,MATH 20D,A01,083765,Staff,3,1,30,27
1651086578243,MATH 20D,A02,083766,Staff,1,0,30,29
1651086578243,MATH 20D,A03,083767,Staff,22,0,30,8
1651086584270,MATH 20E,A01,083771,Staff,2,0,30,28
1651086584270,MATH 20E,A02,083772,Staff,10,0,30,20
1651086584270,MATH 20E,B01,083773,Staff,0,0,30,30
1651086584270,MATH 20E,B02,083774,Staff,0,0,30,30
1651086590307,MATH 103A,A01,083777,Staff,0,17,30,30
1651086590307,MATH 103A,A02,083778,Staff,0,17,30,30
1651086590307,MATH 103A,B01,083779,Staff,0,15,30,30
1651086590307,MATH 103A,B02,083780,Staff,0,14,30,30
1651086596329,MATH 105,A01,085443,Staff,0,24,30,30
1651086602355,MATH 109,A01,083213,Anzaldo; Leesa B,0,7,30,30
1651086602355,MATH 109,A02,083214,Anzaldo; Leesa B,0,7,30,30
1651086602355,MATH 109,B01,083215,Anzaldo; Leesa B,0,8,30,30
1651086602355,MATH 109,B02,083216,Anzaldo; Leesa B,1,8,30,29
1651086608389,MATH 142A,A01,083219,Chow; Bennett,0,15,30,30
1651086608389,MATH 142A,A02,083220,Chow; Bennett,0,15,30,30
1651086608389,MATH 142A,B01,083221,Chow; Bennett,0,16,30,30
1651086608389,MATH 142A,B02,083222,Chow; Bennett,0,15,30,30
1651086614422,MATH 193A,A01,083224,Staff,0,9,30,30
1651086614422,MATH 193A,A02,083225,Staff,0,7,30,30
1651086614422,MATH 193A,A03,083781,Staff,0,7,30,30
1651086614422,MATH 193A,A04,083782,Staff,0,7,30,30
1651086620445,MATH 197,001,091859,McAuley; Julian John,9998,0,9999,1
1651086626505,COGS 9,A01,083615,Staff,0,20,60,60
1651086632534,COGS 11,A01,083617,Boyle; Mary E. T.,13,0,40,27
1651086638564,COGS 13,A01,083071,Staff,0,38,40,40
1651086644588,COGS 14A,A01,092681,Staff,0,39,100,100
1651086650614,COGS 14B,A01,083073,Cheng; Tzu-Han,0,13,50,50
1651086656646,COGS 17,A01,092677,Staff,9,0,75,66
1651086662676,COGS 100,A01,083619,Staff,0,30,60,60
1651086668710,COGS 101A,A01,083621,Davis; Joshua Daniel,0,29,60,60
1651086674740,COGS 101B,A01,091572,Staff,0,8,60,60
1651086680765,COGS 101C,A01,083625,Delgado; Tania,13,0,30,17
1651086686790,COGS 107A,A01,083627,Boyle; Mary E. T.,0,17,60,60
1651086692817,COGS 118A,A01,083075,Staff,0,10,60,60
1651086698854,CSE 3,A50,083646,Miranda; Gregory Joseph,15,0,38,23
1651086698854,CSE 3,A51,083647,Miranda; Gregory Joseph,36,0,37,1
1651086704886,CSE 8A,A50,083650,Miranda; Gregory Joseph,0,31,40,40
1651086710910,CSE 11,A01,083080,Cao; Yingjun,1,98,40,39
1651086716931,CSE 12,A01,083652,Staff,0,27,100,100
1651086722962,CSE 15L,A01,083654,Staff,0,3,50,50
1651086722962,CSE 15L,A02,083655,Staff,0,3,50,50
1651086728984,CSE 20,A01,083657,Staff,46,0,80,34
1651086735013,CSE 30,A01,083084,Eldon; John,0,38,80,80
1651086741037,CSE 100,A01,083659,Cao; Yingjun,0,72,50,50
1651086747062,CSE 134B,A01,083661,Powell; Thomas Allan,0,38,65,65
1651086753086,CSE 140,A01,083663,Staff,0,15,75,75
1651086759115,CSE 140L,A01,083088,Eldon; John,3,0,100,97
1651086765137,CSE 175,A01,083665,Kumar; Rakesh,0,0,25,25
1651086771163,CSE 190,A00,092507,Dubnov; Shlomo,9,0,20,11
1651086777188,ECE 45,A01,083139,Staff,0,7,60,60
1651086783210,ECE 65,A50,083695,Staff,0,7,30,30
1651086789233,ECE 109,A01,091882,Touri; Behrouz,33,0,70,37
1651086795259,ECE 180,A00,083140,Abi Samra; Nicholas Camill,17,0,30,13
1651086795259,ECE 180,B00,083141,Abi Samra; Nicholas Camill,0,0,30,30
1651086801281,MATH 10A,A01,083735,Patchell; Gregory David,0,0,30,30
1651086801281,MATH 10A,A02,083736,Patchell; Gregory David,27,0,30,3
1651086801281,MATH 10A,A03,083737,Patchell; Gregory David,22,0,30,8
1651086807305,MATH 10B,A01,083207,Staff,0,7,30,30
1651086807305,MATH 10B,A02,083208,Staff,0,6,30,30
1651086807305,MATH 10B,B01,083739,Staff,8,0,30,22
1651086807305,MATH 10B,B02,083740,Staff,28,0,30,2
1651086813335,MATH 18,A01,083743,Staff,0,0,30,30
1651086813335,MATH 18,A02,083744,Staff,23,0,30,7
1651086813335,MATH 18,A03,083745,Staff,19,0,30,11
1651086813335,MATH 18,A04,083746,Staff,26,0,30,4
1651086813335,MATH 18,B01,083748,Staff,0,16,30,30
1651086813335,MATH 18,B02,083749,Staff,0,14,30,30
1651086813335,MATH 18,B03,083750,Staff,0,14,30,30
1651086813335,MATH 18,B04,083751,Staff,0,13,30,30
1651086819363,MATH 20A,A01,083754,Staff,18,0,40,22
1651086825388,MATH 20B,A01,083756,Staff,0,14,30,30
1651086825388,MATH 20B,A02,083757,Staff,0,11,30,30
1651086831520,MATH 20C,A01,083760,Staff,0,16,30,30
1651086831520,MATH 20C,A02,083761,Staff,0,15,30,30
1651086831520,MATH 20C,B01,083762,Staff,7,0,30,23
1651086831520,MATH 20C,B02,083763,Staff,27,0,30,3
1651086837545,MATH 20D,A01,083765,Staff,3,1,30,27
1651086837545,MATH 20D,A02,083766,Staff,1,0,30,29
1651086837545,MATH 20D,A03,083767,Staff,22,0,30,8
1651086843583,MATH 20E,A01,083771,Staff,2,0,30,28
1651086843583,MATH 20E,A02,083772,Staff,10,0,30,20
1651086843583,MATH 20E,B01,083773,Staff,0,0,30,30
1651086843583,MATH 20E,B02,083774,Staff,0,1,30,30
1651086849608,MATH 103A,A01,083777,Staff,0,17,30,30
1651086849608,MATH 103A,A02,083778,Staff,0,17,30,30
1651086849608,MATH 103A,B01,083779,Staff,0,15,30,30
1651086849608,MATH 103A,B02,083780,Staff,0,14,30,30
1651086855631,MATH 105,A01,085443,Staff,0,24,30,30
1651086861668,MATH 109,A01,083213,Anzaldo; Leesa B,0,7,30,30
1651086861668,MATH 109,A02,083214,Anzaldo; Leesa B,0,7,30,30
1651086861668,MATH 109,B01,083215,Anzaldo; Leesa B,0,8,30,30
1651086861668,MATH 109,B02,083216,Anzaldo; Leesa B,1,8,30,29
1651086867702,MATH 142A,A01,083219,Chow; Bennett,0,15,30,30
1651086867702,MATH 142A,A02,083220,Chow; Bennett,0,15,30,30
1651086867702,MATH 142A,B01,083221,Chow; Bennett,0,16,30,30
1651086867702,MATH 142A,B02,083222,Chow; Bennett,0,15,30,30
1651086873724,MATH 193A,A01,083224,Staff,0,9,30,30
1651086873724,MATH 193A,A02,083225,Staff,0,7,30,30
1651086873724,MATH 193A,A03,083781,Staff,0,7,30,30
1651086873724,MATH 193A,A04,083782,Staff,0,7,30,30
1651086879747,MATH 197,001,091859,McAuley; Julian John,9998,0,9999,1
1651086885817,COGS 9,A01,083615,Staff,0,20,60,60
1651086891840,COGS 11,A01,083617,Boyle; Mary E. T.,13,0,40,27
1651086897862,COGS 13,A01,083071,Staff,0,38,40,40
1651086903887,COGS 14A,A01,092681,Staff,0,39,100,100
1651086909917,COGS 14B,A01,083073,Cheng; Tzu-Han,0,13,50,50
1651086915938,COGS 17,A01,092677,Staff,9,0,75,66
1651086921960,COGS 100,A01,083619,Staff,0,30,60,60
1651086927985,COGS 101A,A01,083621,Davis; Joshua Daniel,0,29,60,60
1651086934018,COGS 101B,A01,091572,Staff,0,8,60,60
1651086940049,COGS 101C,A01,083625,Delgado; Tania,13,0,30,17
1651086946073,COGS 107A,A01,083627,Boyle; Mary E. T.,0,17,60,60
1651086952115,COGS 118A,A01,083075,Staff,0,10,60,60
1651086958143,CSE 3,A50,083646,Miranda; Gregory Joseph,15,0,38,23
1651086958143,CSE 3,A51,083647,Miranda; Gregory Joseph,36,0,37,1
1651086964170,CSE 8A,A50,083650,Miranda; Gregory Joseph,0,31,40,40
1651086970194,CSE 11,A01,083080,Cao; Yingjun,1,98,40,39
1651086976217,CSE 12,A01,083652,Staff,0,27,100,100
1651086982242,CSE 15L,A01,083654,Staff,0,3,50,50
1651086982242,CSE 15L,A02,083655,Staff,0,3,50,50
1651086988268,CSE 20,A01,083657,Staff,46,0,80,34
1651086994301,CSE 30,A01,083084,Eldon; John,0,38,80,80
1651087000325,CSE 100,A01,083659,Cao; Yingjun,0,72,50,50
1651087006346,CSE 134B,A01,083661,Powell; Thomas Allan,0,38,65,65
1651087012378,CSE 140,A01,083663,Staff,0,15,75,75
1651087018409,CSE 140L,A01,083088,Eldon; John,3,0,100,97
1651087024432,CSE 175,A01,083665,Kumar; Rakesh,0,0,25,25
1651087030458,CSE 190,A00,092507,Dubnov; Shlomo,9,0,20,11
1651087036485,ECE 45,A01,083139,Staff,0,7,60,60
1651087042511,ECE 65,A50,083695,Staff,0,7,30,30
1651087048535,ECE 109,A01,091882,Touri; Behrouz,33,0,70,37
1651087054562,ECE 180,A00,083140,Abi Samra; Nicholas Camill,17,0,30,13
1651087054562,ECE 180,B00,083141,Abi Samra; Nicholas Camill,0,0,30,30
1651087060604,MATH 10A,A01,083735,Patchell; Gregory David,0,0,30,30
1651087060604,MATH 10A,A02,083736,Patchell; Gregory David,27,0,30,3
1651087060604,MATH 10A,A03,083737,Patchell; Gregory David,22,0,30,8
1651087066632,MATH 10B,A01,083207,Staff,0,7,30,30
1651087066632,MATH 10B,A02,083208,Staff,0,6,30,30
1651087066632,MATH 10B,B01,083739,Staff,8,0,30,22
1651087066632,MATH 10B,B02,083740,Staff,28,0,30,2
1651087072661,MATH 18,A01,083743,Staff,0,0,30,30
1651087072661,MATH 18,A02,083744,Staff,23,0,30,7
1651087072661,MATH 18,A03,083745,Staff,19,0,30,11
1651087072661,MATH 18,A04,083746,Staff,26,0,30,4
1651087072661,MATH 18,B01,083748,Staff,0,16,30,30
1651087072661,MATH 18,B02,083749,Staff,0,14,30,30
1651087072661,MATH 18,B03,083750,Staff,0,14,30,30
1651087072661,MATH 18,B04,083751,Staff,0,13,30,30
1651087078687,MATH 20A,A01,083754,Staff,18,0,40,22
1651087084710,MATH 20B,A01,083756,Staff,0,14,30,30
1651087084710,MATH 20B,A02,083757,Staff,0,11,30,30
1651087090732,MATH 20C,A01,083760,Staff,0,16,30,30
1651087090732,MATH 20C,A02,083761,Staff,0,15,30,30
1651087090732,MATH 20C,B01,083762,Staff,7,0,30,23
1651087090732,MATH 20C,B02,083763,Staff,27,0,30,3
1651087096769,MATH 20D,A01,083765,Staff,3,1,30,27
1651087096769,MATH 20D,A02,083766,Staff,1,0,30,29
1651087096769,MATH 20D,A03,083767,Staff,22,0,30,8
1651087102794,MATH 20E,A01,083771,Staff,2,0,30,28
1651087102794,MATH 20E,A02,083772,Staff,10,0,30,20
1651087102794,MATH 20E,B01,083773,Staff,0,0,30,30
1651087102794,MATH 20E,B02,083774,Staff,0,1,30,30
1651087108816,MATH 103A,A01,083777,Staff,0,17,30,30
1651087108816,MATH 103A,A02,083778,Staff,0,17,30,30
1651087108816,MATH 103A,B01,083779,Staff,0,15,30,30
1651087108816,MATH 103A,B02,083780,Staff,0,14,30,30
1651087114839,MATH 105,A01,085443,Staff,0,24,30,30
1651087120865,MATH 109,A01,083213,Anzaldo; Leesa B,0,7,30,30
1651087120865,MATH 109,A02,083214,Anzaldo; Leesa B,0,7,30,30
1651087120865,MATH 109,B01,083215,Anzaldo; Leesa B,0,8,30,30
1651087120865,MATH 109,B02,083216,Anzaldo; Leesa B,1,8,30,29
1651087126890,MATH 142A,A01,083219,Chow; Bennett,0,15,30,30
1651087126890,MATH 142A,A02,083220,Chow; Bennett,0,15,30,30
1651087126890,MATH 142A,B01,083221,Chow; Bennett,0,16,30,30
1651087126890,MATH 142A,B02,083222,Chow; Bennett,0,15,30,30
1651087132924,MATH 193A,A01,083224,Staff,0,9,30,30
1651087132924,MATH 193A,A02,083225,Staff,0,7,30,30
1651087132924,MATH 193A,A03,083781,Staff,0,7,30,30
1651087132924,MATH 193A,A04,083782,Staff,0,7,30,30
1651087138949,MATH 197,001,091859,McAuley; Julian John,9998,0,9999,1
1651087144996,COGS 9,A01,083615,Staff,0,20,60,60
1651087151032,COGS 11,A01,083617,Boyle; Mary E. T.,13,0,40,27
1651087157059,COGS 13,A01,083071,Staff,0,38,40,40
1651087163086,COGS 14A,A01,092681,Staff,0,39,100,100
1651087169110,COGS 14B,A01,083073,Cheng; Tzu-Han,0,13,50,50
1651087175134,COGS 17,A01,092677,Staff,9,0,75,66
1651087181164,COGS 100,A01,083619,Staff,0,30,60,60
1651087187187,COGS 101A,A01,083621,Davis; Joshua Daniel,0,29,60,60
1651087193210,COGS 101B,A01,091572,Staff,0,8,60,60
1651087199235,COGS 101C,A01,083625,Delgado; Tania,13,0,30,17
1651087205256,COGS 107A,A01,083627,Boyle; Mary E. T.,0,17,60,60
1651087211281,COGS 118A,A01,083075,Staff,0,10,60,60
1651087217304,CSE 3,A50,083646,Miranda; Gregory Joseph,15,0,38,23
1651087217304,CSE 3,A51,083647,Miranda; Gregory Joseph,36,0,37,1
1651087223330,CSE 8A,A50,083650,Miranda; Gregory Joseph,0,31,40,40
1651087229355,CSE 11,A01,083080,Cao; Yingjun,1,98,40,39
1651087235378,CSE 12,A01,083652,Staff,0,27,100,100
1651087241403,CSE 15L,A01,083654,Staff,0,3,50,50
1651087241403,CSE 15L,A02,083655,Staff,0,3,50,50
1651087247429,CSE 20,A01,083657,Staff,46,0,80,34
1651087253456,CSE 30,A01,083084,Eldon; John,0,38,80,80
1651087259477,CSE 100,A01,083659,Cao; Yingjun,0,72,50,50
1651087265503,CSE 134B,A01,083661,Powell; Thomas Allan,0,38,65,65
1651087271527,CSE 140,A01,083663,Staff,0,15,75,75
1651087277549,CSE 140L,A01,083088,Eldon; John,3,0,100,97
1651087283580,CSE 175,A01,083665,Kumar; Rakesh,0,0,25,25
1651087289604,CSE 190,A00,092507,Dubnov; Shlomo,9,0,20,11
1651087295637,ECE 45,A01,083139,Staff,0,7,60,60
1651087301660,ECE 65,A50,083695,Staff,0,7,30,30
1651087307707,ECE 109,A01,091882,Touri; Behrouz,33,0,70,37
1651087313735,ECE 180,A00,083140,Abi Samra; Nicholas Camill,17,0,30,13
1651087313735,ECE 180,B00,083141,Abi Samra; Nicholas Camill,0,0,30,30
1651087319763,MATH 10A,A01,083735,Patchell; Gregory David,0,0,30,30
1651087319763,MATH 10A,A02,083736,Patchell; Gregory David,27,0,30,3
1651087319763,MATH 10A,A03,083737,Patchell; Gregory David,22,0,30,8
1651087325787,MATH 10B,A01,083207,Staff,0,7,30,30
1651087325787,MATH 10B,A02,083208,Staff,0,6,30,30
1651087325787,MATH 10B,B01,083739,Staff,8,0,30,22
1651087325787,MATH 10B,B02,083740,Staff,28,0,30,2
1651087331812,MATH 18,A01,083743,Staff,0,0,30,30
1651087331812,MATH 18,A02,083744,Staff,23,0,30,7
1651087331812,MATH 18,A03,083745,Staff,19,0,30,11
1651087331812,MATH 18,A04,083746,Staff,26,0,30,4
1651087331812,MATH 18,B01,083748,Staff,0,16,30,30
1651087331812,MATH 18,B02,083749,Staff,0,14,30,30
1651087331812,MATH 18,B03,083750,Staff,0,14,30,30
1651087331812,MATH 18,B04,083751,Staff,0,13,30,30
1651087337839,MATH 20A,A01,083754,Staff,18,0,40,22
1651087343866,MATH 20B,A01,083756,Staff,0,14,30,30
1651087343866,MATH 20B,A02,083757,Staff,0,11,30,30
1651087349892,MATH 20C,A01,083760,Staff,0,16,30,30
1651087349892,MATH 20C,A02,083761,Staff,0,15,30,30
1651087349892,MATH 20C,B01,083762,Staff,7,0,30,23
1651087349892,MATH 20C,B02,083763,Staff,27,0,30,3
1651087355924,MATH 20D,A01,083765,Staff,3,1,30,27
1651087355924,MATH 20D,A02,083766,Staff,1,0,30,29
1651087355924,MATH 20D,A03,083767,Staff,22,0,30,8
1651087361951,MATH 20E,A01,083771,Staff,2,0,30,28
1651087361951,MATH 20E,A02,083772,Staff,10,0,30,20
1651087361951,MATH 20E,B01,083773,Staff,0,0,30,30
1651087361951,MATH 20E,B02,083774,Staff,0,1,30,30
1651087367978,MATH 103A,A01,083777,Staff,0,17,30,30
1651087367978,MATH 103A,A02,083778,Staff,0,17,30,30
1651087367978,MATH 103A,B01,083779,Staff,0,15,30,30
1651087367978,MATH 103A,B02,083780,Staff,0,14,30,30
1651087374004,MATH 105,A01,085443,Staff,0,24,30,30
1651087380027,MATH 109,A01,083213,Anzaldo; Leesa B,0,7,30,30
1651087380027,MATH 109,A02,083214,Anzaldo; Leesa B,0,7,30,30
1651087380027,MATH 109,B01,083215,Anzaldo; Leesa B,0,8,30,30
1651087380027,MATH 109,B02,083216,Anzaldo; Leesa B,1,8,30,29
1651087386054,MATH 142A,A01,083219,Chow; Bennett,0,15,30,30
1651087386054,MATH 142A,A02,083220,Chow; Bennett,0,15,30,30
1651087386054,MATH 142A,B01,083221,Chow; Bennett,0,16,30,30
1651087386054,MATH 142A,B02,083222,Chow; Bennett,0,15,30,30
1651087392086,MATH 193A,A01,083224,Staff,0,9,30,30
1651087392086,MATH 193A,A02,083225,Staff,0,7,30,30
1651087392086,MATH 193A,A03,083781,Staff,0,7,30,30
1651087392086,MATH 193A,A04,083782,Staff,0,7,30,30
1651087398108,MATH 197,001,091859,McAuley; Julian John,9998,0,9999,1
1651087404163,COGS 9,A01,083615,Staff,0,20,60,60
1651087410188,COGS 11,A01,083617,Boyle; Mary E. T.,13,0,40,27
1651087416214,COGS 13,A01,083071,Staff,0,38,40,40
1651087422331,COGS 14A,A01,092681,Staff,0,39,100,100
1651087428358,COGS 14B,A01,083073,Cheng; Tzu-Han,0,13,50,50
1651087434382,COGS 17,A01,092677,Staff,9,0,75,66
1651087440408,COGS 100,A01,083619,Staff,0,30,60,60
1651087446429,COGS 101A,A01,083621,Davis; Joshua Daniel,0,29,60,60
1651087452455,COGS 101B,A01,091572,Staff,0,8,60,60
1651087458480,COGS 101C,A01,083625,Delgado; Tania,13,0,30,17
1651087464504,COGS 107A,A01,083627,Boyle; Mary E. T.,0,17,60,60
1651087470538,COGS 118A,A01,083075,Staff,0,10,60,60
1651087476569,CSE 3,A50,083646,Miranda; Gregory Joseph,15,0,38,23
1651087476569,CSE 3,A51,083647,Miranda; Gregory Joseph,36,0,37,1
1651087482603,CSE 8A,A50,083650,Miranda; Gregory Joseph,0,31,40,40
1651087488631,CSE 11,A01,083080,Cao; Yingjun,1,98,40,39
1651087494660,CSE 12,A01,083652,Staff,0,27,100,100
1651087500683,CSE 15L,A01,083654,Staff,0,3,50,50
1651087500683,CSE 15L,A02,083655,Staff,0,3,50,50
1651087506707,CSE 20,A01,083657,Staff,46,0,80,34
1651087512742,CSE 30,A01,083084,Eldon; John,0,38,80,80
1651087518768,CSE 100,A01,083659,Cao; Yingjun,0,72,50,50
1651087524794,CSE 134B,A01,083661,Powell; Thomas Allan,0,38,65,65
1651087530817,CSE 140,A01,083663,Staff,0,15,75,75
1651087536839,CSE 140L,A01,083088,Eldon; John,3,0,100,97
1651087542868,CSE 175,A01,083665,Kumar; Rakesh,0,0,25,25
1651087548891,CSE 190,A00,092507,Dubnov; Shlomo,9,0,20,11
1651087554917,ECE 45,A01,083139,Staff,0,7,60,60
1651087560943,ECE 65,A50,083695,Staff,0,7,30,30
1651087566968,ECE 109,A01,091882,Touri; Behrouz,33,0,70,37
1651087572990,ECE 180,A00,083140,Abi Samra; Nicholas Camill,17,0,30,13
1651087572990,ECE 180,B00,083141,Abi Samra; Nicholas Camill,0,0,30,30
1651087579018,MATH 10A,A01,083735,Patchell; Gregory David,0,0,30,30
1651087579018,MATH 10A,A02,083736,Patchell; Gregory David,27,0,30,3
1651087579018,MATH 10A,A03,083737,Patchell; Gregory David,22,0,30,8
1651087585041,MATH 10B,A01,083207,Staff,0,7,30,30
1651087585041,MATH 10B,A02,083208,Staff,0,6,30,30
1651087585041,MATH 10B,B01,083739,Staff,8,0,30,22
1651087585041,MATH 10B,B02,083740,Staff,28,0,30,2
1651087591067,MATH 18,A01,083743,Staff,0,0,30,30
1651087591067,MATH 18,A02,083744,Staff,23,0,30,7
1651087591067,MATH 18,A03,083745,Staff,19,0,30,11
1651087591067,MATH 18,A04,083746,Staff,26,0,30,4
1651087591067,MATH 18,B01,083748,Staff,0,16,30,30
1651087591067,MATH 18,B02,083749,Staff,0,14,30,30
1651087591067,MATH 18,B03,083750,Staff,0,14,30,30
1651087591067,MATH 18,B04,083751,Staff,0,13,30,30
1651087597093,MATH 20A,A01,083754,Staff,18,0,40,22
1651087603119,MATH 20B,A01,083756,Staff,0,14,30,30
1651087603119,MATH 20B,A02,083757,Staff,0,11,30,30
1651087609142,MATH 20C,A01,083760,Staff,0,16,30,30
1651087609142,MATH 20C,A02,083761,Staff,0,15,30,30
1651087609142,MATH 20C,B01,083762,Staff,7,0,30,23
1651087609142,MATH 20C,B02,083763,Staff,27,0,30,3
1651087615170,MATH 20D,A01,083765,Staff,3,1,30,27
1651087615170,MATH 20D,A02,083766,Staff,1,0,30,29
1651087615170,MATH 20D,A03,083767,Staff,22,0,30,8
1651087621193,MATH 20E,A01,083771,Staff,2,0,30,28
1651087621193,MATH 20E,A02,083772,Staff,10,0,30,20
1651087621193,MATH 20E,B01,083773,Staff,0,0,30,30
1651087621193,MATH 20E,B02,083774,Staff,0,1,30,30
1651087627233,MATH 103A,A01,083777,Staff,0,17,30,30
1651087627233,MATH 103A,A02,083778,Staff,0,17,30,30
1651087627233,MATH 103A,B01,083779,Staff,0,15,30,30
1651087627233,MATH 103A,B02,083780,Staff,0,14,30,30
1651087633260,MATH 105,A01,085443,Staff,0,24,30,30
1651087639287,MATH 109,A01,083213,Anzaldo; Leesa B,0,7,30,30
1651087639287,MATH 109,A02,083214,Anzaldo; Leesa B,0,7,30,30
1651087639287,MATH 109,B01,083215,Anzaldo; Leesa B,0,8,30,30
1651087639287,MATH 109,B02,083216,Anzaldo; Leesa B,1,8,30,29
1651087645315,MATH 142A,A01,083219,Chow; Bennett,0,15,30,30
1651087645315,MATH 142A,A02,083220,Chow; Bennett,0,15,30,30
1651087645315,MATH 142A,B01,083221,Chow; Bennett,0,16,30,30
1651087645315,MATH 142A,B02,083222,Chow; Bennett,0,15,30,30
1651087651338,MATH 193A,A01,083224,Staff,0,9,30,30
1651087651338,MATH 193A,A02,083225,Staff,0,7,30,30
1651087651338,MATH 193A,A03,083781,Staff,0,7,30,30
1651087651338,MATH 193A,A04,083782,Staff,0,7,30,30
1651087657363,MATH 197,001,091859,McAuley; Julian John,9998,0,9999,1
1651087663416,COGS 9,A01,083615,Staff,0,20,60,60
1651087669438,COGS 11,A01,083617,Boyle; Mary E. T.,13,0,40,27
1651087675469,COGS 13,A01,083071,Staff,0,38,40,40
1651087681494,COGS 14A,A01,092681,Staff,0,39,100,100
1651087687517,COGS 14B,A01,083073,Cheng; Tzu-Han,0,13,50,50
1651087693542,COGS 17,A01,092677,Staff,9,0,75,66
1651087699567,COGS 100,A01,083619,Staff,0,30,60,60
1651087705594,COGS 101A,A01,083621,Davis; Joshua Daniel,0,29,60,60
1651087711619,COGS 101B,A01,091572,Staff,0,8,60,60
1651087717660,COGS 101C,A01,083625,Delgado; Tania,13,0,30,17
1651087723682,COGS 107A,A01,083627,Boyle; Mary E. T.,0,17,60,60
1651087729712,COGS 118A,A01,083075,Staff,0,10,60,60
1651087735738,CSE 3,A50,083646,Miranda; Gregory Joseph,15,0,38,23
1651087735738,CSE 3,A51,083647,Miranda; Gregory Joseph,36,0,37,1
1651087741762,CSE 8A,A50,083650,Miranda; Gregory Joseph,0,31,40,40
1651087747792,CSE 11,A01,083080,Cao; Yingjun,1,98,40,39
1651087753814,CSE 12,A01,083652,Staff,0,27,100,100
1651087759838,CSE 15L,A01,083654,Staff,0,3,50,50
1651087759838,CSE 15L,A02,083655,Staff,0,3,50,50
1651087765860,CSE 20,A01,083657,Staff,46,0,80,34
1651087771885,CSE 30,A01,083084,Eldon; John,0,38,80,80
1651087777918,CSE 100,A01,083659,Cao; Yingjun,0,72,50,50
1651087783941,CSE 134B,A01,083661,Powell; Thomas Allan,0,38,65,65
1651087789963,CSE 140,A01,083663,Staff,0,15,75,75
1651087796002,CSE 140L,A01,083088,Eldon; John,3,0,100,97
1651087802028,CSE 175,A01,083665,Kumar; Rakesh,0,0,25,25
1651087808051,CSE 190,A00,092507,Dubnov; Shlomo,9,0,20,11
1651087814077,ECE 45,A01,083139,Staff,0,7,60,60
1651087820105,ECE 65,A50,083695,Staff,0,7,30,30
1651087826135,ECE 109,A01,091882,Touri; Behrouz,33,0,70,37
1651087832192,ECE 180,A00,083140,Abi Samra; Nicholas Camill,17,0,30,13
1651087832192,ECE 180,B00,083141,Abi Samra; Nicholas Camill,0,0,30,30
1651087838219,MATH 10A,A01,083735,Patchell; Gregory David,0,0,30,30
1651087838219,MATH 10A,A02,083736,Patchell; Gregory David,27,0,30,3
1651087838219,MATH 10A,A03,083737,Patchell; Gregory David,22,0,30,8
1651087844245,MATH 10B,A01,083207,Staff,0,7,30,30
1651087844245,MATH 10B,A02,083208,Staff,0,6,30,30
1651087844245,MATH 10B,B01,083739,Staff,8,0,30,22
1651087844245,MATH 10B,B02,083740,Staff,28,0,30,2
1651087850269,MATH 18,A01,083743,Staff,0,0,30,30
1651087850269,MATH 18,A02,083744,Staff,23,0,30,7
1651087850269,MATH 18,A03,083745,Staff,19,0,30,11
1651087850269,MATH 18,A04,083746,Staff,26,0,30,4
1651087850269,MATH 18,B01,083748,Staff,0,16,30,30
1651087850269,MATH 18,B02,083749,Staff,0,14,30,30
1651087850269,MATH 18,B03,083750,Staff,0,14,30,30
1651087850269,MATH 18,B04,083751,Staff,0,13,30,30
1651087856293,MATH 20A,A01,083754,Staff,18,0,40,22
1651087862317,MATH 20B,A01,083756,Staff,0,14,30,30
1651087862317,MATH 20B,A02,083757,Staff,0,11,30,30
1651087868340,MATH 20C,A01,083760,Staff,0,16,30,30
1651087868340,MATH 20C,A02,083761,Staff,0,15,30,30
1651087868340,MATH 20C,B01,083762,Staff,7,0,30,23
1651087868340,MATH 20C,B02,083763,Staff,27,0,30,3
1651087874364,MATH 20D,A01,083765,Staff,3,1,30,27
1651087874364,MATH 20D,A02,083766,Staff,1,0,30,29
1651087874364,MATH 20D,A03,083767,Staff,22,0,30,8
1651087880390,MATH 20E,A01,083771,Staff,2,0,30,28
1651087880390,MATH 20E,A02,083772,Staff,9,0,30,21
1651087880390,MATH 20E,B01,083773,Staff,0,0,30,30
1651087880390,MATH 20E,B02,083774,Staff,0,1,30,30
1651087886417,MATH 103A,A01,083777,Staff,0,17,30,30
1651087886417,MATH 103A,A02,083778,Staff,0,17,30,30
1651087886417,MATH 103A,B01,083779,Staff,0,15,30,30
1651087886417,MATH 103A,B02,083780,Staff,0,14,30,30
1651087892450,MATH 105,A01,085443,Staff,0,24,30,30
1651087898472,MATH 109,A01,083213,Anzaldo; Leesa B,0,7,30,30
1651087898472,MATH 109,A02,083214,Anzaldo; Leesa B,0,7,30,30
1651087898472,MATH 109,B01,083215,Anzaldo; Leesa B,0,8,30,30
1651087898472,MATH 109,B02,083216,Anzaldo; Leesa B,1,8,30,29
1651087904499,MATH 142A,A01,083219,Chow; Bennett,0,15,30,30
1651087904499,MATH 142A,A02,083220,Chow; Bennett,0,15,30,30
1651087904499,MATH 142A,B01,083221,Chow; Bennett,0,16,30,30
1651087904499,MATH 142A,B02,083222,Chow; Bennett,0,15,30,30
1651087910524,MATH 193A,A01,083224,Staff,0,9,30,30
1651087910524,MATH 193A,A02,083225,Staff,0,7,30,30
1651087910524,MATH 193A,A03,083781,Staff,0,7,30,30
1651087910524,MATH 193A,A04,083782,Staff,0,7,30,30
1651087916556,MATH 197,001,091859,McAuley; Julian John,9998,0,9999,1
1651087922615,COGS 9,A01,083615,Staff,0,20,60,60
1651087928638,COGS 11,A01,083617,Boyle; Mary E. T.,13,0,40,27
1651087934662,COGS 13,A01,083071,Staff,0,38,40,40
1651087940688,COGS 14A,A01,092681,Staff,0,39,100,100
1651087946713,COGS 14B,A01,083073,Cheng; Tzu-Han,0,13,50,50
1651087952757,COGS 17,A01,092677,Staff,9,0,75,66
1651087958794,COGS 100,A01,083619,Staff,0,30,60,60
1651087964819,COGS 101A,A01,083621,Davis; Joshua Daniel,0,29,60,60
1651087970851,COGS 101B,A01,091572,Staff,0,8,60,60
1651087976879,COGS 101C,A01,083625,Delgado; Tania,13,0,30,17
1651087982907,COGS 107A,A01,083627,Boyle; Mary E. T.,0,17,60,60
1651087988939,COGS 118A,A01,083075,Staff,0,10,60,60
1651087994978,CSE 3,A50,083646,Miranda; Gregory Joseph,15,0,38,23
1651087994978,CSE 3,A51,083647,Miranda; Gregory Joseph,36,0,37,1
1651088001005,CSE 8A,A50,083650,Miranda; Gregory Joseph,0,31,40,40
1651088007030,CSE 11,A01,083080,Cao; Yingjun,1,98,40,39
1651088013052,CSE 12,A01,083652,Staff,0,27,100,100
1651088019170,CSE 15L,A01,083654,Staff,0,3,50,50
1651088019170,CSE 15L,A02,083655,Staff,0,3,50,50
1651088025192,CSE 20,A01,083657,Staff,46,0,80,34
1651088031220,CSE 30,A01,083084,Eldon; John,0,38,80,80
1651088037245,CSE 100,A01,083659,Cao; Yingjun,0,72,50,50
1651088043277,CSE 134B,A01,083661,Powell; Thomas Allan,0,38,65,65
1651088049304,CSE 140,A01,083663,Staff,0,15,75,75
1651088055332,CSE 140L,A01,083088,Eldon; John,3,0,100,97
1651088061358,CSE 175,A01,083665,Kumar; Rakesh,0,0,25,25
1651088067384,CSE 190,A00,092507,Dubnov; Shlomo,9,0,20,11
1651088073410,ECE 45,A01,083139,Staff,0,7,60,60
1651088079434,ECE 65,A50,083695,Staff,0,7,30,30
1651088085482,ECE 109,A01,091882,Touri; Behrouz,33,0,70,37
1651088091505,ECE 180,A00,083140,Abi Samra; Nicholas Camill,17,0,30,13
1651088091505,ECE 180,B00,083141,Abi Samra; Nicholas Camill,0,0,30,30
1651088097529,MATH 10A,A01,083735,Patchell; Gregory David,0,0,30,30
1651088097529,MATH 10A,A02,083736,Patchell; Gregory David,27,0,30,3
1651088097529,MATH 10A,A03,083737,Patchell; Gregory David,22,0,30,8
1651088103552,MATH 10B,A01,083207,Staff,0,7,30,30
1651088103552,MATH 10B,A02,083208,Staff,0,6,30,30
1651088103552,MATH 10B,B01,083739,Staff,8,0,30,22
1651088103552,MATH 10B,B02,083740,Staff,28,0,30,2
1651088109590,MATH 18,A01,083743,Staff,0,0,30,30
1651088109590,MATH 18,A02,083744,Staff,23,0,30,7
1651088109590,MATH 18,A03,083745,Staff,19,0,30,11
1651088109590,MATH 18,A04,083746,Staff,26,0,30,4
1651088109590,MATH 18,B01,083748,Staff,0,16,30,30
1651088109590,MATH 18,B02,083749,Staff,0,14,30,30
1651088109590,MATH 18,B03,083750,Staff,0,14,30,30
1651088109590,MATH 18,B04,083751,Staff,0,13,30,30
1651088115620,MATH 20A,A01,083754,Staff,18,0,40,22
1651088121648,MATH 20B,A01,083756,Staff,0,14,30,30
1651088121648,MATH 20B,A02,083757,Staff,0,11,30,30
1651088127674,MATH 20C,A01,083760,Staff,0,16,30,30
1651088127674,MATH 20C,A02,083761,Staff,0,15,30,30
1651088127674,MATH 20C,B01,083762,Staff,7,0,30,23
1651088127674,MATH 20C,B02,083763,Staff,27,0,30,3
1651088133708,MATH 20D,A01,083765,Staff,3,1,30,27
1651088133708,MATH 20D,A02,083766,Staff,1,0,30,29
1651088133708,MATH 20D,A03,083767,Staff,22,0,30,8
1651088139734,MATH 20E,A01,083771,Staff,2,0,30,28
1651088139734,MATH 20E,A02,083772,Staff,9,0,30,21
1651088139734,MATH 20E,B01,083773,Staff,0,0,30,30
1651088139734,MATH 20E,B02,083774,Staff,0,1,30,30
1651088145769,MATH 103A,A01,083777,Staff,0,17,30,30
1651088145769,MATH 103A,A02,083778,Staff,0,17,30,30
1651088145769,MATH 103A,B01,083779,Staff,0,15,30,30
1651088145769,MATH 103A,B02,083780,Staff,0,14,30,30
1651088151867,MATH 105,A01,085443,Staff,0,24,30,30
1651088157898,MATH 109,A01,083213,Anzaldo; Leesa B,0,7,30,30
1651088157898,MATH 109,A02,083214,Anzaldo; Leesa B,0,7,30,30
1651088157898,MATH 109,B01,083215,Anzaldo; Leesa B,0,8,30,30
1651088157898,MATH 109,B02,083216,Anzaldo; Leesa B,1,8,30,29
1651088163921,MATH 142A,A01,083219,Chow; Bennett,0,15,30,30
1651088163921,MATH 142A,A02,083220,Chow; Bennett,0,15,30,30
1651088163921,MATH 142A,B01,083221,Chow; Bennett,0,16,30,30
1651088163921,MATH 142A,B02,083222,Chow; Bennett,0,15,30,30
1651088169944,MATH 193A,A01,083224,Staff,0,9,30,30
1651088169944,MATH 193A,A02,083225,Staff,0,7,30,30
1651088169944,MATH 193A,A03,083781,Staff,0,7,30,30
1651088169944,MATH 193A,A04,083782,Staff,0,7,30,30
1651088175974,MATH 197,001,091859,McAuley; Julian John,9998,0,9999,1
1651088182033,COGS 9,A01,083615,Staff,0,20,60,60
1651088188074,COGS 11,A01,083617,Boyle; Mary E. T.,13,0,40,27
1651088194107,COGS 13,A01,083071,Staff,0,38,40,40
1651088200130,COGS 14A,A01,092681,Staff,0,39,100,100
1651088206155,COGS 14B,A01,083073,Cheng; Tzu-Han,0,13,50,50
1651088212179,COGS 17,A01,092677,Staff,9,0,75,66
1651088218214,COGS 100,A01,083619,Staff,0,30,60,60
1651088224241,COGS 101A,A01,083621,Davis; Joshua Daniel,0,29,60,60
1651088230271,COGS 101B,A01,091572,Staff,0,8,60,60
1651088236296,COGS 101C,A01,083625,Delgado; Tania,13,0,30,17
1651088242322,COGS 107A,A01,083627,Boyle; Mary E. T.,0,17,60,60
1651088248348,COGS 118A,A01,083075,Staff,0,10,60,60
1651088254375,CSE 3,A50,083646,Miranda; Gregory Joseph,15,0,38,23
1651088254375,CSE 3,A51,083647,Miranda; Gregory Joseph,36,0,37,1
1651088260398,CSE 8A,A50,083650,Miranda; Gregory Joseph,0,31,40,40
1651088266425,CSE 11,A01,083080,Cao; Yingjun,1,98,40,39
1651088272463,CSE 12,A01,083652,Staff,0,27,100,100
1651088278488,CSE 15L,A01,083654,Staff,0,3,50,50
1651088278488,CSE 15L,A02,083655,Staff,0,3,50,50
1651088284510,CSE 20,A01,083657,Staff,46,0,80,34
1651088290533,CSE 30,A01,083084,Eldon; John,0,38,80,80
1651088296561,CSE 100,A01,083659,Cao; Yingjun,0,72,50,50
1651088302584,CSE 134B,A01,083661,Powell; Thomas Allan,0,38,65,65
1651088308610,CSE 140,A01,083663,Staff,0,15,75,75
1651088314634,CSE 140L,A01,083088,Eldon; John,3,0,100,97
1651088320662,CSE 175,A01,083665,Kumar; Rakesh,0,0,25,25
1651088326684,CSE 190,A00,092507,Dubnov; Shlomo,9,0,20,11
1651088332711,ECE 45,A01,083139,Staff,0,7,60,60
1651088338739,ECE 65,A50,083695,Staff,0,7,30,30
1651088344762,ECE 109,A01,091882,Touri; Behrouz,33,0,70,37
1651088350784,ECE 180,A00,083140,Abi Samra; Nicholas Camill,17,0,30,13
1651088350784,ECE 180,B00,083141,Abi Samra; Nicholas Camill,0,0,30,32
1651088356818,MATH 10A,A01,083735,Patchell; Gregory David,0,0,30,30
1651088356818,MATH 10A,A02,083736,Patchell; Gregory David,27,0,30,3
1651088356818,MATH 10A,A03,083737,Patchell; Gregory David,22,0,30,8
1651088362843,MATH 10B,A01,083207,Staff,0,7,30,30
1651088362843,MATH 10B,A02,083208,Staff,0,6,30,30
1651088362843,MATH 10B,B01,083739,Staff,8,0,30,22
1651088362843,MATH 10B,B02,083740,Staff,28,0,30,2
1651088368869,MATH 18,A01,083743,Staff,0,0,30,30
1651088368869,MATH 18,A02,083744,Staff,23,0,30,7
1651088368869,MATH 18,A03,083745,Staff,19,0,30,11
1651088368869,MATH 18,A04,083746,Staff,26,0,30,4
1651088368869,MATH 18,B01,083748,Staff,0,16,30,30
1651088368869,MATH 18,B02,083749,Staff,0,14,30,30
1651088368869,MATH 18,B03,083750,Staff,0,14,30,30
1651088368869,MATH 18,B04,083751,Staff,0,13,30,30
1651088374895,MATH 20A,A01,083754,Staff,18,0,40,22
1651088380917,MATH 20B,A01,083756,Staff,0,14,30,30
1651088380917,MATH 20B,A02,083757,Staff,0,11,30,30
1651088386945,MATH 20C,A01,083760,Staff,0,16,30,30
1651088386945,MATH 20C,A02,083761,Staff,0,15,30,30
1651088386945,MATH 20C,B01,083762,Staff,7,0,30,23
1651088386945,MATH 20C,B02,083763,Staff,27,0,30,3
1651088392976,MATH 20D,A01,083765,Staff,3,1,30,27
1651088392976,MATH 20D,A02,083766,Staff,1,0,30,29
1651088392976,MATH 20D,A03,083767,Staff,22,0,30,8
1651088399011,MATH 20E,A01,083771,Staff,1,0,30,29
1651088399011,MATH 20E,A02,083772,Staff,9,0,30,21
1651088399011,MATH 20E,B01,083773,Staff,0,0,30,30
1651088399011,MATH 20E,B02,083774,Staff,0,1,30,30
1651088405038,MATH 103A,A01,083777,Staff,0,17,30,30
1651088405038,MATH 103A,A02,083778,Staff,0,17,30,30
1651088405038,MATH 103A,B01,083779,Staff,0,15,30,30
1651088405038,MATH 103A,B02,083780,Staff,0,14,30,30
1651088411070,MATH 105,A01,085443,Staff,0,24,30,30
1651088417095,MATH 109,A01,083213,Anzaldo; Leesa B,0,7,30,30
1651088417095,MATH 109,A02,083214,Anzaldo; Leesa B,0,7,30,30
1651088417095,MATH 109,B01,083215,Anzaldo; Leesa B,0,8,30,30
1651088417095,MATH 109,B02,083216,Anzaldo; Leesa B,1,8,30,29
1651088423129,MATH 142A,A01,083219,Chow; Bennett,0,15,30,30
1651088423129,MATH 142A,A02,083220,Chow; Bennett,0,15,30,30
1651088423129,MATH 142A,B01,083221,Chow; Bennett,0,16,30,30
1651088423129,MATH 142A,B02,083222,Chow; Bennett,0,15,30,30
1651088429152,MATH 193A,A01,083224,Staff,0,9,30,30
1651088429152,MATH 193A,A02,083225,Staff,0,7,30,30
1651088429152,MATH 193A,A03,083781,Staff,0,7,30,30
1651088429152,MATH 193A,A04,083782,Staff,0,7,30,30
1651088435193,MATH 197,001,091859,McAuley; Julian John,9998,0,9999,1
1651088441252,COGS 9,A01,083615,Staff,0,20,60,60
1651088447275,COGS 11,A01,083617,Boyle; Mary E. T.,13,0,40,27
1651088453304,COGS 13,A01,083071,Staff,0,38,40,40
1651088459330,COGS 14A,A01,092681,Staff,0,39,100,100
1651088465358,COGS 14B,A01,083073,Cheng; Tzu-Han,0,13,50,50
1651088471380,COGS 17,A01,092677,Staff,9,0,75,66
1651088477405,COGS 100,A01,083619,Staff,0,30,60,60
1651088483430,COGS 101A,A01,083621,Davis; Joshua Daniel,0,29,60,60
1651088489457,COGS 101B,A01,091572,Staff,0,8,60,60
1651088495478,COGS 101C,A01,083625,Delgado; Tania,13,0,30,17
1651088501511,COGS 107A,A01,083627,Boyle; Mary E. T.,0,17,60,60
1651088507532,COGS 118A,A01,083075,Staff,0,10,60,60
1651088513560,CSE 3,A50,083646,Miranda; Gregory Joseph,15,0,38,23
1651088513560,CSE 3,A51,083647,Miranda; Gregory Joseph,36,0,37,1
1651088519582,CSE 8A,A50,083650,Miranda; Gregory Joseph,0,31,40,40
1651088525605,CSE 11,A01,083080,Cao; Yingjun,1,98,40,39
1651088531627,CSE 12,A01,083652,Staff,0,27,100,100
1651088537650,CSE 15L,A01,083654,Staff,0,3,50,50
1651088537650,CSE 15L,A02,083655,Staff,0,3,50,50
1651088543673,CSE 20,A01,083657,Staff,46,0,80,34
1651088549710,CSE 30,A01,083084,Eldon; John,0,38,80,80
1651088555742,CSE 100,A01,083659,Cao; Yingjun,0,72,50,50
1651088561767,CSE 134B,A01,083661,Powell; Thomas Allan,0,38,65,65
1651088567792,CSE 140,A01,083663,Staff,0,15,75,75
1651088573816,CSE 140L,A01,083088,Eldon; John,3,0,100,97
1651088579840,CSE 175,A01,083665,Kumar; Rakesh,0,0,25,25
1651088585864,CSE 190,A00,092507,Dubnov; Shlomo,9,0,20,11
1651088591891,ECE 45,A01,083139,Staff,0,7,60,60
1651088597917,ECE 65,A50,083695,Staff,0,7,30,30
1651088603947,ECE 109,A01,091882,Touri; Behrouz,33,0,70,37
1651088609974,ECE 180,A00,083140,Abi Samra; Nicholas Camill,17,0,30,13
1651088609974,ECE 180,B00,083141,Abi Samra; Nicholas Camill,0,0,30,32
1651088616088,MATH 10A,A01,083735,Patchell; Gregory David,0,0,30,30
1651088616088,MATH 10A,A02,083736,Patchell; Gregory David,27,0,30,3
1651088616088,MATH 10A,A03,083737,Patchell; Gregory David,22,0,30,8
1651088622114,MATH 10B,A01,083207,Staff,0,7,30,30
1651088622114,MATH 10B,A02,083208,Staff,0,6,30,30
1651088622114,MATH 10B,B01,083739,Staff,8,0,30,22
1651088622114,MATH 10B,B02,083740,Staff,28,0,30,2
1651088628142,MATH 18,A01,083743,Staff,0,0,30,30
1651088628142,MATH 18,A02,083744,Staff,23,0,30,7
1651088628142,MATH 18,A03,083745,Staff,19,0,30,11
1651088628142,MATH 18,A04,083746,Staff,26,0,30,4
1651088628142,MATH 18,B01,083748,Staff,0,16,30,30
1651088628142,MATH 18,B02,083749,Staff,0,14,30,30
1651088628142,MATH 18,B03,083750,Staff,0,14,30,30
1651088628142,MATH 18,B04,083751,Staff,0,13,30,30
1651088634172,MATH 20A,A01,083754,Staff,18,0,40,22
1651088640204,MATH 20B,A01,083756,Staff,0,14,30,30
1651088640204,MATH 20B,A02,083757,Staff,0,11,30,30
1651088646227,MATH 20C,A01,083760,Staff,0,16,30,30
1651088646227,MATH 20C,A02,083761,Staff,0,15,30,30
1651088646227,MATH 20C,B01,083762,Staff,7,0,30,23
1651088646227,MATH 20C,B02,083763,Staff,27,0,30,3
1651088652250,MATH 20D,A01,083765,Staff,3,1,30,27
1651088652250,MATH 20D,A02,083766,Staff,1,0,30,29
1651088652250,MATH 20D,A03,083767,Staff,22,0,30,8
1651088658280,MATH 20E,A01,083771,Staff,1,0,30,29
1651088658280,MATH 20E,A02,083772,Staff,9,0,30,21
1651088658280,MATH 20E,B01,083773,Staff,0,0,30,30
1651088658280,MATH 20E,B02,083774,Staff,0,1,30,30
1651088664303,MATH 103A,A01,083777,Staff,0,17,30,30
1651088664303,MATH 103A,A02,083778,Staff,0,17,30,30
1651088664303,MATH 103A,B01,083779,Staff,0,15,30,30
1651088664303,MATH 103A,B02,083780,Staff,0,14,30,30
1651088670330,MATH 105,A01,085443,Staff,0,24,30,30
1651088676364,MATH 109,A01,083213,Anzaldo; Leesa B,0,7,30,30
1651088676364,MATH 109,A02,083214,Anzaldo; Leesa B,0,7,30,30
1651088676364,MATH 109,B01,083215,Anzaldo; Leesa B,0,8,30,30
1651088676364,MATH 109,B02,083216,Anzaldo; Leesa B,1,8,30,29
1651088682388,MATH 142A,A01,083219,Chow; Bennett,0,15,30,30
1651088682388,MATH 142A,A02,083220,Chow; Bennett,0,15,30,30
1651088682388,MATH 142A,B01,083221,Chow; Bennett,0,16,30,30
1651088682388,MATH 142A,B02,083222,Chow; Bennett,0,15,30,30
1651088688415,MATH 193A,A01,083224,Staff,0,9,30,30
1651088688415,MATH 193A,A02,083225,Staff,0,7,30,30
1651088688415,MATH 193A,A03,083781,Staff,0,7,30,30
1651088688415,MATH 193A,A04,083782,Staff,0,7,30,30
1651088694445,MATH 197,001,091859,McAuley; Julian John,9998,0,9999,1
1651088700496,COGS 9,A01,083615,Staff,0,20,60,60
1651088706519,COGS 11,A01,083617,Boyle; Mary E. T.,13,0,40,27
1651088712544,COGS 13,A01,083071,Staff,0,38,40,40
1651088718584,COGS 14A,A01,092681,Staff,0,39,100,100
1651088724606,COGS 14B,A01,083073,Cheng; Tzu-Han,0,13,50,50
1651088730631,COGS 17,A01,092677,Staff,9,0,75,66
1651088736655,COGS 100,A01,083619,Staff,0,30,60,60
1651088742679,COGS 101A,A01,083621,Davis; Joshua Daniel,0,29,60,60
1651088748724,COGS 101B,A01,091572,Staff,0,8,60,60
1651088754749,COGS 101C,A01,083625,Delgado; Tania,13,0,30,17
1651088760772,COGS 107A,A01,083627,Boyle; Mary E. T.,0,17,60,60
1651088766800,COGS 118A,A01,083075,Staff,0,10,60,60
1651088772823,CSE 3,A50,083646,Miranda; Gregory Joseph,15,0,38,23
1651088772823,CSE 3,A51,083647,Miranda; Gregory Joseph,36,0,37,1
1651088778848,CSE 8A,A50,083650,Miranda; Gregory Joseph,0,31,40,40
1651088784873,CSE 11,A01,083080,Cao; Yingjun,1,98,40,39
1651088790897,CSE 12,A01,083652,Staff,0,27,100,100
1651088796922,CSE 15L,A01,083654,Staff,0,3,50,50
1651088796922,CSE 15L,A02,083655,Staff,0,3,50,50
1651088802943,CSE 20,A01,083657,Staff,46,0,80,34
1651088808965,CSE 30,A01,083084,Eldon; John,0,38,80,80
1651088814994,CSE 100,A01,083659,Cao; Yingjun,0,72,50,50
1651088821028,CSE 134B,A01,083661,Powell; Thomas Allan,0,38,65,65
1651088827051,CSE 140,A01,083663,Staff,0,15,75,75
1651088833075,CSE 140L,A01,083088,Eldon; John,3,0,100,97
1651088839101,CSE 175,A01,083665,Kumar; Rakesh,0,0,25,25
1651088845132,CSE 190,A00,092507,Dubnov; Shlomo,9,0,20,11
1651088851167,ECE 45,A01,083139,Staff,0,7,60,60
1651088857189,ECE 65,A50,083695,Staff,0,7,30,30
1651088863217,ECE 109,A01,091882,Touri; Behrouz,33,0,70,37
1651088869242,ECE 180,A00,083140,Abi Samra; Nicholas Camill,17,0,30,13
1651088869242,ECE 180,B00,083141,Abi Samra; Nicholas Camill,0,0,30,32
1651088875267,MATH 10A,A01,083735,Patchell; Gregory David,0,0,30,30
1651088875267,MATH 10A,A02,083736,Patchell; Gregory David,27,0,30,3
1651088875267,MATH 10A,A03,083737,Patchell; Gregory David,22,0,30,8
1651088881293,MATH 10B,A01,083207,Staff,0,7,30,30
1651088881293,MATH 10B,A02,083208,Staff,0,6,30,30
1651088881293,MATH 10B,B01,083739,Staff,8,0,30,22
1651088881293,MATH 10B,B02,083740,Staff,28,0,30,2
1651088887328,MATH 18,A01,083743,Staff,0,0,30,30
1651088887328,MATH 18,A02,083744,Staff,23,0,30,7
1651088887328,MATH 18,A03,083745,Staff,19,0,30,11
1651088887328,MATH 18,A04,083746,Staff,26,0,30,4
1651088887328,MATH 18,B01,083748,Staff,0,16,30,30
1651088887328,MATH 18,B02,083749,Staff,0,14,30,30
1651088887328,MATH 18,B03,083750,Staff,0,14,30,30
1651088887328,MATH 18,B04,083751,Staff,0,13,30,30
1651088893352,MATH 20A,A01,083754,Staff,18,0,40,22
1651088899376,MATH 20B,A01,083756,Staff,0,14,30,30
1651088899376,MATH 20B,A02,083757,Staff,0,11,30,30
1651088905408,MATH 20C,A01,083760,Staff,0,16,30,30
1651088905408,MATH 20C,A02,083761,Staff,0,15,30,30
1651088905408,MATH 20C,B01,083762,Staff,7,0,30,23
1651088905408,MATH 20C,B02,083763,Staff,27,0,30,3
1651088911437,MATH 20D,A01,083765,Staff,3,1,30,27
1651088911437,MATH 20D,A02,083766,Staff,1,0,30,29
1651088911437,MATH 20D,A03,083767,Staff,22,0,30,8
1651088917460,MATH 20E,A01,083771,Staff,1,0,30,29
1651088917460,MATH 20E,A02,083772,Staff,9,0,30,21
1651088917460,MATH 20E,B01,083773,Staff,5,0,35,30
1651088917460,MATH 20E,B02,083774,Staff,5,1,35,30
1651088923482,MATH 103A,A01,083777,Staff,0,17,30,30
1651088923482,MATH 103A,A02,083778,Staff,0,17,30,30
1651088923482,MATH 103A,B01,083779,Staff,0,15,30,30
1651088923482,MATH 103A,B02,083780,Staff,0,14,30,30
1651088929505,MATH 105,A01,085443,Staff,0,24,30,30
1651088935529,MATH 109,A01,083213,Anzaldo; Leesa B,0,7,30,30
1651088935529,MATH 109,A02,083214,Anzaldo; Leesa B,0,7,30,30
1651088935529,MATH 109,B01,083215,Anzaldo; Leesa B,0,8,30,30
1651088935529,MATH 109,B02,083216,Anzaldo; Leesa B,1,8,30,29
1651088941559,MATH 142A,A01,083219,Chow; Bennett,0,15,30,30
1651088941559,MATH 142A,A02,083220,Chow; Bennett,0,15,30,30
1651088941559,MATH 142A,B01,083221,Chow; Bennett,0,16,30,30
1651088941559,MATH 142A,B02,083222,Chow; Bennett,0,15,30,30
1651088947588,MATH 193A,A01,083224,Staff,0,9,30,30
1651088947588,MATH 193A,A02,083225,Staff,0,7,30,30
1651088947588,MATH 193A,A03,083781,Staff,0,7,30,30
1651088947588,MATH 193A,A04,083782,Staff,0,7,30,30
1651088953611,MATH 197,001,091859,McAuley; Julian John,9998,0,9999,1
1651088959682,COGS 9,A01,083615,Staff,0,20,60,60
1651088965716,COGS 11,A01,083617,Boyle; Mary E. T.,13,0,40,27
1651088971742,COGS 13,A01,083071,Staff,0,38,40,40
1651088977769,COGS 14A,A01,092681,Staff,0,39,100,100
1651088983792,COGS 14B,A01,083073,Cheng; Tzu-Han,0,12,50,50
1651088989816,COGS 17,A01,092677,Staff,9,0,75,66
1651088995839,COGS 100,A01,083619,Staff,0,30,60,60
1651089001865,COGS 101A,A01,083621,Davis; Joshua Daniel,0,29,60,60
1651089007886,COGS 101B,A01,091572,Staff,0,8,60,60
1651089013912,COGS 101C,A01,083625,Delgado; Tania,13,0,30,17
1651089019937,COGS 107A,A01,083627,Boyle; Mary E. T.,0,17,60,60
1651089025972,COGS 118A,A01,083075,Staff,0,10,60,60
1651089031997,CSE 3,A50,083646,Miranda; Gregory Joseph,15,0,38,23
1651089031997,CSE 3,A51,083647,Miranda; Gregory Joseph,36,0,37,1
1651089038020,CSE 8A,A50,083650,Miranda; Gregory Joseph,0,31,40,40
1651089044043,CSE 11,A01,083080,Cao; Yingjun,1,98,40,39
1651089050069,CSE 12,A01,083652,Staff,0,27,100,100
1651089056092,CSE 15L,A01,083654,Staff,0,3,50,50
1651089056092,CSE 15L,A02,083655,Staff,0,3,50,50
1651089062113,CSE 20,A01,083657,Staff,46,0,80,34
1651089068136,CSE 30,A01,083084,Eldon; John,0,38,80,80
1651089074159,CSE 100,A01,083659,Cao; Yingjun,0,72,50,50
1651089080185,CSE 134B,A01,083661,Powell; Thomas Allan,0,38,65,65
1651089086210,CSE 140,A01,083663,Staff,0,15,75,75
1651089092238,CSE 140L,A01,083088,Eldon; John,3,0,100,97
1651089098259,CSE 175,A01,083665,Kumar; Rakesh,0,0,25,25
1651089104286,CSE 190,A00,092507,Dubnov; Shlomo,9,0,20,11
1651089110313,ECE 45,A01,083139,Staff,0,7,60,60
1651089116337,ECE 65,A50,083695,Staff,0,7,30,30
1651089122361,ECE 109,A01,091882,Touri; Behrouz,33,0,70,37
1651089128400,ECE 180,A00,083140,Abi Samra; Nicholas Camill,17,0,30,13
1651089128400,ECE 180,B00,083141,Abi Samra; Nicholas Camill,0,0,30,32
1651089134430,MATH 10A,A01,083735,Patchell; Gregory David,0,0,30,30
1651089134430,MATH 10A,A02,083736,Patchell; Gregory David,27,0,30,3
1651089134430,MATH 10A,A03,083737,Patchell; Gregory David,22,0,30,8
1651089140455,MATH 10B,A01,083207,Staff,0,7,30,30
1651089140455,MATH 10B,A02,083208,Staff,0,6,30,30
1651089140455,MATH 10B,B01,083739,Staff,8,0,30,22
1651089140455,MATH 10B,B02,083740,Staff,28,0,30,2
1651089146480,MATH 18,A01,083743,Staff,0,0,30,30
1651089146480,MATH 18,A02,083744,Staff,23,0,30,7
1651089146480,MATH 18,A03,083745,Staff,19,0,30,11
1651089146480,MATH 18,A04,083746,Staff,26,0,30,4
1651089146480,MATH 18,B01,083748,Staff,0,16,30,30
1651089146480,MATH 18,B02,083749,Staff,0,14,30,30
1651089146480,MATH 18,B03,083750,Staff,0,14,30,30
1651089146480,MATH 18,B04,083751,Staff,0,13,30,30
1651089152502,MATH 20A,A01,083754,Staff,18,0,40,22
1651089158545,MATH 20B,A01,083756,Staff,0,14,30,30
1651089158545,MATH 20B,A02,083757,Staff,0,11,30,30
1651089164570,MATH 20C,A01,083760,Staff,0,16,30,30
1651089164570,MATH 20C,A02,083761,Staff,0,15,30,30
1651089164570,MATH 20C,B01,083762,Staff,7,0,30,23
1651089164570,MATH 20C,B02,083763,Staff,27,0,30,3
1651089170606,MATH 20D,A01,083765,Staff,3,1,30,27
1651089170606,MATH 20D,A02,083766,Staff,1,0,30,29
1651089170606,MATH 20D,A03,083767,Staff,22,0,30,8
1651089176633,MATH 20E,A01,083771,Staff,1,0,30,29
1651089176633,MATH 20E,A02,083772,Staff,9,0,30,21
1651089176633,MATH 20E,B01,083773,Staff,5,0,35,30
1651089176633,MATH 20E,B02,083774,Staff,5,1,35,30
1651089182674,MATH 103A,A01,083777,Staff,0,17,30,30
1651089182674,MATH 103A,A02,083778,Staff,0,17,30,30
1651089182674,MATH 103A,B01,083779,Staff,0,15,30,30
1651089182674,MATH 103A,B02,083780,Staff,0,14,30,30
1651089188703,MATH 105,A01,085443,Staff,0,24,30,30
1651089194729,MATH 109,A01,083213,Anzaldo; Leesa B,0,7,30,30
1651089194729,MATH 109,A02,083214,Anzaldo; Leesa B,0,7,30,30
1651089194729,MATH 109,B01,083215,Anzaldo; Leesa B,0,8,30,30
1651089194729,MATH 109,B02,083216,Anzaldo; Leesa B,1,8,30,29
1651089200754,MATH 142A,A01,083219,Chow; Bennett,0,15,30,30
1651089200754,MATH 142A,A02,083220,Chow; Bennett,0,15,30,30
1651089200754,MATH 142A,B01,083221,Chow; Bennett,0,16,30,30
1651089200754,MATH 142A,B02,083222,Chow; Bennett,0,15,30,30
1651089206776,MATH 193A,A01,083224,Staff,0,9,30,30
1651089206776,MATH 193A,A02,083225,Staff,0,7,30,30
1651089206776,MATH 193A,A03,083781,Staff,0,7,30,30
1651089206776,MATH 193A,A04,083782,Staff,0,7,30,30
1651089212885,MATH 197,001,091859,McAuley; Julian John,9998,0,9999,1
1651089218939,COGS 9,A01,083615,Staff,0,20,60,60
1651089224961,COGS 11,A01,083617,Boyle; Mary E. T.,13,0,40,27
1651089230984,COGS 13,A01,083071,Staff,0,38,40,40
1651089237008,COGS 14A,A01,092681,Staff,0,39,100,100
1651089243034,COGS 14B,A01,083073,Cheng; Tzu-Han,0,12,50,50
1651089249060,COGS 17,A01,092677,Staff,9,0,75,66
1651089255083,COGS 100,A01,083619,Staff,0,30,60,60
1651089261115,COGS 101A,A01,083621,Davis; Joshua Daniel,0,29,60,60
1651089267141,COGS 101B,A01,091572,Staff,0,8,60,60
1651089273168,COGS 101C,A01,083625,Delgado; Tania,13,0,30,17
1651089279206,COGS 107A,A01,083627,Boyle; Mary E. T.,0,17,60,60
1651089285233,COGS 118A,A01,083075,Staff,0,10,60,60
1651089291260,CSE 3,A50,083646,Miranda; Gregory Joseph,15,0,38,23
1651089291260,CSE 3,A51,083647,Miranda; Gregory Joseph,36,0,37,1
1651089297296,CSE 8A,A50,083650,Miranda; Gregory Joseph,0,31,40,40
1651089303322,CSE 11,A01,083080,Cao; Yingjun,1,98,40,39
1651089309343,CSE 12,A01,083652,Staff,0,27,100,100
1651089315371,CSE 15L,A01,083654,Staff,0,3,50,50
1651089315371,CSE 15L,A02,083655,Staff,0,3,50,50
1651089321400,CSE 20,A01,083657,Staff,46,0,80,34
1651089327427,CSE 30,A01,083084,Eldon; John,0,38,80,80
1651089333453,CSE 100,A01,083659,Cao; Yingjun,0,72,50,50
1651089339479,CSE 134B,A01,083661,Powell; Thomas Allan,0,38,65,65
1651089345504,CSE 140,A01,083663,Staff,0,15,75,75
1651089351538,CSE 140L,A01,083088,Eldon; John,3,0,100,97
1651089357562,CSE 175,A01,083665,Kumar; Rakesh,0,0,25,25
1651089363586,CSE 190,A00,092507,Dubnov; Shlomo,9,0,20,11
1651089369610,ECE 45,A01,083139,Staff,0,7,60,60
1651089375646,ECE 65,A50,083695,Staff,0,7,30,30
1651089381669,ECE 109,A01,091882,Touri; Behrouz,33,0,70,37
1651089387696,ECE 180,A00,083140,Abi Samra; Nicholas Camill,17,0,30,13
1651089387696,ECE 180,B00,083141,Abi Samra; Nicholas Camill,0,0,30,32
1651089393724,MATH 10A,A01,083735,Patchell; Gregory David,0,0,30,30
1651089393724,MATH 10A,A02,083736,Patchell; Gregory David,27,0,30,3
1651089393724,MATH 10A,A03,083737,Patchell; Gregory David,22,0,30,8
1651089399749,MATH 10B,A01,083207,Staff,0,7,30,30
1651089399749,MATH 10B,A02,083208,Staff,0,6,30,30
1651089399749,MATH 10B,B01,083739,Staff,7,0,30,23
1651089399749,MATH 10B,B02,083740,Staff,28,0,30,2
1651089405778,MATH 18,A01,083743,Staff,0,0,30,30
1651089405778,MATH 18,A02,083744,Staff,22,0,30,8
1651089405778,MATH 18,A03,083745,Staff,19,0,30,11
1651089405778,MATH 18,A04,083746,Staff,26,0,30,4
1651089405778,MATH 18,B01,083748,Staff,0,16,30,30
1651089405778,MATH 18,B02,083749,Staff,0,14,30,30
1651089405778,MATH 18,B03,083750,Staff,0,14,30,30
1651089405778,MATH 18,B04,083751,Staff,0,13,30,30
1651089411804,MATH 20A,A01,083754,Staff,18,0,40,22
1651089417828,MATH 20B,A01,083756,Staff,0,14,30,30
1651089417828,MATH 20B,A02,083757,Staff,0,11,30,30
1651089423851,MATH 20C,A01,083760,Staff,0,16,30,30
1651089423851,MATH 20C,A02,083761,Staff,0,15,30,30
1651089423851,MATH 20C,B01,083762,Staff,7,0,30,23
1651089423851,MATH 20C,B02,083763,Staff,27,0,30,3
1651089429879,MATH 20D,A01,083765,Staff,3,1,30,27
1651089429879,MATH 20D,A02,083766,Staff,1,0,30,29
1651089429879,MATH 20D,A03,083767,Staff,22,0,30,8
1651089435900,MATH 20E,A01,083771,Staff,1,0,30,29
1651089435900,MATH 20E,A02,083772,Staff,9,0,30,21
1651089435900,MATH 20E,B01,083773,Staff,5,0,35,30
1651089435900,MATH 20E,B02,083774,Staff,5,1,35,30
1651089441927,MATH 103A,A01,083777,Staff,0,17,30,30
1651089441927,MATH 103A,A02,083778,Staff,0,17,30,30
1651089441927,MATH 103A,B01,083779,Staff,0,15,30,30
1651089441927,MATH 103A,B02,083780,Staff,0,14,30,30
1651089447950,MATH 105,A01,085443,Staff,0,24,30,30
1651089453974,MATH 109,A01,083213,Anzaldo; Leesa B,0,7,30,30
1651089453974,MATH 109,A02,083214,Anzaldo; Leesa B,0,7,30,30
1651089453974,MATH 109,B01,083215,Anzaldo; Leesa B,0,8,30,30
1651089453974,MATH 109,B02,083216,Anzaldo; Leesa B,1,8,30,29
1651089459998,MATH 142A,A01,083219,Chow; Bennett,0,15,30,30
1651089459998,MATH 142A,A02,083220,Chow; Bennett,0,15,30,30
1651089459998,MATH 142A,B01,083221,Chow; Bennett,0,16,30,30
1651089459998,MATH 142A,B02,083222,Chow; Bennett,0,15,30,30
1651089466024,MATH 193A,A01,083224,Staff,0,9,30,30
1651089466024,MATH 193A,A02,083225,Staff,0,7,30,30
1651089466024,MATH 193A,A03,083781,Staff,0,7,30,30
1651089466024,MATH 193A,A04,083782,Staff,0,7,30,30
1651089472046,MATH 197,001,091859,McAuley; Julian John,9998,0,9999,1
1651089478096,COGS 9,A01,083615,Staff,0,20,60,60
1651089484123,COGS 11,A01,083617,Boyle; Mary E. T.,13,0,40,27
1651089490165,COGS 13,A01,083071,Staff,0,38,40,40
1651089496188,COGS 14A,A01,092681,Staff,0,39,100,100
1651089502211,COGS 14B,A01,083073,Cheng; Tzu-Han,0,12,50,50
1651089508255,COGS 17,A01,092677,Staff,9,0,75,66
1651089514289,COGS 100,A01,083619,Staff,0,30,60,60
1651089520312,COGS 101A,A01,083621,Davis; Joshua Daniel,0,29,60,60
1651089526356,COGS 101B,A01,091572,Staff,0,8,60,60
1651089532387,COGS 101C,A01,083625,Delgado; Tania,13,0,30,17
1651089538420,COGS 107A,A01,083627,Boyle; Mary E. T.,0,17,60,60
1651089544442,COGS 118A,A01,083075,Staff,0,10,60,60
1651089550463,CSE 3,A50,083646,Miranda; Gregory Joseph,15,0,38,23
1651089550463,CSE 3,A51,083647,Miranda; Gregory Joseph,36,0,37,1
1651089556508,CSE 8A,A50,083650,Miranda; Gregory Joseph,0,31,40,40
1651089562535,CSE 11,A01,083080,Cao; Yingjun,1,98,40,39
1651089568557,CSE 12,A01,083652,Staff,0,28,100,100
1651089574583,CSE 15L,A01,083654,Staff,0,3,50,50
1651089574583,CSE 15L,A02,083655,Staff,0,3,50,50
1651089580620,CSE 20,A01,083657,Staff,46,0,80,34
1651089586651,CSE 30,A01,083084,Eldon; John,0,38,80,80
1651089592687,CSE 100,A01,083659,Cao; Yingjun,0,72,50,50
1651089598712,CSE 134B,A01,083661,Powell; Thomas Allan,0,38,65,65
1651089604734,CSE 140,A01,083663,Staff,0,15,75,75
1651089610756,CSE 140L,A01,083088,Eldon; John,3,0,100,97
1651089616779,CSE 175,A01,083665,Kumar; Rakesh,0,0,25,25
1651089622802,CSE 190,A00,092507,Dubnov; Shlomo,9,0,20,11
1651089628824,ECE 45,A01,083139,Staff,0,7,60,60
1651089634848,ECE 65,A50,083695,Staff,0,7,30,30
1651089640874,ECE 109,A01,091882,Touri; Behrouz,33,0,70,37
1651089646907,ECE 180,A00,083140,Abi Samra; Nicholas Camill,17,0,30,13
1651089646907,ECE 180,B00,083141,Abi Samra; Nicholas Camill,0,0,30,32
1651089652934,MATH 10A,A01,083735,Patchell; Gregory David,0,0,30,30
1651089652934,MATH 10A,A02,083736,Patchell; Gregory David,27,0,30,3
1651089652934,MATH 10A,A03,083737,Patchell; Gregory David,22,0,30,8
1651089658959,MATH 10B,A01,083207,Staff,0,7,30,30
1651089658959,MATH 10B,A02,083208,Staff,0,6,30,30
1651089658959,MATH 10B,B01,083739,Staff,7,0,30,23
1651089658959,MATH 10B,B02,083740,Staff,28,0,30,2
1651089664996,MATH 18,A01,083743,Staff,0,0,30,30
1651089664996,MATH 18,A02,083744,Staff,22,0,30,8
1651089664996,MATH 18,A03,083745,Staff,19,0,30,11
1651089664996,MATH 18,A04,083746,Staff,26,0,30,4
1651089664996,MATH 18,B01,083748,Staff,0,16,30,30
1651089664996,MATH 18,B02,083749,Staff,0,14,30,30
1651089664996,MATH 18,B03,083750,Staff,0,14,30,30
1651089664996,MATH 18,B04,083751,Staff,0,13,30,30
1651089671020,MATH 20A,A01,083754,Staff,18,0,40,22
1651089677047,MATH 20B,A01,083756,Staff,0,14,30,30
1651089677047,MATH 20B,A02,083757,Staff,0,11,30,30
1651089683075,MATH 20C,A01,083760,Staff,0,16,30,30
1651089683075,MATH 20C,A02,083761,Staff,0,15,30,30
1651089683075,MATH 20C,B01,083762,Staff,7,0,30,23
1651089683075,MATH 20C,B02,083763,Staff,27,0,30,3
1651089689108,MATH 20D,A01,083765,Staff,3,1,30,27
1651089689108,MATH 20D,A02,083766,Staff,1,0,30,29
1651089689108,MATH 20D,A03,083767,Staff,22,0,30,8
1651089695145,MATH 20E,A01,083771,Staff,1,0,30,29
1651089695145,MATH 20E,A02,083772,Staff,9,0,30,21
1651089695145,MATH 20E,B01,083773,Staff,5,0,35,30
1651089695145,MATH 20E,B02,083774,Staff,5,1,35,30
1651089701174,MATH 103A,A01,083777,Staff,0,17,30,30
1651089701174,MATH 103A,A02,083778,Staff,0,17,30,30
1651089701174,MATH 103A,B01,083779,Staff,0,15,30,30
1651089701174,MATH 103A,B02,083780,Staff,0,14,30,30
1651089707202,MATH 105,A01,085443,Staff,0,24,30,30
1651089713227,MATH 109,A01,083213,Anzaldo; Leesa B,0,7,30,30
1651089713227,MATH 109,A02,083214,Anzaldo; Leesa B,0,7,30,30
1651089713227,MATH 109,B01,083215,Anzaldo; Leesa B,0,8,30,30
1651089713227,MATH 109,B02,083216,Anzaldo; Leesa B,1,8,30,29
1651089719254,MATH 142A,A01,083219,Chow; Bennett,0,15,30,30
1651089719254,MATH 142A,A02,083220,Chow; Bennett,0,15,30,30
1651089719254,MATH 142A,B01,083221,Chow; Bennett,0,16,30,30
1651089719254,MATH 142A,B02,083222,Chow; Bennett,0,15,30,30
1651089725279,MATH 193A,A01,083224,Staff,0,9,30,30
1651089725279,MATH 193A,A02,083225,Staff,0,7,30,30
1651089725279,MATH 193A,A03,083781,Staff,0,7,30,30
1651089725279,MATH 193A,A04,083782,Staff,0,7,30,30
1651089731364,MATH 197,001,091859,McAuley; Julian John,9998,0,9999,1
1651089737421,COGS 9,A01,083615,Staff,0,20,60,60
1651089743444,COGS 11,A01,083617,Boyle; Mary E. T.,13,0,40,27
1651089749467,COGS 13,A01,083071,Staff,0,38,40,40
1651089755494,COGS 14A,A01,092681,Staff,0,39,100,100
1651089761532,COGS 14B,A01,083073,Cheng; Tzu-Han,0,12,50,50
1651089767557,COGS 17,A01,092677,Staff,9,0,75,66
1651089773581,COGS 100,A01,083619,Staff,0,30,60,60
1651089779612,COGS 101A,A01,083621,Davis; Joshua Daniel,0,29,60,60
1651089785636,COGS 101B,A01,091572,Staff,0,8,60,60
1651089791658,COGS 101C,A01,083625,Delgado; Tania,13,0,30,17
1651089797682,COGS 107A,A01,083627,Boyle; Mary E. T.,0,17,60,60
1651089803798,COGS 118A,A01,083075,Staff,0,10,60,60
1651089809821,CSE 3,A50,083646,Miranda; Gregory Joseph,15,0,38,23
1651089809821,CSE 3,A51,083647,Miranda; Gregory Joseph,36,0,37,1
1651089815852,CSE 8A,A50,083650,Miranda; Gregory Joseph,0,31,40,40
1651089821876,CSE 11,A01,083080,Cao; Yingjun,1,98,40,39
1651089827899,CSE 12,A01,083652,Staff,0,28,100,100
1651089833923,CSE 15L,A01,083654,Staff,0,3,50,50
1651089833923,CSE 15L,A02,083655,Staff,0,3,50,50
1651089839948,CSE 20,A01,083657,Staff,46,0,80,34
1651089845977,CSE 30,A01,083084,Eldon; John,0,38,80,80
1651089852012,CSE 100,A01,083659,Cao; Yingjun,0,72,50,50
1651089858040,CSE 134B,A01,083661,Powell; Thomas Allan,0,38,65,65
1651089864062,CSE 140,A01,083663,Staff,0,15,75,75
1651089870099,CSE 140L,A01,083088,Eldon; John,3,0,100,97
1651089876124,CSE 175,A01,083665,Kumar; Rakesh,0,0,25,25
1651089882149,CSE 190,A00,092507,Dubnov; Shlomo,9,0,20,11
1651089888179,ECE 45,A01,083139,Staff,0,7,60,60
1651089894202,ECE 65,A50,083695,Staff,0,7,30,30
1651089900225,ECE 109,A01,091882,Touri; Behrouz,33,0,70,37
1651089906252,ECE 180,A00,083140,Abi Samra; Nicholas Camill,17,0,30,13
1651089906252,ECE 180,B00,083141,Abi Samra; Nicholas Camill,0,0,30,32
1651089912277,MATH 10A,A01,083735,Patchell; Gregory David,0,0,30,30
1651089912277,MATH 10A,A02,083736,Patchell; Gregory David,27,0,30,3
1651089912277,MATH 10A,A03,083737,Patchell; Gregory David,22,0,30,8
1651089918302,MATH 10B,A01,083207,Staff,0,7,30,30
1651089918302,MATH 10B,A02,083208,Staff,0,6,30,30
1651089918302,MATH 10B,B01,083739,Staff,7,0,30,23
1651089918302,MATH 10B,B02,083740,Staff,28,0,30,2
1651089924343,MATH 18,A01,083743,Staff,0,0,30,30
1651089924343,MATH 18,A02,083744,Staff,22,0,30,8
1651089924343,MATH 18,A03,083745,Staff,19,0,30,11
1651089924343,MATH 18,A04,083746,Staff,26,0,30,4
1651089924343,MATH 18,B01,083748,Staff,0,16,30,30
1651089924343,MATH 18,B02,083749,Staff,0,14,30,30
1651089924343,MATH 18,B03,083750,Staff,0,14,30,30
1651089924343,MATH 18,B04,083751,Staff,0,13,30,30
1651089930367,MATH 20A,A01,083754,Staff,18,0,40,22
1651089936395,MATH 20B,A01,083756,Staff,0,14,30,30
1651089936395,MATH 20B,A02,083757,Staff,0,11,30,30
1651089942421,MATH 20C,A01,083760,Staff,0,16,30,30
1651089942421,MATH 20C,A02,083761,Staff,0,15,30,30
1651089942421,MATH 20C,B01,083762,Staff,7,0,30,23
1651089942421,MATH 20C,B02,083763,Staff,27,0,30,3
1651089948443,MATH 20D,A01,083765,Staff,3,1,30,27
1651089948443,MATH 20D,A02,083766,Staff,1,0,30,29
1651089948443,MATH 20D,A03,083767,Staff,22,0,30,8
1651089954471,MATH 20E,A01,083771,Staff,1,0,30,29
1651089954471,MATH 20E,A02,083772,Staff,9,0,30,21
1651089954471,MATH 20E,B01,083773,Staff,5,0,35,30
1651089954471,MATH 20E,B02,083774,Staff,5,1,35,30
1651089960503,MATH 103A,A01,083777,Staff,0,17,30,30
1651089960503,MATH 103A,A02,083778,Staff,0,17,30,30
1651089960503,MATH 103A,B01,083779,Staff,0,15,30,30
1651089960503,MATH 103A,B02,083780,Staff,0,14,30,30
1651089966526,MATH 105,A01,085443,Staff,0,24,30,30
1651089972558,MATH 109,A01,083213,Anzaldo; Leesa B,0,7,30,30
1651089972558,MATH 109,A02,083214,Anzaldo; Leesa B,0,7,30,30
1651089972558,MATH 109,B01,083215,Anzaldo; Leesa B,0,8,30,30
1651089972558,MATH 109,B02,083216,Anzaldo; Leesa B,1,8,30,29
1651089978588,MATH 142A,A01,083219,Chow; Bennett,0,15,30,30
1651089978588,MATH 142A,A02,083220,Chow; Bennett,0,15,30,30
1651089978588,MATH 142A,B01,083221,Chow; Bennett,0,16,30,30
1651089978588,MATH 142A,B02,083222,Chow; Bennett,0,15,30,30
1651089984614,MATH 193A,A01,083224,Staff,0,9,30,30
1651089984614,MATH 193A,A02,083225,Staff,0,7,30,30
1651089984614,MATH 193A,A03,083781,Staff,0,7,30,30
1651089984614,MATH 193A,A04,083782,Staff,0,7,30,30
1651089990637,MATH 197,001,091859,McAuley; Julian John,9998,0,9999,1
1651089996686,COGS 9,A01,083615,Staff,0,20,60,60
1651090002716,COGS 11,A01,083617,Boyle; Mary E. T.,13,0,40,27
1651090008740,COGS 13,A01,083071,Staff,0,38,40,40
1651090014766,COGS 14A,A01,092681,Staff,0,39,100,100
1651090020789,COGS 14B,A01,083073,Cheng; Tzu-Han,0,12,50,50
1651090026812,COGS 17,A01,092677,Staff,8,0,75,67
1651090032835,COGS 100,A01,083619,Staff,0,30,60,60
1651090038857,COGS 101A,A01,083621,Davis; Joshua Daniel,0,29,60,60
1651090044880,COGS 101B,A01,091572,Staff,0,8,60,60
1651090050907,COGS 101C,A01,083625,Delgado; Tania,13,0,30,17
1651090056929,COGS 107A,A01,083627,Boyle; Mary E. T.,0,17,60,60
1651090062956,COGS 118A,A01,083075,Staff,0,10,60,60
1651090068979,CSE 3,A50,083646,Miranda; Gregory Joseph,15,0,38,23
1651090068979,CSE 3,A51,083647,Miranda; Gregory Joseph,36,0,37,1
1651090075005,CSE 8A,A50,083650,Miranda; Gregory Joseph,0,31,40,40
1651090081030,CSE 11,A01,083080,Cao; Yingjun,1,98,40,39
1651090087067,CSE 12,A01,083652,Staff,0,28,100,100
1651090093094,CSE 15L,A01,083654,Staff,0,3,50,50
1651090093094,CSE 15L,A02,083655,Staff,0,3,50,50
1651090099121,CSE 20,A01,083657,Staff,46,0,80,34
1651090105147,CSE 30,A01,083084,Eldon; John,0,38,80,80
1651090111172,CSE 100,A01,083659,Cao; Yingjun,0,72,50,50
1651090117200,CSE 134B,A01,083661,Powell; Thomas Allan,0,38,65,65
1651090134761,CSE 140,A01,083663,Staff,0,15,75,75
1651090140784,CSE 140L,A01,083088,Eldon; John,3,0,100,97
1651090146807,CSE 175,A01,083665,Kumar; Rakesh,0,0,25,25
1651090152832,CSE 190,A00,092507,Dubnov; Shlomo,9,0,20,11
1651090158863,ECE 45,A01,083139,Staff,0,7,60,60
1651090164892,ECE 65,A50,083695,Staff,0,7,30,30
1651090170920,ECE 109,A01,091882,Touri; Behrouz,33,0,70,37
1651090176944,ECE 180,A00,083140,Abi Samra; Nicholas Camill,17,0,30,13
1651090176944,ECE 180,B00,083141,Abi Samra; Nicholas Camill,0,0,30,32
1651090182973,MATH 10A,A01,083735,Patchell; Gregory David,0,0,30,30
1651090182973,MATH 10A,A02,083736,Patchell; Gregory David,27,0,30,3
1651090182973,MATH 10A,A03,083737,Patchell; Gregory David,22,0,30,8
1651090188996,MATH 10B,A01,083207,Staff,0,7,30,30
1651090188996,MATH 10B,A02,083208,Staff,0,6,30,30
1651090188996,MATH 10B,B01,083739,Staff,7,0,30,23
1651090188996,MATH 10B,B02,083740,Staff,28,0,30,2
1651090195030,MATH 18,A01,083743,Staff,0,0,30,30
1651090195030,MATH 18,A02,083744,Staff,22,0,30,8
1651090195030,MATH 18,A03,083745,Staff,19,0,30,11
1651090195030,MATH 18,A04,083746,Staff,26,0,30,4
1651090195030,MATH 18,B01,083748,Staff,0,16,30,30
1651090195030,MATH 18,B02,083749,Staff,0,14,30,30
1651090195030,MATH 18,B03,083750,Staff,0,14,30,30
1651090195030,MATH 18,B04,083751,Staff,0,13,30,30
1651090201056,MATH 20A,A01,083754,Staff,18,0,40,22
1651090207080,MATH 20B,A01,083756,Staff,0,14,30,30
1651090207080,MATH 20B,A02,083757,Staff,0,11,30,30
1651090213104,MATH 20C,A01,083760,Staff,0,16,30,30
1651090213104,MATH 20C,A02,083761,Staff,0,15,30,30
1651090213104,MATH 20C,B01,083762,Staff,7,0,30,23
1651090213104,MATH 20C,B02,083763,Staff,27,0,30,3
1651090219140,MATH 20D,A01,083765,Staff,3,1,30,27
1651090219140,MATH 20D,A02,083766,Staff,1,0,30,29
1651090219140,MATH 20D,A03,083767,Staff,22,0,30,8
1651090225168,MATH 20E,A01,083771,Staff,1,0,30,29
1651090225168,MATH 20E,A02,083772,Staff,9,0,30,21
1651090225168,MATH 20E,B01,083773,Staff,5,0,35,30
1651090225168,MATH 20E,B02,083774,Staff,5,1,35,30
1651090231200,MATH 103A,A01,083777,Staff,0,17,30,30
1651090231200,MATH 103A,A02,083778,Staff,0,17,30,30
1651090231200,MATH 103A,B01,083779,Staff,0,15,30,30
1651090231200,MATH 103A,B02,083780,Staff,0,14,30,30
1651090237224,MATH 105,A01,085443,Staff,0,24,30,30
1651090243251,MATH 109,A01,083213,Anzaldo; Leesa B,0,7,30,30
1651090243251,MATH 109,A02,083214,Anzaldo; Leesa B,0,7,30,30
1651090243251,MATH 109,B01,083215,Anzaldo; Leesa B,0,8,30,30
1651090243251,MATH 109,B02,083216,Anzaldo; Leesa B,1,8,30,29
1651090249279,MATH 142A,A01,083219,Chow; Bennett,0,15,30,30
1651090249279,MATH 142A,A02,083220,Chow; Bennett,0,15,30,30
1651090249279,MATH 142A,B01,083221,Chow; Bennett,0,16,30,30
1651090249279,MATH 142A,B02,083222,Chow; Bennett,0,15,30,30
1651090255302,MATH 193A,A01,083224,Staff,0,9,30,30
1651090255302,MATH 193A,A02,083225,Staff,0,7,30,30
1651090255302,MATH 193A,A03,083781,Staff,0,7,30,30
1651090255302,MATH 193A,A04,083782,Staff,0,7,30,30
1651090261325,MATH 197,001,091859,McAuley; Julian John,9998,0,9999,1
1651090267379,COGS 9,A01,083615,Staff,0,20,60,60
1651090273434,COGS 11,A01,083617,Boyle; Mary E. T.,13,0,40,27
1651090279457,COGS 13,A01,083071,Staff,0,38,40,40
1651090285480,COGS 14A,A01,092681,Staff,0,39,100,100
1651090291505,COGS 14B,A01,083073,Cheng; Tzu-Han,0,12,50,50
1651090297530,COGS 17,A01,092677,Staff,8,0,75,67
1651090303555,COGS 100,A01,083619,Staff,0,30,60,60
1651090309581,COGS 101A,A01,083621,Davis; Joshua Daniel,0,29,60,60
1651090315605,COGS 101B,A01,091572,Staff,0,8,60,60
1651090321632,COGS 101C,A01,083625,Delgado; Tania,13,0,30,17
1651090327658,COGS 107A,A01,083627,Boyle; Mary E. T.,0,17,60,60
1651090333696,COGS 118A,A01,083075,Staff,0,10,60,60
1651090339731,CSE 3,A50,083646,Miranda; Gregory Joseph,15,0,38,23
1651090339731,CSE 3,A51,083647,Miranda; Gregory Joseph,36,0,37,1
1651090345770,CSE 8A,A50,083650,Miranda; Gregory Joseph,0,31,40,40
1651090351797,CSE 11,A01,083080,Cao; Yingjun,1,98,40,39
1651090357823,CSE 12,A01,083652,Staff,0,28,100,100
1651090363853,CSE 15L,A01,083654,Staff,0,3,50,50
1651090363853,CSE 15L,A02,083655,Staff,0,3,50,50
1651090369877,CSE 20,A01,083657,Staff,46,0,80,34
1651090375899,CSE 30,A01,083084,Eldon; John,0,38,80,80
1651090381921,CSE 100,A01,083659,Cao; Yingjun,0,72,50,50
1651090387944,CSE 134B,A01,083661,Powell; Thomas Allan,0,38,65,65
1651090393969,CSE 140,A01,083663,Staff,0,15,75,75
1651090400015,CSE 140L,A01,083088,Eldon; John,3,0,100,97
1651090406041,CSE 175,A01,083665,Kumar; Rakesh,0,0,25,25
1651090412146,CSE 190,A00,092507,Dubnov; Shlomo,9,0,20,11
1651090418182,ECE 45,A01,083139,Staff,0,7,60,60
1651090424205,ECE 65,A50,083695,Staff,0,7,30,30
1651090430228,ECE 109,A01,091882,Touri; Behrouz,33,0,70,37
1651090436253,ECE 180,A00,083140,Abi Samra; Nicholas Camill,17,0,30,13
1651090436253,ECE 180,B00,083141,Abi Samra; Nicholas Camill,0,0,30,32
1651090442281,MATH 10A,A01,083735,Patchell; Gregory David,0,0,30,30
1651090442281,MATH 10A,A02,083736,Patchell; Gregory David,27,0,30,3
1651090442281,MATH 10A,A03,083737,Patchell; Gregory David,22,0,30,8
1651090448309,MATH 10B,A01,083207,Staff,0,7,30,30
1651090448309,MATH 10B,A02,083208,Staff,0,6,30,30
1651090448309,MATH 10B,B01,083739,Staff,7,0,30,23
1651090448309,MATH 10B,B02,083740,Staff,28,0,30,2
1651090454346,MATH 18,A01,083743,Staff,0,0,30,30
1651090454346,MATH 18,A02,083744,Staff,22,0,30,8
1651090454346,MATH 18,A03,083745,Staff,19,0,30,11
1651090454346,MATH 18,A04,083746,Staff,26,0,30,4
1651090454346,MATH 18,B01,083748,Staff,0,16,30,30
1651090454346,MATH 18,B02,083749,Staff,0,14,30,30
1651090454346,MATH 18,B03,083750,Staff,0,14,30,30
1651090454346,MATH 18,B04,083751,Staff,0,13,30,30
1651090460375,MATH 20A,A01,083754,Staff,18,0,40,22
1651090466400,MATH 20B,A01,083756,Staff,0,14,30,30
1651090466400,MATH 20B,A02,083757,Staff,0,11,30,30
1651090472423,MATH 20C,A01,083760,Staff,0,16,30,30
1651090472423,MATH 20C,A02,083761,Staff,0,15,30,30
1651090472423,MATH 20C,B01,083762,Staff,7,0,30,23
1651090472423,MATH 20C,B02,083763,Staff,27,0,30,3
1651090478445,MATH 20D,A01,083765,Staff,3,1,30,27
1651090478445,MATH 20D,A02,083766,Staff,1,0,30,29
1651090478445,MATH 20D,A03,083767,Staff,22,0,30,8
1651090484469,MATH 20E,A01,083771,Staff,1,0,30,29
1651090484469,MATH 20E,A02,083772,Staff,9,0,30,21
1651090484469,MATH 20E,B01,083773,Staff,5,0,35,30
1651090484469,MATH 20E,B02,083774,Staff,5,1,35,30
1651090490501,MATH 103A,A01,083777,Staff,0,17,30,30
1651090490501,MATH 103A,A02,083778,Staff,0,17,30,30
1651090490501,MATH 103A,B01,083779,Staff,0,15,30,30
1651090490501,MATH 103A,B02,083780,Staff,0,14,30,30
1651090496530,MATH 105,A01,085443,Staff,0,24,30,30
1651090502553,MATH 109,A01,083213,Anzaldo; Leesa B,0,7,30,30
1651090502553,MATH 109,A02,083214,Anzaldo; Leesa B,0,7,30,30
1651090502553,MATH 109,B01,083215,Anzaldo; Leesa B,0,8,30,30
1651090502553,MATH 109,B02,083216,Anzaldo; Leesa B,1,8,30,29
1651090508588,MATH 142A,A01,083219,Chow; Bennett,0,15,30,30
1651090508588,MATH 142A,A02,083220,Chow; Bennett,0,15,30,30
1651090508588,MATH 142A,B01,083221,Chow; Bennett,0,16,30,30
1651090508588,MATH 142A,B02,083222,Chow; Bennett,0,15,30,30
1651090514616,MATH 193A,A01,083224,Staff,0,9,30,30
1651090514616,MATH 193A,A02,083225,Staff,0,7,30,30
1651090514616,MATH 193A,A03,083781,Staff,0,7,30,30
1651090514616,MATH 193A,A04,083782,Staff,0,7,30,30
1651090520639,MATH 197,001,091859,McAuley; Julian John,9998,0,9999,1
1651090526713,COGS 9,A01,083615,Staff,0,20,60,60
1651090532748,COGS 11,A01,083617,Boyle; Mary E. T.,13,0,40,27
1651090538775,COGS 13,A01,083071,Staff,0,38,40,40
1651090544802,COGS 14A,A01,092681,Staff,0,39,100,100
1651090550825,COGS 14B,A01,083073,Cheng; Tzu-Han,0,12,50,50
1651090556850,COGS 17,A01,092677,Staff,8,0,75,67
1651090562883,COGS 100,A01,083619,Staff,0,30,60,60
1651090568910,COGS 101A,A01,083621,Davis; Joshua Daniel,0,29,60,60
1651090574948,COGS 101B,A01,091572,Staff,0,8,60,60
1651090580978,COGS 101C,A01,083625,Delgado; Tania,13,0,30,17
1651090587001,COGS 107A,A01,083627,Boyle; Mary E. T.,0,17,60,60
1651090593033,COGS 118A,A01,083075,Staff,0,10,60,60
1651090599060,CSE 3,A50,083646,Miranda; Gregory Joseph,15,0,38,23
1651090599060,CSE 3,A51,083647,Miranda; Gregory Joseph,36,0,37,1
1651090605084,CSE 8A,A50,083650,Miranda; Gregory Joseph,0,31,40,40
1651090611108,CSE 11,A01,083080,Cao; Yingjun,1,98,40,39
1651090617135,CSE 12,A01,083652,Staff,0,28,100,100
1651090623172,CSE 15L,A01,083654,Staff,0,3,50,50
1651090623172,CSE 15L,A02,083655,Staff,0,3,50,50
1651090629195,CSE 20,A01,083657,Staff,46,0,80,34
1651090635219,CSE 30,A01,083084,Eldon; John,0,38,80,80
1651090641245,CSE 100,A01,083659,Cao; Yingjun,0,72,50,50
1651090647288,CSE 134B,A01,083661,Powell; Thomas Allan,0,38,65,65
1651090653312,CSE 140,A01,083663,Staff,0,15,75,75
1651090659347,CSE 140L,A01,083088,Eldon; John,3,0,100,97
1651090665374,CSE 175,A01,083665,Kumar; Rakesh,0,0,25,25
1651090671400,CSE 190,A00,092507,Dubnov; Shlomo,9,0,20,11
1651090677431,ECE 45,A01,083139,Staff,0,7,60,60
1651090683457,ECE 65,A50,083695,Staff,0,7,30,30
1651090689485,ECE 109,A01,091882,Touri; Behrouz,33,0,70,37
1651090695508,ECE 180,A00,083140,Abi Samra; Nicholas Camill,17,0,30,13
1651090695508,ECE 180,B00,083141,Abi Samra; Nicholas Camill,0,0,30,32
1651090701531,MATH 10A,A01,083735,Patchell; Gregory David,0,0,30,30
1651090701531,MATH 10A,A02,083736,Patchell; Gregory David,27,0,30,3
1651090701531,MATH 10A,A03,083737,Patchell; Gregory David,22,0,30,8
1651090707554,MATH 10B,A01,083207,Staff,0,7,30,30
1651090707554,MATH 10B,A02,083208,Staff,0,6,30,30
1651090707554,MATH 10B,B01,083739,Staff,7,0,30,23
1651090707554,MATH 10B,B02,083740,Staff,28,0,30,2
1651090713583,MATH 18,A01,083743,Staff,0,0,30,30
1651090713583,MATH 18,A02,083744,Staff,22,0,30,8
1651090713583,MATH 18,A03,083745,Staff,19,0,30,11
1651090713583,MATH 18,A04,083746,Staff,26,0,30,4
1651090713583,MATH 18,B01,083748,Staff,0,16,30,30
1651090713583,MATH 18,B02,083749,Staff,0,14,30,30
1651090713583,MATH 18,B03,083750,Staff,0,14,30,30
1651090713583,MATH 18,B04,083751,Staff,0,13,30,30
1651090719605,MATH 20A,A01,083754,Staff,18,0,40,22
1651090725628,MATH 20B,A01,083756,Staff,0,14,30,30
1651090725628,MATH 20B,A02,083757,Staff,0,11,30,30
1651090731657,MATH 20C,A01,083760,Staff,0,16,30,30
1651090731657,MATH 20C,A02,083761,Staff,0,15,30,30
1651090731657,MATH 20C,B01,083762,Staff,7,0,30,23
1651090731657,MATH 20C,B02,083763,Staff,27,0,30,3
1651090737699,MATH 20D,A01,083765,Staff,3,1,30,27
1651090737699,MATH 20D,A02,083766,Staff,1,0,30,29
1651090737699,MATH 20D,A03,083767,Staff,22,0,30,8
1651090743734,MATH 20E,A01,083771,Staff,1,0,30,29
1651090743734,MATH 20E,A02,083772,Staff,9,0,30,21
1651090743734,MATH 20E,B01,083773,Staff,5,0,35,30
1651090743734,MATH 20E,B02,083774,Staff,5,1,35,30
1651090749759,MATH 103A,A01,083777,Staff,0,17,30,30
1651090749759,MATH 103A,A02,083778,Staff,0,17,30,30
1651090749759,MATH 103A,B01,083779,Staff,0,15,30,30
1651090749759,MATH 103A,B02,083780,Staff,0,14,30,30
1651090755785,MATH 105,A01,085443,Staff,0,24,30,30
1651090761813,MATH 109,A01,083213,Anzaldo; Leesa B,0,7,30,30
1651090761813,MATH 109,A02,083214,Anzaldo; Leesa B,0,7,30,30
1651090761813,MATH 109,B01,083215,Anzaldo; Leesa B,0,8,30,30
1651090761813,MATH 109,B02,083216,Anzaldo; Leesa B,1,8,30,29
1651090767845,MATH 142A,A01,083219,Chow; Bennett,0,15,30,30
1651090767845,MATH 142A,A02,083220,Chow; Bennett,0,15,30,30
1651090767845,MATH 142A,B01,083221,Chow; Bennett,0,16,30,30
1651090767845,MATH 142A,B02,083222,Chow; Bennett,0,15,30,30
1651090773873,MATH 193A,A01,083224,Staff,0,9,30,30
1651090773873,MATH 193A,A02,083225,Staff,0,7,30,30
1651090773873,MATH 193A,A03,083781,Staff,0,7,30,30
1651090773873,MATH 193A,A04,083782,Staff,0,7,30,30
1651090779895,MATH 197,001,091859,McAuley; Julian John,9998,0,9999,1
1651090785944,COGS 9,A01,083615,Staff,0,20,60,60
1651090791977,COGS 11,A01,083617,Boyle; Mary E. T.,13,0,40,27
1651090798013,COGS 13,A01,083071,Staff,0,38,40,40
1651090804035,COGS 14A,A01,092681,Staff,0,40,100,100
1651090810070,COGS 14B,A01,083073,Cheng; Tzu-Han,0,12,50,50
1651090816092,COGS 17,A01,092677,Staff,8,0,75,67
1651090822117,COGS 100,A01,083619,Staff,0,30,60,60
1651090828146,COGS 101A,A01,083621,Davis; Joshua Daniel,0,29,60,60
1651090834171,COGS 101B,A01,091572,Staff,0,8,60,60
1651090840201,COGS 101C,A01,083625,Delgado; Tania,13,0,30,17
1651090846229,COGS 107A,A01,083627,Boyle; Mary E. T.,0,17,60,60
1651090852251,COGS 118A,A01,083075,Staff,0,10,60,60
1651090858277,CSE 3,A50,083646,Miranda; Gregory Joseph,15,0,38,23
1651090858277,CSE 3,A51,083647,Miranda; Gregory Joseph,36,0,37,1
1651090864305,CSE 8A,A50,083650,Miranda; Gregory Joseph,0,31,40,40
1651090870332,CSE 11,A01,083080,Cao; Yingjun,1,98,40,39
1651090876355,CSE 12,A01,083652,Staff,0,28,100,100
1651090882377,CSE 15L,A01,083654,Staff,0,3,50,50
1651090882377,CSE 15L,A02,083655,Staff,0,3,50,50
1651090888408,CSE 20,A01,083657,Staff,46,0,80,34
1651090894430,CSE 30,A01,083084,Eldon; John,0,38,80,80
1651090900458,CSE 100,A01,083659,Cao; Yingjun,0,72,50,50
1651090906487,CSE 134B,A01,083661,Powell; Thomas Allan,0,38,65,65
1651090912518,CSE 140,A01,083663,Staff,0,15,75,75
1651090918543,CSE 140L,A01,083088,Eldon; John,3,0,100,97
1651090924567,CSE 175,A01,083665,Kumar; Rakesh,0,0,25,25
1651090930591,CSE 190,A00,092507,Dubnov; Shlomo,9,0,20,11
1651090936622,ECE 45,A01,083139,Staff,0,7,60,60
1651090942667,ECE 65,A50,083695,Staff,0,7,30,30
1651090948694,ECE 109,A01,091882,Touri; Behrouz,33,0,70,37
1651090954727,ECE 180,A00,083140,Abi Samra; Nicholas Camill,17,0,30,13
1651090954727,ECE 180,B00,083141,Abi Samra; Nicholas Camill,0,0,30,32
1651090960754,MATH 10A,A01,083735,Patchell; Gregory David,0,0,30,30
1651090960754,MATH 10A,A02,083736,Patchell; Gregory David,27,0,30,3
1651090960754,MATH 10A,A03,083737,Patchell; Gregory David,22,0,30,8
1651090966787,MATH 10B,A01,083207,Staff,0,7,30,30
1651090966787,MATH 10B,A02,083208,Staff,0,6,30,30
1651090966787,MATH 10B,B01,083739,Staff,7,0,30,23
1651090966787,MATH 10B,B02,083740,Staff,28,0,30,2
1651090972820,MATH 18,A01,083743,Staff,0,0,30,30
1651090972820,MATH 18,A02,083744,Staff,22,0,30,8
1651090972820,MATH 18,A03,083745,Staff,19,0,30,11
1651090972820,MATH 18,A04,083746,Staff,26,0,30,4
1651090972820,MATH 18,B01,083748,Staff,0,16,30,30
1651090972820,MATH 18,B02,083749,Staff,0,14,30,30
1651090972820,MATH 18,B03,083750,Staff,0,14,30,30
1651090972820,MATH 18,B04,083751,Staff,0,13,30,30
1651090978855,MATH 20A,A01,083754,Staff,18,0,40,22
1651090984883,MATH 20B,A01,083756,Staff,0,14,30,30
1651090984883,MATH 20B,A02,083757,Staff,0,11,30,30
1651090990909,MATH 20C,A01,083760,Staff,0,16,30,30
1651090990909,MATH 20C,A02,083761,Staff,0,15,30,30
1651090990909,MATH 20C,B01,083762,Staff,7,0,30,23
1651090990909,MATH 20C,B02,083763,Staff,27,0,30,3
1651090996932,MATH 20D,A01,083765,Staff,3,1,30,27
1651090996932,MATH 20D,A02,083766,Staff,1,0,30,29
1651090996932,MATH 20D,A03,083767,Staff,22,0,30,8
1651091002961,MATH 20E,A01,083771,Staff,1,0,30,29
1651091002961,MATH 20E,A02,083772,Staff,9,0,30,21
1651091002961,MATH 20E,B01,083773,Staff,5,0,35,30
1651091002961,MATH 20E,B02,083774,Staff,5,1,35,30
1651091009058,MATH 103A,A01,083777,Staff,0,17,30,30
1651091009058,MATH 103A,A02,083778,Staff,0,17,30,30
1651091009058,MATH 103A,B01,083779,Staff,0,15,30,30
1651091009058,MATH 103A,B02,083780,Staff,0,14,30,30
1651091015091,MATH 105,A01,085443,Staff,0,24,30,30
1651091021114,MATH 109,A01,083213,Anzaldo; Leesa B,0,7,30,30
1651091021114,MATH 109,A02,083214,Anzaldo; Leesa B,0,7,30,30
1651091021114,MATH 109,B01,083215,Anzaldo; Leesa B,0,8,30,30
1651091021114,MATH 109,B02,083216,Anzaldo; Leesa B,1,8,30,29
1651091027139,MATH 142A,A01,083219,Chow; Bennett,0,15,30,30
1651091027139,MATH 142A,A02,083220,Chow; Bennett,0,15,30,30
1651091027139,MATH 142A,B01,083221,Chow; Bennett,0,16,30,30
1651091027139,MATH 142A,B02,083222,Chow; Bennett,0,15,30,30
1651091033163,MATH 193A,A01,083224,Staff,0,9,30,30
1651091033163,MATH 193A,A02,083225,Staff,0,7,30,30
1651091033163,MATH 193A,A03,083781,Staff,0,7,30,30
1651091033163,MATH 193A,A04,083782,Staff,0,7,30,30
1651091039185,MATH 197,001,091859,McAuley; Julian John,9998,0,9999,1
1651091045245,COGS 9,A01,083615,Staff,0,20,60,60
1651091051267,COGS 11,A01,083617,Boyle; Mary E. T.,13,0,40,27
1651091057291,COGS 13,A01,083071,Staff,0,38,40,40
1651091063335,COGS 14A,A01,092681,Staff,0,40,100,100
1651091069364,COGS 14B,A01,083073,Cheng; Tzu-Han,0,12,50,50
1651091075393,COGS 17,A01,092677,Staff,8,0,75,67
1651091081426,COGS 100,A01,083619,Staff,0,30,60,60
1651091087453,COGS 101A,A01,083621,Davis; Joshua Daniel,0,29,60,60
1651091093476,COGS 101B,A01,091572,Staff,0,8,60,60
1651091099508,COGS 101C,A01,083625,Delgado; Tania,13,0,30,17
1651091105533,COGS 107A,A01,083627,Boyle; Mary E. T.,0,17,60,60
1651091111571,COGS 118A,A01,083075,Staff,0,10,60,60
1651091117593,CSE 3,A50,083646,Miranda; Gregory Joseph,15,0,38,23
1651091117593,CSE 3,A51,083647,Miranda; Gregory Joseph,36,0,37,1
1651091123625,CSE 8A,A50,083650,Miranda; Gregory Joseph,0,31,40,40
1651091129648,CSE 11,A01,083080,Cao; Yingjun,1,98,40,39
1651091135693,CSE 12,A01,083652,Staff,0,28,100,100
1651091141717,CSE 15L,A01,083654,Staff,0,3,50,50
1651091141717,CSE 15L,A02,083655,Staff,0,3,50,50
1651091147743,CSE 20,A01,083657,Staff,46,0,80,34
1651091153775,CSE 30,A01,083084,Eldon; John,0,38,80,80
1651091159798,CSE 100,A01,083659,Cao; Yingjun,0,72,50,50
1651091165820,CSE 134B,A01,083661,Powell; Thomas Allan,0,38,65,65
1651091171857,CSE 140,A01,083663,Staff,0,15,75,75
1651091177884,CSE 140L,A01,083088,Eldon; John,3,0,100,97
1651091183907,CSE 175,A01,083665,Kumar; Rakesh,0,0,25,25
1651091189937,CSE 190,A00,092507,Dubnov; Shlomo,9,0,20,11
1651091195965,ECE 45,A01,083139,Staff,0,7,60,60
1651091201988,ECE 65,A50,083695,Staff,0,7,30,30
1651091208015,ECE 109,A01,091882,Touri; Behrouz,33,0,70,37
1651091214043,ECE 180,A00,083140,Abi Samra; Nicholas Camill,17,0,30,13
1651091214043,ECE 180,B00,083141,Abi Samra; Nicholas Camill,0,0,30,32
1651091220067,MATH 10A,A01,083735,Patchell; Gregory David,0,0,30,30
1651091220067,MATH 10A,A02,083736,Patchell; Gregory David,27,0,30,3
1651091220067,MATH 10A,A03,083737,Patchell; Gregory David,22,0,30,8
1651091226101,MATH 10B,A01,083207,Staff,0,7,30,30
1651091226101,MATH 10B,A02,083208,Staff,0,6,30,30
1651091226101,MATH 10B,B01,083739,Staff,7,0,30,23
1651091226101,MATH 10B,B02,083740,Staff,28,0,30,2
1651091232123,MATH 18,A01,083743,Staff,0,0,30,30
1651091232123,MATH 18,A02,083744,Staff,22,0,30,8
1651091232123,MATH 18,A03,083745,Staff,19,0,30,11
1651091232123,MATH 18,A04,083746,Staff,26,0,30,4
1651091232123,MATH 18,B01,083748,Staff,0,16,30,30
1651091232123,MATH 18,B02,083749,Staff,0,14,30,30
1651091232123,MATH 18,B03,083750,Staff,0,14,30,30
1651091232123,MATH 18,B04,083751,Staff,0,13,30,30
1651091238146,MATH 20A,A01,083754,Staff,18,0,40,22
1651091244172,MATH 20B,A01,083756,Staff,0,14,30,30
1651091244172,MATH 20B,A02,083757,Staff,0,11,30,30
1651091250210,MATH 20C,A01,083760,Staff,0,16,30,30
1651091250210,MATH 20C,A02,083761,Staff,0,15,30,30
1651091250210,MATH 20C,B01,083762,Staff,7,0,30,23
1651091250210,MATH 20C,B02,083763,Staff,27,0,30,3
1651091256234,MATH 20D,A01,083765,Staff,3,1,30,27
1651091256234,MATH 20D,A02,083766,Staff,1,0,30,29
1651091256234,MATH 20D,A03,083767,Staff,22,0,30,8
1651091262257,MATH 20E,A01,083771,Staff,1,0,30,29
1651091262257,MATH 20E,A02,083772,Staff,9,0,30,21
1651091262257,MATH 20E,B01,083773,Staff,5,0,35,30
1651091262257,MATH 20E,B02,083774,Staff,5,1,35,30
1651091268281,MATH 103A,A01,083777,Staff,0,17,30,30
1651091268281,MATH 103A,A02,083778,Staff,0,17,30,30
1651091268281,MATH 103A,B01,083779,Staff,0,15,30,30
1651091268281,MATH 103A,B02,083780,Staff,0,14,30,30
1651091274309,MATH 105,A01,085443,Staff,0,24,30,30
1651091280332,MATH 109,A01,083213,Anzaldo; Leesa B,0,7,30,30
1651091280332,MATH 109,A02,083214,Anzaldo; Leesa B,0,7,30,30
1651091280332,MATH 109,B01,083215,Anzaldo; Leesa B,0,8,30,30
1651091280332,MATH 109,B02,083216,Anzaldo; Leesa B,1,8,30,29
1651091286359,MATH 142A,A01,083219,Chow; Bennett,0,15,30,30
1651091286359,MATH 142A,A02,083220,Chow; Bennett,0,15,30,30
1651091286359,MATH 142A,B01,083221,Chow; Bennett,0,16,30,30
1651091286359,MATH 142A,B02,083222,Chow; Bennett,0,15,30,30
1651091292384,MATH 193A,A01,083224,Staff,0,9,30,30
1651091292384,MATH 193A,A02,083225,Staff,0,7,30,30
1651091292384,MATH 193A,A03,083781,Staff,0,7,30,30
1651091292384,MATH 193A,A04,083782,Staff,0,7,30,30
1651091298409,MATH 197,001,091859,McAuley; Julian John,9998,0,9999,1
1651091304459,COGS 9,A01,083615,Staff,0,20,60,60
1651091310482,COGS 11,A01,083617,Boyle; Mary E. T.,13,0,40,27
1651091316508,COGS 13,A01,083071,Staff,0,38,40,40
1651091322534,COGS 14A,A01,092681,Staff,0,40,100,100
1651091328556,COGS 14B,A01,083073,Cheng; Tzu-Han,0,12,50,50
1651091334585,COGS 17,A01,092677,Staff,8,0,75,67
1651091340613,COGS 100,A01,083619,Staff,0,30,60,60
1651091346645,COGS 101A,A01,083621,Davis; Joshua Daniel,0,29,60,60
1651091352679,COGS 101B,A01,091572,Staff,0,8,60,60
1651091358708,COGS 101C,A01,083625,Delgado; Tania,13,0,30,17
1651091364733,COGS 107A,A01,083627,Boyle; Mary E. T.,0,17,60,60
1651091370758,COGS 118A,A01,083075,Staff,0,10,60,60
1651091376780,CSE 3,A50,083646,Miranda; Gregory Joseph,15,0,38,23
1651091376780,CSE 3,A51,083647,Miranda; Gregory Joseph,36,0,37,1
1651091382804,CSE 8A,A50,083650,Miranda; Gregory Joseph,0,31,40,40
1651091388830,CSE 11,A01,083080,Cao; Yingjun,1,98,40,39
1651091394860,CSE 12,A01,083652,Staff,0,28,100,100
1651091400885,CSE 15L,A01,083654,Staff,0,3,50,50
1651091400885,CSE 15L,A02,083655,Staff,0,3,50,50
1651091406907,CSE 20,A01,083657,Staff,46,0,80,34
1651091412947,CSE 30,A01,083084,Eldon; John,0,38,80,80
1651091418970,CSE 100,A01,083659,Cao; Yingjun,0,72,50,50
1651091425008,CSE 134B,A01,083661,Powell; Thomas Allan,0,38,65,65
1651091431041,CSE 140,A01,083663,Staff,0,15,75,75
1651091437068,CSE 140L,A01,083088,Eldon; John,3,0,100,97
1651091443103,CSE 175,A01,083665,Kumar; Rakesh,0,0,25,25
1651091449128,CSE 190,A00,092507,Dubnov; Shlomo,9,0,20,11
1651091455152,ECE 45,A01,083139,Staff,0,7,60,60
1651091461175,ECE 65,A50,083695,Staff,0,7,30,30
1651091467209,ECE 109,A01,091882,Touri; Behrouz,33,0,70,37
1651091473231,ECE 180,A00,083140,Abi Samra; Nicholas Camill,17,0,30,13
1651091473231,ECE 180,B00,083141,Abi Samra; Nicholas Camill,0,0,30,32
1651091479271,MATH 10A,A01,083735,Patchell; Gregory David,0,0,30,30
1651091479271,MATH 10A,A02,083736,Patchell; Gregory David,27,0,30,3
1651091479271,MATH 10A,A03,083737,Patchell; Gregory David,22,0,30,8
1651091485294,MATH 10B,A01,083207,Staff,0,7,30,30
1651091485294,MATH 10B,A02,083208,Staff,0,6,30,30
1651091485294,MATH 10B,B01,083739,Staff,7,0,30,23
1651091485294,MATH 10B,B02,083740,Staff,28,0,30,2
1651091491326,MATH 18,A01,083743,Staff,0,0,30,30
1651091491326,MATH 18,A02,083744,Staff,22,0,30,8
1651091491326,MATH 18,A03,083745,Staff,19,0,30,11
1651091491326,MATH 18,A04,083746,Staff,26,0,30,4
1651091491326,MATH 18,B01,083748,Staff,0,16,30,30
1651091491326,MATH 18,B02,083749,Staff,0,14,30,30
1651091491326,MATH 18,B03,083750,Staff,0,14,30,30
1651091491326,MATH 18,B04,083751,Staff,0,13,30,30
1651091497363,MATH 20A,A01,083754,Staff,18,0,40,22
1651091503405,MATH 20B,A01,083756,Staff,0,14,30,30
1651091503405,MATH 20B,A02,083757,Staff,0,11,30,30
1651091509432,MATH 20C,A01,083760,Staff,0,16,30,30
1651091509432,MATH 20C,A02,083761,Staff,0,15,30,30
1651091509432,MATH 20C,B01,083762,Staff,7,0,30,23
1651091509432,MATH 20C,B02,083763,Staff,27,0,30,3
1651091515464,MATH 20D,A01,083765,Staff,3,1,30,27
1651091515464,MATH 20D,A02,083766,Staff,1,0,30,29
1651091515464,MATH 20D,A03,083767,Staff,22,0,30,8
1651091521489,MATH 20E,A01,083771,Staff,1,0,30,29
1651091521489,MATH 20E,A02,083772,Staff,9,0,30,21
1651091521489,MATH 20E,B01,083773,Staff,5,0,35,30
1651091521489,MATH 20E,B02,083774,Staff,5,1,35,30
1651091527519,MATH 103A,A01,083777,Staff,0,17,30,30
1651091527519,MATH 103A,A02,083778,Staff,0,17,30,30
1651091527519,MATH 103A,B01,083779,Staff,0,15,30,30
1651091527519,MATH 103A,B02,083780,Staff,0,14,30,30
1651091533542,MATH 105,A01,085443,Staff,0,24,30,30
1651091539566,MATH 109,A01,083213,Anzaldo; Leesa B,0,7,30,30
1651091539566,MATH 109,A02,083214,Anzaldo; Leesa B,0,7,30,30
1651091539566,MATH 109,B01,083215,Anzaldo; Leesa B,0,8,30,30
1651091539566,MATH 109,B02,083216,Anzaldo; Leesa B,1,8,30,29
1651091545591,MATH 142A,A01,083219,Chow; Bennett,0,15,30,30
1651091545591,MATH 142A,A02,083220,Chow; Bennett,0,15,30,30
1651091545591,MATH 142A,B01,083221,Chow; Bennett,0,16,30,30
1651091545591,MATH 142A,B02,083222,Chow; Bennett,0,15,30,30
1651091551627,MATH 193A,A01,083224,Staff,0,9,30,30
1651091551627,MATH 193A,A02,083225,Staff,0,7,30,30
1651091551627,MATH 193A,A03,083781,Staff,0,7,30,30
1651091551627,MATH 193A,A04,083782,Staff,0,7,30,30
1651091557661,MATH 197,001,091859,McAuley; Julian John,9998,0,9999,1
1651091563721,COGS 9,A01,083615,Staff,0,20,60,60
1651091569745,COGS 11,A01,083617,Boyle; Mary E. T.,13,0,40,27
1651091575766,COGS 13,A01,083071,Staff,0,38,40,40
1651091581790,COGS 14A,A01,092681,Staff,0,40,100,100
1651091587820,COGS 14B,A01,083073,Cheng; Tzu-Han,0,12,50,50
1651091593850,COGS 17,A01,092677,Staff,8,0,75,67
1651091599979,COGS 100,A01,083619,Staff,0,30,60,60
1651091606003,COGS 101A,A01,083621,Davis; Joshua Daniel,0,29,60,60
1651091612034,COGS 101B,A01,091572,Staff,0,8,60,60
1651091618061,COGS 101C,A01,083625,Delgado; Tania,13,0,30,17
1651091624085,COGS 107A,A01,083627,Boyle; Mary E. T.,0,17,60,60
1651091630114,COGS 118A,A01,083075,Staff,0,10,60,60
1651091636139,CSE 3,A50,083646,Miranda; Gregory Joseph,15,0,38,23
1651091636139,CSE 3,A51,083647,Miranda; Gregory Joseph,36,0,37,1
1651091642180,CSE 8A,A50,083650,Miranda; Gregory Joseph,0,31,40,40
1651091648202,CSE 11,A01,083080,Cao; Yingjun,1,98,40,39
1651091654229,CSE 12,A01,083652,Staff,0,28,100,100
1651091660253,CSE 15L,A01,083654,Staff,0,3,50,50
1651091660253,CSE 15L,A02,083655,Staff,0,3,50,50
1651091666276,CSE 20,A01,083657,Staff,46,0,80,34
1651091672323,CSE 30,A01,083084,Eldon; John,0,38,80,80
1651091678346,CSE 100,A01,083659,Cao; Yingjun,0,72,50,50
1651091684377,CSE 134B,A01,083661,Powell; Thomas Allan,0,38,65,65
1651091690399,CSE 140,A01,083663,Staff,0,15,75,75
1651091696422,CSE 140L,A01,083088,Eldon; John,3,0,100,97
1651091702449,CSE 175,A01,083665,Kumar; Rakesh,0,0,25,25
1651091708474,CSE 190,A00,092507,Dubnov; Shlomo,9,0,20,11
1651091714504,ECE 45,A01,083139,Staff,0,7,60,60
1651091720526,ECE 65,A50,083695,Staff,0,7,30,30
1651091726549,ECE 109,A01,091882,Touri; Behrouz,33,0,70,37
1651091732577,ECE 180,A00,083140,Abi Samra; Nicholas Camill,17,0,30,13
1651091732577,ECE 180,B00,083141,Abi Samra; Nicholas Camill,0,0,30,32
1651091738616,MATH 10A,A01,083735,Patchell; Gregory David,0,0,30,30
1651091738616,MATH 10A,A02,083736,Patchell; Gregory David,26,0,30,4
1651091738616,MATH 10A,A03,083737,Patchell; Gregory David,22,0,30,8
1651091744651,MATH 10B,A01,083207,Staff,0,7,30,30
1651091744651,MATH 10B,A02,083208,Staff,0,6,30,30
1651091744651,MATH 10B,B01,083739,Staff,7,0,30,23
1651091744651,MATH 10B,B02,083740,Staff,28,0,30,2
1651091750677,MATH 18,A01,083743,Staff,0,0,30,30
1651091750677,MATH 18,A02,083744,Staff,22,0,30,8
1651091750677,MATH 18,A03,083745,Staff,19,0,30,11
1651091750677,MATH 18,A04,083746,Staff,26,0,30,4
1651091750677,MATH 18,B01,083748,Staff,0,16,30,30
1651091750677,MATH 18,B02,083749,Staff,0,14,30,30
1651091750677,MATH 18,B03,083750,Staff,0,14,30,30
1651091750677,MATH 18,B04,083751,Staff,0,13,30,30
1651091756706,MATH 20A,A01,083754,Staff,18,0,40,22
1651091762729,MATH 20B,A01,083756,Staff,0,14,30,30
1651091762729,MATH 20B,A02,083757,Staff,0,11,30,30
1651091768756,MATH 20C,A01,083760,Staff,0,16,30,30
1651091768756,MATH 20C,A02,083761,Staff,0,15,30,30
1651091768756,MATH 20C,B01,083762,Staff,7,0,30,23
1651091768756,MATH 20C,B02,083763,Staff,27,0,30,3
1651091774781,MATH 20D,A01,083765,Staff,3,1,30,27
1651091774781,MATH 20D,A02,083766,Staff,1,0,30,29
1651091774781,MATH 20D,A03,083767,Staff,22,0,30,8
1651091780805,MATH 20E,A01,083771,Staff,1,0,30,29
1651091780805,MATH 20E,A02,083772,Staff,9,0,30,21
1651091780805,MATH 20E,B01,083773,Staff,5,0,35,30
1651091780805,MATH 20E,B02,083774,Staff,5,1,35,30
1651091786828,MATH 103A,A01,083777,Staff,0,17,30,30
1651091786828,MATH 103A,A02,083778,Staff,0,17,30,30
1651091786828,MATH 103A,B01,083779,Staff,0,15,30,30
1651091786828,MATH 103A,B02,083780,Staff,0,14,30,30
1651091792851,MATH 105,A01,085443,Staff,0,24,30,30
1651091798875,MATH 109,A01,083213,Anzaldo; Leesa B,0,7,30,30
1651091798875,MATH 109,A02,083214,Anzaldo; Leesa B,0,7,30,30
1651091798875,MATH 109,B01,083215,Anzaldo; Leesa B,0,8,30,30
1651091798875,MATH 109,B02,083216,Anzaldo; Leesa B,1,8,30,29
1651091804904,MATH 142A,A01,083219,Chow; Bennett,0,15,30,30
1651091804904,MATH 142A,A02,083220,Chow; Bennett,0,15,30,30
1651091804904,MATH 142A,B01,083221,Chow; Bennett,0,16,30,30
1651091804904,MATH 142A,B02,083222,Chow; Bennett,0,15,30,30
1651091810928,MATH 193A,A01,083224,Staff,0,9,30,30
1651091810928,MATH 193A,A02,083225,Staff,0,7,30,30
1651091810928,MATH 193A,A03,083781,Staff,0,7,30,30
1651091810928,MATH 193A,A04,083782,Staff,0,7,30,30
1651091816957,MATH 197,001,091859,McAuley; Julian John,9998,0,9999,1
1651091823028,COGS 9,A01,083615,Staff,0,20,60,60
1651091829052,COGS 11,A01,083617,Boyle; Mary E. T.,13,0,40,27
1651091835090,COGS 13,A01,083071,Staff,0,38,40,40
1651091841114,COGS 14A,A01,092681,Staff,0,40,100,100
1651091847153,COGS 14B,A01,083073,Cheng; Tzu-Han,0,12,50,50
1651091853177,COGS 17,A01,092677,Staff,8,0,75,67
1651091859200,COGS 100,A01,083619,Staff,0,30,60,60
1651091865227,COGS 101A,A01,083621,Davis; Joshua Daniel,0,29,60,60
1651091871249,COGS 101B,A01,091572,Staff,0,8,60,60
1651091877276,COGS 101C,A01,083625,Delgado; Tania,13,0,30,17
1651091883300,COGS 107A,A01,083627,Boyle; Mary E. T.,0,17,60,60
1651091889322,COGS 118A,A01,083075,Staff,0,10,60,60
1651091895346,CSE 3,A50,083646,Miranda; Gregory Joseph,15,0,38,23
1651091895346,CSE 3,A51,083647,Miranda; Gregory Joseph,36,0,37,1
1651091901373,CSE 8A,A50,083650,Miranda; Gregory Joseph,0,31,40,40
1651091907408,CSE 11,A01,083080,Cao; Yingjun,1,98,40,39
1651091913430,CSE 12,A01,083652,Staff,0,28,100,100
1651091919469,CSE 15L,A01,083654,Staff,0,3,50,50
1651091919469,CSE 15L,A02,083655,Staff,0,3,50,50
1651091925492,CSE 20,A01,083657,Staff,46,0,80,34
1651091931517,CSE 30,A01,083084,Eldon; John,0,38,80,80
1651091937556,CSE 100,A01,083659,Cao; Yingjun,0,72,50,50
1651091943579,CSE 134B,A01,083661,Powell; Thomas Allan,0,38,65,65
1651091949603,CSE 140,A01,083663,Staff,0,15,75,75
1651091955627,CSE 140L,A01,083088,Eldon; John,3,0,100,97
1651091961655,CSE 175,A01,083665,Kumar; Rakesh,0,0,25,25
1651091967689,CSE 190,A00,092507,Dubnov; Shlomo,9,0,20,11
1651091973715,ECE 45,A01,083139,Staff,0,7,60,60
1651091979739,ECE 65,A50,083695,Staff,0,7,30,30
1651091985762,ECE 109,A01,091882,Touri; Behrouz,33,0,70,37
1651091991786,ECE 180,A00,083140,Abi Samra; Nicholas Camill,17,0,30,13
1651091991786,ECE 180,B00,083141,Abi Samra; Nicholas Camill,0,0,30,32
1651091997811,MATH 10A,A01,083735,Patchell; Gregory David,0,0,30,30
1651091997811,MATH 10A,A02,083736,Patchell; Gregory David,26,0,30,4
1651091997811,MATH 10A,A03,083737,Patchell; Gregory David,22,0,30,8
1651092003858,MATH 10B,A01,083207,Staff,0,7,30,30
1651092003858,MATH 10B,A02,083208,Staff,0,6,30,30
1651092003858,MATH 10B,B01,083739,Staff,6,0,30,24
1651092003858,MATH 10B,B02,083740,Staff,28,0,30,2
1651092009883,MATH 18,A01,083743,Staff,0,0,30,30
1651092009883,MATH 18,A02,083744,Staff,22,0,30,8
1651092009883,MATH 18,A03,083745,Staff,19,0,30,11
1651092009883,MATH 18,A04,083746,Staff,26,0,30,4
1651092009883,MATH 18,B01,083748,Staff,0,16,30,30
1651092009883,MATH 18,B02,083749,Staff,0,14,30,30
1651092009883,MATH 18,B03,083750,Staff,0,14,30,30
1651092009883,MATH 18,B04,083751,Staff,0,13,30,30
1651092015906,MATH 20A,A01,083754,Staff,18,0,40,22
1651092021933,MATH 20B,A01,083756,Staff,0,14,30,30
1651092021933,MATH 20B,A02,083757,Staff,0,11,30,30
1651092027963,MATH 20C,A01,083760,Staff,0,16,30,30
1651092027963,MATH 20C,A02,083761,Staff,0,15,30,30
1651092027963,MATH 20C,B01,083762,Staff,7,0,30,23
1651092027963,MATH 20C,B02,083763,Staff,27,0,30,3
1651092033990,MATH 20D,A01,083765,Staff,3,1,30,27
1651092033990,MATH 20D,A02,083766,Staff,1,0,30,29
1651092033990,MATH 20D,A03,083767,Staff,22,0,30,8
1651092040017,MATH 20E,A01,083771,Staff,1,0,30,29
1651092040017,MATH 20E,A02,083772,Staff,9,0,30,21
1651092040017,MATH 20E,B01,083773,Staff,5,0,35,30
1651092040017,MATH 20E,B02,083774,Staff,5,1,35,30
1651092046070,MATH 103A,A01,083777,Staff,0,17,30,30
1651092046070,MATH 103A,A02,083778,Staff,0,17,30,30
1651092046070,MATH 103A,B01,083779,Staff,0,15,30,30
1651092046070,MATH 103A,B02,083780,Staff,0,14,30,30
1651092052092,MATH 105,A01,085443,Staff,0,24,30,30
1651092058128,MATH 109,A01,083213,Anzaldo; Leesa B,0,7,30,30
1651092058128,MATH 109,A02,083214,Anzaldo; Leesa B,0,7,30,30
1651092058128,MATH 109,B01,083215,Anzaldo; Leesa B,0,8,30,30
1651092058128,MATH 109,B02,083216,Anzaldo; Leesa B,1,8,30,29
1651092064169,MATH 142A,A01,083219,Chow; Bennett,0,15,30,30
1651092064169,MATH 142A,A02,083220,Chow; Bennett,0,15,30,30
1651092064169,MATH 142A,B01,083221,Chow; Bennett,0,16,30,30
1651092064169,MATH 142A,B02,083222,Chow; Bennett,0,15,30,30
1651092070196,MATH 193A,A01,083224,Staff,0,9,30,30
1651092070196,MATH 193A,A02,083225,Staff,0,7,30,30
1651092070196,MATH 193A,A03,083781,Staff,0,7,30,30
1651092070196,MATH 193A,A04,083782,Staff,0,7,30,30
1651092076224,MATH 197,001,091859,McAuley; Julian John,9998,0,9999,1
1651092082271,COGS 9,A01,083615,Staff,0,20,60,60
1651092088295,COGS 11,A01,083617,Boyle; Mary E. T.,13,0,40,27
1651092094327,COGS 13,A01,083071,Staff,0,38,40,40
1651092100353,COGS 14A,A01,092681,Staff,0,40,100,100
1651092106380,COGS 14B,A01,083073,Cheng; Tzu-Han,0,12,50,50
1651092112406,COGS 17,A01,092677,Staff,8,0,75,67
1651092118439,COGS 100,A01,083619,Staff,0,30,60,60
1651092124464,COGS 101A,A01,083621,Davis; Joshua Daniel,0,29,60,60
1651092130487,COGS 101B,A01,091572,Staff,0,8,60,60
1651092136526,COGS 101C,A01,083625,Delgado; Tania,13,0,30,17
1651092142548,COGS 107A,A01,083627,Boyle; Mary E. T.,0,17,60,60
1651092148573,COGS 118A,A01,083075,Staff,0,10,60,60
1651092154604,CSE 3,A50,083646,Miranda; Gregory Joseph,15,0,38,23
1651092154604,CSE 3,A51,083647,Miranda; Gregory Joseph,36,0,37,1
1651092160628,CSE 8A,A50,083650,Miranda; Gregory Joseph,0,31,40,40
1651092166654,CSE 11,A01,083080,Cao; Yingjun,1,98,40,39
1651092172677,CSE 12,A01,083652,Staff,0,28,100,100
1651092178716,CSE 15L,A01,083654,Staff,0,3,50,50
1651092178716,CSE 15L,A02,083655,Staff,0,3,50,50
1651092184742,CSE 20,A01,083657,Staff,46,0,80,34
1651092190768,CSE 30,A01,083084,Eldon; John,0,38,80,80
1651092196899,CSE 100,A01,083659,Cao; Yingjun,0,72,50,50
1651092202925,CSE 134B,A01,083661,Powell; Thomas Allan,0,38,65,65
1651092208950,CSE 140,A01,083663,Staff,0,15,75,75
1651092214974,CSE 140L,A01,083088,Eldon; John,3,0,100,97
1651092221006,CSE 175,A01,083665,Kumar; Rakesh,0,0,25,25
1651092227033,CSE 190,A00,092507,Dubnov; Shlomo,9,0,20,11
1651092233057,ECE 45,A01,083139,Staff,0,7,60,60
1651092239084,ECE 65,A50,083695,Staff,0,7,30,30
1651092245128,ECE 109,A01,091882,Touri; Behrouz,33,0,70,37
1651092251153,ECE 180,A00,083140,Abi Samra; Nicholas Camill,17,0,30,13
1651092251153,ECE 180,B00,083141,Abi Samra; Nicholas Camill,0,0,30,32
1651092257205,MATH 10A,A01,083735,Patchell; Gregory David,0,0,30,30
1651092257205,MATH 10A,A02,083736,Patchell; Gregory David,26,0,30,4
1651092257205,MATH 10A,A03,083737,Patchell; Gregory David,22,0,30,8
1651092263229,MATH 10B,A01,083207,Staff,0,7,30,30
1651092263229,MATH 10B,A02,083208,Staff,0,6,30,30
1651092263229,MATH 10B,B01,083739,Staff,6,0,30,24
1651092263229,MATH 10B,B02,083740,Staff,28,0,30,2
1651092269254,MATH 18,A01,083743,Staff,0,0,30,30
1651092269254,MATH 18,A02,083744,Staff,22,0,30,8
1651092269254,MATH 18,A03,083745,Staff,19,0,30,11
1651092269254,MATH 18,A04,083746,Staff,26,0,30,4
1651092269254,MATH 18,B01,083748,Staff,0,16,30,30
1651092269254,MATH 18,B02,083749,Staff,0,14,30,30
1651092269254,MATH 18,B03,083750,Staff,0,14,30,30
1651092269254,MATH 18,B04,083751,Staff,0,13,30,30
1651092275276,MATH 20A,A01,083754,Staff,18,0,40,22
1651092281300,MATH 20B,A01,083756,Staff,0,14,30,30
1651092281300,MATH 20B,A02,083757,Staff,0,11,30,30
1651092287327,MATH 20C,A01,083760,Staff,0,16,30,30
1651092287327,MATH 20C,A02,083761,Staff,0,15,30,30
1651092287327,MATH 20C,B01,083762,Staff,7,0,30,23
1651092287327,MATH 20C,B02,083763,Staff,27,0,30,3
1651092293354,MATH 20D,A01,083765,Staff,3,1,30,27
1651092293354,MATH 20D,A02,083766,Staff,1,0,30,29
1651092293354,MATH 20D,A03,083767,Staff,22,0,30,8
1651092299379,MATH 20E,A01,083771,Staff,1,0,30,29
1651092299379,MATH 20E,A02,083772,Staff,9,0,30,21
1651092299379,MATH 20E,B01,083773,Staff,5,0,35,30
1651092299379,MATH 20E,B02,083774,Staff,5,1,35,30
1651092305403,MATH 103A,A01,083777,Staff,0,17,30,30
1651092305403,MATH 103A,A02,083778,Staff,0,17,30,30
1651092305403,MATH 103A,B01,083779,Staff,0,15,30,30
1651092305403,MATH 103A,B02,083780,Staff,0,14,30,30
1651092311429,MATH 105,A01,085443,Staff,0,24,30,30
1651092317450,MATH 109,A01,083213,Anzaldo; Leesa B,0,7,30,30
1651092317450,MATH 109,A02,083214,Anzaldo; Leesa B,0,7,30,30
1651092317450,MATH 109,B01,083215,Anzaldo; Leesa B,0,8,30,30
1651092317450,MATH 109,B02,083216,Anzaldo; Leesa B,1,8,30,29
1651092323473,MATH 142A,A01,083219,Chow; Bennett,0,15,30,30
1651092323473,MATH 142A,A02,083220,Chow; Bennett,0,15,30,30
1651092323473,MATH 142A,B01,083221,Chow; Bennett,0,16,30,30
1651092323473,MATH 142A,B02,083222,Chow; Bennett,0,15,30,30
1651092329500,MATH 193A,A01,083224,Staff,0,9,30,30
1651092329500,MATH 193A,A02,083225,Staff,0,7,30,30
1651092329500,MATH 193A,A03,083781,Staff,0,7,30,30
1651092329500,MATH 193A,A04,083782,Staff,0,7,30,30
1651092335524,MATH 197,001,091859,McAuley; Julian John,9998,0,9999,1
1651092341588,COGS 9,A01,083615,Staff,0,20,60,60
1651092347613,COGS 11,A01,083617,Boyle; Mary E. T.,13,0,40,27
1651092353642,COGS 13,A01,083071,Staff,0,38,40,40
1651092359665,COGS 14A,A01,092681,Staff,0,40,100,100
1651092365689,COGS 14B,A01,083073,Cheng; Tzu-Han,0,12,50,50
1651092371714,COGS 17,A01,092677,Staff,8,0,75,67
1651092377737,COGS 100,A01,083619,Staff,0,30,60,60
1651092383760,COGS 101A,A01,083621,Davis; Joshua Daniel,0,29,60,60
1651092389792,COGS 101B,A01,091572,Staff,0,8,60,60
1651092395817,COGS 101C,A01,083625,Delgado; Tania,13,0,30,17
1651092401840,COGS 107A,A01,083627,Boyle; Mary E. T.,0,17,60,60
1651092407864,COGS 118A,A01,083075,Staff,0,10,60,60
1651092413905,CSE 3,A50,083646,Miranda; Gregory Joseph,15,0,38,23
1651092413905,CSE 3,A51,083647,Miranda; Gregory Joseph,36,0,37,1
1651092419932,CSE 8A,A50,083650,Miranda; Gregory Joseph,0,31,40,40
1651092425965,CSE 11,A01,083080,Cao; Yingjun,1,98,40,39
1651092431989,CSE 12,A01,083652,Staff,0,28,100,100
1651092438013,CSE 15L,A01,083654,Staff,0,3,50,50
1651092438013,CSE 15L,A02,083655,Staff,0,3,50,50
1651092444042,CSE 20,A01,083657,Staff,46,0,80,34
1651092450065,CSE 30,A01,083084,Eldon; John,0,38,80,80
1651092456089,CSE 100,A01,083659,Cao; Yingjun,0,72,50,50
1651092462115,CSE 134B,A01,083661,Powell; Thomas Allan,0,38,65,65
1651092468141,CSE 140,A01,083663,Staff,0,15,75,75
1651092474165,CSE 140L,A01,083088,Eldon; John,3,0,100,97
1651092480200,CSE 175,A01,083665,Kumar; Rakesh,0,0,25,25
1651092486226,CSE 190,A00,092507,Dubnov; Shlomo,9,0,20,11
1651092492251,ECE 45,A01,083139,Staff,0,7,60,60
1651092498276,ECE 65,A50,083695,Staff,0,7,30,30
1651092504304,ECE 109,A01,091882,Touri; Behrouz,33,0,70,37
1651092510332,ECE 180,A00,083140,Abi Samra; Nicholas Camill,17,0,30,13
1651092510332,ECE 180,B00,083141,Abi Samra; Nicholas Camill,0,0,30,32
1651092516362,MATH 10A,A01,083735,Patchell; Gregory David,0,0,30,30
1651092516362,MATH 10A,A02,083736,Patchell; Gregory David,26,0,30,4
1651092516362,MATH 10A,A03,083737,Patchell; Gregory David,22,0,30,8
1651092522389,MATH 10B,A01,083207,Staff,0,7,30,30
1651092522389,MATH 10B,A02,083208,Staff,0,6,30,30
1651092522389,MATH 10B,B01,083739,Staff,6,0,30,24
1651092522389,MATH 10B,B02,083740,Staff,28,0,30,2
1651092528420,MATH 18,A01,083743,Staff,0,0,30,30
1651092528420,MATH 18,A02,083744,Staff,22,0,30,8
1651092528420,MATH 18,A03,083745,Staff,19,0,30,11
1651092528420,MATH 18,A04,083746,Staff,26,0,30,4
1651092528420,MATH 18,B01,083748,Staff,0,16,30,30
1651092528420,MATH 18,B02,083749,Staff,0,14,30,30
1651092528420,MATH 18,B03,083750,Staff,0,14,30,30
1651092528420,MATH 18,B04,083751,Staff,0,13,30,30
1651092534458,MATH 20A,A01,083754,Staff,18,0,40,22
1651092540481,MATH 20B,A01,083756,Staff,0,14,30,30
1651092540481,MATH 20B,A02,083757,Staff,0,11,30,30
1651092546505,MATH 20C,A01,083760,Staff,0,16,30,30
1651092546505,MATH 20C,A02,083761,Staff,0,15,30,30
1651092546505,MATH 20C,B01,083762,Staff,7,0,30,23
1651092546505,MATH 20C,B02,083763,Staff,27,0,30,3
1651092552528,MATH 20D,A01,083765,Staff,3,1,30,27
1651092552528,MATH 20D,A02,083766,Staff,1,0,30,29
1651092552528,MATH 20D,A03,083767,Staff,22,0,30,8
1651092558552,MATH 20E,A01,083771,Staff,1,0,30,29
1651092558552,MATH 20E,A02,083772,Staff,9,0,30,21
1651092558552,MATH 20E,B01,083773,Staff,5,0,35,30
1651092558552,MATH 20E,B02,083774,Staff,5,1,35,30
1651092564590,MATH 103A,A01,083777,Staff,0,17,30,30
1651092564590,MATH 103A,A02,083778,Staff,0,17,30,30
1651092564590,MATH 103A,B01,083779,Staff,0,15,30,30
1651092564590,MATH 103A,B02,083780,Staff,0,14,30,30
1651092570625,MATH 105,A01,085443,Staff,0,24,30,30
1651092576660,MATH 109,A01,083213,Anzaldo; Leesa B,0,7,30,30
1651092576660,MATH 109,A02,083214,Anzaldo; Leesa B,0,7,30,30
1651092576660,MATH 109,B01,083215,Anzaldo; Leesa B,0,8,30,30
1651092576660,MATH 109,B02,083216,Anzaldo; Leesa B,1,8,30,29
1651092582687,MATH 142A,A01,083219,Chow; Bennett,0,15,30,30
1651092582687,MATH 142A,A02,083220,Chow; Bennett,0,15,30,30
1651092582687,MATH 142A,B01,083221,Chow; Bennett,0,16,30,30
1651092582687,MATH 142A,B02,083222,Chow; Bennett,0,15,30,30
1651092588713,MATH 193A,A01,083224,Staff,0,9,30,30
1651092588713,MATH 193A,A02,083225,Staff,0,7,30,30
1651092588713,MATH 193A,A03,083781,Staff,0,7,30,30
1651092588713,MATH 193A,A04,083782,Staff,0,7,30,30
1651092594737,MATH 197,001,091859,McAuley; Julian John,9998,0,9999,1
1651092600789,COGS 9,A01,083615,Staff,0,20,60,60
1651092606819,COGS 11,A01,083617,Boyle; Mary E. T.,13,0,40,27
1651092612848,COGS 13,A01,083071,Staff,0,38,40,40
1651092618870,COGS 14A,A01,092681,Staff,0,40,100,100
1651092624896,COGS 14B,A01,083073,Cheng; Tzu-Han,0,12,50,50
1651092630920,COGS 17,A01,092677,Staff,8,0,75,67
1651092636953,COGS 100,A01,083619,Staff,0,30,60,60
1651092642980,COGS 101A,A01,083621,Davis; Joshua Daniel,0,29,60,60
1651092649002,COGS 101B,A01,091572,Staff,0,8,60,60
1651092655028,COGS 101C,A01,083625,Delgado; Tania,13,0,30,17
1651092661059,COGS 107A,A01,083627,Boyle; Mary E. T.,0,17,60,60
1651092667102,COGS 118A,A01,083075,Staff,0,10,60,60
1651092673128,CSE 3,A50,083646,Miranda; Gregory Joseph,15,0,38,23
1651092673128,CSE 3,A51,083647,Miranda; Gregory Joseph,36,0,37,1
1651092679151,CSE 8A,A50,083650,Miranda; Gregory Joseph,0,31,40,40
1651092685190,CSE 11,A01,083080,Cao; Yingjun,1,98,40,39
1651092691215,CSE 12,A01,083652,Staff,0,28,100,100
1651092697248,CSE 15L,A01,083654,Staff,0,3,50,50
1651092697248,CSE 15L,A02,083655,Staff,0,3,50,50
1651092703271,CSE 20,A01,083657,Staff,46,0,80,34
1651092709298,CSE 30,A01,083084,Eldon; John,0,38,80,80
1651092715322,CSE 100,A01,083659,Cao; Yingjun,0,72,50,50
1651092721349,CSE 134B,A01,083661,Powell; Thomas Allan,0,38,65,65
1651092727376,CSE 140,A01,083663,Staff,0,15,75,75
1651092733398,CSE 140L,A01,083088,Eldon; John,3,0,100,97
1651092739422,CSE 175,A01,083665,Kumar; Rakesh,0,0,25,25
1651092745454,CSE 190,A00,092507,Dubnov; Shlomo,9,0,20,11
1651092751476,ECE 45,A01,083139,Staff,0,7,60,60
1651092757502,ECE 65,A50,083695,Staff,0,7,30,30
1651092763544,ECE 109,A01,091882,Touri; Behrouz,33,0,70,37
1651092769589,ECE 180,A00,083140,Abi Samra; Nicholas Camill,17,0,30,13
1651092769589,ECE 180,B00,083141,Abi Samra; Nicholas Camill,0,0,30,32
1651092775629,MATH 10A,A01,083735,Patchell; Gregory David,0,0,30,30
1651092775629,MATH 10A,A02,083736,Patchell; Gregory David,26,0,30,4
1651092775629,MATH 10A,A03,083737,Patchell; Gregory David,22,0,30,8
1651092781662,MATH 10B,A01,083207,Staff,0,7,30,30
1651092781662,MATH 10B,A02,083208,Staff,0,6,30,30
1651092781662,MATH 10B,B01,083739,Staff,6,0,30,24
1651092781662,MATH 10B,B02,083740,Staff,28,0,30,2
1651092787689,MATH 18,A01,083743,Staff,0,0,30,30
1651092787689,MATH 18,A02,083744,Staff,22,0,30,8
1651092787689,MATH 18,A03,083745,Staff,19,0,30,11
1651092787689,MATH 18,A04,083746,Staff,26,0,30,4
1651092787689,MATH 18,B01,083748,Staff,0,16,30,30
1651092787689,MATH 18,B02,083749,Staff,0,14,30,30
1651092787689,MATH 18,B03,083750,Staff,0,14,30,30
1651092787689,MATH 18,B04,083751,Staff,0,13,30,30
1651092793786,MATH 20A,A01,083754,Staff,18,0,40,22
1651092799822,MATH 20B,A01,083756,Staff,0,14,30,30
1651092799822,MATH 20B,A02,083757,Staff,0,11,30,30
1651092805849,MATH 20C,A01,083760,Staff,0,16,30,30
1651092805849,MATH 20C,A02,083761,Staff,0,15,30,30
1651092805849,MATH 20C,B01,083762,Staff,7,0,30,23
1651092805849,MATH 20C,B02,083763,Staff,27,0,30,3
1651092811872,MATH 20D,A01,083765,Staff,3,1,30,27
1651092811872,MATH 20D,A02,083766,Staff,1,0,30,29
1651092811872,MATH 20D,A03,083767,Staff,22,0,30,8
1651092817896,MATH 20E,A01,083771,Staff,1,0,30,29
1651092817896,MATH 20E,A02,083772,Staff,9,0,30,21
1651092817896,MATH 20E,B01,083773,Staff,5,0,35,30
1651092817896,MATH 20E,B02,083774,Staff,5,1,35,30
1651092823919,MATH 103A,A01,083777,Staff,0,17,30,30
1651092823919,MATH 103A,A02,083778,Staff,0,17,30,30
1651092823919,MATH 103A,B01,083779,Staff,0,15,30,30
1651092823919,MATH 103A,B02,083780,Staff,0,14,30,30
1651092829944,MATH 105,A01,085443,Staff,0,24,30,30
1651092835967,MATH 109,A01,083213,Anzaldo; Leesa B,0,7,30,30
1651092835967,MATH 109,A02,083214,Anzaldo; Leesa B,0,7,30,30
1651092835967,MATH 109,B01,083215,Anzaldo; Leesa B,0,8,30,30
1651092835967,MATH 109,B02,083216,Anzaldo; Leesa B,1,8,30,29
1651092841997,MATH 142A,A01,083219,Chow; Bennett,0,15,30,30
1651092841997,MATH 142A,A02,083220,Chow; Bennett,0,15,30,30
1651092841997,MATH 142A,B01,083221,Chow; Bennett,0,16,30,30
1651092841997,MATH 142A,B02,083222,Chow; Bennett,0,15,30,30
1651092848021,MATH 193A,A01,083224,Staff,0,9,30,30
1651092848021,MATH 193A,A02,083225,Staff,1,7,30,29
1651092848021,MATH 193A,A03,083781,Staff,0,7,30,30
1651092848021,MATH 193A,A04,083782,Staff,0,7,30,30
1651092854045,MATH 197,001,091859,McAuley; Julian John,9998,0,9999,1
1651092860102,COGS 9,A01,083615,Staff,0,20,60,60
1651092866127,COGS 11,A01,083617,Boyle; Mary E. T.,13,0,40,27
1651092872151,COGS 13,A01,083071,Staff,0,38,40,40
1651092878179,COGS 14A,A01,092681,Staff,0,40,100,100
1651092884202,COGS 14B,A01,083073,Cheng; Tzu-Han,0,12,50,50
1651092890227,COGS 17,A01,092677,Staff,8,0,75,67
1651092896252,COGS 100,A01,083619,Staff,0,30,60,60
1651092902279,COGS 101A,A01,083621,Davis; Joshua Daniel,0,29,60,60
1651092908308,COGS 101B,A01,091572,Staff,0,8,60,60
1651092914334,COGS 101C,A01,083625,Delgado; Tania,13,0,30,17
1651092920358,COGS 107A,A01,083627,Boyle; Mary E. T.,0,17,60,60
1651092926379,COGS 118A,A01,083075,Staff,0,10,60,60
1651092932419,CSE 3,A50,083646,Miranda; Gregory Joseph,15,0,38,23
1651092932419,CSE 3,A51,083647,Miranda; Gregory Joseph,36,0,37,1
1651092938462,CSE 8A,A50,083650,Miranda; Gregory Joseph,0,31,40,40
1651092944485,CSE 11,A01,083080,Cao; Yingjun,1,98,40,39
1651092950510,CSE 12,A01,083652,Staff,0,28,100,100
1651092956532,CSE 15L,A01,083654,Staff,0,3,50,50
1651092956532,CSE 15L,A02,083655,Staff,0,3,50,50
1651092962556,CSE 20,A01,083657,Staff,46,0,80,34
1651092968579,CSE 30,A01,083084,Eldon; John,0,38,80,80
1651092974601,CSE 100,A01,083659,Cao; Yingjun,0,72,50,50
1651092980633,CSE 134B,A01,083661,Powell; Thomas Allan,0,38,65,65
1651092986657,CSE 140,A01,083663,Staff,0,15,75,75
1651092992702,CSE 140L,A01,083088,Eldon; John,3,0,100,97
1651092998728,CSE 175,A01,083665,Kumar; Rakesh,0,0,25,25
1651093004771,CSE 190,A00,092507,Dubnov; Shlomo,9,0,20,11
1651093010797,ECE 45,A01,083139,Staff,0,7,60,60
1651093016823,ECE 65,A50,083695,Staff,0,7,30,30
1651093022862,ECE 109,A01,091882,Touri; Behrouz,32,0,70,38
1651093028888,ECE 180,A00,083140,Abi Samra; Nicholas Camill,17,0,30,13
1651093028888,ECE 180,B00,083141,Abi Samra; Nicholas Camill,0,0,30,32
1651093034917,MATH 10A,A01,083735,Patchell; Gregory David,0,0,30,30
1651093034917,MATH 10A,A02,083736,Patchell; Gregory David,26,0,30,4
1651093034917,MATH 10A,A03,083737,Patchell; Gregory David,22,0,30,8
1651093041009,MATH 10B,A01,083207,Staff,0,7,30,30
1651093041009,MATH 10B,A02,083208,Staff,0,6,30,30
1651093041009,MATH 10B,B01,083739,Staff,6,0,30,24
1651093041009,MATH 10B,B02,083740,Staff,28,0,30,2
1651093047038,MATH 18,A01,083743,Staff,0,0,30,30
1651093047038,MATH 18,A02,083744,Staff,22,0,30,8
1651093047038,MATH 18,A03,083745,Staff,19,0,30,11
1651093047038,MATH 18,A04,083746,Staff,26,0,30,4
1651093047038,MATH 18,B01,083748,Staff,0,16,30,30
1651093047038,MATH 18,B02,083749,Staff,0,14,30,30
1651093047038,MATH 18,B03,083750,Staff,0,14,30,30
1651093047038,MATH 18,B04,083751,Staff,0,13,30,30
1651093053061,MATH 20A,A01,083754,Staff,18,0,40,22
1651093059088,MATH 20B,A01,083756,Staff,0,14,30,30
1651093059088,MATH 20B,A02,083757,Staff,0,11,30,30
1651093065115,MATH 20C,A01,083760,Staff,0,16,30,30
1651093065115,MATH 20C,A02,083761,Staff,0,15,30,30
1651093065115,MATH 20C,B01,083762,Staff,7,0,30,23
1651093065115,MATH 20C,B02,083763,Staff,27,0,30,3
1651093071137,MATH 20D,A01,083765,Staff,3,1,30,27
1651093071137,MATH 20D,A02,083766,Staff,1,0,30,29
1651093071137,MATH 20D,A03,083767,Staff,22,0,30,8
1651093077161,MATH 20E,A01,083771,Staff,1,0,30,29
1651093077161,MATH 20E,A02,083772,Staff,9,0,30,21
1651093077161,MATH 20E,B01,083773,Staff,5,0,35,30
1651093077161,MATH 20E,B02,083774,Staff,5,1,35,30
1651093083184,MATH 103A,A01,083777,Staff,0,17,30,30
1651093083184,MATH 103A,A02,083778,Staff,0,17,30,30
1651093083184,MATH 103A,B01,083779,Staff,0,15,30,30
1651093083184,MATH 103A,B02,083780,Staff,0,14,30,30
1651093089211,MATH 105,A01,085443,Staff,0,24,30,30
1651093095237,MATH 109,A01,083213,Anzaldo; Leesa B,0,7,30,30
1651093095237,MATH 109,A02,083214,Anzaldo; Leesa B,0,7,30,30
1651093095237,MATH 109,B01,083215,Anzaldo; Leesa B,0,8,30,30
1651093095237,MATH 109,B02,083216,Anzaldo; Leesa B,1,8,30,29
1651093101262,MATH 142A,A01,083219,Chow; Bennett,0,15,30,30
1651093101262,MATH 142A,A02,083220,Chow; Bennett,0,15,30,30
1651093101262,MATH 142A,B01,083221,Chow; Bennett,0,16,30,30
1651093101262,MATH 142A,B02,083222,Chow; Bennett,0,15,30,30
1651093107291,MATH 193A,A01,083224,Staff,0,9,30,30
1651093107291,MATH 193A,A02,083225,Staff,1,7,30,29
1651093107291,MATH 193A,A03,083781,Staff,0,7,30,30
1651093107291,MATH 193A,A04,083782,Staff,0,7,30,30
1651093113313,MATH 197,001,091859,McAuley; Julian John,9998,0,9999,1
1651093119376,COGS 9,A01,083615,Staff,0,20,60,60
1651093125408,COGS 11,A01,083617,Boyle; Mary E. T.,13,0,40,27
1651093131431,COGS 13,A01,083071,Staff,0,38,40,40
1651093137454,COGS 14A,A01,092681,Staff,0,40,100,100
1651093143476,COGS 14B,A01,083073,Cheng; Tzu-Han,0,12,50,50
1651093149499,COGS 17,A01,092677,Staff,8,0,75,67
1651093155524,COGS 100,A01,083619,Staff,0,30,60,60
1651093161557,COGS 101A,A01,083621,Davis; Joshua Daniel,0,29,60,60
1651093167583,COGS 101B,A01,091572,Staff,0,8,60,60
1651093173632,COGS 101C,A01,083625,Delgado; Tania,13,0,30,17
1651093179654,COGS 107A,A01,083627,Boyle; Mary E. T.,0,17,60,60
1651093185677,COGS 118A,A01,083075,Staff,0,10,60,60
1651093191704,CSE 3,A50,083646,Miranda; Gregory Joseph,15,0,38,23
1651093191704,CSE 3,A51,083647,Miranda; Gregory Joseph,36,0,37,1
1651093197740,CSE 8A,A50,083650,Miranda; Gregory Joseph,0,31,40,40
1651093203764,CSE 11,A01,083080,Cao; Yingjun,1,98,40,39
1651093209792,CSE 12,A01,083652,Staff,0,28,100,100
1651093215816,CSE 15L,A01,083654,Staff,0,3,50,50
1651093215816,CSE 15L,A02,083655,Staff,0,3,50,50
1651093221839,CSE 20,A01,083657,Staff,46,0,80,34
1651093227871,CSE 30,A01,083084,Eldon; John,0,38,80,80
1651093233895,CSE 100,A01,083659,Cao; Yingjun,0,72,50,50
1651093239918,CSE 134B,A01,083661,Powell; Thomas Allan,0,38,65,65
1651093245940,CSE 140,A01,083663,Staff,0,15,75,75
1651093251963,CSE 140L,A01,083088,Eldon; John,3,0,100,97
1651093257993,CSE 175,A01,083665,Kumar; Rakesh,0,0,25,25
1651093264030,CSE 190,A00,092507,Dubnov; Shlomo,9,0,20,11
1651093270058,ECE 45,A01,083139,Staff,0,7,60,60
1651093276085,ECE 65,A50,083695,Staff,0,7,30,30
1651093282107,ECE 109,A01,091882,Touri; Behrouz,32,0,70,38
1651093288131,ECE 180,A00,083140,Abi Samra; Nicholas Camill,17,0,30,13
1651093288131,ECE 180,B00,083141,Abi Samra; Nicholas Camill,0,0,30,32
1651093294154,MATH 10A,A01,083735,Patchell; Gregory David,0,0,30,30
1651093294154,MATH 10A,A02,083736,Patchell; Gregory David,26,0,30,4
1651093294154,MATH 10A,A03,083737,Patchell; Gregory David,22,0,30,8
1651093300180,MATH 10B,A01,083207,Staff,0,7,30,30
1651093300180,MATH 10B,A02,083208,Staff,0,6,30,30
1651093300180,MATH 10B,B01,083739,Staff,6,0,30,24
1651093300180,MATH 10B,B02,083740,Staff,28,0,30,2
1651093306211,MATH 18,A01,083743,Staff,0,0,30,30
1651093306211,MATH 18,A02,083744,Staff,22,0,30,8
1651093306211,MATH 18,A03,083745,Staff,19,0,30,11
1651093306211,MATH 18,A04,083746,Staff,26,0,30,4
1651093306211,MATH 18,B01,083748,Staff,0,16,30,30
1651093306211,MATH 18,B02,083749,Staff,0,14,30,30
1651093306211,MATH 18,B03,083750,Staff,0,14,30,30
1651093306211,MATH 18,B04,083751,Staff,0,13,30,30
1651093312246,MATH 20A,A01,083754,Staff,18,0,40,22
1651093318270,MATH 20B,A01,083756,Staff,0,14,30,30
1651093318270,MATH 20B,A02,083757,Staff,0,11,30,30
1651093324294,MATH 20C,A01,083760,Staff,0,16,30,30
1651093324294,MATH 20C,A02,083761,Staff,0,15,30,30
1651093324294,MATH 20C,B01,083762,Staff,7,0,30,23
1651093324294,MATH 20C,B02,083763,Staff,27,0,30,3
1651093330319,MATH 20D,A01,083765,Staff,3,1,30,27
1651093330319,MATH 20D,A02,083766,Staff,1,0,30,29
1651093330319,MATH 20D,A03,083767,Staff,22,0,30,8
1651093336347,MATH 20E,A01,083771,Staff,1,0,30,29
1651093336347,MATH 20E,A02,083772,Staff,9,0,30,21
1651093336347,MATH 20E,B01,083773,Staff,5,0,35,30
1651093336347,MATH 20E,B02,083774,Staff,5,1,35,30
1651093342371,MATH 103A,A01,083777,Staff,0,17,30,30
1651093342371,MATH 103A,A02,083778,Staff,0,17,30,30
1651093342371,MATH 103A,B01,083779,Staff,0,15,30,30
1651093342371,MATH 103A,B02,083780,Staff,0,14,30,30
1651093348393,MATH 105,A01,085443,Staff,0,24,30,30
1651093354423,MATH 109,A01,083213,Anzaldo; Leesa B,0,7,30,30
1651093354423,MATH 109,A02,083214,Anzaldo; Leesa B,0,7,30,30
1651093354423,MATH 109,B01,083215,Anzaldo; Leesa B,0,8,30,30
1651093354423,MATH 109,B02,083216,Anzaldo; Leesa B,1,8,30,29
1651093360447,MATH 142A,A01,083219,Chow; Bennett,0,15,30,30
1651093360447,MATH 142A,A02,083220,Chow; Bennett,0,15,30,30
1651093360447,MATH 142A,B01,083221,Chow; Bennett,0,16,30,30
1651093360447,MATH 142A,B02,083222,Chow; Bennett,0,15,30,30
1651093366470,MATH 193A,A01,083224,Staff,0,9,30,30
1651093366470,MATH 193A,A02,083225,Staff,1,7,30,29
1651093366470,MATH 193A,A03,083781,Staff,0,7,30,30
1651093366470,MATH 193A,A04,083782,Staff,0,7,30,30
1651093372493,MATH 197,001,091859,McAuley; Julian John,9998,0,9999,1
1651093378561,COGS 9,A01,083615,Staff,0,20,60,60
1651093384676,COGS 11,A01,083617,Boyle; Mary E. T.,13,0,40,27
1651093390698,COGS 13,A01,083071,Staff,0,38,40,40
1651093396727,COGS 14A,A01,092681,Staff,0,40,100,100
1651093402748,COGS 14B,A01,083073,Cheng; Tzu-Han,0,12,50,50
1651093408774,COGS 17,A01,092677,Staff,8,0,75,67
1651093414796,COGS 100,A01,083619,Staff,0,30,60,60
1651093420827,COGS 101A,A01,083621,Davis; Joshua Daniel,0,29,60,60
1651093426864,COGS 101B,A01,091572,Staff,0,8,60,60
1651093432888,COGS 101C,A01,083625,Delgado; Tania,13,0,30,17
1651093438915,COGS 107A,A01,083627,Boyle; Mary E. T.,0,17,60,60
1651093444938,COGS 118A,A01,083075,Staff,0,10,60,60
1651093450973,CSE 3,A50,083646,Miranda; Gregory Joseph,15,0,38,23
1651093450973,CSE 3,A51,083647,Miranda; Gregory Joseph,36,0,37,1
1651093457005,CSE 8A,A50,083650,Miranda; Gregory Joseph,0,31,40,40
1651093463029,CSE 11,A01,083080,Cao; Yingjun,1,98,40,39
1651093469050,CSE 12,A01,083652,Staff,0,28,100,100
1651093475076,CSE 15L,A01,083654,Staff,0,3,50,50
1651093475076,CSE 15L,A02,083655,Staff,0,3,50,50
1651093481104,CSE 20,A01,083657,Staff,46,0,80,34
1651093487126,CSE 30,A01,083084,Eldon; John,0,38,80,80
1651093493150,CSE 100,A01,083659,Cao; Yingjun,0,72,50,50
1651093499183,CSE 134B,A01,083661,Powell; Thomas Allan,0,38,65,65
1651093505220,CSE 140,A01,083663,Staff,0,15,75,75
1651093511249,CSE 140L,A01,083088,Eldon; John,3,0,100,97
1651093517281,CSE 175,A01,083665,Kumar; Rakesh,0,0,25,25
1651093523305,CSE 190,A00,092507,Dubnov; Shlomo,9,0,20,11
1651093529327,ECE 45,A01,083139,Staff,0,7,60,60
1651093535358,ECE 65,A50,083695,Staff,0,7,30,30
1651093541379,ECE 109,A01,091882,Touri; Behrouz,32,0,70,38
1651093547403,ECE 180,A00,083140,Abi Samra; Nicholas Camill,17,0,30,13
1651093547403,ECE 180,B00,083141,Abi Samra; Nicholas Camill,0,0,30,32
1651093553428,MATH 10A,A01,083735,Patchell; Gregory David,0,0,30,30
1651093553428,MATH 10A,A02,083736,Patchell; Gregory David,26,0,30,4
1651093553428,MATH 10A,A03,083737,Patchell; Gregory David,22,0,30,8
1651093559463,MATH 10B,A01,083207,Staff,0,7,30,30
1651093559463,MATH 10B,A02,083208,Staff,0,6,30,30
1651093559463,MATH 10B,B01,083739,Staff,6,0,30,24
1651093559463,MATH 10B,B02,083740,Staff,28,0,30,2
1651093565494,MATH 18,A01,083743,Staff,0,0,30,30
1651093565494,MATH 18,A02,083744,Staff,22,0,30,8
1651093565494,MATH 18,A03,083745,Staff,19,0,30,11
1651093565494,MATH 18,A04,083746,Staff,26,0,30,4
1651093565494,MATH 18,B01,083748,Staff,0,16,30,30
1651093565494,MATH 18,B02,083749,Staff,0,14,30,30
1651093565494,MATH 18,B03,083750,Staff,0,14,30,30
1651093565494,MATH 18,B04,083751,Staff,0,13,30,30
1651093571516,MATH 20A,A01,083754,Staff,18,0,40,22
1651093577545,MATH 20B,A01,083756,Staff,0,14,30,30
1651093577545,MATH 20B,A02,083757,Staff,0,11,30,30
1651093583568,MATH 20C,A01,083760,Staff,0,16,30,30
1651093583568,MATH 20C,A02,083761,Staff,0,15,30,30
1651093583568,MATH 20C,B01,083762,Staff,7,0,30,23
1651093583568,MATH 20C,B02,083763,Staff,27,0,30,3
1651093589592,MATH 20D,A01,083765,Staff,3,1,30,27
1651093589592,MATH 20D,A02,083766,Staff,1,0,30,29
1651093589592,MATH 20D,A03,083767,Staff,22,0,30,8
1651093595625,MATH 20E,A01,083771,Staff,0,0,30,30
1651093595625,MATH 20E,A02,083772,Staff,9,0,30,21
1651093595625,MATH 20E,B01,083773,Staff,5,0,35,30
1651093595625,MATH 20E,B02,083774,Staff,5,1,35,30
1651093601653,MATH 103A,A01,083777,Staff,0,17,30,30
1651093601653,MATH 103A,A02,083778,Staff,0,17,30,30
1651093601653,MATH 103A,B01,083779,Staff,0,15,30,30
1651093601653,MATH 103A,B02,083780,Staff,0,14,30,30
1651093607677,MATH 105,A01,085443,Staff,0,24,30,30
1651093613703,MATH 109,A01,083213,Anzaldo; Leesa B,0,7,30,30
1651093613703,MATH 109,A02,083214,Anzaldo; Leesa B,0,7,30,30
1651093613703,MATH 109,B01,083215,Anzaldo; Leesa B,0,8,30,30
1651093613703,MATH 109,B02,083216,Anzaldo; Leesa B,1,8,30,29
1651093619729,MATH 142A,A01,083219,Chow; Bennett,0,15,30,30
1651093619729,MATH 142A,A02,083220,Chow; Bennett,0,15,30,30
1651093619729,MATH 142A,B01,083221,Chow; Bennett,0,16,30,30
1651093619729,MATH 142A,B02,083222,Chow; Bennett,0,15,30,30
1651093625759,MATH 193A,A01,083224,Staff,0,9,30,30
1651093625759,MATH 193A,A02,083225,Staff,1,7,30,29
1651093625759,MATH 193A,A03,083781,Staff,0,7,30,30
1651093625759,MATH 193A,A04,083782,Staff,0,7,30,30
1651093631785,MATH 197,001,091859,McAuley; Julian John,9998,0,9999,1
1651093637837,COGS 9,A01,083615,Staff,0,20,60,60
1651093643863,COGS 11,A01,083617,Boyle; Mary E. T.,13,0,40,27
1651093649889,COGS 13,A01,083071,Staff,0,38,40,40
1651093655914,COGS 14A,A01,092681,Staff,0,40,100,100
1651093661949,COGS 14B,A01,083073,Cheng; Tzu-Han,0,12,50,50
1651093667971,COGS 17,A01,092677,Staff,8,0,75,67
1651093673994,COGS 100,A01,083619,Staff,0,30,60,60
1651093680021,COGS 101A,A01,083621,Davis; Joshua Daniel,0,29,60,60
1651093686048,COGS 101B,A01,091572,Staff,0,8,60,60
1651093692076,COGS 101C,A01,083625,Delgado; Tania,13,0,30,17
1651093698100,COGS 107A,A01,083627,Boyle; Mary E. T.,0,17,60,60
1651093704123,COGS 118A,A01,083075,Staff,0,10,60,60
1651093710146,CSE 3,A50,083646,Miranda; Gregory Joseph,15,0,38,23
1651093710146,CSE 3,A51,083647,Miranda; Gregory Joseph,36,0,37,1
1651093716189,CSE 8A,A50,083650,Miranda; Gregory Joseph,0,31,40,40
1651093722227,CSE 11,A01,083080,Cao; Yingjun,1,98,40,39
1651093728252,CSE 12,A01,083652,Staff,0,28,100,100
1651093734281,CSE 15L,A01,083654,Staff,0,3,50,50
1651093734281,CSE 15L,A02,083655,Staff,0,3,50,50
1651093740311,CSE 20,A01,083657,Staff,46,0,80,34
1651093746338,CSE 30,A01,083084,Eldon; John,0,38,80,80
1651093752369,CSE 100,A01,083659,Cao; Yingjun,0,72,50,50
1651093758392,CSE 134B,A01,083661,Powell; Thomas Allan,0,38,65,65
1651093764418,CSE 140,A01,083663,Staff,0,15,75,75
1651093770440,CSE 140L,A01,083088,Eldon; John,3,0,100,97
1651093776469,CSE 175,A01,083665,Kumar; Rakesh,0,0,25,25
1651093782492,CSE 190,A00,092507,Dubnov; Shlomo,9,0,20,11
1651093788514,ECE 45,A01,083139,Staff,0,7,60,60
1651093794543,ECE 65,A50,083695,Staff,0,7,30,30
1651093800569,ECE 109,A01,091882,Touri; Behrouz,32,0,70,38
1651093806608,ECE 180,A00,083140,Abi Samra; Nicholas Camill,17,0,30,13
1651093806608,ECE 180,B00,083141,Abi Samra; Nicholas Camill,0,0,30,32
1651093812638,MATH 10A,A01,083735,Patchell; Gregory David,0,0,30,30
1651093812638,MATH 10A,A02,083736,Patchell; Gregory David,26,0,30,4
1651093812638,MATH 10A,A03,083737,Patchell; Gregory David,22,0,30,8
1651093818664,MATH 10B,A01,083207,Staff,0,7,30,30
1651093818664,MATH 10B,A02,083208,Staff,0,6,30,30
1651093818664,MATH 10B,B01,083739,Staff,6,0,30,24
1651093818664,MATH 10B,B02,083740,Staff,28,0,30,2
1651093824693,MATH 18,A01,083743,Staff,0,0,30,30
1651093824693,MATH 18,A02,083744,Staff,22,0,30,8
1651093824693,MATH 18,A03,083745,Staff,19,0,30,11
1651093824693,MATH 18,A04,083746,Staff,26,0,30,4
1651093824693,MATH 18,B01,083748,Staff,0,16,30,30
1651093824693,MATH 18,B02,083749,Staff,0,14,30,30
1651093824693,MATH 18,B03,083750,Staff,0,14,30,30
1651093824693,MATH 18,B04,083751,Staff,0,13,30,30
1651093830714,MATH 20A,A01,083754,Staff,18,0,40,22
1651093836738,MATH 20B,A01,083756,Staff,0,14,30,30
1651093836738,MATH 20B,A02,083757,Staff,0,11,30,30
1651093842766,MATH 20C,A01,083760,Staff,0,16,30,30
1651093842766,MATH 20C,A02,083761,Staff,0,15,30,30
1651093842766,MATH 20C,B01,083762,Staff,7,0,30,23
1651093842766,MATH 20C,B02,083763,Staff,27,0,30,3
1651093848793,MATH 20D,A01,083765,Staff,3,1,30,27
1651093848793,MATH 20D,A02,083766,Staff,1,0,30,29
1651093848793,MATH 20D,A03,083767,Staff,22,0,30,8
1651093854823,MATH 20E,A01,083771,Staff,0,0,30,30
1651093854823,MATH 20E,A02,083772,Staff,9,0,30,21
1651093854823,MATH 20E,B01,083773,Staff,5,0,35,30
1651093854823,MATH 20E,B02,083774,Staff,5,1,35,30
1651093860875,MATH 103A,A01,083777,Staff,0,17,30,30
1651093860875,MATH 103A,A02,083778,Staff,0,17,30,30
1651093860875,MATH 103A,B01,083779,Staff,0,15,30,30
1651093860875,MATH 103A,B02,083780,Staff,0,14,30,30
1651093866901,MATH 105,A01,085443,Staff,0,24,30,30
1651093872924,MATH 109,A01,083213,Anzaldo; Leesa B,0,7,30,30
1651093872924,MATH 109,A02,083214,Anzaldo; Leesa B,0,7,30,30
1651093872924,MATH 109,B01,083215,Anzaldo; Leesa B,0,8,30,30
1651093872924,MATH 109,B02,083216,Anzaldo; Leesa B,1,8,30,29
1651093878950,MATH 142A,A01,083219,Chow; Bennett,0,15,30,30
1651093878950,MATH 142A,A02,083220,Chow; Bennett,0,15,30,30
1651093878950,MATH 142A,B01,083221,Chow; Bennett,0,16,30,30
1651093878950,MATH 142A,B02,083222,Chow; Bennett,0,15,30,30
1651093884979,MATH 193A,A01,083224,Staff,0,9,30,30
1651093884979,MATH 193A,A02,083225,Staff,1,7,30,29
1651093884979,MATH 193A,A03,083781,Staff,0,7,30,30
1651093884979,MATH 193A,A04,083782,Staff,0,7,30,30
1651093891003,MATH 197,001,091859,McAuley; Julian John,9998,0,9999,1
1651093897061,COGS 9,A01,083615,Staff,0,20,60,60
1651093903085,COGS 11,A01,083617,Boyle; Mary E. T.,13,0,40,27
1651093909107,COGS 13,A01,083071,Staff,0,38,40,40
1651093915134,COGS 14A,A01,092681,Staff,0,40,100,100
1651093921159,COGS 14B,A01,083073,Cheng; Tzu-Han,0,12,50,50
1651093927186,COGS 17,A01,092677,Staff,8,0,75,67
1651093933216,COGS 100,A01,083619,Staff,0,30,60,60
1651093939239,COGS 101A,A01,083621,Davis; Joshua Daniel,0,29,60,60
1651093945264,COGS 101B,A01,091572,Staff,0,8,60,60
1651093951288,COGS 101C,A01,083625,Delgado; Tania,13,0,30,17
1651093957313,COGS 107A,A01,083627,Boyle; Mary E. T.,0,17,60,60
1651093963344,COGS 118A,A01,083075,Staff,0,10,60,60
1651093969368,CSE 3,A50,083646,Miranda; Gregory Joseph,15,0,38,23
1651093969368,CSE 3,A51,083647,Miranda; Gregory Joseph,36,0,37,1
1651093975395,CSE 8A,A50,083650,Miranda; Gregory Joseph,0,31,40,40
1651093981513,CSE 11,A01,083080,Cao; Yingjun,1,98,40,39
1651093987538,CSE 12,A01,083652,Staff,0,28,100,100
1651093993575,CSE 15L,A01,083654,Staff,0,3,50,50
1651093993575,CSE 15L,A02,083655,Staff,0,3,50,50
1651093999600,CSE 20,A01,083657,Staff,46,0,80,34
1651094005629,CSE 30,A01,083084,Eldon; John,0,38,80,80
1651094011653,CSE 100,A01,083659,Cao; Yingjun,0,72,50,50
1651094017678,CSE 134B,A01,083661,Powell; Thomas Allan,0,38,65,65
1651094023704,CSE 140,A01,083663,Staff,0,15,75,75
1651094029730,CSE 140L,A01,083088,Eldon; John,3,0,100,97
1651094035751,CSE 175,A01,083665,Kumar; Rakesh,0,0,25,25
1651094041787,CSE 190,A00,092507,Dubnov; Shlomo,9,0,20,11
1651094047812,ECE 45,A01,083139,Staff,0,7,60,60
1651094053835,ECE 65,A50,083695,Staff,0,7,30,30
1651094059859,ECE 109,A01,091882,Touri; Behrouz,32,0,70,38
1651094065888,ECE 180,A00,083140,Abi Samra; Nicholas Camill,17,0,30,13
1651094065888,ECE 180,B00,083141,Abi Samra; Nicholas Camill,0,0,30,32
1651094071913,MATH 10A,A01,083735,Patchell; Gregory David,0,0,30,30
1651094071913,MATH 10A,A02,083736,Patchell; Gregory David,26,0,30,4
1651094071913,MATH 10A,A03,083737,Patchell; Gregory David,22,0,30,8
1651094077936,MATH 10B,A01,083207,Staff,0,7,30,30
1651094077936,MATH 10B,A02,083208,Staff,0,6,30,30
1651094077936,MATH 10B,B01,083739,Staff,6,0,30,24
1651094077936,MATH 10B,B02,083740,Staff,28,0,30,2
1651094083965,MATH 18,A01,083743,Staff,0,0,30,30
1651094083965,MATH 18,A02,083744,Staff,22,0,30,8
1651094083965,MATH 18,A03,083745,Staff,19,0,30,11
1651094083965,MATH 18,A04,083746,Staff,26,0,30,4
1651094083965,MATH 18,B01,083748,Staff,0,16,30,30
1651094083965,MATH 18,B02,083749,Staff,0,14,30,30
1651094083965,MATH 18,B03,083750,Staff,0,14,30,30
1651094083965,MATH 18,B04,083751,Staff,0,13,30,30
1651094089990,MATH 20A,A01,083754,Staff,18,0,40,22
1651094096017,MATH 20B,A01,083756,Staff,0,14,30,30
1651094096017,MATH 20B,A02,083757,Staff,0,11,30,30
1651094102044,MATH 20C,A01,083760,Staff,0,16,30,30
1651094102044,MATH 20C,A02,083761,Staff,0,15,30,30
1651094102044,MATH 20C,B01,083762,Staff,7,0,30,23
1651094102044,MATH 20C,B02,083763,Staff,27,0,30,3
1651094108072,MATH 20D,A01,083765,Staff,3,1,30,27
1651094108072,MATH 20D,A02,083766,Staff,1,0,30,29
1651094108072,MATH 20D,A03,083767,Staff,22,0,30,8
1651094114102,MATH 20E,A01,083771,Staff,0,0,30,30
1651094114102,MATH 20E,A02,083772,Staff,9,0,30,21
1651094114102,MATH 20E,B01,083773,Staff,5,0,35,30
1651094114102,MATH 20E,B02,083774,Staff,5,1,35,30
1651094120125,MATH 103A,A01,083777,Staff,0,17,30,30
1651094120125,MATH 103A,A02,083778,Staff,0,17,30,30
1651094120125,MATH 103A,B01,083779,Staff,0,15,30,30
1651094120125,MATH 103A,B02,083780,Staff,0,14,30,30
1651094126151,MATH 105,A01,085443,Staff,0,24,30,30
1651094132185,MATH 109,A01,083213,Anzaldo; Leesa B,0,7,30,30
1651094132185,MATH 109,A02,083214,Anzaldo; Leesa B,0,7,30,30
1651094132185,MATH 109,B01,083215,Anzaldo; Leesa B,0,8,30,30
1651094132185,MATH 109,B02,083216,Anzaldo; Leesa B,1,8,30,29
1651094138213,MATH 142A,A01,083219,Chow; Bennett,0,15,30,30
1651094138213,MATH 142A,A02,083220,Chow; Bennett,0,15,30,30
1651094138213,MATH 142A,B01,083221,Chow; Bennett,0,16,30,30
1651094138213,MATH 142A,B02,083222,Chow; Bennett,0,15,30,30
1651094144246,MATH 193A,A01,083224,Staff,0,9,30,30
1651094144246,MATH 193A,A02,083225,Staff,1,7,30,29
1651094144246,MATH 193A,A03,083781,Staff,0,7,30,30
1651094144246,MATH 193A,A04,083782,Staff,0,7,30,30
1651094150268,MATH 197,001,091859,McAuley; Julian John,9998,0,9999,1
1651094156325,COGS 9,A01,083615,Staff,0,20,60,60
1651094162356,COGS 11,A01,083617,Boyle; Mary E. T.,13,0,40,27
1651094168377,COGS 13,A01,083071,Staff,0,38,40,40
1651094174406,COGS 14A,A01,092681,Staff,0,40,100,100
1651094180437,COGS 14B,A01,083073,Cheng; Tzu-Han,0,12,50,50
1651094186463,COGS 17,A01,092677,Staff,8,0,75,67
1651094192486,COGS 100,A01,083619,Staff,0,30,60,60
1651094198512,COGS 101A,A01,083621,Davis; Joshua Daniel,0,29,60,60
1651094204535,COGS 101B,A01,091572,Staff,0,8,60,60
1651094210570,COGS 101C,A01,083625,Delgado; Tania,13,0,30,17
1651094216597,COGS 107A,A01,083627,Boyle; Mary E. T.,0,17,60,60
1651094222635,COGS 118A,A01,083075,Staff,0,10,60,60
1651094228663,CSE 3,A50,083646,Miranda; Gregory Joseph,15,0,38,23
1651094228663,CSE 3,A51,083647,Miranda; Gregory Joseph,36,0,37,1
1651094234686,CSE 8A,A50,083650,Miranda; Gregory Joseph,0,31,40,40
1651094240713,CSE 11,A01,083080,Cao; Yingjun,1,98,40,39
1651094246741,CSE 12,A01,083652,Staff,0,28,100,100
1651094252772,CSE 15L,A01,083654,Staff,0,3,50,50
1651094252772,CSE 15L,A02,083655,Staff,0,3,50,50
1651094258795,CSE 20,A01,083657,Staff,46,0,80,34
1651094264823,CSE 30,A01,083084,Eldon; John,0,38,80,80
1651094270859,CSE 100,A01,083659,Cao; Yingjun,0,72,50,50
1651094276886,CSE 134B,A01,083661,Powell; Thomas Allan,0,38,65,65
1651094282910,CSE 140,A01,083663,Staff,0,15,75,75
1651094288941,CSE 140L,A01,083088,Eldon; John,3,0,100,97
1651094294978,CSE 175,A01,083665,Kumar; Rakesh,0,0,25,25
1651094301006,CSE 190,A00,092507,Dubnov; Shlomo,9,0,20,11
1651094307030,ECE 45,A01,083139,Staff,0,7,60,60
1651094313056,ECE 65,A50,083695,Staff,0,7,30,30
1651094319079,ECE 109,A01,091882,Touri; Behrouz,32,0,70,38
1651094325104,ECE 180,A00,083140,Abi Samra; Nicholas Camill,17,0,30,13
1651094325104,ECE 180,B00,083141,Abi Samra; Nicholas Camill,0,0,30,32
1651094331130,MATH 10A,A01,083735,Patchell; Gregory David,0,0,30,30
1651094331130,MATH 10A,A02,083736,Patchell; Gregory David,26,0,30,4
1651094331130,MATH 10A,A03,083737,Patchell; Gregory David,22,0,30,8
1651094337168,MATH 10B,A01,083207,Staff,0,7,30,30
1651094337168,MATH 10B,A02,083208,Staff,0,6,30,30
1651094337168,MATH 10B,B01,083739,Staff,6,0,30,24
1651094337168,MATH 10B,B02,083740,Staff,28,0,30,2
1651094343210,MATH 18,A01,083743,Staff,0,0,30,30
1651094343210,MATH 18,A02,083744,Staff,22,0,30,8
1651094343210,MATH 18,A03,083745,Staff,19,0,30,11
1651094343210,MATH 18,A04,083746,Staff,26,0,30,4
1651094343210,MATH 18,B01,083748,Staff,0,16,30,30
1651094343210,MATH 18,B02,083749,Staff,0,14,30,30
1651094343210,MATH 18,B03,083750,Staff,0,14,30,30
1651094343210,MATH 18,B04,083751,Staff,0,13,30,30
1651094349236,MATH 20A,A01,083754,Staff,18,0,40,22
1651094355264,MATH 20B,A01,083756,Staff,0,14,30,30
1651094355264,MATH 20B,A02,083757,Staff,0,11,30,30
1651094361288,MATH 20C,A01,083760,Staff,0,16,30,30
1651094361288,MATH 20C,A02,083761,Staff,0,15,30,30
1651094361288,MATH 20C,B01,083762,Staff,7,0,30,23
1651094361288,MATH 20C,B02,083763,Staff,27,0,30,3
1651094367319,MATH 20D,A01,083765,Staff,3,1,30,27
1651094367319,MATH 20D,A02,083766,Staff,1,0,30,29
1651094367319,MATH 20D,A03,083767,Staff,22,0,30,8
1651094373346,MATH 20E,A01,083771,Staff,0,0,30,30
1651094373346,MATH 20E,A02,083772,Staff,9,0,30,21
1651094373346,MATH 20E,B01,083773,Staff,5,0,35,30
1651094373346,MATH 20E,B02,083774,Staff,5,1,35,30
1651094379370,MATH 103A,A01,083777,Staff,0,17,30,30
1651094379370,MATH 103A,A02,083778,Staff,0,17,30,30
1651094379370,MATH 103A,B01,083779,Staff,0,15,30,30
1651094379370,MATH 103A,B02,083780,Staff,0,14,30,30
1651094385393,MATH 105,A01,085443,Staff,0,24,30,30
1651094391418,MATH 109,A01,083213,Anzaldo; Leesa B,0,7,30,30
1651094391418,MATH 109,A02,083214,Anzaldo; Leesa B,0,7,30,30
1651094391418,MATH 109,B01,083215,Anzaldo; Leesa B,0,8,30,30
1651094391418,MATH 109,B02,083216,Anzaldo; Leesa B,1,8,30,29
1651094397453,MATH 142A,A01,083219,Chow; Bennett,0,15,30,30
1651094397453,MATH 142A,A02,083220,Chow; Bennett,0,15,30,30
1651094397453,MATH 142A,B01,083221,Chow; Bennett,0,16,30,30
1651094397453,MATH 142A,B02,083222,Chow; Bennett,0,15,30,30
1651094403483,MATH 193A,A01,083224,Staff,0,9,30,30
1651094403483,MATH 193A,A02,083225,Staff,1,7,30,29
1651094403483,MATH 193A,A03,083781,Staff,0,7,30,30
1651094403483,MATH 193A,A04,083782,Staff,0,7,30,30
1651094409510,MATH 197,001,091859,McAuley; Julian John,9998,0,9999,1
1651094415570,COGS 9,A01,083615,Staff,0,20,60,60
1651094421593,COGS 11,A01,083617,Boyle; Mary E. T.,13,0,40,27
1651094427621,COGS 13,A01,083071,Staff,0,38,40,40
1651094433645,COGS 14A,A01,092681,Staff,0,40,100,100
1651094439672,COGS 14B,A01,083073,Cheng; Tzu-Han,0,12,50,50
1651094445702,COGS 17,A01,092677,Staff,8,0,75,67
1651094451733,COGS 100,A01,083619,Staff,0,30,60,60
1651094457768,COGS 101A,A01,083621,Davis; Joshua Daniel,0,29,60,60
1651094463791,COGS 101B,A01,091572,Staff,0,8,60,60
1651094469821,COGS 101C,A01,083625,Delgado; Tania,13,0,30,17
1651094475843,COGS 107A,A01,083627,Boyle; Mary E. T.,0,17,60,60
1651094481876,COGS 118A,A01,083075,Staff,0,10,60,60
1651094487905,CSE 3,A50,083646,Miranda; Gregory Joseph,15,0,38,23
1651094487905,CSE 3,A51,083647,Miranda; Gregory Joseph,36,0,37,1
1651094493929,CSE 8A,A50,083650,Miranda; Gregory Joseph,0,31,40,40
1651094499959,CSE 11,A01,083080,Cao; Yingjun,1,98,40,39
1651094505982,CSE 12,A01,083652,Staff,0,28,100,100
1651094512019,CSE 15L,A01,083654,Staff,0,3,50,50
1651094512019,CSE 15L,A02,083655,Staff,0,3,50,50
1651094518046,CSE 20,A01,083657,Staff,46,0,80,34
1651094524081,CSE 30,A01,083084,Eldon; John,0,38,80,80
1651094530116,CSE 100,A01,083659,Cao; Yingjun,0,72,50,50
1651094536152,CSE 134B,A01,083661,Powell; Thomas Allan,0,38,65,65
1651094542175,CSE 140,A01,083663,Staff,0,15,75,75
1651094548199,CSE 140L,A01,083088,Eldon; John,3,0,100,97
1651094554224,CSE 175,A01,083665,Kumar; Rakesh,0,0,25,25
1651094560248,CSE 190,A00,092507,Dubnov; Shlomo,9,0,20,11
1651094566271,ECE 45,A01,083139,Staff,0,7,60,60
1651094572297,ECE 65,A50,083695,Staff,0,7,30,30
1651094578424,ECE 109,A01,091882,Touri; Behrouz,32,0,70,38
1651094584458,ECE 180,A00,083140,Abi Samra; Nicholas Camill,17,0,30,13
1651094584458,ECE 180,B00,083141,Abi Samra; Nicholas Camill,0,0,30,32
1651094590482,MATH 10A,A01,083735,Patchell; Gregory David,0,0,30,30
1651094590482,MATH 10A,A02,083736,Patchell; Gregory David,26,0,30,4
1651094590482,MATH 10A,A03,083737,Patchell; Gregory David,22,0,30,8
1651094596513,MATH 10B,A01,083207,Staff,0,7,30,30
1651094596513,MATH 10B,A02,083208,Staff,0,6,30,30
1651094596513,MATH 10B,B01,083739,Staff,6,0,30,24
1651094596513,MATH 10B,B02,083740,Staff,28,0,30,2
1651094602543,MATH 18,A01,083743,Staff,0,0,30,30
1651094602543,MATH 18,A02,083744,Staff,22,0,30,8
1651094602543,MATH 18,A03,083745,Staff,19,0,30,11
1651094602543,MATH 18,A04,083746,Staff,26,0,30,4
1651094602543,MATH 18,B01,083748,Staff,0,16,30,30
1651094602543,MATH 18,B02,083749,Staff,0,14,30,30
1651094602543,MATH 18,B03,083750,Staff,0,14,30,30
1651094602543,MATH 18,B04,083751,Staff,0,13,30,30
1651094608570,MATH 20A,A01,083754,Staff,18,0,40,22
1651094614593,MATH 20B,A01,083756,Staff,0,14,30,30
1651094614593,MATH 20B,A02,083757,Staff,0,11,30,30
1651094620617,MATH 20C,A01,083760,Staff,0,16,30,30
1651094620617,MATH 20C,A02,083761,Staff,0,15,30,30
1651094620617,MATH 20C,B01,083762,Staff,7,0,30,23
1651094620617,MATH 20C,B02,083763,Staff,27,0,30,3
1651094626644,MATH 20D,A01,083765,Staff,3,1,30,27
1651094626644,MATH 20D,A02,083766,Staff,1,0,30,29
1651094626644,MATH 20D,A03,083767,Staff,22,0,30,8
1651094632680,MATH 20E,A01,083771,Staff,0,0,30,30
1651094632680,MATH 20E,A02,083772,Staff,9,0,30,21
1651094632680,MATH 20E,B01,083773,Staff,5,0,35,30
1651094632680,MATH 20E,B02,083774,Staff,5,1,35,30
1651094638708,MATH 103A,A01,083777,Staff,0,17,30,30
1651094638708,MATH 103A,A02,083778,Staff,0,17,30,30
1651094638708,MATH 103A,B01,083779,Staff,0,15,30,30
1651094638708,MATH 103A,B02,083780,Staff,0,14,30,30
1651094644734,MATH 105,A01,085443,Staff,0,24,30,30
1651094650762,MATH 109,A01,083213,Anzaldo; Leesa B,0,7,30,30
1651094650762,MATH 109,A02,083214,Anzaldo; Leesa B,0,7,30,30
1651094650762,MATH 109,B01,083215,Anzaldo; Leesa B,0,8,30,30
1651094650762,MATH 109,B02,083216,Anzaldo; Leesa B,1,8,30,29
1651094656797,MATH 142A,A01,083219,Chow; Bennett,0,15,30,30
1651094656797,MATH 142A,A02,083220,Chow; Bennett,0,15,30,30
1651094656797,MATH 142A,B01,083221,Chow; Bennett,0,16,30,30
1651094656797,MATH 142A,B02,083222,Chow; Bennett,0,15,30,30
1651094662819,MATH 193A,A01,083224,Staff,0,9,30,30
1651094662819,MATH 193A,A02,083225,Staff,1,7,30,29
1651094662819,MATH 193A,A03,083781,Staff,0,7,30,30
1651094662819,MATH 193A,A04,083782,Staff,0,7,30,30
1651094668842,MATH 197,001,091859,McAuley; Julian John,9998,0,9999,1
1651094674904,COGS 9,A01,083615,Staff,0,20,60,60
1651094680927,COGS 11,A01,083617,Boyle; Mary E. T.,13,0,40,27
1651094686961,COGS 13,A01,083071,Staff,0,38,40,40
1651094692985,COGS 14A,A01,092681,Staff,0,40,100,100
1651094699024,COGS 14B,A01,083073,Cheng; Tzu-Han,0,12,50,50
1651094705052,COGS 17,A01,092677,Staff,8,0,75,67
1651094711078,COGS 100,A01,083619,Staff,0,30,60,60
1651094717104,COGS 101A,A01,083621,Davis; Joshua Daniel,0,29,60,60
1651094723134,COGS 101B,A01,091572,Staff,0,8,60,60
1651094729166,COGS 101C,A01,083625,Delgado; Tania,13,0,30,17
1651094735196,COGS 107A,A01,083627,Boyle; Mary E. T.,0,17,60,60
1651094741224,COGS 118A,A01,083075,Staff,0,10,60,60
1651094747248,CSE 3,A50,083646,Miranda; Gregory Joseph,15,0,38,23
1651094747248,CSE 3,A51,083647,Miranda; Gregory Joseph,36,0,37,1
1651094753270,CSE 8A,A50,083650,Miranda; Gregory Joseph,0,31,40,40
1651094759294,CSE 11,A01,083080,Cao; Yingjun,1,98,40,39
1651094765325,CSE 12,A01,083652,Staff,0,28,100,100
1651094771362,CSE 15L,A01,083654,Staff,0,3,50,50
1651094771362,CSE 15L,A02,083655,Staff,0,3,50,50
1651094777386,CSE 20,A01,083657,Staff,46,0,80,34
1651094783416,CSE 30,A01,083084,Eldon; John,0,38,80,80
1651094789442,CSE 100,A01,083659,Cao; Yingjun,0,72,50,50
1651094795479,CSE 134B,A01,083661,Powell; Thomas Allan,0,38,65,65
1651094801501,CSE 140,A01,083663,Staff,0,15,75,75
1651094807525,CSE 140L,A01,083088,Eldon; John,3,0,100,97
1651094813547,CSE 175,A01,083665,Kumar; Rakesh,0,0,25,25
1651094819583,CSE 190,A00,092507,Dubnov; Shlomo,9,0,20,11
1651094825606,ECE 45,A01,083139,Staff,0,7,60,60
1651094831631,ECE 65,A50,083695,Staff,0,7,30,30
1651094837663,ECE 109,A01,091882,Touri; Behrouz,32,0,70,38
1651094843691,ECE 180,A00,083140,Abi Samra; Nicholas Camill,17,0,30,13
1651094843691,ECE 180,B00,083141,Abi Samra; Nicholas Camill,0,0,30,32
1651094849714,MATH 10A,A01,083735,Patchell; Gregory David,0,0,30,30
1651094849714,MATH 10A,A02,083736,Patchell; Gregory David,26,0,30,4
1651094849714,MATH 10A,A03,083737,Patchell; Gregory David,22,0,30,8
1651094855737,MATH 10B,A01,083207,Staff,0,7,30,30
1651094855737,MATH 10B,A02,083208,Staff,0,6,30,30
1651094855737,MATH 10B,B01,083739,Staff,6,0,30,24
1651094855737,MATH 10B,B02,083740,Staff,28,0,30,2
1651094861761,MATH 18,A01,083743,Staff,0,0,30,30
1651094861761,MATH 18,A02,083744,Staff,22,0,30,8
1651094861761,MATH 18,A03,083745,Staff,19,0,30,11
1651094861761,MATH 18,A04,083746,Staff,26,0,30,4
1651094861761,MATH 18,B01,083748,Staff,0,16,30,30
1651094861761,MATH 18,B02,083749,Staff,0,14,30,30
1651094861761,MATH 18,B03,083750,Staff,0,14,30,30
1651094861761,MATH 18,B04,083751,Staff,0,13,30,30
1651094867784,MATH 20A,A01,083754,Staff,18,0,40,22
1651094873807,MATH 20B,A01,083756,Staff,0,14,30,30
1651094873807,MATH 20B,A02,083757,Staff,0,11,30,30
1651094879831,MATH 20C,A01,083760,Staff,0,16,30,30
1651094879831,MATH 20C,A02,083761,Staff,0,15,30,30
1651094879831,MATH 20C,B01,083762,Staff,7,0,30,23
1651094879831,MATH 20C,B02,083763,Staff,27,0,30,3
1651094885854,MATH 20D,A01,083765,Staff,3,1,30,27
1651094885854,MATH 20D,A02,083766,Staff,1,0,30,29
1651094885854,MATH 20D,A03,083767,Staff,22,0,30,8
1651094891878,MATH 20E,A01,083771,Staff,0,0,30,30
1651094891878,MATH 20E,A02,083772,Staff,9,0,30,21
1651094891878,MATH 20E,B01,083773,Staff,5,0,35,30
1651094891878,MATH 20E,B02,083774,Staff,5,1,35,30
1651094897908,MATH 103A,A01,083777,Staff,0,17,30,30
1651094897908,MATH 103A,A02,083778,Staff,0,17,30,30
1651094897908,MATH 103A,B01,083779,Staff,0,15,30,30
1651094897908,MATH 103A,B02,083780,Staff,0,14,30,30
1651094903935,MATH 105,A01,085443,Staff,0,24,30,30
1651094909958,MATH 109,A01,083213,Anzaldo; Leesa B,0,7,30,30
1651094909958,MATH 109,A02,083214,Anzaldo; Leesa B,0,7,30,30
1651094909958,MATH 109,B01,083215,Anzaldo; Leesa B,0,8,30,30
1651094909958,MATH 109,B02,083216,Anzaldo; Leesa B,1,8,30,29
1651094916000,MATH 142A,A01,083219,Chow; Bennett,0,15,30,30
1651094916000,MATH 142A,A02,083220,Chow; Bennett,0,15,30,30
1651094916000,MATH 142A,B01,083221,Chow; Bennett,0,16,30,30
1651094916000,MATH 142A,B02,083222,Chow; Bennett,0,15,30,30
1651094922023,MATH 193A,A01,083224,Staff,0,9,30,30
1651094922023,MATH 193A,A02,083225,Staff,1,7,30,29
1651094922023,MATH 193A,A03,083781,Staff,0,7,30,30
1651094922023,MATH 193A,A04,083782,Staff,0,7,30,30
1651094928052,MATH 197,001,091859,McAuley; Julian John,9998,0,9999,1
1651094934100,COGS 9,A01,083615,Staff,0,20,60,60
1651094940126,COGS 11,A01,083617,Boyle; Mary E. T.,13,0,40,27
1651094946162,COGS 13,A01,083071,Staff,0,38,40,40
1651094954563,COGS 14A,A01,092681,Staff,0,40,100,100
1651094960588,COGS 14B,A01,083073,Cheng; Tzu-Han,0,12,50,50
1651094966615,COGS 17,A01,092677,Staff,8,0,75,67
1651094972644,COGS 100,A01,083619,Staff,0,30,60,60
1651094978667,COGS 101A,A01,083621,Davis; Joshua Daniel,0,29,60,60
1651094984693,COGS 101B,A01,091572,Staff,0,8,60,60
1651094990716,COGS 101C,A01,083625,Delgado; Tania,13,0,30,17
1651094996744,COGS 107A,A01,083627,Boyle; Mary E. T.,0,17,60,60
1651095002768,COGS 118A,A01,083075,Staff,0,10,60,60
1651095008798,CSE 3,A50,083646,Miranda; Gregory Joseph,15,0,38,23
1651095008798,CSE 3,A51,083647,Miranda; Gregory Joseph,36,0,37,1
1651095014825,CSE 8A,A50,083650,Miranda; Gregory Joseph,0,31,40,40
1651095020857,CSE 11,A01,083080,Cao; Yingjun,1,98,40,39
1651095026881,CSE 12,A01,083652,Staff,0,28,100,100
1651095032904,CSE 15L,A01,083654,Staff,0,3,50,50
1651095032904,CSE 15L,A02,083655,Staff,0,3,50,50
1651095038930,CSE 20,A01,083657,Staff,46,0,80,34
1651095044954,CSE 30,A01,083084,Eldon; John,0,38,80,80
1651095050988,CSE 100,A01,083659,Cao; Yingjun,0,72,50,50
1651095057013,CSE 134B,A01,083661,Powell; Thomas Allan,0,38,65,65
1651095063036,CSE 140,A01,083663,Staff,0,15,75,75
1651095069062,CSE 140L,A01,083088,Eldon; John,3,0,100,97
1651095075088,CSE 175,A01,083665,Kumar; Rakesh,0,0,25,25
1651095081118,CSE 190,A00,092507,Dubnov; Shlomo,9,0,20,11
1651095087141,ECE 45,A01,083139,Staff,0,7,60,60
1651095093164,ECE 65,A50,083695,Staff,0,7,30,30
1651095099194,ECE 109,A01,091882,Touri; Behrouz,32,0,70,38
1651095105223,ECE 180,A00,083140,Abi Samra; Nicholas Camill,17,0,30,13
1651095105223,ECE 180,B00,083141,Abi Samra; Nicholas Camill,0,0,30,32
1651095111246,MATH 10A,A01,083735,Patchell; Gregory David,0,0,30,30
1651095111246,MATH 10A,A02,083736,Patchell; Gregory David,26,0,30,4
1651095111246,MATH 10A,A03,083737,Patchell; Gregory David,22,0,30,8
1651095117271,MATH 10B,A01,083207,Staff,0,7,30,30
1651095117271,MATH 10B,A02,083208,Staff,0,6,30,30
1651095117271,MATH 10B,B01,083739,Staff,6,0,30,24
1651095117271,MATH 10B,B02,083740,Staff,28,0,30,2
1651095123301,MATH 18,A01,083743,Staff,0,0,30,30
1651095123301,MATH 18,A02,083744,Staff,22,0,30,8
1651095123301,MATH 18,A03,083745,Staff,19,0,30,11
1651095123301,MATH 18,A04,083746,Staff,26,0,30,4
1651095123301,MATH 18,B01,083748,Staff,0,16,30,30
1651095123301,MATH 18,B02,083749,Staff,0,14,30,30
1651095123301,MATH 18,B03,083750,Staff,0,14,30,30
1651095123301,MATH 18,B04,083751,Staff,0,13,30,30
1651095129325,MATH 20A,A01,083754,Staff,18,0,40,22
1651095135348,MATH 20B,A01,083756,Staff,0,14,30,30
1651095135348,MATH 20B,A02,083757,Staff,0,11,30,30
1651095141379,MATH 20C,A01,083760,Staff,0,16,30,30
1651095141379,MATH 20C,A02,083761,Staff,0,15,30,30
1651095141379,MATH 20C,B01,083762,Staff,7,0,30,23
1651095141379,MATH 20C,B02,083763,Staff,27,0,30,3
1651095147411,MATH 20D,A01,083765,Staff,3,1,30,27
1651095147411,MATH 20D,A02,083766,Staff,1,0,30,29
1651095147411,MATH 20D,A03,083767,Staff,22,0,30,8
1651095153439,MATH 20E,A01,083771,Staff,0,0,30,30
1651095153439,MATH 20E,A02,083772,Staff,9,0,30,21
1651095153439,MATH 20E,B01,083773,Staff,5,0,35,30
1651095153439,MATH 20E,B02,083774,Staff,5,1,35,30
1651095159467,MATH 103A,A01,083777,Staff,0,17,30,30
1651095159467,MATH 103A,A02,083778,Staff,0,17,30,30
1651095159467,MATH 103A,B01,083779,Staff,0,15,30,30
1651095159467,MATH 103A,B02,083780,Staff,0,14,30,30
1651095165490,MATH 105,A01,085443,Staff,0,24,30,30
1651095171532,MATH 109,A01,083213,Anzaldo; Leesa B,0,7,30,30
1651095171532,MATH 109,A02,083214,Anzaldo; Leesa B,0,7,30,30
1651095171532,MATH 109,B01,083215,Anzaldo; Leesa B,0,8,30,30
1651095171532,MATH 109,B02,083216,Anzaldo; Leesa B,1,8,30,29
1651095177661,MATH 142A,A01,083219,Chow; Bennett,0,15,30,30
1651095177661,MATH 142A,A02,083220,Chow; Bennett,0,15,30,30
1651095177661,MATH 142A,B01,083221,Chow; Bennett,0,16,30,30
1651095177661,MATH 142A,B02,083222,Chow; Bennett,0,15,30,30
1651095183687,MATH 193A,A01,083224,Staff,0,9,30,30
1651095183687,MATH 193A,A02,083225,Staff,1,7,30,29
1651095183687,MATH 193A,A03,083781,Staff,0,7,30,30
1651095183687,MATH 193A,A04,083782,Staff,0,7,30,30
1651095189712,MATH 197,001,091859,McAuley; Julian John,9998,0,9999,1
1651095195775,COGS 9,A01,083615,Staff,0,20,60,60
1651095201801,COGS 11,A01,083617,Boyle; Mary E. T.,13,0,40,27
1651095207840,COGS 13,A01,083071,Staff,0,38,40,40
1651095213865,COGS 14A,A01,092681,Staff,0,40,100,100
1651095219892,COGS 14B,A01,083073,Cheng; Tzu-Han,0,12,50,50
1651095225916,COGS 17,A01,092677,Staff,8,0,75,67
1651095231937,COGS 100,A01,083619,Staff,0,30,60,60
1651095237960,COGS 101A,A01,083621,Davis; Joshua Daniel,0,29,60,60
1651095243984,COGS 101B,A01,091572,Staff,0,8,60,60
1651095250007,COGS 101C,A01,083625,Delgado; Tania,13,0,30,17
1651095256031,COGS 107A,A01,083627,Boyle; Mary E. T.,0,17,60,60
1651095262061,COGS 118A,A01,083075,Staff,0,10,60,60
1651095268086,CSE 3,A50,083646,Miranda; Gregory Joseph,15,0,38,23
1651095268086,CSE 3,A51,083647,Miranda; Gregory Joseph,36,0,37,1
1651095274110,CSE 8A,A50,083650,Miranda; Gregory Joseph,0,31,40,40
1651095280136,CSE 11,A01,083080,Cao; Yingjun,1,98,40,39
1651095286161,CSE 12,A01,083652,Staff,0,28,100,100
1651095292185,CSE 15L,A01,083654,Staff,0,3,50,50
1651095292185,CSE 15L,A02,083655,Staff,0,3,50,50
1651095298207,CSE 20,A01,083657,Staff,46,0,80,34
1651095304229,CSE 30,A01,083084,Eldon; John,0,38,80,80
1651095310258,CSE 100,A01,083659,Cao; Yingjun,0,72,50,50
1651095316284,CSE 134B,A01,083661,Powell; Thomas Allan,0,38,65,65
1651095322315,CSE 140,A01,083663,Staff,0,15,75,75
1651095328341,CSE 140L,A01,083088,Eldon; John,3,0,100,97
1651095334365,CSE 175,A01,083665,Kumar; Rakesh,0,0,25,25
1651095340387,CSE 190,A00,092507,Dubnov; Shlomo,9,0,20,11
1651095346417,ECE 45,A01,083139,Staff,0,7,60,60
1651095352441,ECE 65,A50,083695,Staff,0,7,30,30
1651095358476,ECE 109,A01,091882,Touri; Behrouz,32,0,70,38
1651095364500,ECE 180,A00,083140,Abi Samra; Nicholas Camill,17,0,30,13
1651095364500,ECE 180,B00,083141,Abi Samra; Nicholas Camill,0,0,30,32
1651095370528,MATH 10A,A01,083735,Patchell; Gregory David,0,0,30,30
1651095370528,MATH 10A,A02,083736,Patchell; Gregory David,26,0,30,4
1651095370528,MATH 10A,A03,083737,Patchell; Gregory David,22,0,30,8
1651095376556,MATH 10B,A01,083207,Staff,0,7,30,30
1651095376556,MATH 10B,A02,083208,Staff,0,6,30,30
1651095376556,MATH 10B,B01,083739,Staff,6,0,30,24
1651095376556,MATH 10B,B02,083740,Staff,28,0,30,2
1651095382579,MATH 18,A01,083743,Staff,0,0,30,30
1651095382579,MATH 18,A02,083744,Staff,22,0,30,8
1651095382579,MATH 18,A03,083745,Staff,19,0,30,11
1651095382579,MATH 18,A04,083746,Staff,26,0,30,4
1651095382579,MATH 18,B01,083748,Staff,0,16,30,30
1651095382579,MATH 18,B02,083749,Staff,0,14,30,30
1651095382579,MATH 18,B03,083750,Staff,0,14,30,30
1651095382579,MATH 18,B04,083751,Staff,0,13,30,30
1651095388606,MATH 20A,A01,083754,Staff,18,0,40,22
1651095394634,MATH 20B,A01,083756,Staff,0,14,30,30
1651095394634,MATH 20B,A02,083757,Staff,0,11,30,30
1651095400660,MATH 20C,A01,083760,Staff,0,16,30,30
1651095400660,MATH 20C,A02,083761,Staff,0,15,30,30
1651095400660,MATH 20C,B01,083762,Staff,7,0,30,23
1651095400660,MATH 20C,B02,083763,Staff,27,0,30,3
1651095406683,MATH 20D,A01,083765,Staff,3,1,30,27
1651095406683,MATH 20D,A02,083766,Staff,1,0,30,29
1651095406683,MATH 20D,A03,083767,Staff,22,0,30,8
1651095412707,MATH 20E,A01,083771,Staff,0,0,30,30
1651095412707,MATH 20E,A02,083772,Staff,9,0,30,21
1651095412707,MATH 20E,B01,083773,Staff,5,0,35,30
1651095412707,MATH 20E,B02,083774,Staff,5,1,35,30
1651095418732,MATH 103A,A01,083777,Staff,0,17,30,30
1651095418732,MATH 103A,A02,083778,Staff,0,17,30,30
1651095418732,MATH 103A,B01,083779,Staff,0,15,30,30
1651095418732,MATH 103A,B02,083780,Staff,0,14,30,30
1651095424771,MATH 105,A01,085443,Staff,0,24,30,30
1651095430795,MATH 109,A01,083213,Anzaldo; Leesa B,0,7,30,30
1651095430795,MATH 109,A02,083214,Anzaldo; Leesa B,0,7,30,30
1651095430795,MATH 109,B01,083215,Anzaldo; Leesa B,0,8,30,30
1651095430795,MATH 109,B02,083216,Anzaldo; Leesa B,1,8,30,29
1651095436819,MATH 142A,A01,083219,Chow; Bennett,0,15,30,30
1651095436819,MATH 142A,A02,083220,Chow; Bennett,0,15,30,30
1651095436819,MATH 142A,B01,083221,Chow; Bennett,0,16,30,30
1651095436819,MATH 142A,B02,083222,Chow; Bennett,0,15,30,30
1651095442845,MATH 193A,A01,083224,Staff,0,9,30,30
1651095442845,MATH 193A,A02,083225,Staff,1,7,30,29
1651095442845,MATH 193A,A03,083781,Staff,0,7,30,30
1651095442845,MATH 193A,A04,083782,Staff,0,7,30,30
1651095448868,MATH 197,001,091859,McAuley; Julian John,9998,0,9999,1
1651095454928,COGS 9,A01,083615,Staff,0,20,60,60
1651095460962,COGS 11,A01,083617,Boyle; Mary E. T.,13,0,40,27
1651095466988,COGS 13,A01,083071,Staff,0,38,40,40
1651095473014,COGS 14A,A01,092681,Staff,0,40,100,100
1651095479045,COGS 14B,A01,083073,Cheng; Tzu-Han,0,12,50,50
1651095485069,COGS 17,A01,092677,Staff,8,0,75,67
1651095491093,COGS 100,A01,083619,Staff,0,30,60,60
1651095497116,COGS 101A,A01,083621,Davis; Joshua Daniel,0,29,60,60
1651095503141,COGS 101B,A01,091572,Staff,0,8,60,60
1651095509164,COGS 101C,A01,083625,Delgado; Tania,13,0,30,17
1651095515198,COGS 107A,A01,083627,Boyle; Mary E. T.,0,17,60,60
1651095521223,COGS 118A,A01,083075,Staff,0,10,60,60
1651095527246,CSE 3,A50,083646,Miranda; Gregory Joseph,15,0,38,23
1651095527246,CSE 3,A51,083647,Miranda; Gregory Joseph,36,0,37,1
1651095533270,CSE 8A,A50,083650,Miranda; Gregory Joseph,0,31,40,40
1651095539294,CSE 11,A01,083080,Cao; Yingjun,1,98,40,39
1651095545323,CSE 12,A01,083652,Staff,0,28,100,100
1651095551346,CSE 15L,A01,083654,Staff,0,3,50,50
1651095551346,CSE 15L,A02,083655,Staff,0,3,50,50
1651095557378,CSE 20,A01,083657,Staff,46,0,80,34
1651095563400,CSE 30,A01,083084,Eldon; John,0,38,80,80
1651095569424,CSE 100,A01,083659,Cao; Yingjun,0,72,50,50
1651095575451,CSE 134B,A01,083661,Powell; Thomas Allan,0,38,65,65
1651095581479,CSE 140,A01,083663,Staff,0,15,75,75
1651095587505,CSE 140L,A01,083088,Eldon; John,3,0,100,97
1651095593526,CSE 175,A01,083665,Kumar; Rakesh,0,0,25,25
1651095599551,CSE 190,A00,092507,Dubnov; Shlomo,9,0,20,11
1651095605573,ECE 45,A01,083139,Staff,0,7,60,60
1651095611614,ECE 65,A50,083695,Staff,0,7,30,30
1651095617640,ECE 109,A01,091882,Touri; Behrouz,32,0,70,38
1651095623661,ECE 180,A00,083140,Abi Samra; Nicholas Camill,17,0,30,13
1651095623661,ECE 180,B00,083141,Abi Samra; Nicholas Camill,0,0,30,32
1651095629688,MATH 10A,A01,083735,Patchell; Gregory David,0,0,30,30
1651095629688,MATH 10A,A02,083736,Patchell; Gregory David,26,0,30,4
1651095629688,MATH 10A,A03,083737,Patchell; Gregory David,22,0,30,8
1651095635715,MATH 10B,A01,083207,Staff,0,7,30,30
1651095635715,MATH 10B,A02,083208,Staff,0,6,30,30
1651095635715,MATH 10B,B01,083739,Staff,6,0,30,24
1651095635715,MATH 10B,B02,083740,Staff,28,0,30,2
1651095641746,MATH 18,A01,083743,Staff,0,0,30,30
1651095641746,MATH 18,A02,083744,Staff,22,0,30,8
1651095641746,MATH 18,A03,083745,Staff,19,0,30,11
1651095641746,MATH 18,A04,083746,Staff,26,0,30,4
1651095641746,MATH 18,B01,083748,Staff,0,16,30,30
1651095641746,MATH 18,B02,083749,Staff,0,14,30,30
1651095641746,MATH 18,B03,083750,Staff,0,14,30,30
1651095641746,MATH 18,B04,083751,Staff,0,13,30,30
1651095647770,MATH 20A,A01,083754,Staff,18,0,40,22
1651095653798,MATH 20B,A01,083756,Staff,0,14,30,30
1651095653798,MATH 20B,A02,083757,Staff,0,11,30,30
1651095659821,MATH 20C,A01,083760,Staff,0,16,30,30
1651095659821,MATH 20C,A02,083761,Staff,0,15,30,30
1651095659821,MATH 20C,B01,083762,Staff,7,0,30,23
1651095659821,MATH 20C,B02,083763,Staff,27,0,30,3
1651095665845,MATH 20D,A01,083765,Staff,3,1,30,27
1651095665845,MATH 20D,A02,083766,Staff,1,0,30,29
1651095665845,MATH 20D,A03,083767,Staff,22,0,30,8
1651095671885,MATH 20E,A01,083771,Staff,0,0,30,30
1651095671885,MATH 20E,A02,083772,Staff,9,0,30,21
1651095671885,MATH 20E,B01,083773,Staff,5,0,35,30
1651095671885,MATH 20E,B02,083774,Staff,5,1,35,30
1651095677916,MATH 103A,A01,083777,Staff,0,17,30,30
1651095677916,MATH 103A,A02,083778,Staff,0,17,30,30
1651095677916,MATH 103A,B01,083779,Staff,0,15,30,30
1651095677916,MATH 103A,B02,083780,Staff,0,14,30,30
1651095683939,MATH 105,A01,085443,Staff,0,24,30,30
1651095689964,MATH 109,A01,083213,Anzaldo; Leesa B,0,7,30,30
1651095689964,MATH 109,A02,083214,Anzaldo; Leesa B,0,7,30,30
1651095689964,MATH 109,B01,083215,Anzaldo; Leesa B,0,8,30,30
1651095689964,MATH 109,B02,083216,Anzaldo; Leesa B,1,8,30,29
1651095695996,MATH 142A,A01,083219,Chow; Bennett,0,15,30,30
1651095695996,MATH 142A,A02,083220,Chow; Bennett,0,15,30,30
1651095695996,MATH 142A,B01,083221,Chow; Bennett,0,16,30,30
1651095695996,MATH 142A,B02,083222,Chow; Bennett,0,15,30,30
1651095702028,MATH 193A,A01,083224,Staff,0,9,30,30
1651095702028,MATH 193A,A02,083225,Staff,1,7,30,29
1651095702028,MATH 193A,A03,083781,Staff,0,7,30,30
1651095702028,MATH 193A,A04,083782,Staff,0,7,30,30
1651095708054,MATH 197,001,091859,McAuley; Julian John,9998,0,9999,1
1651095714111,COGS 9,A01,083615,Staff,0,20,60,60
1651095720138,COGS 11,A01,083617,Boyle; Mary E. T.,13,0,40,27
1651095726172,COGS 13,A01,083071,Staff,0,38,40,40
1651095732201,COGS 14A,A01,092681,Staff,0,40,100,100
1651095738229,COGS 14B,A01,083073,Cheng; Tzu-Han,0,12,50,50
1651095744253,COGS 17,A01,092677,Staff,8,0,75,67
1651095750278,COGS 100,A01,083619,Staff,0,30,60,60
1651095756312,COGS 101A,A01,083621,Davis; Joshua Daniel,0,29,60,60
1651095762341,COGS 101B,A01,091572,Staff,0,8,60,60
1651095768454,COGS 101C,A01,083625,Delgado; Tania,13,0,30,17
1651095774480,COGS 107A,A01,083627,Boyle; Mary E. T.,0,17,60,60
1651095780506,COGS 118A,A01,083075,Staff,0,10,60,60
1651095786554,CSE 3,A50,083646,Miranda; Gregory Joseph,15,0,38,23
1651095786554,CSE 3,A51,083647,Miranda; Gregory Joseph,36,0,37,1
1651095792583,CSE 8A,A50,083650,Miranda; Gregory Joseph,0,31,40,40
1651095798605,CSE 11,A01,083080,Cao; Yingjun,1,98,40,39
1651095804632,CSE 12,A01,083652,Staff,0,28,100,100
1651095810656,CSE 15L,A01,083654,Staff,0,3,50,50
1651095810656,CSE 15L,A02,083655,Staff,0,3,50,50
1651095816684,CSE 20,A01,083657,Staff,46,0,80,34
1651095822709,CSE 30,A01,083084,Eldon; John,0,38,80,80
1651095828731,CSE 100,A01,083659,Cao; Yingjun,0,72,50,50
1651095834753,CSE 134B,A01,083661,Powell; Thomas Allan,0,38,65,65
1651095840780,CSE 140,A01,083663,Staff,0,15,75,75
1651095846803,CSE 140L,A01,083088,Eldon; John,3,0,100,97
1651095852828,CSE 175,A01,083665,Kumar; Rakesh,0,0,25,25
1651095858858,CSE 190,A00,092507,Dubnov; Shlomo,9,0,20,11
1651095864882,ECE 45,A01,083139,Staff,0,7,60,60
1651095870908,ECE 65,A50,083695,Staff,0,7,30,30
1651095876939,ECE 109,A01,091882,Touri; Behrouz,32,0,70,38
1651095882963,ECE 180,A00,083140,Abi Samra; Nicholas Camill,17,0,30,13
1651095882963,ECE 180,B00,083141,Abi Samra; Nicholas Camill,0,1,30,32
1651095888989,MATH 10A,A01,083735,Patchell; Gregory David,0,0,30,30
1651095888989,MATH 10A,A02,083736,Patchell; Gregory David,26,0,30,4
1651095888989,MATH 10A,A03,083737,Patchell; Gregory David,22,0,30,8
1651095895015,MATH 10B,A01,083207,Staff,0,7,30,30
1651095895015,MATH 10B,A02,083208,Staff,0,6,30,30
1651095895015,MATH 10B,B01,083739,Staff,6,0,30,24
1651095895015,MATH 10B,B02,083740,Staff,28,0,30,2
1651095901054,MATH 18,A01,083743,Staff,0,0,30,30
1651095901054,MATH 18,A02,083744,Staff,22,0,30,8
1651095901054,MATH 18,A03,083745,Staff,19,0,30,11
1651095901054,MATH 18,A04,083746,Staff,26,0,30,4
1651095901054,MATH 18,B01,083748,Staff,0,16,30,30
1651095901054,MATH 18,B02,083749,Staff,0,14,30,30
1651095901054,MATH 18,B03,083750,Staff,0,14,30,30
1651095901054,MATH 18,B04,083751,Staff,0,14,30,30
1651095907076,MATH 20A,A01,083754,Staff,18,0,40,22
1651095913101,MATH 20B,A01,083756,Staff,0,14,30,30
1651095913101,MATH 20B,A02,083757,Staff,0,11,30,30
1651095919124,MATH 20C,A01,083760,Staff,0,16,30,30
1651095919124,MATH 20C,A02,083761,Staff,0,15,30,30
1651095919124,MATH 20C,B01,083762,Staff,7,0,30,23
1651095919124,MATH 20C,B02,083763,Staff,27,0,30,3
1651095925162,MATH 20D,A01,083765,Staff,3,1,30,27
1651095925162,MATH 20D,A02,083766,Staff,1,0,30,29
1651095925162,MATH 20D,A03,083767,Staff,22,0,30,8
1651095931191,MATH 20E,A01,083771,Staff,0,0,30,30
1651095931191,MATH 20E,A02,083772,Staff,9,0,30,21
1651095931191,MATH 20E,B01,083773,Staff,5,0,35,30
1651095931191,MATH 20E,B02,083774,Staff,5,1,35,30
1651095937225,MATH 103A,A01,083777,Staff,0,17,30,30
1651095937225,MATH 103A,A02,083778,Staff,0,17,30,30
1651095937225,MATH 103A,B01,083779,Staff,0,15,30,30
1651095937225,MATH 103A,B02,083780,Staff,0,14,30,30
1651095943258,MATH 105,A01,085443,Staff,0,24,30,30
1651095949285,MATH 109,A01,083213,Anzaldo; Leesa B,0,7,30,30
1651095949285,MATH 109,A02,083214,Anzaldo; Leesa B,0,7,30,30
1651095949285,MATH 109,B01,083215,Anzaldo; Leesa B,0,8,30,30
1651095949285,MATH 109,B02,083216,Anzaldo; Leesa B,1,8,30,29
1651095955313,MATH 142A,A01,083219,Chow; Bennett,0,15,30,30
1651095955313,MATH 142A,A02,083220,Chow; Bennett,0,15,30,30
1651095955313,MATH 142A,B01,083221,Chow; Bennett,0,16,30,30
1651095955313,MATH 142A,B02,083222,Chow; Bennett,0,15,30,30
1651095961341,MATH 193A,A01,083224,Staff,0,9,30,30
1651095961341,MATH 193A,A02,083225,Staff,1,7,30,29
1651095961341,MATH 193A,A03,083781,Staff,0,7,30,30
1651095961341,MATH 193A,A04,083782,Staff,0,7,30,30
1651095967382,MATH 197,001,091859,McAuley; Julian John,9998,0,9999,1
1651095973432,COGS 9,A01,083615,Staff,0,20,60,60
1651095979455,COGS 11,A01,083617,Boyle; Mary E. T.,13,0,40,27
1651095985478,COGS 13,A01,083071,Staff,0,38,40,40
1651095991499,COGS 14A,A01,092681,Staff,0,40,100,100
1651095997535,COGS 14B,A01,083073,Cheng; Tzu-Han,0,12,50,50
1651096003560,COGS 17,A01,092677,Staff,8,0,75,67
1651096009589,COGS 100,A01,083619,Staff,0,30,60,60
1651096015613,COGS 101A,A01,083621,Davis; Joshua Daniel,0,29,60,60
1651096027378,COGS 101B,A01,091572,Staff,0,8,60,60
1651096033404,COGS 101C,A01,083625,Delgado; Tania,13,0,30,17
1651096039434,COGS 107A,A01,083627,Boyle; Mary E. T.,0,17,60,60
1651096045472,COGS 118A,A01,083075,Staff,0,10,60,60
1651096051496,CSE 3,A50,083646,Miranda; Gregory Joseph,15,0,38,23
1651096051496,CSE 3,A51,083647,Miranda; Gregory Joseph,36,0,37,1
1651096057520,CSE 8A,A50,083650,Miranda; Gregory Joseph,0,31,40,40
1651096063543,CSE 11,A01,083080,Cao; Yingjun,1,98,40,39
1651096069565,CSE 12,A01,083652,Staff,0,28,100,100
1651096075593,CSE 15L,A01,083654,Staff,0,3,50,50
1651096075593,CSE 15L,A02,083655,Staff,0,3,50,50
1651096081620,CSE 20,A01,083657,Staff,46,0,80,34
1651096087644,CSE 30,A01,083084,Eldon; John,0,38,80,80
1651096093667,CSE 100,A01,083659,Cao; Yingjun,0,72,50,50
1651096099697,CSE 134B,A01,083661,Powell; Thomas Allan,0,38,65,65
1651096105722,CSE 140,A01,083663,Staff,0,15,75,75
1651096111749,CSE 140L,A01,083088,Eldon; John,3,0,100,97
1651096117774,CSE 175,A01,083665,Kumar; Rakesh,0,0,25,25
1651096123801,CSE 190,A00,092507,Dubnov; Shlomo,9,0,20,11
1651096129837,ECE 45,A01,083139,Staff,0,7,60,60
1651096135862,ECE 65,A50,083695,Staff,0,7,30,30
1651096141886,ECE 109,A01,091882,Touri; Behrouz,32,0,70,38
1651096147910,ECE 180,A00,083140,Abi Samra; Nicholas Camill,17,0,30,13
1651096147910,ECE 180,B00,083141,Abi Samra; Nicholas Camill,0,1,30,32
1651096153933,MATH 10A,A01,083735,Patchell; Gregory David,0,0,30,30
1651096153933,MATH 10A,A02,083736,Patchell; Gregory David,26,0,30,4
1651096153933,MATH 10A,A03,083737,Patchell; Gregory David,22,0,30,8
1651096159960,MATH 10B,A01,083207,Staff,0,7,30,30
1651096159960,MATH 10B,A02,083208,Staff,0,6,30,30
1651096159960,MATH 10B,B01,083739,Staff,6,0,30,24
1651096159960,MATH 10B,B02,083740,Staff,28,0,30,2
1651096165992,MATH 18,A01,083743,Staff,0,0,30,30
1651096165992,MATH 18,A02,083744,Staff,22,0,30,8
1651096165992,MATH 18,A03,083745,Staff,19,0,30,11
1651096165992,MATH 18,A04,083746,Staff,26,0,30,4
1651096165992,MATH 18,B01,083748,Staff,0,16,30,30
1651096165992,MATH 18,B02,083749,Staff,0,14,30,30
1651096165992,MATH 18,B03,083750,Staff,0,14,30,30
1651096165992,MATH 18,B04,083751,Staff,0,14,30,30
1651096172021,MATH 20A,A01,083754,Staff,18,0,40,22
1651096178044,MATH 20B,A01,083756,Staff,0,14,30,30
1651096178044,MATH 20B,A02,083757,Staff,0,11,30,30
1651096184079,MATH 20C,A01,083760,Staff,0,16,30,30
1651096184079,MATH 20C,A02,083761,Staff,0,15,30,30
1651096184079,MATH 20C,B01,083762,Staff,7,0,30,23
1651096184079,MATH 20C,B02,083763,Staff,27,0,30,3
1651096190103,MATH 20D,A01,083765,Staff,3,1,30,27
1651096190103,MATH 20D,A02,083766,Staff,1,0,30,29
1651096190103,MATH 20D,A03,083767,Staff,22,0,30,8
1651096196127,MATH 20E,A01,083771,Staff,0,0,30,30
1651096196127,MATH 20E,A02,083772,Staff,9,0,30,21
1651096196127,MATH 20E,B01,083773,Staff,5,0,35,30
1651096196127,MATH 20E,B02,083774,Staff,5,1,35,30
1651096202156,MATH 103A,A01,083777,Staff,0,17,30,30
1651096202156,MATH 103A,A02,083778,Staff,0,17,30,30
1651096202156,MATH 103A,B01,083779,Staff,0,15,30,30
1651096202156,MATH 103A,B02,083780,Staff,0,14,30,30
1651096208180,MATH 105,A01,085443,Staff,0,24,30,30
1651096214208,MATH 109,A01,083213,Anzaldo; Leesa B,0,7,30,30
1651096214208,MATH 109,A02,083214,Anzaldo; Leesa B,0,7,30,30
1651096214208,MATH 109,B01,083215,Anzaldo; Leesa B,0,8,30,30
1651096214208,MATH 109,B02,083216,Anzaldo; Leesa B,1,8,30,29
1651096220232,MATH 142A,A01,083219,Chow; Bennett,0,15,30,30
1651096220232,MATH 142A,A02,083220,Chow; Bennett,0,15,30,30
1651096220232,MATH 142A,B01,083221,Chow; Bennett,0,16,30,30
1651096220232,MATH 142A,B02,083222,Chow; Bennett,0,15,30,30
1651096226260,MATH 193A,A01,083224,Staff,0,9,30,30
1651096226260,MATH 193A,A02,083225,Staff,1,7,30,29
1651096226260,MATH 193A,A03,083781,Staff,0,7,30,30
1651096226260,MATH 193A,A04,083782,Staff,0,7,30,30
1651096232286,MATH 197,001,091859,McAuley; Julian John,9998,0,9999,1
1651096238340,COGS 9,A01,083615,Staff,0,20,60,60
1651096244375,COGS 11,A01,083617,Boyle; Mary E. T.,13,0,40,27
1651096250397,COGS 13,A01,083071,Staff,0,38,40,40
1651096256423,COGS 14A,A01,092681,Staff,0,40,100,100
1651096262453,COGS 14B,A01,083073,Cheng; Tzu-Han,0,12,50,50
1651096268478,COGS 17,A01,092677,Staff,8,0,75,67
1651096274504,COGS 100,A01,083619,Staff,0,30,60,60
1651096280539,COGS 101A,A01,083621,Davis; Joshua Daniel,0,29,60,60
1651096286564,COGS 101B,A01,091572,Staff,0,8,60,60
1651096292592,COGS 101C,A01,083625,Delgado; Tania,13,0,30,17
1651096298615,COGS 107A,A01,083627,Boyle; Mary E. T.,0,17,60,60
1651096304640,COGS 118A,A01,083075,Staff,0,10,60,60
1651096310669,CSE 3,A50,083646,Miranda; Gregory Joseph,15,0,38,23
1651096310669,CSE 3,A51,083647,Miranda; Gregory Joseph,36,0,37,1
1651096316691,CSE 8A,A50,083650,Miranda; Gregory Joseph,0,31,40,40
1651096322717,CSE 11,A01,083080,Cao; Yingjun,1,98,40,39
1651096328756,CSE 12,A01,083652,Staff,0,28,100,100
1651096334786,CSE 15L,A01,083654,Staff,0,3,50,50
1651096334786,CSE 15L,A02,083655,Staff,0,3,50,50
1651096340815,CSE 20,A01,083657,Staff,46,0,80,34
1651096346837,CSE 30,A01,083084,Eldon; John,0,38,80,80
1651096352867,CSE 100,A01,083659,Cao; Yingjun,0,72,50,50
1651096358898,CSE 134B,A01,083661,Powell; Thomas Allan,0,38,65,65
1651096364924,CSE 140,A01,083663,Staff,0,15,75,75
1651096371046,CSE 140L,A01,083088,Eldon; John,3,0,100,97
1651096377072,CSE 175,A01,083665,Kumar; Rakesh,0,0,25,25
1651096383101,CSE 190,A00,092507,Dubnov; Shlomo,9,0,20,11
1651096389127,ECE 45,A01,083139,Staff,0,7,60,60
1651096395176,ECE 65,A50,083695,Staff,0,7,30,30
1651096401199,ECE 109,A01,091882,Touri; Behrouz,32,0,70,38
1651096407222,ECE 180,A00,083140,Abi Samra; Nicholas Camill,17,0,30,13
1651096407222,ECE 180,B00,083141,Abi Samra; Nicholas Camill,0,1,30,32
1651096413246,MATH 10A,A01,083735,Patchell; Gregory David,0,0,30,30
1651096413246,MATH 10A,A02,083736,Patchell; Gregory David,26,0,30,4
1651096413246,MATH 10A,A03,083737,Patchell; Gregory David,22,0,30,8
1651096419270,MATH 10B,A01,083207,Staff,0,7,30,30
1651096419270,MATH 10B,A02,083208,Staff,0,6,30,30
1651096419270,MATH 10B,B01,083739,Staff,7,0,30,23
1651096419270,MATH 10B,B02,083740,Staff,28,0,30,2
1651096425293,MATH 18,A01,083743,Staff,0,0,30,30
1651096425293,MATH 18,A02,083744,Staff,23,0,30,7
1651096425293,MATH 18,A03,083745,Staff,19,0,30,11
1651096425293,MATH 18,A04,083746,Staff,26,0,30,4
1651096425293,MATH 18,B01,083748,Staff,0,16,30,30
1651096425293,MATH 18,B02,083749,Staff,0,14,30,30
1651096425293,MATH 18,B03,083750,Staff,0,14,30,30
1651096425293,MATH 18,B04,083751,Staff,0,14,30,30
1651096431325,MATH 20A,A01,083754,Staff,18,0,40,22
1651096437355,MATH 20B,A01,083756,Staff,0,14,30,30
1651096437355,MATH 20B,A02,083757,Staff,0,11,30,30
1651096443381,MATH 20C,A01,083760,Staff,0,16,30,30
1651096443381,MATH 20C,A02,083761,Staff,0,15,30,30
1651096443381,MATH 20C,B01,083762,Staff,7,0,30,23
1651096443381,MATH 20C,B02,083763,Staff,27,0,30,3
1651096449404,MATH 20D,A01,083765,Staff,3,1,30,27
1651096449404,MATH 20D,A02,083766,Staff,1,0,30,29
1651096449404,MATH 20D,A03,083767,Staff,22,0,30,8
1651096455440,MATH 20E,A01,083771,Staff,0,0,30,30
1651096455440,MATH 20E,A02,083772,Staff,9,0,30,21
1651096455440,MATH 20E,B01,083773,Staff,5,0,35,30
1651096455440,MATH 20E,B02,083774,Staff,5,1,35,30
1651096461463,MATH 103A,A01,083777,Staff,0,17,30,30
1651096461463,MATH 103A,A02,083778,Staff,0,17,30,30
1651096461463,MATH 103A,B01,083779,Staff,0,15,30,30
1651096461463,MATH 103A,B02,083780,Staff,0,14,30,30
1651096467500,MATH 105,A01,085443,Staff,0,24,30,30
1651096473528,MATH 109,A01,083213,Anzaldo; Leesa B,0,7,30,30
1651096473528,MATH 109,A02,083214,Anzaldo; Leesa B,0,7,30,30
1651096473528,MATH 109,B01,083215,Anzaldo; Leesa B,0,8,30,30
1651096473528,MATH 109,B02,083216,Anzaldo; Leesa B,1,8,30,29
1651096479561,MATH 142A,A01,083219,Chow; Bennett,0,15,30,30
1651096479561,MATH 142A,A02,083220,Chow; Bennett,0,15,30,30
1651096479561,MATH 142A,B01,083221,Chow; Bennett,0,16,30,30
1651096479561,MATH 142A,B02,083222,Chow; Bennett,0,15,30,30
1651096485585,MATH 193A,A01,083224,Staff,0,9,30,30
1651096485585,MATH 193A,A02,083225,Staff,1,7,30,29
1651096485585,MATH 193A,A03,083781,Staff,0,7,30,30
1651096485585,MATH 193A,A04,083782,Staff,0,7,30,30
1651096491622,MATH 197,001,091859,McAuley; Julian John,9998,0,9999,1
1651096497697,COGS 9,A01,083615,Staff,0,20,60,60
1651096503736,COGS 11,A01,083617,Boyle; Mary E. T.,13,0,40,27
1651096509762,COGS 13,A01,083071,Staff,0,38,40,40
1651096515791,COGS 14A,A01,092681,Staff,0,40,100,100
1651096521814,COGS 14B,A01,083073,Cheng; Tzu-Han,0,12,50,50
1651096527843,COGS 17,A01,092677,Staff,8,0,75,67
1651096533867,COGS 100,A01,083619,Staff,0,30,60,60
1651096539901,COGS 101A,A01,083621,Davis; Joshua Daniel,0,29,60,60
1651096545929,COGS 101B,A01,091572,Staff,0,8,60,60
1651096551955,COGS 101C,A01,083625,Delgado; Tania,13,0,30,17
1651096557982,COGS 107A,A01,083627,Boyle; Mary E. T.,0,17,60,60
1651096564004,COGS 118A,A01,083075,Staff,0,10,60,60
1651096570030,CSE 3,A50,083646,Miranda; Gregory Joseph,15,0,38,23
1651096570030,CSE 3,A51,083647,Miranda; Gregory Joseph,36,0,37,1
1651096576055,CSE 8A,A50,083650,Miranda; Gregory Joseph,0,31,40,40
1651096582078,CSE 11,A01,083080,Cao; Yingjun,1,98,40,39
1651096588107,CSE 12,A01,083652,Staff,0,28,100,100
1651096594137,CSE 15L,A01,083654,Staff,0,3,50,50
1651096594137,CSE 15L,A02,083655,Staff,0,3,50,50
1651096600172,CSE 20,A01,083657,Staff,46,0,80,34
1651096606214,CSE 30,A01,083084,Eldon; John,0,38,80,80
1651096612241,CSE 100,A01,083659,Cao; Yingjun,0,72,50,50
1651096618277,CSE 134B,A01,083661,Powell; Thomas Allan,0,38,65,65
1651096624300,CSE 140,A01,083663,Staff,0,15,75,75
1651096630336,CSE 140L,A01,083088,Eldon; John,3,0,100,97
1651096636365,CSE 175,A01,083665,Kumar; Rakesh,0,0,25,25
1651096642393,CSE 190,A00,092507,Dubnov; Shlomo,9,0,20,11
1651096648417,ECE 45,A01,083139,Staff,0,7,60,60
1651096654442,ECE 65,A50,083695,Staff,0,7,30,30
1651096660465,ECE 109,A01,091882,Touri; Behrouz,32,0,70,38
1651096666488,ECE 180,A00,083140,Abi Samra; Nicholas Camill,17,0,30,13
1651096666488,ECE 180,B00,083141,Abi Samra; Nicholas Camill,0,1,30,32
1651096672515,MATH 10A,A01,083735,Patchell; Gregory David,0,0,30,30
1651096672515,MATH 10A,A02,083736,Patchell; Gregory David,26,0,30,4
1651096672515,MATH 10A,A03,083737,Patchell; Gregory David,22,0,30,8
1651096678539,MATH 10B,A01,083207,Staff,0,7,30,30
1651096678539,MATH 10B,A02,083208,Staff,0,6,30,30
1651096678539,MATH 10B,B01,083739,Staff,7,0,30,23
1651096678539,MATH 10B,B02,083740,Staff,28,0,30,2
1651096684569,MATH 18,A01,083743,Staff,0,0,30,30
1651096684569,MATH 18,A02,083744,Staff,23,0,30,7
1651096684569,MATH 18,A03,083745,Staff,19,0,30,11
1651096684569,MATH 18,A04,083746,Staff,26,0,30,4
1651096684569,MATH 18,B01,083748,Staff,0,16,30,30
1651096684569,MATH 18,B02,083749,Staff,0,14,30,30
1651096684569,MATH 18,B03,083750,Staff,0,14,30,30
1651096684569,MATH 18,B04,083751,Staff,0,14,30,30
1651096690595,MATH 20A,A01,083754,Staff,18,0,40,22
1651096696630,MATH 20B,A01,083756,Staff,0,14,30,30
1651096696630,MATH 20B,A02,083757,Staff,0,11,30,30
1651096702658,MATH 20C,A01,083760,Staff,0,16,30,30
1651096702658,MATH 20C,A02,083761,Staff,0,15,30,30
1651096702658,MATH 20C,B01,083762,Staff,7,0,30,23
1651096702658,MATH 20C,B02,083763,Staff,27,0,30,3
1651096708693,MATH 20D,A01,083765,Staff,3,1,30,27
1651096708693,MATH 20D,A02,083766,Staff,1,0,30,29
1651096708693,MATH 20D,A03,083767,Staff,22,0,30,8
1651096714720,MATH 20E,A01,083771,Staff,0,0,30,30
1651096714720,MATH 20E,A02,083772,Staff,9,0,30,21
1651096714720,MATH 20E,B01,083773,Staff,5,0,35,30
1651096714720,MATH 20E,B02,083774,Staff,5,1,35,30
1651096720752,MATH 103A,A01,083777,Staff,0,17,30,30
1651096720752,MATH 103A,A02,083778,Staff,0,17,30,30
1651096720752,MATH 103A,B01,083779,Staff,0,15,30,30
1651096720752,MATH 103A,B02,083780,Staff,0,14,30,30
1651096726775,MATH 105,A01,085443,Staff,0,24,30,30
1651096732802,MATH 109,A01,083213,Anzaldo; Leesa B,0,7,30,30
1651096732802,MATH 109,A02,083214,Anzaldo; Leesa B,0,7,30,30
1651096732802,MATH 109,B01,083215,Anzaldo; Leesa B,0,8,30,30
1651096732802,MATH 109,B02,083216,Anzaldo; Leesa B,1,8,30,29
1651096738826,MATH 142A,A01,083219,Chow; Bennett,0,15,30,30
1651096738826,MATH 142A,A02,083220,Chow; Bennett,0,15,30,30
1651096738826,MATH 142A,B01,083221,Chow; Bennett,0,16,30,30
1651096738826,MATH 142A,B02,083222,Chow; Bennett,0,15,30,30
1651096744854,MATH 193A,A01,083224,Staff,0,9,30,30
1651096744854,MATH 193A,A02,083225,Staff,1,7,30,29
1651096744854,MATH 193A,A03,083781,Staff,0,7,30,30
1651096744854,MATH 193A,A04,083782,Staff,0,7,30,30
1651096750891,MATH 197,001,091859,McAuley; Julian John,9998,0,9999,1
1651096756949,COGS 9,A01,083615,Staff,0,20,60,60
1651096762975,COGS 11,A01,083617,Boyle; Mary E. T.,13,0,40,27
1651096769003,COGS 13,A01,083071,Staff,0,38,40,40
1651096775028,COGS 14A,A01,092681,Staff,0,40,100,100
1651096781064,COGS 14B,A01,083073,Cheng; Tzu-Han,0,12,50,50
1651096787091,COGS 17,A01,092677,Staff,8,0,75,67
1651096793118,COGS 100,A01,083619,Staff,0,30,60,60
1651096799143,COGS 101A,A01,083621,Davis; Joshua Daniel,0,29,60,60
1651096805168,COGS 101B,A01,091572,Staff,0,8,60,60
1651096811189,COGS 101C,A01,083625,Delgado; Tania,12,0,30,18
1651096817216,COGS 107A,A01,083627,Boyle; Mary E. T.,0,17,60,60
1651096823254,COGS 118A,A01,083075,Staff,0,10,60,60
1651096829286,CSE 3,A50,083646,Miranda; Gregory Joseph,15,0,38,23
1651096829286,CSE 3,A51,083647,Miranda; Gregory Joseph,36,0,37,1
1651096835309,CSE 8A,A50,083650,Miranda; Gregory Joseph,0,31,40,40
1651096841360,CSE 11,A01,083080,Cao; Yingjun,1,98,40,39
1651096847384,CSE 12,A01,083652,Staff,0,28,100,100
1651096853407,CSE 15L,A01,083654,Staff,0,3,50,50
1651096853407,CSE 15L,A02,083655,Staff,0,3,50,50
1651096859437,CSE 20,A01,083657,Staff,46,0,80,34
1651096865459,CSE 30,A01,083084,Eldon; John,0,38,80,80
1651096871482,CSE 100,A01,083659,Cao; Yingjun,0,72,50,50
1651096877517,CSE 134B,A01,083661,Powell; Thomas Allan,0,38,65,65
1651096883542,CSE 140,A01,083663,Staff,0,15,75,75
1651096889568,CSE 140L,A01,083088,Eldon; John,3,0,100,97
1651096895598,CSE 175,A01,083665,Kumar; Rakesh,0,0,25,25
1651096901622,CSE 190,A00,092507,Dubnov; Shlomo,9,0,20,11
1651096907650,ECE 45,A01,083139,Staff,0,7,60,60
1651096913674,ECE 65,A50,083695,Staff,0,7,30,30
1651096919697,ECE 109,A01,091882,Touri; Behrouz,32,0,70,38
1651096925723,ECE 180,A00,083140,Abi Samra; Nicholas Camill,17,0,30,13
1651096925723,ECE 180,B00,083141,Abi Samra; Nicholas Camill,0,1,30,32
1651096931750,MATH 10A,A01,083735,Patchell; Gregory David,0,0,30,30
1651096931750,MATH 10A,A02,083736,Patchell; Gregory David,26,0,30,4
1651096931750,MATH 10A,A03,083737,Patchell; Gregory David,22,0,30,8
1651096937773,MATH 10B,A01,083207,Staff,0,7,30,30
1651096937773,MATH 10B,A02,083208,Staff,0,6,30,30
1651096937773,MATH 10B,B01,083739,Staff,7,0,30,23
1651096937773,MATH 10B,B02,083740,Staff,28,0,30,2
1651096943804,MATH 18,A01,083743,Staff,0,0,30,30
1651096943804,MATH 18,A02,083744,Staff,23,0,30,7
1651096943804,MATH 18,A03,083745,Staff,19,0,30,11
1651096943804,MATH 18,A04,083746,Staff,26,0,30,4
1651096943804,MATH 18,B01,083748,Staff,0,16,30,30
1651096943804,MATH 18,B02,083749,Staff,0,14,30,30
1651096943804,MATH 18,B03,083750,Staff,0,15,30,30
1651096943804,MATH 18,B04,083751,Staff,0,14,30,30
1651096949826,MATH 20A,A01,083754,Staff,18,0,40,22
1651096955855,MATH 20B,A01,083756,Staff,0,14,30,30
1651096955855,MATH 20B,A02,083757,Staff,0,11,30,30
1651096961881,MATH 20C,A01,083760,Staff,0,16,30,30
1651096961881,MATH 20C,A02,083761,Staff,0,15,30,30
1651096961881,MATH 20C,B01,083762,Staff,7,0,30,23
1651096961881,MATH 20C,B02,083763,Staff,27,0,30,3
1651096968014,MATH 20D,A01,083765,Staff,3,1,30,27
1651096968014,MATH 20D,A02,083766,Staff,1,0,30,29
1651096968014,MATH 20D,A03,083767,Staff,22,0,30,8
1651096974042,MATH 20E,A01,083771,Staff,0,0,30,30
1651096974042,MATH 20E,A02,083772,Staff,9,0,30,21
1651096974042,MATH 20E,B01,083773,Staff,5,0,35,30
1651096974042,MATH 20E,B02,083774,Staff,5,1,35,30
1651096980072,MATH 103A,A01,083777,Staff,0,17,30,30
1651096980072,MATH 103A,A02,083778,Staff,0,17,30,30
1651096980072,MATH 103A,B01,083779,Staff,0,15,30,30
1651096980072,MATH 103A,B02,083780,Staff,0,14,30,30
1651096986097,MATH 105,A01,085443,Staff,0,24,30,30
1651096992129,MATH 109,A01,083213,Anzaldo; Leesa B,0,7,30,30
1651096992129,MATH 109,A02,083214,Anzaldo; Leesa B,0,7,30,30
1651096992129,MATH 109,B01,083215,Anzaldo; Leesa B,0,8,30,30
1651096992129,MATH 109,B02,083216,Anzaldo; Leesa B,1,8,30,29
1651096998158,MATH 142A,A01,083219,Chow; Bennett,0,15,30,30
1651096998158,MATH 142A,A02,083220,Chow; Bennett,0,15,30,30
1651096998158,MATH 142A,B01,083221,Chow; Bennett,0,16,30,30
1651096998158,MATH 142A,B02,083222,Chow; Bennett,0,15,30,30
1651097004183,MATH 193A,A01,083224,Staff,0,9,30,30
1651097004183,MATH 193A,A02,083225,Staff,1,7,30,29
1651097004183,MATH 193A,A03,083781,Staff,0,7,30,30
1651097004183,MATH 193A,A04,083782,Staff,0,7,30,30
1651097010214,MATH 197,001,091859,McAuley; Julian John,9998,0,9999,1
1651097016265,COGS 9,A01,083615,Staff,0,20,60,60
1651097022289,COGS 11,A01,083617,Boyle; Mary E. T.,13,0,40,27
1651097028315,COGS 13,A01,083071,Staff,0,38,40,40
1651097034338,COGS 14A,A01,092681,Staff,0,40,100,100
1651097040363,COGS 14B,A01,083073,Cheng; Tzu-Han,0,12,50,50
1651097046388,COGS 17,A01,092677,Staff,8,0,75,67
1651097052411,COGS 100,A01,083619,Staff,0,30,60,60
1651097058435,COGS 101A,A01,083621,Davis; Joshua Daniel,0,29,60,60
1651097064458,COGS 101B,A01,091572,Staff,0,8,60,60
1651097070482,COGS 101C,A01,083625,Delgado; Tania,12,0,30,18
1651097076509,COGS 107A,A01,083627,Boyle; Mary E. T.,0,17,60,60
1651097082532,COGS 118A,A01,083075,Staff,0,10,60,60
1651097088557,CSE 3,A50,083646,Miranda; Gregory Joseph,15,0,38,23
1651097088557,CSE 3,A51,083647,Miranda; Gregory Joseph,36,0,37,1
1651097094581,CSE 8A,A50,083650,Miranda; Gregory Joseph,0,31,40,40
1651097100608,CSE 11,A01,083080,Cao; Yingjun,1,98,40,39
1651097106632,CSE 12,A01,083652,Staff,0,28,100,100
1651097112658,CSE 15L,A01,083654,Staff,0,3,50,50
1651097112658,CSE 15L,A02,083655,Staff,0,3,50,50
1651097118682,CSE 20,A01,083657,Staff,46,0,80,34
1651097124704,CSE 30,A01,083084,Eldon; John,0,38,80,80
1651097130732,CSE 100,A01,083659,Cao; Yingjun,0,72,50,50
1651097136766,CSE 134B,A01,083661,Powell; Thomas Allan,0,38,65,65
1651097142799,CSE 140,A01,083663,Staff,0,15,75,75
1651097148827,CSE 140L,A01,083088,Eldon; John,3,0,100,97
1651097154854,CSE 175,A01,083665,Kumar; Rakesh,0,0,25,25
1651097160887,CSE 190,A00,092507,Dubnov; Shlomo,9,0,20,11
1651097166922,ECE 45,A01,083139,Staff,0,7,60,60
1651097172952,ECE 65,A50,083695,Staff,0,7,30,30
1651097178983,ECE 109,A01,091882,Touri; Behrouz,32,0,70,38
1651097185008,ECE 180,A00,083140,Abi Samra; Nicholas Camill,17,0,30,13
1651097185008,ECE 180,B00,083141,Abi Samra; Nicholas Camill,0,1,30,32
1651097191030,MATH 10A,A01,083735,Patchell; Gregory David,0,0,30,30
1651097191030,MATH 10A,A02,083736,Patchell; Gregory David,26,0,30,4
1651097191030,MATH 10A,A03,083737,Patchell; Gregory David,22,0,30,8
1651097197054,MATH 10B,A01,083207,Staff,0,7,30,30
1651097197054,MATH 10B,A02,083208,Staff,0,6,30,30
1651097197054,MATH 10B,B01,083739,Staff,7,0,30,23
1651097197054,MATH 10B,B02,083740,Staff,28,0,30,2
1651097203080,MATH 18,A01,083743,Staff,0,0,30,30
1651097203080,MATH 18,A02,083744,Staff,23,0,30,7
1651097203080,MATH 18,A03,083745,Staff,19,0,30,11
1651097203080,MATH 18,A04,083746,Staff,26,0,30,4
1651097203080,MATH 18,B01,083748,Staff,0,16,30,30
1651097203080,MATH 18,B02,083749,Staff,0,14,30,30
1651097203080,MATH 18,B03,083750,Staff,0,15,30,30
1651097203080,MATH 18,B04,083751,Staff,0,14,30,30
1651097209113,MATH 20A,A01,083754,Staff,18,0,40,22
1651097215140,MATH 20B,A01,083756,Staff,0,14,30,30
1651097215140,MATH 20B,A02,083757,Staff,0,11,30,30
1651097221169,MATH 20C,A01,083760,Staff,0,16,30,30
1651097221169,MATH 20C,A02,083761,Staff,0,15,30,30
1651097221169,MATH 20C,B01,083762,Staff,7,0,30,23
1651097221169,MATH 20C,B02,083763,Staff,27,0,30,3
1651097227194,MATH 20D,A01,083765,Staff,3,1,30,27
1651097227194,MATH 20D,A02,083766,Staff,1,0,30,29
1651097227194,MATH 20D,A03,083767,Staff,22,0,30,8
1651097233220,MATH 20E,A01,083771,Staff,0,0,30,30
1651097233220,MATH 20E,A02,083772,Staff,9,0,30,21
1651097233220,MATH 20E,B01,083773,Staff,5,0,35,30
1651097233220,MATH 20E,B02,083774,Staff,5,1,35,30
1651097239257,MATH 103A,A01,083777,Staff,0,17,30,30
1651097239257,MATH 103A,A02,083778,Staff,0,17,30,30
1651097239257,MATH 103A,B01,083779,Staff,0,15,30,30
1651097239257,MATH 103A,B02,083780,Staff,0,14,30,30
1651097245283,MATH 105,A01,085443,Staff,0,24,30,30
1651097251316,MATH 109,A01,083213,Anzaldo; Leesa B,0,7,30,30
1651097251316,MATH 109,A02,083214,Anzaldo; Leesa B,0,7,30,30
1651097251316,MATH 109,B01,083215,Anzaldo; Leesa B,0,8,30,30
1651097251316,MATH 109,B02,083216,Anzaldo; Leesa B,1,8,30,29
1651097257339,MATH 142A,A01,083219,Chow; Bennett,0,15,30,30
1651097257339,MATH 142A,A02,083220,Chow; Bennett,0,15,30,30
1651097257339,MATH 142A,B01,083221,Chow; Bennett,0,16,30,30
1651097257339,MATH 142A,B02,083222,Chow; Bennett,0,15,30,30
1651097263363,MATH 193A,A01,083224,Staff,0,9,30,30
1651097263363,MATH 193A,A02,083225,Staff,1,7,30,29
1651097263363,MATH 193A,A03,083781,Staff,0,7,30,30
1651097263363,MATH 193A,A04,083782,Staff,0,7,30,30
1651097269390,MATH 197,001,091859,McAuley; Julian John,9998,0,9999,1
1651097275451,COGS 9,A01,083615,Staff,0,20,60,60
1651097281475,COGS 11,A01,083617,Boyle; Mary E. T.,13,0,40,27
1651097287505,COGS 13,A01,083071,Staff,0,38,40,40
1651097293530,COGS 14A,A01,092681,Staff,0,40,100,100
1651097299558,COGS 14B,A01,083073,Cheng; Tzu-Han,0,12,50,50
1651097305588,COGS 17,A01,092677,Staff,8,0,75,67
1651097311613,COGS 100,A01,083619,Staff,0,30,60,60
1651097317638,COGS 101A,A01,083621,Davis; Joshua Daniel,0,29,60,60
1651097323665,COGS 101B,A01,091572,Staff,0,8,60,60
1651097329702,COGS 101C,A01,083625,Delgado; Tania,12,0,30,18
1651097335729,COGS 107A,A01,083627,Boyle; Mary E. T.,0,17,60,60
1651097341753,COGS 118A,A01,083075,Staff,0,10,60,60
1651097347780,CSE 3,A50,083646,Miranda; Gregory Joseph,15,0,38,23
1651097347780,CSE 3,A51,083647,Miranda; Gregory Joseph,36,0,37,1
1651097353806,CSE 8A,A50,083650,Miranda; Gregory Joseph,0,31,40,40
1651097359832,CSE 11,A01,083080,Cao; Yingjun,1,98,40,39
1651097365855,CSE 12,A01,083652,Staff,0,28,100,100
1651097371890,CSE 15L,A01,083654,Staff,0,3,50,50
1651097371890,CSE 15L,A02,083655,Staff,0,3,50,50
1651097377917,CSE 20,A01,083657,Staff,46,0,80,34
1651097383949,CSE 30,A01,083084,Eldon; John,0,38,80,80
1651097389987,CSE 100,A01,083659,Cao; Yingjun,0,72,50,50
1651097396015,CSE 134B,A01,083661,Powell; Thomas Allan,0,38,65,65
1651097402038,CSE 140,A01,083663,Staff,0,15,75,75
1651097408064,CSE 140L,A01,083088,Eldon; John,3,0,100,97
1651097414090,CSE 175,A01,083665,Kumar; Rakesh,0,0,25,25
1651097420113,CSE 190,A00,092507,Dubnov; Shlomo,9,0,20,11
1651097426139,ECE 45,A01,083139,Staff,0,7,60,60
1651097432177,ECE 65,A50,083695,Staff,0,7,30,30
1651097438210,ECE 109,A01,091882,Touri; Behrouz,32,0,70,38
1651097444234,ECE 180,A00,083140,Abi Samra; Nicholas Camill,17,0,30,13
1651097444234,ECE 180,B00,083141,Abi Samra; Nicholas Camill,0,1,30,32
1651097450258,MATH 10A,A01,083735,Patchell; Gregory David,0,0,30,30
1651097450258,MATH 10A,A02,083736,Patchell; Gregory David,26,0,30,4
1651097450258,MATH 10A,A03,083737,Patchell; Gregory David,22,0,30,8
1651097456288,MATH 10B,A01,083207,Staff,0,7,30,30
1651097456288,MATH 10B,A02,083208,Staff,0,6,30,30
1651097456288,MATH 10B,B01,083739,Staff,7,0,30,23
1651097456288,MATH 10B,B02,083740,Staff,28,0,30,2
1651097462313,MATH 18,A01,083743,Staff,0,0,30,30
1651097462313,MATH 18,A02,083744,Staff,23,0,30,7
1651097462313,MATH 18,A03,083745,Staff,19,0,30,11
1651097462313,MATH 18,A04,083746,Staff,26,0,30,4
1651097462313,MATH 18,B01,083748,Staff,0,16,30,30
1651097462313,MATH 18,B02,083749,Staff,0,14,30,30
1651097462313,MATH 18,B03,083750,Staff,0,15,30,30
1651097462313,MATH 18,B04,083751,Staff,0,14,30,30
1651097468338,MATH 20A,A01,083754,Staff,18,0,40,22
1651097474360,MATH 20B,A01,083756,Staff,0,14,30,30
1651097474360,MATH 20B,A02,083757,Staff,0,11,30,30
1651097480394,MATH 20C,A01,083760,Staff,1,16,30,29
1651097480394,MATH 20C,A02,083761,Staff,0,15,30,30
1651097480394,MATH 20C,B01,083762,Staff,7,0,30,23
1651097480394,MATH 20C,B02,083763,Staff,27,0,30,3
1651097486417,MATH 20D,A01,083765,Staff,3,1,30,27
1651097486417,MATH 20D,A02,083766,Staff,1,0,30,29
1651097486417,MATH 20D,A03,083767,Staff,22,0,30,8
1651097492439,MATH 20E,A01,083771,Staff,0,0,30,30
1651097492439,MATH 20E,A02,083772,Staff,9,0,30,21
1651097492439,MATH 20E,B01,083773,Staff,5,0,35,30
1651097492439,MATH 20E,B02,083774,Staff,5,1,35,30
1651097498478,MATH 103A,A01,083777,Staff,0,17,30,30
1651097498478,MATH 103A,A02,083778,Staff,0,17,30,30
1651097498478,MATH 103A,B01,083779,Staff,0,15,30,30
1651097498478,MATH 103A,B02,083780,Staff,0,14,30,30
1651097504502,MATH 105,A01,085443,Staff,0,24,30,30
1651097510523,MATH 109,A01,083213,Anzaldo; Leesa B,0,7,30,30
1651097510523,MATH 109,A02,083214,Anzaldo; Leesa B,0,7,30,30
1651097510523,MATH 109,B01,083215,Anzaldo; Leesa B,0,8,30,30
1651097510523,MATH 109,B02,083216,Anzaldo; Leesa B,1,8,30,29
1651097516557,MATH 142A,A01,083219,Chow; Bennett,0,15,30,30
1651097516557,MATH 142A,A02,083220,Chow; Bennett,0,15,30,30
1651097516557,MATH 142A,B01,083221,Chow; Bennett,0,16,30,30
1651097516557,MATH 142A,B02,083222,Chow; Bennett,0,15,30,30
1651097522582,MATH 193A,A01,083224,Staff,0,9,30,30
1651097522582,MATH 193A,A02,083225,Staff,1,7,30,29
1651097522582,MATH 193A,A03,083781,Staff,0,7,30,30
1651097522582,MATH 193A,A04,083782,Staff,0,7,30,30
1651097528608,MATH 197,001,091859,McAuley; Julian John,9998,0,9999,1
1651097534684,COGS 9,A01,083615,Staff,0,20,60,60
1651097540728,COGS 11,A01,083617,Boyle; Mary E. T.,13,0,40,27
1651097546759,COGS 13,A01,083071,Staff,0,38,40,40
1651097552786,COGS 14A,A01,092681,Staff,0,40,100,100
1651097558889,COGS 14B,A01,083073,Cheng; Tzu-Han,0,12,50,50
1651097564916,COGS 17,A01,092677,Staff,8,0,75,67
1651097570941,COGS 100,A01,083619,Staff,0,30,60,60
1651097576966,COGS 101A,A01,083621,Davis; Joshua Daniel,0,29,60,60
1651097582990,COGS 101B,A01,091572,Staff,0,9,60,60
1651097589017,COGS 101C,A01,083625,Delgado; Tania,12,0,30,18
1651097595040,COGS 107A,A01,083627,Boyle; Mary E. T.,0,17,60,60
1651097601066,COGS 118A,A01,083075,Staff,0,10,60,60
1651097607089,CSE 3,A50,083646,Miranda; Gregory Joseph,15,0,38,23
1651097607089,CSE 3,A51,083647,Miranda; Gregory Joseph,36,0,37,1
1651097613113,CSE 8A,A50,083650,Miranda; Gregory Joseph,0,31,40,40
1651097619136,CSE 11,A01,083080,Cao; Yingjun,1,98,40,39
1651097625163,CSE 12,A01,083652,Staff,0,28,100,100
1651097631188,CSE 15L,A01,083654,Staff,0,3,50,50
1651097631188,CSE 15L,A02,083655,Staff,0,3,50,50
1651097637223,CSE 20,A01,083657,Staff,46,0,80,34
1651097643249,CSE 30,A01,083084,Eldon; John,0,38,80,80
1651097649276,CSE 100,A01,083659,Cao; Yingjun,0,72,50,50
1651097655311,CSE 134B,A01,083661,Powell; Thomas Allan,0,38,65,65
1651097661341,CSE 140,A01,083663,Staff,0,15,75,75
1651097667368,CSE 140L,A01,083088,Eldon; John,3,0,100,97
1651097673391,CSE 175,A01,083665,Kumar; Rakesh,0,0,25,25
1651097679414,CSE 190,A00,092507,Dubnov; Shlomo,9,0,20,11
1651097685448,ECE 45,A01,083139,Staff,0,7,60,60
1651097691480,ECE 65,A50,083695,Staff,0,7,30,30
1651097697502,ECE 109,A01,091882,Touri; Behrouz,32,0,70,38
1651097703542,ECE 180,A00,083140,Abi Samra; Nicholas Camill,17,0,30,13
1651097703542,ECE 180,B00,083141,Abi Samra; Nicholas Camill,0,1,30,32
1651097709566,MATH 10A,A01,083735,Patchell; Gregory David,0,0,30,30
1651097709566,MATH 10A,A02,083736,Patchell; Gregory David,26,0,30,4
1651097709566,MATH 10A,A03,083737,Patchell; Gregory David,22,0,30,8
1651097715605,MATH 10B,A01,083207,Staff,0,7,30,30
1651097715605,MATH 10B,A02,083208,Staff,0,6,30,30
1651097715605,MATH 10B,B01,083739,Staff,7,0,30,23
1651097715605,MATH 10B,B02,083740,Staff,28,0,30,2
1651097721631,MATH 18,A01,083743,Staff,0,0,30,30
1651097721631,MATH 18,A02,083744,Staff,23,0,30,7
1651097721631,MATH 18,A03,083745,Staff,19,0,30,11
1651097721631,MATH 18,A04,083746,Staff,26,0,30,4
1651097721631,MATH 18,B01,083748,Staff,0,16,30,30
1651097721631,MATH 18,B02,083749,Staff,0,14,30,30
1651097721631,MATH 18,B03,083750,Staff,0,15,30,30
1651097721631,MATH 18,B04,083751,Staff,0,14,30,30
1651097727662,MATH 20A,A01,083754,Staff,18,0,40,22
1651097733685,MATH 20B,A01,083756,Staff,0,14,30,30
1651097733685,MATH 20B,A02,083757,Staff,0,11,30,30
1651097739707,MATH 20C,A01,083760,Staff,1,16,30,29
1651097739707,MATH 20C,A02,083761,Staff,0,15,30,30
1651097739707,MATH 20C,B01,083762,Staff,7,0,30,23
1651097739707,MATH 20C,B02,083763,Staff,27,0,30,3
1651097745730,MATH 20D,A01,083765,Staff,3,1,30,27
1651097745730,MATH 20D,A02,083766,Staff,1,0,30,29
1651097745730,MATH 20D,A03,083767,Staff,22,0,30,8
1651097751753,MATH 20E,A01,083771,Staff,0,0,30,30
1651097751753,MATH 20E,A02,083772,Staff,9,0,30,21
1651097751753,MATH 20E,B01,083773,Staff,5,0,35,30
1651097751753,MATH 20E,B02,083774,Staff,5,1,35,30
1651097757777,MATH 103A,A01,083777,Staff,0,17,30,30
1651097757777,MATH 103A,A02,083778,Staff,0,17,30,30
1651097757777,MATH 103A,B01,083779,Staff,0,15,30,30
1651097757777,MATH 103A,B02,083780,Staff,0,14,30,30
1651097763812,MATH 105,A01,085443,Staff,0,24,30,30
1651097769857,MATH 109,A01,083213,Anzaldo; Leesa B,0,7,30,30
1651097769857,MATH 109,A02,083214,Anzaldo; Leesa B,0,7,30,30
1651097769857,MATH 109,B01,083215,Anzaldo; Leesa B,0,8,30,30
1651097769857,MATH 109,B02,083216,Anzaldo; Leesa B,1,8,30,29
1651097775880,MATH 142A,A01,083219,Chow; Bennett,0,15,30,30
1651097775880,MATH 142A,A02,083220,Chow; Bennett,0,15,30,30
1651097775880,MATH 142A,B01,083221,Chow; Bennett,0,16,30,30
1651097775880,MATH 142A,B02,083222,Chow; Bennett,0,15,30,30
1651097781911,MATH 193A,A01,083224,Staff,0,9,30,30
1651097781911,MATH 193A,A02,083225,Staff,1,7,30,29
1651097781911,MATH 193A,A03,083781,Staff,0,7,30,30
1651097781911,MATH 193A,A04,083782,Staff,0,7,30,30
1651097787936,MATH 197,001,091859,McAuley; Julian John,9998,0,9999,1
1651097794007,COGS 9,A01,083615,Staff,0,20,60,60
1651097800030,COGS 11,A01,083617,Boyle; Mary E. T.,13,0,40,27
1651097806061,COGS 13,A01,083071,Staff,0,38,40,40
1651097812104,COGS 14A,A01,092681,Staff,0,40,100,100
1651097818134,COGS 14B,A01,083073,Cheng; Tzu-Han,0,12,50,50
1651097824175,COGS 17,A01,092677,Staff,8,0,75,67
1651097830206,COGS 100,A01,083619,Staff,0,30,60,60
1651097836231,COGS 101A,A01,083621,Davis; Joshua Daniel,0,29,60,60
1651097842261,COGS 101B,A01,091572,Staff,0,9,60,60
1651097848285,COGS 101C,A01,083625,Delgado; Tania,12,0,30,18
1651097854309,COGS 107A,A01,083627,Boyle; Mary E. T.,0,17,60,60
1651097860337,COGS 118A,A01,083075,Staff,0,10,60,60
1651097866365,CSE 3,A50,083646,Miranda; Gregory Joseph,15,0,38,23
1651097866365,CSE 3,A51,083647,Miranda; Gregory Joseph,36,0,37,1
1651097872391,CSE 8A,A50,083650,Miranda; Gregory Joseph,0,31,40,40
1651097878413,CSE 11,A01,083080,Cao; Yingjun,1,98,40,39
1651097884448,CSE 12,A01,083652,Staff,0,28,100,100
1651097890470,CSE 15L,A01,083654,Staff,0,3,50,50
1651097890470,CSE 15L,A02,083655,Staff,0,3,50,50
1651097896500,CSE 20,A01,083657,Staff,46,0,80,34
1651097902525,CSE 30,A01,083084,Eldon; John,0,38,80,80
1651097908551,CSE 100,A01,083659,Cao; Yingjun,0,72,50,50
1651097914574,CSE 134B,A01,083661,Powell; Thomas Allan,0,38,65,65
1651097920601,CSE 140,A01,083663,Staff,0,15,75,75
1651097926626,CSE 140L,A01,083088,Eldon; John,3,0,100,97
1651097932650,CSE 175,A01,083665,Kumar; Rakesh,0,0,25,25
1651097938672,CSE 190,A00,092507,Dubnov; Shlomo,9,0,20,11
1651097944699,ECE 45,A01,083139,Staff,0,7,60,60
1651097950729,ECE 65,A50,083695,Staff,0,7,30,30
1651097956751,ECE 109,A01,091882,Touri; Behrouz,32,0,70,38
1651097962775,ECE 180,A00,083140,Abi Samra; Nicholas Camill,17,0,30,13
1651097962775,ECE 180,B00,083141,Abi Samra; Nicholas Camill,0,1,30,32
1651097968803,MATH 10A,A01,083735,Patchell; Gregory David,0,0,30,30
1651097968803,MATH 10A,A02,083736,Patchell; Gregory David,26,0,30,4
1651097968803,MATH 10A,A03,083737,Patchell; Gregory David,22,0,30,8
1651097974832,MATH 10B,A01,083207,Staff,0,7,30,30
1651097974832,MATH 10B,A02,083208,Staff,0,6,30,30
1651097974832,MATH 10B,B01,083739,Staff,7,0,30,23
1651097974832,MATH 10B,B02,083740,Staff,28,0,30,2
1651097980862,MATH 18,A01,083743,Staff,0,0,30,30
1651097980862,MATH 18,A02,083744,Staff,23,0,30,7
1651097980862,MATH 18,A03,083745,Staff,19,0,30,11
1651097980862,MATH 18,A04,083746,Staff,26,0,30,4
1651097980862,MATH 18,B01,083748,Staff,0,16,30,30
1651097980862,MATH 18,B02,083749,Staff,0,14,30,30
1651097980862,MATH 18,B03,083750,Staff,0,15,30,30
1651097980862,MATH 18,B04,083751,Staff,0,14,30,30
1651097986918,MATH 20A,A01,083754,Staff,18,0,40,22
1651097992951,MATH 20B,A01,083756,Staff,0,14,30,30
1651097992951,MATH 20B,A02,083757,Staff,0,11,30,30
1651097998975,MATH 20C,A01,083760,Staff,1,16,30,29
1651097998975,MATH 20C,A02,083761,Staff,0,16,30,30
1651097998975,MATH 20C,B01,083762,Staff,7,0,30,23
1651097998975,MATH 20C,B02,083763,Staff,27,0,30,3
1651098005003,MATH 20D,A01,083765,Staff,3,1,30,27
1651098005003,MATH 20D,A02,083766,Staff,1,0,30,29
1651098005003,MATH 20D,A03,083767,Staff,22,0,30,8
1651098011028,MATH 20E,A01,083771,Staff,0,0,30,30
1651098011028,MATH 20E,A02,083772,Staff,9,0,30,21
1651098011028,MATH 20E,B01,083773,Staff,5,0,35,30
1651098011028,MATH 20E,B02,083774,Staff,5,1,35,30
1651098017060,MATH 103A,A01,083777,Staff,0,17,30,30
1651098017060,MATH 103A,A02,083778,Staff,0,17,30,30
1651098017060,MATH 103A,B01,083779,Staff,0,15,30,30
1651098017060,MATH 103A,B02,083780,Staff,0,14,30,30
1651098023084,MATH 105,A01,085443,Staff,0,24,30,30
1651098029115,MATH 109,A01,083213,Anzaldo; Leesa B,0,7,30,30
1651098029115,MATH 109,A02,083214,Anzaldo; Leesa B,0,7,30,30
1651098029115,MATH 109,B01,083215,Anzaldo; Leesa B,0,8,30,30
1651098029115,MATH 109,B02,083216,Anzaldo; Leesa B,1,8,30,29
1651098035147,MATH 142A,A01,083219,Chow; Bennett,0,15,30,30
1651098035147,MATH 142A,A02,083220,Chow; Bennett,0,15,30,30
1651098035147,MATH 142A,B01,083221,Chow; Bennett,0,16,30,30
1651098035147,MATH 142A,B02,083222,Chow; Bennett,0,15,30,30
1651098041173,MATH 193A,A01,083224,Staff,0,9,30,30
1651098041173,MATH 193A,A02,083225,Staff,1,7,30,29
1651098041173,MATH 193A,A03,083781,Staff,0,7,30,30
1651098041173,MATH 193A,A04,083782,Staff,0,7,30,30
1651098047202,MATH 197,001,091859,McAuley; Julian John,9998,0,9999,1
1651098053266,COGS 9,A01,083615,Staff,0,20,60,60
1651098059288,COGS 11,A01,083617,Boyle; Mary E. T.,13,0,40,27
1651098065322,COGS 13,A01,083071,Staff,0,38,40,40
1651098071348,COGS 14A,A01,092681,Staff,0,40,100,100
1651098077372,COGS 14B,A01,083073,Cheng; Tzu-Han,0,12,50,50
1651098083409,COGS 17,A01,092677,Staff,8,0,75,67
1651098089434,COGS 100,A01,083619,Staff,0,30,60,60
1651098095461,COGS 101A,A01,083621,Davis; Joshua Daniel,0,29,60,60
1651098101489,COGS 101B,A01,091572,Staff,0,9,60,60
1651098107512,COGS 101C,A01,083625,Delgado; Tania,12,0,30,18
1651098113552,COGS 107A,A01,083627,Boyle; Mary E. T.,0,17,60,60
1651098119588,COGS 118A,A01,083075,Staff,0,10,60,60
1651098125611,CSE 3,A50,083646,Miranda; Gregory Joseph,15,0,38,23
1651098125611,CSE 3,A51,083647,Miranda; Gregory Joseph,36,0,37,1
1651098131639,CSE 8A,A50,083650,Miranda; Gregory Joseph,0,31,40,40
1651098137664,CSE 11,A01,083080,Cao; Yingjun,1,98,40,39
1651098143691,CSE 12,A01,083652,Staff,0,28,100,100
1651098149717,CSE 15L,A01,083654,Staff,0,3,50,50
1651098149717,CSE 15L,A02,083655,Staff,0,3,50,50
1651098155824,CSE 20,A01,083657,Staff,46,0,80,34
1651098161857,CSE 30,A01,083084,Eldon; John,0,38,80,80
1651098167883,CSE 100,A01,083659,Cao; Yingjun,0,72,50,50
1651098173924,CSE 134B,A01,083661,Powell; Thomas Allan,0,38,65,65
1651098179947,CSE 140,A01,083663,Staff,0,15,75,75
1651098185969,CSE 140L,A01,083088,Eldon; John,3,0,100,97
1651098191995,CSE 175,A01,083665,Kumar; Rakesh,0,0,25,25
1651098198021,CSE 190,A00,092507,Dubnov; Shlomo,9,0,20,11
1651098204044,ECE 45,A01,083139,Staff,0,7,60,60
1651098210069,ECE 65,A50,083695,Staff,0,7,30,30
1651098216094,ECE 109,A01,091882,Touri; Behrouz,32,0,70,38
1651098222137,ECE 180,A00,083140,Abi Samra; Nicholas Camill,17,0,30,13
1651098222137,ECE 180,B00,083141,Abi Samra; Nicholas Camill,0,1,30,32
1651098228166,MATH 10A,A01,083735,Patchell; Gregory David,0,0,30,30
1651098228166,MATH 10A,A02,083736,Patchell; Gregory David,26,0,30,4
1651098228166,MATH 10A,A03,083737,Patchell; Gregory David,22,0,30,8
1651098234193,MATH 10B,A01,083207,Staff,0,7,30,30
1651098234193,MATH 10B,A02,083208,Staff,0,6,30,30
1651098234193,MATH 10B,B01,083739,Staff,7,0,30,23
1651098234193,MATH 10B,B02,083740,Staff,28,0,30,2
1651098240220,MATH 18,A01,083743,Staff,0,0,30,30
1651098240220,MATH 18,A02,083744,Staff,23,0,30,7
1651098240220,MATH 18,A03,083745,Staff,19,0,30,11
1651098240220,MATH 18,A04,083746,Staff,26,0,30,4
1651098240220,MATH 18,B01,083748,Staff,0,16,30,30
1651098240220,MATH 18,B02,083749,Staff,0,14,30,30
1651098240220,MATH 18,B03,083750,Staff,0,15,30,30
1651098240220,MATH 18,B04,083751,Staff,0,14,30,30
1651098246247,MATH 20A,A01,083754,Staff,18,0,40,22
1651098252274,MATH 20B,A01,083756,Staff,0,14,30,30
1651098252274,MATH 20B,A02,083757,Staff,0,11,30,30
1651098258307,MATH 20C,A01,083760,Staff,1,16,30,29
1651098258307,MATH 20C,A02,083761,Staff,0,16,30,30
1651098258307,MATH 20C,B01,083762,Staff,7,0,30,23
1651098258307,MATH 20C,B02,083763,Staff,27,0,30,3
1651098264335,MATH 20D,A01,083765,Staff,3,1,30,27
1651098264335,MATH 20D,A02,083766,Staff,1,0,30,29
1651098264335,MATH 20D,A03,083767,Staff,22,0,30,8
1651098270361,MATH 20E,A01,083771,Staff,0,0,30,30
1651098270361,MATH 20E,A02,083772,Staff,9,0,30,21
1651098270361,MATH 20E,B01,083773,Staff,5,0,35,30
1651098270361,MATH 20E,B02,083774,Staff,5,1,35,30
1651098276385,MATH 103A,A01,083777,Staff,0,17,30,30
1651098276385,MATH 103A,A02,083778,Staff,0,17,30,30
1651098276385,MATH 103A,B01,083779,Staff,0,15,30,30
1651098276385,MATH 103A,B02,083780,Staff,0,14,30,30
1651098282408,MATH 105,A01,085443,Staff,0,24,30,30
1651098288436,MATH 109,A01,083213,Anzaldo; Leesa B,0,7,30,30
1651098288436,MATH 109,A02,083214,Anzaldo; Leesa B,0,7,30,30
1651098288436,MATH 109,B01,083215,Anzaldo; Leesa B,0,8,30,30
1651098288436,MATH 109,B02,083216,Anzaldo; Leesa B,1,8,30,29
1651098294460,MATH 142A,A01,083219,Chow; Bennett,0,15,30,30
1651098294460,MATH 142A,A02,083220,Chow; Bennett,0,15,30,30
1651098294460,MATH 142A,B01,083221,Chow; Bennett,0,16,30,30
1651098294460,MATH 142A,B02,083222,Chow; Bennett,0,15,30,30
1651098300485,MATH 193A,A01,083224,Staff,0,9,30,30
1651098300485,MATH 193A,A02,083225,Staff,1,7,30,29
1651098300485,MATH 193A,A03,083781,Staff,0,7,30,30
1651098300485,MATH 193A,A04,083782,Staff,0,7,30,30
1651098306521,MATH 197,001,091859,McAuley; Julian John,9998,0,9999,1
1651098312600,COGS 9,A01,083615,Staff,0,20,60,60
1651098318624,COGS 11,A01,083617,Boyle; Mary E. T.,13,0,40,27
1651098324647,COGS 13,A01,083071,Staff,0,38,40,40
1651098330673,COGS 14A,A01,092681,Staff,0,40,100,100
1651098336703,COGS 14B,A01,083073,Cheng; Tzu-Han,0,12,50,50
1651098342741,COGS 17,A01,092677,Staff,8,0,75,67
1651098348769,COGS 100,A01,083619,Staff,0,30,60,60
1651098354792,COGS 101A,A01,083621,Davis; Joshua Daniel,0,29,60,60
1651098360816,COGS 101B,A01,091572,Staff,0,9,60,60
1651098366839,COGS 101C,A01,083625,Delgado; Tania,12,0,30,18
1651098372871,COGS 107A,A01,083627,Boyle; Mary E. T.,0,17,60,60
1651098378896,COGS 118A,A01,083075,Staff,0,10,60,60
1651098384925,CSE 3,A50,083646,Miranda; Gregory Joseph,15,0,38,23
1651098384925,CSE 3,A51,083647,Miranda; Gregory Joseph,36,0,37,1
1651098390948,CSE 8A,A50,083650,Miranda; Gregory Joseph,0,31,40,40
1651098396979,CSE 11,A01,083080,Cao; Yingjun,1,98,40,39
1651098403003,CSE 12,A01,083652,Staff,0,28,100,100
1651098409027,CSE 15L,A01,083654,Staff,0,3,50,50
1651098409027,CSE 15L,A02,083655,Staff,0,3,50,50
1651098415061,CSE 20,A01,083657,Staff,46,0,80,34
1651098421092,CSE 30,A01,083084,Eldon; John,0,38,80,80
1651098427121,CSE 100,A01,083659,Cao; Yingjun,0,72,50,50
1651098433167,CSE 134B,A01,083661,Powell; Thomas Allan,0,38,65,65
1651098439197,CSE 140,A01,083663,Staff,0,17,75,75
1651098445222,CSE 140L,A01,083088,Eldon; John,1,0,100,99
1651098451245,CSE 175,A01,083665,Kumar; Rakesh,0,0,25,25
1651098457272,CSE 190,A00,092507,Dubnov; Shlomo,9,0,20,11
1651098463294,ECE 45,A01,083139,Staff,0,7,60,60
1651098469329,ECE 65,A50,083695,Staff,0,7,30,30
1651098475371,ECE 109,A01,091882,Touri; Behrouz,32,0,70,38
1651098481414,ECE 180,A00,083140,Abi Samra; Nicholas Camill,17,0,30,13
1651098481414,ECE 180,B00,083141,Abi Samra; Nicholas Camill,0,1,30,32
1651098487440,MATH 10A,A01,083735,Patchell; Gregory David,0,0,30,30
1651098487440,MATH 10A,A02,083736,Patchell; Gregory David,26,0,30,4
1651098487440,MATH 10A,A03,083737,Patchell; Gregory David,22,0,30,8
1651098493466,MATH 10B,A01,083207,Staff,0,7,30,30
1651098493466,MATH 10B,A02,083208,Staff,0,6,30,30
1651098493466,MATH 10B,B01,083739,Staff,7,0,30,23
1651098493466,MATH 10B,B02,083740,Staff,28,0,30,2
1651098499491,MATH 18,A01,083743,Staff,0,0,30,30
1651098499491,MATH 18,A02,083744,Staff,23,0,30,7
1651098499491,MATH 18,A03,083745,Staff,19,0,30,11
1651098499491,MATH 18,A04,083746,Staff,26,0,30,4
1651098499491,MATH 18,B01,083748,Staff,0,16,30,30
1651098499491,MATH 18,B02,083749,Staff,0,14,30,30
1651098499491,MATH 18,B03,083750,Staff,0,15,30,30
1651098499491,MATH 18,B04,083751,Staff,0,14,30,30
1651098505514,MATH 20A,A01,083754,Staff,18,0,40,22
1651098511549,MATH 20B,A01,083756,Staff,0,14,30,30
1651098511549,MATH 20B,A02,083757,Staff,0,11,30,30
1651098517572,MATH 20C,A01,083760,Staff,1,16,30,29
1651098517572,MATH 20C,A02,083761,Staff,0,16,30,30
1651098517572,MATH 20C,B01,083762,Staff,7,0,30,23
1651098517572,MATH 20C,B02,083763,Staff,27,0,30,3
1651098523595,MATH 20D,A01,083765,Staff,3,1,30,27
1651098523595,MATH 20D,A02,083766,Staff,1,0,30,29
1651098523595,MATH 20D,A03,083767,Staff,22,0,30,8
1651098529620,MATH 20E,A01,083771,Staff,0,0,30,30
1651098529620,MATH 20E,A02,083772,Staff,9,0,30,21
1651098529620,MATH 20E,B01,083773,Staff,5,0,35,30
1651098529620,MATH 20E,B02,083774,Staff,5,1,35,30
1651098535655,MATH 103A,A01,083777,Staff,0,17,30,30
1651098535655,MATH 103A,A02,083778,Staff,0,17,30,30
1651098535655,MATH 103A,B01,083779,Staff,0,15,30,30
1651098535655,MATH 103A,B02,083780,Staff,0,14,30,30
1651098541677,MATH 105,A01,085443,Staff,0,24,30,30
1651098547705,MATH 109,A01,083213,Anzaldo; Leesa B,0,7,30,30
1651098547705,MATH 109,A02,083214,Anzaldo; Leesa B,0,7,30,30
1651098547705,MATH 109,B01,083215,Anzaldo; Leesa B,0,8,30,30
1651098547705,MATH 109,B02,083216,Anzaldo; Leesa B,1,8,30,29
1651098553729,MATH 142A,A01,083219,Chow; Bennett,0,15,30,30
1651098553729,MATH 142A,A02,083220,Chow; Bennett,0,15,30,30
1651098553729,MATH 142A,B01,083221,Chow; Bennett,0,16,30,30
1651098553729,MATH 142A,B02,083222,Chow; Bennett,0,15,30,30
1651098559756,MATH 193A,A01,083224,Staff,0,9,30,30
1651098559756,MATH 193A,A02,083225,Staff,1,7,30,29
1651098559756,MATH 193A,A03,083781,Staff,0,7,30,30
1651098559756,MATH 193A,A04,083782,Staff,0,7,30,30
1651098565779,MATH 197,001,091859,McAuley; Julian John,9998,0,9999,1
1651098571833,COGS 9,A01,083615,Staff,0,20,60,60
1651098577858,COGS 11,A01,083617,Boyle; Mary E. T.,13,0,40,27
1651098583881,COGS 13,A01,083071,Staff,0,38,40,40
1651098589909,COGS 14A,A01,092681,Staff,0,40,100,100
1651098595935,COGS 14B,A01,083073,Cheng; Tzu-Han,0,12,50,50
1651098601966,COGS 17,A01,092677,Staff,8,0,75,67
1651098607991,COGS 100,A01,083619,Staff,0,30,60,60
1651098614017,COGS 101A,A01,083621,Davis; Joshua Daniel,0,29,60,60
1651098620039,COGS 101B,A01,091572,Staff,0,9,60,60
1651098626066,COGS 101C,A01,083625,Delgado; Tania,12,0,30,18
1651098632099,COGS 107A,A01,083627,Boyle; Mary E. T.,0,17,60,60
1651098638121,COGS 118A,A01,083075,Staff,0,10,60,60
1651098644151,CSE 3,A50,083646,Miranda; Gregory Joseph,15,0,38,23
1651098644151,CSE 3,A51,083647,Miranda; Gregory Joseph,36,0,37,1
1651098650175,CSE 8A,A50,083650,Miranda; Gregory Joseph,0,31,40,40
1651098656204,CSE 11,A01,083080,Cao; Yingjun,1,98,40,39
1651098662230,CSE 12,A01,083652,Staff,0,28,100,100
1651098668254,CSE 15L,A01,083654,Staff,0,3,50,50
1651098668254,CSE 15L,A02,083655,Staff,0,3,50,50
1651098674280,CSE 20,A01,083657,Staff,46,0,80,34
1651098680317,CSE 30,A01,083084,Eldon; John,0,38,80,80
1651098686342,CSE 100,A01,083659,Cao; Yingjun,0,72,50,50
1651098692365,CSE 134B,A01,083661,Powell; Thomas Allan,0,38,65,65
1651098698390,CSE 140,A01,083663,Staff,0,17,75,75
1651098704412,CSE 140L,A01,083088,Eldon; John,1,0,100,99
1651098710434,CSE 175,A01,083665,Kumar; Rakesh,0,0,25,25
1651098716470,CSE 190,A00,092507,Dubnov; Shlomo,9,0,20,11
1651098722493,ECE 45,A01,083139,Staff,0,7,60,60
1651098728520,ECE 65,A50,083695,Staff,0,7,30,30
1651098734547,ECE 109,A01,091882,Touri; Behrouz,32,0,70,38
1651098740569,ECE 180,A00,083140,Abi Samra; Nicholas Camill,17,0,30,13
1651098740569,ECE 180,B00,083141,Abi Samra; Nicholas Camill,0,1,30,32
1651098746596,MATH 10A,A01,083735,Patchell; Gregory David,0,0,30,30
1651098746596,MATH 10A,A02,083736,Patchell; Gregory David,26,0,30,4
1651098746596,MATH 10A,A03,083737,Patchell; Gregory David,22,0,30,8
1651098752708,MATH 10B,A01,083207,Staff,0,7,30,30
1651098752708,MATH 10B,A02,083208,Staff,0,6,30,30
1651098752708,MATH 10B,B01,083739,Staff,7,0,30,23
1651098752708,MATH 10B,B02,083740,Staff,28,0,30,2
1651098758742,MATH 18,A01,083743,Staff,0,0,30,30
1651098758742,MATH 18,A02,083744,Staff,23,0,30,7
1651098758742,MATH 18,A03,083745,Staff,19,0,30,11
1651098758742,MATH 18,A04,083746,Staff,26,0,30,4
1651098758742,MATH 18,B01,083748,Staff,0,16,30,30
1651098758742,MATH 18,B02,083749,Staff,0,14,30,30
1651098758742,MATH 18,B03,083750,Staff,0,15,30,30
1651098758742,MATH 18,B04,083751,Staff,0,14,30,30
1651098764774,MATH 20A,A01,083754,Staff,18,0,40,22
1651098770810,MATH 20B,A01,083756,Staff,0,14,30,30
1651098770810,MATH 20B,A02,083757,Staff,0,11,30,30
1651098776835,MATH 20C,A01,083760,Staff,1,16,30,29
1651098776835,MATH 20C,A02,083761,Staff,0,16,30,30
1651098776835,MATH 20C,B01,083762,Staff,7,0,30,23
1651098776835,MATH 20C,B02,083763,Staff,27,0,30,3
1651098782858,MATH 20D,A01,083765,Staff,3,1,30,27
1651098782858,MATH 20D,A02,083766,Staff,1,0,30,29
1651098782858,MATH 20D,A03,083767,Staff,22,0,30,8
1651098788882,MATH 20E,A01,083771,Staff,0,0,30,30
1651098788882,MATH 20E,A02,083772,Staff,9,0,30,21
1651098788882,MATH 20E,B01,083773,Staff,5,0,35,30
1651098788882,MATH 20E,B02,083774,Staff,5,1,35,30
1651098794911,MATH 103A,A01,083777,Staff,0,17,30,30
1651098794911,MATH 103A,A02,083778,Staff,0,17,30,30
1651098794911,MATH 103A,B01,083779,Staff,0,15,30,30
1651098794911,MATH 103A,B02,083780,Staff,0,14,30,30
1651098800937,MATH 105,A01,085443,Staff,0,24,30,30
1651098806960,MATH 109,A01,083213,Anzaldo; Leesa B,0,7,30,30
1651098806960,MATH 109,A02,083214,Anzaldo; Leesa B,0,7,30,30
1651098806960,MATH 109,B01,083215,Anzaldo; Leesa B,0,8,30,30
1651098806960,MATH 109,B02,083216,Anzaldo; Leesa B,1,8,30,29
1651098812988,MATH 142A,A01,083219,Chow; Bennett,0,15,30,30
1651098812988,MATH 142A,A02,083220,Chow; Bennett,0,15,30,30
1651098812988,MATH 142A,B01,083221,Chow; Bennett,0,16,30,30
1651098812988,MATH 142A,B02,083222,Chow; Bennett,0,15,30,30
1651098819016,MATH 193A,A01,083224,Staff,0,9,30,30
1651098819016,MATH 193A,A02,083225,Staff,1,7,30,29
1651098819016,MATH 193A,A03,083781,Staff,0,7,30,30
1651098819016,MATH 193A,A04,083782,Staff,0,7,30,30
1651098825038,MATH 197,001,091859,McAuley; Julian John,9998,0,9999,1
1651098831094,COGS 9,A01,083615,Staff,0,20,60,60
1651098837127,COGS 11,A01,083617,Boyle; Mary E. T.,13,0,40,27
1651098843165,COGS 13,A01,083071,Staff,0,38,40,40
1651098849188,COGS 14A,A01,092681,Staff,0,40,100,100
1651098855213,COGS 14B,A01,083073,Cheng; Tzu-Han,0,12,50,50
1651098861237,COGS 17,A01,092677,Staff,8,0,75,67
1651098867259,COGS 100,A01,083619,Staff,0,30,60,60
1651098873283,COGS 101A,A01,083621,Davis; Joshua Daniel,0,29,60,60
1651098879307,COGS 101B,A01,091572,Staff,0,9,60,60
1651098885333,COGS 101C,A01,083625,Delgado; Tania,12,0,30,18
1651098891356,COGS 107A,A01,083627,Boyle; Mary E. T.,0,17,60,60
1651098897383,COGS 118A,A01,083075,Staff,0,10,60,60
1651098903407,CSE 3,A50,083646,Miranda; Gregory Joseph,15,0,38,23
1651098903407,CSE 3,A51,083647,Miranda; Gregory Joseph,36,0,37,1
1651098909434,CSE 8A,A50,083650,Miranda; Gregory Joseph,0,31,40,40
1651098915461,CSE 11,A01,083080,Cao; Yingjun,1,98,40,39
1651098921487,CSE 12,A01,083652,Staff,0,28,100,100
1651098927512,CSE 15L,A01,083654,Staff,0,3,50,50
1651098927512,CSE 15L,A02,083655,Staff,0,3,50,50
1651098933536,CSE 20,A01,083657,Staff,46,0,80,34
1651098939559,CSE 30,A01,083084,Eldon; John,0,38,80,80
1651098945583,CSE 100,A01,083659,Cao; Yingjun,0,72,50,50
1651098951610,CSE 134B,A01,083661,Powell; Thomas Allan,0,38,65,65
1651098957636,CSE 140,A01,083663,Staff,0,17,75,75
1651098963668,CSE 140L,A01,083088,Eldon; John,1,0,100,99
1651098969690,CSE 175,A01,083665,Kumar; Rakesh,0,0,25,25
1651098975726,CSE 190,A00,092507,Dubnov; Shlomo,9,0,20,11
1651098981749,ECE 45,A01,083139,Staff,0,7,60,60
1651098987771,ECE 65,A50,083695,Staff,0,7,30,30
1651098993796,ECE 109,A01,091882,Touri; Behrouz,32,0,70,38
1651098999820,ECE 180,A00,083140,Abi Samra; Nicholas Camill,17,0,30,13
1651098999820,ECE 180,B00,083141,Abi Samra; Nicholas Camill,0,1,30,32
1651099005846,MATH 10A,A01,083735,Patchell; Gregory David,0,0,30,30
1651099005846,MATH 10A,A02,083736,Patchell; Gregory David,26,0,30,4
1651099005846,MATH 10A,A03,083737,Patchell; Gregory David,22,0,30,8
1651099011883,MATH 10B,A01,083207,Staff,0,7,30,30
1651099011883,MATH 10B,A02,083208,Staff,0,6,30,30
1651099011883,MATH 10B,B01,083739,Staff,7,0,30,23
1651099011883,MATH 10B,B02,083740,Staff,28,0,30,2
1651099017908,MATH 18,A01,083743,Staff,0,0,30,30
1651099017908,MATH 18,A02,083744,Staff,23,0,30,7
1651099017908,MATH 18,A03,083745,Staff,19,0,30,11
1651099017908,MATH 18,A04,083746,Staff,26,0,30,4
1651099017908,MATH 18,B01,083748,Staff,0,16,30,30
1651099017908,MATH 18,B02,083749,Staff,0,14,30,30
1651099017908,MATH 18,B03,083750,Staff,0,15,30,30
1651099017908,MATH 18,B04,083751,Staff,0,14,30,30
1651099023931,MATH 20A,A01,083754,Staff,18,0,40,22
1651099029957,MATH 20B,A01,083756,Briones; Jor-el Thomas Caparas,0,14,30,30
1651099029957,MATH 20B,A02,083757,Briones; Jor-el Thomas Caparas,0,11,30,30
1651099035992,MATH 20C,A01,083760,Staff,1,16,30,29
1651099035992,MATH 20C,A02,083761,Staff,0,16,30,30
1651099035992,MATH 20C,B01,083762,Staff,7,0,30,23
1651099035992,MATH 20C,B02,083763,Staff,27,0,30,3
1651099042020,MATH 20D,A01,083765,Staff,3,1,30,27
1651099042020,MATH 20D,A02,083766,Staff,1,0,30,29
1651099042020,MATH 20D,A03,083767,Staff,22,0,30,8
1651099048048,MATH 20E,A01,083771,Staff,0,0,30,30
1651099048048,MATH 20E,A02,083772,Staff,9,0,30,21
1651099048048,MATH 20E,B01,083773,Staff,5,0,35,30
1651099048048,MATH 20E,B02,083774,Staff,5,1,35,30
1651099054077,MATH 103A,A01,083777,Staff,0,17,30,30
1651099054077,MATH 103A,A02,083778,Staff,0,17,30,30
1651099054077,MATH 103A,B01,083779,Staff,0,15,30,30
1651099054077,MATH 103A,B02,083780,Staff,0,14,30,30
1651099060103,MATH 105,A01,085443,Staff,0,24,30,30
1651099066125,MATH 109,A01,083213,Anzaldo; Leesa B,0,7,30,30
1651099066125,MATH 109,A02,083214,Anzaldo; Leesa B,0,7,30,30
1651099066125,MATH 109,B01,083215,Anzaldo; Leesa B,0,8,30,30
1651099066125,MATH 109,B02,083216,Anzaldo; Leesa B,1,8,30,29
1651099072153,MATH 142A,A01,083219,Chow; Bennett,0,15,30,30
1651099072153,MATH 142A,A02,083220,Chow; Bennett,0,15,30,30
1651099072153,MATH 142A,B01,083221,Chow; Bennett,0,16,30,30
1651099072153,MATH 142A,B02,083222,Chow; Bennett,0,15,30,30
1651099078183,MATH 193A,A01,083224,Staff,0,9,30,30
1651099078183,MATH 193A,A02,083225,Staff,1,7,30,29
1651099078183,MATH 193A,A03,083781,Staff,0,7,30,30
1651099078183,MATH 193A,A04,083782,Staff,0,7,30,30
1651099084208,MATH 197,001,091859,McAuley; Julian John,9998,0,9999,1
1651099090267,COGS 9,A01,083615,Staff,0,20,60,60
1651099096288,COGS 11,A01,083617,Boyle; Mary E. T.,13,0,40,27
1651099102311,COGS 13,A01,083071,Staff,0,38,40,40
1651099108334,COGS 14A,A01,092681,Staff,0,40,100,100
1651099114372,COGS 14B,A01,083073,Cheng; Tzu-Han,0,12,50,50
1651099120403,COGS 17,A01,092677,Staff,8,0,75,67
1651099126425,COGS 100,A01,083619,Staff,0,30,60,60
1651099132451,COGS 101A,A01,083621,Davis; Joshua Daniel,0,29,60,60
1651099138475,COGS 101B,A01,091572,Staff,0,9,60,60
1651099144505,COGS 101C,A01,083625,Delgado; Tania,12,0,30,18
1651099150542,COGS 107A,A01,083627,Boyle; Mary E. T.,0,17,60,60
1651099156566,COGS 118A,A01,083075,Staff,0,10,60,60
1651099162601,CSE 3,A50,083646,Miranda; Gregory Joseph,15,0,38,23
1651099162601,CSE 3,A51,083647,Miranda; Gregory Joseph,36,0,37,1
1651099168624,CSE 8A,A50,083650,Miranda; Gregory Joseph,0,31,40,40
1651099174648,CSE 11,A01,083080,Cao; Yingjun,1,98,40,39
1651099180674,CSE 12,A01,083652,Staff,0,28,100,100
1651099186704,CSE 15L,A01,083654,Staff,0,3,50,50
1651099186704,CSE 15L,A02,083655,Staff,0,3,50,50
1651099192732,CSE 20,A01,083657,Staff,46,0,80,34
1651099198753,CSE 30,A01,083084,Eldon; John,0,38,80,80
1651099204781,CSE 100,A01,083659,Cao; Yingjun,0,72,50,50
1651099210807,CSE 134B,A01,083661,Powell; Thomas Allan,0,38,65,65
1651099216831,CSE 140,A01,083663,Staff,0,17,75,75
1651099222858,CSE 140L,A01,083088,Eldon; John,1,0,100,99
1651099228887,CSE 175,A01,083665,Kumar; Rakesh,0,0,25,25
1651099234917,CSE 190,A00,092507,Dubnov; Shlomo,9,0,20,11
1651099240940,ECE 45,A01,083139,Staff,0,7,60,60
1651099246964,ECE 65,A50,083695,Staff,0,7,30,30
1651099252986,ECE 109,A01,091882,Touri; Behrouz,32,0,70,38
1651099259021,ECE 180,A00,083140,Abi Samra; Nicholas Camill,17,0,30,13
1651099259021,ECE 180,B00,083141,Abi Samra; Nicholas Camill,0,1,30,32
1651099265061,MATH 10A,A01,083735,Patchell; Gregory David,0,0,30,30
1651099265061,MATH 10A,A02,083736,Patchell; Gregory David,26,0,30,4
1651099265061,MATH 10A,A03,083737,Patchell; Gregory David,22,0,30,8
1651099271101,MATH 10B,A01,083207,Staff,0,7,30,30
1651099271101,MATH 10B,A02,083208,Staff,0,6,30,30
1651099271101,MATH 10B,B01,083739,Staff,7,0,30,23
1651099271101,MATH 10B,B02,083740,Staff,28,0,30,2
1651099277134,MATH 18,A01,083743,Staff,0,0,30,30
1651099277134,MATH 18,A02,083744,Staff,23,0,30,7
1651099277134,MATH 18,A03,083745,Staff,19,0,30,11
1651099277134,MATH 18,A04,083746,Staff,26,0,30,4
1651099277134,MATH 18,B01,083748,Staff,0,16,30,30
1651099277134,MATH 18,B02,083749,Staff,0,14,30,30
1651099277134,MATH 18,B03,083750,Staff,0,15,30,30
1651099277134,MATH 18,B04,083751,Staff,0,14,30,30
1651099283156,MATH 20A,A01,083754,Staff,18,0,40,22
1651099289180,MATH 20B,A01,083756,Briones; Jor-el Thomas Caparas,0,14,30,30
1651099289180,MATH 20B,A02,083757,Briones; Jor-el Thomas Caparas,0,11,30,30
1651099295210,MATH 20C,A01,083760,Briones; Jor-el Thomas Caparas,1,16,30,29
1651099295210,MATH 20C,A02,083761,Briones; Jor-el Thomas Caparas,0,16,30,30
1651099295210,MATH 20C,B01,083762,Staff,7,0,30,23
1651099295210,MATH 20C,B02,083763,Staff,27,0,30,3
1651099301233,MATH 20D,A01,083765,Tran; Brian Kha,3,1,30,27
1651099301233,MATH 20D,A02,083766,Tran; Brian Kha,1,0,30,29
1651099301233,MATH 20D,A03,083767,Tran; Brian Kha,22,0,30,8
1651099307260,MATH 20E,A01,083771,Staff,0,0,30,30
1651099307260,MATH 20E,A02,083772,Staff,9,0,30,21
1651099307260,MATH 20E,B01,083773,Staff,5,0,35,30
1651099307260,MATH 20E,B02,083774,Staff,5,1,35,30
1651099313287,MATH 103A,A01,083777,Staff,0,17,30,30
1651099313287,MATH 103A,A02,083778,Staff,0,17,30,30
1651099313287,MATH 103A,B01,083779,Staff,0,15,30,30
1651099313287,MATH 103A,B02,083780,Staff,0,14,30,30
1651099319316,MATH 105,A01,085443,Staff,0,24,30,30
1651099325343,MATH 109,A01,083213,Anzaldo; Leesa B,0,7,30,30
1651099325343,MATH 109,A02,083214,Anzaldo; Leesa B,0,7,30,30
1651099325343,MATH 109,B01,083215,Anzaldo; Leesa B,0,8,30,30
1651099325343,MATH 109,B02,083216,Anzaldo; Leesa B,1,8,30,29
1651099331372,MATH 142A,A01,083219,Chow; Bennett,0,15,30,30
1651099331372,MATH 142A,A02,083220,Chow; Bennett,0,15,30,30
1651099331372,MATH 142A,B01,083221,Chow; Bennett,0,16,30,30
1651099331372,MATH 142A,B02,083222,Chow; Bennett,0,15,30,30
1651099337396,MATH 193A,A01,083224,Staff,0,9,30,30
1651099337396,MATH 193A,A02,083225,Staff,1,7,30,29
1651099337396,MATH 193A,A03,083781,Staff,0,7,30,30
1651099337396,MATH 193A,A04,083782,Staff,0,7,30,30
1651099343420,MATH 197,001,091859,McAuley; Julian John,9998,0,9999,1
1651099349564,COGS 9,A01,083615,Staff,0,20,60,60
1651099355603,COGS 11,A01,083617,Boyle; Mary E. T.,13,0,40,27
1651099361625,COGS 13,A01,083071,Staff,0,38,40,40
1651099367650,COGS 14A,A01,092681,Staff,0,40,100,100
1651099373673,COGS 14B,A01,083073,Cheng; Tzu-Han,0,12,50,50
1651099379696,COGS 17,A01,092677,Staff,8,0,75,67
1651099385720,COGS 100,A01,083619,Staff,0,30,60,60
1651099391742,COGS 101A,A01,083621,Davis; Joshua Daniel,0,29,60,60
1651099397767,COGS 101B,A01,091572,Staff,0,9,60,60
1651099403789,COGS 101C,A01,083625,Delgado; Tania,12,0,30,18
1651099409814,COGS 107A,A01,083627,Boyle; Mary E. T.,0,17,60,60
1651099415837,COGS 118A,A01,083075,Staff,0,10,60,60
1651099421860,CSE 3,A50,083646,Miranda; Gregory Joseph,15,0,38,23
1651099421860,CSE 3,A51,083647,Miranda; Gregory Joseph,36,0,37,1
1651099427884,CSE 8A,A50,083650,Miranda; Gregory Joseph,0,31,40,40
1651099433906,CSE 11,A01,083080,Cao; Yingjun,1,98,40,39
1651099439929,CSE 12,A01,083652,Staff,0,28,100,100
1651099445953,CSE 15L,A01,083654,Staff,0,3,50,50
1651099445953,CSE 15L,A02,083655,Staff,0,3,50,50
1651099451976,CSE 20,A01,083657,Staff,46,0,80,34
1651099457998,CSE 30,A01,083084,Eldon; John,0,38,80,80
1651099464039,CSE 100,A01,083659,Cao; Yingjun,0,72,50,50
1651099470065,CSE 134B,A01,083661,Powell; Thomas Allan,0,38,65,65
1651099476089,CSE 140,A01,083663,Staff,0,17,75,75
1651099482111,CSE 140L,A01,083088,Eldon; John,1,0,100,99
1651099488133,CSE 175,A01,083665,Kumar; Rakesh,0,0,25,25
1651099494159,CSE 190,A00,092507,Dubnov; Shlomo,9,0,20,11
1651099500182,ECE 45,A01,083139,Staff,0,7,60,60
1651099506213,ECE 65,A50,083695,Staff,0,7,30,30
1651099512240,ECE 109,A01,091882,Touri; Behrouz,32,0,70,38
1651099518268,ECE 180,A00,083140,Abi Samra; Nicholas Camill,17,0,30,13
1651099518268,ECE 180,B00,083141,Abi Samra; Nicholas Camill,0,1,30,32
1651099524292,MATH 10A,A01,083735,Patchell; Gregory David,0,0,30,30
1651099524292,MATH 10A,A02,083736,Patchell; Gregory David,26,0,30,4
1651099524292,MATH 10A,A03,083737,Patchell; Gregory David,22,0,30,8
1651099530315,MATH 10B,A01,083207,Staff,0,7,30,30
1651099530315,MATH 10B,A02,083208,Staff,0,6,30,30
1651099530315,MATH 10B,B01,083739,Staff,7,0,30,23
1651099530315,MATH 10B,B02,083740,Staff,28,0,30,2
1651099536346,MATH 18,A01,083743,Staff,0,0,30,30
1651099536346,MATH 18,A02,083744,Staff,23,0,30,7
1651099536346,MATH 18,A03,083745,Staff,19,0,30,11
1651099536346,MATH 18,A04,083746,Staff,26,0,30,4
1651099536346,MATH 18,B01,083748,Staff,0,16,30,30
1651099536346,MATH 18,B02,083749,Staff,0,14,30,30
1651099536346,MATH 18,B03,083750,Staff,0,15,30,30
1651099536346,MATH 18,B04,083751,Staff,0,14,30,30
1651099542378,MATH 20A,A01,083754,Staff,18,0,40,22
1651099548409,MATH 20B,A01,083756,Briones; Jor-el Thomas Caparas,0,14,30,30
1651099548409,MATH 20B,A02,083757,Briones; Jor-el Thomas Caparas,0,11,30,30
1651099554436,MATH 20C,A01,083760,Briones; Jor-el Thomas Caparas,1,16,30,29
1651099554436,MATH 20C,A02,083761,Briones; Jor-el Thomas Caparas,0,16,30,30
1651099554436,MATH 20C,B01,083762,Staff,7,0,30,23
1651099554436,MATH 20C,B02,083763,Staff,27,0,30,3
1651099560464,MATH 20D,A01,083765,Tran; Brian Kha,3,1,30,27
1651099560464,MATH 20D,A02,083766,Tran; Brian Kha,1,0,30,29
1651099560464,MATH 20D,A03,083767,Tran; Brian Kha,22,0,30,8
1651099566492,MATH 20E,A01,083771,Staff,0,0,30,30
1651099566492,MATH 20E,A02,083772,Staff,9,0,30,21
1651099566492,MATH 20E,B01,083773,Staff,5,0,35,30
1651099566492,MATH 20E,B02,083774,Staff,5,1,35,30
1651099572514,MATH 103A,A01,083777,Greenfeld; Be'Eri,0,17,30,30
1651099572514,MATH 103A,A02,083778,Greenfeld; Be'Eri,0,17,30,30
1651099572514,MATH 103A,B01,083779,Greenfeld; Be'Eri,0,15,30,30
1651099572514,MATH 103A,B02,083780,Greenfeld; Be'Eri,0,14,30,30
1651099578545,MATH 105,A01,085443,Staff,0,24,30,30
1651099584572,MATH 109,A01,083213,Anzaldo; Leesa B,0,7,30,30
1651099584572,MATH 109,A02,083214,Anzaldo; Leesa B,0,7,30,30
1651099584572,MATH 109,B01,083215,Anzaldo; Leesa B,0,8,30,30
1651099584572,MATH 109,B02,083216,Anzaldo; Leesa B,1,8,30,29
1651099590597,MATH 142A,A01,083219,Chow; Bennett,0,15,30,30
1651099590597,MATH 142A,A02,083220,Chow; Bennett,0,15,30,30
1651099590597,MATH 142A,B01,083221,Chow; Bennett,0,16,30,30
1651099590597,MATH 142A,B02,083222,Chow; Bennett,0,15,30,30
1651099596633,MATH 193A,A01,083224,Staff,0,9,30,30
1651099596633,MATH 193A,A02,083225,Staff,1,7,30,29
1651099596633,MATH 193A,A03,083781,Staff,0,7,30,30
1651099596633,MATH 193A,A04,083782,Staff,0,7,30,30
1651099602664,MATH 197,001,091859,McAuley; Julian John,9998,0,9999,1
1651099608732,COGS 9,A01,083615,Staff,0,20,60,60
1651099614754,COGS 11,A01,083617,Boyle; Mary E. T.,13,0,40,27
1651099620782,COGS 13,A01,083071,Staff,0,38,40,40
1651099626806,COGS 14A,A01,092681,Staff,0,40,100,100
1651099632830,COGS 14B,A01,083073,Cheng; Tzu-Han,0,11,50,50
1651099638853,COGS 17,A01,092677,Staff,8,0,75,67
1651099644887,COGS 100,A01,083619,Staff,0,30,60,60
1651099650909,COGS 101A,A01,083621,Davis; Joshua Daniel,0,29,60,60
1651099656935,COGS 101B,A01,091572,Staff,0,9,60,60
1651099662959,COGS 101C,A01,083625,Delgado; Tania,12,0,30,18
1651099668983,COGS 107A,A01,083627,Boyle; Mary E. T.,0,17,60,60
1651099675009,COGS 118A,A01,083075,Staff,0,10,60,60
1651099681043,CSE 3,A50,083646,Miranda; Gregory Joseph,15,0,38,23
1651099681043,CSE 3,A51,083647,Miranda; Gregory Joseph,36,0,37,1
1651099687070,CSE 8A,A50,083650,Miranda; Gregory Joseph,0,31,40,40
1651099693096,CSE 11,A01,083080,Cao; Yingjun,1,98,40,39
1651099699123,CSE 12,A01,083652,Staff,0,28,100,100
1651099705153,CSE 15L,A01,083654,Staff,0,3,50,50
1651099705153,CSE 15L,A02,083655,Staff,0,3,50,50
1651099711179,CSE 20,A01,083657,Staff,46,0,80,34
1651099717205,CSE 30,A01,083084,Eldon; John,0,38,80,80
1651099723231,CSE 100,A01,083659,Cao; Yingjun,0,72,50,50
1651099729255,CSE 134B,A01,083661,Powell; Thomas Allan,0,38,65,65
1651099735279,CSE 140,A01,083663,Staff,0,17,75,75
1651099741307,CSE 140L,A01,083088,Eldon; John,1,0,100,99
1651099747337,CSE 175,A01,083665,Kumar; Rakesh,0,0,25,25
1651099753363,CSE 190,A00,092507,Dubnov; Shlomo,9,0,20,11
1651099759387,ECE 45,A01,083139,Staff,0,7,60,60
1651099765410,ECE 65,A50,083695,Staff,0,7,30,30
1651099771434,ECE 109,A01,091882,Touri; Behrouz,32,0,70,38
1651099777457,ECE 180,A00,083140,Abi Samra; Nicholas Camill,17,0,30,13
1651099777457,ECE 180,B00,083141,Abi Samra; Nicholas Camill,0,1,30,32
1651099783482,MATH 10A,A01,083735,Patchell; Gregory David,0,0,30,30
1651099783482,MATH 10A,A02,083736,Patchell; Gregory David,26,0,30,4
1651099783482,MATH 10A,A03,083737,Patchell; Gregory David,22,0,30,8
1651099789515,MATH 10B,A01,083207,Staff,0,7,30,30
1651099789515,MATH 10B,A02,083208,Staff,0,6,30,30
1651099789515,MATH 10B,B01,083739,Staff,7,0,30,23
1651099789515,MATH 10B,B02,083740,Staff,28,0,30,2
1651099795541,MATH 18,A01,083743,Staff,0,0,30,30
1651099795541,MATH 18,A02,083744,Staff,23,0,30,7
1651099795541,MATH 18,A03,083745,Staff,19,0,30,11
1651099795541,MATH 18,A04,083746,Staff,26,0,30,4
1651099795541,MATH 18,B01,083748,Staff,0,16,30,30
1651099795541,MATH 18,B02,083749,Staff,0,14,30,30
1651099795541,MATH 18,B03,083750,Staff,0,15,30,30
1651099795541,MATH 18,B04,083751,Staff,0,14,30,30
1651099801566,MATH 20A,A01,083754,Staff,18,0,40,22
1651099807611,MATH 20B,A01,083756,Briones; Jor-el Thomas Caparas,0,14,30,30
1651099807611,MATH 20B,A02,083757,Briones; Jor-el Thomas Caparas,0,11,30,30
1651099813636,MATH 20C,A01,083760,Briones; Jor-el Thomas Caparas,1,16,30,29
1651099813636,MATH 20C,A02,083761,Briones; Jor-el Thomas Caparas,0,16,30,30
1651099813636,MATH 20C,B01,083762,Staff,7,0,30,23
1651099813636,MATH 20C,B02,083763,Staff,27,0,30,3
1651099819660,MATH 20D,A01,083765,Tran; Brian Kha,3,1,30,27
1651099819660,MATH 20D,A02,083766,Tran; Brian Kha,1,0,30,29
1651099819660,MATH 20D,A03,083767,Tran; Brian Kha,22,0,30,8
1651099825690,MATH 20E,A01,083771,Staff,0,0,30,30
1651099825690,MATH 20E,A02,083772,Staff,9,0,30,21
1651099825690,MATH 20E,B01,083773,Staff,5,0,35,30
1651099825690,MATH 20E,B02,083774,Staff,5,1,35,30
1651099831714,MATH 103A,A01,083777,Greenfeld; Be'Eri,0,17,30,30
1651099831714,MATH 103A,A02,083778,Greenfeld; Be'Eri,0,17,30,30
1651099831714,MATH 103A,B01,083779,Greenfeld; Be'Eri,0,15,30,30
1651099831714,MATH 103A,B02,083780,Greenfeld; Be'Eri,0,14,30,30
1651099837743,MATH 105,A01,085443,Staff,0,24,30,30
1651099843764,MATH 109,A01,083213,Anzaldo; Leesa B,0,7,30,30
1651099843764,MATH 109,A02,083214,Anzaldo; Leesa B,0,7,30,30
1651099843764,MATH 109,B01,083215,Anzaldo; Leesa B,0,8,30,30
1651099843764,MATH 109,B02,083216,Anzaldo; Leesa B,1,8,30,29
1651099849794,MATH 142A,A01,083219,Chow; Bennett,0,15,30,30
1651099849794,MATH 142A,A02,083220,Chow; Bennett,0,15,30,30
1651099849794,MATH 142A,B01,083221,Chow; Bennett,0,16,30,30
1651099849794,MATH 142A,B02,083222,Chow; Bennett,0,15,30,30
1651099855827,MATH 193A,A01,083224,Staff,0,9,30,30
1651099855827,MATH 193A,A02,083225,Staff,1,7,30,29
1651099855827,MATH 193A,A03,083781,Staff,0,7,30,30
1651099855827,MATH 193A,A04,083782,Staff,0,7,30,30
1651099861850,MATH 197,001,091859,McAuley; Julian John,9998,0,9999,1
1651099867907,COGS 9,A01,083615,Staff,0,20,60,60
1651099873930,COGS 11,A01,083617,Boyle; Mary E. T.,13,0,40,27
1651099879953,COGS 13,A01,083071,Staff,0,38,40,40
1651099885979,COGS 14A,A01,092681,Staff,0,40,100,100
1651099892014,COGS 14B,A01,083073,Cheng; Tzu-Han,0,11,50,50
1651099898038,COGS 17,A01,092677,Staff,8,0,75,67
1651099904068,COGS 100,A01,083619,Staff,0,30,60,60
1651099910093,COGS 101A,A01,083621,Davis; Joshua Daniel,0,29,60,60
1651099916119,COGS 101B,A01,091572,Staff,0,9,60,60
1651099922145,COGS 101C,A01,083625,Delgado; Tania,12,0,30,18
1651099928172,COGS 107A,A01,083627,Boyle; Mary E. T.,0,17,60,60
1651099934196,COGS 118A,A01,083075,Staff,0,10,60,60
1651099940350,CSE 3,A50,083646,Miranda; Gregory Joseph,15,0,38,23
1651099940350,CSE 3,A51,083647,Miranda; Gregory Joseph,36,0,37,1
1651099946373,CSE 8A,A50,083650,Miranda; Gregory Joseph,0,31,40,40
1651099952398,CSE 11,A01,083080,Cao; Yingjun,1,98,40,39
1651099958424,CSE 12,A01,083652,Staff,0,28,100,100
1651099964454,CSE 15L,A01,083654,Staff,0,3,50,50
1651099964454,CSE 15L,A02,083655,Staff,0,3,50,50
1651099970480,CSE 20,A01,083657,Staff,46,0,80,34
1651099976511,CSE 30,A01,083084,Eldon; John,0,38,80,80
1651099982536,CSE 100,A01,083659,Cao; Yingjun,0,72,50,50
1651099988562,CSE 134B,A01,083661,Powell; Thomas Allan,0,38,65,65
1651099994585,CSE 140,A01,083663,Staff,0,17,75,75
1651100000625,CSE 140L,A01,083088,Eldon; John,1,0,100,99
1651100006647,CSE 175,A01,083665,Kumar; Rakesh,0,0,25,25
1651100012670,CSE 190,A00,092507,Dubnov; Shlomo,9,0,20,11
1651100018694,ECE 45,A01,083139,Staff,0,7,60,60
1651100024718,ECE 65,A50,083695,Staff,0,7,30,30
1651100030744,ECE 109,A01,091882,Touri; Behrouz,32,0,70,38
1651100036769,ECE 180,A00,083140,Abi Samra; Nicholas Camill,17,0,30,13
1651100036769,ECE 180,B00,083141,Abi Samra; Nicholas Camill,0,1,30,32
1651100042792,MATH 10A,A01,083735,Patchell; Gregory David,0,0,30,30
1651100042792,MATH 10A,A02,083736,Patchell; Gregory David,26,0,30,4
1651100042792,MATH 10A,A03,083737,Patchell; Gregory David,22,0,30,8
1651100048826,MATH 10B,A01,083207,Staff,0,7,30,30
1651100048826,MATH 10B,A02,083208,Staff,0,6,30,30
1651100048826,MATH 10B,B01,083739,Staff,7,0,30,23
1651100048826,MATH 10B,B02,083740,Staff,28,0,30,2
1651100054855,MATH 18,A01,083743,Staff,0,0,30,30
1651100054855,MATH 18,A02,083744,Staff,23,0,30,7
1651100054855,MATH 18,A03,083745,Staff,19,0,30,11
1651100054855,MATH 18,A04,083746,Staff,26,0,30,4
1651100054855,MATH 18,B01,083748,Staff,0,16,30,30
1651100054855,MATH 18,B02,083749,Staff,0,14,30,30
1651100054855,MATH 18,B03,083750,Staff,0,15,30,30
1651100054855,MATH 18,B04,083751,Staff,0,14,30,30
1651100060878,MATH 20A,A01,083754,Staff,18,0,40,22
1651100066904,MATH 20B,A01,083756,Briones; Jor-el Thomas Caparas,0,14,30,30
1651100066904,MATH 20B,A02,083757,Briones; Jor-el Thomas Caparas,0,11,30,30
1651100072933,MATH 20C,A01,083760,Briones; Jor-el Thomas Caparas,1,16,30,29
1651100072933,MATH 20C,A02,083761,Briones; Jor-el Thomas Caparas,0,16,30,30
1651100072933,MATH 20C,B01,083762,Staff,7,0,30,23
1651100072933,MATH 20C,B02,083763,Staff,27,0,30,3
1651100078955,MATH 20D,A01,083765,Tran; Brian Kha,3,1,30,27
1651100078955,MATH 20D,A02,083766,Tran; Brian Kha,1,0,30,29
1651100078955,MATH 20D,A03,083767,Tran; Brian Kha,22,0,30,8
1651100084977,MATH 20E,A01,083771,Staff,0,0,30,30
1651100084977,MATH 20E,A02,083772,Staff,9,0,30,21
1651100084977,MATH 20E,B01,083773,Staff,5,0,35,30
1651100084977,MATH 20E,B02,083774,Staff,5,1,35,30
1651100091006,MATH 103A,A01,083777,Greenfeld; Be'Eri,0,17,30,30
1651100091006,MATH 103A,A02,083778,Greenfeld; Be'Eri,0,17,30,30
1651100091006,MATH 103A,B01,083779,Greenfeld; Be'Eri,0,15,30,30
1651100091006,MATH 103A,B02,083780,Greenfeld; Be'Eri,0,14,30,30
1651100097037,MATH 105,A01,085443,Staff,0,24,30,30
1651100103065,MATH 109,A01,083213,Anzaldo; Leesa B,0,7,30,30
1651100103065,MATH 109,A02,083214,Anzaldo; Leesa B,0,7,30,30
1651100103065,MATH 109,B01,083215,Anzaldo; Leesa B,0,8,30,30
1651100103065,MATH 109,B02,083216,Anzaldo; Leesa B,1,8,30,29
1651100109091,MATH 142A,A01,083219,Chow; Bennett,0,15,30,30
1651100109091,MATH 142A,A02,083220,Chow; Bennett,0,15,30,30
1651100109091,MATH 142A,B01,083221,Chow; Bennett,0,16,30,30
1651100109091,MATH 142A,B02,083222,Chow; Bennett,0,15,30,30
1651100115117,MATH 193A,A01,083224,Staff,0,9,30,30
1651100115117,MATH 193A,A02,083225,Staff,1,7,30,29
1651100115117,MATH 193A,A03,083781,Staff,0,7,30,30
1651100115117,MATH 193A,A04,083782,Staff,0,7,30,30
1651100121139,MATH 197,001,091859,McAuley; Julian John,9998,0,9999,1
1651100127196,COGS 9,A01,083615,Staff,0,20,60,60
1651100133223,COGS 11,A01,083617,Boyle; Mary E. T.,13,0,40,27
1651100139263,COGS 13,A01,083071,Staff,0,38,40,40
1651100145295,COGS 14A,A01,092681,Staff,0,40,100,100
1651100151321,COGS 14B,A01,083073,Cheng; Tzu-Han,0,11,50,50
1651100157347,COGS 17,A01,092677,Staff,8,0,75,67
1651100163381,COGS 100,A01,083619,Staff,0,30,60,60
1651100169408,COGS 101A,A01,083621,Davis; Joshua Daniel,0,29,60,60
1651100175431,COGS 101B,A01,091572,Staff,0,9,60,60
1651100181457,COGS 101C,A01,083625,Delgado; Tania,12,0,30,18
1651100187484,COGS 107A,A01,083627,Boyle; Mary E. T.,0,17,60,60
1651100193510,COGS 118A,A01,083075,Staff,0,10,60,60
1651100199535,CSE 3,A50,083646,Miranda; Gregory Joseph,15,0,38,23
1651100199535,CSE 3,A51,083647,Miranda; Gregory Joseph,36,0,37,1
1651100205557,CSE 8A,A50,083650,Miranda; Gregory Joseph,0,31,40,40
1651100211581,CSE 11,A01,083080,Cao; Yingjun,1,98,40,39
1651100217607,CSE 12,A01,083652,Staff,0,28,100,100
1651100223647,CSE 15L,A01,083654,Staff,0,3,50,50
1651100223647,CSE 15L,A02,083655,Staff,0,3,50,50
1651100229670,CSE 20,A01,083657,Staff,46,0,80,34
1651100235693,CSE 30,A01,083084,Eldon; John,0,38,80,80
1651100241721,CSE 100,A01,083659,Cao; Yingjun,0,72,50,50
1651100247744,CSE 134B,A01,083661,Powell; Thomas Allan,0,38,65,65
1651100253772,CSE 140,A01,083663,Staff,0,17,75,75
1651100259798,CSE 140L,A01,083088,Eldon; John,1,0,100,99
1651100265824,CSE 175,A01,083665,Kumar; Rakesh,0,0,25,25
1651100271850,CSE 190,A00,092507,Dubnov; Shlomo,9,0,20,11
1651100277873,ECE 45,A01,083139,Staff,0,8,60,60
1651100283900,ECE 65,A50,083695,Staff,0,7,30,30
1651100289925,ECE 109,A01,091882,Touri; Behrouz,32,0,70,38
1651100295960,ECE 180,A00,083140,Abi Samra; Nicholas Camill,17,0,30,13
1651100295960,ECE 180,B00,083141,Abi Samra; Nicholas Camill,0,1,30,32
1651100301987,MATH 10A,A01,083735,Patchell; Gregory David,0,0,30,30
1651100301987,MATH 10A,A02,083736,Patchell; Gregory David,26,0,30,4
1651100301987,MATH 10A,A03,083737,Patchell; Gregory David,22,0,30,8
1651100308009,MATH 10B,A01,083207,Staff,0,7,30,30
1651100308009,MATH 10B,A02,083208,Staff,0,6,30,30
1651100308009,MATH 10B,B01,083739,Staff,7,0,30,23
1651100308009,MATH 10B,B02,083740,Staff,28,0,30,2
1651100314034,MATH 18,A01,083743,Staff,0,0,30,30
1651100314034,MATH 18,A02,083744,Staff,23,0,30,7
1651100314034,MATH 18,A03,083745,Staff,19,0,30,11
1651100314034,MATH 18,A04,083746,Staff,26,0,30,4
1651100314034,MATH 18,B01,083748,Staff,0,16,30,30
1651100314034,MATH 18,B02,083749,Staff,0,14,30,30
1651100314034,MATH 18,B03,083750,Staff,0,15,30,30
1651100314034,MATH 18,B04,083751,Staff,0,14,30,30
1651100320060,MATH 20A,A01,083754,Staff,18,0,40,22
1651100326083,MATH 20B,A01,083756,Briones; Jor-el Thomas Caparas,0,14,30,30
1651100326083,MATH 20B,A02,083757,Briones; Jor-el Thomas Caparas,0,11,30,30
1651100332114,MATH 20C,A01,083760,Briones; Jor-el Thomas Caparas,1,16,30,29
1651100332114,MATH 20C,A02,083761,Briones; Jor-el Thomas Caparas,0,16,30,30
1651100332114,MATH 20C,B01,083762,Staff,7,0,30,23
1651100332114,MATH 20C,B02,083763,Staff,27,0,30,3
1651100338141,MATH 20D,A01,083765,Tran; Brian Kha,3,1,30,27
1651100338141,MATH 20D,A02,083766,Tran; Brian Kha,1,0,30,29
1651100338141,MATH 20D,A03,083767,Tran; Brian Kha,22,0,30,8
1651100344167,MATH 20E,A01,083771,Staff,0,0,30,30
1651100344167,MATH 20E,A02,083772,Staff,9,0,30,21
1651100344167,MATH 20E,B01,083773,Staff,5,0,35,30
1651100344167,MATH 20E,B02,083774,Staff,5,1,35,30
1651100350204,MATH 103A,A01,083777,Greenfeld; Be'Eri,0,17,30,30
1651100350204,MATH 103A,A02,083778,Greenfeld; Be'Eri,0,17,30,30
1651100350204,MATH 103A,B01,083779,Greenfeld; Be'Eri,0,15,30,30
1651100350204,MATH 103A,B02,083780,Greenfeld; Be'Eri,0,14,30,30
1651100356229,MATH 105,A01,085443,Staff,0,24,30,30
1651100362255,MATH 109,A01,083213,Anzaldo; Leesa B,0,7,30,30
1651100362255,MATH 109,A02,083214,Anzaldo; Leesa B,0,7,30,30
1651100362255,MATH 109,B01,083215,Anzaldo; Leesa B,0,8,30,30
1651100362255,MATH 109,B02,083216,Anzaldo; Leesa B,1,8,30,29
1651100368279,MATH 142A,A01,083219,Chow; Bennett,0,15,30,30
1651100368279,MATH 142A,A02,083220,Chow; Bennett,0,15,30,30
1651100368279,MATH 142A,B01,083221,Chow; Bennett,0,16,30,30
1651100368279,MATH 142A,B02,083222,Chow; Bennett,0,15,30,30
1651100374318,MATH 193A,A01,083224,Staff,0,9,30,30
1651100374318,MATH 193A,A02,083225,Staff,1,7,30,29
1651100374318,MATH 193A,A03,083781,Staff,0,7,30,30
1651100374318,MATH 193A,A04,083782,Staff,0,7,30,30
1651100380344,MATH 197,001,091859,McAuley; Julian John,9998,0,9999,1
1651100386405,COGS 9,A01,083615,Staff,0,20,60,60
1651100392432,COGS 11,A01,083617,Boyle; Mary E. T.,13,0,40,27
1651100398455,COGS 13,A01,083071,Staff,0,38,40,40
1651100404493,COGS 14A,A01,092681,Staff,0,40,100,100
1651100410535,COGS 14B,A01,083073,Cheng; Tzu-Han,0,11,50,50
1651100416561,COGS 17,A01,092677,Staff,8,0,75,67
1651100422584,COGS 100,A01,083619,Staff,0,30,60,60
1651100428608,COGS 101A,A01,083621,Davis; Joshua Daniel,0,29,60,60
1651100434634,COGS 101B,A01,091572,Staff,0,9,60,60
1651100440661,COGS 101C,A01,083625,Delgado; Tania,12,0,30,18
1651100446688,COGS 107A,A01,083627,Boyle; Mary E. T.,0,17,60,60
1651100452714,COGS 118A,A01,083075,Staff,0,10,60,60
1651100458748,CSE 3,A50,083646,Miranda; Gregory Joseph,15,0,38,23
1651100458748,CSE 3,A51,083647,Miranda; Gregory Joseph,36,0,37,1
1651100464778,CSE 8A,A50,083650,Miranda; Gregory Joseph,0,31,40,40
1651100470805,CSE 11,A01,083080,Cao; Yingjun,1,98,40,39
1651100476830,CSE 12,A01,083652,Staff,0,28,100,100
1651100482855,CSE 15L,A01,083654,Staff,0,3,50,50
1651100482855,CSE 15L,A02,083655,Staff,0,3,50,50
1651100488883,CSE 20,A01,083657,Staff,46,0,80,34
1651100494907,CSE 30,A01,083084,Eldon; John,0,38,80,80
1651100500940,CSE 100,A01,083659,Cao; Yingjun,0,72,50,50
1651100506966,CSE 134B,A01,083661,Powell; Thomas Allan,0,38,65,65
1651100512989,CSE 140,A01,083663,Staff,0,17,75,75
1651100519015,CSE 140L,A01,083088,Eldon; John,1,0,100,99
1651100525037,CSE 175,A01,083665,Kumar; Rakesh,0,0,25,25
1651100531061,CSE 190,A00,092507,Dubnov; Shlomo,9,0,20,11
1651100537180,ECE 45,A01,083139,Staff,0,8,60,60
1651100543206,ECE 65,A50,083695,Staff,0,7,30,30
1651100549232,ECE 109,A01,091882,Touri; Behrouz,32,0,70,38
1651100555254,ECE 180,A00,083140,Abi Samra; Nicholas Camill,17,0,30,13
1651100555254,ECE 180,B00,083141,Abi Samra; Nicholas Camill,0,1,30,32
1651100561277,MATH 10A,A01,083735,Patchell; Gregory David,0,0,30,30
1651100561277,MATH 10A,A02,083736,Patchell; Gregory David,26,0,30,4
1651100561277,MATH 10A,A03,083737,Patchell; Gregory David,22,0,30,8
1651100567304,MATH 10B,A01,083207,Staff,0,7,30,30
1651100567304,MATH 10B,A02,083208,Staff,0,6,30,30
1651100567304,MATH 10B,B01,083739,Staff,7,0,30,23
1651100567304,MATH 10B,B02,083740,Staff,28,0,30,2
1651100573333,MATH 18,A01,083743,Staff,0,0,30,30
1651100573333,MATH 18,A02,083744,Staff,23,0,30,7
1651100573333,MATH 18,A03,083745,Staff,19,0,30,11
1651100573333,MATH 18,A04,083746,Staff,26,0,30,4
1651100573333,MATH 18,B01,083748,Staff,0,16,30,30
1651100573333,MATH 18,B02,083749,Staff,0,14,30,30
1651100573333,MATH 18,B03,083750,Staff,0,15,30,30
1651100573333,MATH 18,B04,083751,Staff,0,14,30,30
1651100579369,MATH 20A,A01,083754,Staff,18,0,40,22
1651100585394,MATH 20B,A01,083756,Briones; Jor-el Thomas Caparas,0,14,30,30
1651100585394,MATH 20B,A02,083757,Briones; Jor-el Thomas Caparas,0,11,30,30
1651100591420,MATH 20C,A01,083760,Briones; Jor-el Thomas Caparas,1,17,30,29
1651100591420,MATH 20C,A02,083761,Briones; Jor-el Thomas Caparas,0,16,30,30
1651100591420,MATH 20C,B01,083762,Staff,7,0,30,23
1651100591420,MATH 20C,B02,083763,Staff,27,0,30,3
1651100597451,MATH 20D,A01,083765,Tran; Brian Kha,3,1,30,27
1651100597451,MATH 20D,A02,083766,Tran; Brian Kha,1,0,30,29
1651100597451,MATH 20D,A03,083767,Tran; Brian Kha,22,0,30,8
1651100603473,MATH 20E,A01,083771,Staff,0,0,30,30
1651100603473,MATH 20E,A02,083772,Staff,9,0,30,21
1651100603473,MATH 20E,B01,083773,Staff,5,0,35,30
1651100603473,MATH 20E,B02,083774,Staff,5,1,35,30
1651100609504,MATH 103A,A01,083777,Greenfeld; Be'Eri,0,17,30,30
1651100609504,MATH 103A,A02,083778,Greenfeld; Be'Eri,0,17,30,30
1651100609504,MATH 103A,B01,083779,Greenfeld; Be'Eri,0,15,30,30
1651100609504,MATH 103A,B02,083780,Greenfeld; Be'Eri,0,14,30,30
1651100615533,MATH 105,A01,085443,Staff,0,24,30,30
1651100621556,MATH 109,A01,083213,Anzaldo; Leesa B,0,7,30,30
1651100621556,MATH 109,A02,083214,Anzaldo; Leesa B,0,7,30,30
1651100621556,MATH 109,B01,083215,Anzaldo; Leesa B,0,8,30,30
1651100621556,MATH 109,B02,083216,Anzaldo; Leesa B,1,8,30,29
1651100627578,MATH 142A,A01,083219,Chow; Bennett,0,15,30,30
1651100627578,MATH 142A,A02,083220,Chow; Bennett,0,15,30,30
1651100627578,MATH 142A,B01,083221,Chow; Bennett,0,16,30,30
1651100627578,MATH 142A,B02,083222,Chow; Bennett,0,15,30,30
1651100633605,MATH 193A,A01,083224,Staff,0,9,30,30
1651100633605,MATH 193A,A02,083225,Staff,1,7,30,29
1651100633605,MATH 193A,A03,083781,Staff,0,7,30,30
1651100633605,MATH 193A,A04,083782,Staff,0,7,30,30
1651100639629,MATH 197,001,091859,McAuley; Julian John,9998,0,9999,1
1651100645677,COGS 9,A01,083615,Staff,0,20,60,60
1651100651707,COGS 11,A01,083617,Boyle; Mary E. T.,13,0,40,27
1651100657730,COGS 13,A01,083071,Staff,0,38,40,40
1651100663754,COGS 14A,A01,092681,Staff,0,40,100,100
1651100669778,COGS 14B,A01,083073,Cheng; Tzu-Han,0,11,50,50
1651100675808,COGS 17,A01,092677,Staff,8,0,75,67
1651100681843,COGS 100,A01,083619,Staff,0,30,60,60
1651100687869,COGS 101A,A01,083621,Davis; Joshua Daniel,0,29,60,60
1651100693904,COGS 101B,A01,091572,Staff,0,9,60,60
1651100699927,COGS 101C,A01,083625,Delgado; Tania,12,0,30,18
1651100705953,COGS 107A,A01,083627,Boyle; Mary E. T.,0,17,60,60
1651100711975,COGS 118A,A01,083075,Staff,0,10,60,60
1651100718003,CSE 3,A50,083646,Miranda; Gregory Joseph,15,0,38,23
1651100718003,CSE 3,A51,083647,Miranda; Gregory Joseph,36,0,37,1
1651100724048,CSE 8A,A50,083650,Miranda; Gregory Joseph,0,31,40,40
1651100730086,CSE 11,A01,083080,Cao; Yingjun,1,98,40,39
1651100736109,CSE 12,A01,083652,Staff,0,29,100,100
1651100742136,CSE 15L,A01,083654,Staff,0,3,50,50
1651100742136,CSE 15L,A02,083655,Staff,0,3,50,50
1651100748159,CSE 20,A01,083657,Staff,46,0,80,34
1651100754188,CSE 30,A01,083084,Eldon; John,0,38,80,80
1651100760212,CSE 100,A01,083659,Cao; Yingjun,0,72,50,50
1651100766239,CSE 134B,A01,083661,Powell; Thomas Allan,0,38,65,65
1651100772261,CSE 140,A01,083663,Staff,0,17,75,75
1651100778285,CSE 140L,A01,083088,Eldon; John,1,0,100,99
1651100784311,CSE 175,A01,083665,Kumar; Rakesh,0,0,25,25
1651100790335,CSE 190,A00,092507,Dubnov; Shlomo,9,0,20,11
1651100796360,ECE 45,A01,083139,Staff,0,8,60,60
1651100802386,ECE 65,A50,083695,Staff,0,7,30,30
1651100808409,ECE 109,A01,091882,Touri; Behrouz,32,0,70,38
1651100814431,ECE 180,A00,083140,Abi Samra; Nicholas Camill,17,0,30,13
1651100814431,ECE 180,B00,083141,Abi Samra; Nicholas Camill,0,1,30,32
1651100820457,MATH 10A,A01,083735,Patchell; Gregory David,0,0,30,30
1651100820457,MATH 10A,A02,083736,Patchell; Gregory David,26,0,30,4
1651100820457,MATH 10A,A03,083737,Patchell; Gregory David,22,0,30,8
1651100826479,MATH 10B,A01,083207,Staff,0,7,30,30
1651100826479,MATH 10B,A02,083208,Staff,0,6,30,30
1651100826479,MATH 10B,B01,083739,Staff,7,0,30,23
1651100826479,MATH 10B,B02,083740,Staff,28,0,30,2
1651100832505,MATH 18,A01,083743,Staff,0,0,30,30
1651100832505,MATH 18,A02,083744,Staff,23,0,30,7
1651100832505,MATH 18,A03,083745,Staff,19,0,30,11
1651100832505,MATH 18,A04,083746,Staff,26,0,30,4
1651100832505,MATH 18,B01,083748,Staff,0,16,30,30
1651100832505,MATH 18,B02,083749,Staff,0,14,30,30
1651100832505,MATH 18,B03,083750,Staff,0,15,30,30
1651100832505,MATH 18,B04,083751,Staff,0,14,30,30
1651100838533,MATH 20A,A01,083754,Staff,18,0,40,22
1651100844568,MATH 20B,A01,083756,Briones; Jor-el Thomas Caparas,0,14,30,30
1651100844568,MATH 20B,A02,083757,Briones; Jor-el Thomas Caparas,0,11,30,30
1651100850592,MATH 20C,A01,083760,Briones; Jor-el Thomas Caparas,1,17,30,29
1651100850592,MATH 20C,A02,083761,Briones; Jor-el Thomas Caparas,0,16,30,30
1651100850592,MATH 20C,B01,083762,Staff,7,0,30,23
1651100850592,MATH 20C,B02,083763,Staff,27,0,30,3
1651100856618,MATH 20D,A01,083765,Tran; Brian Kha,3,1,30,27
1651100856618,MATH 20D,A02,083766,Tran; Brian Kha,1,0,30,29
1651100856618,MATH 20D,A03,083767,Tran; Brian Kha,22,0,30,8
1651100862644,MATH 20E,A01,083771,Staff,0,0,30,30
1651100862644,MATH 20E,A02,083772,Staff,9,0,30,21
1651100862644,MATH 20E,B01,083773,Staff,5,0,35,30
1651100862644,MATH 20E,B02,083774,Staff,5,1,35,30
1651100868669,MATH 103A,A01,083777,Greenfeld; Be'Eri,0,17,30,30
1651100868669,MATH 103A,A02,083778,Greenfeld; Be'Eri,0,17,30,30
1651100868669,MATH 103A,B01,083779,Greenfeld; Be'Eri,0,15,30,30
1651100868669,MATH 103A,B02,083780,Greenfeld; Be'Eri,0,14,30,30
1651100874693,MATH 105,A01,085443,Staff,0,24,30,30
1651100880735,MATH 109,A01,083213,Anzaldo; Leesa B,0,7,30,30
1651100880735,MATH 109,A02,083214,Anzaldo; Leesa B,0,7,30,30
1651100880735,MATH 109,B01,083215,Anzaldo; Leesa B,0,8,30,30
1651100880735,MATH 109,B02,083216,Anzaldo; Leesa B,1,8,30,29
1651100886767,MATH 142A,A01,083219,Chow; Bennett,0,15,30,30
1651100886767,MATH 142A,A02,083220,Chow; Bennett,0,15,30,30
1651100886767,MATH 142A,B01,083221,Chow; Bennett,0,16,30,30
1651100886767,MATH 142A,B02,083222,Chow; Bennett,0,15,30,30
1651100892790,MATH 193A,A01,083224,Staff,0,9,30,30
1651100892790,MATH 193A,A02,083225,Staff,1,7,30,29
1651100892790,MATH 193A,A03,083781,Staff,0,7,30,30
1651100892790,MATH 193A,A04,083782,Staff,0,7,30,30
1651100898811,MATH 197,001,091859,McAuley; Julian John,9998,0,9999,1
1651100904858,COGS 9,A01,083615,Staff,0,20,60,60
1651100910882,COGS 11,A01,083617,Boyle; Mary E. T.,13,0,40,27
1651100916902,COGS 13,A01,083071,Staff,0,38,40,40
1651100922926,COGS 14A,A01,092681,Staff,0,40,100,100
1651100928950,COGS 14B,A01,083073,Cheng; Tzu-Han,0,11,50,50
1651100934977,COGS 17,A01,092677,Staff,8,0,75,67
1651100941009,COGS 100,A01,083619,Staff,0,30,60,60
1651100947032,COGS 101A,A01,083621,Davis; Joshua Daniel,0,29,60,60
1651100953056,COGS 101B,A01,091572,Staff,0,9,60,60
1651100959078,COGS 101C,A01,083625,Delgado; Tania,12,0,30,18
1651100965104,COGS 107A,A01,083627,Boyle; Mary E. T.,0,17,60,60
1651100971131,COGS 118A,A01,083075,Staff,0,10,60,60
1651100977154,CSE 3,A50,083646,Miranda; Gregory Joseph,15,0,38,23
1651100977154,CSE 3,A51,083647,Miranda; Gregory Joseph,36,0,37,1
1651100983180,CSE 8A,A50,083650,Miranda; Gregory Joseph,0,31,40,40
1651100989203,CSE 11,A01,083080,Cao; Yingjun,1,98,40,39
1651100995230,CSE 12,A01,083652,Staff,0,29,100,100
1651101001252,CSE 15L,A01,083654,Staff,0,3,50,50
1651101001252,CSE 15L,A02,083655,Staff,0,3,50,50
1651101007277,CSE 20,A01,083657,Staff,46,0,80,34
1651101013299,CSE 30,A01,083084,Eldon; John,0,38,80,80
1651101019325,CSE 100,A01,083659,Cao; Yingjun,0,72,50,50
1651101025347,CSE 134B,A01,083661,Powell; Thomas Allan,0,38,65,65
1651101031369,CSE 140,A01,083663,Staff,0,17,75,75
1651101037393,CSE 140L,A01,083088,Eldon; John,1,0,100,99
1651101043423,CSE 175,A01,083665,Kumar; Rakesh,0,0,25,25
1651101049455,CSE 190,A00,092507,Dubnov; Shlomo,9,0,20,11
1651101055482,ECE 45,A01,083139,Staff,0,8,60,60
1651101061505,ECE 65,A50,083695,Staff,0,7,30,30
1651101067542,ECE 109,A01,091882,Touri; Behrouz,32,0,70,38
1651101073566,ECE 180,A00,083140,Abi Samra; Nicholas Camill,17,0,30,13
1651101073566,ECE 180,B00,083141,Abi Samra; Nicholas Camill,0,1,30,32
1651101079590,MATH 10A,A01,083735,Patchell; Gregory David,0,0,30,30
1651101079590,MATH 10A,A02,083736,Patchell; Gregory David,26,0,30,4
1651101079590,MATH 10A,A03,083737,Patchell; Gregory David,22,0,30,8
1651101085613,MATH 10B,A01,083207,Staff,0,7,30,30
1651101085613,MATH 10B,A02,083208,Staff,0,6,30,30
1651101085613,MATH 10B,B01,083739,Staff,7,0,30,23
1651101085613,MATH 10B,B02,083740,Staff,28,0,30,2
1651101091650,MATH 18,A01,083743,Staff,0,0,30,30
1651101091650,MATH 18,A02,083744,Staff,23,0,30,7
1651101091650,MATH 18,A03,083745,Staff,19,0,30,11
1651101091650,MATH 18,A04,083746,Staff,26,0,30,4
1651101091650,MATH 18,B01,083748,Staff,0,16,30,30
1651101091650,MATH 18,B02,083749,Staff,0,14,30,30
1651101091650,MATH 18,B03,083750,Staff,0,15,30,30
1651101091650,MATH 18,B04,083751,Staff,0,14,30,30
1651101097673,MATH 20A,A01,083754,Staff,18,0,40,22
1651101103715,MATH 20B,A01,083756,Briones; Jor-el Thomas Caparas,0,14,30,30
1651101103715,MATH 20B,A02,083757,Briones; Jor-el Thomas Caparas,0,11,30,30
1651101109747,MATH 20C,A01,083760,Briones; Jor-el Thomas Caparas,1,17,30,29
1651101109747,MATH 20C,A02,083761,Briones; Jor-el Thomas Caparas,0,16,30,30
1651101109747,MATH 20C,B01,083762,Staff,7,0,30,23
1651101109747,MATH 20C,B02,083763,Staff,27,0,30,3
1651101115776,MATH 20D,A01,083765,Tran; Brian Kha,3,1,30,27
1651101115776,MATH 20D,A02,083766,Tran; Brian Kha,1,0,30,29
1651101115776,MATH 20D,A03,083767,Tran; Brian Kha,22,0,30,8
1651101121805,MATH 20E,A01,083771,Staff,0,0,30,30
1651101121805,MATH 20E,A02,083772,Staff,9,0,30,21
1651101121805,MATH 20E,B01,083773,Staff,5,0,35,30
1651101121805,MATH 20E,B02,083774,Staff,5,1,35,30
1651101127834,MATH 103A,A01,083777,Greenfeld; Be'Eri,0,17,30,30
1651101127834,MATH 103A,A02,083778,Greenfeld; Be'Eri,0,17,30,30
1651101127834,MATH 103A,B01,083779,Greenfeld; Be'Eri,0,15,30,30
1651101127834,MATH 103A,B02,083780,Greenfeld; Be'Eri,0,14,30,30
1651101133953,MATH 105,A01,085443,Staff,0,24,30,30
1651101139976,MATH 109,A01,083213,Ganzberger; Geoffrey Michael,0,7,30,30
1651101139976,MATH 109,A02,083214,Ganzberger; Geoffrey Michael,0,7,30,30
1651101139976,MATH 109,B01,083215,Ganzberger; Geoffrey Michael,0,8,30,30
1651101139976,MATH 109,B02,083216,Ganzberger; Geoffrey Michael,1,8,30,29
1651101146001,MATH 142A,A01,083219,Chow; Bennett,0,15,30,30
1651101146001,MATH 142A,A02,083220,Chow; Bennett,0,15,30,30
1651101146001,MATH 142A,B01,083221,Chow; Bennett,0,16,30,30
1651101146001,MATH 142A,B02,083222,Chow; Bennett,0,15,30,30
1651101152039,MATH 193A,A01,083224,Staff,0,9,30,30
1651101152039,MATH 193A,A02,083225,Staff,1,7,30,29
1651101152039,MATH 193A,A03,083781,Staff,0,7,30,30
1651101152039,MATH 193A,A04,083782,Staff,0,7,30,30
1651101158073,MATH 197,001,091859,McAuley; Julian John,9998,0,9999,1
1651101164132,COGS 9,A01,083615,Staff,0,20,60,60
1651101170155,COGS 11,A01,083617,Boyle; Mary E. T.,13,0,40,27
1651101176179,COGS 13,A01,083071,Staff,0,38,40,40
1651101182205,COGS 14A,A01,092681,Staff,0,40,100,100
1651101188231,COGS 14B,A01,083073,Cheng; Tzu-Han,0,11,50,50
1651101194256,COGS 17,A01,092677,Staff,8,0,75,67
1651101200280,COGS 100,A01,083619,Staff,0,30,60,60
1651101206304,COGS 101A,A01,083621,Davis; Joshua Daniel,0,29,60,60
1651101212328,COGS 101B,A01,091572,Staff,0,9,60,60
1651101218357,COGS 101C,A01,083625,Delgado; Tania,12,0,30,18
1651101224381,COGS 107A,A01,083627,Boyle; Mary E. T.,0,17,60,60
1651101230418,COGS 118A,A01,083075,Staff,0,10,60,60
1651101236448,CSE 3,A50,083646,Miranda; Gregory Joseph,15,0,38,23
1651101236448,CSE 3,A51,083647,Miranda; Gregory Joseph,36,0,37,1
1651101242470,CSE 8A,A50,083650,Miranda; Gregory Joseph,0,31,40,40
1651101248496,CSE 11,A01,083080,Cao; Yingjun,1,98,40,39
1651101254521,CSE 12,A01,083652,Staff,0,28,100,100
1651101260543,CSE 15L,A01,083654,Staff,0,3,50,50
1651101260543,CSE 15L,A02,083655,Staff,0,3,50,50
1651101266575,CSE 20,A01,083657,Staff,46,0,80,34
1651101272601,CSE 30,A01,083084,Eldon; John,0,38,80,80
1651101278626,CSE 100,A01,083659,Cao; Yingjun,0,72,50,50
1651101284651,CSE 134B,A01,083661,Powell; Thomas Allan,0,38,65,65
1651101290676,CSE 140,A01,083663,Staff,0,17,75,75
1651101296712,CSE 140L,A01,083088,Eldon; John,1,0,100,99
1651101302734,CSE 175,A01,083665,Kumar; Rakesh,0,0,25,25
1651101308756,CSE 190,A00,092507,Dubnov; Shlomo,9,0,20,11
1651101314782,ECE 45,A01,083139,Staff,0,8,60,60
1651101320805,ECE 65,A50,083695,Staff,0,7,30,30
1651101326833,ECE 109,A01,091882,Touri; Behrouz,32,0,70,38
1651101332856,ECE 180,A00,083140,Abi Samra; Nicholas Camill,17,0,30,13
1651101332856,ECE 180,B00,083141,Abi Samra; Nicholas Camill,0,1,30,32
1651101338881,MATH 10A,A01,083735,Patchell; Gregory David,0,0,30,30
1651101338881,MATH 10A,A02,083736,Patchell; Gregory David,26,0,30,4
1651101338881,MATH 10A,A03,083737,Patchell; Gregory David,22,0,30,8
1651101344911,MATH 10B,A01,083207,Staff,0,7,30,30
1651101344911,MATH 10B,A02,083208,Staff,0,6,30,30
1651101344911,MATH 10B,B01,083739,Staff,7,0,30,23
1651101344911,MATH 10B,B02,083740,Staff,28,0,30,2
1651101350942,MATH 18,A01,083743,Staff,0,0,30,30
1651101350942,MATH 18,A02,083744,Staff,23,0,30,7
1651101350942,MATH 18,A03,083745,Staff,19,0,30,11
1651101350942,MATH 18,A04,083746,Staff,26,0,30,4
1651101350942,MATH 18,B01,083748,Staff,0,16,30,30
1651101350942,MATH 18,B02,083749,Staff,0,14,30,30
1651101350942,MATH 18,B03,083750,Staff,0,15,30,30
1651101350942,MATH 18,B04,083751,Staff,0,14,30,30
1651101356966,MATH 20A,A01,083754,Staff,18,0,40,22
1651101362994,MATH 20B,A01,083756,Briones; Jor-el Thomas Caparas,0,14,30,30
1651101362994,MATH 20B,A02,083757,Briones; Jor-el Thomas Caparas,0,11,30,30
1651101369019,MATH 20C,A01,083760,Briones; Jor-el Thomas Caparas,1,17,30,29
1651101369019,MATH 20C,A02,083761,Briones; Jor-el Thomas Caparas,0,16,30,30
1651101369019,MATH 20C,B01,083762,Staff,7,0,30,23
1651101369019,MATH 20C,B02,083763,Staff,27,0,30,3
1651101375046,MATH 20D,A01,083765,Tran; Brian Kha,3,1,30,27
1651101375046,MATH 20D,A02,083766,Tran; Brian Kha,1,0,30,29
1651101375046,MATH 20D,A03,083767,Tran; Brian Kha,22,0,30,8
1651101381069,MATH 20E,A01,083771,Staff,0,0,30,30
1651101381069,MATH 20E,A02,083772,Staff,9,0,30,21
1651101381069,MATH 20E,B01,083773,Staff,5,0,35,30
1651101381069,MATH 20E,B02,083774,Staff,5,1,35,30
1651101387098,MATH 103A,A01,083777,Greenfeld; Be'Eri,0,17,30,30
1651101387098,MATH 103A,A02,083778,Greenfeld; Be'Eri,0,17,30,30
1651101387098,MATH 103A,B01,083779,Greenfeld; Be'Eri,0,15,30,30
1651101387098,MATH 103A,B02,083780,Greenfeld; Be'Eri,0,14,30,30
1651101393122,MATH 105,A01,085443,Staff,0,24,30,30
1651101399150,MATH 109,A01,083213,Ganzberger; Geoffrey Michael,0,7,30,30
1651101399150,MATH 109,A02,083214,Ganzberger; Geoffrey Michael,0,7,30,30
1651101399150,MATH 109,B01,083215,Ganzberger; Geoffrey Michael,0,8,30,30
1651101399150,MATH 109,B02,083216,Ganzberger; Geoffrey Michael,1,8,30,29
1651101405177,MATH 142A,A01,083219,Chow; Bennett,0,15,30,30
1651101405177,MATH 142A,A02,083220,Chow; Bennett,0,15,30,30
1651101405177,MATH 142A,B01,083221,Chow; Bennett,0,16,30,30
1651101405177,MATH 142A,B02,083222,Chow; Bennett,0,15,30,30
1651101411201,MATH 193A,A01,083224,Staff,0,9,30,30
1651101411201,MATH 193A,A02,083225,Staff,1,7,30,29
1651101411201,MATH 193A,A03,083781,Staff,0,7,30,30
1651101411201,MATH 193A,A04,083782,Staff,0,7,30,30
1651101417227,MATH 197,001,091859,McAuley; Julian John,9998,0,9999,1
1651101423309,COGS 9,A01,083615,Staff,0,20,60,60
1651101429349,COGS 11,A01,083617,Boyle; Mary E. T.,13,0,40,27
1651101435373,COGS 13,A01,083071,Staff,0,38,40,40
1651101441397,COGS 14A,A01,092681,Staff,0,40,100,100
1651101447421,COGS 14B,A01,083073,Cheng; Tzu-Han,0,11,50,50
1651101453448,COGS 17,A01,092677,Staff,8,0,75,67
1651101459474,COGS 100,A01,083619,Staff,0,30,60,60
1651101465501,COGS 101A,A01,083621,Davis; Joshua Daniel,0,29,60,60
1651101471526,COGS 101B,A01,091572,Staff,0,9,60,60
1651101477549,COGS 101C,A01,083625,Delgado; Tania,12,0,30,18
1651101483572,COGS 107A,A01,083627,Boyle; Mary E. T.,0,17,60,60
1651101489598,COGS 118A,A01,083075,Staff,0,10,60,60
1651101495622,CSE 3,A50,083646,Miranda; Gregory Joseph,15,0,38,23
1651101495622,CSE 3,A51,083647,Miranda; Gregory Joseph,36,0,37,1
1651101501646,CSE 8A,A50,083650,Miranda; Gregory Joseph,0,31,40,40
1651101507673,CSE 11,A01,083080,Cao; Yingjun,1,98,40,39
1651101513698,CSE 12,A01,083652,Staff,0,28,100,100
1651101519722,CSE 15L,A01,083654,Staff,0,3,50,50
1651101519722,CSE 15L,A02,083655,Staff,0,3,50,50
1651101525751,CSE 20,A01,083657,Staff,46,0,80,34
1651101531783,CSE 30,A01,083084,Eldon; John,0,38,80,80
1651101537806,CSE 100,A01,083659,Cao; Yingjun,0,72,50,50
1651101543830,CSE 134B,A01,083661,Powell; Thomas Allan,0,38,65,65
1651101549855,CSE 140,A01,083663,Staff,0,17,75,75
1651101555877,CSE 140L,A01,083088,Eldon; John,1,0,100,99
1651101561901,CSE 175,A01,083665,Kumar; Rakesh,0,0,25,25
1651101567929,CSE 190,A00,092507,Dubnov; Shlomo,9,0,20,11
1651101573952,ECE 45,A01,083139,Staff,0,8,60,60
1651101579979,ECE 65,A50,083695,Staff,0,7,30,30
1651101586003,ECE 109,A01,091882,Touri; Behrouz,32,0,70,38
1651101592029,ECE 180,A00,083140,Abi Samra; Nicholas Camill,17,0,30,13
1651101592029,ECE 180,B00,083141,Abi Samra; Nicholas Camill,0,1,30,32
1651101598053,MATH 10A,A01,083735,Patchell; Gregory David,0,0,30,30
1651101598053,MATH 10A,A02,083736,Patchell; Gregory David,26,0,30,4
1651101598053,MATH 10A,A03,083737,Patchell; Gregory David,22,0,30,8
1651101604083,MATH 10B,A01,083207,Staff,0,7,30,30
1651101604083,MATH 10B,A02,083208,Staff,0,6,30,30
1651101604083,MATH 10B,B01,083739,Staff,7,0,30,23
1651101604083,MATH 10B,B02,083740,Staff,28,0,30,2
1651101610113,MATH 18,A01,083743,Staff,0,0,30,30
1651101610113,MATH 18,A02,083744,Staff,23,0,30,7
1651101610113,MATH 18,A03,083745,Staff,19,0,30,11
1651101610113,MATH 18,A04,083746,Staff,26,0,30,4
1651101610113,MATH 18,B01,083748,Staff,0,16,30,30
1651101610113,MATH 18,B02,083749,Staff,0,14,30,30
1651101610113,MATH 18,B03,083750,Staff,0,15,30,30
1651101610113,MATH 18,B04,083751,Staff,0,14,30,30
1651101616149,MATH 20A,A01,083754,Staff,18,0,40,22
1651101622180,MATH 20B,A01,083756,Briones; Jor-el Thomas Caparas,0,14,30,30
1651101622180,MATH 20B,A02,083757,Briones; Jor-el Thomas Caparas,0,11,30,30
1651101628208,MATH 20C,A01,083760,Briones; Jor-el Thomas Caparas,1,17,30,29
1651101628208,MATH 20C,A02,083761,Briones; Jor-el Thomas Caparas,0,16,30,30
1651101628208,MATH 20C,B01,083762,Staff,7,0,30,23
1651101628208,MATH 20C,B02,083763,Staff,27,0,30,3
1651101634234,MATH 20D,A01,083765,Tran; Brian Kha,3,1,30,27
1651101634234,MATH 20D,A02,083766,Tran; Brian Kha,0,0,30,30
1651101634234,MATH 20D,A03,083767,Tran; Brian Kha,22,0,30,8
1651101640275,MATH 20E,A01,083771,Staff,0,0,30,30
1651101640275,MATH 20E,A02,083772,Staff,9,0,30,21
1651101640275,MATH 20E,B01,083773,Staff,5,0,35,30
1651101640275,MATH 20E,B02,083774,Staff,5,1,35,30
1651101646299,MATH 103A,A01,083777,Greenfeld; Be'Eri,0,17,30,30
1651101646299,MATH 103A,A02,083778,Greenfeld; Be'Eri,0,17,30,30
1651101646299,MATH 103A,B01,083779,Greenfeld; Be'Eri,0,15,30,30
1651101646299,MATH 103A,B02,083780,Greenfeld; Be'Eri,0,14,30,30
1651101652324,MATH 105,A01,085443,Staff,0,24,30,30
1651101658356,MATH 109,A01,083213,Ganzberger; Geoffrey Michael,0,7,30,30
1651101658356,MATH 109,A02,083214,Ganzberger; Geoffrey Michael,0,7,30,30
1651101658356,MATH 109,B01,083215,Ganzberger; Geoffrey Michael,0,8,30,30
1651101658356,MATH 109,B02,083216,Ganzberger; Geoffrey Michael,1,8,30,29
1651101664380,MATH 142A,A01,083219,Chow; Bennett,0,15,30,30
1651101664380,MATH 142A,A02,083220,Chow; Bennett,0,15,30,30
1651101664380,MATH 142A,B01,083221,Chow; Bennett,0,16,30,30
1651101664380,MATH 142A,B02,083222,Chow; Bennett,0,15,30,30
1651101678238,MATH 193A,A01,083224,Staff,0,9,30,30
1651101678238,MATH 193A,A02,083225,Staff,1,7,30,29
1651101678238,MATH 193A,A03,083781,Staff,0,7,30,30
1651101678238,MATH 193A,A04,083782,Staff,0,7,30,30
1651101684265,MATH 197,001,091859,McAuley; Julian John,9998,0,9999,1
1651101690317,COGS 9,A01,083615,Staff,0,20,60,60
1651101696351,COGS 11,A01,083617,Boyle; Mary E. T.,13,0,40,27
1651101702376,COGS 13,A01,083071,Staff,0,38,40,40
1651101708400,COGS 14A,A01,092681,Staff,0,40,100,100
1651101714432,COGS 14B,A01,083073,Cheng; Tzu-Han,0,11,50,50
1651101720458,COGS 17,A01,092677,Staff,8,0,75,67
1651101726481,COGS 100,A01,083619,Staff,0,30,60,60
1651101732595,COGS 101A,A01,083621,Davis; Joshua Daniel,0,29,60,60
1651101738620,COGS 101B,A01,091572,Staff,0,9,60,60
1651101744643,COGS 101C,A01,083625,Delgado; Tania,12,0,30,18
1651101750674,COGS 107A,A01,083627,Boyle; Mary E. T.,0,17,60,60
1651101756696,COGS 118A,A01,083075,Staff,0,10,60,60
1651101762725,CSE 3,A50,083646,Miranda; Gregory Joseph,15,0,38,23
1651101762725,CSE 3,A51,083647,Miranda; Gregory Joseph,36,0,37,1
1651101768749,CSE 8A,A50,083650,Miranda; Gregory Joseph,0,31,40,40
1651101774775,CSE 11,A01,083080,Cao; Yingjun,1,98,40,39
1651101780801,CSE 12,A01,083652,Staff,0,28,100,100
1651101786829,CSE 15L,A01,083654,Staff,0,3,50,50
1651101786829,CSE 15L,A02,083655,Staff,0,3,50,50
1651101792853,CSE 20,A01,083657,Staff,46,0,80,34
1651101798880,CSE 30,A01,083084,Eldon; John,0,38,80,80
1651101804906,CSE 100,A01,083659,Cao; Yingjun,0,72,50,50
1651101810933,CSE 134B,A01,083661,Powell; Thomas Allan,0,38,65,65
1651101816956,CSE 140,A01,083663,Staff,0,17,75,75
1651101822978,CSE 140L,A01,083088,Eldon; John,1,0,100,99
1651101829000,CSE 175,A01,083665,Kumar; Rakesh,0,0,25,25
1651101835024,CSE 190,A00,092507,Dubnov; Shlomo,9,0,20,11
1651101841047,ECE 45,A01,083139,Staff,0,8,60,60
1651101847069,ECE 65,A50,083695,Staff,0,7,30,30
1651101853091,ECE 109,A01,091882,Touri; Behrouz,32,0,70,38
1651101859115,ECE 180,A00,083140,Abi Samra; Nicholas Camill,17,0,30,13
1651101859115,ECE 180,B00,083141,Abi Samra; Nicholas Camill,0,1,30,32
1651101865139,MATH 10A,A01,083735,Patchell; Gregory David,0,0,30,30
1651101865139,MATH 10A,A02,083736,Patchell; Gregory David,26,0,30,4
1651101865139,MATH 10A,A03,083737,Patchell; Gregory David,22,0,30,8
1651101871166,MATH 10B,A01,083207,Staff,0,7,30,30
1651101871166,MATH 10B,A02,083208,Staff,0,6,30,30
1651101871166,MATH 10B,B01,083739,Staff,7,0,30,23
1651101871166,MATH 10B,B02,083740,Staff,28,0,30,2
1651101877191,MATH 18,A01,083743,Staff,0,0,30,30
1651101877191,MATH 18,A02,083744,Staff,23,0,30,7
1651101877191,MATH 18,A03,083745,Staff,19,0,30,11
1651101877191,MATH 18,A04,083746,Staff,26,0,30,4
1651101877191,MATH 18,B01,083748,Staff,0,16,30,30
1651101877191,MATH 18,B02,083749,Staff,0,14,30,30
1651101877191,MATH 18,B03,083750,Staff,0,15,30,30
1651101877191,MATH 18,B04,083751,Staff,0,14,30,30
1651101883221,MATH 20A,A01,083754,Staff,18,0,40,22
1651101889244,MATH 20B,A01,083756,Briones; Jor-el Thomas Caparas,0,14,30,30
1651101889244,MATH 20B,A02,083757,Briones; Jor-el Thomas Caparas,0,11,30,30
1651101895268,MATH 20C,A01,083760,Briones; Jor-el Thomas Caparas,1,17,30,29
1651101895268,MATH 20C,A02,083761,Briones; Jor-el Thomas Caparas,0,16,30,30
1651101895268,MATH 20C,B01,083762,Staff,7,0,30,23
1651101895268,MATH 20C,B02,083763,Staff,27,0,30,3
1651101901295,MATH 20D,A01,083765,Tran; Brian Kha,3,1,30,27
1651101901295,MATH 20D,A02,083766,Tran; Brian Kha,0,0,30,30
1651101901295,MATH 20D,A03,083767,Tran; Brian Kha,22,0,30,8
1651101907319,MATH 20E,A01,083771,Staff,0,0,30,30
1651101907319,MATH 20E,A02,083772,Staff,9,0,30,21
1651101907319,MATH 20E,B01,083773,Staff,5,0,35,30
1651101907319,MATH 20E,B02,083774,Staff,5,1,35,30
1651101913342,MATH 103A,A01,083777,Greenfeld; Be'Eri,0,17,30,30
1651101913342,MATH 103A,A02,083778,Greenfeld; Be'Eri,0,17,30,30
1651101913342,MATH 103A,B01,083779,Greenfeld; Be'Eri,0,15,30,30
1651101913342,MATH 103A,B02,083780,Greenfeld; Be'Eri,0,14,30,30
1651101919371,MATH 105,A01,085443,Staff,0,24,30,30
1651101925395,MATH 109,A01,083213,Ganzberger; Geoffrey Michael,0,7,30,30
1651101925395,MATH 109,A02,083214,Ganzberger; Geoffrey Michael,0,7,30,30
1651101925395,MATH 109,B01,083215,Ganzberger; Geoffrey Michael,0,8,30,30
1651101925395,MATH 109,B02,083216,Ganzberger; Geoffrey Michael,1,8,30,29
1651101931419,MATH 142A,A01,083219,Chow; Bennett,0,15,30,30
1651101931419,MATH 142A,A02,083220,Chow; Bennett,0,15,30,30
1651101931419,MATH 142A,B01,083221,Chow; Bennett,0,16,30,30
1651101931419,MATH 142A,B02,083222,Chow; Bennett,0,15,30,30
1651101937449,MATH 193A,A01,083224,Staff,0,9,30,30
1651101937449,MATH 193A,A02,083225,Staff,1,7,30,29
1651101937449,MATH 193A,A03,083781,Staff,0,7,30,30
1651101937449,MATH 193A,A04,083782,Staff,0,7,30,30
1651101943472,MATH 197,001,091859,McAuley; Julian John,9998,0,9999,1
1651101949531,COGS 9,A01,083615,Staff,0,20,60,60
1651101955556,COGS 11,A01,083617,Boyle; Mary E. T.,13,0,40,27
1651101961585,COGS 13,A01,083071,Staff,0,38,40,40
1651101967614,COGS 14A,A01,092681,Staff,0,40,100,100
1651101973637,COGS 14B,A01,083073,Cheng; Tzu-Han,0,11,50,50
1651101979661,COGS 17,A01,092677,Staff,8,0,75,67
1651101985687,COGS 100,A01,083619,Staff,0,30,60,60
1651101991711,COGS 101A,A01,083621,Davis; Joshua Daniel,0,29,60,60
1651101997746,COGS 101B,A01,091572,Staff,0,9,60,60
1651102003772,COGS 101C,A01,083625,Delgado; Tania,12,0,30,18
1651102009805,COGS 107A,A01,083627,Boyle; Mary E. T.,0,17,60,60
1651102015837,COGS 118A,A01,083075,Staff,0,10,60,60
1651102021861,CSE 3,A50,083646,Miranda; Gregory Joseph,15,0,38,23
1651102021861,CSE 3,A51,083647,Miranda; Gregory Joseph,36,0,37,1
1651102027888,CSE 8A,A50,083650,Miranda; Gregory Joseph,0,31,40,40
1651102033911,CSE 11,A01,083080,Cao; Yingjun,1,98,40,39
1651102039935,CSE 12,A01,083652,Staff,0,28,100,100
1651102045957,CSE 15L,A01,083654,Staff,0,3,50,50
1651102045957,CSE 15L,A02,083655,Staff,0,3,50,50
1651102051985,CSE 20,A01,083657,Staff,46,0,80,34
1651102058009,CSE 30,A01,083084,Eldon; John,0,38,80,80
1651102064032,CSE 100,A01,083659,Cao; Yingjun,0,72,50,50
1651102070055,CSE 134B,A01,083661,Powell; Thomas Allan,0,38,65,65
1651102076079,CSE 140,A01,083663,Staff,0,17,75,75
1651102082106,CSE 140L,A01,083088,Eldon; John,1,0,100,99
1651102088128,CSE 175,A01,083665,Kumar; Rakesh,0,0,25,25
1651102094152,CSE 190,A00,092507,Dubnov; Shlomo,9,0,20,11
1651102100190,ECE 45,A01,083139,Staff,0,8,60,60
1651102106219,ECE 65,A50,083695,Staff,0,7,30,30
1651102112240,ECE 109,A01,091882,Touri; Behrouz,32,0,70,38
1651102118266,ECE 180,A00,083140,Abi Samra; Nicholas Camill,17,0,30,13
1651102118266,ECE 180,B00,083141,Abi Samra; Nicholas Camill,0,1,30,32
1651102124287,MATH 10A,A01,083735,Patchell; Gregory David,0,0,30,30
1651102124287,MATH 10A,A02,083736,Patchell; Gregory David,26,0,30,4
1651102124287,MATH 10A,A03,083737,Patchell; Gregory David,22,0,30,8
1651102130322,MATH 10B,A01,083207,Staff,0,7,30,30
1651102130322,MATH 10B,A02,083208,Staff,0,6,30,30
1651102130322,MATH 10B,B01,083739,Staff,7,0,30,23
1651102130322,MATH 10B,B02,083740,Staff,28,0,30,2
1651102136351,MATH 18,A01,083743,Staff,0,0,30,30
1651102136351,MATH 18,A02,083744,Staff,23,0,30,7
1651102136351,MATH 18,A03,083745,Staff,19,0,30,11
1651102136351,MATH 18,A04,083746,Staff,26,0,30,4
1651102136351,MATH 18,B01,083748,Staff,0,16,30,30
1651102136351,MATH 18,B02,083749,Staff,0,14,30,30
1651102136351,MATH 18,B03,083750,Staff,0,15,30,30
1651102136351,MATH 18,B04,083751,Staff,0,14,30,30
1651102142378,MATH 20A,A01,083754,Staff,18,0,40,22
1651102148404,MATH 20B,A01,083756,Briones; Jor-el Thomas Caparas,0,14,30,30
1651102148404,MATH 20B,A02,083757,Briones; Jor-el Thomas Caparas,0,11,30,30
1651102154433,MATH 20C,A01,083760,Briones; Jor-el Thomas Caparas,1,17,30,29
1651102154433,MATH 20C,A02,083761,Briones; Jor-el Thomas Caparas,0,16,30,30
1651102154433,MATH 20C,B01,083762,Staff,7,0,30,23
1651102154433,MATH 20C,B02,083763,Staff,27,0,30,3
1651102160456,MATH 20D,A01,083765,Tran; Brian Kha,3,1,30,27
1651102160456,MATH 20D,A02,083766,Tran; Brian Kha,0,0,30,30
1651102160456,MATH 20D,A03,083767,Tran; Brian Kha,22,0,30,8
1651102166480,MATH 20E,A01,083771,Staff,0,0,30,30
1651102166480,MATH 20E,A02,083772,Staff,9,0,30,21
1651102166480,MATH 20E,B01,083773,Staff,5,0,35,30
1651102166480,MATH 20E,B02,083774,Staff,5,1,35,30
1651102172503,MATH 103A,A01,083777,Greenfeld; Be'Eri,0,17,30,30
1651102172503,MATH 103A,A02,083778,Greenfeld; Be'Eri,0,17,30,30
1651102172503,MATH 103A,B01,083779,Greenfeld; Be'Eri,0,15,30,30
1651102172503,MATH 103A,B02,083780,Greenfeld; Be'Eri,0,14,30,30
1651102178526,MATH 105,A01,085443,Staff,0,24,30,30
1651102184551,MATH 109,A01,083213,Ganzberger; Geoffrey Michael,0,7,30,30
1651102184551,MATH 109,A02,083214,Ganzberger; Geoffrey Michael,0,7,30,30
1651102184551,MATH 109,B01,083215,Ganzberger; Geoffrey Michael,0,8,30,30
1651102184551,MATH 109,B02,083216,Ganzberger; Geoffrey Michael,1,8,30,29
1651102190574,MATH 142A,A01,083219,Chow; Bennett,0,15,30,30
1651102190574,MATH 142A,A02,083220,Chow; Bennett,0,15,30,30
1651102190574,MATH 142A,B01,083221,Chow; Bennett,0,16,30,30
1651102190574,MATH 142A,B02,083222,Chow; Bennett,0,15,30,30
1651102196600,MATH 193A,A01,083224,Staff,0,9,30,30
1651102196600,MATH 193A,A02,083225,Staff,1,7,30,29
1651102196600,MATH 193A,A03,083781,Staff,0,7,30,30
1651102196600,MATH 193A,A04,083782,Staff,0,7,30,30
1651102202623,MATH 197,001,091859,McAuley; Julian John,9998,0,9999,1
1651102208680,COGS 9,A01,083615,Staff,0,20,60,60
1651102214702,COGS 11,A01,083617,Boyle; Mary E. T.,13,0,40,27
1651102220726,COGS 13,A01,083071,Staff,0,38,40,40
1651102226753,COGS 14A,A01,092681,Staff,0,40,100,100
1651102232775,COGS 14B,A01,083073,Cheng; Tzu-Han,0,11,50,50
1651102238811,COGS 17,A01,092677,Staff,8,0,75,67
1651102244854,COGS 100,A01,083619,Staff,0,30,60,60
1651102250878,COGS 101A,A01,083621,Davis; Joshua Daniel,0,29,60,60
1651102256901,COGS 101B,A01,091572,Staff,0,9,60,60
1651102262934,COGS 101C,A01,083625,Delgado; Tania,12,0,30,18
1651102268957,COGS 107A,A01,083627,Boyle; Mary E. T.,0,17,60,60
1651102274980,COGS 118A,A01,083075,Staff,0,10,60,60
1651102281004,CSE 3,A50,083646,Miranda; Gregory Joseph,15,0,38,23
1651102281004,CSE 3,A51,083647,Miranda; Gregory Joseph,36,0,37,1
1651102287032,CSE 8A,A50,083650,Miranda; Gregory Joseph,0,31,40,40
1651102293058,CSE 11,A01,083080,Cao; Yingjun,1,98,40,39
1651102299086,CSE 12,A01,083652,Staff,0,28,100,100
1651102305108,CSE 15L,A01,083654,Staff,0,3,50,50
1651102305108,CSE 15L,A02,083655,Staff,0,3,50,50
1651102311162,CSE 20,A01,083657,Staff,46,0,80,34
1651102317183,CSE 30,A01,083084,Eldon; John,0,38,80,80
1651102323210,CSE 100,A01,083659,Cao; Yingjun,0,72,50,50
1651102329345,CSE 134B,A01,083661,Powell; Thomas Allan,0,38,65,65
1651102335374,CSE 140,A01,083663,Staff,0,17,75,75
1651102341397,CSE 140L,A01,083088,Eldon; John,1,0,100,99
1651102347422,CSE 175,A01,083665,Kumar; Rakesh,0,0,25,25
1651102353452,CSE 190,A00,092507,Dubnov; Shlomo,9,0,20,11
1651102359479,ECE 45,A01,083139,Staff,0,8,60,60
1651102365510,ECE 65,A50,083695,Staff,0,7,30,30
1651102371536,ECE 109,A01,091882,Touri; Behrouz,32,0,70,38
1651102377563,ECE 180,A00,083140,Abi Samra; Nicholas Camill,17,0,30,13
1651102377563,ECE 180,B00,083141,Abi Samra; Nicholas Camill,0,1,30,32
1651102383596,MATH 10A,A01,083735,Patchell; Gregory David,0,0,30,30
1651102383596,MATH 10A,A02,083736,Patchell; Gregory David,26,0,30,4
1651102383596,MATH 10A,A03,083737,Patchell; Gregory David,22,0,30,8
1651102389619,MATH 10B,A01,083207,Staff,0,7,30,30
1651102389619,MATH 10B,A02,083208,Staff,0,6,30,30
1651102389619,MATH 10B,B01,083739,Staff,7,0,30,23
1651102389619,MATH 10B,B02,083740,Staff,28,0,30,2
1651102395645,MATH 18,A01,083743,Staff,0,0,30,30
1651102395645,MATH 18,A02,083744,Staff,23,0,30,7
1651102395645,MATH 18,A03,083745,Staff,19,0,30,11
1651102395645,MATH 18,A04,083746,Staff,26,0,30,4
1651102395645,MATH 18,B01,083748,Staff,0,16,30,30
1651102395645,MATH 18,B02,083749,Staff,0,14,30,30
1651102395645,MATH 18,B03,083750,Staff,0,15,30,30
1651102395645,MATH 18,B04,083751,Staff,0,14,30,30
1651102401668,MATH 20A,A01,083754,Staff,18,0,40,22
1651102407696,MATH 20B,A01,083756,Briones; Jor-el Thomas Caparas,0,14,30,30
1651102407696,MATH 20B,A02,083757,Briones; Jor-el Thomas Caparas,0,11,30,30
1651102413725,MATH 20C,A01,083760,Briones; Jor-el Thomas Caparas,1,17,30,29
1651102413725,MATH 20C,A02,083761,Briones; Jor-el Thomas Caparas,0,16,30,30
1651102413725,MATH 20C,B01,083762,Staff,7,0,30,23
1651102413725,MATH 20C,B02,083763,Staff,27,0,30,3
1651102419752,MATH 20D,A01,083765,Tran; Brian Kha,3,1,30,27
1651102419752,MATH 20D,A02,083766,Tran; Brian Kha,0,0,30,30
1651102419752,MATH 20D,A03,083767,Tran; Brian Kha,22,0,30,8
1651102425784,MATH 20E,A01,083771,Staff,0,0,30,30
1651102425784,MATH 20E,A02,083772,Staff,9,0,30,21
1651102425784,MATH 20E,B01,083773,Staff,5,0,35,30
1651102425784,MATH 20E,B02,083774,Staff,5,1,35,30
1651102431809,MATH 103A,A01,083777,Greenfeld; Be'Eri,0,17,30,30
1651102431809,MATH 103A,A02,083778,Greenfeld; Be'Eri,0,17,30,30
1651102431809,MATH 103A,B01,083779,Greenfeld; Be'Eri,0,15,30,30
1651102431809,MATH 103A,B02,083780,Greenfeld; Be'Eri,0,14,30,30
1651102437833,MATH 105,A01,085443,Staff,0,24,30,30
1651102443869,MATH 109,A01,083213,Ganzberger; Geoffrey Michael,0,7,30,30
1651102443869,MATH 109,A02,083214,Ganzberger; Geoffrey Michael,0,7,30,30
1651102443869,MATH 109,B01,083215,Ganzberger; Geoffrey Michael,0,8,30,30
1651102443869,MATH 109,B02,083216,Ganzberger; Geoffrey Michael,1,8,30,29
1651102449898,MATH 142A,A01,083219,Chow; Bennett,0,15,30,30
1651102449898,MATH 142A,A02,083220,Chow; Bennett,0,15,30,30
1651102449898,MATH 142A,B01,083221,Chow; Bennett,0,16,30,30
1651102449898,MATH 142A,B02,083222,Chow; Bennett,0,15,30,30
1651102455933,MATH 193A,A01,083224,Staff,0,9,30,30
1651102455933,MATH 193A,A02,083225,Staff,1,7,30,29
1651102455933,MATH 193A,A03,083781,Staff,0,7,30,30
1651102455933,MATH 193A,A04,083782,Staff,0,7,30,30
1651102461969,MATH 197,001,091859,McAuley; Julian John,9998,0,9999,1
1651102468016,COGS 9,A01,083615,Staff,0,20,60,60
1651102474038,COGS 11,A01,083617,Boyle; Mary E. T.,13,0,40,27
1651102480062,COGS 13,A01,083071,Staff,0,38,40,40
1651102486087,COGS 14A,A01,092681,Staff,0,40,100,100
1651102492131,COGS 14B,A01,083073,Cheng; Tzu-Han,0,11,50,50
1651102498157,COGS 17,A01,092677,Staff,8,0,75,67
1651102504180,COGS 100,A01,083619,Staff,0,30,60,60
1651102510202,COGS 101A,A01,083621,Davis; Joshua Daniel,0,29,60,60
1651102516227,COGS 101B,A01,091572,Staff,0,9,60,60
1651102522249,COGS 101C,A01,083625,Delgado; Tania,12,0,30,18
1651102528276,COGS 107A,A01,083627,Boyle; Mary E. T.,0,17,60,60
1651102534298,COGS 118A,A01,083075,Staff,0,10,60,60
1651102540322,CSE 3,A50,083646,Miranda; Gregory Joseph,15,0,38,23
1651102540322,CSE 3,A51,083647,Miranda; Gregory Joseph,36,0,37,1
1651102546356,CSE 8A,A50,083650,Miranda; Gregory Joseph,0,31,40,40
1651102552388,CSE 11,A01,083080,Cao; Yingjun,1,98,40,39
1651102558411,CSE 12,A01,083652,Staff,0,28,100,100
1651102564434,CSE 15L,A01,083654,Staff,0,3,50,50
1651102564434,CSE 15L,A02,083655,Staff,0,3,50,50
1651102570460,CSE 20,A01,083657,Staff,46,0,80,34
1651102576486,CSE 30,A01,083084,Eldon; John,0,38,80,80
1651102582512,CSE 100,A01,083659,Cao; Yingjun,0,72,50,50
1651102588536,CSE 134B,A01,083661,Powell; Thomas Allan,0,38,65,65
1651102594562,CSE 140,A01,083663,Staff,0,17,75,75
1651102600584,CSE 140L,A01,083088,Eldon; John,1,0,100,99
1651102606608,CSE 175,A01,083665,Kumar; Rakesh,0,0,25,25
1651102612634,CSE 190,A00,092507,Dubnov; Shlomo,9,0,20,11
1651102618658,ECE 45,A01,083139,Staff,0,8,60,60
1651102624685,ECE 65,A50,083695,Staff,0,7,30,30
1651102630709,ECE 109,A01,091882,Touri; Behrouz,32,0,70,38
1651102636739,ECE 180,A00,083140,Abi Samra; Nicholas Camill,17,0,30,13
1651102636739,ECE 180,B00,083141,Abi Samra; Nicholas Camill,0,1,30,32
1651102642764,MATH 10A,A01,083735,Patchell; Gregory David,0,0,30,30
1651102642764,MATH 10A,A02,083736,Patchell; Gregory David,26,0,30,4
1651102642764,MATH 10A,A03,083737,Patchell; Gregory David,22,0,30,8
1651102648791,MATH 10B,A01,083207,Staff,0,7,30,30
1651102648791,MATH 10B,A02,083208,Staff,0,6,30,30
1651102648791,MATH 10B,B01,083739,Staff,7,0,30,23
1651102648791,MATH 10B,B02,083740,Staff,28,0,30,2
1651102654814,MATH 18,A01,083743,Staff,0,0,30,30
1651102654814,MATH 18,A02,083744,Staff,23,0,30,7
1651102654814,MATH 18,A03,083745,Staff,19,0,30,11
1651102654814,MATH 18,A04,083746,Staff,26,0,30,4
1651102654814,MATH 18,B01,083748,Staff,0,16,30,30
1651102654814,MATH 18,B02,083749,Staff,0,14,30,30
1651102654814,MATH 18,B03,083750,Staff,0,15,30,30
1651102654814,MATH 18,B04,083751,Staff,0,14,30,30
1651102660839,MATH 20A,A01,083754,Staff,18,0,40,22
1651102666868,MATH 20B,A01,083756,Briones; Jor-el Thomas Caparas,0,14,30,30
1651102666868,MATH 20B,A02,083757,Briones; Jor-el Thomas Caparas,0,11,30,30
1651102672892,MATH 20C,A01,083760,Briones; Jor-el Thomas Caparas,1,17,30,29
1651102672892,MATH 20C,A02,083761,Briones; Jor-el Thomas Caparas,0,16,30,30
1651102672892,MATH 20C,B01,083762,Staff,7,0,30,23
1651102672892,MATH 20C,B02,083763,Staff,27,0,30,3
1651102678915,MATH 20D,A01,083765,Tran; Brian Kha,3,1,30,27
1651102678915,MATH 20D,A02,083766,Tran; Brian Kha,0,0,30,30
1651102678915,MATH 20D,A03,083767,Tran; Brian Kha,22,0,30,8
1651102684939,MATH 20E,A01,083771,Staff,0,0,30,30
1651102684939,MATH 20E,A02,083772,Staff,9,0,30,21
1651102684939,MATH 20E,B01,083773,Staff,5,0,35,30
1651102684939,MATH 20E,B02,083774,Staff,5,1,35,30
1651102690967,MATH 103A,A01,083777,Greenfeld; Be'Eri,0,17,30,30
1651102690967,MATH 103A,A02,083778,Greenfeld; Be'Eri,0,17,30,30
1651102690967,MATH 103A,B01,083779,Greenfeld; Be'Eri,0,15,30,30
1651102690967,MATH 103A,B02,083780,Greenfeld; Be'Eri,0,14,30,30
1651102696991,MATH 105,A01,085443,Staff,0,24,30,30
1651102703020,MATH 109,A01,083213,Ganzberger; Geoffrey Michael,0,8,30,30
1651102703020,MATH 109,A02,083214,Ganzberger; Geoffrey Michael,0,7,30,30
1651102703020,MATH 109,B01,083215,Ganzberger; Geoffrey Michael,0,8,30,30
1651102703020,MATH 109,B02,083216,Ganzberger; Geoffrey Michael,1,8,30,29
1651102709054,MATH 142A,A01,083219,Chow; Bennett,0,15,30,30
1651102709054,MATH 142A,A02,083220,Chow; Bennett,0,15,30,30
1651102709054,MATH 142A,B01,083221,Chow; Bennett,0,16,30,30
1651102709054,MATH 142A,B02,083222,Chow; Bennett,0,15,30,30
1651102715078,MATH 193A,A01,083224,Staff,0,9,30,30
1651102715078,MATH 193A,A02,083225,Staff,1,7,30,29
1651102715078,MATH 193A,A03,083781,Staff,0,7,30,30
1651102715078,MATH 193A,A04,083782,Staff,0,7,30,30
1651102721103,MATH 197,001,091859,McAuley; Julian John,9998,0,9999,1
1651102727160,COGS 9,A01,083615,Staff,0,20,60,60
1651102733183,COGS 11,A01,083617,Boyle; Mary E. T.,13,0,40,27
1651102739207,COGS 13,A01,083071,Staff,0,38,40,40
1651102745227,COGS 14A,A01,092681,Staff,0,40,100,100
1651102751250,COGS 14B,A01,083073,Cheng; Tzu-Han,0,11,50,50
1651102757271,COGS 17,A01,092677,Staff,8,0,75,67
1651102763297,COGS 100,A01,083619,Staff,0,30,60,60
1651102769320,COGS 101A,A01,083621,Davis; Joshua Daniel,0,29,60,60
1651102775342,COGS 101B,A01,091572,Staff,0,9,60,60
1651102781365,COGS 101C,A01,083625,Delgado; Tania,12,0,30,18
1651102787397,COGS 107A,A01,083627,Boyle; Mary E. T.,0,17,60,60
1651102793424,COGS 118A,A01,083075,Staff,0,10,60,60
1651102799465,CSE 3,A50,083646,Miranda; Gregory Joseph,15,0,38,23
1651102799465,CSE 3,A51,083647,Miranda; Gregory Joseph,36,0,37,1
1651102805492,CSE 8A,A50,083650,Miranda; Gregory Joseph,0,31,40,40
1651102811518,CSE 11,A01,083080,Cao; Yingjun,1,98,40,39
1651102817556,CSE 12,A01,083652,Staff,0,28,100,100
1651102823579,CSE 15L,A01,083654,Staff,0,3,50,50
1651102823579,CSE 15L,A02,083655,Staff,0,3,50,50
1651102829605,CSE 20,A01,083657,Staff,46,0,80,34
1651102835637,CSE 30,A01,083084,Eldon; John,0,38,80,80
1651102841663,CSE 100,A01,083659,Cao; Yingjun,0,72,50,50
1651102847688,CSE 134B,A01,083661,Powell; Thomas Allan,0,38,65,65
1651102853711,CSE 140,A01,083663,Staff,0,17,75,75
1651102859734,CSE 140L,A01,083088,Eldon; John,1,0,100,99
1651102865757,CSE 175,A01,083665,Kumar; Rakesh,0,0,25,25
1651102871780,CSE 190,A00,092507,Dubnov; Shlomo,9,0,20,11
1651102877802,ECE 45,A01,083139,Staff,0,8,60,60
1651102883829,ECE 65,A50,083695,Staff,0,7,30,30
1651102889860,ECE 109,A01,091882,Touri; Behrouz,32,0,70,38
1651102895890,ECE 180,A00,083140,Abi Samra; Nicholas Camill,17,0,30,13
1651102895890,ECE 180,B00,083141,Abi Samra; Nicholas Camill,0,1,30,32
1651102901917,MATH 10A,A01,083735,Patchell; Gregory David,0,0,30,30
1651102901917,MATH 10A,A02,083736,Patchell; Gregory David,26,0,30,4
1651102901917,MATH 10A,A03,083737,Patchell; Gregory David,22,0,30,8
1651102907940,MATH 10B,A01,083207,Staff,0,7,30,30
1651102907940,MATH 10B,A02,083208,Staff,0,6,30,30
1651102907940,MATH 10B,B01,083739,Staff,7,0,30,23
1651102907940,MATH 10B,B02,083740,Staff,28,0,30,2
1651102913964,MATH 18,A01,083743,Staff,0,0,30,30
1651102913964,MATH 18,A02,083744,Staff,23,0,30,7
1651102913964,MATH 18,A03,083745,Staff,19,0,30,11
1651102913964,MATH 18,A04,083746,Staff,26,0,30,4
1651102913964,MATH 18,B01,083748,Staff,0,16,30,30
1651102913964,MATH 18,B02,083749,Staff,0,14,30,30
1651102913964,MATH 18,B03,083750,Staff,0,15,30,30
1651102913964,MATH 18,B04,083751,Staff,0,14,30,30
1651102919994,MATH 20A,A01,083754,Staff,18,0,40,22
1651102926114,MATH 20B,A01,083756,Briones; Jor-el Thomas Caparas,0,14,30,30
1651102926114,MATH 20B,A02,083757,Briones; Jor-el Thomas Caparas,0,11,30,30
1651102932144,MATH 20C,A01,083760,Briones; Jor-el Thomas Caparas,1,17,30,29
1651102932144,MATH 20C,A02,083761,Briones; Jor-el Thomas Caparas,0,16,30,30
1651102932144,MATH 20C,B01,083762,Staff,7,0,30,23
1651102932144,MATH 20C,B02,083763,Staff,27,0,30,3
1651102938167,MATH 20D,A01,083765,Tran; Brian Kha,3,1,30,27
1651102938167,MATH 20D,A02,083766,Tran; Brian Kha,0,0,30,30
1651102938167,MATH 20D,A03,083767,Tran; Brian Kha,22,0,30,8
1651102944191,MATH 20E,A01,083771,Staff,0,0,30,30
1651102944191,MATH 20E,A02,083772,Staff,9,0,30,21
1651102944191,MATH 20E,B01,083773,Staff,5,0,35,30
1651102944191,MATH 20E,B02,083774,Staff,5,1,35,30
1651102950218,MATH 103A,A01,083777,Greenfeld; Be'Eri,0,17,30,30
1651102950218,MATH 103A,A02,083778,Greenfeld; Be'Eri,0,17,30,30
1651102950218,MATH 103A,B01,083779,Greenfeld; Be'Eri,0,15,30,30
1651102950218,MATH 103A,B02,083780,Greenfeld; Be'Eri,0,14,30,30
1651102956240,MATH 105,A01,085443,Staff,0,24,30,30
1651102962266,MATH 109,A01,083213,Ganzberger; Geoffrey Michael,0,8,30,30
1651102962266,MATH 109,A02,083214,Ganzberger; Geoffrey Michael,0,7,30,30
1651102962266,MATH 109,B01,083215,Ganzberger; Geoffrey Michael,0,8,30,30
1651102962266,MATH 109,B02,083216,Ganzberger; Geoffrey Michael,1,8,30,29
1651102968289,MATH 142A,A01,083219,Chow; Bennett,0,15,30,30
1651102968289,MATH 142A,A02,083220,Chow; Bennett,0,15,30,30
1651102968289,MATH 142A,B01,083221,Chow; Bennett,0,16,30,30
1651102968289,MATH 142A,B02,083222,Chow; Bennett,0,15,30,30
1651102974316,MATH 193A,A01,083224,Staff,0,9,30,30
1651102974316,MATH 193A,A02,083225,Staff,1,7,30,29
1651102974316,MATH 193A,A03,083781,Staff,0,7,30,30
1651102974316,MATH 193A,A04,083782,Staff,0,7,30,30
1651102980338,MATH 197,001,091859,McAuley; Julian John,9998,0,9999,1
1651102986399,COGS 9,A01,083615,Staff,0,20,60,60
1651102992422,COGS 11,A01,083617,Boyle; Mary E. T.,13,0,40,27
1651102998447,COGS 13,A01,083071,Staff,0,38,40,40
1651103004468,COGS 14A,A01,092681,Staff,0,40,100,100
1651103010491,COGS 14B,A01,083073,Cheng; Tzu-Han,0,11,50,50
1651103016523,COGS 17,A01,092677,Staff,8,0,75,67
1651103022547,COGS 100,A01,083619,Staff,0,30,60,60
1651103028569,COGS 101A,A01,083621,Davis; Joshua Daniel,0,29,60,60
1651103034596,COGS 101B,A01,091572,Staff,0,9,60,60
1651103040632,COGS 101C,A01,083625,Delgado; Tania,12,0,30,18
1651103046669,COGS 107A,A01,083627,Boyle; Mary E. T.,0,17,60,60
1651103052702,COGS 118A,A01,083075,Staff,0,10,60,60
1651103058728,CSE 3,A50,083646,Miranda; Gregory Joseph,15,0,38,23
1651103058728,CSE 3,A51,083647,Miranda; Gregory Joseph,36,0,37,1
1651103064759,CSE 8A,A50,083650,Miranda; Gregory Joseph,0,31,40,40
1651103070786,CSE 11,A01,083080,Cao; Yingjun,1,98,40,39
1651103076812,CSE 12,A01,083652,Staff,0,28,100,100
1651103082842,CSE 15L,A01,083654,Staff,0,3,50,50
1651103082842,CSE 15L,A02,083655,Staff,0,3,50,50
1651103088868,CSE 20,A01,083657,Staff,46,0,80,34
1651103094892,CSE 30,A01,083084,Eldon; John,0,38,80,80
1651103100918,CSE 100,A01,083659,Cao; Yingjun,0,72,50,50
1651103106941,CSE 134B,A01,083661,Powell; Thomas Allan,0,38,65,65
1651103112963,CSE 140,A01,083663,Staff,0,17,75,75
1651103118986,CSE 140L,A01,083088,Eldon; John,1,0,100,99
1651103125008,CSE 175,A01,083665,Kumar; Rakesh,0,0,25,25
1651103131036,CSE 190,A00,092507,Dubnov; Shlomo,9,0,20,11
1651103137062,ECE 45,A01,083139,Staff,0,8,60,60
1651103143085,ECE 65,A50,083695,Staff,0,7,30,30
1651103149110,ECE 109,A01,091882,Touri; Behrouz,32,0,70,38
1651103155133,ECE 180,A00,083140,Abi Samra; Nicholas Camill,17,0,30,13
1651103155133,ECE 180,B00,083141,Abi Samra; Nicholas Camill,0,1,30,32
1651103161158,MATH 10A,A01,083735,Patchell; Gregory David,0,0,30,30
1651103161158,MATH 10A,A02,083736,Patchell; Gregory David,26,0,30,4
1651103161158,MATH 10A,A03,083737,Patchell; Gregory David,22,0,30,8
1651103167189,MATH 10B,A01,083207,Staff,0,7,30,30
1651103167189,MATH 10B,A02,083208,Staff,0,6,30,30
1651103167189,MATH 10B,B01,083739,Staff,7,0,30,23
1651103167189,MATH 10B,B02,083740,Staff,28,0,30,2
1651103173213,MATH 18,A01,083743,Staff,0,0,30,30
1651103173213,MATH 18,A02,083744,Staff,23,0,30,7
1651103173213,MATH 18,A03,083745,Staff,19,0,30,11
1651103173213,MATH 18,A04,083746,Staff,26,0,30,4
1651103173213,MATH 18,B01,083748,Staff,0,16,30,30
1651103173213,MATH 18,B02,083749,Staff,0,14,30,30
1651103173213,MATH 18,B03,083750,Staff,0,15,30,30
1651103173213,MATH 18,B04,083751,Staff,0,14,30,30
1651103179235,MATH 20A,A01,083754,Staff,18,0,40,22
1651103185268,MATH 20B,A01,083756,Briones; Jor-el Thomas Caparas,0,14,30,30
1651103185268,MATH 20B,A02,083757,Briones; Jor-el Thomas Caparas,0,11,30,30
1651103191296,MATH 20C,A01,083760,Briones; Jor-el Thomas Caparas,1,17,30,29
1651103191296,MATH 20C,A02,083761,Briones; Jor-el Thomas Caparas,0,16,30,30
1651103191296,MATH 20C,B01,083762,Staff,7,0,30,23
1651103191296,MATH 20C,B02,083763,Staff,27,0,30,3
1651103197321,MATH 20D,A01,083765,Tran; Brian Kha,3,1,30,27
1651103197321,MATH 20D,A02,083766,Tran; Brian Kha,0,0,30,30
1651103197321,MATH 20D,A03,083767,Tran; Brian Kha,22,0,30,8
1651103203353,MATH 20E,A01,083771,Staff,0,0,30,30
1651103203353,MATH 20E,A02,083772,Staff,9,0,30,21
1651103203353,MATH 20E,B01,083773,Staff,5,0,35,30
1651103203353,MATH 20E,B02,083774,Staff,5,1,35,30
1651103209383,MATH 103A,A01,083777,Greenfeld; Be'Eri,0,17,30,30
1651103209383,MATH 103A,A02,083778,Greenfeld; Be'Eri,0,17,30,30
1651103209383,MATH 103A,B01,083779,Greenfeld; Be'Eri,0,15,30,30
1651103209383,MATH 103A,B02,083780,Greenfeld; Be'Eri,0,14,30,30
1651103215406,MATH 105,A01,085443,Staff,0,24,30,30
1651103221430,MATH 109,A01,083213,Ganzberger; Geoffrey Michael,0,8,30,30
1651103221430,MATH 109,A02,083214,Ganzberger; Geoffrey Michael,0,7,30,30
1651103221430,MATH 109,B01,083215,Ganzberger; Geoffrey Michael,0,8,30,30
1651103221430,MATH 109,B02,083216,Ganzberger; Geoffrey Michael,1,8,30,29
1651103227453,MATH 142A,A01,083219,Chow; Bennett,0,15,30,30
1651103227453,MATH 142A,A02,083220,Chow; Bennett,0,15,30,30
1651103227453,MATH 142A,B01,083221,Chow; Bennett,0,16,30,30
1651103227453,MATH 142A,B02,083222,Chow; Bennett,0,15,30,30
1651103233476,MATH 193A,A01,083224,Staff,0,9,30,30
1651103233476,MATH 193A,A02,083225,Staff,1,7,30,29
1651103233476,MATH 193A,A03,083781,Staff,0,7,30,30
1651103233476,MATH 193A,A04,083782,Staff,0,7,30,30
1651103239506,MATH 197,001,091859,McAuley; Julian John,9998,0,9999,1
1651103245562,COGS 9,A01,083615,Staff,0,20,60,60
1651103251589,COGS 11,A01,083617,Boyle; Mary E. T.,13,0,40,27
1651103257612,COGS 13,A01,083071,Staff,0,38,40,40
1651103263645,COGS 14A,A01,092681,Staff,0,40,100,100
1651103269680,COGS 14B,A01,083073,Cheng; Tzu-Han,0,11,50,50
1651103275713,COGS 17,A01,092677,Staff,8,0,75,67
1651103281745,COGS 100,A01,083619,Staff,0,30,60,60
1651103287767,COGS 101A,A01,083621,Davis; Joshua Daniel,0,29,60,60
1651103293790,COGS 101B,A01,091572,Staff,0,9,60,60
1651103299815,COGS 101C,A01,083625,Delgado; Tania,12,0,30,18
1651103305841,COGS 107A,A01,083627,Boyle; Mary E. T.,0,17,60,60
1651103311865,COGS 118A,A01,083075,Staff,0,10,60,60
1651103317892,CSE 3,A50,083646,Miranda; Gregory Joseph,15,0,38,23
1651103317892,CSE 3,A51,083647,Miranda; Gregory Joseph,36,0,37,1
1651103323918,CSE 8A,A50,083650,Miranda; Gregory Joseph,0,31,40,40
1651103329941,CSE 11,A01,083080,Cao; Yingjun,1,98,40,39
1651103335965,CSE 12,A01,083652,Staff,0,28,100,100
1651103341988,CSE 15L,A01,083654,Staff,0,3,50,50
1651103341988,CSE 15L,A02,083655,Staff,0,3,50,50
1651103348013,CSE 20,A01,083657,Staff,46,0,80,34
1651103354045,CSE 30,A01,083084,Eldon; John,0,38,80,80
1651103360069,CSE 100,A01,083659,Cao; Yingjun,0,72,50,50
1651103366092,CSE 134B,A01,083661,Powell; Thomas Allan,0,38,65,65
1651103372114,CSE 140,A01,083663,Staff,0,17,75,75
1651103378140,CSE 140L,A01,083088,Eldon; John,1,0,100,99
1651103384171,CSE 175,A01,083665,Kumar; Rakesh,0,0,25,25
1651103390198,CSE 190,A00,092507,Dubnov; Shlomo,9,0,20,11
1651103396221,ECE 45,A01,083139,Staff,0,8,60,60
1651103402246,ECE 65,A50,083695,Staff,0,7,30,30
1651103408269,ECE 109,A01,091882,Touri; Behrouz,32,0,70,38
1651103414294,ECE 180,A00,083140,Abi Samra; Nicholas Camill,17,0,30,13
1651103414294,ECE 180,B00,083141,Abi Samra; Nicholas Camill,0,1,30,32
1651103420338,MATH 10A,A01,083735,Patchell; Gregory David,0,0,30,30
1651103420338,MATH 10A,A02,083736,Patchell; Gregory David,26,0,30,4
1651103420338,MATH 10A,A03,083737,Patchell; Gregory David,22,0,30,8
1651103426363,MATH 10B,A01,083207,Staff,0,7,30,30
1651103426363,MATH 10B,A02,083208,Staff,0,6,30,30
1651103426363,MATH 10B,B01,083739,Staff,7,0,30,23
1651103426363,MATH 10B,B02,083740,Staff,28,0,30,2
1651103432388,MATH 18,A01,083743,Staff,0,0,30,30
1651103432388,MATH 18,A02,083744,Staff,23,0,30,7
1651103432388,MATH 18,A03,083745,Staff,19,0,30,11
1651103432388,MATH 18,A04,083746,Staff,26,0,30,4
1651103432388,MATH 18,B01,083748,Staff,0,16,30,30
1651103432388,MATH 18,B02,083749,Staff,0,14,30,30
1651103432388,MATH 18,B03,083750,Staff,0,15,30,30
1651103432388,MATH 18,B04,083751,Staff,0,14,30,30
1651103438414,MATH 20A,A01,083754,Staff,18,0,40,22
1651103444436,MATH 20B,A01,083756,Briones; Jor-el Thomas Caparas,0,14,30,30
1651103444436,MATH 20B,A02,083757,Briones; Jor-el Thomas Caparas,0,11,30,30
1651103450458,MATH 20C,A01,083760,Briones; Jor-el Thomas Caparas,1,17,30,29
1651103450458,MATH 20C,A02,083761,Briones; Jor-el Thomas Caparas,0,16,30,30
1651103450458,MATH 20C,B01,083762,Staff,7,0,30,23
1651103450458,MATH 20C,B02,083763,Staff,27,0,30,3
1651103456486,MATH 20D,A01,083765,Tran; Brian Kha,3,1,30,27
1651103456486,MATH 20D,A02,083766,Tran; Brian Kha,0,0,30,30
1651103456486,MATH 20D,A03,083767,Tran; Brian Kha,22,0,30,8
1651103462508,MATH 20E,A01,083771,Staff,0,0,30,30
1651103462508,MATH 20E,A02,083772,Staff,9,0,30,21
1651103462508,MATH 20E,B01,083773,Staff,5,0,35,30
1651103462508,MATH 20E,B02,083774,Staff,5,1,35,30
1651103468530,MATH 103A,A01,083777,Greenfeld; Be'Eri,0,17,30,30
1651103468530,MATH 103A,A02,083778,Greenfeld; Be'Eri,0,17,30,30
1651103468530,MATH 103A,B01,083779,Greenfeld; Be'Eri,0,15,30,30
1651103468530,MATH 103A,B02,083780,Greenfeld; Be'Eri,0,14,30,30
1651103474553,MATH 105,A01,085443,Staff,0,24,30,30
1651103480579,MATH 109,A01,083213,Ganzberger; Geoffrey Michael,0,8,30,30
1651103480579,MATH 109,A02,083214,Ganzberger; Geoffrey Michael,0,7,30,30
1651103480579,MATH 109,B01,083215,Ganzberger; Geoffrey Michael,0,8,30,30
1651103480579,MATH 109,B02,083216,Ganzberger; Geoffrey Michael,1,8,30,29
1651103486611,MATH 142A,A01,083219,Chow; Bennett,0,15,30,30
1651103486611,MATH 142A,A02,083220,Chow; Bennett,0,15,30,30
1651103486611,MATH 142A,B01,083221,Chow; Bennett,0,16,30,30
1651103486611,MATH 142A,B02,083222,Chow; Bennett,0,16,30,30
1651103492638,MATH 193A,A01,083224,Staff,0,9,30,30
1651103492638,MATH 193A,A02,083225,Staff,1,7,30,29
1651103492638,MATH 193A,A03,083781,Staff,0,7,30,30
1651103492638,MATH 193A,A04,083782,Staff,0,7,30,30
1651103498662,MATH 197,001,091859,McAuley; Julian John,9998,0,9999,1
1651103504742,COGS 9,A01,083615,Staff,0,20,60,60
1651103510770,COGS 11,A01,083617,Boyle; Mary E. T.,13,0,40,27
1651103516871,COGS 13,A01,083071,Staff,0,38,40,40
1651103522894,COGS 14A,A01,092681,Staff,0,40,100,100
1651103528916,COGS 14B,A01,083073,Cheng; Tzu-Han,0,11,50,50
1651103534939,COGS 17,A01,092677,Staff,8,0,75,67
1651103540963,COGS 100,A01,083619,Staff,0,30,60,60
1651103546986,COGS 101A,A01,083621,Davis; Joshua Daniel,0,29,60,60
1651103553010,COGS 101B,A01,091572,Staff,0,9,60,60
1651103559042,COGS 101C,A01,083625,Delgado; Tania,12,0,30,18
1651103565071,COGS 107A,A01,083627,Boyle; Mary E. T.,0,17,60,60
1651103571095,COGS 118A,A01,083075,Staff,0,10,60,60
1651103577117,CSE 3,A50,083646,Miranda; Gregory Joseph,15,0,38,23
1651103577117,CSE 3,A51,083647,Miranda; Gregory Joseph,36,0,37,1
1651103583155,CSE 8A,A50,083650,Miranda; Gregory Joseph,0,31,40,40
1651103589186,CSE 11,A01,083080,Cao; Yingjun,1,98,40,39
1651103595213,CSE 12,A01,083652,Staff,0,28,100,100
1651103601238,CSE 15L,A01,083654,Staff,0,3,50,50
1651103601238,CSE 15L,A02,083655,Staff,0,3,50,50
1651103607261,CSE 20,A01,083657,Staff,46,0,80,34
1651103613285,CSE 30,A01,083084,Eldon; John,0,38,80,80
1651103619307,CSE 100,A01,083659,Cao; Yingjun,0,72,50,50
1651103625334,CSE 134B,A01,083661,Powell; Thomas Allan,0,38,65,65
1651103631357,CSE 140,A01,083663,Staff,0,17,75,75
1651103637382,CSE 140L,A01,083088,Eldon; John,1,0,100,99
1651103643413,CSE 175,A01,083665,Kumar; Rakesh,0,0,25,25
1651103649435,CSE 190,A00,092507,Dubnov; Shlomo,9,0,20,11
1651103655459,ECE 45,A01,083139,Staff,0,8,60,60
1651103661482,ECE 65,A50,083695,Staff,0,7,30,30
1651103667508,ECE 109,A01,091882,Touri; Behrouz,32,0,70,38
1651103673531,ECE 180,A00,083140,Abi Samra; Nicholas Camill,17,0,30,13
1651103673531,ECE 180,B00,083141,Abi Samra; Nicholas Camill,0,1,30,32
1651103679565,MATH 10A,A01,083735,Patchell; Gregory David,0,0,30,30
1651103679565,MATH 10A,A02,083736,Patchell; Gregory David,26,0,30,4
1651103679565,MATH 10A,A03,083737,Patchell; Gregory David,22,0,30,8
1651103685593,MATH 10B,A01,083207,Staff,0,7,30,30
1651103685593,MATH 10B,A02,083208,Staff,0,6,30,30
1651103685593,MATH 10B,B01,083739,Staff,7,0,30,23
1651103685593,MATH 10B,B02,083740,Staff,28,0,30,2
1651103691630,MATH 18,A01,083743,Staff,0,0,30,30
1651103691630,MATH 18,A02,083744,Staff,23,0,30,7
1651103691630,MATH 18,A03,083745,Staff,19,0,30,11
1651103691630,MATH 18,A04,083746,Staff,26,0,30,4
1651103691630,MATH 18,B01,083748,Staff,0,16,30,30
1651103691630,MATH 18,B02,083749,Staff,0,14,30,30
1651103691630,MATH 18,B03,083750,Staff,0,15,30,30
1651103691630,MATH 18,B04,083751,Staff,0,14,30,30
1651103697655,MATH 20A,A01,083754,Staff,18,0,40,22
1651103703683,MATH 20B,A01,083756,Briones; Jor-el Thomas Caparas,0,14,30,30
1651103703683,MATH 20B,A02,083757,Briones; Jor-el Thomas Caparas,0,11,30,30
1651103709714,MATH 20C,A01,083760,Briones; Jor-el Thomas Caparas,1,17,30,29
1651103709714,MATH 20C,A02,083761,Briones; Jor-el Thomas Caparas,0,16,30,30
1651103709714,MATH 20C,B01,083762,Staff,7,0,30,23
1651103709714,MATH 20C,B02,083763,Staff,27,0,30,3
1651103715740,MATH 20D,A01,083765,Tran; Brian Kha,3,1,30,27
1651103715740,MATH 20D,A02,083766,Tran; Brian Kha,0,0,30,30
1651103715740,MATH 20D,A03,083767,Tran; Brian Kha,22,0,30,8
1651103721765,MATH 20E,A01,083771,Staff,0,0,30,30
1651103721765,MATH 20E,A02,083772,Staff,9,0,30,21
1651103721765,MATH 20E,B01,083773,Staff,5,0,35,30
1651103721765,MATH 20E,B02,083774,Staff,5,1,35,30
1651103727788,MATH 103A,A01,083777,Greenfeld; Be'Eri,0,17,30,30
1651103727788,MATH 103A,A02,083778,Greenfeld; Be'Eri,0,17,30,30
1651103727788,MATH 103A,B01,083779,Greenfeld; Be'Eri,0,15,30,30
1651103727788,MATH 103A,B02,083780,Greenfeld; Be'Eri,0,14,30,30
1651103733821,MATH 105,A01,085443,Staff,0,24,30,30
1651103739866,MATH 109,A01,083213,Ganzberger; Geoffrey Michael,0,8,30,30
1651103739866,MATH 109,A02,083214,Ganzberger; Geoffrey Michael,0,7,30,30
1651103739866,MATH 109,B01,083215,Ganzberger; Geoffrey Michael,0,8,30,30
1651103739866,MATH 109,B02,083216,Ganzberger; Geoffrey Michael,1,8,30,29
1651103745893,MATH 142A,A01,083219,Chow; Bennett,0,15,30,30
1651103745893,MATH 142A,A02,083220,Chow; Bennett,0,15,30,30
1651103745893,MATH 142A,B01,083221,Chow; Bennett,0,16,30,30
1651103745893,MATH 142A,B02,083222,Chow; Bennett,0,16,30,30
1651103751920,MATH 193A,A01,083224,Staff,0,9,30,30
1651103751920,MATH 193A,A02,083225,Staff,1,7,30,29
1651103751920,MATH 193A,A03,083781,Staff,0,7,30,30
1651103751920,MATH 193A,A04,083782,Staff,0,7,30,30
1651103757944,MATH 197,001,091859,McAuley; Julian John,9998,0,9999,1
1651103764002,COGS 9,A01,083615,Staff,0,20,60,60
1651103770025,COGS 11,A01,083617,Boyle; Mary E. T.,13,0,40,27
1651103776058,COGS 13,A01,083071,Staff,0,38,40,40
1651103782088,COGS 14A,A01,092681,Staff,0,40,100,100
1651103788116,COGS 14B,A01,083073,Cheng; Tzu-Han,0,11,50,50
1651103794154,COGS 17,A01,092677,Staff,8,0,75,67
1651103800177,COGS 100,A01,083619,Staff,0,30,60,60
1651103806204,COGS 101A,A01,083621,Davis; Joshua Daniel,0,29,60,60
1651103812229,COGS 101B,A01,091572,Staff,0,9,60,60
1651103818255,COGS 101C,A01,083625,Delgado; Tania,12,0,30,18
1651103824284,COGS 107A,A01,083627,Boyle; Mary E. T.,0,17,60,60
1651103830310,COGS 118A,A01,083075,Staff,0,10,60,60
1651103836340,CSE 3,A50,083646,Miranda; Gregory Joseph,15,0,38,23
1651103836340,CSE 3,A51,083647,Miranda; Gregory Joseph,36,0,37,1
1651103842368,CSE 8A,A50,083650,Miranda; Gregory Joseph,0,31,40,40
1651103848390,CSE 11,A01,083080,Cao; Yingjun,1,98,40,39
1651103854412,CSE 12,A01,083652,Staff,0,28,100,100
1651103860435,CSE 15L,A01,083654,Staff,0,3,50,50
1651103860435,CSE 15L,A02,083655,Staff,0,3,50,50
1651103866459,CSE 20,A01,083657,Staff,46,0,80,34
1651103872483,CSE 30,A01,083084,Eldon; John,0,38,80,80
1651103878513,CSE 100,A01,083659,Cao; Yingjun,0,72,50,50
1651103884536,CSE 134B,A01,083661,Powell; Thomas Allan,0,38,65,65
1651103890558,CSE 140,A01,083663,Staff,0,17,75,75
1651103896582,CSE 140L,A01,083088,Eldon; John,1,0,100,99
1651103902605,CSE 175,A01,083665,Kumar; Rakesh,0,0,25,25
1651103908628,CSE 190,A00,092507,Dubnov; Shlomo,9,0,20,11
1651103914654,ECE 45,A01,083139,Staff,0,8,60,60
1651103920680,ECE 65,A50,083695,Staff,0,7,30,30
1651103926705,ECE 109,A01,091882,Touri; Behrouz,32,0,70,38
1651103932729,ECE 180,A00,083140,Abi Samra; Nicholas Camill,17,0,30,13
1651103932729,ECE 180,B00,083141,Abi Samra; Nicholas Camill,0,1,30,32
1651103938755,MATH 10A,A01,083735,Patchell; Gregory David,0,0,30,30
1651103938755,MATH 10A,A02,083736,Patchell; Gregory David,26,0,30,4
1651103938755,MATH 10A,A03,083737,Patchell; Gregory David,22,0,30,8
1651103944790,MATH 10B,A01,083207,Staff,0,7,30,30
1651103944790,MATH 10B,A02,083208,Staff,0,6,30,30
1651103944790,MATH 10B,B01,083739,Staff,7,0,30,23
1651103944790,MATH 10B,B02,083740,Staff,28,0,30,2
1651103950833,MATH 18,A01,083743,Staff,0,0,30,30
1651103950833,MATH 18,A02,083744,Staff,23,0,30,7
1651103950833,MATH 18,A03,083745,Staff,19,0,30,11
1651103950833,MATH 18,A04,083746,Staff,26,0,30,4
1651103950833,MATH 18,B01,083748,Staff,0,16,30,30
1651103950833,MATH 18,B02,083749,Staff,0,14,30,30
1651103950833,MATH 18,B03,083750,Staff,0,15,30,30
1651103950833,MATH 18,B04,083751,Staff,0,14,30,30
1651103956857,MATH 20A,A01,083754,Staff,18,0,40,22
1651103962881,MATH 20B,A01,083756,Briones; Jor-el Thomas Caparas,0,14,30,30
1651103962881,MATH 20B,A02,083757,Briones; Jor-el Thomas Caparas,0,11,30,30
1651103968910,MATH 20C,A01,083760,Briones; Jor-el Thomas Caparas,1,17,30,29
1651103968910,MATH 20C,A02,083761,Briones; Jor-el Thomas Caparas,0,16,30,30
1651103968910,MATH 20C,B01,083762,Staff,7,0,30,23
1651103968910,MATH 20C,B02,083763,Staff,27,0,30,3
1651103974934,MATH 20D,A01,083765,Tran; Brian Kha,3,1,30,27
1651103974934,MATH 20D,A02,083766,Tran; Brian Kha,0,0,30,30
1651103974934,MATH 20D,A03,083767,Tran; Brian Kha,22,0,30,8
1651103980955,MATH 20E,A01,083771,Staff,0,0,30,30
1651103980955,MATH 20E,A02,083772,Staff,9,0,30,21
1651103980955,MATH 20E,B01,083773,Staff,5,0,35,30
1651103980955,MATH 20E,B02,083774,Staff,5,1,35,30
1651103986980,MATH 103A,A01,083777,Greenfeld; Be'Eri,0,17,30,30
1651103986980,MATH 103A,A02,083778,Greenfeld; Be'Eri,0,17,30,30
1651103986980,MATH 103A,B01,083779,Greenfeld; Be'Eri,0,15,30,30
1651103986980,MATH 103A,B02,083780,Greenfeld; Be'Eri,0,14,30,30
1651103993005,MATH 105,A01,085443,Staff,0,24,30,30
1651103999029,MATH 109,A01,083213,Ganzberger; Geoffrey Michael,0,8,30,30
1651103999029,MATH 109,A02,083214,Ganzberger; Geoffrey Michael,0,7,30,30
1651103999029,MATH 109,B01,083215,Ganzberger; Geoffrey Michael,0,8,30,30
1651103999029,MATH 109,B02,083216,Ganzberger; Geoffrey Michael,1,8,30,29
1651104005053,MATH 142A,A01,083219,Chow; Bennett,0,15,30,30
1651104005053,MATH 142A,A02,083220,Chow; Bennett,0,15,30,30
1651104005053,MATH 142A,B01,083221,Chow; Bennett,0,16,30,30
1651104005053,MATH 142A,B02,083222,Chow; Bennett,0,16,30,30
1651104011078,MATH 193A,A01,083224,Staff,0,9,30,30
1651104011078,MATH 193A,A02,083225,Staff,1,7,30,29
1651104011078,MATH 193A,A03,083781,Staff,0,7,30,30
1651104011078,MATH 193A,A04,083782,Staff,0,7,30,30
1651104017105,MATH 197,001,091859,McAuley; Julian John,9998,0,9999,1
1651104023183,COGS 9,A01,083615,Staff,0,20,60,60
1651104029206,COGS 11,A01,083617,Boyle; Mary E. T.,13,0,40,27
1651104035232,COGS 13,A01,083071,Staff,0,38,40,40
1651104041259,COGS 14A,A01,092681,Staff,0,40,100,100
1651104047286,COGS 14B,A01,083073,Cheng; Tzu-Han,0,11,50,50
1651104053316,COGS 17,A01,092677,Staff,8,0,75,67
1651104059340,COGS 100,A01,083619,Staff,0,30,60,60
1651104065370,COGS 101A,A01,083621,Davis; Joshua Daniel,0,29,60,60
1651104071393,COGS 101B,A01,091572,Staff,0,9,60,60
1651104077425,COGS 101C,A01,083625,Delgado; Tania,12,0,30,18
1651104083446,COGS 107A,A01,083627,Boyle; Mary E. T.,0,17,60,60
1651104089470,COGS 118A,A01,083075,Staff,0,10,60,60
1651104095493,CSE 3,A50,083646,Miranda; Gregory Joseph,15,0,38,23
1651104095493,CSE 3,A51,083647,Miranda; Gregory Joseph,36,0,37,1
1651104101518,CSE 8A,A50,083650,Miranda; Gregory Joseph,0,31,40,40
1651104107542,CSE 11,A01,083080,Cao; Yingjun,1,98,40,39
1651104113659,CSE 12,A01,083652,Staff,0,28,100,100
1651104119689,CSE 15L,A01,083654,Staff,0,3,50,50
1651104119689,CSE 15L,A02,083655,Staff,0,3,50,50
1651104125714,CSE 20,A01,083657,Staff,46,0,80,34
1651104131737,CSE 30,A01,083084,Eldon; John,0,38,80,80
1651104137766,CSE 100,A01,083659,Cao; Yingjun,0,72,50,50
1651104143788,CSE 134B,A01,083661,Powell; Thomas Allan,0,38,65,65
1651104149811,CSE 140,A01,083663,Staff,0,17,75,75
1651104155836,CSE 140L,A01,083088,Eldon; John,1,0,100,99
1651104161858,CSE 175,A01,083665,Kumar; Rakesh,0,0,25,25
1651104167886,CSE 190,A00,092507,Dubnov; Shlomo,9,0,20,11
1651104173916,ECE 45,A01,083139,Staff,0,8,60,60
1651104179947,ECE 65,A50,083695,Staff,0,7,30,30
1651104185970,ECE 109,A01,091882,Touri; Behrouz,32,0,70,38
1651104191993,ECE 180,A00,083140,Abi Samra; Nicholas Camill,17,0,30,13
1651104191993,ECE 180,B00,083141,Abi Samra; Nicholas Camill,0,1,30,32
1651104198020,MATH 10A,A01,083735,Patchell; Gregory David,0,0,30,30
1651104198020,MATH 10A,A02,083736,Patchell; Gregory David,26,0,30,4
1651104198020,MATH 10A,A03,083737,Patchell; Gregory David,22,0,30,8
1651104204044,MATH 10B,A01,083207,Staff,0,7,30,30
1651104204044,MATH 10B,A02,083208,Staff,0,6,30,30
1651104204044,MATH 10B,B01,083739,Staff,7,0,30,23
1651104204044,MATH 10B,B02,083740,Staff,28,0,30,2
1651104210067,MATH 18,A01,083743,Staff,0,0,30,30
1651104210067,MATH 18,A02,083744,Staff,23,0,30,7
1651104210067,MATH 18,A03,083745,Staff,19,0,30,11
1651104210067,MATH 18,A04,083746,Staff,26,0,30,4
1651104210067,MATH 18,B01,083748,Staff,0,16,30,30
1651104210067,MATH 18,B02,083749,Staff,0,14,30,30
1651104210067,MATH 18,B03,083750,Staff,0,15,30,30
1651104210067,MATH 18,B04,083751,Staff,0,14,30,30
1651104216096,MATH 20A,A01,083754,Staff,18,0,40,22
1651104222119,MATH 20B,A01,083756,Briones; Jor-el Thomas Caparas,0,14,30,30
1651104222119,MATH 20B,A02,083757,Briones; Jor-el Thomas Caparas,0,11,30,30
1651104228142,MATH 20C,A01,083760,Briones; Jor-el Thomas Caparas,1,17,30,29
1651104228142,MATH 20C,A02,083761,Briones; Jor-el Thomas Caparas,0,16,30,30
1651104228142,MATH 20C,B01,083762,Staff,7,0,30,23
1651104228142,MATH 20C,B02,083763,Staff,27,0,30,3
1651104234165,MATH 20D,A01,083765,Tran; Brian Kha,3,1,30,27
1651104234165,MATH 20D,A02,083766,Tran; Brian Kha,0,0,30,30
1651104234165,MATH 20D,A03,083767,Tran; Brian Kha,22,0,30,8
1651104240203,MATH 20E,A01,083771,Staff,0,0,30,30
1651104240203,MATH 20E,A02,083772,Staff,9,0,30,21
1651104240203,MATH 20E,B01,083773,Staff,5,0,35,30
1651104240203,MATH 20E,B02,083774,Staff,5,1,35,30
1651104246232,MATH 103A,A01,083777,Greenfeld; Be'Eri,0,17,30,30
1651104246232,MATH 103A,A02,083778,Greenfeld; Be'Eri,0,17,30,30
1651104246232,MATH 103A,B01,083779,Greenfeld; Be'Eri,0,15,30,30
1651104246232,MATH 103A,B02,083780,Greenfeld; Be'Eri,0,14,30,30
1651104252259,MATH 105,A01,085443,Staff,0,24,30,30
1651104258284,MATH 109,A01,083213,Ganzberger; Geoffrey Michael,0,8,30,30
1651104258284,MATH 109,A02,083214,Ganzberger; Geoffrey Michael,0,7,30,30
1651104258284,MATH 109,B01,083215,Ganzberger; Geoffrey Michael,0,8,30,30
1651104258284,MATH 109,B02,083216,Ganzberger; Geoffrey Michael,1,8,30,29
1651104264308,MATH 142A,A01,083219,Chow; Bennett,0,15,30,30
1651104264308,MATH 142A,A02,083220,Chow; Bennett,0,15,30,30
1651104264308,MATH 142A,B01,083221,Chow; Bennett,0,16,30,30
1651104264308,MATH 142A,B02,083222,Chow; Bennett,0,16,30,30
1651104270337,MATH 193A,A01,083224,Staff,0,9,30,30
1651104270337,MATH 193A,A02,083225,Staff,1,7,30,29
1651104270337,MATH 193A,A03,083781,Staff,0,7,30,30
1651104270337,MATH 193A,A04,083782,Staff,0,7,30,30
1651104276361,MATH 197,001,091859,McAuley; Julian John,9998,0,9999,1
1651104282413,COGS 9,A01,083615,Staff,0,20,60,60
1651104288439,COGS 11,A01,083617,Boyle; Mary E. T.,13,0,40,27
1651104294465,COGS 13,A01,083071,Staff,0,38,40,40
1651104300502,COGS 14A,A01,092681,Staff,0,40,100,100
1651104306524,COGS 14B,A01,083073,Cheng; Tzu-Han,0,11,50,50
1651104312552,COGS 17,A01,092677,Staff,8,0,75,67
1651104318575,COGS 100,A01,083619,Staff,0,30,60,60
1651104324599,COGS 101A,A01,083621,Davis; Joshua Daniel,0,29,60,60
1651104330621,COGS 101B,A01,091572,Staff,0,9,60,60
1651104336644,COGS 101C,A01,083625,Delgado; Tania,12,0,30,18
1651104342671,COGS 107A,A01,083627,Boyle; Mary E. T.,0,17,60,60
1651104348697,COGS 118A,A01,083075,Staff,0,10,60,60
1651104354728,CSE 3,A50,083646,Miranda; Gregory Joseph,15,0,38,23
1651104354728,CSE 3,A51,083647,Miranda; Gregory Joseph,36,0,37,1
1651104360752,CSE 8A,A50,083650,Miranda; Gregory Joseph,0,31,40,40
1651104366787,CSE 11,A01,083080,Cao; Yingjun,1,99,40,39
1651104372821,CSE 12,A01,083652,Staff,0,29,100,100
1651104378844,CSE 15L,A01,083654,Staff,0,3,50,50
1651104378844,CSE 15L,A02,083655,Staff,0,3,50,50
1651104384868,CSE 20,A01,083657,Staff,46,0,80,34
1651104390889,CSE 30,A01,083084,Eldon; John,0,38,80,80
1651104396914,CSE 100,A01,083659,Cao; Yingjun,0,72,50,50
1651104402936,CSE 134B,A01,083661,Powell; Thomas Allan,0,38,65,65
1651104408959,CSE 140,A01,083663,Staff,0,17,75,75
1651104414981,CSE 140L,A01,083088,Eldon; John,1,0,100,99
1651104421010,CSE 175,A01,083665,Kumar; Rakesh,0,0,25,25
1651104427033,CSE 190,A00,092507,Dubnov; Shlomo,9,0,20,11
1651104433058,ECE 45,A01,083139,Staff,0,8,60,60
1651104439083,ECE 65,A50,083695,Staff,0,7,30,30
1651104445121,ECE 109,A01,091882,Touri; Behrouz,32,0,70,38
1651104451143,ECE 180,A00,083140,Abi Samra; Nicholas Camill,17,0,30,13
1651104451143,ECE 180,B00,083141,Abi Samra; Nicholas Camill,0,1,30,32
1651104457180,MATH 10A,A01,083735,Patchell; Gregory David,0,0,30,30
1651104457180,MATH 10A,A02,083736,Patchell; Gregory David,26,0,30,4
1651104457180,MATH 10A,A03,083737,Patchell; Gregory David,22,0,30,8
1651104463204,MATH 10B,A01,083207,Staff,0,7,30,30
1651104463204,MATH 10B,A02,083208,Staff,0,6,30,30
1651104463204,MATH 10B,B01,083739,Staff,7,0,30,23
1651104463204,MATH 10B,B02,083740,Staff,28,0,30,2
1651104469235,MATH 18,A01,083743,Staff,0,0,30,30
1651104469235,MATH 18,A02,083744,Staff,23,0,30,7
1651104469235,MATH 18,A03,083745,Staff,19,0,30,11
1651104469235,MATH 18,A04,083746,Staff,26,0,30,4
1651104469235,MATH 18,B01,083748,Staff,0,16,30,30
1651104469235,MATH 18,B02,083749,Staff,0,14,30,30
1651104469235,MATH 18,B03,083750,Staff,0,15,30,30
1651104469235,MATH 18,B04,083751,Staff,0,14,30,30
1651104475259,MATH 20A,A01,083754,Staff,18,0,40,22
1651104481287,MATH 20B,A01,083756,Briones; Jor-el Thomas Caparas,0,14,30,30
1651104481287,MATH 20B,A02,083757,Briones; Jor-el Thomas Caparas,0,11,30,30
1651104487312,MATH 20C,A01,083760,Briones; Jor-el Thomas Caparas,1,17,30,29
1651104487312,MATH 20C,A02,083761,Briones; Jor-el Thomas Caparas,0,16,30,30
1651104487312,MATH 20C,B01,083762,Staff,7,0,30,23
1651104487312,MATH 20C,B02,083763,Staff,27,0,30,3
1651104493336,MATH 20D,A01,083765,Tran; Brian Kha,3,1,30,27
1651104493336,MATH 20D,A02,083766,Tran; Brian Kha,0,0,30,30
1651104493336,MATH 20D,A03,083767,Tran; Brian Kha,22,0,30,8
1651104499360,MATH 20E,A01,083771,Staff,0,0,30,30
1651104499360,MATH 20E,A02,083772,Staff,9,0,30,21
1651104499360,MATH 20E,B01,083773,Staff,5,0,35,30
1651104499360,MATH 20E,B02,083774,Staff,5,1,35,30
1651104505387,MATH 103A,A01,083777,Greenfeld; Be'Eri,0,17,30,30
1651104505387,MATH 103A,A02,083778,Greenfeld; Be'Eri,0,17,30,30
1651104505387,MATH 103A,B01,083779,Greenfeld; Be'Eri,0,15,30,30
1651104505387,MATH 103A,B02,083780,Greenfeld; Be'Eri,0,14,30,30
1651104511411,MATH 105,A01,085443,Staff,0,24,30,30
1651104517439,MATH 109,A01,083213,Ganzberger; Geoffrey Michael,0,8,30,30
1651104517439,MATH 109,A02,083214,Ganzberger; Geoffrey Michael,0,7,30,30
1651104517439,MATH 109,B01,083215,Ganzberger; Geoffrey Michael,0,8,30,30
1651104517439,MATH 109,B02,083216,Ganzberger; Geoffrey Michael,1,8,30,29
1651104523462,MATH 142A,A01,083219,Chow; Bennett,0,15,30,30
1651104523462,MATH 142A,A02,083220,Chow; Bennett,0,15,30,30
1651104523462,MATH 142A,B01,083221,Chow; Bennett,0,16,30,30
1651104523462,MATH 142A,B02,083222,Chow; Bennett,0,16,30,30
1651104529491,MATH 193A,A01,083224,Staff,0,9,30,30
1651104529491,MATH 193A,A02,083225,Staff,1,7,30,29
1651104529491,MATH 193A,A03,083781,Staff,0,7,30,30
1651104529491,MATH 193A,A04,083782,Staff,0,7,30,30
1651104535513,MATH 197,001,091859,McAuley; Julian John,9998,0,9999,1
1651104541573,COGS 9,A01,083615,Staff,0,20,60,60
1651104547600,COGS 11,A01,083617,Boyle; Mary E. T.,13,0,40,27
1651104553621,COGS 13,A01,083071,Staff,0,38,40,40
1651104559643,COGS 14A,A01,092681,Staff,0,40,100,100
1651104565669,COGS 14B,A01,083073,Cheng; Tzu-Han,0,11,50,50
1651104571693,COGS 17,A01,092677,Staff,8,0,75,67
1651104577718,COGS 100,A01,083619,Staff,0,30,60,60
1651104583740,COGS 101A,A01,083621,Davis; Joshua Daniel,0,29,60,60
1651104589764,COGS 101B,A01,091572,Staff,0,9,60,60
1651104595792,COGS 101C,A01,083625,Delgado; Tania,12,0,30,18
1651104601822,COGS 107A,A01,083627,Boyle; Mary E. T.,0,17,60,60
1651104607846,COGS 118A,A01,083075,Staff,0,10,60,60
1651104613873,CSE 3,A50,083646,Miranda; Gregory Joseph,15,0,38,23
1651104613873,CSE 3,A51,083647,Miranda; Gregory Joseph,36,0,37,1
1651104619899,CSE 8A,A50,083650,Miranda; Gregory Joseph,0,30,40,40
1651104625924,CSE 11,A01,083080,Cao; Yingjun,1,98,40,39
1651104631950,CSE 12,A01,083652,Staff,0,29,100,100
1651104637982,CSE 15L,A01,083654,Staff,0,3,50,50
1651104637982,CSE 15L,A02,083655,Staff,0,3,50,50
1651104644012,CSE 20,A01,083657,Staff,46,0,80,34
1651104650038,CSE 30,A01,083084,Eldon; John,0,38,80,80
1651104656068,CSE 100,A01,083659,Cao; Yingjun,0,72,50,50
1651104662095,CSE 134B,A01,083661,Powell; Thomas Allan,0,38,65,65
1651104668118,CSE 140,A01,083663,Staff,0,17,75,75
1651104674144,CSE 140L,A01,083088,Eldon; John,1,0,100,99
1651104680178,CSE 175,A01,083665,Kumar; Rakesh,0,0,25,25
1651104686203,CSE 190,A00,092507,Dubnov; Shlomo,9,0,20,11
1651104692228,ECE 45,A01,083139,Staff,0,8,60,60
1651104698252,ECE 65,A50,083695,Staff,0,7,30,30
1651104704281,ECE 109,A01,091882,Touri; Behrouz,32,0,70,38
1651104710393,ECE 180,A00,083140,Abi Samra; Nicholas Camill,17,0,30,13
1651104710393,ECE 180,B00,083141,Abi Samra; Nicholas Camill,0,1,30,32
1651104716419,MATH 10A,A01,083735,Patchell; Gregory David,0,0,30,30
1651104716419,MATH 10A,A02,083736,Patchell; Gregory David,26,0,30,4
1651104716419,MATH 10A,A03,083737,Patchell; Gregory David,22,0,30,8
1651104722446,MATH 10B,A01,083207,Staff,0,7,30,30
1651104722446,MATH 10B,A02,083208,Staff,0,6,30,30
1651104722446,MATH 10B,B01,083739,Staff,7,0,30,23
1651104722446,MATH 10B,B02,083740,Staff,28,0,30,2
1651104728477,MATH 18,A01,083743,Staff,0,0,30,30
1651104728477,MATH 18,A02,083744,Staff,23,0,30,7
1651104728477,MATH 18,A03,083745,Staff,19,0,30,11
1651104728477,MATH 18,A04,083746,Staff,26,0,30,4
1651104728477,MATH 18,B01,083748,Staff,0,16,30,30
1651104728477,MATH 18,B02,083749,Staff,0,14,30,30
1651104728477,MATH 18,B03,083750,Staff,0,15,30,30
1651104728477,MATH 18,B04,083751,Staff,0,14,30,30
1651104734503,MATH 20A,A01,083754,Staff,18,0,40,22
1651104740545,MATH 20B,A01,083756,Briones; Jor-el Thomas Caparas,0,14,30,30
1651104740545,MATH 20B,A02,083757,Briones; Jor-el Thomas Caparas,0,11,30,30
1651104746574,MATH 20C,A01,083760,Briones; Jor-el Thomas Caparas,1,17,30,29
1651104746574,MATH 20C,A02,083761,Briones; Jor-el Thomas Caparas,0,16,30,30
1651104746574,MATH 20C,B01,083762,Staff,7,0,30,23
1651104746574,MATH 20C,B02,083763,Staff,27,0,30,3
1651104752600,MATH 20D,A01,083765,Tran; Brian Kha,3,1,30,27
1651104752600,MATH 20D,A02,083766,Tran; Brian Kha,0,0,30,30
1651104752600,MATH 20D,A03,083767,Tran; Brian Kha,22,0,30,8
1651104758627,MATH 20E,A01,083771,Staff,0,0,30,30
1651104758627,MATH 20E,A02,083772,Staff,9,0,30,21
1651104758627,MATH 20E,B01,083773,Staff,5,0,35,30
1651104758627,MATH 20E,B02,083774,Staff,5,1,35,30
1651104764659,MATH 103A,A01,083777,Greenfeld; Be'Eri,0,17,30,30
1651104764659,MATH 103A,A02,083778,Greenfeld; Be'Eri,0,17,30,30
1651104764659,MATH 103A,B01,083779,Greenfeld; Be'Eri,0,15,30,30
1651104764659,MATH 103A,B02,083780,Greenfeld; Be'Eri,0,14,30,30
1651104770692,MATH 105,A01,085443,Staff,0,24,30,30
1651104776721,MATH 109,A01,083213,Ganzberger; Geoffrey Michael,0,8,30,30
1651104776721,MATH 109,A02,083214,Ganzberger; Geoffrey Michael,0,7,30,30
1651104776721,MATH 109,B01,083215,Ganzberger; Geoffrey Michael,0,8,30,30
1651104776721,MATH 109,B02,083216,Ganzberger; Geoffrey Michael,1,8,30,29
1651104782746,MATH 142A,A01,083219,Chow; Bennett,0,15,30,30
1651104782746,MATH 142A,A02,083220,Chow; Bennett,0,15,30,30
1651104782746,MATH 142A,B01,083221,Chow; Bennett,0,16,30,30
1651104782746,MATH 142A,B02,083222,Chow; Bennett,0,16,30,30
1651104788769,MATH 193A,A01,083224,Staff,0,9,30,30
1651104788769,MATH 193A,A02,083225,Staff,1,7,30,29
1651104788769,MATH 193A,A03,083781,Staff,0,7,30,30
1651104788769,MATH 193A,A04,083782,Staff,0,7,30,30
1651104794794,MATH 197,001,091859,McAuley; Julian John,9998,0,9999,1
1651104800855,COGS 9,A01,083615,Staff,0,20,60,60
1651104806880,COGS 11,A01,083617,Boyle; Mary E. T.,13,0,40,27
1651104812908,COGS 13,A01,083071,Staff,0,38,40,40
1651104818932,COGS 14A,A01,092681,Staff,0,40,100,100
1651104824954,COGS 14B,A01,083073,Cheng; Tzu-Han,0,11,50,50
1651104830981,COGS 17,A01,092677,Staff,8,0,75,67
1651104837005,COGS 100,A01,083619,Staff,0,30,60,60
1651104843033,COGS 101A,A01,083621,Davis; Joshua Daniel,0,29,60,60
1651104849058,COGS 101B,A01,091572,Staff,0,9,60,60
1651104855081,COGS 101C,A01,083625,Delgado; Tania,12,0,30,18
1651104861104,COGS 107A,A01,083627,Boyle; Mary E. T.,0,17,60,60
1651104867136,COGS 118A,A01,083075,Staff,0,10,60,60
1651104873160,CSE 3,A50,083646,Miranda; Gregory Joseph,15,0,38,23
1651104873160,CSE 3,A51,083647,Miranda; Gregory Joseph,36,0,37,1
1651104879183,CSE 8A,A50,083650,Miranda; Gregory Joseph,0,30,40,40
1651104885208,CSE 11,A01,083080,Cao; Yingjun,1,98,40,39
1651104891240,CSE 12,A01,083652,Staff,0,29,100,100
1651104897266,CSE 15L,A01,083654,Staff,0,3,50,50
1651104897266,CSE 15L,A02,083655,Staff,0,3,50,50
1651104903294,CSE 20,A01,083657,Staff,46,0,80,34
1651104909320,CSE 30,A01,083084,Eldon; John,0,38,80,80
1651104915348,CSE 100,A01,083659,Cao; Yingjun,0,72,50,50
1651104921373,CSE 134B,A01,083661,Powell; Thomas Allan,0,38,65,65
1651104927399,CSE 140,A01,083663,Staff,0,17,75,75
1651104933425,CSE 140L,A01,083088,Eldon; John,1,0,100,99
1651104939453,CSE 175,A01,083665,Kumar; Rakesh,0,0,25,25
1651104945478,CSE 190,A00,092507,Dubnov; Shlomo,9,0,20,11
1651104951503,ECE 45,A01,083139,Staff,0,8,60,60
1651104957528,ECE 65,A50,083695,Staff,0,7,30,30
1651104963550,ECE 109,A01,091882,Touri; Behrouz,32,0,70,38
1651104969589,ECE 180,A00,083140,Abi Samra; Nicholas Camill,17,0,30,13
1651104969589,ECE 180,B00,083141,Abi Samra; Nicholas Camill,0,1,30,32
1651104975615,MATH 10A,A01,083735,Patchell; Gregory David,0,0,30,30
1651104975615,MATH 10A,A02,083736,Patchell; Gregory David,26,0,30,4
1651104975615,MATH 10A,A03,083737,Patchell; Gregory David,22,0,30,8
1651104981642,MATH 10B,A01,083207,Staff,0,7,30,30
1651104981642,MATH 10B,A02,083208,Staff,0,6,30,30
1651104981642,MATH 10B,B01,083739,Staff,7,0,30,23
1651104981642,MATH 10B,B02,083740,Staff,28,0,30,2
1651104987668,MATH 18,A01,083743,Staff,0,0,30,30
1651104987668,MATH 18,A02,083744,Staff,23,0,30,7
1651104987668,MATH 18,A03,083745,Staff,19,0,30,11
1651104987668,MATH 18,A04,083746,Staff,26,0,30,4
1651104987668,MATH 18,B01,083748,Staff,0,16,30,30
1651104987668,MATH 18,B02,083749,Staff,0,14,30,30
1651104987668,MATH 18,B03,083750,Staff,0,15,30,30
1651104987668,MATH 18,B04,083751,Staff,0,14,30,30
1651104993690,MATH 20A,A01,083754,Staff,18,0,40,22
1651104999716,MATH 20B,A01,083756,Briones; Jor-el Thomas Caparas,0,14,30,30
1651104999716,MATH 20B,A02,083757,Briones; Jor-el Thomas Caparas,0,11,30,30
1651105005748,MATH 20C,A01,083760,Briones; Jor-el Thomas Caparas,1,17,30,29
1651105005748,MATH 20C,A02,083761,Briones; Jor-el Thomas Caparas,0,16,30,30
1651105005748,MATH 20C,B01,083762,Staff,7,0,30,23
1651105005748,MATH 20C,B02,083763,Staff,27,0,30,3
1651105011772,MATH 20D,A01,083765,Tran; Brian Kha,3,1,30,27
1651105011772,MATH 20D,A02,083766,Tran; Brian Kha,0,0,30,30
1651105011772,MATH 20D,A03,083767,Tran; Brian Kha,22,0,30,8
1651105017796,MATH 20E,A01,083771,Staff,0,0,30,30
1651105017796,MATH 20E,A02,083772,Staff,9,0,30,21
1651105017796,MATH 20E,B01,083773,Staff,5,0,35,30
1651105017796,MATH 20E,B02,083774,Staff,5,1,35,30
1651105023818,MATH 103A,A01,083777,Greenfeld; Be'Eri,0,17,30,30
1651105023818,MATH 103A,A02,083778,Greenfeld; Be'Eri,0,17,30,30
1651105023818,MATH 103A,B01,083779,Greenfeld; Be'Eri,0,15,30,30
1651105023818,MATH 103A,B02,083780,Greenfeld; Be'Eri,0,14,30,30
1651105029845,MATH 105,A01,085443,Staff,0,24,30,30
1651105035870,MATH 109,A01,083213,Ganzberger; Geoffrey Michael,0,8,30,30
1651105035870,MATH 109,A02,083214,Ganzberger; Geoffrey Michael,0,7,30,30
1651105035870,MATH 109,B01,083215,Ganzberger; Geoffrey Michael,0,8,30,30
1651105035870,MATH 109,B02,083216,Ganzberger; Geoffrey Michael,1,8,30,29
1651105041906,MATH 142A,A01,083219,Chow; Bennett,0,15,30,30
1651105041906,MATH 142A,A02,083220,Chow; Bennett,0,15,30,30
1651105041906,MATH 142A,B01,083221,Chow; Bennett,0,16,30,30
1651105041906,MATH 142A,B02,083222,Chow; Bennett,0,16,30,30
1651105047931,MATH 193A,A01,083224,Staff,0,9,30,30
1651105047931,MATH 193A,A02,083225,Staff,1,7,30,29
1651105047931,MATH 193A,A03,083781,Staff,0,7,30,30
1651105047931,MATH 193A,A04,083782,Staff,0,7,30,30
1651105053952,MATH 197,001,091859,McAuley; Julian John,9998,0,9999,1
1651105060016,COGS 9,A01,083615,Staff,0,20,60,60
1651105066043,COGS 11,A01,083617,Boyle; Mary E. T.,13,0,40,27
1651105072067,COGS 13,A01,083071,Staff,0,38,40,40
1651105078091,COGS 14A,A01,092681,Staff,0,40,100,100
1651105084114,COGS 14B,A01,083073,Cheng; Tzu-Han,0,11,50,50
1651105090137,COGS 17,A01,092677,Staff,8,0,75,67
1651105096163,COGS 100,A01,083619,Staff,0,30,60,60
1651105102191,COGS 101A,A01,083621,Davis; Joshua Daniel,0,29,60,60
1651105108219,COGS 101B,A01,091572,Staff,0,9,60,60
1651105114251,COGS 101C,A01,083625,Delgado; Tania,12,0,30,18
1651105120273,COGS 107A,A01,083627,Boyle; Mary E. T.,0,17,60,60
1651105126296,COGS 118A,A01,083075,Staff,0,10,60,60
1651105132319,CSE 3,A50,083646,Miranda; Gregory Joseph,15,0,38,23
1651105132319,CSE 3,A51,083647,Miranda; Gregory Joseph,36,0,37,1
1651105138352,CSE 8A,A50,083650,Miranda; Gregory Joseph,0,30,40,40
1651105144378,CSE 11,A01,083080,Cao; Yingjun,1,98,40,39
1651105150405,CSE 12,A01,083652,Staff,0,29,100,100
1651105156429,CSE 15L,A01,083654,Staff,0,3,50,50
1651105156429,CSE 15L,A02,083655,Staff,0,3,50,50
1651105162451,CSE 20,A01,083657,Staff,46,0,80,34
1651105168472,CSE 30,A01,083084,Eldon; John,0,38,80,80
1651105174498,CSE 100,A01,083659,Cao; Yingjun,0,72,50,50
1651105180521,CSE 134B,A01,083661,Powell; Thomas Allan,0,38,65,65
1651105186545,CSE 140,A01,083663,Staff,0,17,75,75
1651105192568,CSE 140L,A01,083088,Eldon; John,1,0,100,99
1651105198597,CSE 175,A01,083665,Kumar; Rakesh,0,0,25,25
1651105204618,CSE 190,A00,092507,Dubnov; Shlomo,9,0,20,11
1651105210641,ECE 45,A01,083139,Staff,0,8,60,60
1651105216667,ECE 65,A50,083695,Staff,0,7,30,30
1651105222694,ECE 109,A01,091882,Touri; Behrouz,32,0,70,38
1651105228719,ECE 180,A00,083140,Abi Samra; Nicholas Camill,17,0,30,13
1651105228719,ECE 180,B00,083141,Abi Samra; Nicholas Camill,0,1,30,32
1651105234750,MATH 10A,A01,083735,Patchell; Gregory David,0,0,30,30
1651105234750,MATH 10A,A02,083736,Patchell; Gregory David,26,0,30,4
1651105234750,MATH 10A,A03,083737,Patchell; Gregory David,22,0,30,8
1651105240775,MATH 10B,A01,083207,Staff,0,7,30,30
1651105240775,MATH 10B,A02,083208,Staff,0,6,30,30
1651105240775,MATH 10B,B01,083739,Staff,7,0,30,23
1651105240775,MATH 10B,B02,083740,Staff,28,0,30,2
1651105246804,MATH 18,A01,083743,Staff,0,0,30,30
1651105246804,MATH 18,A02,083744,Staff,23,0,30,7
1651105246804,MATH 18,A03,083745,Staff,19,0,30,11
1651105246804,MATH 18,A04,083746,Staff,26,0,30,4
1651105246804,MATH 18,B01,083748,Staff,0,16,30,30
1651105246804,MATH 18,B02,083749,Staff,0,14,30,30
1651105246804,MATH 18,B03,083750,Staff,0,15,30,30
1651105246804,MATH 18,B04,083751,Staff,0,14,30,30
1651105252836,MATH 20A,A01,083754,Staff,18,0,40,22
1651105258865,MATH 20B,A01,083756,Briones; Jor-el Thomas Caparas,0,14,30,30
1651105258865,MATH 20B,A02,083757,Briones; Jor-el Thomas Caparas,0,11,30,30
1651105264890,MATH 20C,A01,083760,Briones; Jor-el Thomas Caparas,1,17,30,29
1651105264890,MATH 20C,A02,083761,Briones; Jor-el Thomas Caparas,0,16,30,30
1651105264890,MATH 20C,B01,083762,Staff,7,0,30,23
1651105264890,MATH 20C,B02,083763,Staff,27,0,30,3
1651105270922,MATH 20D,A01,083765,Tran; Brian Kha,3,1,30,27
1651105270922,MATH 20D,A02,083766,Tran; Brian Kha,0,0,30,30
1651105270922,MATH 20D,A03,083767,Tran; Brian Kha,22,0,30,8
1651105276946,MATH 20E,A01,083771,Staff,0,0,30,30
1651105276946,MATH 20E,A02,083772,Staff,9,0,30,21
1651105276946,MATH 20E,B01,083773,Staff,5,0,35,30
1651105276946,MATH 20E,B02,083774,Staff,5,1,35,30
1651105282975,MATH 103A,A01,083777,Greenfeld; Be'Eri,0,17,30,30
1651105282975,MATH 103A,A02,083778,Greenfeld; Be'Eri,0,17,30,30
1651105282975,MATH 103A,B01,083779,Greenfeld; Be'Eri,0,15,30,30
1651105282975,MATH 103A,B02,083780,Greenfeld; Be'Eri,0,14,30,30
1651105289001,MATH 105,A01,085443,Staff,0,24,30,30
1651105295025,MATH 109,A01,083213,Ganzberger; Geoffrey Michael,0,8,30,30
1651105295025,MATH 109,A02,083214,Ganzberger; Geoffrey Michael,0,7,30,30
1651105295025,MATH 109,B01,083215,Ganzberger; Geoffrey Michael,0,8,30,30
1651105295025,MATH 109,B02,083216,Ganzberger; Geoffrey Michael,1,8,30,29
1651105301050,MATH 142A,A01,083219,Chow; Bennett,0,15,30,30
1651105301050,MATH 142A,A02,083220,Chow; Bennett,0,15,30,30
1651105301050,MATH 142A,B01,083221,Chow; Bennett,0,16,30,30
1651105301050,MATH 142A,B02,083222,Chow; Bennett,0,16,30,30
1651105307164,MATH 193A,A01,083224,Staff,0,9,30,30
1651105307164,MATH 193A,A02,083225,Staff,1,7,30,29
1651105307164,MATH 193A,A03,083781,Staff,0,7,30,30
1651105307164,MATH 193A,A04,083782,Staff,0,7,30,30
1651105313187,MATH 197,001,091859,McAuley; Julian John,9998,0,9999,1
1651105319245,COGS 9,A01,083615,Staff,0,20,60,60
1651105325269,COGS 11,A01,083617,Boyle; Mary E. T.,13,0,40,27
1651105331294,COGS 13,A01,083071,Staff,0,38,40,40
1651105337321,COGS 14A,A01,092681,Staff,0,40,100,100
1651105343346,COGS 14B,A01,083073,Cheng; Tzu-Han,0,11,50,50
1651105349368,COGS 17,A01,092677,Staff,8,0,75,67
1651105355392,COGS 100,A01,083619,Staff,0,30,60,60
1651105361428,COGS 101A,A01,083621,Davis; Joshua Daniel,0,29,60,60
1651105367452,COGS 101B,A01,091572,Staff,0,9,60,60
1651105373475,COGS 101C,A01,083625,Delgado; Tania,12,0,30,18
1651105379497,COGS 107A,A01,083627,Boyle; Mary E. T.,0,17,60,60
1651105385524,COGS 118A,A01,083075,Staff,0,10,60,60
1651105391548,CSE 3,A50,083646,Miranda; Gregory Joseph,15,0,38,23
1651105391548,CSE 3,A51,083647,Miranda; Gregory Joseph,36,0,37,1
1651105397570,CSE 8A,A50,083650,Miranda; Gregory Joseph,0,30,40,40
1651105403596,CSE 11,A01,083080,Cao; Yingjun,1,98,40,39
1651105409621,CSE 12,A01,083652,Staff,0,29,100,100
1651105415654,CSE 15L,A01,083654,Staff,0,3,50,50
1651105415654,CSE 15L,A02,083655,Staff,0,3,50,50
1651105421678,CSE 20,A01,083657,Staff,46,0,80,34
1651105427704,CSE 30,A01,083084,Eldon; John,0,38,80,80
1651105433731,CSE 100,A01,083659,Cao; Yingjun,0,72,50,50
1651105439770,CSE 134B,A01,083661,Powell; Thomas Allan,0,38,65,65
1651105445797,CSE 140,A01,083663,Staff,0,17,75,75
1651105451829,CSE 140L,A01,083088,Eldon; John,1,0,100,99
1651105457870,CSE 175,A01,083665,Kumar; Rakesh,0,0,25,25
1651105463892,CSE 190,A00,092507,Dubnov; Shlomo,9,0,20,11
1651105469914,ECE 45,A01,083139,Staff,0,8,60,60
1651105475945,ECE 65,A50,083695,Staff,0,7,30,30
1651105481969,ECE 109,A01,091882,Touri; Behrouz,32,0,70,38
1651105487993,ECE 180,A00,083140,Abi Samra; Nicholas Camill,17,0,30,13
1651105487993,ECE 180,B00,083141,Abi Samra; Nicholas Camill,0,1,30,32
1651105494018,MATH 10A,A01,083735,Patchell; Gregory David,0,0,30,30
1651105494018,MATH 10A,A02,083736,Patchell; Gregory David,26,0,30,4
1651105494018,MATH 10A,A03,083737,Patchell; Gregory David,22,0,30,8
1651105500045,MATH 10B,A01,083207,Staff,0,7,30,30
1651105500045,MATH 10B,A02,083208,Staff,0,6,30,30
1651105500045,MATH 10B,B01,083739,Staff,7,0,30,23
1651105500045,MATH 10B,B02,083740,Staff,28,0,30,2
1651105506070,MATH 18,A01,083743,Staff,0,0,30,30
1651105506070,MATH 18,A02,083744,Staff,23,0,30,7
1651105506070,MATH 18,A03,083745,Staff,19,0,30,11
1651105506070,MATH 18,A04,083746,Staff,26,0,30,4
1651105506070,MATH 18,B01,083748,Staff,0,16,30,30
1651105506070,MATH 18,B02,083749,Staff,0,14,30,30
1651105506070,MATH 18,B03,083750,Staff,0,15,30,30
1651105506070,MATH 18,B04,083751,Staff,0,14,30,30
1651105512095,MATH 20A,A01,083754,Staff,18,0,40,22
1651105518120,MATH 20B,A01,083756,Briones; Jor-el Thomas Caparas,0,14,30,30
1651105518120,MATH 20B,A02,083757,Briones; Jor-el Thomas Caparas,0,11,30,30
1651105524148,MATH 20C,A01,083760,Briones; Jor-el Thomas Caparas,1,17,30,29
1651105524148,MATH 20C,A02,083761,Briones; Jor-el Thomas Caparas,0,16,30,30
1651105524148,MATH 20C,B01,083762,Staff,7,0,30,23
1651105524148,MATH 20C,B02,083763,Staff,27,0,30,3
1651105530173,MATH 20D,A01,083765,Tran; Brian Kha,3,1,30,27
1651105530173,MATH 20D,A02,083766,Tran; Brian Kha,0,0,30,30
1651105530173,MATH 20D,A03,083767,Tran; Brian Kha,22,0,30,8
1651105536195,MATH 20E,A01,083771,Staff,0,0,30,30
1651105536195,MATH 20E,A02,083772,Staff,9,0,30,21
1651105536195,MATH 20E,B01,083773,Staff,5,0,35,30
1651105536195,MATH 20E,B02,083774,Staff,5,1,35,30
1651105542218,MATH 103A,A01,083777,Greenfeld; Be'Eri,0,17,30,30
1651105542218,MATH 103A,A02,083778,Greenfeld; Be'Eri,0,17,30,30
1651105542218,MATH 103A,B01,083779,Greenfeld; Be'Eri,0,15,30,30
1651105542218,MATH 103A,B02,083780,Greenfeld; Be'Eri,0,14,30,30
1651105548242,MATH 105,A01,085443,Staff,0,24,30,30
1651105554273,MATH 109,A01,083213,Ganzberger; Geoffrey Michael,0,8,30,30
1651105554273,MATH 109,A02,083214,Ganzberger; Geoffrey Michael,0,7,30,30
1651105554273,MATH 109,B01,083215,Ganzberger; Geoffrey Michael,0,8,30,30
1651105554273,MATH 109,B02,083216,Ganzberger; Geoffrey Michael,1,8,30,29
1651105560302,MATH 142A,A01,083219,Chow; Bennett,0,15,30,30
1651105560302,MATH 142A,A02,083220,Chow; Bennett,0,15,30,30
1651105560302,MATH 142A,B01,083221,Chow; Bennett,0,16,30,30
1651105560302,MATH 142A,B02,083222,Chow; Bennett,0,16,30,30
1651105566337,MATH 193A,A01,083224,Staff,0,9,30,30
1651105566337,MATH 193A,A02,083225,Staff,1,7,30,29
1651105566337,MATH 193A,A03,083781,Staff,0,7,30,30
1651105566337,MATH 193A,A04,083782,Staff,0,7,30,30
1651105572359,MATH 197,001,091859,McAuley; Julian John,9998,0,9999,1
1651105578424,COGS 9,A01,083615,Staff,0,20,60,60
1651105584448,COGS 11,A01,083617,Boyle; Mary E. T.,13,0,40,27
1651105590473,COGS 13,A01,083071,Staff,0,38,40,40
1651105596502,COGS 14A,A01,092681,Staff,0,40,100,100
1651105602526,COGS 14B,A01,083073,Cheng; Tzu-Han,0,11,50,50
1651105608563,COGS 17,A01,092677,Staff,8,0,75,67
1651105614587,COGS 100,A01,083619,Staff,0,30,60,60
1651105620616,COGS 101A,A01,083621,Davis; Joshua Daniel,0,29,60,60
1651105626639,COGS 101B,A01,091572,Staff,0,9,60,60
1651105632666,COGS 101C,A01,083625,Delgado; Tania,12,0,30,18
1651105638689,COGS 107A,A01,083627,Boyle; Mary E. T.,0,17,60,60
1651105644712,COGS 118A,A01,083075,Staff,0,10,60,60
1651105650748,CSE 3,A50,083646,Miranda; Gregory Joseph,15,0,38,23
1651105650748,CSE 3,A51,083647,Miranda; Gregory Joseph,36,0,37,1
1651105656771,CSE 8A,A50,083650,Miranda; Gregory Joseph,0,30,40,40
1651105662796,CSE 11,A01,083080,Cao; Yingjun,1,98,40,39
1651105668822,CSE 12,A01,083652,Staff,0,29,100,100
1651105674849,CSE 15L,A01,083654,Staff,0,3,50,50
1651105674849,CSE 15L,A02,083655,Staff,0,3,50,50
1651105680876,CSE 20,A01,083657,Staff,46,0,80,34
1651105686906,CSE 30,A01,083084,Eldon; John,0,38,80,80
1651105692938,CSE 100,A01,083659,Cao; Yingjun,0,72,50,50
1651105698961,CSE 134B,A01,083661,Powell; Thomas Allan,0,38,65,65
1651105704996,CSE 140,A01,083663,Staff,0,17,75,75
1651105711020,CSE 140L,A01,083088,Eldon; John,1,0,100,99
1651105717054,CSE 175,A01,083665,Kumar; Rakesh,0,0,25,25
1651105723085,CSE 190,A00,092507,Dubnov; Shlomo,9,0,20,11
1651105729110,ECE 45,A01,083139,Staff,0,8,60,60
1651105735143,ECE 65,A50,083695,Staff,0,7,30,30
1651105741167,ECE 109,A01,091882,Touri; Behrouz,32,0,70,38
1651105747190,ECE 180,A00,083140,Abi Samra; Nicholas Camill,17,0,30,13
1651105747190,ECE 180,B00,083141,Abi Samra; Nicholas Camill,0,1,30,32
1651105753217,MATH 10A,A01,083735,Patchell; Gregory David,0,0,30,30
1651105753217,MATH 10A,A02,083736,Patchell; Gregory David,26,0,30,4
1651105753217,MATH 10A,A03,083737,Patchell; Gregory David,22,0,30,8
1651105759245,MATH 10B,A01,083207,Staff,0,7,30,30
1651105759245,MATH 10B,A02,083208,Staff,0,6,30,30
1651105759245,MATH 10B,B01,083739,Staff,7,0,30,23
1651105759245,MATH 10B,B02,083740,Staff,28,0,30,2
1651105765275,MATH 18,A01,083743,Staff,0,0,30,30
1651105765275,MATH 18,A02,083744,Staff,23,0,30,7
1651105765275,MATH 18,A03,083745,Staff,19,0,30,11
1651105765275,MATH 18,A04,083746,Staff,26,0,30,4
1651105765275,MATH 18,B01,083748,Staff,0,16,30,30
1651105765275,MATH 18,B02,083749,Staff,0,14,30,30
1651105765275,MATH 18,B03,083750,Staff,0,15,30,30
1651105765275,MATH 18,B04,083751,Staff,0,14,30,30
1651105771308,MATH 20A,A01,083754,Staff,18,0,40,22
1651105777331,MATH 20B,A01,083756,Briones; Jor-el Thomas Caparas,0,14,30,30
1651105777331,MATH 20B,A02,083757,Briones; Jor-el Thomas Caparas,0,11,30,30
1651105783354,MATH 20C,A01,083760,Briones; Jor-el Thomas Caparas,1,17,30,29
1651105783354,MATH 20C,A02,083761,Briones; Jor-el Thomas Caparas,0,16,30,30
1651105783354,MATH 20C,B01,083762,Staff,7,0,30,23
1651105783354,MATH 20C,B02,083763,Staff,27,0,30,3
1651105789377,MATH 20D,A01,083765,Tran; Brian Kha,3,1,30,27
1651105789377,MATH 20D,A02,083766,Tran; Brian Kha,0,0,30,30
1651105789377,MATH 20D,A03,083767,Tran; Brian Kha,22,0,30,8
1651105795399,MATH 20E,A01,083771,Staff,0,0,30,30
1651105795399,MATH 20E,A02,083772,Staff,9,0,30,21
1651105795399,MATH 20E,B01,083773,Staff,5,0,35,30
1651105795399,MATH 20E,B02,083774,Staff,5,1,35,30
1651105801428,MATH 103A,A01,083777,Greenfeld; Be'Eri,0,17,30,30
1651105801428,MATH 103A,A02,083778,Greenfeld; Be'Eri,0,17,30,30
1651105801428,MATH 103A,B01,083779,Greenfeld; Be'Eri,0,15,30,30
1651105801428,MATH 103A,B02,083780,Greenfeld; Be'Eri,0,14,30,30
1651105807457,MATH 105,A01,085443,Staff,0,24,30,30
1651105813484,MATH 109,A01,083213,Ganzberger; Geoffrey Michael,0,8,30,30
1651105813484,MATH 109,A02,083214,Ganzberger; Geoffrey Michael,0,7,30,30
1651105813484,MATH 109,B01,083215,Ganzberger; Geoffrey Michael,0,8,30,30
1651105813484,MATH 109,B02,083216,Ganzberger; Geoffrey Michael,1,8,30,29
1651105819511,MATH 142A,A01,083219,Chow; Bennett,0,15,30,30
1651105819511,MATH 142A,A02,083220,Chow; Bennett,0,15,30,30
1651105819511,MATH 142A,B01,083221,Chow; Bennett,0,16,30,30
1651105819511,MATH 142A,B02,083222,Chow; Bennett,0,16,30,30
1651105825534,MATH 193A,A01,083224,Staff,0,9,30,30
1651105825534,MATH 193A,A02,083225,Staff,1,7,30,29
1651105825534,MATH 193A,A03,083781,Staff,0,7,30,30
1651105825534,MATH 193A,A04,083782,Staff,0,7,30,30
1651105831561,MATH 197,001,091859,McAuley; Julian John,9998,0,9999,1
1651105837612,COGS 9,A01,083615,Staff,0,20,60,60
1651105843646,COGS 11,A01,083617,Boyle; Mary E. T.,13,0,40,27
1651105849668,COGS 13,A01,083071,Staff,0,38,40,40
1651105855690,COGS 14A,A01,092681,Staff,0,40,100,100
1651105861729,COGS 14B,A01,083073,Cheng; Tzu-Han,0,11,50,50
1651105867757,COGS 17,A01,092677,Staff,8,0,75,67
1651105873778,COGS 100,A01,083619,Staff,0,30,60,60
1651105879803,COGS 101A,A01,083621,Davis; Joshua Daniel,0,29,60,60
1651105885830,COGS 101B,A01,091572,Staff,0,9,60,60
1651105891874,COGS 101C,A01,083625,Delgado; Tania,12,0,30,18
1651105897994,COGS 107A,A01,083627,Boyle; Mary E. T.,0,17,60,60
1651105904020,COGS 118A,A01,083075,Staff,0,10,60,60
1651105910042,CSE 3,A50,083646,Miranda; Gregory Joseph,15,0,38,23
1651105910042,CSE 3,A51,083647,Miranda; Gregory Joseph,36,0,37,1
1651105916069,CSE 8A,A50,083650,Miranda; Gregory Joseph,0,30,40,40
1651105922095,CSE 11,A01,083080,Cao; Yingjun,1,98,40,39
1651105928120,CSE 12,A01,083652,Staff,0,29,100,100
1651105934144,CSE 15L,A01,083654,Staff,0,3,50,50
1651105934144,CSE 15L,A02,083655,Staff,0,3,50,50
1651105940168,CSE 20,A01,083657,Staff,46,0,80,34
1651105946196,CSE 30,A01,083084,Eldon; John,0,38,80,80
1651105952222,CSE 100,A01,083659,Cao; Yingjun,0,72,50,50
1651105958246,CSE 134B,A01,083661,Powell; Thomas Allan,0,38,65,65
1651105964269,CSE 140,A01,083663,Staff,0,17,75,75
1651105970292,CSE 140L,A01,083088,Eldon; John,1,0,100,99
1651105976325,CSE 175,A01,083665,Kumar; Rakesh,0,0,25,25
1651105982346,CSE 190,A00,092507,Dubnov; Shlomo,9,0,20,11
1651105988371,ECE 45,A01,083139,Staff,0,8,60,60
1651105994393,ECE 65,A50,083695,Staff,0,7,30,30
1651106000415,ECE 109,A01,091882,Touri; Behrouz,32,0,70,38
1651106006443,ECE 180,A00,083140,Abi Samra; Nicholas Camill,17,0,30,13
1651106006443,ECE 180,B00,083141,Abi Samra; Nicholas Camill,0,1,30,32
1651106012483,MATH 10A,A01,083735,Patchell; Gregory David,0,0,30,30
1651106012483,MATH 10A,A02,083736,Patchell; Gregory David,26,0,30,4
1651106012483,MATH 10A,A03,083737,Patchell; Gregory David,22,0,30,8
1651106018514,MATH 10B,A01,083207,Staff,0,7,30,30
1651106018514,MATH 10B,A02,083208,Staff,0,6,30,30
1651106018514,MATH 10B,B01,083739,Staff,7,0,30,23
1651106018514,MATH 10B,B02,083740,Staff,28,0,30,2
1651106024542,MATH 18,A01,083743,Staff,0,0,30,30
1651106024542,MATH 18,A02,083744,Staff,23,0,30,7
1651106024542,MATH 18,A03,083745,Staff,19,0,30,11
1651106024542,MATH 18,A04,083746,Staff,26,0,30,4
1651106024542,MATH 18,B01,083748,Staff,0,16,30,30
1651106024542,MATH 18,B02,083749,Staff,0,14,30,30
1651106024542,MATH 18,B03,083750,Staff,0,15,30,30
1651106024542,MATH 18,B04,083751,Staff,0,14,30,30
1651106030570,MATH 20A,A01,083754,Staff,18,0,40,22
1651106036597,MATH 20B,A01,083756,Briones; Jor-el Thomas Caparas,0,14,30,30
1651106036597,MATH 20B,A02,083757,Briones; Jor-el Thomas Caparas,0,11,30,30
1651106042624,MATH 20C,A01,083760,Briones; Jor-el Thomas Caparas,1,17,30,29
1651106042624,MATH 20C,A02,083761,Briones; Jor-el Thomas Caparas,0,16,30,30
1651106042624,MATH 20C,B01,083762,Staff,7,0,30,23
1651106042624,MATH 20C,B02,083763,Staff,27,0,30,3
1651106048663,MATH 20D,A01,083765,Tran; Brian Kha,3,1,30,27
1651106048663,MATH 20D,A02,083766,Tran; Brian Kha,0,0,30,30
1651106048663,MATH 20D,A03,083767,Tran; Brian Kha,22,0,30,8
1651106054686,MATH 20E,A01,083771,Staff,0,0,30,30
1651106054686,MATH 20E,A02,083772,Staff,9,0,30,21
1651106054686,MATH 20E,B01,083773,Staff,5,0,35,30
1651106054686,MATH 20E,B02,083774,Staff,5,1,35,30
1651106060709,MATH 103A,A01,083777,Greenfeld; Be'Eri,0,17,30,30
1651106060709,MATH 103A,A02,083778,Greenfeld; Be'Eri,0,17,30,30
1651106060709,MATH 103A,B01,083779,Greenfeld; Be'Eri,0,15,30,30
1651106060709,MATH 103A,B02,083780,Greenfeld; Be'Eri,0,14,30,30
1651106066732,MATH 105,A01,085443,Staff,0,24,30,30
1651106072762,MATH 109,A01,083213,Ganzberger; Geoffrey Michael,0,8,30,30
1651106072762,MATH 109,A02,083214,Ganzberger; Geoffrey Michael,0,7,30,30
1651106072762,MATH 109,B01,083215,Ganzberger; Geoffrey Michael,0,8,30,30
1651106072762,MATH 109,B02,083216,Ganzberger; Geoffrey Michael,1,8,30,29
1651106078786,MATH 142A,A01,083219,Chow; Bennett,0,15,30,30
1651106078786,MATH 142A,A02,083220,Chow; Bennett,0,15,30,30
1651106078786,MATH 142A,B01,083221,Chow; Bennett,0,16,30,30
1651106078786,MATH 142A,B02,083222,Chow; Bennett,0,16,30,30
1651106084811,MATH 193A,A01,083224,Staff,0,9,30,30
1651106084811,MATH 193A,A02,083225,Staff,1,7,30,29
1651106084811,MATH 193A,A03,083781,Staff,0,7,30,30
1651106084811,MATH 193A,A04,083782,Staff,0,7,30,30
1651106090835,MATH 197,001,091859,McAuley; Julian John,9998,0,9999,1
1651106096920,COGS 9,A01,083615,Staff,0,20,60,60
1651106102948,COGS 11,A01,083617,Boyle; Mary E. T.,13,0,40,27
1651106108969,COGS 13,A01,083071,Staff,0,38,40,40
1651106114993,COGS 14A,A01,092681,Staff,0,40,100,100
1651106121024,COGS 14B,A01,083073,Cheng; Tzu-Han,0,11,50,50
1651106127050,COGS 17,A01,092677,Staff,8,0,75,67
1651106133073,COGS 100,A01,083619,Staff,0,30,60,60
1651106139100,COGS 101A,A01,083621,Davis; Joshua Daniel,0,29,60,60
1651106145123,COGS 101B,A01,091572,Staff,0,9,60,60
1651106151147,COGS 101C,A01,083625,Delgado; Tania,12,0,30,18
1651106157174,COGS 107A,A01,083627,Boyle; Mary E. T.,0,17,60,60
1651106163199,COGS 118A,A01,083075,Staff,0,10,60,60
1651106169227,CSE 3,A50,083646,Miranda; Gregory Joseph,15,0,38,23
1651106169227,CSE 3,A51,083647,Miranda; Gregory Joseph,36,0,37,1
1651106175251,CSE 8A,A50,083650,Miranda; Gregory Joseph,0,30,40,40
1651106181290,CSE 11,A01,083080,Cao; Yingjun,1,98,40,39
1651106187324,CSE 12,A01,083652,Staff,0,29,100,100
1651106193350,CSE 15L,A01,083654,Staff,0,3,50,50
1651106193350,CSE 15L,A02,083655,Staff,0,3,50,50
1651106199380,CSE 20,A01,083657,Staff,46,0,80,34
1651106205409,CSE 30,A01,083084,Eldon; John,0,38,80,80
1651106211436,CSE 100,A01,083659,Cao; Yingjun,0,72,50,50
1651106217463,CSE 134B,A01,083661,Powell; Thomas Allan,0,38,65,65
1651106223487,CSE 140,A01,083663,Staff,0,17,75,75
1651106229512,CSE 140L,A01,083088,Eldon; John,1,0,100,99
1651106235538,CSE 175,A01,083665,Kumar; Rakesh,0,0,25,25
1651106241566,CSE 190,A00,092507,Dubnov; Shlomo,9,0,20,11
1651106247593,ECE 45,A01,083139,Staff,0,8,60,60
1651106253621,ECE 65,A50,083695,Staff,0,7,30,30
1651106259643,ECE 109,A01,091882,Touri; Behrouz,32,0,70,38
1651106265669,ECE 180,A00,083140,Abi Samra; Nicholas Camill,17,0,30,13
1651106265669,ECE 180,B00,083141,Abi Samra; Nicholas Camill,0,1,30,32
1651106271694,MATH 10A,A01,083735,Patchell; Gregory David,0,0,30,30
1651106271694,MATH 10A,A02,083736,Patchell; Gregory David,26,0,30,4
1651106271694,MATH 10A,A03,083737,Patchell; Gregory David,22,0,30,8
1651106277717,MATH 10B,A01,083207,Staff,0,7,30,30
1651106277717,MATH 10B,A02,083208,Staff,0,6,30,30
1651106277717,MATH 10B,B01,083739,Staff,7,0,30,23
1651106277717,MATH 10B,B02,083740,Staff,28,0,30,2
1651106283754,MATH 18,A01,083743,Staff,0,0,30,30
1651106283754,MATH 18,A02,083744,Staff,23,0,30,7
1651106283754,MATH 18,A03,083745,Staff,19,0,30,11
1651106283754,MATH 18,A04,083746,Staff,26,0,30,4
1651106283754,MATH 18,B01,083748,Staff,0,16,30,30
1651106283754,MATH 18,B02,083749,Staff,0,14,30,30
1651106283754,MATH 18,B03,083750,Staff,0,15,30,30
1651106283754,MATH 18,B04,083751,Staff,0,14,30,30
1651106289779,MATH 20A,A01,083754,Staff,18,0,40,22
1651106295802,MATH 20B,A01,083756,Briones; Jor-el Thomas Caparas,0,14,30,30
1651106295802,MATH 20B,A02,083757,Briones; Jor-el Thomas Caparas,0,11,30,30
1651106301830,MATH 20C,A01,083760,Briones; Jor-el Thomas Caparas,1,17,30,29
1651106301830,MATH 20C,A02,083761,Briones; Jor-el Thomas Caparas,0,16,30,30
1651106301830,MATH 20C,B01,083762,Staff,7,0,30,23
1651106301830,MATH 20C,B02,083763,Staff,27,0,30,3
1651106307858,MATH 20D,A01,083765,Tran; Brian Kha,3,1,30,27
1651106307858,MATH 20D,A02,083766,Tran; Brian Kha,0,0,30,30
1651106307858,MATH 20D,A03,083767,Tran; Brian Kha,22,0,30,8
1651106313887,MATH 20E,A01,083771,Staff,0,0,30,30
1651106313887,MATH 20E,A02,083772,Staff,9,0,30,21
1651106313887,MATH 20E,B01,083773,Staff,5,0,35,30
1651106313887,MATH 20E,B02,083774,Staff,5,1,35,30
1651106319912,MATH 103A,A01,083777,Greenfeld; Be'Eri,0,17,30,30
1651106319912,MATH 103A,A02,083778,Greenfeld; Be'Eri,0,17,30,30
1651106319912,MATH 103A,B01,083779,Greenfeld; Be'Eri,0,15,30,30
1651106319912,MATH 103A,B02,083780,Greenfeld; Be'Eri,0,14,30,30
1651106325947,MATH 105,A01,085443,Staff,0,24,30,30
1651106331979,MATH 109,A01,083213,Ganzberger; Geoffrey Michael,0,8,30,30
1651106331979,MATH 109,A02,083214,Ganzberger; Geoffrey Michael,0,7,30,30
1651106331979,MATH 109,B01,083215,Ganzberger; Geoffrey Michael,0,8,30,30
1651106331979,MATH 109,B02,083216,Ganzberger; Geoffrey Michael,1,8,30,29
1651106338004,MATH 142A,A01,083219,Chow; Bennett,0,15,30,30
1651106338004,MATH 142A,A02,083220,Chow; Bennett,0,15,30,30
1651106338004,MATH 142A,B01,083221,Chow; Bennett,0,16,30,30
1651106338004,MATH 142A,B02,083222,Chow; Bennett,0,16,30,30
1651106344031,MATH 193A,A01,083224,Staff,0,9,30,30
1651106344031,MATH 193A,A02,083225,Staff,1,7,30,29
1651106344031,MATH 193A,A03,083781,Staff,0,7,30,30
1651106344031,MATH 193A,A04,083782,Staff,0,7,30,30
1651106350071,MATH 197,001,091859,McAuley; Julian John,9998,0,9999,1
1651106356134,COGS 9,A01,083615,Staff,0,20,60,60
1651106362160,COGS 11,A01,083617,Boyle; Mary E. T.,13,0,40,27
1651106368183,COGS 13,A01,083071,Staff,0,38,40,40
1651106374216,COGS 14A,A01,092681,Staff,0,40,100,100
1651106380248,COGS 14B,A01,083073,Cheng; Tzu-Han,0,11,50,50
1651106386274,COGS 17,A01,092677,Staff,8,0,75,67
1651106392298,COGS 100,A01,083619,Staff,0,30,60,60
1651106398324,COGS 101A,A01,083621,Davis; Joshua Daniel,0,29,60,60
1651106404352,COGS 101B,A01,091572,Staff,0,9,60,60
1651106410375,COGS 101C,A01,083625,Delgado; Tania,12,0,30,18
1651106416397,COGS 107A,A01,083627,Boyle; Mary E. T.,0,17,60,60
1651106422428,COGS 118A,A01,083075,Staff,0,10,60,60
1651106428463,CSE 3,A50,083646,Miranda; Gregory Joseph,15,0,38,23
1651106428463,CSE 3,A51,083647,Miranda; Gregory Joseph,36,0,37,1
1651106434489,CSE 8A,A50,083650,Miranda; Gregory Joseph,0,30,40,40
1651106440515,CSE 11,A01,083080,Cao; Yingjun,1,98,40,39
1651106446544,CSE 12,A01,083652,Staff,0,29,100,100
1651106452568,CSE 15L,A01,083654,Staff,0,3,50,50
1651106452568,CSE 15L,A02,083655,Staff,0,3,50,50
1651106458595,CSE 20,A01,083657,Staff,46,0,80,34
1651106464619,CSE 30,A01,083084,Eldon; John,0,38,80,80
1651106470646,CSE 100,A01,083659,Cao; Yingjun,0,72,50,50
1651106476681,CSE 134B,A01,083661,Powell; Thomas Allan,0,38,65,65
1651106482703,CSE 140,A01,083663,Staff,0,17,75,75
1651106488726,CSE 140L,A01,083088,Eldon; John,1,0,100,99
1651106494854,CSE 175,A01,083665,Kumar; Rakesh,0,0,25,25
1651106500876,CSE 190,A00,092507,Dubnov; Shlomo,9,0,20,11
1651106506905,ECE 45,A01,083139,Staff,0,8,60,60
1651106512927,ECE 65,A50,083695,Staff,0,7,30,30
1651106518958,ECE 109,A01,091882,Touri; Behrouz,32,0,70,38
1651106524988,ECE 180,A00,083140,Abi Samra; Nicholas Camill,17,0,30,13
1651106524988,ECE 180,B00,083141,Abi Samra; Nicholas Camill,0,1,30,32
1651106531017,MATH 10A,A01,083735,Patchell; Gregory David,0,0,30,30
1651106531017,MATH 10A,A02,083736,Patchell; Gregory David,26,0,30,4
1651106531017,MATH 10A,A03,083737,Patchell; Gregory David,22,0,30,8
1651106537044,MATH 10B,A01,083207,Staff,0,7,30,30
1651106537044,MATH 10B,A02,083208,Staff,0,6,30,30
1651106537044,MATH 10B,B01,083739,Staff,7,0,30,23
1651106537044,MATH 10B,B02,083740,Staff,28,0,30,2
1651106543070,MATH 18,A01,083743,Staff,0,0,30,30
1651106543070,MATH 18,A02,083744,Staff,23,0,30,7
1651106543070,MATH 18,A03,083745,Staff,19,0,30,11
1651106543070,MATH 18,A04,083746,Staff,26,0,30,4
1651106543070,MATH 18,B01,083748,Staff,0,16,30,30
1651106543070,MATH 18,B02,083749,Staff,0,14,30,30
1651106543070,MATH 18,B03,083750,Staff,0,15,30,30
1651106543070,MATH 18,B04,083751,Staff,0,14,30,30
1651106549098,MATH 20A,A01,083754,Staff,18,0,40,22
1651106555120,MATH 20B,A01,083756,Briones; Jor-el Thomas Caparas,0,14,30,30
1651106555120,MATH 20B,A02,083757,Briones; Jor-el Thomas Caparas,0,11,30,30
1651106561142,MATH 20C,A01,083760,Briones; Jor-el Thomas Caparas,1,17,30,29
1651106561142,MATH 20C,A02,083761,Briones; Jor-el Thomas Caparas,0,16,30,30
1651106561142,MATH 20C,B01,083762,Staff,7,0,30,23
1651106561142,MATH 20C,B02,083763,Staff,27,0,30,3
1651106567166,MATH 20D,A01,083765,Tran; Brian Kha,3,1,30,27
1651106567166,MATH 20D,A02,083766,Tran; Brian Kha,0,0,30,30
1651106567166,MATH 20D,A03,083767,Tran; Brian Kha,22,0,30,8
1651106573196,MATH 20E,A01,083771,Staff,0,0,30,30
1651106573196,MATH 20E,A02,083772,Staff,9,0,30,21
1651106573196,MATH 20E,B01,083773,Staff,5,0,35,30
1651106573196,MATH 20E,B02,083774,Staff,5,1,35,30
1651106579220,MATH 103A,A01,083777,Greenfeld; Be'Eri,0,17,30,30
1651106579220,MATH 103A,A02,083778,Greenfeld; Be'Eri,0,17,30,30
1651106579220,MATH 103A,B01,083779,Greenfeld; Be'Eri,0,15,30,30
1651106579220,MATH 103A,B02,083780,Greenfeld; Be'Eri,0,14,30,30
1651106585251,MATH 105,A01,085443,Staff,0,24,30,30
1651106591275,MATH 109,A01,083213,Ganzberger; Geoffrey Michael,0,8,30,30
1651106591275,MATH 109,A02,083214,Ganzberger; Geoffrey Michael,0,7,30,30
1651106591275,MATH 109,B01,083215,Ganzberger; Geoffrey Michael,0,8,30,30
1651106591275,MATH 109,B02,083216,Ganzberger; Geoffrey Michael,1,8,30,29
1651106597304,MATH 142A,A01,083219,Chow; Bennett,0,15,30,30
1651106597304,MATH 142A,A02,083220,Chow; Bennett,0,15,30,30
1651106597304,MATH 142A,B01,083221,Chow; Bennett,0,16,30,30
1651106597304,MATH 142A,B02,083222,Chow; Bennett,0,16,30,30
1651106603327,MATH 193A,A01,083224,Staff,0,9,30,30
1651106603327,MATH 193A,A02,083225,Staff,1,7,30,29
1651106603327,MATH 193A,A03,083781,Staff,0,7,30,30
1651106603327,MATH 193A,A04,083782,Staff,0,7,30,30
1651106609349,MATH 197,001,091859,McAuley; Julian John,9998,0,9999,1
1651106615407,COGS 9,A01,083615,Staff,0,20,60,60
1651106621430,COGS 11,A01,083617,Boyle; Mary E. T.,13,0,40,27
1651106627461,COGS 13,A01,083071,Staff,0,38,40,40
1651106633494,COGS 14A,A01,092681,Staff,0,40,100,100
1651106639516,COGS 14B,A01,083073,Cheng; Tzu-Han,0,11,50,50
1651106645539,COGS 17,A01,092677,Staff,8,0,75,67
1651106651561,COGS 100,A01,083619,Staff,0,30,60,60
1651106657588,COGS 101A,A01,083621,Davis; Joshua Daniel,0,29,60,60
1651106663612,COGS 101B,A01,091572,Staff,0,9,60,60
1651106669640,COGS 101C,A01,083625,Delgado; Tania,12,0,30,18
1651106675664,COGS 107A,A01,083627,Boyle; Mary E. T.,0,17,60,60
1651106681688,COGS 118A,A01,083075,Staff,0,10,60,60
1651106687716,CSE 3,A50,083646,Miranda; Gregory Joseph,15,0,38,23
1651106687716,CSE 3,A51,083647,Miranda; Gregory Joseph,36,0,37,1
1651106693744,CSE 8A,A50,083650,Miranda; Gregory Joseph,0,30,40,40
1651106699772,CSE 11,A01,083080,Cao; Yingjun,1,98,40,39
1651106705795,CSE 12,A01,083652,Staff,0,29,100,100
1651106711818,CSE 15L,A01,083654,Staff,0,3,50,50
1651106711818,CSE 15L,A02,083655,Staff,0,3,50,50
1651106717841,CSE 20,A01,083657,Staff,46,0,80,34
1651106723864,CSE 30,A01,083084,Eldon; John,0,38,80,80
1651106729887,CSE 100,A01,083659,Cao; Yingjun,0,72,50,50
1651106735913,CSE 134B,A01,083661,Powell; Thomas Allan,0,38,65,65
1651106741941,CSE 140,A01,083663,Staff,0,17,75,75
1651106747964,CSE 140L,A01,083088,Eldon; John,1,0,100,99
1651106753999,CSE 175,A01,083665,Kumar; Rakesh,0,0,25,25
1651106760022,CSE 190,A00,092507,Dubnov; Shlomo,9,0,20,11
1651106766045,ECE 45,A01,083139,Staff,0,8,60,60
1651106772069,ECE 65,A50,083695,Staff,0,7,30,30
1651106778096,ECE 109,A01,091882,Touri; Behrouz,32,0,70,38
1651106784118,ECE 180,A00,083140,Abi Samra; Nicholas Camill,17,0,30,13
1651106784118,ECE 180,B00,083141,Abi Samra; Nicholas Camill,0,1,30,32
1651106790141,MATH 10A,A01,083735,Patchell; Gregory David,0,0,30,30
1651106790141,MATH 10A,A02,083736,Patchell; Gregory David,26,0,30,4
1651106790141,MATH 10A,A03,083737,Patchell; Gregory David,22,0,30,8
1651106796165,MATH 10B,A01,083207,Staff,0,7,30,30
1651106796165,MATH 10B,A02,083208,Staff,0,6,30,30
1651106796165,MATH 10B,B01,083739,Staff,7,0,30,23
1651106796165,MATH 10B,B02,083740,Staff,28,0,30,2
1651106802205,MATH 18,A01,083743,Staff,0,0,30,30
1651106802205,MATH 18,A02,083744,Staff,23,0,30,7
1651106802205,MATH 18,A03,083745,Staff,19,0,30,11
1651106802205,MATH 18,A04,083746,Staff,26,0,30,4
1651106802205,MATH 18,B01,083748,Staff,0,16,30,30
1651106802205,MATH 18,B02,083749,Staff,0,14,30,30
1651106802205,MATH 18,B03,083750,Staff,0,15,30,30
1651106802205,MATH 18,B04,083751,Staff,0,14,30,30
1651106808236,MATH 20A,A01,083754,Staff,18,0,40,22
1651106814263,MATH 20B,A01,083756,Briones; Jor-el Thomas Caparas,0,14,30,30
1651106814263,MATH 20B,A02,083757,Briones; Jor-el Thomas Caparas,0,11,30,30
1651106820290,MATH 20C,A01,083760,Briones; Jor-el Thomas Caparas,1,17,30,29
1651106820290,MATH 20C,A02,083761,Briones; Jor-el Thomas Caparas,0,16,30,30
1651106820290,MATH 20C,B01,083762,Staff,7,0,30,23
1651106820290,MATH 20C,B02,083763,Staff,27,0,30,3
1651106826316,MATH 20D,A01,083765,Tran; Brian Kha,3,1,30,27
1651106826316,MATH 20D,A02,083766,Tran; Brian Kha,0,0,30,30
1651106826316,MATH 20D,A03,083767,Tran; Brian Kha,22,0,30,8
1651106832339,MATH 20E,A01,083771,Staff,0,0,30,30
1651106832339,MATH 20E,A02,083772,Staff,9,0,30,21
1651106832339,MATH 20E,B01,083773,Staff,5,0,35,30
1651106832339,MATH 20E,B02,083774,Staff,5,1,35,30
1651106838364,MATH 103A,A01,083777,Greenfeld; Be'Eri,0,17,30,30
1651106838364,MATH 103A,A02,083778,Greenfeld; Be'Eri,0,17,30,30
1651106838364,MATH 103A,B01,083779,Greenfeld; Be'Eri,0,15,30,30
1651106838364,MATH 103A,B02,083780,Greenfeld; Be'Eri,0,14,30,30
1651106844390,MATH 105,A01,085443,Staff,0,24,30,30
1651106850418,MATH 109,A01,083213,Ganzberger; Geoffrey Michael,0,8,30,30
1651106850418,MATH 109,A02,083214,Ganzberger; Geoffrey Michael,0,7,30,30
1651106850418,MATH 109,B01,083215,Ganzberger; Geoffrey Michael,0,8,30,30
1651106850418,MATH 109,B02,083216,Ganzberger; Geoffrey Michael,1,8,30,29
1651106856447,MATH 142A,A01,083219,Chow; Bennett,0,15,30,30
1651106856447,MATH 142A,A02,083220,Chow; Bennett,0,15,30,30
1651106856447,MATH 142A,B01,083221,Chow; Bennett,0,16,30,30
1651106856447,MATH 142A,B02,083222,Chow; Bennett,0,16,30,30
1651106862471,MATH 193A,A01,083224,Staff,0,9,30,30
1651106862471,MATH 193A,A02,083225,Staff,1,7,30,29
1651106862471,MATH 193A,A03,083781,Staff,0,7,30,30
1651106862471,MATH 193A,A04,083782,Staff,0,7,30,30
1651106868500,MATH 197,001,091859,McAuley; Julian John,9998,0,9999,1
1651106874549,COGS 9,A01,083615,Staff,0,20,60,60
1651106880575,COGS 11,A01,083617,Boyle; Mary E. T.,13,0,40,27
1651106886598,COGS 13,A01,083071,Staff,0,38,40,40
1651106892630,COGS 14A,A01,092681,Staff,0,40,100,100
1651106898654,COGS 14B,A01,083073,Cheng; Tzu-Han,0,11,50,50
1651106904677,COGS 17,A01,092677,Staff,8,0,75,67
1651106910701,COGS 100,A01,083619,Staff,0,30,60,60
1651106916724,COGS 101A,A01,083621,Davis; Joshua Daniel,0,29,60,60
1651106922754,COGS 101B,A01,091572,Staff,0,9,60,60
1651106928778,COGS 101C,A01,083625,Delgado; Tania,12,0,30,18
1651106934801,COGS 107A,A01,083627,Boyle; Mary E. T.,0,17,60,60
1651106940825,COGS 118A,A01,083075,Staff,0,10,60,60
1651106946863,CSE 3,A50,083646,Miranda; Gregory Joseph,15,0,38,23
1651106946863,CSE 3,A51,083647,Miranda; Gregory Joseph,36,0,37,1
1651106952899,CSE 8A,A50,083650,Miranda; Gregory Joseph,0,30,40,40
1651106958923,CSE 11,A01,083080,Cao; Yingjun,1,98,40,39
1651106964949,CSE 12,A01,083652,Staff,0,29,100,100
1651106970971,CSE 15L,A01,083654,Staff,0,3,50,50
1651106970971,CSE 15L,A02,083655,Staff,0,3,50,50
1651106976995,CSE 20,A01,083657,Staff,46,0,80,34
1651106983021,CSE 30,A01,083084,Eldon; John,0,38,80,80
1651106989050,CSE 100,A01,083659,Cao; Yingjun,0,72,50,50
1651106995073,CSE 134B,A01,083661,Powell; Thomas Allan,0,38,65,65
1651107001103,CSE 140,A01,083663,Staff,0,17,75,75
1651107007127,CSE 140L,A01,083088,Eldon; John,1,0,100,99
1651107013153,CSE 175,A01,083665,Kumar; Rakesh,0,0,25,25
1651107019188,CSE 190,A00,092507,Dubnov; Shlomo,9,0,20,11
1651107025215,ECE 45,A01,083139,Staff,0,8,60,60
1651107031241,ECE 65,A50,083695,Staff,0,7,30,30
1651107037268,ECE 109,A01,091882,Touri; Behrouz,32,0,70,38
1651107043290,ECE 180,A00,083140,Abi Samra; Nicholas Camill,17,0,30,13
1651107043290,ECE 180,B00,083141,Abi Samra; Nicholas Camill,0,1,30,32
1651107049314,MATH 10A,A01,083735,Patchell; Gregory David,0,0,30,30
1651107049314,MATH 10A,A02,083736,Patchell; Gregory David,26,0,30,4
1651107049314,MATH 10A,A03,083737,Patchell; Gregory David,22,0,30,8
1651107055341,MATH 10B,A01,083207,Staff,0,8,30,30
1651107055341,MATH 10B,A02,083208,Staff,0,6,30,30
1651107055341,MATH 10B,B01,083739,Staff,7,0,30,23
1651107055341,MATH 10B,B02,083740,Staff,28,0,30,2
1651107061371,MATH 18,A01,083743,Staff,0,0,30,30
1651107061371,MATH 18,A02,083744,Staff,23,0,30,7
1651107061371,MATH 18,A03,083745,Staff,19,0,30,11
1651107061371,MATH 18,A04,083746,Staff,26,0,30,4
1651107061371,MATH 18,B01,083748,Staff,0,16,30,30
1651107061371,MATH 18,B02,083749,Staff,0,14,30,30
1651107061371,MATH 18,B03,083750,Staff,0,15,30,30
1651107061371,MATH 18,B04,083751,Staff,0,14,30,30
1651107067394,MATH 20A,A01,083754,Staff,18,0,40,22
1651107073421,MATH 20B,A01,083756,Briones; Jor-el Thomas Caparas,0,14,30,30
1651107073421,MATH 20B,A02,083757,Briones; Jor-el Thomas Caparas,0,11,30,30
1651107079444,MATH 20C,A01,083760,Briones; Jor-el Thomas Caparas,1,17,30,29
1651107079444,MATH 20C,A02,083761,Briones; Jor-el Thomas Caparas,0,16,30,30
1651107079444,MATH 20C,B01,083762,Staff,7,0,30,23
1651107079444,MATH 20C,B02,083763,Staff,27,0,30,3
1651107085472,MATH 20D,A01,083765,Tran; Brian Kha,3,1,30,27
1651107085472,MATH 20D,A02,083766,Tran; Brian Kha,0,0,30,30
1651107085472,MATH 20D,A03,083767,Tran; Brian Kha,22,0,30,8
1651107091598,MATH 20E,A01,083771,Staff,0,0,30,30
1651107091598,MATH 20E,A02,083772,Staff,9,0,30,21
1651107091598,MATH 20E,B01,083773,Staff,5,0,35,30
1651107091598,MATH 20E,B02,083774,Staff,5,1,35,30
1651107097626,MATH 103A,A01,083777,Greenfeld; Be'Eri,0,17,30,30
1651107097626,MATH 103A,A02,083778,Greenfeld; Be'Eri,0,17,30,30
1651107097626,MATH 103A,B01,083779,Greenfeld; Be'Eri,0,15,30,30
1651107097626,MATH 103A,B02,083780,Greenfeld; Be'Eri,0,14,30,30
1651107103658,MATH 105,A01,085443,Staff,0,24,30,30
1651107109680,MATH 109,A01,083213,Ganzberger; Geoffrey Michael,0,8,30,30
1651107109680,MATH 109,A02,083214,Ganzberger; Geoffrey Michael,0,7,30,30
1651107109680,MATH 109,B01,083215,Ganzberger; Geoffrey Michael,0,8,30,30
1651107109680,MATH 109,B02,083216,Ganzberger; Geoffrey Michael,1,8,30,29
1651107115709,MATH 142A,A01,083219,Chow; Bennett,0,15,30,30
1651107115709,MATH 142A,A02,083220,Chow; Bennett,0,15,30,30
1651107115709,MATH 142A,B01,083221,Chow; Bennett,0,16,30,30
1651107115709,MATH 142A,B02,083222,Chow; Bennett,0,16,30,30
1651107121736,MATH 193A,A01,083224,Staff,0,9,30,30
1651107121736,MATH 193A,A02,083225,Staff,1,7,30,29
1651107121736,MATH 193A,A03,083781,Staff,0,7,30,30
1651107121736,MATH 193A,A04,083782,Staff,0,7,30,30
1651107127760,MATH 197,001,091859,McAuley; Julian John,9998,0,9999,1
1651107133813,COGS 9,A01,083615,Staff,0,20,60,60
1651107139840,COGS 11,A01,083617,Boyle; Mary E. T.,13,0,40,27
1651107145872,COGS 13,A01,083071,Staff,0,38,40,40
1651107151896,COGS 14A,A01,092681,Staff,0,40,100,100
1651107157923,COGS 14B,A01,083073,Cheng; Tzu-Han,0,11,50,50
1651107163946,COGS 17,A01,092677,Staff,8,0,75,67
1651107169968,COGS 100,A01,083619,Staff,0,30,60,60
1651107175993,COGS 101A,A01,083621,Davis; Joshua Daniel,0,29,60,60
1651107182028,COGS 101B,A01,091572,Staff,0,9,60,60
1651107188050,COGS 101C,A01,083625,Delgado; Tania,12,0,30,18
1651107194075,COGS 107A,A01,083627,Boyle; Mary E. T.,0,17,60,60
1651107200099,COGS 118A,A01,083075,Staff,0,10,60,60
1651107206123,CSE 3,A50,083646,Miranda; Gregory Joseph,15,0,38,23
1651107206123,CSE 3,A51,083647,Miranda; Gregory Joseph,36,0,37,1
1651107212149,CSE 8A,A50,083650,Miranda; Gregory Joseph,0,30,40,40
1651107218172,CSE 11,A01,083080,Cao; Yingjun,1,98,40,39
1651107224196,CSE 12,A01,083652,Staff,0,29,100,100
1651107230219,CSE 15L,A01,083654,Staff,0,3,50,50
1651107230219,CSE 15L,A02,083655,Staff,0,3,50,50
1651107236245,CSE 20,A01,083657,Staff,46,0,80,34
1651107242268,CSE 30,A01,083084,Eldon; John,0,38,80,80
1651107248295,CSE 100,A01,083659,Cao; Yingjun,0,72,50,50
1651107254322,CSE 134B,A01,083661,Powell; Thomas Allan,0,38,65,65
1651107260345,CSE 140,A01,083663,Staff,0,17,75,75
1651107266367,CSE 140L,A01,083088,Eldon; John,1,0,100,99
1651107272390,CSE 175,A01,083665,Kumar; Rakesh,0,0,25,25
1651107278415,CSE 190,A00,092507,Dubnov; Shlomo,9,0,20,11
1651107284443,ECE 45,A01,083139,Staff,0,8,60,60
1651107290465,ECE 65,A50,083695,Staff,0,7,30,30
1651107296490,ECE 109,A01,091882,Touri; Behrouz,32,0,70,38
1651107302514,ECE 180,A00,083140,Abi Samra; Nicholas Camill,17,0,30,13
1651107302514,ECE 180,B00,083141,Abi Samra; Nicholas Camill,0,1,30,32
1651107308538,MATH 10A,A01,083735,Patchell; Gregory David,0,0,30,30
1651107308538,MATH 10A,A02,083736,Patchell; Gregory David,26,0,30,4
1651107308538,MATH 10A,A03,083737,Patchell; Gregory David,22,0,30,8
1651107314564,MATH 10B,A01,083207,Staff,0,8,30,30
1651107314564,MATH 10B,A02,083208,Staff,0,6,30,30
1651107314564,MATH 10B,B01,083739,Staff,7,0,30,23
1651107314564,MATH 10B,B02,083740,Staff,28,0,30,2
1651107320587,MATH 18,A01,083743,Staff,0,0,30,30
1651107320587,MATH 18,A02,083744,Staff,23,0,30,7
1651107320587,MATH 18,A03,083745,Staff,19,0,30,11
1651107320587,MATH 18,A04,083746,Staff,26,0,30,4
1651107320587,MATH 18,B01,083748,Staff,0,16,30,30
1651107320587,MATH 18,B02,083749,Staff,0,14,30,30
1651107320587,MATH 18,B03,083750,Staff,0,15,30,30
1651107320587,MATH 18,B04,083751,Staff,0,14,30,30
1651107326611,MATH 20A,A01,083754,Staff,18,0,40,22
1651107332633,MATH 20B,A01,083756,Briones; Jor-el Thomas Caparas,0,14,30,30
1651107332633,MATH 20B,A02,083757,Briones; Jor-el Thomas Caparas,0,11,30,30
1651107338664,MATH 20C,A01,083760,Briones; Jor-el Thomas Caparas,1,17,30,29
1651107338664,MATH 20C,A02,083761,Briones; Jor-el Thomas Caparas,0,16,30,30
1651107338664,MATH 20C,B01,083762,Staff,7,0,30,23
1651107338664,MATH 20C,B02,083763,Staff,27,0,30,3
1651107344688,MATH 20D,A01,083765,Tran; Brian Kha,3,1,30,27
1651107344688,MATH 20D,A02,083766,Tran; Brian Kha,0,0,30,30
1651107344688,MATH 20D,A03,083767,Tran; Brian Kha,22,0,30,8
1651107350719,MATH 20E,A01,083771,Staff,0,0,30,30
1651107350719,MATH 20E,A02,083772,Staff,9,0,30,21
1651107350719,MATH 20E,B01,083773,Staff,5,0,35,30
1651107350719,MATH 20E,B02,083774,Staff,5,1,35,30
1651107356742,MATH 103A,A01,083777,Greenfeld; Be'Eri,0,17,30,30
1651107356742,MATH 103A,A02,083778,Greenfeld; Be'Eri,0,17,30,30
1651107356742,MATH 103A,B01,083779,Greenfeld; Be'Eri,0,15,30,30
1651107356742,MATH 103A,B02,083780,Greenfeld; Be'Eri,0,14,30,30
1651107362769,MATH 105,A01,085443,Staff,0,24,30,30
1651107368791,MATH 109,A01,083213,Ganzberger; Geoffrey Michael,0,8,30,30
1651107368791,MATH 109,A02,083214,Ganzberger; Geoffrey Michael,0,7,30,30
1651107368791,MATH 109,B01,083215,Ganzberger; Geoffrey Michael,0,8,30,30
1651107368791,MATH 109,B02,083216,Ganzberger; Geoffrey Michael,1,8,30,29
1651107374824,MATH 142A,A01,083219,Chow; Bennett,0,15,30,30
1651107374824,MATH 142A,A02,083220,Chow; Bennett,0,15,30,30
1651107374824,MATH 142A,B01,083221,Chow; Bennett,0,16,30,30
1651107374824,MATH 142A,B02,083222,Chow; Bennett,0,16,30,30
1651107380848,MATH 193A,A01,083224,Staff,0,9,30,30
1651107380848,MATH 193A,A02,083225,Staff,1,7,30,29
1651107380848,MATH 193A,A03,083781,Staff,0,7,30,30
1651107380848,MATH 193A,A04,083782,Staff,0,7,30,30
1651107386870,MATH 197,001,091859,McAuley; Julian John,9998,0,9999,1
1651107392921,COGS 9,A01,083615,Staff,0,20,60,60
1651107398946,COGS 11,A01,083617,Boyle; Mary E. T.,13,0,40,27
1651107404970,COGS 13,A01,083071,Staff,0,38,40,40
1651107410993,COGS 14A,A01,092681,Staff,0,40,100,100
1651107417017,COGS 14B,A01,083073,Cheng; Tzu-Han,0,11,50,50
1651107423044,COGS 17,A01,092677,Staff,8,0,75,67
1651107429076,COGS 100,A01,083619,Staff,0,30,60,60
1651107435100,COGS 101A,A01,083621,Davis; Joshua Daniel,0,29,60,60
1651107441123,COGS 101B,A01,091572,Staff,0,9,60,60
1651107447156,COGS 101C,A01,083625,Delgado; Tania,12,0,30,18
1651107453184,COGS 107A,A01,083627,Boyle; Mary E. T.,0,17,60,60
1651107459208,COGS 118A,A01,083075,Staff,0,10,60,60
1651107465232,CSE 3,A50,083646,Miranda; Gregory Joseph,15,0,38,23
1651107465232,CSE 3,A51,083647,Miranda; Gregory Joseph,36,0,37,1
1651107471258,CSE 8A,A50,083650,Miranda; Gregory Joseph,0,30,40,40
1651107477293,CSE 11,A01,083080,Cao; Yingjun,1,98,40,39
1651107483315,CSE 12,A01,083652,Staff,0,29,100,100
1651107489343,CSE 15L,A01,083654,Staff,0,3,50,50
1651107489343,CSE 15L,A02,083655,Staff,0,3,50,50
1651107495376,CSE 20,A01,083657,Staff,46,0,80,34
1651107501403,CSE 30,A01,083084,Eldon; John,0,38,80,80
1651107507430,CSE 100,A01,083659,Cao; Yingjun,0,72,50,50
1651107513463,CSE 134B,A01,083661,Powell; Thomas Allan,0,38,65,65
1651107519485,CSE 140,A01,083663,Staff,0,17,75,75
1651107525510,CSE 140L,A01,083088,Eldon; John,1,0,100,99
1651107531541,CSE 175,A01,083665,Kumar; Rakesh,0,0,25,25
1651107537573,CSE 190,A00,092507,Dubnov; Shlomo,9,0,20,11
1651107543596,ECE 45,A01,083139,Staff,0,8,60,60
1651107549625,ECE 65,A50,083695,Staff,0,7,30,30
1651107555657,ECE 109,A01,091882,Touri; Behrouz,32,0,70,38
1651107561684,ECE 180,A00,083140,Abi Samra; Nicholas Camill,17,0,30,13
1651107561684,ECE 180,B00,083141,Abi Samra; Nicholas Camill,0,1,30,32
1651107567711,MATH 10A,A01,083735,Patchell; Gregory David,0,0,30,30
1651107567711,MATH 10A,A02,083736,Patchell; Gregory David,26,0,30,4
1651107567711,MATH 10A,A03,083737,Patchell; Gregory David,22,0,30,8
1651107573740,MATH 10B,A01,083207,Staff,0,8,30,30
1651107573740,MATH 10B,A02,083208,Staff,0,6,30,30
1651107573740,MATH 10B,B01,083739,Staff,7,0,30,23
1651107573740,MATH 10B,B02,083740,Staff,28,0,30,2
1651107579781,MATH 18,A01,083743,Staff,0,0,30,30
1651107579781,MATH 18,A02,083744,Staff,23,0,30,7
1651107579781,MATH 18,A03,083745,Staff,19,0,30,11
1651107579781,MATH 18,A04,083746,Staff,26,0,30,4
1651107579781,MATH 18,B01,083748,Staff,0,16,30,30
1651107579781,MATH 18,B02,083749,Staff,0,14,30,30
1651107579781,MATH 18,B03,083750,Staff,0,15,30,30
1651107579781,MATH 18,B04,083751,Staff,0,14,30,30
1651107585810,MATH 20A,A01,083754,Staff,18,0,40,22
1651107591837,MATH 20B,A01,083756,Briones; Jor-el Thomas Caparas,0,14,30,30
1651107591837,MATH 20B,A02,083757,Briones; Jor-el Thomas Caparas,0,11,30,30
1651107597859,MATH 20C,A01,083760,Briones; Jor-el Thomas Caparas,1,17,30,29
1651107597859,MATH 20C,A02,083761,Briones; Jor-el Thomas Caparas,0,16,30,30
1651107597859,MATH 20C,B01,083762,Staff,7,0,30,23
1651107597859,MATH 20C,B02,083763,Staff,27,0,30,3
1651107603889,MATH 20D,A01,083765,Tran; Brian Kha,3,1,30,27
1651107603889,MATH 20D,A02,083766,Tran; Brian Kha,0,0,30,30
1651107603889,MATH 20D,A03,083767,Tran; Brian Kha,22,0,30,8
1651107609913,MATH 20E,A01,083771,Staff,0,0,30,30
1651107609913,MATH 20E,A02,083772,Staff,9,0,30,21
1651107609913,MATH 20E,B01,083773,Staff,5,0,35,30
1651107609913,MATH 20E,B02,083774,Staff,5,1,35,30
1651107615935,MATH 103A,A01,083777,Greenfeld; Be'Eri,0,17,30,30
1651107615935,MATH 103A,A02,083778,Greenfeld; Be'Eri,0,17,30,30
1651107615935,MATH 103A,B01,083779,Greenfeld; Be'Eri,0,15,30,30
1651107615935,MATH 103A,B02,083780,Greenfeld; Be'Eri,0,14,30,30
1651107621958,MATH 105,A01,085443,Staff,0,24,30,30
1651107627980,MATH 109,A01,083213,Ganzberger; Geoffrey Michael,0,8,30,30
1651107627980,MATH 109,A02,083214,Ganzberger; Geoffrey Michael,0,7,30,30
1651107627980,MATH 109,B01,083215,Ganzberger; Geoffrey Michael,0,8,30,30
1651107627980,MATH 109,B02,083216,Ganzberger; Geoffrey Michael,1,8,30,29
1651107634005,MATH 142A,A01,083219,Chow; Bennett,0,15,30,30
1651107634005,MATH 142A,A02,083220,Chow; Bennett,0,15,30,30
1651107634005,MATH 142A,B01,083221,Chow; Bennett,0,16,30,30
1651107634005,MATH 142A,B02,083222,Chow; Bennett,0,16,30,30
1651107640030,MATH 193A,A01,083224,Staff,0,9,30,30
1651107640030,MATH 193A,A02,083225,Staff,1,7,30,29
1651107640030,MATH 193A,A03,083781,Staff,0,7,30,30
1651107640030,MATH 193A,A04,083782,Staff,0,7,30,30
1651107646055,MATH 197,001,091859,McAuley; Julian John,9998,0,9999,1
1651107652113,COGS 9,A01,083615,Staff,0,20,60,60
1651107658137,COGS 11,A01,083617,Boyle; Mary E. T.,13,0,40,27
1651107664192,COGS 13,A01,083071,Staff,0,38,40,40
1651107670221,COGS 14A,A01,092681,Staff,0,40,100,100
1651107676253,COGS 14B,A01,083073,Cheng; Tzu-Han,0,11,50,50
1651107682394,COGS 17,A01,092677,Staff,8,0,75,67
1651107688426,COGS 100,A01,083619,Staff,0,30,60,60
1651107694455,COGS 101A,A01,083621,Davis; Joshua Daniel,0,29,60,60
1651107700482,COGS 101B,A01,091572,Staff,0,9,60,60
1651107706512,COGS 101C,A01,083625,Delgado; Tania,12,0,30,18
1651107712538,COGS 107A,A01,083627,Boyle; Mary E. T.,0,17,60,60
1651107718576,COGS 118A,A01,083075,Staff,0,10,60,60
1651107724599,CSE 3,A50,083646,Miranda; Gregory Joseph,15,0,38,23
1651107724599,CSE 3,A51,083647,Miranda; Gregory Joseph,36,0,37,1
1651107730628,CSE 8A,A50,083650,Miranda; Gregory Joseph,0,30,40,40
1651107736651,CSE 11,A01,083080,Cao; Yingjun,1,98,40,39
1651107742686,CSE 12,A01,083652,Staff,0,29,100,100
1651107748714,CSE 15L,A01,083654,Staff,0,3,50,50
1651107748714,CSE 15L,A02,083655,Staff,0,3,50,50
1651107754741,CSE 20,A01,083657,Staff,46,0,80,34
1651107760762,CSE 30,A01,083084,Eldon; John,0,38,80,80
1651107766786,CSE 100,A01,083659,Cao; Yingjun,0,72,50,50
1651107772810,CSE 134B,A01,083661,Powell; Thomas Allan,0,38,65,65
1651107778837,CSE 140,A01,083663,Staff,0,17,75,75
1651107784863,CSE 140L,A01,083088,Eldon; John,1,0,100,99
1651107790885,CSE 175,A01,083665,Kumar; Rakesh,0,0,25,25
1651107796916,CSE 190,A00,092507,Dubnov; Shlomo,9,0,20,11
1651107802939,ECE 45,A01,083139,Staff,0,8,60,60
1651107808964,ECE 65,A50,083695,Staff,0,7,30,30
1651107814988,ECE 109,A01,091882,Touri; Behrouz,32,0,70,38
1651107821022,ECE 180,A00,083140,Abi Samra; Nicholas Camill,17,0,30,13
1651107821022,ECE 180,B00,083141,Abi Samra; Nicholas Camill,0,1,30,32
1651107827053,MATH 10A,A01,083735,Patchell; Gregory David,0,0,30,30
1651107827053,MATH 10A,A02,083736,Patchell; Gregory David,26,0,30,4
1651107827053,MATH 10A,A03,083737,Patchell; Gregory David,22,0,30,8
1651107833082,MATH 10B,A01,083207,Staff,0,8,30,30
1651107833082,MATH 10B,A02,083208,Staff,0,6,30,30
1651107833082,MATH 10B,B01,083739,Staff,7,0,30,23
1651107833082,MATH 10B,B02,083740,Staff,28,0,30,2
1651107839117,MATH 18,A01,083743,Staff,0,0,30,30
1651107839117,MATH 18,A02,083744,Staff,23,0,30,7
1651107839117,MATH 18,A03,083745,Staff,19,0,30,11
1651107839117,MATH 18,A04,083746,Staff,26,0,30,4
1651107839117,MATH 18,B01,083748,Staff,0,16,30,30
1651107839117,MATH 18,B02,083749,Staff,0,14,30,30
1651107839117,MATH 18,B03,083750,Staff,0,15,30,30
1651107839117,MATH 18,B04,083751,Staff,0,14,30,30
1651107845143,MATH 20A,A01,083754,Staff,18,0,40,22
1651107851165,MATH 20B,A01,083756,Briones; Jor-el Thomas Caparas,0,14,30,30
1651107851165,MATH 20B,A02,083757,Briones; Jor-el Thomas Caparas,0,11,30,30
1651107857198,MATH 20C,A01,083760,Briones; Jor-el Thomas Caparas,1,17,30,29
1651107857198,MATH 20C,A02,083761,Briones; Jor-el Thomas Caparas,0,16,30,30
1651107857198,MATH 20C,B01,083762,Staff,7,0,30,23
1651107857198,MATH 20C,B02,083763,Staff,27,0,30,3
1651107863221,MATH 20D,A01,083765,Tran; Brian Kha,3,1,30,27
1651107863221,MATH 20D,A02,083766,Tran; Brian Kha,0,0,30,30
1651107863221,MATH 20D,A03,083767,Tran; Brian Kha,22,0,30,8
1651107869260,MATH 20E,A01,083771,Staff,0,0,30,30
1651107869260,MATH 20E,A02,083772,Staff,9,0,30,21
1651107869260,MATH 20E,B01,083773,Staff,5,0,35,30
1651107869260,MATH 20E,B02,083774,Staff,5,1,35,30
1651107875298,MATH 103A,A01,083777,Greenfeld; Be'Eri,0,17,30,30
1651107875298,MATH 103A,A02,083778,Greenfeld; Be'Eri,0,17,30,30
1651107875298,MATH 103A,B01,083779,Greenfeld; Be'Eri,0,15,30,30
1651107875298,MATH 103A,B02,083780,Greenfeld; Be'Eri,0,14,30,30
1651107881321,MATH 105,A01,085443,Staff,0,24,30,30
1651107887348,MATH 109,A01,083213,Ganzberger; Geoffrey Michael,0,8,30,30
1651107887348,MATH 109,A02,083214,Ganzberger; Geoffrey Michael,0,7,30,30
1651107887348,MATH 109,B01,083215,Ganzberger; Geoffrey Michael,0,8,30,30
1651107887348,MATH 109,B02,083216,Ganzberger; Geoffrey Michael,1,8,30,29
1651107893371,MATH 142A,A01,083219,Chow; Bennett,0,15,30,30
1651107893371,MATH 142A,A02,083220,Chow; Bennett,0,15,30,30
1651107893371,MATH 142A,B01,083221,Chow; Bennett,0,16,30,30
1651107893371,MATH 142A,B02,083222,Chow; Bennett,0,16,30,30
1651107899396,MATH 193A,A01,083224,Staff,0,9,30,30
1651107899396,MATH 193A,A02,083225,Staff,1,7,30,29
1651107899396,MATH 193A,A03,083781,Staff,0,7,30,30
1651107899396,MATH 193A,A04,083782,Staff,0,7,30,30
1651107905418,MATH 197,001,091859,McAuley; Julian John,9998,0,9999,1
1651107911479,COGS 9,A01,083615,Staff,0,20,60,60
1651107917505,COGS 11,A01,083617,Boyle; Mary E. T.,13,0,40,27
1651107923530,COGS 13,A01,083071,Staff,0,38,40,40
1651107929553,COGS 14A,A01,092681,Staff,0,40,100,100
1651107935579,COGS 14B,A01,083073,Cheng; Tzu-Han,0,11,50,50
1651107941606,COGS 17,A01,092677,Staff,8,0,75,67
1651107947630,COGS 100,A01,083619,Staff,0,30,60,60
1651107953652,COGS 101A,A01,083621,Davis; Joshua Daniel,0,29,60,60
1651107959687,COGS 101B,A01,091572,Staff,0,9,60,60
1651107965714,COGS 101C,A01,083625,Delgado; Tania,12,0,30,18
1651107971737,COGS 107A,A01,083627,Boyle; Mary E. T.,0,17,60,60
1651107977769,COGS 118A,A01,083075,Staff,0,10,60,60
1651107983799,CSE 3,A50,083646,Miranda; Gregory Joseph,15,0,38,23
1651107983799,CSE 3,A51,083647,Miranda; Gregory Joseph,36,0,37,1
1651107989823,CSE 8A,A50,083650,Miranda; Gregory Joseph,0,30,40,40
1651107995845,CSE 11,A01,083080,Cao; Yingjun,1,98,40,39
1651108001868,CSE 12,A01,083652,Staff,0,29,100,100
1651108007892,CSE 15L,A01,083654,Staff,0,3,50,50
1651108007892,CSE 15L,A02,083655,Staff,0,3,50,50
1651108013915,CSE 20,A01,083657,Staff,46,0,80,34
1651108019942,CSE 30,A01,083084,Eldon; John,0,38,80,80
1651108025970,CSE 100,A01,083659,Cao; Yingjun,0,72,50,50
1651108031993,CSE 134B,A01,083661,Powell; Thomas Allan,0,38,65,65
1651108038018,CSE 140,A01,083663,Staff,0,17,75,75
1651108044042,CSE 140L,A01,083088,Eldon; John,1,0,100,99
1651108050067,CSE 175,A01,083665,Kumar; Rakesh,0,0,25,25
1651108056093,CSE 190,A00,092507,Dubnov; Shlomo,9,0,20,11
1651108062117,ECE 45,A01,083139,Staff,0,8,60,60
1651108068141,ECE 65,A50,083695,Staff,0,7,30,30
1651108074174,ECE 109,A01,091882,Touri; Behrouz,32,0,70,38
1651108080200,ECE 180,A00,083140,Abi Samra; Nicholas Camill,17,0,30,13
1651108080200,ECE 180,B00,083141,Abi Samra; Nicholas Camill,0,1,30,32
1651108086227,MATH 10A,A01,083735,Patchell; Gregory David,0,0,30,30
1651108086227,MATH 10A,A02,083736,Patchell; Gregory David,26,0,30,4
1651108086227,MATH 10A,A03,083737,Patchell; Gregory David,22,0,30,8
1651108092255,MATH 10B,A01,083207,Staff,0,8,30,30
1651108092255,MATH 10B,A02,083208,Staff,0,6,30,30
1651108092255,MATH 10B,B01,083739,Staff,7,0,30,23
1651108092255,MATH 10B,B02,083740,Staff,28,0,30,2
1651108098280,MATH 18,A01,083743,Staff,0,0,30,30
1651108098280,MATH 18,A02,083744,Staff,23,0,30,7
1651108098280,MATH 18,A03,083745,Staff,19,0,30,11
1651108098280,MATH 18,A04,083746,Staff,26,0,30,4
1651108098280,MATH 18,B01,083748,Staff,0,16,30,30
1651108098280,MATH 18,B02,083749,Staff,0,14,30,30
1651108098280,MATH 18,B03,083750,Staff,0,15,30,30
1651108098280,MATH 18,B04,083751,Staff,0,14,30,30
1651108104302,MATH 20A,A01,083754,Staff,18,0,40,22
1651108110325,MATH 20B,A01,083756,Briones; Jor-el Thomas Caparas,0,14,30,30
1651108110325,MATH 20B,A02,083757,Briones; Jor-el Thomas Caparas,0,11,30,30
1651108116354,MATH 20C,A01,083760,Briones; Jor-el Thomas Caparas,1,17,30,29
1651108116354,MATH 20C,A02,083761,Briones; Jor-el Thomas Caparas,0,16,30,30
1651108116354,MATH 20C,B01,083762,Staff,7,0,30,23
1651108116354,MATH 20C,B02,083763,Staff,27,0,30,3
1651108122389,MATH 20D,A01,083765,Tran; Brian Kha,3,1,30,27
1651108122389,MATH 20D,A02,083766,Tran; Brian Kha,0,0,30,30
1651108122389,MATH 20D,A03,083767,Tran; Brian Kha,22,0,30,8
1651108128420,MATH 20E,A01,083771,Staff,0,0,30,30
1651108128420,MATH 20E,A02,083772,Staff,9,0,30,21
1651108128420,MATH 20E,B01,083773,Staff,5,0,35,30
1651108128420,MATH 20E,B02,083774,Staff,5,1,35,30
1651108134448,MATH 103A,A01,083777,Greenfeld; Be'Eri,0,17,30,30
1651108134448,MATH 103A,A02,083778,Greenfeld; Be'Eri,0,17,30,30
1651108134448,MATH 103A,B01,083779,Greenfeld; Be'Eri,0,15,30,30
1651108134448,MATH 103A,B02,083780,Greenfeld; Be'Eri,0,14,30,30
1651108140477,MATH 105,A01,085443,Staff,0,24,30,30
1651108146514,MATH 109,A01,083213,Ganzberger; Geoffrey Michael,0,8,30,30
1651108146514,MATH 109,A02,083214,Ganzberger; Geoffrey Michael,0,7,30,30
1651108146514,MATH 109,B01,083215,Ganzberger; Geoffrey Michael,0,8,30,30
1651108146514,MATH 109,B02,083216,Ganzberger; Geoffrey Michael,1,8,30,29
1651108152549,MATH 142A,A01,083219,Chow; Bennett,0,15,30,30
1651108152549,MATH 142A,A02,083220,Chow; Bennett,0,15,30,30
1651108152549,MATH 142A,B01,083221,Chow; Bennett,0,16,30,30
1651108152549,MATH 142A,B02,083222,Chow; Bennett,0,16,30,30
1651108158575,MATH 193A,A01,083224,Staff,0,9,30,30
1651108158575,MATH 193A,A02,083225,Staff,1,7,30,29
1651108158575,MATH 193A,A03,083781,Staff,0,7,30,30
1651108158575,MATH 193A,A04,083782,Staff,0,7,30,30
1651108164606,MATH 197,001,091859,McAuley; Julian John,9998,0,9999,1
1651108170659,COGS 9,A01,083615,Staff,0,20,60,60
1651108176682,COGS 11,A01,083617,Boyle; Mary E. T.,13,0,40,27
1651108182709,COGS 13,A01,083071,Staff,0,38,40,40
1651108188746,COGS 14A,A01,092681,Staff,0,40,100,100
1651108194770,COGS 14B,A01,083073,Cheng; Tzu-Han,0,11,50,50
1651108200797,COGS 17,A01,092677,Staff,8,0,75,67
1651108206823,COGS 100,A01,083619,Staff,0,30,60,60
1651108212850,COGS 101A,A01,083621,Davis; Joshua Daniel,0,29,60,60
1651108218874,COGS 101B,A01,091572,Staff,0,9,60,60
1651108224897,COGS 101C,A01,083625,Delgado; Tania,12,0,30,18
1651108230923,COGS 107A,A01,083627,Boyle; Mary E. T.,0,17,60,60
1651108236950,COGS 118A,A01,083075,Staff,0,10,60,60
1651108242975,CSE 3,A50,083646,Miranda; Gregory Joseph,15,0,38,23
1651108242975,CSE 3,A51,083647,Miranda; Gregory Joseph,36,0,37,1
1651108249005,CSE 8A,A50,083650,Miranda; Gregory Joseph,0,30,40,40
1651108255033,CSE 11,A01,083080,Cao; Yingjun,1,98,40,39
1651108261058,CSE 12,A01,083652,Staff,0,29,100,100
1651108267080,CSE 15L,A01,083654,Staff,0,3,50,50
1651108267080,CSE 15L,A02,083655,Staff,0,3,50,50
1651108273103,CSE 20,A01,083657,Staff,46,0,80,34
1651108279216,CSE 30,A01,083084,Eldon; John,0,38,80,80
1651108285241,CSE 100,A01,083659,Cao; Yingjun,0,72,50,50
1651108291267,CSE 134B,A01,083661,Powell; Thomas Allan,0,38,65,65
1651108297290,CSE 140,A01,083663,Staff,0,17,75,75
1651108303316,CSE 140L,A01,083088,Eldon; John,1,0,100,99
1651108309341,CSE 175,A01,083665,Kumar; Rakesh,0,0,25,25
1651108315363,CSE 190,A00,092507,Dubnov; Shlomo,9,0,20,11
1651108321391,ECE 45,A01,083139,Staff,0,8,60,60
1651108327418,ECE 65,A50,083695,Staff,0,7,30,30
1651108333442,ECE 109,A01,091882,Touri; Behrouz,32,0,70,38
1651108339466,ECE 180,A00,083140,Abi Samra; Nicholas Camill,17,0,30,13
1651108339466,ECE 180,B00,083141,Abi Samra; Nicholas Camill,0,1,30,32
1651108345489,MATH 10A,A01,083735,Patchell; Gregory David,0,0,30,30
1651108345489,MATH 10A,A02,083736,Patchell; Gregory David,26,0,30,4
1651108345489,MATH 10A,A03,083737,Patchell; Gregory David,22,0,30,8
1651108351518,MATH 10B,A01,083207,Staff,0,8,30,30
1651108351518,MATH 10B,A02,083208,Staff,0,6,30,30
1651108351518,MATH 10B,B01,083739,Staff,7,0,30,23
1651108351518,MATH 10B,B02,083740,Staff,28,0,30,2
1651108357550,MATH 18,A01,083743,Staff,0,0,30,30
1651108357550,MATH 18,A02,083744,Staff,23,0,30,7
1651108357550,MATH 18,A03,083745,Staff,19,0,30,11
1651108357550,MATH 18,A04,083746,Staff,26,0,30,4
1651108357550,MATH 18,B01,083748,Staff,0,16,30,30
1651108357550,MATH 18,B02,083749,Staff,0,14,30,30
1651108357550,MATH 18,B03,083750,Staff,0,15,30,30
1651108357550,MATH 18,B04,083751,Staff,0,14,30,30
1651108363574,MATH 20A,A01,083754,Staff,18,0,40,22
1651108369600,MATH 20B,A01,083756,Briones; Jor-el Thomas Caparas,0,14,30,30
1651108369600,MATH 20B,A02,083757,Briones; Jor-el Thomas Caparas,0,11,30,30
1651108375624,MATH 20C,A01,083760,Briones; Jor-el Thomas Caparas,1,17,30,29
1651108375624,MATH 20C,A02,083761,Briones; Jor-el Thomas Caparas,0,16,30,30
1651108375624,MATH 20C,B01,083762,Staff,7,0,30,23
1651108375624,MATH 20C,B02,083763,Staff,27,0,30,3
1651108381653,MATH 20D,A01,083765,Tran; Brian Kha,3,1,30,27
1651108381653,MATH 20D,A02,083766,Tran; Brian Kha,0,0,30,30
1651108381653,MATH 20D,A03,083767,Tran; Brian Kha,22,0,30,8
1651108387677,MATH 20E,A01,083771,Staff,0,0,30,30
1651108387677,MATH 20E,A02,083772,Staff,9,0,30,21
1651108387677,MATH 20E,B01,083773,Staff,5,0,35,30
1651108387677,MATH 20E,B02,083774,Staff,5,1,35,30
1651108393711,MATH 103A,A01,083777,Greenfeld; Be'Eri,0,17,30,30
1651108393711,MATH 103A,A02,083778,Greenfeld; Be'Eri,0,17,30,30
1651108393711,MATH 103A,B01,083779,Greenfeld; Be'Eri,0,15,30,30
1651108393711,MATH 103A,B02,083780,Greenfeld; Be'Eri,0,14,30,30
1651108408741,MATH 105,A01,085443,Staff,0,24,30,30
1651108414766,MATH 109,A01,083213,Ganzberger; Geoffrey Michael,0,8,30,30
1651108414766,MATH 109,A02,083214,Ganzberger; Geoffrey Michael,0,7,30,30
1651108414766,MATH 109,B01,083215,Ganzberger; Geoffrey Michael,0,8,30,30
1651108414766,MATH 109,B02,083216,Ganzberger; Geoffrey Michael,1,8,30,29
1651108420797,MATH 142A,A01,083219,Chow; Bennett,0,15,30,30
1651108420797,MATH 142A,A02,083220,Chow; Bennett,0,15,30,30
1651108420797,MATH 142A,B01,083221,Chow; Bennett,0,16,30,30
1651108420797,MATH 142A,B02,083222,Chow; Bennett,0,16,30,30
1651108426821,MATH 193A,A01,083224,Staff,0,9,30,30
1651108426821,MATH 193A,A02,083225,Staff,1,7,30,29
1651108426821,MATH 193A,A03,083781,Staff,0,7,30,30
1651108426821,MATH 193A,A04,083782,Staff,0,7,30,30
1651108432847,MATH 197,001,091859,McAuley; Julian John,9998,0,9999,1
1651108438906,COGS 9,A01,083615,Staff,0,20,60,60
1651108444930,COGS 11,A01,083617,Boyle; Mary E. T.,13,0,40,27
1651108450953,COGS 13,A01,083071,Staff,0,38,40,40
1651108456978,COGS 14A,A01,092681,Staff,0,40,100,100
1651108463012,COGS 14B,A01,083073,Cheng; Tzu-Han,0,11,50,50
1651108469040,COGS 17,A01,092677,Staff,8,0,75,67
1651108475062,COGS 100,A01,083619,Staff,0,30,60,60
1651108481090,COGS 101A,A01,083621,Davis; Joshua Daniel,0,29,60,60
1651108487116,COGS 101B,A01,091572,Staff,0,9,60,60
1651108493152,COGS 101C,A01,083625,Delgado; Tania,12,0,30,18
1651108499191,COGS 107A,A01,083627,Boyle; Mary E. T.,0,17,60,60
1651108505214,COGS 118A,A01,083075,Staff,0,10,60,60
1651108511237,CSE 3,A50,083646,Miranda; Gregory Joseph,15,0,38,23
1651108511237,CSE 3,A51,083647,Miranda; Gregory Joseph,36,0,37,1
1651108517265,CSE 8A,A50,083650,Miranda; Gregory Joseph,0,30,40,40
1651108523291,CSE 11,A01,083080,Cao; Yingjun,1,98,40,39
1651108529314,CSE 12,A01,083652,Staff,0,29,100,100
1651108535337,CSE 15L,A01,083654,Staff,0,3,50,50
1651108535337,CSE 15L,A02,083655,Staff,0,3,50,50
1651108541363,CSE 20,A01,083657,Staff,46,0,80,34
1651108547383,CSE 30,A01,083084,Eldon; John,0,38,80,80
1651108553411,CSE 100,A01,083659,Cao; Yingjun,0,72,50,50
1651108559440,CSE 134B,A01,083661,Powell; Thomas Allan,0,38,65,65
1651108565464,CSE 140,A01,083663,Staff,0,17,75,75
1651108571490,CSE 140L,A01,083088,Eldon; John,1,0,100,99
1651108577516,CSE 175,A01,083665,Kumar; Rakesh,0,0,25,25
1651108583543,CSE 190,A00,092507,Dubnov; Shlomo,9,0,20,11
1651108589569,ECE 45,A01,083139,Staff,0,8,60,60
1651108595594,ECE 65,A50,083695,Staff,0,7,30,30
1651108601615,ECE 109,A01,091882,Touri; Behrouz,32,0,70,38
1651108607640,ECE 180,A00,083140,Abi Samra; Nicholas Camill,17,0,30,13
1651108607640,ECE 180,B00,083141,Abi Samra; Nicholas Camill,0,1,30,32
1651108613671,MATH 10A,A01,083735,Patchell; Gregory David,0,0,30,30
1651108613671,MATH 10A,A02,083736,Patchell; Gregory David,26,0,30,4
1651108613671,MATH 10A,A03,083737,Patchell; Gregory David,22,0,30,8
1651108619698,MATH 10B,A01,083207,Staff,0,8,30,30
1651108619698,MATH 10B,A02,083208,Staff,0,6,30,30
1651108619698,MATH 10B,B01,083739,Staff,7,0,30,23
1651108619698,MATH 10B,B02,083740,Staff,28,0,30,2
1651108625729,MATH 18,A01,083743,Staff,0,0,30,30
1651108625729,MATH 18,A02,083744,Staff,23,0,30,7
1651108625729,MATH 18,A03,083745,Staff,19,0,30,11
1651108625729,MATH 18,A04,083746,Staff,26,0,30,4
1651108625729,MATH 18,B01,083748,Staff,0,16,30,30
1651108625729,MATH 18,B02,083749,Staff,0,14,30,30
1651108625729,MATH 18,B03,083750,Staff,0,15,30,30
1651108625729,MATH 18,B04,083751,Staff,0,14,30,30
1651108631756,MATH 20A,A01,083754,Staff,18,0,40,22
1651108637780,MATH 20B,A01,083756,Briones; Jor-el Thomas Caparas,0,14,30,30
1651108637780,MATH 20B,A02,083757,Briones; Jor-el Thomas Caparas,0,11,30,30
1651108643812,MATH 20C,A01,083760,Briones; Jor-el Thomas Caparas,1,17,30,29
1651108643812,MATH 20C,A02,083761,Briones; Jor-el Thomas Caparas,0,16,30,30
1651108643812,MATH 20C,B01,083762,Staff,7,0,30,23
1651108643812,MATH 20C,B02,083763,Staff,27,0,30,3
1651108649844,MATH 20D,A01,083765,Tran; Brian Kha,3,1,30,27
1651108649844,MATH 20D,A02,083766,Tran; Brian Kha,0,0,30,30
1651108649844,MATH 20D,A03,083767,Tran; Brian Kha,22,0,30,8
1651108655867,MATH 20E,A01,083771,Staff,0,0,30,30
1651108655867,MATH 20E,A02,083772,Staff,9,0,30,21
1651108655867,MATH 20E,B01,083773,Staff,5,0,35,30
1651108655867,MATH 20E,B02,083774,Staff,5,1,35,30
1651108661899,MATH 103A,A01,083777,Greenfeld; Be'Eri,0,17,30,30
1651108661899,MATH 103A,A02,083778,Greenfeld; Be'Eri,0,17,30,30
1651108661899,MATH 103A,B01,083779,Greenfeld; Be'Eri,0,15,30,30
1651108661899,MATH 103A,B02,083780,Greenfeld; Be'Eri,0,14,30,30
1651108667923,MATH 105,A01,085443,Staff,0,24,30,30
1651108673954,MATH 109,A01,083213,Ganzberger; Geoffrey Michael,0,8,30,30
1651108673954,MATH 109,A02,083214,Ganzberger; Geoffrey Michael,0,7,30,30
1651108673954,MATH 109,B01,083215,Ganzberger; Geoffrey Michael,0,8,30,30
1651108673954,MATH 109,B02,083216,Ganzberger; Geoffrey Michael,1,8,30,29
1651108679978,MATH 142A,A01,083219,Chow; Bennett,0,15,30,30
1651108679978,MATH 142A,A02,083220,Chow; Bennett,0,15,30,30
1651108679978,MATH 142A,B01,083221,Chow; Bennett,0,16,30,30
1651108679978,MATH 142A,B02,083222,Chow; Bennett,0,16,30,30
1651108686017,MATH 193A,A01,083224,Staff,0,9,30,30
1651108686017,MATH 193A,A02,083225,Staff,1,7,30,29
1651108686017,MATH 193A,A03,083781,Staff,0,7,30,30
1651108686017,MATH 193A,A04,083782,Staff,0,7,30,30
1651108692038,MATH 197,001,091859,McAuley; Julian John,9998,0,9999,1
1651108698090,COGS 9,A01,083615,Staff,0,20,60,60
1651108704114,COGS 11,A01,083617,Boyle; Mary E. T.,13,0,40,27
1651108710139,COGS 13,A01,083071,Staff,0,38,40,40
1651108716168,COGS 14A,A01,092681,Staff,0,40,100,100
1651108722195,COGS 14B,A01,083073,Cheng; Tzu-Han,0,11,50,50
1651108728224,COGS 17,A01,092677,Staff,8,0,75,67
1651108734250,COGS 100,A01,083619,Staff,0,30,60,60
1651108740276,COGS 101A,A01,083621,Davis; Joshua Daniel,0,29,60,60
1651108746299,COGS 101B,A01,091572,Staff,0,9,60,60
1651108752327,COGS 101C,A01,083625,Delgado; Tania,12,0,30,18
1651108758354,COGS 107A,A01,083627,Boyle; Mary E. T.,0,17,60,60
1651108764380,COGS 118A,A01,083075,Staff,0,10,60,60
1651108770403,CSE 3,A50,083646,Miranda; Gregory Joseph,15,0,38,23
1651108770403,CSE 3,A51,083647,Miranda; Gregory Joseph,36,0,37,1
1651108776431,CSE 8A,A50,083650,Miranda; Gregory Joseph,0,30,40,40
1651108782468,CSE 11,A01,083080,Cao; Yingjun,1,98,40,39
1651108788494,CSE 12,A01,083652,Staff,0,29,100,100
1651108794517,CSE 15L,A01,083654,Staff,0,3,50,50
1651108794517,CSE 15L,A02,083655,Staff,0,3,50,50
1651108800545,CSE 20,A01,083657,Staff,46,0,80,34
1651108806567,CSE 30,A01,083084,Eldon; John,0,38,80,80
1651108812593,CSE 100,A01,083659,Cao; Yingjun,0,72,50,50
1651108818616,CSE 134B,A01,083661,Powell; Thomas Allan,0,38,65,65
1651108824642,CSE 140,A01,083663,Staff,0,17,75,75
1651108830666,CSE 140L,A01,083088,Eldon; John,1,0,100,99
1651108836688,CSE 175,A01,083665,Kumar; Rakesh,0,0,25,25
1651108842715,CSE 190,A00,092507,Dubnov; Shlomo,9,0,20,11
1651108848738,ECE 45,A01,083139,Staff,0,8,60,60
1651108854762,ECE 65,A50,083695,Staff,0,7,30,30
1651108860792,ECE 109,A01,091882,Touri; Behrouz,32,0,70,38
1651108866823,ECE 180,A00,083140,Abi Samra; Nicholas Camill,17,0,30,13
1651108866823,ECE 180,B00,083141,Abi Samra; Nicholas Camill,0,1,30,32
1651108872854,MATH 10A,A01,083735,Patchell; Gregory David,0,0,30,30
1651108872854,MATH 10A,A02,083736,Patchell; Gregory David,26,0,30,4
1651108872854,MATH 10A,A03,083737,Patchell; Gregory David,22,0,30,8
1651108878880,MATH 10B,A01,083207,Staff,0,8,30,30
1651108878880,MATH 10B,A02,083208,Staff,0,6,30,30
1651108878880,MATH 10B,B01,083739,Staff,7,0,30,23
1651108878880,MATH 10B,B02,083740,Staff,28,0,30,2
1651108884997,MATH 18,A01,083743,Staff,0,0,30,30
1651108884997,MATH 18,A02,083744,Staff,23,0,30,7
1651108884997,MATH 18,A03,083745,Staff,19,0,30,11
1651108884997,MATH 18,A04,083746,Staff,26,0,30,4
1651108884997,MATH 18,B01,083748,Staff,0,16,30,30
1651108884997,MATH 18,B02,083749,Staff,0,14,30,30
1651108884997,MATH 18,B03,083750,Staff,0,15,30,30
1651108884997,MATH 18,B04,083751,Staff,0,14,30,30
1651108891025,MATH 20A,A01,083754,Staff,18,0,40,22
1651108897050,MATH 20B,A01,083756,Briones; Jor-el Thomas Caparas,0,14,30,30
1651108897050,MATH 20B,A02,083757,Briones; Jor-el Thomas Caparas,0,11,30,30
1651108903077,MATH 20C,A01,083760,Briones; Jor-el Thomas Caparas,1,17,30,29
1651108903077,MATH 20C,A02,083761,Briones; Jor-el Thomas Caparas,0,16,30,30
1651108903077,MATH 20C,B01,083762,Staff,7,0,30,23
1651108903077,MATH 20C,B02,083763,Staff,27,0,30,3
1651108909104,MATH 20D,A01,083765,Tran; Brian Kha,3,1,30,27
1651108909104,MATH 20D,A02,083766,Tran; Brian Kha,0,0,30,30
1651108909104,MATH 20D,A03,083767,Tran; Brian Kha,22,0,30,8
1651108915134,MATH 20E,A01,083771,Staff,0,0,30,30
1651108915134,MATH 20E,A02,083772,Staff,9,0,30,21
1651108915134,MATH 20E,B01,083773,Staff,5,0,35,30
1651108915134,MATH 20E,B02,083774,Staff,5,1,35,30
1651108921220,MATH 103A,A01,083777,Greenfeld; Be'Eri,0,17,30,30
1651108921220,MATH 103A,A02,083778,Greenfeld; Be'Eri,0,17,30,30
1651108921220,MATH 103A,B01,083779,Greenfeld; Be'Eri,0,15,30,30
1651108921220,MATH 103A,B02,083780,Greenfeld; Be'Eri,0,14,30,30
1651108927245,MATH 105,A01,085443,Staff,0,24,30,30
1651108933268,MATH 109,A01,083213,Ganzberger; Geoffrey Michael,0,8,30,30
1651108933268,MATH 109,A02,083214,Ganzberger; Geoffrey Michael,0,7,30,30
1651108933268,MATH 109,B01,083215,Ganzberger; Geoffrey Michael,0,8,30,30
1651108933268,MATH 109,B02,083216,Ganzberger; Geoffrey Michael,1,8,30,29
1651108939292,MATH 142A,A01,083219,Chow; Bennett,0,15,30,30
1651108939292,MATH 142A,A02,083220,Chow; Bennett,0,15,30,30
1651108939292,MATH 142A,B01,083221,Chow; Bennett,0,16,30,30
1651108939292,MATH 142A,B02,083222,Chow; Bennett,0,16,30,30
1651108945320,MATH 193A,A01,083224,Staff,0,9,30,30
1651108945320,MATH 193A,A02,083225,Staff,1,7,30,29
1651108945320,MATH 193A,A03,083781,Staff,0,7,30,30
1651108945320,MATH 193A,A04,083782,Staff,0,7,30,30
1651108951346,MATH 197,001,091859,McAuley; Julian John,9998,0,9999,1
1651108957410,COGS 9,A01,083615,Staff,0,20,60,60
1651108963444,COGS 11,A01,083617,Boyle; Mary E. T.,13,0,40,27
1651108969473,COGS 13,A01,083071,Staff,0,38,40,40
1651108975499,COGS 14A,A01,092681,Staff,0,40,100,100
1651108981529,COGS 14B,A01,083073,Cheng; Tzu-Han,0,11,50,50
1651108987552,COGS 17,A01,092677,Staff,8,0,75,67
1651108993580,COGS 100,A01,083619,Staff,0,30,60,60
1651108999604,COGS 101A,A01,083621,Davis; Joshua Daniel,0,29,60,60
1651109005631,COGS 101B,A01,091572,Staff,0,9,60,60
1651109011654,COGS 101C,A01,083625,Delgado; Tania,12,0,30,18
1651109017680,COGS 107A,A01,083627,Boyle; Mary E. T.,0,17,60,60
1651109023722,COGS 118A,A01,083075,Staff,0,10,60,60
1651109029747,CSE 3,A50,083646,Miranda; Gregory Joseph,15,0,38,23
1651109029747,CSE 3,A51,083647,Miranda; Gregory Joseph,36,0,37,1
1651109035770,CSE 8A,A50,083650,Miranda; Gregory Joseph,0,30,40,40
1651109041793,CSE 11,A01,083080,Cao; Yingjun,1,98,40,39
1651109047818,CSE 12,A01,083652,Staff,0,29,100,100
1651109053841,CSE 15L,A01,083654,Staff,0,3,50,50
1651109053841,CSE 15L,A02,083655,Staff,0,3,50,50
1651109059867,CSE 20,A01,083657,Staff,46,0,80,34
1651109065896,CSE 30,A01,083084,Eldon; John,0,38,80,80
1651109071925,CSE 100,A01,083659,Cao; Yingjun,0,72,50,50
1651109077947,CSE 134B,A01,083661,Powell; Thomas Allan,0,38,65,65
1651109083970,CSE 140,A01,083663,Staff,0,17,75,75
1651109089996,CSE 140L,A01,083088,Eldon; John,1,0,100,99
1651109096018,CSE 175,A01,083665,Kumar; Rakesh,0,0,25,25
1651109102043,CSE 190,A00,092507,Dubnov; Shlomo,9,0,20,11
1651109108068,ECE 45,A01,083139,Staff,0,8,60,60
1651109114094,ECE 65,A50,083695,Staff,0,7,30,30
1651109120116,ECE 109,A01,091882,Touri; Behrouz,32,0,70,38
1651109126139,ECE 180,A00,083140,Abi Samra; Nicholas Camill,17,0,30,13
1651109126139,ECE 180,B00,083141,Abi Samra; Nicholas Camill,0,1,30,32
1651109132167,MATH 10A,A01,083735,Patchell; Gregory David,0,0,30,30
1651109132167,MATH 10A,A02,083736,Patchell; Gregory David,26,0,30,4
1651109132167,MATH 10A,A03,083737,Patchell; Gregory David,22,0,30,8
1651109138191,MATH 10B,A01,083207,Staff,0,8,30,30
1651109138191,MATH 10B,A02,083208,Staff,0,6,30,30
1651109138191,MATH 10B,B01,083739,Staff,7,0,30,23
1651109138191,MATH 10B,B02,083740,Staff,28,0,30,2
1651109144220,MATH 18,A01,083743,Staff,0,0,30,30
1651109144220,MATH 18,A02,083744,Staff,23,0,30,7
1651109144220,MATH 18,A03,083745,Staff,19,0,30,11
1651109144220,MATH 18,A04,083746,Staff,26,0,30,4
1651109144220,MATH 18,B01,083748,Staff,0,16,30,30
1651109144220,MATH 18,B02,083749,Staff,0,14,30,30
1651109144220,MATH 18,B03,083750,Staff,0,15,30,30
1651109144220,MATH 18,B04,083751,Staff,0,14,30,30
1651109150252,MATH 20A,A01,083754,Staff,18,0,40,22
1651109156280,MATH 20B,A01,083756,Briones; Jor-el Thomas Caparas,0,14,30,30
1651109156280,MATH 20B,A02,083757,Briones; Jor-el Thomas Caparas,0,11,30,30
1651109162312,MATH 20C,A01,083760,Briones; Jor-el Thomas Caparas,1,17,30,29
1651109162312,MATH 20C,A02,083761,Briones; Jor-el Thomas Caparas,0,16,30,30
1651109162312,MATH 20C,B01,083762,Staff,7,0,30,23
1651109162312,MATH 20C,B02,083763,Staff,27,0,30,3
1651109168336,MATH 20D,A01,083765,Tran; Brian Kha,4,1,30,26
1651109168336,MATH 20D,A02,083766,Tran; Brian Kha,0,0,30,30
1651109168336,MATH 20D,A03,083767,Tran; Brian Kha,22,0,30,8
1651109174374,MATH 20E,A01,083771,Staff,0,0,30,30
1651109174374,MATH 20E,A02,083772,Staff,9,0,30,21
1651109174374,MATH 20E,B01,083773,Staff,5,0,35,30
1651109174374,MATH 20E,B02,083774,Staff,5,1,35,30
1651109180411,MATH 103A,A01,083777,Greenfeld; Be'Eri,0,17,30,30
1651109180411,MATH 103A,A02,083778,Greenfeld; Be'Eri,0,17,30,30
1651109180411,MATH 103A,B01,083779,Greenfeld; Be'Eri,0,15,30,30
1651109180411,MATH 103A,B02,083780,Greenfeld; Be'Eri,0,14,30,30
1651109186435,MATH 105,A01,085443,Staff,0,24,30,30
1651109192462,MATH 109,A01,083213,Ganzberger; Geoffrey Michael,0,8,30,30
1651109192462,MATH 109,A02,083214,Ganzberger; Geoffrey Michael,0,7,30,30
1651109192462,MATH 109,B01,083215,Ganzberger; Geoffrey Michael,0,8,30,30
1651109192462,MATH 109,B02,083216,Ganzberger; Geoffrey Michael,1,8,30,29
1651109198489,MATH 142A,A01,083219,Chow; Bennett,0,15,30,30
1651109198489,MATH 142A,A02,083220,Chow; Bennett,0,15,30,30
1651109198489,MATH 142A,B01,083221,Chow; Bennett,0,16,30,30
1651109198489,MATH 142A,B02,083222,Chow; Bennett,0,16,30,30
1651109204512,MATH 193A,A01,083224,Staff,0,9,30,30
1651109204512,MATH 193A,A02,083225,Staff,1,7,30,29
1651109204512,MATH 193A,A03,083781,Staff,0,7,30,30
1651109204512,MATH 193A,A04,083782,Staff,0,7,30,30
1651109210536,MATH 197,001,091859,McAuley; Julian John,9998,0,9999,1
1651109216583,COGS 9,A01,083615,Staff,0,20,60,60
1651109222606,COGS 11,A01,083617,Boyle; Mary E. T.,13,0,40,27
1651109228630,COGS 13,A01,083071,Staff,0,38,40,40
1651109234656,COGS 14A,A01,092681,Staff,0,40,100,100
1651109240678,COGS 14B,A01,083073,Cheng; Tzu-Han,0,11,50,50
1651109246705,COGS 17,A01,092677,Staff,8,0,75,67
1651109252728,COGS 100,A01,083619,Staff,0,30,60,60
1651109258750,COGS 101A,A01,083621,Davis; Joshua Daniel,0,29,60,60
1651109264775,COGS 101B,A01,091572,Staff,0,9,60,60
1651109270801,COGS 101C,A01,083625,Delgado; Tania,12,0,30,18
1651109276828,COGS 107A,A01,083627,Boyle; Mary E. T.,0,17,60,60
1651109282851,COGS 118A,A01,083075,Staff,0,10,60,60
1651109288884,CSE 3,A50,083646,Miranda; Gregory Joseph,15,0,38,23
1651109288884,CSE 3,A51,083647,Miranda; Gregory Joseph,36,0,37,1
1651109294907,CSE 8A,A50,083650,Miranda; Gregory Joseph,0,30,40,40
1651109300936,CSE 11,A01,083080,Cao; Yingjun,1,98,40,39
1651109306965,CSE 12,A01,083652,Staff,0,29,100,100
1651109312989,CSE 15L,A01,083654,Staff,0,3,50,50
1651109312989,CSE 15L,A02,083655,Staff,0,3,50,50
1651109319012,CSE 20,A01,083657,Staff,46,0,80,34
1651109325043,CSE 30,A01,083084,Eldon; John,0,38,80,80
1651109331070,CSE 100,A01,083659,Cao; Yingjun,0,72,50,50
1651109337105,CSE 134B,A01,083661,Powell; Thomas Allan,0,38,65,65
1651109343128,CSE 140,A01,083663,Staff,0,17,75,75
1651109349152,CSE 140L,A01,083088,Eldon; John,1,0,100,99
1651109355178,CSE 175,A01,083665,Kumar; Rakesh,0,0,25,25
1651109361205,CSE 190,A00,092507,Dubnov; Shlomo,9,0,20,11
1651109367232,ECE 45,A01,083139,Staff,0,8,60,60
1651109373267,ECE 65,A50,083695,Staff,0,7,30,30
1651109379291,ECE 109,A01,091882,Touri; Behrouz,32,0,70,38
1651109385317,ECE 180,A00,083140,Abi Samra; Nicholas Camill,17,0,30,13
1651109385317,ECE 180,B00,083141,Abi Samra; Nicholas Camill,0,1,30,32
1651109391344,MATH 10A,A01,083735,Patchell; Gregory David,0,0,30,30
1651109391344,MATH 10A,A02,083736,Patchell; Gregory David,26,0,30,4
1651109391344,MATH 10A,A03,083737,Patchell; Gregory David,22,0,30,8
1651109397366,MATH 10B,A01,083207,Staff,0,8,30,30
1651109397366,MATH 10B,A02,083208,Staff,0,6,30,30
1651109397366,MATH 10B,B01,083739,Staff,7,0,30,23
1651109397366,MATH 10B,B02,083740,Staff,28,0,30,2
1651109403391,MATH 18,A01,083743,Staff,0,0,30,30
1651109403391,MATH 18,A02,083744,Staff,23,0,30,7
1651109403391,MATH 18,A03,083745,Staff,19,0,30,11
1651109403391,MATH 18,A04,083746,Staff,26,0,30,4
1651109403391,MATH 18,B01,083748,Staff,0,16,30,30
1651109403391,MATH 18,B02,083749,Staff,0,14,30,30
1651109403391,MATH 18,B03,083750,Staff,0,15,30,30
1651109403391,MATH 18,B04,083751,Staff,0,14,30,30
1651109409417,MATH 20A,A01,083754,Staff,18,0,40,22
1651109415441,MATH 20B,A01,083756,Briones; Jor-el Thomas Caparas,0,14,30,30
1651109415441,MATH 20B,A02,083757,Briones; Jor-el Thomas Caparas,0,11,30,30
1651109421472,MATH 20C,A01,083760,Briones; Jor-el Thomas Caparas,1,17,30,29
1651109421472,MATH 20C,A02,083761,Briones; Jor-el Thomas Caparas,0,16,30,30
1651109421472,MATH 20C,B01,083762,Staff,7,0,30,23
1651109421472,MATH 20C,B02,083763,Staff,27,0,30,3
1651109427500,MATH 20D,A01,083765,Tran; Brian Kha,4,1,30,26
1651109427500,MATH 20D,A02,083766,Tran; Brian Kha,0,0,30,30
1651109427500,MATH 20D,A03,083767,Tran; Brian Kha,22,0,30,8
1651109433556,MATH 20E,A01,083771,Staff,0,0,30,30
1651109433556,MATH 20E,A02,083772,Staff,9,0,30,21
1651109433556,MATH 20E,B01,083773,Staff,5,0,35,30
1651109433556,MATH 20E,B02,083774,Staff,5,1,35,30
1651109439580,MATH 103A,A01,083777,Greenfeld; Be'Eri,0,17,30,30
1651109439580,MATH 103A,A02,083778,Greenfeld; Be'Eri,0,17,30,30
1651109439580,MATH 103A,B01,083779,Greenfeld; Be'Eri,0,15,30,30
1651109439580,MATH 103A,B02,083780,Greenfeld; Be'Eri,0,14,30,30
1651109445611,MATH 105,A01,085443,Staff,0,24,30,30
1651109451639,MATH 109,A01,083213,Ganzberger; Geoffrey Michael,0,8,30,30
1651109451639,MATH 109,A02,083214,Ganzberger; Geoffrey Michael,0,7,30,30
1651109451639,MATH 109,B01,083215,Ganzberger; Geoffrey Michael,0,8,30,30
1651109451639,MATH 109,B02,083216,Ganzberger; Geoffrey Michael,1,8,30,29
1651109457662,MATH 142A,A01,083219,Chow; Bennett,0,15,30,30
1651109457662,MATH 142A,A02,083220,Chow; Bennett,0,15,30,30
1651109457662,MATH 142A,B01,083221,Chow; Bennett,0,16,30,30
1651109457662,MATH 142A,B02,083222,Chow; Bennett,0,16,30,30
1651109463690,MATH 193A,A01,083224,Staff,0,9,30,30
1651109463690,MATH 193A,A02,083225,Staff,1,7,30,29
1651109463690,MATH 193A,A03,083781,Staff,0,7,30,30
1651109463690,MATH 193A,A04,083782,Staff,0,7,30,30
1651109469713,MATH 197,001,091859,McAuley; Julian John,9998,0,9999,1
1651109475862,COGS 9,A01,083615,Staff,0,20,60,60
1651109481889,COGS 11,A01,083617,Boyle; Mary E. T.,13,0,40,27
1651109487913,COGS 13,A01,083071,Staff,0,38,40,40
1651109493936,COGS 14A,A01,092681,Staff,0,40,100,100
1651109499963,COGS 14B,A01,083073,Cheng; Tzu-Han,0,11,50,50
1651109505986,COGS 17,A01,092677,Staff,8,0,75,67
1651109512009,COGS 100,A01,083619,Staff,0,30,60,60
1651109518038,COGS 101A,A01,083621,Davis; Joshua Daniel,0,29,60,60
1651109524065,COGS 101B,A01,091572,Staff,0,9,60,60
1651109530091,COGS 101C,A01,083625,Delgado; Tania,12,0,30,18
1651109536118,COGS 107A,A01,083627,Boyle; Mary E. T.,0,17,60,60
1651109542146,COGS 118A,A01,083075,Staff,0,10,60,60
1651109548175,CSE 3,A50,083646,Miranda; Gregory Joseph,15,0,38,23
1651109548175,CSE 3,A51,083647,Miranda; Gregory Joseph,36,0,37,1
1651109554210,CSE 8A,A50,083650,Miranda; Gregory Joseph,0,30,40,40
1651109560233,CSE 11,A01,083080,Cao; Yingjun,1,98,40,39
1651109566261,CSE 12,A01,083652,Staff,0,29,100,100
1651109572285,CSE 15L,A01,083654,Staff,0,3,50,50
1651109572285,CSE 15L,A02,083655,Staff,0,3,50,50
1651109578308,CSE 20,A01,083657,Staff,46,0,80,34
1651109584331,CSE 30,A01,083084,Eldon; John,0,38,80,80
1651109590358,CSE 100,A01,083659,Cao; Yingjun,0,72,50,50
1651109596380,CSE 134B,A01,083661,Powell; Thomas Allan,0,38,65,65
1651109602405,CSE 140,A01,083663,Staff,0,17,75,75
1651109608432,CSE 140L,A01,083088,Eldon; John,1,0,100,99
1651109614454,CSE 175,A01,083665,Kumar; Rakesh,0,0,25,25
1651109620481,CSE 190,A00,092507,Dubnov; Shlomo,9,0,20,11
1651109626508,ECE 45,A01,083139,Staff,0,8,60,60
1651109632531,ECE 65,A50,083695,Staff,0,7,30,30
1651109638557,ECE 109,A01,091882,Touri; Behrouz,32,0,70,38
1651109644588,ECE 180,A00,083140,Abi Samra; Nicholas Camill,17,0,30,13
1651109644588,ECE 180,B00,083141,Abi Samra; Nicholas Camill,0,1,30,32
1651109650612,MATH 10A,A01,083735,Patchell; Gregory David,0,0,30,30
1651109650612,MATH 10A,A02,083736,Patchell; Gregory David,26,0,30,4
1651109650612,MATH 10A,A03,083737,Patchell; Gregory David,22,0,30,8
1651109656635,MATH 10B,A01,083207,Staff,0,8,30,30
1651109656635,MATH 10B,A02,083208,Staff,0,6,30,30
1651109656635,MATH 10B,B01,083739,Staff,7,0,30,23
1651109656635,MATH 10B,B02,083740,Staff,28,0,30,2
1651109662660,MATH 18,A01,083743,Staff,0,0,30,30
1651109662660,MATH 18,A02,083744,Staff,23,0,30,7
1651109662660,MATH 18,A03,083745,Staff,19,0,30,11
1651109662660,MATH 18,A04,083746,Staff,26,0,30,4
1651109662660,MATH 18,B01,083748,Staff,0,16,30,30
1651109662660,MATH 18,B02,083749,Staff,0,14,30,30
1651109662660,MATH 18,B03,083750,Staff,0,15,30,30
1651109662660,MATH 18,B04,083751,Staff,0,14,30,30
1651109668687,MATH 20A,A01,083754,Staff,18,0,40,22
1651109674710,MATH 20B,A01,083756,Briones; Jor-el Thomas Caparas,0,14,30,30
1651109674710,MATH 20B,A02,083757,Briones; Jor-el Thomas Caparas,0,11,30,30
1651109680741,MATH 20C,A01,083760,Briones; Jor-el Thomas Caparas,1,17,30,29
1651109680741,MATH 20C,A02,083761,Briones; Jor-el Thomas Caparas,0,16,30,30
1651109680741,MATH 20C,B01,083762,Staff,7,0,30,23
1651109680741,MATH 20C,B02,083763,Staff,27,0,30,3
1651109686766,MATH 20D,A01,083765,Tran; Brian Kha,4,1,30,26
1651109686766,MATH 20D,A02,083766,Tran; Brian Kha,0,0,30,30
1651109686766,MATH 20D,A03,083767,Tran; Brian Kha,22,0,30,8
1651109692793,MATH 20E,A01,083771,Staff,0,0,30,30
1651109692793,MATH 20E,A02,083772,Staff,9,0,30,21
1651109692793,MATH 20E,B01,083773,Staff,5,0,35,30
1651109692793,MATH 20E,B02,083774,Staff,5,1,35,30
1651109698822,MATH 103A,A01,083777,Greenfeld; Be'Eri,0,17,30,30
1651109698822,MATH 103A,A02,083778,Greenfeld; Be'Eri,0,17,30,30
1651109698822,MATH 103A,B01,083779,Greenfeld; Be'Eri,0,15,30,30
1651109698822,MATH 103A,B02,083780,Greenfeld; Be'Eri,0,14,30,30
1651109704857,MATH 105,A01,085443,Staff,0,24,30,30
1651109710880,MATH 109,A01,083213,Ganzberger; Geoffrey Michael,0,8,30,30
1651109710880,MATH 109,A02,083214,Ganzberger; Geoffrey Michael,0,7,30,30
1651109710880,MATH 109,B01,083215,Ganzberger; Geoffrey Michael,0,8,30,30
1651109710880,MATH 109,B02,083216,Ganzberger; Geoffrey Michael,1,8,30,29
1651109716903,MATH 142A,A01,083219,Chow; Bennett,0,15,30,30
1651109716903,MATH 142A,A02,083220,Chow; Bennett,0,15,30,30
1651109716903,MATH 142A,B01,083221,Chow; Bennett,0,16,30,30
1651109716903,MATH 142A,B02,083222,Chow; Bennett,0,16,30,30
1651109722927,MATH 193A,A01,083224,Staff,0,9,30,30
1651109722927,MATH 193A,A02,083225,Staff,1,7,30,29
1651109722927,MATH 193A,A03,083781,Staff,0,7,30,30
1651109722927,MATH 193A,A04,083782,Staff,0,7,30,30
1651109728950,MATH 197,001,091859,McAuley; Julian John,9998,0,9999,1
1651109735016,COGS 9,A01,083615,Staff,0,20,60,60
1651109741040,COGS 11,A01,083617,Boyle; Mary E. T.,13,0,40,27
1651109747063,COGS 13,A01,083071,Staff,0,38,40,40
1651109753086,COGS 14A,A01,092681,Staff,0,40,100,100
1651109759110,COGS 14B,A01,083073,Cheng; Tzu-Han,0,11,50,50
1651109765135,COGS 17,A01,092677,Staff,8,0,75,67
1651109771160,COGS 100,A01,083619,Staff,0,30,60,60
1651109777194,COGS 101A,A01,083621,Davis; Joshua Daniel,0,29,60,60
1651109783214,COGS 101B,A01,091572,Staff,0,9,60,60
1651109789241,COGS 101C,A01,083625,Delgado; Tania,12,0,30,18
1651109795265,COGS 107A,A01,083627,Boyle; Mary E. T.,0,17,60,60
1651109801287,COGS 118A,A01,083075,Staff,0,10,60,60
1651109807314,CSE 3,A50,083646,Miranda; Gregory Joseph,15,0,38,23
1651109807314,CSE 3,A51,083647,Miranda; Gregory Joseph,36,0,37,1
1651109813339,CSE 8A,A50,083650,Miranda; Gregory Joseph,0,30,40,40
1651109819363,CSE 11,A01,083080,Cao; Yingjun,1,98,40,39
1651109825387,CSE 12,A01,083652,Staff,0,29,100,100
1651109831410,CSE 15L,A01,083654,Staff,0,3,50,50
1651109831410,CSE 15L,A02,083655,Staff,0,3,50,50
1651109837431,CSE 20,A01,083657,Staff,46,0,80,34
1651109843462,CSE 30,A01,083084,Eldon; John,0,38,80,80
1651109849487,CSE 100,A01,083659,Cao; Yingjun,0,72,50,50
1651109855509,CSE 134B,A01,083661,Powell; Thomas Allan,0,38,65,65
1651109861533,CSE 140,A01,083663,Staff,0,17,75,75
1651109867560,CSE 140L,A01,083088,Eldon; John,1,0,100,99
1651109873583,CSE 175,A01,083665,Kumar; Rakesh,0,0,25,25
1651109879607,CSE 190,A00,092507,Dubnov; Shlomo,9,0,20,11
1651109885632,ECE 45,A01,083139,Staff,0,8,60,60
1651109891660,ECE 65,A50,083695,Staff,0,7,30,30
1651109897690,ECE 109,A01,091882,Touri; Behrouz,32,0,70,38
1651109903723,ECE 180,A00,083140,Abi Samra; Nicholas Camill,17,0,30,13
1651109903723,ECE 180,B00,083141,Abi Samra; Nicholas Camill,0,1,30,32
1651109909766,MATH 10A,A01,083735,Patchell; Gregory David,0,0,30,30
1651109909766,MATH 10A,A02,083736,Patchell; Gregory David,26,0,30,4
1651109909766,MATH 10A,A03,083737,Patchell; Gregory David,22,0,30,8
1651109915794,MATH 10B,A01,083207,Staff,0,8,30,30
1651109915794,MATH 10B,A02,083208,Staff,0,6,30,30
1651109915794,MATH 10B,B01,083739,Staff,7,0,30,23
1651109915794,MATH 10B,B02,083740,Staff,28,0,30,2
1651109921821,MATH 18,A01,083743,Staff,0,0,30,30
1651109921821,MATH 18,A02,083744,Staff,23,0,30,7
1651109921821,MATH 18,A03,083745,Staff,19,0,30,11
1651109921821,MATH 18,A04,083746,Staff,26,0,30,4
1651109921821,MATH 18,B01,083748,Staff,0,16,30,30
1651109921821,MATH 18,B02,083749,Staff,0,14,30,30
1651109921821,MATH 18,B03,083750,Staff,0,15,30,30
1651109921821,MATH 18,B04,083751,Staff,0,14,30,30
1651109927847,MATH 20A,A01,083754,Staff,18,0,40,22
1651109933885,MATH 20B,A01,083756,Briones; Jor-el Thomas Caparas,0,14,30,30
1651109933885,MATH 20B,A02,083757,Briones; Jor-el Thomas Caparas,0,11,30,30
1651109939909,MATH 20C,A01,083760,Briones; Jor-el Thomas Caparas,1,17,30,29
1651109939909,MATH 20C,A02,083761,Briones; Jor-el Thomas Caparas,0,16,30,30
1651109939909,MATH 20C,B01,083762,Staff,7,0,30,23
1651109939909,MATH 20C,B02,083763,Staff,27,0,30,3
1651109945939,MATH 20D,A01,083765,Tran; Brian Kha,4,1,30,26
1651109945939,MATH 20D,A02,083766,Tran; Brian Kha,0,0,30,30
1651109945939,MATH 20D,A03,083767,Tran; Brian Kha,22,0,30,8
1651109951963,MATH 20E,A01,083771,Staff,0,0,30,30
1651109951963,MATH 20E,A02,083772,Staff,9,0,30,21
1651109951963,MATH 20E,B01,083773,Staff,5,0,35,30
1651109951963,MATH 20E,B02,083774,Staff,5,1,35,30
1651109957988,MATH 103A,A01,083777,Greenfeld; Be'Eri,0,17,30,30
1651109957988,MATH 103A,A02,083778,Greenfeld; Be'Eri,0,17,30,30
1651109957988,MATH 103A,B01,083779,Greenfeld; Be'Eri,0,15,30,30
1651109957988,MATH 103A,B02,083780,Greenfeld; Be'Eri,0,14,30,30
1651109964011,MATH 105,A01,085443,Staff,0,24,30,30
1651109970045,MATH 109,A01,083213,Ganzberger; Geoffrey Michael,0,8,30,30
1651109970045,MATH 109,A02,083214,Ganzberger; Geoffrey Michael,0,7,30,30
1651109970045,MATH 109,B01,083215,Ganzberger; Geoffrey Michael,0,8,30,30
1651109970045,MATH 109,B02,083216,Ganzberger; Geoffrey Michael,1,8,30,29
1651109976068,MATH 142A,A01,083219,Chow; Bennett,0,15,30,30
1651109976068,MATH 142A,A02,083220,Chow; Bennett,0,15,30,30
1651109976068,MATH 142A,B01,083221,Chow; Bennett,0,16,30,30
1651109976068,MATH 142A,B02,083222,Chow; Bennett,0,16,30,30
1651109982091,MATH 193A,A01,083224,Staff,0,9,30,30
1651109982091,MATH 193A,A02,083225,Staff,1,7,30,29
1651109982091,MATH 193A,A03,083781,Staff,0,7,30,30
1651109982091,MATH 193A,A04,083782,Staff,0,7,30,30
1651109988117,MATH 197,001,091859,McAuley; Julian John,9998,0,9999,1
1651109994177,COGS 9,A01,083615,Staff,0,20,60,60
1651110000204,COGS 11,A01,083617,Boyle; Mary E. T.,13,0,40,27
1651110006228,COGS 13,A01,083071,Staff,0,38,40,40
1651110012250,COGS 14A,A01,092681,Staff,0,40,100,100
1651110018277,COGS 14B,A01,083073,Cheng; Tzu-Han,0,11,50,50
1651110024298,COGS 17,A01,092677,Staff,8,0,75,67
1651110030324,COGS 100,A01,083619,Staff,0,30,60,60
1651110036350,COGS 101A,A01,083621,Davis; Joshua Daniel,0,29,60,60
1651110042377,COGS 101B,A01,091572,Staff,0,9,60,60
1651110048402,COGS 101C,A01,083625,Delgado; Tania,12,0,30,18
1651110054426,COGS 107A,A01,083627,Boyle; Mary E. T.,0,17,60,60
1651110060449,COGS 118A,A01,083075,Staff,0,10,60,60
1651110066474,CSE 3,A50,083646,Miranda; Gregory Joseph,15,0,38,23
1651110066474,CSE 3,A51,083647,Miranda; Gregory Joseph,36,0,37,1
1651110072578,CSE 8A,A50,083650,Miranda; Gregory Joseph,0,30,40,40
1651110078604,CSE 11,A01,083080,Cao; Yingjun,1,98,40,39
1651110084626,CSE 12,A01,083652,Staff,0,29,100,100
1651110090649,CSE 15L,A01,083654,Staff,0,3,50,50
1651110090649,CSE 15L,A02,083655,Staff,0,3,50,50
1651110096681,CSE 20,A01,083657,Staff,46,0,80,34
1651110102707,CSE 30,A01,083084,Eldon; John,0,38,80,80
1651110108731,CSE 100,A01,083659,Cao; Yingjun,0,72,50,50
1651110114753,CSE 134B,A01,083661,Powell; Thomas Allan,0,38,65,65
1651110120781,CSE 140,A01,083663,Staff,0,17,75,75
1651110126819,CSE 140L,A01,083088,Eldon; John,1,0,100,99
1651110132845,CSE 175,A01,083665,Kumar; Rakesh,0,0,25,25
1651110138871,CSE 190,A00,092507,Dubnov; Shlomo,9,0,20,11
1651110144906,ECE 45,A01,083139,Staff,0,8,60,60
1651110150929,ECE 65,A50,083695,Staff,0,7,30,30
1651110156953,ECE 109,A01,091882,Touri; Behrouz,32,0,70,38
1651110162981,ECE 180,A00,083140,Abi Samra; Nicholas Camill,17,0,30,13
1651110162981,ECE 180,B00,083141,Abi Samra; Nicholas Camill,0,1,30,32
1651110169003,MATH 10A,A01,083735,Patchell; Gregory David,0,0,30,30
1651110169003,MATH 10A,A02,083736,Patchell; Gregory David,26,0,30,4
1651110169003,MATH 10A,A03,083737,Patchell; Gregory David,22,0,30,8
1651110175042,MATH 10B,A01,083207,Staff,0,8,30,30
1651110175042,MATH 10B,A02,083208,Staff,0,6,30,30
1651110175042,MATH 10B,B01,083739,Staff,7,0,30,23
1651110175042,MATH 10B,B02,083740,Staff,28,0,30,2
1651110181074,MATH 18,A01,083743,Staff,0,0,30,30
1651110181074,MATH 18,A02,083744,Staff,23,0,30,7
1651110181074,MATH 18,A03,083745,Staff,19,0,30,11
1651110181074,MATH 18,A04,083746,Staff,26,0,30,4
1651110181074,MATH 18,B01,083748,Staff,0,16,30,30
1651110181074,MATH 18,B02,083749,Staff,0,14,30,30
1651110181074,MATH 18,B03,083750,Staff,0,15,30,30
1651110181074,MATH 18,B04,083751,Staff,0,14,30,30
1651110187098,MATH 20A,A01,083754,Staff,18,0,40,22
1651110193124,MATH 20B,A01,083756,Briones; Jor-el Thomas Caparas,0,14,30,30
1651110193124,MATH 20B,A02,083757,Briones; Jor-el Thomas Caparas,0,11,30,30
1651110199160,MATH 20C,A01,083760,Briones; Jor-el Thomas Caparas,1,17,30,29
1651110199160,MATH 20C,A02,083761,Briones; Jor-el Thomas Caparas,0,16,30,30
1651110199160,MATH 20C,B01,083762,Staff,7,0,30,23
1651110199160,MATH 20C,B02,083763,Staff,27,0,30,3
1651110205187,MATH 20D,A01,083765,Tran; Brian Kha,4,1,30,26
1651110205187,MATH 20D,A02,083766,Tran; Brian Kha,0,0,30,30
1651110205187,MATH 20D,A03,083767,Tran; Brian Kha,22,0,30,8
1651110211221,MATH 20E,A01,083771,Staff,0,0,30,30
1651110211221,MATH 20E,A02,083772,Staff,9,0,30,21
1651110211221,MATH 20E,B01,083773,Staff,5,0,35,30
1651110211221,MATH 20E,B02,083774,Staff,5,1,35,30
1651110217248,MATH 103A,A01,083777,Greenfeld; Be'Eri,0,17,30,30
1651110217248,MATH 103A,A02,083778,Greenfeld; Be'Eri,0,17,30,30
1651110217248,MATH 103A,B01,083779,Greenfeld; Be'Eri,0,15,30,30
1651110217248,MATH 103A,B02,083780,Greenfeld; Be'Eri,0,14,30,30
1651110223272,MATH 105,A01,085443,Staff,0,24,30,30
1651110229298,MATH 109,A01,083213,Ganzberger; Geoffrey Michael,0,8,30,30
1651110229298,MATH 109,A02,083214,Ganzberger; Geoffrey Michael,0,7,30,30
1651110229298,MATH 109,B01,083215,Ganzberger; Geoffrey Michael,0,8,30,30
1651110229298,MATH 109,B02,083216,Ganzberger; Geoffrey Michael,1,8,30,29
1651110235326,MATH 142A,A01,083219,Chow; Bennett,0,15,30,30
1651110235326,MATH 142A,A02,083220,Chow; Bennett,0,15,30,30
1651110235326,MATH 142A,B01,083221,Chow; Bennett,0,16,30,30
1651110235326,MATH 142A,B02,083222,Chow; Bennett,0,16,30,30
1651110241364,MATH 193A,A01,083224,Staff,0,9,30,30
1651110241364,MATH 193A,A02,083225,Staff,1,7,30,29
1651110241364,MATH 193A,A03,083781,Staff,0,7,30,30
1651110241364,MATH 193A,A04,083782,Staff,0,7,30,30
1651110247392,MATH 197,001,091859,McAuley; Julian John,9998,0,9999,1
1651110253444,COGS 9,A01,083615,Staff,0,20,60,60
1651110259467,COGS 11,A01,083617,Boyle; Mary E. T.,13,0,40,27
1651110265496,COGS 13,A01,083071,Staff,0,38,40,40
1651110271522,COGS 14A,A01,092681,Staff,0,40,100,100
1651110277551,COGS 14B,A01,083073,Cheng; Tzu-Han,0,11,50,50
1651110283581,COGS 17,A01,092677,Staff,8,0,75,67
1651110289603,COGS 100,A01,083619,Staff,0,30,60,60
1651110295628,COGS 101A,A01,083621,Davis; Joshua Daniel,0,29,60,60
1651110301650,COGS 101B,A01,091572,Staff,0,9,60,60
1651110307687,COGS 101C,A01,083625,Delgado; Tania,12,0,30,18
1651110313711,COGS 107A,A01,083627,Boyle; Mary E. T.,0,17,60,60
1651110319737,COGS 118A,A01,083075,Staff,0,10,60,60
1651110325770,CSE 3,A50,083646,Miranda; Gregory Joseph,15,0,38,23
1651110325770,CSE 3,A51,083647,Miranda; Gregory Joseph,36,0,37,1
1651110331798,CSE 8A,A50,083650,Miranda; Gregory Joseph,0,30,40,40
1651110337822,CSE 11,A01,083080,Cao; Yingjun,1,99,40,39
1651110343848,CSE 12,A01,083652,Staff,0,29,100,100
1651110349874,CSE 15L,A01,083654,Staff,0,3,50,50
1651110349874,CSE 15L,A02,083655,Staff,0,3,50,50
1651110355896,CSE 20,A01,083657,Staff,46,0,80,34
1651110361921,CSE 30,A01,083084,Eldon; John,0,38,80,80
1651110367947,CSE 100,A01,083659,Cao; Yingjun,0,72,50,50
1651110373971,CSE 134B,A01,083661,Powell; Thomas Allan,0,38,65,65
1651110379994,CSE 140,A01,083663,Staff,0,17,75,75
1651110386021,CSE 140L,A01,083088,Eldon; John,1,0,100,99
1651110392044,CSE 175,A01,083665,Kumar; Rakesh,0,0,25,25
1651110398067,CSE 190,A00,092507,Dubnov; Shlomo,9,0,20,11
1651110404096,ECE 45,A01,083139,Staff,0,8,60,60
1651110410122,ECE 65,A50,083695,Staff,0,7,30,30
1651110416149,ECE 109,A01,091882,Touri; Behrouz,32,0,70,38
1651110422176,ECE 180,A00,083140,Abi Samra; Nicholas Camill,17,0,30,13
1651110422176,ECE 180,B00,083141,Abi Samra; Nicholas Camill,0,1,30,32
1651110428198,MATH 10A,A01,083735,Patchell; Gregory David,0,0,30,30
1651110428198,MATH 10A,A02,083736,Patchell; Gregory David,26,0,30,4
1651110428198,MATH 10A,A03,083737,Patchell; Gregory David,22,0,30,8
1651110434221,MATH 10B,A01,083207,Staff,0,8,30,30
1651110434221,MATH 10B,A02,083208,Staff,0,6,30,30
1651110434221,MATH 10B,B01,083739,Staff,7,0,30,23
1651110434221,MATH 10B,B02,083740,Staff,28,0,30,2
1651110440245,MATH 18,A01,083743,Staff,0,0,30,30
1651110440245,MATH 18,A02,083744,Staff,23,0,30,7
1651110440245,MATH 18,A03,083745,Staff,19,0,30,11
1651110440245,MATH 18,A04,083746,Staff,26,0,30,4
1651110440245,MATH 18,B01,083748,Staff,0,16,30,30
1651110440245,MATH 18,B02,083749,Staff,0,14,30,30
1651110440245,MATH 18,B03,083750,Staff,0,15,30,30
1651110440245,MATH 18,B04,083751,Staff,0,14,30,30
1651110446267,MATH 20A,A01,083754,Staff,18,0,40,22
1651110452302,MATH 20B,A01,083756,Briones; Jor-el Thomas Caparas,0,14,30,30
1651110452302,MATH 20B,A02,083757,Briones; Jor-el Thomas Caparas,0,11,30,30
1651110458324,MATH 20C,A01,083760,Briones; Jor-el Thomas Caparas,1,17,30,29
1651110458324,MATH 20C,A02,083761,Briones; Jor-el Thomas Caparas,0,16,30,30
1651110458324,MATH 20C,B01,083762,Staff,7,0,30,23
1651110458324,MATH 20C,B02,083763,Staff,27,0,30,3
1651110464347,MATH 20D,A01,083765,Tran; Brian Kha,4,1,30,26
1651110464347,MATH 20D,A02,083766,Tran; Brian Kha,0,0,30,30
1651110464347,MATH 20D,A03,083767,Tran; Brian Kha,22,0,30,8
1651110470370,MATH 20E,A01,083771,Staff,0,0,30,30
1651110470370,MATH 20E,A02,083772,Staff,9,0,30,21
1651110470370,MATH 20E,B01,083773,Staff,5,0,35,30
1651110470370,MATH 20E,B02,083774,Staff,5,1,35,30
1651110476392,MATH 103A,A01,083777,Greenfeld; Be'Eri,0,17,30,30
1651110476392,MATH 103A,A02,083778,Greenfeld; Be'Eri,0,17,30,30
1651110476392,MATH 103A,B01,083779,Greenfeld; Be'Eri,0,15,30,30
1651110476392,MATH 103A,B02,083780,Greenfeld; Be'Eri,0,14,30,30
1651110482415,MATH 105,A01,085443,Staff,0,24,30,30
1651110488445,MATH 109,A01,083213,Ganzberger; Geoffrey Michael,0,8,30,30
1651110488445,MATH 109,A02,083214,Ganzberger; Geoffrey Michael,0,7,30,30
1651110488445,MATH 109,B01,083215,Ganzberger; Geoffrey Michael,0,8,30,30
1651110488445,MATH 109,B02,083216,Ganzberger; Geoffrey Michael,1,8,30,29
1651110494474,MATH 142A,A01,083219,Chow; Bennett,0,15,30,30
1651110494474,MATH 142A,A02,083220,Chow; Bennett,0,15,30,30
1651110494474,MATH 142A,B01,083221,Chow; Bennett,0,16,30,30
1651110494474,MATH 142A,B02,083222,Chow; Bennett,0,16,30,30
1651110500498,MATH 193A,A01,083224,Staff,0,9,30,30
1651110500498,MATH 193A,A02,083225,Staff,1,7,30,29
1651110500498,MATH 193A,A03,083781,Staff,0,7,30,30
1651110500498,MATH 193A,A04,083782,Staff,0,7,30,30
1651110506525,MATH 197,001,091859,McAuley; Julian John,9998,0,9999,1
1651110512576,COGS 9,A01,083615,Staff,0,20,60,60
1651110518599,COGS 11,A01,083617,Boyle; Mary E. T.,13,0,40,27
1651110524622,COGS 13,A01,083071,Staff,0,38,40,40
1651110530648,COGS 14A,A01,092681,Staff,0,40,100,100
1651110536684,COGS 14B,A01,083073,Cheng; Tzu-Han,0,11,50,50
1651110542708,COGS 17,A01,092677,Staff,8,0,75,67
1651110548734,COGS 100,A01,083619,Staff,0,30,60,60
1651110554761,COGS 101A,A01,083621,Davis; Joshua Daniel,0,29,60,60
1651110560787,COGS 101B,A01,091572,Staff,0,9,60,60
1651110566813,COGS 101C,A01,083625,Delgado; Tania,12,0,30,18
1651110572844,COGS 107A,A01,083627,Boyle; Mary E. T.,0,17,60,60
1651110578869,COGS 118A,A01,083075,Staff,0,10,60,60
1651110584896,CSE 3,A50,083646,Miranda; Gregory Joseph,15,0,38,23
1651110584896,CSE 3,A51,083647,Miranda; Gregory Joseph,36,0,37,1
1651110590918,CSE 8A,A50,083650,Miranda; Gregory Joseph,0,30,40,40
1651110596941,CSE 11,A01,083080,Cao; Yingjun,1,99,40,39
1651110602966,CSE 12,A01,083652,Staff,0,29,100,100
1651110608991,CSE 15L,A01,083654,Staff,0,3,50,50
1651110608991,CSE 15L,A02,083655,Staff,0,3,50,50
1651110615015,CSE 20,A01,083657,Staff,46,0,80,34
1651110621041,CSE 30,A01,083084,Eldon; John,0,38,80,80
1651110627070,CSE 100,A01,083659,Cao; Yingjun,0,72,50,50
1651110633096,CSE 134B,A01,083661,Powell; Thomas Allan,0,38,65,65
1651110639118,CSE 140,A01,083663,Staff,0,17,75,75
1651110645140,CSE 140L,A01,083088,Eldon; John,1,0,100,99
1651110651165,CSE 175,A01,083665,Kumar; Rakesh,0,0,25,25
1651110657188,CSE 190,A00,092507,Dubnov; Shlomo,9,0,20,11
1651110663223,ECE 45,A01,083139,Staff,0,8,60,60
1651110669333,ECE 65,A50,083695,Staff,0,7,30,30
1651110675357,ECE 109,A01,091882,Touri; Behrouz,32,0,70,38
1651110681385,ECE 180,A00,083140,Abi Samra; Nicholas Camill,17,0,30,13
1651110681385,ECE 180,B00,083141,Abi Samra; Nicholas Camill,0,1,30,32
1651110687419,MATH 10A,A01,083735,Patchell; Gregory David,0,0,30,30
1651110687419,MATH 10A,A02,083736,Patchell; Gregory David,26,0,30,4
1651110687419,MATH 10A,A03,083737,Patchell; Gregory David,22,0,30,8
1651110693443,MATH 10B,A01,083207,Staff,0,8,30,30
1651110693443,MATH 10B,A02,083208,Staff,0,6,30,30
1651110693443,MATH 10B,B01,083739,Staff,7,0,30,23
1651110693443,MATH 10B,B02,083740,Staff,28,0,30,2
1651110699467,MATH 18,A01,083743,Staff,0,0,30,30
1651110699467,MATH 18,A02,083744,Staff,23,0,30,7
1651110699467,MATH 18,A03,083745,Staff,19,0,30,11
1651110699467,MATH 18,A04,083746,Staff,26,0,30,4
1651110699467,MATH 18,B01,083748,Staff,0,16,30,30
1651110699467,MATH 18,B02,083749,Staff,0,15,30,30
1651110699467,MATH 18,B03,083750,Staff,0,15,30,30
1651110699467,MATH 18,B04,083751,Staff,0,14,30,30
1651110705489,MATH 20A,A01,083754,Staff,18,0,40,22
1651110711516,MATH 20B,A01,083756,Briones; Jor-el Thomas Caparas,0,14,30,30
1651110711516,MATH 20B,A02,083757,Briones; Jor-el Thomas Caparas,0,11,30,30
1651110717540,MATH 20C,A01,083760,Briones; Jor-el Thomas Caparas,1,17,30,29
1651110717540,MATH 20C,A02,083761,Briones; Jor-el Thomas Caparas,0,16,30,30
1651110717540,MATH 20C,B01,083762,Staff,7,0,30,23
1651110717540,MATH 20C,B02,083763,Staff,27,0,30,3
1651110723567,MATH 20D,A01,083765,Tran; Brian Kha,4,1,30,26
1651110723567,MATH 20D,A02,083766,Tran; Brian Kha,0,0,30,30
1651110723567,MATH 20D,A03,083767,Tran; Brian Kha,22,0,30,8
1651110729593,MATH 20E,A01,083771,Staff,0,0,30,30
1651110729593,MATH 20E,A02,083772,Staff,9,0,30,21
1651110729593,MATH 20E,B01,083773,Staff,5,0,35,30
1651110729593,MATH 20E,B02,083774,Staff,5,1,35,30
1651110735617,MATH 103A,A01,083777,Greenfeld; Be'Eri,0,17,30,30
1651110735617,MATH 103A,A02,083778,Greenfeld; Be'Eri,0,17,30,30
1651110735617,MATH 103A,B01,083779,Greenfeld; Be'Eri,0,15,30,30
1651110735617,MATH 103A,B02,083780,Greenfeld; Be'Eri,0,14,30,30
1651110741640,MATH 105,A01,085443,Staff,0,24,30,30
1651110747667,MATH 109,A01,083213,Ganzberger; Geoffrey Michael,0,8,30,30
1651110747667,MATH 109,A02,083214,Ganzberger; Geoffrey Michael,0,7,30,30
1651110747667,MATH 109,B01,083215,Ganzberger; Geoffrey Michael,0,8,30,30
1651110747667,MATH 109,B02,083216,Ganzberger; Geoffrey Michael,1,8,30,29
1651110753702,MATH 142A,A01,083219,Chow; Bennett,0,15,30,30
1651110753702,MATH 142A,A02,083220,Chow; Bennett,0,15,30,30
1651110753702,MATH 142A,B01,083221,Chow; Bennett,0,16,30,30
1651110753702,MATH 142A,B02,083222,Chow; Bennett,0,16,30,30
1651110759730,MATH 193A,A01,083224,Staff,0,9,30,30
1651110759730,MATH 193A,A02,083225,Staff,1,7,30,29
1651110759730,MATH 193A,A03,083781,Staff,0,7,30,30
1651110759730,MATH 193A,A04,083782,Staff,0,7,30,30
1651110765757,MATH 197,001,091859,McAuley; Julian John,9998,0,9999,1
1651110771807,COGS 9,A01,083615,Staff,0,20,60,60
1651110777832,COGS 11,A01,083617,Boyle; Mary E. T.,13,0,40,27
1651110783856,COGS 13,A01,083071,Staff,0,38,40,40
1651110789880,COGS 14A,A01,092681,Staff,0,40,100,100
1651110795905,COGS 14B,A01,083073,Cheng; Tzu-Han,0,11,50,50
1651110801931,COGS 17,A01,092677,Staff,8,0,75,67
1651110807956,COGS 100,A01,083619,Staff,0,30,60,60
1651110813985,COGS 101A,A01,083621,Davis; Joshua Daniel,0,29,60,60
1651110820006,COGS 101B,A01,091572,Staff,0,9,60,60
1651110826030,COGS 101C,A01,083625,Delgado; Tania,12,0,30,18
1651110832052,COGS 107A,A01,083627,Boyle; Mary E. T.,0,17,60,60
1651110838080,COGS 118A,A01,083075,Staff,0,10,60,60
1651110844106,CSE 3,A50,083646,Miranda; Gregory Joseph,15,0,38,23
1651110844106,CSE 3,A51,083647,Miranda; Gregory Joseph,36,0,37,1
1651110850135,CSE 8A,A50,083650,Miranda; Gregory Joseph,0,30,40,40
1651110856157,CSE 11,A01,083080,Cao; Yingjun,1,99,40,39
1651110862181,CSE 12,A01,083652,Staff,0,29,100,100
1651110868204,CSE 15L,A01,083654,Staff,0,3,50,50
1651110868204,CSE 15L,A02,083655,Staff,0,3,50,50
1651110874227,CSE 20,A01,083657,Staff,47,0,80,33
1651110880249,CSE 30,A01,083084,Eldon; John,0,38,80,80
1651110886282,CSE 100,A01,083659,Cao; Yingjun,0,72,50,50
1651110892305,CSE 134B,A01,083661,Powell; Thomas Allan,0,38,65,65
1651110898330,CSE 140,A01,083663,Staff,0,17,75,75
1651110904353,CSE 140L,A01,083088,Eldon; John,1,0,100,99
1651110910379,CSE 175,A01,083665,Kumar; Rakesh,0,0,25,25
1651110916403,CSE 190,A00,092507,Dubnov; Shlomo,9,0,20,11
1651110922425,ECE 45,A01,083139,Staff,0,8,60,60
1651110928448,ECE 65,A50,083695,Staff,0,7,30,30
1651110934470,ECE 109,A01,091882,Touri; Behrouz,32,0,70,38
1651110940497,ECE 180,A00,083140,Abi Samra; Nicholas Camill,17,0,30,13
1651110940497,ECE 180,B00,083141,Abi Samra; Nicholas Camill,0,1,30,32
1651110946521,MATH 10A,A01,083735,Patchell; Gregory David,0,0,30,30
1651110946521,MATH 10A,A02,083736,Patchell; Gregory David,26,0,30,4
1651110946521,MATH 10A,A03,083737,Patchell; Gregory David,22,0,30,8
1651110952546,MATH 10B,A01,083207,Staff,0,8,30,30
1651110952546,MATH 10B,A02,083208,Staff,0,6,30,30
1651110952546,MATH 10B,B01,083739,Staff,7,0,30,23
1651110952546,MATH 10B,B02,083740,Staff,28,0,30,2
1651110958589,MATH 18,A01,083743,Staff,0,0,30,30
1651110958589,MATH 18,A02,083744,Staff,23,0,30,7
1651110958589,MATH 18,A03,083745,Staff,19,0,30,11
1651110958589,MATH 18,A04,083746,Staff,26,0,30,4
1651110958589,MATH 18,B01,083748,Staff,0,16,30,30
1651110958589,MATH 18,B02,083749,Staff,0,15,30,30
1651110958589,MATH 18,B03,083750,Staff,0,15,30,30
1651110958589,MATH 18,B04,083751,Staff,0,14,30,30
1651110964611,MATH 20A,A01,083754,Staff,18,0,40,22
1651110970637,MATH 20B,A01,083756,Briones; Jor-el Thomas Caparas,0,14,30,30
1651110970637,MATH 20B,A02,083757,Briones; Jor-el Thomas Caparas,0,11,30,30
1651110976665,MATH 20C,A01,083760,Briones; Jor-el Thomas Caparas,1,17,30,29
1651110976665,MATH 20C,A02,083761,Briones; Jor-el Thomas Caparas,0,16,30,30
1651110976665,MATH 20C,B01,083762,Staff,7,0,30,23
1651110976665,MATH 20C,B02,083763,Staff,27,0,30,3
1651110982692,MATH 20D,A01,083765,Tran; Brian Kha,4,1,30,26
1651110982692,MATH 20D,A02,083766,Tran; Brian Kha,0,0,30,30
1651110982692,MATH 20D,A03,083767,Tran; Brian Kha,22,0,30,8
1651110988718,MATH 20E,A01,083771,Staff,0,0,30,30
1651110988718,MATH 20E,A02,083772,Staff,9,0,30,21
1651110988718,MATH 20E,B01,083773,Staff,5,0,35,30
1651110988718,MATH 20E,B02,083774,Staff,5,1,35,30
1651110994748,MATH 103A,A01,083777,Greenfeld; Be'Eri,0,17,30,30
1651110994748,MATH 103A,A02,083778,Greenfeld; Be'Eri,0,17,30,30
1651110994748,MATH 103A,B01,083779,Greenfeld; Be'Eri,0,15,30,30
1651110994748,MATH 103A,B02,083780,Greenfeld; Be'Eri,0,14,30,30
1651111000773,MATH 105,A01,085443,Staff,0,24,30,30
1651111006796,MATH 109,A01,083213,Ganzberger; Geoffrey Michael,0,8,30,30
1651111006796,MATH 109,A02,083214,Ganzberger; Geoffrey Michael,0,7,30,30
1651111006796,MATH 109,B01,083215,Ganzberger; Geoffrey Michael,0,8,30,30
1651111006796,MATH 109,B02,083216,Ganzberger; Geoffrey Michael,1,8,30,29
1651111012821,MATH 142A,A01,083219,Chow; Bennett,0,15,30,30
1651111012821,MATH 142A,A02,083220,Chow; Bennett,0,15,30,30
1651111012821,MATH 142A,B01,083221,Chow; Bennett,0,16,30,30
1651111012821,MATH 142A,B02,083222,Chow; Bennett,0,16,30,30
1651111018852,MATH 193A,A01,083224,Staff,0,9,30,30
1651111018852,MATH 193A,A02,083225,Staff,1,7,30,29
1651111018852,MATH 193A,A03,083781,Staff,0,7,30,30
1651111018852,MATH 193A,A04,083782,Staff,0,7,30,30
1651111024878,MATH 197,001,091859,McAuley; Julian John,9998,0,9999,1
1651111030938,COGS 9,A01,083615,Staff,0,20,60,60
1651111036962,COGS 11,A01,083617,Boyle; Mary E. T.,13,0,40,27
1651111042989,COGS 13,A01,083071,Staff,0,38,40,40
1651111049012,COGS 14A,A01,092681,Staff,0,40,100,100
1651111055040,COGS 14B,A01,083073,Cheng; Tzu-Han,0,11,50,50
1651111061063,COGS 17,A01,092677,Staff,8,0,75,67
1651111067085,COGS 100,A01,083619,Staff,0,30,60,60
1651111073108,COGS 101A,A01,083621,Davis; Joshua Daniel,0,29,60,60
1651111079134,COGS 101B,A01,091572,Staff,0,9,60,60
1651111085158,COGS 101C,A01,083625,Delgado; Tania,12,0,30,18
1651111091183,COGS 107A,A01,083627,Boyle; Mary E. T.,0,17,60,60
1651111097206,COGS 118A,A01,083075,Staff,0,10,60,60
1651111103235,CSE 3,A50,083646,Miranda; Gregory Joseph,15,0,38,23
1651111103235,CSE 3,A51,083647,Miranda; Gregory Joseph,36,0,37,1
1651111109270,CSE 8A,A50,083650,Miranda; Gregory Joseph,0,30,40,40
1651111115297,CSE 11,A01,083080,Cao; Yingjun,1,99,40,39
1651111121324,CSE 12,A01,083652,Staff,0,29,100,100
1651111127349,CSE 15L,A01,083654,Staff,0,3,50,50
1651111127349,CSE 15L,A02,083655,Staff,0,3,50,50
1651111133373,CSE 20,A01,083657,Staff,47,0,80,33
1651111139394,CSE 30,A01,083084,Eldon; John,0,38,80,80
1651111145417,CSE 100,A01,083659,Cao; Yingjun,0,72,50,50
1651111151439,CSE 134B,A01,083661,Powell; Thomas Allan,0,38,65,65
1651111157461,CSE 140,A01,083663,Staff,0,17,75,75
1651111163489,CSE 140L,A01,083088,Eldon; John,1,0,100,99
1651111169511,CSE 175,A01,083665,Kumar; Rakesh,0,0,25,25
1651111175534,CSE 190,A00,092507,Dubnov; Shlomo,9,0,20,11
1651111181559,ECE 45,A01,083139,Staff,0,8,60,60
1651111187584,ECE 65,A50,083695,Staff,0,7,30,30
1651111193608,ECE 109,A01,091882,Touri; Behrouz,32,0,70,38
1651111199633,ECE 180,A00,083140,Abi Samra; Nicholas Camill,17,0,30,13
1651111199633,ECE 180,B00,083141,Abi Samra; Nicholas Camill,0,1,30,32
1651111205660,MATH 10A,A01,083735,Patchell; Gregory David,0,0,30,30
1651111205660,MATH 10A,A02,083736,Patchell; Gregory David,26,0,30,4
1651111205660,MATH 10A,A03,083737,Patchell; Gregory David,22,0,30,8
1651111211691,MATH 10B,A01,083207,Staff,0,8,30,30
1651111211691,MATH 10B,A02,083208,Staff,0,6,30,30
1651111211691,MATH 10B,B01,083739,Staff,7,0,30,23
1651111211691,MATH 10B,B02,083740,Staff,28,0,30,2
1651111217714,MATH 18,A01,083743,Staff,0,0,30,30
1651111217714,MATH 18,A02,083744,Staff,23,0,30,7
1651111217714,MATH 18,A03,083745,Staff,19,0,30,11
1651111217714,MATH 18,A04,083746,Staff,26,0,30,4
1651111217714,MATH 18,B01,083748,Staff,0,16,30,30
1651111217714,MATH 18,B02,083749,Staff,0,15,30,30
1651111217714,MATH 18,B03,083750,Staff,0,15,30,30
1651111217714,MATH 18,B04,083751,Staff,0,14,30,30
1651111223739,MATH 20A,A01,083754,Staff,18,0,40,22
1651111229766,MATH 20B,A01,083756,Briones; Jor-el Thomas Caparas,0,14,30,30
1651111229766,MATH 20B,A02,083757,Briones; Jor-el Thomas Caparas,0,11,30,30
1651111235796,MATH 20C,A01,083760,Briones; Jor-el Thomas Caparas,1,17,30,29
1651111235796,MATH 20C,A02,083761,Briones; Jor-el Thomas Caparas,0,16,30,30
1651111235796,MATH 20C,B01,083762,Staff,7,0,30,23
1651111235796,MATH 20C,B02,083763,Staff,27,0,30,3
1651111241825,MATH 20D,A01,083765,Tran; Brian Kha,4,1,30,26
1651111241825,MATH 20D,A02,083766,Tran; Brian Kha,0,0,30,30
1651111241825,MATH 20D,A03,083767,Tran; Brian Kha,22,0,30,8
1651111247847,MATH 20E,A01,083771,Staff,0,0,30,30
1651111247847,MATH 20E,A02,083772,Staff,9,0,30,21
1651111247847,MATH 20E,B01,083773,Staff,5,0,35,30
1651111247847,MATH 20E,B02,083774,Staff,5,1,35,30
1651111253871,MATH 103A,A01,083777,Greenfeld; Be'Eri,0,17,30,30
1651111253871,MATH 103A,A02,083778,Greenfeld; Be'Eri,0,17,30,30
1651111253871,MATH 103A,B01,083779,Greenfeld; Be'Eri,0,15,30,30
1651111253871,MATH 103A,B02,083780,Greenfeld; Be'Eri,0,14,30,30
1651111259894,MATH 105,A01,085443,Staff,0,24,30,30
1651111266001,MATH 109,A01,083213,Ganzberger; Geoffrey Michael,0,8,30,30
1651111266001,MATH 109,A02,083214,Ganzberger; Geoffrey Michael,0,7,30,30
1651111266001,MATH 109,B01,083215,Ganzberger; Geoffrey Michael,0,8,30,30
1651111266001,MATH 109,B02,083216,Ganzberger; Geoffrey Michael,1,8,30,29
1651111272027,MATH 142A,A01,083219,Chow; Bennett,0,15,30,30
1651111272027,MATH 142A,A02,083220,Chow; Bennett,0,15,30,30
1651111272027,MATH 142A,B01,083221,Chow; Bennett,0,16,30,30
1651111272027,MATH 142A,B02,083222,Chow; Bennett,0,16,30,30
1651111278054,MATH 193A,A01,083224,Staff,0,9,30,30
1651111278054,MATH 193A,A02,083225,Staff,1,7,30,29
1651111278054,MATH 193A,A03,083781,Staff,0,7,30,30
1651111278054,MATH 193A,A04,083782,Staff,0,7,30,30
1651111284080,MATH 197,001,091859,McAuley; Julian John,9998,0,9999,1
1651111290141,COGS 9,A01,083615,Staff,0,20,60,60
1651111296162,COGS 11,A01,083617,Boyle; Mary E. T.,13,0,40,27
1651111302187,COGS 13,A01,083071,Staff,0,38,40,40
1651111308213,COGS 14A,A01,092681,Staff,0,40,100,100
1651111314238,COGS 14B,A01,083073,Cheng; Tzu-Han,0,11,50,50
1651111320266,COGS 17,A01,092677,Staff,8,0,75,67
1651111326293,COGS 100,A01,083619,Staff,0,30,60,60
1651111332319,COGS 101A,A01,083621,Davis; Joshua Daniel,0,29,60,60
1651111338343,COGS 101B,A01,091572,Staff,0,9,60,60
1651111344367,COGS 101C,A01,083625,Delgado; Tania,12,0,30,18
1651111350390,COGS 107A,A01,083627,Boyle; Mary E. T.,0,17,60,60
1651111356416,COGS 118A,A01,083075,Staff,0,10,60,60
1651111362443,CSE 3,A50,083646,Miranda; Gregory Joseph,15,0,38,23
1651111362443,CSE 3,A51,083647,Miranda; Gregory Joseph,36,0,37,1
1651111368469,CSE 8A,A50,083650,Miranda; Gregory Joseph,0,30,40,40
1651111374493,CSE 11,A01,083080,Cao; Yingjun,1,99,40,39
1651111380526,CSE 12,A01,083652,Staff,0,29,100,100
1651111386556,CSE 15L,A01,083654,Staff,0,3,50,50
1651111386556,CSE 15L,A02,083655,Staff,0,3,50,50
1651111392585,CSE 20,A01,083657,Staff,47,0,80,33
1651111398608,CSE 30,A01,083084,Eldon; John,0,38,80,80
1651111404631,CSE 100,A01,083659,Cao; Yingjun,0,72,50,50
1651111410665,CSE 134B,A01,083661,Powell; Thomas Allan,0,38,65,65
1651111416688,CSE 140,A01,083663,Staff,0,17,75,75
1651111422712,CSE 140L,A01,083088,Eldon; John,1,0,100,99
1651111428739,CSE 175,A01,083665,Kumar; Rakesh,0,0,25,25
1651111434765,CSE 190,A00,092507,Dubnov; Shlomo,9,0,20,11
1651111440788,ECE 45,A01,083139,Staff,0,8,60,60
1651111446815,ECE 65,A50,083695,Staff,0,7,30,30
1651111452839,ECE 109,A01,091882,Touri; Behrouz,32,0,70,38
1651111458863,ECE 180,A00,083140,Abi Samra; Nicholas Camill,17,0,30,13
1651111458863,ECE 180,B00,083141,Abi Samra; Nicholas Camill,0,1,30,32
1651111464891,MATH 10A,A01,083735,Patchell; Gregory David,0,0,30,30
1651111464891,MATH 10A,A02,083736,Patchell; Gregory David,26,0,30,4
1651111464891,MATH 10A,A03,083737,Patchell; Gregory David,22,0,30,8
1651111470918,MATH 10B,A01,083207,Staff,0,8,30,30
1651111470918,MATH 10B,A02,083208,Staff,0,6,30,30
1651111470918,MATH 10B,B01,083739,Staff,7,0,30,23
1651111470918,MATH 10B,B02,083740,Staff,28,0,30,2
1651111476952,MATH 18,A01,083743,Staff,0,0,30,30
1651111476952,MATH 18,A02,083744,Staff,23,0,30,7
1651111476952,MATH 18,A03,083745,Staff,19,0,30,11
1651111476952,MATH 18,A04,083746,Staff,26,0,30,4
1651111476952,MATH 18,B01,083748,Staff,0,16,30,30
1651111476952,MATH 18,B02,083749,Staff,0,15,30,30
1651111476952,MATH 18,B03,083750,Staff,0,15,30,30
1651111476952,MATH 18,B04,083751,Staff,0,14,30,30
1651111482983,MATH 20A,A01,083754,Staff,18,0,40,22
1651111489011,MATH 20B,A01,083756,Briones; Jor-el Thomas Caparas,0,14,30,30
1651111489011,MATH 20B,A02,083757,Briones; Jor-el Thomas Caparas,0,11,30,30
1651111495036,MATH 20C,A01,083760,Briones; Jor-el Thomas Caparas,1,17,30,29
1651111495036,MATH 20C,A02,083761,Briones; Jor-el Thomas Caparas,0,16,30,30
1651111495036,MATH 20C,B01,083762,Staff,7,0,30,23
1651111495036,MATH 20C,B02,083763,Staff,27,0,30,3
1651111501070,MATH 20D,A01,083765,Tran; Brian Kha,4,1,30,26
1651111501070,MATH 20D,A02,083766,Tran; Brian Kha,0,0,30,30
1651111501070,MATH 20D,A03,083767,Tran; Brian Kha,22,0,30,8
1651111507096,MATH 20E,A01,083771,Staff,0,0,30,30
1651111507096,MATH 20E,A02,083772,Staff,9,0,30,21
1651111507096,MATH 20E,B01,083773,Staff,5,0,35,30
1651111507096,MATH 20E,B02,083774,Staff,5,1,35,30
1651111513125,MATH 103A,A01,083777,Greenfeld; Be'Eri,0,17,30,30
1651111513125,MATH 103A,A02,083778,Greenfeld; Be'Eri,0,17,30,30
1651111513125,MATH 103A,B01,083779,Greenfeld; Be'Eri,0,15,30,30
1651111513125,MATH 103A,B02,083780,Greenfeld; Be'Eri,0,14,30,30
1651111519148,MATH 105,A01,085443,Staff,0,24,30,30
1651111525172,MATH 109,A01,083213,Ganzberger; Geoffrey Michael,0,8,30,30
1651111525172,MATH 109,A02,083214,Ganzberger; Geoffrey Michael,0,7,30,30
1651111525172,MATH 109,B01,083215,Ganzberger; Geoffrey Michael,0,8,30,30
1651111525172,MATH 109,B02,083216,Ganzberger; Geoffrey Michael,1,8,30,29
1651111531194,MATH 142A,A01,083219,Chow; Bennett,0,15,30,30
1651111531194,MATH 142A,A02,083220,Chow; Bennett,0,15,30,30
1651111531194,MATH 142A,B01,083221,Chow; Bennett,0,16,30,30
1651111531194,MATH 142A,B02,083222,Chow; Bennett,0,16,30,30
1651111537221,MATH 193A,A01,083224,Staff,0,9,30,30
1651111537221,MATH 193A,A02,083225,Staff,1,7,30,29
1651111537221,MATH 193A,A03,083781,Staff,0,7,30,30
1651111537221,MATH 193A,A04,083782,Staff,0,7,30,30
1651111543256,MATH 197,001,091859,McAuley; Julian John,9998,0,9999,1
1651111549307,COGS 9,A01,083615,Staff,0,20,60,60
1651111555330,COGS 11,A01,083617,Boyle; Mary E. T.,13,0,40,27
1651111561357,COGS 13,A01,083071,Staff,0,38,40,40
1651111567398,COGS 14A,A01,092681,Staff,0,40,100,100
1651111573425,COGS 14B,A01,083073,Cheng; Tzu-Han,0,11,50,50
1651111579447,COGS 17,A01,092677,Staff,8,0,75,67
1651111585469,COGS 100,A01,083619,Staff,0,30,60,60
1651111591491,COGS 101A,A01,083621,Davis; Joshua Daniel,0,29,60,60
1651111597525,COGS 101B,A01,091572,Staff,0,9,60,60
1651111603548,COGS 101C,A01,083625,Delgado; Tania,12,0,30,18
1651111609572,COGS 107A,A01,083627,Boyle; Mary E. T.,0,17,60,60
1651111615605,COGS 118A,A01,083075,Staff,0,10,60,60
1651111621631,CSE 3,A50,083646,Miranda; Gregory Joseph,15,0,38,23
1651111621631,CSE 3,A51,083647,Miranda; Gregory Joseph,36,0,37,1
1651111627654,CSE 8A,A50,083650,Miranda; Gregory Joseph,0,30,40,40
1651111633676,CSE 11,A01,083080,Cao; Yingjun,1,99,40,39
1651111639700,CSE 12,A01,083652,Staff,0,29,100,100
1651111645731,CSE 15L,A01,083654,Staff,0,3,50,50
1651111645731,CSE 15L,A02,083655,Staff,0,3,50,50
1651111651757,CSE 20,A01,083657,Staff,47,0,80,33
1651111657780,CSE 30,A01,083084,Eldon; John,0,38,80,80
1651111663811,CSE 100,A01,083659,Cao; Yingjun,0,72,50,50
1651111669836,CSE 134B,A01,083661,Powell; Thomas Allan,0,38,65,65
1651111675861,CSE 140,A01,083663,Staff,0,17,75,75
1651111681886,CSE 140L,A01,083088,Eldon; John,1,0,100,99
1651111687911,CSE 175,A01,083665,Kumar; Rakesh,0,0,25,25
1651111693942,CSE 190,A00,092507,Dubnov; Shlomo,9,0,20,11
1651111699965,ECE 45,A01,083139,Staff,0,8,60,60
1651111705995,ECE 65,A50,083695,Staff,0,7,30,30
1651111712016,ECE 109,A01,091882,Touri; Behrouz,32,0,70,38
1651111718040,ECE 180,A00,083140,Abi Samra; Nicholas Camill,17,0,30,13
1651111718040,ECE 180,B00,083141,Abi Samra; Nicholas Camill,0,1,30,32
1651111724070,MATH 10A,A01,083735,Patchell; Gregory David,0,0,30,30
1651111724070,MATH 10A,A02,083736,Patchell; Gregory David,26,0,30,4
1651111724070,MATH 10A,A03,083737,Patchell; Gregory David,22,0,30,8
1651111730093,MATH 10B,A01,083207,Staff,0,8,30,30
1651111730093,MATH 10B,A02,083208,Staff,0,6,30,30
1651111730093,MATH 10B,B01,083739,Staff,7,0,30,23
1651111730093,MATH 10B,B02,083740,Staff,28,0,30,2
1651111736122,MATH 18,A01,083743,Staff,0,0,30,30
1651111736122,MATH 18,A02,083744,Staff,23,0,30,7
1651111736122,MATH 18,A03,083745,Staff,19,0,30,11
1651111736122,MATH 18,A04,083746,Staff,26,0,30,4
1651111736122,MATH 18,B01,083748,Staff,0,16,30,30
1651111736122,MATH 18,B02,083749,Staff,0,15,30,30
1651111736122,MATH 18,B03,083750,Staff,0,15,30,30
1651111736122,MATH 18,B04,083751,Staff,0,14,30,30
1651111742153,MATH 20A,A01,083754,Staff,18,0,40,22
1651111748177,MATH 20B,A01,083756,Briones; Jor-el Thomas Caparas,0,14,30,30
1651111748177,MATH 20B,A02,083757,Briones; Jor-el Thomas Caparas,0,11,30,30
1651111754199,MATH 20C,A01,083760,Briones; Jor-el Thomas Caparas,1,17,30,29
1651111754199,MATH 20C,A02,083761,Briones; Jor-el Thomas Caparas,0,16,30,30
1651111754199,MATH 20C,B01,083762,Staff,7,0,30,23
1651111754199,MATH 20C,B02,083763,Staff,27,0,30,3
1651111760227,MATH 20D,A01,083765,Tran; Brian Kha,4,1,30,26
1651111760227,MATH 20D,A02,083766,Tran; Brian Kha,0,0,30,30
1651111760227,MATH 20D,A03,083767,Tran; Brian Kha,22,0,30,8
1651111766250,MATH 20E,A01,083771,Staff,0,0,30,30
1651111766250,MATH 20E,A02,083772,Staff,9,0,30,21
1651111766250,MATH 20E,B01,083773,Staff,5,0,35,30
1651111766250,MATH 20E,B02,083774,Staff,5,1,35,30
1651111772273,MATH 103A,A01,083777,Greenfeld; Be'Eri,0,17,30,30
1651111772273,MATH 103A,A02,083778,Greenfeld; Be'Eri,0,17,30,30
1651111772273,MATH 103A,B01,083779,Greenfeld; Be'Eri,0,15,30,30
1651111772273,MATH 103A,B02,083780,Greenfeld; Be'Eri,0,14,30,30
1651111778296,MATH 105,A01,085443,Staff,0,24,30,30
1651111784318,MATH 109,A01,083213,Ganzberger; Geoffrey Michael,0,8,30,30
1651111784318,MATH 109,A02,083214,Ganzberger; Geoffrey Michael,0,7,30,30
1651111784318,MATH 109,B01,083215,Ganzberger; Geoffrey Michael,0,8,30,30
1651111784318,MATH 109,B02,083216,Ganzberger; Geoffrey Michael,1,8,30,29
1651111790346,MATH 142A,A01,083219,Chow; Bennett,0,15,30,30
1651111790346,MATH 142A,A02,083220,Chow; Bennett,0,15,30,30
1651111790346,MATH 142A,B01,083221,Chow; Bennett,0,16,30,30
1651111790346,MATH 142A,B02,083222,Chow; Bennett,0,16,30,30
1651111796370,MATH 193A,A01,083224,Staff,0,9,30,30
1651111796370,MATH 193A,A02,083225,Staff,1,7,30,29
1651111796370,MATH 193A,A03,083781,Staff,0,7,30,30
1651111796370,MATH 193A,A04,083782,Staff,0,7,30,30
1651111802392,MATH 197,001,091859,McAuley; Julian John,9998,0,9999,1
1651111808450,COGS 9,A01,083615,Staff,0,20,60,60
1651111814477,COGS 11,A01,083617,Boyle; Mary E. T.,13,0,40,27
1651111820499,COGS 13,A01,083071,Staff,0,38,40,40
1651111826525,COGS 14A,A01,092681,Staff,0,40,100,100
1651111832546,COGS 14B,A01,083073,Cheng; Tzu-Han,0,11,50,50
1651111838568,COGS 17,A01,092677,Staff,8,0,75,67
1651111844590,COGS 100,A01,083619,Staff,0,30,60,60
1651111850610,COGS 101A,A01,083621,Davis; Joshua Daniel,0,29,60,60
1651111856724,COGS 101B,A01,091572,Staff,0,9,60,60
1651111862754,COGS 101C,A01,083625,Delgado; Tania,12,0,30,18
1651111868776,COGS 107A,A01,083627,Boyle; Mary E. T.,0,17,60,60
1651111874802,COGS 118A,A01,083075,Staff,0,10,60,60
1651111880842,CSE 3,A50,083646,Miranda; Gregory Joseph,15,0,38,23
1651111880842,CSE 3,A51,083647,Miranda; Gregory Joseph,36,0,37,1
1651111886873,CSE 8A,A50,083650,Miranda; Gregory Joseph,0,30,40,40
1651111892908,CSE 11,A01,083080,Cao; Yingjun,1,99,40,39
1651111898931,CSE 12,A01,083652,Staff,0,29,100,100
1651111904955,CSE 15L,A01,083654,Staff,0,3,50,50
1651111904955,CSE 15L,A02,083655,Staff,0,3,50,50
1651111910979,CSE 20,A01,083657,Staff,47,0,80,33
1651111917010,CSE 30,A01,083084,Eldon; John,0,38,80,80
1651111923034,CSE 100,A01,083659,Cao; Yingjun,0,72,50,50
1651111929060,CSE 134B,A01,083661,Powell; Thomas Allan,0,38,65,65
1651111935082,CSE 140,A01,083663,Staff,0,17,75,75
1651111941107,CSE 140L,A01,083088,Eldon; John,1,0,100,99
1651111947130,CSE 175,A01,083665,Kumar; Rakesh,0,0,25,25
1651111953158,CSE 190,A00,092507,Dubnov; Shlomo,9,0,20,11
1651111959182,ECE 45,A01,083139,Staff,0,8,60,60
1651111965204,ECE 65,A50,083695,Staff,0,7,30,30
1651111971227,ECE 109,A01,091882,Touri; Behrouz,32,0,70,38
1651111977258,ECE 180,A00,083140,Abi Samra; Nicholas Camill,17,0,30,13
1651111977258,ECE 180,B00,083141,Abi Samra; Nicholas Camill,0,1,30,32
1651111983282,MATH 10A,A01,083735,Patchell; Gregory David,0,0,30,30
1651111983282,MATH 10A,A02,083736,Patchell; Gregory David,26,0,30,4
1651111983282,MATH 10A,A03,083737,Patchell; Gregory David,22,0,30,8
1651111989304,MATH 10B,A01,083207,Staff,0,8,30,30
1651111989304,MATH 10B,A02,083208,Staff,0,6,30,30
1651111989304,MATH 10B,B01,083739,Staff,7,0,30,23
1651111989304,MATH 10B,B02,083740,Staff,28,0,30,2
1651111995334,MATH 18,A01,083743,Staff,0,0,30,30
1651111995334,MATH 18,A02,083744,Staff,23,0,30,7
1651111995334,MATH 18,A03,083745,Staff,19,0,30,11
1651111995334,MATH 18,A04,083746,Staff,26,0,30,4
1651111995334,MATH 18,B01,083748,Staff,0,16,30,30
1651111995334,MATH 18,B02,083749,Staff,0,15,30,30
1651111995334,MATH 18,B03,083750,Staff,0,15,30,30
1651111995334,MATH 18,B04,083751,Staff,0,14,30,30
1651112001357,MATH 20A,A01,083754,Staff,18,0,40,22
1651112007381,MATH 20B,A01,083756,Briones; Jor-el Thomas Caparas,0,14,30,30
1651112007381,MATH 20B,A02,083757,Briones; Jor-el Thomas Caparas,0,11,30,30
1651112013405,MATH 20C,A01,083760,Briones; Jor-el Thomas Caparas,1,17,30,29
1651112013405,MATH 20C,A02,083761,Briones; Jor-el Thomas Caparas,0,16,30,30
1651112013405,MATH 20C,B01,083762,Staff,7,0,30,23
1651112013405,MATH 20C,B02,083763,Staff,27,0,30,3
1651112019430,MATH 20D,A01,083765,Tran; Brian Kha,4,1,30,26
1651112019430,MATH 20D,A02,083766,Tran; Brian Kha,0,0,30,30
1651112019430,MATH 20D,A03,083767,Tran; Brian Kha,22,0,30,8
1651112025452,MATH 20E,A01,083771,Staff,0,0,30,30
1651112025452,MATH 20E,A02,083772,Staff,9,0,30,21
1651112025452,MATH 20E,B01,083773,Staff,5,0,35,30
1651112025452,MATH 20E,B02,083774,Staff,5,1,35,30
1651112031482,MATH 103A,A01,083777,Greenfeld; Be'Eri,0,17,30,30
1651112031482,MATH 103A,A02,083778,Greenfeld; Be'Eri,0,17,30,30
1651112031482,MATH 103A,B01,083779,Greenfeld; Be'Eri,0,15,30,30
1651112031482,MATH 103A,B02,083780,Greenfeld; Be'Eri,0,14,30,30
1651112037506,MATH 105,A01,085443,Staff,0,24,30,30
1651112043532,MATH 109,A01,083213,Ganzberger; Geoffrey Michael,0,8,30,30
1651112043532,MATH 109,A02,083214,Ganzberger; Geoffrey Michael,0,7,30,30
1651112043532,MATH 109,B01,083215,Ganzberger; Geoffrey Michael,0,8,30,30
1651112043532,MATH 109,B02,083216,Ganzberger; Geoffrey Michael,1,8,30,29
1651112049561,MATH 142A,A01,083219,Chow; Bennett,0,15,30,30
1651112049561,MATH 142A,A02,083220,Chow; Bennett,0,15,30,30
1651112049561,MATH 142A,B01,083221,Chow; Bennett,0,16,30,30
1651112049561,MATH 142A,B02,083222,Chow; Bennett,0,16,30,30
1651112055585,MATH 193A,A01,083224,Staff,0,9,30,30
1651112055585,MATH 193A,A02,083225,Staff,1,7,30,29
1651112055585,MATH 193A,A03,083781,Staff,0,7,30,30
1651112055585,MATH 193A,A04,083782,Staff,0,7,30,30
1651112061609,MATH 197,001,091859,McAuley; Julian John,9998,0,9999,1
1651112067666,COGS 9,A01,083615,Staff,0,20,60,60
1651112073689,COGS 11,A01,083617,Boyle; Mary E. T.,13,0,40,27
1651112079711,COGS 13,A01,083071,Staff,0,38,40,40
1651112085734,COGS 14A,A01,092681,Staff,0,40,100,100
1651112091764,COGS 14B,A01,083073,Cheng; Tzu-Han,0,11,50,50
1651112097789,COGS 17,A01,092677,Staff,8,0,75,67
1651112103817,COGS 100,A01,083619,Staff,0,30,60,60
1651112109839,COGS 101A,A01,083621,Davis; Joshua Daniel,0,29,60,60
1651112115862,COGS 101B,A01,091572,Staff,0,9,60,60
1651112121883,COGS 101C,A01,083625,Delgado; Tania,12,0,30,18
1651112127905,COGS 107A,A01,083627,Boyle; Mary E. T.,0,17,60,60
1651112133929,COGS 118A,A01,083075,Staff,0,10,60,60
1651112139956,CSE 3,A50,083646,Miranda; Gregory Joseph,15,0,38,23
1651112139956,CSE 3,A51,083647,Miranda; Gregory Joseph,36,0,37,1
1651112145984,CSE 8A,A50,083650,Miranda; Gregory Joseph,0,30,40,40
1651112152013,CSE 11,A01,083080,Cao; Yingjun,1,99,40,39
1651112158037,CSE 12,A01,083652,Staff,0,29,100,100
1651112164068,CSE 15L,A01,083654,Staff,0,3,50,50
1651112164068,CSE 15L,A02,083655,Staff,0,3,50,50
1651112170095,CSE 20,A01,083657,Staff,47,0,80,33
1651112176118,CSE 30,A01,083084,Eldon; John,0,38,80,80
1651112182141,CSE 100,A01,083659,Cao; Yingjun,0,72,50,50
1651112188167,CSE 134B,A01,083661,Powell; Thomas Allan,0,38,65,65
1651112194190,CSE 140,A01,083663,Staff,0,17,75,75
1651112200216,CSE 140L,A01,083088,Eldon; John,1,0,100,99
1651112206242,CSE 175,A01,083665,Kumar; Rakesh,0,0,25,25
1651112212264,CSE 190,A00,092507,Dubnov; Shlomo,9,0,20,11
1651112218296,ECE 45,A01,083139,Staff,0,8,60,60
1651112224320,ECE 65,A50,083695,Staff,0,7,30,30
1651112230347,ECE 109,A01,091882,Touri; Behrouz,32,0,70,38
1651112236370,ECE 180,A00,083140,Abi Samra; Nicholas Camill,17,0,30,13
1651112236370,ECE 180,B00,083141,Abi Samra; Nicholas Camill,0,1,30,32
1651112242396,MATH 10A,A01,083735,Patchell; Gregory David,0,0,30,30
1651112242396,MATH 10A,A02,083736,Patchell; Gregory David,26,0,30,4
1651112242396,MATH 10A,A03,083737,Patchell; Gregory David,22,0,30,8
1651112248420,MATH 10B,A01,083207,Staff,0,8,30,30
1651112248420,MATH 10B,A02,083208,Staff,0,6,30,30
1651112248420,MATH 10B,B01,083739,Staff,7,0,30,23
1651112248420,MATH 10B,B02,083740,Staff,28,0,30,2
1651112254457,MATH 18,A01,083743,Staff,0,0,30,30
1651112254457,MATH 18,A02,083744,Staff,23,0,30,7
1651112254457,MATH 18,A03,083745,Staff,19,0,30,11
1651112254457,MATH 18,A04,083746,Staff,26,0,30,4
1651112254457,MATH 18,B01,083748,Staff,0,16,30,30
1651112254457,MATH 18,B02,083749,Staff,0,15,30,30
1651112254457,MATH 18,B03,083750,Staff,0,15,30,30
1651112254457,MATH 18,B04,083751,Staff,0,14,30,30
1651112260481,MATH 20A,A01,083754,Staff,18,0,40,22
1651112266502,MATH 20B,A01,083756,Briones; Jor-el Thomas Caparas,0,14,30,30
1651112266502,MATH 20B,A02,083757,Briones; Jor-el Thomas Caparas,0,11,30,30
1651112272524,MATH 20C,A01,083760,Briones; Jor-el Thomas Caparas,1,17,30,29
1651112272524,MATH 20C,A02,083761,Briones; Jor-el Thomas Caparas,0,16,30,30
1651112272524,MATH 20C,B01,083762,Staff,7,0,30,23
1651112272524,MATH 20C,B02,083763,Staff,27,0,30,3
1651112278547,MATH 20D,A01,083765,Tran; Brian Kha,4,1,30,26
1651112278547,MATH 20D,A02,083766,Tran; Brian Kha,0,0,30,30
1651112278547,MATH 20D,A03,083767,Tran; Brian Kha,22,0,30,8
1651112284572,MATH 20E,A01,083771,Staff,0,0,30,30
1651112284572,MATH 20E,A02,083772,Staff,9,0,30,21
1651112284572,MATH 20E,B01,083773,Staff,5,0,35,30
1651112284572,MATH 20E,B02,083774,Staff,5,1,35,30
1651112290597,MATH 103A,A01,083777,Greenfeld; Be'Eri,0,17,30,30
1651112290597,MATH 103A,A02,083778,Greenfeld; Be'Eri,0,17,30,30
1651112290597,MATH 103A,B01,083779,Greenfeld; Be'Eri,0,15,30,30
1651112290597,MATH 103A,B02,083780,Greenfeld; Be'Eri,0,14,30,30
1651112296627,MATH 105,A01,085443,Staff,0,24,30,30
1651112302654,MATH 109,A01,083213,Ganzberger; Geoffrey Michael,0,8,30,30
1651112302654,MATH 109,A02,083214,Ganzberger; Geoffrey Michael,0,7,30,30
1651112302654,MATH 109,B01,083215,Ganzberger; Geoffrey Michael,0,8,30,30
1651112302654,MATH 109,B02,083216,Ganzberger; Geoffrey Michael,1,8,30,29
1651112308679,MATH 142A,A01,083219,Chow; Bennett,0,15,30,30
1651112308679,MATH 142A,A02,083220,Chow; Bennett,0,15,30,30
1651112308679,MATH 142A,B01,083221,Chow; Bennett,0,16,30,30
1651112308679,MATH 142A,B02,083222,Chow; Bennett,0,16,30,30
1651112314704,MATH 193A,A01,083224,Staff,0,9,30,30
1651112314704,MATH 193A,A02,083225,Staff,1,7,30,29
1651112314704,MATH 193A,A03,083781,Staff,0,7,30,30
1651112314704,MATH 193A,A04,083782,Staff,0,7,30,30
1651112320726,MATH 197,001,091859,McAuley; Julian John,9998,0,9999,1
1651112326779,COGS 9,A01,083615,Staff,0,20,60,60
1651112332801,COGS 11,A01,083617,Boyle; Mary E. T.,13,0,40,27
1651112338824,COGS 13,A01,083071,Staff,0,38,40,40
1651112344850,COGS 14A,A01,092681,Staff,0,40,100,100
1651112350875,COGS 14B,A01,083073,Cheng; Tzu-Han,0,11,50,50
1651112356900,COGS 17,A01,092677,Staff,8,0,75,67
1651112362938,COGS 100,A01,083619,Staff,0,30,60,60
1651112368968,COGS 101A,A01,083621,Davis; Joshua Daniel,0,29,60,60
1651112374996,COGS 101B,A01,091572,Staff,0,9,60,60
1651112381019,COGS 101C,A01,083625,Delgado; Tania,12,0,30,18
1651112387045,COGS 107A,A01,083627,Boyle; Mary E. T.,0,17,60,60
1651112393071,COGS 118A,A01,083075,Staff,0,10,60,60
1651112399095,CSE 3,A50,083646,Miranda; Gregory Joseph,15,0,38,23
1651112399095,CSE 3,A51,083647,Miranda; Gregory Joseph,36,0,37,1
1651112405119,CSE 8A,A50,083650,Miranda; Gregory Joseph,0,30,40,40
1651112411142,CSE 11,A01,083080,Cao; Yingjun,1,99,40,39
1651112417168,CSE 12,A01,083652,Staff,0,29,100,100
1651112423195,CSE 15L,A01,083654,Staff,0,3,50,50
1651112423195,CSE 15L,A02,083655,Staff,0,3,50,50
1651112429221,CSE 20,A01,083657,Staff,47,0,80,33
1651112435245,CSE 30,A01,083084,Eldon; John,0,38,80,80
1651112441273,CSE 100,A01,083659,Cao; Yingjun,0,72,50,50
1651112447298,CSE 134B,A01,083661,Powell; Thomas Allan,0,38,65,65
1651112453412,CSE 140,A01,083663,Staff,0,17,75,75
1651112459438,CSE 140L,A01,083088,Eldon; John,1,0,100,99
1651112465472,CSE 175,A01,083665,Kumar; Rakesh,0,0,25,25
1651112471500,CSE 190,A00,092507,Dubnov; Shlomo,9,0,20,11
1651112477528,ECE 45,A01,083139,Staff,0,8,60,60
1651112483558,ECE 65,A50,083695,Staff,0,7,30,30
1651112489581,ECE 109,A01,091882,Touri; Behrouz,32,0,70,38
1651112495604,ECE 180,A00,083140,Abi Samra; Nicholas Camill,17,0,30,13
1651112495604,ECE 180,B00,083141,Abi Samra; Nicholas Camill,0,1,30,32
1651112501626,MATH 10A,A01,083735,Patchell; Gregory David,0,0,30,30
1651112501626,MATH 10A,A02,083736,Patchell; Gregory David,26,0,30,4
1651112501626,MATH 10A,A03,083737,Patchell; Gregory David,22,0,30,8
1651112507649,MATH 10B,A01,083207,Staff,0,8,30,30
1651112507649,MATH 10B,A02,083208,Staff,0,6,30,30
1651112507649,MATH 10B,B01,083739,Staff,7,0,30,23
1651112507649,MATH 10B,B02,083740,Staff,28,0,30,2
1651112513674,MATH 18,A01,083743,Staff,0,0,30,30
1651112513674,MATH 18,A02,083744,Staff,23,0,30,7
1651112513674,MATH 18,A03,083745,Staff,19,0,30,11
1651112513674,MATH 18,A04,083746,Staff,26,0,30,4
1651112513674,MATH 18,B01,083748,Staff,0,16,30,30
1651112513674,MATH 18,B02,083749,Staff,0,15,30,30
1651112513674,MATH 18,B03,083750,Staff,0,15,30,30
1651112513674,MATH 18,B04,083751,Staff,0,14,30,30
1651112519700,MATH 20A,A01,083754,Staff,18,0,40,22
1651112525728,MATH 20B,A01,083756,Briones; Jor-el Thomas Caparas,0,14,30,30
1651112525728,MATH 20B,A02,083757,Briones; Jor-el Thomas Caparas,0,11,30,30
1651112531764,MATH 20C,A01,083760,Briones; Jor-el Thomas Caparas,1,17,30,29
1651112531764,MATH 20C,A02,083761,Briones; Jor-el Thomas Caparas,0,16,30,30
1651112531764,MATH 20C,B01,083762,Staff,7,0,30,23
1651112531764,MATH 20C,B02,083763,Staff,27,0,30,3
1651112537786,MATH 20D,A01,083765,Tran; Brian Kha,4,1,30,26
1651112537786,MATH 20D,A02,083766,Tran; Brian Kha,0,0,30,30
1651112537786,MATH 20D,A03,083767,Tran; Brian Kha,22,0,30,8
1651112543814,MATH 20E,A01,083771,Staff,0,0,30,30
1651112543814,MATH 20E,A02,083772,Staff,9,0,30,21
1651112543814,MATH 20E,B01,083773,Staff,5,0,35,30
1651112543814,MATH 20E,B02,083774,Staff,5,1,35,30
1651112549837,MATH 103A,A01,083777,Greenfeld; Be'Eri,0,17,30,30
1651112549837,MATH 103A,A02,083778,Greenfeld; Be'Eri,0,17,30,30
1651112549837,MATH 103A,B01,083779,Greenfeld; Be'Eri,0,15,30,30
1651112549837,MATH 103A,B02,083780,Greenfeld; Be'Eri,0,14,30,30
1651112555860,MATH 105,A01,085443,Staff,0,24,30,30
1651112561891,MATH 109,A01,083213,Ganzberger; Geoffrey Michael,0,8,30,30
1651112561891,MATH 109,A02,083214,Ganzberger; Geoffrey Michael,0,7,30,30
1651112561891,MATH 109,B01,083215,Ganzberger; Geoffrey Michael,0,8,30,30
1651112561891,MATH 109,B02,083216,Ganzberger; Geoffrey Michael,1,8,30,29
1651112567922,MATH 142A,A01,083219,Chow; Bennett,0,15,30,30
1651112567922,MATH 142A,A02,083220,Chow; Bennett,0,15,30,30
1651112567922,MATH 142A,B01,083221,Chow; Bennett,0,16,30,30
1651112567922,MATH 142A,B02,083222,Chow; Bennett,0,16,30,30
1651112573949,MATH 193A,A01,083224,Staff,0,9,30,30
1651112573949,MATH 193A,A02,083225,Staff,1,7,30,29
1651112573949,MATH 193A,A03,083781,Staff,0,7,30,30
1651112573949,MATH 193A,A04,083782,Staff,0,7,30,30
1651112579972,MATH 197,001,091859,McAuley; Julian John,9998,0,9999,1
1651112586048,COGS 9,A01,083615,Staff,0,20,60,60
1651112592070,COGS 11,A01,083617,Boyle; Mary E. T.,13,0,40,27
1651112598101,COGS 13,A01,083071,Staff,0,38,40,40
1651112604128,COGS 14A,A01,092681,Staff,0,40,100,100
1651112610154,COGS 14B,A01,083073,Cheng; Tzu-Han,0,11,50,50
1651112616180,COGS 17,A01,092677,Staff,8,0,75,67
1651112622205,COGS 100,A01,083619,Staff,0,30,60,60
1651112628228,COGS 101A,A01,083621,Davis; Joshua Daniel,0,29,60,60
1651112634255,COGS 101B,A01,091572,Staff,0,9,60,60
1651112640288,COGS 101C,A01,083625,Delgado; Tania,12,0,30,18
1651112646329,COGS 107A,A01,083627,Boyle; Mary E. T.,0,17,60,60
1651112652354,COGS 118A,A01,083075,Staff,0,10,60,60
1651112658382,CSE 3,A50,083646,Miranda; Gregory Joseph,15,0,38,23
1651112658382,CSE 3,A51,083647,Miranda; Gregory Joseph,36,0,37,1
1651112664405,CSE 8A,A50,083650,Miranda; Gregory Joseph,0,30,40,40
1651112670431,CSE 11,A01,083080,Cao; Yingjun,1,99,40,39
1651112676456,CSE 12,A01,083652,Staff,0,29,100,100
1651112682485,CSE 15L,A01,083654,Staff,0,3,50,50
1651112682485,CSE 15L,A02,083655,Staff,0,3,50,50
1651112688510,CSE 20,A01,083657,Staff,47,0,80,33
1651112694532,CSE 30,A01,083084,Eldon; John,0,38,80,80
1651112700563,CSE 100,A01,083659,Cao; Yingjun,0,72,50,50
1651112706590,CSE 134B,A01,083661,Powell; Thomas Allan,0,38,65,65
1651112712616,CSE 140,A01,083663,Staff,0,17,75,75
1651112718643,CSE 140L,A01,083088,Eldon; John,1,0,100,99
1651112724667,CSE 175,A01,083665,Kumar; Rakesh,0,0,25,25
1651112730693,CSE 190,A00,092507,Dubnov; Shlomo,9,0,20,11
1651112736724,ECE 45,A01,083139,Staff,0,8,60,60
1651112742747,ECE 65,A50,083695,Staff,0,7,30,30
1651112748768,ECE 109,A01,091882,Touri; Behrouz,32,0,70,38
1651112754792,ECE 180,A00,083140,Abi Samra; Nicholas Camill,17,0,30,13
1651112754792,ECE 180,B00,083141,Abi Samra; Nicholas Camill,0,1,30,32
1651112760817,MATH 10A,A01,083735,Patchell; Gregory David,0,0,30,30
1651112760817,MATH 10A,A02,083736,Patchell; Gregory David,26,0,30,4
1651112760817,MATH 10A,A03,083737,Patchell; Gregory David,22,0,30,8
1651112766839,MATH 10B,A01,083207,Staff,0,8,30,30
1651112766839,MATH 10B,A02,083208,Staff,0,6,30,30
1651112766839,MATH 10B,B01,083739,Staff,7,0,30,23
1651112766839,MATH 10B,B02,083740,Staff,28,0,30,2
1651112772865,MATH 18,A01,083743,Staff,0,0,30,30
1651112772865,MATH 18,A02,083744,Staff,23,0,30,7
1651112772865,MATH 18,A03,083745,Staff,19,0,30,11
1651112772865,MATH 18,A04,083746,Staff,26,0,30,4
1651112772865,MATH 18,B01,083748,Staff,0,16,30,30
1651112772865,MATH 18,B02,083749,Staff,0,15,30,30
1651112772865,MATH 18,B03,083750,Staff,0,15,30,30
1651112772865,MATH 18,B04,083751,Staff,0,15,30,30
1651112778887,MATH 20A,A01,083754,Staff,18,0,40,22
1651112784911,MATH 20B,A01,083756,Briones; Jor-el Thomas Caparas,0,14,30,30
1651112784911,MATH 20B,A02,083757,Briones; Jor-el Thomas Caparas,0,11,30,30
1651112790938,MATH 20C,A01,083760,Briones; Jor-el Thomas Caparas,1,17,30,29
1651112790938,MATH 20C,A02,083761,Briones; Jor-el Thomas Caparas,0,16,30,30
1651112790938,MATH 20C,B01,083762,Staff,7,0,30,23
1651112790938,MATH 20C,B02,083763,Staff,27,0,30,3
1651112796974,MATH 20D,A01,083765,Tran; Brian Kha,4,1,30,26
1651112796974,MATH 20D,A02,083766,Tran; Brian Kha,0,0,30,30
1651112796974,MATH 20D,A03,083767,Tran; Brian Kha,22,0,30,8
1651112803002,MATH 20E,A01,083771,Staff,0,0,30,30
1651112803002,MATH 20E,A02,083772,Staff,9,0,30,21
1651112803002,MATH 20E,B01,083773,Staff,5,0,35,30
1651112803002,MATH 20E,B02,083774,Staff,5,1,35,30
1651112809026,MATH 103A,A01,083777,Greenfeld; Be'Eri,0,17,30,30
1651112809026,MATH 103A,A02,083778,Greenfeld; Be'Eri,0,17,30,30
1651112809026,MATH 103A,B01,083779,Greenfeld; Be'Eri,0,15,30,30
1651112809026,MATH 103A,B02,083780,Greenfeld; Be'Eri,0,14,30,30
1651112815050,MATH 105,A01,085443,Staff,0,24,30,30
1651112821086,MATH 109,A01,083213,Ganzberger; Geoffrey Michael,0,8,30,30
1651112821086,MATH 109,A02,083214,Ganzberger; Geoffrey Michael,0,7,30,30
1651112821086,MATH 109,B01,083215,Ganzberger; Geoffrey Michael,0,8,30,30
1651112821086,MATH 109,B02,083216,Ganzberger; Geoffrey Michael,1,8,30,29
1651112827113,MATH 142A,A01,083219,Chow; Bennett,0,15,30,30
1651112827113,MATH 142A,A02,083220,Chow; Bennett,0,15,30,30
1651112827113,MATH 142A,B01,083221,Chow; Bennett,0,16,30,30
1651112827113,MATH 142A,B02,083222,Chow; Bennett,0,16,30,30
1651112833137,MATH 193A,A01,083224,Staff,0,9,30,30
1651112833137,MATH 193A,A02,083225,Staff,1,7,30,29
1651112833137,MATH 193A,A03,083781,Staff,0,7,30,30
1651112833137,MATH 193A,A04,083782,Staff,0,7,30,30
1651112839161,MATH 197,001,091859,McAuley; Julian John,9998,0,9999,1
1651112845214,COGS 9,A01,083615,Staff,0,20,60,60
1651112851240,COGS 11,A01,083617,Boyle; Mary E. T.,13,0,40,27
1651112857265,COGS 13,A01,083071,Staff,0,38,40,40
1651112863290,COGS 14A,A01,092681,Staff,0,40,100,100
1651112869314,COGS 14B,A01,083073,Cheng; Tzu-Han,0,11,50,50
1651112875339,COGS 17,A01,092677,Staff,8,0,75,67
1651112881363,COGS 100,A01,083619,Staff,0,30,60,60
1651112887387,COGS 101A,A01,083621,Davis; Joshua Daniel,0,29,60,60
1651112893408,COGS 101B,A01,091572,Staff,0,9,60,60
1651112899433,COGS 101C,A01,083625,Delgado; Tania,12,0,30,18
1651112905456,COGS 107A,A01,083627,Boyle; Mary E. T.,0,17,60,60
1651112911481,COGS 118A,A01,083075,Staff,0,10,60,60
1651112917508,CSE 3,A50,083646,Miranda; Gregory Joseph,15,0,38,23
1651112917508,CSE 3,A51,083647,Miranda; Gregory Joseph,36,0,37,1
1651112923534,CSE 8A,A50,083650,Miranda; Gregory Joseph,0,30,40,40
1651112929556,CSE 11,A01,083080,Cao; Yingjun,1,99,40,39
1651112935586,CSE 12,A01,083652,Staff,0,29,100,100
1651112941608,CSE 15L,A01,083654,Staff,0,3,50,50
1651112941608,CSE 15L,A02,083655,Staff,0,3,50,50
1651112947631,CSE 20,A01,083657,Staff,47,0,80,33
1651112953654,CSE 30,A01,083084,Eldon; John,0,38,80,80
1651112959683,CSE 100,A01,083659,Cao; Yingjun,0,72,50,50
1651112965709,CSE 134B,A01,083661,Powell; Thomas Allan,0,38,65,65
1651112971731,CSE 140,A01,083663,Staff,0,17,75,75
1651112977767,CSE 140L,A01,083088,Eldon; John,1,0,100,99
1651112983792,CSE 175,A01,083665,Kumar; Rakesh,0,0,25,25
1651112989818,CSE 190,A00,092507,Dubnov; Shlomo,9,0,20,11
1651112995842,ECE 45,A01,083139,Staff,0,8,60,60
1651113001867,ECE 65,A50,083695,Staff,0,7,30,30
1651113007895,ECE 109,A01,091882,Touri; Behrouz,32,0,70,38
1651113013922,ECE 180,A00,083140,Abi Samra; Nicholas Camill,17,0,30,13
1651113013922,ECE 180,B00,083141,Abi Samra; Nicholas Camill,0,1,30,32
1651113019947,MATH 10A,A01,083735,Patchell; Gregory David,0,0,30,30
1651113019947,MATH 10A,A02,083736,Patchell; Gregory David,26,0,30,4
1651113019947,MATH 10A,A03,083737,Patchell; Gregory David,22,0,30,8
1651113025968,MATH 10B,A01,083207,Staff,0,8,30,30
1651113025968,MATH 10B,A02,083208,Staff,0,6,30,30
1651113025968,MATH 10B,B01,083739,Staff,7,0,30,23
1651113025968,MATH 10B,B02,083740,Staff,28,0,30,2
1651113031992,MATH 18,A01,083743,Staff,0,0,30,30
1651113031992,MATH 18,A02,083744,Staff,23,0,30,7
1651113031992,MATH 18,A03,083745,Staff,19,0,30,11
1651113031992,MATH 18,A04,083746,Staff,26,0,30,4
1651113031992,MATH 18,B01,083748,Staff,0,16,30,30
1651113031992,MATH 18,B02,083749,Staff,0,15,30,30
1651113031992,MATH 18,B03,083750,Staff,0,15,30,30
1651113031992,MATH 18,B04,083751,Staff,0,15,30,30
1651113038018,MATH 20A,A01,083754,Staff,18,0,40,22
1651113044046,MATH 20B,A01,083756,Briones; Jor-el Thomas Caparas,0,14,30,30
1651113044046,MATH 20B,A02,083757,Briones; Jor-el Thomas Caparas,0,11,30,30
1651113050174,MATH 20C,A01,083760,Briones; Jor-el Thomas Caparas,1,17,30,29
1651113050174,MATH 20C,A02,083761,Briones; Jor-el Thomas Caparas,0,16,30,30
1651113050174,MATH 20C,B01,083762,Staff,7,0,30,23
1651113050174,MATH 20C,B02,083763,Staff,28,0,30,2
1651113056195,MATH 20D,A01,083765,Tran; Brian Kha,4,1,30,26
1651113056195,MATH 20D,A02,083766,Tran; Brian Kha,0,0,30,30
1651113056195,MATH 20D,A03,083767,Tran; Brian Kha,22,0,30,8
1651113062223,MATH 20E,A01,083771,Staff,0,0,30,30
1651113062223,MATH 20E,A02,083772,Staff,9,0,30,21
1651113062223,MATH 20E,B01,083773,Staff,5,0,35,30
1651113062223,MATH 20E,B02,083774,Staff,5,1,35,30
1651113068255,MATH 103A,A01,083777,Greenfeld; Be'Eri,0,17,30,30
1651113068255,MATH 103A,A02,083778,Greenfeld; Be'Eri,0,17,30,30
1651113068255,MATH 103A,B01,083779,Greenfeld; Be'Eri,0,15,30,30
1651113068255,MATH 103A,B02,083780,Greenfeld; Be'Eri,0,14,30,30
1651113074290,MATH 105,A01,085443,Staff,0,24,30,30
1651113080319,MATH 109,A01,083213,Ganzberger; Geoffrey Michael,0,8,30,30
1651113080319,MATH 109,A02,083214,Ganzberger; Geoffrey Michael,0,7,30,30
1651113080319,MATH 109,B01,083215,Ganzberger; Geoffrey Michael,0,8,30,30
1651113080319,MATH 109,B02,083216,Ganzberger; Geoffrey Michael,1,8,30,29
1651113086341,MATH 142A,A01,083219,Chow; Bennett,0,15,30,30
1651113086341,MATH 142A,A02,083220,Chow; Bennett,0,15,30,30
1651113086341,MATH 142A,B01,083221,Chow; Bennett,0,16,30,30
1651113086341,MATH 142A,B02,083222,Chow; Bennett,0,16,30,30
1651113092365,MATH 193A,A01,083224,Staff,0,9,30,30
1651113092365,MATH 193A,A02,083225,Staff,1,7,30,29
1651113092365,MATH 193A,A03,083781,Staff,0,7,30,30
1651113092365,MATH 193A,A04,083782,Staff,0,7,30,30
1651113098389,MATH 197,001,091859,McAuley; Julian John,9998,0,9999,1
1651113104446,COGS 9,A01,083615,Staff,0,20,60,60
1651113110467,COGS 11,A01,083617,Boyle; Mary E. T.,13,0,40,27
1651113116490,COGS 13,A01,083071,Staff,0,38,40,40
1651113122514,COGS 14A,A01,092681,Staff,0,40,100,100
1651113128540,COGS 14B,A01,083073,Cheng; Tzu-Han,0,11,50,50
1651113134563,COGS 17,A01,092677,Staff,8,0,75,67
1651113140589,COGS 100,A01,083619,Staff,0,30,60,60
1651113146623,COGS 101A,A01,083621,Davis; Joshua Daniel,0,29,60,60
1651113152648,COGS 101B,A01,091572,Staff,0,9,60,60
1651113158674,COGS 101C,A01,083625,Delgado; Tania,12,0,30,18
1651113164696,COGS 107A,A01,083627,Boyle; Mary E. T.,0,17,60,60
1651113170719,COGS 118A,A01,083075,Staff,0,10,60,60
1651113176747,CSE 3,A50,083646,Miranda; Gregory Joseph,15,0,38,23
1651113176747,CSE 3,A51,083647,Miranda; Gregory Joseph,36,0,37,1
1651113182779,CSE 8A,A50,083650,Miranda; Gregory Joseph,0,30,40,40
1651113188802,CSE 11,A01,083080,Cao; Yingjun,1,99,40,39
1651113194828,CSE 12,A01,083652,Staff,0,29,100,100
1651113200854,CSE 15L,A01,083654,Staff,0,3,50,50
1651113200854,CSE 15L,A02,083655,Staff,0,3,50,50
1651113206875,CSE 20,A01,083657,Staff,47,0,80,33
1651113212901,CSE 30,A01,083084,Eldon; John,0,38,80,80
1651113218926,CSE 100,A01,083659,Cao; Yingjun,0,72,50,50
1651113224958,CSE 134B,A01,083661,Powell; Thomas Allan,0,38,65,65
1651113230981,CSE 140,A01,083663,Staff,0,17,75,75
1651113237011,CSE 140L,A01,083088,Eldon; John,1,0,100,99
1651113243037,CSE 175,A01,083665,Kumar; Rakesh,0,0,25,25
1651113249062,CSE 190,A00,092507,Dubnov; Shlomo,9,0,20,11
1651113255084,ECE 45,A01,083139,Staff,0,8,60,60
1651113261117,ECE 65,A50,083695,Staff,0,7,30,30
1651113267140,ECE 109,A01,091882,Touri; Behrouz,32,0,70,38
1651113273162,ECE 180,A00,083140,Abi Samra; Nicholas Camill,17,0,30,13
1651113273162,ECE 180,B00,083141,Abi Samra; Nicholas Camill,0,1,30,32
1651113279189,MATH 10A,A01,083735,Patchell; Gregory David,0,0,30,30
1651113279189,MATH 10A,A02,083736,Patchell; Gregory David,26,0,30,4
1651113279189,MATH 10A,A03,083737,Patchell; Gregory David,22,0,30,8
1651113285212,MATH 10B,A01,083207,Staff,0,8,30,30
1651113285212,MATH 10B,A02,083208,Staff,0,6,30,30
1651113285212,MATH 10B,B01,083739,Staff,7,0,30,23
1651113285212,MATH 10B,B02,083740,Staff,28,0,30,2
1651113291237,MATH 18,A01,083743,Staff,0,0,30,30
1651113291237,MATH 18,A02,083744,Staff,23,0,30,7
1651113291237,MATH 18,A03,083745,Staff,19,0,30,11
1651113291237,MATH 18,A04,083746,Staff,26,0,30,4
1651113291237,MATH 18,B01,083748,Staff,0,16,30,30
1651113291237,MATH 18,B02,083749,Staff,0,15,30,30
1651113291237,MATH 18,B03,083750,Staff,0,15,30,30
1651113291237,MATH 18,B04,083751,Staff,0,15,30,30
1651113297260,MATH 20A,A01,083754,Staff,18,0,40,22
1651113303287,MATH 20B,A01,083756,Briones; Jor-el Thomas Caparas,0,14,30,30
1651113303287,MATH 20B,A02,083757,Briones; Jor-el Thomas Caparas,0,11,30,30
1651113309313,MATH 20C,A01,083760,Briones; Jor-el Thomas Caparas,1,17,30,29
1651113309313,MATH 20C,A02,083761,Briones; Jor-el Thomas Caparas,0,16,30,30
1651113309313,MATH 20C,B01,083762,Staff,7,0,30,23
1651113309313,MATH 20C,B02,083763,Staff,28,0,30,2
1651113315337,MATH 20D,A01,083765,Tran; Brian Kha,4,1,30,26
1651113315337,MATH 20D,A02,083766,Tran; Brian Kha,0,0,30,30
1651113315337,MATH 20D,A03,083767,Tran; Brian Kha,22,0,30,8
1651113321359,MATH 20E,A01,083771,Staff,0,0,30,30
1651113321359,MATH 20E,A02,083772,Staff,9,0,30,21
1651113321359,MATH 20E,B01,083773,Staff,5,0,35,30
1651113321359,MATH 20E,B02,083774,Staff,5,1,35,30
1651113327393,MATH 103A,A01,083777,Greenfeld; Be'Eri,0,17,30,30
1651113327393,MATH 103A,A02,083778,Greenfeld; Be'Eri,0,17,30,30
1651113327393,MATH 103A,B01,083779,Greenfeld; Be'Eri,0,15,30,30
1651113327393,MATH 103A,B02,083780,Greenfeld; Be'Eri,0,14,30,30
1651113333418,MATH 105,A01,085443,Staff,0,24,30,30
1651113339442,MATH 109,A01,083213,Ganzberger; Geoffrey Michael,0,8,30,30
1651113339442,MATH 109,A02,083214,Ganzberger; Geoffrey Michael,0,7,30,30
1651113339442,MATH 109,B01,083215,Ganzberger; Geoffrey Michael,0,8,30,30
1651113339442,MATH 109,B02,083216,Ganzberger; Geoffrey Michael,1,8,30,29
1651113345466,MATH 142A,A01,083219,Chow; Bennett,0,15,30,30
1651113345466,MATH 142A,A02,083220,Chow; Bennett,0,15,30,30
1651113345466,MATH 142A,B01,083221,Chow; Bennett,0,16,30,30
1651113345466,MATH 142A,B02,083222,Chow; Bennett,0,16,30,30
1651113351490,MATH 193A,A01,083224,Staff,0,9,30,30
1651113351490,MATH 193A,A02,083225,Staff,1,7,30,29
1651113351490,MATH 193A,A03,083781,Staff,0,7,30,30
1651113351490,MATH 193A,A04,083782,Staff,0,7,30,30
1651113357516,MATH 197,001,091859,McAuley; Julian John,9998,0,9999,1
1651113363569,COGS 9,A01,083615,Staff,0,20,60,60
1651113369591,COGS 11,A01,083617,Boyle; Mary E. T.,13,0,40,27
1651113375615,COGS 13,A01,083071,Staff,0,38,40,40
1651113381637,COGS 14A,A01,092681,Staff,0,40,100,100
1651113387658,COGS 14B,A01,083073,Cheng; Tzu-Han,0,11,50,50
1651113393681,COGS 17,A01,092677,Staff,8,0,75,67
1651113399706,COGS 100,A01,083619,Staff,0,30,60,60
1651113405738,COGS 101A,A01,083621,Davis; Joshua Daniel,0,29,60,60
1651113411764,COGS 101B,A01,091572,Staff,0,9,60,60
1651113417788,COGS 101C,A01,083625,Delgado; Tania,12,0,30,18
1651113423813,COGS 107A,A01,083627,Boyle; Mary E. T.,0,17,60,60
1651113429839,COGS 118A,A01,083075,Staff,0,10,60,60
1651113435866,CSE 3,A50,083646,Miranda; Gregory Joseph,15,0,38,23
1651113435866,CSE 3,A51,083647,Miranda; Gregory Joseph,36,0,37,1
1651113441914,CSE 8A,A50,083650,Miranda; Gregory Joseph,0,30,40,40
1651113447944,CSE 11,A01,083080,Cao; Yingjun,1,99,40,39
1651113453968,CSE 12,A01,083652,Staff,0,29,100,100
1651113460007,CSE 15L,A01,083654,Staff,0,3,50,50
1651113460007,CSE 15L,A02,083655,Staff,0,3,50,50
1651113466031,CSE 20,A01,083657,Staff,47,0,80,33
1651113472053,CSE 30,A01,083084,Eldon; John,0,38,80,80
1651113478079,CSE 100,A01,083659,Cao; Yingjun,0,72,50,50
1651113484106,CSE 134B,A01,083661,Powell; Thomas Allan,0,38,65,65
1651113490131,CSE 140,A01,083663,Staff,0,17,75,75
1651113496157,CSE 140L,A01,083088,Eldon; John,1,0,100,99
1651113502183,CSE 175,A01,083665,Kumar; Rakesh,0,0,25,25
1651113508211,CSE 190,A00,092507,Dubnov; Shlomo,9,0,20,11
1651113514237,ECE 45,A01,083139,Staff,0,8,60,60
1651113520262,ECE 65,A50,083695,Staff,0,7,30,30
1651113526284,ECE 109,A01,091882,Touri; Behrouz,32,0,70,38
1651113532310,ECE 180,A00,083140,Abi Samra; Nicholas Camill,17,0,30,13
1651113532310,ECE 180,B00,083141,Abi Samra; Nicholas Camill,0,1,30,32
1651113538345,MATH 10A,A01,083735,Patchell; Gregory David,0,0,30,30
1651113538345,MATH 10A,A02,083736,Patchell; Gregory David,26,0,30,4
1651113538345,MATH 10A,A03,083737,Patchell; Gregory David,22,0,30,8
1651113544371,MATH 10B,A01,083207,Staff,0,8,30,30
1651113544371,MATH 10B,A02,083208,Staff,0,6,30,30
1651113544371,MATH 10B,B01,083739,Staff,7,0,30,23
1651113544371,MATH 10B,B02,083740,Staff,28,0,30,2
1651113550399,MATH 18,A01,083743,Staff,0,0,30,30
1651113550399,MATH 18,A02,083744,Staff,23,0,30,7
1651113550399,MATH 18,A03,083745,Staff,19,0,30,11
1651113550399,MATH 18,A04,083746,Staff,26,0,30,4
1651113550399,MATH 18,B01,083748,Staff,0,16,30,30
1651113550399,MATH 18,B02,083749,Staff,0,15,30,30
1651113550399,MATH 18,B03,083750,Staff,0,15,30,30
1651113550399,MATH 18,B04,083751,Staff,0,15,30,30
1651113556423,MATH 20A,A01,083754,Staff,18,0,40,22
1651113562446,MATH 20B,A01,083756,Briones; Jor-el Thomas Caparas,0,14,30,30
1651113562446,MATH 20B,A02,083757,Briones; Jor-el Thomas Caparas,0,11,30,30
1651113568481,MATH 20C,A01,083760,Briones; Jor-el Thomas Caparas,1,17,30,29
1651113568481,MATH 20C,A02,083761,Briones; Jor-el Thomas Caparas,0,16,30,30
1651113568481,MATH 20C,B01,083762,Staff,7,0,30,23
1651113568481,MATH 20C,B02,083763,Staff,28,0,30,2
1651113574507,MATH 20D,A01,083765,Tran; Brian Kha,4,1,30,26
1651113574507,MATH 20D,A02,083766,Tran; Brian Kha,0,0,30,30
1651113574507,MATH 20D,A03,083767,Tran; Brian Kha,22,0,30,8
1651113580530,MATH 20E,A01,083771,Staff,0,0,30,30
1651113580530,MATH 20E,A02,083772,Staff,9,0,30,21
1651113580530,MATH 20E,B01,083773,Staff,5,0,35,30
1651113580530,MATH 20E,B02,083774,Staff,5,1,35,30
1651113586558,MATH 103A,A01,083777,Greenfeld; Be'Eri,0,17,30,30
1651113586558,MATH 103A,A02,083778,Greenfeld; Be'Eri,0,17,30,30
1651113586558,MATH 103A,B01,083779,Greenfeld; Be'Eri,0,15,30,30
1651113586558,MATH 103A,B02,083780,Greenfeld; Be'Eri,0,14,30,30
1651113592594,MATH 105,A01,085443,Staff,0,24,30,30
1651113598620,MATH 109,A01,083213,Ganzberger; Geoffrey Michael,0,8,30,30
1651113598620,MATH 109,A02,083214,Ganzberger; Geoffrey Michael,0,7,30,30
1651113598620,MATH 109,B01,083215,Ganzberger; Geoffrey Michael,0,8,30,30
1651113598620,MATH 109,B02,083216,Ganzberger; Geoffrey Michael,1,8,30,29
1651113604644,MATH 142A,A01,083219,Chow; Bennett,0,15,30,30
1651113604644,MATH 142A,A02,083220,Chow; Bennett,0,15,30,30
1651113604644,MATH 142A,B01,083221,Chow; Bennett,0,16,30,30
1651113604644,MATH 142A,B02,083222,Chow; Bennett,0,16,30,30
1651113610668,MATH 193A,A01,083224,Staff,0,9,30,30
1651113610668,MATH 193A,A02,083225,Staff,1,7,30,29
1651113610668,MATH 193A,A03,083781,Staff,0,7,30,30
1651113610668,MATH 193A,A04,083782,Staff,0,7,30,30
1651113616694,MATH 197,001,091859,McAuley; Julian John,9998,0,9999,1
1651113622743,COGS 9,A01,083615,Staff,0,20,60,60
1651113628774,COGS 11,A01,083617,Boyle; Mary E. T.,13,0,40,27
1651113634797,COGS 13,A01,083071,Staff,0,38,40,40
1651113640928,COGS 14A,A01,092681,Staff,0,40,100,100
1651113646950,COGS 14B,A01,083073,Cheng; Tzu-Han,0,11,50,50
1651113652977,COGS 17,A01,092677,Staff,8,0,75,67
1651113659001,COGS 100,A01,083619,Staff,0,30,60,60
1651113665023,COGS 101A,A01,083621,Davis; Joshua Daniel,0,29,60,60
1651113671053,COGS 101B,A01,091572,Staff,0,9,60,60
1651113677079,COGS 101C,A01,083625,Delgado; Tania,12,0,30,18
1651113683106,COGS 107A,A01,083627,Boyle; Mary E. T.,0,17,60,60
1651113689162,COGS 118A,A01,083075,Staff,0,10,60,60
1651113695190,CSE 3,A50,083646,Miranda; Gregory Joseph,15,0,38,23
1651113695190,CSE 3,A51,083647,Miranda; Gregory Joseph,36,0,37,1
1651113701214,CSE 8A,A50,083650,Miranda; Gregory Joseph,0,30,40,40
1651113707260,CSE 11,A01,083080,Cao; Yingjun,1,99,40,39
1651113713283,CSE 12,A01,083652,Staff,0,29,100,100
1651113719306,CSE 15L,A01,083654,Staff,0,3,50,50
1651113719306,CSE 15L,A02,083655,Staff,0,3,50,50
1651113725338,CSE 20,A01,083657,Staff,47,0,80,33
1651113731362,CSE 30,A01,083084,Eldon; John,0,38,80,80
1651113737388,CSE 100,A01,083659,Cao; Yingjun,0,72,50,50
1651113743410,CSE 134B,A01,083661,Powell; Thomas Allan,0,38,65,65
1651113749433,CSE 140,A01,083663,Staff,0,17,75,75
1651113755454,CSE 140L,A01,083088,Eldon; John,1,0,100,99
1651113761476,CSE 175,A01,083665,Kumar; Rakesh,0,0,25,25
1651113767506,CSE 190,A00,092507,Dubnov; Shlomo,9,0,20,11
1651113773529,ECE 45,A01,083139,Staff,0,8,60,60
1651113779554,ECE 65,A50,083695,Staff,0,7,30,30
1651113785586,ECE 109,A01,091882,Touri; Behrouz,32,0,70,38
1651113791611,ECE 180,A00,083140,Abi Samra; Nicholas Camill,17,0,30,13
1651113791611,ECE 180,B00,083141,Abi Samra; Nicholas Camill,0,1,30,32
1651113797641,MATH 10A,A01,083735,Patchell; Gregory David,0,0,30,30
1651113797641,MATH 10A,A02,083736,Patchell; Gregory David,26,0,30,4
1651113797641,MATH 10A,A03,083737,Patchell; Gregory David,22,0,30,8
1651113803664,MATH 10B,A01,083207,Staff,0,8,30,30
1651113803664,MATH 10B,A02,083208,Staff,0,6,30,30
1651113803664,MATH 10B,B01,083739,Staff,7,0,30,23
1651113803664,MATH 10B,B02,083740,Staff,28,0,30,2
1651113809688,MATH 18,A01,083743,Staff,0,0,30,30
1651113809688,MATH 18,A02,083744,Staff,23,0,30,7
1651113809688,MATH 18,A03,083745,Staff,19,0,30,11
1651113809688,MATH 18,A04,083746,Staff,26,0,30,4
1651113809688,MATH 18,B01,083748,Staff,0,16,30,30
1651113809688,MATH 18,B02,083749,Staff,0,15,30,30
1651113809688,MATH 18,B03,083750,Staff,0,15,30,30
1651113809688,MATH 18,B04,083751,Staff,0,15,30,30
1651113815711,MATH 20A,A01,083754,Staff,18,0,40,22
1651113821736,MATH 20B,A01,083756,Briones; Jor-el Thomas Caparas,0,14,30,30
1651113821736,MATH 20B,A02,083757,Briones; Jor-el Thomas Caparas,0,11,30,30
1651113827761,MATH 20C,A01,083760,Briones; Jor-el Thomas Caparas,1,17,30,29
1651113827761,MATH 20C,A02,083761,Briones; Jor-el Thomas Caparas,0,16,30,30
1651113827761,MATH 20C,B01,083762,Staff,7,0,30,23
1651113827761,MATH 20C,B02,083763,Staff,28,0,30,2
1651113833788,MATH 20D,A01,083765,Tran; Brian Kha,4,1,30,26
1651113833788,MATH 20D,A02,083766,Tran; Brian Kha,0,0,30,30
1651113833788,MATH 20D,A03,083767,Tran; Brian Kha,22,0,30,8
1651113839815,MATH 20E,A01,083771,Staff,0,0,30,30
1651113839815,MATH 20E,A02,083772,Staff,9,0,30,21
1651113839815,MATH 20E,B01,083773,Staff,5,0,35,30
1651113839815,MATH 20E,B02,083774,Staff,5,1,35,30
1651113845844,MATH 103A,A01,083777,Greenfeld; Be'Eri,0,17,30,30
1651113845844,MATH 103A,A02,083778,Greenfeld; Be'Eri,0,17,30,30
1651113845844,MATH 103A,B01,083779,Greenfeld; Be'Eri,0,15,30,30
1651113845844,MATH 103A,B02,083780,Greenfeld; Be'Eri,0,14,30,30
1651113851878,MATH 105,A01,085443,Staff,0,24,30,30
1651113857901,MATH 109,A01,083213,Ganzberger; Geoffrey Michael,0,8,30,30
1651113857901,MATH 109,A02,083214,Ganzberger; Geoffrey Michael,0,7,30,30
1651113857901,MATH 109,B01,083215,Ganzberger; Geoffrey Michael,0,8,30,30
1651113857901,MATH 109,B02,083216,Ganzberger; Geoffrey Michael,1,8,30,29
1651113863937,MATH 142A,A01,083219,Chow; Bennett,0,15,30,30
1651113863937,MATH 142A,A02,083220,Chow; Bennett,0,15,30,30
1651113863937,MATH 142A,B01,083221,Chow; Bennett,0,16,30,30
1651113863937,MATH 142A,B02,083222,Chow; Bennett,0,16,30,30
1651113869964,MATH 193A,A01,083224,Staff,0,9,30,30
1651113869964,MATH 193A,A02,083225,Staff,1,7,30,29
1651113869964,MATH 193A,A03,083781,Staff,0,7,30,30
1651113869964,MATH 193A,A04,083782,Staff,0,7,30,30
1651113875985,MATH 197,001,091859,McAuley; Julian John,9998,0,9999,1
1651113882043,COGS 9,A01,083615,Staff,0,20,60,60
1651113888069,COGS 11,A01,083617,Boyle; Mary E. T.,13,0,40,27
1651113894095,COGS 13,A01,083071,Staff,0,38,40,40
1651113900120,COGS 14A,A01,092681,Staff,0,40,100,100
1651113906143,COGS 14B,A01,083073,Cheng; Tzu-Han,0,11,50,50
1651113912171,COGS 17,A01,092677,Staff,8,0,75,67
1651113918193,COGS 100,A01,083619,Staff,0,30,60,60
1651113924225,COGS 101A,A01,083621,Davis; Joshua Daniel,0,29,60,60
1651113930250,COGS 101B,A01,091572,Staff,0,8,60,60
1651113936280,COGS 101C,A01,083625,Delgado; Tania,12,0,30,18
1651113942304,COGS 107A,A01,083627,Boyle; Mary E. T.,0,17,60,60
1651113948342,COGS 118A,A01,083075,Staff,0,10,60,60
1651113954375,CSE 3,A50,083646,Miranda; Gregory Joseph,15,0,38,23
1651113954375,CSE 3,A51,083647,Miranda; Gregory Joseph,36,0,37,1
1651113960403,CSE 8A,A50,083650,Miranda; Gregory Joseph,0,30,40,40
1651113966427,CSE 11,A01,083080,Cao; Yingjun,1,99,40,39
1651113972450,CSE 12,A01,083652,Staff,0,29,100,100
1651113978474,CSE 15L,A01,083654,Staff,0,3,50,50
1651113978474,CSE 15L,A02,083655,Staff,0,3,50,50
1651113984505,CSE 20,A01,083657,Staff,47,0,80,33
1651113990529,CSE 30,A01,083084,Eldon; John,0,38,80,80
1651113996560,CSE 100,A01,083659,Cao; Yingjun,0,72,50,50
1651114002599,CSE 134B,A01,083661,Powell; Thomas Allan,0,38,65,65
1651114008630,CSE 140,A01,083663,Staff,0,17,75,75
1651114014654,CSE 140L,A01,083088,Eldon; John,1,0,100,99
1651114020678,CSE 175,A01,083665,Kumar; Rakesh,0,0,25,25
1651114026702,CSE 190,A00,092507,Dubnov; Shlomo,9,0,20,11
1651114032724,ECE 45,A01,083139,Staff,0,8,60,60
1651114038750,ECE 65,A50,083695,Staff,0,7,30,30
1651114044774,ECE 109,A01,091882,Touri; Behrouz,32,0,70,38
1651114050797,ECE 180,A00,083140,Abi Samra; Nicholas Camill,17,0,30,13
1651114050797,ECE 180,B00,083141,Abi Samra; Nicholas Camill,0,1,30,32
1651114056821,MATH 10A,A01,083735,Patchell; Gregory David,0,0,30,30
1651114056821,MATH 10A,A02,083736,Patchell; Gregory David,26,0,30,4
1651114056821,MATH 10A,A03,083737,Patchell; Gregory David,22,0,30,8
1651114062845,MATH 10B,A01,083207,Staff,0,8,30,30
1651114062845,MATH 10B,A02,083208,Staff,0,6,30,30
1651114062845,MATH 10B,B01,083739,Staff,7,0,30,23
1651114062845,MATH 10B,B02,083740,Staff,28,0,30,2
1651114068869,MATH 18,A01,083743,Staff,0,0,30,30
1651114068869,MATH 18,A02,083744,Staff,23,0,30,7
1651114068869,MATH 18,A03,083745,Staff,19,0,30,11
1651114068869,MATH 18,A04,083746,Staff,26,0,30,4
1651114068869,MATH 18,B01,083748,Staff,0,16,30,30
1651114068869,MATH 18,B02,083749,Staff,0,15,30,30
1651114068869,MATH 18,B03,083750,Staff,0,15,30,30
1651114068869,MATH 18,B04,083751,Staff,0,15,30,30
1651114074895,MATH 20A,A01,083754,Staff,18,0,40,22
1651114080919,MATH 20B,A01,083756,Briones; Jor-el Thomas Caparas,0,14,30,30
1651114080919,MATH 20B,A02,083757,Briones; Jor-el Thomas Caparas,0,11,30,30
1651114086953,MATH 20C,A01,083760,Briones; Jor-el Thomas Caparas,1,17,30,29
1651114086953,MATH 20C,A02,083761,Briones; Jor-el Thomas Caparas,0,16,30,30
1651114086953,MATH 20C,B01,083762,Staff,7,0,30,23
1651114086953,MATH 20C,B02,083763,Staff,28,0,30,2
1651114092986,MATH 20D,A01,083765,Tran; Brian Kha,4,1,30,26
1651114092986,MATH 20D,A02,083766,Tran; Brian Kha,0,0,30,30
1651114092986,MATH 20D,A03,083767,Tran; Brian Kha,22,0,30,8
1651114099010,MATH 20E,A01,083771,Staff,0,0,30,30
1651114099010,MATH 20E,A02,083772,Staff,9,0,30,21
1651114099010,MATH 20E,B01,083773,Staff,5,0,35,30
1651114099010,MATH 20E,B02,083774,Staff,5,1,35,30
1651114105053,MATH 103A,A01,083777,Greenfeld; Be'Eri,0,17,30,30
1651114105053,MATH 103A,A02,083778,Greenfeld; Be'Eri,0,17,30,30
1651114105053,MATH 103A,B01,083779,Greenfeld; Be'Eri,0,15,30,30
1651114105053,MATH 103A,B02,083780,Greenfeld; Be'Eri,0,14,30,30
1651114111079,MATH 105,A01,085443,Staff,0,24,30,30
1651114117107,MATH 109,A01,083213,Ganzberger; Geoffrey Michael,0,8,30,30
1651114117107,MATH 109,A02,083214,Ganzberger; Geoffrey Michael,0,7,30,30
1651114117107,MATH 109,B01,083215,Ganzberger; Geoffrey Michael,0,8,30,30
1651114117107,MATH 109,B02,083216,Ganzberger; Geoffrey Michael,1,8,30,29
1651114123136,MATH 142A,A01,083219,Chow; Bennett,0,15,30,30
1651114123136,MATH 142A,A02,083220,Chow; Bennett,0,15,30,30
1651114123136,MATH 142A,B01,083221,Chow; Bennett,0,16,30,30
1651114123136,MATH 142A,B02,083222,Chow; Bennett,0,16,30,30
1651114129159,MATH 193A,A01,083224,Staff,0,9,30,30
1651114129159,MATH 193A,A02,083225,Staff,1,7,30,29
1651114129159,MATH 193A,A03,083781,Staff,0,7,30,30
1651114129159,MATH 193A,A04,083782,Staff,0,7,30,30
1651114135198,MATH 197,001,091859,McAuley; Julian John,9998,0,9999,1
1651114141250,COGS 9,A01,083615,Staff,0,20,60,60
1651114147274,COGS 11,A01,083617,Boyle; Mary E. T.,13,0,40,27
1651114153299,COGS 13,A01,083071,Staff,0,38,40,40
1651114159344,COGS 14A,A01,092681,Staff,0,40,100,100
1651114165371,COGS 14B,A01,083073,Cheng; Tzu-Han,0,11,50,50
1651114171396,COGS 17,A01,092677,Staff,8,0,75,67
1651114177418,COGS 100,A01,083619,Staff,0,30,60,60
1651114183450,COGS 101A,A01,083621,Davis; Joshua Daniel,0,29,60,60
1651114189483,COGS 101B,A01,091572,Staff,0,8,60,60
1651114195507,COGS 101C,A01,083625,Delgado; Tania,12,0,30,18
1651114201567,COGS 107A,A01,083627,Boyle; Mary E. T.,0,17,60,60
1651114207591,COGS 118A,A01,083075,Staff,0,10,60,60
1651114213625,CSE 3,A50,083646,Miranda; Gregory Joseph,15,0,38,23
1651114213625,CSE 3,A51,083647,Miranda; Gregory Joseph,36,0,37,1
1651114219649,CSE 8A,A50,083650,Miranda; Gregory Joseph,0,30,40,40
1651114225671,CSE 11,A01,083080,Cao; Yingjun,1,99,40,39
1651114231693,CSE 12,A01,083652,Staff,0,29,100,100
1651114237808,CSE 15L,A01,083654,Staff,0,3,50,50
1651114237808,CSE 15L,A02,083655,Staff,0,3,50,50
1651114243843,CSE 20,A01,083657,Staff,47,0,80,33
1651114249870,CSE 30,A01,083084,Eldon; John,0,38,80,80
1651114255896,CSE 100,A01,083659,Cao; Yingjun,0,72,50,50
1651114261919,CSE 134B,A01,083661,Powell; Thomas Allan,0,38,65,65
1651114267946,CSE 140,A01,083663,Staff,0,17,75,75
1651114273968,CSE 140L,A01,083088,Eldon; John,1,0,100,99
1651114279993,CSE 175,A01,083665,Kumar; Rakesh,0,0,25,25
1651114286036,CSE 190,A00,092507,Dubnov; Shlomo,9,0,20,11
1651114292058,ECE 45,A01,083139,Staff,0,8,60,60
1651114298083,ECE 65,A50,083695,Staff,0,7,30,30
1651114304108,ECE 109,A01,091882,Touri; Behrouz,32,0,70,38
1651114310130,ECE 180,A00,083140,Abi Samra; Nicholas Camill,17,0,30,13
1651114310130,ECE 180,B00,083141,Abi Samra; Nicholas Camill,0,1,30,32
1651114316155,MATH 10A,A01,083735,Patchell; Gregory David,0,0,30,30
1651114316155,MATH 10A,A02,083736,Patchell; Gregory David,26,0,30,4
1651114316155,MATH 10A,A03,083737,Patchell; Gregory David,22,0,30,8
1651114322193,MATH 10B,A01,083207,Staff,0,8,30,30
1651114322193,MATH 10B,A02,083208,Staff,0,6,30,30
1651114322193,MATH 10B,B01,083739,Staff,7,0,30,23
1651114322193,MATH 10B,B02,083740,Staff,28,0,30,2
1651114328218,MATH 18,A01,083743,Staff,0,0,30,30
1651114328218,MATH 18,A02,083744,Staff,23,0,30,7
1651114328218,MATH 18,A03,083745,Staff,19,0,30,11
1651114328218,MATH 18,A04,083746,Staff,26,0,30,4
1651114328218,MATH 18,B01,083748,Staff,0,16,30,30
1651114328218,MATH 18,B02,083749,Staff,0,15,30,30
1651114328218,MATH 18,B03,083750,Staff,0,15,30,30
1651114328218,MATH 18,B04,083751,Staff,0,15,30,30
1651114334249,MATH 20A,A01,083754,Staff,18,0,40,22
1651114340291,MATH 20B,A01,083756,Briones; Jor-el Thomas Caparas,0,14,30,30
1651114340291,MATH 20B,A02,083757,Briones; Jor-el Thomas Caparas,0,11,30,30
1651114346315,MATH 20C,A01,083760,Briones; Jor-el Thomas Caparas,1,17,30,29
1651114346315,MATH 20C,A02,083761,Briones; Jor-el Thomas Caparas,0,17,30,30
1651114346315,MATH 20C,B01,083762,Staff,7,0,30,23
1651114346315,MATH 20C,B02,083763,Staff,28,0,30,2
1651114352351,MATH 20D,A01,083765,Tran; Brian Kha,4,1,30,26
1651114352351,MATH 20D,A02,083766,Tran; Brian Kha,0,0,30,30
1651114352351,MATH 20D,A03,083767,Tran; Brian Kha,22,0,30,8
1651114358378,MATH 20E,A01,083771,Staff,0,0,30,30
1651114358378,MATH 20E,A02,083772,Staff,9,0,30,21
1651114358378,MATH 20E,B01,083773,Staff,5,0,35,30
1651114358378,MATH 20E,B02,083774,Staff,5,1,35,30
1651114364401,MATH 103A,A01,083777,Greenfeld; Be'Eri,0,17,30,30
1651114364401,MATH 103A,A02,083778,Greenfeld; Be'Eri,0,17,30,30
1651114364401,MATH 103A,B01,083779,Greenfeld; Be'Eri,0,15,30,30
1651114364401,MATH 103A,B02,083780,Greenfeld; Be'Eri,0,14,30,30
1651114370427,MATH 105,A01,085443,Staff,0,24,30,30
1651114376455,MATH 109,A01,083213,Ganzberger; Geoffrey Michael,0,8,30,30
1651114376455,MATH 109,A02,083214,Ganzberger; Geoffrey Michael,0,7,30,30
1651114376455,MATH 109,B01,083215,Ganzberger; Geoffrey Michael,0,8,30,30
1651114376455,MATH 109,B02,083216,Ganzberger; Geoffrey Michael,1,8,30,29
1651114382479,MATH 142A,A01,083219,Chow; Bennett,0,15,30,30
1651114382479,MATH 142A,A02,083220,Chow; Bennett,0,15,30,30
1651114382479,MATH 142A,B01,083221,Chow; Bennett,0,16,30,30
1651114382479,MATH 142A,B02,083222,Chow; Bennett,0,16,30,30
1651114388501,MATH 193A,A01,083224,Staff,0,9,30,30
1651114388501,MATH 193A,A02,083225,Staff,1,7,30,29
1651114388501,MATH 193A,A03,083781,Staff,0,7,30,30
1651114388501,MATH 193A,A04,083782,Staff,0,7,30,30
1651114394523,MATH 197,001,091859,McAuley; Julian John,9998,0,9999,1
1651114400577,COGS 9,A01,083615,Staff,0,20,60,60
1651114406607,COGS 11,A01,083617,Boyle; Mary E. T.,13,0,40,27
1651114412632,COGS 13,A01,083071,Staff,0,38,40,40
1651114418655,COGS 14A,A01,092681,Staff,0,40,100,100
1651114424681,COGS 14B,A01,083073,Cheng; Tzu-Han,0,11,50,50
1651114430706,COGS 17,A01,092677,Staff,8,0,75,67
1651114436729,COGS 100,A01,083619,Staff,0,30,60,60
1651114442760,COGS 101A,A01,083621,Davis; Joshua Daniel,0,29,60,60
1651114448784,COGS 101B,A01,091572,Staff,0,8,60,60
1651114454807,COGS 101C,A01,083625,Delgado; Tania,12,0,30,18
1651114460830,COGS 107A,A01,083627,Boyle; Mary E. T.,0,17,60,60
1651114466859,COGS 118A,A01,083075,Staff,0,10,60,60
1651114472885,CSE 3,A50,083646,Miranda; Gregory Joseph,15,0,38,23
1651114472885,CSE 3,A51,083647,Miranda; Gregory Joseph,36,0,37,1
1651114478913,CSE 8A,A50,083650,Miranda; Gregory Joseph,0,30,40,40
1651114484936,CSE 11,A01,083080,Cao; Yingjun,1,99,40,39
1651114490959,CSE 12,A01,083652,Staff,0,29,100,100
1651114496996,CSE 15L,A01,083654,Staff,0,3,50,50
1651114496996,CSE 15L,A02,083655,Staff,0,3,50,50
1651114503020,CSE 20,A01,083657,Staff,47,0,80,33
1651114509045,CSE 30,A01,083084,Eldon; John,0,38,80,80
1651114515068,CSE 100,A01,083659,Cao; Yingjun,0,72,50,50
1651114521090,CSE 134B,A01,083661,Powell; Thomas Allan,0,38,65,65
1651114527113,CSE 140,A01,083663,Staff,0,17,75,75
1651114533135,CSE 140L,A01,083088,Eldon; John,1,0,100,99
1651114539160,CSE 175,A01,083665,Kumar; Rakesh,0,0,25,25
1651114545195,CSE 190,A00,092507,Dubnov; Shlomo,9,0,20,11
1651114551217,ECE 45,A01,083139,Staff,0,8,60,60
1651114557240,ECE 65,A50,083695,Staff,0,7,30,30
1651114563266,ECE 109,A01,091882,Touri; Behrouz,32,0,70,38
1651114569288,ECE 180,A00,083140,Abi Samra; Nicholas Camill,17,0,30,13
1651114569288,ECE 180,B00,083141,Abi Samra; Nicholas Camill,0,1,30,32
1651114575323,MATH 10A,A01,083735,Patchell; Gregory David,0,0,30,30
1651114575323,MATH 10A,A02,083736,Patchell; Gregory David,26,0,30,4
1651114575323,MATH 10A,A03,083737,Patchell; Gregory David,22,0,30,8
1651114581363,MATH 10B,A01,083207,Staff,0,8,30,30
1651114581363,MATH 10B,A02,083208,Staff,0,6,30,30
1651114581363,MATH 10B,B01,083739,Staff,7,0,30,23
1651114581363,MATH 10B,B02,083740,Staff,28,0,30,2
1651114587387,MATH 18,A01,083743,Staff,0,0,30,30
1651114587387,MATH 18,A02,083744,Staff,23,0,30,7
1651114587387,MATH 18,A03,083745,Staff,19,0,30,11
1651114587387,MATH 18,A04,083746,Staff,26,0,30,4
1651114587387,MATH 18,B01,083748,Staff,0,16,30,30
1651114587387,MATH 18,B02,083749,Staff,0,15,30,30
1651114587387,MATH 18,B03,083750,Staff,0,15,30,30
1651114587387,MATH 18,B04,083751,Staff,0,15,30,30
1651114593413,MATH 20A,A01,083754,Staff,18,0,40,22
1651114599436,MATH 20B,A01,083756,Briones; Jor-el Thomas Caparas,0,14,30,30
1651114599436,MATH 20B,A02,083757,Briones; Jor-el Thomas Caparas,0,11,30,30
1651114605459,MATH 20C,A01,083760,Briones; Jor-el Thomas Caparas,1,17,30,29
1651114605459,MATH 20C,A02,083761,Briones; Jor-el Thomas Caparas,0,17,30,30
1651114605459,MATH 20C,B01,083762,Staff,7,0,30,23
1651114605459,MATH 20C,B02,083763,Staff,28,0,30,2
1651114611482,MATH 20D,A01,083765,Tran; Brian Kha,4,1,30,26
1651114611482,MATH 20D,A02,083766,Tran; Brian Kha,0,0,30,30
1651114611482,MATH 20D,A03,083767,Tran; Brian Kha,22,0,30,8
1651114617513,MATH 20E,A01,083771,Staff,0,0,30,30
1651114617513,MATH 20E,A02,083772,Staff,9,0,30,21
1651114617513,MATH 20E,B01,083773,Staff,5,0,35,30
1651114617513,MATH 20E,B02,083774,Staff,5,1,35,30
1651114623541,MATH 103A,A01,083777,Greenfeld; Be'Eri,0,17,30,30
1651114623541,MATH 103A,A02,083778,Greenfeld; Be'Eri,0,17,30,30
1651114623541,MATH 103A,B01,083779,Greenfeld; Be'Eri,0,15,30,30
1651114623541,MATH 103A,B02,083780,Greenfeld; Be'Eri,0,14,30,30
1651114629564,MATH 105,A01,085443,Staff,0,24,30,30
1651114635589,MATH 109,A01,083213,Ganzberger; Geoffrey Michael,0,8,30,30
1651114635589,MATH 109,A02,083214,Ganzberger; Geoffrey Michael,0,7,30,30
1651114635589,MATH 109,B01,083215,Ganzberger; Geoffrey Michael,0,8,30,30
1651114635589,MATH 109,B02,083216,Ganzberger; Geoffrey Michael,1,8,30,29
1651114641613,MATH 142A,A01,083219,Chow; Bennett,0,15,30,30
1651114641613,MATH 142A,A02,083220,Chow; Bennett,0,15,30,30
1651114641613,MATH 142A,B01,083221,Chow; Bennett,0,16,30,30
1651114641613,MATH 142A,B02,083222,Chow; Bennett,0,16,30,30
1651114647636,MATH 193A,A01,083224,Staff,0,9,30,30
1651114647636,MATH 193A,A02,083225,Staff,1,7,30,29
1651114647636,MATH 193A,A03,083781,Staff,0,7,30,30
1651114647636,MATH 193A,A04,083782,Staff,0,7,30,30
1651114653659,MATH 197,001,091859,McAuley; Julian John,9998,0,9999,1
1651114659717,COGS 9,A01,083615,Staff,0,20,60,60
1651114665749,COGS 11,A01,083617,Boyle; Mary E. T.,13,0,40,27
1651114671774,COGS 13,A01,083071,Staff,0,38,40,40
1651114677810,COGS 14A,A01,092681,Staff,0,40,100,100
1651114683834,COGS 14B,A01,083073,Cheng; Tzu-Han,0,11,50,50
1651114689868,COGS 17,A01,092677,Staff,8,0,75,67
1651114695891,COGS 100,A01,083619,Staff,0,30,60,60
1651114701915,COGS 101A,A01,083621,Davis; Joshua Daniel,0,29,60,60
1651114707943,COGS 101B,A01,091572,Staff,0,8,60,60
1651114713970,COGS 101C,A01,083625,Delgado; Tania,12,0,30,18
1651114719996,COGS 107A,A01,083627,Boyle; Mary E. T.,0,17,60,60
1651114726020,COGS 118A,A01,083075,Staff,0,10,60,60
1651114732053,CSE 3,A50,083646,Miranda; Gregory Joseph,15,0,38,23
1651114732053,CSE 3,A51,083647,Miranda; Gregory Joseph,36,0,37,1
1651114738078,CSE 8A,A50,083650,Miranda; Gregory Joseph,0,30,40,40
1651114744102,CSE 11,A01,083080,Cao; Yingjun,1,99,40,39
1651114750128,CSE 12,A01,083652,Staff,0,29,100,100
1651114756149,CSE 15L,A01,083654,Staff,0,3,50,50
1651114756149,CSE 15L,A02,083655,Staff,0,3,50,50
1651114762177,CSE 20,A01,083657,Staff,47,0,80,33
1651114768213,CSE 30,A01,083084,Eldon; John,0,38,80,80
1651114774237,CSE 100,A01,083659,Cao; Yingjun,0,72,50,50
1651114780265,CSE 134B,A01,083661,Powell; Thomas Allan,0,38,65,65
1651114786287,CSE 140,A01,083663,Staff,0,17,75,75
1651114792310,CSE 140L,A01,083088,Eldon; John,1,0,100,99
1651114798333,CSE 175,A01,083665,Kumar; Rakesh,0,0,25,25
1651114804356,CSE 190,A00,092507,Dubnov; Shlomo,9,0,20,11
1651114810388,ECE 45,A01,083139,Staff,0,8,60,60
1651114816441,ECE 65,A50,083695,Staff,0,7,30,30
1651114822476,ECE 109,A01,091882,Touri; Behrouz,32,0,70,38
1651114828499,ECE 180,A00,083140,Abi Samra; Nicholas Camill,17,0,30,13
1651114828499,ECE 180,B00,083141,Abi Samra; Nicholas Camill,0,1,30,32
1651114834615,MATH 10A,A01,083735,Patchell; Gregory David,0,0,30,30
1651114834615,MATH 10A,A02,083736,Patchell; Gregory David,26,0,30,4
1651114834615,MATH 10A,A03,083737,Patchell; Gregory David,22,0,30,8
1651114840641,MATH 10B,A01,083207,Staff,0,8,30,30
1651114840641,MATH 10B,A02,083208,Staff,0,6,30,30
1651114840641,MATH 10B,B01,083739,Staff,7,0,30,23
1651114840641,MATH 10B,B02,083740,Staff,28,0,30,2
1651114846669,MATH 18,A01,083743,Staff,0,0,30,30
1651114846669,MATH 18,A02,083744,Staff,23,0,30,7
1651114846669,MATH 18,A03,083745,Staff,19,0,30,11
1651114846669,MATH 18,A04,083746,Staff,26,0,30,4
1651114846669,MATH 18,B01,083748,Staff,0,16,30,30
1651114846669,MATH 18,B02,083749,Staff,0,15,30,30
1651114846669,MATH 18,B03,083750,Staff,0,15,30,30
1651114846669,MATH 18,B04,083751,Staff,0,15,30,30
1651114852694,MATH 20A,A01,083754,Staff,18,0,40,22
1651114858718,MATH 20B,A01,083756,Briones; Jor-el Thomas Caparas,0,14,30,30
1651114858718,MATH 20B,A02,083757,Briones; Jor-el Thomas Caparas,0,11,30,30
1651114864751,MATH 20C,A01,083760,Briones; Jor-el Thomas Caparas,1,17,30,29
1651114864751,MATH 20C,A02,083761,Briones; Jor-el Thomas Caparas,0,17,30,30
1651114864751,MATH 20C,B01,083762,Staff,7,0,30,23
1651114864751,MATH 20C,B02,083763,Staff,28,0,30,2
1651114870774,MATH 20D,A01,083765,Tran; Brian Kha,4,1,30,26
1651114870774,MATH 20D,A02,083766,Tran; Brian Kha,0,0,30,30
1651114870774,MATH 20D,A03,083767,Tran; Brian Kha,22,0,30,8
1651114876803,MATH 20E,A01,083771,Staff,0,0,30,30
1651114876803,MATH 20E,A02,083772,Staff,9,0,30,21
1651114876803,MATH 20E,B01,083773,Staff,5,0,35,30
1651114876803,MATH 20E,B02,083774,Staff,5,1,35,30
1651114882834,MATH 103A,A01,083777,Greenfeld; Be'Eri,0,17,30,30
1651114882834,MATH 103A,A02,083778,Greenfeld; Be'Eri,0,17,30,30
1651114882834,MATH 103A,B01,083779,Greenfeld; Be'Eri,0,15,30,30
1651114882834,MATH 103A,B02,083780,Greenfeld; Be'Eri,0,14,30,30
1651114888857,MATH 105,A01,085443,Staff,0,24,30,30
1651114894885,MATH 109,A01,083213,Ganzberger; Geoffrey Michael,0,8,30,30
1651114894885,MATH 109,A02,083214,Ganzberger; Geoffrey Michael,0,7,30,30
1651114894885,MATH 109,B01,083215,Ganzberger; Geoffrey Michael,0,8,30,30
1651114894885,MATH 109,B02,083216,Ganzberger; Geoffrey Michael,1,8,30,29
1651114900909,MATH 142A,A01,083219,Chow; Bennett,0,15,30,30
1651114900909,MATH 142A,A02,083220,Chow; Bennett,0,15,30,30
1651114900909,MATH 142A,B01,083221,Chow; Bennett,0,16,30,30
1651114900909,MATH 142A,B02,083222,Chow; Bennett,0,16,30,30
1651114906931,MATH 193A,A01,083224,Staff,0,9,30,30
1651114906931,MATH 193A,A02,083225,Staff,1,7,30,29
1651114906931,MATH 193A,A03,083781,Staff,0,7,30,30
1651114906931,MATH 193A,A04,083782,Staff,0,7,30,30
1651114912957,MATH 197,001,091859,McAuley; Julian John,9998,0,9999,1
1651114919017,COGS 9,A01,083615,Staff,0,20,60,60
1651114925045,COGS 11,A01,083617,Boyle; Mary E. T.,13,0,40,27
1651114931074,COGS 13,A01,083071,Staff,0,38,40,40
1651114937111,COGS 14A,A01,092681,Staff,0,40,100,100
1651114943134,COGS 14B,A01,083073,Cheng; Tzu-Han,0,11,50,50
1651114949160,COGS 17,A01,092677,Staff,8,0,75,67
1651114955184,COGS 100,A01,083619,Staff,0,30,60,60
1651114961214,COGS 101A,A01,083621,Davis; Joshua Daniel,0,29,60,60
1651114967243,COGS 101B,A01,091572,Staff,0,8,60,60
1651114973270,COGS 101C,A01,083625,Delgado; Tania,12,0,30,18
1651114979294,COGS 107A,A01,083627,Boyle; Mary E. T.,0,17,60,60
1651114985324,COGS 118A,A01,083075,Staff,0,10,60,60
1651114991350,CSE 3,A50,083646,Miranda; Gregory Joseph,15,0,38,23
1651114991350,CSE 3,A51,083647,Miranda; Gregory Joseph,36,0,37,1
1651114997374,CSE 8A,A50,083650,Miranda; Gregory Joseph,0,30,40,40
1651115003396,CSE 11,A01,083080,Cao; Yingjun,1,99,40,39
1651115009429,CSE 12,A01,083652,Staff,0,29,100,100
1651115015453,CSE 15L,A01,083654,Staff,0,3,50,50
1651115015453,CSE 15L,A02,083655,Staff,0,3,50,50
1651115021478,CSE 20,A01,083657,Staff,47,0,80,33
1651115027504,CSE 30,A01,083084,Eldon; John,0,38,80,80
1651115033526,CSE 100,A01,083659,Cao; Yingjun,0,72,50,50
1651115039556,CSE 134B,A01,083661,Powell; Thomas Allan,0,38,65,65
1651115045586,CSE 140,A01,083663,Staff,0,17,75,75
1651115051608,CSE 140L,A01,083088,Eldon; John,1,0,100,99
1651115057640,CSE 175,A01,083665,Kumar; Rakesh,0,0,25,25
1651115063663,CSE 190,A00,092507,Dubnov; Shlomo,9,0,20,11
1651115069687,ECE 45,A01,083139,Staff,0,8,60,60
1651115075709,ECE 65,A50,083695,Staff,0,7,30,30
1651115081734,ECE 109,A01,091882,Touri; Behrouz,32,0,70,38
1651115087758,ECE 180,A00,083140,Abi Samra; Nicholas Camill,17,0,30,13
1651115087758,ECE 180,B00,083141,Abi Samra; Nicholas Camill,0,1,30,32
1651115093786,MATH 10A,A01,083735,Patchell; Gregory David,0,0,30,30
1651115093786,MATH 10A,A02,083736,Patchell; Gregory David,26,0,30,4
1651115093786,MATH 10A,A03,083737,Patchell; Gregory David,22,0,30,8
1651115099815,MATH 10B,A01,083207,Staff,0,8,30,30
1651115099815,MATH 10B,A02,083208,Staff,0,6,30,30
1651115099815,MATH 10B,B01,083739,Staff,7,0,30,23
1651115099815,MATH 10B,B02,083740,Staff,28,0,30,2
1651115105845,MATH 18,A01,083743,Staff,0,0,30,30
1651115105845,MATH 18,A02,083744,Staff,23,0,30,7
1651115105845,MATH 18,A03,083745,Staff,19,0,30,11
1651115105845,MATH 18,A04,083746,Staff,26,0,30,4
1651115105845,MATH 18,B01,083748,Staff,0,16,30,30
1651115105845,MATH 18,B02,083749,Staff,0,15,30,30
1651115105845,MATH 18,B03,083750,Staff,0,15,30,30
1651115105845,MATH 18,B04,083751,Staff,0,15,30,30
1651115111868,MATH 20A,A01,083754,Staff,18,0,40,22
1651115117891,MATH 20B,A01,083756,Briones; Jor-el Thomas Caparas,0,14,30,30
1651115117891,MATH 20B,A02,083757,Briones; Jor-el Thomas Caparas,0,11,30,30
1651115123919,MATH 20C,A01,083760,Briones; Jor-el Thomas Caparas,1,17,30,29
1651115123919,MATH 20C,A02,083761,Briones; Jor-el Thomas Caparas,0,17,30,30
1651115123919,MATH 20C,B01,083762,Staff,7,0,30,23
1651115123919,MATH 20C,B02,083763,Staff,28,0,30,2
1651115129942,MATH 20D,A01,083765,Tran; Brian Kha,4,1,30,26
1651115129942,MATH 20D,A02,083766,Tran; Brian Kha,0,0,30,30
1651115129942,MATH 20D,A03,083767,Tran; Brian Kha,22,0,30,8
1651115135967,MATH 20E,A01,083771,Staff,0,0,30,30
1651115135967,MATH 20E,A02,083772,Staff,9,0,30,21
1651115135967,MATH 20E,B01,083773,Staff,5,0,35,30
1651115135967,MATH 20E,B02,083774,Staff,5,1,35,30
1651115142001,MATH 103A,A01,083777,Greenfeld; Be'Eri,0,17,30,30
1651115142001,MATH 103A,A02,083778,Greenfeld; Be'Eri,0,17,30,30
1651115142001,MATH 103A,B01,083779,Greenfeld; Be'Eri,0,15,30,30
1651115142001,MATH 103A,B02,083780,Greenfeld; Be'Eri,0,14,30,30
1651115148051,MATH 105,A01,085443,Staff,0,24,30,30
1651115154082,MATH 109,A01,083213,Ganzberger; Geoffrey Michael,0,8,30,30
1651115154082,MATH 109,A02,083214,Ganzberger; Geoffrey Michael,0,7,30,30
1651115154082,MATH 109,B01,083215,Ganzberger; Geoffrey Michael,0,8,30,30
1651115154082,MATH 109,B02,083216,Ganzberger; Geoffrey Michael,1,8,30,29
1651115160106,MATH 142A,A01,083219,Chow; Bennett,0,15,30,30
1651115160106,MATH 142A,A02,083220,Chow; Bennett,0,15,30,30
1651115160106,MATH 142A,B01,083221,Chow; Bennett,0,16,30,30
1651115160106,MATH 142A,B02,083222,Chow; Bennett,0,16,30,30
1651115166134,MATH 193A,A01,083224,Staff,0,9,30,30
1651115166134,MATH 193A,A02,083225,Staff,1,7,30,29
1651115166134,MATH 193A,A03,083781,Staff,0,7,30,30
1651115166134,MATH 193A,A04,083782,Staff,0,7,30,30
1651115172155,MATH 197,001,091859,McAuley; Julian John,9998,0,9999,1
1651115178210,COGS 9,A01,083615,Staff,0,20,60,60
1651115184235,COGS 11,A01,083617,Boyle; Mary E. T.,13,0,40,27
1651115190269,COGS 13,A01,083071,Staff,0,38,40,40
1651115196291,COGS 14A,A01,092681,Staff,0,40,100,100
1651115202317,COGS 14B,A01,083073,Cheng; Tzu-Han,0,11,50,50
1651115208342,COGS 17,A01,092677,Staff,8,0,75,67
1651115214368,COGS 100,A01,083619,Staff,0,30,60,60
1651115220392,COGS 101A,A01,083621,Davis; Joshua Daniel,0,29,60,60
1651115226419,COGS 101B,A01,091572,Staff,0,8,60,60
1651115232454,COGS 101C,A01,083625,Delgado; Tania,12,0,30,18
1651115238478,COGS 107A,A01,083627,Boyle; Mary E. T.,0,17,60,60
1651115244501,COGS 118A,A01,083075,Staff,0,10,60,60
1651115250528,CSE 3,A50,083646,Miranda; Gregory Joseph,15,0,38,23
1651115250528,CSE 3,A51,083647,Miranda; Gregory Joseph,36,0,37,1
1651115256551,CSE 8A,A50,083650,Miranda; Gregory Joseph,0,30,40,40
1651115262575,CSE 11,A01,083080,Cao; Yingjun,1,99,40,39
1651115268599,CSE 12,A01,083652,Staff,0,29,100,100
1651115274628,CSE 15L,A01,083654,Staff,0,3,50,50
1651115274628,CSE 15L,A02,083655,Staff,0,3,50,50
1651115280650,CSE 20,A01,083657,Staff,47,0,80,33
1651115286681,CSE 30,A01,083084,Eldon; John,0,38,80,80
1651115292705,CSE 100,A01,083659,Cao; Yingjun,0,72,50,50
1651115298728,CSE 134B,A01,083661,Powell; Thomas Allan,0,38,65,65
1651115304753,CSE 140,A01,083663,Staff,0,17,75,75
1651115310776,CSE 140L,A01,083088,Eldon; John,1,0,100,99
1651115316805,CSE 175,A01,083665,Kumar; Rakesh,0,0,25,25
1651115322830,CSE 190,A00,092507,Dubnov; Shlomo,9,0,20,11
1651115328867,ECE 45,A01,083139,Staff,0,8,60,60
1651115334900,ECE 65,A50,083695,Staff,0,7,30,30
1651115340930,ECE 109,A01,091882,Touri; Behrouz,32,0,70,38
1651115346961,ECE 180,A00,083140,Abi Samra; Nicholas Camill,17,0,30,13
1651115346961,ECE 180,B00,083141,Abi Samra; Nicholas Camill,0,1,30,32
1651115352989,MATH 10A,A01,083735,Patchell; Gregory David,0,0,30,30
1651115352989,MATH 10A,A02,083736,Patchell; Gregory David,26,0,30,4
1651115352989,MATH 10A,A03,083737,Patchell; Gregory David,22,0,30,8
1651115359015,MATH 10B,A01,083207,Staff,0,8,30,30
1651115359015,MATH 10B,A02,083208,Staff,0,6,30,30
1651115359015,MATH 10B,B01,083739,Staff,7,0,30,23
1651115359015,MATH 10B,B02,083740,Staff,28,0,30,2
1651115365041,MATH 18,A01,083743,Staff,0,0,30,30
1651115365041,MATH 18,A02,083744,Staff,23,0,30,7
1651115365041,MATH 18,A03,083745,Staff,19,0,30,11
1651115365041,MATH 18,A04,083746,Staff,26,0,30,4
1651115365041,MATH 18,B01,083748,Staff,0,16,30,30
1651115365041,MATH 18,B02,083749,Staff,0,15,30,30
1651115365041,MATH 18,B03,083750,Staff,0,15,30,30
1651115365041,MATH 18,B04,083751,Staff,0,15,30,30
1651115371066,MATH 20A,A01,083754,Staff,18,0,40,22
1651115377092,MATH 20B,A01,083756,Briones; Jor-el Thomas Caparas,0,14,30,30
1651115377092,MATH 20B,A02,083757,Briones; Jor-el Thomas Caparas,0,11,30,30
1651115383117,MATH 20C,A01,083760,Briones; Jor-el Thomas Caparas,1,17,30,29
1651115383117,MATH 20C,A02,083761,Briones; Jor-el Thomas Caparas,0,17,30,30
1651115383117,MATH 20C,B01,083762,Staff,7,0,30,23
1651115383117,MATH 20C,B02,083763,Staff,28,0,30,2
1651115389139,MATH 20D,A01,083765,Tran; Brian Kha,4,1,30,26
1651115389139,MATH 20D,A02,083766,Tran; Brian Kha,0,0,30,30
1651115389139,MATH 20D,A03,083767,Tran; Brian Kha,22,0,30,8
1651115395171,MATH 20E,A01,083771,Staff,0,0,30,30
1651115395171,MATH 20E,A02,083772,Staff,9,0,30,21
1651115395171,MATH 20E,B01,083773,Staff,5,0,35,30
1651115395171,MATH 20E,B02,083774,Staff,5,1,35,30
1651115401198,MATH 103A,A01,083777,Greenfeld; Be'Eri,0,17,30,30
1651115401198,MATH 103A,A02,083778,Greenfeld; Be'Eri,0,17,30,30
1651115401198,MATH 103A,B01,083779,Greenfeld; Be'Eri,0,15,30,30
1651115401198,MATH 103A,B02,083780,Greenfeld; Be'Eri,0,14,30,30
1651115407231,MATH 105,A01,085443,Staff,0,24,30,30
1651115413261,MATH 109,A01,083213,Ganzberger; Geoffrey Michael,0,8,30,30
1651115413261,MATH 109,A02,083214,Ganzberger; Geoffrey Michael,0,7,30,30
1651115413261,MATH 109,B01,083215,Ganzberger; Geoffrey Michael,0,8,30,30
1651115413261,MATH 109,B02,083216,Ganzberger; Geoffrey Michael,1,8,30,29
1651115419285,MATH 142A,A01,083219,Chow; Bennett,0,15,30,30
1651115419285,MATH 142A,A02,083220,Chow; Bennett,0,15,30,30
1651115419285,MATH 142A,B01,083221,Chow; Bennett,0,16,30,30
1651115419285,MATH 142A,B02,083222,Chow; Bennett,0,16,30,30
1651115425311,MATH 193A,A01,083224,Staff,0,9,30,30
1651115425311,MATH 193A,A02,083225,Staff,1,7,30,29
1651115425311,MATH 193A,A03,083781,Staff,0,7,30,30
1651115425311,MATH 193A,A04,083782,Staff,0,7,30,30
1651115431428,MATH 197,001,091859,McAuley; Julian John,9998,0,9999,1
1651115437485,COGS 9,A01,083615,Staff,0,20,60,60
1651115443512,COGS 11,A01,083617,Boyle; Mary E. T.,13,0,40,27
1651115449537,COGS 13,A01,083071,Staff,0,38,40,40
1651115455564,COGS 14A,A01,092681,Staff,0,40,100,100
1651115461588,COGS 14B,A01,083073,Cheng; Tzu-Han,0,11,50,50
1651115467611,COGS 17,A01,092677,Staff,8,0,75,67
1651115473634,COGS 100,A01,083619,Staff,0,30,60,60
1651115479668,COGS 101A,A01,083621,Davis; Joshua Daniel,0,29,60,60
1651115485695,COGS 101B,A01,091572,Staff,0,8,60,60
1651115491719,COGS 101C,A01,083625,Delgado; Tania,12,0,30,18
1651115497743,COGS 107A,A01,083627,Boyle; Mary E. T.,0,17,60,60
1651115503769,COGS 118A,A01,083075,Staff,0,10,60,60
1651115509796,CSE 3,A50,083646,Miranda; Gregory Joseph,15,0,38,23
1651115509796,CSE 3,A51,083647,Miranda; Gregory Joseph,36,0,37,1
1651115515823,CSE 8A,A50,083650,Miranda; Gregory Joseph,0,30,40,40
1651115521851,CSE 11,A01,083080,Cao; Yingjun,1,99,40,39
1651115527875,CSE 12,A01,083652,Staff,0,29,100,100
1651115533902,CSE 15L,A01,083654,Staff,0,3,50,50
1651115533902,CSE 15L,A02,083655,Staff,0,3,50,50
1651115539928,CSE 20,A01,083657,Staff,47,0,80,33
1651115545958,CSE 30,A01,083084,Eldon; John,0,38,80,80
1651115551984,CSE 100,A01,083659,Cao; Yingjun,0,72,50,50
1651115558011,CSE 134B,A01,083661,Powell; Thomas Allan,0,38,65,65
1651115564033,CSE 140,A01,083663,Staff,0,17,75,75
1651115570057,CSE 140L,A01,083088,Eldon; John,1,0,100,99
1651115576083,CSE 175,A01,083665,Kumar; Rakesh,0,0,25,25
1651115582106,CSE 190,A00,092507,Dubnov; Shlomo,9,0,20,11
1651115588129,ECE 45,A01,083139,Staff,0,8,60,60
1651115594152,ECE 65,A50,083695,Staff,0,7,30,30
1651115600178,ECE 109,A01,091882,Touri; Behrouz,32,0,70,38
1651115606211,ECE 180,A00,083140,Abi Samra; Nicholas Camill,17,0,30,13
1651115606211,ECE 180,B00,083141,Abi Samra; Nicholas Camill,0,1,30,32
1651115612233,MATH 10A,A01,083735,Patchell; Gregory David,0,0,30,30
1651115612233,MATH 10A,A02,083736,Patchell; Gregory David,26,0,30,4
1651115612233,MATH 10A,A03,083737,Patchell; Gregory David,22,0,30,8
1651115618261,MATH 10B,A01,083207,Staff,0,8,30,30
1651115618261,MATH 10B,A02,083208,Staff,0,6,30,30
1651115618261,MATH 10B,B01,083739,Staff,7,0,30,23
1651115618261,MATH 10B,B02,083740,Staff,28,0,30,2
1651115624290,MATH 18,A01,083743,Staff,0,0,30,30
1651115624290,MATH 18,A02,083744,Staff,23,0,30,7
1651115624290,MATH 18,A03,083745,Staff,19,0,30,11
1651115624290,MATH 18,A04,083746,Staff,26,0,30,4
1651115624290,MATH 18,B01,083748,Staff,0,16,30,30
1651115624290,MATH 18,B02,083749,Staff,0,15,30,30
1651115624290,MATH 18,B03,083750,Staff,0,15,30,30
1651115624290,MATH 18,B04,083751,Staff,0,15,30,30
1651115630313,MATH 20A,A01,083754,Staff,18,0,40,22
1651115636340,MATH 20B,A01,083756,Briones; Jor-el Thomas Caparas,0,14,30,30
1651115636340,MATH 20B,A02,083757,Briones; Jor-el Thomas Caparas,0,11,30,30
1651115642363,MATH 20C,A01,083760,Briones; Jor-el Thomas Caparas,1,17,30,29
1651115642363,MATH 20C,A02,083761,Briones; Jor-el Thomas Caparas,0,17,30,30
1651115642363,MATH 20C,B01,083762,Staff,7,0,30,23
1651115642363,MATH 20C,B02,083763,Staff,28,0,30,2
1651115648389,MATH 20D,A01,083765,Tran; Brian Kha,4,1,30,26
1651115648389,MATH 20D,A02,083766,Tran; Brian Kha,0,0,30,30
1651115648389,MATH 20D,A03,083767,Tran; Brian Kha,22,0,30,8
1651115654415,MATH 20E,A01,083771,Staff,0,0,30,30
1651115654415,MATH 20E,A02,083772,Staff,9,0,30,21
1651115654415,MATH 20E,B01,083773,Staff,5,0,35,30
1651115654415,MATH 20E,B02,083774,Staff,5,1,35,30
1651115660437,MATH 103A,A01,083777,Greenfeld; Be'Eri,0,17,30,30
1651115660437,MATH 103A,A02,083778,Greenfeld; Be'Eri,0,17,30,30
1651115660437,MATH 103A,B01,083779,Greenfeld; Be'Eri,0,15,30,30
1651115660437,MATH 103A,B02,083780,Greenfeld; Be'Eri,0,14,30,30
1651115666477,MATH 105,A01,085443,Staff,0,24,30,30
1651115672504,MATH 109,A01,083213,Ganzberger; Geoffrey Michael,0,8,30,30
1651115672504,MATH 109,A02,083214,Ganzberger; Geoffrey Michael,0,7,30,30
1651115672504,MATH 109,B01,083215,Ganzberger; Geoffrey Michael,0,8,30,30
1651115672504,MATH 109,B02,083216,Ganzberger; Geoffrey Michael,1,8,30,29
1651115678527,MATH 142A,A01,083219,Chow; Bennett,0,15,30,30
1651115678527,MATH 142A,A02,083220,Chow; Bennett,0,15,30,30
1651115678527,MATH 142A,B01,083221,Chow; Bennett,0,16,30,30
1651115678527,MATH 142A,B02,083222,Chow; Bennett,0,16,30,30
1651115684548,MATH 193A,A01,083224,Staff,0,9,30,30
1651115684548,MATH 193A,A02,083225,Staff,1,7,30,29
1651115684548,MATH 193A,A03,083781,Staff,0,7,30,30
1651115684548,MATH 193A,A04,083782,Staff,0,7,30,30
1651115690574,MATH 197,001,091859,McAuley; Julian John,9998,0,9999,1
1651115696629,COGS 9,A01,083615,Staff,0,20,60,60
1651115702652,COGS 11,A01,083617,Boyle; Mary E. T.,13,0,40,27
1651115708680,COGS 13,A01,083071,Staff,0,38,40,40
1651115714703,COGS 14A,A01,092681,Staff,0,40,100,100
1651115720728,COGS 14B,A01,083073,Cheng; Tzu-Han,0,11,50,50
1651115726764,COGS 17,A01,092677,Staff,8,0,75,67
1651115732795,COGS 100,A01,083619,Staff,0,30,60,60
1651115738818,COGS 101A,A01,083621,Davis; Joshua Daniel,0,29,60,60
1651115744845,COGS 101B,A01,091572,Staff,0,8,60,60
1651115750876,COGS 101C,A01,083625,Delgado; Tania,12,0,30,18
1651115756898,COGS 107A,A01,083627,Boyle; Mary E. T.,0,17,60,60
1651115762924,COGS 118A,A01,083075,Staff,0,10,60,60
1651115768947,CSE 3,A50,083646,Miranda; Gregory Joseph,15,0,38,23
1651115768947,CSE 3,A51,083647,Miranda; Gregory Joseph,36,0,37,1
1651115774980,CSE 8A,A50,083650,Miranda; Gregory Joseph,0,30,40,40
1651115781013,CSE 11,A01,083080,Cao; Yingjun,1,99,40,39
1651115787037,CSE 12,A01,083652,Staff,0,29,100,100
1651115793061,CSE 15L,A01,083654,Staff,0,3,50,50
1651115793061,CSE 15L,A02,083655,Staff,0,3,50,50
1651115799087,CSE 20,A01,083657,Staff,47,0,80,33
1651115805113,CSE 30,A01,083084,Eldon; John,0,38,80,80
1651115811140,CSE 100,A01,083659,Cao; Yingjun,0,72,50,50
1651115817171,CSE 134B,A01,083661,Powell; Thomas Allan,0,38,65,65
1651115823194,CSE 140,A01,083663,Staff,0,17,75,75
1651115829218,CSE 140L,A01,083088,Eldon; John,1,0,100,99
1651115835245,CSE 175,A01,083665,Kumar; Rakesh,0,0,25,25
1651115841266,CSE 190,A00,092507,Dubnov; Shlomo,9,0,20,11
1651115847297,ECE 45,A01,083139,Staff,0,8,60,60
1651115853323,ECE 65,A50,083695,Staff,0,7,30,30
1651115859345,ECE 109,A01,091882,Touri; Behrouz,32,0,70,38
1651115865369,ECE 180,A00,083140,Abi Samra; Nicholas Camill,17,0,30,13
1651115865369,ECE 180,B00,083141,Abi Samra; Nicholas Camill,0,1,30,32
1651115871392,MATH 10A,A01,083735,Patchell; Gregory David,0,0,30,30
1651115871392,MATH 10A,A02,083736,Patchell; Gregory David,26,0,30,4
1651115871392,MATH 10A,A03,083737,Patchell; Gregory David,22,0,30,8
1651115877420,MATH 10B,A01,083207,Staff,0,8,30,30
1651115877420,MATH 10B,A02,083208,Staff,0,6,30,30
1651115877420,MATH 10B,B01,083739,Staff,7,0,30,23
1651115877420,MATH 10B,B02,083740,Staff,28,0,30,2
1651115883443,MATH 18,A01,083743,Staff,0,0,30,30
1651115883443,MATH 18,A02,083744,Staff,23,0,30,7
1651115883443,MATH 18,A03,083745,Staff,19,0,30,11
1651115883443,MATH 18,A04,083746,Staff,26,0,30,4
1651115883443,MATH 18,B01,083748,Staff,0,16,30,30
1651115883443,MATH 18,B02,083749,Staff,0,15,30,30
1651115883443,MATH 18,B03,083750,Staff,0,15,30,30
1651115883443,MATH 18,B04,083751,Staff,0,15,30,30
1651115889465,MATH 20A,A01,083754,Staff,18,0,40,22
1651115895489,MATH 20B,A01,083756,Briones; Jor-el Thomas Caparas,0,14,30,30
1651115895489,MATH 20B,A02,083757,Briones; Jor-el Thomas Caparas,0,11,30,30
1651115901512,MATH 20C,A01,083760,Briones; Jor-el Thomas Caparas,1,17,30,29
1651115901512,MATH 20C,A02,083761,Briones; Jor-el Thomas Caparas,0,17,30,30
1651115901512,MATH 20C,B01,083762,Staff,6,0,30,24
1651115901512,MATH 20C,B02,083763,Staff,28,0,30,2
1651115907535,MATH 20D,A01,083765,Tran; Brian Kha,4,1,30,26
1651115907535,MATH 20D,A02,083766,Tran; Brian Kha,0,0,30,30
1651115907535,MATH 20D,A03,083767,Tran; Brian Kha,22,0,30,8
1651115913558,MATH 20E,A01,083771,Staff,0,0,30,30
1651115913558,MATH 20E,A02,083772,Staff,9,0,30,21
1651115913558,MATH 20E,B01,083773,Staff,5,0,35,30
1651115913558,MATH 20E,B02,083774,Staff,5,1,35,30
1651115919581,MATH 103A,A01,083777,Greenfeld; Be'Eri,0,17,30,30
1651115919581,MATH 103A,A02,083778,Greenfeld; Be'Eri,0,17,30,30
1651115919581,MATH 103A,B01,083779,Greenfeld; Be'Eri,0,15,30,30
1651115919581,MATH 103A,B02,083780,Greenfeld; Be'Eri,0,14,30,30
1651115925604,MATH 105,A01,085443,Staff,0,24,30,30
1651115931630,MATH 109,A01,083213,Ganzberger; Geoffrey Michael,0,8,30,30
1651115931630,MATH 109,A02,083214,Ganzberger; Geoffrey Michael,0,7,30,30
1651115931630,MATH 109,B01,083215,Ganzberger; Geoffrey Michael,0,8,30,30
1651115931630,MATH 109,B02,083216,Ganzberger; Geoffrey Michael,1,8,30,29
1651115937653,MATH 142A,A01,083219,Chow; Bennett,0,15,30,30
1651115937653,MATH 142A,A02,083220,Chow; Bennett,0,15,30,30
1651115937653,MATH 142A,B01,083221,Chow; Bennett,0,16,30,30
1651115937653,MATH 142A,B02,083222,Chow; Bennett,0,16,30,30
1651115943676,MATH 193A,A01,083224,Staff,0,9,30,30
1651115943676,MATH 193A,A02,083225,Staff,1,7,30,29
1651115943676,MATH 193A,A03,083781,Staff,0,7,30,30
1651115943676,MATH 193A,A04,083782,Staff,0,7,30,30
1651115949700,MATH 197,001,091859,McAuley; Julian John,9998,0,9999,1
1651115955757,COGS 9,A01,083615,Staff,0,20,60,60
1651115961780,COGS 11,A01,083617,Boyle; Mary E. T.,13,0,40,27
1651115967803,COGS 13,A01,083071,Staff,0,38,40,40
1651115980417,COGS 14A,A01,092681,Staff,0,40,100,100
1651115986451,COGS 14B,A01,083073,Cheng; Tzu-Han,0,11,50,50
1651115992478,COGS 17,A01,092677,Staff,8,0,75,67
1651115998503,COGS 100,A01,083619,Staff,0,30,60,60
1651116004526,COGS 101A,A01,083621,Davis; Joshua Daniel,0,29,60,60
1651116010597,COGS 101B,A01,091572,Staff,0,8,60,60
1651116016622,COGS 101C,A01,083625,Delgado; Tania,12,0,30,18
1651116022648,COGS 107A,A01,083627,Boyle; Mary E. T.,0,17,60,60
1651116028744,COGS 118A,A01,083075,Staff,0,10,60,60
1651116034768,CSE 3,A50,083646,Miranda; Gregory Joseph,15,0,38,23
1651116034768,CSE 3,A51,083647,Miranda; Gregory Joseph,36,0,37,1
1651116040790,CSE 8A,A50,083650,Miranda; Gregory Joseph,0,30,40,40
1651116046816,CSE 11,A01,083080,Cao; Yingjun,1,99,40,39
1651116052839,CSE 12,A01,083652,Staff,0,29,100,100
1651116058862,CSE 15L,A01,083654,Staff,0,3,50,50
1651116058862,CSE 15L,A02,083655,Staff,0,3,50,50
1651116064885,CSE 20,A01,083657,Staff,47,0,80,33
1651116070913,CSE 30,A01,083084,Eldon; John,0,38,80,80
1651116076940,CSE 100,A01,083659,Cao; Yingjun,0,72,50,50
1651116082966,CSE 134B,A01,083661,Powell; Thomas Allan,0,38,65,65
1651116088988,CSE 140,A01,083663,Staff,0,17,75,75
1651116095012,CSE 140L,A01,083088,Eldon; John,1,0,100,99
1651116101039,CSE 175,A01,083665,Kumar; Rakesh,0,0,25,25
1651116107070,CSE 190,A00,092507,Dubnov; Shlomo,9,0,20,11
1651116113095,ECE 45,A01,083139,Staff,0,8,60,60
1651116119122,ECE 65,A50,083695,Staff,0,7,30,30
1651116125147,ECE 109,A01,091882,Touri; Behrouz,32,0,70,38
1651116131173,ECE 180,A00,083140,Abi Samra; Nicholas Camill,17,0,30,13
1651116131173,ECE 180,B00,083141,Abi Samra; Nicholas Camill,0,1,30,32
1651116137200,MATH 10A,A01,083735,Patchell; Gregory David,0,0,30,30
1651116137200,MATH 10A,A02,083736,Patchell; Gregory David,26,0,30,4
1651116137200,MATH 10A,A03,083737,Patchell; Gregory David,22,0,30,8
1651116143224,MATH 10B,A01,083207,Staff,0,8,30,30
1651116143224,MATH 10B,A02,083208,Staff,0,6,30,30
1651116143224,MATH 10B,B01,083739,Staff,7,0,30,23
1651116143224,MATH 10B,B02,083740,Staff,28,0,30,2
1651116149249,MATH 18,A01,083743,Staff,0,0,30,30
1651116149249,MATH 18,A02,083744,Staff,23,0,30,7
1651116149249,MATH 18,A03,083745,Staff,19,0,30,11
1651116149249,MATH 18,A04,083746,Staff,26,0,30,4
1651116149249,MATH 18,B01,083748,Staff,0,16,30,30
1651116149249,MATH 18,B02,083749,Staff,0,15,30,30
1651116149249,MATH 18,B03,083750,Staff,0,15,30,30
1651116149249,MATH 18,B04,083751,Staff,0,15,30,30
1651116155273,MATH 20A,A01,083754,Staff,18,0,40,22
1651116161297,MATH 20B,A01,083756,Briones; Jor-el Thomas Caparas,0,14,30,30
1651116161297,MATH 20B,A02,083757,Briones; Jor-el Thomas Caparas,0,11,30,30
1651116167321,MATH 20C,A01,083760,Briones; Jor-el Thomas Caparas,1,17,30,29
1651116167321,MATH 20C,A02,083761,Briones; Jor-el Thomas Caparas,0,17,30,30
1651116167321,MATH 20C,B01,083762,Staff,6,0,30,24
1651116167321,MATH 20C,B02,083763,Staff,28,0,30,2
1651116173352,MATH 20D,A01,083765,Tran; Brian Kha,4,1,30,26
1651116173352,MATH 20D,A02,083766,Tran; Brian Kha,0,0,30,30
1651116173352,MATH 20D,A03,083767,Tran; Brian Kha,22,0,30,8
1651116179378,MATH 20E,A01,083771,Staff,0,0,30,30
1651116179378,MATH 20E,A02,083772,Staff,9,0,30,21
1651116179378,MATH 20E,B01,083773,Staff,5,0,35,30
1651116179378,MATH 20E,B02,083774,Staff,5,1,35,30
1651116185410,MATH 103A,A01,083777,Greenfeld; Be'Eri,0,17,30,30
1651116185410,MATH 103A,A02,083778,Greenfeld; Be'Eri,0,17,30,30
1651116185410,MATH 103A,B01,083779,Greenfeld; Be'Eri,0,15,30,30
1651116185410,MATH 103A,B02,083780,Greenfeld; Be'Eri,0,14,30,30
1651116191435,MATH 105,A01,085443,Staff,0,24,30,30
1651116197458,MATH 109,A01,083213,Ganzberger; Geoffrey Michael,0,8,30,30
1651116197458,MATH 109,A02,083214,Ganzberger; Geoffrey Michael,0,7,30,30
1651116197458,MATH 109,B01,083215,Ganzberger; Geoffrey Michael,0,8,30,30
1651116197458,MATH 109,B02,083216,Ganzberger; Geoffrey Michael,1,8,30,29
1651116203486,MATH 142A,A01,083219,Chow; Bennett,0,15,30,30
1651116203486,MATH 142A,A02,083220,Chow; Bennett,0,15,30,30
1651116203486,MATH 142A,B01,083221,Chow; Bennett,0,16,30,30
1651116203486,MATH 142A,B02,083222,Chow; Bennett,0,16,30,30
1651116209510,MATH 193A,A01,083224,Staff,0,9,30,30
1651116209510,MATH 193A,A02,083225,Staff,1,7,30,29
1651116209510,MATH 193A,A03,083781,Staff,0,7,30,30
1651116209510,MATH 193A,A04,083782,Staff,0,7,30,30
1651116215534,MATH 197,001,091859,McAuley; Julian John,9998,0,9999,1
1651116221596,COGS 9,A01,083615,Staff,0,20,60,60
1651116227626,COGS 11,A01,083617,Boyle; Mary E. T.,13,0,40,27
1651116233651,COGS 13,A01,083071,Staff,0,38,40,40
1651116239672,COGS 14A,A01,092681,Staff,0,40,100,100
1651116245707,COGS 14B,A01,083073,Cheng; Tzu-Han,0,11,50,50
1651116251732,COGS 17,A01,092677,Staff,8,0,75,67
1651116257760,COGS 100,A01,083619,Staff,0,30,60,60
1651116263783,COGS 101A,A01,083621,Davis; Joshua Daniel,0,29,60,60
1651116269823,COGS 101B,A01,091572,Staff,0,8,60,60
1651116275846,COGS 101C,A01,083625,Delgado; Tania,12,0,30,18
1651116281872,COGS 107A,A01,083627,Boyle; Mary E. T.,0,17,60,60
1651116287897,COGS 118A,A01,083075,Staff,0,10,60,60
1651116293921,CSE 3,A50,083646,Miranda; Gregory Joseph,15,0,38,23
1651116293921,CSE 3,A51,083647,Miranda; Gregory Joseph,36,0,37,1
1651116299948,CSE 8A,A50,083650,Miranda; Gregory Joseph,0,30,40,40
1651116305971,CSE 11,A01,083080,Cao; Yingjun,1,99,40,39
1651116311997,CSE 12,A01,083652,Staff,0,29,100,100
1651116318031,CSE 15L,A01,083654,Staff,0,3,50,50
1651116318031,CSE 15L,A02,083655,Staff,0,3,50,50
1651116324057,CSE 20,A01,083657,Staff,47,0,80,33
1651116330080,CSE 30,A01,083084,Eldon; John,0,38,80,80
1651116336105,CSE 100,A01,083659,Cao; Yingjun,0,72,50,50
1651116342128,CSE 134B,A01,083661,Powell; Thomas Allan,0,38,65,65
1651116348153,CSE 140,A01,083663,Staff,0,17,75,75
1651116354180,CSE 140L,A01,083088,Eldon; John,1,0,100,99
1651116360203,CSE 175,A01,083665,Kumar; Rakesh,0,0,25,25
1651116366225,CSE 190,A00,092507,Dubnov; Shlomo,9,0,20,11
1651116372251,ECE 45,A01,083139,Staff,0,8,60,60
1651116378275,ECE 65,A50,083695,Staff,0,7,30,30
1651116384302,ECE 109,A01,091882,Touri; Behrouz,32,0,70,38
1651116390328,ECE 180,A00,083140,Abi Samra; Nicholas Camill,17,0,30,13
1651116390328,ECE 180,B00,083141,Abi Samra; Nicholas Camill,0,1,30,32
1651116396355,MATH 10A,A01,083735,Patchell; Gregory David,0,0,30,30
1651116396355,MATH 10A,A02,083736,Patchell; Gregory David,26,0,30,4
1651116396355,MATH 10A,A03,083737,Patchell; Gregory David,22,0,30,8
1651116402384,MATH 10B,A01,083207,Staff,0,8,30,30
1651116402384,MATH 10B,A02,083208,Staff,0,6,30,30
1651116402384,MATH 10B,B01,083739,Staff,7,0,30,23
1651116402384,MATH 10B,B02,083740,Staff,28,0,30,2
1651116408410,MATH 18,A01,083743,Staff,0,0,30,30
1651116408410,MATH 18,A02,083744,Staff,23,0,30,7
1651116408410,MATH 18,A03,083745,Staff,19,0,30,11
1651116408410,MATH 18,A04,083746,Staff,26,0,30,4
1651116408410,MATH 18,B01,083748,Staff,0,16,30,30
1651116408410,MATH 18,B02,083749,Staff,0,15,30,30
1651116408410,MATH 18,B03,083750,Staff,0,15,30,30
1651116408410,MATH 18,B04,083751,Staff,0,15,30,30
1651116414433,MATH 20A,A01,083754,Staff,18,0,40,22
1651116420457,MATH 20B,A01,083756,Briones; Jor-el Thomas Caparas,0,14,30,30
1651116420457,MATH 20B,A02,083757,Briones; Jor-el Thomas Caparas,0,11,30,30
1651116426481,MATH 20C,A01,083760,Briones; Jor-el Thomas Caparas,1,17,30,29
1651116426481,MATH 20C,A02,083761,Briones; Jor-el Thomas Caparas,0,17,30,30
1651116426481,MATH 20C,B01,083762,Staff,6,0,30,24
1651116426481,MATH 20C,B02,083763,Staff,28,0,30,2
1651116432517,MATH 20D,A01,083765,Tran; Brian Kha,4,1,30,26
1651116432517,MATH 20D,A02,083766,Tran; Brian Kha,0,0,30,30
1651116432517,MATH 20D,A03,083767,Tran; Brian Kha,22,0,30,8
1651116438556,MATH 20E,A01,083771,Staff,0,0,30,30
1651116438556,MATH 20E,A02,083772,Staff,9,0,30,21
1651116438556,MATH 20E,B01,083773,Staff,5,0,35,30
1651116438556,MATH 20E,B02,083774,Staff,5,1,35,30
1651116444580,MATH 103A,A01,083777,Greenfeld; Be'Eri,0,17,30,30
1651116444580,MATH 103A,A02,083778,Greenfeld; Be'Eri,0,17,30,30
1651116444580,MATH 103A,B01,083779,Greenfeld; Be'Eri,0,15,30,30
1651116444580,MATH 103A,B02,083780,Greenfeld; Be'Eri,0,14,30,30
1651116450604,MATH 105,A01,085443,Staff,0,24,30,30
1651116456626,MATH 109,A01,083213,Ganzberger; Geoffrey Michael,0,8,30,30
1651116456626,MATH 109,A02,083214,Ganzberger; Geoffrey Michael,0,7,30,30
1651116456626,MATH 109,B01,083215,Ganzberger; Geoffrey Michael,0,8,30,30
1651116456626,MATH 109,B02,083216,Ganzberger; Geoffrey Michael,1,8,30,29
1651116462648,MATH 142A,A01,083219,Chow; Bennett,0,15,30,30
1651116462648,MATH 142A,A02,083220,Chow; Bennett,0,15,30,30
1651116462648,MATH 142A,B01,083221,Chow; Bennett,0,16,30,30
1651116462648,MATH 142A,B02,083222,Chow; Bennett,0,16,30,30
1651116468674,MATH 193A,A01,083224,Staff,0,9,30,30
1651116468674,MATH 193A,A02,083225,Staff,1,7,30,29
1651116468674,MATH 193A,A03,083781,Staff,0,7,30,30
1651116468674,MATH 193A,A04,083782,Staff,0,7,30,30
1651116474697,MATH 197,001,091859,McAuley; Julian John,9998,0,9999,1
1651116480761,COGS 9,A01,083615,Staff,0,20,60,60
1651116486785,COGS 11,A01,083617,Boyle; Mary E. T.,13,0,40,27
1651116492825,COGS 13,A01,083071,Staff,0,38,40,40
1651116498848,COGS 14A,A01,092681,Staff,0,40,100,100
1651116504873,COGS 14B,A01,083073,Cheng; Tzu-Han,0,11,50,50
1651116510897,COGS 17,A01,092677,Staff,8,0,75,67
1651116516921,COGS 100,A01,083619,Staff,0,30,60,60
1651116522945,COGS 101A,A01,083621,Davis; Joshua Daniel,0,29,60,60
1651116528968,COGS 101B,A01,091572,Staff,0,8,60,60
1651116534992,COGS 101C,A01,083625,Delgado; Tania,12,0,30,18
1651116541014,COGS 107A,A01,083627,Boyle; Mary E. T.,0,17,60,60
1651116547042,COGS 118A,A01,083075,Staff,0,10,60,60
1651116553064,CSE 3,A50,083646,Miranda; Gregory Joseph,15,0,38,23
1651116553064,CSE 3,A51,083647,Miranda; Gregory Joseph,36,0,37,1
1651116559086,CSE 8A,A50,083650,Miranda; Gregory Joseph,0,30,40,40
1651116565109,CSE 11,A01,083080,Cao; Yingjun,1,99,40,39
1651116571144,CSE 12,A01,083652,Staff,0,29,100,100
1651116577167,CSE 15L,A01,083654,Staff,0,3,50,50
1651116577167,CSE 15L,A02,083655,Staff,0,3,50,50
1651116583192,CSE 20,A01,083657,Staff,47,0,80,33
1651116589215,CSE 30,A01,083084,Eldon; John,0,38,80,80
1651116595242,CSE 100,A01,083659,Cao; Yingjun,0,72,50,50
1651116601264,CSE 134B,A01,083661,Powell; Thomas Allan,0,38,65,65
1651116607289,CSE 140,A01,083663,Staff,0,17,75,75
1651116613316,CSE 140L,A01,083088,Eldon; John,1,0,100,99
1651116619336,CSE 175,A01,083665,Kumar; Rakesh,0,0,25,25
1651116625464,CSE 190,A00,092507,Dubnov; Shlomo,9,0,20,11
1651116631496,ECE 45,A01,083139,Staff,0,8,60,60
1651116637531,ECE 65,A50,083695,Staff,0,7,30,30
1651116643556,ECE 109,A01,091882,Touri; Behrouz,32,0,70,38
1651116649583,ECE 180,A00,083140,Abi Samra; Nicholas Camill,17,0,30,13
1651116649583,ECE 180,B00,083141,Abi Samra; Nicholas Camill,0,1,30,32
1651116655616,MATH 10A,A01,083735,Patchell; Gregory David,0,0,30,30
1651116655616,MATH 10A,A02,083736,Patchell; Gregory David,26,0,30,4
1651116655616,MATH 10A,A03,083737,Patchell; Gregory David,22,0,30,8
1651116661645,MATH 10B,A01,083207,Staff,0,8,30,30
1651116661645,MATH 10B,A02,083208,Staff,0,6,30,30
1651116661645,MATH 10B,B01,083739,Staff,7,0,30,23
1651116661645,MATH 10B,B02,083740,Staff,28,0,30,2
1651116667679,MATH 18,A01,083743,Staff,0,0,30,30
1651116667679,MATH 18,A02,083744,Staff,23,0,30,7
1651116667679,MATH 18,A03,083745,Staff,19,0,30,11
1651116667679,MATH 18,A04,083746,Staff,26,0,30,4
1651116667679,MATH 18,B01,083748,Staff,0,16,30,30
1651116667679,MATH 18,B02,083749,Staff,0,15,30,30
1651116667679,MATH 18,B03,083750,Staff,0,15,30,30
1651116667679,MATH 18,B04,083751,Staff,0,15,30,30
1651116673713,MATH 20A,A01,083754,Staff,18,0,40,22
1651116679740,MATH 20B,A01,083756,Briones; Jor-el Thomas Caparas,0,14,30,30
1651116679740,MATH 20B,A02,083757,Briones; Jor-el Thomas Caparas,0,11,30,30
1651116685770,MATH 20C,A01,083760,Briones; Jor-el Thomas Caparas,1,17,30,29
1651116685770,MATH 20C,A02,083761,Briones; Jor-el Thomas Caparas,0,17,30,30
1651116685770,MATH 20C,B01,083762,Staff,6,0,30,24
1651116685770,MATH 20C,B02,083763,Staff,28,0,30,2
1651116691796,MATH 20D,A01,083765,Tran; Brian Kha,4,1,30,26
1651116691796,MATH 20D,A02,083766,Tran; Brian Kha,0,0,30,30
1651116691796,MATH 20D,A03,083767,Tran; Brian Kha,22,0,30,8
1651116697824,MATH 20E,A01,083771,Staff,0,0,30,30
1651116697824,MATH 20E,A02,083772,Staff,9,0,30,21
1651116697824,MATH 20E,B01,083773,Staff,5,0,35,30
1651116697824,MATH 20E,B02,083774,Staff,5,1,35,30
1651116703848,MATH 103A,A01,083777,Greenfeld; Be'Eri,0,17,30,30
1651116703848,MATH 103A,A02,083778,Greenfeld; Be'Eri,0,17,30,30
1651116703848,MATH 103A,B01,083779,Greenfeld; Be'Eri,0,15,30,30
1651116703848,MATH 103A,B02,083780,Greenfeld; Be'Eri,0,14,30,30
1651116709871,MATH 105,A01,085443,Staff,0,24,30,30
1651116715896,MATH 109,A01,083213,Ganzberger; Geoffrey Michael,0,8,30,30
1651116715896,MATH 109,A02,083214,Ganzberger; Geoffrey Michael,0,7,30,30
1651116715896,MATH 109,B01,083215,Ganzberger; Geoffrey Michael,0,8,30,30
1651116715896,MATH 109,B02,083216,Ganzberger; Geoffrey Michael,1,8,30,29
1651116721924,MATH 142A,A01,083219,Chow; Bennett,0,15,30,30
1651116721924,MATH 142A,A02,083220,Chow; Bennett,0,15,30,30
1651116721924,MATH 142A,B01,083221,Chow; Bennett,0,16,30,30
1651116721924,MATH 142A,B02,083222,Chow; Bennett,0,16,30,30
1651116727945,MATH 193A,A01,083224,Staff,0,9,30,30
1651116727945,MATH 193A,A02,083225,Staff,1,7,30,29
1651116727945,MATH 193A,A03,083781,Staff,0,7,30,30
1651116727945,MATH 193A,A04,083782,Staff,0,7,30,30
1651116733971,MATH 197,001,091859,McAuley; Julian John,9998,0,9999,1
1651116740029,COGS 9,A01,083615,Staff,0,20,60,60
1651116746064,COGS 11,A01,083617,Boyle; Mary E. T.,13,0,40,27
1651116752088,COGS 13,A01,083071,Staff,0,38,40,40
1651116758110,COGS 14A,A01,092681,Staff,0,40,100,100
1651116764134,COGS 14B,A01,083073,Cheng; Tzu-Han,0,11,50,50
1651116770157,COGS 17,A01,092677,Staff,8,0,75,67
1651116776184,COGS 100,A01,083619,Staff,0,30,60,60
1651116782209,COGS 101A,A01,083621,Davis; Joshua Daniel,0,29,60,60
1651116788243,COGS 101B,A01,091572,Staff,0,8,60,60
1651116794266,COGS 101C,A01,083625,Delgado; Tania,12,0,30,18
1651116800289,COGS 107A,A01,083627,Boyle; Mary E. T.,0,17,60,60
1651116806311,COGS 118A,A01,083075,Staff,0,10,60,60
1651116812335,CSE 3,A50,083646,Miranda; Gregory Joseph,15,0,38,23
1651116812335,CSE 3,A51,083647,Miranda; Gregory Joseph,36,0,37,1
1651116818359,CSE 8A,A50,083650,Miranda; Gregory Joseph,0,30,40,40
1651116824385,CSE 11,A01,083080,Cao; Yingjun,1,99,40,39
1651116830408,CSE 12,A01,083652,Staff,0,29,100,100
1651116836432,CSE 15L,A01,083654,Staff,0,3,50,50
1651116836432,CSE 15L,A02,083655,Staff,0,3,50,50
1651116842456,CSE 20,A01,083657,Staff,47,0,80,33
1651116848482,CSE 30,A01,083084,Eldon; John,0,38,80,80
1651116854506,CSE 100,A01,083659,Cao; Yingjun,0,72,50,50
1651116860531,CSE 134B,A01,083661,Powell; Thomas Allan,0,38,65,65
1651116866553,CSE 140,A01,083663,Staff,0,17,75,75
1651116872577,CSE 140L,A01,083088,Eldon; John,1,0,100,99
1651116878599,CSE 175,A01,083665,Kumar; Rakesh,0,0,25,25
1651116884626,CSE 190,A00,092507,Dubnov; Shlomo,9,0,20,11
1651116890649,ECE 45,A01,083139,Staff,0,8,60,60
1651116896683,ECE 65,A50,083695,Staff,0,7,30,30
1651116902706,ECE 109,A01,091882,Touri; Behrouz,32,0,70,38
1651116908739,ECE 180,A00,083140,Abi Samra; Nicholas Camill,17,0,30,13
1651116908739,ECE 180,B00,083141,Abi Samra; Nicholas Camill,0,1,30,32
1651116914770,MATH 10A,A01,083735,Patchell; Gregory David,0,0,30,30
1651116914770,MATH 10A,A02,083736,Patchell; Gregory David,26,0,30,4
1651116914770,MATH 10A,A03,083737,Patchell; Gregory David,22,0,30,8
1651116920795,MATH 10B,A01,083207,Staff,0,8,30,30
1651116920795,MATH 10B,A02,083208,Staff,0,6,30,30
1651116920795,MATH 10B,B01,083739,Staff,7,0,30,23
1651116920795,MATH 10B,B02,083740,Staff,28,0,30,2
1651116926823,MATH 18,A01,083743,Staff,0,0,30,30
1651116926823,MATH 18,A02,083744,Staff,23,0,30,7
1651116926823,MATH 18,A03,083745,Staff,19,0,30,11
1651116926823,MATH 18,A04,083746,Staff,26,0,30,4
1651116926823,MATH 18,B01,083748,Staff,0,16,30,30
1651116926823,MATH 18,B02,083749,Staff,0,15,30,30
1651116926823,MATH 18,B03,083750,Staff,0,15,30,30
1651116926823,MATH 18,B04,083751,Staff,0,15,30,30
1651116932846,MATH 20A,A01,083754,Staff,18,0,40,22
1651116938879,MATH 20B,A01,083756,Briones; Jor-el Thomas Caparas,0,14,30,30
1651116938879,MATH 20B,A02,083757,Briones; Jor-el Thomas Caparas,0,11,30,30
1651116944907,MATH 20C,A01,083760,Briones; Jor-el Thomas Caparas,1,17,30,29
1651116944907,MATH 20C,A02,083761,Briones; Jor-el Thomas Caparas,0,17,30,30
1651116944907,MATH 20C,B01,083762,Staff,6,0,30,24
1651116944907,MATH 20C,B02,083763,Staff,28,0,30,2
1651116950929,MATH 20D,A01,083765,Tran; Brian Kha,4,1,30,26
1651116950929,MATH 20D,A02,083766,Tran; Brian Kha,0,0,30,30
1651116950929,MATH 20D,A03,083767,Tran; Brian Kha,22,0,30,8
1651116956953,MATH 20E,A01,083771,Staff,0,0,30,30
1651116956953,MATH 20E,A02,083772,Staff,9,0,30,21
1651116956953,MATH 20E,B01,083773,Staff,5,0,35,30
1651116956953,MATH 20E,B02,083774,Staff,5,1,35,30
1651116962984,MATH 103A,A01,083777,Greenfeld; Be'Eri,0,17,30,30
1651116962984,MATH 103A,A02,083778,Greenfeld; Be'Eri,0,17,30,30
1651116962984,MATH 103A,B01,083779,Greenfeld; Be'Eri,0,15,30,30
1651116962984,MATH 103A,B02,083780,Greenfeld; Be'Eri,0,14,30,30
1651116969009,MATH 105,A01,085443,Staff,0,24,30,30
1651116975033,MATH 109,A01,083213,Ganzberger; Geoffrey Michael,0,8,30,30
1651116975033,MATH 109,A02,083214,Ganzberger; Geoffrey Michael,0,7,30,30
1651116975033,MATH 109,B01,083215,Ganzberger; Geoffrey Michael,0,8,30,30
1651116975033,MATH 109,B02,083216,Ganzberger; Geoffrey Michael,1,8,30,29
1651116981062,MATH 142A,A01,083219,Chow; Bennett,0,15,30,30
1651116981062,MATH 142A,A02,083220,Chow; Bennett,0,15,30,30
1651116981062,MATH 142A,B01,083221,Chow; Bennett,0,16,30,30
1651116981062,MATH 142A,B02,083222,Chow; Bennett,0,16,30,30
1651116987097,MATH 193A,A01,083224,Staff,0,9,30,30
1651116987097,MATH 193A,A02,083225,Staff,1,7,30,29
1651116987097,MATH 193A,A03,083781,Staff,0,7,30,30
1651116987097,MATH 193A,A04,083782,Staff,0,7,30,30
1651116993119,MATH 197,001,091859,McAuley; Julian John,9998,0,9999,1
1651116999166,COGS 9,A01,083615,Staff,0,20,60,60
1651117005201,COGS 11,A01,083617,Boyle; Mary E. T.,13,0,40,27
1651117011225,COGS 13,A01,083071,Staff,0,38,40,40
1651117017254,COGS 14A,A01,092681,Staff,0,40,100,100
1651117023280,COGS 14B,A01,083073,Cheng; Tzu-Han,0,11,50,50
1651117029306,COGS 17,A01,092677,Staff,8,0,75,67
1651117035335,COGS 100,A01,083619,Staff,0,30,60,60
1651117041361,COGS 101A,A01,083621,Davis; Joshua Daniel,0,29,60,60
1651117047385,COGS 101B,A01,091572,Staff,0,8,60,60
1651117053410,COGS 101C,A01,083625,Delgado; Tania,12,0,30,18
1651117059436,COGS 107A,A01,083627,Boyle; Mary E. T.,0,17,60,60
1651117065461,COGS 118A,A01,083075,Staff,0,10,60,60
1651117071482,CSE 3,A50,083646,Miranda; Gregory Joseph,15,0,38,23
1651117071482,CSE 3,A51,083647,Miranda; Gregory Joseph,36,0,37,1
1651117077520,CSE 8A,A50,083650,Miranda; Gregory Joseph,0,30,40,40
1651117083545,CSE 11,A01,083080,Cao; Yingjun,1,99,40,39
1651117089569,CSE 12,A01,083652,Staff,0,29,100,100
1651117095593,CSE 15L,A01,083654,Staff,0,3,50,50
1651117095593,CSE 15L,A02,083655,Staff,0,3,50,50
1651117101619,CSE 20,A01,083657,Staff,47,0,80,33
1651117107648,CSE 30,A01,083084,Eldon; John,0,38,80,80
1651117113670,CSE 100,A01,083659,Cao; Yingjun,0,72,50,50
1651117119695,CSE 134B,A01,083661,Powell; Thomas Allan,0,38,65,65
1651117125721,CSE 140,A01,083663,Staff,0,17,75,75
1651117131744,CSE 140L,A01,083088,Eldon; John,1,0,100,99
1651117137770,CSE 175,A01,083665,Kumar; Rakesh,0,0,25,25
1651117143795,CSE 190,A00,092507,Dubnov; Shlomo,9,0,20,11
1651117149816,ECE 45,A01,083139,Staff,0,8,60,60
1651117155848,ECE 65,A50,083695,Staff,0,7,30,30
1651117161871,ECE 109,A01,091882,Touri; Behrouz,32,0,70,38
1651117167901,ECE 180,A00,083140,Abi Samra; Nicholas Camill,17,0,30,13
1651117167901,ECE 180,B00,083141,Abi Samra; Nicholas Camill,0,1,30,32
1651117173923,MATH 10A,A01,083735,Patchell; Gregory David,0,0,30,30
1651117173923,MATH 10A,A02,083736,Patchell; Gregory David,26,0,30,4
1651117173923,MATH 10A,A03,083737,Patchell; Gregory David,22,0,30,8
1651117179959,MATH 10B,A01,083207,Staff,0,8,30,30
1651117179959,MATH 10B,A02,083208,Staff,0,6,30,30
1651117179959,MATH 10B,B01,083739,Staff,7,0,30,23
1651117179959,MATH 10B,B02,083740,Staff,28,0,30,2
1651117185982,MATH 18,A01,083743,Staff,0,0,30,30
1651117185982,MATH 18,A02,083744,Staff,23,0,30,7
1651117185982,MATH 18,A03,083745,Staff,19,0,30,11
1651117185982,MATH 18,A04,083746,Staff,26,0,30,4
1651117185982,MATH 18,B01,083748,Staff,0,16,30,30
1651117185982,MATH 18,B02,083749,Staff,0,15,30,30
1651117185982,MATH 18,B03,083750,Staff,0,15,30,30
1651117185982,MATH 18,B04,083751,Staff,0,15,30,30
1651117192005,MATH 20A,A01,083754,Staff,18,0,40,22
1651117198034,MATH 20B,A01,083756,Briones; Jor-el Thomas Caparas,0,14,30,30
1651117198034,MATH 20B,A02,083757,Briones; Jor-el Thomas Caparas,0,11,30,30
1651117204058,MATH 20C,A01,083760,Briones; Jor-el Thomas Caparas,1,17,30,29
1651117204058,MATH 20C,A02,083761,Briones; Jor-el Thomas Caparas,0,17,30,30
1651117204058,MATH 20C,B01,083762,Staff,6,0,30,24
1651117204058,MATH 20C,B02,083763,Staff,28,0,30,2
1651117210081,MATH 20D,A01,083765,Tran; Brian Kha,4,1,30,26
1651117210081,MATH 20D,A02,083766,Tran; Brian Kha,0,0,30,30
1651117210081,MATH 20D,A03,083767,Tran; Brian Kha,22,0,30,8
1651117216110,MATH 20E,A01,083771,Staff,0,0,30,30
1651117216110,MATH 20E,A02,083772,Staff,9,0,30,21
1651117216110,MATH 20E,B01,083773,Staff,5,0,35,30
1651117216110,MATH 20E,B02,083774,Staff,5,1,35,30
1651117222227,MATH 103A,A01,083777,Greenfeld; Be'Eri,0,17,30,30
1651117222227,MATH 103A,A02,083778,Greenfeld; Be'Eri,0,17,30,30
1651117222227,MATH 103A,B01,083779,Greenfeld; Be'Eri,0,15,30,30
1651117222227,MATH 103A,B02,083780,Greenfeld; Be'Eri,0,15,30,30
1651117228254,MATH 105,A01,085443,Staff,0,24,30,30
1651117234281,MATH 109,A01,083213,Ganzberger; Geoffrey Michael,0,8,30,30
1651117234281,MATH 109,A02,083214,Ganzberger; Geoffrey Michael,0,7,30,30
1651117234281,MATH 109,B01,083215,Ganzberger; Geoffrey Michael,0,8,30,30
1651117234281,MATH 109,B02,083216,Ganzberger; Geoffrey Michael,1,8,30,29
1651117240308,MATH 142A,A01,083219,Chow; Bennett,0,15,30,30
1651117240308,MATH 142A,A02,083220,Chow; Bennett,0,15,30,30
1651117240308,MATH 142A,B01,083221,Chow; Bennett,0,16,30,30
1651117240308,MATH 142A,B02,083222,Chow; Bennett,0,16,30,30
1651117246331,MATH 193A,A01,083224,Staff,0,9,30,30
1651117246331,MATH 193A,A02,083225,Staff,1,7,30,29
1651117246331,MATH 193A,A03,083781,Staff,0,7,30,30
1651117246331,MATH 193A,A04,083782,Staff,0,7,30,30
1651117252354,MATH 197,001,091859,McAuley; Julian John,9998,0,9999,1
1651117258403,COGS 9,A01,083615,Staff,0,20,60,60
1651117264426,COGS 11,A01,083617,Boyle; Mary E. T.,13,0,40,27
1651117270451,COGS 13,A01,083071,Staff,0,38,40,40
1651117276474,COGS 14A,A01,092681,Staff,0,40,100,100
1651117282498,COGS 14B,A01,083073,Cheng; Tzu-Han,0,11,50,50
1651117288523,COGS 17,A01,092677,Staff,8,0,75,67
1651117294554,COGS 100,A01,083619,Staff,0,30,60,60
1651117300576,COGS 101A,A01,083621,Davis; Joshua Daniel,0,29,60,60
1651117306603,COGS 101B,A01,091572,Staff,0,8,60,60
1651117312625,COGS 101C,A01,083625,Delgado; Tania,12,0,30,18
1651117318650,COGS 107A,A01,083627,Boyle; Mary E. T.,0,17,60,60
1651117324681,COGS 118A,A01,083075,Staff,0,10,60,60
1651117330705,CSE 3,A50,083646,Miranda; Gregory Joseph,15,0,38,23
1651117330705,CSE 3,A51,083647,Miranda; Gregory Joseph,36,0,37,1
1651117336732,CSE 8A,A50,083650,Miranda; Gregory Joseph,0,30,40,40
1651117342758,CSE 11,A01,083080,Cao; Yingjun,1,99,40,39
1651117348780,CSE 12,A01,083652,Staff,0,29,100,100
1651117354804,CSE 15L,A01,083654,Staff,0,3,50,50
1651117354804,CSE 15L,A02,083655,Staff,0,3,50,50
1651117360828,CSE 20,A01,083657,Staff,47,0,80,33
1651117366852,CSE 30,A01,083084,Eldon; John,0,38,80,80
1651117372874,CSE 100,A01,083659,Cao; Yingjun,0,72,50,50
1651117378896,CSE 134B,A01,083661,Powell; Thomas Allan,0,38,65,65
1651117384929,CSE 140,A01,083663,Staff,0,17,75,75
1651117390951,CSE 140L,A01,083088,Eldon; John,1,0,100,99
1651117396978,CSE 175,A01,083665,Kumar; Rakesh,0,0,25,25
1651117403001,CSE 190,A00,092507,Dubnov; Shlomo,9,0,20,11
1651117409024,ECE 45,A01,083139,Staff,0,8,60,60
1651117415048,ECE 65,A50,083695,Staff,0,7,30,30
1651117421073,ECE 109,A01,091882,Touri; Behrouz,32,0,70,38
1651117427101,ECE 180,A00,083140,Abi Samra; Nicholas Camill,17,0,30,13
1651117427101,ECE 180,B00,083141,Abi Samra; Nicholas Camill,0,1,30,32
1651117433126,MATH 10A,A01,083735,Patchell; Gregory David,0,0,30,30
1651117433126,MATH 10A,A02,083736,Patchell; Gregory David,26,0,30,4
1651117433126,MATH 10A,A03,083737,Patchell; Gregory David,22,0,30,8
1651117439149,MATH 10B,A01,083207,Staff,0,8,30,30
1651117439149,MATH 10B,A02,083208,Staff,0,6,30,30
1651117439149,MATH 10B,B01,083739,Staff,7,0,30,23
1651117439149,MATH 10B,B02,083740,Staff,28,0,30,2
1651117445179,MATH 18,A01,083743,Staff,0,0,30,30
1651117445179,MATH 18,A02,083744,Staff,23,0,30,7
1651117445179,MATH 18,A03,083745,Staff,19,0,30,11
1651117445179,MATH 18,A04,083746,Staff,26,0,30,4
1651117445179,MATH 18,B01,083748,Staff,0,16,30,30
1651117445179,MATH 18,B02,083749,Staff,0,15,30,30
1651117445179,MATH 18,B03,083750,Staff,0,15,30,30
1651117445179,MATH 18,B04,083751,Staff,0,15,30,30
1651117451204,MATH 20A,A01,083754,Staff,18,0,40,22
1651117457227,MATH 20B,A01,083756,Briones; Jor-el Thomas Caparas,0,14,30,30
1651117457227,MATH 20B,A02,083757,Briones; Jor-el Thomas Caparas,0,11,30,30
1651117463253,MATH 20C,A01,083760,Briones; Jor-el Thomas Caparas,1,17,30,29
1651117463253,MATH 20C,A02,083761,Briones; Jor-el Thomas Caparas,0,17,30,30
1651117463253,MATH 20C,B01,083762,Staff,6,0,30,24
1651117463253,MATH 20C,B02,083763,Staff,28,0,30,2
1651117469284,MATH 20D,A01,083765,Tran; Brian Kha,4,1,30,26
1651117469284,MATH 20D,A02,083766,Tran; Brian Kha,0,0,30,30
1651117469284,MATH 20D,A03,083767,Tran; Brian Kha,22,0,30,8
1651117475307,MATH 20E,A01,083771,Staff,0,0,30,30
1651117475307,MATH 20E,A02,083772,Staff,9,0,30,21
1651117475307,MATH 20E,B01,083773,Staff,5,0,35,30
1651117475307,MATH 20E,B02,083774,Staff,5,1,35,30
1651117481349,MATH 103A,A01,083777,Greenfeld; Be'Eri,0,17,30,30
1651117481349,MATH 103A,A02,083778,Greenfeld; Be'Eri,0,17,30,30
1651117481349,MATH 103A,B01,083779,Greenfeld; Be'Eri,0,15,30,30
1651117481349,MATH 103A,B02,083780,Greenfeld; Be'Eri,0,15,30,30
1651117487372,MATH 105,A01,085443,Staff,0,24,30,30
1651117493405,MATH 109,A01,083213,Ganzberger; Geoffrey Michael,0,8,30,30
1651117493405,MATH 109,A02,083214,Ganzberger; Geoffrey Michael,0,7,30,30
1651117493405,MATH 109,B01,083215,Ganzberger; Geoffrey Michael,0,8,30,30
1651117493405,MATH 109,B02,083216,Ganzberger; Geoffrey Michael,1,8,30,29
1651117499428,MATH 142A,A01,083219,Chow; Bennett,0,15,30,30
1651117499428,MATH 142A,A02,083220,Chow; Bennett,0,15,30,30
1651117499428,MATH 142A,B01,083221,Chow; Bennett,0,16,30,30
1651117499428,MATH 142A,B02,083222,Chow; Bennett,0,16,30,30
1651117505453,MATH 193A,A01,083224,Staff,0,9,30,30
1651117505453,MATH 193A,A02,083225,Staff,1,7,30,29
1651117505453,MATH 193A,A03,083781,Staff,0,7,30,30
1651117505453,MATH 193A,A04,083782,Staff,0,7,30,30
1651117511478,MATH 197,001,091859,McAuley; Julian John,9998,0,9999,1
1651117517538,COGS 9,A01,083615,Staff,0,20,60,60
1651117523567,COGS 11,A01,083617,Boyle; Mary E. T.,13,0,40,27
1651117529590,COGS 13,A01,083071,Staff,0,38,40,40
1651117535616,COGS 14A,A01,092681,Staff,0,40,100,100
1651117541639,COGS 14B,A01,083073,Cheng; Tzu-Han,0,11,50,50
1651117547666,COGS 17,A01,092677,Staff,8,0,75,67
1651117553690,COGS 100,A01,083619,Staff,0,30,60,60
1651117559715,COGS 101A,A01,083621,Davis; Joshua Daniel,0,29,60,60
1651117565738,COGS 101B,A01,091572,Staff,0,8,60,60
1651117571763,COGS 101C,A01,083625,Delgado; Tania,12,0,30,18
1651117577787,COGS 107A,A01,083627,Boyle; Mary E. T.,0,17,60,60
1651117583808,COGS 118A,A01,083075,Staff,0,10,60,60
1651117589835,CSE 3,A50,083646,Miranda; Gregory Joseph,15,0,38,23
1651117589835,CSE 3,A51,083647,Miranda; Gregory Joseph,36,0,37,1
1651117595858,CSE 8A,A50,083650,Miranda; Gregory Joseph,0,30,40,40
1651117601884,CSE 11,A01,083080,Cao; Yingjun,1,99,40,39
1651117607915,CSE 12,A01,083652,Staff,0,29,100,100
1651117613938,CSE 15L,A01,083654,Staff,0,3,50,50
1651117613938,CSE 15L,A02,083655,Staff,0,3,50,50
1651117619961,CSE 20,A01,083657,Staff,47,0,80,33
1651117625986,CSE 30,A01,083084,Eldon; John,0,38,80,80
1651117632009,CSE 100,A01,083659,Cao; Yingjun,0,72,50,50
1651117638032,CSE 134B,A01,083661,Powell; Thomas Allan,0,38,65,65
1651117644060,CSE 140,A01,083663,Staff,0,17,75,75
1651117650090,CSE 140L,A01,083088,Eldon; John,1,0,100,99
1651117656116,CSE 175,A01,083665,Kumar; Rakesh,0,0,25,25
1651117662143,CSE 190,A00,092507,Dubnov; Shlomo,9,0,20,11
1651117668177,ECE 45,A01,083139,Staff,0,8,60,60
1651117674200,ECE 65,A50,083695,Staff,0,7,30,30
1651117680230,ECE 109,A01,091882,Touri; Behrouz,32,0,70,38
1651117686258,ECE 180,A00,083140,Abi Samra; Nicholas Camill,17,0,30,13
1651117686258,ECE 180,B00,083141,Abi Samra; Nicholas Camill,0,1,30,32
1651117692279,MATH 10A,A01,083735,Patchell; Gregory David,0,0,30,30
1651117692279,MATH 10A,A02,083736,Patchell; Gregory David,26,0,30,4
1651117692279,MATH 10A,A03,083737,Patchell; Gregory David,22,0,30,8
1651117698304,MATH 10B,A01,083207,Staff,0,8,30,30
1651117698304,MATH 10B,A02,083208,Staff,0,6,30,30
1651117698304,MATH 10B,B01,083739,Staff,7,0,30,23
1651117698304,MATH 10B,B02,083740,Staff,28,0,30,2
1651117704334,MATH 18,A01,083743,Staff,0,0,30,30
1651117704334,MATH 18,A02,083744,Staff,23,0,30,7
1651117704334,MATH 18,A03,083745,Staff,19,0,30,11
1651117704334,MATH 18,A04,083746,Staff,26,0,30,4
1651117704334,MATH 18,B01,083748,Staff,0,16,30,30
1651117704334,MATH 18,B02,083749,Staff,0,15,30,30
1651117704334,MATH 18,B03,083750,Staff,0,15,30,30
1651117704334,MATH 18,B04,083751,Staff,0,15,30,30
1651117710357,MATH 20A,A01,083754,Staff,18,0,40,22
1651117716381,MATH 20B,A01,083756,Briones; Jor-el Thomas Caparas,0,14,30,30
1651117716381,MATH 20B,A02,083757,Briones; Jor-el Thomas Caparas,0,11,30,30
1651117722413,MATH 20C,A01,083760,Briones; Jor-el Thomas Caparas,1,17,30,29
1651117722413,MATH 20C,A02,083761,Briones; Jor-el Thomas Caparas,0,17,30,30
1651117722413,MATH 20C,B01,083762,Staff,6,0,30,24
1651117722413,MATH 20C,B02,083763,Staff,28,0,30,2
1651117728451,MATH 20D,A01,083765,Tran; Brian Kha,4,1,30,26
1651117728451,MATH 20D,A02,083766,Tran; Brian Kha,0,0,30,30
1651117728451,MATH 20D,A03,083767,Tran; Brian Kha,22,0,30,8
1651117734473,MATH 20E,A01,083771,Staff,0,0,30,30
1651117734473,MATH 20E,A02,083772,Staff,9,0,30,21
1651117734473,MATH 20E,B01,083773,Staff,5,0,35,30
1651117734473,MATH 20E,B02,083774,Staff,5,1,35,30
1651117740501,MATH 103A,A01,083777,Greenfeld; Be'Eri,0,17,30,30
1651117740501,MATH 103A,A02,083778,Greenfeld; Be'Eri,0,17,30,30
1651117740501,MATH 103A,B01,083779,Greenfeld; Be'Eri,0,15,30,30
1651117740501,MATH 103A,B02,083780,Greenfeld; Be'Eri,0,15,30,30
1651117746527,MATH 105,A01,085443,Staff,0,24,30,30
1651117752552,MATH 109,A01,083213,Ganzberger; Geoffrey Michael,0,8,30,30
1651117752552,MATH 109,A02,083214,Ganzberger; Geoffrey Michael,0,7,30,30
1651117752552,MATH 109,B01,083215,Ganzberger; Geoffrey Michael,0,8,30,30
1651117752552,MATH 109,B02,083216,Ganzberger; Geoffrey Michael,1,8,30,29
1651117758576,MATH 142A,A01,083219,Chow; Bennett,0,15,30,30
1651117758576,MATH 142A,A02,083220,Chow; Bennett,0,15,30,30
1651117758576,MATH 142A,B01,083221,Chow; Bennett,0,16,30,30
1651117758576,MATH 142A,B02,083222,Chow; Bennett,0,16,30,30
1651117764600,MATH 193A,A01,083224,Staff,0,9,30,30
1651117764600,MATH 193A,A02,083225,Staff,1,7,30,29
1651117764600,MATH 193A,A03,083781,Staff,0,7,30,30
1651117764600,MATH 193A,A04,083782,Staff,0,7,30,30
1651117770625,MATH 197,001,091859,McAuley; Julian John,9998,0,9999,1
1651117776674,COGS 9,A01,083615,Staff,0,20,60,60
1651117782701,COGS 11,A01,083617,Boyle; Mary E. T.,13,0,40,27
1651117788727,COGS 13,A01,083071,Staff,0,38,40,40
1651117794751,COGS 14A,A01,092681,Staff,0,40,100,100
1651117800782,COGS 14B,A01,083073,Cheng; Tzu-Han,0,11,50,50
1651117806806,COGS 17,A01,092677,Staff,8,0,75,67
1651117812923,COGS 100,A01,083619,Staff,0,30,60,60
1651117818946,COGS 101A,A01,083621,Davis; Joshua Daniel,0,29,60,60
1651117824973,COGS 101B,A01,091572,Staff,0,8,60,60
1651117830999,COGS 101C,A01,083625,Delgado; Tania,12,0,30,18
1651117837023,COGS 107A,A01,083627,Boyle; Mary E. T.,0,17,60,60
1651117843047,COGS 118A,A01,083075,Staff,0,10,60,60
1651117849071,CSE 3,A50,083646,Miranda; Gregory Joseph,15,0,38,23
1651117849071,CSE 3,A51,083647,Miranda; Gregory Joseph,36,0,37,1
1651117855094,CSE 8A,A50,083650,Miranda; Gregory Joseph,0,30,40,40
1651117861117,CSE 11,A01,083080,Cao; Yingjun,1,99,40,39
1651117867145,CSE 12,A01,083652,Staff,0,30,100,100
1651117873172,CSE 15L,A01,083654,Staff,0,4,50,50
1651117873172,CSE 15L,A02,083655,Staff,0,3,50,50
1651117879199,CSE 20,A01,083657,Staff,47,0,80,33
1651117885223,CSE 30,A01,083084,Eldon; John,0,38,80,80
1651117891252,CSE 100,A01,083659,Cao; Yingjun,0,72,50,50
1651117897279,CSE 134B,A01,083661,Powell; Thomas Allan,0,38,65,65
1651117903302,CSE 140,A01,083663,Staff,0,17,75,75
1651117909329,CSE 140L,A01,083088,Eldon; John,1,0,100,99
1651117915352,CSE 175,A01,083665,Kumar; Rakesh,0,0,25,25
1651117921378,CSE 190,A00,092507,Dubnov; Shlomo,9,0,20,11
1651117927401,ECE 45,A01,083139,Staff,0,8,60,60
1651117933425,ECE 65,A50,083695,Staff,0,7,30,30
1651117939449,ECE 109,A01,091882,Touri; Behrouz,32,0,70,38
1651117945472,ECE 180,A00,083140,Abi Samra; Nicholas Camill,17,0,30,13
1651117945472,ECE 180,B00,083141,Abi Samra; Nicholas Camill,0,1,30,32
1651117951496,MATH 10A,A01,083735,Patchell; Gregory David,0,0,30,30
1651117951496,MATH 10A,A02,083736,Patchell; Gregory David,26,0,30,4
1651117951496,MATH 10A,A03,083737,Patchell; Gregory David,22,0,30,8
1651117957522,MATH 10B,A01,083207,Staff,0,8,30,30
1651117957522,MATH 10B,A02,083208,Staff,0,6,30,30
1651117957522,MATH 10B,B01,083739,Staff,7,0,30,23
1651117957522,MATH 10B,B02,083740,Staff,28,0,30,2
1651117963546,MATH 18,A01,083743,Staff,0,0,30,30
1651117963546,MATH 18,A02,083744,Staff,23,0,30,7
1651117963546,MATH 18,A03,083745,Staff,19,0,30,11
1651117963546,MATH 18,A04,083746,Staff,26,0,30,4
1651117963546,MATH 18,B01,083748,Staff,0,16,30,30
1651117963546,MATH 18,B02,083749,Staff,0,15,30,30
1651117963546,MATH 18,B03,083750,Staff,0,15,30,30
1651117963546,MATH 18,B04,083751,Staff,0,15,30,30
1651117969569,MATH 20A,A01,083754,Staff,18,0,40,22
1651117975598,MATH 20B,A01,083756,Briones; Jor-el Thomas Caparas,0,14,30,30
1651117975598,MATH 20B,A02,083757,Briones; Jor-el Thomas Caparas,0,11,30,30
1651117981625,MATH 20C,A01,083760,Briones; Jor-el Thomas Caparas,1,17,30,29
1651117981625,MATH 20C,A02,083761,Briones; Jor-el Thomas Caparas,0,17,30,30
1651117981625,MATH 20C,B01,083762,Staff,6,0,30,24
1651117981625,MATH 20C,B02,083763,Staff,28,0,30,2
1651117987662,MATH 20D,A01,083765,Tran; Brian Kha,4,1,30,26
1651117987662,MATH 20D,A02,083766,Tran; Brian Kha,0,0,30,30
1651117987662,MATH 20D,A03,083767,Tran; Brian Kha,22,0,30,8
1651117993686,MATH 20E,A01,083771,Staff,0,0,30,30
1651117993686,MATH 20E,A02,083772,Staff,9,0,30,21
1651117993686,MATH 20E,B01,083773,Staff,5,0,35,30
1651117993686,MATH 20E,B02,083774,Staff,5,1,35,30
1651117999715,MATH 103A,A01,083777,Greenfeld; Be'Eri,0,17,30,30
1651117999715,MATH 103A,A02,083778,Greenfeld; Be'Eri,0,17,30,30
1651117999715,MATH 103A,B01,083779,Greenfeld; Be'Eri,0,15,30,30
1651117999715,MATH 103A,B02,083780,Greenfeld; Be'Eri,0,15,30,30
1651118005737,MATH 105,A01,085443,Staff,0,24,30,30
1651118011761,MATH 109,A01,083213,Ganzberger; Geoffrey Michael,0,8,30,30
1651118011761,MATH 109,A02,083214,Ganzberger; Geoffrey Michael,0,7,30,30
1651118011761,MATH 109,B01,083215,Ganzberger; Geoffrey Michael,0,8,30,30
1651118011761,MATH 109,B02,083216,Ganzberger; Geoffrey Michael,1,8,30,29
1651118017823,MATH 142A,A01,083219,Chow; Bennett,0,15,30,30
1651118017823,MATH 142A,A02,083220,Chow; Bennett,0,15,30,30
1651118017823,MATH 142A,B01,083221,Chow; Bennett,0,16,30,30
1651118017823,MATH 142A,B02,083222,Chow; Bennett,0,16,30,30
1651118023858,MATH 193A,A01,083224,Staff,0,9,30,30
1651118023858,MATH 193A,A02,083225,Staff,1,7,30,29
1651118023858,MATH 193A,A03,083781,Staff,0,7,30,30
1651118023858,MATH 193A,A04,083782,Staff,0,7,30,30
1651118029881,MATH 197,001,091859,McAuley; Julian John,9998,0,9999,1
1651118035932,COGS 9,A01,083615,Staff,0,20,60,60
1651118041955,COGS 11,A01,083617,Boyle; Mary E. T.,13,0,40,27
1651118047978,COGS 13,A01,083071,Staff,0,39,40,40
1651118054003,COGS 14A,A01,092681,Staff,0,41,100,100
1651118060030,COGS 14B,A01,083073,Cheng; Tzu-Han,0,11,50,50
1651118066065,COGS 17,A01,092677,Staff,8,0,75,67
1651118072092,COGS 100,A01,083619,Staff,0,30,60,60
1651118078114,COGS 101A,A01,083621,Davis; Joshua Daniel,0,29,60,60
1651118084138,COGS 101B,A01,091572,Staff,0,8,60,60
1651118090162,COGS 101C,A01,083625,Delgado; Tania,12,0,30,18
1651118096188,COGS 107A,A01,083627,Boyle; Mary E. T.,0,17,60,60
1651118102212,COGS 118A,A01,083075,Staff,0,10,60,60
1651118108235,CSE 3,A50,083646,Miranda; Gregory Joseph,15,0,38,23
1651118108235,CSE 3,A51,083647,Miranda; Gregory Joseph,36,0,37,1
1651118114272,CSE 8A,A50,083650,Miranda; Gregory Joseph,0,30,40,40
1651118120296,CSE 11,A01,083080,Cao; Yingjun,1,99,40,39
1651118126323,CSE 12,A01,083652,Staff,0,30,100,100
1651118132347,CSE 15L,A01,083654,Staff,0,4,50,50
1651118132347,CSE 15L,A02,083655,Staff,0,3,50,50
1651118138377,CSE 20,A01,083657,Staff,47,0,80,33
1651118144408,CSE 30,A01,083084,Eldon; John,0,38,80,80
1651118150434,CSE 100,A01,083659,Cao; Yingjun,0,72,50,50
1651118156456,CSE 134B,A01,083661,Powell; Thomas Allan,0,38,65,65
1651118162490,CSE 140,A01,083663,Staff,0,17,75,75
1651118168513,CSE 140L,A01,083088,Eldon; John,1,0,100,99
1651118174541,CSE 175,A01,083665,Kumar; Rakesh,0,0,25,25
1651118180572,CSE 190,A00,092507,Dubnov; Shlomo,9,0,20,11
1651118186594,ECE 45,A01,083139,Staff,0,8,60,60
1651118192621,ECE 65,A50,083695,Staff,0,7,30,30
1651118198651,ECE 109,A01,091882,Touri; Behrouz,32,0,70,38
1651118204673,ECE 180,A00,083140,Abi Samra; Nicholas Camill,17,0,30,13
1651118204673,ECE 180,B00,083141,Abi Samra; Nicholas Camill,0,1,30,32
1651118210702,MATH 10A,A01,083735,Patchell; Gregory David,0,0,30,30
1651118210702,MATH 10A,A02,083736,Patchell; Gregory David,26,0,30,4
1651118210702,MATH 10A,A03,083737,Patchell; Gregory David,22,0,30,8
1651118216731,MATH 10B,A01,083207,Staff,0,8,30,30
1651118216731,MATH 10B,A02,083208,Staff,0,6,30,30
1651118216731,MATH 10B,B01,083739,Staff,7,0,30,23
1651118216731,MATH 10B,B02,083740,Staff,28,0,30,2
1651118222755,MATH 18,A01,083743,Staff,0,0,30,30
1651118222755,MATH 18,A02,083744,Staff,23,0,30,7
1651118222755,MATH 18,A03,083745,Staff,19,0,30,11
1651118222755,MATH 18,A04,083746,Staff,26,0,30,4
1651118222755,MATH 18,B01,083748,Staff,0,16,30,30
1651118222755,MATH 18,B02,083749,Staff,0,15,30,30
1651118222755,MATH 18,B03,083750,Staff,0,15,30,30
1651118222755,MATH 18,B04,083751,Staff,0,15,30,30
1651118228781,MATH 20A,A01,083754,Staff,18,0,40,22
1651118234805,MATH 20B,A01,083756,Briones; Jor-el Thomas Caparas,0,14,30,30
1651118234805,MATH 20B,A02,083757,Briones; Jor-el Thomas Caparas,0,11,30,30
1651118240828,MATH 20C,A01,083760,Briones; Jor-el Thomas Caparas,1,17,30,29
1651118240828,MATH 20C,A02,083761,Briones; Jor-el Thomas Caparas,0,17,30,30
1651118240828,MATH 20C,B01,083762,Staff,6,0,30,24
1651118240828,MATH 20C,B02,083763,Staff,28,0,30,2
1651118246851,MATH 20D,A01,083765,Tran; Brian Kha,4,1,30,26
1651118246851,MATH 20D,A02,083766,Tran; Brian Kha,0,0,30,30
1651118246851,MATH 20D,A03,083767,Tran; Brian Kha,22,0,30,8
1651118252874,MATH 20E,A01,083771,Staff,0,0,30,30
1651118252874,MATH 20E,A02,083772,Staff,9,0,30,21
1651118252874,MATH 20E,B01,083773,Staff,5,0,35,30
1651118252874,MATH 20E,B02,083774,Staff,5,1,35,30
1651118258904,MATH 103A,A01,083777,Greenfeld; Be'Eri,0,17,30,30
1651118258904,MATH 103A,A02,083778,Greenfeld; Be'Eri,0,17,30,30
1651118258904,MATH 103A,B01,083779,Greenfeld; Be'Eri,0,15,30,30
1651118258904,MATH 103A,B02,083780,Greenfeld; Be'Eri,0,15,30,30
1651118264926,MATH 105,A01,085443,Staff,0,24,30,30
1651118270950,MATH 109,A01,083213,Ganzberger; Geoffrey Michael,0,8,30,30
1651118270950,MATH 109,A02,083214,Ganzberger; Geoffrey Michael,0,7,30,30
1651118270950,MATH 109,B01,083215,Ganzberger; Geoffrey Michael,0,8,30,30
1651118270950,MATH 109,B02,083216,Ganzberger; Geoffrey Michael,1,8,30,29
1651118276973,MATH 142A,A01,083219,Chow; Bennett,0,15,30,30
1651118276973,MATH 142A,A02,083220,Chow; Bennett,0,15,30,30
1651118276973,MATH 142A,B01,083221,Chow; Bennett,0,16,30,30
1651118276973,MATH 142A,B02,083222,Chow; Bennett,0,16,30,30
1651118282997,MATH 193A,A01,083224,Staff,0,9,30,30
1651118282997,MATH 193A,A02,083225,Staff,1,7,30,29
1651118282997,MATH 193A,A03,083781,Staff,0,7,30,30
1651118282997,MATH 193A,A04,083782,Staff,0,7,30,30
1651118289021,MATH 197,001,091859,McAuley; Julian John,9998,0,9999,1
1651118295069,COGS 9,A01,083615,Staff,0,20,60,60
1651118301093,COGS 11,A01,083617,Boyle; Mary E. T.,13,0,40,27
1651118307120,COGS 13,A01,083071,Staff,0,39,40,40
1651118313144,COGS 14A,A01,092681,Staff,0,41,100,100
1651118319170,COGS 14B,A01,083073,Cheng; Tzu-Han,0,11,50,50
1651118325192,COGS 17,A01,092677,Staff,8,0,75,67
1651118331216,COGS 100,A01,083619,Staff,0,30,60,60
1651118337239,COGS 101A,A01,083621,Davis; Joshua Daniel,0,29,60,60
1651118343265,COGS 101B,A01,091572,Staff,0,8,60,60
1651118349286,COGS 101C,A01,083625,Delgado; Tania,12,0,30,18
1651118355309,COGS 107A,A01,083627,Boyle; Mary E. T.,0,17,60,60
1651118361332,COGS 118A,A01,083075,Staff,0,10,60,60
1651118367355,CSE 3,A50,083646,Miranda; Gregory Joseph,15,0,38,23
1651118367355,CSE 3,A51,083647,Miranda; Gregory Joseph,36,0,37,1
1651118373382,CSE 8A,A50,083650,Miranda; Gregory Joseph,0,30,40,40
1651118379408,CSE 11,A01,083080,Cao; Yingjun,1,99,40,39
1651118385433,CSE 12,A01,083652,Staff,0,30,100,100
1651118391456,CSE 15L,A01,083654,Staff,0,4,50,50
1651118391456,CSE 15L,A02,083655,Staff,0,3,50,50
1651118397478,CSE 20,A01,083657,Staff,47,0,80,33
1651118403501,CSE 30,A01,083084,Eldon; John,0,38,80,80
1651118409613,CSE 100,A01,083659,Cao; Yingjun,0,72,50,50
1651118415639,CSE 134B,A01,083661,Powell; Thomas Allan,0,38,65,65
1651118421670,CSE 140,A01,083663,Staff,0,17,75,75
1651118427700,CSE 140L,A01,083088,Eldon; John,1,0,100,99
1651118433722,CSE 175,A01,083665,Kumar; Rakesh,0,0,25,25
1651118439749,CSE 190,A00,092507,Dubnov; Shlomo,9,0,20,11
1651118445773,ECE 45,A01,083139,Staff,0,8,60,60
1651118451798,ECE 65,A50,083695,Staff,0,7,30,30
1651118457823,ECE 109,A01,091882,Touri; Behrouz,32,0,70,38
1651118463848,ECE 180,A00,083140,Abi Samra; Nicholas Camill,17,0,30,13
1651118463848,ECE 180,B00,083141,Abi Samra; Nicholas Camill,0,1,30,32
1651118469883,MATH 10A,A01,083735,Patchell; Gregory David,0,0,30,30
1651118469883,MATH 10A,A02,083736,Patchell; Gregory David,26,0,30,4
1651118469883,MATH 10A,A03,083737,Patchell; Gregory David,22,0,30,8
1651118475906,MATH 10B,A01,083207,Staff,0,8,30,30
1651118475906,MATH 10B,A02,083208,Staff,0,6,30,30
1651118475906,MATH 10B,B01,083739,Staff,7,0,30,23
1651118475906,MATH 10B,B02,083740,Staff,28,0,30,2
1651118481932,MATH 18,A01,083743,Staff,0,0,30,30
1651118481932,MATH 18,A02,083744,Staff,23,0,30,7
1651118481932,MATH 18,A03,083745,Staff,19,0,30,11
1651118481932,MATH 18,A04,083746,Staff,26,0,30,4
1651118481932,MATH 18,B01,083748,Staff,0,16,30,30
1651118481932,MATH 18,B02,083749,Staff,0,15,30,30
1651118481932,MATH 18,B03,083750,Staff,0,15,30,30
1651118481932,MATH 18,B04,083751,Staff,0,15,30,30
1651118487955,MATH 20A,A01,083754,Staff,18,0,40,22
1651118493985,MATH 20B,A01,083756,Briones; Jor-el Thomas Caparas,0,14,30,30
1651118493985,MATH 20B,A02,083757,Briones; Jor-el Thomas Caparas,0,11,30,30
1651118500008,MATH 20C,A01,083760,Briones; Jor-el Thomas Caparas,1,17,30,29
1651118500008,MATH 20C,A02,083761,Briones; Jor-el Thomas Caparas,0,17,30,30
1651118500008,MATH 20C,B01,083762,Staff,6,0,30,24
1651118500008,MATH 20C,B02,083763,Staff,28,0,30,2
1651118506036,MATH 20D,A01,083765,Tran; Brian Kha,4,1,30,26
1651118506036,MATH 20D,A02,083766,Tran; Brian Kha,0,0,30,30
1651118506036,MATH 20D,A03,083767,Tran; Brian Kha,22,0,30,8
1651118512064,MATH 20E,A01,083771,Staff,0,0,30,30
1651118512064,MATH 20E,A02,083772,Staff,9,0,30,21
1651118512064,MATH 20E,B01,083773,Staff,5,0,35,30
1651118512064,MATH 20E,B02,083774,Staff,5,1,35,30
1651118518090,MATH 103A,A01,083777,Greenfeld; Be'Eri,0,17,30,30
1651118518090,MATH 103A,A02,083778,Greenfeld; Be'Eri,0,17,30,30
1651118518090,MATH 103A,B01,083779,Greenfeld; Be'Eri,0,15,30,30
1651118518090,MATH 103A,B02,083780,Greenfeld; Be'Eri,0,15,30,30
1651118524118,MATH 105,A01,085443,Staff,0,24,30,30
1651118530145,MATH 109,A01,083213,Ganzberger; Geoffrey Michael,0,8,30,30
1651118530145,MATH 109,A02,083214,Ganzberger; Geoffrey Michael,0,7,30,30
1651118530145,MATH 109,B01,083215,Ganzberger; Geoffrey Michael,0,8,30,30
1651118530145,MATH 109,B02,083216,Ganzberger; Geoffrey Michael,1,8,30,29
1651118536168,MATH 142A,A01,083219,Chow; Bennett,0,15,30,30
1651118536168,MATH 142A,A02,083220,Chow; Bennett,0,15,30,30
1651118536168,MATH 142A,B01,083221,Chow; Bennett,0,16,30,30
1651118536168,MATH 142A,B02,083222,Chow; Bennett,0,16,30,30
1651118542193,MATH 193A,A01,083224,Staff,0,9,30,30
1651118542193,MATH 193A,A02,083225,Staff,1,7,30,29
1651118542193,MATH 193A,A03,083781,Staff,0,7,30,30
1651118542193,MATH 193A,A04,083782,Staff,0,7,30,30
1651118548223,MATH 197,001,091859,McAuley; Julian John,9998,0,9999,1
1651118554275,COGS 9,A01,083615,Staff,0,20,60,60
1651118560301,COGS 11,A01,083617,Boyle; Mary E. T.,13,0,40,27
1651118566327,COGS 13,A01,083071,Staff,0,39,40,40
1651118572356,COGS 14A,A01,092681,Staff,0,41,100,100
1651118578380,COGS 14B,A01,083073,Cheng; Tzu-Han,0,11,50,50
1651118584405,COGS 17,A01,092677,Staff,8,0,75,67
1651118590427,COGS 100,A01,083619,Staff,0,30,60,60
1651118596458,COGS 101A,A01,083621,Davis; Joshua Daniel,0,29,60,60
1651118602493,COGS 101B,A01,091572,Staff,0,8,60,60
1651118608520,COGS 101C,A01,083625,Delgado; Tania,12,0,30,18
1651118614557,COGS 107A,A01,083627,Boyle; Mary E. T.,0,17,60,60
1651118620582,COGS 118A,A01,083075,Staff,0,10,60,60
1651118626605,CSE 3,A50,083646,Miranda; Gregory Joseph,15,0,38,23
1651118626605,CSE 3,A51,083647,Miranda; Gregory Joseph,36,0,37,1
1651118632633,CSE 8A,A50,083650,Miranda; Gregory Joseph,0,30,40,40
1651118638661,CSE 11,A01,083080,Cao; Yingjun,1,99,40,39
1651118644688,CSE 12,A01,083652,Staff,0,30,100,100
1651118650717,CSE 15L,A01,083654,Staff,0,4,50,50
1651118650717,CSE 15L,A02,083655,Staff,0,3,50,50
1651118656742,CSE 20,A01,083657,Staff,47,0,80,33
1651118662769,CSE 30,A01,083084,Eldon; John,0,39,80,80
1651118668795,CSE 100,A01,083659,Cao; Yingjun,0,72,50,50
1651118674821,CSE 134B,A01,083661,Powell; Thomas Allan,0,38,65,65
1651118680850,CSE 140,A01,083663,Staff,0,17,75,75
1651118686875,CSE 140L,A01,083088,Eldon; John,1,0,100,99
1651118692900,CSE 175,A01,083665,Kumar; Rakesh,0,0,25,25
1651118698923,CSE 190,A00,092507,Dubnov; Shlomo,9,0,20,11
1651118704950,ECE 45,A01,083139,Staff,0,8,60,60
1651118710980,ECE 65,A50,083695,Staff,0,7,30,30
1651118717006,ECE 109,A01,091882,Touri; Behrouz,32,0,70,38
1651118723029,ECE 180,A00,083140,Abi Samra; Nicholas Camill,17,0,30,13
1651118723029,ECE 180,B00,083141,Abi Samra; Nicholas Camill,0,1,30,32
1651118729057,MATH 10A,A01,083735,Patchell; Gregory David,0,0,30,30
1651118729057,MATH 10A,A02,083736,Patchell; Gregory David,26,0,30,4
1651118729057,MATH 10A,A03,083737,Patchell; Gregory David,22,0,30,8
1651118735079,MATH 10B,A01,083207,Staff,0,8,30,30
1651118735079,MATH 10B,A02,083208,Staff,0,6,30,30
1651118735079,MATH 10B,B01,083739,Staff,7,0,30,23
1651118735079,MATH 10B,B02,083740,Staff,28,0,30,2
1651118741109,MATH 18,A01,083743,Staff,0,0,30,30
1651118741109,MATH 18,A02,083744,Staff,23,0,30,7
1651118741109,MATH 18,A03,083745,Staff,19,0,30,11
1651118741109,MATH 18,A04,083746,Staff,26,0,30,4
1651118741109,MATH 18,B01,083748,Staff,0,16,30,30
1651118741109,MATH 18,B02,083749,Staff,0,15,30,30
1651118741109,MATH 18,B03,083750,Staff,0,15,30,30
1651118741109,MATH 18,B04,083751,Staff,0,15,30,30
1651118747136,MATH 20A,A01,083754,Staff,18,0,40,22
1651118753164,MATH 20B,A01,083756,Briones; Jor-el Thomas Caparas,0,14,30,30
1651118753164,MATH 20B,A02,083757,Briones; Jor-el Thomas Caparas,0,11,30,30
1651118759195,MATH 20C,A01,083760,Briones; Jor-el Thomas Caparas,1,17,30,29
1651118759195,MATH 20C,A02,083761,Briones; Jor-el Thomas Caparas,0,17,30,30
1651118759195,MATH 20C,B01,083762,Staff,6,0,30,24
1651118759195,MATH 20C,B02,083763,Staff,28,0,30,2
1651118765226,MATH 20D,A01,083765,Tran; Brian Kha,4,1,30,26
1651118765226,MATH 20D,A02,083766,Tran; Brian Kha,0,0,30,30
1651118765226,MATH 20D,A03,083767,Tran; Brian Kha,22,0,30,8
1651118771255,MATH 20E,A01,083771,Staff,0,0,30,30
1651118771255,MATH 20E,A02,083772,Staff,9,0,30,21
1651118771255,MATH 20E,B01,083773,Staff,5,0,35,30
1651118771255,MATH 20E,B02,083774,Staff,5,1,35,30
1651118777282,MATH 103A,A01,083777,Greenfeld; Be'Eri,0,17,30,30
1651118777282,MATH 103A,A02,083778,Greenfeld; Be'Eri,0,18,30,30
1651118777282,MATH 103A,B01,083779,Greenfeld; Be'Eri,0,15,30,30
1651118777282,MATH 103A,B02,083780,Greenfeld; Be'Eri,0,15,30,30
1651118783305,MATH 105,A01,085443,Staff,0,24,30,30
1651118789330,MATH 109,A01,083213,Ganzberger; Geoffrey Michael,0,8,30,30
1651118789330,MATH 109,A02,083214,Ganzberger; Geoffrey Michael,0,7,30,30
1651118789330,MATH 109,B01,083215,Ganzberger; Geoffrey Michael,0,8,30,30
1651118789330,MATH 109,B02,083216,Ganzberger; Geoffrey Michael,1,8,30,29
1651118795355,MATH 142A,A01,083219,Chow; Bennett,0,15,30,30
1651118795355,MATH 142A,A02,083220,Chow; Bennett,0,15,30,30
1651118795355,MATH 142A,B01,083221,Chow; Bennett,0,16,30,30
1651118795355,MATH 142A,B02,083222,Chow; Bennett,0,16,30,30
1651118801377,MATH 193A,A01,083224,Staff,0,9,30,30
1651118801377,MATH 193A,A02,083225,Staff,1,7,30,29
1651118801377,MATH 193A,A03,083781,Staff,0,7,30,30
1651118801377,MATH 193A,A04,083782,Staff,0,7,30,30
1651118807401,MATH 197,001,091859,McAuley; Julian John,9998,0,9999,1
1651118813466,COGS 9,A01,083615,Staff,0,20,60,60
1651118819495,COGS 11,A01,083617,Boyle; Mary E. T.,13,0,40,27
1651118825521,COGS 13,A01,083071,Staff,0,39,40,40
1651118831546,COGS 14A,A01,092681,Staff,0,41,100,100
1651118837569,COGS 14B,A01,083073,Cheng; Tzu-Han,0,11,50,50
1651118843591,COGS 17,A01,092677,Staff,8,0,75,67
1651118849616,COGS 100,A01,083619,Staff,0,30,60,60
1651118855643,COGS 101A,A01,083621,Davis; Joshua Daniel,0,29,60,60
1651118861665,COGS 101B,A01,091572,Staff,0,8,60,60
1651118867689,COGS 101C,A01,083625,Delgado; Tania,12,0,30,18
1651118873714,COGS 107A,A01,083627,Boyle; Mary E. T.,0,17,60,60
1651118879753,COGS 118A,A01,083075,Staff,0,10,60,60
1651118885781,CSE 3,A50,083646,Miranda; Gregory Joseph,15,0,38,23
1651118885781,CSE 3,A51,083647,Miranda; Gregory Joseph,36,0,37,1
1651118891808,CSE 8A,A50,083650,Miranda; Gregory Joseph,0,30,40,40
1651118897831,CSE 11,A01,083080,Cao; Yingjun,1,99,40,39
1651118903858,CSE 12,A01,083652,Staff,0,30,100,100
1651118909883,CSE 15L,A01,083654,Staff,0,4,50,50
1651118909883,CSE 15L,A02,083655,Staff,0,3,50,50
1651118915917,CSE 20,A01,083657,Staff,47,0,80,33
1651118921941,CSE 30,A01,083084,Eldon; John,0,39,80,80
1651118927967,CSE 100,A01,083659,Cao; Yingjun,0,72,50,50
1651118933994,CSE 134B,A01,083661,Powell; Thomas Allan,0,38,65,65
1651118940021,CSE 140,A01,083663,Staff,0,17,75,75
1651118946049,CSE 140L,A01,083088,Eldon; John,1,0,100,99
1651118952077,CSE 175,A01,083665,Kumar; Rakesh,0,0,25,25
1651118958104,CSE 190,A00,092507,Dubnov; Shlomo,9,0,20,11
1651118964130,ECE 45,A01,083139,Staff,0,8,60,60
1651118970156,ECE 65,A50,083695,Staff,0,7,30,30
1651118976182,ECE 109,A01,091882,Touri; Behrouz,32,0,70,38
1651118982213,ECE 180,A00,083140,Abi Samra; Nicholas Camill,17,0,30,13
1651118982213,ECE 180,B00,083141,Abi Samra; Nicholas Camill,0,1,30,32
1651118988239,MATH 10A,A01,083735,Patchell; Gregory David,0,0,30,30
1651118988239,MATH 10A,A02,083736,Patchell; Gregory David,26,0,30,4
1651118988239,MATH 10A,A03,083737,Patchell; Gregory David,22,0,30,8
1651118994281,MATH 10B,A01,083207,Staff,0,8,30,30
1651118994281,MATH 10B,A02,083208,Staff,0,6,30,30
1651118994281,MATH 10B,B01,083739,Staff,7,0,30,23
1651118994281,MATH 10B,B02,083740,Staff,28,0,30,2
1651119000313,MATH 18,A01,083743,Staff,0,0,30,30
1651119000313,MATH 18,A02,083744,Staff,23,0,30,7
1651119000313,MATH 18,A03,083745,Staff,19,0,30,11
1651119000313,MATH 18,A04,083746,Staff,26,0,30,4
1651119000313,MATH 18,B01,083748,Staff,0,16,30,30
1651119000313,MATH 18,B02,083749,Staff,0,15,30,30
1651119000313,MATH 18,B03,083750,Staff,0,15,30,30
1651119000313,MATH 18,B04,083751,Staff,0,15,30,30
1651119006432,MATH 20A,A01,083754,Staff,18,0,40,22
1651119012460,MATH 20B,A01,083756,Briones; Jor-el Thomas Caparas,0,14,30,30
1651119012460,MATH 20B,A02,083757,Briones; Jor-el Thomas Caparas,0,11,30,30
1651119018484,MATH 20C,A01,083760,Briones; Jor-el Thomas Caparas,1,17,30,29
1651119018484,MATH 20C,A02,083761,Briones; Jor-el Thomas Caparas,0,17,30,30
1651119018484,MATH 20C,B01,083762,Staff,6,0,30,24
1651119018484,MATH 20C,B02,083763,Staff,28,0,30,2
1651119024515,MATH 20D,A01,083765,Tran; Brian Kha,4,1,30,26
1651119024515,MATH 20D,A02,083766,Tran; Brian Kha,0,0,30,30
1651119024515,MATH 20D,A03,083767,Tran; Brian Kha,22,0,30,8
1651119030541,MATH 20E,A01,083771,Staff,0,0,30,30
1651119030541,MATH 20E,A02,083772,Staff,9,0,30,21
1651119030541,MATH 20E,B01,083773,Staff,5,0,35,30
1651119030541,MATH 20E,B02,083774,Staff,5,1,35,30
1651119036566,MATH 103A,A01,083777,Greenfeld; Be'Eri,0,17,30,30
1651119036566,MATH 103A,A02,083778,Greenfeld; Be'Eri,0,18,30,30
1651119036566,MATH 103A,B01,083779,Greenfeld; Be'Eri,0,15,30,30
1651119036566,MATH 103A,B02,083780,Greenfeld; Be'Eri,0,15,30,30
1651119042599,MATH 105,A01,085443,Staff,0,24,30,30
1651119048622,MATH 109,A01,083213,Ganzberger; Geoffrey Michael,0,8,30,30
1651119048622,MATH 109,A02,083214,Ganzberger; Geoffrey Michael,0,7,30,30
1651119048622,MATH 109,B01,083215,Ganzberger; Geoffrey Michael,0,8,30,30
1651119048622,MATH 109,B02,083216,Ganzberger; Geoffrey Michael,1,8,30,29
1651119054650,MATH 142A,A01,083219,Chow; Bennett,0,15,30,30
1651119054650,MATH 142A,A02,083220,Chow; Bennett,0,15,30,30
1651119054650,MATH 142A,B01,083221,Chow; Bennett,0,16,30,30
1651119054650,MATH 142A,B02,083222,Chow; Bennett,0,16,30,30
1651119060676,MATH 193A,A01,083224,Staff,0,9,30,30
1651119060676,MATH 193A,A02,083225,Staff,1,7,30,29
1651119060676,MATH 193A,A03,083781,Staff,0,7,30,30
1651119060676,MATH 193A,A04,083782,Staff,0,7,30,30
1651119066700,MATH 197,001,091859,McAuley; Julian John,9998,0,9999,1
1651119072749,COGS 9,A01,083615,Staff,0,20,60,60
1651119078775,COGS 11,A01,083617,Boyle; Mary E. T.,13,0,40,27
1651119084797,COGS 13,A01,083071,Staff,0,39,40,40
1651119090820,COGS 14A,A01,092681,Staff,0,41,100,100
1651119096848,COGS 14B,A01,083073,Cheng; Tzu-Han,0,11,50,50
1651119102869,COGS 17,A01,092677,Staff,8,0,75,67
1651119108894,COGS 100,A01,083619,Staff,0,30,60,60
1651119114918,COGS 101A,A01,083621,Davis; Joshua Daniel,0,29,60,60
1651119120947,COGS 101B,A01,091572,Staff,0,8,60,60
1651119126973,COGS 101C,A01,083625,Delgado; Tania,12,0,30,18
1651119132998,COGS 107A,A01,083627,Boyle; Mary E. T.,0,17,60,60
1651119139033,COGS 118A,A01,083075,Staff,0,10,60,60
1651119145056,CSE 3,A50,083646,Miranda; Gregory Joseph,15,0,38,23
1651119145056,CSE 3,A51,083647,Miranda; Gregory Joseph,36,0,37,1
1651119151079,CSE 8A,A50,083650,Miranda; Gregory Joseph,0,30,40,40
1651119157103,CSE 11,A01,083080,Cao; Yingjun,1,99,40,39
1651119163126,CSE 12,A01,083652,Staff,0,30,100,100
1651119169149,CSE 15L,A01,083654,Staff,0,4,50,50
1651119169149,CSE 15L,A02,083655,Staff,0,3,50,50
1651119175176,CSE 20,A01,083657,Staff,47,0,80,33
1651119181200,CSE 30,A01,083084,Eldon; John,0,39,80,80
1651119187225,CSE 100,A01,083659,Cao; Yingjun,0,72,50,50
1651119193248,CSE 134B,A01,083661,Powell; Thomas Allan,0,38,65,65
1651119199275,CSE 140,A01,083663,Staff,0,17,75,75
1651119205302,CSE 140L,A01,083088,Eldon; John,1,0,100,99
1651119211325,CSE 175,A01,083665,Kumar; Rakesh,0,0,25,25
1651119217353,CSE 190,A00,092507,Dubnov; Shlomo,9,0,20,11
1651119223378,ECE 45,A01,083139,Staff,0,8,60,60
1651119229402,ECE 65,A50,083695,Staff,0,7,30,30
1651119235426,ECE 109,A01,091882,Touri; Behrouz,32,0,70,38
1651119241452,ECE 180,A00,083140,Abi Samra; Nicholas Camill,17,0,30,13
1651119241452,ECE 180,B00,083141,Abi Samra; Nicholas Camill,0,1,30,32
1651119247476,MATH 10A,A01,083735,Patchell; Gregory David,0,0,30,30
1651119247476,MATH 10A,A02,083736,Patchell; Gregory David,26,0,30,4
1651119247476,MATH 10A,A03,083737,Patchell; Gregory David,22,0,30,8
1651119253499,MATH 10B,A01,083207,Staff,0,8,30,30
1651119253499,MATH 10B,A02,083208,Staff,0,6,30,30
1651119253499,MATH 10B,B01,083739,Staff,7,0,30,23
1651119253499,MATH 10B,B02,083740,Staff,28,0,30,2
1651119259523,MATH 18,A01,083743,Staff,0,0,30,30
1651119259523,MATH 18,A02,083744,Staff,23,0,30,7
1651119259523,MATH 18,A03,083745,Staff,19,0,30,11
1651119259523,MATH 18,A04,083746,Staff,26,0,30,4
1651119259523,MATH 18,B01,083748,Staff,0,16,30,30
1651119259523,MATH 18,B02,083749,Staff,0,15,30,30
1651119259523,MATH 18,B03,083750,Staff,0,15,30,30
1651119259523,MATH 18,B04,083751,Staff,0,15,30,30
1651119265550,MATH 20A,A01,083754,Staff,18,0,40,22
1651119271577,MATH 20B,A01,083756,Briones; Jor-el Thomas Caparas,0,14,30,30
1651119271577,MATH 20B,A02,083757,Briones; Jor-el Thomas Caparas,0,11,30,30
1651119277601,MATH 20C,A01,083760,Briones; Jor-el Thomas Caparas,1,17,30,29
1651119277601,MATH 20C,A02,083761,Briones; Jor-el Thomas Caparas,0,17,30,30
1651119277601,MATH 20C,B01,083762,Staff,6,0,30,24
1651119277601,MATH 20C,B02,083763,Staff,28,0,30,2
1651119283629,MATH 20D,A01,083765,Tran; Brian Kha,4,1,30,26
1651119283629,MATH 20D,A02,083766,Tran; Brian Kha,0,0,30,30
1651119283629,MATH 20D,A03,083767,Tran; Brian Kha,22,0,30,8
1651119289657,MATH 20E,A01,083771,Staff,0,0,30,30
1651119289657,MATH 20E,A02,083772,Staff,9,0,30,21
1651119289657,MATH 20E,B01,083773,Staff,5,0,35,30
1651119289657,MATH 20E,B02,083774,Staff,5,1,35,30
1651119295699,MATH 103A,A01,083777,Greenfeld; Be'Eri,0,17,30,30
1651119295699,MATH 103A,A02,083778,Greenfeld; Be'Eri,0,17,30,30
1651119295699,MATH 103A,B01,083779,Greenfeld; Be'Eri,0,16,30,30
1651119295699,MATH 103A,B02,083780,Greenfeld; Be'Eri,0,15,30,30
1651119301729,MATH 105,A01,085443,Staff,0,24,30,30
1651119307757,MATH 109,A01,083213,Ganzberger; Geoffrey Michael,0,8,30,30
1651119307757,MATH 109,A02,083214,Ganzberger; Geoffrey Michael,0,7,30,30
1651119307757,MATH 109,B01,083215,Ganzberger; Geoffrey Michael,0,8,30,30
1651119307757,MATH 109,B02,083216,Ganzberger; Geoffrey Michael,1,8,30,29
1651119313808,MATH 142A,A01,083219,Chow; Bennett,0,15,30,30
1651119313808,MATH 142A,A02,083220,Chow; Bennett,0,15,30,30
1651119313808,MATH 142A,B01,083221,Chow; Bennett,0,16,30,30
1651119313808,MATH 142A,B02,083222,Chow; Bennett,0,16,30,30
1651119319830,MATH 193A,A01,083224,Staff,0,9,30,30
1651119319830,MATH 193A,A02,083225,Staff,1,7,30,29
1651119319830,MATH 193A,A03,083781,Staff,0,7,30,30
1651119319830,MATH 193A,A04,083782,Staff,0,7,30,30
1651119325853,MATH 197,001,091859,McAuley; Julian John,9998,0,9999,1
1651119331911,COGS 9,A01,083615,Staff,0,20,60,60
1651119337937,COGS 11,A01,083617,Boyle; Mary E. T.,13,0,40,27
1651119343963,COGS 13,A01,083071,Staff,0,39,40,40
1651119349990,COGS 14A,A01,092681,Staff,0,41,100,100
1651119356013,COGS 14B,A01,083073,Cheng; Tzu-Han,0,11,50,50
1651119362040,COGS 17,A01,092677,Staff,8,0,75,67
1651119368062,COGS 100,A01,083619,Staff,0,30,60,60
1651119374087,COGS 101A,A01,083621,Davis; Joshua Daniel,0,29,60,60
1651119380121,COGS 101B,A01,091572,Staff,0,8,60,60
1651119386146,COGS 101C,A01,083625,Delgado; Tania,12,0,30,18
1651119392170,COGS 107A,A01,083627,Boyle; Mary E. T.,0,17,60,60
1651119398194,COGS 118A,A01,083075,Staff,0,10,60,60
1651119404218,CSE 3,A50,083646,Miranda; Gregory Joseph,15,0,38,23
1651119404218,CSE 3,A51,083647,Miranda; Gregory Joseph,36,0,37,1
1651119410254,CSE 8A,A50,083650,Miranda; Gregory Joseph,0,30,40,40
1651119416278,CSE 11,A01,083080,Cao; Yingjun,1,99,40,39
1651119422300,CSE 12,A01,083652,Staff,0,30,100,100
1651119428326,CSE 15L,A01,083654,Staff,0,4,50,50
1651119428326,CSE 15L,A02,083655,Staff,0,3,50,50
1651119434352,CSE 20,A01,083657,Staff,47,0,80,33
1651119440381,CSE 30,A01,083084,Eldon; John,0,39,80,80
1651119446407,CSE 100,A01,083659,Cao; Yingjun,0,72,50,50
1651119452455,CSE 134B,A01,083661,Powell; Thomas Allan,0,38,65,65
1651119458486,CSE 140,A01,083663,Staff,0,17,75,75
1651119464509,CSE 140L,A01,083088,Eldon; John,1,0,100,99
1651119470535,CSE 175,A01,083665,Kumar; Rakesh,0,0,25,25
1651119476568,CSE 190,A00,092507,Dubnov; Shlomo,9,0,20,11
1651119482595,ECE 45,A01,083139,Staff,0,8,60,60
1651119488618,ECE 65,A50,083695,Staff,0,7,30,30
1651119494643,ECE 109,A01,091882,Touri; Behrouz,32,0,70,38
1651119500665,ECE 180,A00,083140,Abi Samra; Nicholas Camill,17,0,30,13
1651119500665,ECE 180,B00,083141,Abi Samra; Nicholas Camill,0,1,30,32
1651119506692,MATH 10A,A01,083735,Patchell; Gregory David,0,0,30,30
1651119506692,MATH 10A,A02,083736,Patchell; Gregory David,26,0,30,4
1651119506692,MATH 10A,A03,083737,Patchell; Gregory David,22,0,30,8
1651119512719,MATH 10B,A01,083207,Staff,0,8,30,30
1651119512719,MATH 10B,A02,083208,Staff,0,6,30,30
1651119512719,MATH 10B,B01,083739,Staff,7,0,30,23
1651119512719,MATH 10B,B02,083740,Staff,28,0,30,2
1651119518744,MATH 18,A01,083743,Staff,0,0,30,30
1651119518744,MATH 18,A02,083744,Staff,23,0,30,7
1651119518744,MATH 18,A03,083745,Staff,19,0,30,11
1651119518744,MATH 18,A04,083746,Staff,26,0,30,4
1651119518744,MATH 18,B01,083748,Staff,0,16,30,30
1651119518744,MATH 18,B02,083749,Staff,0,15,30,30
1651119518744,MATH 18,B03,083750,Staff,0,15,30,30
1651119518744,MATH 18,B04,083751,Staff,0,15,30,30
1651119524776,MATH 20A,A01,083754,Staff,18,0,40,22
1651119530805,MATH 20B,A01,083756,Briones; Jor-el Thomas Caparas,0,14,30,30
1651119530805,MATH 20B,A02,083757,Briones; Jor-el Thomas Caparas,0,11,30,30
1651119536839,MATH 20C,A01,083760,Briones; Jor-el Thomas Caparas,1,17,30,29
1651119536839,MATH 20C,A02,083761,Briones; Jor-el Thomas Caparas,0,17,30,30
1651119536839,MATH 20C,B01,083762,Staff,6,0,30,24
1651119536839,MATH 20C,B02,083763,Staff,28,0,30,2
1651119542864,MATH 20D,A01,083765,Tran; Brian Kha,4,1,30,26
1651119542864,MATH 20D,A02,083766,Tran; Brian Kha,0,0,30,30
1651119542864,MATH 20D,A03,083767,Tran; Brian Kha,22,0,30,8
1651119548890,MATH 20E,A01,083771,Staff,0,0,30,30
1651119548890,MATH 20E,A02,083772,Staff,9,0,30,21
1651119548890,MATH 20E,B01,083773,Staff,5,0,35,30
1651119548890,MATH 20E,B02,083774,Staff,5,1,35,30
1651119554913,MATH 103A,A01,083777,Greenfeld; Be'Eri,0,17,30,30
1651119554913,MATH 103A,A02,083778,Greenfeld; Be'Eri,0,17,30,30
1651119554913,MATH 103A,B01,083779,Greenfeld; Be'Eri,0,16,30,30
1651119554913,MATH 103A,B02,083780,Greenfeld; Be'Eri,0,15,30,30
1651119560953,MATH 105,A01,085443,Staff,0,24,30,30
1651119566976,MATH 109,A01,083213,Ganzberger; Geoffrey Michael,0,8,30,30
1651119566976,MATH 109,A02,083214,Ganzberger; Geoffrey Michael,0,7,30,30
1651119566976,MATH 109,B01,083215,Ganzberger; Geoffrey Michael,0,8,30,30
1651119566976,MATH 109,B02,083216,Ganzberger; Geoffrey Michael,1,8,30,29
1651119573003,MATH 142A,A01,083219,Chow; Bennett,0,15,30,30
1651119573003,MATH 142A,A02,083220,Chow; Bennett,0,15,30,30
1651119573003,MATH 142A,B01,083221,Chow; Bennett,0,16,30,30
1651119573003,MATH 142A,B02,083222,Chow; Bennett,0,16,30,30
1651119579033,MATH 193A,A01,083224,Staff,0,9,30,30
1651119579033,MATH 193A,A02,083225,Staff,1,7,30,29
1651119579033,MATH 193A,A03,083781,Staff,0,7,30,30
1651119579033,MATH 193A,A04,083782,Staff,0,7,30,30
1651119585057,MATH 197,001,091859,McAuley; Julian John,9998,0,9999,1
1651119591114,COGS 9,A01,083615,Staff,0,20,60,60
1651119597230,COGS 11,A01,083617,Boyle; Mary E. T.,13,0,40,27
1651119603255,COGS 13,A01,083071,Staff,0,39,40,40
1651119609287,COGS 14A,A01,092681,Staff,0,41,100,100
1651119615311,COGS 14B,A01,083073,Cheng; Tzu-Han,0,11,50,50
1651119621337,COGS 17,A01,092677,Staff,8,0,75,67
1651119627360,COGS 100,A01,083619,Staff,0,30,60,60
1651119633386,COGS 101A,A01,083621,Davis; Joshua Daniel,0,29,60,60
1651119639409,COGS 101B,A01,091572,Staff,0,8,60,60
1651119645442,COGS 101C,A01,083625,Delgado; Tania,12,0,30,18
1651119651465,COGS 107A,A01,083627,Boyle; Mary E. T.,0,17,60,60
1651119657493,COGS 118A,A01,083075,Staff,0,10,60,60
1651119663515,CSE 3,A50,083646,Miranda; Gregory Joseph,15,0,38,23
1651119663515,CSE 3,A51,083647,Miranda; Gregory Joseph,36,0,37,1
1651119669539,CSE 8A,A50,083650,Miranda; Gregory Joseph,0,30,40,40
1651119675562,CSE 11,A01,083080,Cao; Yingjun,1,99,40,39
1651119681598,CSE 12,A01,083652,Staff,0,30,100,100
1651119687625,CSE 15L,A01,083654,Staff,0,4,50,50
1651119687625,CSE 15L,A02,083655,Staff,0,3,50,50
1651119693648,CSE 20,A01,083657,Staff,47,0,80,33
1651119699675,CSE 30,A01,083084,Eldon; John,0,39,80,80
1651119705698,CSE 100,A01,083659,Cao; Yingjun,0,72,50,50
1651119711724,CSE 134B,A01,083661,Powell; Thomas Allan,0,38,65,65
1651119717778,CSE 140,A01,083663,Staff,0,17,75,75
1651119723802,CSE 140L,A01,083088,Eldon; John,1,0,100,99
1651119729825,CSE 175,A01,083665,Kumar; Rakesh,0,0,25,25
1651119735854,CSE 190,A00,092507,Dubnov; Shlomo,9,0,20,11
1651119741877,ECE 45,A01,083139,Staff,0,8,60,60
1651119747904,ECE 65,A50,083695,Staff,0,7,30,30
1651119753929,ECE 109,A01,091882,Touri; Behrouz,32,0,70,38
1651119759953,ECE 180,A00,083140,Abi Samra; Nicholas Camill,17,0,30,13
1651119759953,ECE 180,B00,083141,Abi Samra; Nicholas Camill,0,1,30,32
1651119765980,MATH 10A,A01,083735,Patchell; Gregory David,0,0,30,30
1651119765980,MATH 10A,A02,083736,Patchell; Gregory David,26,0,30,4
1651119765980,MATH 10A,A03,083737,Patchell; Gregory David,22,0,30,8
1651119772004,MATH 10B,A01,083207,Staff,0,8,30,30
1651119772004,MATH 10B,A02,083208,Staff,0,6,30,30
1651119772004,MATH 10B,B01,083739,Staff,7,0,30,23
1651119772004,MATH 10B,B02,083740,Staff,28,0,30,2
1651119778033,MATH 18,A01,083743,Staff,0,0,30,30
1651119778033,MATH 18,A02,083744,Staff,23,0,30,7
1651119778033,MATH 18,A03,083745,Staff,19,0,30,11
1651119778033,MATH 18,A04,083746,Staff,26,0,30,4
1651119778033,MATH 18,B01,083748,Staff,0,16,30,30
1651119778033,MATH 18,B02,083749,Staff,0,15,30,30
1651119778033,MATH 18,B03,083750,Staff,0,15,30,30
1651119778033,MATH 18,B04,083751,Staff,0,15,30,30
1651119784057,MATH 20A,A01,083754,Staff,18,0,40,22
1651119790080,MATH 20B,A01,083756,Briones; Jor-el Thomas Caparas,0,14,30,30
1651119790080,MATH 20B,A02,083757,Briones; Jor-el Thomas Caparas,0,11,30,30
1651119796118,MATH 20C,A01,083760,Briones; Jor-el Thomas Caparas,1,17,30,29
1651119796118,MATH 20C,A02,083761,Briones; Jor-el Thomas Caparas,0,17,30,30
1651119796118,MATH 20C,B01,083762,Staff,6,0,30,24
1651119796118,MATH 20C,B02,083763,Staff,28,0,30,2
1651119802146,MATH 20D,A01,083765,Tran; Brian Kha,4,1,30,26
1651119802146,MATH 20D,A02,083766,Tran; Brian Kha,0,0,30,30
1651119802146,MATH 20D,A03,083767,Tran; Brian Kha,22,0,30,8
1651119808176,MATH 20E,A01,083771,Staff,0,0,30,30
1651119808176,MATH 20E,A02,083772,Staff,9,0,30,21
1651119808176,MATH 20E,B01,083773,Staff,5,0,35,30
1651119808176,MATH 20E,B02,083774,Staff,5,1,35,30
1651119814204,MATH 103A,A01,083777,Greenfeld; Be'Eri,0,17,30,30
1651119814204,MATH 103A,A02,083778,Greenfeld; Be'Eri,0,17,30,30
1651119814204,MATH 103A,B01,083779,Greenfeld; Be'Eri,0,16,30,30
1651119814204,MATH 103A,B02,083780,Greenfeld; Be'Eri,0,15,30,30
1651119820226,MATH 105,A01,085443,Staff,0,24,30,30
1651119826254,MATH 109,A01,083213,Ganzberger; Geoffrey Michael,0,8,30,30
1651119826254,MATH 109,A02,083214,Ganzberger; Geoffrey Michael,0,7,30,30
1651119826254,MATH 109,B01,083215,Ganzberger; Geoffrey Michael,0,8,30,30
1651119826254,MATH 109,B02,083216,Ganzberger; Geoffrey Michael,1,8,30,29
1651119832282,MATH 142A,A01,083219,Chow; Bennett,0,15,30,30
1651119832282,MATH 142A,A02,083220,Chow; Bennett,0,15,30,30
1651119832282,MATH 142A,B01,083221,Chow; Bennett,0,16,30,30
1651119832282,MATH 142A,B02,083222,Chow; Bennett,0,16,30,30
1651119838304,MATH 193A,A01,083224,Staff,0,9,30,30
1651119838304,MATH 193A,A02,083225,Staff,1,7,30,29
1651119838304,MATH 193A,A03,083781,Staff,0,7,30,30
1651119838304,MATH 193A,A04,083782,Staff,0,7,30,30
1651119844325,MATH 197,001,091859,McAuley; Julian John,9998,0,9999,1
1651119850375,COGS 9,A01,083615,Staff,0,20,60,60
1651119856399,COGS 11,A01,083617,Boyle; Mary E. T.,13,0,40,27
1651119862424,COGS 13,A01,083071,Staff,0,39,40,40
1651119868447,COGS 14A,A01,092681,Staff,0,41,100,100
1651119874470,COGS 14B,A01,083073,Cheng; Tzu-Han,0,11,50,50
1651119880496,COGS 17,A01,092677,Staff,8,0,75,67
1651119886520,COGS 100,A01,083619,Staff,0,30,60,60
1651119892552,COGS 101A,A01,083621,Davis; Joshua Daniel,0,29,60,60
1651119898576,COGS 101B,A01,091572,Staff,0,8,60,60
1651119904600,COGS 101C,A01,083625,Delgado; Tania,12,0,30,18
1651119910626,COGS 107A,A01,083627,Boyle; Mary E. T.,0,17,60,60
1651119916652,COGS 118A,A01,083075,Staff,0,10,60,60
1651119922678,CSE 3,A50,083646,Miranda; Gregory Joseph,15,0,38,23
1651119922678,CSE 3,A51,083647,Miranda; Gregory Joseph,36,0,37,1
1651119928701,CSE 8A,A50,083650,Miranda; Gregory Joseph,0,30,40,40
1651119934727,CSE 11,A01,083080,Cao; Yingjun,1,99,40,39
1651119940753,CSE 12,A01,083652,Staff,0,30,100,100
1651119946778,CSE 15L,A01,083654,Staff,0,4,50,50
1651119946778,CSE 15L,A02,083655,Staff,0,3,50,50
1651119952804,CSE 20,A01,083657,Staff,47,0,80,33
1651119958828,CSE 30,A01,083084,Eldon; John,0,39,80,80
1651119964859,CSE 100,A01,083659,Cao; Yingjun,0,72,50,50
1651119970890,CSE 134B,A01,083661,Powell; Thomas Allan,0,38,65,65
1651119976923,CSE 140,A01,083663,Staff,0,17,75,75
1651119982947,CSE 140L,A01,083088,Eldon; John,1,0,100,99
1651119988969,CSE 175,A01,083665,Kumar; Rakesh,0,0,25,25
1651119994993,CSE 190,A00,092507,Dubnov; Shlomo,9,0,20,11
1651120001015,ECE 45,A01,083139,Staff,0,8,60,60
1651120007042,ECE 65,A50,083695,Staff,0,7,30,30
1651120013065,ECE 109,A01,091882,Touri; Behrouz,32,0,70,38
1651120019090,ECE 180,A00,083140,Abi Samra; Nicholas Camill,17,0,30,13
1651120019090,ECE 180,B00,083141,Abi Samra; Nicholas Camill,0,1,30,32
1651120025113,MATH 10A,A01,083735,Patchell; Gregory David,0,0,30,30
1651120025113,MATH 10A,A02,083736,Patchell; Gregory David,26,0,30,4
1651120025113,MATH 10A,A03,083737,Patchell; Gregory David,22,0,30,8
1651120031138,MATH 10B,A01,083207,Staff,0,8,30,30
1651120031138,MATH 10B,A02,083208,Staff,0,6,30,30
1651120031138,MATH 10B,B01,083739,Staff,7,0,30,23
1651120031138,MATH 10B,B02,083740,Staff,28,0,30,2
1651120037169,MATH 18,A01,083743,Staff,0,0,30,30
1651120037169,MATH 18,A02,083744,Staff,23,0,30,7
1651120037169,MATH 18,A03,083745,Staff,19,0,30,11
1651120037169,MATH 18,A04,083746,Staff,26,0,30,4
1651120037169,MATH 18,B01,083748,Staff,0,16,30,30
1651120037169,MATH 18,B02,083749,Staff,0,15,30,30
1651120037169,MATH 18,B03,083750,Staff,0,15,30,30
1651120037169,MATH 18,B04,083751,Staff,0,15,30,30
1651120043191,MATH 20A,A01,083754,Staff,18,0,40,22
1651120049215,MATH 20B,A01,083756,Briones; Jor-el Thomas Caparas,0,14,30,30
1651120049215,MATH 20B,A02,083757,Briones; Jor-el Thomas Caparas,0,11,30,30
1651120055242,MATH 20C,A01,083760,Briones; Jor-el Thomas Caparas,1,17,30,29
1651120055242,MATH 20C,A02,083761,Briones; Jor-el Thomas Caparas,0,17,30,30
1651120055242,MATH 20C,B01,083762,Staff,6,0,30,24
1651120055242,MATH 20C,B02,083763,Staff,28,0,30,2
1651120061266,MATH 20D,A01,083765,Tran; Brian Kha,4,1,30,26
1651120061266,MATH 20D,A02,083766,Tran; Brian Kha,0,0,30,30
1651120061266,MATH 20D,A03,083767,Tran; Brian Kha,22,0,30,8
1651120067296,MATH 20E,A01,083771,Staff,0,0,30,30
1651120067296,MATH 20E,A02,083772,Staff,9,0,30,21
1651120067296,MATH 20E,B01,083773,Staff,5,0,35,30
1651120067296,MATH 20E,B02,083774,Staff,5,1,35,30
1651120073319,MATH 103A,A01,083777,Greenfeld; Be'Eri,0,17,30,30
1651120073319,MATH 103A,A02,083778,Greenfeld; Be'Eri,0,17,30,30
1651120073319,MATH 103A,B01,083779,Greenfeld; Be'Eri,0,16,30,30
1651120073319,MATH 103A,B02,083780,Greenfeld; Be'Eri,0,15,30,30
1651120079343,MATH 105,A01,085443,Staff,0,24,30,30
1651120085368,MATH 109,A01,083213,Ganzberger; Geoffrey Michael,0,8,30,30
1651120085368,MATH 109,A02,083214,Ganzberger; Geoffrey Michael,0,7,30,30
1651120085368,MATH 109,B01,083215,Ganzberger; Geoffrey Michael,0,8,30,30
1651120085368,MATH 109,B02,083216,Ganzberger; Geoffrey Michael,1,8,30,29
1651120091396,MATH 142A,A01,083219,Chow; Bennett,0,15,30,30
1651120091396,MATH 142A,A02,083220,Chow; Bennett,0,15,30,30
1651120091396,MATH 142A,B01,083221,Chow; Bennett,0,16,30,30
1651120091396,MATH 142A,B02,083222,Chow; Bennett,0,16,30,30
1651120097425,MATH 193A,A01,083224,Staff,0,9,30,30
1651120097425,MATH 193A,A02,083225,Staff,1,7,30,29
1651120097425,MATH 193A,A03,083781,Staff,0,7,30,30
1651120097425,MATH 193A,A04,083782,Staff,0,7,30,30
1651120103451,MATH 197,001,091859,McAuley; Julian John,9998,0,9999,1
1651120109498,COGS 9,A01,083615,Staff,0,20,60,60
1651120115521,COGS 11,A01,083617,Boyle; Mary E. T.,13,0,40,27
1651120121543,COGS 13,A01,083071,Staff,0,39,40,40
1651120127566,COGS 14A,A01,092681,Staff,0,41,100,100
1651120133588,COGS 14B,A01,083073,Cheng; Tzu-Han,0,11,50,50
1651120139612,COGS 17,A01,092677,Staff,8,0,75,67
1651120145641,COGS 100,A01,083619,Staff,0,30,60,60
1651120151666,COGS 101A,A01,083621,Davis; Joshua Daniel,0,29,60,60
1651120157689,COGS 101B,A01,091572,Staff,0,8,60,60
1651120163713,COGS 101C,A01,083625,Delgado; Tania,12,0,30,18
1651120169736,COGS 107A,A01,083627,Boyle; Mary E. T.,0,17,60,60
1651120175761,COGS 118A,A01,083075,Staff,0,10,60,60
1651120181788,CSE 3,A50,083646,Miranda; Gregory Joseph,15,0,38,23
1651120181788,CSE 3,A51,083647,Miranda; Gregory Joseph,36,0,37,1
1651120187812,CSE 8A,A50,083650,Miranda; Gregory Joseph,0,30,40,40
1651120193939,CSE 11,A01,083080,Cao; Yingjun,1,99,40,39
1651120199966,CSE 12,A01,083652,Staff,0,30,100,100
1651120205988,CSE 15L,A01,083654,Staff,0,4,50,50
1651120205988,CSE 15L,A02,083655,Staff,0,3,50,50
1651120212014,CSE 20,A01,083657,Staff,47,0,80,33
1651120218049,CSE 30,A01,083084,Eldon; John,0,39,80,80
1651120224076,CSE 100,A01,083659,Cao; Yingjun,0,72,50,50
1651120230099,CSE 134B,A01,083661,Powell; Thomas Allan,0,38,65,65
1651120236124,CSE 140,A01,083663,Staff,0,17,75,75
1651120242147,CSE 140L,A01,083088,Eldon; John,1,0,100,99
1651120248170,CSE 175,A01,083665,Kumar; Rakesh,0,0,25,25
1651120254194,CSE 190,A00,092507,Dubnov; Shlomo,9,0,20,11
1651120260221,ECE 45,A01,083139,Staff,0,8,60,60
1651120266243,ECE 65,A50,083695,Staff,0,7,30,30
1651120272266,ECE 109,A01,091882,Touri; Behrouz,32,0,70,38
1651120278289,ECE 180,A00,083140,Abi Samra; Nicholas Camill,17,0,30,13
1651120278289,ECE 180,B00,083141,Abi Samra; Nicholas Camill,0,1,30,32
1651120284321,MATH 10A,A01,083735,Patchell; Gregory David,0,0,30,30
1651120284321,MATH 10A,A02,083736,Patchell; Gregory David,26,0,30,4
1651120284321,MATH 10A,A03,083737,Patchell; Gregory David,22,0,30,8
1651120290346,MATH 10B,A01,083207,Staff,0,9,30,30
1651120290346,MATH 10B,A02,083208,Staff,0,6,30,30
1651120290346,MATH 10B,B01,083739,Staff,7,0,30,23
1651120290346,MATH 10B,B02,083740,Staff,28,0,30,2
1651120296368,MATH 18,A01,083743,Staff,0,0,30,30
1651120296368,MATH 18,A02,083744,Staff,23,0,30,7
1651120296368,MATH 18,A03,083745,Staff,19,0,30,11
1651120296368,MATH 18,A04,083746,Staff,26,0,30,4
1651120296368,MATH 18,B01,083748,Staff,0,16,30,30
1651120296368,MATH 18,B02,083749,Staff,0,15,30,30
1651120296368,MATH 18,B03,083750,Staff,0,15,30,30
1651120296368,MATH 18,B04,083751,Staff,0,15,30,30
1651120302398,MATH 20A,A01,083754,Staff,18,0,40,22
1651120308421,MATH 20B,A01,083756,Briones; Jor-el Thomas Caparas,0,14,30,30
1651120308421,MATH 20B,A02,083757,Briones; Jor-el Thomas Caparas,0,11,30,30
1651120314449,MATH 20C,A01,083760,Briones; Jor-el Thomas Caparas,1,17,30,29
1651120314449,MATH 20C,A02,083761,Briones; Jor-el Thomas Caparas,0,17,30,30
1651120314449,MATH 20C,B01,083762,Staff,6,0,30,24
1651120314449,MATH 20C,B02,083763,Staff,28,0,30,2
1651120320486,MATH 20D,A01,083765,Tran; Brian Kha,4,1,30,26
1651120320486,MATH 20D,A02,083766,Tran; Brian Kha,0,0,30,30
1651120320486,MATH 20D,A03,083767,Tran; Brian Kha,22,0,30,8
1651120326510,MATH 20E,A01,083771,Staff,0,0,30,30
1651120326510,MATH 20E,A02,083772,Staff,9,0,30,21
1651120326510,MATH 20E,B01,083773,Staff,5,0,35,30
1651120326510,MATH 20E,B02,083774,Staff,5,1,35,30
1651120332538,MATH 103A,A01,083777,Greenfeld; Be'Eri,0,17,30,30
1651120332538,MATH 103A,A02,083778,Greenfeld; Be'Eri,0,17,30,30
1651120332538,MATH 103A,B01,083779,Greenfeld; Be'Eri,0,16,30,30
1651120332538,MATH 103A,B02,083780,Greenfeld; Be'Eri,0,15,30,30
1651120338565,MATH 105,A01,085443,Staff,0,24,30,30
1651120344588,MATH 109,A01,083213,Ganzberger; Geoffrey Michael,0,8,30,30
1651120344588,MATH 109,A02,083214,Ganzberger; Geoffrey Michael,0,7,30,30
1651120344588,MATH 109,B01,083215,Ganzberger; Geoffrey Michael,0,8,30,30
1651120344588,MATH 109,B02,083216,Ganzberger; Geoffrey Michael,1,8,30,29
1651120350612,MATH 142A,A01,083219,Chow; Bennett,0,15,30,30
1651120350612,MATH 142A,A02,083220,Chow; Bennett,0,15,30,30
1651120350612,MATH 142A,B01,083221,Chow; Bennett,0,16,30,30
1651120350612,MATH 142A,B02,083222,Chow; Bennett,0,16,30,30
1651120356634,MATH 193A,A01,083224,Staff,0,9,30,30
1651120356634,MATH 193A,A02,083225,Staff,1,7,30,29
1651120356634,MATH 193A,A03,083781,Staff,0,7,30,30
1651120356634,MATH 193A,A04,083782,Staff,0,7,30,30
1651120362657,MATH 197,001,091859,McAuley; Julian John,9998,0,9999,1
1651120368713,COGS 9,A01,083615,Staff,0,20,60,60
1651120374736,COGS 11,A01,083617,Boyle; Mary E. T.,13,0,40,27
1651120380765,COGS 13,A01,083071,Staff,0,39,40,40
1651120386789,COGS 14A,A01,092681,Staff,0,41,100,100
1651120392811,COGS 14B,A01,083073,Cheng; Tzu-Han,0,11,50,50
1651120398836,COGS 17,A01,092677,Staff,8,0,75,67
1651120404858,COGS 100,A01,083619,Staff,0,30,60,60
1651120410881,COGS 101A,A01,083621,Davis; Joshua Daniel,0,29,60,60
1651120416906,COGS 101B,A01,091572,Staff,0,8,60,60
1651120422931,COGS 101C,A01,083625,Delgado; Tania,12,0,30,18
1651120428956,COGS 107A,A01,083627,Boyle; Mary E. T.,0,17,60,60
1651120434982,COGS 118A,A01,083075,Staff,0,10,60,60
1651120441011,CSE 3,A50,083646,Miranda; Gregory Joseph,15,0,38,23
1651120441011,CSE 3,A51,083647,Miranda; Gregory Joseph,36,0,37,1
1651120447033,CSE 8A,A50,083650,Miranda; Gregory Joseph,0,30,40,40
1651120453056,CSE 11,A01,083080,Cao; Yingjun,1,99,40,39
1651120459081,CSE 12,A01,083652,Staff,0,30,100,100
1651120465118,CSE 15L,A01,083654,Staff,0,4,50,50
1651120465118,CSE 15L,A02,083655,Staff,0,3,50,50
1651120471142,CSE 20,A01,083657,Staff,47,0,80,33
1651120477168,CSE 30,A01,083084,Eldon; John,0,39,80,80
1651120483194,CSE 100,A01,083659,Cao; Yingjun,0,72,50,50
1651120489218,CSE 134B,A01,083661,Powell; Thomas Allan,0,38,65,65
1651120495243,CSE 140,A01,083663,Staff,0,17,75,75
1651120501269,CSE 140L,A01,083088,Eldon; John,1,0,100,99
1651120507292,CSE 175,A01,083665,Kumar; Rakesh,0,0,25,25
1651120513319,CSE 190,A00,092507,Dubnov; Shlomo,9,0,20,11
1651120519344,ECE 45,A01,083139,Staff,0,8,60,60
1651120525367,ECE 65,A50,083695,Staff,0,7,30,30
1651120531389,ECE 109,A01,091882,Touri; Behrouz,32,0,70,38
1651120537416,ECE 180,A00,083140,Abi Samra; Nicholas Camill,17,0,30,13
1651120537416,ECE 180,B00,083141,Abi Samra; Nicholas Camill,0,1,30,32
1651120543438,MATH 10A,A01,083735,Patchell; Gregory David,0,0,30,30
1651120543438,MATH 10A,A02,083736,Patchell; Gregory David,26,0,30,4
1651120543438,MATH 10A,A03,083737,Patchell; Gregory David,22,0,30,8
1651120549474,MATH 10B,A01,083207,Staff,0,9,30,30
1651120549474,MATH 10B,A02,083208,Staff,0,6,30,30
1651120549474,MATH 10B,B01,083739,Staff,7,0,30,23
1651120549474,MATH 10B,B02,083740,Staff,28,0,30,2
1651120555499,MATH 18,A01,083743,Staff,0,0,30,30
1651120555499,MATH 18,A02,083744,Staff,23,0,30,7
1651120555499,MATH 18,A03,083745,Staff,19,0,30,11
1651120555499,MATH 18,A04,083746,Staff,26,0,30,4
1651120555499,MATH 18,B01,083748,Staff,0,16,30,30
1651120555499,MATH 18,B02,083749,Staff,0,15,30,30
1651120555499,MATH 18,B03,083750,Staff,0,15,30,30
1651120555499,MATH 18,B04,083751,Staff,0,15,30,30
1651120561525,MATH 20A,A01,083754,Staff,18,0,40,22
1651120567548,MATH 20B,A01,083756,Briones; Jor-el Thomas Caparas,0,14,30,30
1651120567548,MATH 20B,A02,083757,Briones; Jor-el Thomas Caparas,0,11,30,30
1651120573571,MATH 20C,A01,083760,Briones; Jor-el Thomas Caparas,1,17,30,29
1651120573571,MATH 20C,A02,083761,Briones; Jor-el Thomas Caparas,0,17,30,30
1651120573571,MATH 20C,B01,083762,Staff,6,0,30,24
1651120573571,MATH 20C,B02,083763,Staff,28,0,30,2
1651120579594,MATH 20D,A01,083765,Tran; Brian Kha,4,1,30,26
1651120579594,MATH 20D,A02,083766,Tran; Brian Kha,0,0,30,30
1651120579594,MATH 20D,A03,083767,Tran; Brian Kha,22,0,30,8
1651120585619,MATH 20E,A01,083771,Staff,0,0,30,30
1651120585619,MATH 20E,A02,083772,Staff,9,0,30,21
1651120585619,MATH 20E,B01,083773,Staff,5,0,35,30
1651120585619,MATH 20E,B02,083774,Staff,5,1,35,30
1651120591642,MATH 103A,A01,083777,Greenfeld; Be'Eri,0,17,30,30
1651120591642,MATH 103A,A02,083778,Greenfeld; Be'Eri,0,17,30,30
1651120591642,MATH 103A,B01,083779,Greenfeld; Be'Eri,0,16,30,30
1651120591642,MATH 103A,B02,083780,Greenfeld; Be'Eri,0,15,30,30
1651120597665,MATH 105,A01,085443,Staff,0,24,30,30
1651120603692,MATH 109,A01,083213,Ganzberger; Geoffrey Michael,0,8,30,30
1651120603692,MATH 109,A02,083214,Ganzberger; Geoffrey Michael,0,7,30,30
1651120603692,MATH 109,B01,083215,Ganzberger; Geoffrey Michael,0,8,30,30
1651120603692,MATH 109,B02,083216,Ganzberger; Geoffrey Michael,1,8,30,29
1651120609715,MATH 142A,A01,083219,Chow; Bennett,0,15,30,30
1651120609715,MATH 142A,A02,083220,Chow; Bennett,0,15,30,30
1651120609715,MATH 142A,B01,083221,Chow; Bennett,0,16,30,30
1651120609715,MATH 142A,B02,083222,Chow; Bennett,0,16,30,30
1651120615742,MATH 193A,A01,083224,Staff,0,9,30,30
1651120615742,MATH 193A,A02,083225,Staff,1,7,30,29
1651120615742,MATH 193A,A03,083781,Staff,0,7,30,30
1651120615742,MATH 193A,A04,083782,Staff,0,7,30,30
1651120621773,MATH 197,001,091859,McAuley; Julian John,9998,0,9999,1
1651120627821,COGS 9,A01,083615,Staff,0,20,60,60
1651120633843,COGS 11,A01,083617,Boyle; Mary E. T.,13,0,40,27
1651120639869,COGS 13,A01,083071,Staff,0,39,40,40
1651120645894,COGS 14A,A01,092681,Staff,0,41,100,100
1651120651916,COGS 14B,A01,083073,Cheng; Tzu-Han,0,11,50,50
1651120657945,COGS 17,A01,092677,Staff,8,0,75,67
1651120663977,COGS 100,A01,083619,Staff,0,30,60,60
1651120670000,COGS 101A,A01,083621,Davis; Joshua Daniel,0,29,60,60
1651120676025,COGS 101B,A01,091572,Staff,0,8,60,60
1651120682050,COGS 101C,A01,083625,Delgado; Tania,12,0,30,18
1651120688077,COGS 107A,A01,083627,Boyle; Mary E. T.,0,17,60,60
1651120694100,COGS 118A,A01,083075,Staff,0,10,60,60
1651120700128,CSE 3,A50,083646,Miranda; Gregory Joseph,15,0,38,23
1651120700128,CSE 3,A51,083647,Miranda; Gregory Joseph,36,0,37,1
1651120706157,CSE 8A,A50,083650,Miranda; Gregory Joseph,0,30,40,40
1651120712189,CSE 11,A01,083080,Cao; Yingjun,1,99,40,39
1651120718215,CSE 12,A01,083652,Staff,0,30,100,100
1651120724240,CSE 15L,A01,083654,Staff,0,4,50,50
1651120724240,CSE 15L,A02,083655,Staff,0,3,50,50
1651120730266,CSE 20,A01,083657,Staff,47,0,80,33
1651120736290,CSE 30,A01,083084,Eldon; John,0,39,80,80
1651120742312,CSE 100,A01,083659,Cao; Yingjun,0,72,50,50
1651120748338,CSE 134B,A01,083661,Powell; Thomas Allan,0,38,65,65
1651120754360,CSE 140,A01,083663,Staff,0,17,75,75
1651120760387,CSE 140L,A01,083088,Eldon; John,1,0,100,99
1651120766412,CSE 175,A01,083665,Kumar; Rakesh,0,0,25,25
1651120772442,CSE 190,A00,092507,Dubnov; Shlomo,9,0,20,11
1651120778478,ECE 45,A01,083139,Staff,0,8,60,60
1651120784503,ECE 65,A50,083695,Staff,0,7,30,30
1651120790623,ECE 109,A01,091882,Touri; Behrouz,32,0,70,38
1651120796648,ECE 180,A00,083140,Abi Samra; Nicholas Camill,17,0,30,13
1651120796648,ECE 180,B00,083141,Abi Samra; Nicholas Camill,0,1,30,32
1651120802675,MATH 10A,A01,083735,Patchell; Gregory David,0,0,30,30
1651120802675,MATH 10A,A02,083736,Patchell; Gregory David,26,0,30,4
1651120802675,MATH 10A,A03,083737,Patchell; Gregory David,22,0,30,8
1651120808704,MATH 10B,A01,083207,Staff,0,9,30,30
1651120808704,MATH 10B,A02,083208,Staff,0,6,30,30
1651120808704,MATH 10B,B01,083739,Staff,7,0,30,23
1651120808704,MATH 10B,B02,083740,Staff,28,0,30,2
1651120814726,MATH 18,A01,083743,Staff,0,0,30,30
1651120814726,MATH 18,A02,083744,Staff,23,0,30,7
1651120814726,MATH 18,A03,083745,Staff,19,0,30,11
1651120814726,MATH 18,A04,083746,Staff,26,0,30,4
1651120814726,MATH 18,B01,083748,Staff,0,16,30,30
1651120814726,MATH 18,B02,083749,Staff,0,15,30,30
1651120814726,MATH 18,B03,083750,Staff,0,15,30,30
1651120814726,MATH 18,B04,083751,Staff,0,15,30,30
1651120820748,MATH 20A,A01,083754,Staff,18,0,40,22
1651120826771,MATH 20B,A01,083756,Briones; Jor-el Thomas Caparas,0,14,30,30
1651120826771,MATH 20B,A02,083757,Briones; Jor-el Thomas Caparas,0,11,30,30
1651120832794,MATH 20C,A01,083760,Briones; Jor-el Thomas Caparas,1,17,30,29
1651120832794,MATH 20C,A02,083761,Briones; Jor-el Thomas Caparas,0,17,30,30
1651120832794,MATH 20C,B01,083762,Staff,6,0,30,24
1651120832794,MATH 20C,B02,083763,Staff,28,0,30,2
1651120838820,MATH 20D,A01,083765,Tran; Brian Kha,4,1,30,26
1651120838820,MATH 20D,A02,083766,Tran; Brian Kha,0,0,30,30
1651120838820,MATH 20D,A03,083767,Tran; Brian Kha,22,0,30,8
1651120844844,MATH 20E,A01,083771,Staff,0,0,30,30
1651120844844,MATH 20E,A02,083772,Staff,9,0,30,21
1651120844844,MATH 20E,B01,083773,Staff,5,0,35,30
1651120844844,MATH 20E,B02,083774,Staff,5,1,35,30
1651120850868,MATH 103A,A01,083777,Greenfeld; Be'Eri,0,17,30,30
1651120850868,MATH 103A,A02,083778,Greenfeld; Be'Eri,0,17,30,30
1651120850868,MATH 103A,B01,083779,Greenfeld; Be'Eri,0,16,30,30
1651120850868,MATH 103A,B02,083780,Greenfeld; Be'Eri,0,15,30,30
1651120856894,MATH 105,A01,085443,Staff,0,24,30,30
1651120862918,MATH 109,A01,083213,Ganzberger; Geoffrey Michael,0,8,30,30
1651120862918,MATH 109,A02,083214,Ganzberger; Geoffrey Michael,0,7,30,30
1651120862918,MATH 109,B01,083215,Ganzberger; Geoffrey Michael,0,8,30,30
1651120862918,MATH 109,B02,083216,Ganzberger; Geoffrey Michael,1,8,30,29
1651120868940,MATH 142A,A01,083219,Chow; Bennett,0,15,30,30
1651120868940,MATH 142A,A02,083220,Chow; Bennett,0,15,30,30
1651120868940,MATH 142A,B01,083221,Chow; Bennett,0,16,30,30
1651120868940,MATH 142A,B02,083222,Chow; Bennett,0,16,30,30
1651120874964,MATH 193A,A01,083224,Staff,0,9,30,30
1651120874964,MATH 193A,A02,083225,Staff,1,7,30,29
1651120874964,MATH 193A,A03,083781,Staff,0,7,30,30
1651120874964,MATH 193A,A04,083782,Staff,0,7,30,30
1651120880988,MATH 197,001,091859,McAuley; Julian John,9998,0,9999,1
1651120887048,COGS 9,A01,083615,Staff,0,20,60,60
1651120893073,COGS 11,A01,083617,Boyle; Mary E. T.,13,0,40,27
1651120899096,COGS 13,A01,083071,Staff,0,39,40,40
1651120905120,COGS 14A,A01,092681,Staff,0,41,100,100
1651120911143,COGS 14B,A01,083073,Cheng; Tzu-Han,0,11,50,50
1651120917167,COGS 17,A01,092677,Staff,8,0,75,67
1651120923199,COGS 100,A01,083619,Staff,0,30,60,60
1651120929225,COGS 101A,A01,083621,Davis; Joshua Daniel,0,29,60,60
1651120935250,COGS 101B,A01,091572,Staff,0,8,60,60
1651120941274,COGS 101C,A01,083625,Delgado; Tania,12,0,30,18
1651120947298,COGS 107A,A01,083627,Boyle; Mary E. T.,0,17,60,60
1651120953352,COGS 118A,A01,083075,Staff,0,10,60,60
1651120959386,CSE 3,A50,083646,Miranda; Gregory Joseph,15,0,38,23
1651120959386,CSE 3,A51,083647,Miranda; Gregory Joseph,36,0,37,1
1651120965409,CSE 8A,A50,083650,Miranda; Gregory Joseph,0,30,40,40
1651120971432,CSE 11,A01,083080,Cao; Yingjun,1,99,40,39
1651120977457,CSE 12,A01,083652,Staff,0,30,100,100
1651120983489,CSE 15L,A01,083654,Staff,0,4,50,50
1651120983489,CSE 15L,A02,083655,Staff,0,3,50,50
1651120989512,CSE 20,A01,083657,Staff,47,0,80,33
1651120995535,CSE 30,A01,083084,Eldon; John,0,39,80,80
1651121001561,CSE 100,A01,083659,Cao; Yingjun,0,72,50,50
1651121007585,CSE 134B,A01,083661,Powell; Thomas Allan,0,38,65,65
1651121013615,CSE 140,A01,083663,Staff,0,17,75,75
1651121019641,CSE 140L,A01,083088,Eldon; John,1,0,100,99
1651121025665,CSE 175,A01,083665,Kumar; Rakesh,0,0,25,25
1651121031691,CSE 190,A00,092507,Dubnov; Shlomo,9,0,20,11
1651121037725,ECE 45,A01,083139,Staff,0,8,60,60
1651121043748,ECE 65,A50,083695,Staff,0,7,30,30
1651121049774,ECE 109,A01,091882,Touri; Behrouz,32,0,70,38
1651121055803,ECE 180,A00,083140,Abi Samra; Nicholas Camill,17,0,30,13
1651121055803,ECE 180,B00,083141,Abi Samra; Nicholas Camill,0,1,30,32
1651121061827,MATH 10A,A01,083735,Patchell; Gregory David,0,0,30,30
1651121061827,MATH 10A,A02,083736,Patchell; Gregory David,26,0,30,4
1651121061827,MATH 10A,A03,083737,Patchell; Gregory David,22,0,30,8
1651121067856,MATH 10B,A01,083207,Staff,0,8,30,30
1651121067856,MATH 10B,A02,083208,Staff,0,7,30,30
1651121067856,MATH 10B,B01,083739,Staff,7,0,30,23
1651121067856,MATH 10B,B02,083740,Staff,28,0,30,2
1651121073882,MATH 18,A01,083743,Staff,0,0,30,30
1651121073882,MATH 18,A02,083744,Staff,23,0,30,7
1651121073882,MATH 18,A03,083745,Staff,19,0,30,11
1651121073882,MATH 18,A04,083746,Staff,26,0,30,4
1651121073882,MATH 18,B01,083748,Staff,0,16,30,30
1651121073882,MATH 18,B02,083749,Staff,0,15,30,30
1651121073882,MATH 18,B03,083750,Staff,0,15,30,30
1651121073882,MATH 18,B04,083751,Staff,0,15,30,30
1651121079908,MATH 20A,A01,083754,Staff,18,0,40,22
1651121085934,MATH 20B,A01,083756,Briones; Jor-el Thomas Caparas,0,14,30,30
1651121085934,MATH 20B,A02,083757,Briones; Jor-el Thomas Caparas,0,11,30,30
1651121091970,MATH 20C,A01,083760,Briones; Jor-el Thomas Caparas,1,17,30,29
1651121091970,MATH 20C,A02,083761,Briones; Jor-el Thomas Caparas,0,17,30,30
1651121091970,MATH 20C,B01,083762,Staff,6,0,30,24
1651121091970,MATH 20C,B02,083763,Staff,28,0,30,2
1651121098004,MATH 20D,A01,083765,Tran; Brian Kha,4,1,30,26
1651121098004,MATH 20D,A02,083766,Tran; Brian Kha,0,0,30,30
1651121098004,MATH 20D,A03,083767,Tran; Brian Kha,22,0,30,8
1651121104030,MATH 20E,A01,083771,Staff,0,0,30,30
1651121104030,MATH 20E,A02,083772,Staff,9,0,30,21
1651121104030,MATH 20E,B01,083773,Staff,5,0,35,30
1651121104030,MATH 20E,B02,083774,Staff,5,1,35,30
1651121110054,MATH 103A,A01,083777,Greenfeld; Be'Eri,0,17,30,30
1651121110054,MATH 103A,A02,083778,Greenfeld; Be'Eri,0,17,30,30
1651121110054,MATH 103A,B01,083779,Greenfeld; Be'Eri,0,16,30,30
1651121110054,MATH 103A,B02,083780,Greenfeld; Be'Eri,0,15,30,30
1651121116077,MATH 105,A01,085443,Staff,0,24,30,30
1651121122100,MATH 109,A01,083213,Ganzberger; Geoffrey Michael,0,8,30,30
1651121122100,MATH 109,A02,083214,Ganzberger; Geoffrey Michael,0,7,30,30
1651121122100,MATH 109,B01,083215,Ganzberger; Geoffrey Michael,0,8,30,30
1651121122100,MATH 109,B02,083216,Ganzberger; Geoffrey Michael,1,8,30,29
1651121128134,MATH 142A,A01,083219,Chow; Bennett,0,15,30,30
1651121128134,MATH 142A,A02,083220,Chow; Bennett,0,15,30,30
1651121128134,MATH 142A,B01,083221,Chow; Bennett,0,16,30,30
1651121128134,MATH 142A,B02,083222,Chow; Bennett,0,16,30,30
1651121134167,MATH 193A,A01,083224,Staff,0,9,30,30
1651121134167,MATH 193A,A02,083225,Staff,1,7,30,29
1651121134167,MATH 193A,A03,083781,Staff,0,7,30,30
1651121134167,MATH 193A,A04,083782,Staff,0,7,30,30
1651121140188,MATH 197,001,091859,McAuley; Julian John,9998,0,9999,1
1651121146246,COGS 9,A01,083615,Staff,0,20,60,60
1651121152269,COGS 11,A01,083617,Boyle; Mary E. T.,13,0,40,27
1651121158292,COGS 13,A01,083071,Staff,0,39,40,40
1651121164314,COGS 14A,A01,092681,Staff,0,41,100,100
1651121170337,COGS 14B,A01,083073,Cheng; Tzu-Han,0,11,50,50
1651121176365,COGS 17,A01,092677,Staff,8,0,75,67
1651121182400,COGS 100,A01,083619,Staff,0,30,60,60
1651121188423,COGS 101A,A01,083621,Davis; Joshua Daniel,0,29,60,60
1651121194448,COGS 101B,A01,091572,Staff,0,8,60,60
1651121200471,COGS 101C,A01,083625,Delgado; Tania,12,0,30,18
1651121206495,COGS 107A,A01,083627,Boyle; Mary E. T.,0,17,60,60
1651121212521,COGS 118A,A01,083075,Staff,0,10,60,60
1651121218549,CSE 3,A50,083646,Miranda; Gregory Joseph,15,0,38,23
1651121218549,CSE 3,A51,083647,Miranda; Gregory Joseph,36,0,37,1
1651121224575,CSE 8A,A50,083650,Miranda; Gregory Joseph,0,30,40,40
1651121230609,CSE 11,A01,083080,Cao; Yingjun,1,99,40,39
1651121236633,CSE 12,A01,083652,Staff,0,30,100,100
1651121242659,CSE 15L,A01,083654,Staff,0,4,50,50
1651121242659,CSE 15L,A02,083655,Staff,0,3,50,50
1651121248683,CSE 20,A01,083657,Staff,47,0,80,33
1651121254769,CSE 30,A01,083084,Eldon; John,0,39,80,80
1651121260795,CSE 100,A01,083659,Cao; Yingjun,0,72,50,50
1651121271189,CSE 134B,A01,083661,Powell; Thomas Allan,0,38,65,65
1651121277210,CSE 140,A01,083663,Staff,0,17,75,75
1651121283233,CSE 140L,A01,083088,Eldon; John,1,0,100,99
1651121289257,CSE 175,A01,083665,Kumar; Rakesh,0,0,25,25
1651121295279,CSE 190,A00,092507,Dubnov; Shlomo,9,0,20,11
1651121301310,ECE 45,A01,083139,Staff,0,8,60,60
1651121307333,ECE 65,A50,083695,Staff,0,7,30,30
1651121313355,ECE 109,A01,091882,Touri; Behrouz,32,0,70,38
1651121319389,ECE 180,A00,083140,Abi Samra; Nicholas Camill,17,0,30,13
1651121319389,ECE 180,B00,083141,Abi Samra; Nicholas Camill,0,1,30,32
1651121325413,MATH 10A,A01,083735,Patchell; Gregory David,0,0,30,30
1651121325413,MATH 10A,A02,083736,Patchell; Gregory David,26,0,30,4
1651121325413,MATH 10A,A03,083737,Patchell; Gregory David,22,0,30,8
1651121331435,MATH 10B,A01,083207,Staff,0,8,30,30
1651121331435,MATH 10B,A02,083208,Staff,0,7,30,30
1651121331435,MATH 10B,B01,083739,Staff,7,0,30,23
1651121331435,MATH 10B,B02,083740,Staff,28,0,30,2
1651121337470,MATH 18,A01,083743,Staff,0,0,30,30
1651121337470,MATH 18,A02,083744,Staff,23,0,30,7
1651121337470,MATH 18,A03,083745,Staff,19,0,30,11
1651121337470,MATH 18,A04,083746,Staff,26,0,30,4
1651121337470,MATH 18,B01,083748,Staff,0,16,30,30
1651121337470,MATH 18,B02,083749,Staff,0,15,30,30
1651121337470,MATH 18,B03,083750,Staff,0,15,30,30
1651121337470,MATH 18,B04,083751,Staff,0,15,30,30
1651121343494,MATH 20A,A01,083754,Staff,18,0,40,22
1651121349527,MATH 20B,A01,083756,Briones; Jor-el Thomas Caparas,0,14,30,30
1651121349527,MATH 20B,A02,083757,Briones; Jor-el Thomas Caparas,0,11,30,30
1651121355559,MATH 20C,A01,083760,Briones; Jor-el Thomas Caparas,1,17,30,29
1651121355559,MATH 20C,A02,083761,Briones; Jor-el Thomas Caparas,0,17,30,30
1651121355559,MATH 20C,B01,083762,Staff,6,0,30,24
1651121355559,MATH 20C,B02,083763,Staff,28,0,30,2
1651121361583,MATH 20D,A01,083765,Tran; Brian Kha,4,1,30,26
1651121361583,MATH 20D,A02,083766,Tran; Brian Kha,0,0,30,30
1651121361583,MATH 20D,A03,083767,Tran; Brian Kha,22,0,30,8
1651121367628,MATH 20E,A01,083771,Staff,0,0,30,30
1651121367628,MATH 20E,A02,083772,Staff,9,0,30,21
1651121367628,MATH 20E,B01,083773,Staff,5,0,35,30
1651121367628,MATH 20E,B02,083774,Staff,5,1,35,30
1651121373653,MATH 103A,A01,083777,Greenfeld; Be'Eri,0,17,30,30
1651121373653,MATH 103A,A02,083778,Greenfeld; Be'Eri,0,17,30,30
1651121373653,MATH 103A,B01,083779,Greenfeld; Be'Eri,0,16,30,30
1651121373653,MATH 103A,B02,083780,Greenfeld; Be'Eri,0,15,30,30
1651121379675,MATH 105,A01,085443,Staff,0,24,30,30
1651121385719,MATH 109,A01,083213,Ganzberger; Geoffrey Michael,0,8,30,30
1651121385719,MATH 109,A02,083214,Ganzberger; Geoffrey Michael,0,7,30,30
1651121385719,MATH 109,B01,083215,Ganzberger; Geoffrey Michael,0,8,30,30
1651121385719,MATH 109,B02,083216,Ganzberger; Geoffrey Michael,1,8,30,29
1651121391838,MATH 142A,A01,083219,Chow; Bennett,0,15,30,30
1651121391838,MATH 142A,A02,083220,Chow; Bennett,0,15,30,30
1651121391838,MATH 142A,B01,083221,Chow; Bennett,0,16,30,30
1651121391838,MATH 142A,B02,083222,Chow; Bennett,0,16,30,30
1651121397867,MATH 193A,A01,083224,Staff,0,9,30,30
1651121397867,MATH 193A,A02,083225,Staff,1,7,30,29
1651121397867,MATH 193A,A03,083781,Staff,0,7,30,30
1651121397867,MATH 193A,A04,083782,Staff,0,7,30,30
1651121403892,MATH 197,001,091859,McAuley; Julian John,9998,0,9999,1
1651121409941,COGS 9,A01,083615,Staff,0,20,60,60
1651121415971,COGS 11,A01,083617,Boyle; Mary E. T.,13,0,40,27
1651121421995,COGS 13,A01,083071,Staff,0,39,40,40
1651121428018,COGS 14A,A01,092681,Staff,0,41,100,100
1651121434042,COGS 14B,A01,083073,Cheng; Tzu-Han,0,11,50,50
1651121440066,COGS 17,A01,092677,Staff,8,0,75,67
1651121446096,COGS 100,A01,083619,Staff,0,30,60,60
1651121452122,COGS 101A,A01,083621,Davis; Joshua Daniel,0,29,60,60
1651121458152,COGS 101B,A01,091572,Staff,0,8,60,60
1651121464177,COGS 101C,A01,083625,Delgado; Tania,12,0,30,18
1651121470202,COGS 107A,A01,083627,Boyle; Mary E. T.,0,17,60,60
1651121476228,COGS 118A,A01,083075,Staff,0,10,60,60
1651121482257,CSE 3,A50,083646,Miranda; Gregory Joseph,15,0,38,23
1651121482257,CSE 3,A51,083647,Miranda; Gregory Joseph,36,0,37,1
1651121488283,CSE 8A,A50,083650,Miranda; Gregory Joseph,0,30,40,40
1651121494309,CSE 11,A01,083080,Cao; Yingjun,1,99,40,39
1651121500335,CSE 12,A01,083652,Staff,0,30,100,100
1651121506373,CSE 15L,A01,083654,Staff,0,4,50,50
1651121506373,CSE 15L,A02,083655,Staff,0,3,50,50
1651121512399,CSE 20,A01,083657,Staff,47,0,80,33
1651121518423,CSE 30,A01,083084,Eldon; John,0,39,80,80
1651121524444,CSE 100,A01,083659,Cao; Yingjun,0,72,50,50
1651121530469,CSE 134B,A01,083661,Powell; Thomas Allan,0,38,65,65
1651121536494,CSE 140,A01,083663,Staff,0,17,75,75
1651121542517,CSE 140L,A01,083088,Eldon; John,1,0,100,99
1651121548541,CSE 175,A01,083665,Kumar; Rakesh,0,0,25,25
1651121554563,CSE 190,A00,092507,Dubnov; Shlomo,9,0,20,11
1651121560585,ECE 45,A01,083139,Staff,0,8,60,60
1651121566608,ECE 65,A50,083695,Staff,0,7,30,30
1651121572633,ECE 109,A01,091882,Touri; Behrouz,32,0,70,38
1651121578656,ECE 180,A00,083140,Abi Samra; Nicholas Camill,17,0,30,13
1651121578656,ECE 180,B00,083141,Abi Samra; Nicholas Camill,0,1,30,32
1651121584683,MATH 10A,A01,083735,Patchell; Gregory David,0,0,30,30
1651121584683,MATH 10A,A02,083736,Patchell; Gregory David,26,0,30,4
1651121584683,MATH 10A,A03,083737,Patchell; Gregory David,22,0,30,8
1651121590705,MATH 10B,A01,083207,Staff,0,8,30,30
1651121590705,MATH 10B,A02,083208,Staff,0,7,30,30
1651121590705,MATH 10B,B01,083739,Staff,7,0,30,23
1651121590705,MATH 10B,B02,083740,Staff,28,0,30,2
1651121596735,MATH 18,A01,083743,Staff,0,0,30,30
1651121596735,MATH 18,A02,083744,Staff,23,0,30,7
1651121596735,MATH 18,A03,083745,Staff,19,0,30,11
1651121596735,MATH 18,A04,083746,Staff,26,0,30,4
1651121596735,MATH 18,B01,083748,Staff,0,16,30,30
1651121596735,MATH 18,B02,083749,Staff,0,15,30,30
1651121596735,MATH 18,B03,083750,Staff,0,15,30,30
1651121596735,MATH 18,B04,083751,Staff,0,15,30,30
1651121602769,MATH 20A,A01,083754,Staff,18,0,40,22
1651121608790,MATH 20B,A01,083756,Briones; Jor-el Thomas Caparas,0,14,30,30
1651121608790,MATH 20B,A02,083757,Briones; Jor-el Thomas Caparas,0,11,30,30
1651121614814,MATH 20C,A01,083760,Briones; Jor-el Thomas Caparas,1,17,30,29
1651121614814,MATH 20C,A02,083761,Briones; Jor-el Thomas Caparas,0,17,30,30
1651121614814,MATH 20C,B01,083762,Staff,6,0,30,24
1651121614814,MATH 20C,B02,083763,Staff,28,0,30,2
1651121620840,MATH 20D,A01,083765,Tran; Brian Kha,4,1,30,26
1651121620840,MATH 20D,A02,083766,Tran; Brian Kha,0,0,30,30
1651121620840,MATH 20D,A03,083767,Tran; Brian Kha,22,0,30,8
1651121626865,MATH 20E,A01,083771,Staff,0,0,30,30
1651121626865,MATH 20E,A02,083772,Staff,9,0,30,21
1651121626865,MATH 20E,B01,083773,Staff,5,0,35,30
1651121626865,MATH 20E,B02,083774,Staff,5,1,35,30
1651121632890,MATH 103A,A01,083777,Greenfeld; Be'Eri,0,17,30,30
1651121632890,MATH 103A,A02,083778,Greenfeld; Be'Eri,0,17,30,30
1651121632890,MATH 103A,B01,083779,Greenfeld; Be'Eri,0,16,30,30
1651121632890,MATH 103A,B02,083780,Greenfeld; Be'Eri,0,15,30,30
1651121638913,MATH 105,A01,085443,Staff,0,24,30,30
1651121644941,MATH 109,A01,083213,Ganzberger; Geoffrey Michael,0,8,30,30
1651121644941,MATH 109,A02,083214,Ganzberger; Geoffrey Michael,0,7,30,30
1651121644941,MATH 109,B01,083215,Ganzberger; Geoffrey Michael,0,8,30,30
1651121644941,MATH 109,B02,083216,Ganzberger; Geoffrey Michael,1,8,30,29
1651121650971,MATH 142A,A01,083219,Chow; Bennett,0,15,30,30
1651121650971,MATH 142A,A02,083220,Chow; Bennett,0,15,30,30
1651121650971,MATH 142A,B01,083221,Chow; Bennett,0,16,30,30
1651121650971,MATH 142A,B02,083222,Chow; Bennett,0,16,30,30
1651121656997,MATH 193A,A01,083224,Staff,0,9,30,30
1651121656997,MATH 193A,A02,083225,Staff,1,7,30,29
1651121656997,MATH 193A,A03,083781,Staff,0,7,30,30
1651121656997,MATH 193A,A04,083782,Staff,0,7,30,30
1651121663021,MATH 197,001,091859,McAuley; Julian John,9998,0,9999,1
1651121669073,COGS 9,A01,083615,Staff,0,20,60,60
1651121675095,COGS 11,A01,083617,Boyle; Mary E. T.,13,0,40,27
1651121681127,COGS 13,A01,083071,Staff,0,39,40,40
1651121687149,COGS 14A,A01,092681,Staff,0,41,100,100
1651121693177,COGS 14B,A01,083073,Cheng; Tzu-Han,0,11,50,50
1651121699202,COGS 17,A01,092677,Staff,8,0,75,67
1651121705226,COGS 100,A01,083619,Staff,0,30,60,60
1651121711250,COGS 101A,A01,083621,Davis; Joshua Daniel,0,29,60,60
1651121717275,COGS 101B,A01,091572,Staff,0,8,60,60
1651121723298,COGS 101C,A01,083625,Delgado; Tania,12,0,30,18
1651121729327,COGS 107A,A01,083627,Boyle; Mary E. T.,0,17,60,60
1651121735353,COGS 118A,A01,083075,Staff,0,10,60,60
1651121741377,CSE 3,A50,083646,Miranda; Gregory Joseph,15,0,38,23
1651121741377,CSE 3,A51,083647,Miranda; Gregory Joseph,36,0,37,1
1651121747401,CSE 8A,A50,083650,Miranda; Gregory Joseph,0,30,40,40
1651121753427,CSE 11,A01,083080,Cao; Yingjun,1,99,40,39
1651121759451,CSE 12,A01,083652,Staff,0,30,100,100
1651121765477,CSE 15L,A01,083654,Staff,0,4,50,50
1651121765477,CSE 15L,A02,083655,Staff,0,3,50,50
1651121771506,CSE 20,A01,083657,Staff,47,0,80,33
1651121777531,CSE 30,A01,083084,Eldon; John,0,39,80,80
1651121783553,CSE 100,A01,083659,Cao; Yingjun,0,72,50,50
1651121789584,CSE 134B,A01,083661,Powell; Thomas Allan,0,38,65,65
1651121795609,CSE 140,A01,083663,Staff,0,17,75,75
1651121801634,CSE 140L,A01,083088,Eldon; John,1,0,100,99
1651121807658,CSE 175,A01,083665,Kumar; Rakesh,0,0,25,25
1651121813683,CSE 190,A00,092507,Dubnov; Shlomo,9,0,20,11
1651121819706,ECE 45,A01,083139,Staff,0,8,60,60
1651121825730,ECE 65,A50,083695,Staff,0,7,30,30
1651121831754,ECE 109,A01,091882,Touri; Behrouz,32,0,70,38
1651121837778,ECE 180,A00,083140,Abi Samra; Nicholas Camill,17,0,30,13
1651121837778,ECE 180,B00,083141,Abi Samra; Nicholas Camill,0,1,30,32
1651121843805,MATH 10A,A01,083735,Patchell; Gregory David,0,0,30,30
1651121843805,MATH 10A,A02,083736,Patchell; Gregory David,26,0,30,4
1651121843805,MATH 10A,A03,083737,Patchell; Gregory David,22,0,30,8
1651121849830,MATH 10B,A01,083207,Staff,0,8,30,30
1651121849830,MATH 10B,A02,083208,Staff,0,7,30,30
1651121849830,MATH 10B,B01,083739,Staff,7,0,30,23
1651121849830,MATH 10B,B02,083740,Staff,28,0,30,2
1651121855861,MATH 18,A01,083743,Staff,0,0,30,30
1651121855861,MATH 18,A02,083744,Staff,23,0,30,7
1651121855861,MATH 18,A03,083745,Staff,19,0,30,11
1651121855861,MATH 18,A04,083746,Staff,26,0,30,4
1651121855861,MATH 18,B01,083748,Staff,0,16,30,30
1651121855861,MATH 18,B02,083749,Staff,0,15,30,30
1651121855861,MATH 18,B03,083750,Staff,0,15,30,30
1651121855861,MATH 18,B04,083751,Staff,0,15,30,30
1651121861886,MATH 20A,A01,083754,Staff,18,0,40,22
1651121867910,MATH 20B,A01,083756,Briones; Jor-el Thomas Caparas,0,14,30,30
1651121867910,MATH 20B,A02,083757,Briones; Jor-el Thomas Caparas,0,11,30,30
1651121873943,MATH 20C,A01,083760,Briones; Jor-el Thomas Caparas,1,17,30,29
1651121873943,MATH 20C,A02,083761,Briones; Jor-el Thomas Caparas,0,17,30,30
1651121873943,MATH 20C,B01,083762,Staff,6,0,30,24
1651121873943,MATH 20C,B02,083763,Staff,28,0,30,2
1651121879966,MATH 20D,A01,083765,Tran; Brian Kha,4,1,30,26
1651121879966,MATH 20D,A02,083766,Tran; Brian Kha,0,0,30,30
1651121879966,MATH 20D,A03,083767,Tran; Brian Kha,22,0,30,8
1651121885991,MATH 20E,A01,083771,Staff,0,0,30,30
1651121885991,MATH 20E,A02,083772,Staff,9,0,30,21
1651121885991,MATH 20E,B01,083773,Staff,4,0,35,31
1651121885991,MATH 20E,B02,083774,Staff,5,1,35,30
1651121892019,MATH 103A,A01,083777,Greenfeld; Be'Eri,0,17,30,30
1651121892019,MATH 103A,A02,083778,Greenfeld; Be'Eri,0,17,30,30
1651121892019,MATH 103A,B01,083779,Greenfeld; Be'Eri,0,16,30,30
1651121892019,MATH 103A,B02,083780,Greenfeld; Be'Eri,0,15,30,30
1651121898043,MATH 105,A01,085443,Staff,0,24,30,30
1651121904068,MATH 109,A01,083213,Ganzberger; Geoffrey Michael,0,8,30,30
1651121904068,MATH 109,A02,083214,Ganzberger; Geoffrey Michael,0,7,30,30
1651121904068,MATH 109,B01,083215,Ganzberger; Geoffrey Michael,0,8,30,30
1651121904068,MATH 109,B02,083216,Ganzberger; Geoffrey Michael,1,8,30,29
1651121910091,MATH 142A,A01,083219,Chow; Bennett,0,15,30,30
1651121910091,MATH 142A,A02,083220,Chow; Bennett,0,15,30,30
1651121910091,MATH 142A,B01,083221,Chow; Bennett,0,16,30,30
1651121910091,MATH 142A,B02,083222,Chow; Bennett,0,15,30,30
1651121916114,MATH 193A,A01,083224,Staff,0,9,30,30
1651121916114,MATH 193A,A02,083225,Staff,1,7,30,29
1651121916114,MATH 193A,A03,083781,Staff,0,7,30,30
1651121916114,MATH 193A,A04,083782,Staff,0,7,30,30
1651121922135,MATH 197,001,091859,McAuley; Julian John,9998,0,9999,1
1651121928195,COGS 9,A01,083615,Staff,0,20,60,60
1651121934224,COGS 11,A01,083617,Boyle; Mary E. T.,13,0,40,27
1651121940250,COGS 13,A01,083071,Staff,0,39,40,40
1651121946272,COGS 14A,A01,092681,Staff,0,41,100,100
1651121952294,COGS 14B,A01,083073,Cheng; Tzu-Han,0,11,50,50
1651121958317,COGS 17,A01,092677,Staff,8,0,75,67
1651121964339,COGS 100,A01,083619,Staff,0,30,60,60
1651121970363,COGS 101A,A01,083621,Davis; Joshua Daniel,0,29,60,60
1651121976390,COGS 101B,A01,091572,Staff,0,8,60,60
1651121982494,COGS 101C,A01,083625,Delgado; Tania,12,0,30,18
1651121988518,COGS 107A,A01,083627,Boyle; Mary E. T.,0,17,60,60
1651121994541,COGS 118A,A01,083075,Staff,0,10,60,60
1651122000578,CSE 3,A50,083646,Miranda; Gregory Joseph,15,0,38,23
1651122000578,CSE 3,A51,083647,Miranda; Gregory Joseph,36,0,37,1
1651122006605,CSE 8A,A50,083650,Miranda; Gregory Joseph,0,30,40,40
1651122012628,CSE 11,A01,083080,Cao; Yingjun,1,99,40,39
1651122018655,CSE 12,A01,083652,Staff,0,30,100,100
1651122024677,CSE 15L,A01,083654,Staff,0,4,50,50
1651122024677,CSE 15L,A02,083655,Staff,0,3,50,50
1651122030700,CSE 20,A01,083657,Staff,47,0,80,33
1651122036730,CSE 30,A01,083084,Eldon; John,0,39,80,80
1651122042755,CSE 100,A01,083659,Cao; Yingjun,0,72,50,50
1651122048781,CSE 134B,A01,083661,Powell; Thomas Allan,0,38,65,65
1651122054806,CSE 140,A01,083663,Staff,0,17,75,75
1651122060839,CSE 140L,A01,083088,Eldon; John,1,0,100,99
1651122066866,CSE 175,A01,083665,Kumar; Rakesh,0,0,25,25
1651122072889,CSE 190,A00,092507,Dubnov; Shlomo,9,0,20,11
1651122078912,ECE 45,A01,083139,Staff,0,8,60,60
1651122084939,ECE 65,A50,083695,Staff,0,7,30,30
1651122090962,ECE 109,A01,091882,Touri; Behrouz,32,0,70,38
1651122096989,ECE 180,A00,083140,Abi Samra; Nicholas Camill,17,0,30,13
1651122096989,ECE 180,B00,083141,Abi Samra; Nicholas Camill,0,1,30,32
1651122103026,MATH 10A,A01,083735,Patchell; Gregory David,0,0,30,30
1651122103026,MATH 10A,A02,083736,Patchell; Gregory David,26,0,30,4
1651122103026,MATH 10A,A03,083737,Patchell; Gregory David,22,0,30,8
1651122109049,MATH 10B,A01,083207,Staff,0,8,30,30
1651122109049,MATH 10B,A02,083208,Staff,0,7,30,30
1651122109049,MATH 10B,B01,083739,Staff,7,0,30,23
1651122109049,MATH 10B,B02,083740,Staff,28,0,30,2
1651122115078,MATH 18,A01,083743,Staff,0,0,30,30
1651122115078,MATH 18,A02,083744,Staff,23,0,30,7
1651122115078,MATH 18,A03,083745,Staff,19,0,30,11
1651122115078,MATH 18,A04,083746,Staff,26,0,30,4
1651122115078,MATH 18,B01,083748,Staff,0,16,30,30
1651122115078,MATH 18,B02,083749,Staff,0,15,30,30
1651122115078,MATH 18,B03,083750,Staff,0,15,30,30
1651122115078,MATH 18,B04,083751,Staff,0,15,30,30
1651122121102,MATH 20A,A01,083754,Staff,18,0,40,22
1651122127126,MATH 20B,A01,083756,Briones; Jor-el Thomas Caparas,0,14,30,30
1651122127126,MATH 20B,A02,083757,Briones; Jor-el Thomas Caparas,0,11,30,30
1651122133154,MATH 20C,A01,083760,Briones; Jor-el Thomas Caparas,1,17,30,29
1651122133154,MATH 20C,A02,083761,Briones; Jor-el Thomas Caparas,0,17,30,30
1651122133154,MATH 20C,B01,083762,Staff,6,0,30,24
1651122133154,MATH 20C,B02,083763,Staff,28,0,30,2
1651122139180,MATH 20D,A01,083765,Tran; Brian Kha,4,1,30,26
1651122139180,MATH 20D,A02,083766,Tran; Brian Kha,0,0,30,30
1651122139180,MATH 20D,A03,083767,Tran; Brian Kha,22,0,30,8
1651122145207,MATH 20E,A01,083771,Staff,0,0,30,30
1651122145207,MATH 20E,A02,083772,Staff,9,0,30,21
1651122145207,MATH 20E,B01,083773,Staff,4,0,35,31
1651122145207,MATH 20E,B02,083774,Staff,5,1,35,30
1651122151231,MATH 103A,A01,083777,Greenfeld; Be'Eri,0,17,30,30
1651122151231,MATH 103A,A02,083778,Greenfeld; Be'Eri,0,17,30,30
1651122151231,MATH 103A,B01,083779,Greenfeld; Be'Eri,0,16,30,30
1651122151231,MATH 103A,B02,083780,Greenfeld; Be'Eri,0,15,30,30
1651122157254,MATH 105,A01,085443,Staff,0,24,30,30
1651122163290,MATH 109,A01,083213,Ganzberger; Geoffrey Michael,0,8,30,30
1651122163290,MATH 109,A02,083214,Ganzberger; Geoffrey Michael,0,7,30,30
1651122163290,MATH 109,B01,083215,Ganzberger; Geoffrey Michael,0,8,30,30
1651122163290,MATH 109,B02,083216,Ganzberger; Geoffrey Michael,1,8,30,29
1651122169328,MATH 142A,A01,083219,Chow; Bennett,0,15,30,30
1651122169328,MATH 142A,A02,083220,Chow; Bennett,0,15,30,30
1651122169328,MATH 142A,B01,083221,Chow; Bennett,0,16,30,30
1651122169328,MATH 142A,B02,083222,Chow; Bennett,0,15,30,30
1651122175358,MATH 193A,A01,083224,Staff,0,9,30,30
1651122175358,MATH 193A,A02,083225,Staff,1,7,30,29
1651122175358,MATH 193A,A03,083781,Staff,0,7,30,30
1651122175358,MATH 193A,A04,083782,Staff,0,7,30,30
1651122181381,MATH 197,001,091859,McAuley; Julian John,9998,0,9999,1
1651122187450,COGS 9,A01,083615,Staff,0,20,60,60
1651122193474,COGS 11,A01,083617,Boyle; Mary E. T.,13,0,40,27
1651122199502,COGS 13,A01,083071,Staff,0,39,40,40
1651122205533,COGS 14A,A01,092681,Staff,0,41,100,100
1651122211558,COGS 14B,A01,083073,Cheng; Tzu-Han,0,11,50,50
1651122217588,COGS 17,A01,092677,Staff,8,0,75,67
1651122223610,COGS 100,A01,083619,Staff,0,30,60,60
1651122229633,COGS 101A,A01,083621,Davis; Joshua Daniel,0,29,60,60
1651122235656,COGS 101B,A01,091572,Staff,0,8,60,60
1651122241683,COGS 101C,A01,083625,Delgado; Tania,12,0,30,18
1651122247704,COGS 107A,A01,083627,Boyle; Mary E. T.,0,17,60,60
1651122253727,COGS 118A,A01,083075,Staff,0,10,60,60
1651122259751,CSE 3,A50,083646,Miranda; Gregory Joseph,15,0,38,23
1651122259751,CSE 3,A51,083647,Miranda; Gregory Joseph,36,0,37,1
1651122265774,CSE 8A,A50,083650,Miranda; Gregory Joseph,0,30,40,40
1651122271797,CSE 11,A01,083080,Cao; Yingjun,1,99,40,39
1651122277821,CSE 12,A01,083652,Staff,0,30,100,100
1651122283848,CSE 15L,A01,083654,Staff,0,4,50,50
1651122283848,CSE 15L,A02,083655,Staff,0,3,50,50
1651122289875,CSE 20,A01,083657,Staff,47,0,80,33
1651122295898,CSE 30,A01,083084,Eldon; John,0,39,80,80
1651122301923,CSE 100,A01,083659,Cao; Yingjun,0,72,50,50
1651122307948,CSE 134B,A01,083661,Powell; Thomas Allan,0,38,65,65
1651122313973,CSE 140,A01,083663,Staff,0,17,75,75
1651122320000,CSE 140L,A01,083088,Eldon; John,1,0,100,99
1651122326022,CSE 175,A01,083665,Kumar; Rakesh,0,0,25,25
1651122332046,CSE 190,A00,092507,Dubnov; Shlomo,9,0,20,11
1651122338074,ECE 45,A01,083139,Staff,0,8,60,60
1651122344098,ECE 65,A50,083695,Staff,0,7,30,30
1651122350121,ECE 109,A01,091882,Touri; Behrouz,32,0,70,38
1651122356146,ECE 180,A00,083140,Abi Samra; Nicholas Camill,17,0,30,13
1651122356146,ECE 180,B00,083141,Abi Samra; Nicholas Camill,0,1,30,32
1651122362172,MATH 10A,A01,083735,Patchell; Gregory David,0,0,30,30
1651122362172,MATH 10A,A02,083736,Patchell; Gregory David,26,0,30,4
1651122362172,MATH 10A,A03,083737,Patchell; Gregory David,22,0,30,8
1651122368196,MATH 10B,A01,083207,Staff,0,8,30,30
1651122368196,MATH 10B,A02,083208,Staff,0,7,30,30
1651122368196,MATH 10B,B01,083739,Staff,7,0,30,23
1651122368196,MATH 10B,B02,083740,Staff,28,0,30,2
1651122374236,MATH 18,A01,083743,Staff,0,0,30,30
1651122374236,MATH 18,A02,083744,Staff,23,0,30,7
1651122374236,MATH 18,A03,083745,Staff,19,0,30,11
1651122374236,MATH 18,A04,083746,Staff,26,0,30,4
1651122374236,MATH 18,B01,083748,Staff,0,16,30,30
1651122374236,MATH 18,B02,083749,Staff,0,15,30,30
1651122374236,MATH 18,B03,083750,Staff,0,15,30,30
1651122374236,MATH 18,B04,083751,Staff,0,15,30,30
1651122380262,MATH 20A,A01,083754,Staff,18,0,40,22
1651122386286,MATH 20B,A01,083756,Briones; Jor-el Thomas Caparas,0,14,30,30
1651122386286,MATH 20B,A02,083757,Briones; Jor-el Thomas Caparas,0,11,30,30
1651122392310,MATH 20C,A01,083760,Briones; Jor-el Thomas Caparas,1,17,30,29
1651122392310,MATH 20C,A02,083761,Briones; Jor-el Thomas Caparas,0,17,30,30
1651122392310,MATH 20C,B01,083762,Staff,6,0,30,24
1651122392310,MATH 20C,B02,083763,Staff,28,0,30,2
1651122398338,MATH 20D,A01,083765,Tran; Brian Kha,4,1,30,26
1651122398338,MATH 20D,A02,083766,Tran; Brian Kha,0,0,30,30
1651122398338,MATH 20D,A03,083767,Tran; Brian Kha,22,0,30,8
1651122404363,MATH 20E,A01,083771,Staff,0,0,30,30
1651122404363,MATH 20E,A02,083772,Staff,9,0,30,21
1651122404363,MATH 20E,B01,083773,Staff,4,0,35,31
1651122404363,MATH 20E,B02,083774,Staff,5,1,35,30
1651122410389,MATH 103A,A01,083777,Greenfeld; Be'Eri,0,17,30,30
1651122410389,MATH 103A,A02,083778,Greenfeld; Be'Eri,0,17,30,30
1651122410389,MATH 103A,B01,083779,Greenfeld; Be'Eri,0,16,30,30
1651122410389,MATH 103A,B02,083780,Greenfeld; Be'Eri,0,15,30,30
1651122416414,MATH 105,A01,085443,Staff,0,24,30,30
1651122422440,MATH 109,A01,083213,Ganzberger; Geoffrey Michael,0,8,30,30
1651122422440,MATH 109,A02,083214,Ganzberger; Geoffrey Michael,0,7,30,30
1651122422440,MATH 109,B01,083215,Ganzberger; Geoffrey Michael,0,8,30,30
1651122422440,MATH 109,B02,083216,Ganzberger; Geoffrey Michael,1,8,30,29
1651122428466,MATH 142A,A01,083219,Chow; Bennett,0,15,30,30
1651122428466,MATH 142A,A02,083220,Chow; Bennett,0,15,30,30
1651122428466,MATH 142A,B01,083221,Chow; Bennett,0,16,30,30
1651122428466,MATH 142A,B02,083222,Chow; Bennett,0,15,30,30
1651122434492,MATH 193A,A01,083224,Staff,0,9,30,30
1651122434492,MATH 193A,A02,083225,Staff,1,7,30,29
1651122434492,MATH 193A,A03,083781,Staff,0,7,30,30
1651122434492,MATH 193A,A04,083782,Staff,0,7,30,30
1651122440514,MATH 197,001,091859,McAuley; Julian John,9998,0,9999,1
1651122446566,COGS 9,A01,083615,Staff,0,20,60,60
1651122452592,COGS 11,A01,083617,Boyle; Mary E. T.,13,0,40,27
1651122458617,COGS 13,A01,083071,Staff,0,39,40,40
1651122464649,COGS 14A,A01,092681,Staff,0,41,100,100
1651122470674,COGS 14B,A01,083073,Cheng; Tzu-Han,0,11,50,50
1651122476704,COGS 17,A01,092677,Staff,8,0,75,67
1651122482729,COGS 100,A01,083619,Staff,0,30,60,60
1651122488762,COGS 101A,A01,083621,Davis; Joshua Daniel,0,29,60,60
1651122494791,COGS 101B,A01,091572,Staff,0,8,60,60
1651122500813,COGS 101C,A01,083625,Delgado; Tania,12,0,30,18
1651122506838,COGS 107A,A01,083627,Boyle; Mary E. T.,0,17,60,60
1651122512864,COGS 118A,A01,083075,Staff,0,10,60,60
1651122518894,CSE 3,A50,083646,Miranda; Gregory Joseph,15,0,38,23
1651122518894,CSE 3,A51,083647,Miranda; Gregory Joseph,36,0,37,1
1651122524917,CSE 8A,A50,083650,Miranda; Gregory Joseph,0,30,40,40
1651122530942,CSE 11,A01,083080,Cao; Yingjun,1,99,40,39
1651122536965,CSE 12,A01,083652,Staff,0,30,100,100
1651122542993,CSE 15L,A01,083654,Staff,0,4,50,50
1651122542993,CSE 15L,A02,083655,Staff,0,3,50,50
1651122549015,CSE 20,A01,083657,Staff,47,0,80,33
1651122555036,CSE 30,A01,083084,Eldon; John,0,39,80,80
1651122561063,CSE 100,A01,083659,Cao; Yingjun,0,72,50,50
1651122567099,CSE 134B,A01,083661,Powell; Thomas Allan,0,38,65,65
1651122573124,CSE 140,A01,083663,Staff,0,17,75,75
1651122579236,CSE 140L,A01,083088,Eldon; John,1,0,100,99
1651122585258,CSE 175,A01,083665,Kumar; Rakesh,0,0,25,25
1651122591282,CSE 190,A00,092507,Dubnov; Shlomo,9,0,20,11
1651122597307,ECE 45,A01,083139,Staff,0,8,60,60
1651122603329,ECE 65,A50,083695,Staff,0,7,30,30
1651122609351,ECE 109,A01,091882,Touri; Behrouz,32,0,70,38
1651122615378,ECE 180,A00,083140,Abi Samra; Nicholas Camill,17,0,30,13
1651122615378,ECE 180,B00,083141,Abi Samra; Nicholas Camill,0,1,30,32
1651122621410,MATH 10A,A01,083735,Patchell; Gregory David,0,0,30,30
1651122621410,MATH 10A,A02,083736,Patchell; Gregory David,26,0,30,4
1651122621410,MATH 10A,A03,083737,Patchell; Gregory David,22,0,30,8
1651122627436,MATH 10B,A01,083207,Staff,0,8,30,30
1651122627436,MATH 10B,A02,083208,Staff,0,7,30,30
1651122627436,MATH 10B,B01,083739,Staff,7,0,30,23
1651122627436,MATH 10B,B02,083740,Staff,28,0,30,2
1651122633459,MATH 18,A01,083743,Staff,0,0,30,30
1651122633459,MATH 18,A02,083744,Staff,23,0,30,7
1651122633459,MATH 18,A03,083745,Staff,19,0,30,11
1651122633459,MATH 18,A04,083746,Staff,26,0,30,4
1651122633459,MATH 18,B01,083748,Staff,0,16,30,30
1651122633459,MATH 18,B02,083749,Staff,0,15,30,30
1651122633459,MATH 18,B03,083750,Staff,0,15,30,30
1651122633459,MATH 18,B04,083751,Staff,0,15,30,30
1651122639484,MATH 20A,A01,083754,Staff,18,0,40,22
1651122645511,MATH 20B,A01,083756,Briones; Jor-el Thomas Caparas,0,14,30,30
1651122645511,MATH 20B,A02,083757,Briones; Jor-el Thomas Caparas,0,11,30,30
1651122651535,MATH 20C,A01,083760,Briones; Jor-el Thomas Caparas,1,17,30,29
1651122651535,MATH 20C,A02,083761,Briones; Jor-el Thomas Caparas,0,17,30,30
1651122651535,MATH 20C,B01,083762,Staff,6,0,30,24
1651122651535,MATH 20C,B02,083763,Staff,28,0,30,2
1651122657557,MATH 20D,A01,083765,Tran; Brian Kha,4,1,30,26
1651122657557,MATH 20D,A02,083766,Tran; Brian Kha,0,0,30,30
1651122657557,MATH 20D,A03,083767,Tran; Brian Kha,22,0,30,8
1651122663580,MATH 20E,A01,083771,Staff,0,0,30,30
1651122663580,MATH 20E,A02,083772,Staff,9,0,30,21
1651122663580,MATH 20E,B01,083773,Staff,4,0,35,31
1651122663580,MATH 20E,B02,083774,Staff,5,1,35,30
1651122669605,MATH 103A,A01,083777,Greenfeld; Be'Eri,0,17,30,30
1651122669605,MATH 103A,A02,083778,Greenfeld; Be'Eri,0,17,30,30
1651122669605,MATH 103A,B01,083779,Greenfeld; Be'Eri,0,16,30,30
1651122669605,MATH 103A,B02,083780,Greenfeld; Be'Eri,0,15,30,30
1651122675629,MATH 105,A01,085443,Staff,0,24,30,30
1651122681662,MATH 109,A01,083213,Ganzberger; Geoffrey Michael,0,8,30,30
1651122681662,MATH 109,A02,083214,Ganzberger; Geoffrey Michael,0,7,30,30
1651122681662,MATH 109,B01,083215,Ganzberger; Geoffrey Michael,0,8,30,30
1651122681662,MATH 109,B02,083216,Ganzberger; Geoffrey Michael,1,8,30,29
1651122687685,MATH 142A,A01,083219,Chow; Bennett,0,15,30,30
1651122687685,MATH 142A,A02,083220,Chow; Bennett,0,15,30,30
1651122687685,MATH 142A,B01,083221,Chow; Bennett,0,16,30,30
1651122687685,MATH 142A,B02,083222,Chow; Bennett,0,15,30,30
1651122693718,MATH 193A,A01,083224,Staff,0,9,30,30
1651122693718,MATH 193A,A02,083225,Staff,1,7,30,29
1651122693718,MATH 193A,A03,083781,Staff,0,7,30,30
1651122693718,MATH 193A,A04,083782,Staff,0,7,30,30
1651122699750,MATH 197,001,091859,McAuley; Julian John,9998,0,9999,1
1651122705809,COGS 9,A01,083615,Staff,0,20,60,60
1651122711836,COGS 11,A01,083617,Boyle; Mary E. T.,13,0,40,27
1651122717859,COGS 13,A01,083071,Staff,0,39,40,40
1651122723884,COGS 14A,A01,092681,Staff,0,41,100,100
1651122729907,COGS 14B,A01,083073,Cheng; Tzu-Han,0,11,50,50
1651122735931,COGS 17,A01,092677,Staff,8,0,75,67
1651122741955,COGS 100,A01,083619,Staff,0,30,60,60
1651122747978,COGS 101A,A01,083621,Davis; Joshua Daniel,0,29,60,60
1651122754000,COGS 101B,A01,091572,Staff,0,8,60,60
1651122760025,COGS 101C,A01,083625,Delgado; Tania,12,0,30,18
1651122766046,COGS 107A,A01,083627,Boyle; Mary E. T.,0,17,60,60
1651122772071,COGS 118A,A01,083075,Staff,0,10,60,60
1651122778103,CSE 3,A50,083646,Miranda; Gregory Joseph,15,0,38,23
1651122778103,CSE 3,A51,083647,Miranda; Gregory Joseph,36,0,37,1
1651122784127,CSE 8A,A50,083650,Miranda; Gregory Joseph,0,30,40,40
1651122790149,CSE 11,A01,083080,Cao; Yingjun,1,99,40,39
1651122796171,CSE 12,A01,083652,Staff,0,30,100,100
1651122802197,CSE 15L,A01,083654,Staff,0,4,50,50
1651122802197,CSE 15L,A02,083655,Staff,0,3,50,50
1651122808229,CSE 20,A01,083657,Staff,47,0,80,33
1651122814263,CSE 30,A01,083084,Eldon; John,0,39,80,80
1651122820287,CSE 100,A01,083659,Cao; Yingjun,0,72,50,50
1651122826319,CSE 134B,A01,083661,Powell; Thomas Allan,0,38,65,65
1651122832342,CSE 140,A01,083663,Staff,0,17,75,75
1651122838371,CSE 140L,A01,083088,Eldon; John,1,0,100,99
1651122844395,CSE 175,A01,083665,Kumar; Rakesh,0,0,25,25
1651122850420,CSE 190,A00,092507,Dubnov; Shlomo,9,0,20,11
1651122856445,ECE 45,A01,083139,Staff,0,8,60,60
1651122862467,ECE 65,A50,083695,Staff,0,7,30,30
1651122868492,ECE 109,A01,091882,Touri; Behrouz,32,0,70,38
1651122874515,ECE 180,A00,083140,Abi Samra; Nicholas Camill,17,0,30,13
1651122874515,ECE 180,B00,083141,Abi Samra; Nicholas Camill,0,1,30,32
1651122880539,MATH 10A,A01,083735,Patchell; Gregory David,0,0,30,30
1651122880539,MATH 10A,A02,083736,Patchell; Gregory David,26,0,30,4
1651122880539,MATH 10A,A03,083737,Patchell; Gregory David,22,0,30,8
1651122886562,MATH 10B,A01,083207,Staff,0,8,30,30
1651122886562,MATH 10B,A02,083208,Staff,0,7,30,30
1651122886562,MATH 10B,B01,083739,Staff,7,0,30,23
1651122886562,MATH 10B,B02,083740,Staff,28,0,30,2
1651122892592,MATH 18,A01,083743,Staff,0,0,30,30
1651122892592,MATH 18,A02,083744,Staff,23,0,30,7
1651122892592,MATH 18,A03,083745,Staff,19,0,30,11
1651122892592,MATH 18,A04,083746,Staff,26,0,30,4
1651122892592,MATH 18,B01,083748,Staff,0,16,30,30
1651122892592,MATH 18,B02,083749,Staff,0,15,30,30
1651122892592,MATH 18,B03,083750,Staff,0,15,30,30
1651122892592,MATH 18,B04,083751,Staff,0,15,30,30
1651122898614,MATH 20A,A01,083754,Staff,18,0,40,22
1651122904645,MATH 20B,A01,083756,Briones; Jor-el Thomas Caparas,0,14,30,30
1651122904645,MATH 20B,A02,083757,Briones; Jor-el Thomas Caparas,0,11,30,30
1651122910678,MATH 20C,A01,083760,Briones; Jor-el Thomas Caparas,1,17,30,29
1651122910678,MATH 20C,A02,083761,Briones; Jor-el Thomas Caparas,0,17,30,30
1651122910678,MATH 20C,B01,083762,Staff,6,0,30,24
1651122910678,MATH 20C,B02,083763,Staff,28,0,30,2
1651122916708,MATH 20D,A01,083765,Tran; Brian Kha,4,1,30,26
1651122916708,MATH 20D,A02,083766,Tran; Brian Kha,0,0,30,30
1651122916708,MATH 20D,A03,083767,Tran; Brian Kha,22,0,30,8
1651122922732,MATH 20E,A01,083771,Staff,0,0,30,30
1651122922732,MATH 20E,A02,083772,Staff,9,0,30,21
1651122922732,MATH 20E,B01,083773,Staff,4,0,35,31
1651122922732,MATH 20E,B02,083774,Staff,5,1,35,30
1651122928760,MATH 103A,A01,083777,Greenfeld; Be'Eri,0,17,30,30
1651122928760,MATH 103A,A02,083778,Greenfeld; Be'Eri,0,17,30,30
1651122928760,MATH 103A,B01,083779,Greenfeld; Be'Eri,0,16,30,30
1651122928760,MATH 103A,B02,083780,Greenfeld; Be'Eri,0,15,30,30
1651122934786,MATH 105,A01,085443,Staff,0,24,30,30
1651122940811,MATH 109,A01,083213,Ganzberger; Geoffrey Michael,0,8,30,30
1651122940811,MATH 109,A02,083214,Ganzberger; Geoffrey Michael,0,7,30,30
1651122940811,MATH 109,B01,083215,Ganzberger; Geoffrey Michael,0,8,30,30
1651122940811,MATH 109,B02,083216,Ganzberger; Geoffrey Michael,1,8,30,29
1651122946839,MATH 142A,A01,083219,Chow; Bennett,0,15,30,30
1651122946839,MATH 142A,A02,083220,Chow; Bennett,0,15,30,30
1651122946839,MATH 142A,B01,083221,Chow; Bennett,0,16,30,30
1651122946839,MATH 142A,B02,083222,Chow; Bennett,0,15,30,30
1651122952866,MATH 193A,A01,083224,Staff,0,9,30,30
1651122952866,MATH 193A,A02,083225,Staff,1,7,30,29
1651122952866,MATH 193A,A03,083781,Staff,0,7,30,30
1651122952866,MATH 193A,A04,083782,Staff,0,7,30,30
1651122958889,MATH 197,001,091859,McAuley; Julian John,9998,0,9999,1
1651122964943,COGS 9,A01,083615,Staff,0,20,60,60
1651122970966,COGS 11,A01,083617,Boyle; Mary E. T.,13,0,40,27
1651122976989,COGS 13,A01,083071,Staff,0,39,40,40
1651122983020,COGS 14A,A01,092681,Staff,0,41,100,100
1651122989052,COGS 14B,A01,083073,Cheng; Tzu-Han,0,11,50,50
1651122995077,COGS 17,A01,092677,Staff,8,0,75,67
1651123001100,COGS 100,A01,083619,Staff,0,30,60,60
1651123007123,COGS 101A,A01,083621,Davis; Joshua Daniel,0,29,60,60
1651123013147,COGS 101B,A01,091572,Staff,0,8,60,60
1651123019173,COGS 101C,A01,083625,Delgado; Tania,12,0,30,18
1651123025194,COGS 107A,A01,083627,Boyle; Mary E. T.,0,17,60,60
1651123031220,COGS 118A,A01,083075,Staff,0,10,60,60
1651123037248,CSE 3,A50,083646,Miranda; Gregory Joseph,15,0,38,23
1651123037248,CSE 3,A51,083647,Miranda; Gregory Joseph,36,0,37,1
1651123043275,CSE 8A,A50,083650,Miranda; Gregory Joseph,0,30,40,40
1651123049299,CSE 11,A01,083080,Cao; Yingjun,1,99,40,39
1651123055324,CSE 12,A01,083652,Staff,0,30,100,100
1651123061348,CSE 15L,A01,083654,Staff,0,4,50,50
1651123061348,CSE 15L,A02,083655,Staff,0,3,50,50
1651123067371,CSE 20,A01,083657,Staff,47,0,80,33
1651123073398,CSE 30,A01,083084,Eldon; John,0,39,80,80
1651123079421,CSE 100,A01,083659,Cao; Yingjun,0,72,50,50
1651123085449,CSE 134B,A01,083661,Powell; Thomas Allan,0,38,65,65
1651123091480,CSE 140,A01,083663,Staff,0,17,75,75
1651123097501,CSE 140L,A01,083088,Eldon; John,1,0,100,99
1651123103525,CSE 175,A01,083665,Kumar; Rakesh,0,0,25,25
1651123109550,CSE 190,A00,092507,Dubnov; Shlomo,9,0,20,11
1651123115576,ECE 45,A01,083139,Staff,0,8,60,60
1651123121598,ECE 65,A50,083695,Staff,0,7,30,30
1651123127620,ECE 109,A01,091882,Touri; Behrouz,32,0,70,38
1651123133648,ECE 180,A00,083140,Abi Samra; Nicholas Camill,17,0,30,13
1651123133648,ECE 180,B00,083141,Abi Samra; Nicholas Camill,0,1,30,32
1651123139673,MATH 10A,A01,083735,Patchell; Gregory David,0,0,30,30
1651123139673,MATH 10A,A02,083736,Patchell; Gregory David,26,0,30,4
1651123139673,MATH 10A,A03,083737,Patchell; Gregory David,22,0,30,8
1651123145698,MATH 10B,A01,083207,Staff,0,8,30,30
1651123145698,MATH 10B,A02,083208,Staff,0,7,30,30
1651123145698,MATH 10B,B01,083739,Staff,7,0,30,23
1651123145698,MATH 10B,B02,083740,Staff,28,0,30,2
1651123151731,MATH 18,A01,083743,Staff,0,0,30,30
1651123151731,MATH 18,A02,083744,Staff,23,0,30,7
1651123151731,MATH 18,A03,083745,Staff,19,0,30,11
1651123151731,MATH 18,A04,083746,Staff,26,0,30,4
1651123151731,MATH 18,B01,083748,Staff,0,16,30,30
1651123151731,MATH 18,B02,083749,Staff,0,15,30,30
1651123151731,MATH 18,B03,083750,Staff,0,15,30,30
1651123151731,MATH 18,B04,083751,Staff,0,15,30,30
1651123157759,MATH 20A,A01,083754,Staff,18,0,40,22
1651123163782,MATH 20B,A01,083756,Briones; Jor-el Thomas Caparas,0,14,30,30
1651123163782,MATH 20B,A02,083757,Briones; Jor-el Thomas Caparas,0,11,30,30
1651123169814,MATH 20C,A01,083760,Briones; Jor-el Thomas Caparas,1,17,30,29
1651123169814,MATH 20C,A02,083761,Briones; Jor-el Thomas Caparas,0,17,30,30
1651123169814,MATH 20C,B01,083762,Staff,6,0,30,24
1651123169814,MATH 20C,B02,083763,Staff,28,0,30,2
1651123175943,MATH 20D,A01,083765,Tran; Brian Kha,4,1,30,26
1651123175943,MATH 20D,A02,083766,Tran; Brian Kha,0,0,30,30
1651123175943,MATH 20D,A03,083767,Tran; Brian Kha,22,0,30,8
1651123181966,MATH 20E,A01,083771,Staff,0,0,30,30
1651123181966,MATH 20E,A02,083772,Staff,9,0,30,21
1651123181966,MATH 20E,B01,083773,Staff,4,0,35,31
1651123181966,MATH 20E,B02,083774,Staff,5,1,35,30
1651123187990,MATH 103A,A01,083777,Greenfeld; Be'Eri,0,17,30,30
1651123187990,MATH 103A,A02,083778,Greenfeld; Be'Eri,0,17,30,30
1651123187990,MATH 103A,B01,083779,Greenfeld; Be'Eri,0,16,30,30
1651123187990,MATH 103A,B02,083780,Greenfeld; Be'Eri,0,15,30,30
1651123194016,MATH 105,A01,085443,Staff,0,24,30,30
1651123200046,MATH 109,A01,083213,Ganzberger; Geoffrey Michael,0,8,30,30
1651123200046,MATH 109,A02,083214,Ganzberger; Geoffrey Michael,0,7,30,30
1651123200046,MATH 109,B01,083215,Ganzberger; Geoffrey Michael,0,8,30,30
1651123200046,MATH 109,B02,083216,Ganzberger; Geoffrey Michael,1,8,30,29
1651123206070,MATH 142A,A01,083219,Chow; Bennett,0,15,30,30
1651123206070,MATH 142A,A02,083220,Chow; Bennett,0,15,30,30
1651123206070,MATH 142A,B01,083221,Chow; Bennett,0,16,30,30
1651123206070,MATH 142A,B02,083222,Chow; Bennett,0,15,30,30
1651123212094,MATH 193A,A01,083224,Staff,0,9,30,30
1651123212094,MATH 193A,A02,083225,Staff,1,7,30,29
1651123212094,MATH 193A,A03,083781,Staff,0,7,30,30
1651123212094,MATH 193A,A04,083782,Staff,0,7,30,30
1651123218119,MATH 197,001,091859,McAuley; Julian John,9998,0,9999,1
1651123224186,COGS 9,A01,083615,Staff,0,20,60,60
1651123230215,COGS 11,A01,083617,Boyle; Mary E. T.,13,0,40,27
1651123236252,COGS 13,A01,083071,Staff,0,39,40,40
1651123242275,COGS 14A,A01,092681,Staff,0,41,100,100
1651123248302,COGS 14B,A01,083073,Cheng; Tzu-Han,0,11,50,50
1651123254327,COGS 17,A01,092677,Staff,8,0,75,67
1651123260360,COGS 100,A01,083619,Staff,0,30,60,60
1651123266383,COGS 101A,A01,083621,Davis; Joshua Daniel,0,29,60,60
1651123272414,COGS 101B,A01,091572,Staff,0,8,60,60
1651123278439,COGS 101C,A01,083625,Delgado; Tania,12,0,30,18
1651123284468,COGS 107A,A01,083627,Boyle; Mary E. T.,0,17,60,60
1651123290493,COGS 118A,A01,083075,Staff,0,10,60,60
1651123296516,CSE 3,A50,083646,Miranda; Gregory Joseph,15,0,38,23
1651123296516,CSE 3,A51,083647,Miranda; Gregory Joseph,36,0,37,1
1651123302545,CSE 8A,A50,083650,Miranda; Gregory Joseph,0,30,40,40
1651123308570,CSE 11,A01,083080,Cao; Yingjun,1,99,40,39
1651123314593,CSE 12,A01,083652,Staff,0,30,100,100
1651123320619,CSE 15L,A01,083654,Staff,0,4,50,50
1651123320619,CSE 15L,A02,083655,Staff,0,3,50,50
1651123326645,CSE 20,A01,083657,Staff,47,0,80,33
1651123332672,CSE 30,A01,083084,Eldon; John,0,39,80,80
1651123338703,CSE 100,A01,083659,Cao; Yingjun,0,72,50,50
1651123344739,CSE 134B,A01,083661,Powell; Thomas Allan,0,38,65,65
1651123350762,CSE 140,A01,083663,Staff,0,17,75,75
1651123356786,CSE 140L,A01,083088,Eldon; John,1,0,100,99
1651123362810,CSE 175,A01,083665,Kumar; Rakesh,0,0,25,25
1651123368836,CSE 190,A00,092507,Dubnov; Shlomo,9,0,20,11
1651123374860,ECE 45,A01,083139,Staff,0,8,60,60
1651123380884,ECE 65,A50,083695,Staff,0,7,30,30
1651123386906,ECE 109,A01,091882,Touri; Behrouz,32,0,70,38
1651123392932,ECE 180,A00,083140,Abi Samra; Nicholas Camill,17,0,30,13
1651123392932,ECE 180,B00,083141,Abi Samra; Nicholas Camill,0,1,30,32
1651123398961,MATH 10A,A01,083735,Patchell; Gregory David,0,0,30,30
1651123398961,MATH 10A,A02,083736,Patchell; Gregory David,26,0,30,4
1651123398961,MATH 10A,A03,083737,Patchell; Gregory David,22,0,30,8
1651123404987,MATH 10B,A01,083207,Staff,0,8,30,30
1651123404987,MATH 10B,A02,083208,Staff,0,7,30,30
1651123404987,MATH 10B,B01,083739,Staff,7,0,30,23
1651123404987,MATH 10B,B02,083740,Staff,28,0,30,2
1651123411013,MATH 18,A01,083743,Staff,0,0,30,30
1651123411013,MATH 18,A02,083744,Staff,23,0,30,7
1651123411013,MATH 18,A03,083745,Staff,19,0,30,11
1651123411013,MATH 18,A04,083746,Staff,26,0,30,4
1651123411013,MATH 18,B01,083748,Staff,0,16,30,30
1651123411013,MATH 18,B02,083749,Staff,0,15,30,30
1651123411013,MATH 18,B03,083750,Staff,0,15,30,30
1651123411013,MATH 18,B04,083751,Staff,0,15,30,30
1651123417035,MATH 20A,A01,083754,Staff,18,0,40,22
1651123423061,MATH 20B,A01,083756,Briones; Jor-el Thomas Caparas,0,14,30,30
1651123423061,MATH 20B,A02,083757,Briones; Jor-el Thomas Caparas,0,11,30,30
1651123429084,MATH 20C,A01,083760,Briones; Jor-el Thomas Caparas,1,17,30,29
1651123429084,MATH 20C,A02,083761,Briones; Jor-el Thomas Caparas,0,17,30,30
1651123429084,MATH 20C,B01,083762,Staff,6,0,30,24
1651123429084,MATH 20C,B02,083763,Staff,28,0,30,2
1651123435111,MATH 20D,A01,083765,Tran; Brian Kha,4,1,30,26
1651123435111,MATH 20D,A02,083766,Tran; Brian Kha,0,0,30,30
1651123435111,MATH 20D,A03,083767,Tran; Brian Kha,22,0,30,8
1651123441135,MATH 20E,A01,083771,Staff,0,0,30,30
1651123441135,MATH 20E,A02,083772,Staff,9,0,30,21
1651123441135,MATH 20E,B01,083773,Staff,4,0,35,31
1651123441135,MATH 20E,B02,083774,Staff,5,1,35,30
1651123447163,MATH 103A,A01,083777,Greenfeld; Be'Eri,0,17,30,30
1651123447163,MATH 103A,A02,083778,Greenfeld; Be'Eri,0,17,30,30
1651123447163,MATH 103A,B01,083779,Greenfeld; Be'Eri,0,16,30,30
1651123447163,MATH 103A,B02,083780,Greenfeld; Be'Eri,0,15,30,30
1651123453196,MATH 105,A01,085443,Staff,0,24,30,30
1651123459220,MATH 109,A01,083213,Ganzberger; Geoffrey Michael,0,8,30,30
1651123459220,MATH 109,A02,083214,Ganzberger; Geoffrey Michael,0,7,30,30
1651123459220,MATH 109,B01,083215,Ganzberger; Geoffrey Michael,0,8,30,30
1651123459220,MATH 109,B02,083216,Ganzberger; Geoffrey Michael,1,8,30,29
1651123465251,MATH 142A,A01,083219,Chow; Bennett,0,15,30,30
1651123465251,MATH 142A,A02,083220,Chow; Bennett,0,15,30,30
1651123465251,MATH 142A,B01,083221,Chow; Bennett,0,16,30,30
1651123465251,MATH 142A,B02,083222,Chow; Bennett,0,15,30,30
1651123471274,MATH 193A,A01,083224,Staff,0,9,30,30
1651123471274,MATH 193A,A02,083225,Staff,1,7,30,29
1651123471274,MATH 193A,A03,083781,Staff,0,7,30,30
1651123471274,MATH 193A,A04,083782,Staff,0,7,30,30
1651123477296,MATH 197,001,091859,McAuley; Julian John,9998,0,9999,1
1651123483362,COGS 9,A01,083615,Staff,0,20,60,60
1651123489391,COGS 11,A01,083617,Boyle; Mary E. T.,13,0,40,27
1651123495414,COGS 13,A01,083071,Staff,0,39,40,40
1651123501438,COGS 14A,A01,092681,Staff,0,41,100,100
1651123507460,COGS 14B,A01,083073,Cheng; Tzu-Han,0,11,50,50
1651123513482,COGS 17,A01,092677,Staff,8,0,75,67
1651123519509,COGS 100,A01,083619,Staff,0,30,60,60
1651123525532,COGS 101A,A01,083621,Davis; Joshua Daniel,0,29,60,60
1651123531555,COGS 101B,A01,091572,Staff,0,8,60,60
1651123537584,COGS 101C,A01,083625,Delgado; Tania,12,0,30,18
1651123543611,COGS 107A,A01,083627,Boyle; Mary E. T.,0,17,60,60
1651123549635,COGS 118A,A01,083075,Staff,0,10,60,60
1651123555657,CSE 3,A50,083646,Miranda; Gregory Joseph,15,0,38,23
1651123555657,CSE 3,A51,083647,Miranda; Gregory Joseph,36,0,37,1
1651123561679,CSE 8A,A50,083650,Miranda; Gregory Joseph,0,30,40,40
1651123567706,CSE 11,A01,083080,Cao; Yingjun,1,99,40,39
1651123573732,CSE 12,A01,083652,Staff,0,30,100,100
1651123579759,CSE 15L,A01,083654,Staff,0,4,50,50
1651123579759,CSE 15L,A02,083655,Staff,0,3,50,50
1651123585785,CSE 20,A01,083657,Staff,47,0,80,33
1651123591812,CSE 30,A01,083084,Eldon; John,0,39,80,80
1651123597835,CSE 100,A01,083659,Cao; Yingjun,0,72,50,50
1651123603858,CSE 134B,A01,083661,Powell; Thomas Allan,0,38,65,65
1651123609882,CSE 140,A01,083663,Staff,0,17,75,75
1651123615906,CSE 140L,A01,083088,Eldon; John,1,0,100,99
1651123621932,CSE 175,A01,083665,Kumar; Rakesh,0,0,25,25
1651123627958,CSE 190,A00,092507,Dubnov; Shlomo,9,0,20,11
1651123633990,ECE 45,A01,083139,Staff,0,8,60,60
1651123640017,ECE 65,A50,083695,Staff,0,7,30,30
1651123646043,ECE 109,A01,091882,Touri; Behrouz,32,0,70,38
1651123652066,ECE 180,A00,083140,Abi Samra; Nicholas Camill,17,0,30,13
1651123652066,ECE 180,B00,083141,Abi Samra; Nicholas Camill,0,1,30,32
1651123658091,MATH 10A,A01,083735,Patchell; Gregory David,0,0,30,30
1651123658091,MATH 10A,A02,083736,Patchell; Gregory David,26,0,30,4
1651123658091,MATH 10A,A03,083737,Patchell; Gregory David,22,0,30,8
1651123664116,MATH 10B,A01,083207,Staff,0,8,30,30
1651123664116,MATH 10B,A02,083208,Staff,0,7,30,30
1651123664116,MATH 10B,B01,083739,Staff,7,0,30,23
1651123664116,MATH 10B,B02,083740,Staff,28,0,30,2
1651123670140,MATH 18,A01,083743,Staff,0,0,30,30
1651123670140,MATH 18,A02,083744,Staff,23,0,30,7
1651123670140,MATH 18,A03,083745,Staff,19,0,30,11
1651123670140,MATH 18,A04,083746,Staff,26,0,30,4
1651123670140,MATH 18,B01,083748,Staff,0,16,30,30
1651123670140,MATH 18,B02,083749,Staff,0,15,30,30
1651123670140,MATH 18,B03,083750,Staff,0,15,30,30
1651123670140,MATH 18,B04,083751,Staff,0,15,30,30
1651123676163,MATH 20A,A01,083754,Staff,18,0,40,22
1651123682187,MATH 20B,A01,083756,Briones; Jor-el Thomas Caparas,0,14,30,30
1651123682187,MATH 20B,A02,083757,Briones; Jor-el Thomas Caparas,0,11,30,30
1651123688210,MATH 20C,A01,083760,Briones; Jor-el Thomas Caparas,0,16,30,30
1651123688210,MATH 20C,A02,083761,Briones; Jor-el Thomas Caparas,0,17,30,30
1651123688210,MATH 20C,B01,083762,Staff,6,0,30,24
1651123688210,MATH 20C,B02,083763,Staff,28,0,30,2
1651123694234,MATH 20D,A01,083765,Tran; Brian Kha,4,1,30,26
1651123694234,MATH 20D,A02,083766,Tran; Brian Kha,0,0,30,30
1651123694234,MATH 20D,A03,083767,Tran; Brian Kha,21,0,30,9
1651123700256,MATH 20E,A01,083771,Staff,0,0,30,30
1651123700256,MATH 20E,A02,083772,Staff,9,0,30,21
1651123700256,MATH 20E,B01,083773,Staff,4,0,35,31
1651123700256,MATH 20E,B02,083774,Staff,4,0,35,31
1651123706284,MATH 103A,A01,083777,Greenfeld; Be'Eri,0,17,30,30
1651123706284,MATH 103A,A02,083778,Greenfeld; Be'Eri,0,17,30,30
1651123706284,MATH 103A,B01,083779,Greenfeld; Be'Eri,0,16,30,30
1651123706284,MATH 103A,B02,083780,Greenfeld; Be'Eri,0,15,30,30
1651123712306,MATH 105,A01,085443,Staff,0,24,30,30
1651123718332,MATH 109,A01,083213,Ganzberger; Geoffrey Michael,0,8,30,30
1651123718332,MATH 109,A02,083214,Ganzberger; Geoffrey Michael,0,7,30,30
1651123718332,MATH 109,B01,083215,Ganzberger; Geoffrey Michael,0,8,30,30
1651123718332,MATH 109,B02,083216,Ganzberger; Geoffrey Michael,0,7,30,30
1651123724360,MATH 142A,A01,083219,Chow; Bennett,0,15,30,30
1651123724360,MATH 142A,A02,083220,Chow; Bennett,0,15,30,30
1651123724360,MATH 142A,B01,083221,Chow; Bennett,0,16,30,30
1651123724360,MATH 142A,B02,083222,Chow; Bennett,0,15,30,30
1651123730391,MATH 193A,A01,083224,Staff,0,9,30,30
1651123730391,MATH 193A,A02,083225,Staff,0,6,30,30
1651123730391,MATH 193A,A03,083781,Staff,0,7,30,30
1651123730391,MATH 193A,A04,083782,Staff,0,7,30,30
1651123736411,MATH 197,001,091859,McAuley; Julian John,9998,0,9999,1
1651123742462,COGS 9,A01,083615,Staff,0,20,60,60
1651123748487,COGS 11,A01,083617,Boyle; Mary E. T.,13,0,40,27
1651123754512,COGS 13,A01,083071,Staff,0,39,40,40
1651123760539,COGS 14A,A01,092681,Staff,0,41,100,100
1651123766651,COGS 14B,A01,083073,Cheng; Tzu-Han,0,11,50,50
1651123772674,COGS 17,A01,092677,Staff,8,0,75,67
1651123778700,COGS 100,A01,083619,Staff,0,30,60,60
1651123784724,COGS 101A,A01,083621,Davis; Joshua Daniel,0,29,60,60
1651123790749,COGS 101B,A01,091572,Staff,0,8,60,60
1651123796772,COGS 101C,A01,083625,Delgado; Tania,12,0,30,18
1651123802795,COGS 107A,A01,083627,Boyle; Mary E. T.,0,17,60,60
1651123808818,COGS 118A,A01,083075,Staff,0,10,60,60
1651123814846,CSE 3,A50,083646,Miranda; Gregory Joseph,15,0,38,23
1651123814846,CSE 3,A51,083647,Miranda; Gregory Joseph,36,0,37,1
1651123820880,CSE 8A,A50,083650,Miranda; Gregory Joseph,0,30,40,40
1651123826902,CSE 11,A01,083080,Cao; Yingjun,0,98,40,40
1651123832925,CSE 12,A01,083652,Staff,0,30,100,100
1651123838948,CSE 15L,A01,083654,Staff,0,4,50,50
1651123838948,CSE 15L,A02,083655,Staff,0,3,50,50
1651123844971,CSE 20,A01,083657,Staff,47,0,80,33
1651123850998,CSE 30,A01,083084,Eldon; John,0,39,80,80
1651123857034,CSE 100,A01,083659,Cao; Yingjun,0,72,50,50
1651123863057,CSE 134B,A01,083661,Powell; Thomas Allan,0,38,65,65
1651123869081,CSE 140,A01,083663,Staff,0,17,75,75
1651123875104,CSE 140L,A01,083088,Eldon; John,1,0,100,99
1651123881130,CSE 175,A01,083665,Kumar; Rakesh,0,0,25,25
1651123887160,CSE 190,A00,092507,Dubnov; Shlomo,9,0,20,11
1651123893188,ECE 45,A01,083139,Staff,0,8,60,60
1651123899214,ECE 65,A50,083695,Staff,0,7,30,30
1651123905248,ECE 109,A01,091882,Touri; Behrouz,32,0,70,38
1651123911274,ECE 180,A00,083140,Abi Samra; Nicholas Camill,17,0,30,13
1651123911274,ECE 180,B00,083141,Abi Samra; Nicholas Camill,0,1,30,32
1651123917306,MATH 10A,A01,083735,Patchell; Gregory David,0,0,30,30
1651123917306,MATH 10A,A02,083736,Patchell; Gregory David,26,0,30,4
1651123917306,MATH 10A,A03,083737,Patchell; Gregory David,22,0,30,8
1651123923330,MATH 10B,A01,083207,Staff,0,8,30,30
1651123923330,MATH 10B,A02,083208,Staff,0,7,30,30
1651123923330,MATH 10B,B01,083739,Staff,7,0,30,23
1651123923330,MATH 10B,B02,083740,Staff,28,0,30,2
1651123929359,MATH 18,A01,083743,Staff,0,0,30,30
1651123929359,MATH 18,A02,083744,Staff,23,0,30,7
1651123929359,MATH 18,A03,083745,Staff,19,0,30,11
1651123929359,MATH 18,A04,083746,Staff,26,0,30,4
1651123929359,MATH 18,B01,083748,Staff,0,16,30,30
1651123929359,MATH 18,B02,083749,Staff,0,15,30,30
1651123929359,MATH 18,B03,083750,Staff,0,15,30,30
1651123929359,MATH 18,B04,083751,Staff,0,15,30,30
1651123935382,MATH 20A,A01,083754,Staff,18,0,40,22
1651123941405,MATH 20B,A01,083756,Briones; Jor-el Thomas Caparas,0,14,30,30
1651123941405,MATH 20B,A02,083757,Briones; Jor-el Thomas Caparas,0,11,30,30
1651123947432,MATH 20C,A01,083760,Briones; Jor-el Thomas Caparas,0,16,30,30
1651123947432,MATH 20C,A02,083761,Briones; Jor-el Thomas Caparas,0,17,30,30
1651123947432,MATH 20C,B01,083762,Staff,6,0,30,24
1651123947432,MATH 20C,B02,083763,Staff,28,0,30,2
1651123953466,MATH 20D,A01,083765,Tran; Brian Kha,4,1,30,26
1651123953466,MATH 20D,A02,083766,Tran; Brian Kha,0,0,30,30
1651123953466,MATH 20D,A03,083767,Tran; Brian Kha,21,0,30,9
1651123959493,MATH 20E,A01,083771,Staff,0,0,30,30
1651123959493,MATH 20E,A02,083772,Staff,9,0,30,21
1651123959493,MATH 20E,B01,083773,Staff,4,0,35,31
1651123959493,MATH 20E,B02,083774,Staff,4,0,35,31
1651123965526,MATH 103A,A01,083777,Greenfeld; Be'Eri,0,17,30,30
1651123965526,MATH 103A,A02,083778,Greenfeld; Be'Eri,0,17,30,30
1651123965526,MATH 103A,B01,083779,Greenfeld; Be'Eri,0,16,30,30
1651123965526,MATH 103A,B02,083780,Greenfeld; Be'Eri,0,15,30,30
1651123971553,MATH 105,A01,085443,Staff,0,24,30,30
1651123977579,MATH 109,A01,083213,Ganzberger; Geoffrey Michael,0,8,30,30
1651123977579,MATH 109,A02,083214,Ganzberger; Geoffrey Michael,0,7,30,30
1651123977579,MATH 109,B01,083215,Ganzberger; Geoffrey Michael,0,8,30,30
1651123977579,MATH 109,B02,083216,Ganzberger; Geoffrey Michael,0,7,30,30
1651123983601,MATH 142A,A01,083219,Chow; Bennett,0,15,30,30
1651123983601,MATH 142A,A02,083220,Chow; Bennett,0,15,30,30
1651123983601,MATH 142A,B01,083221,Chow; Bennett,0,16,30,30
1651123983601,MATH 142A,B02,083222,Chow; Bennett,0,15,30,30
1651123989629,MATH 193A,A01,083224,Staff,0,9,30,30
1651123989629,MATH 193A,A02,083225,Staff,0,6,30,30
1651123989629,MATH 193A,A03,083781,Staff,0,7,30,30
1651123989629,MATH 193A,A04,083782,Staff,0,7,30,30
1651123995662,MATH 197,001,091859,McAuley; Julian John,9998,0,9999,1
1651124001733,COGS 9,A01,083615,Staff,0,20,60,60
1651124007758,COGS 11,A01,083617,Boyle; Mary E. T.,13,0,40,27
1651124013782,COGS 13,A01,083071,Staff,0,39,40,40
1651124019806,COGS 14A,A01,092681,Staff,0,41,100,100
1651124025830,COGS 14B,A01,083073,Cheng; Tzu-Han,0,11,50,50
1651124031853,COGS 17,A01,092677,Staff,8,0,75,67
1651124037877,COGS 100,A01,083619,Staff,0,30,60,60
1651124043908,COGS 101A,A01,083621,Davis; Joshua Daniel,0,29,60,60
1651124049932,COGS 101B,A01,091572,Staff,0,8,60,60
1651124055956,COGS 101C,A01,083625,Delgado; Tania,12,0,30,18
1651124061982,COGS 107A,A01,083627,Boyle; Mary E. T.,0,17,60,60
1651124068009,COGS 118A,A01,083075,Staff,0,10,60,60
1651124074032,CSE 3,A50,083646,Miranda; Gregory Joseph,15,0,38,23
1651124074032,CSE 3,A51,083647,Miranda; Gregory Joseph,36,0,37,1
1651124080058,CSE 8A,A50,083650,Miranda; Gregory Joseph,0,30,40,40
1651124086091,CSE 11,A01,083080,Cao; Yingjun,0,98,40,40
1651124092116,CSE 12,A01,083652,Staff,0,30,100,100
1651124098139,CSE 15L,A01,083654,Staff,0,4,50,50
1651124098139,CSE 15L,A02,083655,Staff,0,3,50,50
1651124104162,CSE 20,A01,083657,Staff,47,0,80,33
1651124110185,CSE 30,A01,083084,Eldon; John,0,39,80,80
1651124116213,CSE 100,A01,083659,Cao; Yingjun,0,72,50,50
1651124122237,CSE 134B,A01,083661,Powell; Thomas Allan,0,38,65,65
1651124128260,CSE 140,A01,083663,Staff,0,17,75,75
1651124134286,CSE 140L,A01,083088,Eldon; John,1,0,100,99
1651124140307,CSE 175,A01,083665,Kumar; Rakesh,0,0,25,25
1651124146331,CSE 190,A00,092507,Dubnov; Shlomo,9,0,20,11
1651124152356,ECE 45,A01,083139,Staff,0,8,60,60
1651124158379,ECE 65,A50,083695,Staff,0,7,30,30
1651124164402,ECE 109,A01,091882,Touri; Behrouz,32,0,70,38
1651124170425,ECE 180,A00,083140,Abi Samra; Nicholas Camill,17,0,30,13
1651124170425,ECE 180,B00,083141,Abi Samra; Nicholas Camill,0,1,30,32
1651124176448,MATH 10A,A01,083735,Patchell; Gregory David,0,0,30,30
1651124176448,MATH 10A,A02,083736,Patchell; Gregory David,26,0,30,4
1651124176448,MATH 10A,A03,083737,Patchell; Gregory David,22,0,30,8
1651124182474,MATH 10B,A01,083207,Staff,0,8,30,30
1651124182474,MATH 10B,A02,083208,Staff,0,7,30,30
1651124182474,MATH 10B,B01,083739,Staff,7,0,30,23
1651124182474,MATH 10B,B02,083740,Staff,28,0,30,2
1651124188497,MATH 18,A01,083743,Staff,0,0,30,30
1651124188497,MATH 18,A02,083744,Staff,23,0,30,7
1651124188497,MATH 18,A03,083745,Staff,19,0,30,11
1651124188497,MATH 18,A04,083746,Staff,26,0,30,4
1651124188497,MATH 18,B01,083748,Staff,0,16,30,30
1651124188497,MATH 18,B02,083749,Staff,0,15,30,30
1651124188497,MATH 18,B03,083750,Staff,0,15,30,30
1651124188497,MATH 18,B04,083751,Staff,0,15,30,30
1651124194521,MATH 20A,A01,083754,Staff,18,0,40,22
1651124200544,MATH 20B,A01,083756,Briones; Jor-el Thomas Caparas,0,14,30,30
1651124200544,MATH 20B,A02,083757,Briones; Jor-el Thomas Caparas,0,11,30,30
1651124206568,MATH 20C,A01,083760,Briones; Jor-el Thomas Caparas,0,16,30,30
1651124206568,MATH 20C,A02,083761,Briones; Jor-el Thomas Caparas,0,17,30,30
1651124206568,MATH 20C,B01,083762,Staff,6,0,30,24
1651124206568,MATH 20C,B02,083763,Staff,28,0,30,2
1651124212592,MATH 20D,A01,083765,Tran; Brian Kha,4,1,30,26
1651124212592,MATH 20D,A02,083766,Tran; Brian Kha,0,0,30,30
1651124212592,MATH 20D,A03,083767,Tran; Brian Kha,21,0,30,9
1651124218615,MATH 20E,A01,083771,Staff,0,0,30,30
1651124218615,MATH 20E,A02,083772,Staff,9,0,30,21
1651124218615,MATH 20E,B01,083773,Staff,4,0,35,31
1651124218615,MATH 20E,B02,083774,Staff,4,0,35,31
1651124224638,MATH 103A,A01,083777,Greenfeld; Be'Eri,0,17,30,30
1651124224638,MATH 103A,A02,083778,Greenfeld; Be'Eri,0,17,30,30
1651124224638,MATH 103A,B01,083779,Greenfeld; Be'Eri,0,16,30,30
1651124224638,MATH 103A,B02,083780,Greenfeld; Be'Eri,0,15,30,30
1651124230664,MATH 105,A01,085443,Staff,0,24,30,30
1651124236690,MATH 109,A01,083213,Ganzberger; Geoffrey Michael,0,8,30,30
1651124236690,MATH 109,A02,083214,Ganzberger; Geoffrey Michael,0,7,30,30
1651124236690,MATH 109,B01,083215,Ganzberger; Geoffrey Michael,0,8,30,30
1651124236690,MATH 109,B02,083216,Ganzberger; Geoffrey Michael,0,7,30,30
1651124242712,MATH 142A,A01,083219,Chow; Bennett,0,15,30,30
1651124242712,MATH 142A,A02,083220,Chow; Bennett,0,15,30,30
1651124242712,MATH 142A,B01,083221,Chow; Bennett,0,16,30,30
1651124242712,MATH 142A,B02,083222,Chow; Bennett,0,15,30,30
1651124248735,MATH 193A,A01,083224,Staff,0,9,30,30
1651124248735,MATH 193A,A02,083225,Staff,0,6,30,30
1651124248735,MATH 193A,A03,083781,Staff,0,7,30,30
1651124248735,MATH 193A,A04,083782,Staff,0,7,30,30
1651124254758,MATH 197,001,091859,McAuley; Julian John,9998,0,9999,1
1651124260808,COGS 9,A01,083615,Staff,0,20,60,60
1651124266836,COGS 11,A01,083617,Boyle; Mary E. T.,13,0,40,27
1651124272859,COGS 13,A01,083071,Staff,0,39,40,40
1651124278883,COGS 14A,A01,092681,Staff,0,41,100,100
1651124284908,COGS 14B,A01,083073,Cheng; Tzu-Han,0,11,50,50
1651124290931,COGS 17,A01,092677,Staff,8,0,75,67
1651124296953,COGS 100,A01,083619,Staff,0,30,60,60
1651124302975,COGS 101A,A01,083621,Davis; Joshua Daniel,0,29,60,60
1651124309006,COGS 101B,A01,091572,Staff,0,8,60,60
1651124315033,COGS 101C,A01,083625,Delgado; Tania,12,0,30,18
1651124321055,COGS 107A,A01,083627,Boyle; Mary E. T.,0,17,60,60
1651124327080,COGS 118A,A01,083075,Staff,0,10,60,60
1651124333105,CSE 3,A50,083646,Miranda; Gregory Joseph,15,0,38,23
1651124333105,CSE 3,A51,083647,Miranda; Gregory Joseph,36,0,37,1
1651124339130,CSE 8A,A50,083650,Miranda; Gregory Joseph,0,30,40,40
1651124345155,CSE 11,A01,083080,Cao; Yingjun,0,98,40,40
1651124351178,CSE 12,A01,083652,Staff,0,30,100,100
1651124357201,CSE 15L,A01,083654,Staff,0,4,50,50
1651124357201,CSE 15L,A02,083655,Staff,0,3,50,50
1651124363301,CSE 20,A01,083657,Staff,47,0,80,33
1651124369327,CSE 30,A01,083084,Eldon; John,0,39,80,80
1651124375349,CSE 100,A01,083659,Cao; Yingjun,0,72,50,50
1651124381372,CSE 134B,A01,083661,Powell; Thomas Allan,0,38,65,65
1651124387397,CSE 140,A01,083663,Staff,0,17,75,75
1651124393423,CSE 140L,A01,083088,Eldon; John,1,0,100,99
1651124399444,CSE 175,A01,083665,Kumar; Rakesh,0,0,25,25
1651124405466,CSE 190,A00,092507,Dubnov; Shlomo,9,0,20,11
1651124411502,ECE 45,A01,083139,Staff,0,8,60,60
1651124417524,ECE 65,A50,083695,Staff,0,7,30,30
1651124423546,ECE 109,A01,091882,Touri; Behrouz,32,0,70,38
1651124429571,ECE 180,A00,083140,Abi Samra; Nicholas Camill,17,0,30,13
1651124429571,ECE 180,B00,083141,Abi Samra; Nicholas Camill,0,1,30,32
1651124435593,MATH 10A,A01,083735,Patchell; Gregory David,0,0,30,30
1651124435593,MATH 10A,A02,083736,Patchell; Gregory David,26,0,30,4
1651124435593,MATH 10A,A03,083737,Patchell; Gregory David,22,0,30,8
1651124441624,MATH 10B,A01,083207,Staff,0,8,30,30
1651124441624,MATH 10B,A02,083208,Staff,0,7,30,30
1651124441624,MATH 10B,B01,083739,Staff,7,0,30,23
1651124441624,MATH 10B,B02,083740,Staff,28,0,30,2
1651124447649,MATH 18,A01,083743,Staff,0,0,30,30
1651124447649,MATH 18,A02,083744,Staff,23,0,30,7
1651124447649,MATH 18,A03,083745,Staff,19,0,30,11
1651124447649,MATH 18,A04,083746,Staff,26,0,30,4
1651124447649,MATH 18,B01,083748,Staff,0,16,30,30
1651124447649,MATH 18,B02,083749,Staff,0,15,30,30
1651124447649,MATH 18,B03,083750,Staff,0,15,30,30
1651124447649,MATH 18,B04,083751,Staff,0,15,30,30
1651124453672,MATH 20A,A01,083754,Staff,18,0,40,22
1651124459697,MATH 20B,A01,083756,Briones; Jor-el Thomas Caparas,0,14,30,30
1651124459697,MATH 20B,A02,083757,Briones; Jor-el Thomas Caparas,0,11,30,30
1651124465725,MATH 20C,A01,083760,Briones; Jor-el Thomas Caparas,0,16,30,30
1651124465725,MATH 20C,A02,083761,Briones; Jor-el Thomas Caparas,0,17,30,30
1651124465725,MATH 20C,B01,083762,Staff,6,0,30,24
1651124465725,MATH 20C,B02,083763,Staff,28,0,30,2
1651124471749,MATH 20D,A01,083765,Tran; Brian Kha,4,1,30,26
1651124471749,MATH 20D,A02,083766,Tran; Brian Kha,0,0,30,30
1651124471749,MATH 20D,A03,083767,Tran; Brian Kha,21,0,30,9
1651124477773,MATH 20E,A01,083771,Staff,0,0,30,30
1651124477773,MATH 20E,A02,083772,Staff,9,0,30,21
1651124477773,MATH 20E,B01,083773,Staff,4,0,35,31
1651124477773,MATH 20E,B02,083774,Staff,4,0,35,31
1651124483800,MATH 103A,A01,083777,Greenfeld; Be'Eri,0,17,30,30
1651124483800,MATH 103A,A02,083778,Greenfeld; Be'Eri,0,17,30,30
1651124483800,MATH 103A,B01,083779,Greenfeld; Be'Eri,0,16,30,30
1651124483800,MATH 103A,B02,083780,Greenfeld; Be'Eri,0,15,30,30
1651124489824,MATH 105,A01,085443,Staff,0,24,30,30
1651124495850,MATH 109,A01,083213,Ganzberger; Geoffrey Michael,0,8,30,30
1651124495850,MATH 109,A02,083214,Ganzberger; Geoffrey Michael,0,7,30,30
1651124495850,MATH 109,B01,083215,Ganzberger; Geoffrey Michael,0,8,30,30
1651124495850,MATH 109,B02,083216,Ganzberger; Geoffrey Michael,0,7,30,30
1651124501874,MATH 142A,A01,083219,Chow; Bennett,0,15,30,30
1651124501874,MATH 142A,A02,083220,Chow; Bennett,0,15,30,30
1651124501874,MATH 142A,B01,083221,Chow; Bennett,0,16,30,30
1651124501874,MATH 142A,B02,083222,Chow; Bennett,0,15,30,30
1651124507903,MATH 193A,A01,083224,Staff,0,9,30,30
1651124507903,MATH 193A,A02,083225,Staff,0,6,30,30
1651124507903,MATH 193A,A03,083781,Staff,0,7,30,30
1651124507903,MATH 193A,A04,083782,Staff,0,7,30,30
1651124513925,MATH 197,001,091859,McAuley; Julian John,9998,0,9999,1
1651124519981,COGS 9,A01,083615,Staff,0,20,60,60
1651124526007,COGS 11,A01,083617,Boyle; Mary E. T.,13,0,40,27
1651124532032,COGS 13,A01,083071,Staff,0,39,40,40
1651124538053,COGS 14A,A01,092681,Staff,0,41,100,100
1651124544080,COGS 14B,A01,083073,Cheng; Tzu-Han,0,11,50,50
1651124550104,COGS 17,A01,092677,Staff,8,0,75,67
1651124556129,COGS 100,A01,083619,Staff,0,30,60,60
1651124562151,COGS 101A,A01,083621,Davis; Joshua Daniel,0,29,60,60
1651124568179,COGS 101B,A01,091572,Staff,0,8,60,60
1651124574201,COGS 101C,A01,083625,Delgado; Tania,12,0,30,18
1651124580234,COGS 107A,A01,083627,Boyle; Mary E. T.,0,17,60,60
1651124586257,COGS 118A,A01,083075,Staff,0,10,60,60
1651124592280,CSE 3,A50,083646,Miranda; Gregory Joseph,15,0,38,23
1651124592280,CSE 3,A51,083647,Miranda; Gregory Joseph,36,0,37,1
1651124598302,CSE 8A,A50,083650,Miranda; Gregory Joseph,0,30,40,40
1651124604326,CSE 11,A01,083080,Cao; Yingjun,0,98,40,40
1651124610351,CSE 12,A01,083652,Staff,0,30,100,100
1651124616377,CSE 15L,A01,083654,Staff,0,4,50,50
1651124616377,CSE 15L,A02,083655,Staff,0,3,50,50
1651124622406,CSE 20,A01,083657,Staff,47,0,80,33
1651124628442,CSE 30,A01,083084,Eldon; John,0,39,80,80
1651124634466,CSE 100,A01,083659,Cao; Yingjun,0,72,50,50
1651124640493,CSE 134B,A01,083661,Powell; Thomas Allan,0,38,65,65
1651124646519,CSE 140,A01,083663,Staff,0,17,75,75
1651124652547,CSE 140L,A01,083088,Eldon; John,1,0,100,99
1651124658573,CSE 175,A01,083665,Kumar; Rakesh,0,0,25,25
1651124664598,CSE 190,A00,092507,Dubnov; Shlomo,9,0,20,11
1651124670622,ECE 45,A01,083139,Staff,0,8,60,60
1651124676652,ECE 65,A50,083695,Staff,0,7,30,30
1651124682679,ECE 109,A01,091882,Touri; Behrouz,32,0,70,38
1651124688705,ECE 180,A00,083140,Abi Samra; Nicholas Camill,17,0,30,13
1651124688705,ECE 180,B00,083141,Abi Samra; Nicholas Camill,0,1,30,32
1651124694733,MATH 10A,A01,083735,Patchell; Gregory David,0,0,30,30
1651124694733,MATH 10A,A02,083736,Patchell; Gregory David,26,0,30,4
1651124694733,MATH 10A,A03,083737,Patchell; Gregory David,22,0,30,8
1651124700757,MATH 10B,A01,083207,Staff,0,8,30,30
1651124700757,MATH 10B,A02,083208,Staff,0,7,30,30
1651124700757,MATH 10B,B01,083739,Staff,7,0,30,23
1651124700757,MATH 10B,B02,083740,Staff,28,0,30,2
1651124706779,MATH 18,A01,083743,Staff,0,0,30,30
1651124706779,MATH 18,A02,083744,Staff,23,0,30,7
1651124706779,MATH 18,A03,083745,Staff,19,0,30,11
1651124706779,MATH 18,A04,083746,Staff,26,0,30,4
1651124706779,MATH 18,B01,083748,Staff,0,16,30,30
1651124706779,MATH 18,B02,083749,Staff,0,15,30,30
1651124706779,MATH 18,B03,083750,Staff,0,15,30,30
1651124706779,MATH 18,B04,083751,Staff,0,15,30,30
1651124712814,MATH 20A,A01,083754,Staff,18,0,40,22
1651124718837,MATH 20B,A01,083756,Briones; Jor-el Thomas Caparas,0,14,30,30
1651124718837,MATH 20B,A02,083757,Briones; Jor-el Thomas Caparas,0,11,30,30
1651124724865,MATH 20C,A01,083760,Briones; Jor-el Thomas Caparas,0,16,30,30
1651124724865,MATH 20C,A02,083761,Briones; Jor-el Thomas Caparas,0,17,30,30
1651124724865,MATH 20C,B01,083762,Staff,6,0,30,24
1651124724865,MATH 20C,B02,083763,Staff,28,0,30,2
1651124730890,MATH 20D,A01,083765,Tran; Brian Kha,4,1,30,26
1651124730890,MATH 20D,A02,083766,Tran; Brian Kha,0,0,30,30
1651124730890,MATH 20D,A03,083767,Tran; Brian Kha,21,0,30,9
1651124736932,MATH 20E,A01,083771,Staff,0,0,30,30
1651124736932,MATH 20E,A02,083772,Staff,9,0,30,21
1651124736932,MATH 20E,B01,083773,Staff,4,0,35,31
1651124736932,MATH 20E,B02,083774,Staff,4,0,35,31
1651124742957,MATH 103A,A01,083777,Greenfeld; Be'Eri,0,17,30,30
1651124742957,MATH 103A,A02,083778,Greenfeld; Be'Eri,0,17,30,30
1651124742957,MATH 103A,B01,083779,Greenfeld; Be'Eri,0,16,30,30
1651124742957,MATH 103A,B02,083780,Greenfeld; Be'Eri,0,15,30,30
1651124748981,MATH 105,A01,085443,Staff,0,24,30,30
1651124755004,MATH 109,A01,083213,Ganzberger; Geoffrey Michael,0,8,30,30
1651124755004,MATH 109,A02,083214,Ganzberger; Geoffrey Michael,0,7,30,30
1651124755004,MATH 109,B01,083215,Ganzberger; Geoffrey Michael,0,8,30,30
1651124755004,MATH 109,B02,083216,Ganzberger; Geoffrey Michael,0,7,30,30
1651124761029,MATH 142A,A01,083219,Chow; Bennett,0,15,30,30
1651124761029,MATH 142A,A02,083220,Chow; Bennett,0,15,30,30
1651124761029,MATH 142A,B01,083221,Chow; Bennett,0,16,30,30
1651124761029,MATH 142A,B02,083222,Chow; Bennett,0,15,30,30
1651124767054,MATH 193A,A01,083224,Staff,0,9,30,30
1651124767054,MATH 193A,A02,083225,Staff,0,6,30,30
1651124767054,MATH 193A,A03,083781,Staff,0,7,30,30
1651124767054,MATH 193A,A04,083782,Staff,0,7,30,30
1651124773092,MATH 197,001,091859,McAuley; Julian John,9998,0,9999,1
1651124779148,COGS 9,A01,083615,Staff,0,20,60,60
1651124785176,COGS 11,A01,083617,Boyle; Mary E. T.,13,0,40,27
1651124791198,COGS 13,A01,083071,Staff,0,39,40,40
1651124797223,COGS 14A,A01,092681,Staff,0,41,100,100
1651124803249,COGS 14B,A01,083073,Cheng; Tzu-Han,0,11,50,50
1651124809288,COGS 17,A01,092677,Staff,8,0,75,67
1651124815312,COGS 100,A01,083619,Staff,0,29,60,61
1651124821339,COGS 101A,A01,083621,Davis; Joshua Daniel,0,29,60,60
1651124827363,COGS 101B,A01,091572,Staff,0,8,60,60
1651124833389,COGS 101C,A01,083625,Delgado; Tania,12,0,30,18
1651124839427,COGS 107A,A01,083627,Boyle; Mary E. T.,0,17,60,60
1651124845449,COGS 118A,A01,083075,Staff,0,10,60,60
1651124851475,CSE 3,A50,083646,Miranda; Gregory Joseph,15,0,38,23
1651124851475,CSE 3,A51,083647,Miranda; Gregory Joseph,36,0,37,1
1651124857497,CSE 8A,A50,083650,Miranda; Gregory Joseph,0,30,40,40
1651124863522,CSE 11,A01,083080,Cao; Yingjun,0,98,40,40
1651124869550,CSE 12,A01,083652,Staff,0,30,100,100
1651124875576,CSE 15L,A01,083654,Staff,0,4,50,50
1651124875576,CSE 15L,A02,083655,Staff,0,3,50,50
1651124881600,CSE 20,A01,083657,Staff,47,0,80,33
1651124887622,CSE 30,A01,083084,Eldon; John,0,39,80,80
1651124893645,CSE 100,A01,083659,Cao; Yingjun,0,72,50,50
1651124899672,CSE 134B,A01,083661,Powell; Thomas Allan,0,38,65,65
1651124905695,CSE 140,A01,083663,Staff,0,17,75,75
1651124911719,CSE 140L,A01,083088,Eldon; John,1,0,100,99
1651124917741,CSE 175,A01,083665,Kumar; Rakesh,0,0,25,25
1651124923767,CSE 190,A00,092507,Dubnov; Shlomo,9,0,20,11
1651124929797,ECE 45,A01,083139,Staff,0,8,60,60
1651124935820,ECE 65,A50,083695,Staff,0,7,30,30
1651124941853,ECE 109,A01,091882,Touri; Behrouz,32,0,70,38
1651124947880,ECE 180,A00,083140,Abi Samra; Nicholas Camill,17,0,30,13
1651124947880,ECE 180,B00,083141,Abi Samra; Nicholas Camill,0,1,30,32
1651124953904,MATH 10A,A01,083735,Patchell; Gregory David,0,0,30,30
1651124953904,MATH 10A,A02,083736,Patchell; Gregory David,26,0,30,4
1651124953904,MATH 10A,A03,083737,Patchell; Gregory David,22,0,30,8
1651124959999,MATH 10B,A01,083207,Staff,0,8,30,30
1651124959999,MATH 10B,A02,083208,Staff,0,7,30,30
1651124959999,MATH 10B,B01,083739,Staff,7,0,30,23
1651124959999,MATH 10B,B02,083740,Staff,28,0,30,2
1651124966029,MATH 18,A01,083743,Staff,0,0,30,30
1651124966029,MATH 18,A02,083744,Staff,23,0,30,7
1651124966029,MATH 18,A03,083745,Staff,19,0,30,11
1651124966029,MATH 18,A04,083746,Staff,26,0,30,4
1651124966029,MATH 18,B01,083748,Staff,0,16,30,30
1651124966029,MATH 18,B02,083749,Staff,0,15,30,30
1651124966029,MATH 18,B03,083750,Staff,0,15,30,30
1651124966029,MATH 18,B04,083751,Staff,0,15,30,30
1651124972055,MATH 20A,A01,083754,Staff,18,0,40,22
1651124978078,MATH 20B,A01,083756,Briones; Jor-el Thomas Caparas,0,14,30,30
1651124978078,MATH 20B,A02,083757,Briones; Jor-el Thomas Caparas,0,11,30,30
1651124984102,MATH 20C,A01,083760,Briones; Jor-el Thomas Caparas,0,16,30,30
1651124984102,MATH 20C,A02,083761,Briones; Jor-el Thomas Caparas,0,17,30,30
1651124984102,MATH 20C,B01,083762,Staff,6,0,30,24
1651124984102,MATH 20C,B02,083763,Staff,28,0,30,2
1651124990125,MATH 20D,A01,083765,Tran; Brian Kha,4,1,30,26
1651124990125,MATH 20D,A02,083766,Tran; Brian Kha,0,0,30,30
1651124990125,MATH 20D,A03,083767,Tran; Brian Kha,21,0,30,9
1651124996153,MATH 20E,A01,083771,Staff,0,0,30,30
1651124996153,MATH 20E,A02,083772,Staff,9,0,30,21
1651124996153,MATH 20E,B01,083773,Staff,4,0,35,31
1651124996153,MATH 20E,B02,083774,Staff,4,0,35,31
1651125002183,MATH 103A,A01,083777,Greenfeld; Be'Eri,0,17,30,30
1651125002183,MATH 103A,A02,083778,Greenfeld; Be'Eri,0,17,30,30
1651125002183,MATH 103A,B01,083779,Greenfeld; Be'Eri,0,16,30,30
1651125002183,MATH 103A,B02,083780,Greenfeld; Be'Eri,0,15,30,30
1651125008207,MATH 105,A01,085443,Staff,0,24,30,30
1651125014234,MATH 109,A01,083213,Ganzberger; Geoffrey Michael,0,8,30,30
1651125014234,MATH 109,A02,083214,Ganzberger; Geoffrey Michael,0,7,30,30
1651125014234,MATH 109,B01,083215,Ganzberger; Geoffrey Michael,0,8,30,30
1651125014234,MATH 109,B02,083216,Ganzberger; Geoffrey Michael,0,7,30,30
1651125020265,MATH 142A,A01,083219,Chow; Bennett,0,15,30,30
1651125020265,MATH 142A,A02,083220,Chow; Bennett,0,15,30,30
1651125020265,MATH 142A,B01,083221,Chow; Bennett,0,16,30,30
1651125020265,MATH 142A,B02,083222,Chow; Bennett,0,15,30,30
1651125026292,MATH 193A,A01,083224,Staff,0,9,30,30
1651125026292,MATH 193A,A02,083225,Staff,0,6,30,30
1651125026292,MATH 193A,A03,083781,Staff,0,7,30,30
1651125026292,MATH 193A,A04,083782,Staff,0,7,30,30
1651125032315,MATH 197,001,091859,McAuley; Julian John,9998,0,9999,1
1651125038364,COGS 9,A01,083615,Staff,0,20,60,60
1651125044390,COGS 11,A01,083617,Boyle; Mary E. T.,13,0,40,27
1651125050420,COGS 13,A01,083071,Staff,0,39,40,40
1651125056445,COGS 14A,A01,092681,Staff,0,41,100,100
1651125062470,COGS 14B,A01,083073,Cheng; Tzu-Han,0,11,50,50
1651125068495,COGS 17,A01,092677,Staff,8,0,75,67
1651125074521,COGS 100,A01,083619,Staff,0,29,60,61
1651125080547,COGS 101A,A01,083621,Davis; Joshua Daniel,0,29,60,60
1651125086570,COGS 101B,A01,091572,Staff,0,8,60,60
1651125092592,COGS 101C,A01,083625,Delgado; Tania,12,0,30,18
1651125098616,COGS 107A,A01,083627,Boyle; Mary E. T.,0,17,60,60
1651125104639,COGS 118A,A01,083075,Staff,0,10,60,60
1651125110663,CSE 3,A50,083646,Miranda; Gregory Joseph,15,0,38,23
1651125110663,CSE 3,A51,083647,Miranda; Gregory Joseph,36,0,37,1
1651125116691,CSE 8A,A50,083650,Miranda; Gregory Joseph,0,30,40,40
1651125122720,CSE 11,A01,083080,Cao; Yingjun,0,98,40,40
1651125128744,CSE 12,A01,083652,Staff,0,30,100,100
1651125134768,CSE 15L,A01,083654,Staff,0,4,50,50
1651125134768,CSE 15L,A02,083655,Staff,0,3,50,50
1651125140790,CSE 20,A01,083657,Staff,47,0,80,33
1651125146815,CSE 30,A01,083084,Eldon; John,0,39,80,80
1651125152839,CSE 100,A01,083659,Cao; Yingjun,0,72,50,50
1651125158866,CSE 134B,A01,083661,Powell; Thomas Allan,0,38,65,65
1651125164892,CSE 140,A01,083663,Staff,0,17,75,75
1651125170916,CSE 140L,A01,083088,Eldon; John,1,0,100,99
1651125176944,CSE 175,A01,083665,Kumar; Rakesh,0,0,25,25
1651125182971,CSE 190,A00,092507,Dubnov; Shlomo,9,0,20,11
1651125188999,ECE 45,A01,083139,Staff,0,8,60,60
1651125195022,ECE 65,A50,083695,Staff,0,7,30,30
1651125201047,ECE 109,A01,091882,Touri; Behrouz,32,0,70,38
1651125207072,ECE 180,A00,083140,Abi Samra; Nicholas Camill,17,0,30,13
1651125207072,ECE 180,B00,083141,Abi Samra; Nicholas Camill,0,1,30,32
1651125213096,MATH 10A,A01,083735,Patchell; Gregory David,0,0,30,30
1651125213096,MATH 10A,A02,083736,Patchell; Gregory David,26,0,30,4
1651125213096,MATH 10A,A03,083737,Patchell; Gregory David,22,0,30,8
1651125219125,MATH 10B,A01,083207,Staff,0,8,30,30
1651125219125,MATH 10B,A02,083208,Staff,0,7,30,30
1651125219125,MATH 10B,B01,083739,Staff,7,0,30,23
1651125219125,MATH 10B,B02,083740,Staff,28,0,30,2
1651125225154,MATH 18,A01,083743,Staff,0,0,30,30
1651125225154,MATH 18,A02,083744,Staff,23,0,30,7
1651125225154,MATH 18,A03,083745,Staff,19,0,30,11
1651125225154,MATH 18,A04,083746,Staff,26,0,30,4
1651125225154,MATH 18,B01,083748,Staff,0,16,30,30
1651125225154,MATH 18,B02,083749,Staff,0,15,30,30
1651125225154,MATH 18,B03,083750,Staff,0,15,30,30
1651125225154,MATH 18,B04,083751,Staff,0,15,30,30
1651125231179,MATH 20A,A01,083754,Staff,18,0,40,22
1651125237204,MATH 20B,A01,083756,Briones; Jor-el Thomas Caparas,0,14,30,30
1651125237204,MATH 20B,A02,083757,Briones; Jor-el Thomas Caparas,0,11,30,30
1651125243232,MATH 20C,A01,083760,Briones; Jor-el Thomas Caparas,0,16,30,30
1651125243232,MATH 20C,A02,083761,Briones; Jor-el Thomas Caparas,0,17,30,30
1651125243232,MATH 20C,B01,083762,Staff,6,0,30,24
1651125243232,MATH 20C,B02,083763,Staff,28,0,30,2
1651125249258,MATH 20D,A01,083765,Tran; Brian Kha,4,1,30,26
1651125249258,MATH 20D,A02,083766,Tran; Brian Kha,0,0,30,30
1651125249258,MATH 20D,A03,083767,Tran; Brian Kha,21,0,30,9
1651125255281,MATH 20E,A01,083771,Staff,0,0,30,30
1651125255281,MATH 20E,A02,083772,Staff,9,0,30,21
1651125255281,MATH 20E,B01,083773,Staff,5,0,35,30
1651125255281,MATH 20E,B02,083774,Staff,4,0,35,31
1651125261309,MATH 103A,A01,083777,Greenfeld; Be'Eri,0,17,30,30
1651125261309,MATH 103A,A02,083778,Greenfeld; Be'Eri,0,17,30,30
1651125261309,MATH 103A,B01,083779,Greenfeld; Be'Eri,0,16,30,30
1651125261309,MATH 103A,B02,083780,Greenfeld; Be'Eri,0,15,30,30
1651125267332,MATH 105,A01,085443,Staff,0,24,30,30
1651125273363,MATH 109,A01,083213,Ganzberger; Geoffrey Michael,0,8,30,30
1651125273363,MATH 109,A02,083214,Ganzberger; Geoffrey Michael,0,7,30,30
1651125273363,MATH 109,B01,083215,Ganzberger; Geoffrey Michael,0,8,30,30
1651125273363,MATH 109,B02,083216,Ganzberger; Geoffrey Michael,0,7,30,30
1651125279390,MATH 142A,A01,083219,Chow; Bennett,0,15,30,30
1651125279390,MATH 142A,A02,083220,Chow; Bennett,0,15,30,30
1651125279390,MATH 142A,B01,083221,Chow; Bennett,0,16,30,30
1651125279390,MATH 142A,B02,083222,Chow; Bennett,0,15,30,30
1651125285414,MATH 193A,A01,083224,Staff,0,9,30,30
1651125285414,MATH 193A,A02,083225,Staff,0,6,30,30
1651125285414,MATH 193A,A03,083781,Staff,0,7,30,30
1651125285414,MATH 193A,A04,083782,Staff,0,7,30,30
1651125291443,MATH 197,001,091859,McAuley; Julian John,9998,0,9999,1
1651125297497,COGS 9,A01,083615,Staff,0,20,60,60
1651125303521,COGS 11,A01,083617,Boyle; Mary E. T.,13,0,40,27
1651125309547,COGS 13,A01,083071,Staff,0,39,40,40
1651125315570,COGS 14A,A01,092681,Staff,0,41,100,100
1651125321610,COGS 14B,A01,083073,Cheng; Tzu-Han,0,11,50,50
1651125327641,COGS 17,A01,092677,Staff,8,0,75,67
1651125333663,COGS 100,A01,083619,Staff,0,29,60,61
1651125339688,COGS 101A,A01,083621,Davis; Joshua Daniel,0,29,60,60
1651125345709,COGS 101B,A01,091572,Staff,0,8,60,60
1651125351731,COGS 101C,A01,083625,Delgado; Tania,12,0,30,18
1651125357755,COGS 107A,A01,083627,Boyle; Mary E. T.,0,17,60,60
1651125363785,COGS 118A,A01,083075,Staff,0,10,60,60
1651125369810,CSE 3,A50,083646,Miranda; Gregory Joseph,15,0,38,23
1651125369810,CSE 3,A51,083647,Miranda; Gregory Joseph,36,0,37,1
1651125375837,CSE 8A,A50,083650,Miranda; Gregory Joseph,0,30,40,40
1651125381861,CSE 11,A01,083080,Cao; Yingjun,0,98,40,40
1651125387888,CSE 12,A01,083652,Staff,0,30,100,100
1651125393914,CSE 15L,A01,083654,Staff,0,4,50,50
1651125393914,CSE 15L,A02,083655,Staff,0,3,50,50
1651125399948,CSE 20,A01,083657,Staff,47,0,80,33
1651125405971,CSE 30,A01,083084,Eldon; John,0,39,80,80
1651125411996,CSE 100,A01,083659,Cao; Yingjun,0,72,50,50
1651125418022,CSE 134B,A01,083661,Powell; Thomas Allan,0,38,65,65
1651125424045,CSE 140,A01,083663,Staff,0,17,75,75
1651125430073,CSE 140L,A01,083088,Eldon; John,1,0,100,99
1651125436099,CSE 175,A01,083665,Kumar; Rakesh,0,0,25,25
1651125442130,CSE 190,A00,092507,Dubnov; Shlomo,9,0,20,11
1651125448152,ECE 45,A01,083139,Staff,0,8,60,60
1651125454176,ECE 65,A50,083695,Staff,0,7,30,30
1651125460206,ECE 109,A01,091882,Touri; Behrouz,32,0,70,38
1651125466230,ECE 180,A00,083140,Abi Samra; Nicholas Camill,17,0,30,13
1651125466230,ECE 180,B00,083141,Abi Samra; Nicholas Camill,0,1,30,32
1651125472257,MATH 10A,A01,083735,Patchell; Gregory David,0,0,30,30
1651125472257,MATH 10A,A02,083736,Patchell; Gregory David,26,0,30,4
1651125472257,MATH 10A,A03,083737,Patchell; Gregory David,22,0,30,8
1651125478284,MATH 10B,A01,083207,Staff,0,8,30,30
1651125478284,MATH 10B,A02,083208,Staff,0,7,30,30
1651125478284,MATH 10B,B01,083739,Staff,7,0,30,23
1651125478284,MATH 10B,B02,083740,Staff,28,0,30,2
1651125484307,MATH 18,A01,083743,Staff,0,0,30,30
1651125484307,MATH 18,A02,083744,Staff,23,0,30,7
1651125484307,MATH 18,A03,083745,Staff,19,0,30,11
1651125484307,MATH 18,A04,083746,Staff,26,0,30,4
1651125484307,MATH 18,B01,083748,Staff,0,16,30,30
1651125484307,MATH 18,B02,083749,Staff,0,15,30,30
1651125484307,MATH 18,B03,083750,Staff,0,15,30,30
1651125484307,MATH 18,B04,083751,Staff,0,15,30,30
1651125490332,MATH 20A,A01,083754,Staff,18,0,40,22
1651125496354,MATH 20B,A01,083756,Briones; Jor-el Thomas Caparas,0,14,30,30
1651125496354,MATH 20B,A02,083757,Briones; Jor-el Thomas Caparas,0,11,30,30
1651125502376,MATH 20C,A01,083760,Briones; Jor-el Thomas Caparas,0,16,30,30
1651125502376,MATH 20C,A02,083761,Briones; Jor-el Thomas Caparas,0,17,30,30
1651125502376,MATH 20C,B01,083762,Staff,6,0,30,24
1651125502376,MATH 20C,B02,083763,Staff,28,0,30,2
1651125508403,MATH 20D,A01,083765,Tran; Brian Kha,4,1,30,26
1651125508403,MATH 20D,A02,083766,Tran; Brian Kha,0,0,30,30
1651125508403,MATH 20D,A03,083767,Tran; Brian Kha,21,0,30,9
1651125514429,MATH 20E,A01,083771,Staff,0,0,30,30
1651125514429,MATH 20E,A02,083772,Staff,9,0,30,21
1651125514429,MATH 20E,B01,083773,Staff,5,0,35,30
1651125514429,MATH 20E,B02,083774,Staff,4,0,35,31
1651125520466,MATH 103A,A01,083777,Greenfeld; Be'Eri,0,17,30,30
1651125520466,MATH 103A,A02,083778,Greenfeld; Be'Eri,0,17,30,30
1651125520466,MATH 103A,B01,083779,Greenfeld; Be'Eri,0,16,30,30
1651125520466,MATH 103A,B02,083780,Greenfeld; Be'Eri,0,15,30,30
1651125526491,MATH 105,A01,085443,Staff,0,24,30,30
1651125532514,MATH 109,A01,083213,Ganzberger; Geoffrey Michael,0,8,30,30
1651125532514,MATH 109,A02,083214,Ganzberger; Geoffrey Michael,0,7,30,30
1651125532514,MATH 109,B01,083215,Ganzberger; Geoffrey Michael,0,8,30,30
1651125532514,MATH 109,B02,083216,Ganzberger; Geoffrey Michael,0,7,30,30
1651125538548,MATH 142A,A01,083219,Chow; Bennett,0,15,30,30
1651125538548,MATH 142A,A02,083220,Chow; Bennett,0,15,30,30
1651125538548,MATH 142A,B01,083221,Chow; Bennett,0,16,30,30
1651125538548,MATH 142A,B02,083222,Chow; Bennett,0,15,30,30
1651125544571,MATH 193A,A01,083224,Staff,0,9,30,30
1651125544571,MATH 193A,A02,083225,Staff,0,6,30,30
1651125544571,MATH 193A,A03,083781,Staff,0,7,30,30
1651125544571,MATH 193A,A04,083782,Staff,0,7,30,30
1651125550596,MATH 197,001,091859,McAuley; Julian John,9998,0,9999,1
1651125556724,COGS 9,A01,083615,Staff,0,20,60,60
1651125562751,COGS 11,A01,083617,Boyle; Mary E. T.,13,0,40,27
1651125568778,COGS 13,A01,083071,Staff,0,39,40,40
1651125574801,COGS 14A,A01,092681,Staff,0,41,100,100
1651125580829,COGS 14B,A01,083073,Cheng; Tzu-Han,0,11,50,50
1651125586850,COGS 17,A01,092677,Staff,8,0,75,67
1651125592876,COGS 100,A01,083619,Staff,0,29,60,61
1651125598903,COGS 101A,A01,083621,Davis; Joshua Daniel,0,29,60,60
1651125604929,COGS 101B,A01,091572,Staff,0,8,60,60
1651125610961,COGS 101C,A01,083625,Delgado; Tania,12,0,30,18
1651125616987,COGS 107A,A01,083627,Boyle; Mary E. T.,0,17,60,60
1651125623009,COGS 118A,A01,083075,Staff,0,10,60,60
1651125629039,CSE 3,A50,083646,Miranda; Gregory Joseph,15,0,38,23
1651125629039,CSE 3,A51,083647,Miranda; Gregory Joseph,36,0,37,1
1651125635068,CSE 8A,A50,083650,Miranda; Gregory Joseph,0,30,40,40
1651125641092,CSE 11,A01,083080,Cao; Yingjun,0,98,40,40
1651125647129,CSE 12,A01,083652,Staff,0,30,100,100
1651125653158,CSE 15L,A01,083654,Staff,0,4,50,50
1651125653158,CSE 15L,A02,083655,Staff,0,3,50,50
1651125659183,CSE 20,A01,083657,Staff,47,0,80,33
1651125665213,CSE 30,A01,083084,Eldon; John,0,39,80,80
1651125671241,CSE 100,A01,083659,Cao; Yingjun,0,72,50,50
1651125677263,CSE 134B,A01,083661,Powell; Thomas Allan,0,38,65,65
1651125683293,CSE 140,A01,083663,Staff,0,17,75,75
1651125689317,CSE 140L,A01,083088,Eldon; John,1,0,100,99
1651125695342,CSE 175,A01,083665,Kumar; Rakesh,0,0,25,25
1651125701366,CSE 190,A00,092507,Dubnov; Shlomo,9,0,20,11
1651125707388,ECE 45,A01,083139,Staff,0,8,60,60
1651125713413,ECE 65,A50,083695,Staff,0,7,30,30
1651125719437,ECE 109,A01,091882,Touri; Behrouz,32,0,70,38
1651125725462,ECE 180,A00,083140,Abi Samra; Nicholas Camill,17,0,30,13
1651125725462,ECE 180,B00,083141,Abi Samra; Nicholas Camill,0,1,30,32
1651125731490,MATH 10A,A01,083735,Patchell; Gregory David,0,0,30,30
1651125731490,MATH 10A,A02,083736,Patchell; Gregory David,26,0,30,4
1651125731490,MATH 10A,A03,083737,Patchell; Gregory David,22,0,30,8
1651125737514,MATH 10B,A01,083207,Staff,0,8,30,30
1651125737514,MATH 10B,A02,083208,Staff,0,7,30,30
1651125737514,MATH 10B,B01,083739,Staff,7,0,30,23
1651125737514,MATH 10B,B02,083740,Staff,28,0,30,2
1651125743539,MATH 18,A01,083743,Staff,0,0,30,30
1651125743539,MATH 18,A02,083744,Staff,23,0,30,7
1651125743539,MATH 18,A03,083745,Staff,19,0,30,11
1651125743539,MATH 18,A04,083746,Staff,26,0,30,4
1651125743539,MATH 18,B01,083748,Staff,0,16,30,30
1651125743539,MATH 18,B02,083749,Staff,0,15,30,30
1651125743539,MATH 18,B03,083750,Staff,0,15,30,30
1651125743539,MATH 18,B04,083751,Staff,0,15,30,30
1651125749562,MATH 20A,A01,083754,Staff,18,0,40,22
1651125755585,MATH 20B,A01,083756,Briones; Jor-el Thomas Caparas,0,14,30,30
1651125755585,MATH 20B,A02,083757,Briones; Jor-el Thomas Caparas,0,11,30,30
1651125761608,MATH 20C,A01,083760,Briones; Jor-el Thomas Caparas,0,16,30,30
1651125761608,MATH 20C,A02,083761,Briones; Jor-el Thomas Caparas,0,17,30,30
1651125761608,MATH 20C,B01,083762,Staff,6,0,30,24
1651125761608,MATH 20C,B02,083763,Staff,28,0,30,2
1651125767635,MATH 20D,A01,083765,Tran; Brian Kha,4,1,30,26
1651125767635,MATH 20D,A02,083766,Tran; Brian Kha,0,0,30,30
1651125767635,MATH 20D,A03,083767,Tran; Brian Kha,21,0,30,9
1651125773661,MATH 20E,A01,083771,Staff,0,0,30,30
1651125773661,MATH 20E,A02,083772,Staff,9,0,30,21
1651125773661,MATH 20E,B01,083773,Staff,5,0,35,30
1651125773661,MATH 20E,B02,083774,Staff,4,0,35,31
1651125779693,MATH 103A,A01,083777,Greenfeld; Be'Eri,0,17,30,30
1651125779693,MATH 103A,A02,083778,Greenfeld; Be'Eri,0,17,30,30
1651125779693,MATH 103A,B01,083779,Greenfeld; Be'Eri,0,16,30,30
1651125779693,MATH 103A,B02,083780,Greenfeld; Be'Eri,0,15,30,30
1651125785731,MATH 105,A01,085443,Staff,0,24,30,30
1651125791762,MATH 109,A01,083213,Ganzberger; Geoffrey Michael,0,8,30,30
1651125791762,MATH 109,A02,083214,Ganzberger; Geoffrey Michael,0,7,30,30
1651125791762,MATH 109,B01,083215,Ganzberger; Geoffrey Michael,0,8,30,30
1651125791762,MATH 109,B02,083216,Ganzberger; Geoffrey Michael,0,7,30,30
1651125797797,MATH 142A,A01,083219,Chow; Bennett,0,15,30,30
1651125797797,MATH 142A,A02,083220,Chow; Bennett,0,15,30,30
1651125797797,MATH 142A,B01,083221,Chow; Bennett,0,16,30,30
1651125797797,MATH 142A,B02,083222,Chow; Bennett,0,15,30,30
1651125803820,MATH 193A,A01,083224,Staff,0,9,30,30
1651125803820,MATH 193A,A02,083225,Staff,0,6,30,30
1651125803820,MATH 193A,A03,083781,Staff,0,7,30,30
1651125803820,MATH 193A,A04,083782,Staff,0,7,30,30
1651125809845,MATH 197,001,091859,McAuley; Julian John,9998,0,9999,1
1651125815930,COGS 9,A01,083615,Staff,0,20,60,60
1651125821956,COGS 11,A01,083617,Boyle; Mary E. T.,13,0,40,27
1651125827991,COGS 13,A01,083071,Staff,0,39,40,40
1651125834021,COGS 14A,A01,092681,Staff,0,41,100,100
1651125840048,COGS 14B,A01,083073,Cheng; Tzu-Han,0,11,50,50
1651125846076,COGS 17,A01,092677,Staff,8,0,75,67
1651125852109,COGS 100,A01,083619,Staff,0,29,60,61
1651125858153,COGS 101A,A01,083621,Davis; Joshua Daniel,0,29,60,60
1651125864187,COGS 101B,A01,091572,Staff,0,8,60,60
1651125870219,COGS 101C,A01,083625,Delgado; Tania,12,0,30,18
1651125876253,COGS 107A,A01,083627,Boyle; Mary E. T.,0,17,60,60
1651125882290,COGS 118A,A01,083075,Staff,0,10,60,60
1651125888337,CSE 3,A50,083646,Miranda; Gregory Joseph,15,0,38,23
1651125888337,CSE 3,A51,083647,Miranda; Gregory Joseph,36,0,37,1
1651125894361,CSE 8A,A50,083650,Miranda; Gregory Joseph,0,30,40,40
1651125900392,CSE 11,A01,083080,Cao; Yingjun,0,98,40,40
1651125906414,CSE 12,A01,083652,Staff,0,30,100,100
1651125912442,CSE 15L,A01,083654,Staff,0,4,50,50
1651125912442,CSE 15L,A02,083655,Staff,0,3,50,50
1651125918469,CSE 20,A01,083657,Staff,47,0,80,33
1651125924492,CSE 30,A01,083084,Eldon; John,0,39,80,80
1651125930520,CSE 100,A01,083659,Cao; Yingjun,0,72,50,50
1651125936545,CSE 134B,A01,083661,Powell; Thomas Allan,0,38,65,65
1651125942577,CSE 140,A01,083663,Staff,0,17,75,75
1651125948602,CSE 140L,A01,083088,Eldon; John,1,0,100,99
1651125954626,CSE 175,A01,083665,Kumar; Rakesh,0,0,25,25
1651125960648,CSE 190,A00,092507,Dubnov; Shlomo,9,0,20,11
1651125966670,ECE 45,A01,083139,Staff,0,8,60,60
1651125972695,ECE 65,A50,083695,Staff,0,7,30,30
1651125978722,ECE 109,A01,091882,Touri; Behrouz,32,0,70,38
1651125984745,ECE 180,A00,083140,Abi Samra; Nicholas Camill,17,0,30,13
1651125984745,ECE 180,B00,083141,Abi Samra; Nicholas Camill,0,1,30,32
1651125990768,MATH 10A,A01,083735,Patchell; Gregory David,0,0,30,30
1651125990768,MATH 10A,A02,083736,Patchell; Gregory David,26,0,30,4
1651125990768,MATH 10A,A03,083737,Patchell; Gregory David,22,0,30,8
1651125996792,MATH 10B,A01,083207,Staff,0,8,30,30
1651125996792,MATH 10B,A02,083208,Staff,0,7,30,30
1651125996792,MATH 10B,B01,083739,Staff,7,0,30,23
1651125996792,MATH 10B,B02,083740,Staff,28,0,30,2
1651126002826,MATH 18,A01,083743,Staff,0,0,30,30
1651126002826,MATH 18,A02,083744,Staff,23,0,30,7
1651126002826,MATH 18,A03,083745,Staff,19,0,30,11
1651126002826,MATH 18,A04,083746,Staff,26,0,30,4
1651126002826,MATH 18,B01,083748,Staff,0,16,30,30
1651126002826,MATH 18,B02,083749,Staff,0,15,30,30
1651126002826,MATH 18,B03,083750,Staff,0,15,30,30
1651126002826,MATH 18,B04,083751,Staff,0,15,30,30
1651126008851,MATH 20A,A01,083754,Staff,18,0,40,22
1651126014876,MATH 20B,A01,083756,Briones; Jor-el Thomas Caparas,0,14,30,30
1651126014876,MATH 20B,A02,083757,Briones; Jor-el Thomas Caparas,0,11,30,30
1651126020897,MATH 20C,A01,083760,Briones; Jor-el Thomas Caparas,0,16,30,30
1651126020897,MATH 20C,A02,083761,Briones; Jor-el Thomas Caparas,0,17,30,30
1651126020897,MATH 20C,B01,083762,Staff,6,0,30,24
1651126020897,MATH 20C,B02,083763,Staff,28,0,30,2
1651126026920,MATH 20D,A01,083765,Tran; Brian Kha,4,1,30,26
1651126026920,MATH 20D,A02,083766,Tran; Brian Kha,0,0,30,30
1651126026920,MATH 20D,A03,083767,Tran; Brian Kha,21,0,30,9
1651126032949,MATH 20E,A01,083771,Staff,0,0,30,30
1651126032949,MATH 20E,A02,083772,Staff,9,0,30,21
1651126032949,MATH 20E,B01,083773,Staff,5,0,35,30
1651126032949,MATH 20E,B02,083774,Staff,4,0,35,31
1651126038980,MATH 103A,A01,083777,Greenfeld; Be'Eri,0,17,30,30
1651126038980,MATH 103A,A02,083778,Greenfeld; Be'Eri,0,17,30,30
1651126038980,MATH 103A,B01,083779,Greenfeld; Be'Eri,0,16,30,30
1651126038980,MATH 103A,B02,083780,Greenfeld; Be'Eri,0,15,30,30
1651126045007,MATH 105,A01,085443,Staff,0,24,30,30
1651126051038,MATH 109,A01,083213,Ganzberger; Geoffrey Michael,0,8,30,30
1651126051038,MATH 109,A02,083214,Ganzberger; Geoffrey Michael,0,7,30,30
1651126051038,MATH 109,B01,083215,Ganzberger; Geoffrey Michael,0,8,30,30
1651126051038,MATH 109,B02,083216,Ganzberger; Geoffrey Michael,0,7,30,30
1651126057061,MATH 142A,A01,083219,Chow; Bennett,0,15,30,30
1651126057061,MATH 142A,A02,083220,Chow; Bennett,0,15,30,30
1651126057061,MATH 142A,B01,083221,Chow; Bennett,0,16,30,30
1651126057061,MATH 142A,B02,083222,Chow; Bennett,0,15,30,30
1651126063085,MATH 193A,A01,083224,Staff,0,9,30,30
1651126063085,MATH 193A,A02,083225,Staff,0,6,30,30
1651126063085,MATH 193A,A03,083781,Staff,0,7,30,30
1651126063085,MATH 193A,A04,083782,Staff,0,7,30,30
1651126069110,MATH 197,001,091859,McAuley; Julian John,9998,0,9999,1
1651126075168,COGS 9,A01,083615,Staff,0,20,60,60
1651126081193,COGS 11,A01,083617,Boyle; Mary E. T.,13,0,40,27
1651126087225,COGS 13,A01,083071,Staff,0,39,40,40
1651126093248,COGS 14A,A01,092681,Staff,0,41,100,100
1651126099275,COGS 14B,A01,083073,Cheng; Tzu-Han,0,11,50,50
1651126105302,COGS 17,A01,092677,Staff,8,0,75,67
1651126111324,COGS 100,A01,083619,Staff,0,29,60,61
1651126117346,COGS 101A,A01,083621,Davis; Joshua Daniel,0,29,60,60
1651126123369,COGS 101B,A01,091572,Staff,0,8,60,60
1651126129392,COGS 101C,A01,083625,Delgado; Tania,12,0,30,18
1651126135415,COGS 107A,A01,083627,Boyle; Mary E. T.,0,17,60,60
1651126141443,COGS 118A,A01,083075,Staff,0,10,60,60
1651126147570,CSE 3,A50,083646,Miranda; Gregory Joseph,15,0,38,23
1651126147570,CSE 3,A51,083647,Miranda; Gregory Joseph,36,0,37,1
1651126153594,CSE 8A,A50,083650,Miranda; Gregory Joseph,0,30,40,40
1651126159631,CSE 11,A01,083080,Cao; Yingjun,0,98,40,40
1651126165659,CSE 12,A01,083652,Staff,0,30,100,100
1651126171686,CSE 15L,A01,083654,Staff,0,4,50,50
1651126171686,CSE 15L,A02,083655,Staff,0,3,50,50
1651126177708,CSE 20,A01,083657,Staff,47,0,80,33
1651126183732,CSE 30,A01,083084,Eldon; John,0,39,80,80
1651126189754,CSE 100,A01,083659,Cao; Yingjun,0,72,50,50
1651126195777,CSE 134B,A01,083661,Powell; Thomas Allan,0,38,65,65
1651126201805,CSE 140,A01,083663,Staff,0,17,75,75
1651126207831,CSE 140L,A01,083088,Eldon; John,1,0,100,99
1651126213856,CSE 175,A01,083665,Kumar; Rakesh,0,0,25,25
1651126219879,CSE 190,A00,092507,Dubnov; Shlomo,9,0,20,11
1651126225915,ECE 45,A01,083139,Staff,0,8,60,60
1651126231936,ECE 65,A50,083695,Staff,0,7,30,30
1651126237963,ECE 109,A01,091882,Touri; Behrouz,32,0,70,38
1651126243986,ECE 180,A00,083140,Abi Samra; Nicholas Camill,17,0,30,13
1651126243986,ECE 180,B00,083141,Abi Samra; Nicholas Camill,0,1,30,32
1651126250008,MATH 10A,A01,083735,Patchell; Gregory David,0,0,30,30
1651126250008,MATH 10A,A02,083736,Patchell; Gregory David,26,0,30,4
1651126250008,MATH 10A,A03,083737,Patchell; Gregory David,22,0,30,8
1651126256030,MATH 10B,A01,083207,Staff,0,8,30,30
1651126256030,MATH 10B,A02,083208,Staff,0,7,30,30
1651126256030,MATH 10B,B01,083739,Staff,7,0,30,23
1651126256030,MATH 10B,B02,083740,Staff,28,0,30,2
1651126262055,MATH 18,A01,083743,Staff,0,0,30,30
1651126262055,MATH 18,A02,083744,Staff,23,0,30,7
1651126262055,MATH 18,A03,083745,Staff,19,0,30,11
1651126262055,MATH 18,A04,083746,Staff,26,0,30,4
1651126262055,MATH 18,B01,083748,Staff,0,16,30,30
1651126262055,MATH 18,B02,083749,Staff,0,15,30,30
1651126262055,MATH 18,B03,083750,Staff,0,15,30,30
1651126262055,MATH 18,B04,083751,Staff,0,15,30,30
1651126268080,MATH 20A,A01,083754,Staff,18,0,40,22
1651126274108,MATH 20B,A01,083756,Briones; Jor-el Thomas Caparas,0,14,30,30
1651126274108,MATH 20B,A02,083757,Briones; Jor-el Thomas Caparas,0,11,30,30
1651126280134,MATH 20C,A01,083760,Briones; Jor-el Thomas Caparas,0,16,30,30
1651126280134,MATH 20C,A02,083761,Briones; Jor-el Thomas Caparas,0,17,30,30
1651126280134,MATH 20C,B01,083762,Staff,6,0,30,24
1651126280134,MATH 20C,B02,083763,Staff,28,0,30,2
1651126286164,MATH 20D,A01,083765,Tran; Brian Kha,4,1,30,26
1651126286164,MATH 20D,A02,083766,Tran; Brian Kha,0,0,30,30
1651126286164,MATH 20D,A03,083767,Tran; Brian Kha,21,0,30,9
1651126292192,MATH 20E,A01,083771,Staff,0,0,30,30
1651126292192,MATH 20E,A02,083772,Staff,9,0,30,21
1651126292192,MATH 20E,B01,083773,Staff,5,0,35,30
1651126292192,MATH 20E,B02,083774,Staff,4,0,35,31
1651126298214,MATH 103A,A01,083777,Greenfeld; Be'Eri,0,17,30,30
1651126298214,MATH 103A,A02,083778,Greenfeld; Be'Eri,0,17,30,30
1651126298214,MATH 103A,B01,083779,Greenfeld; Be'Eri,0,16,30,30
1651126298214,MATH 103A,B02,083780,Greenfeld; Be'Eri,0,15,30,30
1651126304249,MATH 105,A01,085443,Staff,0,24,30,30
1651126310272,MATH 109,A01,083213,Ganzberger; Geoffrey Michael,0,8,30,30
1651126310272,MATH 109,A02,083214,Ganzberger; Geoffrey Michael,0,7,30,30
1651126310272,MATH 109,B01,083215,Ganzberger; Geoffrey Michael,0,8,30,30
1651126310272,MATH 109,B02,083216,Ganzberger; Geoffrey Michael,0,7,30,30
1651126316294,MATH 142A,A01,083219,Chow; Bennett,0,15,30,30
1651126316294,MATH 142A,A02,083220,Chow; Bennett,0,15,30,30
1651126316294,MATH 142A,B01,083221,Chow; Bennett,0,16,30,30
1651126316294,MATH 142A,B02,083222,Chow; Bennett,0,15,30,30
1651126322317,MATH 193A,A01,083224,Staff,0,9,30,30
1651126322317,MATH 193A,A02,083225,Staff,0,6,30,30
1651126322317,MATH 193A,A03,083781,Staff,0,7,30,30
1651126322317,MATH 193A,A04,083782,Staff,0,7,30,30
1651126328339,MATH 197,001,091859,McAuley; Julian John,9998,0,9999,1
1651126334393,COGS 9,A01,083615,Staff,0,20,60,60
1651126340428,COGS 11,A01,083617,Boyle; Mary E. T.,13,0,40,27
1651126346454,COGS 13,A01,083071,Staff,0,39,40,40
1651126352477,COGS 14A,A01,092681,Staff,0,41,100,100
1651126358501,COGS 14B,A01,083073,Cheng; Tzu-Han,0,11,50,50
1651126364523,COGS 17,A01,092677,Staff,8,0,75,67
1651126370547,COGS 100,A01,083619,Staff,0,29,60,61
1651126376573,COGS 101A,A01,083621,Davis; Joshua Daniel,0,29,60,60
1651126382602,COGS 101B,A01,091572,Staff,0,8,60,60
1651126388629,COGS 101C,A01,083625,Delgado; Tania,12,0,30,18
1651126394658,COGS 107A,A01,083627,Boyle; Mary E. T.,0,17,60,60
1651126400685,COGS 118A,A01,083075,Staff,0,10,60,60
1651126406716,CSE 3,A50,083646,Miranda; Gregory Joseph,15,0,38,23
1651126406716,CSE 3,A51,083647,Miranda; Gregory Joseph,36,0,37,1
1651126412743,CSE 8A,A50,083650,Miranda; Gregory Joseph,0,30,40,40
1651126418767,CSE 11,A01,083080,Cao; Yingjun,0,98,40,40
1651126424790,CSE 12,A01,083652,Staff,0,30,100,100
1651126430816,CSE 15L,A01,083654,Staff,0,4,50,50
1651126430816,CSE 15L,A02,083655,Staff,0,3,50,50
1651126436841,CSE 20,A01,083657,Staff,47,0,80,33
1651126442862,CSE 30,A01,083084,Eldon; John,0,39,80,80
1651126448885,CSE 100,A01,083659,Cao; Yingjun,0,72,50,50
1651126454909,CSE 134B,A01,083661,Powell; Thomas Allan,0,38,65,65
1651126460931,CSE 140,A01,083663,Staff,0,17,75,75
1651126466955,CSE 140L,A01,083088,Eldon; John,1,0,100,99
1651126472983,CSE 175,A01,083665,Kumar; Rakesh,0,0,25,25
1651126479006,CSE 190,A00,092507,Dubnov; Shlomo,9,0,20,11
1651126485032,ECE 45,A01,083139,Staff,0,8,60,60
1651126491069,ECE 65,A50,083695,Staff,0,7,30,30
1651126497095,ECE 109,A01,091882,Touri; Behrouz,32,0,70,38
1651126503123,ECE 180,A00,083140,Abi Samra; Nicholas Camill,17,0,30,13
1651126503123,ECE 180,B00,083141,Abi Samra; Nicholas Camill,0,1,30,32
1651126509147,MATH 10A,A01,083735,Patchell; Gregory David,0,0,30,30
1651126509147,MATH 10A,A02,083736,Patchell; Gregory David,26,0,30,4
1651126509147,MATH 10A,A03,083737,Patchell; Gregory David,22,0,30,8
1651126515176,MATH 10B,A01,083207,Staff,0,8,30,30
1651126515176,MATH 10B,A02,083208,Staff,0,7,30,30
1651126515176,MATH 10B,B01,083739,Staff,7,0,30,23
1651126515176,MATH 10B,B02,083740,Staff,28,0,30,2
1651126521199,MATH 18,A01,083743,Staff,0,0,30,30
1651126521199,MATH 18,A02,083744,Staff,23,0,30,7
1651126521199,MATH 18,A03,083745,Staff,19,0,30,11
1651126521199,MATH 18,A04,083746,Staff,26,0,30,4
1651126521199,MATH 18,B01,083748,Staff,0,16,30,30
1651126521199,MATH 18,B02,083749,Staff,0,15,30,30
1651126521199,MATH 18,B03,083750,Staff,0,15,30,30
1651126521199,MATH 18,B04,083751,Staff,0,15,30,30
1651126527222,MATH 20A,A01,083754,Staff,18,0,40,22
1651126533246,MATH 20B,A01,083756,Briones; Jor-el Thomas Caparas,0,14,30,30
1651126533246,MATH 20B,A02,083757,Briones; Jor-el Thomas Caparas,0,11,30,30
1651126539271,MATH 20C,A01,083760,Briones; Jor-el Thomas Caparas,0,16,30,30
1651126539271,MATH 20C,A02,083761,Briones; Jor-el Thomas Caparas,0,17,30,30
1651126539271,MATH 20C,B01,083762,Staff,6,0,30,24
1651126539271,MATH 20C,B02,083763,Staff,28,0,30,2
1651126545299,MATH 20D,A01,083765,Tran; Brian Kha,4,1,30,26
1651126545299,MATH 20D,A02,083766,Tran; Brian Kha,0,0,30,30
1651126545299,MATH 20D,A03,083767,Tran; Brian Kha,21,0,30,9
1651126551322,MATH 20E,A01,083771,Staff,0,0,30,30
1651126551322,MATH 20E,A02,083772,Staff,9,0,30,21
1651126551322,MATH 20E,B01,083773,Staff,5,0,35,30
1651126551322,MATH 20E,B02,083774,Staff,4,0,35,31
1651126557346,MATH 103A,A01,083777,Greenfeld; Be'Eri,0,17,30,30
1651126557346,MATH 103A,A02,083778,Greenfeld; Be'Eri,0,17,30,30
1651126557346,MATH 103A,B01,083779,Greenfeld; Be'Eri,0,16,30,30
1651126557346,MATH 103A,B02,083780,Greenfeld; Be'Eri,0,15,30,30
1651126563377,MATH 105,A01,085443,Staff,0,24,30,30
1651126569400,MATH 109,A01,083213,Ganzberger; Geoffrey Michael,0,8,30,30
1651126569400,MATH 109,A02,083214,Ganzberger; Geoffrey Michael,0,7,30,30
1651126569400,MATH 109,B01,083215,Ganzberger; Geoffrey Michael,0,8,30,30
1651126569400,MATH 109,B02,083216,Ganzberger; Geoffrey Michael,0,7,30,30
1651126575428,MATH 142A,A01,083219,Chow; Bennett,0,15,30,30
1651126575428,MATH 142A,A02,083220,Chow; Bennett,0,15,30,30
1651126575428,MATH 142A,B01,083221,Chow; Bennett,0,16,30,30
1651126575428,MATH 142A,B02,083222,Chow; Bennett,0,15,30,30
1651126581455,MATH 193A,A01,083224,Staff,0,9,30,30
1651126581455,MATH 193A,A02,083225,Staff,0,6,30,30
1651126581455,MATH 193A,A03,083781,Staff,0,7,30,30
1651126581455,MATH 193A,A04,083782,Staff,0,7,30,30
1651126587481,MATH 197,001,091859,McAuley; Julian John,9998,0,9999,1
1651126593539,COGS 9,A01,083615,Staff,0,20,60,60
1651126599564,COGS 11,A01,083617,Boyle; Mary E. T.,13,0,40,27
1651126605588,COGS 13,A01,083071,Staff,0,39,40,40
1651126611622,COGS 14A,A01,092681,Staff,0,41,100,100
1651126617645,COGS 14B,A01,083073,Cheng; Tzu-Han,0,11,50,50
1651126623668,COGS 17,A01,092677,Staff,8,0,75,67
1651126629701,COGS 100,A01,083619,Staff,0,29,60,61
1651126635724,COGS 101A,A01,083621,Davis; Joshua Daniel,0,29,60,60
1651126641750,COGS 101B,A01,091572,Staff,0,8,60,60
1651126647772,COGS 101C,A01,083625,Delgado; Tania,12,0,30,18
1651126653801,COGS 107A,A01,083627,Boyle; Mary E. T.,0,17,60,60
1651126659827,COGS 118A,A01,083075,Staff,0,10,60,60
1651126665858,CSE 3,A50,083646,Miranda; Gregory Joseph,15,0,38,23
1651126665858,CSE 3,A51,083647,Miranda; Gregory Joseph,36,0,37,1
1651126671880,CSE 8A,A50,083650,Miranda; Gregory Joseph,0,30,40,40
1651126677905,CSE 11,A01,083080,Cao; Yingjun,0,98,40,40
1651126683932,CSE 12,A01,083652,Staff,0,30,100,100
1651126689958,CSE 15L,A01,083654,Staff,0,4,50,50
1651126689958,CSE 15L,A02,083655,Staff,0,3,50,50
1651126695981,CSE 20,A01,083657,Staff,47,0,80,33
1651126702005,CSE 30,A01,083084,Eldon; John,0,39,80,80
1651126708028,CSE 100,A01,083659,Cao; Yingjun,0,72,50,50
1651126714056,CSE 134B,A01,083661,Powell; Thomas Allan,0,38,65,65
1651126720089,CSE 140,A01,083663,Staff,0,17,75,75
1651126726112,CSE 140L,A01,083088,Eldon; John,1,0,100,99
1651126732135,CSE 175,A01,083665,Kumar; Rakesh,0,0,25,25
1651126738158,CSE 190,A00,092507,Dubnov; Shlomo,9,0,20,11
1651126744258,ECE 45,A01,083139,Staff,0,8,60,60
1651126750284,ECE 65,A50,083695,Staff,0,7,30,30
1651126756308,ECE 109,A01,091882,Touri; Behrouz,32,0,70,38
1651126762333,ECE 180,A00,083140,Abi Samra; Nicholas Camill,17,0,30,13
1651126762333,ECE 180,B00,083141,Abi Samra; Nicholas Camill,0,1,30,32
1651126768360,MATH 10A,A01,083735,Patchell; Gregory David,0,0,30,30
1651126768360,MATH 10A,A02,083736,Patchell; Gregory David,26,0,30,4
1651126768360,MATH 10A,A03,083737,Patchell; Gregory David,22,0,30,8
1651126774384,MATH 10B,A01,083207,Staff,0,8,30,30
1651126774384,MATH 10B,A02,083208,Staff,0,7,30,30
1651126774384,MATH 10B,B01,083739,Staff,7,0,30,23
1651126774384,MATH 10B,B02,083740,Staff,28,0,30,2
1651126780415,MATH 18,A01,083743,Staff,0,0,30,30
1651126780415,MATH 18,A02,083744,Staff,23,0,30,7
1651126780415,MATH 18,A03,083745,Staff,19,0,30,11
1651126780415,MATH 18,A04,083746,Staff,26,0,30,4
1651126780415,MATH 18,B01,083748,Staff,0,16,30,30
1651126780415,MATH 18,B02,083749,Staff,0,15,30,30
1651126780415,MATH 18,B03,083750,Staff,0,15,30,30
1651126780415,MATH 18,B04,083751,Staff,0,15,30,30
1651126786441,MATH 20A,A01,083754,Staff,18,0,40,22
1651126792465,MATH 20B,A01,083756,Briones; Jor-el Thomas Caparas,0,14,30,30
1651126792465,MATH 20B,A02,083757,Briones; Jor-el Thomas Caparas,0,11,30,30
1651126798494,MATH 20C,A01,083760,Briones; Jor-el Thomas Caparas,0,16,30,30
1651126798494,MATH 20C,A02,083761,Briones; Jor-el Thomas Caparas,0,17,30,30
1651126798494,MATH 20C,B01,083762,Staff,6,0,30,24
1651126798494,MATH 20C,B02,083763,Staff,28,0,30,2
1651126804519,MATH 20D,A01,083765,Tran; Brian Kha,4,1,30,26
1651126804519,MATH 20D,A02,083766,Tran; Brian Kha,0,0,30,30
1651126804519,MATH 20D,A03,083767,Tran; Brian Kha,21,0,30,9
1651126810545,MATH 20E,A01,083771,Staff,0,0,30,30
1651126810545,MATH 20E,A02,083772,Staff,9,0,30,21
1651126810545,MATH 20E,B01,083773,Staff,5,0,35,30
1651126810545,MATH 20E,B02,083774,Staff,4,0,35,31
1651126816573,MATH 103A,A01,083777,Greenfeld; Be'Eri,0,17,30,30
1651126816573,MATH 103A,A02,083778,Greenfeld; Be'Eri,0,17,30,30
1651126816573,MATH 103A,B01,083779,Greenfeld; Be'Eri,0,16,30,30
1651126816573,MATH 103A,B02,083780,Greenfeld; Be'Eri,0,15,30,30
1651126822597,MATH 105,A01,085443,Staff,0,24,30,30
1651126828621,MATH 109,A01,083213,Ganzberger; Geoffrey Michael,0,8,30,30
1651126828621,MATH 109,A02,083214,Ganzberger; Geoffrey Michael,0,7,30,30
1651126828621,MATH 109,B01,083215,Ganzberger; Geoffrey Michael,0,8,30,30
1651126828621,MATH 109,B02,083216,Ganzberger; Geoffrey Michael,0,7,30,30
1651126834650,MATH 142A,A01,083219,Chow; Bennett,0,15,30,30
1651126834650,MATH 142A,A02,083220,Chow; Bennett,0,15,30,30
1651126834650,MATH 142A,B01,083221,Chow; Bennett,0,16,30,30
1651126834650,MATH 142A,B02,083222,Chow; Bennett,0,15,30,30
1651126840676,MATH 193A,A01,083224,Staff,0,9,30,30
1651126840676,MATH 193A,A02,083225,Staff,0,6,30,30
1651126840676,MATH 193A,A03,083781,Staff,0,7,30,30
1651126840676,MATH 193A,A04,083782,Staff,0,7,30,30
1651126846700,MATH 197,001,091859,McAuley; Julian John,9998,0,9999,1
1651126852784,COGS 9,A01,083615,Staff,0,20,60,60
1651126858811,COGS 11,A01,083617,Boyle; Mary E. T.,13,0,40,27
1651126864836,COGS 13,A01,083071,Staff,0,39,40,40
1651126870863,COGS 14A,A01,092681,Staff,0,41,100,100
1651126876886,COGS 14B,A01,083073,Cheng; Tzu-Han,0,11,50,50
1651126882910,COGS 17,A01,092677,Staff,8,0,75,67
1651126888934,COGS 100,A01,083619,Staff,0,29,60,61
1651126894958,COGS 101A,A01,083621,Davis; Joshua Daniel,0,29,60,60
1651126900984,COGS 101B,A01,091572,Staff,0,8,60,60
1651126907008,COGS 101C,A01,083625,Delgado; Tania,12,0,30,18
1651126913031,COGS 107A,A01,083627,Boyle; Mary E. T.,0,17,60,60
1651126919058,COGS 118A,A01,083075,Staff,0,10,60,60
1651126925079,CSE 3,A50,083646,Miranda; Gregory Joseph,15,0,38,23
1651126925079,CSE 3,A51,083647,Miranda; Gregory Joseph,36,0,37,1
1651126931107,CSE 8A,A50,083650,Miranda; Gregory Joseph,0,30,40,40
1651126937134,CSE 11,A01,083080,Cao; Yingjun,0,98,40,40
1651126943160,CSE 12,A01,083652,Staff,0,30,100,100
1651126949185,CSE 15L,A01,083654,Staff,0,4,50,50
1651126949185,CSE 15L,A02,083655,Staff,0,3,50,50
1651126955213,CSE 20,A01,083657,Staff,47,0,80,33
1651126961235,CSE 30,A01,083084,Eldon; John,0,39,80,80
1651126967260,CSE 100,A01,083659,Cao; Yingjun,0,72,50,50
1651126973283,CSE 134B,A01,083661,Powell; Thomas Allan,0,38,65,65
1651126979310,CSE 140,A01,083663,Staff,0,17,75,75
1651126985335,CSE 140L,A01,083088,Eldon; John,1,0,100,99
1651126991360,CSE 175,A01,083665,Kumar; Rakesh,0,0,25,25
1651126997382,CSE 190,A00,092507,Dubnov; Shlomo,9,0,20,11
1651127003406,ECE 45,A01,083139,Staff,0,8,60,60
1651127009429,ECE 65,A50,083695,Staff,0,7,30,30
1651127015452,ECE 109,A01,091882,Touri; Behrouz,32,0,70,38
1651127021477,ECE 180,A00,083140,Abi Samra; Nicholas Camill,17,0,30,13
1651127021477,ECE 180,B00,083141,Abi Samra; Nicholas Camill,0,1,30,32
1651127027502,MATH 10A,A01,083735,Patchell; Gregory David,0,0,30,30
1651127027502,MATH 10A,A02,083736,Patchell; Gregory David,26,0,30,4
1651127027502,MATH 10A,A03,083737,Patchell; Gregory David,22,0,30,8
1651127033524,MATH 10B,A01,083207,Staff,0,8,30,30
1651127033524,MATH 10B,A02,083208,Staff,0,7,30,30
1651127033524,MATH 10B,B01,083739,Staff,7,0,30,23
1651127033524,MATH 10B,B02,083740,Staff,28,0,30,2
1651127039554,MATH 18,A01,083743,Staff,0,0,30,30
1651127039554,MATH 18,A02,083744,Staff,23,0,30,7
1651127039554,MATH 18,A03,083745,Staff,19,0,30,11
1651127039554,MATH 18,A04,083746,Staff,26,0,30,4
1651127039554,MATH 18,B01,083748,Staff,0,16,30,30
1651127039554,MATH 18,B02,083749,Staff,0,15,30,30
1651127039554,MATH 18,B03,083750,Staff,0,15,30,30
1651127039554,MATH 18,B04,083751,Staff,0,15,30,30
1651127045577,MATH 20A,A01,083754,Staff,18,0,40,22
1651127051603,MATH 20B,A01,083756,Briones; Jor-el Thomas Caparas,0,14,30,30
1651127051603,MATH 20B,A02,083757,Briones; Jor-el Thomas Caparas,0,11,30,30
1651127057628,MATH 20C,A01,083760,Briones; Jor-el Thomas Caparas,0,16,30,30
1651127057628,MATH 20C,A02,083761,Briones; Jor-el Thomas Caparas,0,17,30,30
1651127057628,MATH 20C,B01,083762,Staff,6,0,30,24
1651127057628,MATH 20C,B02,083763,Staff,28,0,30,2
1651127063689,MATH 20D,A01,083765,Tran; Brian Kha,4,1,30,26
1651127063689,MATH 20D,A02,083766,Tran; Brian Kha,0,0,30,30
1651127063689,MATH 20D,A03,083767,Tran; Brian Kha,21,0,30,9
1651127069718,MATH 20E,A01,083771,Staff,0,0,30,30
1651127069718,MATH 20E,A02,083772,Staff,9,0,30,21
1651127069718,MATH 20E,B01,083773,Staff,5,0,35,30
1651127069718,MATH 20E,B02,083774,Staff,4,0,35,31
1651127075748,MATH 103A,A01,083777,Greenfeld; Be'Eri,0,17,30,30
1651127075748,MATH 103A,A02,083778,Greenfeld; Be'Eri,0,17,30,30
1651127075748,MATH 103A,B01,083779,Greenfeld; Be'Eri,0,16,30,30
1651127075748,MATH 103A,B02,083780,Greenfeld; Be'Eri,0,15,30,30
1651127081775,MATH 105,A01,085443,Staff,0,24,30,30
1651127087805,MATH 109,A01,083213,Ganzberger; Geoffrey Michael,0,8,30,30
1651127087805,MATH 109,A02,083214,Ganzberger; Geoffrey Michael,0,7,30,30
1651127087805,MATH 109,B01,083215,Ganzberger; Geoffrey Michael,0,8,30,30
1651127087805,MATH 109,B02,083216,Ganzberger; Geoffrey Michael,0,7,30,30
1651127093832,MATH 142A,A01,083219,Chow; Bennett,0,15,30,30
1651127093832,MATH 142A,A02,083220,Chow; Bennett,0,15,30,30
1651127093832,MATH 142A,B01,083221,Chow; Bennett,0,16,30,30
1651127093832,MATH 142A,B02,083222,Chow; Bennett,0,15,30,30
1651127099861,MATH 193A,A01,083224,Staff,0,9,30,30
1651127099861,MATH 193A,A02,083225,Staff,0,6,30,30
1651127099861,MATH 193A,A03,083781,Staff,0,7,30,30
1651127099861,MATH 193A,A04,083782,Staff,0,7,30,30
1651127105912,MATH 197,001,091859,McAuley; Julian John,9998,0,9999,1
1651127111969,COGS 9,A01,083615,Staff,0,20,60,60
1651127117995,COGS 11,A01,083617,Boyle; Mary E. T.,13,0,40,27
1651127124019,COGS 13,A01,083071,Staff,0,39,40,40
1651127130043,COGS 14A,A01,092681,Staff,0,41,100,100
1651127136071,COGS 14B,A01,083073,Cheng; Tzu-Han,0,11,50,50
1651127142094,COGS 17,A01,092677,Staff,8,0,75,67
1651127148117,COGS 100,A01,083619,Staff,0,29,60,61
1651127154140,COGS 101A,A01,083621,Davis; Joshua Daniel,0,29,60,60
1651127160166,COGS 101B,A01,091572,Staff,0,8,60,60
1651127166189,COGS 101C,A01,083625,Delgado; Tania,12,0,30,18
1651127172213,COGS 107A,A01,083627,Boyle; Mary E. T.,0,17,60,60
1651127178239,COGS 118A,A01,083075,Staff,0,10,60,60
1651127184267,CSE 3,A50,083646,Miranda; Gregory Joseph,15,0,38,23
1651127184267,CSE 3,A51,083647,Miranda; Gregory Joseph,36,0,37,1
1651127190291,CSE 8A,A50,083650,Miranda; Gregory Joseph,0,30,40,40
1651127196317,CSE 11,A01,083080,Cao; Yingjun,0,98,40,40
1651127202340,CSE 12,A01,083652,Staff,0,30,100,100
1651127208363,CSE 15L,A01,083654,Staff,0,4,50,50
1651127208363,CSE 15L,A02,083655,Staff,0,3,50,50
1651127214391,CSE 20,A01,083657,Staff,47,0,80,33
1651127220414,CSE 30,A01,083084,Eldon; John,0,39,80,80
1651127226438,CSE 100,A01,083659,Cao; Yingjun,0,72,50,50
1651127232463,CSE 134B,A01,083661,Powell; Thomas Allan,0,38,65,65
1651127238489,CSE 140,A01,083663,Staff,0,17,75,75
1651127244516,CSE 140L,A01,083088,Eldon; John,1,0,100,99
1651127250542,CSE 175,A01,083665,Kumar; Rakesh,0,0,25,25
1651127256574,CSE 190,A00,092507,Dubnov; Shlomo,9,0,20,11
1651127262600,ECE 45,A01,083139,Staff,0,8,60,60
1651127268626,ECE 65,A50,083695,Staff,0,7,30,30
1651127274650,ECE 109,A01,091882,Touri; Behrouz,32,0,70,38
1651127280677,ECE 180,A00,083140,Abi Samra; Nicholas Camill,17,0,30,13
1651127280677,ECE 180,B00,083141,Abi Samra; Nicholas Camill,0,1,30,32
1651127286703,MATH 10A,A01,083735,Patchell; Gregory David,0,0,30,30
1651127286703,MATH 10A,A02,083736,Patchell; Gregory David,26,0,30,4
1651127286703,MATH 10A,A03,083737,Patchell; Gregory David,22,0,30,8
1651127292730,MATH 10B,A01,083207,Staff,0,8,30,30
1651127292730,MATH 10B,A02,083208,Staff,0,7,30,30
1651127292730,MATH 10B,B01,083739,Staff,7,0,30,23
1651127292730,MATH 10B,B02,083740,Staff,28,0,30,2
1651127298759,MATH 18,A01,083743,Staff,0,0,30,30
1651127298759,MATH 18,A02,083744,Staff,23,0,30,7
1651127298759,MATH 18,A03,083745,Staff,19,0,30,11
1651127298759,MATH 18,A04,083746,Staff,26,0,30,4
1651127298759,MATH 18,B01,083748,Staff,0,16,30,30
1651127298759,MATH 18,B02,083749,Staff,0,15,30,30
1651127298759,MATH 18,B03,083750,Staff,0,15,30,30
1651127298759,MATH 18,B04,083751,Staff,0,15,30,30
1651127304784,MATH 20A,A01,083754,Staff,18,0,40,22
1651127310808,MATH 20B,A01,083756,Briones; Jor-el Thomas Caparas,0,14,30,30
1651127310808,MATH 20B,A02,083757,Briones; Jor-el Thomas Caparas,0,11,30,30
1651127316834,MATH 20C,A01,083760,Briones; Jor-el Thomas Caparas,0,16,30,30
1651127316834,MATH 20C,A02,083761,Briones; Jor-el Thomas Caparas,0,17,30,30
1651127316834,MATH 20C,B01,083762,Staff,6,0,30,24
1651127316834,MATH 20C,B02,083763,Staff,28,0,30,2
1651127322858,MATH 20D,A01,083765,Tran; Brian Kha,4,1,30,26
1651127322858,MATH 20D,A02,083766,Tran; Brian Kha,0,0,30,30
1651127322858,MATH 20D,A03,083767,Tran; Brian Kha,21,0,30,9
1651127328892,MATH 20E,A01,083771,Staff,0,0,30,30
1651127328892,MATH 20E,A02,083772,Staff,9,0,30,21
1651127328892,MATH 20E,B01,083773,Staff,5,0,35,30
1651127328892,MATH 20E,B02,083774,Staff,4,0,35,31
1651127334918,MATH 103A,A01,083777,Greenfeld; Be'Eri,0,17,30,30
1651127334918,MATH 103A,A02,083778,Greenfeld; Be'Eri,0,17,30,30
1651127334918,MATH 103A,B01,083779,Greenfeld; Be'Eri,0,16,30,30
1651127334918,MATH 103A,B02,083780,Greenfeld; Be'Eri,0,15,30,30
1651127341013,MATH 105,A01,085443,Staff,0,24,30,30
1651127347038,MATH 109,A01,083213,Ganzberger; Geoffrey Michael,0,8,30,30
1651127347038,MATH 109,A02,083214,Ganzberger; Geoffrey Michael,0,7,30,30
1651127347038,MATH 109,B01,083215,Ganzberger; Geoffrey Michael,0,8,30,30
1651127347038,MATH 109,B02,083216,Ganzberger; Geoffrey Michael,0,7,30,30
1651127353068,MATH 142A,A01,083219,Chow; Bennett,0,15,30,30
1651127353068,MATH 142A,A02,083220,Chow; Bennett,0,15,30,30
1651127353068,MATH 142A,B01,083221,Chow; Bennett,0,16,30,30
1651127353068,MATH 142A,B02,083222,Chow; Bennett,0,15,30,30
1651127359092,MATH 193A,A01,083224,Staff,0,9,30,30
1651127359092,MATH 193A,A02,083225,Staff,0,6,30,30
1651127359092,MATH 193A,A03,083781,Staff,0,7,30,30
1651127359092,MATH 193A,A04,083782,Staff,0,7,30,30
1651127365119,MATH 197,001,091859,McAuley; Julian John,9998,0,9999,1
1651127371177,COGS 9,A01,083615,Staff,0,20,60,60
1651127377206,COGS 11,A01,083617,Boyle; Mary E. T.,13,0,40,27
1651127383231,COGS 13,A01,083071,Staff,0,39,40,40
1651127389255,COGS 14A,A01,092681,Staff,0,41,100,100
1651127395281,COGS 14B,A01,083073,Cheng; Tzu-Han,0,11,50,50
1651127401303,COGS 17,A01,092677,Staff,8,0,75,67
1651127407327,COGS 100,A01,083619,Staff,0,29,60,61
1651127413354,COGS 101A,A01,083621,Davis; Joshua Daniel,0,29,60,60
1651127419376,COGS 101B,A01,091572,Staff,0,8,60,60
1651127425399,COGS 101C,A01,083625,Delgado; Tania,12,0,30,18
1651127431426,COGS 107A,A01,083627,Boyle; Mary E. T.,0,17,60,60
1651127437448,COGS 118A,A01,083075,Staff,0,10,60,60
1651127443473,CSE 3,A50,083646,Miranda; Gregory Joseph,15,0,38,23
1651127443473,CSE 3,A51,083647,Miranda; Gregory Joseph,36,0,37,1
1651127449511,CSE 8A,A50,083650,Miranda; Gregory Joseph,0,30,40,40
1651127455543,CSE 11,A01,083080,Cao; Yingjun,0,98,40,40
1651127461571,CSE 12,A01,083652,Staff,0,30,100,100
1651127467600,CSE 15L,A01,083654,Staff,0,4,50,50
1651127467600,CSE 15L,A02,083655,Staff,0,3,50,50
1651127473626,CSE 20,A01,083657,Staff,47,0,80,33
1651127479648,CSE 30,A01,083084,Eldon; John,0,39,80,80
1651127485677,CSE 100,A01,083659,Cao; Yingjun,0,72,50,50
1651127491700,CSE 134B,A01,083661,Powell; Thomas Allan,0,38,65,65
1651127497727,CSE 140,A01,083663,Staff,0,17,75,75
1651127503754,CSE 140L,A01,083088,Eldon; John,1,0,100,99
1651127509777,CSE 175,A01,083665,Kumar; Rakesh,0,0,25,25
1651127515800,CSE 190,A00,092507,Dubnov; Shlomo,9,0,20,11
1651127521825,ECE 45,A01,083139,Staff,0,8,60,60
1651127527854,ECE 65,A50,083695,Staff,0,7,30,30
1651127533877,ECE 109,A01,091882,Touri; Behrouz,32,0,70,38
1651127539904,ECE 180,A00,083140,Abi Samra; Nicholas Camill,17,0,30,13
1651127539904,ECE 180,B00,083141,Abi Samra; Nicholas Camill,0,1,30,32
1651127545928,MATH 10A,A01,083735,Patchell; Gregory David,0,0,30,30
1651127545928,MATH 10A,A02,083736,Patchell; Gregory David,26,0,30,4
1651127545928,MATH 10A,A03,083737,Patchell; Gregory David,22,0,30,8
1651127551953,MATH 10B,A01,083207,Staff,0,8,30,30
1651127551953,MATH 10B,A02,083208,Staff,0,7,30,30
1651127551953,MATH 10B,B01,083739,Staff,7,0,30,23
1651127551953,MATH 10B,B02,083740,Staff,28,0,30,2
1651127557976,MATH 18,A01,083743,Staff,0,0,30,30
1651127557976,MATH 18,A02,083744,Staff,23,0,30,7
1651127557976,MATH 18,A03,083745,Staff,19,0,30,11
1651127557976,MATH 18,A04,083746,Staff,26,0,30,4
1651127557976,MATH 18,B01,083748,Staff,0,16,30,30
1651127557976,MATH 18,B02,083749,Staff,0,15,30,30
1651127557976,MATH 18,B03,083750,Staff,0,15,30,30
1651127557976,MATH 18,B04,083751,Staff,0,15,30,30
1651127564000,MATH 20A,A01,083754,Staff,18,0,40,22
1651127570024,MATH 20B,A01,083756,Briones; Jor-el Thomas Caparas,0,14,30,30
1651127570024,MATH 20B,A02,083757,Briones; Jor-el Thomas Caparas,0,11,30,30
1651127576055,MATH 20C,A01,083760,Briones; Jor-el Thomas Caparas,0,16,30,30
1651127576055,MATH 20C,A02,083761,Briones; Jor-el Thomas Caparas,0,17,30,30
1651127576055,MATH 20C,B01,083762,Staff,6,0,30,24
1651127576055,MATH 20C,B02,083763,Staff,28,0,30,2
1651127582082,MATH 20D,A01,083765,Tran; Brian Kha,4,1,30,26
1651127582082,MATH 20D,A02,083766,Tran; Brian Kha,0,0,30,30
1651127582082,MATH 20D,A03,083767,Tran; Brian Kha,21,0,30,9
1651127588105,MATH 20E,A01,083771,Staff,0,0,30,30
1651127588105,MATH 20E,A02,083772,Staff,9,0,30,21
1651127588105,MATH 20E,B01,083773,Staff,5,0,35,30
1651127588105,MATH 20E,B02,083774,Staff,4,0,35,31
1651127594138,MATH 103A,A01,083777,Greenfeld; Be'Eri,0,17,30,30
1651127594138,MATH 103A,A02,083778,Greenfeld; Be'Eri,0,18,30,30
1651127594138,MATH 103A,B01,083779,Greenfeld; Be'Eri,0,16,30,30
1651127594138,MATH 103A,B02,083780,Greenfeld; Be'Eri,0,15,30,30
1651127600165,MATH 105,A01,085443,Staff,0,25,30,30
1651127606190,MATH 109,A01,083213,Ganzberger; Geoffrey Michael,0,8,30,30
1651127606190,MATH 109,A02,083214,Ganzberger; Geoffrey Michael,0,7,30,30
1651127606190,MATH 109,B01,083215,Ganzberger; Geoffrey Michael,0,8,30,30
1651127606190,MATH 109,B02,083216,Ganzberger; Geoffrey Michael,0,7,30,30
1651127612215,MATH 142A,A01,083219,Chow; Bennett,0,16,30,30
1651127612215,MATH 142A,A02,083220,Chow; Bennett,0,15,30,30
1651127612215,MATH 142A,B01,083221,Chow; Bennett,0,16,30,30
1651127612215,MATH 142A,B02,083222,Chow; Bennett,0,15,30,30
1651127618240,MATH 193A,A01,083224,Staff,0,9,30,30
1651127618240,MATH 193A,A02,083225,Staff,0,6,30,30
1651127618240,MATH 193A,A03,083781,Staff,0,7,30,30
1651127618240,MATH 193A,A04,083782,Staff,0,7,30,30
1651127624266,MATH 197,001,091859,McAuley; Julian John,9998,0,9999,1
1651127630320,COGS 9,A01,083615,Staff,0,20,60,60
1651127636348,COGS 11,A01,083617,Boyle; Mary E. T.,13,0,40,27
1651127642376,COGS 13,A01,083071,Staff,0,39,40,40
1651127648404,COGS 14A,A01,092681,Staff,0,41,100,100
1651127654430,COGS 14B,A01,083073,Cheng; Tzu-Han,0,11,50,50
1651127660473,COGS 17,A01,092677,Staff,8,0,75,67
1651127666498,COGS 100,A01,083619,Staff,0,29,60,61
1651127672526,COGS 101A,A01,083621,Davis; Joshua Daniel,0,29,60,60
1651127678550,COGS 101B,A01,091572,Staff,0,8,60,60
1651127684576,COGS 101C,A01,083625,Delgado; Tania,12,0,30,18
1651127690598,COGS 107A,A01,083627,Boyle; Mary E. T.,0,17,60,60
1651127696627,COGS 118A,A01,083075,Staff,0,10,60,60
1651127702655,CSE 3,A50,083646,Miranda; Gregory Joseph,15,0,38,23
1651127702655,CSE 3,A51,083647,Miranda; Gregory Joseph,36,0,37,1
1651127708678,CSE 8A,A50,083650,Miranda; Gregory Joseph,0,30,40,40
1651127714701,CSE 11,A01,083080,Cao; Yingjun,0,98,40,40
1651127720738,CSE 12,A01,083652,Staff,0,30,100,100
1651127726762,CSE 15L,A01,083654,Staff,0,4,50,50
1651127726762,CSE 15L,A02,083655,Staff,0,3,50,50
1651127732786,CSE 20,A01,083657,Staff,47,0,80,33
1651127738809,CSE 30,A01,083084,Eldon; John,0,39,80,80
1651127744839,CSE 100,A01,083659,Cao; Yingjun,0,72,50,50
1651127750864,CSE 134B,A01,083661,Powell; Thomas Allan,0,38,65,65
1651127756890,CSE 140,A01,083663,Staff,0,17,75,75
1651127762919,CSE 140L,A01,083088,Eldon; John,1,0,100,99
1651127768947,CSE 175,A01,083665,Kumar; Rakesh,0,0,25,25
1651127774973,CSE 190,A00,092507,Dubnov; Shlomo,9,0,20,11
1651127780997,ECE 45,A01,083139,Staff,0,8,60,60
1651127787020,ECE 65,A50,083695,Staff,0,7,30,30
1651127793044,ECE 109,A01,091882,Touri; Behrouz,32,0,70,38
1651127799070,ECE 180,A00,083140,Abi Samra; Nicholas Camill,17,0,30,13
1651127799070,ECE 180,B00,083141,Abi Samra; Nicholas Camill,0,1,30,32
1651127805097,MATH 10A,A01,083735,Patchell; Gregory David,0,0,30,30
1651127805097,MATH 10A,A02,083736,Patchell; Gregory David,26,0,30,4
1651127805097,MATH 10A,A03,083737,Patchell; Gregory David,22,0,30,8
1651127811121,MATH 10B,A01,083207,Staff,0,8,30,30
1651127811121,MATH 10B,A02,083208,Staff,0,7,30,30
1651127811121,MATH 10B,B01,083739,Staff,7,0,30,23
1651127811121,MATH 10B,B02,083740,Staff,28,0,30,2
1651127817150,MATH 18,A01,083743,Staff,0,0,30,30
1651127817150,MATH 18,A02,083744,Staff,23,0,30,7
1651127817150,MATH 18,A03,083745,Staff,19,0,30,11
1651127817150,MATH 18,A04,083746,Staff,26,0,30,4
1651127817150,MATH 18,B01,083748,Staff,0,16,30,30
1651127817150,MATH 18,B02,083749,Staff,0,15,30,30
1651127817150,MATH 18,B03,083750,Staff,0,15,30,30
1651127817150,MATH 18,B04,083751,Staff,0,15,30,30
1651127823172,MATH 20A,A01,083754,Staff,18,0,40,22
1651127829200,MATH 20B,A01,083756,Briones; Jor-el Thomas Caparas,0,14,30,30
1651127829200,MATH 20B,A02,083757,Briones; Jor-el Thomas Caparas,0,11,30,30
1651127835226,MATH 20C,A01,083760,Briones; Jor-el Thomas Caparas,0,16,30,30
1651127835226,MATH 20C,A02,083761,Briones; Jor-el Thomas Caparas,0,17,30,30
1651127835226,MATH 20C,B01,083762,Staff,6,0,30,24
1651127835226,MATH 20C,B02,083763,Staff,28,0,30,2
1651127841253,MATH 20D,A01,083765,Tran; Brian Kha,4,1,30,26
1651127841253,MATH 20D,A02,083766,Tran; Brian Kha,0,0,30,30
1651127841253,MATH 20D,A03,083767,Tran; Brian Kha,21,0,30,9
1651127847281,MATH 20E,A01,083771,Staff,0,0,30,30
1651127847281,MATH 20E,A02,083772,Staff,9,0,30,21
1651127847281,MATH 20E,B01,083773,Staff,5,0,35,30
1651127847281,MATH 20E,B02,083774,Staff,4,0,35,31
1651127853308,MATH 103A,A01,083777,Greenfeld; Be'Eri,0,17,30,30
1651127853308,MATH 103A,A02,083778,Greenfeld; Be'Eri,0,18,30,30
1651127853308,MATH 103A,B01,083779,Greenfeld; Be'Eri,0,16,30,30
1651127853308,MATH 103A,B02,083780,Greenfeld; Be'Eri,0,15,30,30
1651127859332,MATH 105,A01,085443,Staff,0,24,30,30
1651127865356,MATH 109,A01,083213,Ganzberger; Geoffrey Michael,0,8,30,30
1651127865356,MATH 109,A02,083214,Ganzberger; Geoffrey Michael,0,7,30,30
1651127865356,MATH 109,B01,083215,Ganzberger; Geoffrey Michael,0,8,30,30
1651127865356,MATH 109,B02,083216,Ganzberger; Geoffrey Michael,0,7,30,30
1651127871380,MATH 142A,A01,083219,Chow; Bennett,0,16,30,30
1651127871380,MATH 142A,A02,083220,Chow; Bennett,0,15,30,30
1651127871380,MATH 142A,B01,083221,Chow; Bennett,0,16,30,30
1651127871380,MATH 142A,B02,083222,Chow; Bennett,0,15,30,30
1651127877405,MATH 193A,A01,083224,Staff,0,9,30,30
1651127877405,MATH 193A,A02,083225,Staff,0,7,30,30
1651127877405,MATH 193A,A03,083781,Staff,0,7,30,30
1651127877405,MATH 193A,A04,083782,Staff,0,7,30,30
1651127883428,MATH 197,001,091859,McAuley; Julian John,9998,0,9999,1
1651127889510,COGS 9,A01,083615,Staff,0,20,60,60
1651127895534,COGS 11,A01,083617,Boyle; Mary E. T.,13,0,40,27
1651127901560,COGS 13,A01,083071,Staff,0,39,40,40
1651127907592,COGS 14A,A01,092681,Staff,0,41,100,100
1651127913615,COGS 14B,A01,083073,Cheng; Tzu-Han,0,11,50,50
1651127919638,COGS 17,A01,092677,Staff,8,0,75,67
1651127925664,COGS 100,A01,083619,Staff,0,29,60,61
1651127931763,COGS 101A,A01,083621,Davis; Joshua Daniel,0,29,60,60
1651127937786,COGS 101B,A01,091572,Staff,0,8,60,60
1651127943810,COGS 101C,A01,083625,Delgado; Tania,12,0,30,18
1651127949834,COGS 107A,A01,083627,Boyle; Mary E. T.,0,17,60,60
1651127955872,COGS 118A,A01,083075,Staff,0,10,60,60
1651127961896,CSE 3,A50,083646,Miranda; Gregory Joseph,15,0,38,23
1651127961896,CSE 3,A51,083647,Miranda; Gregory Joseph,36,0,37,1
1651127967920,CSE 8A,A50,083650,Miranda; Gregory Joseph,0,30,40,40
1651127973943,CSE 11,A01,083080,Cao; Yingjun,0,98,40,40
1651127979966,CSE 12,A01,083652,Staff,0,30,100,100
1651127985995,CSE 15L,A01,083654,Staff,0,4,50,50
1651127985995,CSE 15L,A02,083655,Staff,0,3,50,50
1651127992018,CSE 20,A01,083657,Staff,47,0,80,33
1651127998042,CSE 30,A01,083084,Eldon; John,0,39,80,80
1651128004067,CSE 100,A01,083659,Cao; Yingjun,0,72,50,50
1651128010090,CSE 134B,A01,083661,Powell; Thomas Allan,0,38,65,65
1651128016113,CSE 140,A01,083663,Staff,0,17,75,75
1651128022136,CSE 140L,A01,083088,Eldon; John,1,0,100,99
1651128028159,CSE 175,A01,083665,Kumar; Rakesh,0,0,25,25
1651128034184,CSE 190,A00,092507,Dubnov; Shlomo,9,0,20,11
1651128040208,ECE 45,A01,083139,Staff,0,8,60,60
1651128046231,ECE 65,A50,083695,Staff,0,7,30,30
1651128052257,ECE 109,A01,091882,Touri; Behrouz,32,0,70,38
1651128058280,ECE 180,A00,083140,Abi Samra; Nicholas Camill,17,0,30,13
1651128058280,ECE 180,B00,083141,Abi Samra; Nicholas Camill,0,1,30,32
1651128064307,MATH 10A,A01,083735,Patchell; Gregory David,0,0,30,30
1651128064307,MATH 10A,A02,083736,Patchell; Gregory David,26,0,30,4
1651128064307,MATH 10A,A03,083737,Patchell; Gregory David,22,0,30,8
1651128070335,MATH 10B,A01,083207,Staff,0,8,30,30
1651128070335,MATH 10B,A02,083208,Staff,0,7,30,30
1651128070335,MATH 10B,B01,083739,Staff,7,0,30,23
1651128070335,MATH 10B,B02,083740,Staff,28,0,30,2
1651128076360,MATH 18,A01,083743,Staff,0,0,30,30
1651128076360,MATH 18,A02,083744,Staff,23,0,30,7
1651128076360,MATH 18,A03,083745,Staff,19,0,30,11
1651128076360,MATH 18,A04,083746,Staff,26,0,30,4
1651128076360,MATH 18,B01,083748,Staff,0,16,30,30
1651128076360,MATH 18,B02,083749,Staff,0,15,30,30
1651128076360,MATH 18,B03,083750,Staff,0,15,30,30
1651128076360,MATH 18,B04,083751,Staff,0,15,30,30
1651128082384,MATH 20A,A01,083754,Staff,18,0,40,22
1651128088407,MATH 20B,A01,083756,Briones; Jor-el Thomas Caparas,0,14,30,30
1651128088407,MATH 20B,A02,083757,Briones; Jor-el Thomas Caparas,0,11,30,30
1651128094434,MATH 20C,A01,083760,Briones; Jor-el Thomas Caparas,0,16,30,30
1651128094434,MATH 20C,A02,083761,Briones; Jor-el Thomas Caparas,0,17,30,30
1651128094434,MATH 20C,B01,083762,Staff,6,0,30,24
1651128094434,MATH 20C,B02,083763,Staff,28,0,30,2
1651128100461,MATH 20D,A01,083765,Tran; Brian Kha,4,1,30,26
1651128100461,MATH 20D,A02,083766,Tran; Brian Kha,0,0,30,30
1651128100461,MATH 20D,A03,083767,Tran; Brian Kha,21,0,30,9
1651128106485,MATH 20E,A01,083771,Staff,0,0,30,30
1651128106485,MATH 20E,A02,083772,Staff,9,0,30,21
1651128106485,MATH 20E,B01,083773,Staff,5,0,35,30
1651128106485,MATH 20E,B02,083774,Staff,4,0,35,31
1651128112519,MATH 103A,A01,083777,Greenfeld; Be'Eri,0,17,30,30
1651128112519,MATH 103A,A02,083778,Greenfeld; Be'Eri,0,18,30,30
1651128112519,MATH 103A,B01,083779,Greenfeld; Be'Eri,0,16,30,30
1651128112519,MATH 103A,B02,083780,Greenfeld; Be'Eri,0,15,30,30
1651128118542,MATH 105,A01,085443,Staff,0,24,30,30
1651128124570,MATH 109,A01,083213,Ganzberger; Geoffrey Michael,0,8,30,30
1651128124570,MATH 109,A02,083214,Ganzberger; Geoffrey Michael,0,7,30,30
1651128124570,MATH 109,B01,083215,Ganzberger; Geoffrey Michael,0,8,30,30
1651128124570,MATH 109,B02,083216,Ganzberger; Geoffrey Michael,0,7,30,30
1651128130595,MATH 142A,A01,083219,Chow; Bennett,0,16,30,30
1651128130595,MATH 142A,A02,083220,Chow; Bennett,0,15,30,30
1651128130595,MATH 142A,B01,083221,Chow; Bennett,0,16,30,30
1651128130595,MATH 142A,B02,083222,Chow; Bennett,0,15,30,30
1651128136635,MATH 193A,A01,083224,Staff,0,9,30,30
1651128136635,MATH 193A,A02,083225,Staff,0,7,30,30
1651128136635,MATH 193A,A03,083781,Staff,0,7,30,30
1651128136635,MATH 193A,A04,083782,Staff,0,7,30,30
1651128142658,MATH 197,001,091859,McAuley; Julian John,9998,0,9999,1
1651128148732,COGS 9,A01,083615,Staff,0,20,60,60
1651128154766,COGS 11,A01,083617,Boyle; Mary E. T.,13,0,40,27
1651128160793,COGS 13,A01,083071,Staff,0,39,40,40
1651128166826,COGS 14A,A01,092681,Staff,0,41,100,100
1651128172850,COGS 14B,A01,083073,Cheng; Tzu-Han,0,11,50,50
1651128178873,COGS 17,A01,092677,Staff,8,0,75,67
1651128184897,COGS 100,A01,083619,Staff,0,29,60,61
1651128190952,COGS 101A,A01,083621,Davis; Joshua Daniel,0,29,60,60
1651128196982,COGS 101B,A01,091572,Staff,0,8,60,60
1651128203005,COGS 101C,A01,083625,Delgado; Tania,12,0,30,18
1651128209028,COGS 107A,A01,083627,Boyle; Mary E. T.,0,17,60,60
1651128215052,COGS 118A,A01,083075,Staff,0,10,60,60
1651128221075,CSE 3,A50,083646,Miranda; Gregory Joseph,15,0,38,23
1651128221075,CSE 3,A51,083647,Miranda; Gregory Joseph,36,0,37,1
1651128227101,CSE 8A,A50,083650,Miranda; Gregory Joseph,0,30,40,40
1651128233124,CSE 11,A01,083080,Cao; Yingjun,0,98,40,40
1651128239147,CSE 12,A01,083652,Staff,0,30,100,100
1651128245171,CSE 15L,A01,083654,Staff,0,4,50,50
1651128245171,CSE 15L,A02,083655,Staff,0,3,50,50
1651128251195,CSE 20,A01,083657,Staff,47,0,80,33
1651128257222,CSE 30,A01,083084,Eldon; John,0,39,80,80
1651128263246,CSE 100,A01,083659,Cao; Yingjun,0,72,50,50
1651128269268,CSE 134B,A01,083661,Powell; Thomas Allan,0,38,65,65
1651128275292,CSE 140,A01,083663,Staff,0,17,75,75
1651128281319,CSE 140L,A01,083088,Eldon; John,1,0,100,99
1651128287346,CSE 175,A01,083665,Kumar; Rakesh,0,0,25,25
1651128293372,CSE 190,A00,092507,Dubnov; Shlomo,9,0,20,11
1651128299394,ECE 45,A01,083139,Staff,0,8,60,60
1651128305416,ECE 65,A50,083695,Staff,0,7,30,30
1651128311442,ECE 109,A01,091882,Touri; Behrouz,32,0,70,38
1651128317466,ECE 180,A00,083140,Abi Samra; Nicholas Camill,17,0,30,13
1651128317466,ECE 180,B00,083141,Abi Samra; Nicholas Camill,0,1,30,32
1651128323492,MATH 10A,A01,083735,Patchell; Gregory David,0,0,30,30
1651128323492,MATH 10A,A02,083736,Patchell; Gregory David,26,0,30,4
1651128323492,MATH 10A,A03,083737,Patchell; Gregory David,22,0,30,8
1651128329514,MATH 10B,A01,083207,Staff,0,8,30,30
1651128329514,MATH 10B,A02,083208,Staff,0,7,30,30
1651128329514,MATH 10B,B01,083739,Staff,7,0,30,23
1651128329514,MATH 10B,B02,083740,Staff,28,0,30,2
1651128335537,MATH 18,A01,083743,Staff,0,0,30,30
1651128335537,MATH 18,A02,083744,Staff,23,0,30,7
1651128335537,MATH 18,A03,083745,Staff,19,0,30,11
1651128335537,MATH 18,A04,083746,Staff,26,0,30,4
1651128335537,MATH 18,B01,083748,Staff,0,16,30,30
1651128335537,MATH 18,B02,083749,Staff,0,15,30,30
1651128335537,MATH 18,B03,083750,Staff,0,15,30,30
1651128335537,MATH 18,B04,083751,Staff,0,15,30,30
1651128341561,MATH 20A,A01,083754,Staff,18,0,40,22
1651128347583,MATH 20B,A01,083756,Briones; Jor-el Thomas Caparas,0,14,30,30
1651128347583,MATH 20B,A02,083757,Briones; Jor-el Thomas Caparas,0,11,30,30
1651128353614,MATH 20C,A01,083760,Briones; Jor-el Thomas Caparas,0,16,30,30
1651128353614,MATH 20C,A02,083761,Briones; Jor-el Thomas Caparas,0,17,30,30
1651128353614,MATH 20C,B01,083762,Staff,6,0,30,24
1651128353614,MATH 20C,B02,083763,Staff,28,0,30,2
1651128359642,MATH 20D,A01,083765,Tran; Brian Kha,4,1,30,26
1651128359642,MATH 20D,A02,083766,Tran; Brian Kha,0,0,30,30
1651128359642,MATH 20D,A03,083767,Tran; Brian Kha,21,0,30,9
1651128365669,MATH 20E,A01,083771,Staff,0,0,30,30
1651128365669,MATH 20E,A02,083772,Staff,9,0,30,21
1651128365669,MATH 20E,B01,083773,Staff,5,0,35,30
1651128365669,MATH 20E,B02,083774,Staff,4,0,35,31
1651128371701,MATH 103A,A01,083777,Greenfeld; Be'Eri,0,17,30,30
1651128371701,MATH 103A,A02,083778,Greenfeld; Be'Eri,0,18,30,30
1651128371701,MATH 103A,B01,083779,Greenfeld; Be'Eri,0,16,30,30
1651128371701,MATH 103A,B02,083780,Greenfeld; Be'Eri,0,15,30,30
1651128377730,MATH 105,A01,085443,Staff,0,24,30,30
1651128383758,MATH 109,A01,083213,Ganzberger; Geoffrey Michael,0,8,30,30
1651128383758,MATH 109,A02,083214,Ganzberger; Geoffrey Michael,0,7,30,30
1651128383758,MATH 109,B01,083215,Ganzberger; Geoffrey Michael,0,8,30,30
1651128383758,MATH 109,B02,083216,Ganzberger; Geoffrey Michael,0,7,30,30
1651128389786,MATH 142A,A01,083219,Chow; Bennett,0,16,30,30
1651128389786,MATH 142A,A02,083220,Chow; Bennett,0,15,30,30
1651128389786,MATH 142A,B01,083221,Chow; Bennett,0,16,30,30
1651128389786,MATH 142A,B02,083222,Chow; Bennett,0,15,30,30
1651128395813,MATH 193A,A01,083224,Staff,0,9,30,30
1651128395813,MATH 193A,A02,083225,Staff,0,7,30,30
1651128395813,MATH 193A,A03,083781,Staff,0,7,30,30
1651128395813,MATH 193A,A04,083782,Staff,0,7,30,30
1651128401839,MATH 197,001,091859,McAuley; Julian John,9998,0,9999,1
1651128407898,COGS 9,A01,083615,Staff,0,20,60,60
1651128422524,COGS 11,A01,083617,Boyle; Mary E. T.,13,0,40,27
1651128428547,COGS 13,A01,083071,Staff,0,39,40,40
1651128434571,COGS 14A,A01,092681,Staff,0,41,100,100
1651128440593,COGS 14B,A01,083073,Cheng; Tzu-Han,0,11,50,50
1651128446619,COGS 17,A01,092677,Staff,8,0,75,67
1651128452645,COGS 100,A01,083619,Staff,0,29,60,61
1651128458672,COGS 101A,A01,083621,Davis; Joshua Daniel,0,29,60,60
1651128464694,COGS 101B,A01,091572,Staff,0,8,60,60
1651128470721,COGS 101C,A01,083625,Delgado; Tania,12,0,30,18
1651128476748,COGS 107A,A01,083627,Boyle; Mary E. T.,0,17,60,60
1651128482771,COGS 118A,A01,083075,Staff,0,10,60,60
1651128488796,CSE 3,A50,083646,Miranda; Gregory Joseph,15,0,38,23
1651128488796,CSE 3,A51,083647,Miranda; Gregory Joseph,36,0,37,1
1651128494822,CSE 8A,A50,083650,Miranda; Gregory Joseph,0,30,40,40
1651128500848,CSE 11,A01,083080,Cao; Yingjun,0,98,40,40
1651128506876,CSE 12,A01,083652,Staff,0,30,100,100
1651128512903,CSE 15L,A01,083654,Staff,0,4,50,50
1651128512903,CSE 15L,A02,083655,Staff,0,3,50,50
1651128518926,CSE 20,A01,083657,Staff,47,0,80,33
1651128524951,CSE 30,A01,083084,Eldon; John,0,39,80,80
1651128530975,CSE 100,A01,083659,Cao; Yingjun,0,72,50,50
1651128537095,CSE 134B,A01,083661,Powell; Thomas Allan,0,38,65,65
1651128543122,CSE 140,A01,083663,Staff,0,17,75,75
1651128549150,CSE 140L,A01,083088,Eldon; John,1,0,100,99
1651128555172,CSE 175,A01,083665,Kumar; Rakesh,0,0,25,25
1651128561195,CSE 190,A00,092507,Dubnov; Shlomo,9,0,20,11
1651128567219,ECE 45,A01,083139,Staff,0,8,60,60
1651128573246,ECE 65,A50,083695,Staff,0,7,30,30
1651128579272,ECE 109,A01,091882,Touri; Behrouz,32,0,70,38
1651128585303,ECE 180,A00,083140,Abi Samra; Nicholas Camill,17,0,30,13
1651128585303,ECE 180,B00,083141,Abi Samra; Nicholas Camill,0,1,30,32
1651128591330,MATH 10A,A01,083735,Patchell; Gregory David,0,0,30,30
1651128591330,MATH 10A,A02,083736,Patchell; Gregory David,26,0,30,4
1651128591330,MATH 10A,A03,083737,Patchell; Gregory David,22,0,30,8
1651128597361,MATH 10B,A01,083207,Staff,0,8,30,30
1651128597361,MATH 10B,A02,083208,Staff,0,7,30,30
1651128597361,MATH 10B,B01,083739,Staff,7,0,30,23
1651128597361,MATH 10B,B02,083740,Staff,28,0,30,2
1651128603390,MATH 18,A01,083743,Staff,0,0,30,30
1651128603390,MATH 18,A02,083744,Staff,23,0,30,7
1651128603390,MATH 18,A03,083745,Staff,19,0,30,11
1651128603390,MATH 18,A04,083746,Staff,26,0,30,4
1651128603390,MATH 18,B01,083748,Staff,0,16,30,30
1651128603390,MATH 18,B02,083749,Staff,0,15,30,30
1651128603390,MATH 18,B03,083750,Staff,0,15,30,30
1651128603390,MATH 18,B04,083751,Staff,0,15,30,30
1651128609415,MATH 20A,A01,083754,Staff,18,0,40,22
1651128615442,MATH 20B,A01,083756,Briones; Jor-el Thomas Caparas,0,14,30,30
1651128615442,MATH 20B,A02,083757,Briones; Jor-el Thomas Caparas,0,11,30,30
1651128621466,MATH 20C,A01,083760,Briones; Jor-el Thomas Caparas,0,16,30,30
1651128621466,MATH 20C,A02,083761,Briones; Jor-el Thomas Caparas,0,17,30,30
1651128621466,MATH 20C,B01,083762,Staff,6,0,30,24
1651128621466,MATH 20C,B02,083763,Staff,28,0,30,2
1651128627490,MATH 20D,A01,083765,Tran; Brian Kha,4,1,30,26
1651128627490,MATH 20D,A02,083766,Tran; Brian Kha,0,0,30,30
1651128627490,MATH 20D,A03,083767,Tran; Brian Kha,21,0,30,9
1651128633517,MATH 20E,A01,083771,Staff,0,0,30,30
1651128633517,MATH 20E,A02,083772,Staff,9,0,30,21
1651128633517,MATH 20E,B01,083773,Staff,5,0,35,30
1651128633517,MATH 20E,B02,083774,Staff,4,0,35,31
1651128639545,MATH 103A,A01,083777,Greenfeld; Be'Eri,0,17,30,30
1651128639545,MATH 103A,A02,083778,Greenfeld; Be'Eri,0,18,30,30
1651128639545,MATH 103A,B01,083779,Greenfeld; Be'Eri,0,16,30,30
1651128639545,MATH 103A,B02,083780,Greenfeld; Be'Eri,0,15,30,30
1651128645571,MATH 105,A01,085443,Staff,0,24,30,30
1651128651601,MATH 109,A01,083213,Ganzberger; Geoffrey Michael,0,8,30,30
1651128651601,MATH 109,A02,083214,Ganzberger; Geoffrey Michael,0,7,30,30
1651128651601,MATH 109,B01,083215,Ganzberger; Geoffrey Michael,0,8,30,30
1651128651601,MATH 109,B02,083216,Ganzberger; Geoffrey Michael,0,7,30,30
1651128657630,MATH 142A,A01,083219,Chow; Bennett,0,16,30,30
1651128657630,MATH 142A,A02,083220,Chow; Bennett,0,15,30,30
1651128657630,MATH 142A,B01,083221,Chow; Bennett,0,16,30,30
1651128657630,MATH 142A,B02,083222,Chow; Bennett,0,15,30,30
1651128663659,MATH 193A,A01,083224,Staff,0,9,30,30
1651128663659,MATH 193A,A02,083225,Staff,0,7,30,30
1651128663659,MATH 193A,A03,083781,Staff,0,7,30,30
1651128663659,MATH 193A,A04,083782,Staff,0,7,30,30
1651128669684,MATH 197,001,091859,McAuley; Julian John,9998,0,9999,1
1651128675742,COGS 9,A01,083615,Staff,0,20,60,60
1651128681777,COGS 11,A01,083617,Boyle; Mary E. T.,13,0,40,27
1651128687799,COGS 13,A01,083071,Staff,0,39,40,40
1651128693827,COGS 14A,A01,092681,Staff,0,41,100,100
1651128699850,COGS 14B,A01,083073,Cheng; Tzu-Han,0,11,50,50
1651128705874,COGS 17,A01,092677,Staff,8,0,75,67
1651128711901,COGS 100,A01,083619,Staff,0,29,60,61
1651128717927,COGS 101A,A01,083621,Davis; Joshua Daniel,0,29,60,60
1651128723953,COGS 101B,A01,091572,Staff,0,8,60,60
1651128729980,COGS 101C,A01,083625,Delgado; Tania,12,0,30,18
1651128736015,COGS 107A,A01,083627,Boyle; Mary E. T.,0,17,60,60
1651128742045,COGS 118A,A01,083075,Staff,0,10,60,60
1651128748069,CSE 3,A50,083646,Miranda; Gregory Joseph,15,0,38,23
1651128748069,CSE 3,A51,083647,Miranda; Gregory Joseph,36,0,37,1
1651128754096,CSE 8A,A50,083650,Miranda; Gregory Joseph,0,30,40,40
1651128760122,CSE 11,A01,083080,Cao; Yingjun,0,98,40,40
1651128766145,CSE 12,A01,083652,Staff,0,30,100,100
1651128772169,CSE 15L,A01,083654,Staff,0,4,50,50
1651128772169,CSE 15L,A02,083655,Staff,0,3,50,50
1651128778206,CSE 20,A01,083657,Staff,47,0,80,33
1651128784234,CSE 30,A01,083084,Eldon; John,0,39,80,80
1651128790258,CSE 100,A01,083659,Cao; Yingjun,0,72,50,50
1651128796284,CSE 134B,A01,083661,Powell; Thomas Allan,0,38,65,65
1651128802308,CSE 140,A01,083663,Staff,0,17,75,75
1651128808334,CSE 140L,A01,083088,Eldon; John,1,0,100,99
1651128814366,CSE 175,A01,083665,Kumar; Rakesh,0,0,25,25
1651128820392,CSE 190,A00,092507,Dubnov; Shlomo,9,0,20,11
1651128826415,ECE 45,A01,083139,Staff,0,8,60,60
1651128832441,ECE 65,A50,083695,Staff,0,7,30,30
1651128838462,ECE 109,A01,091882,Touri; Behrouz,32,0,70,38
1651128844489,ECE 180,A00,083140,Abi Samra; Nicholas Camill,17,0,30,13
1651128844489,ECE 180,B00,083141,Abi Samra; Nicholas Camill,0,1,30,32
1651128850518,MATH 10A,A01,083735,Patchell; Gregory David,0,0,30,30
1651128850518,MATH 10A,A02,083736,Patchell; Gregory David,26,0,30,4
1651128850518,MATH 10A,A03,083737,Patchell; Gregory David,22,0,30,8
1651128856545,MATH 10B,A01,083207,Staff,0,8,30,30
1651128856545,MATH 10B,A02,083208,Staff,0,7,30,30
1651128856545,MATH 10B,B01,083739,Staff,7,0,30,23
1651128856545,MATH 10B,B02,083740,Staff,28,0,30,2
1651128862575,MATH 18,A01,083743,Staff,0,0,30,30
1651128862575,MATH 18,A02,083744,Staff,23,0,30,7
1651128862575,MATH 18,A03,083745,Staff,19,0,30,11
1651128862575,MATH 18,A04,083746,Staff,26,0,30,4
1651128862575,MATH 18,B01,083748,Staff,0,16,30,30
1651128862575,MATH 18,B02,083749,Staff,0,15,30,30
1651128862575,MATH 18,B03,083750,Staff,0,15,30,30
1651128862575,MATH 18,B04,083751,Staff,0,15,30,30
1651128868603,MATH 20A,A01,083754,Staff,18,0,40,22
1651128874627,MATH 20B,A01,083756,Briones; Jor-el Thomas Caparas,0,14,30,30
1651128874627,MATH 20B,A02,083757,Briones; Jor-el Thomas Caparas,0,11,30,30
1651128880655,MATH 20C,A01,083760,Briones; Jor-el Thomas Caparas,0,16,30,30
1651128880655,MATH 20C,A02,083761,Briones; Jor-el Thomas Caparas,0,17,30,30
1651128880655,MATH 20C,B01,083762,Staff,6,0,30,24
1651128880655,MATH 20C,B02,083763,Staff,28,0,30,2
1651128886679,MATH 20D,A01,083765,Tran; Brian Kha,4,1,30,26
1651128886679,MATH 20D,A02,083766,Tran; Brian Kha,0,0,30,30
1651128886679,MATH 20D,A03,083767,Tran; Brian Kha,21,0,30,9
1651128892704,MATH 20E,A01,083771,Staff,0,0,30,30
1651128892704,MATH 20E,A02,083772,Staff,9,0,30,21
1651128892704,MATH 20E,B01,083773,Staff,5,0,35,30
1651128892704,MATH 20E,B02,083774,Staff,4,0,35,31
1651128898729,MATH 103A,A01,083777,Greenfeld; Be'Eri,0,17,30,30
1651128898729,MATH 103A,A02,083778,Greenfeld; Be'Eri,0,18,30,30
1651128898729,MATH 103A,B01,083779,Greenfeld; Be'Eri,0,16,30,30
1651128898729,MATH 103A,B02,083780,Greenfeld; Be'Eri,0,15,30,30
1651128904755,MATH 105,A01,085443,Staff,0,24,30,30
1651128910784,MATH 109,A01,083213,Ganzberger; Geoffrey Michael,0,8,30,30
1651128910784,MATH 109,A02,083214,Ganzberger; Geoffrey Michael,0,7,30,30
1651128910784,MATH 109,B01,083215,Ganzberger; Geoffrey Michael,0,8,30,30
1651128910784,MATH 109,B02,083216,Ganzberger; Geoffrey Michael,0,7,30,30
1651128916808,MATH 142A,A01,083219,Chow; Bennett,0,16,30,30
1651128916808,MATH 142A,A02,083220,Chow; Bennett,0,15,30,30
1651128916808,MATH 142A,B01,083221,Chow; Bennett,0,16,30,30
1651128916808,MATH 142A,B02,083222,Chow; Bennett,0,15,30,30
1651128922832,MATH 193A,A01,083224,Staff,0,9,30,30
1651128922832,MATH 193A,A02,083225,Staff,0,7,30,30
1651128922832,MATH 193A,A03,083781,Staff,0,7,30,30
1651128922832,MATH 193A,A04,083782,Staff,0,7,30,30
1651128928856,MATH 197,001,091859,McAuley; Julian John,9998,0,9999,1
1651128934915,COGS 9,A01,083615,Staff,0,20,60,60
1651128940941,COGS 11,A01,083617,Boyle; Mary E. T.,13,0,40,27
1651128946979,COGS 13,A01,083071,Staff,0,39,40,40
1651128953002,COGS 14A,A01,092681,Staff,0,41,100,100
1651128959035,COGS 14B,A01,083073,Cheng; Tzu-Han,0,11,50,50
1651128965059,COGS 17,A01,092677,Staff,8,0,75,67
1651128971083,COGS 100,A01,083619,Staff,0,29,60,61
1651128977114,COGS 101A,A01,083621,Davis; Joshua Daniel,0,29,60,60
1651128983141,COGS 101B,A01,091572,Staff,0,8,60,60
1651128989168,COGS 101C,A01,083625,Delgado; Tania,12,0,30,18
1651128995194,COGS 107A,A01,083627,Boyle; Mary E. T.,0,17,60,60
1651129001223,COGS 118A,A01,083075,Staff,0,10,60,60
1651129007247,CSE 3,A50,083646,Miranda; Gregory Joseph,15,0,38,23
1651129007247,CSE 3,A51,083647,Miranda; Gregory Joseph,36,0,37,1
1651129013272,CSE 8A,A50,083650,Miranda; Gregory Joseph,0,30,40,40
1651129019296,CSE 11,A01,083080,Cao; Yingjun,0,98,40,40
1651129025328,CSE 12,A01,083652,Staff,0,30,100,100
1651129031356,CSE 15L,A01,083654,Staff,0,4,50,50
1651129031356,CSE 15L,A02,083655,Staff,0,3,50,50
1651129037378,CSE 20,A01,083657,Staff,47,0,80,33
1651129043401,CSE 30,A01,083084,Eldon; John,0,39,80,80
1651129049425,CSE 100,A01,083659,Cao; Yingjun,0,72,50,50
1651129055451,CSE 134B,A01,083661,Powell; Thomas Allan,0,38,65,65
1651129061473,CSE 140,A01,083663,Staff,0,17,75,75
1651129067499,CSE 140L,A01,083088,Eldon; John,1,0,100,99
1651129073525,CSE 175,A01,083665,Kumar; Rakesh,0,0,25,25
1651129079548,CSE 190,A00,092507,Dubnov; Shlomo,9,0,20,11
1651129085575,ECE 45,A01,083139,Staff,0,8,60,60
1651129091598,ECE 65,A50,083695,Staff,0,7,30,30
1651129097626,ECE 109,A01,091882,Touri; Behrouz,32,0,70,38
1651129103653,ECE 180,A00,083140,Abi Samra; Nicholas Camill,17,0,30,13
1651129103653,ECE 180,B00,083141,Abi Samra; Nicholas Camill,0,1,30,32
1651129109681,MATH 10A,A01,083735,Patchell; Gregory David,0,0,30,30
1651129109681,MATH 10A,A02,083736,Patchell; Gregory David,26,0,30,4
1651129109681,MATH 10A,A03,083737,Patchell; Gregory David,22,0,30,8
1651129115706,MATH 10B,A01,083207,Staff,0,8,30,30
1651129115706,MATH 10B,A02,083208,Staff,0,7,30,30
1651129115706,MATH 10B,B01,083739,Staff,7,0,30,23
1651129115706,MATH 10B,B02,083740,Staff,28,0,30,2
1651129121731,MATH 18,A01,083743,Staff,0,0,30,30
1651129121731,MATH 18,A02,083744,Staff,23,0,30,7
1651129121731,MATH 18,A03,083745,Staff,19,0,30,11
1651129121731,MATH 18,A04,083746,Staff,26,0,30,4
1651129121731,MATH 18,B01,083748,Staff,0,16,30,30
1651129121731,MATH 18,B02,083749,Staff,0,15,30,30
1651129121731,MATH 18,B03,083750,Staff,0,15,30,30
1651129121731,MATH 18,B04,083751,Staff,0,15,30,30
1651129127755,MATH 20A,A01,083754,Staff,18,0,40,22
1651129133879,MATH 20B,A01,083756,Briones; Jor-el Thomas Caparas,0,14,30,30
1651129133879,MATH 20B,A02,083757,Briones; Jor-el Thomas Caparas,0,11,30,30
1651129139902,MATH 20C,A01,083760,Briones; Jor-el Thomas Caparas,0,16,30,30
1651129139902,MATH 20C,A02,083761,Briones; Jor-el Thomas Caparas,0,17,30,30
1651129139902,MATH 20C,B01,083762,Staff,6,0,30,24
1651129139902,MATH 20C,B02,083763,Staff,28,0,30,2
1651129145927,MATH 20D,A01,083765,Tran; Brian Kha,4,1,30,26
1651129145927,MATH 20D,A02,083766,Tran; Brian Kha,0,0,30,30
1651129145927,MATH 20D,A03,083767,Tran; Brian Kha,21,0,30,9
1651129151952,MATH 20E,A01,083771,Staff,0,0,30,30
1651129151952,MATH 20E,A02,083772,Staff,9,0,30,21
1651129151952,MATH 20E,B01,083773,Staff,5,0,35,30
1651129151952,MATH 20E,B02,083774,Staff,4,0,35,31
1651129157980,MATH 103A,A01,083777,Greenfeld; Be'Eri,0,17,30,30
1651129157980,MATH 103A,A02,083778,Greenfeld; Be'Eri,0,18,30,30
1651129157980,MATH 103A,B01,083779,Greenfeld; Be'Eri,0,16,30,30
1651129157980,MATH 103A,B02,083780,Greenfeld; Be'Eri,0,15,30,30
1651129164003,MATH 105,A01,085443,Staff,0,24,30,30
1651129170028,MATH 109,A01,083213,Ganzberger; Geoffrey Michael,0,8,30,30
1651129170028,MATH 109,A02,083214,Ganzberger; Geoffrey Michael,0,7,30,30
1651129170028,MATH 109,B01,083215,Ganzberger; Geoffrey Michael,0,8,30,30
1651129170028,MATH 109,B02,083216,Ganzberger; Geoffrey Michael,0,7,30,30
1651129176058,MATH 142A,A01,083219,Chow; Bennett,0,16,30,30
1651129176058,MATH 142A,A02,083220,Chow; Bennett,0,15,30,30
1651129176058,MATH 142A,B01,083221,Chow; Bennett,0,16,30,30
1651129176058,MATH 142A,B02,083222,Chow; Bennett,0,15,30,30
1651129182081,MATH 193A,A01,083224,Staff,0,9,30,30
1651129182081,MATH 193A,A02,083225,Staff,0,7,30,30
1651129182081,MATH 193A,A03,083781,Staff,0,7,30,30
1651129182081,MATH 193A,A04,083782,Staff,0,7,30,30
1651129188107,MATH 197,001,091859,McAuley; Julian John,9998,0,9999,1
1651129194168,COGS 9,A01,083615,Staff,0,20,60,60
1651129200192,COGS 11,A01,083617,Boyle; Mary E. T.,13,0,40,27
1651129206220,COGS 13,A01,083071,Staff,0,39,40,40
1651129212243,COGS 14A,A01,092681,Staff,0,41,100,100
1651129218270,COGS 14B,A01,083073,Cheng; Tzu-Han,0,11,50,50
1651129224299,COGS 17,A01,092677,Staff,8,0,75,67
1651129230331,COGS 100,A01,083619,Staff,0,29,60,61
1651129236355,COGS 101A,A01,083621,Davis; Joshua Daniel,0,29,60,60
1651129242380,COGS 101B,A01,091572,Staff,0,8,60,60
1651129248408,COGS 101C,A01,083625,Delgado; Tania,12,0,30,18
1651129254441,COGS 107A,A01,083627,Boyle; Mary E. T.,0,17,60,60
1651129260466,COGS 118A,A01,083075,Staff,0,10,60,60
1651129266490,CSE 3,A50,083646,Miranda; Gregory Joseph,15,0,38,23
1651129266490,CSE 3,A51,083647,Miranda; Gregory Joseph,36,0,37,1
1651129272514,CSE 8A,A50,083650,Miranda; Gregory Joseph,0,30,40,40
1651129278540,CSE 11,A01,083080,Cao; Yingjun,0,98,40,40
1651129284565,CSE 12,A01,083652,Staff,0,30,100,100
1651129290589,CSE 15L,A01,083654,Staff,0,4,50,50
1651129290589,CSE 15L,A02,083655,Staff,0,3,50,50
1651129296617,CSE 20,A01,083657,Staff,47,0,80,33
1651129302642,CSE 30,A01,083084,Eldon; John,0,39,80,80
1651129308666,CSE 100,A01,083659,Cao; Yingjun,0,72,50,50
1651129314694,CSE 134B,A01,083661,Powell; Thomas Allan,0,38,65,65
1651129320722,CSE 140,A01,083663,Staff,0,17,75,75
1651129326750,CSE 140L,A01,083088,Eldon; John,1,0,100,99
1651129332781,CSE 175,A01,083665,Kumar; Rakesh,0,0,25,25
1651129338809,CSE 190,A00,092507,Dubnov; Shlomo,9,0,20,11
1651129344834,ECE 45,A01,083139,Staff,0,8,60,60
1651129350857,ECE 65,A50,083695,Staff,0,7,30,30
1651129356895,ECE 109,A01,091882,Touri; Behrouz,32,0,70,38
1651129362922,ECE 180,A00,083140,Abi Samra; Nicholas Camill,17,0,30,13
1651129362922,ECE 180,B00,083141,Abi Samra; Nicholas Camill,0,1,30,32
1651129368946,MATH 10A,A01,083735,Patchell; Gregory David,0,0,30,30
1651129368946,MATH 10A,A02,083736,Patchell; Gregory David,26,0,30,4
1651129368946,MATH 10A,A03,083737,Patchell; Gregory David,22,0,30,8
1651129374976,MATH 10B,A01,083207,Staff,0,8,30,30
1651129374976,MATH 10B,A02,083208,Staff,0,7,30,30
1651129374976,MATH 10B,B01,083739,Staff,7,0,30,23
1651129374976,MATH 10B,B02,083740,Staff,28,0,30,2
1651129381006,MATH 18,A01,083743,Staff,0,0,30,30
1651129381006,MATH 18,A02,083744,Staff,23,0,30,7
1651129381006,MATH 18,A03,083745,Staff,19,0,30,11
1651129381006,MATH 18,A04,083746,Staff,26,0,30,4
1651129381006,MATH 18,B01,083748,Staff,0,16,30,30
1651129381006,MATH 18,B02,083749,Staff,0,15,30,30
1651129381006,MATH 18,B03,083750,Staff,0,15,30,30
1651129381006,MATH 18,B04,083751,Staff,0,15,30,30
1651129387030,MATH 20A,A01,083754,Staff,18,0,40,22
1651129393057,MATH 20B,A01,083756,Briones; Jor-el Thomas Caparas,0,14,30,30
1651129393057,MATH 20B,A02,083757,Briones; Jor-el Thomas Caparas,0,11,30,30
1651129399082,MATH 20C,A01,083760,Briones; Jor-el Thomas Caparas,0,16,30,30
1651129399082,MATH 20C,A02,083761,Briones; Jor-el Thomas Caparas,0,17,30,30
1651129399082,MATH 20C,B01,083762,Staff,6,0,30,24
1651129399082,MATH 20C,B02,083763,Staff,28,0,30,2
1651129405107,MATH 20D,A01,083765,Tran; Brian Kha,4,1,30,26
1651129405107,MATH 20D,A02,083766,Tran; Brian Kha,0,0,30,30
1651129405107,MATH 20D,A03,083767,Tran; Brian Kha,21,0,30,9
1651129411130,MATH 20E,A01,083771,Staff,0,0,30,30
1651129411130,MATH 20E,A02,083772,Staff,9,0,30,21
1651129411130,MATH 20E,B01,083773,Staff,5,0,35,30
1651129411130,MATH 20E,B02,083774,Staff,4,0,35,31
1651129417159,MATH 103A,A01,083777,Greenfeld; Be'Eri,0,17,30,30
1651129417159,MATH 103A,A02,083778,Greenfeld; Be'Eri,0,18,30,30
1651129417159,MATH 103A,B01,083779,Greenfeld; Be'Eri,0,16,30,30
1651129417159,MATH 103A,B02,083780,Greenfeld; Be'Eri,0,15,30,30
1651129423185,MATH 105,A01,085443,Staff,0,24,30,30
1651129429215,MATH 109,A01,083213,Ganzberger; Geoffrey Michael,0,8,30,30
1651129429215,MATH 109,A02,083214,Ganzberger; Geoffrey Michael,0,7,30,30
1651129429215,MATH 109,B01,083215,Ganzberger; Geoffrey Michael,0,8,30,30
1651129429215,MATH 109,B02,083216,Ganzberger; Geoffrey Michael,0,7,30,30
1651129435247,MATH 142A,A01,083219,Chow; Bennett,0,16,30,30
1651129435247,MATH 142A,A02,083220,Chow; Bennett,0,15,30,30
1651129435247,MATH 142A,B01,083221,Chow; Bennett,0,16,30,30
1651129435247,MATH 142A,B02,083222,Chow; Bennett,0,15,30,30
1651129441277,MATH 193A,A01,083224,Staff,0,9,30,30
1651129441277,MATH 193A,A02,083225,Staff,0,7,30,30
1651129441277,MATH 193A,A03,083781,Staff,0,7,30,30
1651129441277,MATH 193A,A04,083782,Staff,0,7,30,30
1651129447301,MATH 197,001,091859,McAuley; Julian John,9998,0,9999,1
1651129453368,COGS 9,A01,083615,Staff,0,20,60,60
1651129459398,COGS 11,A01,083617,Boyle; Mary E. T.,13,0,40,27
1651129465422,COGS 13,A01,083071,Staff,0,39,40,40
1651129471451,COGS 14A,A01,092681,Staff,0,41,100,100
1651129477473,COGS 14B,A01,083073,Cheng; Tzu-Han,0,11,50,50
1651129483496,COGS 17,A01,092677,Staff,8,0,75,67
1651129489520,COGS 100,A01,083619,Staff,0,29,60,61
1651129495548,COGS 101A,A01,083621,Davis; Joshua Daniel,0,29,60,60
1651129501575,COGS 101B,A01,091572,Staff,0,8,60,60
1651129507606,COGS 101C,A01,083625,Delgado; Tania,12,0,30,18
1651129513638,COGS 107A,A01,083627,Boyle; Mary E. T.,0,17,60,60
1651129519662,COGS 118A,A01,083075,Staff,0,10,60,60
1651129525689,CSE 3,A50,083646,Miranda; Gregory Joseph,15,0,38,23
1651129525689,CSE 3,A51,083647,Miranda; Gregory Joseph,36,0,37,1
1651129531717,CSE 8A,A50,083650,Miranda; Gregory Joseph,0,30,40,40
1651129537741,CSE 11,A01,083080,Cao; Yingjun,0,98,40,40
1651129543765,CSE 12,A01,083652,Staff,0,30,100,100
1651129549789,CSE 15L,A01,083654,Staff,0,4,50,50
1651129549789,CSE 15L,A02,083655,Staff,0,3,50,50
1651129555813,CSE 20,A01,083657,Staff,47,0,80,33
1651129561837,CSE 30,A01,083084,Eldon; John,0,39,80,80
1651129567869,CSE 100,A01,083659,Cao; Yingjun,0,72,50,50
1651129573893,CSE 134B,A01,083661,Powell; Thomas Allan,0,38,65,65
1651129579921,CSE 140,A01,083663,Staff,0,17,75,75
1651129585946,CSE 140L,A01,083088,Eldon; John,1,0,100,99
1651129591969,CSE 175,A01,083665,Kumar; Rakesh,0,0,25,25
1651129597993,CSE 190,A00,092507,Dubnov; Shlomo,9,0,20,11
1651129604017,ECE 45,A01,083139,Staff,0,8,60,60
1651129610045,ECE 65,A50,083695,Staff,0,7,30,30
1651129616070,ECE 109,A01,091882,Touri; Behrouz,32,0,70,38
1651129622102,ECE 180,A00,083140,Abi Samra; Nicholas Camill,17,0,30,13
1651129622102,ECE 180,B00,083141,Abi Samra; Nicholas Camill,0,1,30,32
1651129628131,MATH 10A,A01,083735,Patchell; Gregory David,0,0,30,30
1651129628131,MATH 10A,A02,083736,Patchell; Gregory David,26,0,30,4
1651129628131,MATH 10A,A03,083737,Patchell; Gregory David,22,0,30,8
1651129634156,MATH 10B,A01,083207,Staff,0,8,30,30
1651129634156,MATH 10B,A02,083208,Staff,0,7,30,30
1651129634156,MATH 10B,B01,083739,Staff,7,0,30,23
1651129634156,MATH 10B,B02,083740,Staff,28,0,30,2
1651129640181,MATH 18,A01,083743,Staff,0,0,30,30
1651129640181,MATH 18,A02,083744,Staff,23,0,30,7
1651129640181,MATH 18,A03,083745,Staff,19,0,30,11
1651129640181,MATH 18,A04,083746,Staff,26,0,30,4
1651129640181,MATH 18,B01,083748,Staff,0,16,30,30
1651129640181,MATH 18,B02,083749,Staff,0,15,30,30
1651129640181,MATH 18,B03,083750,Staff,0,15,30,30
1651129640181,MATH 18,B04,083751,Staff,0,15,30,30
1651129646206,MATH 20A,A01,083754,Staff,18,0,40,22
1651129652230,MATH 20B,A01,083756,Briones; Jor-el Thomas Caparas,0,14,30,30
1651129652230,MATH 20B,A02,083757,Briones; Jor-el Thomas Caparas,0,11,30,30
1651129658263,MATH 20C,A01,083760,Briones; Jor-el Thomas Caparas,0,16,30,30
1651129658263,MATH 20C,A02,083761,Briones; Jor-el Thomas Caparas,0,17,30,30
1651129658263,MATH 20C,B01,083762,Staff,6,0,30,24
1651129658263,MATH 20C,B02,083763,Staff,28,0,30,2
1651129664286,MATH 20D,A01,083765,Tran; Brian Kha,4,1,30,26
1651129664286,MATH 20D,A02,083766,Tran; Brian Kha,0,0,30,30
1651129664286,MATH 20D,A03,083767,Tran; Brian Kha,21,0,30,9
1651129670309,MATH 20E,A01,083771,Staff,0,0,30,30
1651129670309,MATH 20E,A02,083772,Staff,9,0,30,21
1651129670309,MATH 20E,B01,083773,Staff,5,0,35,30
1651129670309,MATH 20E,B02,083774,Staff,4,0,35,31
1651129676338,MATH 103A,A01,083777,Greenfeld; Be'Eri,0,17,30,30
1651129676338,MATH 103A,A02,083778,Greenfeld; Be'Eri,0,18,30,30
1651129676338,MATH 103A,B01,083779,Greenfeld; Be'Eri,0,16,30,30
1651129676338,MATH 103A,B02,083780,Greenfeld; Be'Eri,0,15,30,30
1651129682386,MATH 105,A01,085443,Staff,0,24,30,30
1651129688416,MATH 109,A01,083213,Ganzberger; Geoffrey Michael,0,8,30,30
1651129688416,MATH 109,A02,083214,Ganzberger; Geoffrey Michael,0,7,30,30
1651129688416,MATH 109,B01,083215,Ganzberger; Geoffrey Michael,0,8,30,30
1651129688416,MATH 109,B02,083216,Ganzberger; Geoffrey Michael,0,7,30,30
1651129694455,MATH 142A,A01,083219,Chow; Bennett,0,16,30,30
1651129694455,MATH 142A,A02,083220,Chow; Bennett,0,15,30,30
1651129694455,MATH 142A,B01,083221,Chow; Bennett,0,16,30,30
1651129694455,MATH 142A,B02,083222,Chow; Bennett,0,15,30,30
1651129700509,MATH 193A,A01,083224,Staff,0,9,30,30
1651129700509,MATH 193A,A02,083225,Staff,0,7,30,30
1651129700509,MATH 193A,A03,083781,Staff,0,7,30,30
1651129700509,MATH 193A,A04,083782,Staff,0,7,30,30
1651129706532,MATH 197,001,091859,McAuley; Julian John,9998,0,9999,1
1651129712595,COGS 9,A01,083615,Staff,0,20,60,60
1651129718620,COGS 11,A01,083617,Boyle; Mary E. T.,13,0,40,27
1651129724773,COGS 13,A01,083071,Staff,0,39,40,40
1651129730796,COGS 14A,A01,092681,Staff,0,41,100,100
1651129736825,COGS 14B,A01,083073,Cheng; Tzu-Han,0,11,50,50
1651129742849,COGS 17,A01,092677,Staff,8,0,75,67
1651129748871,COGS 100,A01,083619,Staff,0,29,60,61
1651129754900,COGS 101A,A01,083621,Davis; Joshua Daniel,0,29,60,60
1651129760923,COGS 101B,A01,091572,Staff,0,8,60,60
1651129766951,COGS 101C,A01,083625,Delgado; Tania,12,0,30,18
1651129772978,COGS 107A,A01,083627,Boyle; Mary E. T.,0,17,60,60
1651129779006,COGS 118A,A01,083075,Staff,0,10,60,60
1651129785029,CSE 3,A50,083646,Miranda; Gregory Joseph,15,0,38,23
1651129785029,CSE 3,A51,083647,Miranda; Gregory Joseph,36,0,37,1
1651129791057,CSE 8A,A50,083650,Miranda; Gregory Joseph,0,30,40,40
1651129797096,CSE 11,A01,083080,Cao; Yingjun,0,98,40,40
1651129803122,CSE 12,A01,083652,Staff,0,30,100,100
1651129809146,CSE 15L,A01,083654,Staff,0,4,50,50
1651129809146,CSE 15L,A02,083655,Staff,0,3,50,50
1651129815171,CSE 20,A01,083657,Staff,47,0,80,33
1651129821202,CSE 30,A01,083084,Eldon; John,0,39,80,80
1651129827227,CSE 100,A01,083659,Cao; Yingjun,0,72,50,50
1651129833251,CSE 134B,A01,083661,Powell; Thomas Allan,0,38,65,65
1651129839275,CSE 140,A01,083663,Staff,0,17,75,75
1651129845303,CSE 140L,A01,083088,Eldon; John,1,0,100,99
1651129851327,CSE 175,A01,083665,Kumar; Rakesh,0,0,25,25
1651129857351,CSE 190,A00,092507,Dubnov; Shlomo,9,0,20,11
1651129863376,ECE 45,A01,083139,Staff,0,8,60,60
1651129869403,ECE 65,A50,083695,Staff,0,7,30,30
1651129875427,ECE 109,A01,091882,Touri; Behrouz,32,0,70,38
1651129881452,ECE 180,A00,083140,Abi Samra; Nicholas Camill,17,0,30,13
1651129881452,ECE 180,B00,083141,Abi Samra; Nicholas Camill,0,1,30,32
1651129887482,MATH 10A,A01,083735,Patchell; Gregory David,0,0,30,30
1651129887482,MATH 10A,A02,083736,Patchell; Gregory David,26,0,30,4
1651129887482,MATH 10A,A03,083737,Patchell; Gregory David,22,0,30,8
1651129893505,MATH 10B,A01,083207,Staff,0,8,30,30
1651129893505,MATH 10B,A02,083208,Staff,0,7,30,30
1651129893505,MATH 10B,B01,083739,Staff,7,0,30,23
1651129893505,MATH 10B,B02,083740,Staff,28,0,30,2
1651129899536,MATH 18,A01,083743,Staff,0,0,30,30
1651129899536,MATH 18,A02,083744,Staff,23,0,30,7
1651129899536,MATH 18,A03,083745,Staff,19,0,30,11
1651129899536,MATH 18,A04,083746,Staff,26,0,30,4
1651129899536,MATH 18,B01,083748,Staff,0,16,30,30
1651129899536,MATH 18,B02,083749,Staff,0,15,30,30
1651129899536,MATH 18,B03,083750,Staff,0,15,30,30
1651129899536,MATH 18,B04,083751,Staff,0,15,30,30
1651129905560,MATH 20A,A01,083754,Staff,18,0,40,22
1651129911586,MATH 20B,A01,083756,Briones; Jor-el Thomas Caparas,0,14,30,30
1651129911586,MATH 20B,A02,083757,Briones; Jor-el Thomas Caparas,0,11,30,30
1651129917614,MATH 20C,A01,083760,Briones; Jor-el Thomas Caparas,0,16,30,30
1651129917614,MATH 20C,A02,083761,Briones; Jor-el Thomas Caparas,0,17,30,30
1651129917614,MATH 20C,B01,083762,Staff,6,0,30,24
1651129917614,MATH 20C,B02,083763,Staff,28,0,30,2
1651129923638,MATH 20D,A01,083765,Tran; Brian Kha,4,1,30,26
1651129923638,MATH 20D,A02,083766,Tran; Brian Kha,0,0,30,30
1651129923638,MATH 20D,A03,083767,Tran; Brian Kha,21,0,30,9
1651129929663,MATH 20E,A01,083771,Staff,0,0,30,30
1651129929663,MATH 20E,A02,083772,Staff,9,0,30,21
1651129929663,MATH 20E,B01,083773,Staff,5,0,35,30
1651129929663,MATH 20E,B02,083774,Staff,4,0,35,31
1651129935687,MATH 103A,A01,083777,Greenfeld; Be'Eri,0,17,30,30
1651129935687,MATH 103A,A02,083778,Greenfeld; Be'Eri,0,18,30,30
1651129935687,MATH 103A,B01,083779,Greenfeld; Be'Eri,0,16,30,30
1651129935687,MATH 103A,B02,083780,Greenfeld; Be'Eri,0,15,30,30
1651129941717,MATH 105,A01,085443,Staff,0,24,30,30
1651129947741,MATH 109,A01,083213,Ganzberger; Geoffrey Michael,0,8,30,30
1651129947741,MATH 109,A02,083214,Ganzberger; Geoffrey Michael,0,7,30,30
1651129947741,MATH 109,B01,083215,Ganzberger; Geoffrey Michael,0,8,30,30
1651129947741,MATH 109,B02,083216,Ganzberger; Geoffrey Michael,0,7,30,30
1651129953772,MATH 142A,A01,083219,Chow; Bennett,0,16,30,30
1651129953772,MATH 142A,A02,083220,Chow; Bennett,0,15,30,30
1651129953772,MATH 142A,B01,083221,Chow; Bennett,0,16,30,30
1651129953772,MATH 142A,B02,083222,Chow; Bennett,0,15,30,30
1651129959796,MATH 193A,A01,083224,Staff,0,9,30,30
1651129959796,MATH 193A,A02,083225,Staff,0,7,30,30
1651129959796,MATH 193A,A03,083781,Staff,0,7,30,30
1651129959796,MATH 193A,A04,083782,Staff,0,7,30,30
1651129965819,MATH 197,001,091859,McAuley; Julian John,9998,0,9999,1
1651129971872,COGS 9,A01,083615,Staff,0,21,60,60
1651129977906,COGS 11,A01,083617,Boyle; Mary E. T.,13,0,40,27
1651129983930,COGS 13,A01,083071,Staff,0,39,40,40
1651129989959,COGS 14A,A01,092681,Staff,0,41,100,100
1651129995987,COGS 14B,A01,083073,Cheng; Tzu-Han,0,11,50,50
1651130002022,COGS 17,A01,092677,Staff,8,0,75,67
1651130008046,COGS 100,A01,083619,Staff,0,29,60,61
1651130014077,COGS 101A,A01,083621,Davis; Joshua Daniel,0,29,60,60
1651130020114,COGS 101B,A01,091572,Staff,0,8,60,60
1651130026142,COGS 101C,A01,083625,Delgado; Tania,12,0,30,18
1651130032171,COGS 107A,A01,083627,Boyle; Mary E. T.,0,17,60,60
1651130038206,COGS 118A,A01,083075,Staff,0,10,60,60
1651130044250,CSE 3,A50,083646,Miranda; Gregory Joseph,15,0,38,23
1651130044250,CSE 3,A51,083647,Miranda; Gregory Joseph,36,0,37,1
1651130050283,CSE 8A,A50,083650,Miranda; Gregory Joseph,0,30,40,40
1651130056311,CSE 11,A01,083080,Cao; Yingjun,0,98,40,40
1651130062335,CSE 12,A01,083652,Staff,0,30,100,100
1651130068380,CSE 15L,A01,083654,Staff,0,4,50,50
1651130068380,CSE 15L,A02,083655,Staff,0,3,50,50
1651130074405,CSE 20,A01,083657,Staff,47,0,80,33
1651130080436,CSE 30,A01,083084,Eldon; John,0,39,80,80
1651130086460,CSE 100,A01,083659,Cao; Yingjun,0,72,50,50
1651130092505,CSE 134B,A01,083661,Powell; Thomas Allan,0,38,65,65
1651130098538,CSE 140,A01,083663,Staff,0,17,75,75
1651130104567,CSE 140L,A01,083088,Eldon; John,1,0,100,99
1651130110594,CSE 175,A01,083665,Kumar; Rakesh,0,0,25,25
1651130116638,CSE 190,A00,092507,Dubnov; Shlomo,9,0,20,11
1651130122668,ECE 45,A01,083139,Staff,0,8,60,60
1651130128692,ECE 65,A50,083695,Staff,0,7,30,30
1651130134715,ECE 109,A01,091882,Touri; Behrouz,32,0,70,38
1651130140743,ECE 180,A00,083140,Abi Samra; Nicholas Camill,17,0,30,13
1651130140743,ECE 180,B00,083141,Abi Samra; Nicholas Camill,0,1,30,32
1651130146776,MATH 10A,A01,083735,Patchell; Gregory David,0,0,30,30
1651130146776,MATH 10A,A02,083736,Patchell; Gregory David,26,0,30,4
1651130146776,MATH 10A,A03,083737,Patchell; Gregory David,22,0,30,8
1651130152802,MATH 10B,A01,083207,Staff,0,8,30,30
1651130152802,MATH 10B,A02,083208,Staff,0,7,30,30
1651130152802,MATH 10B,B01,083739,Staff,7,0,30,23
1651130152802,MATH 10B,B02,083740,Staff,28,0,30,2
1651130158833,MATH 18,A01,083743,Staff,0,0,30,30
1651130158833,MATH 18,A02,083744,Staff,23,0,30,7
1651130158833,MATH 18,A03,083745,Staff,19,0,30,11
1651130158833,MATH 18,A04,083746,Staff,26,0,30,4
1651130158833,MATH 18,B01,083748,Staff,0,16,30,30
1651130158833,MATH 18,B02,083749,Staff,0,15,30,30
1651130158833,MATH 18,B03,083750,Staff,0,15,30,30
1651130158833,MATH 18,B04,083751,Staff,0,15,30,30
1651130164860,MATH 20A,A01,083754,Staff,18,0,40,22
1651130170888,MATH 20B,A01,083756,Briones; Jor-el Thomas Caparas,0,14,30,30
1651130170888,MATH 20B,A02,083757,Briones; Jor-el Thomas Caparas,0,11,30,30
1651130176926,MATH 20C,A01,083760,Briones; Jor-el Thomas Caparas,0,16,30,30
1651130176926,MATH 20C,A02,083761,Briones; Jor-el Thomas Caparas,0,17,30,30
1651130176926,MATH 20C,B01,083762,Staff,6,0,30,24
1651130176926,MATH 20C,B02,083763,Staff,28,0,30,2
1651130182950,MATH 20D,A01,083765,Tran; Brian Kha,4,1,30,26
1651130182950,MATH 20D,A02,083766,Tran; Brian Kha,0,0,30,30
1651130182950,MATH 20D,A03,083767,Tran; Brian Kha,21,0,30,9
1651130188975,MATH 20E,A01,083771,Staff,0,0,30,30
1651130188975,MATH 20E,A02,083772,Staff,9,0,30,21
1651130188975,MATH 20E,B01,083773,Staff,5,0,35,30
1651130188975,MATH 20E,B02,083774,Staff,4,0,35,31
1651130195022,MATH 103A,A01,083777,Greenfeld; Be'Eri,0,17,30,30
1651130195022,MATH 103A,A02,083778,Greenfeld; Be'Eri,0,18,30,30
1651130195022,MATH 103A,B01,083779,Greenfeld; Be'Eri,0,16,30,30
1651130195022,MATH 103A,B02,083780,Greenfeld; Be'Eri,0,15,30,30
1651130201063,MATH 105,A01,085443,Staff,0,24,30,30
1651130207087,MATH 109,A01,083213,Ganzberger; Geoffrey Michael,0,8,30,30
1651130207087,MATH 109,A02,083214,Ganzberger; Geoffrey Michael,0,7,30,30
1651130207087,MATH 109,B01,083215,Ganzberger; Geoffrey Michael,0,8,30,30
1651130207087,MATH 109,B02,083216,Ganzberger; Geoffrey Michael,0,7,30,30
1651130213114,MATH 142A,A01,083219,Chow; Bennett,0,16,30,30
1651130213114,MATH 142A,A02,083220,Chow; Bennett,0,15,30,30
1651130213114,MATH 142A,B01,083221,Chow; Bennett,0,16,30,30
1651130213114,MATH 142A,B02,083222,Chow; Bennett,0,15,30,30
1651130219137,MATH 193A,A01,083224,Staff,0,9,30,30
1651130219137,MATH 193A,A02,083225,Staff,0,7,30,30
1651130219137,MATH 193A,A03,083781,Staff,0,7,30,30
1651130219137,MATH 193A,A04,083782,Staff,0,7,30,30
1651130225166,MATH 197,001,091859,McAuley; Julian John,9998,0,9999,1
1651130231227,COGS 9,A01,083615,Staff,0,21,60,60
1651130237264,COGS 11,A01,083617,Boyle; Mary E. T.,13,0,40,27
1651130243288,COGS 13,A01,083071,Staff,0,39,40,40
1651130249312,COGS 14A,A01,092681,Staff,0,41,100,100
1651130255337,COGS 14B,A01,083073,Cheng; Tzu-Han,0,11,50,50
1651130261363,COGS 17,A01,092677,Staff,8,0,75,67
1651130267387,COGS 100,A01,083619,Staff,0,29,60,61
1651130273417,COGS 101A,A01,083621,Davis; Joshua Daniel,0,29,60,60
1651130279443,COGS 101B,A01,091572,Staff,0,8,60,60
1651130285472,COGS 101C,A01,083625,Delgado; Tania,12,0,30,18
1651130291494,COGS 107A,A01,083627,Boyle; Mary E. T.,0,17,60,60
1651130297521,COGS 118A,A01,083075,Staff,0,10,60,60
1651130303548,CSE 3,A50,083646,Miranda; Gregory Joseph,15,0,38,23
1651130303548,CSE 3,A51,083647,Miranda; Gregory Joseph,36,0,37,1
1651130309569,CSE 8A,A50,083650,Miranda; Gregory Joseph,0,30,40,40
1651130315593,CSE 11,A01,083080,Cao; Yingjun,0,98,40,40
1651130321709,CSE 12,A01,083652,Staff,0,30,100,100
1651130327735,CSE 15L,A01,083654,Staff,0,4,50,50
1651130327735,CSE 15L,A02,083655,Staff,0,3,50,50
1651130333760,CSE 20,A01,083657,Staff,47,0,80,33
1651130339789,CSE 30,A01,083084,Eldon; John,0,39,80,80
1651130345826,CSE 100,A01,083659,Cao; Yingjun,0,72,50,50
1651130351851,CSE 134B,A01,083661,Powell; Thomas Allan,0,38,65,65
1651130357882,CSE 140,A01,083663,Staff,0,17,75,75
1651130363908,CSE 140L,A01,083088,Eldon; John,1,0,100,99
1651130369933,CSE 175,A01,083665,Kumar; Rakesh,0,0,25,25
1651130375957,CSE 190,A00,092507,Dubnov; Shlomo,9,0,20,11
1651130381994,ECE 45,A01,083139,Staff,0,8,60,60
1651130388019,ECE 65,A50,083695,Staff,0,7,30,30
1651130394042,ECE 109,A01,091882,Touri; Behrouz,32,0,70,38
1651130400073,ECE 180,A00,083140,Abi Samra; Nicholas Camill,17,0,30,13
1651130400073,ECE 180,B00,083141,Abi Samra; Nicholas Camill,0,1,30,32
1651130406112,MATH 10A,A01,083735,Patchell; Gregory David,0,0,30,30
1651130406112,MATH 10A,A02,083736,Patchell; Gregory David,26,0,30,4
1651130406112,MATH 10A,A03,083737,Patchell; Gregory David,22,0,30,8
1651130412135,MATH 10B,A01,083207,Staff,0,8,30,30
1651130412135,MATH 10B,A02,083208,Staff,0,7,30,30
1651130412135,MATH 10B,B01,083739,Staff,7,0,30,23
1651130412135,MATH 10B,B02,083740,Staff,28,0,30,2
1651130418174,MATH 18,A01,083743,Staff,0,0,30,30
1651130418174,MATH 18,A02,083744,Staff,23,0,30,7
1651130418174,MATH 18,A03,083745,Staff,19,0,30,11
1651130418174,MATH 18,A04,083746,Staff,26,0,30,4
1651130418174,MATH 18,B01,083748,Staff,0,16,30,30
1651130418174,MATH 18,B02,083749,Staff,0,15,30,30
1651130418174,MATH 18,B03,083750,Staff,0,15,30,30
1651130418174,MATH 18,B04,083751,Staff,0,15,30,30
1651130424201,MATH 20A,A01,083754,Staff,18,0,40,22
1651130430233,MATH 20B,A01,083756,Briones; Jor-el Thomas Caparas,0,14,30,30
1651130430233,MATH 20B,A02,083757,Briones; Jor-el Thomas Caparas,0,11,30,30
1651130436267,MATH 20C,A01,083760,Briones; Jor-el Thomas Caparas,0,16,30,30
1651130436267,MATH 20C,A02,083761,Briones; Jor-el Thomas Caparas,0,17,30,30
1651130436267,MATH 20C,B01,083762,Staff,6,0,30,24
1651130436267,MATH 20C,B02,083763,Staff,28,0,30,2
1651130442291,MATH 20D,A01,083765,Tran; Brian Kha,4,1,30,26
1651130442291,MATH 20D,A02,083766,Tran; Brian Kha,0,0,30,30
1651130442291,MATH 20D,A03,083767,Tran; Brian Kha,21,0,30,9
1651130448325,MATH 20E,A01,083771,Staff,0,0,30,30
1651130448325,MATH 20E,A02,083772,Staff,9,0,30,21
1651130448325,MATH 20E,B01,083773,Staff,5,0,35,30
1651130448325,MATH 20E,B02,083774,Staff,4,0,35,31
1651130454352,MATH 103A,A01,083777,Greenfeld; Be'Eri,0,17,30,30
1651130454352,MATH 103A,A02,083778,Greenfeld; Be'Eri,0,18,30,30
1651130454352,MATH 103A,B01,083779,Greenfeld; Be'Eri,0,16,30,30
1651130454352,MATH 103A,B02,083780,Greenfeld; Be'Eri,0,15,30,30
1651130460376,MATH 105,A01,085443,Staff,0,24,30,30
1651130466400,MATH 109,A01,083213,Ganzberger; Geoffrey Michael,0,8,30,30
1651130466400,MATH 109,A02,083214,Ganzberger; Geoffrey Michael,0,7,30,30
1651130466400,MATH 109,B01,083215,Ganzberger; Geoffrey Michael,0,8,30,30
1651130466400,MATH 109,B02,083216,Ganzberger; Geoffrey Michael,0,7,30,30
1651130472426,MATH 142A,A01,083219,Chow; Bennett,0,16,30,30
1651130472426,MATH 142A,A02,083220,Chow; Bennett,0,15,30,30
1651130472426,MATH 142A,B01,083221,Chow; Bennett,0,16,30,30
1651130472426,MATH 142A,B02,083222,Chow; Bennett,0,15,30,30
1651130478456,MATH 193A,A01,083224,Staff,0,9,30,30
1651130478456,MATH 193A,A02,083225,Staff,0,7,30,30
1651130478456,MATH 193A,A03,083781,Staff,0,7,30,30
1651130478456,MATH 193A,A04,083782,Staff,0,7,30,30
1651130484480,MATH 197,001,091859,McAuley; Julian John,9998,0,9999,1
1651130490544,COGS 9,A01,083615,Staff,0,21,60,60
1651130496573,COGS 11,A01,083617,Boyle; Mary E. T.,13,0,40,27
1651130502602,COGS 13,A01,083071,Staff,0,39,40,40
1651130508630,COGS 14A,A01,092681,Staff,0,41,100,100
1651130514654,COGS 14B,A01,083073,Cheng; Tzu-Han,0,11,50,50
1651130520679,COGS 17,A01,092677,Staff,8,0,75,67
1651130526703,COGS 100,A01,083619,Staff,0,29,60,61
1651130532732,COGS 101A,A01,083621,Davis; Joshua Daniel,0,29,60,60
1651130538760,COGS 101B,A01,091572,Staff,0,8,60,60
1651130544789,COGS 101C,A01,083625,Delgado; Tania,12,0,30,18
1651130550818,COGS 107A,A01,083627,Boyle; Mary E. T.,0,17,60,60
1651130556842,COGS 118A,A01,083075,Staff,0,10,60,60
1651130562868,CSE 3,A50,083646,Miranda; Gregory Joseph,15,0,38,23
1651130562868,CSE 3,A51,083647,Miranda; Gregory Joseph,36,0,37,1
1651130568893,CSE 8A,A50,083650,Miranda; Gregory Joseph,0,30,40,40
1651130574917,CSE 11,A01,083080,Cao; Yingjun,0,98,40,40
1651130580944,CSE 12,A01,083652,Staff,0,30,100,100
1651130586971,CSE 15L,A01,083654,Staff,0,4,50,50
1651130586971,CSE 15L,A02,083655,Staff,0,3,50,50
1651130592995,CSE 20,A01,083657,Staff,47,0,80,33
1651130599023,CSE 30,A01,083084,Eldon; John,0,39,80,80
1651130605047,CSE 100,A01,083659,Cao; Yingjun,0,72,50,50
1651130611069,CSE 134B,A01,083661,Powell; Thomas Allan,0,38,65,65
1651130617092,CSE 140,A01,083663,Staff,0,17,75,75
1651130623116,CSE 140L,A01,083088,Eldon; John,1,0,100,99
1651130629140,CSE 175,A01,083665,Kumar; Rakesh,0,0,25,25
1651130635164,CSE 190,A00,092507,Dubnov; Shlomo,9,0,20,11
1651130641190,ECE 45,A01,083139,Staff,0,8,60,60
1651130647219,ECE 65,A50,083695,Staff,0,7,30,30
1651130653244,ECE 109,A01,091882,Touri; Behrouz,32,0,70,38
1651130659270,ECE 180,A00,083140,Abi Samra; Nicholas Camill,17,0,30,13
1651130659270,ECE 180,B00,083141,Abi Samra; Nicholas Camill,0,1,30,32
1651130665294,MATH 10A,A01,083735,Patchell; Gregory David,0,0,30,30
1651130665294,MATH 10A,A02,083736,Patchell; Gregory David,26,0,30,4
1651130665294,MATH 10A,A03,083737,Patchell; Gregory David,22,0,30,8
1651130671319,MATH 10B,A01,083207,Staff,0,8,30,30
1651130671319,MATH 10B,A02,083208,Staff,0,7,30,30
1651130671319,MATH 10B,B01,083739,Staff,7,0,30,23
1651130671319,MATH 10B,B02,083740,Staff,28,0,30,2
1651130677344,MATH 18,A01,083743,Staff,0,0,30,30
1651130677344,MATH 18,A02,083744,Staff,23,0,30,7
1651130677344,MATH 18,A03,083745,Staff,19,0,30,11
1651130677344,MATH 18,A04,083746,Staff,26,0,30,4
1651130677344,MATH 18,B01,083748,Staff,0,16,30,30
1651130677344,MATH 18,B02,083749,Staff,0,15,30,30
1651130677344,MATH 18,B03,083750,Staff,0,15,30,30
1651130677344,MATH 18,B04,083751,Staff,0,15,30,30
1651130683371,MATH 20A,A01,083754,Staff,18,0,40,22
1651130689396,MATH 20B,A01,083756,Briones; Jor-el Thomas Caparas,0,14,30,30
1651130689396,MATH 20B,A02,083757,Briones; Jor-el Thomas Caparas,0,11,30,30
1651130695420,MATH 20C,A01,083760,Briones; Jor-el Thomas Caparas,0,16,30,30
1651130695420,MATH 20C,A02,083761,Briones; Jor-el Thomas Caparas,0,17,30,30
1651130695420,MATH 20C,B01,083762,Staff,6,0,30,24
1651130695420,MATH 20C,B02,083763,Staff,28,0,30,2
1651130701445,MATH 20D,A01,083765,Tran; Brian Kha,4,1,30,26
1651130701445,MATH 20D,A02,083766,Tran; Brian Kha,0,0,30,30
1651130701445,MATH 20D,A03,083767,Tran; Brian Kha,21,0,30,9
1651130707470,MATH 20E,A01,083771,Staff,0,0,30,30
1651130707470,MATH 20E,A02,083772,Staff,9,0,30,21
1651130707470,MATH 20E,B01,083773,Staff,5,0,35,30
1651130707470,MATH 20E,B02,083774,Staff,4,0,35,31
1651130713511,MATH 103A,A01,083777,Greenfeld; Be'Eri,0,17,30,30
1651130713511,MATH 103A,A02,083778,Greenfeld; Be'Eri,0,18,30,30
1651130713511,MATH 103A,B01,083779,Greenfeld; Be'Eri,0,16,30,30
1651130713511,MATH 103A,B02,083780,Greenfeld; Be'Eri,0,15,30,30
1651130719535,MATH 105,A01,085443,Staff,0,24,30,30
1651130725560,MATH 109,A01,083213,Ganzberger; Geoffrey Michael,0,8,30,30
1651130725560,MATH 109,A02,083214,Ganzberger; Geoffrey Michael,0,7,30,30
1651130725560,MATH 109,B01,083215,Ganzberger; Geoffrey Michael,0,8,30,30
1651130725560,MATH 109,B02,083216,Ganzberger; Geoffrey Michael,0,7,30,30
1651130731588,MATH 142A,A01,083219,Chow; Bennett,0,16,30,30
1651130731588,MATH 142A,A02,083220,Chow; Bennett,0,15,30,30
1651130731588,MATH 142A,B01,083221,Chow; Bennett,0,16,30,30
1651130731588,MATH 142A,B02,083222,Chow; Bennett,0,15,30,30
1651130737614,MATH 193A,A01,083224,Staff,0,9,30,30
1651130737614,MATH 193A,A02,083225,Staff,0,7,30,30
1651130737614,MATH 193A,A03,083781,Staff,0,7,30,30
1651130737614,MATH 193A,A04,083782,Staff,0,7,30,30
1651130743641,MATH 197,001,091859,McAuley; Julian John,9998,0,9999,1
1651130749708,COGS 9,A01,083615,Staff,0,21,60,60
1651130755735,COGS 11,A01,083617,Boyle; Mary E. T.,13,0,40,27
1651130761774,COGS 13,A01,083071,Staff,0,39,40,40
1651130767800,COGS 14A,A01,092681,Staff,0,41,100,100
1651130773823,COGS 14B,A01,083073,Cheng; Tzu-Han,0,11,50,50
1651130779849,COGS 17,A01,092677,Staff,8,0,75,67
1651130785876,COGS 100,A01,083619,Staff,0,29,60,61
1651130791908,COGS 101A,A01,083621,Davis; Joshua Daniel,0,29,60,60
1651130797933,COGS 101B,A01,091572,Staff,0,8,60,60
1651130803957,COGS 101C,A01,083625,Delgado; Tania,12,0,30,18
1651130809980,COGS 107A,A01,083627,Boyle; Mary E. T.,0,17,60,60
1651130816005,COGS 118A,A01,083075,Staff,0,10,60,60
1651130822029,CSE 3,A50,083646,Miranda; Gregory Joseph,15,0,38,23
1651130822029,CSE 3,A51,083647,Miranda; Gregory Joseph,36,0,37,1
1651130828053,CSE 8A,A50,083650,Miranda; Gregory Joseph,0,30,40,40
1651130834077,CSE 11,A01,083080,Cao; Yingjun,0,98,40,40
1651130840112,CSE 12,A01,083652,Staff,0,30,100,100
1651130846137,CSE 15L,A01,083654,Staff,0,4,50,50
1651130846137,CSE 15L,A02,083655,Staff,0,3,50,50
1651130852161,CSE 20,A01,083657,Staff,47,0,80,33
1651130858185,CSE 30,A01,083084,Eldon; John,0,39,80,80
1651130864215,CSE 100,A01,083659,Cao; Yingjun,0,72,50,50
1651130870239,CSE 134B,A01,083661,Powell; Thomas Allan,0,38,65,65
1651130876265,CSE 140,A01,083663,Staff,0,17,75,75
1651130882292,CSE 140L,A01,083088,Eldon; John,1,0,100,99
1651130888319,CSE 175,A01,083665,Kumar; Rakesh,0,0,25,25
1651130894346,CSE 190,A00,092507,Dubnov; Shlomo,9,0,20,11
1651130900369,ECE 45,A01,083139,Staff,0,8,60,60
1651130906396,ECE 65,A50,083695,Staff,0,7,30,30
1651130912429,ECE 109,A01,091882,Touri; Behrouz,32,0,70,38
1651130918550,ECE 180,A00,083140,Abi Samra; Nicholas Camill,17,0,30,13
1651130918550,ECE 180,B00,083141,Abi Samra; Nicholas Camill,0,1,30,32
1651130924581,MATH 10A,A01,083735,Patchell; Gregory David,0,0,30,30
1651130924581,MATH 10A,A02,083736,Patchell; Gregory David,26,0,30,4
1651130924581,MATH 10A,A03,083737,Patchell; Gregory David,22,0,30,8
1651130930604,MATH 10B,A01,083207,Staff,0,8,30,30
1651130930604,MATH 10B,A02,083208,Staff,0,7,30,30
1651130930604,MATH 10B,B01,083739,Staff,7,0,30,23
1651130930604,MATH 10B,B02,083740,Staff,28,0,30,2
1651130936633,MATH 18,A01,083743,Staff,0,0,30,30
1651130936633,MATH 18,A02,083744,Staff,23,0,30,7
1651130936633,MATH 18,A03,083745,Staff,19,0,30,11
1651130936633,MATH 18,A04,083746,Staff,26,0,30,4
1651130936633,MATH 18,B01,083748,Staff,0,16,30,30
1651130936633,MATH 18,B02,083749,Staff,0,15,30,30
1651130936633,MATH 18,B03,083750,Staff,0,15,30,30
1651130936633,MATH 18,B04,083751,Staff,0,15,30,30
1651130942656,MATH 20A,A01,083754,Staff,18,0,40,22
1651130948680,MATH 20B,A01,083756,Briones; Jor-el Thomas Caparas,0,14,30,30
1651130948680,MATH 20B,A02,083757,Briones; Jor-el Thomas Caparas,0,11,30,30
1651130954723,MATH 20C,A01,083760,Briones; Jor-el Thomas Caparas,0,16,30,30
1651130954723,MATH 20C,A02,083761,Briones; Jor-el Thomas Caparas,0,17,30,30
1651130954723,MATH 20C,B01,083762,Staff,6,0,30,24
1651130954723,MATH 20C,B02,083763,Staff,28,0,30,2
1651130960752,MATH 20D,A01,083765,Tran; Brian Kha,4,1,30,26
1651130960752,MATH 20D,A02,083766,Tran; Brian Kha,0,0,30,30
1651130960752,MATH 20D,A03,083767,Tran; Brian Kha,21,0,30,9
1651130966777,MATH 20E,A01,083771,Staff,0,0,30,30
1651130966777,MATH 20E,A02,083772,Staff,9,0,30,21
1651130966777,MATH 20E,B01,083773,Staff,5,0,35,30
1651130966777,MATH 20E,B02,083774,Staff,4,0,35,31
1651130972807,MATH 103A,A01,083777,Greenfeld; Be'Eri,0,17,30,30
1651130972807,MATH 103A,A02,083778,Greenfeld; Be'Eri,0,18,30,30
1651130972807,MATH 103A,B01,083779,Greenfeld; Be'Eri,0,16,30,30
1651130972807,MATH 103A,B02,083780,Greenfeld; Be'Eri,0,15,30,30
1651130978834,MATH 105,A01,085443,Staff,0,24,30,30
1651130984858,MATH 109,A01,083213,Ganzberger; Geoffrey Michael,0,8,30,30
1651130984858,MATH 109,A02,083214,Ganzberger; Geoffrey Michael,0,7,30,30
1651130984858,MATH 109,B01,083215,Ganzberger; Geoffrey Michael,0,8,30,30
1651130984858,MATH 109,B02,083216,Ganzberger; Geoffrey Michael,0,7,30,30
1651130990884,MATH 142A,A01,083219,Chow; Bennett,0,16,30,30
1651130990884,MATH 142A,A02,083220,Chow; Bennett,0,15,30,30
1651130990884,MATH 142A,B01,083221,Chow; Bennett,0,16,30,30
1651130990884,MATH 142A,B02,083222,Chow; Bennett,0,15,30,30
1651130996908,MATH 193A,A01,083224,Staff,0,9,30,30
1651130996908,MATH 193A,A02,083225,Staff,0,7,30,30
1651130996908,MATH 193A,A03,083781,Staff,0,7,30,30
1651130996908,MATH 193A,A04,083782,Staff,0,7,30,30
1651131002931,MATH 197,001,091859,McAuley; Julian John,9998,0,9999,1
1651131008989,COGS 9,A01,083615,Staff,0,21,60,60
1651131015016,COGS 11,A01,083617,Boyle; Mary E. T.,13,0,40,27
1651131021042,COGS 13,A01,083071,Staff,0,39,40,40
1651131027066,COGS 14A,A01,092681,Staff,0,41,100,100
1651131033089,COGS 14B,A01,083073,Cheng; Tzu-Han,0,11,50,50
1651131039112,COGS 17,A01,092677,Staff,8,0,75,67
1651131045136,COGS 100,A01,083619,Staff,0,29,60,61
1651131051158,COGS 101A,A01,083621,Davis; Joshua Daniel,0,29,60,60
1651131057192,COGS 101B,A01,091572,Staff,0,8,60,60
1651131063220,COGS 101C,A01,083625,Delgado; Tania,12,0,30,18
1651131069249,COGS 107A,A01,083627,Boyle; Mary E. T.,0,17,60,60
1651131075274,COGS 118A,A01,083075,Staff,0,10,60,60
1651131081298,CSE 3,A50,083646,Miranda; Gregory Joseph,15,0,38,23
1651131081298,CSE 3,A51,083647,Miranda; Gregory Joseph,36,0,37,1
1651131087326,CSE 8A,A50,083650,Miranda; Gregory Joseph,0,30,40,40
1651131093351,CSE 11,A01,083080,Cao; Yingjun,0,98,40,40
1651131099390,CSE 12,A01,083652,Staff,0,30,100,100
1651131105415,CSE 15L,A01,083654,Staff,0,4,50,50
1651131105415,CSE 15L,A02,083655,Staff,0,3,50,50
1651131111440,CSE 20,A01,083657,Staff,47,0,80,33
1651131117466,CSE 30,A01,083084,Eldon; John,0,39,80,80
1651131123493,CSE 100,A01,083659,Cao; Yingjun,0,72,50,50
1651131129522,CSE 134B,A01,083661,Powell; Thomas Allan,0,38,65,65
1651131135546,CSE 140,A01,083663,Staff,0,17,75,75
1651131141570,CSE 140L,A01,083088,Eldon; John,1,0,100,99
1651131147595,CSE 175,A01,083665,Kumar; Rakesh,0,0,25,25
1651131153626,CSE 190,A00,092507,Dubnov; Shlomo,9,0,20,11
1651131159653,ECE 45,A01,083139,Staff,0,8,60,60
1651131165689,ECE 65,A50,083695,Staff,0,7,30,30
1651131171719,ECE 109,A01,091882,Touri; Behrouz,32,0,70,38
1651131177745,ECE 180,A00,083140,Abi Samra; Nicholas Camill,17,0,30,13
1651131177745,ECE 180,B00,083141,Abi Samra; Nicholas Camill,0,1,30,32
1651131183793,MATH 10A,A01,083735,Patchell; Gregory David,0,0,30,30
1651131183793,MATH 10A,A02,083736,Patchell; Gregory David,26,0,30,4
1651131183793,MATH 10A,A03,083737,Patchell; Gregory David,22,0,30,8
1651131189821,MATH 10B,A01,083207,Staff,0,8,30,30
1651131189821,MATH 10B,A02,083208,Staff,0,7,30,30
1651131189821,MATH 10B,B01,083739,Staff,7,0,30,23
1651131189821,MATH 10B,B02,083740,Staff,28,0,30,2
1651131195850,MATH 18,A01,083743,Staff,0,0,30,30
1651131195850,MATH 18,A02,083744,Staff,23,0,30,7
1651131195850,MATH 18,A03,083745,Staff,19,0,30,11
1651131195850,MATH 18,A04,083746,Staff,26,0,30,4
1651131195850,MATH 18,B01,083748,Staff,0,16,30,30
1651131195850,MATH 18,B02,083749,Staff,0,15,30,30
1651131195850,MATH 18,B03,083750,Staff,0,15,30,30
1651131195850,MATH 18,B04,083751,Staff,0,15,30,30
1651131201873,MATH 20A,A01,083754,Staff,18,0,40,22
1651131207897,MATH 20B,A01,083756,Briones; Jor-el Thomas Caparas,0,14,30,30
1651131207897,MATH 20B,A02,083757,Briones; Jor-el Thomas Caparas,0,11,30,30
1651131213929,MATH 20C,A01,083760,Briones; Jor-el Thomas Caparas,0,16,30,30
1651131213929,MATH 20C,A02,083761,Briones; Jor-el Thomas Caparas,0,17,30,30
1651131213929,MATH 20C,B01,083762,Staff,6,0,30,24
1651131213929,MATH 20C,B02,083763,Staff,28,0,30,2
1651131219957,MATH 20D,A01,083765,Tran; Brian Kha,4,1,30,26
1651131219957,MATH 20D,A02,083766,Tran; Brian Kha,0,0,30,30
1651131219957,MATH 20D,A03,083767,Tran; Brian Kha,21,0,30,9
1651131225989,MATH 20E,A01,083771,Staff,0,0,30,30
1651131225989,MATH 20E,A02,083772,Staff,9,0,30,21
1651131225989,MATH 20E,B01,083773,Staff,5,0,35,30
1651131225989,MATH 20E,B02,083774,Staff,4,0,35,31
1651131232027,MATH 103A,A01,083777,Greenfeld; Be'Eri,0,17,30,30
1651131232027,MATH 103A,A02,083778,Greenfeld; Be'Eri,0,18,30,30
1651131232027,MATH 103A,B01,083779,Greenfeld; Be'Eri,0,16,30,30
1651131232027,MATH 103A,B02,083780,Greenfeld; Be'Eri,0,15,30,30
1651131238057,MATH 105,A01,085443,Staff,0,24,30,30
1651131244084,MATH 109,A01,083213,Ganzberger; Geoffrey Michael,0,8,30,30
1651131244084,MATH 109,A02,083214,Ganzberger; Geoffrey Michael,0,7,30,30
1651131244084,MATH 109,B01,083215,Ganzberger; Geoffrey Michael,0,8,30,30
1651131244084,MATH 109,B02,083216,Ganzberger; Geoffrey Michael,0,7,30,30
1651131250113,MATH 142A,A01,083219,Chow; Bennett,0,16,30,30
1651131250113,MATH 142A,A02,083220,Chow; Bennett,0,15,30,30
1651131250113,MATH 142A,B01,083221,Chow; Bennett,0,16,30,30
1651131250113,MATH 142A,B02,083222,Chow; Bennett,0,15,30,30
1651131256141,MATH 193A,A01,083224,Staff,0,9,30,30
1651131256141,MATH 193A,A02,083225,Staff,0,7,30,30
1651131256141,MATH 193A,A03,083781,Staff,0,7,30,30
1651131256141,MATH 193A,A04,083782,Staff,0,7,30,30
1651131262165,MATH 197,001,091859,McAuley; Julian John,9998,0,9999,1
1651131268245,COGS 9,A01,083615,Staff,0,21,60,60
1651131274277,COGS 11,A01,083617,Boyle; Mary E. T.,13,0,40,27
1651131280301,COGS 13,A01,083071,Staff,0,39,40,40
1651131286330,COGS 14A,A01,092681,Staff,0,41,100,100
1651131292354,COGS 14B,A01,083073,Cheng; Tzu-Han,0,11,50,50
1651131298378,COGS 17,A01,092677,Staff,8,0,75,67
1651131304406,COGS 100,A01,083619,Staff,0,29,60,61
1651131310434,COGS 101A,A01,083621,Davis; Joshua Daniel,0,29,60,60
1651131316459,COGS 101B,A01,091572,Staff,0,8,60,60
1651131322489,COGS 101C,A01,083625,Delgado; Tania,12,0,30,18
1651131328514,COGS 107A,A01,083627,Boyle; Mary E. T.,0,17,60,60
1651131334542,COGS 118A,A01,083075,Staff,0,10,60,60
1651131340574,CSE 3,A50,083646,Miranda; Gregory Joseph,15,0,38,23
1651131340574,CSE 3,A51,083647,Miranda; Gregory Joseph,36,0,37,1
1651131346607,CSE 8A,A50,083650,Miranda; Gregory Joseph,0,30,40,40
1651131352634,CSE 11,A01,083080,Cao; Yingjun,0,98,40,40
1651131358658,CSE 12,A01,083652,Staff,0,30,100,100
1651131364683,CSE 15L,A01,083654,Staff,0,4,50,50
1651131364683,CSE 15L,A02,083655,Staff,0,3,50,50
1651131370706,CSE 20,A01,083657,Staff,47,0,80,33
1651131376743,CSE 30,A01,083084,Eldon; John,0,39,80,80
1651131382769,CSE 100,A01,083659,Cao; Yingjun,0,72,50,50
1651131388797,CSE 134B,A01,083661,Powell; Thomas Allan,0,38,65,65
1651131394822,CSE 140,A01,083663,Staff,0,17,75,75
1651131400845,CSE 140L,A01,083088,Eldon; John,1,0,100,99
1651131406880,CSE 175,A01,083665,Kumar; Rakesh,0,0,25,25
1651131412903,CSE 190,A00,092507,Dubnov; Shlomo,9,0,20,11
1651131418928,ECE 45,A01,083139,Staff,0,8,60,60
1651131424953,ECE 65,A50,083695,Staff,0,7,30,30
1651131430982,ECE 109,A01,091882,Touri; Behrouz,32,0,70,38
1651131437008,ECE 180,A00,083140,Abi Samra; Nicholas Camill,17,0,30,13
1651131437008,ECE 180,B00,083141,Abi Samra; Nicholas Camill,0,1,30,32
1651131443035,MATH 10A,A01,083735,Patchell; Gregory David,0,0,30,30
1651131443035,MATH 10A,A02,083736,Patchell; Gregory David,26,0,30,4
1651131443035,MATH 10A,A03,083737,Patchell; Gregory David,22,0,30,8
1651131449071,MATH 10B,A01,083207,Staff,0,8,30,30
1651131449071,MATH 10B,A02,083208,Staff,0,7,30,30
1651131449071,MATH 10B,B01,083739,Staff,7,0,30,23
1651131449071,MATH 10B,B02,083740,Staff,28,0,30,2
1651131455131,MATH 18,A01,083743,Staff,0,0,30,30
1651131455131,MATH 18,A02,083744,Staff,23,0,30,7
1651131455131,MATH 18,A03,083745,Staff,19,0,30,11
1651131455131,MATH 18,A04,083746,Staff,26,0,30,4
1651131455131,MATH 18,B01,083748,Staff,0,16,30,30
1651131455131,MATH 18,B02,083749,Staff,0,15,30,30
1651131455131,MATH 18,B03,083750,Staff,0,15,30,30
1651131455131,MATH 18,B04,083751,Staff,0,15,30,30
1651131461156,MATH 20A,A01,083754,Staff,18,0,40,22
1651131467189,MATH 20B,A01,083756,Briones; Jor-el Thomas Caparas,0,14,30,30
1651131467189,MATH 20B,A02,083757,Briones; Jor-el Thomas Caparas,0,11,30,30
1651131473218,MATH 20C,A01,083760,Briones; Jor-el Thomas Caparas,0,16,30,30
1651131473218,MATH 20C,A02,083761,Briones; Jor-el Thomas Caparas,0,17,30,30
1651131473218,MATH 20C,B01,083762,Staff,6,0,30,24
1651131473218,MATH 20C,B02,083763,Staff,28,0,30,2
1651131479244,MATH 20D,A01,083765,Tran; Brian Kha,4,1,30,26
1651131479244,MATH 20D,A02,083766,Tran; Brian Kha,0,0,30,30
1651131479244,MATH 20D,A03,083767,Tran; Brian Kha,21,0,30,9
1651131485272,MATH 20E,A01,083771,Staff,0,0,30,30
1651131485272,MATH 20E,A02,083772,Staff,9,0,30,21
1651131485272,MATH 20E,B01,083773,Staff,5,0,35,30
1651131485272,MATH 20E,B02,083774,Staff,4,0,35,31
1651131491308,MATH 103A,A01,083777,Greenfeld; Be'Eri,0,17,30,30
1651131491308,MATH 103A,A02,083778,Greenfeld; Be'Eri,0,18,30,30
1651131491308,MATH 103A,B01,083779,Greenfeld; Be'Eri,0,16,30,30
1651131491308,MATH 103A,B02,083780,Greenfeld; Be'Eri,0,15,30,30
1651131497332,MATH 105,A01,085443,Staff,0,24,30,30
1651131503363,MATH 109,A01,083213,Ganzberger; Geoffrey Michael,0,8,30,30
1651131503363,MATH 109,A02,083214,Ganzberger; Geoffrey Michael,0,7,30,30
1651131503363,MATH 109,B01,083215,Ganzberger; Geoffrey Michael,0,8,30,30
1651131503363,MATH 109,B02,083216,Ganzberger; Geoffrey Michael,0,7,30,30
1651131509397,MATH 142A,A01,083219,Chow; Bennett,0,16,30,30
1651131509397,MATH 142A,A02,083220,Chow; Bennett,0,15,30,30
1651131509397,MATH 142A,B01,083221,Chow; Bennett,0,16,30,30
1651131509397,MATH 142A,B02,083222,Chow; Bennett,0,15,30,30
1651131515508,MATH 193A,A01,083224,Staff,0,9,30,30
1651131515508,MATH 193A,A02,083225,Staff,0,7,30,30
1651131515508,MATH 193A,A03,083781,Staff,0,7,30,30
1651131515508,MATH 193A,A04,083782,Staff,0,7,30,30
1651131521533,MATH 197,001,091859,McAuley; Julian John,9998,0,9999,1
1651131527603,COGS 9,A01,083615,Staff,0,21,60,60
1651131533635,COGS 11,A01,083617,Boyle; Mary E. T.,13,0,40,27
1651131539662,COGS 13,A01,083071,Staff,0,39,40,40
1651131545689,COGS 14A,A01,092681,Staff,0,41,100,100
1651131551718,COGS 14B,A01,083073,Cheng; Tzu-Han,0,11,50,50
1651131557742,COGS 17,A01,092677,Staff,8,0,75,67
1651131563771,COGS 100,A01,083619,Staff,0,29,60,61
1651131569800,COGS 101A,A01,083621,Davis; Joshua Daniel,0,29,60,60
1651131575826,COGS 101B,A01,091572,Staff,0,8,60,60
1651131581854,COGS 101C,A01,083625,Delgado; Tania,12,0,30,18
1651131587880,COGS 107A,A01,083627,Boyle; Mary E. T.,0,17,60,60
1651131593903,COGS 118A,A01,083075,Staff,0,10,60,60
1651131599928,CSE 3,A50,083646,Miranda; Gregory Joseph,15,0,38,23
1651131599928,CSE 3,A51,083647,Miranda; Gregory Joseph,36,0,37,1
1651131605965,CSE 8A,A50,083650,Miranda; Gregory Joseph,0,30,40,40
1651131611989,CSE 11,A01,083080,Cao; Yingjun,0,98,40,40
1651131618013,CSE 12,A01,083652,Staff,0,30,100,100
1651131624045,CSE 15L,A01,083654,Staff,0,4,50,50
1651131624045,CSE 15L,A02,083655,Staff,0,3,50,50
1651131630070,CSE 20,A01,083657,Staff,47,0,80,33
1651131636099,CSE 30,A01,083084,Eldon; John,0,39,80,80
1651131642128,CSE 100,A01,083659,Cao; Yingjun,0,72,50,50
1651131648151,CSE 134B,A01,083661,Powell; Thomas Allan,0,38,65,65
1651131654185,CSE 140,A01,083663,Staff,0,17,75,75
1651131660218,CSE 140L,A01,083088,Eldon; John,1,0,100,99
1651131666243,CSE 175,A01,083665,Kumar; Rakesh,0,0,25,25
1651131672269,CSE 190,A00,092507,Dubnov; Shlomo,9,0,20,11
1651131678299,ECE 45,A01,083139,Staff,0,8,60,60
1651131684329,ECE 65,A50,083695,Staff,0,7,30,30
1651131690355,ECE 109,A01,091882,Touri; Behrouz,32,0,70,38
1651131696381,ECE 180,A00,083140,Abi Samra; Nicholas Camill,17,0,30,13
1651131696381,ECE 180,B00,083141,Abi Samra; Nicholas Camill,0,1,30,32
1651131702415,MATH 10A,A01,083735,Patchell; Gregory David,0,0,30,30
1651131702415,MATH 10A,A02,083736,Patchell; Gregory David,26,0,30,4
1651131702415,MATH 10A,A03,083737,Patchell; Gregory David,22,0,30,8
1651131708441,MATH 10B,A01,083207,Staff,0,8,30,30
1651131708441,MATH 10B,A02,083208,Staff,0,7,30,30
1651131708441,MATH 10B,B01,083739,Staff,7,0,30,23
1651131708441,MATH 10B,B02,083740,Staff,28,0,30,2
1651131714476,MATH 18,A01,083743,Staff,0,0,30,30
1651131714476,MATH 18,A02,083744,Staff,23,0,30,7
1651131714476,MATH 18,A03,083745,Staff,19,0,30,11
1651131714476,MATH 18,A04,083746,Staff,26,0,30,4
1651131714476,MATH 18,B01,083748,Staff,0,16,30,30
1651131714476,MATH 18,B02,083749,Staff,0,15,30,30
1651131714476,MATH 18,B03,083750,Staff,0,15,30,30
1651131714476,MATH 18,B04,083751,Staff,0,15,30,30
1651131720515,MATH 20A,A01,083754,Staff,18,0,40,22
1651131726551,MATH 20B,A01,083756,Briones; Jor-el Thomas Caparas,0,14,30,30
1651131726551,MATH 20B,A02,083757,Briones; Jor-el Thomas Caparas,0,11,30,30
1651131732583,MATH 20C,A01,083760,Briones; Jor-el Thomas Caparas,0,16,30,30
1651131732583,MATH 20C,A02,083761,Briones; Jor-el Thomas Caparas,0,17,30,30
1651131732583,MATH 20C,B01,083762,Staff,6,0,30,24
1651131732583,MATH 20C,B02,083763,Staff,28,0,30,2
1651131738610,MATH 20D,A01,083765,Tran; Brian Kha,4,1,30,26
1651131738610,MATH 20D,A02,083766,Tran; Brian Kha,0,0,30,30
1651131738610,MATH 20D,A03,083767,Tran; Brian Kha,21,0,30,9
1651131744637,MATH 20E,A01,083771,Staff,0,0,30,30
1651131744637,MATH 20E,A02,083772,Staff,9,0,30,21
1651131744637,MATH 20E,B01,083773,Staff,5,0,35,30
1651131744637,MATH 20E,B02,083774,Staff,4,0,35,31
1651131750680,MATH 103A,A01,083777,Greenfeld; Be'Eri,0,17,30,30
1651131750680,MATH 103A,A02,083778,Greenfeld; Be'Eri,0,18,30,30
1651131750680,MATH 103A,B01,083779,Greenfeld; Be'Eri,0,16,30,30
1651131750680,MATH 103A,B02,083780,Greenfeld; Be'Eri,0,15,30,30
1651131756709,MATH 105,A01,085443,Staff,0,24,30,30
1651131762736,MATH 109,A01,083213,Ganzberger; Geoffrey Michael,0,8,30,30
1651131762736,MATH 109,A02,083214,Ganzberger; Geoffrey Michael,0,7,30,30
1651131762736,MATH 109,B01,083215,Ganzberger; Geoffrey Michael,0,8,30,30
1651131762736,MATH 109,B02,083216,Ganzberger; Geoffrey Michael,0,7,30,30
1651131768763,MATH 142A,A01,083219,Chow; Bennett,0,16,30,30
1651131768763,MATH 142A,A02,083220,Chow; Bennett,0,15,30,30
1651131768763,MATH 142A,B01,083221,Chow; Bennett,0,16,30,30
1651131768763,MATH 142A,B02,083222,Chow; Bennett,0,15,30,30
1651131774787,MATH 193A,A01,083224,Staff,0,9,30,30
1651131774787,MATH 193A,A02,083225,Staff,0,7,30,30
1651131774787,MATH 193A,A03,083781,Staff,0,7,30,30
1651131774787,MATH 193A,A04,083782,Staff,0,7,30,30
1651131780814,MATH 197,001,091859,McAuley; Julian John,9998,0,9999,1
1651131786897,COGS 9,A01,083615,Staff,0,21,60,60
1651131792922,COGS 11,A01,083617,Boyle; Mary E. T.,13,0,40,27
1651131798947,COGS 13,A01,083071,Staff,0,39,40,40
1651131804986,COGS 14A,A01,092681,Staff,0,41,100,100
1651131811010,COGS 14B,A01,083073,Cheng; Tzu-Han,0,11,50,50
1651131817037,COGS 17,A01,092677,Staff,8,0,75,67
1651131823061,COGS 100,A01,083619,Staff,0,29,60,61
1651131829093,COGS 101A,A01,083621,Davis; Joshua Daniel,0,29,60,60
1651131835119,COGS 101B,A01,091572,Staff,0,8,60,60
1651131841146,COGS 101C,A01,083625,Delgado; Tania,12,0,30,18
1651131847172,COGS 107A,A01,083627,Boyle; Mary E. T.,0,17,60,60
1651131853203,COGS 118A,A01,083075,Staff,0,10,60,60
1651131859236,CSE 3,A50,083646,Miranda; Gregory Joseph,15,0,38,23
1651131859236,CSE 3,A51,083647,Miranda; Gregory Joseph,36,0,37,1
1651131865264,CSE 8A,A50,083650,Miranda; Gregory Joseph,0,30,40,40
1651131871293,CSE 11,A01,083080,Cao; Yingjun,0,98,40,40
1651131877318,CSE 12,A01,083652,Staff,0,30,100,100
1651131883346,CSE 15L,A01,083654,Staff,0,4,50,50
1651131883346,CSE 15L,A02,083655,Staff,0,3,50,50
1651131889382,CSE 20,A01,083657,Staff,47,0,80,33
1651131895407,CSE 30,A01,083084,Eldon; John,0,39,80,80
1651131901437,CSE 100,A01,083659,Cao; Yingjun,0,72,50,50
1651131907462,CSE 134B,A01,083661,Powell; Thomas Allan,0,38,65,65
1651131913487,CSE 140,A01,083663,Staff,0,17,75,75
1651131919515,CSE 140L,A01,083088,Eldon; John,1,0,100,99
1651131925540,CSE 175,A01,083665,Kumar; Rakesh,0,0,25,25
1651131931566,CSE 190,A00,092507,Dubnov; Shlomo,9,0,20,11
1651131937594,ECE 45,A01,083139,Staff,0,8,60,60
1651131943619,ECE 65,A50,083695,Staff,0,7,30,30
1651131949645,ECE 109,A01,091882,Touri; Behrouz,32,0,70,38
1651131955671,ECE 180,A00,083140,Abi Samra; Nicholas Camill,17,0,30,13
1651131955671,ECE 180,B00,083141,Abi Samra; Nicholas Camill,0,1,30,32
1651131961700,MATH 10A,A01,083735,Patchell; Gregory David,0,0,30,30
1651131961700,MATH 10A,A02,083736,Patchell; Gregory David,26,0,30,4
1651131961700,MATH 10A,A03,083737,Patchell; Gregory David,22,0,30,8
1651131967757,MATH 10B,A01,083207,Staff,0,8,30,30
1651131967757,MATH 10B,A02,083208,Staff,0,7,30,30
1651131967757,MATH 10B,B01,083739,Staff,7,0,30,23
1651131967757,MATH 10B,B02,083740,Staff,28,0,30,2
1651131973799,MATH 18,A01,083743,Staff,0,0,30,30
1651131973799,MATH 18,A02,083744,Staff,23,0,30,7
1651131973799,MATH 18,A03,083745,Staff,19,0,30,11
1651131973799,MATH 18,A04,083746,Staff,26,0,30,4
1651131973799,MATH 18,B01,083748,Staff,0,16,30,30
1651131973799,MATH 18,B02,083749,Staff,0,15,30,30
1651131973799,MATH 18,B03,083750,Staff,0,15,30,30
1651131973799,MATH 18,B04,083751,Staff,0,15,30,30
1651131979824,MATH 20A,A01,083754,Staff,18,0,40,22
1651131985857,MATH 20B,A01,083756,Briones; Jor-el Thomas Caparas,0,14,30,30
1651131985857,MATH 20B,A02,083757,Briones; Jor-el Thomas Caparas,0,11,30,30
1651131991889,MATH 20C,A01,083760,Briones; Jor-el Thomas Caparas,0,16,30,30
1651131991889,MATH 20C,A02,083761,Briones; Jor-el Thomas Caparas,0,17,30,30
1651131991889,MATH 20C,B01,083762,Staff,6,0,30,24
1651131991889,MATH 20C,B02,083763,Staff,28,0,30,2
1651131997921,MATH 20D,A01,083765,Tran; Brian Kha,4,1,30,26
1651131997921,MATH 20D,A02,083766,Tran; Brian Kha,0,0,30,30
1651131997921,MATH 20D,A03,083767,Tran; Brian Kha,21,0,30,9
1651132003947,MATH 20E,A01,083771,Staff,0,0,30,30
1651132003947,MATH 20E,A02,083772,Staff,9,0,30,21
1651132003947,MATH 20E,B01,083773,Staff,5,0,35,30
1651132003947,MATH 20E,B02,083774,Staff,4,0,35,31
1651132009977,MATH 103A,A01,083777,Greenfeld; Be'Eri,0,17,30,30
1651132009977,MATH 103A,A02,083778,Greenfeld; Be'Eri,0,18,30,30
1651132009977,MATH 103A,B01,083779,Greenfeld; Be'Eri,0,16,30,30
1651132009977,MATH 103A,B02,083780,Greenfeld; Be'Eri,0,15,30,30
1651132016004,MATH 105,A01,085443,Staff,0,24,30,30
1651132022035,MATH 109,A01,083213,Ganzberger; Geoffrey Michael,0,8,30,30
1651132022035,MATH 109,A02,083214,Ganzberger; Geoffrey Michael,0,7,30,30
1651132022035,MATH 109,B01,083215,Ganzberger; Geoffrey Michael,0,8,30,30
1651132022035,MATH 109,B02,083216,Ganzberger; Geoffrey Michael,0,7,30,30
1651132028073,MATH 142A,A01,083219,Chow; Bennett,0,16,30,30
1651132028073,MATH 142A,A02,083220,Chow; Bennett,0,15,30,30
1651132028073,MATH 142A,B01,083221,Chow; Bennett,0,16,30,30
1651132028073,MATH 142A,B02,083222,Chow; Bennett,0,15,30,30
1651132034099,MATH 193A,A01,083224,Staff,0,9,30,30
1651132034099,MATH 193A,A02,083225,Staff,0,7,30,30
1651132034099,MATH 193A,A03,083781,Staff,0,7,30,30
1651132034099,MATH 193A,A04,083782,Staff,0,7,30,30
1651132040123,MATH 197,001,091859,McAuley; Julian John,9998,0,9999,1
1651132046197,COGS 9,A01,083615,Staff,0,21,60,60
1651132052229,COGS 11,A01,083617,Boyle; Mary E. T.,13,0,40,27
1651132058258,COGS 13,A01,083071,Staff,0,39,40,40
1651132064288,COGS 14A,A01,092681,Staff,0,41,100,100
1651132070313,COGS 14B,A01,083073,Cheng; Tzu-Han,0,11,50,50
1651132076336,COGS 17,A01,092677,Staff,8,0,75,67
1651132082363,COGS 100,A01,083619,Staff,0,29,60,61
1651132088389,COGS 101A,A01,083621,Davis; Joshua Daniel,0,29,60,60
1651132094414,COGS 101B,A01,091572,Staff,0,8,60,60
1651132100456,COGS 101C,A01,083625,Delgado; Tania,12,0,30,18
1651132106575,COGS 107A,A01,083627,Boyle; Mary E. T.,0,17,60,60
1651132112598,COGS 118A,A01,083075,Staff,0,10,60,60
1651132118630,CSE 3,A50,083646,Miranda; Gregory Joseph,15,0,38,23
1651132118630,CSE 3,A51,083647,Miranda; Gregory Joseph,36,0,37,1
1651132124660,CSE 8A,A50,083650,Miranda; Gregory Joseph,0,30,40,40
1651132130684,CSE 11,A01,083080,Cao; Yingjun,0,98,40,40
1651132136708,CSE 12,A01,083652,Staff,0,30,100,100
1651132142732,CSE 15L,A01,083654,Staff,0,4,50,50
1651132142732,CSE 15L,A02,083655,Staff,0,3,50,50
1651132148765,CSE 20,A01,083657,Staff,47,0,80,33
1651132154789,CSE 30,A01,083084,Eldon; John,0,39,80,80
1651132160819,CSE 100,A01,083659,Cao; Yingjun,0,72,50,50
1651132166848,CSE 134B,A01,083661,Powell; Thomas Allan,0,38,65,65
1651132172872,CSE 140,A01,083663,Staff,0,17,75,75
1651132178905,CSE 140L,A01,083088,Eldon; John,1,0,100,99
1651132184928,CSE 175,A01,083665,Kumar; Rakesh,0,0,25,25
1651132190954,CSE 190,A00,092507,Dubnov; Shlomo,9,0,20,11
1651132196982,ECE 45,A01,083139,Staff,0,8,60,60
1651132203016,ECE 65,A50,083695,Staff,0,7,30,30
1651132209045,ECE 109,A01,091882,Touri; Behrouz,32,0,70,38
1651132215072,ECE 180,A00,083140,Abi Samra; Nicholas Camill,17,0,30,13
1651132215072,ECE 180,B00,083141,Abi Samra; Nicholas Camill,0,1,30,32
1651132221099,MATH 10A,A01,083735,Patchell; Gregory David,0,0,30,30
1651132221099,MATH 10A,A02,083736,Patchell; Gregory David,26,0,30,4
1651132221099,MATH 10A,A03,083737,Patchell; Gregory David,22,0,30,8
1651132227126,MATH 10B,A01,083207,Staff,0,8,30,30
1651132227126,MATH 10B,A02,083208,Staff,0,7,30,30
1651132227126,MATH 10B,B01,083739,Staff,7,0,30,23
1651132227126,MATH 10B,B02,083740,Staff,28,0,30,2
1651132233153,MATH 18,A01,083743,Staff,0,0,30,30
1651132233153,MATH 18,A02,083744,Staff,23,0,30,7
1651132233153,MATH 18,A03,083745,Staff,19,0,30,11
1651132233153,MATH 18,A04,083746,Staff,26,0,30,4
1651132233153,MATH 18,B01,083748,Staff,0,16,30,30
1651132233153,MATH 18,B02,083749,Staff,0,15,30,30
1651132233153,MATH 18,B03,083750,Staff,0,15,30,30
1651132233153,MATH 18,B04,083751,Staff,0,15,30,30
1651132239178,MATH 20A,A01,083754,Staff,18,0,40,22
1651132245211,MATH 20B,A01,083756,Briones; Jor-el Thomas Caparas,0,14,30,30
1651132245211,MATH 20B,A02,083757,Briones; Jor-el Thomas Caparas,0,11,30,30
1651132251242,MATH 20C,A01,083760,Briones; Jor-el Thomas Caparas,0,16,30,30
1651132251242,MATH 20C,A02,083761,Briones; Jor-el Thomas Caparas,0,17,30,30
1651132251242,MATH 20C,B01,083762,Staff,6,0,30,24
1651132251242,MATH 20C,B02,083763,Staff,28,0,30,2
1651132257267,MATH 20D,A01,083765,Tran; Brian Kha,4,1,30,26
1651132257267,MATH 20D,A02,083766,Tran; Brian Kha,0,0,30,30
1651132257267,MATH 20D,A03,083767,Tran; Brian Kha,21,0,30,9
1651132263301,MATH 20E,A01,083771,Staff,0,0,30,30
1651132263301,MATH 20E,A02,083772,Staff,9,0,30,21
1651132263301,MATH 20E,B01,083773,Staff,5,0,35,30
1651132263301,MATH 20E,B02,083774,Staff,4,0,35,31
1651132269328,MATH 103A,A01,083777,Greenfeld; Be'Eri,0,17,30,30
1651132269328,MATH 103A,A02,083778,Greenfeld; Be'Eri,0,18,30,30
1651132269328,MATH 103A,B01,083779,Greenfeld; Be'Eri,0,16,30,30
1651132269328,MATH 103A,B02,083780,Greenfeld; Be'Eri,0,15,30,30
1651132275353,MATH 105,A01,085443,Staff,0,24,30,30
1651132281380,MATH 109,A01,083213,Ganzberger; Geoffrey Michael,0,8,30,30
1651132281380,MATH 109,A02,083214,Ganzberger; Geoffrey Michael,0,7,30,30
1651132281380,MATH 109,B01,083215,Ganzberger; Geoffrey Michael,0,8,30,30
1651132281380,MATH 109,B02,083216,Ganzberger; Geoffrey Michael,0,7,30,30
1651132287410,MATH 142A,A01,083219,Chow; Bennett,0,16,30,30
1651132287410,MATH 142A,A02,083220,Chow; Bennett,0,15,30,30
1651132287410,MATH 142A,B01,083221,Chow; Bennett,0,16,30,30
1651132287410,MATH 142A,B02,083222,Chow; Bennett,0,15,30,30
1651132293434,MATH 193A,A01,083224,Staff,0,9,30,30
1651132293434,MATH 193A,A02,083225,Staff,0,7,30,30
1651132293434,MATH 193A,A03,083781,Staff,0,7,30,30
1651132293434,MATH 193A,A04,083782,Staff,0,7,30,30
1651132299463,MATH 197,001,091859,McAuley; Julian John,9998,0,9999,1
1651132305530,COGS 9,A01,083615,Staff,0,21,60,60
1651132311554,COGS 11,A01,083617,Boyle; Mary E. T.,13,0,40,27
1651132317584,COGS 13,A01,083071,Staff,0,39,40,40
1651132323609,COGS 14A,A01,092681,Staff,0,41,100,100
1651132329640,COGS 14B,A01,083073,Cheng; Tzu-Han,0,11,50,50
1651132335670,COGS 17,A01,092677,Staff,8,0,75,67
1651132341702,COGS 100,A01,083619,Staff,0,29,60,61
1651132347727,COGS 101A,A01,083621,Davis; Joshua Daniel,0,29,60,60
1651132353755,COGS 101B,A01,091572,Staff,0,8,60,60
1651132359785,COGS 101C,A01,083625,Delgado; Tania,12,0,30,18
1651132365808,COGS 107A,A01,083627,Boyle; Mary E. T.,0,17,60,60
1651132371834,COGS 118A,A01,083075,Staff,0,10,60,60
1651132377878,CSE 3,A50,083646,Miranda; Gregory Joseph,15,0,38,23
1651132377878,CSE 3,A51,083647,Miranda; Gregory Joseph,36,0,37,1
1651132383901,CSE 8A,A50,083650,Miranda; Gregory Joseph,0,30,40,40
1651132389930,CSE 11,A01,083080,Cao; Yingjun,0,98,40,40
1651132395958,CSE 12,A01,083652,Staff,0,30,100,100
1651132401983,CSE 15L,A01,083654,Staff,0,4,50,50
1651132401983,CSE 15L,A02,083655,Staff,0,3,50,50
1651132408009,CSE 20,A01,083657,Staff,47,0,80,33
1651132414037,CSE 30,A01,083084,Eldon; John,0,39,80,80
1651132420062,CSE 100,A01,083659,Cao; Yingjun,0,72,50,50
1651132426087,CSE 134B,A01,083661,Powell; Thomas Allan,0,38,65,65
1651132432111,CSE 140,A01,083663,Staff,0,17,75,75
1651132438137,CSE 140L,A01,083088,Eldon; John,1,0,100,99
1651132444161,CSE 175,A01,083665,Kumar; Rakesh,0,0,25,25
1651132450186,CSE 190,A00,092507,Dubnov; Shlomo,9,0,20,11
1651132456211,ECE 45,A01,083139,Staff,0,8,60,60
1651132462235,ECE 65,A50,083695,Staff,0,7,30,30
1651132468261,ECE 109,A01,091882,Touri; Behrouz,32,0,70,38
1651132474291,ECE 180,A00,083140,Abi Samra; Nicholas Camill,17,0,30,13
1651132474291,ECE 180,B00,083141,Abi Samra; Nicholas Camill,0,1,30,32
1651132480319,MATH 10A,A01,083735,Patchell; Gregory David,0,0,30,30
1651132480319,MATH 10A,A02,083736,Patchell; Gregory David,26,0,30,4
1651132480319,MATH 10A,A03,083737,Patchell; Gregory David,22,0,30,8
1651132486347,MATH 10B,A01,083207,Staff,0,8,30,30
1651132486347,MATH 10B,A02,083208,Staff,0,7,30,30
1651132486347,MATH 10B,B01,083739,Staff,7,0,30,23
1651132486347,MATH 10B,B02,083740,Staff,28,0,30,2
1651132492381,MATH 18,A01,083743,Staff,0,0,30,30
1651132492381,MATH 18,A02,083744,Staff,23,0,30,7
1651132492381,MATH 18,A03,083745,Staff,19,0,30,11
1651132492381,MATH 18,A04,083746,Staff,26,0,30,4
1651132492381,MATH 18,B01,083748,Staff,0,16,30,30
1651132492381,MATH 18,B02,083749,Staff,0,15,30,30
1651132492381,MATH 18,B03,083750,Staff,0,15,30,30
1651132492381,MATH 18,B04,083751,Staff,0,15,30,30
1651132498405,MATH 20A,A01,083754,Staff,18,0,40,22
1651132504436,MATH 20B,A01,083756,Briones; Jor-el Thomas Caparas,0,14,30,30
1651132504436,MATH 20B,A02,083757,Briones; Jor-el Thomas Caparas,0,11,30,30
1651132510470,MATH 20C,A01,083760,Briones; Jor-el Thomas Caparas,0,16,30,30
1651132510470,MATH 20C,A02,083761,Briones; Jor-el Thomas Caparas,0,17,30,30
1651132510470,MATH 20C,B01,083762,Staff,6,0,30,24
1651132510470,MATH 20C,B02,083763,Staff,28,0,30,2
1651132516496,MATH 20D,A01,083765,Tran; Brian Kha,4,1,30,26
1651132516496,MATH 20D,A02,083766,Tran; Brian Kha,0,0,30,30
1651132516496,MATH 20D,A03,083767,Tran; Brian Kha,21,0,30,9
1651132522522,MATH 20E,A01,083771,Staff,0,0,30,30
1651132522522,MATH 20E,A02,083772,Staff,9,0,30,21
1651132522522,MATH 20E,B01,083773,Staff,5,0,35,30
1651132522522,MATH 20E,B02,083774,Staff,4,0,35,31
1651132528548,MATH 103A,A01,083777,Greenfeld; Be'Eri,0,17,30,30
1651132528548,MATH 103A,A02,083778,Greenfeld; Be'Eri,0,18,30,30
1651132528548,MATH 103A,B01,083779,Greenfeld; Be'Eri,0,16,30,30
1651132528548,MATH 103A,B02,083780,Greenfeld; Be'Eri,0,15,30,30
1651132534581,MATH 105,A01,085443,Staff,0,24,30,30
1651132540607,MATH 109,A01,083213,Ganzberger; Geoffrey Michael,0,8,30,30
1651132540607,MATH 109,A02,083214,Ganzberger; Geoffrey Michael,0,7,30,30
1651132540607,MATH 109,B01,083215,Ganzberger; Geoffrey Michael,0,8,30,30
1651132540607,MATH 109,B02,083216,Ganzberger; Geoffrey Michael,0,7,30,30
1651132546631,MATH 142A,A01,083219,Chow; Bennett,0,16,30,30
1651132546631,MATH 142A,A02,083220,Chow; Bennett,0,15,30,30
1651132546631,MATH 142A,B01,083221,Chow; Bennett,0,16,30,30
1651132546631,MATH 142A,B02,083222,Chow; Bennett,0,15,30,30
1651132552658,MATH 193A,A01,083224,Staff,0,9,30,30
1651132552658,MATH 193A,A02,083225,Staff,0,7,30,30
1651132552658,MATH 193A,A03,083781,Staff,0,7,30,30
1651132552658,MATH 193A,A04,083782,Staff,0,7,30,30
1651132558682,MATH 197,001,091859,McAuley; Julian John,9998,0,9999,1
1651132564801,COGS 9,A01,083615,Staff,0,21,60,60
1651132570830,COGS 11,A01,083617,Boyle; Mary E. T.,13,0,40,27
1651132576856,COGS 13,A01,083071,Staff,0,39,40,40
1651132582882,COGS 14A,A01,092681,Staff,0,41,100,100
1651132588906,COGS 14B,A01,083073,Cheng; Tzu-Han,0,11,50,50
1651132594933,COGS 17,A01,092677,Staff,8,0,75,67
1651132600963,COGS 100,A01,083619,Staff,0,29,60,61
1651132606990,COGS 101A,A01,083621,Davis; Joshua Daniel,0,29,60,60
1651132613016,COGS 101B,A01,091572,Staff,0,8,60,60
1651132619044,COGS 101C,A01,083625,Delgado; Tania,12,0,30,18
1651132625067,COGS 107A,A01,083627,Boyle; Mary E. T.,0,17,60,60
1651132631100,COGS 118A,A01,083075,Staff,0,10,60,60
1651132637131,CSE 3,A50,083646,Miranda; Gregory Joseph,15,0,38,23
1651132637131,CSE 3,A51,083647,Miranda; Gregory Joseph,36,0,37,1
1651132643155,CSE 8A,A50,083650,Miranda; Gregory Joseph,0,30,40,40
1651132649182,CSE 11,A01,083080,Cao; Yingjun,0,98,40,40
1651132655209,CSE 12,A01,083652,Staff,0,30,100,100
1651132661232,CSE 15L,A01,083654,Staff,0,4,50,50
1651132661232,CSE 15L,A02,083655,Staff,0,3,50,50
1651132667254,CSE 20,A01,083657,Staff,47,0,80,33
1651132673278,CSE 30,A01,083084,Eldon; John,0,39,80,80
1651132679305,CSE 100,A01,083659,Cao; Yingjun,0,72,50,50
1651132685331,CSE 134B,A01,083661,Powell; Thomas Allan,0,38,65,65
1651132691353,CSE 140,A01,083663,Staff,0,17,75,75
1651132697376,CSE 140L,A01,083088,Eldon; John,1,0,100,99
1651132703490,CSE 175,A01,083665,Kumar; Rakesh,0,0,25,25
1651132709512,CSE 190,A00,092507,Dubnov; Shlomo,9,0,20,11
1651132715535,ECE 45,A01,083139,Staff,0,8,60,60
1651132721558,ECE 65,A50,083695,Staff,0,7,30,30
1651132727582,ECE 109,A01,091882,Touri; Behrouz,32,0,70,38
1651132733605,ECE 180,A00,083140,Abi Samra; Nicholas Camill,17,0,30,13
1651132733605,ECE 180,B00,083141,Abi Samra; Nicholas Camill,0,1,30,32
1651132739629,MATH 10A,A01,083735,Patchell; Gregory David,0,0,30,30
1651132739629,MATH 10A,A02,083736,Patchell; Gregory David,26,0,30,4
1651132739629,MATH 10A,A03,083737,Patchell; Gregory David,22,0,30,8
1651132745655,MATH 10B,A01,083207,Staff,0,8,30,30
1651132745655,MATH 10B,A02,083208,Staff,0,7,30,30
1651132745655,MATH 10B,B01,083739,Staff,7,0,30,23
1651132745655,MATH 10B,B02,083740,Staff,28,0,30,2
1651132751683,MATH 18,A01,083743,Staff,0,0,30,30
1651132751683,MATH 18,A02,083744,Staff,23,0,30,7
1651132751683,MATH 18,A03,083745,Staff,19,0,30,11
1651132751683,MATH 18,A04,083746,Staff,26,0,30,4
1651132751683,MATH 18,B01,083748,Staff,0,16,30,30
1651132751683,MATH 18,B02,083749,Staff,0,15,30,30
1651132751683,MATH 18,B03,083750,Staff,0,15,30,30
1651132751683,MATH 18,B04,083751,Staff,0,15,30,30
1651132757707,MATH 20A,A01,083754,Staff,18,0,40,22
1651132763732,MATH 20B,A01,083756,Briones; Jor-el Thomas Caparas,0,14,30,30
1651132763732,MATH 20B,A02,083757,Briones; Jor-el Thomas Caparas,0,11,30,30
1651132769761,MATH 20C,A01,083760,Briones; Jor-el Thomas Caparas,0,16,30,30
1651132769761,MATH 20C,A02,083761,Briones; Jor-el Thomas Caparas,0,17,30,30
1651132769761,MATH 20C,B01,083762,Staff,6,0,30,24
1651132769761,MATH 20C,B02,083763,Staff,28,0,30,2
1651132775793,MATH 20D,A01,083765,Tran; Brian Kha,4,1,30,26
1651132775793,MATH 20D,A02,083766,Tran; Brian Kha,0,0,30,30
1651132775793,MATH 20D,A03,083767,Tran; Brian Kha,21,0,30,9
1651132781821,MATH 20E,A01,083771,Staff,0,0,30,30
1651132781821,MATH 20E,A02,083772,Staff,9,0,30,21
1651132781821,MATH 20E,B01,083773,Staff,5,0,35,30
1651132781821,MATH 20E,B02,083774,Staff,4,0,35,31
1651132787845,MATH 103A,A01,083777,Greenfeld; Be'Eri,0,17,30,30
1651132787845,MATH 103A,A02,083778,Greenfeld; Be'Eri,0,18,30,30
1651132787845,MATH 103A,B01,083779,Greenfeld; Be'Eri,0,16,30,30
1651132787845,MATH 103A,B02,083780,Greenfeld; Be'Eri,0,15,30,30
1651132793869,MATH 105,A01,085443,Staff,0,24,30,30
1651132799896,MATH 109,A01,083213,Ganzberger; Geoffrey Michael,0,8,30,30
1651132799896,MATH 109,A02,083214,Ganzberger; Geoffrey Michael,0,7,30,30
1651132799896,MATH 109,B01,083215,Ganzberger; Geoffrey Michael,0,8,30,30
1651132799896,MATH 109,B02,083216,Ganzberger; Geoffrey Michael,0,7,30,30
1651132805921,MATH 142A,A01,083219,Chow; Bennett,0,16,30,30
1651132805921,MATH 142A,A02,083220,Chow; Bennett,0,15,30,30
1651132805921,MATH 142A,B01,083221,Chow; Bennett,0,16,30,30
1651132805921,MATH 142A,B02,083222,Chow; Bennett,0,15,30,30
1651132811947,MATH 193A,A01,083224,Staff,0,9,30,30
1651132811947,MATH 193A,A02,083225,Staff,0,7,30,30
1651132811947,MATH 193A,A03,083781,Staff,0,7,30,30
1651132811947,MATH 193A,A04,083782,Staff,0,7,30,30
1651132817969,MATH 197,001,091859,McAuley; Julian John,9998,0,9999,1
1651132824031,COGS 9,A01,083615,Staff,0,21,60,60
1651132830066,COGS 11,A01,083617,Boyle; Mary E. T.,13,0,40,27
1651132836089,COGS 13,A01,083071,Staff,0,39,40,40
1651132842118,COGS 14A,A01,092681,Staff,0,41,100,100
1651132848156,COGS 14B,A01,083073,Cheng; Tzu-Han,0,11,50,50
1651132854181,COGS 17,A01,092677,Staff,8,0,75,67
1651132860217,COGS 100,A01,083619,Staff,0,29,60,61
1651132866241,COGS 101A,A01,083621,Davis; Joshua Daniel,0,29,60,60
1651132872265,COGS 101B,A01,091572,Staff,0,8,60,60
1651132878290,COGS 101C,A01,083625,Delgado; Tania,12,0,30,18
1651132884318,COGS 107A,A01,083627,Boyle; Mary E. T.,0,17,60,60
1651132890345,COGS 118A,A01,083075,Staff,0,10,60,60
1651132896375,CSE 3,A50,083646,Miranda; Gregory Joseph,15,0,38,23
1651132896375,CSE 3,A51,083647,Miranda; Gregory Joseph,36,0,37,1
1651132902403,CSE 8A,A50,083650,Miranda; Gregory Joseph,0,30,40,40
1651132908435,CSE 11,A01,083080,Cao; Yingjun,0,98,40,40
1651132914457,CSE 12,A01,083652,Staff,0,30,100,100
1651132920479,CSE 15L,A01,083654,Staff,0,4,50,50
1651132920479,CSE 15L,A02,083655,Staff,0,3,50,50
1651132926507,CSE 20,A01,083657,Staff,47,0,80,33
1651132932530,CSE 30,A01,083084,Eldon; John,0,39,80,80
1651132938554,CSE 100,A01,083659,Cao; Yingjun,0,72,50,50
1651132944579,CSE 134B,A01,083661,Powell; Thomas Allan,0,38,65,65
1651132950603,CSE 140,A01,083663,Staff,0,17,75,75
1651132956632,CSE 140L,A01,083088,Eldon; John,1,0,100,99
1651132962657,CSE 175,A01,083665,Kumar; Rakesh,0,0,25,25
1651132968685,CSE 190,A00,092507,Dubnov; Shlomo,9,0,20,11
1651132974711,ECE 45,A01,083139,Staff,0,8,60,60
1651132980735,ECE 65,A50,083695,Staff,0,7,30,30
1651132986764,ECE 109,A01,091882,Touri; Behrouz,32,0,70,38
1651132992789,ECE 180,A00,083140,Abi Samra; Nicholas Camill,17,0,30,13
1651132992789,ECE 180,B00,083141,Abi Samra; Nicholas Camill,0,1,30,32
1651132998818,MATH 10A,A01,083735,Patchell; Gregory David,0,0,30,30
1651132998818,MATH 10A,A02,083736,Patchell; Gregory David,26,0,30,4
1651132998818,MATH 10A,A03,083737,Patchell; Gregory David,22,0,30,8
1651133004852,MATH 10B,A01,083207,Staff,0,8,30,30
1651133004852,MATH 10B,A02,083208,Staff,0,7,30,30
1651133004852,MATH 10B,B01,083739,Staff,7,0,30,23
1651133004852,MATH 10B,B02,083740,Staff,28,0,30,2
1651133010879,MATH 18,A01,083743,Staff,0,0,30,30
1651133010879,MATH 18,A02,083744,Staff,23,0,30,7
1651133010879,MATH 18,A03,083745,Staff,19,0,30,11
1651133010879,MATH 18,A04,083746,Staff,26,0,30,4
1651133010879,MATH 18,B01,083748,Staff,0,16,30,30
1651133010879,MATH 18,B02,083749,Staff,0,15,30,30
1651133010879,MATH 18,B03,083750,Staff,0,15,30,30
1651133010879,MATH 18,B04,083751,Staff,0,15,30,30
1651133016906,MATH 20A,A01,083754,Staff,18,0,40,22
1651133022932,MATH 20B,A01,083756,Briones; Jor-el Thomas Caparas,0,14,30,30
1651133022932,MATH 20B,A02,083757,Briones; Jor-el Thomas Caparas,0,11,30,30
1651133028960,MATH 20C,A01,083760,Briones; Jor-el Thomas Caparas,0,16,30,30
1651133028960,MATH 20C,A02,083761,Briones; Jor-el Thomas Caparas,0,17,30,30
1651133028960,MATH 20C,B01,083762,Staff,6,0,30,24
1651133028960,MATH 20C,B02,083763,Staff,28,0,30,2
1651133034985,MATH 20D,A01,083765,Tran; Brian Kha,4,1,30,26
1651133034985,MATH 20D,A02,083766,Tran; Brian Kha,0,0,30,30
1651133034985,MATH 20D,A03,083767,Tran; Brian Kha,21,0,30,9
1651133041013,MATH 20E,A01,083771,Staff,0,0,30,30
1651133041013,MATH 20E,A02,083772,Staff,9,0,30,21
1651133041013,MATH 20E,B01,083773,Staff,5,0,35,30
1651133041013,MATH 20E,B02,083774,Staff,4,0,35,31
1651133047043,MATH 103A,A01,083777,Greenfeld; Be'Eri,0,17,30,30
1651133047043,MATH 103A,A02,083778,Greenfeld; Be'Eri,0,18,30,30
1651133047043,MATH 103A,B01,083779,Greenfeld; Be'Eri,0,16,30,30
1651133047043,MATH 103A,B02,083780,Greenfeld; Be'Eri,0,15,30,30
1651133053071,MATH 105,A01,085443,Staff,0,24,30,30
1651133059100,MATH 109,A01,083213,Ganzberger; Geoffrey Michael,0,8,30,30
1651133059100,MATH 109,A02,083214,Ganzberger; Geoffrey Michael,0,7,30,30
1651133059100,MATH 109,B01,083215,Ganzberger; Geoffrey Michael,0,8,30,30
1651133059100,MATH 109,B02,083216,Ganzberger; Geoffrey Michael,0,7,30,30
1651133065126,MATH 142A,A01,083219,Chow; Bennett,0,16,30,30
1651133065126,MATH 142A,A02,083220,Chow; Bennett,0,15,30,30
1651133065126,MATH 142A,B01,083221,Chow; Bennett,0,16,30,30
1651133065126,MATH 142A,B02,083222,Chow; Bennett,0,15,30,30
1651133071152,MATH 193A,A01,083224,Staff,0,9,30,30
1651133071152,MATH 193A,A02,083225,Staff,0,7,30,30
1651133071152,MATH 193A,A03,083781,Staff,0,7,30,30
1651133071152,MATH 193A,A04,083782,Staff,0,7,30,30
1651133077177,MATH 197,001,091859,McAuley; Julian John,9998,0,9999,1
1651133083231,COGS 9,A01,083615,Staff,0,21,60,60
1651133089255,COGS 11,A01,083617,Boyle; Mary E. T.,13,0,40,27
1651133095283,COGS 13,A01,083071,Staff,0,39,40,40
1651133101305,COGS 14A,A01,092681,Staff,0,41,100,100
1651133107331,COGS 14B,A01,083073,Cheng; Tzu-Han,0,11,50,50
1651133113354,COGS 17,A01,092677,Staff,8,0,75,67
1651133119378,COGS 100,A01,083619,Staff,0,29,60,61
1651133125403,COGS 101A,A01,083621,Davis; Joshua Daniel,0,29,60,60
1651133131425,COGS 101B,A01,091572,Staff,0,8,60,60
1651133137456,COGS 101C,A01,083625,Delgado; Tania,12,0,30,18
1651133143480,COGS 107A,A01,083627,Boyle; Mary E. T.,0,17,60,60
1651133149504,COGS 118A,A01,083075,Staff,0,10,60,60
1651133155533,CSE 3,A50,083646,Miranda; Gregory Joseph,15,0,38,23
1651133155533,CSE 3,A51,083647,Miranda; Gregory Joseph,36,0,37,1
1651133161556,CSE 8A,A50,083650,Miranda; Gregory Joseph,0,30,40,40
1651133167584,CSE 11,A01,083080,Cao; Yingjun,0,98,40,40
1651133173607,CSE 12,A01,083652,Staff,0,30,100,100
1651133179636,CSE 15L,A01,083654,Staff,0,4,50,50
1651133179636,CSE 15L,A02,083655,Staff,0,3,50,50
1651133185661,CSE 20,A01,083657,Staff,47,0,80,33
1651133191685,CSE 30,A01,083084,Eldon; John,0,39,80,80
1651133197708,CSE 100,A01,083659,Cao; Yingjun,0,72,50,50
1651133203733,CSE 134B,A01,083661,Powell; Thomas Allan,0,38,65,65
1651133209757,CSE 140,A01,083663,Staff,0,17,75,75
1651133215781,CSE 140L,A01,083088,Eldon; John,1,0,100,99
1651133221805,CSE 175,A01,083665,Kumar; Rakesh,0,0,25,25
1651133227828,CSE 190,A00,092507,Dubnov; Shlomo,9,0,20,11
1651133233854,ECE 45,A01,083139,Staff,0,8,60,60
1651133239877,ECE 65,A50,083695,Staff,0,7,30,30
1651133245901,ECE 109,A01,091882,Touri; Behrouz,32,0,70,38
1651133251928,ECE 180,A00,083140,Abi Samra; Nicholas Camill,17,0,30,13
1651133251928,ECE 180,B00,083141,Abi Samra; Nicholas Camill,0,1,30,32
1651133257951,MATH 10A,A01,083735,Patchell; Gregory David,0,0,30,30
1651133257951,MATH 10A,A02,083736,Patchell; Gregory David,26,0,30,4
1651133257951,MATH 10A,A03,083737,Patchell; Gregory David,22,0,30,8
1651133263974,MATH 10B,A01,083207,Staff,0,8,30,30
1651133263974,MATH 10B,A02,083208,Staff,0,7,30,30
1651133263974,MATH 10B,B01,083739,Staff,7,0,30,23
1651133263974,MATH 10B,B02,083740,Staff,28,0,30,2
1651133269999,MATH 18,A01,083743,Staff,0,0,30,30
1651133269999,MATH 18,A02,083744,Staff,23,0,30,7
1651133269999,MATH 18,A03,083745,Staff,19,0,30,11
1651133269999,MATH 18,A04,083746,Staff,26,0,30,4
1651133269999,MATH 18,B01,083748,Staff,0,16,30,30
1651133269999,MATH 18,B02,083749,Staff,0,15,30,30
1651133269999,MATH 18,B03,083750,Staff,0,15,30,30
1651133269999,MATH 18,B04,083751,Staff,0,15,30,30
1651133276022,MATH 20A,A01,083754,Staff,18,0,40,22
1651133282047,MATH 20B,A01,083756,Briones; Jor-el Thomas Caparas,0,14,30,30
1651133282047,MATH 20B,A02,083757,Briones; Jor-el Thomas Caparas,0,11,30,30
1651133288071,MATH 20C,A01,083760,Briones; Jor-el Thomas Caparas,0,16,30,30
1651133288071,MATH 20C,A02,083761,Briones; Jor-el Thomas Caparas,0,17,30,30
1651133288071,MATH 20C,B01,083762,Staff,6,0,30,24
1651133288071,MATH 20C,B02,083763,Staff,28,0,30,2
1651133294095,MATH 20D,A01,083765,Tran; Brian Kha,4,1,30,26
1651133294095,MATH 20D,A02,083766,Tran; Brian Kha,0,0,30,30
1651133294095,MATH 20D,A03,083767,Tran; Brian Kha,21,0,30,9
1651133300228,MATH 20E,A01,083771,Staff,0,0,30,30
1651133300228,MATH 20E,A02,083772,Staff,9,0,30,21
1651133300228,MATH 20E,B01,083773,Staff,5,0,35,30
1651133300228,MATH 20E,B02,083774,Staff,4,0,35,31
1651133306253,MATH 103A,A01,083777,Greenfeld; Be'Eri,0,17,30,30
1651133306253,MATH 103A,A02,083778,Greenfeld; Be'Eri,0,18,30,30
1651133306253,MATH 103A,B01,083779,Greenfeld; Be'Eri,0,16,30,30
1651133306253,MATH 103A,B02,083780,Greenfeld; Be'Eri,0,15,30,30
1651133312275,MATH 105,A01,085443,Staff,0,24,30,30
1651133318307,MATH 109,A01,083213,Ganzberger; Geoffrey Michael,0,8,30,30
1651133318307,MATH 109,A02,083214,Ganzberger; Geoffrey Michael,0,7,30,30
1651133318307,MATH 109,B01,083215,Ganzberger; Geoffrey Michael,0,8,30,30
1651133318307,MATH 109,B02,083216,Ganzberger; Geoffrey Michael,0,7,30,30
1651133324347,MATH 142A,A01,083219,Chow; Bennett,0,16,30,30
1651133324347,MATH 142A,A02,083220,Chow; Bennett,0,15,30,30
1651133324347,MATH 142A,B01,083221,Chow; Bennett,0,16,30,30
1651133324347,MATH 142A,B02,083222,Chow; Bennett,0,15,30,30
1651133330369,MATH 193A,A01,083224,Staff,0,9,30,30
1651133330369,MATH 193A,A02,083225,Staff,0,7,30,30
1651133330369,MATH 193A,A03,083781,Staff,0,7,30,30
1651133330369,MATH 193A,A04,083782,Staff,0,7,30,30
1651133336399,MATH 197,001,091859,McAuley; Julian John,9998,0,9999,1
1651133342454,COGS 9,A01,083615,Staff,0,21,60,60
1651133348478,COGS 11,A01,083617,Boyle; Mary E. T.,13,0,40,27
1651133354503,COGS 13,A01,083071,Staff,0,39,40,40
1651133360527,COGS 14A,A01,092681,Staff,0,41,100,100
1651133366550,COGS 14B,A01,083073,Cheng; Tzu-Han,0,11,50,50
1651133372572,COGS 17,A01,092677,Staff,8,0,75,67
1651133378598,COGS 100,A01,083619,Staff,0,29,60,61
1651133384622,COGS 101A,A01,083621,Davis; Joshua Daniel,0,29,60,60
1651133390648,COGS 101B,A01,091572,Staff,0,8,60,60
1651133396675,COGS 101C,A01,083625,Delgado; Tania,12,0,30,18
1651133402703,COGS 107A,A01,083627,Boyle; Mary E. T.,0,17,60,60
1651133408725,COGS 118A,A01,083075,Staff,0,10,60,60
1651133414755,CSE 3,A50,083646,Miranda; Gregory Joseph,15,0,38,23
1651133414755,CSE 3,A51,083647,Miranda; Gregory Joseph,36,0,37,1
1651133420779,CSE 8A,A50,083650,Miranda; Gregory Joseph,0,30,40,40
1651133426807,CSE 11,A01,083080,Cao; Yingjun,0,98,40,40
1651133432830,CSE 12,A01,083652,Staff,0,30,100,100
1651133438857,CSE 15L,A01,083654,Staff,0,4,50,50
1651133438857,CSE 15L,A02,083655,Staff,0,3,50,50
1651133444883,CSE 20,A01,083657,Staff,47,0,80,33
1651133450910,CSE 30,A01,083084,Eldon; John,0,39,80,80
1651133456937,CSE 100,A01,083659,Cao; Yingjun,0,72,50,50
1651133462961,CSE 134B,A01,083661,Powell; Thomas Allan,0,38,65,65
1651133468988,CSE 140,A01,083663,Staff,0,17,75,75
1651133475012,CSE 140L,A01,083088,Eldon; John,1,0,100,99
1651133481038,CSE 175,A01,083665,Kumar; Rakesh,0,0,25,25
1651133487064,CSE 190,A00,092507,Dubnov; Shlomo,9,0,20,11
1651133493091,ECE 45,A01,083139,Staff,0,8,60,60
1651133499119,ECE 65,A50,083695,Staff,0,7,30,30
1651133505150,ECE 109,A01,091882,Touri; Behrouz,32,0,70,38
1651133511183,ECE 180,A00,083140,Abi Samra; Nicholas Camill,17,0,30,13
1651133511183,ECE 180,B00,083141,Abi Samra; Nicholas Camill,0,1,30,32
1651133517222,MATH 10A,A01,083735,Patchell; Gregory David,0,0,30,30
1651133517222,MATH 10A,A02,083736,Patchell; Gregory David,26,0,30,4
1651133517222,MATH 10A,A03,083737,Patchell; Gregory David,22,0,30,8
1651133523248,MATH 10B,A01,083207,Staff,0,8,30,30
1651133523248,MATH 10B,A02,083208,Staff,0,7,30,30
1651133523248,MATH 10B,B01,083739,Staff,7,0,30,23
1651133523248,MATH 10B,B02,083740,Staff,28,0,30,2
1651133529282,MATH 18,A01,083743,Staff,0,0,30,30
1651133529282,MATH 18,A02,083744,Staff,23,0,30,7
1651133529282,MATH 18,A03,083745,Staff,19,0,30,11
1651133529282,MATH 18,A04,083746,Staff,26,0,30,4
1651133529282,MATH 18,B01,083748,Staff,0,16,30,30
1651133529282,MATH 18,B02,083749,Staff,0,15,30,30
1651133529282,MATH 18,B03,083750,Staff,0,15,30,30
1651133529282,MATH 18,B04,083751,Staff,0,15,30,30
1651133535305,MATH 20A,A01,083754,Staff,18,0,40,22
1651133541331,MATH 20B,A01,083756,Briones; Jor-el Thomas Caparas,0,14,30,30
1651133541331,MATH 20B,A02,083757,Briones; Jor-el Thomas Caparas,0,11,30,30
1651133547361,MATH 20C,A01,083760,Briones; Jor-el Thomas Caparas,0,16,30,30
1651133547361,MATH 20C,A02,083761,Briones; Jor-el Thomas Caparas,0,17,30,30
1651133547361,MATH 20C,B01,083762,Staff,6,0,30,24
1651133547361,MATH 20C,B02,083763,Staff,28,0,30,2
1651133553385,MATH 20D,A01,083765,Tran; Brian Kha,4,1,30,26
1651133553385,MATH 20D,A02,083766,Tran; Brian Kha,0,0,30,30
1651133553385,MATH 20D,A03,083767,Tran; Brian Kha,21,0,30,9
1651133559410,MATH 20E,A01,083771,Staff,0,0,30,30
1651133559410,MATH 20E,A02,083772,Staff,9,0,30,21
1651133559410,MATH 20E,B01,083773,Staff,5,0,35,30
1651133559410,MATH 20E,B02,083774,Staff,4,0,35,31
1651133565446,MATH 103A,A01,083777,Greenfeld; Be'Eri,0,17,30,30
1651133565446,MATH 103A,A02,083778,Greenfeld; Be'Eri,0,18,30,30
1651133565446,MATH 103A,B01,083779,Greenfeld; Be'Eri,0,16,30,30
1651133565446,MATH 103A,B02,083780,Greenfeld; Be'Eri,0,15,30,30
1651133571475,MATH 105,A01,085443,Staff,0,24,30,30
1651133577508,MATH 109,A01,083213,Ganzberger; Geoffrey Michael,0,8,30,30
1651133577508,MATH 109,A02,083214,Ganzberger; Geoffrey Michael,0,7,30,30
1651133577508,MATH 109,B01,083215,Ganzberger; Geoffrey Michael,0,8,30,30
1651133577508,MATH 109,B02,083216,Ganzberger; Geoffrey Michael,0,7,30,30
1651133583533,MATH 142A,A01,083219,Chow; Bennett,0,16,30,30
1651133583533,MATH 142A,A02,083220,Chow; Bennett,0,15,30,30
1651133583533,MATH 142A,B01,083221,Chow; Bennett,0,16,30,30
1651133583533,MATH 142A,B02,083222,Chow; Bennett,0,15,30,30
1651133589562,MATH 193A,A01,083224,Staff,0,9,30,30
1651133589562,MATH 193A,A02,083225,Staff,0,7,30,30
1651133589562,MATH 193A,A03,083781,Staff,0,7,30,30
1651133589562,MATH 193A,A04,083782,Staff,0,7,30,30
1651133595590,MATH 197,001,091859,McAuley; Julian John,9998,0,9999,1
1651133601650,COGS 9,A01,083615,Staff,0,21,60,60
1651133607677,COGS 11,A01,083617,Boyle; Mary E. T.,13,0,40,27
1651133613701,COGS 13,A01,083071,Staff,0,39,40,40
1651133619735,COGS 14A,A01,092681,Staff,0,41,100,100
1651133625767,COGS 14B,A01,083073,Cheng; Tzu-Han,0,11,50,50
1651133631790,COGS 17,A01,092677,Staff,8,0,75,67
1651133637815,COGS 100,A01,083619,Staff,0,29,60,61
1651133643845,COGS 101A,A01,083621,Davis; Joshua Daniel,0,29,60,60
1651133649880,COGS 101B,A01,091572,Staff,0,8,60,60
1651133655906,COGS 101C,A01,083625,Delgado; Tania,12,0,30,18
1651133661933,COGS 107A,A01,083627,Boyle; Mary E. T.,0,17,60,60
1651133667957,COGS 118A,A01,083075,Staff,0,10,60,60
1651133673981,CSE 3,A50,083646,Miranda; Gregory Joseph,15,0,38,23
1651133673981,CSE 3,A51,083647,Miranda; Gregory Joseph,36,0,37,1
1651133680011,CSE 8A,A50,083650,Miranda; Gregory Joseph,0,30,40,40
1651133686033,CSE 11,A01,083080,Cao; Yingjun,0,98,40,40
1651133692061,CSE 12,A01,083652,Staff,0,30,100,100
1651133698086,CSE 15L,A01,083654,Staff,0,4,50,50
1651133698086,CSE 15L,A02,083655,Staff,0,3,50,50
1651133704117,CSE 20,A01,083657,Staff,47,0,80,33
1651133710141,CSE 30,A01,083084,Eldon; John,0,39,80,80
1651133716168,CSE 100,A01,083659,Cao; Yingjun,0,72,50,50
1651133722193,CSE 134B,A01,083661,Powell; Thomas Allan,0,38,65,65
1651133728215,CSE 140,A01,083663,Staff,0,17,75,75
1651133734239,CSE 140L,A01,083088,Eldon; John,1,0,100,99
1651133740261,CSE 175,A01,083665,Kumar; Rakesh,0,0,25,25
1651133746286,CSE 190,A00,092507,Dubnov; Shlomo,9,0,20,11
1651133752311,ECE 45,A01,083139,Staff,0,8,60,60
1651133758338,ECE 65,A50,083695,Staff,0,7,30,30
1651133764368,ECE 109,A01,091882,Touri; Behrouz,32,0,70,38
1651133770392,ECE 180,A00,083140,Abi Samra; Nicholas Camill,17,0,30,13
1651133770392,ECE 180,B00,083141,Abi Samra; Nicholas Camill,0,1,30,32
1651133776422,MATH 10A,A01,083735,Patchell; Gregory David,0,0,30,30
1651133776422,MATH 10A,A02,083736,Patchell; Gregory David,26,0,30,4
1651133776422,MATH 10A,A03,083737,Patchell; Gregory David,22,0,30,8
1651133782457,MATH 10B,A01,083207,Staff,0,8,30,30
1651133782457,MATH 10B,A02,083208,Staff,0,7,30,30
1651133782457,MATH 10B,B01,083739,Staff,7,0,30,23
1651133782457,MATH 10B,B02,083740,Staff,28,0,30,2
1651133788484,MATH 18,A01,083743,Staff,0,0,30,30
1651133788484,MATH 18,A02,083744,Staff,23,0,30,7
1651133788484,MATH 18,A03,083745,Staff,19,0,30,11
1651133788484,MATH 18,A04,083746,Staff,26,0,30,4
1651133788484,MATH 18,B01,083748,Staff,0,16,30,30
1651133788484,MATH 18,B02,083749,Staff,0,15,30,30
1651133788484,MATH 18,B03,083750,Staff,0,15,30,30
1651133788484,MATH 18,B04,083751,Staff,0,15,30,30
1651133794511,MATH 20A,A01,083754,Staff,18,0,40,22
1651133800539,MATH 20B,A01,083756,Briones; Jor-el Thomas Caparas,0,14,30,30
1651133800539,MATH 20B,A02,083757,Briones; Jor-el Thomas Caparas,0,11,30,30
1651133806567,MATH 20C,A01,083760,Briones; Jor-el Thomas Caparas,0,16,30,30
1651133806567,MATH 20C,A02,083761,Briones; Jor-el Thomas Caparas,0,17,30,30
1651133806567,MATH 20C,B01,083762,Staff,6,0,30,24
1651133806567,MATH 20C,B02,083763,Staff,28,0,30,2
1651133812595,MATH 20D,A01,083765,Tran; Brian Kha,4,1,30,26
1651133812595,MATH 20D,A02,083766,Tran; Brian Kha,0,0,30,30
1651133812595,MATH 20D,A03,083767,Tran; Brian Kha,21,0,30,9
1651133818620,MATH 20E,A01,083771,Staff,0,0,30,30
1651133818620,MATH 20E,A02,083772,Staff,9,0,30,21
1651133818620,MATH 20E,B01,083773,Staff,5,0,35,30
1651133818620,MATH 20E,B02,083774,Staff,4,0,35,31
1651133824655,MATH 103A,A01,083777,Greenfeld; Be'Eri,0,17,30,30
1651133824655,MATH 103A,A02,083778,Greenfeld; Be'Eri,0,18,30,30
1651133824655,MATH 103A,B01,083779,Greenfeld; Be'Eri,0,16,30,30
1651133824655,MATH 103A,B02,083780,Greenfeld; Be'Eri,0,15,30,30
1651133830686,MATH 105,A01,085443,Staff,0,24,30,30
1651133836710,MATH 109,A01,083213,Ganzberger; Geoffrey Michael,0,8,30,30
1651133836710,MATH 109,A02,083214,Ganzberger; Geoffrey Michael,0,7,30,30
1651133836710,MATH 109,B01,083215,Ganzberger; Geoffrey Michael,0,8,30,30
1651133836710,MATH 109,B02,083216,Ganzberger; Geoffrey Michael,0,7,30,30
1651133842738,MATH 142A,A01,083219,Chow; Bennett,0,16,30,30
1651133842738,MATH 142A,A02,083220,Chow; Bennett,0,15,30,30
1651133842738,MATH 142A,B01,083221,Chow; Bennett,0,16,30,30
1651133842738,MATH 142A,B02,083222,Chow; Bennett,0,15,30,30
1651133848782,MATH 193A,A01,083224,Staff,0,9,30,30
1651133848782,MATH 193A,A02,083225,Staff,0,7,30,30
1651133848782,MATH 193A,A03,083781,Staff,0,7,30,30
1651133848782,MATH 193A,A04,083782,Staff,0,7,30,30
1651133854806,MATH 197,001,091859,McAuley; Julian John,9998,0,9999,1
1651133860877,COGS 9,A01,083615,Staff,0,21,60,60
1651133866905,COGS 11,A01,083617,Boyle; Mary E. T.,13,0,40,27
1651133872928,COGS 13,A01,083071,Staff,0,39,40,40
1651133878952,COGS 14A,A01,092681,Staff,0,41,100,100
1651133884980,COGS 14B,A01,083073,Cheng; Tzu-Han,0,11,50,50
1651133891080,COGS 17,A01,092677,Staff,8,0,75,67
1651133897106,COGS 100,A01,083619,Staff,0,29,60,61
1651133903133,COGS 101A,A01,083621,Davis; Joshua Daniel,0,29,60,60
1651133909161,COGS 101B,A01,091572,Staff,0,8,60,60
1651133915187,COGS 101C,A01,083625,Delgado; Tania,12,0,30,18
1651133921214,COGS 107A,A01,083627,Boyle; Mary E. T.,0,17,60,60
1651133927238,COGS 118A,A01,083075,Staff,0,10,60,60
1651133933260,CSE 3,A50,083646,Miranda; Gregory Joseph,15,0,38,23
1651133933260,CSE 3,A51,083647,Miranda; Gregory Joseph,36,0,37,1
1651133939285,CSE 8A,A50,083650,Miranda; Gregory Joseph,0,30,40,40
1651133945315,CSE 11,A01,083080,Cao; Yingjun,0,98,40,40
1651133951339,CSE 12,A01,083652,Staff,0,30,100,100
1651133957364,CSE 15L,A01,083654,Staff,0,4,50,50
1651133957364,CSE 15L,A02,083655,Staff,0,3,50,50
1651133963386,CSE 20,A01,083657,Staff,47,0,80,33
1651133969414,CSE 30,A01,083084,Eldon; John,0,39,80,80
1651133975438,CSE 100,A01,083659,Cao; Yingjun,0,72,50,50
1651133981463,CSE 134B,A01,083661,Powell; Thomas Allan,0,38,65,65
1651133987489,CSE 140,A01,083663,Staff,0,17,75,75
1651133993515,CSE 140L,A01,083088,Eldon; John,1,0,100,99
1651133999539,CSE 175,A01,083665,Kumar; Rakesh,0,0,25,25
1651134005563,CSE 190,A00,092507,Dubnov; Shlomo,9,0,20,11
1651134011588,ECE 45,A01,083139,Staff,0,8,60,60
1651134017615,ECE 65,A50,083695,Staff,0,7,30,30
1651134023642,ECE 109,A01,091882,Touri; Behrouz,32,0,70,38
1651134029666,ECE 180,A00,083140,Abi Samra; Nicholas Camill,17,0,30,13
1651134029666,ECE 180,B00,083141,Abi Samra; Nicholas Camill,0,1,30,32
1651134035690,MATH 10A,A01,083735,Patchell; Gregory David,0,0,30,30
1651134035690,MATH 10A,A02,083736,Patchell; Gregory David,26,0,30,4
1651134035690,MATH 10A,A03,083737,Patchell; Gregory David,22,0,30,8
1651134041716,MATH 10B,A01,083207,Staff,0,8,30,30
1651134041716,MATH 10B,A02,083208,Staff,0,7,30,30
1651134041716,MATH 10B,B01,083739,Staff,7,0,30,23
1651134041716,MATH 10B,B02,083740,Staff,28,0,30,2
1651134047741,MATH 18,A01,083743,Staff,0,0,30,30
1651134047741,MATH 18,A02,083744,Staff,23,0,30,7
1651134047741,MATH 18,A03,083745,Staff,19,0,30,11
1651134047741,MATH 18,A04,083746,Staff,26,0,30,4
1651134047741,MATH 18,B01,083748,Staff,0,16,30,30
1651134047741,MATH 18,B02,083749,Staff,0,15,30,30
1651134047741,MATH 18,B03,083750,Staff,0,15,30,30
1651134047741,MATH 18,B04,083751,Staff,0,15,30,30
1651134053767,MATH 20A,A01,083754,Staff,18,0,40,22
1651134059795,MATH 20B,A01,083756,Briones; Jor-el Thomas Caparas,0,14,30,30
1651134059795,MATH 20B,A02,083757,Briones; Jor-el Thomas Caparas,0,11,30,30
1651134065819,MATH 20C,A01,083760,Briones; Jor-el Thomas Caparas,0,16,30,30
1651134065819,MATH 20C,A02,083761,Briones; Jor-el Thomas Caparas,0,17,30,30
1651134065819,MATH 20C,B01,083762,Staff,6,0,30,24
1651134065819,MATH 20C,B02,083763,Staff,28,0,30,2
1651134071844,MATH 20D,A01,083765,Tran; Brian Kha,4,1,30,26
1651134071844,MATH 20D,A02,083766,Tran; Brian Kha,0,0,30,30
1651134071844,MATH 20D,A03,083767,Tran; Brian Kha,21,0,30,9
1651134077869,MATH 20E,A01,083771,Staff,0,0,30,30
1651134077869,MATH 20E,A02,083772,Staff,9,0,30,21
1651134077869,MATH 20E,B01,083773,Staff,5,0,35,30
1651134077869,MATH 20E,B02,083774,Staff,4,0,35,31
1651134083899,MATH 103A,A01,083777,Greenfeld; Be'Eri,0,17,30,30
1651134083899,MATH 103A,A02,083778,Greenfeld; Be'Eri,0,18,30,30
1651134083899,MATH 103A,B01,083779,Greenfeld; Be'Eri,0,16,30,30
1651134083899,MATH 103A,B02,083780,Greenfeld; Be'Eri,0,15,30,30
1651134089926,MATH 105,A01,085443,Staff,0,24,30,30
1651134095954,MATH 109,A01,083213,Ganzberger; Geoffrey Michael,0,8,30,30
1651134095954,MATH 109,A02,083214,Ganzberger; Geoffrey Michael,0,7,30,30
1651134095954,MATH 109,B01,083215,Ganzberger; Geoffrey Michael,0,8,30,30
1651134095954,MATH 109,B02,083216,Ganzberger; Geoffrey Michael,0,7,30,30
1651134101985,MATH 142A,A01,083219,Chow; Bennett,0,16,30,30
1651134101985,MATH 142A,A02,083220,Chow; Bennett,0,15,30,30
1651134101985,MATH 142A,B01,083221,Chow; Bennett,0,16,30,30
1651134101985,MATH 142A,B02,083222,Chow; Bennett,0,15,30,30
1651134108008,MATH 193A,A01,083224,Staff,0,9,30,30
1651134108008,MATH 193A,A02,083225,Staff,0,7,30,30
1651134108008,MATH 193A,A03,083781,Staff,0,7,30,30
1651134108008,MATH 193A,A04,083782,Staff,0,7,30,30
1651134114029,MATH 197,001,091859,McAuley; Julian John,9998,0,9999,1
1651134120083,COGS 9,A01,083615,Staff,0,21,60,60
1651134126117,COGS 11,A01,083617,Boyle; Mary E. T.,13,0,40,27
1651134132144,COGS 13,A01,083071,Staff,0,39,40,40
1651134138170,COGS 14A,A01,092681,Staff,0,41,100,100
1651134144197,COGS 14B,A01,083073,Cheng; Tzu-Han,0,11,50,50
1651134150221,COGS 17,A01,092677,Staff,8,0,75,67
1651134156245,COGS 100,A01,083619,Staff,0,29,60,61
1651134162270,COGS 101A,A01,083621,Davis; Joshua Daniel,0,29,60,60
1651134168301,COGS 101B,A01,091572,Staff,0,8,60,60
1651134174333,COGS 101C,A01,083625,Delgado; Tania,12,0,30,18
1651134180360,COGS 107A,A01,083627,Boyle; Mary E. T.,0,17,60,60
1651134186382,COGS 118A,A01,083075,Staff,0,10,60,60
1651134192407,CSE 3,A50,083646,Miranda; Gregory Joseph,15,0,38,23
1651134192407,CSE 3,A51,083647,Miranda; Gregory Joseph,36,0,37,1
1651134198431,CSE 8A,A50,083650,Miranda; Gregory Joseph,0,30,40,40
1651134204458,CSE 11,A01,083080,Cao; Yingjun,0,98,40,40
1651134210481,CSE 12,A01,083652,Staff,0,30,100,100
1651134216505,CSE 15L,A01,083654,Staff,0,4,50,50
1651134216505,CSE 15L,A02,083655,Staff,0,3,50,50
1651134222528,CSE 20,A01,083657,Staff,47,0,80,33
1651134228560,CSE 30,A01,083084,Eldon; John,0,39,80,80
1651134234586,CSE 100,A01,083659,Cao; Yingjun,0,72,50,50
1651134240610,CSE 134B,A01,083661,Powell; Thomas Allan,0,38,65,65
1651134246645,CSE 140,A01,083663,Staff,0,17,75,75
1651134252669,CSE 140L,A01,083088,Eldon; John,1,0,100,99
1651134258694,CSE 175,A01,083665,Kumar; Rakesh,0,0,25,25
1651134264720,CSE 190,A00,092507,Dubnov; Shlomo,9,0,20,11
1651134270742,ECE 45,A01,083139,Staff,0,8,60,60
1651134276775,ECE 65,A50,083695,Staff,0,7,30,30
1651134282800,ECE 109,A01,091882,Touri; Behrouz,32,0,70,38
1651134288829,ECE 180,A00,083140,Abi Samra; Nicholas Camill,17,0,30,13
1651134288829,ECE 180,B00,083141,Abi Samra; Nicholas Camill,0,1,30,32
1651134294852,MATH 10A,A01,083735,Patchell; Gregory David,0,0,30,30
1651134294852,MATH 10A,A02,083736,Patchell; Gregory David,26,0,30,4
1651134294852,MATH 10A,A03,083737,Patchell; Gregory David,22,0,30,8
1651134300887,MATH 10B,A01,083207,Staff,0,8,30,30
1651134300887,MATH 10B,A02,083208,Staff,0,7,30,30
1651134300887,MATH 10B,B01,083739,Staff,7,0,30,23
1651134300887,MATH 10B,B02,083740,Staff,28,0,30,2
1651134306919,MATH 18,A01,083743,Staff,0,0,30,30
1651134306919,MATH 18,A02,083744,Staff,23,0,30,7
1651134306919,MATH 18,A03,083745,Staff,19,0,30,11
1651134306919,MATH 18,A04,083746,Staff,26,0,30,4
1651134306919,MATH 18,B01,083748,Staff,0,16,30,30
1651134306919,MATH 18,B02,083749,Staff,0,15,30,30
1651134306919,MATH 18,B03,083750,Staff,0,15,30,30
1651134306919,MATH 18,B04,083751,Staff,0,15,30,30
1651134312943,MATH 20A,A01,083754,Staff,18,0,40,22
1651134318967,MATH 20B,A01,083756,Briones; Jor-el Thomas Caparas,0,14,30,30
1651134318967,MATH 20B,A02,083757,Briones; Jor-el Thomas Caparas,0,11,30,30
1651134324995,MATH 20C,A01,083760,Briones; Jor-el Thomas Caparas,0,16,30,30
1651134324995,MATH 20C,A02,083761,Briones; Jor-el Thomas Caparas,0,17,30,30
1651134324995,MATH 20C,B01,083762,Staff,6,0,30,24
1651134324995,MATH 20C,B02,083763,Staff,28,0,30,2
1651134331020,MATH 20D,A01,083765,Tran; Brian Kha,4,1,30,26
1651134331020,MATH 20D,A02,083766,Tran; Brian Kha,0,0,30,30
1651134331020,MATH 20D,A03,083767,Tran; Brian Kha,21,0,30,9
1651134337045,MATH 20E,A01,083771,Staff,0,0,30,30
1651134337045,MATH 20E,A02,083772,Staff,9,0,30,21
1651134337045,MATH 20E,B01,083773,Staff,5,0,35,30
1651134337045,MATH 20E,B02,083774,Staff,4,0,35,31
1651134343077,MATH 103A,A01,083777,Greenfeld; Be'Eri,0,17,30,30
1651134343077,MATH 103A,A02,083778,Greenfeld; Be'Eri,0,18,30,30
1651134343077,MATH 103A,B01,083779,Greenfeld; Be'Eri,0,16,30,30
1651134343077,MATH 103A,B02,083780,Greenfeld; Be'Eri,0,15,30,30
1651134349102,MATH 105,A01,085443,Staff,0,24,30,30
1651134355127,MATH 109,A01,083213,Ganzberger; Geoffrey Michael,0,8,30,30
1651134355127,MATH 109,A02,083214,Ganzberger; Geoffrey Michael,0,7,30,30
1651134355127,MATH 109,B01,083215,Ganzberger; Geoffrey Michael,0,8,30,30
1651134355127,MATH 109,B02,083216,Ganzberger; Geoffrey Michael,0,7,30,30
1651134361159,MATH 142A,A01,083219,Chow; Bennett,0,16,30,30
1651134361159,MATH 142A,A02,083220,Chow; Bennett,0,15,30,30
1651134361159,MATH 142A,B01,083221,Chow; Bennett,0,16,30,30
1651134361159,MATH 142A,B02,083222,Chow; Bennett,0,15,30,30
1651134367182,MATH 193A,A01,083224,Staff,0,9,30,30
1651134367182,MATH 193A,A02,083225,Staff,0,7,30,30
1651134367182,MATH 193A,A03,083781,Staff,0,7,30,30
1651134367182,MATH 193A,A04,083782,Staff,0,7,30,30
1651134373207,MATH 197,001,091859,McAuley; Julian John,9998,0,9999,1
1651134379262,COGS 9,A01,083615,Staff,0,21,60,60
1651134385286,COGS 11,A01,083617,Boyle; Mary E. T.,13,0,40,27
1651134391308,COGS 13,A01,083071,Staff,0,39,40,40
1651134397345,COGS 14A,A01,092681,Staff,0,41,100,100
1651134403368,COGS 14B,A01,083073,Cheng; Tzu-Han,0,11,50,50
1651134409394,COGS 17,A01,092677,Staff,8,0,75,67
1651134415420,COGS 100,A01,083619,Staff,0,29,60,61
1651134421459,COGS 101A,A01,083621,Davis; Joshua Daniel,0,29,60,60
1651134427483,COGS 101B,A01,091572,Staff,0,8,60,60
1651134433511,COGS 101C,A01,083625,Delgado; Tania,12,0,30,18
1651134439537,COGS 107A,A01,083627,Boyle; Mary E. T.,0,17,60,60
1651134445567,COGS 118A,A01,083075,Staff,0,10,60,60
1651134451590,CSE 3,A50,083646,Miranda; Gregory Joseph,15,0,38,23
1651134451590,CSE 3,A51,083647,Miranda; Gregory Joseph,36,0,37,1
1651134457614,CSE 8A,A50,083650,Miranda; Gregory Joseph,0,30,40,40
1651134463641,CSE 11,A01,083080,Cao; Yingjun,0,98,40,40
1651134469678,CSE 12,A01,083652,Staff,0,30,100,100
1651134475707,CSE 15L,A01,083654,Staff,0,4,50,50
1651134475707,CSE 15L,A02,083655,Staff,0,3,50,50
1651134481738,CSE 20,A01,083657,Staff,47,0,80,33
1651134487850,CSE 30,A01,083084,Eldon; John,0,39,80,80
1651134493874,CSE 100,A01,083659,Cao; Yingjun,0,72,50,50
1651134499899,CSE 134B,A01,083661,Powell; Thomas Allan,0,38,65,65
1651134505921,CSE 140,A01,083663,Staff,0,17,75,75
1651134511948,CSE 140L,A01,083088,Eldon; John,1,0,100,99
1651134517975,CSE 175,A01,083665,Kumar; Rakesh,0,0,25,25
1651134523998,CSE 190,A00,092507,Dubnov; Shlomo,9,0,20,11
1651134530022,ECE 45,A01,083139,Staff,0,8,60,60
1651134536049,ECE 65,A50,083695,Staff,0,7,30,30
1651134542076,ECE 109,A01,091882,Touri; Behrouz,32,0,70,38
1651134548100,ECE 180,A00,083140,Abi Samra; Nicholas Camill,17,0,30,13
1651134548100,ECE 180,B00,083141,Abi Samra; Nicholas Camill,0,1,30,32
1651134554123,MATH 10A,A01,083735,Patchell; Gregory David,0,0,30,30
1651134554123,MATH 10A,A02,083736,Patchell; Gregory David,26,0,30,4
1651134554123,MATH 10A,A03,083737,Patchell; Gregory David,22,0,30,8
1651134560151,MATH 10B,A01,083207,Staff,0,8,30,30
1651134560151,MATH 10B,A02,083208,Staff,0,7,30,30
1651134560151,MATH 10B,B01,083739,Staff,7,0,30,23
1651134560151,MATH 10B,B02,083740,Staff,28,0,30,2
1651134566183,MATH 18,A01,083743,Staff,0,0,30,30
1651134566183,MATH 18,A02,083744,Staff,23,0,30,7
1651134566183,MATH 18,A03,083745,Staff,19,0,30,11
1651134566183,MATH 18,A04,083746,Staff,26,0,30,4
1651134566183,MATH 18,B01,083748,Staff,0,16,30,30
1651134566183,MATH 18,B02,083749,Staff,0,15,30,30
1651134566183,MATH 18,B03,083750,Staff,0,15,30,30
1651134566183,MATH 18,B04,083751,Staff,0,15,30,30
1651134572207,MATH 20A,A01,083754,Staff,18,0,40,22
1651134578233,MATH 20B,A01,083756,Briones; Jor-el Thomas Caparas,0,14,30,30
1651134578233,MATH 20B,A02,083757,Briones; Jor-el Thomas Caparas,0,11,30,30
1651134584257,MATH 20C,A01,083760,Briones; Jor-el Thomas Caparas,0,16,30,30
1651134584257,MATH 20C,A02,083761,Briones; Jor-el Thomas Caparas,0,17,30,30
1651134584257,MATH 20C,B01,083762,Staff,6,0,30,24
1651134584257,MATH 20C,B02,083763,Staff,28,0,30,2
1651134590281,MATH 20D,A01,083765,Tran; Brian Kha,4,1,30,26
1651134590281,MATH 20D,A02,083766,Tran; Brian Kha,0,0,30,30
1651134590281,MATH 20D,A03,083767,Tran; Brian Kha,21,0,30,9
1651134596305,MATH 20E,A01,083771,Staff,0,0,30,30
1651134596305,MATH 20E,A02,083772,Staff,9,0,30,21
1651134596305,MATH 20E,B01,083773,Staff,5,0,35,30
1651134596305,MATH 20E,B02,083774,Staff,4,0,35,31
1651134602335,MATH 103A,A01,083777,Greenfeld; Be'Eri,0,17,30,30
1651134602335,MATH 103A,A02,083778,Greenfeld; Be'Eri,0,18,30,30
1651134602335,MATH 103A,B01,083779,Greenfeld; Be'Eri,0,16,30,30
1651134602335,MATH 103A,B02,083780,Greenfeld; Be'Eri,0,15,30,30
1651134608358,MATH 105,A01,085443,Staff,0,24,30,30
1651134614395,MATH 109,A01,083213,Ganzberger; Geoffrey Michael,0,8,30,30
1651134614395,MATH 109,A02,083214,Ganzberger; Geoffrey Michael,0,7,30,30
1651134614395,MATH 109,B01,083215,Ganzberger; Geoffrey Michael,0,8,30,30
1651134614395,MATH 109,B02,083216,Ganzberger; Geoffrey Michael,0,7,30,30
1651134620429,MATH 142A,A01,083219,Chow; Bennett,0,16,30,30
1651134620429,MATH 142A,A02,083220,Chow; Bennett,0,15,30,30
1651134620429,MATH 142A,B01,083221,Chow; Bennett,0,16,30,30
1651134620429,MATH 142A,B02,083222,Chow; Bennett,0,15,30,30
1651134626458,MATH 193A,A01,083224,Staff,0,9,30,30
1651134626458,MATH 193A,A02,083225,Staff,0,7,30,30
1651134626458,MATH 193A,A03,083781,Staff,0,7,30,30
1651134626458,MATH 193A,A04,083782,Staff,0,7,30,30
1651134632482,MATH 197,001,091859,McAuley; Julian John,9998,0,9999,1
1651134638535,COGS 9,A01,083615,Staff,0,21,60,60
1651134644563,COGS 11,A01,083617,Boyle; Mary E. T.,13,0,40,27
1651134650585,COGS 13,A01,083071,Staff,0,39,40,40
1651134656613,COGS 14A,A01,092681,Staff,0,41,100,100
1651134662639,COGS 14B,A01,083073,Cheng; Tzu-Han,0,11,50,50
1651134668663,COGS 17,A01,092677,Staff,8,0,75,67
1651134674690,COGS 100,A01,083619,Staff,0,29,60,61
1651134680718,COGS 101A,A01,083621,Davis; Joshua Daniel,0,29,60,60
1651134686742,COGS 101B,A01,091572,Staff,0,8,60,60
1651134692775,COGS 101C,A01,083625,Delgado; Tania,12,0,30,18
1651134698800,COGS 107A,A01,083627,Boyle; Mary E. T.,0,17,60,60
1651134704824,COGS 118A,A01,083075,Staff,0,10,60,60
1651134710866,CSE 3,A50,083646,Miranda; Gregory Joseph,15,0,38,23
1651134710866,CSE 3,A51,083647,Miranda; Gregory Joseph,36,0,37,1
1651134716888,CSE 8A,A50,083650,Miranda; Gregory Joseph,0,30,40,40
1651134722916,CSE 11,A01,083080,Cao; Yingjun,0,98,40,40
1651134728941,CSE 12,A01,083652,Staff,0,30,100,100
1651134734964,CSE 15L,A01,083654,Staff,0,4,50,50
1651134734964,CSE 15L,A02,083655,Staff,0,3,50,50
1651134740994,CSE 20,A01,083657,Staff,47,0,80,33
1651134747017,CSE 30,A01,083084,Eldon; John,0,39,80,80
1651134753044,CSE 100,A01,083659,Cao; Yingjun,0,72,50,50
1651134759071,CSE 134B,A01,083661,Powell; Thomas Allan,0,38,65,65
1651134765097,CSE 140,A01,083663,Staff,0,17,75,75
1651134771122,CSE 140L,A01,083088,Eldon; John,1,0,100,99
1651134777146,CSE 175,A01,083665,Kumar; Rakesh,0,0,25,25
1651134783175,CSE 190,A00,092507,Dubnov; Shlomo,9,0,20,11
1651134789198,ECE 45,A01,083139,Staff,0,8,60,60
1651134795221,ECE 65,A50,083695,Staff,0,7,30,30
1651134801250,ECE 109,A01,091882,Touri; Behrouz,32,0,70,38
1651134807281,ECE 180,A00,083140,Abi Samra; Nicholas Camill,17,0,30,13
1651134807281,ECE 180,B00,083141,Abi Samra; Nicholas Camill,0,1,30,32
1651134813306,MATH 10A,A01,083735,Patchell; Gregory David,0,0,30,30
1651134813306,MATH 10A,A02,083736,Patchell; Gregory David,26,0,30,4
1651134813306,MATH 10A,A03,083737,Patchell; Gregory David,22,0,30,8
1651134819335,MATH 10B,A01,083207,Staff,0,8,30,30
1651134819335,MATH 10B,A02,083208,Staff,0,7,30,30
1651134819335,MATH 10B,B01,083739,Staff,7,0,30,23
1651134819335,MATH 10B,B02,083740,Staff,28,0,30,2
1651134825359,MATH 18,A01,083743,Staff,0,0,30,30
1651134825359,MATH 18,A02,083744,Staff,23,0,30,7
1651134825359,MATH 18,A03,083745,Staff,19,0,30,11
1651134825359,MATH 18,A04,083746,Staff,26,0,30,4
1651134825359,MATH 18,B01,083748,Staff,0,16,30,30
1651134825359,MATH 18,B02,083749,Staff,0,15,30,30
1651134825359,MATH 18,B03,083750,Staff,0,15,30,30
1651134825359,MATH 18,B04,083751,Staff,0,15,30,30
1651134831389,MATH 20A,A01,083754,Staff,18,0,40,22
1651134837413,MATH 20B,A01,083756,Briones; Jor-el Thomas Caparas,0,14,30,30
1651134837413,MATH 20B,A02,083757,Briones; Jor-el Thomas Caparas,0,11,30,30
1651134843437,MATH 20C,A01,083760,Briones; Jor-el Thomas Caparas,0,16,30,30
1651134843437,MATH 20C,A02,083761,Briones; Jor-el Thomas Caparas,0,17,30,30
1651134843437,MATH 20C,B01,083762,Staff,6,0,30,24
1651134843437,MATH 20C,B02,083763,Staff,28,0,30,2
1651134849462,MATH 20D,A01,083765,Tran; Brian Kha,4,1,30,26
1651134849462,MATH 20D,A02,083766,Tran; Brian Kha,0,0,30,30
1651134849462,MATH 20D,A03,083767,Tran; Brian Kha,21,0,30,9
1651134855487,MATH 20E,A01,083771,Staff,0,0,30,30
1651134855487,MATH 20E,A02,083772,Staff,9,0,30,21
1651134855487,MATH 20E,B01,083773,Staff,5,0,35,30
1651134855487,MATH 20E,B02,083774,Staff,4,0,35,31
1651134861513,MATH 103A,A01,083777,Greenfeld; Be'Eri,0,17,30,30
1651134861513,MATH 103A,A02,083778,Greenfeld; Be'Eri,0,18,30,30
1651134861513,MATH 103A,B01,083779,Greenfeld; Be'Eri,0,16,30,30
1651134861513,MATH 103A,B02,083780,Greenfeld; Be'Eri,0,15,30,30
1651134867537,MATH 105,A01,085443,Staff,0,24,30,30
1651134873563,MATH 109,A01,083213,Ganzberger; Geoffrey Michael,0,8,30,30
1651134873563,MATH 109,A02,083214,Ganzberger; Geoffrey Michael,0,7,30,30
1651134873563,MATH 109,B01,083215,Ganzberger; Geoffrey Michael,0,8,30,30
1651134873563,MATH 109,B02,083216,Ganzberger; Geoffrey Michael,0,7,30,30
1651134879595,MATH 142A,A01,083219,Chow; Bennett,0,16,30,30
1651134879595,MATH 142A,A02,083220,Chow; Bennett,0,15,30,30
1651134879595,MATH 142A,B01,083221,Chow; Bennett,0,16,30,30
1651134879595,MATH 142A,B02,083222,Chow; Bennett,0,15,30,30
1651134885618,MATH 193A,A01,083224,Staff,0,9,30,30
1651134885618,MATH 193A,A02,083225,Staff,0,7,30,30
1651134885618,MATH 193A,A03,083781,Staff,0,7,30,30
1651134885618,MATH 193A,A04,083782,Staff,0,7,30,30
1651134891641,MATH 197,001,091859,McAuley; Julian John,9998,0,9999,1
1651134897709,COGS 9,A01,083615,Staff,0,21,60,60
1651134903734,COGS 11,A01,083617,Boyle; Mary E. T.,13,0,40,27
1651134909761,COGS 13,A01,083071,Staff,0,39,40,40
1651134915786,COGS 14A,A01,092681,Staff,0,41,100,100
1651134921811,COGS 14B,A01,083073,Cheng; Tzu-Han,0,11,50,50
1651134927835,COGS 17,A01,092677,Staff,8,0,75,67
1651134933859,COGS 100,A01,083619,Staff,0,29,60,61
1651134939886,COGS 101A,A01,083621,Davis; Joshua Daniel,0,29,60,60
1651134945910,COGS 101B,A01,091572,Staff,0,8,60,60
1651134951934,COGS 101C,A01,083625,Delgado; Tania,12,0,30,18
1651134957961,COGS 107A,A01,083627,Boyle; Mary E. T.,0,17,60,60
1651134963991,COGS 118A,A01,083075,Staff,0,10,60,60
1651134970019,CSE 3,A50,083646,Miranda; Gregory Joseph,15,0,38,23
1651134970019,CSE 3,A51,083647,Miranda; Gregory Joseph,36,0,37,1
1651134976046,CSE 8A,A50,083650,Miranda; Gregory Joseph,0,30,40,40
1651134982071,CSE 11,A01,083080,Cao; Yingjun,0,98,40,40
1651134988095,CSE 12,A01,083652,Staff,0,30,100,100
1651134994119,CSE 15L,A01,083654,Staff,0,4,50,50
1651134994119,CSE 15L,A02,083655,Staff,0,3,50,50
1651135000146,CSE 20,A01,083657,Staff,47,0,80,33
1651135006173,CSE 30,A01,083084,Eldon; John,0,39,80,80
1651135012201,CSE 100,A01,083659,Cao; Yingjun,0,72,50,50
1651135018228,CSE 134B,A01,083661,Powell; Thomas Allan,0,38,65,65
1651135024251,CSE 140,A01,083663,Staff,0,17,75,75
1651135030281,CSE 140L,A01,083088,Eldon; John,1,0,100,99
1651135036306,CSE 175,A01,083665,Kumar; Rakesh,0,0,25,25
1651135042342,CSE 190,A00,092507,Dubnov; Shlomo,9,0,20,11
1651135048368,ECE 45,A01,083139,Staff,0,8,60,60
1651135054391,ECE 65,A50,083695,Staff,0,7,30,30
1651135060419,ECE 109,A01,091882,Touri; Behrouz,32,0,70,38
1651135066456,ECE 180,A00,083140,Abi Samra; Nicholas Camill,17,0,30,13
1651135066456,ECE 180,B00,083141,Abi Samra; Nicholas Camill,0,1,30,32
1651135072480,MATH 10A,A01,083735,Patchell; Gregory David,0,0,30,30
1651135072480,MATH 10A,A02,083736,Patchell; Gregory David,26,0,30,4
1651135072480,MATH 10A,A03,083737,Patchell; Gregory David,22,0,30,8
1651135078504,MATH 10B,A01,083207,Staff,0,8,30,30
1651135078504,MATH 10B,A02,083208,Staff,0,7,30,30
1651135078504,MATH 10B,B01,083739,Staff,7,0,30,23
1651135078504,MATH 10B,B02,083740,Staff,28,0,30,2
1651135084626,MATH 18,A01,083743,Staff,0,0,30,30
1651135084626,MATH 18,A02,083744,Staff,23,0,30,7
1651135084626,MATH 18,A03,083745,Staff,19,0,30,11
1651135084626,MATH 18,A04,083746,Staff,26,0,30,4
1651135084626,MATH 18,B01,083748,Staff,0,16,30,30
1651135084626,MATH 18,B02,083749,Staff,0,15,30,30
1651135084626,MATH 18,B03,083750,Staff,0,15,30,30
1651135084626,MATH 18,B04,083751,Staff,0,15,30,30
1651135090653,MATH 20A,A01,083754,Staff,18,0,40,22
1651135096680,MATH 20B,A01,083756,Briones; Jor-el Thomas Caparas,0,14,30,30
1651135096680,MATH 20B,A02,083757,Briones; Jor-el Thomas Caparas,0,11,30,30
1651135102707,MATH 20C,A01,083760,Briones; Jor-el Thomas Caparas,0,16,30,30
1651135102707,MATH 20C,A02,083761,Briones; Jor-el Thomas Caparas,0,17,30,30
1651135102707,MATH 20C,B01,083762,Staff,6,0,30,24
1651135102707,MATH 20C,B02,083763,Staff,28,0,30,2
1651135108740,MATH 20D,A01,083765,Tran; Brian Kha,4,1,30,26
1651135108740,MATH 20D,A02,083766,Tran; Brian Kha,0,0,30,30
1651135108740,MATH 20D,A03,083767,Tran; Brian Kha,21,0,30,9
1651135114764,MATH 20E,A01,083771,Staff,0,0,30,30
1651135114764,MATH 20E,A02,083772,Staff,9,0,30,21
1651135114764,MATH 20E,B01,083773,Staff,5,0,35,30
1651135114764,MATH 20E,B02,083774,Staff,4,0,35,31
1651135120789,MATH 103A,A01,083777,Greenfeld; Be'Eri,0,17,30,30
1651135120789,MATH 103A,A02,083778,Greenfeld; Be'Eri,0,18,30,30
1651135120789,MATH 103A,B01,083779,Greenfeld; Be'Eri,0,16,30,30
1651135120789,MATH 103A,B02,083780,Greenfeld; Be'Eri,0,15,30,30
1651135126822,MATH 105,A01,085443,Staff,0,24,30,30
1651135132845,MATH 109,A01,083213,Ganzberger; Geoffrey Michael,0,8,30,30
1651135132845,MATH 109,A02,083214,Ganzberger; Geoffrey Michael,0,7,30,30
1651135132845,MATH 109,B01,083215,Ganzberger; Geoffrey Michael,0,8,30,30
1651135132845,MATH 109,B02,083216,Ganzberger; Geoffrey Michael,0,7,30,30
1651135138870,MATH 142A,A01,083219,Chow; Bennett,0,16,30,30
1651135138870,MATH 142A,A02,083220,Chow; Bennett,0,15,30,30
1651135138870,MATH 142A,B01,083221,Chow; Bennett,0,16,30,30
1651135138870,MATH 142A,B02,083222,Chow; Bennett,0,15,30,30
1651135144894,MATH 193A,A01,083224,Staff,0,9,30,30
1651135144894,MATH 193A,A02,083225,Staff,0,7,30,30
1651135144894,MATH 193A,A03,083781,Staff,0,7,30,30
1651135144894,MATH 193A,A04,083782,Staff,0,7,30,30
1651135150918,MATH 197,001,091859,McAuley; Julian John,9998,0,9999,1
1651135156995,COGS 9,A01,083615,Staff,0,21,60,60
1651135163022,COGS 11,A01,083617,Boyle; Mary E. T.,13,0,40,27
1651135169046,COGS 13,A01,083071,Staff,0,39,40,40
1651135175071,COGS 14A,A01,092681,Staff,0,41,100,100
1651135181098,COGS 14B,A01,083073,Cheng; Tzu-Han,0,11,50,50
1651135187122,COGS 17,A01,092677,Staff,8,0,75,67
1651135193146,COGS 100,A01,083619,Staff,0,29,60,61
1651135199173,COGS 101A,A01,083621,Davis; Joshua Daniel,0,29,60,60
1651135205197,COGS 101B,A01,091572,Staff,0,8,60,60
1651135211221,COGS 101C,A01,083625,Delgado; Tania,12,0,30,18
1651135217248,COGS 107A,A01,083627,Boyle; Mary E. T.,0,17,60,60
1651135223272,COGS 118A,A01,083075,Staff,0,10,60,60
1651135229300,CSE 3,A50,083646,Miranda; Gregory Joseph,15,0,38,23
1651135229300,CSE 3,A51,083647,Miranda; Gregory Joseph,36,0,37,1
1651135235328,CSE 8A,A50,083650,Miranda; Gregory Joseph,0,30,40,40
1651135241353,CSE 11,A01,083080,Cao; Yingjun,0,98,40,40
1651135247376,CSE 12,A01,083652,Staff,0,30,100,100
1651135253400,CSE 15L,A01,083654,Staff,0,4,50,50
1651135253400,CSE 15L,A02,083655,Staff,0,3,50,50
1651135259428,CSE 20,A01,083657,Staff,47,0,80,33
1651135265457,CSE 30,A01,083084,Eldon; John,0,39,80,80
1651135271483,CSE 100,A01,083659,Cao; Yingjun,0,72,50,50
1651135277511,CSE 134B,A01,083661,Powell; Thomas Allan,0,38,65,65
1651135283534,CSE 140,A01,083663,Staff,0,17,75,75
1651135289563,CSE 140L,A01,083088,Eldon; John,1,0,100,99
1651135295590,CSE 175,A01,083665,Kumar; Rakesh,0,0,25,25
1651135301617,CSE 190,A00,092507,Dubnov; Shlomo,9,0,20,11
1651135307644,ECE 45,A01,083139,Staff,0,8,60,60
1651135313670,ECE 65,A50,083695,Staff,0,7,30,30
1651135319696,ECE 109,A01,091882,Touri; Behrouz,32,0,70,38
1651135325726,ECE 180,A00,083140,Abi Samra; Nicholas Camill,17,0,30,13
1651135325726,ECE 180,B00,083141,Abi Samra; Nicholas Camill,0,1,30,32
1651135331758,MATH 10A,A01,083735,Patchell; Gregory David,0,0,30,30
1651135331758,MATH 10A,A02,083736,Patchell; Gregory David,26,0,30,4
1651135331758,MATH 10A,A03,083737,Patchell; Gregory David,22,0,30,8
1651135337789,MATH 10B,A01,083207,Staff,0,8,30,30
1651135337789,MATH 10B,A02,083208,Staff,0,7,30,30
1651135337789,MATH 10B,B01,083739,Staff,7,0,30,23
1651135337789,MATH 10B,B02,083740,Staff,28,0,30,2
1651135343823,MATH 18,A01,083743,Staff,0,0,30,30
1651135343823,MATH 18,A02,083744,Staff,23,0,30,7
1651135343823,MATH 18,A03,083745,Staff,19,0,30,11
1651135343823,MATH 18,A04,083746,Staff,26,0,30,4
1651135343823,MATH 18,B01,083748,Staff,0,16,30,30
1651135343823,MATH 18,B02,083749,Staff,0,15,30,30
1651135343823,MATH 18,B03,083750,Staff,0,15,30,30
1651135343823,MATH 18,B04,083751,Staff,0,15,30,30
1651135349854,MATH 20A,A01,083754,Staff,18,0,40,22
1651135355879,MATH 20B,A01,083756,Briones; Jor-el Thomas Caparas,0,14,30,30
1651135355879,MATH 20B,A02,083757,Briones; Jor-el Thomas Caparas,0,11,30,30
1651135361903,MATH 20C,A01,083760,Briones; Jor-el Thomas Caparas,0,16,30,30
1651135361903,MATH 20C,A02,083761,Briones; Jor-el Thomas Caparas,0,17,30,30
1651135361903,MATH 20C,B01,083762,Staff,6,0,30,24
1651135361903,MATH 20C,B02,083763,Staff,28,0,30,2
1651135367931,MATH 20D,A01,083765,Tran; Brian Kha,4,1,30,26
1651135367931,MATH 20D,A02,083766,Tran; Brian Kha,0,0,30,30
1651135367931,MATH 20D,A03,083767,Tran; Brian Kha,21,0,30,9
1651135373963,MATH 20E,A01,083771,Staff,0,0,30,30
1651135373963,MATH 20E,A02,083772,Staff,9,0,30,21
1651135373963,MATH 20E,B01,083773,Staff,5,0,35,30
1651135373963,MATH 20E,B02,083774,Staff,4,0,35,31
1651135379992,MATH 103A,A01,083777,Greenfeld; Be'Eri,0,17,30,30
1651135379992,MATH 103A,A02,083778,Greenfeld; Be'Eri,0,18,30,30
1651135379992,MATH 103A,B01,083779,Greenfeld; Be'Eri,0,16,30,30
1651135379992,MATH 103A,B02,083780,Greenfeld; Be'Eri,0,15,30,30
1651135386022,MATH 105,A01,085443,Staff,0,24,30,30
1651135392069,MATH 109,A01,083213,Ganzberger; Geoffrey Michael,0,8,30,30
1651135392069,MATH 109,A02,083214,Ganzberger; Geoffrey Michael,0,7,30,30
1651135392069,MATH 109,B01,083215,Ganzberger; Geoffrey Michael,0,8,30,30
1651135392069,MATH 109,B02,083216,Ganzberger; Geoffrey Michael,0,7,30,30
1651135398095,MATH 142A,A01,083219,Chow; Bennett,0,16,30,30
1651135398095,MATH 142A,A02,083220,Chow; Bennett,0,15,30,30
1651135398095,MATH 142A,B01,083221,Chow; Bennett,0,16,30,30
1651135398095,MATH 142A,B02,083222,Chow; Bennett,0,15,30,30
1651135404117,MATH 193A,A01,083224,Staff,0,9,30,30
1651135404117,MATH 193A,A02,083225,Staff,0,7,30,30
1651135404117,MATH 193A,A03,083781,Staff,0,7,30,30
1651135404117,MATH 193A,A04,083782,Staff,0,7,30,30
1651135410141,MATH 197,001,091859,McAuley; Julian John,9998,0,9999,1
1651135416224,COGS 9,A01,083615,Staff,0,21,60,60
1651135422248,COGS 11,A01,083617,Boyle; Mary E. T.,13,0,40,27
1651135428272,COGS 13,A01,083071,Staff,0,39,40,40
1651135434301,COGS 14A,A01,092681,Staff,0,41,100,100
1651135440328,COGS 14B,A01,083073,Cheng; Tzu-Han,0,11,50,50
1651135446355,COGS 17,A01,092677,Staff,8,0,75,67
1651135452382,COGS 100,A01,083619,Staff,0,29,60,61
1651135458407,COGS 101A,A01,083621,Davis; Joshua Daniel,0,29,60,60
1651135464432,COGS 101B,A01,091572,Staff,0,8,60,60
1651135470459,COGS 101C,A01,083625,Delgado; Tania,12,0,30,18
1651135476484,COGS 107A,A01,083627,Boyle; Mary E. T.,0,17,60,60
1651135482512,COGS 118A,A01,083075,Staff,0,10,60,60
1651135488544,CSE 3,A50,083646,Miranda; Gregory Joseph,15,0,38,23
1651135488544,CSE 3,A51,083647,Miranda; Gregory Joseph,36,0,37,1
1651135494568,CSE 8A,A50,083650,Miranda; Gregory Joseph,0,30,40,40
1651135500595,CSE 11,A01,083080,Cao; Yingjun,0,98,40,40
1651135506636,CSE 12,A01,083652,Staff,0,30,100,100
1651135512666,CSE 15L,A01,083654,Staff,0,4,50,50
1651135512666,CSE 15L,A02,083655,Staff,0,3,50,50
1651135518692,CSE 20,A01,083657,Staff,47,0,80,33
1651135524729,CSE 30,A01,083084,Eldon; John,0,39,80,80
1651135530757,CSE 100,A01,083659,Cao; Yingjun,0,72,50,50
1651135536786,CSE 134B,A01,083661,Powell; Thomas Allan,0,38,65,65
1651135542825,CSE 140,A01,083663,Staff,0,17,75,75
1651135548856,CSE 140L,A01,083088,Eldon; John,1,0,100,99
1651135554881,CSE 175,A01,083665,Kumar; Rakesh,0,0,25,25
1651135560907,CSE 190,A00,092507,Dubnov; Shlomo,9,0,20,11
1651135566935,ECE 45,A01,083139,Staff,0,8,60,60
1651135572972,ECE 65,A50,083695,Staff,0,7,30,30
1651135578998,ECE 109,A01,091882,Touri; Behrouz,32,0,70,38
1651135585022,ECE 180,A00,083140,Abi Samra; Nicholas Camill,17,0,30,13
1651135585022,ECE 180,B00,083141,Abi Samra; Nicholas Camill,0,1,30,32
1651135591049,MATH 10A,A01,083735,Patchell; Gregory David,0,0,30,30
1651135591049,MATH 10A,A02,083736,Patchell; Gregory David,26,0,30,4
1651135591049,MATH 10A,A03,083737,Patchell; Gregory David,22,0,30,8
1651135597074,MATH 10B,A01,083207,Staff,0,8,30,30
1651135597074,MATH 10B,A02,083208,Staff,0,7,30,30
1651135597074,MATH 10B,B01,083739,Staff,7,0,30,23
1651135597074,MATH 10B,B02,083740,Staff,28,0,30,2
1651135603110,MATH 18,A01,083743,Staff,0,0,30,30
1651135603110,MATH 18,A02,083744,Staff,23,0,30,7
1651135603110,MATH 18,A03,083745,Staff,19,0,30,11
1651135603110,MATH 18,A04,083746,Staff,26,0,30,4
1651135603110,MATH 18,B01,083748,Staff,0,16,30,30
1651135603110,MATH 18,B02,083749,Staff,0,15,30,30
1651135603110,MATH 18,B03,083750,Staff,0,15,30,30
1651135603110,MATH 18,B04,083751,Staff,0,15,30,30
1651135609146,MATH 20A,A01,083754,Staff,18,0,40,22
1651135615172,MATH 20B,A01,083756,Briones; Jor-el Thomas Caparas,0,14,30,30
1651135615172,MATH 20B,A02,083757,Briones; Jor-el Thomas Caparas,0,11,30,30
1651135621195,MATH 20C,A01,083760,Briones; Jor-el Thomas Caparas,0,16,30,30
1651135621195,MATH 20C,A02,083761,Briones; Jor-el Thomas Caparas,0,17,30,30
1651135621195,MATH 20C,B01,083762,Staff,6,0,30,24
1651135621195,MATH 20C,B02,083763,Staff,28,0,30,2
1651135627220,MATH 20D,A01,083765,Tran; Brian Kha,4,1,30,26
1651135627220,MATH 20D,A02,083766,Tran; Brian Kha,0,0,30,30
1651135627220,MATH 20D,A03,083767,Tran; Brian Kha,21,0,30,9
1651135633245,MATH 20E,A01,083771,Staff,0,0,30,30
1651135633245,MATH 20E,A02,083772,Staff,9,0,30,21
1651135633245,MATH 20E,B01,083773,Staff,5,0,35,30
1651135633245,MATH 20E,B02,083774,Staff,4,0,35,31
1651135639280,MATH 103A,A01,083777,Greenfeld; Be'Eri,0,17,30,30
1651135639280,MATH 103A,A02,083778,Greenfeld; Be'Eri,0,18,30,30
1651135639280,MATH 103A,B01,083779,Greenfeld; Be'Eri,0,16,30,30
1651135639280,MATH 103A,B02,083780,Greenfeld; Be'Eri,0,15,30,30
1651135645306,MATH 105,A01,085443,Staff,0,24,30,30
1651135651332,MATH 109,A01,083213,Ganzberger; Geoffrey Michael,0,8,30,30
1651135651332,MATH 109,A02,083214,Ganzberger; Geoffrey Michael,0,7,30,30
1651135651332,MATH 109,B01,083215,Ganzberger; Geoffrey Michael,0,8,30,30
1651135651332,MATH 109,B02,083216,Ganzberger; Geoffrey Michael,0,7,30,30
1651135657357,MATH 142A,A01,083219,Chow; Bennett,0,16,30,30
1651135657357,MATH 142A,A02,083220,Chow; Bennett,0,15,30,30
1651135657357,MATH 142A,B01,083221,Chow; Bennett,0,16,30,30
1651135657357,MATH 142A,B02,083222,Chow; Bennett,0,15,30,30
1651135663394,MATH 193A,A01,083224,Staff,0,9,30,30
1651135663394,MATH 193A,A02,083225,Staff,0,7,30,30
1651135663394,MATH 193A,A03,083781,Staff,0,7,30,30
1651135663394,MATH 193A,A04,083782,Staff,0,7,30,30
1651135669421,MATH 197,001,091859,McAuley; Julian John,9998,0,9999,1
1651135675588,COGS 9,A01,083615,Staff,0,21,60,60
1651135681617,COGS 11,A01,083617,Boyle; Mary E. T.,13,0,40,27
1651135687641,COGS 13,A01,083071,Staff,0,39,40,40
1651135693668,COGS 14A,A01,092681,Staff,0,41,100,100
1651135699705,COGS 14B,A01,083073,Cheng; Tzu-Han,0,11,50,50
1651135705729,COGS 17,A01,092677,Staff,8,0,75,67
1651135711754,COGS 100,A01,083619,Staff,0,29,60,61
1651135717782,COGS 101A,A01,083621,Davis; Joshua Daniel,0,29,60,60
1651135723810,COGS 101B,A01,091572,Staff,0,8,60,60
1651135729846,COGS 101C,A01,083625,Delgado; Tania,12,0,30,18
1651135735874,COGS 107A,A01,083627,Boyle; Mary E. T.,0,17,60,60
1651135741899,COGS 118A,A01,083075,Staff,0,10,60,60
1651135747925,CSE 3,A50,083646,Miranda; Gregory Joseph,15,0,38,23
1651135747925,CSE 3,A51,083647,Miranda; Gregory Joseph,36,0,37,1
1651135753948,CSE 8A,A50,083650,Miranda; Gregory Joseph,0,30,40,40
1651135759984,CSE 11,A01,083080,Cao; Yingjun,0,98,40,40
1651135766013,CSE 12,A01,083652,Staff,0,30,100,100
1651135772040,CSE 15L,A01,083654,Staff,0,4,50,50
1651135772040,CSE 15L,A02,083655,Staff,0,3,50,50
1651135778067,CSE 20,A01,083657,Staff,47,0,80,33
1651135784096,CSE 30,A01,083084,Eldon; John,0,39,80,80
1651135790120,CSE 100,A01,083659,Cao; Yingjun,0,72,50,50
1651135796145,CSE 134B,A01,083661,Powell; Thomas Allan,0,38,65,65
1651135802170,CSE 140,A01,083663,Staff,0,17,75,75
1651135808193,CSE 140L,A01,083088,Eldon; John,1,0,100,99
1651135814217,CSE 175,A01,083665,Kumar; Rakesh,0,0,25,25
1651135820242,CSE 190,A00,092507,Dubnov; Shlomo,9,0,20,11
1651135826272,ECE 45,A01,083139,Staff,0,8,60,60
1651135832296,ECE 65,A50,083695,Staff,0,7,30,30
1651135838321,ECE 109,A01,091882,Touri; Behrouz,32,0,70,38
1651135844344,ECE 180,A00,083140,Abi Samra; Nicholas Camill,17,0,30,13
1651135844344,ECE 180,B00,083141,Abi Samra; Nicholas Camill,0,1,30,32
1651135850372,MATH 10A,A01,083735,Patchell; Gregory David,0,0,30,30
1651135850372,MATH 10A,A02,083736,Patchell; Gregory David,26,0,30,4
1651135850372,MATH 10A,A03,083737,Patchell; Gregory David,22,0,30,8
1651135856399,MATH 10B,A01,083207,Staff,0,8,30,30
1651135856399,MATH 10B,A02,083208,Staff,0,7,30,30
1651135856399,MATH 10B,B01,083739,Staff,7,0,30,23
1651135856399,MATH 10B,B02,083740,Staff,28,0,30,2
1651135862433,MATH 18,A01,083743,Staff,0,0,30,30
1651135862433,MATH 18,A02,083744,Staff,23,0,30,7
1651135862433,MATH 18,A03,083745,Staff,19,0,30,11
1651135862433,MATH 18,A04,083746,Staff,26,0,30,4
1651135862433,MATH 18,B01,083748,Staff,0,16,30,30
1651135862433,MATH 18,B02,083749,Staff,0,15,30,30
1651135862433,MATH 18,B03,083750,Staff,0,15,30,30
1651135862433,MATH 18,B04,083751,Staff,0,15,30,30
1651135868463,MATH 20A,A01,083754,Staff,18,0,40,22
1651135874486,MATH 20B,A01,083756,Briones; Jor-el Thomas Caparas,0,14,30,30
1651135874486,MATH 20B,A02,083757,Briones; Jor-el Thomas Caparas,0,11,30,30
1651135880511,MATH 20C,A01,083760,Briones; Jor-el Thomas Caparas,0,16,30,30
1651135880511,MATH 20C,A02,083761,Briones; Jor-el Thomas Caparas,0,17,30,30
1651135880511,MATH 20C,B01,083762,Staff,6,0,30,24
1651135880511,MATH 20C,B02,083763,Staff,28,0,30,2
1651135886535,MATH 20D,A01,083765,Tran; Brian Kha,4,1,30,26
1651135886535,MATH 20D,A02,083766,Tran; Brian Kha,0,0,30,30
1651135886535,MATH 20D,A03,083767,Tran; Brian Kha,21,0,30,9
1651135892564,MATH 20E,A01,083771,Staff,0,0,30,30
1651135892564,MATH 20E,A02,083772,Staff,9,0,30,21
1651135892564,MATH 20E,B01,083773,Staff,5,0,35,30
1651135892564,MATH 20E,B02,083774,Staff,4,0,35,31
1651135898602,MATH 103A,A01,083777,Greenfeld; Be'Eri,0,17,30,30
1651135898602,MATH 103A,A02,083778,Greenfeld; Be'Eri,0,18,30,30
1651135898602,MATH 103A,B01,083779,Greenfeld; Be'Eri,0,16,30,30
1651135898602,MATH 103A,B02,083780,Greenfeld; Be'Eri,0,15,30,30
1651135904628,MATH 105,A01,085443,Staff,0,24,30,30
1651135910657,MATH 109,A01,083213,Ganzberger; Geoffrey Michael,0,8,30,30
1651135910657,MATH 109,A02,083214,Ganzberger; Geoffrey Michael,0,7,30,30
1651135910657,MATH 109,B01,083215,Ganzberger; Geoffrey Michael,0,8,30,30
1651135910657,MATH 109,B02,083216,Ganzberger; Geoffrey Michael,0,7,30,30
1651135916692,MATH 142A,A01,083219,Chow; Bennett,0,16,30,30
1651135916692,MATH 142A,A02,083220,Chow; Bennett,0,15,30,30
1651135916692,MATH 142A,B01,083221,Chow; Bennett,0,16,30,30
1651135916692,MATH 142A,B02,083222,Chow; Bennett,0,15,30,30
1651135922716,MATH 193A,A01,083224,Staff,0,9,30,30
1651135922716,MATH 193A,A02,083225,Staff,0,7,30,30
1651135922716,MATH 193A,A03,083781,Staff,0,7,30,30
1651135922716,MATH 193A,A04,083782,Staff,0,7,30,30
1651135928759,MATH 197,001,091859,McAuley; Julian John,9998,0,9999,1
1651135934835,COGS 9,A01,083615,Staff,0,21,60,60
1651135940862,COGS 11,A01,083617,Boyle; Mary E. T.,13,0,40,27
1651135946891,COGS 13,A01,083071,Staff,0,39,40,40
1651135952918,COGS 14A,A01,092681,Staff,0,41,100,100
1651135958942,COGS 14B,A01,083073,Cheng; Tzu-Han,0,11,50,50
1651135964975,COGS 17,A01,092677,Staff,8,0,75,67
1651135971002,COGS 100,A01,083619,Staff,0,29,60,61
1651135977025,COGS 101A,A01,083621,Davis; Joshua Daniel,0,29,60,60
1651135983049,COGS 101B,A01,091572,Staff,0,8,60,60
1651135989074,COGS 101C,A01,083625,Delgado; Tania,12,0,30,18
1651135995106,COGS 107A,A01,083627,Boyle; Mary E. T.,0,17,60,60
1651136001130,COGS 118A,A01,083075,Staff,0,10,60,60
1651136007157,CSE 3,A50,083646,Miranda; Gregory Joseph,15,0,38,23
1651136007157,CSE 3,A51,083647,Miranda; Gregory Joseph,36,0,37,1
1651136013181,CSE 8A,A50,083650,Miranda; Gregory Joseph,0,30,40,40
1651136019211,CSE 11,A01,083080,Cao; Yingjun,0,98,40,40
1651136025235,CSE 12,A01,083652,Staff,0,30,100,100
1651136031262,CSE 15L,A01,083654,Staff,0,4,50,50
1651136031262,CSE 15L,A02,083655,Staff,0,3,50,50
1651136037289,CSE 20,A01,083657,Staff,47,0,80,33
1651136043315,CSE 30,A01,083084,Eldon; John,0,39,80,80
1651136049342,CSE 100,A01,083659,Cao; Yingjun,0,72,50,50
1651136055370,CSE 134B,A01,083661,Powell; Thomas Allan,0,38,65,65
1651136061397,CSE 140,A01,083663,Staff,0,17,75,75
1651136067428,CSE 140L,A01,083088,Eldon; John,1,0,100,99
1651136073452,CSE 175,A01,083665,Kumar; Rakesh,0,0,25,25
1651136079479,CSE 190,A00,092507,Dubnov; Shlomo,9,0,20,11
1651136085506,ECE 45,A01,083139,Staff,0,8,60,60
1651136091533,ECE 65,A50,083695,Staff,0,7,30,30
1651136097558,ECE 109,A01,091882,Touri; Behrouz,32,0,70,38
1651136103585,ECE 180,A00,083140,Abi Samra; Nicholas Camill,17,0,30,13
1651136103585,ECE 180,B00,083141,Abi Samra; Nicholas Camill,0,1,30,32
1651136109612,MATH 10A,A01,083735,Patchell; Gregory David,0,0,30,30
1651136109612,MATH 10A,A02,083736,Patchell; Gregory David,26,0,30,4
1651136109612,MATH 10A,A03,083737,Patchell; Gregory David,22,0,30,8
1651136115636,MATH 10B,A01,083207,Staff,0,8,30,30
1651136115636,MATH 10B,A02,083208,Staff,0,7,30,30
1651136115636,MATH 10B,B01,083739,Staff,7,0,30,23
1651136115636,MATH 10B,B02,083740,Staff,28,0,30,2
1651136121661,MATH 18,A01,083743,Staff,0,0,30,30
1651136121661,MATH 18,A02,083744,Staff,23,0,30,7
1651136121661,MATH 18,A03,083745,Staff,19,0,30,11
1651136121661,MATH 18,A04,083746,Staff,26,0,30,4
1651136121661,MATH 18,B01,083748,Staff,0,16,30,30
1651136121661,MATH 18,B02,083749,Staff,0,15,30,30
1651136121661,MATH 18,B03,083750,Staff,0,15,30,30
1651136121661,MATH 18,B04,083751,Staff,0,15,30,30
1651136127688,MATH 20A,A01,083754,Staff,18,0,40,22
1651136133711,MATH 20B,A01,083756,Briones; Jor-el Thomas Caparas,0,14,30,30
1651136133711,MATH 20B,A02,083757,Briones; Jor-el Thomas Caparas,0,11,30,30
1651136139736,MATH 20C,A01,083760,Briones; Jor-el Thomas Caparas,0,16,30,30
1651136139736,MATH 20C,A02,083761,Briones; Jor-el Thomas Caparas,0,17,30,30
1651136139736,MATH 20C,B01,083762,Staff,6,0,30,24
1651136139736,MATH 20C,B02,083763,Staff,28,0,30,2
1651136145763,MATH 20D,A01,083765,Tran; Brian Kha,4,1,30,26
1651136145763,MATH 20D,A02,083766,Tran; Brian Kha,0,0,30,30
1651136145763,MATH 20D,A03,083767,Tran; Brian Kha,21,0,30,9
1651136151788,MATH 20E,A01,083771,Staff,0,0,30,30
1651136151788,MATH 20E,A02,083772,Staff,9,0,30,21
1651136151788,MATH 20E,B01,083773,Staff,5,0,35,30
1651136151788,MATH 20E,B02,083774,Staff,4,0,35,31
1651136157817,MATH 103A,A01,083777,Greenfeld; Be'Eri,0,17,30,30
1651136157817,MATH 103A,A02,083778,Greenfeld; Be'Eri,0,18,30,30
1651136157817,MATH 103A,B01,083779,Greenfeld; Be'Eri,0,16,30,30
1651136157817,MATH 103A,B02,083780,Greenfeld; Be'Eri,0,15,30,30
1651136163841,MATH 105,A01,085443,Staff,0,24,30,30
1651136169864,MATH 109,A01,083213,Ganzberger; Geoffrey Michael,0,8,30,30
1651136169864,MATH 109,A02,083214,Ganzberger; Geoffrey Michael,0,7,30,30
1651136169864,MATH 109,B01,083215,Ganzberger; Geoffrey Michael,0,8,30,30
1651136169864,MATH 109,B02,083216,Ganzberger; Geoffrey Michael,0,7,30,30
1651136175889,MATH 142A,A01,083219,Chow; Bennett,0,16,30,30
1651136175889,MATH 142A,A02,083220,Chow; Bennett,0,15,30,30
1651136175889,MATH 142A,B01,083221,Chow; Bennett,0,16,30,30
1651136175889,MATH 142A,B02,083222,Chow; Bennett,0,15,30,30
1651136181923,MATH 193A,A01,083224,Staff,0,9,30,30
1651136181923,MATH 193A,A02,083225,Staff,0,7,30,30
1651136181923,MATH 193A,A03,083781,Staff,0,7,30,30
1651136181923,MATH 193A,A04,083782,Staff,0,7,30,30
1651136187946,MATH 197,001,091859,McAuley; Julian John,9998,0,9999,1
1651136194007,COGS 9,A01,083615,Staff,0,21,60,60
1651136200031,COGS 11,A01,083617,Boyle; Mary E. T.,13,0,40,27
1651136206056,COGS 13,A01,083071,Staff,0,39,40,40
1651136212081,COGS 14A,A01,092681,Staff,0,41,100,100
1651136218105,COGS 14B,A01,083073,Cheng; Tzu-Han,0,11,50,50
1651136224129,COGS 17,A01,092677,Staff,8,0,75,67
1651136230153,COGS 100,A01,083619,Staff,0,29,60,61
1651136236175,COGS 101A,A01,083621,Davis; Joshua Daniel,0,29,60,60
1651136242200,COGS 101B,A01,091572,Staff,0,8,60,60
1651136248227,COGS 101C,A01,083625,Delgado; Tania,12,0,30,18
1651136254250,COGS 107A,A01,083627,Boyle; Mary E. T.,0,17,60,60
1651136260273,COGS 118A,A01,083075,Staff,0,10,60,60
1651136266306,CSE 3,A50,083646,Miranda; Gregory Joseph,15,0,38,23
1651136266306,CSE 3,A51,083647,Miranda; Gregory Joseph,36,0,37,1
1651136272419,CSE 8A,A50,083650,Miranda; Gregory Joseph,0,30,40,40
1651136278445,CSE 11,A01,083080,Cao; Yingjun,0,98,40,40
1651136284471,CSE 12,A01,083652,Staff,0,30,100,100
1651136290493,CSE 15L,A01,083654,Staff,0,4,50,50
1651136290493,CSE 15L,A02,083655,Staff,0,3,50,50
1651136296516,CSE 20,A01,083657,Staff,47,0,80,33
1651136302540,CSE 30,A01,083084,Eldon; John,0,39,80,80
1651136308566,CSE 100,A01,083659,Cao; Yingjun,0,72,50,50
1651136314588,CSE 134B,A01,083661,Powell; Thomas Allan,0,38,65,65
1651136320611,CSE 140,A01,083663,Staff,0,17,75,75
1651136326638,CSE 140L,A01,083088,Eldon; John,1,0,100,99
1651136332663,CSE 175,A01,083665,Kumar; Rakesh,0,0,25,25
1651136338687,CSE 190,A00,092507,Dubnov; Shlomo,9,0,20,11
1651136344715,ECE 45,A01,083139,Staff,0,8,60,60
1651136350740,ECE 65,A50,083695,Staff,0,7,30,30
1651136356763,ECE 109,A01,091882,Touri; Behrouz,32,0,70,38
1651136362787,ECE 180,A00,083140,Abi Samra; Nicholas Camill,17,0,30,13
1651136362787,ECE 180,B00,083141,Abi Samra; Nicholas Camill,0,1,30,32
1651136368813,MATH 10A,A01,083735,Patchell; Gregory David,0,0,30,30
1651136368813,MATH 10A,A02,083736,Patchell; Gregory David,26,0,30,4
1651136368813,MATH 10A,A03,083737,Patchell; Gregory David,22,0,30,8
1651136374843,MATH 10B,A01,083207,Staff,0,8,30,30
1651136374843,MATH 10B,A02,083208,Staff,0,7,30,30
1651136374843,MATH 10B,B01,083739,Staff,7,0,30,23
1651136374843,MATH 10B,B02,083740,Staff,28,0,30,2
1651136380874,MATH 18,A01,083743,Staff,0,0,30,30
1651136380874,MATH 18,A02,083744,Staff,23,0,30,7
1651136380874,MATH 18,A03,083745,Staff,19,0,30,11
1651136380874,MATH 18,A04,083746,Staff,26,0,30,4
1651136380874,MATH 18,B01,083748,Staff,0,16,30,30
1651136380874,MATH 18,B02,083749,Staff,0,15,30,30
1651136380874,MATH 18,B03,083750,Staff,0,15,30,30
1651136380874,MATH 18,B04,083751,Staff,0,15,30,30
1651136386900,MATH 20A,A01,083754,Staff,18,0,40,22
1651136392926,MATH 20B,A01,083756,Briones; Jor-el Thomas Caparas,0,14,30,30
1651136392926,MATH 20B,A02,083757,Briones; Jor-el Thomas Caparas,0,11,30,30
1651136398956,MATH 20C,A01,083760,Briones; Jor-el Thomas Caparas,0,16,30,30
1651136398956,MATH 20C,A02,083761,Briones; Jor-el Thomas Caparas,0,17,30,30
1651136398956,MATH 20C,B01,083762,Staff,6,0,30,24
1651136398956,MATH 20C,B02,083763,Staff,28,0,30,2
1651136404982,MATH 20D,A01,083765,Tran; Brian Kha,4,1,30,26
1651136404982,MATH 20D,A02,083766,Tran; Brian Kha,0,0,30,30
1651136404982,MATH 20D,A03,083767,Tran; Brian Kha,21,0,30,9
1651136411012,MATH 20E,A01,083771,Staff,0,0,30,30
1651136411012,MATH 20E,A02,083772,Staff,9,0,30,21
1651136411012,MATH 20E,B01,083773,Staff,5,0,35,30
1651136411012,MATH 20E,B02,083774,Staff,4,0,35,31
1651136417040,MATH 103A,A01,083777,Greenfeld; Be'Eri,0,17,30,30
1651136417040,MATH 103A,A02,083778,Greenfeld; Be'Eri,0,18,30,30
1651136417040,MATH 103A,B01,083779,Greenfeld; Be'Eri,0,16,30,30
1651136417040,MATH 103A,B02,083780,Greenfeld; Be'Eri,0,15,30,30
1651136423063,MATH 105,A01,085443,Staff,0,24,30,30
1651136429091,MATH 109,A01,083213,Ganzberger; Geoffrey Michael,0,8,30,30
1651136429091,MATH 109,A02,083214,Ganzberger; Geoffrey Michael,0,7,30,30
1651136429091,MATH 109,B01,083215,Ganzberger; Geoffrey Michael,0,8,30,30
1651136429091,MATH 109,B02,083216,Ganzberger; Geoffrey Michael,0,7,30,30
1651136435115,MATH 142A,A01,083219,Chow; Bennett,0,16,30,30
1651136435115,MATH 142A,A02,083220,Chow; Bennett,0,15,30,30
1651136435115,MATH 142A,B01,083221,Chow; Bennett,0,16,30,30
1651136435115,MATH 142A,B02,083222,Chow; Bennett,0,15,30,30
1651136441143,MATH 193A,A01,083224,Staff,0,9,30,30
1651136441143,MATH 193A,A02,083225,Staff,0,7,30,30
1651136441143,MATH 193A,A03,083781,Staff,0,7,30,30
1651136441143,MATH 193A,A04,083782,Staff,0,7,30,30
1651136447169,MATH 197,001,091859,McAuley; Julian John,9998,0,9999,1
1651136453230,COGS 9,A01,083615,Staff,0,21,60,60
1651136459254,COGS 11,A01,083617,Boyle; Mary E. T.,13,0,40,27
1651136465280,COGS 13,A01,083071,Staff,0,39,40,40
1651136471302,COGS 14A,A01,092681,Staff,0,41,100,100
1651136477329,COGS 14B,A01,083073,Cheng; Tzu-Han,0,11,50,50
1651136483350,COGS 17,A01,092677,Staff,8,0,75,67
1651136489372,COGS 100,A01,083619,Staff,0,29,60,61
1651136495395,COGS 101A,A01,083621,Davis; Joshua Daniel,0,29,60,60
1651136501423,COGS 101B,A01,091572,Staff,0,8,60,60
1651136507450,COGS 101C,A01,083625,Delgado; Tania,12,0,30,18
1651136513476,COGS 107A,A01,083627,Boyle; Mary E. T.,0,17,60,60
1651136519501,COGS 118A,A01,083075,Staff,0,10,60,60
1651136525530,CSE 3,A50,083646,Miranda; Gregory Joseph,15,0,38,23
1651136525530,CSE 3,A51,083647,Miranda; Gregory Joseph,36,0,37,1
1651136531560,CSE 8A,A50,083650,Miranda; Gregory Joseph,0,30,40,40
1651136537585,CSE 11,A01,083080,Cao; Yingjun,0,98,40,40
1651136543614,CSE 12,A01,083652,Staff,0,30,100,100
1651136549645,CSE 15L,A01,083654,Staff,0,4,50,50
1651136549645,CSE 15L,A02,083655,Staff,0,3,50,50
1651136555678,CSE 20,A01,083657,Staff,47,0,80,33
1651136561707,CSE 30,A01,083084,Eldon; John,0,39,80,80
1651136567735,CSE 100,A01,083659,Cao; Yingjun,0,72,50,50
1651136573762,CSE 134B,A01,083661,Powell; Thomas Allan,0,38,65,65
1651136579803,CSE 140,A01,083663,Staff,0,17,75,75
1651136585828,CSE 140L,A01,083088,Eldon; John,1,0,100,99
1651136591854,CSE 175,A01,083665,Kumar; Rakesh,0,0,25,25
1651136597879,CSE 190,A00,092507,Dubnov; Shlomo,9,0,20,11
1651136603902,ECE 45,A01,083139,Staff,0,8,60,60
1651136609932,ECE 65,A50,083695,Staff,0,7,30,30
1651136615973,ECE 109,A01,091882,Touri; Behrouz,32,0,70,38
1651136621997,ECE 180,A00,083140,Abi Samra; Nicholas Camill,17,0,30,13
1651136621997,ECE 180,B00,083141,Abi Samra; Nicholas Camill,0,1,30,32
1651136628024,MATH 10A,A01,083735,Patchell; Gregory David,0,0,30,30
1651136628024,MATH 10A,A02,083736,Patchell; Gregory David,26,0,30,4
1651136628024,MATH 10A,A03,083737,Patchell; Gregory David,22,0,30,8
1651136634052,MATH 10B,A01,083207,Staff,0,8,30,30
1651136634052,MATH 10B,A02,083208,Staff,0,7,30,30
1651136634052,MATH 10B,B01,083739,Staff,7,0,30,23
1651136634052,MATH 10B,B02,083740,Staff,28,0,30,2
1651136640077,MATH 18,A01,083743,Staff,0,0,30,30
1651136640077,MATH 18,A02,083744,Staff,23,0,30,7
1651136640077,MATH 18,A03,083745,Staff,19,0,30,11
1651136640077,MATH 18,A04,083746,Staff,26,0,30,4
1651136640077,MATH 18,B01,083748,Staff,0,16,30,30
1651136640077,MATH 18,B02,083749,Staff,0,15,30,30
1651136640077,MATH 18,B03,083750,Staff,0,15,30,30
1651136640077,MATH 18,B04,083751,Staff,0,15,30,30
1651136646102,MATH 20A,A01,083754,Staff,18,0,40,22
1651136652130,MATH 20B,A01,083756,Briones; Jor-el Thomas Caparas,0,14,30,30
1651136652130,MATH 20B,A02,083757,Briones; Jor-el Thomas Caparas,0,11,30,30
1651136658155,MATH 20C,A01,083760,Briones; Jor-el Thomas Caparas,0,16,30,30
1651136658155,MATH 20C,A02,083761,Briones; Jor-el Thomas Caparas,0,17,30,30
1651136658155,MATH 20C,B01,083762,Staff,6,0,30,24
1651136658155,MATH 20C,B02,083763,Staff,28,0,30,2
1651136664183,MATH 20D,A01,083765,Tran; Brian Kha,4,1,30,26
1651136664183,MATH 20D,A02,083766,Tran; Brian Kha,0,0,30,30
1651136664183,MATH 20D,A03,083767,Tran; Brian Kha,21,0,30,9
1651136670209,MATH 20E,A01,083771,Staff,0,0,30,30
1651136670209,MATH 20E,A02,083772,Staff,9,0,30,21
1651136670209,MATH 20E,B01,083773,Staff,5,0,35,30
1651136670209,MATH 20E,B02,083774,Staff,4,0,35,31
1651136676234,MATH 103A,A01,083777,Greenfeld; Be'Eri,0,17,30,30
1651136676234,MATH 103A,A02,083778,Greenfeld; Be'Eri,0,18,30,30
1651136676234,MATH 103A,B01,083779,Greenfeld; Be'Eri,0,16,30,30
1651136676234,MATH 103A,B02,083780,Greenfeld; Be'Eri,0,15,30,30
1651136682263,MATH 105,A01,085443,Staff,0,24,30,30
1651136688298,MATH 109,A01,083213,Ganzberger; Geoffrey Michael,0,8,30,30
1651136688298,MATH 109,A02,083214,Ganzberger; Geoffrey Michael,0,7,30,30
1651136688298,MATH 109,B01,083215,Ganzberger; Geoffrey Michael,0,8,30,30
1651136688298,MATH 109,B02,083216,Ganzberger; Geoffrey Michael,0,7,30,30
1651136694322,MATH 142A,A01,083219,Chow; Bennett,0,16,30,30
1651136694322,MATH 142A,A02,083220,Chow; Bennett,0,15,30,30
1651136694322,MATH 142A,B01,083221,Chow; Bennett,0,16,30,30
1651136694322,MATH 142A,B02,083222,Chow; Bennett,0,15,30,30
1651136700348,MATH 193A,A01,083224,Staff,0,9,30,30
1651136700348,MATH 193A,A02,083225,Staff,0,7,30,30
1651136700348,MATH 193A,A03,083781,Staff,0,7,30,30
1651136700348,MATH 193A,A04,083782,Staff,0,7,30,30
1651136706375,MATH 197,001,091859,McAuley; Julian John,9998,0,9999,1
1651136712426,COGS 9,A01,083615,Staff,0,21,60,60
1651136718450,COGS 11,A01,083617,Boyle; Mary E. T.,13,0,40,27
1651136724474,COGS 13,A01,083071,Staff,0,39,40,40
1651136730501,COGS 14A,A01,092681,Staff,0,41,100,100
1651136736526,COGS 14B,A01,083073,Cheng; Tzu-Han,0,11,50,50
1651136742551,COGS 17,A01,092677,Staff,8,0,75,67
1651136748575,COGS 100,A01,083619,Staff,0,29,60,61
1651136754599,COGS 101A,A01,083621,Davis; Joshua Daniel,0,29,60,60
1651136760628,COGS 101B,A01,091572,Staff,0,8,60,60
1651136766660,COGS 101C,A01,083625,Delgado; Tania,12,0,30,18
1651136772683,COGS 107A,A01,083627,Boyle; Mary E. T.,0,17,60,60
1651136778707,COGS 118A,A01,083075,Staff,0,10,60,60
1651136784735,CSE 3,A50,083646,Miranda; Gregory Joseph,15,0,38,23
1651136784735,CSE 3,A51,083647,Miranda; Gregory Joseph,36,0,37,1
1651136790760,CSE 8A,A50,083650,Miranda; Gregory Joseph,0,30,40,40
1651136796784,CSE 11,A01,083080,Cao; Yingjun,0,98,40,40
1651136802809,CSE 12,A01,083652,Staff,0,30,100,100
1651136808835,CSE 15L,A01,083654,Staff,0,4,50,50
1651136808835,CSE 15L,A02,083655,Staff,0,3,50,50
1651136814859,CSE 20,A01,083657,Staff,47,0,80,33
1651136820881,CSE 30,A01,083084,Eldon; John,0,39,80,80
1651136826909,CSE 100,A01,083659,Cao; Yingjun,0,72,50,50
1651136832932,CSE 134B,A01,083661,Powell; Thomas Allan,0,38,65,65
1651136838961,CSE 140,A01,083663,Staff,0,17,75,75
1651136844984,CSE 140L,A01,083088,Eldon; John,1,0,100,99
1651136851020,CSE 175,A01,083665,Kumar; Rakesh,0,0,25,25
1651136857044,CSE 190,A00,092507,Dubnov; Shlomo,9,0,20,11
1651136863080,ECE 45,A01,083139,Staff,0,8,60,60
1651136869202,ECE 65,A50,083695,Staff,0,7,30,30
1651136875224,ECE 109,A01,091882,Touri; Behrouz,32,0,70,38
1651136881251,ECE 180,A00,083140,Abi Samra; Nicholas Camill,17,0,30,13
1651136881251,ECE 180,B00,083141,Abi Samra; Nicholas Camill,0,1,30,32
1651136887279,MATH 10A,A01,083735,Patchell; Gregory David,0,0,30,30
1651136887279,MATH 10A,A02,083736,Patchell; Gregory David,26,0,30,4
1651136887279,MATH 10A,A03,083737,Patchell; Gregory David,22,0,30,8
1651136893307,MATH 10B,A01,083207,Staff,0,8,30,30
1651136893307,MATH 10B,A02,083208,Staff,0,7,30,30
1651136893307,MATH 10B,B01,083739,Staff,7,0,30,23
1651136893307,MATH 10B,B02,083740,Staff,28,0,30,2
1651136899340,MATH 18,A01,083743,Staff,0,0,30,30
1651136899340,MATH 18,A02,083744,Staff,23,0,30,7
1651136899340,MATH 18,A03,083745,Staff,19,0,30,11
1651136899340,MATH 18,A04,083746,Staff,26,0,30,4
1651136899340,MATH 18,B01,083748,Staff,0,16,30,30
1651136899340,MATH 18,B02,083749,Staff,0,15,30,30
1651136899340,MATH 18,B03,083750,Staff,0,15,30,30
1651136899340,MATH 18,B04,083751,Staff,0,15,30,30
1651136905364,MATH 20A,A01,083754,Staff,18,0,40,22
1651136911400,MATH 20B,A01,083756,Briones; Jor-el Thomas Caparas,0,14,30,30
1651136911400,MATH 20B,A02,083757,Briones; Jor-el Thomas Caparas,0,11,30,30
1651136917424,MATH 20C,A01,083760,Briones; Jor-el Thomas Caparas,0,16,30,30
1651136917424,MATH 20C,A02,083761,Briones; Jor-el Thomas Caparas,0,17,30,30
1651136917424,MATH 20C,B01,083762,Staff,6,0,30,24
1651136917424,MATH 20C,B02,083763,Staff,28,0,30,2
1651136923451,MATH 20D,A01,083765,Tran; Brian Kha,4,1,30,26
1651136923451,MATH 20D,A02,083766,Tran; Brian Kha,0,0,30,30
1651136923451,MATH 20D,A03,083767,Tran; Brian Kha,21,0,30,9
1651136929475,MATH 20E,A01,083771,Staff,0,0,30,30
1651136929475,MATH 20E,A02,083772,Staff,9,0,30,21
1651136929475,MATH 20E,B01,083773,Staff,5,0,35,30
1651136929475,MATH 20E,B02,083774,Staff,4,0,35,31
1651136935498,MATH 103A,A01,083777,Greenfeld; Be'Eri,0,17,30,30
1651136935498,MATH 103A,A02,083778,Greenfeld; Be'Eri,0,18,30,30
1651136935498,MATH 103A,B01,083779,Greenfeld; Be'Eri,0,16,30,30
1651136935498,MATH 103A,B02,083780,Greenfeld; Be'Eri,0,15,30,30
1651136941525,MATH 105,A01,085443,Staff,0,24,30,30
1651136947549,MATH 109,A01,083213,Ganzberger; Geoffrey Michael,0,8,30,30
1651136947549,MATH 109,A02,083214,Ganzberger; Geoffrey Michael,0,7,30,30
1651136947549,MATH 109,B01,083215,Ganzberger; Geoffrey Michael,0,8,30,30
1651136947549,MATH 109,B02,083216,Ganzberger; Geoffrey Michael,0,7,30,30
1651136953573,MATH 142A,A01,083219,Chow; Bennett,0,16,30,30
1651136953573,MATH 142A,A02,083220,Chow; Bennett,0,15,30,30
1651136953573,MATH 142A,B01,083221,Chow; Bennett,0,16,30,30
1651136953573,MATH 142A,B02,083222,Chow; Bennett,0,15,30,30
1651136959598,MATH 193A,A01,083224,Staff,0,9,30,30
1651136959598,MATH 193A,A02,083225,Staff,0,7,30,30
1651136959598,MATH 193A,A03,083781,Staff,0,7,30,30
1651136959598,MATH 193A,A04,083782,Staff,0,7,30,30
1651136965621,MATH 197,001,091859,McAuley; Julian John,9998,0,9999,1
1651136971671,COGS 9,A01,083615,Staff,0,21,60,60
1651136977695,COGS 11,A01,083617,Boyle; Mary E. T.,13,0,40,27
1651136983723,COGS 13,A01,083071,Staff,0,39,40,40
1651136989754,COGS 14A,A01,092681,Staff,0,41,100,100
1651136995785,COGS 14B,A01,083073,Cheng; Tzu-Han,0,11,50,50
1651137001809,COGS 17,A01,092677,Staff,8,0,75,67
1651137007835,COGS 100,A01,083619,Staff,0,29,60,61
1651137013863,COGS 101A,A01,083621,Davis; Joshua Daniel,0,29,60,60
1651137019887,COGS 101B,A01,091572,Staff,0,8,60,60
1651137025914,COGS 101C,A01,083625,Delgado; Tania,12,0,30,18
1651137031942,COGS 107A,A01,083627,Boyle; Mary E. T.,0,17,60,60
1651137037968,COGS 118A,A01,083075,Staff,0,10,60,60
1651137044005,CSE 3,A50,083646,Miranda; Gregory Joseph,15,0,38,23
1651137044005,CSE 3,A51,083647,Miranda; Gregory Joseph,36,0,37,1
1651137050029,CSE 8A,A50,083650,Miranda; Gregory Joseph,0,30,40,40
1651137056052,CSE 11,A01,083080,Cao; Yingjun,0,98,40,40
1651137062078,CSE 12,A01,083652,Staff,0,30,100,100
1651137068105,CSE 15L,A01,083654,Staff,0,4,50,50
1651137068105,CSE 15L,A02,083655,Staff,0,3,50,50
1651137074137,CSE 20,A01,083657,Staff,47,0,80,33
1651137080163,CSE 30,A01,083084,Eldon; John,0,39,80,80
1651137086196,CSE 100,A01,083659,Cao; Yingjun,0,72,50,50
1651137092220,CSE 134B,A01,083661,Powell; Thomas Allan,0,38,65,65
1651137098243,CSE 140,A01,083663,Staff,0,17,75,75
1651137104267,CSE 140L,A01,083088,Eldon; John,1,0,100,99
1651137110293,CSE 175,A01,083665,Kumar; Rakesh,0,0,25,25
1651137116317,CSE 190,A00,092507,Dubnov; Shlomo,9,0,20,11
1651137122340,ECE 45,A01,083139,Staff,0,8,60,60
1651137128363,ECE 65,A50,083695,Staff,0,7,30,30
1651137134390,ECE 109,A01,091882,Touri; Behrouz,32,0,70,38
1651137140415,ECE 180,A00,083140,Abi Samra; Nicholas Camill,17,0,30,13
1651137140415,ECE 180,B00,083141,Abi Samra; Nicholas Camill,0,1,30,32
1651137146439,MATH 10A,A01,083735,Patchell; Gregory David,0,0,30,30
1651137146439,MATH 10A,A02,083736,Patchell; Gregory David,26,0,30,4
1651137146439,MATH 10A,A03,083737,Patchell; Gregory David,22,0,30,8
1651137152467,MATH 10B,A01,083207,Staff,0,8,30,30
1651137152467,MATH 10B,A02,083208,Staff,0,7,30,30
1651137152467,MATH 10B,B01,083739,Staff,7,0,30,23
1651137152467,MATH 10B,B02,083740,Staff,28,0,30,2
1651137158493,MATH 18,A01,083743,Staff,0,0,30,30
1651137158493,MATH 18,A02,083744,Staff,23,0,30,7
1651137158493,MATH 18,A03,083745,Staff,19,0,30,11
1651137158493,MATH 18,A04,083746,Staff,26,0,30,4
1651137158493,MATH 18,B01,083748,Staff,0,16,30,30
1651137158493,MATH 18,B02,083749,Staff,0,15,30,30
1651137158493,MATH 18,B03,083750,Staff,0,15,30,30
1651137158493,MATH 18,B04,083751,Staff,0,15,30,30
1651137164520,MATH 20A,A01,083754,Staff,18,0,40,22
1651137170546,MATH 20B,A01,083756,Briones; Jor-el Thomas Caparas,0,14,30,30
1651137170546,MATH 20B,A02,083757,Briones; Jor-el Thomas Caparas,0,11,30,30
1651137176570,MATH 20C,A01,083760,Briones; Jor-el Thomas Caparas,0,16,30,30
1651137176570,MATH 20C,A02,083761,Briones; Jor-el Thomas Caparas,0,17,30,30
1651137176570,MATH 20C,B01,083762,Staff,6,0,30,24
1651137176570,MATH 20C,B02,083763,Staff,28,0,30,2
1651137182596,MATH 20D,A01,083765,Tran; Brian Kha,4,1,30,26
1651137182596,MATH 20D,A02,083766,Tran; Brian Kha,0,0,30,30
1651137182596,MATH 20D,A03,083767,Tran; Brian Kha,21,0,30,9
1651137188619,MATH 20E,A01,083771,Staff,0,0,30,30
1651137188619,MATH 20E,A02,083772,Staff,9,0,30,21
1651137188619,MATH 20E,B01,083773,Staff,5,0,35,30
1651137188619,MATH 20E,B02,083774,Staff,4,0,35,31
1651137194643,MATH 103A,A01,083777,Greenfeld; Be'Eri,0,17,30,30
1651137194643,MATH 103A,A02,083778,Greenfeld; Be'Eri,0,18,30,30
1651137194643,MATH 103A,B01,083779,Greenfeld; Be'Eri,0,16,30,30
1651137194643,MATH 103A,B02,083780,Greenfeld; Be'Eri,0,15,30,30
1651137200670,MATH 105,A01,085443,Staff,0,24,30,30
1651137206698,MATH 109,A01,083213,Ganzberger; Geoffrey Michael,0,8,30,30
1651137206698,MATH 109,A02,083214,Ganzberger; Geoffrey Michael,0,7,30,30
1651137206698,MATH 109,B01,083215,Ganzberger; Geoffrey Michael,0,8,30,30
1651137206698,MATH 109,B02,083216,Ganzberger; Geoffrey Michael,0,7,30,30
1651137212726,MATH 142A,A01,083219,Chow; Bennett,0,16,30,30
1651137212726,MATH 142A,A02,083220,Chow; Bennett,0,15,30,30
1651137212726,MATH 142A,B01,083221,Chow; Bennett,0,16,30,30
1651137212726,MATH 142A,B02,083222,Chow; Bennett,0,15,30,30
1651137218753,MATH 193A,A01,083224,Staff,0,9,30,30
1651137218753,MATH 193A,A02,083225,Staff,0,7,30,30
1651137218753,MATH 193A,A03,083781,Staff,0,7,30,30
1651137218753,MATH 193A,A04,083782,Staff,0,7,30,30
1651137224779,MATH 197,001,091859,McAuley; Julian John,9998,0,9999,1
1651137230844,COGS 9,A01,083615,Staff,0,21,60,60
1651137236871,COGS 11,A01,083617,Boyle; Mary E. T.,13,0,40,27
1651137242898,COGS 13,A01,083071,Staff,0,39,40,40
1651137248925,COGS 14A,A01,092681,Staff,0,41,100,100
1651137254949,COGS 14B,A01,083073,Cheng; Tzu-Han,0,11,50,50
1651137260972,COGS 17,A01,092677,Staff,8,0,75,67
1651137267003,COGS 100,A01,083619,Staff,0,29,60,61
1651137273028,COGS 101A,A01,083621,Davis; Joshua Daniel,0,29,60,60
1651137279054,COGS 101B,A01,091572,Staff,0,8,60,60
1651137285082,COGS 101C,A01,083625,Delgado; Tania,12,0,30,18
1651137291110,COGS 107A,A01,083627,Boyle; Mary E. T.,0,17,60,60
1651137297143,COGS 118A,A01,083075,Staff,0,10,60,60
1651137303174,CSE 3,A50,083646,Miranda; Gregory Joseph,15,0,38,23
1651137303174,CSE 3,A51,083647,Miranda; Gregory Joseph,36,0,37,1
1651137309203,CSE 8A,A50,083650,Miranda; Gregory Joseph,0,30,40,40
1651137315242,CSE 11,A01,083080,Cao; Yingjun,0,98,40,40
1651137321269,CSE 12,A01,083652,Staff,0,30,100,100
1651137327293,CSE 15L,A01,083654,Staff,0,4,50,50
1651137327293,CSE 15L,A02,083655,Staff,0,3,50,50
1651137333318,CSE 20,A01,083657,Staff,47,0,80,33
1651137339343,CSE 30,A01,083084,Eldon; John,0,39,80,80
1651137345371,CSE 100,A01,083659,Cao; Yingjun,0,72,50,50
1651137351398,CSE 134B,A01,083661,Powell; Thomas Allan,0,38,65,65
1651137357424,CSE 140,A01,083663,Staff,0,17,75,75
1651137363452,CSE 140L,A01,083088,Eldon; John,1,0,100,99
1651137369479,CSE 175,A01,083665,Kumar; Rakesh,0,0,25,25
1651137375502,CSE 190,A00,092507,Dubnov; Shlomo,9,0,20,11
1651137381530,ECE 45,A01,083139,Staff,0,8,60,60
1651137387556,ECE 65,A50,083695,Staff,0,7,30,30
1651137393583,ECE 109,A01,091882,Touri; Behrouz,32,0,70,38
1651137399613,ECE 180,A00,083140,Abi Samra; Nicholas Camill,17,0,30,13
1651137399613,ECE 180,B00,083141,Abi Samra; Nicholas Camill,0,1,30,32
1651137405638,MATH 10A,A01,083735,Patchell; Gregory David,0,0,30,30
1651137405638,MATH 10A,A02,083736,Patchell; Gregory David,26,0,30,4
1651137405638,MATH 10A,A03,083737,Patchell; Gregory David,22,0,30,8
1651137411667,MATH 10B,A01,083207,Staff,0,8,30,30
1651137411667,MATH 10B,A02,083208,Staff,0,7,30,30
1651137411667,MATH 10B,B01,083739,Staff,7,0,30,23
1651137411667,MATH 10B,B02,083740,Staff,28,0,30,2
1651137417697,MATH 18,A01,083743,Staff,0,0,30,30
1651137417697,MATH 18,A02,083744,Staff,23,0,30,7
1651137417697,MATH 18,A03,083745,Staff,19,0,30,11
1651137417697,MATH 18,A04,083746,Staff,26,0,30,4
1651137417697,MATH 18,B01,083748,Staff,0,16,30,30
1651137417697,MATH 18,B02,083749,Staff,0,15,30,30
1651137417697,MATH 18,B03,083750,Staff,0,15,30,30
1651137417697,MATH 18,B04,083751,Staff,0,15,30,30
1651137423725,MATH 20A,A01,083754,Staff,18,0,40,22
1651137429753,MATH 20B,A01,083756,Briones; Jor-el Thomas Caparas,0,14,30,30
1651137429753,MATH 20B,A02,083757,Briones; Jor-el Thomas Caparas,0,11,30,30
1651137435781,MATH 20C,A01,083760,Briones; Jor-el Thomas Caparas,0,16,30,30
1651137435781,MATH 20C,A02,083761,Briones; Jor-el Thomas Caparas,0,17,30,30
1651137435781,MATH 20C,B01,083762,Staff,6,0,30,24
1651137435781,MATH 20C,B02,083763,Staff,28,0,30,2
1651137441805,MATH 20D,A01,083765,Tran; Brian Kha,4,1,30,26
1651137441805,MATH 20D,A02,083766,Tran; Brian Kha,0,0,30,30
1651137441805,MATH 20D,A03,083767,Tran; Brian Kha,21,0,30,9
1651137447829,MATH 20E,A01,083771,Staff,0,0,30,30
1651137447829,MATH 20E,A02,083772,Staff,9,0,30,21
1651137447829,MATH 20E,B01,083773,Staff,5,0,35,30
1651137447829,MATH 20E,B02,083774,Staff,4,0,35,31
1651137453879,MATH 103A,A01,083777,Greenfeld; Be'Eri,0,17,30,30
1651137453879,MATH 103A,A02,083778,Greenfeld; Be'Eri,0,18,30,30
1651137453879,MATH 103A,B01,083779,Greenfeld; Be'Eri,0,16,30,30
1651137453879,MATH 103A,B02,083780,Greenfeld; Be'Eri,0,15,30,30
1651137459906,MATH 105,A01,085443,Staff,0,24,30,30
1651137466024,MATH 109,A01,083213,Ganzberger; Geoffrey Michael,0,8,30,30
1651137466024,MATH 109,A02,083214,Ganzberger; Geoffrey Michael,0,7,30,30
1651137466024,MATH 109,B01,083215,Ganzberger; Geoffrey Michael,0,8,30,30
1651137466024,MATH 109,B02,083216,Ganzberger; Geoffrey Michael,0,7,30,30
1651137472053,MATH 142A,A01,083219,Chow; Bennett,0,16,30,30
1651137472053,MATH 142A,A02,083220,Chow; Bennett,0,15,30,30
1651137472053,MATH 142A,B01,083221,Chow; Bennett,0,16,30,30
1651137472053,MATH 142A,B02,083222,Chow; Bennett,0,15,30,30
1651137478077,MATH 193A,A01,083224,Staff,0,9,30,30
1651137478077,MATH 193A,A02,083225,Staff,0,7,30,30
1651137478077,MATH 193A,A03,083781,Staff,0,7,30,30
1651137478077,MATH 193A,A04,083782,Staff,0,7,30,30
1651137484104,MATH 197,001,091859,McAuley; Julian John,9998,0,9999,1
1651137490163,COGS 9,A01,083615,Staff,0,21,60,60
1651137496186,COGS 11,A01,083617,Boyle; Mary E. T.,13,0,40,27
1651137502213,COGS 13,A01,083071,Staff,0,39,40,40
1651137508236,COGS 14A,A01,092681,Staff,0,41,100,100
1651137514260,COGS 14B,A01,083073,Cheng; Tzu-Han,0,11,50,50
1651137520286,COGS 17,A01,092677,Staff,8,0,75,67
1651137526311,COGS 100,A01,083619,Staff,0,29,60,61
1651137532338,COGS 101A,A01,083621,Davis; Joshua Daniel,0,29,60,60
1651137538362,COGS 101B,A01,091572,Staff,0,8,60,60
1651137544385,COGS 101C,A01,083625,Delgado; Tania,12,0,30,18
1651137550409,COGS 107A,A01,083627,Boyle; Mary E. T.,0,17,60,60
1651137556436,COGS 118A,A01,083075,Staff,0,10,60,60
1651137562475,CSE 3,A50,083646,Miranda; Gregory Joseph,15,0,38,23
1651137562475,CSE 3,A51,083647,Miranda; Gregory Joseph,36,0,37,1
1651137568498,CSE 8A,A50,083650,Miranda; Gregory Joseph,0,30,40,40
1651137574522,CSE 11,A01,083080,Cao; Yingjun,0,98,40,40
1651137580549,CSE 12,A01,083652,Staff,0,30,100,100
1651137586574,CSE 15L,A01,083654,Staff,0,4,50,50
1651137586574,CSE 15L,A02,083655,Staff,0,3,50,50
1651137592598,CSE 20,A01,083657,Staff,47,0,80,33
1651137598622,CSE 30,A01,083084,Eldon; John,0,39,80,80
1651137604656,CSE 100,A01,083659,Cao; Yingjun,0,72,50,50
1651137610679,CSE 134B,A01,083661,Powell; Thomas Allan,0,38,65,65
1651137616703,CSE 140,A01,083663,Staff,0,17,75,75
1651137622726,CSE 140L,A01,083088,Eldon; John,1,0,100,99
1651137628754,CSE 175,A01,083665,Kumar; Rakesh,0,0,25,25
1651137634779,CSE 190,A00,092507,Dubnov; Shlomo,9,0,20,11
1651137640810,ECE 45,A01,083139,Staff,0,8,60,60
1651137646837,ECE 65,A50,083695,Staff,0,7,30,30
1651137652861,ECE 109,A01,091882,Touri; Behrouz,32,0,70,38
1651137658885,ECE 180,A00,083140,Abi Samra; Nicholas Camill,17,0,30,13
1651137658885,ECE 180,B00,083141,Abi Samra; Nicholas Camill,0,1,30,32
1651137664909,MATH 10A,A01,083735,Patchell; Gregory David,0,0,30,30
1651137664909,MATH 10A,A02,083736,Patchell; Gregory David,26,0,30,4
1651137664909,MATH 10A,A03,083737,Patchell; Gregory David,22,0,30,8
1651137670937,MATH 10B,A01,083207,Staff,0,8,30,30
1651137670937,MATH 10B,A02,083208,Staff,0,7,30,30
1651137670937,MATH 10B,B01,083739,Staff,7,0,30,23
1651137670937,MATH 10B,B02,083740,Staff,28,0,30,2
1651137676964,MATH 18,A01,083743,Staff,0,0,30,30
1651137676964,MATH 18,A02,083744,Staff,23,0,30,7
1651137676964,MATH 18,A03,083745,Staff,19,0,30,11
1651137676964,MATH 18,A04,083746,Staff,26,0,30,4
1651137676964,MATH 18,B01,083748,Staff,0,16,30,30
1651137676964,MATH 18,B02,083749,Staff,0,15,30,30
1651137676964,MATH 18,B03,083750,Staff,0,15,30,30
1651137676964,MATH 18,B04,083751,Staff,0,15,30,30
1651137682991,MATH 20A,A01,083754,Staff,18,0,40,22
1651137689015,MATH 20B,A01,083756,Briones; Jor-el Thomas Caparas,0,14,30,30
1651137689015,MATH 20B,A02,083757,Briones; Jor-el Thomas Caparas,0,11,30,30
1651137695039,MATH 20C,A01,083760,Briones; Jor-el Thomas Caparas,0,16,30,30
1651137695039,MATH 20C,A02,083761,Briones; Jor-el Thomas Caparas,0,17,30,30
1651137695039,MATH 20C,B01,083762,Staff,6,0,30,24
1651137695039,MATH 20C,B02,083763,Staff,28,0,30,2
1651137701067,MATH 20D,A01,083765,Tran; Brian Kha,4,1,30,26
1651137701067,MATH 20D,A02,083766,Tran; Brian Kha,0,0,30,30
1651137701067,MATH 20D,A03,083767,Tran; Brian Kha,21,0,30,9
1651137707091,MATH 20E,A01,083771,Staff,0,0,30,30
1651137707091,MATH 20E,A02,083772,Staff,9,0,30,21
1651137707091,MATH 20E,B01,083773,Staff,5,0,35,30
1651137707091,MATH 20E,B02,083774,Staff,4,0,35,31
1651137713116,MATH 103A,A01,083777,Greenfeld; Be'Eri,0,17,30,30
1651137713116,MATH 103A,A02,083778,Greenfeld; Be'Eri,0,18,30,30
1651137713116,MATH 103A,B01,083779,Greenfeld; Be'Eri,0,16,30,30
1651137713116,MATH 103A,B02,083780,Greenfeld; Be'Eri,0,15,30,30
1651137719143,MATH 105,A01,085443,Staff,0,24,30,30
1651137725166,MATH 109,A01,083213,Ganzberger; Geoffrey Michael,0,8,30,30
1651137725166,MATH 109,A02,083214,Ganzberger; Geoffrey Michael,0,7,30,30
1651137725166,MATH 109,B01,083215,Ganzberger; Geoffrey Michael,0,8,30,30
1651137725166,MATH 109,B02,083216,Ganzberger; Geoffrey Michael,0,7,30,30
1651137731196,MATH 142A,A01,083219,Chow; Bennett,0,16,30,30
1651137731196,MATH 142A,A02,083220,Chow; Bennett,0,15,30,30
1651137731196,MATH 142A,B01,083221,Chow; Bennett,0,16,30,30
1651137731196,MATH 142A,B02,083222,Chow; Bennett,0,15,30,30
1651137737220,MATH 193A,A01,083224,Staff,0,9,30,30
1651137737220,MATH 193A,A02,083225,Staff,0,7,30,30
1651137737220,MATH 193A,A03,083781,Staff,0,7,30,30
1651137737220,MATH 193A,A04,083782,Staff,0,7,30,30
1651137743244,MATH 197,001,091859,McAuley; Julian John,9998,0,9999,1
1651137749295,COGS 9,A01,083615,Staff,0,21,60,60
1651137755319,COGS 11,A01,083617,Boyle; Mary E. T.,13,0,40,27
1651137761344,COGS 13,A01,083071,Staff,0,39,40,40
1651137767367,COGS 14A,A01,092681,Staff,0,41,100,100
1651137773390,COGS 14B,A01,083073,Cheng; Tzu-Han,0,11,50,50
1651137779416,COGS 17,A01,092677,Staff,8,0,75,67
1651137785443,COGS 100,A01,083619,Staff,0,29,60,61
1651137791468,COGS 101A,A01,083621,Davis; Joshua Daniel,0,29,60,60
1651137797491,COGS 101B,A01,091572,Staff,0,8,60,60
1651137803516,COGS 101C,A01,083625,Delgado; Tania,12,0,30,18
1651137809538,COGS 107A,A01,083627,Boyle; Mary E. T.,0,17,60,60
1651137815564,COGS 118A,A01,083075,Staff,0,10,60,60
1651137821585,CSE 3,A50,083646,Miranda; Gregory Joseph,15,0,38,23
1651137821585,CSE 3,A51,083647,Miranda; Gregory Joseph,36,0,37,1
1651137827609,CSE 8A,A50,083650,Miranda; Gregory Joseph,0,30,40,40
1651137833636,CSE 11,A01,083080,Cao; Yingjun,0,98,40,40
1651137839660,CSE 12,A01,083652,Staff,0,30,100,100
1651137845688,CSE 15L,A01,083654,Staff,0,4,50,50
1651137845688,CSE 15L,A02,083655,Staff,0,3,50,50
1651137851712,CSE 20,A01,083657,Staff,47,0,80,33
1651137857738,CSE 30,A01,083084,Eldon; John,0,39,80,80
1651137863766,CSE 100,A01,083659,Cao; Yingjun,0,72,50,50
1651137869792,CSE 134B,A01,083661,Powell; Thomas Allan,0,38,65,65
1651137875817,CSE 140,A01,083663,Staff,0,17,75,75
1651137881845,CSE 140L,A01,083088,Eldon; John,1,0,100,99
1651137887868,CSE 175,A01,083665,Kumar; Rakesh,0,0,25,25
1651137893894,CSE 190,A00,092507,Dubnov; Shlomo,9,0,20,11
1651137899925,ECE 45,A01,083139,Staff,0,8,60,60
1651137905947,ECE 65,A50,083695,Staff,0,7,30,30
1651137911975,ECE 109,A01,091882,Touri; Behrouz,32,0,70,38
1651137918001,ECE 180,A00,083140,Abi Samra; Nicholas Camill,17,0,30,13
1651137918001,ECE 180,B00,083141,Abi Samra; Nicholas Camill,0,1,30,32
1651137924026,MATH 10A,A01,083735,Patchell; Gregory David,0,0,30,30
1651137924026,MATH 10A,A02,083736,Patchell; Gregory David,26,0,30,4
1651137924026,MATH 10A,A03,083737,Patchell; Gregory David,22,0,30,8
1651137930054,MATH 10B,A01,083207,Staff,0,8,30,30
1651137930054,MATH 10B,A02,083208,Staff,0,7,30,30
1651137930054,MATH 10B,B01,083739,Staff,7,0,30,23
1651137930054,MATH 10B,B02,083740,Staff,28,0,30,2
1651137936080,MATH 18,A01,083743,Staff,0,0,30,30
1651137936080,MATH 18,A02,083744,Staff,23,0,30,7
1651137936080,MATH 18,A03,083745,Staff,19,0,30,11
1651137936080,MATH 18,A04,083746,Staff,26,0,30,4
1651137936080,MATH 18,B01,083748,Staff,0,16,30,30
1651137936080,MATH 18,B02,083749,Staff,0,15,30,30
1651137936080,MATH 18,B03,083750,Staff,0,15,30,30
1651137936080,MATH 18,B04,083751,Staff,0,15,30,30
1651137942107,MATH 20A,A01,083754,Staff,18,0,40,22
1651137948134,MATH 20B,A01,083756,Briones; Jor-el Thomas Caparas,0,14,30,30
1651137948134,MATH 20B,A02,083757,Briones; Jor-el Thomas Caparas,0,11,30,30
1651137954160,MATH 20C,A01,083760,Briones; Jor-el Thomas Caparas,0,16,30,30
1651137954160,MATH 20C,A02,083761,Briones; Jor-el Thomas Caparas,0,17,30,30
1651137954160,MATH 20C,B01,083762,Staff,6,0,30,24
1651137954160,MATH 20C,B02,083763,Staff,28,0,30,2
1651137960191,MATH 20D,A01,083765,Tran; Brian Kha,4,1,30,26
1651137960191,MATH 20D,A02,083766,Tran; Brian Kha,0,0,30,30
1651137960191,MATH 20D,A03,083767,Tran; Brian Kha,21,0,30,9
1651137966220,MATH 20E,A01,083771,Staff,0,0,30,30
1651137966220,MATH 20E,A02,083772,Staff,9,0,30,21
1651137966220,MATH 20E,B01,083773,Staff,5,0,35,30
1651137966220,MATH 20E,B02,083774,Staff,4,0,35,31
1651137972252,MATH 103A,A01,083777,Greenfeld; Be'Eri,0,17,30,30
1651137972252,MATH 103A,A02,083778,Greenfeld; Be'Eri,0,18,30,30
1651137972252,MATH 103A,B01,083779,Greenfeld; Be'Eri,0,16,30,30
1651137972252,MATH 103A,B02,083780,Greenfeld; Be'Eri,0,15,30,30
1651137978275,MATH 105,A01,085443,Staff,0,24,30,30
1651137984298,MATH 109,A01,083213,Ganzberger; Geoffrey Michael,0,8,30,30
1651137984298,MATH 109,A02,083214,Ganzberger; Geoffrey Michael,0,7,30,30
1651137984298,MATH 109,B01,083215,Ganzberger; Geoffrey Michael,0,8,30,30
1651137984298,MATH 109,B02,083216,Ganzberger; Geoffrey Michael,0,7,30,30
1651137990322,MATH 142A,A01,083219,Chow; Bennett,0,16,30,30
1651137990322,MATH 142A,A02,083220,Chow; Bennett,0,15,30,30
1651137990322,MATH 142A,B01,083221,Chow; Bennett,0,16,30,30
1651137990322,MATH 142A,B02,083222,Chow; Bennett,0,15,30,30
1651137996346,MATH 193A,A01,083224,Staff,0,9,30,30
1651137996346,MATH 193A,A02,083225,Staff,0,7,30,30
1651137996346,MATH 193A,A03,083781,Staff,0,7,30,30
1651137996346,MATH 193A,A04,083782,Staff,0,7,30,30
1651138002370,MATH 197,001,091859,McAuley; Julian John,9998,0,9999,1
1651138008422,COGS 9,A01,083615,Staff,0,21,60,60
1651138014451,COGS 11,A01,083617,Boyle; Mary E. T.,13,0,40,27
1651138020485,COGS 13,A01,083071,Staff,0,39,40,40
1651138026512,COGS 14A,A01,092681,Staff,0,41,100,100
1651138032534,COGS 14B,A01,083073,Cheng; Tzu-Han,0,11,50,50
1651138038563,COGS 17,A01,092677,Staff,8,0,75,67
1651138044589,COGS 100,A01,083619,Staff,0,29,60,61
1651138050621,COGS 101A,A01,083621,Davis; Joshua Daniel,0,29,60,60
1651138056737,COGS 101B,A01,091572,Staff,0,8,60,60
1651138062763,COGS 101C,A01,083625,Delgado; Tania,12,0,30,18
1651138068793,COGS 107A,A01,083627,Boyle; Mary E. T.,0,17,60,60
1651138074816,COGS 118A,A01,083075,Staff,0,10,60,60
1651138080845,CSE 3,A50,083646,Miranda; Gregory Joseph,15,0,38,23
1651138080845,CSE 3,A51,083647,Miranda; Gregory Joseph,36,0,37,1
1651138086883,CSE 8A,A50,083650,Miranda; Gregory Joseph,0,30,40,40
1651138092906,CSE 11,A01,083080,Cao; Yingjun,0,98,40,40
1651138098933,CSE 12,A01,083652,Staff,0,30,100,100
1651138104958,CSE 15L,A01,083654,Staff,0,4,50,50
1651138104958,CSE 15L,A02,083655,Staff,0,3,50,50
1651138110981,CSE 20,A01,083657,Staff,47,0,80,33
1651138117006,CSE 30,A01,083084,Eldon; John,0,39,80,80
1651138123030,CSE 100,A01,083659,Cao; Yingjun,0,72,50,50
1651138129053,CSE 134B,A01,083661,Powell; Thomas Allan,0,38,65,65
1651138135077,CSE 140,A01,083663,Staff,0,17,75,75
1651138141104,CSE 140L,A01,083088,Eldon; John,1,0,100,99
1651138147126,CSE 175,A01,083665,Kumar; Rakesh,0,0,25,25
1651138153149,CSE 190,A00,092507,Dubnov; Shlomo,9,0,20,11
1651138159172,ECE 45,A01,083139,Staff,0,8,60,60
1651138165196,ECE 65,A50,083695,Staff,0,7,30,30
1651138171219,ECE 109,A01,091882,Touri; Behrouz,32,0,70,38
1651138177243,ECE 180,A00,083140,Abi Samra; Nicholas Camill,17,0,30,13
1651138177243,ECE 180,B00,083141,Abi Samra; Nicholas Camill,0,1,30,32
1651138183271,MATH 10A,A01,083735,Patchell; Gregory David,0,0,30,30
1651138183271,MATH 10A,A02,083736,Patchell; Gregory David,26,0,30,4
1651138183271,MATH 10A,A03,083737,Patchell; Gregory David,22,0,30,8
1651138189295,MATH 10B,A01,083207,Staff,0,8,30,30
1651138189295,MATH 10B,A02,083208,Staff,0,7,30,30
1651138189295,MATH 10B,B01,083739,Staff,7,0,30,23
1651138189295,MATH 10B,B02,083740,Staff,28,0,30,2
1651138195321,MATH 18,A01,083743,Staff,0,0,30,30
1651138195321,MATH 18,A02,083744,Staff,23,0,30,7
1651138195321,MATH 18,A03,083745,Staff,19,0,30,11
1651138195321,MATH 18,A04,083746,Staff,26,0,30,4
1651138195321,MATH 18,B01,083748,Staff,0,16,30,30
1651138195321,MATH 18,B02,083749,Staff,0,15,30,30
1651138195321,MATH 18,B03,083750,Staff,0,15,30,30
1651138195321,MATH 18,B04,083751,Staff,0,15,30,30
1651138201350,MATH 20A,A01,083754,Staff,18,0,40,22
1651138207373,MATH 20B,A01,083756,Briones; Jor-el Thomas Caparas,0,14,30,30
1651138207373,MATH 20B,A02,083757,Briones; Jor-el Thomas Caparas,0,11,30,30
1651138213395,MATH 20C,A01,083760,Briones; Jor-el Thomas Caparas,0,16,30,30
1651138213395,MATH 20C,A02,083761,Briones; Jor-el Thomas Caparas,0,17,30,30
1651138213395,MATH 20C,B01,083762,Staff,6,0,30,24
1651138213395,MATH 20C,B02,083763,Staff,28,0,30,2
1651138219420,MATH 20D,A01,083765,Tran; Brian Kha,4,1,30,26
1651138219420,MATH 20D,A02,083766,Tran; Brian Kha,0,0,30,30
1651138219420,MATH 20D,A03,083767,Tran; Brian Kha,21,0,30,9
1651138225444,MATH 20E,A01,083771,Staff,0,0,30,30
1651138225444,MATH 20E,A02,083772,Staff,9,0,30,21
1651138225444,MATH 20E,B01,083773,Staff,5,0,35,30
1651138225444,MATH 20E,B02,083774,Staff,4,0,35,31
1651138231468,MATH 103A,A01,083777,Greenfeld; Be'Eri,0,17,30,30
1651138231468,MATH 103A,A02,083778,Greenfeld; Be'Eri,0,18,30,30
1651138231468,MATH 103A,B01,083779,Greenfeld; Be'Eri,0,16,30,30
1651138231468,MATH 103A,B02,083780,Greenfeld; Be'Eri,0,15,30,30
1651138237493,MATH 105,A01,085443,Staff,0,24,30,30
1651138243516,MATH 109,A01,083213,Ganzberger; Geoffrey Michael,0,8,30,30
1651138243516,MATH 109,A02,083214,Ganzberger; Geoffrey Michael,0,7,30,30
1651138243516,MATH 109,B01,083215,Ganzberger; Geoffrey Michael,0,8,30,30
1651138243516,MATH 109,B02,083216,Ganzberger; Geoffrey Michael,0,7,30,30
1651138249545,MATH 142A,A01,083219,Chow; Bennett,0,16,30,30
1651138249545,MATH 142A,A02,083220,Chow; Bennett,0,15,30,30
1651138249545,MATH 142A,B01,083221,Chow; Bennett,0,16,30,30
1651138249545,MATH 142A,B02,083222,Chow; Bennett,0,15,30,30
1651138255575,MATH 193A,A01,083224,Staff,0,9,30,30
1651138255575,MATH 193A,A02,083225,Staff,0,7,30,30
1651138255575,MATH 193A,A03,083781,Staff,0,7,30,30
1651138255575,MATH 193A,A04,083782,Staff,0,7,30,30
1651138261601,MATH 197,001,091859,McAuley; Julian John,9998,0,9999,1
1651138267650,COGS 9,A01,083615,Staff,0,21,60,60
1651138273678,COGS 11,A01,083617,Boyle; Mary E. T.,13,0,40,27
1651138279703,COGS 13,A01,083071,Staff,0,39,40,40
1651138285729,COGS 14A,A01,092681,Staff,0,41,100,100
1651138291756,COGS 14B,A01,083073,Cheng; Tzu-Han,0,11,50,50
1651138297780,COGS 17,A01,092677,Staff,8,0,75,67
1651138303806,COGS 100,A01,083619,Staff,0,29,60,61
1651138309830,COGS 101A,A01,083621,Davis; Joshua Daniel,0,29,60,60
1651138315854,COGS 101B,A01,091572,Staff,0,8,60,60
1651138321881,COGS 101C,A01,083625,Delgado; Tania,12,0,30,18
1651138327909,COGS 107A,A01,083627,Boyle; Mary E. T.,0,17,60,60
1651138333932,COGS 118A,A01,083075,Staff,0,10,60,60
1651138339960,CSE 3,A50,083646,Miranda; Gregory Joseph,15,0,38,23
1651138339960,CSE 3,A51,083647,Miranda; Gregory Joseph,36,0,37,1
1651138345987,CSE 8A,A50,083650,Miranda; Gregory Joseph,0,30,40,40
1651138352012,CSE 11,A01,083080,Cao; Yingjun,0,98,40,40
1651138358039,CSE 12,A01,083652,Staff,0,30,100,100
1651138364065,CSE 15L,A01,083654,Staff,0,4,50,50
1651138364065,CSE 15L,A02,083655,Staff,0,3,50,50
1651138370088,CSE 20,A01,083657,Staff,47,0,80,33
1651138376112,CSE 30,A01,083084,Eldon; John,0,39,80,80
1651138382138,CSE 100,A01,083659,Cao; Yingjun,0,72,50,50
1651138388161,CSE 134B,A01,083661,Powell; Thomas Allan,0,38,65,65
1651138394187,CSE 140,A01,083663,Staff,0,17,75,75
1651138400213,CSE 140L,A01,083088,Eldon; John,1,0,100,99
1651138406237,CSE 175,A01,083665,Kumar; Rakesh,0,0,25,25
1651138412263,CSE 190,A00,092507,Dubnov; Shlomo,9,0,20,11
1651138418289,ECE 45,A01,083139,Staff,0,8,60,60
1651138424311,ECE 65,A50,083695,Staff,0,7,30,30
1651138430337,ECE 109,A01,091882,Touri; Behrouz,32,0,70,38
1651138436364,ECE 180,A00,083140,Abi Samra; Nicholas Camill,17,0,30,13
1651138436364,ECE 180,B00,083141,Abi Samra; Nicholas Camill,0,1,30,32
1651138442393,MATH 10A,A01,083735,Patchell; Gregory David,0,0,30,30
1651138442393,MATH 10A,A02,083736,Patchell; Gregory David,26,0,30,4
1651138442393,MATH 10A,A03,083737,Patchell; Gregory David,22,0,30,8
1651138448417,MATH 10B,A01,083207,Staff,0,8,30,30
1651138448417,MATH 10B,A02,083208,Staff,0,7,30,30
1651138448417,MATH 10B,B01,083739,Staff,7,0,30,23
1651138448417,MATH 10B,B02,083740,Staff,28,0,30,2
1651138454441,MATH 18,A01,083743,Staff,0,0,30,30
1651138454441,MATH 18,A02,083744,Staff,23,0,30,7
1651138454441,MATH 18,A03,083745,Staff,19,0,30,11
1651138454441,MATH 18,A04,083746,Staff,26,0,30,4
1651138454441,MATH 18,B01,083748,Staff,0,16,30,30
1651138454441,MATH 18,B02,083749,Staff,0,15,30,30
1651138454441,MATH 18,B03,083750,Staff,0,15,30,30
1651138454441,MATH 18,B04,083751,Staff,0,15,30,30
1651138460463,MATH 20A,A01,083754,Staff,18,0,40,22
1651138466487,MATH 20B,A01,083756,Briones; Jor-el Thomas Caparas,0,14,30,30
1651138466487,MATH 20B,A02,083757,Briones; Jor-el Thomas Caparas,0,11,30,30
1651138472515,MATH 20C,A01,083760,Briones; Jor-el Thomas Caparas,0,16,30,30
1651138472515,MATH 20C,A02,083761,Briones; Jor-el Thomas Caparas,0,17,30,30
1651138472515,MATH 20C,B01,083762,Staff,6,0,30,24
1651138472515,MATH 20C,B02,083763,Staff,28,0,30,2
1651138478539,MATH 20D,A01,083765,Tran; Brian Kha,4,1,30,26
1651138478539,MATH 20D,A02,083766,Tran; Brian Kha,0,0,30,30
1651138478539,MATH 20D,A03,083767,Tran; Brian Kha,21,0,30,9
1651138484565,MATH 20E,A01,083771,Staff,0,0,30,30
1651138484565,MATH 20E,A02,083772,Staff,9,0,30,21
1651138484565,MATH 20E,B01,083773,Staff,5,0,35,30
1651138484565,MATH 20E,B02,083774,Staff,4,0,35,31
1651138490587,MATH 103A,A01,083777,Greenfeld; Be'Eri,0,17,30,30
1651138490587,MATH 103A,A02,083778,Greenfeld; Be'Eri,0,18,30,30
1651138490587,MATH 103A,B01,083779,Greenfeld; Be'Eri,0,16,30,30
1651138490587,MATH 103A,B02,083780,Greenfeld; Be'Eri,0,15,30,30
1651138496609,MATH 105,A01,085443,Staff,0,24,30,30
1651138502633,MATH 109,A01,083213,Ganzberger; Geoffrey Michael,0,8,30,30
1651138502633,MATH 109,A02,083214,Ganzberger; Geoffrey Michael,0,7,30,30
1651138502633,MATH 109,B01,083215,Ganzberger; Geoffrey Michael,0,8,30,30
1651138502633,MATH 109,B02,083216,Ganzberger; Geoffrey Michael,0,7,30,30
1651138508660,MATH 142A,A01,083219,Chow; Bennett,0,16,30,30
1651138508660,MATH 142A,A02,083220,Chow; Bennett,0,15,30,30
1651138508660,MATH 142A,B01,083221,Chow; Bennett,0,16,30,30
1651138508660,MATH 142A,B02,083222,Chow; Bennett,0,15,30,30
1651138514684,MATH 193A,A01,083224,Staff,0,9,30,30
1651138514684,MATH 193A,A02,083225,Staff,0,7,30,30
1651138514684,MATH 193A,A03,083781,Staff,0,7,30,30
1651138514684,MATH 193A,A04,083782,Staff,0,7,30,30
1651138520707,MATH 197,001,091859,McAuley; Julian John,9998,0,9999,1
1651138526756,COGS 9,A01,083615,Staff,0,21,60,60
1651138532779,COGS 11,A01,083617,Boyle; Mary E. T.,13,0,40,27
1651138538805,COGS 13,A01,083071,Staff,0,39,40,40
1651138544831,COGS 14A,A01,092681,Staff,0,41,100,100
1651138550855,COGS 14B,A01,083073,Cheng; Tzu-Han,0,11,50,50
1651138556884,COGS 17,A01,092677,Staff,8,0,75,67
1651138562911,COGS 100,A01,083619,Staff,0,29,60,61
1651138568934,COGS 101A,A01,083621,Davis; Joshua Daniel,0,29,60,60
1651138574958,COGS 101B,A01,091572,Staff,0,8,60,60
1651138580983,COGS 101C,A01,083625,Delgado; Tania,12,0,30,18
1651138587006,COGS 107A,A01,083627,Boyle; Mary E. T.,0,17,60,60
1651138593030,COGS 118A,A01,083075,Staff,0,10,60,60
1651138599052,CSE 3,A50,083646,Miranda; Gregory Joseph,15,0,38,23
1651138599052,CSE 3,A51,083647,Miranda; Gregory Joseph,36,0,37,1
1651138605075,CSE 8A,A50,083650,Miranda; Gregory Joseph,0,30,40,40
1651138611098,CSE 11,A01,083080,Cao; Yingjun,0,98,40,40
1651138617122,CSE 12,A01,083652,Staff,0,30,100,100
1651138623146,CSE 15L,A01,083654,Staff,0,4,50,50
1651138623146,CSE 15L,A02,083655,Staff,0,3,50,50
1651138629172,CSE 20,A01,083657,Staff,47,0,80,33
1651138635198,CSE 30,A01,083084,Eldon; John,0,39,80,80
1651138641221,CSE 100,A01,083659,Cao; Yingjun,0,72,50,50
1651138647245,CSE 134B,A01,083661,Powell; Thomas Allan,0,38,65,65
1651138653361,CSE 140,A01,083663,Staff,0,17,75,75
1651138659385,CSE 140L,A01,083088,Eldon; John,1,0,100,99
1651138665410,CSE 175,A01,083665,Kumar; Rakesh,0,0,25,25
1651138671435,CSE 190,A00,092507,Dubnov; Shlomo,9,0,20,11
1651138677461,ECE 45,A01,083139,Staff,0,8,60,60
1651138683485,ECE 65,A50,083695,Staff,0,7,30,30
1651138689508,ECE 109,A01,091882,Touri; Behrouz,32,0,70,38
1651138695531,ECE 180,A00,083140,Abi Samra; Nicholas Camill,17,0,30,13
1651138695531,ECE 180,B00,083141,Abi Samra; Nicholas Camill,0,1,30,32
1651138701559,MATH 10A,A01,083735,Patchell; Gregory David,0,0,30,30
1651138701559,MATH 10A,A02,083736,Patchell; Gregory David,26,0,30,4
1651138701559,MATH 10A,A03,083737,Patchell; Gregory David,22,0,30,8
1651138707587,MATH 10B,A01,083207,Staff,0,8,30,30
1651138707587,MATH 10B,A02,083208,Staff,0,7,30,30
1651138707587,MATH 10B,B01,083739,Staff,7,0,30,23
1651138707587,MATH 10B,B02,083740,Staff,28,0,30,2
1651138713612,MATH 18,A01,083743,Staff,0,0,30,30
1651138713612,MATH 18,A02,083744,Staff,23,0,30,7
1651138713612,MATH 18,A03,083745,Staff,19,0,30,11
1651138713612,MATH 18,A04,083746,Staff,26,0,30,4
1651138713612,MATH 18,B01,083748,Staff,0,16,30,30
1651138713612,MATH 18,B02,083749,Staff,0,15,30,30
1651138713612,MATH 18,B03,083750,Staff,0,15,30,30
1651138713612,MATH 18,B04,083751,Staff,0,15,30,30
1651138719636,MATH 20A,A01,083754,Staff,18,0,40,22
1651138725664,MATH 20B,A01,083756,Briones; Jor-el Thomas Caparas,0,14,30,30
1651138725664,MATH 20B,A02,083757,Briones; Jor-el Thomas Caparas,0,11,30,30
1651138731695,MATH 20C,A01,083760,Briones; Jor-el Thomas Caparas,0,16,30,30
1651138731695,MATH 20C,A02,083761,Briones; Jor-el Thomas Caparas,0,17,30,30
1651138731695,MATH 20C,B01,083762,Staff,6,0,30,24
1651138731695,MATH 20C,B02,083763,Staff,28,0,30,2
1651138737722,MATH 20D,A01,083765,Tran; Brian Kha,4,1,30,26
1651138737722,MATH 20D,A02,083766,Tran; Brian Kha,0,0,30,30
1651138737722,MATH 20D,A03,083767,Tran; Brian Kha,21,0,30,9
1651138743745,MATH 20E,A01,083771,Staff,0,0,30,30
1651138743745,MATH 20E,A02,083772,Staff,9,0,30,21
1651138743745,MATH 20E,B01,083773,Staff,5,0,35,30
1651138743745,MATH 20E,B02,083774,Staff,4,0,35,31
1651138749769,MATH 103A,A01,083777,Greenfeld; Be'Eri,0,17,30,30
1651138749769,MATH 103A,A02,083778,Greenfeld; Be'Eri,0,18,30,30
1651138749769,MATH 103A,B01,083779,Greenfeld; Be'Eri,0,16,30,30
1651138749769,MATH 103A,B02,083780,Greenfeld; Be'Eri,0,15,30,30
1651138755795,MATH 105,A01,085443,Staff,0,24,30,30
1651138761823,MATH 109,A01,083213,Ganzberger; Geoffrey Michael,0,8,30,30
1651138761823,MATH 109,A02,083214,Ganzberger; Geoffrey Michael,0,7,30,30
1651138761823,MATH 109,B01,083215,Ganzberger; Geoffrey Michael,0,8,30,30
1651138761823,MATH 109,B02,083216,Ganzberger; Geoffrey Michael,0,7,30,30
1651138767851,MATH 142A,A01,083219,Chow; Bennett,0,16,30,30
1651138767851,MATH 142A,A02,083220,Chow; Bennett,0,15,30,30
1651138767851,MATH 142A,B01,083221,Chow; Bennett,0,16,30,30
1651138767851,MATH 142A,B02,083222,Chow; Bennett,0,15,30,30
1651138773875,MATH 193A,A01,083224,Staff,0,9,30,30
1651138773875,MATH 193A,A02,083225,Staff,0,7,30,30
1651138773875,MATH 193A,A03,083781,Staff,0,7,30,30
1651138773875,MATH 193A,A04,083782,Staff,0,7,30,30
1651138779913,MATH 197,001,091859,McAuley; Julian John,9998,0,9999,1
1651138785966,COGS 9,A01,083615,Staff,0,21,60,60
1651138791989,COGS 11,A01,083617,Boyle; Mary E. T.,13,0,40,27
1651138798018,COGS 13,A01,083071,Staff,0,39,40,40
1651138804040,COGS 14A,A01,092681,Staff,0,41,100,100
1651138810068,COGS 14B,A01,083073,Cheng; Tzu-Han,0,11,50,50
1651138816104,COGS 17,A01,092677,Staff,8,0,75,67
1651138822130,COGS 100,A01,083619,Staff,0,29,60,61
1651138828157,COGS 101A,A01,083621,Davis; Joshua Daniel,0,29,60,60
1651138834183,COGS 101B,A01,091572,Staff,0,8,60,60
1651138840210,COGS 101C,A01,083625,Delgado; Tania,12,0,30,18
1651138846236,COGS 107A,A01,083627,Boyle; Mary E. T.,0,17,60,60
1651138852260,COGS 118A,A01,083075,Staff,0,10,60,60
1651138858286,CSE 3,A50,083646,Miranda; Gregory Joseph,15,0,38,23
1651138858286,CSE 3,A51,083647,Miranda; Gregory Joseph,36,0,37,1
1651138864311,CSE 8A,A50,083650,Miranda; Gregory Joseph,0,30,40,40
1651138870335,CSE 11,A01,083080,Cao; Yingjun,0,98,40,40
1651138876358,CSE 12,A01,083652,Staff,0,30,100,100
1651138882382,CSE 15L,A01,083654,Staff,0,4,50,50
1651138882382,CSE 15L,A02,083655,Staff,0,3,50,50
1651138888405,CSE 20,A01,083657,Staff,47,0,80,33
1651138894429,CSE 30,A01,083084,Eldon; John,0,39,80,80
1651138900452,CSE 100,A01,083659,Cao; Yingjun,0,72,50,50
1651138906476,CSE 134B,A01,083661,Powell; Thomas Allan,0,38,65,65
1651138912501,CSE 140,A01,083663,Staff,0,17,75,75
1651138918527,CSE 140L,A01,083088,Eldon; John,1,0,100,99
1651138924554,CSE 175,A01,083665,Kumar; Rakesh,0,0,25,25
1651138930579,CSE 190,A00,092507,Dubnov; Shlomo,9,0,20,11
1651138936605,ECE 45,A01,083139,Staff,0,8,60,60
1651138942628,ECE 65,A50,083695,Staff,0,7,30,30
1651138948662,ECE 109,A01,091882,Touri; Behrouz,32,0,70,38
1651138954689,ECE 180,A00,083140,Abi Samra; Nicholas Camill,17,0,30,13
1651138954689,ECE 180,B00,083141,Abi Samra; Nicholas Camill,0,1,30,32
1651138960718,MATH 10A,A01,083735,Patchell; Gregory David,0,0,30,30
1651138960718,MATH 10A,A02,083736,Patchell; Gregory David,26,0,30,4
1651138960718,MATH 10A,A03,083737,Patchell; Gregory David,22,0,30,8
1651138966746,MATH 10B,A01,083207,Staff,0,8,30,30
1651138966746,MATH 10B,A02,083208,Staff,0,7,30,30
1651138966746,MATH 10B,B01,083739,Staff,7,0,30,23
1651138966746,MATH 10B,B02,083740,Staff,28,0,30,2
1651138972777,MATH 18,A01,083743,Staff,0,0,30,30
1651138972777,MATH 18,A02,083744,Staff,23,0,30,7
1651138972777,MATH 18,A03,083745,Staff,19,0,30,11
1651138972777,MATH 18,A04,083746,Staff,26,0,30,4
1651138972777,MATH 18,B01,083748,Staff,0,16,30,30
1651138972777,MATH 18,B02,083749,Staff,0,15,30,30
1651138972777,MATH 18,B03,083750,Staff,0,15,30,30
1651138972777,MATH 18,B04,083751,Staff,0,15,30,30
1651138978808,MATH 20A,A01,083754,Staff,18,0,40,22
1651138984847,MATH 20B,A01,083756,Briones; Jor-el Thomas Caparas,0,14,30,30
1651138984847,MATH 20B,A02,083757,Briones; Jor-el Thomas Caparas,0,11,30,30
1651138990875,MATH 20C,A01,083760,Briones; Jor-el Thomas Caparas,0,16,30,30
1651138990875,MATH 20C,A02,083761,Briones; Jor-el Thomas Caparas,0,17,30,30
1651138990875,MATH 20C,B01,083762,Staff,6,0,30,24
1651138990875,MATH 20C,B02,083763,Staff,28,0,30,2
1651138996898,MATH 20D,A01,083765,Tran; Brian Kha,4,1,30,26
1651138996898,MATH 20D,A02,083766,Tran; Brian Kha,0,0,30,30
1651138996898,MATH 20D,A03,083767,Tran; Brian Kha,21,0,30,9
1651139002925,MATH 20E,A01,083771,Staff,0,0,30,30
1651139002925,MATH 20E,A02,083772,Staff,9,0,30,21
1651139002925,MATH 20E,B01,083773,Staff,5,0,35,30
1651139002925,MATH 20E,B02,083774,Staff,4,0,35,31
1651139008949,MATH 103A,A01,083777,Greenfeld; Be'Eri,0,17,30,30
1651139008949,MATH 103A,A02,083778,Greenfeld; Be'Eri,0,18,30,30
1651139008949,MATH 103A,B01,083779,Greenfeld; Be'Eri,0,16,30,30
1651139008949,MATH 103A,B02,083780,Greenfeld; Be'Eri,0,15,30,30
1651139014972,MATH 105,A01,085443,Staff,0,24,30,30
1651139020996,MATH 109,A01,083213,Ganzberger; Geoffrey Michael,0,8,30,30
1651139020996,MATH 109,A02,083214,Ganzberger; Geoffrey Michael,0,7,30,30
1651139020996,MATH 109,B01,083215,Ganzberger; Geoffrey Michael,0,8,30,30
1651139020996,MATH 109,B02,083216,Ganzberger; Geoffrey Michael,0,7,30,30
1651139027024,MATH 142A,A01,083219,Chow; Bennett,0,16,30,30
1651139027024,MATH 142A,A02,083220,Chow; Bennett,0,15,30,30
1651139027024,MATH 142A,B01,083221,Chow; Bennett,0,16,30,30
1651139027024,MATH 142A,B02,083222,Chow; Bennett,0,15,30,30
1651139033048,MATH 193A,A01,083224,Staff,0,9,30,30
1651139033048,MATH 193A,A02,083225,Staff,0,7,30,30
1651139033048,MATH 193A,A03,083781,Staff,0,7,30,30
1651139033048,MATH 193A,A04,083782,Staff,0,7,30,30
1651139039072,MATH 197,001,091859,McAuley; Julian John,9998,0,9999,1
1651139045126,COGS 9,A01,083615,Staff,0,21,60,60
1651139051152,COGS 11,A01,083617,Boyle; Mary E. T.,13,0,40,27
1651139057178,COGS 13,A01,083071,Staff,0,39,40,40
1651139063201,COGS 14A,A01,092681,Staff,0,41,100,100
1651139069229,COGS 14B,A01,083073,Cheng; Tzu-Han,0,11,50,50
1651139075259,COGS 17,A01,092677,Staff,8,0,75,67
1651139081284,COGS 100,A01,083619,Staff,0,29,60,61
1651139087310,COGS 101A,A01,083621,Davis; Joshua Daniel,0,29,60,60
1651139093346,COGS 101B,A01,091572,Staff,0,8,60,60
1651139099374,COGS 101C,A01,083625,Delgado; Tania,12,0,30,18
1651139105401,COGS 107A,A01,083627,Boyle; Mary E. T.,0,17,60,60
1651139111425,COGS 118A,A01,083075,Staff,0,10,60,60
1651139117452,CSE 3,A50,083646,Miranda; Gregory Joseph,15,0,38,23
1651139117452,CSE 3,A51,083647,Miranda; Gregory Joseph,36,0,37,1
1651139123477,CSE 8A,A50,083650,Miranda; Gregory Joseph,0,30,40,40
1651139129503,CSE 11,A01,083080,Cao; Yingjun,0,98,40,40
1651139135526,CSE 12,A01,083652,Staff,0,30,100,100
1651139141548,CSE 15L,A01,083654,Staff,0,4,50,50
1651139141548,CSE 15L,A02,083655,Staff,0,3,50,50
1651139147571,CSE 20,A01,083657,Staff,47,0,80,33
1651139153595,CSE 30,A01,083084,Eldon; John,0,39,80,80
1651139159619,CSE 100,A01,083659,Cao; Yingjun,0,72,50,50
1651139165641,CSE 134B,A01,083661,Powell; Thomas Allan,0,38,65,65
1651139171666,CSE 140,A01,083663,Staff,0,17,75,75
1651139177689,CSE 140L,A01,083088,Eldon; John,1,0,100,99
1651139183715,CSE 175,A01,083665,Kumar; Rakesh,0,0,25,25
1651139189737,CSE 190,A00,092507,Dubnov; Shlomo,9,0,20,11
1651139195764,ECE 45,A01,083139,Staff,0,8,60,60
1651139201788,ECE 65,A50,083695,Staff,0,7,30,30
1651139207812,ECE 109,A01,091882,Touri; Behrouz,32,0,70,38
1651139213842,ECE 180,A00,083140,Abi Samra; Nicholas Camill,17,0,30,13
1651139213842,ECE 180,B00,083141,Abi Samra; Nicholas Camill,0,1,30,32
1651139219866,MATH 10A,A01,083735,Patchell; Gregory David,0,0,30,30
1651139219866,MATH 10A,A02,083736,Patchell; Gregory David,26,0,30,4
1651139219866,MATH 10A,A03,083737,Patchell; Gregory David,22,0,30,8
1651139225890,MATH 10B,A01,083207,Staff,0,8,30,30
1651139225890,MATH 10B,A02,083208,Staff,0,7,30,30
1651139225890,MATH 10B,B01,083739,Staff,7,0,30,23
1651139225890,MATH 10B,B02,083740,Staff,28,0,30,2
1651139231915,MATH 18,A01,083743,Staff,0,0,30,30
1651139231915,MATH 18,A02,083744,Staff,23,0,30,7
1651139231915,MATH 18,A03,083745,Staff,19,0,30,11
1651139231915,MATH 18,A04,083746,Staff,26,0,30,4
1651139231915,MATH 18,B01,083748,Staff,0,16,30,30
1651139231915,MATH 18,B02,083749,Staff,0,15,30,30
1651139231915,MATH 18,B03,083750,Staff,0,15,30,30
1651139231915,MATH 18,B04,083751,Staff,0,15,30,30
1651139237939,MATH 20A,A01,083754,Staff,18,0,40,22
1651139243963,MATH 20B,A01,083756,Briones; Jor-el Thomas Caparas,0,14,30,30
1651139243963,MATH 20B,A02,083757,Briones; Jor-el Thomas Caparas,0,11,30,30
1651139250077,MATH 20C,A01,083760,Briones; Jor-el Thomas Caparas,0,16,30,30
1651139250077,MATH 20C,A02,083761,Briones; Jor-el Thomas Caparas,0,17,30,30
1651139250077,MATH 20C,B01,083762,Staff,6,0,30,24
1651139250077,MATH 20C,B02,083763,Staff,28,0,30,2
1651139256101,MATH 20D,A01,083765,Tran; Brian Kha,4,1,30,26
1651139256101,MATH 20D,A02,083766,Tran; Brian Kha,0,0,30,30
1651139256101,MATH 20D,A03,083767,Tran; Brian Kha,21,0,30,9
1651139262126,MATH 20E,A01,083771,Staff,0,0,30,30
1651139262126,MATH 20E,A02,083772,Staff,9,0,30,21
1651139262126,MATH 20E,B01,083773,Staff,5,0,35,30
1651139262126,MATH 20E,B02,083774,Staff,4,0,35,31
1651139268150,MATH 103A,A01,083777,Greenfeld; Be'Eri,0,17,30,30
1651139268150,MATH 103A,A02,083778,Greenfeld; Be'Eri,0,18,30,30
1651139268150,MATH 103A,B01,083779,Greenfeld; Be'Eri,0,16,30,30
1651139268150,MATH 103A,B02,083780,Greenfeld; Be'Eri,0,15,30,30
1651139274176,MATH 105,A01,085443,Staff,0,24,30,30
1651139280201,MATH 109,A01,083213,Ganzberger; Geoffrey Michael,0,8,30,30
1651139280201,MATH 109,A02,083214,Ganzberger; Geoffrey Michael,0,7,30,30
1651139280201,MATH 109,B01,083215,Ganzberger; Geoffrey Michael,0,8,30,30
1651139280201,MATH 109,B02,083216,Ganzberger; Geoffrey Michael,0,7,30,30
1651139286224,MATH 142A,A01,083219,Chow; Bennett,0,16,30,30
1651139286224,MATH 142A,A02,083220,Chow; Bennett,0,15,30,30
1651139286224,MATH 142A,B01,083221,Chow; Bennett,0,16,30,30
1651139286224,MATH 142A,B02,083222,Chow; Bennett,0,15,30,30
1651139292250,MATH 193A,A01,083224,Staff,0,9,30,30
1651139292250,MATH 193A,A02,083225,Staff,0,7,30,30
1651139292250,MATH 193A,A03,083781,Staff,0,7,30,30
1651139292250,MATH 193A,A04,083782,Staff,0,7,30,30
1651139298273,MATH 197,001,091859,McAuley; Julian John,9998,0,9999,1
1651139304327,COGS 9,A01,083615,Staff,0,21,60,60
1651139310350,COGS 11,A01,083617,Boyle; Mary E. T.,13,0,40,27
1651139316374,COGS 13,A01,083071,Staff,0,39,40,40
1651139322397,COGS 14A,A01,092681,Staff,0,41,100,100
1651139328423,COGS 14B,A01,083073,Cheng; Tzu-Han,0,11,50,50
1651139334449,COGS 17,A01,092677,Staff,8,0,75,67
1651139340473,COGS 100,A01,083619,Staff,0,29,60,61
1651139346497,COGS 101A,A01,083621,Davis; Joshua Daniel,0,29,60,60
1651139352522,COGS 101B,A01,091572,Staff,0,8,60,60
1651139358549,COGS 101C,A01,083625,Delgado; Tania,12,0,30,18
1651139364571,COGS 107A,A01,083627,Boyle; Mary E. T.,0,17,60,60
1651139370604,COGS 118A,A01,083075,Staff,0,10,60,60
1651139376628,CSE 3,A50,083646,Miranda; Gregory Joseph,15,0,38,23
1651139376628,CSE 3,A51,083647,Miranda; Gregory Joseph,36,0,37,1
1651139382653,CSE 8A,A50,083650,Miranda; Gregory Joseph,0,30,40,40
1651139388681,CSE 11,A01,083080,Cao; Yingjun,0,98,40,40
1651139394704,CSE 12,A01,083652,Staff,0,30,100,100
1651139400730,CSE 15L,A01,083654,Staff,0,4,50,50
1651139400730,CSE 15L,A02,083655,Staff,0,3,50,50
1651139406758,CSE 20,A01,083657,Staff,47,0,80,33
1651139412780,CSE 30,A01,083084,Eldon; John,0,39,80,80
1651139418807,CSE 100,A01,083659,Cao; Yingjun,0,72,50,50
1651139424834,CSE 134B,A01,083661,Powell; Thomas Allan,0,38,65,65
1651139430862,CSE 140,A01,083663,Staff,0,17,75,75
1651139436890,CSE 140L,A01,083088,Eldon; John,1,0,100,99
1651139442913,CSE 175,A01,083665,Kumar; Rakesh,0,0,25,25
1651139448936,CSE 190,A00,092507,Dubnov; Shlomo,9,0,20,11
1651139454960,ECE 45,A01,083139,Staff,0,8,60,60
1651139460984,ECE 65,A50,083695,Staff,0,7,30,30
1651139467008,ECE 109,A01,091882,Touri; Behrouz,32,0,70,38
1651139473031,ECE 180,A00,083140,Abi Samra; Nicholas Camill,17,0,30,13
1651139473031,ECE 180,B00,083141,Abi Samra; Nicholas Camill,0,1,30,32
1651139479054,MATH 10A,A01,083735,Patchell; Gregory David,0,0,30,30
1651139479054,MATH 10A,A02,083736,Patchell; Gregory David,26,0,30,4
1651139479054,MATH 10A,A03,083737,Patchell; Gregory David,22,0,30,8
1651139485082,MATH 10B,A01,083207,Staff,0,8,30,30
1651139485082,MATH 10B,A02,083208,Staff,0,7,30,30
1651139485082,MATH 10B,B01,083739,Staff,7,0,30,23
1651139485082,MATH 10B,B02,083740,Staff,28,0,30,2
1651139491108,MATH 18,A01,083743,Staff,0,0,30,30
1651139491108,MATH 18,A02,083744,Staff,23,0,30,7
1651139491108,MATH 18,A03,083745,Staff,19,0,30,11
1651139491108,MATH 18,A04,083746,Staff,26,0,30,4
1651139491108,MATH 18,B01,083748,Staff,0,16,30,30
1651139491108,MATH 18,B02,083749,Staff,0,15,30,30
1651139491108,MATH 18,B03,083750,Staff,0,15,30,30
1651139491108,MATH 18,B04,083751,Staff,0,15,30,30
1651139497134,MATH 20A,A01,083754,Staff,18,0,40,22
1651139503163,MATH 20B,A01,083756,Briones; Jor-el Thomas Caparas,0,14,30,30
1651139503163,MATH 20B,A02,083757,Briones; Jor-el Thomas Caparas,0,11,30,30
1651139509187,MATH 20C,A01,083760,Briones; Jor-el Thomas Caparas,0,16,30,30
1651139509187,MATH 20C,A02,083761,Briones; Jor-el Thomas Caparas,0,17,30,30
1651139509187,MATH 20C,B01,083762,Staff,6,0,30,24
1651139509187,MATH 20C,B02,083763,Staff,28,0,30,2
1651139515211,MATH 20D,A01,083765,Tran; Brian Kha,4,1,30,26
1651139515211,MATH 20D,A02,083766,Tran; Brian Kha,0,0,30,30
1651139515211,MATH 20D,A03,083767,Tran; Brian Kha,21,0,30,9
1651139521236,MATH 20E,A01,083771,Staff,0,0,30,30
1651139521236,MATH 20E,A02,083772,Staff,9,0,30,21
1651139521236,MATH 20E,B01,083773,Staff,5,0,35,30
1651139521236,MATH 20E,B02,083774,Staff,4,0,35,31
1651139527273,MATH 103A,A01,083777,Greenfeld; Be'Eri,0,17,30,30
1651139527273,MATH 103A,A02,083778,Greenfeld; Be'Eri,0,18,30,30
1651139527273,MATH 103A,B01,083779,Greenfeld; Be'Eri,0,16,30,30
1651139527273,MATH 103A,B02,083780,Greenfeld; Be'Eri,0,15,30,30
1651139533298,MATH 105,A01,085443,Staff,0,24,30,30
1651139539325,MATH 109,A01,083213,Ganzberger; Geoffrey Michael,0,8,30,30
1651139539325,MATH 109,A02,083214,Ganzberger; Geoffrey Michael,0,7,30,30
1651139539325,MATH 109,B01,083215,Ganzberger; Geoffrey Michael,0,8,30,30
1651139539325,MATH 109,B02,083216,Ganzberger; Geoffrey Michael,0,7,30,30
1651139545350,MATH 142A,A01,083219,Chow; Bennett,0,16,30,30
1651139545350,MATH 142A,A02,083220,Chow; Bennett,0,15,30,30
1651139545350,MATH 142A,B01,083221,Chow; Bennett,0,16,30,30
1651139545350,MATH 142A,B02,083222,Chow; Bennett,0,15,30,30
1651139551374,MATH 193A,A01,083224,Staff,0,9,30,30
1651139551374,MATH 193A,A02,083225,Staff,0,7,30,30
1651139551374,MATH 193A,A03,083781,Staff,0,7,30,30
1651139551374,MATH 193A,A04,083782,Staff,0,7,30,30
1651139557397,MATH 197,001,091859,McAuley; Julian John,9998,0,9999,1
1651139563456,COGS 9,A01,083615,Staff,0,21,60,60
1651139569483,COGS 11,A01,083617,Boyle; Mary E. T.,13,0,40,27
1651139575506,COGS 13,A01,083071,Staff,0,39,40,40
1651139581535,COGS 14A,A01,092681,Staff,0,41,100,100
1651139587562,COGS 14B,A01,083073,Cheng; Tzu-Han,0,11,50,50
1651139593587,COGS 17,A01,092677,Staff,8,0,75,67
1651139599610,COGS 100,A01,083619,Staff,0,29,60,61
1651139605638,COGS 101A,A01,083621,Davis; Joshua Daniel,0,29,60,60
1651139611664,COGS 101B,A01,091572,Staff,0,8,60,60
1651139617691,COGS 101C,A01,083625,Delgado; Tania,12,0,30,18
1651139623716,COGS 107A,A01,083627,Boyle; Mary E. T.,0,17,60,60
1651139629739,COGS 118A,A01,083075,Staff,0,10,60,60
1651139635763,CSE 3,A50,083646,Miranda; Gregory Joseph,15,0,38,23
1651139635763,CSE 3,A51,083647,Miranda; Gregory Joseph,36,0,37,1
1651139641787,CSE 8A,A50,083650,Miranda; Gregory Joseph,0,30,40,40
1651139647811,CSE 11,A01,083080,Cao; Yingjun,0,98,40,40
1651139653833,CSE 12,A01,083652,Staff,0,30,100,100
1651139659860,CSE 15L,A01,083654,Staff,0,4,50,50
1651139659860,CSE 15L,A02,083655,Staff,0,3,50,50
1651139665883,CSE 20,A01,083657,Staff,47,0,80,33
1651139671906,CSE 30,A01,083084,Eldon; John,0,39,80,80
1651139677932,CSE 100,A01,083659,Cao; Yingjun,0,72,50,50
1651139683958,CSE 134B,A01,083661,Powell; Thomas Allan,0,38,65,65
1651139689985,CSE 140,A01,083663,Staff,0,17,75,75
1651139696009,CSE 140L,A01,083088,Eldon; John,1,0,100,99
1651139702035,CSE 175,A01,083665,Kumar; Rakesh,0,0,25,25
1651139708064,CSE 190,A00,092507,Dubnov; Shlomo,9,0,20,11
1651139714087,ECE 45,A01,083139,Staff,0,8,60,60
1651139720110,ECE 65,A50,083695,Staff,0,7,30,30
1651139726141,ECE 109,A01,091882,Touri; Behrouz,32,0,70,38
1651139732166,ECE 180,A00,083140,Abi Samra; Nicholas Camill,17,0,30,13
1651139732166,ECE 180,B00,083141,Abi Samra; Nicholas Camill,0,1,30,32
1651139738191,MATH 10A,A01,083735,Patchell; Gregory David,0,0,30,30
1651139738191,MATH 10A,A02,083736,Patchell; Gregory David,26,0,30,4
1651139738191,MATH 10A,A03,083737,Patchell; Gregory David,22,0,30,8
1651139744221,MATH 10B,A01,083207,Staff,0,8,30,30
1651139744221,MATH 10B,A02,083208,Staff,0,7,30,30
1651139744221,MATH 10B,B01,083739,Staff,7,0,30,23
1651139744221,MATH 10B,B02,083740,Staff,28,0,30,2
1651139750257,MATH 18,A01,083743,Staff,0,0,30,30
1651139750257,MATH 18,A02,083744,Staff,23,0,30,7
1651139750257,MATH 18,A03,083745,Staff,19,0,30,11
1651139750257,MATH 18,A04,083746,Staff,26,0,30,4
1651139750257,MATH 18,B01,083748,Staff,0,16,30,30
1651139750257,MATH 18,B02,083749,Staff,0,15,30,30
1651139750257,MATH 18,B03,083750,Staff,0,15,30,30
1651139750257,MATH 18,B04,083751,Staff,0,15,30,30
1651139756283,MATH 20A,A01,083754,Staff,18,0,40,22
1651139762308,MATH 20B,A01,083756,Briones; Jor-el Thomas Caparas,0,14,30,30
1651139762308,MATH 20B,A02,083757,Briones; Jor-el Thomas Caparas,0,11,30,30
1651139768331,MATH 20C,A01,083760,Briones; Jor-el Thomas Caparas,0,16,30,30
1651139768331,MATH 20C,A02,083761,Briones; Jor-el Thomas Caparas,0,17,30,30
1651139768331,MATH 20C,B01,083762,Staff,6,0,30,24
1651139768331,MATH 20C,B02,083763,Staff,28,0,30,2
1651139774356,MATH 20D,A01,083765,Tran; Brian Kha,4,1,30,26
1651139774356,MATH 20D,A02,083766,Tran; Brian Kha,0,0,30,30
1651139774356,MATH 20D,A03,083767,Tran; Brian Kha,21,0,30,9
1651139780387,MATH 20E,A01,083771,Staff,0,0,30,30
1651139780387,MATH 20E,A02,083772,Staff,9,0,30,21
1651139780387,MATH 20E,B01,083773,Staff,5,0,35,30
1651139780387,MATH 20E,B02,083774,Staff,4,0,35,31
1651139786411,MATH 103A,A01,083777,Greenfeld; Be'Eri,0,17,30,30
1651139786411,MATH 103A,A02,083778,Greenfeld; Be'Eri,0,18,30,30
1651139786411,MATH 103A,B01,083779,Greenfeld; Be'Eri,0,16,30,30
1651139786411,MATH 103A,B02,083780,Greenfeld; Be'Eri,0,15,30,30
1651139792435,MATH 105,A01,085443,Staff,0,24,30,30
1651139798467,MATH 109,A01,083213,Ganzberger; Geoffrey Michael,0,8,30,30
1651139798467,MATH 109,A02,083214,Ganzberger; Geoffrey Michael,0,7,30,30
1651139798467,MATH 109,B01,083215,Ganzberger; Geoffrey Michael,0,8,30,30
1651139798467,MATH 109,B02,083216,Ganzberger; Geoffrey Michael,0,7,30,30
1651139804490,MATH 142A,A01,083219,Chow; Bennett,0,16,30,30
1651139804490,MATH 142A,A02,083220,Chow; Bennett,0,15,30,30
1651139804490,MATH 142A,B01,083221,Chow; Bennett,0,16,30,30
1651139804490,MATH 142A,B02,083222,Chow; Bennett,0,15,30,30
1651139810520,MATH 193A,A01,083224,Staff,0,9,30,30
1651139810520,MATH 193A,A02,083225,Staff,0,7,30,30
1651139810520,MATH 193A,A03,083781,Staff,0,7,30,30
1651139810520,MATH 193A,A04,083782,Staff,0,7,30,30
1651139816549,MATH 197,001,091859,McAuley; Julian John,9998,0,9999,1
1651139822619,COGS 9,A01,083615,Staff,0,21,60,60
1651139828646,COGS 11,A01,083617,Boyle; Mary E. T.,13,0,40,27
1651139834685,COGS 13,A01,083071,Staff,0,39,40,40
1651139840802,COGS 14A,A01,092681,Staff,0,41,100,100
1651139846828,COGS 14B,A01,083073,Cheng; Tzu-Han,0,11,50,50
1651139852854,COGS 17,A01,092677,Staff,8,0,75,67
1651139858879,COGS 100,A01,083619,Staff,0,29,60,61
1651139864905,COGS 101A,A01,083621,Davis; Joshua Daniel,0,29,60,60
1651139870935,COGS 101B,A01,091572,Staff,0,8,60,60
1651139876968,COGS 101C,A01,083625,Delgado; Tania,12,0,30,18
1651139882999,COGS 107A,A01,083627,Boyle; Mary E. T.,0,17,60,60
1651139889025,COGS 118A,A01,083075,Staff,0,10,60,60
1651139895077,CSE 3,A50,083646,Miranda; Gregory Joseph,15,0,38,23
1651139895077,CSE 3,A51,083647,Miranda; Gregory Joseph,36,0,37,1
1651139901101,CSE 8A,A50,083650,Miranda; Gregory Joseph,0,30,40,40
1651139907127,CSE 11,A01,083080,Cao; Yingjun,0,98,40,40
1651139913156,CSE 12,A01,083652,Staff,0,30,100,100
1651139919179,CSE 15L,A01,083654,Staff,0,4,50,50
1651139919179,CSE 15L,A02,083655,Staff,0,3,50,50
1651139925204,CSE 20,A01,083657,Staff,47,0,80,33
1651139931241,CSE 30,A01,083084,Eldon; John,0,39,80,80
1651139937267,CSE 100,A01,083659,Cao; Yingjun,0,72,50,50
1651139943298,CSE 134B,A01,083661,Powell; Thomas Allan,0,38,65,65
1651139949325,CSE 140,A01,083663,Staff,0,17,75,75
1651139955350,CSE 140L,A01,083088,Eldon; John,1,0,100,99
1651139961376,CSE 175,A01,083665,Kumar; Rakesh,0,0,25,25
1651139967402,CSE 190,A00,092507,Dubnov; Shlomo,9,0,20,11
1651139973437,ECE 45,A01,083139,Staff,0,8,60,60
1651139979462,ECE 65,A50,083695,Staff,0,7,30,30
1651139985488,ECE 109,A01,091882,Touri; Behrouz,32,0,70,38
1651139991514,ECE 180,A00,083140,Abi Samra; Nicholas Camill,17,0,30,13
1651139991514,ECE 180,B00,083141,Abi Samra; Nicholas Camill,0,1,30,32
1651139997549,MATH 10A,A01,083735,Patchell; Gregory David,0,0,30,30
1651139997549,MATH 10A,A02,083736,Patchell; Gregory David,26,0,30,4
1651139997549,MATH 10A,A03,083737,Patchell; Gregory David,22,0,30,8
1651140003582,MATH 10B,A01,083207,Staff,0,8,30,30
1651140003582,MATH 10B,A02,083208,Staff,0,7,30,30
1651140003582,MATH 10B,B01,083739,Staff,7,0,30,23
1651140003582,MATH 10B,B02,083740,Staff,28,0,30,2
1651140009621,MATH 18,A01,083743,Staff,0,0,30,30
1651140009621,MATH 18,A02,083744,Staff,23,0,30,7
1651140009621,MATH 18,A03,083745,Staff,19,0,30,11
1651140009621,MATH 18,A04,083746,Staff,26,0,30,4
1651140009621,MATH 18,B01,083748,Staff,0,16,30,30
1651140009621,MATH 18,B02,083749,Staff,0,15,30,30
1651140009621,MATH 18,B03,083750,Staff,0,15,30,30
1651140009621,MATH 18,B04,083751,Staff,0,15,30,30
1651140015643,MATH 20A,A01,083754,Staff,18,0,40,22
1651140021668,MATH 20B,A01,083756,Briones; Jor-el Thomas Caparas,0,14,30,30
1651140021668,MATH 20B,A02,083757,Briones; Jor-el Thomas Caparas,0,11,30,30
1651140027697,MATH 20C,A01,083760,Briones; Jor-el Thomas Caparas,0,16,30,30
1651140027697,MATH 20C,A02,083761,Briones; Jor-el Thomas Caparas,0,17,30,30
1651140027697,MATH 20C,B01,083762,Staff,6,0,30,24
1651140027697,MATH 20C,B02,083763,Staff,28,0,30,2
1651140033728,MATH 20D,A01,083765,Tran; Brian Kha,4,1,30,26
1651140033728,MATH 20D,A02,083766,Tran; Brian Kha,0,0,30,30
1651140033728,MATH 20D,A03,083767,Tran; Brian Kha,21,0,30,9
1651140039754,MATH 20E,A01,083771,Staff,0,0,30,30
1651140039754,MATH 20E,A02,083772,Staff,9,0,30,21
1651140039754,MATH 20E,B01,083773,Staff,5,0,35,30
1651140039754,MATH 20E,B02,083774,Staff,4,0,35,31
1651140045779,MATH 103A,A01,083777,Greenfeld; Be'Eri,0,17,30,30
1651140045779,MATH 103A,A02,083778,Greenfeld; Be'Eri,0,18,30,30
1651140045779,MATH 103A,B01,083779,Greenfeld; Be'Eri,0,16,30,30
1651140045779,MATH 103A,B02,083780,Greenfeld; Be'Eri,0,15,30,30
1651140051807,MATH 105,A01,085443,Staff,0,24,30,30
1651140057838,MATH 109,A01,083213,Ganzberger; Geoffrey Michael,0,8,30,30
1651140057838,MATH 109,A02,083214,Ganzberger; Geoffrey Michael,0,7,30,30
1651140057838,MATH 109,B01,083215,Ganzberger; Geoffrey Michael,0,8,30,30
1651140057838,MATH 109,B02,083216,Ganzberger; Geoffrey Michael,0,7,30,30
1651140063870,MATH 142A,A01,083219,Chow; Bennett,0,16,30,30
1651140063870,MATH 142A,A02,083220,Chow; Bennett,0,15,30,30
1651140063870,MATH 142A,B01,083221,Chow; Bennett,0,16,30,30
1651140063870,MATH 142A,B02,083222,Chow; Bennett,0,15,30,30
1651140069895,MATH 193A,A01,083224,Staff,0,9,30,30
1651140069895,MATH 193A,A02,083225,Staff,0,7,30,30
1651140069895,MATH 193A,A03,083781,Staff,0,7,30,30
1651140069895,MATH 193A,A04,083782,Staff,0,7,30,30
1651140075919,MATH 197,001,091859,McAuley; Julian John,9998,0,9999,1
1651140082002,COGS 9,A01,083615,Staff,0,21,60,60
1651140088032,COGS 11,A01,083617,Boyle; Mary E. T.,13,0,40,27
1651140094060,COGS 13,A01,083071,Staff,0,39,40,40
1651140100092,COGS 14A,A01,092681,Staff,0,41,100,100
1651140106117,COGS 14B,A01,083073,Cheng; Tzu-Han,0,11,50,50
1651140112144,COGS 17,A01,092677,Staff,8,0,75,67
1651140118170,COGS 100,A01,083619,Staff,0,29,60,61
1651140124195,COGS 101A,A01,083621,Davis; Joshua Daniel,0,29,60,60
1651140130219,COGS 101B,A01,091572,Staff,0,8,60,60
1651140136245,COGS 101C,A01,083625,Delgado; Tania,12,0,30,18
1651140142274,COGS 107A,A01,083627,Boyle; Mary E. T.,0,17,60,60
1651140148301,COGS 118A,A01,083075,Staff,0,10,60,60
1651140154327,CSE 3,A50,083646,Miranda; Gregory Joseph,15,0,38,23
1651140154327,CSE 3,A51,083647,Miranda; Gregory Joseph,36,0,37,1
1651140160355,CSE 8A,A50,083650,Miranda; Gregory Joseph,0,30,40,40
1651140166381,CSE 11,A01,083080,Cao; Yingjun,0,98,40,40
1651140172406,CSE 12,A01,083652,Staff,0,30,100,100
1651140178434,CSE 15L,A01,083654,Staff,0,4,50,50
1651140178434,CSE 15L,A02,083655,Staff,0,3,50,50
1651140184464,CSE 20,A01,083657,Staff,47,0,80,33
1651140190488,CSE 30,A01,083084,Eldon; John,0,39,80,80
1651140196518,CSE 100,A01,083659,Cao; Yingjun,0,72,50,50
1651140202547,CSE 134B,A01,083661,Powell; Thomas Allan,0,38,65,65
1651140208576,CSE 140,A01,083663,Staff,0,17,75,75
1651140214600,CSE 140L,A01,083088,Eldon; John,1,0,100,99
1651140220625,CSE 175,A01,083665,Kumar; Rakesh,0,0,25,25
1651140226661,CSE 190,A00,092507,Dubnov; Shlomo,9,0,20,11
1651140232691,ECE 45,A01,083139,Staff,0,8,60,60
1651140238720,ECE 65,A50,083695,Staff,0,7,30,30
1651140244745,ECE 109,A01,091882,Touri; Behrouz,32,0,70,38
1651140250775,ECE 180,A00,083140,Abi Samra; Nicholas Camill,17,0,30,13
1651140250775,ECE 180,B00,083141,Abi Samra; Nicholas Camill,0,1,30,32
1651140256806,MATH 10A,A01,083735,Patchell; Gregory David,0,0,30,30
1651140256806,MATH 10A,A02,083736,Patchell; Gregory David,26,0,30,4
1651140256806,MATH 10A,A03,083737,Patchell; Gregory David,22,0,30,8
1651140262841,MATH 10B,A01,083207,Staff,0,8,30,30
1651140262841,MATH 10B,A02,083208,Staff,0,7,30,30
1651140262841,MATH 10B,B01,083739,Staff,7,0,30,23
1651140262841,MATH 10B,B02,083740,Staff,28,0,30,2
1651140268871,MATH 18,A01,083743,Staff,0,0,30,30
1651140268871,MATH 18,A02,083744,Staff,23,0,30,7
1651140268871,MATH 18,A03,083745,Staff,19,0,30,11
1651140268871,MATH 18,A04,083746,Staff,26,0,30,4
1651140268871,MATH 18,B01,083748,Staff,0,16,30,30
1651140268871,MATH 18,B02,083749,Staff,0,15,30,30
1651140268871,MATH 18,B03,083750,Staff,0,15,30,30
1651140268871,MATH 18,B04,083751,Staff,0,15,30,30
1651140274895,MATH 20A,A01,083754,Staff,18,0,40,22
1651140280925,MATH 20B,A01,083756,Briones; Jor-el Thomas Caparas,0,14,30,30
1651140280925,MATH 20B,A02,083757,Briones; Jor-el Thomas Caparas,0,11,30,30
1651140286952,MATH 20C,A01,083760,Briones; Jor-el Thomas Caparas,0,16,30,30
1651140286952,MATH 20C,A02,083761,Briones; Jor-el Thomas Caparas,0,17,30,30
1651140286952,MATH 20C,B01,083762,Staff,6,0,30,24
1651140286952,MATH 20C,B02,083763,Staff,28,0,30,2
1651140292982,MATH 20D,A01,083765,Tran; Brian Kha,4,1,30,26
1651140292982,MATH 20D,A02,083766,Tran; Brian Kha,0,0,30,30
1651140292982,MATH 20D,A03,083767,Tran; Brian Kha,21,0,30,9
1651140299009,MATH 20E,A01,083771,Staff,0,0,30,30
1651140299009,MATH 20E,A02,083772,Staff,9,0,30,21
1651140299009,MATH 20E,B01,083773,Staff,5,0,35,30
1651140299009,MATH 20E,B02,083774,Staff,4,0,35,31
1651140305046,MATH 103A,A01,083777,Greenfeld; Be'Eri,0,17,30,30
1651140305046,MATH 103A,A02,083778,Greenfeld; Be'Eri,0,18,30,30
1651140305046,MATH 103A,B01,083779,Greenfeld; Be'Eri,0,16,30,30
1651140305046,MATH 103A,B02,083780,Greenfeld; Be'Eri,0,15,30,30
1651140311070,MATH 105,A01,085443,Staff,0,24,30,30
1651140317102,MATH 109,A01,083213,Ganzberger; Geoffrey Michael,0,8,30,30
1651140317102,MATH 109,A02,083214,Ganzberger; Geoffrey Michael,0,7,30,30
1651140317102,MATH 109,B01,083215,Ganzberger; Geoffrey Michael,0,8,30,30
1651140317102,MATH 109,B02,083216,Ganzberger; Geoffrey Michael,0,7,30,30
1651140323135,MATH 142A,A01,083219,Chow; Bennett,0,16,30,30
1651140323135,MATH 142A,A02,083220,Chow; Bennett,0,15,30,30
1651140323135,MATH 142A,B01,083221,Chow; Bennett,0,16,30,30
1651140323135,MATH 142A,B02,083222,Chow; Bennett,0,15,30,30
1651140329175,MATH 193A,A01,083224,Staff,0,9,30,30
1651140329175,MATH 193A,A02,083225,Staff,0,7,30,30
1651140329175,MATH 193A,A03,083781,Staff,0,7,30,30
1651140329175,MATH 193A,A04,083782,Staff,0,7,30,30
1651140335200,MATH 197,001,091859,McAuley; Julian John,9998,0,9999,1
1651140341282,COGS 9,A01,083615,Staff,0,21,60,60
1651140347314,COGS 11,A01,083617,Boyle; Mary E. T.,13,0,40,27
1651140353338,COGS 13,A01,083071,Staff,0,39,40,40
1651140359365,COGS 14A,A01,092681,Staff,0,41,100,100
1651140365395,COGS 14B,A01,083073,Cheng; Tzu-Han,0,11,50,50
1651140371424,COGS 17,A01,092677,Staff,8,0,75,67
1651140377450,COGS 100,A01,083619,Staff,0,29,60,61
1651140383477,COGS 101A,A01,083621,Davis; Joshua Daniel,0,29,60,60
1651140389501,COGS 101B,A01,091572,Staff,0,8,60,60
1651140395532,COGS 101C,A01,083625,Delgado; Tania,12,0,30,18
1651140401561,COGS 107A,A01,083627,Boyle; Mary E. T.,0,17,60,60
1651140407591,COGS 118A,A01,083075,Staff,0,10,60,60
1651140413626,CSE 3,A50,083646,Miranda; Gregory Joseph,15,0,38,23
1651140413626,CSE 3,A51,083647,Miranda; Gregory Joseph,36,0,37,1
1651140419655,CSE 8A,A50,083650,Miranda; Gregory Joseph,0,30,40,40
1651140425687,CSE 11,A01,083080,Cao; Yingjun,0,98,40,40
1651140431712,CSE 12,A01,083652,Staff,0,30,100,100
1651140437821,CSE 15L,A01,083654,Staff,0,4,50,50
1651140437821,CSE 15L,A02,083655,Staff,0,3,50,50
1651140443850,CSE 20,A01,083657,Staff,47,0,80,33
1651140449883,CSE 30,A01,083084,Eldon; John,0,39,80,80
1651140455916,CSE 100,A01,083659,Cao; Yingjun,0,72,50,50
1651140461948,CSE 134B,A01,083661,Powell; Thomas Allan,0,38,65,65
1651140467978,CSE 140,A01,083663,Staff,0,17,75,75
1651140474009,CSE 140L,A01,083088,Eldon; John,1,0,100,99
1651140480041,CSE 175,A01,083665,Kumar; Rakesh,0,0,25,25
1651140486066,CSE 190,A00,092507,Dubnov; Shlomo,9,0,20,11
1651140492095,ECE 45,A01,083139,Staff,0,8,60,60
1651140498121,ECE 65,A50,083695,Staff,0,7,30,30
1651140504202,ECE 109,A01,091882,Touri; Behrouz,32,0,70,38
1651140510233,ECE 180,A00,083140,Abi Samra; Nicholas Camill,17,0,30,13
1651140510233,ECE 180,B00,083141,Abi Samra; Nicholas Camill,0,1,30,32
1651140516267,MATH 10A,A01,083735,Patchell; Gregory David,0,0,30,30
1651140516267,MATH 10A,A02,083736,Patchell; Gregory David,26,0,30,4
1651140516267,MATH 10A,A03,083737,Patchell; Gregory David,22,0,30,8
1651140522293,MATH 10B,A01,083207,Staff,0,8,30,30
1651140522293,MATH 10B,A02,083208,Staff,0,7,30,30
1651140522293,MATH 10B,B01,083739,Staff,7,0,30,23
1651140522293,MATH 10B,B02,083740,Staff,28,0,30,2
1651140528324,MATH 18,A01,083743,Staff,0,0,30,30
1651140528324,MATH 18,A02,083744,Staff,23,0,30,7
1651140528324,MATH 18,A03,083745,Staff,19,0,30,11
1651140528324,MATH 18,A04,083746,Staff,26,0,30,4
1651140528324,MATH 18,B01,083748,Staff,0,16,30,30
1651140528324,MATH 18,B02,083749,Staff,0,15,30,30
1651140528324,MATH 18,B03,083750,Staff,0,15,30,30
1651140528324,MATH 18,B04,083751,Staff,0,15,30,30
1651140534348,MATH 20A,A01,083754,Staff,18,0,40,22
1651140540386,MATH 20B,A01,083756,Briones; Jor-el Thomas Caparas,0,14,30,30
1651140540386,MATH 20B,A02,083757,Briones; Jor-el Thomas Caparas,0,11,30,30
1651140546425,MATH 20C,A01,083760,Briones; Jor-el Thomas Caparas,0,16,30,30
1651140546425,MATH 20C,A02,083761,Briones; Jor-el Thomas Caparas,0,17,30,30
1651140546425,MATH 20C,B01,083762,Staff,6,0,30,24
1651140546425,MATH 20C,B02,083763,Staff,28,0,30,2
1651140552455,MATH 20D,A01,083765,Tran; Brian Kha,4,1,30,26
1651140552455,MATH 20D,A02,083766,Tran; Brian Kha,0,0,30,30
1651140552455,MATH 20D,A03,083767,Tran; Brian Kha,21,0,30,9
1651140558481,MATH 20E,A01,083771,Staff,0,0,30,30
1651140558481,MATH 20E,A02,083772,Staff,9,0,30,21
1651140558481,MATH 20E,B01,083773,Staff,5,0,35,30
1651140558481,MATH 20E,B02,083774,Staff,4,0,35,31
1651140564508,MATH 103A,A01,083777,Greenfeld; Be'Eri,0,17,30,30
1651140564508,MATH 103A,A02,083778,Greenfeld; Be'Eri,0,18,30,30
1651140564508,MATH 103A,B01,083779,Greenfeld; Be'Eri,0,16,30,30
1651140564508,MATH 103A,B02,083780,Greenfeld; Be'Eri,0,15,30,30
1651140570532,MATH 105,A01,085443,Staff,0,24,30,30
1651140576564,MATH 109,A01,083213,Ganzberger; Geoffrey Michael,0,8,30,30
1651140576564,MATH 109,A02,083214,Ganzberger; Geoffrey Michael,0,7,30,30
1651140576564,MATH 109,B01,083215,Ganzberger; Geoffrey Michael,0,8,30,30
1651140576564,MATH 109,B02,083216,Ganzberger; Geoffrey Michael,0,7,30,30
1651140582590,MATH 142A,A01,083219,Chow; Bennett,0,16,30,30
1651140582590,MATH 142A,A02,083220,Chow; Bennett,0,15,30,30
1651140582590,MATH 142A,B01,083221,Chow; Bennett,0,16,30,30
1651140582590,MATH 142A,B02,083222,Chow; Bennett,0,15,30,30
1651140588615,MATH 193A,A01,083224,Staff,0,9,30,30
1651140588615,MATH 193A,A02,083225,Staff,0,7,30,30
1651140588615,MATH 193A,A03,083781,Staff,0,7,30,30
1651140588615,MATH 193A,A04,083782,Staff,0,7,30,30
1651140594640,MATH 197,001,091859,McAuley; Julian John,9998,0,9999,1
1651140600714,COGS 9,A01,083615,Staff,0,21,60,60
1651140606744,COGS 11,A01,083617,Boyle; Mary E. T.,13,0,40,27
1651140612773,COGS 13,A01,083071,Staff,0,39,40,40
1651140618801,COGS 14A,A01,092681,Staff,0,41,100,100
1651140624825,COGS 14B,A01,083073,Cheng; Tzu-Han,0,11,50,50
1651140630855,COGS 17,A01,092677,Staff,8,0,75,67
1651140636880,COGS 100,A01,083619,Staff,0,29,60,61
1651140642905,COGS 101A,A01,083621,Davis; Joshua Daniel,0,29,60,60
1651140648930,COGS 101B,A01,091572,Staff,0,8,60,60
1651140654960,COGS 101C,A01,083625,Delgado; Tania,12,0,30,18
1651140660984,COGS 107A,A01,083627,Boyle; Mary E. T.,0,17,60,60
1651140667011,COGS 118A,A01,083075,Staff,0,10,60,60
1651140673046,CSE 3,A50,083646,Miranda; Gregory Joseph,15,0,38,23
1651140673046,CSE 3,A51,083647,Miranda; Gregory Joseph,36,0,37,1
1651140679070,CSE 8A,A50,083650,Miranda; Gregory Joseph,0,30,40,40
1651140685099,CSE 11,A01,083080,Cao; Yingjun,0,98,40,40
1651140691123,CSE 12,A01,083652,Staff,0,30,100,100
1651140697152,CSE 15L,A01,083654,Staff,0,4,50,50
1651140697152,CSE 15L,A02,083655,Staff,0,3,50,50
1651140703175,CSE 20,A01,083657,Staff,47,0,80,33
1651140709200,CSE 30,A01,083084,Eldon; John,0,39,80,80
1651140715225,CSE 100,A01,083659,Cao; Yingjun,0,72,50,50
1651140721248,CSE 134B,A01,083661,Powell; Thomas Allan,0,38,65,65
1651140727271,CSE 140,A01,083663,Staff,0,17,75,75
1651140733297,CSE 140L,A01,083088,Eldon; John,1,0,100,99
1651140739325,CSE 175,A01,083665,Kumar; Rakesh,0,0,25,25
1651140745348,CSE 190,A00,092507,Dubnov; Shlomo,9,0,20,11
1651140751376,ECE 45,A01,083139,Staff,0,8,60,60
1651140757406,ECE 65,A50,083695,Staff,0,7,30,30
1651140763431,ECE 109,A01,091882,Touri; Behrouz,32,0,70,38
1651140769462,ECE 180,A00,083140,Abi Samra; Nicholas Camill,17,0,30,13
1651140769462,ECE 180,B00,083141,Abi Samra; Nicholas Camill,0,1,30,32
1651140775489,MATH 10A,A01,083735,Patchell; Gregory David,0,0,30,30
1651140775489,MATH 10A,A02,083736,Patchell; Gregory David,26,0,30,4
1651140775489,MATH 10A,A03,083737,Patchell; Gregory David,22,0,30,8
1651140781530,MATH 10B,A01,083207,Staff,0,8,30,30
1651140781530,MATH 10B,A02,083208,Staff,0,7,30,30
1651140781530,MATH 10B,B01,083739,Staff,7,0,30,23
1651140781530,MATH 10B,B02,083740,Staff,28,0,30,2
1651140787575,MATH 18,A01,083743,Staff,0,0,30,30
1651140787575,MATH 18,A02,083744,Staff,23,0,30,7
1651140787575,MATH 18,A03,083745,Staff,19,0,30,11
1651140787575,MATH 18,A04,083746,Staff,26,0,30,4
1651140787575,MATH 18,B01,083748,Staff,0,16,30,30
1651140787575,MATH 18,B02,083749,Staff,0,15,30,30
1651140787575,MATH 18,B03,083750,Staff,0,15,30,30
1651140787575,MATH 18,B04,083751,Staff,0,15,30,30
1651140793601,MATH 20A,A01,083754,Staff,18,0,40,22
1651140799626,MATH 20B,A01,083756,Briones; Jor-el Thomas Caparas,0,14,30,30
1651140799626,MATH 20B,A02,083757,Briones; Jor-el Thomas Caparas,0,11,30,30
1651140805652,MATH 20C,A01,083760,Briones; Jor-el Thomas Caparas,0,16,30,30
1651140805652,MATH 20C,A02,083761,Briones; Jor-el Thomas Caparas,0,17,30,30
1651140805652,MATH 20C,B01,083762,Staff,6,0,30,24
1651140805652,MATH 20C,B02,083763,Staff,28,0,30,2
1651140811675,MATH 20D,A01,083765,Tran; Brian Kha,4,1,30,26
1651140811675,MATH 20D,A02,083766,Tran; Brian Kha,0,0,30,30
1651140811675,MATH 20D,A03,083767,Tran; Brian Kha,21,0,30,9
1651140817701,MATH 20E,A01,083771,Staff,0,0,30,30
1651140817701,MATH 20E,A02,083772,Staff,9,0,30,21
1651140817701,MATH 20E,B01,083773,Staff,5,0,35,30
1651140817701,MATH 20E,B02,083774,Staff,4,0,35,31
1651140823726,MATH 103A,A01,083777,Greenfeld; Be'Eri,0,17,30,30
1651140823726,MATH 103A,A02,083778,Greenfeld; Be'Eri,0,18,30,30
1651140823726,MATH 103A,B01,083779,Greenfeld; Be'Eri,0,16,30,30
1651140823726,MATH 103A,B02,083780,Greenfeld; Be'Eri,0,15,30,30
1651140829752,MATH 105,A01,085443,Staff,0,24,30,30
1651140835777,MATH 109,A01,083213,Ganzberger; Geoffrey Michael,0,8,30,30
1651140835777,MATH 109,A02,083214,Ganzberger; Geoffrey Michael,0,7,30,30
1651140835777,MATH 109,B01,083215,Ganzberger; Geoffrey Michael,0,8,30,30
1651140835777,MATH 109,B02,083216,Ganzberger; Geoffrey Michael,0,7,30,30
1651140841804,MATH 142A,A01,083219,Chow; Bennett,0,16,30,30
1651140841804,MATH 142A,A02,083220,Chow; Bennett,0,15,30,30
1651140841804,MATH 142A,B01,083221,Chow; Bennett,0,16,30,30
1651140841804,MATH 142A,B02,083222,Chow; Bennett,0,15,30,30
1651140847830,MATH 193A,A01,083224,Staff,0,9,30,30
1651140847830,MATH 193A,A02,083225,Staff,0,7,30,30
1651140847830,MATH 193A,A03,083781,Staff,0,7,30,30
1651140847830,MATH 193A,A04,083782,Staff,0,7,30,30
1651140853855,MATH 197,001,091859,McAuley; Julian John,9998,0,9999,1
1651140859929,COGS 9,A01,083615,Staff,0,21,60,60
1651140865959,COGS 11,A01,083617,Boyle; Mary E. T.,13,0,40,27
1651140871984,COGS 13,A01,083071,Staff,0,39,40,40
1651140878013,COGS 14A,A01,092681,Staff,0,41,100,100
1651140884039,COGS 14B,A01,083073,Cheng; Tzu-Han,0,11,50,50
1651140890066,COGS 17,A01,092677,Staff,8,0,75,67
1651140896099,COGS 100,A01,083619,Staff,0,29,60,61
1651140902128,COGS 101A,A01,083621,Davis; Joshua Daniel,0,29,60,60
1651140908152,COGS 101B,A01,091572,Staff,0,8,60,60
1651140914178,COGS 101C,A01,083625,Delgado; Tania,12,0,30,18
1651140920204,COGS 107A,A01,083627,Boyle; Mary E. T.,0,17,60,60
1651140926238,COGS 118A,A01,083075,Staff,0,10,60,60
1651140932274,CSE 3,A50,083646,Miranda; Gregory Joseph,15,0,38,23
1651140932274,CSE 3,A51,083647,Miranda; Gregory Joseph,36,0,37,1
1651140938306,CSE 8A,A50,083650,Miranda; Gregory Joseph,0,30,40,40
1651140944331,CSE 11,A01,083080,Cao; Yingjun,0,98,40,40
1651140950362,CSE 12,A01,083652,Staff,0,30,100,100
1651140956386,CSE 15L,A01,083654,Staff,0,4,50,50
1651140956386,CSE 15L,A02,083655,Staff,0,3,50,50
1651140962411,CSE 20,A01,083657,Staff,47,0,80,33
1651140968438,CSE 30,A01,083084,Eldon; John,0,39,80,80
1651140974463,CSE 100,A01,083659,Cao; Yingjun,0,72,50,50
1651140980489,CSE 134B,A01,083661,Powell; Thomas Allan,0,38,65,65
1651140986513,CSE 140,A01,083663,Staff,0,17,75,75
1651140992537,CSE 140L,A01,083088,Eldon; John,1,0,100,99
1651140998569,CSE 175,A01,083665,Kumar; Rakesh,0,0,25,25
1651141004596,CSE 190,A00,092507,Dubnov; Shlomo,9,0,20,11
1651141010625,ECE 45,A01,083139,Staff,0,8,60,60
1651141016658,ECE 65,A50,083695,Staff,0,7,30,30
1651141022692,ECE 109,A01,091882,Touri; Behrouz,32,0,70,38
1651141028718,ECE 180,A00,083140,Abi Samra; Nicholas Camill,17,0,30,13
1651141028718,ECE 180,B00,083141,Abi Samra; Nicholas Camill,0,1,30,32
1651141034844,MATH 10A,A01,083735,Patchell; Gregory David,0,0,30,30
1651141034844,MATH 10A,A02,083736,Patchell; Gregory David,26,0,30,4
1651141034844,MATH 10A,A03,083737,Patchell; Gregory David,22,0,30,8
1651141040871,MATH 10B,A01,083207,Staff,0,8,30,30
1651141040871,MATH 10B,A02,083208,Staff,0,7,30,30
1651141040871,MATH 10B,B01,083739,Staff,7,0,30,23
1651141040871,MATH 10B,B02,083740,Staff,28,0,30,2
1651141046900,MATH 18,A01,083743,Staff,0,0,30,30
1651141046900,MATH 18,A02,083744,Staff,23,0,30,7
1651141046900,MATH 18,A03,083745,Staff,19,0,30,11
1651141046900,MATH 18,A04,083746,Staff,26,0,30,4
1651141046900,MATH 18,B01,083748,Staff,0,16,30,30
1651141046900,MATH 18,B02,083749,Staff,0,15,30,30
1651141046900,MATH 18,B03,083750,Staff,0,15,30,30
1651141046900,MATH 18,B04,083751,Staff,0,15,30,30
1651141052927,MATH 20A,A01,083754,Staff,18,0,40,22
1651141058953,MATH 20B,A01,083756,Briones; Jor-el Thomas Caparas,0,14,30,30
1651141058953,MATH 20B,A02,083757,Briones; Jor-el Thomas Caparas,0,11,30,30
1651141064980,MATH 20C,A01,083760,Briones; Jor-el Thomas Caparas,0,16,30,30
1651141064980,MATH 20C,A02,083761,Briones; Jor-el Thomas Caparas,0,17,30,30
1651141064980,MATH 20C,B01,083762,Staff,6,0,30,24
1651141064980,MATH 20C,B02,083763,Staff,28,0,30,2
1651141071013,MATH 20D,A01,083765,Tran; Brian Kha,4,1,30,26
1651141071013,MATH 20D,A02,083766,Tran; Brian Kha,0,0,30,30
1651141071013,MATH 20D,A03,083767,Tran; Brian Kha,21,0,30,9
1651141077042,MATH 20E,A01,083771,Staff,0,0,30,30
1651141077042,MATH 20E,A02,083772,Staff,9,0,30,21
1651141077042,MATH 20E,B01,083773,Staff,5,0,35,30
1651141077042,MATH 20E,B02,083774,Staff,4,0,35,31
1651141083072,MATH 103A,A01,083777,Greenfeld; Be'Eri,0,17,30,30
1651141083072,MATH 103A,A02,083778,Greenfeld; Be'Eri,0,18,30,30
1651141083072,MATH 103A,B01,083779,Greenfeld; Be'Eri,0,16,30,30
1651141083072,MATH 103A,B02,083780,Greenfeld; Be'Eri,0,15,30,30
1651141089101,MATH 105,A01,085443,Staff,0,24,30,30
1651141095128,MATH 109,A01,083213,Ganzberger; Geoffrey Michael,0,8,30,30
1651141095128,MATH 109,A02,083214,Ganzberger; Geoffrey Michael,0,7,30,30
1651141095128,MATH 109,B01,083215,Ganzberger; Geoffrey Michael,0,8,30,30
1651141095128,MATH 109,B02,083216,Ganzberger; Geoffrey Michael,0,7,30,30
1651141101155,MATH 142A,A01,083219,Chow; Bennett,0,16,30,30
1651141101155,MATH 142A,A02,083220,Chow; Bennett,0,15,30,30
1651141101155,MATH 142A,B01,083221,Chow; Bennett,0,16,30,30
1651141101155,MATH 142A,B02,083222,Chow; Bennett,0,15,30,30
1651141107186,MATH 193A,A01,083224,Staff,0,9,30,30
1651141107186,MATH 193A,A02,083225,Staff,0,7,30,30
1651141107186,MATH 193A,A03,083781,Staff,0,7,30,30
1651141107186,MATH 193A,A04,083782,Staff,0,7,30,30
1651141113215,MATH 197,001,091859,McAuley; Julian John,9998,0,9999,1
1651141119296,COGS 9,A01,083615,Staff,0,21,60,60
1651141125324,COGS 11,A01,083617,Boyle; Mary E. T.,13,0,40,27
1651141131351,COGS 13,A01,083071,Staff,0,39,40,40
1651141137381,COGS 14A,A01,092681,Staff,0,41,100,100
1651141143416,COGS 14B,A01,083073,Cheng; Tzu-Han,0,11,50,50
1651141149445,COGS 17,A01,092677,Staff,8,0,75,67
1651141155471,COGS 100,A01,083619,Staff,0,29,60,61
1651141161502,COGS 101A,A01,083621,Davis; Joshua Daniel,0,29,60,60
1651141167533,COGS 101B,A01,091572,Staff,0,8,60,60
1651141173565,COGS 101C,A01,083625,Delgado; Tania,12,0,30,18
1651141179593,COGS 107A,A01,083627,Boyle; Mary E. T.,0,17,60,60
1651141185621,COGS 118A,A01,083075,Staff,0,10,60,60
1651141191647,CSE 3,A50,083646,Miranda; Gregory Joseph,15,0,38,23
1651141191647,CSE 3,A51,083647,Miranda; Gregory Joseph,36,0,37,1
1651141197676,CSE 8A,A50,083650,Miranda; Gregory Joseph,0,30,40,40
1651141203700,CSE 11,A01,083080,Cao; Yingjun,0,98,40,40
1651141209725,CSE 12,A01,083652,Staff,0,30,100,100
1651141215753,CSE 15L,A01,083654,Staff,0,4,50,50
1651141215753,CSE 15L,A02,083655,Staff,0,3,50,50
1651141221781,CSE 20,A01,083657,Staff,47,0,80,33
1651141227809,CSE 30,A01,083084,Eldon; John,0,39,80,80
1651141233834,CSE 100,A01,083659,Cao; Yingjun,0,72,50,50
1651141239858,CSE 134B,A01,083661,Powell; Thomas Allan,0,38,65,65
1651141245888,CSE 140,A01,083663,Staff,0,17,75,75
1651141251914,CSE 140L,A01,083088,Eldon; John,1,0,100,99
1651141257943,CSE 175,A01,083665,Kumar; Rakesh,0,0,25,25
1651141263968,CSE 190,A00,092507,Dubnov; Shlomo,9,0,20,11
1651141269992,ECE 45,A01,083139,Staff,0,8,60,60
1651141276023,ECE 65,A50,083695,Staff,0,7,30,30
1651141282048,ECE 109,A01,091882,Touri; Behrouz,32,0,70,38
1651141288073,ECE 180,A00,083140,Abi Samra; Nicholas Camill,17,0,30,13
1651141288073,ECE 180,B00,083141,Abi Samra; Nicholas Camill,0,1,30,32
1651141294103,MATH 10A,A01,083735,Patchell; Gregory David,0,0,30,30
1651141294103,MATH 10A,A02,083736,Patchell; Gregory David,26,0,30,4
1651141294103,MATH 10A,A03,083737,Patchell; Gregory David,22,0,30,8
1651141300129,MATH 10B,A01,083207,Staff,0,8,30,30
1651141300129,MATH 10B,A02,083208,Staff,0,7,30,30
1651141300129,MATH 10B,B01,083739,Staff,7,0,30,23
1651141300129,MATH 10B,B02,083740,Staff,28,0,30,2
1651141306164,MATH 18,A01,083743,Staff,0,0,30,30
1651141306164,MATH 18,A02,083744,Staff,23,0,30,7
1651141306164,MATH 18,A03,083745,Staff,19,0,30,11
1651141306164,MATH 18,A04,083746,Staff,26,0,30,4
1651141306164,MATH 18,B01,083748,Staff,0,16,30,30
1651141306164,MATH 18,B02,083749,Staff,0,15,30,30
1651141306164,MATH 18,B03,083750,Staff,0,15,30,30
1651141306164,MATH 18,B04,083751,Staff,0,15,30,30
1651141312188,MATH 20A,A01,083754,Staff,18,0,40,22
1651141318217,MATH 20B,A01,083756,Briones; Jor-el Thomas Caparas,0,14,30,30
1651141318217,MATH 20B,A02,083757,Briones; Jor-el Thomas Caparas,0,11,30,30
1651141324248,MATH 20C,A01,083760,Briones; Jor-el Thomas Caparas,0,16,30,30
1651141324248,MATH 20C,A02,083761,Briones; Jor-el Thomas Caparas,0,17,30,30
1651141324248,MATH 20C,B01,083762,Staff,6,0,30,24
1651141324248,MATH 20C,B02,083763,Staff,28,0,30,2
1651141330273,MATH 20D,A01,083765,Tran; Brian Kha,4,1,30,26
1651141330273,MATH 20D,A02,083766,Tran; Brian Kha,0,0,30,30
1651141330273,MATH 20D,A03,083767,Tran; Brian Kha,21,0,30,9
1651141336299,MATH 20E,A01,083771,Staff,0,0,30,30
1651141336299,MATH 20E,A02,083772,Staff,9,0,30,21
1651141336299,MATH 20E,B01,083773,Staff,5,0,35,30
1651141336299,MATH 20E,B02,083774,Staff,4,0,35,31
1651141342333,MATH 103A,A01,083777,Greenfeld; Be'Eri,0,17,30,30
1651141342333,MATH 103A,A02,083778,Greenfeld; Be'Eri,0,18,30,30
1651141342333,MATH 103A,B01,083779,Greenfeld; Be'Eri,0,16,30,30
1651141342333,MATH 103A,B02,083780,Greenfeld; Be'Eri,0,15,30,30
1651141348357,MATH 105,A01,085443,Staff,0,24,30,30
1651141354384,MATH 109,A01,083213,Ganzberger; Geoffrey Michael,0,8,30,30
1651141354384,MATH 109,A02,083214,Ganzberger; Geoffrey Michael,0,7,30,30
1651141354384,MATH 109,B01,083215,Ganzberger; Geoffrey Michael,0,8,30,30
1651141354384,MATH 109,B02,083216,Ganzberger; Geoffrey Michael,0,7,30,30
1651141360414,MATH 142A,A01,083219,Chow; Bennett,0,16,30,30
1651141360414,MATH 142A,A02,083220,Chow; Bennett,0,15,30,30
1651141360414,MATH 142A,B01,083221,Chow; Bennett,0,16,30,30
1651141360414,MATH 142A,B02,083222,Chow; Bennett,0,15,30,30
1651141366445,MATH 193A,A01,083224,Staff,0,9,30,30
1651141366445,MATH 193A,A02,083225,Staff,0,7,30,30
1651141366445,MATH 193A,A03,083781,Staff,0,7,30,30
1651141366445,MATH 193A,A04,083782,Staff,0,7,30,30
1651141372470,MATH 197,001,091859,McAuley; Julian John,9998,0,9999,1
1651141378524,COGS 9,A01,083615,Staff,0,21,60,60
1651141384548,COGS 11,A01,083617,Boyle; Mary E. T.,13,0,40,27
1651141390576,COGS 13,A01,083071,Staff,0,39,40,40
1651141396598,COGS 14A,A01,092681,Staff,0,41,100,100
1651141402625,COGS 14B,A01,083073,Cheng; Tzu-Han,0,11,50,50
1651141408651,COGS 17,A01,092677,Staff,8,0,75,67
1651141414675,COGS 100,A01,083619,Staff,0,29,60,61
1651141420700,COGS 101A,A01,083621,Davis; Joshua Daniel,0,29,60,60
1651141426732,COGS 101B,A01,091572,Staff,0,8,60,60
1651141432758,COGS 101C,A01,083625,Delgado; Tania,12,0,30,18
1651141438787,COGS 107A,A01,083627,Boyle; Mary E. T.,0,17,60,60
1651141444812,COGS 118A,A01,083075,Staff,0,10,60,60
1651141450844,CSE 3,A50,083646,Miranda; Gregory Joseph,15,0,38,23
1651141450844,CSE 3,A51,083647,Miranda; Gregory Joseph,36,0,37,1
1651141456872,CSE 8A,A50,083650,Miranda; Gregory Joseph,0,30,40,40
1651141462897,CSE 11,A01,083080,Cao; Yingjun,0,98,40,40
1651141468923,CSE 12,A01,083652,Staff,0,30,100,100
1651141474950,CSE 15L,A01,083654,Staff,0,4,50,50
1651141474950,CSE 15L,A02,083655,Staff,0,3,50,50
1651141480976,CSE 20,A01,083657,Staff,47,0,80,33
1651141487004,CSE 30,A01,083084,Eldon; John,0,39,80,80
1651141493031,CSE 100,A01,083659,Cao; Yingjun,0,72,50,50
1651141499057,CSE 134B,A01,083661,Powell; Thomas Allan,0,38,65,65
1651141505085,CSE 140,A01,083663,Staff,0,17,75,75
1651141511114,CSE 140L,A01,083088,Eldon; John,1,0,100,99
1651141517138,CSE 175,A01,083665,Kumar; Rakesh,0,0,25,25
1651141523163,CSE 190,A00,092507,Dubnov; Shlomo,9,0,20,11
1651141529191,ECE 45,A01,083139,Staff,0,8,60,60
1651141535214,ECE 65,A50,083695,Staff,0,7,30,30
1651141541248,ECE 109,A01,091882,Touri; Behrouz,32,0,70,38
1651141547274,ECE 180,A00,083140,Abi Samra; Nicholas Camill,17,0,30,13
1651141547274,ECE 180,B00,083141,Abi Samra; Nicholas Camill,0,1,30,32
1651141553307,MATH 10A,A01,083735,Patchell; Gregory David,0,0,30,30
1651141553307,MATH 10A,A02,083736,Patchell; Gregory David,26,0,30,4
1651141553307,MATH 10A,A03,083737,Patchell; Gregory David,22,0,30,8
1651141559332,MATH 10B,A01,083207,Staff,0,8,30,30
1651141559332,MATH 10B,A02,083208,Staff,0,7,30,30
1651141559332,MATH 10B,B01,083739,Staff,7,0,30,23
1651141559332,MATH 10B,B02,083740,Staff,28,0,30,2
1651141565356,MATH 18,A01,083743,Staff,0,0,30,30
1651141565356,MATH 18,A02,083744,Staff,23,0,30,7
1651141565356,MATH 18,A03,083745,Staff,19,0,30,11
1651141565356,MATH 18,A04,083746,Staff,26,0,30,4
1651141565356,MATH 18,B01,083748,Staff,0,16,30,30
1651141565356,MATH 18,B02,083749,Staff,0,15,30,30
1651141565356,MATH 18,B03,083750,Staff,0,15,30,30
1651141565356,MATH 18,B04,083751,Staff,0,15,30,30
1651141571379,MATH 20A,A01,083754,Staff,18,0,40,22
1651141577407,MATH 20B,A01,083756,Briones; Jor-el Thomas Caparas,0,14,30,30
1651141577407,MATH 20B,A02,083757,Briones; Jor-el Thomas Caparas,0,11,30,30
1651141583434,MATH 20C,A01,083760,Briones; Jor-el Thomas Caparas,0,16,30,30
1651141583434,MATH 20C,A02,083761,Briones; Jor-el Thomas Caparas,0,17,30,30
1651141583434,MATH 20C,B01,083762,Staff,6,0,30,24
1651141583434,MATH 20C,B02,083763,Staff,28,0,30,2
1651141589461,MATH 20D,A01,083765,Tran; Brian Kha,4,1,30,26
1651141589461,MATH 20D,A02,083766,Tran; Brian Kha,0,0,30,30
1651141589461,MATH 20D,A03,083767,Tran; Brian Kha,21,0,30,9
1651141595485,MATH 20E,A01,083771,Staff,0,0,30,30
1651141595485,MATH 20E,A02,083772,Staff,9,0,30,21
1651141595485,MATH 20E,B01,083773,Staff,5,0,35,30
1651141595485,MATH 20E,B02,083774,Staff,4,0,35,31
1651141601509,MATH 103A,A01,083777,Greenfeld; Be'Eri,0,17,30,30
1651141601509,MATH 103A,A02,083778,Greenfeld; Be'Eri,0,18,30,30
1651141601509,MATH 103A,B01,083779,Greenfeld; Be'Eri,0,16,30,30
1651141601509,MATH 103A,B02,083780,Greenfeld; Be'Eri,0,15,30,30
1651141607530,MATH 105,A01,085443,Staff,0,24,30,30
1651141613556,MATH 109,A01,083213,Ganzberger; Geoffrey Michael,0,8,30,30
1651141613556,MATH 109,A02,083214,Ganzberger; Geoffrey Michael,0,7,30,30
1651141613556,MATH 109,B01,083215,Ganzberger; Geoffrey Michael,0,8,30,30
1651141613556,MATH 109,B02,083216,Ganzberger; Geoffrey Michael,0,7,30,30
1651141619586,MATH 142A,A01,083219,Chow; Bennett,0,16,30,30
1651141619586,MATH 142A,A02,083220,Chow; Bennett,0,15,30,30
1651141619586,MATH 142A,B01,083221,Chow; Bennett,0,16,30,30
1651141619586,MATH 142A,B02,083222,Chow; Bennett,0,15,30,30
1651141625612,MATH 193A,A01,083224,Staff,0,9,30,30
1651141625612,MATH 193A,A02,083225,Staff,0,7,30,30
1651141625612,MATH 193A,A03,083781,Staff,0,7,30,30
1651141625612,MATH 193A,A04,083782,Staff,0,7,30,30
1651141631738,MATH 197,001,091859,McAuley; Julian John,9998,0,9999,1
1651141637817,COGS 9,A01,083615,Staff,0,21,60,60
1651141643843,COGS 11,A01,083617,Boyle; Mary E. T.,13,0,40,27
1651141649867,COGS 13,A01,083071,Staff,0,39,40,40
1651141655892,COGS 14A,A01,092681,Staff,0,41,100,100
1651141661915,COGS 14B,A01,083073,Cheng; Tzu-Han,0,11,50,50
1651141667942,COGS 17,A01,092677,Staff,8,0,75,67
1651141673973,COGS 100,A01,083619,Staff,0,29,60,61
1651141680006,COGS 101A,A01,083621,Davis; Joshua Daniel,0,29,60,60
1651141686030,COGS 101B,A01,091572,Staff,0,8,60,60
1651141692053,COGS 101C,A01,083625,Delgado; Tania,12,0,30,18
1651141698077,COGS 107A,A01,083627,Boyle; Mary E. T.,0,17,60,60
1651141704101,COGS 118A,A01,083075,Staff,0,10,60,60
1651141710132,CSE 3,A50,083646,Miranda; Gregory Joseph,15,0,38,23
1651141710132,CSE 3,A51,083647,Miranda; Gregory Joseph,36,0,37,1
1651141716161,CSE 8A,A50,083650,Miranda; Gregory Joseph,0,30,40,40
1651141722195,CSE 11,A01,083080,Cao; Yingjun,0,98,40,40
1651141728225,CSE 12,A01,083652,Staff,0,30,100,100
1651141734251,CSE 15L,A01,083654,Staff,0,4,50,50
1651141734251,CSE 15L,A02,083655,Staff,0,3,50,50
1651141740275,CSE 20,A01,083657,Staff,47,0,80,33
1651141746306,CSE 30,A01,083084,Eldon; John,0,39,80,80
1651141752333,CSE 100,A01,083659,Cao; Yingjun,0,72,50,50
1651141758361,CSE 134B,A01,083661,Powell; Thomas Allan,0,38,65,65
1651141764384,CSE 140,A01,083663,Staff,0,17,75,75
1651141770409,CSE 140L,A01,083088,Eldon; John,1,0,100,99
1651141776433,CSE 175,A01,083665,Kumar; Rakesh,0,0,25,25
1651141782464,CSE 190,A00,092507,Dubnov; Shlomo,9,0,20,11
1651141788494,ECE 45,A01,083139,Staff,0,8,60,60
1651141794525,ECE 65,A50,083695,Staff,0,7,30,30
1651141800549,ECE 109,A01,091882,Touri; Behrouz,32,0,70,38
1651141806578,ECE 180,A00,083140,Abi Samra; Nicholas Camill,17,0,30,13
1651141806578,ECE 180,B00,083141,Abi Samra; Nicholas Camill,0,1,30,32
1651141812610,MATH 10A,A01,083735,Patchell; Gregory David,0,0,30,30
1651141812610,MATH 10A,A02,083736,Patchell; Gregory David,26,0,30,4
1651141812610,MATH 10A,A03,083737,Patchell; Gregory David,22,0,30,8
1651141818635,MATH 10B,A01,083207,Staff,0,8,30,30
1651141818635,MATH 10B,A02,083208,Staff,0,7,30,30
1651141818635,MATH 10B,B01,083739,Staff,7,0,30,23
1651141818635,MATH 10B,B02,083740,Staff,28,0,30,2
1651141824661,MATH 18,A01,083743,Staff,0,0,30,30
1651141824661,MATH 18,A02,083744,Staff,23,0,30,7
1651141824661,MATH 18,A03,083745,Staff,19,0,30,11
1651141824661,MATH 18,A04,083746,Staff,26,0,30,4
1651141824661,MATH 18,B01,083748,Staff,0,16,30,30
1651141824661,MATH 18,B02,083749,Staff,0,15,30,30
1651141824661,MATH 18,B03,083750,Staff,0,15,30,30
1651141824661,MATH 18,B04,083751,Staff,0,15,30,30
1651141830689,MATH 20A,A01,083754,Staff,18,0,40,22
1651141836714,MATH 20B,A01,083756,Briones; Jor-el Thomas Caparas,0,14,30,30
1651141836714,MATH 20B,A02,083757,Briones; Jor-el Thomas Caparas,0,11,30,30
1651141842743,MATH 20C,A01,083760,Briones; Jor-el Thomas Caparas,0,16,30,30
1651141842743,MATH 20C,A02,083761,Briones; Jor-el Thomas Caparas,0,17,30,30
1651141842743,MATH 20C,B01,083762,Staff,6,0,30,24
1651141842743,MATH 20C,B02,083763,Staff,28,0,30,2
1651141848773,MATH 20D,A01,083765,Tran; Brian Kha,4,1,30,26
1651141848773,MATH 20D,A02,083766,Tran; Brian Kha,0,0,30,30
1651141848773,MATH 20D,A03,083767,Tran; Brian Kha,21,0,30,9
1651141854805,MATH 20E,A01,083771,Staff,0,0,30,30
1651141854805,MATH 20E,A02,083772,Staff,9,0,30,21
1651141854805,MATH 20E,B01,083773,Staff,5,0,35,30
1651141854805,MATH 20E,B02,083774,Staff,4,0,35,31
1651141860835,MATH 103A,A01,083777,Greenfeld; Be'Eri,0,17,30,30
1651141860835,MATH 103A,A02,083778,Greenfeld; Be'Eri,0,18,30,30
1651141860835,MATH 103A,B01,083779,Greenfeld; Be'Eri,0,16,30,30
1651141860835,MATH 103A,B02,083780,Greenfeld; Be'Eri,0,15,30,30
1651141866859,MATH 105,A01,085443,Staff,0,24,30,30
1651141872886,MATH 109,A01,083213,Ganzberger; Geoffrey Michael,0,8,30,30
1651141872886,MATH 109,A02,083214,Ganzberger; Geoffrey Michael,0,7,30,30
1651141872886,MATH 109,B01,083215,Ganzberger; Geoffrey Michael,0,8,30,30
1651141872886,MATH 109,B02,083216,Ganzberger; Geoffrey Michael,0,7,30,30
1651141878911,MATH 142A,A01,083219,Chow; Bennett,0,16,30,30
1651141878911,MATH 142A,A02,083220,Chow; Bennett,0,15,30,30
1651141878911,MATH 142A,B01,083221,Chow; Bennett,0,16,30,30
1651141878911,MATH 142A,B02,083222,Chow; Bennett,0,15,30,30
1651141884936,MATH 193A,A01,083224,Staff,0,9,30,30
1651141884936,MATH 193A,A02,083225,Staff,0,7,30,30
1651141884936,MATH 193A,A03,083781,Staff,0,7,30,30
1651141884936,MATH 193A,A04,083782,Staff,0,7,30,30
1651141890960,MATH 197,001,091859,McAuley; Julian John,9998,0,9999,1
1651141897033,COGS 9,A01,083615,Staff,0,21,60,60
1651141903064,COGS 11,A01,083617,Boyle; Mary E. T.,13,0,40,27
1651141909089,COGS 13,A01,083071,Staff,0,39,40,40
1651141915116,COGS 14A,A01,092681,Staff,0,41,100,100
1651141921143,COGS 14B,A01,083073,Cheng; Tzu-Han,0,11,50,50
1651141927167,COGS 17,A01,092677,Staff,8,0,75,67
1651141933191,COGS 100,A01,083619,Staff,0,29,60,61
1651141939215,COGS 101A,A01,083621,Davis; Joshua Daniel,0,29,60,60
1651141945245,COGS 101B,A01,091572,Staff,0,8,60,60
1651141951271,COGS 101C,A01,083625,Delgado; Tania,12,0,30,18
1651141957296,COGS 107A,A01,083627,Boyle; Mary E. T.,0,17,60,60
1651141963320,COGS 118A,A01,083075,Staff,0,10,60,60
1651141969354,CSE 3,A50,083646,Miranda; Gregory Joseph,15,0,38,23
1651141969354,CSE 3,A51,083647,Miranda; Gregory Joseph,36,0,37,1
1651141975379,CSE 8A,A50,083650,Miranda; Gregory Joseph,0,30,40,40
1651141981404,CSE 11,A01,083080,Cao; Yingjun,0,98,40,40
1651141987433,CSE 12,A01,083652,Staff,0,30,100,100
1651141993462,CSE 15L,A01,083654,Staff,0,4,50,50
1651141993462,CSE 15L,A02,083655,Staff,0,3,50,50
1651141999489,CSE 20,A01,083657,Staff,47,0,80,33
1651142005516,CSE 30,A01,083084,Eldon; John,0,39,80,80
1651142011544,CSE 100,A01,083659,Cao; Yingjun,0,72,50,50
1651142017568,CSE 134B,A01,083661,Powell; Thomas Allan,0,38,65,65
1651142023593,CSE 140,A01,083663,Staff,0,17,75,75
1651142029622,CSE 140L,A01,083088,Eldon; John,1,0,100,99
1651142035647,CSE 175,A01,083665,Kumar; Rakesh,0,0,25,25
1651142041678,CSE 190,A00,092507,Dubnov; Shlomo,9,0,20,11
1651142047707,ECE 45,A01,083139,Staff,0,8,60,60
1651142053733,ECE 65,A50,083695,Staff,0,7,30,30
1651142059766,ECE 109,A01,091882,Touri; Behrouz,32,0,70,38
1651142065805,ECE 180,A00,083140,Abi Samra; Nicholas Camill,17,0,30,13
1651142065805,ECE 180,B00,083141,Abi Samra; Nicholas Camill,0,1,30,32
1651142071830,MATH 10A,A01,083735,Patchell; Gregory David,0,0,30,30
1651142071830,MATH 10A,A02,083736,Patchell; Gregory David,26,0,30,4
1651142071830,MATH 10A,A03,083737,Patchell; Gregory David,22,0,30,8
1651142077862,MATH 10B,A01,083207,Staff,0,8,30,30
1651142077862,MATH 10B,A02,083208,Staff,0,7,30,30
1651142077862,MATH 10B,B01,083739,Staff,7,0,30,23
1651142077862,MATH 10B,B02,083740,Staff,28,0,30,2
1651142083891,MATH 18,A01,083743,Staff,0,0,30,30
1651142083891,MATH 18,A02,083744,Staff,23,0,30,7
1651142083891,MATH 18,A03,083745,Staff,19,0,30,11
1651142083891,MATH 18,A04,083746,Staff,26,0,30,4
1651142083891,MATH 18,B01,083748,Staff,0,16,30,30
1651142083891,MATH 18,B02,083749,Staff,0,15,30,30
1651142083891,MATH 18,B03,083750,Staff,0,15,30,30
1651142083891,MATH 18,B04,083751,Staff,0,15,30,30
1651142089914,MATH 20A,A01,083754,Staff,18,0,40,22
1651142095946,MATH 20B,A01,083756,Briones; Jor-el Thomas Caparas,0,14,30,30
1651142095946,MATH 20B,A02,083757,Briones; Jor-el Thomas Caparas,0,11,30,30
1651142101972,MATH 20C,A01,083760,Briones; Jor-el Thomas Caparas,0,16,30,30
1651142101972,MATH 20C,A02,083761,Briones; Jor-el Thomas Caparas,0,17,30,30
1651142101972,MATH 20C,B01,083762,Staff,6,0,30,24
1651142101972,MATH 20C,B02,083763,Staff,28,0,30,2
1651142108003,MATH 20D,A01,083765,Tran; Brian Kha,4,1,30,26
1651142108003,MATH 20D,A02,083766,Tran; Brian Kha,0,0,30,30
1651142108003,MATH 20D,A03,083767,Tran; Brian Kha,21,0,30,9
1651142114035,MATH 20E,A01,083771,Staff,0,0,30,30
1651142114035,MATH 20E,A02,083772,Staff,9,0,30,21
1651142114035,MATH 20E,B01,083773,Staff,5,0,35,30
1651142114035,MATH 20E,B02,083774,Staff,4,0,35,31
1651142120062,MATH 103A,A01,083777,Greenfeld; Be'Eri,0,17,30,30
1651142120062,MATH 103A,A02,083778,Greenfeld; Be'Eri,0,18,30,30
1651142120062,MATH 103A,B01,083779,Greenfeld; Be'Eri,0,16,30,30
1651142120062,MATH 103A,B02,083780,Greenfeld; Be'Eri,0,15,30,30
1651142126086,MATH 105,A01,085443,Staff,0,24,30,30
1651142132111,MATH 109,A01,083213,Ganzberger; Geoffrey Michael,0,8,30,30
1651142132111,MATH 109,A02,083214,Ganzberger; Geoffrey Michael,0,7,30,30
1651142132111,MATH 109,B01,083215,Ganzberger; Geoffrey Michael,0,8,30,30
1651142132111,MATH 109,B02,083216,Ganzberger; Geoffrey Michael,0,7,30,30
1651142138137,MATH 142A,A01,083219,Chow; Bennett,0,16,30,30
1651142138137,MATH 142A,A02,083220,Chow; Bennett,0,15,30,30
1651142138137,MATH 142A,B01,083221,Chow; Bennett,0,16,30,30
1651142138137,MATH 142A,B02,083222,Chow; Bennett,0,15,30,30
1651142144168,MATH 193A,A01,083224,Staff,0,9,30,30
1651142144168,MATH 193A,A02,083225,Staff,0,7,30,30
1651142144168,MATH 193A,A03,083781,Staff,0,7,30,30
1651142144168,MATH 193A,A04,083782,Staff,0,7,30,30
1651142150195,MATH 197,001,091859,McAuley; Julian John,9998,0,9999,1
1651142156271,COGS 9,A01,083615,Staff,0,21,60,60
1651142162297,COGS 11,A01,083617,Boyle; Mary E. T.,13,0,40,27
1651142168322,COGS 13,A01,083071,Staff,0,39,40,40
1651142174348,COGS 14A,A01,092681,Staff,0,41,100,100
1651142180377,COGS 14B,A01,083073,Cheng; Tzu-Han,0,11,50,50
1651142186405,COGS 17,A01,092677,Staff,8,0,75,67
1651142192430,COGS 100,A01,083619,Staff,0,29,60,61
1651142198455,COGS 101A,A01,083621,Davis; Joshua Daniel,0,29,60,60
1651142204482,COGS 101B,A01,091572,Staff,0,8,60,60
1651142210508,COGS 101C,A01,083625,Delgado; Tania,12,0,30,18
1651142216537,COGS 107A,A01,083627,Boyle; Mary E. T.,0,17,60,60
1651142222665,COGS 118A,A01,083075,Staff,0,10,60,60
1651142228690,CSE 3,A50,083646,Miranda; Gregory Joseph,15,0,38,23
1651142228690,CSE 3,A51,083647,Miranda; Gregory Joseph,36,0,37,1
1651142234716,CSE 8A,A50,083650,Miranda; Gregory Joseph,0,30,40,40
1651142240742,CSE 11,A01,083080,Cao; Yingjun,0,98,40,40
1651142246766,CSE 12,A01,083652,Staff,0,30,100,100
1651142252790,CSE 15L,A01,083654,Staff,0,4,50,50
1651142252790,CSE 15L,A02,083655,Staff,0,3,50,50
1651142258814,CSE 20,A01,083657,Staff,47,0,80,33
1651142264838,CSE 30,A01,083084,Eldon; John,0,39,80,80
1651142270869,CSE 100,A01,083659,Cao; Yingjun,0,72,50,50
1651142276894,CSE 134B,A01,083661,Powell; Thomas Allan,0,38,65,65
1651142282924,CSE 140,A01,083663,Staff,0,17,75,75
1651142288964,CSE 140L,A01,083088,Eldon; John,1,0,100,99
1651142295001,CSE 175,A01,083665,Kumar; Rakesh,0,0,25,25
1651142301040,CSE 190,A00,092507,Dubnov; Shlomo,9,0,20,11
1651142307064,ECE 45,A01,083139,Staff,0,8,60,60
1651142313092,ECE 65,A50,083695,Staff,0,7,30,30
1651142319119,ECE 109,A01,091882,Touri; Behrouz,32,0,70,38
1651142325143,ECE 180,A00,083140,Abi Samra; Nicholas Camill,17,0,30,13
1651142325143,ECE 180,B00,083141,Abi Samra; Nicholas Camill,0,1,30,32
1651142331171,MATH 10A,A01,083735,Patchell; Gregory David,0,0,30,30
1651142331171,MATH 10A,A02,083736,Patchell; Gregory David,26,0,30,4
1651142331171,MATH 10A,A03,083737,Patchell; Gregory David,22,0,30,8
1651142337203,MATH 10B,A01,083207,Staff,0,8,30,30
1651142337203,MATH 10B,A02,083208,Staff,0,7,30,30
1651142337203,MATH 10B,B01,083739,Staff,7,0,30,23
1651142337203,MATH 10B,B02,083740,Staff,28,0,30,2
1651142343233,MATH 18,A01,083743,Staff,0,0,30,30
1651142343233,MATH 18,A02,083744,Staff,23,0,30,7
1651142343233,MATH 18,A03,083745,Staff,19,0,30,11
1651142343233,MATH 18,A04,083746,Staff,26,0,30,4
1651142343233,MATH 18,B01,083748,Staff,0,16,30,30
1651142343233,MATH 18,B02,083749,Staff,0,15,30,30
1651142343233,MATH 18,B03,083750,Staff,0,15,30,30
1651142343233,MATH 18,B04,083751,Staff,0,15,30,30
1651142349261,MATH 20A,A01,083754,Staff,18,0,40,22
1651142355285,MATH 20B,A01,083756,Briones; Jor-el Thomas Caparas,0,14,30,30
1651142355285,MATH 20B,A02,083757,Briones; Jor-el Thomas Caparas,0,11,30,30
1651142361311,MATH 20C,A01,083760,Briones; Jor-el Thomas Caparas,0,16,30,30
1651142361311,MATH 20C,A02,083761,Briones; Jor-el Thomas Caparas,0,17,30,30
1651142361311,MATH 20C,B01,083762,Staff,6,0,30,24
1651142361311,MATH 20C,B02,083763,Staff,28,0,30,2
1651142367336,MATH 20D,A01,083765,Tran; Brian Kha,4,1,30,26
1651142367336,MATH 20D,A02,083766,Tran; Brian Kha,0,0,30,30
1651142367336,MATH 20D,A03,083767,Tran; Brian Kha,21,0,30,9
1651142373364,MATH 20E,A01,083771,Staff,0,0,30,30
1651142373364,MATH 20E,A02,083772,Staff,9,0,30,21
1651142373364,MATH 20E,B01,083773,Staff,5,0,35,30
1651142373364,MATH 20E,B02,083774,Staff,4,0,35,31
1651142379391,MATH 103A,A01,083777,Greenfeld; Be'Eri,0,17,30,30
1651142379391,MATH 103A,A02,083778,Greenfeld; Be'Eri,0,18,30,30
1651142379391,MATH 103A,B01,083779,Greenfeld; Be'Eri,0,16,30,30
1651142379391,MATH 103A,B02,083780,Greenfeld; Be'Eri,0,15,30,30
1651142385421,MATH 105,A01,085443,Staff,0,24,30,30
1651142391452,MATH 109,A01,083213,Ganzberger; Geoffrey Michael,0,8,30,30
1651142391452,MATH 109,A02,083214,Ganzberger; Geoffrey Michael,0,7,30,30
1651142391452,MATH 109,B01,083215,Ganzberger; Geoffrey Michael,0,8,30,30
1651142391452,MATH 109,B02,083216,Ganzberger; Geoffrey Michael,0,7,30,30
1651142397478,MATH 142A,A01,083219,Chow; Bennett,0,16,30,30
1651142397478,MATH 142A,A02,083220,Chow; Bennett,0,15,30,30
1651142397478,MATH 142A,B01,083221,Chow; Bennett,0,16,30,30
1651142397478,MATH 142A,B02,083222,Chow; Bennett,0,15,30,30
1651142403505,MATH 193A,A01,083224,Staff,0,9,30,30
1651142403505,MATH 193A,A02,083225,Staff,0,7,30,30
1651142403505,MATH 193A,A03,083781,Staff,0,7,30,30
1651142403505,MATH 193A,A04,083782,Staff,0,7,30,30
1651142409528,MATH 197,001,091859,McAuley; Julian John,9998,0,9999,1
1651142415597,COGS 9,A01,083615,Staff,0,21,60,60
1651142421626,COGS 11,A01,083617,Boyle; Mary E. T.,13,0,40,27
1651142427651,COGS 13,A01,083071,Staff,0,39,40,40
1651142433677,COGS 14A,A01,092681,Staff,0,41,100,100
1651142439701,COGS 14B,A01,083073,Cheng; Tzu-Han,0,11,50,50
1651142445727,COGS 17,A01,092677,Staff,8,0,75,67
1651142451755,COGS 100,A01,083619,Staff,0,29,60,61
1651142457781,COGS 101A,A01,083621,Davis; Joshua Daniel,0,29,60,60
1651142463806,COGS 101B,A01,091572,Staff,0,8,60,60
1651142469832,COGS 101C,A01,083625,Delgado; Tania,12,0,30,18
1651142475877,COGS 107A,A01,083627,Boyle; Mary E. T.,0,17,60,60
1651142481901,COGS 118A,A01,083075,Staff,0,10,60,60
1651142487935,CSE 3,A50,083646,Miranda; Gregory Joseph,15,0,38,23
1651142487935,CSE 3,A51,083647,Miranda; Gregory Joseph,36,0,37,1
1651142493959,CSE 8A,A50,083650,Miranda; Gregory Joseph,0,30,40,40
1651142499990,CSE 11,A01,083080,Cao; Yingjun,0,98,40,40
1651142506016,CSE 12,A01,083652,Staff,0,30,100,100
1651142512040,CSE 15L,A01,083654,Staff,0,4,50,50
1651142512040,CSE 15L,A02,083655,Staff,0,3,50,50
1651142518063,CSE 20,A01,083657,Staff,47,0,80,33
1651142524089,CSE 30,A01,083084,Eldon; John,0,39,80,80
1651142530115,CSE 100,A01,083659,Cao; Yingjun,0,72,50,50
1651142536145,CSE 134B,A01,083661,Powell; Thomas Allan,0,38,65,65
1651142542173,CSE 140,A01,083663,Staff,0,17,75,75
1651142548199,CSE 140L,A01,083088,Eldon; John,1,0,100,99
1651142554235,CSE 175,A01,083665,Kumar; Rakesh,0,0,25,25
1651142560261,CSE 190,A00,092507,Dubnov; Shlomo,9,0,20,11
1651142566290,ECE 45,A01,083139,Staff,0,8,60,60
1651142572315,ECE 65,A50,083695,Staff,0,7,30,30
1651142578341,ECE 109,A01,091882,Touri; Behrouz,32,0,70,38
1651142584364,ECE 180,A00,083140,Abi Samra; Nicholas Camill,17,0,30,13
1651142584364,ECE 180,B00,083141,Abi Samra; Nicholas Camill,0,1,30,32
1651142590390,MATH 10A,A01,083735,Patchell; Gregory David,0,0,30,30
1651142590390,MATH 10A,A02,083736,Patchell; Gregory David,26,0,30,4
1651142590390,MATH 10A,A03,083737,Patchell; Gregory David,22,0,30,8
1651142596417,MATH 10B,A01,083207,Staff,0,8,30,30
1651142596417,MATH 10B,A02,083208,Staff,0,7,30,30
1651142596417,MATH 10B,B01,083739,Staff,7,0,30,23
1651142596417,MATH 10B,B02,083740,Staff,28,0,30,2
1651142602445,MATH 18,A01,083743,Staff,0,0,30,30
1651142602445,MATH 18,A02,083744,Staff,23,0,30,7
1651142602445,MATH 18,A03,083745,Staff,19,0,30,11
1651142602445,MATH 18,A04,083746,Staff,26,0,30,4
1651142602445,MATH 18,B01,083748,Staff,0,16,30,30
1651142602445,MATH 18,B02,083749,Staff,0,15,30,30
1651142602445,MATH 18,B03,083750,Staff,0,15,30,30
1651142602445,MATH 18,B04,083751,Staff,0,15,30,30
1651142608469,MATH 20A,A01,083754,Staff,18,0,40,22
1651142614496,MATH 20B,A01,083756,Briones; Jor-el Thomas Caparas,0,14,30,30
1651142614496,MATH 20B,A02,083757,Briones; Jor-el Thomas Caparas,0,11,30,30
1651142620521,MATH 20C,A01,083760,Briones; Jor-el Thomas Caparas,0,16,30,30
1651142620521,MATH 20C,A02,083761,Briones; Jor-el Thomas Caparas,0,17,30,30
1651142620521,MATH 20C,B01,083762,Staff,6,0,30,24
1651142620521,MATH 20C,B02,083763,Staff,28,0,30,2
1651142626547,MATH 20D,A01,083765,Tran; Brian Kha,4,1,30,26
1651142626547,MATH 20D,A02,083766,Tran; Brian Kha,0,0,30,30
1651142626547,MATH 20D,A03,083767,Tran; Brian Kha,21,0,30,9
1651142632572,MATH 20E,A01,083771,Staff,0,0,30,30
1651142632572,MATH 20E,A02,083772,Staff,9,0,30,21
1651142632572,MATH 20E,B01,083773,Staff,5,0,35,30
1651142632572,MATH 20E,B02,083774,Staff,4,0,35,31
1651142638605,MATH 103A,A01,083777,Greenfeld; Be'Eri,0,17,30,30
1651142638605,MATH 103A,A02,083778,Greenfeld; Be'Eri,0,18,30,30
1651142638605,MATH 103A,B01,083779,Greenfeld; Be'Eri,0,16,30,30
1651142638605,MATH 103A,B02,083780,Greenfeld; Be'Eri,0,15,30,30
1651142644631,MATH 105,A01,085443,Staff,0,24,30,30
1651142650661,MATH 109,A01,083213,Ganzberger; Geoffrey Michael,0,8,30,30
1651142650661,MATH 109,A02,083214,Ganzberger; Geoffrey Michael,0,7,30,30
1651142650661,MATH 109,B01,083215,Ganzberger; Geoffrey Michael,0,8,30,30
1651142650661,MATH 109,B02,083216,Ganzberger; Geoffrey Michael,0,7,30,30
1651142656692,MATH 142A,A01,083219,Chow; Bennett,0,16,30,30
1651142656692,MATH 142A,A02,083220,Chow; Bennett,0,15,30,30
1651142656692,MATH 142A,B01,083221,Chow; Bennett,0,16,30,30
1651142656692,MATH 142A,B02,083222,Chow; Bennett,0,15,30,30
1651142662723,MATH 193A,A01,083224,Staff,0,9,30,30
1651142662723,MATH 193A,A02,083225,Staff,0,7,30,30
1651142662723,MATH 193A,A03,083781,Staff,0,7,30,30
1651142662723,MATH 193A,A04,083782,Staff,0,7,30,30
1651142668748,MATH 197,001,091859,McAuley; Julian John,9998,0,9999,1
1651142674810,COGS 9,A01,083615,Staff,0,21,60,60
1651142680837,COGS 11,A01,083617,Boyle; Mary E. T.,13,0,40,27
1651142686862,COGS 13,A01,083071,Staff,0,39,40,40
1651142692889,COGS 14A,A01,092681,Staff,0,41,100,100
1651142698916,COGS 14B,A01,083073,Cheng; Tzu-Han,0,11,50,50
1651142704939,COGS 17,A01,092677,Staff,8,0,75,67
1651142710967,COGS 100,A01,083619,Staff,0,29,60,61
1651142716997,COGS 101A,A01,083621,Davis; Joshua Daniel,0,29,60,60
1651142723025,COGS 101B,A01,091572,Staff,0,8,60,60
1651142729051,COGS 101C,A01,083625,Delgado; Tania,12,0,30,18
1651142735075,COGS 107A,A01,083627,Boyle; Mary E. T.,0,17,60,60
1651142741101,COGS 118A,A01,083075,Staff,0,10,60,60
1651142747125,CSE 3,A50,083646,Miranda; Gregory Joseph,15,0,38,23
1651142747125,CSE 3,A51,083647,Miranda; Gregory Joseph,36,0,37,1
1651142753150,CSE 8A,A50,083650,Miranda; Gregory Joseph,0,30,40,40
1651142759180,CSE 11,A01,083080,Cao; Yingjun,0,98,40,40
1651142765205,CSE 12,A01,083652,Staff,0,30,100,100
1651142771229,CSE 15L,A01,083654,Staff,0,4,50,50
1651142771229,CSE 15L,A02,083655,Staff,0,3,50,50
1651142777253,CSE 20,A01,083657,Staff,47,0,80,33
1651142783283,CSE 30,A01,083084,Eldon; John,0,39,80,80
1651142789314,CSE 100,A01,083659,Cao; Yingjun,0,72,50,50
1651142795341,CSE 134B,A01,083661,Powell; Thomas Allan,0,38,65,65
1651142801363,CSE 140,A01,083663,Staff,0,17,75,75
1651142807386,CSE 140L,A01,083088,Eldon; John,1,0,100,99
1651142813409,CSE 175,A01,083665,Kumar; Rakesh,0,0,25,25
1651142819527,CSE 190,A00,092507,Dubnov; Shlomo,9,0,20,11
1651142825551,ECE 45,A01,083139,Staff,0,8,60,60
1651142831576,ECE 65,A50,083695,Staff,0,7,30,30
1651142837602,ECE 109,A01,091882,Touri; Behrouz,32,0,70,38
1651142843627,ECE 180,A00,083140,Abi Samra; Nicholas Camill,17,0,30,13
1651142843627,ECE 180,B00,083141,Abi Samra; Nicholas Camill,0,1,30,32
1651142849653,MATH 10A,A01,083735,Patchell; Gregory David,0,0,30,30
1651142849653,MATH 10A,A02,083736,Patchell; Gregory David,26,0,30,4
1651142849653,MATH 10A,A03,083737,Patchell; Gregory David,22,0,30,8
1651142855679,MATH 10B,A01,083207,Staff,0,8,30,30
1651142855679,MATH 10B,A02,083208,Staff,0,7,30,30
1651142855679,MATH 10B,B01,083739,Staff,7,0,30,23
1651142855679,MATH 10B,B02,083740,Staff,28,0,30,2
1651142861711,MATH 18,A01,083743,Staff,0,0,30,30
1651142861711,MATH 18,A02,083744,Staff,23,0,30,7
1651142861711,MATH 18,A03,083745,Staff,19,0,30,11
1651142861711,MATH 18,A04,083746,Staff,26,0,30,4
1651142861711,MATH 18,B01,083748,Staff,0,16,30,30
1651142861711,MATH 18,B02,083749,Staff,0,15,30,30
1651142861711,MATH 18,B03,083750,Staff,0,15,30,30
1651142861711,MATH 18,B04,083751,Staff,0,15,30,30
1651142867748,MATH 20A,A01,083754,Staff,18,0,40,22
1651142873774,MATH 20B,A01,083756,Briones; Jor-el Thomas Caparas,0,14,30,30
1651142873774,MATH 20B,A02,083757,Briones; Jor-el Thomas Caparas,0,11,30,30
1651142879799,MATH 20C,A01,083760,Briones; Jor-el Thomas Caparas,0,16,30,30
1651142879799,MATH 20C,A02,083761,Briones; Jor-el Thomas Caparas,0,17,30,30
1651142879799,MATH 20C,B01,083762,Staff,6,0,30,24
1651142879799,MATH 20C,B02,083763,Staff,28,0,30,2
1651142885824,MATH 20D,A01,083765,Tran; Brian Kha,4,1,30,26
1651142885824,MATH 20D,A02,083766,Tran; Brian Kha,0,0,30,30
1651142885824,MATH 20D,A03,083767,Tran; Brian Kha,21,0,30,9
1651142891853,MATH 20E,A01,083771,Staff,0,0,30,30
1651142891853,MATH 20E,A02,083772,Staff,9,0,30,21
1651142891853,MATH 20E,B01,083773,Staff,5,0,35,30
1651142891853,MATH 20E,B02,083774,Staff,4,0,35,31
1651142897883,MATH 103A,A01,083777,Greenfeld; Be'Eri,0,17,30,30
1651142897883,MATH 103A,A02,083778,Greenfeld; Be'Eri,0,18,30,30
1651142897883,MATH 103A,B01,083779,Greenfeld; Be'Eri,0,16,30,30
1651142897883,MATH 103A,B02,083780,Greenfeld; Be'Eri,0,15,30,30
1651142903906,MATH 105,A01,085443,Staff,0,24,30,30
1651142909944,MATH 109,A01,083213,Ganzberger; Geoffrey Michael,0,8,30,30
1651142909944,MATH 109,A02,083214,Ganzberger; Geoffrey Michael,0,7,30,30
1651142909944,MATH 109,B01,083215,Ganzberger; Geoffrey Michael,0,8,30,30
1651142909944,MATH 109,B02,083216,Ganzberger; Geoffrey Michael,0,7,30,30
1651142915974,MATH 142A,A01,083219,Chow; Bennett,0,16,30,30
1651142915974,MATH 142A,A02,083220,Chow; Bennett,0,15,30,30
1651142915974,MATH 142A,B01,083221,Chow; Bennett,0,16,30,30
1651142915974,MATH 142A,B02,083222,Chow; Bennett,0,15,30,30
1651142921999,MATH 193A,A01,083224,Staff,0,9,30,30
1651142921999,MATH 193A,A02,083225,Staff,0,7,30,30
1651142921999,MATH 193A,A03,083781,Staff,0,7,30,30
1651142921999,MATH 193A,A04,083782,Staff,0,7,30,30
1651142928024,MATH 197,001,091859,McAuley; Julian John,9998,0,9999,1
1651142934101,COGS 9,A01,083615,Staff,0,21,60,60
1651142940126,COGS 11,A01,083617,Boyle; Mary E. T.,13,0,40,27
1651142946160,COGS 13,A01,083071,Staff,0,39,40,40
1651142952184,COGS 14A,A01,092681,Staff,0,41,100,100
1651142958217,COGS 14B,A01,083073,Cheng; Tzu-Han,0,11,50,50
1651142964242,COGS 17,A01,092677,Staff,8,0,75,67
1651142970282,COGS 100,A01,083619,Staff,0,29,60,61
1651142976308,COGS 101A,A01,083621,Davis; Joshua Daniel,0,29,60,60
1651142982336,COGS 101B,A01,091572,Staff,0,8,60,60
1651142988360,COGS 101C,A01,083625,Delgado; Tania,12,0,30,18
1651142994387,COGS 107A,A01,083627,Boyle; Mary E. T.,0,17,60,60
1651143000415,COGS 118A,A01,083075,Staff,0,10,60,60
1651143006441,CSE 3,A50,083646,Miranda; Gregory Joseph,15,0,38,23
1651143006441,CSE 3,A51,083647,Miranda; Gregory Joseph,36,0,37,1
1651143012465,CSE 8A,A50,083650,Miranda; Gregory Joseph,0,30,40,40
1651143018490,CSE 11,A01,083080,Cao; Yingjun,0,98,40,40
1651143024515,CSE 12,A01,083652,Staff,0,30,100,100
1651143030538,CSE 15L,A01,083654,Staff,0,4,50,50
1651143030538,CSE 15L,A02,083655,Staff,0,3,50,50
1651143036563,CSE 20,A01,083657,Staff,47,0,80,33
1651143042588,CSE 30,A01,083084,Eldon; John,0,39,80,80
1651143048621,CSE 100,A01,083659,Cao; Yingjun,0,72,50,50
1651143054647,CSE 134B,A01,083661,Powell; Thomas Allan,0,38,65,65
1651143060675,CSE 140,A01,083663,Staff,0,17,75,75
1651143066700,CSE 140L,A01,083088,Eldon; John,1,0,100,99
1651143072750,CSE 175,A01,083665,Kumar; Rakesh,0,0,25,25
1651143078779,CSE 190,A00,092507,Dubnov; Shlomo,9,0,20,11
1651143084805,ECE 45,A01,083139,Staff,0,8,60,60
1651143090834,ECE 65,A50,083695,Staff,0,7,30,30
1651143096859,ECE 109,A01,091882,Touri; Behrouz,32,0,70,38
1651143102896,ECE 180,A00,083140,Abi Samra; Nicholas Camill,17,0,30,13
1651143102896,ECE 180,B00,083141,Abi Samra; Nicholas Camill,0,1,30,32
1651143108922,MATH 10A,A01,083735,Patchell; Gregory David,0,0,30,30
1651143108922,MATH 10A,A02,083736,Patchell; Gregory David,26,0,30,4
1651143108922,MATH 10A,A03,083737,Patchell; Gregory David,22,0,30,8
1651143114950,MATH 10B,A01,083207,Staff,0,8,30,30
1651143114950,MATH 10B,A02,083208,Staff,0,7,30,30
1651143114950,MATH 10B,B01,083739,Staff,7,0,30,23
1651143114950,MATH 10B,B02,083740,Staff,28,0,30,2
1651143120985,MATH 18,A01,083743,Staff,0,0,30,30
1651143120985,MATH 18,A02,083744,Staff,23,0,30,7
1651143120985,MATH 18,A03,083745,Staff,19,0,30,11
1651143120985,MATH 18,A04,083746,Staff,26,0,30,4
1651143120985,MATH 18,B01,083748,Staff,0,16,30,30
1651143120985,MATH 18,B02,083749,Staff,0,15,30,30
1651143120985,MATH 18,B03,083750,Staff,0,15,30,30
1651143120985,MATH 18,B04,083751,Staff,0,15,30,30
1651143127016,MATH 20A,A01,083754,Staff,18,0,40,22
1651143133041,MATH 20B,A01,083756,Briones; Jor-el Thomas Caparas,0,14,30,30
1651143133041,MATH 20B,A02,083757,Briones; Jor-el Thomas Caparas,0,11,30,30
1651143139075,MATH 20C,A01,083760,Briones; Jor-el Thomas Caparas,0,16,30,30
1651143139075,MATH 20C,A02,083761,Briones; Jor-el Thomas Caparas,0,17,30,30
1651143139075,MATH 20C,B01,083762,Staff,6,0,30,24
1651143139075,MATH 20C,B02,083763,Staff,28,0,30,2
1651143145100,MATH 20D,A01,083765,Tran; Brian Kha,4,1,30,26
1651143145100,MATH 20D,A02,083766,Tran; Brian Kha,0,0,30,30
1651143145100,MATH 20D,A03,083767,Tran; Brian Kha,21,0,30,9
1651143151125,MATH 20E,A01,083771,Staff,0,0,30,30
1651143151125,MATH 20E,A02,083772,Staff,9,0,30,21
1651143151125,MATH 20E,B01,083773,Staff,5,0,35,30
1651143151125,MATH 20E,B02,083774,Staff,4,0,35,31
1651143157151,MATH 103A,A01,083777,Greenfeld; Be'Eri,0,17,30,30
1651143157151,MATH 103A,A02,083778,Greenfeld; Be'Eri,0,18,30,30
1651143157151,MATH 103A,B01,083779,Greenfeld; Be'Eri,0,16,30,30
1651143157151,MATH 103A,B02,083780,Greenfeld; Be'Eri,0,15,30,30
1651143163180,MATH 105,A01,085443,Staff,0,24,30,30
1651143169213,MATH 109,A01,083213,Ganzberger; Geoffrey Michael,0,8,30,30
1651143169213,MATH 109,A02,083214,Ganzberger; Geoffrey Michael,0,7,30,30
1651143169213,MATH 109,B01,083215,Ganzberger; Geoffrey Michael,0,8,30,30
1651143169213,MATH 109,B02,083216,Ganzberger; Geoffrey Michael,0,7,30,30
1651143175245,MATH 142A,A01,083219,Chow; Bennett,0,16,30,30
1651143175245,MATH 142A,A02,083220,Chow; Bennett,0,15,30,30
1651143175245,MATH 142A,B01,083221,Chow; Bennett,0,16,30,30
1651143175245,MATH 142A,B02,083222,Chow; Bennett,0,15,30,30
1651143181276,MATH 193A,A01,083224,Staff,0,9,30,30
1651143181276,MATH 193A,A02,083225,Staff,0,7,30,30
1651143181276,MATH 193A,A03,083781,Staff,0,7,30,30
1651143181276,MATH 193A,A04,083782,Staff,0,7,30,30
1651143187304,MATH 197,001,091859,McAuley; Julian John,9998,0,9999,1
1651143193368,COGS 9,A01,083615,Staff,0,21,60,60
1651143199392,COGS 11,A01,083617,Boyle; Mary E. T.,13,0,40,27
1651143205416,COGS 13,A01,083071,Staff,0,39,40,40
1651143211444,COGS 14A,A01,092681,Staff,0,41,100,100
1651143217472,COGS 14B,A01,083073,Cheng; Tzu-Han,0,11,50,50
1651143223498,COGS 17,A01,092677,Staff,8,0,75,67
1651143229523,COGS 100,A01,083619,Staff,0,29,60,61
1651143235547,COGS 101A,A01,083621,Davis; Joshua Daniel,0,29,60,60
1651143241573,COGS 101B,A01,091572,Staff,0,8,60,60
1651143247604,COGS 101C,A01,083625,Delgado; Tania,12,0,30,18
1651143253629,COGS 107A,A01,083627,Boyle; Mary E. T.,0,17,60,60
1651143259653,COGS 118A,A01,083075,Staff,0,10,60,60
1651143265688,CSE 3,A50,083646,Miranda; Gregory Joseph,15,0,38,23
1651143265688,CSE 3,A51,083647,Miranda; Gregory Joseph,36,0,37,1
1651143271716,CSE 8A,A50,083650,Miranda; Gregory Joseph,0,30,40,40
1651143277744,CSE 11,A01,083080,Cao; Yingjun,0,98,40,40
1651143283769,CSE 12,A01,083652,Staff,0,30,100,100
1651143289793,CSE 15L,A01,083654,Staff,0,4,50,50
1651143289793,CSE 15L,A02,083655,Staff,0,3,50,50
1651143295826,CSE 20,A01,083657,Staff,47,0,80,33
1651143301852,CSE 30,A01,083084,Eldon; John,0,39,80,80
1651143307879,CSE 100,A01,083659,Cao; Yingjun,0,72,50,50
1651143313903,CSE 134B,A01,083661,Powell; Thomas Allan,0,38,65,65
1651143319940,CSE 140,A01,083663,Staff,0,17,75,75
1651143325971,CSE 140L,A01,083088,Eldon; John,1,0,100,99
1651143331996,CSE 175,A01,083665,Kumar; Rakesh,0,0,25,25
1651143338024,CSE 190,A00,092507,Dubnov; Shlomo,9,0,20,11
1651143344048,ECE 45,A01,083139,Staff,0,8,60,60
1651143350079,ECE 65,A50,083695,Staff,0,7,30,30
1651143356105,ECE 109,A01,091882,Touri; Behrouz,32,0,70,38
1651143362131,ECE 180,A00,083140,Abi Samra; Nicholas Camill,17,0,30,13
1651143362131,ECE 180,B00,083141,Abi Samra; Nicholas Camill,0,1,30,32
1651143368175,MATH 10A,A01,083735,Patchell; Gregory David,0,0,30,30
1651143368175,MATH 10A,A02,083736,Patchell; Gregory David,26,0,30,4
1651143368175,MATH 10A,A03,083737,Patchell; Gregory David,22,0,30,8
1651143374204,MATH 10B,A01,083207,Staff,0,8,30,30
1651143374204,MATH 10B,A02,083208,Staff,0,7,30,30
1651143374204,MATH 10B,B01,083739,Staff,7,0,30,23
1651143374204,MATH 10B,B02,083740,Staff,28,0,30,2
1651143380231,MATH 18,A01,083743,Staff,0,0,30,30
1651143380231,MATH 18,A02,083744,Staff,23,0,30,7
1651143380231,MATH 18,A03,083745,Staff,19,0,30,11
1651143380231,MATH 18,A04,083746,Staff,26,0,30,4
1651143380231,MATH 18,B01,083748,Staff,0,16,30,30
1651143380231,MATH 18,B02,083749,Staff,0,15,30,30
1651143380231,MATH 18,B03,083750,Staff,0,15,30,30
1651143380231,MATH 18,B04,083751,Staff,0,15,30,30
1651143386258,MATH 20A,A01,083754,Staff,18,0,40,22
1651143392290,MATH 20B,A01,083756,Briones; Jor-el Thomas Caparas,0,14,30,30
1651143392290,MATH 20B,A02,083757,Briones; Jor-el Thomas Caparas,0,11,30,30
1651143398324,MATH 20C,A01,083760,Briones; Jor-el Thomas Caparas,0,16,30,30
1651143398324,MATH 20C,A02,083761,Briones; Jor-el Thomas Caparas,0,17,30,30
1651143398324,MATH 20C,B01,083762,Staff,6,0,30,24
1651143398324,MATH 20C,B02,083763,Staff,28,0,30,2
1651143404350,MATH 20D,A01,083765,Tran; Brian Kha,4,1,30,26
1651143404350,MATH 20D,A02,083766,Tran; Brian Kha,0,0,30,30
1651143404350,MATH 20D,A03,083767,Tran; Brian Kha,21,0,30,9
1651143410374,MATH 20E,A01,083771,Staff,0,0,30,30
1651143410374,MATH 20E,A02,083772,Staff,9,0,30,21
1651143410374,MATH 20E,B01,083773,Staff,5,0,35,30
1651143410374,MATH 20E,B02,083774,Staff,4,0,35,31
1651143416488,MATH 103A,A01,083777,Greenfeld; Be'Eri,0,17,30,30
1651143416488,MATH 103A,A02,083778,Greenfeld; Be'Eri,0,18,30,30
1651143416488,MATH 103A,B01,083779,Greenfeld; Be'Eri,0,16,30,30
1651143416488,MATH 103A,B02,083780,Greenfeld; Be'Eri,0,15,30,30
1651143422515,MATH 105,A01,085443,Staff,0,24,30,30
1651143428550,MATH 109,A01,083213,Ganzberger; Geoffrey Michael,0,8,30,30
1651143428550,MATH 109,A02,083214,Ganzberger; Geoffrey Michael,0,7,30,30
1651143428550,MATH 109,B01,083215,Ganzberger; Geoffrey Michael,0,8,30,30
1651143428550,MATH 109,B02,083216,Ganzberger; Geoffrey Michael,0,7,30,30
1651143434574,MATH 142A,A01,083219,Chow; Bennett,0,16,30,30
1651143434574,MATH 142A,A02,083220,Chow; Bennett,0,15,30,30
1651143434574,MATH 142A,B01,083221,Chow; Bennett,0,16,30,30
1651143434574,MATH 142A,B02,083222,Chow; Bennett,0,15,30,30
1651143440597,MATH 193A,A01,083224,Staff,0,9,30,30
1651143440597,MATH 193A,A02,083225,Staff,0,7,30,30
1651143440597,MATH 193A,A03,083781,Staff,0,7,30,30
1651143440597,MATH 193A,A04,083782,Staff,0,7,30,30
1651143446621,MATH 197,001,091859,McAuley; Julian John,9998,0,9999,1
1651143452692,COGS 9,A01,083615,Staff,0,21,60,60
1651143458730,COGS 11,A01,083617,Boyle; Mary E. T.,13,0,40,27
1651143464755,COGS 13,A01,083071,Staff,0,39,40,40
1651143470779,COGS 14A,A01,092681,Staff,0,41,100,100
1651143476809,COGS 14B,A01,083073,Cheng; Tzu-Han,0,11,50,50
1651143482833,COGS 17,A01,092677,Staff,8,0,75,67
1651143488860,COGS 100,A01,083619,Staff,0,29,60,61
1651143494890,COGS 101A,A01,083621,Davis; Joshua Daniel,0,29,60,60
1651143500917,COGS 101B,A01,091572,Staff,0,8,60,60
1651143506947,COGS 101C,A01,083625,Delgado; Tania,12,0,30,18
1651143512974,COGS 107A,A01,083627,Boyle; Mary E. T.,0,17,60,60
1651143518999,COGS 118A,A01,083075,Staff,0,10,60,60
1651143525029,CSE 3,A50,083646,Miranda; Gregory Joseph,15,0,38,23
1651143525029,CSE 3,A51,083647,Miranda; Gregory Joseph,36,0,37,1
1651143531054,CSE 8A,A50,083650,Miranda; Gregory Joseph,0,30,40,40
1651143537081,CSE 11,A01,083080,Cao; Yingjun,0,98,40,40
1651143543110,CSE 12,A01,083652,Staff,0,30,100,100
1651143549136,CSE 15L,A01,083654,Staff,0,4,50,50
1651143549136,CSE 15L,A02,083655,Staff,0,3,50,50
1651143555170,CSE 20,A01,083657,Staff,47,0,80,33
1651143561200,CSE 30,A01,083084,Eldon; John,0,39,80,80
1651143567241,CSE 100,A01,083659,Cao; Yingjun,0,72,50,50
1651143573277,CSE 134B,A01,083661,Powell; Thomas Allan,0,38,65,65
1651143579303,CSE 140,A01,083663,Staff,0,17,75,75
1651143585327,CSE 140L,A01,083088,Eldon; John,1,0,100,99
1651143591351,CSE 175,A01,083665,Kumar; Rakesh,0,0,25,25
1651143597379,CSE 190,A00,092507,Dubnov; Shlomo,9,0,20,11
1651143603404,ECE 45,A01,083139,Staff,0,8,60,60
1651143609430,ECE 65,A50,083695,Staff,0,7,30,30
1651143615475,ECE 109,A01,091882,Touri; Behrouz,32,0,70,38
1651143621503,ECE 180,A00,083140,Abi Samra; Nicholas Camill,17,0,30,13
1651143621503,ECE 180,B00,083141,Abi Samra; Nicholas Camill,0,1,30,32
1651143627528,MATH 10A,A01,083735,Patchell; Gregory David,0,0,30,30
1651143627528,MATH 10A,A02,083736,Patchell; Gregory David,26,0,30,4
1651143627528,MATH 10A,A03,083737,Patchell; Gregory David,22,0,30,8
1651143633561,MATH 10B,A01,083207,Staff,0,8,30,30
1651143633561,MATH 10B,A02,083208,Staff,0,7,30,30
1651143633561,MATH 10B,B01,083739,Staff,7,0,30,23
1651143633561,MATH 10B,B02,083740,Staff,28,0,30,2
1651143639591,MATH 18,A01,083743,Staff,0,0,30,30
1651143639591,MATH 18,A02,083744,Staff,23,0,30,7
1651143639591,MATH 18,A03,083745,Staff,19,0,30,11
1651143639591,MATH 18,A04,083746,Staff,26,0,30,4
1651143639591,MATH 18,B01,083748,Staff,0,16,30,30
1651143639591,MATH 18,B02,083749,Staff,0,15,30,30
1651143639591,MATH 18,B03,083750,Staff,0,15,30,30
1651143639591,MATH 18,B04,083751,Staff,0,15,30,30
1651143645614,MATH 20A,A01,083754,Staff,18,0,40,22
1651143651654,MATH 20B,A01,083756,Briones; Jor-el Thomas Caparas,0,14,30,30
1651143651654,MATH 20B,A02,083757,Briones; Jor-el Thomas Caparas,0,11,30,30
1651143657711,MATH 20C,A01,083760,Briones; Jor-el Thomas Caparas,0,16,30,30
1651143657711,MATH 20C,A02,083761,Briones; Jor-el Thomas Caparas,0,17,30,30
1651143657711,MATH 20C,B01,083762,Staff,6,0,30,24
1651143657711,MATH 20C,B02,083763,Staff,28,0,30,2
1651143663740,MATH 20D,A01,083765,Tran; Brian Kha,4,1,30,26
1651143663740,MATH 20D,A02,083766,Tran; Brian Kha,0,0,30,30
1651143663740,MATH 20D,A03,083767,Tran; Brian Kha,21,0,30,9
1651143669770,MATH 20E,A01,083771,Staff,0,0,30,30
1651143669770,MATH 20E,A02,083772,Staff,9,0,30,21
1651143669770,MATH 20E,B01,083773,Staff,5,0,35,30
1651143669770,MATH 20E,B02,083774,Staff,4,0,35,31
1651143675814,MATH 103A,A01,083777,Greenfeld; Be'Eri,0,17,30,30
1651143675814,MATH 103A,A02,083778,Greenfeld; Be'Eri,0,18,30,30
1651143675814,MATH 103A,B01,083779,Greenfeld; Be'Eri,0,16,30,30
1651143675814,MATH 103A,B02,083780,Greenfeld; Be'Eri,0,15,30,30
1651143681841,MATH 105,A01,085443,Staff,0,24,30,30
1651143687870,MATH 109,A01,083213,Ganzberger; Geoffrey Michael,0,8,30,30
1651143687870,MATH 109,A02,083214,Ganzberger; Geoffrey Michael,0,7,30,30
1651143687870,MATH 109,B01,083215,Ganzberger; Geoffrey Michael,0,8,30,30
1651143687870,MATH 109,B02,083216,Ganzberger; Geoffrey Michael,0,7,30,30
1651143693900,MATH 142A,A01,083219,Chow; Bennett,0,16,30,30
1651143693900,MATH 142A,A02,083220,Chow; Bennett,0,15,30,30
1651143693900,MATH 142A,B01,083221,Chow; Bennett,0,16,30,30
1651143693900,MATH 142A,B02,083222,Chow; Bennett,0,15,30,30
1651143699924,MATH 193A,A01,083224,Staff,0,9,30,30
1651143699924,MATH 193A,A02,083225,Staff,0,7,30,30
1651143699924,MATH 193A,A03,083781,Staff,0,7,30,30
1651143699924,MATH 193A,A04,083782,Staff,0,7,30,30
1651143705948,MATH 197,001,091859,McAuley; Julian John,9998,0,9999,1
1651143712007,COGS 9,A01,083615,Staff,0,21,60,60
1651143718040,COGS 11,A01,083617,Boyle; Mary E. T.,13,0,40,27
1651143724068,COGS 13,A01,083071,Staff,0,39,40,40
1651143730105,COGS 14A,A01,092681,Staff,0,41,100,100
1651143736130,COGS 14B,A01,083073,Cheng; Tzu-Han,0,11,50,50
1651143742152,COGS 17,A01,092677,Staff,8,0,75,67
1651143748178,COGS 100,A01,083619,Staff,0,29,60,61
1651143754204,COGS 101A,A01,083621,Davis; Joshua Daniel,0,29,60,60
1651143760227,COGS 101B,A01,091572,Staff,0,8,60,60
1651143766254,COGS 101C,A01,083625,Delgado; Tania,12,0,30,18
1651143772282,COGS 107A,A01,083627,Boyle; Mary E. T.,0,17,60,60
1651143778305,COGS 118A,A01,083075,Staff,0,10,60,60
1651143784333,CSE 3,A50,083646,Miranda; Gregory Joseph,15,0,38,23
1651143784333,CSE 3,A51,083647,Miranda; Gregory Joseph,36,0,37,1
1651143790370,CSE 8A,A50,083650,Miranda; Gregory Joseph,0,30,40,40
1651143796400,CSE 11,A01,083080,Cao; Yingjun,0,98,40,40
1651143802428,CSE 12,A01,083652,Staff,0,30,100,100
1651143808561,CSE 15L,A01,083654,Staff,0,4,50,50
1651143808561,CSE 15L,A02,083655,Staff,0,3,50,50
1651143814599,CSE 20,A01,083657,Staff,47,0,80,33
1651143820634,CSE 30,A01,083084,Eldon; John,0,39,80,80
1651143826661,CSE 100,A01,083659,Cao; Yingjun,0,72,50,50
1651143832692,CSE 134B,A01,083661,Powell; Thomas Allan,0,38,65,65
1651143838720,CSE 140,A01,083663,Staff,0,17,75,75
1651143844751,CSE 140L,A01,083088,Eldon; John,1,0,100,99
1651143850781,CSE 175,A01,083665,Kumar; Rakesh,0,0,25,25
1651143856814,CSE 190,A00,092507,Dubnov; Shlomo,9,0,20,11
1651143862843,ECE 45,A01,083139,Staff,0,8,60,60
1651143868869,ECE 65,A50,083695,Staff,0,7,30,30
1651143874902,ECE 109,A01,091882,Touri; Behrouz,32,0,70,38
1651143880928,ECE 180,A00,083140,Abi Samra; Nicholas Camill,17,0,30,13
1651143880928,ECE 180,B00,083141,Abi Samra; Nicholas Camill,0,1,30,32
1651143886958,MATH 10A,A01,083735,Patchell; Gregory David,0,0,30,30
1651143886958,MATH 10A,A02,083736,Patchell; Gregory David,26,0,30,4
1651143886958,MATH 10A,A03,083737,Patchell; Gregory David,22,0,30,8
1651143892984,MATH 10B,A01,083207,Staff,0,8,30,30
1651143892984,MATH 10B,A02,083208,Staff,0,7,30,30
1651143892984,MATH 10B,B01,083739,Staff,7,0,30,23
1651143892984,MATH 10B,B02,083740,Staff,28,0,30,2
1651143899010,MATH 18,A01,083743,Staff,0,0,30,30
1651143899010,MATH 18,A02,083744,Staff,23,0,30,7
1651143899010,MATH 18,A03,083745,Staff,19,0,30,11
1651143899010,MATH 18,A04,083746,Staff,26,0,30,4
1651143899010,MATH 18,B01,083748,Staff,0,16,30,30
1651143899010,MATH 18,B02,083749,Staff,0,15,30,30
1651143899010,MATH 18,B03,083750,Staff,0,15,30,30
1651143899010,MATH 18,B04,083751,Staff,0,15,30,30
1651143905034,MATH 20A,A01,083754,Staff,18,0,40,22
1651143911086,MATH 20B,A01,083756,Briones; Jor-el Thomas Caparas,0,14,30,30
1651143911086,MATH 20B,A02,083757,Briones; Jor-el Thomas Caparas,0,11,30,30
1651143917118,MATH 20C,A01,083760,Briones; Jor-el Thomas Caparas,0,16,30,30
1651143917118,MATH 20C,A02,083761,Briones; Jor-el Thomas Caparas,0,17,30,30
1651143917118,MATH 20C,B01,083762,Staff,6,0,30,24
1651143917118,MATH 20C,B02,083763,Staff,28,0,30,2
1651143923143,MATH 20D,A01,083765,Tran; Brian Kha,4,1,30,26
1651143923143,MATH 20D,A02,083766,Tran; Brian Kha,0,0,30,30
1651143923143,MATH 20D,A03,083767,Tran; Brian Kha,21,0,30,9
1651143929168,MATH 20E,A01,083771,Staff,0,0,30,30
1651143929168,MATH 20E,A02,083772,Staff,9,0,30,21
1651143929168,MATH 20E,B01,083773,Staff,5,0,35,30
1651143929168,MATH 20E,B02,083774,Staff,4,0,35,31
1651143935194,MATH 103A,A01,083777,Greenfeld; Be'Eri,0,17,30,30
1651143935194,MATH 103A,A02,083778,Greenfeld; Be'Eri,0,18,30,30
1651143935194,MATH 103A,B01,083779,Greenfeld; Be'Eri,0,16,30,30
1651143935194,MATH 103A,B02,083780,Greenfeld; Be'Eri,0,15,30,30
1651143941218,MATH 105,A01,085443,Staff,0,24,30,30
1651143947248,MATH 109,A01,083213,Ganzberger; Geoffrey Michael,0,8,30,30
1651143947248,MATH 109,A02,083214,Ganzberger; Geoffrey Michael,0,7,30,30
1651143947248,MATH 109,B01,083215,Ganzberger; Geoffrey Michael,0,8,30,30
1651143947248,MATH 109,B02,083216,Ganzberger; Geoffrey Michael,0,7,30,30
1651143953273,MATH 142A,A01,083219,Chow; Bennett,0,16,30,30
1651143953273,MATH 142A,A02,083220,Chow; Bennett,0,15,30,30
1651143953273,MATH 142A,B01,083221,Chow; Bennett,0,16,30,30
1651143953273,MATH 142A,B02,083222,Chow; Bennett,0,15,30,30
1651143959297,MATH 193A,A01,083224,Staff,0,9,30,30
1651143959297,MATH 193A,A02,083225,Staff,0,7,30,30
1651143959297,MATH 193A,A03,083781,Staff,0,7,30,30
1651143959297,MATH 193A,A04,083782,Staff,0,7,30,30
1651143974434,MATH 197,001,091859,McAuley; Julian John,9998,0,9999,1
1651143980492,COGS 9,A01,083615,Staff,0,21,60,60
1651143986516,COGS 11,A01,083617,Boyle; Mary E. T.,13,0,40,27
1651143992542,COGS 13,A01,083071,Staff,0,39,40,40
1651143998568,COGS 14A,A01,092681,Staff,0,41,100,100
1651144004595,COGS 14B,A01,083073,Cheng; Tzu-Han,0,11,50,50
1651144010622,COGS 17,A01,092677,Staff,8,0,75,67
1651144016647,COGS 100,A01,083619,Staff,0,29,60,61
1651144022673,COGS 101A,A01,083621,Davis; Joshua Daniel,0,29,60,60
1651144028702,COGS 101B,A01,091572,Staff,0,8,60,60
1651144034731,COGS 101C,A01,083625,Delgado; Tania,12,0,30,18
1651144040760,COGS 107A,A01,083627,Boyle; Mary E. T.,0,17,60,60
1651144046798,COGS 118A,A01,083075,Staff,0,10,60,60
1651144052833,CSE 3,A50,083646,Miranda; Gregory Joseph,15,0,38,23
1651144052833,CSE 3,A51,083647,Miranda; Gregory Joseph,36,0,37,1
1651144058861,CSE 8A,A50,083650,Miranda; Gregory Joseph,0,30,40,40
1651144064891,CSE 11,A01,083080,Cao; Yingjun,0,98,40,40
1651144070918,CSE 12,A01,083652,Staff,0,30,100,100
1651144076955,CSE 15L,A01,083654,Staff,0,4,50,50
1651144076955,CSE 15L,A02,083655,Staff,0,3,50,50
1651144082983,CSE 20,A01,083657,Staff,47,0,80,33
1651144089009,CSE 30,A01,083084,Eldon; John,0,39,80,80
1651144095041,CSE 100,A01,083659,Cao; Yingjun,0,72,50,50
1651144101067,CSE 134B,A01,083661,Powell; Thomas Allan,0,38,65,65
1651144107104,CSE 140,A01,083663,Staff,0,17,75,75
1651144113128,CSE 140L,A01,083088,Eldon; John,1,0,100,99
1651144119154,CSE 175,A01,083665,Kumar; Rakesh,0,0,25,25
1651144125185,CSE 190,A00,092507,Dubnov; Shlomo,9,0,20,11
1651144131210,ECE 45,A01,083139,Staff,0,8,60,60
1651144137239,ECE 65,A50,083695,Staff,0,7,30,30
1651144143281,ECE 109,A01,091882,Touri; Behrouz,32,0,70,38
1651144149306,ECE 180,A00,083140,Abi Samra; Nicholas Camill,17,0,30,13
1651144149306,ECE 180,B00,083141,Abi Samra; Nicholas Camill,0,1,30,32
1651144155346,MATH 10A,A01,083735,Patchell; Gregory David,0,0,30,30
1651144155346,MATH 10A,A02,083736,Patchell; Gregory David,26,0,30,4
1651144155346,MATH 10A,A03,083737,Patchell; Gregory David,22,0,30,8
1651144161377,MATH 10B,A01,083207,Staff,0,8,30,30
1651144161377,MATH 10B,A02,083208,Staff,0,7,30,30
1651144161377,MATH 10B,B01,083739,Staff,7,0,30,23
1651144161377,MATH 10B,B02,083740,Staff,28,0,30,2
1651144167426,MATH 18,A01,083743,Staff,0,0,30,30
1651144167426,MATH 18,A02,083744,Staff,23,0,30,7
1651144167426,MATH 18,A03,083745,Staff,19,0,30,11
1651144167426,MATH 18,A04,083746,Staff,26,0,30,4
1651144167426,MATH 18,B01,083748,Staff,0,16,30,30
1651144167426,MATH 18,B02,083749,Staff,0,15,30,30
1651144167426,MATH 18,B03,083750,Staff,0,15,30,30
1651144167426,MATH 18,B04,083751,Staff,0,15,30,30
1651144173450,MATH 20A,A01,083754,Staff,18,0,40,22
1651144179483,MATH 20B,A01,083756,Briones; Jor-el Thomas Caparas,0,14,30,30
1651144179483,MATH 20B,A02,083757,Briones; Jor-el Thomas Caparas,0,11,30,30
1651144185514,MATH 20C,A01,083760,Briones; Jor-el Thomas Caparas,0,16,30,30
1651144185514,MATH 20C,A02,083761,Briones; Jor-el Thomas Caparas,0,17,30,30
1651144185514,MATH 20C,B01,083762,Staff,6,0,30,24
1651144185514,MATH 20C,B02,083763,Staff,28,0,30,2
1651144191543,MATH 20D,A01,083765,Tran; Brian Kha,4,1,30,26
1651144191543,MATH 20D,A02,083766,Tran; Brian Kha,0,0,30,30
1651144191543,MATH 20D,A03,083767,Tran; Brian Kha,21,0,30,9
1651144197568,MATH 20E,A01,083771,Staff,0,0,30,30
1651144197568,MATH 20E,A02,083772,Staff,9,0,30,21
1651144197568,MATH 20E,B01,083773,Staff,5,0,35,30
1651144197568,MATH 20E,B02,083774,Staff,4,0,35,31
1651144203597,MATH 103A,A01,083777,Greenfeld; Be'Eri,0,17,30,30
1651144203597,MATH 103A,A02,083778,Greenfeld; Be'Eri,0,18,30,30
1651144203597,MATH 103A,B01,083779,Greenfeld; Be'Eri,0,16,30,30
1651144203597,MATH 103A,B02,083780,Greenfeld; Be'Eri,0,15,30,30
1651144209622,MATH 105,A01,085443,Staff,0,24,30,30
1651144215652,MATH 109,A01,083213,Ganzberger; Geoffrey Michael,0,8,30,30
1651144215652,MATH 109,A02,083214,Ganzberger; Geoffrey Michael,0,7,30,30
1651144215652,MATH 109,B01,083215,Ganzberger; Geoffrey Michael,0,8,30,30
1651144215652,MATH 109,B02,083216,Ganzberger; Geoffrey Michael,0,7,30,30
1651144221690,MATH 142A,A01,083219,Chow; Bennett,0,16,30,30
1651144221690,MATH 142A,A02,083220,Chow; Bennett,0,15,30,30
1651144221690,MATH 142A,B01,083221,Chow; Bennett,0,16,30,30
1651144221690,MATH 142A,B02,083222,Chow; Bennett,0,15,30,30
1651144227715,MATH 193A,A01,083224,Staff,0,9,30,30
1651144227715,MATH 193A,A02,083225,Staff,0,7,30,30
1651144227715,MATH 193A,A03,083781,Staff,0,7,30,30
1651144227715,MATH 193A,A04,083782,Staff,0,7,30,30
