time,subj_course_id,sec_code,sec_id,prof,available,waitlist,total,enrolled_ct
1650367511998,COGS 9,A01,083615,Staff,0,14,60,60
1650367518034,COGS 11,A01,083617,Boyle; Mary E. T.,22,0,40,18
1650367524069,COGS 13,A01,083071,Staff,0,32,40,40
1650367530104,COGS 14A,A01,092681,Staff,0,21,100,100
1650367536142,COGS 14B,A01,083073,Cheng; Tzu-Han,0,10,50,50
1650367542176,COGS 17,A01,092677,Staff,24,0,75,51
1650367548210,COGS 100,A01,083619,Staff,0,24,60,60
1650367554249,COGS 101A,A01,083621,Davis; Joshua Daniel,0,21,60,60
1650367560288,COGS 101B,A01,091572,Staff,0,0,60,60
1650367566323,COGS 101C,A01,083625,Delgado; Tania,17,0,30,13
1650367572358,COGS 107A,A01,083627,Boyle; Mary E. T.,0,10,60,60
1650367578394,COGS 118A,A01,083075,Staff,4,0,60,56
1650367584427,CSE 3,A50,083646,Miranda; Gregory Joseph,21,0,38,17
1650367584427,CSE 3,A51,083647,Miranda; Gregory Joseph,37,0,37,0
1650367590464,CSE 8A,A50,083650,Miranda; Gregory Joseph,0,28,40,40
1650367596496,CSE 11,A01,083080,Cao; Yingjun,0,88,40,40
1650367602530,CSE 12,A01,083652,Staff,0,12,100,100
1650367608558,CSE 15L,A01,083654,Staff,0,1,50,50
1650367608558,CSE 15L,A02,083655,Staff,3,0,50,47
1650367614594,CSE 20,A01,083657,Staff,52,0,80,28
1650367620626,CSE 30,A01,083084,Eldon; John,0,76,40,40
1650367626664,CSE 100,A01,083659,Cao; Yingjun,0,66,50,50
1650367632693,CSE 134B,A01,083661,Powell; Thomas Allan,0,31,65,65
1650367638723,CSE 140,A01,083663,Staff,0,0,75,75
1650367644754,CSE 140L,A01,083088,Eldon; John,0,7,75,75
1650367650786,CSE 175,A01,083665,Kumar; Rakesh,8,0,25,17
1650367656818,CSE 190,A00,092507,Dubnov; Shlomo,14,0,20,6
1650367662851,ECE 45,A01,083139,Staff,0,17,40,40
1650367668886,ECE 65,A50,083695,Staff,0,5,30,30
1650367674917,ECE 109,A01,091882,Touri; Behrouz,40,0,70,30
1650367680951,ECE 180,A00,083140,Abi Samra; Nicholas Camill,23,0,30,7
1650367680951,ECE 180,B00,083141,Abi Samra; Nicholas Camill,5,0,30,25
1650367686993,MATH 10A,A01,083735,Patchell; Gregory David,7,0,30,23
1650367686993,MATH 10A,A02,083736,Patchell; Gregory David,28,0,30,2
1650367686993,MATH 10A,A03,083737,Patchell; Gregory David,25,0,30,5
1650367693025,MATH 10B,A01,083207,Staff,0,7,30,30
1650367693025,MATH 10B,A02,083208,Staff,0,6,30,30
1650367693025,MATH 10B,B01,083739,Staff,17,0,30,13
1650367693025,MATH 10B,B02,083740,Staff,28,0,30,2
1650367699072,MATH 18,A01,083743,Staff,3,0,30,27
1650367699072,MATH 18,A02,083744,Staff,27,0,30,3
1650367699072,MATH 18,A03,083745,Staff,22,0,30,8
1650367699072,MATH 18,A04,083746,Staff,27,0,30,3
1650367699072,MATH 18,B01,083748,Staff,0,11,30,30
1650367699072,MATH 18,B02,083749,Staff,0,11,30,30
1650367699072,MATH 18,B03,083750,Staff,0,11,30,30
1650367699072,MATH 18,B04,083751,Staff,0,9,30,30
1650367705106,MATH 20A,A01,083754,Staff,26,0,40,14
1650367711136,MATH 20B,A01,083756,Staff,0,8,30,30
1650367711136,MATH 20B,A02,083757,Staff,0,8,30,30
1650367717169,MATH 20C,A01,083760,Staff,0,14,30,30
1650367717169,MATH 20C,A02,083761,Staff,0,15,30,30
1650367717169,MATH 20C,B01,083762,Staff,13,0,30,17
1650367717169,MATH 20C,B02,083763,Staff,28,0,30,2
1650367723204,MATH 20D,A01,083765,Staff,0,1,30,30
1650367723204,MATH 20D,A02,083766,Staff,7,0,30,23
1650367723204,MATH 20D,A03,083767,Staff,26,0,30,4
1650367729248,MATH 20E,A01,083771,Staff,5,0,30,25
1650367729248,MATH 20E,A02,083772,Staff,19,0,30,11
1650367729248,MATH 20E,B01,083773,Staff,0,0,30,30
1650367729248,MATH 20E,B02,083774,Staff,12,0,30,18
1650367735279,MATH 103A,A01,083777,Staff,0,11,30,30
1650367735279,MATH 103A,A02,083778,Staff,0,12,30,30
1650367735279,MATH 103A,B01,083779,Staff,0,13,30,30
1650367735279,MATH 103A,B02,083780,Staff,0,11,30,30
1650367741312,MATH 105,A01,085443,Staff,0,21,30,30
1650367747342,MATH 109,A01,083213,Anzaldo; Leesa B,0,6,30,30
1650367747342,MATH 109,A02,083214,Anzaldo; Leesa B,0,7,30,30
1650367747342,MATH 109,B01,083215,Anzaldo; Leesa B,0,5,30,30
1650367747342,MATH 109,B02,083216,Anzaldo; Leesa B,0,5,30,30
1650367753371,MATH 142A,A01,083219,Chow; Bennett,0,14,30,30
1650367753371,MATH 142A,A02,083220,Chow; Bennett,0,12,30,30
1650367753371,MATH 142A,B01,083221,Chow; Bennett,0,12,30,30
1650367753371,MATH 142A,B02,083222,Chow; Bennett,0,12,30,30
1650367759404,MATH 193A,A01,083224,Staff,0,5,30,30
1650367759404,MATH 193A,A02,083225,Staff,0,5,30,30
1650367759404,MATH 193A,A03,083781,Staff,0,4,30,30
1650367759404,MATH 193A,A04,083782,Staff,0,3,30,30
1650367765444,MATH 197,001,091859,McAuley; Julian John,9998,0,9999,1
1650367771528,COGS 9,A01,083615,Staff,0,14,60,60
1650367777558,COGS 11,A01,083617,Boyle; Mary E. T.,22,0,40,18
1650367783585,COGS 13,A01,083071,Staff,0,32,40,40
1650367789618,COGS 14A,A01,092681,Staff,0,21,100,100
1650367795649,COGS 14B,A01,083073,Cheng; Tzu-Han,0,10,50,50
1650367801681,COGS 17,A01,092677,Staff,24,0,75,51
1650367807710,COGS 100,A01,083619,Staff,0,24,60,60
1650367813740,COGS 101A,A01,083621,Davis; Joshua Daniel,0,21,60,60
1650367819775,COGS 101B,A01,091572,Staff,0,0,60,60
1650367825810,COGS 101C,A01,083625,Delgado; Tania,17,0,30,13
1650367831839,COGS 107A,A01,083627,Boyle; Mary E. T.,0,10,60,60
1650367837873,COGS 118A,A01,083075,Staff,4,0,60,56
1650367843910,CSE 3,A50,083646,Miranda; Gregory Joseph,21,0,38,17
1650367843910,CSE 3,A51,083647,Miranda; Gregory Joseph,37,0,37,0
1650367855790,CSE 8A,A50,083650,Miranda; Gregory Joseph,0,28,40,40
1650367861824,CSE 11,A01,083080,Cao; Yingjun,0,88,40,40
1650367876546,CSE 12,A01,083652,Staff,0,12,100,100
1650367882574,CSE 15L,A01,083654,Staff,0,1,50,50
1650367882574,CSE 15L,A02,083655,Staff,3,0,50,47
1650367888604,CSE 20,A01,083657,Staff,52,0,80,28
1650367894633,CSE 30,A01,083084,Eldon; John,0,76,40,40
1650367900667,CSE 100,A01,083659,Cao; Yingjun,0,66,50,50
1650367906700,CSE 134B,A01,083661,Powell; Thomas Allan,0,31,65,65
1650367912742,CSE 140,A01,083663,Staff,0,0,75,75
1650367918771,CSE 140L,A01,083088,Eldon; John,0,7,75,75
1650367924805,CSE 175,A01,083665,Kumar; Rakesh,8,0,25,17
1650367930838,CSE 190,A00,092507,Dubnov; Shlomo,14,0,20,6
1650367936871,ECE 45,A01,083139,Staff,0,17,40,40
1650367942906,ECE 65,A50,083695,Staff,0,5,30,30
1650367948936,ECE 109,A01,091882,Touri; Behrouz,40,0,70,30
1650367954966,ECE 180,A00,083140,Abi Samra; Nicholas Camill,23,0,30,7
1650367954966,ECE 180,B00,083141,Abi Samra; Nicholas Camill,5,0,30,25
1650367961005,MATH 10A,A01,083735,Patchell; Gregory David,7,0,30,23
1650367961005,MATH 10A,A02,083736,Patchell; Gregory David,28,0,30,2
1650367961005,MATH 10A,A03,083737,Patchell; Gregory David,25,0,30,5
1650367967042,MATH 10B,A01,083207,Staff,0,7,30,30
1650367967042,MATH 10B,A02,083208,Staff,0,6,30,30
1650367967042,MATH 10B,B01,083739,Staff,17,0,30,13
1650367967042,MATH 10B,B02,083740,Staff,28,0,30,2
1650367973074,MATH 18,A01,083743,Staff,3,0,30,27
1650367973074,MATH 18,A02,083744,Staff,27,0,30,3
1650367973074,MATH 18,A03,083745,Staff,22,0,30,8
1650367973074,MATH 18,A04,083746,Staff,27,0,30,3
1650367973074,MATH 18,B01,083748,Staff,0,11,30,30
1650367973074,MATH 18,B02,083749,Staff,0,11,30,30
1650367973074,MATH 18,B03,083750,Staff,0,11,30,30
1650367973074,MATH 18,B04,083751,Staff,0,9,30,30
1650367979108,MATH 20A,A01,083754,Staff,26,0,40,14
1650367985136,MATH 20B,A01,083756,Staff,0,8,30,30
1650367985136,MATH 20B,A02,083757,Staff,0,8,30,30
1650367991167,MATH 20C,A01,083760,Staff,0,14,30,30
1650367991167,MATH 20C,A02,083761,Staff,0,15,30,30
1650367991167,MATH 20C,B01,083762,Staff,13,0,30,17
1650367991167,MATH 20C,B02,083763,Staff,28,0,30,2
1650367997200,MATH 20D,A01,083765,Staff,0,1,30,30
1650367997200,MATH 20D,A02,083766,Staff,7,0,30,23
1650367997200,MATH 20D,A03,083767,Staff,26,0,30,4
1650368003238,MATH 20E,A01,083771,Staff,5,0,30,25
1650368003238,MATH 20E,A02,083772,Staff,19,0,30,11
1650368003238,MATH 20E,B01,083773,Staff,0,0,30,30
1650368003238,MATH 20E,B02,083774,Staff,12,0,30,18
1650368009267,MATH 103A,A01,083777,Staff,0,11,30,30
1650368009267,MATH 103A,A02,083778,Staff,0,12,30,30
1650368009267,MATH 103A,B01,083779,Staff,0,13,30,30
1650368009267,MATH 103A,B02,083780,Staff,0,11,30,30
1650368015299,MATH 105,A01,085443,Staff,0,21,30,30
1650368021333,MATH 109,A01,083213,Anzaldo; Leesa B,0,6,30,30
1650368021333,MATH 109,A02,083214,Anzaldo; Leesa B,0,7,30,30
1650368021333,MATH 109,B01,083215,Anzaldo; Leesa B,0,5,30,30
1650368021333,MATH 109,B02,083216,Anzaldo; Leesa B,0,5,30,30
1650368027360,MATH 142A,A01,083219,Chow; Bennett,0,14,30,30
1650368027360,MATH 142A,A02,083220,Chow; Bennett,0,12,30,30
1650368027360,MATH 142A,B01,083221,Chow; Bennett,0,12,30,30
1650368027360,MATH 142A,B02,083222,Chow; Bennett,0,12,30,30
1650368033406,MATH 193A,A01,083224,Staff,0,5,30,30
1650368033406,MATH 193A,A02,083225,Staff,0,5,30,30
1650368033406,MATH 193A,A03,083781,Staff,0,4,30,30
1650368033406,MATH 193A,A04,083782,Staff,0,3,30,30
1650368039433,MATH 197,001,091859,McAuley; Julian John,9998,0,9999,1
1650368045507,COGS 9,A01,083615,Staff,0,14,60,60
1650368051537,COGS 11,A01,083617,Boyle; Mary E. T.,22,0,40,18
1650368057569,COGS 13,A01,083071,Staff,0,32,40,40
1650368063599,COGS 14A,A01,092681,Staff,0,21,100,100
1650368069632,COGS 14B,A01,083073,Cheng; Tzu-Han,0,10,50,50
1650368075661,COGS 17,A01,092677,Staff,24,0,75,51
1650368081706,COGS 100,A01,083619,Staff,0,24,60,60
1650368087740,COGS 101A,A01,083621,Davis; Joshua Daniel,0,21,60,60
1650368093775,COGS 101B,A01,091572,Staff,0,0,60,60
1650368099898,COGS 101C,A01,083625,Delgado; Tania,17,0,30,13
1650368105927,COGS 107A,A01,083627,Boyle; Mary E. T.,0,10,60,60
1650368111959,COGS 118A,A01,083075,Staff,4,0,60,56
1650368118001,CSE 3,A50,083646,Miranda; Gregory Joseph,21,0,38,17
1650368118001,CSE 3,A51,083647,Miranda; Gregory Joseph,37,0,37,0
1650368124031,CSE 8A,A50,083650,Miranda; Gregory Joseph,0,28,40,40
1650368130063,CSE 11,A01,083080,Cao; Yingjun,0,88,40,40
1650368136092,CSE 12,A01,083652,Staff,0,12,100,100
1650368142119,CSE 15L,A01,083654,Staff,0,1,50,50
1650368142119,CSE 15L,A02,083655,Staff,3,0,50,47
1650368148150,CSE 20,A01,083657,Staff,52,0,80,28
1650368154179,CSE 30,A01,083084,Eldon; John,0,76,40,40
1650368160207,CSE 100,A01,083659,Cao; Yingjun,0,66,50,50
1650368166240,CSE 134B,A01,083661,Powell; Thomas Allan,0,31,65,65
1650368172270,CSE 140,A01,083663,Staff,0,0,75,75
1650368178297,CSE 140L,A01,083088,Eldon; John,0,7,75,75
1650368184327,CSE 175,A01,083665,Kumar; Rakesh,8,0,25,17
1650368190358,CSE 190,A00,092507,Dubnov; Shlomo,14,0,20,6
1650368196387,ECE 45,A01,083139,Staff,0,17,40,40
1650368202417,ECE 65,A50,083695,Staff,0,5,30,30
1650368208452,ECE 109,A01,091882,Touri; Behrouz,40,0,70,30
1650368214480,ECE 180,A00,083140,Abi Samra; Nicholas Camill,23,0,30,7
1650368214480,ECE 180,B00,083141,Abi Samra; Nicholas Camill,5,0,30,25
1650368220515,MATH 10A,A01,083735,Patchell; Gregory David,7,0,30,23
1650368220515,MATH 10A,A02,083736,Patchell; Gregory David,28,0,30,2
1650368220515,MATH 10A,A03,083737,Patchell; Gregory David,25,0,30,5
1650368226567,MATH 10B,A01,083207,Staff,0,7,30,30
1650368226567,MATH 10B,A02,083208,Staff,0,6,30,30
1650368226567,MATH 10B,B01,083739,Staff,17,0,30,13
1650368226567,MATH 10B,B02,083740,Staff,28,0,30,2
1650368232606,MATH 18,A01,083743,Staff,3,0,30,27
1650368232606,MATH 18,A02,083744,Staff,27,0,30,3
1650368232606,MATH 18,A03,083745,Staff,22,0,30,8
1650368232606,MATH 18,A04,083746,Staff,27,0,30,3
1650368232606,MATH 18,B01,083748,Staff,0,11,30,30
1650368232606,MATH 18,B02,083749,Staff,0,11,30,30
1650368232606,MATH 18,B03,083750,Staff,0,11,30,30
1650368232606,MATH 18,B04,083751,Staff,0,9,30,30
1650368238633,MATH 20A,A01,083754,Staff,26,0,40,14
1650368244667,MATH 20B,A01,083756,Staff,0,8,30,30
1650368244667,MATH 20B,A02,083757,Staff,0,8,30,30
1650368250695,MATH 20C,A01,083760,Staff,0,14,30,30
1650368250695,MATH 20C,A02,083761,Staff,0,15,30,30
1650368250695,MATH 20C,B01,083762,Staff,13,0,30,17
1650368250695,MATH 20C,B02,083763,Staff,28,0,30,2
1650368256722,MATH 20D,A01,083765,Staff,0,1,30,30
1650368256722,MATH 20D,A02,083766,Staff,7,0,30,23
1650368256722,MATH 20D,A03,083767,Staff,26,0,30,4
1650368262749,MATH 20E,A01,083771,Staff,5,0,30,25
1650368262749,MATH 20E,A02,083772,Staff,19,0,30,11
1650368262749,MATH 20E,B01,083773,Staff,0,0,30,30
1650368262749,MATH 20E,B02,083774,Staff,12,0,30,18
1650368268775,MATH 103A,A01,083777,Staff,0,11,30,30
1650368268775,MATH 103A,A02,083778,Staff,0,12,30,30
1650368268775,MATH 103A,B01,083779,Staff,0,13,30,30
1650368268775,MATH 103A,B02,083780,Staff,0,11,30,30
1650368274804,MATH 105,A01,085443,Staff,0,21,30,30
1650368280851,MATH 109,A01,083213,Anzaldo; Leesa B,0,6,30,30
1650368280851,MATH 109,A02,083214,Anzaldo; Leesa B,0,7,30,30
1650368280851,MATH 109,B01,083215,Anzaldo; Leesa B,0,5,30,30
1650368280851,MATH 109,B02,083216,Anzaldo; Leesa B,0,5,30,30
1650368286882,MATH 142A,A01,083219,Chow; Bennett,0,14,30,30
1650368286882,MATH 142A,A02,083220,Chow; Bennett,0,12,30,30
1650368286882,MATH 142A,B01,083221,Chow; Bennett,0,12,30,30
1650368286882,MATH 142A,B02,083222,Chow; Bennett,0,12,30,30
1650368292915,MATH 193A,A01,083224,Staff,0,5,30,30
1650368292915,MATH 193A,A02,083225,Staff,0,5,30,30
1650368292915,MATH 193A,A03,083781,Staff,0,4,30,30
1650368292915,MATH 193A,A04,083782,Staff,0,3,30,30
1650368298947,MATH 197,001,091859,McAuley; Julian John,9998,0,9999,1
1650368305014,COGS 9,A01,083615,Staff,0,14,60,60
1650368311045,COGS 11,A01,083617,Boyle; Mary E. T.,22,0,40,18
1650368317074,COGS 13,A01,083071,Staff,0,32,40,40
1650368323114,COGS 14A,A01,092681,Staff,0,21,100,100
1650368329143,COGS 14B,A01,083073,Cheng; Tzu-Han,0,10,50,50
1650368335167,COGS 17,A01,092677,Staff,24,0,75,51
1650368341196,COGS 100,A01,083619,Staff,0,24,60,60
1650368347226,COGS 101A,A01,083621,Davis; Joshua Daniel,0,21,60,60
1650368353258,COGS 101B,A01,091572,Staff,0,0,60,60
1650368359286,COGS 101C,A01,083625,Delgado; Tania,17,0,30,13
1650368365317,COGS 107A,A01,083627,Boyle; Mary E. T.,0,10,60,60
1650368371342,COGS 118A,A01,083075,Staff,4,0,60,56
1650368377374,CSE 3,A50,083646,Miranda; Gregory Joseph,21,0,38,17
1650368377374,CSE 3,A51,083647,Miranda; Gregory Joseph,37,0,37,0
1650368383400,CSE 8A,A50,083650,Miranda; Gregory Joseph,0,28,40,40
1650368389444,CSE 11,A01,083080,Cao; Yingjun,0,88,40,40
1650368395476,CSE 12,A01,083652,Staff,0,12,100,100
1650368401507,CSE 15L,A01,083654,Staff,0,1,50,50
1650368401507,CSE 15L,A02,083655,Staff,3,0,50,47
1650368407534,CSE 20,A01,083657,Staff,52,0,80,28
1650368413563,CSE 30,A01,083084,Eldon; John,0,76,40,40
1650368419596,CSE 100,A01,083659,Cao; Yingjun,0,66,50,50
1650368425630,CSE 134B,A01,083661,Powell; Thomas Allan,0,31,65,65
1650368431662,CSE 140,A01,083663,Staff,0,0,75,75
1650368437695,CSE 140L,A01,083088,Eldon; John,0,7,75,75
1650368443726,CSE 175,A01,083665,Kumar; Rakesh,8,0,25,17
1650368449757,CSE 190,A00,092507,Dubnov; Shlomo,14,0,20,6
1650368455786,ECE 45,A01,083139,Staff,0,17,40,40
1650368461818,ECE 65,A50,083695,Staff,0,5,30,30
1650368467848,ECE 109,A01,091882,Touri; Behrouz,40,0,70,30
1650368473884,ECE 180,A00,083140,Abi Samra; Nicholas Camill,23,0,30,7
1650368473884,ECE 180,B00,083141,Abi Samra; Nicholas Camill,5,0,30,25
1650368479919,MATH 10A,A01,083735,Patchell; Gregory David,7,0,30,23
1650368479919,MATH 10A,A02,083736,Patchell; Gregory David,28,0,30,2
1650368479919,MATH 10A,A03,083737,Patchell; Gregory David,25,0,30,5
1650368485949,MATH 10B,A01,083207,Staff,0,7,30,30
1650368485949,MATH 10B,A02,083208,Staff,0,6,30,30
1650368485949,MATH 10B,B01,083739,Staff,17,0,30,13
1650368485949,MATH 10B,B02,083740,Staff,28,0,30,2
1650368491989,MATH 18,A01,083743,Staff,3,0,30,27
1650368491989,MATH 18,A02,083744,Staff,27,0,30,3
1650368491989,MATH 18,A03,083745,Staff,22,0,30,8
1650368491989,MATH 18,A04,083746,Staff,27,0,30,3
1650368491989,MATH 18,B01,083748,Staff,0,11,30,30
1650368491989,MATH 18,B02,083749,Staff,0,11,30,30
1650368491989,MATH 18,B03,083750,Staff,0,11,30,30
1650368491989,MATH 18,B04,083751,Staff,0,9,30,30
1650368498018,MATH 20A,A01,083754,Staff,26,0,40,14
1650368504061,MATH 20B,A01,083756,Staff,0,8,30,30
1650368504061,MATH 20B,A02,083757,Staff,0,8,30,30
1650368510089,MATH 20C,A01,083760,Staff,0,14,30,30
1650368510089,MATH 20C,A02,083761,Staff,0,15,30,30
1650368510089,MATH 20C,B01,083762,Staff,13,0,30,17
1650368510089,MATH 20C,B02,083763,Staff,28,0,30,2
1650368516117,MATH 20D,A01,083765,Staff,0,1,30,30
1650368516117,MATH 20D,A02,083766,Staff,7,0,30,23
1650368516117,MATH 20D,A03,083767,Staff,26,0,30,4
1650368522147,MATH 20E,A01,083771,Staff,5,0,30,25
1650368522147,MATH 20E,A02,083772,Staff,19,0,30,11
1650368522147,MATH 20E,B01,083773,Staff,0,0,30,30
1650368522147,MATH 20E,B02,083774,Staff,12,0,30,18
1650368528176,MATH 103A,A01,083777,Staff,0,11,30,30
1650368528176,MATH 103A,A02,083778,Staff,0,12,30,30
1650368528176,MATH 103A,B01,083779,Staff,0,13,30,30
1650368528176,MATH 103A,B02,083780,Staff,0,11,30,30
1650368534208,MATH 105,A01,085443,Staff,0,21,30,30
1650368540242,MATH 109,A01,083213,Anzaldo; Leesa B,0,6,30,30
1650368540242,MATH 109,A02,083214,Anzaldo; Leesa B,0,7,30,30
1650368540242,MATH 109,B01,083215,Anzaldo; Leesa B,0,5,30,30
1650368540242,MATH 109,B02,083216,Anzaldo; Leesa B,0,5,30,30
1650368546274,MATH 142A,A01,083219,Chow; Bennett,0,14,30,30
1650368546274,MATH 142A,A02,083220,Chow; Bennett,0,12,30,30
1650368546274,MATH 142A,B01,083221,Chow; Bennett,0,12,30,30
1650368546274,MATH 142A,B02,083222,Chow; Bennett,0,12,30,30
1650368552306,MATH 193A,A01,083224,Staff,0,5,30,30
1650368552306,MATH 193A,A02,083225,Staff,0,5,30,30
1650368552306,MATH 193A,A03,083781,Staff,0,4,30,30
1650368552306,MATH 193A,A04,083782,Staff,0,3,30,30
1650368558334,MATH 197,001,091859,McAuley; Julian John,9998,0,9999,1
1650368564406,COGS 9,A01,083615,Staff,0,14,60,60
1650368570435,COGS 11,A01,083617,Boyle; Mary E. T.,22,0,40,18
1650368576465,COGS 13,A01,083071,Staff,0,32,40,40
1650368582500,COGS 14A,A01,092681,Staff,0,21,100,100
1650368588533,COGS 14B,A01,083073,Cheng; Tzu-Han,0,10,50,50
1650368594559,COGS 17,A01,092677,Staff,24,0,75,51
1650368600587,COGS 100,A01,083619,Staff,0,24,60,60
1650368606621,COGS 101A,A01,083621,Davis; Joshua Daniel,0,21,60,60
1650368612647,COGS 101B,A01,091572,Staff,0,0,60,60
1650368618684,COGS 101C,A01,083625,Delgado; Tania,17,0,30,13
1650368624714,COGS 107A,A01,083627,Boyle; Mary E. T.,0,10,60,60
1650368630745,COGS 118A,A01,083075,Staff,4,0,60,56
1650368636776,CSE 3,A50,083646,Miranda; Gregory Joseph,21,0,38,17
1650368636776,CSE 3,A51,083647,Miranda; Gregory Joseph,37,0,37,0
1650368642806,CSE 8A,A50,083650,Miranda; Gregory Joseph,0,28,40,40
1650368648842,CSE 11,A01,083080,Cao; Yingjun,0,88,40,40
1650368654875,CSE 12,A01,083652,Staff,0,12,100,100
1650368660907,CSE 15L,A01,083654,Staff,0,1,50,50
1650368660907,CSE 15L,A02,083655,Staff,3,0,50,47
1650368666935,CSE 20,A01,083657,Staff,52,0,80,28
1650368672969,CSE 30,A01,083084,Eldon; John,0,76,40,40
1650368679003,CSE 100,A01,083659,Cao; Yingjun,0,66,50,50
1650368685034,CSE 134B,A01,083661,Powell; Thomas Allan,0,31,65,65
1650368691063,CSE 140,A01,083663,Staff,0,0,75,75
1650368697186,CSE 140L,A01,083088,Eldon; John,0,7,75,75
1650368703215,CSE 175,A01,083665,Kumar; Rakesh,8,0,25,17
1650368709242,CSE 190,A00,092507,Dubnov; Shlomo,14,0,20,6
1650368715268,ECE 45,A01,083139,Staff,0,17,40,40
1650368721301,ECE 65,A50,083695,Staff,0,5,30,30
1650368727328,ECE 109,A01,091882,Touri; Behrouz,40,0,70,30
1650368733371,ECE 180,A00,083140,Abi Samra; Nicholas Camill,23,0,30,7
1650368733371,ECE 180,B00,083141,Abi Samra; Nicholas Camill,5,0,30,25
1650368739399,MATH 10A,A01,083735,Patchell; Gregory David,7,0,30,23
1650368739399,MATH 10A,A02,083736,Patchell; Gregory David,28,0,30,2
1650368739399,MATH 10A,A03,083737,Patchell; Gregory David,25,0,30,5
1650368745433,MATH 10B,A01,083207,Staff,0,7,30,30
1650368745433,MATH 10B,A02,083208,Staff,0,6,30,30
1650368745433,MATH 10B,B01,083739,Staff,17,0,30,13
1650368745433,MATH 10B,B02,083740,Staff,28,0,30,2
1650368751460,MATH 18,A01,083743,Staff,3,0,30,27
1650368751460,MATH 18,A02,083744,Staff,27,0,30,3
1650368751460,MATH 18,A03,083745,Staff,22,0,30,8
1650368751460,MATH 18,A04,083746,Staff,27,0,30,3
1650368751460,MATH 18,B01,083748,Staff,0,11,30,30
1650368751460,MATH 18,B02,083749,Staff,0,11,30,30
1650368751460,MATH 18,B03,083750,Staff,0,11,30,30
1650368751460,MATH 18,B04,083751,Staff,0,9,30,30
1650368757486,MATH 20A,A01,083754,Staff,26,0,40,14
1650368763517,MATH 20B,A01,083756,Staff,0,8,30,30
1650368763517,MATH 20B,A02,083757,Staff,0,8,30,30
1650368769546,MATH 20C,A01,083760,Staff,0,14,30,30
1650368769546,MATH 20C,A02,083761,Staff,0,15,30,30
1650368769546,MATH 20C,B01,083762,Staff,13,0,30,17
1650368769546,MATH 20C,B02,083763,Staff,28,0,30,2
1650368775576,MATH 20D,A01,083765,Staff,0,1,30,30
1650368775576,MATH 20D,A02,083766,Staff,7,0,30,23
1650368775576,MATH 20D,A03,083767,Staff,26,0,30,4
1650368781608,MATH 20E,A01,083771,Staff,5,0,30,25
1650368781608,MATH 20E,A02,083772,Staff,19,0,30,11
1650368781608,MATH 20E,B01,083773,Staff,0,0,30,30
1650368781608,MATH 20E,B02,083774,Staff,12,0,30,18
1650368787638,MATH 103A,A01,083777,Staff,0,11,30,30
1650368787638,MATH 103A,A02,083778,Staff,0,12,30,30
1650368787638,MATH 103A,B01,083779,Staff,0,13,30,30
1650368787638,MATH 103A,B02,083780,Staff,0,11,30,30
1650368793669,MATH 105,A01,085443,Staff,0,21,30,30
1650368799703,MATH 109,A01,083213,Anzaldo; Leesa B,0,6,30,30
1650368799703,MATH 109,A02,083214,Anzaldo; Leesa B,0,7,30,30
1650368799703,MATH 109,B01,083215,Anzaldo; Leesa B,0,5,30,30
1650368799703,MATH 109,B02,083216,Anzaldo; Leesa B,0,5,30,30
1650368805736,MATH 142A,A01,083219,Chow; Bennett,0,14,30,30
1650368805736,MATH 142A,A02,083220,Chow; Bennett,0,12,30,30
1650368805736,MATH 142A,B01,083221,Chow; Bennett,0,12,30,30
1650368805736,MATH 142A,B02,083222,Chow; Bennett,0,12,30,30
1650368811764,MATH 193A,A01,083224,Staff,0,5,30,30
1650368811764,MATH 193A,A02,083225,Staff,0,5,30,30
1650368811764,MATH 193A,A03,083781,Staff,0,4,30,30
1650368811764,MATH 193A,A04,083782,Staff,0,3,30,30
1650368817789,MATH 197,001,091859,McAuley; Julian John,9998,0,9999,1
1650368823900,COGS 9,A01,083615,Staff,0,14,60,60
1650368829932,COGS 11,A01,083617,Boyle; Mary E. T.,22,0,40,18
1650368835961,COGS 13,A01,083071,Staff,0,32,40,40
1650368841992,COGS 14A,A01,092681,Staff,0,21,100,100
1650368848024,COGS 14B,A01,083073,Cheng; Tzu-Han,0,10,50,50
1650368854052,COGS 17,A01,092677,Staff,24,0,75,51
1650368860080,COGS 100,A01,083619,Staff,0,24,60,60
1650368866114,COGS 101A,A01,083621,Davis; Joshua Daniel,0,21,60,60
1650368872143,COGS 101B,A01,091572,Staff,0,0,60,60
1650368878176,COGS 101C,A01,083625,Delgado; Tania,17,0,30,13
1650368884203,COGS 107A,A01,083627,Boyle; Mary E. T.,0,10,60,60
1650368890233,COGS 118A,A01,083075,Staff,4,0,60,56
1650368896269,CSE 3,A50,083646,Miranda; Gregory Joseph,21,0,38,17
1650368896269,CSE 3,A51,083647,Miranda; Gregory Joseph,37,0,37,0
1650368902300,CSE 8A,A50,083650,Miranda; Gregory Joseph,0,28,40,40
1650368908326,CSE 11,A01,083080,Cao; Yingjun,0,88,40,40
1650368914351,CSE 12,A01,083652,Staff,0,12,100,100
1650368920376,CSE 15L,A01,083654,Staff,0,1,50,50
1650368920376,CSE 15L,A02,083655,Staff,3,0,50,47
1650368926409,CSE 20,A01,083657,Staff,52,0,80,28
1650368932754,CSE 30,A01,083084,Eldon; John,0,76,40,40
1650368938783,CSE 100,A01,083659,Cao; Yingjun,0,66,50,50
1650368944812,CSE 134B,A01,083661,Powell; Thomas Allan,0,31,65,65
1650368950840,CSE 140,A01,083663,Staff,0,0,75,75
1650368956873,CSE 140L,A01,083088,Eldon; John,0,7,75,75
1650368962902,CSE 175,A01,083665,Kumar; Rakesh,8,0,25,17
1650368968931,CSE 190,A00,092507,Dubnov; Shlomo,14,0,20,6
1650368974958,ECE 45,A01,083139,Staff,0,17,40,40
1650368980984,ECE 65,A50,083695,Staff,0,5,30,30
1650368987012,ECE 109,A01,091882,Touri; Behrouz,40,0,70,30
1650368993044,ECE 180,A00,083140,Abi Samra; Nicholas Camill,23,0,30,7
1650368993044,ECE 180,B00,083141,Abi Samra; Nicholas Camill,5,0,30,25
1650368999078,MATH 10A,A01,083735,Patchell; Gregory David,7,0,30,23
1650368999078,MATH 10A,A02,083736,Patchell; Gregory David,28,0,30,2
1650368999078,MATH 10A,A03,083737,Patchell; Gregory David,25,0,30,5
1650369005111,MATH 10B,A01,083207,Staff,0,7,30,30
1650369005111,MATH 10B,A02,083208,Staff,0,6,30,30
1650369005111,MATH 10B,B01,083739,Staff,17,0,30,13
1650369005111,MATH 10B,B02,083740,Staff,28,0,30,2
1650369011143,MATH 18,A01,083743,Staff,3,0,30,27
1650369011143,MATH 18,A02,083744,Staff,27,0,30,3
1650369011143,MATH 18,A03,083745,Staff,22,0,30,8
1650369011143,MATH 18,A04,083746,Staff,27,0,30,3
1650369011143,MATH 18,B01,083748,Staff,0,11,30,30
1650369011143,MATH 18,B02,083749,Staff,0,11,30,30
1650369011143,MATH 18,B03,083750,Staff,0,11,30,30
1650369011143,MATH 18,B04,083751,Staff,0,9,30,30
1650369017170,MATH 20A,A01,083754,Staff,26,0,40,14
1650369023196,MATH 20B,A01,083756,Staff,0,8,30,30
1650369023196,MATH 20B,A02,083757,Staff,0,8,30,30
1650369029225,MATH 20C,A01,083760,Staff,0,14,30,30
1650369029225,MATH 20C,A02,083761,Staff,0,15,30,30
1650369029225,MATH 20C,B01,083762,Staff,13,0,30,17
1650369029225,MATH 20C,B02,083763,Staff,28,0,30,2
1650369035255,MATH 20D,A01,083765,Staff,0,1,30,30
1650369035255,MATH 20D,A02,083766,Staff,7,0,30,23
1650369035255,MATH 20D,A03,083767,Staff,26,0,30,4
1650369041280,MATH 20E,A01,083771,Staff,5,0,30,25
1650369041280,MATH 20E,A02,083772,Staff,19,0,30,11
1650369041280,MATH 20E,B01,083773,Staff,0,0,30,30
1650369041280,MATH 20E,B02,083774,Staff,12,0,30,18
1650369047310,MATH 103A,A01,083777,Staff,0,11,30,30
1650369047310,MATH 103A,A02,083778,Staff,0,12,30,30
1650369047310,MATH 103A,B01,083779,Staff,0,13,30,30
1650369047310,MATH 103A,B02,083780,Staff,0,11,30,30
1650369053894,MATH 105,A01,085443,Staff,0,21,30,30
1650369059923,MATH 109,A01,083213,Anzaldo; Leesa B,0,6,30,30
1650369059923,MATH 109,A02,083214,Anzaldo; Leesa B,0,7,30,30
1650369059923,MATH 109,B01,083215,Anzaldo; Leesa B,0,5,30,30
1650369059923,MATH 109,B02,083216,Anzaldo; Leesa B,0,5,30,30
1650369065948,MATH 142A,A01,083219,Chow; Bennett,0,14,30,30
1650369065948,MATH 142A,A02,083220,Chow; Bennett,0,12,30,30
1650369065948,MATH 142A,B01,083221,Chow; Bennett,0,12,30,30
1650369065948,MATH 142A,B02,083222,Chow; Bennett,0,12,30,30
1650369071981,MATH 193A,A01,083224,Staff,0,5,30,30
1650369071981,MATH 193A,A02,083225,Staff,0,5,30,30
1650369071981,MATH 193A,A03,083781,Staff,0,4,30,30
1650369071981,MATH 193A,A04,083782,Staff,0,3,30,30
1650369078008,MATH 197,001,091859,McAuley; Julian John,9998,0,9999,1
1650369084084,COGS 9,A01,083615,Staff,0,14,60,60
1650369090113,COGS 11,A01,083617,Boyle; Mary E. T.,22,0,40,18
1650369096142,COGS 13,A01,083071,Staff,0,32,40,40
1650369102168,COGS 14A,A01,092681,Staff,0,21,100,100
1650369108197,COGS 14B,A01,083073,Cheng; Tzu-Han,0,10,50,50
1650369114225,COGS 17,A01,092677,Staff,24,0,75,51
1650369120259,COGS 100,A01,083619,Staff,0,24,60,60
1650369126287,COGS 101A,A01,083621,Davis; Joshua Daniel,0,21,60,60
1650369132316,COGS 101B,A01,091572,Staff,0,0,60,60
1650369138343,COGS 101C,A01,083625,Delgado; Tania,17,0,30,13
1650369144382,COGS 107A,A01,083627,Boyle; Mary E. T.,0,10,60,60
1650369150413,COGS 118A,A01,083075,Staff,4,0,60,56
1650369156450,CSE 3,A50,083646,Miranda; Gregory Joseph,21,0,38,17
1650369156450,CSE 3,A51,083647,Miranda; Gregory Joseph,37,0,37,0
1650369162474,CSE 8A,A50,083650,Miranda; Gregory Joseph,0,28,40,40
1650369168502,CSE 11,A01,083080,Cao; Yingjun,0,88,40,40
1650369174534,CSE 12,A01,083652,Staff,0,12,100,100
1650369180562,CSE 15L,A01,083654,Staff,0,1,50,50
1650369180562,CSE 15L,A02,083655,Staff,3,0,50,47
1650369186589,CSE 20,A01,083657,Staff,52,0,80,28
1650369192618,CSE 30,A01,083084,Eldon; John,0,76,40,40
1650369198646,CSE 100,A01,083659,Cao; Yingjun,0,66,50,50
1650369204679,CSE 134B,A01,083661,Powell; Thomas Allan,0,31,65,65
1650369210710,CSE 140,A01,083663,Staff,0,0,75,75
1650369216743,CSE 140L,A01,083088,Eldon; John,0,7,75,75
1650369222775,CSE 175,A01,083665,Kumar; Rakesh,8,0,25,17
1650369228806,CSE 190,A00,092507,Dubnov; Shlomo,14,0,20,6
1650369234835,ECE 45,A01,083139,Staff,0,17,40,40
1650369240866,ECE 65,A50,083695,Staff,0,5,30,30
1650369246895,ECE 109,A01,091882,Touri; Behrouz,40,0,70,30
1650369252928,ECE 180,A00,083140,Abi Samra; Nicholas Camill,23,0,30,7
1650369252928,ECE 180,B00,083141,Abi Samra; Nicholas Camill,5,0,30,25
1650369258969,MATH 10A,A01,083735,Patchell; Gregory David,7,0,30,23
1650369258969,MATH 10A,A02,083736,Patchell; Gregory David,28,0,30,2
1650369258969,MATH 10A,A03,083737,Patchell; Gregory David,25,0,30,5
1650369264995,MATH 10B,A01,083207,Staff,0,7,30,30
1650369264995,MATH 10B,A02,083208,Staff,0,6,30,30
1650369264995,MATH 10B,B01,083739,Staff,17,0,30,13
1650369264995,MATH 10B,B02,083740,Staff,28,0,30,2
1650369271026,MATH 18,A01,083743,Staff,3,0,30,27
1650369271026,MATH 18,A02,083744,Staff,27,0,30,3
1650369271026,MATH 18,A03,083745,Staff,22,0,30,8
1650369271026,MATH 18,A04,083746,Staff,27,0,30,3
1650369271026,MATH 18,B01,083748,Staff,0,11,30,30
1650369271026,MATH 18,B02,083749,Staff,0,11,30,30
1650369271026,MATH 18,B03,083750,Staff,0,11,30,30
1650369271026,MATH 18,B04,083751,Staff,0,9,30,30
1650369277058,MATH 20A,A01,083754,Staff,26,0,40,14
1650369283108,MATH 20B,A01,083756,Staff,0,8,30,30
1650369283108,MATH 20B,A02,083757,Staff,0,8,30,30
1650369289134,MATH 20C,A01,083760,Staff,0,14,30,30
1650369289134,MATH 20C,A02,083761,Staff,0,15,30,30
1650369289134,MATH 20C,B01,083762,Staff,13,0,30,17
1650369289134,MATH 20C,B02,083763,Staff,28,0,30,2
1650369295256,MATH 20D,A01,083765,Staff,0,1,30,30
1650369295256,MATH 20D,A02,083766,Staff,7,0,30,23
1650369295256,MATH 20D,A03,083767,Staff,26,0,30,4
1650369301286,MATH 20E,A01,083771,Staff,5,0,30,25
1650369301286,MATH 20E,A02,083772,Staff,19,0,30,11
1650369301286,MATH 20E,B01,083773,Staff,0,0,30,30
1650369301286,MATH 20E,B02,083774,Staff,12,0,30,18
1650369307313,MATH 103A,A01,083777,Staff,0,11,30,30
1650369307313,MATH 103A,A02,083778,Staff,0,12,30,30
1650369307313,MATH 103A,B01,083779,Staff,0,13,30,30
1650369307313,MATH 103A,B02,083780,Staff,0,11,30,30
1650369313549,MATH 105,A01,085443,Staff,0,21,30,30
1650369319578,MATH 109,A01,083213,Anzaldo; Leesa B,0,6,30,30
1650369319578,MATH 109,A02,083214,Anzaldo; Leesa B,0,7,30,30
1650369319578,MATH 109,B01,083215,Anzaldo; Leesa B,0,5,30,30
1650369319578,MATH 109,B02,083216,Anzaldo; Leesa B,0,5,30,30
1650369325607,MATH 142A,A01,083219,Chow; Bennett,0,14,30,30
1650369325607,MATH 142A,A02,083220,Chow; Bennett,0,12,30,30
1650369325607,MATH 142A,B01,083221,Chow; Bennett,0,12,30,30
1650369325607,MATH 142A,B02,083222,Chow; Bennett,0,12,30,30
1650369331631,MATH 193A,A01,083224,Staff,0,5,30,30
1650369331631,MATH 193A,A02,083225,Staff,0,5,30,30
1650369331631,MATH 193A,A03,083781,Staff,0,4,30,30
1650369331631,MATH 193A,A04,083782,Staff,0,3,30,30
1650369337659,MATH 197,001,091859,McAuley; Julian John,9998,0,9999,1
1650369343731,COGS 9,A01,083615,Staff,0,14,60,60
1650369349764,COGS 11,A01,083617,Boyle; Mary E. T.,22,0,40,18
1650369355796,COGS 13,A01,083071,Staff,0,32,40,40
1650369361825,COGS 14A,A01,092681,Staff,0,21,100,100
1650369367854,COGS 14B,A01,083073,Cheng; Tzu-Han,0,10,50,50
1650369373884,COGS 17,A01,092677,Staff,24,0,75,51
1650369379942,COGS 100,A01,083619,Staff,0,24,60,60
1650369385967,COGS 101A,A01,083621,Davis; Joshua Daniel,0,21,60,60
1650369391996,COGS 101B,A01,091572,Staff,0,0,60,60
1650369398025,COGS 101C,A01,083625,Delgado; Tania,17,0,30,13
1650369404055,COGS 107A,A01,083627,Boyle; Mary E. T.,0,10,60,60
1650369410082,COGS 118A,A01,083075,Staff,4,0,60,56
1650369416116,CSE 3,A50,083646,Miranda; Gregory Joseph,21,0,38,17
1650369416116,CSE 3,A51,083647,Miranda; Gregory Joseph,37,0,37,0
1650369422148,CSE 8A,A50,083650,Miranda; Gregory Joseph,0,28,40,40
1650369428180,CSE 11,A01,083080,Cao; Yingjun,0,88,40,40
1650369434210,CSE 12,A01,083652,Staff,0,12,100,100
1650369440240,CSE 15L,A01,083654,Staff,0,1,50,50
1650369440240,CSE 15L,A02,083655,Staff,3,0,50,47
1650369446270,CSE 20,A01,083657,Staff,52,0,80,28
1650369452307,CSE 30,A01,083084,Eldon; John,0,76,40,40
1650369458336,CSE 100,A01,083659,Cao; Yingjun,0,66,50,50
1650369464362,CSE 134B,A01,083661,Powell; Thomas Allan,0,31,65,65
1650369470386,CSE 140,A01,083663,Staff,0,0,75,75
1650369476413,CSE 140L,A01,083088,Eldon; John,0,7,75,75
1650369482445,CSE 175,A01,083665,Kumar; Rakesh,8,0,25,17
1650369488472,CSE 190,A00,092507,Dubnov; Shlomo,14,0,20,6
1650369494505,ECE 45,A01,083139,Staff,0,17,40,40
1650369500539,ECE 65,A50,083695,Staff,0,5,30,30
1650369506569,ECE 109,A01,091882,Touri; Behrouz,40,0,70,30
1650369512595,ECE 180,A00,083140,Abi Samra; Nicholas Camill,23,0,30,7
1650369512595,ECE 180,B00,083141,Abi Samra; Nicholas Camill,5,0,30,25
1650369518632,MATH 10A,A01,083735,Patchell; Gregory David,7,0,30,23
1650369518632,MATH 10A,A02,083736,Patchell; Gregory David,28,0,30,2
1650369518632,MATH 10A,A03,083737,Patchell; Gregory David,25,0,30,5
1650369524662,MATH 10B,A01,083207,Staff,0,7,30,30
1650369524662,MATH 10B,A02,083208,Staff,0,6,30,30
1650369524662,MATH 10B,B01,083739,Staff,17,0,30,13
1650369524662,MATH 10B,B02,083740,Staff,28,0,30,2
1650369530692,MATH 18,A01,083743,Staff,3,0,30,27
1650369530692,MATH 18,A02,083744,Staff,27,0,30,3
1650369530692,MATH 18,A03,083745,Staff,22,0,30,8
1650369530692,MATH 18,A04,083746,Staff,27,0,30,3
1650369530692,MATH 18,B01,083748,Staff,0,11,30,30
1650369530692,MATH 18,B02,083749,Staff,0,11,30,30
1650369530692,MATH 18,B03,083750,Staff,0,11,30,30
1650369530692,MATH 18,B04,083751,Staff,0,9,30,30
1650369536723,MATH 20A,A01,083754,Staff,26,0,40,14
1650369542752,MATH 20B,A01,083756,Staff,0,8,30,30
1650369542752,MATH 20B,A02,083757,Staff,0,8,30,30
1650369548782,MATH 20C,A01,083760,Staff,0,14,30,30
1650369548782,MATH 20C,A02,083761,Staff,0,15,30,30
1650369548782,MATH 20C,B01,083762,Staff,13,0,30,17
1650369548782,MATH 20C,B02,083763,Staff,28,0,30,2
1650369554811,MATH 20D,A01,083765,Staff,0,1,30,30
1650369554811,MATH 20D,A02,083766,Staff,7,0,30,23
1650369554811,MATH 20D,A03,083767,Staff,26,0,30,4
1650369560839,MATH 20E,A01,083771,Staff,5,0,30,25
1650369560839,MATH 20E,A02,083772,Staff,19,0,30,11
1650369560839,MATH 20E,B01,083773,Staff,0,0,30,30
1650369560839,MATH 20E,B02,083774,Staff,12,0,30,18
1650369566865,MATH 103A,A01,083777,Staff,0,11,30,30
1650369566865,MATH 103A,A02,083778,Staff,0,12,30,30
1650369566865,MATH 103A,B01,083779,Staff,0,13,30,30
1650369566865,MATH 103A,B02,083780,Staff,0,11,30,30
1650369572898,MATH 105,A01,085443,Staff,0,21,30,30
1650369578931,MATH 109,A01,083213,Anzaldo; Leesa B,0,6,30,30
1650369578931,MATH 109,A02,083214,Anzaldo; Leesa B,0,7,30,30
1650369578931,MATH 109,B01,083215,Anzaldo; Leesa B,0,5,30,30
1650369578931,MATH 109,B02,083216,Anzaldo; Leesa B,0,5,30,30
1650369584959,MATH 142A,A01,083219,Chow; Bennett,0,14,30,30
1650369584959,MATH 142A,A02,083220,Chow; Bennett,0,12,30,30
1650369584959,MATH 142A,B01,083221,Chow; Bennett,0,12,30,30
1650369584959,MATH 142A,B02,083222,Chow; Bennett,0,12,30,30
1650369590990,MATH 193A,A01,083224,Staff,0,5,30,30
1650369590990,MATH 193A,A02,083225,Staff,0,5,30,30
1650369590990,MATH 193A,A03,083781,Staff,0,4,30,30
1650369590990,MATH 193A,A04,083782,Staff,0,3,30,30
1650369597018,MATH 197,001,091859,McAuley; Julian John,9998,0,9999,1
1650369603095,COGS 9,A01,083615,Staff,0,14,60,60
1650369609121,COGS 11,A01,083617,Boyle; Mary E. T.,22,0,40,18
1650369615153,COGS 13,A01,083071,Staff,0,32,40,40
1650369621183,COGS 14A,A01,092681,Staff,0,21,100,100
1650369627208,COGS 14B,A01,083073,Cheng; Tzu-Han,0,10,50,50
1650369633239,COGS 17,A01,092677,Staff,24,0,75,51
1650369639266,COGS 100,A01,083619,Staff,0,24,60,60
1650369645296,COGS 101A,A01,083621,Davis; Joshua Daniel,0,21,60,60
1650369651328,COGS 101B,A01,091572,Staff,0,0,60,60
1650369657354,COGS 101C,A01,083625,Delgado; Tania,17,0,30,13
1650369663388,COGS 107A,A01,083627,Boyle; Mary E. T.,0,10,60,60
1650369669413,COGS 118A,A01,083075,Staff,4,0,60,56
1650369675440,CSE 3,A50,083646,Miranda; Gregory Joseph,21,0,38,17
1650369675440,CSE 3,A51,083647,Miranda; Gregory Joseph,37,0,37,0
1650369681465,CSE 8A,A50,083650,Miranda; Gregory Joseph,0,28,40,40
1650369687490,CSE 11,A01,083080,Cao; Yingjun,0,88,40,40
1650369693517,CSE 12,A01,083652,Staff,0,12,100,100
1650369699547,CSE 15L,A01,083654,Staff,0,1,50,50
1650369699547,CSE 15L,A02,083655,Staff,3,0,50,47
1650369705573,CSE 20,A01,083657,Staff,52,0,80,28
1650369711600,CSE 30,A01,083084,Eldon; John,0,76,40,40
1650369717630,CSE 100,A01,083659,Cao; Yingjun,0,66,50,50
1650369723655,CSE 134B,A01,083661,Powell; Thomas Allan,0,31,65,65
1650369729681,CSE 140,A01,083663,Staff,0,0,75,75
1650369735712,CSE 140L,A01,083088,Eldon; John,0,7,75,75
1650369741737,CSE 175,A01,083665,Kumar; Rakesh,8,0,25,17
1650369747772,CSE 190,A00,092507,Dubnov; Shlomo,14,0,20,6
1650369753798,ECE 45,A01,083139,Staff,0,17,40,40
1650369759827,ECE 65,A50,083695,Staff,0,5,30,30
1650369765854,ECE 109,A01,091882,Touri; Behrouz,40,0,70,30
1650369771879,ECE 180,A00,083140,Abi Samra; Nicholas Camill,23,0,30,7
1650369771879,ECE 180,B00,083141,Abi Samra; Nicholas Camill,5,0,30,25
1650369777908,MATH 10A,A01,083735,Patchell; Gregory David,7,0,30,23
1650369777908,MATH 10A,A02,083736,Patchell; Gregory David,28,0,30,2
1650369777908,MATH 10A,A03,083737,Patchell; Gregory David,25,0,30,5
1650369783938,MATH 10B,A01,083207,Staff,0,7,30,30
1650369783938,MATH 10B,A02,083208,Staff,0,6,30,30
1650369783938,MATH 10B,B01,083739,Staff,17,0,30,13
1650369783938,MATH 10B,B02,083740,Staff,28,0,30,2
1650369789967,MATH 18,A01,083743,Staff,3,0,30,27
1650369789967,MATH 18,A02,083744,Staff,27,0,30,3
1650369789967,MATH 18,A03,083745,Staff,22,0,30,8
1650369789967,MATH 18,A04,083746,Staff,27,0,30,3
1650369789967,MATH 18,B01,083748,Staff,0,11,30,30
1650369789967,MATH 18,B02,083749,Staff,0,11,30,30
1650369789967,MATH 18,B03,083750,Staff,0,11,30,30
1650369789967,MATH 18,B04,083751,Staff,0,9,30,30
1650369795996,MATH 20A,A01,083754,Staff,26,0,40,14
1650369802021,MATH 20B,A01,083756,Staff,0,8,30,30
1650369802021,MATH 20B,A02,083757,Staff,0,8,30,30
1650369808048,MATH 20C,A01,083760,Staff,0,14,30,30
1650369808048,MATH 20C,A02,083761,Staff,0,15,30,30
1650369808048,MATH 20C,B01,083762,Staff,13,0,30,17
1650369808048,MATH 20C,B02,083763,Staff,28,0,30,2
1650369814085,MATH 20D,A01,083765,Staff,0,1,30,30
1650369814085,MATH 20D,A02,083766,Staff,7,0,30,23
1650369814085,MATH 20D,A03,083767,Staff,26,0,30,4
1650369820117,MATH 20E,A01,083771,Staff,5,0,30,25
1650369820117,MATH 20E,A02,083772,Staff,19,0,30,11
1650369820117,MATH 20E,B01,083773,Staff,0,0,30,30
1650369820117,MATH 20E,B02,083774,Staff,12,0,30,18
1650369826143,MATH 103A,A01,083777,Staff,0,11,30,30
1650369826143,MATH 103A,A02,083778,Staff,0,12,30,30
1650369826143,MATH 103A,B01,083779,Staff,0,13,30,30
1650369826143,MATH 103A,B02,083780,Staff,0,11,30,30
1650369832168,MATH 105,A01,085443,Staff,0,21,30,30
1650369838200,MATH 109,A01,083213,Anzaldo; Leesa B,0,6,30,30
1650369838200,MATH 109,A02,083214,Anzaldo; Leesa B,0,7,30,30
1650369838200,MATH 109,B01,083215,Anzaldo; Leesa B,0,5,30,30
1650369838200,MATH 109,B02,083216,Anzaldo; Leesa B,0,5,30,30
1650369844232,MATH 142A,A01,083219,Chow; Bennett,0,14,30,30
1650369844232,MATH 142A,A02,083220,Chow; Bennett,0,12,30,30
1650369844232,MATH 142A,B01,083221,Chow; Bennett,0,12,30,30
1650369844232,MATH 142A,B02,083222,Chow; Bennett,0,12,30,30
1650369850263,MATH 193A,A01,083224,Staff,0,5,30,30
1650369850263,MATH 193A,A02,083225,Staff,0,5,30,30
1650369850263,MATH 193A,A03,083781,Staff,0,4,30,30
1650369850263,MATH 193A,A04,083782,Staff,0,3,30,30
1650369856289,MATH 197,001,091859,McAuley; Julian John,9998,0,9999,1
1650369862356,COGS 9,A01,083615,Staff,0,14,60,60
1650369868386,COGS 11,A01,083617,Boyle; Mary E. T.,22,0,40,18
1650369874416,COGS 13,A01,083071,Staff,0,32,40,40
1650369880451,COGS 14A,A01,092681,Staff,0,21,100,100
1650369886575,COGS 14B,A01,083073,Cheng; Tzu-Han,0,10,50,50
1650369892605,COGS 17,A01,092677,Staff,24,0,75,51
1650369898638,COGS 100,A01,083619,Staff,0,24,60,60
1650369904670,COGS 101A,A01,083621,Davis; Joshua Daniel,0,21,60,60
1650369910696,COGS 101B,A01,091572,Staff,0,0,60,60
1650369916724,COGS 101C,A01,083625,Delgado; Tania,17,0,30,13
1650369922755,COGS 107A,A01,083627,Boyle; Mary E. T.,0,10,60,60
1650369928785,COGS 118A,A01,083075,Staff,4,0,60,56
1650369934812,CSE 3,A50,083646,Miranda; Gregory Joseph,21,0,38,17
1650369934812,CSE 3,A51,083647,Miranda; Gregory Joseph,37,0,37,0
1650369940843,CSE 8A,A50,083650,Miranda; Gregory Joseph,0,28,40,40
1650369946870,CSE 11,A01,083080,Cao; Yingjun,0,88,40,40
1650369952901,CSE 12,A01,083652,Staff,0,12,100,100
1650369958942,CSE 15L,A01,083654,Staff,0,1,50,50
1650369958942,CSE 15L,A02,083655,Staff,3,0,50,47
1650369964972,CSE 20,A01,083657,Staff,52,0,80,28
1650369971013,CSE 30,A01,083084,Eldon; John,0,76,40,40
1650369977039,CSE 100,A01,083659,Cao; Yingjun,0,66,50,50
1650369983069,CSE 134B,A01,083661,Powell; Thomas Allan,0,31,65,65
1650369989095,CSE 140,A01,083663,Staff,0,0,75,75
1650369995121,CSE 140L,A01,083088,Eldon; John,0,7,75,75
1650370001152,CSE 175,A01,083665,Kumar; Rakesh,8,0,25,17
1650370007179,CSE 190,A00,092507,Dubnov; Shlomo,14,0,20,6
1650370013207,ECE 45,A01,083139,Staff,0,17,40,40
1650370019236,ECE 65,A50,083695,Staff,0,5,30,30
1650370025261,ECE 109,A01,091882,Touri; Behrouz,40,0,70,30
1650370031291,ECE 180,A00,083140,Abi Samra; Nicholas Camill,23,0,30,7
1650370031291,ECE 180,B00,083141,Abi Samra; Nicholas Camill,5,0,30,25
1650370037321,MATH 10A,A01,083735,Patchell; Gregory David,7,0,30,23
1650370037321,MATH 10A,A02,083736,Patchell; Gregory David,28,0,30,2
1650370037321,MATH 10A,A03,083737,Patchell; Gregory David,25,0,30,5
1650370043351,MATH 10B,A01,083207,Staff,0,7,30,30
1650370043351,MATH 10B,A02,083208,Staff,0,6,30,30
1650370043351,MATH 10B,B01,083739,Staff,17,0,30,13
1650370043351,MATH 10B,B02,083740,Staff,28,0,30,2
1650370049381,MATH 18,A01,083743,Staff,3,0,30,27
1650370049381,MATH 18,A02,083744,Staff,27,0,30,3
1650370049381,MATH 18,A03,083745,Staff,22,0,30,8
1650370049381,MATH 18,A04,083746,Staff,27,0,30,3
1650370049381,MATH 18,B01,083748,Staff,0,11,30,30
1650370049381,MATH 18,B02,083749,Staff,0,11,30,30
1650370049381,MATH 18,B03,083750,Staff,0,11,30,30
1650370049381,MATH 18,B04,083751,Staff,0,9,30,30
1650370055407,MATH 20A,A01,083754,Staff,26,0,40,14
1650370061434,MATH 20B,A01,083756,Staff,0,8,30,30
1650370061434,MATH 20B,A02,083757,Staff,0,8,30,30
1650370067464,MATH 20C,A01,083760,Staff,0,14,30,30
1650370067464,MATH 20C,A02,083761,Staff,0,15,30,30
1650370067464,MATH 20C,B01,083762,Staff,13,0,30,17
1650370067464,MATH 20C,B02,083763,Staff,28,0,30,2
1650370073490,MATH 20D,A01,083765,Staff,0,1,30,30
1650370073490,MATH 20D,A02,083766,Staff,7,0,30,23
1650370073490,MATH 20D,A03,083767,Staff,26,0,30,4
1650370079519,MATH 20E,A01,083771,Staff,5,0,30,25
1650370079519,MATH 20E,A02,083772,Staff,19,0,30,11
1650370079519,MATH 20E,B01,083773,Staff,0,0,30,30
1650370079519,MATH 20E,B02,083774,Staff,12,0,30,18
1650370085548,MATH 103A,A01,083777,Staff,0,11,30,30
1650370085548,MATH 103A,A02,083778,Staff,0,12,30,30
1650370085548,MATH 103A,B01,083779,Staff,0,13,30,30
1650370085548,MATH 103A,B02,083780,Staff,0,11,30,30
1650370091577,MATH 105,A01,085443,Staff,0,21,30,30
1650370097604,MATH 109,A01,083213,Anzaldo; Leesa B,0,6,30,30
1650370097604,MATH 109,A02,083214,Anzaldo; Leesa B,0,7,30,30
1650370097604,MATH 109,B01,083215,Anzaldo; Leesa B,0,5,30,30
1650370097604,MATH 109,B02,083216,Anzaldo; Leesa B,0,5,30,30
1650370103644,MATH 142A,A01,083219,Chow; Bennett,0,14,30,30
1650370103644,MATH 142A,A02,083220,Chow; Bennett,0,12,30,30
1650370103644,MATH 142A,B01,083221,Chow; Bennett,0,12,30,30
1650370103644,MATH 142A,B02,083222,Chow; Bennett,0,12,30,30
1650370109671,MATH 193A,A01,083224,Staff,0,5,30,30
1650370109671,MATH 193A,A02,083225,Staff,0,5,30,30
1650370109671,MATH 193A,A03,083781,Staff,0,4,30,30
1650370109671,MATH 193A,A04,083782,Staff,0,3,30,30
1650370115696,MATH 197,001,091859,McAuley; Julian John,9998,0,9999,1
1650370121780,COGS 9,A01,083615,Staff,0,14,60,60
1650370127807,COGS 11,A01,083617,Boyle; Mary E. T.,22,0,40,18
1650370133836,COGS 13,A01,083071,Staff,0,32,40,40
1650370139864,COGS 14A,A01,092681,Staff,0,21,100,100
1650370145896,COGS 14B,A01,083073,Cheng; Tzu-Han,0,10,50,50
1650370151921,COGS 17,A01,092677,Staff,24,0,75,51
1650370157948,COGS 100,A01,083619,Staff,0,24,60,60
1650370163985,COGS 101A,A01,083621,Davis; Joshua Daniel,0,21,60,60
1650370170012,COGS 101B,A01,091572,Staff,0,0,60,60
1650370176044,COGS 101C,A01,083625,Delgado; Tania,17,0,30,13
1650370182072,COGS 107A,A01,083627,Boyle; Mary E. T.,0,10,60,60
1650370188099,COGS 118A,A01,083075,Staff,4,0,60,56
1650370194132,CSE 3,A50,083646,Miranda; Gregory Joseph,21,0,38,17
1650370194132,CSE 3,A51,083647,Miranda; Gregory Joseph,37,0,37,0
1650370200160,CSE 8A,A50,083650,Miranda; Gregory Joseph,0,28,40,40
1650370206206,CSE 11,A01,083080,Cao; Yingjun,0,88,40,40
1650370212245,CSE 12,A01,083652,Staff,0,12,100,100
1650370218270,CSE 15L,A01,083654,Staff,0,1,50,50
1650370218270,CSE 15L,A02,083655,Staff,3,0,50,47
1650370224313,CSE 20,A01,083657,Staff,52,0,80,28
1650370230348,CSE 30,A01,083084,Eldon; John,0,76,40,40
1650370236376,CSE 100,A01,083659,Cao; Yingjun,0,66,50,50
1650370242403,CSE 134B,A01,083661,Powell; Thomas Allan,0,31,65,65
1650370248428,CSE 140,A01,083663,Staff,0,0,75,75
1650370254457,CSE 140L,A01,083088,Eldon; John,0,7,75,75
1650370260489,CSE 175,A01,083665,Kumar; Rakesh,8,0,25,17
1650370266522,CSE 190,A00,092507,Dubnov; Shlomo,14,0,20,6
1650370272553,ECE 45,A01,083139,Staff,0,17,40,40
1650370278586,ECE 65,A50,083695,Staff,0,5,30,30
1650370284617,ECE 109,A01,091882,Touri; Behrouz,40,0,70,30
1650370290643,ECE 180,A00,083140,Abi Samra; Nicholas Camill,23,0,30,7
1650370290643,ECE 180,B00,083141,Abi Samra; Nicholas Camill,5,0,30,25
1650370296671,MATH 10A,A01,083735,Patchell; Gregory David,7,0,30,23
1650370296671,MATH 10A,A02,083736,Patchell; Gregory David,28,0,30,2
1650370296671,MATH 10A,A03,083737,Patchell; Gregory David,25,0,30,5
1650370302697,MATH 10B,A01,083207,Staff,0,7,30,30
1650370302697,MATH 10B,A02,083208,Staff,0,6,30,30
1650370302697,MATH 10B,B01,083739,Staff,17,0,30,13
1650370302697,MATH 10B,B02,083740,Staff,28,0,30,2
1650370308736,MATH 18,A01,083743,Staff,3,0,30,27
1650370308736,MATH 18,A02,083744,Staff,27,0,30,3
1650370308736,MATH 18,A03,083745,Staff,22,0,30,8
1650370308736,MATH 18,A04,083746,Staff,27,0,30,3
1650370308736,MATH 18,B01,083748,Staff,0,11,30,30
1650370308736,MATH 18,B02,083749,Staff,0,11,30,30
1650370308736,MATH 18,B03,083750,Staff,0,11,30,30
1650370308736,MATH 18,B04,083751,Staff,0,9,30,30
1650370314766,MATH 20A,A01,083754,Staff,26,0,40,14
1650370320800,MATH 20B,A01,083756,Staff,0,8,30,30
1650370320800,MATH 20B,A02,083757,Staff,0,8,30,30
1650370326830,MATH 20C,A01,083760,Staff,0,14,30,30
1650370326830,MATH 20C,A02,083761,Staff,0,15,30,30
1650370326830,MATH 20C,B01,083762,Staff,13,0,30,17
1650370326830,MATH 20C,B02,083763,Staff,28,0,30,2
1650370332857,MATH 20D,A01,083765,Staff,0,1,30,30
1650370332857,MATH 20D,A02,083766,Staff,7,0,30,23
1650370332857,MATH 20D,A03,083767,Staff,26,0,30,4
1650370338893,MATH 20E,A01,083771,Staff,5,0,30,25
1650370338893,MATH 20E,A02,083772,Staff,19,0,30,11
1650370338893,MATH 20E,B01,083773,Staff,0,0,30,30
1650370338893,MATH 20E,B02,083774,Staff,12,0,30,18
1650370344924,MATH 103A,A01,083777,Staff,0,11,30,30
1650370344924,MATH 103A,A02,083778,Staff,0,12,30,30
1650370344924,MATH 103A,B01,083779,Staff,0,13,30,30
1650370344924,MATH 103A,B02,083780,Staff,0,11,30,30
1650370350951,MATH 105,A01,085443,Staff,0,21,30,30
1650370356982,MATH 109,A01,083213,Anzaldo; Leesa B,0,6,30,30
1650370356982,MATH 109,A02,083214,Anzaldo; Leesa B,0,7,30,30
1650370356982,MATH 109,B01,083215,Anzaldo; Leesa B,0,5,30,30
1650370356982,MATH 109,B02,083216,Anzaldo; Leesa B,0,5,30,30
1650370363038,MATH 142A,A01,083219,Chow; Bennett,0,14,30,30
1650370363038,MATH 142A,A02,083220,Chow; Bennett,0,12,30,30
1650370363038,MATH 142A,B01,083221,Chow; Bennett,0,12,30,30
1650370363038,MATH 142A,B02,083222,Chow; Bennett,0,12,30,30
1650370369074,MATH 193A,A01,083224,Staff,0,5,30,30
1650370369074,MATH 193A,A02,083225,Staff,0,5,30,30
1650370369074,MATH 193A,A03,083781,Staff,0,4,30,30
1650370369074,MATH 193A,A04,083782,Staff,0,3,30,30
1650370375099,MATH 197,001,091859,McAuley; Julian John,9998,0,9999,1
1650370381186,COGS 9,A01,083615,Staff,0,14,60,60
1650370387218,COGS 11,A01,083617,Boyle; Mary E. T.,22,0,40,18
1650370393252,COGS 13,A01,083071,Staff,0,32,40,40
1650370399302,COGS 14A,A01,092681,Staff,0,21,100,100
1650370405331,COGS 14B,A01,083073,Cheng; Tzu-Han,0,10,50,50
1650370411365,COGS 17,A01,092677,Staff,24,0,75,51
1650370417398,COGS 100,A01,083619,Staff,0,24,60,60
1650370423430,COGS 101A,A01,083621,Davis; Joshua Daniel,0,21,60,60
1650370429462,COGS 101B,A01,091572,Staff,0,0,60,60
1650370435494,COGS 101C,A01,083625,Delgado; Tania,17,0,30,13
1650370441519,COGS 107A,A01,083627,Boyle; Mary E. T.,0,10,60,60
1650370447546,COGS 118A,A01,083075,Staff,4,0,60,56
1650370453575,CSE 3,A50,083646,Miranda; Gregory Joseph,21,0,38,17
1650370453575,CSE 3,A51,083647,Miranda; Gregory Joseph,37,0,37,0
1650370459626,CSE 8A,A50,083650,Miranda; Gregory Joseph,0,28,40,40
1650370465651,CSE 11,A01,083080,Cao; Yingjun,0,88,40,40
1650370471679,CSE 12,A01,083652,Staff,0,12,100,100
1650370477708,CSE 15L,A01,083654,Staff,0,1,50,50
1650370477708,CSE 15L,A02,083655,Staff,3,0,50,47
1650370483834,CSE 20,A01,083657,Staff,52,0,80,28
1650370489867,CSE 30,A01,083084,Eldon; John,0,76,40,40
1650370495900,CSE 100,A01,083659,Cao; Yingjun,0,66,50,50
1650370501932,CSE 134B,A01,083661,Powell; Thomas Allan,0,31,65,65
1650370507960,CSE 140,A01,083663,Staff,0,0,75,75
1650370513983,CSE 140L,A01,083088,Eldon; John,0,7,75,75
1650370520007,CSE 175,A01,083665,Kumar; Rakesh,8,0,25,17
1650370526033,CSE 190,A00,092507,Dubnov; Shlomo,14,0,20,6
1650370532066,ECE 45,A01,083139,Staff,0,17,40,40
1650370538095,ECE 65,A50,083695,Staff,0,5,30,30
1650370544135,ECE 109,A01,091882,Touri; Behrouz,40,0,70,30
1650370550174,ECE 180,A00,083140,Abi Samra; Nicholas Camill,23,0,30,7
1650370550174,ECE 180,B00,083141,Abi Samra; Nicholas Camill,5,0,30,25
1650370556202,MATH 10A,A01,083735,Patchell; Gregory David,7,0,30,23
1650370556202,MATH 10A,A02,083736,Patchell; Gregory David,28,0,30,2
1650370556202,MATH 10A,A03,083737,Patchell; Gregory David,25,0,30,5
1650370562227,MATH 10B,A01,083207,Staff,0,7,30,30
1650370562227,MATH 10B,A02,083208,Staff,0,6,30,30
1650370562227,MATH 10B,B01,083739,Staff,17,0,30,13
1650370562227,MATH 10B,B02,083740,Staff,28,0,30,2
1650370568262,MATH 18,A01,083743,Staff,3,0,30,27
1650370568262,MATH 18,A02,083744,Staff,27,0,30,3
1650370568262,MATH 18,A03,083745,Staff,22,0,30,8
1650370568262,MATH 18,A04,083746,Staff,27,0,30,3
1650370568262,MATH 18,B01,083748,Staff,0,11,30,30
1650370568262,MATH 18,B02,083749,Staff,0,11,30,30
1650370568262,MATH 18,B03,083750,Staff,0,11,30,30
1650370568262,MATH 18,B04,083751,Staff,0,9,30,30
1650370574287,MATH 20A,A01,083754,Staff,26,0,40,14
1650370580314,MATH 20B,A01,083756,Staff,0,8,30,30
1650370580314,MATH 20B,A02,083757,Staff,0,8,30,30
1650370586340,MATH 20C,A01,083760,Staff,0,14,30,30
1650370586340,MATH 20C,A02,083761,Staff,0,15,30,30
1650370586340,MATH 20C,B01,083762,Staff,13,0,30,17
1650370586340,MATH 20C,B02,083763,Staff,28,0,30,2
1650370592370,MATH 20D,A01,083765,Staff,0,1,30,30
1650370592370,MATH 20D,A02,083766,Staff,7,0,30,23
1650370592370,MATH 20D,A03,083767,Staff,26,0,30,4
1650370598395,MATH 20E,A01,083771,Staff,5,0,30,25
1650370598395,MATH 20E,A02,083772,Staff,19,0,30,11
1650370598395,MATH 20E,B01,083773,Staff,0,0,30,30
1650370598395,MATH 20E,B02,083774,Staff,12,0,30,18
1650370604426,MATH 103A,A01,083777,Staff,0,11,30,30
1650370604426,MATH 103A,A02,083778,Staff,0,12,30,30
1650370604426,MATH 103A,B01,083779,Staff,0,13,30,30
1650370604426,MATH 103A,B02,083780,Staff,0,11,30,30
1650370610454,MATH 105,A01,085443,Staff,0,21,30,30
1650370616506,MATH 109,A01,083213,Anzaldo; Leesa B,0,6,30,30
1650370616506,MATH 109,A02,083214,Anzaldo; Leesa B,0,7,30,30
1650370616506,MATH 109,B01,083215,Anzaldo; Leesa B,0,5,30,30
1650370616506,MATH 109,B02,083216,Anzaldo; Leesa B,0,5,30,30
1650370622537,MATH 142A,A01,083219,Chow; Bennett,0,14,30,30
1650370622537,MATH 142A,A02,083220,Chow; Bennett,0,12,30,30
1650370622537,MATH 142A,B01,083221,Chow; Bennett,0,12,30,30
1650370622537,MATH 142A,B02,083222,Chow; Bennett,0,12,30,30
1650370628576,MATH 193A,A01,083224,Staff,0,5,30,30
1650370628576,MATH 193A,A02,083225,Staff,0,5,30,30
1650370628576,MATH 193A,A03,083781,Staff,0,4,30,30
1650370628576,MATH 193A,A04,083782,Staff,0,3,30,30
1650370634602,MATH 197,001,091859,McAuley; Julian John,9998,0,9999,1
1650370640694,COGS 9,A01,083615,Staff,0,14,60,60
1650370646721,COGS 11,A01,083617,Boyle; Mary E. T.,22,0,40,18
1650370652747,COGS 13,A01,083071,Staff,0,32,40,40
1650370658778,COGS 14A,A01,092681,Staff,0,21,100,100
1650370664803,COGS 14B,A01,083073,Cheng; Tzu-Han,0,10,50,50
1650370670833,COGS 17,A01,092677,Staff,24,0,75,51
1650370676859,COGS 100,A01,083619,Staff,0,24,60,60
1650370682890,COGS 101A,A01,083621,Davis; Joshua Daniel,0,21,60,60
1650370688917,COGS 101B,A01,091572,Staff,0,0,60,60
1650370694947,COGS 101C,A01,083625,Delgado; Tania,17,0,30,13
1650370700971,COGS 107A,A01,083627,Boyle; Mary E. T.,0,10,60,60
1650370706999,COGS 118A,A01,083075,Staff,4,0,60,56
1650370713033,CSE 3,A50,083646,Miranda; Gregory Joseph,21,0,38,17
1650370713033,CSE 3,A51,083647,Miranda; Gregory Joseph,37,0,37,0
1650370719060,CSE 8A,A50,083650,Miranda; Gregory Joseph,0,28,40,40
1650370725098,CSE 11,A01,083080,Cao; Yingjun,0,88,40,40
1650370731123,CSE 12,A01,083652,Staff,0,12,100,100
1650370737149,CSE 15L,A01,083654,Staff,0,1,50,50
1650370737149,CSE 15L,A02,083655,Staff,3,0,50,47
1650370743175,CSE 20,A01,083657,Staff,52,0,80,28
1650370749201,CSE 30,A01,083084,Eldon; John,0,76,40,40
1650370755240,CSE 100,A01,083659,Cao; Yingjun,0,66,50,50
1650370761270,CSE 134B,A01,083661,Powell; Thomas Allan,0,31,65,65
1650370767325,CSE 140,A01,083663,Staff,0,0,75,75
1650370773356,CSE 140L,A01,083088,Eldon; John,0,7,75,75
1650370779383,CSE 175,A01,083665,Kumar; Rakesh,8,0,25,17
1650370785409,CSE 190,A00,092507,Dubnov; Shlomo,14,0,20,6
1650370791437,ECE 45,A01,083139,Staff,0,17,40,40
1650370797463,ECE 65,A50,083695,Staff,0,5,30,30
1650370803493,ECE 109,A01,091882,Touri; Behrouz,40,0,70,30
1650370809523,ECE 180,A00,083140,Abi Samra; Nicholas Camill,23,0,30,7
1650370809523,ECE 180,B00,083141,Abi Samra; Nicholas Camill,5,0,30,25
1650370815551,MATH 10A,A01,083735,Patchell; Gregory David,7,0,30,23
1650370815551,MATH 10A,A02,083736,Patchell; Gregory David,28,0,30,2
1650370815551,MATH 10A,A03,083737,Patchell; Gregory David,25,0,30,5
1650370821581,MATH 10B,A01,083207,Staff,0,7,30,30
1650370821581,MATH 10B,A02,083208,Staff,0,6,30,30
1650370821581,MATH 10B,B01,083739,Staff,17,0,30,13
1650370821581,MATH 10B,B02,083740,Staff,28,0,30,2
1650370827607,MATH 18,A01,083743,Staff,3,0,30,27
1650370827607,MATH 18,A02,083744,Staff,27,0,30,3
1650370827607,MATH 18,A03,083745,Staff,22,0,30,8
1650370827607,MATH 18,A04,083746,Staff,27,0,30,3
1650370827607,MATH 18,B01,083748,Staff,0,11,30,30
1650370827607,MATH 18,B02,083749,Staff,0,11,30,30
1650370827607,MATH 18,B03,083750,Staff,0,11,30,30
1650370827607,MATH 18,B04,083751,Staff,0,9,30,30
1650370833635,MATH 20A,A01,083754,Staff,26,0,40,14
1650370839664,MATH 20B,A01,083756,Staff,0,8,30,30
1650370839664,MATH 20B,A02,083757,Staff,0,8,30,30
1650370845691,MATH 20C,A01,083760,Staff,0,14,30,30
1650370845691,MATH 20C,A02,083761,Staff,0,15,30,30
1650370845691,MATH 20C,B01,083762,Staff,13,0,30,17
1650370845691,MATH 20C,B02,083763,Staff,28,0,30,2
1650370851716,MATH 20D,A01,083765,Staff,0,1,30,30
1650370851716,MATH 20D,A02,083766,Staff,7,0,30,23
1650370851716,MATH 20D,A03,083767,Staff,26,0,30,4
1650370857741,MATH 20E,A01,083771,Staff,5,0,30,25
1650370857741,MATH 20E,A02,083772,Staff,19,0,30,11
1650370857741,MATH 20E,B01,083773,Staff,0,0,30,30
1650370857741,MATH 20E,B02,083774,Staff,12,0,30,18
1650370863767,MATH 103A,A01,083777,Staff,0,11,30,30
1650370863767,MATH 103A,A02,083778,Staff,0,12,30,30
1650370863767,MATH 103A,B01,083779,Staff,0,13,30,30
1650370863767,MATH 103A,B02,083780,Staff,0,11,30,30
1650370869791,MATH 105,A01,085443,Staff,0,21,30,30
1650370875819,MATH 109,A01,083213,Anzaldo; Leesa B,0,6,30,30
1650370875819,MATH 109,A02,083214,Anzaldo; Leesa B,0,7,30,30
1650370875819,MATH 109,B01,083215,Anzaldo; Leesa B,0,5,30,30
1650370875819,MATH 109,B02,083216,Anzaldo; Leesa B,0,5,30,30
1650370881855,MATH 142A,A01,083219,Chow; Bennett,0,14,30,30
1650370881855,MATH 142A,A02,083220,Chow; Bennett,0,12,30,30
1650370881855,MATH 142A,B01,083221,Chow; Bennett,0,12,30,30
1650370881855,MATH 142A,B02,083222,Chow; Bennett,0,12,30,30
1650370887887,MATH 193A,A01,083224,Staff,0,5,30,30
1650370887887,MATH 193A,A02,083225,Staff,0,5,30,30
1650370887887,MATH 193A,A03,083781,Staff,0,4,30,30
1650370887887,MATH 193A,A04,083782,Staff,0,3,30,30
1650370893913,MATH 197,001,091859,McAuley; Julian John,9998,0,9999,1
1650370900003,COGS 9,A01,083615,Staff,0,14,60,60
1650370906027,COGS 11,A01,083617,Boyle; Mary E. T.,22,0,40,18
1650370912053,COGS 13,A01,083071,Staff,0,32,40,40
1650370918079,COGS 14A,A01,092681,Staff,0,21,100,100
1650370924106,COGS 14B,A01,083073,Cheng; Tzu-Han,0,10,50,50
1650370930132,COGS 17,A01,092677,Staff,24,0,75,51
1650370936159,COGS 100,A01,083619,Staff,0,24,60,60
1650370942190,COGS 101A,A01,083621,Davis; Joshua Daniel,0,21,60,60
1650370948220,COGS 101B,A01,091572,Staff,0,0,60,60
1650370954248,COGS 101C,A01,083625,Delgado; Tania,17,0,30,13
1650370960272,COGS 107A,A01,083627,Boyle; Mary E. T.,0,10,60,60
1650370966297,COGS 118A,A01,083075,Staff,4,0,60,56
1650370972332,CSE 3,A50,083646,Miranda; Gregory Joseph,21,0,38,17
1650370972332,CSE 3,A51,083647,Miranda; Gregory Joseph,37,0,37,0
1650370978363,CSE 8A,A50,083650,Miranda; Gregory Joseph,0,28,40,40
1650370984394,CSE 11,A01,083080,Cao; Yingjun,0,88,40,40
1650370990417,CSE 12,A01,083652,Staff,0,12,100,100
1650370996444,CSE 15L,A01,083654,Staff,0,1,50,50
1650370996444,CSE 15L,A02,083655,Staff,3,0,50,47
1650371002482,CSE 20,A01,083657,Staff,52,0,80,28
1650371008512,CSE 30,A01,083084,Eldon; John,0,76,40,40
1650371014551,CSE 100,A01,083659,Cao; Yingjun,0,66,50,50
1650371020590,CSE 134B,A01,083661,Powell; Thomas Allan,0,31,65,65
1650371026620,CSE 140,A01,083663,Staff,0,0,75,75
1650371032647,CSE 140L,A01,083088,Eldon; John,0,7,75,75
1650371038689,CSE 175,A01,083665,Kumar; Rakesh,8,0,25,17
1650371044728,CSE 190,A00,092507,Dubnov; Shlomo,14,0,20,6
1650371050753,ECE 45,A01,083139,Staff,0,17,40,40
1650371056777,ECE 65,A50,083695,Staff,0,5,30,30
1650371062803,ECE 109,A01,091882,Touri; Behrouz,40,0,70,30
1650371068828,ECE 180,A00,083140,Abi Samra; Nicholas Camill,23,0,30,7
1650371068828,ECE 180,B00,083141,Abi Samra; Nicholas Camill,5,0,30,25
1650371074863,MATH 10A,A01,083735,Patchell; Gregory David,7,0,30,23
1650371074863,MATH 10A,A02,083736,Patchell; Gregory David,28,0,30,2
1650371074863,MATH 10A,A03,083737,Patchell; Gregory David,25,0,30,5
1650371080981,MATH 10B,A01,083207,Staff,0,7,30,30
1650371080981,MATH 10B,A02,083208,Staff,0,6,30,30
1650371080981,MATH 10B,B01,083739,Staff,17,0,30,13
1650371080981,MATH 10B,B02,083740,Staff,28,0,30,2
1650371087019,MATH 18,A01,083743,Staff,3,0,30,27
1650371087019,MATH 18,A02,083744,Staff,27,0,30,3
1650371087019,MATH 18,A03,083745,Staff,22,0,30,8
1650371087019,MATH 18,A04,083746,Staff,27,0,30,3
1650371087019,MATH 18,B01,083748,Staff,0,11,30,30
1650371087019,MATH 18,B02,083749,Staff,0,11,30,30
1650371087019,MATH 18,B03,083750,Staff,0,11,30,30
1650371087019,MATH 18,B04,083751,Staff,0,9,30,30
1650371093049,MATH 20A,A01,083754,Staff,26,0,40,14
1650371099080,MATH 20B,A01,083756,Staff,0,8,30,30
1650371099080,MATH 20B,A02,083757,Staff,0,8,30,30
1650371105108,MATH 20C,A01,083760,Staff,0,14,30,30
1650371105108,MATH 20C,A02,083761,Staff,0,15,30,30
1650371105108,MATH 20C,B01,083762,Staff,13,0,30,17
1650371105108,MATH 20C,B02,083763,Staff,28,0,30,2
1650371111138,MATH 20D,A01,083765,Staff,0,1,30,30
1650371111138,MATH 20D,A02,083766,Staff,7,0,30,23
1650371111138,MATH 20D,A03,083767,Staff,26,0,30,4
1650371117164,MATH 20E,A01,083771,Staff,5,0,30,25
1650371117164,MATH 20E,A02,083772,Staff,19,0,30,11
1650371117164,MATH 20E,B01,083773,Staff,0,0,30,30
1650371117164,MATH 20E,B02,083774,Staff,12,0,30,18
1650371123191,MATH 103A,A01,083777,Staff,0,11,30,30
1650371123191,MATH 103A,A02,083778,Staff,0,12,30,30
1650371123191,MATH 103A,B01,083779,Staff,0,13,30,30
1650371123191,MATH 103A,B02,083780,Staff,0,11,30,30
1650371129216,MATH 105,A01,085443,Staff,0,21,30,30
1650371135245,MATH 109,A01,083213,Anzaldo; Leesa B,0,6,30,30
1650371135245,MATH 109,A02,083214,Anzaldo; Leesa B,0,7,30,30
1650371135245,MATH 109,B01,083215,Anzaldo; Leesa B,0,5,30,30
1650371135245,MATH 109,B02,083216,Anzaldo; Leesa B,0,5,30,30
1650371141270,MATH 142A,A01,083219,Chow; Bennett,0,14,30,30
1650371141270,MATH 142A,A02,083220,Chow; Bennett,0,12,30,30
1650371141270,MATH 142A,B01,083221,Chow; Bennett,0,12,30,30
1650371141270,MATH 142A,B02,083222,Chow; Bennett,0,12,30,30
1650371147299,MATH 193A,A01,083224,Staff,0,5,30,30
1650371147299,MATH 193A,A02,083225,Staff,0,5,30,30
1650371147299,MATH 193A,A03,083781,Staff,0,4,30,30
1650371147299,MATH 193A,A04,083782,Staff,0,3,30,30
1650371153325,MATH 197,001,091859,McAuley; Julian John,9998,0,9999,1
1650371159388,COGS 9,A01,083615,Staff,0,14,60,60
1650371165421,COGS 11,A01,083617,Boyle; Mary E. T.,22,0,40,18
1650371171451,COGS 13,A01,083071,Staff,0,32,40,40
1650371177478,COGS 14A,A01,092681,Staff,0,21,100,100
1650371183505,COGS 14B,A01,083073,Cheng; Tzu-Han,0,10,50,50
1650371189533,COGS 17,A01,092677,Staff,24,0,75,51
1650371195564,COGS 100,A01,083619,Staff,0,24,60,60
1650371201609,COGS 101A,A01,083621,Davis; Joshua Daniel,0,21,60,60
1650371207634,COGS 101B,A01,091572,Staff,0,0,60,60
1650371213661,COGS 101C,A01,083625,Delgado; Tania,17,0,30,13
1650371219689,COGS 107A,A01,083627,Boyle; Mary E. T.,0,10,60,60
1650371225715,COGS 118A,A01,083075,Staff,4,0,60,56
1650371231741,CSE 3,A50,083646,Miranda; Gregory Joseph,21,0,38,17
1650371231741,CSE 3,A51,083647,Miranda; Gregory Joseph,37,0,37,0
1650371237767,CSE 8A,A50,083650,Miranda; Gregory Joseph,0,28,40,40
1650371243796,CSE 11,A01,083080,Cao; Yingjun,0,88,40,40
1650371249830,CSE 12,A01,083652,Staff,0,12,100,100
1650371255855,CSE 15L,A01,083654,Staff,0,1,50,50
1650371255855,CSE 15L,A02,083655,Staff,3,0,50,47
1650371261880,CSE 20,A01,083657,Staff,52,0,80,28
1650371267905,CSE 30,A01,083084,Eldon; John,0,76,40,40
1650371273937,CSE 100,A01,083659,Cao; Yingjun,0,66,50,50
1650371279963,CSE 134B,A01,083661,Powell; Thomas Allan,0,31,65,65
1650371285993,CSE 140,A01,083663,Staff,0,0,75,75
1650371292017,CSE 140L,A01,083088,Eldon; John,0,7,75,75
1650371298054,CSE 175,A01,083665,Kumar; Rakesh,8,0,25,17
1650371304081,CSE 190,A00,092507,Dubnov; Shlomo,14,0,20,6
1650371310109,ECE 45,A01,083139,Staff,0,17,40,40
1650371316144,ECE 65,A50,083695,Staff,0,5,30,30
1650371322175,ECE 109,A01,091882,Touri; Behrouz,40,0,70,30
1650371328203,ECE 180,A00,083140,Abi Samra; Nicholas Camill,23,0,30,7
1650371328203,ECE 180,B00,083141,Abi Samra; Nicholas Camill,5,0,30,25
1650371334235,MATH 10A,A01,083735,Patchell; Gregory David,7,0,30,23
1650371334235,MATH 10A,A02,083736,Patchell; Gregory David,28,0,30,2
1650371334235,MATH 10A,A03,083737,Patchell; Gregory David,25,0,30,5
1650371340268,MATH 10B,A01,083207,Staff,0,7,30,30
1650371340268,MATH 10B,A02,083208,Staff,0,6,30,30
1650371340268,MATH 10B,B01,083739,Staff,17,0,30,13
1650371340268,MATH 10B,B02,083740,Staff,28,0,30,2
1650371346298,MATH 18,A01,083743,Staff,3,0,30,27
1650371346298,MATH 18,A02,083744,Staff,27,0,30,3
1650371346298,MATH 18,A03,083745,Staff,22,0,30,8
1650371346298,MATH 18,A04,083746,Staff,27,0,30,3
1650371346298,MATH 18,B01,083748,Staff,0,11,30,30
1650371346298,MATH 18,B02,083749,Staff,0,11,30,30
1650371346298,MATH 18,B03,083750,Staff,0,11,30,30
1650371346298,MATH 18,B04,083751,Staff,0,9,30,30
1650371352323,MATH 20A,A01,083754,Staff,26,0,40,14
1650371358349,MATH 20B,A01,083756,Staff,0,8,30,30
1650371358349,MATH 20B,A02,083757,Staff,0,8,30,30
1650371364375,MATH 20C,A01,083760,Staff,0,14,30,30
1650371364375,MATH 20C,A02,083761,Staff,0,15,30,30
1650371364375,MATH 20C,B01,083762,Staff,13,0,30,17
1650371364375,MATH 20C,B02,083763,Staff,28,0,30,2
1650371370402,MATH 20D,A01,083765,Staff,0,1,30,30
1650371370402,MATH 20D,A02,083766,Staff,7,0,30,23
1650371370402,MATH 20D,A03,083767,Staff,26,0,30,4
1650371376437,MATH 20E,A01,083771,Staff,5,0,30,25
1650371376437,MATH 20E,A02,083772,Staff,19,0,30,11
1650371376437,MATH 20E,B01,083773,Staff,0,0,30,30
1650371376437,MATH 20E,B02,083774,Staff,12,0,30,18
1650371382463,MATH 103A,A01,083777,Staff,0,11,30,30
1650371382463,MATH 103A,A02,083778,Staff,0,12,30,30
1650371382463,MATH 103A,B01,083779,Staff,0,13,30,30
1650371382463,MATH 103A,B02,083780,Staff,0,11,30,30
1650371388488,MATH 105,A01,085443,Staff,0,21,30,30
1650371394513,MATH 109,A01,083213,Anzaldo; Leesa B,0,6,30,30
1650371394513,MATH 109,A02,083214,Anzaldo; Leesa B,0,7,30,30
1650371394513,MATH 109,B01,083215,Anzaldo; Leesa B,0,5,30,30
1650371394513,MATH 109,B02,083216,Anzaldo; Leesa B,0,5,30,30
1650371400543,MATH 142A,A01,083219,Chow; Bennett,0,14,30,30
1650371400543,MATH 142A,A02,083220,Chow; Bennett,0,12,30,30
1650371400543,MATH 142A,B01,083221,Chow; Bennett,0,12,30,30
1650371400543,MATH 142A,B02,083222,Chow; Bennett,0,12,30,30
1650371406574,MATH 193A,A01,083224,Staff,0,5,30,30
1650371406574,MATH 193A,A02,083225,Staff,0,5,30,30
1650371406574,MATH 193A,A03,083781,Staff,0,4,30,30
1650371406574,MATH 193A,A04,083782,Staff,0,3,30,30
1650371412601,MATH 197,001,091859,McAuley; Julian John,9998,0,9999,1
1650371418665,COGS 9,A01,083615,Staff,0,14,60,60
1650371424692,COGS 11,A01,083617,Boyle; Mary E. T.,22,0,40,18
1650371430734,COGS 13,A01,083071,Staff,0,32,40,40
1650371436760,COGS 14A,A01,092681,Staff,0,21,100,100
1650371442790,COGS 14B,A01,083073,Cheng; Tzu-Han,0,10,50,50
1650371448828,COGS 17,A01,092677,Staff,24,0,75,51
1650371454862,COGS 100,A01,083619,Staff,0,24,60,60
1650371460892,COGS 101A,A01,083621,Davis; Joshua Daniel,0,21,60,60
1650371466917,COGS 101B,A01,091572,Staff,0,0,60,60
1650371472952,COGS 101C,A01,083625,Delgado; Tania,17,0,30,13
1650371478978,COGS 107A,A01,083627,Boyle; Mary E. T.,0,10,60,60
1650371485008,COGS 118A,A01,083075,Staff,4,0,60,56
1650371491036,CSE 3,A50,083646,Miranda; Gregory Joseph,21,0,38,17
1650371491036,CSE 3,A51,083647,Miranda; Gregory Joseph,37,0,37,0
1650371497089,CSE 8A,A50,083650,Miranda; Gregory Joseph,0,28,40,40
1650371503116,CSE 11,A01,083080,Cao; Yingjun,0,88,40,40
1650371509145,CSE 12,A01,083652,Staff,0,12,100,100
1650371515174,CSE 15L,A01,083654,Staff,0,1,50,50
1650371515174,CSE 15L,A02,083655,Staff,3,0,50,47
1650371521205,CSE 20,A01,083657,Staff,52,0,80,28
1650371527234,CSE 30,A01,083084,Eldon; John,0,76,40,40
1650371533287,CSE 100,A01,083659,Cao; Yingjun,0,66,50,50
1650371539318,CSE 134B,A01,083661,Powell; Thomas Allan,0,31,65,65
1650371545342,CSE 140,A01,083663,Staff,0,0,75,75
1650371551371,CSE 140L,A01,083088,Eldon; John,0,7,75,75
1650371557401,CSE 175,A01,083665,Kumar; Rakesh,8,0,25,17
1650371563437,CSE 190,A00,092507,Dubnov; Shlomo,14,0,20,6
1650371569466,ECE 45,A01,083139,Staff,0,17,40,40
1650371575495,ECE 65,A50,083695,Staff,0,5,30,30
1650371581529,ECE 109,A01,091882,Touri; Behrouz,40,0,70,30
1650371587556,ECE 180,A00,083140,Abi Samra; Nicholas Camill,23,0,30,7
1650371587556,ECE 180,B00,083141,Abi Samra; Nicholas Camill,5,0,30,25
1650371593587,MATH 10A,A01,083735,Patchell; Gregory David,7,0,30,23
1650371593587,MATH 10A,A02,083736,Patchell; Gregory David,28,0,30,2
1650371593587,MATH 10A,A03,083737,Patchell; Gregory David,25,0,30,5
1650371599616,MATH 10B,A01,083207,Staff,0,7,30,30
1650371599616,MATH 10B,A02,083208,Staff,0,6,30,30
1650371599616,MATH 10B,B01,083739,Staff,17,0,30,13
1650371599616,MATH 10B,B02,083740,Staff,28,0,30,2
1650371605647,MATH 18,A01,083743,Staff,3,0,30,27
1650371605647,MATH 18,A02,083744,Staff,27,0,30,3
1650371605647,MATH 18,A03,083745,Staff,22,0,30,8
1650371605647,MATH 18,A04,083746,Staff,27,0,30,3
1650371605647,MATH 18,B01,083748,Staff,0,11,30,30
1650371605647,MATH 18,B02,083749,Staff,0,11,30,30
1650371605647,MATH 18,B03,083750,Staff,0,11,30,30
1650371605647,MATH 18,B04,083751,Staff,0,9,30,30
1650371611678,MATH 20A,A01,083754,Staff,26,0,40,14
1650371617711,MATH 20B,A01,083756,Staff,0,8,30,30
1650371617711,MATH 20B,A02,083757,Staff,0,8,30,30
1650371623744,MATH 20C,A01,083760,Staff,0,14,30,30
1650371623744,MATH 20C,A02,083761,Staff,0,15,30,30
1650371623744,MATH 20C,B01,083762,Staff,13,0,30,17
1650371623744,MATH 20C,B02,083763,Staff,28,0,30,2
1650371629775,MATH 20D,A01,083765,Staff,0,1,30,30
1650371629775,MATH 20D,A02,083766,Staff,7,0,30,23
1650371629775,MATH 20D,A03,083767,Staff,26,0,30,4
1650371635833,MATH 20E,A01,083771,Staff,5,0,30,25
1650371635833,MATH 20E,A02,083772,Staff,19,0,30,11
1650371635833,MATH 20E,B01,083773,Staff,0,0,30,30
1650371635833,MATH 20E,B02,083774,Staff,12,0,30,18
1650371641866,MATH 103A,A01,083777,Staff,0,11,30,30
1650371641866,MATH 103A,A02,083778,Staff,0,12,30,30
1650371641866,MATH 103A,B01,083779,Staff,0,13,30,30
1650371641866,MATH 103A,B02,083780,Staff,0,11,30,30
1650371647917,MATH 105,A01,085443,Staff,0,21,30,30
1650371653952,MATH 109,A01,083213,Anzaldo; Leesa B,0,6,30,30
1650371653952,MATH 109,A02,083214,Anzaldo; Leesa B,0,7,30,30
1650371653952,MATH 109,B01,083215,Anzaldo; Leesa B,0,5,30,30
1650371653952,MATH 109,B02,083216,Anzaldo; Leesa B,0,5,30,30
1650371659984,MATH 142A,A01,083219,Chow; Bennett,0,14,30,30
1650371659984,MATH 142A,A02,083220,Chow; Bennett,0,12,30,30
1650371659984,MATH 142A,B01,083221,Chow; Bennett,0,12,30,30
1650371659984,MATH 142A,B02,083222,Chow; Bennett,0,12,30,30
1650371666016,MATH 193A,A01,083224,Staff,0,5,30,30
1650371666016,MATH 193A,A02,083225,Staff,0,5,30,30
1650371666016,MATH 193A,A03,083781,Staff,0,4,30,30
1650371666016,MATH 193A,A04,083782,Staff,0,3,30,30
1650371672058,MATH 197,001,091859,McAuley; Julian John,9998,0,9999,1
1650371678225,COGS 9,A01,083615,Staff,0,14,60,60
1650371684251,COGS 11,A01,083617,Boyle; Mary E. T.,22,0,40,18
1650371690279,COGS 13,A01,083071,Staff,0,32,40,40
1650371696310,COGS 14A,A01,092681,Staff,0,21,100,100
1650371702338,COGS 14B,A01,083073,Cheng; Tzu-Han,0,10,50,50
1650371708370,COGS 17,A01,092677,Staff,24,0,75,51
1650371714399,COGS 100,A01,083619,Staff,0,24,60,60
1650371720445,COGS 101A,A01,083621,Davis; Joshua Daniel,0,21,60,60
1650371726475,COGS 101B,A01,091572,Staff,0,0,60,60
1650371732508,COGS 101C,A01,083625,Delgado; Tania,17,0,30,13
1650371738555,COGS 107A,A01,083627,Boyle; Mary E. T.,0,10,60,60
1650371744591,COGS 118A,A01,083075,Staff,4,0,60,56
1650371750619,CSE 3,A50,083646,Miranda; Gregory Joseph,21,0,38,17
1650371750619,CSE 3,A51,083647,Miranda; Gregory Joseph,37,0,37,0
1650371756657,CSE 8A,A50,083650,Miranda; Gregory Joseph,0,28,40,40
1650371762684,CSE 11,A01,083080,Cao; Yingjun,0,88,40,40
1650371768710,CSE 12,A01,083652,Staff,0,12,100,100
1650371774737,CSE 15L,A01,083654,Staff,0,1,50,50
1650371774737,CSE 15L,A02,083655,Staff,3,0,50,47
1650371780770,CSE 20,A01,083657,Staff,52,0,80,28
1650371786795,CSE 30,A01,083084,Eldon; John,0,76,40,40
1650371792827,CSE 100,A01,083659,Cao; Yingjun,0,66,50,50
1650371798877,CSE 134B,A01,083661,Powell; Thomas Allan,0,31,65,65
1650371804904,CSE 140,A01,083663,Staff,0,0,75,75
1650371810930,CSE 140L,A01,083088,Eldon; John,0,7,75,75
1650371816958,CSE 175,A01,083665,Kumar; Rakesh,8,0,25,17
1650371822997,CSE 190,A00,092507,Dubnov; Shlomo,14,0,20,6
1650371829039,ECE 45,A01,083139,Staff,0,17,40,40
1650371835081,ECE 65,A50,083695,Staff,0,5,30,30
1650371841108,ECE 109,A01,091882,Touri; Behrouz,40,0,70,30
1650371847140,ECE 180,A00,083140,Abi Samra; Nicholas Camill,23,0,30,7
1650371847140,ECE 180,B00,083141,Abi Samra; Nicholas Camill,5,0,30,25
1650371853175,MATH 10A,A01,083735,Patchell; Gregory David,7,0,30,23
1650371853175,MATH 10A,A02,083736,Patchell; Gregory David,28,0,30,2
1650371853175,MATH 10A,A03,083737,Patchell; Gregory David,25,0,30,5
1650371859203,MATH 10B,A01,083207,Staff,0,7,30,30
1650371859203,MATH 10B,A02,083208,Staff,0,6,30,30
1650371859203,MATH 10B,B01,083739,Staff,17,0,30,13
1650371859203,MATH 10B,B02,083740,Staff,28,0,30,2
1650371865232,MATH 18,A01,083743,Staff,3,0,30,27
1650371865232,MATH 18,A02,083744,Staff,27,0,30,3
1650371865232,MATH 18,A03,083745,Staff,22,0,30,8
1650371865232,MATH 18,A04,083746,Staff,27,0,30,3
1650371865232,MATH 18,B01,083748,Staff,0,11,30,30
1650371865232,MATH 18,B02,083749,Staff,0,11,30,30
1650371865232,MATH 18,B03,083750,Staff,0,11,30,30
1650371865232,MATH 18,B04,083751,Staff,0,9,30,30
1650371871261,MATH 20A,A01,083754,Staff,26,0,40,14
1650371877299,MATH 20B,A01,083756,Staff,0,8,30,30
1650371877299,MATH 20B,A02,083757,Staff,0,8,30,30
1650371883329,MATH 20C,A01,083760,Staff,0,14,30,30
1650371883329,MATH 20C,A02,083761,Staff,0,15,30,30
1650371883329,MATH 20C,B01,083762,Staff,13,0,30,17
1650371883329,MATH 20C,B02,083763,Staff,28,0,30,2
1650371889360,MATH 20D,A01,083765,Staff,0,1,30,30
1650371889360,MATH 20D,A02,083766,Staff,7,0,30,23
1650371889360,MATH 20D,A03,083767,Staff,26,0,30,4
1650371895398,MATH 20E,A01,083771,Staff,5,0,30,25
1650371895398,MATH 20E,A02,083772,Staff,19,0,30,11
1650371895398,MATH 20E,B01,083773,Staff,0,0,30,30
1650371895398,MATH 20E,B02,083774,Staff,12,0,30,18
1650371901424,MATH 103A,A01,083777,Staff,0,11,30,30
1650371901424,MATH 103A,A02,083778,Staff,0,12,30,30
1650371901424,MATH 103A,B01,083779,Staff,0,13,30,30
1650371901424,MATH 103A,B02,083780,Staff,0,11,30,30
1650371907466,MATH 105,A01,085443,Staff,0,21,30,30
1650371913498,MATH 109,A01,083213,Anzaldo; Leesa B,0,6,30,30
1650371913498,MATH 109,A02,083214,Anzaldo; Leesa B,0,7,30,30
1650371913498,MATH 109,B01,083215,Anzaldo; Leesa B,0,5,30,30
1650371913498,MATH 109,B02,083216,Anzaldo; Leesa B,0,5,30,30
1650371919530,MATH 142A,A01,083219,Chow; Bennett,0,14,30,30
1650371919530,MATH 142A,A02,083220,Chow; Bennett,0,12,30,30
1650371919530,MATH 142A,B01,083221,Chow; Bennett,0,12,30,30
1650371919530,MATH 142A,B02,083222,Chow; Bennett,0,12,30,30
1650371925557,MATH 193A,A01,083224,Staff,0,5,30,30
1650371925557,MATH 193A,A02,083225,Staff,0,5,30,30
1650371925557,MATH 193A,A03,083781,Staff,0,4,30,30
1650371925557,MATH 193A,A04,083782,Staff,0,3,30,30
1650371931586,MATH 197,001,091859,McAuley; Julian John,9998,0,9999,1
1650371937664,COGS 9,A01,083615,Staff,0,14,60,60
1650371943693,COGS 11,A01,083617,Boyle; Mary E. T.,22,0,40,18
1650371949723,COGS 13,A01,083071,Staff,0,32,40,40
1650371955777,COGS 14A,A01,092681,Staff,0,21,100,100
1650371961804,COGS 14B,A01,083073,Cheng; Tzu-Han,0,10,50,50
1650371967829,COGS 17,A01,092677,Staff,24,0,75,51
1650371973854,COGS 100,A01,083619,Staff,0,24,60,60
1650371979907,COGS 101A,A01,083621,Davis; Joshua Daniel,0,21,60,60
1650371985940,COGS 101B,A01,091572,Staff,0,0,60,60
1650371991965,COGS 101C,A01,083625,Delgado; Tania,17,0,30,13
1650371997992,COGS 107A,A01,083627,Boyle; Mary E. T.,0,10,60,60
1650372004020,COGS 118A,A01,083075,Staff,4,0,60,56
1650372010053,CSE 3,A50,083646,Miranda; Gregory Joseph,21,0,38,17
1650372010053,CSE 3,A51,083647,Miranda; Gregory Joseph,37,0,37,0
1650372016080,CSE 8A,A50,083650,Miranda; Gregory Joseph,0,28,40,40
1650372022108,CSE 11,A01,083080,Cao; Yingjun,0,88,40,40
1650372028134,CSE 12,A01,083652,Staff,0,12,100,100
1650372034164,CSE 15L,A01,083654,Staff,0,1,50,50
1650372034164,CSE 15L,A02,083655,Staff,3,0,50,47
1650372040193,CSE 20,A01,083657,Staff,52,0,80,28
1650372046230,CSE 30,A01,083084,Eldon; John,0,76,40,40
1650372052254,CSE 100,A01,083659,Cao; Yingjun,0,66,50,50
1650372058292,CSE 134B,A01,083661,Powell; Thomas Allan,0,31,65,65
1650372064317,CSE 140,A01,083663,Staff,0,0,75,75
1650372070347,CSE 140L,A01,083088,Eldon; John,0,7,75,75
1650372076396,CSE 175,A01,083665,Kumar; Rakesh,8,0,25,17
1650372082441,CSE 190,A00,092507,Dubnov; Shlomo,14,0,20,6
1650372088473,ECE 45,A01,083139,Staff,0,17,40,40
1650372094525,ECE 65,A50,083695,Staff,0,5,30,30
1650372100568,ECE 109,A01,091882,Touri; Behrouz,40,0,70,30
1650372106603,ECE 180,A00,083140,Abi Samra; Nicholas Camill,23,0,30,7
1650372106603,ECE 180,B00,083141,Abi Samra; Nicholas Camill,5,0,30,25
1650372112637,MATH 10A,A01,083735,Patchell; Gregory David,7,0,30,23
1650372112637,MATH 10A,A02,083736,Patchell; Gregory David,28,0,30,2
1650372112637,MATH 10A,A03,083737,Patchell; Gregory David,25,0,30,5
1650372118684,MATH 10B,A01,083207,Staff,0,7,30,30
1650372118684,MATH 10B,A02,083208,Staff,0,6,30,30
1650372118684,MATH 10B,B01,083739,Staff,17,0,30,13
1650372118684,MATH 10B,B02,083740,Staff,28,0,30,2
1650372124725,MATH 18,A01,083743,Staff,3,0,30,27
1650372124725,MATH 18,A02,083744,Staff,27,0,30,3
1650372124725,MATH 18,A03,083745,Staff,22,0,30,8
1650372124725,MATH 18,A04,083746,Staff,27,0,30,3
1650372124725,MATH 18,B01,083748,Staff,0,11,30,30
1650372124725,MATH 18,B02,083749,Staff,0,11,30,30
1650372124725,MATH 18,B03,083750,Staff,0,11,30,30
1650372124725,MATH 18,B04,083751,Staff,0,9,30,30
1650372130753,MATH 20A,A01,083754,Staff,26,0,40,14
1650372136780,MATH 20B,A01,083756,Staff,0,8,30,30
1650372136780,MATH 20B,A02,083757,Staff,0,8,30,30
1650372142817,MATH 20C,A01,083760,Staff,0,14,30,30
1650372142817,MATH 20C,A02,083761,Staff,0,15,30,30
1650372142817,MATH 20C,B01,083762,Staff,13,0,30,17
1650372142817,MATH 20C,B02,083763,Staff,28,0,30,2
1650372148857,MATH 20D,A01,083765,Staff,0,1,30,30
1650372148857,MATH 20D,A02,083766,Staff,7,0,30,23
1650372148857,MATH 20D,A03,083767,Staff,26,0,30,4
1650372154884,MATH 20E,A01,083771,Staff,5,0,30,25
1650372154884,MATH 20E,A02,083772,Staff,19,0,30,11
1650372154884,MATH 20E,B01,083773,Staff,0,0,30,30
1650372154884,MATH 20E,B02,083774,Staff,12,0,30,18
1650372160931,MATH 103A,A01,083777,Staff,0,11,30,30
1650372160931,MATH 103A,A02,083778,Staff,0,12,30,30
1650372160931,MATH 103A,B01,083779,Staff,0,13,30,30
1650372160931,MATH 103A,B02,083780,Staff,0,11,30,30
1650372166969,MATH 105,A01,085443,Staff,0,21,30,30
1650372172999,MATH 109,A01,083213,Anzaldo; Leesa B,0,6,30,30
1650372172999,MATH 109,A02,083214,Anzaldo; Leesa B,0,7,30,30
1650372172999,MATH 109,B01,083215,Anzaldo; Leesa B,0,5,30,30
1650372172999,MATH 109,B02,083216,Anzaldo; Leesa B,0,5,30,30
1650372179023,MATH 142A,A01,083219,Chow; Bennett,0,14,30,30
1650372179023,MATH 142A,A02,083220,Chow; Bennett,0,12,30,30
1650372179023,MATH 142A,B01,083221,Chow; Bennett,0,12,30,30
1650372179023,MATH 142A,B02,083222,Chow; Bennett,0,12,30,30
1650372185051,MATH 193A,A01,083224,Staff,0,5,30,30
1650372185051,MATH 193A,A02,083225,Staff,0,5,30,30
1650372185051,MATH 193A,A03,083781,Staff,0,4,30,30
1650372185051,MATH 193A,A04,083782,Staff,0,3,30,30
1650372191075,MATH 197,001,091859,McAuley; Julian John,9998,0,9999,1
1650372197146,COGS 9,A01,083615,Staff,0,14,60,60
1650372203187,COGS 11,A01,083617,Boyle; Mary E. T.,22,0,40,18
1650372209214,COGS 13,A01,083071,Staff,0,32,40,40
1650372215237,COGS 14A,A01,092681,Staff,0,21,100,100
1650372221263,COGS 14B,A01,083073,Cheng; Tzu-Han,0,10,50,50
1650372227288,COGS 17,A01,092677,Staff,24,0,75,51
1650372233336,COGS 100,A01,083619,Staff,0,24,60,60
1650372239362,COGS 101A,A01,083621,Davis; Joshua Daniel,0,21,60,60
1650372245387,COGS 101B,A01,091572,Staff,0,0,60,60
1650372251417,COGS 101C,A01,083625,Delgado; Tania,17,0,30,13
1650372257456,COGS 107A,A01,083627,Boyle; Mary E. T.,0,10,60,60
1650372263486,COGS 118A,A01,083075,Staff,4,0,60,56
1650372269636,CSE 3,A50,083646,Miranda; Gregory Joseph,21,0,38,17
1650372269636,CSE 3,A51,083647,Miranda; Gregory Joseph,37,0,37,0
1650372275659,CSE 8A,A50,083650,Miranda; Gregory Joseph,0,28,40,40
1650372281710,CSE 11,A01,083080,Cao; Yingjun,0,88,40,40
1650372287734,CSE 12,A01,083652,Staff,0,12,100,100
1650372293774,CSE 15L,A01,083654,Staff,0,1,50,50
1650372293774,CSE 15L,A02,083655,Staff,3,0,50,47
1650372299798,CSE 20,A01,083657,Staff,52,0,80,28
1650372305822,CSE 30,A01,083084,Eldon; John,0,76,40,40
1650372311848,CSE 100,A01,083659,Cao; Yingjun,0,66,50,50
1650372317872,CSE 134B,A01,083661,Powell; Thomas Allan,0,31,65,65
1650372323910,CSE 140,A01,083663,Staff,0,0,75,75
1650372329936,CSE 140L,A01,083088,Eldon; John,0,7,75,75
1650372335975,CSE 175,A01,083665,Kumar; Rakesh,8,0,25,17
1650372342019,CSE 190,A00,092507,Dubnov; Shlomo,14,0,20,6
1650372348043,ECE 45,A01,083139,Staff,0,17,40,40
1650372354071,ECE 65,A50,083695,Staff,0,5,30,30
1650372360097,ECE 109,A01,091882,Touri; Behrouz,40,0,70,30
1650372366129,ECE 180,A00,083140,Abi Samra; Nicholas Camill,23,0,30,7
1650372366129,ECE 180,B00,083141,Abi Samra; Nicholas Camill,5,0,30,25
1650372372153,MATH 10A,A01,083735,Patchell; Gregory David,7,0,30,23
1650372372153,MATH 10A,A02,083736,Patchell; Gregory David,28,0,30,2
1650372372153,MATH 10A,A03,083737,Patchell; Gregory David,25,0,30,5
1650372378183,MATH 10B,A01,083207,Staff,0,7,30,30
1650372378183,MATH 10B,A02,083208,Staff,0,6,30,30
1650372378183,MATH 10B,B01,083739,Staff,17,0,30,13
1650372378183,MATH 10B,B02,083740,Staff,28,0,30,2
1650372384206,MATH 18,A01,083743,Staff,3,0,30,27
1650372384206,MATH 18,A02,083744,Staff,27,0,30,3
1650372384206,MATH 18,A03,083745,Staff,22,0,30,8
1650372384206,MATH 18,A04,083746,Staff,27,0,30,3
1650372384206,MATH 18,B01,083748,Staff,0,11,30,30
1650372384206,MATH 18,B02,083749,Staff,0,11,30,30
1650372384206,MATH 18,B03,083750,Staff,0,11,30,30
1650372384206,MATH 18,B04,083751,Staff,0,9,30,30
1650372390246,MATH 20A,A01,083754,Staff,26,0,40,14
1650372396293,MATH 20B,A01,083756,Staff,0,8,30,30
1650372396293,MATH 20B,A02,083757,Staff,0,8,30,30
1650372402323,MATH 20C,A01,083760,Staff,0,14,30,30
1650372402323,MATH 20C,A02,083761,Staff,0,15,30,30
1650372402323,MATH 20C,B01,083762,Staff,13,0,30,17
1650372402323,MATH 20C,B02,083763,Staff,28,0,30,2
1650372408364,MATH 20D,A01,083765,Staff,0,1,30,30
1650372408364,MATH 20D,A02,083766,Staff,7,0,30,23
1650372408364,MATH 20D,A03,083767,Staff,26,0,30,4
1650372414389,MATH 20E,A01,083771,Staff,5,0,30,25
1650372414389,MATH 20E,A02,083772,Staff,19,0,30,11
1650372414389,MATH 20E,B01,083773,Staff,0,0,30,30
1650372414389,MATH 20E,B02,083774,Staff,12,0,30,18
1650372420418,MATH 103A,A01,083777,Staff,0,11,30,30
1650372420418,MATH 103A,A02,083778,Staff,0,12,30,30
1650372420418,MATH 103A,B01,083779,Staff,0,13,30,30
1650372420418,MATH 103A,B02,083780,Staff,0,11,30,30
1650372426442,MATH 105,A01,085443,Staff,0,21,30,30
1650372432473,MATH 109,A01,083213,Anzaldo; Leesa B,0,6,30,30
1650372432473,MATH 109,A02,083214,Anzaldo; Leesa B,0,7,30,30
1650372432473,MATH 109,B01,083215,Anzaldo; Leesa B,0,5,30,30
1650372432473,MATH 109,B02,083216,Anzaldo; Leesa B,0,5,30,30
1650372438508,MATH 142A,A01,083219,Chow; Bennett,0,14,30,30
1650372438508,MATH 142A,A02,083220,Chow; Bennett,0,12,30,30
1650372438508,MATH 142A,B01,083221,Chow; Bennett,0,12,30,30
1650372438508,MATH 142A,B02,083222,Chow; Bennett,0,12,30,30
1650372444543,MATH 193A,A01,083224,Staff,0,5,30,30
1650372444543,MATH 193A,A02,083225,Staff,0,5,30,30
1650372444543,MATH 193A,A03,083781,Staff,0,4,30,30
1650372444543,MATH 193A,A04,083782,Staff,0,3,30,30
1650372450566,MATH 197,001,091859,McAuley; Julian John,9998,0,9999,1
1650372456630,COGS 9,A01,083615,Staff,0,14,60,60
1650372462677,COGS 11,A01,083617,Boyle; Mary E. T.,22,0,40,18
1650372468706,COGS 13,A01,083071,Staff,0,32,40,40
1650372474741,COGS 14A,A01,092681,Staff,0,21,100,100
1650372480784,COGS 14B,A01,083073,Cheng; Tzu-Han,0,10,50,50
1650372486820,COGS 17,A01,092677,Staff,24,0,75,51
1650372492861,COGS 100,A01,083619,Staff,0,24,60,60
1650372498888,COGS 101A,A01,083621,Davis; Joshua Daniel,0,21,60,60
1650372504914,COGS 101B,A01,091572,Staff,0,0,60,60
1650372510940,COGS 101C,A01,083625,Delgado; Tania,17,0,30,13
1650372516978,COGS 107A,A01,083627,Boyle; Mary E. T.,0,10,60,60
1650372523002,COGS 118A,A01,083075,Staff,4,0,60,56
1650372529041,CSE 3,A50,083646,Miranda; Gregory Joseph,21,0,38,17
1650372529041,CSE 3,A51,083647,Miranda; Gregory Joseph,37,0,37,0
1650372536812,CSE 8A,A50,083650,Miranda; Gregory Joseph,0,28,40,40
1650372542854,CSE 11,A01,083080,Cao; Yingjun,0,88,40,40
1650372548878,CSE 12,A01,083652,Staff,0,12,100,100
1650372554913,CSE 15L,A01,083654,Staff,0,1,50,50
1650372554913,CSE 15L,A02,083655,Staff,3,0,50,47
1650372560948,CSE 20,A01,083657,Staff,52,0,80,28
1650372566985,CSE 30,A01,083084,Eldon; John,0,76,40,40
1650372573034,CSE 100,A01,083659,Cao; Yingjun,0,66,50,50
1650372579062,CSE 134B,A01,083661,Powell; Thomas Allan,0,31,65,65
1650372585092,CSE 140,A01,083663,Staff,0,0,75,75
1650372591124,CSE 140L,A01,083088,Eldon; John,0,7,75,75
1650372597157,CSE 175,A01,083665,Kumar; Rakesh,8,0,25,17
1650372603187,CSE 190,A00,092507,Dubnov; Shlomo,14,0,20,6
1650372609215,ECE 45,A01,083139,Staff,0,17,40,40
1650372615251,ECE 65,A50,083695,Staff,0,5,30,30
1650372621277,ECE 109,A01,091882,Touri; Behrouz,40,0,70,30
1650372627302,ECE 180,A00,083140,Abi Samra; Nicholas Camill,23,0,30,7
1650372627302,ECE 180,B00,083141,Abi Samra; Nicholas Camill,5,0,30,25
1650372633332,MATH 10A,A01,083735,Patchell; Gregory David,7,0,30,23
1650372633332,MATH 10A,A02,083736,Patchell; Gregory David,28,0,30,2
1650372633332,MATH 10A,A03,083737,Patchell; Gregory David,25,0,30,5
1650372639370,MATH 10B,A01,083207,Staff,0,7,30,30
1650372639370,MATH 10B,A02,083208,Staff,0,6,30,30
1650372639370,MATH 10B,B01,083739,Staff,17,0,30,13
1650372639370,MATH 10B,B02,083740,Staff,28,0,30,2
1650372645399,MATH 18,A01,083743,Staff,3,0,30,27
1650372645399,MATH 18,A02,083744,Staff,27,0,30,3
1650372645399,MATH 18,A03,083745,Staff,22,0,30,8
1650372645399,MATH 18,A04,083746,Staff,27,0,30,3
1650372645399,MATH 18,B01,083748,Staff,0,11,30,30
1650372645399,MATH 18,B02,083749,Staff,0,11,30,30
1650372645399,MATH 18,B03,083750,Staff,0,11,30,30
1650372645399,MATH 18,B04,083751,Staff,0,9,30,30
1650372651424,MATH 20A,A01,083754,Staff,26,0,40,14
1650372657468,MATH 20B,A01,083756,Staff,0,8,30,30
1650372657468,MATH 20B,A02,083757,Staff,0,8,30,30
1650372663498,MATH 20C,A01,083760,Staff,0,14,30,30
1650372663498,MATH 20C,A02,083761,Staff,0,15,30,30
1650372663498,MATH 20C,B01,083762,Staff,13,0,30,17
1650372663498,MATH 20C,B02,083763,Staff,28,0,30,2
1650372669520,MATH 20D,A01,083765,Staff,0,1,30,30
1650372669520,MATH 20D,A02,083766,Staff,7,0,30,23
1650372669520,MATH 20D,A03,083767,Staff,26,0,30,4
1650372675546,MATH 20E,A01,083771,Staff,5,0,30,25
1650372675546,MATH 20E,A02,083772,Staff,19,0,30,11
1650372675546,MATH 20E,B01,083773,Staff,0,0,30,30
1650372675546,MATH 20E,B02,083774,Staff,12,0,30,18
1650372681574,MATH 103A,A01,083777,Staff,0,11,30,30
1650372681574,MATH 103A,A02,083778,Staff,0,12,30,30
1650372681574,MATH 103A,B01,083779,Staff,0,13,30,30
1650372681574,MATH 103A,B02,083780,Staff,0,11,30,30
1650372687602,MATH 105,A01,085443,Staff,0,21,30,30
1650372693628,MATH 109,A01,083213,Anzaldo; Leesa B,0,6,30,30
1650372693628,MATH 109,A02,083214,Anzaldo; Leesa B,0,7,30,30
1650372693628,MATH 109,B01,083215,Anzaldo; Leesa B,0,5,30,30
1650372693628,MATH 109,B02,083216,Anzaldo; Leesa B,0,5,30,30
1650372699655,MATH 142A,A01,083219,Chow; Bennett,0,14,30,30
1650372699655,MATH 142A,A02,083220,Chow; Bennett,0,12,30,30
1650372699655,MATH 142A,B01,083221,Chow; Bennett,0,12,30,30
1650372699655,MATH 142A,B02,083222,Chow; Bennett,0,12,30,30
1650372705688,MATH 193A,A01,083224,Staff,0,5,30,30
1650372705688,MATH 193A,A02,083225,Staff,0,5,30,30
1650372705688,MATH 193A,A03,083781,Staff,0,4,30,30
1650372705688,MATH 193A,A04,083782,Staff,0,3,30,30
1650372711716,MATH 197,001,091859,McAuley; Julian John,9998,0,9999,1
1650372717830,COGS 9,A01,083615,Staff,0,14,60,60
1650372723857,COGS 11,A01,083617,Boyle; Mary E. T.,22,0,40,18
1650372729887,COGS 13,A01,083071,Staff,0,32,40,40
1650372735912,COGS 14A,A01,092681,Staff,0,21,100,100
1650372741942,COGS 14B,A01,083073,Cheng; Tzu-Han,0,10,50,50
1650372747977,COGS 17,A01,092677,Staff,24,0,75,51
1650372754024,COGS 100,A01,083619,Staff,0,24,60,60
1650372760056,COGS 101A,A01,083621,Davis; Joshua Daniel,0,21,60,60
1650372766095,COGS 101B,A01,091572,Staff,0,0,60,60
1650372772134,COGS 101C,A01,083625,Delgado; Tania,17,0,30,13
1650372778170,COGS 107A,A01,083627,Boyle; Mary E. T.,0,10,60,60
1650372784196,COGS 118A,A01,083075,Staff,4,0,60,56
1650372790240,CSE 3,A50,083646,Miranda; Gregory Joseph,21,0,38,17
1650372790240,CSE 3,A51,083647,Miranda; Gregory Joseph,37,0,37,0
1650372796272,CSE 8A,A50,083650,Miranda; Gregory Joseph,0,28,40,40
1650372802303,CSE 11,A01,083080,Cao; Yingjun,0,88,40,40
1650372808351,CSE 12,A01,083652,Staff,0,12,100,100
1650372814382,CSE 15L,A01,083654,Staff,0,1,50,50
1650372814382,CSE 15L,A02,083655,Staff,3,0,50,47
1650372820415,CSE 20,A01,083657,Staff,52,0,80,28
1650372826443,CSE 30,A01,083084,Eldon; John,0,76,40,40
1650372832493,CSE 100,A01,083659,Cao; Yingjun,0,66,50,50
1650372838536,CSE 134B,A01,083661,Powell; Thomas Allan,0,31,65,65
1650372844561,CSE 140,A01,083663,Staff,0,0,75,75
1650372850589,CSE 140L,A01,083088,Eldon; John,0,7,75,75
1650372856624,CSE 175,A01,083665,Kumar; Rakesh,8,0,25,17
1650372862668,CSE 190,A00,092507,Dubnov; Shlomo,14,0,20,6
1650372868807,ECE 45,A01,083139,Staff,0,17,40,40
1650372874843,ECE 65,A50,083695,Staff,0,5,30,30
1650372880885,ECE 109,A01,091882,Touri; Behrouz,40,0,70,30
1650372886912,ECE 180,A00,083140,Abi Samra; Nicholas Camill,23,0,30,7
1650372886912,ECE 180,B00,083141,Abi Samra; Nicholas Camill,5,0,30,25
1650372892945,MATH 10A,A01,083735,Patchell; Gregory David,7,0,30,23
1650372892945,MATH 10A,A02,083736,Patchell; Gregory David,28,0,30,2
1650372892945,MATH 10A,A03,083737,Patchell; Gregory David,25,0,30,5
1650372898974,MATH 10B,A01,083207,Staff,0,7,30,30
1650372898974,MATH 10B,A02,083208,Staff,0,6,30,30
1650372898974,MATH 10B,B01,083739,Staff,17,0,30,13
1650372898974,MATH 10B,B02,083740,Staff,28,0,30,2
1650372905001,MATH 18,A01,083743,Staff,3,0,30,27
1650372905001,MATH 18,A02,083744,Staff,27,0,30,3
1650372905001,MATH 18,A03,083745,Staff,22,0,30,8
1650372905001,MATH 18,A04,083746,Staff,27,0,30,3
1650372905001,MATH 18,B01,083748,Staff,0,11,30,30
1650372905001,MATH 18,B02,083749,Staff,0,11,30,30
1650372905001,MATH 18,B03,083750,Staff,0,11,30,30
1650372905001,MATH 18,B04,083751,Staff,0,9,30,30
1650372911028,MATH 20A,A01,083754,Staff,26,0,40,14
1650372917063,MATH 20B,A01,083756,Staff,0,8,30,30
1650372917063,MATH 20B,A02,083757,Staff,0,8,30,30
1650372923096,MATH 20C,A01,083760,Staff,0,14,30,30
1650372923096,MATH 20C,A02,083761,Staff,0,15,30,30
1650372923096,MATH 20C,B01,083762,Staff,13,0,30,17
1650372923096,MATH 20C,B02,083763,Staff,28,0,30,2
1650372929145,MATH 20D,A01,083765,Staff,0,1,30,30
1650372929145,MATH 20D,A02,083766,Staff,7,0,30,23
1650372929145,MATH 20D,A03,083767,Staff,26,0,30,4
1650372935198,MATH 20E,A01,083771,Staff,5,0,30,25
1650372935198,MATH 20E,A02,083772,Staff,19,0,30,11
1650372935198,MATH 20E,B01,083773,Staff,0,0,30,30
1650372935198,MATH 20E,B02,083774,Staff,12,0,30,18
1650372941224,MATH 103A,A01,083777,Staff,0,11,30,30
1650372941224,MATH 103A,A02,083778,Staff,0,12,30,30
1650372941224,MATH 103A,B01,083779,Staff,0,13,30,30
1650372941224,MATH 103A,B02,083780,Staff,0,11,30,30
1650372947254,MATH 105,A01,085443,Staff,0,21,30,30
1650372953289,MATH 109,A01,083213,Anzaldo; Leesa B,0,6,30,30
1650372953289,MATH 109,A02,083214,Anzaldo; Leesa B,0,7,30,30
1650372953289,MATH 109,B01,083215,Anzaldo; Leesa B,0,5,30,30
1650372953289,MATH 109,B02,083216,Anzaldo; Leesa B,0,5,30,30
1650372959320,MATH 142A,A01,083219,Chow; Bennett,0,14,30,30
1650372959320,MATH 142A,A02,083220,Chow; Bennett,0,12,30,30
1650372959320,MATH 142A,B01,083221,Chow; Bennett,0,12,30,30
1650372959320,MATH 142A,B02,083222,Chow; Bennett,0,12,30,30
1650372965345,MATH 193A,A01,083224,Staff,0,5,30,30
1650372965345,MATH 193A,A02,083225,Staff,0,5,30,30
1650372965345,MATH 193A,A03,083781,Staff,0,4,30,30
1650372965345,MATH 193A,A04,083782,Staff,0,3,30,30
1650372971372,MATH 197,001,091859,McAuley; Julian John,9998,0,9999,1
1650372977440,COGS 9,A01,083615,Staff,0,14,60,60
1650372983470,COGS 11,A01,083617,Boyle; Mary E. T.,22,0,40,18
1650372989499,COGS 13,A01,083071,Staff,0,32,40,40
1650372995536,COGS 14A,A01,092681,Staff,0,21,100,100
1650373001567,COGS 14B,A01,083073,Cheng; Tzu-Han,0,10,50,50
1650373007592,COGS 17,A01,092677,Staff,24,0,75,51
1650373013615,COGS 100,A01,083619,Staff,0,24,60,60
1650373019665,COGS 101A,A01,083621,Davis; Joshua Daniel,0,21,60,60
1650373025693,COGS 101B,A01,091572,Staff,0,0,60,60
1650373031719,COGS 101C,A01,083625,Delgado; Tania,17,0,30,13
1650373037749,COGS 107A,A01,083627,Boyle; Mary E. T.,0,10,60,60
1650373043776,COGS 118A,A01,083075,Staff,4,0,60,56
1650373049821,CSE 3,A50,083646,Miranda; Gregory Joseph,21,0,38,17
1650373049821,CSE 3,A51,083647,Miranda; Gregory Joseph,37,0,37,0
1650373055848,CSE 8A,A50,083650,Miranda; Gregory Joseph,0,28,40,40
1650373061878,CSE 11,A01,083080,Cao; Yingjun,0,88,40,40
1650373067903,CSE 12,A01,083652,Staff,0,12,100,100
1650373073931,CSE 15L,A01,083654,Staff,0,1,50,50
1650373073931,CSE 15L,A02,083655,Staff,3,0,50,47
1650373079958,CSE 20,A01,083657,Staff,52,0,80,28
1650373085984,CSE 30,A01,083084,Eldon; John,0,76,40,40
1650373092017,CSE 100,A01,083659,Cao; Yingjun,0,66,50,50
1650373098066,CSE 134B,A01,083661,Powell; Thomas Allan,0,31,65,65
1650373104091,CSE 140,A01,083663,Staff,0,0,75,75
1650373110132,CSE 140L,A01,083088,Eldon; John,0,7,75,75
1650373116178,CSE 175,A01,083665,Kumar; Rakesh,8,0,25,17
1650373122204,CSE 190,A00,092507,Dubnov; Shlomo,14,0,20,6
1650373128230,ECE 45,A01,083139,Staff,0,17,40,40
1650373134257,ECE 65,A50,083695,Staff,0,5,30,30
1650373140290,ECE 109,A01,091882,Touri; Behrouz,40,0,70,30
1650373146321,ECE 180,A00,083140,Abi Samra; Nicholas Camill,23,0,30,7
1650373146321,ECE 180,B00,083141,Abi Samra; Nicholas Camill,5,0,30,25
1650373152353,MATH 10A,A01,083735,Patchell; Gregory David,7,0,30,23
1650373152353,MATH 10A,A02,083736,Patchell; Gregory David,28,0,30,2
1650373152353,MATH 10A,A03,083737,Patchell; Gregory David,25,0,30,5
1650373158380,MATH 10B,A01,083207,Staff,0,7,30,30
1650373158380,MATH 10B,A02,083208,Staff,0,6,30,30
1650373158380,MATH 10B,B01,083739,Staff,17,0,30,13
1650373158380,MATH 10B,B02,083740,Staff,28,0,30,2
1650373164409,MATH 18,A01,083743,Staff,3,0,30,27
1650373164409,MATH 18,A02,083744,Staff,27,0,30,3
1650373164409,MATH 18,A03,083745,Staff,22,0,30,8
1650373164409,MATH 18,A04,083746,Staff,27,0,30,3
1650373164409,MATH 18,B01,083748,Staff,0,11,30,30
1650373164409,MATH 18,B02,083749,Staff,0,11,30,30
1650373164409,MATH 18,B03,083750,Staff,0,11,30,30
1650373164409,MATH 18,B04,083751,Staff,0,9,30,30
1650373170449,MATH 20A,A01,083754,Staff,26,0,40,14
1650373176481,MATH 20B,A01,083756,Staff,0,8,30,30
1650373176481,MATH 20B,A02,083757,Staff,0,8,30,30
1650373182509,MATH 20C,A01,083760,Staff,0,14,30,30
1650373182509,MATH 20C,A02,083761,Staff,0,15,30,30
1650373182509,MATH 20C,B01,083762,Staff,13,0,30,17
1650373182509,MATH 20C,B02,083763,Staff,28,0,30,2
1650373188536,MATH 20D,A01,083765,Staff,0,1,30,30
1650373188536,MATH 20D,A02,083766,Staff,7,0,30,23
1650373188536,MATH 20D,A03,083767,Staff,26,0,30,4
1650373194566,MATH 20E,A01,083771,Staff,5,0,30,25
1650373194566,MATH 20E,A02,083772,Staff,19,0,30,11
1650373194566,MATH 20E,B01,083773,Staff,0,0,30,30
1650373194566,MATH 20E,B02,083774,Staff,12,0,30,18
1650373200590,MATH 103A,A01,083777,Staff,0,11,30,30
1650373200590,MATH 103A,A02,083778,Staff,0,12,30,30
1650373200590,MATH 103A,B01,083779,Staff,0,13,30,30
1650373200590,MATH 103A,B02,083780,Staff,0,11,30,30
1650373206627,MATH 105,A01,085443,Staff,0,21,30,30
1650373212653,MATH 109,A01,083213,Anzaldo; Leesa B,0,6,30,30
1650373212653,MATH 109,A02,083214,Anzaldo; Leesa B,0,7,30,30
1650373212653,MATH 109,B01,083215,Anzaldo; Leesa B,0,5,30,30
1650373212653,MATH 109,B02,083216,Anzaldo; Leesa B,0,5,30,30
1650373218681,MATH 142A,A01,083219,Chow; Bennett,0,14,30,30
1650373218681,MATH 142A,A02,083220,Chow; Bennett,0,12,30,30
1650373218681,MATH 142A,B01,083221,Chow; Bennett,0,12,30,30
1650373218681,MATH 142A,B02,083222,Chow; Bennett,0,12,30,30
1650373224706,MATH 193A,A01,083224,Staff,0,5,30,30
1650373224706,MATH 193A,A02,083225,Staff,0,5,30,30
1650373224706,MATH 193A,A03,083781,Staff,0,4,30,30
1650373224706,MATH 193A,A04,083782,Staff,0,3,30,30
1650373230740,MATH 197,001,091859,McAuley; Julian John,9998,0,9999,1
1650373236803,COGS 9,A01,083615,Staff,0,14,60,60
1650373242828,COGS 11,A01,083617,Boyle; Mary E. T.,22,0,40,18
1650373248860,COGS 13,A01,083071,Staff,0,32,40,40
1650373254889,COGS 14A,A01,092681,Staff,0,21,100,100
1650373260950,COGS 14B,A01,083073,Cheng; Tzu-Han,0,10,50,50
1650373266975,COGS 17,A01,092677,Staff,24,0,75,51
1650373273000,COGS 100,A01,083619,Staff,0,24,60,60
1650373279026,COGS 101A,A01,083621,Davis; Joshua Daniel,0,21,60,60
1650373285060,COGS 101B,A01,091572,Staff,0,0,60,60
1650373291114,COGS 101C,A01,083625,Delgado; Tania,17,0,30,13
1650373297143,COGS 107A,A01,083627,Boyle; Mary E. T.,0,10,60,60
1650373303169,COGS 118A,A01,083075,Staff,4,0,60,56
1650373309204,CSE 3,A50,083646,Miranda; Gregory Joseph,21,0,38,17
1650373309204,CSE 3,A51,083647,Miranda; Gregory Joseph,37,0,37,0
1650373315230,CSE 8A,A50,083650,Miranda; Gregory Joseph,0,28,40,40
1650373321257,CSE 11,A01,083080,Cao; Yingjun,0,88,40,40
1650373327282,CSE 12,A01,083652,Staff,0,12,100,100
1650373333306,CSE 15L,A01,083654,Staff,0,1,50,50
1650373333306,CSE 15L,A02,083655,Staff,3,0,50,47
1650373339338,CSE 20,A01,083657,Staff,52,0,80,28
1650373345368,CSE 30,A01,083084,Eldon; John,0,76,40,40
1650373351394,CSE 100,A01,083659,Cao; Yingjun,0,66,50,50
1650373357421,CSE 134B,A01,083661,Powell; Thomas Allan,0,31,65,65
1650373363447,CSE 140,A01,083663,Staff,0,0,75,75
1650373369474,CSE 140L,A01,083088,Eldon; John,0,7,75,75
1650373375503,CSE 175,A01,083665,Kumar; Rakesh,8,0,25,17
1650373381534,CSE 190,A00,092507,Dubnov; Shlomo,14,0,20,6
1650373387557,ECE 45,A01,083139,Staff,0,17,40,40
1650373393587,ECE 65,A50,083695,Staff,0,5,30,30
1650373399620,ECE 109,A01,091882,Touri; Behrouz,40,0,70,30
1650373405659,ECE 180,A00,083140,Abi Samra; Nicholas Camill,23,0,30,7
1650373405659,ECE 180,B00,083141,Abi Samra; Nicholas Camill,5,0,30,25
1650373411685,MATH 10A,A01,083735,Patchell; Gregory David,7,0,30,23
1650373411685,MATH 10A,A02,083736,Patchell; Gregory David,28,0,30,2
1650373411685,MATH 10A,A03,083737,Patchell; Gregory David,25,0,30,5
1650373417720,MATH 10B,A01,083207,Staff,0,7,30,30
1650373417720,MATH 10B,A02,083208,Staff,0,6,30,30
1650373417720,MATH 10B,B01,083739,Staff,17,0,30,13
1650373417720,MATH 10B,B02,083740,Staff,28,0,30,2
1650373423759,MATH 18,A01,083743,Staff,3,0,30,27
1650373423759,MATH 18,A02,083744,Staff,27,0,30,3
1650373423759,MATH 18,A03,083745,Staff,22,0,30,8
1650373423759,MATH 18,A04,083746,Staff,27,0,30,3
1650373423759,MATH 18,B01,083748,Staff,0,11,30,30
1650373423759,MATH 18,B02,083749,Staff,0,11,30,30
1650373423759,MATH 18,B03,083750,Staff,0,11,30,30
1650373423759,MATH 18,B04,083751,Staff,0,9,30,30
1650373429800,MATH 20A,A01,083754,Staff,26,0,40,14
1650373435829,MATH 20B,A01,083756,Staff,0,8,30,30
1650373435829,MATH 20B,A02,083757,Staff,0,8,30,30
1650373441854,MATH 20C,A01,083760,Staff,0,14,30,30
1650373441854,MATH 20C,A02,083761,Staff,0,15,30,30
1650373441854,MATH 20C,B01,083762,Staff,13,0,30,17
1650373441854,MATH 20C,B02,083763,Staff,28,0,30,2
1650373447879,MATH 20D,A01,083765,Staff,0,1,30,30
1650373447879,MATH 20D,A02,083766,Staff,7,0,30,23
1650373447879,MATH 20D,A03,083767,Staff,26,0,30,4
1650373453905,MATH 20E,A01,083771,Staff,5,0,30,25
1650373453905,MATH 20E,A02,083772,Staff,19,0,30,11
1650373453905,MATH 20E,B01,083773,Staff,0,0,30,30
1650373453905,MATH 20E,B02,083774,Staff,12,0,30,18
1650373459940,MATH 103A,A01,083777,Staff,0,11,30,30
1650373459940,MATH 103A,A02,083778,Staff,0,12,30,30
1650373459940,MATH 103A,B01,083779,Staff,0,13,30,30
1650373459940,MATH 103A,B02,083780,Staff,0,11,30,30
1650373466061,MATH 105,A01,085443,Staff,0,21,30,30
1650373472094,MATH 109,A01,083213,Anzaldo; Leesa B,0,6,30,30
1650373472094,MATH 109,A02,083214,Anzaldo; Leesa B,0,7,30,30
1650373472094,MATH 109,B01,083215,Anzaldo; Leesa B,0,5,30,30
1650373472094,MATH 109,B02,083216,Anzaldo; Leesa B,0,5,30,30
1650373478119,MATH 142A,A01,083219,Chow; Bennett,0,14,30,30
1650373478119,MATH 142A,A02,083220,Chow; Bennett,0,12,30,30
1650373478119,MATH 142A,B01,083221,Chow; Bennett,0,12,30,30
1650373478119,MATH 142A,B02,083222,Chow; Bennett,0,12,30,30
1650373484156,MATH 193A,A01,083224,Staff,0,5,30,30
1650373484156,MATH 193A,A02,083225,Staff,0,5,30,30
1650373484156,MATH 193A,A03,083781,Staff,0,4,30,30
1650373484156,MATH 193A,A04,083782,Staff,0,3,30,30
1650373490181,MATH 197,001,091859,McAuley; Julian John,9998,0,9999,1
1650373496270,COGS 9,A01,083615,Staff,0,14,60,60
1650373502308,COGS 11,A01,083617,Boyle; Mary E. T.,22,0,40,18
1650373508334,COGS 13,A01,083071,Staff,0,32,40,40
1650373514360,COGS 14A,A01,092681,Staff,0,21,100,100
1650373520386,COGS 14B,A01,083073,Cheng; Tzu-Han,0,10,50,50
1650373526408,COGS 17,A01,092677,Staff,24,0,75,51
1650373532434,COGS 100,A01,083619,Staff,0,24,60,60
1650373538463,COGS 101A,A01,083621,Davis; Joshua Daniel,0,21,60,60
1650373544493,COGS 101B,A01,091572,Staff,0,0,60,60
1650373550520,COGS 101C,A01,083625,Delgado; Tania,17,0,30,13
1650373556546,COGS 107A,A01,083627,Boyle; Mary E. T.,0,10,60,60
1650373562573,COGS 118A,A01,083075,Staff,4,0,60,56
1650373568607,CSE 3,A50,083646,Miranda; Gregory Joseph,21,0,38,17
1650373568607,CSE 3,A51,083647,Miranda; Gregory Joseph,37,0,37,0
1650373574637,CSE 8A,A50,083650,Miranda; Gregory Joseph,0,28,40,40
1650373580662,CSE 11,A01,083080,Cao; Yingjun,0,88,40,40
1650373586687,CSE 12,A01,083652,Staff,0,12,100,100
1650373592720,CSE 15L,A01,083654,Staff,0,1,50,50
1650373592720,CSE 15L,A02,083655,Staff,3,0,50,47
1650373598776,CSE 20,A01,083657,Staff,52,0,80,28
1650373604802,CSE 30,A01,083084,Eldon; John,0,76,40,40
1650373610828,CSE 100,A01,083659,Cao; Yingjun,0,66,50,50
1650373616857,CSE 134B,A01,083661,Powell; Thomas Allan,0,31,65,65
1650373622882,CSE 140,A01,083663,Staff,0,0,75,75
1650373628910,CSE 140L,A01,083088,Eldon; John,0,7,75,75
1650373634942,CSE 175,A01,083665,Kumar; Rakesh,8,0,25,17
1650373640975,CSE 190,A00,092507,Dubnov; Shlomo,14,0,20,6
1650373647001,ECE 45,A01,083139,Staff,0,17,40,40
1650373653033,ECE 65,A50,083695,Staff,0,5,30,30
1650373659060,ECE 109,A01,091882,Touri; Behrouz,40,0,70,30
1650373665086,ECE 180,A00,083140,Abi Samra; Nicholas Camill,23,0,30,7
1650373665086,ECE 180,B00,083141,Abi Samra; Nicholas Camill,5,0,30,25
1650373671115,MATH 10A,A01,083735,Patchell; Gregory David,7,0,30,23
1650373671115,MATH 10A,A02,083736,Patchell; Gregory David,28,0,30,2
1650373671115,MATH 10A,A03,083737,Patchell; Gregory David,25,0,30,5
1650373677151,MATH 10B,A01,083207,Staff,0,7,30,30
1650373677151,MATH 10B,A02,083208,Staff,0,6,30,30
1650373677151,MATH 10B,B01,083739,Staff,17,0,30,13
1650373677151,MATH 10B,B02,083740,Staff,28,0,30,2
1650373683180,MATH 18,A01,083743,Staff,3,0,30,27
1650373683180,MATH 18,A02,083744,Staff,27,0,30,3
1650373683180,MATH 18,A03,083745,Staff,22,0,30,8
1650373683180,MATH 18,A04,083746,Staff,27,0,30,3
1650373683180,MATH 18,B01,083748,Staff,0,11,30,30
1650373683180,MATH 18,B02,083749,Staff,0,11,30,30
1650373683180,MATH 18,B03,083750,Staff,0,11,30,30
1650373683180,MATH 18,B04,083751,Staff,0,9,30,30
1650373689207,MATH 20A,A01,083754,Staff,26,0,40,14
1650373695232,MATH 20B,A01,083756,Staff,0,8,30,30
1650373695232,MATH 20B,A02,083757,Staff,0,8,30,30
1650373701262,MATH 20C,A01,083760,Staff,0,14,30,30
1650373701262,MATH 20C,A02,083761,Staff,0,15,30,30
1650373701262,MATH 20C,B01,083762,Staff,13,0,30,17
1650373701262,MATH 20C,B02,083763,Staff,28,0,30,2
1650373707289,MATH 20D,A01,083765,Staff,0,1,30,30
1650373707289,MATH 20D,A02,083766,Staff,7,0,30,23
1650373707289,MATH 20D,A03,083767,Staff,26,0,30,4
1650373713315,MATH 20E,A01,083771,Staff,5,0,30,25
1650373713315,MATH 20E,A02,083772,Staff,19,0,30,11
1650373713315,MATH 20E,B01,083773,Staff,0,0,30,30
1650373713315,MATH 20E,B02,083774,Staff,12,0,30,18
1650373719357,MATH 103A,A01,083777,Staff,0,11,30,30
1650373719357,MATH 103A,A02,083778,Staff,0,12,30,30
1650373719357,MATH 103A,B01,083779,Staff,0,13,30,30
1650373719357,MATH 103A,B02,083780,Staff,0,11,30,30
1650373725390,MATH 105,A01,085443,Staff,0,21,30,30
1650373731423,MATH 109,A01,083213,Anzaldo; Leesa B,0,6,30,30
1650373731423,MATH 109,A02,083214,Anzaldo; Leesa B,0,7,30,30
1650373731423,MATH 109,B01,083215,Anzaldo; Leesa B,0,5,30,30
1650373731423,MATH 109,B02,083216,Anzaldo; Leesa B,0,5,30,30
1650373737451,MATH 142A,A01,083219,Chow; Bennett,0,14,30,30
1650373737451,MATH 142A,A02,083220,Chow; Bennett,0,12,30,30
1650373737451,MATH 142A,B01,083221,Chow; Bennett,0,12,30,30
1650373737451,MATH 142A,B02,083222,Chow; Bennett,0,12,30,30
1650373743477,MATH 193A,A01,083224,Staff,0,5,30,30
1650373743477,MATH 193A,A02,083225,Staff,0,5,30,30
1650373743477,MATH 193A,A03,083781,Staff,0,4,30,30
1650373743477,MATH 193A,A04,083782,Staff,0,3,30,30
1650373749508,MATH 197,001,091859,McAuley; Julian John,9998,0,9999,1
1650373755592,COGS 9,A01,083615,Staff,0,14,60,60
1650373761624,COGS 11,A01,083617,Boyle; Mary E. T.,22,0,40,18
1650373767653,COGS 13,A01,083071,Staff,0,32,40,40
1650373773679,COGS 14A,A01,092681,Staff,0,21,100,100
1650373779707,COGS 14B,A01,083073,Cheng; Tzu-Han,0,10,50,50
1650373785732,COGS 17,A01,092677,Staff,24,0,75,51
1650373791767,COGS 100,A01,083619,Staff,0,24,60,60
1650373797795,COGS 101A,A01,083621,Davis; Joshua Daniel,0,21,60,60
1650373803821,COGS 101B,A01,091572,Staff,0,0,60,60
1650373809848,COGS 101C,A01,083625,Delgado; Tania,17,0,30,13
1650373815876,COGS 107A,A01,083627,Boyle; Mary E. T.,0,10,60,60
1650373821903,COGS 118A,A01,083075,Staff,4,0,60,56
1650373827929,CSE 3,A50,083646,Miranda; Gregory Joseph,21,0,38,17
1650373827929,CSE 3,A51,083647,Miranda; Gregory Joseph,37,0,37,0
1650373833955,CSE 8A,A50,083650,Miranda; Gregory Joseph,0,28,40,40
1650373839986,CSE 11,A01,083080,Cao; Yingjun,0,88,40,40
1650373846012,CSE 12,A01,083652,Staff,0,12,100,100
1650373852038,CSE 15L,A01,083654,Staff,0,1,50,50
1650373852038,CSE 15L,A02,083655,Staff,3,0,50,47
1650373858068,CSE 20,A01,083657,Staff,52,0,80,28
1650373864098,CSE 30,A01,083084,Eldon; John,0,76,40,40
1650373870131,CSE 100,A01,083659,Cao; Yingjun,0,66,50,50
1650373876159,CSE 134B,A01,083661,Powell; Thomas Allan,0,31,65,65
1650373882184,CSE 140,A01,083663,Staff,0,0,75,75
1650373888221,CSE 140L,A01,083088,Eldon; John,0,7,75,75
1650373894248,CSE 175,A01,083665,Kumar; Rakesh,8,0,25,17
1650373900280,CSE 190,A00,092507,Dubnov; Shlomo,14,0,20,6
1650373906323,ECE 45,A01,083139,Staff,0,17,40,40
1650373912349,ECE 65,A50,083695,Staff,0,5,30,30
1650373918374,ECE 109,A01,091882,Touri; Behrouz,40,0,70,30
1650373924401,ECE 180,A00,083140,Abi Samra; Nicholas Camill,23,0,30,7
1650373924401,ECE 180,B00,083141,Abi Samra; Nicholas Camill,5,0,30,25
1650373930429,MATH 10A,A01,083735,Patchell; Gregory David,7,0,30,23
1650373930429,MATH 10A,A02,083736,Patchell; Gregory David,28,0,30,2
1650373930429,MATH 10A,A03,083737,Patchell; Gregory David,25,0,30,5
1650373936453,MATH 10B,A01,083207,Staff,0,7,30,30
1650373936453,MATH 10B,A02,083208,Staff,0,6,30,30
1650373936453,MATH 10B,B01,083739,Staff,17,0,30,13
1650373936453,MATH 10B,B02,083740,Staff,28,0,30,2
1650373942485,MATH 18,A01,083743,Staff,3,0,30,27
1650373942485,MATH 18,A02,083744,Staff,27,0,30,3
1650373942485,MATH 18,A03,083745,Staff,22,0,30,8
1650373942485,MATH 18,A04,083746,Staff,27,0,30,3
1650373942485,MATH 18,B01,083748,Staff,0,11,30,30
1650373942485,MATH 18,B02,083749,Staff,0,11,30,30
1650373942485,MATH 18,B03,083750,Staff,0,11,30,30
1650373942485,MATH 18,B04,083751,Staff,0,9,30,30
1650373948512,MATH 20A,A01,083754,Staff,26,0,40,14
1650373954545,MATH 20B,A01,083756,Staff,0,8,30,30
1650373954545,MATH 20B,A02,083757,Staff,0,8,30,30
1650373960575,MATH 20C,A01,083760,Staff,0,14,30,30
1650373960575,MATH 20C,A02,083761,Staff,0,15,30,30
1650373960575,MATH 20C,B01,083762,Staff,13,0,30,17
1650373960575,MATH 20C,B02,083763,Staff,28,0,30,2
1650373966605,MATH 20D,A01,083765,Staff,0,1,30,30
1650373966605,MATH 20D,A02,083766,Staff,7,0,30,23
1650373966605,MATH 20D,A03,083767,Staff,26,0,30,4
1650373972630,MATH 20E,A01,083771,Staff,5,0,30,25
1650373972630,MATH 20E,A02,083772,Staff,19,0,30,11
1650373972630,MATH 20E,B01,083773,Staff,0,0,30,30
1650373972630,MATH 20E,B02,083774,Staff,12,0,30,18
1650373978657,MATH 103A,A01,083777,Staff,0,11,30,30
1650373978657,MATH 103A,A02,083778,Staff,0,12,30,30
1650373978657,MATH 103A,B01,083779,Staff,0,13,30,30
1650373978657,MATH 103A,B02,083780,Staff,0,11,30,30
1650373984682,MATH 105,A01,085443,Staff,0,21,30,30
1650373990722,MATH 109,A01,083213,Anzaldo; Leesa B,0,6,30,30
1650373990722,MATH 109,A02,083214,Anzaldo; Leesa B,0,7,30,30
1650373990722,MATH 109,B01,083215,Anzaldo; Leesa B,0,5,30,30
1650373990722,MATH 109,B02,083216,Anzaldo; Leesa B,0,5,30,30
1650373996749,MATH 142A,A01,083219,Chow; Bennett,0,14,30,30
1650373996749,MATH 142A,A02,083220,Chow; Bennett,0,12,30,30
1650373996749,MATH 142A,B01,083221,Chow; Bennett,0,12,30,30
1650373996749,MATH 142A,B02,083222,Chow; Bennett,0,12,30,30
1650374002780,MATH 193A,A01,083224,Staff,0,5,30,30
1650374002780,MATH 193A,A02,083225,Staff,0,5,30,30
1650374002780,MATH 193A,A03,083781,Staff,0,4,30,30
1650374002780,MATH 193A,A04,083782,Staff,0,3,30,30
1650374008806,MATH 197,001,091859,McAuley; Julian John,9998,0,9999,1
1650374014881,COGS 9,A01,083615,Staff,0,14,60,60
1650374020907,COGS 11,A01,083617,Boyle; Mary E. T.,22,0,40,18
1650374026932,COGS 13,A01,083071,Staff,0,32,40,40
1650374032964,COGS 14A,A01,092681,Staff,0,21,100,100
1650374039000,COGS 14B,A01,083073,Cheng; Tzu-Han,0,10,50,50
1650374045025,COGS 17,A01,092677,Staff,24,0,75,51
1650374051051,COGS 100,A01,083619,Staff,0,24,60,60
1650374057170,COGS 101A,A01,083621,Davis; Joshua Daniel,0,21,60,60
1650374063195,COGS 101B,A01,091572,Staff,0,0,60,60
1650374069222,COGS 101C,A01,083625,Delgado; Tania,17,0,30,13
1650374075250,COGS 107A,A01,083627,Boyle; Mary E. T.,0,10,60,60
1650374081274,COGS 118A,A01,083075,Staff,4,0,60,56
1650374087307,CSE 3,A50,083646,Miranda; Gregory Joseph,21,0,38,17
1650374087307,CSE 3,A51,083647,Miranda; Gregory Joseph,37,0,37,0
1650374093332,CSE 8A,A50,083650,Miranda; Gregory Joseph,0,28,40,40
1650374099368,CSE 11,A01,083080,Cao; Yingjun,0,88,40,40
1650374105398,CSE 12,A01,083652,Staff,0,12,100,100
1650374111428,CSE 15L,A01,083654,Staff,0,1,50,50
1650374111428,CSE 15L,A02,083655,Staff,3,0,50,47
1650374117459,CSE 20,A01,083657,Staff,52,0,80,28
1650374123490,CSE 30,A01,083084,Eldon; John,0,76,40,40
1650374129520,CSE 100,A01,083659,Cao; Yingjun,0,66,50,50
1650374135544,CSE 134B,A01,083661,Powell; Thomas Allan,0,31,65,65
1650374141569,CSE 140,A01,083663,Staff,0,0,75,75
1650374147593,CSE 140L,A01,083088,Eldon; John,0,7,75,75
1650374153623,CSE 175,A01,083665,Kumar; Rakesh,8,0,25,17
1650374159651,CSE 190,A00,092507,Dubnov; Shlomo,14,0,20,6
1650374165677,ECE 45,A01,083139,Staff,0,17,40,40
1650374171701,ECE 65,A50,083695,Staff,0,5,30,30
1650374177734,ECE 109,A01,091882,Touri; Behrouz,40,0,70,30
1650374183762,ECE 180,A00,083140,Abi Samra; Nicholas Camill,23,0,30,7
1650374183762,ECE 180,B00,083141,Abi Samra; Nicholas Camill,5,0,30,25
1650374189795,MATH 10A,A01,083735,Patchell; Gregory David,7,0,30,23
1650374189795,MATH 10A,A02,083736,Patchell; Gregory David,28,0,30,2
1650374189795,MATH 10A,A03,083737,Patchell; Gregory David,25,0,30,5
1650374195826,MATH 10B,A01,083207,Staff,0,7,30,30
1650374195826,MATH 10B,A02,083208,Staff,0,6,30,30
1650374195826,MATH 10B,B01,083739,Staff,17,0,30,13
1650374195826,MATH 10B,B02,083740,Staff,28,0,30,2
1650374201862,MATH 18,A01,083743,Staff,3,0,30,27
1650374201862,MATH 18,A02,083744,Staff,27,0,30,3
1650374201862,MATH 18,A03,083745,Staff,22,0,30,8
1650374201862,MATH 18,A04,083746,Staff,27,0,30,3
1650374201862,MATH 18,B01,083748,Staff,0,11,30,30
1650374201862,MATH 18,B02,083749,Staff,0,11,30,30
1650374201862,MATH 18,B03,083750,Staff,0,11,30,30
1650374201862,MATH 18,B04,083751,Staff,0,9,30,30
1650374207892,MATH 20A,A01,083754,Staff,26,0,40,14
1650374213928,MATH 20B,A01,083756,Staff,0,8,30,30
1650374213928,MATH 20B,A02,083757,Staff,0,8,30,30
1650374219956,MATH 20C,A01,083760,Staff,0,14,30,30
1650374219956,MATH 20C,A02,083761,Staff,0,15,30,30
1650374219956,MATH 20C,B01,083762,Staff,13,0,30,17
1650374219956,MATH 20C,B02,083763,Staff,28,0,30,2
1650374225987,MATH 20D,A01,083765,Staff,0,1,30,30
1650374225987,MATH 20D,A02,083766,Staff,7,0,30,23
1650374225987,MATH 20D,A03,083767,Staff,26,0,30,4
1650374232021,MATH 20E,A01,083771,Staff,5,0,30,25
1650374232021,MATH 20E,A02,083772,Staff,19,0,30,11
1650374232021,MATH 20E,B01,083773,Staff,0,0,30,30
1650374232021,MATH 20E,B02,083774,Staff,12,0,30,18
1650374238050,MATH 103A,A01,083777,Staff,0,11,30,30
1650374238050,MATH 103A,A02,083778,Staff,0,12,30,30
1650374238050,MATH 103A,B01,083779,Staff,0,13,30,30
1650374238050,MATH 103A,B02,083780,Staff,0,11,30,30
1650374244089,MATH 105,A01,085443,Staff,0,21,30,30
1650374250127,MATH 109,A01,083213,Anzaldo; Leesa B,0,6,30,30
1650374250127,MATH 109,A02,083214,Anzaldo; Leesa B,0,7,30,30
1650374250127,MATH 109,B01,083215,Anzaldo; Leesa B,0,5,30,30
1650374250127,MATH 109,B02,083216,Anzaldo; Leesa B,0,5,30,30
1650374256155,MATH 142A,A01,083219,Chow; Bennett,0,14,30,30
1650374256155,MATH 142A,A02,083220,Chow; Bennett,0,12,30,30
1650374256155,MATH 142A,B01,083221,Chow; Bennett,0,12,30,30
1650374256155,MATH 142A,B02,083222,Chow; Bennett,0,12,30,30
1650374262186,MATH 193A,A01,083224,Staff,0,5,30,30
1650374262186,MATH 193A,A02,083225,Staff,0,5,30,30
1650374262186,MATH 193A,A03,083781,Staff,0,4,30,30
1650374262186,MATH 193A,A04,083782,Staff,0,3,30,30
1650374268213,MATH 197,001,091859,McAuley; Julian John,9998,0,9999,1
1650374274304,COGS 9,A01,083615,Staff,0,14,60,60
1650374280331,COGS 11,A01,083617,Boyle; Mary E. T.,22,0,40,18
1650374286359,COGS 13,A01,083071,Staff,0,32,40,40
1650374292387,COGS 14A,A01,092681,Staff,0,21,100,100
1650374298413,COGS 14B,A01,083073,Cheng; Tzu-Han,0,10,50,50
1650374304444,COGS 17,A01,092677,Staff,24,0,75,51
1650374310472,COGS 100,A01,083619,Staff,0,24,60,60
1650374316501,COGS 101A,A01,083621,Davis; Joshua Daniel,0,21,60,60
1650374322551,COGS 101B,A01,091572,Staff,0,0,60,60
1650374328582,COGS 101C,A01,083625,Delgado; Tania,17,0,30,13
1650374334608,COGS 107A,A01,083627,Boyle; Mary E. T.,0,10,60,60
1650374340635,COGS 118A,A01,083075,Staff,4,0,60,56
1650374346674,CSE 3,A50,083646,Miranda; Gregory Joseph,21,0,38,17
1650374346674,CSE 3,A51,083647,Miranda; Gregory Joseph,37,0,37,0
1650374352699,CSE 8A,A50,083650,Miranda; Gregory Joseph,0,28,40,40
1650374358726,CSE 11,A01,083080,Cao; Yingjun,0,88,40,40
1650374364751,CSE 12,A01,083652,Staff,0,12,100,100
1650374370775,CSE 15L,A01,083654,Staff,0,1,50,50
1650374370775,CSE 15L,A02,083655,Staff,3,0,50,47
1650374376800,CSE 20,A01,083657,Staff,52,0,80,28
1650374382826,CSE 30,A01,083084,Eldon; John,0,76,40,40
1650374388853,CSE 100,A01,083659,Cao; Yingjun,0,66,50,50
1650374394882,CSE 134B,A01,083661,Powell; Thomas Allan,0,31,65,65
1650374400908,CSE 140,A01,083663,Staff,0,0,75,75
1650374406933,CSE 140L,A01,083088,Eldon; John,0,7,75,75
1650374412964,CSE 175,A01,083665,Kumar; Rakesh,8,0,25,17
1650374418991,CSE 190,A00,092507,Dubnov; Shlomo,14,0,20,6
1650374425024,ECE 45,A01,083139,Staff,0,17,40,40
1650374431052,ECE 65,A50,083695,Staff,0,5,30,30
1650374437078,ECE 109,A01,091882,Touri; Behrouz,40,0,70,30
1650374443110,ECE 180,A00,083140,Abi Samra; Nicholas Camill,23,0,30,7
1650374443110,ECE 180,B00,083141,Abi Samra; Nicholas Camill,5,0,30,25
1650374449145,MATH 10A,A01,083735,Patchell; Gregory David,7,0,30,23
1650374449145,MATH 10A,A02,083736,Patchell; Gregory David,28,0,30,2
1650374449145,MATH 10A,A03,083737,Patchell; Gregory David,25,0,30,5
1650374455178,MATH 10B,A01,083207,Staff,0,7,30,30
1650374455178,MATH 10B,A02,083208,Staff,0,6,30,30
1650374455178,MATH 10B,B01,083739,Staff,17,0,30,13
1650374455178,MATH 10B,B02,083740,Staff,28,0,30,2
1650374461206,MATH 18,A01,083743,Staff,3,0,30,27
1650374461206,MATH 18,A02,083744,Staff,27,0,30,3
1650374461206,MATH 18,A03,083745,Staff,22,0,30,8
1650374461206,MATH 18,A04,083746,Staff,27,0,30,3
1650374461206,MATH 18,B01,083748,Staff,0,11,30,30
1650374461206,MATH 18,B02,083749,Staff,0,11,30,30
1650374461206,MATH 18,B03,083750,Staff,0,11,30,30
1650374461206,MATH 18,B04,083751,Staff,0,9,30,30
1650374467233,MATH 20A,A01,083754,Staff,26,0,40,14
1650374473257,MATH 20B,A01,083756,Staff,0,8,30,30
1650374473257,MATH 20B,A02,083757,Staff,0,8,30,30
1650374479298,MATH 20C,A01,083760,Staff,0,14,30,30
1650374479298,MATH 20C,A02,083761,Staff,0,15,30,30
1650374479298,MATH 20C,B01,083762,Staff,13,0,30,17
1650374479298,MATH 20C,B02,083763,Staff,28,0,30,2
1650374485326,MATH 20D,A01,083765,Staff,0,1,30,30
1650374485326,MATH 20D,A02,083766,Staff,7,0,30,23
1650374485326,MATH 20D,A03,083767,Staff,26,0,30,4
1650374491359,MATH 20E,A01,083771,Staff,5,0,30,25
1650374491359,MATH 20E,A02,083772,Staff,19,0,30,11
1650374491359,MATH 20E,B01,083773,Staff,0,0,30,30
1650374491359,MATH 20E,B02,083774,Staff,12,0,30,18
1650374497385,MATH 103A,A01,083777,Staff,0,11,30,30
1650374497385,MATH 103A,A02,083778,Staff,0,12,30,30
1650374497385,MATH 103A,B01,083779,Staff,0,13,30,30
1650374497385,MATH 103A,B02,083780,Staff,0,11,30,30
1650374503415,MATH 105,A01,085443,Staff,0,21,30,30
1650374509444,MATH 109,A01,083213,Anzaldo; Leesa B,0,6,30,30
1650374509444,MATH 109,A02,083214,Anzaldo; Leesa B,0,7,30,30
1650374509444,MATH 109,B01,083215,Anzaldo; Leesa B,0,5,30,30
1650374509444,MATH 109,B02,083216,Anzaldo; Leesa B,0,5,30,30
1650374515470,MATH 142A,A01,083219,Chow; Bennett,0,14,30,30
1650374515470,MATH 142A,A02,083220,Chow; Bennett,0,12,30,30
1650374515470,MATH 142A,B01,083221,Chow; Bennett,0,12,30,30
1650374515470,MATH 142A,B02,083222,Chow; Bennett,0,12,30,30
1650374521504,MATH 193A,A01,083224,Staff,0,5,30,30
1650374521504,MATH 193A,A02,083225,Staff,0,5,30,30
1650374521504,MATH 193A,A03,083781,Staff,0,4,30,30
1650374521504,MATH 193A,A04,083782,Staff,0,3,30,30
1650374527535,MATH 197,001,091859,McAuley; Julian John,9998,0,9999,1
1650374533596,COGS 9,A01,083615,Staff,0,14,60,60
1650374539627,COGS 11,A01,083617,Boyle; Mary E. T.,22,0,40,18
1650374545667,COGS 13,A01,083071,Staff,0,32,40,40
1650374551693,COGS 14A,A01,092681,Staff,0,21,100,100
1650374557724,COGS 14B,A01,083073,Cheng; Tzu-Han,0,10,50,50
1650374563750,COGS 17,A01,092677,Staff,24,0,75,51
1650374569775,COGS 100,A01,083619,Staff,0,24,60,60
1650374575799,COGS 101A,A01,083621,Davis; Joshua Daniel,0,21,60,60
1650374581824,COGS 101B,A01,091572,Staff,0,0,60,60
1650374587850,COGS 101C,A01,083625,Delgado; Tania,17,0,30,13
1650374593875,COGS 107A,A01,083627,Boyle; Mary E. T.,0,10,60,60
1650374599902,COGS 118A,A01,083075,Staff,4,0,60,56
1650374605936,CSE 3,A50,083646,Miranda; Gregory Joseph,21,0,38,17
1650374605936,CSE 3,A51,083647,Miranda; Gregory Joseph,37,0,37,0
1650374611965,CSE 8A,A50,083650,Miranda; Gregory Joseph,0,28,40,40
1650374617994,CSE 11,A01,083080,Cao; Yingjun,0,88,40,40
1650374624021,CSE 12,A01,083652,Staff,0,12,100,100
1650374630046,CSE 15L,A01,083654,Staff,0,1,50,50
1650374630046,CSE 15L,A02,083655,Staff,3,0,50,47
1650374636072,CSE 20,A01,083657,Staff,52,0,80,28
1650374642097,CSE 30,A01,083084,Eldon; John,0,76,40,40
1650374648124,CSE 100,A01,083659,Cao; Yingjun,0,66,50,50
1650374654249,CSE 134B,A01,083661,Powell; Thomas Allan,0,31,65,65
1650374660274,CSE 140,A01,083663,Staff,0,0,75,75
1650374666304,CSE 140L,A01,083088,Eldon; John,0,7,75,75
1650374672340,CSE 175,A01,083665,Kumar; Rakesh,8,0,25,17
1650374678372,CSE 190,A00,092507,Dubnov; Shlomo,14,0,20,6
1650374684403,ECE 45,A01,083139,Staff,0,17,40,40
1650374690428,ECE 65,A50,083695,Staff,0,5,30,30
1650374696458,ECE 109,A01,091882,Touri; Behrouz,40,0,70,30
1650374702484,ECE 180,A00,083140,Abi Samra; Nicholas Camill,23,0,30,7
1650374702484,ECE 180,B00,083141,Abi Samra; Nicholas Camill,5,0,30,25
1650374708519,MATH 10A,A01,083735,Patchell; Gregory David,7,0,30,23
1650374708519,MATH 10A,A02,083736,Patchell; Gregory David,28,0,30,2
1650374708519,MATH 10A,A03,083737,Patchell; Gregory David,25,0,30,5
1650374714548,MATH 10B,A01,083207,Staff,0,7,30,30
1650374714548,MATH 10B,A02,083208,Staff,0,6,30,30
1650374714548,MATH 10B,B01,083739,Staff,17,0,30,13
1650374714548,MATH 10B,B02,083740,Staff,28,0,30,2
1650374720581,MATH 18,A01,083743,Staff,3,0,30,27
1650374720581,MATH 18,A02,083744,Staff,27,0,30,3
1650374720581,MATH 18,A03,083745,Staff,22,0,30,8
1650374720581,MATH 18,A04,083746,Staff,27,0,30,3
1650374720581,MATH 18,B01,083748,Staff,0,11,30,30
1650374720581,MATH 18,B02,083749,Staff,0,11,30,30
1650374720581,MATH 18,B03,083750,Staff,0,11,30,30
1650374720581,MATH 18,B04,083751,Staff,0,9,30,30
1650374726606,MATH 20A,A01,083754,Staff,26,0,40,14
1650374732631,MATH 20B,A01,083756,Staff,0,8,30,30
1650374732631,MATH 20B,A02,083757,Staff,0,8,30,30
1650374738656,MATH 20C,A01,083760,Staff,0,14,30,30
1650374738656,MATH 20C,A02,083761,Staff,0,15,30,30
1650374738656,MATH 20C,B01,083762,Staff,13,0,30,17
1650374738656,MATH 20C,B02,083763,Staff,28,0,30,2
1650374744682,MATH 20D,A01,083765,Staff,0,1,30,30
1650374744682,MATH 20D,A02,083766,Staff,7,0,30,23
1650374744682,MATH 20D,A03,083767,Staff,26,0,30,4
1650374750708,MATH 20E,A01,083771,Staff,5,0,30,25
1650374750708,MATH 20E,A02,083772,Staff,19,0,30,11
1650374750708,MATH 20E,B01,083773,Staff,0,0,30,30
1650374750708,MATH 20E,B02,083774,Staff,12,0,30,18
1650374756741,MATH 103A,A01,083777,Staff,0,11,30,30
1650374756741,MATH 103A,A02,083778,Staff,0,12,30,30
1650374756741,MATH 103A,B01,083779,Staff,0,13,30,30
1650374756741,MATH 103A,B02,083780,Staff,0,11,30,30
1650374762766,MATH 105,A01,085443,Staff,0,21,30,30
1650374768797,MATH 109,A01,083213,Anzaldo; Leesa B,0,6,30,30
1650374768797,MATH 109,A02,083214,Anzaldo; Leesa B,0,7,30,30
1650374768797,MATH 109,B01,083215,Anzaldo; Leesa B,0,5,30,30
1650374768797,MATH 109,B02,083216,Anzaldo; Leesa B,0,5,30,30
1650374774824,MATH 142A,A01,083219,Chow; Bennett,0,14,30,30
1650374774824,MATH 142A,A02,083220,Chow; Bennett,0,12,30,30
1650374774824,MATH 142A,B01,083221,Chow; Bennett,0,12,30,30
1650374774824,MATH 142A,B02,083222,Chow; Bennett,0,12,30,30
1650374780850,MATH 193A,A01,083224,Staff,0,5,30,30
1650374780850,MATH 193A,A02,083225,Staff,0,5,30,30
1650374780850,MATH 193A,A03,083781,Staff,0,4,30,30
1650374780850,MATH 193A,A04,083782,Staff,0,3,30,30
1650374786888,MATH 197,001,091859,McAuley; Julian John,9998,0,9999,1
1650374792950,COGS 9,A01,083615,Staff,0,14,60,60
1650374798976,COGS 11,A01,083617,Boyle; Mary E. T.,22,0,40,18
1650374805001,COGS 13,A01,083071,Staff,0,32,40,40
1650374811029,COGS 14A,A01,092681,Staff,0,21,100,100
1650374817054,COGS 14B,A01,083073,Cheng; Tzu-Han,0,10,50,50
1650374823081,COGS 17,A01,092677,Staff,24,0,75,51
1650374829109,COGS 100,A01,083619,Staff,0,24,60,60
1650374835142,COGS 101A,A01,083621,Davis; Joshua Daniel,0,21,60,60
1650374841174,COGS 101B,A01,091572,Staff,0,0,60,60
1650374847205,COGS 101C,A01,083625,Delgado; Tania,17,0,30,13
1650374853231,COGS 107A,A01,083627,Boyle; Mary E. T.,0,10,60,60
1650374859257,COGS 118A,A01,083075,Staff,4,0,60,56
1650374865283,CSE 3,A50,083646,Miranda; Gregory Joseph,21,0,38,17
1650374865283,CSE 3,A51,083647,Miranda; Gregory Joseph,37,0,37,0
1650374871311,CSE 8A,A50,083650,Miranda; Gregory Joseph,0,28,40,40
1650374877337,CSE 11,A01,083080,Cao; Yingjun,0,88,40,40
1650374883361,CSE 12,A01,083652,Staff,0,12,100,100
1650374889386,CSE 15L,A01,083654,Staff,0,1,50,50
1650374889386,CSE 15L,A02,083655,Staff,3,0,50,47
1650374895415,CSE 20,A01,083657,Staff,52,0,80,28
1650374901439,CSE 30,A01,083084,Eldon; John,0,76,40,40
1650374907470,CSE 100,A01,083659,Cao; Yingjun,0,66,50,50
1650374913497,CSE 134B,A01,083661,Powell; Thomas Allan,0,31,65,65
1650374919526,CSE 140,A01,083663,Staff,0,0,75,75
1650374925553,CSE 140L,A01,083088,Eldon; John,0,7,75,75
1650374931578,CSE 175,A01,083665,Kumar; Rakesh,8,0,25,17
1650374937606,CSE 190,A00,092507,Dubnov; Shlomo,14,0,20,6
1650374943635,ECE 45,A01,083139,Staff,0,17,40,40
1650374949661,ECE 65,A50,083695,Staff,0,5,30,30
1650374955688,ECE 109,A01,091882,Touri; Behrouz,40,0,70,30
1650374961712,ECE 180,A00,083140,Abi Samra; Nicholas Camill,23,0,30,7
1650374961712,ECE 180,B00,083141,Abi Samra; Nicholas Camill,5,0,30,25
1650374967738,MATH 10A,A01,083735,Patchell; Gregory David,7,0,30,23
1650374967738,MATH 10A,A02,083736,Patchell; Gregory David,28,0,30,2
1650374967738,MATH 10A,A03,083737,Patchell; Gregory David,25,0,30,5
1650374973768,MATH 10B,A01,083207,Staff,0,7,30,30
1650374973768,MATH 10B,A02,083208,Staff,0,6,30,30
1650374973768,MATH 10B,B01,083739,Staff,17,0,30,13
1650374973768,MATH 10B,B02,083740,Staff,28,0,30,2
1650374979796,MATH 18,A01,083743,Staff,3,0,30,27
1650374979796,MATH 18,A02,083744,Staff,27,0,30,3
1650374979796,MATH 18,A03,083745,Staff,22,0,30,8
1650374979796,MATH 18,A04,083746,Staff,27,0,30,3
1650374979796,MATH 18,B01,083748,Staff,0,11,30,30
1650374979796,MATH 18,B02,083749,Staff,0,11,30,30
1650374979796,MATH 18,B03,083750,Staff,0,11,30,30
1650374979796,MATH 18,B04,083751,Staff,0,9,30,30
1650374985822,MATH 20A,A01,083754,Staff,26,0,40,14
1650374991849,MATH 20B,A01,083756,Staff,0,8,30,30
1650374991849,MATH 20B,A02,083757,Staff,0,8,30,30
1650374997880,MATH 20C,A01,083760,Staff,0,14,30,30
1650374997880,MATH 20C,A02,083761,Staff,0,15,30,30
1650374997880,MATH 20C,B01,083762,Staff,13,0,30,17
1650374997880,MATH 20C,B02,083763,Staff,28,0,30,2
1650375003905,MATH 20D,A01,083765,Staff,0,1,30,30
1650375003905,MATH 20D,A02,083766,Staff,7,0,30,23
1650375003905,MATH 20D,A03,083767,Staff,26,0,30,4
1650375009934,MATH 20E,A01,083771,Staff,5,0,30,25
1650375009934,MATH 20E,A02,083772,Staff,19,0,30,11
1650375009934,MATH 20E,B01,083773,Staff,0,0,30,30
1650375009934,MATH 20E,B02,083774,Staff,12,0,30,18
1650375015960,MATH 103A,A01,083777,Staff,0,11,30,30
1650375015960,MATH 103A,A02,083778,Staff,0,12,30,30
1650375015960,MATH 103A,B01,083779,Staff,0,13,30,30
1650375015960,MATH 103A,B02,083780,Staff,0,11,30,30
1650375021984,MATH 105,A01,085443,Staff,0,21,30,30
1650375028013,MATH 109,A01,083213,Anzaldo; Leesa B,0,6,30,30
1650375028013,MATH 109,A02,083214,Anzaldo; Leesa B,0,7,30,30
1650375028013,MATH 109,B01,083215,Anzaldo; Leesa B,0,5,30,30
1650375028013,MATH 109,B02,083216,Anzaldo; Leesa B,0,5,30,30
1650375034038,MATH 142A,A01,083219,Chow; Bennett,0,14,30,30
1650375034038,MATH 142A,A02,083220,Chow; Bennett,0,13,30,30
1650375034038,MATH 142A,B01,083221,Chow; Bennett,0,12,30,30
1650375034038,MATH 142A,B02,083222,Chow; Bennett,0,12,30,30
1650375040064,MATH 193A,A01,083224,Staff,0,5,30,30
1650375040064,MATH 193A,A02,083225,Staff,0,5,30,30
1650375040064,MATH 193A,A03,083781,Staff,0,4,30,30
1650375040064,MATH 193A,A04,083782,Staff,0,4,30,30
1650375046098,MATH 197,001,091859,McAuley; Julian John,9998,0,9999,1
1650375052182,COGS 9,A01,083615,Staff,0,14,60,60
1650375058204,COGS 11,A01,083617,Boyle; Mary E. T.,22,0,40,18
1650375064230,COGS 13,A01,083071,Staff,0,32,40,40
1650375070255,COGS 14A,A01,092681,Staff,0,21,100,100
1650375076277,COGS 14B,A01,083073,Cheng; Tzu-Han,0,10,50,50
1650375082300,COGS 17,A01,092677,Staff,24,0,75,51
1650375088323,COGS 100,A01,083619,Staff,0,24,60,60
1650375094349,COGS 101A,A01,083621,Davis; Joshua Daniel,0,21,60,60
1650375100377,COGS 101B,A01,091572,Staff,0,0,60,60
1650375106402,COGS 101C,A01,083625,Delgado; Tania,17,0,30,13
1650375112427,COGS 107A,A01,083627,Boyle; Mary E. T.,0,10,60,60
1650375118456,COGS 118A,A01,083075,Staff,4,0,60,56
1650375124488,CSE 3,A50,083646,Miranda; Gregory Joseph,21,0,38,17
1650375124488,CSE 3,A51,083647,Miranda; Gregory Joseph,37,0,37,0
1650375130517,CSE 8A,A50,083650,Miranda; Gregory Joseph,0,28,40,40
1650375136547,CSE 11,A01,083080,Cao; Yingjun,0,88,40,40
1650375142573,CSE 12,A01,083652,Staff,0,12,100,100
1650375148630,CSE 15L,A01,083654,Staff,0,1,50,50
1650375148630,CSE 15L,A02,083655,Staff,3,0,50,47
1650375154657,CSE 20,A01,083657,Staff,52,0,80,28
1650375160685,CSE 30,A01,083084,Eldon; John,0,76,40,40
1650375166711,CSE 100,A01,083659,Cao; Yingjun,0,66,50,50
1650375172741,CSE 134B,A01,083661,Powell; Thomas Allan,0,31,65,65
1650375178767,CSE 140,A01,083663,Staff,0,0,75,75
1650375184803,CSE 140L,A01,083088,Eldon; John,0,7,75,75
1650375190830,CSE 175,A01,083665,Kumar; Rakesh,8,0,25,17
1650375196861,CSE 190,A00,092507,Dubnov; Shlomo,14,0,20,6
1650375202888,ECE 45,A01,083139,Staff,0,17,40,40
1650375208914,ECE 65,A50,083695,Staff,0,5,30,30
1650375214940,ECE 109,A01,091882,Touri; Behrouz,40,0,70,30
1650375220967,ECE 180,A00,083140,Abi Samra; Nicholas Camill,23,0,30,7
1650375220967,ECE 180,B00,083141,Abi Samra; Nicholas Camill,5,0,30,25
1650375227000,MATH 10A,A01,083735,Patchell; Gregory David,7,0,30,23
1650375227000,MATH 10A,A02,083736,Patchell; Gregory David,28,0,30,2
1650375227000,MATH 10A,A03,083737,Patchell; Gregory David,25,0,30,5
1650375233030,MATH 10B,A01,083207,Staff,0,7,30,30
1650375233030,MATH 10B,A02,083208,Staff,0,6,30,30
1650375233030,MATH 10B,B01,083739,Staff,17,0,30,13
1650375233030,MATH 10B,B02,083740,Staff,28,0,30,2
1650375239062,MATH 18,A01,083743,Staff,3,0,30,27
1650375239062,MATH 18,A02,083744,Staff,27,0,30,3
1650375239062,MATH 18,A03,083745,Staff,22,0,30,8
1650375239062,MATH 18,A04,083746,Staff,27,0,30,3
1650375239062,MATH 18,B01,083748,Staff,0,11,30,30
1650375239062,MATH 18,B02,083749,Staff,0,11,30,30
1650375239062,MATH 18,B03,083750,Staff,0,11,30,30
1650375239062,MATH 18,B04,083751,Staff,0,9,30,30
1650375245090,MATH 20A,A01,083754,Staff,26,0,40,14
1650375251210,MATH 20B,A01,083756,Staff,0,8,30,30
1650375251210,MATH 20B,A02,083757,Staff,0,8,30,30
1650375257241,MATH 20C,A01,083760,Staff,0,14,30,30
1650375257241,MATH 20C,A02,083761,Staff,0,15,30,30
1650375257241,MATH 20C,B01,083762,Staff,13,0,30,17
1650375257241,MATH 20C,B02,083763,Staff,28,0,30,2
1650375263271,MATH 20D,A01,083765,Staff,0,1,30,30
1650375263271,MATH 20D,A02,083766,Staff,7,0,30,23
1650375263271,MATH 20D,A03,083767,Staff,26,0,30,4
1650375269306,MATH 20E,A01,083771,Staff,5,0,30,25
1650375269306,MATH 20E,A02,083772,Staff,19,0,30,11
1650375269306,MATH 20E,B01,083773,Staff,0,0,30,30
1650375269306,MATH 20E,B02,083774,Staff,12,0,30,18
1650375275335,MATH 103A,A01,083777,Staff,0,11,30,30
1650375275335,MATH 103A,A02,083778,Staff,0,12,30,30
1650375275335,MATH 103A,B01,083779,Staff,0,13,30,30
1650375275335,MATH 103A,B02,083780,Staff,0,11,30,30
1650375281361,MATH 105,A01,085443,Staff,0,21,30,30
1650375287389,MATH 109,A01,083213,Anzaldo; Leesa B,0,6,30,30
1650375287389,MATH 109,A02,083214,Anzaldo; Leesa B,0,7,30,30
1650375287389,MATH 109,B01,083215,Anzaldo; Leesa B,0,5,30,30
1650375287389,MATH 109,B02,083216,Anzaldo; Leesa B,0,5,30,30
1650375293427,MATH 142A,A01,083219,Chow; Bennett,0,14,30,30
1650375293427,MATH 142A,A02,083220,Chow; Bennett,0,13,30,30
1650375293427,MATH 142A,B01,083221,Chow; Bennett,0,12,30,30
1650375293427,MATH 142A,B02,083222,Chow; Bennett,0,12,30,30
1650375299462,MATH 193A,A01,083224,Staff,0,5,30,30
1650375299462,MATH 193A,A02,083225,Staff,0,5,30,30
1650375299462,MATH 193A,A03,083781,Staff,0,4,30,30
1650375299462,MATH 193A,A04,083782,Staff,0,4,30,30
1650375305488,MATH 197,001,091859,McAuley; Julian John,9998,0,9999,1
1650375311567,COGS 9,A01,083615,Staff,0,14,60,60
1650375317601,COGS 11,A01,083617,Boyle; Mary E. T.,22,0,40,18
1650375323634,COGS 13,A01,083071,Staff,0,32,40,40
1650375329665,COGS 14A,A01,092681,Staff,0,21,100,100
1650375335699,COGS 14B,A01,083073,Cheng; Tzu-Han,0,10,50,50
1650375341727,COGS 17,A01,092677,Staff,24,0,75,51
1650375347753,COGS 100,A01,083619,Staff,0,24,60,60
1650375353783,COGS 101A,A01,083621,Davis; Joshua Daniel,0,21,60,60
1650375359816,COGS 101B,A01,091572,Staff,0,0,60,60
1650375365843,COGS 101C,A01,083625,Delgado; Tania,17,0,30,13
1650375371869,COGS 107A,A01,083627,Boyle; Mary E. T.,0,10,60,60
1650375377907,COGS 118A,A01,083075,Staff,4,0,60,56
1650375383933,CSE 3,A50,083646,Miranda; Gregory Joseph,21,0,38,17
1650375383933,CSE 3,A51,083647,Miranda; Gregory Joseph,37,0,37,0
1650375389970,CSE 8A,A50,083650,Miranda; Gregory Joseph,0,28,40,40
1650375395997,CSE 11,A01,083080,Cao; Yingjun,0,88,40,40
1650375402024,CSE 12,A01,083652,Staff,0,12,100,100
1650375408049,CSE 15L,A01,083654,Staff,0,1,50,50
1650375408049,CSE 15L,A02,083655,Staff,3,0,50,47
1650375414075,CSE 20,A01,083657,Staff,52,0,80,28
1650375420099,CSE 30,A01,083084,Eldon; John,0,76,40,40
1650375426128,CSE 100,A01,083659,Cao; Yingjun,0,66,50,50
1650375432155,CSE 134B,A01,083661,Powell; Thomas Allan,0,31,65,65
1650375438183,CSE 140,A01,083663,Staff,0,0,75,75
1650375444217,CSE 140L,A01,083088,Eldon; John,0,7,75,75
1650375450243,CSE 175,A01,083665,Kumar; Rakesh,8,0,25,17
1650375456268,CSE 190,A00,092507,Dubnov; Shlomo,14,0,20,6
1650375462293,ECE 45,A01,083139,Staff,0,17,40,40
1650375468319,ECE 65,A50,083695,Staff,0,5,30,30
1650375474345,ECE 109,A01,091882,Touri; Behrouz,40,0,70,30
1650375480380,ECE 180,A00,083140,Abi Samra; Nicholas Camill,23,0,30,7
1650375480380,ECE 180,B00,083141,Abi Samra; Nicholas Camill,5,0,30,25
1650375486408,MATH 10A,A01,083735,Patchell; Gregory David,7,0,30,23
1650375486408,MATH 10A,A02,083736,Patchell; Gregory David,28,0,30,2
1650375486408,MATH 10A,A03,083737,Patchell; Gregory David,25,0,30,5
1650375492435,MATH 10B,A01,083207,Staff,0,7,30,30
1650375492435,MATH 10B,A02,083208,Staff,0,6,30,30
1650375492435,MATH 10B,B01,083739,Staff,17,0,30,13
1650375492435,MATH 10B,B02,083740,Staff,28,0,30,2
1650375498462,MATH 18,A01,083743,Staff,3,0,30,27
1650375498462,MATH 18,A02,083744,Staff,27,0,30,3
1650375498462,MATH 18,A03,083745,Staff,22,0,30,8
1650375498462,MATH 18,A04,083746,Staff,27,0,30,3
1650375498462,MATH 18,B01,083748,Staff,0,11,30,30
1650375498462,MATH 18,B02,083749,Staff,0,11,30,30
1650375498462,MATH 18,B03,083750,Staff,0,11,30,30
1650375498462,MATH 18,B04,083751,Staff,0,9,30,30
1650375504490,MATH 20A,A01,083754,Staff,26,0,40,14
1650375510513,MATH 20B,A01,083756,Staff,0,8,30,30
1650375510513,MATH 20B,A02,083757,Staff,0,8,30,30
1650375516536,MATH 20C,A01,083760,Staff,0,14,30,30
1650375516536,MATH 20C,A02,083761,Staff,0,15,30,30
1650375516536,MATH 20C,B01,083762,Staff,13,0,30,17
1650375516536,MATH 20C,B02,083763,Staff,28,0,30,2
1650375522562,MATH 20D,A01,083765,Staff,0,1,30,30
1650375522562,MATH 20D,A02,083766,Staff,7,0,30,23
1650375522562,MATH 20D,A03,083767,Staff,26,0,30,4
1650375528586,MATH 20E,A01,083771,Staff,5,0,30,25
1650375528586,MATH 20E,A02,083772,Staff,19,0,30,11
1650375528586,MATH 20E,B01,083773,Staff,0,0,30,30
1650375528586,MATH 20E,B02,083774,Staff,12,0,30,18
1650375534611,MATH 103A,A01,083777,Staff,0,11,30,30
1650375534611,MATH 103A,A02,083778,Staff,0,12,30,30
1650375534611,MATH 103A,B01,083779,Staff,0,13,30,30
1650375534611,MATH 103A,B02,083780,Staff,0,11,30,30
1650375540638,MATH 105,A01,085443,Staff,0,21,30,30
1650375546669,MATH 109,A01,083213,Anzaldo; Leesa B,0,6,30,30
1650375546669,MATH 109,A02,083214,Anzaldo; Leesa B,0,7,30,30
1650375546669,MATH 109,B01,083215,Anzaldo; Leesa B,0,5,30,30
1650375546669,MATH 109,B02,083216,Anzaldo; Leesa B,0,5,30,30
1650375552701,MATH 142A,A01,083219,Chow; Bennett,0,14,30,30
1650375552701,MATH 142A,A02,083220,Chow; Bennett,0,13,30,30
1650375552701,MATH 142A,B01,083221,Chow; Bennett,0,12,30,30
1650375552701,MATH 142A,B02,083222,Chow; Bennett,0,12,30,30
1650375558726,MATH 193A,A01,083224,Staff,0,5,30,30
1650375558726,MATH 193A,A02,083225,Staff,0,5,30,30
1650375558726,MATH 193A,A03,083781,Staff,0,4,30,30
1650375558726,MATH 193A,A04,083782,Staff,0,4,30,30
1650375564758,MATH 197,001,091859,McAuley; Julian John,9998,0,9999,1
1650375570809,COGS 9,A01,083615,Staff,0,14,60,60
1650375576838,COGS 11,A01,083617,Boyle; Mary E. T.,22,0,40,18
1650375582876,COGS 13,A01,083071,Staff,0,32,40,40
1650375588901,COGS 14A,A01,092681,Staff,0,21,100,100
1650375594926,COGS 14B,A01,083073,Cheng; Tzu-Han,0,10,50,50
1650375600951,COGS 17,A01,092677,Staff,24,0,75,51
1650375606975,COGS 100,A01,083619,Staff,0,24,60,60
1650375613000,COGS 101A,A01,083621,Davis; Joshua Daniel,0,21,60,60
1650375619034,COGS 101B,A01,091572,Staff,0,0,60,60
1650375625063,COGS 101C,A01,083625,Delgado; Tania,17,0,30,13
1650375631088,COGS 107A,A01,083627,Boyle; Mary E. T.,0,10,60,60
1650375637120,COGS 118A,A01,083075,Staff,4,0,60,56
1650375643145,CSE 3,A50,083646,Miranda; Gregory Joseph,21,0,38,17
1650375643145,CSE 3,A51,083647,Miranda; Gregory Joseph,37,0,37,0
1650375649174,CSE 8A,A50,083650,Miranda; Gregory Joseph,0,28,40,40
1650375655200,CSE 11,A01,083080,Cao; Yingjun,0,88,40,40
1650375661226,CSE 12,A01,083652,Staff,0,12,100,100
1650375667252,CSE 15L,A01,083654,Staff,0,1,50,50
1650375667252,CSE 15L,A02,083655,Staff,3,0,50,47
1650375673276,CSE 20,A01,083657,Staff,52,0,80,28
1650375679308,CSE 30,A01,083084,Eldon; John,0,76,40,40
1650375685333,CSE 100,A01,083659,Cao; Yingjun,0,66,50,50
1650375691356,CSE 134B,A01,083661,Powell; Thomas Allan,0,31,65,65
1650375697386,CSE 140,A01,083663,Staff,0,0,75,75
1650375703413,CSE 140L,A01,083088,Eldon; John,0,7,75,75
1650375709438,CSE 175,A01,083665,Kumar; Rakesh,8,0,25,17
1650375715460,CSE 190,A00,092507,Dubnov; Shlomo,14,0,20,6
1650375721491,ECE 45,A01,083139,Staff,0,17,40,40
1650375727518,ECE 65,A50,083695,Staff,0,5,30,30
1650375733541,ECE 109,A01,091882,Touri; Behrouz,40,0,70,30
1650375739566,ECE 180,A00,083140,Abi Samra; Nicholas Camill,23,0,30,7
1650375739566,ECE 180,B00,083141,Abi Samra; Nicholas Camill,5,0,30,25
1650375745596,MATH 10A,A01,083735,Patchell; Gregory David,7,0,30,23
1650375745596,MATH 10A,A02,083736,Patchell; Gregory David,28,0,30,2
1650375745596,MATH 10A,A03,083737,Patchell; Gregory David,25,0,30,5
1650375751619,MATH 10B,A01,083207,Staff,0,7,30,30
1650375751619,MATH 10B,A02,083208,Staff,0,6,30,30
1650375751619,MATH 10B,B01,083739,Staff,17,0,30,13
1650375751619,MATH 10B,B02,083740,Staff,28,0,30,2
1650375757645,MATH 18,A01,083743,Staff,3,0,30,27
1650375757645,MATH 18,A02,083744,Staff,27,0,30,3
1650375757645,MATH 18,A03,083745,Staff,22,0,30,8
1650375757645,MATH 18,A04,083746,Staff,27,0,30,3
1650375757645,MATH 18,B01,083748,Staff,0,11,30,30
1650375757645,MATH 18,B02,083749,Staff,0,11,30,30
1650375757645,MATH 18,B03,083750,Staff,0,11,30,30
1650375757645,MATH 18,B04,083751,Staff,0,9,30,30
1650375763670,MATH 20A,A01,083754,Staff,26,0,40,14
1650375769694,MATH 20B,A01,083756,Staff,0,8,30,30
1650375769694,MATH 20B,A02,083757,Staff,0,8,30,30
1650375775721,MATH 20C,A01,083760,Staff,0,14,30,30
1650375775721,MATH 20C,A02,083761,Staff,0,15,30,30
1650375775721,MATH 20C,B01,083762,Staff,13,0,30,17
1650375775721,MATH 20C,B02,083763,Staff,28,0,30,2
1650375781749,MATH 20D,A01,083765,Staff,0,1,30,30
1650375781749,MATH 20D,A02,083766,Staff,7,0,30,23
1650375781749,MATH 20D,A03,083767,Staff,26,0,30,4
1650375787777,MATH 20E,A01,083771,Staff,5,0,30,25
1650375787777,MATH 20E,A02,083772,Staff,19,0,30,11
1650375787777,MATH 20E,B01,083773,Staff,0,0,30,30
1650375787777,MATH 20E,B02,083774,Staff,12,0,30,18
1650375793805,MATH 103A,A01,083777,Staff,0,11,30,30
1650375793805,MATH 103A,A02,083778,Staff,0,12,30,30
1650375793805,MATH 103A,B01,083779,Staff,0,13,30,30
1650375793805,MATH 103A,B02,083780,Staff,0,11,30,30
1650375799829,MATH 105,A01,085443,Staff,0,21,30,30
1650375805854,MATH 109,A01,083213,Anzaldo; Leesa B,0,6,30,30
1650375805854,MATH 109,A02,083214,Anzaldo; Leesa B,0,7,30,30
1650375805854,MATH 109,B01,083215,Anzaldo; Leesa B,0,5,30,30
1650375805854,MATH 109,B02,083216,Anzaldo; Leesa B,0,5,30,30
1650375811879,MATH 142A,A01,083219,Chow; Bennett,0,14,30,30
1650375811879,MATH 142A,A02,083220,Chow; Bennett,0,13,30,30
1650375811879,MATH 142A,B01,083221,Chow; Bennett,0,12,30,30
1650375811879,MATH 142A,B02,083222,Chow; Bennett,0,12,30,30
1650375817902,MATH 193A,A01,083224,Staff,0,5,30,30
1650375817902,MATH 193A,A02,083225,Staff,0,5,30,30
1650375817902,MATH 193A,A03,083781,Staff,0,4,30,30
1650375817902,MATH 193A,A04,083782,Staff,0,4,30,30
1650375823928,MATH 197,001,091859,McAuley; Julian John,9998,0,9999,1
1650375830062,COGS 9,A01,083615,Staff,0,14,60,60
1650375836087,COGS 11,A01,083617,Boyle; Mary E. T.,22,0,40,18
1650375842203,COGS 13,A01,083071,Staff,0,32,40,40
1650375848227,COGS 14A,A01,092681,Staff,0,21,100,100
1650375854255,COGS 14B,A01,083073,Cheng; Tzu-Han,0,10,50,50
1650375860281,COGS 17,A01,092677,Staff,24,0,75,51
1650375866305,COGS 100,A01,083619,Staff,0,24,60,60
1650375872331,COGS 101A,A01,083621,Davis; Joshua Daniel,0,21,60,60
1650375878368,COGS 101B,A01,091572,Staff,0,0,60,60
1650375884400,COGS 101C,A01,083625,Delgado; Tania,17,0,30,13
1650375890426,COGS 107A,A01,083627,Boyle; Mary E. T.,0,10,60,60
1650375896451,COGS 118A,A01,083075,Staff,4,0,60,56
1650375902475,CSE 3,A50,083646,Miranda; Gregory Joseph,21,0,38,17
1650375902475,CSE 3,A51,083647,Miranda; Gregory Joseph,37,0,37,0
1650375908505,CSE 8A,A50,083650,Miranda; Gregory Joseph,0,28,40,40
1650375914534,CSE 11,A01,083080,Cao; Yingjun,0,88,40,40
1650375920566,CSE 12,A01,083652,Staff,0,12,100,100
1650375926590,CSE 15L,A01,083654,Staff,0,1,50,50
1650375926590,CSE 15L,A02,083655,Staff,3,0,50,47
1650375932617,CSE 20,A01,083657,Staff,52,0,80,28
1650375938640,CSE 30,A01,083084,Eldon; John,0,76,40,40
1650375944661,CSE 100,A01,083659,Cao; Yingjun,0,66,50,50
1650375950686,CSE 134B,A01,083661,Powell; Thomas Allan,0,31,65,65
1650375956713,CSE 140,A01,083663,Staff,0,0,75,75
1650375962739,CSE 140L,A01,083088,Eldon; John,0,7,75,75
1650375968764,CSE 175,A01,083665,Kumar; Rakesh,8,0,25,17
1650375974789,CSE 190,A00,092507,Dubnov; Shlomo,14,0,20,6
1650375980820,ECE 45,A01,083139,Staff,0,17,40,40
1650375986844,ECE 65,A50,083695,Staff,0,5,30,30
1650375992868,ECE 109,A01,091882,Touri; Behrouz,40,0,70,30
1650375998890,ECE 180,A00,083140,Abi Samra; Nicholas Camill,23,0,30,7
1650375998890,ECE 180,B00,083141,Abi Samra; Nicholas Camill,5,0,30,25
1650376004925,MATH 10A,A01,083735,Patchell; Gregory David,7,0,30,23
1650376004925,MATH 10A,A02,083736,Patchell; Gregory David,28,0,30,2
1650376004925,MATH 10A,A03,083737,Patchell; Gregory David,25,0,30,5
1650376010950,MATH 10B,A01,083207,Staff,0,7,30,30
1650376010950,MATH 10B,A02,083208,Staff,0,6,30,30
1650376010950,MATH 10B,B01,083739,Staff,17,0,30,13
1650376010950,MATH 10B,B02,083740,Staff,28,0,30,2
1650376016979,MATH 18,A01,083743,Staff,3,0,30,27
1650376016979,MATH 18,A02,083744,Staff,27,0,30,3
1650376016979,MATH 18,A03,083745,Staff,22,0,30,8
1650376016979,MATH 18,A04,083746,Staff,27,0,30,3
1650376016979,MATH 18,B01,083748,Staff,0,11,30,30
1650376016979,MATH 18,B02,083749,Staff,0,11,30,30
1650376016979,MATH 18,B03,083750,Staff,0,11,30,30
1650376016979,MATH 18,B04,083751,Staff,0,9,30,30
1650376023008,MATH 20A,A01,083754,Staff,26,0,40,14
1650376029030,MATH 20B,A01,083756,Staff,0,8,30,30
1650376029030,MATH 20B,A02,083757,Staff,0,8,30,30
1650376035055,MATH 20C,A01,083760,Staff,0,14,30,30
1650376035055,MATH 20C,A02,083761,Staff,0,15,30,30
1650376035055,MATH 20C,B01,083762,Staff,13,0,30,17
1650376035055,MATH 20C,B02,083763,Staff,28,0,30,2
1650376041083,MATH 20D,A01,083765,Staff,0,1,30,30
1650376041083,MATH 20D,A02,083766,Staff,7,0,30,23
1650376041083,MATH 20D,A03,083767,Staff,26,0,30,4
1650376047108,MATH 20E,A01,083771,Staff,5,0,30,25
1650376047108,MATH 20E,A02,083772,Staff,19,0,30,11
1650376047108,MATH 20E,B01,083773,Staff,0,0,30,30
1650376047108,MATH 20E,B02,083774,Staff,12,0,30,18
1650376053132,MATH 103A,A01,083777,Staff,0,11,30,30
1650376053132,MATH 103A,A02,083778,Staff,0,12,30,30
1650376053132,MATH 103A,B01,083779,Staff,0,13,30,30
1650376053132,MATH 103A,B02,083780,Staff,0,11,30,30
1650376059157,MATH 105,A01,085443,Staff,0,21,30,30
1650376065182,MATH 109,A01,083213,Anzaldo; Leesa B,0,6,30,30
1650376065182,MATH 109,A02,083214,Anzaldo; Leesa B,0,7,30,30
1650376065182,MATH 109,B01,083215,Anzaldo; Leesa B,0,5,30,30
1650376065182,MATH 109,B02,083216,Anzaldo; Leesa B,0,5,30,30
1650376071210,MATH 142A,A01,083219,Chow; Bennett,0,14,30,30
1650376071210,MATH 142A,A02,083220,Chow; Bennett,0,13,30,30
1650376071210,MATH 142A,B01,083221,Chow; Bennett,0,12,30,30
1650376071210,MATH 142A,B02,083222,Chow; Bennett,0,12,30,30
1650376077236,MATH 193A,A01,083224,Staff,0,5,30,30
1650376077236,MATH 193A,A02,083225,Staff,0,5,30,30
1650376077236,MATH 193A,A03,083781,Staff,0,4,30,30
1650376077236,MATH 193A,A04,083782,Staff,0,4,30,30
1650376083262,MATH 197,001,091859,McAuley; Julian John,9998,0,9999,1
1650376089317,COGS 9,A01,083615,Staff,0,14,60,60
1650376095341,COGS 11,A01,083617,Boyle; Mary E. T.,22,0,40,18
1650376101371,COGS 13,A01,083071,Staff,0,32,40,40
1650376107398,COGS 14A,A01,092681,Staff,0,21,100,100
1650376113423,COGS 14B,A01,083073,Cheng; Tzu-Han,0,10,50,50
1650376119450,COGS 17,A01,092677,Staff,24,0,75,51
1650376125477,COGS 100,A01,083619,Staff,0,24,60,60
1650376131503,COGS 101A,A01,083621,Davis; Joshua Daniel,0,21,60,60
1650376137526,COGS 101B,A01,091572,Staff,0,0,60,60
1650376143553,COGS 101C,A01,083625,Delgado; Tania,17,0,30,13
1650376149582,COGS 107A,A01,083627,Boyle; Mary E. T.,0,10,60,60
1650376155606,COGS 118A,A01,083075,Staff,4,0,60,56
1650376161634,CSE 3,A50,083646,Miranda; Gregory Joseph,21,0,38,17
1650376161634,CSE 3,A51,083647,Miranda; Gregory Joseph,37,0,37,0
1650376167657,CSE 8A,A50,083650,Miranda; Gregory Joseph,0,28,40,40
1650376173682,CSE 11,A01,083080,Cao; Yingjun,0,88,40,40
1650376179710,CSE 12,A01,083652,Staff,0,12,100,100
1650376185737,CSE 15L,A01,083654,Staff,0,1,50,50
1650376185737,CSE 15L,A02,083655,Staff,3,0,50,47
1650376191760,CSE 20,A01,083657,Staff,52,0,80,28
1650376197783,CSE 30,A01,083084,Eldon; John,0,76,40,40
1650376203817,CSE 100,A01,083659,Cao; Yingjun,0,66,50,50
1650376209841,CSE 134B,A01,083661,Powell; Thomas Allan,0,31,65,65
1650376215866,CSE 140,A01,083663,Staff,0,0,75,75
1650376221893,CSE 140L,A01,083088,Eldon; John,0,7,75,75
1650376227929,CSE 175,A01,083665,Kumar; Rakesh,8,0,25,17
1650376233953,CSE 190,A00,092507,Dubnov; Shlomo,14,0,20,6
1650376239975,ECE 45,A01,083139,Staff,0,17,40,40
1650376246014,ECE 65,A50,083695,Staff,0,5,30,30
1650376252038,ECE 109,A01,091882,Touri; Behrouz,40,0,70,30
1650376258070,ECE 180,A00,083140,Abi Samra; Nicholas Camill,23,0,30,7
1650376258070,ECE 180,B00,083141,Abi Samra; Nicholas Camill,5,0,30,25
1650376264099,MATH 10A,A01,083735,Patchell; Gregory David,7,0,30,23
1650376264099,MATH 10A,A02,083736,Patchell; Gregory David,28,0,30,2
1650376264099,MATH 10A,A03,083737,Patchell; Gregory David,25,0,30,5
1650376270123,MATH 10B,A01,083207,Staff,0,7,30,30
1650376270123,MATH 10B,A02,083208,Staff,0,6,30,30
1650376270123,MATH 10B,B01,083739,Staff,17,0,30,13
1650376270123,MATH 10B,B02,083740,Staff,28,0,30,2
1650376276155,MATH 18,A01,083743,Staff,3,0,30,27
1650376276155,MATH 18,A02,083744,Staff,27,0,30,3
1650376276155,MATH 18,A03,083745,Staff,22,0,30,8
1650376276155,MATH 18,A04,083746,Staff,27,0,30,3
1650376276155,MATH 18,B01,083748,Staff,0,11,30,30
1650376276155,MATH 18,B02,083749,Staff,0,11,30,30
1650376276155,MATH 18,B03,083750,Staff,0,11,30,30
1650376276155,MATH 18,B04,083751,Staff,0,9,30,30
1650376282183,MATH 20A,A01,083754,Staff,26,0,40,14
1650376288209,MATH 20B,A01,083756,Staff,0,8,30,30
1650376288209,MATH 20B,A02,083757,Staff,0,8,30,30
1650376294234,MATH 20C,A01,083760,Staff,0,14,30,30
1650376294234,MATH 20C,A02,083761,Staff,0,15,30,30
1650376294234,MATH 20C,B01,083762,Staff,13,0,30,17
1650376294234,MATH 20C,B02,083763,Staff,28,0,30,2
1650376300259,MATH 20D,A01,083765,Staff,0,1,30,30
1650376300259,MATH 20D,A02,083766,Staff,7,0,30,23
1650376300259,MATH 20D,A03,083767,Staff,26,0,30,4
1650376306303,MATH 20E,A01,083771,Staff,5,0,30,25
1650376306303,MATH 20E,A02,083772,Staff,19,0,30,11
1650376306303,MATH 20E,B01,083773,Staff,0,0,30,30
1650376306303,MATH 20E,B02,083774,Staff,12,0,30,18
1650376312331,MATH 103A,A01,083777,Staff,0,11,30,30
1650376312331,MATH 103A,A02,083778,Staff,0,12,30,30
1650376312331,MATH 103A,B01,083779,Staff,0,13,30,30
1650376312331,MATH 103A,B02,083780,Staff,0,11,30,30
1650376318362,MATH 105,A01,085443,Staff,0,21,30,30
1650376324389,MATH 109,A01,083213,Anzaldo; Leesa B,0,6,30,30
1650376324389,MATH 109,A02,083214,Anzaldo; Leesa B,0,7,30,30
1650376324389,MATH 109,B01,083215,Anzaldo; Leesa B,0,5,30,30
1650376324389,MATH 109,B02,083216,Anzaldo; Leesa B,0,5,30,30
1650376330418,MATH 142A,A01,083219,Chow; Bennett,0,14,30,30
1650376330418,MATH 142A,A02,083220,Chow; Bennett,0,13,30,30
1650376330418,MATH 142A,B01,083221,Chow; Bennett,0,12,30,30
1650376330418,MATH 142A,B02,083222,Chow; Bennett,0,12,30,30
1650376336448,MATH 193A,A01,083224,Staff,0,5,30,30
1650376336448,MATH 193A,A02,083225,Staff,0,5,30,30
1650376336448,MATH 193A,A03,083781,Staff,0,4,30,30
1650376336448,MATH 193A,A04,083782,Staff,0,4,30,30
1650376342485,MATH 197,001,091859,McAuley; Julian John,9998,0,9999,1
1650376348537,COGS 9,A01,083615,Staff,0,14,60,60
1650376354568,COGS 11,A01,083617,Boyle; Mary E. T.,22,0,40,18
1650376360596,COGS 13,A01,083071,Staff,0,32,40,40
1650376366630,COGS 14A,A01,092681,Staff,0,21,100,100
1650376372655,COGS 14B,A01,083073,Cheng; Tzu-Han,0,10,50,50
1650376378681,COGS 17,A01,092677,Staff,24,0,75,51
1650376384706,COGS 100,A01,083619,Staff,0,24,60,60
1650376390732,COGS 101A,A01,083621,Davis; Joshua Daniel,0,21,60,60
1650376396755,COGS 101B,A01,091572,Staff,0,0,60,60
1650376402779,COGS 101C,A01,083625,Delgado; Tania,17,0,30,13
1650376408805,COGS 107A,A01,083627,Boyle; Mary E. T.,0,10,60,60
1650376414829,COGS 118A,A01,083075,Staff,4,0,60,56
1650376420855,CSE 3,A50,083646,Miranda; Gregory Joseph,21,0,38,17
1650376420855,CSE 3,A51,083647,Miranda; Gregory Joseph,37,0,37,0
1650376426881,CSE 8A,A50,083650,Miranda; Gregory Joseph,0,28,40,40
1650376432905,CSE 11,A01,083080,Cao; Yingjun,0,88,40,40
1650376439010,CSE 12,A01,083652,Staff,0,12,100,100
1650376445035,CSE 15L,A01,083654,Staff,0,1,50,50
1650376445035,CSE 15L,A02,083655,Staff,3,0,50,47
1650376451061,CSE 20,A01,083657,Staff,52,0,80,28
1650376457086,CSE 30,A01,083084,Eldon; John,0,76,40,40
1650376463113,CSE 100,A01,083659,Cao; Yingjun,0,66,50,50
1650376469140,CSE 134B,A01,083661,Powell; Thomas Allan,0,31,65,65
1650376475163,CSE 140,A01,083663,Staff,0,0,75,75
1650376481195,CSE 140L,A01,083088,Eldon; John,0,7,75,75
1650376487222,CSE 175,A01,083665,Kumar; Rakesh,8,0,25,17
1650376493247,CSE 190,A00,092507,Dubnov; Shlomo,14,0,20,6
1650376499273,ECE 45,A01,083139,Staff,0,17,40,40
1650376505295,ECE 65,A50,083695,Staff,0,5,30,30
1650376511319,ECE 109,A01,091882,Touri; Behrouz,40,0,70,30
1650376517353,ECE 180,A00,083140,Abi Samra; Nicholas Camill,23,0,30,7
1650376517353,ECE 180,B00,083141,Abi Samra; Nicholas Camill,5,0,30,25
1650376523381,MATH 10A,A01,083735,Patchell; Gregory David,7,0,30,23
1650376523381,MATH 10A,A02,083736,Patchell; Gregory David,28,0,30,2
1650376523381,MATH 10A,A03,083737,Patchell; Gregory David,25,0,30,5
1650376529405,MATH 10B,A01,083207,Staff,0,7,30,30
1650376529405,MATH 10B,A02,083208,Staff,0,6,30,30
1650376529405,MATH 10B,B01,083739,Staff,17,0,30,13
1650376529405,MATH 10B,B02,083740,Staff,28,0,30,2
1650376535434,MATH 18,A01,083743,Staff,3,0,30,27
1650376535434,MATH 18,A02,083744,Staff,27,0,30,3
1650376535434,MATH 18,A03,083745,Staff,22,0,30,8
1650376535434,MATH 18,A04,083746,Staff,27,0,30,3
1650376535434,MATH 18,B01,083748,Staff,0,11,30,30
1650376535434,MATH 18,B02,083749,Staff,0,12,30,30
1650376535434,MATH 18,B03,083750,Staff,0,11,30,30
1650376535434,MATH 18,B04,083751,Staff,0,9,30,30
1650376541458,MATH 20A,A01,083754,Staff,26,0,40,14
1650376547485,MATH 20B,A01,083756,Staff,0,8,30,30
1650376547485,MATH 20B,A02,083757,Staff,0,8,30,30
1650376553509,MATH 20C,A01,083760,Staff,0,14,30,30
1650376553509,MATH 20C,A02,083761,Staff,0,15,30,30
1650376553509,MATH 20C,B01,083762,Staff,13,0,30,17
1650376553509,MATH 20C,B02,083763,Staff,28,0,30,2
1650376559534,MATH 20D,A01,083765,Staff,0,1,30,30
1650376559534,MATH 20D,A02,083766,Staff,7,0,30,23
1650376559534,MATH 20D,A03,083767,Staff,26,0,30,4
1650376565560,MATH 20E,A01,083771,Staff,5,0,30,25
1650376565560,MATH 20E,A02,083772,Staff,19,0,30,11
1650376565560,MATH 20E,B01,083773,Staff,0,0,30,30
1650376565560,MATH 20E,B02,083774,Staff,12,0,30,18
1650376571590,MATH 103A,A01,083777,Staff,0,11,30,30
1650376571590,MATH 103A,A02,083778,Staff,0,12,30,30
1650376571590,MATH 103A,B01,083779,Staff,0,13,30,30
1650376571590,MATH 103A,B02,083780,Staff,0,11,30,30
1650376577615,MATH 105,A01,085443,Staff,0,21,30,30
1650376583640,MATH 109,A01,083213,Anzaldo; Leesa B,0,6,30,30
1650376583640,MATH 109,A02,083214,Anzaldo; Leesa B,0,7,30,30
1650376583640,MATH 109,B01,083215,Anzaldo; Leesa B,0,5,30,30
1650376583640,MATH 109,B02,083216,Anzaldo; Leesa B,0,5,30,30
1650376589669,MATH 142A,A01,083219,Chow; Bennett,0,14,30,30
1650376589669,MATH 142A,A02,083220,Chow; Bennett,0,13,30,30
1650376589669,MATH 142A,B01,083221,Chow; Bennett,0,12,30,30
1650376589669,MATH 142A,B02,083222,Chow; Bennett,0,12,30,30
1650376595696,MATH 193A,A01,083224,Staff,0,5,30,30
1650376595696,MATH 193A,A02,083225,Staff,0,5,30,30
1650376595696,MATH 193A,A03,083781,Staff,0,4,30,30
1650376595696,MATH 193A,A04,083782,Staff,0,4,30,30
1650376601723,MATH 197,001,091859,McAuley; Julian John,9998,0,9999,1
1650376607776,COGS 9,A01,083615,Staff,0,14,60,60
1650376613804,COGS 11,A01,083617,Boyle; Mary E. T.,22,0,40,18
1650376619834,COGS 13,A01,083071,Staff,0,32,40,40
1650376625864,COGS 14A,A01,092681,Staff,0,21,100,100
1650376631903,COGS 14B,A01,083073,Cheng; Tzu-Han,0,10,50,50
1650376637928,COGS 17,A01,092677,Staff,24,0,75,51
1650376643956,COGS 100,A01,083619,Staff,0,24,60,60
1650376650016,COGS 101A,A01,083621,Davis; Joshua Daniel,0,21,60,60
1650376656043,COGS 101B,A01,091572,Staff,0,0,60,60
1650376662066,COGS 101C,A01,083625,Delgado; Tania,17,0,30,13
1650376668090,COGS 107A,A01,083627,Boyle; Mary E. T.,0,10,60,60
1650376674126,COGS 118A,A01,083075,Staff,4,0,60,56
1650376680151,CSE 3,A50,083646,Miranda; Gregory Joseph,21,0,38,17
1650376680151,CSE 3,A51,083647,Miranda; Gregory Joseph,37,0,37,0
1650376686176,CSE 8A,A50,083650,Miranda; Gregory Joseph,0,28,40,40
1650376692205,CSE 11,A01,083080,Cao; Yingjun,0,88,40,40
1650376698240,CSE 12,A01,083652,Staff,0,12,100,100
1650376704263,CSE 15L,A01,083654,Staff,0,1,50,50
1650376704263,CSE 15L,A02,083655,Staff,3,0,50,47
1650376710286,CSE 20,A01,083657,Staff,52,0,80,28
1650376716319,CSE 30,A01,083084,Eldon; John,0,76,40,40
1650376722354,CSE 100,A01,083659,Cao; Yingjun,0,66,50,50
1650376728380,CSE 134B,A01,083661,Powell; Thomas Allan,0,31,65,65
1650376734410,CSE 140,A01,083663,Staff,0,0,75,75
1650376740436,CSE 140L,A01,083088,Eldon; John,0,7,75,75
1650376746462,CSE 175,A01,083665,Kumar; Rakesh,8,0,25,17
1650376752490,CSE 190,A00,092507,Dubnov; Shlomo,14,0,20,6
1650376758515,ECE 45,A01,083139,Staff,0,17,40,40
1650376764539,ECE 65,A50,083695,Staff,0,5,30,30
1650376770563,ECE 109,A01,091882,Touri; Behrouz,40,0,70,30
1650376776589,ECE 180,A00,083140,Abi Samra; Nicholas Camill,23,0,30,7
1650376776589,ECE 180,B00,083141,Abi Samra; Nicholas Camill,5,0,30,25
1650376782612,MATH 10A,A01,083735,Patchell; Gregory David,7,0,30,23
1650376782612,MATH 10A,A02,083736,Patchell; Gregory David,28,0,30,2
1650376782612,MATH 10A,A03,083737,Patchell; Gregory David,25,0,30,5
1650376788639,MATH 10B,A01,083207,Staff,0,7,30,30
1650376788639,MATH 10B,A02,083208,Staff,0,6,30,30
1650376788639,MATH 10B,B01,083739,Staff,17,0,30,13
1650376788639,MATH 10B,B02,083740,Staff,28,0,30,2
1650376794673,MATH 18,A01,083743,Staff,3,0,30,27
1650376794673,MATH 18,A02,083744,Staff,27,0,30,3
1650376794673,MATH 18,A03,083745,Staff,22,0,30,8
1650376794673,MATH 18,A04,083746,Staff,27,0,30,3
1650376794673,MATH 18,B01,083748,Staff,0,11,30,30
1650376794673,MATH 18,B02,083749,Staff,0,12,30,30
1650376794673,MATH 18,B03,083750,Staff,0,11,30,30
1650376794673,MATH 18,B04,083751,Staff,0,9,30,30
1650376800697,MATH 20A,A01,083754,Staff,26,0,40,14
1650376806723,MATH 20B,A01,083756,Staff,0,8,30,30
1650376806723,MATH 20B,A02,083757,Staff,0,8,30,30
1650376812766,MATH 20C,A01,083760,Staff,0,14,30,30
1650376812766,MATH 20C,A02,083761,Staff,0,15,30,30
1650376812766,MATH 20C,B01,083762,Staff,13,0,30,17
1650376812766,MATH 20C,B02,083763,Staff,28,0,30,2
1650376818798,MATH 20D,A01,083765,Staff,0,1,30,30
1650376818798,MATH 20D,A02,083766,Staff,7,0,30,23
1650376818798,MATH 20D,A03,083767,Staff,26,0,30,4
1650376824827,MATH 20E,A01,083771,Staff,5,0,30,25
1650376824827,MATH 20E,A02,083772,Staff,19,0,30,11
1650376824827,MATH 20E,B01,083773,Staff,0,0,30,30
1650376824827,MATH 20E,B02,083774,Staff,12,0,30,18
1650376830857,MATH 103A,A01,083777,Staff,0,11,30,30
1650376830857,MATH 103A,A02,083778,Staff,0,12,30,30
1650376830857,MATH 103A,B01,083779,Staff,0,13,30,30
1650376830857,MATH 103A,B02,083780,Staff,0,11,30,30
1650376836885,MATH 105,A01,085443,Staff,0,21,30,30
1650376842919,MATH 109,A01,083213,Anzaldo; Leesa B,0,6,30,30
1650376842919,MATH 109,A02,083214,Anzaldo; Leesa B,0,7,30,30
1650376842919,MATH 109,B01,083215,Anzaldo; Leesa B,0,5,30,30
1650376842919,MATH 109,B02,083216,Anzaldo; Leesa B,0,5,30,30
1650376848949,MATH 142A,A01,083219,Chow; Bennett,0,14,30,30
1650376848949,MATH 142A,A02,083220,Chow; Bennett,0,13,30,30
1650376848949,MATH 142A,B01,083221,Chow; Bennett,0,12,30,30
1650376848949,MATH 142A,B02,083222,Chow; Bennett,0,12,30,30
1650376854979,MATH 193A,A01,083224,Staff,0,5,30,30
1650376854979,MATH 193A,A02,083225,Staff,0,5,30,30
1650376854979,MATH 193A,A03,083781,Staff,0,4,30,30
1650376854979,MATH 193A,A04,083782,Staff,0,4,30,30
1650376861011,MATH 197,001,091859,McAuley; Julian John,9998,0,9999,1
1650376867071,COGS 9,A01,083615,Staff,0,14,60,60
1650376873113,COGS 11,A01,083617,Boyle; Mary E. T.,22,0,40,18
1650376879148,COGS 13,A01,083071,Staff,0,32,40,40
1650376885190,COGS 14A,A01,092681,Staff,0,21,100,100
1650376891217,COGS 14B,A01,083073,Cheng; Tzu-Han,0,10,50,50
1650376897246,COGS 17,A01,092677,Staff,24,0,75,51
1650376903273,COGS 100,A01,083619,Staff,0,24,60,60
1650376909303,COGS 101A,A01,083621,Davis; Joshua Daniel,0,21,60,60
1650376915333,COGS 101B,A01,091572,Staff,0,0,60,60
1650376921357,COGS 101C,A01,083625,Delgado; Tania,17,0,30,13
1650376927385,COGS 107A,A01,083627,Boyle; Mary E. T.,0,10,60,60
1650376933413,COGS 118A,A01,083075,Staff,4,0,60,56
1650376939438,CSE 3,A50,083646,Miranda; Gregory Joseph,21,0,38,17
1650376939438,CSE 3,A51,083647,Miranda; Gregory Joseph,37,0,37,0
1650376945467,CSE 8A,A50,083650,Miranda; Gregory Joseph,0,28,40,40
1650376951492,CSE 11,A01,083080,Cao; Yingjun,0,88,40,40
1650376957521,CSE 12,A01,083652,Staff,0,12,100,100
1650376963545,CSE 15L,A01,083654,Staff,0,1,50,50
1650376963545,CSE 15L,A02,083655,Staff,3,0,50,47
1650376969574,CSE 20,A01,083657,Staff,52,0,80,28
1650376975598,CSE 30,A01,083084,Eldon; John,0,76,40,40
1650376981626,CSE 100,A01,083659,Cao; Yingjun,0,66,50,50
1650376987653,CSE 134B,A01,083661,Powell; Thomas Allan,0,31,65,65
1650376993692,CSE 140,A01,083663,Staff,0,0,75,75
1650376999721,CSE 140L,A01,083088,Eldon; John,0,7,75,75
1650377005748,CSE 175,A01,083665,Kumar; Rakesh,8,0,25,17
1650377011776,CSE 190,A00,092507,Dubnov; Shlomo,14,0,20,6
1650377017801,ECE 45,A01,083139,Staff,0,17,40,40
1650377023826,ECE 65,A50,083695,Staff,0,5,30,30
1650377029857,ECE 109,A01,091882,Touri; Behrouz,40,0,70,30
1650377035977,ECE 180,A00,083140,Abi Samra; Nicholas Camill,23,0,30,7
1650377035977,ECE 180,B00,083141,Abi Samra; Nicholas Camill,5,0,30,25
1650377042007,MATH 10A,A01,083735,Patchell; Gregory David,7,0,30,23
1650377042007,MATH 10A,A02,083736,Patchell; Gregory David,28,0,30,2
1650377042007,MATH 10A,A03,083737,Patchell; Gregory David,25,0,30,5
1650377048037,MATH 10B,A01,083207,Staff,0,7,30,30
1650377048037,MATH 10B,A02,083208,Staff,0,6,30,30
1650377048037,MATH 10B,B01,083739,Staff,17,0,30,13
1650377048037,MATH 10B,B02,083740,Staff,28,0,30,2
1650377054067,MATH 18,A01,083743,Staff,3,0,30,27
1650377054067,MATH 18,A02,083744,Staff,27,0,30,3
1650377054067,MATH 18,A03,083745,Staff,22,0,30,8
1650377054067,MATH 18,A04,083746,Staff,27,0,30,3
1650377054067,MATH 18,B01,083748,Staff,0,11,30,30
1650377054067,MATH 18,B02,083749,Staff,0,12,30,30
1650377054067,MATH 18,B03,083750,Staff,0,11,30,30
1650377054067,MATH 18,B04,083751,Staff,0,9,30,30
1650377060092,MATH 20A,A01,083754,Staff,26,0,40,14
1650377066117,MATH 20B,A01,083756,Staff,0,8,30,30
1650377066117,MATH 20B,A02,083757,Staff,0,8,30,30
1650377072142,MATH 20C,A01,083760,Staff,0,14,30,30
1650377072142,MATH 20C,A02,083761,Staff,0,15,30,30
1650377072142,MATH 20C,B01,083762,Staff,13,0,30,17
1650377072142,MATH 20C,B02,083763,Staff,28,0,30,2
1650377078170,MATH 20D,A01,083765,Staff,0,1,30,30
1650377078170,MATH 20D,A02,083766,Staff,7,0,30,23
1650377078170,MATH 20D,A03,083767,Staff,26,0,30,4
1650377084196,MATH 20E,A01,083771,Staff,5,0,30,25
1650377084196,MATH 20E,A02,083772,Staff,19,0,30,11
1650377084196,MATH 20E,B01,083773,Staff,0,0,30,30
1650377084196,MATH 20E,B02,083774,Staff,12,0,30,18
1650377090226,MATH 103A,A01,083777,Staff,0,11,30,30
1650377090226,MATH 103A,A02,083778,Staff,0,12,30,30
1650377090226,MATH 103A,B01,083779,Staff,0,13,30,30
1650377090226,MATH 103A,B02,083780,Staff,0,11,30,30
1650377096251,MATH 105,A01,085443,Staff,0,21,30,30
1650377102284,MATH 109,A01,083213,Anzaldo; Leesa B,0,6,30,30
1650377102284,MATH 109,A02,083214,Anzaldo; Leesa B,0,7,30,30
1650377102284,MATH 109,B01,083215,Anzaldo; Leesa B,0,5,30,30
1650377102284,MATH 109,B02,083216,Anzaldo; Leesa B,0,5,30,30
1650377108326,MATH 142A,A01,083219,Chow; Bennett,0,14,30,30
1650377108326,MATH 142A,A02,083220,Chow; Bennett,0,13,30,30
1650377108326,MATH 142A,B01,083221,Chow; Bennett,0,12,30,30
1650377108326,MATH 142A,B02,083222,Chow; Bennett,0,12,30,30
1650377114356,MATH 193A,A01,083224,Staff,0,5,30,30
1650377114356,MATH 193A,A02,083225,Staff,0,5,30,30
1650377114356,MATH 193A,A03,083781,Staff,0,4,30,30
1650377114356,MATH 193A,A04,083782,Staff,0,4,30,30
1650377120385,MATH 197,001,091859,McAuley; Julian John,9998,0,9999,1
1650377126447,COGS 9,A01,083615,Staff,0,14,60,60
1650377132472,COGS 11,A01,083617,Boyle; Mary E. T.,22,0,40,18
1650377138502,COGS 13,A01,083071,Staff,0,32,40,40
1650377144528,COGS 14A,A01,092681,Staff,0,21,100,100
1650377150557,COGS 14B,A01,083073,Cheng; Tzu-Han,0,10,50,50
1650377156585,COGS 17,A01,092677,Staff,24,0,75,51
1650377162610,COGS 100,A01,083619,Staff,0,24,60,60
1650377168643,COGS 101A,A01,083621,Davis; Joshua Daniel,0,21,60,60
1650377174665,COGS 101B,A01,091572,Staff,0,0,60,60
1650377180690,COGS 101C,A01,083625,Delgado; Tania,17,0,30,13
1650377186716,COGS 107A,A01,083627,Boyle; Mary E. T.,0,10,60,60
1650377192744,COGS 118A,A01,083075,Staff,4,0,60,56
1650377198774,CSE 3,A50,083646,Miranda; Gregory Joseph,21,0,38,17
1650377198774,CSE 3,A51,083647,Miranda; Gregory Joseph,37,0,37,0
1650377204798,CSE 8A,A50,083650,Miranda; Gregory Joseph,0,28,40,40
1650377210826,CSE 11,A01,083080,Cao; Yingjun,0,88,40,40
1650377216854,CSE 12,A01,083652,Staff,0,12,100,100
1650377222886,CSE 15L,A01,083654,Staff,0,1,50,50
1650377222886,CSE 15L,A02,083655,Staff,3,0,50,47
1650377228910,CSE 20,A01,083657,Staff,52,0,80,28
1650377234933,CSE 30,A01,083084,Eldon; John,0,76,40,40
1650377240957,CSE 100,A01,083659,Cao; Yingjun,0,66,50,50
1650377246982,CSE 134B,A01,083661,Powell; Thomas Allan,0,31,65,65
1650377253010,CSE 140,A01,083663,Staff,0,0,75,75
1650377259038,CSE 140L,A01,083088,Eldon; John,0,7,75,75
1650377265075,CSE 175,A01,083665,Kumar; Rakesh,8,0,25,17
1650377271102,CSE 190,A00,092507,Dubnov; Shlomo,14,0,20,6
1650377277127,ECE 45,A01,083139,Staff,0,17,40,40
1650377283152,ECE 65,A50,083695,Staff,0,5,30,30
1650377289179,ECE 109,A01,091882,Touri; Behrouz,40,0,70,30
1650377295223,ECE 180,A00,083140,Abi Samra; Nicholas Camill,23,0,30,7
1650377295223,ECE 180,B00,083141,Abi Samra; Nicholas Camill,5,0,30,25
1650377301248,MATH 10A,A01,083735,Patchell; Gregory David,7,0,30,23
1650377301248,MATH 10A,A02,083736,Patchell; Gregory David,28,0,30,2
1650377301248,MATH 10A,A03,083737,Patchell; Gregory David,25,0,30,5
1650377307273,MATH 10B,A01,083207,Staff,0,7,30,30
1650377307273,MATH 10B,A02,083208,Staff,0,6,30,30
1650377307273,MATH 10B,B01,083739,Staff,17,0,30,13
1650377307273,MATH 10B,B02,083740,Staff,28,0,30,2
1650377313302,MATH 18,A01,083743,Staff,3,0,30,27
1650377313302,MATH 18,A02,083744,Staff,27,0,30,3
1650377313302,MATH 18,A03,083745,Staff,22,0,30,8
1650377313302,MATH 18,A04,083746,Staff,27,0,30,3
1650377313302,MATH 18,B01,083748,Staff,0,11,30,30
1650377313302,MATH 18,B02,083749,Staff,0,12,30,30
1650377313302,MATH 18,B03,083750,Staff,0,11,30,30
1650377313302,MATH 18,B04,083751,Staff,0,9,30,30
1650377319343,MATH 20A,A01,083754,Staff,26,0,40,14
1650377325369,MATH 20B,A01,083756,Staff,0,8,30,30
1650377325369,MATH 20B,A02,083757,Staff,0,8,30,30
1650377331394,MATH 20C,A01,083760,Staff,0,14,30,30
1650377331394,MATH 20C,A02,083761,Staff,0,15,30,30
1650377331394,MATH 20C,B01,083762,Staff,13,0,30,17
1650377331394,MATH 20C,B02,083763,Staff,28,0,30,2
1650377337422,MATH 20D,A01,083765,Staff,0,1,30,30
1650377337422,MATH 20D,A02,083766,Staff,7,0,30,23
1650377337422,MATH 20D,A03,083767,Staff,26,0,30,4
1650377343451,MATH 20E,A01,083771,Staff,5,0,30,25
1650377343451,MATH 20E,A02,083772,Staff,19,0,30,11
1650377343451,MATH 20E,B01,083773,Staff,0,0,30,30
1650377343451,MATH 20E,B02,083774,Staff,12,0,30,18
1650377349477,MATH 103A,A01,083777,Staff,0,11,30,30
1650377349477,MATH 103A,A02,083778,Staff,0,12,30,30
1650377349477,MATH 103A,B01,083779,Staff,0,13,30,30
1650377349477,MATH 103A,B02,083780,Staff,0,11,30,30
1650377355504,MATH 105,A01,085443,Staff,0,21,30,30
1650377361527,MATH 109,A01,083213,Anzaldo; Leesa B,0,6,30,30
1650377361527,MATH 109,A02,083214,Anzaldo; Leesa B,0,7,30,30
1650377361527,MATH 109,B01,083215,Anzaldo; Leesa B,0,5,30,30
1650377361527,MATH 109,B02,083216,Anzaldo; Leesa B,0,5,30,30
1650377367553,MATH 142A,A01,083219,Chow; Bennett,0,14,30,30
1650377367553,MATH 142A,A02,083220,Chow; Bennett,0,13,30,30
1650377367553,MATH 142A,B01,083221,Chow; Bennett,0,12,30,30
1650377367553,MATH 142A,B02,083222,Chow; Bennett,0,12,30,30
1650377373585,MATH 193A,A01,083224,Staff,0,5,30,30
1650377373585,MATH 193A,A02,083225,Staff,0,5,30,30
1650377373585,MATH 193A,A03,083781,Staff,0,4,30,30
1650377373585,MATH 193A,A04,083782,Staff,0,4,30,30
1650377379608,MATH 197,001,091859,McAuley; Julian John,9998,0,9999,1
1650377385672,COGS 9,A01,083615,Staff,0,14,60,60
1650377391700,COGS 11,A01,083617,Boyle; Mary E. T.,22,0,40,18
1650377397724,COGS 13,A01,083071,Staff,0,32,40,40
1650377403747,COGS 14A,A01,092681,Staff,0,22,100,100
1650377409772,COGS 14B,A01,083073,Cheng; Tzu-Han,0,10,50,50
1650377415807,COGS 17,A01,092677,Staff,24,0,75,51
1650377421832,COGS 100,A01,083619,Staff,0,24,60,60
1650377427858,COGS 101A,A01,083621,Davis; Joshua Daniel,0,21,60,60
1650377433886,COGS 101B,A01,091572,Staff,0,0,60,60
1650377439912,COGS 101C,A01,083625,Delgado; Tania,17,0,30,13
1650377445941,COGS 107A,A01,083627,Boyle; Mary E. T.,0,10,60,60
1650377451974,COGS 118A,A01,083075,Staff,4,0,60,56
1650377457998,CSE 3,A50,083646,Miranda; Gregory Joseph,21,0,38,17
1650377457998,CSE 3,A51,083647,Miranda; Gregory Joseph,37,0,37,0
1650377464026,CSE 8A,A50,083650,Miranda; Gregory Joseph,0,28,40,40
1650377470053,CSE 11,A01,083080,Cao; Yingjun,0,88,40,40
1650377476080,CSE 12,A01,083652,Staff,0,12,100,100
1650377482105,CSE 15L,A01,083654,Staff,0,1,50,50
1650377482105,CSE 15L,A02,083655,Staff,3,0,50,47
1650377488129,CSE 20,A01,083657,Staff,52,0,80,28
1650377494154,CSE 30,A01,083084,Eldon; John,0,76,40,40
1650377500182,CSE 100,A01,083659,Cao; Yingjun,0,66,50,50
1650377506214,CSE 134B,A01,083661,Powell; Thomas Allan,0,31,65,65
1650377512238,CSE 140,A01,083663,Staff,0,0,75,75
1650377518263,CSE 140L,A01,083088,Eldon; John,0,7,75,75
1650377524291,CSE 175,A01,083665,Kumar; Rakesh,8,0,25,17
1650377530339,CSE 190,A00,092507,Dubnov; Shlomo,14,0,20,6
1650377536381,ECE 45,A01,083139,Staff,0,17,40,40
1650377542408,ECE 65,A50,083695,Staff,0,5,30,30
1650377548437,ECE 109,A01,091882,Touri; Behrouz,40,0,70,30
1650377554468,ECE 180,A00,083140,Abi Samra; Nicholas Camill,23,0,30,7
1650377554468,ECE 180,B00,083141,Abi Samra; Nicholas Camill,5,0,30,25
1650377560507,MATH 10A,A01,083735,Patchell; Gregory David,7,0,30,23
1650377560507,MATH 10A,A02,083736,Patchell; Gregory David,28,0,30,2
1650377560507,MATH 10A,A03,083737,Patchell; Gregory David,25,0,30,5
1650377566536,MATH 10B,A01,083207,Staff,0,7,30,30
1650377566536,MATH 10B,A02,083208,Staff,0,6,30,30
1650377566536,MATH 10B,B01,083739,Staff,17,0,30,13
1650377566536,MATH 10B,B02,083740,Staff,28,0,30,2
1650377572561,MATH 18,A01,083743,Staff,3,0,30,27
1650377572561,MATH 18,A02,083744,Staff,27,0,30,3
1650377572561,MATH 18,A03,083745,Staff,22,0,30,8
1650377572561,MATH 18,A04,083746,Staff,27,0,30,3
1650377572561,MATH 18,B01,083748,Staff,0,11,30,30
1650377572561,MATH 18,B02,083749,Staff,0,12,30,30
1650377572561,MATH 18,B03,083750,Staff,0,11,30,30
1650377572561,MATH 18,B04,083751,Staff,0,9,30,30
1650377578587,MATH 20A,A01,083754,Staff,26,0,40,14
1650377584617,MATH 20B,A01,083756,Staff,0,8,30,30
1650377584617,MATH 20B,A02,083757,Staff,0,8,30,30
1650377590643,MATH 20C,A01,083760,Staff,0,14,30,30
1650377590643,MATH 20C,A02,083761,Staff,0,15,30,30
1650377590643,MATH 20C,B01,083762,Staff,13,0,30,17
1650377590643,MATH 20C,B02,083763,Staff,28,0,30,2
1650377596672,MATH 20D,A01,083765,Staff,0,1,30,30
1650377596672,MATH 20D,A02,083766,Staff,7,0,30,23
1650377596672,MATH 20D,A03,083767,Staff,26,0,30,4
1650377602699,MATH 20E,A01,083771,Staff,5,0,30,25
1650377602699,MATH 20E,A02,083772,Staff,19,0,30,11
1650377602699,MATH 20E,B01,083773,Staff,0,0,30,30
1650377602699,MATH 20E,B02,083774,Staff,12,0,30,18
1650377608726,MATH 103A,A01,083777,Staff,0,11,30,30
1650377608726,MATH 103A,A02,083778,Staff,0,12,30,30
1650377608726,MATH 103A,B01,083779,Staff,0,13,30,30
1650377608726,MATH 103A,B02,083780,Staff,0,11,30,30
1650377614752,MATH 105,A01,085443,Staff,0,21,30,30
1650377620777,MATH 109,A01,083213,Anzaldo; Leesa B,0,6,30,30
1650377620777,MATH 109,A02,083214,Anzaldo; Leesa B,0,7,30,30
1650377620777,MATH 109,B01,083215,Anzaldo; Leesa B,0,5,30,30
1650377620777,MATH 109,B02,083216,Anzaldo; Leesa B,0,5,30,30
1650377626813,MATH 142A,A01,083219,Chow; Bennett,0,14,30,30
1650377626813,MATH 142A,A02,083220,Chow; Bennett,0,13,30,30
1650377626813,MATH 142A,B01,083221,Chow; Bennett,0,12,30,30
1650377626813,MATH 142A,B02,083222,Chow; Bennett,0,12,30,30
1650377632931,MATH 193A,A01,083224,Staff,0,5,30,30
1650377632931,MATH 193A,A02,083225,Staff,0,5,30,30
1650377632931,MATH 193A,A03,083781,Staff,0,4,30,30
1650377632931,MATH 193A,A04,083782,Staff,0,4,30,30
1650377638972,MATH 197,001,091859,McAuley; Julian John,9998,0,9999,1
1650377645038,COGS 9,A01,083615,Staff,0,14,60,60
1650377651062,COGS 11,A01,083617,Boyle; Mary E. T.,22,0,40,18
1650377657086,COGS 13,A01,083071,Staff,0,32,40,40
1650377663114,COGS 14A,A01,092681,Staff,0,22,100,100
1650377669140,COGS 14B,A01,083073,Cheng; Tzu-Han,0,10,50,50
1650377675173,COGS 17,A01,092677,Staff,24,0,75,51
1650377681196,COGS 100,A01,083619,Staff,0,24,60,60
1650377687221,COGS 101A,A01,083621,Davis; Joshua Daniel,0,21,60,60
1650377693253,COGS 101B,A01,091572,Staff,0,0,60,60
1650377699277,COGS 101C,A01,083625,Delgado; Tania,17,0,30,13
1650377705301,COGS 107A,A01,083627,Boyle; Mary E. T.,0,10,60,60
1650377711325,COGS 118A,A01,083075,Staff,4,0,60,56
1650377717350,CSE 3,A50,083646,Miranda; Gregory Joseph,21,0,38,17
1650377717350,CSE 3,A51,083647,Miranda; Gregory Joseph,37,0,37,0
1650377723381,CSE 8A,A50,083650,Miranda; Gregory Joseph,0,28,40,40
1650377729408,CSE 11,A01,083080,Cao; Yingjun,0,88,40,40
1650377735436,CSE 12,A01,083652,Staff,0,12,100,100
1650377741461,CSE 15L,A01,083654,Staff,0,1,50,50
1650377741461,CSE 15L,A02,083655,Staff,3,0,50,47
1650377747489,CSE 20,A01,083657,Staff,52,0,80,28
1650377753517,CSE 30,A01,083084,Eldon; John,0,76,40,40
1650377759548,CSE 100,A01,083659,Cao; Yingjun,0,66,50,50
1650377765578,CSE 134B,A01,083661,Powell; Thomas Allan,0,31,65,65
1650377771605,CSE 140,A01,083663,Staff,0,0,75,75
1650377777632,CSE 140L,A01,083088,Eldon; John,0,7,75,75
1650377783655,CSE 175,A01,083665,Kumar; Rakesh,8,0,25,17
1650377789690,CSE 190,A00,092507,Dubnov; Shlomo,14,0,20,6
1650377795718,ECE 45,A01,083139,Staff,0,17,40,40
1650377801743,ECE 65,A50,083695,Staff,0,5,30,30
1650377807769,ECE 109,A01,091882,Touri; Behrouz,40,0,70,30
1650377813795,ECE 180,A00,083140,Abi Samra; Nicholas Camill,23,0,30,7
1650377813795,ECE 180,B00,083141,Abi Samra; Nicholas Camill,5,0,30,25
1650377819821,MATH 10A,A01,083735,Patchell; Gregory David,7,0,30,23
1650377819821,MATH 10A,A02,083736,Patchell; Gregory David,28,0,30,2
1650377819821,MATH 10A,A03,083737,Patchell; Gregory David,25,0,30,5
1650377825869,MATH 10B,A01,083207,Staff,0,7,30,30
1650377825869,MATH 10B,A02,083208,Staff,0,6,30,30
1650377825869,MATH 10B,B01,083739,Staff,17,0,30,13
1650377825869,MATH 10B,B02,083740,Staff,28,0,30,2
1650377831896,MATH 18,A01,083743,Staff,3,0,30,27
1650377831896,MATH 18,A02,083744,Staff,27,0,30,3
1650377831896,MATH 18,A03,083745,Staff,22,0,30,8
1650377831896,MATH 18,A04,083746,Staff,27,0,30,3
1650377831896,MATH 18,B01,083748,Staff,0,11,30,30
1650377831896,MATH 18,B02,083749,Staff,0,12,30,30
1650377831896,MATH 18,B03,083750,Staff,0,11,30,30
1650377831896,MATH 18,B04,083751,Staff,0,9,30,30
1650377837922,MATH 20A,A01,083754,Staff,26,0,40,14
1650377843947,MATH 20B,A01,083756,Staff,0,8,30,30
1650377843947,MATH 20B,A02,083757,Staff,0,8,30,30
1650377849972,MATH 20C,A01,083760,Staff,0,14,30,30
1650377849972,MATH 20C,A02,083761,Staff,0,15,30,30
1650377849972,MATH 20C,B01,083762,Staff,13,0,30,17
1650377849972,MATH 20C,B02,083763,Staff,28,0,30,2
1650377855998,MATH 20D,A01,083765,Staff,0,1,30,30
1650377855998,MATH 20D,A02,083766,Staff,7,0,30,23
1650377855998,MATH 20D,A03,083767,Staff,26,0,30,4
1650377862031,MATH 20E,A01,083771,Staff,5,0,30,25
1650377862031,MATH 20E,A02,083772,Staff,19,0,30,11
1650377862031,MATH 20E,B01,083773,Staff,0,0,30,30
1650377862031,MATH 20E,B02,083774,Staff,12,0,30,18
1650377868062,MATH 103A,A01,083777,Staff,0,11,30,30
1650377868062,MATH 103A,A02,083778,Staff,0,12,30,30
1650377868062,MATH 103A,B01,083779,Staff,0,13,30,30
1650377868062,MATH 103A,B02,083780,Staff,0,11,30,30
1650377874087,MATH 105,A01,085443,Staff,0,21,30,30
1650377880112,MATH 109,A01,083213,Anzaldo; Leesa B,0,6,30,30
1650377880112,MATH 109,A02,083214,Anzaldo; Leesa B,0,7,30,30
1650377880112,MATH 109,B01,083215,Anzaldo; Leesa B,0,5,30,30
1650377880112,MATH 109,B02,083216,Anzaldo; Leesa B,0,5,30,30
1650377886136,MATH 142A,A01,083219,Chow; Bennett,0,14,30,30
1650377886136,MATH 142A,A02,083220,Chow; Bennett,0,13,30,30
1650377886136,MATH 142A,B01,083221,Chow; Bennett,0,12,30,30
1650377886136,MATH 142A,B02,083222,Chow; Bennett,0,12,30,30
1650377892167,MATH 193A,A01,083224,Staff,0,5,30,30
1650377892167,MATH 193A,A02,083225,Staff,0,5,30,30
1650377892167,MATH 193A,A03,083781,Staff,0,4,30,30
1650377892167,MATH 193A,A04,083782,Staff,0,4,30,30
1650377898191,MATH 197,001,091859,McAuley; Julian John,9998,0,9999,1
1650377904251,COGS 9,A01,083615,Staff,0,14,60,60
1650377910276,COGS 11,A01,083617,Boyle; Mary E. T.,22,0,40,18
1650377916305,COGS 13,A01,083071,Staff,0,32,40,40
1650377922330,COGS 14A,A01,092681,Staff,0,22,100,100
1650377928356,COGS 14B,A01,083073,Cheng; Tzu-Han,0,10,50,50
1650377934383,COGS 17,A01,092677,Staff,24,0,75,51
1650377940408,COGS 100,A01,083619,Staff,0,24,60,60
1650377946434,COGS 101A,A01,083621,Davis; Joshua Daniel,0,21,60,60
1650377952457,COGS 101B,A01,091572,Staff,0,0,60,60
1650377958480,COGS 101C,A01,083625,Delgado; Tania,17,0,30,13
1650377964506,COGS 107A,A01,083627,Boyle; Mary E. T.,0,10,60,60
1650377970533,COGS 118A,A01,083075,Staff,4,0,60,56
1650377976559,CSE 3,A50,083646,Miranda; Gregory Joseph,21,0,38,17
1650377976559,CSE 3,A51,083647,Miranda; Gregory Joseph,37,0,37,0
1650377982592,CSE 8A,A50,083650,Miranda; Gregory Joseph,0,28,40,40
1650377988616,CSE 11,A01,083080,Cao; Yingjun,0,88,40,40
1650377994651,CSE 12,A01,083652,Staff,0,12,100,100
1650378000687,CSE 15L,A01,083654,Staff,0,1,50,50
1650378000687,CSE 15L,A02,083655,Staff,3,0,50,47
1650378006714,CSE 20,A01,083657,Staff,52,0,80,28
1650378012739,CSE 30,A01,083084,Eldon; John,0,76,40,40
1650378018766,CSE 100,A01,083659,Cao; Yingjun,0,66,50,50
1650378024797,CSE 134B,A01,083661,Powell; Thomas Allan,0,31,65,65
1650378030826,CSE 140,A01,083663,Staff,0,0,75,75
1650378036851,CSE 140L,A01,083088,Eldon; John,0,7,75,75
1650378042880,CSE 175,A01,083665,Kumar; Rakesh,8,0,25,17
1650378048907,CSE 190,A00,092507,Dubnov; Shlomo,14,0,20,6
1650378054950,ECE 45,A01,083139,Staff,0,17,40,40
1650378060979,ECE 65,A50,083695,Staff,0,5,30,30
1650378067006,ECE 109,A01,091882,Touri; Behrouz,40,0,70,30
1650378073030,ECE 180,A00,083140,Abi Samra; Nicholas Camill,23,0,30,7
1650378073030,ECE 180,B00,083141,Abi Samra; Nicholas Camill,5,0,30,25
1650378079056,MATH 10A,A01,083735,Patchell; Gregory David,7,0,30,23
1650378079056,MATH 10A,A02,083736,Patchell; Gregory David,28,0,30,2
1650378079056,MATH 10A,A03,083737,Patchell; Gregory David,25,0,30,5
1650378085082,MATH 10B,A01,083207,Staff,0,7,30,30
1650378085082,MATH 10B,A02,083208,Staff,0,6,30,30
1650378085082,MATH 10B,B01,083739,Staff,17,0,30,13
1650378085082,MATH 10B,B02,083740,Staff,28,0,30,2
1650378091118,MATH 18,A01,083743,Staff,3,0,30,27
1650378091118,MATH 18,A02,083744,Staff,27,0,30,3
1650378091118,MATH 18,A03,083745,Staff,22,0,30,8
1650378091118,MATH 18,A04,083746,Staff,27,0,30,3
1650378091118,MATH 18,B01,083748,Staff,0,11,30,30
1650378091118,MATH 18,B02,083749,Staff,0,12,30,30
1650378091118,MATH 18,B03,083750,Staff,0,11,30,30
1650378091118,MATH 18,B04,083751,Staff,0,9,30,30
1650378097144,MATH 20A,A01,083754,Staff,26,0,40,14
1650378103169,MATH 20B,A01,083756,Staff,0,8,30,30
1650378103169,MATH 20B,A02,083757,Staff,0,8,30,30
1650378109198,MATH 20C,A01,083760,Staff,0,14,30,30
1650378109198,MATH 20C,A02,083761,Staff,0,15,30,30
1650378109198,MATH 20C,B01,083762,Staff,13,0,30,17
1650378109198,MATH 20C,B02,083763,Staff,28,0,30,2
1650378115231,MATH 20D,A01,083765,Staff,0,1,30,30
1650378115231,MATH 20D,A02,083766,Staff,7,0,30,23
1650378115231,MATH 20D,A03,083767,Staff,26,0,30,4
1650378121258,MATH 20E,A01,083771,Staff,5,0,30,25
1650378121258,MATH 20E,A02,083772,Staff,19,0,30,11
1650378121258,MATH 20E,B01,083773,Staff,0,0,30,30
1650378121258,MATH 20E,B02,083774,Staff,12,0,30,18
1650378127287,MATH 103A,A01,083777,Staff,0,11,30,30
1650378127287,MATH 103A,A02,083778,Staff,0,12,30,30
1650378127287,MATH 103A,B01,083779,Staff,0,13,30,30
1650378127287,MATH 103A,B02,083780,Staff,0,11,30,30
1650378133312,MATH 105,A01,085443,Staff,0,21,30,30
1650378139342,MATH 109,A01,083213,Anzaldo; Leesa B,0,6,30,30
1650378139342,MATH 109,A02,083214,Anzaldo; Leesa B,0,7,30,30
1650378139342,MATH 109,B01,083215,Anzaldo; Leesa B,0,5,30,30
1650378139342,MATH 109,B02,083216,Anzaldo; Leesa B,0,5,30,30
1650378145368,MATH 142A,A01,083219,Chow; Bennett,0,14,30,30
1650378145368,MATH 142A,A02,083220,Chow; Bennett,0,13,30,30
1650378145368,MATH 142A,B01,083221,Chow; Bennett,0,12,30,30
1650378145368,MATH 142A,B02,083222,Chow; Bennett,0,12,30,30
1650378151395,MATH 193A,A01,083224,Staff,0,5,30,30
1650378151395,MATH 193A,A02,083225,Staff,0,5,30,30
1650378151395,MATH 193A,A03,083781,Staff,0,4,30,30
1650378151395,MATH 193A,A04,083782,Staff,0,4,30,30
1650378157419,MATH 197,001,091859,McAuley; Julian John,9998,0,9999,1
1650378163476,COGS 9,A01,083615,Staff,0,14,60,60
1650378169502,COGS 11,A01,083617,Boyle; Mary E. T.,22,0,40,18
1650378175541,COGS 13,A01,083071,Staff,0,32,40,40
1650378181567,COGS 14A,A01,092681,Staff,0,22,100,100
1650378187596,COGS 14B,A01,083073,Cheng; Tzu-Han,0,10,50,50
1650378193621,COGS 17,A01,092677,Staff,24,0,75,51
1650378199661,COGS 100,A01,083619,Staff,0,24,60,60
1650378205689,COGS 101A,A01,083621,Davis; Joshua Daniel,0,21,60,60
1650378211717,COGS 101B,A01,091572,Staff,0,0,60,60
1650378217742,COGS 101C,A01,083625,Delgado; Tania,17,0,30,13
1650378223870,COGS 107A,A01,083627,Boyle; Mary E. T.,0,10,60,60
1650378229903,COGS 118A,A01,083075,Staff,4,0,60,56
1650378235945,CSE 3,A50,083646,Miranda; Gregory Joseph,21,0,38,17
1650378235945,CSE 3,A51,083647,Miranda; Gregory Joseph,37,0,37,0
1650378241975,CSE 8A,A50,083650,Miranda; Gregory Joseph,0,28,40,40
1650378248003,CSE 11,A01,083080,Cao; Yingjun,0,88,40,40
1650378254032,CSE 12,A01,083652,Staff,0,12,100,100
1650378260064,CSE 15L,A01,083654,Staff,0,1,50,50
1650378260064,CSE 15L,A02,083655,Staff,3,0,50,47
1650378266088,CSE 20,A01,083657,Staff,52,0,80,28
1650378272114,CSE 30,A01,083084,Eldon; John,0,76,40,40
1650378278138,CSE 100,A01,083659,Cao; Yingjun,0,66,50,50
1650378284167,CSE 134B,A01,083661,Powell; Thomas Allan,0,31,65,65
1650378290194,CSE 140,A01,083663,Staff,0,0,75,75
1650378296217,CSE 140L,A01,083088,Eldon; John,0,7,75,75
1650378302240,CSE 175,A01,083665,Kumar; Rakesh,8,0,25,17
1650378308270,CSE 190,A00,092507,Dubnov; Shlomo,14,0,20,6
1650378314297,ECE 45,A01,083139,Staff,0,17,40,40
1650378320319,ECE 65,A50,083695,Staff,0,5,30,30
1650378326344,ECE 109,A01,091882,Touri; Behrouz,40,0,70,30
1650378332374,ECE 180,A00,083140,Abi Samra; Nicholas Camill,23,0,30,7
1650378332374,ECE 180,B00,083141,Abi Samra; Nicholas Camill,5,0,30,25
1650378338404,MATH 10A,A01,083735,Patchell; Gregory David,7,0,30,23
1650378338404,MATH 10A,A02,083736,Patchell; Gregory David,28,0,30,2
1650378338404,MATH 10A,A03,083737,Patchell; Gregory David,25,0,30,5
1650378344430,MATH 10B,A01,083207,Staff,0,7,30,30
1650378344430,MATH 10B,A02,083208,Staff,0,6,30,30
1650378344430,MATH 10B,B01,083739,Staff,17,0,30,13
1650378344430,MATH 10B,B02,083740,Staff,28,0,30,2
1650378350456,MATH 18,A01,083743,Staff,3,0,30,27
1650378350456,MATH 18,A02,083744,Staff,27,0,30,3
1650378350456,MATH 18,A03,083745,Staff,22,0,30,8
1650378350456,MATH 18,A04,083746,Staff,27,0,30,3
1650378350456,MATH 18,B01,083748,Staff,0,11,30,30
1650378350456,MATH 18,B02,083749,Staff,0,12,30,30
1650378350456,MATH 18,B03,083750,Staff,0,11,30,30
1650378350456,MATH 18,B04,083751,Staff,0,9,30,30
1650378356481,MATH 20A,A01,083754,Staff,26,0,40,14
1650378362506,MATH 20B,A01,083756,Staff,0,8,30,30
1650378362506,MATH 20B,A02,083757,Staff,0,8,30,30
1650378368531,MATH 20C,A01,083760,Staff,0,14,30,30
1650378368531,MATH 20C,A02,083761,Staff,0,15,30,30
1650378368531,MATH 20C,B01,083762,Staff,13,0,30,17
1650378368531,MATH 20C,B02,083763,Staff,28,0,30,2
1650378374559,MATH 20D,A01,083765,Staff,0,1,30,30
1650378374559,MATH 20D,A02,083766,Staff,7,0,30,23
1650378374559,MATH 20D,A03,083767,Staff,26,0,30,4
1650378380593,MATH 20E,A01,083771,Staff,5,0,30,25
1650378380593,MATH 20E,A02,083772,Staff,19,0,30,11
1650378380593,MATH 20E,B01,083773,Staff,0,0,30,30
1650378380593,MATH 20E,B02,083774,Staff,12,0,30,18
1650378386623,MATH 103A,A01,083777,Staff,0,11,30,30
1650378386623,MATH 103A,A02,083778,Staff,0,12,30,30
1650378386623,MATH 103A,B01,083779,Staff,0,13,30,30
1650378386623,MATH 103A,B02,083780,Staff,0,11,30,30
1650378392650,MATH 105,A01,085443,Staff,0,21,30,30
1650378398676,MATH 109,A01,083213,Anzaldo; Leesa B,0,6,30,30
1650378398676,MATH 109,A02,083214,Anzaldo; Leesa B,0,7,30,30
1650378398676,MATH 109,B01,083215,Anzaldo; Leesa B,0,5,30,30
1650378398676,MATH 109,B02,083216,Anzaldo; Leesa B,0,5,30,30
1650378404705,MATH 142A,A01,083219,Chow; Bennett,0,14,30,30
1650378404705,MATH 142A,A02,083220,Chow; Bennett,0,13,30,30
1650378404705,MATH 142A,B01,083221,Chow; Bennett,0,12,30,30
1650378404705,MATH 142A,B02,083222,Chow; Bennett,0,12,30,30
1650378410733,MATH 193A,A01,083224,Staff,0,5,30,30
1650378410733,MATH 193A,A02,083225,Staff,0,5,30,30
1650378410733,MATH 193A,A03,083781,Staff,0,4,30,30
1650378410733,MATH 193A,A04,083782,Staff,0,4,30,30
1650378416760,MATH 197,001,091859,McAuley; Julian John,9998,0,9999,1
1650378422826,COGS 9,A01,083615,Staff,0,14,60,60
1650378428854,COGS 11,A01,083617,Boyle; Mary E. T.,22,0,40,18
1650378434883,COGS 13,A01,083071,Staff,0,32,40,40
1650378440921,COGS 14A,A01,092681,Staff,0,22,100,100
1650378446948,COGS 14B,A01,083073,Cheng; Tzu-Han,0,10,50,50
1650378452988,COGS 17,A01,092677,Staff,24,0,75,51
1650378459017,COGS 100,A01,083619,Staff,0,24,60,60
1650378465044,COGS 101A,A01,083621,Davis; Joshua Daniel,0,21,60,60
1650378471069,COGS 101B,A01,091572,Staff,0,0,60,60
1650378477096,COGS 101C,A01,083625,Delgado; Tania,17,0,30,13
1650378483124,COGS 107A,A01,083627,Boyle; Mary E. T.,0,10,60,60
1650378489153,COGS 118A,A01,083075,Staff,4,0,60,56
1650378495180,CSE 3,A50,083646,Miranda; Gregory Joseph,21,0,38,17
1650378495180,CSE 3,A51,083647,Miranda; Gregory Joseph,37,0,37,0
1650378501208,CSE 8A,A50,083650,Miranda; Gregory Joseph,0,28,40,40
1650378507235,CSE 11,A01,083080,Cao; Yingjun,0,88,40,40
1650378513260,CSE 12,A01,083652,Staff,0,12,100,100
1650378519283,CSE 15L,A01,083654,Staff,0,1,50,50
1650378519283,CSE 15L,A02,083655,Staff,3,0,50,47
1650378525307,CSE 20,A01,083657,Staff,52,0,80,28
1650378531335,CSE 30,A01,083084,Eldon; John,0,76,40,40
1650378537363,CSE 100,A01,083659,Cao; Yingjun,0,66,50,50
1650378543389,CSE 134B,A01,083661,Powell; Thomas Allan,0,31,65,65
1650378549421,CSE 140,A01,083663,Staff,0,0,75,75
1650378555448,CSE 140L,A01,083088,Eldon; John,0,7,75,75
1650378561472,CSE 175,A01,083665,Kumar; Rakesh,8,0,25,17
1650378567497,CSE 190,A00,092507,Dubnov; Shlomo,14,0,20,6
1650378573524,ECE 45,A01,083139,Staff,0,17,40,40
1650378579550,ECE 65,A50,083695,Staff,0,5,30,30
1650378585573,ECE 109,A01,091882,Touri; Behrouz,40,0,70,30
1650378591600,ECE 180,A00,083140,Abi Samra; Nicholas Camill,23,0,30,7
1650378591600,ECE 180,B00,083141,Abi Samra; Nicholas Camill,5,0,30,25
1650378597622,MATH 10A,A01,083735,Patchell; Gregory David,7,0,30,23
1650378597622,MATH 10A,A02,083736,Patchell; Gregory David,28,0,30,2
1650378597622,MATH 10A,A03,083737,Patchell; Gregory David,25,0,30,5
1650378603652,MATH 10B,A01,083207,Staff,0,7,30,30
1650378603652,MATH 10B,A02,083208,Staff,0,6,30,30
1650378603652,MATH 10B,B01,083739,Staff,17,0,30,13
1650378603652,MATH 10B,B02,083740,Staff,28,0,30,2
1650378609681,MATH 18,A01,083743,Staff,3,0,30,27
1650378609681,MATH 18,A02,083744,Staff,27,0,30,3
1650378609681,MATH 18,A03,083745,Staff,22,0,30,8
1650378609681,MATH 18,A04,083746,Staff,27,0,30,3
1650378609681,MATH 18,B01,083748,Staff,0,11,30,30
1650378609681,MATH 18,B02,083749,Staff,0,12,30,30
1650378609681,MATH 18,B03,083750,Staff,0,11,30,30
1650378609681,MATH 18,B04,083751,Staff,0,9,30,30
1650378615707,MATH 20A,A01,083754,Staff,26,0,40,14
1650378621729,MATH 20B,A01,083756,Staff,0,8,30,30
1650378621729,MATH 20B,A02,083757,Staff,0,8,30,30
1650378627759,MATH 20C,A01,083760,Staff,0,14,30,30
1650378627759,MATH 20C,A02,083761,Staff,0,15,30,30
1650378627759,MATH 20C,B01,083762,Staff,13,0,30,17
1650378627759,MATH 20C,B02,083763,Staff,28,0,30,2
1650378633791,MATH 20D,A01,083765,Staff,0,1,30,30
1650378633791,MATH 20D,A02,083766,Staff,7,0,30,23
1650378633791,MATH 20D,A03,083767,Staff,26,0,30,4
1650378639822,MATH 20E,A01,083771,Staff,5,0,30,25
1650378639822,MATH 20E,A02,083772,Staff,19,0,30,11
1650378639822,MATH 20E,B01,083773,Staff,0,0,30,30
1650378639822,MATH 20E,B02,083774,Staff,12,0,30,18
1650378645849,MATH 103A,A01,083777,Staff,0,11,30,30
1650378645849,MATH 103A,A02,083778,Staff,0,12,30,30
1650378645849,MATH 103A,B01,083779,Staff,0,13,30,30
1650378645849,MATH 103A,B02,083780,Staff,0,11,30,30
1650378651872,MATH 105,A01,085443,Staff,0,21,30,30
1650378657899,MATH 109,A01,083213,Anzaldo; Leesa B,0,6,30,30
1650378657899,MATH 109,A02,083214,Anzaldo; Leesa B,0,7,30,30
1650378657899,MATH 109,B01,083215,Anzaldo; Leesa B,0,5,30,30
1650378657899,MATH 109,B02,083216,Anzaldo; Leesa B,0,5,30,30
1650378663923,MATH 142A,A01,083219,Chow; Bennett,0,14,30,30
1650378663923,MATH 142A,A02,083220,Chow; Bennett,0,13,30,30
1650378663923,MATH 142A,B01,083221,Chow; Bennett,0,12,30,30
1650378663923,MATH 142A,B02,083222,Chow; Bennett,0,12,30,30
1650378669955,MATH 193A,A01,083224,Staff,0,5,30,30
1650378669955,MATH 193A,A02,083225,Staff,0,5,30,30
1650378669955,MATH 193A,A03,083781,Staff,0,4,30,30
1650378669955,MATH 193A,A04,083782,Staff,0,4,30,30
1650378675979,MATH 197,001,091859,McAuley; Julian John,9998,0,9999,1
1650378682036,COGS 9,A01,083615,Staff,0,14,60,60
1650378688063,COGS 11,A01,083617,Boyle; Mary E. T.,22,0,40,18
1650378694089,COGS 13,A01,083071,Staff,0,32,40,40
1650378700114,COGS 14A,A01,092681,Staff,0,22,100,100
1650378706139,COGS 14B,A01,083073,Cheng; Tzu-Han,0,10,50,50
1650378712164,COGS 17,A01,092677,Staff,24,0,75,51
1650378718207,COGS 100,A01,083619,Staff,0,24,60,60
1650378724231,COGS 101A,A01,083621,Davis; Joshua Daniel,0,21,60,60
1650378730258,COGS 101B,A01,091572,Staff,0,0,60,60
1650378736283,COGS 101C,A01,083625,Delgado; Tania,17,0,30,13
1650378742309,COGS 107A,A01,083627,Boyle; Mary E. T.,0,10,60,60
1650378748339,COGS 118A,A01,083075,Staff,4,0,60,56
1650378754368,CSE 3,A50,083646,Miranda; Gregory Joseph,21,0,38,17
1650378754368,CSE 3,A51,083647,Miranda; Gregory Joseph,37,0,37,0
1650378760398,CSE 8A,A50,083650,Miranda; Gregory Joseph,0,28,40,40
1650378766429,CSE 11,A01,083080,Cao; Yingjun,0,88,40,40
1650378772453,CSE 12,A01,083652,Staff,0,12,100,100
1650378778480,CSE 15L,A01,083654,Staff,0,1,50,50
1650378778480,CSE 15L,A02,083655,Staff,3,0,50,47
1650378784508,CSE 20,A01,083657,Staff,52,0,80,28
1650378790532,CSE 30,A01,083084,Eldon; John,0,76,40,40
1650378796559,CSE 100,A01,083659,Cao; Yingjun,0,66,50,50
1650378802582,CSE 134B,A01,083661,Powell; Thomas Allan,0,31,65,65
1650378808607,CSE 140,A01,083663,Staff,0,0,75,75
1650378814635,CSE 140L,A01,083088,Eldon; John,0,7,75,75
1650378820755,CSE 175,A01,083665,Kumar; Rakesh,8,0,25,17
1650378826780,CSE 190,A00,092507,Dubnov; Shlomo,14,0,20,6
1650378832807,ECE 45,A01,083139,Staff,0,17,40,40
1650378838831,ECE 65,A50,083695,Staff,0,5,30,30
1650378844853,ECE 109,A01,091882,Touri; Behrouz,40,0,70,30
1650378850876,ECE 180,A00,083140,Abi Samra; Nicholas Camill,23,0,30,7
1650378850876,ECE 180,B00,083141,Abi Samra; Nicholas Camill,5,0,30,25
1650378856907,MATH 10A,A01,083735,Patchell; Gregory David,7,0,30,23
1650378856907,MATH 10A,A02,083736,Patchell; Gregory David,28,0,30,2
1650378856907,MATH 10A,A03,083737,Patchell; Gregory David,25,0,30,5
1650378862950,MATH 10B,A01,083207,Staff,0,7,30,30
1650378862950,MATH 10B,A02,083208,Staff,0,6,30,30
1650378862950,MATH 10B,B01,083739,Staff,17,0,30,13
1650378862950,MATH 10B,B02,083740,Staff,28,0,30,2
1650378868976,MATH 18,A01,083743,Staff,3,0,30,27
1650378868976,MATH 18,A02,083744,Staff,27,0,30,3
1650378868976,MATH 18,A03,083745,Staff,22,0,30,8
1650378868976,MATH 18,A04,083746,Staff,27,0,30,3
1650378868976,MATH 18,B01,083748,Staff,0,11,30,30
1650378868976,MATH 18,B02,083749,Staff,0,12,30,30
1650378868976,MATH 18,B03,083750,Staff,0,11,30,30
1650378868976,MATH 18,B04,083751,Staff,0,9,30,30
1650378875002,MATH 20A,A01,083754,Staff,26,0,40,14
1650378881025,MATH 20B,A01,083756,Staff,0,8,30,30
1650378881025,MATH 20B,A02,083757,Staff,0,8,30,30
1650378887048,MATH 20C,A01,083760,Staff,0,14,30,30
1650378887048,MATH 20C,A02,083761,Staff,0,15,30,30
1650378887048,MATH 20C,B01,083762,Staff,13,0,30,17
1650378887048,MATH 20C,B02,083763,Staff,28,0,30,2
1650378893071,MATH 20D,A01,083765,Staff,0,1,30,30
1650378893071,MATH 20D,A02,083766,Staff,7,0,30,23
1650378893071,MATH 20D,A03,083767,Staff,26,0,30,4
1650378899103,MATH 20E,A01,083771,Staff,5,0,30,25
1650378899103,MATH 20E,A02,083772,Staff,19,0,30,11
1650378899103,MATH 20E,B01,083773,Staff,0,0,30,30
1650378899103,MATH 20E,B02,083774,Staff,12,0,30,18
1650378905132,MATH 103A,A01,083777,Staff,0,11,30,30
1650378905132,MATH 103A,A02,083778,Staff,0,12,30,30
1650378905132,MATH 103A,B01,083779,Staff,0,13,30,30
1650378905132,MATH 103A,B02,083780,Staff,0,11,30,30
1650378911156,MATH 105,A01,085443,Staff,0,21,30,30
1650378917178,MATH 109,A01,083213,Anzaldo; Leesa B,0,6,30,30
1650378917178,MATH 109,A02,083214,Anzaldo; Leesa B,0,7,30,30
1650378917178,MATH 109,B01,083215,Anzaldo; Leesa B,0,5,30,30
1650378917178,MATH 109,B02,083216,Anzaldo; Leesa B,0,5,30,30
1650378923207,MATH 142A,A01,083219,Chow; Bennett,0,14,30,30
1650378923207,MATH 142A,A02,083220,Chow; Bennett,0,13,30,30
1650378923207,MATH 142A,B01,083221,Chow; Bennett,0,12,30,30
1650378923207,MATH 142A,B02,083222,Chow; Bennett,0,12,30,30
1650378929232,MATH 193A,A01,083224,Staff,0,5,30,30
1650378929232,MATH 193A,A02,083225,Staff,0,5,30,30
1650378929232,MATH 193A,A03,083781,Staff,0,4,30,30
1650378929232,MATH 193A,A04,083782,Staff,0,4,30,30
1650378935257,MATH 197,001,091859,McAuley; Julian John,9998,0,9999,1
1650378941323,COGS 9,A01,083615,Staff,0,14,60,60
1650378947348,COGS 11,A01,083617,Boyle; Mary E. T.,22,0,40,18
1650378953376,COGS 13,A01,083071,Staff,0,32,40,40
1650378959410,COGS 14A,A01,092681,Staff,0,22,100,100
1650378965436,COGS 14B,A01,083073,Cheng; Tzu-Han,0,10,50,50
1650378971462,COGS 17,A01,092677,Staff,24,0,75,51
1650378977486,COGS 100,A01,083619,Staff,0,24,60,60
1650378983513,COGS 101A,A01,083621,Davis; Joshua Daniel,0,21,60,60
1650378989536,COGS 101B,A01,091572,Staff,0,0,60,60
1650378995561,COGS 101C,A01,083625,Delgado; Tania,17,0,30,13
1650379001583,COGS 107A,A01,083627,Boyle; Mary E. T.,0,10,60,60
1650379007609,COGS 118A,A01,083075,Staff,4,0,60,56
1650379013634,CSE 3,A50,083646,Miranda; Gregory Joseph,21,0,38,17
1650379013634,CSE 3,A51,083647,Miranda; Gregory Joseph,37,0,37,0
1650379019661,CSE 8A,A50,083650,Miranda; Gregory Joseph,0,28,40,40
1650379025688,CSE 11,A01,083080,Cao; Yingjun,0,88,40,40
1650379031714,CSE 12,A01,083652,Staff,0,12,100,100
1650379037741,CSE 15L,A01,083654,Staff,0,1,50,50
1650379037741,CSE 15L,A02,083655,Staff,3,0,50,47
1650379043768,CSE 20,A01,083657,Staff,52,0,80,28
1650379049792,CSE 30,A01,083084,Eldon; John,0,76,40,40
1650379055815,CSE 100,A01,083659,Cao; Yingjun,0,66,50,50
1650379061840,CSE 134B,A01,083661,Powell; Thomas Allan,0,31,65,65
1650379067868,CSE 140,A01,083663,Staff,0,0,75,75
1650379073892,CSE 140L,A01,083088,Eldon; John,0,7,75,75
1650379079915,CSE 175,A01,083665,Kumar; Rakesh,8,0,25,17
1650379085938,CSE 190,A00,092507,Dubnov; Shlomo,14,0,20,6
1650379091968,ECE 45,A01,083139,Staff,0,17,40,40
1650379097999,ECE 65,A50,083695,Staff,0,5,30,30
1650379104032,ECE 109,A01,091882,Touri; Behrouz,40,0,70,30
1650379110060,ECE 180,A00,083140,Abi Samra; Nicholas Camill,23,0,30,7
1650379110060,ECE 180,B00,083141,Abi Samra; Nicholas Camill,5,0,30,25
1650379116087,MATH 10A,A01,083735,Patchell; Gregory David,7,0,30,23
1650379116087,MATH 10A,A02,083736,Patchell; Gregory David,28,0,30,2
1650379116087,MATH 10A,A03,083737,Patchell; Gregory David,25,0,30,5
1650379122121,MATH 10B,A01,083207,Staff,0,7,30,30
1650379122121,MATH 10B,A02,083208,Staff,0,6,30,30
1650379122121,MATH 10B,B01,083739,Staff,17,0,30,13
1650379122121,MATH 10B,B02,083740,Staff,28,0,30,2
1650379128148,MATH 18,A01,083743,Staff,3,0,30,27
1650379128148,MATH 18,A02,083744,Staff,27,0,30,3
1650379128148,MATH 18,A03,083745,Staff,22,0,30,8
1650379128148,MATH 18,A04,083746,Staff,27,0,30,3
1650379128148,MATH 18,B01,083748,Staff,0,11,30,30
1650379128148,MATH 18,B02,083749,Staff,0,12,30,30
1650379128148,MATH 18,B03,083750,Staff,0,11,30,30
1650379128148,MATH 18,B04,083751,Staff,0,9,30,30
1650379134176,MATH 20A,A01,083754,Staff,26,0,40,14
1650379140213,MATH 20B,A01,083756,Staff,0,8,30,30
1650379140213,MATH 20B,A02,083757,Staff,0,8,30,30
1650379146237,MATH 20C,A01,083760,Staff,0,14,30,30
1650379146237,MATH 20C,A02,083761,Staff,0,15,30,30
1650379146237,MATH 20C,B01,083762,Staff,13,0,30,17
1650379146237,MATH 20C,B02,083763,Staff,28,0,30,2
1650379152260,MATH 20D,A01,083765,Staff,0,1,30,30
1650379152260,MATH 20D,A02,083766,Staff,7,0,30,23
1650379152260,MATH 20D,A03,083767,Staff,26,0,30,4
1650379158293,MATH 20E,A01,083771,Staff,5,0,30,25
1650379158293,MATH 20E,A02,083772,Staff,19,0,30,11
1650379158293,MATH 20E,B01,083773,Staff,0,0,30,30
1650379158293,MATH 20E,B02,083774,Staff,12,0,30,18
1650379164323,MATH 103A,A01,083777,Staff,0,11,30,30
1650379164323,MATH 103A,A02,083778,Staff,0,12,30,30
1650379164323,MATH 103A,B01,083779,Staff,0,13,30,30
1650379164323,MATH 103A,B02,083780,Staff,0,11,30,30
1650379170349,MATH 105,A01,085443,Staff,0,21,30,30
1650379176373,MATH 109,A01,083213,Anzaldo; Leesa B,0,6,30,30
1650379176373,MATH 109,A02,083214,Anzaldo; Leesa B,0,7,30,30
1650379176373,MATH 109,B01,083215,Anzaldo; Leesa B,0,5,30,30
1650379176373,MATH 109,B02,083216,Anzaldo; Leesa B,0,5,30,30
1650379182401,MATH 142A,A01,083219,Chow; Bennett,0,14,30,30
1650379182401,MATH 142A,A02,083220,Chow; Bennett,0,13,30,30
1650379182401,MATH 142A,B01,083221,Chow; Bennett,0,12,30,30
1650379182401,MATH 142A,B02,083222,Chow; Bennett,0,12,30,30
1650379188426,MATH 193A,A01,083224,Staff,0,5,30,30
1650379188426,MATH 193A,A02,083225,Staff,0,5,30,30
1650379188426,MATH 193A,A03,083781,Staff,0,4,30,30
1650379188426,MATH 193A,A04,083782,Staff,0,4,30,30
1650379194471,MATH 197,001,091859,McAuley; Julian John,9998,0,9999,1
1650379200524,COGS 9,A01,083615,Staff,0,14,60,60
1650379206547,COGS 11,A01,083617,Boyle; Mary E. T.,22,0,40,18
1650379212573,COGS 13,A01,083071,Staff,0,32,40,40
1650379218598,COGS 14A,A01,092681,Staff,0,22,100,100
1650379224627,COGS 14B,A01,083073,Cheng; Tzu-Han,0,10,50,50
1650379230648,COGS 17,A01,092677,Staff,24,0,75,51
1650379236672,COGS 100,A01,083619,Staff,0,24,60,60
1650379242700,COGS 101A,A01,083621,Davis; Joshua Daniel,0,21,60,60
1650379248728,COGS 101B,A01,091572,Staff,0,0,60,60
1650379254753,COGS 101C,A01,083625,Delgado; Tania,17,0,30,13
1650379260784,COGS 107A,A01,083627,Boyle; Mary E. T.,0,10,60,60
1650379266824,COGS 118A,A01,083075,Staff,4,0,60,56
1650379272858,CSE 3,A50,083646,Miranda; Gregory Joseph,21,0,38,17
1650379272858,CSE 3,A51,083647,Miranda; Gregory Joseph,37,0,37,0
1650379278887,CSE 8A,A50,083650,Miranda; Gregory Joseph,0,28,40,40
1650379284919,CSE 11,A01,083080,Cao; Yingjun,0,88,40,40
1650379290946,CSE 12,A01,083652,Staff,0,12,100,100
1650379296970,CSE 15L,A01,083654,Staff,0,1,50,50
1650379296970,CSE 15L,A02,083655,Staff,3,0,50,47
1650379302995,CSE 20,A01,083657,Staff,52,0,80,28
1650379309033,CSE 30,A01,083084,Eldon; John,0,76,40,40
1650379315059,CSE 100,A01,083659,Cao; Yingjun,0,66,50,50
1650379321088,CSE 134B,A01,083661,Powell; Thomas Allan,0,31,65,65
1650379327115,CSE 140,A01,083663,Staff,0,0,75,75
1650379333140,CSE 140L,A01,083088,Eldon; John,0,7,75,75
1650379339168,CSE 175,A01,083665,Kumar; Rakesh,8,0,25,17
1650379345192,CSE 190,A00,092507,Dubnov; Shlomo,14,0,20,6
1650379351218,ECE 45,A01,083139,Staff,0,17,40,40
1650379357247,ECE 65,A50,083695,Staff,0,5,30,30
1650379363271,ECE 109,A01,091882,Touri; Behrouz,40,0,70,30
1650379369300,ECE 180,A00,083140,Abi Samra; Nicholas Camill,23,0,30,7
1650379369300,ECE 180,B00,083141,Abi Samra; Nicholas Camill,5,0,30,25
1650379375323,MATH 10A,A01,083735,Patchell; Gregory David,7,0,30,23
1650379375323,MATH 10A,A02,083736,Patchell; Gregory David,28,0,30,2
1650379375323,MATH 10A,A03,083737,Patchell; Gregory David,25,0,30,5
1650379381355,MATH 10B,A01,083207,Staff,0,7,30,30
1650379381355,MATH 10B,A02,083208,Staff,0,6,30,30
1650379381355,MATH 10B,B01,083739,Staff,17,0,30,13
1650379381355,MATH 10B,B02,083740,Staff,28,0,30,2
1650379387382,MATH 18,A01,083743,Staff,3,0,30,27
1650379387382,MATH 18,A02,083744,Staff,27,0,30,3
1650379387382,MATH 18,A03,083745,Staff,22,0,30,8
1650379387382,MATH 18,A04,083746,Staff,27,0,30,3
1650379387382,MATH 18,B01,083748,Staff,0,11,30,30
1650379387382,MATH 18,B02,083749,Staff,0,12,30,30
1650379387382,MATH 18,B03,083750,Staff,0,11,30,30
1650379387382,MATH 18,B04,083751,Staff,0,9,30,30
1650379393412,MATH 20A,A01,083754,Staff,26,0,40,14
1650379399439,MATH 20B,A01,083756,Staff,0,8,30,30
1650379399439,MATH 20B,A02,083757,Staff,0,8,30,30
1650379405475,MATH 20C,A01,083760,Staff,0,14,30,30
1650379405475,MATH 20C,A02,083761,Staff,0,15,30,30
1650379405475,MATH 20C,B01,083762,Staff,13,0,30,17
1650379405475,MATH 20C,B02,083763,Staff,28,0,30,2
1650379411502,MATH 20D,A01,083765,Staff,0,1,30,30
1650379411502,MATH 20D,A02,083766,Staff,7,0,30,23
1650379411502,MATH 20D,A03,083767,Staff,26,0,30,4
1650379417632,MATH 20E,A01,083771,Staff,5,0,30,25
1650379417632,MATH 20E,A02,083772,Staff,19,0,30,11
1650379417632,MATH 20E,B01,083773,Staff,0,0,30,30
1650379417632,MATH 20E,B02,083774,Staff,12,0,30,18
1650379423661,MATH 103A,A01,083777,Staff,0,11,30,30
1650379423661,MATH 103A,A02,083778,Staff,0,12,30,30
1650379423661,MATH 103A,B01,083779,Staff,0,13,30,30
1650379423661,MATH 103A,B02,083780,Staff,0,11,30,30
1650379429686,MATH 105,A01,085443,Staff,0,21,30,30
1650379435714,MATH 109,A01,083213,Anzaldo; Leesa B,0,6,30,30
1650379435714,MATH 109,A02,083214,Anzaldo; Leesa B,0,7,30,30
1650379435714,MATH 109,B01,083215,Anzaldo; Leesa B,0,5,30,30
1650379435714,MATH 109,B02,083216,Anzaldo; Leesa B,0,5,30,30
1650379441742,MATH 142A,A01,083219,Chow; Bennett,0,14,30,30
1650379441742,MATH 142A,A02,083220,Chow; Bennett,0,13,30,30
1650379441742,MATH 142A,B01,083221,Chow; Bennett,0,12,30,30
1650379441742,MATH 142A,B02,083222,Chow; Bennett,0,12,30,30
1650379447765,MATH 193A,A01,083224,Staff,0,5,30,30
1650379447765,MATH 193A,A02,083225,Staff,0,5,30,30
1650379447765,MATH 193A,A03,083781,Staff,0,4,30,30
1650379447765,MATH 193A,A04,083782,Staff,0,4,30,30
1650379453790,MATH 197,001,091859,McAuley; Julian John,9998,0,9999,1
1650379459872,COGS 9,A01,083615,Staff,0,14,60,60
1650379465899,COGS 11,A01,083617,Boyle; Mary E. T.,22,0,40,18
1650379471927,COGS 13,A01,083071,Staff,0,32,40,40
1650379477951,COGS 14A,A01,092681,Staff,0,22,100,100
1650379483975,COGS 14B,A01,083073,Cheng; Tzu-Han,0,10,50,50
1650379489999,COGS 17,A01,092677,Staff,24,0,75,51
1650379496027,COGS 100,A01,083619,Staff,0,24,60,60
1650379502049,COGS 101A,A01,083621,Davis; Joshua Daniel,0,21,60,60
1650379508073,COGS 101B,A01,091572,Staff,0,0,60,60
1650379514099,COGS 101C,A01,083625,Delgado; Tania,17,0,30,13
1650379520130,COGS 107A,A01,083627,Boyle; Mary E. T.,0,10,60,60
1650379526158,COGS 118A,A01,083075,Staff,4,0,60,56
1650379532189,CSE 3,A50,083646,Miranda; Gregory Joseph,21,0,38,17
1650379532189,CSE 3,A51,083647,Miranda; Gregory Joseph,37,0,37,0
1650379538228,CSE 8A,A50,083650,Miranda; Gregory Joseph,0,28,40,40
1650379544256,CSE 11,A01,083080,Cao; Yingjun,0,88,40,40
1650379550282,CSE 12,A01,083652,Staff,0,12,100,100
1650379556305,CSE 15L,A01,083654,Staff,0,1,50,50
1650379556305,CSE 15L,A02,083655,Staff,3,0,50,47
1650379562335,CSE 20,A01,083657,Staff,52,0,80,28
1650379568368,CSE 30,A01,083084,Eldon; John,0,76,40,40
1650379574392,CSE 100,A01,083659,Cao; Yingjun,0,66,50,50
1650379580416,CSE 134B,A01,083661,Powell; Thomas Allan,0,31,65,65
1650379586442,CSE 140,A01,083663,Staff,0,0,75,75
1650379592466,CSE 140L,A01,083088,Eldon; John,0,7,75,75
1650379598503,CSE 175,A01,083665,Kumar; Rakesh,8,0,25,17
1650379604528,CSE 190,A00,092507,Dubnov; Shlomo,14,0,20,6
1650379610554,ECE 45,A01,083139,Staff,0,17,40,40
1650379616576,ECE 65,A50,083695,Staff,0,5,30,30
1650379622606,ECE 109,A01,091882,Touri; Behrouz,40,0,70,30
1650379628633,ECE 180,A00,083140,Abi Samra; Nicholas Camill,23,0,30,7
1650379628633,ECE 180,B00,083141,Abi Samra; Nicholas Camill,5,0,30,25
1650379634658,MATH 10A,A01,083735,Patchell; Gregory David,7,0,30,23
1650379634658,MATH 10A,A02,083736,Patchell; Gregory David,28,0,30,2
1650379634658,MATH 10A,A03,083737,Patchell; Gregory David,25,0,30,5
1650379640687,MATH 10B,A01,083207,Staff,0,7,30,30
1650379640687,MATH 10B,A02,083208,Staff,0,6,30,30
1650379640687,MATH 10B,B01,083739,Staff,17,0,30,13
1650379640687,MATH 10B,B02,083740,Staff,28,0,30,2
1650379646718,MATH 18,A01,083743,Staff,3,0,30,27
1650379646718,MATH 18,A02,083744,Staff,27,0,30,3
1650379646718,MATH 18,A03,083745,Staff,22,0,30,8
1650379646718,MATH 18,A04,083746,Staff,27,0,30,3
1650379646718,MATH 18,B01,083748,Staff,0,11,30,30
1650379646718,MATH 18,B02,083749,Staff,0,12,30,30
1650379646718,MATH 18,B03,083750,Staff,0,11,30,30
1650379646718,MATH 18,B04,083751,Staff,0,9,30,30
1650379652745,MATH 20A,A01,083754,Staff,26,0,40,14
1650379658770,MATH 20B,A01,083756,Staff,0,8,30,30
1650379658770,MATH 20B,A02,083757,Staff,0,8,30,30
1650379664795,MATH 20C,A01,083760,Staff,0,14,30,30
1650379664795,MATH 20C,A02,083761,Staff,0,15,30,30
1650379664795,MATH 20C,B01,083762,Staff,13,0,30,17
1650379664795,MATH 20C,B02,083763,Staff,28,0,30,2
1650379670817,MATH 20D,A01,083765,Staff,0,1,30,30
1650379670817,MATH 20D,A02,083766,Staff,7,0,30,23
1650379670817,MATH 20D,A03,083767,Staff,26,0,30,4
1650379676845,MATH 20E,A01,083771,Staff,5,0,30,25
1650379676845,MATH 20E,A02,083772,Staff,19,0,30,11
1650379676845,MATH 20E,B01,083773,Staff,0,0,30,30
1650379676845,MATH 20E,B02,083774,Staff,12,0,30,18
1650379682879,MATH 103A,A01,083777,Staff,0,11,30,30
1650379682879,MATH 103A,A02,083778,Staff,0,12,30,30
1650379682879,MATH 103A,B01,083779,Staff,0,13,30,30
1650379682879,MATH 103A,B02,083780,Staff,0,11,30,30
1650379688906,MATH 105,A01,085443,Staff,0,21,30,30
1650379694930,MATH 109,A01,083213,Anzaldo; Leesa B,0,6,30,30
1650379694930,MATH 109,A02,083214,Anzaldo; Leesa B,0,7,30,30
1650379694930,MATH 109,B01,083215,Anzaldo; Leesa B,0,5,30,30
1650379694930,MATH 109,B02,083216,Anzaldo; Leesa B,0,5,30,30
1650379700959,MATH 142A,A01,083219,Chow; Bennett,0,14,30,30
1650379700959,MATH 142A,A02,083220,Chow; Bennett,0,13,30,30
1650379700959,MATH 142A,B01,083221,Chow; Bennett,0,12,30,30
1650379700959,MATH 142A,B02,083222,Chow; Bennett,0,12,30,30
1650379706987,MATH 193A,A01,083224,Staff,0,5,30,30
1650379706987,MATH 193A,A02,083225,Staff,0,5,30,30
1650379706987,MATH 193A,A03,083781,Staff,0,4,30,30
1650379706987,MATH 193A,A04,083782,Staff,0,4,30,30
1650379713010,MATH 197,001,091859,McAuley; Julian John,9998,0,9999,1
1650379719065,COGS 9,A01,083615,Staff,0,14,60,60
1650379725091,COGS 11,A01,083617,Boyle; Mary E. T.,22,0,40,18
1650379731114,COGS 13,A01,083071,Staff,0,32,40,40
1650379737150,COGS 14A,A01,092681,Staff,0,22,100,100
1650379743178,COGS 14B,A01,083073,Cheng; Tzu-Han,0,10,50,50
1650379749202,COGS 17,A01,092677,Staff,24,0,75,51
1650379755224,COGS 100,A01,083619,Staff,0,24,60,60
1650379761249,COGS 101A,A01,083621,Davis; Joshua Daniel,0,21,60,60
1650379767283,COGS 101B,A01,091572,Staff,0,0,60,60
1650379773311,COGS 101C,A01,083625,Delgado; Tania,17,0,30,13
1650379779337,COGS 107A,A01,083627,Boyle; Mary E. T.,0,10,60,60
1650379785360,COGS 118A,A01,083075,Staff,4,0,60,56
1650379791385,CSE 3,A50,083646,Miranda; Gregory Joseph,21,0,38,17
1650379791385,CSE 3,A51,083647,Miranda; Gregory Joseph,37,0,37,0
1650379797411,CSE 8A,A50,083650,Miranda; Gregory Joseph,0,28,40,40
1650379803439,CSE 11,A01,083080,Cao; Yingjun,0,88,40,40
1650379809468,CSE 12,A01,083652,Staff,0,12,100,100
1650379815493,CSE 15L,A01,083654,Staff,0,1,50,50
1650379815493,CSE 15L,A02,083655,Staff,3,0,50,47
1650379821521,CSE 20,A01,083657,Staff,52,0,80,28
1650379827547,CSE 30,A01,083084,Eldon; John,0,76,40,40
1650379833570,CSE 100,A01,083659,Cao; Yingjun,0,66,50,50
1650379839599,CSE 134B,A01,083661,Powell; Thomas Allan,0,31,65,65
1650379845625,CSE 140,A01,083663,Staff,0,0,75,75
1650379851653,CSE 140L,A01,083088,Eldon; John,0,7,75,75
1650379857679,CSE 175,A01,083665,Kumar; Rakesh,8,0,25,17
1650379863707,CSE 190,A00,092507,Dubnov; Shlomo,14,0,20,6
1650379869737,ECE 45,A01,083139,Staff,0,17,40,40
1650379875760,ECE 65,A50,083695,Staff,0,5,30,30
1650379881783,ECE 109,A01,091882,Touri; Behrouz,40,0,70,30
1650379887811,ECE 180,A00,083140,Abi Samra; Nicholas Camill,23,0,30,7
1650379887811,ECE 180,B00,083141,Abi Samra; Nicholas Camill,5,0,30,25
1650379893843,MATH 10A,A01,083735,Patchell; Gregory David,7,0,30,23
1650379893843,MATH 10A,A02,083736,Patchell; Gregory David,28,0,30,2
1650379893843,MATH 10A,A03,083737,Patchell; Gregory David,25,0,30,5
1650379899880,MATH 10B,A01,083207,Staff,0,7,30,30
1650379899880,MATH 10B,A02,083208,Staff,0,6,30,30
1650379899880,MATH 10B,B01,083739,Staff,17,0,30,13
1650379899880,MATH 10B,B02,083740,Staff,28,0,30,2
1650379905906,MATH 18,A01,083743,Staff,3,0,30,27
1650379905906,MATH 18,A02,083744,Staff,27,0,30,3
1650379905906,MATH 18,A03,083745,Staff,22,0,30,8
1650379905906,MATH 18,A04,083746,Staff,27,0,30,3
1650379905906,MATH 18,B01,083748,Staff,0,11,30,30
1650379905906,MATH 18,B02,083749,Staff,0,12,30,30
1650379905906,MATH 18,B03,083750,Staff,0,11,30,30
1650379905906,MATH 18,B04,083751,Staff,0,9,30,30
1650379911938,MATH 20A,A01,083754,Staff,26,0,40,14
1650379917965,MATH 20B,A01,083756,Staff,0,8,30,30
1650379917965,MATH 20B,A02,083757,Staff,0,8,30,30
1650379923990,MATH 20C,A01,083760,Staff,0,14,30,30
1650379923990,MATH 20C,A02,083761,Staff,0,15,30,30
1650379923990,MATH 20C,B01,083762,Staff,13,0,30,17
1650379923990,MATH 20C,B02,083763,Staff,28,0,30,2
1650379930015,MATH 20D,A01,083765,Staff,0,1,30,30
1650379930015,MATH 20D,A02,083766,Staff,7,0,30,23
1650379930015,MATH 20D,A03,083767,Staff,26,0,30,4
1650379936045,MATH 20E,A01,083771,Staff,5,0,30,25
1650379936045,MATH 20E,A02,083772,Staff,19,0,30,11
1650379936045,MATH 20E,B01,083773,Staff,0,0,30,30
1650379936045,MATH 20E,B02,083774,Staff,12,0,30,18
1650379942071,MATH 103A,A01,083777,Staff,0,11,30,30
1650379942071,MATH 103A,A02,083778,Staff,0,12,30,30
1650379942071,MATH 103A,B01,083779,Staff,0,13,30,30
1650379942071,MATH 103A,B02,083780,Staff,0,11,30,30
1650379948094,MATH 105,A01,085443,Staff,0,21,30,30
1650379954128,MATH 109,A01,083213,Anzaldo; Leesa B,0,6,30,30
1650379954128,MATH 109,A02,083214,Anzaldo; Leesa B,0,7,30,30
1650379954128,MATH 109,B01,083215,Anzaldo; Leesa B,0,5,30,30
1650379954128,MATH 109,B02,083216,Anzaldo; Leesa B,0,5,30,30
1650379960156,MATH 142A,A01,083219,Chow; Bennett,0,14,30,30
1650379960156,MATH 142A,A02,083220,Chow; Bennett,0,13,30,30
1650379960156,MATH 142A,B01,083221,Chow; Bennett,0,12,30,30
1650379960156,MATH 142A,B02,083222,Chow; Bennett,0,12,30,30
1650379966188,MATH 193A,A01,083224,Staff,0,5,30,30
1650379966188,MATH 193A,A02,083225,Staff,0,5,30,30
1650379966188,MATH 193A,A03,083781,Staff,0,4,30,30
1650379966188,MATH 193A,A04,083782,Staff,0,4,30,30
1650379972219,MATH 197,001,091859,McAuley; Julian John,9998,0,9999,1
1650379978293,COGS 9,A01,083615,Staff,0,14,60,60
1650379984331,COGS 11,A01,083617,Boyle; Mary E. T.,22,0,40,18
1650379990377,COGS 13,A01,083071,Staff,0,32,40,40
1650379996420,COGS 14A,A01,092681,Staff,0,22,100,100
1650380002464,COGS 14B,A01,083073,Cheng; Tzu-Han,0,10,50,50
1650380008598,COGS 17,A01,092677,Staff,24,0,75,51
1650380014646,COGS 100,A01,083619,Staff,0,24,60,60
1650380020688,COGS 101A,A01,083621,Davis; Joshua Daniel,0,21,60,60
1650380026729,COGS 101B,A01,091572,Staff,0,0,60,60
1650380032785,COGS 101C,A01,083625,Delgado; Tania,17,0,30,13
1650380038818,COGS 107A,A01,083627,Boyle; Mary E. T.,0,10,60,60
1650380044855,COGS 118A,A01,083075,Staff,4,0,60,56
1650380050885,CSE 3,A50,083646,Miranda; Gregory Joseph,21,0,38,17
1650380050885,CSE 3,A51,083647,Miranda; Gregory Joseph,37,0,37,0
1650380056937,CSE 8A,A50,083650,Miranda; Gregory Joseph,0,28,40,40
1650380062963,CSE 11,A01,083080,Cao; Yingjun,0,88,40,40
1650380068988,CSE 12,A01,083652,Staff,0,12,100,100
1650380075012,CSE 15L,A01,083654,Staff,0,1,50,50
1650380075012,CSE 15L,A02,083655,Staff,3,0,50,47
1650380081039,CSE 20,A01,083657,Staff,52,0,80,28
1650380087070,CSE 30,A01,083084,Eldon; John,0,76,40,40
1650380093095,CSE 100,A01,083659,Cao; Yingjun,0,66,50,50
1650380099125,CSE 134B,A01,083661,Powell; Thomas Allan,0,31,65,65
1650380105151,CSE 140,A01,083663,Staff,0,0,75,75
1650380111175,CSE 140L,A01,083088,Eldon; John,0,7,75,75
1650380117200,CSE 175,A01,083665,Kumar; Rakesh,8,0,25,17
1650380123224,CSE 190,A00,092507,Dubnov; Shlomo,14,0,20,6
1650380129255,ECE 45,A01,083139,Staff,0,17,40,40
1650380135284,ECE 65,A50,083695,Staff,0,5,30,30
1650380141315,ECE 109,A01,091882,Touri; Behrouz,40,0,70,30
1650380147354,ECE 180,A00,083140,Abi Samra; Nicholas Camill,23,0,30,7
1650380147354,ECE 180,B00,083141,Abi Samra; Nicholas Camill,5,0,30,25
1650380153395,MATH 10A,A01,083735,Patchell; Gregory David,7,0,30,23
1650380153395,MATH 10A,A02,083736,Patchell; Gregory David,28,0,30,2
1650380153395,MATH 10A,A03,083737,Patchell; Gregory David,25,0,30,5
1650380159418,MATH 10B,A01,083207,Staff,0,7,30,30
1650380159418,MATH 10B,A02,083208,Staff,0,6,30,30
1650380159418,MATH 10B,B01,083739,Staff,17,0,30,13
1650380159418,MATH 10B,B02,083740,Staff,28,0,30,2
1650380165444,MATH 18,A01,083743,Staff,3,0,30,27
1650380165444,MATH 18,A02,083744,Staff,27,0,30,3
1650380165444,MATH 18,A03,083745,Staff,22,0,30,8
1650380165444,MATH 18,A04,083746,Staff,27,0,30,3
1650380165444,MATH 18,B01,083748,Staff,0,11,30,30
1650380165444,MATH 18,B02,083749,Staff,0,12,30,30
1650380165444,MATH 18,B03,083750,Staff,0,11,30,30
1650380165444,MATH 18,B04,083751,Staff,0,9,30,30
1650380171477,MATH 20A,A01,083754,Staff,26,0,40,14
1650380177503,MATH 20B,A01,083756,Staff,0,8,30,30
1650380177503,MATH 20B,A02,083757,Staff,0,8,30,30
1650380183526,MATH 20C,A01,083760,Staff,0,14,30,30
1650380183526,MATH 20C,A02,083761,Staff,0,15,30,30
1650380183526,MATH 20C,B01,083762,Staff,13,0,30,17
1650380183526,MATH 20C,B02,083763,Staff,28,0,30,2
1650380189549,MATH 20D,A01,083765,Staff,0,1,30,30
1650380189549,MATH 20D,A02,083766,Staff,7,0,30,23
1650380189549,MATH 20D,A03,083767,Staff,26,0,30,4
1650380195573,MATH 20E,A01,083771,Staff,5,0,30,25
1650380195573,MATH 20E,A02,083772,Staff,19,0,30,11
1650380195573,MATH 20E,B01,083773,Staff,0,0,30,30
1650380195573,MATH 20E,B02,083774,Staff,12,0,30,18
1650380201602,MATH 103A,A01,083777,Staff,0,11,30,30
1650380201602,MATH 103A,A02,083778,Staff,0,12,30,30
1650380201602,MATH 103A,B01,083779,Staff,0,13,30,30
1650380201602,MATH 103A,B02,083780,Staff,0,11,30,30
1650380207624,MATH 105,A01,085443,Staff,0,21,30,30
1650380213648,MATH 109,A01,083213,Anzaldo; Leesa B,0,6,30,30
1650380213648,MATH 109,A02,083214,Anzaldo; Leesa B,0,7,30,30
1650380213648,MATH 109,B01,083215,Anzaldo; Leesa B,0,5,30,30
1650380213648,MATH 109,B02,083216,Anzaldo; Leesa B,0,5,30,30
1650380219673,MATH 142A,A01,083219,Chow; Bennett,0,14,30,30
1650380219673,MATH 142A,A02,083220,Chow; Bennett,0,13,30,30
1650380219673,MATH 142A,B01,083221,Chow; Bennett,0,12,30,30
1650380219673,MATH 142A,B02,083222,Chow; Bennett,0,12,30,30
1650380225707,MATH 193A,A01,083224,Staff,0,5,30,30
1650380225707,MATH 193A,A02,083225,Staff,0,5,30,30
1650380225707,MATH 193A,A03,083781,Staff,0,4,30,30
1650380225707,MATH 193A,A04,083782,Staff,0,4,30,30
1650380231730,MATH 197,001,091859,McAuley; Julian John,9998,0,9999,1
1650380237780,COGS 9,A01,083615,Staff,0,14,60,60
1650380243828,COGS 11,A01,083617,Boyle; Mary E. T.,22,0,40,18
1650380249861,COGS 13,A01,083071,Staff,0,32,40,40
1650380255902,COGS 14A,A01,092681,Staff,0,22,100,100
1650380261928,COGS 14B,A01,083073,Cheng; Tzu-Han,0,10,50,50
1650380267951,COGS 17,A01,092677,Staff,24,0,75,51
1650380273979,COGS 100,A01,083619,Staff,0,24,60,60
1650380280006,COGS 101A,A01,083621,Davis; Joshua Daniel,0,21,60,60
1650380286032,COGS 101B,A01,091572,Staff,0,0,60,60
1650380292067,COGS 101C,A01,083625,Delgado; Tania,17,0,30,13
1650380298092,COGS 107A,A01,083627,Boyle; Mary E. T.,0,10,60,60
1650380304134,COGS 118A,A01,083075,Staff,4,0,60,56
1650380310161,CSE 3,A50,083646,Miranda; Gregory Joseph,21,0,38,17
1650380310161,CSE 3,A51,083647,Miranda; Gregory Joseph,37,0,37,0
1650380316189,CSE 8A,A50,083650,Miranda; Gregory Joseph,0,28,40,40
1650380322212,CSE 11,A01,083080,Cao; Yingjun,0,88,40,40
1650380328239,CSE 12,A01,083652,Staff,0,12,100,100
1650380334275,CSE 15L,A01,083654,Staff,0,1,50,50
1650380334275,CSE 15L,A02,083655,Staff,3,0,50,47
1650380340297,CSE 20,A01,083657,Staff,52,0,80,28
1650380346322,CSE 30,A01,083084,Eldon; John,0,76,40,40
1650380352345,CSE 100,A01,083659,Cao; Yingjun,0,66,50,50
1650380358370,CSE 134B,A01,083661,Powell; Thomas Allan,0,31,65,65
1650380364400,CSE 140,A01,083663,Staff,0,0,75,75
1650380370422,CSE 140L,A01,083088,Eldon; John,0,7,75,75
1650380376444,CSE 175,A01,083665,Kumar; Rakesh,8,0,25,17
1650380382467,CSE 190,A00,092507,Dubnov; Shlomo,14,0,20,6
1650380388490,ECE 45,A01,083139,Staff,0,17,40,40
1650380394513,ECE 65,A50,083695,Staff,0,5,30,30
1650380400551,ECE 109,A01,091882,Touri; Behrouz,40,0,70,30
1650380406582,ECE 180,A00,083140,Abi Samra; Nicholas Camill,23,0,30,7
1650380406582,ECE 180,B00,083141,Abi Samra; Nicholas Camill,5,0,30,25
1650380412609,MATH 10A,A01,083735,Patchell; Gregory David,7,0,30,23
1650380412609,MATH 10A,A02,083736,Patchell; Gregory David,28,0,30,2
1650380412609,MATH 10A,A03,083737,Patchell; Gregory David,25,0,30,5
1650380418635,MATH 10B,A01,083207,Staff,0,7,30,30
1650380418635,MATH 10B,A02,083208,Staff,0,6,30,30
1650380418635,MATH 10B,B01,083739,Staff,17,0,30,13
1650380418635,MATH 10B,B02,083740,Staff,28,0,30,2
1650380424664,MATH 18,A01,083743,Staff,3,0,30,27
1650380424664,MATH 18,A02,083744,Staff,27,0,30,3
1650380424664,MATH 18,A03,083745,Staff,22,0,30,8
1650380424664,MATH 18,A04,083746,Staff,27,0,30,3
1650380424664,MATH 18,B01,083748,Staff,0,11,30,30
1650380424664,MATH 18,B02,083749,Staff,0,12,30,30
1650380424664,MATH 18,B03,083750,Staff,0,11,30,30
1650380424664,MATH 18,B04,083751,Staff,0,9,30,30
1650380430687,MATH 20A,A01,083754,Staff,26,0,40,14
1650380436722,MATH 20B,A01,083756,Staff,0,8,30,30
1650380436722,MATH 20B,A02,083757,Staff,0,8,30,30
1650380442746,MATH 20C,A01,083760,Staff,0,14,30,30
1650380442746,MATH 20C,A02,083761,Staff,0,15,30,30
1650380442746,MATH 20C,B01,083762,Staff,13,0,30,17
1650380442746,MATH 20C,B02,083763,Staff,28,0,30,2
1650380448771,MATH 20D,A01,083765,Staff,0,1,30,30
1650380448771,MATH 20D,A02,083766,Staff,7,0,30,23
1650380448771,MATH 20D,A03,083767,Staff,26,0,30,4
1650380454795,MATH 20E,A01,083771,Staff,5,0,30,25
1650380454795,MATH 20E,A02,083772,Staff,19,0,30,11
1650380454795,MATH 20E,B01,083773,Staff,0,0,30,30
1650380454795,MATH 20E,B02,083774,Staff,12,0,30,18
1650380460820,MATH 103A,A01,083777,Staff,0,11,30,30
1650380460820,MATH 103A,A02,083778,Staff,0,12,30,30
1650380460820,MATH 103A,B01,083779,Staff,0,13,30,30
1650380460820,MATH 103A,B02,083780,Staff,0,11,30,30
1650380466852,MATH 105,A01,085443,Staff,0,21,30,30
1650380472877,MATH 109,A01,083213,Anzaldo; Leesa B,0,6,30,30
1650380472877,MATH 109,A02,083214,Anzaldo; Leesa B,0,7,30,30
1650380472877,MATH 109,B01,083215,Anzaldo; Leesa B,0,5,30,30
1650380472877,MATH 109,B02,083216,Anzaldo; Leesa B,0,5,30,30
1650380478900,MATH 142A,A01,083219,Chow; Bennett,0,14,30,30
1650380478900,MATH 142A,A02,083220,Chow; Bennett,0,13,30,30
1650380478900,MATH 142A,B01,083221,Chow; Bennett,0,12,30,30
1650380478900,MATH 142A,B02,083222,Chow; Bennett,0,12,30,30
1650380484924,MATH 193A,A01,083224,Staff,0,5,30,30
1650380484924,MATH 193A,A02,083225,Staff,0,5,30,30
1650380484924,MATH 193A,A03,083781,Staff,0,4,30,30
1650380484924,MATH 193A,A04,083782,Staff,0,4,30,30
1650380490971,MATH 197,001,091859,McAuley; Julian John,9998,0,9999,1
1650380497027,COGS 9,A01,083615,Staff,0,14,60,60
1650380503053,COGS 11,A01,083617,Boyle; Mary E. T.,22,0,40,18
1650380509078,COGS 13,A01,083071,Staff,0,32,40,40
1650380515102,COGS 14A,A01,092681,Staff,0,22,100,100
1650380521126,COGS 14B,A01,083073,Cheng; Tzu-Han,0,10,50,50
1650380527149,COGS 17,A01,092677,Staff,24,0,75,51
1650380533175,COGS 100,A01,083619,Staff,0,24,60,60
1650380539199,COGS 101A,A01,083621,Davis; Joshua Daniel,0,21,60,60
1650380545228,COGS 101B,A01,091572,Staff,0,0,60,60
1650380551255,COGS 101C,A01,083625,Delgado; Tania,16,0,30,14
1650380557282,COGS 107A,A01,083627,Boyle; Mary E. T.,0,10,60,60
1650380563308,COGS 118A,A01,083075,Staff,4,0,60,56
1650380569340,CSE 3,A50,083646,Miranda; Gregory Joseph,21,0,38,17
1650380569340,CSE 3,A51,083647,Miranda; Gregory Joseph,37,0,37,0
1650380575364,CSE 8A,A50,083650,Miranda; Gregory Joseph,0,28,40,40
1650380581392,CSE 11,A01,083080,Cao; Yingjun,0,88,40,40
1650380587415,CSE 12,A01,083652,Staff,0,12,100,100
1650380593438,CSE 15L,A01,083654,Staff,0,1,50,50
1650380593438,CSE 15L,A02,083655,Staff,3,0,50,47
1650380599466,CSE 20,A01,083657,Staff,52,0,80,28
1650380605593,CSE 30,A01,083084,Eldon; John,0,76,40,40
1650380611621,CSE 100,A01,083659,Cao; Yingjun,0,66,50,50
1650380617649,CSE 134B,A01,083661,Powell; Thomas Allan,0,31,65,65
1650380623673,CSE 140,A01,083663,Staff,0,0,75,75
1650380629697,CSE 140L,A01,083088,Eldon; John,0,7,75,75
1650380635721,CSE 175,A01,083665,Kumar; Rakesh,8,0,25,17
1650380641744,CSE 190,A00,092507,Dubnov; Shlomo,14,0,20,6
1650380647771,ECE 45,A01,083139,Staff,0,17,40,40
1650380653811,ECE 65,A50,083695,Staff,0,5,30,30
1650380659834,ECE 109,A01,091882,Touri; Behrouz,40,0,70,30
1650380665863,ECE 180,A00,083140,Abi Samra; Nicholas Camill,23,0,30,7
1650380665863,ECE 180,B00,083141,Abi Samra; Nicholas Camill,5,0,30,25
1650380671904,MATH 10A,A01,083735,Patchell; Gregory David,7,0,30,23
1650380671904,MATH 10A,A02,083736,Patchell; Gregory David,28,0,30,2
1650380671904,MATH 10A,A03,083737,Patchell; Gregory David,25,0,30,5
1650380677928,MATH 10B,A01,083207,Staff,0,7,30,30
1650380677928,MATH 10B,A02,083208,Staff,0,6,30,30
1650380677928,MATH 10B,B01,083739,Staff,17,0,30,13
1650380677928,MATH 10B,B02,083740,Staff,28,0,30,2
1650380683953,MATH 18,A01,083743,Staff,3,0,30,27
1650380683953,MATH 18,A02,083744,Staff,27,0,30,3
1650380683953,MATH 18,A03,083745,Staff,22,0,30,8
1650380683953,MATH 18,A04,083746,Staff,27,0,30,3
1650380683953,MATH 18,B01,083748,Staff,0,11,30,30
1650380683953,MATH 18,B02,083749,Staff,0,12,30,30
1650380683953,MATH 18,B03,083750,Staff,0,11,30,30
1650380683953,MATH 18,B04,083751,Staff,0,9,30,30
1650380689979,MATH 20A,A01,083754,Staff,26,0,40,14
1650380696006,MATH 20B,A01,083756,Staff,0,8,30,30
1650380696006,MATH 20B,A02,083757,Staff,0,8,30,30
1650380702040,MATH 20C,A01,083760,Staff,0,14,30,30
1650380702040,MATH 20C,A02,083761,Staff,0,15,30,30
1650380702040,MATH 20C,B01,083762,Staff,13,0,30,17
1650380702040,MATH 20C,B02,083763,Staff,28,0,30,2
1650380708063,MATH 20D,A01,083765,Staff,0,1,30,30
1650380708063,MATH 20D,A02,083766,Staff,7,0,30,23
1650380708063,MATH 20D,A03,083767,Staff,26,0,30,4
1650380714092,MATH 20E,A01,083771,Staff,5,0,30,25
1650380714092,MATH 20E,A02,083772,Staff,19,0,30,11
1650380714092,MATH 20E,B01,083773,Staff,0,0,30,30
1650380714092,MATH 20E,B02,083774,Staff,12,0,30,18
1650380720116,MATH 103A,A01,083777,Staff,0,11,30,30
1650380720116,MATH 103A,A02,083778,Staff,0,12,30,30
1650380720116,MATH 103A,B01,083779,Staff,0,13,30,30
1650380720116,MATH 103A,B02,083780,Staff,0,11,30,30
1650380726143,MATH 105,A01,085443,Staff,0,21,30,30
1650380732168,MATH 109,A01,083213,Anzaldo; Leesa B,0,6,30,30
1650380732168,MATH 109,A02,083214,Anzaldo; Leesa B,0,7,30,30
1650380732168,MATH 109,B01,083215,Anzaldo; Leesa B,0,5,30,30
1650380732168,MATH 109,B02,083216,Anzaldo; Leesa B,0,5,30,30
1650380738199,MATH 142A,A01,083219,Chow; Bennett,0,14,30,30
1650380738199,MATH 142A,A02,083220,Chow; Bennett,0,13,30,30
1650380738199,MATH 142A,B01,083221,Chow; Bennett,0,12,30,30
1650380738199,MATH 142A,B02,083222,Chow; Bennett,0,12,30,30
1650380744222,MATH 193A,A01,083224,Staff,0,5,30,30
1650380744222,MATH 193A,A02,083225,Staff,0,5,30,30
1650380744222,MATH 193A,A03,083781,Staff,0,4,30,30
1650380744222,MATH 193A,A04,083782,Staff,0,4,30,30
1650380750249,MATH 197,001,091859,McAuley; Julian John,9998,0,9999,1
1650380756307,COGS 9,A01,083615,Staff,0,14,60,60
1650380762336,COGS 11,A01,083617,Boyle; Mary E. T.,22,0,40,18
1650380768360,COGS 13,A01,083071,Staff,0,32,40,40
1650380774389,COGS 14A,A01,092681,Staff,0,22,100,100
1650380780414,COGS 14B,A01,083073,Cheng; Tzu-Han,0,10,50,50
1650380786449,COGS 17,A01,092677,Staff,24,0,75,51
1650380792489,COGS 100,A01,083619,Staff,0,24,60,60
1650380798519,COGS 101A,A01,083621,Davis; Joshua Daniel,0,21,60,60
1650380804547,COGS 101B,A01,091572,Staff,0,0,60,60
1650380810570,COGS 101C,A01,083625,Delgado; Tania,16,0,30,14
1650380816603,COGS 107A,A01,083627,Boyle; Mary E. T.,0,10,60,60
1650380822627,COGS 118A,A01,083075,Staff,4,0,60,56
1650380828651,CSE 3,A50,083646,Miranda; Gregory Joseph,21,0,38,17
1650380828651,CSE 3,A51,083647,Miranda; Gregory Joseph,37,0,37,0
1650380834685,CSE 8A,A50,083650,Miranda; Gregory Joseph,0,28,40,40
1650380840711,CSE 11,A01,083080,Cao; Yingjun,0,88,40,40
1650380846735,CSE 12,A01,083652,Staff,0,12,100,100
1650380852760,CSE 15L,A01,083654,Staff,0,1,50,50
1650380852760,CSE 15L,A02,083655,Staff,3,0,50,47
1650380858783,CSE 20,A01,083657,Staff,52,0,80,28
1650380864815,CSE 30,A01,083084,Eldon; John,0,76,40,40
1650380870843,CSE 100,A01,083659,Cao; Yingjun,0,66,50,50
1650380876866,CSE 134B,A01,083661,Powell; Thomas Allan,0,31,65,65
1650380882892,CSE 140,A01,083663,Staff,0,0,75,75
1650380888924,CSE 140L,A01,083088,Eldon; John,0,7,75,75
1650380894946,CSE 175,A01,083665,Kumar; Rakesh,8,0,25,17
1650380900972,CSE 190,A00,092507,Dubnov; Shlomo,14,0,20,6
1650380906995,ECE 45,A01,083139,Staff,0,17,40,40
1650380913026,ECE 65,A50,083695,Staff,0,5,30,30
1650380919049,ECE 109,A01,091882,Touri; Behrouz,40,0,70,30
1650380925071,ECE 180,A00,083140,Abi Samra; Nicholas Camill,23,0,30,7
1650380925071,ECE 180,B00,083141,Abi Samra; Nicholas Camill,5,0,30,25
1650380931100,MATH 10A,A01,083735,Patchell; Gregory David,7,0,30,23
1650380931100,MATH 10A,A02,083736,Patchell; Gregory David,28,0,30,2
1650380931100,MATH 10A,A03,083737,Patchell; Gregory David,25,0,30,5
1650380937123,MATH 10B,A01,083207,Staff,0,7,30,30
1650380937123,MATH 10B,A02,083208,Staff,0,6,30,30
1650380937123,MATH 10B,B01,083739,Staff,17,0,30,13
1650380937123,MATH 10B,B02,083740,Staff,28,0,30,2
1650380943154,MATH 18,A01,083743,Staff,3,0,30,27
1650380943154,MATH 18,A02,083744,Staff,27,0,30,3
1650380943154,MATH 18,A03,083745,Staff,22,0,30,8
1650380943154,MATH 18,A04,083746,Staff,27,0,30,3
1650380943154,MATH 18,B01,083748,Staff,0,11,30,30
1650380943154,MATH 18,B02,083749,Staff,0,12,30,30
1650380943154,MATH 18,B03,083750,Staff,0,11,30,30
1650380943154,MATH 18,B04,083751,Staff,0,9,30,30
1650380949177,MATH 20A,A01,083754,Staff,26,0,40,14
1650380955201,MATH 20B,A01,083756,Staff,0,8,30,30
1650380955201,MATH 20B,A02,083757,Staff,0,8,30,30
1650380961230,MATH 20C,A01,083760,Staff,0,14,30,30
1650380961230,MATH 20C,A02,083761,Staff,0,15,30,30
1650380961230,MATH 20C,B01,083762,Staff,13,0,30,17
1650380961230,MATH 20C,B02,083763,Staff,28,0,30,2
1650380967264,MATH 20D,A01,083765,Staff,0,1,30,30
1650380967264,MATH 20D,A02,083766,Staff,7,0,30,23
1650380967264,MATH 20D,A03,083767,Staff,26,0,30,4
1650380973289,MATH 20E,A01,083771,Staff,5,0,30,25
1650380973289,MATH 20E,A02,083772,Staff,19,0,30,11
1650380973289,MATH 20E,B01,083773,Staff,0,0,30,30
1650380973289,MATH 20E,B02,083774,Staff,12,0,30,18
1650380979316,MATH 103A,A01,083777,Staff,0,11,30,30
1650380979316,MATH 103A,A02,083778,Staff,0,12,30,30
1650380979316,MATH 103A,B01,083779,Staff,0,13,30,30
1650380979316,MATH 103A,B02,083780,Staff,0,11,30,30
1650380985340,MATH 105,A01,085443,Staff,0,21,30,30
1650380991364,MATH 109,A01,083213,Anzaldo; Leesa B,0,6,30,30
1650380991364,MATH 109,A02,083214,Anzaldo; Leesa B,0,7,30,30
1650380991364,MATH 109,B01,083215,Anzaldo; Leesa B,0,5,30,30
1650380991364,MATH 109,B02,083216,Anzaldo; Leesa B,0,5,30,30
1650380997393,MATH 142A,A01,083219,Chow; Bennett,0,14,30,30
1650380997393,MATH 142A,A02,083220,Chow; Bennett,0,13,30,30
1650380997393,MATH 142A,B01,083221,Chow; Bennett,0,12,30,30
1650380997393,MATH 142A,B02,083222,Chow; Bennett,0,12,30,30
1650381003420,MATH 193A,A01,083224,Staff,0,5,30,30
1650381003420,MATH 193A,A02,083225,Staff,0,5,30,30
1650381003420,MATH 193A,A03,083781,Staff,0,4,30,30
1650381003420,MATH 193A,A04,083782,Staff,0,4,30,30
1650381009448,MATH 197,001,091859,McAuley; Julian John,9998,0,9999,1
1650381015507,COGS 9,A01,083615,Staff,0,14,60,60
1650381021535,COGS 11,A01,083617,Boyle; Mary E. T.,22,0,40,18
1650381027567,COGS 13,A01,083071,Staff,0,32,40,40
1650381033589,COGS 14A,A01,092681,Staff,0,22,100,100
1650381039611,COGS 14B,A01,083073,Cheng; Tzu-Han,0,10,50,50
1650381045636,COGS 17,A01,092677,Staff,24,0,75,51
1650381051679,COGS 100,A01,083619,Staff,0,24,60,60
1650381057705,COGS 101A,A01,083621,Davis; Joshua Daniel,0,21,60,60
1650381063731,COGS 101B,A01,091572,Staff,0,0,60,60
1650381069753,COGS 101C,A01,083625,Delgado; Tania,16,0,30,14
1650381075778,COGS 107A,A01,083627,Boyle; Mary E. T.,0,10,60,60
1650381081814,COGS 118A,A01,083075,Staff,4,0,60,56
1650381087846,CSE 3,A50,083646,Miranda; Gregory Joseph,21,0,38,17
1650381087846,CSE 3,A51,083647,Miranda; Gregory Joseph,37,0,37,0
1650381093880,CSE 8A,A50,083650,Miranda; Gregory Joseph,0,28,40,40
1650381099903,CSE 11,A01,083080,Cao; Yingjun,0,89,40,40
1650381105926,CSE 12,A01,083652,Staff,0,12,100,100
1650381111953,CSE 15L,A01,083654,Staff,0,1,50,50
1650381111953,CSE 15L,A02,083655,Staff,3,0,50,47
1650381117987,CSE 20,A01,083657,Staff,52,0,80,28
1650381124015,CSE 30,A01,083084,Eldon; John,0,76,40,40
1650381130044,CSE 100,A01,083659,Cao; Yingjun,0,66,50,50
1650381136081,CSE 134B,A01,083661,Powell; Thomas Allan,0,31,65,65
1650381142111,CSE 140,A01,083663,Staff,0,0,75,75
1650381148139,CSE 140L,A01,083088,Eldon; John,0,7,75,75
1650381154168,CSE 175,A01,083665,Kumar; Rakesh,8,0,25,17
1650381160193,CSE 190,A00,092507,Dubnov; Shlomo,14,0,20,6
1650381166215,ECE 45,A01,083139,Staff,0,17,40,40
1650381172240,ECE 65,A50,083695,Staff,0,5,30,30
1650381178264,ECE 109,A01,091882,Touri; Behrouz,40,0,70,30
1650381184302,ECE 180,A00,083140,Abi Samra; Nicholas Camill,23,0,30,7
1650381184302,ECE 180,B00,083141,Abi Samra; Nicholas Camill,5,0,30,25
1650381190331,MATH 10A,A01,083735,Patchell; Gregory David,7,0,30,23
1650381190331,MATH 10A,A02,083736,Patchell; Gregory David,28,0,30,2
1650381190331,MATH 10A,A03,083737,Patchell; Gregory David,25,0,30,5
1650381196355,MATH 10B,A01,083207,Staff,0,7,30,30
1650381196355,MATH 10B,A02,083208,Staff,0,6,30,30
1650381196355,MATH 10B,B01,083739,Staff,17,0,30,13
1650381196355,MATH 10B,B02,083740,Staff,28,0,30,2
1650381202481,MATH 18,A01,083743,Staff,3,0,30,27
1650381202481,MATH 18,A02,083744,Staff,27,0,30,3
1650381202481,MATH 18,A03,083745,Staff,22,0,30,8
1650381202481,MATH 18,A04,083746,Staff,27,0,30,3
1650381202481,MATH 18,B01,083748,Staff,0,11,30,30
1650381202481,MATH 18,B02,083749,Staff,0,12,30,30
1650381202481,MATH 18,B03,083750,Staff,0,11,30,30
1650381202481,MATH 18,B04,083751,Staff,0,9,30,30
1650381208508,MATH 20A,A01,083754,Staff,26,0,40,14
1650381214532,MATH 20B,A01,083756,Staff,0,8,30,30
1650381214532,MATH 20B,A02,083757,Staff,0,8,30,30
1650381220555,MATH 20C,A01,083760,Staff,0,14,30,30
1650381220555,MATH 20C,A02,083761,Staff,0,15,30,30
1650381220555,MATH 20C,B01,083762,Staff,13,0,30,17
1650381220555,MATH 20C,B02,083763,Staff,28,0,30,2
1650381226597,MATH 20D,A01,083765,Staff,0,1,30,30
1650381226597,MATH 20D,A02,083766,Staff,7,0,30,23
1650381226597,MATH 20D,A03,083767,Staff,26,0,30,4
1650381232622,MATH 20E,A01,083771,Staff,5,0,30,25
1650381232622,MATH 20E,A02,083772,Staff,19,0,30,11
1650381232622,MATH 20E,B01,083773,Staff,0,0,30,30
1650381232622,MATH 20E,B02,083774,Staff,12,0,30,18
1650381238658,MATH 103A,A01,083777,Staff,0,11,30,30
1650381238658,MATH 103A,A02,083778,Staff,0,12,30,30
1650381238658,MATH 103A,B01,083779,Staff,0,13,30,30
1650381238658,MATH 103A,B02,083780,Staff,0,11,30,30
1650381244683,MATH 105,A01,085443,Staff,0,21,30,30
1650381250705,MATH 109,A01,083213,Anzaldo; Leesa B,0,6,30,30
1650381250705,MATH 109,A02,083214,Anzaldo; Leesa B,0,7,30,30
1650381250705,MATH 109,B01,083215,Anzaldo; Leesa B,0,5,30,30
1650381250705,MATH 109,B02,083216,Anzaldo; Leesa B,0,5,30,30
1650381256743,MATH 142A,A01,083219,Chow; Bennett,0,14,30,30
1650381256743,MATH 142A,A02,083220,Chow; Bennett,0,13,30,30
1650381256743,MATH 142A,B01,083221,Chow; Bennett,0,12,30,30
1650381256743,MATH 142A,B02,083222,Chow; Bennett,0,12,30,30
1650381262776,MATH 193A,A01,083224,Staff,0,5,30,30
1650381262776,MATH 193A,A02,083225,Staff,0,5,30,30
1650381262776,MATH 193A,A03,083781,Staff,0,4,30,30
1650381262776,MATH 193A,A04,083782,Staff,0,4,30,30
1650381268799,MATH 197,001,091859,McAuley; Julian John,9998,0,9999,1
1650381274860,COGS 9,A01,083615,Staff,0,14,60,60
1650381280884,COGS 11,A01,083617,Boyle; Mary E. T.,22,0,40,18
1650381286906,COGS 13,A01,083071,Staff,0,32,40,40
1650381292929,COGS 14A,A01,092681,Staff,0,22,100,100
1650381298952,COGS 14B,A01,083073,Cheng; Tzu-Han,0,10,50,50
1650381304977,COGS 17,A01,092677,Staff,24,0,75,51
1650381311014,COGS 100,A01,083619,Staff,0,24,60,60
1650381317042,COGS 101A,A01,083621,Davis; Joshua Daniel,0,21,60,60
1650381323065,COGS 101B,A01,091572,Staff,0,0,60,60
1650381329089,COGS 101C,A01,083625,Delgado; Tania,16,0,30,14
1650381335124,COGS 107A,A01,083627,Boyle; Mary E. T.,0,10,60,60
1650381341151,COGS 118A,A01,083075,Staff,4,0,60,56
1650381347180,CSE 3,A50,083646,Miranda; Gregory Joseph,21,0,38,17
1650381347180,CSE 3,A51,083647,Miranda; Gregory Joseph,37,0,37,0
1650381353219,CSE 8A,A50,083650,Miranda; Gregory Joseph,0,28,40,40
1650381359242,CSE 11,A01,083080,Cao; Yingjun,0,89,40,40
1650381365270,CSE 12,A01,083652,Staff,0,12,100,100
1650381371296,CSE 15L,A01,083654,Staff,0,1,50,50
1650381371296,CSE 15L,A02,083655,Staff,3,0,50,47
1650381377319,CSE 20,A01,083657,Staff,52,0,80,28
1650381383346,CSE 30,A01,083084,Eldon; John,0,76,40,40
1650381389369,CSE 100,A01,083659,Cao; Yingjun,0,66,50,50
1650381395395,CSE 134B,A01,083661,Powell; Thomas Allan,0,31,65,65
1650381401421,CSE 140,A01,083663,Staff,0,0,75,75
1650381407453,CSE 140L,A01,083088,Eldon; John,0,7,75,75
1650381413479,CSE 175,A01,083665,Kumar; Rakesh,8,0,25,17
1650381419506,CSE 190,A00,092507,Dubnov; Shlomo,14,0,20,6
1650381425529,ECE 45,A01,083139,Staff,0,17,40,40
1650381431560,ECE 65,A50,083695,Staff,0,5,30,30
1650381437588,ECE 109,A01,091882,Touri; Behrouz,40,0,70,30
1650381443620,ECE 180,A00,083140,Abi Samra; Nicholas Camill,23,0,30,7
1650381443620,ECE 180,B00,083141,Abi Samra; Nicholas Camill,5,0,30,25
1650381449644,MATH 10A,A01,083735,Patchell; Gregory David,7,0,30,23
1650381449644,MATH 10A,A02,083736,Patchell; Gregory David,28,0,30,2
1650381449644,MATH 10A,A03,083737,Patchell; Gregory David,25,0,30,5
1650381455674,MATH 10B,A01,083207,Staff,0,7,30,30
1650381455674,MATH 10B,A02,083208,Staff,0,6,30,30
1650381455674,MATH 10B,B01,083739,Staff,17,0,30,13
1650381455674,MATH 10B,B02,083740,Staff,28,0,30,2
1650381461706,MATH 18,A01,083743,Staff,3,0,30,27
1650381461706,MATH 18,A02,083744,Staff,27,0,30,3
1650381461706,MATH 18,A03,083745,Staff,22,0,30,8
1650381461706,MATH 18,A04,083746,Staff,27,0,30,3
1650381461706,MATH 18,B01,083748,Staff,0,11,30,30
1650381461706,MATH 18,B02,083749,Staff,0,12,30,30
1650381461706,MATH 18,B03,083750,Staff,0,11,30,30
1650381461706,MATH 18,B04,083751,Staff,0,9,30,30
1650381467731,MATH 20A,A01,083754,Staff,26,0,40,14
1650381473758,MATH 20B,A01,083756,Staff,0,8,30,30
1650381473758,MATH 20B,A02,083757,Staff,0,8,30,30
1650381479789,MATH 20C,A01,083760,Staff,0,14,30,30
1650381479789,MATH 20C,A02,083761,Staff,0,15,30,30
1650381479789,MATH 20C,B01,083762,Staff,13,0,30,17
1650381479789,MATH 20C,B02,083763,Staff,28,0,30,2
1650381485816,MATH 20D,A01,083765,Staff,0,1,30,30
1650381485816,MATH 20D,A02,083766,Staff,7,0,30,23
1650381485816,MATH 20D,A03,083767,Staff,26,0,30,4
1650381491852,MATH 20E,A01,083771,Staff,5,0,30,25
1650381491852,MATH 20E,A02,083772,Staff,19,0,30,11
1650381491852,MATH 20E,B01,083773,Staff,0,0,30,30
1650381491852,MATH 20E,B02,083774,Staff,12,0,30,18
1650381497881,MATH 103A,A01,083777,Staff,0,11,30,30
1650381497881,MATH 103A,A02,083778,Staff,0,12,30,30
1650381497881,MATH 103A,B01,083779,Staff,0,13,30,30
1650381497881,MATH 103A,B02,083780,Staff,0,11,30,30
1650381503905,MATH 105,A01,085443,Staff,0,21,30,30
1650381509939,MATH 109,A01,083213,Anzaldo; Leesa B,0,6,30,30
1650381509939,MATH 109,A02,083214,Anzaldo; Leesa B,0,7,30,30
1650381509939,MATH 109,B01,083215,Anzaldo; Leesa B,0,5,30,30
1650381509939,MATH 109,B02,083216,Anzaldo; Leesa B,0,5,30,30
1650381515963,MATH 142A,A01,083219,Chow; Bennett,0,14,30,30
1650381515963,MATH 142A,A02,083220,Chow; Bennett,0,13,30,30
1650381515963,MATH 142A,B01,083221,Chow; Bennett,0,12,30,30
1650381515963,MATH 142A,B02,083222,Chow; Bennett,0,12,30,30
1650381521986,MATH 193A,A01,083224,Staff,0,5,30,30
1650381521986,MATH 193A,A02,083225,Staff,0,5,30,30
1650381521986,MATH 193A,A03,083781,Staff,0,4,30,30
1650381521986,MATH 193A,A04,083782,Staff,0,4,30,30
1650381528013,MATH 197,001,091859,McAuley; Julian John,9998,0,9999,1
1650381534075,COGS 9,A01,083615,Staff,0,14,60,60
1650381540097,COGS 11,A01,083617,Boyle; Mary E. T.,22,0,40,18
1650381546121,COGS 13,A01,083071,Staff,0,32,40,40
1650381552145,COGS 14A,A01,092681,Staff,0,22,100,100
1650381558175,COGS 14B,A01,083073,Cheng; Tzu-Han,0,10,50,50
1650381564199,COGS 17,A01,092677,Staff,24,0,75,51
1650381570230,COGS 100,A01,083619,Staff,0,24,60,60
1650381576255,COGS 101A,A01,083621,Davis; Joshua Daniel,0,21,60,60
1650381582286,COGS 101B,A01,091572,Staff,0,0,60,60
1650381588310,COGS 101C,A01,083625,Delgado; Tania,16,0,30,14
1650381594334,COGS 107A,A01,083627,Boyle; Mary E. T.,0,10,60,60
1650381600361,COGS 118A,A01,083075,Staff,4,0,60,56
1650381606400,CSE 3,A50,083646,Miranda; Gregory Joseph,21,0,38,17
1650381606400,CSE 3,A51,083647,Miranda; Gregory Joseph,37,0,37,0
1650381612433,CSE 8A,A50,083650,Miranda; Gregory Joseph,0,28,40,40
1650381618470,CSE 11,A01,083080,Cao; Yingjun,0,89,40,40
1650381624504,CSE 12,A01,083652,Staff,0,12,100,100
1650381630531,CSE 15L,A01,083654,Staff,0,1,50,50
1650381630531,CSE 15L,A02,083655,Staff,3,0,50,47
1650381636558,CSE 20,A01,083657,Staff,52,0,80,28
1650381642589,CSE 30,A01,083084,Eldon; John,0,76,40,40
1650381648611,CSE 100,A01,083659,Cao; Yingjun,0,66,50,50
1650381654636,CSE 134B,A01,083661,Powell; Thomas Allan,0,31,65,65
1650381660659,CSE 140,A01,083663,Staff,0,0,75,75
1650381666696,CSE 140L,A01,083088,Eldon; John,0,7,75,75
1650381672727,CSE 175,A01,083665,Kumar; Rakesh,8,0,25,17
1650381678751,CSE 190,A00,092507,Dubnov; Shlomo,14,0,20,6
1650381684775,ECE 45,A01,083139,Staff,0,17,40,40
1650381690799,ECE 65,A50,083695,Staff,0,5,30,30
1650381696824,ECE 109,A01,091882,Touri; Behrouz,40,0,70,30
1650381702848,ECE 180,A00,083140,Abi Samra; Nicholas Camill,23,0,30,7
1650381702848,ECE 180,B00,083141,Abi Samra; Nicholas Camill,5,0,30,25
1650381708875,MATH 10A,A01,083735,Patchell; Gregory David,7,0,30,23
1650381708875,MATH 10A,A02,083736,Patchell; Gregory David,28,0,30,2
1650381708875,MATH 10A,A03,083737,Patchell; Gregory David,25,0,30,5
1650381714903,MATH 10B,A01,083207,Staff,0,7,30,30
1650381714903,MATH 10B,A02,083208,Staff,0,6,30,30
1650381714903,MATH 10B,B01,083739,Staff,17,0,30,13
1650381714903,MATH 10B,B02,083740,Staff,28,0,30,2
1650381720934,MATH 18,A01,083743,Staff,3,0,30,27
1650381720934,MATH 18,A02,083744,Staff,27,0,30,3
1650381720934,MATH 18,A03,083745,Staff,22,0,30,8
1650381720934,MATH 18,A04,083746,Staff,27,0,30,3
1650381720934,MATH 18,B01,083748,Staff,0,11,30,30
1650381720934,MATH 18,B02,083749,Staff,0,12,30,30
1650381720934,MATH 18,B03,083750,Staff,0,11,30,30
1650381720934,MATH 18,B04,083751,Staff,0,9,30,30
1650381726957,MATH 20A,A01,083754,Staff,26,0,40,14
1650381732983,MATH 20B,A01,083756,Staff,0,8,30,30
1650381732983,MATH 20B,A02,083757,Staff,0,8,30,30
1650381739007,MATH 20C,A01,083760,Staff,0,14,30,30
1650381739007,MATH 20C,A02,083761,Staff,0,15,30,30
1650381739007,MATH 20C,B01,083762,Staff,13,0,30,17
1650381739007,MATH 20C,B02,083763,Staff,28,0,30,2
1650381745032,MATH 20D,A01,083765,Staff,0,1,30,30
1650381745032,MATH 20D,A02,083766,Staff,7,0,30,23
1650381745032,MATH 20D,A03,083767,Staff,26,0,30,4
1650381751056,MATH 20E,A01,083771,Staff,5,0,30,25
1650381751056,MATH 20E,A02,083772,Staff,19,0,30,11
1650381751056,MATH 20E,B01,083773,Staff,0,0,30,30
1650381751056,MATH 20E,B02,083774,Staff,12,0,30,18
1650381757079,MATH 103A,A01,083777,Staff,0,11,30,30
1650381757079,MATH 103A,A02,083778,Staff,0,12,30,30
1650381757079,MATH 103A,B01,083779,Staff,0,13,30,30
1650381757079,MATH 103A,B02,083780,Staff,0,11,30,30
1650381763104,MATH 105,A01,085443,Staff,0,21,30,30
1650381769129,MATH 109,A01,083213,Anzaldo; Leesa B,0,6,30,30
1650381769129,MATH 109,A02,083214,Anzaldo; Leesa B,0,7,30,30
1650381769129,MATH 109,B01,083215,Anzaldo; Leesa B,0,5,30,30
1650381769129,MATH 109,B02,083216,Anzaldo; Leesa B,0,5,30,30
1650381775153,MATH 142A,A01,083219,Chow; Bennett,0,14,30,30
1650381775153,MATH 142A,A02,083220,Chow; Bennett,0,13,30,30
1650381775153,MATH 142A,B01,083221,Chow; Bennett,0,12,30,30
1650381775153,MATH 142A,B02,083222,Chow; Bennett,0,12,30,30
1650381781178,MATH 193A,A01,083224,Staff,0,5,30,30
1650381781178,MATH 193A,A02,083225,Staff,0,5,30,30
1650381781178,MATH 193A,A03,083781,Staff,0,4,30,30
1650381781178,MATH 193A,A04,083782,Staff,0,4,30,30
1650381787202,MATH 197,001,091859,McAuley; Julian John,9998,0,9999,1
1650381793366,COGS 9,A01,083615,Staff,0,14,60,60
1650381799391,COGS 11,A01,083617,Boyle; Mary E. T.,22,0,40,18
1650381805420,COGS 13,A01,083071,Staff,0,32,40,40
1650381811447,COGS 14A,A01,092681,Staff,0,22,100,100
1650381817471,COGS 14B,A01,083073,Cheng; Tzu-Han,0,10,50,50
1650381823495,COGS 17,A01,092677,Staff,24,0,75,51
1650381829520,COGS 100,A01,083619,Staff,0,24,60,60
1650381835549,COGS 101A,A01,083621,Davis; Joshua Daniel,0,21,60,60
1650381841575,COGS 101B,A01,091572,Staff,0,0,60,60
1650381847608,COGS 101C,A01,083625,Delgado; Tania,16,0,30,14
1650381853646,COGS 107A,A01,083627,Boyle; Mary E. T.,0,10,60,60
1650381859673,COGS 118A,A01,083075,Staff,4,0,60,56
1650381865703,CSE 3,A50,083646,Miranda; Gregory Joseph,21,0,38,17
1650381865703,CSE 3,A51,083647,Miranda; Gregory Joseph,37,0,37,0
1650381871728,CSE 8A,A50,083650,Miranda; Gregory Joseph,0,28,40,40
1650381877760,CSE 11,A01,083080,Cao; Yingjun,0,89,40,40
1650381883785,CSE 12,A01,083652,Staff,0,12,100,100
1650381889809,CSE 15L,A01,083654,Staff,0,1,50,50
1650381889809,CSE 15L,A02,083655,Staff,3,0,50,47
1650381895843,CSE 20,A01,083657,Staff,52,0,80,28
1650381901873,CSE 30,A01,083084,Eldon; John,0,76,40,40
1650381907897,CSE 100,A01,083659,Cao; Yingjun,0,66,50,50
1650381913923,CSE 134B,A01,083661,Powell; Thomas Allan,0,31,65,65
1650381919947,CSE 140,A01,083663,Staff,0,0,75,75
1650381925974,CSE 140L,A01,083088,Eldon; John,0,7,75,75
1650381932006,CSE 175,A01,083665,Kumar; Rakesh,8,0,25,17
1650381938029,CSE 190,A00,092507,Dubnov; Shlomo,14,0,20,6
1650381944061,ECE 45,A01,083139,Staff,0,17,40,40
1650381950088,ECE 65,A50,083695,Staff,0,5,30,30
1650381956114,ECE 109,A01,091882,Touri; Behrouz,40,0,70,30
1650381962141,ECE 180,A00,083140,Abi Samra; Nicholas Camill,23,0,30,7
1650381962141,ECE 180,B00,083141,Abi Samra; Nicholas Camill,5,0,30,25
1650381968166,MATH 10A,A01,083735,Patchell; Gregory David,7,0,30,23
1650381968166,MATH 10A,A02,083736,Patchell; Gregory David,28,0,30,2
1650381968166,MATH 10A,A03,083737,Patchell; Gregory David,25,0,30,5
1650381974193,MATH 10B,A01,083207,Staff,0,7,30,30
1650381974193,MATH 10B,A02,083208,Staff,0,6,30,30
1650381974193,MATH 10B,B01,083739,Staff,17,0,30,13
1650381974193,MATH 10B,B02,083740,Staff,28,0,30,2
1650381980225,MATH 18,A01,083743,Staff,3,0,30,27
1650381980225,MATH 18,A02,083744,Staff,27,0,30,3
1650381980225,MATH 18,A03,083745,Staff,22,0,30,8
1650381980225,MATH 18,A04,083746,Staff,27,0,30,3
1650381980225,MATH 18,B01,083748,Staff,0,11,30,30
1650381980225,MATH 18,B02,083749,Staff,0,12,30,30
1650381980225,MATH 18,B03,083750,Staff,0,11,30,30
1650381980225,MATH 18,B04,083751,Staff,0,9,30,30
1650381986247,MATH 20A,A01,083754,Staff,26,0,40,14
1650381992274,MATH 20B,A01,083756,Staff,0,8,30,30
1650381992274,MATH 20B,A02,083757,Staff,0,8,30,30
1650381998323,MATH 20C,A01,083760,Staff,0,14,30,30
1650381998323,MATH 20C,A02,083761,Staff,0,15,30,30
1650381998323,MATH 20C,B01,083762,Staff,13,0,30,17
1650381998323,MATH 20C,B02,083763,Staff,28,0,30,2
1650382004350,MATH 20D,A01,083765,Staff,0,1,30,30
1650382004350,MATH 20D,A02,083766,Staff,7,0,30,23
1650382004350,MATH 20D,A03,083767,Staff,26,0,30,4
1650382010380,MATH 20E,A01,083771,Staff,5,0,30,25
1650382010380,MATH 20E,A02,083772,Staff,19,0,30,11
1650382010380,MATH 20E,B01,083773,Staff,0,0,30,30
1650382010380,MATH 20E,B02,083774,Staff,12,0,30,18
1650382016413,MATH 103A,A01,083777,Staff,0,11,30,30
1650382016413,MATH 103A,A02,083778,Staff,0,12,30,30
1650382016413,MATH 103A,B01,083779,Staff,0,13,30,30
1650382016413,MATH 103A,B02,083780,Staff,0,11,30,30
1650382022440,MATH 105,A01,085443,Staff,0,21,30,30
1650382028469,MATH 109,A01,083213,Anzaldo; Leesa B,0,6,30,30
1650382028469,MATH 109,A02,083214,Anzaldo; Leesa B,0,7,30,30
1650382028469,MATH 109,B01,083215,Anzaldo; Leesa B,0,5,30,30
1650382028469,MATH 109,B02,083216,Anzaldo; Leesa B,0,5,30,30
1650382034494,MATH 142A,A01,083219,Chow; Bennett,0,14,30,30
1650382034494,MATH 142A,A02,083220,Chow; Bennett,0,13,30,30
1650382034494,MATH 142A,B01,083221,Chow; Bennett,0,12,30,30
1650382034494,MATH 142A,B02,083222,Chow; Bennett,0,12,30,30
1650382040522,MATH 193A,A01,083224,Staff,0,5,30,30
1650382040522,MATH 193A,A02,083225,Staff,0,5,30,30
1650382040522,MATH 193A,A03,083781,Staff,0,4,30,30
1650382040522,MATH 193A,A04,083782,Staff,0,4,30,30
1650382046553,MATH 197,001,091859,McAuley; Julian John,9998,0,9999,1
1650382052613,COGS 9,A01,083615,Staff,0,14,60,60
1650382058647,COGS 11,A01,083617,Boyle; Mary E. T.,22,0,40,18
1650382064670,COGS 13,A01,083071,Staff,0,32,40,40
1650382070705,COGS 14A,A01,092681,Staff,0,22,100,100
1650382076730,COGS 14B,A01,083073,Cheng; Tzu-Han,0,10,50,50
1650382082755,COGS 17,A01,092677,Staff,24,0,75,51
1650382088787,COGS 100,A01,083619,Staff,0,24,60,60
1650382094811,COGS 101A,A01,083621,Davis; Joshua Daniel,0,21,60,60
1650382100837,COGS 101B,A01,091572,Staff,0,0,60,60
1650382106869,COGS 101C,A01,083625,Delgado; Tania,16,0,30,14
1650382112894,COGS 107A,A01,083627,Boyle; Mary E. T.,0,10,60,60
1650382118920,COGS 118A,A01,083075,Staff,4,0,60,56
1650382124943,CSE 3,A50,083646,Miranda; Gregory Joseph,21,0,38,17
1650382124943,CSE 3,A51,083647,Miranda; Gregory Joseph,37,0,37,0
1650382130973,CSE 8A,A50,083650,Miranda; Gregory Joseph,0,28,40,40
1650382136996,CSE 11,A01,083080,Cao; Yingjun,0,89,40,40
1650382143024,CSE 12,A01,083652,Staff,0,12,100,100
1650382149056,CSE 15L,A01,083654,Staff,0,1,50,50
1650382149056,CSE 15L,A02,083655,Staff,3,0,50,47
1650382155083,CSE 20,A01,083657,Staff,52,0,80,28
1650382161117,CSE 30,A01,083084,Eldon; John,0,76,40,40
1650382167140,CSE 100,A01,083659,Cao; Yingjun,0,66,50,50
1650382173163,CSE 134B,A01,083661,Powell; Thomas Allan,0,31,65,65
1650382179191,CSE 140,A01,083663,Staff,0,0,75,75
1650382185226,CSE 140L,A01,083088,Eldon; John,0,7,75,75
1650382191268,CSE 175,A01,083665,Kumar; Rakesh,8,0,25,17
1650382197292,CSE 190,A00,092507,Dubnov; Shlomo,14,0,20,6
1650382203321,ECE 45,A01,083139,Staff,0,17,40,40
1650382209345,ECE 65,A50,083695,Staff,0,5,30,30
1650382215369,ECE 109,A01,091882,Touri; Behrouz,40,0,70,30
1650382221404,ECE 180,A00,083140,Abi Samra; Nicholas Camill,23,0,30,7
1650382221404,ECE 180,B00,083141,Abi Samra; Nicholas Camill,5,0,30,25
1650382227429,MATH 10A,A01,083735,Patchell; Gregory David,7,0,30,23
1650382227429,MATH 10A,A02,083736,Patchell; Gregory David,28,0,30,2
1650382227429,MATH 10A,A03,083737,Patchell; Gregory David,25,0,30,5
1650382233458,MATH 10B,A01,083207,Staff,0,7,30,30
1650382233458,MATH 10B,A02,083208,Staff,0,6,30,30
1650382233458,MATH 10B,B01,083739,Staff,17,0,30,13
1650382233458,MATH 10B,B02,083740,Staff,28,0,30,2
1650382239492,MATH 18,A01,083743,Staff,3,0,30,27
1650382239492,MATH 18,A02,083744,Staff,27,0,30,3
1650382239492,MATH 18,A03,083745,Staff,22,0,30,8
1650382239492,MATH 18,A04,083746,Staff,27,0,30,3
1650382239492,MATH 18,B01,083748,Staff,0,11,30,30
1650382239492,MATH 18,B02,083749,Staff,0,12,30,30
1650382239492,MATH 18,B03,083750,Staff,0,11,30,30
1650382239492,MATH 18,B04,083751,Staff,0,9,30,30
1650382245519,MATH 20A,A01,083754,Staff,26,0,40,14
1650382251546,MATH 20B,A01,083756,Staff,0,8,30,30
1650382251546,MATH 20B,A02,083757,Staff,0,8,30,30
1650382257569,MATH 20C,A01,083760,Staff,0,14,30,30
1650382257569,MATH 20C,A02,083761,Staff,0,15,30,30
1650382257569,MATH 20C,B01,083762,Staff,13,0,30,17
1650382257569,MATH 20C,B02,083763,Staff,28,0,30,2
1650382263593,MATH 20D,A01,083765,Staff,0,1,30,30
1650382263593,MATH 20D,A02,083766,Staff,7,0,30,23
1650382263593,MATH 20D,A03,083767,Staff,26,0,30,4
1650382269621,MATH 20E,A01,083771,Staff,5,0,30,25
1650382269621,MATH 20E,A02,083772,Staff,19,0,30,11
1650382269621,MATH 20E,B01,083773,Staff,0,0,30,30
1650382269621,MATH 20E,B02,083774,Staff,12,0,30,18
1650382275650,MATH 103A,A01,083777,Staff,0,11,30,30
1650382275650,MATH 103A,A02,083778,Staff,0,12,30,30
1650382275650,MATH 103A,B01,083779,Staff,0,13,30,30
1650382275650,MATH 103A,B02,083780,Staff,0,11,30,30
1650382281685,MATH 105,A01,085443,Staff,0,21,30,30
1650382287709,MATH 109,A01,083213,Anzaldo; Leesa B,0,6,30,30
1650382287709,MATH 109,A02,083214,Anzaldo; Leesa B,0,7,30,30
1650382287709,MATH 109,B01,083215,Anzaldo; Leesa B,0,5,30,30
1650382287709,MATH 109,B02,083216,Anzaldo; Leesa B,0,5,30,30
1650382293735,MATH 142A,A01,083219,Chow; Bennett,0,14,30,30
1650382293735,MATH 142A,A02,083220,Chow; Bennett,0,13,30,30
1650382293735,MATH 142A,B01,083221,Chow; Bennett,0,12,30,30
1650382293735,MATH 142A,B02,083222,Chow; Bennett,0,12,30,30
1650382299763,MATH 193A,A01,083224,Staff,0,5,30,30
1650382299763,MATH 193A,A02,083225,Staff,0,5,30,30
1650382299763,MATH 193A,A03,083781,Staff,0,4,30,30
1650382299763,MATH 193A,A04,083782,Staff,0,4,30,30
1650382305789,MATH 197,001,091859,McAuley; Julian John,9998,0,9999,1
1650382311848,COGS 9,A01,083615,Staff,0,14,60,60
1650382317871,COGS 11,A01,083617,Boyle; Mary E. T.,22,0,40,18
1650382323920,COGS 13,A01,083071,Staff,0,32,40,40
1650382329947,COGS 14A,A01,092681,Staff,0,22,100,100
1650382335982,COGS 14B,A01,083073,Cheng; Tzu-Han,0,10,50,50
1650382342007,COGS 17,A01,092677,Staff,24,0,75,51
1650382348034,COGS 100,A01,083619,Staff,0,24,60,60
1650382354060,COGS 101A,A01,083621,Davis; Joshua Daniel,0,21,60,60
1650382360088,COGS 101B,A01,091572,Staff,0,0,60,60
1650382366112,COGS 101C,A01,083625,Delgado; Tania,16,0,30,14
1650382372138,COGS 107A,A01,083627,Boyle; Mary E. T.,0,10,60,60
1650382378163,COGS 118A,A01,083075,Staff,4,0,60,56
1650382384192,CSE 3,A50,083646,Miranda; Gregory Joseph,21,0,38,17
1650382384192,CSE 3,A51,083647,Miranda; Gregory Joseph,37,0,37,0
1650382390321,CSE 8A,A50,083650,Miranda; Gregory Joseph,0,28,40,40
1650382396348,CSE 11,A01,083080,Cao; Yingjun,0,89,40,40
1650382402380,CSE 12,A01,083652,Staff,0,12,100,100
1650382408408,CSE 15L,A01,083654,Staff,0,1,50,50
1650382408408,CSE 15L,A02,083655,Staff,3,0,50,47
1650382414433,CSE 20,A01,083657,Staff,52,0,80,28
1650382420465,CSE 30,A01,083084,Eldon; John,0,76,40,40
1650382426493,CSE 100,A01,083659,Cao; Yingjun,0,66,50,50
1650382432517,CSE 134B,A01,083661,Powell; Thomas Allan,0,31,65,65
1650382438546,CSE 140,A01,083663,Staff,0,0,75,75
1650382444571,CSE 140L,A01,083088,Eldon; John,0,7,75,75
1650382450596,CSE 175,A01,083665,Kumar; Rakesh,8,0,25,17
1650382456631,CSE 190,A00,092507,Dubnov; Shlomo,14,0,20,6
1650382462661,ECE 45,A01,083139,Staff,0,17,40,40
1650382468694,ECE 65,A50,083695,Staff,0,5,30,30
1650382474719,ECE 109,A01,091882,Touri; Behrouz,40,0,70,30
1650382480755,ECE 180,A00,083140,Abi Samra; Nicholas Camill,23,0,30,7
1650382480755,ECE 180,B00,083141,Abi Samra; Nicholas Camill,5,0,30,25
1650382486789,MATH 10A,A01,083735,Patchell; Gregory David,7,0,30,23
1650382486789,MATH 10A,A02,083736,Patchell; Gregory David,28,0,30,2
1650382486789,MATH 10A,A03,083737,Patchell; Gregory David,25,0,30,5
1650382492820,MATH 10B,A01,083207,Staff,0,7,30,30
1650382492820,MATH 10B,A02,083208,Staff,0,6,30,30
1650382492820,MATH 10B,B01,083739,Staff,17,0,30,13
1650382492820,MATH 10B,B02,083740,Staff,28,0,30,2
1650382498856,MATH 18,A01,083743,Staff,3,0,30,27
1650382498856,MATH 18,A02,083744,Staff,27,0,30,3
1650382498856,MATH 18,A03,083745,Staff,22,0,30,8
1650382498856,MATH 18,A04,083746,Staff,27,0,30,3
1650382498856,MATH 18,B01,083748,Staff,0,11,30,30
1650382498856,MATH 18,B02,083749,Staff,0,12,30,30
1650382498856,MATH 18,B03,083750,Staff,0,11,30,30
1650382498856,MATH 18,B04,083751,Staff,0,9,30,30
1650382504883,MATH 20A,A01,083754,Staff,26,0,40,14
1650382510910,MATH 20B,A01,083756,Staff,0,8,30,30
1650382510910,MATH 20B,A02,083757,Staff,0,8,30,30
1650382516937,MATH 20C,A01,083760,Staff,0,14,30,30
1650382516937,MATH 20C,A02,083761,Staff,0,15,30,30
1650382516937,MATH 20C,B01,083762,Staff,13,0,30,17
1650382516937,MATH 20C,B02,083763,Staff,28,0,30,2
1650382522963,MATH 20D,A01,083765,Staff,0,1,30,30
1650382522963,MATH 20D,A02,083766,Staff,7,0,30,23
1650382522963,MATH 20D,A03,083767,Staff,26,0,30,4
1650382528990,MATH 20E,A01,083771,Staff,5,0,30,25
1650382528990,MATH 20E,A02,083772,Staff,19,0,30,11
1650382528990,MATH 20E,B01,083773,Staff,0,0,30,30
1650382528990,MATH 20E,B02,083774,Staff,12,0,30,18
1650382535015,MATH 103A,A01,083777,Staff,0,11,30,30
1650382535015,MATH 103A,A02,083778,Staff,0,12,30,30
1650382535015,MATH 103A,B01,083779,Staff,0,13,30,30
1650382535015,MATH 103A,B02,083780,Staff,0,11,30,30
1650382541039,MATH 105,A01,085443,Staff,0,21,30,30
1650382547086,MATH 109,A01,083213,Anzaldo; Leesa B,0,6,30,30
1650382547086,MATH 109,A02,083214,Anzaldo; Leesa B,0,7,30,30
1650382547086,MATH 109,B01,083215,Anzaldo; Leesa B,0,5,30,30
1650382547086,MATH 109,B02,083216,Anzaldo; Leesa B,0,5,30,30
1650382553111,MATH 142A,A01,083219,Chow; Bennett,0,14,30,30
1650382553111,MATH 142A,A02,083220,Chow; Bennett,0,13,30,30
1650382553111,MATH 142A,B01,083221,Chow; Bennett,0,12,30,30
1650382553111,MATH 142A,B02,083222,Chow; Bennett,0,12,30,30
1650382559143,MATH 193A,A01,083224,Staff,0,5,30,30
1650382559143,MATH 193A,A02,083225,Staff,0,5,30,30
1650382559143,MATH 193A,A03,083781,Staff,0,4,30,30
1650382559143,MATH 193A,A04,083782,Staff,0,4,30,30
1650382565174,MATH 197,001,091859,McAuley; Julian John,9998,0,9999,1
1650382571228,COGS 9,A01,083615,Staff,0,14,60,60
1650382577258,COGS 11,A01,083617,Boyle; Mary E. T.,22,0,40,18
1650382583280,COGS 13,A01,083071,Staff,0,32,40,40
1650382589313,COGS 14A,A01,092681,Staff,0,22,100,100
1650382595339,COGS 14B,A01,083073,Cheng; Tzu-Han,0,10,50,50
1650382601363,COGS 17,A01,092677,Staff,24,0,75,51
1650382607390,COGS 100,A01,083619,Staff,0,24,60,60
1650382613420,COGS 101A,A01,083621,Davis; Joshua Daniel,0,21,60,60
1650382619452,COGS 101B,A01,091572,Staff,0,0,60,60
1650382625480,COGS 101C,A01,083625,Delgado; Tania,16,0,30,14
1650382631516,COGS 107A,A01,083627,Boyle; Mary E. T.,0,10,60,60
1650382637542,COGS 118A,A01,083075,Staff,4,0,60,56
1650382643576,CSE 3,A50,083646,Miranda; Gregory Joseph,21,0,38,17
1650382643576,CSE 3,A51,083647,Miranda; Gregory Joseph,37,0,37,0
1650382649601,CSE 8A,A50,083650,Miranda; Gregory Joseph,0,28,40,40
1650382655638,CSE 11,A01,083080,Cao; Yingjun,0,89,40,40
1650382661669,CSE 12,A01,083652,Staff,0,12,100,100
1650382667694,CSE 15L,A01,083654,Staff,0,1,50,50
1650382667694,CSE 15L,A02,083655,Staff,3,0,50,47
1650382673717,CSE 20,A01,083657,Staff,52,0,80,28
1650382679745,CSE 30,A01,083084,Eldon; John,0,76,40,40
1650382685770,CSE 100,A01,083659,Cao; Yingjun,0,66,50,50
1650382691797,CSE 134B,A01,083661,Powell; Thomas Allan,0,31,65,65
1650382697831,CSE 140,A01,083663,Staff,0,0,75,75
1650382703853,CSE 140L,A01,083088,Eldon; John,0,7,75,75
1650382709884,CSE 175,A01,083665,Kumar; Rakesh,8,0,25,17
1650382715913,CSE 190,A00,092507,Dubnov; Shlomo,14,0,20,6
1650382721937,ECE 45,A01,083139,Staff,0,17,40,40
1650382727968,ECE 65,A50,083695,Staff,0,5,30,30
1650382733995,ECE 109,A01,091882,Touri; Behrouz,40,0,70,30
1650382740023,ECE 180,A00,083140,Abi Samra; Nicholas Camill,23,0,30,7
1650382740023,ECE 180,B00,083141,Abi Samra; Nicholas Camill,5,0,30,25
1650382746049,MATH 10A,A01,083735,Patchell; Gregory David,7,0,30,23
1650382746049,MATH 10A,A02,083736,Patchell; Gregory David,28,0,30,2
1650382746049,MATH 10A,A03,083737,Patchell; Gregory David,25,0,30,5
1650382752077,MATH 10B,A01,083207,Staff,0,7,30,30
1650382752077,MATH 10B,A02,083208,Staff,0,6,30,30
1650382752077,MATH 10B,B01,083739,Staff,17,0,30,13
1650382752077,MATH 10B,B02,083740,Staff,28,0,30,2
1650382758107,MATH 18,A01,083743,Staff,3,0,30,27
1650382758107,MATH 18,A02,083744,Staff,27,0,30,3
1650382758107,MATH 18,A03,083745,Staff,22,0,30,8
1650382758107,MATH 18,A04,083746,Staff,27,0,30,3
1650382758107,MATH 18,B01,083748,Staff,0,11,30,30
1650382758107,MATH 18,B02,083749,Staff,0,12,30,30
1650382758107,MATH 18,B03,083750,Staff,0,11,30,30
1650382758107,MATH 18,B04,083751,Staff,0,9,30,30
1650382764132,MATH 20A,A01,083754,Staff,26,0,40,14
1650382770160,MATH 20B,A01,083756,Staff,0,8,30,30
1650382770160,MATH 20B,A02,083757,Staff,0,8,30,30
1650382776185,MATH 20C,A01,083760,Staff,0,14,30,30
1650382776185,MATH 20C,A02,083761,Staff,0,15,30,30
1650382776185,MATH 20C,B01,083762,Staff,13,0,30,17
1650382776185,MATH 20C,B02,083763,Staff,28,0,30,2
1650382782217,MATH 20D,A01,083765,Staff,0,1,30,30
1650382782217,MATH 20D,A02,083766,Staff,7,0,30,23
1650382782217,MATH 20D,A03,083767,Staff,26,0,30,4
1650382788244,MATH 20E,A01,083771,Staff,5,0,30,25
1650382788244,MATH 20E,A02,083772,Staff,19,0,30,11
1650382788244,MATH 20E,B01,083773,Staff,0,0,30,30
1650382788244,MATH 20E,B02,083774,Staff,12,0,30,18
1650382794272,MATH 103A,A01,083777,Staff,0,11,30,30
1650382794272,MATH 103A,A02,083778,Staff,0,12,30,30
1650382794272,MATH 103A,B01,083779,Staff,0,13,30,30
1650382794272,MATH 103A,B02,083780,Staff,0,11,30,30
1650382800299,MATH 105,A01,085443,Staff,0,21,30,30
1650382806323,MATH 109,A01,083213,Anzaldo; Leesa B,0,6,30,30
1650382806323,MATH 109,A02,083214,Anzaldo; Leesa B,0,7,30,30
1650382806323,MATH 109,B01,083215,Anzaldo; Leesa B,0,5,30,30
1650382806323,MATH 109,B02,083216,Anzaldo; Leesa B,0,5,30,30
1650382812353,MATH 142A,A01,083219,Chow; Bennett,0,14,30,30
1650382812353,MATH 142A,A02,083220,Chow; Bennett,0,13,30,30
1650382812353,MATH 142A,B01,083221,Chow; Bennett,0,12,30,30
1650382812353,MATH 142A,B02,083222,Chow; Bennett,0,12,30,30
1650382818380,MATH 193A,A01,083224,Staff,0,5,30,30
1650382818380,MATH 193A,A02,083225,Staff,0,5,30,30
1650382818380,MATH 193A,A03,083781,Staff,0,4,30,30
1650382818380,MATH 193A,A04,083782,Staff,0,4,30,30
1650382824422,MATH 197,001,091859,McAuley; Julian John,9998,0,9999,1
1650382830484,COGS 9,A01,083615,Staff,0,14,60,60
1650382836508,COGS 11,A01,083617,Boyle; Mary E. T.,22,0,40,18
1650382842535,COGS 13,A01,083071,Staff,0,32,40,40
1650382848560,COGS 14A,A01,092681,Staff,0,22,100,100
1650382854595,COGS 14B,A01,083073,Cheng; Tzu-Han,0,10,50,50
1650382860618,COGS 17,A01,092677,Staff,24,0,75,51
1650382866641,COGS 100,A01,083619,Staff,0,24,60,60
1650382872667,COGS 101A,A01,083621,Davis; Joshua Daniel,0,21,60,60
1650382878696,COGS 101B,A01,091572,Staff,0,0,60,60
1650382884729,COGS 101C,A01,083625,Delgado; Tania,16,0,30,14
1650382890754,COGS 107A,A01,083627,Boyle; Mary E. T.,0,10,60,60
1650382896777,COGS 118A,A01,083075,Staff,4,0,60,56
1650382902802,CSE 3,A50,083646,Miranda; Gregory Joseph,21,0,38,17
1650382902802,CSE 3,A51,083647,Miranda; Gregory Joseph,37,0,37,0
1650382908833,CSE 8A,A50,083650,Miranda; Gregory Joseph,0,28,40,40
1650382914857,CSE 11,A01,083080,Cao; Yingjun,0,89,40,40
1650382920885,CSE 12,A01,083652,Staff,0,12,100,100
1650382926912,CSE 15L,A01,083654,Staff,0,1,50,50
1650382926912,CSE 15L,A02,083655,Staff,3,0,50,47
1650382932942,CSE 20,A01,083657,Staff,52,0,80,28
1650382938968,CSE 30,A01,083084,Eldon; John,0,76,40,40
1650382944995,CSE 100,A01,083659,Cao; Yingjun,0,66,50,50
1650382951022,CSE 134B,A01,083661,Powell; Thomas Allan,0,31,65,65
1650382957046,CSE 140,A01,083663,Staff,0,0,75,75
1650382963079,CSE 140L,A01,083088,Eldon; John,0,7,75,75
1650382969118,CSE 175,A01,083665,Kumar; Rakesh,8,0,25,17
1650382975144,CSE 190,A00,092507,Dubnov; Shlomo,14,0,20,6
1650382981170,ECE 45,A01,083139,Staff,0,17,40,40
1650382987291,ECE 65,A50,083695,Staff,0,5,30,30
1650382993316,ECE 109,A01,091882,Touri; Behrouz,40,0,70,30
1650382999354,ECE 180,A00,083140,Abi Samra; Nicholas Camill,23,0,30,7
1650382999354,ECE 180,B00,083141,Abi Samra; Nicholas Camill,5,0,30,25
1650383005378,MATH 10A,A01,083735,Patchell; Gregory David,7,0,30,23
1650383005378,MATH 10A,A02,083736,Patchell; Gregory David,28,0,30,2
1650383005378,MATH 10A,A03,083737,Patchell; Gregory David,25,0,30,5
1650383011400,MATH 10B,A01,083207,Staff,0,7,30,30
1650383011400,MATH 10B,A02,083208,Staff,0,6,30,30
1650383011400,MATH 10B,B01,083739,Staff,17,0,30,13
1650383011400,MATH 10B,B02,083740,Staff,28,0,30,2
1650383017426,MATH 18,A01,083743,Staff,3,0,30,27
1650383017426,MATH 18,A02,083744,Staff,27,0,30,3
1650383017426,MATH 18,A03,083745,Staff,22,0,30,8
1650383017426,MATH 18,A04,083746,Staff,27,0,30,3
1650383017426,MATH 18,B01,083748,Staff,0,11,30,30
1650383017426,MATH 18,B02,083749,Staff,0,12,30,30
1650383017426,MATH 18,B03,083750,Staff,0,11,30,30
1650383017426,MATH 18,B04,083751,Staff,0,9,30,30
1650383023449,MATH 20A,A01,083754,Staff,26,0,40,14
1650383029474,MATH 20B,A01,083756,Staff,0,8,30,30
1650383029474,MATH 20B,A02,083757,Staff,0,8,30,30
1650383035501,MATH 20C,A01,083760,Staff,0,14,30,30
1650383035501,MATH 20C,A02,083761,Staff,0,15,30,30
1650383035501,MATH 20C,B01,083762,Staff,13,0,30,17
1650383035501,MATH 20C,B02,083763,Staff,28,0,30,2
1650383041533,MATH 20D,A01,083765,Staff,0,1,30,30
1650383041533,MATH 20D,A02,083766,Staff,7,0,30,23
1650383041533,MATH 20D,A03,083767,Staff,26,0,30,4
1650383047563,MATH 20E,A01,083771,Staff,5,0,30,25
1650383047563,MATH 20E,A02,083772,Staff,19,0,30,11
1650383047563,MATH 20E,B01,083773,Staff,0,0,30,30
1650383047563,MATH 20E,B02,083774,Staff,12,0,30,18
1650383053593,MATH 103A,A01,083777,Staff,0,11,30,30
1650383053593,MATH 103A,A02,083778,Staff,0,12,30,30
1650383053593,MATH 103A,B01,083779,Staff,0,13,30,30
1650383053593,MATH 103A,B02,083780,Staff,0,11,30,30
1650383059618,MATH 105,A01,085443,Staff,0,21,30,30
1650383065646,MATH 109,A01,083213,Anzaldo; Leesa B,0,6,30,30
1650383065646,MATH 109,A02,083214,Anzaldo; Leesa B,0,7,30,30
1650383065646,MATH 109,B01,083215,Anzaldo; Leesa B,0,5,30,30
1650383065646,MATH 109,B02,083216,Anzaldo; Leesa B,0,5,30,30
1650383071677,MATH 142A,A01,083219,Chow; Bennett,0,14,30,30
1650383071677,MATH 142A,A02,083220,Chow; Bennett,0,13,30,30
1650383071677,MATH 142A,B01,083221,Chow; Bennett,0,12,30,30
1650383071677,MATH 142A,B02,083222,Chow; Bennett,0,12,30,30
1650383077703,MATH 193A,A01,083224,Staff,0,5,30,30
1650383077703,MATH 193A,A02,083225,Staff,0,5,30,30
1650383077703,MATH 193A,A03,083781,Staff,0,4,30,30
1650383077703,MATH 193A,A04,083782,Staff,0,4,30,30
1650383083741,MATH 197,001,091859,McAuley; Julian John,9998,0,9999,1
1650383089791,COGS 9,A01,083615,Staff,0,14,60,60
1650383095817,COGS 11,A01,083617,Boyle; Mary E. T.,22,0,40,18
1650383101850,COGS 13,A01,083071,Staff,0,32,40,40
1650383107883,COGS 14A,A01,092681,Staff,0,22,100,100
1650383113907,COGS 14B,A01,083073,Cheng; Tzu-Han,0,10,50,50
1650383119936,COGS 17,A01,092677,Staff,24,0,75,51
1650383125972,COGS 100,A01,083619,Staff,0,24,60,60
1650383131996,COGS 101A,A01,083621,Davis; Joshua Daniel,0,21,60,60
1650383138021,COGS 101B,A01,091572,Staff,0,0,60,60
1650383144056,COGS 101C,A01,083625,Delgado; Tania,16,0,30,14
1650383150086,COGS 107A,A01,083627,Boyle; Mary E. T.,0,10,60,60
1650383156109,COGS 118A,A01,083075,Staff,4,0,60,56
1650383162151,CSE 3,A50,083646,Miranda; Gregory Joseph,21,0,38,17
1650383162151,CSE 3,A51,083647,Miranda; Gregory Joseph,37,0,37,0
1650383168179,CSE 8A,A50,083650,Miranda; Gregory Joseph,0,28,40,40
1650383174207,CSE 11,A01,083080,Cao; Yingjun,0,89,40,40
1650383180231,CSE 12,A01,083652,Staff,0,12,100,100
1650383186261,CSE 15L,A01,083654,Staff,0,1,50,50
1650383186261,CSE 15L,A02,083655,Staff,3,0,50,47
1650383192294,CSE 20,A01,083657,Staff,52,0,80,28
1650383198319,CSE 30,A01,083084,Eldon; John,0,76,40,40
1650383204357,CSE 100,A01,083659,Cao; Yingjun,0,66,50,50
1650383210389,CSE 134B,A01,083661,Powell; Thomas Allan,0,31,65,65
1650383216419,CSE 140,A01,083663,Staff,0,0,75,75
1650383222447,CSE 140L,A01,083088,Eldon; John,0,7,75,75
1650383228483,CSE 175,A01,083665,Kumar; Rakesh,8,0,25,17
1650383234515,CSE 190,A00,092507,Dubnov; Shlomo,14,0,20,6
1650383240541,ECE 45,A01,083139,Staff,0,17,40,40
1650383246566,ECE 65,A50,083695,Staff,0,5,30,30
1650383252592,ECE 109,A01,091882,Touri; Behrouz,40,0,70,30
1650383258616,ECE 180,A00,083140,Abi Samra; Nicholas Camill,23,0,30,7
1650383258616,ECE 180,B00,083141,Abi Samra; Nicholas Camill,5,0,30,25
1650383264645,MATH 10A,A01,083735,Patchell; Gregory David,7,0,30,23
1650383264645,MATH 10A,A02,083736,Patchell; Gregory David,28,0,30,2
1650383264645,MATH 10A,A03,083737,Patchell; Gregory David,25,0,30,5
1650383270671,MATH 10B,A01,083207,Staff,0,7,30,30
1650383270671,MATH 10B,A02,083208,Staff,0,6,30,30
1650383270671,MATH 10B,B01,083739,Staff,17,0,30,13
1650383270671,MATH 10B,B02,083740,Staff,28,0,30,2
1650383276706,MATH 18,A01,083743,Staff,3,0,30,27
1650383276706,MATH 18,A02,083744,Staff,27,0,30,3
1650383276706,MATH 18,A03,083745,Staff,22,0,30,8
1650383276706,MATH 18,A04,083746,Staff,27,0,30,3
1650383276706,MATH 18,B01,083748,Staff,0,11,30,30
1650383276706,MATH 18,B02,083749,Staff,0,12,30,30
1650383276706,MATH 18,B03,083750,Staff,0,11,30,30
1650383276706,MATH 18,B04,083751,Staff,0,9,30,30
1650383282732,MATH 20A,A01,083754,Staff,26,0,40,14
1650383288757,MATH 20B,A01,083756,Staff,0,8,30,30
1650383288757,MATH 20B,A02,083757,Staff,0,8,30,30
1650383294782,MATH 20C,A01,083760,Staff,0,14,30,30
1650383294782,MATH 20C,A02,083761,Staff,0,15,30,30
1650383294782,MATH 20C,B01,083762,Staff,13,0,30,17
1650383294782,MATH 20C,B02,083763,Staff,28,0,30,2
1650383300809,MATH 20D,A01,083765,Staff,0,1,30,30
1650383300809,MATH 20D,A02,083766,Staff,7,0,30,23
1650383300809,MATH 20D,A03,083767,Staff,26,0,30,4
1650383306834,MATH 20E,A01,083771,Staff,5,0,30,25
1650383306834,MATH 20E,A02,083772,Staff,19,0,30,11
1650383306834,MATH 20E,B01,083773,Staff,0,0,30,30
1650383306834,MATH 20E,B02,083774,Staff,12,0,30,18
1650383312873,MATH 103A,A01,083777,Staff,0,11,30,30
1650383312873,MATH 103A,A02,083778,Staff,0,12,30,30
1650383312873,MATH 103A,B01,083779,Staff,0,13,30,30
1650383312873,MATH 103A,B02,083780,Staff,0,11,30,30
1650383318901,MATH 105,A01,085443,Staff,0,21,30,30
1650383324931,MATH 109,A01,083213,Anzaldo; Leesa B,0,6,30,30
1650383324931,MATH 109,A02,083214,Anzaldo; Leesa B,0,7,30,30
1650383324931,MATH 109,B01,083215,Anzaldo; Leesa B,0,5,30,30
1650383324931,MATH 109,B02,083216,Anzaldo; Leesa B,0,5,30,30
1650383330968,MATH 142A,A01,083219,Chow; Bennett,0,14,30,30
1650383330968,MATH 142A,A02,083220,Chow; Bennett,0,13,30,30
1650383330968,MATH 142A,B01,083221,Chow; Bennett,0,12,30,30
1650383330968,MATH 142A,B02,083222,Chow; Bennett,0,12,30,30
1650383336997,MATH 193A,A01,083224,Staff,0,5,30,30
1650383336997,MATH 193A,A02,083225,Staff,0,5,30,30
1650383336997,MATH 193A,A03,083781,Staff,0,4,30,30
1650383336997,MATH 193A,A04,083782,Staff,0,4,30,30
1650383343022,MATH 197,001,091859,McAuley; Julian John,9998,0,9999,1
1650383349078,COGS 9,A01,083615,Staff,0,14,60,60
1650383355101,COGS 11,A01,083617,Boyle; Mary E. T.,22,0,40,18
1650383361126,COGS 13,A01,083071,Staff,0,32,40,40
1650383367153,COGS 14A,A01,092681,Staff,0,22,100,100
1650383373176,COGS 14B,A01,083073,Cheng; Tzu-Han,0,10,50,50
1650383379203,COGS 17,A01,092677,Staff,24,0,75,51
1650383385228,COGS 100,A01,083619,Staff,0,24,60,60
1650383391254,COGS 101A,A01,083621,Davis; Joshua Daniel,0,21,60,60
1650383397277,COGS 101B,A01,091572,Staff,0,0,60,60
1650383403302,COGS 101C,A01,083625,Delgado; Tania,16,0,30,14
1650383409331,COGS 107A,A01,083627,Boyle; Mary E. T.,0,10,60,60
1650383415357,COGS 118A,A01,083075,Staff,4,0,60,56
1650383421383,CSE 3,A50,083646,Miranda; Gregory Joseph,21,0,38,17
1650383421383,CSE 3,A51,083647,Miranda; Gregory Joseph,37,0,37,0
1650383427413,CSE 8A,A50,083650,Miranda; Gregory Joseph,0,28,40,40
1650383433436,CSE 11,A01,083080,Cao; Yingjun,0,89,40,40
1650383439462,CSE 12,A01,083652,Staff,0,12,100,100
1650383445490,CSE 15L,A01,083654,Staff,0,1,50,50
1650383445490,CSE 15L,A02,083655,Staff,3,0,50,47
1650383451515,CSE 20,A01,083657,Staff,52,0,80,28
1650383457548,CSE 30,A01,083084,Eldon; John,0,76,40,40
1650383463574,CSE 100,A01,083659,Cao; Yingjun,0,66,50,50
1650383469602,CSE 134B,A01,083661,Powell; Thomas Allan,0,31,65,65
1650383475636,CSE 140,A01,083663,Staff,0,0,75,75
1650383481661,CSE 140L,A01,083088,Eldon; John,0,7,75,75
1650383487696,CSE 175,A01,083665,Kumar; Rakesh,8,0,25,17
1650383493722,CSE 190,A00,092507,Dubnov; Shlomo,14,0,20,6
1650383499758,ECE 45,A01,083139,Staff,0,17,40,40
1650383505782,ECE 65,A50,083695,Staff,0,5,30,30
1650383511809,ECE 109,A01,091882,Touri; Behrouz,40,0,70,30
1650383517832,ECE 180,A00,083140,Abi Samra; Nicholas Camill,23,0,30,7
1650383517832,ECE 180,B00,083141,Abi Samra; Nicholas Camill,5,0,30,25
1650383523855,MATH 10A,A01,083735,Patchell; Gregory David,7,0,30,23
1650383523855,MATH 10A,A02,083736,Patchell; Gregory David,28,0,30,2
1650383523855,MATH 10A,A03,083737,Patchell; Gregory David,25,0,30,5
1650383536758,MATH 10B,A01,083207,Staff,0,7,30,30
1650383536758,MATH 10B,A02,083208,Staff,0,6,30,30
1650383536758,MATH 10B,B01,083739,Staff,17,0,30,13
1650383536758,MATH 10B,B02,083740,Staff,28,0,30,2
1650383542792,MATH 18,A01,083743,Staff,3,0,30,27
1650383542792,MATH 18,A02,083744,Staff,27,0,30,3
1650383542792,MATH 18,A03,083745,Staff,22,0,30,8
1650383542792,MATH 18,A04,083746,Staff,27,0,30,3
1650383542792,MATH 18,B01,083748,Staff,0,11,30,30
1650383542792,MATH 18,B02,083749,Staff,0,12,30,30
1650383542792,MATH 18,B03,083750,Staff,0,11,30,30
1650383542792,MATH 18,B04,083751,Staff,0,9,30,30
1650383548826,MATH 20A,A01,083754,Staff,26,0,40,14
1650383554856,MATH 20B,A01,083756,Staff,0,8,30,30
1650383554856,MATH 20B,A02,083757,Staff,0,8,30,30
1650383560885,MATH 20C,A01,083760,Staff,0,14,30,30
1650383560885,MATH 20C,A02,083761,Staff,0,15,30,30
1650383560885,MATH 20C,B01,083762,Staff,13,0,30,17
1650383560885,MATH 20C,B02,083763,Staff,28,0,30,2
1650383566910,MATH 20D,A01,083765,Staff,0,1,30,30
1650383566910,MATH 20D,A02,083766,Staff,7,0,30,23
1650383566910,MATH 20D,A03,083767,Staff,26,0,30,4
1650383572936,MATH 20E,A01,083771,Staff,5,0,30,25
1650383572936,MATH 20E,A02,083772,Staff,19,0,30,11
1650383572936,MATH 20E,B01,083773,Staff,0,0,30,30
1650383572936,MATH 20E,B02,083774,Staff,12,0,30,18
1650383578962,MATH 103A,A01,083777,Staff,0,11,30,30
1650383578962,MATH 103A,A02,083778,Staff,0,12,30,30
1650383578962,MATH 103A,B01,083779,Staff,0,13,30,30
1650383578962,MATH 103A,B02,083780,Staff,0,11,30,30
1650383584991,MATH 105,A01,085443,Staff,0,21,30,30
1650383591115,MATH 109,A01,083213,Anzaldo; Leesa B,0,6,30,30
1650383591115,MATH 109,A02,083214,Anzaldo; Leesa B,0,7,30,30
1650383591115,MATH 109,B01,083215,Anzaldo; Leesa B,0,5,30,30
1650383591115,MATH 109,B02,083216,Anzaldo; Leesa B,0,5,30,30
1650383597143,MATH 142A,A01,083219,Chow; Bennett,0,14,30,30
1650383597143,MATH 142A,A02,083220,Chow; Bennett,0,13,30,30
1650383597143,MATH 142A,B01,083221,Chow; Bennett,0,12,30,30
1650383597143,MATH 142A,B02,083222,Chow; Bennett,0,12,30,30
1650383603167,MATH 193A,A01,083224,Staff,0,5,30,30
1650383603167,MATH 193A,A02,083225,Staff,0,5,30,30
1650383603167,MATH 193A,A03,083781,Staff,0,4,30,30
1650383603167,MATH 193A,A04,083782,Staff,0,4,30,30
1650383609206,MATH 197,001,091859,McAuley; Julian John,9998,0,9999,1
1650383615266,COGS 9,A01,083615,Staff,0,14,60,60
1650383621289,COGS 11,A01,083617,Boyle; Mary E. T.,22,0,40,18
1650383627322,COGS 13,A01,083071,Staff,0,32,40,40
1650383633347,COGS 14A,A01,092681,Staff,0,22,100,100
1650383639376,COGS 14B,A01,083073,Cheng; Tzu-Han,0,10,50,50
1650383645404,COGS 17,A01,092677,Staff,24,0,75,51
1650383651430,COGS 100,A01,083619,Staff,0,24,60,60
1650383657454,COGS 101A,A01,083621,Davis; Joshua Daniel,0,21,60,60
1650383663477,COGS 101B,A01,091572,Staff,0,0,60,60
1650383669501,COGS 101C,A01,083625,Delgado; Tania,16,0,30,14
1650383675525,COGS 107A,A01,083627,Boyle; Mary E. T.,0,10,60,60
1650383681547,COGS 118A,A01,083075,Staff,4,0,60,56
1650383687570,CSE 3,A50,083646,Miranda; Gregory Joseph,21,0,38,17
1650383687570,CSE 3,A51,083647,Miranda; Gregory Joseph,37,0,37,0
1650383693604,CSE 8A,A50,083650,Miranda; Gregory Joseph,0,28,40,40
1650383699627,CSE 11,A01,083080,Cao; Yingjun,0,89,40,40
1650383705659,CSE 12,A01,083652,Staff,0,12,100,100
1650383711683,CSE 15L,A01,083654,Staff,0,1,50,50
1650383711683,CSE 15L,A02,083655,Staff,3,0,50,47
1650383717710,CSE 20,A01,083657,Staff,52,0,80,28
1650383723740,CSE 30,A01,083084,Eldon; John,0,76,40,40
1650383729765,CSE 100,A01,083659,Cao; Yingjun,0,66,50,50
1650383735788,CSE 134B,A01,083661,Powell; Thomas Allan,0,31,65,65
1650383741813,CSE 140,A01,083663,Staff,0,0,75,75
1650383747851,CSE 140L,A01,083088,Eldon; John,0,7,75,75
1650383753886,CSE 175,A01,083665,Kumar; Rakesh,8,0,25,17
1650383759910,CSE 190,A00,092507,Dubnov; Shlomo,14,0,20,6
1650383765935,ECE 45,A01,083139,Staff,0,17,40,40
1650383771970,ECE 65,A50,083695,Staff,0,5,30,30
1650383777993,ECE 109,A01,091882,Touri; Behrouz,40,0,70,30
1650383784016,ECE 180,A00,083140,Abi Samra; Nicholas Camill,23,0,30,7
1650383784016,ECE 180,B00,083141,Abi Samra; Nicholas Camill,5,0,30,25
1650383790041,MATH 10A,A01,083735,Patchell; Gregory David,7,0,30,23
1650383790041,MATH 10A,A02,083736,Patchell; Gregory David,28,0,30,2
1650383790041,MATH 10A,A03,083737,Patchell; Gregory David,25,0,30,5
1650383796065,MATH 10B,A01,083207,Staff,0,7,30,30
1650383796065,MATH 10B,A02,083208,Staff,0,6,30,30
1650383796065,MATH 10B,B01,083739,Staff,17,0,30,13
1650383796065,MATH 10B,B02,083740,Staff,28,0,30,2
1650383802100,MATH 18,A01,083743,Staff,3,0,30,27
1650383802100,MATH 18,A02,083744,Staff,27,0,30,3
1650383802100,MATH 18,A03,083745,Staff,22,0,30,8
1650383802100,MATH 18,A04,083746,Staff,27,0,30,3
1650383802100,MATH 18,B01,083748,Staff,0,11,30,30
1650383802100,MATH 18,B02,083749,Staff,0,12,30,30
1650383802100,MATH 18,B03,083750,Staff,0,11,30,30
1650383802100,MATH 18,B04,083751,Staff,0,9,30,30
1650383808123,MATH 20A,A01,083754,Staff,26,0,40,14
1650383814148,MATH 20B,A01,083756,Staff,0,8,30,30
1650383814148,MATH 20B,A02,083757,Staff,0,8,30,30
1650383820171,MATH 20C,A01,083760,Staff,0,14,30,30
1650383820171,MATH 20C,A02,083761,Staff,0,15,30,30
1650383820171,MATH 20C,B01,083762,Staff,13,0,30,17
1650383820171,MATH 20C,B02,083763,Staff,28,0,30,2
1650383826197,MATH 20D,A01,083765,Staff,0,1,30,30
1650383826197,MATH 20D,A02,083766,Staff,7,0,30,23
1650383826197,MATH 20D,A03,083767,Staff,26,0,30,4
1650383832222,MATH 20E,A01,083771,Staff,5,0,30,25
1650383832222,MATH 20E,A02,083772,Staff,19,0,30,11
1650383832222,MATH 20E,B01,083773,Staff,0,0,30,30
1650383832222,MATH 20E,B02,083774,Staff,12,0,30,18
1650383838255,MATH 103A,A01,083777,Staff,0,11,30,30
1650383838255,MATH 103A,A02,083778,Staff,0,12,30,30
1650383838255,MATH 103A,B01,083779,Staff,0,13,30,30
1650383838255,MATH 103A,B02,083780,Staff,0,11,30,30
1650383844281,MATH 105,A01,085443,Staff,0,21,30,30
1650383850311,MATH 109,A01,083213,Anzaldo; Leesa B,0,6,30,30
1650383850311,MATH 109,A02,083214,Anzaldo; Leesa B,0,7,30,30
1650383850311,MATH 109,B01,083215,Anzaldo; Leesa B,0,5,30,30
1650383850311,MATH 109,B02,083216,Anzaldo; Leesa B,0,5,30,30
1650383856341,MATH 142A,A01,083219,Chow; Bennett,0,14,30,30
1650383856341,MATH 142A,A02,083220,Chow; Bennett,0,13,30,30
1650383856341,MATH 142A,B01,083221,Chow; Bennett,0,12,30,30
1650383856341,MATH 142A,B02,083222,Chow; Bennett,0,12,30,30
1650383862377,MATH 193A,A01,083224,Staff,0,5,30,30
1650383862377,MATH 193A,A02,083225,Staff,0,5,30,30
1650383862377,MATH 193A,A03,083781,Staff,0,4,30,30
1650383862377,MATH 193A,A04,083782,Staff,0,4,30,30
1650383868416,MATH 197,001,091859,McAuley; Julian John,9998,0,9999,1
1650383874473,COGS 9,A01,083615,Staff,0,14,60,60
1650383880501,COGS 11,A01,083617,Boyle; Mary E. T.,22,0,40,18
1650383886528,COGS 13,A01,083071,Staff,0,32,40,40
1650383892560,COGS 14A,A01,092681,Staff,0,22,100,100
1650383898586,COGS 14B,A01,083073,Cheng; Tzu-Han,0,10,50,50
1650383904612,COGS 17,A01,092677,Staff,24,0,75,51
1650383910638,COGS 100,A01,083619,Staff,0,24,60,60
1650383916664,COGS 101A,A01,083621,Davis; Joshua Daniel,0,21,60,60
1650383922689,COGS 101B,A01,091572,Staff,0,0,60,60
1650383928711,COGS 101C,A01,083625,Delgado; Tania,16,0,30,14
1650383934744,COGS 107A,A01,083627,Boyle; Mary E. T.,0,10,60,60
1650383940771,COGS 118A,A01,083075,Staff,4,0,60,56
1650383946798,CSE 3,A50,083646,Miranda; Gregory Joseph,21,0,38,17
1650383946798,CSE 3,A51,083647,Miranda; Gregory Joseph,37,0,37,0
1650383952823,CSE 8A,A50,083650,Miranda; Gregory Joseph,0,28,40,40
1650383958846,CSE 11,A01,083080,Cao; Yingjun,0,89,40,40
1650383964871,CSE 12,A01,083652,Staff,0,12,100,100
1650383970901,CSE 15L,A01,083654,Staff,0,1,50,50
1650383970901,CSE 15L,A02,083655,Staff,3,0,50,47
1650383976928,CSE 20,A01,083657,Staff,52,0,80,28
1650383982950,CSE 30,A01,083084,Eldon; John,0,76,40,40
1650383988974,CSE 100,A01,083659,Cao; Yingjun,0,66,50,50
1650383994999,CSE 134B,A01,083661,Powell; Thomas Allan,0,31,65,65
1650384001033,CSE 140,A01,083663,Staff,0,0,75,75
1650384007059,CSE 140L,A01,083088,Eldon; John,0,7,75,75
1650384013092,CSE 175,A01,083665,Kumar; Rakesh,8,0,25,17
1650384019121,CSE 190,A00,092507,Dubnov; Shlomo,14,0,20,6
1650384025145,ECE 45,A01,083139,Staff,0,17,40,40
1650384031173,ECE 65,A50,083695,Staff,0,5,30,30
1650384037195,ECE 109,A01,091882,Touri; Behrouz,40,0,70,30
1650384043218,ECE 180,A00,083140,Abi Samra; Nicholas Camill,23,0,30,7
1650384043218,ECE 180,B00,083141,Abi Samra; Nicholas Camill,5,0,30,25
1650384049254,MATH 10A,A01,083735,Patchell; Gregory David,7,0,30,23
1650384049254,MATH 10A,A02,083736,Patchell; Gregory David,28,0,30,2
1650384049254,MATH 10A,A03,083737,Patchell; Gregory David,25,0,30,5
1650384055286,MATH 10B,A01,083207,Staff,0,8,30,30
1650384055286,MATH 10B,A02,083208,Staff,0,6,30,30
1650384055286,MATH 10B,B01,083739,Staff,17,0,30,13
1650384055286,MATH 10B,B02,083740,Staff,28,0,30,2
1650384061311,MATH 18,A01,083743,Staff,3,0,30,27
1650384061311,MATH 18,A02,083744,Staff,27,0,30,3
1650384061311,MATH 18,A03,083745,Staff,22,0,30,8
1650384061311,MATH 18,A04,083746,Staff,27,0,30,3
1650384061311,MATH 18,B01,083748,Staff,0,11,30,30
1650384061311,MATH 18,B02,083749,Staff,0,12,30,30
1650384061311,MATH 18,B03,083750,Staff,0,11,30,30
1650384061311,MATH 18,B04,083751,Staff,0,9,30,30
1650384067340,MATH 20A,A01,083754,Staff,26,0,40,14
1650384073363,MATH 20B,A01,083756,Staff,0,8,30,30
1650384073363,MATH 20B,A02,083757,Staff,0,8,30,30
1650384079391,MATH 20C,A01,083760,Staff,0,14,30,30
1650384079391,MATH 20C,A02,083761,Staff,0,15,30,30
1650384079391,MATH 20C,B01,083762,Staff,13,0,30,17
1650384079391,MATH 20C,B02,083763,Staff,28,0,30,2
1650384085434,MATH 20D,A01,083765,Staff,0,1,30,30
1650384085434,MATH 20D,A02,083766,Staff,7,0,30,23
1650384085434,MATH 20D,A03,083767,Staff,26,0,30,4
1650384091458,MATH 20E,A01,083771,Staff,5,0,30,25
1650384091458,MATH 20E,A02,083772,Staff,19,0,30,11
1650384091458,MATH 20E,B01,083773,Staff,0,0,30,30
1650384091458,MATH 20E,B02,083774,Staff,12,0,30,18
1650384097495,MATH 103A,A01,083777,Staff,0,11,30,30
1650384097495,MATH 103A,A02,083778,Staff,0,12,30,30
1650384097495,MATH 103A,B01,083779,Staff,0,13,30,30
1650384097495,MATH 103A,B02,083780,Staff,0,11,30,30
1650384103519,MATH 105,A01,085443,Staff,0,21,30,30
1650384109543,MATH 109,A01,083213,Anzaldo; Leesa B,0,6,30,30
1650384109543,MATH 109,A02,083214,Anzaldo; Leesa B,0,7,30,30
1650384109543,MATH 109,B01,083215,Anzaldo; Leesa B,0,5,30,30
1650384109543,MATH 109,B02,083216,Anzaldo; Leesa B,0,5,30,30
1650384115567,MATH 142A,A01,083219,Chow; Bennett,0,14,30,30
1650384115567,MATH 142A,A02,083220,Chow; Bennett,0,13,30,30
1650384115567,MATH 142A,B01,083221,Chow; Bennett,0,12,30,30
1650384115567,MATH 142A,B02,083222,Chow; Bennett,0,12,30,30
1650384121600,MATH 193A,A01,083224,Staff,0,5,30,30
1650384121600,MATH 193A,A02,083225,Staff,0,5,30,30
1650384121600,MATH 193A,A03,083781,Staff,0,4,30,30
1650384121600,MATH 193A,A04,083782,Staff,0,4,30,30
1650384127622,MATH 197,001,091859,McAuley; Julian John,9998,0,9999,1
1650384133675,COGS 9,A01,083615,Staff,0,14,60,60
1650384139702,COGS 11,A01,083617,Boyle; Mary E. T.,22,0,40,18
1650384145729,COGS 13,A01,083071,Staff,0,32,40,40
1650384151751,COGS 14A,A01,092681,Staff,0,22,100,100
1650384157783,COGS 14B,A01,083073,Cheng; Tzu-Han,0,10,50,50
1650384163821,COGS 17,A01,092677,Staff,24,0,75,51
1650384169848,COGS 100,A01,083619,Staff,0,24,60,60
1650384175871,COGS 101A,A01,083621,Davis; Joshua Daniel,0,21,60,60
1650384181995,COGS 101B,A01,091572,Staff,0,0,60,60
1650384188025,COGS 101C,A01,083625,Delgado; Tania,16,0,30,14
1650384194065,COGS 107A,A01,083627,Boyle; Mary E. T.,0,10,60,60
1650384200100,COGS 118A,A01,083075,Staff,4,0,60,56
1650384206125,CSE 3,A50,083646,Miranda; Gregory Joseph,21,0,38,17
1650384206125,CSE 3,A51,083647,Miranda; Gregory Joseph,37,0,37,0
1650384212155,CSE 8A,A50,083650,Miranda; Gregory Joseph,0,28,40,40
1650384218190,CSE 11,A01,083080,Cao; Yingjun,0,89,40,40
1650384224213,CSE 12,A01,083652,Staff,0,12,100,100
1650384230236,CSE 15L,A01,083654,Staff,0,1,50,50
1650384230236,CSE 15L,A02,083655,Staff,3,0,50,47
1650384236259,CSE 20,A01,083657,Staff,52,0,80,28
1650384242283,CSE 30,A01,083084,Eldon; John,0,76,40,40
1650384248307,CSE 100,A01,083659,Cao; Yingjun,0,66,50,50
1650384254330,CSE 134B,A01,083661,Powell; Thomas Allan,0,31,65,65
1650384260354,CSE 140,A01,083663,Staff,0,0,75,75
1650384266403,CSE 140L,A01,083088,Eldon; John,0,7,75,75
1650384272426,CSE 175,A01,083665,Kumar; Rakesh,8,0,25,17
1650384278449,CSE 190,A00,092507,Dubnov; Shlomo,14,0,20,6
1650384284473,ECE 45,A01,083139,Staff,0,17,40,40
1650384290505,ECE 65,A50,083695,Staff,0,5,30,30
1650384296532,ECE 109,A01,091882,Touri; Behrouz,40,0,70,30
1650384302569,ECE 180,A00,083140,Abi Samra; Nicholas Camill,23,0,30,7
1650384302569,ECE 180,B00,083141,Abi Samra; Nicholas Camill,5,0,30,25
1650384308597,MATH 10A,A01,083735,Patchell; Gregory David,7,0,30,23
1650384308597,MATH 10A,A02,083736,Patchell; Gregory David,28,0,30,2
1650384308597,MATH 10A,A03,083737,Patchell; Gregory David,25,0,30,5
1650384314621,MATH 10B,A01,083207,Staff,0,7,30,30
1650384314621,MATH 10B,A02,083208,Staff,0,7,30,30
1650384314621,MATH 10B,B01,083739,Staff,17,0,30,13
1650384314621,MATH 10B,B02,083740,Staff,28,0,30,2
1650384320652,MATH 18,A01,083743,Staff,3,0,30,27
1650384320652,MATH 18,A02,083744,Staff,27,0,30,3
1650384320652,MATH 18,A03,083745,Staff,22,0,30,8
1650384320652,MATH 18,A04,083746,Staff,27,0,30,3
1650384320652,MATH 18,B01,083748,Staff,0,11,30,30
1650384320652,MATH 18,B02,083749,Staff,0,12,30,30
1650384320652,MATH 18,B03,083750,Staff,0,11,30,30
1650384320652,MATH 18,B04,083751,Staff,0,9,30,30
1650384326676,MATH 20A,A01,083754,Staff,26,0,40,14
1650384332699,MATH 20B,A01,083756,Staff,0,8,30,30
1650384332699,MATH 20B,A02,083757,Staff,0,8,30,30
1650384338723,MATH 20C,A01,083760,Staff,0,14,30,30
1650384338723,MATH 20C,A02,083761,Staff,0,15,30,30
1650384338723,MATH 20C,B01,083762,Staff,13,0,30,17
1650384338723,MATH 20C,B02,083763,Staff,28,0,30,2
1650384344747,MATH 20D,A01,083765,Staff,0,1,30,30
1650384344747,MATH 20D,A02,083766,Staff,7,0,30,23
1650384344747,MATH 20D,A03,083767,Staff,26,0,30,4
1650384350779,MATH 20E,A01,083771,Staff,5,0,30,25
1650384350779,MATH 20E,A02,083772,Staff,19,0,30,11
1650384350779,MATH 20E,B01,083773,Staff,0,0,30,30
1650384350779,MATH 20E,B02,083774,Staff,12,0,30,18
1650384356806,MATH 103A,A01,083777,Staff,0,11,30,30
1650384356806,MATH 103A,A02,083778,Staff,0,12,30,30
1650384356806,MATH 103A,B01,083779,Staff,0,13,30,30
1650384356806,MATH 103A,B02,083780,Staff,0,11,30,30
1650384362835,MATH 105,A01,085443,Staff,0,21,30,30
1650384368880,MATH 109,A01,083213,Anzaldo; Leesa B,0,6,30,30
1650384368880,MATH 109,A02,083214,Anzaldo; Leesa B,0,7,30,30
1650384368880,MATH 109,B01,083215,Anzaldo; Leesa B,0,5,30,30
1650384368880,MATH 109,B02,083216,Anzaldo; Leesa B,0,5,30,30
1650384374923,MATH 142A,A01,083219,Chow; Bennett,0,14,30,30
1650384374923,MATH 142A,A02,083220,Chow; Bennett,0,13,30,30
1650384374923,MATH 142A,B01,083221,Chow; Bennett,0,12,30,30
1650384374923,MATH 142A,B02,083222,Chow; Bennett,0,12,30,30
1650384380951,MATH 193A,A01,083224,Staff,0,5,30,30
1650384380951,MATH 193A,A02,083225,Staff,0,5,30,30
1650384380951,MATH 193A,A03,083781,Staff,0,4,30,30
1650384380951,MATH 193A,A04,083782,Staff,0,4,30,30
1650384386975,MATH 197,001,091859,McAuley; Julian John,9998,0,9999,1
1650384393032,COGS 9,A01,083615,Staff,0,14,60,60
1650384399059,COGS 11,A01,083617,Boyle; Mary E. T.,22,0,40,18
1650384405083,COGS 13,A01,083071,Staff,0,32,40,40
1650384411110,COGS 14A,A01,092681,Staff,0,22,100,100
1650384417134,COGS 14B,A01,083073,Cheng; Tzu-Han,0,10,50,50
1650384423162,COGS 17,A01,092677,Staff,24,0,75,51
1650384429189,COGS 100,A01,083619,Staff,0,24,60,60
1650384435218,COGS 101A,A01,083621,Davis; Joshua Daniel,0,21,60,60
1650384441243,COGS 101B,A01,091572,Staff,0,0,60,60
1650384447268,COGS 101C,A01,083625,Delgado; Tania,16,0,30,14
1650384453306,COGS 107A,A01,083627,Boyle; Mary E. T.,0,10,60,60
1650384459329,COGS 118A,A01,083075,Staff,4,0,60,56
1650384465367,CSE 3,A50,083646,Miranda; Gregory Joseph,21,0,38,17
1650384465367,CSE 3,A51,083647,Miranda; Gregory Joseph,37,0,37,0
1650384471396,CSE 8A,A50,083650,Miranda; Gregory Joseph,0,28,40,40
1650384477436,CSE 11,A01,083080,Cao; Yingjun,0,89,40,40
1650384483467,CSE 12,A01,083652,Staff,0,12,100,100
1650384489500,CSE 15L,A01,083654,Staff,0,1,50,50
1650384489500,CSE 15L,A02,083655,Staff,3,0,50,47
1650384495527,CSE 20,A01,083657,Staff,52,0,80,28
1650384501561,CSE 30,A01,083084,Eldon; John,0,76,40,40
1650384507590,CSE 100,A01,083659,Cao; Yingjun,0,66,50,50
1650384513613,CSE 134B,A01,083661,Powell; Thomas Allan,0,31,65,65
1650384519642,CSE 140,A01,083663,Staff,0,0,75,75
1650384525673,CSE 140L,A01,083088,Eldon; John,0,7,75,75
1650384531697,CSE 175,A01,083665,Kumar; Rakesh,8,0,25,17
1650384537729,CSE 190,A00,092507,Dubnov; Shlomo,14,0,20,6
1650384543754,ECE 45,A01,083139,Staff,0,17,40,40
1650384549776,ECE 65,A50,083695,Staff,0,5,30,30
1650384555799,ECE 109,A01,091882,Touri; Behrouz,40,0,70,30
1650384561829,ECE 180,A00,083140,Abi Samra; Nicholas Camill,23,0,30,7
1650384561829,ECE 180,B00,083141,Abi Samra; Nicholas Camill,5,0,30,25
1650384567854,MATH 10A,A01,083735,Patchell; Gregory David,7,0,30,23
1650384567854,MATH 10A,A02,083736,Patchell; Gregory David,28,0,30,2
1650384567854,MATH 10A,A03,083737,Patchell; Gregory David,25,0,30,5
1650384573898,MATH 10B,A01,083207,Staff,0,7,30,30
1650384573898,MATH 10B,A02,083208,Staff,0,7,30,30
1650384573898,MATH 10B,B01,083739,Staff,17,0,30,13
1650384573898,MATH 10B,B02,083740,Staff,28,0,30,2
1650384579923,MATH 18,A01,083743,Staff,3,0,30,27
1650384579923,MATH 18,A02,083744,Staff,27,0,30,3
1650384579923,MATH 18,A03,083745,Staff,22,0,30,8
1650384579923,MATH 18,A04,083746,Staff,27,0,30,3
1650384579923,MATH 18,B01,083748,Staff,0,11,30,30
1650384579923,MATH 18,B02,083749,Staff,0,12,30,30
1650384579923,MATH 18,B03,083750,Staff,0,11,30,30
1650384579923,MATH 18,B04,083751,Staff,0,9,30,30
1650384585948,MATH 20A,A01,083754,Staff,26,0,40,14
1650384591972,MATH 20B,A01,083756,Staff,0,8,30,30
1650384591972,MATH 20B,A02,083757,Staff,0,8,30,30
1650384597999,MATH 20C,A01,083760,Staff,0,14,30,30
1650384597999,MATH 20C,A02,083761,Staff,0,15,30,30
1650384597999,MATH 20C,B01,083762,Staff,13,0,30,17
1650384597999,MATH 20C,B02,083763,Staff,28,0,30,2
1650384604026,MATH 20D,A01,083765,Staff,0,1,30,30
1650384604026,MATH 20D,A02,083766,Staff,7,0,30,23
1650384604026,MATH 20D,A03,083767,Staff,26,0,30,4
1650384610050,MATH 20E,A01,083771,Staff,5,0,30,25
1650384610050,MATH 20E,A02,083772,Staff,19,0,30,11
1650384610050,MATH 20E,B01,083773,Staff,0,0,30,30
1650384610050,MATH 20E,B02,083774,Staff,12,0,30,18
1650384616078,MATH 103A,A01,083777,Staff,0,11,30,30
1650384616078,MATH 103A,A02,083778,Staff,0,12,30,30
1650384616078,MATH 103A,B01,083779,Staff,0,13,30,30
1650384616078,MATH 103A,B02,083780,Staff,0,11,30,30
1650384622106,MATH 105,A01,085443,Staff,0,21,30,30
1650384628131,MATH 109,A01,083213,Anzaldo; Leesa B,0,6,30,30
1650384628131,MATH 109,A02,083214,Anzaldo; Leesa B,0,7,30,30
1650384628131,MATH 109,B01,083215,Anzaldo; Leesa B,0,5,30,30
1650384628131,MATH 109,B02,083216,Anzaldo; Leesa B,0,5,30,30
1650384634155,MATH 142A,A01,083219,Chow; Bennett,0,14,30,30
1650384634155,MATH 142A,A02,083220,Chow; Bennett,0,13,30,30
1650384634155,MATH 142A,B01,083221,Chow; Bennett,0,12,30,30
1650384634155,MATH 142A,B02,083222,Chow; Bennett,0,12,30,30
1650384640179,MATH 193A,A01,083224,Staff,0,5,30,30
1650384640179,MATH 193A,A02,083225,Staff,0,5,30,30
1650384640179,MATH 193A,A03,083781,Staff,0,4,30,30
1650384640179,MATH 193A,A04,083782,Staff,0,4,30,30
1650384646205,MATH 197,001,091859,McAuley; Julian John,9998,0,9999,1
1650384652261,COGS 9,A01,083615,Staff,0,14,60,60
1650384658287,COGS 11,A01,083617,Boyle; Mary E. T.,22,0,40,18
1650384664311,COGS 13,A01,083071,Staff,0,32,40,40
1650384670338,COGS 14A,A01,092681,Staff,0,22,100,100
1650384676361,COGS 14B,A01,083073,Cheng; Tzu-Han,0,10,50,50
1650384682387,COGS 17,A01,092677,Staff,24,0,75,51
1650384688410,COGS 100,A01,083619,Staff,0,24,60,60
1650384694438,COGS 101A,A01,083621,Davis; Joshua Daniel,0,21,60,60
1650384700465,COGS 101B,A01,091572,Staff,0,0,60,60
1650384706492,COGS 101C,A01,083625,Delgado; Tania,16,0,30,14
1650384712516,COGS 107A,A01,083627,Boyle; Mary E. T.,0,10,60,60
1650384718539,COGS 118A,A01,083075,Staff,4,0,60,56
1650384724567,CSE 3,A50,083646,Miranda; Gregory Joseph,21,0,38,17
1650384724567,CSE 3,A51,083647,Miranda; Gregory Joseph,37,0,37,0
1650384730591,CSE 8A,A50,083650,Miranda; Gregory Joseph,0,28,40,40
1650384736615,CSE 11,A01,083080,Cao; Yingjun,0,89,40,40
1650384742641,CSE 12,A01,083652,Staff,0,12,100,100
1650384748675,CSE 15L,A01,083654,Staff,0,1,50,50
1650384748675,CSE 15L,A02,083655,Staff,3,0,50,47
1650384754700,CSE 20,A01,083657,Staff,52,0,80,28
1650384760747,CSE 30,A01,083084,Eldon; John,0,76,40,40
1650384766779,CSE 100,A01,083659,Cao; Yingjun,0,66,50,50
1650384772804,CSE 134B,A01,083661,Powell; Thomas Allan,0,31,65,65
1650384778915,CSE 140,A01,083663,Staff,0,0,75,75
1650384784942,CSE 140L,A01,083088,Eldon; John,0,7,75,75
1650384790968,CSE 175,A01,083665,Kumar; Rakesh,8,0,25,17
1650384796994,CSE 190,A00,092507,Dubnov; Shlomo,14,0,20,6
1650384803020,ECE 45,A01,083139,Staff,0,17,40,40
1650384809053,ECE 65,A50,083695,Staff,0,5,30,30
1650384815077,ECE 109,A01,091882,Touri; Behrouz,40,0,70,30
1650384821105,ECE 180,A00,083140,Abi Samra; Nicholas Camill,23,0,30,7
1650384821105,ECE 180,B00,083141,Abi Samra; Nicholas Camill,5,0,30,25
1650384827142,MATH 10A,A01,083735,Patchell; Gregory David,7,0,30,23
1650384827142,MATH 10A,A02,083736,Patchell; Gregory David,28,0,30,2
1650384827142,MATH 10A,A03,083737,Patchell; Gregory David,25,0,30,5
1650384833173,MATH 10B,A01,083207,Staff,0,7,30,30
1650384833173,MATH 10B,A02,083208,Staff,0,7,30,30
1650384833173,MATH 10B,B01,083739,Staff,17,0,30,13
1650384833173,MATH 10B,B02,083740,Staff,28,0,30,2
1650384839204,MATH 18,A01,083743,Staff,3,0,30,27
1650384839204,MATH 18,A02,083744,Staff,27,0,30,3
1650384839204,MATH 18,A03,083745,Staff,22,0,30,8
1650384839204,MATH 18,A04,083746,Staff,27,0,30,3
1650384839204,MATH 18,B01,083748,Staff,0,11,30,30
1650384839204,MATH 18,B02,083749,Staff,0,12,30,30
1650384839204,MATH 18,B03,083750,Staff,0,11,30,30
1650384839204,MATH 18,B04,083751,Staff,0,9,30,30
1650384845228,MATH 20A,A01,083754,Staff,26,0,40,14
1650384851252,MATH 20B,A01,083756,Staff,0,8,30,30
1650384851252,MATH 20B,A02,083757,Staff,0,8,30,30
1650384857284,MATH 20C,A01,083760,Staff,0,14,30,30
1650384857284,MATH 20C,A02,083761,Staff,0,15,30,30
1650384857284,MATH 20C,B01,083762,Staff,13,0,30,17
1650384857284,MATH 20C,B02,083763,Staff,28,0,30,2
1650384863308,MATH 20D,A01,083765,Staff,0,1,30,30
1650384863308,MATH 20D,A02,083766,Staff,7,0,30,23
1650384863308,MATH 20D,A03,083767,Staff,26,0,30,4
1650384869332,MATH 20E,A01,083771,Staff,5,0,30,25
1650384869332,MATH 20E,A02,083772,Staff,19,0,30,11
1650384869332,MATH 20E,B01,083773,Staff,0,0,30,30
1650384869332,MATH 20E,B02,083774,Staff,12,0,30,18
1650384875356,MATH 103A,A01,083777,Staff,0,11,30,30
1650384875356,MATH 103A,A02,083778,Staff,0,12,30,30
1650384875356,MATH 103A,B01,083779,Staff,0,13,30,30
1650384875356,MATH 103A,B02,083780,Staff,0,11,30,30
1650384881386,MATH 105,A01,085443,Staff,0,21,30,30
1650384887411,MATH 109,A01,083213,Anzaldo; Leesa B,0,6,30,30
1650384887411,MATH 109,A02,083214,Anzaldo; Leesa B,0,7,30,30
1650384887411,MATH 109,B01,083215,Anzaldo; Leesa B,0,5,30,30
1650384887411,MATH 109,B02,083216,Anzaldo; Leesa B,0,5,30,30
1650384893435,MATH 142A,A01,083219,Chow; Bennett,0,14,30,30
1650384893435,MATH 142A,A02,083220,Chow; Bennett,0,13,30,30
1650384893435,MATH 142A,B01,083221,Chow; Bennett,0,12,30,30
1650384893435,MATH 142A,B02,083222,Chow; Bennett,0,12,30,30
1650384899459,MATH 193A,A01,083224,Staff,0,5,30,30
1650384899459,MATH 193A,A02,083225,Staff,0,5,30,30
1650384899459,MATH 193A,A03,083781,Staff,0,4,30,30
1650384899459,MATH 193A,A04,083782,Staff,0,4,30,30
1650384905481,MATH 197,001,091859,McAuley; Julian John,9998,0,9999,1
1650384911539,COGS 9,A01,083615,Staff,0,14,60,60
1650384917563,COGS 11,A01,083617,Boyle; Mary E. T.,22,0,40,18
1650384923587,COGS 13,A01,083071,Staff,0,32,40,40
1650384929610,COGS 14A,A01,092681,Staff,0,22,100,100
1650384935634,COGS 14B,A01,083073,Cheng; Tzu-Han,0,10,50,50
1650384941659,COGS 17,A01,092677,Staff,24,0,75,51
1650384947688,COGS 100,A01,083619,Staff,0,24,60,60
1650384953712,COGS 101A,A01,083621,Davis; Joshua Daniel,0,21,60,60
1650384959736,COGS 101B,A01,091572,Staff,0,0,60,60
1650384965763,COGS 101C,A01,083625,Delgado; Tania,16,0,30,14
1650384971789,COGS 107A,A01,083627,Boyle; Mary E. T.,0,10,60,60
1650384977815,COGS 118A,A01,083075,Staff,4,0,60,56
1650384983843,CSE 3,A50,083646,Miranda; Gregory Joseph,21,0,38,17
1650384983843,CSE 3,A51,083647,Miranda; Gregory Joseph,37,0,37,0
1650384989866,CSE 8A,A50,083650,Miranda; Gregory Joseph,0,28,40,40
1650384995889,CSE 11,A01,083080,Cao; Yingjun,0,89,40,40
1650385001913,CSE 12,A01,083652,Staff,0,12,100,100
1650385007936,CSE 15L,A01,083654,Staff,0,1,50,50
1650385007936,CSE 15L,A02,083655,Staff,3,0,50,47
1650385013963,CSE 20,A01,083657,Staff,52,0,80,28
1650385019997,CSE 30,A01,083084,Eldon; John,0,76,40,40
1650385026020,CSE 100,A01,083659,Cao; Yingjun,0,66,50,50
1650385032046,CSE 134B,A01,083661,Powell; Thomas Allan,0,31,65,65
1650385038070,CSE 140,A01,083663,Staff,0,0,75,75
1650385044103,CSE 140L,A01,083088,Eldon; John,0,7,75,75
1650385050125,CSE 175,A01,083665,Kumar; Rakesh,8,0,25,17
1650385056150,CSE 190,A00,092507,Dubnov; Shlomo,14,0,20,6
1650385062178,ECE 45,A01,083139,Staff,0,17,40,40
1650385068203,ECE 65,A50,083695,Staff,0,5,30,30
1650385074227,ECE 109,A01,091882,Touri; Behrouz,40,0,70,30
1650385080258,ECE 180,A00,083140,Abi Samra; Nicholas Camill,24,0,30,6
1650385080258,ECE 180,B00,083141,Abi Samra; Nicholas Camill,3,0,30,27
1650385086292,MATH 10A,A01,083735,Patchell; Gregory David,7,0,30,23
1650385086292,MATH 10A,A02,083736,Patchell; Gregory David,28,0,30,2
1650385086292,MATH 10A,A03,083737,Patchell; Gregory David,25,0,30,5
1650385092319,MATH 10B,A01,083207,Staff,0,7,30,30
1650385092319,MATH 10B,A02,083208,Staff,0,7,30,30
1650385092319,MATH 10B,B01,083739,Staff,17,0,30,13
1650385092319,MATH 10B,B02,083740,Staff,28,0,30,2
1650385098349,MATH 18,A01,083743,Staff,3,0,30,27
1650385098349,MATH 18,A02,083744,Staff,27,0,30,3
1650385098349,MATH 18,A03,083745,Staff,22,0,30,8
1650385098349,MATH 18,A04,083746,Staff,27,0,30,3
1650385098349,MATH 18,B01,083748,Staff,0,11,30,30
1650385098349,MATH 18,B02,083749,Staff,0,12,30,30
1650385098349,MATH 18,B03,083750,Staff,0,11,30,30
1650385098349,MATH 18,B04,083751,Staff,0,9,30,30
1650385104380,MATH 20A,A01,083754,Staff,26,0,40,14
1650385110403,MATH 20B,A01,083756,Staff,0,8,30,30
1650385110403,MATH 20B,A02,083757,Staff,0,8,30,30
1650385116441,MATH 20C,A01,083760,Staff,0,14,30,30
1650385116441,MATH 20C,A02,083761,Staff,0,15,30,30
1650385116441,MATH 20C,B01,083762,Staff,13,0,30,17
1650385116441,MATH 20C,B02,083763,Staff,28,0,30,2
1650385122468,MATH 20D,A01,083765,Staff,0,1,30,30
1650385122468,MATH 20D,A02,083766,Staff,7,0,30,23
1650385122468,MATH 20D,A03,083767,Staff,26,0,30,4
1650385128505,MATH 20E,A01,083771,Staff,5,0,30,25
1650385128505,MATH 20E,A02,083772,Staff,19,0,30,11
1650385128505,MATH 20E,B01,083773,Staff,0,0,30,30
1650385128505,MATH 20E,B02,083774,Staff,12,0,30,18
1650385134528,MATH 103A,A01,083777,Staff,0,11,30,30
1650385134528,MATH 103A,A02,083778,Staff,0,12,30,30
1650385134528,MATH 103A,B01,083779,Staff,0,13,30,30
1650385134528,MATH 103A,B02,083780,Staff,0,11,30,30
1650385140554,MATH 105,A01,085443,Staff,0,21,30,30
1650385146579,MATH 109,A01,083213,Anzaldo; Leesa B,0,6,30,30
1650385146579,MATH 109,A02,083214,Anzaldo; Leesa B,0,7,30,30
1650385146579,MATH 109,B01,083215,Anzaldo; Leesa B,0,5,30,30
1650385146579,MATH 109,B02,083216,Anzaldo; Leesa B,0,5,30,30
1650385152606,MATH 142A,A01,083219,Chow; Bennett,0,14,30,30
1650385152606,MATH 142A,A02,083220,Chow; Bennett,0,13,30,30
1650385152606,MATH 142A,B01,083221,Chow; Bennett,0,12,30,30
1650385152606,MATH 142A,B02,083222,Chow; Bennett,0,12,30,30
1650385158632,MATH 193A,A01,083224,Staff,0,5,30,30
1650385158632,MATH 193A,A02,083225,Staff,0,5,30,30
1650385158632,MATH 193A,A03,083781,Staff,0,4,30,30
1650385158632,MATH 193A,A04,083782,Staff,0,4,30,30
1650385164656,MATH 197,001,091859,McAuley; Julian John,9998,0,9999,1
1650385170720,COGS 9,A01,083615,Staff,0,14,60,60
1650385176743,COGS 11,A01,083617,Boyle; Mary E. T.,22,0,40,18
1650385182770,COGS 13,A01,083071,Staff,0,32,40,40
1650385188800,COGS 14A,A01,092681,Staff,0,22,100,100
1650385194825,COGS 14B,A01,083073,Cheng; Tzu-Han,0,10,50,50
1650385200849,COGS 17,A01,092677,Staff,24,0,75,51
1650385206877,COGS 100,A01,083619,Staff,0,24,60,60
1650385212902,COGS 101A,A01,083621,Davis; Joshua Daniel,0,21,60,60
1650385218931,COGS 101B,A01,091572,Staff,0,0,60,60
1650385224955,COGS 101C,A01,083625,Delgado; Tania,16,0,30,14
1650385230979,COGS 107A,A01,083627,Boyle; Mary E. T.,0,10,60,60
1650385237003,COGS 118A,A01,083075,Staff,4,0,60,56
1650385243028,CSE 3,A50,083646,Miranda; Gregory Joseph,21,0,38,17
1650385243028,CSE 3,A51,083647,Miranda; Gregory Joseph,37,0,37,0
1650385249051,CSE 8A,A50,083650,Miranda; Gregory Joseph,0,28,40,40
1650385255077,CSE 11,A01,083080,Cao; Yingjun,0,89,40,40
1650385261108,CSE 12,A01,083652,Staff,0,12,100,100
1650385267133,CSE 15L,A01,083654,Staff,0,1,50,50
1650385267133,CSE 15L,A02,083655,Staff,3,0,50,47
1650385273157,CSE 20,A01,083657,Staff,52,0,80,28
1650385279188,CSE 30,A01,083084,Eldon; John,0,76,40,40
1650385285212,CSE 100,A01,083659,Cao; Yingjun,0,66,50,50
1650385291236,CSE 134B,A01,083661,Powell; Thomas Allan,0,31,65,65
1650385297262,CSE 140,A01,083663,Staff,0,0,75,75
1650385303294,CSE 140L,A01,083088,Eldon; John,0,7,75,75
1650385309319,CSE 175,A01,083665,Kumar; Rakesh,8,0,25,17
1650385315344,CSE 190,A00,092507,Dubnov; Shlomo,14,0,20,6
1650385321367,ECE 45,A01,083139,Staff,0,17,40,40
1650385327391,ECE 65,A50,083695,Staff,0,5,30,30
1650385333415,ECE 109,A01,091882,Touri; Behrouz,40,0,70,30
1650385339442,ECE 180,A00,083140,Abi Samra; Nicholas Camill,24,0,30,6
1650385339442,ECE 180,B00,083141,Abi Samra; Nicholas Camill,3,0,30,27
1650385345469,MATH 10A,A01,083735,Patchell; Gregory David,7,0,30,23
1650385345469,MATH 10A,A02,083736,Patchell; Gregory David,28,0,30,2
1650385345469,MATH 10A,A03,083737,Patchell; Gregory David,25,0,30,5
1650385351499,MATH 10B,A01,083207,Staff,0,7,30,30
1650385351499,MATH 10B,A02,083208,Staff,0,7,30,30
1650385351499,MATH 10B,B01,083739,Staff,17,0,30,13
1650385351499,MATH 10B,B02,083740,Staff,28,0,30,2
1650385357539,MATH 18,A01,083743,Staff,3,0,30,27
1650385357539,MATH 18,A02,083744,Staff,27,0,30,3
1650385357539,MATH 18,A03,083745,Staff,22,0,30,8
1650385357539,MATH 18,A04,083746,Staff,27,0,30,3
1650385357539,MATH 18,B01,083748,Staff,0,11,30,30
1650385357539,MATH 18,B02,083749,Staff,0,12,30,30
1650385357539,MATH 18,B03,083750,Staff,0,11,30,30
1650385357539,MATH 18,B04,083751,Staff,0,9,30,30
1650385363567,MATH 20A,A01,083754,Staff,26,0,40,14
1650385369590,MATH 20B,A01,083756,Staff,0,8,30,30
1650385369590,MATH 20B,A02,083757,Staff,0,8,30,30
1650385375696,MATH 20C,A01,083760,Staff,0,14,30,30
1650385375696,MATH 20C,A02,083761,Staff,0,15,30,30
1650385375696,MATH 20C,B01,083762,Staff,13,0,30,17
1650385375696,MATH 20C,B02,083763,Staff,28,0,30,2
1650385381724,MATH 20D,A01,083765,Staff,0,1,30,30
1650385381724,MATH 20D,A02,083766,Staff,7,0,30,23
1650385381724,MATH 20D,A03,083767,Staff,26,0,30,4
1650385387749,MATH 20E,A01,083771,Staff,5,0,30,25
1650385387749,MATH 20E,A02,083772,Staff,19,0,30,11
1650385387749,MATH 20E,B01,083773,Staff,0,0,30,30
1650385387749,MATH 20E,B02,083774,Staff,12,0,30,18
1650385393772,MATH 103A,A01,083777,Staff,0,11,30,30
1650385393772,MATH 103A,A02,083778,Staff,0,12,30,30
1650385393772,MATH 103A,B01,083779,Staff,0,13,30,30
1650385393772,MATH 103A,B02,083780,Staff,0,11,30,30
1650385399807,MATH 105,A01,085443,Staff,0,21,30,30
1650385405832,MATH 109,A01,083213,Anzaldo; Leesa B,0,6,30,30
1650385405832,MATH 109,A02,083214,Anzaldo; Leesa B,0,7,30,30
1650385405832,MATH 109,B01,083215,Anzaldo; Leesa B,0,5,30,30
1650385405832,MATH 109,B02,083216,Anzaldo; Leesa B,0,5,30,30
1650385411861,MATH 142A,A01,083219,Chow; Bennett,0,14,30,30
1650385411861,MATH 142A,A02,083220,Chow; Bennett,0,13,30,30
1650385411861,MATH 142A,B01,083221,Chow; Bennett,0,12,30,30
1650385411861,MATH 142A,B02,083222,Chow; Bennett,0,12,30,30
1650385417885,MATH 193A,A01,083224,Staff,0,5,30,30
1650385417885,MATH 193A,A02,083225,Staff,0,5,30,30
1650385417885,MATH 193A,A03,083781,Staff,0,4,30,30
1650385417885,MATH 193A,A04,083782,Staff,0,4,30,30
1650385423909,MATH 197,001,091859,McAuley; Julian John,9998,0,9999,1
1650385429971,COGS 9,A01,083615,Staff,0,14,60,60
1650385435999,COGS 11,A01,083617,Boyle; Mary E. T.,22,0,40,18
1650385442025,COGS 13,A01,083071,Staff,0,32,40,40
1650385448049,COGS 14A,A01,092681,Staff,0,22,100,100
1650385454076,COGS 14B,A01,083073,Cheng; Tzu-Han,0,10,50,50
1650385460099,COGS 17,A01,092677,Staff,24,0,75,51
1650385466123,COGS 100,A01,083619,Staff,0,24,60,60
1650385472146,COGS 101A,A01,083621,Davis; Joshua Daniel,0,21,60,60
1650385478170,COGS 101B,A01,091572,Staff,0,0,60,60
1650385484202,COGS 101C,A01,083625,Delgado; Tania,16,0,30,14
1650385490232,COGS 107A,A01,083627,Boyle; Mary E. T.,0,10,60,60
1650385496264,COGS 118A,A01,083075,Staff,4,0,60,56
1650385502289,CSE 3,A50,083646,Miranda; Gregory Joseph,21,0,38,17
1650385502289,CSE 3,A51,083647,Miranda; Gregory Joseph,37,0,37,0
1650385508314,CSE 8A,A50,083650,Miranda; Gregory Joseph,0,28,40,40
1650385514343,CSE 11,A01,083080,Cao; Yingjun,0,89,40,40
1650385520367,CSE 12,A01,083652,Staff,0,12,100,100
1650385526399,CSE 15L,A01,083654,Staff,0,1,50,50
1650385526399,CSE 15L,A02,083655,Staff,3,0,50,47
1650385532423,CSE 20,A01,083657,Staff,52,0,80,28
1650385538449,CSE 30,A01,083084,Eldon; John,0,76,40,40
1650385544478,CSE 100,A01,083659,Cao; Yingjun,0,66,50,50
1650385550500,CSE 134B,A01,083661,Powell; Thomas Allan,0,31,65,65
1650385556526,CSE 140,A01,083663,Staff,0,0,75,75
1650385562559,CSE 140L,A01,083088,Eldon; John,0,7,75,75
1650385568583,CSE 175,A01,083665,Kumar; Rakesh,8,0,25,17
1650385574614,CSE 190,A00,092507,Dubnov; Shlomo,14,0,20,6
1650385580641,ECE 45,A01,083139,Staff,0,17,40,40
1650385586673,ECE 65,A50,083695,Staff,0,5,30,30
1650385592696,ECE 109,A01,091882,Touri; Behrouz,40,0,70,30
1650385598723,ECE 180,A00,083140,Abi Samra; Nicholas Camill,24,0,30,6
1650385598723,ECE 180,B00,083141,Abi Samra; Nicholas Camill,3,0,30,27
1650385604756,MATH 10A,A01,083735,Patchell; Gregory David,7,0,30,23
1650385604756,MATH 10A,A02,083736,Patchell; Gregory David,28,0,30,2
1650385604756,MATH 10A,A03,083737,Patchell; Gregory David,25,0,30,5
1650385610784,MATH 10B,A01,083207,Staff,0,7,30,30
1650385610784,MATH 10B,A02,083208,Staff,0,7,30,30
1650385610784,MATH 10B,B01,083739,Staff,17,0,30,13
1650385610784,MATH 10B,B02,083740,Staff,28,0,30,2
1650385616811,MATH 18,A01,083743,Staff,3,0,30,27
1650385616811,MATH 18,A02,083744,Staff,27,0,30,3
1650385616811,MATH 18,A03,083745,Staff,22,0,30,8
1650385616811,MATH 18,A04,083746,Staff,27,0,30,3
1650385616811,MATH 18,B01,083748,Staff,0,11,30,30
1650385616811,MATH 18,B02,083749,Staff,0,12,30,30
1650385616811,MATH 18,B03,083750,Staff,0,11,30,30
1650385616811,MATH 18,B04,083751,Staff,0,9,30,30
1650385622833,MATH 20A,A01,083754,Staff,26,0,40,14
1650385628857,MATH 20B,A01,083756,Staff,0,8,30,30
1650385628857,MATH 20B,A02,083757,Staff,0,8,30,30
1650385634884,MATH 20C,A01,083760,Staff,0,14,30,30
1650385634884,MATH 20C,A02,083761,Staff,0,15,30,30
1650385634884,MATH 20C,B01,083762,Staff,13,0,30,17
1650385634884,MATH 20C,B02,083763,Staff,28,0,30,2
1650385640914,MATH 20D,A01,083765,Staff,0,1,30,30
1650385640914,MATH 20D,A02,083766,Staff,7,0,30,23
1650385640914,MATH 20D,A03,083767,Staff,26,0,30,4
1650385646944,MATH 20E,A01,083771,Staff,5,0,30,25
1650385646944,MATH 20E,A02,083772,Staff,19,0,30,11
1650385646944,MATH 20E,B01,083773,Staff,0,0,30,30
1650385646944,MATH 20E,B02,083774,Staff,12,0,30,18
1650385652968,MATH 103A,A01,083777,Staff,0,11,30,30
1650385652968,MATH 103A,A02,083778,Staff,0,12,30,30
1650385652968,MATH 103A,B01,083779,Staff,0,13,30,30
1650385652968,MATH 103A,B02,083780,Staff,0,11,30,30
1650385658994,MATH 105,A01,085443,Staff,0,21,30,30
1650385665023,MATH 109,A01,083213,Anzaldo; Leesa B,0,6,30,30
1650385665023,MATH 109,A02,083214,Anzaldo; Leesa B,0,7,30,30
1650385665023,MATH 109,B01,083215,Anzaldo; Leesa B,0,5,30,30
1650385665023,MATH 109,B02,083216,Anzaldo; Leesa B,0,5,30,30
1650385671054,MATH 142A,A01,083219,Chow; Bennett,0,14,30,30
1650385671054,MATH 142A,A02,083220,Chow; Bennett,0,13,30,30
1650385671054,MATH 142A,B01,083221,Chow; Bennett,0,12,30,30
1650385671054,MATH 142A,B02,083222,Chow; Bennett,0,12,30,30
1650385677081,MATH 193A,A01,083224,Staff,0,5,30,30
1650385677081,MATH 193A,A02,083225,Staff,0,5,30,30
1650385677081,MATH 193A,A03,083781,Staff,0,4,30,30
1650385677081,MATH 193A,A04,083782,Staff,0,4,30,30
1650385683104,MATH 197,001,091859,McAuley; Julian John,9998,0,9999,1
1650385689158,COGS 9,A01,083615,Staff,0,14,60,60
1650385695191,COGS 11,A01,083617,Boyle; Mary E. T.,22,0,40,18
1650385701218,COGS 13,A01,083071,Staff,0,33,40,40
1650385707242,COGS 14A,A01,092681,Staff,0,22,100,100
1650385713265,COGS 14B,A01,083073,Cheng; Tzu-Han,0,10,50,50
1650385719288,COGS 17,A01,092677,Staff,24,0,75,51
1650385725323,COGS 100,A01,083619,Staff,0,24,60,60
1650385731357,COGS 101A,A01,083621,Davis; Joshua Daniel,0,21,60,60
1650385737380,COGS 101B,A01,091572,Staff,0,0,60,60
1650385743421,COGS 101C,A01,083625,Delgado; Tania,16,0,30,14
1650385749449,COGS 107A,A01,083627,Boyle; Mary E. T.,0,10,60,60
1650385755472,COGS 118A,A01,083075,Staff,4,0,60,56
1650385761500,CSE 3,A50,083646,Miranda; Gregory Joseph,21,0,38,17
1650385761500,CSE 3,A51,083647,Miranda; Gregory Joseph,37,0,37,0
1650385767529,CSE 8A,A50,083650,Miranda; Gregory Joseph,0,28,40,40
1650385773558,CSE 11,A01,083080,Cao; Yingjun,0,89,40,40
1650385779583,CSE 12,A01,083652,Staff,0,12,100,100
1650385785616,CSE 15L,A01,083654,Staff,0,1,50,50
1650385785616,CSE 15L,A02,083655,Staff,3,0,50,47
1650385791638,CSE 20,A01,083657,Staff,52,0,80,28
1650385797668,CSE 30,A01,083084,Eldon; John,0,76,40,40
1650385803693,CSE 100,A01,083659,Cao; Yingjun,0,66,50,50
1650385809717,CSE 134B,A01,083661,Powell; Thomas Allan,0,31,65,65
1650385815748,CSE 140,A01,083663,Staff,0,0,75,75
1650385821772,CSE 140L,A01,083088,Eldon; John,0,7,75,75
1650385827803,CSE 175,A01,083665,Kumar; Rakesh,8,0,25,17
1650385833827,CSE 190,A00,092507,Dubnov; Shlomo,14,0,20,6
1650385839861,ECE 45,A01,083139,Staff,0,17,40,40
1650385845892,ECE 65,A50,083695,Staff,0,5,30,30
1650385851922,ECE 109,A01,091882,Touri; Behrouz,40,0,70,30
1650385857957,ECE 180,A00,083140,Abi Samra; Nicholas Camill,24,0,30,6
1650385857957,ECE 180,B00,083141,Abi Samra; Nicholas Camill,3,0,30,27
1650385863985,MATH 10A,A01,083735,Patchell; Gregory David,7,0,30,23
1650385863985,MATH 10A,A02,083736,Patchell; Gregory David,28,0,30,2
1650385863985,MATH 10A,A03,083737,Patchell; Gregory David,25,0,30,5
1650385870010,MATH 10B,A01,083207,Staff,0,7,30,30
1650385870010,MATH 10B,A02,083208,Staff,0,7,30,30
1650385870010,MATH 10B,B01,083739,Staff,17,0,30,13
1650385870010,MATH 10B,B02,083740,Staff,28,0,30,2
1650385876037,MATH 18,A01,083743,Staff,3,0,30,27
1650385876037,MATH 18,A02,083744,Staff,27,0,30,3
1650385876037,MATH 18,A03,083745,Staff,22,0,30,8
1650385876037,MATH 18,A04,083746,Staff,27,0,30,3
1650385876037,MATH 18,B01,083748,Staff,0,11,30,30
1650385876037,MATH 18,B02,083749,Staff,0,12,30,30
1650385876037,MATH 18,B03,083750,Staff,0,11,30,30
1650385876037,MATH 18,B04,083751,Staff,0,9,30,30
1650385882061,MATH 20A,A01,083754,Staff,26,0,40,14
1650385888088,MATH 20B,A01,083756,Staff,0,8,30,30
1650385888088,MATH 20B,A02,083757,Staff,0,8,30,30
1650385894113,MATH 20C,A01,083760,Staff,0,14,30,30
1650385894113,MATH 20C,A02,083761,Staff,0,15,30,30
1650385894113,MATH 20C,B01,083762,Staff,13,0,30,17
1650385894113,MATH 20C,B02,083763,Staff,28,0,30,2
1650385900136,MATH 20D,A01,083765,Staff,0,1,30,30
1650385900136,MATH 20D,A02,083766,Staff,7,0,30,23
1650385900136,MATH 20D,A03,083767,Staff,26,0,30,4
1650385906160,MATH 20E,A01,083771,Staff,5,0,30,25
1650385906160,MATH 20E,A02,083772,Staff,19,0,30,11
1650385906160,MATH 20E,B01,083773,Staff,0,0,30,30
1650385906160,MATH 20E,B02,083774,Staff,12,0,30,18
1650385912185,MATH 103A,A01,083777,Staff,0,11,30,30
1650385912185,MATH 103A,A02,083778,Staff,0,12,30,30
1650385912185,MATH 103A,B01,083779,Staff,0,13,30,30
1650385912185,MATH 103A,B02,083780,Staff,0,11,30,30
1650385918210,MATH 105,A01,085443,Staff,0,21,30,30
1650385924238,MATH 109,A01,083213,Anzaldo; Leesa B,0,6,30,30
1650385924238,MATH 109,A02,083214,Anzaldo; Leesa B,0,7,30,30
1650385924238,MATH 109,B01,083215,Anzaldo; Leesa B,0,5,30,30
1650385924238,MATH 109,B02,083216,Anzaldo; Leesa B,0,5,30,30
1650385930272,MATH 142A,A01,083219,Chow; Bennett,0,14,30,30
1650385930272,MATH 142A,A02,083220,Chow; Bennett,0,13,30,30
1650385930272,MATH 142A,B01,083221,Chow; Bennett,0,12,30,30
1650385930272,MATH 142A,B02,083222,Chow; Bennett,0,12,30,30
1650385936296,MATH 193A,A01,083224,Staff,0,5,30,30
1650385936296,MATH 193A,A02,083225,Staff,0,5,30,30
1650385936296,MATH 193A,A03,083781,Staff,0,4,30,30
1650385936296,MATH 193A,A04,083782,Staff,0,4,30,30
1650385942323,MATH 197,001,091859,McAuley; Julian John,9998,0,9999,1
1650385948377,COGS 9,A01,083615,Staff,0,14,60,60
1650385954414,COGS 11,A01,083617,Boyle; Mary E. T.,22,0,40,18
1650385960439,COGS 13,A01,083071,Staff,0,33,40,40
1650385966536,COGS 14A,A01,092681,Staff,0,22,100,100
1650385972560,COGS 14B,A01,083073,Cheng; Tzu-Han,0,10,50,50
1650385978584,COGS 17,A01,092677,Staff,24,0,75,51
1650385984608,COGS 100,A01,083619,Staff,0,24,60,60
1650385990635,COGS 101A,A01,083621,Davis; Joshua Daniel,0,21,60,60
1650385996657,COGS 101B,A01,091572,Staff,0,0,60,60
1650386002683,COGS 101C,A01,083625,Delgado; Tania,16,0,30,14
1650386008711,COGS 107A,A01,083627,Boyle; Mary E. T.,0,10,60,60
1650386014735,COGS 118A,A01,083075,Staff,4,0,60,56
1650386020763,CSE 3,A50,083646,Miranda; Gregory Joseph,21,0,38,17
1650386020763,CSE 3,A51,083647,Miranda; Gregory Joseph,37,0,37,0
1650386026786,CSE 8A,A50,083650,Miranda; Gregory Joseph,0,28,40,40
1650386032810,CSE 11,A01,083080,Cao; Yingjun,0,89,40,40
1650386038836,CSE 12,A01,083652,Staff,0,12,100,100
1650386044859,CSE 15L,A01,083654,Staff,0,1,50,50
1650386044859,CSE 15L,A02,083655,Staff,3,0,50,47
1650386050885,CSE 20,A01,083657,Staff,52,0,80,28
1650386056921,CSE 30,A01,083084,Eldon; John,0,76,40,40
1650386062944,CSE 100,A01,083659,Cao; Yingjun,0,66,50,50
1650386068969,CSE 134B,A01,083661,Powell; Thomas Allan,0,31,65,65
1650386074992,CSE 140,A01,083663,Staff,0,0,75,75
1650386081018,CSE 140L,A01,083088,Eldon; John,0,7,75,75
1650386087058,CSE 175,A01,083665,Kumar; Rakesh,8,0,25,17
1650386093082,CSE 190,A00,092507,Dubnov; Shlomo,14,0,20,6
1650386099126,ECE 45,A01,083139,Staff,0,17,40,40
1650386105156,ECE 65,A50,083695,Staff,0,5,30,30
1650386111180,ECE 109,A01,091882,Touri; Behrouz,40,0,70,30
1650386117202,ECE 180,A00,083140,Abi Samra; Nicholas Camill,24,0,30,6
1650386117202,ECE 180,B00,083141,Abi Samra; Nicholas Camill,3,0,30,27
1650386123232,MATH 10A,A01,083735,Patchell; Gregory David,7,0,30,23
1650386123232,MATH 10A,A02,083736,Patchell; Gregory David,28,0,30,2
1650386123232,MATH 10A,A03,083737,Patchell; Gregory David,25,0,30,5
1650386129260,MATH 10B,A01,083207,Staff,0,7,30,30
1650386129260,MATH 10B,A02,083208,Staff,0,7,30,30
1650386129260,MATH 10B,B01,083739,Staff,17,0,30,13
1650386129260,MATH 10B,B02,083740,Staff,28,0,30,2
1650386135283,MATH 18,A01,083743,Staff,3,0,30,27
1650386135283,MATH 18,A02,083744,Staff,27,0,30,3
1650386135283,MATH 18,A03,083745,Staff,22,0,30,8
1650386135283,MATH 18,A04,083746,Staff,27,0,30,3
1650386135283,MATH 18,B01,083748,Staff,0,11,30,30
1650386135283,MATH 18,B02,083749,Staff,0,12,30,30
1650386135283,MATH 18,B03,083750,Staff,0,11,30,30
1650386135283,MATH 18,B04,083751,Staff,0,9,30,30
1650386141310,MATH 20A,A01,083754,Staff,26,0,40,14
1650386147334,MATH 20B,A01,083756,Staff,0,8,30,30
1650386147334,MATH 20B,A02,083757,Staff,0,8,30,30
1650386153357,MATH 20C,A01,083760,Staff,0,14,30,30
1650386153357,MATH 20C,A02,083761,Staff,0,15,30,30
1650386153357,MATH 20C,B01,083762,Staff,13,0,30,17
1650386153357,MATH 20C,B02,083763,Staff,28,0,30,2
1650386159380,MATH 20D,A01,083765,Staff,0,1,30,30
1650386159380,MATH 20D,A02,083766,Staff,7,0,30,23
1650386159380,MATH 20D,A03,083767,Staff,26,0,30,4
1650386165407,MATH 20E,A01,083771,Staff,5,0,30,25
1650386165407,MATH 20E,A02,083772,Staff,19,0,30,11
1650386165407,MATH 20E,B01,083773,Staff,0,0,30,30
1650386165407,MATH 20E,B02,083774,Staff,12,0,30,18
1650386171440,MATH 103A,A01,083777,Staff,0,11,30,30
1650386171440,MATH 103A,A02,083778,Staff,0,12,30,30
1650386171440,MATH 103A,B01,083779,Staff,0,13,30,30
1650386171440,MATH 103A,B02,083780,Staff,0,11,30,30
1650386177463,MATH 105,A01,085443,Staff,0,21,30,30
1650386183488,MATH 109,A01,083213,Anzaldo; Leesa B,0,6,30,30
1650386183488,MATH 109,A02,083214,Anzaldo; Leesa B,0,7,30,30
1650386183488,MATH 109,B01,083215,Anzaldo; Leesa B,0,5,30,30
1650386183488,MATH 109,B02,083216,Anzaldo; Leesa B,0,5,30,30
1650386189522,MATH 142A,A01,083219,Chow; Bennett,0,14,30,30
1650386189522,MATH 142A,A02,083220,Chow; Bennett,0,13,30,30
1650386189522,MATH 142A,B01,083221,Chow; Bennett,0,12,30,30
1650386189522,MATH 142A,B02,083222,Chow; Bennett,0,12,30,30
1650386195554,MATH 193A,A01,083224,Staff,0,5,30,30
1650386195554,MATH 193A,A02,083225,Staff,0,5,30,30
1650386195554,MATH 193A,A03,083781,Staff,0,4,30,30
1650386195554,MATH 193A,A04,083782,Staff,0,4,30,30
1650386201580,MATH 197,001,091859,McAuley; Julian John,9998,0,9999,1
1650386207652,COGS 9,A01,083615,Staff,0,14,60,60
1650386213678,COGS 11,A01,083617,Boyle; Mary E. T.,22,0,40,18
1650386219703,COGS 13,A01,083071,Staff,0,33,40,40
1650386225742,COGS 14A,A01,092681,Staff,0,22,100,100
1650386231769,COGS 14B,A01,083073,Cheng; Tzu-Han,0,10,50,50
1650386237799,COGS 17,A01,092677,Staff,24,0,75,51
1650386243825,COGS 100,A01,083619,Staff,0,24,60,60
1650386249869,COGS 101A,A01,083621,Davis; Joshua Daniel,0,21,60,60
1650386255890,COGS 101B,A01,091572,Staff,0,0,60,60
1650386261916,COGS 101C,A01,083625,Delgado; Tania,16,0,30,14
1650386267948,COGS 107A,A01,083627,Boyle; Mary E. T.,0,10,60,60
1650386273970,COGS 118A,A01,083075,Staff,4,0,60,56
1650386280003,CSE 3,A50,083646,Miranda; Gregory Joseph,21,0,38,17
1650386280003,CSE 3,A51,083647,Miranda; Gregory Joseph,37,0,37,0
1650386286027,CSE 8A,A50,083650,Miranda; Gregory Joseph,0,28,40,40
1650386292050,CSE 11,A01,083080,Cao; Yingjun,0,89,40,40
1650386298082,CSE 12,A01,083652,Staff,0,12,100,100
1650386304112,CSE 15L,A01,083654,Staff,0,1,50,50
1650386304112,CSE 15L,A02,083655,Staff,3,0,50,47
1650386310138,CSE 20,A01,083657,Staff,52,0,80,28
1650386316162,CSE 30,A01,083084,Eldon; John,0,76,40,40
1650386322195,CSE 100,A01,083659,Cao; Yingjun,0,66,50,50
1650386328228,CSE 134B,A01,083661,Powell; Thomas Allan,0,31,65,65
1650386334253,CSE 140,A01,083663,Staff,0,0,75,75
1650386340284,CSE 140L,A01,083088,Eldon; John,0,7,75,75
1650386346306,CSE 175,A01,083665,Kumar; Rakesh,8,0,25,17
1650386352330,CSE 190,A00,092507,Dubnov; Shlomo,14,0,20,6
1650386358363,ECE 45,A01,083139,Staff,0,17,40,40
1650386364386,ECE 65,A50,083695,Staff,0,5,30,30
1650386370413,ECE 109,A01,091882,Touri; Behrouz,40,0,70,30
1650386376438,ECE 180,A00,083140,Abi Samra; Nicholas Camill,24,0,30,6
1650386376438,ECE 180,B00,083141,Abi Samra; Nicholas Camill,3,0,30,27
1650386382462,MATH 10A,A01,083735,Patchell; Gregory David,7,0,30,23
1650386382462,MATH 10A,A02,083736,Patchell; Gregory David,28,0,30,2
1650386382462,MATH 10A,A03,083737,Patchell; Gregory David,25,0,30,5
1650386388485,MATH 10B,A01,083207,Staff,0,7,30,30
1650386388485,MATH 10B,A02,083208,Staff,0,7,30,30
1650386388485,MATH 10B,B01,083739,Staff,17,0,30,13
1650386388485,MATH 10B,B02,083740,Staff,28,0,30,2
1650386394518,MATH 18,A01,083743,Staff,3,0,30,27
1650386394518,MATH 18,A02,083744,Staff,27,0,30,3
1650386394518,MATH 18,A03,083745,Staff,22,0,30,8
1650386394518,MATH 18,A04,083746,Staff,27,0,30,3
1650386394518,MATH 18,B01,083748,Staff,0,11,30,30
1650386394518,MATH 18,B02,083749,Staff,0,12,30,30
1650386394518,MATH 18,B03,083750,Staff,0,11,30,30
1650386394518,MATH 18,B04,083751,Staff,0,9,30,30
1650386400549,MATH 20A,A01,083754,Staff,26,0,40,14
1650386406582,MATH 20B,A01,083756,Staff,0,8,30,30
1650386406582,MATH 20B,A02,083757,Staff,0,8,30,30
1650386412606,MATH 20C,A01,083760,Staff,0,14,30,30
1650386412606,MATH 20C,A02,083761,Staff,0,15,30,30
1650386412606,MATH 20C,B01,083762,Staff,13,0,30,17
1650386412606,MATH 20C,B02,083763,Staff,28,0,30,2
1650386418629,MATH 20D,A01,083765,Staff,0,1,30,30
1650386418629,MATH 20D,A02,083766,Staff,7,0,30,23
1650386418629,MATH 20D,A03,083767,Staff,26,0,30,4
1650386424654,MATH 20E,A01,083771,Staff,5,0,30,25
1650386424654,MATH 20E,A02,083772,Staff,19,0,30,11
1650386424654,MATH 20E,B01,083773,Staff,0,0,30,30
1650386424654,MATH 20E,B02,083774,Staff,12,0,30,18
1650386430684,MATH 103A,A01,083777,Staff,0,11,30,30
1650386430684,MATH 103A,A02,083778,Staff,0,12,30,30
1650386430684,MATH 103A,B01,083779,Staff,0,13,30,30
1650386430684,MATH 103A,B02,083780,Staff,0,11,30,30
1650386436713,MATH 105,A01,085443,Staff,0,21,30,30
1650386442736,MATH 109,A01,083213,Anzaldo; Leesa B,0,6,30,30
1650386442736,MATH 109,A02,083214,Anzaldo; Leesa B,0,7,30,30
1650386442736,MATH 109,B01,083215,Anzaldo; Leesa B,0,5,30,30
1650386442736,MATH 109,B02,083216,Anzaldo; Leesa B,0,5,30,30
1650386448765,MATH 142A,A01,083219,Chow; Bennett,0,14,30,30
1650386448765,MATH 142A,A02,083220,Chow; Bennett,0,13,30,30
1650386448765,MATH 142A,B01,083221,Chow; Bennett,0,12,30,30
1650386448765,MATH 142A,B02,083222,Chow; Bennett,0,12,30,30
1650386454788,MATH 193A,A01,083224,Staff,0,5,30,30
1650386454788,MATH 193A,A02,083225,Staff,0,5,30,30
1650386454788,MATH 193A,A03,083781,Staff,0,4,30,30
1650386454788,MATH 193A,A04,083782,Staff,0,4,30,30
1650386460818,MATH 197,001,091859,McAuley; Julian John,9998,0,9999,1
1650386466870,COGS 9,A01,083615,Staff,0,14,60,60
1650386472898,COGS 11,A01,083617,Boyle; Mary E. T.,22,0,40,18
1650386478936,COGS 13,A01,083071,Staff,0,33,40,40
1650386484962,COGS 14A,A01,092681,Staff,0,22,100,100
1650386490986,COGS 14B,A01,083073,Cheng; Tzu-Han,0,10,50,50
1650386497015,COGS 17,A01,092677,Staff,24,0,75,51
1650386503039,COGS 100,A01,083619,Staff,0,24,60,60
1650386509062,COGS 101A,A01,083621,Davis; Joshua Daniel,0,21,60,60
1650386515086,COGS 101B,A01,091572,Staff,0,0,60,60
1650386521110,COGS 101C,A01,083625,Delgado; Tania,16,0,30,14
1650386527153,COGS 107A,A01,083627,Boyle; Mary E. T.,0,10,60,60
1650386533186,COGS 118A,A01,083075,Staff,4,0,60,56
1650386539209,CSE 3,A50,083646,Miranda; Gregory Joseph,21,0,38,17
1650386539209,CSE 3,A51,083647,Miranda; Gregory Joseph,37,0,37,0
1650386545237,CSE 8A,A50,083650,Miranda; Gregory Joseph,0,28,40,40
1650386551273,CSE 11,A01,083080,Cao; Yingjun,0,89,40,40
1650386557297,CSE 12,A01,083652,Staff,0,13,100,100
1650386563395,CSE 15L,A01,083654,Staff,0,2,50,50
1650386563395,CSE 15L,A02,083655,Staff,3,0,50,47
1650386569418,CSE 20,A01,083657,Staff,52,0,80,28
1650386575442,CSE 30,A01,083084,Eldon; John,0,76,40,40
1650386581466,CSE 100,A01,083659,Cao; Yingjun,0,66,50,50
1650386587491,CSE 134B,A01,083661,Powell; Thomas Allan,0,31,65,65
1650386593517,CSE 140,A01,083663,Staff,0,0,75,75
1650386599545,CSE 140L,A01,083088,Eldon; John,0,7,75,75
1650386605571,CSE 175,A01,083665,Kumar; Rakesh,8,0,25,17
1650386611597,CSE 190,A00,092507,Dubnov; Shlomo,14,0,20,6
1650386617621,ECE 45,A01,083139,Staff,0,17,40,40
1650386623649,ECE 65,A50,083695,Staff,0,5,30,30
1650386629679,ECE 109,A01,091882,Touri; Behrouz,40,0,70,30
1650386635703,ECE 180,A00,083140,Abi Samra; Nicholas Camill,24,0,30,6
1650386635703,ECE 180,B00,083141,Abi Samra; Nicholas Camill,3,0,30,27
1650386641737,MATH 10A,A01,083735,Patchell; Gregory David,7,0,30,23
1650386641737,MATH 10A,A02,083736,Patchell; Gregory David,28,0,30,2
1650386641737,MATH 10A,A03,083737,Patchell; Gregory David,25,0,30,5
1650386647761,MATH 10B,A01,083207,Staff,0,7,30,30
1650386647761,MATH 10B,A02,083208,Staff,0,7,30,30
1650386647761,MATH 10B,B01,083739,Staff,17,0,30,13
1650386647761,MATH 10B,B02,083740,Staff,28,0,30,2
1650386653786,MATH 18,A01,083743,Staff,3,0,30,27
1650386653786,MATH 18,A02,083744,Staff,27,0,30,3
1650386653786,MATH 18,A03,083745,Staff,22,0,30,8
1650386653786,MATH 18,A04,083746,Staff,27,0,30,3
1650386653786,MATH 18,B01,083748,Staff,0,11,30,30
1650386653786,MATH 18,B02,083749,Staff,0,12,30,30
1650386653786,MATH 18,B03,083750,Staff,0,11,30,30
1650386653786,MATH 18,B04,083751,Staff,0,9,30,30
1650386659813,MATH 20A,A01,083754,Staff,26,0,40,14
1650386665835,MATH 20B,A01,083756,Staff,0,8,30,30
1650386665835,MATH 20B,A02,083757,Staff,0,8,30,30
1650386671865,MATH 20C,A01,083760,Staff,0,14,30,30
1650386671865,MATH 20C,A02,083761,Staff,0,15,30,30
1650386671865,MATH 20C,B01,083762,Staff,13,0,30,17
1650386671865,MATH 20C,B02,083763,Staff,28,0,30,2
1650386677903,MATH 20D,A01,083765,Staff,0,1,30,30
1650386677903,MATH 20D,A02,083766,Staff,7,0,30,23
1650386677903,MATH 20D,A03,083767,Staff,26,0,30,4
1650386683928,MATH 20E,A01,083771,Staff,5,0,30,25
1650386683928,MATH 20E,A02,083772,Staff,19,0,30,11
1650386683928,MATH 20E,B01,083773,Staff,0,0,30,30
1650386683928,MATH 20E,B02,083774,Staff,12,0,30,18
1650386689954,MATH 103A,A01,083777,Staff,0,11,30,30
1650386689954,MATH 103A,A02,083778,Staff,0,12,30,30
1650386689954,MATH 103A,B01,083779,Staff,0,13,30,30
1650386689954,MATH 103A,B02,083780,Staff,0,11,30,30
1650386695977,MATH 105,A01,085443,Staff,0,21,30,30
1650386702000,MATH 109,A01,083213,Anzaldo; Leesa B,0,6,30,30
1650386702000,MATH 109,A02,083214,Anzaldo; Leesa B,0,7,30,30
1650386702000,MATH 109,B01,083215,Anzaldo; Leesa B,0,5,30,30
1650386702000,MATH 109,B02,083216,Anzaldo; Leesa B,0,5,30,30
1650386708025,MATH 142A,A01,083219,Chow; Bennett,0,14,30,30
1650386708025,MATH 142A,A02,083220,Chow; Bennett,0,13,30,30
1650386708025,MATH 142A,B01,083221,Chow; Bennett,0,12,30,30
1650386708025,MATH 142A,B02,083222,Chow; Bennett,0,12,30,30
1650386714067,MATH 193A,A01,083224,Staff,0,5,30,30
1650386714067,MATH 193A,A02,083225,Staff,0,5,30,30
1650386714067,MATH 193A,A03,083781,Staff,0,4,30,30
1650386714067,MATH 193A,A04,083782,Staff,0,4,30,30
1650386720097,MATH 197,001,091859,McAuley; Julian John,9998,0,9999,1
1650386726167,COGS 9,A01,083615,Staff,0,14,60,60
1650386732200,COGS 11,A01,083617,Boyle; Mary E. T.,22,0,40,18
1650386738223,COGS 13,A01,083071,Staff,0,33,40,40
1650386744254,COGS 14A,A01,092681,Staff,0,22,100,100
1650386750277,COGS 14B,A01,083073,Cheng; Tzu-Han,0,10,50,50
1650386756311,COGS 17,A01,092677,Staff,24,0,75,51
1650386762339,COGS 100,A01,083619,Staff,0,24,60,60
1650386768363,COGS 101A,A01,083621,Davis; Joshua Daniel,0,21,60,60
1650386774391,COGS 101B,A01,091572,Staff,0,0,60,60
1650386780417,COGS 101C,A01,083625,Delgado; Tania,16,0,30,14
1650386786448,COGS 107A,A01,083627,Boyle; Mary E. T.,0,10,60,60
1650386792478,COGS 118A,A01,083075,Staff,4,0,60,56
1650386798505,CSE 3,A50,083646,Miranda; Gregory Joseph,21,0,38,17
1650386798505,CSE 3,A51,083647,Miranda; Gregory Joseph,37,0,37,0
1650386804532,CSE 8A,A50,083650,Miranda; Gregory Joseph,0,28,40,40
1650386810556,CSE 11,A01,083080,Cao; Yingjun,0,89,40,40
1650386816580,CSE 12,A01,083652,Staff,0,13,100,100
1650386822604,CSE 15L,A01,083654,Staff,0,1,50,50
1650386822604,CSE 15L,A02,083655,Staff,2,0,50,48
1650386828635,CSE 20,A01,083657,Staff,52,0,80,28
1650386834662,CSE 30,A01,083084,Eldon; John,0,76,40,40
1650386840687,CSE 100,A01,083659,Cao; Yingjun,0,66,50,50
1650386846710,CSE 134B,A01,083661,Powell; Thomas Allan,0,31,65,65
1650386852739,CSE 140,A01,083663,Staff,0,0,75,75
1650386858771,CSE 140L,A01,083088,Eldon; John,0,7,75,75
1650386864802,CSE 175,A01,083665,Kumar; Rakesh,8,0,25,17
1650386870827,CSE 190,A00,092507,Dubnov; Shlomo,14,0,20,6
1650386876852,ECE 45,A01,083139,Staff,0,17,40,40
1650386882879,ECE 65,A50,083695,Staff,0,5,30,30
1650386888906,ECE 109,A01,091882,Touri; Behrouz,40,0,70,30
1650386894932,ECE 180,A00,083140,Abi Samra; Nicholas Camill,24,0,30,6
1650386894932,ECE 180,B00,083141,Abi Samra; Nicholas Camill,3,0,30,27
1650386900957,MATH 10A,A01,083735,Patchell; Gregory David,7,0,30,23
1650386900957,MATH 10A,A02,083736,Patchell; Gregory David,28,0,30,2
1650386900957,MATH 10A,A03,083737,Patchell; Gregory David,25,0,30,5
1650386906985,MATH 10B,A01,083207,Staff,0,7,30,30
1650386906985,MATH 10B,A02,083208,Staff,0,7,30,30
1650386906985,MATH 10B,B01,083739,Staff,17,0,30,13
1650386906985,MATH 10B,B02,083740,Staff,28,0,30,2
1650386913012,MATH 18,A01,083743,Staff,3,0,30,27
1650386913012,MATH 18,A02,083744,Staff,27,0,30,3
1650386913012,MATH 18,A03,083745,Staff,22,0,30,8
1650386913012,MATH 18,A04,083746,Staff,27,0,30,3
1650386913012,MATH 18,B01,083748,Staff,0,11,30,30
1650386913012,MATH 18,B02,083749,Staff,0,12,30,30
1650386913012,MATH 18,B03,083750,Staff,0,11,30,30
1650386913012,MATH 18,B04,083751,Staff,0,9,30,30
1650386919036,MATH 20A,A01,083754,Staff,26,0,40,14
1650386925063,MATH 20B,A01,083756,Staff,0,8,30,30
1650386925063,MATH 20B,A02,083757,Staff,0,8,30,30
1650386931097,MATH 20C,A01,083760,Staff,0,14,30,30
1650386931097,MATH 20C,A02,083761,Staff,0,15,30,30
1650386931097,MATH 20C,B01,083762,Staff,13,0,30,17
1650386931097,MATH 20C,B02,083763,Staff,28,0,30,2
1650386937120,MATH 20D,A01,083765,Staff,0,1,30,30
1650386937120,MATH 20D,A02,083766,Staff,7,0,30,23
1650386937120,MATH 20D,A03,083767,Staff,26,0,30,4
1650386943144,MATH 20E,A01,083771,Staff,5,0,30,25
1650386943144,MATH 20E,A02,083772,Staff,19,0,30,11
1650386943144,MATH 20E,B01,083773,Staff,0,0,30,30
1650386943144,MATH 20E,B02,083774,Staff,12,0,30,18
1650386949185,MATH 103A,A01,083777,Staff,0,11,30,30
1650386949185,MATH 103A,A02,083778,Staff,0,12,30,30
1650386949185,MATH 103A,B01,083779,Staff,0,13,30,30
1650386949185,MATH 103A,B02,083780,Staff,0,11,30,30
1650386955215,MATH 105,A01,085443,Staff,0,21,30,30
1650386961247,MATH 109,A01,083213,Anzaldo; Leesa B,0,6,30,30
1650386961247,MATH 109,A02,083214,Anzaldo; Leesa B,0,7,30,30
1650386961247,MATH 109,B01,083215,Anzaldo; Leesa B,0,5,30,30
1650386961247,MATH 109,B02,083216,Anzaldo; Leesa B,0,5,30,30
1650386967281,MATH 142A,A01,083219,Chow; Bennett,0,14,30,30
1650386967281,MATH 142A,A02,083220,Chow; Bennett,0,13,30,30
1650386967281,MATH 142A,B01,083221,Chow; Bennett,0,12,30,30
1650386967281,MATH 142A,B02,083222,Chow; Bennett,0,12,30,30
1650386973307,MATH 193A,A01,083224,Staff,0,5,30,30
1650386973307,MATH 193A,A02,083225,Staff,0,5,30,30
1650386973307,MATH 193A,A03,083781,Staff,0,4,30,30
1650386973307,MATH 193A,A04,083782,Staff,0,4,30,30
1650386979344,MATH 197,001,091859,McAuley; Julian John,9998,0,9999,1
1650386985403,COGS 9,A01,083615,Staff,0,14,60,60
1650386991430,COGS 11,A01,083617,Boyle; Mary E. T.,22,0,40,18
1650386997453,COGS 13,A01,083071,Staff,0,33,40,40
1650387003479,COGS 14A,A01,092681,Staff,0,22,100,100
1650387009504,COGS 14B,A01,083073,Cheng; Tzu-Han,0,10,50,50
1650387015531,COGS 17,A01,092677,Staff,24,0,75,51
1650387021564,COGS 100,A01,083619,Staff,0,24,60,60
1650387027588,COGS 101A,A01,083621,Davis; Joshua Daniel,0,21,60,60
1650387033614,COGS 101B,A01,091572,Staff,0,0,60,60
1650387039656,COGS 101C,A01,083625,Delgado; Tania,16,0,30,14
1650387045683,COGS 107A,A01,083627,Boyle; Mary E. T.,0,10,60,60
1650387051725,COGS 118A,A01,083075,Staff,4,0,60,56
1650387057750,CSE 3,A50,083646,Miranda; Gregory Joseph,21,0,38,17
1650387057750,CSE 3,A51,083647,Miranda; Gregory Joseph,37,0,37,0
1650387063774,CSE 8A,A50,083650,Miranda; Gregory Joseph,0,28,40,40
1650387069800,CSE 11,A01,083080,Cao; Yingjun,0,89,40,40
1650387075825,CSE 12,A01,083652,Staff,0,13,100,100
1650387081849,CSE 15L,A01,083654,Staff,0,1,50,50
1650387081849,CSE 15L,A02,083655,Staff,2,0,50,48
1650387087873,CSE 20,A01,083657,Staff,52,0,80,28
1650387093900,CSE 30,A01,083084,Eldon; John,0,76,40,40
1650387099923,CSE 100,A01,083659,Cao; Yingjun,0,66,50,50
1650387105947,CSE 134B,A01,083661,Powell; Thomas Allan,0,31,65,65
1650387111970,CSE 140,A01,083663,Staff,0,0,75,75
1650387117994,CSE 140L,A01,083088,Eldon; John,0,7,75,75
1650387124022,CSE 175,A01,083665,Kumar; Rakesh,8,0,25,17
1650387130051,CSE 190,A00,092507,Dubnov; Shlomo,14,0,20,6
1650387136077,ECE 45,A01,083139,Staff,0,17,40,40
1650387142100,ECE 65,A50,083695,Staff,0,5,30,30
1650387148134,ECE 109,A01,091882,Touri; Behrouz,40,0,70,30
1650387154161,ECE 180,A00,083140,Abi Samra; Nicholas Camill,24,0,30,6
1650387154161,ECE 180,B00,083141,Abi Samra; Nicholas Camill,3,0,30,27
1650387160277,MATH 10A,A01,083735,Patchell; Gregory David,7,0,30,23
1650387160277,MATH 10A,A02,083736,Patchell; Gregory David,28,0,30,2
1650387160277,MATH 10A,A03,083737,Patchell; Gregory David,25,0,30,5
1650387166304,MATH 10B,A01,083207,Staff,0,7,30,30
1650387166304,MATH 10B,A02,083208,Staff,0,7,30,30
1650387166304,MATH 10B,B01,083739,Staff,17,0,30,13
1650387166304,MATH 10B,B02,083740,Staff,28,0,30,2
1650387172329,MATH 18,A01,083743,Staff,3,0,30,27
1650387172329,MATH 18,A02,083744,Staff,27,0,30,3
1650387172329,MATH 18,A03,083745,Staff,22,0,30,8
1650387172329,MATH 18,A04,083746,Staff,27,0,30,3
1650387172329,MATH 18,B01,083748,Staff,0,11,30,30
1650387172329,MATH 18,B02,083749,Staff,0,12,30,30
1650387172329,MATH 18,B03,083750,Staff,0,11,30,30
1650387172329,MATH 18,B04,083751,Staff,0,9,30,30
1650387178358,MATH 20A,A01,083754,Staff,26,0,40,14
1650387184384,MATH 20B,A01,083756,Staff,0,8,30,30
1650387184384,MATH 20B,A02,083757,Staff,0,8,30,30
1650387190409,MATH 20C,A01,083760,Staff,0,14,30,30
1650387190409,MATH 20C,A02,083761,Staff,0,15,30,30
1650387190409,MATH 20C,B01,083762,Staff,13,0,30,17
1650387190409,MATH 20C,B02,083763,Staff,28,0,30,2
1650387196432,MATH 20D,A01,083765,Staff,0,1,30,30
1650387196432,MATH 20D,A02,083766,Staff,7,0,30,23
1650387196432,MATH 20D,A03,083767,Staff,26,0,30,4
1650387202456,MATH 20E,A01,083771,Staff,5,0,30,25
1650387202456,MATH 20E,A02,083772,Staff,19,0,30,11
1650387202456,MATH 20E,B01,083773,Staff,0,0,30,30
1650387202456,MATH 20E,B02,083774,Staff,12,0,30,18
1650387208484,MATH 103A,A01,083777,Staff,0,11,30,30
1650387208484,MATH 103A,A02,083778,Staff,0,12,30,30
1650387208484,MATH 103A,B01,083779,Staff,0,13,30,30
1650387208484,MATH 103A,B02,083780,Staff,0,11,30,30
1650387214507,MATH 105,A01,085443,Staff,0,21,30,30
1650387220534,MATH 109,A01,083213,Anzaldo; Leesa B,0,6,30,30
1650387220534,MATH 109,A02,083214,Anzaldo; Leesa B,0,7,30,30
1650387220534,MATH 109,B01,083215,Anzaldo; Leesa B,0,5,30,30
1650387220534,MATH 109,B02,083216,Anzaldo; Leesa B,0,5,30,30
1650387226558,MATH 142A,A01,083219,Chow; Bennett,0,14,30,30
1650387226558,MATH 142A,A02,083220,Chow; Bennett,0,13,30,30
1650387226558,MATH 142A,B01,083221,Chow; Bennett,0,12,30,30
1650387226558,MATH 142A,B02,083222,Chow; Bennett,0,12,30,30
1650387232585,MATH 193A,A01,083224,Staff,0,5,30,30
1650387232585,MATH 193A,A02,083225,Staff,0,5,30,30
1650387232585,MATH 193A,A03,083781,Staff,0,4,30,30
1650387232585,MATH 193A,A04,083782,Staff,0,4,30,30
1650387238609,MATH 197,001,091859,McAuley; Julian John,9998,0,9999,1
1650387244664,COGS 9,A01,083615,Staff,0,14,60,60
1650387250693,COGS 11,A01,083617,Boyle; Mary E. T.,22,0,40,18
1650387256734,COGS 13,A01,083071,Staff,0,33,40,40
1650387262762,COGS 14A,A01,092681,Staff,0,22,100,100
1650387268787,COGS 14B,A01,083073,Cheng; Tzu-Han,0,10,50,50
1650387274811,COGS 17,A01,092677,Staff,24,0,75,51
1650387280838,COGS 100,A01,083619,Staff,0,24,60,60
1650387286863,COGS 101A,A01,083621,Davis; Joshua Daniel,0,21,60,60
1650387292893,COGS 101B,A01,091572,Staff,0,0,60,60
1650387298916,COGS 101C,A01,083625,Delgado; Tania,16,0,30,14
1650387304945,COGS 107A,A01,083627,Boyle; Mary E. T.,0,10,60,60
1650387310975,COGS 118A,A01,083075,Staff,4,0,60,56
1650387317001,CSE 3,A50,083646,Miranda; Gregory Joseph,21,0,38,17
1650387317001,CSE 3,A51,083647,Miranda; Gregory Joseph,37,0,37,0
1650387323030,CSE 8A,A50,083650,Miranda; Gregory Joseph,0,28,40,40
1650387329057,CSE 11,A01,083080,Cao; Yingjun,0,89,40,40
1650387335086,CSE 12,A01,083652,Staff,0,13,100,100
1650387341137,CSE 15L,A01,083654,Staff,0,1,50,50
1650387341137,CSE 15L,A02,083655,Staff,2,0,50,48
1650387347161,CSE 20,A01,083657,Staff,52,0,80,28
1650387353202,CSE 30,A01,083084,Eldon; John,0,76,40,40
1650387359228,CSE 100,A01,083659,Cao; Yingjun,0,66,50,50
1650387365262,CSE 134B,A01,083661,Powell; Thomas Allan,0,31,65,65
1650387371291,CSE 140,A01,083663,Staff,0,0,75,75
1650387377328,CSE 140L,A01,083088,Eldon; John,0,7,75,75
1650387383349,CSE 175,A01,083665,Kumar; Rakesh,8,0,25,17
1650387389378,CSE 190,A00,092507,Dubnov; Shlomo,14,0,20,6
1650387395405,ECE 45,A01,083139,Staff,0,17,40,40
1650387401441,ECE 65,A50,083695,Staff,0,5,30,30
1650387407471,ECE 109,A01,091882,Touri; Behrouz,40,0,70,30
1650387413494,ECE 180,A00,083140,Abi Samra; Nicholas Camill,24,0,30,6
1650387413494,ECE 180,B00,083141,Abi Samra; Nicholas Camill,3,0,30,27
1650387419518,MATH 10A,A01,083735,Patchell; Gregory David,7,0,30,23
1650387419518,MATH 10A,A02,083736,Patchell; Gregory David,28,0,30,2
1650387419518,MATH 10A,A03,083737,Patchell; Gregory David,25,0,30,5
1650387425546,MATH 10B,A01,083207,Staff,0,7,30,30
1650387425546,MATH 10B,A02,083208,Staff,0,7,30,30
1650387425546,MATH 10B,B01,083739,Staff,17,0,30,13
1650387425546,MATH 10B,B02,083740,Staff,28,0,30,2
1650387431583,MATH 18,A01,083743,Staff,3,0,30,27
1650387431583,MATH 18,A02,083744,Staff,27,0,30,3
1650387431583,MATH 18,A03,083745,Staff,22,0,30,8
1650387431583,MATH 18,A04,083746,Staff,27,0,30,3
1650387431583,MATH 18,B01,083748,Staff,0,11,30,30
1650387431583,MATH 18,B02,083749,Staff,0,12,30,30
1650387431583,MATH 18,B03,083750,Staff,0,11,30,30
1650387431583,MATH 18,B04,083751,Staff,0,9,30,30
1650387437610,MATH 20A,A01,083754,Staff,26,0,40,14
1650387443648,MATH 20B,A01,083756,Staff,0,8,30,30
1650387443648,MATH 20B,A02,083757,Staff,0,8,30,30
1650387449675,MATH 20C,A01,083760,Staff,0,14,30,30
1650387449675,MATH 20C,A02,083761,Staff,0,15,30,30
1650387449675,MATH 20C,B01,083762,Staff,13,0,30,17
1650387449675,MATH 20C,B02,083763,Staff,28,0,30,2
1650387455709,MATH 20D,A01,083765,Staff,0,1,30,30
1650387455709,MATH 20D,A02,083766,Staff,7,0,30,23
1650387455709,MATH 20D,A03,083767,Staff,26,0,30,4
1650387461748,MATH 20E,A01,083771,Staff,5,0,30,25
1650387461748,MATH 20E,A02,083772,Staff,19,0,30,11
1650387461748,MATH 20E,B01,083773,Staff,0,0,30,30
1650387461748,MATH 20E,B02,083774,Staff,12,0,30,18
1650387467772,MATH 103A,A01,083777,Staff,0,11,30,30
1650387467772,MATH 103A,A02,083778,Staff,0,12,30,30
1650387467772,MATH 103A,B01,083779,Staff,0,13,30,30
1650387467772,MATH 103A,B02,083780,Staff,0,11,30,30
1650387473795,MATH 105,A01,085443,Staff,0,21,30,30
1650387479823,MATH 109,A01,083213,Anzaldo; Leesa B,0,6,30,30
1650387479823,MATH 109,A02,083214,Anzaldo; Leesa B,0,7,30,30
1650387479823,MATH 109,B01,083215,Anzaldo; Leesa B,0,5,30,30
1650387479823,MATH 109,B02,083216,Anzaldo; Leesa B,0,5,30,30
1650387485850,MATH 142A,A01,083219,Chow; Bennett,0,14,30,30
1650387485850,MATH 142A,A02,083220,Chow; Bennett,0,13,30,30
1650387485850,MATH 142A,B01,083221,Chow; Bennett,0,12,30,30
1650387485850,MATH 142A,B02,083222,Chow; Bennett,0,12,30,30
1650387491875,MATH 193A,A01,083224,Staff,0,5,30,30
1650387491875,MATH 193A,A02,083225,Staff,0,5,30,30
1650387491875,MATH 193A,A03,083781,Staff,0,4,30,30
1650387491875,MATH 193A,A04,083782,Staff,0,4,30,30
1650387497901,MATH 197,001,091859,McAuley; Julian John,9998,0,9999,1
1650387503960,COGS 9,A01,083615,Staff,0,14,60,60
1650387509983,COGS 11,A01,083617,Boyle; Mary E. T.,22,0,40,18
1650387516008,COGS 13,A01,083071,Staff,0,33,40,40
1650387522033,COGS 14A,A01,092681,Staff,0,22,100,100
1650387528056,COGS 14B,A01,083073,Cheng; Tzu-Han,0,10,50,50
1650387534080,COGS 17,A01,092677,Staff,24,0,75,51
1650387540104,COGS 100,A01,083619,Staff,0,24,60,60
1650387546128,COGS 101A,A01,083621,Davis; Joshua Daniel,0,21,60,60
1650387552162,COGS 101B,A01,091572,Staff,0,0,60,60
1650387558186,COGS 101C,A01,083625,Delgado; Tania,16,0,30,14
1650387564212,COGS 107A,A01,083627,Boyle; Mary E. T.,0,10,60,60
1650387570235,COGS 118A,A01,083075,Staff,4,0,60,56
1650387576268,CSE 3,A50,083646,Miranda; Gregory Joseph,21,0,38,17
1650387576268,CSE 3,A51,083647,Miranda; Gregory Joseph,37,0,37,0
1650387582304,CSE 8A,A50,083650,Miranda; Gregory Joseph,0,28,40,40
1650387588330,CSE 11,A01,083080,Cao; Yingjun,0,89,40,40
1650387594356,CSE 12,A01,083652,Staff,0,13,100,100
1650387600379,CSE 15L,A01,083654,Staff,0,1,50,50
1650387600379,CSE 15L,A02,083655,Staff,2,0,50,48
1650387606405,CSE 20,A01,083657,Staff,52,0,80,28
1650387612428,CSE 30,A01,083084,Eldon; John,0,76,40,40
1650387618452,CSE 100,A01,083659,Cao; Yingjun,0,66,50,50
1650387624478,CSE 134B,A01,083661,Powell; Thomas Allan,0,31,65,65
1650387630501,CSE 140,A01,083663,Staff,0,0,75,75
1650387636534,CSE 140L,A01,083088,Eldon; John,0,7,75,75
1650387642560,CSE 175,A01,083665,Kumar; Rakesh,8,0,25,17
1650387648582,CSE 190,A00,092507,Dubnov; Shlomo,14,0,20,6
1650387654606,ECE 45,A01,083139,Staff,0,17,40,40
1650387660643,ECE 65,A50,083695,Staff,0,5,30,30
1650387666667,ECE 109,A01,091882,Touri; Behrouz,40,0,70,30
1650387672692,ECE 180,A00,083140,Abi Samra; Nicholas Camill,24,0,30,6
1650387672692,ECE 180,B00,083141,Abi Samra; Nicholas Camill,3,0,30,27
1650387678716,MATH 10A,A01,083735,Patchell; Gregory David,7,0,30,23
1650387678716,MATH 10A,A02,083736,Patchell; Gregory David,28,0,30,2
1650387678716,MATH 10A,A03,083737,Patchell; Gregory David,25,0,30,5
1650387684740,MATH 10B,A01,083207,Staff,0,7,30,30
1650387684740,MATH 10B,A02,083208,Staff,0,7,30,30
1650387684740,MATH 10B,B01,083739,Staff,17,0,30,13
1650387684740,MATH 10B,B02,083740,Staff,28,0,30,2
1650387690765,MATH 18,A01,083743,Staff,3,0,30,27
1650387690765,MATH 18,A02,083744,Staff,27,0,30,3
1650387690765,MATH 18,A03,083745,Staff,22,0,30,8
1650387690765,MATH 18,A04,083746,Staff,27,0,30,3
1650387690765,MATH 18,B01,083748,Staff,0,11,30,30
1650387690765,MATH 18,B02,083749,Staff,0,12,30,30
1650387690765,MATH 18,B03,083750,Staff,0,11,30,30
1650387690765,MATH 18,B04,083751,Staff,0,9,30,30
1650387696788,MATH 20A,A01,083754,Staff,26,0,40,14
1650387702832,MATH 20B,A01,083756,Staff,0,8,30,30
1650387702832,MATH 20B,A02,083757,Staff,0,8,30,30
1650387708864,MATH 20C,A01,083760,Staff,0,14,30,30
1650387708864,MATH 20C,A02,083761,Staff,0,15,30,30
1650387708864,MATH 20C,B01,083762,Staff,13,0,30,17
1650387708864,MATH 20C,B02,083763,Staff,28,0,30,2
1650387714890,MATH 20D,A01,083765,Staff,0,1,30,30
1650387714890,MATH 20D,A02,083766,Staff,7,0,30,23
1650387714890,MATH 20D,A03,083767,Staff,26,0,30,4
1650387720915,MATH 20E,A01,083771,Staff,5,0,30,25
1650387720915,MATH 20E,A02,083772,Staff,19,0,30,11
1650387720915,MATH 20E,B01,083773,Staff,0,0,30,30
1650387720915,MATH 20E,B02,083774,Staff,12,0,30,18
1650387726959,MATH 103A,A01,083777,Staff,0,11,30,30
1650387726959,MATH 103A,A02,083778,Staff,0,12,30,30
1650387726959,MATH 103A,B01,083779,Staff,0,13,30,30
1650387726959,MATH 103A,B02,083780,Staff,0,11,30,30
1650387732986,MATH 105,A01,085443,Staff,0,21,30,30
1650387739014,MATH 109,A01,083213,Anzaldo; Leesa B,0,6,30,30
1650387739014,MATH 109,A02,083214,Anzaldo; Leesa B,0,7,30,30
1650387739014,MATH 109,B01,083215,Anzaldo; Leesa B,0,5,30,30
1650387739014,MATH 109,B02,083216,Anzaldo; Leesa B,0,5,30,30
1650387745041,MATH 142A,A01,083219,Chow; Bennett,0,14,30,30
1650387745041,MATH 142A,A02,083220,Chow; Bennett,0,13,30,30
1650387745041,MATH 142A,B01,083221,Chow; Bennett,0,12,30,30
1650387745041,MATH 142A,B02,083222,Chow; Bennett,0,12,30,30
1650387751071,MATH 193A,A01,083224,Staff,0,5,30,30
1650387751071,MATH 193A,A02,083225,Staff,0,5,30,30
1650387751071,MATH 193A,A03,083781,Staff,0,4,30,30
1650387751071,MATH 193A,A04,083782,Staff,0,4,30,30
1650387757193,MATH 197,001,091859,McAuley; Julian John,9998,0,9999,1
1650387763246,COGS 9,A01,083615,Staff,0,14,60,60
1650387769270,COGS 11,A01,083617,Boyle; Mary E. T.,22,0,40,18
1650387775296,COGS 13,A01,083071,Staff,0,33,40,40
1650387781330,COGS 14A,A01,092681,Staff,0,22,100,100
1650387787355,COGS 14B,A01,083073,Cheng; Tzu-Han,0,10,50,50
1650387793380,COGS 17,A01,092677,Staff,24,0,75,51
1650387799409,COGS 100,A01,083619,Staff,0,24,60,60
1650387805434,COGS 101A,A01,083621,Davis; Joshua Daniel,0,21,60,60
1650387811457,COGS 101B,A01,091572,Staff,0,0,60,60
1650387817480,COGS 101C,A01,083625,Delgado; Tania,16,0,30,14
1650387823504,COGS 107A,A01,083627,Boyle; Mary E. T.,0,10,60,60
1650387829527,COGS 118A,A01,083075,Staff,4,0,60,56
1650387835565,CSE 3,A50,083646,Miranda; Gregory Joseph,21,0,38,17
1650387835565,CSE 3,A51,083647,Miranda; Gregory Joseph,37,0,37,0
1650387841589,CSE 8A,A50,083650,Miranda; Gregory Joseph,0,28,40,40
1650387847613,CSE 11,A01,083080,Cao; Yingjun,0,89,40,40
1650387853639,CSE 12,A01,083652,Staff,0,13,100,100
1650387859662,CSE 15L,A01,083654,Staff,0,1,50,50
1650387859662,CSE 15L,A02,083655,Staff,2,0,50,48
1650387866228,CSE 20,A01,083657,Staff,52,0,80,28
1650387872262,CSE 30,A01,083084,Eldon; John,0,76,40,40
1650387878288,CSE 100,A01,083659,Cao; Yingjun,0,66,50,50
1650387884326,CSE 134B,A01,083661,Powell; Thomas Allan,0,31,65,65
1650387890357,CSE 140,A01,083663,Staff,0,0,75,75
1650387896385,CSE 140L,A01,083088,Eldon; John,0,7,75,75
1650387902412,CSE 175,A01,083665,Kumar; Rakesh,8,0,25,17
1650387908439,CSE 190,A00,092507,Dubnov; Shlomo,14,0,20,6
1650387914463,ECE 45,A01,083139,Staff,0,17,40,40
1650387920490,ECE 65,A50,083695,Staff,0,5,30,30
1650387926514,ECE 109,A01,091882,Touri; Behrouz,40,0,70,30
1650387932538,ECE 180,A00,083140,Abi Samra; Nicholas Camill,24,0,30,6
1650387932538,ECE 180,B00,083141,Abi Samra; Nicholas Camill,3,0,30,27
1650387938562,MATH 10A,A01,083735,Patchell; Gregory David,7,0,30,23
1650387938562,MATH 10A,A02,083736,Patchell; Gregory David,28,0,30,2
1650387938562,MATH 10A,A03,083737,Patchell; Gregory David,25,0,30,5
1650387944592,MATH 10B,A01,083207,Staff,0,7,30,30
1650387944592,MATH 10B,A02,083208,Staff,0,7,30,30
1650387944592,MATH 10B,B01,083739,Staff,17,0,30,13
1650387944592,MATH 10B,B02,083740,Staff,28,0,30,2
1650387950622,MATH 18,A01,083743,Staff,3,0,30,27
1650387950622,MATH 18,A02,083744,Staff,27,0,30,3
1650387950622,MATH 18,A03,083745,Staff,22,0,30,8
1650387950622,MATH 18,A04,083746,Staff,27,0,30,3
1650387950622,MATH 18,B01,083748,Staff,0,11,30,30
1650387950622,MATH 18,B02,083749,Staff,0,12,30,30
1650387950622,MATH 18,B03,083750,Staff,0,11,30,30
1650387950622,MATH 18,B04,083751,Staff,0,9,30,30
1650387956659,MATH 20A,A01,083754,Staff,26,0,40,14
1650387962698,MATH 20B,A01,083756,Staff,0,8,30,30
1650387962698,MATH 20B,A02,083757,Staff,0,8,30,30
1650387968721,MATH 20C,A01,083760,Staff,0,14,30,30
1650387968721,MATH 20C,A02,083761,Staff,0,15,30,30
1650387968721,MATH 20C,B01,083762,Staff,13,0,30,17
1650387968721,MATH 20C,B02,083763,Staff,28,0,30,2
1650387974744,MATH 20D,A01,083765,Staff,0,1,30,30
1650387974744,MATH 20D,A02,083766,Staff,7,0,30,23
1650387974744,MATH 20D,A03,083767,Staff,26,0,30,4
1650387980772,MATH 20E,A01,083771,Staff,5,0,30,25
1650387980772,MATH 20E,A02,083772,Staff,19,0,30,11
1650387980772,MATH 20E,B01,083773,Staff,0,0,30,30
1650387980772,MATH 20E,B02,083774,Staff,12,0,30,18
1650387986801,MATH 103A,A01,083777,Staff,0,11,30,30
1650387986801,MATH 103A,A02,083778,Staff,0,12,30,30
1650387986801,MATH 103A,B01,083779,Staff,0,13,30,30
1650387986801,MATH 103A,B02,083780,Staff,0,11,30,30
1650387992826,MATH 105,A01,085443,Staff,0,21,30,30
1650387998859,MATH 109,A01,083213,Anzaldo; Leesa B,0,6,30,30
1650387998859,MATH 109,A02,083214,Anzaldo; Leesa B,0,7,30,30
1650387998859,MATH 109,B01,083215,Anzaldo; Leesa B,0,5,30,30
1650387998859,MATH 109,B02,083216,Anzaldo; Leesa B,0,5,30,30
1650388004898,MATH 142A,A01,083219,Chow; Bennett,0,14,30,30
1650388004898,MATH 142A,A02,083220,Chow; Bennett,0,13,30,30
1650388004898,MATH 142A,B01,083221,Chow; Bennett,0,12,30,30
1650388004898,MATH 142A,B02,083222,Chow; Bennett,0,12,30,30
1650388010927,MATH 193A,A01,083224,Staff,0,5,30,30
1650388010927,MATH 193A,A02,083225,Staff,0,5,30,30
1650388010927,MATH 193A,A03,083781,Staff,0,4,30,30
1650388010927,MATH 193A,A04,083782,Staff,0,4,30,30
1650388016955,MATH 197,001,091859,McAuley; Julian John,9998,0,9999,1
1650388023019,COGS 9,A01,083615,Staff,0,14,60,60
1650388029048,COGS 11,A01,083617,Boyle; Mary E. T.,22,0,40,18
1650388035071,COGS 13,A01,083071,Staff,0,33,40,40
1650388041094,COGS 14A,A01,092681,Staff,0,22,100,100
1650388047124,COGS 14B,A01,083073,Cheng; Tzu-Han,0,10,50,50
1650388053157,COGS 17,A01,092677,Staff,24,0,75,51
1650388059187,COGS 100,A01,083619,Staff,0,24,60,60
1650388065217,COGS 101A,A01,083621,Davis; Joshua Daniel,0,21,60,60
1650388071241,COGS 101B,A01,091572,Staff,0,0,60,60
1650388077268,COGS 101C,A01,083625,Delgado; Tania,16,0,30,14
1650388083295,COGS 107A,A01,083627,Boyle; Mary E. T.,0,10,60,60
1650388089319,COGS 118A,A01,083075,Staff,4,0,60,56
1650388095344,CSE 3,A50,083646,Miranda; Gregory Joseph,21,0,38,17
1650388095344,CSE 3,A51,083647,Miranda; Gregory Joseph,37,0,37,0
1650388101387,CSE 8A,A50,083650,Miranda; Gregory Joseph,0,28,40,40
1650388107423,CSE 11,A01,083080,Cao; Yingjun,0,89,40,40
1650388113447,CSE 12,A01,083652,Staff,0,13,100,100
1650388119471,CSE 15L,A01,083654,Staff,0,1,50,50
1650388119471,CSE 15L,A02,083655,Staff,2,0,50,48
1650388125502,CSE 20,A01,083657,Staff,52,0,80,28
1650388131525,CSE 30,A01,083084,Eldon; John,0,76,40,40
1650388137556,CSE 100,A01,083659,Cao; Yingjun,0,66,50,50
1650388143587,CSE 134B,A01,083661,Powell; Thomas Allan,0,31,65,65
1650388149610,CSE 140,A01,083663,Staff,0,0,75,75
1650388155635,CSE 140L,A01,083088,Eldon; John,0,7,75,75
1650388161659,CSE 175,A01,083665,Kumar; Rakesh,8,0,25,17
1650388167696,CSE 190,A00,092507,Dubnov; Shlomo,14,0,20,6
1650388173723,ECE 45,A01,083139,Staff,0,17,40,40
1650388179753,ECE 65,A50,083695,Staff,0,5,30,30
1650388185783,ECE 109,A01,091882,Touri; Behrouz,40,0,70,30
1650388191817,ECE 180,A00,083140,Abi Samra; Nicholas Camill,24,0,30,6
1650388191817,ECE 180,B00,083141,Abi Samra; Nicholas Camill,3,0,30,27
1650388197848,MATH 10A,A01,083735,Patchell; Gregory David,7,0,30,23
1650388197848,MATH 10A,A02,083736,Patchell; Gregory David,28,0,30,2
1650388197848,MATH 10A,A03,083737,Patchell; Gregory David,25,0,30,5
1650388203888,MATH 10B,A01,083207,Staff,0,7,30,30
1650388203888,MATH 10B,A02,083208,Staff,0,7,30,30
1650388203888,MATH 10B,B01,083739,Staff,17,0,30,13
1650388203888,MATH 10B,B02,083740,Staff,28,0,30,2
1650388209915,MATH 18,A01,083743,Staff,3,0,30,27
1650388209915,MATH 18,A02,083744,Staff,27,0,30,3
1650388209915,MATH 18,A03,083745,Staff,22,0,30,8
1650388209915,MATH 18,A04,083746,Staff,27,0,30,3
1650388209915,MATH 18,B01,083748,Staff,0,11,30,30
1650388209915,MATH 18,B02,083749,Staff,0,12,30,30
1650388209915,MATH 18,B03,083750,Staff,0,11,30,30
1650388209915,MATH 18,B04,083751,Staff,0,9,30,30
1650388215939,MATH 20A,A01,083754,Staff,26,0,40,14
1650388221966,MATH 20B,A01,083756,Staff,0,8,30,30
1650388221966,MATH 20B,A02,083757,Staff,0,8,30,30
1650388227991,MATH 20C,A01,083760,Staff,0,14,30,30
1650388227991,MATH 20C,A02,083761,Staff,0,15,30,30
1650388227991,MATH 20C,B01,083762,Staff,13,0,30,17
1650388227991,MATH 20C,B02,083763,Staff,28,0,30,2
1650388234014,MATH 20D,A01,083765,Staff,0,1,30,30
1650388234014,MATH 20D,A02,083766,Staff,7,0,30,23
1650388234014,MATH 20D,A03,083767,Staff,26,0,30,4
1650388240045,MATH 20E,A01,083771,Staff,5,0,30,25
1650388240045,MATH 20E,A02,083772,Staff,19,0,30,11
1650388240045,MATH 20E,B01,083773,Staff,0,0,30,30
1650388240045,MATH 20E,B02,083774,Staff,12,0,30,18
1650388246072,MATH 103A,A01,083777,Staff,0,11,30,30
1650388246072,MATH 103A,A02,083778,Staff,0,12,30,30
1650388246072,MATH 103A,B01,083779,Staff,0,13,30,30
1650388246072,MATH 103A,B02,083780,Staff,0,11,30,30
1650388252100,MATH 105,A01,085443,Staff,0,21,30,30
1650388258124,MATH 109,A01,083213,Anzaldo; Leesa B,0,6,30,30
1650388258124,MATH 109,A02,083214,Anzaldo; Leesa B,0,7,30,30
1650388258124,MATH 109,B01,083215,Anzaldo; Leesa B,0,5,30,30
1650388258124,MATH 109,B02,083216,Anzaldo; Leesa B,0,5,30,30
1650388264153,MATH 142A,A01,083219,Chow; Bennett,0,14,30,30
1650388264153,MATH 142A,A02,083220,Chow; Bennett,0,13,30,30
1650388264153,MATH 142A,B01,083221,Chow; Bennett,0,12,30,30
1650388264153,MATH 142A,B02,083222,Chow; Bennett,0,12,30,30
1650388270178,MATH 193A,A01,083224,Staff,0,5,30,30
1650388270178,MATH 193A,A02,083225,Staff,0,5,30,30
1650388270178,MATH 193A,A03,083781,Staff,0,4,30,30
1650388270178,MATH 193A,A04,083782,Staff,0,4,30,30
1650388276213,MATH 197,001,091859,McAuley; Julian John,9998,0,9999,1
1650388282275,COGS 9,A01,083615,Staff,0,14,60,60
1650388288298,COGS 11,A01,083617,Boyle; Mary E. T.,22,0,40,18
1650388294325,COGS 13,A01,083071,Staff,0,33,40,40
1650388300351,COGS 14A,A01,092681,Staff,0,22,100,100
1650388306385,COGS 14B,A01,083073,Cheng; Tzu-Han,0,10,50,50
1650388312409,COGS 17,A01,092677,Staff,24,0,75,51
1650388318433,COGS 100,A01,083619,Staff,0,24,60,60
1650388324460,COGS 101A,A01,083621,Davis; Joshua Daniel,0,21,60,60
1650388330492,COGS 101B,A01,091572,Staff,0,0,60,60
1650388336519,COGS 101C,A01,083625,Delgado; Tania,16,0,30,14
1650388342546,COGS 107A,A01,083627,Boyle; Mary E. T.,0,10,60,60
1650388348658,COGS 118A,A01,083075,Staff,4,0,60,56
1650388354695,CSE 3,A50,083646,Miranda; Gregory Joseph,21,0,38,17
1650388354695,CSE 3,A51,083647,Miranda; Gregory Joseph,37,0,37,0
1650388360732,CSE 8A,A50,083650,Miranda; Gregory Joseph,0,28,40,40
1650388366761,CSE 11,A01,083080,Cao; Yingjun,0,89,40,40
1650388372784,CSE 12,A01,083652,Staff,0,13,100,100
1650388378808,CSE 15L,A01,083654,Staff,0,1,50,50
1650388378808,CSE 15L,A02,083655,Staff,2,0,50,48
1650388384838,CSE 20,A01,083657,Staff,52,0,80,28
1650388390865,CSE 30,A01,083084,Eldon; John,0,76,40,40
1650388396894,CSE 100,A01,083659,Cao; Yingjun,0,66,50,50
1650388402924,CSE 134B,A01,083661,Powell; Thomas Allan,0,31,65,65
1650388408951,CSE 140,A01,083663,Staff,0,0,75,75
1650388414980,CSE 140L,A01,083088,Eldon; John,0,7,75,75
1650388421003,CSE 175,A01,083665,Kumar; Rakesh,8,0,25,17
1650388427028,CSE 190,A00,092507,Dubnov; Shlomo,14,0,20,6
1650388433051,ECE 45,A01,083139,Staff,0,17,40,40
1650388439079,ECE 65,A50,083695,Staff,0,5,30,30
1650388445104,ECE 109,A01,091882,Touri; Behrouz,40,0,70,30
1650388451127,ECE 180,A00,083140,Abi Samra; Nicholas Camill,24,0,30,6
1650388451127,ECE 180,B00,083141,Abi Samra; Nicholas Camill,3,0,30,27
1650388457155,MATH 10A,A01,083735,Patchell; Gregory David,7,0,30,23
1650388457155,MATH 10A,A02,083736,Patchell; Gregory David,28,0,30,2
1650388457155,MATH 10A,A03,083737,Patchell; Gregory David,25,0,30,5
1650388463183,MATH 10B,A01,083207,Staff,0,7,30,30
1650388463183,MATH 10B,A02,083208,Staff,0,7,30,30
1650388463183,MATH 10B,B01,083739,Staff,17,0,30,13
1650388463183,MATH 10B,B02,083740,Staff,28,0,30,2
1650388469219,MATH 18,A01,083743,Staff,3,0,30,27
1650388469219,MATH 18,A02,083744,Staff,27,0,30,3
1650388469219,MATH 18,A03,083745,Staff,22,0,30,8
1650388469219,MATH 18,A04,083746,Staff,27,0,30,3
1650388469219,MATH 18,B01,083748,Staff,0,11,30,30
1650388469219,MATH 18,B02,083749,Staff,0,12,30,30
1650388469219,MATH 18,B03,083750,Staff,0,11,30,30
1650388469219,MATH 18,B04,083751,Staff,0,9,30,30
1650388475246,MATH 20A,A01,083754,Staff,26,0,40,14
1650388481278,MATH 20B,A01,083756,Staff,0,8,30,30
1650388481278,MATH 20B,A02,083757,Staff,0,8,30,30
1650388487303,MATH 20C,A01,083760,Staff,0,14,30,30
1650388487303,MATH 20C,A02,083761,Staff,0,15,30,30
1650388487303,MATH 20C,B01,083762,Staff,13,0,30,17
1650388487303,MATH 20C,B02,083763,Staff,28,0,30,2
1650388493326,MATH 20D,A01,083765,Staff,0,1,30,30
1650388493326,MATH 20D,A02,083766,Staff,7,0,30,23
1650388493326,MATH 20D,A03,083767,Staff,26,0,30,4
1650388499353,MATH 20E,A01,083771,Staff,5,0,30,25
1650388499353,MATH 20E,A02,083772,Staff,19,0,30,11
1650388499353,MATH 20E,B01,083773,Staff,0,0,30,30
1650388499353,MATH 20E,B02,083774,Staff,12,0,30,18
1650388505396,MATH 103A,A01,083777,Staff,0,11,30,30
1650388505396,MATH 103A,A02,083778,Staff,0,12,30,30
1650388505396,MATH 103A,B01,083779,Staff,0,13,30,30
1650388505396,MATH 103A,B02,083780,Staff,0,11,30,30
1650388511419,MATH 105,A01,085443,Staff,0,21,30,30
1650388517464,MATH 109,A01,083213,Anzaldo; Leesa B,0,6,30,30
1650388517464,MATH 109,A02,083214,Anzaldo; Leesa B,0,7,30,30
1650388517464,MATH 109,B01,083215,Anzaldo; Leesa B,0,5,30,30
1650388517464,MATH 109,B02,083216,Anzaldo; Leesa B,0,5,30,30
1650388523504,MATH 142A,A01,083219,Chow; Bennett,0,14,30,30
1650388523504,MATH 142A,A02,083220,Chow; Bennett,0,13,30,30
1650388523504,MATH 142A,B01,083221,Chow; Bennett,0,12,30,30
1650388523504,MATH 142A,B02,083222,Chow; Bennett,0,12,30,30
1650388529532,MATH 193A,A01,083224,Staff,0,5,30,30
1650388529532,MATH 193A,A02,083225,Staff,0,5,30,30
1650388529532,MATH 193A,A03,083781,Staff,0,4,30,30
1650388529532,MATH 193A,A04,083782,Staff,0,4,30,30
1650388535568,MATH 197,001,091859,McAuley; Julian John,9998,0,9999,1
1650388541625,COGS 9,A01,083615,Staff,0,14,60,60
1650388547667,COGS 11,A01,083617,Boyle; Mary E. T.,22,0,40,18
1650388553690,COGS 13,A01,083071,Staff,0,33,40,40
1650388559716,COGS 14A,A01,092681,Staff,0,22,100,100
1650388565755,COGS 14B,A01,083073,Cheng; Tzu-Han,0,10,50,50
1650388571778,COGS 17,A01,092677,Staff,24,0,75,51
1650388577806,COGS 100,A01,083619,Staff,0,24,60,60
1650388583830,COGS 101A,A01,083621,Davis; Joshua Daniel,0,21,60,60
1650388589857,COGS 101B,A01,091572,Staff,0,0,60,60
1650388595885,COGS 101C,A01,083625,Delgado; Tania,16,0,30,14
1650388601911,COGS 107A,A01,083627,Boyle; Mary E. T.,0,10,60,60
1650388607934,COGS 118A,A01,083075,Staff,4,0,60,56
1650388613958,CSE 3,A50,083646,Miranda; Gregory Joseph,21,0,38,17
1650388613958,CSE 3,A51,083647,Miranda; Gregory Joseph,37,0,37,0
1650388619982,CSE 8A,A50,083650,Miranda; Gregory Joseph,0,28,40,40
1650388626005,CSE 11,A01,083080,Cao; Yingjun,0,89,40,40
1650388632029,CSE 12,A01,083652,Staff,0,14,100,100
1650388638055,CSE 15L,A01,083654,Staff,0,1,50,50
1650388638055,CSE 15L,A02,083655,Staff,1,0,50,49
1650388644079,CSE 20,A01,083657,Staff,52,0,80,28
1650388650116,CSE 30,A01,083084,Eldon; John,0,76,40,40
1650388656141,CSE 100,A01,083659,Cao; Yingjun,0,66,50,50
1650388662168,CSE 134B,A01,083661,Powell; Thomas Allan,0,31,65,65
1650388668192,CSE 140,A01,083663,Staff,0,0,75,75
1650388674228,CSE 140L,A01,083088,Eldon; John,0,7,75,75
1650388680249,CSE 175,A01,083665,Kumar; Rakesh,8,0,25,17
1650388686285,CSE 190,A00,092507,Dubnov; Shlomo,14,0,20,6
1650388692309,ECE 45,A01,083139,Staff,0,17,40,40
1650388698333,ECE 65,A50,083695,Staff,0,5,30,30
1650388704368,ECE 109,A01,091882,Touri; Behrouz,40,0,70,30
1650388710394,ECE 180,A00,083140,Abi Samra; Nicholas Camill,24,0,30,6
1650388710394,ECE 180,B00,083141,Abi Samra; Nicholas Camill,3,0,30,27
1650388716418,MATH 10A,A01,083735,Patchell; Gregory David,7,0,30,23
1650388716418,MATH 10A,A02,083736,Patchell; Gregory David,28,0,30,2
1650388716418,MATH 10A,A03,083737,Patchell; Gregory David,25,0,30,5
1650388722441,MATH 10B,A01,083207,Staff,0,7,30,30
1650388722441,MATH 10B,A02,083208,Staff,0,7,30,30
1650388722441,MATH 10B,B01,083739,Staff,17,0,30,13
1650388722441,MATH 10B,B02,083740,Staff,28,0,30,2
1650388728472,MATH 18,A01,083743,Staff,3,0,30,27
1650388728472,MATH 18,A02,083744,Staff,27,0,30,3
1650388728472,MATH 18,A03,083745,Staff,22,0,30,8
1650388728472,MATH 18,A04,083746,Staff,27,0,30,3
1650388728472,MATH 18,B01,083748,Staff,0,11,30,30
1650388728472,MATH 18,B02,083749,Staff,0,12,30,30
1650388728472,MATH 18,B03,083750,Staff,0,11,30,30
1650388728472,MATH 18,B04,083751,Staff,0,9,30,30
1650388734497,MATH 20A,A01,083754,Staff,26,0,40,14
1650388740532,MATH 20B,A01,083756,Staff,0,8,30,30
1650388740532,MATH 20B,A02,083757,Staff,0,8,30,30
1650388746553,MATH 20C,A01,083760,Staff,0,14,30,30
1650388746553,MATH 20C,A02,083761,Staff,0,15,30,30
1650388746553,MATH 20C,B01,083762,Staff,13,0,30,17
1650388746553,MATH 20C,B02,083763,Staff,28,0,30,2
1650388752576,MATH 20D,A01,083765,Staff,0,1,30,30
1650388752576,MATH 20D,A02,083766,Staff,7,0,30,23
1650388752576,MATH 20D,A03,083767,Staff,26,0,30,4
1650388758602,MATH 20E,A01,083771,Staff,5,0,30,25
1650388758602,MATH 20E,A02,083772,Staff,19,0,30,11
1650388758602,MATH 20E,B01,083773,Staff,0,0,30,30
1650388758602,MATH 20E,B02,083774,Staff,12,0,30,18
1650388764631,MATH 103A,A01,083777,Staff,0,11,30,30
1650388764631,MATH 103A,A02,083778,Staff,0,12,30,30
1650388764631,MATH 103A,B01,083779,Staff,0,13,30,30
1650388764631,MATH 103A,B02,083780,Staff,0,11,30,30
1650388770654,MATH 105,A01,085443,Staff,0,21,30,30
1650388776682,MATH 109,A01,083213,Anzaldo; Leesa B,0,6,30,30
1650388776682,MATH 109,A02,083214,Anzaldo; Leesa B,0,7,30,30
1650388776682,MATH 109,B01,083215,Anzaldo; Leesa B,0,5,30,30
1650388776682,MATH 109,B02,083216,Anzaldo; Leesa B,0,5,30,30
1650388782717,MATH 142A,A01,083219,Chow; Bennett,0,14,30,30
1650388782717,MATH 142A,A02,083220,Chow; Bennett,0,13,30,30
1650388782717,MATH 142A,B01,083221,Chow; Bennett,0,12,30,30
1650388782717,MATH 142A,B02,083222,Chow; Bennett,0,12,30,30
1650388788744,MATH 193A,A01,083224,Staff,0,5,30,30
1650388788744,MATH 193A,A02,083225,Staff,0,5,30,30
1650388788744,MATH 193A,A03,083781,Staff,0,4,30,30
1650388788744,MATH 193A,A04,083782,Staff,0,4,30,30
1650388794771,MATH 197,001,091859,McAuley; Julian John,9998,0,9999,1
1650388800831,COGS 9,A01,083615,Staff,0,14,60,60
1650388806858,COGS 11,A01,083617,Boyle; Mary E. T.,22,0,40,18
1650388812883,COGS 13,A01,083071,Staff,0,33,40,40
1650388818911,COGS 14A,A01,092681,Staff,0,23,100,100
1650388824948,COGS 14B,A01,083073,Cheng; Tzu-Han,0,10,50,50
1650388830975,COGS 17,A01,092677,Staff,24,0,75,51
1650388837008,COGS 100,A01,083619,Staff,0,24,60,60
1650388843046,COGS 101A,A01,083621,Davis; Joshua Daniel,0,21,60,60
1650388849071,COGS 101B,A01,091572,Staff,0,1,60,60
1650388855095,COGS 101C,A01,083625,Delgado; Tania,16,0,30,14
1650388861130,COGS 107A,A01,083627,Boyle; Mary E. T.,0,10,60,60
1650388867158,COGS 118A,A01,083075,Staff,4,0,60,56
1650388873189,CSE 3,A50,083646,Miranda; Gregory Joseph,21,0,38,17
1650388873189,CSE 3,A51,083647,Miranda; Gregory Joseph,37,0,37,0
1650388879217,CSE 8A,A50,083650,Miranda; Gregory Joseph,0,28,40,40
1650388885244,CSE 11,A01,083080,Cao; Yingjun,0,89,40,40
1650388891267,CSE 12,A01,083652,Staff,0,14,100,100
1650388897291,CSE 15L,A01,083654,Staff,0,1,50,50
1650388897291,CSE 15L,A02,083655,Staff,1,0,50,49
1650388903314,CSE 20,A01,083657,Staff,52,0,80,28
1650388909339,CSE 30,A01,083084,Eldon; John,0,76,40,40
1650388915363,CSE 100,A01,083659,Cao; Yingjun,0,66,50,50
1650388921388,CSE 134B,A01,083661,Powell; Thomas Allan,0,31,65,65
1650388927414,CSE 140,A01,083663,Staff,0,0,75,75
1650388933438,CSE 140L,A01,083088,Eldon; John,0,7,75,75
1650388939462,CSE 175,A01,083665,Kumar; Rakesh,8,0,25,17
1650388945593,CSE 190,A00,092507,Dubnov; Shlomo,14,0,20,6
1650388951617,ECE 45,A01,083139,Staff,0,17,40,40
1650388957643,ECE 65,A50,083695,Staff,0,5,30,30
1650388963667,ECE 109,A01,091882,Touri; Behrouz,40,0,70,30
1650388969694,ECE 180,A00,083140,Abi Samra; Nicholas Camill,24,0,30,6
1650388969694,ECE 180,B00,083141,Abi Samra; Nicholas Camill,3,0,30,27
1650388975721,MATH 10A,A01,083735,Patchell; Gregory David,7,0,30,23
1650388975721,MATH 10A,A02,083736,Patchell; Gregory David,28,0,30,2
1650388975721,MATH 10A,A03,083737,Patchell; Gregory David,25,0,30,5
1650388981744,MATH 10B,A01,083207,Staff,0,7,30,30
1650388981744,MATH 10B,A02,083208,Staff,0,7,30,30
1650388981744,MATH 10B,B01,083739,Staff,17,0,30,13
1650388981744,MATH 10B,B02,083740,Staff,28,0,30,2
1650388987777,MATH 18,A01,083743,Staff,3,0,30,27
1650388987777,MATH 18,A02,083744,Staff,27,0,30,3
1650388987777,MATH 18,A03,083745,Staff,22,0,30,8
1650388987777,MATH 18,A04,083746,Staff,27,0,30,3
1650388987777,MATH 18,B01,083748,Staff,0,11,30,30
1650388987777,MATH 18,B02,083749,Staff,0,12,30,30
1650388987777,MATH 18,B03,083750,Staff,0,11,30,30
1650388987777,MATH 18,B04,083751,Staff,0,9,30,30
1650388993806,MATH 20A,A01,083754,Staff,26,0,40,14
1650388999830,MATH 20B,A01,083756,Staff,0,8,30,30
1650388999830,MATH 20B,A02,083757,Staff,0,8,30,30
1650389005866,MATH 20C,A01,083760,Staff,0,14,30,30
1650389005866,MATH 20C,A02,083761,Staff,0,15,30,30
1650389005866,MATH 20C,B01,083762,Staff,13,0,30,17
1650389005866,MATH 20C,B02,083763,Staff,28,0,30,2
1650389011900,MATH 20D,A01,083765,Staff,0,1,30,30
1650389011900,MATH 20D,A02,083766,Staff,7,0,30,23
1650389011900,MATH 20D,A03,083767,Staff,26,0,30,4
1650389017925,MATH 20E,A01,083771,Staff,5,0,30,25
1650389017925,MATH 20E,A02,083772,Staff,19,0,30,11
1650389017925,MATH 20E,B01,083773,Staff,0,0,30,30
1650389017925,MATH 20E,B02,083774,Staff,12,0,30,18
1650389023956,MATH 103A,A01,083777,Staff,0,11,30,30
1650389023956,MATH 103A,A02,083778,Staff,0,12,30,30
1650389023956,MATH 103A,B01,083779,Staff,0,13,30,30
1650389023956,MATH 103A,B02,083780,Staff,0,11,30,30
1650389029980,MATH 105,A01,085443,Staff,0,21,30,30
1650389036008,MATH 109,A01,083213,Anzaldo; Leesa B,0,6,30,30
1650389036008,MATH 109,A02,083214,Anzaldo; Leesa B,0,7,30,30
1650389036008,MATH 109,B01,083215,Anzaldo; Leesa B,0,5,30,30
1650389036008,MATH 109,B02,083216,Anzaldo; Leesa B,0,5,30,30
1650389042034,MATH 142A,A01,083219,Chow; Bennett,0,14,30,30
1650389042034,MATH 142A,A02,083220,Chow; Bennett,0,13,30,30
1650389042034,MATH 142A,B01,083221,Chow; Bennett,0,12,30,30
1650389042034,MATH 142A,B02,083222,Chow; Bennett,0,12,30,30
1650389048074,MATH 193A,A01,083224,Staff,0,5,30,30
1650389048074,MATH 193A,A02,083225,Staff,0,5,30,30
1650389048074,MATH 193A,A03,083781,Staff,0,4,30,30
1650389048074,MATH 193A,A04,083782,Staff,0,4,30,30
1650389054098,MATH 197,001,091859,McAuley; Julian John,9998,0,9999,1
1650389060168,COGS 9,A01,083615,Staff,0,14,60,60
1650389066192,COGS 11,A01,083617,Boyle; Mary E. T.,22,0,40,18
1650389072221,COGS 13,A01,083071,Staff,0,33,40,40
1650389078245,COGS 14A,A01,092681,Staff,0,23,100,100
1650389084270,COGS 14B,A01,083073,Cheng; Tzu-Han,0,10,50,50
1650389090303,COGS 17,A01,092677,Staff,24,0,75,51
1650389096327,COGS 100,A01,083619,Staff,0,24,60,60
1650389102352,COGS 101A,A01,083621,Davis; Joshua Daniel,0,21,60,60
1650389108383,COGS 101B,A01,091572,Staff,0,1,60,60
1650389114407,COGS 101C,A01,083625,Delgado; Tania,16,0,30,14
1650389120431,COGS 107A,A01,083627,Boyle; Mary E. T.,0,10,60,60
1650389126456,COGS 118A,A01,083075,Staff,4,0,60,56
1650389132483,CSE 3,A50,083646,Miranda; Gregory Joseph,21,0,38,17
1650389132483,CSE 3,A51,083647,Miranda; Gregory Joseph,37,0,37,0
1650389138511,CSE 8A,A50,083650,Miranda; Gregory Joseph,0,28,40,40
1650389144542,CSE 11,A01,083080,Cao; Yingjun,0,89,40,40
1650389150567,CSE 12,A01,083652,Staff,0,14,100,100
1650389156600,CSE 15L,A01,083654,Staff,0,1,50,50
1650389156600,CSE 15L,A02,083655,Staff,1,0,50,49
1650389162624,CSE 20,A01,083657,Staff,52,0,80,28
1650389168653,CSE 30,A01,083084,Eldon; John,0,76,40,40
1650389174685,CSE 100,A01,083659,Cao; Yingjun,0,66,50,50
1650389180718,CSE 134B,A01,083661,Powell; Thomas Allan,0,31,65,65
1650389186744,CSE 140,A01,083663,Staff,0,0,75,75
1650389192775,CSE 140L,A01,083088,Eldon; John,0,7,75,75
1650389198800,CSE 175,A01,083665,Kumar; Rakesh,8,0,25,17
1650389204833,CSE 190,A00,092507,Dubnov; Shlomo,14,0,20,6
1650389210858,ECE 45,A01,083139,Staff,0,17,40,40
1650389216880,ECE 65,A50,083695,Staff,0,5,30,30
1650389222910,ECE 109,A01,091882,Touri; Behrouz,40,0,70,30
1650389228933,ECE 180,A00,083140,Abi Samra; Nicholas Camill,24,0,30,6
1650389228933,ECE 180,B00,083141,Abi Samra; Nicholas Camill,3,0,30,27
1650389234957,MATH 10A,A01,083735,Patchell; Gregory David,7,0,30,23
1650389234957,MATH 10A,A02,083736,Patchell; Gregory David,28,0,30,2
1650389234957,MATH 10A,A03,083737,Patchell; Gregory David,25,0,30,5
1650389240981,MATH 10B,A01,083207,Staff,0,7,30,30
1650389240981,MATH 10B,A02,083208,Staff,0,7,30,30
1650389240981,MATH 10B,B01,083739,Staff,17,0,30,13
1650389240981,MATH 10B,B02,083740,Staff,28,0,30,2
1650389247006,MATH 18,A01,083743,Staff,3,0,30,27
1650389247006,MATH 18,A02,083744,Staff,27,0,30,3
1650389247006,MATH 18,A03,083745,Staff,22,0,30,8
1650389247006,MATH 18,A04,083746,Staff,27,0,30,3
1650389247006,MATH 18,B01,083748,Staff,0,11,30,30
1650389247006,MATH 18,B02,083749,Staff,0,12,30,30
1650389247006,MATH 18,B03,083750,Staff,0,11,30,30
1650389247006,MATH 18,B04,083751,Staff,0,9,30,30
1650389253037,MATH 20A,A01,083754,Staff,26,0,40,14
1650389259070,MATH 20B,A01,083756,Staff,0,8,30,30
1650389259070,MATH 20B,A02,083757,Staff,0,8,30,30
1650389265110,MATH 20C,A01,083760,Staff,0,14,30,30
1650389265110,MATH 20C,A02,083761,Staff,0,15,30,30
1650389265110,MATH 20C,B01,083762,Staff,13,0,30,17
1650389265110,MATH 20C,B02,083763,Staff,28,0,30,2
1650389271138,MATH 20D,A01,083765,Staff,0,1,30,30
1650389271138,MATH 20D,A02,083766,Staff,7,0,30,23
1650389271138,MATH 20D,A03,083767,Staff,26,0,30,4
1650389277165,MATH 20E,A01,083771,Staff,5,0,30,25
1650389277165,MATH 20E,A02,083772,Staff,19,0,30,11
1650389277165,MATH 20E,B01,083773,Staff,0,0,30,30
1650389277165,MATH 20E,B02,083774,Staff,12,0,30,18
1650389283198,MATH 103A,A01,083777,Staff,0,11,30,30
1650389283198,MATH 103A,A02,083778,Staff,0,12,30,30
1650389283198,MATH 103A,B01,083779,Staff,0,13,30,30
1650389283198,MATH 103A,B02,083780,Staff,0,11,30,30
1650389289220,MATH 105,A01,085443,Staff,0,21,30,30
1650389295245,MATH 109,A01,083213,Anzaldo; Leesa B,0,6,30,30
1650389295245,MATH 109,A02,083214,Anzaldo; Leesa B,0,7,30,30
1650389295245,MATH 109,B01,083215,Anzaldo; Leesa B,0,5,30,30
1650389295245,MATH 109,B02,083216,Anzaldo; Leesa B,0,5,30,30
1650389301275,MATH 142A,A01,083219,Chow; Bennett,0,14,30,30
1650389301275,MATH 142A,A02,083220,Chow; Bennett,0,13,30,30
1650389301275,MATH 142A,B01,083221,Chow; Bennett,0,12,30,30
1650389301275,MATH 142A,B02,083222,Chow; Bennett,0,12,30,30
1650389307314,MATH 193A,A01,083224,Staff,0,5,30,30
1650389307314,MATH 193A,A02,083225,Staff,0,5,30,30
1650389307314,MATH 193A,A03,083781,Staff,0,4,30,30
1650389307314,MATH 193A,A04,083782,Staff,0,4,30,30
1650389313335,MATH 197,001,091859,McAuley; Julian John,9998,0,9999,1
1650389319387,COGS 9,A01,083615,Staff,0,14,60,60
1650389325413,COGS 11,A01,083617,Boyle; Mary E. T.,22,0,40,18
1650389331439,COGS 13,A01,083071,Staff,0,33,40,40
1650389337466,COGS 14A,A01,092681,Staff,0,23,100,100
1650389343499,COGS 14B,A01,083073,Cheng; Tzu-Han,0,10,50,50
1650389349523,COGS 17,A01,092677,Staff,24,0,75,51
1650389355557,COGS 100,A01,083619,Staff,0,24,60,60
1650389361583,COGS 101A,A01,083621,Davis; Joshua Daniel,0,21,60,60
1650389367616,COGS 101B,A01,091572,Staff,0,1,60,60
1650389373642,COGS 101C,A01,083625,Delgado; Tania,16,0,30,14
1650389379670,COGS 107A,A01,083627,Boyle; Mary E. T.,0,10,60,60
1650389385701,COGS 118A,A01,083075,Staff,4,0,60,56
1650389391724,CSE 3,A50,083646,Miranda; Gregory Joseph,21,0,38,17
1650389391724,CSE 3,A51,083647,Miranda; Gregory Joseph,37,0,37,0
1650389397748,CSE 8A,A50,083650,Miranda; Gregory Joseph,0,28,40,40
1650389403783,CSE 11,A01,083080,Cao; Yingjun,0,89,40,40
1650389409810,CSE 12,A01,083652,Staff,0,14,100,100
1650389415835,CSE 15L,A01,083654,Staff,0,1,50,50
1650389415835,CSE 15L,A02,083655,Staff,1,0,50,49
1650389421858,CSE 20,A01,083657,Staff,52,0,80,28
1650389427893,CSE 30,A01,083084,Eldon; John,0,76,40,40
1650389433917,CSE 100,A01,083659,Cao; Yingjun,0,66,50,50
1650389439951,CSE 134B,A01,083661,Powell; Thomas Allan,0,31,65,65
1650389445975,CSE 140,A01,083663,Staff,0,0,75,75
1650389452000,CSE 140L,A01,083088,Eldon; John,0,7,75,75
1650389458033,CSE 175,A01,083665,Kumar; Rakesh,8,0,25,17
1650389464065,CSE 190,A00,092507,Dubnov; Shlomo,14,0,20,6
1650389470088,ECE 45,A01,083139,Staff,0,17,40,40
1650389476118,ECE 65,A50,083695,Staff,0,5,30,30
1650389482144,ECE 109,A01,091882,Touri; Behrouz,40,0,70,30
1650389488170,ECE 180,A00,083140,Abi Samra; Nicholas Camill,24,0,30,6
1650389488170,ECE 180,B00,083141,Abi Samra; Nicholas Camill,3,0,30,27
1650389494193,MATH 10A,A01,083735,Patchell; Gregory David,7,0,30,23
1650389494193,MATH 10A,A02,083736,Patchell; Gregory David,28,0,30,2
1650389494193,MATH 10A,A03,083737,Patchell; Gregory David,25,0,30,5
1650389500226,MATH 10B,A01,083207,Staff,0,7,30,30
1650389500226,MATH 10B,A02,083208,Staff,0,7,30,30
1650389500226,MATH 10B,B01,083739,Staff,17,0,30,13
1650389500226,MATH 10B,B02,083740,Staff,28,0,30,2
1650389506264,MATH 18,A01,083743,Staff,3,0,30,27
1650389506264,MATH 18,A02,083744,Staff,27,0,30,3
1650389506264,MATH 18,A03,083745,Staff,22,0,30,8
1650389506264,MATH 18,A04,083746,Staff,27,0,30,3
1650389506264,MATH 18,B01,083748,Staff,0,11,30,30
1650389506264,MATH 18,B02,083749,Staff,0,12,30,30
1650389506264,MATH 18,B03,083750,Staff,0,11,30,30
1650389506264,MATH 18,B04,083751,Staff,0,9,30,30
1650389512294,MATH 20A,A01,083754,Staff,26,0,40,14
1650389518321,MATH 20B,A01,083756,Staff,0,8,30,30
1650389518321,MATH 20B,A02,083757,Staff,0,8,30,30
1650389524349,MATH 20C,A01,083760,Staff,0,14,30,30
1650389524349,MATH 20C,A02,083761,Staff,0,15,30,30
1650389524349,MATH 20C,B01,083762,Staff,13,0,30,17
1650389524349,MATH 20C,B02,083763,Staff,28,0,30,2
1650389530376,MATH 20D,A01,083765,Staff,0,1,30,30
1650389530376,MATH 20D,A02,083766,Staff,7,0,30,23
1650389530376,MATH 20D,A03,083767,Staff,26,0,30,4
1650389536403,MATH 20E,A01,083771,Staff,5,0,30,25
1650389536403,MATH 20E,A02,083772,Staff,19,0,30,11
1650389536403,MATH 20E,B01,083773,Staff,0,0,30,30
1650389536403,MATH 20E,B02,083774,Staff,12,0,30,18
1650389542515,MATH 103A,A01,083777,Staff,0,11,30,30
1650389542515,MATH 103A,A02,083778,Staff,0,12,30,30
1650389542515,MATH 103A,B01,083779,Staff,0,13,30,30
1650389542515,MATH 103A,B02,083780,Staff,0,11,30,30
1650389548542,MATH 105,A01,085443,Staff,0,21,30,30
1650389554564,MATH 109,A01,083213,Anzaldo; Leesa B,0,6,30,30
1650389554564,MATH 109,A02,083214,Anzaldo; Leesa B,0,7,30,30
1650389554564,MATH 109,B01,083215,Anzaldo; Leesa B,0,5,30,30
1650389554564,MATH 109,B02,083216,Anzaldo; Leesa B,0,5,30,30
1650389560590,MATH 142A,A01,083219,Chow; Bennett,0,14,30,30
1650389560590,MATH 142A,A02,083220,Chow; Bennett,0,13,30,30
1650389560590,MATH 142A,B01,083221,Chow; Bennett,0,12,30,30
1650389560590,MATH 142A,B02,083222,Chow; Bennett,0,12,30,30
1650389566617,MATH 193A,A01,083224,Staff,0,5,30,30
1650389566617,MATH 193A,A02,083225,Staff,0,5,30,30
1650389566617,MATH 193A,A03,083781,Staff,0,4,30,30
1650389566617,MATH 193A,A04,083782,Staff,0,4,30,30
1650389572650,MATH 197,001,091859,McAuley; Julian John,9998,0,9999,1
1650389578713,COGS 9,A01,083615,Staff,0,14,60,60
1650389584740,COGS 11,A01,083617,Boyle; Mary E. T.,22,0,40,18
1650389590766,COGS 13,A01,083071,Staff,0,33,40,40
1650389596799,COGS 14A,A01,092681,Staff,0,23,100,100
1650389602831,COGS 14B,A01,083073,Cheng; Tzu-Han,0,10,50,50
1650389608859,COGS 17,A01,092677,Staff,24,0,75,51
1650389614884,COGS 100,A01,083619,Staff,0,24,60,60
1650389620921,COGS 101A,A01,083621,Davis; Joshua Daniel,0,21,60,60
1650389626950,COGS 101B,A01,091572,Staff,0,1,60,60
1650389632985,COGS 101C,A01,083625,Delgado; Tania,16,0,30,14
1650389639010,COGS 107A,A01,083627,Boyle; Mary E. T.,0,10,60,60
1650389645033,COGS 118A,A01,083075,Staff,4,0,60,56
1650389651056,CSE 3,A50,083646,Miranda; Gregory Joseph,21,0,38,17
1650389651056,CSE 3,A51,083647,Miranda; Gregory Joseph,37,0,37,0
1650389657092,CSE 8A,A50,083650,Miranda; Gregory Joseph,0,28,40,40
1650389663120,CSE 11,A01,083080,Cao; Yingjun,0,89,40,40
1650389669145,CSE 12,A01,083652,Staff,0,14,100,100
1650389675171,CSE 15L,A01,083654,Staff,0,1,50,50
1650389675171,CSE 15L,A02,083655,Staff,1,0,50,49
1650389681196,CSE 20,A01,083657,Staff,52,0,80,28
1650389687219,CSE 30,A01,083084,Eldon; John,0,76,40,40
1650389693241,CSE 100,A01,083659,Cao; Yingjun,0,66,50,50
1650389699266,CSE 134B,A01,083661,Powell; Thomas Allan,0,31,65,65
1650389705289,CSE 140,A01,083663,Staff,0,0,75,75
1650389711316,CSE 140L,A01,083088,Eldon; John,0,7,75,75
1650389717339,CSE 175,A01,083665,Kumar; Rakesh,8,0,25,17
1650389723365,CSE 190,A00,092507,Dubnov; Shlomo,14,0,20,6
1650389729388,ECE 45,A01,083139,Staff,0,17,40,40
1650389735411,ECE 65,A50,083695,Staff,0,5,30,30
1650389741441,ECE 109,A01,091882,Touri; Behrouz,40,0,70,30
1650389747468,ECE 180,A00,083140,Abi Samra; Nicholas Camill,24,0,30,6
1650389747468,ECE 180,B00,083141,Abi Samra; Nicholas Camill,3,0,30,27
1650389753492,MATH 10A,A01,083735,Patchell; Gregory David,7,0,30,23
1650389753492,MATH 10A,A02,083736,Patchell; Gregory David,28,0,30,2
1650389753492,MATH 10A,A03,083737,Patchell; Gregory David,25,0,30,5
1650389759517,MATH 10B,A01,083207,Staff,0,7,30,30
1650389759517,MATH 10B,A02,083208,Staff,0,7,30,30
1650389759517,MATH 10B,B01,083739,Staff,17,0,30,13
1650389759517,MATH 10B,B02,083740,Staff,28,0,30,2
1650389765545,MATH 18,A01,083743,Staff,3,0,30,27
1650389765545,MATH 18,A02,083744,Staff,27,0,30,3
1650389765545,MATH 18,A03,083745,Staff,22,0,30,8
1650389765545,MATH 18,A04,083746,Staff,27,0,30,3
1650389765545,MATH 18,B01,083748,Staff,0,11,30,30
1650389765545,MATH 18,B02,083749,Staff,0,12,30,30
1650389765545,MATH 18,B03,083750,Staff,0,11,30,30
1650389765545,MATH 18,B04,083751,Staff,0,9,30,30
1650389771568,MATH 20A,A01,083754,Staff,26,0,40,14
1650389777595,MATH 20B,A01,083756,Staff,0,8,30,30
1650389777595,MATH 20B,A02,083757,Staff,0,8,30,30
1650389783626,MATH 20C,A01,083760,Staff,0,14,30,30
1650389783626,MATH 20C,A02,083761,Staff,0,15,30,30
1650389783626,MATH 20C,B01,083762,Staff,13,0,30,17
1650389783626,MATH 20C,B02,083763,Staff,28,0,30,2
1650389789649,MATH 20D,A01,083765,Staff,0,1,30,30
1650389789649,MATH 20D,A02,083766,Staff,7,0,30,23
1650389789649,MATH 20D,A03,083767,Staff,26,0,30,4
1650389795682,MATH 20E,A01,083771,Staff,5,0,30,25
1650389795682,MATH 20E,A02,083772,Staff,19,0,30,11
1650389795682,MATH 20E,B01,083773,Staff,0,0,30,30
1650389795682,MATH 20E,B02,083774,Staff,12,0,30,18
1650389801730,MATH 103A,A01,083777,Staff,0,11,30,30
1650389801730,MATH 103A,A02,083778,Staff,0,12,30,30
1650389801730,MATH 103A,B01,083779,Staff,0,13,30,30
1650389801730,MATH 103A,B02,083780,Staff,0,11,30,30
1650389807780,MATH 105,A01,085443,Staff,0,21,30,30
1650389813811,MATH 109,A01,083213,Anzaldo; Leesa B,0,6,30,30
1650389813811,MATH 109,A02,083214,Anzaldo; Leesa B,0,7,30,30
1650389813811,MATH 109,B01,083215,Anzaldo; Leesa B,0,5,30,30
1650389813811,MATH 109,B02,083216,Anzaldo; Leesa B,0,5,30,30
1650389819838,MATH 142A,A01,083219,Chow; Bennett,0,14,30,30
1650389819838,MATH 142A,A02,083220,Chow; Bennett,0,13,30,30
1650389819838,MATH 142A,B01,083221,Chow; Bennett,0,12,30,30
1650389819838,MATH 142A,B02,083222,Chow; Bennett,0,12,30,30
1650389825862,MATH 193A,A01,083224,Staff,0,5,30,30
1650389825862,MATH 193A,A02,083225,Staff,0,5,30,30
1650389825862,MATH 193A,A03,083781,Staff,0,4,30,30
1650389825862,MATH 193A,A04,083782,Staff,0,4,30,30
1650389831888,MATH 197,001,091859,McAuley; Julian John,9998,0,9999,1
1650389837943,COGS 9,A01,083615,Staff,0,14,60,60
1650389849127,COGS 11,A01,083617,Boyle; Mary E. T.,22,0,40,18
1650389855156,COGS 13,A01,083071,Staff,0,33,40,40
1650389861183,COGS 14A,A01,092681,Staff,0,23,100,100
1650389867207,COGS 14B,A01,083073,Cheng; Tzu-Han,0,10,50,50
1650389873234,COGS 17,A01,092677,Staff,24,0,75,51
1650389879261,COGS 100,A01,083619,Staff,0,24,60,60
1650389885295,COGS 101A,A01,083621,Davis; Joshua Daniel,0,21,60,60
1650389891323,COGS 101B,A01,091572,Staff,0,1,60,60
1650389897359,COGS 101C,A01,083625,Delgado; Tania,16,0,30,14
1650389903384,COGS 107A,A01,083627,Boyle; Mary E. T.,0,10,60,60
1650389909409,COGS 118A,A01,083075,Staff,4,0,60,56
1650389915439,CSE 3,A50,083646,Miranda; Gregory Joseph,21,0,38,17
1650389915439,CSE 3,A51,083647,Miranda; Gregory Joseph,37,0,37,0
1650389921475,CSE 8A,A50,083650,Miranda; Gregory Joseph,0,28,40,40
1650389927508,CSE 11,A01,083080,Cao; Yingjun,0,89,40,40
1650389933533,CSE 12,A01,083652,Staff,0,14,100,100
1650389939557,CSE 15L,A01,083654,Staff,0,1,50,50
1650389939557,CSE 15L,A02,083655,Staff,1,0,50,49
1650389945598,CSE 20,A01,083657,Staff,52,0,80,28
1650389951622,CSE 30,A01,083084,Eldon; John,0,76,40,40
1650389957647,CSE 100,A01,083659,Cao; Yingjun,0,66,50,50
1650389963682,CSE 134B,A01,083661,Powell; Thomas Allan,0,31,65,65
1650389969715,CSE 140,A01,083663,Staff,0,0,75,75
1650389975738,CSE 140L,A01,083088,Eldon; John,0,7,75,75
1650389981765,CSE 175,A01,083665,Kumar; Rakesh,8,0,25,17
1650389987794,CSE 190,A00,092507,Dubnov; Shlomo,14,0,20,6
1650389993822,ECE 45,A01,083139,Staff,0,17,40,40
1650389999866,ECE 65,A50,083695,Staff,0,5,30,30
1650390005892,ECE 109,A01,091882,Touri; Behrouz,40,0,70,30
1650390011923,ECE 180,A00,083140,Abi Samra; Nicholas Camill,24,0,30,6
1650390011923,ECE 180,B00,083141,Abi Samra; Nicholas Camill,3,0,30,27
1650390017948,MATH 10A,A01,083735,Patchell; Gregory David,7,0,30,23
1650390017948,MATH 10A,A02,083736,Patchell; Gregory David,28,0,30,2
1650390017948,MATH 10A,A03,083737,Patchell; Gregory David,25,0,30,5
1650390023986,MATH 10B,A01,083207,Staff,0,7,30,30
1650390023986,MATH 10B,A02,083208,Staff,0,7,30,30
1650390023986,MATH 10B,B01,083739,Staff,17,0,30,13
1650390023986,MATH 10B,B02,083740,Staff,28,0,30,2
1650390030026,MATH 18,A01,083743,Staff,3,0,30,27
1650390030026,MATH 18,A02,083744,Staff,27,0,30,3
1650390030026,MATH 18,A03,083745,Staff,22,0,30,8
1650390030026,MATH 18,A04,083746,Staff,27,0,30,3
1650390030026,MATH 18,B01,083748,Staff,0,11,30,30
1650390030026,MATH 18,B02,083749,Staff,0,12,30,30
1650390030026,MATH 18,B03,083750,Staff,0,11,30,30
1650390030026,MATH 18,B04,083751,Staff,0,9,30,30
1650390036053,MATH 20A,A01,083754,Staff,26,0,40,14
1650390042085,MATH 20B,A01,083756,Staff,0,8,30,30
1650390042085,MATH 20B,A02,083757,Staff,0,8,30,30
1650390048113,MATH 20C,A01,083760,Staff,0,14,30,30
1650390048113,MATH 20C,A02,083761,Staff,0,15,30,30
1650390048113,MATH 20C,B01,083762,Staff,13,0,30,17
1650390048113,MATH 20C,B02,083763,Staff,28,0,30,2
1650390054141,MATH 20D,A01,083765,Staff,0,1,30,30
1650390054141,MATH 20D,A02,083766,Staff,7,0,30,23
1650390054141,MATH 20D,A03,083767,Staff,26,0,30,4
1650390060176,MATH 20E,A01,083771,Staff,5,0,30,25
1650390060176,MATH 20E,A02,083772,Staff,19,0,30,11
1650390060176,MATH 20E,B01,083773,Staff,0,0,30,30
1650390060176,MATH 20E,B02,083774,Staff,12,0,30,18
1650390066201,MATH 103A,A01,083777,Staff,0,11,30,30
1650390066201,MATH 103A,A02,083778,Staff,0,12,30,30
1650390066201,MATH 103A,B01,083779,Staff,0,13,30,30
1650390066201,MATH 103A,B02,083780,Staff,0,11,30,30
1650390072233,MATH 105,A01,085443,Staff,0,21,30,30
1650390078258,MATH 109,A01,083213,Anzaldo; Leesa B,0,6,30,30
1650390078258,MATH 109,A02,083214,Anzaldo; Leesa B,0,7,30,30
1650390078258,MATH 109,B01,083215,Anzaldo; Leesa B,0,5,30,30
1650390078258,MATH 109,B02,083216,Anzaldo; Leesa B,0,5,30,30
1650390084281,MATH 142A,A01,083219,Chow; Bennett,0,14,30,30
1650390084281,MATH 142A,A02,083220,Chow; Bennett,0,13,30,30
1650390084281,MATH 142A,B01,083221,Chow; Bennett,0,12,30,30
1650390084281,MATH 142A,B02,083222,Chow; Bennett,0,12,30,30
1650390090306,MATH 193A,A01,083224,Staff,0,5,30,30
1650390090306,MATH 193A,A02,083225,Staff,0,5,30,30
1650390090306,MATH 193A,A03,083781,Staff,0,4,30,30
1650390090306,MATH 193A,A04,083782,Staff,0,4,30,30
1650390096339,MATH 197,001,091859,McAuley; Julian John,9998,0,9999,1
1650390102390,COGS 9,A01,083615,Staff,0,14,60,60
1650390108412,COGS 11,A01,083617,Boyle; Mary E. T.,22,0,40,18
1650390114445,COGS 13,A01,083071,Staff,0,33,40,40
1650390120468,COGS 14A,A01,092681,Staff,0,23,100,100
1650390126500,COGS 14B,A01,083073,Cheng; Tzu-Han,0,10,50,50
1650390132524,COGS 17,A01,092677,Staff,24,0,75,51
1650390138656,COGS 100,A01,083619,Staff,0,24,60,60
1650390144699,COGS 101A,A01,083621,Davis; Joshua Daniel,0,21,60,60
1650390150725,COGS 101B,A01,091572,Staff,0,1,60,60
1650390156750,COGS 101C,A01,083625,Delgado; Tania,16,0,30,14
1650390162780,COGS 107A,A01,083627,Boyle; Mary E. T.,0,10,60,60
1650390168806,COGS 118A,A01,083075,Staff,4,0,60,56
1650390174833,CSE 3,A50,083646,Miranda; Gregory Joseph,21,0,38,17
1650390174833,CSE 3,A51,083647,Miranda; Gregory Joseph,37,0,37,0
1650390180868,CSE 8A,A50,083650,Miranda; Gregory Joseph,0,28,40,40
1650390186890,CSE 11,A01,083080,Cao; Yingjun,0,89,40,40
1650390192916,CSE 12,A01,083652,Staff,0,14,100,100
1650390198945,CSE 15L,A01,083654,Staff,0,1,50,50
1650390198945,CSE 15L,A02,083655,Staff,1,0,50,49
1650390204971,CSE 20,A01,083657,Staff,52,0,80,28
1650390211008,CSE 30,A01,083084,Eldon; John,0,76,40,40
1650390217047,CSE 100,A01,083659,Cao; Yingjun,0,66,50,50
1650390223074,CSE 134B,A01,083661,Powell; Thomas Allan,0,31,65,65
1650390229099,CSE 140,A01,083663,Staff,0,0,75,75
1650390235132,CSE 140L,A01,083088,Eldon; John,0,7,75,75
1650390241161,CSE 175,A01,083665,Kumar; Rakesh,8,0,25,17
1650390247201,CSE 190,A00,092507,Dubnov; Shlomo,14,0,20,6
1650390253228,ECE 45,A01,083139,Staff,0,17,40,40
1650390259253,ECE 65,A50,083695,Staff,0,5,30,30
1650390265277,ECE 109,A01,091882,Touri; Behrouz,40,0,70,30
1650390271307,ECE 180,A00,083140,Abi Samra; Nicholas Camill,24,0,30,6
1650390271307,ECE 180,B00,083141,Abi Samra; Nicholas Camill,3,0,30,27
1650390277330,MATH 10A,A01,083735,Patchell; Gregory David,7,0,30,23
1650390277330,MATH 10A,A02,083736,Patchell; Gregory David,28,0,30,2
1650390277330,MATH 10A,A03,083737,Patchell; Gregory David,25,0,30,5
1650390283355,MATH 10B,A01,083207,Staff,0,7,30,30
1650390283355,MATH 10B,A02,083208,Staff,0,7,30,30
1650390283355,MATH 10B,B01,083739,Staff,17,0,30,13
1650390283355,MATH 10B,B02,083740,Staff,28,0,30,2
1650390289381,MATH 18,A01,083743,Staff,3,0,30,27
1650390289381,MATH 18,A02,083744,Staff,27,0,30,3
1650390289381,MATH 18,A03,083745,Staff,22,0,30,8
1650390289381,MATH 18,A04,083746,Staff,27,0,30,3
1650390289381,MATH 18,B01,083748,Staff,0,11,30,30
1650390289381,MATH 18,B02,083749,Staff,0,12,30,30
1650390289381,MATH 18,B03,083750,Staff,0,11,30,30
1650390289381,MATH 18,B04,083751,Staff,0,9,30,30
1650390295406,MATH 20A,A01,083754,Staff,26,0,40,14
1650390301444,MATH 20B,A01,083756,Staff,0,8,30,30
1650390301444,MATH 20B,A02,083757,Staff,0,8,30,30
1650390307467,MATH 20C,A01,083760,Staff,0,14,30,30
1650390307467,MATH 20C,A02,083761,Staff,0,15,30,30
1650390307467,MATH 20C,B01,083762,Staff,13,0,30,17
1650390307467,MATH 20C,B02,083763,Staff,28,0,30,2
1650390313496,MATH 20D,A01,083765,Staff,0,1,30,30
1650390313496,MATH 20D,A02,083766,Staff,7,0,30,23
1650390313496,MATH 20D,A03,083767,Staff,26,0,30,4
1650390319531,MATH 20E,A01,083771,Staff,5,0,30,25
1650390319531,MATH 20E,A02,083772,Staff,19,0,30,11
1650390319531,MATH 20E,B01,083773,Staff,0,0,30,30
1650390319531,MATH 20E,B02,083774,Staff,12,0,30,18
1650390325561,MATH 103A,A01,083777,Staff,0,11,30,30
1650390325561,MATH 103A,A02,083778,Staff,0,12,30,30
1650390325561,MATH 103A,B01,083779,Staff,0,13,30,30
1650390325561,MATH 103A,B02,083780,Staff,0,11,30,30
1650390331594,MATH 105,A01,085443,Staff,0,21,30,30
1650390337619,MATH 109,A01,083213,Anzaldo; Leesa B,0,6,30,30
1650390337619,MATH 109,A02,083214,Anzaldo; Leesa B,0,7,30,30
1650390337619,MATH 109,B01,083215,Anzaldo; Leesa B,0,5,30,30
1650390337619,MATH 109,B02,083216,Anzaldo; Leesa B,0,5,30,30
1650390343649,MATH 142A,A01,083219,Chow; Bennett,0,14,30,30
1650390343649,MATH 142A,A02,083220,Chow; Bennett,0,13,30,30
1650390343649,MATH 142A,B01,083221,Chow; Bennett,0,12,30,30
1650390343649,MATH 142A,B02,083222,Chow; Bennett,0,12,30,30
1650390349672,MATH 193A,A01,083224,Staff,0,5,30,30
1650390349672,MATH 193A,A02,083225,Staff,0,5,30,30
1650390349672,MATH 193A,A03,083781,Staff,0,4,30,30
1650390349672,MATH 193A,A04,083782,Staff,0,4,30,30
1650390355697,MATH 197,001,091859,McAuley; Julian John,9998,0,9999,1
1650390361753,COGS 9,A01,083615,Staff,0,14,60,60
1650390367776,COGS 11,A01,083617,Boyle; Mary E. T.,22,0,40,18
1650390373807,COGS 13,A01,083071,Staff,0,33,40,40
1650390379830,COGS 14A,A01,092681,Staff,0,23,100,100
1650390385862,COGS 14B,A01,083073,Cheng; Tzu-Han,0,10,50,50
1650390391885,COGS 17,A01,092677,Staff,24,0,75,51
1650390397908,COGS 100,A01,083619,Staff,0,24,60,60
1650390403930,COGS 101A,A01,083621,Davis; Joshua Daniel,0,21,60,60
1650390409952,COGS 101B,A01,091572,Staff,0,1,60,60
1650390415985,COGS 101C,A01,083625,Delgado; Tania,16,0,30,14
1650390422014,COGS 107A,A01,083627,Boyle; Mary E. T.,0,10,60,60
1650390428055,COGS 118A,A01,083075,Staff,4,0,60,56
1650390434078,CSE 3,A50,083646,Miranda; Gregory Joseph,21,0,38,17
1650390434078,CSE 3,A51,083647,Miranda; Gregory Joseph,37,0,37,0
1650390440110,CSE 8A,A50,083650,Miranda; Gregory Joseph,0,28,40,40
1650390446135,CSE 11,A01,083080,Cao; Yingjun,0,89,40,40
1650390452164,CSE 12,A01,083652,Staff,0,14,100,100
1650390458192,CSE 15L,A01,083654,Staff,0,1,50,50
1650390458192,CSE 15L,A02,083655,Staff,1,0,50,49
1650390464214,CSE 20,A01,083657,Staff,52,0,80,28
1650390470239,CSE 30,A01,083084,Eldon; John,0,76,40,40
1650390476268,CSE 100,A01,083659,Cao; Yingjun,0,66,50,50
1650390482291,CSE 134B,A01,083661,Powell; Thomas Allan,0,31,65,65
1650390488316,CSE 140,A01,083663,Staff,0,0,75,75
1650390494338,CSE 140L,A01,083088,Eldon; John,0,7,75,75
1650390500365,CSE 175,A01,083665,Kumar; Rakesh,8,0,25,17
1650390506389,CSE 190,A00,092507,Dubnov; Shlomo,14,0,20,6
1650390512414,ECE 45,A01,083139,Staff,0,17,40,40
1650390518438,ECE 65,A50,083695,Staff,0,5,30,30
1650390524463,ECE 109,A01,091882,Touri; Behrouz,40,0,70,30
1650390530486,ECE 180,A00,083140,Abi Samra; Nicholas Camill,24,0,30,6
1650390530486,ECE 180,B00,083141,Abi Samra; Nicholas Camill,3,0,30,27
1650390536517,MATH 10A,A01,083735,Patchell; Gregory David,7,0,30,23
1650390536517,MATH 10A,A02,083736,Patchell; Gregory David,28,0,30,2
1650390536517,MATH 10A,A03,083737,Patchell; Gregory David,25,0,30,5
1650390542541,MATH 10B,A01,083207,Staff,0,7,30,30
1650390542541,MATH 10B,A02,083208,Staff,0,7,30,30
1650390542541,MATH 10B,B01,083739,Staff,17,0,30,13
1650390542541,MATH 10B,B02,083740,Staff,28,0,30,2
1650390548568,MATH 18,A01,083743,Staff,3,0,30,27
1650390548568,MATH 18,A02,083744,Staff,27,0,30,3
1650390548568,MATH 18,A03,083745,Staff,22,0,30,8
1650390548568,MATH 18,A04,083746,Staff,27,0,30,3
1650390548568,MATH 18,B01,083748,Staff,0,11,30,30
1650390548568,MATH 18,B02,083749,Staff,0,12,30,30
1650390548568,MATH 18,B03,083750,Staff,0,11,30,30
1650390548568,MATH 18,B04,083751,Staff,0,9,30,30
1650390554594,MATH 20A,A01,083754,Staff,26,0,40,14
1650390560625,MATH 20B,A01,083756,Staff,0,8,30,30
1650390560625,MATH 20B,A02,083757,Staff,0,8,30,30
1650390566659,MATH 20C,A01,083760,Staff,0,14,30,30
1650390566659,MATH 20C,A02,083761,Staff,0,15,30,30
1650390566659,MATH 20C,B01,083762,Staff,13,0,30,17
1650390566659,MATH 20C,B02,083763,Staff,28,0,30,2
1650390572689,MATH 20D,A01,083765,Staff,0,1,30,30
1650390572689,MATH 20D,A02,083766,Staff,7,0,30,23
1650390572689,MATH 20D,A03,083767,Staff,26,0,30,4
1650390578727,MATH 20E,A01,083771,Staff,5,0,30,25
1650390578727,MATH 20E,A02,083772,Staff,19,0,30,11
1650390578727,MATH 20E,B01,083773,Staff,0,0,30,30
1650390578727,MATH 20E,B02,083774,Staff,12,0,30,18
1650390584751,MATH 103A,A01,083777,Staff,0,11,30,30
1650390584751,MATH 103A,A02,083778,Staff,0,12,30,30
1650390584751,MATH 103A,B01,083779,Staff,0,13,30,30
1650390584751,MATH 103A,B02,083780,Staff,0,11,30,30
1650390590776,MATH 105,A01,085443,Staff,0,21,30,30
1650390596812,MATH 109,A01,083213,Anzaldo; Leesa B,0,6,30,30
1650390596812,MATH 109,A02,083214,Anzaldo; Leesa B,0,7,30,30
1650390596812,MATH 109,B01,083215,Anzaldo; Leesa B,0,5,30,30
1650390596812,MATH 109,B02,083216,Anzaldo; Leesa B,0,5,30,30
1650390602836,MATH 142A,A01,083219,Chow; Bennett,0,14,30,30
1650390602836,MATH 142A,A02,083220,Chow; Bennett,0,13,30,30
1650390602836,MATH 142A,B01,083221,Chow; Bennett,0,12,30,30
1650390602836,MATH 142A,B02,083222,Chow; Bennett,0,12,30,30
1650390608858,MATH 193A,A01,083224,Staff,0,5,30,30
1650390608858,MATH 193A,A02,083225,Staff,0,5,30,30
1650390608858,MATH 193A,A03,083781,Staff,0,4,30,30
1650390608858,MATH 193A,A04,083782,Staff,0,4,30,30
1650390614884,MATH 197,001,091859,McAuley; Julian John,9998,0,9999,1
1650390620954,COGS 9,A01,083615,Staff,0,14,60,60
1650390626981,COGS 11,A01,083617,Boyle; Mary E. T.,22,0,40,18
1650390633010,COGS 13,A01,083071,Staff,0,33,40,40
1650390639036,COGS 14A,A01,092681,Staff,0,23,100,100
1650390645069,COGS 14B,A01,083073,Cheng; Tzu-Han,0,10,50,50
1650390651093,COGS 17,A01,092677,Staff,24,0,75,51
1650390657121,COGS 100,A01,083619,Staff,0,24,60,60
1650390663143,COGS 101A,A01,083621,Davis; Joshua Daniel,0,21,60,60
1650390669176,COGS 101B,A01,091572,Staff,0,1,60,60
1650390675205,COGS 101C,A01,083625,Delgado; Tania,16,0,30,14
1650390681229,COGS 107A,A01,083627,Boyle; Mary E. T.,0,10,60,60
1650390687266,COGS 118A,A01,083075,Staff,4,0,60,56
1650390693293,CSE 3,A50,083646,Miranda; Gregory Joseph,21,0,38,17
1650390693293,CSE 3,A51,083647,Miranda; Gregory Joseph,37,0,37,0
1650390699315,CSE 8A,A50,083650,Miranda; Gregory Joseph,0,28,40,40
1650390705343,CSE 11,A01,083080,Cao; Yingjun,0,89,40,40
1650390711368,CSE 12,A01,083652,Staff,0,14,100,100
1650390717411,CSE 15L,A01,083654,Staff,0,1,50,50
1650390717411,CSE 15L,A02,083655,Staff,1,0,50,49
1650390723444,CSE 20,A01,083657,Staff,52,0,80,28
1650390729466,CSE 30,A01,083084,Eldon; John,0,76,40,40
1650390735580,CSE 100,A01,083659,Cao; Yingjun,0,66,50,50
1650390741613,CSE 134B,A01,083661,Powell; Thomas Allan,0,31,65,65
1650390747651,CSE 140,A01,083663,Staff,0,0,75,75
1650390753677,CSE 140L,A01,083088,Eldon; John,0,7,75,75
1650390759704,CSE 175,A01,083665,Kumar; Rakesh,8,0,25,17
1650390765728,CSE 190,A00,092507,Dubnov; Shlomo,14,0,20,6
1650390771755,ECE 45,A01,083139,Staff,0,17,40,40
1650390777781,ECE 65,A50,083695,Staff,0,5,30,30
1650390783821,ECE 109,A01,091882,Touri; Behrouz,40,0,70,30
1650390789844,ECE 180,A00,083140,Abi Samra; Nicholas Camill,24,0,30,6
1650390789844,ECE 180,B00,083141,Abi Samra; Nicholas Camill,3,0,30,27
1650390795868,MATH 10A,A01,083735,Patchell; Gregory David,7,0,30,23
1650390795868,MATH 10A,A02,083736,Patchell; Gregory David,28,0,30,2
1650390795868,MATH 10A,A03,083737,Patchell; Gregory David,25,0,30,5
1650390801892,MATH 10B,A01,083207,Staff,0,7,30,30
1650390801892,MATH 10B,A02,083208,Staff,0,7,30,30
1650390801892,MATH 10B,B01,083739,Staff,17,0,30,13
1650390801892,MATH 10B,B02,083740,Staff,28,0,30,2
1650390807920,MATH 18,A01,083743,Staff,3,0,30,27
1650390807920,MATH 18,A02,083744,Staff,27,0,30,3
1650390807920,MATH 18,A03,083745,Staff,22,0,30,8
1650390807920,MATH 18,A04,083746,Staff,27,0,30,3
1650390807920,MATH 18,B01,083748,Staff,0,11,30,30
1650390807920,MATH 18,B02,083749,Staff,0,12,30,30
1650390807920,MATH 18,B03,083750,Staff,0,11,30,30
1650390807920,MATH 18,B04,083751,Staff,0,9,30,30
1650390813945,MATH 20A,A01,083754,Staff,26,0,40,14
1650390819969,MATH 20B,A01,083756,Staff,0,8,30,30
1650390819969,MATH 20B,A02,083757,Staff,0,8,30,30
1650390825996,MATH 20C,A01,083760,Staff,0,14,30,30
1650390825996,MATH 20C,A02,083761,Staff,0,15,30,30
1650390825996,MATH 20C,B01,083762,Staff,13,0,30,17
1650390825996,MATH 20C,B02,083763,Staff,28,0,30,2
1650390832037,MATH 20D,A01,083765,Staff,0,1,30,30
1650390832037,MATH 20D,A02,083766,Staff,7,0,30,23
1650390832037,MATH 20D,A03,083767,Staff,26,0,30,4
1650390838066,MATH 20E,A01,083771,Staff,5,0,30,25
1650390838066,MATH 20E,A02,083772,Staff,19,0,30,11
1650390838066,MATH 20E,B01,083773,Staff,0,0,30,30
1650390838066,MATH 20E,B02,083774,Staff,12,0,30,18
1650390844103,MATH 103A,A01,083777,Staff,0,11,30,30
1650390844103,MATH 103A,A02,083778,Staff,0,12,30,30
1650390844103,MATH 103A,B01,083779,Staff,0,13,30,30
1650390844103,MATH 103A,B02,083780,Staff,0,11,30,30
1650390850128,MATH 105,A01,085443,Staff,0,21,30,30
1650390856162,MATH 109,A01,083213,Anzaldo; Leesa B,0,6,30,30
1650390856162,MATH 109,A02,083214,Anzaldo; Leesa B,0,7,30,30
1650390856162,MATH 109,B01,083215,Anzaldo; Leesa B,0,5,30,30
1650390856162,MATH 109,B02,083216,Anzaldo; Leesa B,0,5,30,30
1650390862192,MATH 142A,A01,083219,Chow; Bennett,0,14,30,30
1650390862192,MATH 142A,A02,083220,Chow; Bennett,0,13,30,30
1650390862192,MATH 142A,B01,083221,Chow; Bennett,0,12,30,30
1650390862192,MATH 142A,B02,083222,Chow; Bennett,0,12,30,30
1650390868217,MATH 193A,A01,083224,Staff,0,5,30,30
1650390868217,MATH 193A,A02,083225,Staff,0,5,30,30
1650390868217,MATH 193A,A03,083781,Staff,0,4,30,30
1650390868217,MATH 193A,A04,083782,Staff,0,4,30,30
1650390874239,MATH 197,001,091859,McAuley; Julian John,9998,0,9999,1
1650390880303,COGS 9,A01,083615,Staff,0,14,60,60
1650390886332,COGS 11,A01,083617,Boyle; Mary E. T.,22,0,40,18
1650390892358,COGS 13,A01,083071,Staff,0,33,40,40
1650390898384,COGS 14A,A01,092681,Staff,0,23,100,100
1650390904411,COGS 14B,A01,083073,Cheng; Tzu-Han,0,10,50,50
1650390910437,COGS 17,A01,092677,Staff,24,0,75,51
1650390916464,COGS 100,A01,083619,Staff,0,24,60,60
1650390922508,COGS 101A,A01,083621,Davis; Joshua Daniel,0,21,60,60
1650390928535,COGS 101B,A01,091572,Staff,0,1,60,60
1650390934563,COGS 101C,A01,083625,Delgado; Tania,16,0,30,14
1650390940586,COGS 107A,A01,083627,Boyle; Mary E. T.,0,10,60,60
1650390946609,COGS 118A,A01,083075,Staff,4,0,60,56
1650390952634,CSE 3,A50,083646,Miranda; Gregory Joseph,21,0,38,17
1650390952634,CSE 3,A51,083647,Miranda; Gregory Joseph,37,0,37,0
1650390958668,CSE 8A,A50,083650,Miranda; Gregory Joseph,0,28,40,40
1650390964697,CSE 11,A01,083080,Cao; Yingjun,0,89,40,40
1650390970740,CSE 12,A01,083652,Staff,0,14,100,100
1650390976765,CSE 15L,A01,083654,Staff,0,1,50,50
1650390976765,CSE 15L,A02,083655,Staff,1,0,50,49
1650390982788,CSE 20,A01,083657,Staff,52,0,80,28
1650390988813,CSE 30,A01,083084,Eldon; John,0,76,40,40
1650390994839,CSE 100,A01,083659,Cao; Yingjun,0,66,50,50
1650391000865,CSE 134B,A01,083661,Powell; Thomas Allan,0,31,65,65
1650391006898,CSE 140,A01,083663,Staff,0,0,75,75
1650391012921,CSE 140L,A01,083088,Eldon; John,0,7,75,75
1650391018945,CSE 175,A01,083665,Kumar; Rakesh,8,0,25,17
1650391024975,CSE 190,A00,092507,Dubnov; Shlomo,14,0,20,6
1650391031016,ECE 45,A01,083139,Staff,0,17,40,40
1650391037043,ECE 65,A50,083695,Staff,0,5,30,30
1650391043078,ECE 109,A01,091882,Touri; Behrouz,40,0,70,30
1650391049105,ECE 180,A00,083140,Abi Samra; Nicholas Camill,24,0,30,6
1650391049105,ECE 180,B00,083141,Abi Samra; Nicholas Camill,3,0,30,27
1650391055130,MATH 10A,A01,083735,Patchell; Gregory David,7,0,30,23
1650391055130,MATH 10A,A02,083736,Patchell; Gregory David,28,0,30,2
1650391055130,MATH 10A,A03,083737,Patchell; Gregory David,25,0,30,5
1650391061158,MATH 10B,A01,083207,Staff,0,7,30,30
1650391061158,MATH 10B,A02,083208,Staff,0,7,30,30
1650391061158,MATH 10B,B01,083739,Staff,17,0,30,13
1650391061158,MATH 10B,B02,083740,Staff,28,0,30,2
1650391067195,MATH 18,A01,083743,Staff,3,0,30,27
1650391067195,MATH 18,A02,083744,Staff,27,0,30,3
1650391067195,MATH 18,A03,083745,Staff,22,0,30,8
1650391067195,MATH 18,A04,083746,Staff,27,0,30,3
1650391067195,MATH 18,B01,083748,Staff,0,11,30,30
1650391067195,MATH 18,B02,083749,Staff,0,12,30,30
1650391067195,MATH 18,B03,083750,Staff,0,11,30,30
1650391067195,MATH 18,B04,083751,Staff,0,9,30,30
1650391073222,MATH 20A,A01,083754,Staff,26,0,40,14
1650391079247,MATH 20B,A01,083756,Staff,0,8,30,30
1650391079247,MATH 20B,A02,083757,Staff,0,8,30,30
1650391085271,MATH 20C,A01,083760,Staff,0,14,30,30
1650391085271,MATH 20C,A02,083761,Staff,0,15,30,30
1650391085271,MATH 20C,B01,083762,Staff,13,0,30,17
1650391085271,MATH 20C,B02,083763,Staff,28,0,30,2
1650391091315,MATH 20D,A01,083765,Staff,0,1,30,30
1650391091315,MATH 20D,A02,083766,Staff,7,0,30,23
1650391091315,MATH 20D,A03,083767,Staff,26,0,30,4
1650391097351,MATH 20E,A01,083771,Staff,5,0,30,25
1650391097351,MATH 20E,A02,083772,Staff,19,0,30,11
1650391097351,MATH 20E,B01,083773,Staff,0,0,30,30
1650391097351,MATH 20E,B02,083774,Staff,12,0,30,18
1650391103376,MATH 103A,A01,083777,Staff,0,11,30,30
1650391103376,MATH 103A,A02,083778,Staff,0,12,30,30
1650391103376,MATH 103A,B01,083779,Staff,0,13,30,30
1650391103376,MATH 103A,B02,083780,Staff,0,11,30,30
1650391109400,MATH 105,A01,085443,Staff,0,21,30,30
1650391115425,MATH 109,A01,083213,Anzaldo; Leesa B,0,6,30,30
1650391115425,MATH 109,A02,083214,Anzaldo; Leesa B,0,7,30,30
1650391115425,MATH 109,B01,083215,Anzaldo; Leesa B,0,5,30,30
1650391115425,MATH 109,B02,083216,Anzaldo; Leesa B,0,5,30,30
1650391121455,MATH 142A,A01,083219,Chow; Bennett,0,14,30,30
1650391121455,MATH 142A,A02,083220,Chow; Bennett,0,13,30,30
1650391121455,MATH 142A,B01,083221,Chow; Bennett,0,12,30,30
1650391121455,MATH 142A,B02,083222,Chow; Bennett,0,12,30,30
1650391127482,MATH 193A,A01,083224,Staff,0,5,30,30
1650391127482,MATH 193A,A02,083225,Staff,0,5,30,30
1650391127482,MATH 193A,A03,083781,Staff,0,4,30,30
1650391127482,MATH 193A,A04,083782,Staff,0,4,30,30
1650391133513,MATH 197,001,091859,McAuley; Julian John,9998,0,9999,1
1650391139577,COGS 9,A01,083615,Staff,0,14,60,60
1650391145601,COGS 11,A01,083617,Boyle; Mary E. T.,22,0,40,18
1650391151626,COGS 13,A01,083071,Staff,0,33,40,40
1650391157651,COGS 14A,A01,092681,Staff,0,23,100,100
1650391163676,COGS 14B,A01,083073,Cheng; Tzu-Han,0,10,50,50
1650391169715,COGS 17,A01,092677,Staff,24,0,75,51
1650391175740,COGS 100,A01,083619,Staff,0,24,60,60
1650391181801,COGS 101A,A01,083621,Davis; Joshua Daniel,0,21,60,60
1650391187827,COGS 101B,A01,091572,Staff,0,1,60,60
1650391193854,COGS 101C,A01,083625,Delgado; Tania,16,0,30,14
1650391199880,COGS 107A,A01,083627,Boyle; Mary E. T.,0,10,60,60
1650391205903,COGS 118A,A01,083075,Staff,4,0,60,56
1650391211937,CSE 3,A50,083646,Miranda; Gregory Joseph,21,0,38,17
1650391211937,CSE 3,A51,083647,Miranda; Gregory Joseph,37,0,37,0
1650391217965,CSE 8A,A50,083650,Miranda; Gregory Joseph,0,28,40,40
1650391223989,CSE 11,A01,083080,Cao; Yingjun,0,89,40,40
1650391230012,CSE 12,A01,083652,Staff,0,14,100,100
1650391236034,CSE 15L,A01,083654,Staff,0,1,50,50
1650391236034,CSE 15L,A02,083655,Staff,1,0,50,49
1650391242058,CSE 20,A01,083657,Staff,51,0,80,29
1650391248090,CSE 30,A01,083084,Eldon; John,0,76,40,40
1650391254122,CSE 100,A01,083659,Cao; Yingjun,0,66,50,50
1650391260145,CSE 134B,A01,083661,Powell; Thomas Allan,0,31,65,65
1650391266169,CSE 140,A01,083663,Staff,0,0,75,75
1650391272193,CSE 140L,A01,083088,Eldon; John,0,7,75,75
1650391278221,CSE 175,A01,083665,Kumar; Rakesh,8,0,25,17
1650391284244,CSE 190,A00,092507,Dubnov; Shlomo,14,0,20,6
1650391290267,ECE 45,A01,083139,Staff,0,17,40,40
1650391296293,ECE 65,A50,083695,Staff,0,5,30,30
1650391302326,ECE 109,A01,091882,Touri; Behrouz,40,0,70,30
1650391308352,ECE 180,A00,083140,Abi Samra; Nicholas Camill,24,0,30,6
1650391308352,ECE 180,B00,083141,Abi Samra; Nicholas Camill,3,0,30,27
1650391314384,MATH 10A,A01,083735,Patchell; Gregory David,7,0,30,23
1650391314384,MATH 10A,A02,083736,Patchell; Gregory David,28,0,30,2
1650391314384,MATH 10A,A03,083737,Patchell; Gregory David,25,0,30,5
1650391320411,MATH 10B,A01,083207,Staff,0,7,30,30
1650391320411,MATH 10B,A02,083208,Staff,0,7,30,30
1650391320411,MATH 10B,B01,083739,Staff,17,0,30,13
1650391320411,MATH 10B,B02,083740,Staff,28,0,30,2
1650391326439,MATH 18,A01,083743,Staff,3,0,30,27
1650391326439,MATH 18,A02,083744,Staff,27,0,30,3
1650391326439,MATH 18,A03,083745,Staff,22,0,30,8
1650391326439,MATH 18,A04,083746,Staff,27,0,30,3
1650391326439,MATH 18,B01,083748,Staff,0,11,30,30
1650391326439,MATH 18,B02,083749,Staff,0,12,30,30
1650391326439,MATH 18,B03,083750,Staff,0,11,30,30
1650391326439,MATH 18,B04,083751,Staff,0,9,30,30
1650391332580,MATH 20A,A01,083754,Staff,26,0,40,14
1650391338607,MATH 20B,A01,083756,Staff,0,8,30,30
1650391338607,MATH 20B,A02,083757,Staff,0,8,30,30
1650391344630,MATH 20C,A01,083760,Staff,0,14,30,30
1650391344630,MATH 20C,A02,083761,Staff,0,15,30,30
1650391344630,MATH 20C,B01,083762,Staff,13,0,30,17
1650391344630,MATH 20C,B02,083763,Staff,28,0,30,2
1650391350653,MATH 20D,A01,083765,Staff,0,1,30,30
1650391350653,MATH 20D,A02,083766,Staff,7,0,30,23
1650391350653,MATH 20D,A03,083767,Staff,26,0,30,4
1650391356689,MATH 20E,A01,083771,Staff,5,0,30,25
1650391356689,MATH 20E,A02,083772,Staff,19,0,30,11
1650391356689,MATH 20E,B01,083773,Staff,0,0,30,30
1650391356689,MATH 20E,B02,083774,Staff,12,0,30,18
1650391362712,MATH 103A,A01,083777,Staff,0,11,30,30
1650391362712,MATH 103A,A02,083778,Staff,0,12,30,30
1650391362712,MATH 103A,B01,083779,Staff,0,13,30,30
1650391362712,MATH 103A,B02,083780,Staff,0,11,30,30
1650391368736,MATH 105,A01,085443,Staff,0,21,30,30
1650391374759,MATH 109,A01,083213,Anzaldo; Leesa B,0,6,30,30
1650391374759,MATH 109,A02,083214,Anzaldo; Leesa B,0,7,30,30
1650391374759,MATH 109,B01,083215,Anzaldo; Leesa B,0,5,30,30
1650391374759,MATH 109,B02,083216,Anzaldo; Leesa B,0,5,30,30
1650391380788,MATH 142A,A01,083219,Chow; Bennett,0,14,30,30
1650391380788,MATH 142A,A02,083220,Chow; Bennett,0,13,30,30
1650391380788,MATH 142A,B01,083221,Chow; Bennett,0,12,30,30
1650391380788,MATH 142A,B02,083222,Chow; Bennett,0,12,30,30
1650391386829,MATH 193A,A01,083224,Staff,0,5,30,30
1650391386829,MATH 193A,A02,083225,Staff,0,5,30,30
1650391386829,MATH 193A,A03,083781,Staff,0,4,30,30
1650391386829,MATH 193A,A04,083782,Staff,0,4,30,30
1650391392853,MATH 197,001,091859,McAuley; Julian John,9998,0,9999,1
1650391398916,COGS 9,A01,083615,Staff,0,14,60,60
1650391404938,COGS 11,A01,083617,Boyle; Mary E. T.,22,0,40,18
1650391410965,COGS 13,A01,083071,Staff,0,33,40,40
1650391416995,COGS 14A,A01,092681,Staff,0,23,100,100
1650391423025,COGS 14B,A01,083073,Cheng; Tzu-Han,0,10,50,50
1650391429059,COGS 17,A01,092677,Staff,23,0,75,52
1650391435096,COGS 100,A01,083619,Staff,0,24,60,60
1650391441122,COGS 101A,A01,083621,Davis; Joshua Daniel,0,21,60,60
1650391447146,COGS 101B,A01,091572,Staff,0,1,60,60
1650391453170,COGS 101C,A01,083625,Delgado; Tania,16,0,30,14
1650391459194,COGS 107A,A01,083627,Boyle; Mary E. T.,0,10,60,60
1650391465233,COGS 118A,A01,083075,Staff,4,0,60,56
1650391471269,CSE 3,A50,083646,Miranda; Gregory Joseph,21,0,38,17
1650391471269,CSE 3,A51,083647,Miranda; Gregory Joseph,37,0,37,0
1650391477291,CSE 8A,A50,083650,Miranda; Gregory Joseph,0,28,40,40
1650391483315,CSE 11,A01,083080,Cao; Yingjun,0,89,40,40
1650391489338,CSE 12,A01,083652,Staff,0,14,100,100
1650391495367,CSE 15L,A01,083654,Staff,0,1,50,50
1650391495367,CSE 15L,A02,083655,Staff,1,0,50,49
1650391501398,CSE 20,A01,083657,Staff,51,0,80,29
1650391507423,CSE 30,A01,083084,Eldon; John,0,76,40,40
1650391513447,CSE 100,A01,083659,Cao; Yingjun,0,66,50,50
1650391519472,CSE 134B,A01,083661,Powell; Thomas Allan,0,31,65,65
1650391525500,CSE 140,A01,083663,Staff,0,0,75,75
1650391531533,CSE 140L,A01,083088,Eldon; John,0,7,75,75
1650391537566,CSE 175,A01,083665,Kumar; Rakesh,8,0,25,17
1650391543593,CSE 190,A00,092507,Dubnov; Shlomo,14,0,20,6
1650391549627,ECE 45,A01,083139,Staff,0,17,40,40
1650391555652,ECE 65,A50,083695,Staff,0,5,30,30
1650391561678,ECE 109,A01,091882,Touri; Behrouz,40,0,70,30
1650391567701,ECE 180,A00,083140,Abi Samra; Nicholas Camill,24,0,30,6
1650391567701,ECE 180,B00,083141,Abi Samra; Nicholas Camill,3,0,30,27
1650391573727,MATH 10A,A01,083735,Patchell; Gregory David,7,0,30,23
1650391573727,MATH 10A,A02,083736,Patchell; Gregory David,28,0,30,2
1650391573727,MATH 10A,A03,083737,Patchell; Gregory David,25,0,30,5
1650391579758,MATH 10B,A01,083207,Staff,0,7,30,30
1650391579758,MATH 10B,A02,083208,Staff,0,7,30,30
1650391579758,MATH 10B,B01,083739,Staff,17,0,30,13
1650391579758,MATH 10B,B02,083740,Staff,28,0,30,2
1650391585784,MATH 18,A01,083743,Staff,3,0,30,27
1650391585784,MATH 18,A02,083744,Staff,27,0,30,3
1650391585784,MATH 18,A03,083745,Staff,22,0,30,8
1650391585784,MATH 18,A04,083746,Staff,27,0,30,3
1650391585784,MATH 18,B01,083748,Staff,0,11,30,30
1650391585784,MATH 18,B02,083749,Staff,0,12,30,30
1650391585784,MATH 18,B03,083750,Staff,0,11,30,30
1650391585784,MATH 18,B04,083751,Staff,0,9,30,30
1650391591809,MATH 20A,A01,083754,Staff,26,0,40,14
1650391597833,MATH 20B,A01,083756,Staff,0,8,30,30
1650391597833,MATH 20B,A02,083757,Staff,0,8,30,30
1650391603864,MATH 20C,A01,083760,Staff,0,14,30,30
1650391603864,MATH 20C,A02,083761,Staff,0,15,30,30
1650391603864,MATH 20C,B01,083762,Staff,13,0,30,17
1650391603864,MATH 20C,B02,083763,Staff,28,0,30,2
1650391609889,MATH 20D,A01,083765,Staff,0,1,30,30
1650391609889,MATH 20D,A02,083766,Staff,7,0,30,23
1650391609889,MATH 20D,A03,083767,Staff,26,0,30,4
1650391615914,MATH 20E,A01,083771,Staff,5,0,30,25
1650391615914,MATH 20E,A02,083772,Staff,19,0,30,11
1650391615914,MATH 20E,B01,083773,Staff,0,0,30,30
1650391615914,MATH 20E,B02,083774,Staff,12,0,30,18
1650391621937,MATH 103A,A01,083777,Staff,0,11,30,30
1650391621937,MATH 103A,A02,083778,Staff,0,12,30,30
1650391621937,MATH 103A,B01,083779,Staff,0,13,30,30
1650391621937,MATH 103A,B02,083780,Staff,0,11,30,30
1650391627961,MATH 105,A01,085443,Staff,0,21,30,30
1650391633987,MATH 109,A01,083213,Anzaldo; Leesa B,0,6,30,30
1650391633987,MATH 109,A02,083214,Anzaldo; Leesa B,0,7,30,30
1650391633987,MATH 109,B01,083215,Anzaldo; Leesa B,0,5,30,30
1650391633987,MATH 109,B02,083216,Anzaldo; Leesa B,0,5,30,30
1650391640029,MATH 142A,A01,083219,Chow; Bennett,0,14,30,30
1650391640029,MATH 142A,A02,083220,Chow; Bennett,0,13,30,30
1650391640029,MATH 142A,B01,083221,Chow; Bennett,0,12,30,30
1650391640029,MATH 142A,B02,083222,Chow; Bennett,0,12,30,30
1650391646057,MATH 193A,A01,083224,Staff,0,5,30,30
1650391646057,MATH 193A,A02,083225,Staff,0,5,30,30
1650391646057,MATH 193A,A03,083781,Staff,0,4,30,30
1650391646057,MATH 193A,A04,083782,Staff,0,4,30,30
1650391652081,MATH 197,001,091859,McAuley; Julian John,9998,0,9999,1
1650391658153,COGS 9,A01,083615,Staff,0,14,60,60
1650391664193,COGS 11,A01,083617,Boyle; Mary E. T.,22,0,40,18
1650391670216,COGS 13,A01,083071,Staff,0,33,40,40
1650391676257,COGS 14A,A01,092681,Staff,0,23,100,100
1650391682283,COGS 14B,A01,083073,Cheng; Tzu-Han,0,10,50,50
1650391688309,COGS 17,A01,092677,Staff,23,0,75,52
1650391694341,COGS 100,A01,083619,Staff,0,24,60,60
1650391700365,COGS 101A,A01,083621,Davis; Joshua Daniel,0,21,60,60
1650391706390,COGS 101B,A01,091572,Staff,0,1,60,60
1650391712413,COGS 101C,A01,083625,Delgado; Tania,16,0,30,14
1650391718445,COGS 107A,A01,083627,Boyle; Mary E. T.,0,10,60,60
1650391724474,COGS 118A,A01,083075,Staff,4,0,60,56
1650391730503,CSE 3,A50,083646,Miranda; Gregory Joseph,21,0,38,17
1650391730503,CSE 3,A51,083647,Miranda; Gregory Joseph,37,0,37,0
1650391736536,CSE 8A,A50,083650,Miranda; Gregory Joseph,0,28,40,40
1650391742569,CSE 11,A01,083080,Cao; Yingjun,0,89,40,40
1650391748595,CSE 12,A01,083652,Staff,0,14,100,100
1650391754619,CSE 15L,A01,083654,Staff,0,1,50,50
1650391754619,CSE 15L,A02,083655,Staff,1,0,50,49
1650391760645,CSE 20,A01,083657,Staff,51,0,80,29
1650391766679,CSE 30,A01,083084,Eldon; John,0,76,40,40
1650391772712,CSE 100,A01,083659,Cao; Yingjun,0,66,50,50
1650391778746,CSE 134B,A01,083661,Powell; Thomas Allan,0,31,65,65
1650391784770,CSE 140,A01,083663,Staff,0,0,75,75
1650391790792,CSE 140L,A01,083088,Eldon; John,0,7,75,75
1650391796819,CSE 175,A01,083665,Kumar; Rakesh,8,0,25,17
1650391802845,CSE 190,A00,092507,Dubnov; Shlomo,14,0,20,6
1650391808868,ECE 45,A01,083139,Staff,0,17,40,40
1650391814891,ECE 65,A50,083695,Staff,0,5,30,30
1650391820915,ECE 109,A01,091882,Touri; Behrouz,40,0,70,30
1650391826941,ECE 180,A00,083140,Abi Samra; Nicholas Camill,24,0,30,6
1650391826941,ECE 180,B00,083141,Abi Samra; Nicholas Camill,3,0,30,27
1650391832973,MATH 10A,A01,083735,Patchell; Gregory David,7,0,30,23
1650391832973,MATH 10A,A02,083736,Patchell; Gregory David,28,0,30,2
1650391832973,MATH 10A,A03,083737,Patchell; Gregory David,25,0,30,5
1650391839003,MATH 10B,A01,083207,Staff,0,7,30,30
1650391839003,MATH 10B,A02,083208,Staff,0,7,30,30
1650391839003,MATH 10B,B01,083739,Staff,17,0,30,13
1650391839003,MATH 10B,B02,083740,Staff,28,0,30,2
1650391845032,MATH 18,A01,083743,Staff,3,0,30,27
1650391845032,MATH 18,A02,083744,Staff,27,0,30,3
1650391845032,MATH 18,A03,083745,Staff,22,0,30,8
1650391845032,MATH 18,A04,083746,Staff,27,0,30,3
1650391845032,MATH 18,B01,083748,Staff,0,11,30,30
1650391845032,MATH 18,B02,083749,Staff,0,12,30,30
1650391845032,MATH 18,B03,083750,Staff,0,11,30,30
1650391845032,MATH 18,B04,083751,Staff,0,9,30,30
1650391851069,MATH 20A,A01,083754,Staff,26,0,40,14
1650391857096,MATH 20B,A01,083756,Staff,0,8,30,30
1650391857096,MATH 20B,A02,083757,Staff,0,8,30,30
1650391863134,MATH 20C,A01,083760,Staff,0,14,30,30
1650391863134,MATH 20C,A02,083761,Staff,0,15,30,30
1650391863134,MATH 20C,B01,083762,Staff,13,0,30,17
1650391863134,MATH 20C,B02,083763,Staff,28,0,30,2
1650391869160,MATH 20D,A01,083765,Staff,0,1,30,30
1650391869160,MATH 20D,A02,083766,Staff,7,0,30,23
1650391869160,MATH 20D,A03,083767,Staff,26,0,30,4
1650391875191,MATH 20E,A01,083771,Staff,5,0,30,25
1650391875191,MATH 20E,A02,083772,Staff,19,0,30,11
1650391875191,MATH 20E,B01,083773,Staff,0,0,30,30
1650391875191,MATH 20E,B02,083774,Staff,12,0,30,18
1650391881216,MATH 103A,A01,083777,Staff,0,11,30,30
1650391881216,MATH 103A,A02,083778,Staff,0,12,30,30
1650391881216,MATH 103A,B01,083779,Staff,0,13,30,30
1650391881216,MATH 103A,B02,083780,Staff,0,11,30,30
1650391887240,MATH 105,A01,085443,Staff,0,21,30,30
1650391893269,MATH 109,A01,083213,Anzaldo; Leesa B,0,6,30,30
1650391893269,MATH 109,A02,083214,Anzaldo; Leesa B,0,7,30,30
1650391893269,MATH 109,B01,083215,Anzaldo; Leesa B,0,5,30,30
1650391893269,MATH 109,B02,083216,Anzaldo; Leesa B,0,5,30,30
1650391899293,MATH 142A,A01,083219,Chow; Bennett,0,14,30,30
1650391899293,MATH 142A,A02,083220,Chow; Bennett,0,13,30,30
1650391899293,MATH 142A,B01,083221,Chow; Bennett,0,12,30,30
1650391899293,MATH 142A,B02,083222,Chow; Bennett,0,12,30,30
1650391905323,MATH 193A,A01,083224,Staff,0,5,30,30
1650391905323,MATH 193A,A02,083225,Staff,0,5,30,30
1650391905323,MATH 193A,A03,083781,Staff,0,4,30,30
1650391905323,MATH 193A,A04,083782,Staff,0,4,30,30
1650391911353,MATH 197,001,091859,McAuley; Julian John,9998,0,9999,1
1650391917413,COGS 9,A01,083615,Staff,0,14,60,60
1650391923526,COGS 11,A01,083617,Boyle; Mary E. T.,22,0,40,18
1650391929559,COGS 13,A01,083071,Staff,0,33,40,40
1650391935586,COGS 14A,A01,092681,Staff,0,23,100,100
1650391941610,COGS 14B,A01,083073,Cheng; Tzu-Han,0,10,50,50
1650391947637,COGS 17,A01,092677,Staff,24,0,75,51
1650391953670,COGS 100,A01,083619,Staff,0,24,60,60
1650391959693,COGS 101A,A01,083621,Davis; Joshua Daniel,0,21,60,60
1650391965719,COGS 101B,A01,091572,Staff,0,1,60,60
1650391971743,COGS 101C,A01,083625,Delgado; Tania,16,0,30,14
1650391977770,COGS 107A,A01,083627,Boyle; Mary E. T.,0,10,60,60
1650391983796,COGS 118A,A01,083075,Staff,4,0,60,56
1650391989824,CSE 3,A50,083646,Miranda; Gregory Joseph,21,0,38,17
1650391989824,CSE 3,A51,083647,Miranda; Gregory Joseph,37,0,37,0
1650391995848,CSE 8A,A50,083650,Miranda; Gregory Joseph,0,28,40,40
1650392001887,CSE 11,A01,083080,Cao; Yingjun,0,89,40,40
1650392007918,CSE 12,A01,083652,Staff,0,14,100,100
1650392013955,CSE 15L,A01,083654,Staff,0,1,50,50
1650392013955,CSE 15L,A02,083655,Staff,1,0,50,49
1650392019996,CSE 20,A01,083657,Staff,51,0,80,29
1650392026021,CSE 30,A01,083084,Eldon; John,0,76,40,40
1650392032049,CSE 100,A01,083659,Cao; Yingjun,0,66,50,50
1650392038074,CSE 134B,A01,083661,Powell; Thomas Allan,0,31,65,65
1650392044112,CSE 140,A01,083663,Staff,0,0,75,75
1650392050141,CSE 140L,A01,083088,Eldon; John,0,7,75,75
1650392056175,CSE 175,A01,083665,Kumar; Rakesh,8,0,25,17
1650392062204,CSE 190,A00,092507,Dubnov; Shlomo,14,0,20,6
1650392068226,ECE 45,A01,083139,Staff,0,17,40,40
1650392074250,ECE 65,A50,083695,Staff,0,5,30,30
1650392080277,ECE 109,A01,091882,Touri; Behrouz,40,0,70,30
1650392086300,ECE 180,A00,083140,Abi Samra; Nicholas Camill,24,0,30,6
1650392086300,ECE 180,B00,083141,Abi Samra; Nicholas Camill,3,0,30,27
1650392092330,MATH 10A,A01,083735,Patchell; Gregory David,7,0,30,23
1650392092330,MATH 10A,A02,083736,Patchell; Gregory David,28,0,30,2
1650392092330,MATH 10A,A03,083737,Patchell; Gregory David,25,0,30,5
1650392098355,MATH 10B,A01,083207,Staff,0,7,30,30
1650392098355,MATH 10B,A02,083208,Staff,0,7,30,30
1650392098355,MATH 10B,B01,083739,Staff,16,0,30,14
1650392098355,MATH 10B,B02,083740,Staff,28,0,30,2
1650392104386,MATH 18,A01,083743,Staff,3,0,30,27
1650392104386,MATH 18,A02,083744,Staff,27,0,30,3
1650392104386,MATH 18,A03,083745,Staff,22,0,30,8
1650392104386,MATH 18,A04,083746,Staff,27,0,30,3
1650392104386,MATH 18,B01,083748,Staff,0,11,30,30
1650392104386,MATH 18,B02,083749,Staff,0,12,30,30
1650392104386,MATH 18,B03,083750,Staff,0,11,30,30
1650392104386,MATH 18,B04,083751,Staff,0,9,30,30
1650392110412,MATH 20A,A01,083754,Staff,26,0,40,14
1650392116435,MATH 20B,A01,083756,Staff,0,8,30,30
1650392116435,MATH 20B,A02,083757,Staff,0,8,30,30
1650392122463,MATH 20C,A01,083760,Staff,0,14,30,30
1650392122463,MATH 20C,A02,083761,Staff,0,15,30,30
1650392122463,MATH 20C,B01,083762,Staff,13,0,30,17
1650392122463,MATH 20C,B02,083763,Staff,28,0,30,2
1650392128487,MATH 20D,A01,083765,Staff,0,1,30,30
1650392128487,MATH 20D,A02,083766,Staff,7,0,30,23
1650392128487,MATH 20D,A03,083767,Staff,26,0,30,4
1650392134514,MATH 20E,A01,083771,Staff,5,0,30,25
1650392134514,MATH 20E,A02,083772,Staff,19,0,30,11
1650392134514,MATH 20E,B01,083773,Staff,0,0,30,30
1650392134514,MATH 20E,B02,083774,Staff,12,0,30,18
1650392140538,MATH 103A,A01,083777,Staff,0,11,30,30
1650392140538,MATH 103A,A02,083778,Staff,0,12,30,30
1650392140538,MATH 103A,B01,083779,Staff,0,13,30,30
1650392140538,MATH 103A,B02,083780,Staff,0,11,30,30
1650392146570,MATH 105,A01,085443,Staff,0,21,30,30
1650392152595,MATH 109,A01,083213,Anzaldo; Leesa B,0,6,30,30
1650392152595,MATH 109,A02,083214,Anzaldo; Leesa B,0,7,30,30
1650392152595,MATH 109,B01,083215,Anzaldo; Leesa B,0,5,30,30
1650392152595,MATH 109,B02,083216,Anzaldo; Leesa B,0,5,30,30
1650392158619,MATH 142A,A01,083219,Chow; Bennett,0,14,30,30
1650392158619,MATH 142A,A02,083220,Chow; Bennett,0,13,30,30
1650392158619,MATH 142A,B01,083221,Chow; Bennett,0,12,30,30
1650392158619,MATH 142A,B02,083222,Chow; Bennett,0,12,30,30
1650392164650,MATH 193A,A01,083224,Staff,0,5,30,30
1650392164650,MATH 193A,A02,083225,Staff,0,5,30,30
1650392164650,MATH 193A,A03,083781,Staff,0,4,30,30
1650392164650,MATH 193A,A04,083782,Staff,0,4,30,30
1650392170677,MATH 197,001,091859,McAuley; Julian John,9998,0,9999,1
1650392176740,COGS 9,A01,083615,Staff,0,14,60,60
1650392182771,COGS 11,A01,083617,Boyle; Mary E. T.,22,0,40,18
1650392188795,COGS 13,A01,083071,Staff,0,33,40,40
1650392194820,COGS 14A,A01,092681,Staff,0,23,100,100
1650392200852,COGS 14B,A01,083073,Cheng; Tzu-Han,0,10,50,50
1650392206882,COGS 17,A01,092677,Staff,24,0,75,51
1650392212905,COGS 100,A01,083619,Staff,0,24,60,60
1650392218928,COGS 101A,A01,083621,Davis; Joshua Daniel,0,21,60,60
1650392224955,COGS 101B,A01,091572,Staff,0,1,60,60
1650392230985,COGS 101C,A01,083625,Delgado; Tania,16,0,30,14
1650392237012,COGS 107A,A01,083627,Boyle; Mary E. T.,0,10,60,60
1650392243036,COGS 118A,A01,083075,Staff,4,0,60,56
1650392249063,CSE 3,A50,083646,Miranda; Gregory Joseph,21,0,38,17
1650392249063,CSE 3,A51,083647,Miranda; Gregory Joseph,37,0,37,0
1650392255093,CSE 8A,A50,083650,Miranda; Gregory Joseph,0,28,40,40
1650392261124,CSE 11,A01,083080,Cao; Yingjun,0,89,40,40
1650392267149,CSE 12,A01,083652,Staff,0,14,100,100
1650392273183,CSE 15L,A01,083654,Staff,0,1,50,50
1650392273183,CSE 15L,A02,083655,Staff,1,0,50,49
1650392279215,CSE 20,A01,083657,Staff,51,0,80,29
1650392285242,CSE 30,A01,083084,Eldon; John,0,76,40,40
1650392291268,CSE 100,A01,083659,Cao; Yingjun,0,66,50,50
1650392297296,CSE 134B,A01,083661,Powell; Thomas Allan,0,31,65,65
1650392303340,CSE 140,A01,083663,Staff,0,0,75,75
1650392309371,CSE 140L,A01,083088,Eldon; John,0,7,75,75
1650392315394,CSE 175,A01,083665,Kumar; Rakesh,8,0,25,17
1650392321420,CSE 190,A00,092507,Dubnov; Shlomo,14,0,20,6
1650392327446,ECE 45,A01,083139,Staff,0,17,40,40
1650392333473,ECE 65,A50,083695,Staff,0,5,30,30
1650392339497,ECE 109,A01,091882,Touri; Behrouz,40,0,70,30
1650392345524,ECE 180,A00,083140,Abi Samra; Nicholas Camill,24,0,30,6
1650392345524,ECE 180,B00,083141,Abi Samra; Nicholas Camill,3,0,30,27
1650392351563,MATH 10A,A01,083735,Patchell; Gregory David,7,0,30,23
1650392351563,MATH 10A,A02,083736,Patchell; Gregory David,28,0,30,2
1650392351563,MATH 10A,A03,083737,Patchell; Gregory David,25,0,30,5
1650392357593,MATH 10B,A01,083207,Staff,0,7,30,30
1650392357593,MATH 10B,A02,083208,Staff,0,7,30,30
1650392357593,MATH 10B,B01,083739,Staff,16,0,30,14
1650392357593,MATH 10B,B02,083740,Staff,28,0,30,2
1650392363623,MATH 18,A01,083743,Staff,3,0,30,27
1650392363623,MATH 18,A02,083744,Staff,27,0,30,3
1650392363623,MATH 18,A03,083745,Staff,22,0,30,8
1650392363623,MATH 18,A04,083746,Staff,27,0,30,3
1650392363623,MATH 18,B01,083748,Staff,0,11,30,30
1650392363623,MATH 18,B02,083749,Staff,0,12,30,30
1650392363623,MATH 18,B03,083750,Staff,0,11,30,30
1650392363623,MATH 18,B04,083751,Staff,0,9,30,30
1650392369658,MATH 20A,A01,083754,Staff,26,0,40,14
1650392375684,MATH 20B,A01,083756,Staff,0,8,30,30
1650392375684,MATH 20B,A02,083757,Staff,0,8,30,30
1650392381707,MATH 20C,A01,083760,Staff,0,14,30,30
1650392381707,MATH 20C,A02,083761,Staff,0,15,30,30
1650392381707,MATH 20C,B01,083762,Staff,13,0,30,17
1650392381707,MATH 20C,B02,083763,Staff,28,0,30,2
1650392387734,MATH 20D,A01,083765,Staff,0,1,30,30
1650392387734,MATH 20D,A02,083766,Staff,7,0,30,23
1650392387734,MATH 20D,A03,083767,Staff,26,0,30,4
1650392393763,MATH 20E,A01,083771,Staff,5,0,30,25
1650392393763,MATH 20E,A02,083772,Staff,19,0,30,11
1650392393763,MATH 20E,B01,083773,Staff,0,0,30,30
1650392393763,MATH 20E,B02,083774,Staff,12,0,30,18
1650392399787,MATH 103A,A01,083777,Staff,0,11,30,30
1650392399787,MATH 103A,A02,083778,Staff,0,12,30,30
1650392399787,MATH 103A,B01,083779,Staff,0,13,30,30
1650392399787,MATH 103A,B02,083780,Staff,0,11,30,30
1650392405810,MATH 105,A01,085443,Staff,0,21,30,30
1650392411837,MATH 109,A01,083213,Anzaldo; Leesa B,0,6,30,30
1650392411837,MATH 109,A02,083214,Anzaldo; Leesa B,0,7,30,30
1650392411837,MATH 109,B01,083215,Anzaldo; Leesa B,0,5,30,30
1650392411837,MATH 109,B02,083216,Anzaldo; Leesa B,0,5,30,30
1650392417866,MATH 142A,A01,083219,Chow; Bennett,0,14,30,30
1650392417866,MATH 142A,A02,083220,Chow; Bennett,0,13,30,30
1650392417866,MATH 142A,B01,083221,Chow; Bennett,0,12,30,30
1650392417866,MATH 142A,B02,083222,Chow; Bennett,0,12,30,30
1650392423891,MATH 193A,A01,083224,Staff,0,5,30,30
1650392423891,MATH 193A,A02,083225,Staff,0,5,30,30
1650392423891,MATH 193A,A03,083781,Staff,0,4,30,30
1650392423891,MATH 193A,A04,083782,Staff,0,4,30,30
1650392429914,MATH 197,001,091859,McAuley; Julian John,9998,0,9999,1
1650392435968,COGS 9,A01,083615,Staff,0,14,60,60
1650392441991,COGS 11,A01,083617,Boyle; Mary E. T.,22,0,40,18
1650392448017,COGS 13,A01,083071,Staff,0,33,40,40
1650392454040,COGS 14A,A01,092681,Staff,0,23,100,100
1650392460092,COGS 14B,A01,083073,Cheng; Tzu-Han,0,10,50,50
1650392466123,COGS 17,A01,092677,Staff,24,0,75,51
1650392472151,COGS 100,A01,083619,Staff,0,24,60,60
1650392478210,COGS 101A,A01,083621,Davis; Joshua Daniel,0,21,60,60
1650392484240,COGS 101B,A01,091572,Staff,0,1,60,60
1650392490265,COGS 101C,A01,083625,Delgado; Tania,16,0,30,14
1650392496294,COGS 107A,A01,083627,Boyle; Mary E. T.,0,10,60,60
1650392502318,COGS 118A,A01,083075,Staff,4,0,60,56
1650392508345,CSE 3,A50,083646,Miranda; Gregory Joseph,21,0,38,17
1650392508345,CSE 3,A51,083647,Miranda; Gregory Joseph,37,0,37,0
1650392514368,CSE 8A,A50,083650,Miranda; Gregory Joseph,0,28,40,40
1650392520523,CSE 11,A01,083080,Cao; Yingjun,0,89,40,40
1650392526547,CSE 12,A01,083652,Staff,0,14,100,100
1650392532574,CSE 15L,A01,083654,Staff,0,1,50,50
1650392532574,CSE 15L,A02,083655,Staff,1,0,50,49
1650392538608,CSE 20,A01,083657,Staff,51,0,80,29
1650392544642,CSE 30,A01,083084,Eldon; John,0,76,40,40
1650392550664,CSE 100,A01,083659,Cao; Yingjun,0,66,50,50
1650392556691,CSE 134B,A01,083661,Powell; Thomas Allan,0,31,65,65
1650392562714,CSE 140,A01,083663,Staff,0,0,75,75
1650392568741,CSE 140L,A01,083088,Eldon; John,0,7,75,75
1650392574777,CSE 175,A01,083665,Kumar; Rakesh,8,0,25,17
1650392580799,CSE 190,A00,092507,Dubnov; Shlomo,14,0,20,6
1650392586821,ECE 45,A01,083139,Staff,0,17,40,40
1650392592845,ECE 65,A50,083695,Staff,0,5,30,30
1650392598878,ECE 109,A01,091882,Touri; Behrouz,40,0,70,30
1650392604908,ECE 180,A00,083140,Abi Samra; Nicholas Camill,24,0,30,6
1650392604908,ECE 180,B00,083141,Abi Samra; Nicholas Camill,2,0,30,28
1650392610941,MATH 10A,A01,083735,Patchell; Gregory David,7,0,30,23
1650392610941,MATH 10A,A02,083736,Patchell; Gregory David,28,0,30,2
1650392610941,MATH 10A,A03,083737,Patchell; Gregory David,25,0,30,5
1650392616979,MATH 10B,A01,083207,Staff,0,7,30,30
1650392616979,MATH 10B,A02,083208,Staff,0,7,30,30
1650392616979,MATH 10B,B01,083739,Staff,16,0,30,14
1650392616979,MATH 10B,B02,083740,Staff,28,0,30,2
1650392623013,MATH 18,A01,083743,Staff,3,0,30,27
1650392623013,MATH 18,A02,083744,Staff,27,0,30,3
1650392623013,MATH 18,A03,083745,Staff,22,0,30,8
1650392623013,MATH 18,A04,083746,Staff,27,0,30,3
1650392623013,MATH 18,B01,083748,Staff,0,11,30,30
1650392623013,MATH 18,B02,083749,Staff,0,12,30,30
1650392623013,MATH 18,B03,083750,Staff,0,11,30,30
1650392623013,MATH 18,B04,083751,Staff,0,9,30,30
1650392629036,MATH 20A,A01,083754,Staff,26,0,40,14
1650392635060,MATH 20B,A01,083756,Staff,0,8,30,30
1650392635060,MATH 20B,A02,083757,Staff,0,8,30,30
1650392641088,MATH 20C,A01,083760,Staff,0,14,30,30
1650392641088,MATH 20C,A02,083761,Staff,0,15,30,30
1650392641088,MATH 20C,B01,083762,Staff,13,0,30,17
1650392641088,MATH 20C,B02,083763,Staff,28,0,30,2
1650392647112,MATH 20D,A01,083765,Staff,0,1,30,30
1650392647112,MATH 20D,A02,083766,Staff,7,0,30,23
1650392647112,MATH 20D,A03,083767,Staff,26,0,30,4
1650392653141,MATH 20E,A01,083771,Staff,5,0,30,25
1650392653141,MATH 20E,A02,083772,Staff,19,0,30,11
1650392653141,MATH 20E,B01,083773,Staff,0,0,30,30
1650392653141,MATH 20E,B02,083774,Staff,12,0,30,18
1650392659166,MATH 103A,A01,083777,Staff,0,11,30,30
1650392659166,MATH 103A,A02,083778,Staff,0,12,30,30
1650392659166,MATH 103A,B01,083779,Staff,0,13,30,30
1650392659166,MATH 103A,B02,083780,Staff,0,11,30,30
1650392665194,MATH 105,A01,085443,Staff,0,21,30,30
1650392671228,MATH 109,A01,083213,Anzaldo; Leesa B,0,6,30,30
1650392671228,MATH 109,A02,083214,Anzaldo; Leesa B,0,7,30,30
1650392671228,MATH 109,B01,083215,Anzaldo; Leesa B,0,5,30,30
1650392671228,MATH 109,B02,083216,Anzaldo; Leesa B,0,5,30,30
1650392677256,MATH 142A,A01,083219,Chow; Bennett,0,14,30,30
1650392677256,MATH 142A,A02,083220,Chow; Bennett,0,13,30,30
1650392677256,MATH 142A,B01,083221,Chow; Bennett,0,12,30,30
1650392677256,MATH 142A,B02,083222,Chow; Bennett,0,12,30,30
1650392683286,MATH 193A,A01,083224,Staff,0,5,30,30
1650392683286,MATH 193A,A02,083225,Staff,0,5,30,30
1650392683286,MATH 193A,A03,083781,Staff,0,4,30,30
1650392683286,MATH 193A,A04,083782,Staff,0,4,30,30
1650392689309,MATH 197,001,091859,McAuley; Julian John,9998,0,9999,1
1650392695380,COGS 9,A01,083615,Staff,0,14,60,60
1650392701403,COGS 11,A01,083617,Boyle; Mary E. T.,22,0,40,18
1650392707431,COGS 13,A01,083071,Staff,0,33,40,40
1650392713457,COGS 14A,A01,092681,Staff,0,23,100,100
1650392719482,COGS 14B,A01,083073,Cheng; Tzu-Han,0,10,50,50
1650392725507,COGS 17,A01,092677,Staff,24,0,75,51
1650392731533,COGS 100,A01,083619,Staff,0,24,60,60
1650392737560,COGS 101A,A01,083621,Davis; Joshua Daniel,0,21,60,60
1650392743583,COGS 101B,A01,091572,Staff,0,1,60,60
1650392749609,COGS 101C,A01,083625,Delgado; Tania,16,0,30,14
1650392755635,COGS 107A,A01,083627,Boyle; Mary E. T.,0,10,60,60
1650392761676,COGS 118A,A01,083075,Staff,4,0,60,56
1650392767704,CSE 3,A50,083646,Miranda; Gregory Joseph,21,0,38,17
1650392767704,CSE 3,A51,083647,Miranda; Gregory Joseph,37,0,37,0
1650392773733,CSE 8A,A50,083650,Miranda; Gregory Joseph,0,28,40,40
1650392779762,CSE 11,A01,083080,Cao; Yingjun,0,89,40,40
1650392785786,CSE 12,A01,083652,Staff,0,14,100,100
1650392791813,CSE 15L,A01,083654,Staff,0,1,50,50
1650392791813,CSE 15L,A02,083655,Staff,1,0,50,49
1650392797839,CSE 20,A01,083657,Staff,51,0,80,29
1650392803868,CSE 30,A01,083084,Eldon; John,0,76,40,40
1650392809910,CSE 100,A01,083659,Cao; Yingjun,0,66,50,50
1650392815936,CSE 134B,A01,083661,Powell; Thomas Allan,0,31,65,65
1650392821972,CSE 140,A01,083663,Staff,0,0,75,75
1650392828005,CSE 140L,A01,083088,Eldon; John,0,7,75,75
1650392834030,CSE 175,A01,083665,Kumar; Rakesh,8,0,25,17
1650392840061,CSE 190,A00,092507,Dubnov; Shlomo,14,0,20,6
1650392846089,ECE 45,A01,083139,Staff,0,17,40,40
1650392852115,ECE 65,A50,083695,Staff,0,5,30,30
1650392858139,ECE 109,A01,091882,Touri; Behrouz,40,0,70,30
1650392864166,ECE 180,A00,083140,Abi Samra; Nicholas Camill,24,0,30,6
1650392864166,ECE 180,B00,083141,Abi Samra; Nicholas Camill,2,0,30,28
1650392870194,MATH 10A,A01,083735,Patchell; Gregory David,7,0,30,23
1650392870194,MATH 10A,A02,083736,Patchell; Gregory David,28,0,30,2
1650392870194,MATH 10A,A03,083737,Patchell; Gregory David,25,0,30,5
1650392876238,MATH 10B,A01,083207,Staff,0,7,30,30
1650392876238,MATH 10B,A02,083208,Staff,0,7,30,30
1650392876238,MATH 10B,B01,083739,Staff,16,0,30,14
1650392876238,MATH 10B,B02,083740,Staff,28,0,30,2
1650392882264,MATH 18,A01,083743,Staff,3,0,30,27
1650392882264,MATH 18,A02,083744,Staff,27,0,30,3
1650392882264,MATH 18,A03,083745,Staff,22,0,30,8
1650392882264,MATH 18,A04,083746,Staff,27,0,30,3
1650392882264,MATH 18,B01,083748,Staff,0,11,30,30
1650392882264,MATH 18,B02,083749,Staff,0,12,30,30
1650392882264,MATH 18,B03,083750,Staff,0,11,30,30
1650392882264,MATH 18,B04,083751,Staff,0,9,30,30
1650392888292,MATH 20A,A01,083754,Staff,26,0,40,14
1650392894317,MATH 20B,A01,083756,Staff,0,8,30,30
1650392894317,MATH 20B,A02,083757,Staff,0,8,30,30
1650392900340,MATH 20C,A01,083760,Staff,0,14,30,30
1650392900340,MATH 20C,A02,083761,Staff,0,15,30,30
1650392900340,MATH 20C,B01,083762,Staff,13,0,30,17
1650392900340,MATH 20C,B02,083763,Staff,28,0,30,2
1650392906368,MATH 20D,A01,083765,Staff,0,1,30,30
1650392906368,MATH 20D,A02,083766,Staff,7,0,30,23
1650392906368,MATH 20D,A03,083767,Staff,26,0,30,4
1650392912393,MATH 20E,A01,083771,Staff,5,0,30,25
1650392912393,MATH 20E,A02,083772,Staff,19,0,30,11
1650392912393,MATH 20E,B01,083773,Staff,0,0,30,30
1650392912393,MATH 20E,B02,083774,Staff,12,0,30,18
1650392918418,MATH 103A,A01,083777,Staff,0,11,30,30
1650392918418,MATH 103A,A02,083778,Staff,0,12,30,30
1650392918418,MATH 103A,B01,083779,Staff,0,13,30,30
1650392918418,MATH 103A,B02,083780,Staff,0,11,30,30
1650392924445,MATH 105,A01,085443,Staff,0,21,30,30
1650392930474,MATH 109,A01,083213,Anzaldo; Leesa B,0,6,30,30
1650392930474,MATH 109,A02,083214,Anzaldo; Leesa B,0,7,30,30
1650392930474,MATH 109,B01,083215,Anzaldo; Leesa B,0,5,30,30
1650392930474,MATH 109,B02,083216,Anzaldo; Leesa B,0,5,30,30
1650392936500,MATH 142A,A01,083219,Chow; Bennett,0,14,30,30
1650392936500,MATH 142A,A02,083220,Chow; Bennett,0,13,30,30
1650392936500,MATH 142A,B01,083221,Chow; Bennett,0,12,30,30
1650392936500,MATH 142A,B02,083222,Chow; Bennett,0,12,30,30
1650392942536,MATH 193A,A01,083224,Staff,0,5,30,30
1650392942536,MATH 193A,A02,083225,Staff,0,5,30,30
1650392942536,MATH 193A,A03,083781,Staff,0,4,30,30
1650392942536,MATH 193A,A04,083782,Staff,0,4,30,30
1650392948567,MATH 197,001,091859,McAuley; Julian John,9998,0,9999,1
1650392954636,COGS 9,A01,083615,Staff,0,14,60,60
1650392960663,COGS 11,A01,083617,Boyle; Mary E. T.,22,0,40,18
1650392966697,COGS 13,A01,083071,Staff,0,33,40,40
1650392972732,COGS 14A,A01,092681,Staff,0,23,100,100
1650392978769,COGS 14B,A01,083073,Cheng; Tzu-Han,0,10,50,50
1650392984803,COGS 17,A01,092677,Staff,24,0,75,51
1650392990827,COGS 100,A01,083619,Staff,0,24,60,60
1650392996862,COGS 101A,A01,083621,Davis; Joshua Daniel,0,21,60,60
1650393002889,COGS 101B,A01,091572,Staff,0,2,60,60
1650393008918,COGS 101C,A01,083625,Delgado; Tania,16,0,30,14
1650393014942,COGS 107A,A01,083627,Boyle; Mary E. T.,0,10,60,60
1650393020965,COGS 118A,A01,083075,Staff,4,0,60,56
1650393026988,CSE 3,A50,083646,Miranda; Gregory Joseph,21,0,38,17
1650393026988,CSE 3,A51,083647,Miranda; Gregory Joseph,37,0,37,0
1650393033014,CSE 8A,A50,083650,Miranda; Gregory Joseph,0,28,40,40
1650393039040,CSE 11,A01,083080,Cao; Yingjun,0,89,40,40
1650393045063,CSE 12,A01,083652,Staff,0,14,100,100
1650393051089,CSE 15L,A01,083654,Staff,0,1,50,50
1650393051089,CSE 15L,A02,083655,Staff,1,0,50,49
1650393057124,CSE 20,A01,083657,Staff,51,0,80,29
1650393063151,CSE 30,A01,083084,Eldon; John,0,76,40,40
1650393069180,CSE 100,A01,083659,Cao; Yingjun,0,66,50,50
1650393075207,CSE 134B,A01,083661,Powell; Thomas Allan,0,31,65,65
1650393081239,CSE 140,A01,083663,Staff,0,0,75,75
1650393087271,CSE 140L,A01,083088,Eldon; John,0,7,75,75
1650393093305,CSE 175,A01,083665,Kumar; Rakesh,8,0,25,17
1650393099332,CSE 190,A00,092507,Dubnov; Shlomo,14,0,20,6
1650393105362,ECE 45,A01,083139,Staff,0,17,40,40
1650393111385,ECE 65,A50,083695,Staff,0,5,30,30
1650393117502,ECE 109,A01,091882,Touri; Behrouz,40,0,70,30
1650393123525,ECE 180,A00,083140,Abi Samra; Nicholas Camill,24,0,30,6
1650393123525,ECE 180,B00,083141,Abi Samra; Nicholas Camill,2,0,30,28
1650393129556,MATH 10A,A01,083735,Patchell; Gregory David,7,0,30,23
1650393129556,MATH 10A,A02,083736,Patchell; Gregory David,28,0,30,2
1650393129556,MATH 10A,A03,083737,Patchell; Gregory David,25,0,30,5
1650393135582,MATH 10B,A01,083207,Staff,0,7,30,30
1650393135582,MATH 10B,A02,083208,Staff,0,7,30,30
1650393135582,MATH 10B,B01,083739,Staff,16,0,30,14
1650393135582,MATH 10B,B02,083740,Staff,28,0,30,2
1650393141611,MATH 18,A01,083743,Staff,3,0,30,27
1650393141611,MATH 18,A02,083744,Staff,27,0,30,3
1650393141611,MATH 18,A03,083745,Staff,22,0,30,8
1650393141611,MATH 18,A04,083746,Staff,27,0,30,3
1650393141611,MATH 18,B01,083748,Staff,0,11,30,30
1650393141611,MATH 18,B02,083749,Staff,0,12,30,30
1650393141611,MATH 18,B03,083750,Staff,0,11,30,30
1650393141611,MATH 18,B04,083751,Staff,0,9,30,30
1650393147635,MATH 20A,A01,083754,Staff,26,0,40,14
1650393153661,MATH 20B,A01,083756,Staff,0,8,30,30
1650393153661,MATH 20B,A02,083757,Staff,0,8,30,30
1650393159696,MATH 20C,A01,083760,Staff,0,14,30,30
1650393159696,MATH 20C,A02,083761,Staff,0,15,30,30
1650393159696,MATH 20C,B01,083762,Staff,13,0,30,17
1650393159696,MATH 20C,B02,083763,Staff,28,0,30,2
1650393165720,MATH 20D,A01,083765,Staff,0,1,30,30
1650393165720,MATH 20D,A02,083766,Staff,7,0,30,23
1650393165720,MATH 20D,A03,083767,Staff,26,0,30,4
1650393171744,MATH 20E,A01,083771,Staff,5,0,30,25
1650393171744,MATH 20E,A02,083772,Staff,19,0,30,11
1650393171744,MATH 20E,B01,083773,Staff,0,0,30,30
1650393171744,MATH 20E,B02,083774,Staff,12,0,30,18
1650393177775,MATH 103A,A01,083777,Staff,0,11,30,30
1650393177775,MATH 103A,A02,083778,Staff,0,12,30,30
1650393177775,MATH 103A,B01,083779,Staff,0,13,30,30
1650393177775,MATH 103A,B02,083780,Staff,0,11,30,30
1650393183810,MATH 105,A01,085443,Staff,0,21,30,30
1650393189836,MATH 109,A01,083213,Anzaldo; Leesa B,0,6,30,30
1650393189836,MATH 109,A02,083214,Anzaldo; Leesa B,0,7,30,30
1650393189836,MATH 109,B01,083215,Anzaldo; Leesa B,0,5,30,30
1650393189836,MATH 109,B02,083216,Anzaldo; Leesa B,0,5,30,30
1650393195874,MATH 142A,A01,083219,Chow; Bennett,0,14,30,30
1650393195874,MATH 142A,A02,083220,Chow; Bennett,0,13,30,30
1650393195874,MATH 142A,B01,083221,Chow; Bennett,0,12,30,30
1650393195874,MATH 142A,B02,083222,Chow; Bennett,0,12,30,30
1650393201897,MATH 193A,A01,083224,Staff,0,5,30,30
1650393201897,MATH 193A,A02,083225,Staff,0,5,30,30
1650393201897,MATH 193A,A03,083781,Staff,0,4,30,30
1650393201897,MATH 193A,A04,083782,Staff,0,4,30,30
1650393207933,MATH 197,001,091859,McAuley; Julian John,9998,0,9999,1
1650393213992,COGS 9,A01,083615,Staff,0,14,60,60
1650393220024,COGS 11,A01,083617,Boyle; Mary E. T.,22,0,40,18
1650393226048,COGS 13,A01,083071,Staff,0,33,40,40
1650393232079,COGS 14A,A01,092681,Staff,0,23,100,100
1650393238104,COGS 14B,A01,083073,Cheng; Tzu-Han,0,10,50,50
1650393244128,COGS 17,A01,092677,Staff,24,0,75,51
1650393250153,COGS 100,A01,083619,Staff,0,24,60,60
1650393256196,COGS 101A,A01,083621,Davis; Joshua Daniel,0,21,60,60
1650393262220,COGS 101B,A01,091572,Staff,0,2,60,60
1650393268243,COGS 101C,A01,083625,Delgado; Tania,16,0,30,14
1650393274293,COGS 107A,A01,083627,Boyle; Mary E. T.,0,10,60,60
1650393280320,COGS 118A,A01,083075,Staff,4,0,60,56
1650393286349,CSE 3,A50,083646,Miranda; Gregory Joseph,21,0,38,17
1650393286349,CSE 3,A51,083647,Miranda; Gregory Joseph,37,0,37,0
1650393292376,CSE 8A,A50,083650,Miranda; Gregory Joseph,0,28,40,40
1650393298406,CSE 11,A01,083080,Cao; Yingjun,0,89,40,40
1650393304431,CSE 12,A01,083652,Staff,0,14,100,100
1650393310458,CSE 15L,A01,083654,Staff,0,1,50,50
1650393310458,CSE 15L,A02,083655,Staff,1,0,50,49
1650393316485,CSE 20,A01,083657,Staff,51,0,80,29
1650393322508,CSE 30,A01,083084,Eldon; John,0,76,40,40
1650393328538,CSE 100,A01,083659,Cao; Yingjun,0,66,50,50
1650393334586,CSE 134B,A01,083661,Powell; Thomas Allan,0,31,65,65
1650393340622,CSE 140,A01,083663,Staff,0,0,75,75
1650393346646,CSE 140L,A01,083088,Eldon; John,0,7,75,75
1650393352683,CSE 175,A01,083665,Kumar; Rakesh,8,0,25,17
1650393358717,CSE 190,A00,092507,Dubnov; Shlomo,14,0,20,6
1650393364744,ECE 45,A01,083139,Staff,0,17,40,40
1650393370775,ECE 65,A50,083695,Staff,0,5,30,30
1650393376799,ECE 109,A01,091882,Touri; Behrouz,40,0,70,30
1650393382824,ECE 180,A00,083140,Abi Samra; Nicholas Camill,24,0,30,6
1650393382824,ECE 180,B00,083141,Abi Samra; Nicholas Camill,2,0,30,28
1650393388854,MATH 10A,A01,083735,Patchell; Gregory David,7,0,30,23
1650393388854,MATH 10A,A02,083736,Patchell; Gregory David,28,0,30,2
1650393388854,MATH 10A,A03,083737,Patchell; Gregory David,25,0,30,5
1650393394882,MATH 10B,A01,083207,Staff,0,7,30,30
1650393394882,MATH 10B,A02,083208,Staff,0,7,30,30
1650393394882,MATH 10B,B01,083739,Staff,16,0,30,14
1650393394882,MATH 10B,B02,083740,Staff,28,0,30,2
1650393400906,MATH 18,A01,083743,Staff,3,0,30,27
1650393400906,MATH 18,A02,083744,Staff,27,0,30,3
1650393400906,MATH 18,A03,083745,Staff,22,0,30,8
1650393400906,MATH 18,A04,083746,Staff,27,0,30,3
1650393400906,MATH 18,B01,083748,Staff,0,11,30,30
1650393400906,MATH 18,B02,083749,Staff,0,12,30,30
1650393400906,MATH 18,B03,083750,Staff,0,11,30,30
1650393400906,MATH 18,B04,083751,Staff,0,9,30,30
1650393406937,MATH 20A,A01,083754,Staff,26,0,40,14
1650393412966,MATH 20B,A01,083756,Staff,0,8,30,30
1650393412966,MATH 20B,A02,083757,Staff,0,8,30,30
1650393418990,MATH 20C,A01,083760,Staff,0,14,30,30
1650393418990,MATH 20C,A02,083761,Staff,0,15,30,30
1650393418990,MATH 20C,B01,083762,Staff,13,0,30,17
1650393418990,MATH 20C,B02,083763,Staff,28,0,30,2
1650393425015,MATH 20D,A01,083765,Staff,0,1,30,30
1650393425015,MATH 20D,A02,083766,Staff,7,0,30,23
1650393425015,MATH 20D,A03,083767,Staff,26,0,30,4
1650393431046,MATH 20E,A01,083771,Staff,5,0,30,25
1650393431046,MATH 20E,A02,083772,Staff,19,0,30,11
1650393431046,MATH 20E,B01,083773,Staff,0,0,30,30
1650393431046,MATH 20E,B02,083774,Staff,12,0,30,18
1650393437071,MATH 103A,A01,083777,Staff,0,11,30,30
1650393437071,MATH 103A,A02,083778,Staff,0,12,30,30
1650393437071,MATH 103A,B01,083779,Staff,0,13,30,30
1650393437071,MATH 103A,B02,083780,Staff,0,11,30,30
1650393443104,MATH 105,A01,085443,Staff,0,21,30,30
1650393449137,MATH 109,A01,083213,Anzaldo; Leesa B,0,6,30,30
1650393449137,MATH 109,A02,083214,Anzaldo; Leesa B,0,7,30,30
1650393449137,MATH 109,B01,083215,Anzaldo; Leesa B,0,5,30,30
1650393449137,MATH 109,B02,083216,Anzaldo; Leesa B,0,5,30,30
1650393455176,MATH 142A,A01,083219,Chow; Bennett,0,14,30,30
1650393455176,MATH 142A,A02,083220,Chow; Bennett,0,13,30,30
1650393455176,MATH 142A,B01,083221,Chow; Bennett,0,12,30,30
1650393455176,MATH 142A,B02,083222,Chow; Bennett,0,12,30,30
1650393461208,MATH 193A,A01,083224,Staff,0,5,30,30
1650393461208,MATH 193A,A02,083225,Staff,0,5,30,30
1650393461208,MATH 193A,A03,083781,Staff,0,4,30,30
1650393461208,MATH 193A,A04,083782,Staff,0,4,30,30
1650393467240,MATH 197,001,091859,McAuley; Julian John,9998,0,9999,1
1650393473290,COGS 9,A01,083615,Staff,0,14,60,60
1650393479314,COGS 11,A01,083617,Boyle; Mary E. T.,22,0,40,18
1650393485340,COGS 13,A01,083071,Staff,0,33,40,40
1650393491363,COGS 14A,A01,092681,Staff,0,23,100,100
1650393497397,COGS 14B,A01,083073,Cheng; Tzu-Han,0,10,50,50
1650393503421,COGS 17,A01,092677,Staff,24,0,75,51
1650393509453,COGS 100,A01,083619,Staff,0,24,60,60
1650393515479,COGS 101A,A01,083621,Davis; Joshua Daniel,0,21,60,60
1650393521516,COGS 101B,A01,091572,Staff,0,2,60,60
1650393527551,COGS 101C,A01,083625,Delgado; Tania,16,0,30,14
1650393533585,COGS 107A,A01,083627,Boyle; Mary E. T.,0,10,60,60
1650393539608,COGS 118A,A01,083075,Staff,4,0,60,56
1650393545632,CSE 3,A50,083646,Miranda; Gregory Joseph,21,0,38,17
1650393545632,CSE 3,A51,083647,Miranda; Gregory Joseph,37,0,37,0
1650393551660,CSE 8A,A50,083650,Miranda; Gregory Joseph,0,28,40,40
1650393557686,CSE 11,A01,083080,Cao; Yingjun,0,89,40,40
1650393563723,CSE 12,A01,083652,Staff,0,14,100,100
1650393569758,CSE 15L,A01,083654,Staff,0,1,50,50
1650393569758,CSE 15L,A02,083655,Staff,1,0,50,49
1650393575790,CSE 20,A01,083657,Staff,51,0,80,29
1650393581813,CSE 30,A01,083084,Eldon; John,0,76,40,40
1650393587838,CSE 100,A01,083659,Cao; Yingjun,0,66,50,50
1650393593861,CSE 134B,A01,083661,Powell; Thomas Allan,0,31,65,65
1650393599885,CSE 140,A01,083663,Staff,0,0,75,75
1650393605916,CSE 140L,A01,083088,Eldon; John,0,7,75,75
1650393611940,CSE 175,A01,083665,Kumar; Rakesh,8,0,25,17
1650393617973,CSE 190,A00,092507,Dubnov; Shlomo,14,0,20,6
1650393623999,ECE 45,A01,083139,Staff,0,17,40,40
1650393630026,ECE 65,A50,083695,Staff,0,5,30,30
1650393636055,ECE 109,A01,091882,Touri; Behrouz,40,0,70,30
1650393642089,ECE 180,A00,083140,Abi Samra; Nicholas Camill,24,0,30,6
1650393642089,ECE 180,B00,083141,Abi Samra; Nicholas Camill,2,0,30,28
1650393648112,MATH 10A,A01,083735,Patchell; Gregory David,7,0,30,23
1650393648112,MATH 10A,A02,083736,Patchell; Gregory David,28,0,30,2
1650393648112,MATH 10A,A03,083737,Patchell; Gregory David,25,0,30,5
1650393654136,MATH 10B,A01,083207,Staff,0,7,30,30
1650393654136,MATH 10B,A02,083208,Staff,0,7,30,30
1650393654136,MATH 10B,B01,083739,Staff,16,0,30,14
1650393654136,MATH 10B,B02,083740,Staff,28,0,30,2
1650393660163,MATH 18,A01,083743,Staff,3,0,30,27
1650393660163,MATH 18,A02,083744,Staff,27,0,30,3
1650393660163,MATH 18,A03,083745,Staff,22,0,30,8
1650393660163,MATH 18,A04,083746,Staff,27,0,30,3
1650393660163,MATH 18,B01,083748,Staff,0,11,30,30
1650393660163,MATH 18,B02,083749,Staff,0,12,30,30
1650393660163,MATH 18,B03,083750,Staff,0,11,30,30
1650393660163,MATH 18,B04,083751,Staff,0,9,30,30
1650393666194,MATH 20A,A01,083754,Staff,26,0,40,14
1650393672217,MATH 20B,A01,083756,Staff,0,8,30,30
1650393672217,MATH 20B,A02,083757,Staff,0,8,30,30
1650393678240,MATH 20C,A01,083760,Staff,0,14,30,30
1650393678240,MATH 20C,A02,083761,Staff,0,15,30,30
1650393678240,MATH 20C,B01,083762,Staff,13,0,30,17
1650393678240,MATH 20C,B02,083763,Staff,28,0,30,2
1650393684270,MATH 20D,A01,083765,Staff,0,1,30,30
1650393684270,MATH 20D,A02,083766,Staff,7,0,30,23
1650393684270,MATH 20D,A03,083767,Staff,26,0,30,4
1650393690307,MATH 20E,A01,083771,Staff,5,0,30,25
1650393690307,MATH 20E,A02,083772,Staff,19,0,30,11
1650393690307,MATH 20E,B01,083773,Staff,0,0,30,30
1650393690307,MATH 20E,B02,083774,Staff,12,0,30,18
1650393696335,MATH 103A,A01,083777,Staff,0,11,30,30
1650393696335,MATH 103A,A02,083778,Staff,0,12,30,30
1650393696335,MATH 103A,B01,083779,Staff,0,13,30,30
1650393696335,MATH 103A,B02,083780,Staff,0,11,30,30
1650393702364,MATH 105,A01,085443,Staff,0,21,30,30
1650393708397,MATH 109,A01,083213,Anzaldo; Leesa B,0,7,30,30
1650393708397,MATH 109,A02,083214,Anzaldo; Leesa B,0,7,30,30
1650393708397,MATH 109,B01,083215,Anzaldo; Leesa B,0,5,30,30
1650393708397,MATH 109,B02,083216,Anzaldo; Leesa B,0,5,30,30
1650393714494,MATH 142A,A01,083219,Chow; Bennett,0,14,30,30
1650393714494,MATH 142A,A02,083220,Chow; Bennett,0,13,30,30
1650393714494,MATH 142A,B01,083221,Chow; Bennett,0,12,30,30
1650393714494,MATH 142A,B02,083222,Chow; Bennett,0,12,30,30
1650393720517,MATH 193A,A01,083224,Staff,0,5,30,30
1650393720517,MATH 193A,A02,083225,Staff,0,5,30,30
1650393720517,MATH 193A,A03,083781,Staff,0,4,30,30
1650393720517,MATH 193A,A04,083782,Staff,0,4,30,30
1650393726554,MATH 197,001,091859,McAuley; Julian John,9998,0,9999,1
1650393732605,COGS 9,A01,083615,Staff,0,14,60,60
1650393738633,COGS 11,A01,083617,Boyle; Mary E. T.,22,0,40,18
1650393744662,COGS 13,A01,083071,Staff,0,33,40,40
1650393750718,COGS 14A,A01,092681,Staff,0,23,100,100
1650393756742,COGS 14B,A01,083073,Cheng; Tzu-Han,0,10,50,50
1650393762780,COGS 17,A01,092677,Staff,24,0,75,51
1650393768802,COGS 100,A01,083619,Staff,0,24,60,60
1650393774829,COGS 101A,A01,083621,Davis; Joshua Daniel,0,21,60,60
1650393780855,COGS 101B,A01,091572,Staff,0,2,60,60
1650393786878,COGS 101C,A01,083625,Delgado; Tania,16,0,30,14
1650393792904,COGS 107A,A01,083627,Boyle; Mary E. T.,0,10,60,60
1650393798929,COGS 118A,A01,083075,Staff,4,0,60,56
1650393804954,CSE 3,A50,083646,Miranda; Gregory Joseph,21,0,38,17
1650393804954,CSE 3,A51,083647,Miranda; Gregory Joseph,37,0,37,0
1650393810981,CSE 8A,A50,083650,Miranda; Gregory Joseph,0,28,40,40
1650393817009,CSE 11,A01,083080,Cao; Yingjun,0,89,40,40
1650393823036,CSE 12,A01,083652,Staff,0,14,100,100
1650393829069,CSE 15L,A01,083654,Staff,0,1,50,50
1650393829069,CSE 15L,A02,083655,Staff,1,0,50,49
1650393835096,CSE 20,A01,083657,Staff,51,0,80,29
1650393841123,CSE 30,A01,083084,Eldon; John,0,76,40,40
1650393847156,CSE 100,A01,083659,Cao; Yingjun,0,66,50,50
1650393853184,CSE 134B,A01,083661,Powell; Thomas Allan,0,31,65,65
1650393859210,CSE 140,A01,083663,Staff,0,0,75,75
1650393865238,CSE 140L,A01,083088,Eldon; John,0,7,75,75
1650393871260,CSE 175,A01,083665,Kumar; Rakesh,8,0,25,17
1650393877286,CSE 190,A00,092507,Dubnov; Shlomo,14,0,20,6
1650393883319,ECE 45,A01,083139,Staff,0,17,40,40
1650393889345,ECE 65,A50,083695,Staff,0,5,30,30
1650393895371,ECE 109,A01,091882,Touri; Behrouz,40,0,70,30
1650393901393,ECE 180,A00,083140,Abi Samra; Nicholas Camill,24,0,30,6
1650393901393,ECE 180,B00,083141,Abi Samra; Nicholas Camill,2,0,30,28
1650393907421,MATH 10A,A01,083735,Patchell; Gregory David,7,0,30,23
1650393907421,MATH 10A,A02,083736,Patchell; Gregory David,28,0,30,2
1650393907421,MATH 10A,A03,083737,Patchell; Gregory David,25,0,30,5
1650393913444,MATH 10B,A01,083207,Staff,0,7,30,30
1650393913444,MATH 10B,A02,083208,Staff,0,7,30,30
1650393913444,MATH 10B,B01,083739,Staff,16,0,30,14
1650393913444,MATH 10B,B02,083740,Staff,28,0,30,2
1650393919473,MATH 18,A01,083743,Staff,3,0,30,27
1650393919473,MATH 18,A02,083744,Staff,27,0,30,3
1650393919473,MATH 18,A03,083745,Staff,22,0,30,8
1650393919473,MATH 18,A04,083746,Staff,27,0,30,3
1650393919473,MATH 18,B01,083748,Staff,0,11,30,30
1650393919473,MATH 18,B02,083749,Staff,0,12,30,30
1650393919473,MATH 18,B03,083750,Staff,0,11,30,30
1650393919473,MATH 18,B04,083751,Staff,0,9,30,30
1650393925506,MATH 20A,A01,083754,Staff,26,0,40,14
1650393931544,MATH 20B,A01,083756,Staff,0,8,30,30
1650393931544,MATH 20B,A02,083757,Staff,0,8,30,30
1650393937568,MATH 20C,A01,083760,Staff,0,14,30,30
1650393937568,MATH 20C,A02,083761,Staff,0,15,30,30
1650393937568,MATH 20C,B01,083762,Staff,13,0,30,17
1650393937568,MATH 20C,B02,083763,Staff,28,0,30,2
1650393943594,MATH 20D,A01,083765,Staff,0,1,30,30
1650393943594,MATH 20D,A02,083766,Staff,7,0,30,23
1650393943594,MATH 20D,A03,083767,Staff,26,0,30,4
1650393949621,MATH 20E,A01,083771,Staff,5,0,30,25
1650393949621,MATH 20E,A02,083772,Staff,19,0,30,11
1650393949621,MATH 20E,B01,083773,Staff,0,0,30,30
1650393949621,MATH 20E,B02,083774,Staff,12,0,30,18
1650393955654,MATH 103A,A01,083777,Staff,0,11,30,30
1650393955654,MATH 103A,A02,083778,Staff,0,12,30,30
1650393955654,MATH 103A,B01,083779,Staff,0,13,30,30
1650393955654,MATH 103A,B02,083780,Staff,0,11,30,30
1650393961687,MATH 105,A01,085443,Staff,0,21,30,30
1650393967711,MATH 109,A01,083213,Anzaldo; Leesa B,0,7,30,30
1650393967711,MATH 109,A02,083214,Anzaldo; Leesa B,0,7,30,30
1650393967711,MATH 109,B01,083215,Anzaldo; Leesa B,0,5,30,30
1650393967711,MATH 109,B02,083216,Anzaldo; Leesa B,0,5,30,30
1650393973738,MATH 142A,A01,083219,Chow; Bennett,0,14,30,30
1650393973738,MATH 142A,A02,083220,Chow; Bennett,0,13,30,30
1650393973738,MATH 142A,B01,083221,Chow; Bennett,0,12,30,30
1650393973738,MATH 142A,B02,083222,Chow; Bennett,0,12,30,30
1650393979764,MATH 193A,A01,083224,Staff,0,5,30,30
1650393979764,MATH 193A,A02,083225,Staff,0,5,30,30
1650393979764,MATH 193A,A03,083781,Staff,0,4,30,30
1650393979764,MATH 193A,A04,083782,Staff,0,4,30,30
1650393985797,MATH 197,001,091859,McAuley; Julian John,9998,0,9999,1
1650393991850,COGS 9,A01,083615,Staff,0,14,60,60
1650393997874,COGS 11,A01,083617,Boyle; Mary E. T.,22,0,40,18
1650394003897,COGS 13,A01,083071,Staff,0,33,40,40
1650394009922,COGS 14A,A01,092681,Staff,0,23,100,100
1650394015945,COGS 14B,A01,083073,Cheng; Tzu-Han,0,10,50,50
1650394021987,COGS 17,A01,092677,Staff,24,0,75,51
1650394028027,COGS 100,A01,083619,Staff,0,24,60,60
1650394034055,COGS 101A,A01,083621,Davis; Joshua Daniel,0,21,60,60
1650394040084,COGS 101B,A01,091572,Staff,0,2,60,60
1650394046107,COGS 101C,A01,083625,Delgado; Tania,16,0,30,14
1650394052131,COGS 107A,A01,083627,Boyle; Mary E. T.,0,10,60,60
1650394058155,COGS 118A,A01,083075,Staff,4,0,60,56
1650394064181,CSE 3,A50,083646,Miranda; Gregory Joseph,21,0,38,17
1650394064181,CSE 3,A51,083647,Miranda; Gregory Joseph,37,0,37,0
1650394070209,CSE 8A,A50,083650,Miranda; Gregory Joseph,0,28,40,40
1650394076243,CSE 11,A01,083080,Cao; Yingjun,0,89,40,40
1650394082267,CSE 12,A01,083652,Staff,0,14,100,100
1650394088299,CSE 15L,A01,083654,Staff,0,1,50,50
1650394088299,CSE 15L,A02,083655,Staff,1,0,50,49
1650394094326,CSE 20,A01,083657,Staff,51,0,80,29
1650394100349,CSE 30,A01,083084,Eldon; John,0,76,40,40
1650394106379,CSE 100,A01,083659,Cao; Yingjun,0,66,50,50
1650394112421,CSE 134B,A01,083661,Powell; Thomas Allan,0,31,65,65
1650394118448,CSE 140,A01,083663,Staff,0,0,75,75
1650394124482,CSE 140L,A01,083088,Eldon; John,0,7,75,75
1650394130505,CSE 175,A01,083665,Kumar; Rakesh,8,0,25,17
1650394136534,CSE 190,A00,092507,Dubnov; Shlomo,14,0,20,6
1650394142558,ECE 45,A01,083139,Staff,0,17,40,40
1650394148586,ECE 65,A50,083695,Staff,0,5,30,30
1650394154612,ECE 109,A01,091882,Touri; Behrouz,40,0,70,30
1650394160642,ECE 180,A00,083140,Abi Samra; Nicholas Camill,24,0,30,6
1650394160642,ECE 180,B00,083141,Abi Samra; Nicholas Camill,2,0,30,28
1650394166673,MATH 10A,A01,083735,Patchell; Gregory David,7,0,30,23
1650394166673,MATH 10A,A02,083736,Patchell; Gregory David,28,0,30,2
1650394166673,MATH 10A,A03,083737,Patchell; Gregory David,25,0,30,5
1650394172707,MATH 10B,A01,083207,Staff,0,7,30,30
1650394172707,MATH 10B,A02,083208,Staff,0,7,30,30
1650394172707,MATH 10B,B01,083739,Staff,16,0,30,14
1650394172707,MATH 10B,B02,083740,Staff,28,0,30,2
1650394178732,MATH 18,A01,083743,Staff,3,0,30,27
1650394178732,MATH 18,A02,083744,Staff,27,0,30,3
1650394178732,MATH 18,A03,083745,Staff,22,0,30,8
1650394178732,MATH 18,A04,083746,Staff,27,0,30,3
1650394178732,MATH 18,B01,083748,Staff,0,11,30,30
1650394178732,MATH 18,B02,083749,Staff,0,12,30,30
1650394178732,MATH 18,B03,083750,Staff,0,11,30,30
1650394178732,MATH 18,B04,083751,Staff,0,9,30,30
1650394184757,MATH 20A,A01,083754,Staff,26,0,40,14
1650394190793,MATH 20B,A01,083756,Staff,0,8,30,30
1650394190793,MATH 20B,A02,083757,Staff,0,8,30,30
1650394196817,MATH 20C,A01,083760,Staff,0,14,30,30
1650394196817,MATH 20C,A02,083761,Staff,0,15,30,30
1650394196817,MATH 20C,B01,083762,Staff,13,0,30,17
1650394196817,MATH 20C,B02,083763,Staff,28,0,30,2
1650394202844,MATH 20D,A01,083765,Staff,0,1,30,30
1650394202844,MATH 20D,A02,083766,Staff,7,0,30,23
1650394202844,MATH 20D,A03,083767,Staff,26,0,30,4
1650394208882,MATH 20E,A01,083771,Staff,5,0,30,25
1650394208882,MATH 20E,A02,083772,Staff,19,0,30,11
1650394208882,MATH 20E,B01,083773,Staff,0,0,30,30
1650394208882,MATH 20E,B02,083774,Staff,12,0,30,18
1650394214912,MATH 103A,A01,083777,Staff,0,11,30,30
1650394214912,MATH 103A,A02,083778,Staff,0,12,30,30
1650394214912,MATH 103A,B01,083779,Staff,0,13,30,30
1650394214912,MATH 103A,B02,083780,Staff,0,11,30,30
1650394220939,MATH 105,A01,085443,Staff,0,21,30,30
1650394226964,MATH 109,A01,083213,Anzaldo; Leesa B,0,7,30,30
1650394226964,MATH 109,A02,083214,Anzaldo; Leesa B,0,7,30,30
1650394226964,MATH 109,B01,083215,Anzaldo; Leesa B,0,5,30,30
1650394226964,MATH 109,B02,083216,Anzaldo; Leesa B,0,5,30,30
1650394232994,MATH 142A,A01,083219,Chow; Bennett,0,14,30,30
1650394232994,MATH 142A,A02,083220,Chow; Bennett,0,13,30,30
1650394232994,MATH 142A,B01,083221,Chow; Bennett,0,12,30,30
1650394232994,MATH 142A,B02,083222,Chow; Bennett,0,12,30,30
1650394239016,MATH 193A,A01,083224,Staff,0,5,30,30
1650394239016,MATH 193A,A02,083225,Staff,0,5,30,30
1650394239016,MATH 193A,A03,083781,Staff,0,4,30,30
1650394239016,MATH 193A,A04,083782,Staff,0,4,30,30
1650394245040,MATH 197,001,091859,McAuley; Julian John,9998,0,9999,1
1650394251090,COGS 9,A01,083615,Staff,0,14,60,60
1650394257112,COGS 11,A01,083617,Boyle; Mary E. T.,22,0,40,18
1650394263136,COGS 13,A01,083071,Staff,0,33,40,40
1650394269167,COGS 14A,A01,092681,Staff,0,23,100,100
1650394275189,COGS 14B,A01,083073,Cheng; Tzu-Han,0,10,50,50
1650394281213,COGS 17,A01,092677,Staff,24,0,75,51
1650394287237,COGS 100,A01,083619,Staff,0,24,60,60
1650394293263,COGS 101A,A01,083621,Davis; Joshua Daniel,0,21,60,60
1650394299293,COGS 101B,A01,091572,Staff,0,2,60,60
1650394305419,COGS 101C,A01,083625,Delgado; Tania,16,0,30,14
1650394311459,COGS 107A,A01,083627,Boyle; Mary E. T.,0,10,60,60
1650394317491,COGS 118A,A01,083075,Staff,4,0,60,56
1650394323518,CSE 3,A50,083646,Miranda; Gregory Joseph,21,0,38,17
1650394323518,CSE 3,A51,083647,Miranda; Gregory Joseph,37,0,37,0
1650394329549,CSE 8A,A50,083650,Miranda; Gregory Joseph,0,28,40,40
1650394335574,CSE 11,A01,083080,Cao; Yingjun,0,89,40,40
1650394341598,CSE 12,A01,083652,Staff,0,14,100,100
1650394347628,CSE 15L,A01,083654,Staff,0,1,50,50
1650394347628,CSE 15L,A02,083655,Staff,1,0,50,49
1650394353651,CSE 20,A01,083657,Staff,51,0,80,29
1650394359678,CSE 30,A01,083084,Eldon; John,0,76,40,40
1650394365708,CSE 100,A01,083659,Cao; Yingjun,0,66,50,50
1650394371732,CSE 134B,A01,083661,Powell; Thomas Allan,0,31,65,65
1650394377756,CSE 140,A01,083663,Staff,0,0,75,75
1650394383784,CSE 140L,A01,083088,Eldon; John,0,7,75,75
1650394389818,CSE 175,A01,083665,Kumar; Rakesh,8,0,25,17
1650394395841,CSE 190,A00,092507,Dubnov; Shlomo,14,0,20,6
1650394401865,ECE 45,A01,083139,Staff,0,17,40,40
1650394407893,ECE 65,A50,083695,Staff,0,5,30,30
1650394413920,ECE 109,A01,091882,Touri; Behrouz,40,0,70,30
1650394419967,ECE 180,A00,083140,Abi Samra; Nicholas Camill,24,0,30,6
1650394419967,ECE 180,B00,083141,Abi Samra; Nicholas Camill,2,0,30,28
1650394425989,MATH 10A,A01,083735,Patchell; Gregory David,7,0,30,23
1650394425989,MATH 10A,A02,083736,Patchell; Gregory David,28,0,30,2
1650394425989,MATH 10A,A03,083737,Patchell; Gregory David,25,0,30,5
1650394432015,MATH 10B,A01,083207,Staff,0,7,30,30
1650394432015,MATH 10B,A02,083208,Staff,0,7,30,30
1650394432015,MATH 10B,B01,083739,Staff,16,0,30,14
1650394432015,MATH 10B,B02,083740,Staff,28,0,30,2
1650394438040,MATH 18,A01,083743,Staff,3,0,30,27
1650394438040,MATH 18,A02,083744,Staff,27,0,30,3
1650394438040,MATH 18,A03,083745,Staff,22,0,30,8
1650394438040,MATH 18,A04,083746,Staff,27,0,30,3
1650394438040,MATH 18,B01,083748,Staff,0,11,30,30
1650394438040,MATH 18,B02,083749,Staff,0,12,30,30
1650394438040,MATH 18,B03,083750,Staff,0,11,30,30
1650394438040,MATH 18,B04,083751,Staff,0,9,30,30
1650394444064,MATH 20A,A01,083754,Staff,26,0,40,14
1650394450099,MATH 20B,A01,083756,Staff,0,8,30,30
1650394450099,MATH 20B,A02,083757,Staff,0,8,30,30
1650394456122,MATH 20C,A01,083760,Staff,0,14,30,30
1650394456122,MATH 20C,A02,083761,Staff,0,15,30,30
1650394456122,MATH 20C,B01,083762,Staff,13,0,30,17
1650394456122,MATH 20C,B02,083763,Staff,28,0,30,2
1650394462148,MATH 20D,A01,083765,Staff,0,1,30,30
1650394462148,MATH 20D,A02,083766,Staff,7,0,30,23
1650394462148,MATH 20D,A03,083767,Staff,26,0,30,4
1650394468176,MATH 20E,A01,083771,Staff,5,0,30,25
1650394468176,MATH 20E,A02,083772,Staff,19,0,30,11
1650394468176,MATH 20E,B01,083773,Staff,0,0,30,30
1650394468176,MATH 20E,B02,083774,Staff,12,0,30,18
1650394474219,MATH 103A,A01,083777,Staff,0,11,30,30
1650394474219,MATH 103A,A02,083778,Staff,0,12,30,30
1650394474219,MATH 103A,B01,083779,Staff,0,13,30,30
1650394474219,MATH 103A,B02,083780,Staff,0,11,30,30
1650394480241,MATH 105,A01,085443,Staff,0,21,30,30
1650394486264,MATH 109,A01,083213,Anzaldo; Leesa B,0,7,30,30
1650394486264,MATH 109,A02,083214,Anzaldo; Leesa B,0,7,30,30
1650394486264,MATH 109,B01,083215,Anzaldo; Leesa B,0,5,30,30
1650394486264,MATH 109,B02,083216,Anzaldo; Leesa B,0,5,30,30
1650394492293,MATH 142A,A01,083219,Chow; Bennett,0,14,30,30
1650394492293,MATH 142A,A02,083220,Chow; Bennett,0,13,30,30
1650394492293,MATH 142A,B01,083221,Chow; Bennett,0,12,30,30
1650394492293,MATH 142A,B02,083222,Chow; Bennett,0,12,30,30
1650394498319,MATH 193A,A01,083224,Staff,0,5,30,30
1650394498319,MATH 193A,A02,083225,Staff,0,5,30,30
1650394498319,MATH 193A,A03,083781,Staff,0,4,30,30
1650394498319,MATH 193A,A04,083782,Staff,0,4,30,30
1650394504350,MATH 197,001,091859,McAuley; Julian John,9998,0,9999,1
1650394510415,COGS 9,A01,083615,Staff,0,14,60,60
1650394516438,COGS 11,A01,083617,Boyle; Mary E. T.,22,0,40,18
1650394522463,COGS 13,A01,083071,Staff,0,33,40,40
1650394528486,COGS 14A,A01,092681,Staff,0,23,100,100
1650394534531,COGS 14B,A01,083073,Cheng; Tzu-Han,0,10,50,50
1650394540554,COGS 17,A01,092677,Staff,24,0,75,51
1650394546580,COGS 100,A01,083619,Staff,0,24,60,60
1650394552607,COGS 101A,A01,083621,Davis; Joshua Daniel,0,21,60,60
1650394558635,COGS 101B,A01,091572,Staff,0,2,60,60
1650394564665,COGS 101C,A01,083625,Delgado; Tania,16,0,30,14
1650394570689,COGS 107A,A01,083627,Boyle; Mary E. T.,0,10,60,60
1650394576717,COGS 118A,A01,083075,Staff,4,0,60,56
1650394582740,CSE 3,A50,083646,Miranda; Gregory Joseph,21,0,38,17
1650394582740,CSE 3,A51,083647,Miranda; Gregory Joseph,37,0,37,0
1650394588765,CSE 8A,A50,083650,Miranda; Gregory Joseph,0,28,40,40
1650394594789,CSE 11,A01,083080,Cao; Yingjun,0,89,40,40
1650394600814,CSE 12,A01,083652,Staff,0,14,100,100
1650394606839,CSE 15L,A01,083654,Staff,0,1,50,50
1650394606839,CSE 15L,A02,083655,Staff,1,0,50,49
1650394612865,CSE 20,A01,083657,Staff,51,0,80,29
1650394618893,CSE 30,A01,083084,Eldon; John,0,76,40,40
1650394624938,CSE 100,A01,083659,Cao; Yingjun,0,66,50,50
1650394630972,CSE 134B,A01,083661,Powell; Thomas Allan,0,31,65,65
1650394637000,CSE 140,A01,083663,Staff,0,0,75,75
1650394643022,CSE 140L,A01,083088,Eldon; John,0,7,75,75
1650394649049,CSE 175,A01,083665,Kumar; Rakesh,8,0,25,17
1650394655072,CSE 190,A00,092507,Dubnov; Shlomo,14,0,20,6
1650394661099,ECE 45,A01,083139,Staff,0,17,40,40
1650394667123,ECE 65,A50,083695,Staff,0,5,30,30
1650394673151,ECE 109,A01,091882,Touri; Behrouz,40,0,70,30
1650394679182,ECE 180,A00,083140,Abi Samra; Nicholas Camill,24,0,30,6
1650394679182,ECE 180,B00,083141,Abi Samra; Nicholas Camill,2,0,30,28
1650394685205,MATH 10A,A01,083735,Patchell; Gregory David,7,0,30,23
1650394685205,MATH 10A,A02,083736,Patchell; Gregory David,28,0,30,2
1650394685205,MATH 10A,A03,083737,Patchell; Gregory David,25,0,30,5
1650394691233,MATH 10B,A01,083207,Staff,0,7,30,30
1650394691233,MATH 10B,A02,083208,Staff,0,7,30,30
1650394691233,MATH 10B,B01,083739,Staff,16,0,30,14
1650394691233,MATH 10B,B02,083740,Staff,28,0,30,2
1650394697256,MATH 18,A01,083743,Staff,3,0,30,27
1650394697256,MATH 18,A02,083744,Staff,27,0,30,3
1650394697256,MATH 18,A03,083745,Staff,22,0,30,8
1650394697256,MATH 18,A04,083746,Staff,27,0,30,3
1650394697256,MATH 18,B01,083748,Staff,0,11,30,30
1650394697256,MATH 18,B02,083749,Staff,0,12,30,30
1650394697256,MATH 18,B03,083750,Staff,0,11,30,30
1650394697256,MATH 18,B04,083751,Staff,0,9,30,30
1650394703279,MATH 20A,A01,083754,Staff,26,0,40,14
1650394709303,MATH 20B,A01,083756,Staff,0,8,30,30
1650394709303,MATH 20B,A02,083757,Staff,0,8,30,30
1650394720797,MATH 20C,A01,083760,Staff,0,14,30,30
1650394720797,MATH 20C,A02,083761,Staff,0,15,30,30
1650394720797,MATH 20C,B01,083762,Staff,13,0,30,17
1650394720797,MATH 20C,B02,083763,Staff,28,0,30,2
1650394726823,MATH 20D,A01,083765,Staff,0,1,30,30
1650394726823,MATH 20D,A02,083766,Staff,7,0,30,23
1650394726823,MATH 20D,A03,083767,Staff,26,0,30,4
1650394732852,MATH 20E,A01,083771,Staff,5,0,30,25
1650394732852,MATH 20E,A02,083772,Staff,19,0,30,11
1650394732852,MATH 20E,B01,083773,Staff,0,0,30,30
1650394732852,MATH 20E,B02,083774,Staff,12,0,30,18
1650394738876,MATH 103A,A01,083777,Staff,0,11,30,30
1650394738876,MATH 103A,A02,083778,Staff,0,12,30,30
1650394738876,MATH 103A,B01,083779,Staff,0,13,30,30
1650394738876,MATH 103A,B02,083780,Staff,0,11,30,30
1650394744902,MATH 105,A01,085443,Staff,0,21,30,30
1650394750928,MATH 109,A01,083213,Anzaldo; Leesa B,0,7,30,30
1650394750928,MATH 109,A02,083214,Anzaldo; Leesa B,0,7,30,30
1650394750928,MATH 109,B01,083215,Anzaldo; Leesa B,0,5,30,30
1650394750928,MATH 109,B02,083216,Anzaldo; Leesa B,0,5,30,30
1650394756956,MATH 142A,A01,083219,Chow; Bennett,0,14,30,30
1650394756956,MATH 142A,A02,083220,Chow; Bennett,0,13,30,30
1650394756956,MATH 142A,B01,083221,Chow; Bennett,0,12,30,30
1650394756956,MATH 142A,B02,083222,Chow; Bennett,0,12,30,30
1650394762989,MATH 193A,A01,083224,Staff,0,5,30,30
1650394762989,MATH 193A,A02,083225,Staff,0,5,30,30
1650394762989,MATH 193A,A03,083781,Staff,0,4,30,30
1650394762989,MATH 193A,A04,083782,Staff,0,4,30,30
1650394769012,MATH 197,001,091859,McAuley; Julian John,9998,0,9999,1
1650394775076,COGS 9,A01,083615,Staff,0,14,60,60
1650394781099,COGS 11,A01,083617,Boyle; Mary E. T.,22,0,40,18
1650394787126,COGS 13,A01,083071,Staff,0,33,40,40
1650394793149,COGS 14A,A01,092681,Staff,0,23,100,100
1650394799174,COGS 14B,A01,083073,Cheng; Tzu-Han,0,10,50,50
1650394805209,COGS 17,A01,092677,Staff,24,0,75,51
1650394811240,COGS 100,A01,083619,Staff,0,24,60,60
1650394817278,COGS 101A,A01,083621,Davis; Joshua Daniel,0,21,60,60
1650394823315,COGS 101B,A01,091572,Staff,0,2,60,60
1650394829347,COGS 101C,A01,083625,Delgado; Tania,16,0,30,14
1650394835386,COGS 107A,A01,083627,Boyle; Mary E. T.,0,10,60,60
1650394841421,COGS 118A,A01,083075,Staff,4,0,60,56
1650394847454,CSE 3,A50,083646,Miranda; Gregory Joseph,21,0,38,17
1650394847454,CSE 3,A51,083647,Miranda; Gregory Joseph,37,0,37,0
1650394853477,CSE 8A,A50,083650,Miranda; Gregory Joseph,0,28,40,40
1650394859512,CSE 11,A01,083080,Cao; Yingjun,0,89,40,40
1650394865536,CSE 12,A01,083652,Staff,0,14,100,100
1650394871570,CSE 15L,A01,083654,Staff,0,1,50,50
1650394871570,CSE 15L,A02,083655,Staff,1,0,50,49
1650394877596,CSE 20,A01,083657,Staff,51,0,80,29
1650394883624,CSE 30,A01,083084,Eldon; John,0,76,40,40
1650394889649,CSE 100,A01,083659,Cao; Yingjun,0,66,50,50
1650394895677,CSE 134B,A01,083661,Powell; Thomas Allan,0,31,65,65
1650394901700,CSE 140,A01,083663,Staff,0,0,75,75
1650394907822,CSE 140L,A01,083088,Eldon; John,0,7,75,75
1650394913846,CSE 175,A01,083665,Kumar; Rakesh,8,0,25,17
1650394919873,CSE 190,A00,092507,Dubnov; Shlomo,14,0,20,6
1650394925898,ECE 45,A01,083139,Staff,0,17,40,40
1650394931941,ECE 65,A50,083695,Staff,0,5,30,30
1650394937969,ECE 109,A01,091882,Touri; Behrouz,40,0,70,30
1650394943998,ECE 180,A00,083140,Abi Samra; Nicholas Camill,24,0,30,6
1650394943998,ECE 180,B00,083141,Abi Samra; Nicholas Camill,2,0,30,28
1650394950028,MATH 10A,A01,083735,Patchell; Gregory David,7,0,30,23
1650394950028,MATH 10A,A02,083736,Patchell; Gregory David,28,0,30,2
1650394950028,MATH 10A,A03,083737,Patchell; Gregory David,25,0,30,5
1650394956066,MATH 10B,A01,083207,Staff,0,7,30,30
1650394956066,MATH 10B,A02,083208,Staff,0,7,30,30
1650394956066,MATH 10B,B01,083739,Staff,16,0,30,14
1650394956066,MATH 10B,B02,083740,Staff,28,0,30,2
1650394962092,MATH 18,A01,083743,Staff,3,0,30,27
1650394962092,MATH 18,A02,083744,Staff,27,0,30,3
1650394962092,MATH 18,A03,083745,Staff,22,0,30,8
1650394962092,MATH 18,A04,083746,Staff,27,0,30,3
1650394962092,MATH 18,B01,083748,Staff,0,11,30,30
1650394962092,MATH 18,B02,083749,Staff,0,12,30,30
1650394962092,MATH 18,B03,083750,Staff,0,11,30,30
1650394962092,MATH 18,B04,083751,Staff,0,9,30,30
1650394968115,MATH 20A,A01,083754,Staff,26,0,40,14
1650394974151,MATH 20B,A01,083756,Staff,0,8,30,30
1650394974151,MATH 20B,A02,083757,Staff,0,8,30,30
1650394980181,MATH 20C,A01,083760,Staff,0,14,30,30
1650394980181,MATH 20C,A02,083761,Staff,0,15,30,30
1650394980181,MATH 20C,B01,083762,Staff,13,0,30,17
1650394980181,MATH 20C,B02,083763,Staff,28,0,30,2
1650394986204,MATH 20D,A01,083765,Staff,0,1,30,30
1650394986204,MATH 20D,A02,083766,Staff,7,0,30,23
1650394986204,MATH 20D,A03,083767,Staff,26,0,30,4
1650394992229,MATH 20E,A01,083771,Staff,5,0,30,25
1650394992229,MATH 20E,A02,083772,Staff,19,0,30,11
1650394992229,MATH 20E,B01,083773,Staff,0,0,30,30
1650394992229,MATH 20E,B02,083774,Staff,12,0,30,18
1650394998252,MATH 103A,A01,083777,Staff,0,11,30,30
1650394998252,MATH 103A,A02,083778,Staff,0,12,30,30
1650394998252,MATH 103A,B01,083779,Staff,0,13,30,30
1650394998252,MATH 103A,B02,083780,Staff,0,11,30,30
1650395004279,MATH 105,A01,085443,Staff,0,21,30,30
1650395010303,MATH 109,A01,083213,Anzaldo; Leesa B,0,7,30,30
1650395010303,MATH 109,A02,083214,Anzaldo; Leesa B,0,7,30,30
1650395010303,MATH 109,B01,083215,Anzaldo; Leesa B,0,5,30,30
1650395010303,MATH 109,B02,083216,Anzaldo; Leesa B,0,5,30,30
1650395016332,MATH 142A,A01,083219,Chow; Bennett,0,14,30,30
1650395016332,MATH 142A,A02,083220,Chow; Bennett,0,13,30,30
1650395016332,MATH 142A,B01,083221,Chow; Bennett,0,12,30,30
1650395016332,MATH 142A,B02,083222,Chow; Bennett,0,12,30,30
1650395022355,MATH 193A,A01,083224,Staff,0,5,30,30
1650395022355,MATH 193A,A02,083225,Staff,0,5,30,30
1650395022355,MATH 193A,A03,083781,Staff,0,4,30,30
1650395022355,MATH 193A,A04,083782,Staff,0,4,30,30
1650395028382,MATH 197,001,091859,McAuley; Julian John,9998,0,9999,1
1650395034441,COGS 9,A01,083615,Staff,0,14,60,60
1650395040465,COGS 11,A01,083617,Boyle; Mary E. T.,22,0,40,18
1650395046489,COGS 13,A01,083071,Staff,0,33,40,40
1650395052527,COGS 14A,A01,092681,Staff,0,23,100,100
1650395058554,COGS 14B,A01,083073,Cheng; Tzu-Han,0,10,50,50
1650395064582,COGS 17,A01,092677,Staff,24,0,75,51
1650395070607,COGS 100,A01,083619,Staff,0,24,60,60
1650395076637,COGS 101A,A01,083621,Davis; Joshua Daniel,0,21,60,60
1650395082659,COGS 101B,A01,091572,Staff,0,2,60,60
1650395088691,COGS 101C,A01,083625,Delgado; Tania,16,0,30,14
1650395094723,COGS 107A,A01,083627,Boyle; Mary E. T.,0,10,60,60
1650395100748,COGS 118A,A01,083075,Staff,4,0,60,56
1650395106772,CSE 3,A50,083646,Miranda; Gregory Joseph,21,0,38,17
1650395106772,CSE 3,A51,083647,Miranda; Gregory Joseph,37,0,37,0
1650395112817,CSE 8A,A50,083650,Miranda; Gregory Joseph,0,28,40,40
1650395118852,CSE 11,A01,083080,Cao; Yingjun,0,89,40,40
1650395124876,CSE 12,A01,083652,Staff,0,14,100,100
1650395130899,CSE 15L,A01,083654,Staff,0,1,50,50
1650395130899,CSE 15L,A02,083655,Staff,1,0,50,49
1650395136924,CSE 20,A01,083657,Staff,51,0,80,29
1650395142955,CSE 30,A01,083084,Eldon; John,0,76,40,40
1650395148979,CSE 100,A01,083659,Cao; Yingjun,0,66,50,50
1650395155006,CSE 134B,A01,083661,Powell; Thomas Allan,0,31,65,65
1650395161029,CSE 140,A01,083663,Staff,0,0,75,75
1650395167057,CSE 140L,A01,083088,Eldon; John,0,7,75,75
1650395173093,CSE 175,A01,083665,Kumar; Rakesh,8,0,25,17
1650395179119,CSE 190,A00,092507,Dubnov; Shlomo,14,0,20,6
1650395185151,ECE 45,A01,083139,Staff,0,17,40,40
1650395191178,ECE 65,A50,083695,Staff,0,5,30,30
1650395197201,ECE 109,A01,091882,Touri; Behrouz,40,0,70,30
1650395203228,ECE 180,A00,083140,Abi Samra; Nicholas Camill,24,0,30,6
1650395203228,ECE 180,B00,083141,Abi Samra; Nicholas Camill,2,0,30,28
1650395209259,MATH 10A,A01,083735,Patchell; Gregory David,7,0,30,23
1650395209259,MATH 10A,A02,083736,Patchell; Gregory David,28,0,30,2
1650395209259,MATH 10A,A03,083737,Patchell; Gregory David,25,0,30,5
1650395215289,MATH 10B,A01,083207,Staff,0,7,30,30
1650395215289,MATH 10B,A02,083208,Staff,0,7,30,30
1650395215289,MATH 10B,B01,083739,Staff,16,0,30,14
1650395215289,MATH 10B,B02,083740,Staff,28,0,30,2
1650395221315,MATH 18,A01,083743,Staff,3,0,30,27
1650395221315,MATH 18,A02,083744,Staff,27,0,30,3
1650395221315,MATH 18,A03,083745,Staff,22,0,30,8
1650395221315,MATH 18,A04,083746,Staff,27,0,30,3
1650395221315,MATH 18,B01,083748,Staff,0,11,30,30
1650395221315,MATH 18,B02,083749,Staff,0,12,30,30
1650395221315,MATH 18,B03,083750,Staff,0,11,30,30
1650395221315,MATH 18,B04,083751,Staff,0,9,30,30
1650395227339,MATH 20A,A01,083754,Staff,26,0,40,14
1650395233368,MATH 20B,A01,083756,Staff,0,8,30,30
1650395233368,MATH 20B,A02,083757,Staff,0,8,30,30
1650395239393,MATH 20C,A01,083760,Staff,0,14,30,30
1650395239393,MATH 20C,A02,083761,Staff,1,15,30,29
1650395239393,MATH 20C,B01,083762,Staff,13,0,30,17
1650395239393,MATH 20C,B02,083763,Staff,28,0,30,2
1650395245416,MATH 20D,A01,083765,Staff,0,1,30,30
1650395245416,MATH 20D,A02,083766,Staff,7,0,30,23
1650395245416,MATH 20D,A03,083767,Staff,26,0,30,4
1650395251449,MATH 20E,A01,083771,Staff,5,0,30,25
1650395251449,MATH 20E,A02,083772,Staff,19,0,30,11
1650395251449,MATH 20E,B01,083773,Staff,0,0,30,30
1650395251449,MATH 20E,B02,083774,Staff,12,0,30,18
1650395257477,MATH 103A,A01,083777,Staff,0,11,30,30
1650395257477,MATH 103A,A02,083778,Staff,0,12,30,30
1650395257477,MATH 103A,B01,083779,Staff,0,13,30,30
1650395257477,MATH 103A,B02,083780,Staff,0,11,30,30
1650395263501,MATH 105,A01,085443,Staff,0,21,30,30
1650395269525,MATH 109,A01,083213,Anzaldo; Leesa B,0,7,30,30
1650395269525,MATH 109,A02,083214,Anzaldo; Leesa B,0,7,30,30
1650395269525,MATH 109,B01,083215,Anzaldo; Leesa B,0,5,30,30
1650395269525,MATH 109,B02,083216,Anzaldo; Leesa B,0,5,30,30
1650395275555,MATH 142A,A01,083219,Chow; Bennett,0,14,30,30
1650395275555,MATH 142A,A02,083220,Chow; Bennett,0,13,30,30
1650395275555,MATH 142A,B01,083221,Chow; Bennett,0,12,30,30
1650395275555,MATH 142A,B02,083222,Chow; Bennett,0,12,30,30
1650395281580,MATH 193A,A01,083224,Staff,0,5,30,30
1650395281580,MATH 193A,A02,083225,Staff,0,5,30,30
1650395281580,MATH 193A,A03,083781,Staff,0,4,30,30
1650395281580,MATH 193A,A04,083782,Staff,0,4,30,30
1650395287603,MATH 197,001,091859,McAuley; Julian John,9998,0,9999,1
1650395293655,COGS 9,A01,083615,Staff,0,14,60,60
1650395299677,COGS 11,A01,083617,Boyle; Mary E. T.,22,0,40,18
1650395305700,COGS 13,A01,083071,Staff,0,33,40,40
1650395311724,COGS 14A,A01,092681,Staff,0,23,100,100
1650395317754,COGS 14B,A01,083073,Cheng; Tzu-Han,0,10,50,50
1650395323780,COGS 17,A01,092677,Staff,24,0,75,51
1650395329807,COGS 100,A01,083619,Staff,0,24,60,60
1650395335847,COGS 101A,A01,083621,Davis; Joshua Daniel,0,21,60,60
1650395341874,COGS 101B,A01,091572,Staff,0,2,60,60
1650395347899,COGS 101C,A01,083625,Delgado; Tania,16,0,30,14
1650395353928,COGS 107A,A01,083627,Boyle; Mary E. T.,0,10,60,60
1650395359953,COGS 118A,A01,083075,Staff,4,0,60,56
1650395365990,CSE 3,A50,083646,Miranda; Gregory Joseph,21,0,38,17
1650395365990,CSE 3,A51,083647,Miranda; Gregory Joseph,37,0,37,0
1650395372013,CSE 8A,A50,083650,Miranda; Gregory Joseph,0,28,40,40
1650395378041,CSE 11,A01,083080,Cao; Yingjun,0,89,40,40
1650395384065,CSE 12,A01,083652,Staff,0,14,100,100
1650395390094,CSE 15L,A01,083654,Staff,0,1,50,50
1650395390094,CSE 15L,A02,083655,Staff,1,0,50,49
1650395396123,CSE 20,A01,083657,Staff,51,0,80,29
1650395402148,CSE 30,A01,083084,Eldon; John,0,76,40,40
1650395408176,CSE 100,A01,083659,Cao; Yingjun,0,66,50,50
1650395414203,CSE 134B,A01,083661,Powell; Thomas Allan,0,31,65,65
1650395420228,CSE 140,A01,083663,Staff,0,0,75,75
1650395426256,CSE 140L,A01,083088,Eldon; John,0,7,75,75
1650395432286,CSE 175,A01,083665,Kumar; Rakesh,8,0,25,17
1650395438321,CSE 190,A00,092507,Dubnov; Shlomo,14,0,20,6
1650395444349,ECE 45,A01,083139,Staff,0,17,40,40
1650395450373,ECE 65,A50,083695,Staff,0,5,30,30
1650395456396,ECE 109,A01,091882,Touri; Behrouz,40,0,70,30
1650395462422,ECE 180,A00,083140,Abi Samra; Nicholas Camill,24,0,30,6
1650395462422,ECE 180,B00,083141,Abi Samra; Nicholas Camill,2,0,30,28
1650395468461,MATH 10A,A01,083735,Patchell; Gregory David,7,0,30,23
1650395468461,MATH 10A,A02,083736,Patchell; Gregory David,28,0,30,2
1650395468461,MATH 10A,A03,083737,Patchell; Gregory David,25,0,30,5
1650395474485,MATH 10B,A01,083207,Staff,0,7,30,30
1650395474485,MATH 10B,A02,083208,Staff,0,7,30,30
1650395474485,MATH 10B,B01,083739,Staff,16,0,30,14
1650395474485,MATH 10B,B02,083740,Staff,28,0,30,2
1650395480510,MATH 18,A01,083743,Staff,3,0,30,27
1650395480510,MATH 18,A02,083744,Staff,27,0,30,3
1650395480510,MATH 18,A03,083745,Staff,22,0,30,8
1650395480510,MATH 18,A04,083746,Staff,27,0,30,3
1650395480510,MATH 18,B01,083748,Staff,0,11,30,30
1650395480510,MATH 18,B02,083749,Staff,0,12,30,30
1650395480510,MATH 18,B03,083750,Staff,0,11,30,30
1650395480510,MATH 18,B04,083751,Staff,0,9,30,30
1650395486533,MATH 20A,A01,083754,Staff,26,0,40,14
1650395492561,MATH 20B,A01,083756,Staff,0,8,30,30
1650395492561,MATH 20B,A02,083757,Staff,0,8,30,30
1650395498584,MATH 20C,A01,083760,Staff,0,14,30,30
1650395498584,MATH 20C,A02,083761,Staff,1,15,30,29
1650395498584,MATH 20C,B01,083762,Staff,13,0,30,17
1650395498584,MATH 20C,B02,083763,Staff,28,0,30,2
1650395504696,MATH 20D,A01,083765,Staff,0,1,30,30
1650395504696,MATH 20D,A02,083766,Staff,7,0,30,23
1650395504696,MATH 20D,A03,083767,Staff,26,0,30,4
1650395510725,MATH 20E,A01,083771,Staff,5,0,30,25
1650395510725,MATH 20E,A02,083772,Staff,19,0,30,11
1650395510725,MATH 20E,B01,083773,Staff,0,0,30,30
1650395510725,MATH 20E,B02,083774,Staff,12,0,30,18
1650395516768,MATH 103A,A01,083777,Staff,0,11,30,30
1650395516768,MATH 103A,A02,083778,Staff,0,12,30,30
1650395516768,MATH 103A,B01,083779,Staff,0,13,30,30
1650395516768,MATH 103A,B02,083780,Staff,0,11,30,30
1650395522790,MATH 105,A01,085443,Staff,0,21,30,30
1650395528827,MATH 109,A01,083213,Anzaldo; Leesa B,0,7,30,30
1650395528827,MATH 109,A02,083214,Anzaldo; Leesa B,0,7,30,30
1650395528827,MATH 109,B01,083215,Anzaldo; Leesa B,0,5,30,30
1650395528827,MATH 109,B02,083216,Anzaldo; Leesa B,0,5,30,30
1650395534859,MATH 142A,A01,083219,Chow; Bennett,0,14,30,30
1650395534859,MATH 142A,A02,083220,Chow; Bennett,0,13,30,30
1650395534859,MATH 142A,B01,083221,Chow; Bennett,0,12,30,30
1650395534859,MATH 142A,B02,083222,Chow; Bennett,0,12,30,30
1650395540885,MATH 193A,A01,083224,Staff,0,5,30,30
1650395540885,MATH 193A,A02,083225,Staff,0,5,30,30
1650395540885,MATH 193A,A03,083781,Staff,0,4,30,30
1650395540885,MATH 193A,A04,083782,Staff,0,4,30,30
1650395546908,MATH 197,001,091859,McAuley; Julian John,9998,0,9999,1
1650395552965,COGS 9,A01,083615,Staff,0,14,60,60
1650395558995,COGS 11,A01,083617,Boyle; Mary E. T.,22,0,40,18
1650395565020,COGS 13,A01,083071,Staff,0,33,40,40
1650395571062,COGS 14A,A01,092681,Staff,0,23,100,100
1650395577085,COGS 14B,A01,083073,Cheng; Tzu-Han,0,10,50,50
1650395583109,COGS 17,A01,092677,Staff,24,0,75,51
1650395589134,COGS 100,A01,083619,Staff,0,24,60,60
1650395595162,COGS 101A,A01,083621,Davis; Joshua Daniel,0,21,60,60
1650395601187,COGS 101B,A01,091572,Staff,0,2,60,60
1650395607219,COGS 101C,A01,083625,Delgado; Tania,16,0,30,14
1650395613242,COGS 107A,A01,083627,Boyle; Mary E. T.,0,10,60,60
1650395619267,COGS 118A,A01,083075,Staff,4,0,60,56
1650395625291,CSE 3,A50,083646,Miranda; Gregory Joseph,21,0,38,17
1650395625291,CSE 3,A51,083647,Miranda; Gregory Joseph,37,0,37,0
1650395631320,CSE 8A,A50,083650,Miranda; Gregory Joseph,0,28,40,40
1650395637344,CSE 11,A01,083080,Cao; Yingjun,0,89,40,40
1650395643380,CSE 12,A01,083652,Staff,0,14,100,100
1650395649417,CSE 15L,A01,083654,Staff,0,1,50,50
1650395649417,CSE 15L,A02,083655,Staff,1,0,50,49
1650395655445,CSE 20,A01,083657,Staff,51,0,80,29
1650395661468,CSE 30,A01,083084,Eldon; John,0,76,40,40
1650395667503,CSE 100,A01,083659,Cao; Yingjun,0,66,50,50
1650395673527,CSE 134B,A01,083661,Powell; Thomas Allan,0,31,65,65
1650395679556,CSE 140,A01,083663,Staff,0,0,75,75
1650395685583,CSE 140L,A01,083088,Eldon; John,0,7,75,75
1650395691607,CSE 175,A01,083665,Kumar; Rakesh,8,0,25,17
1650395697641,CSE 190,A00,092507,Dubnov; Shlomo,14,0,20,6
1650395703665,ECE 45,A01,083139,Staff,0,17,40,40
1650395709692,ECE 65,A50,083695,Staff,0,5,30,30
1650395715721,ECE 109,A01,091882,Touri; Behrouz,40,0,70,30
1650395721748,ECE 180,A00,083140,Abi Samra; Nicholas Camill,24,0,30,6
1650395721748,ECE 180,B00,083141,Abi Samra; Nicholas Camill,2,0,30,28
1650395727780,MATH 10A,A01,083735,Patchell; Gregory David,7,0,30,23
1650395727780,MATH 10A,A02,083736,Patchell; Gregory David,28,0,30,2
1650395727780,MATH 10A,A03,083737,Patchell; Gregory David,25,0,30,5
1650395733802,MATH 10B,A01,083207,Staff,0,7,30,30
1650395733802,MATH 10B,A02,083208,Staff,0,7,30,30
1650395733802,MATH 10B,B01,083739,Staff,16,0,30,14
1650395733802,MATH 10B,B02,083740,Staff,28,0,30,2
1650395739833,MATH 18,A01,083743,Staff,3,0,30,27
1650395739833,MATH 18,A02,083744,Staff,27,0,30,3
1650395739833,MATH 18,A03,083745,Staff,22,0,30,8
1650395739833,MATH 18,A04,083746,Staff,27,0,30,3
1650395739833,MATH 18,B01,083748,Staff,0,11,30,30
1650395739833,MATH 18,B02,083749,Staff,0,12,30,30
1650395739833,MATH 18,B03,083750,Staff,0,11,30,30
1650395739833,MATH 18,B04,083751,Staff,0,9,30,30
1650395745864,MATH 20A,A01,083754,Staff,26,0,40,14
1650395751914,MATH 20B,A01,083756,Staff,0,8,30,30
1650395751914,MATH 20B,A02,083757,Staff,0,8,30,30
1650395757939,MATH 20C,A01,083760,Staff,0,14,30,30
1650395757939,MATH 20C,A02,083761,Staff,1,15,30,29
1650395757939,MATH 20C,B01,083762,Staff,13,0,30,17
1650395757939,MATH 20C,B02,083763,Staff,28,0,30,2
1650395763975,MATH 20D,A01,083765,Staff,0,1,30,30
1650395763975,MATH 20D,A02,083766,Staff,7,0,30,23
1650395763975,MATH 20D,A03,083767,Staff,26,0,30,4
1650395769999,MATH 20E,A01,083771,Staff,5,0,30,25
1650395769999,MATH 20E,A02,083772,Staff,19,0,30,11
1650395769999,MATH 20E,B01,083773,Staff,0,0,30,30
1650395769999,MATH 20E,B02,083774,Staff,12,0,30,18
1650395776026,MATH 103A,A01,083777,Staff,0,11,30,30
1650395776026,MATH 103A,A02,083778,Staff,0,12,30,30
1650395776026,MATH 103A,B01,083779,Staff,0,13,30,30
1650395776026,MATH 103A,B02,083780,Staff,0,11,30,30
1650395782068,MATH 105,A01,085443,Staff,0,21,30,30
1650395788097,MATH 109,A01,083213,Anzaldo; Leesa B,0,7,30,30
1650395788097,MATH 109,A02,083214,Anzaldo; Leesa B,0,7,30,30
1650395788097,MATH 109,B01,083215,Anzaldo; Leesa B,0,5,30,30
1650395788097,MATH 109,B02,083216,Anzaldo; Leesa B,0,5,30,30
1650395794139,MATH 142A,A01,083219,Chow; Bennett,0,14,30,30
1650395794139,MATH 142A,A02,083220,Chow; Bennett,0,13,30,30
1650395794139,MATH 142A,B01,083221,Chow; Bennett,0,12,30,30
1650395794139,MATH 142A,B02,083222,Chow; Bennett,0,12,30,30
1650395800178,MATH 193A,A01,083224,Staff,0,5,30,30
1650395800178,MATH 193A,A02,083225,Staff,0,5,30,30
1650395800178,MATH 193A,A03,083781,Staff,0,4,30,30
1650395800178,MATH 193A,A04,083782,Staff,0,4,30,30
1650395806202,MATH 197,001,091859,McAuley; Julian John,9998,0,9999,1
1650395812273,COGS 9,A01,083615,Staff,0,14,60,60
1650395818300,COGS 11,A01,083617,Boyle; Mary E. T.,22,0,40,18
1650395824329,COGS 13,A01,083071,Staff,0,33,40,40
1650395830359,COGS 14A,A01,092681,Staff,0,23,100,100
1650395836394,COGS 14B,A01,083073,Cheng; Tzu-Han,0,10,50,50
1650395842417,COGS 17,A01,092677,Staff,24,0,75,51
1650395848444,COGS 100,A01,083619,Staff,0,24,60,60
1650395854471,COGS 101A,A01,083621,Davis; Joshua Daniel,0,21,60,60
1650395860511,COGS 101B,A01,091572,Staff,0,2,60,60
1650395866547,COGS 101C,A01,083625,Delgado; Tania,16,0,30,14
1650395872577,COGS 107A,A01,083627,Boyle; Mary E. T.,0,10,60,60
1650395878611,COGS 118A,A01,083075,Staff,4,0,60,56
1650395884635,CSE 3,A50,083646,Miranda; Gregory Joseph,21,0,38,17
1650395884635,CSE 3,A51,083647,Miranda; Gregory Joseph,37,0,37,0
1650395890661,CSE 8A,A50,083650,Miranda; Gregory Joseph,0,28,40,40
1650395896697,CSE 11,A01,083080,Cao; Yingjun,0,89,40,40
1650395902721,CSE 12,A01,083652,Staff,0,14,100,100
1650395908750,CSE 15L,A01,083654,Staff,0,1,50,50
1650395908750,CSE 15L,A02,083655,Staff,1,0,50,49
1650395914778,CSE 20,A01,083657,Staff,51,0,80,29
1650395920804,CSE 30,A01,083084,Eldon; John,0,76,40,40
1650395926832,CSE 100,A01,083659,Cao; Yingjun,0,66,50,50
1650395932868,CSE 134B,A01,083661,Powell; Thomas Allan,0,31,65,65
1650395938894,CSE 140,A01,083663,Staff,0,0,75,75
1650395944920,CSE 140L,A01,083088,Eldon; John,0,7,75,75
1650395950947,CSE 175,A01,083665,Kumar; Rakesh,8,0,25,17
1650395956971,CSE 190,A00,092507,Dubnov; Shlomo,14,0,20,6
1650395963005,ECE 45,A01,083139,Staff,0,17,40,40
1650395969033,ECE 65,A50,083695,Staff,0,5,30,30
1650395975060,ECE 109,A01,091882,Touri; Behrouz,39,0,70,31
1650395981087,ECE 180,A00,083140,Abi Samra; Nicholas Camill,24,0,30,6
1650395981087,ECE 180,B00,083141,Abi Samra; Nicholas Camill,2,0,30,28
1650395987111,MATH 10A,A01,083735,Patchell; Gregory David,7,0,30,23
1650395987111,MATH 10A,A02,083736,Patchell; Gregory David,28,0,30,2
1650395987111,MATH 10A,A03,083737,Patchell; Gregory David,25,0,30,5
1650395993139,MATH 10B,A01,083207,Staff,0,7,30,30
1650395993139,MATH 10B,A02,083208,Staff,0,7,30,30
1650395993139,MATH 10B,B01,083739,Staff,16,0,30,14
1650395993139,MATH 10B,B02,083740,Staff,28,0,30,2
1650395999164,MATH 18,A01,083743,Staff,3,0,30,27
1650395999164,MATH 18,A02,083744,Staff,27,0,30,3
1650395999164,MATH 18,A03,083745,Staff,22,0,30,8
1650395999164,MATH 18,A04,083746,Staff,27,0,30,3
1650395999164,MATH 18,B01,083748,Staff,0,11,30,30
1650395999164,MATH 18,B02,083749,Staff,0,12,30,30
1650395999164,MATH 18,B03,083750,Staff,0,11,30,30
1650395999164,MATH 18,B04,083751,Staff,0,9,30,30
1650396005191,MATH 20A,A01,083754,Staff,26,0,40,14
1650396011215,MATH 20B,A01,083756,Staff,0,9,30,30
1650396011215,MATH 20B,A02,083757,Staff,0,8,30,30
1650396017241,MATH 20C,A01,083760,Staff,0,14,30,30
1650396017241,MATH 20C,A02,083761,Staff,1,15,30,29
1650396017241,MATH 20C,B01,083762,Staff,13,0,30,17
1650396017241,MATH 20C,B02,083763,Staff,28,0,30,2
1650396023269,MATH 20D,A01,083765,Staff,0,1,30,30
1650396023269,MATH 20D,A02,083766,Staff,7,0,30,23
1650396023269,MATH 20D,A03,083767,Staff,26,0,30,4
1650396029297,MATH 20E,A01,083771,Staff,5,0,30,25
1650396029297,MATH 20E,A02,083772,Staff,19,0,30,11
1650396029297,MATH 20E,B01,083773,Staff,0,0,30,30
1650396029297,MATH 20E,B02,083774,Staff,12,0,30,18
1650396035327,MATH 103A,A01,083777,Staff,0,11,30,30
1650396035327,MATH 103A,A02,083778,Staff,0,12,30,30
1650396035327,MATH 103A,B01,083779,Staff,0,13,30,30
1650396035327,MATH 103A,B02,083780,Staff,0,11,30,30
1650396041351,MATH 105,A01,085443,Staff,0,21,30,30
1650396047392,MATH 109,A01,083213,Anzaldo; Leesa B,0,7,30,30
1650396047392,MATH 109,A02,083214,Anzaldo; Leesa B,0,7,30,30
1650396047392,MATH 109,B01,083215,Anzaldo; Leesa B,0,5,30,30
1650396047392,MATH 109,B02,083216,Anzaldo; Leesa B,0,5,30,30
1650396053421,MATH 142A,A01,083219,Chow; Bennett,0,14,30,30
1650396053421,MATH 142A,A02,083220,Chow; Bennett,0,13,30,30
1650396053421,MATH 142A,B01,083221,Chow; Bennett,0,12,30,30
1650396053421,MATH 142A,B02,083222,Chow; Bennett,0,12,30,30
1650396059446,MATH 193A,A01,083224,Staff,0,5,30,30
1650396059446,MATH 193A,A02,083225,Staff,0,5,30,30
1650396059446,MATH 193A,A03,083781,Staff,0,4,30,30
1650396059446,MATH 193A,A04,083782,Staff,0,4,30,30
1650396065475,MATH 197,001,091859,McAuley; Julian John,9998,0,9999,1
1650396071528,COGS 9,A01,083615,Staff,0,14,60,60
1650396077553,COGS 11,A01,083617,Boyle; Mary E. T.,22,0,40,18
1650396083584,COGS 13,A01,083071,Staff,0,33,40,40
1650396089612,COGS 14A,A01,092681,Staff,0,23,100,100
1650396095727,COGS 14B,A01,083073,Cheng; Tzu-Han,0,10,50,50
1650396101762,COGS 17,A01,092677,Staff,24,0,75,51
1650396107785,COGS 100,A01,083619,Staff,0,24,60,60
1650396113824,COGS 101A,A01,083621,Davis; Joshua Daniel,0,21,60,60
1650396119847,COGS 101B,A01,091572,Staff,0,2,60,60
1650396125878,COGS 101C,A01,083625,Delgado; Tania,16,0,30,14
1650396131903,COGS 107A,A01,083627,Boyle; Mary E. T.,0,10,60,60
1650396137926,COGS 118A,A01,083075,Staff,4,0,60,56
1650396143952,CSE 3,A50,083646,Miranda; Gregory Joseph,21,0,38,17
1650396143952,CSE 3,A51,083647,Miranda; Gregory Joseph,37,0,37,0
1650396149988,CSE 8A,A50,083650,Miranda; Gregory Joseph,0,28,40,40
1650396156011,CSE 11,A01,083080,Cao; Yingjun,0,89,40,40
1650396162048,CSE 12,A01,083652,Staff,0,14,100,100
1650396168074,CSE 15L,A01,083654,Staff,0,1,50,50
1650396168074,CSE 15L,A02,083655,Staff,1,0,50,49
1650396174107,CSE 20,A01,083657,Staff,51,0,80,29
1650396180141,CSE 30,A01,083084,Eldon; John,0,76,40,40
1650396186172,CSE 100,A01,083659,Cao; Yingjun,0,66,50,50
1650396192195,CSE 134B,A01,083661,Powell; Thomas Allan,0,31,65,65
1650396198222,CSE 140,A01,083663,Staff,0,0,75,75
1650396204249,CSE 140L,A01,083088,Eldon; John,0,7,75,75
1650396210272,CSE 175,A01,083665,Kumar; Rakesh,8,0,25,17
1650396216298,CSE 190,A00,092507,Dubnov; Shlomo,14,0,20,6
1650396222338,ECE 45,A01,083139,Staff,0,17,40,40
1650396228384,ECE 65,A50,083695,Staff,0,5,30,30
1650396234410,ECE 109,A01,091882,Touri; Behrouz,39,0,70,31
1650396240443,ECE 180,A00,083140,Abi Samra; Nicholas Camill,24,0,30,6
1650396240443,ECE 180,B00,083141,Abi Samra; Nicholas Camill,2,0,30,28
1650396246468,MATH 10A,A01,083735,Patchell; Gregory David,7,0,30,23
1650396246468,MATH 10A,A02,083736,Patchell; Gregory David,28,0,30,2
1650396246468,MATH 10A,A03,083737,Patchell; Gregory David,25,0,30,5
1650396252496,MATH 10B,A01,083207,Staff,0,7,30,30
1650396252496,MATH 10B,A02,083208,Staff,0,7,30,30
1650396252496,MATH 10B,B01,083739,Staff,16,0,30,14
1650396252496,MATH 10B,B02,083740,Staff,28,0,30,2
1650396258523,MATH 18,A01,083743,Staff,3,0,30,27
1650396258523,MATH 18,A02,083744,Staff,27,0,30,3
1650396258523,MATH 18,A03,083745,Staff,22,0,30,8
1650396258523,MATH 18,A04,083746,Staff,27,0,30,3
1650396258523,MATH 18,B01,083748,Staff,0,11,30,30
1650396258523,MATH 18,B02,083749,Staff,0,12,30,30
1650396258523,MATH 18,B03,083750,Staff,0,11,30,30
1650396258523,MATH 18,B04,083751,Staff,0,9,30,30
1650396264547,MATH 20A,A01,083754,Staff,26,0,40,14
1650396270580,MATH 20B,A01,083756,Staff,0,9,30,30
1650396270580,MATH 20B,A02,083757,Staff,0,8,30,30
1650396276602,MATH 20C,A01,083760,Staff,0,14,30,30
1650396276602,MATH 20C,A02,083761,Staff,1,15,30,29
1650396276602,MATH 20C,B01,083762,Staff,12,0,30,18
1650396276602,MATH 20C,B02,083763,Staff,28,0,30,2
1650396282629,MATH 20D,A01,083765,Staff,0,1,30,30
1650396282629,MATH 20D,A02,083766,Staff,7,0,30,23
1650396282629,MATH 20D,A03,083767,Staff,26,0,30,4
1650396288663,MATH 20E,A01,083771,Staff,5,0,30,25
1650396288663,MATH 20E,A02,083772,Staff,19,0,30,11
1650396288663,MATH 20E,B01,083773,Staff,0,0,30,30
1650396288663,MATH 20E,B02,083774,Staff,12,0,30,18
1650396294687,MATH 103A,A01,083777,Staff,0,11,30,30
1650396294687,MATH 103A,A02,083778,Staff,0,12,30,30
1650396294687,MATH 103A,B01,083779,Staff,0,13,30,30
1650396294687,MATH 103A,B02,083780,Staff,0,11,30,30
1650396301325,MATH 105,A01,085443,Staff,0,21,30,30
1650396307354,MATH 109,A01,083213,Anzaldo; Leesa B,0,7,30,30
1650396307354,MATH 109,A02,083214,Anzaldo; Leesa B,0,7,30,30
1650396307354,MATH 109,B01,083215,Anzaldo; Leesa B,0,5,30,30
1650396307354,MATH 109,B02,083216,Anzaldo; Leesa B,0,5,30,30
1650396313385,MATH 142A,A01,083219,Chow; Bennett,0,14,30,30
1650396313385,MATH 142A,A02,083220,Chow; Bennett,0,13,30,30
1650396313385,MATH 142A,B01,083221,Chow; Bennett,0,12,30,30
1650396313385,MATH 142A,B02,083222,Chow; Bennett,0,12,30,30
1650396319413,MATH 193A,A01,083224,Staff,0,5,30,30
1650396319413,MATH 193A,A02,083225,Staff,0,5,30,30
1650396319413,MATH 193A,A03,083781,Staff,0,4,30,30
1650396319413,MATH 193A,A04,083782,Staff,0,4,30,30
1650396325437,MATH 197,001,091859,McAuley; Julian John,9998,0,9999,1
1650396331491,COGS 9,A01,083615,Staff,0,14,60,60
1650396337517,COGS 11,A01,083617,Boyle; Mary E. T.,22,0,40,18
1650396343551,COGS 13,A01,083071,Staff,0,33,40,40
1650396349579,COGS 14A,A01,092681,Staff,0,23,100,100
1650396355607,COGS 14B,A01,083073,Cheng; Tzu-Han,0,10,50,50
1650396361637,COGS 17,A01,092677,Staff,24,0,75,51
1650396367664,COGS 100,A01,083619,Staff,0,24,60,60
1650396373688,COGS 101A,A01,083621,Davis; Joshua Daniel,0,21,60,60
1650396379715,COGS 101B,A01,091572,Staff,0,2,60,60
1650396385743,COGS 101C,A01,083625,Delgado; Tania,16,0,30,14
1650396391771,COGS 107A,A01,083627,Boyle; Mary E. T.,0,10,60,60
1650396397799,COGS 118A,A01,083075,Staff,4,0,60,56
1650396403827,CSE 3,A50,083646,Miranda; Gregory Joseph,21,0,38,17
1650396403827,CSE 3,A51,083647,Miranda; Gregory Joseph,37,0,37,0
1650396409851,CSE 8A,A50,083650,Miranda; Gregory Joseph,0,28,40,40
1650396415874,CSE 11,A01,083080,Cao; Yingjun,0,89,40,40
1650396421900,CSE 12,A01,083652,Staff,0,14,100,100
1650396427928,CSE 15L,A01,083654,Staff,0,1,50,50
1650396427928,CSE 15L,A02,083655,Staff,1,0,50,49
1650396433952,CSE 20,A01,083657,Staff,51,0,80,29
1650396439978,CSE 30,A01,083084,Eldon; John,0,76,40,40
1650396446002,CSE 100,A01,083659,Cao; Yingjun,0,66,50,50
1650396452026,CSE 134B,A01,083661,Powell; Thomas Allan,0,31,65,65
1650396458048,CSE 140,A01,083663,Staff,0,0,75,75
1650396464083,CSE 140L,A01,083088,Eldon; John,0,7,75,75
1650396470111,CSE 175,A01,083665,Kumar; Rakesh,8,0,25,17
1650396476141,CSE 190,A00,092507,Dubnov; Shlomo,14,0,20,6
1650396482169,ECE 45,A01,083139,Staff,0,17,40,40
1650396488199,ECE 65,A50,083695,Staff,0,5,30,30
1650396494223,ECE 109,A01,091882,Touri; Behrouz,39,0,70,31
1650396500251,ECE 180,A00,083140,Abi Samra; Nicholas Camill,24,0,30,6
1650396500251,ECE 180,B00,083141,Abi Samra; Nicholas Camill,2,0,30,28
1650396506285,MATH 10A,A01,083735,Patchell; Gregory David,7,0,30,23
1650396506285,MATH 10A,A02,083736,Patchell; Gregory David,28,0,30,2
1650396506285,MATH 10A,A03,083737,Patchell; Gregory David,25,0,30,5
1650396512309,MATH 10B,A01,083207,Staff,0,7,30,30
1650396512309,MATH 10B,A02,083208,Staff,0,7,30,30
1650396512309,MATH 10B,B01,083739,Staff,16,0,30,14
1650396512309,MATH 10B,B02,083740,Staff,28,0,30,2
1650396518334,MATH 18,A01,083743,Staff,3,0,30,27
1650396518334,MATH 18,A02,083744,Staff,27,0,30,3
1650396518334,MATH 18,A03,083745,Staff,22,0,30,8
1650396518334,MATH 18,A04,083746,Staff,27,0,30,3
1650396518334,MATH 18,B01,083748,Staff,0,11,30,30
1650396518334,MATH 18,B02,083749,Staff,0,12,30,30
1650396518334,MATH 18,B03,083750,Staff,0,11,30,30
1650396518334,MATH 18,B04,083751,Staff,0,9,30,30
1650396524367,MATH 20A,A01,083754,Staff,26,0,40,14
1650396530393,MATH 20B,A01,083756,Staff,0,9,30,30
1650396530393,MATH 20B,A02,083757,Staff,0,8,30,30
1650396536421,MATH 20C,A01,083760,Staff,0,14,30,30
1650396536421,MATH 20C,A02,083761,Staff,1,15,30,29
1650396536421,MATH 20C,B01,083762,Staff,13,0,30,17
1650396536421,MATH 20C,B02,083763,Staff,28,0,30,2
1650396542457,MATH 20D,A01,083765,Staff,0,1,30,30
1650396542457,MATH 20D,A02,083766,Staff,7,0,30,23
1650396542457,MATH 20D,A03,083767,Staff,26,0,30,4
1650396548489,MATH 20E,A01,083771,Staff,5,0,30,25
1650396548489,MATH 20E,A02,083772,Staff,19,0,30,11
1650396548489,MATH 20E,B01,083773,Staff,0,0,30,30
1650396548489,MATH 20E,B02,083774,Staff,12,0,30,18
1650396554515,MATH 103A,A01,083777,Staff,0,11,30,30
1650396554515,MATH 103A,A02,083778,Staff,0,12,30,30
1650396554515,MATH 103A,B01,083779,Staff,0,13,30,30
1650396554515,MATH 103A,B02,083780,Staff,0,11,30,30
1650396560538,MATH 105,A01,085443,Staff,0,21,30,30
1650396566567,MATH 109,A01,083213,Anzaldo; Leesa B,0,7,30,30
1650396566567,MATH 109,A02,083214,Anzaldo; Leesa B,0,7,30,30
1650396566567,MATH 109,B01,083215,Anzaldo; Leesa B,0,5,30,30
1650396566567,MATH 109,B02,083216,Anzaldo; Leesa B,0,5,30,30
1650396572590,MATH 142A,A01,083219,Chow; Bennett,0,14,30,30
1650396572590,MATH 142A,A02,083220,Chow; Bennett,0,13,30,30
1650396572590,MATH 142A,B01,083221,Chow; Bennett,0,12,30,30
1650396572590,MATH 142A,B02,083222,Chow; Bennett,0,12,30,30
1650396578614,MATH 193A,A01,083224,Staff,0,5,30,30
1650396578614,MATH 193A,A02,083225,Staff,0,5,30,30
1650396578614,MATH 193A,A03,083781,Staff,0,4,30,30
1650396578614,MATH 193A,A04,083782,Staff,0,4,30,30
1650396584648,MATH 197,001,091859,McAuley; Julian John,9998,0,9999,1
1650396590700,COGS 9,A01,083615,Staff,0,14,60,60
1650396596729,COGS 11,A01,083617,Boyle; Mary E. T.,22,0,40,18
1650396602752,COGS 13,A01,083071,Staff,0,33,40,40
1650396608780,COGS 14A,A01,092681,Staff,0,23,100,100
1650396614821,COGS 14B,A01,083073,Cheng; Tzu-Han,0,10,50,50
1650396620854,COGS 17,A01,092677,Staff,24,0,75,51
1650396626879,COGS 100,A01,083619,Staff,0,24,60,60
1650396632907,COGS 101A,A01,083621,Davis; Joshua Daniel,0,21,60,60
1650396639526,COGS 101B,A01,091572,Staff,0,2,60,60
1650396645549,COGS 101C,A01,083625,Delgado; Tania,16,0,30,14
1650396651577,COGS 107A,A01,083627,Boyle; Mary E. T.,0,10,60,60
1650396657599,COGS 118A,A01,083075,Staff,4,0,60,56
1650396663631,CSE 3,A50,083646,Miranda; Gregory Joseph,21,0,38,17
1650396663631,CSE 3,A51,083647,Miranda; Gregory Joseph,37,0,37,0
1650396669665,CSE 8A,A50,083650,Miranda; Gregory Joseph,0,28,40,40
1650396675697,CSE 11,A01,083080,Cao; Yingjun,0,89,40,40
1650396681729,CSE 12,A01,083652,Staff,0,14,100,100
1650396687753,CSE 15L,A01,083654,Staff,0,1,50,50
1650396687753,CSE 15L,A02,083655,Staff,1,0,50,49
1650396693869,CSE 20,A01,083657,Staff,51,0,80,29
1650396699914,CSE 30,A01,083084,Eldon; John,0,76,40,40
1650396705937,CSE 100,A01,083659,Cao; Yingjun,0,66,50,50
1650396711965,CSE 134B,A01,083661,Powell; Thomas Allan,0,31,65,65
1650396717991,CSE 140,A01,083663,Staff,0,0,75,75
1650396724017,CSE 140L,A01,083088,Eldon; John,0,7,75,75
1650396730044,CSE 175,A01,083665,Kumar; Rakesh,8,0,25,17
1650396736078,CSE 190,A00,092507,Dubnov; Shlomo,14,0,20,6
1650396742113,ECE 45,A01,083139,Staff,0,17,40,40
1650396748139,ECE 65,A50,083695,Staff,0,5,30,30
1650396754162,ECE 109,A01,091882,Touri; Behrouz,39,0,70,31
1650396760189,ECE 180,A00,083140,Abi Samra; Nicholas Camill,24,0,30,6
1650396760189,ECE 180,B00,083141,Abi Samra; Nicholas Camill,2,0,30,28
1650396766221,MATH 10A,A01,083735,Patchell; Gregory David,7,0,30,23
1650396766221,MATH 10A,A02,083736,Patchell; Gregory David,28,0,30,2
1650396766221,MATH 10A,A03,083737,Patchell; Gregory David,25,0,30,5
1650396772245,MATH 10B,A01,083207,Staff,0,7,30,30
1650396772245,MATH 10B,A02,083208,Staff,0,7,30,30
1650396772245,MATH 10B,B01,083739,Staff,16,0,30,14
1650396772245,MATH 10B,B02,083740,Staff,28,0,30,2
1650396778272,MATH 18,A01,083743,Staff,3,0,30,27
1650396778272,MATH 18,A02,083744,Staff,27,0,30,3
1650396778272,MATH 18,A03,083745,Staff,22,0,30,8
1650396778272,MATH 18,A04,083746,Staff,27,0,30,3
1650396778272,MATH 18,B01,083748,Staff,0,11,30,30
1650396778272,MATH 18,B02,083749,Staff,0,12,30,30
1650396778272,MATH 18,B03,083750,Staff,0,11,30,30
1650396778272,MATH 18,B04,083751,Staff,0,9,30,30
1650396784300,MATH 20A,A01,083754,Staff,26,0,40,14
1650396790325,MATH 20B,A01,083756,Staff,0,9,30,30
1650396790325,MATH 20B,A02,083757,Staff,0,8,30,30
1650396796349,MATH 20C,A01,083760,Staff,0,14,30,30
1650396796349,MATH 20C,A02,083761,Staff,1,15,30,29
1650396796349,MATH 20C,B01,083762,Staff,13,0,30,17
1650396796349,MATH 20C,B02,083763,Staff,28,0,30,2
1650396802373,MATH 20D,A01,083765,Staff,0,1,30,30
1650396802373,MATH 20D,A02,083766,Staff,7,0,30,23
1650396802373,MATH 20D,A03,083767,Staff,26,0,30,4
1650396808398,MATH 20E,A01,083771,Staff,5,0,30,25
1650396808398,MATH 20E,A02,083772,Staff,19,0,30,11
1650396808398,MATH 20E,B01,083773,Staff,0,0,30,30
1650396808398,MATH 20E,B02,083774,Staff,12,0,30,18
1650396814423,MATH 103A,A01,083777,Staff,0,11,30,30
1650396814423,MATH 103A,A02,083778,Staff,0,12,30,30
1650396814423,MATH 103A,B01,083779,Staff,0,13,30,30
1650396814423,MATH 103A,B02,083780,Staff,0,11,30,30
1650396820449,MATH 105,A01,085443,Staff,0,21,30,30
1650396826480,MATH 109,A01,083213,Anzaldo; Leesa B,0,7,30,30
1650396826480,MATH 109,A02,083214,Anzaldo; Leesa B,0,7,30,30
1650396826480,MATH 109,B01,083215,Anzaldo; Leesa B,0,5,30,30
1650396826480,MATH 109,B02,083216,Anzaldo; Leesa B,0,5,30,30
1650396832516,MATH 142A,A01,083219,Chow; Bennett,0,14,30,30
1650396832516,MATH 142A,A02,083220,Chow; Bennett,0,13,30,30
1650396832516,MATH 142A,B01,083221,Chow; Bennett,0,12,30,30
1650396832516,MATH 142A,B02,083222,Chow; Bennett,0,12,30,30
1650396838552,MATH 193A,A01,083224,Staff,0,5,30,30
1650396838552,MATH 193A,A02,083225,Staff,0,5,30,30
1650396838552,MATH 193A,A03,083781,Staff,0,4,30,30
1650396838552,MATH 193A,A04,083782,Staff,0,4,30,30
1650396844578,MATH 197,001,091859,McAuley; Julian John,9998,0,9999,1
1650396850637,COGS 9,A01,083615,Staff,0,14,60,60
1650396856669,COGS 11,A01,083617,Boyle; Mary E. T.,22,0,40,18
1650396862693,COGS 13,A01,083071,Staff,0,33,40,40
1650396868716,COGS 14A,A01,092681,Staff,0,23,100,100
1650396874744,COGS 14B,A01,083073,Cheng; Tzu-Han,0,10,50,50
1650396880781,COGS 17,A01,092677,Staff,24,0,75,51
1650396886803,COGS 100,A01,083619,Staff,0,24,60,60
1650396892827,COGS 101A,A01,083621,Davis; Joshua Daniel,0,21,60,60
1650396898850,COGS 101B,A01,091572,Staff,0,2,60,60
1650396904878,COGS 101C,A01,083625,Delgado; Tania,16,0,30,14
1650396910904,COGS 107A,A01,083627,Boyle; Mary E. T.,0,10,60,60
1650396916931,COGS 118A,A01,083075,Staff,4,0,60,56
1650396922958,CSE 3,A50,083646,Miranda; Gregory Joseph,21,0,38,17
1650396922958,CSE 3,A51,083647,Miranda; Gregory Joseph,37,0,37,0
1650396928982,CSE 8A,A50,083650,Miranda; Gregory Joseph,0,28,40,40
1650396935013,CSE 11,A01,083080,Cao; Yingjun,0,89,40,40
1650396941036,CSE 12,A01,083652,Staff,0,14,100,100
1650396947073,CSE 15L,A01,083654,Staff,0,1,50,50
1650396947073,CSE 15L,A02,083655,Staff,1,0,50,49
1650396953100,CSE 20,A01,083657,Staff,51,0,80,29
1650396959125,CSE 30,A01,083084,Eldon; John,0,76,40,40
1650396965154,CSE 100,A01,083659,Cao; Yingjun,0,66,50,50
1650396971176,CSE 134B,A01,083661,Powell; Thomas Allan,0,31,65,65
1650396977214,CSE 140,A01,083663,Staff,0,0,75,75
1650396983238,CSE 140L,A01,083088,Eldon; John,0,7,75,75
1650396989272,CSE 175,A01,083665,Kumar; Rakesh,8,0,25,17
1650396995297,CSE 190,A00,092507,Dubnov; Shlomo,14,0,20,6
1650397001322,ECE 45,A01,083139,Staff,0,17,40,40
1650397007349,ECE 65,A50,083695,Staff,0,5,30,30
1650397013384,ECE 109,A01,091882,Touri; Behrouz,39,0,70,31
1650397019407,ECE 180,A00,083140,Abi Samra; Nicholas Camill,24,0,30,6
1650397019407,ECE 180,B00,083141,Abi Samra; Nicholas Camill,2,0,30,28
1650397025435,MATH 10A,A01,083735,Patchell; Gregory David,7,0,30,23
1650397025435,MATH 10A,A02,083736,Patchell; Gregory David,28,0,30,2
1650397025435,MATH 10A,A03,083737,Patchell; Gregory David,25,0,30,5
1650397031458,MATH 10B,A01,083207,Staff,0,7,30,30
1650397031458,MATH 10B,A02,083208,Staff,0,7,30,30
1650397031458,MATH 10B,B01,083739,Staff,16,0,30,14
1650397031458,MATH 10B,B02,083740,Staff,28,0,30,2
1650397037496,MATH 18,A01,083743,Staff,3,0,30,27
1650397037496,MATH 18,A02,083744,Staff,27,0,30,3
1650397037496,MATH 18,A03,083745,Staff,22,0,30,8
1650397037496,MATH 18,A04,083746,Staff,27,0,30,3
1650397037496,MATH 18,B01,083748,Staff,0,11,30,30
1650397037496,MATH 18,B02,083749,Staff,0,12,30,30
1650397037496,MATH 18,B03,083750,Staff,0,11,30,30
1650397037496,MATH 18,B04,083751,Staff,0,9,30,30
1650397043520,MATH 20A,A01,083754,Staff,26,0,40,14
1650397049551,MATH 20B,A01,083756,Staff,0,9,30,30
1650397049551,MATH 20B,A02,083757,Staff,0,8,30,30
1650397055586,MATH 20C,A01,083760,Staff,0,14,30,30
1650397055586,MATH 20C,A02,083761,Staff,1,15,30,29
1650397055586,MATH 20C,B01,083762,Staff,13,0,30,17
1650397055586,MATH 20C,B02,083763,Staff,28,0,30,2
1650397061613,MATH 20D,A01,083765,Staff,0,1,30,30
1650397061613,MATH 20D,A02,083766,Staff,7,0,30,23
1650397061613,MATH 20D,A03,083767,Staff,26,0,30,4
1650397067643,MATH 20E,A01,083771,Staff,5,0,30,25
1650397067643,MATH 20E,A02,083772,Staff,19,0,30,11
1650397067643,MATH 20E,B01,083773,Staff,0,0,30,30
1650397067643,MATH 20E,B02,083774,Staff,12,0,30,18
1650397073667,MATH 103A,A01,083777,Staff,0,11,30,30
1650397073667,MATH 103A,A02,083778,Staff,0,12,30,30
1650397073667,MATH 103A,B01,083779,Staff,0,13,30,30
1650397073667,MATH 103A,B02,083780,Staff,0,11,30,30
1650397079694,MATH 105,A01,085443,Staff,0,21,30,30
1650397085726,MATH 109,A01,083213,Anzaldo; Leesa B,0,7,30,30
1650397085726,MATH 109,A02,083214,Anzaldo; Leesa B,0,7,30,30
1650397085726,MATH 109,B01,083215,Anzaldo; Leesa B,0,5,30,30
1650397085726,MATH 109,B02,083216,Anzaldo; Leesa B,0,5,30,30
1650397091758,MATH 142A,A01,083219,Chow; Bennett,0,14,30,30
1650397091758,MATH 142A,A02,083220,Chow; Bennett,0,13,30,30
1650397091758,MATH 142A,B01,083221,Chow; Bennett,0,12,30,30
1650397091758,MATH 142A,B02,083222,Chow; Bennett,0,12,30,30
1650397097788,MATH 193A,A01,083224,Staff,0,5,30,30
1650397097788,MATH 193A,A02,083225,Staff,0,5,30,30
1650397097788,MATH 193A,A03,083781,Staff,0,4,30,30
1650397097788,MATH 193A,A04,083782,Staff,0,4,30,30
1650397103818,MATH 197,001,091859,McAuley; Julian John,9998,0,9999,1
1650397109872,COGS 9,A01,083615,Staff,0,14,60,60
1650397115906,COGS 11,A01,083617,Boyle; Mary E. T.,22,0,40,18
1650397121939,COGS 13,A01,083071,Staff,0,33,40,40
1650397127962,COGS 14A,A01,092681,Staff,0,23,100,100
1650397133989,COGS 14B,A01,083073,Cheng; Tzu-Han,0,10,50,50
1650397140023,COGS 17,A01,092677,Staff,24,0,75,51
1650397146058,COGS 100,A01,083619,Staff,0,24,60,60
1650397152086,COGS 101A,A01,083621,Davis; Joshua Daniel,0,21,60,60
1650397158113,COGS 101B,A01,091572,Staff,0,2,60,60
1650397164146,COGS 101C,A01,083625,Delgado; Tania,16,0,30,14
1650397170176,COGS 107A,A01,083627,Boyle; Mary E. T.,0,10,60,60
1650397176249,COGS 118A,A01,083075,Staff,4,0,60,56
1650397182548,CSE 3,A50,083646,Miranda; Gregory Joseph,21,0,38,17
1650397182548,CSE 3,A51,083647,Miranda; Gregory Joseph,37,0,37,0
1650397188897,CSE 8A,A50,083650,Miranda; Gregory Joseph,0,28,40,40
1650397195010,CSE 11,A01,083080,Cao; Yingjun,0,89,40,40
1650397201060,CSE 12,A01,083652,Staff,0,14,100,100
1650397207089,CSE 15L,A01,083654,Staff,0,1,50,50
1650397207089,CSE 15L,A02,083655,Staff,1,0,50,49
1650397213134,CSE 20,A01,083657,Staff,51,0,80,29
1650397219159,CSE 30,A01,083084,Eldon; John,0,76,40,40
1650397225186,CSE 100,A01,083659,Cao; Yingjun,0,66,50,50
1650397231230,CSE 134B,A01,083661,Powell; Thomas Allan,0,31,65,65
1650397237252,CSE 140,A01,083663,Staff,0,0,75,75
1650397243287,CSE 140L,A01,083088,Eldon; John,0,7,75,75
1650397249319,CSE 175,A01,083665,Kumar; Rakesh,8,0,25,17
1650397255344,CSE 190,A00,092507,Dubnov; Shlomo,14,0,20,6
1650397261375,ECE 45,A01,083139,Staff,0,17,40,40
1650397267401,ECE 65,A50,083695,Staff,0,5,30,30
1650397273435,ECE 109,A01,091882,Touri; Behrouz,39,0,70,31
1650397279459,ECE 180,A00,083140,Abi Samra; Nicholas Camill,24,0,30,6
1650397279459,ECE 180,B00,083141,Abi Samra; Nicholas Camill,2,0,30,28
1650397285489,MATH 10A,A01,083735,Patchell; Gregory David,7,0,30,23
1650397285489,MATH 10A,A02,083736,Patchell; Gregory David,28,0,30,2
1650397285489,MATH 10A,A03,083737,Patchell; Gregory David,25,0,30,5
1650397291587,MATH 10B,A01,083207,Staff,0,7,30,30
1650397291587,MATH 10B,A02,083208,Staff,0,7,30,30
1650397291587,MATH 10B,B01,083739,Staff,16,0,30,14
1650397291587,MATH 10B,B02,083740,Staff,28,0,30,2
1650397297630,MATH 18,A01,083743,Staff,3,0,30,27
1650397297630,MATH 18,A02,083744,Staff,27,0,30,3
1650397297630,MATH 18,A03,083745,Staff,22,0,30,8
1650397297630,MATH 18,A04,083746,Staff,27,0,30,3
1650397297630,MATH 18,B01,083748,Staff,0,11,30,30
1650397297630,MATH 18,B02,083749,Staff,0,12,30,30
1650397297630,MATH 18,B03,083750,Staff,0,11,30,30
1650397297630,MATH 18,B04,083751,Staff,0,9,30,30
1650397303656,MATH 20A,A01,083754,Staff,26,0,40,14
1650397309680,MATH 20B,A01,083756,Staff,0,9,30,30
1650397309680,MATH 20B,A02,083757,Staff,0,8,30,30
1650397315714,MATH 20C,A01,083760,Staff,0,14,30,30
1650397315714,MATH 20C,A02,083761,Staff,1,15,30,29
1650397315714,MATH 20C,B01,083762,Staff,13,0,30,17
1650397315714,MATH 20C,B02,083763,Staff,28,0,30,2
1650397321744,MATH 20D,A01,083765,Staff,0,1,30,30
1650397321744,MATH 20D,A02,083766,Staff,7,0,30,23
1650397321744,MATH 20D,A03,083767,Staff,26,0,30,4
1650397327768,MATH 20E,A01,083771,Staff,5,0,30,25
1650397327768,MATH 20E,A02,083772,Staff,19,0,30,11
1650397327768,MATH 20E,B01,083773,Staff,0,0,30,30
1650397327768,MATH 20E,B02,083774,Staff,12,0,30,18
1650397333810,MATH 103A,A01,083777,Staff,0,11,30,30
1650397333810,MATH 103A,A02,083778,Staff,0,12,30,30
1650397333810,MATH 103A,B01,083779,Staff,0,13,30,30
1650397333810,MATH 103A,B02,083780,Staff,0,11,30,30
1650397339849,MATH 105,A01,085443,Staff,0,21,30,30
1650397345873,MATH 109,A01,083213,Anzaldo; Leesa B,0,7,30,30
1650397345873,MATH 109,A02,083214,Anzaldo; Leesa B,0,7,30,30
1650397345873,MATH 109,B01,083215,Anzaldo; Leesa B,0,5,30,30
1650397345873,MATH 109,B02,083216,Anzaldo; Leesa B,0,5,30,30
1650397351897,MATH 142A,A01,083219,Chow; Bennett,0,14,30,30
1650397351897,MATH 142A,A02,083220,Chow; Bennett,0,13,30,30
1650397351897,MATH 142A,B01,083221,Chow; Bennett,0,12,30,30
1650397351897,MATH 142A,B02,083222,Chow; Bennett,0,12,30,30
1650397357923,MATH 193A,A01,083224,Staff,0,5,30,30
1650397357923,MATH 193A,A02,083225,Staff,0,5,30,30
1650397357923,MATH 193A,A03,083781,Staff,0,4,30,30
1650397357923,MATH 193A,A04,083782,Staff,0,4,30,30
1650397363957,MATH 197,001,091859,McAuley; Julian John,9998,0,9999,1
1650397370021,COGS 9,A01,083615,Staff,0,14,60,60
1650397376063,COGS 11,A01,083617,Boyle; Mary E. T.,22,0,40,18
1650397382092,COGS 13,A01,083071,Staff,0,33,40,40
1650397388116,COGS 14A,A01,092681,Staff,0,23,100,100
1650397394142,COGS 14B,A01,083073,Cheng; Tzu-Han,0,10,50,50
1650397400166,COGS 17,A01,092677,Staff,24,0,75,51
1650397406197,COGS 100,A01,083619,Staff,0,24,60,60
1650397412225,COGS 101A,A01,083621,Davis; Joshua Daniel,0,21,60,60
1650397418252,COGS 101B,A01,091572,Staff,0,2,60,60
1650397424295,COGS 101C,A01,083625,Delgado; Tania,16,0,30,14
1650397430325,COGS 107A,A01,083627,Boyle; Mary E. T.,0,10,60,60
1650397436349,COGS 118A,A01,083075,Staff,4,0,60,56
1650397442384,CSE 3,A50,083646,Miranda; Gregory Joseph,21,0,38,17
1650397442384,CSE 3,A51,083647,Miranda; Gregory Joseph,37,0,37,0
1650397448411,CSE 8A,A50,083650,Miranda; Gregory Joseph,0,28,40,40
1650397454439,CSE 11,A01,083080,Cao; Yingjun,0,89,40,40
1650397460464,CSE 12,A01,083652,Staff,0,15,100,100
1650397466492,CSE 15L,A01,083654,Staff,0,1,50,50
1650397466492,CSE 15L,A02,083655,Staff,1,0,50,49
1650397472524,CSE 20,A01,083657,Staff,51,0,80,29
1650397478550,CSE 30,A01,083084,Eldon; John,0,76,40,40
1650397484586,CSE 100,A01,083659,Cao; Yingjun,0,66,50,50
1650397490610,CSE 134B,A01,083661,Powell; Thomas Allan,0,31,65,65
1650397496636,CSE 140,A01,083663,Staff,0,0,75,75
1650397502658,CSE 140L,A01,083088,Eldon; John,0,7,75,75
1650397508681,CSE 175,A01,083665,Kumar; Rakesh,8,0,25,17
1650397514705,CSE 190,A00,092507,Dubnov; Shlomo,14,0,20,6
1650397520736,ECE 45,A01,083139,Staff,0,17,40,40
1650397526763,ECE 65,A50,083695,Staff,0,5,30,30
1650397532791,ECE 109,A01,091882,Touri; Behrouz,39,0,70,31
1650397538819,ECE 180,A00,083140,Abi Samra; Nicholas Camill,24,0,30,6
1650397538819,ECE 180,B00,083141,Abi Samra; Nicholas Camill,2,0,30,28
1650397544848,MATH 10A,A01,083735,Patchell; Gregory David,7,0,30,23
1650397544848,MATH 10A,A02,083736,Patchell; Gregory David,28,0,30,2
1650397544848,MATH 10A,A03,083737,Patchell; Gregory David,25,0,30,5
1650397550881,MATH 10B,A01,083207,Staff,0,7,30,30
1650397550881,MATH 10B,A02,083208,Staff,0,7,30,30
1650397550881,MATH 10B,B01,083739,Staff,16,0,30,14
1650397550881,MATH 10B,B02,083740,Staff,28,0,30,2
1650397556910,MATH 18,A01,083743,Staff,3,0,30,27
1650397556910,MATH 18,A02,083744,Staff,27,0,30,3
1650397556910,MATH 18,A03,083745,Staff,22,0,30,8
1650397556910,MATH 18,A04,083746,Staff,27,0,30,3
1650397556910,MATH 18,B01,083748,Staff,0,11,30,30
1650397556910,MATH 18,B02,083749,Staff,0,12,30,30
1650397556910,MATH 18,B03,083750,Staff,0,11,30,30
1650397556910,MATH 18,B04,083751,Staff,0,9,30,30
1650397562949,MATH 20A,A01,083754,Staff,26,0,40,14
1650397568973,MATH 20B,A01,083756,Staff,0,9,30,30
1650397568973,MATH 20B,A02,083757,Staff,0,8,30,30
1650397574997,MATH 20C,A01,083760,Staff,0,14,30,30
1650397574997,MATH 20C,A02,083761,Staff,1,15,30,29
1650397574997,MATH 20C,B01,083762,Staff,13,0,30,17
1650397574997,MATH 20C,B02,083763,Staff,28,0,30,2
1650397581022,MATH 20D,A01,083765,Staff,0,1,30,30
1650397581022,MATH 20D,A02,083766,Staff,7,0,30,23
1650397581022,MATH 20D,A03,083767,Staff,26,0,30,4
1650397587057,MATH 20E,A01,083771,Staff,5,0,30,25
1650397587057,MATH 20E,A02,083772,Staff,19,0,30,11
1650397587057,MATH 20E,B01,083773,Staff,0,0,30,30
1650397587057,MATH 20E,B02,083774,Staff,12,0,30,18
1650397593088,MATH 103A,A01,083777,Staff,0,11,30,30
1650397593088,MATH 103A,A02,083778,Staff,0,12,30,30
1650397593088,MATH 103A,B01,083779,Staff,0,13,30,30
1650397593088,MATH 103A,B02,083780,Staff,0,11,30,30
1650397599115,MATH 105,A01,085443,Staff,0,21,30,30
1650397605149,MATH 109,A01,083213,Anzaldo; Leesa B,0,7,30,30
1650397605149,MATH 109,A02,083214,Anzaldo; Leesa B,0,7,30,30
1650397605149,MATH 109,B01,083215,Anzaldo; Leesa B,0,5,30,30
1650397605149,MATH 109,B02,083216,Anzaldo; Leesa B,0,5,30,30
1650397611181,MATH 142A,A01,083219,Chow; Bennett,0,14,30,30
1650397611181,MATH 142A,A02,083220,Chow; Bennett,0,13,30,30
1650397611181,MATH 142A,B01,083221,Chow; Bennett,0,12,30,30
1650397611181,MATH 142A,B02,083222,Chow; Bennett,0,12,30,30
1650397617218,MATH 193A,A01,083224,Staff,0,5,30,30
1650397617218,MATH 193A,A02,083225,Staff,0,5,30,30
1650397617218,MATH 193A,A03,083781,Staff,0,4,30,30
1650397617218,MATH 193A,A04,083782,Staff,0,4,30,30
1650397623244,MATH 197,001,091859,McAuley; Julian John,9998,0,9999,1
1650397629320,COGS 9,A01,083615,Staff,0,14,60,60
1650397635344,COGS 11,A01,083617,Boyle; Mary E. T.,22,0,40,18
1650397641370,COGS 13,A01,083071,Staff,0,33,40,40
1650397647394,COGS 14A,A01,092681,Staff,0,23,100,100
1650397653426,COGS 14B,A01,083073,Cheng; Tzu-Han,0,10,50,50
1650397659457,COGS 17,A01,092677,Staff,24,0,75,51
1650397665484,COGS 100,A01,083619,Staff,0,24,60,60
1650397671511,COGS 101A,A01,083621,Davis; Joshua Daniel,0,21,60,60
1650397677535,COGS 101B,A01,091572,Staff,0,2,60,60
1650397683562,COGS 101C,A01,083625,Delgado; Tania,16,0,30,14
1650397689586,COGS 107A,A01,083627,Boyle; Mary E. T.,0,10,60,60
1650397695619,COGS 118A,A01,083075,Staff,4,0,60,56
1650397701643,CSE 3,A50,083646,Miranda; Gregory Joseph,21,0,38,17
1650397701643,CSE 3,A51,083647,Miranda; Gregory Joseph,37,0,37,0
1650397707688,CSE 8A,A50,083650,Miranda; Gregory Joseph,0,28,40,40
1650397713715,CSE 11,A01,083080,Cao; Yingjun,0,89,40,40
1650397719740,CSE 12,A01,083652,Staff,0,15,100,100
1650397725766,CSE 15L,A01,083654,Staff,0,1,50,50
1650397725766,CSE 15L,A02,083655,Staff,1,0,50,49
1650397731802,CSE 20,A01,083657,Staff,51,0,80,29
1650397737833,CSE 30,A01,083084,Eldon; John,0,76,40,40
1650397743864,CSE 100,A01,083659,Cao; Yingjun,0,66,50,50
1650397749888,CSE 134B,A01,083661,Powell; Thomas Allan,0,31,65,65
1650397755912,CSE 140,A01,083663,Staff,0,0,75,75
1650397761939,CSE 140L,A01,083088,Eldon; John,0,7,75,75
1650397767963,CSE 175,A01,083665,Kumar; Rakesh,8,0,25,17
1650397773993,CSE 190,A00,092507,Dubnov; Shlomo,14,0,20,6
1650397780020,ECE 45,A01,083139,Staff,0,17,40,40
1650397786044,ECE 65,A50,083695,Staff,0,5,30,30
1650397792070,ECE 109,A01,091882,Touri; Behrouz,39,0,70,31
1650397798102,ECE 180,A00,083140,Abi Samra; Nicholas Camill,24,0,30,6
1650397798102,ECE 180,B00,083141,Abi Samra; Nicholas Camill,2,0,30,28
1650397804131,MATH 10A,A01,083735,Patchell; Gregory David,7,0,30,23
1650397804131,MATH 10A,A02,083736,Patchell; Gregory David,28,0,30,2
1650397804131,MATH 10A,A03,083737,Patchell; Gregory David,25,0,30,5
1650397810158,MATH 10B,A01,083207,Staff,0,7,30,30
1650397810158,MATH 10B,A02,083208,Staff,0,7,30,30
1650397810158,MATH 10B,B01,083739,Staff,16,0,30,14
1650397810158,MATH 10B,B02,083740,Staff,28,0,30,2
1650397816201,MATH 18,A01,083743,Staff,3,0,30,27
1650397816201,MATH 18,A02,083744,Staff,27,0,30,3
1650397816201,MATH 18,A03,083745,Staff,22,0,30,8
1650397816201,MATH 18,A04,083746,Staff,27,0,30,3
1650397816201,MATH 18,B01,083748,Staff,0,11,30,30
1650397816201,MATH 18,B02,083749,Staff,0,12,30,30
1650397816201,MATH 18,B03,083750,Staff,0,11,30,30
1650397816201,MATH 18,B04,083751,Staff,0,9,30,30
1650397822237,MATH 20A,A01,083754,Staff,26,0,40,14
1650397828281,MATH 20B,A01,083756,Staff,0,9,30,30
1650397828281,MATH 20B,A02,083757,Staff,0,8,30,30
1650397834312,MATH 20C,A01,083760,Staff,0,14,30,30
1650397834312,MATH 20C,A02,083761,Staff,1,15,30,29
1650397834312,MATH 20C,B01,083762,Staff,13,0,30,17
1650397834312,MATH 20C,B02,083763,Staff,28,0,30,2
1650397840335,MATH 20D,A01,083765,Staff,0,1,30,30
1650397840335,MATH 20D,A02,083766,Staff,7,0,30,23
1650397840335,MATH 20D,A03,083767,Staff,26,0,30,4
1650397846362,MATH 20E,A01,083771,Staff,5,0,30,25
1650397846362,MATH 20E,A02,083772,Staff,19,0,30,11
1650397846362,MATH 20E,B01,083773,Staff,0,0,30,30
1650397846362,MATH 20E,B02,083774,Staff,12,0,30,18
1650397852400,MATH 103A,A01,083777,Staff,0,11,30,30
1650397852400,MATH 103A,A02,083778,Staff,0,12,30,30
1650397852400,MATH 103A,B01,083779,Staff,0,13,30,30
1650397852400,MATH 103A,B02,083780,Staff,0,11,30,30
1650397858429,MATH 105,A01,085443,Staff,0,21,30,30
1650397864457,MATH 109,A01,083213,Anzaldo; Leesa B,0,7,30,30
1650397864457,MATH 109,A02,083214,Anzaldo; Leesa B,0,7,30,30
1650397864457,MATH 109,B01,083215,Anzaldo; Leesa B,0,5,30,30
1650397864457,MATH 109,B02,083216,Anzaldo; Leesa B,0,5,30,30
1650397870482,MATH 142A,A01,083219,Chow; Bennett,0,14,30,30
1650397870482,MATH 142A,A02,083220,Chow; Bennett,0,13,30,30
1650397870482,MATH 142A,B01,083221,Chow; Bennett,0,12,30,30
1650397870482,MATH 142A,B02,083222,Chow; Bennett,0,12,30,30
1650397876512,MATH 193A,A01,083224,Staff,0,5,30,30
1650397876512,MATH 193A,A02,083225,Staff,0,5,30,30
1650397876512,MATH 193A,A03,083781,Staff,0,4,30,30
1650397876512,MATH 193A,A04,083782,Staff,0,4,30,30
1650397882536,MATH 197,001,091859,McAuley; Julian John,9998,0,9999,1
1650397888696,COGS 9,A01,083615,Staff,0,14,60,60
1650397894719,COGS 11,A01,083617,Boyle; Mary E. T.,22,0,40,18
1650397900744,COGS 13,A01,083071,Staff,0,33,40,40
1650397906769,COGS 14A,A01,092681,Staff,0,23,100,100
1650397912796,COGS 14B,A01,083073,Cheng; Tzu-Han,0,10,50,50
1650397918825,COGS 17,A01,092677,Staff,24,0,75,51
1650397924847,COGS 100,A01,083619,Staff,0,24,60,60
1650397930875,COGS 101A,A01,083621,Davis; Joshua Daniel,0,21,60,60
1650397936900,COGS 101B,A01,091572,Staff,0,2,60,60
1650397942935,COGS 101C,A01,083625,Delgado; Tania,16,0,30,14
1650397948959,COGS 107A,A01,083627,Boyle; Mary E. T.,0,10,60,60
1650397954984,COGS 118A,A01,083075,Staff,4,0,60,56
1650397961016,CSE 3,A50,083646,Miranda; Gregory Joseph,21,0,38,17
1650397961016,CSE 3,A51,083647,Miranda; Gregory Joseph,37,0,37,0
1650397967051,CSE 8A,A50,083650,Miranda; Gregory Joseph,0,28,40,40
1650397973074,CSE 11,A01,083080,Cao; Yingjun,0,89,40,40
1650397979101,CSE 12,A01,083652,Staff,0,15,100,100
1650397985135,CSE 15L,A01,083654,Staff,0,1,50,50
1650397985135,CSE 15L,A02,083655,Staff,1,0,50,49
1650397991158,CSE 20,A01,083657,Staff,51,0,80,29
1650397997181,CSE 30,A01,083084,Eldon; John,0,76,40,40
1650398003208,CSE 100,A01,083659,Cao; Yingjun,0,66,50,50
1650398009234,CSE 134B,A01,083661,Powell; Thomas Allan,0,31,65,65
1650398015267,CSE 140,A01,083663,Staff,0,0,75,75
1650398021295,CSE 140L,A01,083088,Eldon; John,0,7,75,75
1650398027320,CSE 175,A01,083665,Kumar; Rakesh,8,0,25,17
1650398033342,CSE 190,A00,092507,Dubnov; Shlomo,14,0,20,6
1650398039374,ECE 45,A01,083139,Staff,0,17,40,40
1650398045402,ECE 65,A50,083695,Staff,0,5,30,30
1650398051431,ECE 109,A01,091882,Touri; Behrouz,39,0,70,31
1650398057454,ECE 180,A00,083140,Abi Samra; Nicholas Camill,24,0,30,6
1650398057454,ECE 180,B00,083141,Abi Samra; Nicholas Camill,2,0,30,28
1650398063478,MATH 10A,A01,083735,Patchell; Gregory David,7,0,30,23
1650398063478,MATH 10A,A02,083736,Patchell; Gregory David,28,0,30,2
1650398063478,MATH 10A,A03,083737,Patchell; Gregory David,25,0,30,5
1650398069504,MATH 10B,A01,083207,Staff,0,7,30,30
1650398069504,MATH 10B,A02,083208,Staff,0,7,30,30
1650398069504,MATH 10B,B01,083739,Staff,16,0,30,14
1650398069504,MATH 10B,B02,083740,Staff,28,0,30,2
1650398075535,MATH 18,A01,083743,Staff,3,0,30,27
1650398075535,MATH 18,A02,083744,Staff,27,0,30,3
1650398075535,MATH 18,A03,083745,Staff,22,0,30,8
1650398075535,MATH 18,A04,083746,Staff,27,0,30,3
1650398075535,MATH 18,B01,083748,Staff,0,11,30,30
1650398075535,MATH 18,B02,083749,Staff,0,12,30,30
1650398075535,MATH 18,B03,083750,Staff,0,11,30,30
1650398075535,MATH 18,B04,083751,Staff,0,9,30,30
1650398081581,MATH 20A,A01,083754,Staff,26,0,40,14
1650398087604,MATH 20B,A01,083756,Staff,0,9,30,30
1650398087604,MATH 20B,A02,083757,Staff,0,8,30,30
1650398093630,MATH 20C,A01,083760,Staff,0,14,30,30
1650398093630,MATH 20C,A02,083761,Staff,1,15,30,29
1650398093630,MATH 20C,B01,083762,Staff,13,0,30,17
1650398093630,MATH 20C,B02,083763,Staff,28,0,30,2
1650398099660,MATH 20D,A01,083765,Staff,0,1,30,30
1650398099660,MATH 20D,A02,083766,Staff,7,0,30,23
1650398099660,MATH 20D,A03,083767,Staff,26,0,30,4
1650398105695,MATH 20E,A01,083771,Staff,5,0,30,25
1650398105695,MATH 20E,A02,083772,Staff,19,0,30,11
1650398105695,MATH 20E,B01,083773,Staff,0,0,30,30
1650398105695,MATH 20E,B02,083774,Staff,12,0,30,18
1650398111718,MATH 103A,A01,083777,Staff,0,11,30,30
1650398111718,MATH 103A,A02,083778,Staff,0,12,30,30
1650398111718,MATH 103A,B01,083779,Staff,0,13,30,30
1650398111718,MATH 103A,B02,083780,Staff,0,11,30,30
1650398117744,MATH 105,A01,085443,Staff,0,22,30,30
1650398123767,MATH 109,A01,083213,Anzaldo; Leesa B,0,7,30,30
1650398123767,MATH 109,A02,083214,Anzaldo; Leesa B,0,7,30,30
1650398123767,MATH 109,B01,083215,Anzaldo; Leesa B,0,5,30,30
1650398123767,MATH 109,B02,083216,Anzaldo; Leesa B,0,5,30,30
1650398129797,MATH 142A,A01,083219,Chow; Bennett,0,14,30,30
1650398129797,MATH 142A,A02,083220,Chow; Bennett,0,13,30,30
1650398129797,MATH 142A,B01,083221,Chow; Bennett,0,12,30,30
1650398129797,MATH 142A,B02,083222,Chow; Bennett,0,12,30,30
1650398135828,MATH 193A,A01,083224,Staff,0,5,30,30
1650398135828,MATH 193A,A02,083225,Staff,0,5,30,30
1650398135828,MATH 193A,A03,083781,Staff,0,4,30,30
1650398135828,MATH 193A,A04,083782,Staff,0,4,30,30
1650398141854,MATH 197,001,091859,McAuley; Julian John,9998,0,9999,1
1650398147924,COGS 9,A01,083615,Staff,0,14,60,60
1650398153952,COGS 11,A01,083617,Boyle; Mary E. T.,22,0,40,18
1650398159985,COGS 13,A01,083071,Staff,0,33,40,40
1650398166008,COGS 14A,A01,092681,Staff,0,23,100,100
1650398172036,COGS 14B,A01,083073,Cheng; Tzu-Han,0,10,50,50
1650398178062,COGS 17,A01,092677,Staff,24,0,75,51
1650398184086,COGS 100,A01,083619,Staff,0,24,60,60
1650398190110,COGS 101A,A01,083621,Davis; Joshua Daniel,0,21,60,60
1650398196135,COGS 101B,A01,091572,Staff,0,2,60,60
1650398202159,COGS 101C,A01,083625,Delgado; Tania,16,0,30,14
1650398208185,COGS 107A,A01,083627,Boyle; Mary E. T.,0,10,60,60
1650398214212,COGS 118A,A01,083075,Staff,4,0,60,56
1650398220240,CSE 3,A50,083646,Miranda; Gregory Joseph,21,0,38,17
1650398220240,CSE 3,A51,083647,Miranda; Gregory Joseph,37,0,37,0
1650398226270,CSE 8A,A50,083650,Miranda; Gregory Joseph,0,28,40,40
1650398232299,CSE 11,A01,083080,Cao; Yingjun,0,89,40,40
1650398238334,CSE 12,A01,083652,Staff,0,15,100,100
1650398244375,CSE 15L,A01,083654,Staff,0,1,50,50
1650398244375,CSE 15L,A02,083655,Staff,1,0,50,49
1650398250404,CSE 20,A01,083657,Staff,51,0,80,29
1650398256428,CSE 30,A01,083084,Eldon; John,0,76,40,40
1650398262456,CSE 100,A01,083659,Cao; Yingjun,0,66,50,50
1650398268480,CSE 134B,A01,083661,Powell; Thomas Allan,0,31,65,65
1650398274506,CSE 140,A01,083663,Staff,0,0,75,75
1650398280534,CSE 140L,A01,083088,Eldon; John,0,7,75,75
1650398286560,CSE 175,A01,083665,Kumar; Rakesh,8,0,25,17
1650398292585,CSE 190,A00,092507,Dubnov; Shlomo,14,0,20,6
1650398298621,ECE 45,A01,083139,Staff,0,17,40,40
1650398304654,ECE 65,A50,083695,Staff,0,5,30,30
1650398310679,ECE 109,A01,091882,Touri; Behrouz,39,0,70,31
1650398316704,ECE 180,A00,083140,Abi Samra; Nicholas Camill,24,0,30,6
1650398316704,ECE 180,B00,083141,Abi Samra; Nicholas Camill,2,0,30,28
1650398322736,MATH 10A,A01,083735,Patchell; Gregory David,7,0,30,23
1650398322736,MATH 10A,A02,083736,Patchell; Gregory David,28,0,30,2
1650398322736,MATH 10A,A03,083737,Patchell; Gregory David,25,0,30,5
1650398328762,MATH 10B,A01,083207,Staff,0,7,30,30
1650398328762,MATH 10B,A02,083208,Staff,0,7,30,30
1650398328762,MATH 10B,B01,083739,Staff,16,0,30,14
1650398328762,MATH 10B,B02,083740,Staff,28,0,30,2
1650398334790,MATH 18,A01,083743,Staff,3,0,30,27
1650398334790,MATH 18,A02,083744,Staff,27,0,30,3
1650398334790,MATH 18,A03,083745,Staff,22,0,30,8
1650398334790,MATH 18,A04,083746,Staff,27,0,30,3
1650398334790,MATH 18,B01,083748,Staff,0,11,30,30
1650398334790,MATH 18,B02,083749,Staff,0,12,30,30
1650398334790,MATH 18,B03,083750,Staff,0,11,30,30
1650398334790,MATH 18,B04,083751,Staff,0,9,30,30
1650398340814,MATH 20A,A01,083754,Staff,26,0,40,14
1650398346844,MATH 20B,A01,083756,Staff,0,9,30,30
1650398346844,MATH 20B,A02,083757,Staff,0,8,30,30
1650398352874,MATH 20C,A01,083760,Staff,0,14,30,30
1650398352874,MATH 20C,A02,083761,Staff,1,15,30,29
1650398352874,MATH 20C,B01,083762,Staff,13,0,30,17
1650398352874,MATH 20C,B02,083763,Staff,28,0,30,2
1650398358902,MATH 20D,A01,083765,Staff,0,1,30,30
1650398358902,MATH 20D,A02,083766,Staff,7,0,30,23
1650398358902,MATH 20D,A03,083767,Staff,26,0,30,4
1650398364933,MATH 20E,A01,083771,Staff,5,0,30,25
1650398364933,MATH 20E,A02,083772,Staff,19,0,30,11
1650398364933,MATH 20E,B01,083773,Staff,0,0,30,30
1650398364933,MATH 20E,B02,083774,Staff,12,0,30,18
1650398370958,MATH 103A,A01,083777,Staff,0,11,30,30
1650398370958,MATH 103A,A02,083778,Staff,0,12,30,30
1650398370958,MATH 103A,B01,083779,Staff,0,13,30,30
1650398370958,MATH 103A,B02,083780,Staff,0,11,30,30
1650398376985,MATH 105,A01,085443,Staff,0,22,30,30
1650398383014,MATH 109,A01,083213,Anzaldo; Leesa B,0,7,30,30
1650398383014,MATH 109,A02,083214,Anzaldo; Leesa B,0,7,30,30
1650398383014,MATH 109,B01,083215,Anzaldo; Leesa B,0,5,30,30
1650398383014,MATH 109,B02,083216,Anzaldo; Leesa B,0,5,30,30
1650398389046,MATH 142A,A01,083219,Chow; Bennett,0,14,30,30
1650398389046,MATH 142A,A02,083220,Chow; Bennett,0,13,30,30
1650398389046,MATH 142A,B01,083221,Chow; Bennett,0,12,30,30
1650398389046,MATH 142A,B02,083222,Chow; Bennett,0,12,30,30
1650398395074,MATH 193A,A01,083224,Staff,0,5,30,30
1650398395074,MATH 193A,A02,083225,Staff,0,5,30,30
1650398395074,MATH 193A,A03,083781,Staff,0,4,30,30
1650398395074,MATH 193A,A04,083782,Staff,0,4,30,30
1650398401098,MATH 197,001,091859,McAuley; Julian John,9998,0,9999,1
1650398407151,COGS 9,A01,083615,Staff,0,14,60,60
1650398413174,COGS 11,A01,083617,Boyle; Mary E. T.,22,0,40,18
1650398419235,COGS 13,A01,083071,Staff,0,33,40,40
1650398425278,COGS 14A,A01,092681,Staff,0,23,100,100
1650398431307,COGS 14B,A01,083073,Cheng; Tzu-Han,0,10,50,50
1650398437334,COGS 17,A01,092677,Staff,24,0,75,51
1650398443359,COGS 100,A01,083619,Staff,0,24,60,60
1650398449389,COGS 101A,A01,083621,Davis; Joshua Daniel,0,21,60,60
1650398455412,COGS 101B,A01,091572,Staff,0,2,60,60
1650398461436,COGS 101C,A01,083625,Delgado; Tania,16,0,30,14
1650398467462,COGS 107A,A01,083627,Boyle; Mary E. T.,0,10,60,60
1650398473488,COGS 118A,A01,083075,Staff,4,0,60,56
1650398479612,CSE 3,A50,083646,Miranda; Gregory Joseph,21,0,38,17
1650398479612,CSE 3,A51,083647,Miranda; Gregory Joseph,37,0,37,0
1650398485639,CSE 8A,A50,083650,Miranda; Gregory Joseph,0,28,40,40
1650398491666,CSE 11,A01,083080,Cao; Yingjun,0,89,40,40
1650398497693,CSE 12,A01,083652,Staff,0,15,100,100
1650398503720,CSE 15L,A01,083654,Staff,0,1,50,50
1650398503720,CSE 15L,A02,083655,Staff,1,0,50,49
1650398509769,CSE 20,A01,083657,Staff,51,0,80,29
1650398515807,CSE 30,A01,083084,Eldon; John,0,76,40,40
1650398521830,CSE 100,A01,083659,Cao; Yingjun,0,66,50,50
1650398527855,CSE 134B,A01,083661,Powell; Thomas Allan,0,31,65,65
1650398533878,CSE 140,A01,083663,Staff,0,0,75,75
1650398539907,CSE 140L,A01,083088,Eldon; John,0,7,75,75
1650398545931,CSE 175,A01,083665,Kumar; Rakesh,8,0,25,17
1650398551971,CSE 190,A00,092507,Dubnov; Shlomo,14,0,20,6
1650398558003,ECE 45,A01,083139,Staff,0,17,40,40
1650398564032,ECE 65,A50,083695,Staff,0,5,30,30
1650398570061,ECE 109,A01,091882,Touri; Behrouz,39,0,70,31
1650398576098,ECE 180,A00,083140,Abi Samra; Nicholas Camill,24,0,30,6
1650398576098,ECE 180,B00,083141,Abi Samra; Nicholas Camill,2,0,30,28
1650398582122,MATH 10A,A01,083735,Patchell; Gregory David,7,0,30,23
1650398582122,MATH 10A,A02,083736,Patchell; Gregory David,28,0,30,2
1650398582122,MATH 10A,A03,083737,Patchell; Gregory David,25,0,30,5
1650398588145,MATH 10B,A01,083207,Staff,0,7,30,30
1650398588145,MATH 10B,A02,083208,Staff,0,7,30,30
1650398588145,MATH 10B,B01,083739,Staff,16,0,30,14
1650398588145,MATH 10B,B02,083740,Staff,28,0,30,2
1650398594183,MATH 18,A01,083743,Staff,3,0,30,27
1650398594183,MATH 18,A02,083744,Staff,27,0,30,3
1650398594183,MATH 18,A03,083745,Staff,22,0,30,8
1650398594183,MATH 18,A04,083746,Staff,27,0,30,3
1650398594183,MATH 18,B01,083748,Staff,0,11,30,30
1650398594183,MATH 18,B02,083749,Staff,0,12,30,30
1650398594183,MATH 18,B03,083750,Staff,0,11,30,30
1650398594183,MATH 18,B04,083751,Staff,0,9,30,30
1650398600209,MATH 20A,A01,083754,Staff,26,0,40,14
1650398606233,MATH 20B,A01,083756,Staff,0,9,30,30
1650398606233,MATH 20B,A02,083757,Staff,0,8,30,30
1650398612263,MATH 20C,A01,083760,Staff,0,14,30,30
1650398612263,MATH 20C,A02,083761,Staff,1,15,30,29
1650398612263,MATH 20C,B01,083762,Staff,13,0,30,17
1650398612263,MATH 20C,B02,083763,Staff,28,0,30,2
1650398618286,MATH 20D,A01,083765,Staff,0,1,30,30
1650398618286,MATH 20D,A02,083766,Staff,7,0,30,23
1650398618286,MATH 20D,A03,083767,Staff,26,0,30,4
1650398624318,MATH 20E,A01,083771,Staff,5,0,30,25
1650398624318,MATH 20E,A02,083772,Staff,19,0,30,11
1650398624318,MATH 20E,B01,083773,Staff,0,0,30,30
1650398624318,MATH 20E,B02,083774,Staff,12,0,30,18
1650398630343,MATH 103A,A01,083777,Staff,0,11,30,30
1650398630343,MATH 103A,A02,083778,Staff,0,12,30,30
1650398630343,MATH 103A,B01,083779,Staff,0,13,30,30
1650398630343,MATH 103A,B02,083780,Staff,0,11,30,30
1650398636373,MATH 105,A01,085443,Staff,0,22,30,30
1650398642400,MATH 109,A01,083213,Anzaldo; Leesa B,0,7,30,30
1650398642400,MATH 109,A02,083214,Anzaldo; Leesa B,0,7,30,30
1650398642400,MATH 109,B01,083215,Anzaldo; Leesa B,0,5,30,30
1650398642400,MATH 109,B02,083216,Anzaldo; Leesa B,0,5,30,30
1650398648427,MATH 142A,A01,083219,Chow; Bennett,0,14,30,30
1650398648427,MATH 142A,A02,083220,Chow; Bennett,0,13,30,30
1650398648427,MATH 142A,B01,083221,Chow; Bennett,0,12,30,30
1650398648427,MATH 142A,B02,083222,Chow; Bennett,0,12,30,30
1650398654459,MATH 193A,A01,083224,Staff,0,5,30,30
1650398654459,MATH 193A,A02,083225,Staff,0,5,30,30
1650398654459,MATH 193A,A03,083781,Staff,0,4,30,30
1650398654459,MATH 193A,A04,083782,Staff,0,4,30,30
1650398660485,MATH 197,001,091859,McAuley; Julian John,9998,0,9999,1
1650398666556,COGS 9,A01,083615,Staff,0,14,60,60
1650398672583,COGS 11,A01,083617,Boyle; Mary E. T.,22,0,40,18
1650398678609,COGS 13,A01,083071,Staff,0,33,40,40
1650398684634,COGS 14A,A01,092681,Staff,0,23,100,100
1650398690661,COGS 14B,A01,083073,Cheng; Tzu-Han,0,10,50,50
1650398696685,COGS 17,A01,092677,Staff,24,0,75,51
1650398702710,COGS 100,A01,083619,Staff,0,24,60,60
1650398708740,COGS 101A,A01,083621,Davis; Joshua Daniel,0,21,60,60
1650398714772,COGS 101B,A01,091572,Staff,0,2,60,60
1650398720798,COGS 101C,A01,083625,Delgado; Tania,16,0,30,14
1650398726823,COGS 107A,A01,083627,Boyle; Mary E. T.,0,10,60,60
1650398732849,COGS 118A,A01,083075,Staff,4,0,60,56
1650398738877,CSE 3,A50,083646,Miranda; Gregory Joseph,21,0,38,17
1650398738877,CSE 3,A51,083647,Miranda; Gregory Joseph,37,0,37,0
1650398744900,CSE 8A,A50,083650,Miranda; Gregory Joseph,0,28,40,40
1650398750925,CSE 11,A01,083080,Cao; Yingjun,0,89,40,40
1650398756951,CSE 12,A01,083652,Staff,0,15,100,100
1650398762975,CSE 15L,A01,083654,Staff,0,1,50,50
1650398762975,CSE 15L,A02,083655,Staff,1,0,50,49
1650398769010,CSE 20,A01,083657,Staff,51,0,80,29
1650398775044,CSE 30,A01,083084,Eldon; John,0,76,40,40
1650398781073,CSE 100,A01,083659,Cao; Yingjun,0,66,50,50
1650398787097,CSE 134B,A01,083661,Powell; Thomas Allan,0,31,65,65
1650398793133,CSE 140,A01,083663,Staff,0,0,75,75
1650398799164,CSE 140L,A01,083088,Eldon; John,0,7,75,75
1650398812470,CSE 175,A01,083665,Kumar; Rakesh,8,0,25,17
1650398818505,CSE 190,A00,092507,Dubnov; Shlomo,14,0,20,6
1650398824534,ECE 45,A01,083139,Staff,0,17,40,40
1650398830557,ECE 65,A50,083695,Staff,0,5,30,30
1650398836578,ECE 109,A01,091882,Touri; Behrouz,39,0,70,31
1650398842608,ECE 180,A00,083140,Abi Samra; Nicholas Camill,24,0,30,6
1650398842608,ECE 180,B00,083141,Abi Samra; Nicholas Camill,2,0,30,28
1650398848634,MATH 10A,A01,083735,Patchell; Gregory David,7,0,30,23
1650398848634,MATH 10A,A02,083736,Patchell; Gregory David,28,0,30,2
1650398848634,MATH 10A,A03,083737,Patchell; Gregory David,25,0,30,5
1650398854656,MATH 10B,A01,083207,Staff,0,7,30,30
1650398854656,MATH 10B,A02,083208,Staff,0,7,30,30
1650398854656,MATH 10B,B01,083739,Staff,16,0,30,14
1650398854656,MATH 10B,B02,083740,Staff,28,0,30,2
1650398860686,MATH 18,A01,083743,Staff,3,0,30,27
1650398860686,MATH 18,A02,083744,Staff,27,0,30,3
1650398860686,MATH 18,A03,083745,Staff,22,0,30,8
1650398860686,MATH 18,A04,083746,Staff,27,0,30,3
1650398860686,MATH 18,B01,083748,Staff,0,11,30,30
1650398860686,MATH 18,B02,083749,Staff,0,12,30,30
1650398860686,MATH 18,B03,083750,Staff,0,11,30,30
1650398860686,MATH 18,B04,083751,Staff,0,9,30,30
1650398866719,MATH 20A,A01,083754,Staff,26,0,40,14
1650398872749,MATH 20B,A01,083756,Staff,0,9,30,30
1650398872749,MATH 20B,A02,083757,Staff,0,8,30,30
1650398878773,MATH 20C,A01,083760,Staff,0,14,30,30
1650398878773,MATH 20C,A02,083761,Staff,1,15,30,29
1650398878773,MATH 20C,B01,083762,Staff,13,0,30,17
1650398878773,MATH 20C,B02,083763,Staff,28,0,30,2
1650398884800,MATH 20D,A01,083765,Staff,0,1,30,30
1650398884800,MATH 20D,A02,083766,Staff,7,0,30,23
1650398884800,MATH 20D,A03,083767,Staff,26,0,30,4
1650398890829,MATH 20E,A01,083771,Staff,5,0,30,25
1650398890829,MATH 20E,A02,083772,Staff,19,0,30,11
1650398890829,MATH 20E,B01,083773,Staff,0,0,30,30
1650398890829,MATH 20E,B02,083774,Staff,12,0,30,18
1650398896852,MATH 103A,A01,083777,Staff,0,11,30,30
1650398896852,MATH 103A,A02,083778,Staff,0,12,30,30
1650398896852,MATH 103A,B01,083779,Staff,0,13,30,30
1650398896852,MATH 103A,B02,083780,Staff,0,11,30,30
1650398902875,MATH 105,A01,085443,Staff,0,22,30,30
1650398908905,MATH 109,A01,083213,Anzaldo; Leesa B,0,7,30,30
1650398908905,MATH 109,A02,083214,Anzaldo; Leesa B,0,7,30,30
1650398908905,MATH 109,B01,083215,Anzaldo; Leesa B,0,5,30,30
1650398908905,MATH 109,B02,083216,Anzaldo; Leesa B,0,5,30,30
1650398914935,MATH 142A,A01,083219,Chow; Bennett,0,14,30,30
1650398914935,MATH 142A,A02,083220,Chow; Bennett,0,13,30,30
1650398914935,MATH 142A,B01,083221,Chow; Bennett,0,12,30,30
1650398914935,MATH 142A,B02,083222,Chow; Bennett,0,12,30,30
1650398920966,MATH 193A,A01,083224,Staff,0,5,30,30
1650398920966,MATH 193A,A02,083225,Staff,0,5,30,30
1650398920966,MATH 193A,A03,083781,Staff,0,4,30,30
1650398920966,MATH 193A,A04,083782,Staff,0,4,30,30
1650398926991,MATH 197,001,091859,McAuley; Julian John,9998,0,9999,1
1650398933046,COGS 9,A01,083615,Staff,0,14,60,60
1650398939070,COGS 11,A01,083617,Boyle; Mary E. T.,22,0,40,18
1650398945097,COGS 13,A01,083071,Staff,0,33,40,40
1650398951123,COGS 14A,A01,092681,Staff,0,23,100,100
1650398957150,COGS 14B,A01,083073,Cheng; Tzu-Han,0,10,50,50
1650398963176,COGS 17,A01,092677,Staff,24,0,75,51
1650398969202,COGS 100,A01,083619,Staff,0,24,60,60
1650398975228,COGS 101A,A01,083621,Davis; Joshua Daniel,0,21,60,60
1650398981252,COGS 101B,A01,091572,Staff,0,2,60,60
1650398987283,COGS 101C,A01,083625,Delgado; Tania,16,0,30,14
1650398993310,COGS 107A,A01,083627,Boyle; Mary E. T.,0,10,60,60
1650398999333,COGS 118A,A01,083075,Staff,4,0,60,56
1650399005362,CSE 3,A50,083646,Miranda; Gregory Joseph,21,0,38,17
1650399005362,CSE 3,A51,083647,Miranda; Gregory Joseph,37,0,37,0
1650399011385,CSE 8A,A50,083650,Miranda; Gregory Joseph,0,28,40,40
1650399017413,CSE 11,A01,083080,Cao; Yingjun,0,89,40,40
1650399023438,CSE 12,A01,083652,Staff,0,15,100,100
1650399029464,CSE 15L,A01,083654,Staff,0,1,50,50
1650399029464,CSE 15L,A02,083655,Staff,1,0,50,49
1650399035497,CSE 20,A01,083657,Staff,51,0,80,29
1650399041537,CSE 30,A01,083084,Eldon; John,0,76,40,40
1650399047564,CSE 100,A01,083659,Cao; Yingjun,0,66,50,50
1650399053588,CSE 134B,A01,083661,Powell; Thomas Allan,0,31,65,65
1650399059612,CSE 140,A01,083663,Staff,0,0,75,75
1650399065640,CSE 140L,A01,083088,Eldon; John,0,7,75,75
1650399071677,CSE 175,A01,083665,Kumar; Rakesh,8,0,25,17
1650399077700,CSE 190,A00,092507,Dubnov; Shlomo,14,0,20,6
1650399083817,ECE 45,A01,083139,Staff,0,17,40,40
1650399089847,ECE 65,A50,083695,Staff,0,5,30,30
1650399095877,ECE 109,A01,091882,Touri; Behrouz,39,0,70,31
1650399101993,ECE 180,A00,083140,Abi Samra; Nicholas Camill,24,0,30,6
1650399101993,ECE 180,B00,083141,Abi Samra; Nicholas Camill,2,0,30,28
1650399108015,MATH 10A,A01,083735,Patchell; Gregory David,7,0,30,23
1650399108015,MATH 10A,A02,083736,Patchell; Gregory David,28,0,30,2
1650399108015,MATH 10A,A03,083737,Patchell; Gregory David,25,0,30,5
1650399114040,MATH 10B,A01,083207,Staff,0,7,30,30
1650399114040,MATH 10B,A02,083208,Staff,0,7,30,30
1650399114040,MATH 10B,B01,083739,Staff,16,0,30,14
1650399114040,MATH 10B,B02,083740,Staff,28,0,30,2
1650399120066,MATH 18,A01,083743,Staff,3,0,30,27
1650399120066,MATH 18,A02,083744,Staff,27,0,30,3
1650399120066,MATH 18,A03,083745,Staff,22,0,30,8
1650399120066,MATH 18,A04,083746,Staff,27,0,30,3
1650399120066,MATH 18,B01,083748,Staff,0,11,30,30
1650399120066,MATH 18,B02,083749,Staff,0,12,30,30
1650399120066,MATH 18,B03,083750,Staff,0,11,30,30
1650399120066,MATH 18,B04,083751,Staff,0,9,30,30
1650399126091,MATH 20A,A01,083754,Staff,26,0,40,14
1650399132118,MATH 20B,A01,083756,Staff,0,9,30,30
1650399132118,MATH 20B,A02,083757,Staff,0,8,30,30
1650399138141,MATH 20C,A01,083760,Staff,0,14,30,30
1650399138141,MATH 20C,A02,083761,Staff,1,15,30,29
1650399138141,MATH 20C,B01,083762,Staff,13,0,30,17
1650399138141,MATH 20C,B02,083763,Staff,28,0,30,2
1650399144175,MATH 20D,A01,083765,Staff,0,1,30,30
1650399144175,MATH 20D,A02,083766,Staff,7,0,30,23
1650399144175,MATH 20D,A03,083767,Staff,26,0,30,4
1650399150203,MATH 20E,A01,083771,Staff,5,0,30,25
1650399150203,MATH 20E,A02,083772,Staff,19,0,30,11
1650399150203,MATH 20E,B01,083773,Staff,0,0,30,30
1650399150203,MATH 20E,B02,083774,Staff,12,0,30,18
1650399156228,MATH 103A,A01,083777,Staff,0,11,30,30
1650399156228,MATH 103A,A02,083778,Staff,0,12,30,30
1650399156228,MATH 103A,B01,083779,Staff,0,13,30,30
1650399156228,MATH 103A,B02,083780,Staff,0,11,30,30
1650399162255,MATH 105,A01,085443,Staff,0,22,30,30
1650399168289,MATH 109,A01,083213,Anzaldo; Leesa B,0,7,30,30
1650399168289,MATH 109,A02,083214,Anzaldo; Leesa B,0,7,30,30
1650399168289,MATH 109,B01,083215,Anzaldo; Leesa B,0,5,30,30
1650399168289,MATH 109,B02,083216,Anzaldo; Leesa B,0,5,30,30
1650399174317,MATH 142A,A01,083219,Chow; Bennett,0,14,30,30
1650399174317,MATH 142A,A02,083220,Chow; Bennett,0,13,30,30
1650399174317,MATH 142A,B01,083221,Chow; Bennett,0,12,30,30
1650399174317,MATH 142A,B02,083222,Chow; Bennett,0,12,30,30
1650399180346,MATH 193A,A01,083224,Staff,0,5,30,30
1650399180346,MATH 193A,A02,083225,Staff,0,5,30,30
1650399180346,MATH 193A,A03,083781,Staff,0,4,30,30
1650399180346,MATH 193A,A04,083782,Staff,0,4,30,30
1650399186370,MATH 197,001,091859,McAuley; Julian John,9998,0,9999,1
1650399192448,COGS 9,A01,083615,Staff,0,14,60,60
1650399198470,COGS 11,A01,083617,Boyle; Mary E. T.,22,0,40,18
1650399204507,COGS 13,A01,083071,Staff,0,33,40,40
1650399210529,COGS 14A,A01,092681,Staff,0,23,100,100
1650399216558,COGS 14B,A01,083073,Cheng; Tzu-Han,0,10,50,50
1650399222582,COGS 17,A01,092677,Staff,24,0,75,51
1650399228610,COGS 100,A01,083619,Staff,0,24,60,60
1650399234632,COGS 101A,A01,083621,Davis; Joshua Daniel,0,21,60,60
1650399240658,COGS 101B,A01,091572,Staff,0,2,60,60
1650399246688,COGS 101C,A01,083625,Delgado; Tania,16,0,30,14
1650399252716,COGS 107A,A01,083627,Boyle; Mary E. T.,0,10,60,60
1650399258742,COGS 118A,A01,083075,Staff,4,0,60,56
1650399264768,CSE 3,A50,083646,Miranda; Gregory Joseph,21,0,38,17
1650399264768,CSE 3,A51,083647,Miranda; Gregory Joseph,37,0,37,0
1650399270807,CSE 8A,A50,083650,Miranda; Gregory Joseph,0,28,40,40
1650399276833,CSE 11,A01,083080,Cao; Yingjun,0,89,40,40
1650399282867,CSE 12,A01,083652,Staff,0,15,100,100
1650399288891,CSE 15L,A01,083654,Staff,0,1,50,50
1650399288891,CSE 15L,A02,083655,Staff,1,0,50,49
1650399294915,CSE 20,A01,083657,Staff,51,0,80,29
1650399300945,CSE 30,A01,083084,Eldon; John,0,76,40,40
1650399306972,CSE 100,A01,083659,Cao; Yingjun,0,66,50,50
1650399313014,CSE 134B,A01,083661,Powell; Thomas Allan,0,31,65,65
1650399319049,CSE 140,A01,083663,Staff,0,0,75,75
1650399325084,CSE 140L,A01,083088,Eldon; John,0,7,75,75
1650399331110,CSE 175,A01,083665,Kumar; Rakesh,8,0,25,17
1650399337135,CSE 190,A00,092507,Dubnov; Shlomo,14,0,20,6
1650399343159,ECE 45,A01,083139,Staff,0,17,40,40
1650399349182,ECE 65,A50,083695,Staff,0,5,30,30
1650399355205,ECE 109,A01,091882,Touri; Behrouz,39,0,70,31
1650399361243,ECE 180,A00,083140,Abi Samra; Nicholas Camill,24,0,30,6
1650399361243,ECE 180,B00,083141,Abi Samra; Nicholas Camill,2,0,30,28
1650399367267,MATH 10A,A01,083735,Patchell; Gregory David,7,0,30,23
1650399367267,MATH 10A,A02,083736,Patchell; Gregory David,28,0,30,2
1650399367267,MATH 10A,A03,083737,Patchell; Gregory David,25,0,30,5
1650399373294,MATH 10B,A01,083207,Staff,0,7,30,30
1650399373294,MATH 10B,A02,083208,Staff,0,7,30,30
1650399373294,MATH 10B,B01,083739,Staff,16,0,30,14
1650399373294,MATH 10B,B02,083740,Staff,28,0,30,2
1650399379321,MATH 18,A01,083743,Staff,3,0,30,27
1650399379321,MATH 18,A02,083744,Staff,27,0,30,3
1650399379321,MATH 18,A03,083745,Staff,22,0,30,8
1650399379321,MATH 18,A04,083746,Staff,27,0,30,3
1650399379321,MATH 18,B01,083748,Staff,0,11,30,30
1650399379321,MATH 18,B02,083749,Staff,0,12,30,30
1650399379321,MATH 18,B03,083750,Staff,0,11,30,30
1650399379321,MATH 18,B04,083751,Staff,0,9,30,30
1650399385352,MATH 20A,A01,083754,Staff,26,0,40,14
1650399391379,MATH 20B,A01,083756,Staff,0,9,30,30
1650399391379,MATH 20B,A02,083757,Staff,0,8,30,30
1650399397414,MATH 20C,A01,083760,Staff,0,14,30,30
1650399397414,MATH 20C,A02,083761,Staff,1,15,30,29
1650399397414,MATH 20C,B01,083762,Staff,13,0,30,17
1650399397414,MATH 20C,B02,083763,Staff,28,0,30,2
1650399403436,MATH 20D,A01,083765,Staff,0,1,30,30
1650399403436,MATH 20D,A02,083766,Staff,7,0,30,23
1650399403436,MATH 20D,A03,083767,Staff,26,0,30,4
1650399409460,MATH 20E,A01,083771,Staff,5,0,30,25
1650399409460,MATH 20E,A02,083772,Staff,19,0,30,11
1650399409460,MATH 20E,B01,083773,Staff,0,0,30,30
1650399409460,MATH 20E,B02,083774,Staff,12,0,30,18
1650399415486,MATH 103A,A01,083777,Staff,0,11,30,30
1650399415486,MATH 103A,A02,083778,Staff,0,12,30,30
1650399415486,MATH 103A,B01,083779,Staff,0,13,30,30
1650399415486,MATH 103A,B02,083780,Staff,0,11,30,30
1650399421513,MATH 105,A01,085443,Staff,0,22,30,30
1650399427537,MATH 109,A01,083213,Anzaldo; Leesa B,0,7,30,30
1650399427537,MATH 109,A02,083214,Anzaldo; Leesa B,0,7,30,30
1650399427537,MATH 109,B01,083215,Anzaldo; Leesa B,0,5,30,30
1650399427537,MATH 109,B02,083216,Anzaldo; Leesa B,0,5,30,30
1650399433590,MATH 142A,A01,083219,Chow; Bennett,0,14,30,30
1650399433590,MATH 142A,A02,083220,Chow; Bennett,0,13,30,30
1650399433590,MATH 142A,B01,083221,Chow; Bennett,0,12,30,30
1650399433590,MATH 142A,B02,083222,Chow; Bennett,0,12,30,30
1650399439622,MATH 193A,A01,083224,Staff,0,5,30,30
1650399439622,MATH 193A,A02,083225,Staff,0,5,30,30
1650399439622,MATH 193A,A03,083781,Staff,0,4,30,30
1650399439622,MATH 193A,A04,083782,Staff,0,4,30,30
1650399445660,MATH 197,001,091859,McAuley; Julian John,9998,0,9999,1
1650399451717,COGS 9,A01,083615,Staff,0,14,60,60
1650399457755,COGS 11,A01,083617,Boyle; Mary E. T.,22,0,40,18
1650399463782,COGS 13,A01,083071,Staff,0,33,40,40
1650399469815,COGS 14A,A01,092681,Staff,0,23,100,100
1650399475853,COGS 14B,A01,083073,Cheng; Tzu-Han,0,10,50,50
1650399481879,COGS 17,A01,092677,Staff,24,0,75,51
1650399487905,COGS 100,A01,083619,Staff,0,24,60,60
1650399493933,COGS 101A,A01,083621,Davis; Joshua Daniel,0,21,60,60
1650399499957,COGS 101B,A01,091572,Staff,0,2,60,60
1650399505982,COGS 101C,A01,083625,Delgado; Tania,16,0,30,14
1650399512004,COGS 107A,A01,083627,Boyle; Mary E. T.,0,10,60,60
1650399518042,COGS 118A,A01,083075,Staff,4,0,60,56
1650399524067,CSE 3,A50,083646,Miranda; Gregory Joseph,21,0,38,17
1650399524067,CSE 3,A51,083647,Miranda; Gregory Joseph,37,0,37,0
1650399530104,CSE 8A,A50,083650,Miranda; Gregory Joseph,0,28,40,40
1650399536130,CSE 11,A01,083080,Cao; Yingjun,0,89,40,40
1650399542163,CSE 12,A01,083652,Staff,0,15,100,100
1650399548206,CSE 15L,A01,083654,Staff,0,1,50,50
1650399548206,CSE 15L,A02,083655,Staff,1,0,50,49
1650399554228,CSE 20,A01,083657,Staff,51,0,80,29
1650399560255,CSE 30,A01,083084,Eldon; John,0,76,40,40
1650399566284,CSE 100,A01,083659,Cao; Yingjun,0,66,50,50
1650399572307,CSE 134B,A01,083661,Powell; Thomas Allan,0,31,65,65
1650399578335,CSE 140,A01,083663,Staff,0,0,75,75
1650399584359,CSE 140L,A01,083088,Eldon; John,0,7,75,75
1650399590386,CSE 175,A01,083665,Kumar; Rakesh,7,0,25,18
1650399596409,CSE 190,A00,092507,Dubnov; Shlomo,14,0,20,6
1650399602442,ECE 45,A01,083139,Staff,0,17,40,40
1650399608472,ECE 65,A50,083695,Staff,0,5,30,30
1650399614509,ECE 109,A01,091882,Touri; Behrouz,39,0,70,31
1650399620536,ECE 180,A00,083140,Abi Samra; Nicholas Camill,24,0,30,6
1650399620536,ECE 180,B00,083141,Abi Samra; Nicholas Camill,1,0,30,29
1650399626565,MATH 10A,A01,083735,Patchell; Gregory David,7,0,30,23
1650399626565,MATH 10A,A02,083736,Patchell; Gregory David,28,0,30,2
1650399626565,MATH 10A,A03,083737,Patchell; Gregory David,25,0,30,5
1650399632589,MATH 10B,A01,083207,Staff,0,7,30,30
1650399632589,MATH 10B,A02,083208,Staff,0,7,30,30
1650399632589,MATH 10B,B01,083739,Staff,16,0,30,14
1650399632589,MATH 10B,B02,083740,Staff,28,0,30,2
1650399638614,MATH 18,A01,083743,Staff,3,0,30,27
1650399638614,MATH 18,A02,083744,Staff,27,0,30,3
1650399638614,MATH 18,A03,083745,Staff,22,0,30,8
1650399638614,MATH 18,A04,083746,Staff,27,0,30,3
1650399638614,MATH 18,B01,083748,Staff,0,11,30,30
1650399638614,MATH 18,B02,083749,Staff,0,12,30,30
1650399638614,MATH 18,B03,083750,Staff,0,11,30,30
1650399638614,MATH 18,B04,083751,Staff,0,9,30,30
1650399644641,MATH 20A,A01,083754,Staff,26,0,40,14
1650399650665,MATH 20B,A01,083756,Staff,0,9,30,30
1650399650665,MATH 20B,A02,083757,Staff,0,8,30,30
1650399656689,MATH 20C,A01,083760,Staff,0,14,30,30
1650399656689,MATH 20C,A02,083761,Staff,1,15,30,29
1650399656689,MATH 20C,B01,083762,Staff,13,0,30,17
1650399656689,MATH 20C,B02,083763,Staff,28,0,30,2
1650399662724,MATH 20D,A01,083765,Staff,0,1,30,30
1650399662724,MATH 20D,A02,083766,Staff,7,0,30,23
1650399662724,MATH 20D,A03,083767,Staff,26,0,30,4
1650399668752,MATH 20E,A01,083771,Staff,5,0,30,25
1650399668752,MATH 20E,A02,083772,Staff,19,0,30,11
1650399668752,MATH 20E,B01,083773,Staff,0,0,30,30
1650399668752,MATH 20E,B02,083774,Staff,12,0,30,18
1650399674779,MATH 103A,A01,083777,Staff,0,11,30,30
1650399674779,MATH 103A,A02,083778,Staff,0,12,30,30
1650399674779,MATH 103A,B01,083779,Staff,0,13,30,30
1650399674779,MATH 103A,B02,083780,Staff,0,11,30,30
1650399680901,MATH 105,A01,085443,Staff,0,22,30,30
1650399686937,MATH 109,A01,083213,Anzaldo; Leesa B,0,7,30,30
1650399686937,MATH 109,A02,083214,Anzaldo; Leesa B,0,7,30,30
1650399686937,MATH 109,B01,083215,Anzaldo; Leesa B,0,5,30,30
1650399686937,MATH 109,B02,083216,Anzaldo; Leesa B,0,5,30,30
1650399692975,MATH 142A,A01,083219,Chow; Bennett,0,14,30,30
1650399692975,MATH 142A,A02,083220,Chow; Bennett,0,13,30,30
1650399692975,MATH 142A,B01,083221,Chow; Bennett,0,12,30,30
1650399692975,MATH 142A,B02,083222,Chow; Bennett,0,12,30,30
1650399699001,MATH 193A,A01,083224,Staff,0,5,30,30
1650399699001,MATH 193A,A02,083225,Staff,0,5,30,30
1650399699001,MATH 193A,A03,083781,Staff,0,4,30,30
1650399699001,MATH 193A,A04,083782,Staff,0,4,30,30
1650399705025,MATH 197,001,091859,McAuley; Julian John,9998,0,9999,1
1650399711101,COGS 9,A01,083615,Staff,0,14,60,60
1650399717136,COGS 11,A01,083617,Boyle; Mary E. T.,22,0,40,18
1650399723159,COGS 13,A01,083071,Staff,0,33,40,40
1650399729182,COGS 14A,A01,092681,Staff,0,23,100,100
1650399735218,COGS 14B,A01,083073,Cheng; Tzu-Han,0,10,50,50
1650399741241,COGS 17,A01,092677,Staff,24,0,75,51
1650399747265,COGS 100,A01,083619,Staff,0,24,60,60
1650399753296,COGS 101A,A01,083621,Davis; Joshua Daniel,0,21,60,60
1650399759335,COGS 101B,A01,091572,Staff,0,2,60,60
1650399765361,COGS 101C,A01,083625,Delgado; Tania,16,0,30,14
1650399771387,COGS 107A,A01,083627,Boyle; Mary E. T.,0,10,60,60
1650399777421,COGS 118A,A01,083075,Staff,4,0,60,56
1650399783453,CSE 3,A50,083646,Miranda; Gregory Joseph,21,0,38,17
1650399783453,CSE 3,A51,083647,Miranda; Gregory Joseph,37,0,37,0
1650399789479,CSE 8A,A50,083650,Miranda; Gregory Joseph,0,28,40,40
1650399795503,CSE 11,A01,083080,Cao; Yingjun,0,90,40,40
1650399801530,CSE 12,A01,083652,Staff,0,15,100,100
1650399807563,CSE 15L,A01,083654,Staff,0,1,50,50
1650399807563,CSE 15L,A02,083655,Staff,1,0,50,49
1650399813586,CSE 20,A01,083657,Staff,51,0,80,29
1650399819611,CSE 30,A01,083084,Eldon; John,0,76,40,40
1650399825637,CSE 100,A01,083659,Cao; Yingjun,0,66,50,50
1650399831671,CSE 134B,A01,083661,Powell; Thomas Allan,0,31,65,65
1650399837698,CSE 140,A01,083663,Staff,0,0,75,75
1650399843730,CSE 140L,A01,083088,Eldon; John,0,7,75,75
1650399849755,CSE 175,A01,083665,Kumar; Rakesh,7,0,25,18
1650399855783,CSE 190,A00,092507,Dubnov; Shlomo,14,0,20,6
1650399861808,ECE 45,A01,083139,Staff,0,17,40,40
1650399867832,ECE 65,A50,083695,Staff,0,5,30,30
1650399873858,ECE 109,A01,091882,Touri; Behrouz,39,0,70,31
1650399879901,ECE 180,A00,083140,Abi Samra; Nicholas Camill,24,0,30,6
1650399879901,ECE 180,B00,083141,Abi Samra; Nicholas Camill,1,0,30,29
1650399885936,MATH 10A,A01,083735,Patchell; Gregory David,7,0,30,23
1650399885936,MATH 10A,A02,083736,Patchell; Gregory David,28,0,30,2
1650399885936,MATH 10A,A03,083737,Patchell; Gregory David,25,0,30,5
1650399891964,MATH 10B,A01,083207,Staff,0,7,30,30
1650399891964,MATH 10B,A02,083208,Staff,0,7,30,30
1650399891964,MATH 10B,B01,083739,Staff,16,0,30,14
1650399891964,MATH 10B,B02,083740,Staff,28,0,30,2
1650399897993,MATH 18,A01,083743,Staff,3,0,30,27
1650399897993,MATH 18,A02,083744,Staff,27,0,30,3
1650399897993,MATH 18,A03,083745,Staff,22,0,30,8
1650399897993,MATH 18,A04,083746,Staff,27,0,30,3
1650399897993,MATH 18,B01,083748,Staff,0,11,30,30
1650399897993,MATH 18,B02,083749,Staff,0,12,30,30
1650399897993,MATH 18,B03,083750,Staff,0,11,30,30
1650399897993,MATH 18,B04,083751,Staff,0,9,30,30
1650399904021,MATH 20A,A01,083754,Staff,26,0,40,14
1650399910055,MATH 20B,A01,083756,Staff,0,9,30,30
1650399910055,MATH 20B,A02,083757,Staff,0,8,30,30
1650399916100,MATH 20C,A01,083760,Staff,0,14,30,30
1650399916100,MATH 20C,A02,083761,Staff,1,15,30,29
1650399916100,MATH 20C,B01,083762,Staff,13,0,30,17
1650399916100,MATH 20C,B02,083763,Staff,28,0,30,2
1650399922124,MATH 20D,A01,083765,Staff,0,1,30,30
1650399922124,MATH 20D,A02,083766,Staff,7,0,30,23
1650399922124,MATH 20D,A03,083767,Staff,26,0,30,4
1650399928149,MATH 20E,A01,083771,Staff,5,0,30,25
1650399928149,MATH 20E,A02,083772,Staff,19,0,30,11
1650399928149,MATH 20E,B01,083773,Staff,0,0,30,30
1650399928149,MATH 20E,B02,083774,Staff,12,0,30,18
1650399934173,MATH 103A,A01,083777,Staff,0,11,30,30
1650399934173,MATH 103A,A02,083778,Staff,0,12,30,30
1650399934173,MATH 103A,B01,083779,Staff,0,13,30,30
1650399934173,MATH 103A,B02,083780,Staff,0,11,30,30
1650399940197,MATH 105,A01,085443,Staff,0,22,30,30
1650399946231,MATH 109,A01,083213,Anzaldo; Leesa B,0,7,30,30
1650399946231,MATH 109,A02,083214,Anzaldo; Leesa B,0,7,30,30
1650399946231,MATH 109,B01,083215,Anzaldo; Leesa B,0,5,30,30
1650399946231,MATH 109,B02,083216,Anzaldo; Leesa B,0,5,30,30
1650399952261,MATH 142A,A01,083219,Chow; Bennett,0,14,30,30
1650399952261,MATH 142A,A02,083220,Chow; Bennett,0,13,30,30
1650399952261,MATH 142A,B01,083221,Chow; Bennett,0,12,30,30
1650399952261,MATH 142A,B02,083222,Chow; Bennett,0,12,30,30
1650399958289,MATH 193A,A01,083224,Staff,0,5,30,30
1650399958289,MATH 193A,A02,083225,Staff,0,5,30,30
1650399958289,MATH 193A,A03,083781,Staff,0,4,30,30
1650399958289,MATH 193A,A04,083782,Staff,0,4,30,30
1650399964318,MATH 197,001,091859,McAuley; Julian John,9998,0,9999,1
1650399970373,COGS 9,A01,083615,Staff,0,14,60,60
1650399976397,COGS 11,A01,083617,Boyle; Mary E. T.,22,0,40,18
1650399982420,COGS 13,A01,083071,Staff,0,33,40,40
1650399988447,COGS 14A,A01,092681,Staff,0,23,100,100
1650399994488,COGS 14B,A01,083073,Cheng; Tzu-Han,0,10,50,50
1650400000525,COGS 17,A01,092677,Staff,24,0,75,51
1650400006553,COGS 100,A01,083619,Staff,0,24,60,60
1650400012578,COGS 101A,A01,083621,Davis; Joshua Daniel,0,21,60,60
1650400018607,COGS 101B,A01,091572,Staff,0,2,60,60
1650400024633,COGS 101C,A01,083625,Delgado; Tania,16,0,30,14
1650400030657,COGS 107A,A01,083627,Boyle; Mary E. T.,0,10,60,60
1650400036688,COGS 118A,A01,083075,Staff,4,0,60,56
1650400042719,CSE 3,A50,083646,Miranda; Gregory Joseph,21,0,38,17
1650400042719,CSE 3,A51,083647,Miranda; Gregory Joseph,37,0,37,0
1650400048749,CSE 8A,A50,083650,Miranda; Gregory Joseph,0,28,40,40
1650400054782,CSE 11,A01,083080,Cao; Yingjun,0,90,40,40
1650400060817,CSE 12,A01,083652,Staff,0,15,100,100
1650400066841,CSE 15L,A01,083654,Staff,0,1,50,50
1650400066841,CSE 15L,A02,083655,Staff,1,0,50,49
1650400072874,CSE 20,A01,083657,Staff,51,0,80,29
1650400078900,CSE 30,A01,083084,Eldon; John,0,76,40,40
1650400084927,CSE 100,A01,083659,Cao; Yingjun,0,66,50,50
1650400090956,CSE 134B,A01,083661,Powell; Thomas Allan,0,31,65,65
1650400096986,CSE 140,A01,083663,Staff,0,0,75,75
1650400103011,CSE 140L,A01,083088,Eldon; John,0,7,75,75
1650400109036,CSE 175,A01,083665,Kumar; Rakesh,7,0,25,18
1650400115059,CSE 190,A00,092507,Dubnov; Shlomo,14,0,20,6
1650400121089,ECE 45,A01,083139,Staff,0,17,40,40
1650400127119,ECE 65,A50,083695,Staff,0,5,30,30
1650400133146,ECE 109,A01,091882,Touri; Behrouz,39,0,70,31
1650400139172,ECE 180,A00,083140,Abi Samra; Nicholas Camill,24,0,30,6
1650400139172,ECE 180,B00,083141,Abi Samra; Nicholas Camill,1,0,30,29
1650400145195,MATH 10A,A01,083735,Patchell; Gregory David,7,0,30,23
1650400145195,MATH 10A,A02,083736,Patchell; Gregory David,28,0,30,2
1650400145195,MATH 10A,A03,083737,Patchell; Gregory David,25,0,30,5
1650400151241,MATH 10B,A01,083207,Staff,0,7,30,30
1650400151241,MATH 10B,A02,083208,Staff,0,7,30,30
1650400151241,MATH 10B,B01,083739,Staff,16,0,30,14
1650400151241,MATH 10B,B02,083740,Staff,28,0,30,2
1650400157279,MATH 18,A01,083743,Staff,2,0,30,28
1650400157279,MATH 18,A02,083744,Staff,27,0,30,3
1650400157279,MATH 18,A03,083745,Staff,22,0,30,8
1650400157279,MATH 18,A04,083746,Staff,27,0,30,3
1650400157279,MATH 18,B01,083748,Staff,0,11,30,30
1650400157279,MATH 18,B02,083749,Staff,0,12,30,30
1650400157279,MATH 18,B03,083750,Staff,0,11,30,30
1650400157279,MATH 18,B04,083751,Staff,0,9,30,30
1650400163309,MATH 20A,A01,083754,Staff,26,0,40,14
1650400169335,MATH 20B,A01,083756,Staff,0,9,30,30
1650400169335,MATH 20B,A02,083757,Staff,0,8,30,30
1650400175370,MATH 20C,A01,083760,Staff,0,14,30,30
1650400175370,MATH 20C,A02,083761,Staff,1,15,30,29
1650400175370,MATH 20C,B01,083762,Staff,13,0,30,17
1650400175370,MATH 20C,B02,083763,Staff,28,0,30,2
1650400181413,MATH 20D,A01,083765,Staff,0,1,30,30
1650400181413,MATH 20D,A02,083766,Staff,7,0,30,23
1650400181413,MATH 20D,A03,083767,Staff,26,0,30,4
1650400187437,MATH 20E,A01,083771,Staff,5,0,30,25
1650400187437,MATH 20E,A02,083772,Staff,19,0,30,11
1650400187437,MATH 20E,B01,083773,Staff,0,0,30,30
1650400187437,MATH 20E,B02,083774,Staff,12,0,30,18
1650400193461,MATH 103A,A01,083777,Staff,0,11,30,30
1650400193461,MATH 103A,A02,083778,Staff,0,12,30,30
1650400193461,MATH 103A,B01,083779,Staff,0,13,30,30
1650400193461,MATH 103A,B02,083780,Staff,0,11,30,30
1650400199486,MATH 105,A01,085443,Staff,0,22,30,30
1650400205515,MATH 109,A01,083213,Anzaldo; Leesa B,0,7,30,30
1650400205515,MATH 109,A02,083214,Anzaldo; Leesa B,0,7,30,30
1650400205515,MATH 109,B01,083215,Anzaldo; Leesa B,0,5,30,30
1650400205515,MATH 109,B02,083216,Anzaldo; Leesa B,0,5,30,30
1650400211539,MATH 142A,A01,083219,Chow; Bennett,0,14,30,30
1650400211539,MATH 142A,A02,083220,Chow; Bennett,0,13,30,30
1650400211539,MATH 142A,B01,083221,Chow; Bennett,0,12,30,30
1650400211539,MATH 142A,B02,083222,Chow; Bennett,0,12,30,30
1650400217568,MATH 193A,A01,083224,Staff,0,5,30,30
1650400217568,MATH 193A,A02,083225,Staff,0,5,30,30
1650400217568,MATH 193A,A03,083781,Staff,0,4,30,30
1650400217568,MATH 193A,A04,083782,Staff,0,4,30,30
1650400223605,MATH 197,001,091859,McAuley; Julian John,9998,0,9999,1
1650400229663,COGS 9,A01,083615,Staff,0,14,60,60
1650400235691,COGS 11,A01,083617,Boyle; Mary E. T.,22,0,40,18
1650400241714,COGS 13,A01,083071,Staff,0,33,40,40
1650400247744,COGS 14A,A01,092681,Staff,0,23,100,100
1650400253771,COGS 14B,A01,083073,Cheng; Tzu-Han,0,10,50,50
1650400259796,COGS 17,A01,092677,Staff,24,0,75,51
1650400265820,COGS 100,A01,083619,Staff,0,24,60,60
1650400271962,COGS 101A,A01,083621,Davis; Joshua Daniel,0,21,60,60
1650400277994,COGS 101B,A01,091572,Staff,0,2,60,60
1650400284026,COGS 101C,A01,083625,Delgado; Tania,16,0,30,14
1650400290056,COGS 107A,A01,083627,Boyle; Mary E. T.,0,10,60,60
1650400296084,COGS 118A,A01,083075,Staff,4,0,60,56
1650400302109,CSE 3,A50,083646,Miranda; Gregory Joseph,21,0,38,17
1650400302109,CSE 3,A51,083647,Miranda; Gregory Joseph,37,0,37,0
1650400308139,CSE 8A,A50,083650,Miranda; Gregory Joseph,0,28,40,40
1650400314164,CSE 11,A01,083080,Cao; Yingjun,0,90,40,40
1650400320194,CSE 12,A01,083652,Staff,0,15,100,100
1650400326218,CSE 15L,A01,083654,Staff,0,1,50,50
1650400326218,CSE 15L,A02,083655,Staff,1,0,50,49
1650400332250,CSE 20,A01,083657,Staff,51,0,80,29
1650400338285,CSE 30,A01,083084,Eldon; John,0,76,40,40
1650400344310,CSE 100,A01,083659,Cao; Yingjun,0,66,50,50
1650400350332,CSE 134B,A01,083661,Powell; Thomas Allan,0,31,65,65
1650400356368,CSE 140,A01,083663,Staff,0,0,75,75
1650400362391,CSE 140L,A01,083088,Eldon; John,0,7,75,75
1650400368420,CSE 175,A01,083665,Kumar; Rakesh,7,0,25,18
1650400374447,CSE 190,A00,092507,Dubnov; Shlomo,14,0,20,6
1650400380471,ECE 45,A01,083139,Staff,0,17,40,40
1650400386501,ECE 65,A50,083695,Staff,0,5,30,30
1650400392522,ECE 109,A01,091882,Touri; Behrouz,39,0,70,31
1650400398547,ECE 180,A00,083140,Abi Samra; Nicholas Camill,24,0,30,6
1650400398547,ECE 180,B00,083141,Abi Samra; Nicholas Camill,1,0,30,29
1650400404574,MATH 10A,A01,083735,Patchell; Gregory David,7,0,30,23
1650400404574,MATH 10A,A02,083736,Patchell; Gregory David,28,0,30,2
1650400404574,MATH 10A,A03,083737,Patchell; Gregory David,25,0,30,5
1650400410596,MATH 10B,A01,083207,Staff,0,7,30,30
1650400410596,MATH 10B,A02,083208,Staff,0,7,30,30
1650400410596,MATH 10B,B01,083739,Staff,16,0,30,14
1650400410596,MATH 10B,B02,083740,Staff,28,0,30,2
1650400416625,MATH 18,A01,083743,Staff,2,0,30,28
1650400416625,MATH 18,A02,083744,Staff,27,0,30,3
1650400416625,MATH 18,A03,083745,Staff,22,0,30,8
1650400416625,MATH 18,A04,083746,Staff,27,0,30,3
1650400416625,MATH 18,B01,083748,Staff,0,11,30,30
1650400416625,MATH 18,B02,083749,Staff,0,12,30,30
1650400416625,MATH 18,B03,083750,Staff,0,11,30,30
1650400416625,MATH 18,B04,083751,Staff,0,9,30,30
1650400422651,MATH 20A,A01,083754,Staff,26,0,40,14
1650400428678,MATH 20B,A01,083756,Staff,0,9,30,30
1650400428678,MATH 20B,A02,083757,Staff,0,8,30,30
1650400434706,MATH 20C,A01,083760,Staff,0,14,30,30
1650400434706,MATH 20C,A02,083761,Staff,1,15,30,29
1650400434706,MATH 20C,B01,083762,Staff,13,0,30,17
1650400434706,MATH 20C,B02,083763,Staff,28,0,30,2
1650400440732,MATH 20D,A01,083765,Staff,0,1,30,30
1650400440732,MATH 20D,A02,083766,Staff,7,0,30,23
1650400440732,MATH 20D,A03,083767,Staff,26,0,30,4
1650400446758,MATH 20E,A01,083771,Staff,5,0,30,25
1650400446758,MATH 20E,A02,083772,Staff,19,0,30,11
1650400446758,MATH 20E,B01,083773,Staff,0,0,30,30
1650400446758,MATH 20E,B02,083774,Staff,12,0,30,18
1650400452787,MATH 103A,A01,083777,Staff,0,11,30,30
1650400452787,MATH 103A,A02,083778,Staff,0,12,30,30
1650400452787,MATH 103A,B01,083779,Staff,0,13,30,30
1650400452787,MATH 103A,B02,083780,Staff,0,11,30,30
1650400458813,MATH 105,A01,085443,Staff,0,22,30,30
1650400464836,MATH 109,A01,083213,Anzaldo; Leesa B,0,7,30,30
1650400464836,MATH 109,A02,083214,Anzaldo; Leesa B,0,7,30,30
1650400464836,MATH 109,B01,083215,Anzaldo; Leesa B,0,5,30,30
1650400464836,MATH 109,B02,083216,Anzaldo; Leesa B,0,5,30,30
1650400470863,MATH 142A,A01,083219,Chow; Bennett,0,14,30,30
1650400470863,MATH 142A,A02,083220,Chow; Bennett,0,13,30,30
1650400470863,MATH 142A,B01,083221,Chow; Bennett,0,12,30,30
1650400470863,MATH 142A,B02,083222,Chow; Bennett,0,12,30,30
1650400476894,MATH 193A,A01,083224,Staff,0,5,30,30
1650400476894,MATH 193A,A02,083225,Staff,0,5,30,30
1650400476894,MATH 193A,A03,083781,Staff,0,4,30,30
1650400476894,MATH 193A,A04,083782,Staff,0,4,30,30
1650400482927,MATH 197,001,091859,McAuley; Julian John,9998,0,9999,1
1650400488986,COGS 9,A01,083615,Staff,0,14,60,60
1650400495010,COGS 11,A01,083617,Boyle; Mary E. T.,22,0,40,18
1650400501042,COGS 13,A01,083071,Staff,0,33,40,40
1650400507098,COGS 14A,A01,092681,Staff,0,23,100,100
1650400513125,COGS 14B,A01,083073,Cheng; Tzu-Han,0,10,50,50
1650400519149,COGS 17,A01,092677,Staff,24,0,75,51
1650400525181,COGS 100,A01,083619,Staff,0,24,60,60
1650400531207,COGS 101A,A01,083621,Davis; Joshua Daniel,0,21,60,60
1650400537234,COGS 101B,A01,091572,Staff,0,2,60,60
1650400543257,COGS 101C,A01,083625,Delgado; Tania,16,0,30,14
1650400549292,COGS 107A,A01,083627,Boyle; Mary E. T.,0,10,60,60
1650400555318,COGS 118A,A01,083075,Staff,4,0,60,56
1650400561342,CSE 3,A50,083646,Miranda; Gregory Joseph,21,0,38,17
1650400561342,CSE 3,A51,083647,Miranda; Gregory Joseph,37,0,37,0
1650400567365,CSE 8A,A50,083650,Miranda; Gregory Joseph,0,28,40,40
1650400573392,CSE 11,A01,083080,Cao; Yingjun,0,90,40,40
1650400579415,CSE 12,A01,083652,Staff,0,15,100,100
1650400585458,CSE 15L,A01,083654,Staff,0,1,50,50
1650400585458,CSE 15L,A02,083655,Staff,2,0,50,48
1650400591504,CSE 20,A01,083657,Staff,51,0,80,29
1650400597526,CSE 30,A01,083084,Eldon; John,0,76,40,40
1650400603552,CSE 100,A01,083659,Cao; Yingjun,0,66,50,50
1650400609576,CSE 134B,A01,083661,Powell; Thomas Allan,0,31,65,65
1650400615600,CSE 140,A01,083663,Staff,0,0,75,75
1650400621627,CSE 140L,A01,083088,Eldon; John,0,7,75,75
1650400627655,CSE 175,A01,083665,Kumar; Rakesh,7,0,25,18
1650400633678,CSE 190,A00,092507,Dubnov; Shlomo,14,0,20,6
1650400639702,ECE 45,A01,083139,Staff,0,17,40,40
1650400645735,ECE 65,A50,083695,Staff,0,5,30,30
1650400651764,ECE 109,A01,091882,Touri; Behrouz,39,0,70,31
1650400657788,ECE 180,A00,083140,Abi Samra; Nicholas Camill,24,0,30,6
1650400657788,ECE 180,B00,083141,Abi Samra; Nicholas Camill,1,0,30,29
1650400663824,MATH 10A,A01,083735,Patchell; Gregory David,7,0,30,23
1650400663824,MATH 10A,A02,083736,Patchell; Gregory David,28,0,30,2
1650400663824,MATH 10A,A03,083737,Patchell; Gregory David,25,0,30,5
1650400669854,MATH 10B,A01,083207,Staff,0,7,30,30
1650400669854,MATH 10B,A02,083208,Staff,0,7,30,30
1650400669854,MATH 10B,B01,083739,Staff,16,0,30,14
1650400669854,MATH 10B,B02,083740,Staff,28,0,30,2
1650400675884,MATH 18,A01,083743,Staff,2,0,30,28
1650400675884,MATH 18,A02,083744,Staff,27,0,30,3
1650400675884,MATH 18,A03,083745,Staff,22,0,30,8
1650400675884,MATH 18,A04,083746,Staff,27,0,30,3
1650400675884,MATH 18,B01,083748,Staff,0,11,30,30
1650400675884,MATH 18,B02,083749,Staff,0,12,30,30
1650400675884,MATH 18,B03,083750,Staff,0,11,30,30
1650400675884,MATH 18,B04,083751,Staff,0,9,30,30
1650400681909,MATH 20A,A01,083754,Staff,26,0,40,14
1650400687942,MATH 20B,A01,083756,Staff,0,9,30,30
1650400687942,MATH 20B,A02,083757,Staff,0,8,30,30
1650400693973,MATH 20C,A01,083760,Staff,0,14,30,30
1650400693973,MATH 20C,A02,083761,Staff,1,15,30,29
1650400693973,MATH 20C,B01,083762,Staff,13,0,30,17
1650400693973,MATH 20C,B02,083763,Staff,28,0,30,2
1650400700006,MATH 20D,A01,083765,Staff,0,1,30,30
1650400700006,MATH 20D,A02,083766,Staff,7,0,30,23
1650400700006,MATH 20D,A03,083767,Staff,26,0,30,4
1650400706042,MATH 20E,A01,083771,Staff,5,0,30,25
1650400706042,MATH 20E,A02,083772,Staff,19,0,30,11
1650400706042,MATH 20E,B01,083773,Staff,0,0,30,30
1650400706042,MATH 20E,B02,083774,Staff,12,0,30,18
1650400712066,MATH 103A,A01,083777,Staff,0,11,30,30
1650400712066,MATH 103A,A02,083778,Staff,0,12,30,30
1650400712066,MATH 103A,B01,083779,Staff,0,13,30,30
1650400712066,MATH 103A,B02,083780,Staff,0,11,30,30
1650400718089,MATH 105,A01,085443,Staff,0,22,30,30
1650400724117,MATH 109,A01,083213,Anzaldo; Leesa B,0,7,30,30
1650400724117,MATH 109,A02,083214,Anzaldo; Leesa B,0,7,30,30
1650400724117,MATH 109,B01,083215,Anzaldo; Leesa B,0,5,30,30
1650400724117,MATH 109,B02,083216,Anzaldo; Leesa B,0,5,30,30
1650400730145,MATH 142A,A01,083219,Chow; Bennett,0,14,30,30
1650400730145,MATH 142A,A02,083220,Chow; Bennett,0,13,30,30
1650400730145,MATH 142A,B01,083221,Chow; Bennett,0,12,30,30
1650400730145,MATH 142A,B02,083222,Chow; Bennett,0,12,30,30
1650400736169,MATH 193A,A01,083224,Staff,0,5,30,30
1650400736169,MATH 193A,A02,083225,Staff,0,5,30,30
1650400736169,MATH 193A,A03,083781,Staff,0,4,30,30
1650400736169,MATH 193A,A04,083782,Staff,0,4,30,30
1650400742194,MATH 197,001,091859,McAuley; Julian John,9998,0,9999,1
1650400748257,COGS 9,A01,083615,Staff,0,14,60,60
1650400754279,COGS 11,A01,083617,Boyle; Mary E. T.,22,0,40,18
1650400760301,COGS 13,A01,083071,Staff,0,33,40,40
1650400766324,COGS 14A,A01,092681,Staff,0,23,100,100
1650400772347,COGS 14B,A01,083073,Cheng; Tzu-Han,0,10,50,50
1650400778379,COGS 17,A01,092677,Staff,24,0,75,51
1650400784401,COGS 100,A01,083619,Staff,0,24,60,60
1650400790424,COGS 101A,A01,083621,Davis; Joshua Daniel,0,21,60,60
1650400796447,COGS 101B,A01,091572,Staff,0,2,60,60
1650400802477,COGS 101C,A01,083625,Delgado; Tania,16,0,30,14
1650400808500,COGS 107A,A01,083627,Boyle; Mary E. T.,0,10,60,60
1650400814526,COGS 118A,A01,083075,Staff,4,0,60,56
1650400820559,CSE 3,A50,083646,Miranda; Gregory Joseph,21,0,38,17
1650400820559,CSE 3,A51,083647,Miranda; Gregory Joseph,37,0,37,0
1650400826582,CSE 8A,A50,083650,Miranda; Gregory Joseph,0,28,40,40
1650400832605,CSE 11,A01,083080,Cao; Yingjun,0,90,40,40
1650400838642,CSE 12,A01,083652,Staff,0,15,100,100
1650400844665,CSE 15L,A01,083654,Staff,0,1,50,50
1650400844665,CSE 15L,A02,083655,Staff,2,0,50,48
1650400850698,CSE 20,A01,083657,Staff,51,0,80,29
1650400856724,CSE 30,A01,083084,Eldon; John,0,76,40,40
1650400862749,CSE 100,A01,083659,Cao; Yingjun,0,66,50,50
1650400868853,CSE 134B,A01,083661,Powell; Thomas Allan,0,31,65,65
1650400874875,CSE 140,A01,083663,Staff,0,0,75,75
1650400880912,CSE 140L,A01,083088,Eldon; John,0,7,75,75
1650400886948,CSE 175,A01,083665,Kumar; Rakesh,7,0,25,18
1650400892980,CSE 190,A00,092507,Dubnov; Shlomo,14,0,20,6
1650400899006,ECE 45,A01,083139,Staff,0,17,40,40
1650400905028,ECE 65,A50,083695,Staff,0,5,30,30
1650400911054,ECE 109,A01,091882,Touri; Behrouz,39,0,70,31
1650400917080,ECE 180,A00,083140,Abi Samra; Nicholas Camill,24,0,30,6
1650400917080,ECE 180,B00,083141,Abi Samra; Nicholas Camill,1,0,30,29
1650400923108,MATH 10A,A01,083735,Patchell; Gregory David,7,0,30,23
1650400923108,MATH 10A,A02,083736,Patchell; Gregory David,28,0,30,2
1650400923108,MATH 10A,A03,083737,Patchell; Gregory David,25,0,30,5
1650400929135,MATH 10B,A01,083207,Staff,0,7,30,30
1650400929135,MATH 10B,A02,083208,Staff,0,7,30,30
1650400929135,MATH 10B,B01,083739,Staff,16,0,30,14
1650400929135,MATH 10B,B02,083740,Staff,28,0,30,2
1650400935173,MATH 18,A01,083743,Staff,2,0,30,28
1650400935173,MATH 18,A02,083744,Staff,27,0,30,3
1650400935173,MATH 18,A03,083745,Staff,22,0,30,8
1650400935173,MATH 18,A04,083746,Staff,27,0,30,3
1650400935173,MATH 18,B01,083748,Staff,0,11,30,30
1650400935173,MATH 18,B02,083749,Staff,0,12,30,30
1650400935173,MATH 18,B03,083750,Staff,0,11,30,30
1650400935173,MATH 18,B04,083751,Staff,0,9,30,30
1650400941202,MATH 20A,A01,083754,Staff,26,0,40,14
1650400947225,MATH 20B,A01,083756,Staff,0,9,30,30
1650400947225,MATH 20B,A02,083757,Staff,0,8,30,30
1650400953248,MATH 20C,A01,083760,Staff,0,14,30,30
1650400953248,MATH 20C,A02,083761,Staff,1,15,30,29
1650400953248,MATH 20C,B01,083762,Staff,13,0,30,17
1650400953248,MATH 20C,B02,083763,Staff,28,0,30,2
1650400959272,MATH 20D,A01,083765,Staff,0,1,30,30
1650400959272,MATH 20D,A02,083766,Staff,7,0,30,23
1650400959272,MATH 20D,A03,083767,Staff,26,0,30,4
1650400965301,MATH 20E,A01,083771,Staff,5,0,30,25
1650400965301,MATH 20E,A02,083772,Staff,19,0,30,11
1650400965301,MATH 20E,B01,083773,Staff,0,0,30,30
1650400965301,MATH 20E,B02,083774,Staff,12,0,30,18
1650400971329,MATH 103A,A01,083777,Staff,0,11,30,30
1650400971329,MATH 103A,A02,083778,Staff,0,12,30,30
1650400971329,MATH 103A,B01,083779,Staff,0,13,30,30
1650400971329,MATH 103A,B02,083780,Staff,0,11,30,30
1650400977351,MATH 105,A01,085443,Staff,0,22,30,30
1650400983382,MATH 109,A01,083213,Anzaldo; Leesa B,0,7,30,30
1650400983382,MATH 109,A02,083214,Anzaldo; Leesa B,0,7,30,30
1650400983382,MATH 109,B01,083215,Anzaldo; Leesa B,0,5,30,30
1650400983382,MATH 109,B02,083216,Anzaldo; Leesa B,0,5,30,30
1650400989419,MATH 142A,A01,083219,Chow; Bennett,0,14,30,30
1650400989419,MATH 142A,A02,083220,Chow; Bennett,0,13,30,30
1650400989419,MATH 142A,B01,083221,Chow; Bennett,0,12,30,30
1650400989419,MATH 142A,B02,083222,Chow; Bennett,0,12,30,30
1650400995447,MATH 193A,A01,083224,Staff,0,5,30,30
1650400995447,MATH 193A,A02,083225,Staff,0,5,30,30
1650400995447,MATH 193A,A03,083781,Staff,0,4,30,30
1650400995447,MATH 193A,A04,083782,Staff,0,4,30,30
1650401001471,MATH 197,001,091859,McAuley; Julian John,9998,0,9999,1
1650401007533,COGS 9,A01,083615,Staff,0,14,60,60
1650401013560,COGS 11,A01,083617,Boyle; Mary E. T.,22,0,40,18
1650401019593,COGS 13,A01,083071,Staff,0,33,40,40
1650401025621,COGS 14A,A01,092681,Staff,0,23,100,100
1650401031645,COGS 14B,A01,083073,Cheng; Tzu-Han,0,10,50,50
1650401037667,COGS 17,A01,092677,Staff,24,0,75,51
1650401043698,COGS 100,A01,083619,Staff,0,24,60,60
1650401049724,COGS 101A,A01,083621,Davis; Joshua Daniel,0,21,60,60
1650401055746,COGS 101B,A01,091572,Staff,0,2,60,60
1650401061769,COGS 101C,A01,083625,Delgado; Tania,16,0,30,14
1650401067794,COGS 107A,A01,083627,Boyle; Mary E. T.,0,10,60,60
1650401073825,COGS 118A,A01,083075,Staff,4,0,60,56
1650401079862,CSE 3,A50,083646,Miranda; Gregory Joseph,21,0,38,17
1650401079862,CSE 3,A51,083647,Miranda; Gregory Joseph,37,0,37,0
1650401085890,CSE 8A,A50,083650,Miranda; Gregory Joseph,0,28,40,40
1650401091920,CSE 11,A01,083080,Cao; Yingjun,0,90,40,40
1650401097947,CSE 12,A01,083652,Staff,0,15,100,100
1650401103976,CSE 15L,A01,083654,Staff,0,1,50,50
1650401103976,CSE 15L,A02,083655,Staff,2,0,50,48
1650401110006,CSE 20,A01,083657,Staff,51,0,80,29
1650401116029,CSE 30,A01,083084,Eldon; John,0,76,40,40
1650401122053,CSE 100,A01,083659,Cao; Yingjun,0,66,50,50
1650401128086,CSE 134B,A01,083661,Powell; Thomas Allan,0,31,65,65
1650401134109,CSE 140,A01,083663,Staff,0,0,75,75
1650401140146,CSE 140L,A01,083088,Eldon; John,0,7,75,75
1650401146173,CSE 175,A01,083665,Kumar; Rakesh,7,0,25,18
1650401152195,CSE 190,A00,092507,Dubnov; Shlomo,14,0,20,6
1650401158221,ECE 45,A01,083139,Staff,0,17,40,40
1650401164244,ECE 65,A50,083695,Staff,0,5,30,30
1650401170268,ECE 109,A01,091882,Touri; Behrouz,39,0,70,31
1650401176295,ECE 180,A00,083140,Abi Samra; Nicholas Camill,24,0,30,6
1650401176295,ECE 180,B00,083141,Abi Samra; Nicholas Camill,1,0,30,29
1650401182329,MATH 10A,A01,083735,Patchell; Gregory David,7,0,30,23
1650401182329,MATH 10A,A02,083736,Patchell; Gregory David,28,0,30,2
1650401182329,MATH 10A,A03,083737,Patchell; Gregory David,25,0,30,5
1650401188353,MATH 10B,A01,083207,Staff,0,7,30,30
1650401188353,MATH 10B,A02,083208,Staff,0,7,30,30
1650401188353,MATH 10B,B01,083739,Staff,16,0,30,14
1650401188353,MATH 10B,B02,083740,Staff,28,0,30,2
1650401194388,MATH 18,A01,083743,Staff,2,0,30,28
1650401194388,MATH 18,A02,083744,Staff,27,0,30,3
1650401194388,MATH 18,A03,083745,Staff,22,0,30,8
1650401194388,MATH 18,A04,083746,Staff,27,0,30,3
1650401194388,MATH 18,B01,083748,Staff,0,11,30,30
1650401194388,MATH 18,B02,083749,Staff,0,12,30,30
1650401194388,MATH 18,B03,083750,Staff,0,11,30,30
1650401194388,MATH 18,B04,083751,Staff,0,9,30,30
1650401200412,MATH 20A,A01,083754,Staff,26,0,40,14
1650401206437,MATH 20B,A01,083756,Staff,0,9,30,30
1650401206437,MATH 20B,A02,083757,Staff,0,8,30,30
1650401212463,MATH 20C,A01,083760,Staff,0,14,30,30
1650401212463,MATH 20C,A02,083761,Staff,1,15,30,29
1650401212463,MATH 20C,B01,083762,Staff,13,0,30,17
1650401212463,MATH 20C,B02,083763,Staff,28,0,30,2
1650401218501,MATH 20D,A01,083765,Staff,0,1,30,30
1650401218501,MATH 20D,A02,083766,Staff,7,0,30,23
1650401218501,MATH 20D,A03,083767,Staff,26,0,30,4
1650401224528,MATH 20E,A01,083771,Staff,5,0,30,25
1650401224528,MATH 20E,A02,083772,Staff,19,0,30,11
1650401224528,MATH 20E,B01,083773,Staff,0,0,30,30
1650401224528,MATH 20E,B02,083774,Staff,12,0,30,18
1650401230562,MATH 103A,A01,083777,Staff,0,11,30,30
1650401230562,MATH 103A,A02,083778,Staff,0,12,30,30
1650401230562,MATH 103A,B01,083779,Staff,0,13,30,30
1650401230562,MATH 103A,B02,083780,Staff,0,11,30,30
1650401236595,MATH 105,A01,085443,Staff,0,22,30,30
1650401242636,MATH 109,A01,083213,Anzaldo; Leesa B,0,7,30,30
1650401242636,MATH 109,A02,083214,Anzaldo; Leesa B,0,7,30,30
1650401242636,MATH 109,B01,083215,Anzaldo; Leesa B,0,5,30,30
1650401242636,MATH 109,B02,083216,Anzaldo; Leesa B,0,5,30,30
1650401248665,MATH 142A,A01,083219,Chow; Bennett,0,14,30,30
1650401248665,MATH 142A,A02,083220,Chow; Bennett,0,13,30,30
1650401248665,MATH 142A,B01,083221,Chow; Bennett,0,12,30,30
1650401248665,MATH 142A,B02,083222,Chow; Bennett,0,12,30,30
1650401254690,MATH 193A,A01,083224,Staff,0,5,30,30
1650401254690,MATH 193A,A02,083225,Staff,0,5,30,30
1650401254690,MATH 193A,A03,083781,Staff,0,4,30,30
1650401254690,MATH 193A,A04,083782,Staff,0,4,30,30
1650401260728,MATH 197,001,091859,McAuley; Julian John,9998,0,9999,1
1650401266810,COGS 9,A01,083615,Staff,0,14,60,60
1650401272836,COGS 11,A01,083617,Boyle; Mary E. T.,22,0,40,18
1650401278869,COGS 13,A01,083071,Staff,0,33,40,40
1650401284898,COGS 14A,A01,092681,Staff,0,23,100,100
1650401290922,COGS 14B,A01,083073,Cheng; Tzu-Han,0,10,50,50
1650401296945,COGS 17,A01,092677,Staff,24,0,75,51
1650401302971,COGS 100,A01,083619,Staff,0,24,60,60
1650401309012,COGS 101A,A01,083621,Davis; Joshua Daniel,0,21,60,60
1650401315037,COGS 101B,A01,091572,Staff,0,2,60,60
1650401321061,COGS 101C,A01,083625,Delgado; Tania,16,0,30,14
1650401327085,COGS 107A,A01,083627,Boyle; Mary E. T.,0,10,60,60
1650401333110,COGS 118A,A01,083075,Staff,4,0,60,56
1650401339137,CSE 3,A50,083646,Miranda; Gregory Joseph,21,0,38,17
1650401339137,CSE 3,A51,083647,Miranda; Gregory Joseph,37,0,37,0
1650401345165,CSE 8A,A50,083650,Miranda; Gregory Joseph,0,28,40,40
1650401351189,CSE 11,A01,083080,Cao; Yingjun,0,90,40,40
1650401357227,CSE 12,A01,083652,Staff,0,15,100,100
1650401363254,CSE 15L,A01,083654,Staff,0,1,50,50
1650401363254,CSE 15L,A02,083655,Staff,2,0,50,48
1650401369277,CSE 20,A01,083657,Staff,51,0,80,29
1650401375304,CSE 30,A01,083084,Eldon; John,0,76,40,40
1650401381326,CSE 100,A01,083659,Cao; Yingjun,0,66,50,50
1650401387350,CSE 134B,A01,083661,Powell; Thomas Allan,0,31,65,65
1650401393375,CSE 140,A01,083663,Staff,0,0,75,75
1650401399408,CSE 140L,A01,083088,Eldon; John,0,7,75,75
1650401405431,CSE 175,A01,083665,Kumar; Rakesh,7,0,25,18
1650401411463,CSE 190,A00,092507,Dubnov; Shlomo,14,0,20,6
1650401417489,ECE 45,A01,083139,Staff,0,17,40,40
1650401423551,ECE 65,A50,083695,Staff,0,5,30,30
1650401429574,ECE 109,A01,091882,Touri; Behrouz,39,0,70,31
1650401435597,ECE 180,A00,083140,Abi Samra; Nicholas Camill,24,0,30,6
1650401435597,ECE 180,B00,083141,Abi Samra; Nicholas Camill,1,0,30,29
1650401441624,MATH 10A,A01,083735,Patchell; Gregory David,7,0,30,23
1650401441624,MATH 10A,A02,083736,Patchell; Gregory David,28,0,30,2
1650401441624,MATH 10A,A03,083737,Patchell; Gregory David,25,0,30,5
1650401447647,MATH 10B,A01,083207,Staff,0,7,30,30
1650401447647,MATH 10B,A02,083208,Staff,0,7,30,30
1650401447647,MATH 10B,B01,083739,Staff,16,0,30,14
1650401447647,MATH 10B,B02,083740,Staff,28,0,30,2
1650401453674,MATH 18,A01,083743,Staff,2,0,30,28
1650401453674,MATH 18,A02,083744,Staff,27,0,30,3
1650401453674,MATH 18,A03,083745,Staff,22,0,30,8
1650401453674,MATH 18,A04,083746,Staff,27,0,30,3
1650401453674,MATH 18,B01,083748,Staff,0,11,30,30
1650401453674,MATH 18,B02,083749,Staff,0,12,30,30
1650401453674,MATH 18,B03,083750,Staff,0,11,30,30
1650401453674,MATH 18,B04,083751,Staff,0,9,30,30
1650401459697,MATH 20A,A01,083754,Staff,26,0,40,14
1650401465825,MATH 20B,A01,083756,Staff,0,9,30,30
1650401465825,MATH 20B,A02,083757,Staff,0,8,30,30
1650401471853,MATH 20C,A01,083760,Staff,0,14,30,30
1650401471853,MATH 20C,A02,083761,Staff,1,15,30,29
1650401471853,MATH 20C,B01,083762,Staff,13,0,30,17
1650401471853,MATH 20C,B02,083763,Staff,28,0,30,2
1650401477893,MATH 20D,A01,083765,Staff,0,1,30,30
1650401477893,MATH 20D,A02,083766,Staff,7,0,30,23
1650401477893,MATH 20D,A03,083767,Staff,26,0,30,4
1650401483916,MATH 20E,A01,083771,Staff,5,0,30,25
1650401483916,MATH 20E,A02,083772,Staff,19,0,30,11
1650401483916,MATH 20E,B01,083773,Staff,0,0,30,30
1650401483916,MATH 20E,B02,083774,Staff,12,0,30,18
1650401489947,MATH 103A,A01,083777,Staff,0,11,30,30
1650401489947,MATH 103A,A02,083778,Staff,0,12,30,30
1650401489947,MATH 103A,B01,083779,Staff,0,13,30,30
1650401489947,MATH 103A,B02,083780,Staff,0,11,30,30
1650401495969,MATH 105,A01,085443,Staff,0,22,30,30
1650401501995,MATH 109,A01,083213,Anzaldo; Leesa B,0,7,30,30
1650401501995,MATH 109,A02,083214,Anzaldo; Leesa B,0,7,30,30
1650401501995,MATH 109,B01,083215,Anzaldo; Leesa B,0,5,30,30
1650401501995,MATH 109,B02,083216,Anzaldo; Leesa B,0,5,30,30
1650401508018,MATH 142A,A01,083219,Chow; Bennett,0,14,30,30
1650401508018,MATH 142A,A02,083220,Chow; Bennett,0,13,30,30
1650401508018,MATH 142A,B01,083221,Chow; Bennett,0,12,30,30
1650401508018,MATH 142A,B02,083222,Chow; Bennett,0,12,30,30
1650401514042,MATH 193A,A01,083224,Staff,0,5,30,30
1650401514042,MATH 193A,A02,083225,Staff,0,5,30,30
1650401514042,MATH 193A,A03,083781,Staff,0,4,30,30
1650401514042,MATH 193A,A04,083782,Staff,0,4,30,30
1650401520073,MATH 197,001,091859,McAuley; Julian John,9998,0,9999,1
1650401526124,COGS 9,A01,083615,Staff,0,14,60,60
1650401532154,COGS 11,A01,083617,Boyle; Mary E. T.,22,0,40,18
1650401538184,COGS 13,A01,083071,Staff,0,33,40,40
1650401544214,COGS 14A,A01,092681,Staff,0,23,100,100
1650401550238,COGS 14B,A01,083073,Cheng; Tzu-Han,0,10,50,50
1650401556264,COGS 17,A01,092677,Staff,24,0,75,51
1650401562287,COGS 100,A01,083619,Staff,0,25,60,60
1650401568315,COGS 101A,A01,083621,Davis; Joshua Daniel,0,21,60,60
1650401574341,COGS 101B,A01,091572,Staff,0,3,60,60
1650401580365,COGS 101C,A01,083625,Delgado; Tania,16,0,30,14
1650401586394,COGS 107A,A01,083627,Boyle; Mary E. T.,0,10,60,60
1650401592416,COGS 118A,A01,083075,Staff,4,0,60,56
1650401598444,CSE 3,A50,083646,Miranda; Gregory Joseph,21,0,38,17
1650401598444,CSE 3,A51,083647,Miranda; Gregory Joseph,37,0,37,0
1650401604468,CSE 8A,A50,083650,Miranda; Gregory Joseph,0,28,40,40
1650401610493,CSE 11,A01,083080,Cao; Yingjun,0,90,40,40
1650401616519,CSE 12,A01,083652,Staff,0,15,100,100
1650401622545,CSE 15L,A01,083654,Staff,0,1,50,50
1650401622545,CSE 15L,A02,083655,Staff,2,0,50,48
1650401628573,CSE 20,A01,083657,Staff,51,0,80,29
1650401634599,CSE 30,A01,083084,Eldon; John,0,76,40,40
1650401640632,CSE 100,A01,083659,Cao; Yingjun,0,66,50,50
1650401646658,CSE 134B,A01,083661,Powell; Thomas Allan,0,31,65,65
1650401652681,CSE 140,A01,083663,Staff,0,1,75,75
1650401658712,CSE 140L,A01,083088,Eldon; John,0,7,75,75
1650401664749,CSE 175,A01,083665,Kumar; Rakesh,7,0,25,18
1650401670776,CSE 190,A00,092507,Dubnov; Shlomo,14,0,20,6
1650401676800,ECE 45,A01,083139,Staff,0,17,40,40
1650401682822,ECE 65,A50,083695,Staff,0,5,30,30
1650401688845,ECE 109,A01,091882,Touri; Behrouz,39,0,70,31
1650401694870,ECE 180,A00,083140,Abi Samra; Nicholas Camill,24,0,30,6
1650401694870,ECE 180,B00,083141,Abi Samra; Nicholas Camill,1,0,30,29
1650401700911,MATH 10A,A01,083735,Patchell; Gregory David,7,0,30,23
1650401700911,MATH 10A,A02,083736,Patchell; Gregory David,28,0,30,2
1650401700911,MATH 10A,A03,083737,Patchell; Gregory David,25,0,30,5
1650401706941,MATH 10B,A01,083207,Staff,0,7,30,30
1650401706941,MATH 10B,A02,083208,Staff,0,7,30,30
1650401706941,MATH 10B,B01,083739,Staff,16,0,30,14
1650401706941,MATH 10B,B02,083740,Staff,28,0,30,2
1650401712965,MATH 18,A01,083743,Staff,2,0,30,28
1650401712965,MATH 18,A02,083744,Staff,27,0,30,3
1650401712965,MATH 18,A03,083745,Staff,22,0,30,8
1650401712965,MATH 18,A04,083746,Staff,27,0,30,3
1650401712965,MATH 18,B01,083748,Staff,0,11,30,30
1650401712965,MATH 18,B02,083749,Staff,0,12,30,30
1650401712965,MATH 18,B03,083750,Staff,0,11,30,30
1650401712965,MATH 18,B04,083751,Staff,0,9,30,30
1650401718989,MATH 20A,A01,083754,Staff,26,0,40,14
1650401725019,MATH 20B,A01,083756,Staff,0,9,30,30
1650401725019,MATH 20B,A02,083757,Staff,0,8,30,30
1650401731049,MATH 20C,A01,083760,Staff,0,14,30,30
1650401731049,MATH 20C,A02,083761,Staff,1,15,30,29
1650401731049,MATH 20C,B01,083762,Staff,13,0,30,17
1650401731049,MATH 20C,B02,083763,Staff,28,0,30,2
1650401737076,MATH 20D,A01,083765,Staff,0,1,30,30
1650401737076,MATH 20D,A02,083766,Staff,7,0,30,23
1650401737076,MATH 20D,A03,083767,Staff,26,0,30,4
1650401743122,MATH 20E,A01,083771,Staff,5,0,30,25
1650401743122,MATH 20E,A02,083772,Staff,19,0,30,11
1650401743122,MATH 20E,B01,083773,Staff,0,0,30,30
1650401743122,MATH 20E,B02,083774,Staff,12,0,30,18
1650401749152,MATH 103A,A01,083777,Staff,0,11,30,30
1650401749152,MATH 103A,A02,083778,Staff,0,12,30,30
1650401749152,MATH 103A,B01,083779,Staff,0,13,30,30
1650401749152,MATH 103A,B02,083780,Staff,0,11,30,30
1650401755175,MATH 105,A01,085443,Staff,0,22,30,30
1650401761201,MATH 109,A01,083213,Anzaldo; Leesa B,0,7,30,30
1650401761201,MATH 109,A02,083214,Anzaldo; Leesa B,0,7,30,30
1650401761201,MATH 109,B01,083215,Anzaldo; Leesa B,0,5,30,30
1650401761201,MATH 109,B02,083216,Anzaldo; Leesa B,0,5,30,30
1650401767226,MATH 142A,A01,083219,Chow; Bennett,0,14,30,30
1650401767226,MATH 142A,A02,083220,Chow; Bennett,0,13,30,30
1650401767226,MATH 142A,B01,083221,Chow; Bennett,0,12,30,30
1650401767226,MATH 142A,B02,083222,Chow; Bennett,0,12,30,30
1650401773250,MATH 193A,A01,083224,Staff,0,5,30,30
1650401773250,MATH 193A,A02,083225,Staff,0,5,30,30
1650401773250,MATH 193A,A03,083781,Staff,0,4,30,30
1650401773250,MATH 193A,A04,083782,Staff,0,4,30,30
1650401779280,MATH 197,001,091859,McAuley; Julian John,9998,0,9999,1
1650401785337,COGS 9,A01,083615,Staff,0,14,60,60
1650401791360,COGS 11,A01,083617,Boyle; Mary E. T.,22,0,40,18
1650401797386,COGS 13,A01,083071,Staff,0,33,40,40
1650401803410,COGS 14A,A01,092681,Staff,0,23,100,100
1650401809433,COGS 14B,A01,083073,Cheng; Tzu-Han,0,10,50,50
1650401815458,COGS 17,A01,092677,Staff,24,0,75,51
1650401821493,COGS 100,A01,083619,Staff,0,25,60,60
1650401827525,COGS 101A,A01,083621,Davis; Joshua Daniel,0,21,60,60
1650401833560,COGS 101B,A01,091572,Staff,0,3,60,60
1650401839584,COGS 101C,A01,083625,Delgado; Tania,16,0,30,14
1650401845609,COGS 107A,A01,083627,Boyle; Mary E. T.,0,10,60,60
1650401851642,COGS 118A,A01,083075,Staff,4,0,60,56
1650401857683,CSE 3,A50,083646,Miranda; Gregory Joseph,21,0,38,17
1650401857683,CSE 3,A51,083647,Miranda; Gregory Joseph,37,0,37,0
1650401863710,CSE 8A,A50,083650,Miranda; Gregory Joseph,0,28,40,40
1650401869738,CSE 11,A01,083080,Cao; Yingjun,0,90,40,40
1650401875761,CSE 12,A01,083652,Staff,0,15,100,100
1650401881787,CSE 15L,A01,083654,Staff,0,1,50,50
1650401881787,CSE 15L,A02,083655,Staff,2,0,50,48
1650401887823,CSE 20,A01,083657,Staff,51,0,80,29
1650401893848,CSE 30,A01,083084,Eldon; John,0,76,40,40
1650401899873,CSE 100,A01,083659,Cao; Yingjun,0,66,50,50
1650401905900,CSE 134B,A01,083661,Powell; Thomas Allan,0,31,65,65
1650401911925,CSE 140,A01,083663,Staff,0,1,75,75
1650401917948,CSE 140L,A01,083088,Eldon; John,0,7,75,75
1650401923976,CSE 175,A01,083665,Kumar; Rakesh,7,0,25,18
1650401929999,CSE 190,A00,092507,Dubnov; Shlomo,14,0,20,6
1650401936025,ECE 45,A01,083139,Staff,0,17,40,40
1650401942048,ECE 65,A50,083695,Staff,0,5,30,30
1650401948074,ECE 109,A01,091882,Touri; Behrouz,39,0,70,31
1650401954099,ECE 180,A00,083140,Abi Samra; Nicholas Camill,24,0,30,6
1650401954099,ECE 180,B00,083141,Abi Samra; Nicholas Camill,1,0,30,29
1650401960126,MATH 10A,A01,083735,Patchell; Gregory David,7,0,30,23
1650401960126,MATH 10A,A02,083736,Patchell; Gregory David,28,0,30,2
1650401960126,MATH 10A,A03,083737,Patchell; Gregory David,25,0,30,5
1650401966154,MATH 10B,A01,083207,Staff,0,7,30,30
1650401966154,MATH 10B,A02,083208,Staff,0,7,30,30
1650401966154,MATH 10B,B01,083739,Staff,16,0,30,14
1650401966154,MATH 10B,B02,083740,Staff,28,0,30,2
1650401972179,MATH 18,A01,083743,Staff,2,0,30,28
1650401972179,MATH 18,A02,083744,Staff,27,0,30,3
1650401972179,MATH 18,A03,083745,Staff,22,0,30,8
1650401972179,MATH 18,A04,083746,Staff,27,0,30,3
1650401972179,MATH 18,B01,083748,Staff,0,11,30,30
1650401972179,MATH 18,B02,083749,Staff,0,12,30,30
1650401972179,MATH 18,B03,083750,Staff,0,11,30,30
1650401972179,MATH 18,B04,083751,Staff,0,9,30,30
1650401978213,MATH 20A,A01,083754,Staff,26,0,40,14
1650401984250,MATH 20B,A01,083756,Staff,0,9,30,30
1650401984250,MATH 20B,A02,083757,Staff,0,8,30,30
1650401990278,MATH 20C,A01,083760,Staff,0,14,30,30
1650401990278,MATH 20C,A02,083761,Staff,1,15,30,29
1650401990278,MATH 20C,B01,083762,Staff,13,0,30,17
1650401990278,MATH 20C,B02,083763,Staff,28,0,30,2
1650401996320,MATH 20D,A01,083765,Staff,0,1,30,30
1650401996320,MATH 20D,A02,083766,Staff,7,0,30,23
1650401996320,MATH 20D,A03,083767,Staff,26,0,30,4
1650402002358,MATH 20E,A01,083771,Staff,5,0,30,25
1650402002358,MATH 20E,A02,083772,Staff,19,0,30,11
1650402002358,MATH 20E,B01,083773,Staff,0,0,30,30
1650402002358,MATH 20E,B02,083774,Staff,12,0,30,18
1650402008393,MATH 103A,A01,083777,Staff,0,11,30,30
1650402008393,MATH 103A,A02,083778,Staff,0,12,30,30
1650402008393,MATH 103A,B01,083779,Staff,0,13,30,30
1650402008393,MATH 103A,B02,083780,Staff,0,11,30,30
1650402014419,MATH 105,A01,085443,Staff,0,22,30,30
1650402020447,MATH 109,A01,083213,Anzaldo; Leesa B,0,7,30,30
1650402020447,MATH 109,A02,083214,Anzaldo; Leesa B,0,7,30,30
1650402020447,MATH 109,B01,083215,Anzaldo; Leesa B,0,5,30,30
1650402020447,MATH 109,B02,083216,Anzaldo; Leesa B,0,5,30,30
1650402026485,MATH 142A,A01,083219,Chow; Bennett,0,14,30,30
1650402026485,MATH 142A,A02,083220,Chow; Bennett,0,13,30,30
1650402026485,MATH 142A,B01,083221,Chow; Bennett,0,12,30,30
1650402026485,MATH 142A,B02,083222,Chow; Bennett,0,12,30,30
1650402032507,MATH 193A,A01,083224,Staff,0,5,30,30
1650402032507,MATH 193A,A02,083225,Staff,0,5,30,30
1650402032507,MATH 193A,A03,083781,Staff,0,4,30,30
1650402032507,MATH 193A,A04,083782,Staff,0,4,30,30
1650402038562,MATH 197,001,091859,McAuley; Julian John,9998,0,9999,1
1650402044624,COGS 9,A01,083615,Staff,0,14,60,60
1650402050658,COGS 11,A01,083617,Boyle; Mary E. T.,22,0,40,18
1650402056770,COGS 13,A01,083071,Staff,0,33,40,40
1650402062812,COGS 14A,A01,092681,Staff,0,23,100,100
1650402068843,COGS 14B,A01,083073,Cheng; Tzu-Han,0,10,50,50
1650402074867,COGS 17,A01,092677,Staff,24,0,75,51
1650402080889,COGS 100,A01,083619,Staff,0,25,60,60
1650402086913,COGS 101A,A01,083621,Davis; Joshua Daniel,0,21,60,60
1650402092945,COGS 101B,A01,091572,Staff,0,3,60,60
1650402098971,COGS 101C,A01,083625,Delgado; Tania,16,0,30,14
1650402104996,COGS 107A,A01,083627,Boyle; Mary E. T.,0,10,60,60
1650402111020,COGS 118A,A01,083075,Staff,4,0,60,56
1650402117045,CSE 3,A50,083646,Miranda; Gregory Joseph,21,0,38,17
1650402117045,CSE 3,A51,083647,Miranda; Gregory Joseph,37,0,37,0
1650402123074,CSE 8A,A50,083650,Miranda; Gregory Joseph,0,28,40,40
1650402129101,CSE 11,A01,083080,Cao; Yingjun,0,90,40,40
1650402135133,CSE 12,A01,083652,Staff,0,15,100,100
1650402141158,CSE 15L,A01,083654,Staff,0,1,50,50
1650402141158,CSE 15L,A02,083655,Staff,2,0,50,48
1650402147185,CSE 20,A01,083657,Staff,51,0,80,29
1650402153213,CSE 30,A01,083084,Eldon; John,0,76,40,40
1650402159240,CSE 100,A01,083659,Cao; Yingjun,0,66,50,50
1650402165266,CSE 134B,A01,083661,Powell; Thomas Allan,0,31,65,65
1650402171298,CSE 140,A01,083663,Staff,0,1,75,75
1650402177324,CSE 140L,A01,083088,Eldon; John,0,7,75,75
1650402183350,CSE 175,A01,083665,Kumar; Rakesh,7,0,25,18
1650402189379,CSE 190,A00,092507,Dubnov; Shlomo,14,0,20,6
1650402195402,ECE 45,A01,083139,Staff,0,17,40,40
1650402201432,ECE 65,A50,083695,Staff,0,5,30,30
1650402207465,ECE 109,A01,091882,Touri; Behrouz,39,0,70,31
1650402213493,ECE 180,A00,083140,Abi Samra; Nicholas Camill,24,0,30,6
1650402213493,ECE 180,B00,083141,Abi Samra; Nicholas Camill,1,0,30,29
1650402219517,MATH 10A,A01,083735,Patchell; Gregory David,7,0,30,23
1650402219517,MATH 10A,A02,083736,Patchell; Gregory David,28,0,30,2
1650402219517,MATH 10A,A03,083737,Patchell; Gregory David,25,0,30,5
1650402225541,MATH 10B,A01,083207,Staff,0,7,30,30
1650402225541,MATH 10B,A02,083208,Staff,0,7,30,30
1650402225541,MATH 10B,B01,083739,Staff,16,0,30,14
1650402225541,MATH 10B,B02,083740,Staff,28,0,30,2
1650402231586,MATH 18,A01,083743,Staff,2,0,30,28
1650402231586,MATH 18,A02,083744,Staff,27,0,30,3
1650402231586,MATH 18,A03,083745,Staff,22,0,30,8
1650402231586,MATH 18,A04,083746,Staff,27,0,30,3
1650402231586,MATH 18,B01,083748,Staff,0,11,30,30
1650402231586,MATH 18,B02,083749,Staff,0,12,30,30
1650402231586,MATH 18,B03,083750,Staff,0,11,30,30
1650402231586,MATH 18,B04,083751,Staff,0,9,30,30
1650402237608,MATH 20A,A01,083754,Staff,26,0,40,14
1650402243632,MATH 20B,A01,083756,Staff,0,9,30,30
1650402243632,MATH 20B,A02,083757,Staff,0,8,30,30
1650402249655,MATH 20C,A01,083760,Staff,0,14,30,30
1650402249655,MATH 20C,A02,083761,Staff,1,15,30,29
1650402249655,MATH 20C,B01,083762,Staff,13,0,30,17
1650402249655,MATH 20C,B02,083763,Staff,28,0,30,2
1650402255682,MATH 20D,A01,083765,Staff,0,1,30,30
1650402255682,MATH 20D,A02,083766,Staff,7,0,30,23
1650402255682,MATH 20D,A03,083767,Staff,26,0,30,4
1650402261709,MATH 20E,A01,083771,Staff,5,0,30,25
1650402261709,MATH 20E,A02,083772,Staff,19,0,30,11
1650402261709,MATH 20E,B01,083773,Staff,0,0,30,30
1650402261709,MATH 20E,B02,083774,Staff,12,0,30,18
1650402267746,MATH 103A,A01,083777,Staff,0,11,30,30
1650402267746,MATH 103A,A02,083778,Staff,0,12,30,30
1650402267746,MATH 103A,B01,083779,Staff,0,13,30,30
1650402267746,MATH 103A,B02,083780,Staff,0,11,30,30
1650402273769,MATH 105,A01,085443,Staff,0,22,30,30
1650402279804,MATH 109,A01,083213,Anzaldo; Leesa B,0,7,30,30
1650402279804,MATH 109,A02,083214,Anzaldo; Leesa B,0,7,30,30
1650402279804,MATH 109,B01,083215,Anzaldo; Leesa B,0,5,30,30
1650402279804,MATH 109,B02,083216,Anzaldo; Leesa B,0,5,30,30
1650402285832,MATH 142A,A01,083219,Chow; Bennett,0,14,30,30
1650402285832,MATH 142A,A02,083220,Chow; Bennett,0,13,30,30
1650402285832,MATH 142A,B01,083221,Chow; Bennett,0,12,30,30
1650402285832,MATH 142A,B02,083222,Chow; Bennett,0,12,30,30
1650402291857,MATH 193A,A01,083224,Staff,0,5,30,30
1650402291857,MATH 193A,A02,083225,Staff,0,5,30,30
1650402291857,MATH 193A,A03,083781,Staff,0,4,30,30
1650402291857,MATH 193A,A04,083782,Staff,0,4,30,30
1650402297887,MATH 197,001,091859,McAuley; Julian John,9998,0,9999,1
1650402303965,COGS 9,A01,083615,Staff,0,14,60,60
1650402309989,COGS 11,A01,083617,Boyle; Mary E. T.,22,0,40,18
1650402316025,COGS 13,A01,083071,Staff,0,33,40,40
1650402322050,COGS 14A,A01,092681,Staff,0,23,100,100
1650402328078,COGS 14B,A01,083073,Cheng; Tzu-Han,0,10,50,50
1650402334108,COGS 17,A01,092677,Staff,24,0,75,51
1650402340131,COGS 100,A01,083619,Staff,0,26,60,60
1650402346157,COGS 101A,A01,083621,Davis; Joshua Daniel,0,21,60,60
1650402352183,COGS 101B,A01,091572,Staff,0,3,60,60
1650402358223,COGS 101C,A01,083625,Delgado; Tania,16,0,30,14
1650402364247,COGS 107A,A01,083627,Boyle; Mary E. T.,0,10,60,60
1650402370273,COGS 118A,A01,083075,Staff,4,0,60,56
1650402376299,CSE 3,A50,083646,Miranda; Gregory Joseph,21,0,38,17
1650402376299,CSE 3,A51,083647,Miranda; Gregory Joseph,37,0,37,0
1650402382333,CSE 8A,A50,083650,Miranda; Gregory Joseph,0,28,40,40
1650402388360,CSE 11,A01,083080,Cao; Yingjun,0,90,40,40
1650402394386,CSE 12,A01,083652,Staff,0,15,100,100
1650402400431,CSE 15L,A01,083654,Staff,0,1,50,50
1650402400431,CSE 15L,A02,083655,Staff,2,0,50,48
1650402406455,CSE 20,A01,083657,Staff,51,0,80,29
1650402412490,CSE 30,A01,083084,Eldon; John,0,76,40,40
1650402418525,CSE 100,A01,083659,Cao; Yingjun,0,66,50,50
1650402424555,CSE 134B,A01,083661,Powell; Thomas Allan,0,31,65,65
1650402430579,CSE 140,A01,083663,Staff,0,1,75,75
1650402436604,CSE 140L,A01,083088,Eldon; John,0,7,75,75
1650402442629,CSE 175,A01,083665,Kumar; Rakesh,7,0,25,18
1650402448652,CSE 190,A00,092507,Dubnov; Shlomo,14,0,20,6
1650402454675,ECE 45,A01,083139,Staff,0,17,40,40
1650402460699,ECE 65,A50,083695,Staff,0,5,30,30
1650402466724,ECE 109,A01,091882,Touri; Behrouz,39,0,70,31
1650402472757,ECE 180,A00,083140,Abi Samra; Nicholas Camill,24,0,30,6
1650402472757,ECE 180,B00,083141,Abi Samra; Nicholas Camill,1,0,30,29
1650402478781,MATH 10A,A01,083735,Patchell; Gregory David,7,0,30,23
1650402478781,MATH 10A,A02,083736,Patchell; Gregory David,28,0,30,2
1650402478781,MATH 10A,A03,083737,Patchell; Gregory David,25,0,30,5
1650402484809,MATH 10B,A01,083207,Staff,0,7,30,30
1650402484809,MATH 10B,A02,083208,Staff,0,7,30,30
1650402484809,MATH 10B,B01,083739,Staff,16,0,30,14
1650402484809,MATH 10B,B02,083740,Staff,28,0,30,2
1650402490850,MATH 18,A01,083743,Staff,2,0,30,28
1650402490850,MATH 18,A02,083744,Staff,27,0,30,3
1650402490850,MATH 18,A03,083745,Staff,22,0,30,8
1650402490850,MATH 18,A04,083746,Staff,27,0,30,3
1650402490850,MATH 18,B01,083748,Staff,0,11,30,30
1650402490850,MATH 18,B02,083749,Staff,0,12,30,30
1650402490850,MATH 18,B03,083750,Staff,0,11,30,30
1650402490850,MATH 18,B04,083751,Staff,0,9,30,30
1650402496883,MATH 20A,A01,083754,Staff,26,0,40,14
1650402502910,MATH 20B,A01,083756,Staff,0,9,30,30
1650402502910,MATH 20B,A02,083757,Staff,0,8,30,30
1650402508938,MATH 20C,A01,083760,Staff,0,14,30,30
1650402508938,MATH 20C,A02,083761,Staff,1,15,30,29
1650402508938,MATH 20C,B01,083762,Staff,13,0,30,17
1650402508938,MATH 20C,B02,083763,Staff,28,0,30,2
1650402514961,MATH 20D,A01,083765,Staff,0,1,30,30
1650402514961,MATH 20D,A02,083766,Staff,7,0,30,23
1650402514961,MATH 20D,A03,083767,Staff,26,0,30,4
1650402520990,MATH 20E,A01,083771,Staff,5,0,30,25
1650402520990,MATH 20E,A02,083772,Staff,19,0,30,11
1650402520990,MATH 20E,B01,083773,Staff,0,0,30,30
1650402520990,MATH 20E,B02,083774,Staff,12,0,30,18
1650402527016,MATH 103A,A01,083777,Staff,0,11,30,30
1650402527016,MATH 103A,A02,083778,Staff,0,12,30,30
1650402527016,MATH 103A,B01,083779,Staff,0,13,30,30
1650402527016,MATH 103A,B02,083780,Staff,0,11,30,30
1650402533046,MATH 105,A01,085443,Staff,0,22,30,30
1650402539072,MATH 109,A01,083213,Anzaldo; Leesa B,0,7,30,30
1650402539072,MATH 109,A02,083214,Anzaldo; Leesa B,0,7,30,30
1650402539072,MATH 109,B01,083215,Anzaldo; Leesa B,0,5,30,30
1650402539072,MATH 109,B02,083216,Anzaldo; Leesa B,0,5,30,30
1650402545103,MATH 142A,A01,083219,Chow; Bennett,0,14,30,30
1650402545103,MATH 142A,A02,083220,Chow; Bennett,0,13,30,30
1650402545103,MATH 142A,B01,083221,Chow; Bennett,0,12,30,30
1650402545103,MATH 142A,B02,083222,Chow; Bennett,0,12,30,30
1650402551133,MATH 193A,A01,083224,Staff,0,5,30,30
1650402551133,MATH 193A,A02,083225,Staff,0,5,30,30
1650402551133,MATH 193A,A03,083781,Staff,0,4,30,30
1650402551133,MATH 193A,A04,083782,Staff,0,4,30,30
1650402557155,MATH 197,001,091859,McAuley; Julian John,9998,0,9999,1
1650402563206,COGS 9,A01,083615,Staff,0,14,60,60
1650402569234,COGS 11,A01,083617,Boyle; Mary E. T.,22,0,40,18
1650402575259,COGS 13,A01,083071,Staff,0,33,40,40
1650402581282,COGS 14A,A01,092681,Staff,0,23,100,100
1650402587306,COGS 14B,A01,083073,Cheng; Tzu-Han,0,10,50,50
1650402593340,COGS 17,A01,092677,Staff,24,0,75,51
1650402599380,COGS 100,A01,083619,Staff,0,26,60,60
1650402605411,COGS 101A,A01,083621,Davis; Joshua Daniel,0,21,60,60
1650402611440,COGS 101B,A01,091572,Staff,0,3,60,60
1650402617466,COGS 101C,A01,083625,Delgado; Tania,16,0,30,14
1650402623490,COGS 107A,A01,083627,Boyle; Mary E. T.,0,10,60,60
1650402629516,COGS 118A,A01,083075,Staff,4,0,60,56
1650402635539,CSE 3,A50,083646,Miranda; Gregory Joseph,21,0,38,17
1650402635539,CSE 3,A51,083647,Miranda; Gregory Joseph,37,0,37,0
1650402641567,CSE 8A,A50,083650,Miranda; Gregory Joseph,0,28,40,40
1650402647594,CSE 11,A01,083080,Cao; Yingjun,0,90,40,40
1650402653725,CSE 12,A01,083652,Staff,0,15,100,100
1650402659755,CSE 15L,A01,083654,Staff,0,1,50,50
1650402659755,CSE 15L,A02,083655,Staff,2,0,50,48
1650402665785,CSE 20,A01,083657,Staff,51,0,80,29
1650402671808,CSE 30,A01,083084,Eldon; John,0,76,40,40
1650402677843,CSE 100,A01,083659,Cao; Yingjun,0,66,50,50
1650402683866,CSE 134B,A01,083661,Powell; Thomas Allan,1,31,65,64
1650402689893,CSE 140,A01,083663,Staff,0,1,75,75
1650402695920,CSE 140L,A01,083088,Eldon; John,0,7,75,75
1650402701943,CSE 175,A01,083665,Kumar; Rakesh,7,0,25,18
1650402707965,CSE 190,A00,092507,Dubnov; Shlomo,14,0,20,6
1650402713990,ECE 45,A01,083139,Staff,0,17,40,40
1650402720012,ECE 65,A50,083695,Staff,0,5,30,30
1650402726035,ECE 109,A01,091882,Touri; Behrouz,39,0,70,31
1650402732062,ECE 180,A00,083140,Abi Samra; Nicholas Camill,24,0,30,6
1650402732062,ECE 180,B00,083141,Abi Samra; Nicholas Camill,1,0,30,29
1650402738091,MATH 10A,A01,083735,Patchell; Gregory David,7,0,30,23
1650402738091,MATH 10A,A02,083736,Patchell; Gregory David,28,0,30,2
1650402738091,MATH 10A,A03,083737,Patchell; Gregory David,25,0,30,5
1650402744120,MATH 10B,A01,083207,Staff,0,7,30,30
1650402744120,MATH 10B,A02,083208,Staff,0,7,30,30
1650402744120,MATH 10B,B01,083739,Staff,16,0,30,14
1650402744120,MATH 10B,B02,083740,Staff,28,0,30,2
1650402750154,MATH 18,A01,083743,Staff,2,0,30,28
1650402750154,MATH 18,A02,083744,Staff,27,0,30,3
1650402750154,MATH 18,A03,083745,Staff,22,0,30,8
1650402750154,MATH 18,A04,083746,Staff,27,0,30,3
1650402750154,MATH 18,B01,083748,Staff,0,11,30,30
1650402750154,MATH 18,B02,083749,Staff,0,12,30,30
1650402750154,MATH 18,B03,083750,Staff,0,11,30,30
1650402750154,MATH 18,B04,083751,Staff,0,9,30,30
1650402756183,MATH 20A,A01,083754,Staff,26,0,40,14
1650402762210,MATH 20B,A01,083756,Staff,0,9,30,30
1650402762210,MATH 20B,A02,083757,Staff,0,8,30,30
1650402768232,MATH 20C,A01,083760,Staff,0,14,30,30
1650402768232,MATH 20C,A02,083761,Staff,1,15,30,29
1650402768232,MATH 20C,B01,083762,Staff,13,0,30,17
1650402768232,MATH 20C,B02,083763,Staff,28,0,30,2
1650402774265,MATH 20D,A01,083765,Staff,0,1,30,30
1650402774265,MATH 20D,A02,083766,Staff,7,0,30,23
1650402774265,MATH 20D,A03,083767,Staff,26,0,30,4
1650402780305,MATH 20E,A01,083771,Staff,5,0,30,25
1650402780305,MATH 20E,A02,083772,Staff,19,0,30,11
1650402780305,MATH 20E,B01,083773,Staff,0,0,30,30
1650402780305,MATH 20E,B02,083774,Staff,12,0,30,18
1650402786338,MATH 103A,A01,083777,Staff,0,11,30,30
1650402786338,MATH 103A,A02,083778,Staff,0,12,30,30
1650402786338,MATH 103A,B01,083779,Staff,0,13,30,30
1650402786338,MATH 103A,B02,083780,Staff,0,11,30,30
1650402792364,MATH 105,A01,085443,Staff,0,22,30,30
1650402798388,MATH 109,A01,083213,Anzaldo; Leesa B,0,7,30,30
1650402798388,MATH 109,A02,083214,Anzaldo; Leesa B,0,7,30,30
1650402798388,MATH 109,B01,083215,Anzaldo; Leesa B,0,5,30,30
1650402798388,MATH 109,B02,083216,Anzaldo; Leesa B,0,5,30,30
1650402804413,MATH 142A,A01,083219,Chow; Bennett,0,14,30,30
1650402804413,MATH 142A,A02,083220,Chow; Bennett,0,13,30,30
1650402804413,MATH 142A,B01,083221,Chow; Bennett,0,12,30,30
1650402804413,MATH 142A,B02,083222,Chow; Bennett,0,12,30,30
1650402810436,MATH 193A,A01,083224,Staff,0,5,30,30
1650402810436,MATH 193A,A02,083225,Staff,0,5,30,30
1650402810436,MATH 193A,A03,083781,Staff,0,4,30,30
1650402810436,MATH 193A,A04,083782,Staff,0,4,30,30
1650402816459,MATH 197,001,091859,McAuley; Julian John,9998,0,9999,1
1650402822515,COGS 9,A01,083615,Staff,0,14,60,60
1650402828546,COGS 11,A01,083617,Boyle; Mary E. T.,22,0,40,18
1650402834570,COGS 13,A01,083071,Staff,0,33,40,40
1650402840604,COGS 14A,A01,092681,Staff,0,23,100,100
1650402846629,COGS 14B,A01,083073,Cheng; Tzu-Han,0,10,50,50
1650402852650,COGS 17,A01,092677,Staff,24,0,75,51
1650402858680,COGS 100,A01,083619,Staff,0,26,60,60
1650402864708,COGS 101A,A01,083621,Davis; Joshua Daniel,0,21,60,60
1650402870734,COGS 101B,A01,091572,Staff,0,3,60,60
1650402876759,COGS 101C,A01,083625,Delgado; Tania,16,0,30,14
1650402882782,COGS 107A,A01,083627,Boyle; Mary E. T.,0,10,60,60
1650402888807,COGS 118A,A01,083075,Staff,4,0,60,56
1650402894831,CSE 3,A50,083646,Miranda; Gregory Joseph,21,0,38,17
1650402894831,CSE 3,A51,083647,Miranda; Gregory Joseph,37,0,37,0
1650402900859,CSE 8A,A50,083650,Miranda; Gregory Joseph,0,28,40,40
1650402906891,CSE 11,A01,083080,Cao; Yingjun,0,90,40,40
1650402912916,CSE 12,A01,083652,Staff,0,15,100,100
1650402918940,CSE 15L,A01,083654,Staff,0,1,50,50
1650402918940,CSE 15L,A02,083655,Staff,2,0,50,48
1650402924972,CSE 20,A01,083657,Staff,51,0,80,29
1650402930999,CSE 30,A01,083084,Eldon; John,0,76,40,40
1650402937025,CSE 100,A01,083659,Cao; Yingjun,0,66,50,50
1650402943052,CSE 134B,A01,083661,Powell; Thomas Allan,1,31,65,64
1650402949076,CSE 140,A01,083663,Staff,0,1,75,75
1650402955103,CSE 140L,A01,083088,Eldon; John,0,7,75,75
1650402961132,CSE 175,A01,083665,Kumar; Rakesh,7,0,25,18
1650402967159,CSE 190,A00,092507,Dubnov; Shlomo,14,0,20,6
1650402973184,ECE 45,A01,083139,Staff,0,17,40,40
1650402979210,ECE 65,A50,083695,Staff,0,5,30,30
1650402985235,ECE 109,A01,091882,Touri; Behrouz,39,0,70,31
1650402991269,ECE 180,A00,083140,Abi Samra; Nicholas Camill,24,0,30,6
1650402991269,ECE 180,B00,083141,Abi Samra; Nicholas Camill,1,0,30,29
1650402997298,MATH 10A,A01,083735,Patchell; Gregory David,7,0,30,23
1650402997298,MATH 10A,A02,083736,Patchell; Gregory David,28,0,30,2
1650402997298,MATH 10A,A03,083737,Patchell; Gregory David,25,0,30,5
1650403003323,MATH 10B,A01,083207,Staff,0,7,30,30
1650403003323,MATH 10B,A02,083208,Staff,0,7,30,30
1650403003323,MATH 10B,B01,083739,Staff,16,0,30,14
1650403003323,MATH 10B,B02,083740,Staff,28,0,30,2
1650403009355,MATH 18,A01,083743,Staff,2,0,30,28
1650403009355,MATH 18,A02,083744,Staff,27,0,30,3
1650403009355,MATH 18,A03,083745,Staff,22,0,30,8
1650403009355,MATH 18,A04,083746,Staff,27,0,30,3
1650403009355,MATH 18,B01,083748,Staff,0,11,30,30
1650403009355,MATH 18,B02,083749,Staff,0,12,30,30
1650403009355,MATH 18,B03,083750,Staff,0,11,30,30
1650403009355,MATH 18,B04,083751,Staff,0,9,30,30
1650403015378,MATH 20A,A01,083754,Staff,26,0,40,14
1650403021408,MATH 20B,A01,083756,Staff,0,9,30,30
1650403021408,MATH 20B,A02,083757,Staff,0,8,30,30
1650403027437,MATH 20C,A01,083760,Staff,0,14,30,30
1650403027437,MATH 20C,A02,083761,Staff,1,15,30,29
1650403027437,MATH 20C,B01,083762,Staff,13,0,30,17
1650403027437,MATH 20C,B02,083763,Staff,28,0,30,2
1650403033466,MATH 20D,A01,083765,Staff,0,1,30,30
1650403033466,MATH 20D,A02,083766,Staff,7,0,30,23
1650403033466,MATH 20D,A03,083767,Staff,26,0,30,4
1650403039496,MATH 20E,A01,083771,Staff,5,0,30,25
1650403039496,MATH 20E,A02,083772,Staff,19,0,30,11
1650403039496,MATH 20E,B01,083773,Staff,0,0,30,30
1650403039496,MATH 20E,B02,083774,Staff,12,0,30,18
1650403045523,MATH 103A,A01,083777,Staff,0,11,30,30
1650403045523,MATH 103A,A02,083778,Staff,0,12,30,30
1650403045523,MATH 103A,B01,083779,Staff,0,13,30,30
1650403045523,MATH 103A,B02,083780,Staff,0,11,30,30
1650403051557,MATH 105,A01,085443,Staff,0,22,30,30
1650403057581,MATH 109,A01,083213,Anzaldo; Leesa B,0,7,30,30
1650403057581,MATH 109,A02,083214,Anzaldo; Leesa B,0,7,30,30
1650403057581,MATH 109,B01,083215,Anzaldo; Leesa B,0,5,30,30
1650403057581,MATH 109,B02,083216,Anzaldo; Leesa B,0,5,30,30
1650403063605,MATH 142A,A01,083219,Chow; Bennett,0,14,30,30
1650403063605,MATH 142A,A02,083220,Chow; Bennett,0,13,30,30
1650403063605,MATH 142A,B01,083221,Chow; Bennett,0,12,30,30
1650403063605,MATH 142A,B02,083222,Chow; Bennett,0,12,30,30
1650403069636,MATH 193A,A01,083224,Staff,0,5,30,30
1650403069636,MATH 193A,A02,083225,Staff,0,5,30,30
1650403069636,MATH 193A,A03,083781,Staff,0,4,30,30
1650403069636,MATH 193A,A04,083782,Staff,0,4,30,30
1650403075658,MATH 197,001,091859,McAuley; Julian John,9998,0,9999,1
1650403081726,COGS 9,A01,083615,Staff,0,14,60,60
1650403087749,COGS 11,A01,083617,Boyle; Mary E. T.,22,0,40,18
1650403093772,COGS 13,A01,083071,Staff,0,33,40,40
1650403099808,COGS 14A,A01,092681,Staff,0,23,100,100
1650403105835,COGS 14B,A01,083073,Cheng; Tzu-Han,0,10,50,50
1650403111858,COGS 17,A01,092677,Staff,24,0,75,51
1650403117885,COGS 100,A01,083619,Staff,0,26,60,60
1650403123911,COGS 101A,A01,083621,Davis; Joshua Daniel,0,21,60,60
1650403129935,COGS 101B,A01,091572,Staff,0,4,60,60
1650403135958,COGS 101C,A01,083625,Delgado; Tania,16,0,30,14
1650403141985,COGS 107A,A01,083627,Boyle; Mary E. T.,0,10,60,60
1650403148008,COGS 118A,A01,083075,Staff,4,0,60,56
1650403154035,CSE 3,A50,083646,Miranda; Gregory Joseph,21,0,38,17
1650403154035,CSE 3,A51,083647,Miranda; Gregory Joseph,37,0,37,0
1650403160058,CSE 8A,A50,083650,Miranda; Gregory Joseph,0,28,40,40
1650403166086,CSE 11,A01,083080,Cao; Yingjun,0,90,40,40
1650403172118,CSE 12,A01,083652,Staff,0,15,100,100
1650403178141,CSE 15L,A01,083654,Staff,0,1,50,50
1650403178141,CSE 15L,A02,083655,Staff,2,0,50,48
1650403184164,CSE 20,A01,083657,Staff,51,0,80,29
1650403190194,CSE 30,A01,083084,Eldon; John,0,76,40,40
1650403196223,CSE 100,A01,083659,Cao; Yingjun,0,66,50,50
1650403202246,CSE 134B,A01,083661,Powell; Thomas Allan,1,31,65,64
1650403208272,CSE 140,A01,083663,Staff,0,1,75,75
1650403214299,CSE 140L,A01,083088,Eldon; John,0,7,75,75
1650403220324,CSE 175,A01,083665,Kumar; Rakesh,7,0,25,18
1650403226347,CSE 190,A00,092507,Dubnov; Shlomo,14,0,20,6
1650403232371,ECE 45,A01,083139,Staff,0,17,40,40
1650403238402,ECE 65,A50,083695,Staff,0,5,30,30
1650403244427,ECE 109,A01,091882,Touri; Behrouz,39,0,70,31
1650403250551,ECE 180,A00,083140,Abi Samra; Nicholas Camill,24,0,30,6
1650403250551,ECE 180,B00,083141,Abi Samra; Nicholas Camill,1,0,30,29
1650403256578,MATH 10A,A01,083735,Patchell; Gregory David,7,0,30,23
1650403256578,MATH 10A,A02,083736,Patchell; Gregory David,28,0,30,2
1650403256578,MATH 10A,A03,083737,Patchell; Gregory David,25,0,30,5
1650403262605,MATH 10B,A01,083207,Staff,0,7,30,30
1650403262605,MATH 10B,A02,083208,Staff,0,7,30,30
1650403262605,MATH 10B,B01,083739,Staff,16,0,30,14
1650403262605,MATH 10B,B02,083740,Staff,28,0,30,2
1650403268629,MATH 18,A01,083743,Staff,2,0,30,28
1650403268629,MATH 18,A02,083744,Staff,27,0,30,3
1650403268629,MATH 18,A03,083745,Staff,22,0,30,8
1650403268629,MATH 18,A04,083746,Staff,27,0,30,3
1650403268629,MATH 18,B01,083748,Staff,0,11,30,30
1650403268629,MATH 18,B02,083749,Staff,0,12,30,30
1650403268629,MATH 18,B03,083750,Staff,0,11,30,30
1650403268629,MATH 18,B04,083751,Staff,0,9,30,30
1650403274652,MATH 20A,A01,083754,Staff,26,0,40,14
1650403280679,MATH 20B,A01,083756,Staff,0,9,30,30
1650403280679,MATH 20B,A02,083757,Staff,0,8,30,30
1650403286708,MATH 20C,A01,083760,Staff,0,14,30,30
1650403286708,MATH 20C,A02,083761,Staff,1,15,30,29
1650403286708,MATH 20C,B01,083762,Staff,13,0,30,17
1650403286708,MATH 20C,B02,083763,Staff,28,0,30,2
1650403292734,MATH 20D,A01,083765,Staff,0,1,30,30
1650403292734,MATH 20D,A02,083766,Staff,7,0,30,23
1650403292734,MATH 20D,A03,083767,Staff,26,0,30,4
1650403298758,MATH 20E,A01,083771,Staff,5,0,30,25
1650403298758,MATH 20E,A02,083772,Staff,19,0,30,11
1650403298758,MATH 20E,B01,083773,Staff,0,0,30,30
1650403298758,MATH 20E,B02,083774,Staff,12,0,30,18
1650403304790,MATH 103A,A01,083777,Staff,0,11,30,30
1650403304790,MATH 103A,A02,083778,Staff,0,12,30,30
1650403304790,MATH 103A,B01,083779,Staff,0,13,30,30
1650403304790,MATH 103A,B02,083780,Staff,0,11,30,30
1650403310817,MATH 105,A01,085443,Staff,0,22,30,30
1650403316853,MATH 109,A01,083213,Anzaldo; Leesa B,0,7,30,30
1650403316853,MATH 109,A02,083214,Anzaldo; Leesa B,0,7,30,30
1650403316853,MATH 109,B01,083215,Anzaldo; Leesa B,0,5,30,30
1650403316853,MATH 109,B02,083216,Anzaldo; Leesa B,0,5,30,30
1650403322877,MATH 142A,A01,083219,Chow; Bennett,0,14,30,30
1650403322877,MATH 142A,A02,083220,Chow; Bennett,0,13,30,30
1650403322877,MATH 142A,B01,083221,Chow; Bennett,0,12,30,30
1650403322877,MATH 142A,B02,083222,Chow; Bennett,0,12,30,30
1650403328905,MATH 193A,A01,083224,Staff,0,5,30,30
1650403328905,MATH 193A,A02,083225,Staff,0,5,30,30
1650403328905,MATH 193A,A03,083781,Staff,0,4,30,30
1650403328905,MATH 193A,A04,083782,Staff,0,4,30,30
1650403334927,MATH 197,001,091859,McAuley; Julian John,9998,0,9999,1
1650403340989,COGS 9,A01,083615,Staff,0,14,60,60
1650403347017,COGS 11,A01,083617,Boyle; Mary E. T.,22,0,40,18
1650403353040,COGS 13,A01,083071,Staff,0,33,40,40
1650403359064,COGS 14A,A01,092681,Staff,0,23,100,100
1650403365090,COGS 14B,A01,083073,Cheng; Tzu-Han,0,10,50,50
1650403371123,COGS 17,A01,092677,Staff,24,0,75,51
1650403377150,COGS 100,A01,083619,Staff,0,26,60,60
1650403383183,COGS 101A,A01,083621,Davis; Joshua Daniel,0,21,60,60
1650403389207,COGS 101B,A01,091572,Staff,0,4,60,60
1650403395231,COGS 101C,A01,083625,Delgado; Tania,16,0,30,14
1650403401261,COGS 107A,A01,083627,Boyle; Mary E. T.,0,10,60,60
1650403407293,COGS 118A,A01,083075,Staff,4,0,60,56
1650403413320,CSE 3,A50,083646,Miranda; Gregory Joseph,21,0,38,17
1650403413320,CSE 3,A51,083647,Miranda; Gregory Joseph,37,0,37,0
1650403419344,CSE 8A,A50,083650,Miranda; Gregory Joseph,0,28,40,40
1650403425368,CSE 11,A01,083080,Cao; Yingjun,0,91,40,40
1650403431391,CSE 12,A01,083652,Staff,0,15,100,100
1650403437417,CSE 15L,A01,083654,Staff,0,1,50,50
1650403437417,CSE 15L,A02,083655,Staff,2,0,50,48
1650403443441,CSE 20,A01,083657,Staff,51,0,80,29
1650403449463,CSE 30,A01,083084,Eldon; John,0,76,40,40
1650403455487,CSE 100,A01,083659,Cao; Yingjun,0,66,50,50
1650403461527,CSE 134B,A01,083661,Powell; Thomas Allan,1,31,65,64
1650403467550,CSE 140,A01,083663,Staff,0,1,75,75
1650403473572,CSE 140L,A01,083088,Eldon; John,0,7,75,75
1650403479598,CSE 175,A01,083665,Kumar; Rakesh,7,0,25,18
1650403485619,CSE 190,A00,092507,Dubnov; Shlomo,14,0,20,6
1650403491645,ECE 45,A01,083139,Staff,0,17,40,40
1650403497674,ECE 65,A50,083695,Staff,0,5,30,30
1650403503702,ECE 109,A01,091882,Touri; Behrouz,39,0,70,31
1650403509724,ECE 180,A00,083140,Abi Samra; Nicholas Camill,24,0,30,6
1650403509724,ECE 180,B00,083141,Abi Samra; Nicholas Camill,1,0,30,29
1650403515791,MATH 10A,A01,083735,Patchell; Gregory David,7,0,30,23
1650403515791,MATH 10A,A02,083736,Patchell; Gregory David,28,0,30,2
1650403515791,MATH 10A,A03,083737,Patchell; Gregory David,25,0,30,5
1650403521817,MATH 10B,A01,083207,Staff,0,7,30,30
1650403521817,MATH 10B,A02,083208,Staff,0,7,30,30
1650403521817,MATH 10B,B01,083739,Staff,16,0,30,14
1650403521817,MATH 10B,B02,083740,Staff,28,0,30,2
1650403527843,MATH 18,A01,083743,Staff,2,0,30,28
1650403527843,MATH 18,A02,083744,Staff,27,0,30,3
1650403527843,MATH 18,A03,083745,Staff,22,0,30,8
1650403527843,MATH 18,A04,083746,Staff,27,0,30,3
1650403527843,MATH 18,B01,083748,Staff,0,11,30,30
1650403527843,MATH 18,B02,083749,Staff,0,12,30,30
1650403527843,MATH 18,B03,083750,Staff,0,11,30,30
1650403527843,MATH 18,B04,083751,Staff,0,9,30,30
1650403533867,MATH 20A,A01,083754,Staff,26,0,40,14
1650403539892,MATH 20B,A01,083756,Staff,0,9,30,30
1650403539892,MATH 20B,A02,083757,Staff,0,8,30,30
1650403545918,MATH 20C,A01,083760,Staff,0,14,30,30
1650403545918,MATH 20C,A02,083761,Staff,1,15,30,29
1650403545918,MATH 20C,B01,083762,Staff,13,0,30,17
1650403545918,MATH 20C,B02,083763,Staff,28,0,30,2
1650403551943,MATH 20D,A01,083765,Staff,0,1,30,30
1650403551943,MATH 20D,A02,083766,Staff,7,0,30,23
1650403551943,MATH 20D,A03,083767,Staff,26,0,30,4
1650403557977,MATH 20E,A01,083771,Staff,5,0,30,25
1650403557977,MATH 20E,A02,083772,Staff,19,0,30,11
1650403557977,MATH 20E,B01,083773,Staff,0,0,30,30
1650403557977,MATH 20E,B02,083774,Staff,12,0,30,18
1650403564008,MATH 103A,A01,083777,Staff,0,11,30,30
1650403564008,MATH 103A,A02,083778,Staff,0,12,30,30
1650403564008,MATH 103A,B01,083779,Staff,0,13,30,30
1650403564008,MATH 103A,B02,083780,Staff,0,11,30,30
1650403570031,MATH 105,A01,085443,Staff,0,22,30,30
1650403576065,MATH 109,A01,083213,Anzaldo; Leesa B,0,7,30,30
1650403576065,MATH 109,A02,083214,Anzaldo; Leesa B,0,7,30,30
1650403576065,MATH 109,B01,083215,Anzaldo; Leesa B,0,5,30,30
1650403576065,MATH 109,B02,083216,Anzaldo; Leesa B,0,5,30,30
1650403582102,MATH 142A,A01,083219,Chow; Bennett,0,14,30,30
1650403582102,MATH 142A,A02,083220,Chow; Bennett,0,13,30,30
1650403582102,MATH 142A,B01,083221,Chow; Bennett,0,12,30,30
1650403582102,MATH 142A,B02,083222,Chow; Bennett,0,12,30,30
1650403588126,MATH 193A,A01,083224,Staff,0,5,30,30
1650403588126,MATH 193A,A02,083225,Staff,0,5,30,30
1650403588126,MATH 193A,A03,083781,Staff,0,4,30,30
1650403588126,MATH 193A,A04,083782,Staff,0,4,30,30
1650403594154,MATH 197,001,091859,McAuley; Julian John,9998,0,9999,1
1650403600232,COGS 9,A01,083615,Staff,0,14,60,60
1650403606260,COGS 11,A01,083617,Boyle; Mary E. T.,22,0,40,18
1650403612285,COGS 13,A01,083071,Staff,0,33,40,40
1650403618311,COGS 14A,A01,092681,Staff,0,23,100,100
1650403624336,COGS 14B,A01,083073,Cheng; Tzu-Han,0,10,50,50
1650403630359,COGS 17,A01,092677,Staff,24,0,75,51
1650403636385,COGS 100,A01,083619,Staff,0,26,60,60
1650403642408,COGS 101A,A01,083621,Davis; Joshua Daniel,0,21,60,60
1650403648443,COGS 101B,A01,091572,Staff,0,3,60,60
1650403654483,COGS 101C,A01,083625,Delgado; Tania,15,0,30,15
1650403660511,COGS 107A,A01,083627,Boyle; Mary E. T.,0,10,60,60
1650403666542,COGS 118A,A01,083075,Staff,4,0,60,56
1650403672577,CSE 3,A50,083646,Miranda; Gregory Joseph,21,0,38,17
1650403672577,CSE 3,A51,083647,Miranda; Gregory Joseph,37,0,37,0
1650403678604,CSE 8A,A50,083650,Miranda; Gregory Joseph,0,28,40,40
1650403684628,CSE 11,A01,083080,Cao; Yingjun,0,91,40,40
1650403690653,CSE 12,A01,083652,Staff,0,15,100,100
1650403696677,CSE 15L,A01,083654,Staff,0,1,50,50
1650403696677,CSE 15L,A02,083655,Staff,2,0,50,48
1650403702713,CSE 20,A01,083657,Staff,51,0,80,29
1650403708741,CSE 30,A01,083084,Eldon; John,0,76,40,40
1650403714768,CSE 100,A01,083659,Cao; Yingjun,0,66,50,50
1650403720799,CSE 134B,A01,083661,Powell; Thomas Allan,1,31,65,64
1650403726826,CSE 140,A01,083663,Staff,0,1,75,75
1650403732850,CSE 140L,A01,083088,Eldon; John,0,7,75,75
1650403738877,CSE 175,A01,083665,Kumar; Rakesh,7,0,25,18
1650403744903,CSE 190,A00,092507,Dubnov; Shlomo,14,0,20,6
1650403750936,ECE 45,A01,083139,Staff,0,17,40,40
1650403756961,ECE 65,A50,083695,Staff,0,5,30,30
1650403762987,ECE 109,A01,091882,Touri; Behrouz,39,0,70,31
1650403769011,ECE 180,A00,083140,Abi Samra; Nicholas Camill,24,0,30,6
1650403769011,ECE 180,B00,083141,Abi Samra; Nicholas Camill,1,0,30,29
1650403775034,MATH 10A,A01,083735,Patchell; Gregory David,7,0,30,23
1650403775034,MATH 10A,A02,083736,Patchell; Gregory David,28,0,30,2
1650403775034,MATH 10A,A03,083737,Patchell; Gregory David,25,0,30,5
1650403781061,MATH 10B,A01,083207,Staff,0,7,30,30
1650403781061,MATH 10B,A02,083208,Staff,0,7,30,30
1650403781061,MATH 10B,B01,083739,Staff,16,0,30,14
1650403781061,MATH 10B,B02,083740,Staff,28,0,30,2
1650403787086,MATH 18,A01,083743,Staff,2,0,30,28
1650403787086,MATH 18,A02,083744,Staff,27,0,30,3
1650403787086,MATH 18,A03,083745,Staff,22,0,30,8
1650403787086,MATH 18,A04,083746,Staff,27,0,30,3
1650403787086,MATH 18,B01,083748,Staff,0,11,30,30
1650403787086,MATH 18,B02,083749,Staff,0,12,30,30
1650403787086,MATH 18,B03,083750,Staff,0,11,30,30
1650403787086,MATH 18,B04,083751,Staff,0,9,30,30
1650403793109,MATH 20A,A01,083754,Staff,26,0,40,14
1650403799134,MATH 20B,A01,083756,Staff,0,9,30,30
1650403799134,MATH 20B,A02,083757,Staff,0,8,30,30
1650403805275,MATH 20C,A01,083760,Staff,0,14,30,30
1650403805275,MATH 20C,A02,083761,Staff,1,15,30,29
1650403805275,MATH 20C,B01,083762,Staff,13,0,30,17
1650403805275,MATH 20C,B02,083763,Staff,28,0,30,2
1650403811303,MATH 20D,A01,083765,Staff,0,1,30,30
1650403811303,MATH 20D,A02,083766,Staff,7,0,30,23
1650403811303,MATH 20D,A03,083767,Staff,26,0,30,4
1650403817326,MATH 20E,A01,083771,Staff,5,0,30,25
1650403817326,MATH 20E,A02,083772,Staff,19,0,30,11
1650403817326,MATH 20E,B01,083773,Staff,0,0,30,30
1650403817326,MATH 20E,B02,083774,Staff,12,0,30,18
1650403823351,MATH 103A,A01,083777,Staff,0,11,30,30
1650403823351,MATH 103A,A02,083778,Staff,0,12,30,30
1650403823351,MATH 103A,B01,083779,Staff,0,13,30,30
1650403823351,MATH 103A,B02,083780,Staff,0,11,30,30
1650403829387,MATH 105,A01,085443,Staff,0,22,30,30
1650403835424,MATH 109,A01,083213,Anzaldo; Leesa B,0,7,30,30
1650403835424,MATH 109,A02,083214,Anzaldo; Leesa B,0,7,30,30
1650403835424,MATH 109,B01,083215,Anzaldo; Leesa B,0,5,30,30
1650403835424,MATH 109,B02,083216,Anzaldo; Leesa B,0,5,30,30
1650403841457,MATH 142A,A01,083219,Chow; Bennett,0,14,30,30
1650403841457,MATH 142A,A02,083220,Chow; Bennett,0,13,30,30
1650403841457,MATH 142A,B01,083221,Chow; Bennett,0,12,30,30
1650403841457,MATH 142A,B02,083222,Chow; Bennett,0,13,30,30
1650403847570,MATH 193A,A01,083224,Staff,0,5,30,30
1650403847570,MATH 193A,A02,083225,Staff,0,5,30,30
1650403847570,MATH 193A,A03,083781,Staff,0,4,30,30
1650403847570,MATH 193A,A04,083782,Staff,0,4,30,30
1650403853609,MATH 197,001,091859,McAuley; Julian John,9998,0,9999,1
1650403859681,COGS 9,A01,083615,Staff,0,14,60,60
1650403865705,COGS 11,A01,083617,Boyle; Mary E. T.,22,0,40,18
1650403871727,COGS 13,A01,083071,Staff,0,33,40,40
1650403877754,COGS 14A,A01,092681,Staff,0,23,100,100
1650403883788,COGS 14B,A01,083073,Cheng; Tzu-Han,0,10,50,50
1650403889816,COGS 17,A01,092677,Staff,24,0,75,51
1650403895855,COGS 100,A01,083619,Staff,0,26,60,60
1650403901885,COGS 101A,A01,083621,Davis; Joshua Daniel,0,21,60,60
1650403907917,COGS 101B,A01,091572,Staff,0,4,60,60
1650403913944,COGS 101C,A01,083625,Delgado; Tania,15,0,30,15
1650403919988,COGS 107A,A01,083627,Boyle; Mary E. T.,0,10,60,60
1650403926010,COGS 118A,A01,083075,Staff,4,0,60,56
1650403932050,CSE 3,A50,083646,Miranda; Gregory Joseph,21,0,38,17
1650403932050,CSE 3,A51,083647,Miranda; Gregory Joseph,37,0,37,0
1650403938078,CSE 8A,A50,083650,Miranda; Gregory Joseph,0,28,40,40
1650403944099,CSE 11,A01,083080,Cao; Yingjun,0,91,40,40
1650403950121,CSE 12,A01,083652,Staff,0,15,100,100
1650403956148,CSE 15L,A01,083654,Staff,0,1,50,50
1650403956148,CSE 15L,A02,083655,Staff,2,0,50,48
1650403962177,CSE 20,A01,083657,Staff,51,0,80,29
1650403968199,CSE 30,A01,083084,Eldon; John,0,76,40,40
1650403985055,CSE 100,A01,083659,Cao; Yingjun,0,66,50,50
1650403991081,CSE 134B,A01,083661,Powell; Thomas Allan,1,31,65,64
1650403997103,CSE 140,A01,083663,Staff,0,1,75,75
1650404003133,CSE 140L,A01,083088,Eldon; John,0,7,75,75
1650404009157,CSE 175,A01,083665,Kumar; Rakesh,7,0,25,18
1650404015182,CSE 190,A00,092507,Dubnov; Shlomo,14,0,20,6
1650404021221,ECE 45,A01,083139,Staff,0,17,40,40
1650404027247,ECE 65,A50,083695,Staff,0,5,30,30
1650404033284,ECE 109,A01,091882,Touri; Behrouz,39,0,70,31
1650404039306,ECE 180,A00,083140,Abi Samra; Nicholas Camill,24,0,30,6
1650404039306,ECE 180,B00,083141,Abi Samra; Nicholas Camill,1,0,30,29
1650404045332,MATH 10A,A01,083735,Patchell; Gregory David,7,0,30,23
1650404045332,MATH 10A,A02,083736,Patchell; Gregory David,28,0,30,2
1650404045332,MATH 10A,A03,083737,Patchell; Gregory David,25,0,30,5
1650404051354,MATH 10B,A01,083207,Staff,0,7,30,30
1650404051354,MATH 10B,A02,083208,Staff,0,7,30,30
1650404051354,MATH 10B,B01,083739,Staff,16,0,30,14
1650404051354,MATH 10B,B02,083740,Staff,28,0,30,2
1650404057377,MATH 18,A01,083743,Staff,2,0,30,28
1650404057377,MATH 18,A02,083744,Staff,27,0,30,3
1650404057377,MATH 18,A03,083745,Staff,22,0,30,8
1650404057377,MATH 18,A04,083746,Staff,27,0,30,3
1650404057377,MATH 18,B01,083748,Staff,0,11,30,30
1650404057377,MATH 18,B02,083749,Staff,0,12,30,30
1650404057377,MATH 18,B03,083750,Staff,0,11,30,30
1650404057377,MATH 18,B04,083751,Staff,0,9,30,30
1650404063399,MATH 20A,A01,083754,Staff,26,0,40,14
1650404069432,MATH 20B,A01,083756,Staff,0,9,30,30
1650404069432,MATH 20B,A02,083757,Staff,0,8,30,30
1650404075456,MATH 20C,A01,083760,Staff,0,14,30,30
1650404075456,MATH 20C,A02,083761,Staff,1,15,30,29
1650404075456,MATH 20C,B01,083762,Staff,13,0,30,17
1650404075456,MATH 20C,B02,083763,Staff,28,0,30,2
1650404081498,MATH 20D,A01,083765,Staff,0,1,30,30
1650404081498,MATH 20D,A02,083766,Staff,7,0,30,23
1650404081498,MATH 20D,A03,083767,Staff,26,0,30,4
1650404087527,MATH 20E,A01,083771,Staff,5,0,30,25
1650404087527,MATH 20E,A02,083772,Staff,19,0,30,11
1650404087527,MATH 20E,B01,083773,Staff,0,0,30,30
1650404087527,MATH 20E,B02,083774,Staff,12,0,30,18
1650404093560,MATH 103A,A01,083777,Staff,0,11,30,30
1650404093560,MATH 103A,A02,083778,Staff,0,12,30,30
1650404093560,MATH 103A,B01,083779,Staff,0,13,30,30
1650404093560,MATH 103A,B02,083780,Staff,0,11,30,30
1650404099593,MATH 105,A01,085443,Staff,0,22,30,30
1650404105622,MATH 109,A01,083213,Anzaldo; Leesa B,0,7,30,30
1650404105622,MATH 109,A02,083214,Anzaldo; Leesa B,0,7,30,30
1650404105622,MATH 109,B01,083215,Anzaldo; Leesa B,0,5,30,30
1650404105622,MATH 109,B02,083216,Anzaldo; Leesa B,0,5,30,30
1650404111650,MATH 142A,A01,083219,Chow; Bennett,0,14,30,30
1650404111650,MATH 142A,A02,083220,Chow; Bennett,0,13,30,30
1650404111650,MATH 142A,B01,083221,Chow; Bennett,0,12,30,30
1650404111650,MATH 142A,B02,083222,Chow; Bennett,0,13,30,30
1650404117678,MATH 193A,A01,083224,Staff,0,5,30,30
1650404117678,MATH 193A,A02,083225,Staff,0,5,30,30
1650404117678,MATH 193A,A03,083781,Staff,0,4,30,30
1650404117678,MATH 193A,A04,083782,Staff,0,4,30,30
1650404123718,MATH 197,001,091859,McAuley; Julian John,9998,0,9999,1
1650404129789,COGS 9,A01,083615,Staff,0,14,60,60
1650404135819,COGS 11,A01,083617,Boyle; Mary E. T.,22,0,40,18
1650404141844,COGS 13,A01,083071,Staff,0,33,40,40
1650404147876,COGS 14A,A01,092681,Staff,0,23,100,100
1650404153899,COGS 14B,A01,083073,Cheng; Tzu-Han,0,10,50,50
1650404159921,COGS 17,A01,092677,Staff,24,0,75,51
1650404165952,COGS 100,A01,083619,Staff,0,26,60,60
1650404171982,COGS 101A,A01,083621,Davis; Joshua Daniel,0,21,60,60
1650404178008,COGS 101B,A01,091572,Staff,0,4,60,60
1650404184036,COGS 101C,A01,083625,Delgado; Tania,15,0,30,15
1650404190061,COGS 107A,A01,083627,Boyle; Mary E. T.,0,10,60,60
1650404196085,COGS 118A,A01,083075,Staff,4,0,60,56
1650404202114,CSE 3,A50,083646,Miranda; Gregory Joseph,21,0,38,17
1650404202114,CSE 3,A51,083647,Miranda; Gregory Joseph,37,0,37,0
1650404208137,CSE 8A,A50,083650,Miranda; Gregory Joseph,0,28,40,40
1650404214165,CSE 11,A01,083080,Cao; Yingjun,0,91,40,40
1650404220193,CSE 12,A01,083652,Staff,0,15,100,100
1650404226217,CSE 15L,A01,083654,Staff,0,1,50,50
1650404226217,CSE 15L,A02,083655,Staff,2,0,50,48
1650404232249,CSE 20,A01,083657,Staff,51,0,80,29
1650404238294,CSE 30,A01,083084,Eldon; John,0,76,40,40
1650404244326,CSE 100,A01,083659,Cao; Yingjun,0,66,50,50
1650404250364,CSE 134B,A01,083661,Powell; Thomas Allan,1,31,65,64
1650404256390,CSE 140,A01,083663,Staff,0,1,75,75
1650404262414,CSE 140L,A01,083088,Eldon; John,0,7,75,75
1650404268440,CSE 175,A01,083665,Kumar; Rakesh,7,0,25,18
1650404274464,CSE 190,A00,092507,Dubnov; Shlomo,14,0,20,6
1650404280494,ECE 45,A01,083139,Staff,0,17,40,40
1650404286534,ECE 65,A50,083695,Staff,0,5,30,30
1650404292559,ECE 109,A01,091882,Touri; Behrouz,39,0,70,31
1650404298580,ECE 180,A00,083140,Abi Samra; Nicholas Camill,24,0,30,6
1650404298580,ECE 180,B00,083141,Abi Samra; Nicholas Camill,1,0,30,29
1650404304623,MATH 10A,A01,083735,Patchell; Gregory David,7,0,30,23
1650404304623,MATH 10A,A02,083736,Patchell; Gregory David,28,0,30,2
1650404304623,MATH 10A,A03,083737,Patchell; Gregory David,25,0,30,5
1650404310650,MATH 10B,A01,083207,Staff,0,7,30,30
1650404310650,MATH 10B,A02,083208,Staff,0,7,30,30
1650404310650,MATH 10B,B01,083739,Staff,16,0,30,14
1650404310650,MATH 10B,B02,083740,Staff,28,0,30,2
1650404316681,MATH 18,A01,083743,Staff,2,0,30,28
1650404316681,MATH 18,A02,083744,Staff,27,0,30,3
1650404316681,MATH 18,A03,083745,Staff,22,0,30,8
1650404316681,MATH 18,A04,083746,Staff,27,0,30,3
1650404316681,MATH 18,B01,083748,Staff,0,11,30,30
1650404316681,MATH 18,B02,083749,Staff,0,12,30,30
1650404316681,MATH 18,B03,083750,Staff,0,11,30,30
1650404316681,MATH 18,B04,083751,Staff,0,9,30,30
1650404322705,MATH 20A,A01,083754,Staff,26,0,40,14
1650404328731,MATH 20B,A01,083756,Staff,0,9,30,30
1650404328731,MATH 20B,A02,083757,Staff,0,8,30,30
1650404334755,MATH 20C,A01,083760,Staff,0,14,30,30
1650404334755,MATH 20C,A02,083761,Staff,1,15,30,29
1650404334755,MATH 20C,B01,083762,Staff,13,0,30,17
1650404334755,MATH 20C,B02,083763,Staff,28,0,30,2
1650404340782,MATH 20D,A01,083765,Staff,0,1,30,30
1650404340782,MATH 20D,A02,083766,Staff,7,0,30,23
1650404340782,MATH 20D,A03,083767,Staff,26,0,30,4
1650404346805,MATH 20E,A01,083771,Staff,5,0,30,25
1650404346805,MATH 20E,A02,083772,Staff,19,0,30,11
1650404346805,MATH 20E,B01,083773,Staff,0,0,30,30
1650404346805,MATH 20E,B02,083774,Staff,12,0,30,18
1650404352829,MATH 103A,A01,083777,Staff,0,11,30,30
1650404352829,MATH 103A,A02,083778,Staff,0,12,30,30
1650404352829,MATH 103A,B01,083779,Staff,0,13,30,30
1650404352829,MATH 103A,B02,083780,Staff,0,11,30,30
1650404358855,MATH 105,A01,085443,Staff,0,22,30,30
1650404364878,MATH 109,A01,083213,Anzaldo; Leesa B,0,7,30,30
1650404364878,MATH 109,A02,083214,Anzaldo; Leesa B,0,7,30,30
1650404364878,MATH 109,B01,083215,Anzaldo; Leesa B,0,5,30,30
1650404364878,MATH 109,B02,083216,Anzaldo; Leesa B,0,5,30,30
1650404370905,MATH 142A,A01,083219,Chow; Bennett,0,14,30,30
1650404370905,MATH 142A,A02,083220,Chow; Bennett,0,13,30,30
1650404370905,MATH 142A,B01,083221,Chow; Bennett,0,12,30,30
1650404370905,MATH 142A,B02,083222,Chow; Bennett,0,13,30,30
1650404376929,MATH 193A,A01,083224,Staff,0,5,30,30
1650404376929,MATH 193A,A02,083225,Staff,0,5,30,30
1650404376929,MATH 193A,A03,083781,Staff,0,4,30,30
1650404376929,MATH 193A,A04,083782,Staff,0,4,30,30
1650404382952,MATH 197,001,091859,McAuley; Julian John,9998,0,9999,1
1650404389009,COGS 9,A01,083615,Staff,0,14,60,60
1650404395033,COGS 11,A01,083617,Boyle; Mary E. T.,22,0,40,18
1650404401072,COGS 13,A01,083071,Staff,0,33,40,40
1650404407106,COGS 14A,A01,092681,Staff,0,23,100,100
1650404413143,COGS 14B,A01,083073,Cheng; Tzu-Han,0,10,50,50
1650404419169,COGS 17,A01,092677,Staff,24,0,75,51
1650404425193,COGS 100,A01,083619,Staff,0,26,60,60
1650404431216,COGS 101A,A01,083621,Davis; Joshua Daniel,0,21,60,60
1650404437238,COGS 101B,A01,091572,Staff,0,4,60,60
1650404443266,COGS 101C,A01,083625,Delgado; Tania,15,0,30,15
1650404449395,COGS 107A,A01,083627,Boyle; Mary E. T.,0,10,60,60
1650404455417,COGS 118A,A01,083075,Staff,4,0,60,56
1650404461447,CSE 3,A50,083646,Miranda; Gregory Joseph,21,0,38,17
1650404461447,CSE 3,A51,083647,Miranda; Gregory Joseph,37,0,37,0
1650404467470,CSE 8A,A50,083650,Miranda; Gregory Joseph,0,28,40,40
1650404473493,CSE 11,A01,083080,Cao; Yingjun,0,91,40,40
1650404479517,CSE 12,A01,083652,Staff,0,15,100,100
1650404485541,CSE 15L,A01,083654,Staff,0,1,50,50
1650404485541,CSE 15L,A02,083655,Staff,2,0,50,48
1650404491569,CSE 20,A01,083657,Staff,51,0,80,29
1650404497594,CSE 30,A01,083084,Eldon; John,0,76,40,40
1650404503621,CSE 100,A01,083659,Cao; Yingjun,0,66,50,50
1650404509645,CSE 134B,A01,083661,Powell; Thomas Allan,1,31,65,64
1650404515667,CSE 140,A01,083663,Staff,0,1,75,75
1650404521696,CSE 140L,A01,083088,Eldon; John,0,7,75,75
1650404527723,CSE 175,A01,083665,Kumar; Rakesh,7,0,25,18
1650404533749,CSE 190,A00,092507,Dubnov; Shlomo,14,0,20,6
1650404539773,ECE 45,A01,083139,Staff,0,17,40,40
1650404545800,ECE 65,A50,083695,Staff,0,5,30,30
1650404551823,ECE 109,A01,091882,Touri; Behrouz,39,0,70,31
1650404557859,ECE 180,A00,083140,Abi Samra; Nicholas Camill,24,0,30,6
1650404557859,ECE 180,B00,083141,Abi Samra; Nicholas Camill,1,0,30,29
1650404563883,MATH 10A,A01,083735,Patchell; Gregory David,7,0,30,23
1650404563883,MATH 10A,A02,083736,Patchell; Gregory David,28,0,30,2
1650404563883,MATH 10A,A03,083737,Patchell; Gregory David,25,0,30,5
1650404569909,MATH 10B,A01,083207,Staff,0,7,30,30
1650404569909,MATH 10B,A02,083208,Staff,0,7,30,30
1650404569909,MATH 10B,B01,083739,Staff,16,0,30,14
1650404569909,MATH 10B,B02,083740,Staff,28,0,30,2
1650404575947,MATH 18,A01,083743,Staff,2,0,30,28
1650404575947,MATH 18,A02,083744,Staff,27,0,30,3
1650404575947,MATH 18,A03,083745,Staff,22,0,30,8
1650404575947,MATH 18,A04,083746,Staff,27,0,30,3
1650404575947,MATH 18,B01,083748,Staff,0,11,30,30
1650404575947,MATH 18,B02,083749,Staff,0,12,30,30
1650404575947,MATH 18,B03,083750,Staff,0,11,30,30
1650404575947,MATH 18,B04,083751,Staff,0,9,30,30
1650404581971,MATH 20A,A01,083754,Staff,26,0,40,14
1650404587997,MATH 20B,A01,083756,Staff,0,9,30,30
1650404587997,MATH 20B,A02,083757,Staff,0,8,30,30
1650404594022,MATH 20C,A01,083760,Staff,0,14,30,30
1650404594022,MATH 20C,A02,083761,Staff,1,15,30,29
1650404594022,MATH 20C,B01,083762,Staff,13,0,30,17
1650404594022,MATH 20C,B02,083763,Staff,28,0,30,2
1650404600049,MATH 20D,A01,083765,Staff,0,1,30,30
1650404600049,MATH 20D,A02,083766,Staff,7,0,30,23
1650404600049,MATH 20D,A03,083767,Staff,26,0,30,4
1650404606080,MATH 20E,A01,083771,Staff,5,0,30,25
1650404606080,MATH 20E,A02,083772,Staff,19,0,30,11
1650404606080,MATH 20E,B01,083773,Staff,0,0,30,30
1650404606080,MATH 20E,B02,083774,Staff,12,0,30,18
1650404612114,MATH 103A,A01,083777,Staff,0,11,30,30
1650404612114,MATH 103A,A02,083778,Staff,0,12,30,30
1650404612114,MATH 103A,B01,083779,Staff,0,13,30,30
1650404612114,MATH 103A,B02,083780,Staff,0,11,30,30
1650404618141,MATH 105,A01,085443,Staff,0,22,30,30
1650404624164,MATH 109,A01,083213,Anzaldo; Leesa B,0,7,30,30
1650404624164,MATH 109,A02,083214,Anzaldo; Leesa B,0,7,30,30
1650404624164,MATH 109,B01,083215,Anzaldo; Leesa B,0,5,30,30
1650404624164,MATH 109,B02,083216,Anzaldo; Leesa B,0,5,30,30
1650404630192,MATH 142A,A01,083219,Chow; Bennett,0,14,30,30
1650404630192,MATH 142A,A02,083220,Chow; Bennett,0,13,30,30
1650404630192,MATH 142A,B01,083221,Chow; Bennett,0,12,30,30
1650404630192,MATH 142A,B02,083222,Chow; Bennett,0,12,30,30
1650404636215,MATH 193A,A01,083224,Staff,0,5,30,30
1650404636215,MATH 193A,A02,083225,Staff,0,5,30,30
1650404636215,MATH 193A,A03,083781,Staff,0,4,30,30
1650404636215,MATH 193A,A04,083782,Staff,0,4,30,30
1650404642241,MATH 197,001,091859,McAuley; Julian John,9998,0,9999,1
1650404648310,COGS 9,A01,083615,Staff,0,14,60,60
1650404654343,COGS 11,A01,083617,Boyle; Mary E. T.,22,0,40,18
1650404660365,COGS 13,A01,083071,Staff,0,33,40,40
1650404666388,COGS 14A,A01,092681,Staff,0,23,100,100
1650404672419,COGS 14B,A01,083073,Cheng; Tzu-Han,0,10,50,50
1650404678446,COGS 17,A01,092677,Staff,24,0,75,51
1650404684472,COGS 100,A01,083619,Staff,0,26,60,60
1650404690496,COGS 101A,A01,083621,Davis; Joshua Daniel,0,21,60,60
1650404696520,COGS 101B,A01,091572,Staff,0,4,60,60
1650404702552,COGS 101C,A01,083625,Delgado; Tania,15,0,30,15
1650404708574,COGS 107A,A01,083627,Boyle; Mary E. T.,0,10,60,60
1650404714605,COGS 118A,A01,083075,Staff,4,0,60,56
1650404720632,CSE 3,A50,083646,Miranda; Gregory Joseph,21,0,38,17
1650404720632,CSE 3,A51,083647,Miranda; Gregory Joseph,37,0,37,0
1650404726664,CSE 8A,A50,083650,Miranda; Gregory Joseph,0,28,40,40
1650404732691,CSE 11,A01,083080,Cao; Yingjun,0,91,40,40
1650404738718,CSE 12,A01,083652,Staff,0,15,100,100
1650404744752,CSE 15L,A01,083654,Staff,0,1,50,50
1650404744752,CSE 15L,A02,083655,Staff,2,0,50,48
1650404750781,CSE 20,A01,083657,Staff,51,0,80,29
1650404756806,CSE 30,A01,083084,Eldon; John,0,76,40,40
1650404762830,CSE 100,A01,083659,Cao; Yingjun,0,66,50,50
1650404768856,CSE 134B,A01,083661,Powell; Thomas Allan,1,31,65,64
1650404774882,CSE 140,A01,083663,Staff,0,1,75,75
1650404780911,CSE 140L,A01,083088,Eldon; John,0,7,75,75
1650404786939,CSE 175,A01,083665,Kumar; Rakesh,7,0,25,18
1650404792966,CSE 190,A00,092507,Dubnov; Shlomo,14,0,20,6
1650404798993,ECE 45,A01,083139,Staff,0,17,40,40
1650404805026,ECE 65,A50,083695,Staff,0,5,30,30
1650404811059,ECE 109,A01,091882,Touri; Behrouz,39,0,70,31
1650404817107,ECE 180,A00,083140,Abi Samra; Nicholas Camill,24,0,30,6
1650404817107,ECE 180,B00,083141,Abi Samra; Nicholas Camill,1,0,30,29
1650404823130,MATH 10A,A01,083735,Patchell; Gregory David,7,0,30,23
1650404823130,MATH 10A,A02,083736,Patchell; Gregory David,28,0,30,2
1650404823130,MATH 10A,A03,083737,Patchell; Gregory David,25,0,30,5
1650404829156,MATH 10B,A01,083207,Staff,0,7,30,30
1650404829156,MATH 10B,A02,083208,Staff,0,7,30,30
1650404829156,MATH 10B,B01,083739,Staff,16,0,30,14
1650404829156,MATH 10B,B02,083740,Staff,28,0,30,2
1650404835195,MATH 18,A01,083743,Staff,2,0,30,28
1650404835195,MATH 18,A02,083744,Staff,27,0,30,3
1650404835195,MATH 18,A03,083745,Staff,22,0,30,8
1650404835195,MATH 18,A04,083746,Staff,27,0,30,3
1650404835195,MATH 18,B01,083748,Staff,0,11,30,30
1650404835195,MATH 18,B02,083749,Staff,0,12,30,30
1650404835195,MATH 18,B03,083750,Staff,0,12,30,30
1650404835195,MATH 18,B04,083751,Staff,0,9,30,30
1650404841224,MATH 20A,A01,083754,Staff,26,0,40,14
1650404847247,MATH 20B,A01,083756,Staff,0,9,30,30
1650404847247,MATH 20B,A02,083757,Staff,0,8,30,30
1650404853271,MATH 20C,A01,083760,Staff,0,14,30,30
1650404853271,MATH 20C,A02,083761,Staff,1,15,30,29
1650404853271,MATH 20C,B01,083762,Staff,13,0,30,17
1650404853271,MATH 20C,B02,083763,Staff,28,0,30,2
1650404859296,MATH 20D,A01,083765,Staff,0,1,30,30
1650404859296,MATH 20D,A02,083766,Staff,7,0,30,23
1650404859296,MATH 20D,A03,083767,Staff,26,0,30,4
1650404865331,MATH 20E,A01,083771,Staff,5,0,30,25
1650404865331,MATH 20E,A02,083772,Staff,19,0,30,11
1650404865331,MATH 20E,B01,083773,Staff,0,0,30,30
1650404865331,MATH 20E,B02,083774,Staff,12,0,30,18
1650404871355,MATH 103A,A01,083777,Staff,0,11,30,30
1650404871355,MATH 103A,A02,083778,Staff,0,12,30,30
1650404871355,MATH 103A,B01,083779,Staff,0,13,30,30
1650404871355,MATH 103A,B02,083780,Staff,0,11,30,30
1650404877382,MATH 105,A01,085443,Staff,0,22,30,30
1650404883406,MATH 109,A01,083213,Anzaldo; Leesa B,0,7,30,30
1650404883406,MATH 109,A02,083214,Anzaldo; Leesa B,0,7,30,30
1650404883406,MATH 109,B01,083215,Anzaldo; Leesa B,0,5,30,30
1650404883406,MATH 109,B02,083216,Anzaldo; Leesa B,0,5,30,30
1650404889435,MATH 142A,A01,083219,Chow; Bennett,0,14,30,30
1650404889435,MATH 142A,A02,083220,Chow; Bennett,0,13,30,30
1650404889435,MATH 142A,B01,083221,Chow; Bennett,0,12,30,30
1650404889435,MATH 142A,B02,083222,Chow; Bennett,0,12,30,30
1650404895461,MATH 193A,A01,083224,Staff,0,5,30,30
1650404895461,MATH 193A,A02,083225,Staff,0,5,30,30
1650404895461,MATH 193A,A03,083781,Staff,0,4,30,30
1650404895461,MATH 193A,A04,083782,Staff,0,4,30,30
1650404901492,MATH 197,001,091859,McAuley; Julian John,9998,0,9999,1
1650404907563,COGS 9,A01,083615,Staff,0,14,60,60
1650404913584,COGS 11,A01,083617,Boyle; Mary E. T.,22,0,40,18
1650404919621,COGS 13,A01,083071,Staff,0,33,40,40
1650404925646,COGS 14A,A01,092681,Staff,0,23,100,100
1650404931687,COGS 14B,A01,083073,Cheng; Tzu-Han,0,10,50,50
1650404937713,COGS 17,A01,092677,Staff,24,0,75,51
1650404943739,COGS 100,A01,083619,Staff,0,26,60,60
1650404949765,COGS 101A,A01,083621,Davis; Joshua Daniel,0,21,60,60
1650404955791,COGS 101B,A01,091572,Staff,0,4,60,60
1650404961817,COGS 101C,A01,083625,Delgado; Tania,15,0,30,15
1650404967842,COGS 107A,A01,083627,Boyle; Mary E. T.,0,10,60,60
1650404973870,COGS 118A,A01,083075,Staff,4,0,60,56
1650404979896,CSE 3,A50,083646,Miranda; Gregory Joseph,21,0,38,17
1650404979896,CSE 3,A51,083647,Miranda; Gregory Joseph,37,0,37,0
1650404985919,CSE 8A,A50,083650,Miranda; Gregory Joseph,0,28,40,40
1650404991947,CSE 11,A01,083080,Cao; Yingjun,0,91,40,40
1650404997985,CSE 12,A01,083652,Staff,0,15,100,100
1650405004009,CSE 15L,A01,083654,Staff,0,1,50,50
1650405004009,CSE 15L,A02,083655,Staff,2,0,50,48
1650405010043,CSE 20,A01,083657,Staff,51,0,80,29
1650405016077,CSE 30,A01,083084,Eldon; John,0,76,40,40
1650405022110,CSE 100,A01,083659,Cao; Yingjun,0,66,50,50
1650405028158,CSE 134B,A01,083661,Powell; Thomas Allan,1,31,65,64
1650405034185,CSE 140,A01,083663,Staff,0,1,75,75
1650405040217,CSE 140L,A01,083088,Eldon; John,0,7,75,75
1650405046327,CSE 175,A01,083665,Kumar; Rakesh,7,0,25,18
1650405052354,CSE 190,A00,092507,Dubnov; Shlomo,14,0,20,6
1650405058380,ECE 45,A01,083139,Staff,0,17,40,40
1650405064412,ECE 65,A50,083695,Staff,0,5,30,30
1650405070436,ECE 109,A01,091882,Touri; Behrouz,39,0,70,31
1650405076468,ECE 180,A00,083140,Abi Samra; Nicholas Camill,24,0,30,6
1650405076468,ECE 180,B00,083141,Abi Samra; Nicholas Camill,1,0,30,29
1650405082502,MATH 10A,A01,083735,Patchell; Gregory David,7,0,30,23
1650405082502,MATH 10A,A02,083736,Patchell; Gregory David,28,0,30,2
1650405082502,MATH 10A,A03,083737,Patchell; Gregory David,25,0,30,5
1650405088526,MATH 10B,A01,083207,Staff,0,7,30,30
1650405088526,MATH 10B,A02,083208,Staff,0,7,30,30
1650405088526,MATH 10B,B01,083739,Staff,16,0,30,14
1650405088526,MATH 10B,B02,083740,Staff,28,0,30,2
1650405094571,MATH 18,A01,083743,Staff,2,0,30,28
1650405094571,MATH 18,A02,083744,Staff,27,0,30,3
1650405094571,MATH 18,A03,083745,Staff,22,0,30,8
1650405094571,MATH 18,A04,083746,Staff,27,0,30,3
1650405094571,MATH 18,B01,083748,Staff,0,11,30,30
1650405094571,MATH 18,B02,083749,Staff,0,12,30,30
1650405094571,MATH 18,B03,083750,Staff,0,12,30,30
1650405094571,MATH 18,B04,083751,Staff,0,9,30,30
1650405100598,MATH 20A,A01,083754,Staff,26,0,40,14
1650405106621,MATH 20B,A01,083756,Staff,0,9,30,30
1650405106621,MATH 20B,A02,083757,Staff,0,8,30,30
1650405112644,MATH 20C,A01,083760,Staff,0,14,30,30
1650405112644,MATH 20C,A02,083761,Staff,1,15,30,29
1650405112644,MATH 20C,B01,083762,Staff,13,0,30,17
1650405112644,MATH 20C,B02,083763,Staff,28,0,30,2
1650405118670,MATH 20D,A01,083765,Staff,0,1,30,30
1650405118670,MATH 20D,A02,083766,Staff,7,0,30,23
1650405118670,MATH 20D,A03,083767,Staff,26,0,30,4
1650405124693,MATH 20E,A01,083771,Staff,5,0,30,25
1650405124693,MATH 20E,A02,083772,Staff,19,0,30,11
1650405124693,MATH 20E,B01,083773,Staff,0,0,30,30
1650405124693,MATH 20E,B02,083774,Staff,12,0,30,18
1650405130733,MATH 103A,A01,083777,Staff,0,11,30,30
1650405130733,MATH 103A,A02,083778,Staff,0,12,30,30
1650405130733,MATH 103A,B01,083779,Staff,0,13,30,30
1650405130733,MATH 103A,B02,083780,Staff,0,11,30,30
1650405136766,MATH 105,A01,085443,Staff,0,22,30,30
1650405142791,MATH 109,A01,083213,Anzaldo; Leesa B,0,7,30,30
1650405142791,MATH 109,A02,083214,Anzaldo; Leesa B,0,7,30,30
1650405142791,MATH 109,B01,083215,Anzaldo; Leesa B,0,5,30,30
1650405142791,MATH 109,B02,083216,Anzaldo; Leesa B,0,5,30,30
1650405148814,MATH 142A,A01,083219,Chow; Bennett,0,14,30,30
1650405148814,MATH 142A,A02,083220,Chow; Bennett,0,13,30,30
1650405148814,MATH 142A,B01,083221,Chow; Bennett,0,12,30,30
1650405148814,MATH 142A,B02,083222,Chow; Bennett,0,12,30,30
1650405154843,MATH 193A,A01,083224,Staff,0,5,30,30
1650405154843,MATH 193A,A02,083225,Staff,0,5,30,30
1650405154843,MATH 193A,A03,083781,Staff,0,4,30,30
1650405154843,MATH 193A,A04,083782,Staff,0,4,30,30
1650405160869,MATH 197,001,091859,McAuley; Julian John,9998,0,9999,1
1650405166935,COGS 9,A01,083615,Staff,0,14,60,60
1650405172960,COGS 11,A01,083617,Boyle; Mary E. T.,22,0,40,18
1650405178982,COGS 13,A01,083071,Staff,0,33,40,40
1650405185005,COGS 14A,A01,092681,Staff,0,23,100,100
1650405191032,COGS 14B,A01,083073,Cheng; Tzu-Han,0,10,50,50
1650405197055,COGS 17,A01,092677,Staff,24,0,75,51
1650405203080,COGS 100,A01,083619,Staff,0,26,60,60
1650405209105,COGS 101A,A01,083621,Davis; Joshua Daniel,0,21,60,60
1650405215133,COGS 101B,A01,091572,Staff,0,4,60,60
1650405221157,COGS 101C,A01,083625,Delgado; Tania,15,0,30,15
1650405227184,COGS 107A,A01,083627,Boyle; Mary E. T.,0,10,60,60
1650405233212,COGS 118A,A01,083075,Staff,4,0,60,56
1650405239236,CSE 3,A50,083646,Miranda; Gregory Joseph,21,0,38,17
1650405239236,CSE 3,A51,083647,Miranda; Gregory Joseph,37,0,37,0
1650405245268,CSE 8A,A50,083650,Miranda; Gregory Joseph,0,28,40,40
1650405251292,CSE 11,A01,083080,Cao; Yingjun,0,91,40,40
1650405257318,CSE 12,A01,083652,Staff,0,15,100,100
1650405263343,CSE 15L,A01,083654,Staff,0,1,50,50
1650405263343,CSE 15L,A02,083655,Staff,2,0,50,48
1650405269369,CSE 20,A01,083657,Staff,51,0,80,29
1650405275393,CSE 30,A01,083084,Eldon; John,0,76,40,40
1650405281417,CSE 100,A01,083659,Cao; Yingjun,0,66,50,50
1650405287440,CSE 134B,A01,083661,Powell; Thomas Allan,1,31,65,64
1650405293463,CSE 140,A01,083663,Staff,0,1,75,75
1650405299486,CSE 140L,A01,083088,Eldon; John,0,7,75,75
1650405305511,CSE 175,A01,083665,Kumar; Rakesh,7,0,25,18
1650405311536,CSE 190,A00,092507,Dubnov; Shlomo,14,0,20,6
1650405317563,ECE 45,A01,083139,Staff,0,17,40,40
1650405323603,ECE 65,A50,083695,Staff,0,5,30,30
1650405329628,ECE 109,A01,091882,Touri; Behrouz,39,0,70,31
1650405335655,ECE 180,A00,083140,Abi Samra; Nicholas Camill,24,0,30,6
1650405335655,ECE 180,B00,083141,Abi Samra; Nicholas Camill,1,0,30,29
1650405341683,MATH 10A,A01,083735,Patchell; Gregory David,7,0,30,23
1650405341683,MATH 10A,A02,083736,Patchell; Gregory David,28,0,30,2
1650405341683,MATH 10A,A03,083737,Patchell; Gregory David,25,0,30,5
1650405347707,MATH 10B,A01,083207,Staff,0,7,30,30
1650405347707,MATH 10B,A02,083208,Staff,0,7,30,30
1650405347707,MATH 10B,B01,083739,Staff,16,0,30,14
1650405347707,MATH 10B,B02,083740,Staff,28,0,30,2
1650405353735,MATH 18,A01,083743,Staff,2,0,30,28
1650405353735,MATH 18,A02,083744,Staff,27,0,30,3
1650405353735,MATH 18,A03,083745,Staff,22,0,30,8
1650405353735,MATH 18,A04,083746,Staff,27,0,30,3
1650405353735,MATH 18,B01,083748,Staff,0,11,30,30
1650405353735,MATH 18,B02,083749,Staff,0,12,30,30
1650405353735,MATH 18,B03,083750,Staff,0,12,30,30
1650405353735,MATH 18,B04,083751,Staff,0,9,30,30
1650405359767,MATH 20A,A01,083754,Staff,26,0,40,14
1650405365794,MATH 20B,A01,083756,Staff,0,9,30,30
1650405365794,MATH 20B,A02,083757,Staff,0,8,30,30
1650405371823,MATH 20C,A01,083760,Staff,0,14,30,30
1650405371823,MATH 20C,A02,083761,Staff,1,15,30,29
1650405371823,MATH 20C,B01,083762,Staff,13,0,30,17
1650405371823,MATH 20C,B02,083763,Staff,28,0,30,2
1650405377848,MATH 20D,A01,083765,Staff,0,1,30,30
1650405377848,MATH 20D,A02,083766,Staff,7,0,30,23
1650405377848,MATH 20D,A03,083767,Staff,26,0,30,4
1650405383875,MATH 20E,A01,083771,Staff,5,0,30,25
1650405383875,MATH 20E,A02,083772,Staff,19,0,30,11
1650405383875,MATH 20E,B01,083773,Staff,0,0,30,30
1650405383875,MATH 20E,B02,083774,Staff,12,0,30,18
1650405389904,MATH 103A,A01,083777,Staff,0,11,30,30
1650405389904,MATH 103A,A02,083778,Staff,0,12,30,30
1650405389904,MATH 103A,B01,083779,Staff,0,13,30,30
1650405389904,MATH 103A,B02,083780,Staff,0,11,30,30
1650405395933,MATH 105,A01,085443,Staff,0,22,30,30
1650405401973,MATH 109,A01,083213,Anzaldo; Leesa B,0,7,30,30
1650405401973,MATH 109,A02,083214,Anzaldo; Leesa B,0,7,30,30
1650405401973,MATH 109,B01,083215,Anzaldo; Leesa B,0,5,30,30
1650405401973,MATH 109,B02,083216,Anzaldo; Leesa B,0,5,30,30
1650405408001,MATH 142A,A01,083219,Chow; Bennett,0,14,30,30
1650405408001,MATH 142A,A02,083220,Chow; Bennett,0,13,30,30
1650405408001,MATH 142A,B01,083221,Chow; Bennett,0,12,30,30
1650405408001,MATH 142A,B02,083222,Chow; Bennett,0,12,30,30
1650405414024,MATH 193A,A01,083224,Staff,0,5,30,30
1650405414024,MATH 193A,A02,083225,Staff,0,5,30,30
1650405414024,MATH 193A,A03,083781,Staff,0,4,30,30
1650405414024,MATH 193A,A04,083782,Staff,0,4,30,30
1650405420050,MATH 197,001,091859,McAuley; Julian John,9998,0,9999,1
1650405426105,COGS 9,A01,083615,Staff,0,14,60,60
1650405432133,COGS 11,A01,083617,Boyle; Mary E. T.,22,0,40,18
1650405438173,COGS 13,A01,083071,Staff,0,33,40,40
1650405444201,COGS 14A,A01,092681,Staff,0,23,100,100
1650405450235,COGS 14B,A01,083073,Cheng; Tzu-Han,0,10,50,50
1650405456268,COGS 17,A01,092677,Staff,24,0,75,51
1650405462291,COGS 100,A01,083619,Staff,0,26,60,60
1650405468319,COGS 101A,A01,083621,Davis; Joshua Daniel,0,21,60,60
1650405474345,COGS 101B,A01,091572,Staff,0,4,60,60
1650405480386,COGS 101C,A01,083625,Delgado; Tania,15,0,30,15
1650405486423,COGS 107A,A01,083627,Boyle; Mary E. T.,0,10,60,60
1650405492449,COGS 118A,A01,083075,Staff,3,0,60,57
1650405498473,CSE 3,A50,083646,Miranda; Gregory Joseph,21,0,38,17
1650405498473,CSE 3,A51,083647,Miranda; Gregory Joseph,37,0,37,0
1650405504505,CSE 8A,A50,083650,Miranda; Gregory Joseph,0,28,40,40
1650405510545,CSE 11,A01,083080,Cao; Yingjun,0,91,40,40
1650405516578,CSE 12,A01,083652,Staff,0,15,100,100
1650405522604,CSE 15L,A01,083654,Staff,0,1,50,50
1650405522604,CSE 15L,A02,083655,Staff,2,0,50,48
1650405528626,CSE 20,A01,083657,Staff,51,0,80,29
1650405534650,CSE 30,A01,083084,Eldon; John,0,76,40,40
1650405540677,CSE 100,A01,083659,Cao; Yingjun,0,66,50,50
1650405546714,CSE 134B,A01,083661,Powell; Thomas Allan,1,31,65,64
1650405552743,CSE 140,A01,083663,Staff,0,1,75,75
1650405558765,CSE 140L,A01,083088,Eldon; John,0,7,75,75
1650405564789,CSE 175,A01,083665,Kumar; Rakesh,7,0,25,18
1650405570810,CSE 190,A00,092507,Dubnov; Shlomo,14,0,20,6
1650405576841,ECE 45,A01,083139,Staff,0,17,40,40
1650405582874,ECE 65,A50,083695,Staff,0,5,30,30
1650405588897,ECE 109,A01,091882,Touri; Behrouz,39,0,70,31
1650405594925,ECE 180,A00,083140,Abi Samra; Nicholas Camill,24,0,30,6
1650405594925,ECE 180,B00,083141,Abi Samra; Nicholas Camill,1,0,30,29
1650405600952,MATH 10A,A01,083735,Patchell; Gregory David,7,0,30,23
1650405600952,MATH 10A,A02,083736,Patchell; Gregory David,28,0,30,2
1650405600952,MATH 10A,A03,083737,Patchell; Gregory David,25,0,30,5
1650405606978,MATH 10B,A01,083207,Staff,0,7,30,30
1650405606978,MATH 10B,A02,083208,Staff,0,7,30,30
1650405606978,MATH 10B,B01,083739,Staff,16,0,30,14
1650405606978,MATH 10B,B02,083740,Staff,28,0,30,2
1650405613007,MATH 18,A01,083743,Staff,2,0,30,28
1650405613007,MATH 18,A02,083744,Staff,27,0,30,3
1650405613007,MATH 18,A03,083745,Staff,22,0,30,8
1650405613007,MATH 18,A04,083746,Staff,27,0,30,3
1650405613007,MATH 18,B01,083748,Staff,0,11,30,30
1650405613007,MATH 18,B02,083749,Staff,0,12,30,30
1650405613007,MATH 18,B03,083750,Staff,0,12,30,30
1650405613007,MATH 18,B04,083751,Staff,0,9,30,30
1650405619051,MATH 20A,A01,083754,Staff,26,0,40,14
1650405625078,MATH 20B,A01,083756,Staff,0,9,30,30
1650405625078,MATH 20B,A02,083757,Staff,0,8,30,30
1650405631101,MATH 20C,A01,083760,Staff,0,14,30,30
1650405631101,MATH 20C,A02,083761,Staff,1,15,30,29
1650405631101,MATH 20C,B01,083762,Staff,13,0,30,17
1650405631101,MATH 20C,B02,083763,Staff,28,0,30,2
1650405637132,MATH 20D,A01,083765,Staff,0,1,30,30
1650405637132,MATH 20D,A02,083766,Staff,7,0,30,23
1650405637132,MATH 20D,A03,083767,Staff,26,0,30,4
1650405643283,MATH 20E,A01,083771,Staff,5,0,30,25
1650405643283,MATH 20E,A02,083772,Staff,19,0,30,11
1650405643283,MATH 20E,B01,083773,Staff,0,0,30,30
1650405643283,MATH 20E,B02,083774,Staff,12,0,30,18
1650405649306,MATH 103A,A01,083777,Staff,0,11,30,30
1650405649306,MATH 103A,A02,083778,Staff,0,12,30,30
1650405649306,MATH 103A,B01,083779,Staff,0,13,30,30
1650405649306,MATH 103A,B02,083780,Staff,0,11,30,30
1650405655339,MATH 105,A01,085443,Staff,0,22,30,30
1650405661363,MATH 109,A01,083213,Anzaldo; Leesa B,0,7,30,30
1650405661363,MATH 109,A02,083214,Anzaldo; Leesa B,0,7,30,30
1650405661363,MATH 109,B01,083215,Anzaldo; Leesa B,0,5,30,30
1650405661363,MATH 109,B02,083216,Anzaldo; Leesa B,0,5,30,30
1650405667396,MATH 142A,A01,083219,Chow; Bennett,0,14,30,30
1650405667396,MATH 142A,A02,083220,Chow; Bennett,0,13,30,30
1650405667396,MATH 142A,B01,083221,Chow; Bennett,0,12,30,30
1650405667396,MATH 142A,B02,083222,Chow; Bennett,0,12,30,30
1650405673425,MATH 193A,A01,083224,Staff,0,5,30,30
1650405673425,MATH 193A,A02,083225,Staff,0,5,30,30
1650405673425,MATH 193A,A03,083781,Staff,0,4,30,30
1650405673425,MATH 193A,A04,083782,Staff,0,4,30,30
1650405679460,MATH 197,001,091859,McAuley; Julian John,9998,0,9999,1
1650405685525,COGS 9,A01,083615,Staff,0,14,60,60
1650405691552,COGS 11,A01,083617,Boyle; Mary E. T.,22,0,40,18
1650405697575,COGS 13,A01,083071,Staff,0,33,40,40
1650405703600,COGS 14A,A01,092681,Staff,0,23,100,100
1650405709634,COGS 14B,A01,083073,Cheng; Tzu-Han,0,10,50,50
1650405715660,COGS 17,A01,092677,Staff,24,0,75,51
1650405721684,COGS 100,A01,083619,Staff,0,26,60,60
1650405727712,COGS 101A,A01,083621,Davis; Joshua Daniel,0,21,60,60
1650405733746,COGS 101B,A01,091572,Staff,0,4,60,60
1650405739770,COGS 101C,A01,083625,Delgado; Tania,15,0,30,15
1650405745801,COGS 107A,A01,083627,Boyle; Mary E. T.,0,10,60,60
1650405751825,COGS 118A,A01,083075,Staff,3,0,60,57
1650405757852,CSE 3,A50,083646,Miranda; Gregory Joseph,21,0,38,17
1650405757852,CSE 3,A51,083647,Miranda; Gregory Joseph,37,0,37,0
1650405763884,CSE 8A,A50,083650,Miranda; Gregory Joseph,0,28,40,40
1650405769906,CSE 11,A01,083080,Cao; Yingjun,0,91,40,40
1650405775930,CSE 12,A01,083652,Staff,0,15,100,100
1650405781960,CSE 15L,A01,083654,Staff,0,1,50,50
1650405781960,CSE 15L,A02,083655,Staff,2,0,50,48
1650405787987,CSE 20,A01,083657,Staff,51,0,80,29
1650405794010,CSE 30,A01,083084,Eldon; John,0,76,40,40
1650405800033,CSE 100,A01,083659,Cao; Yingjun,0,66,50,50
1650405806061,CSE 134B,A01,083661,Powell; Thomas Allan,1,31,65,64
1650405812098,CSE 140,A01,083663,Staff,0,1,75,75
1650405818122,CSE 140L,A01,083088,Eldon; John,0,7,75,75
1650405824145,CSE 175,A01,083665,Kumar; Rakesh,7,0,25,18
1650405830173,CSE 190,A00,092507,Dubnov; Shlomo,14,0,20,6
1650405836202,ECE 45,A01,083139,Staff,0,17,40,40
1650405842227,ECE 65,A50,083695,Staff,0,5,30,30
1650405848263,ECE 109,A01,091882,Touri; Behrouz,39,0,70,31
1650405854301,ECE 180,A00,083140,Abi Samra; Nicholas Camill,24,0,30,6
1650405854301,ECE 180,B00,083141,Abi Samra; Nicholas Camill,1,0,30,29
1650405860329,MATH 10A,A01,083735,Patchell; Gregory David,7,0,30,23
1650405860329,MATH 10A,A02,083736,Patchell; Gregory David,28,0,30,2
1650405860329,MATH 10A,A03,083737,Patchell; Gregory David,25,0,30,5
1650405866388,MATH 10B,A01,083207,Staff,0,7,30,30
1650405866388,MATH 10B,A02,083208,Staff,0,7,30,30
1650405866388,MATH 10B,B01,083739,Staff,16,0,30,14
1650405866388,MATH 10B,B02,083740,Staff,28,0,30,2
1650405872411,MATH 18,A01,083743,Staff,2,0,30,28
1650405872411,MATH 18,A02,083744,Staff,27,0,30,3
1650405872411,MATH 18,A03,083745,Staff,22,0,30,8
1650405872411,MATH 18,A04,083746,Staff,27,0,30,3
1650405872411,MATH 18,B01,083748,Staff,0,11,30,30
1650405872411,MATH 18,B02,083749,Staff,0,12,30,30
1650405872411,MATH 18,B03,083750,Staff,0,12,30,30
1650405872411,MATH 18,B04,083751,Staff,0,10,30,30
1650405878441,MATH 20A,A01,083754,Staff,26,0,40,14
1650405884466,MATH 20B,A01,083756,Staff,0,9,30,30
1650405884466,MATH 20B,A02,083757,Staff,0,8,30,30
1650405890490,MATH 20C,A01,083760,Staff,0,14,30,30
1650405890490,MATH 20C,A02,083761,Staff,1,15,30,29
1650405890490,MATH 20C,B01,083762,Staff,13,0,30,17
1650405890490,MATH 20C,B02,083763,Staff,28,0,30,2
1650405896513,MATH 20D,A01,083765,Staff,0,1,30,30
1650405896513,MATH 20D,A02,083766,Staff,7,0,30,23
1650405896513,MATH 20D,A03,083767,Staff,26,0,30,4
1650405902538,MATH 20E,A01,083771,Staff,5,0,30,25
1650405902538,MATH 20E,A02,083772,Staff,19,0,30,11
1650405902538,MATH 20E,B01,083773,Staff,0,0,30,30
1650405902538,MATH 20E,B02,083774,Staff,12,0,30,18
1650405908563,MATH 103A,A01,083777,Staff,0,11,30,30
1650405908563,MATH 103A,A02,083778,Staff,0,12,30,30
1650405908563,MATH 103A,B01,083779,Staff,0,13,30,30
1650405908563,MATH 103A,B02,083780,Staff,0,11,30,30
1650405914586,MATH 105,A01,085443,Staff,0,22,30,30
1650405920610,MATH 109,A01,083213,Anzaldo; Leesa B,0,7,30,30
1650405920610,MATH 109,A02,083214,Anzaldo; Leesa B,0,7,30,30
1650405920610,MATH 109,B01,083215,Anzaldo; Leesa B,0,5,30,30
1650405920610,MATH 109,B02,083216,Anzaldo; Leesa B,0,5,30,30
1650405926639,MATH 142A,A01,083219,Chow; Bennett,0,14,30,30
1650405926639,MATH 142A,A02,083220,Chow; Bennett,0,13,30,30
1650405926639,MATH 142A,B01,083221,Chow; Bennett,0,12,30,30
1650405926639,MATH 142A,B02,083222,Chow; Bennett,0,12,30,30
1650405932664,MATH 193A,A01,083224,Staff,0,5,30,30
1650405932664,MATH 193A,A02,083225,Staff,0,5,30,30
1650405932664,MATH 193A,A03,083781,Staff,0,4,30,30
1650405932664,MATH 193A,A04,083782,Staff,0,4,30,30
1650405938693,MATH 197,001,091859,McAuley; Julian John,9998,0,9999,1
1650405944744,COGS 9,A01,083615,Staff,0,14,60,60
1650405950766,COGS 11,A01,083617,Boyle; Mary E. T.,22,0,40,18
1650405956793,COGS 13,A01,083071,Staff,0,33,40,40
1650405962816,COGS 14A,A01,092681,Staff,0,23,100,100
1650405968842,COGS 14B,A01,083073,Cheng; Tzu-Han,0,10,50,50
1650405974871,COGS 17,A01,092677,Staff,24,0,75,51
1650405980894,COGS 100,A01,083619,Staff,0,26,60,60
1650405986923,COGS 101A,A01,083621,Davis; Joshua Daniel,0,21,60,60
1650405992952,COGS 101B,A01,091572,Staff,0,4,60,60
1650405998975,COGS 101C,A01,083625,Delgado; Tania,15,0,30,15
1650406005000,COGS 107A,A01,083627,Boyle; Mary E. T.,0,10,60,60
1650406011024,COGS 118A,A01,083075,Staff,3,0,60,57
1650406017063,CSE 3,A50,083646,Miranda; Gregory Joseph,21,0,38,17
1650406017063,CSE 3,A51,083647,Miranda; Gregory Joseph,37,0,37,0
1650406023091,CSE 8A,A50,083650,Miranda; Gregory Joseph,0,28,40,40
1650406029116,CSE 11,A01,083080,Cao; Yingjun,0,91,40,40
1650406035143,CSE 12,A01,083652,Staff,0,15,100,100
1650406041172,CSE 15L,A01,083654,Staff,0,1,50,50
1650406041172,CSE 15L,A02,083655,Staff,2,0,50,48
1650406047216,CSE 20,A01,083657,Staff,51,0,80,29
1650406053238,CSE 30,A01,083084,Eldon; John,0,76,40,40
1650406059265,CSE 100,A01,083659,Cao; Yingjun,0,66,50,50
1650406065289,CSE 134B,A01,083661,Powell; Thomas Allan,1,31,65,64
1650406071310,CSE 140,A01,083663,Staff,0,1,75,75
1650406077333,CSE 140L,A01,083088,Eldon; John,0,7,75,75
1650406083362,CSE 175,A01,083665,Kumar; Rakesh,7,0,25,18
1650406089392,CSE 190,A00,092507,Dubnov; Shlomo,14,0,20,6
1650406095418,ECE 45,A01,083139,Staff,0,17,40,40
1650406101450,ECE 65,A50,083695,Staff,0,5,30,30
1650406107477,ECE 109,A01,091882,Touri; Behrouz,39,0,70,31
1650406113518,ECE 180,A00,083140,Abi Samra; Nicholas Camill,24,0,30,6
1650406113518,ECE 180,B00,083141,Abi Samra; Nicholas Camill,1,0,30,29
1650406119552,MATH 10A,A01,083735,Patchell; Gregory David,7,0,30,23
1650406119552,MATH 10A,A02,083736,Patchell; Gregory David,28,0,30,2
1650406119552,MATH 10A,A03,083737,Patchell; Gregory David,25,0,30,5
1650406125581,MATH 10B,A01,083207,Staff,0,7,30,30
1650406125581,MATH 10B,A02,083208,Staff,0,7,30,30
1650406125581,MATH 10B,B01,083739,Staff,16,0,30,14
1650406125581,MATH 10B,B02,083740,Staff,28,0,30,2
1650406131612,MATH 18,A01,083743,Staff,2,0,30,28
1650406131612,MATH 18,A02,083744,Staff,27,0,30,3
1650406131612,MATH 18,A03,083745,Staff,22,0,30,8
1650406131612,MATH 18,A04,083746,Staff,26,0,30,4
1650406131612,MATH 18,B01,083748,Staff,0,11,30,30
1650406131612,MATH 18,B02,083749,Staff,0,12,30,30
1650406131612,MATH 18,B03,083750,Staff,0,12,30,30
1650406131612,MATH 18,B04,083751,Staff,0,10,30,30
1650406137635,MATH 20A,A01,083754,Staff,26,0,40,14
1650406143668,MATH 20B,A01,083756,Staff,0,9,30,30
1650406143668,MATH 20B,A02,083757,Staff,0,8,30,30
1650406149705,MATH 20C,A01,083760,Staff,0,14,30,30
1650406149705,MATH 20C,A02,083761,Staff,1,15,30,29
1650406149705,MATH 20C,B01,083762,Staff,13,0,30,17
1650406149705,MATH 20C,B02,083763,Staff,28,0,30,2
1650406155727,MATH 20D,A01,083765,Staff,0,1,30,30
1650406155727,MATH 20D,A02,083766,Staff,7,0,30,23
1650406155727,MATH 20D,A03,083767,Staff,26,0,30,4
1650406161763,MATH 20E,A01,083771,Staff,5,0,30,25
1650406161763,MATH 20E,A02,083772,Staff,19,0,30,11
1650406161763,MATH 20E,B01,083773,Staff,0,0,30,30
1650406161763,MATH 20E,B02,083774,Staff,12,0,30,18
1650406167786,MATH 103A,A01,083777,Staff,0,11,30,30
1650406167786,MATH 103A,A02,083778,Staff,0,12,30,30
1650406167786,MATH 103A,B01,083779,Staff,0,13,30,30
1650406167786,MATH 103A,B02,083780,Staff,0,11,30,30
1650406173812,MATH 105,A01,085443,Staff,0,22,30,30
1650406179841,MATH 109,A01,083213,Anzaldo; Leesa B,0,7,30,30
1650406179841,MATH 109,A02,083214,Anzaldo; Leesa B,0,7,30,30
1650406179841,MATH 109,B01,083215,Anzaldo; Leesa B,0,5,30,30
1650406179841,MATH 109,B02,083216,Anzaldo; Leesa B,0,5,30,30
1650406185865,MATH 142A,A01,083219,Chow; Bennett,0,14,30,30
1650406185865,MATH 142A,A02,083220,Chow; Bennett,0,13,30,30
1650406185865,MATH 142A,B01,083221,Chow; Bennett,0,12,30,30
1650406185865,MATH 142A,B02,083222,Chow; Bennett,0,12,30,30
1650406191891,MATH 193A,A01,083224,Staff,0,5,30,30
1650406191891,MATH 193A,A02,083225,Staff,0,5,30,30
1650406191891,MATH 193A,A03,083781,Staff,0,4,30,30
1650406191891,MATH 193A,A04,083782,Staff,0,4,30,30
1650406197928,MATH 197,001,091859,McAuley; Julian John,9998,0,9999,1
1650406203997,COGS 9,A01,083615,Staff,0,14,60,60
1650406210022,COGS 11,A01,083617,Boyle; Mary E. T.,22,0,40,18
1650406216049,COGS 13,A01,083071,Staff,0,33,40,40
1650406222091,COGS 14A,A01,092681,Staff,0,23,100,100
1650406228114,COGS 14B,A01,083073,Cheng; Tzu-Han,0,10,50,50
1650406234228,COGS 17,A01,092677,Staff,24,0,75,51
1650406240251,COGS 100,A01,083619,Staff,0,26,60,60
1650406246277,COGS 101A,A01,083621,Davis; Joshua Daniel,0,21,60,60
1650406252302,COGS 101B,A01,091572,Staff,0,4,60,60
1650406258326,COGS 101C,A01,083625,Delgado; Tania,15,0,30,15
1650406264358,COGS 107A,A01,083627,Boyle; Mary E. T.,0,10,60,60
1650406270386,COGS 118A,A01,083075,Staff,3,0,60,57
1650406276411,CSE 3,A50,083646,Miranda; Gregory Joseph,21,0,38,17
1650406276411,CSE 3,A51,083647,Miranda; Gregory Joseph,37,0,37,0
1650406282437,CSE 8A,A50,083650,Miranda; Gregory Joseph,0,28,40,40
1650406288462,CSE 11,A01,083080,Cao; Yingjun,0,91,40,40
1650406294491,CSE 12,A01,083652,Staff,0,15,100,100
1650406300517,CSE 15L,A01,083654,Staff,0,1,50,50
1650406300517,CSE 15L,A02,083655,Staff,2,0,50,48
1650406306541,CSE 20,A01,083657,Staff,51,0,80,29
1650406312567,CSE 30,A01,083084,Eldon; John,0,76,40,40
1650406318590,CSE 100,A01,083659,Cao; Yingjun,0,66,50,50
1650406324619,CSE 134B,A01,083661,Powell; Thomas Allan,1,31,65,64
1650406330656,CSE 140,A01,083663,Staff,0,1,75,75
1650406336683,CSE 140L,A01,083088,Eldon; John,0,7,75,75
1650406342709,CSE 175,A01,083665,Kumar; Rakesh,7,0,25,18
1650406348734,CSE 190,A00,092507,Dubnov; Shlomo,14,0,20,6
1650406354761,ECE 45,A01,083139,Staff,0,17,40,40
1650406360800,ECE 65,A50,083695,Staff,0,5,30,30
1650406366826,ECE 109,A01,091882,Touri; Behrouz,39,0,70,31
1650406372849,ECE 180,A00,083140,Abi Samra; Nicholas Camill,24,0,30,6
1650406372849,ECE 180,B00,083141,Abi Samra; Nicholas Camill,1,0,30,29
1650406378877,MATH 10A,A01,083735,Patchell; Gregory David,7,0,30,23
1650406378877,MATH 10A,A02,083736,Patchell; Gregory David,28,0,30,2
1650406378877,MATH 10A,A03,083737,Patchell; Gregory David,25,0,30,5
1650406384901,MATH 10B,A01,083207,Staff,0,7,30,30
1650406384901,MATH 10B,A02,083208,Staff,0,7,30,30
1650406384901,MATH 10B,B01,083739,Staff,16,0,30,14
1650406384901,MATH 10B,B02,083740,Staff,28,0,30,2
1650406390932,MATH 18,A01,083743,Staff,2,0,30,28
1650406390932,MATH 18,A02,083744,Staff,27,0,30,3
1650406390932,MATH 18,A03,083745,Staff,22,0,30,8
1650406390932,MATH 18,A04,083746,Staff,26,0,30,4
1650406390932,MATH 18,B01,083748,Staff,0,11,30,30
1650406390932,MATH 18,B02,083749,Staff,0,12,30,30
1650406390932,MATH 18,B03,083750,Staff,0,12,30,30
1650406390932,MATH 18,B04,083751,Staff,0,10,30,30
1650406396958,MATH 20A,A01,083754,Staff,26,0,40,14
1650406402992,MATH 20B,A01,083756,Staff,0,9,30,30
1650406402992,MATH 20B,A02,083757,Staff,0,8,30,30
1650406409020,MATH 20C,A01,083760,Staff,0,14,30,30
1650406409020,MATH 20C,A02,083761,Staff,1,15,30,29
1650406409020,MATH 20C,B01,083762,Staff,13,0,30,17
1650406409020,MATH 20C,B02,083763,Staff,28,0,30,2
1650406415046,MATH 20D,A01,083765,Staff,0,1,30,30
1650406415046,MATH 20D,A02,083766,Staff,7,0,30,23
1650406415046,MATH 20D,A03,083767,Staff,26,0,30,4
1650406421072,MATH 20E,A01,083771,Staff,5,0,30,25
1650406421072,MATH 20E,A02,083772,Staff,19,0,30,11
1650406421072,MATH 20E,B01,083773,Staff,0,0,30,30
1650406421072,MATH 20E,B02,083774,Staff,12,0,30,18
1650406427100,MATH 103A,A01,083777,Staff,0,11,30,30
1650406427100,MATH 103A,A02,083778,Staff,0,12,30,30
1650406427100,MATH 103A,B01,083779,Staff,0,13,30,30
1650406427100,MATH 103A,B02,083780,Staff,0,11,30,30
1650406433124,MATH 105,A01,085443,Staff,0,22,30,30
1650406439148,MATH 109,A01,083213,Anzaldo; Leesa B,0,7,30,30
1650406439148,MATH 109,A02,083214,Anzaldo; Leesa B,0,7,30,30
1650406439148,MATH 109,B01,083215,Anzaldo; Leesa B,0,5,30,30
1650406439148,MATH 109,B02,083216,Anzaldo; Leesa B,0,5,30,30
1650406445183,MATH 142A,A01,083219,Chow; Bennett,0,14,30,30
1650406445183,MATH 142A,A02,083220,Chow; Bennett,0,13,30,30
1650406445183,MATH 142A,B01,083221,Chow; Bennett,0,12,30,30
1650406445183,MATH 142A,B02,083222,Chow; Bennett,0,12,30,30
1650406451206,MATH 193A,A01,083224,Staff,0,5,30,30
1650406451206,MATH 193A,A02,083225,Staff,0,5,30,30
1650406451206,MATH 193A,A03,083781,Staff,0,4,30,30
1650406451206,MATH 193A,A04,083782,Staff,0,4,30,30
1650406457232,MATH 197,001,091859,McAuley; Julian John,9998,0,9999,1
1650406463285,COGS 9,A01,083615,Staff,0,14,60,60
1650406469310,COGS 11,A01,083617,Boyle; Mary E. T.,22,0,40,18
1650406475348,COGS 13,A01,083071,Staff,0,33,40,40
1650406481383,COGS 14A,A01,092681,Staff,0,23,100,100
1650406487412,COGS 14B,A01,083073,Cheng; Tzu-Han,0,10,50,50
1650406493438,COGS 17,A01,092677,Staff,24,0,75,51
1650406499465,COGS 100,A01,083619,Staff,0,26,60,60
1650406505489,COGS 101A,A01,083621,Davis; Joshua Daniel,0,21,60,60
1650406511513,COGS 101B,A01,091572,Staff,0,3,60,60
1650406517557,COGS 101C,A01,083625,Delgado; Tania,15,0,30,15
1650406523580,COGS 107A,A01,083627,Boyle; Mary E. T.,0,10,60,60
1650406529605,COGS 118A,A01,083075,Staff,3,0,60,57
1650406535633,CSE 3,A50,083646,Miranda; Gregory Joseph,21,0,38,17
1650406535633,CSE 3,A51,083647,Miranda; Gregory Joseph,37,0,37,0
1650406541656,CSE 8A,A50,083650,Miranda; Gregory Joseph,0,28,40,40
1650406547683,CSE 11,A01,083080,Cao; Yingjun,0,91,40,40
1650406553712,CSE 12,A01,083652,Staff,0,15,100,100
1650406559743,CSE 15L,A01,083654,Staff,0,1,50,50
1650406559743,CSE 15L,A02,083655,Staff,2,0,50,48
1650406565765,CSE 20,A01,083657,Staff,51,0,80,29
1650406571797,CSE 30,A01,083084,Eldon; John,0,76,40,40
1650406577830,CSE 100,A01,083659,Cao; Yingjun,0,66,50,50
1650406583861,CSE 134B,A01,083661,Powell; Thomas Allan,1,31,65,64
1650406589892,CSE 140,A01,083663,Staff,0,1,75,75
1650406595918,CSE 140L,A01,083088,Eldon; John,0,7,75,75
1650406601951,CSE 175,A01,083665,Kumar; Rakesh,7,0,25,18
1650406607975,CSE 190,A00,092507,Dubnov; Shlomo,14,0,20,6
1650406614014,ECE 45,A01,083139,Staff,0,17,40,40
1650406620039,ECE 65,A50,083695,Staff,0,5,30,30
1650406626071,ECE 109,A01,091882,Touri; Behrouz,39,0,70,31
1650406632098,ECE 180,A00,083140,Abi Samra; Nicholas Camill,24,0,30,6
1650406632098,ECE 180,B00,083141,Abi Samra; Nicholas Camill,1,0,30,29
1650406638124,MATH 10A,A01,083735,Patchell; Gregory David,7,0,30,23
1650406638124,MATH 10A,A02,083736,Patchell; Gregory David,28,0,30,2
1650406638124,MATH 10A,A03,083737,Patchell; Gregory David,25,0,30,5
1650406644150,MATH 10B,A01,083207,Staff,0,7,30,30
1650406644150,MATH 10B,A02,083208,Staff,0,7,30,30
1650406644150,MATH 10B,B01,083739,Staff,16,0,30,14
1650406644150,MATH 10B,B02,083740,Staff,28,0,30,2
1650406650180,MATH 18,A01,083743,Staff,2,0,30,28
1650406650180,MATH 18,A02,083744,Staff,27,0,30,3
1650406650180,MATH 18,A03,083745,Staff,22,0,30,8
1650406650180,MATH 18,A04,083746,Staff,26,0,30,4
1650406650180,MATH 18,B01,083748,Staff,0,11,30,30
1650406650180,MATH 18,B02,083749,Staff,0,12,30,30
1650406650180,MATH 18,B03,083750,Staff,0,12,30,30
1650406650180,MATH 18,B04,083751,Staff,0,10,30,30
1650406656208,MATH 20A,A01,083754,Staff,26,0,40,14
1650406662235,MATH 20B,A01,083756,Staff,0,9,30,30
1650406662235,MATH 20B,A02,083757,Staff,0,8,30,30
1650406668266,MATH 20C,A01,083760,Staff,0,14,30,30
1650406668266,MATH 20C,A02,083761,Staff,1,15,30,29
1650406668266,MATH 20C,B01,083762,Staff,13,0,30,17
1650406668266,MATH 20C,B02,083763,Staff,28,0,30,2
1650406674293,MATH 20D,A01,083765,Staff,0,1,30,30
1650406674293,MATH 20D,A02,083766,Staff,7,0,30,23
1650406674293,MATH 20D,A03,083767,Staff,26,0,30,4
1650406680319,MATH 20E,A01,083771,Staff,5,0,30,25
1650406680319,MATH 20E,A02,083772,Staff,19,0,30,11
1650406680319,MATH 20E,B01,083773,Staff,0,0,30,30
1650406680319,MATH 20E,B02,083774,Staff,12,0,30,18
1650406686351,MATH 103A,A01,083777,Staff,0,11,30,30
1650406686351,MATH 103A,A02,083778,Staff,0,12,30,30
1650406686351,MATH 103A,B01,083779,Staff,0,13,30,30
1650406686351,MATH 103A,B02,083780,Staff,0,11,30,30
1650406692381,MATH 105,A01,085443,Staff,0,22,30,30
1650406698405,MATH 109,A01,083213,Anzaldo; Leesa B,0,7,30,30
1650406698405,MATH 109,A02,083214,Anzaldo; Leesa B,0,7,30,30
1650406698405,MATH 109,B01,083215,Anzaldo; Leesa B,0,5,30,30
1650406698405,MATH 109,B02,083216,Anzaldo; Leesa B,0,5,30,30
1650406704429,MATH 142A,A01,083219,Chow; Bennett,0,14,30,30
1650406704429,MATH 142A,A02,083220,Chow; Bennett,0,13,30,30
1650406704429,MATH 142A,B01,083221,Chow; Bennett,0,12,30,30
1650406704429,MATH 142A,B02,083222,Chow; Bennett,0,12,30,30
1650406710461,MATH 193A,A01,083224,Staff,0,5,30,30
1650406710461,MATH 193A,A02,083225,Staff,0,5,30,30
1650406710461,MATH 193A,A03,083781,Staff,0,4,30,30
1650406710461,MATH 193A,A04,083782,Staff,0,4,30,30
1650406716485,MATH 197,001,091859,McAuley; Julian John,9998,0,9999,1
1650406722566,COGS 9,A01,083615,Staff,0,14,60,60
1650406728594,COGS 11,A01,083617,Boyle; Mary E. T.,22,0,40,18
1650406734631,COGS 13,A01,083071,Staff,0,33,40,40
1650406740654,COGS 14A,A01,092681,Staff,0,23,100,100
1650406746681,COGS 14B,A01,083073,Cheng; Tzu-Han,0,10,50,50
1650406752709,COGS 17,A01,092677,Staff,23,0,75,52
1650406758735,COGS 100,A01,083619,Staff,0,26,60,60
1650406764761,COGS 101A,A01,083621,Davis; Joshua Daniel,0,21,60,60
1650406770785,COGS 101B,A01,091572,Staff,0,3,60,60
1650406776809,COGS 101C,A01,083625,Delgado; Tania,15,0,30,15
1650406782833,COGS 107A,A01,083627,Boyle; Mary E. T.,0,11,60,60
1650406788857,COGS 118A,A01,083075,Staff,3,0,60,57
1650406794885,CSE 3,A50,083646,Miranda; Gregory Joseph,21,0,38,17
1650406794885,CSE 3,A51,083647,Miranda; Gregory Joseph,37,0,37,0
1650406800929,CSE 8A,A50,083650,Miranda; Gregory Joseph,0,28,40,40
1650406806973,CSE 11,A01,083080,Cao; Yingjun,0,91,40,40
1650406812996,CSE 12,A01,083652,Staff,0,15,100,100
1650406819032,CSE 15L,A01,083654,Staff,0,1,50,50
1650406819032,CSE 15L,A02,083655,Staff,2,0,50,48
1650406825068,CSE 20,A01,083657,Staff,51,0,80,29
1650406831187,CSE 30,A01,083084,Eldon; John,0,76,40,40
1650406837223,CSE 100,A01,083659,Cao; Yingjun,0,66,50,50
1650406843251,CSE 134B,A01,083661,Powell; Thomas Allan,1,31,65,64
1650406849279,CSE 140,A01,083663,Staff,0,1,75,75
1650406855303,CSE 140L,A01,083088,Eldon; John,0,7,75,75
1650406861326,CSE 175,A01,083665,Kumar; Rakesh,7,0,25,18
1650406867352,CSE 190,A00,092507,Dubnov; Shlomo,14,0,20,6
1650406873387,ECE 45,A01,083139,Staff,0,17,40,40
1650406879411,ECE 65,A50,083695,Staff,0,5,30,30
1650406885435,ECE 109,A01,091882,Touri; Behrouz,39,0,70,31
1650406891458,ECE 180,A00,083140,Abi Samra; Nicholas Camill,24,0,30,6
1650406891458,ECE 180,B00,083141,Abi Samra; Nicholas Camill,1,0,30,29
1650406897488,MATH 10A,A01,083735,Patchell; Gregory David,7,0,30,23
1650406897488,MATH 10A,A02,083736,Patchell; Gregory David,28,0,30,2
1650406897488,MATH 10A,A03,083737,Patchell; Gregory David,25,0,30,5
1650406903516,MATH 10B,A01,083207,Staff,0,7,30,30
1650406903516,MATH 10B,A02,083208,Staff,0,7,30,30
1650406903516,MATH 10B,B01,083739,Staff,16,0,30,14
1650406903516,MATH 10B,B02,083740,Staff,28,0,30,2
1650406909540,MATH 18,A01,083743,Staff,2,0,30,28
1650406909540,MATH 18,A02,083744,Staff,27,0,30,3
1650406909540,MATH 18,A03,083745,Staff,22,0,30,8
1650406909540,MATH 18,A04,083746,Staff,26,0,30,4
1650406909540,MATH 18,B01,083748,Staff,0,11,30,30
1650406909540,MATH 18,B02,083749,Staff,0,12,30,30
1650406909540,MATH 18,B03,083750,Staff,0,12,30,30
1650406909540,MATH 18,B04,083751,Staff,0,10,30,30
1650406915566,MATH 20A,A01,083754,Staff,26,0,40,14
1650406921599,MATH 20B,A01,083756,Staff,0,9,30,30
1650406921599,MATH 20B,A02,083757,Staff,0,8,30,30
1650406927633,MATH 20C,A01,083760,Staff,0,14,30,30
1650406927633,MATH 20C,A02,083761,Staff,1,15,30,29
1650406927633,MATH 20C,B01,083762,Staff,13,0,30,17
1650406927633,MATH 20C,B02,083763,Staff,28,0,30,2
1650406933657,MATH 20D,A01,083765,Staff,0,1,30,30
1650406933657,MATH 20D,A02,083766,Staff,7,0,30,23
1650406933657,MATH 20D,A03,083767,Staff,26,0,30,4
1650406939691,MATH 20E,A01,083771,Staff,5,0,30,25
1650406939691,MATH 20E,A02,083772,Staff,19,0,30,11
1650406939691,MATH 20E,B01,083773,Staff,0,0,30,30
1650406939691,MATH 20E,B02,083774,Staff,12,0,30,18
1650406945720,MATH 103A,A01,083777,Staff,0,11,30,30
1650406945720,MATH 103A,A02,083778,Staff,0,12,30,30
1650406945720,MATH 103A,B01,083779,Staff,0,13,30,30
1650406945720,MATH 103A,B02,083780,Staff,0,11,30,30
1650406951744,MATH 105,A01,085443,Staff,0,22,30,30
1650406957774,MATH 109,A01,083213,Anzaldo; Leesa B,0,7,30,30
1650406957774,MATH 109,A02,083214,Anzaldo; Leesa B,0,7,30,30
1650406957774,MATH 109,B01,083215,Anzaldo; Leesa B,0,5,30,30
1650406957774,MATH 109,B02,083216,Anzaldo; Leesa B,0,5,30,30
1650406963803,MATH 142A,A01,083219,Chow; Bennett,0,14,30,30
1650406963803,MATH 142A,A02,083220,Chow; Bennett,0,13,30,30
1650406963803,MATH 142A,B01,083221,Chow; Bennett,0,12,30,30
1650406963803,MATH 142A,B02,083222,Chow; Bennett,0,12,30,30
1650406969827,MATH 193A,A01,083224,Staff,0,5,30,30
1650406969827,MATH 193A,A02,083225,Staff,0,5,30,30
1650406969827,MATH 193A,A03,083781,Staff,0,4,30,30
1650406969827,MATH 193A,A04,083782,Staff,0,4,30,30
1650406975855,MATH 197,001,091859,McAuley; Julian John,9998,0,9999,1
1650406981913,COGS 9,A01,083615,Staff,0,14,60,60
1650406987940,COGS 11,A01,083617,Boyle; Mary E. T.,22,0,40,18
1650406993972,COGS 13,A01,083071,Staff,0,33,40,40
1650406999995,COGS 14A,A01,092681,Staff,0,23,100,100
1650407006020,COGS 14B,A01,083073,Cheng; Tzu-Han,0,10,50,50
1650407012042,COGS 17,A01,092677,Staff,23,0,75,52
1650407018066,COGS 100,A01,083619,Staff,0,26,60,60
1650407024100,COGS 101A,A01,083621,Davis; Joshua Daniel,0,21,60,60
1650407030123,COGS 101B,A01,091572,Staff,0,4,60,60
1650407036155,COGS 101C,A01,083625,Delgado; Tania,16,0,30,14
1650407042179,COGS 107A,A01,083627,Boyle; Mary E. T.,0,11,60,60
1650407048203,COGS 118A,A01,083075,Staff,3,0,60,57
1650407054226,CSE 3,A50,083646,Miranda; Gregory Joseph,21,0,38,17
1650407054226,CSE 3,A51,083647,Miranda; Gregory Joseph,37,0,37,0
1650407060250,CSE 8A,A50,083650,Miranda; Gregory Joseph,0,28,40,40
1650407066274,CSE 11,A01,083080,Cao; Yingjun,0,91,40,40
1650407072305,CSE 12,A01,083652,Staff,0,15,100,100
1650407078330,CSE 15L,A01,083654,Staff,0,1,50,50
1650407078330,CSE 15L,A02,083655,Staff,2,0,50,48
1650407084357,CSE 20,A01,083657,Staff,51,0,80,29
1650407090385,CSE 30,A01,083084,Eldon; John,0,76,40,40
1650407096419,CSE 100,A01,083659,Cao; Yingjun,0,66,50,50
1650407102450,CSE 134B,A01,083661,Powell; Thomas Allan,1,31,65,64
1650407108472,CSE 140,A01,083663,Staff,0,1,75,75
1650407114498,CSE 140L,A01,083088,Eldon; John,0,7,75,75
1650407120524,CSE 175,A01,083665,Kumar; Rakesh,7,0,25,18
1650407126547,CSE 190,A00,092507,Dubnov; Shlomo,14,0,20,6
1650407132574,ECE 45,A01,083139,Staff,0,17,40,40
1650407138597,ECE 65,A50,083695,Staff,0,5,30,30
1650407144620,ECE 109,A01,091882,Touri; Behrouz,39,0,70,31
1650407150646,ECE 180,A00,083140,Abi Samra; Nicholas Camill,24,0,30,6
1650407150646,ECE 180,B00,083141,Abi Samra; Nicholas Camill,1,0,30,29
1650407156671,MATH 10A,A01,083735,Patchell; Gregory David,7,0,30,23
1650407156671,MATH 10A,A02,083736,Patchell; Gregory David,28,0,30,2
1650407156671,MATH 10A,A03,083737,Patchell; Gregory David,25,0,30,5
1650407162694,MATH 10B,A01,083207,Staff,0,7,30,30
1650407162694,MATH 10B,A02,083208,Staff,0,7,30,30
1650407162694,MATH 10B,B01,083739,Staff,16,0,30,14
1650407162694,MATH 10B,B02,083740,Staff,28,0,30,2
1650407168725,MATH 18,A01,083743,Staff,2,0,30,28
1650407168725,MATH 18,A02,083744,Staff,27,0,30,3
1650407168725,MATH 18,A03,083745,Staff,22,0,30,8
1650407168725,MATH 18,A04,083746,Staff,26,0,30,4
1650407168725,MATH 18,B01,083748,Staff,0,11,30,30
1650407168725,MATH 18,B02,083749,Staff,0,12,30,30
1650407168725,MATH 18,B03,083750,Staff,0,12,30,30
1650407168725,MATH 18,B04,083751,Staff,0,10,30,30
1650407174758,MATH 20A,A01,083754,Staff,26,0,40,14
1650407180828,MATH 20B,A01,083756,Staff,0,9,30,30
1650407180828,MATH 20B,A02,083757,Staff,0,8,30,30
1650407186868,MATH 20C,A01,083760,Staff,0,14,30,30
1650407186868,MATH 20C,A02,083761,Staff,1,15,30,29
1650407186868,MATH 20C,B01,083762,Staff,13,0,30,17
1650407186868,MATH 20C,B02,083763,Staff,28,0,30,2
1650407192892,MATH 20D,A01,083765,Staff,0,1,30,30
1650407192892,MATH 20D,A02,083766,Staff,7,0,30,23
1650407192892,MATH 20D,A03,083767,Staff,26,0,30,4
1650407198925,MATH 20E,A01,083771,Staff,5,0,30,25
1650407198925,MATH 20E,A02,083772,Staff,19,0,30,11
1650407198925,MATH 20E,B01,083773,Staff,0,0,30,30
1650407198925,MATH 20E,B02,083774,Staff,12,0,30,18
1650407204965,MATH 103A,A01,083777,Staff,0,11,30,30
1650407204965,MATH 103A,A02,083778,Staff,0,12,30,30
1650407204965,MATH 103A,B01,083779,Staff,0,13,30,30
1650407204965,MATH 103A,B02,083780,Staff,0,11,30,30
1650407210991,MATH 105,A01,085443,Staff,0,22,30,30
1650407217023,MATH 109,A01,083213,Anzaldo; Leesa B,0,7,30,30
1650407217023,MATH 109,A02,083214,Anzaldo; Leesa B,0,7,30,30
1650407217023,MATH 109,B01,083215,Anzaldo; Leesa B,0,5,30,30
1650407217023,MATH 109,B02,083216,Anzaldo; Leesa B,0,5,30,30
1650407223048,MATH 142A,A01,083219,Chow; Bennett,0,14,30,30
1650407223048,MATH 142A,A02,083220,Chow; Bennett,0,13,30,30
1650407223048,MATH 142A,B01,083221,Chow; Bennett,0,12,30,30
1650407223048,MATH 142A,B02,083222,Chow; Bennett,0,12,30,30
1650407229073,MATH 193A,A01,083224,Staff,0,5,30,30
1650407229073,MATH 193A,A02,083225,Staff,0,5,30,30
1650407229073,MATH 193A,A03,083781,Staff,0,4,30,30
1650407229073,MATH 193A,A04,083782,Staff,0,4,30,30
1650407235095,MATH 197,001,091859,McAuley; Julian John,9998,0,9999,1
1650407241176,COGS 9,A01,083615,Staff,0,14,60,60
1650407247204,COGS 11,A01,083617,Boyle; Mary E. T.,22,0,40,18
1650407253224,COGS 13,A01,083071,Staff,0,33,40,40
1650407259250,COGS 14A,A01,092681,Staff,0,23,100,100
1650407265273,COGS 14B,A01,083073,Cheng; Tzu-Han,0,10,50,50
1650407271301,COGS 17,A01,092677,Staff,23,0,75,52
1650407277333,COGS 100,A01,083619,Staff,0,26,60,60
1650407283360,COGS 101A,A01,083621,Davis; Joshua Daniel,0,21,60,60
1650407289387,COGS 101B,A01,091572,Staff,0,4,60,60
1650407295415,COGS 101C,A01,083625,Delgado; Tania,16,0,30,14
1650407301442,COGS 107A,A01,083627,Boyle; Mary E. T.,0,11,60,60
1650407307467,COGS 118A,A01,083075,Staff,3,0,60,57
1650407313490,CSE 3,A50,083646,Miranda; Gregory Joseph,21,0,38,17
1650407313490,CSE 3,A51,083647,Miranda; Gregory Joseph,37,0,37,0
1650407319517,CSE 8A,A50,083650,Miranda; Gregory Joseph,0,28,40,40
1650407325550,CSE 11,A01,083080,Cao; Yingjun,0,91,40,40
1650407331583,CSE 12,A01,083652,Staff,0,15,100,100
1650407337613,CSE 15L,A01,083654,Staff,0,1,50,50
1650407337613,CSE 15L,A02,083655,Staff,2,0,50,48
1650407343646,CSE 20,A01,083657,Staff,51,0,80,29
1650407349668,CSE 30,A01,083084,Eldon; John,0,76,40,40
1650407355694,CSE 100,A01,083659,Cao; Yingjun,0,66,50,50
1650407361720,CSE 134B,A01,083661,Powell; Thomas Allan,1,31,65,64
1650407367743,CSE 140,A01,083663,Staff,0,1,75,75
1650407373786,CSE 140L,A01,083088,Eldon; John,0,7,75,75
1650407379808,CSE 175,A01,083665,Kumar; Rakesh,7,0,25,18
1650407385831,CSE 190,A00,092507,Dubnov; Shlomo,14,0,20,6
1650407391861,ECE 45,A01,083139,Staff,0,17,40,40
1650407397885,ECE 65,A50,083695,Staff,0,5,30,30
1650407403925,ECE 109,A01,091882,Touri; Behrouz,39,0,70,31
1650407409951,ECE 180,A00,083140,Abi Samra; Nicholas Camill,24,0,30,6
1650407409951,ECE 180,B00,083141,Abi Samra; Nicholas Camill,1,0,30,29
1650407415980,MATH 10A,A01,083735,Patchell; Gregory David,7,0,30,23
1650407415980,MATH 10A,A02,083736,Patchell; Gregory David,28,0,30,2
1650407415980,MATH 10A,A03,083737,Patchell; Gregory David,25,0,30,5
1650407422012,MATH 10B,A01,083207,Staff,0,7,30,30
1650407422012,MATH 10B,A02,083208,Staff,0,7,30,30
1650407422012,MATH 10B,B01,083739,Staff,15,0,30,15
1650407422012,MATH 10B,B02,083740,Staff,28,0,30,2
1650407428143,MATH 18,A01,083743,Staff,2,0,30,28
1650407428143,MATH 18,A02,083744,Staff,27,0,30,3
1650407428143,MATH 18,A03,083745,Staff,22,0,30,8
1650407428143,MATH 18,A04,083746,Staff,26,0,30,4
1650407428143,MATH 18,B01,083748,Staff,0,11,30,30
1650407428143,MATH 18,B02,083749,Staff,0,12,30,30
1650407428143,MATH 18,B03,083750,Staff,0,12,30,30
1650407428143,MATH 18,B04,083751,Staff,0,10,30,30
1650407434169,MATH 20A,A01,083754,Staff,26,0,40,14
1650407440196,MATH 20B,A01,083756,Staff,0,9,30,30
1650407440196,MATH 20B,A02,083757,Staff,0,8,30,30
1650407446224,MATH 20C,A01,083760,Staff,0,14,30,30
1650407446224,MATH 20C,A02,083761,Staff,1,15,30,29
1650407446224,MATH 20C,B01,083762,Staff,13,0,30,17
1650407446224,MATH 20C,B02,083763,Staff,28,0,30,2
1650407452248,MATH 20D,A01,083765,Staff,0,1,30,30
1650407452248,MATH 20D,A02,083766,Staff,7,0,30,23
1650407452248,MATH 20D,A03,083767,Staff,26,0,30,4
1650407458277,MATH 20E,A01,083771,Staff,5,0,30,25
1650407458277,MATH 20E,A02,083772,Staff,19,0,30,11
1650407458277,MATH 20E,B01,083773,Staff,0,0,30,30
1650407458277,MATH 20E,B02,083774,Staff,12,0,30,18
1650407464302,MATH 103A,A01,083777,Staff,0,11,30,30
1650407464302,MATH 103A,A02,083778,Staff,0,12,30,30
1650407464302,MATH 103A,B01,083779,Staff,0,13,30,30
1650407464302,MATH 103A,B02,083780,Staff,0,11,30,30
1650407470333,MATH 105,A01,085443,Staff,0,22,30,30
1650407476360,MATH 109,A01,083213,Anzaldo; Leesa B,0,7,30,30
1650407476360,MATH 109,A02,083214,Anzaldo; Leesa B,0,7,30,30
1650407476360,MATH 109,B01,083215,Anzaldo; Leesa B,0,5,30,30
1650407476360,MATH 109,B02,083216,Anzaldo; Leesa B,0,6,30,30
1650407482385,MATH 142A,A01,083219,Chow; Bennett,0,14,30,30
1650407482385,MATH 142A,A02,083220,Chow; Bennett,0,13,30,30
1650407482385,MATH 142A,B01,083221,Chow; Bennett,0,12,30,30
1650407482385,MATH 142A,B02,083222,Chow; Bennett,0,12,30,30
1650407488407,MATH 193A,A01,083224,Staff,0,5,30,30
1650407488407,MATH 193A,A02,083225,Staff,0,5,30,30
1650407488407,MATH 193A,A03,083781,Staff,0,4,30,30
1650407488407,MATH 193A,A04,083782,Staff,0,4,30,30
1650407494430,MATH 197,001,091859,McAuley; Julian John,9998,0,9999,1
1650407500487,COGS 9,A01,083615,Staff,0,14,60,60
1650407506513,COGS 11,A01,083617,Boyle; Mary E. T.,22,0,40,18
1650407512552,COGS 13,A01,083071,Staff,0,33,40,40
1650407518575,COGS 14A,A01,092681,Staff,0,23,100,100
1650407524607,COGS 14B,A01,083073,Cheng; Tzu-Han,0,11,50,50
1650407530632,COGS 17,A01,092677,Staff,23,0,75,52
1650407536662,COGS 100,A01,083619,Staff,0,26,60,60
1650407542688,COGS 101A,A01,083621,Davis; Joshua Daniel,0,21,60,60
1650407548713,COGS 101B,A01,091572,Staff,0,4,60,60
1650407554737,COGS 101C,A01,083625,Delgado; Tania,16,0,30,14
1650407560764,COGS 107A,A01,083627,Boyle; Mary E. T.,0,11,60,60
1650407566789,COGS 118A,A01,083075,Staff,3,0,60,57
1650407572818,CSE 3,A50,083646,Miranda; Gregory Joseph,21,0,38,17
1650407572818,CSE 3,A51,083647,Miranda; Gregory Joseph,37,0,37,0
1650407578846,CSE 8A,A50,083650,Miranda; Gregory Joseph,0,28,40,40
1650407584872,CSE 11,A01,083080,Cao; Yingjun,0,91,40,40
1650407590895,CSE 12,A01,083652,Staff,0,15,100,100
1650407596925,CSE 15L,A01,083654,Staff,0,1,50,50
1650407596925,CSE 15L,A02,083655,Staff,2,0,50,48
1650407602950,CSE 20,A01,083657,Staff,51,0,80,29
1650407608975,CSE 30,A01,083084,Eldon; John,0,76,40,40
1650407614997,CSE 100,A01,083659,Cao; Yingjun,0,66,50,50
1650407621023,CSE 134B,A01,083661,Powell; Thomas Allan,1,31,65,64
1650407627046,CSE 140,A01,083663,Staff,0,1,75,75
1650407633078,CSE 140L,A01,083088,Eldon; John,0,7,75,75
1650407639101,CSE 175,A01,083665,Kumar; Rakesh,7,0,25,18
1650407645125,CSE 190,A00,092507,Dubnov; Shlomo,14,0,20,6
1650407651155,ECE 45,A01,083139,Staff,0,17,40,40
1650407657183,ECE 65,A50,083695,Staff,0,5,30,30
1650407663218,ECE 109,A01,091882,Touri; Behrouz,39,0,70,31
1650407669276,ECE 180,A00,083140,Abi Samra; Nicholas Camill,23,0,30,7
1650407669276,ECE 180,B00,083141,Abi Samra; Nicholas Camill,1,0,30,29
1650407675301,MATH 10A,A01,083735,Patchell; Gregory David,7,0,30,23
1650407675301,MATH 10A,A02,083736,Patchell; Gregory David,28,0,30,2
1650407675301,MATH 10A,A03,083737,Patchell; Gregory David,25,0,30,5
1650407681325,MATH 10B,A01,083207,Staff,0,7,30,30
1650407681325,MATH 10B,A02,083208,Staff,0,7,30,30
1650407681325,MATH 10B,B01,083739,Staff,15,0,30,15
1650407681325,MATH 10B,B02,083740,Staff,28,0,30,2
1650407687370,MATH 18,A01,083743,Staff,2,0,30,28
1650407687370,MATH 18,A02,083744,Staff,27,0,30,3
1650407687370,MATH 18,A03,083745,Staff,22,0,30,8
1650407687370,MATH 18,A04,083746,Staff,26,0,30,4
1650407687370,MATH 18,B01,083748,Staff,0,11,30,30
1650407687370,MATH 18,B02,083749,Staff,0,12,30,30
1650407687370,MATH 18,B03,083750,Staff,0,12,30,30
1650407687370,MATH 18,B04,083751,Staff,0,10,30,30
1650407693396,MATH 20A,A01,083754,Staff,26,0,40,14
1650407699421,MATH 20B,A01,083756,Staff,0,9,30,30
1650407699421,MATH 20B,A02,083757,Staff,0,8,30,30
1650407705444,MATH 20C,A01,083760,Staff,0,14,30,30
1650407705444,MATH 20C,A02,083761,Staff,1,15,30,29
1650407705444,MATH 20C,B01,083762,Staff,13,0,30,17
1650407705444,MATH 20C,B02,083763,Staff,28,0,30,2
1650407711472,MATH 20D,A01,083765,Staff,0,1,30,30
1650407711472,MATH 20D,A02,083766,Staff,7,0,30,23
1650407711472,MATH 20D,A03,083767,Staff,26,0,30,4
1650407717499,MATH 20E,A01,083771,Staff,5,0,30,25
1650407717499,MATH 20E,A02,083772,Staff,19,0,30,11
1650407717499,MATH 20E,B01,083773,Staff,0,0,30,30
1650407717499,MATH 20E,B02,083774,Staff,12,0,30,18
1650407723540,MATH 103A,A01,083777,Staff,0,11,30,30
1650407723540,MATH 103A,A02,083778,Staff,0,12,30,30
1650407723540,MATH 103A,B01,083779,Staff,0,13,30,30
1650407723540,MATH 103A,B02,083780,Staff,0,11,30,30
1650407729566,MATH 105,A01,085443,Staff,0,22,30,30
1650407735590,MATH 109,A01,083213,Anzaldo; Leesa B,0,7,30,30
1650407735590,MATH 109,A02,083214,Anzaldo; Leesa B,0,7,30,30
1650407735590,MATH 109,B01,083215,Anzaldo; Leesa B,0,5,30,30
1650407735590,MATH 109,B02,083216,Anzaldo; Leesa B,0,6,30,30
1650407741616,MATH 142A,A01,083219,Chow; Bennett,0,14,30,30
1650407741616,MATH 142A,A02,083220,Chow; Bennett,0,13,30,30
1650407741616,MATH 142A,B01,083221,Chow; Bennett,0,12,30,30
1650407741616,MATH 142A,B02,083222,Chow; Bennett,0,12,30,30
1650407747653,MATH 193A,A01,083224,Staff,0,5,30,30
1650407747653,MATH 193A,A02,083225,Staff,0,5,30,30
1650407747653,MATH 193A,A03,083781,Staff,0,4,30,30
1650407747653,MATH 193A,A04,083782,Staff,0,4,30,30
1650407753677,MATH 197,001,091859,McAuley; Julian John,9998,0,9999,1
1650407759734,COGS 9,A01,083615,Staff,0,14,60,60
1650407765770,COGS 11,A01,083617,Boyle; Mary E. T.,22,0,40,18
1650407771799,COGS 13,A01,083071,Staff,0,33,40,40
1650407777834,COGS 14A,A01,092681,Staff,0,23,100,100
1650407783858,COGS 14B,A01,083073,Cheng; Tzu-Han,0,11,50,50
1650407789882,COGS 17,A01,092677,Staff,23,0,75,52
1650407795906,COGS 100,A01,083619,Staff,0,26,60,60
1650407801935,COGS 101A,A01,083621,Davis; Joshua Daniel,0,21,60,60
1650407807962,COGS 101B,A01,091572,Staff,0,4,60,60
1650407813998,COGS 101C,A01,083625,Delgado; Tania,16,0,30,14
1650407820022,COGS 107A,A01,083627,Boyle; Mary E. T.,0,11,60,60
1650407826048,COGS 118A,A01,083075,Staff,3,0,60,57
1650407832072,CSE 3,A50,083646,Miranda; Gregory Joseph,21,0,38,17
1650407832072,CSE 3,A51,083647,Miranda; Gregory Joseph,37,0,37,0
1650407838102,CSE 8A,A50,083650,Miranda; Gregory Joseph,0,28,40,40
1650407844128,CSE 11,A01,083080,Cao; Yingjun,0,91,40,40
1650407850160,CSE 12,A01,083652,Staff,0,15,100,100
1650407856187,CSE 15L,A01,083654,Staff,0,1,50,50
1650407856187,CSE 15L,A02,083655,Staff,2,0,50,48
1650407862222,CSE 20,A01,083657,Staff,51,0,80,29
1650407868254,CSE 30,A01,083084,Eldon; John,0,76,40,40
1650407874284,CSE 100,A01,083659,Cao; Yingjun,0,66,50,50
1650407880306,CSE 134B,A01,083661,Powell; Thomas Allan,1,31,65,64
1650407886333,CSE 140,A01,083663,Staff,0,1,75,75
1650407892360,CSE 140L,A01,083088,Eldon; John,0,7,75,75
1650407898403,CSE 175,A01,083665,Kumar; Rakesh,7,0,25,18
1650407904426,CSE 190,A00,092507,Dubnov; Shlomo,14,0,20,6
1650407910448,ECE 45,A01,083139,Staff,0,17,40,40
1650407916470,ECE 65,A50,083695,Staff,0,5,30,30
1650407922497,ECE 109,A01,091882,Touri; Behrouz,39,0,70,31
1650407928535,ECE 180,A00,083140,Abi Samra; Nicholas Camill,23,0,30,7
1650407928535,ECE 180,B00,083141,Abi Samra; Nicholas Camill,1,0,30,29
1650407934561,MATH 10A,A01,083735,Patchell; Gregory David,7,0,30,23
1650407934561,MATH 10A,A02,083736,Patchell; Gregory David,28,0,30,2
1650407934561,MATH 10A,A03,083737,Patchell; Gregory David,25,0,30,5
1650407940592,MATH 10B,A01,083207,Staff,0,7,30,30
1650407940592,MATH 10B,A02,083208,Staff,0,7,30,30
1650407940592,MATH 10B,B01,083739,Staff,15,0,30,15
1650407940592,MATH 10B,B02,083740,Staff,28,0,30,2
1650407946631,MATH 18,A01,083743,Staff,2,0,30,28
1650407946631,MATH 18,A02,083744,Staff,27,0,30,3
1650407946631,MATH 18,A03,083745,Staff,22,0,30,8
1650407946631,MATH 18,A04,083746,Staff,26,0,30,4
1650407946631,MATH 18,B01,083748,Staff,0,11,30,30
1650407946631,MATH 18,B02,083749,Staff,0,12,30,30
1650407946631,MATH 18,B03,083750,Staff,0,12,30,30
1650407946631,MATH 18,B04,083751,Staff,0,10,30,30
1650407952671,MATH 20A,A01,083754,Staff,26,0,40,14
1650407958706,MATH 20B,A01,083756,Staff,0,9,30,30
1650407958706,MATH 20B,A02,083757,Staff,0,8,30,30
1650407964739,MATH 20C,A01,083760,Staff,0,14,30,30
1650407964739,MATH 20C,A02,083761,Staff,1,15,30,29
1650407964739,MATH 20C,B01,083762,Staff,13,0,30,17
1650407964739,MATH 20C,B02,083763,Staff,28,0,30,2
1650407970780,MATH 20D,A01,083765,Staff,0,1,30,30
1650407970780,MATH 20D,A02,083766,Staff,7,0,30,23
1650407970780,MATH 20D,A03,083767,Staff,26,0,30,4
1650407976813,MATH 20E,A01,083771,Staff,5,0,30,25
1650407976813,MATH 20E,A02,083772,Staff,18,0,30,12
1650407976813,MATH 20E,B01,083773,Staff,0,0,30,30
1650407976813,MATH 20E,B02,083774,Staff,12,0,30,18
1650407982841,MATH 103A,A01,083777,Staff,0,11,30,30
1650407982841,MATH 103A,A02,083778,Staff,0,12,30,30
1650407982841,MATH 103A,B01,083779,Staff,0,13,30,30
1650407982841,MATH 103A,B02,083780,Staff,0,11,30,30
1650407988868,MATH 105,A01,085443,Staff,0,22,30,30
1650407994896,MATH 109,A01,083213,Anzaldo; Leesa B,0,7,30,30
1650407994896,MATH 109,A02,083214,Anzaldo; Leesa B,0,7,30,30
1650407994896,MATH 109,B01,083215,Anzaldo; Leesa B,0,5,30,30
1650407994896,MATH 109,B02,083216,Anzaldo; Leesa B,0,6,30,30
1650408000921,MATH 142A,A01,083219,Chow; Bennett,0,14,30,30
1650408000921,MATH 142A,A02,083220,Chow; Bennett,0,13,30,30
1650408000921,MATH 142A,B01,083221,Chow; Bennett,0,12,30,30
1650408000921,MATH 142A,B02,083222,Chow; Bennett,0,12,30,30
1650408006949,MATH 193A,A01,083224,Staff,0,5,30,30
1650408006949,MATH 193A,A02,083225,Staff,0,5,30,30
1650408006949,MATH 193A,A03,083781,Staff,0,4,30,30
1650408006949,MATH 193A,A04,083782,Staff,0,4,30,30
1650408012982,MATH 197,001,091859,McAuley; Julian John,9998,0,9999,1
1650408019145,COGS 9,A01,083615,Staff,0,14,60,60
1650408025181,COGS 11,A01,083617,Boyle; Mary E. T.,22,0,40,18
1650408031219,COGS 13,A01,083071,Staff,0,33,40,40
1650408037242,COGS 14A,A01,092681,Staff,0,23,100,100
1650408043267,COGS 14B,A01,083073,Cheng; Tzu-Han,0,11,50,50
1650408049291,COGS 17,A01,092677,Staff,23,0,75,52
1650408055326,COGS 100,A01,083619,Staff,0,26,60,60
1650408061361,COGS 101A,A01,083621,Davis; Joshua Daniel,0,21,60,60
1650408067387,COGS 101B,A01,091572,Staff,0,4,60,60
1650408073416,COGS 101C,A01,083625,Delgado; Tania,16,0,30,14
1650408079443,COGS 107A,A01,083627,Boyle; Mary E. T.,0,11,60,60
1650408085474,COGS 118A,A01,083075,Staff,3,0,60,57
1650408091497,CSE 3,A50,083646,Miranda; Gregory Joseph,21,0,38,17
1650408091497,CSE 3,A51,083647,Miranda; Gregory Joseph,37,0,37,0
1650408097522,CSE 8A,A50,083650,Miranda; Gregory Joseph,0,28,40,40
1650408103549,CSE 11,A01,083080,Cao; Yingjun,0,91,40,40
1650408109579,CSE 12,A01,083652,Staff,0,15,100,100
1650408115611,CSE 15L,A01,083654,Staff,0,1,50,50
1650408115611,CSE 15L,A02,083655,Staff,2,0,50,48
1650408121639,CSE 20,A01,083657,Staff,51,0,80,29
1650408127662,CSE 30,A01,083084,Eldon; John,0,76,40,40
1650408133688,CSE 100,A01,083659,Cao; Yingjun,0,66,50,50
1650408139711,CSE 134B,A01,083661,Powell; Thomas Allan,1,31,65,64
1650408145738,CSE 140,A01,083663,Staff,0,1,75,75
1650408151765,CSE 140L,A01,083088,Eldon; John,0,7,75,75
1650408157788,CSE 175,A01,083665,Kumar; Rakesh,7,0,25,18
1650408163821,CSE 190,A00,092507,Dubnov; Shlomo,14,0,20,6
1650408169843,ECE 45,A01,083139,Staff,0,17,40,40
1650408175876,ECE 65,A50,083695,Staff,0,5,30,30
1650408181901,ECE 109,A01,091882,Touri; Behrouz,39,0,70,31
1650408187925,ECE 180,A00,083140,Abi Samra; Nicholas Camill,23,0,30,7
1650408187925,ECE 180,B00,083141,Abi Samra; Nicholas Camill,1,0,30,29
1650408193950,MATH 10A,A01,083735,Patchell; Gregory David,7,0,30,23
1650408193950,MATH 10A,A02,083736,Patchell; Gregory David,28,0,30,2
1650408193950,MATH 10A,A03,083737,Patchell; Gregory David,25,0,30,5
1650408199983,MATH 10B,A01,083207,Staff,0,7,30,30
1650408199983,MATH 10B,A02,083208,Staff,0,7,30,30
1650408199983,MATH 10B,B01,083739,Staff,15,0,30,15
1650408199983,MATH 10B,B02,083740,Staff,28,0,30,2
1650408206020,MATH 18,A01,083743,Staff,2,0,30,28
1650408206020,MATH 18,A02,083744,Staff,27,0,30,3
1650408206020,MATH 18,A03,083745,Staff,22,0,30,8
1650408206020,MATH 18,A04,083746,Staff,26,0,30,4
1650408206020,MATH 18,B01,083748,Staff,0,11,30,30
1650408206020,MATH 18,B02,083749,Staff,0,12,30,30
1650408206020,MATH 18,B03,083750,Staff,0,12,30,30
1650408206020,MATH 18,B04,083751,Staff,0,10,30,30
1650408212044,MATH 20A,A01,083754,Staff,26,0,40,14
1650408218071,MATH 20B,A01,083756,Staff,0,9,30,30
1650408218071,MATH 20B,A02,083757,Staff,0,8,30,30
1650408224096,MATH 20C,A01,083760,Staff,0,14,30,30
1650408224096,MATH 20C,A02,083761,Staff,1,15,30,29
1650408224096,MATH 20C,B01,083762,Staff,13,0,30,17
1650408224096,MATH 20C,B02,083763,Staff,28,0,30,2
1650408230134,MATH 20D,A01,083765,Staff,0,1,30,30
1650408230134,MATH 20D,A02,083766,Staff,7,0,30,23
1650408230134,MATH 20D,A03,083767,Staff,26,0,30,4
1650408236166,MATH 20E,A01,083771,Staff,5,0,30,25
1650408236166,MATH 20E,A02,083772,Staff,18,0,30,12
1650408236166,MATH 20E,B01,083773,Staff,0,0,30,30
1650408236166,MATH 20E,B02,083774,Staff,12,0,30,18
1650408242193,MATH 103A,A01,083777,Staff,0,11,30,30
1650408242193,MATH 103A,A02,083778,Staff,0,12,30,30
1650408242193,MATH 103A,B01,083779,Staff,0,13,30,30
1650408242193,MATH 103A,B02,083780,Staff,0,11,30,30
1650408248220,MATH 105,A01,085443,Staff,0,22,30,30
1650408254249,MATH 109,A01,083213,Anzaldo; Leesa B,0,7,30,30
1650408254249,MATH 109,A02,083214,Anzaldo; Leesa B,0,7,30,30
1650408254249,MATH 109,B01,083215,Anzaldo; Leesa B,0,5,30,30
1650408254249,MATH 109,B02,083216,Anzaldo; Leesa B,0,6,30,30
1650408260278,MATH 142A,A01,083219,Chow; Bennett,0,14,30,30
1650408260278,MATH 142A,A02,083220,Chow; Bennett,0,13,30,30
1650408260278,MATH 142A,B01,083221,Chow; Bennett,0,12,30,30
1650408260278,MATH 142A,B02,083222,Chow; Bennett,0,12,30,30
1650408266301,MATH 193A,A01,083224,Staff,0,5,30,30
1650408266301,MATH 193A,A02,083225,Staff,0,5,30,30
1650408266301,MATH 193A,A03,083781,Staff,0,4,30,30
1650408266301,MATH 193A,A04,083782,Staff,0,4,30,30
1650408272324,MATH 197,001,091859,McAuley; Julian John,9998,0,9999,1
1650408278382,COGS 9,A01,083615,Staff,0,14,60,60
1650408284408,COGS 11,A01,083617,Boyle; Mary E. T.,22,0,40,18
1650408290431,COGS 13,A01,083071,Staff,0,33,40,40
1650408296456,COGS 14A,A01,092681,Staff,0,23,100,100
1650408302483,COGS 14B,A01,083073,Cheng; Tzu-Han,0,11,50,50
1650408308506,COGS 17,A01,092677,Staff,23,0,75,52
1650408314531,COGS 100,A01,083619,Staff,0,26,60,60
1650408320555,COGS 101A,A01,083621,Davis; Joshua Daniel,0,21,60,60
1650408326579,COGS 101B,A01,091572,Staff,0,4,60,60
1650408332606,COGS 101C,A01,083625,Delgado; Tania,16,0,30,14
1650408338634,COGS 107A,A01,083627,Boyle; Mary E. T.,0,11,60,60
1650408344657,COGS 118A,A01,083075,Staff,3,0,60,57
1650408350686,CSE 3,A50,083646,Miranda; Gregory Joseph,21,0,38,17
1650408350686,CSE 3,A51,083647,Miranda; Gregory Joseph,37,0,37,0
1650408356720,CSE 8A,A50,083650,Miranda; Gregory Joseph,0,28,40,40
1650408362748,CSE 11,A01,083080,Cao; Yingjun,0,91,40,40
1650408368772,CSE 12,A01,083652,Staff,0,16,100,100
1650408374795,CSE 15L,A01,083654,Staff,0,1,50,50
1650408374795,CSE 15L,A02,083655,Staff,2,0,50,48
1650408380825,CSE 20,A01,083657,Staff,51,0,80,29
1650408386847,CSE 30,A01,083084,Eldon; John,0,76,40,40
1650408392877,CSE 100,A01,083659,Cao; Yingjun,0,66,50,50
1650408398906,CSE 134B,A01,083661,Powell; Thomas Allan,1,31,65,64
1650408404928,CSE 140,A01,083663,Staff,0,1,75,75
1650408410952,CSE 140L,A01,083088,Eldon; John,0,7,75,75
1650408416975,CSE 175,A01,083665,Kumar; Rakesh,7,0,25,18
1650408423000,CSE 190,A00,092507,Dubnov; Shlomo,14,0,20,6
1650408429030,ECE 45,A01,083139,Staff,0,17,40,40
1650408435054,ECE 65,A50,083695,Staff,0,5,30,30
1650408441082,ECE 109,A01,091882,Touri; Behrouz,39,0,70,31
1650408447106,ECE 180,A00,083140,Abi Samra; Nicholas Camill,23,0,30,7
1650408447106,ECE 180,B00,083141,Abi Samra; Nicholas Camill,1,0,30,29
1650408453130,MATH 10A,A01,083735,Patchell; Gregory David,7,0,30,23
1650408453130,MATH 10A,A02,083736,Patchell; Gregory David,28,0,30,2
1650408453130,MATH 10A,A03,083737,Patchell; Gregory David,25,0,30,5
1650408459156,MATH 10B,A01,083207,Staff,0,7,30,30
1650408459156,MATH 10B,A02,083208,Staff,0,7,30,30
1650408459156,MATH 10B,B01,083739,Staff,15,0,30,15
1650408459156,MATH 10B,B02,083740,Staff,28,0,30,2
1650408465197,MATH 18,A01,083743,Staff,2,0,30,28
1650408465197,MATH 18,A02,083744,Staff,27,0,30,3
1650408465197,MATH 18,A03,083745,Staff,22,0,30,8
1650408465197,MATH 18,A04,083746,Staff,26,0,30,4
1650408465197,MATH 18,B01,083748,Staff,0,11,30,30
1650408465197,MATH 18,B02,083749,Staff,0,12,30,30
1650408465197,MATH 18,B03,083750,Staff,0,12,30,30
1650408465197,MATH 18,B04,083751,Staff,0,10,30,30
1650408471232,MATH 20A,A01,083754,Staff,26,0,40,14
1650408477263,MATH 20B,A01,083756,Staff,0,9,30,30
1650408477263,MATH 20B,A02,083757,Staff,0,8,30,30
1650408483300,MATH 20C,A01,083760,Staff,0,14,30,30
1650408483300,MATH 20C,A02,083761,Staff,1,15,30,29
1650408483300,MATH 20C,B01,083762,Staff,13,0,30,17
1650408483300,MATH 20C,B02,083763,Staff,28,0,30,2
1650408489327,MATH 20D,A01,083765,Staff,0,1,30,30
1650408489327,MATH 20D,A02,083766,Staff,7,0,30,23
1650408489327,MATH 20D,A03,083767,Staff,26,0,30,4
1650408495352,MATH 20E,A01,083771,Staff,5,0,30,25
1650408495352,MATH 20E,A02,083772,Staff,18,0,30,12
1650408495352,MATH 20E,B01,083773,Staff,0,0,30,30
1650408495352,MATH 20E,B02,083774,Staff,12,0,30,18
1650408501379,MATH 103A,A01,083777,Staff,0,11,30,30
1650408501379,MATH 103A,A02,083778,Staff,0,12,30,30
1650408501379,MATH 103A,B01,083779,Staff,0,13,30,30
1650408501379,MATH 103A,B02,083780,Staff,0,11,30,30
1650408507417,MATH 105,A01,085443,Staff,0,22,30,30
1650408513454,MATH 109,A01,083213,Anzaldo; Leesa B,0,7,30,30
1650408513454,MATH 109,A02,083214,Anzaldo; Leesa B,0,7,30,30
1650408513454,MATH 109,B01,083215,Anzaldo; Leesa B,0,5,30,30
1650408513454,MATH 109,B02,083216,Anzaldo; Leesa B,0,6,30,30
1650408519483,MATH 142A,A01,083219,Chow; Bennett,0,14,30,30
1650408519483,MATH 142A,A02,083220,Chow; Bennett,0,13,30,30
1650408519483,MATH 142A,B01,083221,Chow; Bennett,0,12,30,30
1650408519483,MATH 142A,B02,083222,Chow; Bennett,0,13,30,30
1650408525505,MATH 193A,A01,083224,Staff,0,5,30,30
1650408525505,MATH 193A,A02,083225,Staff,0,5,30,30
1650408525505,MATH 193A,A03,083781,Staff,0,4,30,30
1650408525505,MATH 193A,A04,083782,Staff,0,4,30,30
1650408531543,MATH 197,001,091859,McAuley; Julian John,9998,0,9999,1
1650408537595,COGS 9,A01,083615,Staff,0,14,60,60
1650408543618,COGS 11,A01,083617,Boyle; Mary E. T.,22,0,40,18
1650408549647,COGS 13,A01,083071,Staff,0,33,40,40
1650408555671,COGS 14A,A01,092681,Staff,0,23,100,100
1650408561693,COGS 14B,A01,083073,Cheng; Tzu-Han,0,11,50,50
1650408567726,COGS 17,A01,092677,Staff,23,0,75,52
1650408573762,COGS 100,A01,083619,Staff,0,26,60,60
1650408579793,COGS 101A,A01,083621,Davis; Joshua Daniel,0,21,60,60
1650408585841,COGS 101B,A01,091572,Staff,0,4,60,60
1650408591868,COGS 101C,A01,083625,Delgado; Tania,16,0,30,14
1650408597894,COGS 107A,A01,083627,Boyle; Mary E. T.,0,11,60,60
1650408603918,COGS 118A,A01,083075,Staff,3,0,60,57
1650408609946,CSE 3,A50,083646,Miranda; Gregory Joseph,21,0,38,17
1650408609946,CSE 3,A51,083647,Miranda; Gregory Joseph,37,0,37,0
1650408616061,CSE 8A,A50,083650,Miranda; Gregory Joseph,0,28,40,40
1650408622087,CSE 11,A01,083080,Cao; Yingjun,0,91,40,40
1650408628120,CSE 12,A01,083652,Staff,0,16,100,100
1650408634146,CSE 15L,A01,083654,Staff,0,1,50,50
1650408634146,CSE 15L,A02,083655,Staff,2,0,50,48
1650408640186,CSE 20,A01,083657,Staff,51,0,80,29
1650408646209,CSE 30,A01,083084,Eldon; John,0,76,40,40
1650408652238,CSE 100,A01,083659,Cao; Yingjun,0,66,50,50
1650408658262,CSE 134B,A01,083661,Powell; Thomas Allan,1,31,65,64
1650408664286,CSE 140,A01,083663,Staff,0,1,75,75
1650408670315,CSE 140L,A01,083088,Eldon; John,0,7,75,75
1650408676339,CSE 175,A01,083665,Kumar; Rakesh,7,0,25,18
1650408682363,CSE 190,A00,092507,Dubnov; Shlomo,14,0,20,6
1650408688386,ECE 45,A01,083139,Staff,0,17,40,40
1650408694408,ECE 65,A50,083695,Staff,0,5,30,30
1650408700433,ECE 109,A01,091882,Touri; Behrouz,39,0,70,31
1650408706456,ECE 180,A00,083140,Abi Samra; Nicholas Camill,23,0,30,7
1650408706456,ECE 180,B00,083141,Abi Samra; Nicholas Camill,1,0,30,29
1650408712499,MATH 10A,A01,083735,Patchell; Gregory David,7,0,30,23
1650408712499,MATH 10A,A02,083736,Patchell; Gregory David,28,0,30,2
1650408712499,MATH 10A,A03,083737,Patchell; Gregory David,25,0,30,5
1650408718535,MATH 10B,A01,083207,Staff,0,8,30,30
1650408718535,MATH 10B,A02,083208,Staff,0,7,30,30
1650408718535,MATH 10B,B01,083739,Staff,15,0,30,15
1650408718535,MATH 10B,B02,083740,Staff,28,0,30,2
1650408724571,MATH 18,A01,083743,Staff,2,0,30,28
1650408724571,MATH 18,A02,083744,Staff,27,0,30,3
1650408724571,MATH 18,A03,083745,Staff,22,0,30,8
1650408724571,MATH 18,A04,083746,Staff,26,0,30,4
1650408724571,MATH 18,B01,083748,Staff,0,11,30,30
1650408724571,MATH 18,B02,083749,Staff,0,12,30,30
1650408724571,MATH 18,B03,083750,Staff,0,12,30,30
1650408724571,MATH 18,B04,083751,Staff,0,10,30,30
1650408730597,MATH 20A,A01,083754,Staff,26,0,40,14
1650408736627,MATH 20B,A01,083756,Staff,0,9,30,30
1650408736627,MATH 20B,A02,083757,Staff,0,8,30,30
1650408742654,MATH 20C,A01,083760,Staff,0,14,30,30
1650408742654,MATH 20C,A02,083761,Staff,1,15,30,29
1650408742654,MATH 20C,B01,083762,Staff,13,0,30,17
1650408742654,MATH 20C,B02,083763,Staff,28,0,30,2
1650408748682,MATH 20D,A01,083765,Staff,0,1,30,30
1650408748682,MATH 20D,A02,083766,Staff,7,0,30,23
1650408748682,MATH 20D,A03,083767,Staff,26,0,30,4
1650408754706,MATH 20E,A01,083771,Staff,5,0,30,25
1650408754706,MATH 20E,A02,083772,Staff,18,0,30,12
1650408754706,MATH 20E,B01,083773,Staff,0,0,30,30
1650408754706,MATH 20E,B02,083774,Staff,12,0,30,18
1650408760730,MATH 103A,A01,083777,Staff,0,11,30,30
1650408760730,MATH 103A,A02,083778,Staff,0,12,30,30
1650408760730,MATH 103A,B01,083779,Staff,0,13,30,30
1650408760730,MATH 103A,B02,083780,Staff,0,11,30,30
1650408766753,MATH 105,A01,085443,Staff,0,22,30,30
1650408772777,MATH 109,A01,083213,Anzaldo; Leesa B,0,7,30,30
1650408772777,MATH 109,A02,083214,Anzaldo; Leesa B,0,7,30,30
1650408772777,MATH 109,B01,083215,Anzaldo; Leesa B,0,5,30,30
1650408772777,MATH 109,B02,083216,Anzaldo; Leesa B,0,6,30,30
1650408778810,MATH 142A,A01,083219,Chow; Bennett,0,14,30,30
1650408778810,MATH 142A,A02,083220,Chow; Bennett,0,13,30,30
1650408778810,MATH 142A,B01,083221,Chow; Bennett,0,12,30,30
1650408778810,MATH 142A,B02,083222,Chow; Bennett,0,13,30,30
1650408784838,MATH 193A,A01,083224,Staff,0,5,30,30
1650408784838,MATH 193A,A02,083225,Staff,0,5,30,30
1650408784838,MATH 193A,A03,083781,Staff,0,4,30,30
1650408784838,MATH 193A,A04,083782,Staff,0,4,30,30
1650408790861,MATH 197,001,091859,McAuley; Julian John,9998,0,9999,1
1650408796926,COGS 9,A01,083615,Staff,0,14,60,60
1650408802950,COGS 11,A01,083617,Boyle; Mary E. T.,22,0,40,18
1650408808973,COGS 13,A01,083071,Staff,0,33,40,40
1650408814998,COGS 14A,A01,092681,Staff,0,23,100,100
1650408821040,COGS 14B,A01,083073,Cheng; Tzu-Han,0,11,50,50
1650408827064,COGS 17,A01,092677,Staff,23,0,75,52
1650408833092,COGS 100,A01,083619,Staff,0,26,60,60
1650408839117,COGS 101A,A01,083621,Davis; Joshua Daniel,0,21,60,60
1650408845143,COGS 101B,A01,091572,Staff,0,4,60,60
1650408851184,COGS 101C,A01,083625,Delgado; Tania,16,0,30,14
1650408857207,COGS 107A,A01,083627,Boyle; Mary E. T.,0,11,60,60
1650408863247,COGS 118A,A01,083075,Staff,3,0,60,57
1650408869271,CSE 3,A50,083646,Miranda; Gregory Joseph,21,0,38,17
1650408869271,CSE 3,A51,083647,Miranda; Gregory Joseph,37,0,37,0
1650408875310,CSE 8A,A50,083650,Miranda; Gregory Joseph,0,28,40,40
1650408881332,CSE 11,A01,083080,Cao; Yingjun,0,91,40,40
1650408887364,CSE 12,A01,083652,Staff,0,16,100,100
1650408893388,CSE 15L,A01,083654,Staff,0,1,50,50
1650408893388,CSE 15L,A02,083655,Staff,2,0,50,48
1650408899418,CSE 20,A01,083657,Staff,51,0,80,29
1650408905447,CSE 30,A01,083084,Eldon; John,0,76,40,40
1650408911475,CSE 100,A01,083659,Cao; Yingjun,0,66,50,50
1650408917503,CSE 134B,A01,083661,Powell; Thomas Allan,1,31,65,64
1650408923529,CSE 140,A01,083663,Staff,0,1,75,75
1650408929560,CSE 140L,A01,083088,Eldon; John,0,7,75,75
1650408935586,CSE 175,A01,083665,Kumar; Rakesh,7,0,25,18
1650408941612,CSE 190,A00,092507,Dubnov; Shlomo,14,0,20,6
1650408947640,ECE 45,A01,083139,Staff,0,17,40,40
1650408953669,ECE 65,A50,083695,Staff,0,5,30,30
1650408959692,ECE 109,A01,091882,Touri; Behrouz,39,0,70,31
1650408965716,ECE 180,A00,083140,Abi Samra; Nicholas Camill,23,0,30,7
1650408965716,ECE 180,B00,083141,Abi Samra; Nicholas Camill,1,0,30,29
1650408971746,MATH 10A,A01,083735,Patchell; Gregory David,7,0,30,23
1650408971746,MATH 10A,A02,083736,Patchell; Gregory David,28,0,30,2
1650408971746,MATH 10A,A03,083737,Patchell; Gregory David,25,0,30,5
1650408977774,MATH 10B,A01,083207,Staff,0,8,30,30
1650408977774,MATH 10B,A02,083208,Staff,0,7,30,30
1650408977774,MATH 10B,B01,083739,Staff,15,0,30,15
1650408977774,MATH 10B,B02,083740,Staff,28,0,30,2
1650408983800,MATH 18,A01,083743,Staff,2,0,30,28
1650408983800,MATH 18,A02,083744,Staff,27,0,30,3
1650408983800,MATH 18,A03,083745,Staff,22,0,30,8
1650408983800,MATH 18,A04,083746,Staff,26,0,30,4
1650408983800,MATH 18,B01,083748,Staff,0,11,30,30
1650408983800,MATH 18,B02,083749,Staff,0,12,30,30
1650408983800,MATH 18,B03,083750,Staff,0,12,30,30
1650408983800,MATH 18,B04,083751,Staff,0,10,30,30
1650408989824,MATH 20A,A01,083754,Staff,26,0,40,14
1650408995852,MATH 20B,A01,083756,Staff,0,9,30,30
1650408995852,MATH 20B,A02,083757,Staff,0,8,30,30
1650409001891,MATH 20C,A01,083760,Staff,0,14,30,30
1650409001891,MATH 20C,A02,083761,Staff,1,15,30,29
1650409001891,MATH 20C,B01,083762,Staff,13,0,30,17
1650409001891,MATH 20C,B02,083763,Staff,28,0,30,2
1650409007939,MATH 20D,A01,083765,Staff,0,1,30,30
1650409007939,MATH 20D,A02,083766,Staff,7,0,30,23
1650409007939,MATH 20D,A03,083767,Staff,26,0,30,4
1650409013967,MATH 20E,A01,083771,Staff,5,0,30,25
1650409013967,MATH 20E,A02,083772,Staff,18,0,30,12
1650409013967,MATH 20E,B01,083773,Staff,0,0,30,30
1650409013967,MATH 20E,B02,083774,Staff,12,0,30,18
1650409019992,MATH 103A,A01,083777,Staff,0,11,30,30
1650409019992,MATH 103A,A02,083778,Staff,0,12,30,30
1650409019992,MATH 103A,B01,083779,Staff,0,13,30,30
1650409019992,MATH 103A,B02,083780,Staff,0,11,30,30
1650409026022,MATH 105,A01,085443,Staff,0,22,30,30
1650409032050,MATH 109,A01,083213,Anzaldo; Leesa B,0,7,30,30
1650409032050,MATH 109,A02,083214,Anzaldo; Leesa B,0,7,30,30
1650409032050,MATH 109,B01,083215,Anzaldo; Leesa B,0,5,30,30
1650409032050,MATH 109,B02,083216,Anzaldo; Leesa B,0,6,30,30
1650409038074,MATH 142A,A01,083219,Chow; Bennett,0,14,30,30
1650409038074,MATH 142A,A02,083220,Chow; Bennett,0,13,30,30
1650409038074,MATH 142A,B01,083221,Chow; Bennett,0,12,30,30
1650409038074,MATH 142A,B02,083222,Chow; Bennett,0,13,30,30
1650409044098,MATH 193A,A01,083224,Staff,0,5,30,30
1650409044098,MATH 193A,A02,083225,Staff,0,5,30,30
1650409044098,MATH 193A,A03,083781,Staff,0,4,30,30
1650409044098,MATH 193A,A04,083782,Staff,0,4,30,30
1650409050123,MATH 197,001,091859,McAuley; Julian John,9998,0,9999,1
1650409056187,COGS 9,A01,083615,Staff,0,14,60,60
1650409062211,COGS 11,A01,083617,Boyle; Mary E. T.,22,0,40,18
1650409068250,COGS 13,A01,083071,Staff,0,33,40,40
1650409074280,COGS 14A,A01,092681,Staff,0,23,100,100
1650409080307,COGS 14B,A01,083073,Cheng; Tzu-Han,0,11,50,50
1650409086334,COGS 17,A01,092677,Staff,23,0,75,52
1650409092360,COGS 100,A01,083619,Staff,0,26,60,60
1650409098388,COGS 101A,A01,083621,Davis; Joshua Daniel,0,21,60,60
1650409104413,COGS 101B,A01,091572,Staff,0,4,60,60
1650409110436,COGS 101C,A01,083625,Delgado; Tania,16,0,30,14
1650409116460,COGS 107A,A01,083627,Boyle; Mary E. T.,0,11,60,60
1650409122483,COGS 118A,A01,083075,Staff,3,0,60,57
1650409128507,CSE 3,A50,083646,Miranda; Gregory Joseph,21,0,38,17
1650409128507,CSE 3,A51,083647,Miranda; Gregory Joseph,37,0,37,0
1650409134541,CSE 8A,A50,083650,Miranda; Gregory Joseph,0,28,40,40
1650409140580,CSE 11,A01,083080,Cao; Yingjun,0,91,40,40
1650409146604,CSE 12,A01,083652,Staff,0,16,100,100
1650409152636,CSE 15L,A01,083654,Staff,0,1,50,50
1650409152636,CSE 15L,A02,083655,Staff,2,0,50,48
1650409158660,CSE 20,A01,083657,Staff,51,0,80,29
1650409164687,CSE 30,A01,083084,Eldon; John,0,76,40,40
1650409170717,CSE 100,A01,083659,Cao; Yingjun,0,66,50,50
1650409176740,CSE 134B,A01,083661,Powell; Thomas Allan,1,31,65,64
1650409182762,CSE 140,A01,083663,Staff,0,1,75,75
1650409188786,CSE 140L,A01,083088,Eldon; John,0,7,75,75
1650409194814,CSE 175,A01,083665,Kumar; Rakesh,7,0,25,18
1650409200840,CSE 190,A00,092507,Dubnov; Shlomo,14,0,20,6
1650409206862,ECE 45,A01,083139,Staff,0,17,40,40
1650409212985,ECE 65,A50,083695,Staff,0,5,30,30
1650409219012,ECE 109,A01,091882,Touri; Behrouz,39,0,70,31
1650409225047,ECE 180,A00,083140,Abi Samra; Nicholas Camill,23,0,30,7
1650409225047,ECE 180,B00,083141,Abi Samra; Nicholas Camill,1,0,30,29
1650409231080,MATH 10A,A01,083735,Patchell; Gregory David,7,0,30,23
1650409231080,MATH 10A,A02,083736,Patchell; Gregory David,28,0,30,2
1650409231080,MATH 10A,A03,083737,Patchell; Gregory David,25,0,30,5
1650409237109,MATH 10B,A01,083207,Staff,0,8,30,30
1650409237109,MATH 10B,A02,083208,Staff,0,7,30,30
1650409237109,MATH 10B,B01,083739,Staff,15,0,30,15
1650409237109,MATH 10B,B02,083740,Staff,28,0,30,2
1650409243140,MATH 18,A01,083743,Staff,2,0,30,28
1650409243140,MATH 18,A02,083744,Staff,27,0,30,3
1650409243140,MATH 18,A03,083745,Staff,22,0,30,8
1650409243140,MATH 18,A04,083746,Staff,26,0,30,4
1650409243140,MATH 18,B01,083748,Staff,0,11,30,30
1650409243140,MATH 18,B02,083749,Staff,0,12,30,30
1650409243140,MATH 18,B03,083750,Staff,0,12,30,30
1650409243140,MATH 18,B04,083751,Staff,0,10,30,30
1650409249167,MATH 20A,A01,083754,Staff,26,0,40,14
1650409255198,MATH 20B,A01,083756,Staff,0,9,30,30
1650409255198,MATH 20B,A02,083757,Staff,0,8,30,30
1650409261221,MATH 20C,A01,083760,Staff,0,14,30,30
1650409261221,MATH 20C,A02,083761,Staff,1,15,30,29
1650409261221,MATH 20C,B01,083762,Staff,13,0,30,17
1650409261221,MATH 20C,B02,083763,Staff,28,0,30,2
1650409267251,MATH 20D,A01,083765,Staff,0,1,30,30
1650409267251,MATH 20D,A02,083766,Staff,7,0,30,23
1650409267251,MATH 20D,A03,083767,Staff,26,0,30,4
1650409273289,MATH 20E,A01,083771,Staff,5,0,30,25
1650409273289,MATH 20E,A02,083772,Staff,18,0,30,12
1650409273289,MATH 20E,B01,083773,Staff,0,0,30,30
1650409273289,MATH 20E,B02,083774,Staff,12,0,30,18
1650409279312,MATH 103A,A01,083777,Staff,0,11,30,30
1650409279312,MATH 103A,A02,083778,Staff,0,12,30,30
1650409279312,MATH 103A,B01,083779,Staff,0,13,30,30
1650409279312,MATH 103A,B02,083780,Staff,0,11,30,30
1650409285337,MATH 105,A01,085443,Staff,0,22,30,30
1650409291369,MATH 109,A01,083213,Anzaldo; Leesa B,0,7,30,30
1650409291369,MATH 109,A02,083214,Anzaldo; Leesa B,0,7,30,30
1650409291369,MATH 109,B01,083215,Anzaldo; Leesa B,0,5,30,30
1650409291369,MATH 109,B02,083216,Anzaldo; Leesa B,0,6,30,30
1650409297399,MATH 142A,A01,083219,Chow; Bennett,0,14,30,30
1650409297399,MATH 142A,A02,083220,Chow; Bennett,0,13,30,30
1650409297399,MATH 142A,B01,083221,Chow; Bennett,0,12,30,30
1650409297399,MATH 142A,B02,083222,Chow; Bennett,0,13,30,30
1650409303428,MATH 193A,A01,083224,Staff,0,5,30,30
1650409303428,MATH 193A,A02,083225,Staff,0,5,30,30
1650409303428,MATH 193A,A03,083781,Staff,0,4,30,30
1650409303428,MATH 193A,A04,083782,Staff,0,4,30,30
1650409309464,MATH 197,001,091859,McAuley; Julian John,9998,0,9999,1
1650409315515,COGS 9,A01,083615,Staff,0,14,60,60
1650409321554,COGS 11,A01,083617,Boyle; Mary E. T.,22,0,40,18
1650409327600,COGS 13,A01,083071,Staff,0,33,40,40
1650409333631,COGS 14A,A01,092681,Staff,0,24,100,100
1650409339662,COGS 14B,A01,083073,Cheng; Tzu-Han,0,11,50,50
1650409345685,COGS 17,A01,092677,Staff,23,0,75,52
1650409351710,COGS 100,A01,083619,Staff,0,26,60,60
1650409357737,COGS 101A,A01,083621,Davis; Joshua Daniel,0,21,60,60
1650409363763,COGS 101B,A01,091572,Staff,0,4,60,60
1650409369789,COGS 101C,A01,083625,Delgado; Tania,16,0,30,14
1650409375815,COGS 107A,A01,083627,Boyle; Mary E. T.,0,11,60,60
1650409381839,COGS 118A,A01,083075,Staff,3,0,60,57
1650409387864,CSE 3,A50,083646,Miranda; Gregory Joseph,21,0,38,17
1650409387864,CSE 3,A51,083647,Miranda; Gregory Joseph,37,0,37,0
1650409393888,CSE 8A,A50,083650,Miranda; Gregory Joseph,0,28,40,40
1650409399916,CSE 11,A01,083080,Cao; Yingjun,0,91,40,40
1650409405943,CSE 12,A01,083652,Staff,0,16,100,100
1650409411981,CSE 15L,A01,083654,Staff,0,1,50,50
1650409411981,CSE 15L,A02,083655,Staff,2,0,50,48
1650409418021,CSE 20,A01,083657,Staff,51,0,80,29
1650409424047,CSE 30,A01,083084,Eldon; John,0,76,40,40
1650409430073,CSE 100,A01,083659,Cao; Yingjun,0,66,50,50
1650409436107,CSE 134B,A01,083661,Powell; Thomas Allan,1,31,65,64
1650409442134,CSE 140,A01,083663,Staff,0,1,75,75
1650409448162,CSE 140L,A01,083088,Eldon; John,0,7,75,75
1650409454185,CSE 175,A01,083665,Kumar; Rakesh,7,0,25,18
1650409460209,CSE 190,A00,092507,Dubnov; Shlomo,14,0,20,6
1650409466234,ECE 45,A01,083139,Staff,0,17,40,40
1650409472259,ECE 65,A50,083695,Staff,0,5,30,30
1650409478287,ECE 109,A01,091882,Touri; Behrouz,39,0,70,31
1650409484309,ECE 180,A00,083140,Abi Samra; Nicholas Camill,23,0,30,7
1650409484309,ECE 180,B00,083141,Abi Samra; Nicholas Camill,1,0,30,29
1650409490333,MATH 10A,A01,083735,Patchell; Gregory David,7,0,30,23
1650409490333,MATH 10A,A02,083736,Patchell; Gregory David,28,0,30,2
1650409490333,MATH 10A,A03,083737,Patchell; Gregory David,25,0,30,5
1650409496358,MATH 10B,A01,083207,Staff,0,8,30,30
1650409496358,MATH 10B,A02,083208,Staff,0,7,30,30
1650409496358,MATH 10B,B01,083739,Staff,15,0,30,15
1650409496358,MATH 10B,B02,083740,Staff,28,0,30,2
1650409502391,MATH 18,A01,083743,Staff,2,0,30,28
1650409502391,MATH 18,A02,083744,Staff,27,0,30,3
1650409502391,MATH 18,A03,083745,Staff,22,0,30,8
1650409502391,MATH 18,A04,083746,Staff,26,0,30,4
1650409502391,MATH 18,B01,083748,Staff,0,11,30,30
1650409502391,MATH 18,B02,083749,Staff,0,12,30,30
1650409502391,MATH 18,B03,083750,Staff,0,12,30,30
1650409502391,MATH 18,B04,083751,Staff,0,10,30,30
1650409517598,MATH 20A,A01,083754,Staff,26,0,40,14
1650409523621,MATH 20B,A01,083756,Staff,0,9,30,30
1650409523621,MATH 20B,A02,083757,Staff,0,8,30,30
1650409529648,MATH 20C,A01,083760,Staff,0,14,30,30
1650409529648,MATH 20C,A02,083761,Staff,1,15,30,29
1650409529648,MATH 20C,B01,083762,Staff,13,0,30,17
1650409529648,MATH 20C,B02,083763,Staff,28,0,30,2
1650409535672,MATH 20D,A01,083765,Staff,0,1,30,30
1650409535672,MATH 20D,A02,083766,Staff,7,0,30,23
1650409535672,MATH 20D,A03,083767,Staff,26,0,30,4
1650409541696,MATH 20E,A01,083771,Staff,5,0,30,25
1650409541696,MATH 20E,A02,083772,Staff,18,0,30,12
1650409541696,MATH 20E,B01,083773,Staff,0,0,30,30
1650409541696,MATH 20E,B02,083774,Staff,12,0,30,18
1650409547726,MATH 103A,A01,083777,Staff,0,11,30,30
1650409547726,MATH 103A,A02,083778,Staff,0,12,30,30
1650409547726,MATH 103A,B01,083779,Staff,0,13,30,30
1650409547726,MATH 103A,B02,083780,Staff,0,11,30,30
1650409553765,MATH 105,A01,085443,Staff,0,22,30,30
1650409559789,MATH 109,A01,083213,Anzaldo; Leesa B,0,7,30,30
1650409559789,MATH 109,A02,083214,Anzaldo; Leesa B,0,7,30,30
1650409559789,MATH 109,B01,083215,Anzaldo; Leesa B,0,5,30,30
1650409559789,MATH 109,B02,083216,Anzaldo; Leesa B,0,6,30,30
1650409565812,MATH 142A,A01,083219,Chow; Bennett,0,14,30,30
1650409565812,MATH 142A,A02,083220,Chow; Bennett,0,13,30,30
1650409565812,MATH 142A,B01,083221,Chow; Bennett,0,12,30,30
1650409565812,MATH 142A,B02,083222,Chow; Bennett,0,13,30,30
1650409571844,MATH 193A,A01,083224,Staff,0,5,30,30
1650409571844,MATH 193A,A02,083225,Staff,0,5,30,30
1650409571844,MATH 193A,A03,083781,Staff,0,4,30,30
1650409571844,MATH 193A,A04,083782,Staff,0,4,30,30
1650409577874,MATH 197,001,091859,McAuley; Julian John,9998,0,9999,1
1650409583930,COGS 9,A01,083615,Staff,0,14,60,60
1650409589954,COGS 11,A01,083617,Boyle; Mary E. T.,21,0,40,19
1650409595977,COGS 13,A01,083071,Staff,0,33,40,40
1650409602002,COGS 14A,A01,092681,Staff,0,25,100,100
1650409608028,COGS 14B,A01,083073,Cheng; Tzu-Han,0,11,50,50
1650409614056,COGS 17,A01,092677,Staff,23,0,75,52
1650409620081,COGS 100,A01,083619,Staff,0,26,60,60
1650409626108,COGS 101A,A01,083621,Davis; Joshua Daniel,0,21,60,60
1650409632153,COGS 101B,A01,091572,Staff,0,4,60,60
1650409638182,COGS 101C,A01,083625,Delgado; Tania,16,0,30,14
1650409644211,COGS 107A,A01,083627,Boyle; Mary E. T.,0,11,60,60
1650409650235,COGS 118A,A01,083075,Staff,3,0,60,57
1650409656259,CSE 3,A50,083646,Miranda; Gregory Joseph,21,0,38,17
1650409656259,CSE 3,A51,083647,Miranda; Gregory Joseph,37,0,37,0
1650409662282,CSE 8A,A50,083650,Miranda; Gregory Joseph,0,28,40,40
1650409668314,CSE 11,A01,083080,Cao; Yingjun,0,91,40,40
1650409674336,CSE 12,A01,083652,Staff,0,16,100,100
1650409680363,CSE 15L,A01,083654,Staff,0,1,50,50
1650409680363,CSE 15L,A02,083655,Staff,2,0,50,48
1650409686399,CSE 20,A01,083657,Staff,51,0,80,29
1650409692422,CSE 30,A01,083084,Eldon; John,0,76,40,40
1650409698449,CSE 100,A01,083659,Cao; Yingjun,0,66,50,50
1650409704486,CSE 134B,A01,083661,Powell; Thomas Allan,1,31,65,64
1650409710507,CSE 140,A01,083663,Staff,0,1,75,75
1650409716540,CSE 140L,A01,083088,Eldon; John,0,7,75,75
1650409722565,CSE 175,A01,083665,Kumar; Rakesh,7,0,25,18
1650409728591,CSE 190,A00,092507,Dubnov; Shlomo,14,0,20,6
1650409734614,ECE 45,A01,083139,Staff,0,17,40,40
1650409740641,ECE 65,A50,083695,Staff,0,5,30,30
1650409746673,ECE 109,A01,091882,Touri; Behrouz,39,0,70,31
1650409752701,ECE 180,A00,083140,Abi Samra; Nicholas Camill,23,0,30,7
1650409752701,ECE 180,B00,083141,Abi Samra; Nicholas Camill,1,0,30,29
1650409758724,MATH 10A,A01,083735,Patchell; Gregory David,7,0,30,23
1650409758724,MATH 10A,A02,083736,Patchell; Gregory David,28,0,30,2
1650409758724,MATH 10A,A03,083737,Patchell; Gregory David,25,0,30,5
1650409764747,MATH 10B,A01,083207,Staff,0,8,30,30
1650409764747,MATH 10B,A02,083208,Staff,0,7,30,30
1650409764747,MATH 10B,B01,083739,Staff,15,0,30,15
1650409764747,MATH 10B,B02,083740,Staff,28,0,30,2
1650409770777,MATH 18,A01,083743,Staff,2,0,30,28
1650409770777,MATH 18,A02,083744,Staff,27,0,30,3
1650409770777,MATH 18,A03,083745,Staff,22,0,30,8
1650409770777,MATH 18,A04,083746,Staff,26,0,30,4
1650409770777,MATH 18,B01,083748,Staff,0,11,30,30
1650409770777,MATH 18,B02,083749,Staff,0,12,30,30
1650409770777,MATH 18,B03,083750,Staff,0,12,30,30
1650409770777,MATH 18,B04,083751,Staff,0,10,30,30
1650409776799,MATH 20A,A01,083754,Staff,26,0,40,14
1650409782824,MATH 20B,A01,083756,Staff,0,9,30,30
1650409782824,MATH 20B,A02,083757,Staff,0,8,30,30
1650409788863,MATH 20C,A01,083760,Staff,0,14,30,30
1650409788863,MATH 20C,A02,083761,Staff,1,15,30,29
1650409788863,MATH 20C,B01,083762,Staff,13,0,30,17
1650409788863,MATH 20C,B02,083763,Staff,28,0,30,2
1650409794902,MATH 20D,A01,083765,Staff,0,1,30,30
1650409794902,MATH 20D,A02,083766,Staff,7,0,30,23
1650409794902,MATH 20D,A03,083767,Staff,26,0,30,4
1650409800927,MATH 20E,A01,083771,Staff,5,0,30,25
1650409800927,MATH 20E,A02,083772,Staff,18,0,30,12
1650409800927,MATH 20E,B01,083773,Staff,0,0,30,30
1650409800927,MATH 20E,B02,083774,Staff,12,0,30,18
1650409806962,MATH 103A,A01,083777,Staff,0,11,30,30
1650409806962,MATH 103A,A02,083778,Staff,0,12,30,30
1650409806962,MATH 103A,B01,083779,Staff,0,13,30,30
1650409806962,MATH 103A,B02,083780,Staff,0,11,30,30
1650409812989,MATH 105,A01,085443,Staff,0,22,30,30
1650409819123,MATH 109,A01,083213,Anzaldo; Leesa B,0,7,30,30
1650409819123,MATH 109,A02,083214,Anzaldo; Leesa B,0,7,30,30
1650409819123,MATH 109,B01,083215,Anzaldo; Leesa B,0,5,30,30
1650409819123,MATH 109,B02,083216,Anzaldo; Leesa B,0,6,30,30
1650409825151,MATH 142A,A01,083219,Chow; Bennett,0,14,30,30
1650409825151,MATH 142A,A02,083220,Chow; Bennett,0,13,30,30
1650409825151,MATH 142A,B01,083221,Chow; Bennett,0,12,30,30
1650409825151,MATH 142A,B02,083222,Chow; Bennett,0,13,30,30
1650409831174,MATH 193A,A01,083224,Staff,0,5,30,30
1650409831174,MATH 193A,A02,083225,Staff,0,5,30,30
1650409831174,MATH 193A,A03,083781,Staff,0,4,30,30
1650409831174,MATH 193A,A04,083782,Staff,0,4,30,30
1650409837199,MATH 197,001,091859,McAuley; Julian John,9998,0,9999,1
1650409843258,COGS 9,A01,083615,Staff,0,14,60,60
1650409849282,COGS 11,A01,083617,Boyle; Mary E. T.,21,0,40,19
1650409855306,COGS 13,A01,083071,Staff,0,33,40,40
1650409861335,COGS 14A,A01,092681,Staff,0,25,100,100
1650409867370,COGS 14B,A01,083073,Cheng; Tzu-Han,0,11,50,50
1650409873398,COGS 17,A01,092677,Staff,23,0,75,52
1650409879421,COGS 100,A01,083619,Staff,0,26,60,60
1650409885444,COGS 101A,A01,083621,Davis; Joshua Daniel,0,21,60,60
1650409891467,COGS 101B,A01,091572,Staff,0,4,60,60
1650409897491,COGS 101C,A01,083625,Delgado; Tania,16,0,30,14
1650409903514,COGS 107A,A01,083627,Boyle; Mary E. T.,0,11,60,60
1650409909539,COGS 118A,A01,083075,Staff,3,0,60,57
1650409915562,CSE 3,A50,083646,Miranda; Gregory Joseph,21,0,38,17
1650409915562,CSE 3,A51,083647,Miranda; Gregory Joseph,37,0,37,0
1650409921593,CSE 8A,A50,083650,Miranda; Gregory Joseph,0,28,40,40
1650409927616,CSE 11,A01,083080,Cao; Yingjun,0,91,40,40
1650409933640,CSE 12,A01,083652,Staff,0,16,100,100
1650409939668,CSE 15L,A01,083654,Staff,0,1,50,50
1650409939668,CSE 15L,A02,083655,Staff,2,0,50,48
1650409945691,CSE 20,A01,083657,Staff,51,0,80,29
1650409951714,CSE 30,A01,083084,Eldon; John,0,76,40,40
1650409957742,CSE 100,A01,083659,Cao; Yingjun,0,66,50,50
1650409963771,CSE 134B,A01,083661,Powell; Thomas Allan,1,31,65,64
1650409969799,CSE 140,A01,083663,Staff,0,1,75,75
1650409975822,CSE 140L,A01,083088,Eldon; John,0,7,75,75
1650409981847,CSE 175,A01,083665,Kumar; Rakesh,7,0,25,18
1650409987872,CSE 190,A00,092507,Dubnov; Shlomo,14,0,20,6
1650409993901,ECE 45,A01,083139,Staff,0,17,40,40
1650409999924,ECE 65,A50,083695,Staff,0,5,30,30
1650410005957,ECE 109,A01,091882,Touri; Behrouz,39,0,70,31
1650410011982,ECE 180,A00,083140,Abi Samra; Nicholas Camill,23,0,30,7
1650410011982,ECE 180,B00,083141,Abi Samra; Nicholas Camill,1,0,30,29
1650410018005,MATH 10A,A01,083735,Patchell; Gregory David,7,0,30,23
1650410018005,MATH 10A,A02,083736,Patchell; Gregory David,28,0,30,2
1650410018005,MATH 10A,A03,083737,Patchell; Gregory David,25,0,30,5
1650410024029,MATH 10B,A01,083207,Staff,0,8,30,30
1650410024029,MATH 10B,A02,083208,Staff,0,7,30,30
1650410024029,MATH 10B,B01,083739,Staff,15,0,30,15
1650410024029,MATH 10B,B02,083740,Staff,28,0,30,2
1650410030053,MATH 18,A01,083743,Staff,2,0,30,28
1650410030053,MATH 18,A02,083744,Staff,27,0,30,3
1650410030053,MATH 18,A03,083745,Staff,22,0,30,8
1650410030053,MATH 18,A04,083746,Staff,26,0,30,4
1650410030053,MATH 18,B01,083748,Staff,0,12,30,30
1650410030053,MATH 18,B02,083749,Staff,0,12,30,30
1650410030053,MATH 18,B03,083750,Staff,0,12,30,30
1650410030053,MATH 18,B04,083751,Staff,0,10,30,30
1650410036076,MATH 20A,A01,083754,Staff,26,0,40,14
1650410042100,MATH 20B,A01,083756,Staff,0,9,30,30
1650410042100,MATH 20B,A02,083757,Staff,0,8,30,30
1650410048128,MATH 20C,A01,083760,Staff,0,14,30,30
1650410048128,MATH 20C,A02,083761,Staff,1,15,30,29
1650410048128,MATH 20C,B01,083762,Staff,13,0,30,17
1650410048128,MATH 20C,B02,083763,Staff,28,0,30,2
1650410054155,MATH 20D,A01,083765,Staff,0,1,30,30
1650410054155,MATH 20D,A02,083766,Staff,7,0,30,23
1650410054155,MATH 20D,A03,083767,Staff,26,0,30,4
1650410060182,MATH 20E,A01,083771,Staff,5,0,30,25
1650410060182,MATH 20E,A02,083772,Staff,18,0,30,12
1650410060182,MATH 20E,B01,083773,Staff,0,0,30,30
1650410060182,MATH 20E,B02,083774,Staff,12,0,30,18
1650410066205,MATH 103A,A01,083777,Staff,0,11,30,30
1650410066205,MATH 103A,A02,083778,Staff,0,12,30,30
1650410066205,MATH 103A,B01,083779,Staff,0,13,30,30
1650410066205,MATH 103A,B02,083780,Staff,0,11,30,30
1650410072238,MATH 105,A01,085443,Staff,0,22,30,30
1650410078275,MATH 109,A01,083213,Anzaldo; Leesa B,0,7,30,30
1650410078275,MATH 109,A02,083214,Anzaldo; Leesa B,0,7,30,30
1650410078275,MATH 109,B01,083215,Anzaldo; Leesa B,0,5,30,30
1650410078275,MATH 109,B02,083216,Anzaldo; Leesa B,0,6,30,30
1650410084297,MATH 142A,A01,083219,Chow; Bennett,0,14,30,30
1650410084297,MATH 142A,A02,083220,Chow; Bennett,0,13,30,30
1650410084297,MATH 142A,B01,083221,Chow; Bennett,0,12,30,30
1650410084297,MATH 142A,B02,083222,Chow; Bennett,0,13,30,30
1650410090323,MATH 193A,A01,083224,Staff,0,5,30,30
1650410090323,MATH 193A,A02,083225,Staff,0,5,30,30
1650410090323,MATH 193A,A03,083781,Staff,0,4,30,30
1650410090323,MATH 193A,A04,083782,Staff,0,4,30,30
1650410096346,MATH 197,001,091859,McAuley; Julian John,9998,0,9999,1
1650410102414,COGS 9,A01,083615,Staff,0,14,60,60
1650410108442,COGS 11,A01,083617,Boyle; Mary E. T.,21,0,40,19
1650410114465,COGS 13,A01,083071,Staff,0,33,40,40
1650410120491,COGS 14A,A01,092681,Staff,0,25,100,100
1650410126514,COGS 14B,A01,083073,Cheng; Tzu-Han,0,11,50,50
1650410132537,COGS 17,A01,092677,Staff,23,0,75,52
1650410138562,COGS 100,A01,083619,Staff,0,26,60,60
1650410144595,COGS 101A,A01,083621,Davis; Joshua Daniel,0,21,60,60
1650410150617,COGS 101B,A01,091572,Staff,0,4,60,60
1650410156656,COGS 101C,A01,083625,Delgado; Tania,16,0,30,14
1650410162685,COGS 107A,A01,083627,Boyle; Mary E. T.,0,11,60,60
1650410168711,COGS 118A,A01,083075,Staff,3,0,60,57
1650410174737,CSE 3,A50,083646,Miranda; Gregory Joseph,21,0,38,17
1650410174737,CSE 3,A51,083647,Miranda; Gregory Joseph,37,0,37,0
1650410180764,CSE 8A,A50,083650,Miranda; Gregory Joseph,0,28,40,40
1650410186799,CSE 11,A01,083080,Cao; Yingjun,0,91,40,40
1650410192823,CSE 12,A01,083652,Staff,0,16,100,100
1650410198859,CSE 15L,A01,083654,Staff,0,1,50,50
1650410198859,CSE 15L,A02,083655,Staff,2,0,50,48
1650410204883,CSE 20,A01,083657,Staff,51,0,80,29
1650410210909,CSE 30,A01,083084,Eldon; John,0,76,40,40
1650410216937,CSE 100,A01,083659,Cao; Yingjun,0,66,50,50
1650410222965,CSE 134B,A01,083661,Powell; Thomas Allan,1,31,65,64
1650410228990,CSE 140,A01,083663,Staff,0,1,75,75
1650410235016,CSE 140L,A01,083088,Eldon; John,0,7,75,75
1650410241043,CSE 175,A01,083665,Kumar; Rakesh,7,0,25,18
1650410247066,CSE 190,A00,092507,Dubnov; Shlomo,14,0,20,6
1650410253100,ECE 45,A01,083139,Staff,0,17,40,40
1650410259126,ECE 65,A50,083695,Staff,0,5,30,30
1650410265149,ECE 109,A01,091882,Touri; Behrouz,39,0,70,31
1650410271173,ECE 180,A00,083140,Abi Samra; Nicholas Camill,23,0,30,7
1650410271173,ECE 180,B00,083141,Abi Samra; Nicholas Camill,1,0,30,29
1650410277200,MATH 10A,A01,083735,Patchell; Gregory David,7,0,30,23
1650410277200,MATH 10A,A02,083736,Patchell; Gregory David,28,0,30,2
1650410277200,MATH 10A,A03,083737,Patchell; Gregory David,25,0,30,5
1650410283228,MATH 10B,A01,083207,Staff,0,8,30,30
1650410283228,MATH 10B,A02,083208,Staff,0,7,30,30
1650410283228,MATH 10B,B01,083739,Staff,15,0,30,15
1650410283228,MATH 10B,B02,083740,Staff,28,0,30,2
1650410289254,MATH 18,A01,083743,Staff,2,0,30,28
1650410289254,MATH 18,A02,083744,Staff,27,0,30,3
1650410289254,MATH 18,A03,083745,Staff,22,0,30,8
1650410289254,MATH 18,A04,083746,Staff,26,0,30,4
1650410289254,MATH 18,B01,083748,Staff,0,12,30,30
1650410289254,MATH 18,B02,083749,Staff,0,12,30,30
1650410289254,MATH 18,B03,083750,Staff,0,12,30,30
1650410289254,MATH 18,B04,083751,Staff,0,10,30,30
1650410295277,MATH 20A,A01,083754,Staff,26,0,40,14
1650410301301,MATH 20B,A01,083756,Staff,0,9,30,30
1650410301301,MATH 20B,A02,083757,Staff,0,8,30,30
1650410307329,MATH 20C,A01,083760,Staff,0,14,30,30
1650410307329,MATH 20C,A02,083761,Staff,1,15,30,29
1650410307329,MATH 20C,B01,083762,Staff,13,0,30,17
1650410307329,MATH 20C,B02,083763,Staff,28,0,30,2
1650410313352,MATH 20D,A01,083765,Staff,0,1,30,30
1650410313352,MATH 20D,A02,083766,Staff,7,0,30,23
1650410313352,MATH 20D,A03,083767,Staff,26,0,30,4
1650410319384,MATH 20E,A01,083771,Staff,5,0,30,25
1650410319384,MATH 20E,A02,083772,Staff,18,0,30,12
1650410319384,MATH 20E,B01,083773,Staff,0,0,30,30
1650410319384,MATH 20E,B02,083774,Staff,12,0,30,18
1650410325407,MATH 103A,A01,083777,Staff,0,11,30,30
1650410325407,MATH 103A,A02,083778,Staff,0,12,30,30
1650410325407,MATH 103A,B01,083779,Staff,0,13,30,30
1650410325407,MATH 103A,B02,083780,Staff,0,11,30,30
1650410331434,MATH 105,A01,085443,Staff,0,22,30,30
1650410337465,MATH 109,A01,083213,Anzaldo; Leesa B,0,7,30,30
1650410337465,MATH 109,A02,083214,Anzaldo; Leesa B,0,7,30,30
1650410337465,MATH 109,B01,083215,Anzaldo; Leesa B,0,5,30,30
1650410337465,MATH 109,B02,083216,Anzaldo; Leesa B,0,6,30,30
1650410343492,MATH 142A,A01,083219,Chow; Bennett,0,14,30,30
1650410343492,MATH 142A,A02,083220,Chow; Bennett,0,13,30,30
1650410343492,MATH 142A,B01,083221,Chow; Bennett,0,12,30,30
1650410343492,MATH 142A,B02,083222,Chow; Bennett,0,13,30,30
1650410349517,MATH 193A,A01,083224,Staff,0,5,30,30
1650410349517,MATH 193A,A02,083225,Staff,0,5,30,30
1650410349517,MATH 193A,A03,083781,Staff,0,4,30,30
1650410349517,MATH 193A,A04,083782,Staff,0,4,30,30
1650410355546,MATH 197,001,091859,McAuley; Julian John,9998,0,9999,1
1650410361600,COGS 9,A01,083615,Staff,0,14,60,60
1650410367623,COGS 11,A01,083617,Boyle; Mary E. T.,21,0,40,19
1650410373645,COGS 13,A01,083071,Staff,0,33,40,40
1650410379669,COGS 14A,A01,092681,Staff,0,25,100,100
1650410385696,COGS 14B,A01,083073,Cheng; Tzu-Han,0,11,50,50
1650410391721,COGS 17,A01,092677,Staff,23,0,75,52
1650410397750,COGS 100,A01,083619,Staff,0,26,60,60
1650410403773,COGS 101A,A01,083621,Davis; Joshua Daniel,0,21,60,60
1650410409893,COGS 101B,A01,091572,Staff,0,4,60,60
1650410415918,COGS 101C,A01,083625,Delgado; Tania,16,0,30,14
1650410421941,COGS 107A,A01,083627,Boyle; Mary E. T.,0,11,60,60
1650410427982,COGS 118A,A01,083075,Staff,3,0,60,57
1650410434017,CSE 3,A50,083646,Miranda; Gregory Joseph,21,0,38,17
1650410434017,CSE 3,A51,083647,Miranda; Gregory Joseph,37,0,37,0
1650410440044,CSE 8A,A50,083650,Miranda; Gregory Joseph,0,28,40,40
1650410446069,CSE 11,A01,083080,Cao; Yingjun,0,91,40,40
1650410452094,CSE 12,A01,083652,Staff,0,16,100,100
1650410458127,CSE 15L,A01,083654,Staff,0,1,50,50
1650410458127,CSE 15L,A02,083655,Staff,2,0,50,48
1650410464153,CSE 20,A01,083657,Staff,51,0,80,29
1650410470178,CSE 30,A01,083084,Eldon; John,0,76,40,40
1650410476205,CSE 100,A01,083659,Cao; Yingjun,0,66,50,50
1650410482231,CSE 134B,A01,083661,Powell; Thomas Allan,1,31,65,64
1650410488253,CSE 140,A01,083663,Staff,0,1,75,75
1650410494283,CSE 140L,A01,083088,Eldon; John,0,7,75,75
1650410500307,CSE 175,A01,083665,Kumar; Rakesh,7,0,25,18
1650410506332,CSE 190,A00,092507,Dubnov; Shlomo,14,0,20,6
1650410512359,ECE 45,A01,083139,Staff,0,17,40,40
1650410518383,ECE 65,A50,083695,Staff,0,5,30,30
1650410524406,ECE 109,A01,091882,Touri; Behrouz,39,0,70,31
1650410530434,ECE 180,A00,083140,Abi Samra; Nicholas Camill,23,0,30,7
1650410530434,ECE 180,B00,083141,Abi Samra; Nicholas Camill,1,0,30,29
1650410536459,MATH 10A,A01,083735,Patchell; Gregory David,7,0,30,23
1650410536459,MATH 10A,A02,083736,Patchell; Gregory David,28,0,30,2
1650410536459,MATH 10A,A03,083737,Patchell; Gregory David,25,0,30,5
1650410542483,MATH 10B,A01,083207,Staff,0,8,30,30
1650410542483,MATH 10B,A02,083208,Staff,0,7,30,30
1650410542483,MATH 10B,B01,083739,Staff,15,0,30,15
1650410542483,MATH 10B,B02,083740,Staff,28,0,30,2
1650410548530,MATH 18,A01,083743,Staff,2,0,30,28
1650410548530,MATH 18,A02,083744,Staff,27,0,30,3
1650410548530,MATH 18,A03,083745,Staff,22,0,30,8
1650410548530,MATH 18,A04,083746,Staff,26,0,30,4
1650410548530,MATH 18,B01,083748,Staff,0,12,30,30
1650410548530,MATH 18,B02,083749,Staff,0,12,30,30
1650410548530,MATH 18,B03,083750,Staff,0,12,30,30
1650410548530,MATH 18,B04,083751,Staff,0,10,30,30
1650410554555,MATH 20A,A01,083754,Staff,25,0,40,15
1650410560582,MATH 20B,A01,083756,Staff,0,9,30,30
1650410560582,MATH 20B,A02,083757,Staff,0,8,30,30
1650410566606,MATH 20C,A01,083760,Staff,0,14,30,30
1650410566606,MATH 20C,A02,083761,Staff,1,15,30,29
1650410566606,MATH 20C,B01,083762,Staff,13,0,30,17
1650410566606,MATH 20C,B02,083763,Staff,28,0,30,2
1650410572631,MATH 20D,A01,083765,Staff,0,1,30,30
1650410572631,MATH 20D,A02,083766,Staff,7,0,30,23
1650410572631,MATH 20D,A03,083767,Staff,26,0,30,4
1650410578658,MATH 20E,A01,083771,Staff,5,0,30,25
1650410578658,MATH 20E,A02,083772,Staff,18,0,30,12
1650410578658,MATH 20E,B01,083773,Staff,0,0,30,30
1650410578658,MATH 20E,B02,083774,Staff,12,0,30,18
1650410584683,MATH 103A,A01,083777,Staff,0,11,30,30
1650410584683,MATH 103A,A02,083778,Staff,0,12,30,30
1650410584683,MATH 103A,B01,083779,Staff,0,13,30,30
1650410584683,MATH 103A,B02,083780,Staff,0,11,30,30
1650410590708,MATH 105,A01,085443,Staff,0,22,30,30
1650410596736,MATH 109,A01,083213,Anzaldo; Leesa B,0,7,30,30
1650410596736,MATH 109,A02,083214,Anzaldo; Leesa B,0,7,30,30
1650410596736,MATH 109,B01,083215,Anzaldo; Leesa B,0,5,30,30
1650410596736,MATH 109,B02,083216,Anzaldo; Leesa B,0,6,30,30
1650410602759,MATH 142A,A01,083219,Chow; Bennett,0,14,30,30
1650410602759,MATH 142A,A02,083220,Chow; Bennett,0,13,30,30
1650410602759,MATH 142A,B01,083221,Chow; Bennett,0,12,30,30
1650410602759,MATH 142A,B02,083222,Chow; Bennett,0,13,30,30
1650410608783,MATH 193A,A01,083224,Staff,0,5,30,30
1650410608783,MATH 193A,A02,083225,Staff,0,5,30,30
1650410608783,MATH 193A,A03,083781,Staff,0,4,30,30
1650410608783,MATH 193A,A04,083782,Staff,0,4,30,30
1650410614808,MATH 197,001,091859,McAuley; Julian John,9998,0,9999,1
1650410620863,COGS 9,A01,083615,Staff,0,14,60,60
1650410626884,COGS 11,A01,083617,Boyle; Mary E. T.,21,0,40,19
1650410632917,COGS 13,A01,083071,Staff,0,33,40,40
1650410638944,COGS 14A,A01,092681,Staff,0,25,100,100
1650410644968,COGS 14B,A01,083073,Cheng; Tzu-Han,0,11,50,50
1650410650994,COGS 17,A01,092677,Staff,23,0,75,52
1650410657025,COGS 100,A01,083619,Staff,0,26,60,60
1650410663047,COGS 101A,A01,083621,Davis; Joshua Daniel,0,21,60,60
1650410669069,COGS 101B,A01,091572,Staff,0,4,60,60
1650410675092,COGS 101C,A01,083625,Delgado; Tania,16,0,30,14
1650410681116,COGS 107A,A01,083627,Boyle; Mary E. T.,0,11,60,60
1650410687138,COGS 118A,A01,083075,Staff,3,0,60,57
1650410693170,CSE 3,A50,083646,Miranda; Gregory Joseph,21,0,38,17
1650410693170,CSE 3,A51,083647,Miranda; Gregory Joseph,37,0,37,0
1650410699204,CSE 8A,A50,083650,Miranda; Gregory Joseph,0,28,40,40
1650410705229,CSE 11,A01,083080,Cao; Yingjun,0,91,40,40
1650410711255,CSE 12,A01,083652,Staff,0,16,100,100
1650410717279,CSE 15L,A01,083654,Staff,0,1,50,50
1650410717279,CSE 15L,A02,083655,Staff,2,0,50,48
1650410723303,CSE 20,A01,083657,Staff,51,0,80,29
1650410729332,CSE 30,A01,083084,Eldon; John,0,76,40,40
1650410735361,CSE 100,A01,083659,Cao; Yingjun,0,66,50,50
1650410741384,CSE 134B,A01,083661,Powell; Thomas Allan,1,31,65,64
1650410747408,CSE 140,A01,083663,Staff,0,1,75,75
1650410753433,CSE 140L,A01,083088,Eldon; John,0,7,75,75
1650410759459,CSE 175,A01,083665,Kumar; Rakesh,7,0,25,18
1650410765484,CSE 190,A00,092507,Dubnov; Shlomo,14,0,20,6
1650410771510,ECE 45,A01,083139,Staff,0,17,40,40
1650410777532,ECE 65,A50,083695,Staff,0,5,30,30
1650410783557,ECE 109,A01,091882,Touri; Behrouz,39,0,70,31
1650410789580,ECE 180,A00,083140,Abi Samra; Nicholas Camill,23,0,30,7
1650410789580,ECE 180,B00,083141,Abi Samra; Nicholas Camill,1,0,30,29
1650410795610,MATH 10A,A01,083735,Patchell; Gregory David,7,0,30,23
1650410795610,MATH 10A,A02,083736,Patchell; Gregory David,28,0,30,2
1650410795610,MATH 10A,A03,083737,Patchell; Gregory David,25,0,30,5
1650410801634,MATH 10B,A01,083207,Staff,0,8,30,30
1650410801634,MATH 10B,A02,083208,Staff,0,7,30,30
1650410801634,MATH 10B,B01,083739,Staff,15,0,30,15
1650410801634,MATH 10B,B02,083740,Staff,28,0,30,2
1650410807667,MATH 18,A01,083743,Staff,2,0,30,28
1650410807667,MATH 18,A02,083744,Staff,27,0,30,3
1650410807667,MATH 18,A03,083745,Staff,22,0,30,8
1650410807667,MATH 18,A04,083746,Staff,26,0,30,4
1650410807667,MATH 18,B01,083748,Staff,0,12,30,30
1650410807667,MATH 18,B02,083749,Staff,0,12,30,30
1650410807667,MATH 18,B03,083750,Staff,0,12,30,30
1650410807667,MATH 18,B04,083751,Staff,0,10,30,30
1650410813689,MATH 20A,A01,083754,Staff,25,0,40,15
1650410819714,MATH 20B,A01,083756,Staff,0,9,30,30
1650410819714,MATH 20B,A02,083757,Staff,0,8,30,30
1650410825737,MATH 20C,A01,083760,Staff,0,14,30,30
1650410825737,MATH 20C,A02,083761,Staff,1,15,30,29
1650410825737,MATH 20C,B01,083762,Staff,13,0,30,17
1650410825737,MATH 20C,B02,083763,Staff,28,0,30,2
1650410831764,MATH 20D,A01,083765,Staff,0,1,30,30
1650410831764,MATH 20D,A02,083766,Staff,7,0,30,23
1650410831764,MATH 20D,A03,083767,Staff,26,0,30,4
1650410837790,MATH 20E,A01,083771,Staff,5,0,30,25
1650410837790,MATH 20E,A02,083772,Staff,18,0,30,12
1650410837790,MATH 20E,B01,083773,Staff,0,0,30,30
1650410837790,MATH 20E,B02,083774,Staff,12,0,30,18
1650410843821,MATH 103A,A01,083777,Staff,0,11,30,30
1650410843821,MATH 103A,A02,083778,Staff,0,12,30,30
1650410843821,MATH 103A,B01,083779,Staff,0,13,30,30
1650410843821,MATH 103A,B02,083780,Staff,0,11,30,30
1650410849853,MATH 105,A01,085443,Staff,0,22,30,30
1650410855881,MATH 109,A01,083213,Anzaldo; Leesa B,0,7,30,30
1650410855881,MATH 109,A02,083214,Anzaldo; Leesa B,0,7,30,30
1650410855881,MATH 109,B01,083215,Anzaldo; Leesa B,0,5,30,30
1650410855881,MATH 109,B02,083216,Anzaldo; Leesa B,0,6,30,30
1650410861908,MATH 142A,A01,083219,Chow; Bennett,0,14,30,30
1650410861908,MATH 142A,A02,083220,Chow; Bennett,0,13,30,30
1650410861908,MATH 142A,B01,083221,Chow; Bennett,0,12,30,30
1650410861908,MATH 142A,B02,083222,Chow; Bennett,0,13,30,30
1650410867935,MATH 193A,A01,083224,Staff,0,5,30,30
1650410867935,MATH 193A,A02,083225,Staff,0,5,30,30
1650410867935,MATH 193A,A03,083781,Staff,0,4,30,30
1650410867935,MATH 193A,A04,083782,Staff,0,4,30,30
1650410873958,MATH 197,001,091859,McAuley; Julian John,9998,0,9999,1
1650410880018,COGS 9,A01,083615,Staff,0,14,60,60
1650410886043,COGS 11,A01,083617,Boyle; Mary E. T.,21,0,40,19
1650410892074,COGS 13,A01,083071,Staff,0,33,40,40
1650410898096,COGS 14A,A01,092681,Staff,0,25,100,100
1650410904129,COGS 14B,A01,083073,Cheng; Tzu-Han,0,11,50,50
1650410910153,COGS 17,A01,092677,Staff,23,0,75,52
1650410916185,COGS 100,A01,083619,Staff,0,26,60,60
1650410922220,COGS 101A,A01,083621,Davis; Joshua Daniel,0,21,60,60
1650410928243,COGS 101B,A01,091572,Staff,0,4,60,60
1650410934266,COGS 101C,A01,083625,Delgado; Tania,16,0,30,14
1650410940290,COGS 107A,A01,083627,Boyle; Mary E. T.,0,11,60,60
1650410946316,COGS 118A,A01,083075,Staff,2,0,60,58
1650410952340,CSE 3,A50,083646,Miranda; Gregory Joseph,21,0,38,17
1650410952340,CSE 3,A51,083647,Miranda; Gregory Joseph,37,0,37,0
1650410958368,CSE 8A,A50,083650,Miranda; Gregory Joseph,0,28,40,40
1650410964395,CSE 11,A01,083080,Cao; Yingjun,0,91,40,40
1650410970425,CSE 12,A01,083652,Staff,0,16,100,100
1650410976451,CSE 15L,A01,083654,Staff,0,1,50,50
1650410976451,CSE 15L,A02,083655,Staff,2,0,50,48
1650410982477,CSE 20,A01,083657,Staff,51,0,80,29
1650410988503,CSE 30,A01,083084,Eldon; John,0,76,40,40
1650410994526,CSE 100,A01,083659,Cao; Yingjun,0,66,50,50
1650411000556,CSE 134B,A01,083661,Powell; Thomas Allan,1,31,65,64
1650411006655,CSE 140,A01,083663,Staff,0,1,75,75
1650411012677,CSE 140L,A01,083088,Eldon; John,0,7,75,75
1650411018712,CSE 175,A01,083665,Kumar; Rakesh,7,0,25,18
1650411024735,CSE 190,A00,092507,Dubnov; Shlomo,14,0,20,6
1650411030761,ECE 45,A01,083139,Staff,0,17,40,40
1650411036785,ECE 65,A50,083695,Staff,0,5,30,30
1650411042816,ECE 109,A01,091882,Touri; Behrouz,39,0,70,31
1650411048839,ECE 180,A00,083140,Abi Samra; Nicholas Camill,23,0,30,7
1650411048839,ECE 180,B00,083141,Abi Samra; Nicholas Camill,1,0,30,29
1650411054863,MATH 10A,A01,083735,Patchell; Gregory David,7,0,30,23
1650411054863,MATH 10A,A02,083736,Patchell; Gregory David,28,0,30,2
1650411054863,MATH 10A,A03,083737,Patchell; Gregory David,25,0,30,5
1650411060897,MATH 10B,A01,083207,Staff,0,8,30,30
1650411060897,MATH 10B,A02,083208,Staff,0,7,30,30
1650411060897,MATH 10B,B01,083739,Staff,15,0,30,15
1650411060897,MATH 10B,B02,083740,Staff,28,0,30,2
1650411066934,MATH 18,A01,083743,Staff,2,0,30,28
1650411066934,MATH 18,A02,083744,Staff,27,0,30,3
1650411066934,MATH 18,A03,083745,Staff,22,0,30,8
1650411066934,MATH 18,A04,083746,Staff,26,0,30,4
1650411066934,MATH 18,B01,083748,Staff,0,12,30,30
1650411066934,MATH 18,B02,083749,Staff,0,12,30,30
1650411066934,MATH 18,B03,083750,Staff,0,12,30,30
1650411066934,MATH 18,B04,083751,Staff,0,10,30,30
1650411072965,MATH 20A,A01,083754,Staff,25,0,40,15
1650411078993,MATH 20B,A01,083756,Staff,0,9,30,30
1650411078993,MATH 20B,A02,083757,Staff,0,8,30,30
1650411085016,MATH 20C,A01,083760,Staff,0,14,30,30
1650411085016,MATH 20C,A02,083761,Staff,1,15,30,29
1650411085016,MATH 20C,B01,083762,Staff,13,0,30,17
1650411085016,MATH 20C,B02,083763,Staff,28,0,30,2
1650411091046,MATH 20D,A01,083765,Staff,0,1,30,30
1650411091046,MATH 20D,A02,083766,Staff,7,0,30,23
1650411091046,MATH 20D,A03,083767,Staff,26,0,30,4
1650411097074,MATH 20E,A01,083771,Staff,5,0,30,25
1650411097074,MATH 20E,A02,083772,Staff,18,0,30,12
1650411097074,MATH 20E,B01,083773,Staff,0,0,30,30
1650411097074,MATH 20E,B02,083774,Staff,12,0,30,18
1650411103103,MATH 103A,A01,083777,Staff,0,11,30,30
1650411103103,MATH 103A,A02,083778,Staff,0,12,30,30
1650411103103,MATH 103A,B01,083779,Staff,0,13,30,30
1650411103103,MATH 103A,B02,083780,Staff,0,11,30,30
1650411109127,MATH 105,A01,085443,Staff,0,22,30,30
1650411115151,MATH 109,A01,083213,Anzaldo; Leesa B,0,7,30,30
1650411115151,MATH 109,A02,083214,Anzaldo; Leesa B,0,7,30,30
1650411115151,MATH 109,B01,083215,Anzaldo; Leesa B,0,5,30,30
1650411115151,MATH 109,B02,083216,Anzaldo; Leesa B,0,6,30,30
1650411121175,MATH 142A,A01,083219,Chow; Bennett,0,14,30,30
1650411121175,MATH 142A,A02,083220,Chow; Bennett,0,13,30,30
1650411121175,MATH 142A,B01,083221,Chow; Bennett,0,12,30,30
1650411121175,MATH 142A,B02,083222,Chow; Bennett,0,13,30,30
1650411127204,MATH 193A,A01,083224,Staff,0,5,30,30
1650411127204,MATH 193A,A02,083225,Staff,0,5,30,30
1650411127204,MATH 193A,A03,083781,Staff,0,4,30,30
1650411127204,MATH 193A,A04,083782,Staff,0,4,30,30
1650411133232,MATH 197,001,091859,McAuley; Julian John,9998,0,9999,1
1650411139283,COGS 9,A01,083615,Staff,0,14,60,60
1650411145309,COGS 11,A01,083617,Boyle; Mary E. T.,21,0,40,19
1650411151345,COGS 13,A01,083071,Staff,0,33,40,40
1650411157368,COGS 14A,A01,092681,Staff,0,25,100,100
1650411163392,COGS 14B,A01,083073,Cheng; Tzu-Han,0,11,50,50
1650411169429,COGS 17,A01,092677,Staff,23,0,75,52
1650411175452,COGS 100,A01,083619,Staff,0,26,60,60
1650411181484,COGS 101A,A01,083621,Davis; Joshua Daniel,0,21,60,60
1650411187511,COGS 101B,A01,091572,Staff,0,4,60,60
1650411193535,COGS 101C,A01,083625,Delgado; Tania,16,0,30,14
1650411199559,COGS 107A,A01,083627,Boyle; Mary E. T.,0,11,60,60
1650411205593,COGS 118A,A01,083075,Staff,2,0,60,58
1650411211621,CSE 3,A50,083646,Miranda; Gregory Joseph,21,0,38,17
1650411211621,CSE 3,A51,083647,Miranda; Gregory Joseph,37,0,37,0
1650411217644,CSE 8A,A50,083650,Miranda; Gregory Joseph,0,28,40,40
1650411223678,CSE 11,A01,083080,Cao; Yingjun,0,91,40,40
1650411229709,CSE 12,A01,083652,Staff,0,16,100,100
1650411235735,CSE 15L,A01,083654,Staff,0,1,50,50
1650411235735,CSE 15L,A02,083655,Staff,2,0,50,48
1650411241759,CSE 20,A01,083657,Staff,51,0,80,29
1650411247785,CSE 30,A01,083084,Eldon; John,0,76,40,40
1650411253809,CSE 100,A01,083659,Cao; Yingjun,0,66,50,50
1650411259833,CSE 134B,A01,083661,Powell; Thomas Allan,1,31,65,64
1650411265858,CSE 140,A01,083663,Staff,0,1,75,75
1650411271884,CSE 140L,A01,083088,Eldon; John,0,7,75,75
1650411277910,CSE 175,A01,083665,Kumar; Rakesh,7,0,25,18
1650411283936,CSE 190,A00,092507,Dubnov; Shlomo,14,0,20,6
1650411289961,ECE 45,A01,083139,Staff,0,17,40,40
1650411295988,ECE 65,A50,083695,Staff,0,5,30,30
1650411302025,ECE 109,A01,091882,Touri; Behrouz,39,0,70,31
1650411308055,ECE 180,A00,083140,Abi Samra; Nicholas Camill,23,0,30,7
1650411308055,ECE 180,B00,083141,Abi Samra; Nicholas Camill,1,0,30,29
1650411314079,MATH 10A,A01,083735,Patchell; Gregory David,7,0,30,23
1650411314079,MATH 10A,A02,083736,Patchell; Gregory David,28,0,30,2
1650411314079,MATH 10A,A03,083737,Patchell; Gregory David,25,0,30,5
1650411320103,MATH 10B,A01,083207,Staff,0,8,30,30
1650411320103,MATH 10B,A02,083208,Staff,0,7,30,30
1650411320103,MATH 10B,B01,083739,Staff,15,0,30,15
1650411320103,MATH 10B,B02,083740,Staff,28,0,30,2
1650411326130,MATH 18,A01,083743,Staff,2,0,30,28
1650411326130,MATH 18,A02,083744,Staff,27,0,30,3
1650411326130,MATH 18,A03,083745,Staff,22,0,30,8
1650411326130,MATH 18,A04,083746,Staff,26,0,30,4
1650411326130,MATH 18,B01,083748,Staff,0,12,30,30
1650411326130,MATH 18,B02,083749,Staff,0,12,30,30
1650411326130,MATH 18,B03,083750,Staff,0,12,30,30
1650411326130,MATH 18,B04,083751,Staff,0,10,30,30
1650411332156,MATH 20A,A01,083754,Staff,25,0,40,15
1650411338182,MATH 20B,A01,083756,Staff,0,9,30,30
1650411338182,MATH 20B,A02,083757,Staff,0,8,30,30
1650411344206,MATH 20C,A01,083760,Staff,0,14,30,30
1650411344206,MATH 20C,A02,083761,Staff,1,15,30,29
1650411344206,MATH 20C,B01,083762,Staff,13,0,30,17
1650411344206,MATH 20C,B02,083763,Staff,28,0,30,2
1650411350237,MATH 20D,A01,083765,Staff,0,1,30,30
1650411350237,MATH 20D,A02,083766,Staff,7,0,30,23
1650411350237,MATH 20D,A03,083767,Staff,26,0,30,4
1650411356271,MATH 20E,A01,083771,Staff,5,0,30,25
1650411356271,MATH 20E,A02,083772,Staff,18,0,30,12
1650411356271,MATH 20E,B01,083773,Staff,0,0,30,30
1650411356271,MATH 20E,B02,083774,Staff,12,0,30,18
1650411362299,MATH 103A,A01,083777,Staff,0,11,30,30
1650411362299,MATH 103A,A02,083778,Staff,0,12,30,30
1650411362299,MATH 103A,B01,083779,Staff,0,13,30,30
1650411362299,MATH 103A,B02,083780,Staff,0,11,30,30
1650411368327,MATH 105,A01,085443,Staff,0,22,30,30
1650411374355,MATH 109,A01,083213,Anzaldo; Leesa B,0,7,30,30
1650411374355,MATH 109,A02,083214,Anzaldo; Leesa B,0,7,30,30
1650411374355,MATH 109,B01,083215,Anzaldo; Leesa B,0,5,30,30
1650411374355,MATH 109,B02,083216,Anzaldo; Leesa B,0,6,30,30
1650411380382,MATH 142A,A01,083219,Chow; Bennett,0,14,30,30
1650411380382,MATH 142A,A02,083220,Chow; Bennett,0,13,30,30
1650411380382,MATH 142A,B01,083221,Chow; Bennett,0,12,30,30
1650411380382,MATH 142A,B02,083222,Chow; Bennett,0,13,30,30
1650411386405,MATH 193A,A01,083224,Staff,0,5,30,30
1650411386405,MATH 193A,A02,083225,Staff,0,5,30,30
1650411386405,MATH 193A,A03,083781,Staff,0,4,30,30
1650411386405,MATH 193A,A04,083782,Staff,0,4,30,30
1650411392430,MATH 197,001,091859,McAuley; Julian John,9998,0,9999,1
1650411398484,COGS 9,A01,083615,Staff,0,14,60,60
1650411404510,COGS 11,A01,083617,Boyle; Mary E. T.,21,0,40,19
1650411410532,COGS 13,A01,083071,Staff,0,33,40,40
1650411416555,COGS 14A,A01,092681,Staff,0,25,100,100
1650411422586,COGS 14B,A01,083073,Cheng; Tzu-Han,0,11,50,50
1650411428611,COGS 17,A01,092677,Staff,23,0,75,52
1650411434644,COGS 100,A01,083619,Staff,0,26,60,60
1650411440669,COGS 101A,A01,083621,Davis; Joshua Daniel,0,21,60,60
1650411446697,COGS 101B,A01,091572,Staff,0,4,60,60
1650411452733,COGS 101C,A01,083625,Delgado; Tania,16,0,30,14
1650411458772,COGS 107A,A01,083627,Boyle; Mary E. T.,0,11,60,60
1650411464797,COGS 118A,A01,083075,Staff,2,0,60,58
1650411470827,CSE 3,A50,083646,Miranda; Gregory Joseph,21,0,38,17
1650411470827,CSE 3,A51,083647,Miranda; Gregory Joseph,37,0,37,0
1650411476850,CSE 8A,A50,083650,Miranda; Gregory Joseph,0,28,40,40
1650411482881,CSE 11,A01,083080,Cao; Yingjun,0,91,40,40
1650411488908,CSE 12,A01,083652,Staff,0,16,100,100
1650411494940,CSE 15L,A01,083654,Staff,0,1,50,50
1650411494940,CSE 15L,A02,083655,Staff,2,0,50,48
1650411500964,CSE 20,A01,083657,Staff,51,0,80,29
1650411506988,CSE 30,A01,083084,Eldon; John,0,76,40,40
1650411513013,CSE 100,A01,083659,Cao; Yingjun,0,66,50,50
1650411519045,CSE 134B,A01,083661,Powell; Thomas Allan,1,31,65,64
1650411525067,CSE 140,A01,083663,Staff,0,1,75,75
1650411531090,CSE 140L,A01,083088,Eldon; John,0,7,75,75
1650411537112,CSE 175,A01,083665,Kumar; Rakesh,7,0,25,18
1650411543137,CSE 190,A00,092507,Dubnov; Shlomo,14,0,20,6
1650411549161,ECE 45,A01,083139,Staff,0,17,40,40
1650411555185,ECE 65,A50,083695,Staff,0,5,30,30
1650411561213,ECE 109,A01,091882,Touri; Behrouz,39,0,70,31
1650411567240,ECE 180,A00,083140,Abi Samra; Nicholas Camill,23,0,30,7
1650411567240,ECE 180,B00,083141,Abi Samra; Nicholas Camill,1,0,30,29
1650411573262,MATH 10A,A01,083735,Patchell; Gregory David,7,0,30,23
1650411573262,MATH 10A,A02,083736,Patchell; Gregory David,28,0,30,2
1650411573262,MATH 10A,A03,083737,Patchell; Gregory David,25,0,30,5
1650411579285,MATH 10B,A01,083207,Staff,0,8,30,30
1650411579285,MATH 10B,A02,083208,Staff,0,7,30,30
1650411579285,MATH 10B,B01,083739,Staff,15,0,30,15
1650411579285,MATH 10B,B02,083740,Staff,28,0,30,2
1650411585309,MATH 18,A01,083743,Staff,2,0,30,28
1650411585309,MATH 18,A02,083744,Staff,27,0,30,3
1650411585309,MATH 18,A03,083745,Staff,22,0,30,8
1650411585309,MATH 18,A04,083746,Staff,26,0,30,4
1650411585309,MATH 18,B01,083748,Staff,0,12,30,30
1650411585309,MATH 18,B02,083749,Staff,0,12,30,30
1650411585309,MATH 18,B03,083750,Staff,0,12,30,30
1650411585309,MATH 18,B04,083751,Staff,0,11,30,30
1650411591336,MATH 20A,A01,083754,Staff,25,0,40,15
1650411597361,MATH 20B,A01,083756,Staff,0,9,30,30
1650411597361,MATH 20B,A02,083757,Staff,0,8,30,30
1650411603478,MATH 20C,A01,083760,Staff,0,14,30,30
1650411603478,MATH 20C,A02,083761,Staff,1,15,30,29
1650411603478,MATH 20C,B01,083762,Staff,13,0,30,17
1650411603478,MATH 20C,B02,083763,Staff,28,0,30,2
1650411609504,MATH 20D,A01,083765,Staff,0,1,30,30
1650411609504,MATH 20D,A02,083766,Staff,7,0,30,23
1650411609504,MATH 20D,A03,083767,Staff,26,0,30,4
1650411615537,MATH 20E,A01,083771,Staff,5,0,30,25
1650411615537,MATH 20E,A02,083772,Staff,18,0,30,12
1650411615537,MATH 20E,B01,083773,Staff,0,0,30,30
1650411615537,MATH 20E,B02,083774,Staff,12,0,30,18
1650411621566,MATH 103A,A01,083777,Staff,0,11,30,30
1650411621566,MATH 103A,A02,083778,Staff,0,12,30,30
1650411621566,MATH 103A,B01,083779,Staff,0,13,30,30
1650411621566,MATH 103A,B02,083780,Staff,0,11,30,30
1650411627591,MATH 105,A01,085443,Staff,0,22,30,30
1650411633619,MATH 109,A01,083213,Anzaldo; Leesa B,0,7,30,30
1650411633619,MATH 109,A02,083214,Anzaldo; Leesa B,0,7,30,30
1650411633619,MATH 109,B01,083215,Anzaldo; Leesa B,0,5,30,30
1650411633619,MATH 109,B02,083216,Anzaldo; Leesa B,0,6,30,30
1650411639651,MATH 142A,A01,083219,Chow; Bennett,0,14,30,30
1650411639651,MATH 142A,A02,083220,Chow; Bennett,0,13,30,30
1650411639651,MATH 142A,B01,083221,Chow; Bennett,0,12,30,30
1650411639651,MATH 142A,B02,083222,Chow; Bennett,0,13,30,30
1650411645688,MATH 193A,A01,083224,Staff,0,5,30,30
1650411645688,MATH 193A,A02,083225,Staff,0,5,30,30
1650411645688,MATH 193A,A03,083781,Staff,0,4,30,30
1650411645688,MATH 193A,A04,083782,Staff,0,4,30,30
1650411651725,MATH 197,001,091859,McAuley; Julian John,9998,0,9999,1
1650411657777,COGS 9,A01,083615,Staff,0,14,60,60
1650411663798,COGS 11,A01,083617,Boyle; Mary E. T.,21,0,40,19
1650411669821,COGS 13,A01,083071,Staff,0,33,40,40
1650411675844,COGS 14A,A01,092681,Staff,0,25,100,100
1650411681878,COGS 14B,A01,083073,Cheng; Tzu-Han,0,11,50,50
1650411687909,COGS 17,A01,092677,Staff,23,0,75,52
1650411693939,COGS 100,A01,083619,Staff,0,26,60,60
1650411699965,COGS 101A,A01,083621,Davis; Joshua Daniel,0,21,60,60
1650411705989,COGS 101B,A01,091572,Staff,0,4,60,60
1650411712015,COGS 101C,A01,083625,Delgado; Tania,16,0,30,14
1650411718041,COGS 107A,A01,083627,Boyle; Mary E. T.,0,11,60,60
1650411724063,COGS 118A,A01,083075,Staff,2,0,60,58
1650411730087,CSE 3,A50,083646,Miranda; Gregory Joseph,21,0,38,17
1650411730087,CSE 3,A51,083647,Miranda; Gregory Joseph,37,0,37,0
1650411736114,CSE 8A,A50,083650,Miranda; Gregory Joseph,0,28,40,40
1650411742149,CSE 11,A01,083080,Cao; Yingjun,0,91,40,40
1650411748177,CSE 12,A01,083652,Staff,0,16,100,100
1650411754200,CSE 15L,A01,083654,Staff,0,1,50,50
1650411754200,CSE 15L,A02,083655,Staff,2,0,50,48
1650411760235,CSE 20,A01,083657,Staff,51,0,80,29
1650411766262,CSE 30,A01,083084,Eldon; John,0,76,40,40
1650411772290,CSE 100,A01,083659,Cao; Yingjun,0,66,50,50
1650411778313,CSE 134B,A01,083661,Powell; Thomas Allan,1,32,65,64
1650411784336,CSE 140,A01,083663,Staff,0,1,75,75
1650411790367,CSE 140L,A01,083088,Eldon; John,0,7,75,75
1650411796393,CSE 175,A01,083665,Kumar; Rakesh,7,0,25,18
1650411802422,CSE 190,A00,092507,Dubnov; Shlomo,14,0,20,6
1650411808459,ECE 45,A01,083139,Staff,0,17,40,40
1650411814490,ECE 65,A50,083695,Staff,0,5,30,30
1650411820520,ECE 109,A01,091882,Touri; Behrouz,39,0,70,31
1650411826562,ECE 180,A00,083140,Abi Samra; Nicholas Camill,23,0,30,7
1650411826562,ECE 180,B00,083141,Abi Samra; Nicholas Camill,1,0,30,29
1650411832585,MATH 10A,A01,083735,Patchell; Gregory David,7,0,30,23
1650411832585,MATH 10A,A02,083736,Patchell; Gregory David,28,0,30,2
1650411832585,MATH 10A,A03,083737,Patchell; Gregory David,25,0,30,5
1650411838620,MATH 10B,A01,083207,Staff,0,8,30,30
1650411838620,MATH 10B,A02,083208,Staff,0,7,30,30
1650411838620,MATH 10B,B01,083739,Staff,15,0,30,15
1650411838620,MATH 10B,B02,083740,Staff,28,0,30,2
1650411844645,MATH 18,A01,083743,Staff,2,0,30,28
1650411844645,MATH 18,A02,083744,Staff,27,0,30,3
1650411844645,MATH 18,A03,083745,Staff,22,0,30,8
1650411844645,MATH 18,A04,083746,Staff,26,0,30,4
1650411844645,MATH 18,B01,083748,Staff,0,12,30,30
1650411844645,MATH 18,B02,083749,Staff,0,12,30,30
1650411844645,MATH 18,B03,083750,Staff,1,12,30,29
1650411844645,MATH 18,B04,083751,Staff,0,11,30,30
1650411850679,MATH 20A,A01,083754,Staff,25,0,40,15
1650411856702,MATH 20B,A01,083756,Staff,0,9,30,30
1650411856702,MATH 20B,A02,083757,Staff,0,8,30,30
1650411862724,MATH 20C,A01,083760,Staff,0,14,30,30
1650411862724,MATH 20C,A02,083761,Staff,1,15,30,29
1650411862724,MATH 20C,B01,083762,Staff,13,0,30,17
1650411862724,MATH 20C,B02,083763,Staff,28,0,30,2
1650411868754,MATH 20D,A01,083765,Staff,0,1,30,30
1650411868754,MATH 20D,A02,083766,Staff,7,0,30,23
1650411868754,MATH 20D,A03,083767,Staff,26,0,30,4
1650411874801,MATH 20E,A01,083771,Staff,5,0,30,25
1650411874801,MATH 20E,A02,083772,Staff,18,0,30,12
1650411874801,MATH 20E,B01,083773,Staff,0,0,30,30
1650411874801,MATH 20E,B02,083774,Staff,12,0,30,18
1650411880824,MATH 103A,A01,083777,Staff,0,11,30,30
1650411880824,MATH 103A,A02,083778,Staff,0,12,30,30
1650411880824,MATH 103A,B01,083779,Staff,0,13,30,30
1650411880824,MATH 103A,B02,083780,Staff,0,11,30,30
1650411886861,MATH 105,A01,085443,Staff,0,22,30,30
1650411892897,MATH 109,A01,083213,Anzaldo; Leesa B,0,7,30,30
1650411892897,MATH 109,A02,083214,Anzaldo; Leesa B,0,7,30,30
1650411892897,MATH 109,B01,083215,Anzaldo; Leesa B,0,5,30,30
1650411892897,MATH 109,B02,083216,Anzaldo; Leesa B,0,6,30,30
1650411898934,MATH 142A,A01,083219,Chow; Bennett,0,14,30,30
1650411898934,MATH 142A,A02,083220,Chow; Bennett,0,13,30,30
1650411898934,MATH 142A,B01,083221,Chow; Bennett,0,12,30,30
1650411898934,MATH 142A,B02,083222,Chow; Bennett,0,13,30,30
1650411904961,MATH 193A,A01,083224,Staff,0,5,30,30
1650411904961,MATH 193A,A02,083225,Staff,0,5,30,30
1650411904961,MATH 193A,A03,083781,Staff,0,4,30,30
1650411904961,MATH 193A,A04,083782,Staff,0,4,30,30
1650411910987,MATH 197,001,091859,McAuley; Julian John,9998,0,9999,1
1650411917052,COGS 9,A01,083615,Staff,0,14,60,60
1650411923087,COGS 11,A01,083617,Boyle; Mary E. T.,21,0,40,19
1650411929109,COGS 13,A01,083071,Staff,0,33,40,40
1650411935136,COGS 14A,A01,092681,Staff,0,25,100,100
1650411941171,COGS 14B,A01,083073,Cheng; Tzu-Han,0,11,50,50
1650411947200,COGS 17,A01,092677,Staff,23,0,75,52
1650411953223,COGS 100,A01,083619,Staff,0,26,60,60
1650411959252,COGS 101A,A01,083621,Davis; Joshua Daniel,0,21,60,60
1650411965288,COGS 101B,A01,091572,Staff,0,4,60,60
1650411971311,COGS 101C,A01,083625,Delgado; Tania,16,0,30,14
1650411977341,COGS 107A,A01,083627,Boyle; Mary E. T.,0,11,60,60
1650411983365,COGS 118A,A01,083075,Staff,2,0,60,58
1650411989389,CSE 3,A50,083646,Miranda; Gregory Joseph,21,0,38,17
1650411989389,CSE 3,A51,083647,Miranda; Gregory Joseph,37,0,37,0
1650411995426,CSE 8A,A50,083650,Miranda; Gregory Joseph,0,28,40,40
1650412001458,CSE 11,A01,083080,Cao; Yingjun,0,91,40,40
1650412007485,CSE 12,A01,083652,Staff,0,16,100,100
1650412013516,CSE 15L,A01,083654,Staff,0,1,50,50
1650412013516,CSE 15L,A02,083655,Staff,2,0,50,48
1650412019542,CSE 20,A01,083657,Staff,51,0,80,29
1650412025579,CSE 30,A01,083084,Eldon; John,0,76,40,40
1650412031605,CSE 100,A01,083659,Cao; Yingjun,0,66,50,50
1650412037631,CSE 134B,A01,083661,Powell; Thomas Allan,1,32,65,64
1650412043661,CSE 140,A01,083663,Staff,0,1,75,75
1650412049690,CSE 140L,A01,083088,Eldon; John,0,7,75,75
1650412055719,CSE 175,A01,083665,Kumar; Rakesh,7,0,25,18
1650412061751,CSE 190,A00,092507,Dubnov; Shlomo,14,0,20,6
1650412067775,ECE 45,A01,083139,Staff,0,17,40,40
1650412073812,ECE 65,A50,083695,Staff,0,5,30,30
1650412079839,ECE 109,A01,091882,Touri; Behrouz,39,0,70,31
1650412085881,ECE 180,A00,083140,Abi Samra; Nicholas Camill,23,0,30,7
1650412085881,ECE 180,B00,083141,Abi Samra; Nicholas Camill,1,0,30,29
1650412091908,MATH 10A,A01,083735,Patchell; Gregory David,7,0,30,23
1650412091908,MATH 10A,A02,083736,Patchell; Gregory David,28,0,30,2
1650412091908,MATH 10A,A03,083737,Patchell; Gregory David,25,0,30,5
1650412097935,MATH 10B,A01,083207,Staff,0,8,30,30
1650412097935,MATH 10B,A02,083208,Staff,0,7,30,30
1650412097935,MATH 10B,B01,083739,Staff,15,0,30,15
1650412097935,MATH 10B,B02,083740,Staff,28,0,30,2
1650412103960,MATH 18,A01,083743,Staff,2,0,30,28
1650412103960,MATH 18,A02,083744,Staff,27,0,30,3
1650412103960,MATH 18,A03,083745,Staff,22,0,30,8
1650412103960,MATH 18,A04,083746,Staff,26,0,30,4
1650412103960,MATH 18,B01,083748,Staff,0,12,30,30
1650412103960,MATH 18,B02,083749,Staff,0,12,30,30
1650412103960,MATH 18,B03,083750,Staff,1,12,30,29
1650412103960,MATH 18,B04,083751,Staff,0,11,30,30
1650412109985,MATH 20A,A01,083754,Staff,25,0,40,15
1650412116019,MATH 20B,A01,083756,Staff,0,9,30,30
1650412116019,MATH 20B,A02,083757,Staff,0,8,30,30
1650412122047,MATH 20C,A01,083760,Staff,0,14,30,30
1650412122047,MATH 20C,A02,083761,Staff,1,15,30,29
1650412122047,MATH 20C,B01,083762,Staff,13,0,30,17
1650412122047,MATH 20C,B02,083763,Staff,28,0,30,2
1650412128072,MATH 20D,A01,083765,Staff,0,1,30,30
1650412128072,MATH 20D,A02,083766,Staff,7,0,30,23
1650412128072,MATH 20D,A03,083767,Staff,26,0,30,4
1650412134104,MATH 20E,A01,083771,Staff,5,0,30,25
1650412134104,MATH 20E,A02,083772,Staff,18,0,30,12
1650412134104,MATH 20E,B01,083773,Staff,0,0,30,30
1650412134104,MATH 20E,B02,083774,Staff,12,0,30,18
1650412140132,MATH 103A,A01,083777,Staff,0,11,30,30
1650412140132,MATH 103A,A02,083778,Staff,0,12,30,30
1650412140132,MATH 103A,B01,083779,Staff,0,13,30,30
1650412140132,MATH 103A,B02,083780,Staff,0,11,30,30
1650412146159,MATH 105,A01,085443,Staff,0,22,30,30
1650412152183,MATH 109,A01,083213,Anzaldo; Leesa B,0,7,30,30
1650412152183,MATH 109,A02,083214,Anzaldo; Leesa B,0,7,30,30
1650412152183,MATH 109,B01,083215,Anzaldo; Leesa B,0,5,30,30
1650412152183,MATH 109,B02,083216,Anzaldo; Leesa B,0,6,30,30
1650412158206,MATH 142A,A01,083219,Chow; Bennett,0,14,30,30
1650412158206,MATH 142A,A02,083220,Chow; Bennett,0,13,30,30
1650412158206,MATH 142A,B01,083221,Chow; Bennett,0,12,30,30
1650412158206,MATH 142A,B02,083222,Chow; Bennett,0,13,30,30
1650412164230,MATH 193A,A01,083224,Staff,0,5,30,30
1650412164230,MATH 193A,A02,083225,Staff,0,5,30,30
1650412164230,MATH 193A,A03,083781,Staff,0,4,30,30
1650412164230,MATH 193A,A04,083782,Staff,0,4,30,30
1650412170268,MATH 197,001,091859,McAuley; Julian John,9998,0,9999,1
1650412176322,COGS 9,A01,083615,Staff,0,14,60,60
1650412182346,COGS 11,A01,083617,Boyle; Mary E. T.,21,0,40,19
1650412188373,COGS 13,A01,083071,Staff,0,33,40,40
1650412194519,COGS 14A,A01,092681,Staff,0,25,100,100
1650412200550,COGS 14B,A01,083073,Cheng; Tzu-Han,0,11,50,50
1650412206582,COGS 17,A01,092677,Staff,23,0,75,52
1650412212605,COGS 100,A01,083619,Staff,0,26,60,60
1650412218631,COGS 101A,A01,083621,Davis; Joshua Daniel,0,21,60,60
1650412224656,COGS 101B,A01,091572,Staff,0,4,60,60
1650412230691,COGS 101C,A01,083625,Delgado; Tania,16,0,30,14
1650412236715,COGS 107A,A01,083627,Boyle; Mary E. T.,0,11,60,60
1650412242740,COGS 118A,A01,083075,Staff,2,0,60,58
1650412248766,CSE 3,A50,083646,Miranda; Gregory Joseph,21,0,38,17
1650412248766,CSE 3,A51,083647,Miranda; Gregory Joseph,37,0,37,0
1650412254789,CSE 8A,A50,083650,Miranda; Gregory Joseph,0,27,40,40
1650412260823,CSE 11,A01,083080,Cao; Yingjun,0,91,40,40
1650412266850,CSE 12,A01,083652,Staff,0,16,100,100
1650412272880,CSE 15L,A01,083654,Staff,0,1,50,50
1650412272880,CSE 15L,A02,083655,Staff,2,0,50,48
1650412278911,CSE 20,A01,083657,Staff,51,0,80,29
1650412284939,CSE 30,A01,083084,Eldon; John,0,76,40,40
1650412290969,CSE 100,A01,083659,Cao; Yingjun,0,66,50,50
1650412297000,CSE 134B,A01,083661,Powell; Thomas Allan,1,32,65,64
1650412303024,CSE 140,A01,083663,Staff,0,1,75,75
1650412309050,CSE 140L,A01,083088,Eldon; John,0,7,75,75
1650412315075,CSE 175,A01,083665,Kumar; Rakesh,7,0,25,18
1650412321108,CSE 190,A00,092507,Dubnov; Shlomo,14,0,20,6
1650412327131,ECE 45,A01,083139,Staff,0,17,40,40
1650412333159,ECE 65,A50,083695,Staff,0,5,30,30
1650412339182,ECE 109,A01,091882,Touri; Behrouz,39,0,70,31
1650412345211,ECE 180,A00,083140,Abi Samra; Nicholas Camill,23,0,30,7
1650412345211,ECE 180,B00,083141,Abi Samra; Nicholas Camill,1,0,30,29
1650412351238,MATH 10A,A01,083735,Patchell; Gregory David,7,0,30,23
1650412351238,MATH 10A,A02,083736,Patchell; Gregory David,28,0,30,2
1650412351238,MATH 10A,A03,083737,Patchell; Gregory David,25,0,30,5
1650412357264,MATH 10B,A01,083207,Staff,0,8,30,30
1650412357264,MATH 10B,A02,083208,Staff,0,7,30,30
1650412357264,MATH 10B,B01,083739,Staff,15,0,30,15
1650412357264,MATH 10B,B02,083740,Staff,28,0,30,2
1650412363293,MATH 18,A01,083743,Staff,2,0,30,28
1650412363293,MATH 18,A02,083744,Staff,27,0,30,3
1650412363293,MATH 18,A03,083745,Staff,22,0,30,8
1650412363293,MATH 18,A04,083746,Staff,26,0,30,4
1650412363293,MATH 18,B01,083748,Staff,0,12,30,30
1650412363293,MATH 18,B02,083749,Staff,0,12,30,30
1650412363293,MATH 18,B03,083750,Staff,1,12,30,29
1650412363293,MATH 18,B04,083751,Staff,0,11,30,30
1650412369319,MATH 20A,A01,083754,Staff,25,0,40,15
1650412375346,MATH 20B,A01,083756,Staff,0,9,30,30
1650412375346,MATH 20B,A02,083757,Staff,0,8,30,30
1650412381369,MATH 20C,A01,083760,Staff,0,14,30,30
1650412381369,MATH 20C,A02,083761,Staff,1,15,30,29
1650412381369,MATH 20C,B01,083762,Staff,13,0,30,17
1650412381369,MATH 20C,B02,083763,Staff,28,0,30,2
1650412387404,MATH 20D,A01,083765,Staff,0,1,30,30
1650412387404,MATH 20D,A02,083766,Staff,7,0,30,23
1650412387404,MATH 20D,A03,083767,Staff,26,0,30,4
1650412393431,MATH 20E,A01,083771,Staff,5,0,30,25
1650412393431,MATH 20E,A02,083772,Staff,18,0,30,12
1650412393431,MATH 20E,B01,083773,Staff,0,0,30,30
1650412393431,MATH 20E,B02,083774,Staff,12,0,30,18
1650412399454,MATH 103A,A01,083777,Staff,0,11,30,30
1650412399454,MATH 103A,A02,083778,Staff,0,12,30,30
1650412399454,MATH 103A,B01,083779,Staff,0,13,30,30
1650412399454,MATH 103A,B02,083780,Staff,0,11,30,30
1650412405480,MATH 105,A01,085443,Staff,0,22,30,30
1650412411511,MATH 109,A01,083213,Anzaldo; Leesa B,0,7,30,30
1650412411511,MATH 109,A02,083214,Anzaldo; Leesa B,0,7,30,30
1650412411511,MATH 109,B01,083215,Anzaldo; Leesa B,0,5,30,30
1650412411511,MATH 109,B02,083216,Anzaldo; Leesa B,0,6,30,30
1650412417542,MATH 142A,A01,083219,Chow; Bennett,0,14,30,30
1650412417542,MATH 142A,A02,083220,Chow; Bennett,0,13,30,30
1650412417542,MATH 142A,B01,083221,Chow; Bennett,0,12,30,30
1650412417542,MATH 142A,B02,083222,Chow; Bennett,0,13,30,30
1650412423567,MATH 193A,A01,083224,Staff,0,5,30,30
1650412423567,MATH 193A,A02,083225,Staff,0,5,30,30
1650412423567,MATH 193A,A03,083781,Staff,0,4,30,30
1650412423567,MATH 193A,A04,083782,Staff,0,4,30,30
1650412429594,MATH 197,001,091859,McAuley; Julian John,9998,0,9999,1
1650412435643,COGS 9,A01,083615,Staff,0,14,60,60
1650412441678,COGS 11,A01,083617,Boyle; Mary E. T.,21,0,40,19
1650412447701,COGS 13,A01,083071,Staff,0,33,40,40
1650412453730,COGS 14A,A01,092681,Staff,0,25,100,100
1650412459757,COGS 14B,A01,083073,Cheng; Tzu-Han,0,11,50,50
1650412465780,COGS 17,A01,092677,Staff,23,0,75,52
1650412471804,COGS 100,A01,083619,Staff,0,26,60,60
1650412477828,COGS 101A,A01,083621,Davis; Joshua Daniel,0,21,60,60
1650412483850,COGS 101B,A01,091572,Staff,0,4,60,60
1650412489873,COGS 101C,A01,083625,Delgado; Tania,16,0,30,14
1650412495907,COGS 107A,A01,083627,Boyle; Mary E. T.,0,11,60,60
1650412501937,COGS 118A,A01,083075,Staff,2,0,60,58
1650412507963,CSE 3,A50,083646,Miranda; Gregory Joseph,21,0,38,17
1650412507963,CSE 3,A51,083647,Miranda; Gregory Joseph,37,0,37,0
1650412513997,CSE 8A,A50,083650,Miranda; Gregory Joseph,0,27,40,40
1650412520023,CSE 11,A01,083080,Cao; Yingjun,0,91,40,40
1650412526045,CSE 12,A01,083652,Staff,0,16,100,100
1650412532067,CSE 15L,A01,083654,Staff,0,1,50,50
1650412532067,CSE 15L,A02,083655,Staff,2,0,50,48
1650412538092,CSE 20,A01,083657,Staff,51,0,80,29
1650412544119,CSE 30,A01,083084,Eldon; John,0,76,40,40
1650412550143,CSE 100,A01,083659,Cao; Yingjun,0,66,50,50
1650412556165,CSE 134B,A01,083661,Powell; Thomas Allan,1,32,65,64
1650412562197,CSE 140,A01,083663,Staff,0,1,75,75
1650412568223,CSE 140L,A01,083088,Eldon; John,0,7,75,75
1650412574251,CSE 175,A01,083665,Kumar; Rakesh,7,0,25,18
1650412580276,CSE 190,A00,092507,Dubnov; Shlomo,14,0,20,6
1650412586299,ECE 45,A01,083139,Staff,0,17,40,40
1650412592329,ECE 65,A50,083695,Staff,0,5,30,30
1650412598352,ECE 109,A01,091882,Touri; Behrouz,39,0,70,31
1650412604374,ECE 180,A00,083140,Abi Samra; Nicholas Camill,23,0,30,7
1650412604374,ECE 180,B00,083141,Abi Samra; Nicholas Camill,1,0,30,29
1650412610397,MATH 10A,A01,083735,Patchell; Gregory David,7,0,30,23
1650412610397,MATH 10A,A02,083736,Patchell; Gregory David,28,0,30,2
1650412610397,MATH 10A,A03,083737,Patchell; Gregory David,25,0,30,5
1650412616421,MATH 10B,A01,083207,Staff,0,8,30,30
1650412616421,MATH 10B,A02,083208,Staff,0,7,30,30
1650412616421,MATH 10B,B01,083739,Staff,15,0,30,15
1650412616421,MATH 10B,B02,083740,Staff,28,0,30,2
1650412622453,MATH 18,A01,083743,Staff,2,0,30,28
1650412622453,MATH 18,A02,083744,Staff,27,0,30,3
1650412622453,MATH 18,A03,083745,Staff,22,0,30,8
1650412622453,MATH 18,A04,083746,Staff,26,0,30,4
1650412622453,MATH 18,B01,083748,Staff,1,12,30,29
1650412622453,MATH 18,B02,083749,Staff,0,12,30,30
1650412622453,MATH 18,B03,083750,Staff,1,12,30,29
1650412622453,MATH 18,B04,083751,Staff,0,11,30,30
1650412628479,MATH 20A,A01,083754,Staff,25,0,40,15
1650412634511,MATH 20B,A01,083756,Staff,0,9,30,30
1650412634511,MATH 20B,A02,083757,Staff,0,8,30,30
1650412640534,MATH 20C,A01,083760,Staff,0,14,30,30
1650412640534,MATH 20C,A02,083761,Staff,1,15,30,29
1650412640534,MATH 20C,B01,083762,Staff,13,0,30,17
1650412640534,MATH 20C,B02,083763,Staff,28,0,30,2
1650412646559,MATH 20D,A01,083765,Staff,0,1,30,30
1650412646559,MATH 20D,A02,083766,Staff,7,0,30,23
1650412646559,MATH 20D,A03,083767,Staff,26,0,30,4
1650412652593,MATH 20E,A01,083771,Staff,5,0,30,25
1650412652593,MATH 20E,A02,083772,Staff,18,0,30,12
1650412652593,MATH 20E,B01,083773,Staff,0,0,30,30
1650412652593,MATH 20E,B02,083774,Staff,12,0,30,18
1650412658621,MATH 103A,A01,083777,Staff,0,11,30,30
1650412658621,MATH 103A,A02,083778,Staff,0,12,30,30
1650412658621,MATH 103A,B01,083779,Staff,0,13,30,30
1650412658621,MATH 103A,B02,083780,Staff,0,11,30,30
1650412664643,MATH 105,A01,085443,Staff,0,22,30,30
1650412670673,MATH 109,A01,083213,Anzaldo; Leesa B,0,7,30,30
1650412670673,MATH 109,A02,083214,Anzaldo; Leesa B,0,7,30,30
1650412670673,MATH 109,B01,083215,Anzaldo; Leesa B,0,5,30,30
1650412670673,MATH 109,B02,083216,Anzaldo; Leesa B,0,6,30,30
1650412676708,MATH 142A,A01,083219,Chow; Bennett,0,14,30,30
1650412676708,MATH 142A,A02,083220,Chow; Bennett,0,13,30,30
1650412676708,MATH 142A,B01,083221,Chow; Bennett,0,12,30,30
1650412676708,MATH 142A,B02,083222,Chow; Bennett,0,13,30,30
1650412682735,MATH 193A,A01,083224,Staff,0,5,30,30
1650412682735,MATH 193A,A02,083225,Staff,0,5,30,30
1650412682735,MATH 193A,A03,083781,Staff,0,4,30,30
1650412682735,MATH 193A,A04,083782,Staff,0,4,30,30
1650412688759,MATH 197,001,091859,McAuley; Julian John,9998,0,9999,1
1650412694819,COGS 9,A01,083615,Staff,0,14,60,60
1650412700842,COGS 11,A01,083617,Boyle; Mary E. T.,21,0,40,19
1650412706865,COGS 13,A01,083071,Staff,0,33,40,40
1650412712889,COGS 14A,A01,092681,Staff,0,25,100,100
1650412718912,COGS 14B,A01,083073,Cheng; Tzu-Han,0,11,50,50
1650412724943,COGS 17,A01,092677,Staff,23,0,75,52
1650412730967,COGS 100,A01,083619,Staff,0,26,60,60
1650412736993,COGS 101A,A01,083621,Davis; Joshua Daniel,0,21,60,60
1650412743016,COGS 101B,A01,091572,Staff,0,4,60,60
1650412749039,COGS 101C,A01,083625,Delgado; Tania,16,0,30,14
1650412755062,COGS 107A,A01,083627,Boyle; Mary E. T.,0,11,60,60
1650412761090,COGS 118A,A01,083075,Staff,2,0,60,58
1650412767114,CSE 3,A50,083646,Miranda; Gregory Joseph,21,0,38,17
1650412767114,CSE 3,A51,083647,Miranda; Gregory Joseph,37,0,37,0
1650412773142,CSE 8A,A50,083650,Miranda; Gregory Joseph,0,27,40,40
1650412779175,CSE 11,A01,083080,Cao; Yingjun,0,91,40,40
1650412785200,CSE 12,A01,083652,Staff,0,16,100,100
1650412791334,CSE 15L,A01,083654,Staff,0,1,50,50
1650412791334,CSE 15L,A02,083655,Staff,2,0,50,48
1650412797374,CSE 20,A01,083657,Staff,51,0,80,29
1650412803407,CSE 30,A01,083084,Eldon; John,0,76,40,40
1650412809434,CSE 100,A01,083659,Cao; Yingjun,0,66,50,50
1650412815472,CSE 134B,A01,083661,Powell; Thomas Allan,1,32,65,64
1650412821503,CSE 140,A01,083663,Staff,0,1,75,75
1650412827525,CSE 140L,A01,083088,Eldon; John,0,7,75,75
1650412833549,CSE 175,A01,083665,Kumar; Rakesh,7,0,25,18
1650412839573,CSE 190,A00,092507,Dubnov; Shlomo,14,0,20,6
1650412845598,ECE 45,A01,083139,Staff,0,17,40,40
1650412851625,ECE 65,A50,083695,Staff,0,5,30,30
1650412857647,ECE 109,A01,091882,Touri; Behrouz,39,0,70,31
1650412863674,ECE 180,A00,083140,Abi Samra; Nicholas Camill,23,0,30,7
1650412863674,ECE 180,B00,083141,Abi Samra; Nicholas Camill,1,0,30,29
1650412869706,MATH 10A,A01,083735,Patchell; Gregory David,7,0,30,23
1650412869706,MATH 10A,A02,083736,Patchell; Gregory David,28,0,30,2
1650412869706,MATH 10A,A03,083737,Patchell; Gregory David,25,0,30,5
1650412875736,MATH 10B,A01,083207,Staff,0,8,30,30
1650412875736,MATH 10B,A02,083208,Staff,0,7,30,30
1650412875736,MATH 10B,B01,083739,Staff,15,0,30,15
1650412875736,MATH 10B,B02,083740,Staff,28,0,30,2
1650412881769,MATH 18,A01,083743,Staff,2,0,30,28
1650412881769,MATH 18,A02,083744,Staff,27,0,30,3
1650412881769,MATH 18,A03,083745,Staff,22,0,30,8
1650412881769,MATH 18,A04,083746,Staff,26,0,30,4
1650412881769,MATH 18,B01,083748,Staff,1,12,30,29
1650412881769,MATH 18,B02,083749,Staff,0,12,30,30
1650412881769,MATH 18,B03,083750,Staff,1,12,30,29
1650412881769,MATH 18,B04,083751,Staff,0,11,30,30
1650412887806,MATH 20A,A01,083754,Staff,25,0,40,15
1650412893831,MATH 20B,A01,083756,Staff,0,9,30,30
1650412893831,MATH 20B,A02,083757,Staff,0,8,30,30
1650412899858,MATH 20C,A01,083760,Staff,0,14,30,30
1650412899858,MATH 20C,A02,083761,Staff,1,15,30,29
1650412899858,MATH 20C,B01,083762,Staff,13,0,30,17
1650412899858,MATH 20C,B02,083763,Staff,28,0,30,2
1650412905882,MATH 20D,A01,083765,Staff,0,1,30,30
1650412905882,MATH 20D,A02,083766,Staff,7,0,30,23
1650412905882,MATH 20D,A03,083767,Staff,26,0,30,4
1650412911907,MATH 20E,A01,083771,Staff,5,0,30,25
1650412911907,MATH 20E,A02,083772,Staff,18,0,30,12
1650412911907,MATH 20E,B01,083773,Staff,0,0,30,30
1650412911907,MATH 20E,B02,083774,Staff,12,0,30,18
1650412917931,MATH 103A,A01,083777,Staff,0,11,30,30
1650412917931,MATH 103A,A02,083778,Staff,0,12,30,30
1650412917931,MATH 103A,B01,083779,Staff,0,13,30,30
1650412917931,MATH 103A,B02,083780,Staff,0,11,30,30
1650412923955,MATH 105,A01,085443,Staff,0,22,30,30
1650412929993,MATH 109,A01,083213,Anzaldo; Leesa B,0,7,30,30
1650412929993,MATH 109,A02,083214,Anzaldo; Leesa B,0,7,30,30
1650412929993,MATH 109,B01,083215,Anzaldo; Leesa B,0,5,30,30
1650412929993,MATH 109,B02,083216,Anzaldo; Leesa B,0,6,30,30
1650412936018,MATH 142A,A01,083219,Chow; Bennett,0,14,30,30
1650412936018,MATH 142A,A02,083220,Chow; Bennett,0,13,30,30
1650412936018,MATH 142A,B01,083221,Chow; Bennett,0,12,30,30
1650412936018,MATH 142A,B02,083222,Chow; Bennett,0,13,30,30
1650412942049,MATH 193A,A01,083224,Staff,0,5,30,30
1650412942049,MATH 193A,A02,083225,Staff,0,5,30,30
1650412942049,MATH 193A,A03,083781,Staff,0,4,30,30
1650412942049,MATH 193A,A04,083782,Staff,0,4,30,30
1650412948076,MATH 197,001,091859,McAuley; Julian John,9998,0,9999,1
1650412954128,COGS 9,A01,083615,Staff,0,14,60,60
1650412960162,COGS 11,A01,083617,Boyle; Mary E. T.,21,0,40,19
1650412966187,COGS 13,A01,083071,Staff,0,33,40,40
1650412972216,COGS 14A,A01,092681,Staff,0,25,100,100
1650412978249,COGS 14B,A01,083073,Cheng; Tzu-Han,0,11,50,50
1650412984280,COGS 17,A01,092677,Staff,23,0,75,52
1650412990303,COGS 100,A01,083619,Staff,0,26,60,60
1650412996332,COGS 101A,A01,083621,Davis; Joshua Daniel,0,21,60,60
1650413002356,COGS 101B,A01,091572,Staff,0,4,60,60
1650413008388,COGS 101C,A01,083625,Delgado; Tania,16,0,30,14
1650413014429,COGS 107A,A01,083627,Boyle; Mary E. T.,0,11,60,60
1650413020453,COGS 118A,A01,083075,Staff,2,0,60,58
1650413026482,CSE 3,A50,083646,Miranda; Gregory Joseph,21,0,38,17
1650413026482,CSE 3,A51,083647,Miranda; Gregory Joseph,37,0,37,0
1650413032515,CSE 8A,A50,083650,Miranda; Gregory Joseph,0,27,40,40
1650413038544,CSE 11,A01,083080,Cao; Yingjun,0,91,40,40
1650413044573,CSE 12,A01,083652,Staff,0,16,100,100
1650413050600,CSE 15L,A01,083654,Staff,0,1,50,50
1650413050600,CSE 15L,A02,083655,Staff,2,0,50,48
1650413056624,CSE 20,A01,083657,Staff,51,0,80,29
1650413062649,CSE 30,A01,083084,Eldon; John,0,76,40,40
1650413068672,CSE 100,A01,083659,Cao; Yingjun,0,66,50,50
1650413074707,CSE 134B,A01,083661,Powell; Thomas Allan,1,32,65,64
1650413080739,CSE 140,A01,083663,Staff,0,1,75,75
1650413086771,CSE 140L,A01,083088,Eldon; John,0,7,75,75
1650413092795,CSE 175,A01,083665,Kumar; Rakesh,7,0,25,18
1650413098822,CSE 190,A00,092507,Dubnov; Shlomo,14,0,20,6
1650413104851,ECE 45,A01,083139,Staff,0,17,40,40
1650413110878,ECE 65,A50,083695,Staff,0,5,30,30
1650413116904,ECE 109,A01,091882,Touri; Behrouz,39,0,70,31
1650413122932,ECE 180,A00,083140,Abi Samra; Nicholas Camill,23,0,30,7
1650413122932,ECE 180,B00,083141,Abi Samra; Nicholas Camill,1,0,30,29
1650413128960,MATH 10A,A01,083735,Patchell; Gregory David,7,0,30,23
1650413128960,MATH 10A,A02,083736,Patchell; Gregory David,28,0,30,2
1650413128960,MATH 10A,A03,083737,Patchell; Gregory David,25,0,30,5
1650413134987,MATH 10B,A01,083207,Staff,0,8,30,30
1650413134987,MATH 10B,A02,083208,Staff,0,7,30,30
1650413134987,MATH 10B,B01,083739,Staff,15,0,30,15
1650413134987,MATH 10B,B02,083740,Staff,28,0,30,2
1650413141016,MATH 18,A01,083743,Staff,2,0,30,28
1650413141016,MATH 18,A02,083744,Staff,27,0,30,3
1650413141016,MATH 18,A03,083745,Staff,22,0,30,8
1650413141016,MATH 18,A04,083746,Staff,26,0,30,4
1650413141016,MATH 18,B01,083748,Staff,1,12,30,29
1650413141016,MATH 18,B02,083749,Staff,0,12,30,30
1650413141016,MATH 18,B03,083750,Staff,1,12,30,29
1650413141016,MATH 18,B04,083751,Staff,0,11,30,30
1650413147051,MATH 20A,A01,083754,Staff,25,0,40,15
1650413153080,MATH 20B,A01,083756,Staff,0,9,30,30
1650413153080,MATH 20B,A02,083757,Staff,0,8,30,30
1650413159116,MATH 20C,A01,083760,Staff,0,14,30,30
1650413159116,MATH 20C,A02,083761,Staff,1,15,30,29
1650413159116,MATH 20C,B01,083762,Staff,13,0,30,17
1650413159116,MATH 20C,B02,083763,Staff,28,0,30,2
1650413165139,MATH 20D,A01,083765,Staff,0,1,30,30
1650413165139,MATH 20D,A02,083766,Staff,7,0,30,23
1650413165139,MATH 20D,A03,083767,Staff,26,0,30,4
1650413171165,MATH 20E,A01,083771,Staff,5,0,30,25
1650413171165,MATH 20E,A02,083772,Staff,18,0,30,12
1650413171165,MATH 20E,B01,083773,Staff,0,0,30,30
1650413171165,MATH 20E,B02,083774,Staff,12,0,30,18
1650413177199,MATH 103A,A01,083777,Staff,0,11,30,30
1650413177199,MATH 103A,A02,083778,Staff,0,12,30,30
1650413177199,MATH 103A,B01,083779,Staff,0,13,30,30
1650413177199,MATH 103A,B02,083780,Staff,0,11,30,30
1650413183228,MATH 105,A01,085443,Staff,0,22,30,30
1650413189252,MATH 109,A01,083213,Anzaldo; Leesa B,0,7,30,30
1650413189252,MATH 109,A02,083214,Anzaldo; Leesa B,0,7,30,30
1650413189252,MATH 109,B01,083215,Anzaldo; Leesa B,0,5,30,30
1650413189252,MATH 109,B02,083216,Anzaldo; Leesa B,0,6,30,30
1650413195277,MATH 142A,A01,083219,Chow; Bennett,0,14,30,30
1650413195277,MATH 142A,A02,083220,Chow; Bennett,0,13,30,30
1650413195277,MATH 142A,B01,083221,Chow; Bennett,0,12,30,30
1650413195277,MATH 142A,B02,083222,Chow; Bennett,0,13,30,30
1650413201308,MATH 193A,A01,083224,Staff,0,5,30,30
1650413201308,MATH 193A,A02,083225,Staff,0,5,30,30
1650413201308,MATH 193A,A03,083781,Staff,0,4,30,30
1650413201308,MATH 193A,A04,083782,Staff,0,4,30,30
1650413207331,MATH 197,001,091859,McAuley; Julian John,9998,0,9999,1
1650413213392,COGS 9,A01,083615,Staff,0,14,60,60
1650413219419,COGS 11,A01,083617,Boyle; Mary E. T.,21,0,40,19
1650413225446,COGS 13,A01,083071,Staff,0,33,40,40
1650413231468,COGS 14A,A01,092681,Staff,0,25,100,100
1650413237492,COGS 14B,A01,083073,Cheng; Tzu-Han,0,11,50,50
1650413243524,COGS 17,A01,092677,Staff,23,0,75,52
1650413249552,COGS 100,A01,083619,Staff,0,26,60,60
1650413255580,COGS 101A,A01,083621,Davis; Joshua Daniel,0,21,60,60
1650413261619,COGS 101B,A01,091572,Staff,0,4,60,60
1650413267647,COGS 101C,A01,083625,Delgado; Tania,16,0,30,14
1650413273672,COGS 107A,A01,083627,Boyle; Mary E. T.,0,11,60,60
1650413279696,COGS 118A,A01,083075,Staff,2,0,60,58
1650413285726,CSE 3,A50,083646,Miranda; Gregory Joseph,21,0,38,17
1650413285726,CSE 3,A51,083647,Miranda; Gregory Joseph,37,0,37,0
1650413291747,CSE 8A,A50,083650,Miranda; Gregory Joseph,0,27,40,40
1650413297771,CSE 11,A01,083080,Cao; Yingjun,0,91,40,40
1650413303794,CSE 12,A01,083652,Staff,0,16,100,100
1650413309818,CSE 15L,A01,083654,Staff,0,1,50,50
1650413309818,CSE 15L,A02,083655,Staff,2,0,50,48
1650413315841,CSE 20,A01,083657,Staff,51,0,80,29
1650413321868,CSE 30,A01,083084,Eldon; John,0,76,40,40
1650413327890,CSE 100,A01,083659,Cao; Yingjun,0,66,50,50
1650413333915,CSE 134B,A01,083661,Powell; Thomas Allan,1,32,65,64
1650413339941,CSE 140,A01,083663,Staff,0,1,75,75
1650413345964,CSE 140L,A01,083088,Eldon; John,0,7,75,75
1650413351986,CSE 175,A01,083665,Kumar; Rakesh,7,0,25,18
1650413358009,CSE 190,A00,092507,Dubnov; Shlomo,14,0,20,6
1650413364037,ECE 45,A01,083139,Staff,0,17,40,40
1650413370062,ECE 65,A50,083695,Staff,0,5,30,30
1650413376092,ECE 109,A01,091882,Touri; Behrouz,39,0,70,31
1650413382117,ECE 180,A00,083140,Abi Samra; Nicholas Camill,23,0,30,7
1650413382117,ECE 180,B00,083141,Abi Samra; Nicholas Camill,1,0,30,29
1650413388237,MATH 10A,A01,083735,Patchell; Gregory David,7,0,30,23
1650413388237,MATH 10A,A02,083736,Patchell; Gregory David,28,0,30,2
1650413388237,MATH 10A,A03,083737,Patchell; Gregory David,25,0,30,5
1650413394273,MATH 10B,A01,083207,Staff,0,8,30,30
1650413394273,MATH 10B,A02,083208,Staff,0,7,30,30
1650413394273,MATH 10B,B01,083739,Staff,15,0,30,15
1650413394273,MATH 10B,B02,083740,Staff,28,0,30,2
1650413400297,MATH 18,A01,083743,Staff,2,0,30,28
1650413400297,MATH 18,A02,083744,Staff,27,0,30,3
1650413400297,MATH 18,A03,083745,Staff,22,0,30,8
1650413400297,MATH 18,A04,083746,Staff,26,0,30,4
1650413400297,MATH 18,B01,083748,Staff,1,12,30,29
1650413400297,MATH 18,B02,083749,Staff,0,12,30,30
1650413400297,MATH 18,B03,083750,Staff,1,12,30,29
1650413400297,MATH 18,B04,083751,Staff,0,11,30,30
1650413406329,MATH 20A,A01,083754,Staff,25,0,40,15
1650413412353,MATH 20B,A01,083756,Staff,0,9,30,30
1650413412353,MATH 20B,A02,083757,Staff,0,8,30,30
1650413418390,MATH 20C,A01,083760,Staff,0,14,30,30
1650413418390,MATH 20C,A02,083761,Staff,1,15,30,29
1650413418390,MATH 20C,B01,083762,Staff,13,0,30,17
1650413418390,MATH 20C,B02,083763,Staff,28,0,30,2
1650413424414,MATH 20D,A01,083765,Staff,0,1,30,30
1650413424414,MATH 20D,A02,083766,Staff,7,0,30,23
1650413424414,MATH 20D,A03,083767,Staff,26,0,30,4
1650413430438,MATH 20E,A01,083771,Staff,5,0,30,25
1650413430438,MATH 20E,A02,083772,Staff,18,0,30,12
1650413430438,MATH 20E,B01,083773,Staff,0,0,30,30
1650413430438,MATH 20E,B02,083774,Staff,12,0,30,18
1650413436472,MATH 103A,A01,083777,Staff,0,11,30,30
1650413436472,MATH 103A,A02,083778,Staff,0,12,30,30
1650413436472,MATH 103A,B01,083779,Staff,0,13,30,30
1650413436472,MATH 103A,B02,083780,Staff,0,11,30,30
1650413442512,MATH 105,A01,085443,Staff,0,22,30,30
1650413448535,MATH 109,A01,083213,Anzaldo; Leesa B,0,7,30,30
1650413448535,MATH 109,A02,083214,Anzaldo; Leesa B,0,7,30,30
1650413448535,MATH 109,B01,083215,Anzaldo; Leesa B,0,5,30,30
1650413448535,MATH 109,B02,083216,Anzaldo; Leesa B,0,6,30,30
1650413454563,MATH 142A,A01,083219,Chow; Bennett,0,14,30,30
1650413454563,MATH 142A,A02,083220,Chow; Bennett,0,13,30,30
1650413454563,MATH 142A,B01,083221,Chow; Bennett,0,12,30,30
1650413454563,MATH 142A,B02,083222,Chow; Bennett,0,13,30,30
1650413460588,MATH 193A,A01,083224,Staff,0,5,30,30
1650413460588,MATH 193A,A02,083225,Staff,0,5,30,30
1650413460588,MATH 193A,A03,083781,Staff,0,4,30,30
1650413460588,MATH 193A,A04,083782,Staff,0,4,30,30
1650413466611,MATH 197,001,091859,McAuley; Julian John,9998,0,9999,1
1650413472679,COGS 9,A01,083615,Staff,0,14,60,60
1650413478722,COGS 11,A01,083617,Boyle; Mary E. T.,21,0,40,19
1650413484748,COGS 13,A01,083071,Staff,0,33,40,40
1650413490770,COGS 14A,A01,092681,Staff,0,25,100,100
1650413496793,COGS 14B,A01,083073,Cheng; Tzu-Han,0,11,50,50
1650413502819,COGS 17,A01,092677,Staff,23,0,75,52
1650413508846,COGS 100,A01,083619,Staff,0,26,60,60
1650413514873,COGS 101A,A01,083621,Davis; Joshua Daniel,0,21,60,60
1650413520897,COGS 101B,A01,091572,Staff,0,4,60,60
1650413526925,COGS 101C,A01,083625,Delgado; Tania,16,0,30,14
1650413532970,COGS 107A,A01,083627,Boyle; Mary E. T.,0,11,60,60
1650413538994,COGS 118A,A01,083075,Staff,2,0,60,58
1650413545021,CSE 3,A50,083646,Miranda; Gregory Joseph,21,0,38,17
1650413545021,CSE 3,A51,083647,Miranda; Gregory Joseph,37,0,37,0
1650413551045,CSE 8A,A50,083650,Miranda; Gregory Joseph,0,27,40,40
1650413557071,CSE 11,A01,083080,Cao; Yingjun,0,91,40,40
1650413563098,CSE 12,A01,083652,Staff,0,16,100,100
1650413569136,CSE 15L,A01,083654,Staff,0,1,50,50
1650413569136,CSE 15L,A02,083655,Staff,2,0,50,48
1650413575162,CSE 20,A01,083657,Staff,51,0,80,29
1650413581185,CSE 30,A01,083084,Eldon; John,0,76,40,40
1650413587222,CSE 100,A01,083659,Cao; Yingjun,0,66,50,50
1650413593247,CSE 134B,A01,083661,Powell; Thomas Allan,1,33,65,64
1650413599284,CSE 140,A01,083663,Staff,0,1,75,75
1650413605308,CSE 140L,A01,083088,Eldon; John,0,7,75,75
1650413611331,CSE 175,A01,083665,Kumar; Rakesh,7,0,25,18
1650413617358,CSE 190,A00,092507,Dubnov; Shlomo,14,0,20,6
1650413623382,ECE 45,A01,083139,Staff,0,17,40,40
1650413629410,ECE 65,A50,083695,Staff,0,5,30,30
1650413635442,ECE 109,A01,091882,Touri; Behrouz,39,0,70,31
1650413641467,ECE 180,A00,083140,Abi Samra; Nicholas Camill,23,0,30,7
1650413641467,ECE 180,B00,083141,Abi Samra; Nicholas Camill,1,0,30,29
1650413647491,MATH 10A,A01,083735,Patchell; Gregory David,7,0,30,23
1650413647491,MATH 10A,A02,083736,Patchell; Gregory David,28,0,30,2
1650413647491,MATH 10A,A03,083737,Patchell; Gregory David,25,0,30,5
1650413653515,MATH 10B,A01,083207,Staff,0,8,30,30
1650413653515,MATH 10B,A02,083208,Staff,0,7,30,30
1650413653515,MATH 10B,B01,083739,Staff,15,0,30,15
1650413653515,MATH 10B,B02,083740,Staff,28,0,30,2
1650413659540,MATH 18,A01,083743,Staff,2,0,30,28
1650413659540,MATH 18,A02,083744,Staff,27,0,30,3
1650413659540,MATH 18,A03,083745,Staff,22,0,30,8
1650413659540,MATH 18,A04,083746,Staff,26,0,30,4
1650413659540,MATH 18,B01,083748,Staff,1,12,30,29
1650413659540,MATH 18,B02,083749,Staff,0,12,30,30
1650413659540,MATH 18,B03,083750,Staff,1,12,30,29
1650413659540,MATH 18,B04,083751,Staff,0,11,30,30
1650413665564,MATH 20A,A01,083754,Staff,25,0,40,15
1650413671591,MATH 20B,A01,083756,Staff,0,9,30,30
1650413671591,MATH 20B,A02,083757,Staff,0,9,30,30
1650413677626,MATH 20C,A01,083760,Staff,0,14,30,30
1650413677626,MATH 20C,A02,083761,Staff,1,15,30,29
1650413677626,MATH 20C,B01,083762,Staff,13,0,30,17
1650413677626,MATH 20C,B02,083763,Staff,28,0,30,2
1650413683650,MATH 20D,A01,083765,Staff,0,1,30,30
1650413683650,MATH 20D,A02,083766,Staff,7,0,30,23
1650413683650,MATH 20D,A03,083767,Staff,26,0,30,4
1650413689682,MATH 20E,A01,083771,Staff,5,0,30,25
1650413689682,MATH 20E,A02,083772,Staff,18,0,30,12
1650413689682,MATH 20E,B01,083773,Staff,0,0,30,30
1650413689682,MATH 20E,B02,083774,Staff,12,0,30,18
1650413695710,MATH 103A,A01,083777,Staff,0,11,30,30
1650413695710,MATH 103A,A02,083778,Staff,0,12,30,30
1650413695710,MATH 103A,B01,083779,Staff,0,13,30,30
1650413695710,MATH 103A,B02,083780,Staff,0,11,30,30
1650413701732,MATH 105,A01,085443,Staff,0,22,30,30
1650413707754,MATH 109,A01,083213,Anzaldo; Leesa B,0,7,30,30
1650413707754,MATH 109,A02,083214,Anzaldo; Leesa B,0,7,30,30
1650413707754,MATH 109,B01,083215,Anzaldo; Leesa B,0,5,30,30
1650413707754,MATH 109,B02,083216,Anzaldo; Leesa B,0,6,30,30
1650413713779,MATH 142A,A01,083219,Chow; Bennett,0,14,30,30
1650413713779,MATH 142A,A02,083220,Chow; Bennett,0,13,30,30
1650413713779,MATH 142A,B01,083221,Chow; Bennett,0,12,30,30
1650413713779,MATH 142A,B02,083222,Chow; Bennett,0,13,30,30
1650413719806,MATH 193A,A01,083224,Staff,0,5,30,30
1650413719806,MATH 193A,A02,083225,Staff,0,5,30,30
1650413719806,MATH 193A,A03,083781,Staff,0,4,30,30
1650413719806,MATH 193A,A04,083782,Staff,0,4,30,30
1650413725832,MATH 197,001,091859,McAuley; Julian John,9998,0,9999,1
1650413731909,COGS 9,A01,083615,Staff,0,14,60,60
1650413737933,COGS 11,A01,083617,Boyle; Mary E. T.,21,0,40,19
1650413743957,COGS 13,A01,083071,Staff,0,33,40,40
1650413749982,COGS 14A,A01,092681,Staff,0,25,100,100
1650413756007,COGS 14B,A01,083073,Cheng; Tzu-Han,0,11,50,50
1650413762031,COGS 17,A01,092677,Staff,23,0,75,52
1650413768058,COGS 100,A01,083619,Staff,0,26,60,60
1650413774084,COGS 101A,A01,083621,Davis; Joshua Daniel,0,21,60,60
1650413780110,COGS 101B,A01,091572,Staff,0,4,60,60
1650413786138,COGS 101C,A01,083625,Delgado; Tania,16,0,30,14
1650413792167,COGS 107A,A01,083627,Boyle; Mary E. T.,0,11,60,60
1650413798201,COGS 118A,A01,083075,Staff,2,0,60,58
1650413804224,CSE 3,A50,083646,Miranda; Gregory Joseph,21,0,38,17
1650413804224,CSE 3,A51,083647,Miranda; Gregory Joseph,37,0,37,0
1650413810257,CSE 8A,A50,083650,Miranda; Gregory Joseph,0,27,40,40
1650413816288,CSE 11,A01,083080,Cao; Yingjun,0,91,40,40
1650413822312,CSE 12,A01,083652,Staff,0,16,100,100
1650413828334,CSE 15L,A01,083654,Staff,0,1,50,50
1650413828334,CSE 15L,A02,083655,Staff,2,0,50,48
1650413834360,CSE 20,A01,083657,Staff,51,0,80,29
1650413849532,CSE 30,A01,083084,Eldon; John,0,76,40,40
1650413855562,CSE 100,A01,083659,Cao; Yingjun,0,66,50,50
1650413861590,CSE 134B,A01,083661,Powell; Thomas Allan,1,33,65,64
1650413867617,CSE 140,A01,083663,Staff,0,1,75,75
1650413873646,CSE 140L,A01,083088,Eldon; John,0,7,75,75
1650413879669,CSE 175,A01,083665,Kumar; Rakesh,7,0,25,18
1650413885692,CSE 190,A00,092507,Dubnov; Shlomo,14,0,20,6
1650413891719,ECE 45,A01,083139,Staff,0,17,40,40
1650413897742,ECE 65,A50,083695,Staff,0,5,30,30
1650413903768,ECE 109,A01,091882,Touri; Behrouz,39,0,70,31
1650413909791,ECE 180,A00,083140,Abi Samra; Nicholas Camill,23,0,30,7
1650413909791,ECE 180,B00,083141,Abi Samra; Nicholas Camill,1,0,30,29
1650413915818,MATH 10A,A01,083735,Patchell; Gregory David,7,0,30,23
1650413915818,MATH 10A,A02,083736,Patchell; Gregory David,28,0,30,2
1650413915818,MATH 10A,A03,083737,Patchell; Gregory David,25,0,30,5
1650413921844,MATH 10B,A01,083207,Staff,0,8,30,30
1650413921844,MATH 10B,A02,083208,Staff,0,7,30,30
1650413921844,MATH 10B,B01,083739,Staff,15,0,30,15
1650413921844,MATH 10B,B02,083740,Staff,28,0,30,2
1650413927872,MATH 18,A01,083743,Staff,2,0,30,28
1650413927872,MATH 18,A02,083744,Staff,27,0,30,3
1650413927872,MATH 18,A03,083745,Staff,22,0,30,8
1650413927872,MATH 18,A04,083746,Staff,26,0,30,4
1650413927872,MATH 18,B01,083748,Staff,1,12,30,29
1650413927872,MATH 18,B02,083749,Staff,0,12,30,30
1650413927872,MATH 18,B03,083750,Staff,1,12,30,29
1650413927872,MATH 18,B04,083751,Staff,0,11,30,30
1650413933898,MATH 20A,A01,083754,Staff,25,0,40,15
1650413939921,MATH 20B,A01,083756,Staff,0,9,30,30
1650413939921,MATH 20B,A02,083757,Staff,0,9,30,30
1650413945945,MATH 20C,A01,083760,Staff,0,14,30,30
1650413945945,MATH 20C,A02,083761,Staff,1,15,30,29
1650413945945,MATH 20C,B01,083762,Staff,13,0,30,17
1650413945945,MATH 20C,B02,083763,Staff,28,0,30,2
1650413951974,MATH 20D,A01,083765,Staff,0,1,30,30
1650413951974,MATH 20D,A02,083766,Staff,7,0,30,23
1650413951974,MATH 20D,A03,083767,Staff,26,0,30,4
1650413957997,MATH 20E,A01,083771,Staff,5,0,30,25
1650413957997,MATH 20E,A02,083772,Staff,18,0,30,12
1650413957997,MATH 20E,B01,083773,Staff,0,0,30,30
1650413957997,MATH 20E,B02,083774,Staff,12,0,30,18
1650413964020,MATH 103A,A01,083777,Staff,0,11,30,30
1650413964020,MATH 103A,A02,083778,Staff,0,12,30,30
1650413964020,MATH 103A,B01,083779,Staff,0,13,30,30
1650413964020,MATH 103A,B02,083780,Staff,0,11,30,30
1650413970044,MATH 105,A01,085443,Staff,0,22,30,30
1650413976076,MATH 109,A01,083213,Anzaldo; Leesa B,0,7,30,30
1650413976076,MATH 109,A02,083214,Anzaldo; Leesa B,0,7,30,30
1650413976076,MATH 109,B01,083215,Anzaldo; Leesa B,0,5,30,30
1650413976076,MATH 109,B02,083216,Anzaldo; Leesa B,0,6,30,30
1650413982099,MATH 142A,A01,083219,Chow; Bennett,0,14,30,30
1650413982099,MATH 142A,A02,083220,Chow; Bennett,0,13,30,30
1650413982099,MATH 142A,B01,083221,Chow; Bennett,0,12,30,30
1650413982099,MATH 142A,B02,083222,Chow; Bennett,0,13,30,30
1650413988122,MATH 193A,A01,083224,Staff,0,5,30,30
1650413988122,MATH 193A,A02,083225,Staff,0,5,30,30
1650413988122,MATH 193A,A03,083781,Staff,0,4,30,30
1650413988122,MATH 193A,A04,083782,Staff,0,4,30,30
1650413994241,MATH 197,001,091859,McAuley; Julian John,9998,0,9999,1
1650414000304,COGS 9,A01,083615,Staff,0,14,60,60
1650414006330,COGS 11,A01,083617,Boyle; Mary E. T.,21,0,40,19
1650414012354,COGS 13,A01,083071,Staff,0,33,40,40
1650414018377,COGS 14A,A01,092681,Staff,0,25,100,100
1650414024401,COGS 14B,A01,083073,Cheng; Tzu-Han,0,11,50,50
1650414030426,COGS 17,A01,092677,Staff,23,0,75,52
1650414036453,COGS 100,A01,083619,Staff,0,26,60,60
1650414042482,COGS 101A,A01,083621,Davis; Joshua Daniel,0,21,60,60
1650414048506,COGS 101B,A01,091572,Staff,0,4,60,60
1650414054530,COGS 101C,A01,083625,Delgado; Tania,16,0,30,14
1650414060562,COGS 107A,A01,083627,Boyle; Mary E. T.,0,11,60,60
1650414066607,COGS 118A,A01,083075,Staff,2,0,60,58
1650414072630,CSE 3,A50,083646,Miranda; Gregory Joseph,21,0,38,17
1650414072630,CSE 3,A51,083647,Miranda; Gregory Joseph,37,0,37,0
1650414078665,CSE 8A,A50,083650,Miranda; Gregory Joseph,0,27,40,40
1650414084702,CSE 11,A01,083080,Cao; Yingjun,0,91,40,40
1650414090726,CSE 12,A01,083652,Staff,0,16,100,100
1650414096748,CSE 15L,A01,083654,Staff,0,1,50,50
1650414096748,CSE 15L,A02,083655,Staff,2,0,50,48
1650414102771,CSE 20,A01,083657,Staff,51,0,80,29
1650414108797,CSE 30,A01,083084,Eldon; John,0,76,40,40
1650414114821,CSE 100,A01,083659,Cao; Yingjun,0,66,50,50
1650414120854,CSE 134B,A01,083661,Powell; Thomas Allan,1,33,65,64
1650414126879,CSE 140,A01,083663,Staff,0,1,75,75
1650414132904,CSE 140L,A01,083088,Eldon; John,0,7,75,75
1650414138927,CSE 175,A01,083665,Kumar; Rakesh,7,0,25,18
1650414144957,CSE 190,A00,092507,Dubnov; Shlomo,14,0,20,6
1650414150991,ECE 45,A01,083139,Staff,0,17,40,40
1650414157017,ECE 65,A50,083695,Staff,0,5,30,30
1650414163045,ECE 109,A01,091882,Touri; Behrouz,39,0,70,31
1650414169067,ECE 180,A00,083140,Abi Samra; Nicholas Camill,23,0,30,7
1650414169067,ECE 180,B00,083141,Abi Samra; Nicholas Camill,1,0,30,29
1650414175099,MATH 10A,A01,083735,Patchell; Gregory David,7,0,30,23
1650414175099,MATH 10A,A02,083736,Patchell; Gregory David,28,0,30,2
1650414175099,MATH 10A,A03,083737,Patchell; Gregory David,25,0,30,5
1650414181137,MATH 10B,A01,083207,Staff,0,8,30,30
1650414181137,MATH 10B,A02,083208,Staff,0,7,30,30
1650414181137,MATH 10B,B01,083739,Staff,15,0,30,15
1650414181137,MATH 10B,B02,083740,Staff,28,0,30,2
1650414187180,MATH 18,A01,083743,Staff,2,0,30,28
1650414187180,MATH 18,A02,083744,Staff,27,0,30,3
1650414187180,MATH 18,A03,083745,Staff,22,0,30,8
1650414187180,MATH 18,A04,083746,Staff,26,0,30,4
1650414187180,MATH 18,B01,083748,Staff,1,12,30,29
1650414187180,MATH 18,B02,083749,Staff,0,12,30,30
1650414187180,MATH 18,B03,083750,Staff,1,12,30,29
1650414187180,MATH 18,B04,083751,Staff,0,11,30,30
1650414193207,MATH 20A,A01,083754,Staff,25,0,40,15
1650414199230,MATH 20B,A01,083756,Staff,0,9,30,30
1650414199230,MATH 20B,A02,083757,Staff,0,9,30,30
1650414205277,MATH 20C,A01,083760,Staff,0,14,30,30
1650414205277,MATH 20C,A02,083761,Staff,1,15,30,29
1650414205277,MATH 20C,B01,083762,Staff,13,0,30,17
1650414205277,MATH 20C,B02,083763,Staff,28,0,30,2
1650414211314,MATH 20D,A01,083765,Staff,0,1,30,30
1650414211314,MATH 20D,A02,083766,Staff,7,0,30,23
1650414211314,MATH 20D,A03,083767,Staff,26,0,30,4
1650414217338,MATH 20E,A01,083771,Staff,5,0,30,25
1650414217338,MATH 20E,A02,083772,Staff,18,0,30,12
1650414217338,MATH 20E,B01,083773,Staff,0,0,30,30
1650414217338,MATH 20E,B02,083774,Staff,12,0,30,18
1650414223361,MATH 103A,A01,083777,Staff,0,11,30,30
1650414223361,MATH 103A,A02,083778,Staff,0,12,30,30
1650414223361,MATH 103A,B01,083779,Staff,0,13,30,30
1650414223361,MATH 103A,B02,083780,Staff,0,11,30,30
1650414229395,MATH 105,A01,085443,Staff,0,22,30,30
1650414235422,MATH 109,A01,083213,Anzaldo; Leesa B,0,7,30,30
1650414235422,MATH 109,A02,083214,Anzaldo; Leesa B,0,7,30,30
1650414235422,MATH 109,B01,083215,Anzaldo; Leesa B,0,5,30,30
1650414235422,MATH 109,B02,083216,Anzaldo; Leesa B,0,6,30,30
1650414241463,MATH 142A,A01,083219,Chow; Bennett,0,14,30,30
1650414241463,MATH 142A,A02,083220,Chow; Bennett,0,13,30,30
1650414241463,MATH 142A,B01,083221,Chow; Bennett,0,12,30,30
1650414241463,MATH 142A,B02,083222,Chow; Bennett,0,13,30,30
1650414247496,MATH 193A,A01,083224,Staff,0,5,30,30
1650414247496,MATH 193A,A02,083225,Staff,0,5,30,30
1650414247496,MATH 193A,A03,083781,Staff,0,4,30,30
1650414247496,MATH 193A,A04,083782,Staff,0,4,30,30
1650414253526,MATH 197,001,091859,McAuley; Julian John,9998,0,9999,1
1650414259576,COGS 9,A01,083615,Staff,0,14,60,60
1650414265604,COGS 11,A01,083617,Boyle; Mary E. T.,21,0,40,19
1650414271627,COGS 13,A01,083071,Staff,0,33,40,40
1650414277650,COGS 14A,A01,092681,Staff,0,25,100,100
1650414283672,COGS 14B,A01,083073,Cheng; Tzu-Han,0,11,50,50
1650414289710,COGS 17,A01,092677,Staff,23,0,75,52
1650414295741,COGS 100,A01,083619,Staff,0,26,60,60
1650414301772,COGS 101A,A01,083621,Davis; Joshua Daniel,0,21,60,60
1650414307796,COGS 101B,A01,091572,Staff,0,4,60,60
1650414313819,COGS 101C,A01,083625,Delgado; Tania,16,0,30,14
1650414319843,COGS 107A,A01,083627,Boyle; Mary E. T.,0,11,60,60
1650414325869,COGS 118A,A01,083075,Staff,2,0,60,58
1650414331897,CSE 3,A50,083646,Miranda; Gregory Joseph,21,0,38,17
1650414331897,CSE 3,A51,083647,Miranda; Gregory Joseph,37,0,37,0
1650414337929,CSE 8A,A50,083650,Miranda; Gregory Joseph,0,27,40,40
1650414343954,CSE 11,A01,083080,Cao; Yingjun,0,91,40,40
1650414349978,CSE 12,A01,083652,Staff,0,16,100,100
1650414356006,CSE 15L,A01,083654,Staff,0,1,50,50
1650414356006,CSE 15L,A02,083655,Staff,2,0,50,48
1650414362033,CSE 20,A01,083657,Staff,51,0,80,29
1650414368055,CSE 30,A01,083084,Eldon; John,0,76,40,40
1650414374078,CSE 100,A01,083659,Cao; Yingjun,0,66,50,50
1650414380104,CSE 134B,A01,083661,Powell; Thomas Allan,1,33,65,64
1650414386132,CSE 140,A01,083663,Staff,0,1,75,75
1650414392156,CSE 140L,A01,083088,Eldon; John,0,7,75,75
1650414398178,CSE 175,A01,083665,Kumar; Rakesh,7,0,25,18
1650414404203,CSE 190,A00,092507,Dubnov; Shlomo,14,0,20,6
1650414410229,ECE 45,A01,083139,Staff,0,17,40,40
1650414416252,ECE 65,A50,083695,Staff,0,5,30,30
1650414422284,ECE 109,A01,091882,Touri; Behrouz,39,0,70,31
1650414428311,ECE 180,A00,083140,Abi Samra; Nicholas Camill,23,0,30,7
1650414428311,ECE 180,B00,083141,Abi Samra; Nicholas Camill,1,0,30,29
1650414434336,MATH 10A,A01,083735,Patchell; Gregory David,7,0,30,23
1650414434336,MATH 10A,A02,083736,Patchell; Gregory David,28,0,30,2
1650414434336,MATH 10A,A03,083737,Patchell; Gregory David,25,0,30,5
1650414440362,MATH 10B,A01,083207,Staff,0,8,30,30
1650414440362,MATH 10B,A02,083208,Staff,0,7,30,30
1650414440362,MATH 10B,B01,083739,Staff,15,0,30,15
1650414440362,MATH 10B,B02,083740,Staff,28,0,30,2
1650414446386,MATH 18,A01,083743,Staff,2,0,30,28
1650414446386,MATH 18,A02,083744,Staff,27,0,30,3
1650414446386,MATH 18,A03,083745,Staff,22,0,30,8
1650414446386,MATH 18,A04,083746,Staff,26,0,30,4
1650414446386,MATH 18,B01,083748,Staff,1,12,30,29
1650414446386,MATH 18,B02,083749,Staff,0,12,30,30
1650414446386,MATH 18,B03,083750,Staff,1,12,30,29
1650414446386,MATH 18,B04,083751,Staff,0,11,30,30
1650414452419,MATH 20A,A01,083754,Staff,25,0,40,15
1650414458454,MATH 20B,A01,083756,Staff,0,9,30,30
1650414458454,MATH 20B,A02,083757,Staff,0,9,30,30
1650414464491,MATH 20C,A01,083760,Staff,0,14,30,30
1650414464491,MATH 20C,A02,083761,Staff,1,15,30,29
1650414464491,MATH 20C,B01,083762,Staff,13,0,30,17
1650414464491,MATH 20C,B02,083763,Staff,28,0,30,2
1650414470519,MATH 20D,A01,083765,Staff,0,1,30,30
1650414470519,MATH 20D,A02,083766,Staff,7,0,30,23
1650414470519,MATH 20D,A03,083767,Staff,26,0,30,4
1650414476545,MATH 20E,A01,083771,Staff,5,0,30,25
1650414476545,MATH 20E,A02,083772,Staff,18,0,30,12
1650414476545,MATH 20E,B01,083773,Staff,0,0,30,30
1650414476545,MATH 20E,B02,083774,Staff,12,0,30,18
1650414482570,MATH 103A,A01,083777,Staff,0,11,30,30
1650414482570,MATH 103A,A02,083778,Staff,0,12,30,30
1650414482570,MATH 103A,B01,083779,Staff,0,13,30,30
1650414482570,MATH 103A,B02,083780,Staff,0,11,30,30
1650414488594,MATH 105,A01,085443,Staff,0,22,30,30
1650414494615,MATH 109,A01,083213,Anzaldo; Leesa B,0,7,30,30
1650414494615,MATH 109,A02,083214,Anzaldo; Leesa B,0,7,30,30
1650414494615,MATH 109,B01,083215,Anzaldo; Leesa B,0,5,30,30
1650414494615,MATH 109,B02,083216,Anzaldo; Leesa B,0,6,30,30
1650414500646,MATH 142A,A01,083219,Chow; Bennett,0,14,30,30
1650414500646,MATH 142A,A02,083220,Chow; Bennett,0,13,30,30
1650414500646,MATH 142A,B01,083221,Chow; Bennett,0,12,30,30
1650414500646,MATH 142A,B02,083222,Chow; Bennett,0,13,30,30
1650414506669,MATH 193A,A01,083224,Staff,0,5,30,30
1650414506669,MATH 193A,A02,083225,Staff,0,5,30,30
1650414506669,MATH 193A,A03,083781,Staff,0,4,30,30
1650414506669,MATH 193A,A04,083782,Staff,0,4,30,30
1650414512695,MATH 197,001,091859,McAuley; Julian John,9998,0,9999,1
1650414518770,COGS 9,A01,083615,Staff,0,14,60,60
1650414524800,COGS 11,A01,083617,Boyle; Mary E. T.,21,0,40,19
1650414530827,COGS 13,A01,083071,Staff,0,33,40,40
1650414536850,COGS 14A,A01,092681,Staff,0,25,100,100
1650414542873,COGS 14B,A01,083073,Cheng; Tzu-Han,0,11,50,50
1650414548896,COGS 17,A01,092677,Staff,23,0,75,52
1650414554920,COGS 100,A01,083619,Staff,0,26,60,60
1650414560942,COGS 101A,A01,083621,Davis; Joshua Daniel,0,21,60,60
1650414566965,COGS 101B,A01,091572,Staff,0,4,60,60
1650414572989,COGS 101C,A01,083625,Delgado; Tania,16,0,30,14
1650414579013,COGS 107A,A01,083627,Boyle; Mary E. T.,0,11,60,60
1650414585158,COGS 118A,A01,083075,Staff,2,0,60,58
1650414591186,CSE 3,A50,083646,Miranda; Gregory Joseph,21,0,38,17
1650414591186,CSE 3,A51,083647,Miranda; Gregory Joseph,37,0,37,0
1650414597209,CSE 8A,A50,083650,Miranda; Gregory Joseph,0,27,40,40
1650414603236,CSE 11,A01,083080,Cao; Yingjun,0,91,40,40
1650414609263,CSE 12,A01,083652,Staff,0,16,100,100
1650414615290,CSE 15L,A01,083654,Staff,0,1,50,50
1650414615290,CSE 15L,A02,083655,Staff,2,0,50,48
1650414621323,CSE 20,A01,083657,Staff,51,0,80,29
1650414627366,CSE 30,A01,083084,Eldon; John,0,76,40,40
1650414633393,CSE 100,A01,083659,Cao; Yingjun,0,66,50,50
1650414639420,CSE 134B,A01,083661,Powell; Thomas Allan,1,33,65,64
1650414645442,CSE 140,A01,083663,Staff,0,1,75,75
1650414651466,CSE 140L,A01,083088,Eldon; John,0,7,75,75
1650414657488,CSE 175,A01,083665,Kumar; Rakesh,7,0,25,18
1650414663513,CSE 190,A00,092507,Dubnov; Shlomo,14,0,20,6
1650414669545,ECE 45,A01,083139,Staff,0,17,40,40
1650414675569,ECE 65,A50,083695,Staff,0,5,30,30
1650414681593,ECE 109,A01,091882,Touri; Behrouz,39,0,70,31
1650414687620,ECE 180,A00,083140,Abi Samra; Nicholas Camill,23,0,30,7
1650414687620,ECE 180,B00,083141,Abi Samra; Nicholas Camill,1,0,30,29
1650414693644,MATH 10A,A01,083735,Patchell; Gregory David,7,0,30,23
1650414693644,MATH 10A,A02,083736,Patchell; Gregory David,28,0,30,2
1650414693644,MATH 10A,A03,083737,Patchell; Gregory David,25,0,30,5
1650414699668,MATH 10B,A01,083207,Staff,0,8,30,30
1650414699668,MATH 10B,A02,083208,Staff,0,7,30,30
1650414699668,MATH 10B,B01,083739,Staff,15,0,30,15
1650414699668,MATH 10B,B02,083740,Staff,28,0,30,2
1650414705697,MATH 18,A01,083743,Staff,2,0,30,28
1650414705697,MATH 18,A02,083744,Staff,27,0,30,3
1650414705697,MATH 18,A03,083745,Staff,22,0,30,8
1650414705697,MATH 18,A04,083746,Staff,26,0,30,4
1650414705697,MATH 18,B01,083748,Staff,1,12,30,29
1650414705697,MATH 18,B02,083749,Staff,0,12,30,30
1650414705697,MATH 18,B03,083750,Staff,1,12,30,29
1650414705697,MATH 18,B04,083751,Staff,0,11,30,30
1650414711722,MATH 20A,A01,083754,Staff,25,0,40,15
1650414717750,MATH 20B,A01,083756,Staff,0,9,30,30
1650414717750,MATH 20B,A02,083757,Staff,0,9,30,30
1650414723772,MATH 20C,A01,083760,Staff,0,14,30,30
1650414723772,MATH 20C,A02,083761,Staff,1,15,30,29
1650414723772,MATH 20C,B01,083762,Staff,13,0,30,17
1650414723772,MATH 20C,B02,083763,Staff,28,0,30,2
1650414729796,MATH 20D,A01,083765,Staff,0,1,30,30
1650414729796,MATH 20D,A02,083766,Staff,7,0,30,23
1650414729796,MATH 20D,A03,083767,Staff,26,0,30,4
1650414735823,MATH 20E,A01,083771,Staff,5,0,30,25
1650414735823,MATH 20E,A02,083772,Staff,18,0,30,12
1650414735823,MATH 20E,B01,083773,Staff,0,0,30,30
1650414735823,MATH 20E,B02,083774,Staff,12,0,30,18
1650414741851,MATH 103A,A01,083777,Staff,0,11,30,30
1650414741851,MATH 103A,A02,083778,Staff,0,12,30,30
1650414741851,MATH 103A,B01,083779,Staff,0,13,30,30
1650414741851,MATH 103A,B02,083780,Staff,0,11,30,30
1650414747875,MATH 105,A01,085443,Staff,0,22,30,30
1650414753900,MATH 109,A01,083213,Anzaldo; Leesa B,0,7,30,30
1650414753900,MATH 109,A02,083214,Anzaldo; Leesa B,0,7,30,30
1650414753900,MATH 109,B01,083215,Anzaldo; Leesa B,0,5,30,30
1650414753900,MATH 109,B02,083216,Anzaldo; Leesa B,0,6,30,30
1650414759924,MATH 142A,A01,083219,Chow; Bennett,0,14,30,30
1650414759924,MATH 142A,A02,083220,Chow; Bennett,0,13,30,30
1650414759924,MATH 142A,B01,083221,Chow; Bennett,0,12,30,30
1650414759924,MATH 142A,B02,083222,Chow; Bennett,0,13,30,30
1650414765954,MATH 193A,A01,083224,Staff,0,5,30,30
1650414765954,MATH 193A,A02,083225,Staff,0,5,30,30
1650414765954,MATH 193A,A03,083781,Staff,0,4,30,30
1650414765954,MATH 193A,A04,083782,Staff,0,4,30,30
1650414771983,MATH 197,001,091859,McAuley; Julian John,9998,0,9999,1
1650414778032,COGS 9,A01,083615,Staff,0,14,60,60
1650414784062,COGS 11,A01,083617,Boyle; Mary E. T.,21,0,40,19
1650414790086,COGS 13,A01,083071,Staff,0,33,40,40
1650414796118,COGS 14A,A01,092681,Staff,0,25,100,100
1650414802145,COGS 14B,A01,083073,Cheng; Tzu-Han,0,11,50,50
1650414808168,COGS 17,A01,092677,Staff,23,0,75,52
1650414814191,COGS 100,A01,083619,Staff,0,26,60,60
1650414820219,COGS 101A,A01,083621,Davis; Joshua Daniel,0,21,60,60
1650414826244,COGS 101B,A01,091572,Staff,0,4,60,60
1650414832266,COGS 101C,A01,083625,Delgado; Tania,16,0,30,14
1650414838289,COGS 107A,A01,083627,Boyle; Mary E. T.,0,11,60,60
1650414844316,COGS 118A,A01,083075,Staff,2,0,60,58
1650414850350,CSE 3,A50,083646,Miranda; Gregory Joseph,21,0,38,17
1650414850350,CSE 3,A51,083647,Miranda; Gregory Joseph,37,0,37,0
1650414856385,CSE 8A,A50,083650,Miranda; Gregory Joseph,0,27,40,40
1650414862411,CSE 11,A01,083080,Cao; Yingjun,0,91,40,40
1650414868437,CSE 12,A01,083652,Staff,0,16,100,100
1650414874461,CSE 15L,A01,083654,Staff,0,1,50,50
1650414874461,CSE 15L,A02,083655,Staff,2,0,50,48
1650414880488,CSE 20,A01,083657,Staff,51,0,80,29
1650414886512,CSE 30,A01,083084,Eldon; John,0,76,40,40
1650414892535,CSE 100,A01,083659,Cao; Yingjun,0,66,50,50
1650414898559,CSE 134B,A01,083661,Powell; Thomas Allan,1,33,65,64
1650414904585,CSE 140,A01,083663,Staff,0,1,75,75
1650414910609,CSE 140L,A01,083088,Eldon; John,0,7,75,75
1650414916636,CSE 175,A01,083665,Kumar; Rakesh,7,0,25,18
1650414922667,CSE 190,A00,092507,Dubnov; Shlomo,14,0,20,6
1650414928689,ECE 45,A01,083139,Staff,0,17,40,40
1650414934717,ECE 65,A50,083695,Staff,0,5,30,30
1650414940741,ECE 109,A01,091882,Touri; Behrouz,39,0,70,31
1650414946765,ECE 180,A00,083140,Abi Samra; Nicholas Camill,23,0,30,7
1650414946765,ECE 180,B00,083141,Abi Samra; Nicholas Camill,1,0,30,29
1650414952806,MATH 10A,A01,083735,Patchell; Gregory David,7,0,30,23
1650414952806,MATH 10A,A02,083736,Patchell; Gregory David,28,0,30,2
1650414952806,MATH 10A,A03,083737,Patchell; Gregory David,25,0,30,5
1650414958830,MATH 10B,A01,083207,Staff,0,8,30,30
1650414958830,MATH 10B,A02,083208,Staff,0,7,30,30
1650414958830,MATH 10B,B01,083739,Staff,15,0,30,15
1650414958830,MATH 10B,B02,083740,Staff,28,0,30,2
1650414964855,MATH 18,A01,083743,Staff,2,0,30,28
1650414964855,MATH 18,A02,083744,Staff,27,0,30,3
1650414964855,MATH 18,A03,083745,Staff,22,0,30,8
1650414964855,MATH 18,A04,083746,Staff,26,0,30,4
1650414964855,MATH 18,B01,083748,Staff,1,12,30,29
1650414964855,MATH 18,B02,083749,Staff,0,12,30,30
1650414964855,MATH 18,B03,083750,Staff,1,12,30,29
1650414964855,MATH 18,B04,083751,Staff,0,11,30,30
1650414970925,MATH 20A,A01,083754,Staff,25,0,40,15
1650414976949,MATH 20B,A01,083756,Staff,0,9,30,30
1650414976949,MATH 20B,A02,083757,Staff,0,9,30,30
1650414982981,MATH 20C,A01,083760,Staff,0,14,30,30
1650414982981,MATH 20C,A02,083761,Staff,1,15,30,29
1650414982981,MATH 20C,B01,083762,Staff,13,0,30,17
1650414982981,MATH 20C,B02,083763,Staff,28,0,30,2
1650414989004,MATH 20D,A01,083765,Staff,0,1,30,30
1650414989004,MATH 20D,A02,083766,Staff,7,0,30,23
1650414989004,MATH 20D,A03,083767,Staff,26,0,30,4
1650414995032,MATH 20E,A01,083771,Staff,5,0,30,25
1650414995032,MATH 20E,A02,083772,Staff,18,0,30,12
1650414995032,MATH 20E,B01,083773,Staff,0,0,30,30
1650414995032,MATH 20E,B02,083774,Staff,12,0,30,18
1650415001061,MATH 103A,A01,083777,Staff,0,11,30,30
1650415001061,MATH 103A,A02,083778,Staff,0,12,30,30
1650415001061,MATH 103A,B01,083779,Staff,0,13,30,30
1650415001061,MATH 103A,B02,083780,Staff,0,11,30,30
1650415007093,MATH 105,A01,085443,Staff,0,22,30,30
1650415013119,MATH 109,A01,083213,Anzaldo; Leesa B,0,7,30,30
1650415013119,MATH 109,A02,083214,Anzaldo; Leesa B,0,7,30,30
1650415013119,MATH 109,B01,083215,Anzaldo; Leesa B,0,5,30,30
1650415013119,MATH 109,B02,083216,Anzaldo; Leesa B,0,6,30,30
1650415019153,MATH 142A,A01,083219,Chow; Bennett,0,14,30,30
1650415019153,MATH 142A,A02,083220,Chow; Bennett,0,13,30,30
1650415019153,MATH 142A,B01,083221,Chow; Bennett,0,12,30,30
1650415019153,MATH 142A,B02,083222,Chow; Bennett,0,13,30,30
1650415025177,MATH 193A,A01,083224,Staff,0,5,30,30
1650415025177,MATH 193A,A02,083225,Staff,0,5,30,30
1650415025177,MATH 193A,A03,083781,Staff,0,4,30,30
1650415025177,MATH 193A,A04,083782,Staff,0,4,30,30
1650415031210,MATH 197,001,091859,McAuley; Julian John,9998,0,9999,1
1650415037267,COGS 9,A01,083615,Staff,0,14,60,60
1650415043295,COGS 11,A01,083617,Boyle; Mary E. T.,21,0,40,19
1650415049322,COGS 13,A01,083071,Staff,0,33,40,40
1650415055346,COGS 14A,A01,092681,Staff,0,25,100,100
1650415061371,COGS 14B,A01,083073,Cheng; Tzu-Han,0,11,50,50
1650415067396,COGS 17,A01,092677,Staff,23,0,75,52
1650415073420,COGS 100,A01,083619,Staff,0,26,60,60
1650415079451,COGS 101A,A01,083621,Davis; Joshua Daniel,0,21,60,60
1650415085478,COGS 101B,A01,091572,Staff,0,4,60,60
1650415091503,COGS 101C,A01,083625,Delgado; Tania,16,0,30,14
1650415097540,COGS 107A,A01,083627,Boyle; Mary E. T.,0,11,60,60
1650415103565,COGS 118A,A01,083075,Staff,2,0,60,58
1650415109592,CSE 3,A50,083646,Miranda; Gregory Joseph,21,0,38,17
1650415109592,CSE 3,A51,083647,Miranda; Gregory Joseph,37,0,37,0
1650415115620,CSE 8A,A50,083650,Miranda; Gregory Joseph,0,27,40,40
1650415121645,CSE 11,A01,083080,Cao; Yingjun,0,91,40,40
1650415127670,CSE 12,A01,083652,Staff,0,16,100,100
1650415133694,CSE 15L,A01,083654,Staff,0,1,50,50
1650415133694,CSE 15L,A02,083655,Staff,2,0,50,48
1650415139721,CSE 20,A01,083657,Staff,51,0,80,29
1650415145747,CSE 30,A01,083084,Eldon; John,0,76,40,40
1650415151772,CSE 100,A01,083659,Cao; Yingjun,0,66,50,50
1650415157797,CSE 134B,A01,083661,Powell; Thomas Allan,1,33,65,64
1650415163820,CSE 140,A01,083663,Staff,0,1,75,75
1650415169854,CSE 140L,A01,083088,Eldon; John,0,7,75,75
1650415175878,CSE 175,A01,083665,Kumar; Rakesh,7,0,25,18
1650415181996,CSE 190,A00,092507,Dubnov; Shlomo,14,0,20,6
1650415188025,ECE 45,A01,083139,Staff,0,17,40,40
1650415194048,ECE 65,A50,083695,Staff,0,5,30,30
1650415200071,ECE 109,A01,091882,Touri; Behrouz,39,0,70,31
1650415206096,ECE 180,A00,083140,Abi Samra; Nicholas Camill,23,0,30,7
1650415206096,ECE 180,B00,083141,Abi Samra; Nicholas Camill,1,0,30,29
1650415212127,MATH 10A,A01,083735,Patchell; Gregory David,7,0,30,23
1650415212127,MATH 10A,A02,083736,Patchell; Gregory David,28,0,30,2
1650415212127,MATH 10A,A03,083737,Patchell; Gregory David,25,0,30,5
1650415218155,MATH 10B,A01,083207,Staff,0,8,30,30
1650415218155,MATH 10B,A02,083208,Staff,0,7,30,30
1650415218155,MATH 10B,B01,083739,Staff,15,0,30,15
1650415218155,MATH 10B,B02,083740,Staff,28,0,30,2
1650415224182,MATH 18,A01,083743,Staff,2,0,30,28
1650415224182,MATH 18,A02,083744,Staff,27,0,30,3
1650415224182,MATH 18,A03,083745,Staff,22,0,30,8
1650415224182,MATH 18,A04,083746,Staff,26,0,30,4
1650415224182,MATH 18,B01,083748,Staff,1,12,30,29
1650415224182,MATH 18,B02,083749,Staff,0,12,30,30
1650415224182,MATH 18,B03,083750,Staff,1,12,30,29
1650415224182,MATH 18,B04,083751,Staff,0,11,30,30
1650415230205,MATH 20A,A01,083754,Staff,25,0,40,15
1650415236232,MATH 20B,A01,083756,Staff,0,9,30,30
1650415236232,MATH 20B,A02,083757,Staff,0,9,30,30
1650415242256,MATH 20C,A01,083760,Staff,0,14,30,30
1650415242256,MATH 20C,A02,083761,Staff,1,15,30,29
1650415242256,MATH 20C,B01,083762,Staff,13,0,30,17
1650415242256,MATH 20C,B02,083763,Staff,28,0,30,2
1650415248278,MATH 20D,A01,083765,Staff,0,1,30,30
1650415248278,MATH 20D,A02,083766,Staff,7,0,30,23
1650415248278,MATH 20D,A03,083767,Staff,26,0,30,4
1650415254302,MATH 20E,A01,083771,Staff,5,0,30,25
1650415254302,MATH 20E,A02,083772,Staff,18,0,30,12
1650415254302,MATH 20E,B01,083773,Staff,0,0,30,30
1650415254302,MATH 20E,B02,083774,Staff,12,0,30,18
1650415260326,MATH 103A,A01,083777,Staff,0,11,30,30
1650415260326,MATH 103A,A02,083778,Staff,0,12,30,30
1650415260326,MATH 103A,B01,083779,Staff,0,13,30,30
1650415260326,MATH 103A,B02,083780,Staff,0,11,30,30
1650415266351,MATH 105,A01,085443,Staff,0,22,30,30
1650415272379,MATH 109,A01,083213,Anzaldo; Leesa B,0,7,30,30
1650415272379,MATH 109,A02,083214,Anzaldo; Leesa B,0,7,30,30
1650415272379,MATH 109,B01,083215,Anzaldo; Leesa B,0,5,30,30
1650415272379,MATH 109,B02,083216,Anzaldo; Leesa B,0,6,30,30
1650415278405,MATH 142A,A01,083219,Chow; Bennett,0,14,30,30
1650415278405,MATH 142A,A02,083220,Chow; Bennett,0,13,30,30
1650415278405,MATH 142A,B01,083221,Chow; Bennett,0,12,30,30
1650415278405,MATH 142A,B02,083222,Chow; Bennett,0,13,30,30
1650415284432,MATH 193A,A01,083224,Staff,0,5,30,30
1650415284432,MATH 193A,A02,083225,Staff,0,5,30,30
1650415284432,MATH 193A,A03,083781,Staff,0,4,30,30
1650415284432,MATH 193A,A04,083782,Staff,0,4,30,30
1650415290466,MATH 197,001,091859,McAuley; Julian John,9998,0,9999,1
1650415296525,COGS 9,A01,083615,Staff,0,14,60,60
1650415302551,COGS 11,A01,083617,Boyle; Mary E. T.,21,0,40,19
1650415308573,COGS 13,A01,083071,Staff,0,33,40,40
1650415314606,COGS 14A,A01,092681,Staff,0,25,100,100
1650415320630,COGS 14B,A01,083073,Cheng; Tzu-Han,0,11,50,50
1650415326667,COGS 17,A01,092677,Staff,23,0,75,52
1650415332688,COGS 100,A01,083619,Staff,0,26,60,60
1650415338712,COGS 101A,A01,083621,Davis; Joshua Daniel,0,21,60,60
1650415344739,COGS 101B,A01,091572,Staff,0,4,60,60
1650415350763,COGS 101C,A01,083625,Delgado; Tania,16,0,30,14
1650415356788,COGS 107A,A01,083627,Boyle; Mary E. T.,0,11,60,60
1650415362811,COGS 118A,A01,083075,Staff,2,0,60,58
1650415368840,CSE 3,A50,083646,Miranda; Gregory Joseph,21,0,38,17
1650415368840,CSE 3,A51,083647,Miranda; Gregory Joseph,37,0,37,0
1650415374864,CSE 8A,A50,083650,Miranda; Gregory Joseph,0,27,40,40
1650415380889,CSE 11,A01,083080,Cao; Yingjun,0,91,40,40
1650415386913,CSE 12,A01,083652,Staff,0,16,100,100
1650415392937,CSE 15L,A01,083654,Staff,0,1,50,50
1650415392937,CSE 15L,A02,083655,Staff,2,0,50,48
1650415398969,CSE 20,A01,083657,Staff,51,0,80,29
1650415404992,CSE 30,A01,083084,Eldon; John,0,76,40,40
1650415411020,CSE 100,A01,083659,Cao; Yingjun,0,66,50,50
1650415417043,CSE 134B,A01,083661,Powell; Thomas Allan,1,33,65,64
1650415423071,CSE 140,A01,083663,Staff,0,1,75,75
1650415429095,CSE 140L,A01,083088,Eldon; John,0,7,75,75
1650415435119,CSE 175,A01,083665,Kumar; Rakesh,7,0,25,18
1650415441145,CSE 190,A00,092507,Dubnov; Shlomo,14,0,20,6
1650415447172,ECE 45,A01,083139,Staff,0,17,40,40
1650415453195,ECE 65,A50,083695,Staff,0,5,30,30
1650415459227,ECE 109,A01,091882,Touri; Behrouz,39,0,70,31
1650415465259,ECE 180,A00,083140,Abi Samra; Nicholas Camill,23,0,30,7
1650415465259,ECE 180,B00,083141,Abi Samra; Nicholas Camill,1,0,30,29
1650415471282,MATH 10A,A01,083735,Patchell; Gregory David,7,0,30,23
1650415471282,MATH 10A,A02,083736,Patchell; Gregory David,28,0,30,2
1650415471282,MATH 10A,A03,083737,Patchell; Gregory David,25,0,30,5
1650415477313,MATH 10B,A01,083207,Staff,0,8,30,30
1650415477313,MATH 10B,A02,083208,Staff,0,7,30,30
1650415477313,MATH 10B,B01,083739,Staff,15,0,30,15
1650415477313,MATH 10B,B02,083740,Staff,28,0,30,2
1650415483338,MATH 18,A01,083743,Staff,2,0,30,28
1650415483338,MATH 18,A02,083744,Staff,27,0,30,3
1650415483338,MATH 18,A03,083745,Staff,22,0,30,8
1650415483338,MATH 18,A04,083746,Staff,26,0,30,4
1650415483338,MATH 18,B01,083748,Staff,1,12,30,29
1650415483338,MATH 18,B02,083749,Staff,0,12,30,30
1650415483338,MATH 18,B03,083750,Staff,1,12,30,29
1650415483338,MATH 18,B04,083751,Staff,0,11,30,30
1650415489362,MATH 20A,A01,083754,Staff,25,0,40,15
1650415495386,MATH 20B,A01,083756,Staff,0,9,30,30
1650415495386,MATH 20B,A02,083757,Staff,0,9,30,30
1650415501416,MATH 20C,A01,083760,Staff,0,14,30,30
1650415501416,MATH 20C,A02,083761,Staff,1,15,30,29
1650415501416,MATH 20C,B01,083762,Staff,13,0,30,17
1650415501416,MATH 20C,B02,083763,Staff,28,0,30,2
1650415507439,MATH 20D,A01,083765,Staff,0,1,30,30
1650415507439,MATH 20D,A02,083766,Staff,7,0,30,23
1650415507439,MATH 20D,A03,083767,Staff,26,0,30,4
1650415513462,MATH 20E,A01,083771,Staff,5,0,30,25
1650415513462,MATH 20E,A02,083772,Staff,18,0,30,12
1650415513462,MATH 20E,B01,083773,Staff,0,0,30,30
1650415513462,MATH 20E,B02,083774,Staff,12,0,30,18
1650415519485,MATH 103A,A01,083777,Staff,0,11,30,30
1650415519485,MATH 103A,A02,083778,Staff,0,12,30,30
1650415519485,MATH 103A,B01,083779,Staff,0,13,30,30
1650415519485,MATH 103A,B02,083780,Staff,0,11,30,30
1650415525513,MATH 105,A01,085443,Staff,0,22,30,30
1650415531542,MATH 109,A01,083213,Anzaldo; Leesa B,0,7,30,30
1650415531542,MATH 109,A02,083214,Anzaldo; Leesa B,0,7,30,30
1650415531542,MATH 109,B01,083215,Anzaldo; Leesa B,0,5,30,30
1650415531542,MATH 109,B02,083216,Anzaldo; Leesa B,0,6,30,30
1650415537574,MATH 142A,A01,083219,Chow; Bennett,0,14,30,30
1650415537574,MATH 142A,A02,083220,Chow; Bennett,0,13,30,30
1650415537574,MATH 142A,B01,083221,Chow; Bennett,0,12,30,30
1650415537574,MATH 142A,B02,083222,Chow; Bennett,0,13,30,30
1650415543598,MATH 193A,A01,083224,Staff,0,5,30,30
1650415543598,MATH 193A,A02,083225,Staff,0,5,30,30
1650415543598,MATH 193A,A03,083781,Staff,0,4,30,30
1650415543598,MATH 193A,A04,083782,Staff,0,4,30,30
1650415549622,MATH 197,001,091859,McAuley; Julian John,9998,0,9999,1
1650415555672,COGS 9,A01,083615,Staff,0,14,60,60
1650415561698,COGS 11,A01,083617,Boyle; Mary E. T.,21,0,40,19
1650415567723,COGS 13,A01,083071,Staff,0,33,40,40
1650415573745,COGS 14A,A01,092681,Staff,0,25,100,100
1650415579774,COGS 14B,A01,083073,Cheng; Tzu-Han,0,11,50,50
1650415585800,COGS 17,A01,092677,Staff,23,0,75,52
1650415591835,COGS 100,A01,083619,Staff,0,26,60,60
1650415597857,COGS 101A,A01,083621,Davis; Joshua Daniel,0,21,60,60
1650415603882,COGS 101B,A01,091572,Staff,0,4,60,60
1650415609907,COGS 101C,A01,083625,Delgado; Tania,16,0,30,14
1650415615930,COGS 107A,A01,083627,Boyle; Mary E. T.,0,11,60,60
1650415621952,COGS 118A,A01,083075,Staff,2,0,60,58
1650415627976,CSE 3,A50,083646,Miranda; Gregory Joseph,21,0,38,17
1650415627976,CSE 3,A51,083647,Miranda; Gregory Joseph,37,0,37,0
1650415634004,CSE 8A,A50,083650,Miranda; Gregory Joseph,0,27,40,40
1650415640037,CSE 11,A01,083080,Cao; Yingjun,0,91,40,40
1650415646064,CSE 12,A01,083652,Staff,0,16,100,100
1650415652091,CSE 15L,A01,083654,Staff,0,1,50,50
1650415652091,CSE 15L,A02,083655,Staff,2,0,50,48
1650415658117,CSE 20,A01,083657,Staff,51,0,80,29
1650415664144,CSE 30,A01,083084,Eldon; John,0,76,40,40
1650415670176,CSE 100,A01,083659,Cao; Yingjun,0,66,50,50
1650415676198,CSE 134B,A01,083661,Powell; Thomas Allan,1,33,65,64
1650415682226,CSE 140,A01,083663,Staff,0,1,75,75
1650415688252,CSE 140L,A01,083088,Eldon; John,0,7,75,75
1650415694277,CSE 175,A01,083665,Kumar; Rakesh,7,0,25,18
1650415700304,CSE 190,A00,092507,Dubnov; Shlomo,14,0,20,6
1650415706328,ECE 45,A01,083139,Staff,0,17,40,40
1650415712351,ECE 65,A50,083695,Staff,0,5,30,30
1650415718377,ECE 109,A01,091882,Touri; Behrouz,39,0,70,31
1650415724401,ECE 180,A00,083140,Abi Samra; Nicholas Camill,23,0,30,7
1650415724401,ECE 180,B00,083141,Abi Samra; Nicholas Camill,1,0,30,29
1650415730435,MATH 10A,A01,083735,Patchell; Gregory David,7,0,30,23
1650415730435,MATH 10A,A02,083736,Patchell; Gregory David,28,0,30,2
1650415730435,MATH 10A,A03,083737,Patchell; Gregory David,25,0,30,5
1650415736465,MATH 10B,A01,083207,Staff,0,8,30,30
1650415736465,MATH 10B,A02,083208,Staff,0,7,30,30
1650415736465,MATH 10B,B01,083739,Staff,15,0,30,15
1650415736465,MATH 10B,B02,083740,Staff,28,0,30,2
1650415742491,MATH 18,A01,083743,Staff,2,0,30,28
1650415742491,MATH 18,A02,083744,Staff,27,0,30,3
1650415742491,MATH 18,A03,083745,Staff,22,0,30,8
1650415742491,MATH 18,A04,083746,Staff,26,0,30,4
1650415742491,MATH 18,B01,083748,Staff,1,12,30,29
1650415742491,MATH 18,B02,083749,Staff,0,12,30,30
1650415742491,MATH 18,B03,083750,Staff,1,12,30,29
1650415742491,MATH 18,B04,083751,Staff,0,11,30,30
1650415748513,MATH 20A,A01,083754,Staff,25,0,40,15
1650415754535,MATH 20B,A01,083756,Staff,0,9,30,30
1650415754535,MATH 20B,A02,083757,Staff,0,9,30,30
1650415760560,MATH 20C,A01,083760,Staff,0,14,30,30
1650415760560,MATH 20C,A02,083761,Staff,1,15,30,29
1650415760560,MATH 20C,B01,083762,Staff,13,0,30,17
1650415760560,MATH 20C,B02,083763,Staff,28,0,30,2
1650415766587,MATH 20D,A01,083765,Staff,0,1,30,30
1650415766587,MATH 20D,A02,083766,Staff,7,0,30,23
1650415766587,MATH 20D,A03,083767,Staff,26,0,30,4
1650415772612,MATH 20E,A01,083771,Staff,5,0,30,25
1650415772612,MATH 20E,A02,083772,Staff,18,0,30,12
1650415772612,MATH 20E,B01,083773,Staff,0,0,30,30
1650415772612,MATH 20E,B02,083774,Staff,12,0,30,18
1650415778730,MATH 103A,A01,083777,Staff,0,11,30,30
1650415778730,MATH 103A,A02,083778,Staff,0,12,30,30
1650415778730,MATH 103A,B01,083779,Staff,0,13,30,30
1650415778730,MATH 103A,B02,083780,Staff,0,11,30,30
1650415784757,MATH 105,A01,085443,Staff,0,22,30,30
1650415790784,MATH 109,A01,083213,Anzaldo; Leesa B,0,7,30,30
1650415790784,MATH 109,A02,083214,Anzaldo; Leesa B,0,7,30,30
1650415790784,MATH 109,B01,083215,Anzaldo; Leesa B,0,5,30,30
1650415790784,MATH 109,B02,083216,Anzaldo; Leesa B,0,6,30,30
1650415796809,MATH 142A,A01,083219,Chow; Bennett,0,14,30,30
1650415796809,MATH 142A,A02,083220,Chow; Bennett,0,13,30,30
1650415796809,MATH 142A,B01,083221,Chow; Bennett,0,12,30,30
1650415796809,MATH 142A,B02,083222,Chow; Bennett,0,13,30,30
1650415802836,MATH 193A,A01,083224,Staff,0,5,30,30
1650415802836,MATH 193A,A02,083225,Staff,0,5,30,30
1650415802836,MATH 193A,A03,083781,Staff,0,4,30,30
1650415802836,MATH 193A,A04,083782,Staff,0,4,30,30
1650415808862,MATH 197,001,091859,McAuley; Julian John,9998,0,9999,1
1650415814929,COGS 9,A01,083615,Staff,0,14,60,60
1650415820955,COGS 11,A01,083617,Boyle; Mary E. T.,21,0,40,19
1650415826978,COGS 13,A01,083071,Staff,0,33,40,40
1650415833001,COGS 14A,A01,092681,Staff,0,25,100,100
1650415839025,COGS 14B,A01,083073,Cheng; Tzu-Han,0,11,50,50
1650415845048,COGS 17,A01,092677,Staff,23,0,75,52
1650415851078,COGS 100,A01,083619,Staff,0,26,60,60
1650415857103,COGS 101A,A01,083621,Davis; Joshua Daniel,0,21,60,60
1650415863129,COGS 101B,A01,091572,Staff,0,4,60,60
1650415869156,COGS 101C,A01,083625,Delgado; Tania,16,0,30,14
1650415875181,COGS 107A,A01,083627,Boyle; Mary E. T.,0,11,60,60
1650415881207,COGS 118A,A01,083075,Staff,2,0,60,58
1650415887232,CSE 3,A50,083646,Miranda; Gregory Joseph,21,0,38,17
1650415887232,CSE 3,A51,083647,Miranda; Gregory Joseph,37,0,37,0
1650415893260,CSE 8A,A50,083650,Miranda; Gregory Joseph,0,27,40,40
1650415899282,CSE 11,A01,083080,Cao; Yingjun,0,91,40,40
1650415905313,CSE 12,A01,083652,Staff,0,16,100,100
1650415911340,CSE 15L,A01,083654,Staff,0,1,50,50
1650415911340,CSE 15L,A02,083655,Staff,2,0,50,48
1650415917362,CSE 20,A01,083657,Staff,51,0,80,29
1650415923387,CSE 30,A01,083084,Eldon; John,0,76,40,40
1650415929430,CSE 100,A01,083659,Cao; Yingjun,0,66,50,50
1650415935457,CSE 134B,A01,083661,Powell; Thomas Allan,1,33,65,64
1650415941481,CSE 140,A01,083663,Staff,0,1,75,75
1650415947505,CSE 140L,A01,083088,Eldon; John,0,7,75,75
1650415953526,CSE 175,A01,083665,Kumar; Rakesh,7,0,25,18
1650415959551,CSE 190,A00,092507,Dubnov; Shlomo,14,0,20,6
1650415965575,ECE 45,A01,083139,Staff,0,17,40,40
1650415971600,ECE 65,A50,083695,Staff,0,5,30,30
1650415977623,ECE 109,A01,091882,Touri; Behrouz,39,0,70,31
1650415983650,ECE 180,A00,083140,Abi Samra; Nicholas Camill,23,0,30,7
1650415983650,ECE 180,B00,083141,Abi Samra; Nicholas Camill,1,0,30,29
1650415989678,MATH 10A,A01,083735,Patchell; Gregory David,7,0,30,23
1650415989678,MATH 10A,A02,083736,Patchell; Gregory David,28,0,30,2
1650415989678,MATH 10A,A03,083737,Patchell; Gregory David,25,0,30,5
1650415995702,MATH 10B,A01,083207,Staff,0,8,30,30
1650415995702,MATH 10B,A02,083208,Staff,0,7,30,30
1650415995702,MATH 10B,B01,083739,Staff,15,0,30,15
1650415995702,MATH 10B,B02,083740,Staff,28,0,30,2
1650416001730,MATH 18,A01,083743,Staff,2,0,30,28
1650416001730,MATH 18,A02,083744,Staff,27,0,30,3
1650416001730,MATH 18,A03,083745,Staff,22,0,30,8
1650416001730,MATH 18,A04,083746,Staff,26,0,30,4
1650416001730,MATH 18,B01,083748,Staff,1,12,30,29
1650416001730,MATH 18,B02,083749,Staff,0,12,30,30
1650416001730,MATH 18,B03,083750,Staff,1,12,30,29
1650416001730,MATH 18,B04,083751,Staff,0,11,30,30
1650416007762,MATH 20A,A01,083754,Staff,25,0,40,15
1650416013790,MATH 20B,A01,083756,Staff,0,9,30,30
1650416013790,MATH 20B,A02,083757,Staff,0,9,30,30
1650416019813,MATH 20C,A01,083760,Staff,0,14,30,30
1650416019813,MATH 20C,A02,083761,Staff,1,15,30,29
1650416019813,MATH 20C,B01,083762,Staff,13,0,30,17
1650416019813,MATH 20C,B02,083763,Staff,28,0,30,2
1650416025845,MATH 20D,A01,083765,Staff,0,1,30,30
1650416025845,MATH 20D,A02,083766,Staff,7,0,30,23
1650416025845,MATH 20D,A03,083767,Staff,26,0,30,4
1650416031890,MATH 20E,A01,083771,Staff,5,0,30,25
1650416031890,MATH 20E,A02,083772,Staff,18,0,30,12
1650416031890,MATH 20E,B01,083773,Staff,0,0,30,30
1650416031890,MATH 20E,B02,083774,Staff,12,0,30,18
1650416037915,MATH 103A,A01,083777,Staff,0,11,30,30
1650416037915,MATH 103A,A02,083778,Staff,0,12,30,30
1650416037915,MATH 103A,B01,083779,Staff,0,13,30,30
1650416037915,MATH 103A,B02,083780,Staff,0,11,30,30
1650416043941,MATH 105,A01,085443,Staff,0,22,30,30
1650416049964,MATH 109,A01,083213,Anzaldo; Leesa B,0,7,30,30
1650416049964,MATH 109,A02,083214,Anzaldo; Leesa B,0,7,30,30
1650416049964,MATH 109,B01,083215,Anzaldo; Leesa B,0,5,30,30
1650416049964,MATH 109,B02,083216,Anzaldo; Leesa B,0,6,30,30
1650416055993,MATH 142A,A01,083219,Chow; Bennett,0,14,30,30
1650416055993,MATH 142A,A02,083220,Chow; Bennett,0,13,30,30
1650416055993,MATH 142A,B01,083221,Chow; Bennett,0,12,30,30
1650416055993,MATH 142A,B02,083222,Chow; Bennett,0,13,30,30
1650416062020,MATH 193A,A01,083224,Staff,0,5,30,30
1650416062020,MATH 193A,A02,083225,Staff,0,5,30,30
1650416062020,MATH 193A,A03,083781,Staff,0,4,30,30
1650416062020,MATH 193A,A04,083782,Staff,0,4,30,30
1650416068053,MATH 197,001,091859,McAuley; Julian John,9998,0,9999,1
1650416074108,COGS 9,A01,083615,Staff,0,14,60,60
1650416080140,COGS 11,A01,083617,Boyle; Mary E. T.,21,0,40,19
1650416086165,COGS 13,A01,083071,Staff,0,33,40,40
1650416092189,COGS 14A,A01,092681,Staff,0,25,100,100
1650416098210,COGS 14B,A01,083073,Cheng; Tzu-Han,0,11,50,50
1650416104241,COGS 17,A01,092677,Staff,23,0,75,52
1650416110262,COGS 100,A01,083619,Staff,0,26,60,60
1650416116297,COGS 101A,A01,083621,Davis; Joshua Daniel,0,21,60,60
1650416122323,COGS 101B,A01,091572,Staff,0,4,60,60
1650416128344,COGS 101C,A01,083625,Delgado; Tania,16,0,30,14
1650416134366,COGS 107A,A01,083627,Boyle; Mary E. T.,0,11,60,60
1650416140389,COGS 118A,A01,083075,Staff,2,0,60,58
1650416146424,CSE 3,A50,083646,Miranda; Gregory Joseph,21,0,38,17
1650416146424,CSE 3,A51,083647,Miranda; Gregory Joseph,37,0,37,0
1650416152446,CSE 8A,A50,083650,Miranda; Gregory Joseph,0,27,40,40
1650416158480,CSE 11,A01,083080,Cao; Yingjun,0,91,40,40
1650416164503,CSE 12,A01,083652,Staff,0,16,100,100
1650416170525,CSE 15L,A01,083654,Staff,0,1,50,50
1650416170525,CSE 15L,A02,083655,Staff,2,0,50,48
1650416176548,CSE 20,A01,083657,Staff,51,0,80,29
1650416182570,CSE 30,A01,083084,Eldon; John,0,76,40,40
1650416188593,CSE 100,A01,083659,Cao; Yingjun,0,66,50,50
1650416194616,CSE 134B,A01,083661,Powell; Thomas Allan,1,33,65,64
1650416200639,CSE 140,A01,083663,Staff,0,1,75,75
1650416206666,CSE 140L,A01,083088,Eldon; John,0,7,75,75
1650416212691,CSE 175,A01,083665,Kumar; Rakesh,7,0,25,18
1650416218715,CSE 190,A00,092507,Dubnov; Shlomo,14,0,20,6
1650416224739,ECE 45,A01,083139,Staff,0,17,40,40
1650416230765,ECE 65,A50,083695,Staff,0,5,30,30
1650416236791,ECE 109,A01,091882,Touri; Behrouz,39,0,70,31
1650416242825,ECE 180,A00,083140,Abi Samra; Nicholas Camill,23,0,30,7
1650416242825,ECE 180,B00,083141,Abi Samra; Nicholas Camill,1,0,30,29
1650416248849,MATH 10A,A01,083735,Patchell; Gregory David,7,0,30,23
1650416248849,MATH 10A,A02,083736,Patchell; Gregory David,28,0,30,2
1650416248849,MATH 10A,A03,083737,Patchell; Gregory David,25,0,30,5
1650416254880,MATH 10B,A01,083207,Staff,0,8,30,30
1650416254880,MATH 10B,A02,083208,Staff,0,7,30,30
1650416254880,MATH 10B,B01,083739,Staff,15,0,30,15
1650416254880,MATH 10B,B02,083740,Staff,28,0,30,2
1650416260904,MATH 18,A01,083743,Staff,2,0,30,28
1650416260904,MATH 18,A02,083744,Staff,27,0,30,3
1650416260904,MATH 18,A03,083745,Staff,22,0,30,8
1650416260904,MATH 18,A04,083746,Staff,26,0,30,4
1650416260904,MATH 18,B01,083748,Staff,1,12,30,29
1650416260904,MATH 18,B02,083749,Staff,0,12,30,30
1650416260904,MATH 18,B03,083750,Staff,1,12,30,29
1650416260904,MATH 18,B04,083751,Staff,0,11,30,30
1650416266930,MATH 20A,A01,083754,Staff,25,0,40,15
1650416272954,MATH 20B,A01,083756,Staff,0,9,30,30
1650416272954,MATH 20B,A02,083757,Staff,0,9,30,30
1650416278991,MATH 20C,A01,083760,Staff,0,14,30,30
1650416278991,MATH 20C,A02,083761,Staff,1,15,30,29
1650416278991,MATH 20C,B01,083762,Staff,13,0,30,17
1650416278991,MATH 20C,B02,083763,Staff,28,0,30,2
1650416285020,MATH 20D,A01,083765,Staff,0,1,30,30
1650416285020,MATH 20D,A02,083766,Staff,7,0,30,23
1650416285020,MATH 20D,A03,083767,Staff,26,0,30,4
1650416291045,MATH 20E,A01,083771,Staff,5,0,30,25
1650416291045,MATH 20E,A02,083772,Staff,18,0,30,12
1650416291045,MATH 20E,B01,083773,Staff,0,0,30,30
1650416291045,MATH 20E,B02,083774,Staff,12,0,30,18
1650416297073,MATH 103A,A01,083777,Staff,0,11,30,30
1650416297073,MATH 103A,A02,083778,Staff,0,12,30,30
1650416297073,MATH 103A,B01,083779,Staff,0,13,30,30
1650416297073,MATH 103A,B02,083780,Staff,0,11,30,30
1650416303102,MATH 105,A01,085443,Staff,0,22,30,30
1650416309127,MATH 109,A01,083213,Anzaldo; Leesa B,0,7,30,30
1650416309127,MATH 109,A02,083214,Anzaldo; Leesa B,0,7,30,30
1650416309127,MATH 109,B01,083215,Anzaldo; Leesa B,0,5,30,30
1650416309127,MATH 109,B02,083216,Anzaldo; Leesa B,0,6,30,30
1650416315157,MATH 142A,A01,083219,Chow; Bennett,0,14,30,30
1650416315157,MATH 142A,A02,083220,Chow; Bennett,0,13,30,30
1650416315157,MATH 142A,B01,083221,Chow; Bennett,0,12,30,30
1650416315157,MATH 142A,B02,083222,Chow; Bennett,0,13,30,30
1650416321185,MATH 193A,A01,083224,Staff,0,5,30,30
1650416321185,MATH 193A,A02,083225,Staff,0,5,30,30
1650416321185,MATH 193A,A03,083781,Staff,0,4,30,30
1650416321185,MATH 193A,A04,083782,Staff,0,4,30,30
1650416327208,MATH 197,001,091859,McAuley; Julian John,9998,0,9999,1
1650416333265,COGS 9,A01,083615,Staff,0,14,60,60
1650416339288,COGS 11,A01,083617,Boyle; Mary E. T.,21,0,40,19
1650416345311,COGS 13,A01,083071,Staff,0,33,40,40
1650416351338,COGS 14A,A01,092681,Staff,0,25,100,100
1650416357361,COGS 14B,A01,083073,Cheng; Tzu-Han,0,11,50,50
1650416363386,COGS 17,A01,092677,Staff,23,0,75,52
1650416369496,COGS 100,A01,083619,Staff,0,26,60,60
1650416375521,COGS 101A,A01,083621,Davis; Joshua Daniel,0,21,60,60
1650416381549,COGS 101B,A01,091572,Staff,0,4,60,60
1650416387571,COGS 101C,A01,083625,Delgado; Tania,16,0,30,14
1650416393598,COGS 107A,A01,083627,Boyle; Mary E. T.,0,11,60,60
1650416399622,COGS 118A,A01,083075,Staff,2,0,60,58
1650416405646,CSE 3,A50,083646,Miranda; Gregory Joseph,21,0,38,17
1650416405646,CSE 3,A51,083647,Miranda; Gregory Joseph,37,0,37,0
1650416411683,CSE 8A,A50,083650,Miranda; Gregory Joseph,0,27,40,40
1650416417710,CSE 11,A01,083080,Cao; Yingjun,0,91,40,40
1650416423733,CSE 12,A01,083652,Staff,0,16,100,100
1650416429757,CSE 15L,A01,083654,Staff,0,1,50,50
1650416429757,CSE 15L,A02,083655,Staff,2,0,50,48
1650416435781,CSE 20,A01,083657,Staff,51,0,80,29
1650416441804,CSE 30,A01,083084,Eldon; John,0,76,40,40
1650416447828,CSE 100,A01,083659,Cao; Yingjun,0,66,50,50
1650416453857,CSE 134B,A01,083661,Powell; Thomas Allan,1,33,65,64
1650416459880,CSE 140,A01,083663,Staff,0,1,75,75
1650416465913,CSE 140L,A01,083088,Eldon; John,0,7,75,75
1650416471945,CSE 175,A01,083665,Kumar; Rakesh,7,0,25,18
1650416477974,CSE 190,A00,092507,Dubnov; Shlomo,14,0,20,6
1650416484016,ECE 45,A01,083139,Staff,0,17,40,40
1650416490047,ECE 65,A50,083695,Staff,0,5,30,30
1650416496071,ECE 109,A01,091882,Touri; Behrouz,39,0,70,31
1650416502099,ECE 180,A00,083140,Abi Samra; Nicholas Camill,23,0,30,7
1650416502099,ECE 180,B00,083141,Abi Samra; Nicholas Camill,1,0,30,29
1650416508127,MATH 10A,A01,083735,Patchell; Gregory David,7,0,30,23
1650416508127,MATH 10A,A02,083736,Patchell; Gregory David,28,0,30,2
1650416508127,MATH 10A,A03,083737,Patchell; Gregory David,25,0,30,5
1650416514151,MATH 10B,A01,083207,Staff,0,8,30,30
1650416514151,MATH 10B,A02,083208,Staff,0,7,30,30
1650416514151,MATH 10B,B01,083739,Staff,15,0,30,15
1650416514151,MATH 10B,B02,083740,Staff,28,0,30,2
1650416520179,MATH 18,A01,083743,Staff,2,0,30,28
1650416520179,MATH 18,A02,083744,Staff,27,0,30,3
1650416520179,MATH 18,A03,083745,Staff,22,0,30,8
1650416520179,MATH 18,A04,083746,Staff,26,0,30,4
1650416520179,MATH 18,B01,083748,Staff,1,12,30,29
1650416520179,MATH 18,B02,083749,Staff,0,12,30,30
1650416520179,MATH 18,B03,083750,Staff,1,12,30,29
1650416520179,MATH 18,B04,083751,Staff,0,11,30,30
1650416526204,MATH 20A,A01,083754,Staff,25,0,40,15
1650416532241,MATH 20B,A01,083756,Staff,0,9,30,30
1650416532241,MATH 20B,A02,083757,Staff,0,9,30,30
1650416538281,MATH 20C,A01,083760,Staff,0,14,30,30
1650416538281,MATH 20C,A02,083761,Staff,1,15,30,29
1650416538281,MATH 20C,B01,083762,Staff,13,0,30,17
1650416538281,MATH 20C,B02,083763,Staff,28,0,30,2
1650416544307,MATH 20D,A01,083765,Staff,0,1,30,30
1650416544307,MATH 20D,A02,083766,Staff,7,0,30,23
1650416544307,MATH 20D,A03,083767,Staff,26,0,30,4
1650416550331,MATH 20E,A01,083771,Staff,5,0,30,25
1650416550331,MATH 20E,A02,083772,Staff,18,0,30,12
1650416550331,MATH 20E,B01,083773,Staff,0,0,30,30
1650416550331,MATH 20E,B02,083774,Staff,12,0,30,18
1650416556362,MATH 103A,A01,083777,Staff,0,11,30,30
1650416556362,MATH 103A,A02,083778,Staff,0,12,30,30
1650416556362,MATH 103A,B01,083779,Staff,0,13,30,30
1650416556362,MATH 103A,B02,083780,Staff,0,11,30,30
1650416562385,MATH 105,A01,085443,Staff,0,22,30,30
1650416568423,MATH 109,A01,083213,Anzaldo; Leesa B,0,7,30,30
1650416568423,MATH 109,A02,083214,Anzaldo; Leesa B,0,7,30,30
1650416568423,MATH 109,B01,083215,Anzaldo; Leesa B,0,5,30,30
1650416568423,MATH 109,B02,083216,Anzaldo; Leesa B,0,6,30,30
1650416574452,MATH 142A,A01,083219,Chow; Bennett,0,14,30,30
1650416574452,MATH 142A,A02,083220,Chow; Bennett,0,13,30,30
1650416574452,MATH 142A,B01,083221,Chow; Bennett,0,12,30,30
1650416574452,MATH 142A,B02,083222,Chow; Bennett,0,13,30,30
1650416580475,MATH 193A,A01,083224,Staff,0,5,30,30
1650416580475,MATH 193A,A02,083225,Staff,0,5,30,30
1650416580475,MATH 193A,A03,083781,Staff,0,4,30,30
1650416580475,MATH 193A,A04,083782,Staff,0,4,30,30
1650416586502,MATH 197,001,091859,McAuley; Julian John,9998,0,9999,1
1650416592569,COGS 9,A01,083615,Staff,0,14,60,60
1650416598600,COGS 11,A01,083617,Boyle; Mary E. T.,21,0,40,19
1650416604629,COGS 13,A01,083071,Staff,0,33,40,40
1650416610653,COGS 14A,A01,092681,Staff,0,25,100,100
1650416616691,COGS 14B,A01,083073,Cheng; Tzu-Han,0,11,50,50
1650416622722,COGS 17,A01,092677,Staff,23,0,75,52
1650416628750,COGS 100,A01,083619,Staff,0,26,60,60
1650416634773,COGS 101A,A01,083621,Davis; Joshua Daniel,0,21,60,60
1650416640799,COGS 101B,A01,091572,Staff,0,4,60,60
1650416646832,COGS 101C,A01,083625,Delgado; Tania,16,0,30,14
1650416652854,COGS 107A,A01,083627,Boyle; Mary E. T.,0,11,60,60
1650416658878,COGS 118A,A01,083075,Staff,2,0,60,58
1650416664902,CSE 3,A50,083646,Miranda; Gregory Joseph,21,0,38,17
1650416664902,CSE 3,A51,083647,Miranda; Gregory Joseph,37,0,37,0
1650416670933,CSE 8A,A50,083650,Miranda; Gregory Joseph,0,27,40,40
1650416676959,CSE 11,A01,083080,Cao; Yingjun,0,91,40,40
1650416682983,CSE 12,A01,083652,Staff,0,16,100,100
1650416689009,CSE 15L,A01,083654,Staff,0,1,50,50
1650416689009,CSE 15L,A02,083655,Staff,2,0,50,48
1650416695033,CSE 20,A01,083657,Staff,51,0,80,29
1650416701055,CSE 30,A01,083084,Eldon; John,0,76,40,40
1650416707082,CSE 100,A01,083659,Cao; Yingjun,0,66,50,50
1650416713109,CSE 134B,A01,083661,Powell; Thomas Allan,1,33,65,64
1650416719141,CSE 140,A01,083663,Staff,0,1,75,75
1650416725169,CSE 140L,A01,083088,Eldon; John,0,7,75,75
1650416731192,CSE 175,A01,083665,Kumar; Rakesh,7,0,25,18
1650416737217,CSE 190,A00,092507,Dubnov; Shlomo,14,0,20,6
1650416743242,ECE 45,A01,083139,Staff,0,17,40,40
1650416749266,ECE 65,A50,083695,Staff,0,5,30,30
1650416755293,ECE 109,A01,091882,Touri; Behrouz,39,0,70,31
1650416761319,ECE 180,A00,083140,Abi Samra; Nicholas Camill,23,0,30,7
1650416761319,ECE 180,B00,083141,Abi Samra; Nicholas Camill,1,0,30,29
1650416767361,MATH 10A,A01,083735,Patchell; Gregory David,7,0,30,23
1650416767361,MATH 10A,A02,083736,Patchell; Gregory David,28,0,30,2
1650416767361,MATH 10A,A03,083737,Patchell; Gregory David,25,0,30,5
1650416773390,MATH 10B,A01,083207,Staff,0,8,30,30
1650416773390,MATH 10B,A02,083208,Staff,0,7,30,30
1650416773390,MATH 10B,B01,083739,Staff,15,0,30,15
1650416773390,MATH 10B,B02,083740,Staff,28,0,30,2
1650416779416,MATH 18,A01,083743,Staff,2,0,30,28
1650416779416,MATH 18,A02,083744,Staff,27,0,30,3
1650416779416,MATH 18,A03,083745,Staff,22,0,30,8
1650416779416,MATH 18,A04,083746,Staff,26,0,30,4
1650416779416,MATH 18,B01,083748,Staff,1,12,30,29
1650416779416,MATH 18,B02,083749,Staff,0,12,30,30
1650416779416,MATH 18,B03,083750,Staff,1,12,30,29
1650416779416,MATH 18,B04,083751,Staff,0,11,30,30
1650416785452,MATH 20A,A01,083754,Staff,25,0,40,15
1650416791482,MATH 20B,A01,083756,Staff,0,9,30,30
1650416791482,MATH 20B,A02,083757,Staff,0,9,30,30
1650416797524,MATH 20C,A01,083760,Staff,0,14,30,30
1650416797524,MATH 20C,A02,083761,Staff,1,15,30,29
1650416797524,MATH 20C,B01,083762,Staff,13,0,30,17
1650416797524,MATH 20C,B02,083763,Staff,28,0,30,2
1650416803551,MATH 20D,A01,083765,Staff,0,1,30,30
1650416803551,MATH 20D,A02,083766,Staff,7,0,30,23
1650416803551,MATH 20D,A03,083767,Staff,26,0,30,4
1650416809579,MATH 20E,A01,083771,Staff,5,0,30,25
1650416809579,MATH 20E,A02,083772,Staff,18,0,30,12
1650416809579,MATH 20E,B01,083773,Staff,0,0,30,30
1650416809579,MATH 20E,B02,083774,Staff,12,0,30,18
1650416815607,MATH 103A,A01,083777,Staff,0,11,30,30
1650416815607,MATH 103A,A02,083778,Staff,0,12,30,30
1650416815607,MATH 103A,B01,083779,Staff,0,13,30,30
1650416815607,MATH 103A,B02,083780,Staff,0,11,30,30
1650416821632,MATH 105,A01,085443,Staff,0,22,30,30
1650416827656,MATH 109,A01,083213,Anzaldo; Leesa B,0,7,30,30
1650416827656,MATH 109,A02,083214,Anzaldo; Leesa B,0,7,30,30
1650416827656,MATH 109,B01,083215,Anzaldo; Leesa B,0,5,30,30
1650416827656,MATH 109,B02,083216,Anzaldo; Leesa B,0,6,30,30
1650416833681,MATH 142A,A01,083219,Chow; Bennett,0,14,30,30
1650416833681,MATH 142A,A02,083220,Chow; Bennett,0,13,30,30
1650416833681,MATH 142A,B01,083221,Chow; Bennett,0,12,30,30
1650416833681,MATH 142A,B02,083222,Chow; Bennett,0,13,30,30
1650416839704,MATH 193A,A01,083224,Staff,0,5,30,30
1650416839704,MATH 193A,A02,083225,Staff,0,5,30,30
1650416839704,MATH 193A,A03,083781,Staff,0,4,30,30
1650416839704,MATH 193A,A04,083782,Staff,0,4,30,30
1650416845728,MATH 197,001,091859,McAuley; Julian John,9998,0,9999,1
1650416851781,COGS 9,A01,083615,Staff,0,14,60,60
1650416857805,COGS 11,A01,083617,Boyle; Mary E. T.,21,0,40,19
1650416863828,COGS 13,A01,083071,Staff,0,33,40,40
1650416869866,COGS 14A,A01,092681,Staff,0,25,100,100
1650416875891,COGS 14B,A01,083073,Cheng; Tzu-Han,0,11,50,50
1650416881928,COGS 17,A01,092677,Staff,23,0,75,52
1650416887953,COGS 100,A01,083619,Staff,0,26,60,60
1650416893983,COGS 101A,A01,083621,Davis; Joshua Daniel,0,21,60,60
1650416900007,COGS 101B,A01,091572,Staff,0,4,60,60
1650416906034,COGS 101C,A01,083625,Delgado; Tania,16,0,30,14
1650416912059,COGS 107A,A01,083627,Boyle; Mary E. T.,0,11,60,60
1650416918093,COGS 118A,A01,083075,Staff,2,0,60,58
1650416924123,CSE 3,A50,083646,Miranda; Gregory Joseph,21,0,38,17
1650416924123,CSE 3,A51,083647,Miranda; Gregory Joseph,37,0,37,0
1650416930154,CSE 8A,A50,083650,Miranda; Gregory Joseph,0,27,40,40
1650416936180,CSE 11,A01,083080,Cao; Yingjun,0,91,40,40
1650416942206,CSE 12,A01,083652,Staff,0,16,100,100
1650416948231,CSE 15L,A01,083654,Staff,0,1,50,50
1650416948231,CSE 15L,A02,083655,Staff,2,0,50,48
1650416954253,CSE 20,A01,083657,Staff,51,0,80,29
1650416960277,CSE 30,A01,083084,Eldon; John,0,76,40,40
1650416966393,CSE 100,A01,083659,Cao; Yingjun,0,66,50,50
1650416972416,CSE 134B,A01,083661,Powell; Thomas Allan,1,33,65,64
1650416978442,CSE 140,A01,083663,Staff,0,1,75,75
1650416984473,CSE 140L,A01,083088,Eldon; John,0,7,75,75
1650416990496,CSE 175,A01,083665,Kumar; Rakesh,7,0,25,18
1650416996520,CSE 190,A00,092507,Dubnov; Shlomo,14,0,20,6
1650417002544,ECE 45,A01,083139,Staff,0,17,40,40
1650417008568,ECE 65,A50,083695,Staff,0,5,30,30
1650417014600,ECE 109,A01,091882,Touri; Behrouz,39,0,70,31
1650417020628,ECE 180,A00,083140,Abi Samra; Nicholas Camill,23,0,30,7
1650417020628,ECE 180,B00,083141,Abi Samra; Nicholas Camill,1,0,30,29
1650417026658,MATH 10A,A01,083735,Patchell; Gregory David,7,0,30,23
1650417026658,MATH 10A,A02,083736,Patchell; Gregory David,28,0,30,2
1650417026658,MATH 10A,A03,083737,Patchell; Gregory David,25,0,30,5
1650417032682,MATH 10B,A01,083207,Staff,0,8,30,30
1650417032682,MATH 10B,A02,083208,Staff,0,7,30,30
1650417032682,MATH 10B,B01,083739,Staff,15,0,30,15
1650417032682,MATH 10B,B02,083740,Staff,28,0,30,2
1650417038708,MATH 18,A01,083743,Staff,2,0,30,28
1650417038708,MATH 18,A02,083744,Staff,27,0,30,3
1650417038708,MATH 18,A03,083745,Staff,22,0,30,8
1650417038708,MATH 18,A04,083746,Staff,26,0,30,4
1650417038708,MATH 18,B01,083748,Staff,1,12,30,29
1650417038708,MATH 18,B02,083749,Staff,0,12,30,30
1650417038708,MATH 18,B03,083750,Staff,1,12,30,29
1650417038708,MATH 18,B04,083751,Staff,0,11,30,30
1650417044735,MATH 20A,A01,083754,Staff,25,0,40,15
1650417050758,MATH 20B,A01,083756,Staff,0,9,30,30
1650417050758,MATH 20B,A02,083757,Staff,0,9,30,30
1650417056785,MATH 20C,A01,083760,Staff,0,14,30,30
1650417056785,MATH 20C,A02,083761,Staff,1,15,30,29
1650417056785,MATH 20C,B01,083762,Staff,13,0,30,17
1650417056785,MATH 20C,B02,083763,Staff,28,0,30,2
1650417062818,MATH 20D,A01,083765,Staff,0,1,30,30
1650417062818,MATH 20D,A02,083766,Staff,7,0,30,23
1650417062818,MATH 20D,A03,083767,Staff,26,0,30,4
1650417068842,MATH 20E,A01,083771,Staff,5,0,30,25
1650417068842,MATH 20E,A02,083772,Staff,18,0,30,12
1650417068842,MATH 20E,B01,083773,Staff,0,0,30,30
1650417068842,MATH 20E,B02,083774,Staff,12,0,30,18
1650417074868,MATH 103A,A01,083777,Staff,0,11,30,30
1650417074868,MATH 103A,A02,083778,Staff,0,12,30,30
1650417074868,MATH 103A,B01,083779,Staff,0,13,30,30
1650417074868,MATH 103A,B02,083780,Staff,0,11,30,30
1650417080891,MATH 105,A01,085443,Staff,0,22,30,30
1650417086918,MATH 109,A01,083213,Anzaldo; Leesa B,0,7,30,30
1650417086918,MATH 109,A02,083214,Anzaldo; Leesa B,0,7,30,30
1650417086918,MATH 109,B01,083215,Anzaldo; Leesa B,0,5,30,30
1650417086918,MATH 109,B02,083216,Anzaldo; Leesa B,0,6,30,30
1650417092947,MATH 142A,A01,083219,Chow; Bennett,0,14,30,30
1650417092947,MATH 142A,A02,083220,Chow; Bennett,0,13,30,30
1650417092947,MATH 142A,B01,083221,Chow; Bennett,0,12,30,30
1650417092947,MATH 142A,B02,083222,Chow; Bennett,0,13,30,30
1650417098973,MATH 193A,A01,083224,Staff,0,5,30,30
1650417098973,MATH 193A,A02,083225,Staff,0,5,30,30
1650417098973,MATH 193A,A03,083781,Staff,0,4,30,30
1650417098973,MATH 193A,A04,083782,Staff,0,4,30,30
1650417104998,MATH 197,001,091859,McAuley; Julian John,9998,0,9999,1
1650417111049,COGS 9,A01,083615,Staff,0,14,60,60
1650417117076,COGS 11,A01,083617,Boyle; Mary E. T.,21,0,40,19
1650417123108,COGS 13,A01,083071,Staff,0,33,40,40
1650417129140,COGS 14A,A01,092681,Staff,0,25,100,100
1650417135166,COGS 14B,A01,083073,Cheng; Tzu-Han,0,11,50,50
1650417141192,COGS 17,A01,092677,Staff,23,0,75,52
1650417147215,COGS 100,A01,083619,Staff,0,26,60,60
1650417153239,COGS 101A,A01,083621,Davis; Joshua Daniel,0,21,60,60
1650417159261,COGS 101B,A01,091572,Staff,0,4,60,60
1650417165288,COGS 101C,A01,083625,Delgado; Tania,16,0,30,14
1650417171312,COGS 107A,A01,083627,Boyle; Mary E. T.,0,11,60,60
1650417177339,COGS 118A,A01,083075,Staff,2,0,60,58
1650417183367,CSE 3,A50,083646,Miranda; Gregory Joseph,21,0,38,17
1650417183367,CSE 3,A51,083647,Miranda; Gregory Joseph,37,0,37,0
1650417189391,CSE 8A,A50,083650,Miranda; Gregory Joseph,0,27,40,40
1650417195418,CSE 11,A01,083080,Cao; Yingjun,0,91,40,40
1650417201444,CSE 12,A01,083652,Staff,0,16,100,100
1650417207470,CSE 15L,A01,083654,Staff,0,1,50,50
1650417207470,CSE 15L,A02,083655,Staff,2,0,50,48
1650417213493,CSE 20,A01,083657,Staff,51,0,80,29
1650417219533,CSE 30,A01,083084,Eldon; John,0,76,40,40
1650417225560,CSE 100,A01,083659,Cao; Yingjun,0,66,50,50
1650417231585,CSE 134B,A01,083661,Powell; Thomas Allan,1,33,65,64
1650417237608,CSE 140,A01,083663,Staff,0,1,75,75
1650417243635,CSE 140L,A01,083088,Eldon; John,0,7,75,75
1650417249660,CSE 175,A01,083665,Kumar; Rakesh,7,0,25,18
1650417255692,CSE 190,A00,092507,Dubnov; Shlomo,14,0,20,6
1650417261715,ECE 45,A01,083139,Staff,0,17,40,40
1650417267737,ECE 65,A50,083695,Staff,0,5,30,30
1650417273760,ECE 109,A01,091882,Touri; Behrouz,39,0,70,31
1650417279796,ECE 180,A00,083140,Abi Samra; Nicholas Camill,23,0,30,7
1650417279796,ECE 180,B00,083141,Abi Samra; Nicholas Camill,1,0,30,29
1650417285835,MATH 10A,A01,083735,Patchell; Gregory David,7,0,30,23
1650417285835,MATH 10A,A02,083736,Patchell; Gregory David,28,0,30,2
1650417285835,MATH 10A,A03,083737,Patchell; Gregory David,25,0,30,5
1650417291859,MATH 10B,A01,083207,Staff,0,8,30,30
1650417291859,MATH 10B,A02,083208,Staff,0,7,30,30
1650417291859,MATH 10B,B01,083739,Staff,15,0,30,15
1650417291859,MATH 10B,B02,083740,Staff,28,0,30,2
1650417297902,MATH 18,A01,083743,Staff,2,0,30,28
1650417297902,MATH 18,A02,083744,Staff,27,0,30,3
1650417297902,MATH 18,A03,083745,Staff,22,0,30,8
1650417297902,MATH 18,A04,083746,Staff,26,0,30,4
1650417297902,MATH 18,B01,083748,Staff,1,12,30,29
1650417297902,MATH 18,B02,083749,Staff,0,12,30,30
1650417297902,MATH 18,B03,083750,Staff,1,12,30,29
1650417297902,MATH 18,B04,083751,Staff,0,11,30,30
1650417303930,MATH 20A,A01,083754,Staff,25,0,40,15
1650417309963,MATH 20B,A01,083756,Staff,0,9,30,30
1650417309963,MATH 20B,A02,083757,Staff,0,9,30,30
1650417315990,MATH 20C,A01,083760,Staff,0,14,30,30
1650417315990,MATH 20C,A02,083761,Staff,1,15,30,29
1650417315990,MATH 20C,B01,083762,Staff,13,0,30,17
1650417315990,MATH 20C,B02,083763,Staff,28,0,30,2
1650417322081,MATH 20D,A01,083765,Staff,0,1,30,30
1650417322081,MATH 20D,A02,083766,Staff,7,0,30,23
1650417322081,MATH 20D,A03,083767,Staff,26,0,30,4
1650417328105,MATH 20E,A01,083771,Staff,5,0,30,25
1650417328105,MATH 20E,A02,083772,Staff,18,0,30,12
1650417328105,MATH 20E,B01,083773,Staff,0,0,30,30
1650417328105,MATH 20E,B02,083774,Staff,12,0,30,18
1650417334130,MATH 103A,A01,083777,Staff,0,11,30,30
1650417334130,MATH 103A,A02,083778,Staff,0,12,30,30
1650417334130,MATH 103A,B01,083779,Staff,0,13,30,30
1650417334130,MATH 103A,B02,083780,Staff,0,11,30,30
1650417340154,MATH 105,A01,085443,Staff,0,22,30,30
1650417346176,MATH 109,A01,083213,Anzaldo; Leesa B,0,7,30,30
1650417346176,MATH 109,A02,083214,Anzaldo; Leesa B,0,7,30,30
1650417346176,MATH 109,B01,083215,Anzaldo; Leesa B,0,5,30,30
1650417346176,MATH 109,B02,083216,Anzaldo; Leesa B,0,6,30,30
1650417352208,MATH 142A,A01,083219,Chow; Bennett,0,14,30,30
1650417352208,MATH 142A,A02,083220,Chow; Bennett,0,13,30,30
1650417352208,MATH 142A,B01,083221,Chow; Bennett,0,12,30,30
1650417352208,MATH 142A,B02,083222,Chow; Bennett,0,13,30,30
1650417358232,MATH 193A,A01,083224,Staff,0,5,30,30
1650417358232,MATH 193A,A02,083225,Staff,0,5,30,30
1650417358232,MATH 193A,A03,083781,Staff,0,4,30,30
1650417358232,MATH 193A,A04,083782,Staff,0,4,30,30
1650417364258,MATH 197,001,091859,McAuley; Julian John,9998,0,9999,1
1650417370311,COGS 9,A01,083615,Staff,0,14,60,60
1650417376336,COGS 11,A01,083617,Boyle; Mary E. T.,21,0,40,19
1650417382362,COGS 13,A01,083071,Staff,0,33,40,40
1650417388386,COGS 14A,A01,092681,Staff,0,25,100,100
1650417394410,COGS 14B,A01,083073,Cheng; Tzu-Han,0,11,50,50
1650417400436,COGS 17,A01,092677,Staff,23,0,75,52
1650417406461,COGS 100,A01,083619,Staff,0,26,60,60
1650417412495,COGS 101A,A01,083621,Davis; Joshua Daniel,0,21,60,60
1650417418525,COGS 101B,A01,091572,Staff,0,4,60,60
1650417424551,COGS 101C,A01,083625,Delgado; Tania,16,0,30,14
1650417430581,COGS 107A,A01,083627,Boyle; Mary E. T.,0,11,60,60
1650417436605,COGS 118A,A01,083075,Staff,2,0,60,58
1650417442631,CSE 3,A50,083646,Miranda; Gregory Joseph,21,0,38,17
1650417442631,CSE 3,A51,083647,Miranda; Gregory Joseph,37,0,37,0
1650417448656,CSE 8A,A50,083650,Miranda; Gregory Joseph,0,27,40,40
1650417454683,CSE 11,A01,083080,Cao; Yingjun,0,91,40,40
1650417460708,CSE 12,A01,083652,Staff,0,16,100,100
1650417466746,CSE 15L,A01,083654,Staff,0,1,50,50
1650417466746,CSE 15L,A02,083655,Staff,2,0,50,48
1650417472774,CSE 20,A01,083657,Staff,51,0,80,29
1650417478800,CSE 30,A01,083084,Eldon; John,0,76,40,40
1650417484828,CSE 100,A01,083659,Cao; Yingjun,0,66,50,50
1650417490860,CSE 134B,A01,083661,Powell; Thomas Allan,1,33,65,64
1650417496886,CSE 140,A01,083663,Staff,0,1,75,75
1650417502913,CSE 140L,A01,083088,Eldon; John,0,7,75,75
1650417508936,CSE 175,A01,083665,Kumar; Rakesh,7,0,25,18
1650417514958,CSE 190,A00,092507,Dubnov; Shlomo,14,0,20,6
1650417520993,ECE 45,A01,083139,Staff,0,17,40,40
1650417527017,ECE 65,A50,083695,Staff,0,5,30,30
1650417533044,ECE 109,A01,091882,Touri; Behrouz,39,0,70,31
1650417539074,ECE 180,A00,083140,Abi Samra; Nicholas Camill,23,0,30,7
1650417539074,ECE 180,B00,083141,Abi Samra; Nicholas Camill,1,0,30,29
1650417545098,MATH 10A,A01,083735,Patchell; Gregory David,7,0,30,23
1650417545098,MATH 10A,A02,083736,Patchell; Gregory David,28,0,30,2
1650417545098,MATH 10A,A03,083737,Patchell; Gregory David,25,0,30,5
1650417551123,MATH 10B,A01,083207,Staff,0,8,30,30
1650417551123,MATH 10B,A02,083208,Staff,0,7,30,30
1650417551123,MATH 10B,B01,083739,Staff,15,0,30,15
1650417551123,MATH 10B,B02,083740,Staff,28,0,30,2
1650417557162,MATH 18,A01,083743,Staff,2,0,30,28
1650417557162,MATH 18,A02,083744,Staff,27,0,30,3
1650417557162,MATH 18,A03,083745,Staff,22,0,30,8
1650417557162,MATH 18,A04,083746,Staff,26,0,30,4
1650417557162,MATH 18,B01,083748,Staff,1,12,30,29
1650417557162,MATH 18,B02,083749,Staff,0,12,30,30
1650417557162,MATH 18,B03,083750,Staff,1,12,30,29
1650417557162,MATH 18,B04,083751,Staff,0,11,30,30
1650417563286,MATH 20A,A01,083754,Staff,25,0,40,15
1650417569317,MATH 20B,A01,083756,Staff,0,9,30,30
1650417569317,MATH 20B,A02,083757,Staff,0,9,30,30
1650417575341,MATH 20C,A01,083760,Staff,0,14,30,30
1650417575341,MATH 20C,A02,083761,Staff,1,15,30,29
1650417575341,MATH 20C,B01,083762,Staff,13,0,30,17
1650417575341,MATH 20C,B02,083763,Staff,28,0,30,2
1650417581365,MATH 20D,A01,083765,Staff,0,1,30,30
1650417581365,MATH 20D,A02,083766,Staff,7,0,30,23
1650417581365,MATH 20D,A03,083767,Staff,26,0,30,4
1650417587387,MATH 20E,A01,083771,Staff,5,0,30,25
1650417587387,MATH 20E,A02,083772,Staff,18,0,30,12
1650417587387,MATH 20E,B01,083773,Staff,0,0,30,30
1650417587387,MATH 20E,B02,083774,Staff,12,0,30,18
1650417593411,MATH 103A,A01,083777,Staff,0,11,30,30
1650417593411,MATH 103A,A02,083778,Staff,0,12,30,30
1650417593411,MATH 103A,B01,083779,Staff,0,13,30,30
1650417593411,MATH 103A,B02,083780,Staff,0,11,30,30
1650417599432,MATH 105,A01,085443,Staff,0,22,30,30
1650417605457,MATH 109,A01,083213,Anzaldo; Leesa B,0,7,30,30
1650417605457,MATH 109,A02,083214,Anzaldo; Leesa B,0,7,30,30
1650417605457,MATH 109,B01,083215,Anzaldo; Leesa B,0,5,30,30
1650417605457,MATH 109,B02,083216,Anzaldo; Leesa B,0,6,30,30
1650417611483,MATH 142A,A01,083219,Chow; Bennett,0,14,30,30
1650417611483,MATH 142A,A02,083220,Chow; Bennett,0,13,30,30
1650417611483,MATH 142A,B01,083221,Chow; Bennett,0,12,30,30
1650417611483,MATH 142A,B02,083222,Chow; Bennett,0,13,30,30
1650417617506,MATH 193A,A01,083224,Staff,0,5,30,30
1650417617506,MATH 193A,A02,083225,Staff,0,5,30,30
1650417617506,MATH 193A,A03,083781,Staff,0,4,30,30
1650417617506,MATH 193A,A04,083782,Staff,0,4,30,30
1650417623531,MATH 197,001,091859,McAuley; Julian John,9998,0,9999,1
1650417629596,COGS 9,A01,083615,Staff,0,14,60,60
1650417635620,COGS 11,A01,083617,Boyle; Mary E. T.,21,0,40,19
1650417641644,COGS 13,A01,083071,Staff,0,33,40,40
1650417647676,COGS 14A,A01,092681,Staff,0,25,100,100
1650417653700,COGS 14B,A01,083073,Cheng; Tzu-Han,0,11,50,50
1650417659725,COGS 17,A01,092677,Staff,23,0,75,52
1650417665759,COGS 100,A01,083619,Staff,0,26,60,60
1650417671788,COGS 101A,A01,083621,Davis; Joshua Daniel,0,21,60,60
1650417677813,COGS 101B,A01,091572,Staff,0,4,60,60
1650417683837,COGS 101C,A01,083625,Delgado; Tania,16,0,30,14
1650417689870,COGS 107A,A01,083627,Boyle; Mary E. T.,0,11,60,60
1650417695894,COGS 118A,A01,083075,Staff,2,0,60,58
1650417701918,CSE 3,A50,083646,Miranda; Gregory Joseph,21,0,38,17
1650417701918,CSE 3,A51,083647,Miranda; Gregory Joseph,37,0,37,0
1650417707947,CSE 8A,A50,083650,Miranda; Gregory Joseph,0,27,40,40
1650417713972,CSE 11,A01,083080,Cao; Yingjun,0,91,40,40
1650417719996,CSE 12,A01,083652,Staff,0,16,100,100
1650417726018,CSE 15L,A01,083654,Staff,0,1,50,50
1650417726018,CSE 15L,A02,083655,Staff,2,0,50,48
1650417732041,CSE 20,A01,083657,Staff,51,0,80,29
1650417738074,CSE 30,A01,083084,Eldon; John,0,76,40,40
1650417744098,CSE 100,A01,083659,Cao; Yingjun,0,66,50,50
1650417750134,CSE 134B,A01,083661,Powell; Thomas Allan,1,33,65,64
1650417756159,CSE 140,A01,083663,Staff,0,1,75,75
1650417762185,CSE 140L,A01,083088,Eldon; John,0,7,75,75
1650417768211,CSE 175,A01,083665,Kumar; Rakesh,7,0,25,18
1650417774235,CSE 190,A00,092507,Dubnov; Shlomo,14,0,20,6
1650417780259,ECE 45,A01,083139,Staff,0,17,40,40
1650417786282,ECE 65,A50,083695,Staff,0,5,30,30
1650417792310,ECE 109,A01,091882,Touri; Behrouz,39,0,70,31
1650417798334,ECE 180,A00,083140,Abi Samra; Nicholas Camill,23,0,30,7
1650417798334,ECE 180,B00,083141,Abi Samra; Nicholas Camill,1,0,30,29
1650417804360,MATH 10A,A01,083735,Patchell; Gregory David,7,0,30,23
1650417804360,MATH 10A,A02,083736,Patchell; Gregory David,28,0,30,2
1650417804360,MATH 10A,A03,083737,Patchell; Gregory David,25,0,30,5
1650417810385,MATH 10B,A01,083207,Staff,0,8,30,30
1650417810385,MATH 10B,A02,083208,Staff,0,7,30,30
1650417810385,MATH 10B,B01,083739,Staff,15,0,30,15
1650417810385,MATH 10B,B02,083740,Staff,28,0,30,2
1650417816410,MATH 18,A01,083743,Staff,2,0,30,28
1650417816410,MATH 18,A02,083744,Staff,27,0,30,3
1650417816410,MATH 18,A03,083745,Staff,22,0,30,8
1650417816410,MATH 18,A04,083746,Staff,26,0,30,4
1650417816410,MATH 18,B01,083748,Staff,1,12,30,29
1650417816410,MATH 18,B02,083749,Staff,0,12,30,30
1650417816410,MATH 18,B03,083750,Staff,1,12,30,29
1650417816410,MATH 18,B04,083751,Staff,0,11,30,30
1650417822435,MATH 20A,A01,083754,Staff,25,0,40,15
1650417828462,MATH 20B,A01,083756,Staff,0,9,30,30
1650417828462,MATH 20B,A02,083757,Staff,0,9,30,30
1650417834485,MATH 20C,A01,083760,Staff,0,14,30,30
1650417834485,MATH 20C,A02,083761,Staff,1,15,30,29
1650417834485,MATH 20C,B01,083762,Staff,13,0,30,17
1650417834485,MATH 20C,B02,083763,Staff,28,0,30,2
1650417840507,MATH 20D,A01,083765,Staff,0,1,30,30
1650417840507,MATH 20D,A02,083766,Staff,7,0,30,23
1650417840507,MATH 20D,A03,083767,Staff,26,0,30,4
1650417846532,MATH 20E,A01,083771,Staff,5,0,30,25
1650417846532,MATH 20E,A02,083772,Staff,18,0,30,12
1650417846532,MATH 20E,B01,083773,Staff,0,0,30,30
1650417846532,MATH 20E,B02,083774,Staff,12,0,30,18
1650417852555,MATH 103A,A01,083777,Staff,0,11,30,30
1650417852555,MATH 103A,A02,083778,Staff,0,12,30,30
1650417852555,MATH 103A,B01,083779,Staff,0,13,30,30
1650417852555,MATH 103A,B02,083780,Staff,0,11,30,30
1650417858583,MATH 105,A01,085443,Staff,0,22,30,30
1650417864611,MATH 109,A01,083213,Anzaldo; Leesa B,0,7,30,30
1650417864611,MATH 109,A02,083214,Anzaldo; Leesa B,0,7,30,30
1650417864611,MATH 109,B01,083215,Anzaldo; Leesa B,0,5,30,30
1650417864611,MATH 109,B02,083216,Anzaldo; Leesa B,0,6,30,30
1650417870640,MATH 142A,A01,083219,Chow; Bennett,0,14,30,30
1650417870640,MATH 142A,A02,083220,Chow; Bennett,0,13,30,30
1650417870640,MATH 142A,B01,083221,Chow; Bennett,0,12,30,30
1650417870640,MATH 142A,B02,083222,Chow; Bennett,0,13,30,30
1650417876663,MATH 193A,A01,083224,Staff,0,5,30,30
1650417876663,MATH 193A,A02,083225,Staff,0,5,30,30
1650417876663,MATH 193A,A03,083781,Staff,0,4,30,30
1650417876663,MATH 193A,A04,083782,Staff,0,4,30,30
1650417882692,MATH 197,001,091859,McAuley; Julian John,9998,0,9999,1
1650417888751,COGS 9,A01,083615,Staff,0,14,60,60
1650417894774,COGS 11,A01,083617,Boyle; Mary E. T.,21,0,40,19
1650417900802,COGS 13,A01,083071,Staff,0,34,40,40
1650417906829,COGS 14A,A01,092681,Staff,0,25,100,100
1650417912856,COGS 14B,A01,083073,Cheng; Tzu-Han,0,11,50,50
1650417918884,COGS 17,A01,092677,Staff,23,0,75,52
1650417924907,COGS 100,A01,083619,Staff,0,26,60,60
1650417930930,COGS 101A,A01,083621,Davis; Joshua Daniel,0,21,60,60
1650417936970,COGS 101B,A01,091572,Staff,0,4,60,60
1650417943003,COGS 101C,A01,083625,Delgado; Tania,16,0,30,14
1650417949045,COGS 107A,A01,083627,Boyle; Mary E. T.,0,11,60,60
1650417955068,COGS 118A,A01,083075,Staff,2,0,60,58
1650417961096,CSE 3,A50,083646,Miranda; Gregory Joseph,21,0,38,17
1650417961096,CSE 3,A51,083647,Miranda; Gregory Joseph,37,0,37,0
1650417967137,CSE 8A,A50,083650,Miranda; Gregory Joseph,0,27,40,40
1650417973161,CSE 11,A01,083080,Cao; Yingjun,0,91,40,40
1650417979185,CSE 12,A01,083652,Staff,0,16,100,100
1650417985210,CSE 15L,A01,083654,Staff,0,1,50,50
1650417985210,CSE 15L,A02,083655,Staff,2,0,50,48
1650417991237,CSE 20,A01,083657,Staff,51,0,80,29
1650417997263,CSE 30,A01,083084,Eldon; John,0,76,40,40
1650418003287,CSE 100,A01,083659,Cao; Yingjun,0,66,50,50
1650418009312,CSE 134B,A01,083661,Powell; Thomas Allan,1,33,65,64
1650418015351,CSE 140,A01,083663,Staff,0,1,75,75
1650418021387,CSE 140L,A01,083088,Eldon; John,0,7,75,75
1650418027411,CSE 175,A01,083665,Kumar; Rakesh,7,0,25,18
1650418033438,CSE 190,A00,092507,Dubnov; Shlomo,14,0,20,6
1650418039465,ECE 45,A01,083139,Staff,0,17,40,40
1650418045488,ECE 65,A50,083695,Staff,0,5,30,30
1650418051517,ECE 109,A01,091882,Touri; Behrouz,39,0,70,31
1650418057544,ECE 180,A00,083140,Abi Samra; Nicholas Camill,23,0,30,7
1650418057544,ECE 180,B00,083141,Abi Samra; Nicholas Camill,1,0,30,29
1650418063573,MATH 10A,A01,083735,Patchell; Gregory David,7,0,30,23
1650418063573,MATH 10A,A02,083736,Patchell; Gregory David,28,0,30,2
1650418063573,MATH 10A,A03,083737,Patchell; Gregory David,25,0,30,5
1650418069607,MATH 10B,A01,083207,Staff,0,8,30,30
1650418069607,MATH 10B,A02,083208,Staff,0,7,30,30
1650418069607,MATH 10B,B01,083739,Staff,15,0,30,15
1650418069607,MATH 10B,B02,083740,Staff,28,0,30,2
1650418075650,MATH 18,A01,083743,Staff,2,0,30,28
1650418075650,MATH 18,A02,083744,Staff,27,0,30,3
1650418075650,MATH 18,A03,083745,Staff,22,0,30,8
1650418075650,MATH 18,A04,083746,Staff,26,0,30,4
1650418075650,MATH 18,B01,083748,Staff,1,12,30,29
1650418075650,MATH 18,B02,083749,Staff,0,12,30,30
1650418075650,MATH 18,B03,083750,Staff,1,12,30,29
1650418075650,MATH 18,B04,083751,Staff,0,11,30,30
1650418081683,MATH 20A,A01,083754,Staff,25,0,40,15
1650418087710,MATH 20B,A01,083756,Staff,0,9,30,30
1650418087710,MATH 20B,A02,083757,Staff,0,9,30,30
1650418093734,MATH 20C,A01,083760,Staff,0,14,30,30
1650418093734,MATH 20C,A02,083761,Staff,1,15,30,29
1650418093734,MATH 20C,B01,083762,Staff,13,0,30,17
1650418093734,MATH 20C,B02,083763,Staff,28,0,30,2
1650418099761,MATH 20D,A01,083765,Staff,0,1,30,30
1650418099761,MATH 20D,A02,083766,Staff,7,0,30,23
1650418099761,MATH 20D,A03,083767,Staff,26,0,30,4
1650418105789,MATH 20E,A01,083771,Staff,5,0,30,25
1650418105789,MATH 20E,A02,083772,Staff,18,0,30,12
1650418105789,MATH 20E,B01,083773,Staff,0,0,30,30
1650418105789,MATH 20E,B02,083774,Staff,12,0,30,18
1650418111832,MATH 103A,A01,083777,Staff,0,11,30,30
1650418111832,MATH 103A,A02,083778,Staff,0,12,30,30
1650418111832,MATH 103A,B01,083779,Staff,0,13,30,30
1650418111832,MATH 103A,B02,083780,Staff,0,11,30,30
1650418117865,MATH 105,A01,085443,Staff,0,22,30,30
1650418123894,MATH 109,A01,083213,Anzaldo; Leesa B,0,7,30,30
1650418123894,MATH 109,A02,083214,Anzaldo; Leesa B,0,7,30,30
1650418123894,MATH 109,B01,083215,Anzaldo; Leesa B,0,5,30,30
1650418123894,MATH 109,B02,083216,Anzaldo; Leesa B,0,6,30,30
1650418129934,MATH 142A,A01,083219,Chow; Bennett,0,14,30,30
1650418129934,MATH 142A,A02,083220,Chow; Bennett,0,13,30,30
1650418129934,MATH 142A,B01,083221,Chow; Bennett,0,12,30,30
1650418129934,MATH 142A,B02,083222,Chow; Bennett,0,13,30,30
1650418135958,MATH 193A,A01,083224,Staff,0,5,30,30
1650418135958,MATH 193A,A02,083225,Staff,0,5,30,30
1650418135958,MATH 193A,A03,083781,Staff,0,4,30,30
1650418135958,MATH 193A,A04,083782,Staff,0,4,30,30
1650418141987,MATH 197,001,091859,McAuley; Julian John,9998,0,9999,1
1650418148041,COGS 9,A01,083615,Staff,0,14,60,60
1650418154136,COGS 11,A01,083617,Boyle; Mary E. T.,21,0,40,19
1650418160168,COGS 13,A01,083071,Staff,0,34,40,40
1650418166192,COGS 14A,A01,092681,Staff,0,25,100,100
1650418172218,COGS 14B,A01,083073,Cheng; Tzu-Han,0,11,50,50
1650418178242,COGS 17,A01,092677,Staff,23,0,75,52
1650418184268,COGS 100,A01,083619,Staff,0,26,60,60
1650418190294,COGS 101A,A01,083621,Davis; Joshua Daniel,0,21,60,60
1650418196316,COGS 101B,A01,091572,Staff,0,4,60,60
1650418202353,COGS 101C,A01,083625,Delgado; Tania,16,0,30,14
1650418208381,COGS 107A,A01,083627,Boyle; Mary E. T.,0,11,60,60
1650418214403,COGS 118A,A01,083075,Staff,2,0,60,58
1650418220439,CSE 3,A50,083646,Miranda; Gregory Joseph,21,0,38,17
1650418220439,CSE 3,A51,083647,Miranda; Gregory Joseph,37,0,37,0
1650418226468,CSE 8A,A50,083650,Miranda; Gregory Joseph,0,27,40,40
1650418232493,CSE 11,A01,083080,Cao; Yingjun,0,91,40,40
1650418238516,CSE 12,A01,083652,Staff,0,16,100,100
1650418244542,CSE 15L,A01,083654,Staff,0,1,50,50
1650418244542,CSE 15L,A02,083655,Staff,2,0,50,48
1650418250571,CSE 20,A01,083657,Staff,51,0,80,29
1650418256595,CSE 30,A01,083084,Eldon; John,0,76,40,40
1650418262622,CSE 100,A01,083659,Cao; Yingjun,0,66,50,50
1650418268655,CSE 134B,A01,083661,Powell; Thomas Allan,1,33,65,64
1650418274680,CSE 140,A01,083663,Staff,0,1,75,75
1650418280705,CSE 140L,A01,083088,Eldon; John,0,7,75,75
1650418286729,CSE 175,A01,083665,Kumar; Rakesh,7,0,25,18
1650418292758,CSE 190,A00,092507,Dubnov; Shlomo,14,0,20,6
1650418298780,ECE 45,A01,083139,Staff,0,17,40,40
1650418304804,ECE 65,A50,083695,Staff,0,5,30,30
1650418310826,ECE 109,A01,091882,Touri; Behrouz,39,0,70,31
1650418316852,ECE 180,A00,083140,Abi Samra; Nicholas Camill,23,0,30,7
1650418316852,ECE 180,B00,083141,Abi Samra; Nicholas Camill,1,0,30,29
1650418322876,MATH 10A,A01,083735,Patchell; Gregory David,7,0,30,23
1650418322876,MATH 10A,A02,083736,Patchell; Gregory David,28,0,30,2
1650418322876,MATH 10A,A03,083737,Patchell; Gregory David,25,0,30,5
1650418328911,MATH 10B,A01,083207,Staff,0,8,30,30
1650418328911,MATH 10B,A02,083208,Staff,0,7,30,30
1650418328911,MATH 10B,B01,083739,Staff,15,0,30,15
1650418328911,MATH 10B,B02,083740,Staff,28,0,30,2
1650418334941,MATH 18,A01,083743,Staff,2,0,30,28
1650418334941,MATH 18,A02,083744,Staff,27,0,30,3
1650418334941,MATH 18,A03,083745,Staff,22,0,30,8
1650418334941,MATH 18,A04,083746,Staff,26,0,30,4
1650418334941,MATH 18,B01,083748,Staff,1,12,30,29
1650418334941,MATH 18,B02,083749,Staff,0,12,30,30
1650418334941,MATH 18,B03,083750,Staff,1,12,30,29
1650418334941,MATH 18,B04,083751,Staff,0,11,30,30
1650418340979,MATH 20A,A01,083754,Staff,25,0,40,15
1650418347008,MATH 20B,A01,083756,Staff,0,9,30,30
1650418347008,MATH 20B,A02,083757,Staff,0,9,30,30
1650418353032,MATH 20C,A01,083760,Staff,0,14,30,30
1650418353032,MATH 20C,A02,083761,Staff,1,15,30,29
1650418353032,MATH 20C,B01,083762,Staff,13,0,30,17
1650418353032,MATH 20C,B02,083763,Staff,28,0,30,2
1650418359065,MATH 20D,A01,083765,Staff,0,1,30,30
1650418359065,MATH 20D,A02,083766,Staff,7,0,30,23
1650418359065,MATH 20D,A03,083767,Staff,26,0,30,4
1650418365091,MATH 20E,A01,083771,Staff,5,0,30,25
1650418365091,MATH 20E,A02,083772,Staff,18,0,30,12
1650418365091,MATH 20E,B01,083773,Staff,0,0,30,30
1650418365091,MATH 20E,B02,083774,Staff,12,0,30,18
1650418371131,MATH 103A,A01,083777,Staff,0,11,30,30
1650418371131,MATH 103A,A02,083778,Staff,0,12,30,30
1650418371131,MATH 103A,B01,083779,Staff,0,13,30,30
1650418371131,MATH 103A,B02,083780,Staff,0,11,30,30
1650418377156,MATH 105,A01,085443,Staff,0,22,30,30
1650418383184,MATH 109,A01,083213,Anzaldo; Leesa B,0,7,30,30
1650418383184,MATH 109,A02,083214,Anzaldo; Leesa B,0,7,30,30
1650418383184,MATH 109,B01,083215,Anzaldo; Leesa B,0,5,30,30
1650418383184,MATH 109,B02,083216,Anzaldo; Leesa B,0,6,30,30
1650418389212,MATH 142A,A01,083219,Chow; Bennett,0,14,30,30
1650418389212,MATH 142A,A02,083220,Chow; Bennett,0,13,30,30
1650418389212,MATH 142A,B01,083221,Chow; Bennett,0,12,30,30
1650418389212,MATH 142A,B02,083222,Chow; Bennett,0,13,30,30
1650418395248,MATH 193A,A01,083224,Staff,0,5,30,30
1650418395248,MATH 193A,A02,083225,Staff,0,5,30,30
1650418395248,MATH 193A,A03,083781,Staff,0,4,30,30
1650418395248,MATH 193A,A04,083782,Staff,0,4,30,30
1650418401273,MATH 197,001,091859,McAuley; Julian John,9998,0,9999,1
1650418407332,COGS 9,A01,083615,Staff,0,14,60,60
1650418413358,COGS 11,A01,083617,Boyle; Mary E. T.,21,0,40,19
1650418419381,COGS 13,A01,083071,Staff,0,34,40,40
1650418425407,COGS 14A,A01,092681,Staff,0,25,100,100
1650418431435,COGS 14B,A01,083073,Cheng; Tzu-Han,0,11,50,50
1650418437458,COGS 17,A01,092677,Staff,23,0,75,52
1650418443484,COGS 100,A01,083619,Staff,0,26,60,60
1650418449519,COGS 101A,A01,083621,Davis; Joshua Daniel,0,21,60,60
1650418455546,COGS 101B,A01,091572,Staff,0,4,60,60
1650418461575,COGS 101C,A01,083625,Delgado; Tania,16,0,30,14
1650418467600,COGS 107A,A01,083627,Boyle; Mary E. T.,0,11,60,60
1650418473624,COGS 118A,A01,083075,Staff,2,0,60,58
1650418479652,CSE 3,A50,083646,Miranda; Gregory Joseph,21,0,38,17
1650418479652,CSE 3,A51,083647,Miranda; Gregory Joseph,37,0,37,0
1650418485676,CSE 8A,A50,083650,Miranda; Gregory Joseph,0,27,40,40
1650418491702,CSE 11,A01,083080,Cao; Yingjun,0,91,40,40
1650418497724,CSE 12,A01,083652,Staff,0,16,100,100
1650418503748,CSE 15L,A01,083654,Staff,0,1,50,50
1650418503748,CSE 15L,A02,083655,Staff,2,0,50,48
1650418509774,CSE 20,A01,083657,Staff,51,0,80,29
1650418515795,CSE 30,A01,083084,Eldon; John,0,76,40,40
1650418521835,CSE 100,A01,083659,Cao; Yingjun,0,66,50,50
1650418527875,CSE 134B,A01,083661,Powell; Thomas Allan,1,33,65,64
1650418533906,CSE 140,A01,083663,Staff,0,1,75,75
1650418539932,CSE 140L,A01,083088,Eldon; John,0,7,75,75
1650418545956,CSE 175,A01,083665,Kumar; Rakesh,7,0,25,18
1650418551978,CSE 190,A00,092507,Dubnov; Shlomo,14,0,20,6
1650418558001,ECE 45,A01,083139,Staff,0,17,40,40
1650418564031,ECE 65,A50,083695,Staff,0,5,30,30
1650418570055,ECE 109,A01,091882,Touri; Behrouz,39,0,70,31
1650418576081,ECE 180,A00,083140,Abi Samra; Nicholas Camill,23,0,30,7
1650418576081,ECE 180,B00,083141,Abi Samra; Nicholas Camill,1,0,30,29
1650418582113,MATH 10A,A01,083735,Patchell; Gregory David,7,0,30,23
1650418582113,MATH 10A,A02,083736,Patchell; Gregory David,28,0,30,2
1650418582113,MATH 10A,A03,083737,Patchell; Gregory David,25,0,30,5
1650418588139,MATH 10B,A01,083207,Staff,0,8,30,30
1650418588139,MATH 10B,A02,083208,Staff,0,7,30,30
1650418588139,MATH 10B,B01,083739,Staff,15,0,30,15
1650418588139,MATH 10B,B02,083740,Staff,28,0,30,2
1650418594169,MATH 18,A01,083743,Staff,2,0,30,28
1650418594169,MATH 18,A02,083744,Staff,27,0,30,3
1650418594169,MATH 18,A03,083745,Staff,22,0,30,8
1650418594169,MATH 18,A04,083746,Staff,26,0,30,4
1650418594169,MATH 18,B01,083748,Staff,1,12,30,29
1650418594169,MATH 18,B02,083749,Staff,0,12,30,30
1650418594169,MATH 18,B03,083750,Staff,1,12,30,29
1650418594169,MATH 18,B04,083751,Staff,0,11,30,30
1650418600193,MATH 20A,A01,083754,Staff,25,0,40,15
1650418606218,MATH 20B,A01,083756,Staff,0,9,30,30
1650418606218,MATH 20B,A02,083757,Staff,0,9,30,30
1650418612242,MATH 20C,A01,083760,Staff,0,14,30,30
1650418612242,MATH 20C,A02,083761,Staff,1,15,30,29
1650418612242,MATH 20C,B01,083762,Staff,13,0,30,17
1650418612242,MATH 20C,B02,083763,Staff,28,0,30,2
1650418618266,MATH 20D,A01,083765,Staff,0,1,30,30
1650418618266,MATH 20D,A02,083766,Staff,7,0,30,23
1650418618266,MATH 20D,A03,083767,Staff,26,0,30,4
1650418624289,MATH 20E,A01,083771,Staff,5,0,30,25
1650418624289,MATH 20E,A02,083772,Staff,18,0,30,12
1650418624289,MATH 20E,B01,083773,Staff,0,0,30,30
1650418624289,MATH 20E,B02,083774,Staff,12,0,30,18
1650418630317,MATH 103A,A01,083777,Staff,0,11,30,30
1650418630317,MATH 103A,A02,083778,Staff,0,12,30,30
1650418630317,MATH 103A,B01,083779,Staff,0,13,30,30
1650418630317,MATH 103A,B02,083780,Staff,0,11,30,30
1650418636341,MATH 105,A01,085443,Staff,0,22,30,30
1650418642376,MATH 109,A01,083213,Anzaldo; Leesa B,0,7,30,30
1650418642376,MATH 109,A02,083214,Anzaldo; Leesa B,0,7,30,30
1650418642376,MATH 109,B01,083215,Anzaldo; Leesa B,0,5,30,30
1650418642376,MATH 109,B02,083216,Anzaldo; Leesa B,0,6,30,30
1650418648405,MATH 142A,A01,083219,Chow; Bennett,0,14,30,30
1650418648405,MATH 142A,A02,083220,Chow; Bennett,0,13,30,30
1650418648405,MATH 142A,B01,083221,Chow; Bennett,0,12,30,30
1650418648405,MATH 142A,B02,083222,Chow; Bennett,0,13,30,30
1650418654438,MATH 193A,A01,083224,Staff,0,5,30,30
1650418654438,MATH 193A,A02,083225,Staff,0,5,30,30
1650418654438,MATH 193A,A03,083781,Staff,0,4,30,30
1650418654438,MATH 193A,A04,083782,Staff,0,4,30,30
1650418660470,MATH 197,001,091859,McAuley; Julian John,9998,0,9999,1
1650418666534,COGS 9,A01,083615,Staff,0,14,60,60
1650418672558,COGS 11,A01,083617,Boyle; Mary E. T.,21,0,40,19
1650418678584,COGS 13,A01,083071,Staff,0,34,40,40
1650418684611,COGS 14A,A01,092681,Staff,0,25,100,100
1650418690646,COGS 14B,A01,083073,Cheng; Tzu-Han,0,11,50,50
1650418696675,COGS 17,A01,092677,Staff,23,0,75,52
1650418702699,COGS 100,A01,083619,Staff,0,26,60,60
1650418708730,COGS 101A,A01,083621,Davis; Joshua Daniel,0,21,60,60
1650418714763,COGS 101B,A01,091572,Staff,0,4,60,60
1650418720786,COGS 101C,A01,083625,Delgado; Tania,16,0,30,14
1650418726811,COGS 107A,A01,083627,Boyle; Mary E. T.,0,11,60,60
1650418732836,COGS 118A,A01,083075,Staff,2,0,60,58
1650418738867,CSE 3,A50,083646,Miranda; Gregory Joseph,21,0,38,17
1650418738867,CSE 3,A51,083647,Miranda; Gregory Joseph,37,0,37,0
1650418744902,CSE 8A,A50,083650,Miranda; Gregory Joseph,0,27,40,40
1650418751024,CSE 11,A01,083080,Cao; Yingjun,0,91,40,40
1650418757048,CSE 12,A01,083652,Staff,0,16,100,100
1650418763072,CSE 15L,A01,083654,Staff,0,1,50,50
1650418763072,CSE 15L,A02,083655,Staff,2,0,50,48
1650418769096,CSE 20,A01,083657,Staff,51,0,80,29
1650418775122,CSE 30,A01,083084,Eldon; John,0,76,40,40
1650418781146,CSE 100,A01,083659,Cao; Yingjun,0,66,50,50
1650418787172,CSE 134B,A01,083661,Powell; Thomas Allan,1,33,65,64
1650418793194,CSE 140,A01,083663,Staff,0,1,75,75
1650418799222,CSE 140L,A01,083088,Eldon; John,0,7,75,75
1650418805246,CSE 175,A01,083665,Kumar; Rakesh,7,0,25,18
1650418811269,CSE 190,A00,092507,Dubnov; Shlomo,14,0,20,6
1650418817296,ECE 45,A01,083139,Staff,0,17,40,40
1650418823319,ECE 65,A50,083695,Staff,0,5,30,30
1650418829345,ECE 109,A01,091882,Touri; Behrouz,39,0,70,31
1650418835371,ECE 180,A00,083140,Abi Samra; Nicholas Camill,23,0,30,7
1650418835371,ECE 180,B00,083141,Abi Samra; Nicholas Camill,1,0,30,29
1650418841397,MATH 10A,A01,083735,Patchell; Gregory David,7,0,30,23
1650418841397,MATH 10A,A02,083736,Patchell; Gregory David,28,0,30,2
1650418841397,MATH 10A,A03,083737,Patchell; Gregory David,25,0,30,5
1650418847424,MATH 10B,A01,083207,Staff,0,8,30,30
1650418847424,MATH 10B,A02,083208,Staff,0,7,30,30
1650418847424,MATH 10B,B01,083739,Staff,15,0,30,15
1650418847424,MATH 10B,B02,083740,Staff,28,0,30,2
1650418853449,MATH 18,A01,083743,Staff,2,0,30,28
1650418853449,MATH 18,A02,083744,Staff,27,0,30,3
1650418853449,MATH 18,A03,083745,Staff,22,0,30,8
1650418853449,MATH 18,A04,083746,Staff,26,0,30,4
1650418853449,MATH 18,B01,083748,Staff,1,12,30,29
1650418853449,MATH 18,B02,083749,Staff,0,12,30,30
1650418853449,MATH 18,B03,083750,Staff,1,12,30,29
1650418853449,MATH 18,B04,083751,Staff,0,11,30,30
1650418859475,MATH 20A,A01,083754,Staff,25,0,40,15
1650418865518,MATH 20B,A01,083756,Staff,0,9,30,30
1650418865518,MATH 20B,A02,083757,Staff,0,9,30,30
1650418871556,MATH 20C,A01,083760,Staff,0,14,30,30
1650418871556,MATH 20C,A02,083761,Staff,1,15,30,29
1650418871556,MATH 20C,B01,083762,Staff,13,0,30,17
1650418871556,MATH 20C,B02,083763,Staff,28,0,30,2
1650418877583,MATH 20D,A01,083765,Staff,0,1,30,30
1650418877583,MATH 20D,A02,083766,Staff,7,0,30,23
1650418877583,MATH 20D,A03,083767,Staff,26,0,30,4
1650418883605,MATH 20E,A01,083771,Staff,5,0,30,25
1650418883605,MATH 20E,A02,083772,Staff,18,0,30,12
1650418883605,MATH 20E,B01,083773,Staff,0,0,30,30
1650418883605,MATH 20E,B02,083774,Staff,12,0,30,18
1650418889634,MATH 103A,A01,083777,Staff,0,11,30,30
1650418889634,MATH 103A,A02,083778,Staff,0,12,30,30
1650418889634,MATH 103A,B01,083779,Staff,0,13,30,30
1650418889634,MATH 103A,B02,083780,Staff,0,11,30,30
1650418895661,MATH 105,A01,085443,Staff,0,22,30,30
1650418901694,MATH 109,A01,083213,Anzaldo; Leesa B,0,7,30,30
1650418901694,MATH 109,A02,083214,Anzaldo; Leesa B,0,7,30,30
1650418901694,MATH 109,B01,083215,Anzaldo; Leesa B,0,5,30,30
1650418901694,MATH 109,B02,083216,Anzaldo; Leesa B,0,6,30,30
1650418907721,MATH 142A,A01,083219,Chow; Bennett,0,14,30,30
1650418907721,MATH 142A,A02,083220,Chow; Bennett,0,13,30,30
1650418907721,MATH 142A,B01,083221,Chow; Bennett,0,12,30,30
1650418907721,MATH 142A,B02,083222,Chow; Bennett,0,13,30,30
1650418913744,MATH 193A,A01,083224,Staff,0,5,30,30
1650418913744,MATH 193A,A02,083225,Staff,0,5,30,30
1650418913744,MATH 193A,A03,083781,Staff,0,4,30,30
1650418913744,MATH 193A,A04,083782,Staff,0,4,30,30
1650418919770,MATH 197,001,091859,McAuley; Julian John,9998,0,9999,1
1650418925842,COGS 9,A01,083615,Staff,0,14,60,60
1650418931870,COGS 11,A01,083617,Boyle; Mary E. T.,21,0,40,19
1650418937895,COGS 13,A01,083071,Staff,0,34,40,40
1650418943919,COGS 14A,A01,092681,Staff,0,25,100,100
1650418949943,COGS 14B,A01,083073,Cheng; Tzu-Han,0,11,50,50
1650418955965,COGS 17,A01,092677,Staff,23,0,75,52
1650418961989,COGS 100,A01,083619,Staff,0,26,60,60
1650418968019,COGS 101A,A01,083621,Davis; Joshua Daniel,0,21,60,60
1650418974042,COGS 101B,A01,091572,Staff,0,4,60,60
1650418980080,COGS 101C,A01,083625,Delgado; Tania,16,0,30,14
1650418986107,COGS 107A,A01,083627,Boyle; Mary E. T.,0,11,60,60
1650418992132,COGS 118A,A01,083075,Staff,2,0,60,58
1650418998171,CSE 3,A50,083646,Miranda; Gregory Joseph,21,0,38,17
1650418998171,CSE 3,A51,083647,Miranda; Gregory Joseph,37,0,37,0
1650419004194,CSE 8A,A50,083650,Miranda; Gregory Joseph,0,27,40,40
1650419010223,CSE 11,A01,083080,Cao; Yingjun,0,91,40,40
1650419016253,CSE 12,A01,083652,Staff,0,16,100,100
1650419022275,CSE 15L,A01,083654,Staff,0,1,50,50
1650419022275,CSE 15L,A02,083655,Staff,2,0,50,48
1650419028299,CSE 20,A01,083657,Staff,51,0,80,29
1650419034325,CSE 30,A01,083084,Eldon; John,0,76,40,40
1650419040348,CSE 100,A01,083659,Cao; Yingjun,0,66,50,50
1650419046372,CSE 134B,A01,083661,Powell; Thomas Allan,1,33,65,64
1650419052394,CSE 140,A01,083663,Staff,0,1,75,75
1650419058422,CSE 140L,A01,083088,Eldon; John,0,7,75,75
1650419064452,CSE 175,A01,083665,Kumar; Rakesh,7,0,25,18
1650419070478,CSE 190,A00,092507,Dubnov; Shlomo,14,0,20,6
1650419076502,ECE 45,A01,083139,Staff,0,17,40,40
1650419082546,ECE 65,A50,083695,Staff,0,5,30,30
1650419088578,ECE 109,A01,091882,Touri; Behrouz,39,0,70,31
1650419094605,ECE 180,A00,083140,Abi Samra; Nicholas Camill,23,0,30,7
1650419094605,ECE 180,B00,083141,Abi Samra; Nicholas Camill,1,0,30,29
1650419100651,MATH 10A,A01,083735,Patchell; Gregory David,7,0,30,23
1650419100651,MATH 10A,A02,083736,Patchell; Gregory David,28,0,30,2
1650419100651,MATH 10A,A03,083737,Patchell; Gregory David,25,0,30,5
1650419106674,MATH 10B,A01,083207,Staff,0,8,30,30
1650419106674,MATH 10B,A02,083208,Staff,0,7,30,30
1650419106674,MATH 10B,B01,083739,Staff,15,0,30,15
1650419106674,MATH 10B,B02,083740,Staff,28,0,30,2
1650419112699,MATH 18,A01,083743,Staff,2,0,30,28
1650419112699,MATH 18,A02,083744,Staff,27,0,30,3
1650419112699,MATH 18,A03,083745,Staff,22,0,30,8
1650419112699,MATH 18,A04,083746,Staff,26,0,30,4
1650419112699,MATH 18,B01,083748,Staff,1,12,30,29
1650419112699,MATH 18,B02,083749,Staff,0,12,30,30
1650419112699,MATH 18,B03,083750,Staff,1,12,30,29
1650419112699,MATH 18,B04,083751,Staff,0,11,30,30
1650419118721,MATH 20A,A01,083754,Staff,26,0,40,14
1650419124745,MATH 20B,A01,083756,Staff,0,9,30,30
1650419124745,MATH 20B,A02,083757,Staff,0,9,30,30
1650419130779,MATH 20C,A01,083760,Staff,0,14,30,30
1650419130779,MATH 20C,A02,083761,Staff,1,15,30,29
1650419130779,MATH 20C,B01,083762,Staff,13,0,30,17
1650419130779,MATH 20C,B02,083763,Staff,28,0,30,2
1650419136807,MATH 20D,A01,083765,Staff,0,1,30,30
1650419136807,MATH 20D,A02,083766,Staff,7,0,30,23
1650419136807,MATH 20D,A03,083767,Staff,26,0,30,4
1650419142830,MATH 20E,A01,083771,Staff,5,0,30,25
1650419142830,MATH 20E,A02,083772,Staff,18,0,30,12
1650419142830,MATH 20E,B01,083773,Staff,0,0,30,30
1650419142830,MATH 20E,B02,083774,Staff,12,0,30,18
1650419148856,MATH 103A,A01,083777,Staff,0,11,30,30
1650419148856,MATH 103A,A02,083778,Staff,0,12,30,30
1650419148856,MATH 103A,B01,083779,Staff,0,13,30,30
1650419148856,MATH 103A,B02,083780,Staff,0,11,30,30
1650419154880,MATH 105,A01,085443,Staff,0,22,30,30
1650419160916,MATH 109,A01,083213,Anzaldo; Leesa B,0,7,30,30
1650419160916,MATH 109,A02,083214,Anzaldo; Leesa B,0,7,30,30
1650419160916,MATH 109,B01,083215,Anzaldo; Leesa B,0,5,30,30
1650419160916,MATH 109,B02,083216,Anzaldo; Leesa B,0,6,30,30
1650419166945,MATH 142A,A01,083219,Chow; Bennett,0,14,30,30
1650419166945,MATH 142A,A02,083220,Chow; Bennett,0,13,30,30
1650419166945,MATH 142A,B01,083221,Chow; Bennett,0,12,30,30
1650419166945,MATH 142A,B02,083222,Chow; Bennett,0,13,30,30
1650419172968,MATH 193A,A01,083224,Staff,0,5,30,30
1650419172968,MATH 193A,A02,083225,Staff,0,5,30,30
1650419172968,MATH 193A,A03,083781,Staff,0,4,30,30
1650419172968,MATH 193A,A04,083782,Staff,0,4,30,30
1650419178991,MATH 197,001,091859,McAuley; Julian John,9998,0,9999,1
1650419185044,COGS 9,A01,083615,Staff,0,14,60,60
1650419191069,COGS 11,A01,083617,Boyle; Mary E. T.,21,0,40,19
1650419197127,COGS 13,A01,083071,Staff,0,34,40,40
1650419203150,COGS 14A,A01,092681,Staff,0,25,100,100
1650419209176,COGS 14B,A01,083073,Cheng; Tzu-Han,0,11,50,50
1650419215200,COGS 17,A01,092677,Staff,23,0,75,52
1650419221227,COGS 100,A01,083619,Staff,0,26,60,60
1650419227254,COGS 101A,A01,083621,Davis; Joshua Daniel,0,21,60,60
1650419233278,COGS 101B,A01,091572,Staff,0,4,60,60
1650419239303,COGS 101C,A01,083625,Delgado; Tania,16,0,30,14
1650419245332,COGS 107A,A01,083627,Boyle; Mary E. T.,0,11,60,60
1650419251354,COGS 118A,A01,083075,Staff,2,0,60,58
1650419257384,CSE 3,A50,083646,Miranda; Gregory Joseph,21,0,38,17
1650419257384,CSE 3,A51,083647,Miranda; Gregory Joseph,37,0,37,0
1650419263410,CSE 8A,A50,083650,Miranda; Gregory Joseph,0,27,40,40
1650419269439,CSE 11,A01,083080,Cao; Yingjun,0,91,40,40
1650419275474,CSE 12,A01,083652,Staff,0,16,100,100
1650419281497,CSE 15L,A01,083654,Staff,0,1,50,50
1650419281497,CSE 15L,A02,083655,Staff,2,0,50,48
1650419287518,CSE 20,A01,083657,Staff,51,0,80,29
1650419293542,CSE 30,A01,083084,Eldon; John,0,76,40,40
1650419299568,CSE 100,A01,083659,Cao; Yingjun,0,66,50,50
1650419305594,CSE 134B,A01,083661,Powell; Thomas Allan,1,33,65,64
1650419311617,CSE 140,A01,083663,Staff,0,1,75,75
1650419317640,CSE 140L,A01,083088,Eldon; John,0,7,75,75
1650419323671,CSE 175,A01,083665,Kumar; Rakesh,7,0,25,18
1650419329695,CSE 190,A00,092507,Dubnov; Shlomo,14,0,20,6
1650419335718,ECE 45,A01,083139,Staff,0,17,40,40
1650419341740,ECE 65,A50,083695,Staff,0,5,30,30
1650419347861,ECE 109,A01,091882,Touri; Behrouz,39,0,70,31
1650419353884,ECE 180,A00,083140,Abi Samra; Nicholas Camill,23,0,30,7
1650419353884,ECE 180,B00,083141,Abi Samra; Nicholas Camill,0,0,30,30
1650419359911,MATH 10A,A01,083735,Patchell; Gregory David,7,0,30,23
1650419359911,MATH 10A,A02,083736,Patchell; Gregory David,28,0,30,2
1650419359911,MATH 10A,A03,083737,Patchell; Gregory David,25,0,30,5
1650419365936,MATH 10B,A01,083207,Staff,0,8,30,30
1650419365936,MATH 10B,A02,083208,Staff,0,7,30,30
1650419365936,MATH 10B,B01,083739,Staff,14,0,30,16
1650419365936,MATH 10B,B02,083740,Staff,28,0,30,2
1650419371967,MATH 18,A01,083743,Staff,2,0,30,28
1650419371967,MATH 18,A02,083744,Staff,27,0,30,3
1650419371967,MATH 18,A03,083745,Staff,22,0,30,8
1650419371967,MATH 18,A04,083746,Staff,26,0,30,4
1650419371967,MATH 18,B01,083748,Staff,1,12,30,29
1650419371967,MATH 18,B02,083749,Staff,0,12,30,30
1650419371967,MATH 18,B03,083750,Staff,1,12,30,29
1650419371967,MATH 18,B04,083751,Staff,0,11,30,30
1650419377993,MATH 20A,A01,083754,Staff,26,0,40,14
1650419384015,MATH 20B,A01,083756,Staff,0,9,30,30
1650419384015,MATH 20B,A02,083757,Staff,0,9,30,30
1650419390043,MATH 20C,A01,083760,Staff,0,14,30,30
1650419390043,MATH 20C,A02,083761,Staff,1,15,30,29
1650419390043,MATH 20C,B01,083762,Staff,13,0,30,17
1650419390043,MATH 20C,B02,083763,Staff,28,0,30,2
1650419396067,MATH 20D,A01,083765,Staff,0,1,30,30
1650419396067,MATH 20D,A02,083766,Staff,7,0,30,23
1650419396067,MATH 20D,A03,083767,Staff,26,0,30,4
1650419402094,MATH 20E,A01,083771,Staff,5,0,30,25
1650419402094,MATH 20E,A02,083772,Staff,18,0,30,12
1650419402094,MATH 20E,B01,083773,Staff,0,0,30,30
1650419402094,MATH 20E,B02,083774,Staff,12,0,30,18
1650419408119,MATH 103A,A01,083777,Staff,0,11,30,30
1650419408119,MATH 103A,A02,083778,Staff,0,12,30,30
1650419408119,MATH 103A,B01,083779,Staff,0,13,30,30
1650419408119,MATH 103A,B02,083780,Staff,0,11,30,30
1650419414152,MATH 105,A01,085443,Staff,0,22,30,30
1650419420181,MATH 109,A01,083213,Anzaldo; Leesa B,0,7,30,30
1650419420181,MATH 109,A02,083214,Anzaldo; Leesa B,0,7,30,30
1650419420181,MATH 109,B01,083215,Anzaldo; Leesa B,0,5,30,30
1650419420181,MATH 109,B02,083216,Anzaldo; Leesa B,0,6,30,30
1650419426205,MATH 142A,A01,083219,Chow; Bennett,0,14,30,30
1650419426205,MATH 142A,A02,083220,Chow; Bennett,0,13,30,30
1650419426205,MATH 142A,B01,083221,Chow; Bennett,0,12,30,30
1650419426205,MATH 142A,B02,083222,Chow; Bennett,0,13,30,30
1650419432233,MATH 193A,A01,083224,Staff,0,5,30,30
1650419432233,MATH 193A,A02,083225,Staff,0,5,30,30
1650419432233,MATH 193A,A03,083781,Staff,0,4,30,30
1650419432233,MATH 193A,A04,083782,Staff,0,4,30,30
1650419438260,MATH 197,001,091859,McAuley; Julian John,9998,0,9999,1
1650419444322,COGS 9,A01,083615,Staff,0,14,60,60
1650419450349,COGS 11,A01,083617,Boyle; Mary E. T.,21,0,40,19
1650419456376,COGS 13,A01,083071,Staff,0,34,40,40
1650419462398,COGS 14A,A01,092681,Staff,0,25,100,100
1650419468422,COGS 14B,A01,083073,Cheng; Tzu-Han,0,11,50,50
1650419474448,COGS 17,A01,092677,Staff,23,0,75,52
1650419480472,COGS 100,A01,083619,Staff,0,26,60,60
1650419486499,COGS 101A,A01,083621,Davis; Joshua Daniel,0,21,60,60
1650419492522,COGS 101B,A01,091572,Staff,0,4,60,60
1650419498549,COGS 101C,A01,083625,Delgado; Tania,16,0,30,14
1650419504573,COGS 107A,A01,083627,Boyle; Mary E. T.,0,11,60,60
1650419510597,COGS 118A,A01,083075,Staff,2,0,60,58
1650419516621,CSE 3,A50,083646,Miranda; Gregory Joseph,21,0,38,17
1650419516621,CSE 3,A51,083647,Miranda; Gregory Joseph,37,0,37,0
1650419522651,CSE 8A,A50,083650,Miranda; Gregory Joseph,0,27,40,40
1650419528680,CSE 11,A01,083080,Cao; Yingjun,0,91,40,40
1650419534706,CSE 12,A01,083652,Staff,0,16,100,100
1650419540736,CSE 15L,A01,083654,Staff,0,1,50,50
1650419540736,CSE 15L,A02,083655,Staff,2,0,50,48
1650419546763,CSE 20,A01,083657,Staff,51,0,80,29
1650419552790,CSE 30,A01,083084,Eldon; John,0,76,40,40
1650419558814,CSE 100,A01,083659,Cao; Yingjun,0,66,50,50
1650419564841,CSE 134B,A01,083661,Powell; Thomas Allan,1,33,65,64
1650419570863,CSE 140,A01,083663,Staff,0,1,75,75
1650419576890,CSE 140L,A01,083088,Eldon; John,0,7,75,75
1650419582914,CSE 175,A01,083665,Kumar; Rakesh,7,0,25,18
1650419588937,CSE 190,A00,092507,Dubnov; Shlomo,14,0,20,6
1650419594961,ECE 45,A01,083139,Staff,0,17,40,40
1650419600988,ECE 65,A50,083695,Staff,0,5,30,30
1650419607016,ECE 109,A01,091882,Touri; Behrouz,39,0,70,31
1650419613041,ECE 180,A00,083140,Abi Samra; Nicholas Camill,23,0,30,7
1650419613041,ECE 180,B00,083141,Abi Samra; Nicholas Camill,0,0,30,30
1650419619066,MATH 10A,A01,083735,Patchell; Gregory David,7,0,30,23
1650419619066,MATH 10A,A02,083736,Patchell; Gregory David,28,0,30,2
1650419619066,MATH 10A,A03,083737,Patchell; Gregory David,25,0,30,5
1650419625094,MATH 10B,A01,083207,Staff,0,8,30,30
1650419625094,MATH 10B,A02,083208,Staff,0,7,30,30
1650419625094,MATH 10B,B01,083739,Staff,14,0,30,16
1650419625094,MATH 10B,B02,083740,Staff,28,0,30,2
1650419631121,MATH 18,A01,083743,Staff,2,0,30,28
1650419631121,MATH 18,A02,083744,Staff,27,0,30,3
1650419631121,MATH 18,A03,083745,Staff,22,0,30,8
1650419631121,MATH 18,A04,083746,Staff,26,0,30,4
1650419631121,MATH 18,B01,083748,Staff,1,12,30,29
1650419631121,MATH 18,B02,083749,Staff,0,12,30,30
1650419631121,MATH 18,B03,083750,Staff,1,12,30,29
1650419631121,MATH 18,B04,083751,Staff,0,12,30,30
1650419637148,MATH 20A,A01,083754,Staff,26,0,40,14
1650419643171,MATH 20B,A01,083756,Staff,0,9,30,30
1650419643171,MATH 20B,A02,083757,Staff,0,9,30,30
1650419649196,MATH 20C,A01,083760,Staff,0,14,30,30
1650419649196,MATH 20C,A02,083761,Staff,1,15,30,29
1650419649196,MATH 20C,B01,083762,Staff,13,0,30,17
1650419649196,MATH 20C,B02,083763,Staff,28,0,30,2
1650419655229,MATH 20D,A01,083765,Staff,0,1,30,30
1650419655229,MATH 20D,A02,083766,Staff,7,0,30,23
1650419655229,MATH 20D,A03,083767,Staff,26,0,30,4
1650419661254,MATH 20E,A01,083771,Staff,5,0,30,25
1650419661254,MATH 20E,A02,083772,Staff,18,0,30,12
1650419661254,MATH 20E,B01,083773,Staff,0,0,30,30
1650419661254,MATH 20E,B02,083774,Staff,12,0,30,18
1650419667281,MATH 103A,A01,083777,Staff,0,11,30,30
1650419667281,MATH 103A,A02,083778,Staff,0,12,30,30
1650419667281,MATH 103A,B01,083779,Staff,0,13,30,30
1650419667281,MATH 103A,B02,083780,Staff,0,11,30,30
1650419673305,MATH 105,A01,085443,Staff,0,22,30,30
1650419679334,MATH 109,A01,083213,Anzaldo; Leesa B,0,7,30,30
1650419679334,MATH 109,A02,083214,Anzaldo; Leesa B,0,7,30,30
1650419679334,MATH 109,B01,083215,Anzaldo; Leesa B,0,5,30,30
1650419679334,MATH 109,B02,083216,Anzaldo; Leesa B,0,6,30,30
1650419685359,MATH 142A,A01,083219,Chow; Bennett,0,14,30,30
1650419685359,MATH 142A,A02,083220,Chow; Bennett,0,13,30,30
1650419685359,MATH 142A,B01,083221,Chow; Bennett,0,12,30,30
1650419685359,MATH 142A,B02,083222,Chow; Bennett,0,13,30,30
1650419691385,MATH 193A,A01,083224,Staff,0,5,30,30
1650419691385,MATH 193A,A02,083225,Staff,0,5,30,30
1650419691385,MATH 193A,A03,083781,Staff,0,4,30,30
1650419691385,MATH 193A,A04,083782,Staff,0,4,30,30
1650419697409,MATH 197,001,091859,McAuley; Julian John,9998,0,9999,1
1650419703470,COGS 9,A01,083615,Staff,0,14,60,60
1650419709503,COGS 11,A01,083617,Boyle; Mary E. T.,21,0,40,19
1650419715528,COGS 13,A01,083071,Staff,0,34,40,40
1650419721558,COGS 14A,A01,092681,Staff,0,25,100,100
1650419727584,COGS 14B,A01,083073,Cheng; Tzu-Han,0,11,50,50
1650419733607,COGS 17,A01,092677,Staff,23,0,75,52
1650419739629,COGS 100,A01,083619,Staff,0,26,60,60
1650419745656,COGS 101A,A01,083621,Davis; Joshua Daniel,0,21,60,60
1650419751694,COGS 101B,A01,091572,Staff,0,4,60,60
1650419757717,COGS 101C,A01,083625,Delgado; Tania,16,0,30,14
1650419763743,COGS 107A,A01,083627,Boyle; Mary E. T.,0,11,60,60
1650419769765,COGS 118A,A01,083075,Staff,2,0,60,58
1650419775789,CSE 3,A50,083646,Miranda; Gregory Joseph,21,0,38,17
1650419775789,CSE 3,A51,083647,Miranda; Gregory Joseph,37,0,37,0
1650419781814,CSE 8A,A50,083650,Miranda; Gregory Joseph,0,27,40,40
1650419787839,CSE 11,A01,083080,Cao; Yingjun,0,91,40,40
1650419793874,CSE 12,A01,083652,Staff,0,16,100,100
1650419799897,CSE 15L,A01,083654,Staff,0,1,50,50
1650419799897,CSE 15L,A02,083655,Staff,2,0,50,48
1650419805921,CSE 20,A01,083657,Staff,51,0,80,29
1650419811944,CSE 30,A01,083084,Eldon; John,0,76,40,40
1650419817981,CSE 100,A01,083659,Cao; Yingjun,0,66,50,50
1650419824005,CSE 134B,A01,083661,Powell; Thomas Allan,1,33,65,64
1650419830043,CSE 140,A01,083663,Staff,0,1,75,75
1650419836072,CSE 140L,A01,083088,Eldon; John,0,7,75,75
1650419842095,CSE 175,A01,083665,Kumar; Rakesh,7,0,25,18
1650419848118,CSE 190,A00,092507,Dubnov; Shlomo,14,0,20,6
1650419854142,ECE 45,A01,083139,Staff,0,17,40,40
1650419860168,ECE 65,A50,083695,Staff,0,5,30,30
1650419866191,ECE 109,A01,091882,Touri; Behrouz,39,0,70,31
1650419872215,ECE 180,A00,083140,Abi Samra; Nicholas Camill,23,0,30,7
1650419872215,ECE 180,B00,083141,Abi Samra; Nicholas Camill,0,0,30,30
1650419878238,MATH 10A,A01,083735,Patchell; Gregory David,7,0,30,23
1650419878238,MATH 10A,A02,083736,Patchell; Gregory David,28,0,30,2
1650419878238,MATH 10A,A03,083737,Patchell; Gregory David,25,0,30,5
1650419884260,MATH 10B,A01,083207,Staff,0,8,30,30
1650419884260,MATH 10B,A02,083208,Staff,0,7,30,30
1650419884260,MATH 10B,B01,083739,Staff,14,0,30,16
1650419884260,MATH 10B,B02,083740,Staff,28,0,30,2
1650419890289,MATH 18,A01,083743,Staff,2,0,30,28
1650419890289,MATH 18,A02,083744,Staff,27,0,30,3
1650419890289,MATH 18,A03,083745,Staff,22,0,30,8
1650419890289,MATH 18,A04,083746,Staff,26,0,30,4
1650419890289,MATH 18,B01,083748,Staff,1,12,30,29
1650419890289,MATH 18,B02,083749,Staff,0,12,30,30
1650419890289,MATH 18,B03,083750,Staff,1,12,30,29
1650419890289,MATH 18,B04,083751,Staff,0,12,30,30
1650419896313,MATH 20A,A01,083754,Staff,26,0,40,14
1650419902337,MATH 20B,A01,083756,Staff,0,9,30,30
1650419902337,MATH 20B,A02,083757,Staff,0,9,30,30
1650419908366,MATH 20C,A01,083760,Staff,0,14,30,30
1650419908366,MATH 20C,A02,083761,Staff,1,15,30,29
1650419908366,MATH 20C,B01,083762,Staff,13,0,30,17
1650419908366,MATH 20C,B02,083763,Staff,28,0,30,2
1650419914392,MATH 20D,A01,083765,Staff,0,1,30,30
1650419914392,MATH 20D,A02,083766,Staff,7,0,30,23
1650419914392,MATH 20D,A03,083767,Staff,26,0,30,4
1650419920420,MATH 20E,A01,083771,Staff,5,0,30,25
1650419920420,MATH 20E,A02,083772,Staff,18,0,30,12
1650419920420,MATH 20E,B01,083773,Staff,0,0,30,30
1650419920420,MATH 20E,B02,083774,Staff,12,0,30,18
1650419926448,MATH 103A,A01,083777,Staff,0,11,30,30
1650419926448,MATH 103A,A02,083778,Staff,0,12,30,30
1650419926448,MATH 103A,B01,083779,Staff,0,13,30,30
1650419926448,MATH 103A,B02,083780,Staff,0,11,30,30
1650419932476,MATH 105,A01,085443,Staff,0,22,30,30
1650419938503,MATH 109,A01,083213,Anzaldo; Leesa B,0,7,30,30
1650419938503,MATH 109,A02,083214,Anzaldo; Leesa B,0,7,30,30
1650419938503,MATH 109,B01,083215,Anzaldo; Leesa B,0,5,30,30
1650419938503,MATH 109,B02,083216,Anzaldo; Leesa B,0,6,30,30
1650419944623,MATH 142A,A01,083219,Chow; Bennett,0,14,30,30
1650419944623,MATH 142A,A02,083220,Chow; Bennett,0,13,30,30
1650419944623,MATH 142A,B01,083221,Chow; Bennett,0,12,30,30
1650419944623,MATH 142A,B02,083222,Chow; Bennett,0,13,30,30
1650419950645,MATH 193A,A01,083224,Staff,0,5,30,30
1650419950645,MATH 193A,A02,083225,Staff,0,5,30,30
1650419950645,MATH 193A,A03,083781,Staff,0,4,30,30
1650419950645,MATH 193A,A04,083782,Staff,0,4,30,30
1650419956678,MATH 197,001,091859,McAuley; Julian John,9998,0,9999,1
1650419962737,COGS 9,A01,083615,Staff,0,14,60,60
1650419968763,COGS 11,A01,083617,Boyle; Mary E. T.,21,0,40,19
1650419974790,COGS 13,A01,083071,Staff,0,34,40,40
1650419980812,COGS 14A,A01,092681,Staff,0,25,100,100
1650419986839,COGS 14B,A01,083073,Cheng; Tzu-Han,0,11,50,50
1650419992866,COGS 17,A01,092677,Staff,23,0,75,52
1650419998897,COGS 100,A01,083619,Staff,0,26,60,60
1650420004925,COGS 101A,A01,083621,Davis; Joshua Daniel,0,21,60,60
1650420010949,COGS 101B,A01,091572,Staff,0,4,60,60
1650420016975,COGS 101C,A01,083625,Delgado; Tania,16,0,30,14
1650420023001,COGS 107A,A01,083627,Boyle; Mary E. T.,0,11,60,60
1650420029030,COGS 118A,A01,083075,Staff,2,0,60,58
1650420035058,CSE 3,A50,083646,Miranda; Gregory Joseph,21,0,38,17
1650420035058,CSE 3,A51,083647,Miranda; Gregory Joseph,37,0,37,0
1650420041082,CSE 8A,A50,083650,Miranda; Gregory Joseph,0,27,40,40
1650420047115,CSE 11,A01,083080,Cao; Yingjun,0,91,40,40
1650420053139,CSE 12,A01,083652,Staff,0,16,100,100
1650420059180,CSE 15L,A01,083654,Staff,0,1,50,50
1650420059180,CSE 15L,A02,083655,Staff,2,0,50,48
1650420065207,CSE 20,A01,083657,Staff,51,0,80,29
1650420071235,CSE 30,A01,083084,Eldon; John,0,76,40,40
1650420077261,CSE 100,A01,083659,Cao; Yingjun,0,66,50,50
1650420083287,CSE 134B,A01,083661,Powell; Thomas Allan,1,33,65,64
1650420089310,CSE 140,A01,083663,Staff,0,1,75,75
1650420095335,CSE 140L,A01,083088,Eldon; John,0,7,75,75
1650420101357,CSE 175,A01,083665,Kumar; Rakesh,7,0,25,18
1650420107380,CSE 190,A00,092507,Dubnov; Shlomo,14,0,20,6
1650420113403,ECE 45,A01,083139,Staff,0,17,40,40
1650420119427,ECE 65,A50,083695,Staff,0,5,30,30
1650420125451,ECE 109,A01,091882,Touri; Behrouz,39,0,70,31
1650420131489,ECE 180,A00,083140,Abi Samra; Nicholas Camill,23,0,30,7
1650420131489,ECE 180,B00,083141,Abi Samra; Nicholas Camill,0,0,30,30
1650420137519,MATH 10A,A01,083735,Patchell; Gregory David,7,0,30,23
1650420137519,MATH 10A,A02,083736,Patchell; Gregory David,28,0,30,2
1650420137519,MATH 10A,A03,083737,Patchell; Gregory David,25,0,30,5
1650420143556,MATH 10B,A01,083207,Staff,0,8,30,30
1650420143556,MATH 10B,A02,083208,Staff,0,7,30,30
1650420143556,MATH 10B,B01,083739,Staff,14,0,30,16
1650420143556,MATH 10B,B02,083740,Staff,28,0,30,2
1650420149591,MATH 18,A01,083743,Staff,2,0,30,28
1650420149591,MATH 18,A02,083744,Staff,27,0,30,3
1650420149591,MATH 18,A03,083745,Staff,22,0,30,8
1650420149591,MATH 18,A04,083746,Staff,26,0,30,4
1650420149591,MATH 18,B01,083748,Staff,1,12,30,29
1650420149591,MATH 18,B02,083749,Staff,0,12,30,30
1650420149591,MATH 18,B03,083750,Staff,1,12,30,29
1650420149591,MATH 18,B04,083751,Staff,0,12,30,30
1650420155615,MATH 20A,A01,083754,Staff,26,0,40,14
1650420161655,MATH 20B,A01,083756,Staff,0,9,30,30
1650420161655,MATH 20B,A02,083757,Staff,0,9,30,30
1650420167679,MATH 20C,A01,083760,Staff,0,14,30,30
1650420167679,MATH 20C,A02,083761,Staff,1,15,30,29
1650420167679,MATH 20C,B01,083762,Staff,13,0,30,17
1650420167679,MATH 20C,B02,083763,Staff,28,0,30,2
1650420173707,MATH 20D,A01,083765,Staff,0,1,30,30
1650420173707,MATH 20D,A02,083766,Staff,7,0,30,23
1650420173707,MATH 20D,A03,083767,Staff,26,0,30,4
1650420179733,MATH 20E,A01,083771,Staff,5,0,30,25
1650420179733,MATH 20E,A02,083772,Staff,18,0,30,12
1650420179733,MATH 20E,B01,083773,Staff,0,0,30,30
1650420179733,MATH 20E,B02,083774,Staff,12,0,30,18
1650420185756,MATH 103A,A01,083777,Staff,0,11,30,30
1650420185756,MATH 103A,A02,083778,Staff,0,12,30,30
1650420185756,MATH 103A,B01,083779,Staff,0,13,30,30
1650420185756,MATH 103A,B02,083780,Staff,0,11,30,30
1650420191783,MATH 105,A01,085443,Staff,0,22,30,30
1650420197807,MATH 109,A01,083213,Anzaldo; Leesa B,0,7,30,30
1650420197807,MATH 109,A02,083214,Anzaldo; Leesa B,0,7,30,30
1650420197807,MATH 109,B01,083215,Anzaldo; Leesa B,0,5,30,30
1650420197807,MATH 109,B02,083216,Anzaldo; Leesa B,0,6,30,30
1650420203847,MATH 142A,A01,083219,Chow; Bennett,0,14,30,30
1650420203847,MATH 142A,A02,083220,Chow; Bennett,0,13,30,30
1650420203847,MATH 142A,B01,083221,Chow; Bennett,0,12,30,30
1650420203847,MATH 142A,B02,083222,Chow; Bennett,0,13,30,30
1650420209873,MATH 193A,A01,083224,Staff,0,5,30,30
1650420209873,MATH 193A,A02,083225,Staff,0,5,30,30
1650420209873,MATH 193A,A03,083781,Staff,0,4,30,30
1650420209873,MATH 193A,A04,083782,Staff,0,4,30,30
1650420215904,MATH 197,001,091859,McAuley; Julian John,9998,0,9999,1
1650420221968,COGS 9,A01,083615,Staff,0,14,60,60
1650420228003,COGS 11,A01,083617,Boyle; Mary E. T.,21,0,40,19
1650420234029,COGS 13,A01,083071,Staff,0,34,40,40
1650420240053,COGS 14A,A01,092681,Staff,0,25,100,100
1650420246079,COGS 14B,A01,083073,Cheng; Tzu-Han,0,11,50,50
1650420252105,COGS 17,A01,092677,Staff,23,0,75,52
1650420258132,COGS 100,A01,083619,Staff,0,26,60,60
1650420264168,COGS 101A,A01,083621,Davis; Joshua Daniel,0,21,60,60
1650420270191,COGS 101B,A01,091572,Staff,0,4,60,60
1650420276216,COGS 101C,A01,083625,Delgado; Tania,16,0,30,14
1650420282237,COGS 107A,A01,083627,Boyle; Mary E. T.,0,11,60,60
1650420288275,COGS 118A,A01,083075,Staff,2,0,60,58
1650420294303,CSE 3,A50,083646,Miranda; Gregory Joseph,21,0,38,17
1650420294303,CSE 3,A51,083647,Miranda; Gregory Joseph,37,0,37,0
1650420300328,CSE 8A,A50,083650,Miranda; Gregory Joseph,0,28,40,40
1650420306352,CSE 11,A01,083080,Cao; Yingjun,0,91,40,40
1650420312375,CSE 12,A01,083652,Staff,0,16,100,100
1650420318399,CSE 15L,A01,083654,Staff,0,1,50,50
1650420318399,CSE 15L,A02,083655,Staff,2,0,50,48
1650420324425,CSE 20,A01,083657,Staff,51,0,80,29
1650420330459,CSE 30,A01,083084,Eldon; John,0,76,40,40
1650420336485,CSE 100,A01,083659,Cao; Yingjun,0,66,50,50
1650420342507,CSE 134B,A01,083661,Powell; Thomas Allan,1,33,65,64
1650420348543,CSE 140,A01,083663,Staff,0,1,75,75
1650420354569,CSE 140L,A01,083088,Eldon; John,0,7,75,75
1650420360599,CSE 175,A01,083665,Kumar; Rakesh,7,0,25,18
1650420366629,CSE 190,A00,092507,Dubnov; Shlomo,14,0,20,6
1650420372654,ECE 45,A01,083139,Staff,0,17,40,40
1650420378691,ECE 65,A50,083695,Staff,0,5,30,30
1650420384718,ECE 109,A01,091882,Touri; Behrouz,39,0,70,31
1650420390747,ECE 180,A00,083140,Abi Samra; Nicholas Camill,23,0,30,7
1650420390747,ECE 180,B00,083141,Abi Samra; Nicholas Camill,0,0,30,30
1650420396775,MATH 10A,A01,083735,Patchell; Gregory David,7,0,30,23
1650420396775,MATH 10A,A02,083736,Patchell; Gregory David,28,0,30,2
1650420396775,MATH 10A,A03,083737,Patchell; Gregory David,25,0,30,5
1650420402808,MATH 10B,A01,083207,Staff,0,8,30,30
1650420402808,MATH 10B,A02,083208,Staff,0,7,30,30
1650420402808,MATH 10B,B01,083739,Staff,14,0,30,16
1650420402808,MATH 10B,B02,083740,Staff,28,0,30,2
1650420408839,MATH 18,A01,083743,Staff,2,0,30,28
1650420408839,MATH 18,A02,083744,Staff,27,0,30,3
1650420408839,MATH 18,A03,083745,Staff,22,0,30,8
1650420408839,MATH 18,A04,083746,Staff,26,0,30,4
1650420408839,MATH 18,B01,083748,Staff,1,12,30,29
1650420408839,MATH 18,B02,083749,Staff,0,12,30,30
1650420408839,MATH 18,B03,083750,Staff,1,12,30,29
1650420408839,MATH 18,B04,083751,Staff,0,12,30,30
1650420414865,MATH 20A,A01,083754,Staff,26,0,40,14
1650420420891,MATH 20B,A01,083756,Staff,0,9,30,30
1650420420891,MATH 20B,A02,083757,Staff,0,9,30,30
1650420426919,MATH 20C,A01,083760,Staff,0,14,30,30
1650420426919,MATH 20C,A02,083761,Staff,1,15,30,29
1650420426919,MATH 20C,B01,083762,Staff,13,0,30,17
1650420426919,MATH 20C,B02,083763,Staff,28,0,30,2
1650420432942,MATH 20D,A01,083765,Staff,0,1,30,30
1650420432942,MATH 20D,A02,083766,Staff,7,0,30,23
1650420432942,MATH 20D,A03,083767,Staff,26,0,30,4
1650420438969,MATH 20E,A01,083771,Staff,5,0,30,25
1650420438969,MATH 20E,A02,083772,Staff,18,0,30,12
1650420438969,MATH 20E,B01,083773,Staff,0,0,30,30
1650420438969,MATH 20E,B02,083774,Staff,12,0,30,18
1650420444997,MATH 103A,A01,083777,Staff,0,11,30,30
1650420444997,MATH 103A,A02,083778,Staff,0,12,30,30
1650420444997,MATH 103A,B01,083779,Staff,0,13,30,30
1650420444997,MATH 103A,B02,083780,Staff,0,11,30,30
1650420451020,MATH 105,A01,085443,Staff,0,22,30,30
1650420457043,MATH 109,A01,083213,Anzaldo; Leesa B,0,7,30,30
1650420457043,MATH 109,A02,083214,Anzaldo; Leesa B,0,7,30,30
1650420457043,MATH 109,B01,083215,Anzaldo; Leesa B,0,5,30,30
1650420457043,MATH 109,B02,083216,Anzaldo; Leesa B,0,6,30,30
1650420463080,MATH 142A,A01,083219,Chow; Bennett,0,14,30,30
1650420463080,MATH 142A,A02,083220,Chow; Bennett,0,13,30,30
1650420463080,MATH 142A,B01,083221,Chow; Bennett,0,12,30,30
1650420463080,MATH 142A,B02,083222,Chow; Bennett,0,13,30,30
1650420469108,MATH 193A,A01,083224,Staff,0,5,30,30
1650420469108,MATH 193A,A02,083225,Staff,0,5,30,30
1650420469108,MATH 193A,A03,083781,Staff,0,4,30,30
1650420469108,MATH 193A,A04,083782,Staff,0,4,30,30
1650420475130,MATH 197,001,091859,McAuley; Julian John,9998,0,9999,1
1650420481184,COGS 9,A01,083615,Staff,0,14,60,60
1650420487209,COGS 11,A01,083617,Boyle; Mary E. T.,21,0,40,19
1650420493236,COGS 13,A01,083071,Staff,0,34,40,40
1650420499261,COGS 14A,A01,092681,Staff,0,25,100,100
1650420505285,COGS 14B,A01,083073,Cheng; Tzu-Han,0,11,50,50
1650420511308,COGS 17,A01,092677,Staff,23,0,75,52
1650420517334,COGS 100,A01,083619,Staff,0,26,60,60
1650420523355,COGS 101A,A01,083621,Davis; Joshua Daniel,0,21,60,60
1650420529381,COGS 101B,A01,091572,Staff,0,4,60,60
1650420535492,COGS 101C,A01,083625,Delgado; Tania,16,0,30,14
1650420541516,COGS 107A,A01,083627,Boyle; Mary E. T.,0,11,60,60
1650420547543,COGS 118A,A01,083075,Staff,2,0,60,58
1650420553571,CSE 3,A50,083646,Miranda; Gregory Joseph,21,0,38,17
1650420553571,CSE 3,A51,083647,Miranda; Gregory Joseph,37,0,37,0
1650420559593,CSE 8A,A50,083650,Miranda; Gregory Joseph,0,28,40,40
1650420565623,CSE 11,A01,083080,Cao; Yingjun,0,91,40,40
1650420571653,CSE 12,A01,083652,Staff,0,16,100,100
1650420577679,CSE 15L,A01,083654,Staff,0,1,50,50
1650420577679,CSE 15L,A02,083655,Staff,2,0,50,48
1650420583705,CSE 20,A01,083657,Staff,51,0,80,29
1650420589729,CSE 30,A01,083084,Eldon; John,0,76,40,40
1650420595756,CSE 100,A01,083659,Cao; Yingjun,0,66,50,50
1650420601785,CSE 134B,A01,083661,Powell; Thomas Allan,1,33,65,64
1650420607814,CSE 140,A01,083663,Staff,0,1,75,75
1650420613849,CSE 140L,A01,083088,Eldon; John,0,7,75,75
1650420619874,CSE 175,A01,083665,Kumar; Rakesh,7,0,25,18
1650420625900,CSE 190,A00,092507,Dubnov; Shlomo,14,0,20,6
1650420631924,ECE 45,A01,083139,Staff,0,17,40,40
1650420637951,ECE 65,A50,083695,Staff,0,5,30,30
1650420643980,ECE 109,A01,091882,Touri; Behrouz,39,0,70,31
1650420650005,ECE 180,A00,083140,Abi Samra; Nicholas Camill,23,0,30,7
1650420650005,ECE 180,B00,083141,Abi Samra; Nicholas Camill,0,0,30,30
1650420656043,MATH 10A,A01,083735,Patchell; Gregory David,7,0,30,23
1650420656043,MATH 10A,A02,083736,Patchell; Gregory David,28,0,30,2
1650420656043,MATH 10A,A03,083737,Patchell; Gregory David,25,0,30,5
1650420662077,MATH 10B,A01,083207,Staff,0,8,30,30
1650420662077,MATH 10B,A02,083208,Staff,0,7,30,30
1650420662077,MATH 10B,B01,083739,Staff,14,0,30,16
1650420662077,MATH 10B,B02,083740,Staff,28,0,30,2
1650420668108,MATH 18,A01,083743,Staff,2,0,30,28
1650420668108,MATH 18,A02,083744,Staff,27,0,30,3
1650420668108,MATH 18,A03,083745,Staff,22,0,30,8
1650420668108,MATH 18,A04,083746,Staff,26,0,30,4
1650420668108,MATH 18,B01,083748,Staff,1,12,30,29
1650420668108,MATH 18,B02,083749,Staff,0,12,30,30
1650420668108,MATH 18,B03,083750,Staff,1,12,30,29
1650420668108,MATH 18,B04,083751,Staff,0,12,30,30
1650420674133,MATH 20A,A01,083754,Staff,26,0,40,14
1650420680159,MATH 20B,A01,083756,Staff,0,9,30,30
1650420680159,MATH 20B,A02,083757,Staff,0,9,30,30
1650420686184,MATH 20C,A01,083760,Staff,0,14,30,30
1650420686184,MATH 20C,A02,083761,Staff,1,15,30,29
1650420686184,MATH 20C,B01,083762,Staff,13,0,30,17
1650420686184,MATH 20C,B02,083763,Staff,28,0,30,2
1650420692208,MATH 20D,A01,083765,Staff,0,1,30,30
1650420692208,MATH 20D,A02,083766,Staff,7,0,30,23
1650420692208,MATH 20D,A03,083767,Staff,26,0,30,4
1650420698237,MATH 20E,A01,083771,Staff,5,0,30,25
1650420698237,MATH 20E,A02,083772,Staff,18,0,30,12
1650420698237,MATH 20E,B01,083773,Staff,0,0,30,30
1650420698237,MATH 20E,B02,083774,Staff,12,0,30,18
1650420704261,MATH 103A,A01,083777,Staff,0,11,30,30
1650420704261,MATH 103A,A02,083778,Staff,0,12,30,30
1650420704261,MATH 103A,B01,083779,Staff,0,13,30,30
1650420704261,MATH 103A,B02,083780,Staff,0,11,30,30
1650420710289,MATH 105,A01,085443,Staff,0,22,30,30
1650420716323,MATH 109,A01,083213,Anzaldo; Leesa B,0,7,30,30
1650420716323,MATH 109,A02,083214,Anzaldo; Leesa B,0,7,30,30
1650420716323,MATH 109,B01,083215,Anzaldo; Leesa B,0,5,30,30
1650420716323,MATH 109,B02,083216,Anzaldo; Leesa B,0,6,30,30
1650420722348,MATH 142A,A01,083219,Chow; Bennett,0,14,30,30
1650420722348,MATH 142A,A02,083220,Chow; Bennett,0,13,30,30
1650420722348,MATH 142A,B01,083221,Chow; Bennett,0,12,30,30
1650420722348,MATH 142A,B02,083222,Chow; Bennett,0,13,30,30
1650420728375,MATH 193A,A01,083224,Staff,0,5,30,30
1650420728375,MATH 193A,A02,083225,Staff,0,5,30,30
1650420728375,MATH 193A,A03,083781,Staff,0,4,30,30
1650420728375,MATH 193A,A04,083782,Staff,0,4,30,30
1650420734399,MATH 197,001,091859,McAuley; Julian John,9998,0,9999,1
1650420740478,COGS 9,A01,083615,Staff,0,14,60,60
1650420746505,COGS 11,A01,083617,Boyle; Mary E. T.,21,0,40,19
1650420752533,COGS 13,A01,083071,Staff,0,34,40,40
1650420758570,COGS 14A,A01,092681,Staff,0,25,100,100
1650420764601,COGS 14B,A01,083073,Cheng; Tzu-Han,0,11,50,50
1650420770624,COGS 17,A01,092677,Staff,23,0,75,52
1650420776650,COGS 100,A01,083619,Staff,0,26,60,60
1650420782674,COGS 101A,A01,083621,Davis; Joshua Daniel,0,21,60,60
1650420788698,COGS 101B,A01,091572,Staff,0,4,60,60
1650420794736,COGS 101C,A01,083625,Delgado; Tania,16,0,30,14
1650420800762,COGS 107A,A01,083627,Boyle; Mary E. T.,0,11,60,60
1650420806786,COGS 118A,A01,083075,Staff,2,0,60,58
1650420812811,CSE 3,A50,083646,Miranda; Gregory Joseph,21,0,38,17
1650420812811,CSE 3,A51,083647,Miranda; Gregory Joseph,37,0,37,0
1650420818834,CSE 8A,A50,083650,Miranda; Gregory Joseph,0,28,40,40
1650420824860,CSE 11,A01,083080,Cao; Yingjun,0,91,40,40
1650420830887,CSE 12,A01,083652,Staff,0,16,100,100
1650420836911,CSE 15L,A01,083654,Staff,0,1,50,50
1650420836911,CSE 15L,A02,083655,Staff,2,0,50,48
1650420842936,CSE 20,A01,083657,Staff,51,0,80,29
1650420848961,CSE 30,A01,083084,Eldon; John,0,76,40,40
1650420854984,CSE 100,A01,083659,Cao; Yingjun,0,66,50,50
1650420861015,CSE 134B,A01,083661,Powell; Thomas Allan,1,33,65,64
1650420867042,CSE 140,A01,083663,Staff,0,1,75,75
1650420873072,CSE 140L,A01,083088,Eldon; John,0,7,75,75
1650420879094,CSE 175,A01,083665,Kumar; Rakesh,7,0,25,18
1650420885117,CSE 190,A00,092507,Dubnov; Shlomo,14,0,20,6
1650420891144,ECE 45,A01,083139,Staff,0,17,40,40
1650420897167,ECE 65,A50,083695,Staff,0,5,30,30
1650420903189,ECE 109,A01,091882,Touri; Behrouz,39,0,70,31
1650420909213,ECE 180,A00,083140,Abi Samra; Nicholas Camill,23,0,30,7
1650420909213,ECE 180,B00,083141,Abi Samra; Nicholas Camill,0,0,30,30
1650420915238,MATH 10A,A01,083735,Patchell; Gregory David,7,0,30,23
1650420915238,MATH 10A,A02,083736,Patchell; Gregory David,28,0,30,2
1650420915238,MATH 10A,A03,083737,Patchell; Gregory David,25,0,30,5
1650420921267,MATH 10B,A01,083207,Staff,0,8,30,30
1650420921267,MATH 10B,A02,083208,Staff,0,7,30,30
1650420921267,MATH 10B,B01,083739,Staff,14,0,30,16
1650420921267,MATH 10B,B02,083740,Staff,28,0,30,2
1650420927293,MATH 18,A01,083743,Staff,2,0,30,28
1650420927293,MATH 18,A02,083744,Staff,27,0,30,3
1650420927293,MATH 18,A03,083745,Staff,22,0,30,8
1650420927293,MATH 18,A04,083746,Staff,26,0,30,4
1650420927293,MATH 18,B01,083748,Staff,1,12,30,29
1650420927293,MATH 18,B02,083749,Staff,0,12,30,30
1650420927293,MATH 18,B03,083750,Staff,1,12,30,29
1650420927293,MATH 18,B04,083751,Staff,0,12,30,30
1650420942445,MATH 20A,A01,083754,Staff,26,0,40,14
1650420948472,MATH 20B,A01,083756,Staff,0,9,30,30
1650420948472,MATH 20B,A02,083757,Staff,0,9,30,30
1650420954498,MATH 20C,A01,083760,Staff,0,14,30,30
1650420954498,MATH 20C,A02,083761,Staff,1,15,30,29
1650420954498,MATH 20C,B01,083762,Staff,13,0,30,17
1650420954498,MATH 20C,B02,083763,Staff,28,0,30,2
1650420960529,MATH 20D,A01,083765,Staff,0,1,30,30
1650420960529,MATH 20D,A02,083766,Staff,7,0,30,23
1650420960529,MATH 20D,A03,083767,Staff,26,0,30,4
1650420966559,MATH 20E,A01,083771,Staff,5,0,30,25
1650420966559,MATH 20E,A02,083772,Staff,18,0,30,12
1650420966559,MATH 20E,B01,083773,Staff,0,0,30,30
1650420966559,MATH 20E,B02,083774,Staff,12,0,30,18
1650420972585,MATH 103A,A01,083777,Staff,0,11,30,30
1650420972585,MATH 103A,A02,083778,Staff,0,12,30,30
1650420972585,MATH 103A,B01,083779,Staff,0,13,30,30
1650420972585,MATH 103A,B02,083780,Staff,0,11,30,30
1650420978613,MATH 105,A01,085443,Staff,0,22,30,30
1650420984641,MATH 109,A01,083213,Anzaldo; Leesa B,0,7,30,30
1650420984641,MATH 109,A02,083214,Anzaldo; Leesa B,0,7,30,30
1650420984641,MATH 109,B01,083215,Anzaldo; Leesa B,0,5,30,30
1650420984641,MATH 109,B02,083216,Anzaldo; Leesa B,0,6,30,30
1650420990666,MATH 142A,A01,083219,Chow; Bennett,0,14,30,30
1650420990666,MATH 142A,A02,083220,Chow; Bennett,0,13,30,30
1650420990666,MATH 142A,B01,083221,Chow; Bennett,0,12,30,30
1650420990666,MATH 142A,B02,083222,Chow; Bennett,0,13,30,30
1650420996690,MATH 193A,A01,083224,Staff,0,5,30,30
1650420996690,MATH 193A,A02,083225,Staff,0,5,30,30
1650420996690,MATH 193A,A03,083781,Staff,0,4,30,30
1650420996690,MATH 193A,A04,083782,Staff,0,4,30,30
1650421002713,MATH 197,001,091859,McAuley; Julian John,9998,0,9999,1
1650421008774,COGS 9,A01,083615,Staff,0,14,60,60
1650421014799,COGS 11,A01,083617,Boyle; Mary E. T.,21,0,40,19
1650421020821,COGS 13,A01,083071,Staff,0,34,40,40
1650421026846,COGS 14A,A01,092681,Staff,0,25,100,100
1650421032873,COGS 14B,A01,083073,Cheng; Tzu-Han,0,11,50,50
1650421038896,COGS 17,A01,092677,Staff,23,0,75,52
1650421044922,COGS 100,A01,083619,Staff,0,26,60,60
1650421050949,COGS 101A,A01,083621,Davis; Joshua Daniel,0,21,60,60
1650421056972,COGS 101B,A01,091572,Staff,0,4,60,60
1650421062997,COGS 101C,A01,083625,Delgado; Tania,16,0,30,14
1650421069026,COGS 107A,A01,083627,Boyle; Mary E. T.,0,11,60,60
1650421075050,COGS 118A,A01,083075,Staff,2,0,60,58
1650421081079,CSE 3,A50,083646,Miranda; Gregory Joseph,21,0,38,17
1650421081079,CSE 3,A51,083647,Miranda; Gregory Joseph,37,0,37,0
1650421087103,CSE 8A,A50,083650,Miranda; Gregory Joseph,0,28,40,40
1650421093126,CSE 11,A01,083080,Cao; Yingjun,0,91,40,40
1650421099152,CSE 12,A01,083652,Staff,0,16,100,100
1650421105178,CSE 15L,A01,083654,Staff,0,1,50,50
1650421105178,CSE 15L,A02,083655,Staff,2,0,50,48
1650421111203,CSE 20,A01,083657,Staff,51,0,80,29
1650421117230,CSE 30,A01,083084,Eldon; John,0,76,40,40
1650421123255,CSE 100,A01,083659,Cao; Yingjun,0,66,50,50
1650421129284,CSE 134B,A01,083661,Powell; Thomas Allan,1,33,65,64
1650421135310,CSE 140,A01,083663,Staff,0,1,75,75
1650421141426,CSE 140L,A01,083088,Eldon; John,0,7,75,75
1650421147450,CSE 175,A01,083665,Kumar; Rakesh,7,0,25,18
1650421153476,CSE 190,A00,092507,Dubnov; Shlomo,14,0,20,6
1650421159502,ECE 45,A01,083139,Staff,0,17,40,40
1650421165529,ECE 65,A50,083695,Staff,0,5,30,30
1650421171552,ECE 109,A01,091882,Touri; Behrouz,39,0,70,31
1650421177578,ECE 180,A00,083140,Abi Samra; Nicholas Camill,23,0,30,7
1650421177578,ECE 180,B00,083141,Abi Samra; Nicholas Camill,0,0,30,30
1650421183601,MATH 10A,A01,083735,Patchell; Gregory David,7,0,30,23
1650421183601,MATH 10A,A02,083736,Patchell; Gregory David,28,0,30,2
1650421183601,MATH 10A,A03,083737,Patchell; Gregory David,25,0,30,5
1650421189629,MATH 10B,A01,083207,Staff,0,8,30,30
1650421189629,MATH 10B,A02,083208,Staff,0,7,30,30
1650421189629,MATH 10B,B01,083739,Staff,14,0,30,16
1650421189629,MATH 10B,B02,083740,Staff,28,0,30,2
1650421195655,MATH 18,A01,083743,Staff,2,0,30,28
1650421195655,MATH 18,A02,083744,Staff,27,0,30,3
1650421195655,MATH 18,A03,083745,Staff,22,0,30,8
1650421195655,MATH 18,A04,083746,Staff,26,0,30,4
1650421195655,MATH 18,B01,083748,Staff,1,12,30,29
1650421195655,MATH 18,B02,083749,Staff,0,12,30,30
1650421195655,MATH 18,B03,083750,Staff,1,12,30,29
1650421195655,MATH 18,B04,083751,Staff,0,12,30,30
1650421201681,MATH 20A,A01,083754,Staff,26,0,40,14
1650421207705,MATH 20B,A01,083756,Staff,0,9,30,30
1650421207705,MATH 20B,A02,083757,Staff,0,9,30,30
1650421213738,MATH 20C,A01,083760,Staff,0,14,30,30
1650421213738,MATH 20C,A02,083761,Staff,1,15,30,29
1650421213738,MATH 20C,B01,083762,Staff,13,0,30,17
1650421213738,MATH 20C,B02,083763,Staff,28,0,30,2
1650421219767,MATH 20D,A01,083765,Staff,0,1,30,30
1650421219767,MATH 20D,A02,083766,Staff,7,0,30,23
1650421219767,MATH 20D,A03,083767,Staff,26,0,30,4
1650421225794,MATH 20E,A01,083771,Staff,5,0,30,25
1650421225794,MATH 20E,A02,083772,Staff,18,0,30,12
1650421225794,MATH 20E,B01,083773,Staff,0,0,30,30
1650421225794,MATH 20E,B02,083774,Staff,12,0,30,18
1650421231822,MATH 103A,A01,083777,Staff,0,11,30,30
1650421231822,MATH 103A,A02,083778,Staff,0,12,30,30
1650421231822,MATH 103A,B01,083779,Staff,0,13,30,30
1650421231822,MATH 103A,B02,083780,Staff,0,11,30,30
1650421237845,MATH 105,A01,085443,Staff,0,22,30,30
1650421243870,MATH 109,A01,083213,Anzaldo; Leesa B,0,7,30,30
1650421243870,MATH 109,A02,083214,Anzaldo; Leesa B,0,7,30,30
1650421243870,MATH 109,B01,083215,Anzaldo; Leesa B,0,5,30,30
1650421243870,MATH 109,B02,083216,Anzaldo; Leesa B,0,6,30,30
1650421249911,MATH 142A,A01,083219,Chow; Bennett,0,14,30,30
1650421249911,MATH 142A,A02,083220,Chow; Bennett,0,13,30,30
1650421249911,MATH 142A,B01,083221,Chow; Bennett,0,12,30,30
1650421249911,MATH 142A,B02,083222,Chow; Bennett,0,13,30,30
1650421255937,MATH 193A,A01,083224,Staff,0,5,30,30
1650421255937,MATH 193A,A02,083225,Staff,0,5,30,30
1650421255937,MATH 193A,A03,083781,Staff,0,4,30,30
1650421255937,MATH 193A,A04,083782,Staff,0,4,30,30
1650421261965,MATH 197,001,091859,McAuley; Julian John,9998,0,9999,1
1650421268021,COGS 9,A01,083615,Staff,0,14,60,60
1650421274046,COGS 11,A01,083617,Boyle; Mary E. T.,21,0,40,19
1650421280068,COGS 13,A01,083071,Staff,0,34,40,40
1650421286097,COGS 14A,A01,092681,Staff,0,25,100,100
1650421292121,COGS 14B,A01,083073,Cheng; Tzu-Han,0,11,50,50
1650421298145,COGS 17,A01,092677,Staff,23,0,75,52
1650421304170,COGS 100,A01,083619,Staff,0,26,60,60
1650421310196,COGS 101A,A01,083621,Davis; Joshua Daniel,0,21,60,60
1650421316221,COGS 101B,A01,091572,Staff,0,4,60,60
1650421322246,COGS 101C,A01,083625,Delgado; Tania,16,0,30,14
1650421328277,COGS 107A,A01,083627,Boyle; Mary E. T.,0,11,60,60
1650421334310,COGS 118A,A01,083075,Staff,2,0,60,58
1650421340334,CSE 3,A50,083646,Miranda; Gregory Joseph,21,0,38,17
1650421340334,CSE 3,A51,083647,Miranda; Gregory Joseph,37,0,37,0
1650421346375,CSE 8A,A50,083650,Miranda; Gregory Joseph,0,28,40,40
1650421352401,CSE 11,A01,083080,Cao; Yingjun,0,91,40,40
1650421358428,CSE 12,A01,083652,Staff,0,16,100,100
1650421364451,CSE 15L,A01,083654,Staff,0,1,50,50
1650421364451,CSE 15L,A02,083655,Staff,2,0,50,48
1650421370475,CSE 20,A01,083657,Staff,51,0,80,29
1650421376499,CSE 30,A01,083084,Eldon; John,0,76,40,40
1650421382523,CSE 100,A01,083659,Cao; Yingjun,0,66,50,50
1650421388549,CSE 134B,A01,083661,Powell; Thomas Allan,1,33,65,64
1650421394586,CSE 140,A01,083663,Staff,0,1,75,75
1650421400633,CSE 140L,A01,083088,Eldon; John,0,7,75,75
1650421406656,CSE 175,A01,083665,Kumar; Rakesh,7,0,25,18
1650421412681,CSE 190,A00,092507,Dubnov; Shlomo,14,0,20,6
1650421418705,ECE 45,A01,083139,Staff,0,17,40,40
1650421424731,ECE 65,A50,083695,Staff,0,5,30,30
1650421430757,ECE 109,A01,091882,Touri; Behrouz,39,0,70,31
1650421436794,ECE 180,A00,083140,Abi Samra; Nicholas Camill,23,0,30,7
1650421436794,ECE 180,B00,083141,Abi Samra; Nicholas Camill,0,0,30,30
1650421442829,MATH 10A,A01,083735,Patchell; Gregory David,7,0,30,23
1650421442829,MATH 10A,A02,083736,Patchell; Gregory David,28,0,30,2
1650421442829,MATH 10A,A03,083737,Patchell; Gregory David,25,0,30,5
1650421448860,MATH 10B,A01,083207,Staff,0,8,30,30
1650421448860,MATH 10B,A02,083208,Staff,0,7,30,30
1650421448860,MATH 10B,B01,083739,Staff,14,0,30,16
1650421448860,MATH 10B,B02,083740,Staff,28,0,30,2
1650421454889,MATH 18,A01,083743,Staff,2,0,30,28
1650421454889,MATH 18,A02,083744,Staff,27,0,30,3
1650421454889,MATH 18,A03,083745,Staff,22,0,30,8
1650421454889,MATH 18,A04,083746,Staff,26,0,30,4
1650421454889,MATH 18,B01,083748,Staff,1,12,30,29
1650421454889,MATH 18,B02,083749,Staff,0,12,30,30
1650421454889,MATH 18,B03,083750,Staff,1,12,30,29
1650421454889,MATH 18,B04,083751,Staff,0,12,30,30
1650421460915,MATH 20A,A01,083754,Staff,26,0,40,14
1650421466943,MATH 20B,A01,083756,Staff,0,9,30,30
1650421466943,MATH 20B,A02,083757,Staff,0,9,30,30
1650421472983,MATH 20C,A01,083760,Staff,0,14,30,30
1650421472983,MATH 20C,A02,083761,Staff,1,15,30,29
1650421472983,MATH 20C,B01,083762,Staff,13,0,30,17
1650421472983,MATH 20C,B02,083763,Staff,28,0,30,2
1650421479006,MATH 20D,A01,083765,Staff,0,1,30,30
1650421479006,MATH 20D,A02,083766,Staff,7,0,30,23
1650421479006,MATH 20D,A03,083767,Staff,26,0,30,4
1650421485031,MATH 20E,A01,083771,Staff,5,0,30,25
1650421485031,MATH 20E,A02,083772,Staff,18,0,30,12
1650421485031,MATH 20E,B01,083773,Staff,0,0,30,30
1650421485031,MATH 20E,B02,083774,Staff,12,0,30,18
1650421491067,MATH 103A,A01,083777,Staff,0,11,30,30
1650421491067,MATH 103A,A02,083778,Staff,0,12,30,30
1650421491067,MATH 103A,B01,083779,Staff,0,13,30,30
1650421491067,MATH 103A,B02,083780,Staff,0,11,30,30
1650421497092,MATH 105,A01,085443,Staff,0,22,30,30
1650421503120,MATH 109,A01,083213,Anzaldo; Leesa B,0,7,30,30
1650421503120,MATH 109,A02,083214,Anzaldo; Leesa B,0,7,30,30
1650421503120,MATH 109,B01,083215,Anzaldo; Leesa B,0,5,30,30
1650421503120,MATH 109,B02,083216,Anzaldo; Leesa B,0,6,30,30
1650421509146,MATH 142A,A01,083219,Chow; Bennett,0,14,30,30
1650421509146,MATH 142A,A02,083220,Chow; Bennett,0,13,30,30
1650421509146,MATH 142A,B01,083221,Chow; Bennett,0,12,30,30
1650421509146,MATH 142A,B02,083222,Chow; Bennett,0,13,30,30
1650421515173,MATH 193A,A01,083224,Staff,0,5,30,30
1650421515173,MATH 193A,A02,083225,Staff,0,5,30,30
1650421515173,MATH 193A,A03,083781,Staff,0,4,30,30
1650421515173,MATH 193A,A04,083782,Staff,0,4,30,30
1650421521200,MATH 197,001,091859,McAuley; Julian John,9998,0,9999,1
1650421527257,COGS 9,A01,083615,Staff,0,14,60,60
1650421533290,COGS 11,A01,083617,Boyle; Mary E. T.,21,0,40,19
1650421539313,COGS 13,A01,083071,Staff,0,34,40,40
1650421545340,COGS 14A,A01,092681,Staff,0,25,100,100
1650421551364,COGS 14B,A01,083073,Cheng; Tzu-Han,0,11,50,50
1650421557393,COGS 17,A01,092677,Staff,23,0,75,52
1650421563416,COGS 100,A01,083619,Staff,0,26,60,60
1650421569453,COGS 101A,A01,083621,Davis; Joshua Daniel,0,21,60,60
1650421575489,COGS 101B,A01,091572,Staff,0,4,60,60
1650421581511,COGS 101C,A01,083625,Delgado; Tania,16,0,30,14
1650421587544,COGS 107A,A01,083627,Boyle; Mary E. T.,0,11,60,60
1650421593568,COGS 118A,A01,083075,Staff,2,0,60,58
1650421599590,CSE 3,A50,083646,Miranda; Gregory Joseph,21,0,38,17
1650421599590,CSE 3,A51,083647,Miranda; Gregory Joseph,37,0,37,0
1650421605614,CSE 8A,A50,083650,Miranda; Gregory Joseph,0,28,40,40
1650421611646,CSE 11,A01,083080,Cao; Yingjun,0,91,40,40
1650421617669,CSE 12,A01,083652,Staff,0,16,100,100
1650421623696,CSE 15L,A01,083654,Staff,0,1,50,50
1650421623696,CSE 15L,A02,083655,Staff,2,0,50,48
1650421629738,CSE 20,A01,083657,Staff,51,0,80,29
1650421635772,CSE 30,A01,083084,Eldon; John,0,76,40,40
1650421641794,CSE 100,A01,083659,Cao; Yingjun,0,66,50,50
1650421647819,CSE 134B,A01,083661,Powell; Thomas Allan,1,33,65,64
1650421653840,CSE 140,A01,083663,Staff,0,1,75,75
1650421659866,CSE 140L,A01,083088,Eldon; John,0,7,75,75
1650421665890,CSE 175,A01,083665,Kumar; Rakesh,7,0,25,18
1650421671915,CSE 190,A00,092507,Dubnov; Shlomo,14,0,20,6
1650421677947,ECE 45,A01,083139,Staff,0,17,40,40
1650421683983,ECE 65,A50,083695,Staff,0,5,30,30
1650421690005,ECE 109,A01,091882,Touri; Behrouz,39,0,70,31
1650421696030,ECE 180,A00,083140,Abi Samra; Nicholas Camill,23,0,30,7
1650421696030,ECE 180,B00,083141,Abi Samra; Nicholas Camill,0,0,30,30
1650421702059,MATH 10A,A01,083735,Patchell; Gregory David,7,0,30,23
1650421702059,MATH 10A,A02,083736,Patchell; Gregory David,28,0,30,2
1650421702059,MATH 10A,A03,083737,Patchell; Gregory David,25,0,30,5
1650421708085,MATH 10B,A01,083207,Staff,0,8,30,30
1650421708085,MATH 10B,A02,083208,Staff,0,7,30,30
1650421708085,MATH 10B,B01,083739,Staff,14,0,30,16
1650421708085,MATH 10B,B02,083740,Staff,28,0,30,2
1650421714115,MATH 18,A01,083743,Staff,2,0,30,28
1650421714115,MATH 18,A02,083744,Staff,27,0,30,3
1650421714115,MATH 18,A03,083745,Staff,22,0,30,8
1650421714115,MATH 18,A04,083746,Staff,26,0,30,4
1650421714115,MATH 18,B01,083748,Staff,1,12,30,29
1650421714115,MATH 18,B02,083749,Staff,0,12,30,30
1650421714115,MATH 18,B03,083750,Staff,1,12,30,29
1650421714115,MATH 18,B04,083751,Staff,0,12,30,30
1650421720139,MATH 20A,A01,083754,Staff,26,0,40,14
1650421726163,MATH 20B,A01,083756,Staff,0,9,30,30
1650421726163,MATH 20B,A02,083757,Staff,0,9,30,30
1650421732191,MATH 20C,A01,083760,Staff,0,14,30,30
1650421732191,MATH 20C,A02,083761,Staff,1,15,30,29
1650421732191,MATH 20C,B01,083762,Staff,13,0,30,17
1650421732191,MATH 20C,B02,083763,Staff,28,0,30,2
1650421738292,MATH 20D,A01,083765,Staff,0,1,30,30
1650421738292,MATH 20D,A02,083766,Staff,7,0,30,23
1650421738292,MATH 20D,A03,083767,Staff,26,0,30,4
1650421744323,MATH 20E,A01,083771,Staff,5,0,30,25
1650421744323,MATH 20E,A02,083772,Staff,18,0,30,12
1650421744323,MATH 20E,B01,083773,Staff,0,0,30,30
1650421744323,MATH 20E,B02,083774,Staff,12,0,30,18
1650421750350,MATH 103A,A01,083777,Staff,0,11,30,30
1650421750350,MATH 103A,A02,083778,Staff,0,12,30,30
1650421750350,MATH 103A,B01,083779,Staff,0,13,30,30
1650421750350,MATH 103A,B02,083780,Staff,0,11,30,30
1650421756375,MATH 105,A01,085443,Staff,0,22,30,30
1650421762402,MATH 109,A01,083213,Anzaldo; Leesa B,0,7,30,30
1650421762402,MATH 109,A02,083214,Anzaldo; Leesa B,0,7,30,30
1650421762402,MATH 109,B01,083215,Anzaldo; Leesa B,0,5,30,30
1650421762402,MATH 109,B02,083216,Anzaldo; Leesa B,0,6,30,30
1650421768427,MATH 142A,A01,083219,Chow; Bennett,0,14,30,30
1650421768427,MATH 142A,A02,083220,Chow; Bennett,0,13,30,30
1650421768427,MATH 142A,B01,083221,Chow; Bennett,0,12,30,30
1650421768427,MATH 142A,B02,083222,Chow; Bennett,0,13,30,30
1650421774454,MATH 193A,A01,083224,Staff,0,5,30,30
1650421774454,MATH 193A,A02,083225,Staff,0,5,30,30
1650421774454,MATH 193A,A03,083781,Staff,0,4,30,30
1650421774454,MATH 193A,A04,083782,Staff,0,4,30,30
1650421780478,MATH 197,001,091859,McAuley; Julian John,9998,0,9999,1
1650421786540,COGS 9,A01,083615,Staff,0,14,60,60
1650421792566,COGS 11,A01,083617,Boyle; Mary E. T.,21,0,40,19
1650421798589,COGS 13,A01,083071,Staff,0,34,40,40
1650421804618,COGS 14A,A01,092681,Staff,0,25,100,100
1650421810650,COGS 14B,A01,083073,Cheng; Tzu-Han,0,11,50,50
1650421816673,COGS 17,A01,092677,Staff,23,0,75,52
1650421822695,COGS 100,A01,083619,Staff,0,26,60,60
1650421828719,COGS 101A,A01,083621,Davis; Joshua Daniel,0,21,60,60
1650421834752,COGS 101B,A01,091572,Staff,0,4,60,60
1650421840777,COGS 101C,A01,083625,Delgado; Tania,16,0,30,14
1650421846799,COGS 107A,A01,083627,Boyle; Mary E. T.,0,11,60,60
1650421852822,COGS 118A,A01,083075,Staff,2,0,60,58
1650421858847,CSE 3,A50,083646,Miranda; Gregory Joseph,21,0,38,17
1650421858847,CSE 3,A51,083647,Miranda; Gregory Joseph,37,0,37,0
1650421864875,CSE 8A,A50,083650,Miranda; Gregory Joseph,0,28,40,40
1650421870901,CSE 11,A01,083080,Cao; Yingjun,0,91,40,40
1650421876928,CSE 12,A01,083652,Staff,0,16,100,100
1650421882952,CSE 15L,A01,083654,Staff,0,1,50,50
1650421882952,CSE 15L,A02,083655,Staff,2,0,50,48
1650421888975,CSE 20,A01,083657,Staff,51,0,80,29
1650421895001,CSE 30,A01,083084,Eldon; John,0,76,40,40
1650421901028,CSE 100,A01,083659,Cao; Yingjun,0,66,50,50
1650421907055,CSE 134B,A01,083661,Powell; Thomas Allan,1,33,65,64
1650421913080,CSE 140,A01,083663,Staff,0,1,75,75
1650421919103,CSE 140L,A01,083088,Eldon; John,0,7,75,75
1650421925131,CSE 175,A01,083665,Kumar; Rakesh,7,0,25,18
1650421931161,CSE 190,A00,092507,Dubnov; Shlomo,14,0,20,6
1650421937184,ECE 45,A01,083139,Staff,0,17,40,40
1650421943210,ECE 65,A50,083695,Staff,0,5,30,30
1650421949234,ECE 109,A01,091882,Touri; Behrouz,39,0,70,31
1650421955256,ECE 180,A00,083140,Abi Samra; Nicholas Camill,23,0,30,7
1650421955256,ECE 180,B00,083141,Abi Samra; Nicholas Camill,0,0,30,30
1650421961281,MATH 10A,A01,083735,Patchell; Gregory David,7,0,30,23
1650421961281,MATH 10A,A02,083736,Patchell; Gregory David,28,0,30,2
1650421961281,MATH 10A,A03,083737,Patchell; Gregory David,25,0,30,5
1650421967306,MATH 10B,A01,083207,Staff,0,8,30,30
1650421967306,MATH 10B,A02,083208,Staff,0,7,30,30
1650421967306,MATH 10B,B01,083739,Staff,14,0,30,16
1650421967306,MATH 10B,B02,083740,Staff,28,0,30,2
1650421973343,MATH 18,A01,083743,Staff,2,0,30,28
1650421973343,MATH 18,A02,083744,Staff,27,0,30,3
1650421973343,MATH 18,A03,083745,Staff,22,0,30,8
1650421973343,MATH 18,A04,083746,Staff,26,0,30,4
1650421973343,MATH 18,B01,083748,Staff,1,12,30,29
1650421973343,MATH 18,B02,083749,Staff,0,12,30,30
1650421973343,MATH 18,B03,083750,Staff,1,12,30,29
1650421973343,MATH 18,B04,083751,Staff,0,12,30,30
1650421979368,MATH 20A,A01,083754,Staff,26,0,40,14
1650421985395,MATH 20B,A01,083756,Staff,0,9,30,30
1650421985395,MATH 20B,A02,083757,Staff,0,9,30,30
1650421991424,MATH 20C,A01,083760,Staff,0,14,30,30
1650421991424,MATH 20C,A02,083761,Staff,1,15,30,29
1650421991424,MATH 20C,B01,083762,Staff,13,0,30,17
1650421991424,MATH 20C,B02,083763,Staff,28,0,30,2
1650421997448,MATH 20D,A01,083765,Staff,0,1,30,30
1650421997448,MATH 20D,A02,083766,Staff,7,0,30,23
1650421997448,MATH 20D,A03,083767,Staff,26,0,30,4
1650422003472,MATH 20E,A01,083771,Staff,5,0,30,25
1650422003472,MATH 20E,A02,083772,Staff,18,0,30,12
1650422003472,MATH 20E,B01,083773,Staff,0,0,30,30
1650422003472,MATH 20E,B02,083774,Staff,12,0,30,18
1650422009495,MATH 103A,A01,083777,Staff,0,11,30,30
1650422009495,MATH 103A,A02,083778,Staff,0,12,30,30
1650422009495,MATH 103A,B01,083779,Staff,0,13,30,30
1650422009495,MATH 103A,B02,083780,Staff,0,11,30,30
1650422015518,MATH 105,A01,085443,Staff,0,22,30,30
1650422021547,MATH 109,A01,083213,Anzaldo; Leesa B,0,7,30,30
1650422021547,MATH 109,A02,083214,Anzaldo; Leesa B,0,7,30,30
1650422021547,MATH 109,B01,083215,Anzaldo; Leesa B,0,5,30,30
1650422021547,MATH 109,B02,083216,Anzaldo; Leesa B,0,6,30,30
1650422027574,MATH 142A,A01,083219,Chow; Bennett,0,14,30,30
1650422027574,MATH 142A,A02,083220,Chow; Bennett,0,13,30,30
1650422027574,MATH 142A,B01,083221,Chow; Bennett,0,12,30,30
1650422027574,MATH 142A,B02,083222,Chow; Bennett,0,13,30,30
1650422033600,MATH 193A,A01,083224,Staff,0,5,30,30
1650422033600,MATH 193A,A02,083225,Staff,0,5,30,30
1650422033600,MATH 193A,A03,083781,Staff,0,4,30,30
1650422033600,MATH 193A,A04,083782,Staff,0,4,30,30
1650422039626,MATH 197,001,091859,McAuley; Julian John,9998,0,9999,1
1650422045685,COGS 9,A01,083615,Staff,0,14,60,60
1650422051708,COGS 11,A01,083617,Boyle; Mary E. T.,21,0,40,19
1650422057731,COGS 13,A01,083071,Staff,0,34,40,40
1650422063768,COGS 14A,A01,092681,Staff,0,25,100,100
1650422069799,COGS 14B,A01,083073,Cheng; Tzu-Han,0,11,50,50
1650422075821,COGS 17,A01,092677,Staff,23,0,75,52
1650422081845,COGS 100,A01,083619,Staff,0,26,60,60
1650422087871,COGS 101A,A01,083621,Davis; Joshua Daniel,0,21,60,60
1650422093897,COGS 101B,A01,091572,Staff,0,4,60,60
1650422099920,COGS 101C,A01,083625,Delgado; Tania,16,0,30,14
1650422105957,COGS 107A,A01,083627,Boyle; Mary E. T.,0,11,60,60
1650422111992,COGS 118A,A01,083075,Staff,2,0,60,58
1650422118016,CSE 3,A50,083646,Miranda; Gregory Joseph,21,0,38,17
1650422118016,CSE 3,A51,083647,Miranda; Gregory Joseph,37,0,37,0
1650422124041,CSE 8A,A50,083650,Miranda; Gregory Joseph,0,28,40,40
1650422130071,CSE 11,A01,083080,Cao; Yingjun,0,91,40,40
1650422136097,CSE 12,A01,083652,Staff,0,16,100,100
1650422142121,CSE 15L,A01,083654,Staff,0,1,50,50
1650422142121,CSE 15L,A02,083655,Staff,2,0,50,48
1650422148147,CSE 20,A01,083657,Staff,51,0,80,29
1650422154171,CSE 30,A01,083084,Eldon; John,0,76,40,40
1650422160202,CSE 100,A01,083659,Cao; Yingjun,0,66,50,50
1650422166226,CSE 134B,A01,083661,Powell; Thomas Allan,1,33,65,64
1650422172249,CSE 140,A01,083663,Staff,0,1,75,75
1650422178272,CSE 140L,A01,083088,Eldon; John,0,7,75,75
1650422184298,CSE 175,A01,083665,Kumar; Rakesh,7,0,25,18
1650422190326,CSE 190,A00,092507,Dubnov; Shlomo,14,0,20,6
1650422196348,ECE 45,A01,083139,Staff,0,17,40,40
1650422202375,ECE 65,A50,083695,Staff,0,5,30,30
1650422208396,ECE 109,A01,091882,Touri; Behrouz,39,0,70,31
1650422214423,ECE 180,A00,083140,Abi Samra; Nicholas Camill,23,0,30,7
1650422214423,ECE 180,B00,083141,Abi Samra; Nicholas Camill,0,0,30,30
1650422220452,MATH 10A,A01,083735,Patchell; Gregory David,7,0,30,23
1650422220452,MATH 10A,A02,083736,Patchell; Gregory David,28,0,30,2
1650422220452,MATH 10A,A03,083737,Patchell; Gregory David,25,0,30,5
1650422226475,MATH 10B,A01,083207,Staff,0,8,30,30
1650422226475,MATH 10B,A02,083208,Staff,0,7,30,30
1650422226475,MATH 10B,B01,083739,Staff,14,0,30,16
1650422226475,MATH 10B,B02,083740,Staff,28,0,30,2
1650422232506,MATH 18,A01,083743,Staff,2,0,30,28
1650422232506,MATH 18,A02,083744,Staff,27,0,30,3
1650422232506,MATH 18,A03,083745,Staff,22,0,30,8
1650422232506,MATH 18,A04,083746,Staff,26,0,30,4
1650422232506,MATH 18,B01,083748,Staff,1,12,30,29
1650422232506,MATH 18,B02,083749,Staff,0,12,30,30
1650422232506,MATH 18,B03,083750,Staff,1,12,30,29
1650422232506,MATH 18,B04,083751,Staff,0,12,30,30
1650422238529,MATH 20A,A01,083754,Staff,26,0,40,14
1650422244553,MATH 20B,A01,083756,Staff,0,10,30,30
1650422244553,MATH 20B,A02,083757,Staff,0,9,30,30
1650422250585,MATH 20C,A01,083760,Staff,0,14,30,30
1650422250585,MATH 20C,A02,083761,Staff,1,15,30,29
1650422250585,MATH 20C,B01,083762,Staff,13,0,30,17
1650422250585,MATH 20C,B02,083763,Staff,28,0,30,2
1650422256619,MATH 20D,A01,083765,Staff,0,1,30,30
1650422256619,MATH 20D,A02,083766,Staff,7,0,30,23
1650422256619,MATH 20D,A03,083767,Staff,26,0,30,4
1650422262646,MATH 20E,A01,083771,Staff,5,0,30,25
1650422262646,MATH 20E,A02,083772,Staff,18,0,30,12
1650422262646,MATH 20E,B01,083773,Staff,0,0,30,30
1650422262646,MATH 20E,B02,083774,Staff,12,0,30,18
1650422268679,MATH 103A,A01,083777,Staff,0,11,30,30
1650422268679,MATH 103A,A02,083778,Staff,0,12,30,30
1650422268679,MATH 103A,B01,083779,Staff,0,13,30,30
1650422268679,MATH 103A,B02,083780,Staff,0,11,30,30
1650422274703,MATH 105,A01,085443,Staff,0,22,30,30
1650422280731,MATH 109,A01,083213,Anzaldo; Leesa B,0,7,30,30
1650422280731,MATH 109,A02,083214,Anzaldo; Leesa B,0,7,30,30
1650422280731,MATH 109,B01,083215,Anzaldo; Leesa B,0,5,30,30
1650422280731,MATH 109,B02,083216,Anzaldo; Leesa B,0,6,30,30
1650422286775,MATH 142A,A01,083219,Chow; Bennett,0,14,30,30
1650422286775,MATH 142A,A02,083220,Chow; Bennett,0,13,30,30
1650422286775,MATH 142A,B01,083221,Chow; Bennett,0,12,30,30
1650422286775,MATH 142A,B02,083222,Chow; Bennett,0,13,30,30
1650422292797,MATH 193A,A01,083224,Staff,0,5,30,30
1650422292797,MATH 193A,A02,083225,Staff,0,5,30,30
1650422292797,MATH 193A,A03,083781,Staff,0,4,30,30
1650422292797,MATH 193A,A04,083782,Staff,0,4,30,30
1650422298823,MATH 197,001,091859,McAuley; Julian John,9998,0,9999,1
1650422304873,COGS 9,A01,083615,Staff,0,14,60,60
1650422310900,COGS 11,A01,083617,Boyle; Mary E. T.,21,0,40,19
1650422316925,COGS 13,A01,083071,Staff,0,34,40,40
1650422322952,COGS 14A,A01,092681,Staff,0,25,100,100
1650422329087,COGS 14B,A01,083073,Cheng; Tzu-Han,0,11,50,50
1650422335111,COGS 17,A01,092677,Staff,23,0,75,52
1650422341139,COGS 100,A01,083619,Staff,0,26,60,60
1650422347163,COGS 101A,A01,083621,Davis; Joshua Daniel,0,21,60,60
1650422353186,COGS 101B,A01,091572,Staff,0,4,60,60
1650422359213,COGS 101C,A01,083625,Delgado; Tania,16,0,30,14
1650422365236,COGS 107A,A01,083627,Boyle; Mary E. T.,0,11,60,60
1650422371259,COGS 118A,A01,083075,Staff,2,0,60,58
1650422377286,CSE 3,A50,083646,Miranda; Gregory Joseph,21,0,38,17
1650422377286,CSE 3,A51,083647,Miranda; Gregory Joseph,37,0,37,0
1650422383312,CSE 8A,A50,083650,Miranda; Gregory Joseph,0,28,40,40
1650422389334,CSE 11,A01,083080,Cao; Yingjun,0,91,40,40
1650422395364,CSE 12,A01,083652,Staff,0,16,100,100
1650422401388,CSE 15L,A01,083654,Staff,0,1,50,50
1650422401388,CSE 15L,A02,083655,Staff,2,0,50,48
1650422407412,CSE 20,A01,083657,Staff,51,0,80,29
1650422413443,CSE 30,A01,083084,Eldon; John,0,76,40,40
1650422419465,CSE 100,A01,083659,Cao; Yingjun,0,66,50,50
1650422425492,CSE 134B,A01,083661,Powell; Thomas Allan,1,33,65,64
1650422431515,CSE 140,A01,083663,Staff,0,1,75,75
1650422437547,CSE 140L,A01,083088,Eldon; John,0,7,75,75
1650422443568,CSE 175,A01,083665,Kumar; Rakesh,7,0,25,18
1650422449591,CSE 190,A00,092507,Dubnov; Shlomo,14,0,20,6
1650422455615,ECE 45,A01,083139,Staff,0,17,40,40
1650422461643,ECE 65,A50,083695,Staff,0,5,30,30
1650422467675,ECE 109,A01,091882,Touri; Behrouz,39,0,70,31
1650422473698,ECE 180,A00,083140,Abi Samra; Nicholas Camill,23,0,30,7
1650422473698,ECE 180,B00,083141,Abi Samra; Nicholas Camill,0,0,30,30
1650422479723,MATH 10A,A01,083735,Patchell; Gregory David,7,0,30,23
1650422479723,MATH 10A,A02,083736,Patchell; Gregory David,28,0,30,2
1650422479723,MATH 10A,A03,083737,Patchell; Gregory David,25,0,30,5
1650422485747,MATH 10B,A01,083207,Staff,0,8,30,30
1650422485747,MATH 10B,A02,083208,Staff,0,7,30,30
1650422485747,MATH 10B,B01,083739,Staff,14,0,30,16
1650422485747,MATH 10B,B02,083740,Staff,28,0,30,2
1650422491772,MATH 18,A01,083743,Staff,2,0,30,28
1650422491772,MATH 18,A02,083744,Staff,27,0,30,3
1650422491772,MATH 18,A03,083745,Staff,22,0,30,8
1650422491772,MATH 18,A04,083746,Staff,26,0,30,4
1650422491772,MATH 18,B01,083748,Staff,1,12,30,29
1650422491772,MATH 18,B02,083749,Staff,0,12,30,30
1650422491772,MATH 18,B03,083750,Staff,1,12,30,29
1650422491772,MATH 18,B04,083751,Staff,0,12,30,30
1650422497796,MATH 20A,A01,083754,Staff,26,0,40,14
1650422503819,MATH 20B,A01,083756,Staff,0,10,30,30
1650422503819,MATH 20B,A02,083757,Staff,0,9,30,30
1650422509845,MATH 20C,A01,083760,Staff,0,14,30,30
1650422509845,MATH 20C,A02,083761,Staff,1,15,30,29
1650422509845,MATH 20C,B01,083762,Staff,13,0,30,17
1650422509845,MATH 20C,B02,083763,Staff,28,0,30,2
1650422515872,MATH 20D,A01,083765,Staff,0,1,30,30
1650422515872,MATH 20D,A02,083766,Staff,7,0,30,23
1650422515872,MATH 20D,A03,083767,Staff,26,0,30,4
1650422521897,MATH 20E,A01,083771,Staff,5,0,30,25
1650422521897,MATH 20E,A02,083772,Staff,18,0,30,12
1650422521897,MATH 20E,B01,083773,Staff,0,0,30,30
1650422521897,MATH 20E,B02,083774,Staff,12,0,30,18
1650422527921,MATH 103A,A01,083777,Staff,0,11,30,30
1650422527921,MATH 103A,A02,083778,Staff,0,12,30,30
1650422527921,MATH 103A,B01,083779,Staff,0,13,30,30
1650422527921,MATH 103A,B02,083780,Staff,0,11,30,30
1650422533945,MATH 105,A01,085443,Staff,0,22,30,30
1650422539970,MATH 109,A01,083213,Anzaldo; Leesa B,0,7,30,30
1650422539970,MATH 109,A02,083214,Anzaldo; Leesa B,0,7,30,30
1650422539970,MATH 109,B01,083215,Anzaldo; Leesa B,0,5,30,30
1650422539970,MATH 109,B02,083216,Anzaldo; Leesa B,0,6,30,30
1650422546001,MATH 142A,A01,083219,Chow; Bennett,0,14,30,30
1650422546001,MATH 142A,A02,083220,Chow; Bennett,0,13,30,30
1650422546001,MATH 142A,B01,083221,Chow; Bennett,0,12,30,30
1650422546001,MATH 142A,B02,083222,Chow; Bennett,0,13,30,30
1650422552024,MATH 193A,A01,083224,Staff,0,5,30,30
1650422552024,MATH 193A,A02,083225,Staff,0,5,30,30
1650422552024,MATH 193A,A03,083781,Staff,0,4,30,30
1650422552024,MATH 193A,A04,083782,Staff,0,4,30,30
1650422558050,MATH 197,001,091859,McAuley; Julian John,9998,0,9999,1
1650422564115,COGS 9,A01,083615,Staff,0,14,60,60
1650422570142,COGS 11,A01,083617,Boyle; Mary E. T.,21,0,40,19
1650422576175,COGS 13,A01,083071,Staff,0,34,40,40
1650422582210,COGS 14A,A01,092681,Staff,0,25,100,100
1650422588237,COGS 14B,A01,083073,Cheng; Tzu-Han,0,11,50,50
1650422594262,COGS 17,A01,092677,Staff,23,0,75,52
1650422600299,COGS 100,A01,083619,Staff,0,26,60,60
1650422606328,COGS 101A,A01,083621,Davis; Joshua Daniel,0,21,60,60
1650422612354,COGS 101B,A01,091572,Staff,0,4,60,60
1650422618378,COGS 101C,A01,083625,Delgado; Tania,16,0,30,14
1650422624411,COGS 107A,A01,083627,Boyle; Mary E. T.,0,11,60,60
1650422630436,COGS 118A,A01,083075,Staff,2,0,60,58
1650422636475,CSE 3,A50,083646,Miranda; Gregory Joseph,21,0,38,17
1650422636475,CSE 3,A51,083647,Miranda; Gregory Joseph,37,0,37,0
1650422642499,CSE 8A,A50,083650,Miranda; Gregory Joseph,0,28,40,40
1650422648523,CSE 11,A01,083080,Cao; Yingjun,0,91,40,40
1650422654556,CSE 12,A01,083652,Staff,0,16,100,100
1650422660582,CSE 15L,A01,083654,Staff,0,1,50,50
1650422660582,CSE 15L,A02,083655,Staff,2,0,50,48
1650422666609,CSE 20,A01,083657,Staff,51,0,80,29
1650422672638,CSE 30,A01,083084,Eldon; John,0,76,40,40
1650422678668,CSE 100,A01,083659,Cao; Yingjun,0,66,50,50
1650422684691,CSE 134B,A01,083661,Powell; Thomas Allan,1,33,65,64
1650422690722,CSE 140,A01,083663,Staff,0,1,75,75
1650422696785,CSE 140L,A01,083088,Eldon; John,0,7,75,75
1650422702813,CSE 175,A01,083665,Kumar; Rakesh,7,0,25,18
1650422708836,CSE 190,A00,092507,Dubnov; Shlomo,14,0,20,6
1650422714863,ECE 45,A01,083139,Staff,0,17,40,40
1650422720893,ECE 65,A50,083695,Staff,0,5,30,30
1650422726916,ECE 109,A01,091882,Touri; Behrouz,39,0,70,31
1650422732939,ECE 180,A00,083140,Abi Samra; Nicholas Camill,23,0,30,7
1650422732939,ECE 180,B00,083141,Abi Samra; Nicholas Camill,0,0,30,30
1650422738964,MATH 10A,A01,083735,Patchell; Gregory David,7,0,30,23
1650422738964,MATH 10A,A02,083736,Patchell; Gregory David,28,0,30,2
1650422738964,MATH 10A,A03,083737,Patchell; Gregory David,25,0,30,5
1650422744992,MATH 10B,A01,083207,Staff,0,8,30,30
1650422744992,MATH 10B,A02,083208,Staff,0,7,30,30
1650422744992,MATH 10B,B01,083739,Staff,14,0,30,16
1650422744992,MATH 10B,B02,083740,Staff,28,0,30,2
1650422751016,MATH 18,A01,083743,Staff,2,0,30,28
1650422751016,MATH 18,A02,083744,Staff,27,0,30,3
1650422751016,MATH 18,A03,083745,Staff,22,0,30,8
1650422751016,MATH 18,A04,083746,Staff,26,0,30,4
1650422751016,MATH 18,B01,083748,Staff,1,12,30,29
1650422751016,MATH 18,B02,083749,Staff,0,12,30,30
1650422751016,MATH 18,B03,083750,Staff,1,12,30,29
1650422751016,MATH 18,B04,083751,Staff,0,12,30,30
1650422757043,MATH 20A,A01,083754,Staff,26,0,40,14
1650422763067,MATH 20B,A01,083756,Staff,0,10,30,30
1650422763067,MATH 20B,A02,083757,Staff,0,9,30,30
1650422769094,MATH 20C,A01,083760,Staff,0,14,30,30
1650422769094,MATH 20C,A02,083761,Staff,1,15,30,29
1650422769094,MATH 20C,B01,083762,Staff,13,0,30,17
1650422769094,MATH 20C,B02,083763,Staff,28,0,30,2
1650422775119,MATH 20D,A01,083765,Staff,0,1,30,30
1650422775119,MATH 20D,A02,083766,Staff,7,0,30,23
1650422775119,MATH 20D,A03,083767,Staff,26,0,30,4
1650422781142,MATH 20E,A01,083771,Staff,5,0,30,25
1650422781142,MATH 20E,A02,083772,Staff,18,0,30,12
1650422781142,MATH 20E,B01,083773,Staff,0,0,30,30
1650422781142,MATH 20E,B02,083774,Staff,12,0,30,18
1650422787166,MATH 103A,A01,083777,Staff,0,11,30,30
1650422787166,MATH 103A,A02,083778,Staff,0,12,30,30
1650422787166,MATH 103A,B01,083779,Staff,0,13,30,30
1650422787166,MATH 103A,B02,083780,Staff,0,11,30,30
1650422793190,MATH 105,A01,085443,Staff,0,22,30,30
1650422799219,MATH 109,A01,083213,Anzaldo; Leesa B,0,7,30,30
1650422799219,MATH 109,A02,083214,Anzaldo; Leesa B,0,7,30,30
1650422799219,MATH 109,B01,083215,Anzaldo; Leesa B,0,5,30,30
1650422799219,MATH 109,B02,083216,Anzaldo; Leesa B,0,6,30,30
1650422805243,MATH 142A,A01,083219,Chow; Bennett,0,14,30,30
1650422805243,MATH 142A,A02,083220,Chow; Bennett,0,13,30,30
1650422805243,MATH 142A,B01,083221,Chow; Bennett,0,12,30,30
1650422805243,MATH 142A,B02,083222,Chow; Bennett,0,13,30,30
1650422811267,MATH 193A,A01,083224,Staff,0,5,30,30
1650422811267,MATH 193A,A02,083225,Staff,0,5,30,30
1650422811267,MATH 193A,A03,083781,Staff,0,4,30,30
1650422811267,MATH 193A,A04,083782,Staff,0,4,30,30
1650422817291,MATH 197,001,091859,McAuley; Julian John,9998,0,9999,1
1650422823349,COGS 9,A01,083615,Staff,0,14,60,60
1650422829374,COGS 11,A01,083617,Boyle; Mary E. T.,21,0,40,19
1650422835400,COGS 13,A01,083071,Staff,0,34,40,40
1650422841426,COGS 14A,A01,092681,Staff,0,25,100,100
1650422847462,COGS 14B,A01,083073,Cheng; Tzu-Han,0,11,50,50
1650422853490,COGS 17,A01,092677,Staff,23,0,75,52
1650422859514,COGS 100,A01,083619,Staff,0,26,60,60
1650422865542,COGS 101A,A01,083621,Davis; Joshua Daniel,0,21,60,60
1650422871566,COGS 101B,A01,091572,Staff,0,4,60,60
1650422877596,COGS 101C,A01,083625,Delgado; Tania,16,0,30,14
1650422883621,COGS 107A,A01,083627,Boyle; Mary E. T.,0,11,60,60
1650422889642,COGS 118A,A01,083075,Staff,2,0,60,58
1650422895667,CSE 3,A50,083646,Miranda; Gregory Joseph,21,0,38,17
1650422895667,CSE 3,A51,083647,Miranda; Gregory Joseph,37,0,37,0
1650422901694,CSE 8A,A50,083650,Miranda; Gregory Joseph,0,28,40,40
1650422907724,CSE 11,A01,083080,Cao; Yingjun,0,91,40,40
1650422913748,CSE 12,A01,083652,Staff,0,16,100,100
1650422919774,CSE 15L,A01,083654,Staff,0,1,50,50
1650422919774,CSE 15L,A02,083655,Staff,2,0,50,48
1650422925874,CSE 20,A01,083657,Staff,51,0,80,29
1650422931904,CSE 30,A01,083084,Eldon; John,0,76,40,40
1650422937931,CSE 100,A01,083659,Cao; Yingjun,0,66,50,50
1650422943961,CSE 134B,A01,083661,Powell; Thomas Allan,1,33,65,64
1650422949990,CSE 140,A01,083663,Staff,0,1,75,75
1650422956018,CSE 140L,A01,083088,Eldon; John,0,7,75,75
1650422962042,CSE 175,A01,083665,Kumar; Rakesh,7,0,25,18
1650422968068,CSE 190,A00,092507,Dubnov; Shlomo,14,0,20,6
1650422974118,ECE 45,A01,083139,Staff,0,17,40,40
1650422980142,ECE 65,A50,083695,Staff,0,5,30,30
1650422986164,ECE 109,A01,091882,Touri; Behrouz,39,0,70,31
1650422992191,ECE 180,A00,083140,Abi Samra; Nicholas Camill,23,0,30,7
1650422992191,ECE 180,B00,083141,Abi Samra; Nicholas Camill,0,0,30,30
1650422998215,MATH 10A,A01,083735,Patchell; Gregory David,7,0,30,23
1650422998215,MATH 10A,A02,083736,Patchell; Gregory David,28,0,30,2
1650422998215,MATH 10A,A03,083737,Patchell; Gregory David,25,0,30,5
1650423004243,MATH 10B,A01,083207,Staff,0,7,30,30
1650423004243,MATH 10B,A02,083208,Staff,0,7,30,30
1650423004243,MATH 10B,B01,083739,Staff,14,0,30,16
1650423004243,MATH 10B,B02,083740,Staff,28,0,30,2
1650423010288,MATH 18,A01,083743,Staff,2,0,30,28
1650423010288,MATH 18,A02,083744,Staff,27,0,30,3
1650423010288,MATH 18,A03,083745,Staff,22,0,30,8
1650423010288,MATH 18,A04,083746,Staff,26,0,30,4
1650423010288,MATH 18,B01,083748,Staff,1,12,30,29
1650423010288,MATH 18,B02,083749,Staff,0,12,30,30
1650423010288,MATH 18,B03,083750,Staff,1,12,30,29
1650423010288,MATH 18,B04,083751,Staff,0,12,30,30
1650423016312,MATH 20A,A01,083754,Staff,26,0,40,14
1650423022338,MATH 20B,A01,083756,Staff,0,10,30,30
1650423022338,MATH 20B,A02,083757,Staff,0,9,30,30
1650423028367,MATH 20C,A01,083760,Staff,0,14,30,30
1650423028367,MATH 20C,A02,083761,Staff,1,15,30,29
1650423028367,MATH 20C,B01,083762,Staff,13,0,30,17
1650423028367,MATH 20C,B02,083763,Staff,28,0,30,2
1650423034397,MATH 20D,A01,083765,Staff,0,1,30,30
1650423034397,MATH 20D,A02,083766,Staff,7,0,30,23
1650423034397,MATH 20D,A03,083767,Staff,26,0,30,4
1650423040422,MATH 20E,A01,083771,Staff,5,0,30,25
1650423040422,MATH 20E,A02,083772,Staff,18,0,30,12
1650423040422,MATH 20E,B01,083773,Staff,0,0,30,30
1650423040422,MATH 20E,B02,083774,Staff,12,0,30,18
1650423046451,MATH 103A,A01,083777,Staff,0,11,30,30
1650423046451,MATH 103A,A02,083778,Staff,0,12,30,30
1650423046451,MATH 103A,B01,083779,Staff,0,13,30,30
1650423046451,MATH 103A,B02,083780,Staff,0,11,30,30
1650423052477,MATH 105,A01,085443,Staff,0,22,30,30
1650423058501,MATH 109,A01,083213,Anzaldo; Leesa B,0,7,30,30
1650423058501,MATH 109,A02,083214,Anzaldo; Leesa B,0,7,30,30
1650423058501,MATH 109,B01,083215,Anzaldo; Leesa B,0,5,30,30
1650423058501,MATH 109,B02,083216,Anzaldo; Leesa B,0,6,30,30
1650423064525,MATH 142A,A01,083219,Chow; Bennett,0,14,30,30
1650423064525,MATH 142A,A02,083220,Chow; Bennett,0,13,30,30
1650423064525,MATH 142A,B01,083221,Chow; Bennett,0,12,30,30
1650423064525,MATH 142A,B02,083222,Chow; Bennett,0,13,30,30
1650423070548,MATH 193A,A01,083224,Staff,0,5,30,30
1650423070548,MATH 193A,A02,083225,Staff,0,5,30,30
1650423070548,MATH 193A,A03,083781,Staff,0,4,30,30
1650423070548,MATH 193A,A04,083782,Staff,0,4,30,30
1650423076570,MATH 197,001,091859,McAuley; Julian John,9998,0,9999,1
1650423082626,COGS 9,A01,083615,Staff,0,14,60,60
1650423088654,COGS 11,A01,083617,Boyle; Mary E. T.,21,0,40,19
1650423094677,COGS 13,A01,083071,Staff,0,34,40,40
1650423100703,COGS 14A,A01,092681,Staff,0,25,100,100
1650423106727,COGS 14B,A01,083073,Cheng; Tzu-Han,0,11,50,50
1650423112754,COGS 17,A01,092677,Staff,23,0,75,52
1650423118777,COGS 100,A01,083619,Staff,0,26,60,60
1650423124805,COGS 101A,A01,083621,Davis; Joshua Daniel,0,21,60,60
1650423130832,COGS 101B,A01,091572,Staff,0,4,60,60
1650423136863,COGS 101C,A01,083625,Delgado; Tania,16,0,30,14
1650423142888,COGS 107A,A01,083627,Boyle; Mary E. T.,0,11,60,60
1650423148911,COGS 118A,A01,083075,Staff,2,0,60,58
1650423154939,CSE 3,A50,083646,Miranda; Gregory Joseph,21,0,38,17
1650423154939,CSE 3,A51,083647,Miranda; Gregory Joseph,37,0,37,0
1650423160966,CSE 8A,A50,083650,Miranda; Gregory Joseph,0,28,40,40
1650423166989,CSE 11,A01,083080,Cao; Yingjun,0,91,40,40
1650423173014,CSE 12,A01,083652,Staff,0,16,100,100
1650423179042,CSE 15L,A01,083654,Staff,0,1,50,50
1650423179042,CSE 15L,A02,083655,Staff,2,0,50,48
1650423185066,CSE 20,A01,083657,Staff,51,0,80,29
1650423191089,CSE 30,A01,083084,Eldon; John,0,76,40,40
1650423197115,CSE 100,A01,083659,Cao; Yingjun,0,66,50,50
1650423203139,CSE 134B,A01,083661,Powell; Thomas Allan,1,33,65,64
1650423209164,CSE 140,A01,083663,Staff,0,1,75,75
1650423215229,CSE 140L,A01,083088,Eldon; John,0,7,75,75
1650423221253,CSE 175,A01,083665,Kumar; Rakesh,7,0,25,18
1650423227277,CSE 190,A00,092507,Dubnov; Shlomo,14,0,20,6
1650423233299,ECE 45,A01,083139,Staff,0,17,40,40
1650423239329,ECE 65,A50,083695,Staff,0,5,30,30
1650423245352,ECE 109,A01,091882,Touri; Behrouz,39,0,70,31
1650423251380,ECE 180,A00,083140,Abi Samra; Nicholas Camill,23,0,30,7
1650423251380,ECE 180,B00,083141,Abi Samra; Nicholas Camill,0,0,30,30
1650423257404,MATH 10A,A01,083735,Patchell; Gregory David,7,0,30,23
1650423257404,MATH 10A,A02,083736,Patchell; Gregory David,28,0,30,2
1650423257404,MATH 10A,A03,083737,Patchell; Gregory David,25,0,30,5
1650423263427,MATH 10B,A01,083207,Staff,0,7,30,30
1650423263427,MATH 10B,A02,083208,Staff,0,7,30,30
1650423263427,MATH 10B,B01,083739,Staff,14,0,30,16
1650423263427,MATH 10B,B02,083740,Staff,28,0,30,2
1650423269459,MATH 18,A01,083743,Staff,2,0,30,28
1650423269459,MATH 18,A02,083744,Staff,27,0,30,3
1650423269459,MATH 18,A03,083745,Staff,22,0,30,8
1650423269459,MATH 18,A04,083746,Staff,26,0,30,4
1650423269459,MATH 18,B01,083748,Staff,1,12,30,29
1650423269459,MATH 18,B02,083749,Staff,0,12,30,30
1650423269459,MATH 18,B03,083750,Staff,1,12,30,29
1650423269459,MATH 18,B04,083751,Staff,0,12,30,30
1650423275486,MATH 20A,A01,083754,Staff,26,0,40,14
1650423281509,MATH 20B,A01,083756,Staff,0,10,30,30
1650423281509,MATH 20B,A02,083757,Staff,0,9,30,30
1650423287532,MATH 20C,A01,083760,Staff,0,14,30,30
1650423287532,MATH 20C,A02,083761,Staff,1,15,30,29
1650423287532,MATH 20C,B01,083762,Staff,13,0,30,17
1650423287532,MATH 20C,B02,083763,Staff,28,0,30,2
1650423293556,MATH 20D,A01,083765,Staff,0,1,30,30
1650423293556,MATH 20D,A02,083766,Staff,7,0,30,23
1650423293556,MATH 20D,A03,083767,Staff,26,0,30,4
1650423299583,MATH 20E,A01,083771,Staff,5,0,30,25
1650423299583,MATH 20E,A02,083772,Staff,18,0,30,12
1650423299583,MATH 20E,B01,083773,Staff,0,0,30,30
1650423299583,MATH 20E,B02,083774,Staff,12,0,30,18
1650423305610,MATH 103A,A01,083777,Staff,0,11,30,30
1650423305610,MATH 103A,A02,083778,Staff,0,12,30,30
1650423305610,MATH 103A,B01,083779,Staff,0,13,30,30
1650423305610,MATH 103A,B02,083780,Staff,0,11,30,30
1650423311633,MATH 105,A01,085443,Staff,0,22,30,30
1650423317656,MATH 109,A01,083213,Anzaldo; Leesa B,0,7,30,30
1650423317656,MATH 109,A02,083214,Anzaldo; Leesa B,0,7,30,30
1650423317656,MATH 109,B01,083215,Anzaldo; Leesa B,0,5,30,30
1650423317656,MATH 109,B02,083216,Anzaldo; Leesa B,0,6,30,30
1650423323680,MATH 142A,A01,083219,Chow; Bennett,0,14,30,30
1650423323680,MATH 142A,A02,083220,Chow; Bennett,0,13,30,30
1650423323680,MATH 142A,B01,083221,Chow; Bennett,0,12,30,30
1650423323680,MATH 142A,B02,083222,Chow; Bennett,0,13,30,30
1650423329706,MATH 193A,A01,083224,Staff,0,5,30,30
1650423329706,MATH 193A,A02,083225,Staff,0,5,30,30
1650423329706,MATH 193A,A03,083781,Staff,0,4,30,30
1650423329706,MATH 193A,A04,083782,Staff,0,4,30,30
1650423335729,MATH 197,001,091859,McAuley; Julian John,9998,0,9999,1
1650423341789,COGS 9,A01,083615,Staff,0,14,60,60
1650423347812,COGS 11,A01,083617,Boyle; Mary E. T.,21,0,40,19
1650423353836,COGS 13,A01,083071,Staff,0,34,40,40
1650423359859,COGS 14A,A01,092681,Staff,0,25,100,100
1650423365881,COGS 14B,A01,083073,Cheng; Tzu-Han,0,11,50,50
1650423371913,COGS 17,A01,092677,Staff,23,0,75,52
1650423377945,COGS 100,A01,083619,Staff,0,26,60,60
1650423383972,COGS 101A,A01,083621,Davis; Joshua Daniel,0,21,60,60
1650423390004,COGS 101B,A01,091572,Staff,0,4,60,60
1650423396029,COGS 101C,A01,083625,Delgado; Tania,16,0,30,14
1650423402053,COGS 107A,A01,083627,Boyle; Mary E. T.,0,11,60,60
1650423408074,COGS 118A,A01,083075,Staff,2,0,60,58
1650423414098,CSE 3,A50,083646,Miranda; Gregory Joseph,21,0,38,17
1650423414098,CSE 3,A51,083647,Miranda; Gregory Joseph,37,0,37,0
1650423420121,CSE 8A,A50,083650,Miranda; Gregory Joseph,0,28,40,40
1650423426144,CSE 11,A01,083080,Cao; Yingjun,0,91,40,40
1650423432169,CSE 12,A01,083652,Staff,0,16,100,100
1650423438193,CSE 15L,A01,083654,Staff,0,1,50,50
1650423438193,CSE 15L,A02,083655,Staff,2,0,50,48
1650423444218,CSE 20,A01,083657,Staff,51,0,80,29
1650423450241,CSE 30,A01,083084,Eldon; John,0,76,40,40
1650423456269,CSE 100,A01,083659,Cao; Yingjun,0,66,50,50
1650423462295,CSE 134B,A01,083661,Powell; Thomas Allan,1,33,65,64
1650423468321,CSE 140,A01,083663,Staff,0,1,75,75
1650423474345,CSE 140L,A01,083088,Eldon; John,0,7,75,75
1650423480372,CSE 175,A01,083665,Kumar; Rakesh,7,0,25,18
1650423486401,CSE 190,A00,092507,Dubnov; Shlomo,14,0,20,6
1650423492436,ECE 45,A01,083139,Staff,0,17,40,40
1650423498460,ECE 65,A50,083695,Staff,0,5,30,30
1650423504497,ECE 109,A01,091882,Touri; Behrouz,39,0,70,31
1650423510521,ECE 180,A00,083140,Abi Samra; Nicholas Camill,23,0,30,7
1650423510521,ECE 180,B00,083141,Abi Samra; Nicholas Camill,0,0,30,30
1650423516549,MATH 10A,A01,083735,Patchell; Gregory David,7,0,30,23
1650423516549,MATH 10A,A02,083736,Patchell; Gregory David,28,0,30,2
1650423516549,MATH 10A,A03,083737,Patchell; Gregory David,25,0,30,5
1650423522647,MATH 10B,A01,083207,Staff,0,7,30,30
1650423522647,MATH 10B,A02,083208,Staff,0,7,30,30
1650423522647,MATH 10B,B01,083739,Staff,14,0,30,16
1650423522647,MATH 10B,B02,083740,Staff,28,0,30,2
1650423528675,MATH 18,A01,083743,Staff,2,0,30,28
1650423528675,MATH 18,A02,083744,Staff,27,0,30,3
1650423528675,MATH 18,A03,083745,Staff,22,0,30,8
1650423528675,MATH 18,A04,083746,Staff,26,0,30,4
1650423528675,MATH 18,B01,083748,Staff,1,12,30,29
1650423528675,MATH 18,B02,083749,Staff,0,12,30,30
1650423528675,MATH 18,B03,083750,Staff,1,12,30,29
1650423528675,MATH 18,B04,083751,Staff,0,12,30,30
1650423534698,MATH 20A,A01,083754,Staff,26,0,40,14
1650423540731,MATH 20B,A01,083756,Staff,0,10,30,30
1650423540731,MATH 20B,A02,083757,Staff,0,9,30,30
1650423546756,MATH 20C,A01,083760,Staff,0,14,30,30
1650423546756,MATH 20C,A02,083761,Staff,1,15,30,29
1650423546756,MATH 20C,B01,083762,Staff,13,0,30,17
1650423546756,MATH 20C,B02,083763,Staff,28,0,30,2
1650423552781,MATH 20D,A01,083765,Staff,0,1,30,30
1650423552781,MATH 20D,A02,083766,Staff,7,0,30,23
1650423552781,MATH 20D,A03,083767,Staff,26,0,30,4
1650423558804,MATH 20E,A01,083771,Staff,5,0,30,25
1650423558804,MATH 20E,A02,083772,Staff,18,0,30,12
1650423558804,MATH 20E,B01,083773,Staff,0,0,30,30
1650423558804,MATH 20E,B02,083774,Staff,12,0,30,18
1650423564834,MATH 103A,A01,083777,Staff,0,11,30,30
1650423564834,MATH 103A,A02,083778,Staff,0,12,30,30
1650423564834,MATH 103A,B01,083779,Staff,0,13,30,30
1650423564834,MATH 103A,B02,083780,Staff,0,11,30,30
1650423570858,MATH 105,A01,085443,Staff,0,22,30,30
1650423576885,MATH 109,A01,083213,Anzaldo; Leesa B,0,7,30,30
1650423576885,MATH 109,A02,083214,Anzaldo; Leesa B,0,7,30,30
1650423576885,MATH 109,B01,083215,Anzaldo; Leesa B,0,5,30,30
1650423576885,MATH 109,B02,083216,Anzaldo; Leesa B,0,6,30,30
1650423582909,MATH 142A,A01,083219,Chow; Bennett,0,14,30,30
1650423582909,MATH 142A,A02,083220,Chow; Bennett,0,13,30,30
1650423582909,MATH 142A,B01,083221,Chow; Bennett,0,12,30,30
1650423582909,MATH 142A,B02,083222,Chow; Bennett,0,13,30,30
1650423588933,MATH 193A,A01,083224,Staff,0,5,30,30
1650423588933,MATH 193A,A02,083225,Staff,0,5,30,30
1650423588933,MATH 193A,A03,083781,Staff,0,4,30,30
1650423588933,MATH 193A,A04,083782,Staff,0,4,30,30
1650423594959,MATH 197,001,091859,McAuley; Julian John,9998,0,9999,1
1650423601012,COGS 9,A01,083615,Staff,0,14,60,60
1650423607034,COGS 11,A01,083617,Boyle; Mary E. T.,21,0,40,19
1650423613058,COGS 13,A01,083071,Staff,0,34,40,40
1650423619083,COGS 14A,A01,092681,Staff,0,25,100,100
1650423625106,COGS 14B,A01,083073,Cheng; Tzu-Han,0,11,50,50
1650423631128,COGS 17,A01,092677,Staff,23,0,75,52
1650423637153,COGS 100,A01,083619,Staff,0,26,60,60
1650423643190,COGS 101A,A01,083621,Davis; Joshua Daniel,0,21,60,60
1650423649214,COGS 101B,A01,091572,Staff,0,4,60,60
1650423655239,COGS 101C,A01,083625,Delgado; Tania,16,0,30,14
1650423661274,COGS 107A,A01,083627,Boyle; Mary E. T.,0,11,60,60
1650423667298,COGS 118A,A01,083075,Staff,2,0,60,58
1650423673325,CSE 3,A50,083646,Miranda; Gregory Joseph,21,0,38,17
1650423673325,CSE 3,A51,083647,Miranda; Gregory Joseph,37,0,37,0
1650423679353,CSE 8A,A50,083650,Miranda; Gregory Joseph,0,28,40,40
1650423685384,CSE 11,A01,083080,Cao; Yingjun,0,91,40,40
1650423691413,CSE 12,A01,083652,Staff,0,16,100,100
1650423697437,CSE 15L,A01,083654,Staff,0,1,50,50
1650423697437,CSE 15L,A02,083655,Staff,2,0,50,48
1650423703462,CSE 20,A01,083657,Staff,51,0,80,29
1650423709486,CSE 30,A01,083084,Eldon; John,0,76,40,40
1650423715519,CSE 100,A01,083659,Cao; Yingjun,0,66,50,50
1650423721551,CSE 134B,A01,083661,Powell; Thomas Allan,1,33,65,64
1650423727578,CSE 140,A01,083663,Staff,0,2,75,75
1650423733606,CSE 140L,A01,083088,Eldon; John,0,8,75,75
1650423739648,CSE 175,A01,083665,Kumar; Rakesh,7,0,25,18
1650423745677,CSE 190,A00,092507,Dubnov; Shlomo,14,0,20,6
1650423751712,ECE 45,A01,083139,Staff,0,17,40,40
1650423757743,ECE 65,A50,083695,Staff,0,5,30,30
1650423763772,ECE 109,A01,091882,Touri; Behrouz,39,0,70,31
1650423769798,ECE 180,A00,083140,Abi Samra; Nicholas Camill,23,0,30,7
1650423769798,ECE 180,B00,083141,Abi Samra; Nicholas Camill,0,0,30,30
1650423775822,MATH 10A,A01,083735,Patchell; Gregory David,7,0,30,23
1650423775822,MATH 10A,A02,083736,Patchell; Gregory David,28,0,30,2
1650423775822,MATH 10A,A03,083737,Patchell; Gregory David,25,0,30,5
1650423781854,MATH 10B,A01,083207,Staff,0,7,30,30
1650423781854,MATH 10B,A02,083208,Staff,0,7,30,30
1650423781854,MATH 10B,B01,083739,Staff,14,0,30,16
1650423781854,MATH 10B,B02,083740,Staff,28,0,30,2
1650423787880,MATH 18,A01,083743,Staff,2,0,30,28
1650423787880,MATH 18,A02,083744,Staff,27,0,30,3
1650423787880,MATH 18,A03,083745,Staff,22,0,30,8
1650423787880,MATH 18,A04,083746,Staff,26,0,30,4
1650423787880,MATH 18,B01,083748,Staff,1,12,30,29
1650423787880,MATH 18,B02,083749,Staff,0,12,30,30
1650423787880,MATH 18,B03,083750,Staff,1,12,30,29
1650423787880,MATH 18,B04,083751,Staff,0,12,30,30
1650423793919,MATH 20A,A01,083754,Staff,26,0,40,14
1650423799943,MATH 20B,A01,083756,Staff,0,10,30,30
1650423799943,MATH 20B,A02,083757,Staff,0,9,30,30
1650423805967,MATH 20C,A01,083760,Staff,0,14,30,30
1650423805967,MATH 20C,A02,083761,Staff,1,15,30,29
1650423805967,MATH 20C,B01,083762,Staff,13,0,30,17
1650423805967,MATH 20C,B02,083763,Staff,28,0,30,2
1650423811992,MATH 20D,A01,083765,Staff,0,1,30,30
1650423811992,MATH 20D,A02,083766,Staff,7,0,30,23
1650423811992,MATH 20D,A03,083767,Staff,26,0,30,4
1650423818029,MATH 20E,A01,083771,Staff,5,0,30,25
1650423818029,MATH 20E,A02,083772,Staff,18,0,30,12
1650423818029,MATH 20E,B01,083773,Staff,0,0,30,30
1650423818029,MATH 20E,B02,083774,Staff,12,0,30,18
1650423824062,MATH 103A,A01,083777,Staff,0,11,30,30
1650423824062,MATH 103A,A02,083778,Staff,0,12,30,30
1650423824062,MATH 103A,B01,083779,Staff,0,13,30,30
1650423824062,MATH 103A,B02,083780,Staff,0,11,30,30
1650423830085,MATH 105,A01,085443,Staff,0,22,30,30
1650423836110,MATH 109,A01,083213,Anzaldo; Leesa B,0,7,30,30
1650423836110,MATH 109,A02,083214,Anzaldo; Leesa B,0,7,30,30
1650423836110,MATH 109,B01,083215,Anzaldo; Leesa B,0,5,30,30
1650423836110,MATH 109,B02,083216,Anzaldo; Leesa B,0,6,30,30
1650423842134,MATH 142A,A01,083219,Chow; Bennett,0,14,30,30
1650423842134,MATH 142A,A02,083220,Chow; Bennett,0,13,30,30
1650423842134,MATH 142A,B01,083221,Chow; Bennett,0,12,30,30
1650423842134,MATH 142A,B02,083222,Chow; Bennett,0,13,30,30
1650423848158,MATH 193A,A01,083224,Staff,0,5,30,30
1650423848158,MATH 193A,A02,083225,Staff,0,5,30,30
1650423848158,MATH 193A,A03,083781,Staff,0,4,30,30
1650423848158,MATH 193A,A04,083782,Staff,0,4,30,30
1650423854185,MATH 197,001,091859,McAuley; Julian John,9998,0,9999,1
1650423860236,COGS 9,A01,083615,Staff,0,14,60,60
1650423866260,COGS 11,A01,083617,Boyle; Mary E. T.,21,0,40,19
1650423872284,COGS 13,A01,083071,Staff,0,34,40,40
1650423878308,COGS 14A,A01,092681,Staff,0,25,100,100
1650423884331,COGS 14B,A01,083073,Cheng; Tzu-Han,0,11,50,50
1650423890354,COGS 17,A01,092677,Staff,23,0,75,52
1650423896377,COGS 100,A01,083619,Staff,0,26,60,60
1650423902415,COGS 101A,A01,083621,Davis; Joshua Daniel,0,21,60,60
1650423908438,COGS 101B,A01,091572,Staff,0,4,60,60
1650423914469,COGS 101C,A01,083625,Delgado; Tania,16,0,30,14
1650423920496,COGS 107A,A01,083627,Boyle; Mary E. T.,0,11,60,60
1650423926521,COGS 118A,A01,083075,Staff,2,0,60,58
1650423932553,CSE 3,A50,083646,Miranda; Gregory Joseph,21,0,38,17
1650423932553,CSE 3,A51,083647,Miranda; Gregory Joseph,37,0,37,0
1650423938592,CSE 8A,A50,083650,Miranda; Gregory Joseph,0,28,40,40
1650423944626,CSE 11,A01,083080,Cao; Yingjun,0,91,40,40
1650423950660,CSE 12,A01,083652,Staff,0,16,100,100
1650423956687,CSE 15L,A01,083654,Staff,0,1,50,50
1650423956687,CSE 15L,A02,083655,Staff,2,0,50,48
1650423962711,CSE 20,A01,083657,Staff,51,0,80,29
1650423968738,CSE 30,A01,083084,Eldon; John,0,76,40,40
1650423974763,CSE 100,A01,083659,Cao; Yingjun,0,66,50,50
1650423980789,CSE 134B,A01,083661,Powell; Thomas Allan,1,33,65,64
1650423986823,CSE 140,A01,083663,Staff,0,2,75,75
1650423992844,CSE 140L,A01,083088,Eldon; John,0,8,75,75
1650423998872,CSE 175,A01,083665,Kumar; Rakesh,7,0,25,18
1650424004909,CSE 190,A00,092507,Dubnov; Shlomo,14,0,20,6
1650424010933,ECE 45,A01,083139,Staff,0,17,40,40
1650424016969,ECE 65,A50,083695,Staff,0,5,30,30
1650424022992,ECE 109,A01,091882,Touri; Behrouz,39,0,70,31
1650424029016,ECE 180,A00,083140,Abi Samra; Nicholas Camill,23,0,30,7
1650424029016,ECE 180,B00,083141,Abi Samra; Nicholas Camill,0,0,30,30
1650424035047,MATH 10A,A01,083735,Patchell; Gregory David,7,0,30,23
1650424035047,MATH 10A,A02,083736,Patchell; Gregory David,28,0,30,2
1650424035047,MATH 10A,A03,083737,Patchell; Gregory David,25,0,30,5
1650424041072,MATH 10B,A01,083207,Staff,0,7,30,30
1650424041072,MATH 10B,A02,083208,Staff,0,7,30,30
1650424041072,MATH 10B,B01,083739,Staff,14,0,30,16
1650424041072,MATH 10B,B02,083740,Staff,28,0,30,2
1650424047110,MATH 18,A01,083743,Staff,2,0,30,28
1650424047110,MATH 18,A02,083744,Staff,27,0,30,3
1650424047110,MATH 18,A03,083745,Staff,22,0,30,8
1650424047110,MATH 18,A04,083746,Staff,26,0,30,4
1650424047110,MATH 18,B01,083748,Staff,1,12,30,29
1650424047110,MATH 18,B02,083749,Staff,0,12,30,30
1650424047110,MATH 18,B03,083750,Staff,1,12,30,29
1650424047110,MATH 18,B04,083751,Staff,0,12,30,30
1650424053145,MATH 20A,A01,083754,Staff,26,0,40,14
1650424059169,MATH 20B,A01,083756,Staff,0,10,30,30
1650424059169,MATH 20B,A02,083757,Staff,0,9,30,30
1650424065194,MATH 20C,A01,083760,Staff,0,14,30,30
1650424065194,MATH 20C,A02,083761,Staff,1,15,30,29
1650424065194,MATH 20C,B01,083762,Staff,13,0,30,17
1650424065194,MATH 20C,B02,083763,Staff,28,0,30,2
1650424071221,MATH 20D,A01,083765,Staff,0,1,30,30
1650424071221,MATH 20D,A02,083766,Staff,7,0,30,23
1650424071221,MATH 20D,A03,083767,Staff,26,0,30,4
1650424077249,MATH 20E,A01,083771,Staff,5,0,30,25
1650424077249,MATH 20E,A02,083772,Staff,18,0,30,12
1650424077249,MATH 20E,B01,083773,Staff,0,0,30,30
1650424077249,MATH 20E,B02,083774,Staff,12,0,30,18
1650424083273,MATH 103A,A01,083777,Staff,0,11,30,30
1650424083273,MATH 103A,A02,083778,Staff,0,12,30,30
1650424083273,MATH 103A,B01,083779,Staff,0,13,30,30
1650424083273,MATH 103A,B02,083780,Staff,0,11,30,30
1650424089297,MATH 105,A01,085443,Staff,0,22,30,30
1650424095322,MATH 109,A01,083213,Anzaldo; Leesa B,0,7,30,30
1650424095322,MATH 109,A02,083214,Anzaldo; Leesa B,0,7,30,30
1650424095322,MATH 109,B01,083215,Anzaldo; Leesa B,0,5,30,30
1650424095322,MATH 109,B02,083216,Anzaldo; Leesa B,0,6,30,30
1650424101351,MATH 142A,A01,083219,Chow; Bennett,0,14,30,30
1650424101351,MATH 142A,A02,083220,Chow; Bennett,0,13,30,30
1650424101351,MATH 142A,B01,083221,Chow; Bennett,0,12,30,30
1650424101351,MATH 142A,B02,083222,Chow; Bennett,0,13,30,30
1650424107385,MATH 193A,A01,083224,Staff,0,5,30,30
1650424107385,MATH 193A,A02,083225,Staff,0,5,30,30
1650424107385,MATH 193A,A03,083781,Staff,0,4,30,30
1650424107385,MATH 193A,A04,083782,Staff,0,4,30,30
1650424113484,MATH 197,001,091859,McAuley; Julian John,9998,0,9999,1
1650424119562,COGS 9,A01,083615,Staff,0,14,60,60
1650424125585,COGS 11,A01,083617,Boyle; Mary E. T.,21,0,40,19
1650424131606,COGS 13,A01,083071,Staff,0,34,40,40
1650424137628,COGS 14A,A01,092681,Staff,0,25,100,100
1650424143655,COGS 14B,A01,083073,Cheng; Tzu-Han,0,11,50,50
1650424149681,COGS 17,A01,092677,Staff,23,0,75,52
1650424155705,COGS 100,A01,083619,Staff,0,26,60,60
1650424161730,COGS 101A,A01,083621,Davis; Joshua Daniel,0,21,60,60
1650424167755,COGS 101B,A01,091572,Staff,0,4,60,60
1650424173788,COGS 101C,A01,083625,Delgado; Tania,16,0,30,14
1650424179809,COGS 107A,A01,083627,Boyle; Mary E. T.,0,11,60,60
1650424185833,COGS 118A,A01,083075,Staff,2,0,60,58
1650424191858,CSE 3,A50,083646,Miranda; Gregory Joseph,21,0,38,17
1650424191858,CSE 3,A51,083647,Miranda; Gregory Joseph,37,0,37,0
1650424197883,CSE 8A,A50,083650,Miranda; Gregory Joseph,0,28,40,40
1650424203905,CSE 11,A01,083080,Cao; Yingjun,0,91,40,40
1650424209929,CSE 12,A01,083652,Staff,0,16,100,100
1650424215954,CSE 15L,A01,083654,Staff,0,1,50,50
1650424215954,CSE 15L,A02,083655,Staff,2,0,50,48
1650424221989,CSE 20,A01,083657,Staff,51,0,80,29
1650424228012,CSE 30,A01,083084,Eldon; John,0,76,40,40
1650424234036,CSE 100,A01,083659,Cao; Yingjun,0,66,50,50
1650424240059,CSE 134B,A01,083661,Powell; Thomas Allan,1,33,65,64
1650424246083,CSE 140,A01,083663,Staff,0,2,75,75
1650424252110,CSE 140L,A01,083088,Eldon; John,0,8,75,75
1650424258144,CSE 175,A01,083665,Kumar; Rakesh,7,0,25,18
1650424264178,CSE 190,A00,092507,Dubnov; Shlomo,14,0,20,6
1650424270213,ECE 45,A01,083139,Staff,0,17,40,40
1650424276240,ECE 65,A50,083695,Staff,0,5,30,30
1650424282267,ECE 109,A01,091882,Touri; Behrouz,39,0,70,31
1650424288293,ECE 180,A00,083140,Abi Samra; Nicholas Camill,23,0,30,7
1650424288293,ECE 180,B00,083141,Abi Samra; Nicholas Camill,0,0,30,30
1650424294337,MATH 10A,A01,083735,Patchell; Gregory David,7,0,30,23
1650424294337,MATH 10A,A02,083736,Patchell; Gregory David,28,0,30,2
1650424294337,MATH 10A,A03,083737,Patchell; Gregory David,25,0,30,5
1650424300361,MATH 10B,A01,083207,Staff,0,7,30,30
1650424300361,MATH 10B,A02,083208,Staff,0,7,30,30
1650424300361,MATH 10B,B01,083739,Staff,14,0,30,16
1650424300361,MATH 10B,B02,083740,Staff,28,0,30,2
1650424306390,MATH 18,A01,083743,Staff,2,0,30,28
1650424306390,MATH 18,A02,083744,Staff,27,0,30,3
1650424306390,MATH 18,A03,083745,Staff,22,0,30,8
1650424306390,MATH 18,A04,083746,Staff,26,0,30,4
1650424306390,MATH 18,B01,083748,Staff,1,12,30,29
1650424306390,MATH 18,B02,083749,Staff,0,12,30,30
1650424306390,MATH 18,B03,083750,Staff,1,12,30,29
1650424306390,MATH 18,B04,083751,Staff,0,12,30,30
1650424312414,MATH 20A,A01,083754,Staff,26,0,40,14
1650424318442,MATH 20B,A01,083756,Staff,0,10,30,30
1650424318442,MATH 20B,A02,083757,Staff,0,9,30,30
1650424324466,MATH 20C,A01,083760,Staff,0,14,30,30
1650424324466,MATH 20C,A02,083761,Staff,1,15,30,29
1650424324466,MATH 20C,B01,083762,Staff,13,0,30,17
1650424324466,MATH 20C,B02,083763,Staff,28,0,30,2
1650424330490,MATH 20D,A01,083765,Staff,0,1,30,30
1650424330490,MATH 20D,A02,083766,Staff,7,0,30,23
1650424330490,MATH 20D,A03,083767,Staff,26,0,30,4
1650424336518,MATH 20E,A01,083771,Staff,5,0,30,25
1650424336518,MATH 20E,A02,083772,Staff,18,0,30,12
1650424336518,MATH 20E,B01,083773,Staff,0,0,30,30
1650424336518,MATH 20E,B02,083774,Staff,12,0,30,18
1650424342542,MATH 103A,A01,083777,Staff,0,12,30,30
1650424342542,MATH 103A,A02,083778,Staff,0,12,30,30
1650424342542,MATH 103A,B01,083779,Staff,0,13,30,30
1650424342542,MATH 103A,B02,083780,Staff,0,11,30,30
1650424348569,MATH 105,A01,085443,Staff,0,22,30,30
1650424354598,MATH 109,A01,083213,Anzaldo; Leesa B,0,7,30,30
1650424354598,MATH 109,A02,083214,Anzaldo; Leesa B,0,7,30,30
1650424354598,MATH 109,B01,083215,Anzaldo; Leesa B,0,5,30,30
1650424354598,MATH 109,B02,083216,Anzaldo; Leesa B,0,6,30,30
1650424360630,MATH 142A,A01,083219,Chow; Bennett,0,14,30,30
1650424360630,MATH 142A,A02,083220,Chow; Bennett,0,13,30,30
1650424360630,MATH 142A,B01,083221,Chow; Bennett,0,12,30,30
1650424360630,MATH 142A,B02,083222,Chow; Bennett,0,13,30,30
1650424366654,MATH 193A,A01,083224,Staff,0,5,30,30
1650424366654,MATH 193A,A02,083225,Staff,0,5,30,30
1650424366654,MATH 193A,A03,083781,Staff,0,4,30,30
1650424366654,MATH 193A,A04,083782,Staff,0,4,30,30
1650424372678,MATH 197,001,091859,McAuley; Julian John,9998,0,9999,1
1650424378737,COGS 9,A01,083615,Staff,0,14,60,60
1650424384766,COGS 11,A01,083617,Boyle; Mary E. T.,21,0,40,19
1650424390792,COGS 13,A01,083071,Staff,0,34,40,40
1650424396819,COGS 14A,A01,092681,Staff,0,25,100,100
1650424402844,COGS 14B,A01,083073,Cheng; Tzu-Han,0,11,50,50
1650424408871,COGS 17,A01,092677,Staff,23,0,75,52
1650424414898,COGS 100,A01,083619,Staff,0,26,60,60
1650424420939,COGS 101A,A01,083621,Davis; Joshua Daniel,0,21,60,60
1650424426964,COGS 101B,A01,091572,Staff,0,4,60,60
1650424432990,COGS 101C,A01,083625,Delgado; Tania,16,0,30,14
1650424439017,COGS 107A,A01,083627,Boyle; Mary E. T.,0,11,60,60
1650424445054,COGS 118A,A01,083075,Staff,2,0,60,58
1650424451087,CSE 3,A50,083646,Miranda; Gregory Joseph,21,0,38,17
1650424451087,CSE 3,A51,083647,Miranda; Gregory Joseph,37,0,37,0
1650424457114,CSE 8A,A50,083650,Miranda; Gregory Joseph,0,28,40,40
1650424463136,CSE 11,A01,083080,Cao; Yingjun,0,91,40,40
1650424469162,CSE 12,A01,083652,Staff,0,16,100,100
1650424475199,CSE 15L,A01,083654,Staff,0,1,50,50
1650424475199,CSE 15L,A02,083655,Staff,2,0,50,48
1650424481225,CSE 20,A01,083657,Staff,51,0,80,29
1650424487249,CSE 30,A01,083084,Eldon; John,0,76,40,40
1650424493273,CSE 100,A01,083659,Cao; Yingjun,0,66,50,50
1650424499296,CSE 134B,A01,083661,Powell; Thomas Allan,1,33,65,64
1650424505323,CSE 140,A01,083663,Staff,0,2,75,75
1650424511346,CSE 140L,A01,083088,Eldon; John,0,8,75,75
1650424517368,CSE 175,A01,083665,Kumar; Rakesh,7,0,25,18
1650424523394,CSE 190,A00,092507,Dubnov; Shlomo,14,0,20,6
1650424529421,ECE 45,A01,083139,Staff,0,17,40,40
1650424535455,ECE 65,A50,083695,Staff,0,5,30,30
1650424541496,ECE 109,A01,091882,Touri; Behrouz,39,0,70,31
1650424547520,ECE 180,A00,083140,Abi Samra; Nicholas Camill,23,0,30,7
1650424547520,ECE 180,B00,083141,Abi Samra; Nicholas Camill,0,0,30,30
1650424553545,MATH 10A,A01,083735,Patchell; Gregory David,7,0,30,23
1650424553545,MATH 10A,A02,083736,Patchell; Gregory David,28,0,30,2
1650424553545,MATH 10A,A03,083737,Patchell; Gregory David,25,0,30,5
1650424559572,MATH 10B,A01,083207,Staff,0,7,30,30
1650424559572,MATH 10B,A02,083208,Staff,0,7,30,30
1650424559572,MATH 10B,B01,083739,Staff,14,0,30,16
1650424559572,MATH 10B,B02,083740,Staff,28,0,30,2
1650424565601,MATH 18,A01,083743,Staff,2,0,30,28
1650424565601,MATH 18,A02,083744,Staff,27,0,30,3
1650424565601,MATH 18,A03,083745,Staff,22,0,30,8
1650424565601,MATH 18,A04,083746,Staff,26,0,30,4
1650424565601,MATH 18,B01,083748,Staff,1,12,30,29
1650424565601,MATH 18,B02,083749,Staff,0,12,30,30
1650424565601,MATH 18,B03,083750,Staff,1,12,30,29
1650424565601,MATH 18,B04,083751,Staff,0,12,30,30
1650424571632,MATH 20A,A01,083754,Staff,26,0,40,14
1650424577655,MATH 20B,A01,083756,Staff,0,10,30,30
1650424577655,MATH 20B,A02,083757,Staff,0,10,30,30
1650424583696,MATH 20C,A01,083760,Staff,0,14,30,30
1650424583696,MATH 20C,A02,083761,Staff,1,15,30,29
1650424583696,MATH 20C,B01,083762,Staff,13,0,30,17
1650424583696,MATH 20C,B02,083763,Staff,28,0,30,2
1650424589724,MATH 20D,A01,083765,Staff,0,1,30,30
1650424589724,MATH 20D,A02,083766,Staff,7,0,30,23
1650424589724,MATH 20D,A03,083767,Staff,26,0,30,4
1650424595764,MATH 20E,A01,083771,Staff,5,0,30,25
1650424595764,MATH 20E,A02,083772,Staff,18,0,30,12
1650424595764,MATH 20E,B01,083773,Staff,0,0,30,30
1650424595764,MATH 20E,B02,083774,Staff,12,0,30,18
1650424601798,MATH 103A,A01,083777,Staff,0,12,30,30
1650424601798,MATH 103A,A02,083778,Staff,0,12,30,30
1650424601798,MATH 103A,B01,083779,Staff,0,13,30,30
1650424601798,MATH 103A,B02,083780,Staff,0,11,30,30
1650424607820,MATH 105,A01,085443,Staff,0,22,30,30
1650424613846,MATH 109,A01,083213,Anzaldo; Leesa B,0,7,30,30
1650424613846,MATH 109,A02,083214,Anzaldo; Leesa B,0,7,30,30
1650424613846,MATH 109,B01,083215,Anzaldo; Leesa B,0,5,30,30
1650424613846,MATH 109,B02,083216,Anzaldo; Leesa B,0,6,30,30
1650424619878,MATH 142A,A01,083219,Chow; Bennett,0,14,30,30
1650424619878,MATH 142A,A02,083220,Chow; Bennett,0,13,30,30
1650424619878,MATH 142A,B01,083221,Chow; Bennett,0,12,30,30
1650424619878,MATH 142A,B02,083222,Chow; Bennett,0,13,30,30
1650424625906,MATH 193A,A01,083224,Staff,0,5,30,30
1650424625906,MATH 193A,A02,083225,Staff,0,5,30,30
1650424625906,MATH 193A,A03,083781,Staff,0,4,30,30
1650424625906,MATH 193A,A04,083782,Staff,0,4,30,30
1650424631929,MATH 197,001,091859,McAuley; Julian John,9998,0,9999,1
1650424637980,COGS 9,A01,083615,Staff,0,14,60,60
1650424644011,COGS 11,A01,083617,Boyle; Mary E. T.,21,0,40,19
1650424650035,COGS 13,A01,083071,Staff,0,34,40,40
1650424656060,COGS 14A,A01,092681,Staff,0,25,100,100
1650424662098,COGS 14B,A01,083073,Cheng; Tzu-Han,0,11,50,50
1650424668123,COGS 17,A01,092677,Staff,22,0,75,53
1650424674150,COGS 100,A01,083619,Staff,0,26,60,60
1650424680177,COGS 101A,A01,083621,Davis; Joshua Daniel,0,21,60,60
1650424686199,COGS 101B,A01,091572,Staff,0,4,60,60
1650424692227,COGS 101C,A01,083625,Delgado; Tania,16,0,30,14
1650424698260,COGS 107A,A01,083627,Boyle; Mary E. T.,0,11,60,60
1650424704375,COGS 118A,A01,083075,Staff,2,0,60,58
1650424710403,CSE 3,A50,083646,Miranda; Gregory Joseph,21,0,38,17
1650424710403,CSE 3,A51,083647,Miranda; Gregory Joseph,37,0,37,0
1650424716433,CSE 8A,A50,083650,Miranda; Gregory Joseph,0,28,40,40
1650424722456,CSE 11,A01,083080,Cao; Yingjun,0,91,40,40
1650424728482,CSE 12,A01,083652,Staff,0,16,100,100
1650424734505,CSE 15L,A01,083654,Staff,0,1,50,50
1650424734505,CSE 15L,A02,083655,Staff,2,0,50,48
1650424740528,CSE 20,A01,083657,Staff,51,0,80,29
1650424746552,CSE 30,A01,083084,Eldon; John,0,76,40,40
1650424752573,CSE 100,A01,083659,Cao; Yingjun,0,66,50,50
1650424758597,CSE 134B,A01,083661,Powell; Thomas Allan,1,33,65,64
1650424764620,CSE 140,A01,083663,Staff,0,2,75,75
1650424770643,CSE 140L,A01,083088,Eldon; John,0,8,75,75
1650424776670,CSE 175,A01,083665,Kumar; Rakesh,7,0,25,18
1650424782695,CSE 190,A00,092507,Dubnov; Shlomo,14,0,20,6
1650424788717,ECE 45,A01,083139,Staff,0,17,40,40
1650424794741,ECE 65,A50,083695,Staff,0,5,30,30
1650424800771,ECE 109,A01,091882,Touri; Behrouz,39,0,70,31
1650424806795,ECE 180,A00,083140,Abi Samra; Nicholas Camill,23,0,30,7
1650424806795,ECE 180,B00,083141,Abi Samra; Nicholas Camill,0,0,30,30
1650424812817,MATH 10A,A01,083735,Patchell; Gregory David,7,0,30,23
1650424812817,MATH 10A,A02,083736,Patchell; Gregory David,28,0,30,2
1650424812817,MATH 10A,A03,083737,Patchell; Gregory David,25,0,30,5
1650424818842,MATH 10B,A01,083207,Staff,0,7,30,30
1650424818842,MATH 10B,A02,083208,Staff,0,7,30,30
1650424818842,MATH 10B,B01,083739,Staff,14,0,30,16
1650424818842,MATH 10B,B02,083740,Staff,28,0,30,2
1650424824867,MATH 18,A01,083743,Staff,2,0,30,28
1650424824867,MATH 18,A02,083744,Staff,27,0,30,3
1650424824867,MATH 18,A03,083745,Staff,22,0,30,8
1650424824867,MATH 18,A04,083746,Staff,26,0,30,4
1650424824867,MATH 18,B01,083748,Staff,1,12,30,29
1650424824867,MATH 18,B02,083749,Staff,0,12,30,30
1650424824867,MATH 18,B03,083750,Staff,1,12,30,29
1650424824867,MATH 18,B04,083751,Staff,0,12,30,30
1650424830908,MATH 20A,A01,083754,Staff,26,0,40,14
1650424836937,MATH 20B,A01,083756,Staff,0,10,30,30
1650424836937,MATH 20B,A02,083757,Staff,0,10,30,30
1650424842965,MATH 20C,A01,083760,Staff,0,14,30,30
1650424842965,MATH 20C,A02,083761,Staff,1,15,30,29
1650424842965,MATH 20C,B01,083762,Staff,13,0,30,17
1650424842965,MATH 20C,B02,083763,Staff,28,0,30,2
1650424848992,MATH 20D,A01,083765,Staff,0,1,30,30
1650424848992,MATH 20D,A02,083766,Staff,7,0,30,23
1650424848992,MATH 20D,A03,083767,Staff,26,0,30,4
1650424855023,MATH 20E,A01,083771,Staff,5,0,30,25
1650424855023,MATH 20E,A02,083772,Staff,18,0,30,12
1650424855023,MATH 20E,B01,083773,Staff,0,0,30,30
1650424855023,MATH 20E,B02,083774,Staff,12,0,30,18
1650424861055,MATH 103A,A01,083777,Staff,0,12,30,30
1650424861055,MATH 103A,A02,083778,Staff,0,12,30,30
1650424861055,MATH 103A,B01,083779,Staff,0,13,30,30
1650424861055,MATH 103A,B02,083780,Staff,0,11,30,30
1650424867081,MATH 105,A01,085443,Staff,0,22,30,30
1650424873105,MATH 109,A01,083213,Anzaldo; Leesa B,0,7,30,30
1650424873105,MATH 109,A02,083214,Anzaldo; Leesa B,0,7,30,30
1650424873105,MATH 109,B01,083215,Anzaldo; Leesa B,0,5,30,30
1650424873105,MATH 109,B02,083216,Anzaldo; Leesa B,0,6,30,30
1650424879130,MATH 142A,A01,083219,Chow; Bennett,0,14,30,30
1650424879130,MATH 142A,A02,083220,Chow; Bennett,0,13,30,30
1650424879130,MATH 142A,B01,083221,Chow; Bennett,0,12,30,30
1650424879130,MATH 142A,B02,083222,Chow; Bennett,0,13,30,30
1650424885155,MATH 193A,A01,083224,Staff,0,5,30,30
1650424885155,MATH 193A,A02,083225,Staff,0,5,30,30
1650424885155,MATH 193A,A03,083781,Staff,0,4,30,30
1650424885155,MATH 193A,A04,083782,Staff,0,4,30,30
1650424891180,MATH 197,001,091859,McAuley; Julian John,9998,0,9999,1
1650424897263,COGS 9,A01,083615,Staff,0,14,60,60
1650424903292,COGS 11,A01,083617,Boyle; Mary E. T.,21,0,40,19
1650424909316,COGS 13,A01,083071,Staff,0,34,40,40
1650424915344,COGS 14A,A01,092681,Staff,0,25,100,100
1650424921374,COGS 14B,A01,083073,Cheng; Tzu-Han,0,11,50,50
1650424927398,COGS 17,A01,092677,Staff,22,0,75,53
1650424933428,COGS 100,A01,083619,Staff,0,26,60,60
1650424939455,COGS 101A,A01,083621,Davis; Joshua Daniel,0,21,60,60
1650424945481,COGS 101B,A01,091572,Staff,0,4,60,60
1650424951503,COGS 101C,A01,083625,Delgado; Tania,16,0,30,14
1650424957527,COGS 107A,A01,083627,Boyle; Mary E. T.,0,11,60,60
1650424963562,COGS 118A,A01,083075,Staff,2,0,60,58
1650424969586,CSE 3,A50,083646,Miranda; Gregory Joseph,21,0,38,17
1650424969586,CSE 3,A51,083647,Miranda; Gregory Joseph,37,0,37,0
1650424975613,CSE 8A,A50,083650,Miranda; Gregory Joseph,0,28,40,40
1650424981641,CSE 11,A01,083080,Cao; Yingjun,0,91,40,40
1650424987664,CSE 12,A01,083652,Staff,0,16,100,100
1650424993691,CSE 15L,A01,083654,Staff,0,1,50,50
1650424993691,CSE 15L,A02,083655,Staff,2,0,50,48
1650424999717,CSE 20,A01,083657,Staff,51,0,80,29
1650425005756,CSE 30,A01,083084,Eldon; John,0,76,40,40
1650425011777,CSE 100,A01,083659,Cao; Yingjun,0,66,50,50
1650425017808,CSE 134B,A01,083661,Powell; Thomas Allan,1,33,65,64
1650425023831,CSE 140,A01,083663,Staff,0,2,75,75
1650425029854,CSE 140L,A01,083088,Eldon; John,0,8,75,75
1650425035886,CSE 175,A01,083665,Kumar; Rakesh,7,0,25,18
1650425041913,CSE 190,A00,092507,Dubnov; Shlomo,14,0,20,6
1650425047940,ECE 45,A01,083139,Staff,0,17,40,40
1650425053964,ECE 65,A50,083695,Staff,0,5,30,30
1650425059988,ECE 109,A01,091882,Touri; Behrouz,39,0,70,31
1650425066011,ECE 180,A00,083140,Abi Samra; Nicholas Camill,23,0,30,7
1650425066011,ECE 180,B00,083141,Abi Samra; Nicholas Camill,0,0,30,30
1650425072040,MATH 10A,A01,083735,Patchell; Gregory David,7,0,30,23
1650425072040,MATH 10A,A02,083736,Patchell; Gregory David,28,0,30,2
1650425072040,MATH 10A,A03,083737,Patchell; Gregory David,25,0,30,5
1650425078068,MATH 10B,A01,083207,Staff,0,7,30,30
1650425078068,MATH 10B,A02,083208,Staff,0,7,30,30
1650425078068,MATH 10B,B01,083739,Staff,14,0,30,16
1650425078068,MATH 10B,B02,083740,Staff,28,0,30,2
1650425084097,MATH 18,A01,083743,Staff,2,0,30,28
1650425084097,MATH 18,A02,083744,Staff,27,0,30,3
1650425084097,MATH 18,A03,083745,Staff,22,0,30,8
1650425084097,MATH 18,A04,083746,Staff,26,0,30,4
1650425084097,MATH 18,B01,083748,Staff,1,12,30,29
1650425084097,MATH 18,B02,083749,Staff,0,12,30,30
1650425084097,MATH 18,B03,083750,Staff,1,12,30,29
1650425084097,MATH 18,B04,083751,Staff,0,12,30,30
1650425090120,MATH 20A,A01,083754,Staff,26,0,40,14
1650425096154,MATH 20B,A01,083756,Staff,0,10,30,30
1650425096154,MATH 20B,A02,083757,Staff,0,10,30,30
1650425102179,MATH 20C,A01,083760,Staff,0,14,30,30
1650425102179,MATH 20C,A02,083761,Staff,1,15,30,29
1650425102179,MATH 20C,B01,083762,Staff,13,0,30,17
1650425102179,MATH 20C,B02,083763,Staff,28,0,30,2
1650425108209,MATH 20D,A01,083765,Staff,0,1,30,30
1650425108209,MATH 20D,A02,083766,Staff,7,0,30,23
1650425108209,MATH 20D,A03,083767,Staff,26,0,30,4
1650425114231,MATH 20E,A01,083771,Staff,5,0,30,25
1650425114231,MATH 20E,A02,083772,Staff,18,0,30,12
1650425114231,MATH 20E,B01,083773,Staff,0,0,30,30
1650425114231,MATH 20E,B02,083774,Staff,12,0,30,18
1650425120254,MATH 103A,A01,083777,Staff,0,12,30,30
1650425120254,MATH 103A,A02,083778,Staff,0,12,30,30
1650425120254,MATH 103A,B01,083779,Staff,0,13,30,30
1650425120254,MATH 103A,B02,083780,Staff,0,11,30,30
1650425126298,MATH 105,A01,085443,Staff,0,22,30,30
1650425132322,MATH 109,A01,083213,Anzaldo; Leesa B,0,7,30,30
1650425132322,MATH 109,A02,083214,Anzaldo; Leesa B,0,7,30,30
1650425132322,MATH 109,B01,083215,Anzaldo; Leesa B,0,5,30,30
1650425132322,MATH 109,B02,083216,Anzaldo; Leesa B,0,6,30,30
1650425138348,MATH 142A,A01,083219,Chow; Bennett,0,14,30,30
1650425138348,MATH 142A,A02,083220,Chow; Bennett,0,13,30,30
1650425138348,MATH 142A,B01,083221,Chow; Bennett,0,12,30,30
1650425138348,MATH 142A,B02,083222,Chow; Bennett,0,13,30,30
1650425144372,MATH 193A,A01,083224,Staff,0,5,30,30
1650425144372,MATH 193A,A02,083225,Staff,0,5,30,30
1650425144372,MATH 193A,A03,083781,Staff,0,4,30,30
1650425144372,MATH 193A,A04,083782,Staff,0,4,30,30
1650425150401,MATH 197,001,091859,McAuley; Julian John,9998,0,9999,1
1650425156455,COGS 9,A01,083615,Staff,0,14,60,60
1650425162478,COGS 11,A01,083617,Boyle; Mary E. T.,21,0,40,19
1650425168501,COGS 13,A01,083071,Staff,0,34,40,40
1650425174525,COGS 14A,A01,092681,Staff,0,25,100,100
1650425180548,COGS 14B,A01,083073,Cheng; Tzu-Han,0,11,50,50
1650425186576,COGS 17,A01,092677,Staff,22,0,75,53
1650425192603,COGS 100,A01,083619,Staff,0,26,60,60
1650425198631,COGS 101A,A01,083621,Davis; Joshua Daniel,0,21,60,60
1650425204659,COGS 101B,A01,091572,Staff,0,4,60,60
1650425210683,COGS 101C,A01,083625,Delgado; Tania,16,0,30,14
1650425216714,COGS 107A,A01,083627,Boyle; Mary E. T.,0,11,60,60
1650425222741,COGS 118A,A01,083075,Staff,2,0,60,58
1650425228773,CSE 3,A50,083646,Miranda; Gregory Joseph,21,0,38,17
1650425228773,CSE 3,A51,083647,Miranda; Gregory Joseph,37,0,37,0
1650425234797,CSE 8A,A50,083650,Miranda; Gregory Joseph,0,28,40,40
1650425240823,CSE 11,A01,083080,Cao; Yingjun,0,91,40,40
1650425246847,CSE 12,A01,083652,Staff,0,16,100,100
1650425252876,CSE 15L,A01,083654,Staff,0,1,50,50
1650425252876,CSE 15L,A02,083655,Staff,2,0,50,48
1650425258899,CSE 20,A01,083657,Staff,51,0,80,29
1650425264923,CSE 30,A01,083084,Eldon; John,0,76,40,40
1650425270948,CSE 100,A01,083659,Cao; Yingjun,0,66,50,50
1650425276969,CSE 134B,A01,083661,Powell; Thomas Allan,1,33,65,64
1650425282997,CSE 140,A01,083663,Staff,0,2,75,75
1650425289021,CSE 140L,A01,083088,Eldon; John,0,8,75,75
1650425295044,CSE 175,A01,083665,Kumar; Rakesh,7,0,25,18
1650425301159,CSE 190,A00,092507,Dubnov; Shlomo,14,0,20,6
1650425307183,ECE 45,A01,083139,Staff,0,17,40,40
1650425313206,ECE 65,A50,083695,Staff,0,5,30,30
1650425319232,ECE 109,A01,091882,Touri; Behrouz,39,0,70,31
1650425325266,ECE 180,A00,083140,Abi Samra; Nicholas Camill,23,0,30,7
1650425325266,ECE 180,B00,083141,Abi Samra; Nicholas Camill,0,0,30,30
1650425331297,MATH 10A,A01,083735,Patchell; Gregory David,7,0,30,23
1650425331297,MATH 10A,A02,083736,Patchell; Gregory David,28,0,30,2
1650425331297,MATH 10A,A03,083737,Patchell; Gregory David,25,0,30,5
1650425337326,MATH 10B,A01,083207,Staff,0,7,30,30
1650425337326,MATH 10B,A02,083208,Staff,0,7,30,30
1650425337326,MATH 10B,B01,083739,Staff,14,0,30,16
1650425337326,MATH 10B,B02,083740,Staff,28,0,30,2
1650425343356,MATH 18,A01,083743,Staff,2,0,30,28
1650425343356,MATH 18,A02,083744,Staff,27,0,30,3
1650425343356,MATH 18,A03,083745,Staff,22,0,30,8
1650425343356,MATH 18,A04,083746,Staff,26,0,30,4
1650425343356,MATH 18,B01,083748,Staff,1,12,30,29
1650425343356,MATH 18,B02,083749,Staff,0,12,30,30
1650425343356,MATH 18,B03,083750,Staff,1,12,30,29
1650425343356,MATH 18,B04,083751,Staff,0,12,30,30
1650425349395,MATH 20A,A01,083754,Staff,26,0,40,14
1650425355429,MATH 20B,A01,083756,Staff,0,10,30,30
1650425355429,MATH 20B,A02,083757,Staff,0,10,30,30
1650425361451,MATH 20C,A01,083760,Staff,0,14,30,30
1650425361451,MATH 20C,A02,083761,Staff,1,15,30,29
1650425361451,MATH 20C,B01,083762,Staff,13,0,30,17
1650425361451,MATH 20C,B02,083763,Staff,28,0,30,2
1650425367474,MATH 20D,A01,083765,Staff,0,1,30,30
1650425367474,MATH 20D,A02,083766,Staff,7,0,30,23
1650425367474,MATH 20D,A03,083767,Staff,26,0,30,4
1650425373497,MATH 20E,A01,083771,Staff,5,0,30,25
1650425373497,MATH 20E,A02,083772,Staff,18,0,30,12
1650425373497,MATH 20E,B01,083773,Staff,0,0,30,30
1650425373497,MATH 20E,B02,083774,Staff,12,0,30,18
1650425379527,MATH 103A,A01,083777,Staff,0,12,30,30
1650425379527,MATH 103A,A02,083778,Staff,0,12,30,30
1650425379527,MATH 103A,B01,083779,Staff,0,13,30,30
1650425379527,MATH 103A,B02,083780,Staff,0,11,30,30
1650425385549,MATH 105,A01,085443,Staff,0,22,30,30
1650425391576,MATH 109,A01,083213,Anzaldo; Leesa B,0,7,30,30
1650425391576,MATH 109,A02,083214,Anzaldo; Leesa B,0,7,30,30
1650425391576,MATH 109,B01,083215,Anzaldo; Leesa B,0,5,30,30
1650425391576,MATH 109,B02,083216,Anzaldo; Leesa B,0,6,30,30
1650425397597,MATH 142A,A01,083219,Chow; Bennett,0,14,30,30
1650425397597,MATH 142A,A02,083220,Chow; Bennett,0,13,30,30
1650425397597,MATH 142A,B01,083221,Chow; Bennett,0,12,30,30
1650425397597,MATH 142A,B02,083222,Chow; Bennett,0,13,30,30
1650425403627,MATH 193A,A01,083224,Staff,0,5,30,30
1650425403627,MATH 193A,A02,083225,Staff,0,5,30,30
1650425403627,MATH 193A,A03,083781,Staff,0,4,30,30
1650425403627,MATH 193A,A04,083782,Staff,0,4,30,30
1650425409649,MATH 197,001,091859,McAuley; Julian John,9998,0,9999,1
1650425415699,COGS 9,A01,083615,Staff,0,14,60,60
1650425421722,COGS 11,A01,083617,Boyle; Mary E. T.,21,0,40,19
1650425427746,COGS 13,A01,083071,Staff,0,34,40,40
1650425433788,COGS 14A,A01,092681,Staff,0,25,100,100
1650425439816,COGS 14B,A01,083073,Cheng; Tzu-Han,0,11,50,50
1650425445842,COGS 17,A01,092677,Staff,22,0,75,53
1650425451873,COGS 100,A01,083619,Staff,0,26,60,60
1650425457912,COGS 101A,A01,083621,Davis; Joshua Daniel,0,21,60,60
1650425463955,COGS 101B,A01,091572,Staff,0,4,60,60
1650425469981,COGS 101C,A01,083625,Delgado; Tania,16,0,30,14
1650425476010,COGS 107A,A01,083627,Boyle; Mary E. T.,0,11,60,60
1650425482036,COGS 118A,A01,083075,Staff,2,0,60,58
1650425488059,CSE 3,A50,083646,Miranda; Gregory Joseph,21,0,38,17
1650425488059,CSE 3,A51,083647,Miranda; Gregory Joseph,37,0,37,0
1650425494086,CSE 8A,A50,083650,Miranda; Gregory Joseph,0,28,40,40
1650425500114,CSE 11,A01,083080,Cao; Yingjun,0,91,40,40
1650425506141,CSE 12,A01,083652,Staff,0,16,100,100
1650425512166,CSE 15L,A01,083654,Staff,0,1,50,50
1650425512166,CSE 15L,A02,083655,Staff,2,0,50,48
1650425518191,CSE 20,A01,083657,Staff,51,0,80,29
1650425524218,CSE 30,A01,083084,Eldon; John,0,76,40,40
1650425530245,CSE 100,A01,083659,Cao; Yingjun,0,66,50,50
1650425536272,CSE 134B,A01,083661,Powell; Thomas Allan,1,33,65,64
1650425542300,CSE 140,A01,083663,Staff,0,2,75,75
1650425548324,CSE 140L,A01,083088,Eldon; John,0,8,75,75
1650425554348,CSE 175,A01,083665,Kumar; Rakesh,7,0,25,18
1650425560374,CSE 190,A00,092507,Dubnov; Shlomo,14,0,20,6
1650425566412,ECE 45,A01,083139,Staff,0,17,40,40
1650425572436,ECE 65,A50,083695,Staff,0,5,30,30
1650425578459,ECE 109,A01,091882,Touri; Behrouz,39,0,70,31
1650425584486,ECE 180,A00,083140,Abi Samra; Nicholas Camill,23,0,30,7
1650425584486,ECE 180,B00,083141,Abi Samra; Nicholas Camill,0,0,30,30
1650425590514,MATH 10A,A01,083735,Patchell; Gregory David,7,0,30,23
1650425590514,MATH 10A,A02,083736,Patchell; Gregory David,28,0,30,2
1650425590514,MATH 10A,A03,083737,Patchell; Gregory David,25,0,30,5
1650425596541,MATH 10B,A01,083207,Staff,0,7,30,30
1650425596541,MATH 10B,A02,083208,Staff,0,7,30,30
1650425596541,MATH 10B,B01,083739,Staff,14,0,30,16
1650425596541,MATH 10B,B02,083740,Staff,28,0,30,2
1650425602566,MATH 18,A01,083743,Staff,2,0,30,28
1650425602566,MATH 18,A02,083744,Staff,27,0,30,3
1650425602566,MATH 18,A03,083745,Staff,22,0,30,8
1650425602566,MATH 18,A04,083746,Staff,26,0,30,4
1650425602566,MATH 18,B01,083748,Staff,1,12,30,29
1650425602566,MATH 18,B02,083749,Staff,0,12,30,30
1650425602566,MATH 18,B03,083750,Staff,1,12,30,29
1650425602566,MATH 18,B04,083751,Staff,0,12,30,30
1650425608590,MATH 20A,A01,083754,Staff,26,0,40,14
1650425614616,MATH 20B,A01,083756,Staff,0,10,30,30
1650425614616,MATH 20B,A02,083757,Staff,0,10,30,30
1650425620641,MATH 20C,A01,083760,Staff,0,14,30,30
1650425620641,MATH 20C,A02,083761,Staff,1,15,30,29
1650425620641,MATH 20C,B01,083762,Staff,13,0,30,17
1650425620641,MATH 20C,B02,083763,Staff,28,0,30,2
1650425626668,MATH 20D,A01,083765,Staff,0,1,30,30
1650425626668,MATH 20D,A02,083766,Staff,7,0,30,23
1650425626668,MATH 20D,A03,083767,Staff,26,0,30,4
1650425632692,MATH 20E,A01,083771,Staff,5,0,30,25
1650425632692,MATH 20E,A02,083772,Staff,18,0,30,12
1650425632692,MATH 20E,B01,083773,Staff,0,0,30,30
1650425632692,MATH 20E,B02,083774,Staff,12,0,30,18
1650425638717,MATH 103A,A01,083777,Staff,0,12,30,30
1650425638717,MATH 103A,A02,083778,Staff,0,12,30,30
1650425638717,MATH 103A,B01,083779,Staff,0,13,30,30
1650425638717,MATH 103A,B02,083780,Staff,0,11,30,30
1650425644739,MATH 105,A01,085443,Staff,0,22,30,30
1650425650767,MATH 109,A01,083213,Anzaldo; Leesa B,0,7,30,30
1650425650767,MATH 109,A02,083214,Anzaldo; Leesa B,0,7,30,30
1650425650767,MATH 109,B01,083215,Anzaldo; Leesa B,0,5,30,30
1650425650767,MATH 109,B02,083216,Anzaldo; Leesa B,0,6,30,30
1650425656790,MATH 142A,A01,083219,Chow; Bennett,0,14,30,30
1650425656790,MATH 142A,A02,083220,Chow; Bennett,0,13,30,30
1650425656790,MATH 142A,B01,083221,Chow; Bennett,0,12,30,30
1650425656790,MATH 142A,B02,083222,Chow; Bennett,0,13,30,30
1650425662814,MATH 193A,A01,083224,Staff,0,5,30,30
1650425662814,MATH 193A,A02,083225,Staff,0,5,30,30
1650425662814,MATH 193A,A03,083781,Staff,0,4,30,30
1650425662814,MATH 193A,A04,083782,Staff,0,4,30,30
1650425668838,MATH 197,001,091859,McAuley; Julian John,9998,0,9999,1
1650425674888,COGS 9,A01,083615,Staff,0,14,60,60
1650425680910,COGS 11,A01,083617,Boyle; Mary E. T.,21,0,40,19
1650425686934,COGS 13,A01,083071,Staff,0,34,40,40
1650425692960,COGS 14A,A01,092681,Staff,0,25,100,100
1650425698987,COGS 14B,A01,083073,Cheng; Tzu-Han,0,11,50,50
1650425705014,COGS 17,A01,092677,Staff,22,0,75,53
1650425711041,COGS 100,A01,083619,Staff,0,26,60,60
1650425717064,COGS 101A,A01,083621,Davis; Joshua Daniel,0,21,60,60
1650425723088,COGS 101B,A01,091572,Staff,0,4,60,60
1650425729111,COGS 101C,A01,083625,Delgado; Tania,16,0,30,14
1650425735140,COGS 107A,A01,083627,Boyle; Mary E. T.,0,11,60,60
1650425741163,COGS 118A,A01,083075,Staff,2,0,60,58
1650425747186,CSE 3,A50,083646,Miranda; Gregory Joseph,21,0,38,17
1650425747186,CSE 3,A51,083647,Miranda; Gregory Joseph,37,0,37,0
1650425753210,CSE 8A,A50,083650,Miranda; Gregory Joseph,0,28,40,40
1650425759235,CSE 11,A01,083080,Cao; Yingjun,0,91,40,40
1650425765258,CSE 12,A01,083652,Staff,0,16,100,100
1650425771281,CSE 15L,A01,083654,Staff,0,1,50,50
1650425771281,CSE 15L,A02,083655,Staff,2,0,50,48
1650425777306,CSE 20,A01,083657,Staff,51,0,80,29
1650425783331,CSE 30,A01,083084,Eldon; John,0,76,40,40
1650425789358,CSE 100,A01,083659,Cao; Yingjun,0,66,50,50
1650425795383,CSE 134B,A01,083661,Powell; Thomas Allan,1,33,65,64
1650425801419,CSE 140,A01,083663,Staff,0,2,75,75
1650425807442,CSE 140L,A01,083088,Eldon; John,0,8,75,75
1650425813466,CSE 175,A01,083665,Kumar; Rakesh,7,0,25,18
1650425819491,CSE 190,A00,092507,Dubnov; Shlomo,14,0,20,6
1650425825513,ECE 45,A01,083139,Staff,0,17,40,40
1650425831539,ECE 65,A50,083695,Staff,0,5,30,30
1650425837567,ECE 109,A01,091882,Touri; Behrouz,39,0,70,31
1650425843591,ECE 180,A00,083140,Abi Samra; Nicholas Camill,23,0,30,7
1650425843591,ECE 180,B00,083141,Abi Samra; Nicholas Camill,0,0,30,30
1650425849618,MATH 10A,A01,083735,Patchell; Gregory David,7,0,30,23
1650425849618,MATH 10A,A02,083736,Patchell; Gregory David,28,0,30,2
1650425849618,MATH 10A,A03,083737,Patchell; Gregory David,25,0,30,5
1650425855652,MATH 10B,A01,083207,Staff,0,7,30,30
1650425855652,MATH 10B,A02,083208,Staff,0,7,30,30
1650425855652,MATH 10B,B01,083739,Staff,14,0,30,16
1650425855652,MATH 10B,B02,083740,Staff,28,0,30,2
1650425861682,MATH 18,A01,083743,Staff,2,0,30,28
1650425861682,MATH 18,A02,083744,Staff,27,0,30,3
1650425861682,MATH 18,A03,083745,Staff,22,0,30,8
1650425861682,MATH 18,A04,083746,Staff,26,0,30,4
1650425861682,MATH 18,B01,083748,Staff,1,12,30,29
1650425861682,MATH 18,B02,083749,Staff,0,12,30,30
1650425861682,MATH 18,B03,083750,Staff,1,12,30,29
1650425861682,MATH 18,B04,083751,Staff,0,12,30,30
1650425867707,MATH 20A,A01,083754,Staff,26,0,40,14
1650425873731,MATH 20B,A01,083756,Staff,0,10,30,30
1650425873731,MATH 20B,A02,083757,Staff,0,10,30,30
1650425879755,MATH 20C,A01,083760,Staff,0,14,30,30
1650425879755,MATH 20C,A02,083761,Staff,1,15,30,29
1650425879755,MATH 20C,B01,083762,Staff,13,0,30,17
1650425879755,MATH 20C,B02,083763,Staff,28,0,30,2
1650425885787,MATH 20D,A01,083765,Staff,0,1,30,30
1650425885787,MATH 20D,A02,083766,Staff,7,0,30,23
1650425885787,MATH 20D,A03,083767,Staff,26,0,30,4
1650425891812,MATH 20E,A01,083771,Staff,5,0,30,25
1650425891812,MATH 20E,A02,083772,Staff,18,0,30,12
1650425891812,MATH 20E,B01,083773,Staff,0,0,30,30
1650425891812,MATH 20E,B02,083774,Staff,12,0,30,18
1650425897931,MATH 103A,A01,083777,Staff,0,12,30,30
1650425897931,MATH 103A,A02,083778,Staff,0,12,30,30
1650425897931,MATH 103A,B01,083779,Staff,0,13,30,30
1650425897931,MATH 103A,B02,083780,Staff,0,11,30,30
1650425903955,MATH 105,A01,085443,Staff,0,22,30,30
1650425909982,MATH 109,A01,083213,Anzaldo; Leesa B,0,7,30,30
1650425909982,MATH 109,A02,083214,Anzaldo; Leesa B,0,7,30,30
1650425909982,MATH 109,B01,083215,Anzaldo; Leesa B,0,5,30,30
1650425909982,MATH 109,B02,083216,Anzaldo; Leesa B,0,6,30,30
1650425916006,MATH 142A,A01,083219,Chow; Bennett,0,14,30,30
1650425916006,MATH 142A,A02,083220,Chow; Bennett,0,13,30,30
1650425916006,MATH 142A,B01,083221,Chow; Bennett,0,12,30,30
1650425916006,MATH 142A,B02,083222,Chow; Bennett,0,13,30,30
1650425922030,MATH 193A,A01,083224,Staff,0,5,30,30
1650425922030,MATH 193A,A02,083225,Staff,0,5,30,30
1650425922030,MATH 193A,A03,083781,Staff,0,4,30,30
1650425922030,MATH 193A,A04,083782,Staff,0,4,30,30
1650425928056,MATH 197,001,091859,McAuley; Julian John,9998,0,9999,1
1650425934114,COGS 9,A01,083615,Staff,0,14,60,60
1650425940139,COGS 11,A01,083617,Boyle; Mary E. T.,21,0,40,19
1650425946164,COGS 13,A01,083071,Staff,0,34,40,40
1650425952186,COGS 14A,A01,092681,Staff,0,25,100,100
1650425958210,COGS 14B,A01,083073,Cheng; Tzu-Han,0,11,50,50
1650425964238,COGS 17,A01,092677,Staff,22,0,75,53
1650425970262,COGS 100,A01,083619,Staff,0,26,60,60
1650425976287,COGS 101A,A01,083621,Davis; Joshua Daniel,0,21,60,60
1650425982317,COGS 101B,A01,091572,Staff,0,4,60,60
1650425988339,COGS 101C,A01,083625,Delgado; Tania,16,0,30,14
1650425994363,COGS 107A,A01,083627,Boyle; Mary E. T.,0,11,60,60
1650426000386,COGS 118A,A01,083075,Staff,2,0,60,58
1650426006409,CSE 3,A50,083646,Miranda; Gregory Joseph,21,0,38,17
1650426006409,CSE 3,A51,083647,Miranda; Gregory Joseph,37,0,37,0
1650426012433,CSE 8A,A50,083650,Miranda; Gregory Joseph,0,28,40,40
1650426018458,CSE 11,A01,083080,Cao; Yingjun,0,91,40,40
1650426024486,CSE 12,A01,083652,Staff,0,16,100,100
1650426030510,CSE 15L,A01,083654,Staff,0,1,50,50
1650426030510,CSE 15L,A02,083655,Staff,2,0,50,48
1650426036533,CSE 20,A01,083657,Staff,51,0,80,29
1650426042559,CSE 30,A01,083084,Eldon; John,0,76,40,40
1650426048585,CSE 100,A01,083659,Cao; Yingjun,0,66,50,50
1650426054607,CSE 134B,A01,083661,Powell; Thomas Allan,1,33,65,64
1650426060639,CSE 140,A01,083663,Staff,0,2,75,75
1650426066666,CSE 140L,A01,083088,Eldon; John,0,8,75,75
1650426072688,CSE 175,A01,083665,Kumar; Rakesh,7,0,25,18
1650426078717,CSE 190,A00,092507,Dubnov; Shlomo,14,0,20,6
1650426084741,ECE 45,A01,083139,Staff,0,17,40,40
1650426090776,ECE 65,A50,083695,Staff,0,5,30,30
1650426096801,ECE 109,A01,091882,Touri; Behrouz,39,0,70,31
1650426102826,ECE 180,A00,083140,Abi Samra; Nicholas Camill,23,0,30,7
1650426102826,ECE 180,B00,083141,Abi Samra; Nicholas Camill,0,0,30,30
1650426108854,MATH 10A,A01,083735,Patchell; Gregory David,7,0,30,23
1650426108854,MATH 10A,A02,083736,Patchell; Gregory David,28,0,30,2
1650426108854,MATH 10A,A03,083737,Patchell; Gregory David,25,0,30,5
1650426114878,MATH 10B,A01,083207,Staff,0,7,30,30
1650426114878,MATH 10B,A02,083208,Staff,0,7,30,30
1650426114878,MATH 10B,B01,083739,Staff,14,0,30,16
1650426114878,MATH 10B,B02,083740,Staff,28,0,30,2
1650426120908,MATH 18,A01,083743,Staff,2,0,30,28
1650426120908,MATH 18,A02,083744,Staff,27,0,30,3
1650426120908,MATH 18,A03,083745,Staff,22,0,30,8
1650426120908,MATH 18,A04,083746,Staff,26,0,30,4
1650426120908,MATH 18,B01,083748,Staff,1,12,30,29
1650426120908,MATH 18,B02,083749,Staff,0,12,30,30
1650426120908,MATH 18,B03,083750,Staff,1,12,30,29
1650426120908,MATH 18,B04,083751,Staff,0,12,30,30
1650426126931,MATH 20A,A01,083754,Staff,26,0,40,14
1650426132955,MATH 20B,A01,083756,Staff,0,10,30,30
1650426132955,MATH 20B,A02,083757,Staff,0,10,30,30
1650426138979,MATH 20C,A01,083760,Staff,0,14,30,30
1650426138979,MATH 20C,A02,083761,Staff,1,15,30,29
1650426138979,MATH 20C,B01,083762,Staff,13,0,30,17
1650426138979,MATH 20C,B02,083763,Staff,28,0,30,2
1650426145007,MATH 20D,A01,083765,Staff,0,1,30,30
1650426145007,MATH 20D,A02,083766,Staff,7,0,30,23
1650426145007,MATH 20D,A03,083767,Staff,26,0,30,4
1650426151044,MATH 20E,A01,083771,Staff,5,0,30,25
1650426151044,MATH 20E,A02,083772,Staff,18,0,30,12
1650426151044,MATH 20E,B01,083773,Staff,0,0,30,30
1650426151044,MATH 20E,B02,083774,Staff,12,0,30,18
1650426157074,MATH 103A,A01,083777,Staff,0,12,30,30
1650426157074,MATH 103A,A02,083778,Staff,0,12,30,30
1650426157074,MATH 103A,B01,083779,Staff,0,13,30,30
1650426157074,MATH 103A,B02,083780,Staff,0,11,30,30
1650426163099,MATH 105,A01,085443,Staff,0,22,30,30
1650426169122,MATH 109,A01,083213,Anzaldo; Leesa B,0,7,30,30
1650426169122,MATH 109,A02,083214,Anzaldo; Leesa B,0,7,30,30
1650426169122,MATH 109,B01,083215,Anzaldo; Leesa B,0,5,30,30
1650426169122,MATH 109,B02,083216,Anzaldo; Leesa B,0,6,30,30
1650426175146,MATH 142A,A01,083219,Chow; Bennett,0,14,30,30
1650426175146,MATH 142A,A02,083220,Chow; Bennett,0,13,30,30
1650426175146,MATH 142A,B01,083221,Chow; Bennett,0,12,30,30
1650426175146,MATH 142A,B02,083222,Chow; Bennett,0,13,30,30
1650426181172,MATH 193A,A01,083224,Staff,0,5,30,30
1650426181172,MATH 193A,A02,083225,Staff,0,5,30,30
1650426181172,MATH 193A,A03,083781,Staff,0,4,30,30
1650426181172,MATH 193A,A04,083782,Staff,0,4,30,30
1650426187194,MATH 197,001,091859,McAuley; Julian John,9998,0,9999,1
1650426193256,COGS 9,A01,083615,Staff,0,14,60,60
1650426199281,COGS 11,A01,083617,Boyle; Mary E. T.,21,0,40,19
1650426205305,COGS 13,A01,083071,Staff,0,34,40,40
1650426211329,COGS 14A,A01,092681,Staff,0,25,100,100
1650426217352,COGS 14B,A01,083073,Cheng; Tzu-Han,0,11,50,50
1650426223376,COGS 17,A01,092677,Staff,22,0,75,53
1650426229402,COGS 100,A01,083619,Staff,0,26,60,60
1650426235435,COGS 101A,A01,083621,Davis; Joshua Daniel,0,21,60,60
1650426241459,COGS 101B,A01,091572,Staff,0,4,60,60
1650426247483,COGS 101C,A01,083625,Delgado; Tania,16,0,30,14
1650426253510,COGS 107A,A01,083627,Boyle; Mary E. T.,0,11,60,60
1650426259532,COGS 118A,A01,083075,Staff,2,0,60,58
1650426265556,CSE 3,A50,083646,Miranda; Gregory Joseph,21,0,38,17
1650426265556,CSE 3,A51,083647,Miranda; Gregory Joseph,37,0,37,0
1650426271583,CSE 8A,A50,083650,Miranda; Gregory Joseph,0,28,40,40
1650426277608,CSE 11,A01,083080,Cao; Yingjun,0,91,40,40
1650426283631,CSE 12,A01,083652,Staff,0,16,100,100
1650426289659,CSE 15L,A01,083654,Staff,0,1,50,50
1650426289659,CSE 15L,A02,083655,Staff,2,0,50,48
1650426295684,CSE 20,A01,083657,Staff,51,0,80,29
1650426301707,CSE 30,A01,083084,Eldon; John,0,76,40,40
1650426307733,CSE 100,A01,083659,Cao; Yingjun,0,66,50,50
1650426313756,CSE 134B,A01,083661,Powell; Thomas Allan,1,33,65,64
1650426319780,CSE 140,A01,083663,Staff,0,2,75,75
1650426325807,CSE 140L,A01,083088,Eldon; John,0,8,75,75
1650426331834,CSE 175,A01,083665,Kumar; Rakesh,7,0,25,18
1650426337861,CSE 190,A00,092507,Dubnov; Shlomo,14,0,20,6
1650426343885,ECE 45,A01,083139,Staff,0,17,40,40
1650426349909,ECE 65,A50,083695,Staff,0,5,30,30
1650426355933,ECE 109,A01,091882,Touri; Behrouz,39,0,70,31
1650426361958,ECE 180,A00,083140,Abi Samra; Nicholas Camill,23,0,30,7
1650426361958,ECE 180,B00,083141,Abi Samra; Nicholas Camill,0,0,30,30
1650426367987,MATH 10A,A01,083735,Patchell; Gregory David,7,0,30,23
1650426367987,MATH 10A,A02,083736,Patchell; Gregory David,28,0,30,2
1650426367987,MATH 10A,A03,083737,Patchell; Gregory David,25,0,30,5
1650426374014,MATH 10B,A01,083207,Staff,0,7,30,30
1650426374014,MATH 10B,A02,083208,Staff,0,7,30,30
1650426374014,MATH 10B,B01,083739,Staff,14,0,30,16
1650426374014,MATH 10B,B02,083740,Staff,28,0,30,2
1650426380039,MATH 18,A01,083743,Staff,2,0,30,28
1650426380039,MATH 18,A02,083744,Staff,27,0,30,3
1650426380039,MATH 18,A03,083745,Staff,22,0,30,8
1650426380039,MATH 18,A04,083746,Staff,26,0,30,4
1650426380039,MATH 18,B01,083748,Staff,1,12,30,29
1650426380039,MATH 18,B02,083749,Staff,0,12,30,30
1650426380039,MATH 18,B03,083750,Staff,1,12,30,29
1650426380039,MATH 18,B04,083751,Staff,0,12,30,30
1650426386065,MATH 20A,A01,083754,Staff,26,0,40,14
1650426392091,MATH 20B,A01,083756,Staff,0,10,30,30
1650426392091,MATH 20B,A02,083757,Staff,0,10,30,30
1650426398115,MATH 20C,A01,083760,Staff,0,14,30,30
1650426398115,MATH 20C,A02,083761,Staff,1,15,30,29
1650426398115,MATH 20C,B01,083762,Staff,13,0,30,17
1650426398115,MATH 20C,B02,083763,Staff,28,0,30,2
1650426404139,MATH 20D,A01,083765,Staff,0,1,30,30
1650426404139,MATH 20D,A02,083766,Staff,7,0,30,23
1650426404139,MATH 20D,A03,083767,Staff,26,0,30,4
1650426410162,MATH 20E,A01,083771,Staff,5,0,30,25
1650426410162,MATH 20E,A02,083772,Staff,18,0,30,12
1650426410162,MATH 20E,B01,083773,Staff,0,0,30,30
1650426410162,MATH 20E,B02,083774,Staff,12,0,30,18
1650426416201,MATH 103A,A01,083777,Staff,0,12,30,30
1650426416201,MATH 103A,A02,083778,Staff,0,12,30,30
1650426416201,MATH 103A,B01,083779,Staff,0,13,30,30
1650426416201,MATH 103A,B02,083780,Staff,0,11,30,30
1650426422225,MATH 105,A01,085443,Staff,0,22,30,30
1650426428249,MATH 109,A01,083213,Anzaldo; Leesa B,0,7,30,30
1650426428249,MATH 109,A02,083214,Anzaldo; Leesa B,0,7,30,30
1650426428249,MATH 109,B01,083215,Anzaldo; Leesa B,0,5,30,30
1650426428249,MATH 109,B02,083216,Anzaldo; Leesa B,0,6,30,30
1650426434274,MATH 142A,A01,083219,Chow; Bennett,0,14,30,30
1650426434274,MATH 142A,A02,083220,Chow; Bennett,0,13,30,30
1650426434274,MATH 142A,B01,083221,Chow; Bennett,0,12,30,30
1650426434274,MATH 142A,B02,083222,Chow; Bennett,0,13,30,30
1650426440298,MATH 193A,A01,083224,Staff,0,5,30,30
1650426440298,MATH 193A,A02,083225,Staff,0,5,30,30
1650426440298,MATH 193A,A03,083781,Staff,0,4,30,30
1650426440298,MATH 193A,A04,083782,Staff,0,4,30,30
1650426446323,MATH 197,001,091859,McAuley; Julian John,9998,0,9999,1
1650426452383,COGS 9,A01,083615,Staff,0,14,60,60
1650426458410,COGS 11,A01,083617,Boyle; Mary E. T.,21,0,40,19
1650426464434,COGS 13,A01,083071,Staff,0,34,40,40
1650426470458,COGS 14A,A01,092681,Staff,0,25,100,100
1650426476484,COGS 14B,A01,083073,Cheng; Tzu-Han,0,11,50,50
1650426482508,COGS 17,A01,092677,Staff,22,0,75,53
1650426488620,COGS 100,A01,083619,Staff,0,26,60,60
1650426494644,COGS 101A,A01,083621,Davis; Joshua Daniel,0,21,60,60
1650426500678,COGS 101B,A01,091572,Staff,0,4,60,60
1650426506701,COGS 101C,A01,083625,Delgado; Tania,16,0,30,14
1650426512725,COGS 107A,A01,083627,Boyle; Mary E. T.,0,11,60,60
1650426518748,COGS 118A,A01,083075,Staff,2,0,60,58
1650426524777,CSE 3,A50,083646,Miranda; Gregory Joseph,21,0,38,17
1650426524777,CSE 3,A51,083647,Miranda; Gregory Joseph,37,0,37,0
1650426530800,CSE 8A,A50,083650,Miranda; Gregory Joseph,0,28,40,40
1650426536824,CSE 11,A01,083080,Cao; Yingjun,0,91,40,40
1650426542854,CSE 12,A01,083652,Staff,0,16,100,100
1650426548881,CSE 15L,A01,083654,Staff,0,1,50,50
1650426548881,CSE 15L,A02,083655,Staff,2,0,50,48
1650426554905,CSE 20,A01,083657,Staff,51,0,80,29
1650426560933,CSE 30,A01,083084,Eldon; John,0,76,40,40
1650426566968,CSE 100,A01,083659,Cao; Yingjun,0,66,50,50
1650426572992,CSE 134B,A01,083661,Powell; Thomas Allan,1,33,65,64
1650426579017,CSE 140,A01,083663,Staff,0,2,75,75
1650426585043,CSE 140L,A01,083088,Eldon; John,0,8,75,75
1650426591067,CSE 175,A01,083665,Kumar; Rakesh,7,0,25,18
1650426597093,CSE 190,A00,092507,Dubnov; Shlomo,14,0,20,6
1650426603117,ECE 45,A01,083139,Staff,0,17,40,40
1650426609140,ECE 65,A50,083695,Staff,0,5,30,30
1650426615163,ECE 109,A01,091882,Touri; Behrouz,39,0,70,31
1650426621185,ECE 180,A00,083140,Abi Samra; Nicholas Camill,23,0,30,7
1650426621185,ECE 180,B00,083141,Abi Samra; Nicholas Camill,0,0,30,30
1650426627210,MATH 10A,A01,083735,Patchell; Gregory David,7,0,30,23
1650426627210,MATH 10A,A02,083736,Patchell; Gregory David,28,0,30,2
1650426627210,MATH 10A,A03,083737,Patchell; Gregory David,25,0,30,5
1650426633234,MATH 10B,A01,083207,Staff,0,7,30,30
1650426633234,MATH 10B,A02,083208,Staff,0,7,30,30
1650426633234,MATH 10B,B01,083739,Staff,14,0,30,16
1650426633234,MATH 10B,B02,083740,Staff,28,0,30,2
1650426639263,MATH 18,A01,083743,Staff,2,0,30,28
1650426639263,MATH 18,A02,083744,Staff,27,0,30,3
1650426639263,MATH 18,A03,083745,Staff,22,0,30,8
1650426639263,MATH 18,A04,083746,Staff,26,0,30,4
1650426639263,MATH 18,B01,083748,Staff,1,12,30,29
1650426639263,MATH 18,B02,083749,Staff,0,12,30,30
1650426639263,MATH 18,B03,083750,Staff,1,12,30,29
1650426639263,MATH 18,B04,083751,Staff,0,12,30,30
1650426645289,MATH 20A,A01,083754,Staff,26,0,40,14
1650426651316,MATH 20B,A01,083756,Staff,0,10,30,30
1650426651316,MATH 20B,A02,083757,Staff,0,10,30,30
1650426657350,MATH 20C,A01,083760,Staff,0,14,30,30
1650426657350,MATH 20C,A02,083761,Staff,1,15,30,29
1650426657350,MATH 20C,B01,083762,Staff,13,0,30,17
1650426657350,MATH 20C,B02,083763,Staff,28,0,30,2
1650426663373,MATH 20D,A01,083765,Staff,0,1,30,30
1650426663373,MATH 20D,A02,083766,Staff,7,0,30,23
1650426663373,MATH 20D,A03,083767,Staff,26,0,30,4
1650426669399,MATH 20E,A01,083771,Staff,5,0,30,25
1650426669399,MATH 20E,A02,083772,Staff,18,0,30,12
1650426669399,MATH 20E,B01,083773,Staff,0,0,30,30
1650426669399,MATH 20E,B02,083774,Staff,12,0,30,18
1650426675424,MATH 103A,A01,083777,Staff,0,12,30,30
1650426675424,MATH 103A,A02,083778,Staff,0,12,30,30
1650426675424,MATH 103A,B01,083779,Staff,0,13,30,30
1650426675424,MATH 103A,B02,083780,Staff,0,11,30,30
1650426681450,MATH 105,A01,085443,Staff,0,22,30,30
1650426687490,MATH 109,A01,083213,Anzaldo; Leesa B,0,7,30,30
1650426687490,MATH 109,A02,083214,Anzaldo; Leesa B,0,7,30,30
1650426687490,MATH 109,B01,083215,Anzaldo; Leesa B,0,5,30,30
1650426687490,MATH 109,B02,083216,Anzaldo; Leesa B,0,6,30,30
1650426693515,MATH 142A,A01,083219,Chow; Bennett,0,14,30,30
1650426693515,MATH 142A,A02,083220,Chow; Bennett,0,13,30,30
1650426693515,MATH 142A,B01,083221,Chow; Bennett,0,12,30,30
1650426693515,MATH 142A,B02,083222,Chow; Bennett,0,13,30,30
1650426699541,MATH 193A,A01,083224,Staff,0,5,30,30
1650426699541,MATH 193A,A02,083225,Staff,0,5,30,30
1650426699541,MATH 193A,A03,083781,Staff,0,4,30,30
1650426699541,MATH 193A,A04,083782,Staff,0,4,30,30
1650426705563,MATH 197,001,091859,McAuley; Julian John,9998,0,9999,1
1650426711625,COGS 9,A01,083615,Staff,0,14,60,60
1650426717662,COGS 11,A01,083617,Boyle; Mary E. T.,21,0,40,19
1650426723690,COGS 13,A01,083071,Staff,0,34,40,40
1650426729712,COGS 14A,A01,092681,Staff,0,25,100,100
1650426735734,COGS 14B,A01,083073,Cheng; Tzu-Han,0,11,50,50
1650426741771,COGS 17,A01,092677,Staff,22,0,75,53
1650426747793,COGS 100,A01,083619,Staff,0,26,60,60
1650426753818,COGS 101A,A01,083621,Davis; Joshua Daniel,0,21,60,60
1650426759842,COGS 101B,A01,091572,Staff,0,4,60,60
1650426765866,COGS 101C,A01,083625,Delgado; Tania,16,0,30,14
1650426771891,COGS 107A,A01,083627,Boyle; Mary E. T.,0,11,60,60
1650426777915,COGS 118A,A01,083075,Staff,2,0,60,58
1650426783942,CSE 3,A50,083646,Miranda; Gregory Joseph,21,0,38,17
1650426783942,CSE 3,A51,083647,Miranda; Gregory Joseph,37,0,37,0
1650426789971,CSE 8A,A50,083650,Miranda; Gregory Joseph,0,28,40,40
1650426795996,CSE 11,A01,083080,Cao; Yingjun,0,91,40,40
1650426802020,CSE 12,A01,083652,Staff,0,16,100,100
1650426808054,CSE 15L,A01,083654,Staff,0,1,50,50
1650426808054,CSE 15L,A02,083655,Staff,2,0,50,48
1650426814077,CSE 20,A01,083657,Staff,51,0,80,29
1650426820115,CSE 30,A01,083084,Eldon; John,0,76,40,40
1650426826141,CSE 100,A01,083659,Cao; Yingjun,0,66,50,50
1650426832172,CSE 134B,A01,083661,Powell; Thomas Allan,1,33,65,64
1650426838197,CSE 140,A01,083663,Staff,0,2,75,75
1650426844222,CSE 140L,A01,083088,Eldon; John,0,8,75,75
1650426850246,CSE 175,A01,083665,Kumar; Rakesh,7,0,25,18
1650426856272,CSE 190,A00,092507,Dubnov; Shlomo,14,0,20,6
1650426862298,ECE 45,A01,083139,Staff,0,17,40,40
1650426868324,ECE 65,A50,083695,Staff,0,5,30,30
1650426874347,ECE 109,A01,091882,Touri; Behrouz,39,0,70,31
1650426880370,ECE 180,A00,083140,Abi Samra; Nicholas Camill,23,0,30,7
1650426880370,ECE 180,B00,083141,Abi Samra; Nicholas Camill,0,0,30,30
1650426886398,MATH 10A,A01,083735,Patchell; Gregory David,7,0,30,23
1650426886398,MATH 10A,A02,083736,Patchell; Gregory David,28,0,30,2
1650426886398,MATH 10A,A03,083737,Patchell; Gregory David,25,0,30,5
1650426892429,MATH 10B,A01,083207,Staff,0,7,30,30
1650426892429,MATH 10B,A02,083208,Staff,0,7,30,30
1650426892429,MATH 10B,B01,083739,Staff,14,0,30,16
1650426892429,MATH 10B,B02,083740,Staff,28,0,30,2
1650426898460,MATH 18,A01,083743,Staff,2,0,30,28
1650426898460,MATH 18,A02,083744,Staff,27,0,30,3
1650426898460,MATH 18,A03,083745,Staff,22,0,30,8
1650426898460,MATH 18,A04,083746,Staff,26,0,30,4
1650426898460,MATH 18,B01,083748,Staff,1,12,30,29
1650426898460,MATH 18,B02,083749,Staff,0,12,30,30
1650426898460,MATH 18,B03,083750,Staff,1,12,30,29
1650426898460,MATH 18,B04,083751,Staff,0,12,30,30
1650426904485,MATH 20A,A01,083754,Staff,26,0,40,14
1650426910513,MATH 20B,A01,083756,Staff,0,10,30,30
1650426910513,MATH 20B,A02,083757,Staff,0,10,30,30
1650426916541,MATH 20C,A01,083760,Staff,0,14,30,30
1650426916541,MATH 20C,A02,083761,Staff,1,15,30,29
1650426916541,MATH 20C,B01,083762,Staff,13,0,30,17
1650426916541,MATH 20C,B02,083763,Staff,28,0,30,2
1650426922564,MATH 20D,A01,083765,Staff,0,1,30,30
1650426922564,MATH 20D,A02,083766,Staff,7,0,30,23
1650426922564,MATH 20D,A03,083767,Staff,26,0,30,4
1650426928594,MATH 20E,A01,083771,Staff,5,0,30,25
1650426928594,MATH 20E,A02,083772,Staff,18,0,30,12
1650426928594,MATH 20E,B01,083773,Staff,0,0,30,30
1650426928594,MATH 20E,B02,083774,Staff,12,0,30,18
1650426934618,MATH 103A,A01,083777,Staff,0,12,30,30
1650426934618,MATH 103A,A02,083778,Staff,0,12,30,30
1650426934618,MATH 103A,B01,083779,Staff,0,13,30,30
1650426934618,MATH 103A,B02,083780,Staff,0,11,30,30
1650426940640,MATH 105,A01,085443,Staff,0,22,30,30
1650426946667,MATH 109,A01,083213,Anzaldo; Leesa B,0,7,30,30
1650426946667,MATH 109,A02,083214,Anzaldo; Leesa B,0,7,30,30
1650426946667,MATH 109,B01,083215,Anzaldo; Leesa B,0,5,30,30
1650426946667,MATH 109,B02,083216,Anzaldo; Leesa B,0,6,30,30
1650426952692,MATH 142A,A01,083219,Chow; Bennett,0,14,30,30
1650426952692,MATH 142A,A02,083220,Chow; Bennett,0,13,30,30
1650426952692,MATH 142A,B01,083221,Chow; Bennett,0,12,30,30
1650426952692,MATH 142A,B02,083222,Chow; Bennett,0,13,30,30
1650426958717,MATH 193A,A01,083224,Staff,0,5,30,30
1650426958717,MATH 193A,A02,083225,Staff,0,5,30,30
1650426958717,MATH 193A,A03,083781,Staff,0,4,30,30
1650426958717,MATH 193A,A04,083782,Staff,0,4,30,30
1650426964739,MATH 197,001,091859,McAuley; Julian John,9998,0,9999,1
1650426970798,COGS 9,A01,083615,Staff,0,14,60,60
1650426976821,COGS 11,A01,083617,Boyle; Mary E. T.,21,0,40,19
1650426982845,COGS 13,A01,083071,Staff,0,34,40,40
1650426988871,COGS 14A,A01,092681,Staff,0,25,100,100
1650426994895,COGS 14B,A01,083073,Cheng; Tzu-Han,0,11,50,50
1650427000919,COGS 17,A01,092677,Staff,22,0,75,53
1650427006943,COGS 100,A01,083619,Staff,0,26,60,60
1650427012973,COGS 101A,A01,083621,Davis; Joshua Daniel,0,21,60,60
1650427018999,COGS 101B,A01,091572,Staff,0,4,60,60
1650427025023,COGS 101C,A01,083625,Delgado; Tania,16,0,30,14
1650427031050,COGS 107A,A01,083627,Boyle; Mary E. T.,0,11,60,60
1650427037077,COGS 118A,A01,083075,Staff,2,0,60,58
1650427043105,CSE 3,A50,083646,Miranda; Gregory Joseph,21,0,38,17
1650427043105,CSE 3,A51,083647,Miranda; Gregory Joseph,37,0,37,0
1650427049133,CSE 8A,A50,083650,Miranda; Gregory Joseph,0,28,40,40
1650427055155,CSE 11,A01,083080,Cao; Yingjun,0,91,40,40
1650427061187,CSE 12,A01,083652,Staff,0,16,100,100
1650427067211,CSE 15L,A01,083654,Staff,0,1,50,50
1650427067211,CSE 15L,A02,083655,Staff,2,0,50,48
1650427073241,CSE 20,A01,083657,Staff,51,0,80,29
1650427079264,CSE 30,A01,083084,Eldon; John,0,76,40,40
1650427085376,CSE 100,A01,083659,Cao; Yingjun,0,66,50,50
1650427091406,CSE 134B,A01,083661,Powell; Thomas Allan,1,33,65,64
1650427097430,CSE 140,A01,083663,Staff,0,2,75,75
1650427103454,CSE 140L,A01,083088,Eldon; John,0,8,75,75
1650427109483,CSE 175,A01,083665,Kumar; Rakesh,7,0,25,18
1650427115505,CSE 190,A00,092507,Dubnov; Shlomo,14,0,20,6
1650427121532,ECE 45,A01,083139,Staff,0,17,40,40
1650427127561,ECE 65,A50,083695,Staff,0,5,30,30
1650427133588,ECE 109,A01,091882,Touri; Behrouz,39,0,70,31
1650427139611,ECE 180,A00,083140,Abi Samra; Nicholas Camill,23,0,30,7
1650427139611,ECE 180,B00,083141,Abi Samra; Nicholas Camill,0,0,30,30
1650427145634,MATH 10A,A01,083735,Patchell; Gregory David,7,0,30,23
1650427145634,MATH 10A,A02,083736,Patchell; Gregory David,28,0,30,2
1650427145634,MATH 10A,A03,083737,Patchell; Gregory David,25,0,30,5
1650427151659,MATH 10B,A01,083207,Staff,0,7,30,30
1650427151659,MATH 10B,A02,083208,Staff,0,7,30,30
1650427151659,MATH 10B,B01,083739,Staff,14,0,30,16
1650427151659,MATH 10B,B02,083740,Staff,28,0,30,2
1650427157685,MATH 18,A01,083743,Staff,2,0,30,28
1650427157685,MATH 18,A02,083744,Staff,27,0,30,3
1650427157685,MATH 18,A03,083745,Staff,22,0,30,8
1650427157685,MATH 18,A04,083746,Staff,26,0,30,4
1650427157685,MATH 18,B01,083748,Staff,1,12,30,29
1650427157685,MATH 18,B02,083749,Staff,0,12,30,30
1650427157685,MATH 18,B03,083750,Staff,1,12,30,29
1650427157685,MATH 18,B04,083751,Staff,0,12,30,30
1650427163708,MATH 20A,A01,083754,Staff,26,0,40,14
1650427169732,MATH 20B,A01,083756,Staff,0,10,30,30
1650427169732,MATH 20B,A02,083757,Staff,0,10,30,30
1650427175756,MATH 20C,A01,083760,Staff,0,14,30,30
1650427175756,MATH 20C,A02,083761,Staff,1,15,30,29
1650427175756,MATH 20C,B01,083762,Staff,13,0,30,17
1650427175756,MATH 20C,B02,083763,Staff,28,0,30,2
1650427181783,MATH 20D,A01,083765,Staff,0,1,30,30
1650427181783,MATH 20D,A02,083766,Staff,7,0,30,23
1650427181783,MATH 20D,A03,083767,Staff,26,0,30,4
1650427187807,MATH 20E,A01,083771,Staff,5,0,30,25
1650427187807,MATH 20E,A02,083772,Staff,18,0,30,12
1650427187807,MATH 20E,B01,083773,Staff,0,0,30,30
1650427187807,MATH 20E,B02,083774,Staff,12,0,30,18
1650427193835,MATH 103A,A01,083777,Staff,0,12,30,30
1650427193835,MATH 103A,A02,083778,Staff,0,12,30,30
1650427193835,MATH 103A,B01,083779,Staff,0,13,30,30
1650427193835,MATH 103A,B02,083780,Staff,0,11,30,30
1650427199867,MATH 105,A01,085443,Staff,0,22,30,30
1650427205894,MATH 109,A01,083213,Anzaldo; Leesa B,0,7,30,30
1650427205894,MATH 109,A02,083214,Anzaldo; Leesa B,0,7,30,30
1650427205894,MATH 109,B01,083215,Anzaldo; Leesa B,0,5,30,30
1650427205894,MATH 109,B02,083216,Anzaldo; Leesa B,0,6,30,30
1650427211924,MATH 142A,A01,083219,Chow; Bennett,0,14,30,30
1650427211924,MATH 142A,A02,083220,Chow; Bennett,0,13,30,30
1650427211924,MATH 142A,B01,083221,Chow; Bennett,0,12,30,30
1650427211924,MATH 142A,B02,083222,Chow; Bennett,0,13,30,30
1650427217955,MATH 193A,A01,083224,Staff,0,5,30,30
1650427217955,MATH 193A,A02,083225,Staff,0,5,30,30
1650427217955,MATH 193A,A03,083781,Staff,0,4,30,30
1650427217955,MATH 193A,A04,083782,Staff,0,4,30,30
1650427223990,MATH 197,001,091859,McAuley; Julian John,9998,0,9999,1
1650427230045,COGS 9,A01,083615,Staff,0,14,60,60
1650427236069,COGS 11,A01,083617,Boyle; Mary E. T.,21,0,40,19
1650427242095,COGS 13,A01,083071,Staff,0,34,40,40
1650427248121,COGS 14A,A01,092681,Staff,0,25,100,100
1650427254146,COGS 14B,A01,083073,Cheng; Tzu-Han,0,11,50,50
1650427260170,COGS 17,A01,092677,Staff,22,0,75,53
1650427266196,COGS 100,A01,083619,Staff,0,26,60,60
1650427272217,COGS 101A,A01,083621,Davis; Joshua Daniel,0,21,60,60
1650427278241,COGS 101B,A01,091572,Staff,0,4,60,60
1650427284265,COGS 101C,A01,083625,Delgado; Tania,16,0,30,14
1650427290292,COGS 107A,A01,083627,Boyle; Mary E. T.,0,11,60,60
1650427296316,COGS 118A,A01,083075,Staff,2,0,60,58
1650427302391,CSE 3,A50,083646,Miranda; Gregory Joseph,21,0,38,17
1650427302391,CSE 3,A51,083647,Miranda; Gregory Joseph,37,0,37,0
1650427308420,CSE 8A,A50,083650,Miranda; Gregory Joseph,0,28,40,40
1650427314454,CSE 11,A01,083080,Cao; Yingjun,0,91,40,40
1650427320484,CSE 12,A01,083652,Staff,0,16,100,100
1650427326511,CSE 15L,A01,083654,Staff,0,1,50,50
1650427326511,CSE 15L,A02,083655,Staff,2,0,50,48
1650427332535,CSE 20,A01,083657,Staff,51,0,80,29
1650427338561,CSE 30,A01,083084,Eldon; John,0,76,40,40
1650427344584,CSE 100,A01,083659,Cao; Yingjun,0,66,50,50
1650427350611,CSE 134B,A01,083661,Powell; Thomas Allan,1,33,65,64
1650427356637,CSE 140,A01,083663,Staff,0,2,75,75
1650427362662,CSE 140L,A01,083088,Eldon; John,0,8,75,75
1650427368688,CSE 175,A01,083665,Kumar; Rakesh,7,0,25,18
1650427374712,CSE 190,A00,092507,Dubnov; Shlomo,14,0,20,6
1650427380738,ECE 45,A01,083139,Staff,0,17,40,40
1650427386769,ECE 65,A50,083695,Staff,0,5,30,30
1650427392794,ECE 109,A01,091882,Touri; Behrouz,39,0,70,31
1650427398824,ECE 180,A00,083140,Abi Samra; Nicholas Camill,23,0,30,7
1650427398824,ECE 180,B00,083141,Abi Samra; Nicholas Camill,0,0,30,30
1650427404849,MATH 10A,A01,083735,Patchell; Gregory David,7,0,30,23
1650427404849,MATH 10A,A02,083736,Patchell; Gregory David,28,0,30,2
1650427404849,MATH 10A,A03,083737,Patchell; Gregory David,25,0,30,5
1650427410878,MATH 10B,A01,083207,Staff,0,7,30,30
1650427410878,MATH 10B,A02,083208,Staff,0,7,30,30
1650427410878,MATH 10B,B01,083739,Staff,14,0,30,16
1650427410878,MATH 10B,B02,083740,Staff,28,0,30,2
1650427416905,MATH 18,A01,083743,Staff,2,0,30,28
1650427416905,MATH 18,A02,083744,Staff,27,0,30,3
1650427416905,MATH 18,A03,083745,Staff,22,0,30,8
1650427416905,MATH 18,A04,083746,Staff,26,0,30,4
1650427416905,MATH 18,B01,083748,Staff,1,12,30,29
1650427416905,MATH 18,B02,083749,Staff,0,12,30,30
1650427416905,MATH 18,B03,083750,Staff,1,12,30,29
1650427416905,MATH 18,B04,083751,Staff,0,12,30,30
1650427422950,MATH 20A,A01,083754,Staff,26,0,40,14
1650427428975,MATH 20B,A01,083756,Staff,0,10,30,30
1650427428975,MATH 20B,A02,083757,Staff,0,10,30,30
1650427435007,MATH 20C,A01,083760,Staff,0,14,30,30
1650427435007,MATH 20C,A02,083761,Staff,1,15,30,29
1650427435007,MATH 20C,B01,083762,Staff,13,0,30,17
1650427435007,MATH 20C,B02,083763,Staff,28,0,30,2
1650427441036,MATH 20D,A01,083765,Staff,0,1,30,30
1650427441036,MATH 20D,A02,083766,Staff,7,0,30,23
1650427441036,MATH 20D,A03,083767,Staff,26,0,30,4
1650427447059,MATH 20E,A01,083771,Staff,5,0,30,25
1650427447059,MATH 20E,A02,083772,Staff,18,0,30,12
1650427447059,MATH 20E,B01,083773,Staff,0,0,30,30
1650427447059,MATH 20E,B02,083774,Staff,12,0,30,18
1650427453082,MATH 103A,A01,083777,Staff,0,12,30,30
1650427453082,MATH 103A,A02,083778,Staff,0,12,30,30
1650427453082,MATH 103A,B01,083779,Staff,0,13,30,30
1650427453082,MATH 103A,B02,083780,Staff,0,11,30,30
1650427459107,MATH 105,A01,085443,Staff,0,22,30,30
1650427465138,MATH 109,A01,083213,Anzaldo; Leesa B,0,7,30,30
1650427465138,MATH 109,A02,083214,Anzaldo; Leesa B,0,7,30,30
1650427465138,MATH 109,B01,083215,Anzaldo; Leesa B,0,5,30,30
1650427465138,MATH 109,B02,083216,Anzaldo; Leesa B,0,6,30,30
1650427471165,MATH 142A,A01,083219,Chow; Bennett,0,14,30,30
1650427471165,MATH 142A,A02,083220,Chow; Bennett,0,13,30,30
1650427471165,MATH 142A,B01,083221,Chow; Bennett,0,12,30,30
1650427471165,MATH 142A,B02,083222,Chow; Bennett,0,13,30,30
1650427477187,MATH 193A,A01,083224,Staff,0,5,30,30
1650427477187,MATH 193A,A02,083225,Staff,0,5,30,30
1650427477187,MATH 193A,A03,083781,Staff,0,4,30,30
1650427477187,MATH 193A,A04,083782,Staff,0,4,30,30
1650427483211,MATH 197,001,091859,McAuley; Julian John,9998,0,9999,1
1650427489261,COGS 9,A01,083615,Staff,0,14,60,60
1650427495288,COGS 11,A01,083617,Boyle; Mary E. T.,21,0,40,19
1650427501314,COGS 13,A01,083071,Staff,0,34,40,40
1650427507337,COGS 14A,A01,092681,Staff,0,25,100,100
1650427513363,COGS 14B,A01,083073,Cheng; Tzu-Han,0,11,50,50
1650427519392,COGS 17,A01,092677,Staff,22,0,75,53
1650427525415,COGS 100,A01,083619,Staff,0,26,60,60
1650427531438,COGS 101A,A01,083621,Davis; Joshua Daniel,0,21,60,60
1650427537465,COGS 101B,A01,091572,Staff,0,4,60,60
1650427543491,COGS 101C,A01,083625,Delgado; Tania,16,0,30,14
1650427554337,COGS 107A,A01,083627,Boyle; Mary E. T.,0,11,60,60
1650427560363,COGS 118A,A01,083075,Staff,2,0,60,58
1650427566395,CSE 3,A50,083646,Miranda; Gregory Joseph,21,0,38,17
1650427566395,CSE 3,A51,083647,Miranda; Gregory Joseph,37,0,37,0
1650427572417,CSE 8A,A50,083650,Miranda; Gregory Joseph,0,28,40,40
1650427578444,CSE 11,A01,083080,Cao; Yingjun,0,91,40,40
1650427584468,CSE 12,A01,083652,Staff,0,16,100,100
1650427590491,CSE 15L,A01,083654,Staff,0,1,50,50
1650427590491,CSE 15L,A02,083655,Staff,2,0,50,48
1650427596515,CSE 20,A01,083657,Staff,51,0,80,29
1650427602537,CSE 30,A01,083084,Eldon; John,0,76,40,40
1650427608563,CSE 100,A01,083659,Cao; Yingjun,0,66,50,50
1650427614585,CSE 134B,A01,083661,Powell; Thomas Allan,1,33,65,64
1650427620610,CSE 140,A01,083663,Staff,0,2,75,75
1650427626639,CSE 140L,A01,083088,Eldon; John,0,8,75,75
1650427632660,CSE 175,A01,083665,Kumar; Rakesh,7,0,25,18
1650427638689,CSE 190,A00,092507,Dubnov; Shlomo,14,0,20,6
1650427644715,ECE 45,A01,083139,Staff,0,17,40,40
1650427650738,ECE 65,A50,083695,Staff,0,5,30,30
1650427656762,ECE 109,A01,091882,Touri; Behrouz,39,0,70,31
1650427662789,ECE 180,A00,083140,Abi Samra; Nicholas Camill,23,0,30,7
1650427662789,ECE 180,B00,083141,Abi Samra; Nicholas Camill,0,0,30,30
1650427668813,MATH 10A,A01,083735,Patchell; Gregory David,7,0,30,23
1650427668813,MATH 10A,A02,083736,Patchell; Gregory David,28,0,30,2
1650427668813,MATH 10A,A03,083737,Patchell; Gregory David,25,0,30,5
1650427674837,MATH 10B,A01,083207,Staff,0,7,30,30
1650427674837,MATH 10B,A02,083208,Staff,0,7,30,30
1650427674837,MATH 10B,B01,083739,Staff,14,0,30,16
1650427674837,MATH 10B,B02,083740,Staff,28,0,30,2
1650427680861,MATH 18,A01,083743,Staff,2,0,30,28
1650427680861,MATH 18,A02,083744,Staff,27,0,30,3
1650427680861,MATH 18,A03,083745,Staff,22,0,30,8
1650427680861,MATH 18,A04,083746,Staff,26,0,30,4
1650427680861,MATH 18,B01,083748,Staff,1,12,30,29
1650427680861,MATH 18,B02,083749,Staff,0,12,30,30
1650427680861,MATH 18,B03,083750,Staff,1,12,30,29
1650427680861,MATH 18,B04,083751,Staff,0,12,30,30
1650427686974,MATH 20A,A01,083754,Staff,26,0,40,14
1650427692996,MATH 20B,A01,083756,Staff,0,10,30,30
1650427692996,MATH 20B,A02,083757,Staff,0,10,30,30
1650427699023,MATH 20C,A01,083760,Staff,0,14,30,30
1650427699023,MATH 20C,A02,083761,Staff,1,15,30,29
1650427699023,MATH 20C,B01,083762,Staff,13,0,30,17
1650427699023,MATH 20C,B02,083763,Staff,28,0,30,2
1650427705049,MATH 20D,A01,083765,Staff,0,1,30,30
1650427705049,MATH 20D,A02,083766,Staff,7,0,30,23
1650427705049,MATH 20D,A03,083767,Staff,26,0,30,4
1650427711073,MATH 20E,A01,083771,Staff,5,0,30,25
1650427711073,MATH 20E,A02,083772,Staff,18,0,30,12
1650427711073,MATH 20E,B01,083773,Staff,0,0,30,30
1650427711073,MATH 20E,B02,083774,Staff,12,0,30,18
1650427717098,MATH 103A,A01,083777,Staff,0,12,30,30
1650427717098,MATH 103A,A02,083778,Staff,0,12,30,30
1650427717098,MATH 103A,B01,083779,Staff,0,13,30,30
1650427717098,MATH 103A,B02,083780,Staff,0,11,30,30
1650427723121,MATH 105,A01,085443,Staff,0,22,30,30
1650427729144,MATH 109,A01,083213,Anzaldo; Leesa B,0,7,30,30
1650427729144,MATH 109,A02,083214,Anzaldo; Leesa B,0,7,30,30
1650427729144,MATH 109,B01,083215,Anzaldo; Leesa B,0,5,30,30
1650427729144,MATH 109,B02,083216,Anzaldo; Leesa B,0,6,30,30
1650427735172,MATH 142A,A01,083219,Chow; Bennett,0,14,30,30
1650427735172,MATH 142A,A02,083220,Chow; Bennett,0,13,30,30
1650427735172,MATH 142A,B01,083221,Chow; Bennett,0,12,30,30
1650427735172,MATH 142A,B02,083222,Chow; Bennett,0,13,30,30
1650427741199,MATH 193A,A01,083224,Staff,0,5,30,30
1650427741199,MATH 193A,A02,083225,Staff,0,5,30,30
1650427741199,MATH 193A,A03,083781,Staff,0,4,30,30
1650427741199,MATH 193A,A04,083782,Staff,0,4,30,30
1650427747225,MATH 197,001,091859,McAuley; Julian John,9998,0,9999,1
1650427753272,COGS 9,A01,083615,Staff,0,14,60,60
1650427759299,COGS 11,A01,083617,Boyle; Mary E. T.,21,0,40,19
1650427765325,COGS 13,A01,083071,Staff,0,34,40,40
1650427771347,COGS 14A,A01,092681,Staff,0,25,100,100
1650427777374,COGS 14B,A01,083073,Cheng; Tzu-Han,0,11,50,50
1650427783404,COGS 17,A01,092677,Staff,22,0,75,53
1650427789430,COGS 100,A01,083619,Staff,0,26,60,60
1650427795454,COGS 101A,A01,083621,Davis; Joshua Daniel,0,21,60,60
1650427801486,COGS 101B,A01,091572,Staff,0,4,60,60
1650427807508,COGS 101C,A01,083625,Delgado; Tania,16,0,30,14
1650427813535,COGS 107A,A01,083627,Boyle; Mary E. T.,0,11,60,60
1650427819561,COGS 118A,A01,083075,Staff,2,0,60,58
1650427825585,CSE 3,A50,083646,Miranda; Gregory Joseph,21,0,38,17
1650427825585,CSE 3,A51,083647,Miranda; Gregory Joseph,36,0,37,1
1650427831619,CSE 8A,A50,083650,Miranda; Gregory Joseph,0,28,40,40
1650427837646,CSE 11,A01,083080,Cao; Yingjun,0,91,40,40
1650427843672,CSE 12,A01,083652,Staff,0,16,100,100
1650427849696,CSE 15L,A01,083654,Staff,0,1,50,50
1650427849696,CSE 15L,A02,083655,Staff,2,0,50,48
1650427855718,CSE 20,A01,083657,Staff,51,0,80,29
1650427861743,CSE 30,A01,083084,Eldon; John,0,76,40,40
1650427867770,CSE 100,A01,083659,Cao; Yingjun,0,66,50,50
1650427873796,CSE 134B,A01,083661,Powell; Thomas Allan,1,33,65,64
1650427879822,CSE 140,A01,083663,Staff,0,2,75,75
1650427885845,CSE 140L,A01,083088,Eldon; John,0,8,75,75
1650427891866,CSE 175,A01,083665,Kumar; Rakesh,7,0,25,18
1650427897889,CSE 190,A00,092507,Dubnov; Shlomo,14,0,20,6
1650427903914,ECE 45,A01,083139,Staff,0,17,40,40
1650427909938,ECE 65,A50,083695,Staff,0,5,30,30
1650427915964,ECE 109,A01,091882,Touri; Behrouz,39,0,70,31
1650427921988,ECE 180,A00,083140,Abi Samra; Nicholas Camill,23,0,30,7
1650427921988,ECE 180,B00,083141,Abi Samra; Nicholas Camill,0,0,30,30
1650427928015,MATH 10A,A01,083735,Patchell; Gregory David,7,0,30,23
1650427928015,MATH 10A,A02,083736,Patchell; Gregory David,28,0,30,2
1650427928015,MATH 10A,A03,083737,Patchell; Gregory David,25,0,30,5
1650427934052,MATH 10B,A01,083207,Staff,0,7,30,30
1650427934052,MATH 10B,A02,083208,Staff,0,7,30,30
1650427934052,MATH 10B,B01,083739,Staff,14,0,30,16
1650427934052,MATH 10B,B02,083740,Staff,28,0,30,2
1650427940077,MATH 18,A01,083743,Staff,2,0,30,28
1650427940077,MATH 18,A02,083744,Staff,27,0,30,3
1650427940077,MATH 18,A03,083745,Staff,22,0,30,8
1650427940077,MATH 18,A04,083746,Staff,26,0,30,4
1650427940077,MATH 18,B01,083748,Staff,1,12,30,29
1650427940077,MATH 18,B02,083749,Staff,0,12,30,30
1650427940077,MATH 18,B03,083750,Staff,1,12,30,29
1650427940077,MATH 18,B04,083751,Staff,0,12,30,30
1650427946103,MATH 20A,A01,083754,Staff,26,0,40,14
1650427952126,MATH 20B,A01,083756,Staff,0,10,30,30
1650427952126,MATH 20B,A02,083757,Staff,0,10,30,30
1650427958152,MATH 20C,A01,083760,Staff,0,14,30,30
1650427958152,MATH 20C,A02,083761,Staff,1,15,30,29
1650427958152,MATH 20C,B01,083762,Staff,13,0,30,17
1650427958152,MATH 20C,B02,083763,Staff,28,0,30,2
1650427964179,MATH 20D,A01,083765,Staff,0,1,30,30
1650427964179,MATH 20D,A02,083766,Staff,7,0,30,23
1650427964179,MATH 20D,A03,083767,Staff,26,0,30,4
1650427970207,MATH 20E,A01,083771,Staff,5,0,30,25
1650427970207,MATH 20E,A02,083772,Staff,18,0,30,12
1650427970207,MATH 20E,B01,083773,Staff,0,0,30,30
1650427970207,MATH 20E,B02,083774,Staff,12,0,30,18
1650427976234,MATH 103A,A01,083777,Staff,0,12,30,30
1650427976234,MATH 103A,A02,083778,Staff,0,12,30,30
1650427976234,MATH 103A,B01,083779,Staff,0,13,30,30
1650427976234,MATH 103A,B02,083780,Staff,0,11,30,30
1650427982262,MATH 105,A01,085443,Staff,0,22,30,30
1650427988286,MATH 109,A01,083213,Anzaldo; Leesa B,0,7,30,30
1650427988286,MATH 109,A02,083214,Anzaldo; Leesa B,0,7,30,30
1650427988286,MATH 109,B01,083215,Anzaldo; Leesa B,0,5,30,30
1650427988286,MATH 109,B02,083216,Anzaldo; Leesa B,0,6,30,30
1650427994318,MATH 142A,A01,083219,Chow; Bennett,0,14,30,30
1650427994318,MATH 142A,A02,083220,Chow; Bennett,0,13,30,30
1650427994318,MATH 142A,B01,083221,Chow; Bennett,0,12,30,30
1650427994318,MATH 142A,B02,083222,Chow; Bennett,0,13,30,30
1650428000341,MATH 193A,A01,083224,Staff,0,5,30,30
1650428000341,MATH 193A,A02,083225,Staff,0,5,30,30
1650428000341,MATH 193A,A03,083781,Staff,0,4,30,30
1650428000341,MATH 193A,A04,083782,Staff,0,4,30,30
1650428006366,MATH 197,001,091859,McAuley; Julian John,9998,0,9999,1
1650428012416,COGS 9,A01,083615,Staff,0,14,60,60
1650428018439,COGS 11,A01,083617,Boyle; Mary E. T.,21,0,40,19
1650428024469,COGS 13,A01,083071,Staff,0,34,40,40
1650428030493,COGS 14A,A01,092681,Staff,0,25,100,100
1650428036517,COGS 14B,A01,083073,Cheng; Tzu-Han,0,11,50,50
1650428042550,COGS 17,A01,092677,Staff,22,0,75,53
1650428048574,COGS 100,A01,083619,Staff,0,26,60,60
1650428054597,COGS 101A,A01,083621,Davis; Joshua Daniel,0,21,60,60
1650428060620,COGS 101B,A01,091572,Staff,0,4,60,60
1650428066648,COGS 101C,A01,083625,Delgado; Tania,16,0,30,14
1650428072672,COGS 107A,A01,083627,Boyle; Mary E. T.,0,11,60,60
1650428078696,COGS 118A,A01,083075,Staff,2,0,60,58
1650428084720,CSE 3,A50,083646,Miranda; Gregory Joseph,21,0,38,17
1650428084720,CSE 3,A51,083647,Miranda; Gregory Joseph,36,0,37,1
1650428090747,CSE 8A,A50,083650,Miranda; Gregory Joseph,0,28,40,40
1650428096769,CSE 11,A01,083080,Cao; Yingjun,0,91,40,40
1650428102793,CSE 12,A01,083652,Staff,0,16,100,100
1650428108820,CSE 15L,A01,083654,Staff,0,1,50,50
1650428108820,CSE 15L,A02,083655,Staff,2,0,50,48
1650428114843,CSE 20,A01,083657,Staff,51,0,80,29
1650428120870,CSE 30,A01,083084,Eldon; John,0,76,40,40
1650428126897,CSE 100,A01,083659,Cao; Yingjun,0,66,50,50
1650428132923,CSE 134B,A01,083661,Powell; Thomas Allan,1,33,65,64
1650428138949,CSE 140,A01,083663,Staff,0,2,75,75
1650428144974,CSE 140L,A01,083088,Eldon; John,0,8,75,75
1650428151000,CSE 175,A01,083665,Kumar; Rakesh,7,0,25,18
1650428157025,CSE 190,A00,092507,Dubnov; Shlomo,14,0,20,6
1650428163048,ECE 45,A01,083139,Staff,0,17,40,40
1650428169076,ECE 65,A50,083695,Staff,0,5,30,30
1650428175100,ECE 109,A01,091882,Touri; Behrouz,39,0,70,31
1650428181123,ECE 180,A00,083140,Abi Samra; Nicholas Camill,23,0,30,7
1650428181123,ECE 180,B00,083141,Abi Samra; Nicholas Camill,0,0,30,30
1650428187151,MATH 10A,A01,083735,Patchell; Gregory David,7,0,30,23
1650428187151,MATH 10A,A02,083736,Patchell; Gregory David,28,0,30,2
1650428187151,MATH 10A,A03,083737,Patchell; Gregory David,25,0,30,5
1650428193177,MATH 10B,A01,083207,Staff,0,7,30,30
1650428193177,MATH 10B,A02,083208,Staff,0,7,30,30
1650428193177,MATH 10B,B01,083739,Staff,14,0,30,16
1650428193177,MATH 10B,B02,083740,Staff,28,0,30,2
1650428199208,MATH 18,A01,083743,Staff,2,0,30,28
1650428199208,MATH 18,A02,083744,Staff,27,0,30,3
1650428199208,MATH 18,A03,083745,Staff,22,0,30,8
1650428199208,MATH 18,A04,083746,Staff,26,0,30,4
1650428199208,MATH 18,B01,083748,Staff,1,12,30,29
1650428199208,MATH 18,B02,083749,Staff,0,12,30,30
1650428199208,MATH 18,B03,083750,Staff,1,12,30,29
1650428199208,MATH 18,B04,083751,Staff,0,12,30,30
1650428205233,MATH 20A,A01,083754,Staff,26,0,40,14
1650428211256,MATH 20B,A01,083756,Staff,0,10,30,30
1650428211256,MATH 20B,A02,083757,Staff,0,10,30,30
1650428217286,MATH 20C,A01,083760,Staff,0,14,30,30
1650428217286,MATH 20C,A02,083761,Staff,1,15,30,29
1650428217286,MATH 20C,B01,083762,Staff,13,0,30,17
1650428217286,MATH 20C,B02,083763,Staff,28,0,30,2
1650428223310,MATH 20D,A01,083765,Staff,0,1,30,30
1650428223310,MATH 20D,A02,083766,Staff,7,0,30,23
1650428223310,MATH 20D,A03,083767,Staff,26,0,30,4
1650428229333,MATH 20E,A01,083771,Staff,5,0,30,25
1650428229333,MATH 20E,A02,083772,Staff,18,0,30,12
1650428229333,MATH 20E,B01,083773,Staff,0,0,30,30
1650428229333,MATH 20E,B02,083774,Staff,12,0,30,18
1650428235357,MATH 103A,A01,083777,Staff,0,12,30,30
1650428235357,MATH 103A,A02,083778,Staff,0,12,30,30
1650428235357,MATH 103A,B01,083779,Staff,0,13,30,30
1650428235357,MATH 103A,B02,083780,Staff,0,11,30,30
1650428241380,MATH 105,A01,085443,Staff,0,22,30,30
1650428247409,MATH 109,A01,083213,Anzaldo; Leesa B,0,7,30,30
1650428247409,MATH 109,A02,083214,Anzaldo; Leesa B,0,7,30,30
1650428247409,MATH 109,B01,083215,Anzaldo; Leesa B,0,5,30,30
1650428247409,MATH 109,B02,083216,Anzaldo; Leesa B,0,6,30,30
1650428253438,MATH 142A,A01,083219,Chow; Bennett,0,14,30,30
1650428253438,MATH 142A,A02,083220,Chow; Bennett,0,13,30,30
1650428253438,MATH 142A,B01,083221,Chow; Bennett,0,12,30,30
1650428253438,MATH 142A,B02,083222,Chow; Bennett,0,13,30,30
1650428259460,MATH 193A,A01,083224,Staff,0,5,30,30
1650428259460,MATH 193A,A02,083225,Staff,0,5,30,30
1650428259460,MATH 193A,A03,083781,Staff,0,4,30,30
1650428259460,MATH 193A,A04,083782,Staff,0,4,30,30
1650428265486,MATH 197,001,091859,McAuley; Julian John,9998,0,9999,1
1650428271535,COGS 9,A01,083615,Staff,0,14,60,60
1650428277636,COGS 11,A01,083617,Boyle; Mary E. T.,21,0,40,19
1650428283663,COGS 13,A01,083071,Staff,0,34,40,40
1650428289685,COGS 14A,A01,092681,Staff,0,25,100,100
1650428295708,COGS 14B,A01,083073,Cheng; Tzu-Han,0,11,50,50
1650428301731,COGS 17,A01,092677,Staff,22,0,75,53
1650428307763,COGS 100,A01,083619,Staff,0,26,60,60
1650428313785,COGS 101A,A01,083621,Davis; Joshua Daniel,0,21,60,60
1650428319808,COGS 101B,A01,091572,Staff,0,4,60,60
1650428325841,COGS 101C,A01,083625,Delgado; Tania,16,0,30,14
1650428331868,COGS 107A,A01,083627,Boyle; Mary E. T.,0,11,60,60
1650428337892,COGS 118A,A01,083075,Staff,2,0,60,58
1650428343920,CSE 3,A50,083646,Miranda; Gregory Joseph,21,0,38,17
1650428343920,CSE 3,A51,083647,Miranda; Gregory Joseph,36,0,37,1
1650428349949,CSE 8A,A50,083650,Miranda; Gregory Joseph,0,28,40,40
1650428355972,CSE 11,A01,083080,Cao; Yingjun,0,91,40,40
1650428361996,CSE 12,A01,083652,Staff,0,16,100,100
1650428368020,CSE 15L,A01,083654,Staff,0,1,50,50
1650428368020,CSE 15L,A02,083655,Staff,2,0,50,48
1650428374046,CSE 20,A01,083657,Staff,51,0,80,29
1650428380072,CSE 30,A01,083084,Eldon; John,0,76,40,40
1650428386108,CSE 100,A01,083659,Cao; Yingjun,0,66,50,50
1650428392131,CSE 134B,A01,083661,Powell; Thomas Allan,1,33,65,64
1650428398160,CSE 140,A01,083663,Staff,0,2,75,75
1650428404188,CSE 140L,A01,083088,Eldon; John,0,8,75,75
1650428410219,CSE 175,A01,083665,Kumar; Rakesh,7,0,25,18
1650428416242,CSE 190,A00,092507,Dubnov; Shlomo,14,0,20,6
1650428422266,ECE 45,A01,083139,Staff,0,17,40,40
1650428428289,ECE 65,A50,083695,Staff,0,5,30,30
1650428434313,ECE 109,A01,091882,Touri; Behrouz,39,0,70,31
1650428440336,ECE 180,A00,083140,Abi Samra; Nicholas Camill,23,0,30,7
1650428440336,ECE 180,B00,083141,Abi Samra; Nicholas Camill,0,0,30,30
1650428446361,MATH 10A,A01,083735,Patchell; Gregory David,7,0,30,23
1650428446361,MATH 10A,A02,083736,Patchell; Gregory David,28,0,30,2
1650428446361,MATH 10A,A03,083737,Patchell; Gregory David,25,0,30,5
1650428452387,MATH 10B,A01,083207,Staff,0,7,30,30
1650428452387,MATH 10B,A02,083208,Staff,0,7,30,30
1650428452387,MATH 10B,B01,083739,Staff,14,0,30,16
1650428452387,MATH 10B,B02,083740,Staff,28,0,30,2
1650428458417,MATH 18,A01,083743,Staff,2,0,30,28
1650428458417,MATH 18,A02,083744,Staff,27,0,30,3
1650428458417,MATH 18,A03,083745,Staff,22,0,30,8
1650428458417,MATH 18,A04,083746,Staff,26,0,30,4
1650428458417,MATH 18,B01,083748,Staff,1,12,30,29
1650428458417,MATH 18,B02,083749,Staff,0,12,30,30
1650428458417,MATH 18,B03,083750,Staff,1,12,30,29
1650428458417,MATH 18,B04,083751,Staff,0,12,30,30
1650428464440,MATH 20A,A01,083754,Staff,26,0,40,14
1650428470475,MATH 20B,A01,083756,Staff,0,10,30,30
1650428470475,MATH 20B,A02,083757,Staff,0,10,30,30
1650428476502,MATH 20C,A01,083760,Staff,0,14,30,30
1650428476502,MATH 20C,A02,083761,Staff,1,15,30,29
1650428476502,MATH 20C,B01,083762,Staff,13,0,30,17
1650428476502,MATH 20C,B02,083763,Staff,28,0,30,2
1650428482525,MATH 20D,A01,083765,Staff,0,1,30,30
1650428482525,MATH 20D,A02,083766,Staff,7,0,30,23
1650428482525,MATH 20D,A03,083767,Staff,26,0,30,4
1650428488561,MATH 20E,A01,083771,Staff,5,0,30,25
1650428488561,MATH 20E,A02,083772,Staff,18,0,30,12
1650428488561,MATH 20E,B01,083773,Staff,0,0,30,30
1650428488561,MATH 20E,B02,083774,Staff,12,0,30,18
1650428494584,MATH 103A,A01,083777,Staff,0,12,30,30
1650428494584,MATH 103A,A02,083778,Staff,0,12,30,30
1650428494584,MATH 103A,B01,083779,Staff,0,13,30,30
1650428494584,MATH 103A,B02,083780,Staff,0,11,30,30
1650428500630,MATH 105,A01,085443,Staff,0,22,30,30
1650428506658,MATH 109,A01,083213,Anzaldo; Leesa B,0,7,30,30
1650428506658,MATH 109,A02,083214,Anzaldo; Leesa B,0,7,30,30
1650428506658,MATH 109,B01,083215,Anzaldo; Leesa B,0,5,30,30
1650428506658,MATH 109,B02,083216,Anzaldo; Leesa B,0,6,30,30
1650428512680,MATH 142A,A01,083219,Chow; Bennett,0,14,30,30
1650428512680,MATH 142A,A02,083220,Chow; Bennett,0,13,30,30
1650428512680,MATH 142A,B01,083221,Chow; Bennett,0,12,30,30
1650428512680,MATH 142A,B02,083222,Chow; Bennett,0,13,30,30
1650428518707,MATH 193A,A01,083224,Staff,0,5,30,30
1650428518707,MATH 193A,A02,083225,Staff,0,5,30,30
1650428518707,MATH 193A,A03,083781,Staff,0,4,30,30
1650428518707,MATH 193A,A04,083782,Staff,0,4,30,30
1650428524729,MATH 197,001,091859,McAuley; Julian John,9998,0,9999,1
1650428530779,COGS 9,A01,083615,Staff,0,14,60,60
1650428536807,COGS 11,A01,083617,Boyle; Mary E. T.,21,0,40,19
1650428542836,COGS 13,A01,083071,Staff,0,34,40,40
1650428548860,COGS 14A,A01,092681,Staff,0,25,100,100
1650428554889,COGS 14B,A01,083073,Cheng; Tzu-Han,0,11,50,50
1650428560915,COGS 17,A01,092677,Staff,22,0,75,53
1650428566938,COGS 100,A01,083619,Staff,0,26,60,60
1650428572961,COGS 101A,A01,083621,Davis; Joshua Daniel,0,21,60,60
1650428578987,COGS 101B,A01,091572,Staff,0,4,60,60
1650428585011,COGS 101C,A01,083625,Delgado; Tania,16,0,30,14
1650428591038,COGS 107A,A01,083627,Boyle; Mary E. T.,0,11,60,60
1650428597065,COGS 118A,A01,083075,Staff,2,0,60,58
1650428603090,CSE 3,A50,083646,Miranda; Gregory Joseph,21,0,38,17
1650428603090,CSE 3,A51,083647,Miranda; Gregory Joseph,36,0,37,1
1650428609115,CSE 8A,A50,083650,Miranda; Gregory Joseph,0,28,40,40
1650428615140,CSE 11,A01,083080,Cao; Yingjun,0,91,40,40
1650428621162,CSE 12,A01,083652,Staff,0,16,100,100
1650428627192,CSE 15L,A01,083654,Staff,0,1,50,50
1650428627192,CSE 15L,A02,083655,Staff,2,0,50,48
1650428633232,CSE 20,A01,083657,Staff,51,0,80,29
1650428639262,CSE 30,A01,083084,Eldon; John,0,76,40,40
1650428645286,CSE 100,A01,083659,Cao; Yingjun,0,66,50,50
1650428651312,CSE 134B,A01,083661,Powell; Thomas Allan,1,33,65,64
1650428657337,CSE 140,A01,083663,Staff,0,2,75,75
1650428663360,CSE 140L,A01,083088,Eldon; John,0,8,75,75
1650428669390,CSE 175,A01,083665,Kumar; Rakesh,7,0,25,18
1650428675413,CSE 190,A00,092507,Dubnov; Shlomo,14,0,20,6
1650428681437,ECE 45,A01,083139,Staff,0,17,40,40
1650428687460,ECE 65,A50,083695,Staff,0,5,30,30
1650428693487,ECE 109,A01,091882,Touri; Behrouz,39,0,70,31
1650428699510,ECE 180,A00,083140,Abi Samra; Nicholas Camill,23,0,30,7
1650428699510,ECE 180,B00,083141,Abi Samra; Nicholas Camill,0,0,30,30
1650428705533,MATH 10A,A01,083735,Patchell; Gregory David,7,0,30,23
1650428705533,MATH 10A,A02,083736,Patchell; Gregory David,28,0,30,2
1650428705533,MATH 10A,A03,083737,Patchell; Gregory David,25,0,30,5
1650428711557,MATH 10B,A01,083207,Staff,0,7,30,30
1650428711557,MATH 10B,A02,083208,Staff,0,7,30,30
1650428711557,MATH 10B,B01,083739,Staff,14,0,30,16
1650428711557,MATH 10B,B02,083740,Staff,28,0,30,2
1650428717584,MATH 18,A01,083743,Staff,2,0,30,28
1650428717584,MATH 18,A02,083744,Staff,27,0,30,3
1650428717584,MATH 18,A03,083745,Staff,22,0,30,8
1650428717584,MATH 18,A04,083746,Staff,26,0,30,4
1650428717584,MATH 18,B01,083748,Staff,1,12,30,29
1650428717584,MATH 18,B02,083749,Staff,0,12,30,30
1650428717584,MATH 18,B03,083750,Staff,1,12,30,29
1650428717584,MATH 18,B04,083751,Staff,0,12,30,30
1650428723613,MATH 20A,A01,083754,Staff,26,0,40,14
1650428729635,MATH 20B,A01,083756,Staff,0,10,30,30
1650428729635,MATH 20B,A02,083757,Staff,0,10,30,30
1650428735666,MATH 20C,A01,083760,Staff,0,14,30,30
1650428735666,MATH 20C,A02,083761,Staff,1,15,30,29
1650428735666,MATH 20C,B01,083762,Staff,13,0,30,17
1650428735666,MATH 20C,B02,083763,Staff,28,0,30,2
1650428741692,MATH 20D,A01,083765,Staff,0,1,30,30
1650428741692,MATH 20D,A02,083766,Staff,7,0,30,23
1650428741692,MATH 20D,A03,083767,Staff,26,0,30,4
1650428747726,MATH 20E,A01,083771,Staff,5,0,30,25
1650428747726,MATH 20E,A02,083772,Staff,18,0,30,12
1650428747726,MATH 20E,B01,083773,Staff,0,0,30,30
1650428747726,MATH 20E,B02,083774,Staff,12,0,30,18
1650428753750,MATH 103A,A01,083777,Staff,0,12,30,30
1650428753750,MATH 103A,A02,083778,Staff,0,12,30,30
1650428753750,MATH 103A,B01,083779,Staff,0,13,30,30
1650428753750,MATH 103A,B02,083780,Staff,0,11,30,30
1650428759775,MATH 105,A01,085443,Staff,0,22,30,30
1650428765799,MATH 109,A01,083213,Anzaldo; Leesa B,0,7,30,30
1650428765799,MATH 109,A02,083214,Anzaldo; Leesa B,0,7,30,30
1650428765799,MATH 109,B01,083215,Anzaldo; Leesa B,0,5,30,30
1650428765799,MATH 109,B02,083216,Anzaldo; Leesa B,0,6,30,30
1650428771830,MATH 142A,A01,083219,Chow; Bennett,0,14,30,30
1650428771830,MATH 142A,A02,083220,Chow; Bennett,0,13,30,30
1650428771830,MATH 142A,B01,083221,Chow; Bennett,0,12,30,30
1650428771830,MATH 142A,B02,083222,Chow; Bennett,0,13,30,30
1650428777856,MATH 193A,A01,083224,Staff,0,5,30,30
1650428777856,MATH 193A,A02,083225,Staff,0,5,30,30
1650428777856,MATH 193A,A03,083781,Staff,0,4,30,30
1650428777856,MATH 193A,A04,083782,Staff,0,4,30,30
1650428783898,MATH 197,001,091859,McAuley; Julian John,9998,0,9999,1
1650428789955,COGS 9,A01,083615,Staff,0,14,60,60
1650428795979,COGS 11,A01,083617,Boyle; Mary E. T.,21,0,40,19
1650428802011,COGS 13,A01,083071,Staff,0,34,40,40
1650428808033,COGS 14A,A01,092681,Staff,0,25,100,100
1650428814057,COGS 14B,A01,083073,Cheng; Tzu-Han,0,11,50,50
1650428820080,COGS 17,A01,092677,Staff,22,0,75,53
1650428826104,COGS 100,A01,083619,Staff,0,26,60,60
1650428832128,COGS 101A,A01,083621,Davis; Joshua Daniel,0,21,60,60
1650428838153,COGS 101B,A01,091572,Staff,0,4,60,60
1650428844180,COGS 101C,A01,083625,Delgado; Tania,16,0,30,14
1650428850203,COGS 107A,A01,083627,Boyle; Mary E. T.,0,11,60,60
1650428856226,COGS 118A,A01,083075,Staff,2,0,60,58
1650428862250,CSE 3,A50,083646,Miranda; Gregory Joseph,21,0,38,17
1650428862250,CSE 3,A51,083647,Miranda; Gregory Joseph,36,0,37,1
1650428868277,CSE 8A,A50,083650,Miranda; Gregory Joseph,0,28,40,40
1650428874397,CSE 11,A01,083080,Cao; Yingjun,0,91,40,40
1650428880421,CSE 12,A01,083652,Staff,0,16,100,100
1650428886442,CSE 15L,A01,083654,Staff,0,1,50,50
1650428886442,CSE 15L,A02,083655,Staff,2,0,50,48
1650428892467,CSE 20,A01,083657,Staff,51,0,80,29
1650428898496,CSE 30,A01,083084,Eldon; John,0,76,40,40
1650428904521,CSE 100,A01,083659,Cao; Yingjun,0,66,50,50
1650428910547,CSE 134B,A01,083661,Powell; Thomas Allan,1,33,65,64
1650428916572,CSE 140,A01,083663,Staff,0,2,75,75
1650428922594,CSE 140L,A01,083088,Eldon; John,0,8,75,75
1650428928621,CSE 175,A01,083665,Kumar; Rakesh,7,0,25,18
1650428934646,CSE 190,A00,092507,Dubnov; Shlomo,14,0,20,6
1650428940670,ECE 45,A01,083139,Staff,0,17,40,40
1650428946693,ECE 65,A50,083695,Staff,0,5,30,30
1650428952716,ECE 109,A01,091882,Touri; Behrouz,39,0,70,31
1650428958746,ECE 180,A00,083140,Abi Samra; Nicholas Camill,23,0,30,7
1650428958746,ECE 180,B00,083141,Abi Samra; Nicholas Camill,0,0,30,30
1650428964774,MATH 10A,A01,083735,Patchell; Gregory David,7,0,30,23
1650428964774,MATH 10A,A02,083736,Patchell; Gregory David,28,0,30,2
1650428964774,MATH 10A,A03,083737,Patchell; Gregory David,25,0,30,5
1650428970802,MATH 10B,A01,083207,Staff,0,7,30,30
1650428970802,MATH 10B,A02,083208,Staff,0,7,30,30
1650428970802,MATH 10B,B01,083739,Staff,14,0,30,16
1650428970802,MATH 10B,B02,083740,Staff,28,0,30,2
1650428976826,MATH 18,A01,083743,Staff,2,0,30,28
1650428976826,MATH 18,A02,083744,Staff,27,0,30,3
1650428976826,MATH 18,A03,083745,Staff,22,0,30,8
1650428976826,MATH 18,A04,083746,Staff,26,0,30,4
1650428976826,MATH 18,B01,083748,Staff,1,12,30,29
1650428976826,MATH 18,B02,083749,Staff,0,12,30,30
1650428976826,MATH 18,B03,083750,Staff,1,12,30,29
1650428976826,MATH 18,B04,083751,Staff,0,12,30,30
1650428982850,MATH 20A,A01,083754,Staff,26,0,40,14
1650428988875,MATH 20B,A01,083756,Staff,0,10,30,30
1650428988875,MATH 20B,A02,083757,Staff,0,10,30,30
1650428994902,MATH 20C,A01,083760,Staff,0,14,30,30
1650428994902,MATH 20C,A02,083761,Staff,1,15,30,29
1650428994902,MATH 20C,B01,083762,Staff,13,0,30,17
1650428994902,MATH 20C,B02,083763,Staff,28,0,30,2
1650429000928,MATH 20D,A01,083765,Staff,0,1,30,30
1650429000928,MATH 20D,A02,083766,Staff,7,0,30,23
1650429000928,MATH 20D,A03,083767,Staff,26,0,30,4
1650429006955,MATH 20E,A01,083771,Staff,5,0,30,25
1650429006955,MATH 20E,A02,083772,Staff,18,0,30,12
1650429006955,MATH 20E,B01,083773,Staff,0,0,30,30
1650429006955,MATH 20E,B02,083774,Staff,12,0,30,18
1650429012980,MATH 103A,A01,083777,Staff,0,12,30,30
1650429012980,MATH 103A,A02,083778,Staff,0,12,30,30
1650429012980,MATH 103A,B01,083779,Staff,0,13,30,30
1650429012980,MATH 103A,B02,083780,Staff,0,11,30,30
1650429019006,MATH 105,A01,085443,Staff,0,22,30,30
1650429025031,MATH 109,A01,083213,Anzaldo; Leesa B,0,7,30,30
1650429025031,MATH 109,A02,083214,Anzaldo; Leesa B,0,7,30,30
1650429025031,MATH 109,B01,083215,Anzaldo; Leesa B,0,5,30,30
1650429025031,MATH 109,B02,083216,Anzaldo; Leesa B,0,6,30,30
1650429031057,MATH 142A,A01,083219,Chow; Bennett,0,14,30,30
1650429031057,MATH 142A,A02,083220,Chow; Bennett,0,13,30,30
1650429031057,MATH 142A,B01,083221,Chow; Bennett,0,12,30,30
1650429031057,MATH 142A,B02,083222,Chow; Bennett,0,13,30,30
1650429037082,MATH 193A,A01,083224,Staff,0,5,30,30
1650429037082,MATH 193A,A02,083225,Staff,0,5,30,30
1650429037082,MATH 193A,A03,083781,Staff,0,4,30,30
1650429037082,MATH 193A,A04,083782,Staff,0,4,30,30
1650429043107,MATH 197,001,091859,McAuley; Julian John,9998,0,9999,1
1650429049171,COGS 9,A01,083615,Staff,0,14,60,60
1650429055194,COGS 11,A01,083617,Boyle; Mary E. T.,21,0,40,19
1650429061217,COGS 13,A01,083071,Staff,0,34,40,40
1650429067242,COGS 14A,A01,092681,Staff,0,25,100,100
1650429073272,COGS 14B,A01,083073,Cheng; Tzu-Han,0,11,50,50
1650429079311,COGS 17,A01,092677,Staff,22,0,75,53
1650429085337,COGS 100,A01,083619,Staff,0,26,60,60
1650429091363,COGS 101A,A01,083621,Davis; Joshua Daniel,0,21,60,60
1650429097389,COGS 101B,A01,091572,Staff,0,4,60,60
1650429103417,COGS 101C,A01,083625,Delgado; Tania,16,0,30,14
1650429109447,COGS 107A,A01,083627,Boyle; Mary E. T.,0,11,60,60
1650429115473,COGS 118A,A01,083075,Staff,2,0,60,58
1650429121501,CSE 3,A50,083646,Miranda; Gregory Joseph,21,0,38,17
1650429121501,CSE 3,A51,083647,Miranda; Gregory Joseph,36,0,37,1
1650429127526,CSE 8A,A50,083650,Miranda; Gregory Joseph,0,28,40,40
1650429133554,CSE 11,A01,083080,Cao; Yingjun,0,91,40,40
1650429139580,CSE 12,A01,083652,Staff,0,16,100,100
1650429145604,CSE 15L,A01,083654,Staff,0,1,50,50
1650429145604,CSE 15L,A02,083655,Staff,2,0,50,48
1650429151631,CSE 20,A01,083657,Staff,51,0,80,29
1650429157658,CSE 30,A01,083084,Eldon; John,0,76,40,40
1650429163685,CSE 100,A01,083659,Cao; Yingjun,0,66,50,50
1650429169709,CSE 134B,A01,083661,Powell; Thomas Allan,1,33,65,64
1650429175736,CSE 140,A01,083663,Staff,0,2,75,75
1650429181762,CSE 140L,A01,083088,Eldon; John,0,8,75,75
1650429187786,CSE 175,A01,083665,Kumar; Rakesh,7,0,25,18
1650429193810,CSE 190,A00,092507,Dubnov; Shlomo,14,0,20,6
1650429199839,ECE 45,A01,083139,Staff,0,17,40,40
1650429205862,ECE 65,A50,083695,Staff,0,5,30,30
1650429211886,ECE 109,A01,091882,Touri; Behrouz,39,0,70,31
1650429217909,ECE 180,A00,083140,Abi Samra; Nicholas Camill,23,0,30,7
1650429217909,ECE 180,B00,083141,Abi Samra; Nicholas Camill,0,0,30,30
1650429223934,MATH 10A,A01,083735,Patchell; Gregory David,7,0,30,23
1650429223934,MATH 10A,A02,083736,Patchell; Gregory David,28,0,30,2
1650429223934,MATH 10A,A03,083737,Patchell; Gregory David,25,0,30,5
1650429229958,MATH 10B,A01,083207,Staff,0,7,30,30
1650429229958,MATH 10B,A02,083208,Staff,0,7,30,30
1650429229958,MATH 10B,B01,083739,Staff,14,0,30,16
1650429229958,MATH 10B,B02,083740,Staff,28,0,30,2
1650429235984,MATH 18,A01,083743,Staff,2,0,30,28
1650429235984,MATH 18,A02,083744,Staff,27,0,30,3
1650429235984,MATH 18,A03,083745,Staff,22,0,30,8
1650429235984,MATH 18,A04,083746,Staff,26,0,30,4
1650429235984,MATH 18,B01,083748,Staff,1,12,30,29
1650429235984,MATH 18,B02,083749,Staff,0,12,30,30
1650429235984,MATH 18,B03,083750,Staff,1,12,30,29
1650429235984,MATH 18,B04,083751,Staff,0,12,30,30
1650429242009,MATH 20A,A01,083754,Staff,26,0,40,14
1650429248041,MATH 20B,A01,083756,Staff,0,10,30,30
1650429248041,MATH 20B,A02,083757,Staff,0,10,30,30
1650429254065,MATH 20C,A01,083760,Staff,0,14,30,30
1650429254065,MATH 20C,A02,083761,Staff,1,15,30,29
1650429254065,MATH 20C,B01,083762,Staff,13,0,30,17
1650429254065,MATH 20C,B02,083763,Staff,28,0,30,2
1650429260093,MATH 20D,A01,083765,Staff,0,1,30,30
1650429260093,MATH 20D,A02,083766,Staff,8,0,30,22
1650429260093,MATH 20D,A03,083767,Staff,26,0,30,4
1650429266118,MATH 20E,A01,083771,Staff,5,0,30,25
1650429266118,MATH 20E,A02,083772,Staff,18,0,30,12
1650429266118,MATH 20E,B01,083773,Staff,0,0,30,30
1650429266118,MATH 20E,B02,083774,Staff,12,0,30,18
1650429272142,MATH 103A,A01,083777,Staff,0,12,30,30
1650429272142,MATH 103A,A02,083778,Staff,0,12,30,30
1650429272142,MATH 103A,B01,083779,Staff,0,13,30,30
1650429272142,MATH 103A,B02,083780,Staff,0,11,30,30
1650429278167,MATH 105,A01,085443,Staff,0,22,30,30
1650429284206,MATH 109,A01,083213,Anzaldo; Leesa B,0,7,30,30
1650429284206,MATH 109,A02,083214,Anzaldo; Leesa B,0,7,30,30
1650429284206,MATH 109,B01,083215,Anzaldo; Leesa B,0,5,30,30
1650429284206,MATH 109,B02,083216,Anzaldo; Leesa B,0,6,30,30
1650429290231,MATH 142A,A01,083219,Chow; Bennett,0,14,30,30
1650429290231,MATH 142A,A02,083220,Chow; Bennett,0,13,30,30
1650429290231,MATH 142A,B01,083221,Chow; Bennett,0,12,30,30
1650429290231,MATH 142A,B02,083222,Chow; Bennett,0,13,30,30
1650429296258,MATH 193A,A01,083224,Staff,0,5,30,30
1650429296258,MATH 193A,A02,083225,Staff,0,5,30,30
1650429296258,MATH 193A,A03,083781,Staff,0,4,30,30
1650429296258,MATH 193A,A04,083782,Staff,0,4,30,30
1650429302285,MATH 197,001,091859,McAuley; Julian John,9998,0,9999,1
1650429308348,COGS 9,A01,083615,Staff,0,14,60,60
1650429314371,COGS 11,A01,083617,Boyle; Mary E. T.,21,0,40,19
1650429320394,COGS 13,A01,083071,Staff,0,34,40,40
1650429326421,COGS 14A,A01,092681,Staff,0,25,100,100
1650429332444,COGS 14B,A01,083073,Cheng; Tzu-Han,0,11,50,50
1650429338466,COGS 17,A01,092677,Staff,22,0,75,53
1650429344493,COGS 100,A01,083619,Staff,0,26,60,60
1650429350520,COGS 101A,A01,083621,Davis; Joshua Daniel,0,21,60,60
1650429356545,COGS 101B,A01,091572,Staff,0,4,60,60
1650429362569,COGS 101C,A01,083625,Delgado; Tania,16,0,30,14
1650429368593,COGS 107A,A01,083627,Boyle; Mary E. T.,0,11,60,60
1650429374621,COGS 118A,A01,083075,Staff,2,0,60,58
1650429380649,CSE 3,A50,083646,Miranda; Gregory Joseph,21,0,38,17
1650429380649,CSE 3,A51,083647,Miranda; Gregory Joseph,36,0,37,1
1650429386678,CSE 8A,A50,083650,Miranda; Gregory Joseph,0,28,40,40
1650429392702,CSE 11,A01,083080,Cao; Yingjun,0,91,40,40
1650429398725,CSE 12,A01,083652,Staff,0,16,100,100
1650429404750,CSE 15L,A01,083654,Staff,0,1,50,50
1650429404750,CSE 15L,A02,083655,Staff,2,0,50,48
1650429410774,CSE 20,A01,083657,Staff,51,0,80,29
1650429416799,CSE 30,A01,083084,Eldon; John,0,76,40,40
1650429422823,CSE 100,A01,083659,Cao; Yingjun,0,66,50,50
1650429428847,CSE 134B,A01,083661,Powell; Thomas Allan,1,33,65,64
1650429434880,CSE 140,A01,083663,Staff,0,2,75,75
1650429440904,CSE 140L,A01,083088,Eldon; John,0,8,75,75
1650429446926,CSE 175,A01,083665,Kumar; Rakesh,7,0,25,18
1650429452949,CSE 190,A00,092507,Dubnov; Shlomo,14,0,20,6
1650429458974,ECE 45,A01,083139,Staff,0,17,40,40
1650429464998,ECE 65,A50,083695,Staff,0,5,30,30
1650429471111,ECE 109,A01,091882,Touri; Behrouz,39,0,70,31
1650429477138,ECE 180,A00,083140,Abi Samra; Nicholas Camill,23,0,30,7
1650429477138,ECE 180,B00,083141,Abi Samra; Nicholas Camill,0,0,30,30
1650429483165,MATH 10A,A01,083735,Patchell; Gregory David,7,0,30,23
1650429483165,MATH 10A,A02,083736,Patchell; Gregory David,28,0,30,2
1650429483165,MATH 10A,A03,083737,Patchell; Gregory David,25,0,30,5
1650429489189,MATH 10B,A01,083207,Staff,0,7,30,30
1650429489189,MATH 10B,A02,083208,Staff,0,7,30,30
1650429489189,MATH 10B,B01,083739,Staff,14,0,30,16
1650429489189,MATH 10B,B02,083740,Staff,28,0,30,2
1650429495217,MATH 18,A01,083743,Staff,2,0,30,28
1650429495217,MATH 18,A02,083744,Staff,27,0,30,3
1650429495217,MATH 18,A03,083745,Staff,22,0,30,8
1650429495217,MATH 18,A04,083746,Staff,26,0,30,4
1650429495217,MATH 18,B01,083748,Staff,1,12,30,29
1650429495217,MATH 18,B02,083749,Staff,0,12,30,30
1650429495217,MATH 18,B03,083750,Staff,1,12,30,29
1650429495217,MATH 18,B04,083751,Staff,0,12,30,30
1650429501241,MATH 20A,A01,083754,Staff,26,0,40,14
1650429507267,MATH 20B,A01,083756,Staff,0,10,30,30
1650429507267,MATH 20B,A02,083757,Staff,0,10,30,30
1650429513294,MATH 20C,A01,083760,Staff,0,14,30,30
1650429513294,MATH 20C,A02,083761,Staff,1,15,30,29
1650429513294,MATH 20C,B01,083762,Staff,13,0,30,17
1650429513294,MATH 20C,B02,083763,Staff,28,0,30,2
1650429519321,MATH 20D,A01,083765,Staff,0,1,30,30
1650429519321,MATH 20D,A02,083766,Staff,8,0,30,22
1650429519321,MATH 20D,A03,083767,Staff,26,0,30,4
1650429525348,MATH 20E,A01,083771,Staff,5,0,30,25
1650429525348,MATH 20E,A02,083772,Staff,18,0,30,12
1650429525348,MATH 20E,B01,083773,Staff,0,0,30,30
1650429525348,MATH 20E,B02,083774,Staff,12,0,30,18
1650429531381,MATH 103A,A01,083777,Staff,0,12,30,30
1650429531381,MATH 103A,A02,083778,Staff,0,12,30,30
1650429531381,MATH 103A,B01,083779,Staff,0,13,30,30
1650429531381,MATH 103A,B02,083780,Staff,0,11,30,30
1650429537406,MATH 105,A01,085443,Staff,0,22,30,30
1650429543431,MATH 109,A01,083213,Anzaldo; Leesa B,0,7,30,30
1650429543431,MATH 109,A02,083214,Anzaldo; Leesa B,0,7,30,30
1650429543431,MATH 109,B01,083215,Anzaldo; Leesa B,0,5,30,30
1650429543431,MATH 109,B02,083216,Anzaldo; Leesa B,0,6,30,30
1650429549462,MATH 142A,A01,083219,Chow; Bennett,0,14,30,30
1650429549462,MATH 142A,A02,083220,Chow; Bennett,0,13,30,30
1650429549462,MATH 142A,B01,083221,Chow; Bennett,0,12,30,30
1650429549462,MATH 142A,B02,083222,Chow; Bennett,0,13,30,30
1650429555487,MATH 193A,A01,083224,Staff,0,5,30,30
1650429555487,MATH 193A,A02,083225,Staff,0,5,30,30
1650429555487,MATH 193A,A03,083781,Staff,0,4,30,30
1650429555487,MATH 193A,A04,083782,Staff,0,4,30,30
1650429561511,MATH 197,001,091859,McAuley; Julian John,9998,0,9999,1
1650429567560,COGS 9,A01,083615,Staff,0,14,60,60
1650429573581,COGS 11,A01,083617,Boyle; Mary E. T.,21,0,40,19
1650429579605,COGS 13,A01,083071,Staff,0,34,40,40
1650429585625,COGS 14A,A01,092681,Staff,0,25,100,100
1650429591652,COGS 14B,A01,083073,Cheng; Tzu-Han,0,11,50,50
1650429597683,COGS 17,A01,092677,Staff,22,0,75,53
1650429603707,COGS 100,A01,083619,Staff,0,26,60,60
1650429609733,COGS 101A,A01,083621,Davis; Joshua Daniel,0,21,60,60
1650429615756,COGS 101B,A01,091572,Staff,0,4,60,60
1650429621782,COGS 101C,A01,083625,Delgado; Tania,16,0,30,14
1650429627807,COGS 107A,A01,083627,Boyle; Mary E. T.,0,11,60,60
1650429633829,COGS 118A,A01,083075,Staff,2,0,60,58
1650429639858,CSE 3,A50,083646,Miranda; Gregory Joseph,20,0,38,18
1650429639858,CSE 3,A51,083647,Miranda; Gregory Joseph,36,0,37,1
1650429645894,CSE 8A,A50,083650,Miranda; Gregory Joseph,0,28,40,40
1650429651921,CSE 11,A01,083080,Cao; Yingjun,0,91,40,40
1650429657948,CSE 12,A01,083652,Staff,0,16,100,100
1650429663972,CSE 15L,A01,083654,Staff,0,1,50,50
1650429663972,CSE 15L,A02,083655,Staff,2,0,50,48
1650429669999,CSE 20,A01,083657,Staff,51,0,80,29
1650429676022,CSE 30,A01,083084,Eldon; John,0,76,40,40
1650429682052,CSE 100,A01,083659,Cao; Yingjun,0,66,50,50
1650429688075,CSE 134B,A01,083661,Powell; Thomas Allan,1,33,65,64
1650429694103,CSE 140,A01,083663,Staff,0,2,75,75
1650429700132,CSE 140L,A01,083088,Eldon; John,0,8,75,75
1650429706158,CSE 175,A01,083665,Kumar; Rakesh,7,0,25,18
1650429712181,CSE 190,A00,092507,Dubnov; Shlomo,14,0,20,6
1650429718215,ECE 45,A01,083139,Staff,0,17,40,40
1650429724240,ECE 65,A50,083695,Staff,0,5,30,30
1650429730277,ECE 109,A01,091882,Touri; Behrouz,39,0,70,31
1650429736299,ECE 180,A00,083140,Abi Samra; Nicholas Camill,23,0,30,7
1650429736299,ECE 180,B00,083141,Abi Samra; Nicholas Camill,0,0,30,30
1650429742323,MATH 10A,A01,083735,Patchell; Gregory David,7,0,30,23
1650429742323,MATH 10A,A02,083736,Patchell; Gregory David,28,0,30,2
1650429742323,MATH 10A,A03,083737,Patchell; Gregory David,25,0,30,5
1650429748346,MATH 10B,A01,083207,Staff,0,7,30,30
1650429748346,MATH 10B,A02,083208,Staff,0,7,30,30
1650429748346,MATH 10B,B01,083739,Staff,14,0,30,16
1650429748346,MATH 10B,B02,083740,Staff,28,0,30,2
1650429754375,MATH 18,A01,083743,Staff,2,0,30,28
1650429754375,MATH 18,A02,083744,Staff,27,0,30,3
1650429754375,MATH 18,A03,083745,Staff,22,0,30,8
1650429754375,MATH 18,A04,083746,Staff,26,0,30,4
1650429754375,MATH 18,B01,083748,Staff,1,12,30,29
1650429754375,MATH 18,B02,083749,Staff,0,12,30,30
1650429754375,MATH 18,B03,083750,Staff,1,12,30,29
1650429754375,MATH 18,B04,083751,Staff,0,12,30,30
1650429760400,MATH 20A,A01,083754,Staff,26,0,40,14
1650429766428,MATH 20B,A01,083756,Staff,0,10,30,30
1650429766428,MATH 20B,A02,083757,Staff,0,10,30,30
1650429772454,MATH 20C,A01,083760,Staff,0,14,30,30
1650429772454,MATH 20C,A02,083761,Staff,1,15,30,29
1650429772454,MATH 20C,B01,083762,Staff,13,0,30,17
1650429772454,MATH 20C,B02,083763,Staff,28,0,30,2
1650429778479,MATH 20D,A01,083765,Staff,0,1,30,30
1650429778479,MATH 20D,A02,083766,Staff,8,0,30,22
1650429778479,MATH 20D,A03,083767,Staff,26,0,30,4
1650429784505,MATH 20E,A01,083771,Staff,5,0,30,25
1650429784505,MATH 20E,A02,083772,Staff,18,0,30,12
1650429784505,MATH 20E,B01,083773,Staff,0,0,30,30
1650429784505,MATH 20E,B02,083774,Staff,11,0,30,19
1650429790530,MATH 103A,A01,083777,Staff,0,12,30,30
1650429790530,MATH 103A,A02,083778,Staff,0,12,30,30
1650429790530,MATH 103A,B01,083779,Staff,0,13,30,30
1650429790530,MATH 103A,B02,083780,Staff,0,11,30,30
1650429796567,MATH 105,A01,085443,Staff,0,22,30,30
1650429802593,MATH 109,A01,083213,Anzaldo; Leesa B,0,7,30,30
1650429802593,MATH 109,A02,083214,Anzaldo; Leesa B,0,7,30,30
1650429802593,MATH 109,B01,083215,Anzaldo; Leesa B,0,5,30,30
1650429802593,MATH 109,B02,083216,Anzaldo; Leesa B,0,6,30,30
1650429808621,MATH 142A,A01,083219,Chow; Bennett,0,14,30,30
1650429808621,MATH 142A,A02,083220,Chow; Bennett,0,13,30,30
1650429808621,MATH 142A,B01,083221,Chow; Bennett,0,12,30,30
1650429808621,MATH 142A,B02,083222,Chow; Bennett,0,13,30,30
1650429814649,MATH 193A,A01,083224,Staff,0,5,30,30
1650429814649,MATH 193A,A02,083225,Staff,0,5,30,30
1650429814649,MATH 193A,A03,083781,Staff,0,4,30,30
1650429814649,MATH 193A,A04,083782,Staff,0,4,30,30
1650429820671,MATH 197,001,091859,McAuley; Julian John,9998,0,9999,1
1650429826727,COGS 9,A01,083615,Staff,0,14,60,60
1650429832750,COGS 11,A01,083617,Boyle; Mary E. T.,21,0,40,19
1650429838779,COGS 13,A01,083071,Staff,0,34,40,40
1650429844806,COGS 14A,A01,092681,Staff,0,25,100,100
1650429850832,COGS 14B,A01,083073,Cheng; Tzu-Han,0,11,50,50
1650429856854,COGS 17,A01,092677,Staff,22,0,75,53
1650429862878,COGS 100,A01,083619,Staff,0,26,60,60
1650429868902,COGS 101A,A01,083621,Davis; Joshua Daniel,0,21,60,60
1650429874924,COGS 101B,A01,091572,Staff,0,4,60,60
1650429880948,COGS 101C,A01,083625,Delgado; Tania,16,0,30,14
1650429886972,COGS 107A,A01,083627,Boyle; Mary E. T.,0,11,60,60
1650429892999,COGS 118A,A01,083075,Staff,2,0,60,58
1650429899024,CSE 3,A50,083646,Miranda; Gregory Joseph,20,0,38,18
1650429899024,CSE 3,A51,083647,Miranda; Gregory Joseph,36,0,37,1
1650429905052,CSE 8A,A50,083650,Miranda; Gregory Joseph,0,28,40,40
1650429911075,CSE 11,A01,083080,Cao; Yingjun,0,91,40,40
1650429917104,CSE 12,A01,083652,Staff,0,16,100,100
1650429923128,CSE 15L,A01,083654,Staff,0,1,50,50
1650429923128,CSE 15L,A02,083655,Staff,1,0,50,49
1650429929153,CSE 20,A01,083657,Staff,51,0,80,29
1650429935181,CSE 30,A01,083084,Eldon; John,0,76,40,40
1650429941219,CSE 100,A01,083659,Cao; Yingjun,0,66,50,50
1650429947242,CSE 134B,A01,083661,Powell; Thomas Allan,1,33,65,64
1650429953275,CSE 140,A01,083663,Staff,0,2,75,75
1650429959302,CSE 140L,A01,083088,Eldon; John,0,8,75,75
1650429965326,CSE 175,A01,083665,Kumar; Rakesh,7,0,25,18
1650429971350,CSE 190,A00,092507,Dubnov; Shlomo,14,0,20,6
1650429977377,ECE 45,A01,083139,Staff,0,17,40,40
1650429983414,ECE 65,A50,083695,Staff,0,5,30,30
1650429989439,ECE 109,A01,091882,Touri; Behrouz,39,0,70,31
1650429995466,ECE 180,A00,083140,Abi Samra; Nicholas Camill,23,0,30,7
1650429995466,ECE 180,B00,083141,Abi Samra; Nicholas Camill,0,0,30,30
1650430001488,MATH 10A,A01,083735,Patchell; Gregory David,7,0,30,23
1650430001488,MATH 10A,A02,083736,Patchell; Gregory David,28,0,30,2
1650430001488,MATH 10A,A03,083737,Patchell; Gregory David,25,0,30,5
1650430007516,MATH 10B,A01,083207,Staff,0,7,30,30
1650430007516,MATH 10B,A02,083208,Staff,0,7,30,30
1650430007516,MATH 10B,B01,083739,Staff,14,0,30,16
1650430007516,MATH 10B,B02,083740,Staff,28,0,30,2
1650430013539,MATH 18,A01,083743,Staff,2,0,30,28
1650430013539,MATH 18,A02,083744,Staff,27,0,30,3
1650430013539,MATH 18,A03,083745,Staff,22,0,30,8
1650430013539,MATH 18,A04,083746,Staff,26,0,30,4
1650430013539,MATH 18,B01,083748,Staff,1,12,30,29
1650430013539,MATH 18,B02,083749,Staff,0,12,30,30
1650430013539,MATH 18,B03,083750,Staff,1,12,30,29
1650430013539,MATH 18,B04,083751,Staff,0,12,30,30
1650430019563,MATH 20A,A01,083754,Staff,26,0,40,14
1650430025596,MATH 20B,A01,083756,Staff,0,10,30,30
1650430025596,MATH 20B,A02,083757,Staff,0,10,30,30
1650430031619,MATH 20C,A01,083760,Staff,0,14,30,30
1650430031619,MATH 20C,A02,083761,Staff,1,15,30,29
1650430031619,MATH 20C,B01,083762,Staff,13,0,30,17
1650430031619,MATH 20C,B02,083763,Staff,28,0,30,2
1650430037643,MATH 20D,A01,083765,Staff,0,1,30,30
1650430037643,MATH 20D,A02,083766,Staff,8,0,30,22
1650430037643,MATH 20D,A03,083767,Staff,26,0,30,4
1650430043680,MATH 20E,A01,083771,Staff,5,0,30,25
1650430043680,MATH 20E,A02,083772,Staff,18,0,30,12
1650430043680,MATH 20E,B01,083773,Staff,0,0,30,30
1650430043680,MATH 20E,B02,083774,Staff,11,0,30,19
1650430049712,MATH 103A,A01,083777,Staff,0,12,30,30
1650430049712,MATH 103A,A02,083778,Staff,0,12,30,30
1650430049712,MATH 103A,B01,083779,Staff,0,13,30,30
1650430049712,MATH 103A,B02,083780,Staff,0,11,30,30
1650430055735,MATH 105,A01,085443,Staff,0,22,30,30
1650430061766,MATH 109,A01,083213,Anzaldo; Leesa B,0,7,30,30
1650430061766,MATH 109,A02,083214,Anzaldo; Leesa B,0,7,30,30
1650430061766,MATH 109,B01,083215,Anzaldo; Leesa B,0,5,30,30
1650430061766,MATH 109,B02,083216,Anzaldo; Leesa B,0,6,30,30
1650430067881,MATH 142A,A01,083219,Chow; Bennett,0,14,30,30
1650430067881,MATH 142A,A02,083220,Chow; Bennett,0,13,30,30
1650430067881,MATH 142A,B01,083221,Chow; Bennett,0,12,30,30
1650430067881,MATH 142A,B02,083222,Chow; Bennett,0,13,30,30
1650430073907,MATH 193A,A01,083224,Staff,0,5,30,30
1650430073907,MATH 193A,A02,083225,Staff,0,5,30,30
1650430073907,MATH 193A,A03,083781,Staff,0,4,30,30
1650430073907,MATH 193A,A04,083782,Staff,0,4,30,30
1650430079929,MATH 197,001,091859,McAuley; Julian John,9998,0,9999,1
1650430085977,COGS 9,A01,083615,Staff,0,14,60,60
1650430092000,COGS 11,A01,083617,Boyle; Mary E. T.,21,0,40,19
1650430098027,COGS 13,A01,083071,Staff,0,34,40,40
1650430104051,COGS 14A,A01,092681,Staff,0,25,100,100
1650430110078,COGS 14B,A01,083073,Cheng; Tzu-Han,0,11,50,50
1650430116102,COGS 17,A01,092677,Staff,22,0,75,53
1650430122129,COGS 100,A01,083619,Staff,0,26,60,60
1650430128152,COGS 101A,A01,083621,Davis; Joshua Daniel,0,21,60,60
1650430134176,COGS 101B,A01,091572,Staff,0,4,60,60
1650430140213,COGS 101C,A01,083625,Delgado; Tania,16,0,30,14
1650430146240,COGS 107A,A01,083627,Boyle; Mary E. T.,0,11,60,60
1650430152267,COGS 118A,A01,083075,Staff,2,0,60,58
1650430158304,CSE 3,A50,083646,Miranda; Gregory Joseph,20,0,38,18
1650430158304,CSE 3,A51,083647,Miranda; Gregory Joseph,36,0,37,1
1650430164326,CSE 8A,A50,083650,Miranda; Gregory Joseph,0,28,40,40
1650430170348,CSE 11,A01,083080,Cao; Yingjun,0,91,40,40
1650430176377,CSE 12,A01,083652,Staff,0,16,100,100
1650430182406,CSE 15L,A01,083654,Staff,0,1,50,50
1650430182406,CSE 15L,A02,083655,Staff,1,0,50,49
1650430188429,CSE 20,A01,083657,Staff,51,0,80,29
1650430194455,CSE 30,A01,083084,Eldon; John,0,76,40,40
1650430200479,CSE 100,A01,083659,Cao; Yingjun,0,66,50,50
1650430206502,CSE 134B,A01,083661,Powell; Thomas Allan,1,33,65,64
1650430212527,CSE 140,A01,083663,Staff,0,2,75,75
1650430218553,CSE 140L,A01,083088,Eldon; John,0,8,75,75
1650430224575,CSE 175,A01,083665,Kumar; Rakesh,7,0,25,18
1650430230598,CSE 190,A00,092507,Dubnov; Shlomo,14,0,20,6
1650430236620,ECE 45,A01,083139,Staff,0,17,40,40
1650430242645,ECE 65,A50,083695,Staff,0,5,30,30
1650430248668,ECE 109,A01,091882,Touri; Behrouz,39,0,70,31
1650430254691,ECE 180,A00,083140,Abi Samra; Nicholas Camill,23,0,30,7
1650430254691,ECE 180,B00,083141,Abi Samra; Nicholas Camill,0,0,30,30
1650430260714,MATH 10A,A01,083735,Patchell; Gregory David,7,0,30,23
1650430260714,MATH 10A,A02,083736,Patchell; Gregory David,28,0,30,2
1650430260714,MATH 10A,A03,083737,Patchell; Gregory David,25,0,30,5
1650430266737,MATH 10B,A01,083207,Staff,0,7,30,30
1650430266737,MATH 10B,A02,083208,Staff,0,7,30,30
1650430266737,MATH 10B,B01,083739,Staff,14,0,30,16
1650430266737,MATH 10B,B02,083740,Staff,28,0,30,2
1650430272773,MATH 18,A01,083743,Staff,2,0,30,28
1650430272773,MATH 18,A02,083744,Staff,27,0,30,3
1650430272773,MATH 18,A03,083745,Staff,22,0,30,8
1650430272773,MATH 18,A04,083746,Staff,26,0,30,4
1650430272773,MATH 18,B01,083748,Staff,1,12,30,29
1650430272773,MATH 18,B02,083749,Staff,0,12,30,30
1650430272773,MATH 18,B03,083750,Staff,1,12,30,29
1650430272773,MATH 18,B04,083751,Staff,0,12,30,30
1650430278804,MATH 20A,A01,083754,Staff,26,0,40,14
1650430284831,MATH 20B,A01,083756,Staff,0,10,30,30
1650430284831,MATH 20B,A02,083757,Staff,0,10,30,30
1650430290857,MATH 20C,A01,083760,Staff,0,14,30,30
1650430290857,MATH 20C,A02,083761,Staff,1,15,30,29
1650430290857,MATH 20C,B01,083762,Staff,13,0,30,17
1650430290857,MATH 20C,B02,083763,Staff,28,0,30,2
1650430296882,MATH 20D,A01,083765,Staff,0,1,30,30
1650430296882,MATH 20D,A02,083766,Staff,8,0,30,22
1650430296882,MATH 20D,A03,083767,Staff,26,0,30,4
1650430302910,MATH 20E,A01,083771,Staff,5,0,30,25
1650430302910,MATH 20E,A02,083772,Staff,18,0,30,12
1650430302910,MATH 20E,B01,083773,Staff,0,0,30,30
1650430302910,MATH 20E,B02,083774,Staff,11,0,30,19
1650430308934,MATH 103A,A01,083777,Staff,0,12,30,30
1650430308934,MATH 103A,A02,083778,Staff,0,12,30,30
1650430308934,MATH 103A,B01,083779,Staff,0,13,30,30
1650430308934,MATH 103A,B02,083780,Staff,0,11,30,30
1650430314971,MATH 105,A01,085443,Staff,0,22,30,30
1650430320997,MATH 109,A01,083213,Anzaldo; Leesa B,0,7,30,30
1650430320997,MATH 109,A02,083214,Anzaldo; Leesa B,0,7,30,30
1650430320997,MATH 109,B01,083215,Anzaldo; Leesa B,0,5,30,30
1650430320997,MATH 109,B02,083216,Anzaldo; Leesa B,0,6,30,30
1650430327019,MATH 142A,A01,083219,Chow; Bennett,0,14,30,30
1650430327019,MATH 142A,A02,083220,Chow; Bennett,0,13,30,30
1650430327019,MATH 142A,B01,083221,Chow; Bennett,0,12,30,30
1650430327019,MATH 142A,B02,083222,Chow; Bennett,0,13,30,30
1650430333043,MATH 193A,A01,083224,Staff,0,5,30,30
1650430333043,MATH 193A,A02,083225,Staff,0,5,30,30
1650430333043,MATH 193A,A03,083781,Staff,0,4,30,30
1650430333043,MATH 193A,A04,083782,Staff,0,4,30,30
1650430339066,MATH 197,001,091859,McAuley; Julian John,9998,0,9999,1
1650430345125,COGS 9,A01,083615,Staff,0,14,60,60
1650430351148,COGS 11,A01,083617,Boyle; Mary E. T.,21,0,40,19
1650430357174,COGS 13,A01,083071,Staff,0,34,40,40
1650430363197,COGS 14A,A01,092681,Staff,0,25,100,100
1650430369222,COGS 14B,A01,083073,Cheng; Tzu-Han,0,11,50,50
1650430375259,COGS 17,A01,092677,Staff,22,0,75,53
1650430381284,COGS 100,A01,083619,Staff,0,26,60,60
1650430387351,COGS 101A,A01,083621,Davis; Joshua Daniel,0,21,60,60
1650430393389,COGS 101B,A01,091572,Staff,0,4,60,60
1650430399412,COGS 101C,A01,083625,Delgado; Tania,16,0,30,14
1650430405436,COGS 107A,A01,083627,Boyle; Mary E. T.,0,11,60,60
1650430411460,COGS 118A,A01,083075,Staff,2,0,60,58
1650430417484,CSE 3,A50,083646,Miranda; Gregory Joseph,20,0,38,18
1650430417484,CSE 3,A51,083647,Miranda; Gregory Joseph,36,0,37,1
1650430423512,CSE 8A,A50,083650,Miranda; Gregory Joseph,0,28,40,40
1650430429538,CSE 11,A01,083080,Cao; Yingjun,0,91,40,40
1650430435562,CSE 12,A01,083652,Staff,0,16,100,100
1650430441589,CSE 15L,A01,083654,Staff,0,1,50,50
1650430441589,CSE 15L,A02,083655,Staff,1,0,50,49
1650430447612,CSE 20,A01,083657,Staff,51,0,80,29
1650430453643,CSE 30,A01,083084,Eldon; John,0,76,40,40
1650430459670,CSE 100,A01,083659,Cao; Yingjun,0,66,50,50
1650430465703,CSE 134B,A01,083661,Powell; Thomas Allan,1,33,65,64
1650430471728,CSE 140,A01,083663,Staff,0,2,75,75
1650430477752,CSE 140L,A01,083088,Eldon; John,0,8,75,75
1650430483775,CSE 175,A01,083665,Kumar; Rakesh,7,0,25,18
1650430489798,CSE 190,A00,092507,Dubnov; Shlomo,14,0,20,6
1650430495825,ECE 45,A01,083139,Staff,0,17,40,40
1650430501852,ECE 65,A50,083695,Staff,0,5,30,30
1650430507878,ECE 109,A01,091882,Touri; Behrouz,39,0,70,31
1650430513907,ECE 180,A00,083140,Abi Samra; Nicholas Camill,23,0,30,7
1650430513907,ECE 180,B00,083141,Abi Samra; Nicholas Camill,0,0,30,30
1650430519932,MATH 10A,A01,083735,Patchell; Gregory David,7,0,30,23
1650430519932,MATH 10A,A02,083736,Patchell; Gregory David,28,0,30,2
1650430519932,MATH 10A,A03,083737,Patchell; Gregory David,25,0,30,5
1650430525958,MATH 10B,A01,083207,Staff,0,7,30,30
1650430525958,MATH 10B,A02,083208,Staff,0,7,30,30
1650430525958,MATH 10B,B01,083739,Staff,14,0,30,16
1650430525958,MATH 10B,B02,083740,Staff,28,0,30,2
1650430531982,MATH 18,A01,083743,Staff,2,0,30,28
1650430531982,MATH 18,A02,083744,Staff,27,0,30,3
1650430531982,MATH 18,A03,083745,Staff,22,0,30,8
1650430531982,MATH 18,A04,083746,Staff,26,0,30,4
1650430531982,MATH 18,B01,083748,Staff,1,12,30,29
1650430531982,MATH 18,B02,083749,Staff,0,12,30,30
1650430531982,MATH 18,B03,083750,Staff,1,12,30,29
1650430531982,MATH 18,B04,083751,Staff,0,12,30,30
1650430538024,MATH 20A,A01,083754,Staff,26,0,40,14
1650430544051,MATH 20B,A01,083756,Staff,0,10,30,30
1650430544051,MATH 20B,A02,083757,Staff,0,10,30,30
1650430550075,MATH 20C,A01,083760,Staff,0,14,30,30
1650430550075,MATH 20C,A02,083761,Staff,1,15,30,29
1650430550075,MATH 20C,B01,083762,Staff,13,0,30,17
1650430550075,MATH 20C,B02,083763,Staff,28,0,30,2
1650430556098,MATH 20D,A01,083765,Staff,0,1,30,30
1650430556098,MATH 20D,A02,083766,Staff,8,0,30,22
1650430556098,MATH 20D,A03,083767,Staff,26,0,30,4
1650430562123,MATH 20E,A01,083771,Staff,5,0,30,25
1650430562123,MATH 20E,A02,083772,Staff,18,0,30,12
1650430562123,MATH 20E,B01,083773,Staff,0,0,30,30
1650430562123,MATH 20E,B02,083774,Staff,11,0,30,19
1650430568152,MATH 103A,A01,083777,Staff,0,12,30,30
1650430568152,MATH 103A,A02,083778,Staff,0,12,30,30
1650430568152,MATH 103A,B01,083779,Staff,0,13,30,30
1650430568152,MATH 103A,B02,083780,Staff,0,11,30,30
1650430574179,MATH 105,A01,085443,Staff,0,22,30,30
1650430580205,MATH 109,A01,083213,Anzaldo; Leesa B,0,7,30,30
1650430580205,MATH 109,A02,083214,Anzaldo; Leesa B,0,7,30,30
1650430580205,MATH 109,B01,083215,Anzaldo; Leesa B,0,5,30,30
1650430580205,MATH 109,B02,083216,Anzaldo; Leesa B,0,6,30,30
1650430586233,MATH 142A,A01,083219,Chow; Bennett,0,14,30,30
1650430586233,MATH 142A,A02,083220,Chow; Bennett,0,13,30,30
1650430586233,MATH 142A,B01,083221,Chow; Bennett,0,12,30,30
1650430586233,MATH 142A,B02,083222,Chow; Bennett,0,13,30,30
1650430592256,MATH 193A,A01,083224,Staff,0,5,30,30
1650430592256,MATH 193A,A02,083225,Staff,0,5,30,30
1650430592256,MATH 193A,A03,083781,Staff,0,4,30,30
1650430592256,MATH 193A,A04,083782,Staff,0,4,30,30
1650430598283,MATH 197,001,091859,McAuley; Julian John,9998,0,9999,1
1650430604333,COGS 9,A01,083615,Staff,0,14,60,60
1650430610357,COGS 11,A01,083617,Boyle; Mary E. T.,21,0,40,19
1650430616380,COGS 13,A01,083071,Staff,0,34,40,40
1650430622406,COGS 14A,A01,092681,Staff,0,25,100,100
1650430628435,COGS 14B,A01,083073,Cheng; Tzu-Han,0,11,50,50
1650430634468,COGS 17,A01,092677,Staff,22,0,75,53
1650430640491,COGS 100,A01,083619,Staff,0,26,60,60
1650430646515,COGS 101A,A01,083621,Davis; Joshua Daniel,0,21,60,60
1650430652537,COGS 101B,A01,091572,Staff,0,4,60,60
1650430658661,COGS 101C,A01,083625,Delgado; Tania,16,0,30,14
1650430664684,COGS 107A,A01,083627,Boyle; Mary E. T.,0,11,60,60
1650430670709,COGS 118A,A01,083075,Staff,2,0,60,58
1650430676733,CSE 3,A50,083646,Miranda; Gregory Joseph,20,0,38,18
1650430676733,CSE 3,A51,083647,Miranda; Gregory Joseph,36,0,37,1
1650430682759,CSE 8A,A50,083650,Miranda; Gregory Joseph,0,28,40,40
1650430688794,CSE 11,A01,083080,Cao; Yingjun,0,91,40,40
1650430694819,CSE 12,A01,083652,Staff,0,16,100,100
1650430700842,CSE 15L,A01,083654,Staff,0,1,50,50
1650430700842,CSE 15L,A02,083655,Staff,1,0,50,49
1650430706868,CSE 20,A01,083657,Staff,51,0,80,29
1650430712891,CSE 30,A01,083084,Eldon; John,0,76,40,40
1650430718918,CSE 100,A01,083659,Cao; Yingjun,0,66,50,50
1650430724941,CSE 134B,A01,083661,Powell; Thomas Allan,1,33,65,64
1650430730967,CSE 140,A01,083663,Staff,0,2,75,75
1650430736994,CSE 140L,A01,083088,Eldon; John,0,8,75,75
1650430743018,CSE 175,A01,083665,Kumar; Rakesh,7,0,25,18
1650430749049,CSE 190,A00,092507,Dubnov; Shlomo,14,0,20,6
1650430755076,ECE 45,A01,083139,Staff,0,17,40,40
1650430761099,ECE 65,A50,083695,Staff,0,5,30,30
1650430767124,ECE 109,A01,091882,Touri; Behrouz,39,0,70,31
1650430773149,ECE 180,A00,083140,Abi Samra; Nicholas Camill,23,0,30,7
1650430773149,ECE 180,B00,083141,Abi Samra; Nicholas Camill,0,0,30,30
1650430779173,MATH 10A,A01,083735,Patchell; Gregory David,7,0,30,23
1650430779173,MATH 10A,A02,083736,Patchell; Gregory David,28,0,30,2
1650430779173,MATH 10A,A03,083737,Patchell; Gregory David,25,0,30,5
1650430785198,MATH 10B,A01,083207,Staff,0,7,30,30
1650430785198,MATH 10B,A02,083208,Staff,0,7,30,30
1650430785198,MATH 10B,B01,083739,Staff,14,0,30,16
1650430785198,MATH 10B,B02,083740,Staff,28,0,30,2
1650430791223,MATH 18,A01,083743,Staff,2,0,30,28
1650430791223,MATH 18,A02,083744,Staff,27,0,30,3
1650430791223,MATH 18,A03,083745,Staff,22,0,30,8
1650430791223,MATH 18,A04,083746,Staff,26,0,30,4
1650430791223,MATH 18,B01,083748,Staff,1,12,30,29
1650430791223,MATH 18,B02,083749,Staff,0,12,30,30
1650430791223,MATH 18,B03,083750,Staff,1,12,30,29
1650430791223,MATH 18,B04,083751,Staff,0,12,30,30
1650430797249,MATH 20A,A01,083754,Staff,26,0,40,14
1650430803283,MATH 20B,A01,083756,Staff,0,10,30,30
1650430803283,MATH 20B,A02,083757,Staff,0,10,30,30
1650430809310,MATH 20C,A01,083760,Staff,0,14,30,30
1650430809310,MATH 20C,A02,083761,Staff,1,15,30,29
1650430809310,MATH 20C,B01,083762,Staff,13,0,30,17
1650430809310,MATH 20C,B02,083763,Staff,28,0,30,2
1650430815332,MATH 20D,A01,083765,Staff,0,1,30,30
1650430815332,MATH 20D,A02,083766,Staff,9,0,30,21
1650430815332,MATH 20D,A03,083767,Staff,25,0,30,5
1650430821358,MATH 20E,A01,083771,Staff,5,0,30,25
1650430821358,MATH 20E,A02,083772,Staff,18,0,30,12
1650430821358,MATH 20E,B01,083773,Staff,0,0,30,30
1650430821358,MATH 20E,B02,083774,Staff,11,0,30,19
1650430827393,MATH 103A,A01,083777,Staff,0,12,30,30
1650430827393,MATH 103A,A02,083778,Staff,0,12,30,30
1650430827393,MATH 103A,B01,083779,Staff,0,13,30,30
1650430827393,MATH 103A,B02,083780,Staff,0,11,30,30
1650430833415,MATH 105,A01,085443,Staff,0,22,30,30
1650430839442,MATH 109,A01,083213,Anzaldo; Leesa B,0,7,30,30
1650430839442,MATH 109,A02,083214,Anzaldo; Leesa B,0,7,30,30
1650430839442,MATH 109,B01,083215,Anzaldo; Leesa B,0,5,30,30
1650430839442,MATH 109,B02,083216,Anzaldo; Leesa B,0,6,30,30
1650430845466,MATH 142A,A01,083219,Chow; Bennett,0,14,30,30
1650430845466,MATH 142A,A02,083220,Chow; Bennett,0,13,30,30
1650430845466,MATH 142A,B01,083221,Chow; Bennett,0,12,30,30
1650430845466,MATH 142A,B02,083222,Chow; Bennett,0,13,30,30
1650430851488,MATH 193A,A01,083224,Staff,0,5,30,30
1650430851488,MATH 193A,A02,083225,Staff,0,5,30,30
1650430851488,MATH 193A,A03,083781,Staff,0,4,30,30
1650430851488,MATH 193A,A04,083782,Staff,0,4,30,30
1650430857510,MATH 197,001,091859,McAuley; Julian John,9998,0,9999,1
1650430863575,COGS 9,A01,083615,Staff,0,14,60,60
1650430869599,COGS 11,A01,083617,Boyle; Mary E. T.,21,0,40,19
1650430875621,COGS 13,A01,083071,Staff,0,34,40,40
1650430881647,COGS 14A,A01,092681,Staff,0,25,100,100
1650430887684,COGS 14B,A01,083073,Cheng; Tzu-Han,0,11,50,50
1650430893708,COGS 17,A01,092677,Staff,22,0,75,53
1650430899731,COGS 100,A01,083619,Staff,0,26,60,60
1650430905757,COGS 101A,A01,083621,Davis; Joshua Daniel,0,21,60,60
1650430911780,COGS 101B,A01,091572,Staff,0,4,60,60
1650430917807,COGS 101C,A01,083625,Delgado; Tania,16,0,30,14
1650430923838,COGS 107A,A01,083627,Boyle; Mary E. T.,0,11,60,60
1650430929859,COGS 118A,A01,083075,Staff,2,0,60,58
1650430935887,CSE 3,A50,083646,Miranda; Gregory Joseph,20,0,38,18
1650430935887,CSE 3,A51,083647,Miranda; Gregory Joseph,36,0,37,1
1650430941919,CSE 8A,A50,083650,Miranda; Gregory Joseph,0,28,40,40
1650430947944,CSE 11,A01,083080,Cao; Yingjun,0,91,40,40
1650430953967,CSE 12,A01,083652,Staff,0,16,100,100
1650430960001,CSE 15L,A01,083654,Staff,0,1,50,50
1650430960001,CSE 15L,A02,083655,Staff,1,0,50,49
1650430966026,CSE 20,A01,083657,Staff,51,0,80,29
1650430972063,CSE 30,A01,083084,Eldon; John,0,76,40,40
1650430978086,CSE 100,A01,083659,Cao; Yingjun,0,66,50,50
1650430984109,CSE 134B,A01,083661,Powell; Thomas Allan,1,33,65,64
1650430990133,CSE 140,A01,083663,Staff,0,2,75,75
1650430996170,CSE 140L,A01,083088,Eldon; John,0,8,75,75
1650431002193,CSE 175,A01,083665,Kumar; Rakesh,7,0,25,18
1650431008219,CSE 190,A00,092507,Dubnov; Shlomo,14,0,20,6
1650431014246,ECE 45,A01,083139,Staff,0,17,40,40
1650431020270,ECE 65,A50,083695,Staff,0,5,30,30
1650431026293,ECE 109,A01,091882,Touri; Behrouz,39,0,70,31
1650431032319,ECE 180,A00,083140,Abi Samra; Nicholas Camill,23,0,30,7
1650431032319,ECE 180,B00,083141,Abi Samra; Nicholas Camill,0,0,30,30
1650431038342,MATH 10A,A01,083735,Patchell; Gregory David,7,0,30,23
1650431038342,MATH 10A,A02,083736,Patchell; Gregory David,28,0,30,2
1650431038342,MATH 10A,A03,083737,Patchell; Gregory David,25,0,30,5
1650431044366,MATH 10B,A01,083207,Staff,0,7,30,30
1650431044366,MATH 10B,A02,083208,Staff,0,7,30,30
1650431044366,MATH 10B,B01,083739,Staff,14,0,30,16
1650431044366,MATH 10B,B02,083740,Staff,28,0,30,2
1650431050396,MATH 18,A01,083743,Staff,2,0,30,28
1650431050396,MATH 18,A02,083744,Staff,27,0,30,3
1650431050396,MATH 18,A03,083745,Staff,22,0,30,8
1650431050396,MATH 18,A04,083746,Staff,26,0,30,4
1650431050396,MATH 18,B01,083748,Staff,1,12,30,29
1650431050396,MATH 18,B02,083749,Staff,0,12,30,30
1650431050396,MATH 18,B03,083750,Staff,1,12,30,29
1650431050396,MATH 18,B04,083751,Staff,0,12,30,30
1650431056420,MATH 20A,A01,083754,Staff,26,0,40,14
1650431062452,MATH 20B,A01,083756,Staff,0,10,30,30
1650431062452,MATH 20B,A02,083757,Staff,0,10,30,30
1650431068491,MATH 20C,A01,083760,Staff,0,14,30,30
1650431068491,MATH 20C,A02,083761,Staff,1,15,30,29
1650431068491,MATH 20C,B01,083762,Staff,13,0,30,17
1650431068491,MATH 20C,B02,083763,Staff,28,0,30,2
1650431074514,MATH 20D,A01,083765,Staff,0,1,30,30
1650431074514,MATH 20D,A02,083766,Staff,9,0,30,21
1650431074514,MATH 20D,A03,083767,Staff,25,0,30,5
1650431080545,MATH 20E,A01,083771,Staff,5,0,30,25
1650431080545,MATH 20E,A02,083772,Staff,18,0,30,12
1650431080545,MATH 20E,B01,083773,Staff,0,0,30,30
1650431080545,MATH 20E,B02,083774,Staff,11,0,30,19
1650431086569,MATH 103A,A01,083777,Staff,0,12,30,30
1650431086569,MATH 103A,A02,083778,Staff,0,12,30,30
1650431086569,MATH 103A,B01,083779,Staff,0,13,30,30
1650431086569,MATH 103A,B02,083780,Staff,0,11,30,30
1650431092596,MATH 105,A01,085443,Staff,0,22,30,30
1650431098620,MATH 109,A01,083213,Anzaldo; Leesa B,0,7,30,30
1650431098620,MATH 109,A02,083214,Anzaldo; Leesa B,0,7,30,30
1650431098620,MATH 109,B01,083215,Anzaldo; Leesa B,0,5,30,30
1650431098620,MATH 109,B02,083216,Anzaldo; Leesa B,0,6,30,30
1650431104649,MATH 142A,A01,083219,Chow; Bennett,0,14,30,30
1650431104649,MATH 142A,A02,083220,Chow; Bennett,0,13,30,30
1650431104649,MATH 142A,B01,083221,Chow; Bennett,0,12,30,30
1650431104649,MATH 142A,B02,083222,Chow; Bennett,0,13,30,30
1650431110673,MATH 193A,A01,083224,Staff,0,5,30,30
1650431110673,MATH 193A,A02,083225,Staff,0,5,30,30
1650431110673,MATH 193A,A03,083781,Staff,0,4,30,30
1650431110673,MATH 193A,A04,083782,Staff,0,4,30,30
1650431116703,MATH 197,001,091859,McAuley; Julian John,9998,0,9999,1
1650431122762,COGS 9,A01,083615,Staff,0,14,60,60
1650431128784,COGS 11,A01,083617,Boyle; Mary E. T.,21,0,40,19
1650431134811,COGS 13,A01,083071,Staff,0,34,40,40
1650431140836,COGS 14A,A01,092681,Staff,0,25,100,100
1650431146863,COGS 14B,A01,083073,Cheng; Tzu-Han,0,11,50,50
1650431152886,COGS 17,A01,092677,Staff,22,0,75,53
1650431158909,COGS 100,A01,083619,Staff,0,26,60,60
1650431164934,COGS 101A,A01,083621,Davis; Joshua Daniel,0,21,60,60
1650431170959,COGS 101B,A01,091572,Staff,0,4,60,60
1650431176986,COGS 101C,A01,083625,Delgado; Tania,16,0,30,14
1650431183012,COGS 107A,A01,083627,Boyle; Mary E. T.,0,11,60,60
1650431189037,COGS 118A,A01,083075,Staff,2,0,60,58
1650431195061,CSE 3,A50,083646,Miranda; Gregory Joseph,20,0,38,18
1650431195061,CSE 3,A51,083647,Miranda; Gregory Joseph,36,0,37,1
1650431201085,CSE 8A,A50,083650,Miranda; Gregory Joseph,0,28,40,40
1650431207108,CSE 11,A01,083080,Cao; Yingjun,0,91,40,40
1650431213131,CSE 12,A01,083652,Staff,0,16,100,100
1650431219162,CSE 15L,A01,083654,Staff,0,1,50,50
1650431219162,CSE 15L,A02,083655,Staff,1,0,50,49
1650431225189,CSE 20,A01,083657,Staff,51,0,80,29
1650431231222,CSE 30,A01,083084,Eldon; John,0,76,40,40
1650431237250,CSE 100,A01,083659,Cao; Yingjun,0,66,50,50
1650431243275,CSE 134B,A01,083661,Powell; Thomas Allan,1,33,65,64
1650431249309,CSE 140,A01,083663,Staff,0,2,75,75
1650431255422,CSE 140L,A01,083088,Eldon; John,0,8,75,75
1650431261445,CSE 175,A01,083665,Kumar; Rakesh,7,0,25,18
1650431267471,CSE 190,A00,092507,Dubnov; Shlomo,14,0,20,6
1650431273497,ECE 45,A01,083139,Staff,0,17,40,40
1650431279521,ECE 65,A50,083695,Staff,0,5,30,30
1650431285547,ECE 109,A01,091882,Touri; Behrouz,39,0,70,31
1650431291570,ECE 180,A00,083140,Abi Samra; Nicholas Camill,23,0,30,7
1650431291570,ECE 180,B00,083141,Abi Samra; Nicholas Camill,0,0,30,30
1650431297594,MATH 10A,A01,083735,Patchell; Gregory David,7,0,30,23
1650431297594,MATH 10A,A02,083736,Patchell; Gregory David,28,0,30,2
1650431297594,MATH 10A,A03,083737,Patchell; Gregory David,25,0,30,5
1650431303622,MATH 10B,A01,083207,Staff,0,7,30,30
1650431303622,MATH 10B,A02,083208,Staff,0,7,30,30
1650431303622,MATH 10B,B01,083739,Staff,14,0,30,16
1650431303622,MATH 10B,B02,083740,Staff,28,0,30,2
1650431309649,MATH 18,A01,083743,Staff,2,0,30,28
1650431309649,MATH 18,A02,083744,Staff,27,0,30,3
1650431309649,MATH 18,A03,083745,Staff,22,0,30,8
1650431309649,MATH 18,A04,083746,Staff,26,0,30,4
1650431309649,MATH 18,B01,083748,Staff,1,12,30,29
1650431309649,MATH 18,B02,083749,Staff,0,12,30,30
1650431309649,MATH 18,B03,083750,Staff,1,12,30,29
1650431309649,MATH 18,B04,083751,Staff,0,12,30,30
1650431315672,MATH 20A,A01,083754,Staff,26,0,40,14
1650431321696,MATH 20B,A01,083756,Staff,0,10,30,30
1650431321696,MATH 20B,A02,083757,Staff,0,10,30,30
1650431327719,MATH 20C,A01,083760,Staff,0,15,30,30
1650431327719,MATH 20C,A02,083761,Staff,1,15,30,29
1650431327719,MATH 20C,B01,083762,Staff,13,0,30,17
1650431327719,MATH 20C,B02,083763,Staff,28,0,30,2
1650431333742,MATH 20D,A01,083765,Staff,0,1,30,30
1650431333742,MATH 20D,A02,083766,Staff,9,0,30,21
1650431333742,MATH 20D,A03,083767,Staff,25,0,30,5
1650431339764,MATH 20E,A01,083771,Staff,5,0,30,25
1650431339764,MATH 20E,A02,083772,Staff,18,0,30,12
1650431339764,MATH 20E,B01,083773,Staff,0,0,30,30
1650431339764,MATH 20E,B02,083774,Staff,11,0,30,19
1650431345794,MATH 103A,A01,083777,Staff,0,12,30,30
1650431345794,MATH 103A,A02,083778,Staff,0,12,30,30
1650431345794,MATH 103A,B01,083779,Staff,0,13,30,30
1650431345794,MATH 103A,B02,083780,Staff,0,11,30,30
1650431351819,MATH 105,A01,085443,Staff,0,22,30,30
1650431357843,MATH 109,A01,083213,Anzaldo; Leesa B,0,7,30,30
1650431357843,MATH 109,A02,083214,Anzaldo; Leesa B,0,7,30,30
1650431357843,MATH 109,B01,083215,Anzaldo; Leesa B,0,5,30,30
1650431357843,MATH 109,B02,083216,Anzaldo; Leesa B,0,6,30,30
1650431363870,MATH 142A,A01,083219,Chow; Bennett,0,14,30,30
1650431363870,MATH 142A,A02,083220,Chow; Bennett,0,13,30,30
1650431363870,MATH 142A,B01,083221,Chow; Bennett,0,12,30,30
1650431363870,MATH 142A,B02,083222,Chow; Bennett,0,13,30,30
1650431369898,MATH 193A,A01,083224,Staff,0,5,30,30
1650431369898,MATH 193A,A02,083225,Staff,0,5,30,30
1650431369898,MATH 193A,A03,083781,Staff,0,4,30,30
1650431369898,MATH 193A,A04,083782,Staff,0,4,30,30
1650431375921,MATH 197,001,091859,McAuley; Julian John,9998,0,9999,1
1650431381994,COGS 9,A01,083615,Staff,0,14,60,60
1650431388020,COGS 11,A01,083617,Boyle; Mary E. T.,21,0,40,19
1650431394053,COGS 13,A01,083071,Staff,0,34,40,40
1650431400080,COGS 14A,A01,092681,Staff,0,25,100,100
1650431406106,COGS 14B,A01,083073,Cheng; Tzu-Han,0,11,50,50
1650431412132,COGS 17,A01,092677,Staff,22,0,75,53
1650431418159,COGS 100,A01,083619,Staff,0,26,60,60
1650431424192,COGS 101A,A01,083621,Davis; Joshua Daniel,0,21,60,60
1650431430219,COGS 101B,A01,091572,Staff,0,4,60,60
1650431436244,COGS 101C,A01,083625,Delgado; Tania,16,0,30,14
1650431442271,COGS 107A,A01,083627,Boyle; Mary E. T.,0,11,60,60
1650431448296,COGS 118A,A01,083075,Staff,2,0,60,58
1650431454320,CSE 3,A50,083646,Miranda; Gregory Joseph,20,0,38,18
1650431454320,CSE 3,A51,083647,Miranda; Gregory Joseph,36,0,37,1
1650431460344,CSE 8A,A50,083650,Miranda; Gregory Joseph,0,28,40,40
1650431466371,CSE 11,A01,083080,Cao; Yingjun,0,91,40,40
1650431472397,CSE 12,A01,083652,Staff,0,16,100,100
1650431478426,CSE 15L,A01,083654,Staff,0,1,50,50
1650431478426,CSE 15L,A02,083655,Staff,1,0,50,49
1650431484449,CSE 20,A01,083657,Staff,51,0,80,29
1650431490483,CSE 30,A01,083084,Eldon; John,0,76,40,40
1650431496506,CSE 100,A01,083659,Cao; Yingjun,0,66,50,50
1650431502531,CSE 134B,A01,083661,Powell; Thomas Allan,1,33,65,64
1650431508553,CSE 140,A01,083663,Staff,0,2,75,75
1650431514580,CSE 140L,A01,083088,Eldon; John,0,8,75,75
1650431520602,CSE 175,A01,083665,Kumar; Rakesh,7,0,25,18
1650431526634,CSE 190,A00,092507,Dubnov; Shlomo,14,0,20,6
1650431532664,ECE 45,A01,083139,Staff,0,17,40,40
1650431538690,ECE 65,A50,083695,Staff,0,5,30,30
1650431544714,ECE 109,A01,091882,Touri; Behrouz,39,0,70,31
1650431550739,ECE 180,A00,083140,Abi Samra; Nicholas Camill,23,0,30,7
1650431550739,ECE 180,B00,083141,Abi Samra; Nicholas Camill,0,0,30,30
1650431556774,MATH 10A,A01,083735,Patchell; Gregory David,7,0,30,23
1650431556774,MATH 10A,A02,083736,Patchell; Gregory David,28,0,30,2
1650431556774,MATH 10A,A03,083737,Patchell; Gregory David,25,0,30,5
1650431562799,MATH 10B,A01,083207,Staff,0,7,30,30
1650431562799,MATH 10B,A02,083208,Staff,0,7,30,30
1650431562799,MATH 10B,B01,083739,Staff,14,0,30,16
1650431562799,MATH 10B,B02,083740,Staff,28,0,30,2
1650431568826,MATH 18,A01,083743,Staff,2,0,30,28
1650431568826,MATH 18,A02,083744,Staff,27,0,30,3
1650431568826,MATH 18,A03,083745,Staff,22,0,30,8
1650431568826,MATH 18,A04,083746,Staff,26,0,30,4
1650431568826,MATH 18,B01,083748,Staff,1,12,30,29
1650431568826,MATH 18,B02,083749,Staff,0,12,30,30
1650431568826,MATH 18,B03,083750,Staff,1,12,30,29
1650431568826,MATH 18,B04,083751,Staff,0,12,30,30
1650431574850,MATH 20A,A01,083754,Staff,26,0,40,14
1650431580877,MATH 20B,A01,083756,Staff,0,10,30,30
1650431580877,MATH 20B,A02,083757,Staff,0,10,30,30
1650431586900,MATH 20C,A01,083760,Staff,0,15,30,30
1650431586900,MATH 20C,A02,083761,Staff,1,15,30,29
1650431586900,MATH 20C,B01,083762,Staff,13,0,30,17
1650431586900,MATH 20C,B02,083763,Staff,28,0,30,2
1650431592925,MATH 20D,A01,083765,Staff,0,1,30,30
1650431592925,MATH 20D,A02,083766,Staff,9,0,30,21
1650431592925,MATH 20D,A03,083767,Staff,25,0,30,5
1650431598950,MATH 20E,A01,083771,Staff,5,0,30,25
1650431598950,MATH 20E,A02,083772,Staff,18,0,30,12
1650431598950,MATH 20E,B01,083773,Staff,0,0,30,30
1650431598950,MATH 20E,B02,083774,Staff,11,0,30,19
1650431604977,MATH 103A,A01,083777,Staff,0,12,30,30
1650431604977,MATH 103A,A02,083778,Staff,0,12,30,30
1650431604977,MATH 103A,B01,083779,Staff,0,13,30,30
1650431604977,MATH 103A,B02,083780,Staff,0,11,30,30
1650431611000,MATH 105,A01,085443,Staff,0,22,30,30
1650431617024,MATH 109,A01,083213,Anzaldo; Leesa B,0,7,30,30
1650431617024,MATH 109,A02,083214,Anzaldo; Leesa B,0,7,30,30
1650431617024,MATH 109,B01,083215,Anzaldo; Leesa B,0,5,30,30
1650431617024,MATH 109,B02,083216,Anzaldo; Leesa B,0,6,30,30
1650431623048,MATH 142A,A01,083219,Chow; Bennett,0,14,30,30
1650431623048,MATH 142A,A02,083220,Chow; Bennett,0,13,30,30
1650431623048,MATH 142A,B01,083221,Chow; Bennett,0,12,30,30
1650431623048,MATH 142A,B02,083222,Chow; Bennett,0,13,30,30
1650431629078,MATH 193A,A01,083224,Staff,0,5,30,30
1650431629078,MATH 193A,A02,083225,Staff,0,5,30,30
1650431629078,MATH 193A,A03,083781,Staff,0,4,30,30
1650431629078,MATH 193A,A04,083782,Staff,0,4,30,30
1650431635101,MATH 197,001,091859,McAuley; Julian John,9998,0,9999,1
1650431641152,COGS 9,A01,083615,Staff,0,14,60,60
1650431647178,COGS 11,A01,083617,Boyle; Mary E. T.,21,0,40,19
1650431653202,COGS 13,A01,083071,Staff,0,34,40,40
1650431659226,COGS 14A,A01,092681,Staff,0,25,100,100
1650431665249,COGS 14B,A01,083073,Cheng; Tzu-Han,0,11,50,50
1650431671272,COGS 17,A01,092677,Staff,22,0,75,53
1650431677296,COGS 100,A01,083619,Staff,0,26,60,60
1650431683321,COGS 101A,A01,083621,Davis; Joshua Daniel,0,21,60,60
1650431689344,COGS 101B,A01,091572,Staff,0,4,60,60
1650431695368,COGS 101C,A01,083625,Delgado; Tania,16,0,30,14
1650431701394,COGS 107A,A01,083627,Boyle; Mary E. T.,0,11,60,60
1650431707433,COGS 118A,A01,083075,Staff,2,0,60,58
1650431713457,CSE 3,A50,083646,Miranda; Gregory Joseph,20,0,38,18
1650431713457,CSE 3,A51,083647,Miranda; Gregory Joseph,36,0,37,1
1650431719482,CSE 8A,A50,083650,Miranda; Gregory Joseph,0,28,40,40
1650431725510,CSE 11,A01,083080,Cao; Yingjun,0,91,40,40
1650431731533,CSE 12,A01,083652,Staff,0,16,100,100
1650431737556,CSE 15L,A01,083654,Staff,0,1,50,50
1650431737556,CSE 15L,A02,083655,Staff,1,0,50,49
1650431743583,CSE 20,A01,083657,Staff,51,0,80,29
1650431749607,CSE 30,A01,083084,Eldon; John,0,76,40,40
1650431755634,CSE 100,A01,083659,Cao; Yingjun,0,66,50,50
1650431761659,CSE 134B,A01,083661,Powell; Thomas Allan,1,33,65,64
1650431767690,CSE 140,A01,083663,Staff,0,2,75,75
1650431773717,CSE 140L,A01,083088,Eldon; John,0,8,75,75
1650431779763,CSE 175,A01,083665,Kumar; Rakesh,7,0,25,18
1650431785790,CSE 190,A00,092507,Dubnov; Shlomo,14,0,20,6
1650431791812,ECE 45,A01,083139,Staff,0,17,40,40
1650431797837,ECE 65,A50,083695,Staff,0,5,30,30
1650431803870,ECE 109,A01,091882,Touri; Behrouz,39,0,70,31
1650431809897,ECE 180,A00,083140,Abi Samra; Nicholas Camill,23,0,30,7
1650431809897,ECE 180,B00,083141,Abi Samra; Nicholas Camill,0,0,30,30
1650431815925,MATH 10A,A01,083735,Patchell; Gregory David,7,0,30,23
1650431815925,MATH 10A,A02,083736,Patchell; Gregory David,28,0,30,2
1650431815925,MATH 10A,A03,083737,Patchell; Gregory David,25,0,30,5
1650431821959,MATH 10B,A01,083207,Staff,0,7,30,30
1650431821959,MATH 10B,A02,083208,Staff,0,7,30,30
1650431821959,MATH 10B,B01,083739,Staff,14,0,30,16
1650431821959,MATH 10B,B02,083740,Staff,28,0,30,2
1650431827985,MATH 18,A01,083743,Staff,2,0,30,28
1650431827985,MATH 18,A02,083744,Staff,27,0,30,3
1650431827985,MATH 18,A03,083745,Staff,22,0,30,8
1650431827985,MATH 18,A04,083746,Staff,26,0,30,4
1650431827985,MATH 18,B01,083748,Staff,1,12,30,29
1650431827985,MATH 18,B02,083749,Staff,0,12,30,30
1650431827985,MATH 18,B03,083750,Staff,1,12,30,29
1650431827985,MATH 18,B04,083751,Staff,0,12,30,30
1650431834010,MATH 20A,A01,083754,Staff,26,0,40,14
1650431840033,MATH 20B,A01,083756,Staff,0,10,30,30
1650431840033,MATH 20B,A02,083757,Staff,0,10,30,30
1650431846062,MATH 20C,A01,083760,Staff,0,15,30,30
1650431846062,MATH 20C,A02,083761,Staff,1,15,30,29
1650431846062,MATH 20C,B01,083762,Staff,13,0,30,17
1650431846062,MATH 20C,B02,083763,Staff,28,0,30,2
1650431852175,MATH 20D,A01,083765,Staff,0,1,30,30
1650431852175,MATH 20D,A02,083766,Staff,9,0,30,21
1650431852175,MATH 20D,A03,083767,Staff,25,0,30,5
1650431858201,MATH 20E,A01,083771,Staff,5,0,30,25
1650431858201,MATH 20E,A02,083772,Staff,18,0,30,12
1650431858201,MATH 20E,B01,083773,Staff,0,0,30,30
1650431858201,MATH 20E,B02,083774,Staff,11,0,30,19
1650431864230,MATH 103A,A01,083777,Staff,0,12,30,30
1650431864230,MATH 103A,A02,083778,Staff,0,12,30,30
1650431864230,MATH 103A,B01,083779,Staff,0,13,30,30
1650431864230,MATH 103A,B02,083780,Staff,0,11,30,30
1650431870252,MATH 105,A01,085443,Staff,0,22,30,30
1650431876278,MATH 109,A01,083213,Anzaldo; Leesa B,0,7,30,30
1650431876278,MATH 109,A02,083214,Anzaldo; Leesa B,0,7,30,30
1650431876278,MATH 109,B01,083215,Anzaldo; Leesa B,0,5,30,30
1650431876278,MATH 109,B02,083216,Anzaldo; Leesa B,0,6,30,30
1650431882301,MATH 142A,A01,083219,Chow; Bennett,0,14,30,30
1650431882301,MATH 142A,A02,083220,Chow; Bennett,0,13,30,30
1650431882301,MATH 142A,B01,083221,Chow; Bennett,0,12,30,30
1650431882301,MATH 142A,B02,083222,Chow; Bennett,0,13,30,30
1650431888328,MATH 193A,A01,083224,Staff,0,5,30,30
1650431888328,MATH 193A,A02,083225,Staff,0,5,30,30
1650431888328,MATH 193A,A03,083781,Staff,0,4,30,30
1650431888328,MATH 193A,A04,083782,Staff,0,4,30,30
1650431894352,MATH 197,001,091859,McAuley; Julian John,9998,0,9999,1
1650431900406,COGS 9,A01,083615,Staff,0,14,60,60
1650431906431,COGS 11,A01,083617,Boyle; Mary E. T.,21,0,40,19
1650431912465,COGS 13,A01,083071,Staff,0,34,40,40
1650431918492,COGS 14A,A01,092681,Staff,0,25,100,100
1650431924516,COGS 14B,A01,083073,Cheng; Tzu-Han,0,11,50,50
1650431930539,COGS 17,A01,092677,Staff,22,0,75,53
1650431936566,COGS 100,A01,083619,Staff,0,26,60,60
1650431942602,COGS 101A,A01,083621,Davis; Joshua Daniel,0,21,60,60
1650431948628,COGS 101B,A01,091572,Staff,0,4,60,60
1650431954652,COGS 101C,A01,083625,Delgado; Tania,16,0,30,14
1650431960683,COGS 107A,A01,083627,Boyle; Mary E. T.,0,11,60,60
1650431966722,COGS 118A,A01,083075,Staff,2,0,60,58
1650431972749,CSE 3,A50,083646,Miranda; Gregory Joseph,20,0,38,18
1650431972749,CSE 3,A51,083647,Miranda; Gregory Joseph,36,0,37,1
1650431978784,CSE 8A,A50,083650,Miranda; Gregory Joseph,0,28,40,40
1650431984808,CSE 11,A01,083080,Cao; Yingjun,0,91,40,40
1650431990832,CSE 12,A01,083652,Staff,0,16,100,100
1650431996857,CSE 15L,A01,083654,Staff,0,1,50,50
1650431996857,CSE 15L,A02,083655,Staff,1,0,50,49
1650432002884,CSE 20,A01,083657,Staff,51,0,80,29
1650432008911,CSE 30,A01,083084,Eldon; John,0,76,40,40
1650432014940,CSE 100,A01,083659,Cao; Yingjun,0,66,50,50
1650432020965,CSE 134B,A01,083661,Powell; Thomas Allan,1,33,65,64
1650432026990,CSE 140,A01,083663,Staff,0,2,75,75
1650432033018,CSE 140L,A01,083088,Eldon; John,0,8,75,75
1650432039043,CSE 175,A01,083665,Kumar; Rakesh,7,0,25,18
1650432045070,CSE 190,A00,092507,Dubnov; Shlomo,14,0,20,6
1650432051093,ECE 45,A01,083139,Staff,0,17,40,40
1650432057116,ECE 65,A50,083695,Staff,0,5,30,30
1650432063141,ECE 109,A01,091882,Touri; Behrouz,39,0,70,31
1650432069166,ECE 180,A00,083140,Abi Samra; Nicholas Camill,23,0,30,7
1650432069166,ECE 180,B00,083141,Abi Samra; Nicholas Camill,0,0,30,30
1650432075190,MATH 10A,A01,083735,Patchell; Gregory David,7,0,30,23
1650432075190,MATH 10A,A02,083736,Patchell; Gregory David,28,0,30,2
1650432075190,MATH 10A,A03,083737,Patchell; Gregory David,25,0,30,5
1650432081220,MATH 10B,A01,083207,Staff,0,7,30,30
1650432081220,MATH 10B,A02,083208,Staff,0,7,30,30
1650432081220,MATH 10B,B01,083739,Staff,14,0,30,16
1650432081220,MATH 10B,B02,083740,Staff,28,0,30,2
1650432087250,MATH 18,A01,083743,Staff,2,0,30,28
1650432087250,MATH 18,A02,083744,Staff,27,0,30,3
1650432087250,MATH 18,A03,083745,Staff,22,0,30,8
1650432087250,MATH 18,A04,083746,Staff,26,0,30,4
1650432087250,MATH 18,B01,083748,Staff,1,12,30,29
1650432087250,MATH 18,B02,083749,Staff,0,12,30,30
1650432087250,MATH 18,B03,083750,Staff,1,12,30,29
1650432087250,MATH 18,B04,083751,Staff,0,12,30,30
1650432093277,MATH 20A,A01,083754,Staff,26,0,40,14
1650432099301,MATH 20B,A01,083756,Staff,0,10,30,30
1650432099301,MATH 20B,A02,083757,Staff,0,10,30,30
1650432105327,MATH 20C,A01,083760,Staff,0,15,30,30
1650432105327,MATH 20C,A02,083761,Staff,1,15,30,29
1650432105327,MATH 20C,B01,083762,Staff,13,0,30,17
1650432105327,MATH 20C,B02,083763,Staff,28,0,30,2
1650432111352,MATH 20D,A01,083765,Staff,0,1,30,30
1650432111352,MATH 20D,A02,083766,Staff,9,0,30,21
1650432111352,MATH 20D,A03,083767,Staff,25,0,30,5
1650432117379,MATH 20E,A01,083771,Staff,5,0,30,25
1650432117379,MATH 20E,A02,083772,Staff,18,0,30,12
1650432117379,MATH 20E,B01,083773,Staff,0,0,30,30
1650432117379,MATH 20E,B02,083774,Staff,11,0,30,19
1650432123420,MATH 103A,A01,083777,Staff,0,12,30,30
1650432123420,MATH 103A,A02,083778,Staff,0,12,30,30
1650432123420,MATH 103A,B01,083779,Staff,0,13,30,30
1650432123420,MATH 103A,B02,083780,Staff,0,11,30,30
1650432129444,MATH 105,A01,085443,Staff,0,22,30,30
1650432135469,MATH 109,A01,083213,Anzaldo; Leesa B,0,7,30,30
1650432135469,MATH 109,A02,083214,Anzaldo; Leesa B,0,7,30,30
1650432135469,MATH 109,B01,083215,Anzaldo; Leesa B,0,5,30,30
1650432135469,MATH 109,B02,083216,Anzaldo; Leesa B,0,6,30,30
1650432141494,MATH 142A,A01,083219,Chow; Bennett,0,14,30,30
1650432141494,MATH 142A,A02,083220,Chow; Bennett,0,13,30,30
1650432141494,MATH 142A,B01,083221,Chow; Bennett,0,12,30,30
1650432141494,MATH 142A,B02,083222,Chow; Bennett,0,13,30,30
1650432147524,MATH 193A,A01,083224,Staff,0,5,30,30
1650432147524,MATH 193A,A02,083225,Staff,0,5,30,30
1650432147524,MATH 193A,A03,083781,Staff,0,4,30,30
1650432147524,MATH 193A,A04,083782,Staff,0,4,30,30
1650432153546,MATH 197,001,091859,McAuley; Julian John,9998,0,9999,1
1650432159597,COGS 9,A01,083615,Staff,0,14,60,60
1650432165633,COGS 11,A01,083617,Boyle; Mary E. T.,21,0,40,19
1650432171659,COGS 13,A01,083071,Staff,0,34,40,40
1650432177684,COGS 14A,A01,092681,Staff,0,25,100,100
1650432183711,COGS 14B,A01,083073,Cheng; Tzu-Han,0,11,50,50
1650432189735,COGS 17,A01,092677,Staff,22,0,75,53
1650432195770,COGS 100,A01,083619,Staff,0,26,60,60
1650432201792,COGS 101A,A01,083621,Davis; Joshua Daniel,0,21,60,60
1650432207817,COGS 101B,A01,091572,Staff,0,4,60,60
1650432213843,COGS 101C,A01,083625,Delgado; Tania,16,0,30,14
1650432219866,COGS 107A,A01,083627,Boyle; Mary E. T.,0,11,60,60
1650432225899,COGS 118A,A01,083075,Staff,2,0,60,58
1650432231922,CSE 3,A50,083646,Miranda; Gregory Joseph,20,0,38,18
1650432231922,CSE 3,A51,083647,Miranda; Gregory Joseph,36,0,37,1
1650432237946,CSE 8A,A50,083650,Miranda; Gregory Joseph,0,28,40,40
1650432243969,CSE 11,A01,083080,Cao; Yingjun,0,91,40,40
1650432249994,CSE 12,A01,083652,Staff,0,16,100,100
1650432256019,CSE 15L,A01,083654,Staff,0,1,50,50
1650432256019,CSE 15L,A02,083655,Staff,1,0,50,49
1650432262045,CSE 20,A01,083657,Staff,51,0,80,29
1650432268073,CSE 30,A01,083084,Eldon; John,0,76,40,40
1650432274097,CSE 100,A01,083659,Cao; Yingjun,0,66,50,50
1650432280123,CSE 134B,A01,083661,Powell; Thomas Allan,1,33,65,64
1650432286145,CSE 140,A01,083663,Staff,0,2,75,75
1650432292169,CSE 140L,A01,083088,Eldon; John,0,8,75,75
1650432298192,CSE 175,A01,083665,Kumar; Rakesh,7,0,25,18
1650432304219,CSE 190,A00,092507,Dubnov; Shlomo,14,0,20,6
1650432310242,ECE 45,A01,083139,Staff,0,17,40,40
1650432316271,ECE 65,A50,083695,Staff,0,5,30,30
1650432322293,ECE 109,A01,091882,Touri; Behrouz,38,0,70,32
1650432328322,ECE 180,A00,083140,Abi Samra; Nicholas Camill,23,0,30,7
1650432328322,ECE 180,B00,083141,Abi Samra; Nicholas Camill,0,0,30,30
1650432334346,MATH 10A,A01,083735,Patchell; Gregory David,7,0,30,23
1650432334346,MATH 10A,A02,083736,Patchell; Gregory David,28,0,30,2
1650432334346,MATH 10A,A03,083737,Patchell; Gregory David,25,0,30,5
1650432340374,MATH 10B,A01,083207,Staff,0,7,30,30
1650432340374,MATH 10B,A02,083208,Staff,0,7,30,30
1650432340374,MATH 10B,B01,083739,Staff,14,0,30,16
1650432340374,MATH 10B,B02,083740,Staff,28,0,30,2
1650432346398,MATH 18,A01,083743,Staff,2,0,30,28
1650432346398,MATH 18,A02,083744,Staff,27,0,30,3
1650432346398,MATH 18,A03,083745,Staff,22,0,30,8
1650432346398,MATH 18,A04,083746,Staff,26,0,30,4
1650432346398,MATH 18,B01,083748,Staff,1,12,30,29
1650432346398,MATH 18,B02,083749,Staff,0,12,30,30
1650432346398,MATH 18,B03,083750,Staff,1,12,30,29
1650432346398,MATH 18,B04,083751,Staff,0,12,30,30
1650432352421,MATH 20A,A01,083754,Staff,26,0,40,14
1650432367278,MATH 20B,A01,083756,Staff,0,10,30,30
1650432367278,MATH 20B,A02,083757,Staff,0,10,30,30
1650432373306,MATH 20C,A01,083760,Staff,0,15,30,30
1650432373306,MATH 20C,A02,083761,Staff,1,15,30,29
1650432373306,MATH 20C,B01,083762,Staff,13,0,30,17
1650432373306,MATH 20C,B02,083763,Staff,28,0,30,2
1650432379333,MATH 20D,A01,083765,Staff,0,1,30,30
1650432379333,MATH 20D,A02,083766,Staff,9,0,30,21
1650432379333,MATH 20D,A03,083767,Staff,25,0,30,5
1650432385357,MATH 20E,A01,083771,Staff,5,0,30,25
1650432385357,MATH 20E,A02,083772,Staff,18,0,30,12
1650432385357,MATH 20E,B01,083773,Staff,0,0,30,30
1650432385357,MATH 20E,B02,083774,Staff,11,0,30,19
1650432391382,MATH 103A,A01,083777,Staff,0,12,30,30
1650432391382,MATH 103A,A02,083778,Staff,0,12,30,30
1650432391382,MATH 103A,B01,083779,Staff,0,13,30,30
1650432391382,MATH 103A,B02,083780,Staff,0,11,30,30
1650432397410,MATH 105,A01,085443,Staff,0,22,30,30
1650432403447,MATH 109,A01,083213,Anzaldo; Leesa B,0,7,30,30
1650432403447,MATH 109,A02,083214,Anzaldo; Leesa B,0,7,30,30
1650432403447,MATH 109,B01,083215,Anzaldo; Leesa B,0,5,30,30
1650432403447,MATH 109,B02,083216,Anzaldo; Leesa B,0,6,30,30
1650432409470,MATH 142A,A01,083219,Chow; Bennett,0,14,30,30
1650432409470,MATH 142A,A02,083220,Chow; Bennett,0,13,30,30
1650432409470,MATH 142A,B01,083221,Chow; Bennett,0,12,30,30
1650432409470,MATH 142A,B02,083222,Chow; Bennett,0,13,30,30
1650432415495,MATH 193A,A01,083224,Staff,0,5,30,30
1650432415495,MATH 193A,A02,083225,Staff,0,5,30,30
1650432415495,MATH 193A,A03,083781,Staff,0,4,30,30
1650432415495,MATH 193A,A04,083782,Staff,0,4,30,30
1650432421521,MATH 197,001,091859,McAuley; Julian John,9998,0,9999,1
1650432427575,COGS 9,A01,083615,Staff,0,14,60,60
1650432433598,COGS 11,A01,083617,Boyle; Mary E. T.,21,0,40,19
1650432439622,COGS 13,A01,083071,Staff,0,34,40,40
1650432445648,COGS 14A,A01,092681,Staff,0,25,100,100
1650432451763,COGS 14B,A01,083073,Cheng; Tzu-Han,0,11,50,50
1650432457789,COGS 17,A01,092677,Staff,22,0,75,53
1650432463822,COGS 100,A01,083619,Staff,0,26,60,60
1650432469867,COGS 101A,A01,083621,Davis; Joshua Daniel,0,21,60,60
1650432475891,COGS 101B,A01,091572,Staff,0,4,60,60
1650432481914,COGS 101C,A01,083625,Delgado; Tania,16,0,30,14
1650432487941,COGS 107A,A01,083627,Boyle; Mary E. T.,0,11,60,60
1650432493966,COGS 118A,A01,083075,Staff,2,0,60,58
1650432499995,CSE 3,A50,083646,Miranda; Gregory Joseph,20,0,38,18
1650432499995,CSE 3,A51,083647,Miranda; Gregory Joseph,36,0,37,1
1650432506023,CSE 8A,A50,083650,Miranda; Gregory Joseph,0,28,40,40
1650432512049,CSE 11,A01,083080,Cao; Yingjun,0,91,40,40
1650432518073,CSE 12,A01,083652,Staff,0,16,100,100
1650432524099,CSE 15L,A01,083654,Staff,0,1,50,50
1650432524099,CSE 15L,A02,083655,Staff,1,0,50,49
1650432530123,CSE 20,A01,083657,Staff,51,0,80,29
1650432536150,CSE 30,A01,083084,Eldon; John,0,76,40,40
1650432542173,CSE 100,A01,083659,Cao; Yingjun,0,66,50,50
1650432548201,CSE 134B,A01,083661,Powell; Thomas Allan,0,32,65,65
1650432554225,CSE 140,A01,083663,Staff,0,2,75,75
1650432560249,CSE 140L,A01,083088,Eldon; John,0,8,75,75
1650432566274,CSE 175,A01,083665,Kumar; Rakesh,7,0,25,18
1650432572298,CSE 190,A00,092507,Dubnov; Shlomo,14,0,20,6
1650432578338,ECE 45,A01,083139,Staff,0,17,40,40
1650432584365,ECE 65,A50,083695,Staff,0,5,30,30
1650432590439,ECE 109,A01,091882,Touri; Behrouz,38,0,70,32
1650432596463,ECE 180,A00,083140,Abi Samra; Nicholas Camill,23,0,30,7
1650432596463,ECE 180,B00,083141,Abi Samra; Nicholas Camill,0,0,30,30
1650432602486,MATH 10A,A01,083735,Patchell; Gregory David,7,0,30,23
1650432602486,MATH 10A,A02,083736,Patchell; Gregory David,28,0,30,2
1650432602486,MATH 10A,A03,083737,Patchell; Gregory David,25,0,30,5
1650432608512,MATH 10B,A01,083207,Staff,0,7,30,30
1650432608512,MATH 10B,A02,083208,Staff,0,7,30,30
1650432608512,MATH 10B,B01,083739,Staff,14,0,30,16
1650432608512,MATH 10B,B02,083740,Staff,28,0,30,2
1650432614537,MATH 18,A01,083743,Staff,2,0,30,28
1650432614537,MATH 18,A02,083744,Staff,27,0,30,3
1650432614537,MATH 18,A03,083745,Staff,22,0,30,8
1650432614537,MATH 18,A04,083746,Staff,26,0,30,4
1650432614537,MATH 18,B01,083748,Staff,0,11,30,30
1650432614537,MATH 18,B02,083749,Staff,0,12,30,30
1650432614537,MATH 18,B03,083750,Staff,0,11,30,30
1650432614537,MATH 18,B04,083751,Staff,0,12,30,30
1650432620560,MATH 20A,A01,083754,Staff,26,0,40,14
1650432626583,MATH 20B,A01,083756,Staff,0,10,30,30
1650432626583,MATH 20B,A02,083757,Staff,0,10,30,30
1650432632643,MATH 20C,A01,083760,Staff,0,15,30,30
1650432632643,MATH 20C,A02,083761,Staff,1,14,30,29
1650432632643,MATH 20C,B01,083762,Staff,13,0,30,17
1650432632643,MATH 20C,B02,083763,Staff,28,0,30,2
1650432638668,MATH 20D,A01,083765,Staff,0,1,30,30
1650432638668,MATH 20D,A02,083766,Staff,9,0,30,21
1650432638668,MATH 20D,A03,083767,Staff,25,0,30,5
1650432644691,MATH 20E,A01,083771,Staff,5,0,30,25
1650432644691,MATH 20E,A02,083772,Staff,18,0,30,12
1650432644691,MATH 20E,B01,083773,Staff,0,0,30,30
1650432644691,MATH 20E,B02,083774,Staff,11,0,30,19
1650432650716,MATH 103A,A01,083777,Staff,0,12,30,30
1650432650716,MATH 103A,A02,083778,Staff,0,12,30,30
1650432650716,MATH 103A,B01,083779,Staff,0,13,30,30
1650432650716,MATH 103A,B02,083780,Staff,0,11,30,30
1650432656743,MATH 105,A01,085443,Staff,0,22,30,30
1650432662786,MATH 109,A01,083213,Anzaldo; Leesa B,0,7,30,30
1650432662786,MATH 109,A02,083214,Anzaldo; Leesa B,0,7,30,30
1650432662786,MATH 109,B01,083215,Anzaldo; Leesa B,0,5,30,30
1650432662786,MATH 109,B02,083216,Anzaldo; Leesa B,0,6,30,30
1650432668819,MATH 142A,A01,083219,Chow; Bennett,0,14,30,30
1650432668819,MATH 142A,A02,083220,Chow; Bennett,0,13,30,30
1650432668819,MATH 142A,B01,083221,Chow; Bennett,0,12,30,30
1650432668819,MATH 142A,B02,083222,Chow; Bennett,0,13,30,30
1650432674846,MATH 193A,A01,083224,Staff,0,5,30,30
1650432674846,MATH 193A,A02,083225,Staff,0,5,30,30
1650432674846,MATH 193A,A03,083781,Staff,0,4,30,30
1650432674846,MATH 193A,A04,083782,Staff,0,4,30,30
1650432680872,MATH 197,001,091859,McAuley; Julian John,9998,0,9999,1
1650432686930,COGS 9,A01,083615,Staff,0,14,60,60
1650432692954,COGS 11,A01,083617,Boyle; Mary E. T.,21,0,40,19
1650432698977,COGS 13,A01,083071,Staff,0,34,40,40
1650432705003,COGS 14A,A01,092681,Staff,0,25,100,100
1650432711027,COGS 14B,A01,083073,Cheng; Tzu-Han,0,11,50,50
1650432717051,COGS 17,A01,092677,Staff,22,0,75,53
1650432723114,COGS 100,A01,083619,Staff,0,26,60,60
1650432729137,COGS 101A,A01,083621,Davis; Joshua Daniel,0,21,60,60
1650432735160,COGS 101B,A01,091572,Staff,0,4,60,60
1650432741185,COGS 101C,A01,083625,Delgado; Tania,16,0,30,14
1650432747210,COGS 107A,A01,083627,Boyle; Mary E. T.,0,11,60,60
1650432753236,COGS 118A,A01,083075,Staff,2,0,60,58
1650432759327,CSE 3,A50,083646,Miranda; Gregory Joseph,20,0,38,18
1650432759327,CSE 3,A51,083647,Miranda; Gregory Joseph,36,0,37,1
1650432765361,CSE 8A,A50,083650,Miranda; Gregory Joseph,0,28,40,40
1650432771386,CSE 11,A01,083080,Cao; Yingjun,0,91,40,40
1650432777410,CSE 12,A01,083652,Staff,0,16,100,100
1650432783438,CSE 15L,A01,083654,Staff,0,1,50,50
1650432783438,CSE 15L,A02,083655,Staff,1,0,50,49
1650432789468,CSE 20,A01,083657,Staff,51,0,80,29
1650432795494,CSE 30,A01,083084,Eldon; John,0,76,40,40
1650432801517,CSE 100,A01,083659,Cao; Yingjun,0,66,50,50
1650432807552,CSE 134B,A01,083661,Powell; Thomas Allan,0,32,65,65
1650432813573,CSE 140,A01,083663,Staff,0,2,75,75
1650432819599,CSE 140L,A01,083088,Eldon; John,0,8,75,75
1650432825623,CSE 175,A01,083665,Kumar; Rakesh,7,0,25,18
1650432831645,CSE 190,A00,092507,Dubnov; Shlomo,14,0,20,6
1650432837672,ECE 45,A01,083139,Staff,0,17,40,40
1650432843697,ECE 65,A50,083695,Staff,0,5,30,30
1650432849726,ECE 109,A01,091882,Touri; Behrouz,38,0,70,32
1650432855749,ECE 180,A00,083140,Abi Samra; Nicholas Camill,23,0,30,7
1650432855749,ECE 180,B00,083141,Abi Samra; Nicholas Camill,0,0,30,30
1650432861776,MATH 10A,A01,083735,Patchell; Gregory David,7,0,30,23
1650432861776,MATH 10A,A02,083736,Patchell; Gregory David,28,0,30,2
1650432861776,MATH 10A,A03,083737,Patchell; Gregory David,25,0,30,5
1650432867799,MATH 10B,A01,083207,Staff,0,7,30,30
1650432867799,MATH 10B,A02,083208,Staff,0,7,30,30
1650432867799,MATH 10B,B01,083739,Staff,14,0,30,16
1650432867799,MATH 10B,B02,083740,Staff,28,0,30,2
1650432873824,MATH 18,A01,083743,Staff,2,0,30,28
1650432873824,MATH 18,A02,083744,Staff,27,0,30,3
1650432873824,MATH 18,A03,083745,Staff,22,0,30,8
1650432873824,MATH 18,A04,083746,Staff,26,0,30,4
1650432873824,MATH 18,B01,083748,Staff,0,11,30,30
1650432873824,MATH 18,B02,083749,Staff,0,12,30,30
1650432873824,MATH 18,B03,083750,Staff,0,11,30,30
1650432873824,MATH 18,B04,083751,Staff,0,12,30,30
1650432879850,MATH 20A,A01,083754,Staff,26,0,40,14
1650432885877,MATH 20B,A01,083756,Staff,0,10,30,30
1650432885877,MATH 20B,A02,083757,Staff,0,10,30,30
1650432891926,MATH 20C,A01,083760,Staff,0,15,30,30
1650432891926,MATH 20C,A02,083761,Staff,1,14,30,29
1650432891926,MATH 20C,B01,083762,Staff,13,0,30,17
1650432891926,MATH 20C,B02,083763,Staff,28,0,30,2
1650432897953,MATH 20D,A01,083765,Staff,0,1,30,30
1650432897953,MATH 20D,A02,083766,Staff,9,0,30,21
1650432897953,MATH 20D,A03,083767,Staff,25,0,30,5
1650432903980,MATH 20E,A01,083771,Staff,5,0,30,25
1650432903980,MATH 20E,A02,083772,Staff,18,0,30,12
1650432903980,MATH 20E,B01,083773,Staff,0,0,30,30
1650432903980,MATH 20E,B02,083774,Staff,11,0,30,19
1650432910010,MATH 103A,A01,083777,Staff,0,12,30,30
1650432910010,MATH 103A,A02,083778,Staff,0,12,30,30
1650432910010,MATH 103A,B01,083779,Staff,0,13,30,30
1650432910010,MATH 103A,B02,083780,Staff,0,11,30,30
1650432916033,MATH 105,A01,085443,Staff,0,22,30,30
1650432922064,MATH 109,A01,083213,Anzaldo; Leesa B,0,7,30,30
1650432922064,MATH 109,A02,083214,Anzaldo; Leesa B,0,7,30,30
1650432922064,MATH 109,B01,083215,Anzaldo; Leesa B,0,5,30,30
1650432922064,MATH 109,B02,083216,Anzaldo; Leesa B,0,6,30,30
1650432928094,MATH 142A,A01,083219,Chow; Bennett,0,14,30,30
1650432928094,MATH 142A,A02,083220,Chow; Bennett,0,13,30,30
1650432928094,MATH 142A,B01,083221,Chow; Bennett,0,12,30,30
1650432928094,MATH 142A,B02,083222,Chow; Bennett,0,13,30,30
1650432934119,MATH 193A,A01,083224,Staff,0,5,30,30
1650432934119,MATH 193A,A02,083225,Staff,0,5,30,30
1650432934119,MATH 193A,A03,083781,Staff,0,4,30,30
1650432934119,MATH 193A,A04,083782,Staff,0,4,30,30
1650432940145,MATH 197,001,091859,McAuley; Julian John,9998,0,9999,1
1650432946228,COGS 9,A01,083615,Staff,0,14,60,60
1650432952255,COGS 11,A01,083617,Boyle; Mary E. T.,21,0,40,19
1650432958280,COGS 13,A01,083071,Staff,0,34,40,40
1650432964304,COGS 14A,A01,092681,Staff,0,25,100,100
1650432970325,COGS 14B,A01,083073,Cheng; Tzu-Han,0,11,50,50
1650432976353,COGS 17,A01,092677,Staff,22,0,75,53
1650432982378,COGS 100,A01,083619,Staff,0,26,60,60
1650432988400,COGS 101A,A01,083621,Davis; Joshua Daniel,0,21,60,60
1650432994427,COGS 101B,A01,091572,Staff,0,4,60,60
1650433000451,COGS 101C,A01,083625,Delgado; Tania,16,0,30,14
1650433006481,COGS 107A,A01,083627,Boyle; Mary E. T.,0,11,60,60
1650433012505,COGS 118A,A01,083075,Staff,2,0,60,58
1650433018541,CSE 3,A50,083646,Miranda; Gregory Joseph,20,0,38,18
1650433018541,CSE 3,A51,083647,Miranda; Gregory Joseph,36,0,37,1
1650433024565,CSE 8A,A50,083650,Miranda; Gregory Joseph,0,28,40,40
1650433030593,CSE 11,A01,083080,Cao; Yingjun,0,91,40,40
1650433036618,CSE 12,A01,083652,Staff,0,16,100,100
1650433042651,CSE 15L,A01,083654,Staff,0,1,50,50
1650433042651,CSE 15L,A02,083655,Staff,1,0,50,49
1650433048770,CSE 20,A01,083657,Staff,51,0,80,29
1650433054795,CSE 30,A01,083084,Eldon; John,0,76,40,40
1650433060821,CSE 100,A01,083659,Cao; Yingjun,0,66,50,50
1650433066845,CSE 134B,A01,083661,Powell; Thomas Allan,0,32,65,65
1650433072872,CSE 140,A01,083663,Staff,0,2,75,75
1650433078896,CSE 140L,A01,083088,Eldon; John,0,8,75,75
1650433084919,CSE 175,A01,083665,Kumar; Rakesh,7,0,25,18
1650433090943,CSE 190,A00,092507,Dubnov; Shlomo,14,0,20,6
1650433096970,ECE 45,A01,083139,Staff,0,17,40,40
1650433102993,ECE 65,A50,083695,Staff,0,5,30,30
1650433109018,ECE 109,A01,091882,Touri; Behrouz,38,0,70,32
1650433115048,ECE 180,A00,083140,Abi Samra; Nicholas Camill,23,0,30,7
1650433115048,ECE 180,B00,083141,Abi Samra; Nicholas Camill,0,0,30,30
1650433121073,MATH 10A,A01,083735,Patchell; Gregory David,7,0,30,23
1650433121073,MATH 10A,A02,083736,Patchell; Gregory David,28,0,30,2
1650433121073,MATH 10A,A03,083737,Patchell; Gregory David,25,0,30,5
1650433127098,MATH 10B,A01,083207,Staff,0,7,30,30
1650433127098,MATH 10B,A02,083208,Staff,0,7,30,30
1650433127098,MATH 10B,B01,083739,Staff,14,0,30,16
1650433127098,MATH 10B,B02,083740,Staff,28,0,30,2
1650433133123,MATH 18,A01,083743,Staff,2,0,30,28
1650433133123,MATH 18,A02,083744,Staff,27,0,30,3
1650433133123,MATH 18,A03,083745,Staff,22,0,30,8
1650433133123,MATH 18,A04,083746,Staff,26,0,30,4
1650433133123,MATH 18,B01,083748,Staff,0,11,30,30
1650433133123,MATH 18,B02,083749,Staff,0,12,30,30
1650433133123,MATH 18,B03,083750,Staff,0,11,30,30
1650433133123,MATH 18,B04,083751,Staff,0,12,30,30
1650433139147,MATH 20A,A01,083754,Staff,26,0,40,14
1650433145175,MATH 20B,A01,083756,Staff,0,10,30,30
1650433145175,MATH 20B,A02,083757,Staff,0,10,30,30
1650433151198,MATH 20C,A01,083760,Staff,0,15,30,30
1650433151198,MATH 20C,A02,083761,Staff,1,14,30,29
1650433151198,MATH 20C,B01,083762,Staff,13,0,30,17
1650433151198,MATH 20C,B02,083763,Staff,28,0,30,2
1650433157222,MATH 20D,A01,083765,Staff,0,1,30,30
1650433157222,MATH 20D,A02,083766,Staff,9,0,30,21
1650433157222,MATH 20D,A03,083767,Staff,25,0,30,5
1650433163256,MATH 20E,A01,083771,Staff,5,0,30,25
1650433163256,MATH 20E,A02,083772,Staff,18,0,30,12
1650433163256,MATH 20E,B01,083773,Staff,0,0,30,30
1650433163256,MATH 20E,B02,083774,Staff,11,0,30,19
1650433169284,MATH 103A,A01,083777,Staff,0,12,30,30
1650433169284,MATH 103A,A02,083778,Staff,0,12,30,30
1650433169284,MATH 103A,B01,083779,Staff,0,13,30,30
1650433169284,MATH 103A,B02,083780,Staff,0,11,30,30
1650433175310,MATH 105,A01,085443,Staff,0,22,30,30
1650433181335,MATH 109,A01,083213,Anzaldo; Leesa B,0,7,30,30
1650433181335,MATH 109,A02,083214,Anzaldo; Leesa B,0,7,30,30
1650433181335,MATH 109,B01,083215,Anzaldo; Leesa B,0,5,30,30
1650433181335,MATH 109,B02,083216,Anzaldo; Leesa B,0,6,30,30
1650433187363,MATH 142A,A01,083219,Chow; Bennett,0,14,30,30
1650433187363,MATH 142A,A02,083220,Chow; Bennett,0,13,30,30
1650433187363,MATH 142A,B01,083221,Chow; Bennett,0,12,30,30
1650433187363,MATH 142A,B02,083222,Chow; Bennett,0,13,30,30
1650433193406,MATH 193A,A01,083224,Staff,0,5,30,30
1650433193406,MATH 193A,A02,083225,Staff,0,5,30,30
1650433193406,MATH 193A,A03,083781,Staff,0,4,30,30
1650433193406,MATH 193A,A04,083782,Staff,0,4,30,30
1650433199430,MATH 197,001,091859,McAuley; Julian John,9998,0,9999,1
1650433205482,COGS 9,A01,083615,Staff,0,14,60,60
1650433211508,COGS 11,A01,083617,Boyle; Mary E. T.,21,0,40,19
1650433217532,COGS 13,A01,083071,Staff,0,34,40,40
1650433223564,COGS 14A,A01,092681,Staff,0,25,100,100
1650433229589,COGS 14B,A01,083073,Cheng; Tzu-Han,0,11,50,50
1650433235624,COGS 17,A01,092677,Staff,22,0,75,53
1650433241653,COGS 100,A01,083619,Staff,0,26,60,60
1650433247681,COGS 101A,A01,083621,Davis; Joshua Daniel,0,21,60,60
1650433253715,COGS 101B,A01,091572,Staff,0,4,60,60
1650433259741,COGS 101C,A01,083625,Delgado; Tania,16,0,30,14
1650433265768,COGS 107A,A01,083627,Boyle; Mary E. T.,0,11,60,60
1650433271792,COGS 118A,A01,083075,Staff,2,0,60,58
1650433277819,CSE 3,A50,083646,Miranda; Gregory Joseph,20,0,38,18
1650433277819,CSE 3,A51,083647,Miranda; Gregory Joseph,36,0,37,1
1650433283843,CSE 8A,A50,083650,Miranda; Gregory Joseph,0,28,40,40
1650433289876,CSE 11,A01,083080,Cao; Yingjun,0,91,40,40
1650433295909,CSE 12,A01,083652,Staff,0,16,100,100
1650433301937,CSE 15L,A01,083654,Staff,0,1,50,50
1650433301937,CSE 15L,A02,083655,Staff,1,0,50,49
1650433307966,CSE 20,A01,083657,Staff,51,0,80,29
1650433313990,CSE 30,A01,083084,Eldon; John,0,76,40,40
1650433320020,CSE 100,A01,083659,Cao; Yingjun,0,66,50,50
1650433326043,CSE 134B,A01,083661,Powell; Thomas Allan,0,32,65,65
1650433332069,CSE 140,A01,083663,Staff,0,2,75,75
1650433338094,CSE 140L,A01,083088,Eldon; John,0,8,75,75
1650433344121,CSE 175,A01,083665,Kumar; Rakesh,7,0,25,18
1650433350158,CSE 190,A00,092507,Dubnov; Shlomo,14,0,20,6
1650433356184,ECE 45,A01,083139,Staff,0,17,40,40
1650433362207,ECE 65,A50,083695,Staff,0,5,30,30
1650433368231,ECE 109,A01,091882,Touri; Behrouz,38,0,70,32
1650433374255,ECE 180,A00,083140,Abi Samra; Nicholas Camill,23,0,30,7
1650433374255,ECE 180,B00,083141,Abi Samra; Nicholas Camill,0,0,30,30
1650433380279,MATH 10A,A01,083735,Patchell; Gregory David,7,0,30,23
1650433380279,MATH 10A,A02,083736,Patchell; Gregory David,28,0,30,2
1650433380279,MATH 10A,A03,083737,Patchell; Gregory David,25,0,30,5
1650433386303,MATH 10B,A01,083207,Staff,0,7,30,30
1650433386303,MATH 10B,A02,083208,Staff,0,7,30,30
1650433386303,MATH 10B,B01,083739,Staff,14,0,30,16
1650433386303,MATH 10B,B02,083740,Staff,28,0,30,2
1650433392328,MATH 18,A01,083743,Staff,2,0,30,28
1650433392328,MATH 18,A02,083744,Staff,27,0,30,3
1650433392328,MATH 18,A03,083745,Staff,22,0,30,8
1650433392328,MATH 18,A04,083746,Staff,26,0,30,4
1650433392328,MATH 18,B01,083748,Staff,0,11,30,30
1650433392328,MATH 18,B02,083749,Staff,0,12,30,30
1650433392328,MATH 18,B03,083750,Staff,0,11,30,30
1650433392328,MATH 18,B04,083751,Staff,0,12,30,30
1650433398354,MATH 20A,A01,083754,Staff,26,0,40,14
1650433404385,MATH 20B,A01,083756,Staff,0,10,30,30
1650433404385,MATH 20B,A02,083757,Staff,0,10,30,30
1650433410415,MATH 20C,A01,083760,Staff,0,15,30,30
1650433410415,MATH 20C,A02,083761,Staff,1,14,30,29
1650433410415,MATH 20C,B01,083762,Staff,13,0,30,17
1650433410415,MATH 20C,B02,083763,Staff,28,0,30,2
1650433416439,MATH 20D,A01,083765,Staff,0,1,30,30
1650433416439,MATH 20D,A02,083766,Staff,9,0,30,21
1650433416439,MATH 20D,A03,083767,Staff,25,0,30,5
1650433422463,MATH 20E,A01,083771,Staff,5,0,30,25
1650433422463,MATH 20E,A02,083772,Staff,18,0,30,12
1650433422463,MATH 20E,B01,083773,Staff,0,0,30,30
1650433422463,MATH 20E,B02,083774,Staff,11,0,30,19
1650433428491,MATH 103A,A01,083777,Staff,0,12,30,30
1650433428491,MATH 103A,A02,083778,Staff,0,12,30,30
1650433428491,MATH 103A,B01,083779,Staff,0,13,30,30
1650433428491,MATH 103A,B02,083780,Staff,0,11,30,30
1650433434516,MATH 105,A01,085443,Staff,0,22,30,30
1650433440546,MATH 109,A01,083213,Anzaldo; Leesa B,0,7,30,30
1650433440546,MATH 109,A02,083214,Anzaldo; Leesa B,0,7,30,30
1650433440546,MATH 109,B01,083215,Anzaldo; Leesa B,0,5,30,30
1650433440546,MATH 109,B02,083216,Anzaldo; Leesa B,0,6,30,30
1650433446572,MATH 142A,A01,083219,Chow; Bennett,0,14,30,30
1650433446572,MATH 142A,A02,083220,Chow; Bennett,0,13,30,30
1650433446572,MATH 142A,B01,083221,Chow; Bennett,0,12,30,30
1650433446572,MATH 142A,B02,083222,Chow; Bennett,0,13,30,30
1650433452597,MATH 193A,A01,083224,Staff,0,5,30,30
1650433452597,MATH 193A,A02,083225,Staff,0,5,30,30
1650433452597,MATH 193A,A03,083781,Staff,0,4,30,30
1650433452597,MATH 193A,A04,083782,Staff,0,4,30,30
1650433458636,MATH 197,001,091859,McAuley; Julian John,9998,0,9999,1
1650433464688,COGS 9,A01,083615,Staff,0,14,60,60
1650433470716,COGS 11,A01,083617,Boyle; Mary E. T.,21,0,40,19
1650433476747,COGS 13,A01,083071,Staff,0,34,40,40
1650433482770,COGS 14A,A01,092681,Staff,0,25,100,100
1650433488794,COGS 14B,A01,083073,Cheng; Tzu-Han,0,11,50,50
1650433494817,COGS 17,A01,092677,Staff,22,0,75,53
1650433500854,COGS 100,A01,083619,Staff,0,26,60,60
1650433506877,COGS 101A,A01,083621,Davis; Joshua Daniel,0,21,60,60
1650433512900,COGS 101B,A01,091572,Staff,0,4,60,60
1650433518928,COGS 101C,A01,083625,Delgado; Tania,16,0,30,14
1650433524952,COGS 107A,A01,083627,Boyle; Mary E. T.,0,11,60,60
1650433530976,COGS 118A,A01,083075,Staff,2,0,60,58
1650433537004,CSE 3,A50,083646,Miranda; Gregory Joseph,20,0,38,18
1650433537004,CSE 3,A51,083647,Miranda; Gregory Joseph,36,0,37,1
1650433543031,CSE 8A,A50,083650,Miranda; Gregory Joseph,0,28,40,40
1650433549055,CSE 11,A01,083080,Cao; Yingjun,0,91,40,40
1650433555082,CSE 12,A01,083652,Staff,0,16,100,100
1650433561111,CSE 15L,A01,083654,Staff,0,1,50,50
1650433561111,CSE 15L,A02,083655,Staff,1,0,50,49
1650433567145,CSE 20,A01,083657,Staff,51,0,80,29
1650433573171,CSE 30,A01,083084,Eldon; John,0,76,40,40
1650433579195,CSE 100,A01,083659,Cao; Yingjun,0,66,50,50
1650433585233,CSE 134B,A01,083661,Powell; Thomas Allan,0,32,65,65
1650433591259,CSE 140,A01,083663,Staff,0,2,75,75
1650433597287,CSE 140L,A01,083088,Eldon; John,0,8,75,75
1650433603313,CSE 175,A01,083665,Kumar; Rakesh,7,0,25,18
1650433609349,CSE 190,A00,092507,Dubnov; Shlomo,14,0,20,6
1650433615371,ECE 45,A01,083139,Staff,0,18,40,40
1650433621402,ECE 65,A50,083695,Staff,0,6,30,30
1650433627437,ECE 109,A01,091882,Touri; Behrouz,38,0,70,32
1650433633465,ECE 180,A00,083140,Abi Samra; Nicholas Camill,23,0,30,7
1650433633465,ECE 180,B00,083141,Abi Samra; Nicholas Camill,0,0,30,30
1650433639490,MATH 10A,A01,083735,Patchell; Gregory David,7,0,30,23
1650433639490,MATH 10A,A02,083736,Patchell; Gregory David,28,0,30,2
1650433639490,MATH 10A,A03,083737,Patchell; Gregory David,25,0,30,5
1650433645605,MATH 10B,A01,083207,Staff,0,7,30,30
1650433645605,MATH 10B,A02,083208,Staff,0,7,30,30
1650433645605,MATH 10B,B01,083739,Staff,14,0,30,16
1650433645605,MATH 10B,B02,083740,Staff,28,0,30,2
1650433651636,MATH 18,A01,083743,Staff,2,0,30,28
1650433651636,MATH 18,A02,083744,Staff,27,0,30,3
1650433651636,MATH 18,A03,083745,Staff,22,0,30,8
1650433651636,MATH 18,A04,083746,Staff,26,0,30,4
1650433651636,MATH 18,B01,083748,Staff,0,11,30,30
1650433651636,MATH 18,B02,083749,Staff,0,12,30,30
1650433651636,MATH 18,B03,083750,Staff,0,11,30,30
1650433651636,MATH 18,B04,083751,Staff,0,12,30,30
1650433657659,MATH 20A,A01,083754,Staff,26,0,40,14
1650433663686,MATH 20B,A01,083756,Staff,0,10,30,30
1650433663686,MATH 20B,A02,083757,Staff,0,10,30,30
1650433669709,MATH 20C,A01,083760,Staff,0,15,30,30
1650433669709,MATH 20C,A02,083761,Staff,1,14,30,29
1650433669709,MATH 20C,B01,083762,Staff,13,0,30,17
1650433669709,MATH 20C,B02,083763,Staff,28,0,30,2
1650433675736,MATH 20D,A01,083765,Staff,0,1,30,30
1650433675736,MATH 20D,A02,083766,Staff,9,0,30,21
1650433675736,MATH 20D,A03,083767,Staff,25,0,30,5
1650433681771,MATH 20E,A01,083771,Staff,5,0,30,25
1650433681771,MATH 20E,A02,083772,Staff,18,0,30,12
1650433681771,MATH 20E,B01,083773,Staff,0,0,30,30
1650433681771,MATH 20E,B02,083774,Staff,11,0,30,19
1650433687793,MATH 103A,A01,083777,Staff,0,12,30,30
1650433687793,MATH 103A,A02,083778,Staff,0,12,30,30
1650433687793,MATH 103A,B01,083779,Staff,0,13,30,30
1650433687793,MATH 103A,B02,083780,Staff,0,11,30,30
1650433693818,MATH 105,A01,085443,Staff,0,22,30,30
1650433699849,MATH 109,A01,083213,Anzaldo; Leesa B,0,7,30,30
1650433699849,MATH 109,A02,083214,Anzaldo; Leesa B,0,7,30,30
1650433699849,MATH 109,B01,083215,Anzaldo; Leesa B,0,5,30,30
1650433699849,MATH 109,B02,083216,Anzaldo; Leesa B,0,6,30,30
1650433705877,MATH 142A,A01,083219,Chow; Bennett,0,14,30,30
1650433705877,MATH 142A,A02,083220,Chow; Bennett,0,13,30,30
1650433705877,MATH 142A,B01,083221,Chow; Bennett,0,12,30,30
1650433705877,MATH 142A,B02,083222,Chow; Bennett,0,13,30,30
1650433711906,MATH 193A,A01,083224,Staff,0,5,30,30
1650433711906,MATH 193A,A02,083225,Staff,0,5,30,30
1650433711906,MATH 193A,A03,083781,Staff,0,4,30,30
1650433711906,MATH 193A,A04,083782,Staff,0,4,30,30
1650433717931,MATH 197,001,091859,McAuley; Julian John,9998,0,9999,1
1650433723986,COGS 9,A01,083615,Staff,0,14,60,60
1650433730022,COGS 11,A01,083617,Boyle; Mary E. T.,21,0,40,19
1650433736048,COGS 13,A01,083071,Staff,0,34,40,40
1650433742074,COGS 14A,A01,092681,Staff,0,25,100,100
1650433748099,COGS 14B,A01,083073,Cheng; Tzu-Han,0,11,50,50
1650433754125,COGS 17,A01,092677,Staff,22,0,75,53
1650433760151,COGS 100,A01,083619,Staff,0,26,60,60
1650433766174,COGS 101A,A01,083621,Davis; Joshua Daniel,0,21,60,60
1650433772204,COGS 101B,A01,091572,Staff,0,4,60,60
1650433778228,COGS 101C,A01,083625,Delgado; Tania,16,0,30,14
1650433784255,COGS 107A,A01,083627,Boyle; Mary E. T.,0,11,60,60
1650433790278,COGS 118A,A01,083075,Staff,2,0,60,58
1650433796307,CSE 3,A50,083646,Miranda; Gregory Joseph,20,0,38,18
1650433796307,CSE 3,A51,083647,Miranda; Gregory Joseph,36,0,37,1
1650433802330,CSE 8A,A50,083650,Miranda; Gregory Joseph,0,28,40,40
1650433808362,CSE 11,A01,083080,Cao; Yingjun,0,91,40,40
1650433814389,CSE 12,A01,083652,Staff,0,16,100,100
1650433820427,CSE 15L,A01,083654,Staff,0,1,50,50
1650433820427,CSE 15L,A02,083655,Staff,1,0,50,49
1650433826453,CSE 20,A01,083657,Staff,51,0,80,29
1650433832484,CSE 30,A01,083084,Eldon; John,0,76,40,40
1650433838515,CSE 100,A01,083659,Cao; Yingjun,0,66,50,50
1650433844539,CSE 134B,A01,083661,Powell; Thomas Allan,0,32,65,65
1650433850560,CSE 140,A01,083663,Staff,0,2,75,75
1650433856587,CSE 140L,A01,083088,Eldon; John,0,8,75,75
1650433862611,CSE 175,A01,083665,Kumar; Rakesh,7,0,25,18
1650433868635,CSE 190,A00,092507,Dubnov; Shlomo,14,0,20,6
1650433874662,ECE 45,A01,083139,Staff,0,18,40,40
1650433880686,ECE 65,A50,083695,Staff,0,6,30,30
1650433886715,ECE 109,A01,091882,Touri; Behrouz,38,0,70,32
1650433892741,ECE 180,A00,083140,Abi Samra; Nicholas Camill,23,0,30,7
1650433892741,ECE 180,B00,083141,Abi Samra; Nicholas Camill,0,0,30,30
1650433898765,MATH 10A,A01,083735,Patchell; Gregory David,7,0,30,23
1650433898765,MATH 10A,A02,083736,Patchell; Gregory David,28,0,30,2
1650433898765,MATH 10A,A03,083737,Patchell; Gregory David,25,0,30,5
1650433904798,MATH 10B,A01,083207,Staff,0,7,30,30
1650433904798,MATH 10B,A02,083208,Staff,0,7,30,30
1650433904798,MATH 10B,B01,083739,Staff,13,0,30,17
1650433904798,MATH 10B,B02,083740,Staff,28,0,30,2
1650433910824,MATH 18,A01,083743,Staff,2,0,30,28
1650433910824,MATH 18,A02,083744,Staff,27,0,30,3
1650433910824,MATH 18,A03,083745,Staff,22,0,30,8
1650433910824,MATH 18,A04,083746,Staff,26,0,30,4
1650433910824,MATH 18,B01,083748,Staff,0,11,30,30
1650433910824,MATH 18,B02,083749,Staff,0,12,30,30
1650433910824,MATH 18,B03,083750,Staff,0,11,30,30
1650433910824,MATH 18,B04,083751,Staff,0,12,30,30
1650433916872,MATH 20A,A01,083754,Staff,26,0,40,14
1650433922896,MATH 20B,A01,083756,Staff,0,10,30,30
1650433922896,MATH 20B,A02,083757,Staff,0,10,30,30
1650433928920,MATH 20C,A01,083760,Staff,0,15,30,30
1650433928920,MATH 20C,A02,083761,Staff,1,14,30,29
1650433928920,MATH 20C,B01,083762,Staff,13,0,30,17
1650433928920,MATH 20C,B02,083763,Staff,28,0,30,2
1650433934944,MATH 20D,A01,083765,Staff,0,1,30,30
1650433934944,MATH 20D,A02,083766,Staff,9,0,30,21
1650433934944,MATH 20D,A03,083767,Staff,25,0,30,5
1650433940971,MATH 20E,A01,083771,Staff,5,0,30,25
1650433940971,MATH 20E,A02,083772,Staff,18,0,30,12
1650433940971,MATH 20E,B01,083773,Staff,0,0,30,30
1650433940971,MATH 20E,B02,083774,Staff,11,0,30,19
1650433946997,MATH 103A,A01,083777,Staff,0,12,30,30
1650433946997,MATH 103A,A02,083778,Staff,0,12,30,30
1650433946997,MATH 103A,B01,083779,Staff,0,13,30,30
1650433946997,MATH 103A,B02,083780,Staff,0,11,30,30
1650433953024,MATH 105,A01,085443,Staff,0,22,30,30
1650433959052,MATH 109,A01,083213,Anzaldo; Leesa B,0,7,30,30
1650433959052,MATH 109,A02,083214,Anzaldo; Leesa B,0,7,30,30
1650433959052,MATH 109,B01,083215,Anzaldo; Leesa B,0,5,30,30
1650433959052,MATH 109,B02,083216,Anzaldo; Leesa B,0,6,30,30
1650433965081,MATH 142A,A01,083219,Chow; Bennett,0,14,30,30
1650433965081,MATH 142A,A02,083220,Chow; Bennett,0,13,30,30
1650433965081,MATH 142A,B01,083221,Chow; Bennett,0,12,30,30
1650433965081,MATH 142A,B02,083222,Chow; Bennett,0,13,30,30
1650433971115,MATH 193A,A01,083224,Staff,0,5,30,30
1650433971115,MATH 193A,A02,083225,Staff,0,5,30,30
1650433971115,MATH 193A,A03,083781,Staff,0,4,30,30
1650433971115,MATH 193A,A04,083782,Staff,0,4,30,30
1650433977140,MATH 197,001,091859,McAuley; Julian John,9998,0,9999,1
1650433983208,COGS 9,A01,083615,Staff,0,14,60,60
1650433989239,COGS 11,A01,083617,Boyle; Mary E. T.,21,0,40,19
1650433995266,COGS 13,A01,083071,Staff,0,34,40,40
1650434001292,COGS 14A,A01,092681,Staff,0,25,100,100
1650434007318,COGS 14B,A01,083073,Cheng; Tzu-Han,0,11,50,50
1650434013347,COGS 17,A01,092677,Staff,22,0,75,53
1650434019373,COGS 100,A01,083619,Staff,0,26,60,60
1650434025402,COGS 101A,A01,083621,Davis; Joshua Daniel,0,21,60,60
1650434031424,COGS 101B,A01,091572,Staff,0,4,60,60
1650434037463,COGS 101C,A01,083625,Delgado; Tania,16,0,30,14
1650434043485,COGS 107A,A01,083627,Boyle; Mary E. T.,0,11,60,60
1650434049508,COGS 118A,A01,083075,Staff,2,0,60,58
1650434055536,CSE 3,A50,083646,Miranda; Gregory Joseph,20,0,38,18
1650434055536,CSE 3,A51,083647,Miranda; Gregory Joseph,36,0,37,1
1650434061559,CSE 8A,A50,083650,Miranda; Gregory Joseph,0,28,40,40
1650434067592,CSE 11,A01,083080,Cao; Yingjun,0,91,40,40
1650434073614,CSE 12,A01,083652,Staff,0,16,100,100
1650434079636,CSE 15L,A01,083654,Staff,0,1,50,50
1650434079636,CSE 15L,A02,083655,Staff,1,0,50,49
1650434085660,CSE 20,A01,083657,Staff,51,0,80,29
1650434091685,CSE 30,A01,083084,Eldon; John,0,76,40,40
1650434097709,CSE 100,A01,083659,Cao; Yingjun,0,66,50,50
1650434103733,CSE 134B,A01,083661,Powell; Thomas Allan,0,32,65,65
1650434109761,CSE 140,A01,083663,Staff,0,2,75,75
1650434115784,CSE 140L,A01,083088,Eldon; John,0,8,75,75
1650434121809,CSE 175,A01,083665,Kumar; Rakesh,7,0,25,18
1650434127833,CSE 190,A00,092507,Dubnov; Shlomo,14,0,20,6
1650434133860,ECE 45,A01,083139,Staff,0,18,40,40
1650434139888,ECE 65,A50,083695,Staff,0,6,30,30
1650434145913,ECE 109,A01,091882,Touri; Behrouz,38,0,70,32
1650434151934,ECE 180,A00,083140,Abi Samra; Nicholas Camill,23,0,30,7
1650434151934,ECE 180,B00,083141,Abi Samra; Nicholas Camill,0,0,30,30
1650434157962,MATH 10A,A01,083735,Patchell; Gregory David,7,0,30,23
1650434157962,MATH 10A,A02,083736,Patchell; Gregory David,28,0,30,2
1650434157962,MATH 10A,A03,083737,Patchell; Gregory David,25,0,30,5
1650434164002,MATH 10B,A01,083207,Staff,0,7,30,30
1650434164002,MATH 10B,A02,083208,Staff,0,7,30,30
1650434164002,MATH 10B,B01,083739,Staff,13,0,30,17
1650434164002,MATH 10B,B02,083740,Staff,28,0,30,2
1650434170027,MATH 18,A01,083743,Staff,2,0,30,28
1650434170027,MATH 18,A02,083744,Staff,27,0,30,3
1650434170027,MATH 18,A03,083745,Staff,22,0,30,8
1650434170027,MATH 18,A04,083746,Staff,26,0,30,4
1650434170027,MATH 18,B01,083748,Staff,0,11,30,30
1650434170027,MATH 18,B02,083749,Staff,0,12,30,30
1650434170027,MATH 18,B03,083750,Staff,0,11,30,30
1650434170027,MATH 18,B04,083751,Staff,0,12,30,30
1650434176059,MATH 20A,A01,083754,Staff,26,0,40,14
1650434182083,MATH 20B,A01,083756,Staff,0,10,30,30
1650434182083,MATH 20B,A02,083757,Staff,0,10,30,30
1650434188112,MATH 20C,A01,083760,Staff,0,15,30,30
1650434188112,MATH 20C,A02,083761,Staff,1,14,30,29
1650434188112,MATH 20C,B01,083762,Staff,13,0,30,17
1650434188112,MATH 20C,B02,083763,Staff,28,0,30,2
1650434194136,MATH 20D,A01,083765,Staff,0,1,30,30
1650434194136,MATH 20D,A02,083766,Staff,9,0,30,21
1650434194136,MATH 20D,A03,083767,Staff,25,0,30,5
1650434200168,MATH 20E,A01,083771,Staff,5,0,30,25
1650434200168,MATH 20E,A02,083772,Staff,18,0,30,12
1650434200168,MATH 20E,B01,083773,Staff,0,0,30,30
1650434200168,MATH 20E,B02,083774,Staff,11,0,30,19
1650434206195,MATH 103A,A01,083777,Staff,0,12,30,30
1650434206195,MATH 103A,A02,083778,Staff,0,12,30,30
1650434206195,MATH 103A,B01,083779,Staff,0,13,30,30
1650434206195,MATH 103A,B02,083780,Staff,0,11,30,30
1650434212219,MATH 105,A01,085443,Staff,0,22,30,30
1650434218247,MATH 109,A01,083213,Anzaldo; Leesa B,0,7,30,30
1650434218247,MATH 109,A02,083214,Anzaldo; Leesa B,0,7,30,30
1650434218247,MATH 109,B01,083215,Anzaldo; Leesa B,0,5,30,30
1650434218247,MATH 109,B02,083216,Anzaldo; Leesa B,0,6,30,30
1650434224272,MATH 142A,A01,083219,Chow; Bennett,0,14,30,30
1650434224272,MATH 142A,A02,083220,Chow; Bennett,0,13,30,30
1650434224272,MATH 142A,B01,083221,Chow; Bennett,0,12,30,30
1650434224272,MATH 142A,B02,083222,Chow; Bennett,0,13,30,30
1650434230298,MATH 193A,A01,083224,Staff,0,5,30,30
1650434230298,MATH 193A,A02,083225,Staff,0,5,30,30
1650434230298,MATH 193A,A03,083781,Staff,0,4,30,30
1650434230298,MATH 193A,A04,083782,Staff,0,4,30,30
1650434236324,MATH 197,001,091859,McAuley; Julian John,9998,0,9999,1
1650434242484,COGS 9,A01,083615,Staff,0,14,60,60
1650434248508,COGS 11,A01,083617,Boyle; Mary E. T.,21,0,40,19
1650434254536,COGS 13,A01,083071,Staff,0,34,40,40
1650434260563,COGS 14A,A01,092681,Staff,0,25,100,100
1650434266586,COGS 14B,A01,083073,Cheng; Tzu-Han,0,11,50,50
1650434272612,COGS 17,A01,092677,Staff,22,0,75,53
1650434278636,COGS 100,A01,083619,Staff,0,26,60,60
1650434284664,COGS 101A,A01,083621,Davis; Joshua Daniel,0,21,60,60
1650434290688,COGS 101B,A01,091572,Staff,0,4,60,60
1650434296711,COGS 101C,A01,083625,Delgado; Tania,16,0,30,14
1650434302737,COGS 107A,A01,083627,Boyle; Mary E. T.,0,11,60,60
1650434308762,COGS 118A,A01,083075,Staff,2,0,60,58
1650434314786,CSE 3,A50,083646,Miranda; Gregory Joseph,20,0,38,18
1650434314786,CSE 3,A51,083647,Miranda; Gregory Joseph,36,0,37,1
1650434320813,CSE 8A,A50,083650,Miranda; Gregory Joseph,0,28,40,40
1650434326844,CSE 11,A01,083080,Cao; Yingjun,0,91,40,40
1650434332868,CSE 12,A01,083652,Staff,0,16,100,100
1650434338898,CSE 15L,A01,083654,Staff,0,1,50,50
1650434338898,CSE 15L,A02,083655,Staff,1,0,50,49
1650434344925,CSE 20,A01,083657,Staff,51,0,80,29
1650434350951,CSE 30,A01,083084,Eldon; John,0,76,40,40
1650434356976,CSE 100,A01,083659,Cao; Yingjun,0,66,50,50
1650434363004,CSE 134B,A01,083661,Powell; Thomas Allan,0,32,65,65
1650434369032,CSE 140,A01,083663,Staff,0,2,75,75
1650434375059,CSE 140L,A01,083088,Eldon; John,0,8,75,75
1650434381079,CSE 175,A01,083665,Kumar; Rakesh,7,0,25,18
1650434387105,CSE 190,A00,092507,Dubnov; Shlomo,14,0,20,6
1650434393131,ECE 45,A01,083139,Staff,0,18,40,40
1650434399155,ECE 65,A50,083695,Staff,0,6,30,30
1650434405182,ECE 109,A01,091882,Touri; Behrouz,38,0,70,32
1650434411204,ECE 180,A00,083140,Abi Samra; Nicholas Camill,23,0,30,7
1650434411204,ECE 180,B00,083141,Abi Samra; Nicholas Camill,0,0,30,30
1650434417232,MATH 10A,A01,083735,Patchell; Gregory David,7,0,30,23
1650434417232,MATH 10A,A02,083736,Patchell; Gregory David,28,0,30,2
1650434417232,MATH 10A,A03,083737,Patchell; Gregory David,25,0,30,5
1650434423261,MATH 10B,A01,083207,Staff,0,7,30,30
1650434423261,MATH 10B,A02,083208,Staff,0,7,30,30
1650434423261,MATH 10B,B01,083739,Staff,13,0,30,17
1650434423261,MATH 10B,B02,083740,Staff,28,0,30,2
1650434429293,MATH 18,A01,083743,Staff,2,0,30,28
1650434429293,MATH 18,A02,083744,Staff,27,0,30,3
1650434429293,MATH 18,A03,083745,Staff,22,0,30,8
1650434429293,MATH 18,A04,083746,Staff,26,0,30,4
1650434429293,MATH 18,B01,083748,Staff,0,11,30,30
1650434429293,MATH 18,B02,083749,Staff,0,12,30,30
1650434429293,MATH 18,B03,083750,Staff,0,11,30,30
1650434429293,MATH 18,B04,083751,Staff,0,12,30,30
1650434435318,MATH 20A,A01,083754,Staff,26,0,40,14
1650434441341,MATH 20B,A01,083756,Staff,0,10,30,30
1650434441341,MATH 20B,A02,083757,Staff,0,10,30,30
1650434447366,MATH 20C,A01,083760,Staff,0,15,30,30
1650434447366,MATH 20C,A02,083761,Staff,1,14,30,29
1650434447366,MATH 20C,B01,083762,Staff,13,0,30,17
1650434447366,MATH 20C,B02,083763,Staff,28,0,30,2
1650434453398,MATH 20D,A01,083765,Staff,0,1,30,30
1650434453398,MATH 20D,A02,083766,Staff,9,0,30,21
1650434453398,MATH 20D,A03,083767,Staff,25,0,30,5
1650434459422,MATH 20E,A01,083771,Staff,5,0,30,25
1650434459422,MATH 20E,A02,083772,Staff,18,0,30,12
1650434459422,MATH 20E,B01,083773,Staff,0,0,30,30
1650434459422,MATH 20E,B02,083774,Staff,11,0,30,19
1650434465454,MATH 103A,A01,083777,Staff,0,12,30,30
1650434465454,MATH 103A,A02,083778,Staff,0,12,30,30
1650434465454,MATH 103A,B01,083779,Staff,0,13,30,30
1650434465454,MATH 103A,B02,083780,Staff,0,11,30,30
1650434471482,MATH 105,A01,085443,Staff,0,22,30,30
1650434477519,MATH 109,A01,083213,Anzaldo; Leesa B,0,7,30,30
1650434477519,MATH 109,A02,083214,Anzaldo; Leesa B,0,7,30,30
1650434477519,MATH 109,B01,083215,Anzaldo; Leesa B,0,5,30,30
1650434477519,MATH 109,B02,083216,Anzaldo; Leesa B,0,6,30,30
1650434483543,MATH 142A,A01,083219,Chow; Bennett,0,14,30,30
1650434483543,MATH 142A,A02,083220,Chow; Bennett,0,13,30,30
1650434483543,MATH 142A,B01,083221,Chow; Bennett,0,12,30,30
1650434483543,MATH 142A,B02,083222,Chow; Bennett,0,13,30,30
1650434489568,MATH 193A,A01,083224,Staff,0,5,30,30
1650434489568,MATH 193A,A02,083225,Staff,0,5,30,30
1650434489568,MATH 193A,A03,083781,Staff,0,4,30,30
1650434489568,MATH 193A,A04,083782,Staff,0,4,30,30
1650434495591,MATH 197,001,091859,McAuley; Julian John,9998,0,9999,1
1650434501651,COGS 9,A01,083615,Staff,0,14,60,60
1650434507680,COGS 11,A01,083617,Boyle; Mary E. T.,21,0,40,19
1650434513707,COGS 13,A01,083071,Staff,0,34,40,40
1650434519732,COGS 14A,A01,092681,Staff,0,25,100,100
1650434525756,COGS 14B,A01,083073,Cheng; Tzu-Han,0,11,50,50
1650434531780,COGS 17,A01,092677,Staff,22,0,75,53
1650434537804,COGS 100,A01,083619,Staff,0,26,60,60
1650434543830,COGS 101A,A01,083621,Davis; Joshua Daniel,0,21,60,60
1650434549857,COGS 101B,A01,091572,Staff,0,4,60,60
1650434555892,COGS 101C,A01,083625,Delgado; Tania,16,0,30,14
1650434561916,COGS 107A,A01,083627,Boyle; Mary E. T.,0,11,60,60
1650434567943,COGS 118A,A01,083075,Staff,2,0,60,58
1650434573972,CSE 3,A50,083646,Miranda; Gregory Joseph,20,0,38,18
1650434573972,CSE 3,A51,083647,Miranda; Gregory Joseph,36,0,37,1
1650434579998,CSE 8A,A50,083650,Miranda; Gregory Joseph,0,28,40,40
1650434586029,CSE 11,A01,083080,Cao; Yingjun,0,91,40,40
1650434592055,CSE 12,A01,083652,Staff,0,16,100,100
1650434598079,CSE 15L,A01,083654,Staff,0,1,50,50
1650434598079,CSE 15L,A02,083655,Staff,1,0,50,49
1650434604103,CSE 20,A01,083657,Staff,51,0,80,29
1650434610127,CSE 30,A01,083084,Eldon; John,0,76,40,40
1650434616156,CSE 100,A01,083659,Cao; Yingjun,0,66,50,50
1650434622180,CSE 134B,A01,083661,Powell; Thomas Allan,0,32,65,65
1650434628219,CSE 140,A01,083663,Staff,0,2,75,75
1650434634249,CSE 140L,A01,083088,Eldon; John,0,8,75,75
1650434640282,CSE 175,A01,083665,Kumar; Rakesh,7,0,25,18
1650434646315,CSE 190,A00,092507,Dubnov; Shlomo,14,0,20,6
1650434652337,ECE 45,A01,083139,Staff,0,18,40,40
1650434658362,ECE 65,A50,083695,Staff,0,6,30,30
1650434664390,ECE 109,A01,091882,Touri; Behrouz,38,0,70,32
1650434670415,ECE 180,A00,083140,Abi Samra; Nicholas Camill,23,0,30,7
1650434670415,ECE 180,B00,083141,Abi Samra; Nicholas Camill,0,0,30,30
1650434676442,MATH 10A,A01,083735,Patchell; Gregory David,7,0,30,23
1650434676442,MATH 10A,A02,083736,Patchell; Gregory David,28,0,30,2
1650434676442,MATH 10A,A03,083737,Patchell; Gregory David,25,0,30,5
1650434682471,MATH 10B,A01,083207,Staff,0,7,30,30
1650434682471,MATH 10B,A02,083208,Staff,0,7,30,30
1650434682471,MATH 10B,B01,083739,Staff,13,0,30,17
1650434682471,MATH 10B,B02,083740,Staff,28,0,30,2
1650434688498,MATH 18,A01,083743,Staff,2,0,30,28
1650434688498,MATH 18,A02,083744,Staff,27,0,30,3
1650434688498,MATH 18,A03,083745,Staff,22,0,30,8
1650434688498,MATH 18,A04,083746,Staff,26,0,30,4
1650434688498,MATH 18,B01,083748,Staff,0,11,30,30
1650434688498,MATH 18,B02,083749,Staff,0,12,30,30
1650434688498,MATH 18,B03,083750,Staff,0,11,30,30
1650434688498,MATH 18,B04,083751,Staff,0,12,30,30
1650434694523,MATH 20A,A01,083754,Staff,26,0,40,14
1650434700552,MATH 20B,A01,083756,Staff,0,10,30,30
1650434700552,MATH 20B,A02,083757,Staff,0,10,30,30
1650434706582,MATH 20C,A01,083760,Staff,0,15,30,30
1650434706582,MATH 20C,A02,083761,Staff,1,14,30,29
1650434706582,MATH 20C,B01,083762,Staff,13,0,30,17
1650434706582,MATH 20C,B02,083763,Staff,28,0,30,2
1650434712607,MATH 20D,A01,083765,Staff,0,1,30,30
1650434712607,MATH 20D,A02,083766,Staff,9,0,30,21
1650434712607,MATH 20D,A03,083767,Staff,25,0,30,5
1650434718631,MATH 20E,A01,083771,Staff,5,0,30,25
1650434718631,MATH 20E,A02,083772,Staff,18,0,30,12
1650434718631,MATH 20E,B01,083773,Staff,0,0,30,30
1650434718631,MATH 20E,B02,083774,Staff,11,0,30,19
1650434724653,MATH 103A,A01,083777,Staff,0,12,30,30
1650434724653,MATH 103A,A02,083778,Staff,0,12,30,30
1650434724653,MATH 103A,B01,083779,Staff,0,13,30,30
1650434724653,MATH 103A,B02,083780,Staff,0,11,30,30
1650434730676,MATH 105,A01,085443,Staff,0,22,30,30
1650434736703,MATH 109,A01,083213,Anzaldo; Leesa B,0,7,30,30
1650434736703,MATH 109,A02,083214,Anzaldo; Leesa B,0,7,30,30
1650434736703,MATH 109,B01,083215,Anzaldo; Leesa B,0,5,30,30
1650434736703,MATH 109,B02,083216,Anzaldo; Leesa B,0,6,30,30
1650434742811,MATH 142A,A01,083219,Chow; Bennett,0,14,30,30
1650434742811,MATH 142A,A02,083220,Chow; Bennett,0,13,30,30
1650434742811,MATH 142A,B01,083221,Chow; Bennett,0,12,30,30
1650434742811,MATH 142A,B02,083222,Chow; Bennett,0,13,30,30
1650434748836,MATH 193A,A01,083224,Staff,0,5,30,30
1650434748836,MATH 193A,A02,083225,Staff,0,5,30,30
1650434748836,MATH 193A,A03,083781,Staff,0,4,30,30
1650434748836,MATH 193A,A04,083782,Staff,0,4,30,30
1650434754862,MATH 197,001,091859,McAuley; Julian John,9998,0,9999,1
1650434760927,COGS 9,A01,083615,Staff,0,14,60,60
1650434766954,COGS 11,A01,083617,Boyle; Mary E. T.,21,0,40,19
1650434772979,COGS 13,A01,083071,Staff,0,34,40,40
1650434779016,COGS 14A,A01,092681,Staff,0,25,100,100
1650434785054,COGS 14B,A01,083073,Cheng; Tzu-Han,0,11,50,50
1650434791077,COGS 17,A01,092677,Staff,22,0,75,53
1650434797110,COGS 100,A01,083619,Staff,0,26,60,60
1650434803138,COGS 101A,A01,083621,Davis; Joshua Daniel,0,21,60,60
1650434809164,COGS 101B,A01,091572,Staff,0,4,60,60
1650434815198,COGS 101C,A01,083625,Delgado; Tania,16,0,30,14
1650434821227,COGS 107A,A01,083627,Boyle; Mary E. T.,0,11,60,60
1650434827254,COGS 118A,A01,083075,Staff,2,0,60,58
1650434833374,CSE 3,A50,083646,Miranda; Gregory Joseph,20,0,38,18
1650434833374,CSE 3,A51,083647,Miranda; Gregory Joseph,36,0,37,1
1650434839408,CSE 8A,A50,083650,Miranda; Gregory Joseph,0,28,40,40
1650434845444,CSE 11,A01,083080,Cao; Yingjun,0,91,40,40
1650434851469,CSE 12,A01,083652,Staff,0,16,100,100
1650434857493,CSE 15L,A01,083654,Staff,0,1,50,50
1650434857493,CSE 15L,A02,083655,Staff,1,0,50,49
1650434863520,CSE 20,A01,083657,Staff,51,0,80,29
1650434869547,CSE 30,A01,083084,Eldon; John,0,76,40,40
1650434875573,CSE 100,A01,083659,Cao; Yingjun,0,66,50,50
1650434881602,CSE 134B,A01,083661,Powell; Thomas Allan,0,32,65,65
1650434887626,CSE 140,A01,083663,Staff,0,2,75,75
1650434893665,CSE 140L,A01,083088,Eldon; John,0,8,75,75
1650434899691,CSE 175,A01,083665,Kumar; Rakesh,7,0,25,18
1650434905715,CSE 190,A00,092507,Dubnov; Shlomo,14,0,20,6
1650434911739,ECE 45,A01,083139,Staff,0,18,40,40
1650434917764,ECE 65,A50,083695,Staff,0,6,30,30
1650434923791,ECE 109,A01,091882,Touri; Behrouz,38,0,70,32
1650434929815,ECE 180,A00,083140,Abi Samra; Nicholas Camill,23,0,30,7
1650434929815,ECE 180,B00,083141,Abi Samra; Nicholas Camill,0,0,30,30
1650434935838,MATH 10A,A01,083735,Patchell; Gregory David,7,0,30,23
1650434935838,MATH 10A,A02,083736,Patchell; Gregory David,28,0,30,2
1650434935838,MATH 10A,A03,083737,Patchell; Gregory David,25,0,30,5
1650434941867,MATH 10B,A01,083207,Staff,0,7,30,30
1650434941867,MATH 10B,A02,083208,Staff,0,7,30,30
1650434941867,MATH 10B,B01,083739,Staff,13,0,30,17
1650434941867,MATH 10B,B02,083740,Staff,28,0,30,2
1650434947891,MATH 18,A01,083743,Staff,2,0,30,28
1650434947891,MATH 18,A02,083744,Staff,27,0,30,3
1650434947891,MATH 18,A03,083745,Staff,22,0,30,8
1650434947891,MATH 18,A04,083746,Staff,26,0,30,4
1650434947891,MATH 18,B01,083748,Staff,0,11,30,30
1650434947891,MATH 18,B02,083749,Staff,0,12,30,30
1650434947891,MATH 18,B03,083750,Staff,0,11,30,30
1650434947891,MATH 18,B04,083751,Staff,0,12,30,30
1650434953922,MATH 20A,A01,083754,Staff,26,0,40,14
1650434959951,MATH 20B,A01,083756,Staff,0,10,30,30
1650434959951,MATH 20B,A02,083757,Staff,0,10,30,30
1650434965978,MATH 20C,A01,083760,Staff,0,15,30,30
1650434965978,MATH 20C,A02,083761,Staff,1,14,30,29
1650434965978,MATH 20C,B01,083762,Staff,13,0,30,17
1650434965978,MATH 20C,B02,083763,Staff,28,0,30,2
1650434972005,MATH 20D,A01,083765,Staff,0,1,30,30
1650434972005,MATH 20D,A02,083766,Staff,9,0,30,21
1650434972005,MATH 20D,A03,083767,Staff,25,0,30,5
1650434978031,MATH 20E,A01,083771,Staff,5,0,30,25
1650434978031,MATH 20E,A02,083772,Staff,18,0,30,12
1650434978031,MATH 20E,B01,083773,Staff,0,0,30,30
1650434978031,MATH 20E,B02,083774,Staff,11,0,30,19
1650434984060,MATH 103A,A01,083777,Staff,0,12,30,30
1650434984060,MATH 103A,A02,083778,Staff,0,12,30,30
1650434984060,MATH 103A,B01,083779,Staff,0,13,30,30
1650434984060,MATH 103A,B02,083780,Staff,0,11,30,30
1650434990090,MATH 105,A01,085443,Staff,0,22,30,30
1650434996118,MATH 109,A01,083213,Anzaldo; Leesa B,0,7,30,30
1650434996118,MATH 109,A02,083214,Anzaldo; Leesa B,0,7,30,30
1650434996118,MATH 109,B01,083215,Anzaldo; Leesa B,0,5,30,30
1650434996118,MATH 109,B02,083216,Anzaldo; Leesa B,0,6,30,30
1650435002146,MATH 142A,A01,083219,Chow; Bennett,0,14,30,30
1650435002146,MATH 142A,A02,083220,Chow; Bennett,0,13,30,30
1650435002146,MATH 142A,B01,083221,Chow; Bennett,0,12,30,30
1650435002146,MATH 142A,B02,083222,Chow; Bennett,0,13,30,30
1650435008173,MATH 193A,A01,083224,Staff,0,5,30,30
1650435008173,MATH 193A,A02,083225,Staff,0,5,30,30
1650435008173,MATH 193A,A03,083781,Staff,0,4,30,30
1650435008173,MATH 193A,A04,083782,Staff,0,4,30,30
1650435014200,MATH 197,001,091859,McAuley; Julian John,9998,0,9999,1
1650435020261,COGS 9,A01,083615,Staff,0,14,60,60
1650435026285,COGS 11,A01,083617,Boyle; Mary E. T.,21,0,40,19
1650435032316,COGS 13,A01,083071,Staff,0,34,40,40
1650435038348,COGS 14A,A01,092681,Staff,0,25,100,100
1650435044380,COGS 14B,A01,083073,Cheng; Tzu-Han,0,11,50,50
1650435050408,COGS 17,A01,092677,Staff,22,0,75,53
1650435056433,COGS 100,A01,083619,Staff,0,26,60,60
1650435062457,COGS 101A,A01,083621,Davis; Joshua Daniel,0,21,60,60
1650435068489,COGS 101B,A01,091572,Staff,0,4,60,60
1650435074515,COGS 101C,A01,083625,Delgado; Tania,16,0,30,14
1650435080548,COGS 107A,A01,083627,Boyle; Mary E. T.,0,11,60,60
1650435086579,COGS 118A,A01,083075,Staff,2,0,60,58
1650435092608,CSE 3,A50,083646,Miranda; Gregory Joseph,20,0,38,18
1650435092608,CSE 3,A51,083647,Miranda; Gregory Joseph,36,0,37,1
1650435098637,CSE 8A,A50,083650,Miranda; Gregory Joseph,0,28,40,40
1650435104669,CSE 11,A01,083080,Cao; Yingjun,0,91,40,40
1650435110703,CSE 12,A01,083652,Staff,0,16,100,100
1650435116728,CSE 15L,A01,083654,Staff,0,1,50,50
1650435116728,CSE 15L,A02,083655,Staff,1,0,50,49
1650435122752,CSE 20,A01,083657,Staff,51,0,80,29
1650435128784,CSE 30,A01,083084,Eldon; John,0,76,40,40
1650435134818,CSE 100,A01,083659,Cao; Yingjun,0,66,50,50
1650435140841,CSE 134B,A01,083661,Powell; Thomas Allan,0,32,65,65
1650435146891,CSE 140,A01,083663,Staff,0,2,75,75
1650435152914,CSE 140L,A01,083088,Eldon; John,0,8,75,75
1650435158941,CSE 175,A01,083665,Kumar; Rakesh,7,0,25,18
1650435164965,CSE 190,A00,092507,Dubnov; Shlomo,14,0,20,6
1650435170989,ECE 45,A01,083139,Staff,0,18,40,40
1650435177014,ECE 65,A50,083695,Staff,0,6,30,30
1650435183053,ECE 109,A01,091882,Touri; Behrouz,38,0,70,32
1650435189087,ECE 180,A00,083140,Abi Samra; Nicholas Camill,23,0,30,7
1650435189087,ECE 180,B00,083141,Abi Samra; Nicholas Camill,0,0,30,30
1650435195117,MATH 10A,A01,083735,Patchell; Gregory David,7,0,30,23
1650435195117,MATH 10A,A02,083736,Patchell; Gregory David,28,0,30,2
1650435195117,MATH 10A,A03,083737,Patchell; Gregory David,25,0,30,5
1650435201150,MATH 10B,A01,083207,Staff,0,7,30,30
1650435201150,MATH 10B,A02,083208,Staff,0,7,30,30
1650435201150,MATH 10B,B01,083739,Staff,13,0,30,17
1650435201150,MATH 10B,B02,083740,Staff,28,0,30,2
1650435207181,MATH 18,A01,083743,Staff,2,0,30,28
1650435207181,MATH 18,A02,083744,Staff,27,0,30,3
1650435207181,MATH 18,A03,083745,Staff,22,0,30,8
1650435207181,MATH 18,A04,083746,Staff,26,0,30,4
1650435207181,MATH 18,B01,083748,Staff,0,11,30,30
1650435207181,MATH 18,B02,083749,Staff,0,12,30,30
1650435207181,MATH 18,B03,083750,Staff,0,11,30,30
1650435207181,MATH 18,B04,083751,Staff,0,12,30,30
1650435213206,MATH 20A,A01,083754,Staff,26,0,40,14
1650435219229,MATH 20B,A01,083756,Staff,0,10,30,30
1650435219229,MATH 20B,A02,083757,Staff,0,10,30,30
1650435225258,MATH 20C,A01,083760,Staff,0,15,30,30
1650435225258,MATH 20C,A02,083761,Staff,1,14,30,29
1650435225258,MATH 20C,B01,083762,Staff,13,0,30,17
1650435225258,MATH 20C,B02,083763,Staff,28,0,30,2
1650435231283,MATH 20D,A01,083765,Staff,0,1,30,30
1650435231283,MATH 20D,A02,083766,Staff,9,0,30,21
1650435231283,MATH 20D,A03,083767,Staff,25,0,30,5
1650435237309,MATH 20E,A01,083771,Staff,5,0,30,25
1650435237309,MATH 20E,A02,083772,Staff,18,0,30,12
1650435237309,MATH 20E,B01,083773,Staff,0,0,30,30
1650435237309,MATH 20E,B02,083774,Staff,11,0,30,19
1650435243333,MATH 103A,A01,083777,Staff,0,12,30,30
1650435243333,MATH 103A,A02,083778,Staff,0,12,30,30
1650435243333,MATH 103A,B01,083779,Staff,0,13,30,30
1650435243333,MATH 103A,B02,083780,Staff,0,11,30,30
1650435249375,MATH 105,A01,085443,Staff,0,22,30,30
1650435255404,MATH 109,A01,083213,Anzaldo; Leesa B,0,7,30,30
1650435255404,MATH 109,A02,083214,Anzaldo; Leesa B,0,7,30,30
1650435255404,MATH 109,B01,083215,Anzaldo; Leesa B,0,5,30,30
1650435255404,MATH 109,B02,083216,Anzaldo; Leesa B,0,6,30,30
1650435261433,MATH 142A,A01,083219,Chow; Bennett,0,14,30,30
1650435261433,MATH 142A,A02,083220,Chow; Bennett,0,13,30,30
1650435261433,MATH 142A,B01,083221,Chow; Bennett,0,12,30,30
1650435261433,MATH 142A,B02,083222,Chow; Bennett,0,13,30,30
1650435267455,MATH 193A,A01,083224,Staff,0,5,30,30
1650435267455,MATH 193A,A02,083225,Staff,0,5,30,30
1650435267455,MATH 193A,A03,083781,Staff,0,4,30,30
1650435267455,MATH 193A,A04,083782,Staff,0,4,30,30
1650435273479,MATH 197,001,091859,McAuley; Julian John,9998,0,9999,1
1650435279541,COGS 9,A01,083615,Staff,0,14,60,60
1650435285569,COGS 11,A01,083617,Boyle; Mary E. T.,21,0,40,19
1650435291600,COGS 13,A01,083071,Staff,0,34,40,40
1650435297633,COGS 14A,A01,092681,Staff,0,25,100,100
1650435303673,COGS 14B,A01,083073,Cheng; Tzu-Han,0,11,50,50
1650435309700,COGS 17,A01,092677,Staff,22,0,75,53
1650435315732,COGS 100,A01,083619,Staff,0,26,60,60
1650435321761,COGS 101A,A01,083621,Davis; Joshua Daniel,0,21,60,60
1650435327789,COGS 101B,A01,091572,Staff,0,4,60,60
1650435333813,COGS 101C,A01,083625,Delgado; Tania,16,0,30,14
1650435339837,COGS 107A,A01,083627,Boyle; Mary E. T.,0,11,60,60
1650435345864,COGS 118A,A01,083075,Staff,2,0,60,58
1650435351902,CSE 3,A50,083646,Miranda; Gregory Joseph,20,0,38,18
1650435351902,CSE 3,A51,083647,Miranda; Gregory Joseph,36,0,37,1
1650435357927,CSE 8A,A50,083650,Miranda; Gregory Joseph,0,28,40,40
1650435363956,CSE 11,A01,083080,Cao; Yingjun,0,91,40,40
1650435369982,CSE 12,A01,083652,Staff,0,16,100,100
1650435376006,CSE 15L,A01,083654,Staff,0,1,50,50
1650435376006,CSE 15L,A02,083655,Staff,1,0,50,49
1650435382035,CSE 20,A01,083657,Staff,51,0,80,29
1650435388060,CSE 30,A01,083084,Eldon; John,0,76,40,40
1650435394097,CSE 100,A01,083659,Cao; Yingjun,0,66,50,50
1650435400137,CSE 134B,A01,083661,Powell; Thomas Allan,0,32,65,65
1650435406163,CSE 140,A01,083663,Staff,0,2,75,75
1650435412194,CSE 140L,A01,083088,Eldon; John,0,8,75,75
1650435418221,CSE 175,A01,083665,Kumar; Rakesh,7,0,25,18
1650435424247,CSE 190,A00,092507,Dubnov; Shlomo,14,0,20,6
1650435430343,ECE 45,A01,083139,Staff,0,18,40,40
1650435436373,ECE 65,A50,083695,Staff,0,6,30,30
1650435442396,ECE 109,A01,091882,Touri; Behrouz,38,0,70,32
1650435448421,ECE 180,A00,083140,Abi Samra; Nicholas Camill,23,0,30,7
1650435448421,ECE 180,B00,083141,Abi Samra; Nicholas Camill,0,0,30,30
1650435454444,MATH 10A,A01,083735,Patchell; Gregory David,7,0,30,23
1650435454444,MATH 10A,A02,083736,Patchell; Gregory David,28,0,30,2
1650435454444,MATH 10A,A03,083737,Patchell; Gregory David,25,0,30,5
1650435460468,MATH 10B,A01,083207,Staff,0,7,30,30
1650435460468,MATH 10B,A02,083208,Staff,0,7,30,30
1650435460468,MATH 10B,B01,083739,Staff,13,0,30,17
1650435460468,MATH 10B,B02,083740,Staff,28,0,30,2
1650435466497,MATH 18,A01,083743,Staff,2,0,30,28
1650435466497,MATH 18,A02,083744,Staff,27,0,30,3
1650435466497,MATH 18,A03,083745,Staff,22,0,30,8
1650435466497,MATH 18,A04,083746,Staff,26,0,30,4
1650435466497,MATH 18,B01,083748,Staff,0,11,30,30
1650435466497,MATH 18,B02,083749,Staff,0,12,30,30
1650435466497,MATH 18,B03,083750,Staff,0,11,30,30
1650435466497,MATH 18,B04,083751,Staff,0,12,30,30
1650435472527,MATH 20A,A01,083754,Staff,26,0,40,14
1650435478564,MATH 20B,A01,083756,Staff,0,10,30,30
1650435478564,MATH 20B,A02,083757,Staff,0,10,30,30
1650435484593,MATH 20C,A01,083760,Staff,0,15,30,30
1650435484593,MATH 20C,A02,083761,Staff,1,14,30,29
1650435484593,MATH 20C,B01,083762,Staff,13,0,30,17
1650435484593,MATH 20C,B02,083763,Staff,28,0,30,2
1650435490621,MATH 20D,A01,083765,Staff,0,1,30,30
1650435490621,MATH 20D,A02,083766,Staff,9,0,30,21
1650435490621,MATH 20D,A03,083767,Staff,25,0,30,5
1650435496648,MATH 20E,A01,083771,Staff,5,0,30,25
1650435496648,MATH 20E,A02,083772,Staff,18,0,30,12
1650435496648,MATH 20E,B01,083773,Staff,0,0,30,30
1650435496648,MATH 20E,B02,083774,Staff,11,0,30,19
1650435502682,MATH 103A,A01,083777,Staff,0,12,30,30
1650435502682,MATH 103A,A02,083778,Staff,0,12,30,30
1650435502682,MATH 103A,B01,083779,Staff,0,13,30,30
1650435502682,MATH 103A,B02,083780,Staff,0,11,30,30
1650435508709,MATH 105,A01,085443,Staff,0,22,30,30
1650435514735,MATH 109,A01,083213,Anzaldo; Leesa B,0,7,30,30
1650435514735,MATH 109,A02,083214,Anzaldo; Leesa B,0,7,30,30
1650435514735,MATH 109,B01,083215,Anzaldo; Leesa B,0,5,30,30
1650435514735,MATH 109,B02,083216,Anzaldo; Leesa B,0,6,30,30
1650435520765,MATH 142A,A01,083219,Chow; Bennett,0,14,30,30
1650435520765,MATH 142A,A02,083220,Chow; Bennett,0,13,30,30
1650435520765,MATH 142A,B01,083221,Chow; Bennett,0,12,30,30
1650435520765,MATH 142A,B02,083222,Chow; Bennett,0,13,30,30
1650435526800,MATH 193A,A01,083224,Staff,0,5,30,30
1650435526800,MATH 193A,A02,083225,Staff,0,5,30,30
1650435526800,MATH 193A,A03,083781,Staff,0,4,30,30
1650435526800,MATH 193A,A04,083782,Staff,0,4,30,30
1650435532832,MATH 197,001,091859,McAuley; Julian John,9998,0,9999,1
1650435538888,COGS 9,A01,083615,Staff,0,14,60,60
1650435544918,COGS 11,A01,083617,Boyle; Mary E. T.,21,0,40,19
1650435550945,COGS 13,A01,083071,Staff,0,34,40,40
1650435556981,COGS 14A,A01,092681,Staff,0,25,100,100
1650435563005,COGS 14B,A01,083073,Cheng; Tzu-Han,0,11,50,50
1650435569035,COGS 17,A01,092677,Staff,22,0,75,53
1650435575062,COGS 100,A01,083619,Staff,0,26,60,60
1650435581086,COGS 101A,A01,083621,Davis; Joshua Daniel,0,21,60,60
1650435587112,COGS 101B,A01,091572,Staff,0,4,60,60
1650435593137,COGS 101C,A01,083625,Delgado; Tania,16,0,30,14
1650435599172,COGS 107A,A01,083627,Boyle; Mary E. T.,0,11,60,60
1650435605202,COGS 118A,A01,083075,Staff,2,0,60,58
1650435611230,CSE 3,A50,083646,Miranda; Gregory Joseph,20,0,38,18
1650435611230,CSE 3,A51,083647,Miranda; Gregory Joseph,36,0,37,1
1650435617257,CSE 8A,A50,083650,Miranda; Gregory Joseph,0,28,40,40
1650435623309,CSE 11,A01,083080,Cao; Yingjun,0,91,40,40
1650435629333,CSE 12,A01,083652,Staff,0,16,100,100
1650435635368,CSE 15L,A01,083654,Staff,0,1,50,50
1650435635368,CSE 15L,A02,083655,Staff,1,0,50,49
1650435641395,CSE 20,A01,083657,Staff,51,0,80,29
1650435647420,CSE 30,A01,083084,Eldon; John,0,76,40,40
1650435653447,CSE 100,A01,083659,Cao; Yingjun,0,66,50,50
1650435659471,CSE 134B,A01,083661,Powell; Thomas Allan,0,32,65,65
1650435665503,CSE 140,A01,083663,Staff,0,2,75,75
1650435671531,CSE 140L,A01,083088,Eldon; John,0,8,75,75
1650435677557,CSE 175,A01,083665,Kumar; Rakesh,7,0,25,18
1650435683581,CSE 190,A00,092507,Dubnov; Shlomo,14,0,20,6
1650435689604,ECE 45,A01,083139,Staff,0,18,40,40
1650435695628,ECE 65,A50,083695,Staff,0,6,30,30
1650435701655,ECE 109,A01,091882,Touri; Behrouz,38,0,70,32
1650435707678,ECE 180,A00,083140,Abi Samra; Nicholas Camill,23,0,30,7
1650435707678,ECE 180,B00,083141,Abi Samra; Nicholas Camill,0,0,30,30
1650435713703,MATH 10A,A01,083735,Patchell; Gregory David,7,0,30,23
1650435713703,MATH 10A,A02,083736,Patchell; Gregory David,28,0,30,2
1650435713703,MATH 10A,A03,083737,Patchell; Gregory David,25,0,30,5
1650435719729,MATH 10B,A01,083207,Staff,0,7,30,30
1650435719729,MATH 10B,A02,083208,Staff,0,7,30,30
1650435719729,MATH 10B,B01,083739,Staff,13,0,30,17
1650435719729,MATH 10B,B02,083740,Staff,28,0,30,2
1650435725756,MATH 18,A01,083743,Staff,2,0,30,28
1650435725756,MATH 18,A02,083744,Staff,27,0,30,3
1650435725756,MATH 18,A03,083745,Staff,22,0,30,8
1650435725756,MATH 18,A04,083746,Staff,26,0,30,4
1650435725756,MATH 18,B01,083748,Staff,0,11,30,30
1650435725756,MATH 18,B02,083749,Staff,0,12,30,30
1650435725756,MATH 18,B03,083750,Staff,0,11,30,30
1650435725756,MATH 18,B04,083751,Staff,0,12,30,30
1650435731782,MATH 20A,A01,083754,Staff,26,0,40,14
1650435737810,MATH 20B,A01,083756,Staff,0,10,30,30
1650435737810,MATH 20B,A02,083757,Staff,0,10,30,30
1650435743842,MATH 20C,A01,083760,Staff,0,15,30,30
1650435743842,MATH 20C,A02,083761,Staff,1,14,30,29
1650435743842,MATH 20C,B01,083762,Staff,13,0,30,17
1650435743842,MATH 20C,B02,083763,Staff,28,0,30,2
1650435749871,MATH 20D,A01,083765,Staff,0,1,30,30
1650435749871,MATH 20D,A02,083766,Staff,9,0,30,21
1650435749871,MATH 20D,A03,083767,Staff,25,0,30,5
1650435755895,MATH 20E,A01,083771,Staff,5,0,30,25
1650435755895,MATH 20E,A02,083772,Staff,18,0,30,12
1650435755895,MATH 20E,B01,083773,Staff,0,0,30,30
1650435755895,MATH 20E,B02,083774,Staff,11,0,30,19
1650435761920,MATH 103A,A01,083777,Staff,0,12,30,30
1650435761920,MATH 103A,A02,083778,Staff,0,12,30,30
1650435761920,MATH 103A,B01,083779,Staff,0,13,30,30
1650435761920,MATH 103A,B02,083780,Staff,0,11,30,30
1650435767948,MATH 105,A01,085443,Staff,0,22,30,30
1650435773973,MATH 109,A01,083213,Anzaldo; Leesa B,0,7,30,30
1650435773973,MATH 109,A02,083214,Anzaldo; Leesa B,0,7,30,30
1650435773973,MATH 109,B01,083215,Anzaldo; Leesa B,0,5,30,30
1650435773973,MATH 109,B02,083216,Anzaldo; Leesa B,0,6,30,30
1650435780002,MATH 142A,A01,083219,Chow; Bennett,0,14,30,30
1650435780002,MATH 142A,A02,083220,Chow; Bennett,0,13,30,30
1650435780002,MATH 142A,B01,083221,Chow; Bennett,0,12,30,30
1650435780002,MATH 142A,B02,083222,Chow; Bennett,0,13,30,30
1650435786030,MATH 193A,A01,083224,Staff,0,5,30,30
1650435786030,MATH 193A,A02,083225,Staff,0,5,30,30
1650435786030,MATH 193A,A03,083781,Staff,0,4,30,30
1650435786030,MATH 193A,A04,083782,Staff,0,4,30,30
1650435792053,MATH 197,001,091859,McAuley; Julian John,9998,0,9999,1
1650435798122,COGS 9,A01,083615,Staff,0,14,60,60
1650435804148,COGS 11,A01,083617,Boyle; Mary E. T.,21,0,40,19
1650435810178,COGS 13,A01,083071,Staff,0,34,40,40
1650435816207,COGS 14A,A01,092681,Staff,0,25,100,100
1650435822234,COGS 14B,A01,083073,Cheng; Tzu-Han,0,11,50,50
1650435828267,COGS 17,A01,092677,Staff,22,0,75,53
1650435834291,COGS 100,A01,083619,Staff,0,26,60,60
1650435840316,COGS 101A,A01,083621,Davis; Joshua Daniel,0,21,60,60
1650435846339,COGS 101B,A01,091572,Staff,0,4,60,60
1650435852367,COGS 101C,A01,083625,Delgado; Tania,16,0,30,14
1650435858393,COGS 107A,A01,083627,Boyle; Mary E. T.,0,11,60,60
1650435864417,COGS 118A,A01,083075,Staff,2,0,60,58
1650435870452,CSE 3,A50,083646,Miranda; Gregory Joseph,20,0,38,18
1650435870452,CSE 3,A51,083647,Miranda; Gregory Joseph,36,0,37,1
1650435876478,CSE 8A,A50,083650,Miranda; Gregory Joseph,0,28,40,40
1650435882503,CSE 11,A01,083080,Cao; Yingjun,0,91,40,40
1650435888534,CSE 12,A01,083652,Staff,0,16,100,100
1650435894568,CSE 15L,A01,083654,Staff,0,1,50,50
1650435894568,CSE 15L,A02,083655,Staff,1,0,50,49
1650435900592,CSE 20,A01,083657,Staff,51,0,80,29
1650435906618,CSE 30,A01,083084,Eldon; John,0,76,40,40
1650435912644,CSE 100,A01,083659,Cao; Yingjun,0,66,50,50
1650435918671,CSE 134B,A01,083661,Powell; Thomas Allan,0,32,65,65
1650435924694,CSE 140,A01,083663,Staff,0,2,75,75
1650435930722,CSE 140L,A01,083088,Eldon; John,0,8,75,75
1650435936744,CSE 175,A01,083665,Kumar; Rakesh,7,0,25,18
1650435942767,CSE 190,A00,092507,Dubnov; Shlomo,14,0,20,6
1650435948790,ECE 45,A01,083139,Staff,0,18,40,40
1650435954813,ECE 65,A50,083695,Staff,0,6,30,30
1650435960837,ECE 109,A01,091882,Touri; Behrouz,38,0,70,32
1650435966864,ECE 180,A00,083140,Abi Samra; Nicholas Camill,23,0,30,7
1650435966864,ECE 180,B00,083141,Abi Samra; Nicholas Camill,0,0,30,30
1650435972904,MATH 10A,A01,083735,Patchell; Gregory David,7,0,30,23
1650435972904,MATH 10A,A02,083736,Patchell; Gregory David,28,0,30,2
1650435972904,MATH 10A,A03,083737,Patchell; Gregory David,25,0,30,5
1650435978929,MATH 10B,A01,083207,Staff,0,7,30,30
1650435978929,MATH 10B,A02,083208,Staff,0,7,30,30
1650435978929,MATH 10B,B01,083739,Staff,13,0,30,17
1650435978929,MATH 10B,B02,083740,Staff,28,0,30,2
1650435984953,MATH 18,A01,083743,Staff,2,0,30,28
1650435984953,MATH 18,A02,083744,Staff,27,0,30,3
1650435984953,MATH 18,A03,083745,Staff,22,0,30,8
1650435984953,MATH 18,A04,083746,Staff,26,0,30,4
1650435984953,MATH 18,B01,083748,Staff,0,11,30,30
1650435984953,MATH 18,B02,083749,Staff,0,12,30,30
1650435984953,MATH 18,B03,083750,Staff,0,11,30,30
1650435984953,MATH 18,B04,083751,Staff,0,12,30,30
1650435990977,MATH 20A,A01,083754,Staff,26,0,40,14
1650435997001,MATH 20B,A01,083756,Staff,0,10,30,30
1650435997001,MATH 20B,A02,083757,Staff,0,10,30,30
1650436003031,MATH 20C,A01,083760,Staff,0,15,30,30
1650436003031,MATH 20C,A02,083761,Staff,1,14,30,29
1650436003031,MATH 20C,B01,083762,Staff,13,0,30,17
1650436003031,MATH 20C,B02,083763,Staff,28,0,30,2
1650436009053,MATH 20D,A01,083765,Staff,0,1,30,30
1650436009053,MATH 20D,A02,083766,Staff,9,0,30,21
1650436009053,MATH 20D,A03,083767,Staff,25,0,30,5
1650436015078,MATH 20E,A01,083771,Staff,5,0,30,25
1650436015078,MATH 20E,A02,083772,Staff,18,0,30,12
1650436015078,MATH 20E,B01,083773,Staff,0,0,30,30
1650436015078,MATH 20E,B02,083774,Staff,11,0,30,19
1650436021110,MATH 103A,A01,083777,Staff,0,12,30,30
1650436021110,MATH 103A,A02,083778,Staff,0,12,30,30
1650436021110,MATH 103A,B01,083779,Staff,0,13,30,30
1650436021110,MATH 103A,B02,083780,Staff,0,11,30,30
1650436027228,MATH 105,A01,085443,Staff,0,22,30,30
1650436033255,MATH 109,A01,083213,Anzaldo; Leesa B,0,7,30,30
1650436033255,MATH 109,A02,083214,Anzaldo; Leesa B,0,7,30,30
1650436033255,MATH 109,B01,083215,Anzaldo; Leesa B,0,5,30,30
1650436033255,MATH 109,B02,083216,Anzaldo; Leesa B,0,6,30,30
1650436039282,MATH 142A,A01,083219,Chow; Bennett,0,14,30,30
1650436039282,MATH 142A,A02,083220,Chow; Bennett,0,13,30,30
1650436039282,MATH 142A,B01,083221,Chow; Bennett,0,12,30,30
1650436039282,MATH 142A,B02,083222,Chow; Bennett,0,13,30,30
1650436045311,MATH 193A,A01,083224,Staff,0,5,30,30
1650436045311,MATH 193A,A02,083225,Staff,0,5,30,30
1650436045311,MATH 193A,A03,083781,Staff,0,4,30,30
1650436045311,MATH 193A,A04,083782,Staff,0,4,30,30
1650436051344,MATH 197,001,091859,McAuley; Julian John,9998,0,9999,1
1650436057399,COGS 9,A01,083615,Staff,0,14,60,60
1650436063426,COGS 11,A01,083617,Boyle; Mary E. T.,21,0,40,19
1650436069450,COGS 13,A01,083071,Staff,0,34,40,40
1650436075477,COGS 14A,A01,092681,Staff,0,25,100,100
1650436081502,COGS 14B,A01,083073,Cheng; Tzu-Han,0,11,50,50
1650436087530,COGS 17,A01,092677,Staff,22,0,75,53
1650436093554,COGS 100,A01,083619,Staff,0,26,60,60
1650436099578,COGS 101A,A01,083621,Davis; Joshua Daniel,0,21,60,60
1650436105608,COGS 101B,A01,091572,Staff,0,4,60,60
1650436111630,COGS 101C,A01,083625,Delgado; Tania,16,0,30,14
1650436117653,COGS 107A,A01,083627,Boyle; Mary E. T.,0,11,60,60
1650436123684,COGS 118A,A01,083075,Staff,2,0,60,58
1650436129713,CSE 3,A50,083646,Miranda; Gregory Joseph,20,0,38,18
1650436129713,CSE 3,A51,083647,Miranda; Gregory Joseph,36,0,37,1
1650436135741,CSE 8A,A50,083650,Miranda; Gregory Joseph,0,28,40,40
1650436141766,CSE 11,A01,083080,Cao; Yingjun,0,91,40,40
1650436147788,CSE 12,A01,083652,Staff,0,16,100,100
1650436153814,CSE 15L,A01,083654,Staff,0,1,50,50
1650436153814,CSE 15L,A02,083655,Staff,1,0,50,49
1650436159838,CSE 20,A01,083657,Staff,51,0,80,29
1650436165868,CSE 30,A01,083084,Eldon; John,0,76,40,40
1650436171899,CSE 100,A01,083659,Cao; Yingjun,0,66,50,50
1650436177924,CSE 134B,A01,083661,Powell; Thomas Allan,0,32,65,65
1650436183954,CSE 140,A01,083663,Staff,0,2,75,75
1650436189978,CSE 140L,A01,083088,Eldon; John,0,8,75,75
1650436196008,CSE 175,A01,083665,Kumar; Rakesh,7,0,25,18
1650436202031,CSE 190,A00,092507,Dubnov; Shlomo,14,0,20,6
1650436208057,ECE 45,A01,083139,Staff,0,18,40,40
1650436214092,ECE 65,A50,083695,Staff,0,6,30,30
1650436220118,ECE 109,A01,091882,Touri; Behrouz,38,0,70,32
1650436226140,ECE 180,A00,083140,Abi Samra; Nicholas Camill,23,0,30,7
1650436226140,ECE 180,B00,083141,Abi Samra; Nicholas Camill,0,0,30,30
1650436232164,MATH 10A,A01,083735,Patchell; Gregory David,7,0,30,23
1650436232164,MATH 10A,A02,083736,Patchell; Gregory David,28,0,30,2
1650436232164,MATH 10A,A03,083737,Patchell; Gregory David,25,0,30,5
1650436238187,MATH 10B,A01,083207,Staff,0,7,30,30
1650436238187,MATH 10B,A02,083208,Staff,0,7,30,30
1650436238187,MATH 10B,B01,083739,Staff,13,0,30,17
1650436238187,MATH 10B,B02,083740,Staff,28,0,30,2
1650436244234,MATH 18,A01,083743,Staff,2,0,30,28
1650436244234,MATH 18,A02,083744,Staff,27,0,30,3
1650436244234,MATH 18,A03,083745,Staff,22,0,30,8
1650436244234,MATH 18,A04,083746,Staff,26,0,30,4
1650436244234,MATH 18,B01,083748,Staff,0,11,30,30
1650436244234,MATH 18,B02,083749,Staff,0,12,30,30
1650436244234,MATH 18,B03,083750,Staff,0,11,30,30
1650436244234,MATH 18,B04,083751,Staff,0,12,30,30
1650436250256,MATH 20A,A01,083754,Staff,26,0,40,14
1650436256283,MATH 20B,A01,083756,Staff,0,10,30,30
1650436256283,MATH 20B,A02,083757,Staff,0,10,30,30
1650436262315,MATH 20C,A01,083760,Staff,0,15,30,30
1650436262315,MATH 20C,A02,083761,Staff,1,14,30,29
1650436262315,MATH 20C,B01,083762,Staff,13,0,30,17
1650436262315,MATH 20C,B02,083763,Staff,28,0,30,2
1650436268337,MATH 20D,A01,083765,Staff,0,1,30,30
1650436268337,MATH 20D,A02,083766,Staff,9,0,30,21
1650436268337,MATH 20D,A03,083767,Staff,25,0,30,5
1650436274363,MATH 20E,A01,083771,Staff,5,0,30,25
1650436274363,MATH 20E,A02,083772,Staff,18,0,30,12
1650436274363,MATH 20E,B01,083773,Staff,0,0,30,30
1650436274363,MATH 20E,B02,083774,Staff,11,0,30,19
1650436280385,MATH 103A,A01,083777,Staff,0,12,30,30
1650436280385,MATH 103A,A02,083778,Staff,0,12,30,30
1650436280385,MATH 103A,B01,083779,Staff,0,13,30,30
1650436280385,MATH 103A,B02,083780,Staff,0,11,30,30
1650436286429,MATH 105,A01,085443,Staff,0,22,30,30
1650436292460,MATH 109,A01,083213,Anzaldo; Leesa B,0,7,30,30
1650436292460,MATH 109,A02,083214,Anzaldo; Leesa B,0,7,30,30
1650436292460,MATH 109,B01,083215,Anzaldo; Leesa B,0,5,30,30
1650436292460,MATH 109,B02,083216,Anzaldo; Leesa B,0,6,30,30
1650436298483,MATH 142A,A01,083219,Chow; Bennett,0,14,30,30
1650436298483,MATH 142A,A02,083220,Chow; Bennett,0,13,30,30
1650436298483,MATH 142A,B01,083221,Chow; Bennett,0,12,30,30
1650436298483,MATH 142A,B02,083222,Chow; Bennett,0,13,30,30
1650436304509,MATH 193A,A01,083224,Staff,0,5,30,30
1650436304509,MATH 193A,A02,083225,Staff,0,5,30,30
1650436304509,MATH 193A,A03,083781,Staff,0,4,30,30
1650436304509,MATH 193A,A04,083782,Staff,0,4,30,30
1650436310534,MATH 197,001,091859,McAuley; Julian John,9998,0,9999,1
1650436316602,COGS 9,A01,083615,Staff,0,14,60,60
1650436322632,COGS 11,A01,083617,Boyle; Mary E. T.,21,0,40,19
1650436328658,COGS 13,A01,083071,Staff,0,34,40,40
1650436334682,COGS 14A,A01,092681,Staff,0,25,100,100
1650436340705,COGS 14B,A01,083073,Cheng; Tzu-Han,0,11,50,50
1650436346758,COGS 17,A01,092677,Staff,22,0,75,53
1650436352782,COGS 100,A01,083619,Staff,0,26,60,60
1650436358820,COGS 101A,A01,083621,Davis; Joshua Daniel,0,21,60,60
1650436364846,COGS 101B,A01,091572,Staff,0,4,60,60
1650436370874,COGS 101C,A01,083625,Delgado; Tania,16,0,30,14
1650436376895,COGS 107A,A01,083627,Boyle; Mary E. T.,0,11,60,60
1650436382918,COGS 118A,A01,083075,Staff,2,0,60,58
1650436388942,CSE 3,A50,083646,Miranda; Gregory Joseph,20,0,38,18
1650436388942,CSE 3,A51,083647,Miranda; Gregory Joseph,36,0,37,1
1650436394969,CSE 8A,A50,083650,Miranda; Gregory Joseph,0,28,40,40
1650436400995,CSE 11,A01,083080,Cao; Yingjun,0,91,40,40
1650436407022,CSE 12,A01,083652,Staff,0,16,100,100
1650436413048,CSE 15L,A01,083654,Staff,0,1,50,50
1650436413048,CSE 15L,A02,083655,Staff,1,0,50,49
1650436419076,CSE 20,A01,083657,Staff,51,0,80,29
1650436425103,CSE 30,A01,083084,Eldon; John,0,76,40,40
1650436431129,CSE 100,A01,083659,Cao; Yingjun,0,66,50,50
1650436437156,CSE 134B,A01,083661,Powell; Thomas Allan,0,32,65,65
1650436443183,CSE 140,A01,083663,Staff,0,2,75,75
1650436449216,CSE 140L,A01,083088,Eldon; John,0,8,75,75
1650436455248,CSE 175,A01,083665,Kumar; Rakesh,7,0,25,18
1650436461272,CSE 190,A00,092507,Dubnov; Shlomo,14,0,20,6
1650436467299,ECE 45,A01,083139,Staff,0,18,40,40
1650436473322,ECE 65,A50,083695,Staff,0,6,30,30
1650436479349,ECE 109,A01,091882,Touri; Behrouz,38,0,70,32
1650436485373,ECE 180,A00,083140,Abi Samra; Nicholas Camill,23,0,30,7
1650436485373,ECE 180,B00,083141,Abi Samra; Nicholas Camill,0,0,30,30
1650436491400,MATH 10A,A01,083735,Patchell; Gregory David,7,0,30,23
1650436491400,MATH 10A,A02,083736,Patchell; Gregory David,28,0,30,2
1650436491400,MATH 10A,A03,083737,Patchell; Gregory David,25,0,30,5
1650436497425,MATH 10B,A01,083207,Staff,0,7,30,30
1650436497425,MATH 10B,A02,083208,Staff,0,7,30,30
1650436497425,MATH 10B,B01,083739,Staff,13,0,30,17
1650436497425,MATH 10B,B02,083740,Staff,28,0,30,2
1650436503459,MATH 18,A01,083743,Staff,2,0,30,28
1650436503459,MATH 18,A02,083744,Staff,27,0,30,3
1650436503459,MATH 18,A03,083745,Staff,22,0,30,8
1650436503459,MATH 18,A04,083746,Staff,26,0,30,4
1650436503459,MATH 18,B01,083748,Staff,0,11,30,30
1650436503459,MATH 18,B02,083749,Staff,0,12,30,30
1650436503459,MATH 18,B03,083750,Staff,0,11,30,30
1650436503459,MATH 18,B04,083751,Staff,0,12,30,30
1650436509483,MATH 20A,A01,083754,Staff,26,0,40,14
1650436515508,MATH 20B,A01,083756,Staff,0,10,30,30
1650436515508,MATH 20B,A02,083757,Staff,0,10,30,30
1650436521530,MATH 20C,A01,083760,Staff,0,15,30,30
1650436521530,MATH 20C,A02,083761,Staff,1,14,30,29
1650436521530,MATH 20C,B01,083762,Staff,13,0,30,17
1650436521530,MATH 20C,B02,083763,Staff,28,0,30,2
1650436527553,MATH 20D,A01,083765,Staff,0,1,30,30
1650436527553,MATH 20D,A02,083766,Staff,9,0,30,21
1650436527553,MATH 20D,A03,083767,Staff,25,0,30,5
1650436533580,MATH 20E,A01,083771,Staff,5,0,30,25
1650436533580,MATH 20E,A02,083772,Staff,18,0,30,12
1650436533580,MATH 20E,B01,083773,Staff,0,0,30,30
1650436533580,MATH 20E,B02,083774,Staff,10,0,30,20
1650436539606,MATH 103A,A01,083777,Staff,0,12,30,30
1650436539606,MATH 103A,A02,083778,Staff,0,12,30,30
1650436539606,MATH 103A,B01,083779,Staff,0,13,30,30
1650436539606,MATH 103A,B02,083780,Staff,0,11,30,30
1650436545633,MATH 105,A01,085443,Staff,0,22,30,30
1650436551658,MATH 109,A01,083213,Anzaldo; Leesa B,0,7,30,30
1650436551658,MATH 109,A02,083214,Anzaldo; Leesa B,0,7,30,30
1650436551658,MATH 109,B01,083215,Anzaldo; Leesa B,0,5,30,30
1650436551658,MATH 109,B02,083216,Anzaldo; Leesa B,0,6,30,30
1650436557680,MATH 142A,A01,083219,Chow; Bennett,0,14,30,30
1650436557680,MATH 142A,A02,083220,Chow; Bennett,0,13,30,30
1650436557680,MATH 142A,B01,083221,Chow; Bennett,0,12,30,30
1650436557680,MATH 142A,B02,083222,Chow; Bennett,0,13,30,30
1650436563706,MATH 193A,A01,083224,Staff,0,5,30,30
1650436563706,MATH 193A,A02,083225,Staff,0,5,30,30
1650436563706,MATH 193A,A03,083781,Staff,0,4,30,30
1650436563706,MATH 193A,A04,083782,Staff,0,4,30,30
1650436569732,MATH 197,001,091859,McAuley; Julian John,9998,0,9999,1
1650436575787,COGS 9,A01,083615,Staff,0,14,60,60
1650436581810,COGS 11,A01,083617,Boyle; Mary E. T.,21,0,40,19
1650436587832,COGS 13,A01,083071,Staff,0,34,40,40
1650436593868,COGS 14A,A01,092681,Staff,0,25,100,100
1650436599895,COGS 14B,A01,083073,Cheng; Tzu-Han,0,11,50,50
1650436605919,COGS 17,A01,092677,Staff,22,0,75,53
1650436611953,COGS 100,A01,083619,Staff,0,26,60,60
1650436618066,COGS 101A,A01,083621,Davis; Joshua Daniel,0,21,60,60
1650436624091,COGS 101B,A01,091572,Staff,0,4,60,60
1650436630113,COGS 101C,A01,083625,Delgado; Tania,16,0,30,14
1650436636139,COGS 107A,A01,083627,Boyle; Mary E. T.,0,11,60,60
1650436642167,COGS 118A,A01,083075,Staff,2,0,60,58
1650436648197,CSE 3,A50,083646,Miranda; Gregory Joseph,20,0,38,18
1650436648197,CSE 3,A51,083647,Miranda; Gregory Joseph,36,0,37,1
1650436654222,CSE 8A,A50,083650,Miranda; Gregory Joseph,0,28,40,40
1650436660245,CSE 11,A01,083080,Cao; Yingjun,0,91,40,40
1650436666270,CSE 12,A01,083652,Staff,0,16,100,100
1650436672295,CSE 15L,A01,083654,Staff,0,1,50,50
1650436672295,CSE 15L,A02,083655,Staff,1,0,50,49
1650436678334,CSE 20,A01,083657,Staff,51,0,80,29
1650436684357,CSE 30,A01,083084,Eldon; John,0,76,40,40
1650436690381,CSE 100,A01,083659,Cao; Yingjun,0,66,50,50
1650436696412,CSE 134B,A01,083661,Powell; Thomas Allan,0,32,65,65
1650436702447,CSE 140,A01,083663,Staff,0,2,75,75
1650436708479,CSE 140L,A01,083088,Eldon; John,0,8,75,75
1650436714503,CSE 175,A01,083665,Kumar; Rakesh,7,0,25,18
1650436720531,CSE 190,A00,092507,Dubnov; Shlomo,14,0,20,6
1650436726556,ECE 45,A01,083139,Staff,0,18,40,40
1650436732580,ECE 65,A50,083695,Staff,0,6,30,30
1650436738616,ECE 109,A01,091882,Touri; Behrouz,38,0,70,32
1650436744642,ECE 180,A00,083140,Abi Samra; Nicholas Camill,23,0,30,7
1650436744642,ECE 180,B00,083141,Abi Samra; Nicholas Camill,0,0,30,30
1650436750678,MATH 10A,A01,083735,Patchell; Gregory David,7,0,30,23
1650436750678,MATH 10A,A02,083736,Patchell; Gregory David,28,0,30,2
1650436750678,MATH 10A,A03,083737,Patchell; Gregory David,25,0,30,5
1650436756706,MATH 10B,A01,083207,Staff,0,7,30,30
1650436756706,MATH 10B,A02,083208,Staff,0,7,30,30
1650436756706,MATH 10B,B01,083739,Staff,13,0,30,17
1650436756706,MATH 10B,B02,083740,Staff,28,0,30,2
1650436762737,MATH 18,A01,083743,Staff,2,0,30,28
1650436762737,MATH 18,A02,083744,Staff,27,0,30,3
1650436762737,MATH 18,A03,083745,Staff,22,0,30,8
1650436762737,MATH 18,A04,083746,Staff,26,0,30,4
1650436762737,MATH 18,B01,083748,Staff,0,11,30,30
1650436762737,MATH 18,B02,083749,Staff,0,12,30,30
1650436762737,MATH 18,B03,083750,Staff,0,11,30,30
1650436762737,MATH 18,B04,083751,Staff,0,12,30,30
1650436768765,MATH 20A,A01,083754,Staff,26,0,40,14
1650436774789,MATH 20B,A01,083756,Staff,0,10,30,30
1650436774789,MATH 20B,A02,083757,Staff,0,10,30,30
1650436780814,MATH 20C,A01,083760,Staff,0,15,30,30
1650436780814,MATH 20C,A02,083761,Staff,1,14,30,29
1650436780814,MATH 20C,B01,083762,Staff,13,0,30,17
1650436780814,MATH 20C,B02,083763,Staff,28,0,30,2
1650436786838,MATH 20D,A01,083765,Staff,0,1,30,30
1650436786838,MATH 20D,A02,083766,Staff,9,0,30,21
1650436786838,MATH 20D,A03,083767,Staff,25,0,30,5
1650436792864,MATH 20E,A01,083771,Staff,5,0,30,25
1650436792864,MATH 20E,A02,083772,Staff,18,0,30,12
1650436792864,MATH 20E,B01,083773,Staff,0,0,30,30
1650436792864,MATH 20E,B02,083774,Staff,10,0,30,20
1650436798890,MATH 103A,A01,083777,Staff,0,12,30,30
1650436798890,MATH 103A,A02,083778,Staff,0,12,30,30
1650436798890,MATH 103A,B01,083779,Staff,0,13,30,30
1650436798890,MATH 103A,B02,083780,Staff,0,11,30,30
1650436804914,MATH 105,A01,085443,Staff,0,22,30,30
1650436810939,MATH 109,A01,083213,Anzaldo; Leesa B,0,7,30,30
1650436810939,MATH 109,A02,083214,Anzaldo; Leesa B,0,7,30,30
1650436810939,MATH 109,B01,083215,Anzaldo; Leesa B,0,5,30,30
1650436810939,MATH 109,B02,083216,Anzaldo; Leesa B,0,6,30,30
1650436816975,MATH 142A,A01,083219,Chow; Bennett,0,14,30,30
1650436816975,MATH 142A,A02,083220,Chow; Bennett,0,13,30,30
1650436816975,MATH 142A,B01,083221,Chow; Bennett,0,12,30,30
1650436816975,MATH 142A,B02,083222,Chow; Bennett,0,13,30,30
1650436823000,MATH 193A,A01,083224,Staff,0,5,30,30
1650436823000,MATH 193A,A02,083225,Staff,0,5,30,30
1650436823000,MATH 193A,A03,083781,Staff,0,4,30,30
1650436823000,MATH 193A,A04,083782,Staff,0,4,30,30
1650436829037,MATH 197,001,091859,McAuley; Julian John,9998,0,9999,1
1650436835099,COGS 9,A01,083615,Staff,0,14,60,60
1650436841123,COGS 11,A01,083617,Boyle; Mary E. T.,21,0,40,19
1650436847157,COGS 13,A01,083071,Staff,0,34,40,40
1650436853198,COGS 14A,A01,092681,Staff,0,25,100,100
1650436859223,COGS 14B,A01,083073,Cheng; Tzu-Han,0,11,50,50
1650436865251,COGS 17,A01,092677,Staff,22,0,75,53
1650436871274,COGS 100,A01,083619,Staff,0,26,60,60
1650436877300,COGS 101A,A01,083621,Davis; Joshua Daniel,0,21,60,60
1650436883341,COGS 101B,A01,091572,Staff,0,4,60,60
1650436889377,COGS 101C,A01,083625,Delgado; Tania,16,0,30,14
1650436895403,COGS 107A,A01,083627,Boyle; Mary E. T.,0,11,60,60
1650436901430,COGS 118A,A01,083075,Staff,2,0,60,58
1650436907458,CSE 3,A50,083646,Miranda; Gregory Joseph,20,0,38,18
1650436907458,CSE 3,A51,083647,Miranda; Gregory Joseph,36,0,37,1
1650436913483,CSE 8A,A50,083650,Miranda; Gregory Joseph,0,28,40,40
1650436919533,CSE 11,A01,083080,Cao; Yingjun,0,91,40,40
1650436925558,CSE 12,A01,083652,Staff,0,16,100,100
1650436931585,CSE 15L,A01,083654,Staff,0,1,50,50
1650436931585,CSE 15L,A02,083655,Staff,1,0,50,49
1650436937610,CSE 20,A01,083657,Staff,51,0,80,29
1650436943635,CSE 30,A01,083084,Eldon; John,0,76,40,40
1650436949656,CSE 100,A01,083659,Cao; Yingjun,0,66,50,50
1650436955684,CSE 134B,A01,083661,Powell; Thomas Allan,0,32,65,65
1650436961716,CSE 140,A01,083663,Staff,0,2,75,75
1650436967743,CSE 140L,A01,083088,Eldon; John,0,8,75,75
1650436973767,CSE 175,A01,083665,Kumar; Rakesh,7,0,25,18
1650436979793,CSE 190,A00,092507,Dubnov; Shlomo,14,0,20,6
1650436985819,ECE 45,A01,083139,Staff,0,18,40,40
1650436991843,ECE 65,A50,083695,Staff,0,6,30,30
1650436997866,ECE 109,A01,091882,Touri; Behrouz,38,0,70,32
1650437003893,ECE 180,A00,083140,Abi Samra; Nicholas Camill,23,0,30,7
1650437003893,ECE 180,B00,083141,Abi Samra; Nicholas Camill,0,0,30,30
1650437009921,MATH 10A,A01,083735,Patchell; Gregory David,7,0,30,23
1650437009921,MATH 10A,A02,083736,Patchell; Gregory David,28,0,30,2
1650437009921,MATH 10A,A03,083737,Patchell; Gregory David,25,0,30,5
1650437015947,MATH 10B,A01,083207,Staff,0,7,30,30
1650437015947,MATH 10B,A02,083208,Staff,0,7,30,30
1650437015947,MATH 10B,B01,083739,Staff,13,0,30,17
1650437015947,MATH 10B,B02,083740,Staff,28,0,30,2
1650437021971,MATH 18,A01,083743,Staff,2,0,30,28
1650437021971,MATH 18,A02,083744,Staff,27,0,30,3
1650437021971,MATH 18,A03,083745,Staff,22,0,30,8
1650437021971,MATH 18,A04,083746,Staff,26,0,30,4
1650437021971,MATH 18,B01,083748,Staff,0,11,30,30
1650437021971,MATH 18,B02,083749,Staff,0,12,30,30
1650437021971,MATH 18,B03,083750,Staff,0,11,30,30
1650437021971,MATH 18,B04,083751,Staff,0,12,30,30
1650437027995,MATH 20A,A01,083754,Staff,26,0,40,14
1650437034025,MATH 20B,A01,083756,Staff,0,10,30,30
1650437034025,MATH 20B,A02,083757,Staff,0,10,30,30
1650437040049,MATH 20C,A01,083760,Staff,0,15,30,30
1650437040049,MATH 20C,A02,083761,Staff,1,14,30,29
1650437040049,MATH 20C,B01,083762,Staff,13,0,30,17
1650437040049,MATH 20C,B02,083763,Staff,28,0,30,2
1650437046073,MATH 20D,A01,083765,Staff,0,1,30,30
1650437046073,MATH 20D,A02,083766,Staff,9,0,30,21
1650437046073,MATH 20D,A03,083767,Staff,25,0,30,5
1650437052098,MATH 20E,A01,083771,Staff,5,0,30,25
1650437052098,MATH 20E,A02,083772,Staff,18,0,30,12
1650437052098,MATH 20E,B01,083773,Staff,0,0,30,30
1650437052098,MATH 20E,B02,083774,Staff,10,0,30,20
1650437058126,MATH 103A,A01,083777,Staff,0,12,30,30
1650437058126,MATH 103A,A02,083778,Staff,0,12,30,30
1650437058126,MATH 103A,B01,083779,Staff,0,13,30,30
1650437058126,MATH 103A,B02,083780,Staff,0,11,30,30
1650437064151,MATH 105,A01,085443,Staff,0,22,30,30
1650437070176,MATH 109,A01,083213,Anzaldo; Leesa B,0,7,30,30
1650437070176,MATH 109,A02,083214,Anzaldo; Leesa B,0,7,30,30
1650437070176,MATH 109,B01,083215,Anzaldo; Leesa B,0,5,30,30
1650437070176,MATH 109,B02,083216,Anzaldo; Leesa B,0,6,30,30
1650437076200,MATH 142A,A01,083219,Chow; Bennett,0,14,30,30
1650437076200,MATH 142A,A02,083220,Chow; Bennett,0,13,30,30
1650437076200,MATH 142A,B01,083221,Chow; Bennett,0,12,30,30
1650437076200,MATH 142A,B02,083222,Chow; Bennett,0,13,30,30
1650437082225,MATH 193A,A01,083224,Staff,0,5,30,30
1650437082225,MATH 193A,A02,083225,Staff,0,5,30,30
1650437082225,MATH 193A,A03,083781,Staff,0,4,30,30
1650437082225,MATH 193A,A04,083782,Staff,0,4,30,30
1650437088260,MATH 197,001,091859,McAuley; Julian John,9998,0,9999,1
1650437094319,COGS 9,A01,083615,Staff,0,14,60,60
1650437100346,COGS 11,A01,083617,Boyle; Mary E. T.,21,0,40,19
1650437106373,COGS 13,A01,083071,Staff,0,34,40,40
1650437112397,COGS 14A,A01,092681,Staff,0,25,100,100
1650437118430,COGS 14B,A01,083073,Cheng; Tzu-Han,0,11,50,50
1650437124466,COGS 17,A01,092677,Staff,22,0,75,53
1650437130499,COGS 100,A01,083619,Staff,0,26,60,60
1650437136524,COGS 101A,A01,083621,Davis; Joshua Daniel,0,21,60,60
1650437142546,COGS 101B,A01,091572,Staff,0,4,60,60
1650437148572,COGS 101C,A01,083625,Delgado; Tania,16,0,30,14
1650437154595,COGS 107A,A01,083627,Boyle; Mary E. T.,0,11,60,60
1650437160621,COGS 118A,A01,083075,Staff,2,0,60,58
1650437166647,CSE 3,A50,083646,Miranda; Gregory Joseph,20,0,38,18
1650437166647,CSE 3,A51,083647,Miranda; Gregory Joseph,36,0,37,1
1650437172670,CSE 8A,A50,083650,Miranda; Gregory Joseph,0,28,40,40
1650437178704,CSE 11,A01,083080,Cao; Yingjun,0,91,40,40
1650437184728,CSE 12,A01,083652,Staff,0,16,100,100
1650437190753,CSE 15L,A01,083654,Staff,0,1,50,50
1650437190753,CSE 15L,A02,083655,Staff,1,0,50,49
1650437196775,CSE 20,A01,083657,Staff,51,0,80,29
1650437202802,CSE 30,A01,083084,Eldon; John,0,76,40,40
1650437208829,CSE 100,A01,083659,Cao; Yingjun,0,66,50,50
1650437214945,CSE 134B,A01,083661,Powell; Thomas Allan,0,32,65,65
1650437220971,CSE 140,A01,083663,Staff,0,2,75,75
1650437226995,CSE 140L,A01,083088,Eldon; John,0,8,75,75
1650437233021,CSE 175,A01,083665,Kumar; Rakesh,7,0,25,18
1650437239051,CSE 190,A00,092507,Dubnov; Shlomo,14,0,20,6
1650437245073,ECE 45,A01,083139,Staff,0,18,40,40
1650437251095,ECE 65,A50,083695,Staff,0,6,30,30
1650437257118,ECE 109,A01,091882,Touri; Behrouz,38,0,70,32
1650437263142,ECE 180,A00,083140,Abi Samra; Nicholas Camill,23,0,30,7
1650437263142,ECE 180,B00,083141,Abi Samra; Nicholas Camill,0,0,30,30
1650437269166,MATH 10A,A01,083735,Patchell; Gregory David,7,0,30,23
1650437269166,MATH 10A,A02,083736,Patchell; Gregory David,28,0,30,2
1650437269166,MATH 10A,A03,083737,Patchell; Gregory David,25,0,30,5
1650437275194,MATH 10B,A01,083207,Staff,0,7,30,30
1650437275194,MATH 10B,A02,083208,Staff,0,7,30,30
1650437275194,MATH 10B,B01,083739,Staff,13,0,30,17
1650437275194,MATH 10B,B02,083740,Staff,28,0,30,2
1650437281238,MATH 18,A01,083743,Staff,2,0,30,28
1650437281238,MATH 18,A02,083744,Staff,27,0,30,3
1650437281238,MATH 18,A03,083745,Staff,22,0,30,8
1650437281238,MATH 18,A04,083746,Staff,26,0,30,4
1650437281238,MATH 18,B01,083748,Staff,0,11,30,30
1650437281238,MATH 18,B02,083749,Staff,0,12,30,30
1650437281238,MATH 18,B03,083750,Staff,0,11,30,30
1650437281238,MATH 18,B04,083751,Staff,0,12,30,30
1650437287265,MATH 20A,A01,083754,Staff,26,0,40,14
1650437293289,MATH 20B,A01,083756,Staff,0,10,30,30
1650437293289,MATH 20B,A02,083757,Staff,0,10,30,30
1650437299314,MATH 20C,A01,083760,Staff,0,15,30,30
1650437299314,MATH 20C,A02,083761,Staff,1,14,30,29
1650437299314,MATH 20C,B01,083762,Staff,13,0,30,17
1650437299314,MATH 20C,B02,083763,Staff,28,0,30,2
1650437305342,MATH 20D,A01,083765,Staff,0,1,30,30
1650437305342,MATH 20D,A02,083766,Staff,9,0,30,21
1650437305342,MATH 20D,A03,083767,Staff,25,0,30,5
1650437311380,MATH 20E,A01,083771,Staff,5,0,30,25
1650437311380,MATH 20E,A02,083772,Staff,18,0,30,12
1650437311380,MATH 20E,B01,083773,Staff,0,0,30,30
1650437311380,MATH 20E,B02,083774,Staff,10,0,30,20
1650437317412,MATH 103A,A01,083777,Staff,0,12,30,30
1650437317412,MATH 103A,A02,083778,Staff,0,12,30,30
1650437317412,MATH 103A,B01,083779,Staff,0,13,30,30
1650437317412,MATH 103A,B02,083780,Staff,0,11,30,30
1650437323437,MATH 105,A01,085443,Staff,0,22,30,30
1650437329462,MATH 109,A01,083213,Anzaldo; Leesa B,0,7,30,30
1650437329462,MATH 109,A02,083214,Anzaldo; Leesa B,0,7,30,30
1650437329462,MATH 109,B01,083215,Anzaldo; Leesa B,0,5,30,30
1650437329462,MATH 109,B02,083216,Anzaldo; Leesa B,0,6,30,30
1650437335490,MATH 142A,A01,083219,Chow; Bennett,0,14,30,30
1650437335490,MATH 142A,A02,083220,Chow; Bennett,0,13,30,30
1650437335490,MATH 142A,B01,083221,Chow; Bennett,0,12,30,30
1650437335490,MATH 142A,B02,083222,Chow; Bennett,0,13,30,30
1650437341513,MATH 193A,A01,083224,Staff,0,5,30,30
1650437341513,MATH 193A,A02,083225,Staff,0,5,30,30
1650437341513,MATH 193A,A03,083781,Staff,0,4,30,30
1650437341513,MATH 193A,A04,083782,Staff,0,4,30,30
1650437347537,MATH 197,001,091859,McAuley; Julian John,9998,0,9999,1
1650437353596,COGS 9,A01,083615,Staff,0,14,60,60
1650437359622,COGS 11,A01,083617,Boyle; Mary E. T.,21,0,40,19
1650437365646,COGS 13,A01,083071,Staff,0,34,40,40
1650437371669,COGS 14A,A01,092681,Staff,0,25,100,100
1650437377696,COGS 14B,A01,083073,Cheng; Tzu-Han,0,11,50,50
1650437383720,COGS 17,A01,092677,Staff,22,0,75,53
1650437389745,COGS 100,A01,083619,Staff,0,26,60,60
1650437395772,COGS 101A,A01,083621,Davis; Joshua Daniel,0,21,60,60
1650437401807,COGS 101B,A01,091572,Staff,0,4,60,60
1650437407831,COGS 101C,A01,083625,Delgado; Tania,16,0,30,14
1650437413855,COGS 107A,A01,083627,Boyle; Mary E. T.,0,11,60,60
1650437419881,COGS 118A,A01,083075,Staff,2,0,60,58
1650437425910,CSE 3,A50,083646,Miranda; Gregory Joseph,20,0,38,18
1650437425910,CSE 3,A51,083647,Miranda; Gregory Joseph,36,0,37,1
1650437431931,CSE 8A,A50,083650,Miranda; Gregory Joseph,0,28,40,40
1650437437958,CSE 11,A01,083080,Cao; Yingjun,0,91,40,40
1650437443983,CSE 12,A01,083652,Staff,0,16,100,100
1650437450007,CSE 15L,A01,083654,Staff,0,1,50,50
1650437450007,CSE 15L,A02,083655,Staff,1,0,50,49
1650437456032,CSE 20,A01,083657,Staff,51,0,80,29
1650437462060,CSE 30,A01,083084,Eldon; John,0,76,40,40
1650437468088,CSE 100,A01,083659,Cao; Yingjun,0,66,50,50
1650437474111,CSE 134B,A01,083661,Powell; Thomas Allan,0,32,65,65
1650437480147,CSE 140,A01,083663,Staff,0,2,75,75
1650437486171,CSE 140L,A01,083088,Eldon; John,0,8,75,75
1650437492195,CSE 175,A01,083665,Kumar; Rakesh,7,0,25,18
1650437498222,CSE 190,A00,092507,Dubnov; Shlomo,14,0,20,6
1650437504248,ECE 45,A01,083139,Staff,0,18,40,40
1650437510272,ECE 65,A50,083695,Staff,0,6,30,30
1650437516305,ECE 109,A01,091882,Touri; Behrouz,38,0,70,32
1650437522332,ECE 180,A00,083140,Abi Samra; Nicholas Camill,23,0,30,7
1650437522332,ECE 180,B00,083141,Abi Samra; Nicholas Camill,0,0,30,30
1650437528361,MATH 10A,A01,083735,Patchell; Gregory David,7,0,30,23
1650437528361,MATH 10A,A02,083736,Patchell; Gregory David,28,0,30,2
1650437528361,MATH 10A,A03,083737,Patchell; Gregory David,25,0,30,5
1650437534395,MATH 10B,A01,083207,Staff,0,7,30,30
1650437534395,MATH 10B,A02,083208,Staff,0,7,30,30
1650437534395,MATH 10B,B01,083739,Staff,13,0,30,17
1650437534395,MATH 10B,B02,083740,Staff,28,0,30,2
1650437540424,MATH 18,A01,083743,Staff,2,0,30,28
1650437540424,MATH 18,A02,083744,Staff,27,0,30,3
1650437540424,MATH 18,A03,083745,Staff,22,0,30,8
1650437540424,MATH 18,A04,083746,Staff,26,0,30,4
1650437540424,MATH 18,B01,083748,Staff,0,11,30,30
1650437540424,MATH 18,B02,083749,Staff,0,12,30,30
1650437540424,MATH 18,B03,083750,Staff,0,11,30,30
1650437540424,MATH 18,B04,083751,Staff,0,12,30,30
1650437546447,MATH 20A,A01,083754,Staff,26,0,40,14
1650437552474,MATH 20B,A01,083756,Staff,0,10,30,30
1650437552474,MATH 20B,A02,083757,Staff,0,10,30,30
1650437558500,MATH 20C,A01,083760,Staff,0,15,30,30
1650437558500,MATH 20C,A02,083761,Staff,1,14,30,29
1650437558500,MATH 20C,B01,083762,Staff,13,0,30,17
1650437558500,MATH 20C,B02,083763,Staff,28,0,30,2
1650437564527,MATH 20D,A01,083765,Staff,0,1,30,30
1650437564527,MATH 20D,A02,083766,Staff,9,0,30,21
1650437564527,MATH 20D,A03,083767,Staff,25,0,30,5
1650437570551,MATH 20E,A01,083771,Staff,5,0,30,25
1650437570551,MATH 20E,A02,083772,Staff,18,0,30,12
1650437570551,MATH 20E,B01,083773,Staff,0,0,30,30
1650437570551,MATH 20E,B02,083774,Staff,10,0,30,20
1650437576575,MATH 103A,A01,083777,Staff,0,12,30,30
1650437576575,MATH 103A,A02,083778,Staff,0,12,30,30
1650437576575,MATH 103A,B01,083779,Staff,0,13,30,30
1650437576575,MATH 103A,B02,083780,Staff,0,11,30,30
1650437582600,MATH 105,A01,085443,Staff,0,22,30,30
1650437588628,MATH 109,A01,083213,Anzaldo; Leesa B,0,7,30,30
1650437588628,MATH 109,A02,083214,Anzaldo; Leesa B,0,7,30,30
1650437588628,MATH 109,B01,083215,Anzaldo; Leesa B,0,5,30,30
1650437588628,MATH 109,B02,083216,Anzaldo; Leesa B,0,6,30,30
1650437594652,MATH 142A,A01,083219,Chow; Bennett,0,14,30,30
1650437594652,MATH 142A,A02,083220,Chow; Bennett,0,13,30,30
1650437594652,MATH 142A,B01,083221,Chow; Bennett,0,12,30,30
1650437594652,MATH 142A,B02,083222,Chow; Bennett,0,13,30,30
1650437600676,MATH 193A,A01,083224,Staff,0,5,30,30
1650437600676,MATH 193A,A02,083225,Staff,0,5,30,30
1650437600676,MATH 193A,A03,083781,Staff,0,4,30,30
1650437600676,MATH 193A,A04,083782,Staff,0,4,30,30
1650437606699,MATH 197,001,091859,McAuley; Julian John,9998,0,9999,1
1650437612754,COGS 9,A01,083615,Staff,0,14,60,60
1650437618781,COGS 11,A01,083617,Boyle; Mary E. T.,21,0,40,19
1650437624808,COGS 13,A01,083071,Staff,0,34,40,40
1650437630835,COGS 14A,A01,092681,Staff,0,25,100,100
1650437636861,COGS 14B,A01,083073,Cheng; Tzu-Han,0,11,50,50
1650437642883,COGS 17,A01,092677,Staff,22,0,75,53
1650437648915,COGS 100,A01,083619,Staff,0,26,60,60
1650437654941,COGS 101A,A01,083621,Davis; Joshua Daniel,0,21,60,60
1650437660965,COGS 101B,A01,091572,Staff,0,4,60,60
1650437666989,COGS 101C,A01,083625,Delgado; Tania,16,0,30,14
1650437673021,COGS 107A,A01,083627,Boyle; Mary E. T.,0,11,60,60
1650437679048,COGS 118A,A01,083075,Staff,2,0,60,58
1650437685075,CSE 3,A50,083646,Miranda; Gregory Joseph,20,0,38,18
1650437685075,CSE 3,A51,083647,Miranda; Gregory Joseph,36,0,37,1
1650437691111,CSE 8A,A50,083650,Miranda; Gregory Joseph,0,28,40,40
1650437697148,CSE 11,A01,083080,Cao; Yingjun,0,91,40,40
1650437703178,CSE 12,A01,083652,Staff,0,16,100,100
1650437709201,CSE 15L,A01,083654,Staff,0,1,50,50
1650437709201,CSE 15L,A02,083655,Staff,1,0,50,49
1650437715225,CSE 20,A01,083657,Staff,51,0,80,29
1650437721247,CSE 30,A01,083084,Eldon; John,0,76,40,40
1650437727281,CSE 100,A01,083659,Cao; Yingjun,0,66,50,50
1650437733304,CSE 134B,A01,083661,Powell; Thomas Allan,0,32,65,65
1650437739338,CSE 140,A01,083663,Staff,0,2,75,75
1650437745362,CSE 140L,A01,083088,Eldon; John,0,8,75,75
1650437751385,CSE 175,A01,083665,Kumar; Rakesh,7,0,25,18
1650437757408,CSE 190,A00,092507,Dubnov; Shlomo,14,0,20,6
1650437763434,ECE 45,A01,083139,Staff,0,18,40,40
1650437769456,ECE 65,A50,083695,Staff,0,6,30,30
1650437775479,ECE 109,A01,091882,Touri; Behrouz,38,0,70,32
1650437781506,ECE 180,A00,083140,Abi Samra; Nicholas Camill,23,0,30,7
1650437781506,ECE 180,B00,083141,Abi Samra; Nicholas Camill,0,0,30,30
1650437787530,MATH 10A,A01,083735,Patchell; Gregory David,7,0,30,23
1650437787530,MATH 10A,A02,083736,Patchell; Gregory David,28,0,30,2
1650437787530,MATH 10A,A03,083737,Patchell; Gregory David,25,0,30,5
1650437793555,MATH 10B,A01,083207,Staff,0,7,30,30
1650437793555,MATH 10B,A02,083208,Staff,0,7,30,30
1650437793555,MATH 10B,B01,083739,Staff,13,0,30,17
1650437793555,MATH 10B,B02,083740,Staff,28,0,30,2
1650437799579,MATH 18,A01,083743,Staff,2,0,30,28
1650437799579,MATH 18,A02,083744,Staff,27,0,30,3
1650437799579,MATH 18,A03,083745,Staff,22,0,30,8
1650437799579,MATH 18,A04,083746,Staff,26,0,30,4
1650437799579,MATH 18,B01,083748,Staff,0,11,30,30
1650437799579,MATH 18,B02,083749,Staff,0,12,30,30
1650437799579,MATH 18,B03,083750,Staff,0,11,30,30
1650437799579,MATH 18,B04,083751,Staff,0,12,30,30
1650437805603,MATH 20A,A01,083754,Staff,26,0,40,14
1650437811722,MATH 20B,A01,083756,Staff,0,10,30,30
1650437811722,MATH 20B,A02,083757,Staff,0,10,30,30
1650437817747,MATH 20C,A01,083760,Staff,0,15,30,30
1650437817747,MATH 20C,A02,083761,Staff,1,14,30,29
1650437817747,MATH 20C,B01,083762,Staff,13,0,30,17
1650437817747,MATH 20C,B02,083763,Staff,28,0,30,2
1650437823772,MATH 20D,A01,083765,Staff,0,1,30,30
1650437823772,MATH 20D,A02,083766,Staff,9,0,30,21
1650437823772,MATH 20D,A03,083767,Staff,25,0,30,5
1650437839759,MATH 20E,A01,083771,Staff,5,0,30,25
1650437839759,MATH 20E,A02,083772,Staff,18,0,30,12
1650437839759,MATH 20E,B01,083773,Staff,0,0,30,30
1650437839759,MATH 20E,B02,083774,Staff,10,0,30,20
1650437845787,MATH 103A,A01,083777,Staff,0,12,30,30
1650437845787,MATH 103A,A02,083778,Staff,0,12,30,30
1650437845787,MATH 103A,B01,083779,Staff,0,13,30,30
1650437845787,MATH 103A,B02,083780,Staff,0,11,30,30
1650437851814,MATH 105,A01,085443,Staff,0,22,30,30
1650437857837,MATH 109,A01,083213,Anzaldo; Leesa B,0,7,30,30
1650437857837,MATH 109,A02,083214,Anzaldo; Leesa B,0,7,30,30
1650437857837,MATH 109,B01,083215,Anzaldo; Leesa B,0,5,30,30
1650437857837,MATH 109,B02,083216,Anzaldo; Leesa B,0,6,30,30
1650437863866,MATH 142A,A01,083219,Chow; Bennett,0,14,30,30
1650437863866,MATH 142A,A02,083220,Chow; Bennett,0,13,30,30
1650437863866,MATH 142A,B01,083221,Chow; Bennett,0,12,30,30
1650437863866,MATH 142A,B02,083222,Chow; Bennett,0,13,30,30
1650437869892,MATH 193A,A01,083224,Staff,0,5,30,30
1650437869892,MATH 193A,A02,083225,Staff,0,5,30,30
1650437869892,MATH 193A,A03,083781,Staff,0,4,30,30
1650437869892,MATH 193A,A04,083782,Staff,0,4,30,30
1650437875916,MATH 197,001,091859,McAuley; Julian John,9998,0,9999,1
1650437881990,COGS 9,A01,083615,Staff,0,14,60,60
1650437888018,COGS 11,A01,083617,Boyle; Mary E. T.,21,0,40,19
1650437894042,COGS 13,A01,083071,Staff,0,34,40,40
1650437900066,COGS 14A,A01,092681,Staff,0,25,100,100
1650437906089,COGS 14B,A01,083073,Cheng; Tzu-Han,0,11,50,50
1650437912113,COGS 17,A01,092677,Staff,22,0,75,53
1650437918137,COGS 100,A01,083619,Staff,0,26,60,60
1650437924161,COGS 101A,A01,083621,Davis; Joshua Daniel,0,21,60,60
1650437930185,COGS 101B,A01,091572,Staff,0,4,60,60
1650437936210,COGS 101C,A01,083625,Delgado; Tania,16,0,30,14
1650437942233,COGS 107A,A01,083627,Boyle; Mary E. T.,0,11,60,60
1650437948260,COGS 118A,A01,083075,Staff,2,0,60,58
1650437954284,CSE 3,A50,083646,Miranda; Gregory Joseph,20,0,38,18
1650437954284,CSE 3,A51,083647,Miranda; Gregory Joseph,36,0,37,1
1650437960313,CSE 8A,A50,083650,Miranda; Gregory Joseph,0,28,40,40
1650437966336,CSE 11,A01,083080,Cao; Yingjun,0,91,40,40
1650437972363,CSE 12,A01,083652,Staff,0,16,100,100
1650437978396,CSE 15L,A01,083654,Staff,0,1,50,50
1650437978396,CSE 15L,A02,083655,Staff,1,0,50,49
1650437984420,CSE 20,A01,083657,Staff,51,0,80,29
1650437990449,CSE 30,A01,083084,Eldon; John,0,76,40,40
1650437996472,CSE 100,A01,083659,Cao; Yingjun,0,66,50,50
1650438002498,CSE 134B,A01,083661,Powell; Thomas Allan,0,32,65,65
1650438008527,CSE 140,A01,083663,Staff,0,2,75,75
1650438014558,CSE 140L,A01,083088,Eldon; John,0,8,75,75
1650438020582,CSE 175,A01,083665,Kumar; Rakesh,7,0,25,18
1650438026606,CSE 190,A00,092507,Dubnov; Shlomo,14,0,20,6
1650438032639,ECE 45,A01,083139,Staff,0,18,40,40
1650438038674,ECE 65,A50,083695,Staff,0,6,30,30
1650438044699,ECE 109,A01,091882,Touri; Behrouz,38,0,70,32
1650438050729,ECE 180,A00,083140,Abi Samra; Nicholas Camill,23,0,30,7
1650438050729,ECE 180,B00,083141,Abi Samra; Nicholas Camill,0,0,30,30
1650438056766,MATH 10A,A01,083735,Patchell; Gregory David,7,0,30,23
1650438056766,MATH 10A,A02,083736,Patchell; Gregory David,28,0,30,2
1650438056766,MATH 10A,A03,083737,Patchell; Gregory David,25,0,30,5
1650438062964,MATH 10B,A01,083207,Staff,0,7,30,30
1650438062964,MATH 10B,A02,083208,Staff,0,7,30,30
1650438062964,MATH 10B,B01,083739,Staff,13,0,30,17
1650438062964,MATH 10B,B02,083740,Staff,28,0,30,2
1650438068989,MATH 18,A01,083743,Staff,2,0,30,28
1650438068989,MATH 18,A02,083744,Staff,27,0,30,3
1650438068989,MATH 18,A03,083745,Staff,22,0,30,8
1650438068989,MATH 18,A04,083746,Staff,26,0,30,4
1650438068989,MATH 18,B01,083748,Staff,0,11,30,30
1650438068989,MATH 18,B02,083749,Staff,0,12,30,30
1650438068989,MATH 18,B03,083750,Staff,0,11,30,30
1650438068989,MATH 18,B04,083751,Staff,0,12,30,30
1650438075014,MATH 20A,A01,083754,Staff,26,0,40,14
1650438081046,MATH 20B,A01,083756,Staff,0,10,30,30
1650438081046,MATH 20B,A02,083757,Staff,0,10,30,30
1650438087075,MATH 20C,A01,083760,Staff,0,15,30,30
1650438087075,MATH 20C,A02,083761,Staff,1,14,30,29
1650438087075,MATH 20C,B01,083762,Staff,13,0,30,17
1650438087075,MATH 20C,B02,083763,Staff,28,0,30,2
1650438093102,MATH 20D,A01,083765,Staff,0,1,30,30
1650438093102,MATH 20D,A02,083766,Staff,9,0,30,21
1650438093102,MATH 20D,A03,083767,Staff,25,0,30,5
1650438099134,MATH 20E,A01,083771,Staff,5,0,30,25
1650438099134,MATH 20E,A02,083772,Staff,18,0,30,12
1650438099134,MATH 20E,B01,083773,Staff,0,0,30,30
1650438099134,MATH 20E,B02,083774,Staff,10,0,30,20
1650438105165,MATH 103A,A01,083777,Staff,0,12,30,30
1650438105165,MATH 103A,A02,083778,Staff,0,12,30,30
1650438105165,MATH 103A,B01,083779,Staff,0,13,30,30
1650438105165,MATH 103A,B02,083780,Staff,0,11,30,30
1650438111189,MATH 105,A01,085443,Staff,0,22,30,30
1650438117223,MATH 109,A01,083213,Anzaldo; Leesa B,0,7,30,30
1650438117223,MATH 109,A02,083214,Anzaldo; Leesa B,0,7,30,30
1650438117223,MATH 109,B01,083215,Anzaldo; Leesa B,0,5,30,30
1650438117223,MATH 109,B02,083216,Anzaldo; Leesa B,0,6,30,30
1650438123249,MATH 142A,A01,083219,Chow; Bennett,0,14,30,30
1650438123249,MATH 142A,A02,083220,Chow; Bennett,0,13,30,30
1650438123249,MATH 142A,B01,083221,Chow; Bennett,0,12,30,30
1650438123249,MATH 142A,B02,083222,Chow; Bennett,0,13,30,30
1650438129273,MATH 193A,A01,083224,Staff,0,5,30,30
1650438129273,MATH 193A,A02,083225,Staff,0,5,30,30
1650438129273,MATH 193A,A03,083781,Staff,0,4,30,30
1650438129273,MATH 193A,A04,083782,Staff,0,4,30,30
1650438135301,MATH 197,001,091859,McAuley; Julian John,9998,0,9999,1
1650438141366,COGS 9,A01,083615,Staff,0,14,60,60
1650438147397,COGS 11,A01,083617,Boyle; Mary E. T.,21,0,40,19
1650438153423,COGS 13,A01,083071,Staff,0,34,40,40
1650438159447,COGS 14A,A01,092681,Staff,0,25,100,100
1650438165469,COGS 14B,A01,083073,Cheng; Tzu-Han,0,11,50,50
1650438171492,COGS 17,A01,092677,Staff,22,0,75,53
1650438177518,COGS 100,A01,083619,Staff,0,26,60,60
1650438183553,COGS 101A,A01,083621,Davis; Joshua Daniel,0,21,60,60
1650438189580,COGS 101B,A01,091572,Staff,0,4,60,60
1650438195607,COGS 101C,A01,083625,Delgado; Tania,16,0,30,14
1650438201630,COGS 107A,A01,083627,Boyle; Mary E. T.,0,11,60,60
1650438207658,COGS 118A,A01,083075,Staff,2,0,60,58
1650438213692,CSE 3,A50,083646,Miranda; Gregory Joseph,20,0,38,18
1650438213692,CSE 3,A51,083647,Miranda; Gregory Joseph,36,0,37,1
1650438219726,CSE 8A,A50,083650,Miranda; Gregory Joseph,0,28,40,40
1650438225752,CSE 11,A01,083080,Cao; Yingjun,0,91,40,40
1650438231783,CSE 12,A01,083652,Staff,0,16,100,100
1650438237807,CSE 15L,A01,083654,Staff,0,1,50,50
1650438237807,CSE 15L,A02,083655,Staff,1,0,50,49
1650438243835,CSE 20,A01,083657,Staff,51,0,80,29
1650438249862,CSE 30,A01,083084,Eldon; John,0,76,40,40
1650438255887,CSE 100,A01,083659,Cao; Yingjun,0,66,50,50
1650438261910,CSE 134B,A01,083661,Powell; Thomas Allan,0,32,65,65
1650438267934,CSE 140,A01,083663,Staff,0,2,75,75
1650438273967,CSE 140L,A01,083088,Eldon; John,0,8,75,75
1650438279991,CSE 175,A01,083665,Kumar; Rakesh,7,0,25,18
1650438286016,CSE 190,A00,092507,Dubnov; Shlomo,14,0,20,6
1650438292047,ECE 45,A01,083139,Staff,0,18,40,40
1650438298073,ECE 65,A50,083695,Staff,0,6,30,30
1650438304097,ECE 109,A01,091882,Touri; Behrouz,38,0,70,32
1650438310124,ECE 180,A00,083140,Abi Samra; Nicholas Camill,23,0,30,7
1650438310124,ECE 180,B00,083141,Abi Samra; Nicholas Camill,0,0,30,30
1650438316148,MATH 10A,A01,083735,Patchell; Gregory David,7,0,30,23
1650438316148,MATH 10A,A02,083736,Patchell; Gregory David,28,0,30,2
1650438316148,MATH 10A,A03,083737,Patchell; Gregory David,25,0,30,5
1650438322173,MATH 10B,A01,083207,Staff,0,7,30,30
1650438322173,MATH 10B,A02,083208,Staff,0,7,30,30
1650438322173,MATH 10B,B01,083739,Staff,13,0,30,17
1650438322173,MATH 10B,B02,083740,Staff,28,0,30,2
1650438328205,MATH 18,A01,083743,Staff,1,0,30,29
1650438328205,MATH 18,A02,083744,Staff,27,0,30,3
1650438328205,MATH 18,A03,083745,Staff,22,0,30,8
1650438328205,MATH 18,A04,083746,Staff,26,0,30,4
1650438328205,MATH 18,B01,083748,Staff,0,11,30,30
1650438328205,MATH 18,B02,083749,Staff,0,12,30,30
1650438328205,MATH 18,B03,083750,Staff,0,11,30,30
1650438328205,MATH 18,B04,083751,Staff,0,12,30,30
1650438334229,MATH 20A,A01,083754,Staff,26,0,40,14
1650438340254,MATH 20B,A01,083756,Staff,0,10,30,30
1650438340254,MATH 20B,A02,083757,Staff,0,10,30,30
1650438346279,MATH 20C,A01,083760,Staff,0,15,30,30
1650438346279,MATH 20C,A02,083761,Staff,1,14,30,29
1650438346279,MATH 20C,B01,083762,Staff,13,0,30,17
1650438346279,MATH 20C,B02,083763,Staff,28,0,30,2
1650438352307,MATH 20D,A01,083765,Staff,0,1,30,30
1650438352307,MATH 20D,A02,083766,Staff,9,0,30,21
1650438352307,MATH 20D,A03,083767,Staff,25,0,30,5
1650438358332,MATH 20E,A01,083771,Staff,5,0,30,25
1650438358332,MATH 20E,A02,083772,Staff,18,0,30,12
1650438358332,MATH 20E,B01,083773,Staff,0,0,30,30
1650438358332,MATH 20E,B02,083774,Staff,10,0,30,20
1650438364357,MATH 103A,A01,083777,Staff,0,12,30,30
1650438364357,MATH 103A,A02,083778,Staff,0,12,30,30
1650438364357,MATH 103A,B01,083779,Staff,0,13,30,30
1650438364357,MATH 103A,B02,083780,Staff,0,11,30,30
1650438370381,MATH 105,A01,085443,Staff,0,22,30,30
1650438376407,MATH 109,A01,083213,Anzaldo; Leesa B,0,7,30,30
1650438376407,MATH 109,A02,083214,Anzaldo; Leesa B,0,7,30,30
1650438376407,MATH 109,B01,083215,Anzaldo; Leesa B,0,5,30,30
1650438376407,MATH 109,B02,083216,Anzaldo; Leesa B,0,6,30,30
1650438382436,MATH 142A,A01,083219,Chow; Bennett,0,14,30,30
1650438382436,MATH 142A,A02,083220,Chow; Bennett,0,13,30,30
1650438382436,MATH 142A,B01,083221,Chow; Bennett,0,12,30,30
1650438382436,MATH 142A,B02,083222,Chow; Bennett,0,13,30,30
1650438388461,MATH 193A,A01,083224,Staff,0,5,30,30
1650438388461,MATH 193A,A02,083225,Staff,0,5,30,30
1650438388461,MATH 193A,A03,083781,Staff,0,4,30,30
1650438388461,MATH 193A,A04,083782,Staff,0,4,30,30
1650438394484,MATH 197,001,091859,McAuley; Julian John,9998,0,9999,1
1650438400541,COGS 9,A01,083615,Staff,0,14,60,60
1650438406568,COGS 11,A01,083617,Boyle; Mary E. T.,21,0,40,19
1650438412681,COGS 13,A01,083071,Staff,0,34,40,40
1650438418704,COGS 14A,A01,092681,Staff,0,25,100,100
1650438424731,COGS 14B,A01,083073,Cheng; Tzu-Han,0,11,50,50
1650438430754,COGS 17,A01,092677,Staff,22,0,75,53
1650438436793,COGS 100,A01,083619,Staff,0,26,60,60
1650438442821,COGS 101A,A01,083621,Davis; Joshua Daniel,0,21,60,60
1650438448845,COGS 101B,A01,091572,Staff,0,4,60,60
1650438454879,COGS 101C,A01,083625,Delgado; Tania,16,0,30,14
1650438460905,COGS 107A,A01,083627,Boyle; Mary E. T.,0,11,60,60
1650438466928,COGS 118A,A01,083075,Staff,2,0,60,58
1650438472958,CSE 3,A50,083646,Miranda; Gregory Joseph,20,0,38,18
1650438472958,CSE 3,A51,083647,Miranda; Gregory Joseph,36,0,37,1
1650438478992,CSE 8A,A50,083650,Miranda; Gregory Joseph,0,28,40,40
1650438485020,CSE 11,A01,083080,Cao; Yingjun,0,91,40,40
1650438491047,CSE 12,A01,083652,Staff,0,16,100,100
1650438497072,CSE 15L,A01,083654,Staff,0,1,50,50
1650438497072,CSE 15L,A02,083655,Staff,1,0,50,49
1650438503099,CSE 20,A01,083657,Staff,51,0,80,29
1650438509126,CSE 30,A01,083084,Eldon; John,0,76,40,40
1650438515155,CSE 100,A01,083659,Cao; Yingjun,0,66,50,50
1650438521179,CSE 134B,A01,083661,Powell; Thomas Allan,0,32,65,65
1650438527204,CSE 140,A01,083663,Staff,0,2,75,75
1650438533227,CSE 140L,A01,083088,Eldon; John,0,8,75,75
1650438539250,CSE 175,A01,083665,Kumar; Rakesh,7,0,25,18
1650438545278,CSE 190,A00,092507,Dubnov; Shlomo,14,0,20,6
1650438551303,ECE 45,A01,083139,Staff,0,18,40,40
1650438557332,ECE 65,A50,083695,Staff,0,6,30,30
1650438563361,ECE 109,A01,091882,Touri; Behrouz,38,0,70,32
1650438569384,ECE 180,A00,083140,Abi Samra; Nicholas Camill,23,0,30,7
1650438569384,ECE 180,B00,083141,Abi Samra; Nicholas Camill,0,0,30,30
1650438575429,MATH 10A,A01,083735,Patchell; Gregory David,7,0,30,23
1650438575429,MATH 10A,A02,083736,Patchell; Gregory David,28,0,30,2
1650438575429,MATH 10A,A03,083737,Patchell; Gregory David,25,0,30,5
1650438581455,MATH 10B,A01,083207,Staff,0,7,30,30
1650438581455,MATH 10B,A02,083208,Staff,0,7,30,30
1650438581455,MATH 10B,B01,083739,Staff,13,0,30,17
1650438581455,MATH 10B,B02,083740,Staff,28,0,30,2
1650438587484,MATH 18,A01,083743,Staff,1,0,30,29
1650438587484,MATH 18,A02,083744,Staff,27,0,30,3
1650438587484,MATH 18,A03,083745,Staff,22,0,30,8
1650438587484,MATH 18,A04,083746,Staff,26,0,30,4
1650438587484,MATH 18,B01,083748,Staff,0,11,30,30
1650438587484,MATH 18,B02,083749,Staff,0,12,30,30
1650438587484,MATH 18,B03,083750,Staff,0,11,30,30
1650438587484,MATH 18,B04,083751,Staff,0,12,30,30
1650438593513,MATH 20A,A01,083754,Staff,26,0,40,14
1650438599541,MATH 20B,A01,083756,Staff,0,10,30,30
1650438599541,MATH 20B,A02,083757,Staff,0,10,30,30
1650438605570,MATH 20C,A01,083760,Staff,0,15,30,30
1650438605570,MATH 20C,A02,083761,Staff,1,14,30,29
1650438605570,MATH 20C,B01,083762,Staff,13,0,30,17
1650438605570,MATH 20C,B02,083763,Staff,28,0,30,2
1650438611601,MATH 20D,A01,083765,Staff,0,1,30,30
1650438611601,MATH 20D,A02,083766,Staff,9,0,30,21
1650438611601,MATH 20D,A03,083767,Staff,25,0,30,5
1650438617628,MATH 20E,A01,083771,Staff,5,0,30,25
1650438617628,MATH 20E,A02,083772,Staff,18,0,30,12
1650438617628,MATH 20E,B01,083773,Staff,0,0,30,30
1650438617628,MATH 20E,B02,083774,Staff,10,0,30,20
1650438623657,MATH 103A,A01,083777,Staff,0,12,30,30
1650438623657,MATH 103A,A02,083778,Staff,0,12,30,30
1650438623657,MATH 103A,B01,083779,Staff,0,13,30,30
1650438623657,MATH 103A,B02,083780,Staff,0,11,30,30
1650438629681,MATH 105,A01,085443,Staff,0,22,30,30
1650438635710,MATH 109,A01,083213,Anzaldo; Leesa B,0,7,30,30
1650438635710,MATH 109,A02,083214,Anzaldo; Leesa B,0,7,30,30
1650438635710,MATH 109,B01,083215,Anzaldo; Leesa B,0,5,30,30
1650438635710,MATH 109,B02,083216,Anzaldo; Leesa B,0,6,30,30
1650438641735,MATH 142A,A01,083219,Chow; Bennett,0,14,30,30
1650438641735,MATH 142A,A02,083220,Chow; Bennett,0,13,30,30
1650438641735,MATH 142A,B01,083221,Chow; Bennett,0,12,30,30
1650438641735,MATH 142A,B02,083222,Chow; Bennett,0,13,30,30
1650438647767,MATH 193A,A01,083224,Staff,0,5,30,30
1650438647767,MATH 193A,A02,083225,Staff,0,5,30,30
1650438647767,MATH 193A,A03,083781,Staff,0,4,30,30
1650438647767,MATH 193A,A04,083782,Staff,0,4,30,30
1650438653794,MATH 197,001,091859,McAuley; Julian John,9998,0,9999,1
1650438659858,COGS 9,A01,083615,Staff,0,14,60,60
1650438665881,COGS 11,A01,083617,Boyle; Mary E. T.,21,0,40,19
1650438671910,COGS 13,A01,083071,Staff,0,34,40,40
1650438677938,COGS 14A,A01,092681,Staff,1,25,100,99
1650438683968,COGS 14B,A01,083073,Cheng; Tzu-Han,0,11,50,50
1650438689993,COGS 17,A01,092677,Staff,22,0,75,53
1650438696017,COGS 100,A01,083619,Staff,0,26,60,60
1650438702042,COGS 101A,A01,083621,Davis; Joshua Daniel,0,21,60,60
1650438708067,COGS 101B,A01,091572,Staff,0,4,60,60
1650438714093,COGS 101C,A01,083625,Delgado; Tania,16,0,30,14
1650438720123,COGS 107A,A01,083627,Boyle; Mary E. T.,0,11,60,60
1650438726211,COGS 118A,A01,083075,Staff,2,0,60,58
1650438732397,CSE 3,A50,083646,Miranda; Gregory Joseph,20,0,38,18
1650438732397,CSE 3,A51,083647,Miranda; Gregory Joseph,36,0,37,1
1650438738426,CSE 8A,A50,083650,Miranda; Gregory Joseph,0,28,40,40
1650438744457,CSE 11,A01,083080,Cao; Yingjun,0,91,40,40
1650438750488,CSE 12,A01,083652,Staff,0,16,100,100
1650438756512,CSE 15L,A01,083654,Staff,0,1,50,50
1650438756512,CSE 15L,A02,083655,Staff,1,0,50,49
1650438762543,CSE 20,A01,083657,Staff,51,0,80,29
1650438768568,CSE 30,A01,083084,Eldon; John,0,76,40,40
1650438774592,CSE 100,A01,083659,Cao; Yingjun,0,66,50,50
1650438780616,CSE 134B,A01,083661,Powell; Thomas Allan,0,32,65,65
1650438786641,CSE 140,A01,083663,Staff,0,2,75,75
1650438792663,CSE 140L,A01,083088,Eldon; John,0,8,75,75
1650438798687,CSE 175,A01,083665,Kumar; Rakesh,7,0,25,18
1650438804712,CSE 190,A00,092507,Dubnov; Shlomo,14,0,20,6
1650438810737,ECE 45,A01,083139,Staff,0,18,40,40
1650438816764,ECE 65,A50,083695,Staff,0,6,30,30
1650438822789,ECE 109,A01,091882,Touri; Behrouz,38,0,70,32
1650438828818,ECE 180,A00,083140,Abi Samra; Nicholas Camill,23,0,30,7
1650438828818,ECE 180,B00,083141,Abi Samra; Nicholas Camill,0,0,30,30
1650438834851,MATH 10A,A01,083735,Patchell; Gregory David,7,0,30,23
1650438834851,MATH 10A,A02,083736,Patchell; Gregory David,28,0,30,2
1650438834851,MATH 10A,A03,083737,Patchell; Gregory David,25,0,30,5
1650438840882,MATH 10B,A01,083207,Staff,0,7,30,30
1650438840882,MATH 10B,A02,083208,Staff,0,7,30,30
1650438840882,MATH 10B,B01,083739,Staff,13,0,30,17
1650438840882,MATH 10B,B02,083740,Staff,28,0,30,2
1650438846908,MATH 18,A01,083743,Staff,1,0,30,29
1650438846908,MATH 18,A02,083744,Staff,27,0,30,3
1650438846908,MATH 18,A03,083745,Staff,22,0,30,8
1650438846908,MATH 18,A04,083746,Staff,26,0,30,4
1650438846908,MATH 18,B01,083748,Staff,0,11,30,30
1650438846908,MATH 18,B02,083749,Staff,0,12,30,30
1650438846908,MATH 18,B03,083750,Staff,0,11,30,30
1650438846908,MATH 18,B04,083751,Staff,0,12,30,30
1650438852938,MATH 20A,A01,083754,Staff,26,0,40,14
1650438858969,MATH 20B,A01,083756,Staff,0,10,30,30
1650438858969,MATH 20B,A02,083757,Staff,0,10,30,30
1650438864994,MATH 20C,A01,083760,Staff,0,15,30,30
1650438864994,MATH 20C,A02,083761,Staff,1,14,30,29
1650438864994,MATH 20C,B01,083762,Staff,13,0,30,17
1650438864994,MATH 20C,B02,083763,Staff,28,0,30,2
1650438871019,MATH 20D,A01,083765,Staff,0,1,30,30
1650438871019,MATH 20D,A02,083766,Staff,9,0,30,21
1650438871019,MATH 20D,A03,083767,Staff,25,0,30,5
1650438877042,MATH 20E,A01,083771,Staff,5,0,30,25
1650438877042,MATH 20E,A02,083772,Staff,18,0,30,12
1650438877042,MATH 20E,B01,083773,Staff,0,0,30,30
1650438877042,MATH 20E,B02,083774,Staff,10,0,30,20
1650438883065,MATH 103A,A01,083777,Staff,0,12,30,30
1650438883065,MATH 103A,A02,083778,Staff,0,12,30,30
1650438883065,MATH 103A,B01,083779,Staff,0,13,30,30
1650438883065,MATH 103A,B02,083780,Staff,0,11,30,30
1650438889093,MATH 105,A01,085443,Staff,0,22,30,30
1650438895124,MATH 109,A01,083213,Anzaldo; Leesa B,0,7,30,30
1650438895124,MATH 109,A02,083214,Anzaldo; Leesa B,0,7,30,30
1650438895124,MATH 109,B01,083215,Anzaldo; Leesa B,0,5,30,30
1650438895124,MATH 109,B02,083216,Anzaldo; Leesa B,0,6,30,30
1650438901163,MATH 142A,A01,083219,Chow; Bennett,0,14,30,30
1650438901163,MATH 142A,A02,083220,Chow; Bennett,0,13,30,30
1650438901163,MATH 142A,B01,083221,Chow; Bennett,0,12,30,30
1650438901163,MATH 142A,B02,083222,Chow; Bennett,0,13,30,30
1650438907189,MATH 193A,A01,083224,Staff,0,5,30,30
1650438907189,MATH 193A,A02,083225,Staff,0,5,30,30
1650438907189,MATH 193A,A03,083781,Staff,0,4,30,30
1650438907189,MATH 193A,A04,083782,Staff,0,4,30,30
1650438913211,MATH 197,001,091859,McAuley; Julian John,9998,0,9999,1
1650438919279,COGS 9,A01,083615,Staff,0,14,60,60
1650438925308,COGS 11,A01,083617,Boyle; Mary E. T.,21,0,40,19
1650438931341,COGS 13,A01,083071,Staff,0,34,40,40
1650438937376,COGS 14A,A01,092681,Staff,1,25,100,99
1650438943442,COGS 14B,A01,083073,Cheng; Tzu-Han,0,11,50,50
1650438949466,COGS 17,A01,092677,Staff,22,0,75,53
1650438955496,COGS 100,A01,083619,Staff,0,26,60,60
1650438961531,COGS 101A,A01,083621,Davis; Joshua Daniel,0,21,60,60
1650438967555,COGS 101B,A01,091572,Staff,0,4,60,60
1650438973611,COGS 101C,A01,083625,Delgado; Tania,16,0,30,14
1650438979635,COGS 107A,A01,083627,Boyle; Mary E. T.,0,11,60,60
1650438985660,COGS 118A,A01,083075,Staff,2,0,60,58
1650438991685,CSE 3,A50,083646,Miranda; Gregory Joseph,20,0,38,18
1650438991685,CSE 3,A51,083647,Miranda; Gregory Joseph,36,0,37,1
1650438997714,CSE 8A,A50,083650,Miranda; Gregory Joseph,0,28,40,40
1650439003738,CSE 11,A01,083080,Cao; Yingjun,0,91,40,40
1650439009835,CSE 12,A01,083652,Staff,0,16,100,100
1650439015859,CSE 15L,A01,083654,Staff,0,1,50,50
1650439015859,CSE 15L,A02,083655,Staff,1,0,50,49
1650439021894,CSE 20,A01,083657,Staff,51,0,80,29
1650439027921,CSE 30,A01,083084,Eldon; John,0,76,40,40
1650439033947,CSE 100,A01,083659,Cao; Yingjun,0,66,50,50
1650439039973,CSE 134B,A01,083661,Powell; Thomas Allan,0,32,65,65
1650439045995,CSE 140,A01,083663,Staff,0,2,75,75
1650439052020,CSE 140L,A01,083088,Eldon; John,0,8,75,75
1650439058046,CSE 175,A01,083665,Kumar; Rakesh,7,0,25,18
1650439064073,CSE 190,A00,092507,Dubnov; Shlomo,14,0,20,6
1650439070099,ECE 45,A01,083139,Staff,0,18,40,40
1650439076130,ECE 65,A50,083695,Staff,0,6,30,30
1650439082162,ECE 109,A01,091882,Touri; Behrouz,38,0,70,32
1650439088191,ECE 180,A00,083140,Abi Samra; Nicholas Camill,23,0,30,7
1650439088191,ECE 180,B00,083141,Abi Samra; Nicholas Camill,0,0,30,30
1650439094222,MATH 10A,A01,083735,Patchell; Gregory David,7,0,30,23
1650439094222,MATH 10A,A02,083736,Patchell; Gregory David,28,0,30,2
1650439094222,MATH 10A,A03,083737,Patchell; Gregory David,25,0,30,5
1650439100248,MATH 10B,A01,083207,Staff,0,7,30,30
1650439100248,MATH 10B,A02,083208,Staff,0,7,30,30
1650439100248,MATH 10B,B01,083739,Staff,13,0,30,17
1650439100248,MATH 10B,B02,083740,Staff,28,0,30,2
1650439106274,MATH 18,A01,083743,Staff,1,0,30,29
1650439106274,MATH 18,A02,083744,Staff,27,0,30,3
1650439106274,MATH 18,A03,083745,Staff,22,0,30,8
1650439106274,MATH 18,A04,083746,Staff,26,0,30,4
1650439106274,MATH 18,B01,083748,Staff,0,11,30,30
1650439106274,MATH 18,B02,083749,Staff,0,12,30,30
1650439106274,MATH 18,B03,083750,Staff,0,11,30,30
1650439106274,MATH 18,B04,083751,Staff,0,12,30,30
1650439112302,MATH 20A,A01,083754,Staff,26,0,40,14
1650439118326,MATH 20B,A01,083756,Staff,0,10,30,30
1650439118326,MATH 20B,A02,083757,Staff,0,10,30,30
1650439124351,MATH 20C,A01,083760,Staff,0,15,30,30
1650439124351,MATH 20C,A02,083761,Staff,1,14,30,29
1650439124351,MATH 20C,B01,083762,Staff,13,0,30,17
1650439124351,MATH 20C,B02,083763,Staff,28,0,30,2
1650439130380,MATH 20D,A01,083765,Staff,0,1,30,30
1650439130380,MATH 20D,A02,083766,Staff,9,0,30,21
1650439130380,MATH 20D,A03,083767,Staff,25,0,30,5
1650439136412,MATH 20E,A01,083771,Staff,5,0,30,25
1650439136412,MATH 20E,A02,083772,Staff,18,0,30,12
1650439136412,MATH 20E,B01,083773,Staff,0,0,30,30
1650439136412,MATH 20E,B02,083774,Staff,10,0,30,20
1650439142443,MATH 103A,A01,083777,Staff,0,12,30,30
1650439142443,MATH 103A,A02,083778,Staff,0,12,30,30
1650439142443,MATH 103A,B01,083779,Staff,0,13,30,30
1650439142443,MATH 103A,B02,083780,Staff,0,11,30,30
1650439148467,MATH 105,A01,085443,Staff,0,23,30,30
1650439154497,MATH 109,A01,083213,Anzaldo; Leesa B,0,7,30,30
1650439154497,MATH 109,A02,083214,Anzaldo; Leesa B,0,7,30,30
1650439154497,MATH 109,B01,083215,Anzaldo; Leesa B,0,5,30,30
1650439154497,MATH 109,B02,083216,Anzaldo; Leesa B,0,6,30,30
1650439160521,MATH 142A,A01,083219,Chow; Bennett,0,14,30,30
1650439160521,MATH 142A,A02,083220,Chow; Bennett,0,13,30,30
1650439160521,MATH 142A,B01,083221,Chow; Bennett,0,12,30,30
1650439160521,MATH 142A,B02,083222,Chow; Bennett,0,13,30,30
1650439166546,MATH 193A,A01,083224,Staff,0,5,30,30
1650439166546,MATH 193A,A02,083225,Staff,0,5,30,30
1650439166546,MATH 193A,A03,083781,Staff,0,4,30,30
1650439166546,MATH 193A,A04,083782,Staff,0,5,30,30
1650439172570,MATH 197,001,091859,McAuley; Julian John,9998,0,9999,1
1650439178628,COGS 9,A01,083615,Staff,0,14,60,60
1650439184660,COGS 11,A01,083617,Boyle; Mary E. T.,21,0,40,19
1650439190689,COGS 13,A01,083071,Staff,0,34,40,40
1650439196715,COGS 14A,A01,092681,Staff,1,25,100,99
1650439202741,COGS 14B,A01,083073,Cheng; Tzu-Han,0,11,50,50
1650439208763,COGS 17,A01,092677,Staff,22,0,75,53
1650439214805,COGS 100,A01,083619,Staff,0,26,60,60
1650439220837,COGS 101A,A01,083621,Davis; Joshua Daniel,0,21,60,60
1650439226863,COGS 101B,A01,091572,Staff,0,4,60,60
1650439232902,COGS 101C,A01,083625,Delgado; Tania,16,0,30,14
1650439238926,COGS 107A,A01,083627,Boyle; Mary E. T.,0,11,60,60
1650439244953,COGS 118A,A01,083075,Staff,2,0,60,58
1650439250978,CSE 3,A50,083646,Miranda; Gregory Joseph,20,0,38,18
1650439250978,CSE 3,A51,083647,Miranda; Gregory Joseph,36,0,37,1
1650439257003,CSE 8A,A50,083650,Miranda; Gregory Joseph,0,28,40,40
1650439263032,CSE 11,A01,083080,Cao; Yingjun,0,91,40,40
1650439269060,CSE 12,A01,083652,Staff,0,16,100,100
1650439275085,CSE 15L,A01,083654,Staff,0,1,50,50
1650439275085,CSE 15L,A02,083655,Staff,1,0,50,49
1650439281110,CSE 20,A01,083657,Staff,51,0,80,29
1650439287133,CSE 30,A01,083084,Eldon; John,0,76,40,40
1650439293164,CSE 100,A01,083659,Cao; Yingjun,0,66,50,50
1650439299192,CSE 134B,A01,083661,Powell; Thomas Allan,0,32,65,65
1650439305234,CSE 140,A01,083663,Staff,0,2,75,75
1650439311258,CSE 140L,A01,083088,Eldon; John,0,8,75,75
1650439317284,CSE 175,A01,083665,Kumar; Rakesh,7,0,25,18
1650439323310,CSE 190,A00,092507,Dubnov; Shlomo,14,0,20,6
1650439329339,ECE 45,A01,083139,Staff,0,18,40,40
1650439335362,ECE 65,A50,083695,Staff,0,6,30,30
1650439341387,ECE 109,A01,091882,Touri; Behrouz,38,0,70,32
1650439347414,ECE 180,A00,083140,Abi Samra; Nicholas Camill,23,0,30,7
1650439347414,ECE 180,B00,083141,Abi Samra; Nicholas Camill,0,0,30,30
1650439353440,MATH 10A,A01,083735,Patchell; Gregory David,7,0,30,23
1650439353440,MATH 10A,A02,083736,Patchell; Gregory David,28,0,30,2
1650439353440,MATH 10A,A03,083737,Patchell; Gregory David,25,0,30,5
1650439359467,MATH 10B,A01,083207,Staff,0,7,30,30
1650439359467,MATH 10B,A02,083208,Staff,0,7,30,30
1650439359467,MATH 10B,B01,083739,Staff,13,0,30,17
1650439359467,MATH 10B,B02,083740,Staff,28,0,30,2
1650439365500,MATH 18,A01,083743,Staff,1,0,30,29
1650439365500,MATH 18,A02,083744,Staff,27,0,30,3
1650439365500,MATH 18,A03,083745,Staff,22,0,30,8
1650439365500,MATH 18,A04,083746,Staff,26,0,30,4
1650439365500,MATH 18,B01,083748,Staff,0,11,30,30
1650439365500,MATH 18,B02,083749,Staff,0,12,30,30
1650439365500,MATH 18,B03,083750,Staff,0,11,30,30
1650439365500,MATH 18,B04,083751,Staff,0,12,30,30
1650439371527,MATH 20A,A01,083754,Staff,26,0,40,14
1650439377551,MATH 20B,A01,083756,Staff,0,10,30,30
1650439377551,MATH 20B,A02,083757,Staff,0,10,30,30
1650439383573,MATH 20C,A01,083760,Staff,0,15,30,30
1650439383573,MATH 20C,A02,083761,Staff,1,14,30,29
1650439383573,MATH 20C,B01,083762,Staff,13,0,30,17
1650439383573,MATH 20C,B02,083763,Staff,28,0,30,2
1650439389605,MATH 20D,A01,083765,Staff,0,1,30,30
1650439389605,MATH 20D,A02,083766,Staff,9,0,30,21
1650439389605,MATH 20D,A03,083767,Staff,25,0,30,5
1650439395630,MATH 20E,A01,083771,Staff,5,0,30,25
1650439395630,MATH 20E,A02,083772,Staff,18,0,30,12
1650439395630,MATH 20E,B01,083773,Staff,0,0,30,30
1650439395630,MATH 20E,B02,083774,Staff,10,0,30,20
1650439401664,MATH 103A,A01,083777,Staff,0,12,30,30
1650439401664,MATH 103A,A02,083778,Staff,0,12,30,30
1650439401664,MATH 103A,B01,083779,Staff,0,13,30,30
1650439401664,MATH 103A,B02,083780,Staff,0,11,30,30
1650439407689,MATH 105,A01,085443,Staff,0,23,30,30
1650439413731,MATH 109,A01,083213,Anzaldo; Leesa B,0,7,30,30
1650439413731,MATH 109,A02,083214,Anzaldo; Leesa B,0,7,30,30
1650439413731,MATH 109,B01,083215,Anzaldo; Leesa B,0,5,30,30
1650439413731,MATH 109,B02,083216,Anzaldo; Leesa B,0,6,30,30
1650439419755,MATH 142A,A01,083219,Chow; Bennett,0,14,30,30
1650439419755,MATH 142A,A02,083220,Chow; Bennett,0,13,30,30
1650439419755,MATH 142A,B01,083221,Chow; Bennett,0,12,30,30
1650439419755,MATH 142A,B02,083222,Chow; Bennett,0,13,30,30
1650439425779,MATH 193A,A01,083224,Staff,0,5,30,30
1650439425779,MATH 193A,A02,083225,Staff,0,5,30,30
1650439425779,MATH 193A,A03,083781,Staff,0,4,30,30
1650439425779,MATH 193A,A04,083782,Staff,0,5,30,30
1650439431802,MATH 197,001,091859,McAuley; Julian John,9998,0,9999,1
1650439437865,COGS 9,A01,083615,Staff,0,14,60,60
1650439443894,COGS 11,A01,083617,Boyle; Mary E. T.,21,0,40,19
1650439449920,COGS 13,A01,083071,Staff,0,34,40,40
1650439455951,COGS 14A,A01,092681,Staff,1,25,100,99
1650439461974,COGS 14B,A01,083073,Cheng; Tzu-Han,0,11,50,50
1650439467998,COGS 17,A01,092677,Staff,22,0,75,53
1650439474022,COGS 100,A01,083619,Staff,0,26,60,60
1650439480050,COGS 101A,A01,083621,Davis; Joshua Daniel,0,21,60,60
1650439486089,COGS 101B,A01,091572,Staff,0,4,60,60
1650439492112,COGS 101C,A01,083625,Delgado; Tania,16,0,30,14
1650439498135,COGS 107A,A01,083627,Boyle; Mary E. T.,0,11,60,60
1650439504161,COGS 118A,A01,083075,Staff,2,0,60,58
1650439510184,CSE 3,A50,083646,Miranda; Gregory Joseph,20,0,38,18
1650439510184,CSE 3,A51,083647,Miranda; Gregory Joseph,36,0,37,1
1650439516212,CSE 8A,A50,083650,Miranda; Gregory Joseph,0,28,40,40
1650439522236,CSE 11,A01,083080,Cao; Yingjun,0,91,40,40
1650439528263,CSE 12,A01,083652,Staff,0,16,100,100
1650439534289,CSE 15L,A01,083654,Staff,0,1,50,50
1650439534289,CSE 15L,A02,083655,Staff,1,0,50,49
1650439540312,CSE 20,A01,083657,Staff,51,0,80,29
1650439546337,CSE 30,A01,083084,Eldon; John,0,76,40,40
1650439552361,CSE 100,A01,083659,Cao; Yingjun,0,66,50,50
1650439558393,CSE 134B,A01,083661,Powell; Thomas Allan,0,32,65,65
1650439564418,CSE 140,A01,083663,Staff,0,2,75,75
1650439570447,CSE 140L,A01,083088,Eldon; John,0,8,75,75
1650439576472,CSE 175,A01,083665,Kumar; Rakesh,7,0,25,18
1650439582500,CSE 190,A00,092507,Dubnov; Shlomo,14,0,20,6
1650439588530,ECE 45,A01,083139,Staff,0,18,40,40
1650439594557,ECE 65,A50,083695,Staff,0,6,30,30
1650439600581,ECE 109,A01,091882,Touri; Behrouz,38,0,70,32
1650439606696,ECE 180,A00,083140,Abi Samra; Nicholas Camill,23,0,30,7
1650439606696,ECE 180,B00,083141,Abi Samra; Nicholas Camill,0,0,30,30
1650439612726,MATH 10A,A01,083735,Patchell; Gregory David,7,0,30,23
1650439612726,MATH 10A,A02,083736,Patchell; Gregory David,28,0,30,2
1650439612726,MATH 10A,A03,083737,Patchell; Gregory David,25,0,30,5
1650439618751,MATH 10B,A01,083207,Staff,0,7,30,30
1650439618751,MATH 10B,A02,083208,Staff,0,7,30,30
1650439618751,MATH 10B,B01,083739,Staff,13,0,30,17
1650439618751,MATH 10B,B02,083740,Staff,28,0,30,2
1650439624777,MATH 18,A01,083743,Staff,1,0,30,29
1650439624777,MATH 18,A02,083744,Staff,27,0,30,3
1650439624777,MATH 18,A03,083745,Staff,22,0,30,8
1650439624777,MATH 18,A04,083746,Staff,26,0,30,4
1650439624777,MATH 18,B01,083748,Staff,0,11,30,30
1650439624777,MATH 18,B02,083749,Staff,0,12,30,30
1650439624777,MATH 18,B03,083750,Staff,0,11,30,30
1650439624777,MATH 18,B04,083751,Staff,0,12,30,30
1650439630801,MATH 20A,A01,083754,Staff,26,0,40,14
1650439636829,MATH 20B,A01,083756,Staff,0,10,30,30
1650439636829,MATH 20B,A02,083757,Staff,0,10,30,30
1650439642858,MATH 20C,A01,083760,Staff,0,15,30,30
1650439642858,MATH 20C,A02,083761,Staff,1,14,30,29
1650439642858,MATH 20C,B01,083762,Staff,13,0,30,17
1650439642858,MATH 20C,B02,083763,Staff,28,0,30,2
1650439648882,MATH 20D,A01,083765,Staff,0,1,30,30
1650439648882,MATH 20D,A02,083766,Staff,9,0,30,21
1650439648882,MATH 20D,A03,083767,Staff,25,0,30,5
1650439654907,MATH 20E,A01,083771,Staff,5,0,30,25
1650439654907,MATH 20E,A02,083772,Staff,18,0,30,12
1650439654907,MATH 20E,B01,083773,Staff,0,0,30,30
1650439654907,MATH 20E,B02,083774,Staff,10,0,30,20
1650439660936,MATH 103A,A01,083777,Staff,0,12,30,30
1650439660936,MATH 103A,A02,083778,Staff,0,12,30,30
1650439660936,MATH 103A,B01,083779,Staff,0,13,30,30
1650439660936,MATH 103A,B02,083780,Staff,0,11,30,30
1650439666963,MATH 105,A01,085443,Staff,0,23,30,30
1650439672988,MATH 109,A01,083213,Anzaldo; Leesa B,0,7,30,30
1650439672988,MATH 109,A02,083214,Anzaldo; Leesa B,0,7,30,30
1650439672988,MATH 109,B01,083215,Anzaldo; Leesa B,0,5,30,30
1650439672988,MATH 109,B02,083216,Anzaldo; Leesa B,0,6,30,30
1650439679019,MATH 142A,A01,083219,Chow; Bennett,0,14,30,30
1650439679019,MATH 142A,A02,083220,Chow; Bennett,0,13,30,30
1650439679019,MATH 142A,B01,083221,Chow; Bennett,0,12,30,30
1650439679019,MATH 142A,B02,083222,Chow; Bennett,0,13,30,30
1650439685043,MATH 193A,A01,083224,Staff,0,5,30,30
1650439685043,MATH 193A,A02,083225,Staff,0,5,30,30
1650439685043,MATH 193A,A03,083781,Staff,0,4,30,30
1650439685043,MATH 193A,A04,083782,Staff,0,5,30,30
1650439691066,MATH 197,001,091859,McAuley; Julian John,9998,0,9999,1
1650439697123,COGS 9,A01,083615,Staff,0,14,60,60
1650439703147,COGS 11,A01,083617,Boyle; Mary E. T.,21,0,40,19
1650439709172,COGS 13,A01,083071,Staff,0,34,40,40
1650439715197,COGS 14A,A01,092681,Staff,1,25,100,99
1650439721221,COGS 14B,A01,083073,Cheng; Tzu-Han,0,11,50,50
1650439727248,COGS 17,A01,092677,Staff,22,0,75,53
1650439733272,COGS 100,A01,083619,Staff,0,26,60,60
1650439739295,COGS 101A,A01,083621,Davis; Joshua Daniel,0,21,60,60
1650439745321,COGS 101B,A01,091572,Staff,0,4,60,60
1650439751345,COGS 101C,A01,083625,Delgado; Tania,16,0,30,14
1650439757382,COGS 107A,A01,083627,Boyle; Mary E. T.,0,11,60,60
1650439763409,COGS 118A,A01,083075,Staff,2,0,60,58
1650439769437,CSE 3,A50,083646,Miranda; Gregory Joseph,20,0,38,18
1650439769437,CSE 3,A51,083647,Miranda; Gregory Joseph,36,0,37,1
1650439775466,CSE 8A,A50,083650,Miranda; Gregory Joseph,0,28,40,40
1650439781493,CSE 11,A01,083080,Cao; Yingjun,0,91,40,40
1650439787522,CSE 12,A01,083652,Staff,0,16,100,100
1650439793545,CSE 15L,A01,083654,Staff,0,1,50,50
1650439793545,CSE 15L,A02,083655,Staff,1,0,50,49
1650439799569,CSE 20,A01,083657,Staff,51,0,80,29
1650439805595,CSE 30,A01,083084,Eldon; John,0,76,40,40
1650439811620,CSE 100,A01,083659,Cao; Yingjun,0,66,50,50
1650439817654,CSE 134B,A01,083661,Powell; Thomas Allan,0,32,65,65
1650439823679,CSE 140,A01,083663,Staff,0,2,75,75
1650439829708,CSE 140L,A01,083088,Eldon; John,0,8,75,75
1650439835734,CSE 175,A01,083665,Kumar; Rakesh,7,0,25,18
1650439841756,CSE 190,A00,092507,Dubnov; Shlomo,14,0,20,6
1650439847781,ECE 45,A01,083139,Staff,0,18,40,40
1650439853806,ECE 65,A50,083695,Staff,0,6,30,30
1650439859833,ECE 109,A01,091882,Touri; Behrouz,38,0,70,32
1650439865861,ECE 180,A00,083140,Abi Samra; Nicholas Camill,23,0,30,7
1650439865861,ECE 180,B00,083141,Abi Samra; Nicholas Camill,0,0,30,30
1650439871885,MATH 10A,A01,083735,Patchell; Gregory David,7,0,30,23
1650439871885,MATH 10A,A02,083736,Patchell; Gregory David,28,0,30,2
1650439871885,MATH 10A,A03,083737,Patchell; Gregory David,25,0,30,5
1650439877910,MATH 10B,A01,083207,Staff,0,7,30,30
1650439877910,MATH 10B,A02,083208,Staff,0,7,30,30
1650439877910,MATH 10B,B01,083739,Staff,13,0,30,17
1650439877910,MATH 10B,B02,083740,Staff,28,0,30,2
1650439883945,MATH 18,A01,083743,Staff,1,0,30,29
1650439883945,MATH 18,A02,083744,Staff,27,0,30,3
1650439883945,MATH 18,A03,083745,Staff,22,0,30,8
1650439883945,MATH 18,A04,083746,Staff,26,0,30,4
1650439883945,MATH 18,B01,083748,Staff,0,11,30,30
1650439883945,MATH 18,B02,083749,Staff,0,12,30,30
1650439883945,MATH 18,B03,083750,Staff,0,11,30,30
1650439883945,MATH 18,B04,083751,Staff,0,12,30,30
1650439889968,MATH 20A,A01,083754,Staff,26,0,40,14
1650439895997,MATH 20B,A01,083756,Staff,0,10,30,30
1650439895997,MATH 20B,A02,083757,Staff,0,10,30,30
1650439902021,MATH 20C,A01,083760,Staff,0,15,30,30
1650439902021,MATH 20C,A02,083761,Staff,1,14,30,29
1650439902021,MATH 20C,B01,083762,Staff,13,0,30,17
1650439902021,MATH 20C,B02,083763,Staff,28,0,30,2
1650439908050,MATH 20D,A01,083765,Staff,0,1,30,30
1650439908050,MATH 20D,A02,083766,Staff,9,0,30,21
1650439908050,MATH 20D,A03,083767,Staff,25,0,30,5
1650439914079,MATH 20E,A01,083771,Staff,5,0,30,25
1650439914079,MATH 20E,A02,083772,Staff,18,0,30,12
1650439914079,MATH 20E,B01,083773,Staff,0,0,30,30
1650439914079,MATH 20E,B02,083774,Staff,10,0,30,20
1650439920104,MATH 103A,A01,083777,Staff,0,12,30,30
1650439920104,MATH 103A,A02,083778,Staff,0,12,30,30
1650439920104,MATH 103A,B01,083779,Staff,0,13,30,30
1650439920104,MATH 103A,B02,083780,Staff,0,11,30,30
1650439926130,MATH 105,A01,085443,Staff,0,23,30,30
1650439932165,MATH 109,A01,083213,Anzaldo; Leesa B,0,7,30,30
1650439932165,MATH 109,A02,083214,Anzaldo; Leesa B,0,7,30,30
1650439932165,MATH 109,B01,083215,Anzaldo; Leesa B,0,5,30,30
1650439932165,MATH 109,B02,083216,Anzaldo; Leesa B,0,6,30,30
1650439938198,MATH 142A,A01,083219,Chow; Bennett,0,14,30,30
1650439938198,MATH 142A,A02,083220,Chow; Bennett,0,13,30,30
1650439938198,MATH 142A,B01,083221,Chow; Bennett,0,12,30,30
1650439938198,MATH 142A,B02,083222,Chow; Bennett,0,13,30,30
1650439944228,MATH 193A,A01,083224,Staff,0,5,30,30
1650439944228,MATH 193A,A02,083225,Staff,0,5,30,30
1650439944228,MATH 193A,A03,083781,Staff,0,4,30,30
1650439944228,MATH 193A,A04,083782,Staff,0,5,30,30
1650439950256,MATH 197,001,091859,McAuley; Julian John,9998,0,9999,1
1650439956312,COGS 9,A01,083615,Staff,0,14,60,60
1650439962337,COGS 11,A01,083617,Boyle; Mary E. T.,21,0,40,19
1650439968362,COGS 13,A01,083071,Staff,0,34,40,40
1650439974390,COGS 14A,A01,092681,Staff,1,25,100,99
1650439980417,COGS 14B,A01,083073,Cheng; Tzu-Han,0,11,50,50
1650439986458,COGS 17,A01,092677,Staff,22,0,75,53
1650439992482,COGS 100,A01,083619,Staff,0,26,60,60
1650439998509,COGS 101A,A01,083621,Davis; Joshua Daniel,0,21,60,60
1650440004535,COGS 101B,A01,091572,Staff,0,4,60,60
1650440010562,COGS 101C,A01,083625,Delgado; Tania,16,0,30,14
1650440016586,COGS 107A,A01,083627,Boyle; Mary E. T.,0,11,60,60
1650440022618,COGS 118A,A01,083075,Staff,2,0,60,58
1650440028648,CSE 3,A50,083646,Miranda; Gregory Joseph,20,0,38,18
1650440028648,CSE 3,A51,083647,Miranda; Gregory Joseph,36,0,37,1
1650440034676,CSE 8A,A50,083650,Miranda; Gregory Joseph,0,28,40,40
1650440040719,CSE 11,A01,083080,Cao; Yingjun,0,91,40,40
1650440046747,CSE 12,A01,083652,Staff,0,16,100,100
1650440052772,CSE 15L,A01,083654,Staff,0,1,50,50
1650440052772,CSE 15L,A02,083655,Staff,1,0,50,49
1650440058800,CSE 20,A01,083657,Staff,51,0,80,29
1650440064824,CSE 30,A01,083084,Eldon; John,0,76,40,40
1650440070849,CSE 100,A01,083659,Cao; Yingjun,0,66,50,50
1650440076875,CSE 134B,A01,083661,Powell; Thomas Allan,0,32,65,65
1650440082900,CSE 140,A01,083663,Staff,0,2,75,75
1650440088928,CSE 140L,A01,083088,Eldon; John,0,8,75,75
1650440094955,CSE 175,A01,083665,Kumar; Rakesh,7,0,25,18
1650440100984,CSE 190,A00,092507,Dubnov; Shlomo,14,0,20,6
1650440107013,ECE 45,A01,083139,Staff,0,18,40,40
1650440113038,ECE 65,A50,083695,Staff,0,6,30,30
1650440119063,ECE 109,A01,091882,Touri; Behrouz,38,0,70,32
1650440125088,ECE 180,A00,083140,Abi Samra; Nicholas Camill,23,0,30,7
1650440125088,ECE 180,B00,083141,Abi Samra; Nicholas Camill,0,0,30,30
1650440131115,MATH 10A,A01,083735,Patchell; Gregory David,7,0,30,23
1650440131115,MATH 10A,A02,083736,Patchell; Gregory David,28,0,30,2
1650440131115,MATH 10A,A03,083737,Patchell; Gregory David,25,0,30,5
1650440137141,MATH 10B,A01,083207,Staff,0,7,30,30
1650440137141,MATH 10B,A02,083208,Staff,0,7,30,30
1650440137141,MATH 10B,B01,083739,Staff,13,0,30,17
1650440137141,MATH 10B,B02,083740,Staff,28,0,30,2
1650440143176,MATH 18,A01,083743,Staff,1,0,30,29
1650440143176,MATH 18,A02,083744,Staff,27,0,30,3
1650440143176,MATH 18,A03,083745,Staff,22,0,30,8
1650440143176,MATH 18,A04,083746,Staff,26,0,30,4
1650440143176,MATH 18,B01,083748,Staff,0,11,30,30
1650440143176,MATH 18,B02,083749,Staff,0,12,30,30
1650440143176,MATH 18,B03,083750,Staff,0,11,30,30
1650440143176,MATH 18,B04,083751,Staff,0,12,30,30
1650440149201,MATH 20A,A01,083754,Staff,25,0,40,15
1650440155227,MATH 20B,A01,083756,Staff,0,10,30,30
1650440155227,MATH 20B,A02,083757,Staff,0,10,30,30
1650440161251,MATH 20C,A01,083760,Staff,0,15,30,30
1650440161251,MATH 20C,A02,083761,Staff,1,14,30,29
1650440161251,MATH 20C,B01,083762,Staff,13,0,30,17
1650440161251,MATH 20C,B02,083763,Staff,28,0,30,2
1650440167276,MATH 20D,A01,083765,Staff,0,1,30,30
1650440167276,MATH 20D,A02,083766,Staff,9,0,30,21
1650440167276,MATH 20D,A03,083767,Staff,25,0,30,5
1650440173301,MATH 20E,A01,083771,Staff,5,0,30,25
1650440173301,MATH 20E,A02,083772,Staff,18,0,30,12
1650440173301,MATH 20E,B01,083773,Staff,0,0,30,30
1650440173301,MATH 20E,B02,083774,Staff,10,0,30,20
1650440179327,MATH 103A,A01,083777,Staff,0,12,30,30
1650440179327,MATH 103A,A02,083778,Staff,0,12,30,30
1650440179327,MATH 103A,B01,083779,Staff,0,13,30,30
1650440179327,MATH 103A,B02,083780,Staff,0,11,30,30
1650440185354,MATH 105,A01,085443,Staff,0,23,30,30
1650440191385,MATH 109,A01,083213,Anzaldo; Leesa B,0,7,30,30
1650440191385,MATH 109,A02,083214,Anzaldo; Leesa B,0,7,30,30
1650440191385,MATH 109,B01,083215,Anzaldo; Leesa B,0,5,30,30
1650440191385,MATH 109,B02,083216,Anzaldo; Leesa B,0,6,30,30
1650440197410,MATH 142A,A01,083219,Chow; Bennett,0,14,30,30
1650440197410,MATH 142A,A02,083220,Chow; Bennett,0,13,30,30
1650440197410,MATH 142A,B01,083221,Chow; Bennett,0,12,30,30
1650440197410,MATH 142A,B02,083222,Chow; Bennett,0,13,30,30
1650440203524,MATH 193A,A01,083224,Staff,0,5,30,30
1650440203524,MATH 193A,A02,083225,Staff,0,5,30,30
1650440203524,MATH 193A,A03,083781,Staff,0,4,30,30
1650440203524,MATH 193A,A04,083782,Staff,0,5,30,30
1650440209547,MATH 197,001,091859,McAuley; Julian John,9998,0,9999,1
1650440215600,COGS 9,A01,083615,Staff,0,14,60,60
1650440221626,COGS 11,A01,083617,Boyle; Mary E. T.,21,0,40,19
1650440227649,COGS 13,A01,083071,Staff,0,34,40,40
1650440233682,COGS 14A,A01,092681,Staff,1,25,100,99
1650440239706,COGS 14B,A01,083073,Cheng; Tzu-Han,0,11,50,50
1650440245732,COGS 17,A01,092677,Staff,22,0,75,53
1650440251757,COGS 100,A01,083619,Staff,0,26,60,60
1650440257782,COGS 101A,A01,083621,Davis; Joshua Daniel,0,21,60,60
1650440263809,COGS 101B,A01,091572,Staff,0,4,60,60
1650440269843,COGS 101C,A01,083625,Delgado; Tania,16,0,30,14
1650440275871,COGS 107A,A01,083627,Boyle; Mary E. T.,0,11,60,60
1650440281898,COGS 118A,A01,083075,Staff,2,0,60,58
1650440287928,CSE 3,A50,083646,Miranda; Gregory Joseph,20,0,38,18
1650440287928,CSE 3,A51,083647,Miranda; Gregory Joseph,36,0,37,1
1650440293965,CSE 8A,A50,083650,Miranda; Gregory Joseph,0,28,40,40
1650440299994,CSE 11,A01,083080,Cao; Yingjun,0,91,40,40
1650440306023,CSE 12,A01,083652,Staff,0,16,100,100
1650440312046,CSE 15L,A01,083654,Staff,0,1,50,50
1650440312046,CSE 15L,A02,083655,Staff,1,0,50,49
1650440318070,CSE 20,A01,083657,Staff,51,0,80,29
1650440324099,CSE 30,A01,083084,Eldon; John,0,76,40,40
1650440330135,CSE 100,A01,083659,Cao; Yingjun,0,66,50,50
1650440336160,CSE 134B,A01,083661,Powell; Thomas Allan,0,32,65,65
1650440342184,CSE 140,A01,083663,Staff,0,2,75,75
1650440348218,CSE 140L,A01,083088,Eldon; John,0,8,75,75
1650440354254,CSE 175,A01,083665,Kumar; Rakesh,7,0,25,18
1650440360278,CSE 190,A00,092507,Dubnov; Shlomo,14,0,20,6
1650440366306,ECE 45,A01,083139,Staff,0,18,40,40
1650440372330,ECE 65,A50,083695,Staff,0,6,30,30
1650440378365,ECE 109,A01,091882,Touri; Behrouz,38,0,70,32
1650440384423,ECE 180,A00,083140,Abi Samra; Nicholas Camill,23,0,30,7
1650440384423,ECE 180,B00,083141,Abi Samra; Nicholas Camill,0,0,30,30
1650440390450,MATH 10A,A01,083735,Patchell; Gregory David,7,0,30,23
1650440390450,MATH 10A,A02,083736,Patchell; Gregory David,28,0,30,2
1650440390450,MATH 10A,A03,083737,Patchell; Gregory David,25,0,30,5
1650440396480,MATH 10B,A01,083207,Staff,0,7,30,30
1650440396480,MATH 10B,A02,083208,Staff,0,7,30,30
1650440396480,MATH 10B,B01,083739,Staff,13,0,30,17
1650440396480,MATH 10B,B02,083740,Staff,28,0,30,2
1650440402516,MATH 18,A01,083743,Staff,1,0,30,29
1650440402516,MATH 18,A02,083744,Staff,27,0,30,3
1650440402516,MATH 18,A03,083745,Staff,22,0,30,8
1650440402516,MATH 18,A04,083746,Staff,26,0,30,4
1650440402516,MATH 18,B01,083748,Staff,0,11,30,30
1650440402516,MATH 18,B02,083749,Staff,0,12,30,30
1650440402516,MATH 18,B03,083750,Staff,0,11,30,30
1650440402516,MATH 18,B04,083751,Staff,0,12,30,30
1650440408541,MATH 20A,A01,083754,Staff,25,0,40,15
1650440414565,MATH 20B,A01,083756,Staff,0,10,30,30
1650440414565,MATH 20B,A02,083757,Staff,0,10,30,30
1650440420593,MATH 20C,A01,083760,Staff,0,15,30,30
1650440420593,MATH 20C,A02,083761,Staff,1,14,30,29
1650440420593,MATH 20C,B01,083762,Staff,13,0,30,17
1650440420593,MATH 20C,B02,083763,Staff,28,0,30,2
1650440426622,MATH 20D,A01,083765,Staff,0,1,30,30
1650440426622,MATH 20D,A02,083766,Staff,9,0,30,21
1650440426622,MATH 20D,A03,083767,Staff,25,0,30,5
1650440432653,MATH 20E,A01,083771,Staff,5,0,30,25
1650440432653,MATH 20E,A02,083772,Staff,18,0,30,12
1650440432653,MATH 20E,B01,083773,Staff,0,0,30,30
1650440432653,MATH 20E,B02,083774,Staff,10,0,30,20
1650440438679,MATH 103A,A01,083777,Staff,0,12,30,30
1650440438679,MATH 103A,A02,083778,Staff,0,12,30,30
1650440438679,MATH 103A,B01,083779,Staff,0,13,30,30
1650440438679,MATH 103A,B02,083780,Staff,0,11,30,30
1650440444707,MATH 105,A01,085443,Staff,0,23,30,30
1650440450733,MATH 109,A01,083213,Anzaldo; Leesa B,0,7,30,30
1650440450733,MATH 109,A02,083214,Anzaldo; Leesa B,0,7,30,30
1650440450733,MATH 109,B01,083215,Anzaldo; Leesa B,0,5,30,30
1650440450733,MATH 109,B02,083216,Anzaldo; Leesa B,0,6,30,30
1650440456758,MATH 142A,A01,083219,Chow; Bennett,0,14,30,30
1650440456758,MATH 142A,A02,083220,Chow; Bennett,0,13,30,30
1650440456758,MATH 142A,B01,083221,Chow; Bennett,0,12,30,30
1650440456758,MATH 142A,B02,083222,Chow; Bennett,0,13,30,30
1650440462783,MATH 193A,A01,083224,Staff,0,5,30,30
1650440462783,MATH 193A,A02,083225,Staff,0,5,30,30
1650440462783,MATH 193A,A03,083781,Staff,0,4,30,30
1650440462783,MATH 193A,A04,083782,Staff,0,5,30,30
1650440468809,MATH 197,001,091859,McAuley; Julian John,9998,0,9999,1
1650440474876,COGS 9,A01,083615,Staff,0,14,60,60
1650440480907,COGS 11,A01,083617,Boyle; Mary E. T.,21,0,40,19
1650440486931,COGS 13,A01,083071,Staff,0,34,40,40
1650440492958,COGS 14A,A01,092681,Staff,1,25,100,99
1650440498988,COGS 14B,A01,083073,Cheng; Tzu-Han,0,11,50,50
1650440505024,COGS 17,A01,092677,Staff,22,0,75,53
1650440511053,COGS 100,A01,083619,Staff,0,26,60,60
1650440517079,COGS 101A,A01,083621,Davis; Joshua Daniel,0,21,60,60
1650440523104,COGS 101B,A01,091572,Staff,0,4,60,60
1650440529132,COGS 101C,A01,083625,Delgado; Tania,16,0,30,14
1650440535162,COGS 107A,A01,083627,Boyle; Mary E. T.,0,11,60,60
1650440541192,COGS 118A,A01,083075,Staff,2,0,60,58
1650440547219,CSE 3,A50,083646,Miranda; Gregory Joseph,20,0,38,18
1650440547219,CSE 3,A51,083647,Miranda; Gregory Joseph,36,0,37,1
1650440553246,CSE 8A,A50,083650,Miranda; Gregory Joseph,0,28,40,40
1650440559273,CSE 11,A01,083080,Cao; Yingjun,0,91,40,40
1650440565298,CSE 12,A01,083652,Staff,0,16,100,100
1650440571321,CSE 15L,A01,083654,Staff,0,1,50,50
1650440571321,CSE 15L,A02,083655,Staff,1,0,50,49
1650440577346,CSE 20,A01,083657,Staff,51,0,80,29
1650440583373,CSE 30,A01,083084,Eldon; John,0,76,40,40
1650440589400,CSE 100,A01,083659,Cao; Yingjun,0,66,50,50
1650440595426,CSE 134B,A01,083661,Powell; Thomas Allan,0,32,65,65
1650440601456,CSE 140,A01,083663,Staff,0,2,75,75
1650440607485,CSE 140L,A01,083088,Eldon; John,0,8,75,75
1650440613519,CSE 175,A01,083665,Kumar; Rakesh,7,0,25,18
1650440619545,CSE 190,A00,092507,Dubnov; Shlomo,14,0,20,6
1650440625577,ECE 45,A01,083139,Staff,0,18,40,40
1650440631602,ECE 65,A50,083695,Staff,0,6,30,30
1650440637628,ECE 109,A01,091882,Touri; Behrouz,38,0,70,32
1650440643656,ECE 180,A00,083140,Abi Samra; Nicholas Camill,23,0,30,7
1650440643656,ECE 180,B00,083141,Abi Samra; Nicholas Camill,0,0,30,30
1650440649690,MATH 10A,A01,083735,Patchell; Gregory David,7,0,30,23
1650440649690,MATH 10A,A02,083736,Patchell; Gregory David,28,0,30,2
1650440649690,MATH 10A,A03,083737,Patchell; Gregory David,25,0,30,5
1650440655721,MATH 10B,A01,083207,Staff,0,7,30,30
1650440655721,MATH 10B,A02,083208,Staff,0,7,30,30
1650440655721,MATH 10B,B01,083739,Staff,13,0,30,17
1650440655721,MATH 10B,B02,083740,Staff,28,0,30,2
1650440661751,MATH 18,A01,083743,Staff,1,0,30,29
1650440661751,MATH 18,A02,083744,Staff,27,0,30,3
1650440661751,MATH 18,A03,083745,Staff,22,0,30,8
1650440661751,MATH 18,A04,083746,Staff,26,0,30,4
1650440661751,MATH 18,B01,083748,Staff,0,11,30,30
1650440661751,MATH 18,B02,083749,Staff,0,12,30,30
1650440661751,MATH 18,B03,083750,Staff,0,11,30,30
1650440661751,MATH 18,B04,083751,Staff,0,12,30,30
1650440667773,MATH 20A,A01,083754,Staff,25,0,40,15
1650440673806,MATH 20B,A01,083756,Staff,0,10,30,30
1650440673806,MATH 20B,A02,083757,Staff,0,10,30,30
1650440679831,MATH 20C,A01,083760,Staff,0,15,30,30
1650440679831,MATH 20C,A02,083761,Staff,1,14,30,29
1650440679831,MATH 20C,B01,083762,Staff,13,0,30,17
1650440679831,MATH 20C,B02,083763,Staff,28,0,30,2
1650440685856,MATH 20D,A01,083765,Staff,0,1,30,30
1650440685856,MATH 20D,A02,083766,Staff,9,0,30,21
1650440685856,MATH 20D,A03,083767,Staff,25,0,30,5
1650440691883,MATH 20E,A01,083771,Staff,5,0,30,25
1650440691883,MATH 20E,A02,083772,Staff,18,0,30,12
1650440691883,MATH 20E,B01,083773,Staff,0,0,30,30
1650440691883,MATH 20E,B02,083774,Staff,10,0,30,20
1650440697908,MATH 103A,A01,083777,Staff,0,12,30,30
1650440697908,MATH 103A,A02,083778,Staff,0,12,30,30
1650440697908,MATH 103A,B01,083779,Staff,0,13,30,30
1650440697908,MATH 103A,B02,083780,Staff,0,11,30,30
1650440703933,MATH 105,A01,085443,Staff,0,23,30,30
1650440709957,MATH 109,A01,083213,Anzaldo; Leesa B,0,7,30,30
1650440709957,MATH 109,A02,083214,Anzaldo; Leesa B,0,7,30,30
1650440709957,MATH 109,B01,083215,Anzaldo; Leesa B,0,5,30,30
1650440709957,MATH 109,B02,083216,Anzaldo; Leesa B,0,6,30,30
1650440715988,MATH 142A,A01,083219,Chow; Bennett,0,14,30,30
1650440715988,MATH 142A,A02,083220,Chow; Bennett,0,13,30,30
1650440715988,MATH 142A,B01,083221,Chow; Bennett,0,12,30,30
1650440715988,MATH 142A,B02,083222,Chow; Bennett,0,13,30,30
1650440722014,MATH 193A,A01,083224,Staff,0,5,30,30
1650440722014,MATH 193A,A02,083225,Staff,0,5,30,30
1650440722014,MATH 193A,A03,083781,Staff,0,4,30,30
1650440722014,MATH 193A,A04,083782,Staff,0,5,30,30
1650440728040,MATH 197,001,091859,McAuley; Julian John,9998,0,9999,1
1650440734130,COGS 9,A01,083615,Staff,0,14,60,60
1650440740161,COGS 11,A01,083617,Boyle; Mary E. T.,21,0,40,19
1650440746188,COGS 13,A01,083071,Staff,0,34,40,40
1650440752212,COGS 14A,A01,092681,Staff,1,25,100,99
1650440758240,COGS 14B,A01,083073,Cheng; Tzu-Han,0,11,50,50
1650440764269,COGS 17,A01,092677,Staff,22,0,75,53
1650440770293,COGS 100,A01,083619,Staff,0,26,60,60
1650440776324,COGS 101A,A01,083621,Davis; Joshua Daniel,0,21,60,60
1650440782349,COGS 101B,A01,091572,Staff,0,4,60,60
1650440788374,COGS 101C,A01,083625,Delgado; Tania,16,0,30,14
1650440794493,COGS 107A,A01,083627,Boyle; Mary E. T.,0,11,60,60
1650440800518,COGS 118A,A01,083075,Staff,2,0,60,58
1650440806556,CSE 3,A50,083646,Miranda; Gregory Joseph,20,0,38,18
1650440806556,CSE 3,A51,083647,Miranda; Gregory Joseph,36,0,37,1
1650440812586,CSE 8A,A50,083650,Miranda; Gregory Joseph,0,28,40,40
1650440818615,CSE 11,A01,083080,Cao; Yingjun,0,91,40,40
1650440824639,CSE 12,A01,083652,Staff,0,16,100,100
1650440830669,CSE 15L,A01,083654,Staff,0,1,50,50
1650440830669,CSE 15L,A02,083655,Staff,1,0,50,49
1650440836697,CSE 20,A01,083657,Staff,51,0,80,29
1650440842722,CSE 30,A01,083084,Eldon; John,0,76,40,40
1650440848866,CSE 100,A01,083659,Cao; Yingjun,0,66,50,50
1650440854892,CSE 134B,A01,083661,Powell; Thomas Allan,0,32,65,65
1650440860916,CSE 140,A01,083663,Staff,0,2,75,75
1650440866940,CSE 140L,A01,083088,Eldon; John,0,8,75,75
1650440872971,CSE 175,A01,083665,Kumar; Rakesh,7,0,25,18
1650440878997,CSE 190,A00,092507,Dubnov; Shlomo,14,0,20,6
1650440885022,ECE 45,A01,083139,Staff,0,18,40,40
1650440891058,ECE 65,A50,083695,Staff,0,6,30,30
1650440897089,ECE 109,A01,091882,Touri; Behrouz,38,0,70,32
1650440903115,ECE 180,A00,083140,Abi Samra; Nicholas Camill,23,0,30,7
1650440903115,ECE 180,B00,083141,Abi Samra; Nicholas Camill,0,0,30,30
1650440909141,MATH 10A,A01,083735,Patchell; Gregory David,7,0,30,23
1650440909141,MATH 10A,A02,083736,Patchell; Gregory David,28,0,30,2
1650440909141,MATH 10A,A03,083737,Patchell; Gregory David,25,0,30,5
1650440915171,MATH 10B,A01,083207,Staff,0,7,30,30
1650440915171,MATH 10B,A02,083208,Staff,0,7,30,30
1650440915171,MATH 10B,B01,083739,Staff,13,0,30,17
1650440915171,MATH 10B,B02,083740,Staff,28,0,30,2
1650440921197,MATH 18,A01,083743,Staff,1,0,30,29
1650440921197,MATH 18,A02,083744,Staff,27,0,30,3
1650440921197,MATH 18,A03,083745,Staff,22,0,30,8
1650440921197,MATH 18,A04,083746,Staff,26,0,30,4
1650440921197,MATH 18,B01,083748,Staff,0,11,30,30
1650440921197,MATH 18,B02,083749,Staff,0,12,30,30
1650440921197,MATH 18,B03,083750,Staff,0,11,30,30
1650440921197,MATH 18,B04,083751,Staff,0,12,30,30
1650440927222,MATH 20A,A01,083754,Staff,25,0,40,15
1650440933252,MATH 20B,A01,083756,Staff,0,10,30,30
1650440933252,MATH 20B,A02,083757,Staff,0,10,30,30
1650440939282,MATH 20C,A01,083760,Staff,0,15,30,30
1650440939282,MATH 20C,A02,083761,Staff,1,14,30,29
1650440939282,MATH 20C,B01,083762,Staff,13,0,30,17
1650440939282,MATH 20C,B02,083763,Staff,28,0,30,2
1650440945308,MATH 20D,A01,083765,Staff,0,1,30,30
1650440945308,MATH 20D,A02,083766,Staff,9,0,30,21
1650440945308,MATH 20D,A03,083767,Staff,25,0,30,5
1650440951344,MATH 20E,A01,083771,Staff,5,0,30,25
1650440951344,MATH 20E,A02,083772,Staff,18,0,30,12
1650440951344,MATH 20E,B01,083773,Staff,0,0,30,30
1650440951344,MATH 20E,B02,083774,Staff,10,0,30,20
1650440957375,MATH 103A,A01,083777,Staff,0,12,30,30
1650440957375,MATH 103A,A02,083778,Staff,0,12,30,30
1650440957375,MATH 103A,B01,083779,Staff,0,13,30,30
1650440957375,MATH 103A,B02,083780,Staff,0,11,30,30
1650440963400,MATH 105,A01,085443,Staff,0,23,30,30
1650440969428,MATH 109,A01,083213,Anzaldo; Leesa B,0,7,30,30
1650440969428,MATH 109,A02,083214,Anzaldo; Leesa B,0,7,30,30
1650440969428,MATH 109,B01,083215,Anzaldo; Leesa B,0,5,30,30
1650440969428,MATH 109,B02,083216,Anzaldo; Leesa B,0,6,30,30
1650440975468,MATH 142A,A01,083219,Chow; Bennett,0,14,30,30
1650440975468,MATH 142A,A02,083220,Chow; Bennett,0,13,30,30
1650440975468,MATH 142A,B01,083221,Chow; Bennett,0,12,30,30
1650440975468,MATH 142A,B02,083222,Chow; Bennett,0,13,30,30
1650440981494,MATH 193A,A01,083224,Staff,0,5,30,30
1650440981494,MATH 193A,A02,083225,Staff,0,5,30,30
1650440981494,MATH 193A,A03,083781,Staff,0,4,30,30
1650440981494,MATH 193A,A04,083782,Staff,0,5,30,30
1650440987519,MATH 197,001,091859,McAuley; Julian John,9998,0,9999,1
1650440993589,COGS 9,A01,083615,Staff,0,14,60,60
1650440999620,COGS 11,A01,083617,Boyle; Mary E. T.,21,0,40,19
1650441005651,COGS 13,A01,083071,Staff,0,34,40,40
1650441011676,COGS 14A,A01,092681,Staff,1,25,100,99
1650441017700,COGS 14B,A01,083073,Cheng; Tzu-Han,0,11,50,50
1650441023736,COGS 17,A01,092677,Staff,22,0,75,53
1650441029764,COGS 100,A01,083619,Staff,0,26,60,60
1650441035795,COGS 101A,A01,083621,Davis; Joshua Daniel,0,21,60,60
1650441041821,COGS 101B,A01,091572,Staff,0,4,60,60
1650441047850,COGS 101C,A01,083625,Delgado; Tania,16,0,30,14
1650441053885,COGS 107A,A01,083627,Boyle; Mary E. T.,0,11,60,60
1650441059913,COGS 118A,A01,083075,Staff,2,0,60,58
1650441065940,CSE 3,A50,083646,Miranda; Gregory Joseph,20,0,38,18
1650441065940,CSE 3,A51,083647,Miranda; Gregory Joseph,36,0,37,1
1650441071974,CSE 8A,A50,083650,Miranda; Gregory Joseph,0,28,40,40
1650441078002,CSE 11,A01,083080,Cao; Yingjun,0,91,40,40
1650441084036,CSE 12,A01,083652,Staff,0,16,100,100
1650441090064,CSE 15L,A01,083654,Staff,0,1,50,50
1650441090064,CSE 15L,A02,083655,Staff,1,0,50,49
1650441096095,CSE 20,A01,083657,Staff,51,0,80,29
1650441102124,CSE 30,A01,083084,Eldon; John,0,76,40,40
1650441108149,CSE 100,A01,083659,Cao; Yingjun,0,66,50,50
1650441114174,CSE 134B,A01,083661,Powell; Thomas Allan,0,32,65,65
1650441120200,CSE 140,A01,083663,Staff,0,2,75,75
1650441126238,CSE 140L,A01,083088,Eldon; John,0,8,75,75
1650441132270,CSE 175,A01,083665,Kumar; Rakesh,7,0,25,18
1650441138301,CSE 190,A00,092507,Dubnov; Shlomo,14,0,20,6
1650441144327,ECE 45,A01,083139,Staff,0,18,40,40
1650441150353,ECE 65,A50,083695,Staff,0,6,30,30
1650441156389,ECE 109,A01,091882,Touri; Behrouz,38,0,70,32
1650441162420,ECE 180,A00,083140,Abi Samra; Nicholas Camill,23,0,30,7
1650441162420,ECE 180,B00,083141,Abi Samra; Nicholas Camill,0,0,30,30
1650441168447,MATH 10A,A01,083735,Patchell; Gregory David,7,0,30,23
1650441168447,MATH 10A,A02,083736,Patchell; Gregory David,28,0,30,2
1650441168447,MATH 10A,A03,083737,Patchell; Gregory David,25,0,30,5
1650441174473,MATH 10B,A01,083207,Staff,0,7,30,30
1650441174473,MATH 10B,A02,083208,Staff,0,7,30,30
1650441174473,MATH 10B,B01,083739,Staff,13,0,30,17
1650441174473,MATH 10B,B02,083740,Staff,28,0,30,2
1650441180502,MATH 18,A01,083743,Staff,1,0,30,29
1650441180502,MATH 18,A02,083744,Staff,27,0,30,3
1650441180502,MATH 18,A03,083745,Staff,22,0,30,8
1650441180502,MATH 18,A04,083746,Staff,26,0,30,4
1650441180502,MATH 18,B01,083748,Staff,0,11,30,30
1650441180502,MATH 18,B02,083749,Staff,0,12,30,30
1650441180502,MATH 18,B03,083750,Staff,0,11,30,30
1650441180502,MATH 18,B04,083751,Staff,0,12,30,30
1650441186530,MATH 20A,A01,083754,Staff,25,0,40,15
1650441192554,MATH 20B,A01,083756,Staff,0,10,30,30
1650441192554,MATH 20B,A02,083757,Staff,0,10,30,30
1650441198582,MATH 20C,A01,083760,Staff,0,15,30,30
1650441198582,MATH 20C,A02,083761,Staff,1,14,30,29
1650441198582,MATH 20C,B01,083762,Staff,13,0,30,17
1650441198582,MATH 20C,B02,083763,Staff,28,0,30,2
1650441204606,MATH 20D,A01,083765,Staff,0,1,30,30
1650441204606,MATH 20D,A02,083766,Staff,9,0,30,21
1650441204606,MATH 20D,A03,083767,Staff,25,0,30,5
1650441210632,MATH 20E,A01,083771,Staff,5,0,30,25
1650441210632,MATH 20E,A02,083772,Staff,18,0,30,12
1650441210632,MATH 20E,B01,083773,Staff,0,0,30,30
1650441210632,MATH 20E,B02,083774,Staff,10,0,30,20
1650441216659,MATH 103A,A01,083777,Staff,0,12,30,30
1650441216659,MATH 103A,A02,083778,Staff,0,12,30,30
1650441216659,MATH 103A,B01,083779,Staff,0,13,30,30
1650441216659,MATH 103A,B02,083780,Staff,0,11,30,30
1650441222688,MATH 105,A01,085443,Staff,0,23,30,30
1650441228720,MATH 109,A01,083213,Anzaldo; Leesa B,0,7,30,30
1650441228720,MATH 109,A02,083214,Anzaldo; Leesa B,0,7,30,30
1650441228720,MATH 109,B01,083215,Anzaldo; Leesa B,0,5,30,30
1650441228720,MATH 109,B02,083216,Anzaldo; Leesa B,0,6,30,30
1650441234744,MATH 142A,A01,083219,Chow; Bennett,0,14,30,30
1650441234744,MATH 142A,A02,083220,Chow; Bennett,0,13,30,30
1650441234744,MATH 142A,B01,083221,Chow; Bennett,0,12,30,30
1650441234744,MATH 142A,B02,083222,Chow; Bennett,0,13,30,30
1650441240769,MATH 193A,A01,083224,Staff,0,5,30,30
1650441240769,MATH 193A,A02,083225,Staff,0,5,30,30
1650441240769,MATH 193A,A03,083781,Staff,0,4,30,30
1650441240769,MATH 193A,A04,083782,Staff,0,5,30,30
1650441246795,MATH 197,001,091859,McAuley; Julian John,9998,0,9999,1
1650441252866,COGS 9,A01,083615,Staff,0,14,60,60
1650441258895,COGS 11,A01,083617,Boyle; Mary E. T.,21,0,40,19
1650441264924,COGS 13,A01,083071,Staff,0,34,40,40
1650441270950,COGS 14A,A01,092681,Staff,1,25,100,99
1650441276982,COGS 14B,A01,083073,Cheng; Tzu-Han,0,11,50,50
1650441283009,COGS 17,A01,092677,Staff,22,0,75,53
1650441289034,COGS 100,A01,083619,Staff,0,26,60,60
1650441295059,COGS 101A,A01,083621,Davis; Joshua Daniel,0,21,60,60
1650441301092,COGS 101B,A01,091572,Staff,0,4,60,60
1650441307117,COGS 101C,A01,083625,Delgado; Tania,16,0,30,14
1650441313147,COGS 107A,A01,083627,Boyle; Mary E. T.,0,11,60,60
1650441319172,COGS 118A,A01,083075,Staff,2,0,60,58
1650441325205,CSE 3,A50,083646,Miranda; Gregory Joseph,20,0,38,18
1650441325205,CSE 3,A51,083647,Miranda; Gregory Joseph,36,0,37,1
1650441331232,CSE 8A,A50,083650,Miranda; Gregory Joseph,0,28,40,40
1650441337258,CSE 11,A01,083080,Cao; Yingjun,0,91,40,40
1650441343288,CSE 12,A01,083652,Staff,0,16,100,100
1650441349313,CSE 15L,A01,083654,Staff,0,1,50,50
1650441349313,CSE 15L,A02,083655,Staff,1,0,50,49
1650441355337,CSE 20,A01,083657,Staff,51,0,80,29
1650441361369,CSE 30,A01,083084,Eldon; John,0,76,40,40
1650441367394,CSE 100,A01,083659,Cao; Yingjun,0,66,50,50
1650441373420,CSE 134B,A01,083661,Powell; Thomas Allan,0,32,65,65
1650441379444,CSE 140,A01,083663,Staff,0,2,75,75
1650441385468,CSE 140L,A01,083088,Eldon; John,0,8,75,75
1650441391580,CSE 175,A01,083665,Kumar; Rakesh,7,0,25,18
1650441397607,CSE 190,A00,092507,Dubnov; Shlomo,14,0,20,6
1650441403632,ECE 45,A01,083139,Staff,0,18,40,40
1650441409660,ECE 65,A50,083695,Staff,0,6,30,30
1650441415689,ECE 109,A01,091882,Touri; Behrouz,38,0,70,32
1650441421720,ECE 180,A00,083140,Abi Samra; Nicholas Camill,23,0,30,7
1650441421720,ECE 180,B00,083141,Abi Samra; Nicholas Camill,0,0,30,30
1650441427746,MATH 10A,A01,083735,Patchell; Gregory David,7,0,30,23
1650441427746,MATH 10A,A02,083736,Patchell; Gregory David,28,0,30,2
1650441427746,MATH 10A,A03,083737,Patchell; Gregory David,25,0,30,5
1650441433776,MATH 10B,A01,083207,Staff,0,7,30,30
1650441433776,MATH 10B,A02,083208,Staff,0,7,30,30
1650441433776,MATH 10B,B01,083739,Staff,13,0,30,17
1650441433776,MATH 10B,B02,083740,Staff,28,0,30,2
1650441439802,MATH 18,A01,083743,Staff,1,0,30,29
1650441439802,MATH 18,A02,083744,Staff,27,0,30,3
1650441439802,MATH 18,A03,083745,Staff,22,0,30,8
1650441439802,MATH 18,A04,083746,Staff,26,0,30,4
1650441439802,MATH 18,B01,083748,Staff,0,11,30,30
1650441439802,MATH 18,B02,083749,Staff,0,12,30,30
1650441439802,MATH 18,B03,083750,Staff,0,11,30,30
1650441439802,MATH 18,B04,083751,Staff,0,12,30,30
1650441445830,MATH 20A,A01,083754,Staff,25,0,40,15
1650441451860,MATH 20B,A01,083756,Staff,0,10,30,30
1650441451860,MATH 20B,A02,083757,Staff,0,10,30,30
1650441457885,MATH 20C,A01,083760,Staff,0,15,30,30
1650441457885,MATH 20C,A02,083761,Staff,1,14,30,29
1650441457885,MATH 20C,B01,083762,Staff,13,0,30,17
1650441457885,MATH 20C,B02,083763,Staff,28,0,30,2
1650441463910,MATH 20D,A01,083765,Staff,0,1,30,30
1650441463910,MATH 20D,A02,083766,Staff,9,0,30,21
1650441463910,MATH 20D,A03,083767,Staff,25,0,30,5
1650441469939,MATH 20E,A01,083771,Staff,5,0,30,25
1650441469939,MATH 20E,A02,083772,Staff,18,0,30,12
1650441469939,MATH 20E,B01,083773,Staff,0,0,30,30
1650441469939,MATH 20E,B02,083774,Staff,10,0,30,20
1650441475967,MATH 103A,A01,083777,Staff,0,12,30,30
1650441475967,MATH 103A,A02,083778,Staff,0,12,30,30
1650441475967,MATH 103A,B01,083779,Staff,0,13,30,30
1650441475967,MATH 103A,B02,083780,Staff,0,11,30,30
1650441481995,MATH 105,A01,085443,Staff,0,23,30,30
1650441488024,MATH 109,A01,083213,Anzaldo; Leesa B,0,7,30,30
1650441488024,MATH 109,A02,083214,Anzaldo; Leesa B,0,7,30,30
1650441488024,MATH 109,B01,083215,Anzaldo; Leesa B,0,5,30,30
1650441488024,MATH 109,B02,083216,Anzaldo; Leesa B,0,6,30,30
1650441494050,MATH 142A,A01,083219,Chow; Bennett,0,14,30,30
1650441494050,MATH 142A,A02,083220,Chow; Bennett,0,13,30,30
1650441494050,MATH 142A,B01,083221,Chow; Bennett,0,12,30,30
1650441494050,MATH 142A,B02,083222,Chow; Bennett,0,13,30,30
1650441500083,MATH 193A,A01,083224,Staff,0,5,30,30
1650441500083,MATH 193A,A02,083225,Staff,0,5,30,30
1650441500083,MATH 193A,A03,083781,Staff,0,4,30,30
1650441500083,MATH 193A,A04,083782,Staff,0,5,30,30
1650441506108,MATH 197,001,091859,McAuley; Julian John,9998,0,9999,1
1650441512175,COGS 9,A01,083615,Staff,0,14,60,60
1650441518205,COGS 11,A01,083617,Boyle; Mary E. T.,21,0,40,19
1650441524229,COGS 13,A01,083071,Staff,0,34,40,40
1650441530258,COGS 14A,A01,092681,Staff,1,25,100,99
1650441536283,COGS 14B,A01,083073,Cheng; Tzu-Han,0,11,50,50
1650441542307,COGS 17,A01,092677,Staff,22,0,75,53
1650441548337,COGS 100,A01,083619,Staff,0,26,60,60
1650441554362,COGS 101A,A01,083621,Davis; Joshua Daniel,0,21,60,60
1650441560387,COGS 101B,A01,091572,Staff,0,4,60,60
1650441566418,COGS 101C,A01,083625,Delgado; Tania,16,0,30,14
1650441572443,COGS 107A,A01,083627,Boyle; Mary E. T.,0,11,60,60
1650441578469,COGS 118A,A01,083075,Staff,2,0,60,58
1650441584495,CSE 3,A50,083646,Miranda; Gregory Joseph,20,0,38,18
1650441584495,CSE 3,A51,083647,Miranda; Gregory Joseph,36,0,37,1
1650441590520,CSE 8A,A50,083650,Miranda; Gregory Joseph,0,28,40,40
1650441596546,CSE 11,A01,083080,Cao; Yingjun,0,91,40,40
1650441602571,CSE 12,A01,083652,Staff,0,16,100,100
1650441608599,CSE 15L,A01,083654,Staff,0,1,50,50
1650441608599,CSE 15L,A02,083655,Staff,1,0,50,49
1650441614623,CSE 20,A01,083657,Staff,51,0,80,29
1650441620651,CSE 30,A01,083084,Eldon; John,0,76,40,40
1650441626683,CSE 100,A01,083659,Cao; Yingjun,0,66,50,50
1650441632712,CSE 134B,A01,083661,Powell; Thomas Allan,0,32,65,65
1650441638741,CSE 140,A01,083663,Staff,0,2,75,75
1650441644773,CSE 140L,A01,083088,Eldon; John,0,8,75,75
1650441650797,CSE 175,A01,083665,Kumar; Rakesh,7,0,25,18
1650441656828,CSE 190,A00,092507,Dubnov; Shlomo,14,0,20,6
1650441662854,ECE 45,A01,083139,Staff,0,18,40,40
1650441668888,ECE 65,A50,083695,Staff,0,6,30,30
1650441674912,ECE 109,A01,091882,Touri; Behrouz,38,0,70,32
1650441680937,ECE 180,A00,083140,Abi Samra; Nicholas Camill,23,0,30,7
1650441680937,ECE 180,B00,083141,Abi Samra; Nicholas Camill,0,0,30,30
1650441686978,MATH 10A,A01,083735,Patchell; Gregory David,7,0,30,23
1650441686978,MATH 10A,A02,083736,Patchell; Gregory David,28,0,30,2
1650441686978,MATH 10A,A03,083737,Patchell; Gregory David,25,0,30,5
1650441693004,MATH 10B,A01,083207,Staff,0,7,30,30
1650441693004,MATH 10B,A02,083208,Staff,0,7,30,30
1650441693004,MATH 10B,B01,083739,Staff,13,0,30,17
1650441693004,MATH 10B,B02,083740,Staff,28,0,30,2
1650441699031,MATH 18,A01,083743,Staff,1,0,30,29
1650441699031,MATH 18,A02,083744,Staff,27,0,30,3
1650441699031,MATH 18,A03,083745,Staff,22,0,30,8
1650441699031,MATH 18,A04,083746,Staff,26,0,30,4
1650441699031,MATH 18,B01,083748,Staff,0,11,30,30
1650441699031,MATH 18,B02,083749,Staff,0,12,30,30
1650441699031,MATH 18,B03,083750,Staff,0,11,30,30
1650441699031,MATH 18,B04,083751,Staff,0,12,30,30
1650441705058,MATH 20A,A01,083754,Staff,25,0,40,15
1650441711087,MATH 20B,A01,083756,Staff,0,10,30,30
1650441711087,MATH 20B,A02,083757,Staff,0,10,30,30
1650441717123,MATH 20C,A01,083760,Staff,0,15,30,30
1650441717123,MATH 20C,A02,083761,Staff,1,14,30,29
1650441717123,MATH 20C,B01,083762,Staff,13,0,30,17
1650441717123,MATH 20C,B02,083763,Staff,28,0,30,2
1650441723151,MATH 20D,A01,083765,Staff,0,1,30,30
1650441723151,MATH 20D,A02,083766,Staff,9,0,30,21
1650441723151,MATH 20D,A03,083767,Staff,25,0,30,5
1650441729182,MATH 20E,A01,083771,Staff,5,0,30,25
1650441729182,MATH 20E,A02,083772,Staff,18,0,30,12
1650441729182,MATH 20E,B01,083773,Staff,0,0,30,30
1650441729182,MATH 20E,B02,083774,Staff,10,0,30,20
1650441735211,MATH 103A,A01,083777,Staff,0,12,30,30
1650441735211,MATH 103A,A02,083778,Staff,0,12,30,30
1650441735211,MATH 103A,B01,083779,Staff,0,13,30,30
1650441735211,MATH 103A,B02,083780,Staff,0,11,30,30
1650441741236,MATH 105,A01,085443,Staff,0,23,30,30
1650441747265,MATH 109,A01,083213,Anzaldo; Leesa B,0,7,30,30
1650441747265,MATH 109,A02,083214,Anzaldo; Leesa B,0,7,30,30
1650441747265,MATH 109,B01,083215,Anzaldo; Leesa B,0,5,30,30
1650441747265,MATH 109,B02,083216,Anzaldo; Leesa B,0,6,30,30
1650441753296,MATH 142A,A01,083219,Chow; Bennett,0,14,30,30
1650441753296,MATH 142A,A02,083220,Chow; Bennett,0,13,30,30
1650441753296,MATH 142A,B01,083221,Chow; Bennett,0,12,30,30
1650441753296,MATH 142A,B02,083222,Chow; Bennett,0,13,30,30
1650441759320,MATH 193A,A01,083224,Staff,0,5,30,30
1650441759320,MATH 193A,A02,083225,Staff,0,5,30,30
1650441759320,MATH 193A,A03,083781,Staff,0,4,30,30
1650441759320,MATH 193A,A04,083782,Staff,0,5,30,30
1650441765343,MATH 197,001,091859,McAuley; Julian John,9998,0,9999,1
1650441771408,COGS 9,A01,083615,Staff,0,14,60,60
1650441777437,COGS 11,A01,083617,Boyle; Mary E. T.,21,0,40,19
1650441783464,COGS 13,A01,083071,Staff,0,34,40,40
1650441789492,COGS 14A,A01,092681,Staff,1,25,100,99
1650441795517,COGS 14B,A01,083073,Cheng; Tzu-Han,0,11,50,50
1650441801540,COGS 17,A01,092677,Staff,22,0,75,53
1650441807566,COGS 100,A01,083619,Staff,0,26,60,60
1650441813611,COGS 101A,A01,083621,Davis; Joshua Daniel,0,21,60,60
1650441819637,COGS 101B,A01,091572,Staff,0,4,60,60
1650441825664,COGS 101C,A01,083625,Delgado; Tania,16,0,30,14
1650441831694,COGS 107A,A01,083627,Boyle; Mary E. T.,0,11,60,60
1650441837721,COGS 118A,A01,083075,Staff,2,0,60,58
1650441843745,CSE 3,A50,083646,Miranda; Gregory Joseph,20,0,38,18
1650441843745,CSE 3,A51,083647,Miranda; Gregory Joseph,36,0,37,1
1650441849770,CSE 8A,A50,083650,Miranda; Gregory Joseph,0,28,40,40
1650441855793,CSE 11,A01,083080,Cao; Yingjun,0,91,40,40
1650441861819,CSE 12,A01,083652,Staff,0,16,100,100
1650441867853,CSE 15L,A01,083654,Staff,0,1,50,50
1650441867853,CSE 15L,A02,083655,Staff,1,0,50,49
1650441873879,CSE 20,A01,083657,Staff,51,0,80,29
1650441879905,CSE 30,A01,083084,Eldon; John,0,76,40,40
1650441885932,CSE 100,A01,083659,Cao; Yingjun,0,66,50,50
1650441891964,CSE 134B,A01,083661,Powell; Thomas Allan,0,32,65,65
1650441897989,CSE 140,A01,083663,Staff,0,2,75,75
1650441904013,CSE 140L,A01,083088,Eldon; John,0,8,75,75
1650441910036,CSE 175,A01,083665,Kumar; Rakesh,7,0,25,18
1650441916060,CSE 190,A00,092507,Dubnov; Shlomo,14,0,20,6
1650441922089,ECE 45,A01,083139,Staff,0,18,40,40
1650441928120,ECE 65,A50,083695,Staff,0,6,30,30
1650441934151,ECE 109,A01,091882,Touri; Behrouz,38,0,70,32
1650441940179,ECE 180,A00,083140,Abi Samra; Nicholas Camill,23,0,30,7
1650441940179,ECE 180,B00,083141,Abi Samra; Nicholas Camill,0,0,30,30
1650441946207,MATH 10A,A01,083735,Patchell; Gregory David,7,0,30,23
1650441946207,MATH 10A,A02,083736,Patchell; Gregory David,28,0,30,2
1650441946207,MATH 10A,A03,083737,Patchell; Gregory David,25,0,30,5
1650441952233,MATH 10B,A01,083207,Staff,0,7,30,30
1650441952233,MATH 10B,A02,083208,Staff,0,7,30,30
1650441952233,MATH 10B,B01,083739,Staff,13,0,30,17
1650441952233,MATH 10B,B02,083740,Staff,28,0,30,2
1650441958260,MATH 18,A01,083743,Staff,1,0,30,29
1650441958260,MATH 18,A02,083744,Staff,27,0,30,3
1650441958260,MATH 18,A03,083745,Staff,22,0,30,8
1650441958260,MATH 18,A04,083746,Staff,26,0,30,4
1650441958260,MATH 18,B01,083748,Staff,0,11,30,30
1650441958260,MATH 18,B02,083749,Staff,0,12,30,30
1650441958260,MATH 18,B03,083750,Staff,0,11,30,30
1650441958260,MATH 18,B04,083751,Staff,0,12,30,30
1650441964286,MATH 20A,A01,083754,Staff,25,0,40,15
1650441970317,MATH 20B,A01,083756,Staff,0,10,30,30
1650441970317,MATH 20B,A02,083757,Staff,0,10,30,30
1650441976346,MATH 20C,A01,083760,Staff,0,15,30,30
1650441976346,MATH 20C,A02,083761,Staff,1,14,30,29
1650441976346,MATH 20C,B01,083762,Staff,13,0,30,17
1650441976346,MATH 20C,B02,083763,Staff,28,0,30,2
1650441982371,MATH 20D,A01,083765,Staff,0,1,30,30
1650441982371,MATH 20D,A02,083766,Staff,9,0,30,21
1650441982371,MATH 20D,A03,083767,Staff,25,0,30,5
1650441988491,MATH 20E,A01,083771,Staff,5,0,30,25
1650441988491,MATH 20E,A02,083772,Staff,18,0,30,12
1650441988491,MATH 20E,B01,083773,Staff,0,0,30,30
1650441988491,MATH 20E,B02,083774,Staff,10,0,30,20
1650441994536,MATH 103A,A01,083777,Staff,0,12,30,30
1650441994536,MATH 103A,A02,083778,Staff,0,12,30,30
1650441994536,MATH 103A,B01,083779,Staff,0,13,30,30
1650441994536,MATH 103A,B02,083780,Staff,0,11,30,30
1650442000561,MATH 105,A01,085443,Staff,0,23,30,30
1650442006586,MATH 109,A01,083213,Anzaldo; Leesa B,0,7,30,30
1650442006586,MATH 109,A02,083214,Anzaldo; Leesa B,0,7,30,30
1650442006586,MATH 109,B01,083215,Anzaldo; Leesa B,0,5,30,30
1650442006586,MATH 109,B02,083216,Anzaldo; Leesa B,0,6,30,30
1650442012612,MATH 142A,A01,083219,Chow; Bennett,0,14,30,30
1650442012612,MATH 142A,A02,083220,Chow; Bennett,0,13,30,30
1650442012612,MATH 142A,B01,083221,Chow; Bennett,0,12,30,30
1650442012612,MATH 142A,B02,083222,Chow; Bennett,0,13,30,30
1650442018639,MATH 193A,A01,083224,Staff,0,5,30,30
1650442018639,MATH 193A,A02,083225,Staff,0,5,30,30
1650442018639,MATH 193A,A03,083781,Staff,0,4,30,30
1650442018639,MATH 193A,A04,083782,Staff,0,5,30,30
1650442024664,MATH 197,001,091859,McAuley; Julian John,9998,0,9999,1
1650442030742,COGS 9,A01,083615,Staff,0,14,60,60
1650442036773,COGS 11,A01,083617,Boyle; Mary E. T.,21,0,40,19
1650442042798,COGS 13,A01,083071,Staff,0,34,40,40
1650442048822,COGS 14A,A01,092681,Staff,1,25,100,99
1650442054850,COGS 14B,A01,083073,Cheng; Tzu-Han,0,11,50,50
1650442060877,COGS 17,A01,092677,Staff,22,0,75,53
1650442066901,COGS 100,A01,083619,Staff,0,26,60,60
1650442072926,COGS 101A,A01,083621,Davis; Joshua Daniel,0,21,60,60
1650442078951,COGS 101B,A01,091572,Staff,0,4,60,60
1650442084984,COGS 101C,A01,083625,Delgado; Tania,16,0,30,14
1650442091009,COGS 107A,A01,083627,Boyle; Mary E. T.,0,11,60,60
1650442097034,COGS 118A,A01,083075,Staff,2,0,60,58
1650442103064,CSE 3,A50,083646,Miranda; Gregory Joseph,20,0,38,18
1650442103064,CSE 3,A51,083647,Miranda; Gregory Joseph,36,0,37,1
1650442109091,CSE 8A,A50,083650,Miranda; Gregory Joseph,0,28,40,40
1650442115119,CSE 11,A01,083080,Cao; Yingjun,0,91,40,40
1650442121143,CSE 12,A01,083652,Staff,0,16,100,100
1650442127168,CSE 15L,A01,083654,Staff,0,1,50,50
1650442127168,CSE 15L,A02,083655,Staff,1,0,50,49
1650442133197,CSE 20,A01,083657,Staff,51,0,80,29
1650442139222,CSE 30,A01,083084,Eldon; John,0,76,40,40
1650442145247,CSE 100,A01,083659,Cao; Yingjun,0,66,50,50
1650442151276,CSE 134B,A01,083661,Powell; Thomas Allan,0,32,65,65
1650442157300,CSE 140,A01,083663,Staff,0,2,75,75
1650442163325,CSE 140L,A01,083088,Eldon; John,0,8,75,75
1650442169352,CSE 175,A01,083665,Kumar; Rakesh,7,0,25,18
1650442175380,CSE 190,A00,092507,Dubnov; Shlomo,14,0,20,6
1650442181408,ECE 45,A01,083139,Staff,0,18,40,40
1650442187431,ECE 65,A50,083695,Staff,0,6,30,30
1650442193456,ECE 109,A01,091882,Touri; Behrouz,38,0,70,32
1650442199491,ECE 180,A00,083140,Abi Samra; Nicholas Camill,23,0,30,7
1650442199491,ECE 180,B00,083141,Abi Samra; Nicholas Camill,0,0,30,30
1650442205520,MATH 10A,A01,083735,Patchell; Gregory David,7,0,30,23
1650442205520,MATH 10A,A02,083736,Patchell; Gregory David,28,0,30,2
1650442205520,MATH 10A,A03,083737,Patchell; Gregory David,25,0,30,5
1650442211550,MATH 10B,A01,083207,Staff,0,7,30,30
1650442211550,MATH 10B,A02,083208,Staff,0,7,30,30
1650442211550,MATH 10B,B01,083739,Staff,13,0,30,17
1650442211550,MATH 10B,B02,083740,Staff,28,0,30,2
1650442217581,MATH 18,A01,083743,Staff,1,0,30,29
1650442217581,MATH 18,A02,083744,Staff,27,0,30,3
1650442217581,MATH 18,A03,083745,Staff,22,0,30,8
1650442217581,MATH 18,A04,083746,Staff,26,0,30,4
1650442217581,MATH 18,B01,083748,Staff,0,11,30,30
1650442217581,MATH 18,B02,083749,Staff,0,12,30,30
1650442217581,MATH 18,B03,083750,Staff,0,11,30,30
1650442217581,MATH 18,B04,083751,Staff,0,12,30,30
1650442223605,MATH 20A,A01,083754,Staff,25,0,40,15
1650442229640,MATH 20B,A01,083756,Staff,0,10,30,30
1650442229640,MATH 20B,A02,083757,Staff,0,10,30,30
1650442235665,MATH 20C,A01,083760,Staff,0,15,30,30
1650442235665,MATH 20C,A02,083761,Staff,1,14,30,29
1650442235665,MATH 20C,B01,083762,Staff,13,0,30,17
1650442235665,MATH 20C,B02,083763,Staff,28,0,30,2
1650442241693,MATH 20D,A01,083765,Staff,0,1,30,30
1650442241693,MATH 20D,A02,083766,Staff,9,0,30,21
1650442241693,MATH 20D,A03,083767,Staff,25,0,30,5
1650442247716,MATH 20E,A01,083771,Staff,5,0,30,25
1650442247716,MATH 20E,A02,083772,Staff,18,0,30,12
1650442247716,MATH 20E,B01,083773,Staff,0,0,30,30
1650442247716,MATH 20E,B02,083774,Staff,10,0,30,20
1650442253741,MATH 103A,A01,083777,Staff,0,12,30,30
1650442253741,MATH 103A,A02,083778,Staff,0,12,30,30
1650442253741,MATH 103A,B01,083779,Staff,0,13,30,30
1650442253741,MATH 103A,B02,083780,Staff,0,11,30,30
1650442259769,MATH 105,A01,085443,Staff,0,23,30,30
1650442265795,MATH 109,A01,083213,Anzaldo; Leesa B,0,7,30,30
1650442265795,MATH 109,A02,083214,Anzaldo; Leesa B,0,7,30,30
1650442265795,MATH 109,B01,083215,Anzaldo; Leesa B,0,5,30,30
1650442265795,MATH 109,B02,083216,Anzaldo; Leesa B,0,6,30,30
1650442271836,MATH 142A,A01,083219,Chow; Bennett,0,14,30,30
1650442271836,MATH 142A,A02,083220,Chow; Bennett,0,13,30,30
1650442271836,MATH 142A,B01,083221,Chow; Bennett,0,12,30,30
1650442271836,MATH 142A,B02,083222,Chow; Bennett,0,13,30,30
1650442277860,MATH 193A,A01,083224,Staff,0,5,30,30
1650442277860,MATH 193A,A02,083225,Staff,0,5,30,30
1650442277860,MATH 193A,A03,083781,Staff,0,4,30,30
1650442277860,MATH 193A,A04,083782,Staff,0,5,30,30
1650442283885,MATH 197,001,091859,McAuley; Julian John,9998,0,9999,1
1650442289956,COGS 9,A01,083615,Staff,0,14,60,60
1650442295981,COGS 11,A01,083617,Boyle; Mary E. T.,21,0,40,19
1650442302022,COGS 13,A01,083071,Staff,0,34,40,40
1650442308049,COGS 14A,A01,092681,Staff,1,25,100,99
1650442314078,COGS 14B,A01,083073,Cheng; Tzu-Han,0,11,50,50
1650442320105,COGS 17,A01,092677,Staff,22,0,75,53
1650442326133,COGS 100,A01,083619,Staff,0,26,60,60
1650442332160,COGS 101A,A01,083621,Davis; Joshua Daniel,0,21,60,60
1650442338186,COGS 101B,A01,091572,Staff,0,4,60,60
1650442344212,COGS 101C,A01,083625,Delgado; Tania,16,0,30,14
1650442350237,COGS 107A,A01,083627,Boyle; Mary E. T.,0,11,60,60
1650442356261,COGS 118A,A01,083075,Staff,2,0,60,58
1650442362287,CSE 3,A50,083646,Miranda; Gregory Joseph,20,0,38,18
1650442362287,CSE 3,A51,083647,Miranda; Gregory Joseph,36,0,37,1
1650442368317,CSE 8A,A50,083650,Miranda; Gregory Joseph,0,28,40,40
1650442374342,CSE 11,A01,083080,Cao; Yingjun,0,91,40,40
1650442380367,CSE 12,A01,083652,Staff,0,16,100,100
1650442386395,CSE 15L,A01,083654,Staff,0,1,50,50
1650442386395,CSE 15L,A02,083655,Staff,1,0,50,49
1650442392418,CSE 20,A01,083657,Staff,51,0,80,29
1650442398441,CSE 30,A01,083084,Eldon; John,0,76,40,40
1650442404465,CSE 100,A01,083659,Cao; Yingjun,0,66,50,50
1650442410487,CSE 134B,A01,083661,Powell; Thomas Allan,0,32,65,65
1650442416510,CSE 140,A01,083663,Staff,0,2,75,75
1650442422534,CSE 140L,A01,083088,Eldon; John,0,8,75,75
1650442428563,CSE 175,A01,083665,Kumar; Rakesh,7,0,25,18
1650442434586,CSE 190,A00,092507,Dubnov; Shlomo,14,0,20,6
1650442440619,ECE 45,A01,083139,Staff,0,18,40,40
1650442446648,ECE 65,A50,083695,Staff,0,6,30,30
1650442452674,ECE 109,A01,091882,Touri; Behrouz,38,0,70,32
1650442458705,ECE 180,A00,083140,Abi Samra; Nicholas Camill,23,0,30,7
1650442458705,ECE 180,B00,083141,Abi Samra; Nicholas Camill,0,0,30,30
1650442464731,MATH 10A,A01,083735,Patchell; Gregory David,7,0,30,23
1650442464731,MATH 10A,A02,083736,Patchell; Gregory David,28,0,30,2
1650442464731,MATH 10A,A03,083737,Patchell; Gregory David,25,0,30,5
1650442470762,MATH 10B,A01,083207,Staff,0,7,30,30
1650442470762,MATH 10B,A02,083208,Staff,0,7,30,30
1650442470762,MATH 10B,B01,083739,Staff,13,0,30,17
1650442470762,MATH 10B,B02,083740,Staff,28,0,30,2
1650442476795,MATH 18,A01,083743,Staff,1,0,30,29
1650442476795,MATH 18,A02,083744,Staff,27,0,30,3
1650442476795,MATH 18,A03,083745,Staff,22,0,30,8
1650442476795,MATH 18,A04,083746,Staff,26,0,30,4
1650442476795,MATH 18,B01,083748,Staff,0,11,30,30
1650442476795,MATH 18,B02,083749,Staff,0,12,30,30
1650442476795,MATH 18,B03,083750,Staff,0,11,30,30
1650442476795,MATH 18,B04,083751,Staff,0,12,30,30
1650442482819,MATH 20A,A01,083754,Staff,25,0,40,15
1650442488850,MATH 20B,A01,083756,Staff,0,10,30,30
1650442488850,MATH 20B,A02,083757,Staff,0,10,30,30
1650442494878,MATH 20C,A01,083760,Staff,0,15,30,30
1650442494878,MATH 20C,A02,083761,Staff,1,14,30,29
1650442494878,MATH 20C,B01,083762,Staff,13,0,30,17
1650442494878,MATH 20C,B02,083763,Staff,28,0,30,2
1650442500906,MATH 20D,A01,083765,Staff,0,1,30,30
1650442500906,MATH 20D,A02,083766,Staff,9,0,30,21
1650442500906,MATH 20D,A03,083767,Staff,25,0,30,5
1650442506931,MATH 20E,A01,083771,Staff,5,0,30,25
1650442506931,MATH 20E,A02,083772,Staff,18,0,30,12
1650442506931,MATH 20E,B01,083773,Staff,0,0,30,30
1650442506931,MATH 20E,B02,083774,Staff,10,0,30,20
1650442512966,MATH 103A,A01,083777,Staff,0,12,30,30
1650442512966,MATH 103A,A02,083778,Staff,0,12,30,30
1650442512966,MATH 103A,B01,083779,Staff,0,13,30,30
1650442512966,MATH 103A,B02,083780,Staff,0,11,30,30
1650442518991,MATH 105,A01,085443,Staff,0,23,30,30
1650442525020,MATH 109,A01,083213,Anzaldo; Leesa B,0,7,30,30
1650442525020,MATH 109,A02,083214,Anzaldo; Leesa B,0,7,30,30
1650442525020,MATH 109,B01,083215,Anzaldo; Leesa B,0,5,30,30
1650442525020,MATH 109,B02,083216,Anzaldo; Leesa B,0,6,30,30
1650442531045,MATH 142A,A01,083219,Chow; Bennett,0,14,30,30
1650442531045,MATH 142A,A02,083220,Chow; Bennett,0,13,30,30
1650442531045,MATH 142A,B01,083221,Chow; Bennett,0,12,30,30
1650442531045,MATH 142A,B02,083222,Chow; Bennett,0,13,30,30
1650442537069,MATH 193A,A01,083224,Staff,0,5,30,30
1650442537069,MATH 193A,A02,083225,Staff,0,5,30,30
1650442537069,MATH 193A,A03,083781,Staff,0,4,30,30
1650442537069,MATH 193A,A04,083782,Staff,0,5,30,30
1650442543103,MATH 197,001,091859,McAuley; Julian John,9998,0,9999,1
1650442549172,COGS 9,A01,083615,Staff,0,14,60,60
1650442555196,COGS 11,A01,083617,Boyle; Mary E. T.,21,0,40,19
1650442561224,COGS 13,A01,083071,Staff,0,34,40,40
1650442567248,COGS 14A,A01,092681,Staff,1,25,100,99
1650442573277,COGS 14B,A01,083073,Cheng; Tzu-Han,0,11,50,50
1650442579395,COGS 17,A01,092677,Staff,22,0,75,53
1650442585422,COGS 100,A01,083619,Staff,0,26,60,60
1650442591446,COGS 101A,A01,083621,Davis; Joshua Daniel,0,21,60,60
1650442597473,COGS 101B,A01,091572,Staff,0,4,60,60
1650442603501,COGS 101C,A01,083625,Delgado; Tania,16,0,30,14
1650442609525,COGS 107A,A01,083627,Boyle; Mary E. T.,0,11,60,60
1650442615553,COGS 118A,A01,083075,Staff,2,0,60,58
1650442621585,CSE 3,A50,083646,Miranda; Gregory Joseph,20,0,38,18
1650442621585,CSE 3,A51,083647,Miranda; Gregory Joseph,36,0,37,1
1650442627608,CSE 8A,A50,083650,Miranda; Gregory Joseph,0,28,40,40
1650442633635,CSE 11,A01,083080,Cao; Yingjun,0,92,40,40
1650442639659,CSE 12,A01,083652,Staff,0,16,100,100
1650442645686,CSE 15L,A01,083654,Staff,0,1,50,50
1650442645686,CSE 15L,A02,083655,Staff,1,0,50,49
1650442651714,CSE 20,A01,083657,Staff,51,0,80,29
1650442657738,CSE 30,A01,083084,Eldon; John,0,76,40,40
1650442663764,CSE 100,A01,083659,Cao; Yingjun,0,66,50,50
1650442669791,CSE 134B,A01,083661,Powell; Thomas Allan,0,32,65,65
1650442675821,CSE 140,A01,083663,Staff,0,2,75,75
1650442681844,CSE 140L,A01,083088,Eldon; John,0,8,75,75
1650442687867,CSE 175,A01,083665,Kumar; Rakesh,7,0,25,18
1650442693890,CSE 190,A00,092507,Dubnov; Shlomo,14,0,20,6
1650442699914,ECE 45,A01,083139,Staff,0,18,40,40
1650442705937,ECE 65,A50,083695,Staff,0,6,30,30
1650442711969,ECE 109,A01,091882,Touri; Behrouz,38,0,70,32
1650442717994,ECE 180,A00,083140,Abi Samra; Nicholas Camill,23,0,30,7
1650442717994,ECE 180,B00,083141,Abi Samra; Nicholas Camill,0,0,30,30
1650442724020,MATH 10A,A01,083735,Patchell; Gregory David,7,0,30,23
1650442724020,MATH 10A,A02,083736,Patchell; Gregory David,28,0,30,2
1650442724020,MATH 10A,A03,083737,Patchell; Gregory David,25,0,30,5
1650442730049,MATH 10B,A01,083207,Staff,0,7,30,30
1650442730049,MATH 10B,A02,083208,Staff,0,7,30,30
1650442730049,MATH 10B,B01,083739,Staff,13,0,30,17
1650442730049,MATH 10B,B02,083740,Staff,28,0,30,2
1650442736080,MATH 18,A01,083743,Staff,1,0,30,29
1650442736080,MATH 18,A02,083744,Staff,27,0,30,3
1650442736080,MATH 18,A03,083745,Staff,22,0,30,8
1650442736080,MATH 18,A04,083746,Staff,26,0,30,4
1650442736080,MATH 18,B01,083748,Staff,0,11,30,30
1650442736080,MATH 18,B02,083749,Staff,0,12,30,30
1650442736080,MATH 18,B03,083750,Staff,0,11,30,30
1650442736080,MATH 18,B04,083751,Staff,0,12,30,30
1650442742106,MATH 20A,A01,083754,Staff,25,0,40,15
1650442748133,MATH 20B,A01,083756,Staff,0,10,30,30
1650442748133,MATH 20B,A02,083757,Staff,0,10,30,30
1650442754158,MATH 20C,A01,083760,Staff,0,15,30,30
1650442754158,MATH 20C,A02,083761,Staff,1,14,30,29
1650442754158,MATH 20C,B01,083762,Staff,13,0,30,17
1650442754158,MATH 20C,B02,083763,Staff,28,0,30,2
1650442760182,MATH 20D,A01,083765,Staff,0,1,30,30
1650442760182,MATH 20D,A02,083766,Staff,9,0,30,21
1650442760182,MATH 20D,A03,083767,Staff,25,0,30,5
1650442766210,MATH 20E,A01,083771,Staff,5,0,30,25
1650442766210,MATH 20E,A02,083772,Staff,18,0,30,12
1650442766210,MATH 20E,B01,083773,Staff,0,0,30,30
1650442766210,MATH 20E,B02,083774,Staff,10,0,30,20
1650442772234,MATH 103A,A01,083777,Staff,0,12,30,30
1650442772234,MATH 103A,A02,083778,Staff,0,12,30,30
1650442772234,MATH 103A,B01,083779,Staff,0,13,30,30
1650442772234,MATH 103A,B02,083780,Staff,0,11,30,30
1650442778258,MATH 105,A01,085443,Staff,0,23,30,30
1650442784283,MATH 109,A01,083213,Anzaldo; Leesa B,0,7,30,30
1650442784283,MATH 109,A02,083214,Anzaldo; Leesa B,0,7,30,30
1650442784283,MATH 109,B01,083215,Anzaldo; Leesa B,0,5,30,30
1650442784283,MATH 109,B02,083216,Anzaldo; Leesa B,0,6,30,30
1650442790313,MATH 142A,A01,083219,Chow; Bennett,0,14,30,30
1650442790313,MATH 142A,A02,083220,Chow; Bennett,0,13,30,30
1650442790313,MATH 142A,B01,083221,Chow; Bennett,0,12,30,30
1650442790313,MATH 142A,B02,083222,Chow; Bennett,0,13,30,30
1650442796342,MATH 193A,A01,083224,Staff,0,5,30,30
1650442796342,MATH 193A,A02,083225,Staff,0,5,30,30
1650442796342,MATH 193A,A03,083781,Staff,0,4,30,30
1650442796342,MATH 193A,A04,083782,Staff,0,5,30,30
1650442802369,MATH 197,001,091859,McAuley; Julian John,9998,0,9999,1
1650442808429,COGS 9,A01,083615,Staff,0,14,60,60
1650442814469,COGS 11,A01,083617,Boyle; Mary E. T.,21,0,40,19
1650442820493,COGS 13,A01,083071,Staff,0,34,40,40
1650442826520,COGS 14A,A01,092681,Staff,1,25,100,99
1650442832546,COGS 14B,A01,083073,Cheng; Tzu-Han,0,11,50,50
1650442838570,COGS 17,A01,092677,Staff,22,0,75,53
1650442844594,COGS 100,A01,083619,Staff,0,26,60,60
1650442850618,COGS 101A,A01,083621,Davis; Joshua Daniel,0,21,60,60
1650442856642,COGS 101B,A01,091572,Staff,0,4,60,60
1650442862666,COGS 101C,A01,083625,Delgado; Tania,16,0,30,14
1650442868693,COGS 107A,A01,083627,Boyle; Mary E. T.,0,11,60,60
1650442874718,COGS 118A,A01,083075,Staff,2,0,60,58
1650442880745,CSE 3,A50,083646,Miranda; Gregory Joseph,20,0,38,18
1650442880745,CSE 3,A51,083647,Miranda; Gregory Joseph,36,0,37,1
1650442886774,CSE 8A,A50,083650,Miranda; Gregory Joseph,0,28,40,40
1650442892798,CSE 11,A01,083080,Cao; Yingjun,0,92,40,40
1650442898823,CSE 12,A01,083652,Staff,0,16,100,100
1650442904848,CSE 15L,A01,083654,Staff,0,1,50,50
1650442904848,CSE 15L,A02,083655,Staff,1,0,50,49
1650442910875,CSE 20,A01,083657,Staff,51,0,80,29
1650442916898,CSE 30,A01,083084,Eldon; John,0,76,40,40
1650442922925,CSE 100,A01,083659,Cao; Yingjun,0,66,50,50
1650442928952,CSE 134B,A01,083661,Powell; Thomas Allan,0,32,65,65
1650442934978,CSE 140,A01,083663,Staff,0,2,75,75
1650442941002,CSE 140L,A01,083088,Eldon; John,0,8,75,75
1650442947025,CSE 175,A01,083665,Kumar; Rakesh,7,0,25,18
1650442953053,CSE 190,A00,092507,Dubnov; Shlomo,14,0,20,6
1650442959096,ECE 45,A01,083139,Staff,0,18,40,40
1650442965123,ECE 65,A50,083695,Staff,0,6,30,30
1650442971150,ECE 109,A01,091882,Touri; Behrouz,38,0,70,32
1650442977175,ECE 180,A00,083140,Abi Samra; Nicholas Camill,23,0,30,7
1650442977175,ECE 180,B00,083141,Abi Samra; Nicholas Camill,0,0,30,30
1650442983206,MATH 10A,A01,083735,Patchell; Gregory David,7,0,30,23
1650442983206,MATH 10A,A02,083736,Patchell; Gregory David,28,0,30,2
1650442983206,MATH 10A,A03,083737,Patchell; Gregory David,25,0,30,5
1650442989232,MATH 10B,A01,083207,Staff,0,7,30,30
1650442989232,MATH 10B,A02,083208,Staff,0,7,30,30
1650442989232,MATH 10B,B01,083739,Staff,13,0,30,17
1650442989232,MATH 10B,B02,083740,Staff,28,0,30,2
1650442995258,MATH 18,A01,083743,Staff,1,0,30,29
1650442995258,MATH 18,A02,083744,Staff,27,0,30,3
1650442995258,MATH 18,A03,083745,Staff,22,0,30,8
1650442995258,MATH 18,A04,083746,Staff,26,0,30,4
1650442995258,MATH 18,B01,083748,Staff,0,11,30,30
1650442995258,MATH 18,B02,083749,Staff,0,12,30,30
1650442995258,MATH 18,B03,083750,Staff,0,11,30,30
1650442995258,MATH 18,B04,083751,Staff,0,12,30,30
1650443001290,MATH 20A,A01,083754,Staff,25,0,40,15
1650443007316,MATH 20B,A01,083756,Staff,0,10,30,30
1650443007316,MATH 20B,A02,083757,Staff,0,10,30,30
1650443013339,MATH 20C,A01,083760,Staff,0,15,30,30
1650443013339,MATH 20C,A02,083761,Staff,1,14,30,29
1650443013339,MATH 20C,B01,083762,Staff,13,0,30,17
1650443013339,MATH 20C,B02,083763,Staff,28,0,30,2
1650443019363,MATH 20D,A01,083765,Staff,0,1,30,30
1650443019363,MATH 20D,A02,083766,Staff,9,0,30,21
1650443019363,MATH 20D,A03,083767,Staff,25,0,30,5
1650443025391,MATH 20E,A01,083771,Staff,5,0,30,25
1650443025391,MATH 20E,A02,083772,Staff,18,0,30,12
1650443025391,MATH 20E,B01,083773,Staff,0,0,30,30
1650443025391,MATH 20E,B02,083774,Staff,10,0,30,20
1650443031421,MATH 103A,A01,083777,Staff,0,12,30,30
1650443031421,MATH 103A,A02,083778,Staff,0,12,30,30
1650443031421,MATH 103A,B01,083779,Staff,0,13,30,30
1650443031421,MATH 103A,B02,083780,Staff,0,11,30,30
1650443037446,MATH 105,A01,085443,Staff,0,23,30,30
1650443043474,MATH 109,A01,083213,Anzaldo; Leesa B,0,7,30,30
1650443043474,MATH 109,A02,083214,Anzaldo; Leesa B,0,7,30,30
1650443043474,MATH 109,B01,083215,Anzaldo; Leesa B,0,5,30,30
1650443043474,MATH 109,B02,083216,Anzaldo; Leesa B,0,6,30,30
1650443049502,MATH 142A,A01,083219,Chow; Bennett,0,14,30,30
1650443049502,MATH 142A,A02,083220,Chow; Bennett,0,13,30,30
1650443049502,MATH 142A,B01,083221,Chow; Bennett,0,12,30,30
1650443049502,MATH 142A,B02,083222,Chow; Bennett,0,13,30,30
1650443055529,MATH 193A,A01,083224,Staff,0,5,30,30
1650443055529,MATH 193A,A02,083225,Staff,0,5,30,30
1650443055529,MATH 193A,A03,083781,Staff,0,4,30,30
1650443055529,MATH 193A,A04,083782,Staff,0,5,30,30
1650443061557,MATH 197,001,091859,McAuley; Julian John,9998,0,9999,1
1650443067612,COGS 9,A01,083615,Staff,0,14,60,60
1650443073649,COGS 11,A01,083617,Boyle; Mary E. T.,21,0,40,19
1650443079674,COGS 13,A01,083071,Staff,0,34,40,40
1650443085704,COGS 14A,A01,092681,Staff,1,25,100,99
1650443091729,COGS 14B,A01,083073,Cheng; Tzu-Han,0,11,50,50
1650443097752,COGS 17,A01,092677,Staff,22,0,75,53
1650443103774,COGS 100,A01,083619,Staff,0,26,60,60
1650443109797,COGS 101A,A01,083621,Davis; Joshua Daniel,0,21,60,60
1650443115824,COGS 101B,A01,091572,Staff,0,4,60,60
1650443121847,COGS 101C,A01,083625,Delgado; Tania,16,0,30,14
1650443127872,COGS 107A,A01,083627,Boyle; Mary E. T.,0,11,60,60
1650443133899,COGS 118A,A01,083075,Staff,2,0,60,58
1650443139925,CSE 3,A50,083646,Miranda; Gregory Joseph,20,0,38,18
1650443139925,CSE 3,A51,083647,Miranda; Gregory Joseph,36,0,37,1
1650443145949,CSE 8A,A50,083650,Miranda; Gregory Joseph,0,28,40,40
1650443151977,CSE 11,A01,083080,Cao; Yingjun,0,92,40,40
1650443158004,CSE 12,A01,083652,Staff,0,16,100,100
1650443164028,CSE 15L,A01,083654,Staff,0,1,50,50
1650443164028,CSE 15L,A02,083655,Staff,1,0,50,49
1650443170060,CSE 20,A01,083657,Staff,51,0,80,29
1650443176172,CSE 30,A01,083084,Eldon; John,0,76,40,40
1650443182196,CSE 100,A01,083659,Cao; Yingjun,0,66,50,50
1650443188220,CSE 134B,A01,083661,Powell; Thomas Allan,0,32,65,65
1650443194251,CSE 140,A01,083663,Staff,0,2,75,75
1650443200275,CSE 140L,A01,083088,Eldon; John,0,8,75,75
1650443206302,CSE 175,A01,083665,Kumar; Rakesh,7,0,25,18
1650443212328,CSE 190,A00,092507,Dubnov; Shlomo,14,0,20,6
1650443218352,ECE 45,A01,083139,Staff,0,18,40,40
1650443224378,ECE 65,A50,083695,Staff,0,6,30,30
1650443230402,ECE 109,A01,091882,Touri; Behrouz,38,0,70,32
1650443236430,ECE 180,A00,083140,Abi Samra; Nicholas Camill,23,0,30,7
1650443236430,ECE 180,B00,083141,Abi Samra; Nicholas Camill,0,0,30,30
1650443242459,MATH 10A,A01,083735,Patchell; Gregory David,7,0,30,23
1650443242459,MATH 10A,A02,083736,Patchell; Gregory David,28,0,30,2
1650443242459,MATH 10A,A03,083737,Patchell; Gregory David,25,0,30,5
1650443248492,MATH 10B,A01,083207,Staff,0,7,30,30
1650443248492,MATH 10B,A02,083208,Staff,0,7,30,30
1650443248492,MATH 10B,B01,083739,Staff,13,0,30,17
1650443248492,MATH 10B,B02,083740,Staff,28,0,30,2
1650443254516,MATH 18,A01,083743,Staff,1,0,30,29
1650443254516,MATH 18,A02,083744,Staff,27,0,30,3
1650443254516,MATH 18,A03,083745,Staff,22,0,30,8
1650443254516,MATH 18,A04,083746,Staff,26,0,30,4
1650443254516,MATH 18,B01,083748,Staff,0,11,30,30
1650443254516,MATH 18,B02,083749,Staff,0,12,30,30
1650443254516,MATH 18,B03,083750,Staff,0,11,30,30
1650443254516,MATH 18,B04,083751,Staff,0,12,30,30
1650443260543,MATH 20A,A01,083754,Staff,25,0,40,15
1650443266569,MATH 20B,A01,083756,Staff,0,10,30,30
1650443266569,MATH 20B,A02,083757,Staff,0,10,30,30
1650443272597,MATH 20C,A01,083760,Staff,0,15,30,30
1650443272597,MATH 20C,A02,083761,Staff,1,14,30,29
1650443272597,MATH 20C,B01,083762,Staff,13,0,30,17
1650443272597,MATH 20C,B02,083763,Staff,28,0,30,2
1650443278620,MATH 20D,A01,083765,Staff,0,1,30,30
1650443278620,MATH 20D,A02,083766,Staff,9,0,30,21
1650443278620,MATH 20D,A03,083767,Staff,25,0,30,5
1650443284648,MATH 20E,A01,083771,Staff,5,0,30,25
1650443284648,MATH 20E,A02,083772,Staff,18,0,30,12
1650443284648,MATH 20E,B01,083773,Staff,0,0,30,30
1650443284648,MATH 20E,B02,083774,Staff,10,0,30,20
1650443290672,MATH 103A,A01,083777,Staff,0,12,30,30
1650443290672,MATH 103A,A02,083778,Staff,0,12,30,30
1650443290672,MATH 103A,B01,083779,Staff,0,13,30,30
1650443290672,MATH 103A,B02,083780,Staff,0,12,30,30
1650443296697,MATH 105,A01,085443,Staff,0,23,30,30
1650443302720,MATH 109,A01,083213,Anzaldo; Leesa B,0,7,30,30
1650443302720,MATH 109,A02,083214,Anzaldo; Leesa B,0,7,30,30
1650443302720,MATH 109,B01,083215,Anzaldo; Leesa B,0,5,30,30
1650443302720,MATH 109,B02,083216,Anzaldo; Leesa B,0,6,30,30
1650443308750,MATH 142A,A01,083219,Chow; Bennett,0,14,30,30
1650443308750,MATH 142A,A02,083220,Chow; Bennett,0,13,30,30
1650443308750,MATH 142A,B01,083221,Chow; Bennett,0,12,30,30
1650443308750,MATH 142A,B02,083222,Chow; Bennett,0,13,30,30
1650443314774,MATH 193A,A01,083224,Staff,0,5,30,30
1650443314774,MATH 193A,A02,083225,Staff,0,5,30,30
1650443314774,MATH 193A,A03,083781,Staff,0,4,30,30
1650443314774,MATH 193A,A04,083782,Staff,0,5,30,30
1650443320797,MATH 197,001,091859,McAuley; Julian John,9998,0,9999,1
1650443326865,COGS 9,A01,083615,Staff,0,14,60,60
1650443332888,COGS 11,A01,083617,Boyle; Mary E. T.,21,0,40,19
1650443338911,COGS 13,A01,083071,Staff,0,34,40,40
1650443344939,COGS 14A,A01,092681,Staff,1,25,100,99
1650443350965,COGS 14B,A01,083073,Cheng; Tzu-Han,0,11,50,50
1650443356990,COGS 17,A01,092677,Staff,22,0,75,53
1650443363018,COGS 100,A01,083619,Staff,0,26,60,60
1650443369045,COGS 101A,A01,083621,Davis; Joshua Daniel,0,21,60,60
1650443375069,COGS 101B,A01,091572,Staff,0,4,60,60
1650443381097,COGS 101C,A01,083625,Delgado; Tania,16,0,30,14
1650443387123,COGS 107A,A01,083627,Boyle; Mary E. T.,0,11,60,60
1650443393147,COGS 118A,A01,083075,Staff,2,0,60,58
1650443399246,CSE 3,A50,083646,Miranda; Gregory Joseph,20,0,38,18
1650443399246,CSE 3,A51,083647,Miranda; Gregory Joseph,36,0,37,1
1650443405270,CSE 8A,A50,083650,Miranda; Gregory Joseph,0,28,40,40
1650443411298,CSE 11,A01,083080,Cao; Yingjun,0,92,40,40
1650443417322,CSE 12,A01,083652,Staff,0,16,100,100
1650443423349,CSE 15L,A01,083654,Staff,0,1,50,50
1650443423349,CSE 15L,A02,083655,Staff,1,0,50,49
1650443429380,CSE 20,A01,083657,Staff,51,0,80,29
1650443435404,CSE 30,A01,083084,Eldon; John,0,76,40,40
1650443441428,CSE 100,A01,083659,Cao; Yingjun,0,66,50,50
1650443447457,CSE 134B,A01,083661,Powell; Thomas Allan,0,32,65,65
1650443453483,CSE 140,A01,083663,Staff,0,2,75,75
1650443459506,CSE 140L,A01,083088,Eldon; John,0,8,75,75
1650443465530,CSE 175,A01,083665,Kumar; Rakesh,7,0,25,18
1650443471559,CSE 190,A00,092507,Dubnov; Shlomo,14,0,20,6
1650443477582,ECE 45,A01,083139,Staff,0,18,40,40
1650443483610,ECE 65,A50,083695,Staff,0,6,30,30
1650443489635,ECE 109,A01,091882,Touri; Behrouz,38,0,70,32
1650443495659,ECE 180,A00,083140,Abi Samra; Nicholas Camill,23,0,30,7
1650443495659,ECE 180,B00,083141,Abi Samra; Nicholas Camill,0,0,30,30
1650443501684,MATH 10A,A01,083735,Patchell; Gregory David,7,0,30,23
1650443501684,MATH 10A,A02,083736,Patchell; Gregory David,28,0,30,2
1650443501684,MATH 10A,A03,083737,Patchell; Gregory David,25,0,30,5
1650443507722,MATH 10B,A01,083207,Staff,0,7,30,30
1650443507722,MATH 10B,A02,083208,Staff,0,7,30,30
1650443507722,MATH 10B,B01,083739,Staff,13,0,30,17
1650443507722,MATH 10B,B02,083740,Staff,28,0,30,2
1650443513752,MATH 18,A01,083743,Staff,1,0,30,29
1650443513752,MATH 18,A02,083744,Staff,27,0,30,3
1650443513752,MATH 18,A03,083745,Staff,22,0,30,8
1650443513752,MATH 18,A04,083746,Staff,26,0,30,4
1650443513752,MATH 18,B01,083748,Staff,0,11,30,30
1650443513752,MATH 18,B02,083749,Staff,0,12,30,30
1650443513752,MATH 18,B03,083750,Staff,0,11,30,30
1650443513752,MATH 18,B04,083751,Staff,0,12,30,30
1650443519774,MATH 20A,A01,083754,Staff,25,0,40,15
1650443525801,MATH 20B,A01,083756,Staff,0,10,30,30
1650443525801,MATH 20B,A02,083757,Staff,0,10,30,30
1650443531832,MATH 20C,A01,083760,Staff,0,15,30,30
1650443531832,MATH 20C,A02,083761,Staff,1,14,30,29
1650443531832,MATH 20C,B01,083762,Staff,13,0,30,17
1650443531832,MATH 20C,B02,083763,Staff,28,0,30,2
1650443537858,MATH 20D,A01,083765,Staff,0,1,30,30
1650443537858,MATH 20D,A02,083766,Staff,9,0,30,21
1650443537858,MATH 20D,A03,083767,Staff,25,0,30,5
1650443543884,MATH 20E,A01,083771,Staff,5,0,30,25
1650443543884,MATH 20E,A02,083772,Staff,18,0,30,12
1650443543884,MATH 20E,B01,083773,Staff,0,0,30,30
1650443543884,MATH 20E,B02,083774,Staff,10,0,30,20
1650443549912,MATH 103A,A01,083777,Staff,0,12,30,30
1650443549912,MATH 103A,A02,083778,Staff,0,12,30,30
1650443549912,MATH 103A,B01,083779,Staff,0,13,30,30
1650443549912,MATH 103A,B02,083780,Staff,0,12,30,30
1650443555935,MATH 105,A01,085443,Staff,0,23,30,30
1650443561958,MATH 109,A01,083213,Anzaldo; Leesa B,0,7,30,30
1650443561958,MATH 109,A02,083214,Anzaldo; Leesa B,0,7,30,30
1650443561958,MATH 109,B01,083215,Anzaldo; Leesa B,0,5,30,30
1650443561958,MATH 109,B02,083216,Anzaldo; Leesa B,0,6,30,30
1650443567989,MATH 142A,A01,083219,Chow; Bennett,0,14,30,30
1650443567989,MATH 142A,A02,083220,Chow; Bennett,0,13,30,30
1650443567989,MATH 142A,B01,083221,Chow; Bennett,0,12,30,30
1650443567989,MATH 142A,B02,083222,Chow; Bennett,0,13,30,30
1650443574012,MATH 193A,A01,083224,Staff,0,5,30,30
1650443574012,MATH 193A,A02,083225,Staff,0,5,30,30
1650443574012,MATH 193A,A03,083781,Staff,0,4,30,30
1650443574012,MATH 193A,A04,083782,Staff,0,5,30,30
1650443580038,MATH 197,001,091859,McAuley; Julian John,9998,0,9999,1
1650443586108,COGS 9,A01,083615,Staff,0,14,60,60
1650443592135,COGS 11,A01,083617,Boyle; Mary E. T.,21,0,40,19
1650443598174,COGS 13,A01,083071,Staff,0,34,40,40
1650443611186,COGS 14A,A01,092681,Staff,1,25,100,99
1650443617212,COGS 14B,A01,083073,Cheng; Tzu-Han,0,11,50,50
1650443623236,COGS 17,A01,092677,Staff,22,0,75,53
1650443629263,COGS 100,A01,083619,Staff,0,26,60,60
1650443635291,COGS 101A,A01,083621,Davis; Joshua Daniel,0,21,60,60
1650443641315,COGS 101B,A01,091572,Staff,0,4,60,60
1650443647344,COGS 101C,A01,083625,Delgado; Tania,16,0,30,14
1650443653373,COGS 107A,A01,083627,Boyle; Mary E. T.,0,11,60,60
1650443659400,COGS 118A,A01,083075,Staff,2,0,60,58
1650443665422,CSE 3,A50,083646,Miranda; Gregory Joseph,20,0,38,18
1650443665422,CSE 3,A51,083647,Miranda; Gregory Joseph,36,0,37,1
1650443671452,CSE 8A,A50,083650,Miranda; Gregory Joseph,0,28,40,40
1650443677476,CSE 11,A01,083080,Cao; Yingjun,0,92,40,40
1650443683503,CSE 12,A01,083652,Staff,0,16,100,100
1650443689530,CSE 15L,A01,083654,Staff,0,1,50,50
1650443689530,CSE 15L,A02,083655,Staff,1,0,50,49
1650443695557,CSE 20,A01,083657,Staff,51,0,80,29
1650443701584,CSE 30,A01,083084,Eldon; John,0,76,40,40
1650443707607,CSE 100,A01,083659,Cao; Yingjun,0,66,50,50
1650443713639,CSE 134B,A01,083661,Powell; Thomas Allan,0,32,65,65
1650443719664,CSE 140,A01,083663,Staff,0,2,75,75
1650443725687,CSE 140L,A01,083088,Eldon; John,0,8,75,75
1650443731711,CSE 175,A01,083665,Kumar; Rakesh,7,0,25,18
1650443737759,CSE 190,A00,092507,Dubnov; Shlomo,14,0,20,6
1650443743791,ECE 45,A01,083139,Staff,0,18,40,40
1650443749813,ECE 65,A50,083695,Staff,0,6,30,30
1650443755842,ECE 109,A01,091882,Touri; Behrouz,38,0,70,32
1650443761867,ECE 180,A00,083140,Abi Samra; Nicholas Camill,23,0,30,7
1650443761867,ECE 180,B00,083141,Abi Samra; Nicholas Camill,0,0,30,30
1650443767929,MATH 10A,A01,083735,Patchell; Gregory David,7,0,30,23
1650443767929,MATH 10A,A02,083736,Patchell; Gregory David,28,0,30,2
1650443767929,MATH 10A,A03,083737,Patchell; Gregory David,25,0,30,5
1650443773955,MATH 10B,A01,083207,Staff,0,7,30,30
1650443773955,MATH 10B,A02,083208,Staff,0,7,30,30
1650443773955,MATH 10B,B01,083739,Staff,13,0,30,17
1650443773955,MATH 10B,B02,083740,Staff,28,0,30,2
1650443780074,MATH 18,A01,083743,Staff,1,0,30,29
1650443780074,MATH 18,A02,083744,Staff,27,0,30,3
1650443780074,MATH 18,A03,083745,Staff,22,0,30,8
1650443780074,MATH 18,A04,083746,Staff,26,0,30,4
1650443780074,MATH 18,B01,083748,Staff,0,11,30,30
1650443780074,MATH 18,B02,083749,Staff,0,12,30,30
1650443780074,MATH 18,B03,083750,Staff,0,11,30,30
1650443780074,MATH 18,B04,083751,Staff,0,12,30,30
1650443786101,MATH 20A,A01,083754,Staff,25,0,40,15
1650443792124,MATH 20B,A01,083756,Staff,0,10,30,30
1650443792124,MATH 20B,A02,083757,Staff,0,10,30,30
1650443798147,MATH 20C,A01,083760,Staff,0,15,30,30
1650443798147,MATH 20C,A02,083761,Staff,1,14,30,29
1650443798147,MATH 20C,B01,083762,Staff,13,0,30,17
1650443798147,MATH 20C,B02,083763,Staff,28,0,30,2
1650443804174,MATH 20D,A01,083765,Staff,0,1,30,30
1650443804174,MATH 20D,A02,083766,Staff,9,0,30,21
1650443804174,MATH 20D,A03,083767,Staff,25,0,30,5
1650443810213,MATH 20E,A01,083771,Staff,5,0,30,25
1650443810213,MATH 20E,A02,083772,Staff,18,0,30,12
1650443810213,MATH 20E,B01,083773,Staff,0,0,30,30
1650443810213,MATH 20E,B02,083774,Staff,10,0,30,20
1650443816238,MATH 103A,A01,083777,Staff,0,12,30,30
1650443816238,MATH 103A,A02,083778,Staff,0,12,30,30
1650443816238,MATH 103A,B01,083779,Staff,0,13,30,30
1650443816238,MATH 103A,B02,083780,Staff,0,12,30,30
1650443822274,MATH 105,A01,085443,Staff,0,23,30,30
1650443828299,MATH 109,A01,083213,Anzaldo; Leesa B,0,7,30,30
1650443828299,MATH 109,A02,083214,Anzaldo; Leesa B,0,7,30,30
1650443828299,MATH 109,B01,083215,Anzaldo; Leesa B,0,5,30,30
1650443828299,MATH 109,B02,083216,Anzaldo; Leesa B,0,6,30,30
1650443834323,MATH 142A,A01,083219,Chow; Bennett,0,14,30,30
1650443834323,MATH 142A,A02,083220,Chow; Bennett,0,13,30,30
1650443834323,MATH 142A,B01,083221,Chow; Bennett,0,12,30,30
1650443834323,MATH 142A,B02,083222,Chow; Bennett,0,13,30,30
1650443840351,MATH 193A,A01,083224,Staff,0,5,30,30
1650443840351,MATH 193A,A02,083225,Staff,0,5,30,30
1650443840351,MATH 193A,A03,083781,Staff,0,4,30,30
1650443840351,MATH 193A,A04,083782,Staff,0,5,30,30
1650443846378,MATH 197,001,091859,McAuley; Julian John,9998,0,9999,1
1650443852443,COGS 9,A01,083615,Staff,0,14,60,60
1650443858468,COGS 11,A01,083617,Boyle; Mary E. T.,21,0,40,19
1650443864493,COGS 13,A01,083071,Staff,0,34,40,40
1650443870515,COGS 14A,A01,092681,Staff,1,25,100,99
1650443876543,COGS 14B,A01,083073,Cheng; Tzu-Han,0,11,50,50
1650443882567,COGS 17,A01,092677,Staff,22,0,75,53
1650443888590,COGS 100,A01,083619,Staff,0,26,60,60
1650443894614,COGS 101A,A01,083621,Davis; Joshua Daniel,0,21,60,60
1650443900638,COGS 101B,A01,091572,Staff,0,4,60,60
1650443906666,COGS 101C,A01,083625,Delgado; Tania,16,0,30,14
1650443912692,COGS 107A,A01,083627,Boyle; Mary E. T.,0,11,60,60
1650443918720,COGS 118A,A01,083075,Staff,2,0,60,58
1650443924745,CSE 3,A50,083646,Miranda; Gregory Joseph,20,0,38,18
1650443924745,CSE 3,A51,083647,Miranda; Gregory Joseph,36,0,37,1
1650443930774,CSE 8A,A50,083650,Miranda; Gregory Joseph,0,28,40,40
1650443936798,CSE 11,A01,083080,Cao; Yingjun,0,92,40,40
1650443942831,CSE 12,A01,083652,Staff,0,16,100,100
1650443948855,CSE 15L,A01,083654,Staff,0,1,50,50
1650443948855,CSE 15L,A02,083655,Staff,1,0,50,49
1650443954883,CSE 20,A01,083657,Staff,51,0,80,29
1650443960913,CSE 30,A01,083084,Eldon; John,0,76,40,40
1650443966940,CSE 100,A01,083659,Cao; Yingjun,0,66,50,50
1650443972965,CSE 134B,A01,083661,Powell; Thomas Allan,0,32,65,65
1650443978993,CSE 140,A01,083663,Staff,0,2,75,75
1650443985017,CSE 140L,A01,083088,Eldon; John,0,8,75,75
1650443991042,CSE 175,A01,083665,Kumar; Rakesh,7,0,25,18
1650443997072,CSE 190,A00,092507,Dubnov; Shlomo,14,0,20,6
1650444003101,ECE 45,A01,083139,Staff,0,18,40,40
1650444009126,ECE 65,A50,083695,Staff,0,6,30,30
1650444015150,ECE 109,A01,091882,Touri; Behrouz,38,0,70,32
1650444021177,ECE 180,A00,083140,Abi Samra; Nicholas Camill,23,0,30,7
1650444021177,ECE 180,B00,083141,Abi Samra; Nicholas Camill,0,0,30,30
1650444027212,MATH 10A,A01,083735,Patchell; Gregory David,7,0,30,23
1650444027212,MATH 10A,A02,083736,Patchell; Gregory David,28,0,30,2
1650444027212,MATH 10A,A03,083737,Patchell; Gregory David,25,0,30,5
1650444033236,MATH 10B,A01,083207,Staff,0,7,30,30
1650444033236,MATH 10B,A02,083208,Staff,0,7,30,30
1650444033236,MATH 10B,B01,083739,Staff,13,0,30,17
1650444033236,MATH 10B,B02,083740,Staff,28,0,30,2
1650444039263,MATH 18,A01,083743,Staff,1,0,30,29
1650444039263,MATH 18,A02,083744,Staff,27,0,30,3
1650444039263,MATH 18,A03,083745,Staff,22,0,30,8
1650444039263,MATH 18,A04,083746,Staff,26,0,30,4
1650444039263,MATH 18,B01,083748,Staff,0,11,30,30
1650444039263,MATH 18,B02,083749,Staff,0,12,30,30
1650444039263,MATH 18,B03,083750,Staff,0,11,30,30
1650444039263,MATH 18,B04,083751,Staff,0,12,30,30
1650444045286,MATH 20A,A01,083754,Staff,25,0,40,15
1650444051318,MATH 20B,A01,083756,Staff,0,10,30,30
1650444051318,MATH 20B,A02,083757,Staff,0,10,30,30
1650444057348,MATH 20C,A01,083760,Staff,0,15,30,30
1650444057348,MATH 20C,A02,083761,Staff,1,14,30,29
1650444057348,MATH 20C,B01,083762,Staff,13,0,30,17
1650444057348,MATH 20C,B02,083763,Staff,28,0,30,2
1650444063395,MATH 20D,A01,083765,Staff,0,1,30,30
1650444063395,MATH 20D,A02,083766,Staff,9,0,30,21
1650444063395,MATH 20D,A03,083767,Staff,25,0,30,5
1650444069429,MATH 20E,A01,083771,Staff,5,0,30,25
1650444069429,MATH 20E,A02,083772,Staff,18,0,30,12
1650444069429,MATH 20E,B01,083773,Staff,0,0,30,30
1650444069429,MATH 20E,B02,083774,Staff,10,0,30,20
1650444075457,MATH 103A,A01,083777,Staff,0,12,30,30
1650444075457,MATH 103A,A02,083778,Staff,0,12,30,30
1650444075457,MATH 103A,B01,083779,Staff,0,13,30,30
1650444075457,MATH 103A,B02,083780,Staff,0,12,30,30
1650444081483,MATH 105,A01,085443,Staff,0,23,30,30
1650444087507,MATH 109,A01,083213,Anzaldo; Leesa B,0,7,30,30
1650444087507,MATH 109,A02,083214,Anzaldo; Leesa B,0,7,30,30
1650444087507,MATH 109,B01,083215,Anzaldo; Leesa B,0,5,30,30
1650444087507,MATH 109,B02,083216,Anzaldo; Leesa B,0,6,30,30
1650444093532,MATH 142A,A01,083219,Chow; Bennett,0,14,30,30
1650444093532,MATH 142A,A02,083220,Chow; Bennett,0,13,30,30
1650444093532,MATH 142A,B01,083221,Chow; Bennett,0,12,30,30
1650444093532,MATH 142A,B02,083222,Chow; Bennett,0,13,30,30
1650444099564,MATH 193A,A01,083224,Staff,0,5,30,30
1650444099564,MATH 193A,A02,083225,Staff,0,5,30,30
1650444099564,MATH 193A,A03,083781,Staff,0,4,30,30
1650444099564,MATH 193A,A04,083782,Staff,0,5,30,30
1650444105592,MATH 197,001,091859,McAuley; Julian John,9998,0,9999,1
1650444111666,COGS 9,A01,083615,Staff,0,14,60,60
1650444117692,COGS 11,A01,083617,Boyle; Mary E. T.,21,0,40,19
1650444123723,COGS 13,A01,083071,Staff,0,34,40,40
1650444129752,COGS 14A,A01,092681,Staff,1,25,100,99
1650444135775,COGS 14B,A01,083073,Cheng; Tzu-Han,0,11,50,50
1650444141800,COGS 17,A01,092677,Staff,22,0,75,53
1650444147828,COGS 100,A01,083619,Staff,0,26,60,60
1650444153854,COGS 101A,A01,083621,Davis; Joshua Daniel,0,21,60,60
1650444159878,COGS 101B,A01,091572,Staff,0,4,60,60
1650444165911,COGS 101C,A01,083625,Delgado; Tania,16,0,30,14
1650444171936,COGS 107A,A01,083627,Boyle; Mary E. T.,0,11,60,60
1650444177961,COGS 118A,A01,083075,Staff,2,0,60,58
1650444183988,CSE 3,A50,083646,Miranda; Gregory Joseph,20,0,38,18
1650444183988,CSE 3,A51,083647,Miranda; Gregory Joseph,36,0,37,1
1650444190012,CSE 8A,A50,083650,Miranda; Gregory Joseph,0,28,40,40
1650444196040,CSE 11,A01,083080,Cao; Yingjun,0,92,40,40
1650444202064,CSE 12,A01,083652,Staff,0,16,100,100
1650444208088,CSE 15L,A01,083654,Staff,0,1,50,50
1650444208088,CSE 15L,A02,083655,Staff,1,0,50,49
1650444214113,CSE 20,A01,083657,Staff,51,0,80,29
1650444220142,CSE 30,A01,083084,Eldon; John,0,76,40,40
1650444226166,CSE 100,A01,083659,Cao; Yingjun,0,66,50,50
1650444232193,CSE 134B,A01,083661,Powell; Thomas Allan,0,32,65,65
1650444238220,CSE 140,A01,083663,Staff,0,2,75,75
1650444244249,CSE 140L,A01,083088,Eldon; John,0,8,75,75
1650444250277,CSE 175,A01,083665,Kumar; Rakesh,7,0,25,18
1650444256299,CSE 190,A00,092507,Dubnov; Shlomo,14,0,20,6
1650444262324,ECE 45,A01,083139,Staff,0,18,40,40
1650444268354,ECE 65,A50,083695,Staff,0,6,30,30
1650444274379,ECE 109,A01,091882,Touri; Behrouz,38,0,70,32
1650444280403,ECE 180,A00,083140,Abi Samra; Nicholas Camill,23,0,30,7
1650444280403,ECE 180,B00,083141,Abi Samra; Nicholas Camill,0,0,30,30
1650444286429,MATH 10A,A01,083735,Patchell; Gregory David,7,0,30,23
1650444286429,MATH 10A,A02,083736,Patchell; Gregory David,28,0,30,2
1650444286429,MATH 10A,A03,083737,Patchell; Gregory David,25,0,30,5
1650444292456,MATH 10B,A01,083207,Staff,0,7,30,30
1650444292456,MATH 10B,A02,083208,Staff,0,7,30,30
1650444292456,MATH 10B,B01,083739,Staff,13,0,30,17
1650444292456,MATH 10B,B02,083740,Staff,28,0,30,2
1650444298484,MATH 18,A01,083743,Staff,1,0,30,29
1650444298484,MATH 18,A02,083744,Staff,27,0,30,3
1650444298484,MATH 18,A03,083745,Staff,22,0,30,8
1650444298484,MATH 18,A04,083746,Staff,26,0,30,4
1650444298484,MATH 18,B01,083748,Staff,0,11,30,30
1650444298484,MATH 18,B02,083749,Staff,0,12,30,30
1650444298484,MATH 18,B03,083750,Staff,0,11,30,30
1650444298484,MATH 18,B04,083751,Staff,0,12,30,30
1650444304512,MATH 20A,A01,083754,Staff,25,0,40,15
1650444310537,MATH 20B,A01,083756,Staff,0,10,30,30
1650444310537,MATH 20B,A02,083757,Staff,0,10,30,30
1650444316562,MATH 20C,A01,083760,Staff,0,15,30,30
1650444316562,MATH 20C,A02,083761,Staff,1,14,30,29
1650444316562,MATH 20C,B01,083762,Staff,13,0,30,17
1650444316562,MATH 20C,B02,083763,Staff,28,0,30,2
1650444322586,MATH 20D,A01,083765,Staff,0,1,30,30
1650444322586,MATH 20D,A02,083766,Staff,9,0,30,21
1650444322586,MATH 20D,A03,083767,Staff,25,0,30,5
1650444328617,MATH 20E,A01,083771,Staff,5,0,30,25
1650444328617,MATH 20E,A02,083772,Staff,18,0,30,12
1650444328617,MATH 20E,B01,083773,Staff,0,0,30,30
1650444328617,MATH 20E,B02,083774,Staff,10,0,30,20
1650444334643,MATH 103A,A01,083777,Staff,0,12,30,30
1650444334643,MATH 103A,A02,083778,Staff,0,12,30,30
1650444334643,MATH 103A,B01,083779,Staff,0,13,30,30
1650444334643,MATH 103A,B02,083780,Staff,0,12,30,30
1650444340671,MATH 105,A01,085443,Staff,0,23,30,30
1650444346701,MATH 109,A01,083213,Anzaldo; Leesa B,0,7,30,30
1650444346701,MATH 109,A02,083214,Anzaldo; Leesa B,0,7,30,30
1650444346701,MATH 109,B01,083215,Anzaldo; Leesa B,0,5,30,30
1650444346701,MATH 109,B02,083216,Anzaldo; Leesa B,0,6,30,30
1650444352732,MATH 142A,A01,083219,Chow; Bennett,0,14,30,30
1650444352732,MATH 142A,A02,083220,Chow; Bennett,0,13,30,30
1650444352732,MATH 142A,B01,083221,Chow; Bennett,0,12,30,30
1650444352732,MATH 142A,B02,083222,Chow; Bennett,0,13,30,30
1650444358764,MATH 193A,A01,083224,Staff,0,5,30,30
1650444358764,MATH 193A,A02,083225,Staff,0,5,30,30
1650444358764,MATH 193A,A03,083781,Staff,0,4,30,30
1650444358764,MATH 193A,A04,083782,Staff,0,5,30,30
1650444364795,MATH 197,001,091859,McAuley; Julian John,9998,0,9999,1
1650444370965,COGS 9,A01,083615,Staff,0,14,60,60
1650444376990,COGS 11,A01,083617,Boyle; Mary E. T.,21,0,40,19
1650444383022,COGS 13,A01,083071,Staff,0,34,40,40
1650444389046,COGS 14A,A01,092681,Staff,1,25,100,99
1650444395072,COGS 14B,A01,083073,Cheng; Tzu-Han,0,11,50,50
1650444401096,COGS 17,A01,092677,Staff,22,0,75,53
1650444407124,COGS 100,A01,083619,Staff,0,26,60,60
1650444413148,COGS 101A,A01,083621,Davis; Joshua Daniel,0,21,60,60
1650444419173,COGS 101B,A01,091572,Staff,0,4,60,60
1650444425198,COGS 101C,A01,083625,Delgado; Tania,16,0,30,14
1650444431222,COGS 107A,A01,083627,Boyle; Mary E. T.,0,11,60,60
1650444437248,COGS 118A,A01,083075,Staff,2,0,60,58
1650444443277,CSE 3,A50,083646,Miranda; Gregory Joseph,20,0,38,18
1650444443277,CSE 3,A51,083647,Miranda; Gregory Joseph,36,0,37,1
1650444449302,CSE 8A,A50,083650,Miranda; Gregory Joseph,0,28,40,40
1650444455326,CSE 11,A01,083080,Cao; Yingjun,0,92,40,40
1650444461353,CSE 12,A01,083652,Staff,0,16,100,100
1650444467377,CSE 15L,A01,083654,Staff,0,1,50,50
1650444467377,CSE 15L,A02,083655,Staff,1,0,50,49
1650444473405,CSE 20,A01,083657,Staff,51,0,80,29
1650444479430,CSE 30,A01,083084,Eldon; John,0,76,40,40
1650444485459,CSE 100,A01,083659,Cao; Yingjun,0,66,50,50
1650444491482,CSE 134B,A01,083661,Powell; Thomas Allan,0,32,65,65
1650444497506,CSE 140,A01,083663,Staff,0,2,75,75
1650444503532,CSE 140L,A01,083088,Eldon; John,0,8,75,75
1650444509558,CSE 175,A01,083665,Kumar; Rakesh,7,0,25,18
1650444515586,CSE 190,A00,092507,Dubnov; Shlomo,14,0,20,6
1650444521615,ECE 45,A01,083139,Staff,0,18,40,40
1650444527643,ECE 65,A50,083695,Staff,0,6,30,30
1650444533666,ECE 109,A01,091882,Touri; Behrouz,38,0,70,32
1650444539692,ECE 180,A00,083140,Abi Samra; Nicholas Camill,23,0,30,7
1650444539692,ECE 180,B00,083141,Abi Samra; Nicholas Camill,0,0,30,30
1650444545717,MATH 10A,A01,083735,Patchell; Gregory David,7,0,30,23
1650444545717,MATH 10A,A02,083736,Patchell; Gregory David,28,0,30,2
1650444545717,MATH 10A,A03,083737,Patchell; Gregory David,25,0,30,5
1650444551743,MATH 10B,A01,083207,Staff,0,7,30,30
1650444551743,MATH 10B,A02,083208,Staff,0,7,30,30
1650444551743,MATH 10B,B01,083739,Staff,13,0,30,17
1650444551743,MATH 10B,B02,083740,Staff,28,0,30,2
1650444557771,MATH 18,A01,083743,Staff,1,0,30,29
1650444557771,MATH 18,A02,083744,Staff,27,0,30,3
1650444557771,MATH 18,A03,083745,Staff,22,0,30,8
1650444557771,MATH 18,A04,083746,Staff,26,0,30,4
1650444557771,MATH 18,B01,083748,Staff,0,11,30,30
1650444557771,MATH 18,B02,083749,Staff,0,12,30,30
1650444557771,MATH 18,B03,083750,Staff,0,11,30,30
1650444557771,MATH 18,B04,083751,Staff,0,12,30,30
1650444563795,MATH 20A,A01,083754,Staff,25,0,40,15
1650444569825,MATH 20B,A01,083756,Staff,0,10,30,30
1650444569825,MATH 20B,A02,083757,Staff,0,10,30,30
1650444575853,MATH 20C,A01,083760,Staff,0,15,30,30
1650444575853,MATH 20C,A02,083761,Staff,1,14,30,29
1650444575853,MATH 20C,B01,083762,Staff,13,0,30,17
1650444575853,MATH 20C,B02,083763,Staff,28,0,30,2
1650444581877,MATH 20D,A01,083765,Staff,0,1,30,30
1650444581877,MATH 20D,A02,083766,Staff,9,0,30,21
1650444581877,MATH 20D,A03,083767,Staff,25,0,30,5
1650444587904,MATH 20E,A01,083771,Staff,5,0,30,25
1650444587904,MATH 20E,A02,083772,Staff,18,0,30,12
1650444587904,MATH 20E,B01,083773,Staff,0,0,30,30
1650444587904,MATH 20E,B02,083774,Staff,10,0,30,20
1650444593930,MATH 103A,A01,083777,Staff,0,12,30,30
1650444593930,MATH 103A,A02,083778,Staff,0,12,30,30
1650444593930,MATH 103A,B01,083779,Staff,0,13,30,30
1650444593930,MATH 103A,B02,083780,Staff,0,12,30,30
1650444599959,MATH 105,A01,085443,Staff,0,23,30,30
1650444605994,MATH 109,A01,083213,Anzaldo; Leesa B,0,7,30,30
1650444605994,MATH 109,A02,083214,Anzaldo; Leesa B,0,7,30,30
1650444605994,MATH 109,B01,083215,Anzaldo; Leesa B,0,5,30,30
1650444605994,MATH 109,B02,083216,Anzaldo; Leesa B,0,6,30,30
1650444612025,MATH 142A,A01,083219,Chow; Bennett,0,14,30,30
1650444612025,MATH 142A,A02,083220,Chow; Bennett,0,13,30,30
1650444612025,MATH 142A,B01,083221,Chow; Bennett,0,12,30,30
1650444612025,MATH 142A,B02,083222,Chow; Bennett,0,13,30,30
1650444618052,MATH 193A,A01,083224,Staff,0,5,30,30
1650444618052,MATH 193A,A02,083225,Staff,0,5,30,30
1650444618052,MATH 193A,A03,083781,Staff,0,4,30,30
1650444618052,MATH 193A,A04,083782,Staff,0,5,30,30
1650444624076,MATH 197,001,091859,McAuley; Julian John,9998,0,9999,1
1650444630136,COGS 9,A01,083615,Staff,0,14,60,60
1650444636165,COGS 11,A01,083617,Boyle; Mary E. T.,21,0,40,19
1650444642189,COGS 13,A01,083071,Staff,0,34,40,40
1650444648220,COGS 14A,A01,092681,Staff,1,25,100,99
1650444654244,COGS 14B,A01,083073,Cheng; Tzu-Han,0,11,50,50
1650444660267,COGS 17,A01,092677,Staff,22,0,75,53
1650444666293,COGS 100,A01,083619,Staff,0,26,60,60
1650444672319,COGS 101A,A01,083621,Davis; Joshua Daniel,0,21,60,60
1650444678342,COGS 101B,A01,091572,Staff,0,4,60,60
1650444684367,COGS 101C,A01,083625,Delgado; Tania,16,0,30,14
1650444690396,COGS 107A,A01,083627,Boyle; Mary E. T.,0,11,60,60
1650444696427,COGS 118A,A01,083075,Staff,2,0,60,58
1650444702459,CSE 3,A50,083646,Miranda; Gregory Joseph,20,0,38,18
1650444702459,CSE 3,A51,083647,Miranda; Gregory Joseph,36,0,37,1
1650444708488,CSE 8A,A50,083650,Miranda; Gregory Joseph,0,28,40,40
1650444714518,CSE 11,A01,083080,Cao; Yingjun,0,92,40,40
1650444720543,CSE 12,A01,083652,Staff,0,16,100,100
1650444726574,CSE 15L,A01,083654,Staff,0,1,50,50
1650444726574,CSE 15L,A02,083655,Staff,1,0,50,49
1650444732597,CSE 20,A01,083657,Staff,51,0,80,29
1650444738620,CSE 30,A01,083084,Eldon; John,0,76,40,40
1650444744650,CSE 100,A01,083659,Cao; Yingjun,0,66,50,50
1650444750675,CSE 134B,A01,083661,Powell; Thomas Allan,0,32,65,65
1650444756702,CSE 140,A01,083663,Staff,0,2,75,75
1650444762731,CSE 140L,A01,083088,Eldon; John,0,8,75,75
1650444768759,CSE 175,A01,083665,Kumar; Rakesh,7,0,25,18
1650444774781,CSE 190,A00,092507,Dubnov; Shlomo,14,0,20,6
1650444780808,ECE 45,A01,083139,Staff,0,18,40,40
1650444786832,ECE 65,A50,083695,Staff,0,6,30,30
1650444792861,ECE 109,A01,091882,Touri; Behrouz,38,0,70,32
1650444798886,ECE 180,A00,083140,Abi Samra; Nicholas Camill,23,0,30,7
1650444798886,ECE 180,B00,083141,Abi Samra; Nicholas Camill,0,0,30,30
1650444804913,MATH 10A,A01,083735,Patchell; Gregory David,7,0,30,23
1650444804913,MATH 10A,A02,083736,Patchell; Gregory David,28,0,30,2
1650444804913,MATH 10A,A03,083737,Patchell; Gregory David,25,0,30,5
1650444810943,MATH 10B,A01,083207,Staff,0,7,30,30
1650444810943,MATH 10B,A02,083208,Staff,0,7,30,30
1650444810943,MATH 10B,B01,083739,Staff,13,0,30,17
1650444810943,MATH 10B,B02,083740,Staff,28,0,30,2
1650444816968,MATH 18,A01,083743,Staff,1,0,30,29
1650444816968,MATH 18,A02,083744,Staff,27,0,30,3
1650444816968,MATH 18,A03,083745,Staff,22,0,30,8
1650444816968,MATH 18,A04,083746,Staff,26,0,30,4
1650444816968,MATH 18,B01,083748,Staff,0,11,30,30
1650444816968,MATH 18,B02,083749,Staff,0,12,30,30
1650444816968,MATH 18,B03,083750,Staff,0,11,30,30
1650444816968,MATH 18,B04,083751,Staff,0,12,30,30
1650444822992,MATH 20A,A01,083754,Staff,25,0,40,15
1650444829026,MATH 20B,A01,083756,Staff,0,10,30,30
1650444829026,MATH 20B,A02,083757,Staff,0,10,30,30
1650444835051,MATH 20C,A01,083760,Staff,0,15,30,30
1650444835051,MATH 20C,A02,083761,Staff,1,14,30,29
1650444835051,MATH 20C,B01,083762,Staff,13,0,30,17
1650444835051,MATH 20C,B02,083763,Staff,28,0,30,2
1650444841076,MATH 20D,A01,083765,Staff,0,1,30,30
1650444841076,MATH 20D,A02,083766,Staff,9,0,30,21
1650444841076,MATH 20D,A03,083767,Staff,25,0,30,5
1650444847101,MATH 20E,A01,083771,Staff,5,0,30,25
1650444847101,MATH 20E,A02,083772,Staff,18,0,30,12
1650444847101,MATH 20E,B01,083773,Staff,0,0,30,30
1650444847101,MATH 20E,B02,083774,Staff,10,0,30,20
1650444853131,MATH 103A,A01,083777,Staff,0,12,30,30
1650444853131,MATH 103A,A02,083778,Staff,0,12,30,30
1650444853131,MATH 103A,B01,083779,Staff,0,13,30,30
1650444853131,MATH 103A,B02,083780,Staff,0,12,30,30
1650444859157,MATH 105,A01,085443,Staff,0,23,30,30
1650444865183,MATH 109,A01,083213,Anzaldo; Leesa B,0,7,30,30
1650444865183,MATH 109,A02,083214,Anzaldo; Leesa B,0,7,30,30
1650444865183,MATH 109,B01,083215,Anzaldo; Leesa B,0,5,30,30
1650444865183,MATH 109,B02,083216,Anzaldo; Leesa B,0,6,30,30
1650444871215,MATH 142A,A01,083219,Chow; Bennett,0,14,30,30
1650444871215,MATH 142A,A02,083220,Chow; Bennett,0,13,30,30
1650444871215,MATH 142A,B01,083221,Chow; Bennett,0,12,30,30
1650444871215,MATH 142A,B02,083222,Chow; Bennett,0,13,30,30
1650444877248,MATH 193A,A01,083224,Staff,0,5,30,30
1650444877248,MATH 193A,A02,083225,Staff,0,5,30,30
1650444877248,MATH 193A,A03,083781,Staff,0,4,30,30
1650444877248,MATH 193A,A04,083782,Staff,0,5,30,30
1650444883276,MATH 197,001,091859,McAuley; Julian John,9998,0,9999,1
1650444889334,COGS 9,A01,083615,Staff,0,14,60,60
1650444895363,COGS 11,A01,083617,Boyle; Mary E. T.,21,0,40,19
1650444901391,COGS 13,A01,083071,Staff,0,34,40,40
1650444907418,COGS 14A,A01,092681,Staff,1,25,100,99
1650444913443,COGS 14B,A01,083073,Cheng; Tzu-Han,0,11,50,50
1650444919467,COGS 17,A01,092677,Staff,22,0,75,53
1650444925490,COGS 100,A01,083619,Staff,0,26,60,60
1650444931516,COGS 101A,A01,083621,Davis; Joshua Daniel,0,21,60,60
1650444937540,COGS 101B,A01,091572,Staff,0,4,60,60
1650444943573,COGS 101C,A01,083625,Delgado; Tania,16,0,30,14
1650444949597,COGS 107A,A01,083627,Boyle; Mary E. T.,0,11,60,60
1650444955623,COGS 118A,A01,083075,Staff,2,0,60,58
1650444961649,CSE 3,A50,083646,Miranda; Gregory Joseph,20,0,38,18
1650444961649,CSE 3,A51,083647,Miranda; Gregory Joseph,36,0,37,1
1650444967770,CSE 8A,A50,083650,Miranda; Gregory Joseph,0,28,40,40
1650444973794,CSE 11,A01,083080,Cao; Yingjun,0,92,40,40
1650444979817,CSE 12,A01,083652,Staff,0,16,100,100
1650444985841,CSE 15L,A01,083654,Staff,0,1,50,50
1650444985841,CSE 15L,A02,083655,Staff,1,0,50,49
1650444991864,CSE 20,A01,083657,Staff,51,0,80,29
1650444997888,CSE 30,A01,083084,Eldon; John,0,76,40,40
1650445003915,CSE 100,A01,083659,Cao; Yingjun,0,66,50,50
1650445009939,CSE 134B,A01,083661,Powell; Thomas Allan,0,32,65,65
1650445015963,CSE 140,A01,083663,Staff,0,2,75,75
1650445021988,CSE 140L,A01,083088,Eldon; John,0,8,75,75
1650445028011,CSE 175,A01,083665,Kumar; Rakesh,7,0,25,18
1650445034037,CSE 190,A00,092507,Dubnov; Shlomo,14,0,20,6
1650445040060,ECE 45,A01,083139,Staff,0,18,40,40
1650445046084,ECE 65,A50,083695,Staff,0,6,30,30
1650445052111,ECE 109,A01,091882,Touri; Behrouz,38,0,70,32
1650445058137,ECE 180,A00,083140,Abi Samra; Nicholas Camill,23,0,30,7
1650445058137,ECE 180,B00,083141,Abi Samra; Nicholas Camill,0,0,30,30
1650445064165,MATH 10A,A01,083735,Patchell; Gregory David,7,0,30,23
1650445064165,MATH 10A,A02,083736,Patchell; Gregory David,28,0,30,2
1650445064165,MATH 10A,A03,083737,Patchell; Gregory David,25,0,30,5
1650445070194,MATH 10B,A01,083207,Staff,0,7,30,30
1650445070194,MATH 10B,A02,083208,Staff,0,7,30,30
1650445070194,MATH 10B,B01,083739,Staff,13,0,30,17
1650445070194,MATH 10B,B02,083740,Staff,28,0,30,2
1650445076218,MATH 18,A01,083743,Staff,1,0,30,29
1650445076218,MATH 18,A02,083744,Staff,27,0,30,3
1650445076218,MATH 18,A03,083745,Staff,22,0,30,8
1650445076218,MATH 18,A04,083746,Staff,26,0,30,4
1650445076218,MATH 18,B01,083748,Staff,0,11,30,30
1650445076218,MATH 18,B02,083749,Staff,0,12,30,30
1650445076218,MATH 18,B03,083750,Staff,0,11,30,30
1650445076218,MATH 18,B04,083751,Staff,0,12,30,30
1650445082241,MATH 20A,A01,083754,Staff,25,0,40,15
1650445088265,MATH 20B,A01,083756,Staff,0,10,30,30
1650445088265,MATH 20B,A02,083757,Staff,0,10,30,30
1650445094289,MATH 20C,A01,083760,Staff,0,15,30,30
1650445094289,MATH 20C,A02,083761,Staff,1,14,30,29
1650445094289,MATH 20C,B01,083762,Staff,13,0,30,17
1650445094289,MATH 20C,B02,083763,Staff,28,0,30,2
1650445100316,MATH 20D,A01,083765,Staff,0,1,30,30
1650445100316,MATH 20D,A02,083766,Staff,9,0,30,21
1650445100316,MATH 20D,A03,083767,Staff,25,0,30,5
1650445106341,MATH 20E,A01,083771,Staff,5,0,30,25
1650445106341,MATH 20E,A02,083772,Staff,18,0,30,12
1650445106341,MATH 20E,B01,083773,Staff,0,0,30,30
1650445106341,MATH 20E,B02,083774,Staff,10,0,30,20
1650445112371,MATH 103A,A01,083777,Staff,0,12,30,30
1650445112371,MATH 103A,A02,083778,Staff,0,12,30,30
1650445112371,MATH 103A,B01,083779,Staff,0,13,30,30
1650445112371,MATH 103A,B02,083780,Staff,0,12,30,30
1650445118395,MATH 105,A01,085443,Staff,0,23,30,30
1650445124424,MATH 109,A01,083213,Anzaldo; Leesa B,0,7,30,30
1650445124424,MATH 109,A02,083214,Anzaldo; Leesa B,0,7,30,30
1650445124424,MATH 109,B01,083215,Anzaldo; Leesa B,0,5,30,30
1650445124424,MATH 109,B02,083216,Anzaldo; Leesa B,0,6,30,30
1650445130453,MATH 142A,A01,083219,Chow; Bennett,0,14,30,30
1650445130453,MATH 142A,A02,083220,Chow; Bennett,0,13,30,30
1650445130453,MATH 142A,B01,083221,Chow; Bennett,0,12,30,30
1650445130453,MATH 142A,B02,083222,Chow; Bennett,0,13,30,30
1650445136481,MATH 193A,A01,083224,Staff,0,5,30,30
1650445136481,MATH 193A,A02,083225,Staff,0,5,30,30
1650445136481,MATH 193A,A03,083781,Staff,0,4,30,30
1650445136481,MATH 193A,A04,083782,Staff,0,5,30,30
1650445142503,MATH 197,001,091859,McAuley; Julian John,9998,0,9999,1
1650445148557,COGS 9,A01,083615,Staff,0,14,60,60
1650445154583,COGS 11,A01,083617,Boyle; Mary E. T.,21,0,40,19
1650445160608,COGS 13,A01,083071,Staff,0,34,40,40
1650445166631,COGS 14A,A01,092681,Staff,1,25,100,99
1650445172658,COGS 14B,A01,083073,Cheng; Tzu-Han,0,11,50,50
1650445178686,COGS 17,A01,092677,Staff,22,0,75,53
1650445184713,COGS 100,A01,083619,Staff,0,26,60,60
1650445190740,COGS 101A,A01,083621,Davis; Joshua Daniel,0,21,60,60
1650445196765,COGS 101B,A01,091572,Staff,0,4,60,60
1650445202788,COGS 101C,A01,083625,Delgado; Tania,16,0,30,14
1650445208811,COGS 107A,A01,083627,Boyle; Mary E. T.,0,11,60,60
1650445214836,COGS 118A,A01,083075,Staff,2,0,60,58
1650445220860,CSE 3,A50,083646,Miranda; Gregory Joseph,20,0,38,18
1650445220860,CSE 3,A51,083647,Miranda; Gregory Joseph,36,0,37,1
1650445226884,CSE 8A,A50,083650,Miranda; Gregory Joseph,0,28,40,40
1650445232907,CSE 11,A01,083080,Cao; Yingjun,0,92,40,40
1650445238930,CSE 12,A01,083652,Staff,0,16,100,100
1650445244956,CSE 15L,A01,083654,Staff,0,1,50,50
1650445244956,CSE 15L,A02,083655,Staff,1,0,50,49
1650445250980,CSE 20,A01,083657,Staff,51,0,80,29
1650445257003,CSE 30,A01,083084,Eldon; John,0,76,40,40
1650445263036,CSE 100,A01,083659,Cao; Yingjun,0,66,50,50
1650445269063,CSE 134B,A01,083661,Powell; Thomas Allan,0,32,65,65
1650445275088,CSE 140,A01,083663,Staff,0,2,75,75
1650445281115,CSE 140L,A01,083088,Eldon; John,0,8,75,75
1650445287145,CSE 175,A01,083665,Kumar; Rakesh,7,0,25,18
1650445293174,CSE 190,A00,092507,Dubnov; Shlomo,14,0,20,6
1650445299203,ECE 45,A01,083139,Staff,0,18,40,40
1650445305229,ECE 65,A50,083695,Staff,0,6,30,30
1650445311261,ECE 109,A01,091882,Touri; Behrouz,38,0,70,32
1650445317288,ECE 180,A00,083140,Abi Samra; Nicholas Camill,23,0,30,7
1650445317288,ECE 180,B00,083141,Abi Samra; Nicholas Camill,0,0,30,30
1650445323312,MATH 10A,A01,083735,Patchell; Gregory David,7,0,30,23
1650445323312,MATH 10A,A02,083736,Patchell; Gregory David,28,0,30,2
1650445323312,MATH 10A,A03,083737,Patchell; Gregory David,25,0,30,5
1650445329340,MATH 10B,A01,083207,Staff,0,7,30,30
1650445329340,MATH 10B,A02,083208,Staff,0,7,30,30
1650445329340,MATH 10B,B01,083739,Staff,13,0,30,17
1650445329340,MATH 10B,B02,083740,Staff,28,0,30,2
1650445335370,MATH 18,A01,083743,Staff,1,0,30,29
1650445335370,MATH 18,A02,083744,Staff,27,0,30,3
1650445335370,MATH 18,A03,083745,Staff,22,0,30,8
1650445335370,MATH 18,A04,083746,Staff,26,0,30,4
1650445335370,MATH 18,B01,083748,Staff,0,11,30,30
1650445335370,MATH 18,B02,083749,Staff,0,12,30,30
1650445335370,MATH 18,B03,083750,Staff,0,11,30,30
1650445335370,MATH 18,B04,083751,Staff,0,12,30,30
1650445341394,MATH 20A,A01,083754,Staff,25,0,40,15
1650445347425,MATH 20B,A01,083756,Staff,0,10,30,30
1650445347425,MATH 20B,A02,083757,Staff,0,10,30,30
1650445353453,MATH 20C,A01,083760,Staff,0,15,30,30
1650445353453,MATH 20C,A02,083761,Staff,1,14,30,29
1650445353453,MATH 20C,B01,083762,Staff,13,0,30,17
1650445353453,MATH 20C,B02,083763,Staff,28,0,30,2
1650445359475,MATH 20D,A01,083765,Staff,0,1,30,30
1650445359475,MATH 20D,A02,083766,Staff,9,0,30,21
1650445359475,MATH 20D,A03,083767,Staff,25,0,30,5
1650445365499,MATH 20E,A01,083771,Staff,5,0,30,25
1650445365499,MATH 20E,A02,083772,Staff,18,0,30,12
1650445365499,MATH 20E,B01,083773,Staff,0,0,30,30
1650445365499,MATH 20E,B02,083774,Staff,10,0,30,20
1650445371520,MATH 103A,A01,083777,Staff,0,12,30,30
1650445371520,MATH 103A,A02,083778,Staff,0,12,30,30
1650445371520,MATH 103A,B01,083779,Staff,0,13,30,30
1650445371520,MATH 103A,B02,083780,Staff,0,12,30,30
1650445377545,MATH 105,A01,085443,Staff,0,23,30,30
1650445383569,MATH 109,A01,083213,Anzaldo; Leesa B,0,7,30,30
1650445383569,MATH 109,A02,083214,Anzaldo; Leesa B,0,7,30,30
1650445383569,MATH 109,B01,083215,Anzaldo; Leesa B,0,5,30,30
1650445383569,MATH 109,B02,083216,Anzaldo; Leesa B,0,6,30,30
1650445389597,MATH 142A,A01,083219,Chow; Bennett,0,14,30,30
1650445389597,MATH 142A,A02,083220,Chow; Bennett,0,13,30,30
1650445389597,MATH 142A,B01,083221,Chow; Bennett,0,12,30,30
1650445389597,MATH 142A,B02,083222,Chow; Bennett,0,13,30,30
1650445395622,MATH 193A,A01,083224,Staff,0,5,30,30
1650445395622,MATH 193A,A02,083225,Staff,0,5,30,30
1650445395622,MATH 193A,A03,083781,Staff,0,4,30,30
1650445395622,MATH 193A,A04,083782,Staff,0,5,30,30
1650445401647,MATH 197,001,091859,McAuley; Julian John,9998,0,9999,1
1650445407711,COGS 9,A01,083615,Staff,0,14,60,60
1650445413740,COGS 11,A01,083617,Boyle; Mary E. T.,21,0,40,19
1650445419764,COGS 13,A01,083071,Staff,0,34,40,40
1650445425791,COGS 14A,A01,092681,Staff,1,25,100,99
1650445431818,COGS 14B,A01,083073,Cheng; Tzu-Han,0,11,50,50
1650445437842,COGS 17,A01,092677,Staff,22,0,75,53
1650445443867,COGS 100,A01,083619,Staff,0,26,60,60
1650445449907,COGS 101A,A01,083621,Davis; Joshua Daniel,0,21,60,60
1650445455932,COGS 101B,A01,091572,Staff,0,4,60,60
1650445461956,COGS 101C,A01,083625,Delgado; Tania,16,0,30,14
1650445467987,COGS 107A,A01,083627,Boyle; Mary E. T.,0,11,60,60
1650445474012,COGS 118A,A01,083075,Staff,2,0,60,58
1650445480050,CSE 3,A50,083646,Miranda; Gregory Joseph,20,0,38,18
1650445480050,CSE 3,A51,083647,Miranda; Gregory Joseph,36,0,37,1
1650445486075,CSE 8A,A50,083650,Miranda; Gregory Joseph,0,28,40,40
1650445492099,CSE 11,A01,083080,Cao; Yingjun,0,92,40,40
1650445498126,CSE 12,A01,083652,Staff,0,16,100,100
1650445504154,CSE 15L,A01,083654,Staff,0,1,50,50
1650445504154,CSE 15L,A02,083655,Staff,1,0,50,49
1650445510179,CSE 20,A01,083657,Staff,51,0,80,29
1650445516205,CSE 30,A01,083084,Eldon; John,0,76,40,40
1650445522226,CSE 100,A01,083659,Cao; Yingjun,0,66,50,50
1650445528252,CSE 134B,A01,083661,Powell; Thomas Allan,0,32,65,65
1650445534276,CSE 140,A01,083663,Staff,0,2,75,75
1650445540304,CSE 140L,A01,083088,Eldon; John,0,8,75,75
1650445546326,CSE 175,A01,083665,Kumar; Rakesh,7,0,25,18
1650445552351,CSE 190,A00,092507,Dubnov; Shlomo,14,0,20,6
1650445558376,ECE 45,A01,083139,Staff,0,18,40,40
1650445564477,ECE 65,A50,083695,Staff,0,6,30,30
1650445570502,ECE 109,A01,091882,Touri; Behrouz,38,0,70,32
1650445576525,ECE 180,A00,083140,Abi Samra; Nicholas Camill,23,0,30,7
1650445576525,ECE 180,B00,083141,Abi Samra; Nicholas Camill,0,0,30,30
1650445582550,MATH 10A,A01,083735,Patchell; Gregory David,7,0,30,23
1650445582550,MATH 10A,A02,083736,Patchell; Gregory David,28,0,30,2
1650445582550,MATH 10A,A03,083737,Patchell; Gregory David,25,0,30,5
1650445588579,MATH 10B,A01,083207,Staff,0,7,30,30
1650445588579,MATH 10B,A02,083208,Staff,0,7,30,30
1650445588579,MATH 10B,B01,083739,Staff,13,0,30,17
1650445588579,MATH 10B,B02,083740,Staff,28,0,30,2
1650445594602,MATH 18,A01,083743,Staff,1,0,30,29
1650445594602,MATH 18,A02,083744,Staff,27,0,30,3
1650445594602,MATH 18,A03,083745,Staff,22,0,30,8
1650445594602,MATH 18,A04,083746,Staff,26,0,30,4
1650445594602,MATH 18,B01,083748,Staff,0,11,30,30
1650445594602,MATH 18,B02,083749,Staff,0,12,30,30
1650445594602,MATH 18,B03,083750,Staff,0,11,30,30
1650445594602,MATH 18,B04,083751,Staff,0,12,30,30
1650445600629,MATH 20A,A01,083754,Staff,25,0,40,15
1650445606653,MATH 20B,A01,083756,Staff,0,10,30,30
1650445606653,MATH 20B,A02,083757,Staff,0,10,30,30
1650445612678,MATH 20C,A01,083760,Staff,0,15,30,30
1650445612678,MATH 20C,A02,083761,Staff,1,14,30,29
1650445612678,MATH 20C,B01,083762,Staff,13,0,30,17
1650445612678,MATH 20C,B02,083763,Staff,28,0,30,2
1650445618702,MATH 20D,A01,083765,Staff,0,1,30,30
1650445618702,MATH 20D,A02,083766,Staff,9,0,30,21
1650445618702,MATH 20D,A03,083767,Staff,25,0,30,5
1650445624726,MATH 20E,A01,083771,Staff,6,0,30,24
1650445624726,MATH 20E,A02,083772,Staff,18,0,30,12
1650445624726,MATH 20E,B01,083773,Staff,0,0,30,30
1650445624726,MATH 20E,B02,083774,Staff,10,0,30,20
1650445630755,MATH 103A,A01,083777,Staff,0,12,30,30
1650445630755,MATH 103A,A02,083778,Staff,0,12,30,30
1650445630755,MATH 103A,B01,083779,Staff,0,13,30,30
1650445630755,MATH 103A,B02,083780,Staff,0,12,30,30
1650445636781,MATH 105,A01,085443,Staff,0,23,30,30
1650445642808,MATH 109,A01,083213,Anzaldo; Leesa B,0,7,30,30
1650445642808,MATH 109,A02,083214,Anzaldo; Leesa B,0,7,30,30
1650445642808,MATH 109,B01,083215,Anzaldo; Leesa B,0,5,30,30
1650445642808,MATH 109,B02,083216,Anzaldo; Leesa B,0,6,30,30
1650445648833,MATH 142A,A01,083219,Chow; Bennett,0,14,30,30
1650445648833,MATH 142A,A02,083220,Chow; Bennett,0,13,30,30
1650445648833,MATH 142A,B01,083221,Chow; Bennett,0,12,30,30
1650445648833,MATH 142A,B02,083222,Chow; Bennett,0,13,30,30
1650445654857,MATH 193A,A01,083224,Staff,0,5,30,30
1650445654857,MATH 193A,A02,083225,Staff,0,5,30,30
1650445654857,MATH 193A,A03,083781,Staff,0,4,30,30
1650445654857,MATH 193A,A04,083782,Staff,0,5,30,30
1650445660882,MATH 197,001,091859,McAuley; Julian John,9998,0,9999,1
1650445666932,COGS 9,A01,083615,Staff,0,14,60,60
1650445672955,COGS 11,A01,083617,Boyle; Mary E. T.,21,0,40,19
1650445678978,COGS 13,A01,083071,Staff,0,34,40,40
1650445685004,COGS 14A,A01,092681,Staff,1,25,100,99
1650445691029,COGS 14B,A01,083073,Cheng; Tzu-Han,0,11,50,50
1650445697053,COGS 17,A01,092677,Staff,22,0,75,53
1650445703077,COGS 100,A01,083619,Staff,0,26,60,60
1650445709104,COGS 101A,A01,083621,Davis; Joshua Daniel,0,21,60,60
1650445715129,COGS 101B,A01,091572,Staff,0,4,60,60
1650445721154,COGS 101C,A01,083625,Delgado; Tania,16,0,30,14
1650445727180,COGS 107A,A01,083627,Boyle; Mary E. T.,0,11,60,60
1650445733206,COGS 118A,A01,083075,Staff,2,0,60,58
1650445739235,CSE 3,A50,083646,Miranda; Gregory Joseph,20,0,38,18
1650445739235,CSE 3,A51,083647,Miranda; Gregory Joseph,36,0,37,1
1650445745266,CSE 8A,A50,083650,Miranda; Gregory Joseph,0,28,40,40
1650445751290,CSE 11,A01,083080,Cao; Yingjun,0,92,40,40
1650445757319,CSE 12,A01,083652,Staff,0,16,100,100
1650445763344,CSE 15L,A01,083654,Staff,0,1,50,50
1650445763344,CSE 15L,A02,083655,Staff,1,0,50,49
1650445769367,CSE 20,A01,083657,Staff,51,0,80,29
1650445775395,CSE 30,A01,083084,Eldon; John,0,76,40,40
1650445781422,CSE 100,A01,083659,Cao; Yingjun,0,66,50,50
1650445787446,CSE 134B,A01,083661,Powell; Thomas Allan,0,32,65,65
1650445793473,CSE 140,A01,083663,Staff,0,2,75,75
1650445799498,CSE 140L,A01,083088,Eldon; John,0,8,75,75
1650445805521,CSE 175,A01,083665,Kumar; Rakesh,7,0,25,18
1650445811547,CSE 190,A00,092507,Dubnov; Shlomo,14,0,20,6
1650445817572,ECE 45,A01,083139,Staff,0,18,40,40
1650445823596,ECE 65,A50,083695,Staff,0,6,30,30
1650445829618,ECE 109,A01,091882,Touri; Behrouz,38,0,70,32
1650445835642,ECE 180,A00,083140,Abi Samra; Nicholas Camill,23,0,30,7
1650445835642,ECE 180,B00,083141,Abi Samra; Nicholas Camill,0,0,30,30
1650445841677,MATH 10A,A01,083735,Patchell; Gregory David,7,0,30,23
1650445841677,MATH 10A,A02,083736,Patchell; Gregory David,28,0,30,2
1650445841677,MATH 10A,A03,083737,Patchell; Gregory David,25,0,30,5
1650445847701,MATH 10B,A01,083207,Staff,0,7,30,30
1650445847701,MATH 10B,A02,083208,Staff,0,7,30,30
1650445847701,MATH 10B,B01,083739,Staff,13,0,30,17
1650445847701,MATH 10B,B02,083740,Staff,28,0,30,2
1650445853727,MATH 18,A01,083743,Staff,1,0,30,29
1650445853727,MATH 18,A02,083744,Staff,27,0,30,3
1650445853727,MATH 18,A03,083745,Staff,22,0,30,8
1650445853727,MATH 18,A04,083746,Staff,26,0,30,4
1650445853727,MATH 18,B01,083748,Staff,0,11,30,30
1650445853727,MATH 18,B02,083749,Staff,0,12,30,30
1650445853727,MATH 18,B03,083750,Staff,0,11,30,30
1650445853727,MATH 18,B04,083751,Staff,0,12,30,30
1650445859750,MATH 20A,A01,083754,Staff,25,0,40,15
1650445865774,MATH 20B,A01,083756,Staff,0,10,30,30
1650445865774,MATH 20B,A02,083757,Staff,0,10,30,30
1650445871799,MATH 20C,A01,083760,Staff,0,15,30,30
1650445871799,MATH 20C,A02,083761,Staff,1,14,30,29
1650445871799,MATH 20C,B01,083762,Staff,13,0,30,17
1650445871799,MATH 20C,B02,083763,Staff,28,0,30,2
1650445877824,MATH 20D,A01,083765,Staff,0,1,30,30
1650445877824,MATH 20D,A02,083766,Staff,9,0,30,21
1650445877824,MATH 20D,A03,083767,Staff,25,0,30,5
1650445883851,MATH 20E,A01,083771,Staff,6,0,30,24
1650445883851,MATH 20E,A02,083772,Staff,18,0,30,12
1650445883851,MATH 20E,B01,083773,Staff,0,0,30,30
1650445883851,MATH 20E,B02,083774,Staff,10,0,30,20
1650445889876,MATH 103A,A01,083777,Staff,0,12,30,30
1650445889876,MATH 103A,A02,083778,Staff,0,12,30,30
1650445889876,MATH 103A,B01,083779,Staff,0,13,30,30
1650445889876,MATH 103A,B02,083780,Staff,0,12,30,30
1650445895903,MATH 105,A01,085443,Staff,0,23,30,30
1650445901935,MATH 109,A01,083213,Anzaldo; Leesa B,0,7,30,30
1650445901935,MATH 109,A02,083214,Anzaldo; Leesa B,0,7,30,30
1650445901935,MATH 109,B01,083215,Anzaldo; Leesa B,0,5,30,30
1650445901935,MATH 109,B02,083216,Anzaldo; Leesa B,0,6,30,30
1650445907960,MATH 142A,A01,083219,Chow; Bennett,0,14,30,30
1650445907960,MATH 142A,A02,083220,Chow; Bennett,0,13,30,30
1650445907960,MATH 142A,B01,083221,Chow; Bennett,0,12,30,30
1650445907960,MATH 142A,B02,083222,Chow; Bennett,0,13,30,30
1650445913987,MATH 193A,A01,083224,Staff,0,5,30,30
1650445913987,MATH 193A,A02,083225,Staff,0,5,30,30
1650445913987,MATH 193A,A03,083781,Staff,0,4,30,30
1650445913987,MATH 193A,A04,083782,Staff,0,5,30,30
1650445920014,MATH 197,001,091859,McAuley; Julian John,9998,0,9999,1
1650445926074,COGS 9,A01,083615,Staff,0,14,60,60
1650445932099,COGS 11,A01,083617,Boyle; Mary E. T.,21,0,40,19
1650445938122,COGS 13,A01,083071,Staff,0,34,40,40
1650445944144,COGS 14A,A01,092681,Staff,1,25,100,99
1650445950171,COGS 14B,A01,083073,Cheng; Tzu-Han,0,11,50,50
1650445956758,COGS 17,A01,092677,Staff,22,0,75,53
1650445962782,COGS 100,A01,083619,Staff,0,26,60,60
1650445968807,COGS 101A,A01,083621,Davis; Joshua Daniel,0,21,60,60
1650445974838,COGS 101B,A01,091572,Staff,0,4,60,60
1650445980866,COGS 101C,A01,083625,Delgado; Tania,16,0,30,14
1650445986891,COGS 107A,A01,083627,Boyle; Mary E. T.,0,11,60,60
1650445992918,COGS 118A,A01,083075,Staff,2,0,60,58
1650445998946,CSE 3,A50,083646,Miranda; Gregory Joseph,20,0,38,18
1650445998946,CSE 3,A51,083647,Miranda; Gregory Joseph,36,0,37,1
1650446004970,CSE 8A,A50,083650,Miranda; Gregory Joseph,0,28,40,40
1650446010994,CSE 11,A01,083080,Cao; Yingjun,0,92,40,40
1650446017021,CSE 12,A01,083652,Staff,0,16,100,100
1650446023046,CSE 15L,A01,083654,Staff,0,1,50,50
1650446023046,CSE 15L,A02,083655,Staff,1,0,50,49
1650446029071,CSE 20,A01,083657,Staff,51,0,80,29
1650446035095,CSE 30,A01,083084,Eldon; John,0,76,40,40
1650446041123,CSE 100,A01,083659,Cao; Yingjun,0,66,50,50
1650446047148,CSE 134B,A01,083661,Powell; Thomas Allan,0,32,65,65
1650446053173,CSE 140,A01,083663,Staff,0,2,75,75
1650446059195,CSE 140L,A01,083088,Eldon; John,0,8,75,75
1650446065221,CSE 175,A01,083665,Kumar; Rakesh,7,0,25,18
1650446071245,CSE 190,A00,092507,Dubnov; Shlomo,14,0,20,6
1650446077268,ECE 45,A01,083139,Staff,0,18,40,40
1650446083291,ECE 65,A50,083695,Staff,0,6,30,30
1650446089318,ECE 109,A01,091882,Touri; Behrouz,38,0,70,32
1650446095342,ECE 180,A00,083140,Abi Samra; Nicholas Camill,23,0,30,7
1650446095342,ECE 180,B00,083141,Abi Samra; Nicholas Camill,0,0,30,30
1650446101367,MATH 10A,A01,083735,Patchell; Gregory David,7,0,30,23
1650446101367,MATH 10A,A02,083736,Patchell; Gregory David,28,0,30,2
1650446101367,MATH 10A,A03,083737,Patchell; Gregory David,25,0,30,5
1650446107391,MATH 10B,A01,083207,Staff,0,7,30,30
1650446107391,MATH 10B,A02,083208,Staff,0,7,30,30
1650446107391,MATH 10B,B01,083739,Staff,13,0,30,17
1650446107391,MATH 10B,B02,083740,Staff,28,0,30,2
1650446113421,MATH 18,A01,083743,Staff,1,0,30,29
1650446113421,MATH 18,A02,083744,Staff,27,0,30,3
1650446113421,MATH 18,A03,083745,Staff,22,0,30,8
1650446113421,MATH 18,A04,083746,Staff,26,0,30,4
1650446113421,MATH 18,B01,083748,Staff,0,11,30,30
1650446113421,MATH 18,B02,083749,Staff,0,12,30,30
1650446113421,MATH 18,B03,083750,Staff,0,11,30,30
1650446113421,MATH 18,B04,083751,Staff,0,12,30,30
1650446119447,MATH 20A,A01,083754,Staff,25,0,40,15
1650446125471,MATH 20B,A01,083756,Staff,0,10,30,30
1650446125471,MATH 20B,A02,083757,Staff,0,10,30,30
1650446131496,MATH 20C,A01,083760,Staff,0,15,30,30
1650446131496,MATH 20C,A02,083761,Staff,1,14,30,29
1650446131496,MATH 20C,B01,083762,Staff,13,0,30,17
1650446131496,MATH 20C,B02,083763,Staff,28,0,30,2
1650446137523,MATH 20D,A01,083765,Staff,0,1,30,30
1650446137523,MATH 20D,A02,083766,Staff,9,0,30,21
1650446137523,MATH 20D,A03,083767,Staff,25,0,30,5
1650446143549,MATH 20E,A01,083771,Staff,6,0,30,24
1650446143549,MATH 20E,A02,083772,Staff,18,0,30,12
1650446143549,MATH 20E,B01,083773,Staff,0,0,30,30
1650446143549,MATH 20E,B02,083774,Staff,10,0,30,20
1650446149581,MATH 103A,A01,083777,Staff,0,12,30,30
1650446149581,MATH 103A,A02,083778,Staff,0,12,30,30
1650446149581,MATH 103A,B01,083779,Staff,0,13,30,30
1650446149581,MATH 103A,B02,083780,Staff,0,12,30,30
1650446155608,MATH 105,A01,085443,Staff,0,23,30,30
1650446161728,MATH 109,A01,083213,Anzaldo; Leesa B,0,7,30,30
1650446161728,MATH 109,A02,083214,Anzaldo; Leesa B,0,7,30,30
1650446161728,MATH 109,B01,083215,Anzaldo; Leesa B,0,5,30,30
1650446161728,MATH 109,B02,083216,Anzaldo; Leesa B,0,6,30,30
1650446167751,MATH 142A,A01,083219,Chow; Bennett,0,14,30,30
1650446167751,MATH 142A,A02,083220,Chow; Bennett,0,13,30,30
1650446167751,MATH 142A,B01,083221,Chow; Bennett,0,12,30,30
1650446167751,MATH 142A,B02,083222,Chow; Bennett,0,13,30,30
1650446173779,MATH 193A,A01,083224,Staff,0,5,30,30
1650446173779,MATH 193A,A02,083225,Staff,0,5,30,30
1650446173779,MATH 193A,A03,083781,Staff,0,4,30,30
1650446173779,MATH 193A,A04,083782,Staff,0,5,30,30
1650446179804,MATH 197,001,091859,McAuley; Julian John,9998,0,9999,1
1650446185866,COGS 9,A01,083615,Staff,0,14,60,60
1650446191890,COGS 11,A01,083617,Boyle; Mary E. T.,21,0,40,19
1650446197914,COGS 13,A01,083071,Staff,0,34,40,40
1650446203943,COGS 14A,A01,092681,Staff,1,25,100,99
1650446209973,COGS 14B,A01,083073,Cheng; Tzu-Han,0,11,50,50
1650446215997,COGS 17,A01,092677,Staff,22,0,75,53
1650446222024,COGS 100,A01,083619,Staff,0,26,60,60
1650446228048,COGS 101A,A01,083621,Davis; Joshua Daniel,0,21,60,60
1650446234072,COGS 101B,A01,091572,Staff,0,4,60,60
1650446240095,COGS 101C,A01,083625,Delgado; Tania,16,0,30,14
1650446246120,COGS 107A,A01,083627,Boyle; Mary E. T.,0,11,60,60
1650446252142,COGS 118A,A01,083075,Staff,2,0,60,58
1650446258170,CSE 3,A50,083646,Miranda; Gregory Joseph,20,0,38,18
1650446258170,CSE 3,A51,083647,Miranda; Gregory Joseph,36,0,37,1
1650446264199,CSE 8A,A50,083650,Miranda; Gregory Joseph,0,28,40,40
1650446270224,CSE 11,A01,083080,Cao; Yingjun,0,92,40,40
1650446276248,CSE 12,A01,083652,Staff,0,16,100,100
1650446282270,CSE 15L,A01,083654,Staff,0,1,50,50
1650446282270,CSE 15L,A02,083655,Staff,1,0,50,49
1650446288299,CSE 20,A01,083657,Staff,51,0,80,29
1650446294323,CSE 30,A01,083084,Eldon; John,0,76,40,40
1650446300351,CSE 100,A01,083659,Cao; Yingjun,0,66,50,50
1650446306380,CSE 134B,A01,083661,Powell; Thomas Allan,0,32,65,65
1650446312402,CSE 140,A01,083663,Staff,0,2,75,75
1650446318435,CSE 140L,A01,083088,Eldon; John,0,8,75,75
1650446324459,CSE 175,A01,083665,Kumar; Rakesh,7,0,25,18
1650446330482,CSE 190,A00,092507,Dubnov; Shlomo,14,0,20,6
1650446336512,ECE 45,A01,083139,Staff,0,18,40,40
1650446342539,ECE 65,A50,083695,Staff,0,6,30,30
1650446348563,ECE 109,A01,091882,Touri; Behrouz,38,0,70,32
1650446354590,ECE 180,A00,083140,Abi Samra; Nicholas Camill,23,0,30,7
1650446354590,ECE 180,B00,083141,Abi Samra; Nicholas Camill,0,0,30,30
1650446360616,MATH 10A,A01,083735,Patchell; Gregory David,7,0,30,23
1650446360616,MATH 10A,A02,083736,Patchell; Gregory David,28,0,30,2
1650446360616,MATH 10A,A03,083737,Patchell; Gregory David,25,0,30,5
1650446366644,MATH 10B,A01,083207,Staff,0,7,30,30
1650446366644,MATH 10B,A02,083208,Staff,0,7,30,30
1650446366644,MATH 10B,B01,083739,Staff,13,0,30,17
1650446366644,MATH 10B,B02,083740,Staff,28,0,30,2
1650446372671,MATH 18,A01,083743,Staff,1,0,30,29
1650446372671,MATH 18,A02,083744,Staff,27,0,30,3
1650446372671,MATH 18,A03,083745,Staff,22,0,30,8
1650446372671,MATH 18,A04,083746,Staff,26,0,30,4
1650446372671,MATH 18,B01,083748,Staff,0,11,30,30
1650446372671,MATH 18,B02,083749,Staff,0,12,30,30
1650446372671,MATH 18,B03,083750,Staff,0,11,30,30
1650446372671,MATH 18,B04,083751,Staff,0,12,30,30
1650446378693,MATH 20A,A01,083754,Staff,25,0,40,15
1650446384716,MATH 20B,A01,083756,Staff,0,10,30,30
1650446384716,MATH 20B,A02,083757,Staff,0,10,30,30
1650446390744,MATH 20C,A01,083760,Staff,0,15,30,30
1650446390744,MATH 20C,A02,083761,Staff,1,14,30,29
1650446390744,MATH 20C,B01,083762,Staff,13,0,30,17
1650446390744,MATH 20C,B02,083763,Staff,28,0,30,2
1650446396768,MATH 20D,A01,083765,Staff,0,1,30,30
1650446396768,MATH 20D,A02,083766,Staff,9,0,30,21
1650446396768,MATH 20D,A03,083767,Staff,25,0,30,5
1650446402798,MATH 20E,A01,083771,Staff,6,0,30,24
1650446402798,MATH 20E,A02,083772,Staff,18,0,30,12
1650446402798,MATH 20E,B01,083773,Staff,0,0,30,30
1650446402798,MATH 20E,B02,083774,Staff,10,0,30,20
1650446408826,MATH 103A,A01,083777,Staff,0,12,30,30
1650446408826,MATH 103A,A02,083778,Staff,0,12,30,30
1650446408826,MATH 103A,B01,083779,Staff,0,13,30,30
1650446408826,MATH 103A,B02,083780,Staff,0,12,30,30
1650446414850,MATH 105,A01,085443,Staff,0,23,30,30
1650446420876,MATH 109,A01,083213,Anzaldo; Leesa B,0,7,30,30
1650446420876,MATH 109,A02,083214,Anzaldo; Leesa B,0,7,30,30
1650446420876,MATH 109,B01,083215,Anzaldo; Leesa B,0,5,30,30
1650446420876,MATH 109,B02,083216,Anzaldo; Leesa B,0,6,30,30
1650446426902,MATH 142A,A01,083219,Chow; Bennett,0,14,30,30
1650446426902,MATH 142A,A02,083220,Chow; Bennett,0,13,30,30
1650446426902,MATH 142A,B01,083221,Chow; Bennett,0,12,30,30
1650446426902,MATH 142A,B02,083222,Chow; Bennett,0,13,30,30
1650446432925,MATH 193A,A01,083224,Staff,0,5,30,30
1650446432925,MATH 193A,A02,083225,Staff,0,5,30,30
1650446432925,MATH 193A,A03,083781,Staff,0,4,30,30
1650446432925,MATH 193A,A04,083782,Staff,0,5,30,30
1650446438950,MATH 197,001,091859,McAuley; Julian John,9998,0,9999,1
1650446444997,COGS 9,A01,083615,Staff,0,14,60,60
1650446451030,COGS 11,A01,083617,Boyle; Mary E. T.,21,0,40,19
1650446457054,COGS 13,A01,083071,Staff,0,34,40,40
1650446463083,COGS 14A,A01,092681,Staff,1,25,100,99
1650446469108,COGS 14B,A01,083073,Cheng; Tzu-Han,0,11,50,50
1650446475135,COGS 17,A01,092677,Staff,22,0,75,53
1650446481162,COGS 100,A01,083619,Staff,0,26,60,60
1650446487189,COGS 101A,A01,083621,Davis; Joshua Daniel,0,21,60,60
1650446493212,COGS 101B,A01,091572,Staff,0,4,60,60
1650446499236,COGS 101C,A01,083625,Delgado; Tania,16,0,30,14
1650446505262,COGS 107A,A01,083627,Boyle; Mary E. T.,0,11,60,60
1650446511287,COGS 118A,A01,083075,Staff,2,0,60,58
1650446517315,CSE 3,A50,083646,Miranda; Gregory Joseph,20,0,38,18
1650446517315,CSE 3,A51,083647,Miranda; Gregory Joseph,36,0,37,1
1650446523339,CSE 8A,A50,083650,Miranda; Gregory Joseph,0,28,40,40
1650446529367,CSE 11,A01,083080,Cao; Yingjun,0,92,40,40
1650446535391,CSE 12,A01,083652,Staff,0,16,100,100
1650446541415,CSE 15L,A01,083654,Staff,0,1,50,50
1650446541415,CSE 15L,A02,083655,Staff,1,0,50,49
1650446547438,CSE 20,A01,083657,Staff,51,0,80,29
1650446553463,CSE 30,A01,083084,Eldon; John,0,76,40,40
1650446559491,CSE 100,A01,083659,Cao; Yingjun,0,66,50,50
1650446565516,CSE 134B,A01,083661,Powell; Thomas Allan,0,32,65,65
1650446571543,CSE 140,A01,083663,Staff,0,2,75,75
1650446577569,CSE 140L,A01,083088,Eldon; John,0,8,75,75
1650446583597,CSE 175,A01,083665,Kumar; Rakesh,7,0,25,18
1650446589623,CSE 190,A00,092507,Dubnov; Shlomo,14,0,20,6
1650446595647,ECE 45,A01,083139,Staff,0,18,40,40
1650446601674,ECE 65,A50,083695,Staff,0,6,30,30
1650446607701,ECE 109,A01,091882,Touri; Behrouz,38,0,70,32
1650446613724,ECE 180,A00,083140,Abi Samra; Nicholas Camill,23,0,30,7
1650446613724,ECE 180,B00,083141,Abi Samra; Nicholas Camill,0,0,30,30
1650446619748,MATH 10A,A01,083735,Patchell; Gregory David,7,0,30,23
1650446619748,MATH 10A,A02,083736,Patchell; Gregory David,28,0,30,2
1650446619748,MATH 10A,A03,083737,Patchell; Gregory David,25,0,30,5
1650446625771,MATH 10B,A01,083207,Staff,0,7,30,30
1650446625771,MATH 10B,A02,083208,Staff,0,7,30,30
1650446625771,MATH 10B,B01,083739,Staff,13,0,30,17
1650446625771,MATH 10B,B02,083740,Staff,28,0,30,2
1650446631794,MATH 18,A01,083743,Staff,1,0,30,29
1650446631794,MATH 18,A02,083744,Staff,27,0,30,3
1650446631794,MATH 18,A03,083745,Staff,22,0,30,8
1650446631794,MATH 18,A04,083746,Staff,26,0,30,4
1650446631794,MATH 18,B01,083748,Staff,0,11,30,30
1650446631794,MATH 18,B02,083749,Staff,0,12,30,30
1650446631794,MATH 18,B03,083750,Staff,0,11,30,30
1650446631794,MATH 18,B04,083751,Staff,0,12,30,30
1650446637816,MATH 20A,A01,083754,Staff,25,0,40,15
1650446643846,MATH 20B,A01,083756,Staff,0,10,30,30
1650446643846,MATH 20B,A02,083757,Staff,0,10,30,30
1650446649870,MATH 20C,A01,083760,Staff,0,15,30,30
1650446649870,MATH 20C,A02,083761,Staff,1,14,30,29
1650446649870,MATH 20C,B01,083762,Staff,13,0,30,17
1650446649870,MATH 20C,B02,083763,Staff,28,0,30,2
1650446655894,MATH 20D,A01,083765,Staff,0,1,30,30
1650446655894,MATH 20D,A02,083766,Staff,9,0,30,21
1650446655894,MATH 20D,A03,083767,Staff,25,0,30,5
1650446661919,MATH 20E,A01,083771,Staff,6,0,30,24
1650446661919,MATH 20E,A02,083772,Staff,18,0,30,12
1650446661919,MATH 20E,B01,083773,Staff,0,0,30,30
1650446661919,MATH 20E,B02,083774,Staff,10,0,30,20
1650446667944,MATH 103A,A01,083777,Staff,0,12,30,30
1650446667944,MATH 103A,A02,083778,Staff,0,12,30,30
1650446667944,MATH 103A,B01,083779,Staff,0,13,30,30
1650446667944,MATH 103A,B02,083780,Staff,0,12,30,30
1650446673969,MATH 105,A01,085443,Staff,0,23,30,30
1650446679994,MATH 109,A01,083213,Anzaldo; Leesa B,0,7,30,30
1650446679994,MATH 109,A02,083214,Anzaldo; Leesa B,0,7,30,30
1650446679994,MATH 109,B01,083215,Anzaldo; Leesa B,0,5,30,30
1650446679994,MATH 109,B02,083216,Anzaldo; Leesa B,0,6,30,30
1650446686019,MATH 142A,A01,083219,Chow; Bennett,0,14,30,30
1650446686019,MATH 142A,A02,083220,Chow; Bennett,0,13,30,30
1650446686019,MATH 142A,B01,083221,Chow; Bennett,0,12,30,30
1650446686019,MATH 142A,B02,083222,Chow; Bennett,0,13,30,30
1650446692043,MATH 193A,A01,083224,Staff,0,5,30,30
1650446692043,MATH 193A,A02,083225,Staff,0,5,30,30
1650446692043,MATH 193A,A03,083781,Staff,0,4,30,30
1650446692043,MATH 193A,A04,083782,Staff,0,5,30,30
1650446698068,MATH 197,001,091859,McAuley; Julian John,9998,0,9999,1
1650446704130,COGS 9,A01,083615,Staff,0,14,60,60
1650446710153,COGS 11,A01,083617,Boyle; Mary E. T.,21,0,40,19
1650446716181,COGS 13,A01,083071,Staff,0,34,40,40
1650446722204,COGS 14A,A01,092681,Staff,1,25,100,99
1650446728229,COGS 14B,A01,083073,Cheng; Tzu-Han,0,11,50,50
1650446734251,COGS 17,A01,092677,Staff,22,0,75,53
1650446740277,COGS 100,A01,083619,Staff,0,26,60,60
1650446746302,COGS 101A,A01,083621,Davis; Joshua Daniel,0,21,60,60
1650446752417,COGS 101B,A01,091572,Staff,0,4,60,60
1650446758440,COGS 101C,A01,083625,Delgado; Tania,16,0,30,14
1650446764464,COGS 107A,A01,083627,Boyle; Mary E. T.,0,11,60,60
1650446770488,COGS 118A,A01,083075,Staff,2,0,60,58
1650446776515,CSE 3,A50,083646,Miranda; Gregory Joseph,20,0,38,18
1650446776515,CSE 3,A51,083647,Miranda; Gregory Joseph,36,0,37,1
1650446782544,CSE 8A,A50,083650,Miranda; Gregory Joseph,0,28,40,40
1650446788566,CSE 11,A01,083080,Cao; Yingjun,0,92,40,40
1650446794594,CSE 12,A01,083652,Staff,0,16,100,100
1650446800616,CSE 15L,A01,083654,Staff,0,1,50,50
1650446800616,CSE 15L,A02,083655,Staff,1,0,50,49
1650446806644,CSE 20,A01,083657,Staff,51,0,80,29
1650446812669,CSE 30,A01,083084,Eldon; John,0,76,40,40
1650446818695,CSE 100,A01,083659,Cao; Yingjun,0,66,50,50
1650446824719,CSE 134B,A01,083661,Powell; Thomas Allan,0,32,65,65
1650446830743,CSE 140,A01,083663,Staff,0,2,75,75
1650446836767,CSE 140L,A01,083088,Eldon; John,0,8,75,75
1650446842792,CSE 175,A01,083665,Kumar; Rakesh,7,0,25,18
1650446848814,CSE 190,A00,092507,Dubnov; Shlomo,14,0,20,6
1650446854838,ECE 45,A01,083139,Staff,0,18,40,40
1650446860866,ECE 65,A50,083695,Staff,0,6,30,30
1650446866891,ECE 109,A01,091882,Touri; Behrouz,38,0,70,32
1650446872918,ECE 180,A00,083140,Abi Samra; Nicholas Camill,23,0,30,7
1650446872918,ECE 180,B00,083141,Abi Samra; Nicholas Camill,0,0,30,30
1650446878941,MATH 10A,A01,083735,Patchell; Gregory David,7,0,30,23
1650446878941,MATH 10A,A02,083736,Patchell; Gregory David,28,0,30,2
1650446878941,MATH 10A,A03,083737,Patchell; Gregory David,25,0,30,5
1650446884965,MATH 10B,A01,083207,Staff,0,7,30,30
1650446884965,MATH 10B,A02,083208,Staff,0,7,30,30
1650446884965,MATH 10B,B01,083739,Staff,13,0,30,17
1650446884965,MATH 10B,B02,083740,Staff,28,0,30,2
1650446890991,MATH 18,A01,083743,Staff,1,0,30,29
1650446890991,MATH 18,A02,083744,Staff,27,0,30,3
1650446890991,MATH 18,A03,083745,Staff,22,0,30,8
1650446890991,MATH 18,A04,083746,Staff,26,0,30,4
1650446890991,MATH 18,B01,083748,Staff,0,11,30,30
1650446890991,MATH 18,B02,083749,Staff,0,12,30,30
1650446890991,MATH 18,B03,083750,Staff,0,11,30,30
1650446890991,MATH 18,B04,083751,Staff,0,12,30,30
1650446897014,MATH 20A,A01,083754,Staff,25,0,40,15
1650446903038,MATH 20B,A01,083756,Staff,0,10,30,30
1650446903038,MATH 20B,A02,083757,Staff,0,10,30,30
1650446909061,MATH 20C,A01,083760,Staff,0,15,30,30
1650446909061,MATH 20C,A02,083761,Staff,1,14,30,29
1650446909061,MATH 20C,B01,083762,Staff,13,0,30,17
1650446909061,MATH 20C,B02,083763,Staff,28,0,30,2
1650446915088,MATH 20D,A01,083765,Staff,0,1,30,30
1650446915088,MATH 20D,A02,083766,Staff,9,0,30,21
1650446915088,MATH 20D,A03,083767,Staff,25,0,30,5
1650446921117,MATH 20E,A01,083771,Staff,6,0,30,24
1650446921117,MATH 20E,A02,083772,Staff,18,0,30,12
1650446921117,MATH 20E,B01,083773,Staff,0,0,30,30
1650446921117,MATH 20E,B02,083774,Staff,10,0,30,20
1650446927145,MATH 103A,A01,083777,Staff,0,12,30,30
1650446927145,MATH 103A,A02,083778,Staff,0,12,30,30
1650446927145,MATH 103A,B01,083779,Staff,0,13,30,30
1650446927145,MATH 103A,B02,083780,Staff,0,12,30,30
1650446933171,MATH 105,A01,085443,Staff,0,23,30,30
1650446939200,MATH 109,A01,083213,Anzaldo; Leesa B,0,7,30,30
1650446939200,MATH 109,A02,083214,Anzaldo; Leesa B,0,7,30,30
1650446939200,MATH 109,B01,083215,Anzaldo; Leesa B,0,5,30,30
1650446939200,MATH 109,B02,083216,Anzaldo; Leesa B,0,6,30,30
1650446945228,MATH 142A,A01,083219,Chow; Bennett,0,14,30,30
1650446945228,MATH 142A,A02,083220,Chow; Bennett,0,13,30,30
1650446945228,MATH 142A,B01,083221,Chow; Bennett,0,12,30,30
1650446945228,MATH 142A,B02,083222,Chow; Bennett,0,13,30,30
1650446951251,MATH 193A,A01,083224,Staff,0,5,30,30
1650446951251,MATH 193A,A02,083225,Staff,0,5,30,30
1650446951251,MATH 193A,A03,083781,Staff,0,4,30,30
1650446951251,MATH 193A,A04,083782,Staff,0,5,30,30
1650446957274,MATH 197,001,091859,McAuley; Julian John,9998,0,9999,1
1650446963321,COGS 9,A01,083615,Staff,0,14,60,60
1650446969343,COGS 11,A01,083617,Boyle; Mary E. T.,21,0,40,19
1650446975366,COGS 13,A01,083071,Staff,0,34,40,40
1650446981390,COGS 14A,A01,092681,Staff,1,25,100,99
1650446987414,COGS 14B,A01,083073,Cheng; Tzu-Han,0,11,50,50
1650446993437,COGS 17,A01,092677,Staff,22,0,75,53
1650446999465,COGS 100,A01,083619,Staff,0,26,60,60
1650447005493,COGS 101A,A01,083621,Davis; Joshua Daniel,0,21,60,60
1650447011518,COGS 101B,A01,091572,Staff,0,4,60,60
1650447017546,COGS 101C,A01,083625,Delgado; Tania,16,0,30,14
1650447023569,COGS 107A,A01,083627,Boyle; Mary E. T.,0,11,60,60
1650447029594,COGS 118A,A01,083075,Staff,2,0,60,58
1650447035620,CSE 3,A50,083646,Miranda; Gregory Joseph,20,0,38,18
1650447035620,CSE 3,A51,083647,Miranda; Gregory Joseph,36,0,37,1
1650447041643,CSE 8A,A50,083650,Miranda; Gregory Joseph,0,28,40,40
1650447047665,CSE 11,A01,083080,Cao; Yingjun,0,92,40,40
1650447053693,CSE 12,A01,083652,Staff,0,16,100,100
1650447059720,CSE 15L,A01,083654,Staff,0,1,50,50
1650447059720,CSE 15L,A02,083655,Staff,1,0,50,49
1650447065743,CSE 20,A01,083657,Staff,51,0,80,29
1650447071766,CSE 30,A01,083084,Eldon; John,0,76,40,40
1650447077788,CSE 100,A01,083659,Cao; Yingjun,0,66,50,50
1650447083811,CSE 134B,A01,083661,Powell; Thomas Allan,0,32,65,65
1650447089833,CSE 140,A01,083663,Staff,0,2,75,75
1650447095857,CSE 140L,A01,083088,Eldon; John,0,8,75,75
1650447101882,CSE 175,A01,083665,Kumar; Rakesh,7,0,25,18
1650447107910,CSE 190,A00,092507,Dubnov; Shlomo,14,0,20,6
1650447113936,ECE 45,A01,083139,Staff,0,18,40,40
1650447119964,ECE 65,A50,083695,Staff,0,6,30,30
1650447125990,ECE 109,A01,091882,Touri; Behrouz,38,0,70,32
1650447132017,ECE 180,A00,083140,Abi Samra; Nicholas Camill,23,0,30,7
1650447132017,ECE 180,B00,083141,Abi Samra; Nicholas Camill,0,0,30,30
1650447138043,MATH 10A,A01,083735,Patchell; Gregory David,7,0,30,23
1650447138043,MATH 10A,A02,083736,Patchell; Gregory David,28,0,30,2
1650447138043,MATH 10A,A03,083737,Patchell; Gregory David,25,0,30,5
1650447144068,MATH 10B,A01,083207,Staff,0,7,30,30
1650447144068,MATH 10B,A02,083208,Staff,0,7,30,30
1650447144068,MATH 10B,B01,083739,Staff,13,0,30,17
1650447144068,MATH 10B,B02,083740,Staff,28,0,30,2
1650447150099,MATH 18,A01,083743,Staff,1,0,30,29
1650447150099,MATH 18,A02,083744,Staff,27,0,30,3
1650447150099,MATH 18,A03,083745,Staff,22,0,30,8
1650447150099,MATH 18,A04,083746,Staff,26,0,30,4
1650447150099,MATH 18,B01,083748,Staff,0,11,30,30
1650447150099,MATH 18,B02,083749,Staff,0,12,30,30
1650447150099,MATH 18,B03,083750,Staff,0,11,30,30
1650447150099,MATH 18,B04,083751,Staff,0,12,30,30
1650447156123,MATH 20A,A01,083754,Staff,25,0,40,15
1650447162147,MATH 20B,A01,083756,Staff,0,10,30,30
1650447162147,MATH 20B,A02,083757,Staff,0,10,30,30
1650447168173,MATH 20C,A01,083760,Staff,0,15,30,30
1650447168173,MATH 20C,A02,083761,Staff,1,14,30,29
1650447168173,MATH 20C,B01,083762,Staff,13,0,30,17
1650447168173,MATH 20C,B02,083763,Staff,28,0,30,2
1650447174197,MATH 20D,A01,083765,Staff,0,1,30,30
1650447174197,MATH 20D,A02,083766,Staff,9,0,30,21
1650447174197,MATH 20D,A03,083767,Staff,25,0,30,5
1650447180225,MATH 20E,A01,083771,Staff,6,0,30,24
1650447180225,MATH 20E,A02,083772,Staff,18,0,30,12
1650447180225,MATH 20E,B01,083773,Staff,0,0,30,30
1650447180225,MATH 20E,B02,083774,Staff,10,0,30,20
1650447186253,MATH 103A,A01,083777,Staff,0,12,30,30
1650447186253,MATH 103A,A02,083778,Staff,0,12,30,30
1650447186253,MATH 103A,B01,083779,Staff,0,13,30,30
1650447186253,MATH 103A,B02,083780,Staff,0,12,30,30
1650447192276,MATH 105,A01,085443,Staff,0,23,30,30
1650447198304,MATH 109,A01,083213,Anzaldo; Leesa B,0,7,30,30
1650447198304,MATH 109,A02,083214,Anzaldo; Leesa B,0,7,30,30
1650447198304,MATH 109,B01,083215,Anzaldo; Leesa B,0,5,30,30
1650447198304,MATH 109,B02,083216,Anzaldo; Leesa B,0,6,30,30
1650447204328,MATH 142A,A01,083219,Chow; Bennett,0,14,30,30
1650447204328,MATH 142A,A02,083220,Chow; Bennett,0,13,30,30
1650447204328,MATH 142A,B01,083221,Chow; Bennett,0,12,30,30
1650447204328,MATH 142A,B02,083222,Chow; Bennett,0,13,30,30
1650447210356,MATH 193A,A01,083224,Staff,0,5,30,30
1650447210356,MATH 193A,A02,083225,Staff,0,5,30,30
1650447210356,MATH 193A,A03,083781,Staff,0,4,30,30
1650447210356,MATH 193A,A04,083782,Staff,0,5,30,30
1650447216379,MATH 197,001,091859,McAuley; Julian John,9998,0,9999,1
1650447222430,COGS 9,A01,083615,Staff,0,14,60,60
1650447228453,COGS 11,A01,083617,Boyle; Mary E. T.,21,0,40,19
1650447234484,COGS 13,A01,083071,Staff,0,34,40,40
1650447240513,COGS 14A,A01,092681,Staff,1,25,100,99
1650447246538,COGS 14B,A01,083073,Cheng; Tzu-Han,0,11,50,50
1650447252565,COGS 17,A01,092677,Staff,22,0,75,53
1650447258587,COGS 100,A01,083619,Staff,0,26,60,60
1650447264621,COGS 101A,A01,083621,Davis; Joshua Daniel,0,21,60,60
1650447270647,COGS 101B,A01,091572,Staff,0,4,60,60
1650447276670,COGS 101C,A01,083625,Delgado; Tania,16,0,30,14
1650447282692,COGS 107A,A01,083627,Boyle; Mary E. T.,0,11,60,60
1650447288723,COGS 118A,A01,083075,Staff,2,0,60,58
1650447294745,CSE 3,A50,083646,Miranda; Gregory Joseph,20,0,38,18
1650447294745,CSE 3,A51,083647,Miranda; Gregory Joseph,36,0,37,1
1650447300773,CSE 8A,A50,083650,Miranda; Gregory Joseph,0,28,40,40
1650447306795,CSE 11,A01,083080,Cao; Yingjun,0,92,40,40
1650447312820,CSE 12,A01,083652,Staff,0,16,100,100
1650447318843,CSE 15L,A01,083654,Staff,0,1,50,50
1650447318843,CSE 15L,A02,083655,Staff,1,0,50,49
1650447324874,CSE 20,A01,083657,Staff,51,0,80,29
1650447330896,CSE 30,A01,083084,Eldon; John,0,76,40,40
1650447336924,CSE 100,A01,083659,Cao; Yingjun,0,66,50,50
1650447342952,CSE 134B,A01,083661,Powell; Thomas Allan,0,32,65,65
1650447349086,CSE 140,A01,083663,Staff,0,2,75,75
1650447355110,CSE 140L,A01,083088,Eldon; John,0,8,75,75
1650447361140,CSE 175,A01,083665,Kumar; Rakesh,7,0,25,18
1650447367169,CSE 190,A00,092507,Dubnov; Shlomo,14,0,20,6
1650447373194,ECE 45,A01,083139,Staff,0,18,40,40
1650447379221,ECE 65,A50,083695,Staff,0,6,30,30
1650447385245,ECE 109,A01,091882,Touri; Behrouz,38,0,70,32
1650447391268,ECE 180,A00,083140,Abi Samra; Nicholas Camill,23,0,30,7
1650447391268,ECE 180,B00,083141,Abi Samra; Nicholas Camill,0,0,30,30
1650447397293,MATH 10A,A01,083735,Patchell; Gregory David,7,0,30,23
1650447397293,MATH 10A,A02,083736,Patchell; Gregory David,28,0,30,2
1650447397293,MATH 10A,A03,083737,Patchell; Gregory David,25,0,30,5
1650447403320,MATH 10B,A01,083207,Staff,0,7,30,30
1650447403320,MATH 10B,A02,083208,Staff,0,7,30,30
1650447403320,MATH 10B,B01,083739,Staff,13,0,30,17
1650447403320,MATH 10B,B02,083740,Staff,28,0,30,2
1650447409343,MATH 18,A01,083743,Staff,1,0,30,29
1650447409343,MATH 18,A02,083744,Staff,27,0,30,3
1650447409343,MATH 18,A03,083745,Staff,22,0,30,8
1650447409343,MATH 18,A04,083746,Staff,26,0,30,4
1650447409343,MATH 18,B01,083748,Staff,0,11,30,30
1650447409343,MATH 18,B02,083749,Staff,0,12,30,30
1650447409343,MATH 18,B03,083750,Staff,0,11,30,30
1650447409343,MATH 18,B04,083751,Staff,0,12,30,30
1650447415367,MATH 20A,A01,083754,Staff,25,0,40,15
1650447421394,MATH 20B,A01,083756,Staff,0,10,30,30
1650447421394,MATH 20B,A02,083757,Staff,0,10,30,30
1650447427422,MATH 20C,A01,083760,Staff,0,15,30,30
1650447427422,MATH 20C,A02,083761,Staff,1,14,30,29
1650447427422,MATH 20C,B01,083762,Staff,13,0,30,17
1650447427422,MATH 20C,B02,083763,Staff,28,0,30,2
1650447433447,MATH 20D,A01,083765,Staff,0,1,30,30
1650447433447,MATH 20D,A02,083766,Staff,9,0,30,21
1650447433447,MATH 20D,A03,083767,Staff,25,0,30,5
1650447439471,MATH 20E,A01,083771,Staff,6,0,30,24
1650447439471,MATH 20E,A02,083772,Staff,18,0,30,12
1650447439471,MATH 20E,B01,083773,Staff,0,0,30,30
1650447439471,MATH 20E,B02,083774,Staff,10,0,30,20
1650447445499,MATH 103A,A01,083777,Staff,0,12,30,30
1650447445499,MATH 103A,A02,083778,Staff,0,12,30,30
1650447445499,MATH 103A,B01,083779,Staff,0,13,30,30
1650447445499,MATH 103A,B02,083780,Staff,0,12,30,30
1650447451526,MATH 105,A01,085443,Staff,0,23,30,30
1650447457550,MATH 109,A01,083213,Anzaldo; Leesa B,0,7,30,30
1650447457550,MATH 109,A02,083214,Anzaldo; Leesa B,0,7,30,30
1650447457550,MATH 109,B01,083215,Anzaldo; Leesa B,0,5,30,30
1650447457550,MATH 109,B02,083216,Anzaldo; Leesa B,0,6,30,30
1650447463573,MATH 142A,A01,083219,Chow; Bennett,0,14,30,30
1650447463573,MATH 142A,A02,083220,Chow; Bennett,0,13,30,30
1650447463573,MATH 142A,B01,083221,Chow; Bennett,0,12,30,30
1650447463573,MATH 142A,B02,083222,Chow; Bennett,0,13,30,30
1650447469596,MATH 193A,A01,083224,Staff,0,5,30,30
1650447469596,MATH 193A,A02,083225,Staff,0,5,30,30
1650447469596,MATH 193A,A03,083781,Staff,0,4,30,30
1650447469596,MATH 193A,A04,083782,Staff,0,5,30,30
1650447475620,MATH 197,001,091859,McAuley; Julian John,9998,0,9999,1
1650447481668,COGS 9,A01,083615,Staff,0,14,60,60
1650447487692,COGS 11,A01,083617,Boyle; Mary E. T.,21,0,40,19
1650447493717,COGS 13,A01,083071,Staff,0,34,40,40
1650447499741,COGS 14A,A01,092681,Staff,1,25,100,99
1650447505767,COGS 14B,A01,083073,Cheng; Tzu-Han,0,11,50,50
1650447511792,COGS 17,A01,092677,Staff,22,0,75,53
1650447517818,COGS 100,A01,083619,Staff,0,26,60,60
1650447523842,COGS 101A,A01,083621,Davis; Joshua Daniel,0,21,60,60
1650447529866,COGS 101B,A01,091572,Staff,0,4,60,60
1650447535891,COGS 101C,A01,083625,Delgado; Tania,16,0,30,14
1650447541915,COGS 107A,A01,083627,Boyle; Mary E. T.,0,11,60,60
1650447547942,COGS 118A,A01,083075,Staff,2,0,60,58
1650447553966,CSE 3,A50,083646,Miranda; Gregory Joseph,20,0,38,18
1650447553966,CSE 3,A51,083647,Miranda; Gregory Joseph,36,0,37,1
1650447559990,CSE 8A,A50,083650,Miranda; Gregory Joseph,0,28,40,40
1650447566013,CSE 11,A01,083080,Cao; Yingjun,0,92,40,40
1650447572040,CSE 12,A01,083652,Staff,0,16,100,100
1650447578066,CSE 15L,A01,083654,Staff,0,1,50,50
1650447578066,CSE 15L,A02,083655,Staff,1,0,50,49
1650447584090,CSE 20,A01,083657,Staff,51,0,80,29
1650447590114,CSE 30,A01,083084,Eldon; John,0,76,40,40
1650447596142,CSE 100,A01,083659,Cao; Yingjun,0,66,50,50
1650447602166,CSE 134B,A01,083661,Powell; Thomas Allan,0,32,65,65
1650447608189,CSE 140,A01,083663,Staff,0,2,75,75
1650447614218,CSE 140L,A01,083088,Eldon; John,0,8,75,75
1650447620243,CSE 175,A01,083665,Kumar; Rakesh,7,0,25,18
1650447626266,CSE 190,A00,092507,Dubnov; Shlomo,14,0,20,6
1650447632297,ECE 45,A01,083139,Staff,0,18,40,40
1650447638323,ECE 65,A50,083695,Staff,0,6,30,30
1650447644348,ECE 109,A01,091882,Touri; Behrouz,38,0,70,32
1650447650372,ECE 180,A00,083140,Abi Samra; Nicholas Camill,23,0,30,7
1650447650372,ECE 180,B00,083141,Abi Samra; Nicholas Camill,0,0,30,30
1650447656401,MATH 10A,A01,083735,Patchell; Gregory David,7,0,30,23
1650447656401,MATH 10A,A02,083736,Patchell; Gregory David,28,0,30,2
1650447656401,MATH 10A,A03,083737,Patchell; Gregory David,25,0,30,5
1650447662431,MATH 10B,A01,083207,Staff,0,7,30,30
1650447662431,MATH 10B,A02,083208,Staff,0,7,30,30
1650447662431,MATH 10B,B01,083739,Staff,13,0,30,17
1650447662431,MATH 10B,B02,083740,Staff,28,0,30,2
1650447668456,MATH 18,A01,083743,Staff,1,0,30,29
1650447668456,MATH 18,A02,083744,Staff,27,0,30,3
1650447668456,MATH 18,A03,083745,Staff,22,0,30,8
1650447668456,MATH 18,A04,083746,Staff,26,0,30,4
1650447668456,MATH 18,B01,083748,Staff,0,11,30,30
1650447668456,MATH 18,B02,083749,Staff,0,12,30,30
1650447668456,MATH 18,B03,083750,Staff,0,11,30,30
1650447668456,MATH 18,B04,083751,Staff,0,12,30,30
1650447674481,MATH 20A,A01,083754,Staff,25,0,40,15
1650447680508,MATH 20B,A01,083756,Staff,0,10,30,30
1650447680508,MATH 20B,A02,083757,Staff,0,10,30,30
1650447686535,MATH 20C,A01,083760,Staff,0,15,30,30
1650447686535,MATH 20C,A02,083761,Staff,1,14,30,29
1650447686535,MATH 20C,B01,083762,Staff,13,0,30,17
1650447686535,MATH 20C,B02,083763,Staff,28,0,30,2
1650447692563,MATH 20D,A01,083765,Staff,0,1,30,30
1650447692563,MATH 20D,A02,083766,Staff,9,0,30,21
1650447692563,MATH 20D,A03,083767,Staff,25,0,30,5
1650447698589,MATH 20E,A01,083771,Staff,6,0,30,24
1650447698589,MATH 20E,A02,083772,Staff,18,0,30,12
1650447698589,MATH 20E,B01,083773,Staff,0,0,30,30
1650447698589,MATH 20E,B02,083774,Staff,10,0,30,20
1650447704614,MATH 103A,A01,083777,Staff,0,12,30,30
1650447704614,MATH 103A,A02,083778,Staff,0,12,30,30
1650447704614,MATH 103A,B01,083779,Staff,0,13,30,30
1650447704614,MATH 103A,B02,083780,Staff,0,12,30,30
1650447710641,MATH 105,A01,085443,Staff,0,23,30,30
1650447716666,MATH 109,A01,083213,Anzaldo; Leesa B,0,7,30,30
1650447716666,MATH 109,A02,083214,Anzaldo; Leesa B,0,7,30,30
1650447716666,MATH 109,B01,083215,Anzaldo; Leesa B,0,5,30,30
1650447716666,MATH 109,B02,083216,Anzaldo; Leesa B,0,6,30,30
1650447722691,MATH 142A,A01,083219,Chow; Bennett,0,14,30,30
1650447722691,MATH 142A,A02,083220,Chow; Bennett,0,13,30,30
1650447722691,MATH 142A,B01,083221,Chow; Bennett,0,12,30,30
1650447722691,MATH 142A,B02,083222,Chow; Bennett,0,13,30,30
1650447728715,MATH 193A,A01,083224,Staff,0,5,30,30
1650447728715,MATH 193A,A02,083225,Staff,0,5,30,30
1650447728715,MATH 193A,A03,083781,Staff,0,4,30,30
1650447728715,MATH 193A,A04,083782,Staff,0,5,30,30
1650447734746,MATH 197,001,091859,McAuley; Julian John,9998,0,9999,1
1650447740810,COGS 9,A01,083615,Staff,0,14,60,60
1650447746838,COGS 11,A01,083617,Boyle; Mary E. T.,21,0,40,19
1650447752861,COGS 13,A01,083071,Staff,0,34,40,40
1650447758882,COGS 14A,A01,092681,Staff,1,25,100,99
1650447764906,COGS 14B,A01,083073,Cheng; Tzu-Han,0,11,50,50
1650447770929,COGS 17,A01,092677,Staff,22,0,75,53
1650447776952,COGS 100,A01,083619,Staff,0,26,60,60
1650447782976,COGS 101A,A01,083621,Davis; Joshua Daniel,0,21,60,60
1650447789003,COGS 101B,A01,091572,Staff,0,4,60,60
1650447795029,COGS 101C,A01,083625,Delgado; Tania,16,0,30,14
1650447801056,COGS 107A,A01,083627,Boyle; Mary E. T.,0,11,60,60
1650447807080,COGS 118A,A01,083075,Staff,2,0,60,58
1650447813103,CSE 3,A50,083646,Miranda; Gregory Joseph,20,0,38,18
1650447813103,CSE 3,A51,083647,Miranda; Gregory Joseph,36,0,37,1
1650447819131,CSE 8A,A50,083650,Miranda; Gregory Joseph,0,28,40,40
1650447825155,CSE 11,A01,083080,Cao; Yingjun,0,92,40,40
1650447831181,CSE 12,A01,083652,Staff,0,16,100,100
1650447837205,CSE 15L,A01,083654,Staff,0,1,50,50
1650447837205,CSE 15L,A02,083655,Staff,1,0,50,49
1650447843229,CSE 20,A01,083657,Staff,51,0,80,29
1650447849256,CSE 30,A01,083084,Eldon; John,0,76,40,40
1650447855282,CSE 100,A01,083659,Cao; Yingjun,0,66,50,50
1650447861309,CSE 134B,A01,083661,Powell; Thomas Allan,0,32,65,65
1650447867331,CSE 140,A01,083663,Staff,0,2,75,75
1650447873357,CSE 140L,A01,083088,Eldon; John,0,8,75,75
1650447879380,CSE 175,A01,083665,Kumar; Rakesh,7,0,25,18
1650447885403,CSE 190,A00,092507,Dubnov; Shlomo,14,0,20,6
1650447891435,ECE 45,A01,083139,Staff,0,18,40,40
1650447897462,ECE 65,A50,083695,Staff,0,6,30,30
1650447903487,ECE 109,A01,091882,Touri; Behrouz,38,0,70,32
1650447909511,ECE 180,A00,083140,Abi Samra; Nicholas Camill,23,0,30,7
1650447909511,ECE 180,B00,083141,Abi Samra; Nicholas Camill,0,0,30,30
1650447915534,MATH 10A,A01,083735,Patchell; Gregory David,7,0,30,23
1650447915534,MATH 10A,A02,083736,Patchell; Gregory David,28,0,30,2
1650447915534,MATH 10A,A03,083737,Patchell; Gregory David,25,0,30,5
1650447921559,MATH 10B,A01,083207,Staff,0,7,30,30
1650447921559,MATH 10B,A02,083208,Staff,0,7,30,30
1650447921559,MATH 10B,B01,083739,Staff,13,0,30,17
1650447921559,MATH 10B,B02,083740,Staff,28,0,30,2
1650447927586,MATH 18,A01,083743,Staff,1,0,30,29
1650447927586,MATH 18,A02,083744,Staff,27,0,30,3
1650447927586,MATH 18,A03,083745,Staff,22,0,30,8
1650447927586,MATH 18,A04,083746,Staff,26,0,30,4
1650447927586,MATH 18,B01,083748,Staff,0,11,30,30
1650447927586,MATH 18,B02,083749,Staff,0,12,30,30
1650447927586,MATH 18,B03,083750,Staff,0,11,30,30
1650447927586,MATH 18,B04,083751,Staff,0,12,30,30
1650447933617,MATH 20A,A01,083754,Staff,25,0,40,15
1650447939641,MATH 20B,A01,083756,Staff,0,10,30,30
1650447939641,MATH 20B,A02,083757,Staff,0,10,30,30
1650447945757,MATH 20C,A01,083760,Staff,0,15,30,30
1650447945757,MATH 20C,A02,083761,Staff,1,14,30,29
1650447945757,MATH 20C,B01,083762,Staff,13,0,30,17
1650447945757,MATH 20C,B02,083763,Staff,28,0,30,2
1650447951781,MATH 20D,A01,083765,Staff,0,1,30,30
1650447951781,MATH 20D,A02,083766,Staff,9,0,30,21
1650447951781,MATH 20D,A03,083767,Staff,25,0,30,5
1650447957803,MATH 20E,A01,083771,Staff,6,0,30,24
1650447957803,MATH 20E,A02,083772,Staff,18,0,30,12
1650447957803,MATH 20E,B01,083773,Staff,0,0,30,30
1650447957803,MATH 20E,B02,083774,Staff,10,0,30,20
1650447963830,MATH 103A,A01,083777,Staff,0,12,30,30
1650447963830,MATH 103A,A02,083778,Staff,0,12,30,30
1650447963830,MATH 103A,B01,083779,Staff,0,13,30,30
1650447963830,MATH 103A,B02,083780,Staff,0,12,30,30
1650447969853,MATH 105,A01,085443,Staff,0,23,30,30
1650447975878,MATH 109,A01,083213,Anzaldo; Leesa B,0,7,30,30
1650447975878,MATH 109,A02,083214,Anzaldo; Leesa B,0,7,30,30
1650447975878,MATH 109,B01,083215,Anzaldo; Leesa B,0,5,30,30
1650447975878,MATH 109,B02,083216,Anzaldo; Leesa B,0,6,30,30
1650447981901,MATH 142A,A01,083219,Chow; Bennett,0,14,30,30
1650447981901,MATH 142A,A02,083220,Chow; Bennett,0,13,30,30
1650447981901,MATH 142A,B01,083221,Chow; Bennett,0,12,30,30
1650447981901,MATH 142A,B02,083222,Chow; Bennett,0,13,30,30
1650447987928,MATH 193A,A01,083224,Staff,0,5,30,30
1650447987928,MATH 193A,A02,083225,Staff,0,5,30,30
1650447987928,MATH 193A,A03,083781,Staff,0,4,30,30
1650447987928,MATH 193A,A04,083782,Staff,0,5,30,30
1650447993953,MATH 197,001,091859,McAuley; Julian John,9998,0,9999,1
1650448000004,COGS 9,A01,083615,Staff,0,14,60,60
1650448006027,COGS 11,A01,083617,Boyle; Mary E. T.,21,0,40,19
1650448012060,COGS 13,A01,083071,Staff,0,34,40,40
1650448018084,COGS 14A,A01,092681,Staff,1,25,100,99
1650448024107,COGS 14B,A01,083073,Cheng; Tzu-Han,0,11,50,50
1650448030131,COGS 17,A01,092677,Staff,22,0,75,53
1650448036154,COGS 100,A01,083619,Staff,0,26,60,60
1650448042181,COGS 101A,A01,083621,Davis; Joshua Daniel,0,21,60,60
1650448048205,COGS 101B,A01,091572,Staff,0,4,60,60
1650448054232,COGS 101C,A01,083625,Delgado; Tania,16,0,30,14
1650448060256,COGS 107A,A01,083627,Boyle; Mary E. T.,0,11,60,60
1650448066281,COGS 118A,A01,083075,Staff,2,0,60,58
1650448072309,CSE 3,A50,083646,Miranda; Gregory Joseph,20,0,38,18
1650448072309,CSE 3,A51,083647,Miranda; Gregory Joseph,36,0,37,1
1650448078332,CSE 8A,A50,083650,Miranda; Gregory Joseph,0,28,40,40
1650448084356,CSE 11,A01,083080,Cao; Yingjun,0,92,40,40
1650448090384,CSE 12,A01,083652,Staff,0,16,100,100
1650448096408,CSE 15L,A01,083654,Staff,0,1,50,50
1650448096408,CSE 15L,A02,083655,Staff,1,0,50,49
1650448102435,CSE 20,A01,083657,Staff,51,0,80,29
1650448108458,CSE 30,A01,083084,Eldon; John,0,76,40,40
1650448114482,CSE 100,A01,083659,Cao; Yingjun,0,66,50,50
1650448120505,CSE 134B,A01,083661,Powell; Thomas Allan,0,32,65,65
1650448126531,CSE 140,A01,083663,Staff,0,2,75,75
1650448132564,CSE 140L,A01,083088,Eldon; John,0,8,75,75
1650448138588,CSE 175,A01,083665,Kumar; Rakesh,7,0,25,18
1650448144614,CSE 190,A00,092507,Dubnov; Shlomo,14,0,20,6
1650448150638,ECE 45,A01,083139,Staff,0,18,40,40
1650448156662,ECE 65,A50,083695,Staff,0,6,30,30
1650448162687,ECE 109,A01,091882,Touri; Behrouz,38,0,70,32
1650448168714,ECE 180,A00,083140,Abi Samra; Nicholas Camill,23,0,30,7
1650448168714,ECE 180,B00,083141,Abi Samra; Nicholas Camill,0,0,30,30
1650448174742,MATH 10A,A01,083735,Patchell; Gregory David,7,0,30,23
1650448174742,MATH 10A,A02,083736,Patchell; Gregory David,28,0,30,2
1650448174742,MATH 10A,A03,083737,Patchell; Gregory David,25,0,30,5
1650448180774,MATH 10B,A01,083207,Staff,0,7,30,30
1650448180774,MATH 10B,A02,083208,Staff,0,7,30,30
1650448180774,MATH 10B,B01,083739,Staff,13,0,30,17
1650448180774,MATH 10B,B02,083740,Staff,28,0,30,2
1650448186799,MATH 18,A01,083743,Staff,1,0,30,29
1650448186799,MATH 18,A02,083744,Staff,27,0,30,3
1650448186799,MATH 18,A03,083745,Staff,22,0,30,8
1650448186799,MATH 18,A04,083746,Staff,26,0,30,4
1650448186799,MATH 18,B01,083748,Staff,0,11,30,30
1650448186799,MATH 18,B02,083749,Staff,0,12,30,30
1650448186799,MATH 18,B03,083750,Staff,0,11,30,30
1650448186799,MATH 18,B04,083751,Staff,0,12,30,30
1650448192823,MATH 20A,A01,083754,Staff,25,0,40,15
1650448198849,MATH 20B,A01,083756,Staff,0,10,30,30
1650448198849,MATH 20B,A02,083757,Staff,0,10,30,30
1650448204872,MATH 20C,A01,083760,Staff,0,15,30,30
1650448204872,MATH 20C,A02,083761,Staff,1,14,30,29
1650448204872,MATH 20C,B01,083762,Staff,13,0,30,17
1650448204872,MATH 20C,B02,083763,Staff,28,0,30,2
1650448210900,MATH 20D,A01,083765,Staff,0,1,30,30
1650448210900,MATH 20D,A02,083766,Staff,9,0,30,21
1650448210900,MATH 20D,A03,083767,Staff,25,0,30,5
1650448216927,MATH 20E,A01,083771,Staff,6,0,30,24
1650448216927,MATH 20E,A02,083772,Staff,18,0,30,12
1650448216927,MATH 20E,B01,083773,Staff,0,0,30,30
1650448216927,MATH 20E,B02,083774,Staff,10,0,30,20
1650448222952,MATH 103A,A01,083777,Staff,0,12,30,30
1650448222952,MATH 103A,A02,083778,Staff,0,12,30,30
1650448222952,MATH 103A,B01,083779,Staff,0,13,30,30
1650448222952,MATH 103A,B02,083780,Staff,0,12,30,30
1650448228977,MATH 105,A01,085443,Staff,0,23,30,30
1650448235001,MATH 109,A01,083213,Anzaldo; Leesa B,0,7,30,30
1650448235001,MATH 109,A02,083214,Anzaldo; Leesa B,0,7,30,30
1650448235001,MATH 109,B01,083215,Anzaldo; Leesa B,0,5,30,30
1650448235001,MATH 109,B02,083216,Anzaldo; Leesa B,0,6,30,30
1650448241029,MATH 142A,A01,083219,Chow; Bennett,0,14,30,30
1650448241029,MATH 142A,A02,083220,Chow; Bennett,0,13,30,30
1650448241029,MATH 142A,B01,083221,Chow; Bennett,0,12,30,30
1650448241029,MATH 142A,B02,083222,Chow; Bennett,0,13,30,30
1650448247052,MATH 193A,A01,083224,Staff,0,5,30,30
1650448247052,MATH 193A,A02,083225,Staff,0,5,30,30
1650448247052,MATH 193A,A03,083781,Staff,0,4,30,30
1650448247052,MATH 193A,A04,083782,Staff,0,5,30,30
1650448253074,MATH 197,001,091859,McAuley; Julian John,9998,0,9999,1
1650448259125,COGS 9,A01,083615,Staff,0,14,60,60
1650448265149,COGS 11,A01,083617,Boyle; Mary E. T.,21,0,40,19
1650448271173,COGS 13,A01,083071,Staff,0,34,40,40
1650448277197,COGS 14A,A01,092681,Staff,1,25,100,99
1650448283223,COGS 14B,A01,083073,Cheng; Tzu-Han,0,11,50,50
1650448289248,COGS 17,A01,092677,Staff,22,0,75,53
1650448295275,COGS 100,A01,083619,Staff,0,26,60,60
1650448301299,COGS 101A,A01,083621,Davis; Joshua Daniel,0,21,60,60
1650448307326,COGS 101B,A01,091572,Staff,0,4,60,60
1650448313349,COGS 101C,A01,083625,Delgado; Tania,16,0,30,14
1650448319372,COGS 107A,A01,083627,Boyle; Mary E. T.,0,11,60,60
1650448325398,COGS 118A,A01,083075,Staff,2,0,60,58
1650448331425,CSE 3,A50,083646,Miranda; Gregory Joseph,20,0,38,18
1650448331425,CSE 3,A51,083647,Miranda; Gregory Joseph,36,0,37,1
1650448337450,CSE 8A,A50,083650,Miranda; Gregory Joseph,0,28,40,40
1650448343474,CSE 11,A01,083080,Cao; Yingjun,0,92,40,40
1650448349497,CSE 12,A01,083652,Staff,0,16,100,100
1650448355521,CSE 15L,A01,083654,Staff,0,1,50,50
1650448355521,CSE 15L,A02,083655,Staff,1,0,50,49
1650448361543,CSE 20,A01,083657,Staff,51,0,80,29
1650448367567,CSE 30,A01,083084,Eldon; John,0,76,40,40
1650448373593,CSE 100,A01,083659,Cao; Yingjun,0,66,50,50
1650448379619,CSE 134B,A01,083661,Powell; Thomas Allan,0,32,65,65
1650448385645,CSE 140,A01,083663,Staff,0,2,75,75
1650448391669,CSE 140L,A01,083088,Eldon; John,0,8,75,75
1650448397691,CSE 175,A01,083665,Kumar; Rakesh,7,0,25,18
1650448403719,CSE 190,A00,092507,Dubnov; Shlomo,14,0,20,6
1650448409742,ECE 45,A01,083139,Staff,0,18,40,40
1650448415768,ECE 65,A50,083695,Staff,0,6,30,30
1650448421794,ECE 109,A01,091882,Touri; Behrouz,38,0,70,32
1650448427817,ECE 180,A00,083140,Abi Samra; Nicholas Camill,23,0,30,7
1650448427817,ECE 180,B00,083141,Abi Samra; Nicholas Camill,0,0,30,30
1650448433850,MATH 10A,A01,083735,Patchell; Gregory David,7,0,30,23
1650448433850,MATH 10A,A02,083736,Patchell; Gregory David,28,0,30,2
1650448433850,MATH 10A,A03,083737,Patchell; Gregory David,25,0,30,5
1650448439875,MATH 10B,A01,083207,Staff,0,7,30,30
1650448439875,MATH 10B,A02,083208,Staff,0,7,30,30
1650448439875,MATH 10B,B01,083739,Staff,13,0,30,17
1650448439875,MATH 10B,B02,083740,Staff,28,0,30,2
1650448445908,MATH 18,A01,083743,Staff,1,0,30,29
1650448445908,MATH 18,A02,083744,Staff,27,0,30,3
1650448445908,MATH 18,A03,083745,Staff,22,0,30,8
1650448445908,MATH 18,A04,083746,Staff,26,0,30,4
1650448445908,MATH 18,B01,083748,Staff,0,11,30,30
1650448445908,MATH 18,B02,083749,Staff,0,12,30,30
1650448445908,MATH 18,B03,083750,Staff,0,11,30,30
1650448445908,MATH 18,B04,083751,Staff,0,12,30,30
1650448451933,MATH 20A,A01,083754,Staff,25,0,40,15
1650448457956,MATH 20B,A01,083756,Staff,0,10,30,30
1650448457956,MATH 20B,A02,083757,Staff,0,10,30,30
1650448463981,MATH 20C,A01,083760,Staff,0,15,30,30
1650448463981,MATH 20C,A02,083761,Staff,1,14,30,29
1650448463981,MATH 20C,B01,083762,Staff,13,0,30,17
1650448463981,MATH 20C,B02,083763,Staff,28,0,30,2
1650448470004,MATH 20D,A01,083765,Staff,0,1,30,30
1650448470004,MATH 20D,A02,083766,Staff,9,0,30,21
1650448470004,MATH 20D,A03,083767,Staff,25,0,30,5
1650448476031,MATH 20E,A01,083771,Staff,6,0,30,24
1650448476031,MATH 20E,A02,083772,Staff,18,0,30,12
1650448476031,MATH 20E,B01,083773,Staff,0,0,30,30
1650448476031,MATH 20E,B02,083774,Staff,10,0,30,20
1650448482055,MATH 103A,A01,083777,Staff,0,12,30,30
1650448482055,MATH 103A,A02,083778,Staff,0,12,30,30
1650448482055,MATH 103A,B01,083779,Staff,0,13,30,30
1650448482055,MATH 103A,B02,083780,Staff,0,12,30,30
1650448488082,MATH 105,A01,085443,Staff,0,23,30,30
1650448494109,MATH 109,A01,083213,Anzaldo; Leesa B,0,7,30,30
1650448494109,MATH 109,A02,083214,Anzaldo; Leesa B,0,7,30,30
1650448494109,MATH 109,B01,083215,Anzaldo; Leesa B,0,5,30,30
1650448494109,MATH 109,B02,083216,Anzaldo; Leesa B,0,6,30,30
1650448500135,MATH 142A,A01,083219,Chow; Bennett,0,14,30,30
1650448500135,MATH 142A,A02,083220,Chow; Bennett,0,13,30,30
1650448500135,MATH 142A,B01,083221,Chow; Bennett,0,12,30,30
1650448500135,MATH 142A,B02,083222,Chow; Bennett,0,13,30,30
1650448506160,MATH 193A,A01,083224,Staff,0,5,30,30
1650448506160,MATH 193A,A02,083225,Staff,0,5,30,30
1650448506160,MATH 193A,A03,083781,Staff,0,4,30,30
1650448506160,MATH 193A,A04,083782,Staff,0,5,30,30
1650448512186,MATH 197,001,091859,McAuley; Julian John,9998,0,9999,1
1650448518244,COGS 9,A01,083615,Staff,0,14,60,60
1650448524269,COGS 11,A01,083617,Boyle; Mary E. T.,21,0,40,19
1650448530298,COGS 13,A01,083071,Staff,0,34,40,40
1650448536410,COGS 14A,A01,092681,Staff,1,25,100,99
1650448542432,COGS 14B,A01,083073,Cheng; Tzu-Han,0,11,50,50
1650448548458,COGS 17,A01,092677,Staff,22,0,75,53
1650448554482,COGS 100,A01,083619,Staff,0,26,60,60
1650448560511,COGS 101A,A01,083621,Davis; Joshua Daniel,0,21,60,60
1650448566538,COGS 101B,A01,091572,Staff,0,4,60,60
1650448572564,COGS 101C,A01,083625,Delgado; Tania,16,0,30,14
1650448578586,COGS 107A,A01,083627,Boyle; Mary E. T.,0,11,60,60
1650448584612,COGS 118A,A01,083075,Staff,2,0,60,58
1650448590637,CSE 3,A50,083646,Miranda; Gregory Joseph,20,0,38,18
1650448590637,CSE 3,A51,083647,Miranda; Gregory Joseph,36,0,37,1
1650448596664,CSE 8A,A50,083650,Miranda; Gregory Joseph,0,28,40,40
1650448602689,CSE 11,A01,083080,Cao; Yingjun,0,92,40,40
1650448608717,CSE 12,A01,083652,Staff,0,16,100,100
1650448614744,CSE 15L,A01,083654,Staff,0,1,50,50
1650448614744,CSE 15L,A02,083655,Staff,1,0,50,49
1650448620770,CSE 20,A01,083657,Staff,51,0,80,29
1650448626800,CSE 30,A01,083084,Eldon; John,0,76,40,40
1650448632823,CSE 100,A01,083659,Cao; Yingjun,0,66,50,50
1650448638848,CSE 134B,A01,083661,Powell; Thomas Allan,0,32,65,65
1650448644871,CSE 140,A01,083663,Staff,0,2,75,75
1650448650895,CSE 140L,A01,083088,Eldon; John,0,8,75,75
1650448656926,CSE 175,A01,083665,Kumar; Rakesh,7,0,25,18
1650448662952,CSE 190,A00,092507,Dubnov; Shlomo,14,0,20,6
1650448668980,ECE 45,A01,083139,Staff,0,18,40,40
1650448675007,ECE 65,A50,083695,Staff,0,6,30,30
1650448681030,ECE 109,A01,091882,Touri; Behrouz,38,0,70,32
1650448687054,ECE 180,A00,083140,Abi Samra; Nicholas Camill,23,0,30,7
1650448687054,ECE 180,B00,083141,Abi Samra; Nicholas Camill,0,0,30,30
1650448693081,MATH 10A,A01,083735,Patchell; Gregory David,7,0,30,23
1650448693081,MATH 10A,A02,083736,Patchell; Gregory David,28,0,30,2
1650448693081,MATH 10A,A03,083737,Patchell; Gregory David,25,0,30,5
1650448699107,MATH 10B,A01,083207,Staff,0,7,30,30
1650448699107,MATH 10B,A02,083208,Staff,0,7,30,30
1650448699107,MATH 10B,B01,083739,Staff,13,0,30,17
1650448699107,MATH 10B,B02,083740,Staff,28,0,30,2
1650448705135,MATH 18,A01,083743,Staff,1,0,30,29
1650448705135,MATH 18,A02,083744,Staff,27,0,30,3
1650448705135,MATH 18,A03,083745,Staff,22,0,30,8
1650448705135,MATH 18,A04,083746,Staff,26,0,30,4
1650448705135,MATH 18,B01,083748,Staff,0,11,30,30
1650448705135,MATH 18,B02,083749,Staff,0,12,30,30
1650448705135,MATH 18,B03,083750,Staff,0,11,30,30
1650448705135,MATH 18,B04,083751,Staff,0,12,30,30
1650448711163,MATH 20A,A01,083754,Staff,25,0,40,15
1650448717186,MATH 20B,A01,083756,Staff,0,10,30,30
1650448717186,MATH 20B,A02,083757,Staff,0,10,30,30
1650448723214,MATH 20C,A01,083760,Staff,0,15,30,30
1650448723214,MATH 20C,A02,083761,Staff,1,14,30,29
1650448723214,MATH 20C,B01,083762,Staff,13,0,30,17
1650448723214,MATH 20C,B02,083763,Staff,28,0,30,2
1650448729248,MATH 20D,A01,083765,Staff,0,1,30,30
1650448729248,MATH 20D,A02,083766,Staff,9,0,30,21
1650448729248,MATH 20D,A03,083767,Staff,25,0,30,5
1650448735271,MATH 20E,A01,083771,Staff,6,0,30,24
1650448735271,MATH 20E,A02,083772,Staff,18,0,30,12
1650448735271,MATH 20E,B01,083773,Staff,0,0,30,30
1650448735271,MATH 20E,B02,083774,Staff,10,0,30,20
1650448741296,MATH 103A,A01,083777,Staff,0,12,30,30
1650448741296,MATH 103A,A02,083778,Staff,0,12,30,30
1650448741296,MATH 103A,B01,083779,Staff,0,13,30,30
1650448741296,MATH 103A,B02,083780,Staff,0,12,30,30
1650448747324,MATH 105,A01,085443,Staff,0,23,30,30
1650448753349,MATH 109,A01,083213,Anzaldo; Leesa B,0,7,30,30
1650448753349,MATH 109,A02,083214,Anzaldo; Leesa B,0,7,30,30
1650448753349,MATH 109,B01,083215,Anzaldo; Leesa B,0,5,30,30
1650448753349,MATH 109,B02,083216,Anzaldo; Leesa B,0,6,30,30
1650448759372,MATH 142A,A01,083219,Chow; Bennett,0,14,30,30
1650448759372,MATH 142A,A02,083220,Chow; Bennett,0,13,30,30
1650448759372,MATH 142A,B01,083221,Chow; Bennett,0,12,30,30
1650448759372,MATH 142A,B02,083222,Chow; Bennett,0,13,30,30
1650448765399,MATH 193A,A01,083224,Staff,0,5,30,30
1650448765399,MATH 193A,A02,083225,Staff,0,5,30,30
1650448765399,MATH 193A,A03,083781,Staff,0,4,30,30
1650448765399,MATH 193A,A04,083782,Staff,0,5,30,30
1650448771424,MATH 197,001,091859,McAuley; Julian John,9998,0,9999,1
1650448777477,COGS 9,A01,083615,Staff,0,14,60,60
1650448783499,COGS 11,A01,083617,Boyle; Mary E. T.,21,0,40,19
1650448789536,COGS 13,A01,083071,Staff,0,34,40,40
1650448795562,COGS 14A,A01,092681,Staff,1,25,100,99
1650448801588,COGS 14B,A01,083073,Cheng; Tzu-Han,0,11,50,50
1650448807618,COGS 17,A01,092677,Staff,22,0,75,53
1650448813644,COGS 100,A01,083619,Staff,0,26,60,60
1650448819668,COGS 101A,A01,083621,Davis; Joshua Daniel,0,21,60,60
1650448825692,COGS 101B,A01,091572,Staff,0,4,60,60
1650448831715,COGS 101C,A01,083625,Delgado; Tania,16,0,30,14
1650448837739,COGS 107A,A01,083627,Boyle; Mary E. T.,0,11,60,60
1650448843763,COGS 118A,A01,083075,Staff,2,0,60,58
1650448849792,CSE 3,A50,083646,Miranda; Gregory Joseph,20,0,38,18
1650448849792,CSE 3,A51,083647,Miranda; Gregory Joseph,36,0,37,1
1650448855819,CSE 8A,A50,083650,Miranda; Gregory Joseph,0,28,40,40
1650448861843,CSE 11,A01,083080,Cao; Yingjun,0,92,40,40
1650448867866,CSE 12,A01,083652,Staff,0,16,100,100
1650448873893,CSE 15L,A01,083654,Staff,0,1,50,50
1650448873893,CSE 15L,A02,083655,Staff,1,0,50,49
1650448879917,CSE 20,A01,083657,Staff,51,0,80,29
1650448885946,CSE 30,A01,083084,Eldon; John,0,76,40,40
1650448891974,CSE 100,A01,083659,Cao; Yingjun,0,66,50,50
1650448897996,CSE 134B,A01,083661,Powell; Thomas Allan,0,32,65,65
1650448904020,CSE 140,A01,083663,Staff,0,2,75,75
1650448910044,CSE 140L,A01,083088,Eldon; John,0,8,75,75
1650448916070,CSE 175,A01,083665,Kumar; Rakesh,7,0,25,18
1650448922093,CSE 190,A00,092507,Dubnov; Shlomo,14,0,20,6
1650448928119,ECE 45,A01,083139,Staff,0,18,40,40
1650448934143,ECE 65,A50,083695,Staff,0,6,30,30
1650448940167,ECE 109,A01,091882,Touri; Behrouz,38,0,70,32
1650448946191,ECE 180,A00,083140,Abi Samra; Nicholas Camill,23,0,30,7
1650448946191,ECE 180,B00,083141,Abi Samra; Nicholas Camill,0,0,30,30
1650448962755,MATH 10A,A01,083735,Patchell; Gregory David,7,0,30,23
1650448962755,MATH 10A,A02,083736,Patchell; Gregory David,28,0,30,2
1650448962755,MATH 10A,A03,083737,Patchell; Gregory David,25,0,30,5
1650448968779,MATH 10B,A01,083207,Staff,0,7,30,30
1650448968779,MATH 10B,A02,083208,Staff,0,7,30,30
1650448968779,MATH 10B,B01,083739,Staff,13,0,30,17
1650448968779,MATH 10B,B02,083740,Staff,28,0,30,2
1650448974811,MATH 18,A01,083743,Staff,1,0,30,29
1650448974811,MATH 18,A02,083744,Staff,27,0,30,3
1650448974811,MATH 18,A03,083745,Staff,22,0,30,8
1650448974811,MATH 18,A04,083746,Staff,26,0,30,4
1650448974811,MATH 18,B01,083748,Staff,0,11,30,30
1650448974811,MATH 18,B02,083749,Staff,0,12,30,30
1650448974811,MATH 18,B03,083750,Staff,0,11,30,30
1650448974811,MATH 18,B04,083751,Staff,0,12,30,30
1650448980839,MATH 20A,A01,083754,Staff,25,0,40,15
1650448986867,MATH 20B,A01,083756,Staff,0,10,30,30
1650448986867,MATH 20B,A02,083757,Staff,0,10,30,30
1650448992893,MATH 20C,A01,083760,Staff,0,15,30,30
1650448992893,MATH 20C,A02,083761,Staff,1,14,30,29
1650448992893,MATH 20C,B01,083762,Staff,13,0,30,17
1650448992893,MATH 20C,B02,083763,Staff,28,0,30,2
1650448998919,MATH 20D,A01,083765,Staff,0,1,30,30
1650448998919,MATH 20D,A02,083766,Staff,9,0,30,21
1650448998919,MATH 20D,A03,083767,Staff,25,0,30,5
1650449004949,MATH 20E,A01,083771,Staff,6,0,30,24
1650449004949,MATH 20E,A02,083772,Staff,18,0,30,12
1650449004949,MATH 20E,B01,083773,Staff,0,0,30,30
1650449004949,MATH 20E,B02,083774,Staff,10,0,30,20
1650449010973,MATH 103A,A01,083777,Staff,0,12,30,30
1650449010973,MATH 103A,A02,083778,Staff,0,12,30,30
1650449010973,MATH 103A,B01,083779,Staff,0,13,30,30
1650449010973,MATH 103A,B02,083780,Staff,0,12,30,30
1650449016996,MATH 105,A01,085443,Staff,0,23,30,30
1650449023024,MATH 109,A01,083213,Anzaldo; Leesa B,0,7,30,30
1650449023024,MATH 109,A02,083214,Anzaldo; Leesa B,0,7,30,30
1650449023024,MATH 109,B01,083215,Anzaldo; Leesa B,0,5,30,30
1650449023024,MATH 109,B02,083216,Anzaldo; Leesa B,0,6,30,30
1650449029053,MATH 142A,A01,083219,Chow; Bennett,0,14,30,30
1650449029053,MATH 142A,A02,083220,Chow; Bennett,0,13,30,30
1650449029053,MATH 142A,B01,083221,Chow; Bennett,0,12,30,30
1650449029053,MATH 142A,B02,083222,Chow; Bennett,0,13,30,30
1650449035077,MATH 193A,A01,083224,Staff,0,5,30,30
1650449035077,MATH 193A,A02,083225,Staff,0,5,30,30
1650449035077,MATH 193A,A03,083781,Staff,0,4,30,30
1650449035077,MATH 193A,A04,083782,Staff,0,5,30,30
1650449041099,MATH 197,001,091859,McAuley; Julian John,9998,0,9999,1
1650449047159,COGS 9,A01,083615,Staff,0,14,60,60
1650449053183,COGS 11,A01,083617,Boyle; Mary E. T.,21,0,40,19
1650449059210,COGS 13,A01,083071,Staff,0,34,40,40
1650449065233,COGS 14A,A01,092681,Staff,1,25,100,99
1650449071256,COGS 14B,A01,083073,Cheng; Tzu-Han,0,11,50,50
1650449077283,COGS 17,A01,092677,Staff,22,0,75,53
1650449083309,COGS 100,A01,083619,Staff,0,26,60,60
1650449089337,COGS 101A,A01,083621,Davis; Joshua Daniel,0,21,60,60
1650449095363,COGS 101B,A01,091572,Staff,0,4,60,60
1650449101387,COGS 101C,A01,083625,Delgado; Tania,16,0,30,14
1650449107414,COGS 107A,A01,083627,Boyle; Mary E. T.,0,11,60,60
1650449113448,COGS 118A,A01,083075,Staff,2,0,60,58
1650449119477,CSE 3,A50,083646,Miranda; Gregory Joseph,20,0,38,18
1650449119477,CSE 3,A51,083647,Miranda; Gregory Joseph,36,0,37,1
1650449125499,CSE 8A,A50,083650,Miranda; Gregory Joseph,0,28,40,40
1650449131524,CSE 11,A01,083080,Cao; Yingjun,0,92,40,40
1650449137551,CSE 12,A01,083652,Staff,0,16,100,100
1650449143651,CSE 15L,A01,083654,Staff,0,1,50,50
1650449143651,CSE 15L,A02,083655,Staff,1,0,50,49
1650449149685,CSE 20,A01,083657,Staff,51,0,80,29
1650449155713,CSE 30,A01,083084,Eldon; John,0,76,40,40
1650449161735,CSE 100,A01,083659,Cao; Yingjun,0,66,50,50
1650449167760,CSE 134B,A01,083661,Powell; Thomas Allan,0,32,65,65
1650449173784,CSE 140,A01,083663,Staff,0,2,75,75
1650449179810,CSE 140L,A01,083088,Eldon; John,0,8,75,75
1650449185838,CSE 175,A01,083665,Kumar; Rakesh,7,0,25,18
1650449191861,CSE 190,A00,092507,Dubnov; Shlomo,14,0,20,6
1650449197884,ECE 45,A01,083139,Staff,0,18,40,40
1650449203908,ECE 65,A50,083695,Staff,0,6,30,30
1650449209936,ECE 109,A01,091882,Touri; Behrouz,38,0,70,32
1650449215964,ECE 180,A00,083140,Abi Samra; Nicholas Camill,23,0,30,7
1650449215964,ECE 180,B00,083141,Abi Samra; Nicholas Camill,0,0,30,30
1650449221991,MATH 10A,A01,083735,Patchell; Gregory David,7,0,30,23
1650449221991,MATH 10A,A02,083736,Patchell; Gregory David,28,0,30,2
1650449221991,MATH 10A,A03,083737,Patchell; Gregory David,25,0,30,5
1650449228014,MATH 10B,A01,083207,Staff,0,7,30,30
1650449228014,MATH 10B,A02,083208,Staff,0,7,30,30
1650449228014,MATH 10B,B01,083739,Staff,13,0,30,17
1650449228014,MATH 10B,B02,083740,Staff,28,0,30,2
1650449234040,MATH 18,A01,083743,Staff,1,0,30,29
1650449234040,MATH 18,A02,083744,Staff,27,0,30,3
1650449234040,MATH 18,A03,083745,Staff,22,0,30,8
1650449234040,MATH 18,A04,083746,Staff,26,0,30,4
1650449234040,MATH 18,B01,083748,Staff,0,11,30,30
1650449234040,MATH 18,B02,083749,Staff,0,12,30,30
1650449234040,MATH 18,B03,083750,Staff,0,11,30,30
1650449234040,MATH 18,B04,083751,Staff,0,12,30,30
1650449240063,MATH 20A,A01,083754,Staff,25,0,40,15
1650449246090,MATH 20B,A01,083756,Staff,0,10,30,30
1650449246090,MATH 20B,A02,083757,Staff,0,10,30,30
1650449252115,MATH 20C,A01,083760,Staff,0,15,30,30
1650449252115,MATH 20C,A02,083761,Staff,1,14,30,29
1650449252115,MATH 20C,B01,083762,Staff,13,0,30,17
1650449252115,MATH 20C,B02,083763,Staff,28,0,30,2
1650449258138,MATH 20D,A01,083765,Staff,0,1,30,30
1650449258138,MATH 20D,A02,083766,Staff,9,0,30,21
1650449258138,MATH 20D,A03,083767,Staff,25,0,30,5
1650449264166,MATH 20E,A01,083771,Staff,6,0,30,24
1650449264166,MATH 20E,A02,083772,Staff,18,0,30,12
1650449264166,MATH 20E,B01,083773,Staff,0,0,30,30
1650449264166,MATH 20E,B02,083774,Staff,10,0,30,20
1650449270190,MATH 103A,A01,083777,Staff,0,12,30,30
1650449270190,MATH 103A,A02,083778,Staff,0,12,30,30
1650449270190,MATH 103A,B01,083779,Staff,0,13,30,30
1650449270190,MATH 103A,B02,083780,Staff,0,12,30,30
1650449276218,MATH 105,A01,085443,Staff,0,23,30,30
1650449282246,MATH 109,A01,083213,Anzaldo; Leesa B,0,7,30,30
1650449282246,MATH 109,A02,083214,Anzaldo; Leesa B,0,7,30,30
1650449282246,MATH 109,B01,083215,Anzaldo; Leesa B,0,5,30,30
1650449282246,MATH 109,B02,083216,Anzaldo; Leesa B,0,6,30,30
1650449288274,MATH 142A,A01,083219,Chow; Bennett,0,14,30,30
1650449288274,MATH 142A,A02,083220,Chow; Bennett,0,13,30,30
1650449288274,MATH 142A,B01,083221,Chow; Bennett,0,12,30,30
1650449288274,MATH 142A,B02,083222,Chow; Bennett,0,13,30,30
1650449294302,MATH 193A,A01,083224,Staff,0,5,30,30
1650449294302,MATH 193A,A02,083225,Staff,0,5,30,30
1650449294302,MATH 193A,A03,083781,Staff,0,4,30,30
1650449294302,MATH 193A,A04,083782,Staff,0,5,30,30
1650449300324,MATH 197,001,091859,McAuley; Julian John,9998,0,9999,1
1650449306385,COGS 9,A01,083615,Staff,0,14,60,60
1650449312409,COGS 11,A01,083617,Boyle; Mary E. T.,21,0,40,19
1650449318436,COGS 13,A01,083071,Staff,0,34,40,40
1650449324464,COGS 14A,A01,092681,Staff,1,25,100,99
1650449330488,COGS 14B,A01,083073,Cheng; Tzu-Han,0,11,50,50
1650449336512,COGS 17,A01,092677,Staff,22,0,75,53
1650449342535,COGS 100,A01,083619,Staff,0,26,60,60
1650449348562,COGS 101A,A01,083621,Davis; Joshua Daniel,0,21,60,60
1650449354586,COGS 101B,A01,091572,Staff,0,4,60,60
1650449360613,COGS 101C,A01,083625,Delgado; Tania,16,0,30,14
1650449366636,COGS 107A,A01,083627,Boyle; Mary E. T.,0,11,60,60
1650449372663,COGS 118A,A01,083075,Staff,2,0,60,58
1650449378685,CSE 3,A50,083646,Miranda; Gregory Joseph,20,0,38,18
1650449378685,CSE 3,A51,083647,Miranda; Gregory Joseph,36,0,37,1
1650449384718,CSE 8A,A50,083650,Miranda; Gregory Joseph,0,28,40,40
1650449390745,CSE 11,A01,083080,Cao; Yingjun,0,92,40,40
1650449396769,CSE 12,A01,083652,Staff,0,16,100,100
1650449402794,CSE 15L,A01,083654,Staff,0,1,50,50
1650449402794,CSE 15L,A02,083655,Staff,1,0,50,49
1650449408816,CSE 20,A01,083657,Staff,51,0,80,29
1650449414840,CSE 30,A01,083084,Eldon; John,0,76,40,40
1650449420864,CSE 100,A01,083659,Cao; Yingjun,0,66,50,50
1650449426891,CSE 134B,A01,083661,Powell; Thomas Allan,0,32,65,65
1650449432915,CSE 140,A01,083663,Staff,0,2,75,75
1650449438939,CSE 140L,A01,083088,Eldon; John,0,8,75,75
1650449444963,CSE 175,A01,083665,Kumar; Rakesh,7,0,25,18
1650449450989,CSE 190,A00,092507,Dubnov; Shlomo,14,0,20,6
1650449457016,ECE 45,A01,083139,Staff,0,18,40,40
1650449463039,ECE 65,A50,083695,Staff,0,6,30,30
1650449469063,ECE 109,A01,091882,Touri; Behrouz,38,0,70,32
1650449475087,ECE 180,A00,083140,Abi Samra; Nicholas Camill,23,0,30,7
1650449475087,ECE 180,B00,083141,Abi Samra; Nicholas Camill,0,0,30,30
1650449481111,MATH 10A,A01,083735,Patchell; Gregory David,7,0,30,23
1650449481111,MATH 10A,A02,083736,Patchell; Gregory David,28,0,30,2
1650449481111,MATH 10A,A03,083737,Patchell; Gregory David,25,0,30,5
1650449487134,MATH 10B,A01,083207,Staff,0,7,30,30
1650449487134,MATH 10B,A02,083208,Staff,0,7,30,30
1650449487134,MATH 10B,B01,083739,Staff,13,0,30,17
1650449487134,MATH 10B,B02,083740,Staff,28,0,30,2
1650449493160,MATH 18,A01,083743,Staff,1,0,30,29
1650449493160,MATH 18,A02,083744,Staff,27,0,30,3
1650449493160,MATH 18,A03,083745,Staff,22,0,30,8
1650449493160,MATH 18,A04,083746,Staff,26,0,30,4
1650449493160,MATH 18,B01,083748,Staff,0,11,30,30
1650449493160,MATH 18,B02,083749,Staff,0,12,30,30
1650449493160,MATH 18,B03,083750,Staff,0,11,30,30
1650449493160,MATH 18,B04,083751,Staff,0,12,30,30
1650449499185,MATH 20A,A01,083754,Staff,25,0,40,15
1650449505214,MATH 20B,A01,083756,Staff,0,10,30,30
1650449505214,MATH 20B,A02,083757,Staff,0,10,30,30
1650449511238,MATH 20C,A01,083760,Staff,0,15,30,30
1650449511238,MATH 20C,A02,083761,Staff,1,14,30,29
1650449511238,MATH 20C,B01,083762,Staff,13,0,30,17
1650449511238,MATH 20C,B02,083763,Staff,28,0,30,2
1650449517262,MATH 20D,A01,083765,Staff,0,1,30,30
1650449517262,MATH 20D,A02,083766,Staff,9,0,30,21
1650449517262,MATH 20D,A03,083767,Staff,25,0,30,5
1650449523284,MATH 20E,A01,083771,Staff,6,0,30,24
1650449523284,MATH 20E,A02,083772,Staff,18,0,30,12
1650449523284,MATH 20E,B01,083773,Staff,0,0,30,30
1650449523284,MATH 20E,B02,083774,Staff,10,0,30,20
1650449529314,MATH 103A,A01,083777,Staff,0,12,30,30
1650449529314,MATH 103A,A02,083778,Staff,0,12,30,30
1650449529314,MATH 103A,B01,083779,Staff,0,13,30,30
1650449529314,MATH 103A,B02,083780,Staff,0,12,30,30
1650449535337,MATH 105,A01,085443,Staff,0,23,30,30
1650449541361,MATH 109,A01,083213,Anzaldo; Leesa B,0,7,30,30
1650449541361,MATH 109,A02,083214,Anzaldo; Leesa B,0,7,30,30
1650449541361,MATH 109,B01,083215,Anzaldo; Leesa B,0,5,30,30
1650449541361,MATH 109,B02,083216,Anzaldo; Leesa B,0,6,30,30
1650449547389,MATH 142A,A01,083219,Chow; Bennett,0,14,30,30
1650449547389,MATH 142A,A02,083220,Chow; Bennett,0,13,30,30
1650449547389,MATH 142A,B01,083221,Chow; Bennett,0,12,30,30
1650449547389,MATH 142A,B02,083222,Chow; Bennett,0,13,30,30
1650449553415,MATH 193A,A01,083224,Staff,0,5,30,30
1650449553415,MATH 193A,A02,083225,Staff,0,5,30,30
1650449553415,MATH 193A,A03,083781,Staff,0,4,30,30
1650449553415,MATH 193A,A04,083782,Staff,0,5,30,30
1650449559437,MATH 197,001,091859,McAuley; Julian John,9998,0,9999,1
1650449565490,COGS 9,A01,083615,Staff,0,14,60,60
1650449571516,COGS 11,A01,083617,Boyle; Mary E. T.,21,0,40,19
1650449577539,COGS 13,A01,083071,Staff,0,34,40,40
1650449583565,COGS 14A,A01,092681,Staff,1,25,100,99
1650449589586,COGS 14B,A01,083073,Cheng; Tzu-Han,0,11,50,50
1650449595611,COGS 17,A01,092677,Staff,22,0,75,53
1650449601638,COGS 100,A01,083619,Staff,0,26,60,60
1650449607665,COGS 101A,A01,083621,Davis; Joshua Daniel,0,21,60,60
1650449613692,COGS 101B,A01,091572,Staff,0,4,60,60
1650449619719,COGS 101C,A01,083625,Delgado; Tania,16,0,30,14
1650449625746,COGS 107A,A01,083627,Boyle; Mary E. T.,0,11,60,60
1650449631771,COGS 118A,A01,083075,Staff,2,0,60,58
1650449637793,CSE 3,A50,083646,Miranda; Gregory Joseph,20,0,38,18
1650449637793,CSE 3,A51,083647,Miranda; Gregory Joseph,36,0,37,1
1650449643817,CSE 8A,A50,083650,Miranda; Gregory Joseph,0,28,40,40
1650449649844,CSE 11,A01,083080,Cao; Yingjun,0,92,40,40
1650449655868,CSE 12,A01,083652,Staff,0,16,100,100
1650449661892,CSE 15L,A01,083654,Staff,0,1,50,50
1650449661892,CSE 15L,A02,083655,Staff,1,0,50,49
1650449667920,CSE 20,A01,083657,Staff,51,0,80,29
1650449673941,CSE 30,A01,083084,Eldon; John,0,76,40,40
1650449679964,CSE 100,A01,083659,Cao; Yingjun,0,66,50,50
1650449685991,CSE 134B,A01,083661,Powell; Thomas Allan,0,32,65,65
1650449692016,CSE 140,A01,083663,Staff,0,2,75,75
1650449698040,CSE 140L,A01,083088,Eldon; John,0,8,75,75
1650449704063,CSE 175,A01,083665,Kumar; Rakesh,7,0,25,18
1650449710088,CSE 190,A00,092507,Dubnov; Shlomo,14,0,20,6
1650449716116,ECE 45,A01,083139,Staff,0,18,40,40
1650449722143,ECE 65,A50,083695,Staff,0,6,30,30
1650449728164,ECE 109,A01,091882,Touri; Behrouz,38,0,70,32
1650449734187,ECE 180,A00,083140,Abi Samra; Nicholas Camill,23,0,30,7
1650449734187,ECE 180,B00,083141,Abi Samra; Nicholas Camill,0,0,30,30
1650449740305,MATH 10A,A01,083735,Patchell; Gregory David,7,0,30,23
1650449740305,MATH 10A,A02,083736,Patchell; Gregory David,28,0,30,2
1650449740305,MATH 10A,A03,083737,Patchell; Gregory David,25,0,30,5
1650449746329,MATH 10B,A01,083207,Staff,0,7,30,30
1650449746329,MATH 10B,A02,083208,Staff,0,7,30,30
1650449746329,MATH 10B,B01,083739,Staff,13,0,30,17
1650449746329,MATH 10B,B02,083740,Staff,28,0,30,2
1650449752355,MATH 18,A01,083743,Staff,1,0,30,29
1650449752355,MATH 18,A02,083744,Staff,27,0,30,3
1650449752355,MATH 18,A03,083745,Staff,22,0,30,8
1650449752355,MATH 18,A04,083746,Staff,26,0,30,4
1650449752355,MATH 18,B01,083748,Staff,0,11,30,30
1650449752355,MATH 18,B02,083749,Staff,0,12,30,30
1650449752355,MATH 18,B03,083750,Staff,0,11,30,30
1650449752355,MATH 18,B04,083751,Staff,0,12,30,30
1650449758385,MATH 20A,A01,083754,Staff,25,0,40,15
1650449764413,MATH 20B,A01,083756,Staff,0,10,30,30
1650449764413,MATH 20B,A02,083757,Staff,0,10,30,30
1650449770436,MATH 20C,A01,083760,Staff,0,15,30,30
1650449770436,MATH 20C,A02,083761,Staff,1,14,30,29
1650449770436,MATH 20C,B01,083762,Staff,13,0,30,17
1650449770436,MATH 20C,B02,083763,Staff,28,0,30,2
1650449776464,MATH 20D,A01,083765,Staff,0,1,30,30
1650449776464,MATH 20D,A02,083766,Staff,9,0,30,21
1650449776464,MATH 20D,A03,083767,Staff,25,0,30,5
1650449782489,MATH 20E,A01,083771,Staff,6,0,30,24
1650449782489,MATH 20E,A02,083772,Staff,18,0,30,12
1650449782489,MATH 20E,B01,083773,Staff,0,0,30,30
1650449782489,MATH 20E,B02,083774,Staff,10,0,30,20
1650449788514,MATH 103A,A01,083777,Staff,0,12,30,30
1650449788514,MATH 103A,A02,083778,Staff,0,12,30,30
1650449788514,MATH 103A,B01,083779,Staff,0,13,30,30
1650449788514,MATH 103A,B02,083780,Staff,0,12,30,30
1650449794555,MATH 105,A01,085443,Staff,0,23,30,30
1650449800582,MATH 109,A01,083213,Anzaldo; Leesa B,0,7,30,30
1650449800582,MATH 109,A02,083214,Anzaldo; Leesa B,0,7,30,30
1650449800582,MATH 109,B01,083215,Anzaldo; Leesa B,0,5,30,30
1650449800582,MATH 109,B02,083216,Anzaldo; Leesa B,0,6,30,30
1650449806611,MATH 142A,A01,083219,Chow; Bennett,0,14,30,30
1650449806611,MATH 142A,A02,083220,Chow; Bennett,0,13,30,30
1650449806611,MATH 142A,B01,083221,Chow; Bennett,0,12,30,30
1650449806611,MATH 142A,B02,083222,Chow; Bennett,0,13,30,30
1650449812638,MATH 193A,A01,083224,Staff,0,5,30,30
1650449812638,MATH 193A,A02,083225,Staff,0,5,30,30
1650449812638,MATH 193A,A03,083781,Staff,0,4,30,30
1650449812638,MATH 193A,A04,083782,Staff,0,5,30,30
1650449818664,MATH 197,001,091859,McAuley; Julian John,9998,0,9999,1
1650449824719,COGS 9,A01,083615,Staff,0,14,60,60
1650449830744,COGS 11,A01,083617,Boyle; Mary E. T.,21,0,40,19
1650449836771,COGS 13,A01,083071,Staff,0,34,40,40
1650449842799,COGS 14A,A01,092681,Staff,1,25,100,99
1650449848827,COGS 14B,A01,083073,Cheng; Tzu-Han,0,11,50,50
1650449854864,COGS 17,A01,092677,Staff,22,0,75,53
1650449860887,COGS 100,A01,083619,Staff,0,26,60,60
1650449866911,COGS 101A,A01,083621,Davis; Joshua Daniel,0,21,60,60
1650449872938,COGS 101B,A01,091572,Staff,0,4,60,60
1650449878962,COGS 101C,A01,083625,Delgado; Tania,16,0,30,14
1650449884989,COGS 107A,A01,083627,Boyle; Mary E. T.,0,11,60,60
1650449891015,COGS 118A,A01,083075,Staff,2,0,60,58
1650449897042,CSE 3,A50,083646,Miranda; Gregory Joseph,20,0,38,18
1650449897042,CSE 3,A51,083647,Miranda; Gregory Joseph,36,0,37,1
1650449903067,CSE 8A,A50,083650,Miranda; Gregory Joseph,0,28,40,40
1650449909094,CSE 11,A01,083080,Cao; Yingjun,0,92,40,40
1650449915117,CSE 12,A01,083652,Staff,0,16,100,100
1650449921142,CSE 15L,A01,083654,Staff,0,1,50,50
1650449921142,CSE 15L,A02,083655,Staff,1,0,50,49
1650449927167,CSE 20,A01,083657,Staff,51,0,80,29
1650449933194,CSE 30,A01,083084,Eldon; John,0,76,40,40
1650449939217,CSE 100,A01,083659,Cao; Yingjun,0,66,50,50
1650449945245,CSE 134B,A01,083661,Powell; Thomas Allan,0,32,65,65
1650449951269,CSE 140,A01,083663,Staff,0,2,75,75
1650449957298,CSE 140L,A01,083088,Eldon; John,0,8,75,75
1650449963323,CSE 175,A01,083665,Kumar; Rakesh,7,0,25,18
1650449969348,CSE 190,A00,092507,Dubnov; Shlomo,14,0,20,6
1650449975375,ECE 45,A01,083139,Staff,0,18,40,40
1650449981398,ECE 65,A50,083695,Staff,0,6,30,30
1650449987424,ECE 109,A01,091882,Touri; Behrouz,38,0,70,32
1650449993446,ECE 180,A00,083140,Abi Samra; Nicholas Camill,23,0,30,7
1650449993446,ECE 180,B00,083141,Abi Samra; Nicholas Camill,0,0,30,30
1650449999472,MATH 10A,A01,083735,Patchell; Gregory David,7,0,30,23
1650449999472,MATH 10A,A02,083736,Patchell; Gregory David,28,0,30,2
1650449999472,MATH 10A,A03,083737,Patchell; Gregory David,25,0,30,5
1650450005496,MATH 10B,A01,083207,Staff,0,7,30,30
1650450005496,MATH 10B,A02,083208,Staff,0,7,30,30
1650450005496,MATH 10B,B01,083739,Staff,13,0,30,17
1650450005496,MATH 10B,B02,083740,Staff,28,0,30,2
1650450011520,MATH 18,A01,083743,Staff,1,0,30,29
1650450011520,MATH 18,A02,083744,Staff,27,0,30,3
1650450011520,MATH 18,A03,083745,Staff,22,0,30,8
1650450011520,MATH 18,A04,083746,Staff,26,0,30,4
1650450011520,MATH 18,B01,083748,Staff,0,11,30,30
1650450011520,MATH 18,B02,083749,Staff,0,12,30,30
1650450011520,MATH 18,B03,083750,Staff,0,11,30,30
1650450011520,MATH 18,B04,083751,Staff,0,12,30,30
1650450017548,MATH 20A,A01,083754,Staff,25,0,40,15
1650450023574,MATH 20B,A01,083756,Staff,0,10,30,30
1650450023574,MATH 20B,A02,083757,Staff,0,10,30,30
1650450029602,MATH 20C,A01,083760,Staff,0,15,30,30
1650450029602,MATH 20C,A02,083761,Staff,1,14,30,29
1650450029602,MATH 20C,B01,083762,Staff,13,0,30,17
1650450029602,MATH 20C,B02,083763,Staff,28,0,30,2
1650450035625,MATH 20D,A01,083765,Staff,0,1,30,30
1650450035625,MATH 20D,A02,083766,Staff,9,0,30,21
1650450035625,MATH 20D,A03,083767,Staff,25,0,30,5
1650450041648,MATH 20E,A01,083771,Staff,6,0,30,24
1650450041648,MATH 20E,A02,083772,Staff,18,0,30,12
1650450041648,MATH 20E,B01,083773,Staff,0,0,30,30
1650450041648,MATH 20E,B02,083774,Staff,10,0,30,20
1650450047676,MATH 103A,A01,083777,Staff,0,12,30,30
1650450047676,MATH 103A,A02,083778,Staff,0,12,30,30
1650450047676,MATH 103A,B01,083779,Staff,0,13,30,30
1650450047676,MATH 103A,B02,083780,Staff,0,12,30,30
1650450053699,MATH 105,A01,085443,Staff,0,23,30,30
1650450059722,MATH 109,A01,083213,Anzaldo; Leesa B,0,7,30,30
1650450059722,MATH 109,A02,083214,Anzaldo; Leesa B,0,7,30,30
1650450059722,MATH 109,B01,083215,Anzaldo; Leesa B,0,5,30,30
1650450059722,MATH 109,B02,083216,Anzaldo; Leesa B,0,6,30,30
1650450065747,MATH 142A,A01,083219,Chow; Bennett,0,14,30,30
1650450065747,MATH 142A,A02,083220,Chow; Bennett,0,13,30,30
1650450065747,MATH 142A,B01,083221,Chow; Bennett,0,12,30,30
1650450065747,MATH 142A,B02,083222,Chow; Bennett,0,13,30,30
1650450071781,MATH 193A,A01,083224,Staff,0,5,30,30
1650450071781,MATH 193A,A02,083225,Staff,0,5,30,30
1650450071781,MATH 193A,A03,083781,Staff,0,4,30,30
1650450071781,MATH 193A,A04,083782,Staff,0,5,30,30
1650450077808,MATH 197,001,091859,McAuley; Julian John,9998,0,9999,1
1650450083865,COGS 9,A01,083615,Staff,0,14,60,60
1650450089889,COGS 11,A01,083617,Boyle; Mary E. T.,21,0,40,19
1650450095919,COGS 13,A01,083071,Staff,0,34,40,40
1650450101943,COGS 14A,A01,092681,Staff,1,25,100,99
1650450107967,COGS 14B,A01,083073,Cheng; Tzu-Han,0,11,50,50
1650450113994,COGS 17,A01,092677,Staff,22,0,75,53
1650450120022,COGS 100,A01,083619,Staff,0,26,60,60
1650450126061,COGS 101A,A01,083621,Davis; Joshua Daniel,0,21,60,60
1650450132087,COGS 101B,A01,091572,Staff,0,4,60,60
1650450138111,COGS 101C,A01,083625,Delgado; Tania,16,0,30,14
1650450144141,COGS 107A,A01,083627,Boyle; Mary E. T.,0,11,60,60
1650450150176,COGS 118A,A01,083075,Staff,2,0,60,58
1650450156204,CSE 3,A50,083646,Miranda; Gregory Joseph,20,0,38,18
1650450156204,CSE 3,A51,083647,Miranda; Gregory Joseph,36,0,37,1
1650450162234,CSE 8A,A50,083650,Miranda; Gregory Joseph,0,28,40,40
1650450168270,CSE 11,A01,083080,Cao; Yingjun,0,92,40,40
1650450174296,CSE 12,A01,083652,Staff,0,16,100,100
1650450180320,CSE 15L,A01,083654,Staff,0,1,50,50
1650450180320,CSE 15L,A02,083655,Staff,1,0,50,49
1650450186350,CSE 20,A01,083657,Staff,51,0,80,29
1650450192379,CSE 30,A01,083084,Eldon; John,0,76,40,40
1650450198404,CSE 100,A01,083659,Cao; Yingjun,0,66,50,50
1650450204430,CSE 134B,A01,083661,Powell; Thomas Allan,0,32,65,65
1650450210457,CSE 140,A01,083663,Staff,0,2,75,75
1650450216488,CSE 140L,A01,083088,Eldon; John,0,8,75,75
1650450222518,CSE 175,A01,083665,Kumar; Rakesh,7,0,25,18
1650450228544,CSE 190,A00,092507,Dubnov; Shlomo,14,0,20,6
1650450234572,ECE 45,A01,083139,Staff,0,18,40,40
1650450240603,ECE 65,A50,083695,Staff,0,6,30,30
1650450246636,ECE 109,A01,091882,Touri; Behrouz,38,0,70,32
1650450252673,ECE 180,A00,083140,Abi Samra; Nicholas Camill,23,0,30,7
1650450252673,ECE 180,B00,083141,Abi Samra; Nicholas Camill,0,0,30,30
1650450258708,MATH 10A,A01,083735,Patchell; Gregory David,7,0,30,23
1650450258708,MATH 10A,A02,083736,Patchell; Gregory David,28,0,30,2
1650450258708,MATH 10A,A03,083737,Patchell; Gregory David,25,0,30,5
1650450264735,MATH 10B,A01,083207,Staff,0,7,30,30
1650450264735,MATH 10B,A02,083208,Staff,0,7,30,30
1650450264735,MATH 10B,B01,083739,Staff,13,0,30,17
1650450264735,MATH 10B,B02,083740,Staff,28,0,30,2
1650450270762,MATH 18,A01,083743,Staff,1,0,30,29
1650450270762,MATH 18,A02,083744,Staff,27,0,30,3
1650450270762,MATH 18,A03,083745,Staff,22,0,30,8
1650450270762,MATH 18,A04,083746,Staff,26,0,30,4
1650450270762,MATH 18,B01,083748,Staff,0,11,30,30
1650450270762,MATH 18,B02,083749,Staff,0,12,30,30
1650450270762,MATH 18,B03,083750,Staff,0,11,30,30
1650450270762,MATH 18,B04,083751,Staff,0,12,30,30
1650450276790,MATH 20A,A01,083754,Staff,25,0,40,15
1650450282820,MATH 20B,A01,083756,Staff,0,10,30,30
1650450282820,MATH 20B,A02,083757,Staff,0,10,30,30
1650450288851,MATH 20C,A01,083760,Staff,0,15,30,30
1650450288851,MATH 20C,A02,083761,Staff,1,14,30,29
1650450288851,MATH 20C,B01,083762,Staff,13,0,30,17
1650450288851,MATH 20C,B02,083763,Staff,28,0,30,2
1650450294876,MATH 20D,A01,083765,Staff,0,1,30,30
1650450294876,MATH 20D,A02,083766,Staff,9,0,30,21
1650450294876,MATH 20D,A03,083767,Staff,25,0,30,5
1650450300908,MATH 20E,A01,083771,Staff,6,0,30,24
1650450300908,MATH 20E,A02,083772,Staff,18,0,30,12
1650450300908,MATH 20E,B01,083773,Staff,0,0,30,30
1650450300908,MATH 20E,B02,083774,Staff,10,0,30,20
1650450306936,MATH 103A,A01,083777,Staff,0,12,30,30
1650450306936,MATH 103A,A02,083778,Staff,0,12,30,30
1650450306936,MATH 103A,B01,083779,Staff,0,13,30,30
1650450306936,MATH 103A,B02,083780,Staff,0,12,30,30
1650450312965,MATH 105,A01,085443,Staff,0,23,30,30
1650450318999,MATH 109,A01,083213,Anzaldo; Leesa B,0,7,30,30
1650450318999,MATH 109,A02,083214,Anzaldo; Leesa B,0,7,30,30
1650450318999,MATH 109,B01,083215,Anzaldo; Leesa B,0,5,30,30
1650450318999,MATH 109,B02,083216,Anzaldo; Leesa B,0,6,30,30
1650450325024,MATH 142A,A01,083219,Chow; Bennett,0,14,30,30
1650450325024,MATH 142A,A02,083220,Chow; Bennett,0,13,30,30
1650450325024,MATH 142A,B01,083221,Chow; Bennett,0,12,30,30
1650450325024,MATH 142A,B02,083222,Chow; Bennett,0,13,30,30
1650450331054,MATH 193A,A01,083224,Staff,0,5,30,30
1650450331054,MATH 193A,A02,083225,Staff,0,5,30,30
1650450331054,MATH 193A,A03,083781,Staff,0,4,30,30
1650450331054,MATH 193A,A04,083782,Staff,0,5,30,30
1650450337172,MATH 197,001,091859,McAuley; Julian John,9998,0,9999,1
1650450343260,COGS 9,A01,083615,Staff,0,14,60,60
1650450349286,COGS 11,A01,083617,Boyle; Mary E. T.,21,0,40,19
1650450355315,COGS 13,A01,083071,Staff,0,34,40,40
1650450361342,COGS 14A,A01,092681,Staff,1,25,100,99
1650450367368,COGS 14B,A01,083073,Cheng; Tzu-Han,0,11,50,50
1650450373395,COGS 17,A01,092677,Staff,22,0,75,53
1650450379427,COGS 100,A01,083619,Staff,0,26,60,60
1650450385454,COGS 101A,A01,083621,Davis; Joshua Daniel,0,21,60,60
1650450391483,COGS 101B,A01,091572,Staff,0,4,60,60
1650450397519,COGS 101C,A01,083625,Delgado; Tania,16,0,30,14
1650450403549,COGS 107A,A01,083627,Boyle; Mary E. T.,0,11,60,60
1650450409573,COGS 118A,A01,083075,Staff,2,0,60,58
1650450415600,CSE 3,A50,083646,Miranda; Gregory Joseph,20,0,38,18
1650450415600,CSE 3,A51,083647,Miranda; Gregory Joseph,36,0,37,1
1650450421634,CSE 8A,A50,083650,Miranda; Gregory Joseph,0,28,40,40
1650450427663,CSE 11,A01,083080,Cao; Yingjun,0,92,40,40
1650450433688,CSE 12,A01,083652,Staff,0,16,100,100
1650450439722,CSE 15L,A01,083654,Staff,0,1,50,50
1650450439722,CSE 15L,A02,083655,Staff,1,0,50,49
1650450445751,CSE 20,A01,083657,Staff,51,0,80,29
1650450451783,CSE 30,A01,083084,Eldon; John,0,76,40,40
1650450457822,CSE 100,A01,083659,Cao; Yingjun,0,66,50,50
1650450463863,CSE 134B,A01,083661,Powell; Thomas Allan,0,32,65,65
1650450469886,CSE 140,A01,083663,Staff,0,2,75,75
1650450475912,CSE 140L,A01,083088,Eldon; John,0,8,75,75
1650450481938,CSE 175,A01,083665,Kumar; Rakesh,7,0,25,18
1650450487969,CSE 190,A00,092507,Dubnov; Shlomo,14,0,20,6
1650450493993,ECE 45,A01,083139,Staff,0,18,40,40
1650450500019,ECE 65,A50,083695,Staff,0,6,30,30
1650450506049,ECE 109,A01,091882,Touri; Behrouz,38,0,70,32
1650450512075,ECE 180,A00,083140,Abi Samra; Nicholas Camill,23,0,30,7
1650450512075,ECE 180,B00,083141,Abi Samra; Nicholas Camill,0,0,30,30
1650450518108,MATH 10A,A01,083735,Patchell; Gregory David,7,0,30,23
1650450518108,MATH 10A,A02,083736,Patchell; Gregory David,28,0,30,2
1650450518108,MATH 10A,A03,083737,Patchell; Gregory David,25,0,30,5
1650450524134,MATH 10B,A01,083207,Staff,0,7,30,30
1650450524134,MATH 10B,A02,083208,Staff,0,7,30,30
1650450524134,MATH 10B,B01,083739,Staff,13,0,30,17
1650450524134,MATH 10B,B02,083740,Staff,28,0,30,2
1650450530162,MATH 18,A01,083743,Staff,1,0,30,29
1650450530162,MATH 18,A02,083744,Staff,27,0,30,3
1650450530162,MATH 18,A03,083745,Staff,22,0,30,8
1650450530162,MATH 18,A04,083746,Staff,26,0,30,4
1650450530162,MATH 18,B01,083748,Staff,0,11,30,30
1650450530162,MATH 18,B02,083749,Staff,0,12,30,30
1650450530162,MATH 18,B03,083750,Staff,0,11,30,30
1650450530162,MATH 18,B04,083751,Staff,0,12,30,30
1650450536186,MATH 20A,A01,083754,Staff,25,0,40,15
1650450542215,MATH 20B,A01,083756,Staff,0,10,30,30
1650450542215,MATH 20B,A02,083757,Staff,0,10,30,30
1650450548244,MATH 20C,A01,083760,Staff,0,15,30,30
1650450548244,MATH 20C,A02,083761,Staff,1,14,30,29
1650450548244,MATH 20C,B01,083762,Staff,13,0,30,17
1650450548244,MATH 20C,B02,083763,Staff,28,0,30,2
1650450554269,MATH 20D,A01,083765,Staff,0,1,30,30
1650450554269,MATH 20D,A02,083766,Staff,9,0,30,21
1650450554269,MATH 20D,A03,083767,Staff,25,0,30,5
1650450560297,MATH 20E,A01,083771,Staff,6,0,30,24
1650450560297,MATH 20E,A02,083772,Staff,18,0,30,12
1650450560297,MATH 20E,B01,083773,Staff,0,0,30,30
1650450560297,MATH 20E,B02,083774,Staff,10,0,30,20
1650450566322,MATH 103A,A01,083777,Staff,0,12,30,30
1650450566322,MATH 103A,A02,083778,Staff,0,12,30,30
1650450566322,MATH 103A,B01,083779,Staff,0,13,30,30
1650450566322,MATH 103A,B02,083780,Staff,0,12,30,30
1650450572355,MATH 105,A01,085443,Staff,0,23,30,30
1650450578378,MATH 109,A01,083213,Anzaldo; Leesa B,0,7,30,30
1650450578378,MATH 109,A02,083214,Anzaldo; Leesa B,0,7,30,30
1650450578378,MATH 109,B01,083215,Anzaldo; Leesa B,0,5,30,30
1650450578378,MATH 109,B02,083216,Anzaldo; Leesa B,0,6,30,30
1650450584403,MATH 142A,A01,083219,Chow; Bennett,0,14,30,30
1650450584403,MATH 142A,A02,083220,Chow; Bennett,0,13,30,30
1650450584403,MATH 142A,B01,083221,Chow; Bennett,0,12,30,30
1650450584403,MATH 142A,B02,083222,Chow; Bennett,0,13,30,30
1650450590428,MATH 193A,A01,083224,Staff,0,5,30,30
1650450590428,MATH 193A,A02,083225,Staff,0,5,30,30
1650450590428,MATH 193A,A03,083781,Staff,0,4,30,30
1650450590428,MATH 193A,A04,083782,Staff,0,5,30,30
1650450596450,MATH 197,001,091859,McAuley; Julian John,9998,0,9999,1
1650450602525,COGS 9,A01,083615,Staff,0,14,60,60
1650450608563,COGS 11,A01,083617,Boyle; Mary E. T.,21,0,40,19
1650450614595,COGS 13,A01,083071,Staff,0,34,40,40
1650450620620,COGS 14A,A01,092681,Staff,1,25,100,99
1650450626649,COGS 14B,A01,083073,Cheng; Tzu-Han,0,11,50,50
1650450632674,COGS 17,A01,092677,Staff,22,0,75,53
1650450638704,COGS 100,A01,083619,Staff,0,26,60,60
1650450644736,COGS 101A,A01,083621,Davis; Joshua Daniel,0,21,60,60
1650450650761,COGS 101B,A01,091572,Staff,0,4,60,60
1650450656791,COGS 101C,A01,083625,Delgado; Tania,16,0,30,14
1650450662932,COGS 107A,A01,083627,Boyle; Mary E. T.,0,11,60,60
1650450668960,COGS 118A,A01,083075,Staff,2,0,60,58
1650450674985,CSE 3,A50,083646,Miranda; Gregory Joseph,20,0,38,18
1650450674985,CSE 3,A51,083647,Miranda; Gregory Joseph,36,0,37,1
1650450681011,CSE 8A,A50,083650,Miranda; Gregory Joseph,0,28,40,40
1650450687040,CSE 11,A01,083080,Cao; Yingjun,0,92,40,40
1650450693073,CSE 12,A01,083652,Staff,0,16,100,100
1650450699098,CSE 15L,A01,083654,Staff,0,1,50,50
1650450699098,CSE 15L,A02,083655,Staff,1,0,50,49
1650450705126,CSE 20,A01,083657,Staff,51,0,80,29
1650450711150,CSE 30,A01,083084,Eldon; John,0,76,40,40
1650450717176,CSE 100,A01,083659,Cao; Yingjun,0,66,50,50
1650450723205,CSE 134B,A01,083661,Powell; Thomas Allan,0,32,65,65
1650450729230,CSE 140,A01,083663,Staff,0,2,75,75
1650450735259,CSE 140L,A01,083088,Eldon; John,0,8,75,75
1650450741292,CSE 175,A01,083665,Kumar; Rakesh,7,0,25,18
1650450747316,CSE 190,A00,092507,Dubnov; Shlomo,14,0,20,6
1650450753341,ECE 45,A01,083139,Staff,0,18,40,40
1650450759378,ECE 65,A50,083695,Staff,0,6,30,30
1650450765402,ECE 109,A01,091882,Touri; Behrouz,38,0,70,32
1650450771428,ECE 180,A00,083140,Abi Samra; Nicholas Camill,23,0,30,7
1650450771428,ECE 180,B00,083141,Abi Samra; Nicholas Camill,0,0,30,30
1650450777475,MATH 10A,A01,083735,Patchell; Gregory David,7,0,30,23
1650450777475,MATH 10A,A02,083736,Patchell; Gregory David,28,0,30,2
1650450777475,MATH 10A,A03,083737,Patchell; Gregory David,25,0,30,5
1650450783502,MATH 10B,A01,083207,Staff,0,7,30,30
1650450783502,MATH 10B,A02,083208,Staff,0,7,30,30
1650450783502,MATH 10B,B01,083739,Staff,13,0,30,17
1650450783502,MATH 10B,B02,083740,Staff,28,0,30,2
1650450789531,MATH 18,A01,083743,Staff,1,0,30,29
1650450789531,MATH 18,A02,083744,Staff,27,0,30,3
1650450789531,MATH 18,A03,083745,Staff,22,0,30,8
1650450789531,MATH 18,A04,083746,Staff,26,0,30,4
1650450789531,MATH 18,B01,083748,Staff,0,11,30,30
1650450789531,MATH 18,B02,083749,Staff,0,12,30,30
1650450789531,MATH 18,B03,083750,Staff,0,11,30,30
1650450789531,MATH 18,B04,083751,Staff,0,12,30,30
1650450795557,MATH 20A,A01,083754,Staff,25,0,40,15
1650450801582,MATH 20B,A01,083756,Staff,0,10,30,30
1650450801582,MATH 20B,A02,083757,Staff,0,10,30,30
1650450807615,MATH 20C,A01,083760,Staff,0,15,30,30
1650450807615,MATH 20C,A02,083761,Staff,1,14,30,29
1650450807615,MATH 20C,B01,083762,Staff,13,0,30,17
1650450807615,MATH 20C,B02,083763,Staff,28,0,30,2
1650450813643,MATH 20D,A01,083765,Staff,0,1,30,30
1650450813643,MATH 20D,A02,083766,Staff,9,0,30,21
1650450813643,MATH 20D,A03,083767,Staff,25,0,30,5
1650450819670,MATH 20E,A01,083771,Staff,6,0,30,24
1650450819670,MATH 20E,A02,083772,Staff,18,0,30,12
1650450819670,MATH 20E,B01,083773,Staff,0,0,30,30
1650450819670,MATH 20E,B02,083774,Staff,10,0,30,20
1650450825707,MATH 103A,A01,083777,Staff,0,12,30,30
1650450825707,MATH 103A,A02,083778,Staff,0,12,30,30
1650450825707,MATH 103A,B01,083779,Staff,0,13,30,30
1650450825707,MATH 103A,B02,083780,Staff,0,12,30,30
1650450831731,MATH 105,A01,085443,Staff,0,23,30,30
1650450837758,MATH 109,A01,083213,Anzaldo; Leesa B,0,7,30,30
1650450837758,MATH 109,A02,083214,Anzaldo; Leesa B,0,7,30,30
1650450837758,MATH 109,B01,083215,Anzaldo; Leesa B,0,5,30,30
1650450837758,MATH 109,B02,083216,Anzaldo; Leesa B,0,6,30,30
1650450843783,MATH 142A,A01,083219,Chow; Bennett,0,14,30,30
1650450843783,MATH 142A,A02,083220,Chow; Bennett,0,13,30,30
1650450843783,MATH 142A,B01,083221,Chow; Bennett,0,12,30,30
1650450843783,MATH 142A,B02,083222,Chow; Bennett,0,13,30,30
1650450849811,MATH 193A,A01,083224,Staff,0,5,30,30
1650450849811,MATH 193A,A02,083225,Staff,0,5,30,30
1650450849811,MATH 193A,A03,083781,Staff,0,4,30,30
1650450849811,MATH 193A,A04,083782,Staff,0,5,30,30
1650450855842,MATH 197,001,091859,McAuley; Julian John,9998,0,9999,1
1650450861907,COGS 9,A01,083615,Staff,0,14,60,60
1650450867939,COGS 11,A01,083617,Boyle; Mary E. T.,21,0,40,19
1650450873963,COGS 13,A01,083071,Staff,0,34,40,40
1650450879990,COGS 14A,A01,092681,Staff,1,25,100,99
1650450886013,COGS 14B,A01,083073,Cheng; Tzu-Han,0,11,50,50
1650450892037,COGS 17,A01,092677,Staff,22,0,75,53
1650450898065,COGS 100,A01,083619,Staff,0,26,60,60
1650450904090,COGS 101A,A01,083621,Davis; Joshua Daniel,0,21,60,60
1650450910115,COGS 101B,A01,091572,Staff,0,4,60,60
1650450916142,COGS 101C,A01,083625,Delgado; Tania,16,0,30,14
1650450922174,COGS 107A,A01,083627,Boyle; Mary E. T.,0,11,60,60
1650450928288,COGS 118A,A01,083075,Staff,2,0,60,58
1650450934315,CSE 3,A50,083646,Miranda; Gregory Joseph,20,0,38,18
1650450934315,CSE 3,A51,083647,Miranda; Gregory Joseph,36,0,37,1
1650450940340,CSE 8A,A50,083650,Miranda; Gregory Joseph,0,28,40,40
1650450946370,CSE 11,A01,083080,Cao; Yingjun,0,92,40,40
1650450952400,CSE 12,A01,083652,Staff,0,16,100,100
1650450958425,CSE 15L,A01,083654,Staff,0,1,50,50
1650450958425,CSE 15L,A02,083655,Staff,1,0,50,49
1650450964455,CSE 20,A01,083657,Staff,51,0,80,29
1650450970478,CSE 30,A01,083084,Eldon; John,0,76,40,40
1650450976503,CSE 100,A01,083659,Cao; Yingjun,0,66,50,50
1650450982540,CSE 134B,A01,083661,Powell; Thomas Allan,0,32,65,65
1650450988568,CSE 140,A01,083663,Staff,0,2,75,75
1650450994598,CSE 140L,A01,083088,Eldon; John,0,8,75,75
1650451000628,CSE 175,A01,083665,Kumar; Rakesh,7,0,25,18
1650451006665,CSE 190,A00,092507,Dubnov; Shlomo,14,0,20,6
1650451012697,ECE 45,A01,083139,Staff,0,18,40,40
1650451018721,ECE 65,A50,083695,Staff,0,6,30,30
1650451024752,ECE 109,A01,091882,Touri; Behrouz,38,0,70,32
1650451030779,ECE 180,A00,083140,Abi Samra; Nicholas Camill,23,0,30,7
1650451030779,ECE 180,B00,083141,Abi Samra; Nicholas Camill,0,0,30,30
1650451036807,MATH 10A,A01,083735,Patchell; Gregory David,7,0,30,23
1650451036807,MATH 10A,A02,083736,Patchell; Gregory David,28,0,30,2
1650451036807,MATH 10A,A03,083737,Patchell; Gregory David,25,0,30,5
1650451042835,MATH 10B,A01,083207,Staff,0,7,30,30
1650451042835,MATH 10B,A02,083208,Staff,0,7,30,30
1650451042835,MATH 10B,B01,083739,Staff,13,0,30,17
1650451042835,MATH 10B,B02,083740,Staff,28,0,30,2
1650451048873,MATH 18,A01,083743,Staff,1,0,30,29
1650451048873,MATH 18,A02,083744,Staff,27,0,30,3
1650451048873,MATH 18,A03,083745,Staff,22,0,30,8
1650451048873,MATH 18,A04,083746,Staff,26,0,30,4
1650451048873,MATH 18,B01,083748,Staff,0,11,30,30
1650451048873,MATH 18,B02,083749,Staff,0,12,30,30
1650451048873,MATH 18,B03,083750,Staff,0,11,30,30
1650451048873,MATH 18,B04,083751,Staff,0,12,30,30
1650451054898,MATH 20A,A01,083754,Staff,25,0,40,15
1650451060939,MATH 20B,A01,083756,Staff,0,10,30,30
1650451060939,MATH 20B,A02,083757,Staff,0,10,30,30
1650451066967,MATH 20C,A01,083760,Staff,0,15,30,30
1650451066967,MATH 20C,A02,083761,Staff,1,14,30,29
1650451066967,MATH 20C,B01,083762,Staff,13,0,30,17
1650451066967,MATH 20C,B02,083763,Staff,28,0,30,2
1650451072996,MATH 20D,A01,083765,Staff,0,1,30,30
1650451072996,MATH 20D,A02,083766,Staff,9,0,30,21
1650451072996,MATH 20D,A03,083767,Staff,25,0,30,5
1650451079025,MATH 20E,A01,083771,Staff,6,0,30,24
1650451079025,MATH 20E,A02,083772,Staff,18,0,30,12
1650451079025,MATH 20E,B01,083773,Staff,0,0,30,30
1650451079025,MATH 20E,B02,083774,Staff,10,0,30,20
1650451085056,MATH 103A,A01,083777,Staff,0,12,30,30
1650451085056,MATH 103A,A02,083778,Staff,0,12,30,30
1650451085056,MATH 103A,B01,083779,Staff,0,13,30,30
1650451085056,MATH 103A,B02,083780,Staff,0,12,30,30
1650451091084,MATH 105,A01,085443,Staff,0,23,30,30
1650451097116,MATH 109,A01,083213,Anzaldo; Leesa B,0,7,30,30
1650451097116,MATH 109,A02,083214,Anzaldo; Leesa B,0,7,30,30
1650451097116,MATH 109,B01,083215,Anzaldo; Leesa B,0,5,30,30
1650451097116,MATH 109,B02,083216,Anzaldo; Leesa B,0,6,30,30
1650451103149,MATH 142A,A01,083219,Chow; Bennett,0,14,30,30
1650451103149,MATH 142A,A02,083220,Chow; Bennett,0,13,30,30
1650451103149,MATH 142A,B01,083221,Chow; Bennett,0,12,30,30
1650451103149,MATH 142A,B02,083222,Chow; Bennett,0,13,30,30
1650451109175,MATH 193A,A01,083224,Staff,0,5,30,30
1650451109175,MATH 193A,A02,083225,Staff,0,5,30,30
1650451109175,MATH 193A,A03,083781,Staff,0,4,30,30
1650451109175,MATH 193A,A04,083782,Staff,0,5,30,30
1650451115200,MATH 197,001,091859,McAuley; Julian John,9998,0,9999,1
1650451121273,COGS 9,A01,083615,Staff,0,14,60,60
1650451127299,COGS 11,A01,083617,Boyle; Mary E. T.,21,0,40,19
1650451133324,COGS 13,A01,083071,Staff,0,34,40,40
1650451139350,COGS 14A,A01,092681,Staff,1,25,100,99
1650451145378,COGS 14B,A01,083073,Cheng; Tzu-Han,0,11,50,50
1650451151406,COGS 17,A01,092677,Staff,22,0,75,53
1650451157435,COGS 100,A01,083619,Staff,0,26,60,60
1650451163466,COGS 101A,A01,083621,Davis; Joshua Daniel,0,21,60,60
1650451169493,COGS 101B,A01,091572,Staff,0,4,60,60
1650451175519,COGS 101C,A01,083625,Delgado; Tania,16,0,30,14
1650451181546,COGS 107A,A01,083627,Boyle; Mary E. T.,0,11,60,60
1650451187574,COGS 118A,A01,083075,Staff,2,0,60,58
1650451193602,CSE 3,A50,083646,Miranda; Gregory Joseph,20,0,38,18
1650451193602,CSE 3,A51,083647,Miranda; Gregory Joseph,36,0,37,1
1650451199628,CSE 8A,A50,083650,Miranda; Gregory Joseph,0,28,40,40
1650451205658,CSE 11,A01,083080,Cao; Yingjun,0,92,40,40
1650451211684,CSE 12,A01,083652,Staff,0,16,100,100
1650451217709,CSE 15L,A01,083654,Staff,0,1,50,50
1650451217709,CSE 15L,A02,083655,Staff,1,0,50,49
1650451223734,CSE 20,A01,083657,Staff,51,0,80,29
1650451229759,CSE 30,A01,083084,Eldon; John,0,76,40,40
1650451235785,CSE 100,A01,083659,Cao; Yingjun,0,66,50,50
1650451241809,CSE 134B,A01,083661,Powell; Thomas Allan,0,32,65,65
1650451247834,CSE 140,A01,083663,Staff,0,2,75,75
1650451253868,CSE 140L,A01,083088,Eldon; John,0,8,75,75
1650451259894,CSE 175,A01,083665,Kumar; Rakesh,7,0,25,18
1650451265929,CSE 190,A00,092507,Dubnov; Shlomo,14,0,20,6
1650451271958,ECE 45,A01,083139,Staff,0,18,40,40
1650451277983,ECE 65,A50,083695,Staff,0,6,30,30
1650451284010,ECE 109,A01,091882,Touri; Behrouz,38,0,70,32
1650451290036,ECE 180,A00,083140,Abi Samra; Nicholas Camill,23,0,30,7
1650451290036,ECE 180,B00,083141,Abi Samra; Nicholas Camill,0,0,30,30
1650451296063,MATH 10A,A01,083735,Patchell; Gregory David,7,0,30,23
1650451296063,MATH 10A,A02,083736,Patchell; Gregory David,28,0,30,2
1650451296063,MATH 10A,A03,083737,Patchell; Gregory David,25,0,30,5
1650451302091,MATH 10B,A01,083207,Staff,0,7,30,30
1650451302091,MATH 10B,A02,083208,Staff,0,7,30,30
1650451302091,MATH 10B,B01,083739,Staff,13,0,30,17
1650451302091,MATH 10B,B02,083740,Staff,28,0,30,2
1650451308126,MATH 18,A01,083743,Staff,1,0,30,29
1650451308126,MATH 18,A02,083744,Staff,27,0,30,3
1650451308126,MATH 18,A03,083745,Staff,22,0,30,8
1650451308126,MATH 18,A04,083746,Staff,26,0,30,4
1650451308126,MATH 18,B01,083748,Staff,0,11,30,30
1650451308126,MATH 18,B02,083749,Staff,0,12,30,30
1650451308126,MATH 18,B03,083750,Staff,0,11,30,30
1650451308126,MATH 18,B04,083751,Staff,0,12,30,30
1650451314159,MATH 20A,A01,083754,Staff,25,0,40,15
1650451320189,MATH 20B,A01,083756,Staff,0,10,30,30
1650451320189,MATH 20B,A02,083757,Staff,0,10,30,30
1650451326214,MATH 20C,A01,083760,Staff,0,15,30,30
1650451326214,MATH 20C,A02,083761,Staff,1,14,30,29
1650451326214,MATH 20C,B01,083762,Staff,13,0,30,17
1650451326214,MATH 20C,B02,083763,Staff,28,0,30,2
1650451332242,MATH 20D,A01,083765,Staff,0,1,30,30
1650451332242,MATH 20D,A02,083766,Staff,9,0,30,21
1650451332242,MATH 20D,A03,083767,Staff,25,0,30,5
1650451338272,MATH 20E,A01,083771,Staff,6,0,30,24
1650451338272,MATH 20E,A02,083772,Staff,18,0,30,12
1650451338272,MATH 20E,B01,083773,Staff,0,0,30,30
1650451338272,MATH 20E,B02,083774,Staff,10,0,30,20
1650451344296,MATH 103A,A01,083777,Staff,0,12,30,30
1650451344296,MATH 103A,A02,083778,Staff,0,12,30,30
1650451344296,MATH 103A,B01,083779,Staff,0,13,30,30
1650451344296,MATH 103A,B02,083780,Staff,0,12,30,30
1650451350323,MATH 105,A01,085443,Staff,0,23,30,30
1650451356354,MATH 109,A01,083213,Anzaldo; Leesa B,0,7,30,30
1650451356354,MATH 109,A02,083214,Anzaldo; Leesa B,0,7,30,30
1650451356354,MATH 109,B01,083215,Anzaldo; Leesa B,0,5,30,30
1650451356354,MATH 109,B02,083216,Anzaldo; Leesa B,0,6,30,30
1650451362405,MATH 142A,A01,083219,Chow; Bennett,0,14,30,30
1650451362405,MATH 142A,A02,083220,Chow; Bennett,0,13,30,30
1650451362405,MATH 142A,B01,083221,Chow; Bennett,0,12,30,30
1650451362405,MATH 142A,B02,083222,Chow; Bennett,0,13,30,30
1650451368429,MATH 193A,A01,083224,Staff,0,5,30,30
1650451368429,MATH 193A,A02,083225,Staff,0,5,30,30
1650451368429,MATH 193A,A03,083781,Staff,0,4,30,30
1650451368429,MATH 193A,A04,083782,Staff,0,5,30,30
1650451374455,MATH 197,001,091859,McAuley; Julian John,9998,0,9999,1
1650451380524,COGS 9,A01,083615,Staff,0,14,60,60
1650451386547,COGS 11,A01,083617,Boyle; Mary E. T.,21,0,40,19
1650451392575,COGS 13,A01,083071,Staff,0,34,40,40
1650451398603,COGS 14A,A01,092681,Staff,1,25,100,99
1650451404627,COGS 14B,A01,083073,Cheng; Tzu-Han,0,11,50,50
1650451410653,COGS 17,A01,092677,Staff,22,0,75,53
1650451416678,COGS 100,A01,083619,Staff,0,26,60,60
1650451422707,COGS 101A,A01,083621,Davis; Joshua Daniel,0,21,60,60
1650451428738,COGS 101B,A01,091572,Staff,0,4,60,60
1650451434768,COGS 101C,A01,083625,Delgado; Tania,16,0,30,14
1650451440796,COGS 107A,A01,083627,Boyle; Mary E. T.,0,11,60,60
1650451446825,COGS 118A,A01,083075,Staff,2,0,60,58
1650451452857,CSE 3,A50,083646,Miranda; Gregory Joseph,20,0,38,18
1650451452857,CSE 3,A51,083647,Miranda; Gregory Joseph,36,0,37,1
1650451458886,CSE 8A,A50,083650,Miranda; Gregory Joseph,0,28,40,40
1650451464915,CSE 11,A01,083080,Cao; Yingjun,0,92,40,40
1650451470940,CSE 12,A01,083652,Staff,0,16,100,100
1650451476965,CSE 15L,A01,083654,Staff,0,1,50,50
1650451476965,CSE 15L,A02,083655,Staff,1,0,50,49
1650451482989,CSE 20,A01,083657,Staff,51,0,80,29
1650451489015,CSE 30,A01,083084,Eldon; John,0,76,40,40
1650451495046,CSE 100,A01,083659,Cao; Yingjun,0,66,50,50
1650451501087,CSE 134B,A01,083661,Powell; Thomas Allan,0,32,65,65
1650451507116,CSE 140,A01,083663,Staff,0,2,75,75
1650451513142,CSE 140L,A01,083088,Eldon; John,0,8,75,75
1650451519167,CSE 175,A01,083665,Kumar; Rakesh,7,0,25,18
1650451525283,CSE 190,A00,092507,Dubnov; Shlomo,14,0,20,6
1650451531309,ECE 45,A01,083139,Staff,0,18,40,40
1650451537335,ECE 65,A50,083695,Staff,0,6,30,30
1650451543361,ECE 109,A01,091882,Touri; Behrouz,38,0,70,32
1650451549385,ECE 180,A00,083140,Abi Samra; Nicholas Camill,23,0,30,7
1650451549385,ECE 180,B00,083141,Abi Samra; Nicholas Camill,0,0,30,30
1650451555419,MATH 10A,A01,083735,Patchell; Gregory David,7,0,30,23
1650451555419,MATH 10A,A02,083736,Patchell; Gregory David,28,0,30,2
1650451555419,MATH 10A,A03,083737,Patchell; Gregory David,25,0,30,5
1650451561448,MATH 10B,A01,083207,Staff,0,7,30,30
1650451561448,MATH 10B,A02,083208,Staff,0,7,30,30
1650451561448,MATH 10B,B01,083739,Staff,13,0,30,17
1650451561448,MATH 10B,B02,083740,Staff,28,0,30,2
1650451567484,MATH 18,A01,083743,Staff,1,0,30,29
1650451567484,MATH 18,A02,083744,Staff,27,0,30,3
1650451567484,MATH 18,A03,083745,Staff,22,0,30,8
1650451567484,MATH 18,A04,083746,Staff,26,0,30,4
1650451567484,MATH 18,B01,083748,Staff,0,11,30,30
1650451567484,MATH 18,B02,083749,Staff,0,12,30,30
1650451567484,MATH 18,B03,083750,Staff,0,11,30,30
1650451567484,MATH 18,B04,083751,Staff,0,12,30,30
1650451573512,MATH 20A,A01,083754,Staff,25,0,40,15
1650451579538,MATH 20B,A01,083756,Staff,0,10,30,30
1650451579538,MATH 20B,A02,083757,Staff,0,10,30,30
1650451585564,MATH 20C,A01,083760,Staff,0,15,30,30
1650451585564,MATH 20C,A02,083761,Staff,1,14,30,29
1650451585564,MATH 20C,B01,083762,Staff,13,0,30,17
1650451585564,MATH 20C,B02,083763,Staff,28,0,30,2
1650451591592,MATH 20D,A01,083765,Staff,0,1,30,30
1650451591592,MATH 20D,A02,083766,Staff,9,0,30,21
1650451591592,MATH 20D,A03,083767,Staff,25,0,30,5
1650451597618,MATH 20E,A01,083771,Staff,6,0,30,24
1650451597618,MATH 20E,A02,083772,Staff,18,0,30,12
1650451597618,MATH 20E,B01,083773,Staff,0,0,30,30
1650451597618,MATH 20E,B02,083774,Staff,10,0,30,20
1650451603648,MATH 103A,A01,083777,Staff,0,12,30,30
1650451603648,MATH 103A,A02,083778,Staff,0,12,30,30
1650451603648,MATH 103A,B01,083779,Staff,0,13,30,30
1650451603648,MATH 103A,B02,083780,Staff,0,12,30,30
1650451609672,MATH 105,A01,085443,Staff,0,23,30,30
1650451615702,MATH 109,A01,083213,Anzaldo; Leesa B,0,7,30,30
1650451615702,MATH 109,A02,083214,Anzaldo; Leesa B,0,7,30,30
1650451615702,MATH 109,B01,083215,Anzaldo; Leesa B,0,5,30,30
1650451615702,MATH 109,B02,083216,Anzaldo; Leesa B,0,6,30,30
1650451621732,MATH 142A,A01,083219,Chow; Bennett,0,14,30,30
1650451621732,MATH 142A,A02,083220,Chow; Bennett,0,13,30,30
1650451621732,MATH 142A,B01,083221,Chow; Bennett,0,12,30,30
1650451621732,MATH 142A,B02,083222,Chow; Bennett,0,13,30,30
1650451627758,MATH 193A,A01,083224,Staff,0,5,30,30
1650451627758,MATH 193A,A02,083225,Staff,0,5,30,30
1650451627758,MATH 193A,A03,083781,Staff,0,4,30,30
1650451627758,MATH 193A,A04,083782,Staff,0,5,30,30
1650451633783,MATH 197,001,091859,McAuley; Julian John,9998,0,9999,1
1650451639846,COGS 9,A01,083615,Staff,0,14,60,60
1650451645877,COGS 11,A01,083617,Boyle; Mary E. T.,21,0,40,19
1650451651906,COGS 13,A01,083071,Staff,0,34,40,40
1650451657934,COGS 14A,A01,092681,Staff,1,25,100,99
1650451663964,COGS 14B,A01,083073,Cheng; Tzu-Han,0,11,50,50
1650451669988,COGS 17,A01,092677,Staff,22,0,75,53
1650451676013,COGS 100,A01,083619,Staff,0,26,60,60
1650451682044,COGS 101A,A01,083621,Davis; Joshua Daniel,0,21,60,60
1650451688069,COGS 101B,A01,091572,Staff,0,4,60,60
1650451694099,COGS 101C,A01,083625,Delgado; Tania,16,0,30,14
1650451700124,COGS 107A,A01,083627,Boyle; Mary E. T.,0,11,60,60
1650451706151,COGS 118A,A01,083075,Staff,2,0,60,58
1650451712178,CSE 3,A50,083646,Miranda; Gregory Joseph,20,0,38,18
1650451712178,CSE 3,A51,083647,Miranda; Gregory Joseph,36,0,37,1
1650451718211,CSE 8A,A50,083650,Miranda; Gregory Joseph,0,28,40,40
1650451724241,CSE 11,A01,083080,Cao; Yingjun,0,92,40,40
1650451730268,CSE 12,A01,083652,Staff,0,16,100,100
1650451736295,CSE 15L,A01,083654,Staff,0,1,50,50
1650451736295,CSE 15L,A02,083655,Staff,1,0,50,49
1650451742320,CSE 20,A01,083657,Staff,51,0,80,29
1650451748349,CSE 30,A01,083084,Eldon; John,0,76,40,40
1650451754374,CSE 100,A01,083659,Cao; Yingjun,0,66,50,50
1650451760399,CSE 134B,A01,083661,Powell; Thomas Allan,0,32,65,65
1650451766424,CSE 140,A01,083663,Staff,0,2,75,75
1650451772451,CSE 140L,A01,083088,Eldon; John,0,8,75,75
1650451778476,CSE 175,A01,083665,Kumar; Rakesh,7,0,25,18
1650451784517,CSE 190,A00,092507,Dubnov; Shlomo,14,0,20,6
1650451790546,ECE 45,A01,083139,Staff,0,18,40,40
1650451796579,ECE 65,A50,083695,Staff,0,6,30,30
1650451802609,ECE 109,A01,091882,Touri; Behrouz,38,0,70,32
1650451808633,ECE 180,A00,083140,Abi Samra; Nicholas Camill,23,0,30,7
1650451808633,ECE 180,B00,083141,Abi Samra; Nicholas Camill,0,0,30,30
1650451814660,MATH 10A,A01,083735,Patchell; Gregory David,7,0,30,23
1650451814660,MATH 10A,A02,083736,Patchell; Gregory David,28,0,30,2
1650451814660,MATH 10A,A03,083737,Patchell; Gregory David,25,0,30,5
1650451820689,MATH 10B,A01,083207,Staff,0,7,30,30
1650451820689,MATH 10B,A02,083208,Staff,0,7,30,30
1650451820689,MATH 10B,B01,083739,Staff,13,0,30,17
1650451820689,MATH 10B,B02,083740,Staff,28,0,30,2
1650451826718,MATH 18,A01,083743,Staff,1,0,30,29
1650451826718,MATH 18,A02,083744,Staff,27,0,30,3
1650451826718,MATH 18,A03,083745,Staff,22,0,30,8
1650451826718,MATH 18,A04,083746,Staff,26,0,30,4
1650451826718,MATH 18,B01,083748,Staff,0,11,30,30
1650451826718,MATH 18,B02,083749,Staff,0,12,30,30
1650451826718,MATH 18,B03,083750,Staff,0,11,30,30
1650451826718,MATH 18,B04,083751,Staff,0,12,30,30
1650451832743,MATH 20A,A01,083754,Staff,25,0,40,15
1650451838772,MATH 20B,A01,083756,Staff,0,10,30,30
1650451838772,MATH 20B,A02,083757,Staff,0,10,30,30
1650451844799,MATH 20C,A01,083760,Staff,0,15,30,30
1650451844799,MATH 20C,A02,083761,Staff,1,14,30,29
1650451844799,MATH 20C,B01,083762,Staff,13,0,30,17
1650451844799,MATH 20C,B02,083763,Staff,28,0,30,2
1650451850830,MATH 20D,A01,083765,Staff,0,1,30,30
1650451850830,MATH 20D,A02,083766,Staff,9,0,30,21
1650451850830,MATH 20D,A03,083767,Staff,25,0,30,5
1650451856859,MATH 20E,A01,083771,Staff,6,0,30,24
1650451856859,MATH 20E,A02,083772,Staff,18,0,30,12
1650451856859,MATH 20E,B01,083773,Staff,0,0,30,30
1650451856859,MATH 20E,B02,083774,Staff,10,0,30,20
1650451862891,MATH 103A,A01,083777,Staff,0,12,30,30
1650451862891,MATH 103A,A02,083778,Staff,0,12,30,30
1650451862891,MATH 103A,B01,083779,Staff,0,13,30,30
1650451862891,MATH 103A,B02,083780,Staff,0,12,30,30
1650451868914,MATH 105,A01,085443,Staff,0,23,30,30
1650451874947,MATH 109,A01,083213,Anzaldo; Leesa B,0,7,30,30
1650451874947,MATH 109,A02,083214,Anzaldo; Leesa B,0,7,30,30
1650451874947,MATH 109,B01,083215,Anzaldo; Leesa B,0,5,30,30
1650451874947,MATH 109,B02,083216,Anzaldo; Leesa B,0,6,30,30
1650451880977,MATH 142A,A01,083219,Chow; Bennett,0,14,30,30
1650451880977,MATH 142A,A02,083220,Chow; Bennett,0,13,30,30
1650451880977,MATH 142A,B01,083221,Chow; Bennett,0,12,30,30
1650451880977,MATH 142A,B02,083222,Chow; Bennett,0,13,30,30
1650451887008,MATH 193A,A01,083224,Staff,0,5,30,30
1650451887008,MATH 193A,A02,083225,Staff,0,5,30,30
1650451887008,MATH 193A,A03,083781,Staff,0,4,30,30
1650451887008,MATH 193A,A04,083782,Staff,0,5,30,30
1650451893033,MATH 197,001,091859,McAuley; Julian John,9998,0,9999,1
1650451899096,COGS 9,A01,083615,Staff,0,14,60,60
1650451905124,COGS 11,A01,083617,Boyle; Mary E. T.,21,0,40,19
1650451911153,COGS 13,A01,083071,Staff,0,34,40,40
1650451917181,COGS 14A,A01,092681,Staff,1,25,100,99
1650451923206,COGS 14B,A01,083073,Cheng; Tzu-Han,0,11,50,50
1650451929231,COGS 17,A01,092677,Staff,22,0,75,53
1650451935261,COGS 100,A01,083619,Staff,0,26,60,60
1650451941292,COGS 101A,A01,083621,Davis; Joshua Daniel,0,21,60,60
1650451947322,COGS 101B,A01,091572,Staff,0,4,60,60
1650451953347,COGS 101C,A01,083625,Delgado; Tania,16,0,30,14
1650451959383,COGS 107A,A01,083627,Boyle; Mary E. T.,0,11,60,60
1650451965413,COGS 118A,A01,083075,Staff,2,0,60,58
1650451971445,CSE 3,A50,083646,Miranda; Gregory Joseph,20,0,38,18
1650451971445,CSE 3,A51,083647,Miranda; Gregory Joseph,36,0,37,1
1650451977474,CSE 8A,A50,083650,Miranda; Gregory Joseph,0,28,40,40
1650451983503,CSE 11,A01,083080,Cao; Yingjun,0,92,40,40
1650451989538,CSE 12,A01,083652,Staff,0,16,100,100
1650451995561,CSE 15L,A01,083654,Staff,0,1,50,50
1650451995561,CSE 15L,A02,083655,Staff,1,0,50,49
1650452001585,CSE 20,A01,083657,Staff,51,0,80,29
1650452007610,CSE 30,A01,083084,Eldon; John,0,76,40,40
1650452013639,CSE 100,A01,083659,Cao; Yingjun,0,66,50,50
1650452019672,CSE 134B,A01,083661,Powell; Thomas Allan,0,32,65,65
1650452025704,CSE 140,A01,083663,Staff,0,2,75,75
1650452031733,CSE 140L,A01,083088,Eldon; John,0,8,75,75
1650452037764,CSE 175,A01,083665,Kumar; Rakesh,7,0,25,18
1650452043788,CSE 190,A00,092507,Dubnov; Shlomo,14,0,20,6
1650452049812,ECE 45,A01,083139,Staff,0,18,40,40
1650452055837,ECE 65,A50,083695,Staff,0,6,30,30
1650452061866,ECE 109,A01,091882,Touri; Behrouz,38,0,70,32
1650452067906,ECE 180,A00,083140,Abi Samra; Nicholas Camill,23,0,30,7
1650452067906,ECE 180,B00,083141,Abi Samra; Nicholas Camill,0,0,30,30
1650452073933,MATH 10A,A01,083735,Patchell; Gregory David,7,0,30,23
1650452073933,MATH 10A,A02,083736,Patchell; Gregory David,28,0,30,2
1650452073933,MATH 10A,A03,083737,Patchell; Gregory David,25,0,30,5
1650452079969,MATH 10B,A01,083207,Staff,0,7,30,30
1650452079969,MATH 10B,A02,083208,Staff,0,7,30,30
1650452079969,MATH 10B,B01,083739,Staff,13,0,30,17
1650452079969,MATH 10B,B02,083740,Staff,28,0,30,2
1650452085999,MATH 18,A01,083743,Staff,1,0,30,29
1650452085999,MATH 18,A02,083744,Staff,27,0,30,3
1650452085999,MATH 18,A03,083745,Staff,22,0,30,8
1650452085999,MATH 18,A04,083746,Staff,26,0,30,4
1650452085999,MATH 18,B01,083748,Staff,0,11,30,30
1650452085999,MATH 18,B02,083749,Staff,0,12,30,30
1650452085999,MATH 18,B03,083750,Staff,0,11,30,30
1650452085999,MATH 18,B04,083751,Staff,0,12,30,30
1650452092028,MATH 20A,A01,083754,Staff,25,0,40,15
1650452098060,MATH 20B,A01,083756,Staff,0,10,30,30
1650452098060,MATH 20B,A02,083757,Staff,0,10,30,30
1650452104087,MATH 20C,A01,083760,Staff,0,15,30,30
1650452104087,MATH 20C,A02,083761,Staff,1,14,30,29
1650452104087,MATH 20C,B01,083762,Staff,13,0,30,17
1650452104087,MATH 20C,B02,083763,Staff,28,0,30,2
1650452110113,MATH 20D,A01,083765,Staff,0,1,30,30
1650452110113,MATH 20D,A02,083766,Staff,9,0,30,21
1650452110113,MATH 20D,A03,083767,Staff,25,0,30,5
1650452116140,MATH 20E,A01,083771,Staff,6,0,30,24
1650452116140,MATH 20E,A02,083772,Staff,18,0,30,12
1650452116140,MATH 20E,B01,083773,Staff,0,0,30,30
1650452116140,MATH 20E,B02,083774,Staff,10,0,30,20
1650452122255,MATH 103A,A01,083777,Staff,0,12,30,30
1650452122255,MATH 103A,A02,083778,Staff,0,12,30,30
1650452122255,MATH 103A,B01,083779,Staff,0,13,30,30
1650452122255,MATH 103A,B02,083780,Staff,0,12,30,30
1650452128299,MATH 105,A01,085443,Staff,0,23,30,30
1650452134330,MATH 109,A01,083213,Anzaldo; Leesa B,0,7,30,30
1650452134330,MATH 109,A02,083214,Anzaldo; Leesa B,0,7,30,30
1650452134330,MATH 109,B01,083215,Anzaldo; Leesa B,0,5,30,30
1650452134330,MATH 109,B02,083216,Anzaldo; Leesa B,0,6,30,30
1650452140363,MATH 142A,A01,083219,Chow; Bennett,0,14,30,30
1650452140363,MATH 142A,A02,083220,Chow; Bennett,0,13,30,30
1650452140363,MATH 142A,B01,083221,Chow; Bennett,0,12,30,30
1650452140363,MATH 142A,B02,083222,Chow; Bennett,0,13,30,30
1650452146393,MATH 193A,A01,083224,Staff,0,5,30,30
1650452146393,MATH 193A,A02,083225,Staff,0,5,30,30
1650452146393,MATH 193A,A03,083781,Staff,0,4,30,30
1650452146393,MATH 193A,A04,083782,Staff,0,5,30,30
1650452152420,MATH 197,001,091859,McAuley; Julian John,9998,0,9999,1
1650452158481,COGS 9,A01,083615,Staff,0,14,60,60
1650452164511,COGS 11,A01,083617,Boyle; Mary E. T.,21,0,40,19
1650452170537,COGS 13,A01,083071,Staff,0,34,40,40
1650452176565,COGS 14A,A01,092681,Staff,1,25,100,99
1650452182590,COGS 14B,A01,083073,Cheng; Tzu-Han,0,11,50,50
1650452188615,COGS 17,A01,092677,Staff,22,0,75,53
1650452194645,COGS 100,A01,083619,Staff,0,26,60,60
1650452200670,COGS 101A,A01,083621,Davis; Joshua Daniel,0,21,60,60
1650452206697,COGS 101B,A01,091572,Staff,0,4,60,60
1650452212728,COGS 101C,A01,083625,Delgado; Tania,16,0,30,14
1650452218750,COGS 107A,A01,083627,Boyle; Mary E. T.,0,11,60,60
1650452224785,COGS 118A,A01,083075,Staff,2,0,60,58
1650452230811,CSE 3,A50,083646,Miranda; Gregory Joseph,20,0,38,18
1650452230811,CSE 3,A51,083647,Miranda; Gregory Joseph,36,0,37,1
1650452236839,CSE 8A,A50,083650,Miranda; Gregory Joseph,0,28,40,40
1650452242868,CSE 11,A01,083080,Cao; Yingjun,0,92,40,40
1650452248893,CSE 12,A01,083652,Staff,0,16,100,100
1650452254918,CSE 15L,A01,083654,Staff,0,1,50,50
1650452254918,CSE 15L,A02,083655,Staff,1,0,50,49
1650452260943,CSE 20,A01,083657,Staff,51,0,80,29
1650452266976,CSE 30,A01,083084,Eldon; John,0,76,40,40
1650452273004,CSE 100,A01,083659,Cao; Yingjun,0,66,50,50
1650452279035,CSE 134B,A01,083661,Powell; Thomas Allan,0,32,65,65
1650452285059,CSE 140,A01,083663,Staff,0,2,75,75
1650452291087,CSE 140L,A01,083088,Eldon; John,0,8,75,75
1650452297114,CSE 175,A01,083665,Kumar; Rakesh,7,0,25,18
1650452303139,CSE 190,A00,092507,Dubnov; Shlomo,14,0,20,6
1650452309168,ECE 45,A01,083139,Staff,0,18,40,40
1650452315191,ECE 65,A50,083695,Staff,0,6,30,30
1650452321220,ECE 109,A01,091882,Touri; Behrouz,38,0,70,32
1650452327246,ECE 180,A00,083140,Abi Samra; Nicholas Camill,23,0,30,7
1650452327246,ECE 180,B00,083141,Abi Samra; Nicholas Camill,0,0,30,30
1650452333282,MATH 10A,A01,083735,Patchell; Gregory David,7,0,30,23
1650452333282,MATH 10A,A02,083736,Patchell; Gregory David,28,0,30,2
1650452333282,MATH 10A,A03,083737,Patchell; Gregory David,25,0,30,5
1650452339312,MATH 10B,A01,083207,Staff,0,7,30,30
1650452339312,MATH 10B,A02,083208,Staff,0,7,30,30
1650452339312,MATH 10B,B01,083739,Staff,13,0,30,17
1650452339312,MATH 10B,B02,083740,Staff,28,0,30,2
1650452345343,MATH 18,A01,083743,Staff,1,0,30,29
1650452345343,MATH 18,A02,083744,Staff,27,0,30,3
1650452345343,MATH 18,A03,083745,Staff,22,0,30,8
1650452345343,MATH 18,A04,083746,Staff,26,0,30,4
1650452345343,MATH 18,B01,083748,Staff,0,11,30,30
1650452345343,MATH 18,B02,083749,Staff,0,12,30,30
1650452345343,MATH 18,B03,083750,Staff,0,11,30,30
1650452345343,MATH 18,B04,083751,Staff,0,12,30,30
1650452351368,MATH 20A,A01,083754,Staff,25,0,40,15
1650452357393,MATH 20B,A01,083756,Staff,0,10,30,30
1650452357393,MATH 20B,A02,083757,Staff,0,10,30,30
1650452363422,MATH 20C,A01,083760,Staff,0,15,30,30
1650452363422,MATH 20C,A02,083761,Staff,1,14,30,29
1650452363422,MATH 20C,B01,083762,Staff,13,0,30,17
1650452363422,MATH 20C,B02,083763,Staff,28,0,30,2
1650452369447,MATH 20D,A01,083765,Staff,0,1,30,30
1650452369447,MATH 20D,A02,083766,Staff,9,0,30,21
1650452369447,MATH 20D,A03,083767,Staff,25,0,30,5
1650452375470,MATH 20E,A01,083771,Staff,6,0,30,24
1650452375470,MATH 20E,A02,083772,Staff,18,0,30,12
1650452375470,MATH 20E,B01,083773,Staff,0,0,30,30
1650452375470,MATH 20E,B02,083774,Staff,10,0,30,20
1650452381496,MATH 103A,A01,083777,Staff,0,12,30,30
1650452381496,MATH 103A,A02,083778,Staff,0,12,30,30
1650452381496,MATH 103A,B01,083779,Staff,0,13,30,30
1650452381496,MATH 103A,B02,083780,Staff,0,12,30,30
1650452387519,MATH 105,A01,085443,Staff,0,23,30,30
1650452393544,MATH 109,A01,083213,Anzaldo; Leesa B,0,7,30,30
1650452393544,MATH 109,A02,083214,Anzaldo; Leesa B,0,7,30,30
1650452393544,MATH 109,B01,083215,Anzaldo; Leesa B,0,5,30,30
1650452393544,MATH 109,B02,083216,Anzaldo; Leesa B,0,6,30,30
1650452399574,MATH 142A,A01,083219,Chow; Bennett,0,14,30,30
1650452399574,MATH 142A,A02,083220,Chow; Bennett,0,13,30,30
1650452399574,MATH 142A,B01,083221,Chow; Bennett,0,12,30,30
1650452399574,MATH 142A,B02,083222,Chow; Bennett,0,13,30,30
1650452405597,MATH 193A,A01,083224,Staff,0,5,30,30
1650452405597,MATH 193A,A02,083225,Staff,0,5,30,30
1650452405597,MATH 193A,A03,083781,Staff,0,4,30,30
1650452405597,MATH 193A,A04,083782,Staff,0,5,30,30
1650452411626,MATH 197,001,091859,McAuley; Julian John,9998,0,9999,1
1650452417685,COGS 9,A01,083615,Staff,0,14,60,60
1650452423715,COGS 11,A01,083617,Boyle; Mary E. T.,21,0,40,19
1650452429742,COGS 13,A01,083071,Staff,0,34,40,40
1650452435765,COGS 14A,A01,092681,Staff,1,25,100,99
1650452441790,COGS 14B,A01,083073,Cheng; Tzu-Han,0,11,50,50
1650452447819,COGS 17,A01,092677,Staff,22,0,75,53
1650452453847,COGS 100,A01,083619,Staff,0,26,60,60
1650452459880,COGS 101A,A01,083621,Davis; Joshua Daniel,0,21,60,60
1650452465917,COGS 101B,A01,091572,Staff,0,4,60,60
1650452471946,COGS 101C,A01,083625,Delgado; Tania,16,0,30,14
1650452477970,COGS 107A,A01,083627,Boyle; Mary E. T.,0,11,60,60
1650452483993,COGS 118A,A01,083075,Staff,2,0,60,58
1650452490018,CSE 3,A50,083646,Miranda; Gregory Joseph,20,0,38,18
1650452490018,CSE 3,A51,083647,Miranda; Gregory Joseph,36,0,37,1
1650452496043,CSE 8A,A50,083650,Miranda; Gregory Joseph,0,28,40,40
1650452502069,CSE 11,A01,083080,Cao; Yingjun,0,92,40,40
1650452508098,CSE 12,A01,083652,Staff,0,16,100,100
1650452514127,CSE 15L,A01,083654,Staff,0,1,50,50
1650452514127,CSE 15L,A02,083655,Staff,1,0,50,49
1650452520158,CSE 20,A01,083657,Staff,51,0,80,29
1650452526184,CSE 30,A01,083084,Eldon; John,0,76,40,40
1650452532220,CSE 100,A01,083659,Cao; Yingjun,0,66,50,50
1650452538250,CSE 134B,A01,083661,Powell; Thomas Allan,0,32,65,65
1650452544277,CSE 140,A01,083663,Staff,0,2,75,75
1650452550301,CSE 140L,A01,083088,Eldon; John,0,8,75,75
1650452556331,CSE 175,A01,083665,Kumar; Rakesh,7,0,25,18
1650452562361,CSE 190,A00,092507,Dubnov; Shlomo,14,0,20,6
1650452568387,ECE 45,A01,083139,Staff,0,18,40,40
1650452574412,ECE 65,A50,083695,Staff,0,6,30,30
1650452580437,ECE 109,A01,091882,Touri; Behrouz,38,0,70,32
1650452586461,ECE 180,A00,083140,Abi Samra; Nicholas Camill,23,0,30,7
1650452586461,ECE 180,B00,083141,Abi Samra; Nicholas Camill,0,0,30,30
1650452592486,MATH 10A,A01,083735,Patchell; Gregory David,7,0,30,23
1650452592486,MATH 10A,A02,083736,Patchell; Gregory David,28,0,30,2
1650452592486,MATH 10A,A03,083737,Patchell; Gregory David,25,0,30,5
1650452598517,MATH 10B,A01,083207,Staff,0,7,30,30
1650452598517,MATH 10B,A02,083208,Staff,0,7,30,30
1650452598517,MATH 10B,B01,083739,Staff,13,0,30,17
1650452598517,MATH 10B,B02,083740,Staff,28,0,30,2
1650452604556,MATH 18,A01,083743,Staff,1,0,30,29
1650452604556,MATH 18,A02,083744,Staff,27,0,30,3
1650452604556,MATH 18,A03,083745,Staff,22,0,30,8
1650452604556,MATH 18,A04,083746,Staff,26,0,30,4
1650452604556,MATH 18,B01,083748,Staff,0,11,30,30
1650452604556,MATH 18,B02,083749,Staff,0,12,30,30
1650452604556,MATH 18,B03,083750,Staff,0,11,30,30
1650452604556,MATH 18,B04,083751,Staff,0,12,30,30
1650452610590,MATH 20A,A01,083754,Staff,25,0,40,15
1650452616621,MATH 20B,A01,083756,Staff,0,10,30,30
1650452616621,MATH 20B,A02,083757,Staff,0,10,30,30
1650452622648,MATH 20C,A01,083760,Staff,0,15,30,30
1650452622648,MATH 20C,A02,083761,Staff,1,14,30,29
1650452622648,MATH 20C,B01,083762,Staff,13,0,30,17
1650452622648,MATH 20C,B02,083763,Staff,28,0,30,2
1650452628673,MATH 20D,A01,083765,Staff,0,1,30,30
1650452628673,MATH 20D,A02,083766,Staff,9,0,30,21
1650452628673,MATH 20D,A03,083767,Staff,25,0,30,5
1650452634774,MATH 20E,A01,083771,Staff,6,0,30,24
1650452634774,MATH 20E,A02,083772,Staff,18,0,30,12
1650452634774,MATH 20E,B01,083773,Staff,0,0,30,30
1650452634774,MATH 20E,B02,083774,Staff,10,0,30,20
1650452640807,MATH 103A,A01,083777,Staff,0,12,30,30
1650452640807,MATH 103A,A02,083778,Staff,0,12,30,30
1650452640807,MATH 103A,B01,083779,Staff,0,13,30,30
1650452640807,MATH 103A,B02,083780,Staff,0,12,30,30
1650452646836,MATH 105,A01,085443,Staff,0,23,30,30
1650452652861,MATH 109,A01,083213,Anzaldo; Leesa B,0,7,30,30
1650452652861,MATH 109,A02,083214,Anzaldo; Leesa B,0,7,30,30
1650452652861,MATH 109,B01,083215,Anzaldo; Leesa B,0,5,30,30
1650452652861,MATH 109,B02,083216,Anzaldo; Leesa B,0,6,30,30
1650452658895,MATH 142A,A01,083219,Chow; Bennett,0,14,30,30
1650452658895,MATH 142A,A02,083220,Chow; Bennett,0,13,30,30
1650452658895,MATH 142A,B01,083221,Chow; Bennett,0,12,30,30
1650452658895,MATH 142A,B02,083222,Chow; Bennett,0,13,30,30
1650452664923,MATH 193A,A01,083224,Staff,0,5,30,30
1650452664923,MATH 193A,A02,083225,Staff,0,5,30,30
1650452664923,MATH 193A,A03,083781,Staff,0,4,30,30
1650452664923,MATH 193A,A04,083782,Staff,0,5,30,30
1650452670951,MATH 197,001,091859,McAuley; Julian John,9998,0,9999,1
1650452677032,COGS 9,A01,083615,Staff,0,14,60,60
1650452683064,COGS 11,A01,083617,Boyle; Mary E. T.,21,0,40,19
1650452689094,COGS 13,A01,083071,Staff,0,34,40,40
1650452695121,COGS 14A,A01,092681,Staff,1,25,100,99
1650452701148,COGS 14B,A01,083073,Cheng; Tzu-Han,0,11,50,50
1650452707173,COGS 17,A01,092677,Staff,22,0,75,53
1650452713198,COGS 100,A01,083619,Staff,0,26,60,60
1650452719222,COGS 101A,A01,083621,Davis; Joshua Daniel,0,21,60,60
1650452725253,COGS 101B,A01,091572,Staff,0,4,60,60
1650452731278,COGS 101C,A01,083625,Delgado; Tania,16,0,30,14
1650452737307,COGS 107A,A01,083627,Boyle; Mary E. T.,0,11,60,60
1650452743337,COGS 118A,A01,083075,Staff,2,0,60,58
1650452749364,CSE 3,A50,083646,Miranda; Gregory Joseph,20,0,38,18
1650452749364,CSE 3,A51,083647,Miranda; Gregory Joseph,36,0,37,1
1650452755390,CSE 8A,A50,083650,Miranda; Gregory Joseph,0,28,40,40
1650452761428,CSE 11,A01,083080,Cao; Yingjun,0,92,40,40
1650452767457,CSE 12,A01,083652,Staff,0,16,100,100
1650452773482,CSE 15L,A01,083654,Staff,0,1,50,50
1650452773482,CSE 15L,A02,083655,Staff,1,0,50,49
1650452779512,CSE 20,A01,083657,Staff,51,0,80,29
1650452785537,CSE 30,A01,083084,Eldon; John,0,76,40,40
1650452791569,CSE 100,A01,083659,Cao; Yingjun,0,66,50,50
1650452797604,CSE 134B,A01,083661,Powell; Thomas Allan,0,32,65,65
1650452803630,CSE 140,A01,083663,Staff,0,2,75,75
1650452809659,CSE 140L,A01,083088,Eldon; John,0,8,75,75
1650452815687,CSE 175,A01,083665,Kumar; Rakesh,7,0,25,18
1650452821714,CSE 190,A00,092507,Dubnov; Shlomo,14,0,20,6
1650452827739,ECE 45,A01,083139,Staff,0,18,40,40
1650452833768,ECE 65,A50,083695,Staff,0,6,30,30
1650452839800,ECE 109,A01,091882,Touri; Behrouz,38,0,70,32
1650452845831,ECE 180,A00,083140,Abi Samra; Nicholas Camill,23,0,30,7
1650452845831,ECE 180,B00,083141,Abi Samra; Nicholas Camill,0,0,30,30
1650452851860,MATH 10A,A01,083735,Patchell; Gregory David,7,0,30,23
1650452851860,MATH 10A,A02,083736,Patchell; Gregory David,28,0,30,2
1650452851860,MATH 10A,A03,083737,Patchell; Gregory David,25,0,30,5
1650452857893,MATH 10B,A01,083207,Staff,0,7,30,30
1650452857893,MATH 10B,A02,083208,Staff,0,7,30,30
1650452857893,MATH 10B,B01,083739,Staff,13,0,30,17
1650452857893,MATH 10B,B02,083740,Staff,28,0,30,2
1650452863927,MATH 18,A01,083743,Staff,1,0,30,29
1650452863927,MATH 18,A02,083744,Staff,27,0,30,3
1650452863927,MATH 18,A03,083745,Staff,22,0,30,8
1650452863927,MATH 18,A04,083746,Staff,26,0,30,4
1650452863927,MATH 18,B01,083748,Staff,0,11,30,30
1650452863927,MATH 18,B02,083749,Staff,0,12,30,30
1650452863927,MATH 18,B03,083750,Staff,0,11,30,30
1650452863927,MATH 18,B04,083751,Staff,0,12,30,30
1650452869957,MATH 20A,A01,083754,Staff,25,0,40,15
1650452875994,MATH 20B,A01,083756,Staff,0,10,30,30
1650452875994,MATH 20B,A02,083757,Staff,0,10,30,30
1650452882029,MATH 20C,A01,083760,Staff,0,15,30,30
1650452882029,MATH 20C,A02,083761,Staff,1,14,30,29
1650452882029,MATH 20C,B01,083762,Staff,13,0,30,17
1650452882029,MATH 20C,B02,083763,Staff,28,0,30,2
1650452888054,MATH 20D,A01,083765,Staff,0,1,30,30
1650452888054,MATH 20D,A02,083766,Staff,9,0,30,21
1650452888054,MATH 20D,A03,083767,Staff,25,0,30,5
1650452894079,MATH 20E,A01,083771,Staff,6,0,30,24
1650452894079,MATH 20E,A02,083772,Staff,18,0,30,12
1650452894079,MATH 20E,B01,083773,Staff,0,0,30,30
1650452894079,MATH 20E,B02,083774,Staff,10,0,30,20
1650452900106,MATH 103A,A01,083777,Staff,0,12,30,30
1650452900106,MATH 103A,A02,083778,Staff,0,12,30,30
1650452900106,MATH 103A,B01,083779,Staff,0,13,30,30
1650452900106,MATH 103A,B02,083780,Staff,0,12,30,30
1650452906132,MATH 105,A01,085443,Staff,0,23,30,30
1650452912158,MATH 109,A01,083213,Anzaldo; Leesa B,0,7,30,30
1650452912158,MATH 109,A02,083214,Anzaldo; Leesa B,0,7,30,30
1650452912158,MATH 109,B01,083215,Anzaldo; Leesa B,0,5,30,30
1650452912158,MATH 109,B02,083216,Anzaldo; Leesa B,0,6,30,30
1650452918184,MATH 142A,A01,083219,Chow; Bennett,0,14,30,30
1650452918184,MATH 142A,A02,083220,Chow; Bennett,0,13,30,30
1650452918184,MATH 142A,B01,083221,Chow; Bennett,0,12,30,30
1650452918184,MATH 142A,B02,083222,Chow; Bennett,0,13,30,30
1650452924210,MATH 193A,A01,083224,Staff,0,5,30,30
1650452924210,MATH 193A,A02,083225,Staff,0,5,30,30
1650452924210,MATH 193A,A03,083781,Staff,0,4,30,30
1650452924210,MATH 193A,A04,083782,Staff,0,5,30,30
1650452930235,MATH 197,001,091859,McAuley; Julian John,9998,0,9999,1
1650452936306,COGS 9,A01,083615,Staff,0,14,60,60
1650452942333,COGS 11,A01,083617,Boyle; Mary E. T.,21,0,40,19
1650452948365,COGS 13,A01,083071,Staff,0,34,40,40
1650452954394,COGS 14A,A01,092681,Staff,1,25,100,99
1650452960420,COGS 14B,A01,083073,Cheng; Tzu-Han,0,11,50,50
1650452966448,COGS 17,A01,092677,Staff,22,0,75,53
1650452972472,COGS 100,A01,083619,Staff,0,26,60,60
1650452978497,COGS 101A,A01,083621,Davis; Joshua Daniel,0,21,60,60
1650452984531,COGS 101B,A01,091572,Staff,0,4,60,60
1650452990555,COGS 101C,A01,083625,Delgado; Tania,16,0,30,14
1650452996591,COGS 107A,A01,083627,Boyle; Mary E. T.,0,11,60,60
1650453002619,COGS 118A,A01,083075,Staff,2,0,60,58
1650453008646,CSE 3,A50,083646,Miranda; Gregory Joseph,20,0,38,18
1650453008646,CSE 3,A51,083647,Miranda; Gregory Joseph,36,0,37,1
1650453014671,CSE 8A,A50,083650,Miranda; Gregory Joseph,0,28,40,40
1650453020700,CSE 11,A01,083080,Cao; Yingjun,0,92,40,40
