time,subj_course_id,sec_code,sec_id,prof,available,waitlist,total,enrolled_ct
1650280962515,COGS 9,A01,083615,Staff,0,14,60,60
1650280968551,COGS 11,A01,083617,Boyle; Mary E. T.,24,0,40,16
1650280974583,COGS 13,A01,083071,Staff,0,31,40,40
1650280980615,COGS 14A,A01,092681,Staff,0,15,100,100
1650280986648,COGS 14B,A01,083073,Cheng; Tzu-Han,0,9,50,50
1650280992678,COGS 17,A01,092677,Staff,29,0,75,46
1650280998710,COGS 100,A01,083619,Staff,0,23,60,60
1650281004748,COGS 101A,A01,083621,Davis; Joshua Daniel,0,21,60,60
1650281010780,COGS 101B,A01,091572,Staff,4,0,60,56
1650281016816,COGS 101C,A01,083625,Delgado; Tania,19,0,30,11
1650281022850,COGS 107A,A01,083627,Boyle; Mary E. T.,0,8,60,60
1650281028883,COGS 118A,A01,083075,Staff,13,0,60,47
1650281034974,CSE 3,A50,083646,Miranda; Gregory Joseph,21,0,38,17
1650281034974,CSE 3,A51,083647,Miranda; Gregory Joseph,37,0,37,0
1650281041009,CSE 8A,A50,083650,Miranda; Gregory Joseph,0,22,40,40
1650281047036,CSE 11,A01,083080,Cao; Yingjun,0,74,40,40
1650281053067,CSE 12,A01,083652,Staff,0,10,100,100
1650281059098,CSE 15L,A01,083654,Staff,0,1,50,50
1650281059098,CSE 15L,A02,083655,Staff,4,0,50,46
1650281065134,CSE 20,A01,083657,Staff,53,0,80,27
1650281071166,CSE 30,A01,083084,Eldon; John,0,74,40,40
1650281077202,CSE 100,A01,083659,Cao; Yingjun,0,65,50,50
1650281083237,CSE 134B,A01,083661,Powell; Thomas Allan,0,28,65,65
1650281089267,CSE 140,A01,083663,Staff,0,0,75,75
1650281095314,CSE 140L,A01,083088,Eldon; John,0,6,75,75
1650281101355,CSE 175,A01,083665,Kumar; Rakesh,8,0,25,17
1650281107387,CSE 190,A00,092507,Dubnov; Shlomo,14,0,20,6
1650281113420,ECE 45,A01,083139,Staff,0,15,40,40
1650281119449,ECE 65,A50,083695,Staff,0,4,30,30
1650281125483,ECE 109,A01,091882,Touri; Behrouz,43,0,70,27
1650281131517,ECE 180,A00,083140,Abi Samra; Nicholas Camill,24,0,30,6
1650281131517,ECE 180,B00,083141,Abi Samra; Nicholas Camill,7,0,30,23
1650281137551,MATH 10A,A01,083735,Patchell; Gregory David,11,0,30,19
1650281137551,MATH 10A,A02,083736,Patchell; Gregory David,28,0,30,2
1650281137551,MATH 10A,A03,083737,Patchell; Gregory David,26,0,30,4
1650281143584,MATH 10B,A01,083207,Staff,0,6,30,30
1650281143584,MATH 10B,A02,083208,Staff,0,6,30,30
1650281143584,MATH 10B,B01,083739,Staff,17,0,30,13
1650281143584,MATH 10B,B02,083740,Staff,29,0,30,1
1650281149623,MATH 18,A01,083743,Staff,7,0,30,23
1650281149623,MATH 18,A02,083744,Staff,27,0,30,3
1650281149623,MATH 18,A03,083745,Staff,23,0,30,7
1650281149623,MATH 18,A04,083746,Staff,27,0,30,3
1650281149623,MATH 18,B01,083748,Staff,0,11,30,30
1650281149623,MATH 18,B02,083749,Staff,0,9,30,30
1650281149623,MATH 18,B03,083750,Staff,1,8,30,29
1650281149623,MATH 18,B04,083751,Staff,0,9,30,30
1650281155656,MATH 20A,A01,083754,Staff,26,0,40,14
1650281161690,MATH 20B,A01,083756,Staff,0,5,30,30
1650281161690,MATH 20B,A02,083757,Staff,0,7,30,30
1650281167719,MATH 20C,A01,083760,Staff,0,13,30,30
1650281167719,MATH 20C,A02,083761,Staff,0,13,30,30
1650281167719,MATH 20C,B01,083762,Staff,14,0,30,16
1650281167719,MATH 20C,B02,083763,Staff,28,0,30,2
1650281173749,MATH 20D,A01,083765,Staff,0,1,30,30
1650281173749,MATH 20D,A02,083766,Staff,8,0,30,22
1650281173749,MATH 20D,A03,083767,Staff,28,0,30,2
1650281179780,MATH 20E,A01,083771,Staff,6,0,30,24
1650281179780,MATH 20E,A02,083772,Staff,20,0,30,10
1650281179780,MATH 20E,B01,083773,Staff,0,0,30,30
1650281179780,MATH 20E,B02,083774,Staff,11,0,30,19
1650281185823,MATH 103A,A01,083777,Staff,0,10,30,30
1650281185823,MATH 103A,A02,083778,Staff,0,10,30,30
1650281185823,MATH 103A,B01,083779,Staff,0,10,30,30
1650281185823,MATH 103A,B02,083780,Staff,0,10,30,30
1650281191858,MATH 105,A01,085443,Staff,0,17,30,30
1650281197890,MATH 109,A01,083213,Anzaldo; Leesa B,0,5,30,30
1650281197890,MATH 109,A02,083214,Anzaldo; Leesa B,0,6,30,30
1650281197890,MATH 109,B01,083215,Anzaldo; Leesa B,0,4,30,30
1650281197890,MATH 109,B02,083216,Anzaldo; Leesa B,0,3,30,30
1650281203922,MATH 142A,A01,083219,Chow; Bennett,0,12,30,30
1650281203922,MATH 142A,A02,083220,Chow; Bennett,0,11,30,30
1650281203922,MATH 142A,B01,083221,Chow; Bennett,0,11,30,30
1650281203922,MATH 142A,B02,083222,Chow; Bennett,0,12,30,30
1650281209950,MATH 193A,A01,083224,Staff,0,5,30,30
1650281209950,MATH 193A,A02,083225,Staff,0,5,30,30
1650281209950,MATH 193A,A03,083781,Staff,0,2,30,30
1650281209950,MATH 193A,A04,083782,Staff,0,1,30,30
1650281215979,MATH 197,001,091859,McAuley; Julian John,9998,0,9999,1
1650281222073,COGS 9,A01,083615,Staff,0,14,60,60
1650281228107,COGS 11,A01,083617,Boyle; Mary E. T.,24,0,40,16
1650281234137,COGS 13,A01,083071,Staff,0,31,40,40
1650281240167,COGS 14A,A01,092681,Staff,0,15,100,100
1650281246198,COGS 14B,A01,083073,Cheng; Tzu-Han,0,9,50,50
1650281252232,COGS 17,A01,092677,Staff,29,0,75,46
1650281258263,COGS 100,A01,083619,Staff,0,23,60,60
1650281264298,COGS 101A,A01,083621,Davis; Joshua Daniel,0,21,60,60
1650281270332,COGS 101B,A01,091572,Staff,4,0,60,56
1650281276362,COGS 101C,A01,083625,Delgado; Tania,19,0,30,11
1650281282393,COGS 107A,A01,083627,Boyle; Mary E. T.,0,8,60,60
1650281288426,COGS 118A,A01,083075,Staff,13,0,60,47
1650281294463,CSE 3,A50,083646,Miranda; Gregory Joseph,21,0,38,17
1650281294463,CSE 3,A51,083647,Miranda; Gregory Joseph,37,0,37,0
1650281300494,CSE 8A,A50,083650,Miranda; Gregory Joseph,0,22,40,40
1650281306529,CSE 11,A01,083080,Cao; Yingjun,0,74,40,40
1650281312558,CSE 12,A01,083652,Staff,0,10,100,100
1650281318592,CSE 15L,A01,083654,Staff,0,1,50,50
1650281318592,CSE 15L,A02,083655,Staff,4,0,50,46
1650281324620,CSE 20,A01,083657,Staff,53,0,80,27
1650281330648,CSE 30,A01,083084,Eldon; John,0,74,40,40
1650281343727,CSE 100,A01,083659,Cao; Yingjun,0,65,50,50
1650281349763,CSE 134B,A01,083661,Powell; Thomas Allan,0,28,65,65
1650281364224,CSE 140,A01,083663,Staff,0,0,75,75
1650281370256,CSE 140L,A01,083088,Eldon; John,0,6,75,75
1650281376287,CSE 175,A01,083665,Kumar; Rakesh,8,0,25,17
1650281382317,CSE 190,A00,092507,Dubnov; Shlomo,14,0,20,6
1650281388349,ECE 45,A01,083139,Staff,0,15,40,40
1650281394382,ECE 65,A50,083695,Staff,0,4,30,30
1650281400412,ECE 109,A01,091882,Touri; Behrouz,43,0,70,27
1650281406441,ECE 180,A00,083140,Abi Samra; Nicholas Camill,24,0,30,6
1650281406441,ECE 180,B00,083141,Abi Samra; Nicholas Camill,7,0,30,23
1650281412476,MATH 10A,A01,083735,Patchell; Gregory David,11,0,30,19
1650281412476,MATH 10A,A02,083736,Patchell; Gregory David,28,0,30,2
1650281412476,MATH 10A,A03,083737,Patchell; Gregory David,26,0,30,4
1650281418513,MATH 10B,A01,083207,Staff,0,6,30,30
1650281418513,MATH 10B,A02,083208,Staff,0,6,30,30
1650281418513,MATH 10B,B01,083739,Staff,17,0,30,13
1650281418513,MATH 10B,B02,083740,Staff,29,0,30,1
1650281424549,MATH 18,A01,083743,Staff,7,0,30,23
1650281424549,MATH 18,A02,083744,Staff,27,0,30,3
1650281424549,MATH 18,A03,083745,Staff,23,0,30,7
1650281424549,MATH 18,A04,083746,Staff,27,0,30,3
1650281424549,MATH 18,B01,083748,Staff,0,11,30,30
1650281424549,MATH 18,B02,083749,Staff,0,9,30,30
1650281424549,MATH 18,B03,083750,Staff,1,8,30,29
1650281424549,MATH 18,B04,083751,Staff,0,9,30,30
1650281430582,MATH 20A,A01,083754,Staff,26,0,40,14
1650281436611,MATH 20B,A01,083756,Staff,0,5,30,30
1650281436611,MATH 20B,A02,083757,Staff,0,7,30,30
1650281442638,MATH 20C,A01,083760,Staff,0,13,30,30
1650281442638,MATH 20C,A02,083761,Staff,0,13,30,30
1650281442638,MATH 20C,B01,083762,Staff,14,0,30,16
1650281442638,MATH 20C,B02,083763,Staff,28,0,30,2
1650281448671,MATH 20D,A01,083765,Staff,0,1,30,30
1650281448671,MATH 20D,A02,083766,Staff,8,0,30,22
1650281448671,MATH 20D,A03,083767,Staff,28,0,30,2
1650281454708,MATH 20E,A01,083771,Staff,6,0,30,24
1650281454708,MATH 20E,A02,083772,Staff,20,0,30,10
1650281454708,MATH 20E,B01,083773,Staff,0,0,30,30
1650281454708,MATH 20E,B02,083774,Staff,11,0,30,19
1650281460738,MATH 103A,A01,083777,Staff,0,10,30,30
1650281460738,MATH 103A,A02,083778,Staff,0,10,30,30
1650281460738,MATH 103A,B01,083779,Staff,0,10,30,30
1650281460738,MATH 103A,B02,083780,Staff,0,10,30,30
1650281466768,MATH 105,A01,085443,Staff,0,17,30,30
1650281472796,MATH 109,A01,083213,Anzaldo; Leesa B,0,5,30,30
1650281472796,MATH 109,A02,083214,Anzaldo; Leesa B,0,6,30,30
1650281472796,MATH 109,B01,083215,Anzaldo; Leesa B,0,4,30,30
1650281472796,MATH 109,B02,083216,Anzaldo; Leesa B,0,3,30,30
1650281478834,MATH 142A,A01,083219,Chow; Bennett,0,12,30,30
1650281478834,MATH 142A,A02,083220,Chow; Bennett,0,11,30,30
1650281478834,MATH 142A,B01,083221,Chow; Bennett,0,11,30,30
1650281478834,MATH 142A,B02,083222,Chow; Bennett,0,12,30,30
1650281484863,MATH 193A,A01,083224,Staff,0,5,30,30
1650281484863,MATH 193A,A02,083225,Staff,0,5,30,30
1650281484863,MATH 193A,A03,083781,Staff,0,2,30,30
1650281484863,MATH 193A,A04,083782,Staff,0,1,30,30
1650281490894,MATH 197,001,091859,McAuley; Julian John,9998,0,9999,1
1650281496989,COGS 9,A01,083615,Staff,0,14,60,60
1650281503024,COGS 11,A01,083617,Boyle; Mary E. T.,24,0,40,16
1650281509055,COGS 13,A01,083071,Staff,0,31,40,40
1650281515086,COGS 14A,A01,092681,Staff,0,15,100,100
1650281521116,COGS 14B,A01,083073,Cheng; Tzu-Han,0,9,50,50
1650281527150,COGS 17,A01,092677,Staff,29,0,75,46
1650281533179,COGS 100,A01,083619,Staff,0,23,60,60
1650281539213,COGS 101A,A01,083621,Davis; Joshua Daniel,0,21,60,60
1650281545243,COGS 101B,A01,091572,Staff,4,0,60,56
1650281551370,COGS 101C,A01,083625,Delgado; Tania,19,0,30,11
1650281557402,COGS 107A,A01,083627,Boyle; Mary E. T.,0,8,60,60
1650281563429,COGS 118A,A01,083075,Staff,13,0,60,47
1650281569460,CSE 3,A50,083646,Miranda; Gregory Joseph,21,0,38,17
1650281569460,CSE 3,A51,083647,Miranda; Gregory Joseph,37,0,37,0
1650281575489,CSE 8A,A50,083650,Miranda; Gregory Joseph,0,22,40,40
1650281581525,CSE 11,A01,083080,Cao; Yingjun,0,74,40,40
1650281587557,CSE 12,A01,083652,Staff,0,10,100,100
1650281593595,CSE 15L,A01,083654,Staff,0,1,50,50
1650281593595,CSE 15L,A02,083655,Staff,4,0,50,46
1650281599630,CSE 20,A01,083657,Staff,53,0,80,27
1650281605686,CSE 30,A01,083084,Eldon; John,0,74,40,40
1650281611719,CSE 100,A01,083659,Cao; Yingjun,0,65,50,50
1650281617747,CSE 134B,A01,083661,Powell; Thomas Allan,0,28,65,65
1650281623779,CSE 140,A01,083663,Staff,0,0,75,75
1650281629812,CSE 140L,A01,083088,Eldon; John,0,6,75,75
1650281635841,CSE 175,A01,083665,Kumar; Rakesh,8,0,25,17
1650281641868,CSE 190,A00,092507,Dubnov; Shlomo,14,0,20,6
1650281647898,ECE 45,A01,083139,Staff,0,15,40,40
1650281653932,ECE 65,A50,083695,Staff,0,4,30,30
1650281659961,ECE 109,A01,091882,Touri; Behrouz,43,0,70,27
1650281665995,ECE 180,A00,083140,Abi Samra; Nicholas Camill,24,0,30,6
1650281665995,ECE 180,B00,083141,Abi Samra; Nicholas Camill,7,0,30,23
1650281672027,MATH 10A,A01,083735,Patchell; Gregory David,11,0,30,19
1650281672027,MATH 10A,A02,083736,Patchell; Gregory David,28,0,30,2
1650281672027,MATH 10A,A03,083737,Patchell; Gregory David,26,0,30,4
1650281678055,MATH 10B,A01,083207,Staff,0,6,30,30
1650281678055,MATH 10B,A02,083208,Staff,0,6,30,30
1650281678055,MATH 10B,B01,083739,Staff,17,0,30,13
1650281678055,MATH 10B,B02,083740,Staff,29,0,30,1
1650281684094,MATH 18,A01,083743,Staff,7,0,30,23
1650281684094,MATH 18,A02,083744,Staff,27,0,30,3
1650281684094,MATH 18,A03,083745,Staff,23,0,30,7
1650281684094,MATH 18,A04,083746,Staff,27,0,30,3
1650281684094,MATH 18,B01,083748,Staff,0,11,30,30
1650281684094,MATH 18,B02,083749,Staff,0,9,30,30
1650281684094,MATH 18,B03,083750,Staff,1,8,30,29
1650281684094,MATH 18,B04,083751,Staff,0,9,30,30
1650281690126,MATH 20A,A01,083754,Staff,26,0,40,14
1650281696160,MATH 20B,A01,083756,Staff,0,5,30,30
1650281696160,MATH 20B,A02,083757,Staff,0,7,30,30
1650281702191,MATH 20C,A01,083760,Staff,0,13,30,30
1650281702191,MATH 20C,A02,083761,Staff,0,13,30,30
1650281702191,MATH 20C,B01,083762,Staff,14,0,30,16
1650281702191,MATH 20C,B02,083763,Staff,28,0,30,2
1650281708220,MATH 20D,A01,083765,Staff,0,1,30,30
1650281708220,MATH 20D,A02,083766,Staff,8,0,30,22
1650281708220,MATH 20D,A03,083767,Staff,28,0,30,2
1650281714252,MATH 20E,A01,083771,Staff,6,0,30,24
1650281714252,MATH 20E,A02,083772,Staff,20,0,30,10
1650281714252,MATH 20E,B01,083773,Staff,0,0,30,30
1650281714252,MATH 20E,B02,083774,Staff,11,0,30,19
1650281720284,MATH 103A,A01,083777,Staff,0,10,30,30
1650281720284,MATH 103A,A02,083778,Staff,0,10,30,30
1650281720284,MATH 103A,B01,083779,Staff,0,10,30,30
1650281720284,MATH 103A,B02,083780,Staff,0,10,30,30
1650281726349,MATH 105,A01,085443,Staff,0,17,30,30
1650281732380,MATH 109,A01,083213,Anzaldo; Leesa B,0,5,30,30
1650281732380,MATH 109,A02,083214,Anzaldo; Leesa B,0,6,30,30
1650281732380,MATH 109,B01,083215,Anzaldo; Leesa B,0,4,30,30
1650281732380,MATH 109,B02,083216,Anzaldo; Leesa B,0,3,30,30
1650281738411,MATH 142A,A01,083219,Chow; Bennett,0,12,30,30
1650281738411,MATH 142A,A02,083220,Chow; Bennett,0,11,30,30
1650281738411,MATH 142A,B01,083221,Chow; Bennett,0,11,30,30
1650281738411,MATH 142A,B02,083222,Chow; Bennett,0,12,30,30
1650281744441,MATH 193A,A01,083224,Staff,0,5,30,30
1650281744441,MATH 193A,A02,083225,Staff,0,5,30,30
1650281744441,MATH 193A,A03,083781,Staff,0,2,30,30
1650281744441,MATH 193A,A04,083782,Staff,0,1,30,30
1650281750473,MATH 197,001,091859,McAuley; Julian John,9998,0,9999,1
1650281756549,COGS 9,A01,083615,Staff,0,14,60,60
1650281762584,COGS 11,A01,083617,Boyle; Mary E. T.,24,0,40,16
1650281768612,COGS 13,A01,083071,Staff,0,31,40,40
1650281774643,COGS 14A,A01,092681,Staff,0,15,100,100
1650281780672,COGS 14B,A01,083073,Cheng; Tzu-Han,0,9,50,50
1650281786706,COGS 17,A01,092677,Staff,29,0,75,46
1650281792766,COGS 100,A01,083619,Staff,0,23,60,60
1650281798804,COGS 101A,A01,083621,Davis; Joshua Daniel,0,21,60,60
1650281804838,COGS 101B,A01,091572,Staff,4,0,60,56
1650281810869,COGS 101C,A01,083625,Delgado; Tania,19,0,30,11
1650281816897,COGS 107A,A01,083627,Boyle; Mary E. T.,0,8,60,60
1650281822937,COGS 118A,A01,083075,Staff,13,0,60,47
1650281828972,CSE 3,A50,083646,Miranda; Gregory Joseph,21,0,38,17
1650281828972,CSE 3,A51,083647,Miranda; Gregory Joseph,37,0,37,0
1650281835001,CSE 8A,A50,083650,Miranda; Gregory Joseph,0,22,40,40
1650281841030,CSE 11,A01,083080,Cao; Yingjun,0,74,40,40
1650281847057,CSE 12,A01,083652,Staff,0,10,100,100
1650281853085,CSE 15L,A01,083654,Staff,0,1,50,50
1650281853085,CSE 15L,A02,083655,Staff,4,0,50,46
1650281859114,CSE 20,A01,083657,Staff,53,0,80,27
1650281865142,CSE 30,A01,083084,Eldon; John,0,74,40,40
1650281871177,CSE 100,A01,083659,Cao; Yingjun,0,65,50,50
1650281877204,CSE 134B,A01,083661,Powell; Thomas Allan,0,28,65,65
1650281883230,CSE 140,A01,083663,Staff,0,0,75,75
1650281889267,CSE 140L,A01,083088,Eldon; John,0,6,75,75
1650281895293,CSE 175,A01,083665,Kumar; Rakesh,8,0,25,17
1650281901323,CSE 190,A00,092507,Dubnov; Shlomo,14,0,20,6
1650281907349,ECE 45,A01,083139,Staff,0,15,40,40
1650281913378,ECE 65,A50,083695,Staff,0,4,30,30
1650281919405,ECE 109,A01,091882,Touri; Behrouz,43,0,70,27
1650281925438,ECE 180,A00,083140,Abi Samra; Nicholas Camill,24,0,30,6
1650281925438,ECE 180,B00,083141,Abi Samra; Nicholas Camill,7,0,30,23
1650281931472,MATH 10A,A01,083735,Patchell; Gregory David,11,0,30,19
1650281931472,MATH 10A,A02,083736,Patchell; Gregory David,28,0,30,2
1650281931472,MATH 10A,A03,083737,Patchell; Gregory David,26,0,30,4
1650281937505,MATH 10B,A01,083207,Staff,0,6,30,30
1650281937505,MATH 10B,A02,083208,Staff,0,6,30,30
1650281937505,MATH 10B,B01,083739,Staff,17,0,30,13
1650281937505,MATH 10B,B02,083740,Staff,29,0,30,1
1650281943544,MATH 18,A01,083743,Staff,7,0,30,23
1650281943544,MATH 18,A02,083744,Staff,27,0,30,3
1650281943544,MATH 18,A03,083745,Staff,23,0,30,7
1650281943544,MATH 18,A04,083746,Staff,27,0,30,3
1650281943544,MATH 18,B01,083748,Staff,0,11,30,30
1650281943544,MATH 18,B02,083749,Staff,0,9,30,30
1650281943544,MATH 18,B03,083750,Staff,1,8,30,29
1650281943544,MATH 18,B04,083751,Staff,0,9,30,30
1650281949573,MATH 20A,A01,083754,Staff,26,0,40,14
1650281955602,MATH 20B,A01,083756,Staff,0,5,30,30
1650281955602,MATH 20B,A02,083757,Staff,0,7,30,30
1650281961639,MATH 20C,A01,083760,Staff,0,13,30,30
1650281961639,MATH 20C,A02,083761,Staff,0,13,30,30
1650281961639,MATH 20C,B01,083762,Staff,14,0,30,16
1650281961639,MATH 20C,B02,083763,Staff,28,0,30,2
1650281967667,MATH 20D,A01,083765,Staff,0,1,30,30
1650281967667,MATH 20D,A02,083766,Staff,8,0,30,22
1650281967667,MATH 20D,A03,083767,Staff,28,0,30,2
1650281973702,MATH 20E,A01,083771,Staff,6,0,30,24
1650281973702,MATH 20E,A02,083772,Staff,20,0,30,10
1650281973702,MATH 20E,B01,083773,Staff,0,0,30,30
1650281973702,MATH 20E,B02,083774,Staff,11,0,30,19
1650281979735,MATH 103A,A01,083777,Staff,0,10,30,30
1650281979735,MATH 103A,A02,083778,Staff,0,10,30,30
1650281979735,MATH 103A,B01,083779,Staff,0,10,30,30
1650281979735,MATH 103A,B02,083780,Staff,0,10,30,30
1650281985767,MATH 105,A01,085443,Staff,0,17,30,30
1650281991795,MATH 109,A01,083213,Anzaldo; Leesa B,0,5,30,30
1650281991795,MATH 109,A02,083214,Anzaldo; Leesa B,0,6,30,30
1650281991795,MATH 109,B01,083215,Anzaldo; Leesa B,0,4,30,30
1650281991795,MATH 109,B02,083216,Anzaldo; Leesa B,0,3,30,30
1650281997859,MATH 142A,A01,083219,Chow; Bennett,0,12,30,30
1650281997859,MATH 142A,A02,083220,Chow; Bennett,0,11,30,30
1650281997859,MATH 142A,B01,083221,Chow; Bennett,0,11,30,30
1650281997859,MATH 142A,B02,083222,Chow; Bennett,0,12,30,30
1650282003895,MATH 193A,A01,083224,Staff,0,5,30,30
1650282003895,MATH 193A,A02,083225,Staff,0,5,30,30
1650282003895,MATH 193A,A03,083781,Staff,0,2,30,30
1650282003895,MATH 193A,A04,083782,Staff,0,1,30,30
1650282009925,MATH 197,001,091859,McAuley; Julian John,9998,0,9999,1
1650282016001,COGS 9,A01,083615,Staff,0,14,60,60
1650282022035,COGS 11,A01,083617,Boyle; Mary E. T.,24,0,40,16
1650282028066,COGS 13,A01,083071,Staff,0,31,40,40
1650282034095,COGS 14A,A01,092681,Staff,0,15,100,100
1650282040127,COGS 14B,A01,083073,Cheng; Tzu-Han,0,9,50,50
1650282046157,COGS 17,A01,092677,Staff,29,0,75,46
1650282052186,COGS 100,A01,083619,Staff,0,23,60,60
1650282058222,COGS 101A,A01,083621,Davis; Joshua Daniel,0,21,60,60
1650282064249,COGS 101B,A01,091572,Staff,4,0,60,56
1650282070280,COGS 101C,A01,083625,Delgado; Tania,19,0,30,11
1650282076308,COGS 107A,A01,083627,Boyle; Mary E. T.,0,8,60,60
1650282082335,COGS 118A,A01,083075,Staff,13,0,60,47
1650282088370,CSE 3,A50,083646,Miranda; Gregory Joseph,21,0,38,17
1650282088370,CSE 3,A51,083647,Miranda; Gregory Joseph,37,0,37,0
1650282094398,CSE 8A,A50,083650,Miranda; Gregory Joseph,0,22,40,40
1650282100431,CSE 11,A01,083080,Cao; Yingjun,0,74,40,40
1650282106464,CSE 12,A01,083652,Staff,0,10,100,100
1650282112494,CSE 15L,A01,083654,Staff,0,1,50,50
1650282112494,CSE 15L,A02,083655,Staff,4,0,50,46
1650282118528,CSE 20,A01,083657,Staff,53,0,80,27
1650282124562,CSE 30,A01,083084,Eldon; John,0,74,40,40
1650282130594,CSE 100,A01,083659,Cao; Yingjun,0,65,50,50
1650282136628,CSE 134B,A01,083661,Powell; Thomas Allan,0,28,65,65
1650282142658,CSE 140,A01,083663,Staff,0,0,75,75
1650282148774,CSE 140L,A01,083088,Eldon; John,0,6,75,75
1650282154803,CSE 175,A01,083665,Kumar; Rakesh,8,0,25,17
1650282160836,CSE 190,A00,092507,Dubnov; Shlomo,14,0,20,6
1650282166862,ECE 45,A01,083139,Staff,0,15,40,40
1650282172897,ECE 65,A50,083695,Staff,0,4,30,30
1650282178930,ECE 109,A01,091882,Touri; Behrouz,43,0,70,27
1650282184959,ECE 180,A00,083140,Abi Samra; Nicholas Camill,24,0,30,6
1650282184959,ECE 180,B00,083141,Abi Samra; Nicholas Camill,7,0,30,23
1650282191002,MATH 10A,A01,083735,Patchell; Gregory David,11,0,30,19
1650282191002,MATH 10A,A02,083736,Patchell; Gregory David,28,0,30,2
1650282191002,MATH 10A,A03,083737,Patchell; Gregory David,26,0,30,4
1650282197031,MATH 10B,A01,083207,Staff,0,6,30,30
1650282197031,MATH 10B,A02,083208,Staff,0,6,30,30
1650282197031,MATH 10B,B01,083739,Staff,17,0,30,13
1650282197031,MATH 10B,B02,083740,Staff,29,0,30,1
1650282203066,MATH 18,A01,083743,Staff,7,0,30,23
1650282203066,MATH 18,A02,083744,Staff,27,0,30,3
1650282203066,MATH 18,A03,083745,Staff,23,0,30,7
1650282203066,MATH 18,A04,083746,Staff,27,0,30,3
1650282203066,MATH 18,B01,083748,Staff,0,11,30,30
1650282203066,MATH 18,B02,083749,Staff,0,9,30,30
1650282203066,MATH 18,B03,083750,Staff,1,8,30,29
1650282203066,MATH 18,B04,083751,Staff,0,9,30,30
1650282209096,MATH 20A,A01,083754,Staff,26,0,40,14
1650282215123,MATH 20B,A01,083756,Staff,0,5,30,30
1650282215123,MATH 20B,A02,083757,Staff,0,7,30,30
1650282221152,MATH 20C,A01,083760,Staff,0,13,30,30
1650282221152,MATH 20C,A02,083761,Staff,0,13,30,30
1650282221152,MATH 20C,B01,083762,Staff,14,0,30,16
1650282221152,MATH 20C,B02,083763,Staff,28,0,30,2
1650282227179,MATH 20D,A01,083765,Staff,0,1,30,30
1650282227179,MATH 20D,A02,083766,Staff,8,0,30,22
1650282227179,MATH 20D,A03,083767,Staff,28,0,30,2
1650282233212,MATH 20E,A01,083771,Staff,6,0,30,24
1650282233212,MATH 20E,A02,083772,Staff,20,0,30,10
1650282233212,MATH 20E,B01,083773,Staff,0,0,30,30
1650282233212,MATH 20E,B02,083774,Staff,11,0,30,19
1650282239244,MATH 103A,A01,083777,Staff,0,10,30,30
1650282239244,MATH 103A,A02,083778,Staff,0,10,30,30
1650282239244,MATH 103A,B01,083779,Staff,0,10,30,30
1650282239244,MATH 103A,B02,083780,Staff,0,10,30,30
1650282245279,MATH 105,A01,085443,Staff,0,17,30,30
1650282251314,MATH 109,A01,083213,Anzaldo; Leesa B,0,5,30,30
1650282251314,MATH 109,A02,083214,Anzaldo; Leesa B,0,6,30,30
1650282251314,MATH 109,B01,083215,Anzaldo; Leesa B,0,4,30,30
1650282251314,MATH 109,B02,083216,Anzaldo; Leesa B,0,3,30,30
1650282257349,MATH 142A,A01,083219,Chow; Bennett,0,12,30,30
1650282257349,MATH 142A,A02,083220,Chow; Bennett,0,11,30,30
1650282257349,MATH 142A,B01,083221,Chow; Bennett,0,11,30,30
1650282257349,MATH 142A,B02,083222,Chow; Bennett,0,12,30,30
1650282263377,MATH 193A,A01,083224,Staff,0,5,30,30
1650282263377,MATH 193A,A02,083225,Staff,0,5,30,30
1650282263377,MATH 193A,A03,083781,Staff,0,2,30,30
1650282263377,MATH 193A,A04,083782,Staff,0,1,30,30
1650282269404,MATH 197,001,091859,McAuley; Julian John,9998,0,9999,1
1650282275468,COGS 9,A01,083615,Staff,0,14,60,60
1650282281500,COGS 11,A01,083617,Boyle; Mary E. T.,24,0,40,16
1650282287531,COGS 13,A01,083071,Staff,0,31,40,40
1650282293563,COGS 14A,A01,092681,Staff,0,15,100,100
1650282299592,COGS 14B,A01,083073,Cheng; Tzu-Han,0,9,50,50
1650282305620,COGS 17,A01,092677,Staff,29,0,75,46
1650282311653,COGS 100,A01,083619,Staff,0,23,60,60
1650282317680,COGS 101A,A01,083621,Davis; Joshua Daniel,0,21,60,60
1650282323712,COGS 101B,A01,091572,Staff,4,0,60,56
1650282329741,COGS 101C,A01,083625,Delgado; Tania,19,0,30,11
1650282335770,COGS 107A,A01,083627,Boyle; Mary E. T.,0,8,60,60
1650282341800,COGS 118A,A01,083075,Staff,13,0,60,47
1650282347829,CSE 3,A50,083646,Miranda; Gregory Joseph,21,0,38,17
1650282347829,CSE 3,A51,083647,Miranda; Gregory Joseph,37,0,37,0
1650282353855,CSE 8A,A50,083650,Miranda; Gregory Joseph,0,22,40,40
1650282359883,CSE 11,A01,083080,Cao; Yingjun,0,74,40,40
1650282365914,CSE 12,A01,083652,Staff,0,10,100,100
1650282371943,CSE 15L,A01,083654,Staff,0,1,50,50
1650282371943,CSE 15L,A02,083655,Staff,4,0,50,46
1650282377971,CSE 20,A01,083657,Staff,53,0,80,27
1650282384004,CSE 30,A01,083084,Eldon; John,0,74,40,40
1650282390040,CSE 100,A01,083659,Cao; Yingjun,0,65,50,50
1650282396072,CSE 134B,A01,083661,Powell; Thomas Allan,0,28,65,65
1650282402103,CSE 140,A01,083663,Staff,0,0,75,75
1650282408133,CSE 140L,A01,083088,Eldon; John,0,6,75,75
1650282414163,CSE 175,A01,083665,Kumar; Rakesh,8,0,25,17
1650282420194,CSE 190,A00,092507,Dubnov; Shlomo,14,0,20,6
1650282426225,ECE 45,A01,083139,Staff,0,15,40,40
1650282432259,ECE 65,A50,083695,Staff,0,4,30,30
1650282438287,ECE 109,A01,091882,Touri; Behrouz,43,0,70,27
1650282444318,ECE 180,A00,083140,Abi Samra; Nicholas Camill,24,0,30,6
1650282444318,ECE 180,B00,083141,Abi Samra; Nicholas Camill,7,0,30,23
1650282450355,MATH 10A,A01,083735,Patchell; Gregory David,11,0,30,19
1650282450355,MATH 10A,A02,083736,Patchell; Gregory David,28,0,30,2
1650282450355,MATH 10A,A03,083737,Patchell; Gregory David,26,0,30,4
1650282456389,MATH 10B,A01,083207,Staff,0,6,30,30
1650282456389,MATH 10B,A02,083208,Staff,0,6,30,30
1650282456389,MATH 10B,B01,083739,Staff,17,0,30,13
1650282456389,MATH 10B,B02,083740,Staff,29,0,30,1
1650282462426,MATH 18,A01,083743,Staff,7,0,30,23
1650282462426,MATH 18,A02,083744,Staff,27,0,30,3
1650282462426,MATH 18,A03,083745,Staff,23,0,30,7
1650282462426,MATH 18,A04,083746,Staff,27,0,30,3
1650282462426,MATH 18,B01,083748,Staff,0,11,30,30
1650282462426,MATH 18,B02,083749,Staff,0,9,30,30
1650282462426,MATH 18,B03,083750,Staff,1,8,30,29
1650282462426,MATH 18,B04,083751,Staff,0,9,30,30
1650282468456,MATH 20A,A01,083754,Staff,26,0,40,14
1650282474485,MATH 20B,A01,083756,Staff,0,5,30,30
1650282474485,MATH 20B,A02,083757,Staff,0,7,30,30
1650282480513,MATH 20C,A01,083760,Staff,0,13,30,30
1650282480513,MATH 20C,A02,083761,Staff,0,13,30,30
1650282480513,MATH 20C,B01,083762,Staff,14,0,30,16
1650282480513,MATH 20C,B02,083763,Staff,28,0,30,2
1650282486540,MATH 20D,A01,083765,Staff,0,1,30,30
1650282486540,MATH 20D,A02,083766,Staff,8,0,30,22
1650282486540,MATH 20D,A03,083767,Staff,28,0,30,2
1650282492575,MATH 20E,A01,083771,Staff,6,0,30,24
1650282492575,MATH 20E,A02,083772,Staff,20,0,30,10
1650282492575,MATH 20E,B01,083773,Staff,0,0,30,30
1650282492575,MATH 20E,B02,083774,Staff,11,0,30,19
1650282498606,MATH 103A,A01,083777,Staff,0,10,30,30
1650282498606,MATH 103A,A02,083778,Staff,0,10,30,30
1650282498606,MATH 103A,B01,083779,Staff,0,10,30,30
1650282498606,MATH 103A,B02,083780,Staff,0,10,30,30
1650282504631,MATH 105,A01,085443,Staff,0,17,30,30
1650282510658,MATH 109,A01,083213,Anzaldo; Leesa B,0,5,30,30
1650282510658,MATH 109,A02,083214,Anzaldo; Leesa B,0,6,30,30
1650282510658,MATH 109,B01,083215,Anzaldo; Leesa B,0,4,30,30
1650282510658,MATH 109,B02,083216,Anzaldo; Leesa B,0,3,30,30
1650282516691,MATH 142A,A01,083219,Chow; Bennett,0,12,30,30
1650282516691,MATH 142A,A02,083220,Chow; Bennett,0,11,30,30
1650282516691,MATH 142A,B01,083221,Chow; Bennett,0,11,30,30
1650282516691,MATH 142A,B02,083222,Chow; Bennett,0,12,30,30
1650282522716,MATH 193A,A01,083224,Staff,0,5,30,30
1650282522716,MATH 193A,A02,083225,Staff,0,5,30,30
1650282522716,MATH 193A,A03,083781,Staff,0,2,30,30
1650282522716,MATH 193A,A04,083782,Staff,0,1,30,30
1650282528743,MATH 197,001,091859,McAuley; Julian John,9998,0,9999,1
1650282534805,COGS 9,A01,083615,Staff,0,14,60,60
1650282540833,COGS 11,A01,083617,Boyle; Mary E. T.,24,0,40,16
1650282546860,COGS 13,A01,083071,Staff,0,31,40,40
1650282552891,COGS 14A,A01,092681,Staff,0,15,100,100
1650282558925,COGS 14B,A01,083073,Cheng; Tzu-Han,0,9,50,50
1650282564958,COGS 17,A01,092677,Staff,29,0,75,46
1650282570984,COGS 100,A01,083619,Staff,0,23,60,60
1650282577021,COGS 101A,A01,083621,Davis; Joshua Daniel,0,21,60,60
1650282583053,COGS 101B,A01,091572,Staff,4,0,60,56
1650282589085,COGS 101C,A01,083625,Delgado; Tania,19,0,30,11
1650282595120,COGS 107A,A01,083627,Boyle; Mary E. T.,0,8,60,60
1650282601148,COGS 118A,A01,083075,Staff,13,0,60,47
1650282607177,CSE 3,A50,083646,Miranda; Gregory Joseph,21,0,38,17
1650282607177,CSE 3,A51,083647,Miranda; Gregory Joseph,37,0,37,0
1650282613207,CSE 8A,A50,083650,Miranda; Gregory Joseph,0,22,40,40
1650282619237,CSE 11,A01,083080,Cao; Yingjun,0,74,40,40
1650282625264,CSE 12,A01,083652,Staff,0,10,100,100
1650282631291,CSE 15L,A01,083654,Staff,0,1,50,50
1650282631291,CSE 15L,A02,083655,Staff,4,0,50,46
1650282637319,CSE 20,A01,083657,Staff,53,0,80,27
1650282643354,CSE 30,A01,083084,Eldon; John,0,74,40,40
1650282649390,CSE 100,A01,083659,Cao; Yingjun,0,65,50,50
1650282655423,CSE 134B,A01,083661,Powell; Thomas Allan,0,28,65,65
1650282661449,CSE 140,A01,083663,Staff,0,0,75,75
1650282667478,CSE 140L,A01,083088,Eldon; John,0,6,75,75
1650282673507,CSE 175,A01,083665,Kumar; Rakesh,8,0,25,17
1650282679536,CSE 190,A00,092507,Dubnov; Shlomo,14,0,20,6
1650282685567,ECE 45,A01,083139,Staff,0,15,40,40
1650282691598,ECE 65,A50,083695,Staff,0,4,30,30
1650282697627,ECE 109,A01,091882,Touri; Behrouz,43,0,70,27
1650282703659,ECE 180,A00,083140,Abi Samra; Nicholas Camill,24,0,30,6
1650282703659,ECE 180,B00,083141,Abi Samra; Nicholas Camill,7,0,30,23
1650282709688,MATH 10A,A01,083735,Patchell; Gregory David,11,0,30,19
1650282709688,MATH 10A,A02,083736,Patchell; Gregory David,28,0,30,2
1650282709688,MATH 10A,A03,083737,Patchell; Gregory David,26,0,30,4
1650282715716,MATH 10B,A01,083207,Staff,0,6,30,30
1650282715716,MATH 10B,A02,083208,Staff,0,6,30,30
1650282715716,MATH 10B,B01,083739,Staff,17,0,30,13
1650282715716,MATH 10B,B02,083740,Staff,29,0,30,1
1650282721745,MATH 18,A01,083743,Staff,7,0,30,23
1650282721745,MATH 18,A02,083744,Staff,27,0,30,3
1650282721745,MATH 18,A03,083745,Staff,23,0,30,7
1650282721745,MATH 18,A04,083746,Staff,27,0,30,3
1650282721745,MATH 18,B01,083748,Staff,0,11,30,30
1650282721745,MATH 18,B02,083749,Staff,0,9,30,30
1650282721745,MATH 18,B03,083750,Staff,1,8,30,29
1650282721745,MATH 18,B04,083751,Staff,0,9,30,30
1650282727772,MATH 20A,A01,083754,Staff,26,0,40,14
1650282733805,MATH 20B,A01,083756,Staff,0,5,30,30
1650282733805,MATH 20B,A02,083757,Staff,0,7,30,30
1650282739833,MATH 20C,A01,083760,Staff,0,13,30,30
1650282739833,MATH 20C,A02,083761,Staff,0,13,30,30
1650282739833,MATH 20C,B01,083762,Staff,14,0,30,16
1650282739833,MATH 20C,B02,083763,Staff,28,0,30,2
1650282745945,MATH 20D,A01,083765,Staff,0,1,30,30
1650282745945,MATH 20D,A02,083766,Staff,8,0,30,22
1650282745945,MATH 20D,A03,083767,Staff,28,0,30,2
1650282751987,MATH 20E,A01,083771,Staff,6,0,30,24
1650282751987,MATH 20E,A02,083772,Staff,20,0,30,10
1650282751987,MATH 20E,B01,083773,Staff,0,0,30,30
1650282751987,MATH 20E,B02,083774,Staff,11,0,30,19
1650282758016,MATH 103A,A01,083777,Staff,0,10,30,30
1650282758016,MATH 103A,A02,083778,Staff,0,10,30,30
1650282758016,MATH 103A,B01,083779,Staff,0,10,30,30
1650282758016,MATH 103A,B02,083780,Staff,0,10,30,30
1650282764042,MATH 105,A01,085443,Staff,0,17,30,30
1650282770074,MATH 109,A01,083213,Anzaldo; Leesa B,0,5,30,30
1650282770074,MATH 109,A02,083214,Anzaldo; Leesa B,0,6,30,30
1650282770074,MATH 109,B01,083215,Anzaldo; Leesa B,0,4,30,30
1650282770074,MATH 109,B02,083216,Anzaldo; Leesa B,0,3,30,30
1650282776101,MATH 142A,A01,083219,Chow; Bennett,0,12,30,30
1650282776101,MATH 142A,A02,083220,Chow; Bennett,0,11,30,30
1650282776101,MATH 142A,B01,083221,Chow; Bennett,0,11,30,30
1650282776101,MATH 142A,B02,083222,Chow; Bennett,0,12,30,30
1650282782134,MATH 193A,A01,083224,Staff,0,5,30,30
1650282782134,MATH 193A,A02,083225,Staff,0,5,30,30
1650282782134,MATH 193A,A03,083781,Staff,0,2,30,30
1650282782134,MATH 193A,A04,083782,Staff,0,1,30,30
1650282788160,MATH 197,001,091859,McAuley; Julian John,9998,0,9999,1
1650282794240,COGS 9,A01,083615,Staff,0,14,60,60
1650282800267,COGS 11,A01,083617,Boyle; Mary E. T.,24,0,40,16
1650282806296,COGS 13,A01,083071,Staff,0,31,40,40
1650282812321,COGS 14A,A01,092681,Staff,0,15,100,100
1650282818349,COGS 14B,A01,083073,Cheng; Tzu-Han,0,9,50,50
1650282824379,COGS 17,A01,092677,Staff,29,0,75,46
1650282830409,COGS 100,A01,083619,Staff,0,23,60,60
1650282836441,COGS 101A,A01,083621,Davis; Joshua Daniel,0,21,60,60
1650282842472,COGS 101B,A01,091572,Staff,4,0,60,56
1650282848500,COGS 101C,A01,083625,Delgado; Tania,19,0,30,11
1650282854531,COGS 107A,A01,083627,Boyle; Mary E. T.,0,8,60,60
1650282860566,COGS 118A,A01,083075,Staff,13,0,60,47
1650282866601,CSE 3,A50,083646,Miranda; Gregory Joseph,21,0,38,17
1650282866601,CSE 3,A51,083647,Miranda; Gregory Joseph,37,0,37,0
1650282872628,CSE 8A,A50,083650,Miranda; Gregory Joseph,0,22,40,40
1650282878658,CSE 11,A01,083080,Cao; Yingjun,0,74,40,40
1650282884690,CSE 12,A01,083652,Staff,0,10,100,100
1650282890720,CSE 15L,A01,083654,Staff,0,1,50,50
1650282890720,CSE 15L,A02,083655,Staff,4,0,50,46
1650282896748,CSE 20,A01,083657,Staff,53,0,80,27
1650282902778,CSE 30,A01,083084,Eldon; John,0,74,40,40
1650282908807,CSE 100,A01,083659,Cao; Yingjun,0,65,50,50
1650282914837,CSE 134B,A01,083661,Powell; Thomas Allan,0,28,65,65
1650282920868,CSE 140,A01,083663,Staff,0,0,75,75
1650282926895,CSE 140L,A01,083088,Eldon; John,0,6,75,75
1650282932923,CSE 175,A01,083665,Kumar; Rakesh,8,0,25,17
1650282938956,CSE 190,A00,092507,Dubnov; Shlomo,14,0,20,6
1650282944990,ECE 45,A01,083139,Staff,0,15,40,40
1650282951023,ECE 65,A50,083695,Staff,0,4,30,30
1650282957056,ECE 109,A01,091882,Touri; Behrouz,43,0,70,27
1650282963091,ECE 180,A00,083140,Abi Samra; Nicholas Camill,24,0,30,6
1650282963091,ECE 180,B00,083141,Abi Samra; Nicholas Camill,7,0,30,23
1650282969127,MATH 10A,A01,083735,Patchell; Gregory David,11,0,30,19
1650282969127,MATH 10A,A02,083736,Patchell; Gregory David,28,0,30,2
1650282969127,MATH 10A,A03,083737,Patchell; Gregory David,26,0,30,4
1650282975155,MATH 10B,A01,083207,Staff,0,6,30,30
1650282975155,MATH 10B,A02,083208,Staff,0,6,30,30
1650282975155,MATH 10B,B01,083739,Staff,17,0,30,13
1650282975155,MATH 10B,B02,083740,Staff,29,0,30,1
1650282981192,MATH 18,A01,083743,Staff,7,0,30,23
1650282981192,MATH 18,A02,083744,Staff,27,0,30,3
1650282981192,MATH 18,A03,083745,Staff,23,0,30,7
1650282981192,MATH 18,A04,083746,Staff,27,0,30,3
1650282981192,MATH 18,B01,083748,Staff,0,11,30,30
1650282981192,MATH 18,B02,083749,Staff,0,9,30,30
1650282981192,MATH 18,B03,083750,Staff,1,8,30,29
1650282981192,MATH 18,B04,083751,Staff,0,9,30,30
1650282987222,MATH 20A,A01,083754,Staff,26,0,40,14
1650282993252,MATH 20B,A01,083756,Staff,0,5,30,30
1650282993252,MATH 20B,A02,083757,Staff,0,7,30,30
1650282999280,MATH 20C,A01,083760,Staff,0,13,30,30
1650282999280,MATH 20C,A02,083761,Staff,0,13,30,30
1650282999280,MATH 20C,B01,083762,Staff,14,0,30,16
1650282999280,MATH 20C,B02,083763,Staff,28,0,30,2
1650283005312,MATH 20D,A01,083765,Staff,0,1,30,30
1650283005312,MATH 20D,A02,083766,Staff,8,0,30,22
1650283005312,MATH 20D,A03,083767,Staff,28,0,30,2
1650283011340,MATH 20E,A01,083771,Staff,6,0,30,24
1650283011340,MATH 20E,A02,083772,Staff,20,0,30,10
1650283011340,MATH 20E,B01,083773,Staff,0,0,30,30
1650283011340,MATH 20E,B02,083774,Staff,11,0,30,19
1650283017374,MATH 103A,A01,083777,Staff,0,10,30,30
1650283017374,MATH 103A,A02,083778,Staff,0,10,30,30
1650283017374,MATH 103A,B01,083779,Staff,0,10,30,30
1650283017374,MATH 103A,B02,083780,Staff,0,10,30,30
1650283023407,MATH 105,A01,085443,Staff,0,17,30,30
1650283029447,MATH 109,A01,083213,Anzaldo; Leesa B,0,5,30,30
1650283029447,MATH 109,A02,083214,Anzaldo; Leesa B,0,6,30,30
1650283029447,MATH 109,B01,083215,Anzaldo; Leesa B,0,4,30,30
1650283029447,MATH 109,B02,083216,Anzaldo; Leesa B,0,3,30,30
1650283035477,MATH 142A,A01,083219,Chow; Bennett,0,12,30,30
1650283035477,MATH 142A,A02,083220,Chow; Bennett,0,11,30,30
1650283035477,MATH 142A,B01,083221,Chow; Bennett,0,11,30,30
1650283035477,MATH 142A,B02,083222,Chow; Bennett,0,12,30,30
1650283041504,MATH 193A,A01,083224,Staff,0,5,30,30
1650283041504,MATH 193A,A02,083225,Staff,0,5,30,30
1650283041504,MATH 193A,A03,083781,Staff,0,2,30,30
1650283041504,MATH 193A,A04,083782,Staff,0,1,30,30
1650283047538,MATH 197,001,091859,McAuley; Julian John,9998,0,9999,1
1650283053625,COGS 9,A01,083615,Staff,0,14,60,60
1650283059654,COGS 11,A01,083617,Boyle; Mary E. T.,24,0,40,16
1650283065686,COGS 13,A01,083071,Staff,0,31,40,40
1650283071713,COGS 14A,A01,092681,Staff,0,15,100,100
1650283077744,COGS 14B,A01,083073,Cheng; Tzu-Han,0,9,50,50
1650283083771,COGS 17,A01,092677,Staff,29,0,75,46
1650283089796,COGS 100,A01,083619,Staff,0,23,60,60
1650283095827,COGS 101A,A01,083621,Davis; Joshua Daniel,0,21,60,60
1650283101854,COGS 101B,A01,091572,Staff,4,0,60,56
1650283107884,COGS 101C,A01,083625,Delgado; Tania,19,0,30,11
1650283113916,COGS 107A,A01,083627,Boyle; Mary E. T.,0,8,60,60
1650283119944,COGS 118A,A01,083075,Staff,13,0,60,47
1650283125974,CSE 3,A50,083646,Miranda; Gregory Joseph,21,0,38,17
1650283125974,CSE 3,A51,083647,Miranda; Gregory Joseph,37,0,37,0
1650283132002,CSE 8A,A50,083650,Miranda; Gregory Joseph,0,22,40,40
1650283138031,CSE 11,A01,083080,Cao; Yingjun,0,74,40,40
1650283144058,CSE 12,A01,083652,Staff,0,10,100,100
1650283150084,CSE 15L,A01,083654,Staff,0,1,50,50
1650283150084,CSE 15L,A02,083655,Staff,4,0,50,46
1650283156114,CSE 20,A01,083657,Staff,53,0,80,27
1650283162144,CSE 30,A01,083084,Eldon; John,0,74,40,40
1650283168173,CSE 100,A01,083659,Cao; Yingjun,0,65,50,50
1650283174201,CSE 134B,A01,083661,Powell; Thomas Allan,0,28,65,65
1650283180230,CSE 140,A01,083663,Staff,0,0,75,75
1650283186259,CSE 140L,A01,083088,Eldon; John,0,6,75,75
1650283192284,CSE 175,A01,083665,Kumar; Rakesh,8,0,25,17
1650283198319,CSE 190,A00,092507,Dubnov; Shlomo,14,0,20,6
1650283204345,ECE 45,A01,083139,Staff,0,15,40,40
1650283210390,ECE 65,A50,083695,Staff,0,4,30,30
1650283216419,ECE 109,A01,091882,Touri; Behrouz,43,0,70,27
1650283222450,ECE 180,A00,083140,Abi Samra; Nicholas Camill,24,0,30,6
1650283222450,ECE 180,B00,083141,Abi Samra; Nicholas Camill,7,0,30,23
1650283228478,MATH 10A,A01,083735,Patchell; Gregory David,11,0,30,19
1650283228478,MATH 10A,A02,083736,Patchell; Gregory David,28,0,30,2
1650283228478,MATH 10A,A03,083737,Patchell; Gregory David,26,0,30,4
1650283234522,MATH 10B,A01,083207,Staff,0,6,30,30
1650283234522,MATH 10B,A02,083208,Staff,0,6,30,30
1650283234522,MATH 10B,B01,083739,Staff,17,0,30,13
1650283234522,MATH 10B,B02,083740,Staff,29,0,30,1
1650283240555,MATH 18,A01,083743,Staff,7,0,30,23
1650283240555,MATH 18,A02,083744,Staff,27,0,30,3
1650283240555,MATH 18,A03,083745,Staff,23,0,30,7
1650283240555,MATH 18,A04,083746,Staff,27,0,30,3
1650283240555,MATH 18,B01,083748,Staff,0,11,30,30
1650283240555,MATH 18,B02,083749,Staff,0,9,30,30
1650283240555,MATH 18,B03,083750,Staff,1,8,30,29
1650283240555,MATH 18,B04,083751,Staff,0,9,30,30
1650283246585,MATH 20A,A01,083754,Staff,26,0,40,14
1650283252611,MATH 20B,A01,083756,Staff,0,5,30,30
1650283252611,MATH 20B,A02,083757,Staff,0,7,30,30
1650283258639,MATH 20C,A01,083760,Staff,0,13,30,30
1650283258639,MATH 20C,A02,083761,Staff,0,13,30,30
1650283258639,MATH 20C,B01,083762,Staff,14,0,30,16
1650283258639,MATH 20C,B02,083763,Staff,28,0,30,2
1650283264668,MATH 20D,A01,083765,Staff,0,1,30,30
1650283264668,MATH 20D,A02,083766,Staff,8,0,30,22
1650283264668,MATH 20D,A03,083767,Staff,28,0,30,2
1650283270698,MATH 20E,A01,083771,Staff,6,0,30,24
1650283270698,MATH 20E,A02,083772,Staff,20,0,30,10
1650283270698,MATH 20E,B01,083773,Staff,0,0,30,30
1650283270698,MATH 20E,B02,083774,Staff,11,0,30,19
1650283276725,MATH 103A,A01,083777,Staff,0,10,30,30
1650283276725,MATH 103A,A02,083778,Staff,0,10,30,30
1650283276725,MATH 103A,B01,083779,Staff,0,10,30,30
1650283276725,MATH 103A,B02,083780,Staff,0,10,30,30
1650283282757,MATH 105,A01,085443,Staff,0,17,30,30
1650283288797,MATH 109,A01,083213,Anzaldo; Leesa B,0,5,30,30
1650283288797,MATH 109,A02,083214,Anzaldo; Leesa B,0,6,30,30
1650283288797,MATH 109,B01,083215,Anzaldo; Leesa B,0,4,30,30
1650283288797,MATH 109,B02,083216,Anzaldo; Leesa B,0,3,30,30
1650283294827,MATH 142A,A01,083219,Chow; Bennett,0,12,30,30
1650283294827,MATH 142A,A02,083220,Chow; Bennett,0,11,30,30
1650283294827,MATH 142A,B01,083221,Chow; Bennett,0,11,30,30
1650283294827,MATH 142A,B02,083222,Chow; Bennett,0,12,30,30
1650283300854,MATH 193A,A01,083224,Staff,0,5,30,30
1650283300854,MATH 193A,A02,083225,Staff,0,5,30,30
1650283300854,MATH 193A,A03,083781,Staff,0,2,30,30
1650283300854,MATH 193A,A04,083782,Staff,0,1,30,30
1650283306896,MATH 197,001,091859,McAuley; Julian John,9998,0,9999,1
1650283312969,COGS 9,A01,083615,Staff,0,14,60,60
1650283318997,COGS 11,A01,083617,Boyle; Mary E. T.,24,0,40,16
1650283325024,COGS 13,A01,083071,Staff,0,31,40,40
1650283331051,COGS 14A,A01,092681,Staff,0,15,100,100
1650283337161,COGS 14B,A01,083073,Cheng; Tzu-Han,0,9,50,50
1650283343186,COGS 17,A01,092677,Staff,29,0,75,46
1650283349216,COGS 100,A01,083619,Staff,0,23,60,60
1650283355242,COGS 101A,A01,083621,Davis; Joshua Daniel,0,21,60,60
1650283361273,COGS 101B,A01,091572,Staff,4,0,60,56
1650283367303,COGS 101C,A01,083625,Delgado; Tania,19,0,30,11
1650283373338,COGS 107A,A01,083627,Boyle; Mary E. T.,0,8,60,60
1650283379365,COGS 118A,A01,083075,Staff,13,0,60,47
1650283385390,CSE 3,A50,083646,Miranda; Gregory Joseph,21,0,38,17
1650283385390,CSE 3,A51,083647,Miranda; Gregory Joseph,37,0,37,0
1650283391415,CSE 8A,A50,083650,Miranda; Gregory Joseph,0,22,40,40
1650283397443,CSE 11,A01,083080,Cao; Yingjun,0,74,40,40
1650283403468,CSE 12,A01,083652,Staff,0,10,100,100
1650283409496,CSE 15L,A01,083654,Staff,0,1,50,50
1650283409496,CSE 15L,A02,083655,Staff,4,0,50,46
1650283415528,CSE 20,A01,083657,Staff,53,0,80,27
1650283421553,CSE 30,A01,083084,Eldon; John,0,74,40,40
1650283427580,CSE 100,A01,083659,Cao; Yingjun,0,65,50,50
1650283433610,CSE 134B,A01,083661,Powell; Thomas Allan,0,28,65,65
1650283439640,CSE 140,A01,083663,Staff,0,0,75,75
1650283445667,CSE 140L,A01,083088,Eldon; John,0,6,75,75
1650283451692,CSE 175,A01,083665,Kumar; Rakesh,8,0,25,17
1650283457719,CSE 190,A00,092507,Dubnov; Shlomo,14,0,20,6
1650283463750,ECE 45,A01,083139,Staff,0,15,40,40
1650283469778,ECE 65,A50,083695,Staff,0,4,30,30
1650283475807,ECE 109,A01,091882,Touri; Behrouz,43,0,70,27
1650283481835,ECE 180,A00,083140,Abi Samra; Nicholas Camill,24,0,30,6
1650283481835,ECE 180,B00,083141,Abi Samra; Nicholas Camill,7,0,30,23
1650283487861,MATH 10A,A01,083735,Patchell; Gregory David,11,0,30,19
1650283487861,MATH 10A,A02,083736,Patchell; Gregory David,28,0,30,2
1650283487861,MATH 10A,A03,083737,Patchell; Gregory David,26,0,30,4
1650283493891,MATH 10B,A01,083207,Staff,0,6,30,30
1650283493891,MATH 10B,A02,083208,Staff,0,6,30,30
1650283493891,MATH 10B,B01,083739,Staff,17,0,30,13
1650283493891,MATH 10B,B02,083740,Staff,29,0,30,1
1650283499918,MATH 18,A01,083743,Staff,7,0,30,23
1650283499918,MATH 18,A02,083744,Staff,27,0,30,3
1650283499918,MATH 18,A03,083745,Staff,23,0,30,7
1650283499918,MATH 18,A04,083746,Staff,27,0,30,3
1650283499918,MATH 18,B01,083748,Staff,0,11,30,30
1650283499918,MATH 18,B02,083749,Staff,0,9,30,30
1650283499918,MATH 18,B03,083750,Staff,1,8,30,29
1650283499918,MATH 18,B04,083751,Staff,0,9,30,30
1650283505946,MATH 20A,A01,083754,Staff,26,0,40,14
1650283511973,MATH 20B,A01,083756,Staff,0,5,30,30
1650283511973,MATH 20B,A02,083757,Staff,0,7,30,30
1650283518002,MATH 20C,A01,083760,Staff,0,13,30,30
1650283518002,MATH 20C,A02,083761,Staff,0,13,30,30
1650283518002,MATH 20C,B01,083762,Staff,14,0,30,16
1650283518002,MATH 20C,B02,083763,Staff,28,0,30,2
1650283524035,MATH 20D,A01,083765,Staff,0,1,30,30
1650283524035,MATH 20D,A02,083766,Staff,8,0,30,22
1650283524035,MATH 20D,A03,083767,Staff,28,0,30,2
1650283530061,MATH 20E,A01,083771,Staff,6,0,30,24
1650283530061,MATH 20E,A02,083772,Staff,20,0,30,10
1650283530061,MATH 20E,B01,083773,Staff,0,0,30,30
1650283530061,MATH 20E,B02,083774,Staff,11,0,30,19
1650283536084,MATH 103A,A01,083777,Staff,0,10,30,30
1650283536084,MATH 103A,A02,083778,Staff,0,10,30,30
1650283536084,MATH 103A,B01,083779,Staff,0,10,30,30
1650283536084,MATH 103A,B02,083780,Staff,0,10,30,30
1650283542109,MATH 105,A01,085443,Staff,0,17,30,30
1650283548135,MATH 109,A01,083213,Anzaldo; Leesa B,0,5,30,30
1650283548135,MATH 109,A02,083214,Anzaldo; Leesa B,0,6,30,30
1650283548135,MATH 109,B01,083215,Anzaldo; Leesa B,0,4,30,30
1650283548135,MATH 109,B02,083216,Anzaldo; Leesa B,0,3,30,30
1650283554161,MATH 142A,A01,083219,Chow; Bennett,0,12,30,30
1650283554161,MATH 142A,A02,083220,Chow; Bennett,0,11,30,30
1650283554161,MATH 142A,B01,083221,Chow; Bennett,0,11,30,30
1650283554161,MATH 142A,B02,083222,Chow; Bennett,0,12,30,30
1650283560186,MATH 193A,A01,083224,Staff,0,5,30,30
1650283560186,MATH 193A,A02,083225,Staff,0,5,30,30
1650283560186,MATH 193A,A03,083781,Staff,0,2,30,30
1650283560186,MATH 193A,A04,083782,Staff,0,1,30,30
1650283566212,MATH 197,001,091859,McAuley; Julian John,9998,0,9999,1
1650283572279,COGS 9,A01,083615,Staff,0,14,60,60
1650283578304,COGS 11,A01,083617,Boyle; Mary E. T.,24,0,40,16
1650283584329,COGS 13,A01,083071,Staff,0,31,40,40
1650283590355,COGS 14A,A01,092681,Staff,0,15,100,100
1650283596385,COGS 14B,A01,083073,Cheng; Tzu-Han,0,9,50,50
1650283602415,COGS 17,A01,092677,Staff,29,0,75,46
1650283608441,COGS 100,A01,083619,Staff,0,23,60,60
1650283614470,COGS 101A,A01,083621,Davis; Joshua Daniel,0,21,60,60
1650283620505,COGS 101B,A01,091572,Staff,4,0,60,56
1650283626528,COGS 101C,A01,083625,Delgado; Tania,19,0,30,11
1650283632551,COGS 107A,A01,083627,Boyle; Mary E. T.,0,8,60,60
1650283638575,COGS 118A,A01,083075,Staff,13,0,60,47
1650283644609,CSE 3,A50,083646,Miranda; Gregory Joseph,21,0,38,17
1650283644609,CSE 3,A51,083647,Miranda; Gregory Joseph,37,0,37,0
1650283650633,CSE 8A,A50,083650,Miranda; Gregory Joseph,0,22,40,40
1650283656661,CSE 11,A01,083080,Cao; Yingjun,0,74,40,40
1650283662685,CSE 12,A01,083652,Staff,0,10,100,100
1650283668709,CSE 15L,A01,083654,Staff,0,1,50,50
1650283668709,CSE 15L,A02,083655,Staff,4,0,50,46
1650283674733,CSE 20,A01,083657,Staff,53,0,80,27
1650283680763,CSE 30,A01,083084,Eldon; John,0,74,40,40
1650283686805,CSE 100,A01,083659,Cao; Yingjun,0,65,50,50
1650283692829,CSE 134B,A01,083661,Powell; Thomas Allan,0,28,65,65
1650283698854,CSE 140,A01,083663,Staff,0,0,75,75
1650283704879,CSE 140L,A01,083088,Eldon; John,0,6,75,75
1650283710907,CSE 175,A01,083665,Kumar; Rakesh,8,0,25,17
1650283716933,CSE 190,A00,092507,Dubnov; Shlomo,14,0,20,6
1650283722959,ECE 45,A01,083139,Staff,0,15,40,40
1650283728985,ECE 65,A50,083695,Staff,0,4,30,30
1650283735013,ECE 109,A01,091882,Touri; Behrouz,43,0,70,27
1650283741043,ECE 180,A00,083140,Abi Samra; Nicholas Camill,24,0,30,6
1650283741043,ECE 180,B00,083141,Abi Samra; Nicholas Camill,7,0,30,23
1650283747073,MATH 10A,A01,083735,Patchell; Gregory David,11,0,30,19
1650283747073,MATH 10A,A02,083736,Patchell; Gregory David,28,0,30,2
1650283747073,MATH 10A,A03,083737,Patchell; Gregory David,26,0,30,4
1650283753103,MATH 10B,A01,083207,Staff,0,6,30,30
1650283753103,MATH 10B,A02,083208,Staff,0,6,30,30
1650283753103,MATH 10B,B01,083739,Staff,17,0,30,13
1650283753103,MATH 10B,B02,083740,Staff,29,0,30,1
1650283759131,MATH 18,A01,083743,Staff,7,0,30,23
1650283759131,MATH 18,A02,083744,Staff,27,0,30,3
1650283759131,MATH 18,A03,083745,Staff,23,0,30,7
1650283759131,MATH 18,A04,083746,Staff,27,0,30,3
1650283759131,MATH 18,B01,083748,Staff,0,11,30,30
1650283759131,MATH 18,B02,083749,Staff,0,9,30,30
1650283759131,MATH 18,B03,083750,Staff,1,8,30,29
1650283759131,MATH 18,B04,083751,Staff,0,9,30,30
1650283765160,MATH 20A,A01,083754,Staff,26,0,40,14
1650283771190,MATH 20B,A01,083756,Staff,0,5,30,30
1650283771190,MATH 20B,A02,083757,Staff,0,7,30,30
1650283777216,MATH 20C,A01,083760,Staff,0,13,30,30
1650283777216,MATH 20C,A02,083761,Staff,0,13,30,30
1650283777216,MATH 20C,B01,083762,Staff,14,0,30,16
1650283777216,MATH 20C,B02,083763,Staff,28,0,30,2
1650283783243,MATH 20D,A01,083765,Staff,0,1,30,30
1650283783243,MATH 20D,A02,083766,Staff,8,0,30,22
1650283783243,MATH 20D,A03,083767,Staff,28,0,30,2
1650283789273,MATH 20E,A01,083771,Staff,6,0,30,24
1650283789273,MATH 20E,A02,083772,Staff,20,0,30,10
1650283789273,MATH 20E,B01,083773,Staff,0,0,30,30
1650283789273,MATH 20E,B02,083774,Staff,11,0,30,19
1650283795304,MATH 103A,A01,083777,Staff,0,10,30,30
1650283795304,MATH 103A,A02,083778,Staff,0,10,30,30
1650283795304,MATH 103A,B01,083779,Staff,0,10,30,30
1650283795304,MATH 103A,B02,083780,Staff,0,10,30,30
1650283801338,MATH 105,A01,085443,Staff,0,17,30,30
1650283807365,MATH 109,A01,083213,Anzaldo; Leesa B,0,5,30,30
1650283807365,MATH 109,A02,083214,Anzaldo; Leesa B,0,6,30,30
1650283807365,MATH 109,B01,083215,Anzaldo; Leesa B,0,4,30,30
1650283807365,MATH 109,B02,083216,Anzaldo; Leesa B,0,3,30,30
1650283813396,MATH 142A,A01,083219,Chow; Bennett,0,12,30,30
1650283813396,MATH 142A,A02,083220,Chow; Bennett,0,11,30,30
1650283813396,MATH 142A,B01,083221,Chow; Bennett,0,11,30,30
1650283813396,MATH 142A,B02,083222,Chow; Bennett,0,12,30,30
1650283819424,MATH 193A,A01,083224,Staff,0,5,30,30
1650283819424,MATH 193A,A02,083225,Staff,0,5,30,30
1650283819424,MATH 193A,A03,083781,Staff,0,2,30,30
1650283819424,MATH 193A,A04,083782,Staff,0,1,30,30
1650283825452,MATH 197,001,091859,McAuley; Julian John,9998,0,9999,1
1650283831537,COGS 9,A01,083615,Staff,0,14,60,60
1650283837566,COGS 11,A01,083617,Boyle; Mary E. T.,24,0,40,16
1650283843592,COGS 13,A01,083071,Staff,0,31,40,40
1650283849618,COGS 14A,A01,092681,Staff,0,15,100,100
1650283855645,COGS 14B,A01,083073,Cheng; Tzu-Han,0,9,50,50
1650283861672,COGS 17,A01,092677,Staff,29,0,75,46
1650283867700,COGS 100,A01,083619,Staff,0,23,60,60
1650283873727,COGS 101A,A01,083621,Davis; Joshua Daniel,0,21,60,60
1650283879756,COGS 101B,A01,091572,Staff,4,0,60,56
1650283885785,COGS 101C,A01,083625,Delgado; Tania,19,0,30,11
1650283891811,COGS 107A,A01,083627,Boyle; Mary E. T.,0,8,60,60
1650283897840,COGS 118A,A01,083075,Staff,13,0,60,47
1650283903867,CSE 3,A50,083646,Miranda; Gregory Joseph,21,0,38,17
1650283903867,CSE 3,A51,083647,Miranda; Gregory Joseph,37,0,37,0
1650283909901,CSE 8A,A50,083650,Miranda; Gregory Joseph,0,22,40,40
1650283915927,CSE 11,A01,083080,Cao; Yingjun,0,74,40,40
1650283921957,CSE 12,A01,083652,Staff,0,10,100,100
1650283927987,CSE 15L,A01,083654,Staff,0,1,50,50
1650283927987,CSE 15L,A02,083655,Staff,4,0,50,46
1650283934100,CSE 20,A01,083657,Staff,53,0,80,27
1650283940131,CSE 30,A01,083084,Eldon; John,0,74,40,40
1650283946157,CSE 100,A01,083659,Cao; Yingjun,0,65,50,50
1650283952185,CSE 134B,A01,083661,Powell; Thomas Allan,0,28,65,65
1650283958209,CSE 140,A01,083663,Staff,0,0,75,75
1650283964238,CSE 140L,A01,083088,Eldon; John,0,6,75,75
1650283970265,CSE 175,A01,083665,Kumar; Rakesh,8,0,25,17
1650283976289,CSE 190,A00,092507,Dubnov; Shlomo,14,0,20,6
1650283982316,ECE 45,A01,083139,Staff,0,15,40,40
1650283988340,ECE 65,A50,083695,Staff,0,4,30,30
1650283994368,ECE 109,A01,091882,Touri; Behrouz,43,0,70,27
1650284000405,ECE 180,A00,083140,Abi Samra; Nicholas Camill,24,0,30,6
1650284000405,ECE 180,B00,083141,Abi Samra; Nicholas Camill,7,0,30,23
1650284006431,MATH 10A,A01,083735,Patchell; Gregory David,11,0,30,19
1650284006431,MATH 10A,A02,083736,Patchell; Gregory David,28,0,30,2
1650284006431,MATH 10A,A03,083737,Patchell; Gregory David,26,0,30,4
1650284012457,MATH 10B,A01,083207,Staff,0,6,30,30
1650284012457,MATH 10B,A02,083208,Staff,0,6,30,30
1650284012457,MATH 10B,B01,083739,Staff,17,0,30,13
1650284012457,MATH 10B,B02,083740,Staff,29,0,30,1
1650284018485,MATH 18,A01,083743,Staff,7,0,30,23
1650284018485,MATH 18,A02,083744,Staff,27,0,30,3
1650284018485,MATH 18,A03,083745,Staff,23,0,30,7
1650284018485,MATH 18,A04,083746,Staff,27,0,30,3
1650284018485,MATH 18,B01,083748,Staff,0,11,30,30
1650284018485,MATH 18,B02,083749,Staff,0,9,30,30
1650284018485,MATH 18,B03,083750,Staff,1,8,30,29
1650284018485,MATH 18,B04,083751,Staff,0,9,30,30
1650284024511,MATH 20A,A01,083754,Staff,26,0,40,14
1650284030542,MATH 20B,A01,083756,Staff,0,5,30,30
1650284030542,MATH 20B,A02,083757,Staff,0,7,30,30
1650284036568,MATH 20C,A01,083760,Staff,0,13,30,30
1650284036568,MATH 20C,A02,083761,Staff,0,13,30,30
1650284036568,MATH 20C,B01,083762,Staff,14,0,30,16
1650284036568,MATH 20C,B02,083763,Staff,28,0,30,2
1650284042595,MATH 20D,A01,083765,Staff,0,1,30,30
1650284042595,MATH 20D,A02,083766,Staff,8,0,30,22
1650284042595,MATH 20D,A03,083767,Staff,28,0,30,2
1650284048621,MATH 20E,A01,083771,Staff,6,0,30,24
1650284048621,MATH 20E,A02,083772,Staff,20,0,30,10
1650284048621,MATH 20E,B01,083773,Staff,0,0,30,30
1650284048621,MATH 20E,B02,083774,Staff,11,0,30,19
1650284054649,MATH 103A,A01,083777,Staff,0,10,30,30
1650284054649,MATH 103A,A02,083778,Staff,0,10,30,30
1650284054649,MATH 103A,B01,083779,Staff,0,10,30,30
1650284054649,MATH 103A,B02,083780,Staff,0,10,30,30
1650284060679,MATH 105,A01,085443,Staff,0,17,30,30
1650284066708,MATH 109,A01,083213,Anzaldo; Leesa B,0,5,30,30
1650284066708,MATH 109,A02,083214,Anzaldo; Leesa B,0,6,30,30
1650284066708,MATH 109,B01,083215,Anzaldo; Leesa B,0,4,30,30
1650284066708,MATH 109,B02,083216,Anzaldo; Leesa B,0,3,30,30
1650284072738,MATH 142A,A01,083219,Chow; Bennett,0,12,30,30
1650284072738,MATH 142A,A02,083220,Chow; Bennett,0,11,30,30
1650284072738,MATH 142A,B01,083221,Chow; Bennett,0,11,30,30
1650284072738,MATH 142A,B02,083222,Chow; Bennett,0,12,30,30
1650284078765,MATH 193A,A01,083224,Staff,0,5,30,30
1650284078765,MATH 193A,A02,083225,Staff,0,5,30,30
1650284078765,MATH 193A,A03,083781,Staff,0,2,30,30
1650284078765,MATH 193A,A04,083782,Staff,0,1,30,30
1650284084792,MATH 197,001,091859,McAuley; Julian John,9998,0,9999,1
1650284090851,COGS 9,A01,083615,Staff,0,14,60,60
1650284096877,COGS 11,A01,083617,Boyle; Mary E. T.,24,0,40,16
1650284102900,COGS 13,A01,083071,Staff,0,31,40,40
1650284108925,COGS 14A,A01,092681,Staff,0,15,100,100
1650284114952,COGS 14B,A01,083073,Cheng; Tzu-Han,0,9,50,50
1650284120976,COGS 17,A01,092677,Staff,29,0,75,46
1650284127010,COGS 100,A01,083619,Staff,0,23,60,60
1650284133038,COGS 101A,A01,083621,Davis; Joshua Daniel,0,21,60,60
1650284139065,COGS 101B,A01,091572,Staff,4,0,60,56
1650284145095,COGS 101C,A01,083625,Delgado; Tania,19,0,30,11
1650284151140,COGS 107A,A01,083627,Boyle; Mary E. T.,0,8,60,60
1650284157165,COGS 118A,A01,083075,Staff,13,0,60,47
1650284163196,CSE 3,A50,083646,Miranda; Gregory Joseph,21,0,38,17
1650284163196,CSE 3,A51,083647,Miranda; Gregory Joseph,37,0,37,0
1650284169223,CSE 8A,A50,083650,Miranda; Gregory Joseph,0,22,40,40
1650284175250,CSE 11,A01,083080,Cao; Yingjun,0,74,40,40
1650284181281,CSE 12,A01,083652,Staff,0,10,100,100
1650284187319,CSE 15L,A01,083654,Staff,0,1,50,50
1650284187319,CSE 15L,A02,083655,Staff,4,0,50,46
1650284193346,CSE 20,A01,083657,Staff,53,0,80,27
1650284199371,CSE 30,A01,083084,Eldon; John,0,74,40,40
1650284205401,CSE 100,A01,083659,Cao; Yingjun,0,65,50,50
1650284211426,CSE 134B,A01,083661,Powell; Thomas Allan,0,28,65,65
1650284217452,CSE 140,A01,083663,Staff,0,0,75,75
1650284223476,CSE 140L,A01,083088,Eldon; John,0,6,75,75
1650284229507,CSE 175,A01,083665,Kumar; Rakesh,8,0,25,17
1650284235535,CSE 190,A00,092507,Dubnov; Shlomo,14,0,20,6
1650284241563,ECE 45,A01,083139,Staff,0,15,40,40
1650284247588,ECE 65,A50,083695,Staff,0,4,30,30
1650284253612,ECE 109,A01,091882,Touri; Behrouz,43,0,70,27
1650284259641,ECE 180,A00,083140,Abi Samra; Nicholas Camill,24,0,30,6
1650284259641,ECE 180,B00,083141,Abi Samra; Nicholas Camill,7,0,30,23
1650284265667,MATH 10A,A01,083735,Patchell; Gregory David,11,0,30,19
1650284265667,MATH 10A,A02,083736,Patchell; Gregory David,28,0,30,2
1650284265667,MATH 10A,A03,083737,Patchell; Gregory David,26,0,30,4
1650284271692,MATH 10B,A01,083207,Staff,0,6,30,30
1650284271692,MATH 10B,A02,083208,Staff,0,6,30,30
1650284271692,MATH 10B,B01,083739,Staff,17,0,30,13
1650284271692,MATH 10B,B02,083740,Staff,29,0,30,1
1650284277719,MATH 18,A01,083743,Staff,7,0,30,23
1650284277719,MATH 18,A02,083744,Staff,27,0,30,3
1650284277719,MATH 18,A03,083745,Staff,23,0,30,7
1650284277719,MATH 18,A04,083746,Staff,27,0,30,3
1650284277719,MATH 18,B01,083748,Staff,0,11,30,30
1650284277719,MATH 18,B02,083749,Staff,0,9,30,30
1650284277719,MATH 18,B03,083750,Staff,1,8,30,29
1650284277719,MATH 18,B04,083751,Staff,0,9,30,30
1650284283743,MATH 20A,A01,083754,Staff,26,0,40,14
1650284289770,MATH 20B,A01,083756,Staff,0,5,30,30
1650284289770,MATH 20B,A02,083757,Staff,0,7,30,30
1650284295799,MATH 20C,A01,083760,Staff,0,13,30,30
1650284295799,MATH 20C,A02,083761,Staff,0,13,30,30
1650284295799,MATH 20C,B01,083762,Staff,14,0,30,16
1650284295799,MATH 20C,B02,083763,Staff,28,0,30,2
1650284301827,MATH 20D,A01,083765,Staff,0,1,30,30
1650284301827,MATH 20D,A02,083766,Staff,8,0,30,22
1650284301827,MATH 20D,A03,083767,Staff,28,0,30,2
1650284307861,MATH 20E,A01,083771,Staff,6,0,30,24
1650284307861,MATH 20E,A02,083772,Staff,20,0,30,10
1650284307861,MATH 20E,B01,083773,Staff,0,0,30,30
1650284307861,MATH 20E,B02,083774,Staff,11,0,30,19
1650284313888,MATH 103A,A01,083777,Staff,0,10,30,30
1650284313888,MATH 103A,A02,083778,Staff,0,10,30,30
1650284313888,MATH 103A,B01,083779,Staff,0,10,30,30
1650284313888,MATH 103A,B02,083780,Staff,0,10,30,30
1650284319922,MATH 105,A01,085443,Staff,0,17,30,30
1650284325949,MATH 109,A01,083213,Anzaldo; Leesa B,0,5,30,30
1650284325949,MATH 109,A02,083214,Anzaldo; Leesa B,0,6,30,30
1650284325949,MATH 109,B01,083215,Anzaldo; Leesa B,0,4,30,30
1650284325949,MATH 109,B02,083216,Anzaldo; Leesa B,0,3,30,30
1650284331975,MATH 142A,A01,083219,Chow; Bennett,0,12,30,30
1650284331975,MATH 142A,A02,083220,Chow; Bennett,0,11,30,30
1650284331975,MATH 142A,B01,083221,Chow; Bennett,0,11,30,30
1650284331975,MATH 142A,B02,083222,Chow; Bennett,0,12,30,30
1650284338003,MATH 193A,A01,083224,Staff,0,5,30,30
1650284338003,MATH 193A,A02,083225,Staff,0,5,30,30
1650284338003,MATH 193A,A03,083781,Staff,0,2,30,30
1650284338003,MATH 193A,A04,083782,Staff,0,1,30,30
1650284344031,MATH 197,001,091859,McAuley; Julian John,9998,0,9999,1
1650284350098,COGS 9,A01,083615,Staff,0,14,60,60
1650284356123,COGS 11,A01,083617,Boyle; Mary E. T.,24,0,40,16
1650284362151,COGS 13,A01,083071,Staff,0,31,40,40
1650284368179,COGS 14A,A01,092681,Staff,0,15,100,100
1650284374208,COGS 14B,A01,083073,Cheng; Tzu-Han,0,9,50,50
1650284380237,COGS 17,A01,092677,Staff,29,0,75,46
1650284386275,COGS 100,A01,083619,Staff,0,23,60,60
1650284392301,COGS 101A,A01,083621,Davis; Joshua Daniel,0,21,60,60
1650284398327,COGS 101B,A01,091572,Staff,4,0,60,56
1650284404356,COGS 101C,A01,083625,Delgado; Tania,19,0,30,11
1650284410385,COGS 107A,A01,083627,Boyle; Mary E. T.,0,8,60,60
1650284416413,COGS 118A,A01,083075,Staff,13,0,60,47
1650284422442,CSE 3,A50,083646,Miranda; Gregory Joseph,21,0,38,17
1650284422442,CSE 3,A51,083647,Miranda; Gregory Joseph,37,0,37,0
1650284428473,CSE 8A,A50,083650,Miranda; Gregory Joseph,0,22,40,40
1650284434502,CSE 11,A01,083080,Cao; Yingjun,0,74,40,40
1650284440533,CSE 12,A01,083652,Staff,0,10,100,100
1650284446560,CSE 15L,A01,083654,Staff,0,1,50,50
1650284446560,CSE 15L,A02,083655,Staff,4,0,50,46
1650284452585,CSE 20,A01,083657,Staff,53,0,80,27
1650284458629,CSE 30,A01,083084,Eldon; John,0,74,40,40
1650284464656,CSE 100,A01,083659,Cao; Yingjun,0,65,50,50
1650284470680,CSE 134B,A01,083661,Powell; Thomas Allan,0,28,65,65
1650284476704,CSE 140,A01,083663,Staff,0,0,75,75
1650284482731,CSE 140L,A01,083088,Eldon; John,0,6,75,75
1650284488758,CSE 175,A01,083665,Kumar; Rakesh,8,0,25,17
1650284494787,CSE 190,A00,092507,Dubnov; Shlomo,14,0,20,6
1650284500821,ECE 45,A01,083139,Staff,0,15,40,40
1650284506855,ECE 65,A50,083695,Staff,0,4,30,30
1650284512884,ECE 109,A01,091882,Touri; Behrouz,43,0,70,27
1650284518915,ECE 180,A00,083140,Abi Samra; Nicholas Camill,24,0,30,6
1650284518915,ECE 180,B00,083141,Abi Samra; Nicholas Camill,7,0,30,23
1650284524945,MATH 10A,A01,083735,Patchell; Gregory David,11,0,30,19
1650284524945,MATH 10A,A02,083736,Patchell; Gregory David,28,0,30,2
1650284524945,MATH 10A,A03,083737,Patchell; Gregory David,26,0,30,4
1650284531064,MATH 10B,A01,083207,Staff,0,6,30,30
1650284531064,MATH 10B,A02,083208,Staff,0,6,30,30
1650284531064,MATH 10B,B01,083739,Staff,17,0,30,13
1650284531064,MATH 10B,B02,083740,Staff,29,0,30,1
1650284537099,MATH 18,A01,083743,Staff,7,0,30,23
1650284537099,MATH 18,A02,083744,Staff,27,0,30,3
1650284537099,MATH 18,A03,083745,Staff,23,0,30,7
1650284537099,MATH 18,A04,083746,Staff,27,0,30,3
1650284537099,MATH 18,B01,083748,Staff,0,11,30,30
1650284537099,MATH 18,B02,083749,Staff,0,9,30,30
1650284537099,MATH 18,B03,083750,Staff,1,8,30,29
1650284537099,MATH 18,B04,083751,Staff,0,9,30,30
1650284543126,MATH 20A,A01,083754,Staff,26,0,40,14
1650284549151,MATH 20B,A01,083756,Staff,0,5,30,30
1650284549151,MATH 20B,A02,083757,Staff,0,7,30,30
1650284555175,MATH 20C,A01,083760,Staff,0,13,30,30
1650284555175,MATH 20C,A02,083761,Staff,0,13,30,30
1650284555175,MATH 20C,B01,083762,Staff,14,0,30,16
1650284555175,MATH 20C,B02,083763,Staff,28,0,30,2
1650284561200,MATH 20D,A01,083765,Staff,0,1,30,30
1650284561200,MATH 20D,A02,083766,Staff,8,0,30,22
1650284561200,MATH 20D,A03,083767,Staff,28,0,30,2
1650284567228,MATH 20E,A01,083771,Staff,6,0,30,24
1650284567228,MATH 20E,A02,083772,Staff,20,0,30,10
1650284567228,MATH 20E,B01,083773,Staff,0,0,30,30
1650284567228,MATH 20E,B02,083774,Staff,11,0,30,19
1650284573253,MATH 103A,A01,083777,Staff,0,10,30,30
1650284573253,MATH 103A,A02,083778,Staff,0,10,30,30
1650284573253,MATH 103A,B01,083779,Staff,0,10,30,30
1650284573253,MATH 103A,B02,083780,Staff,0,10,30,30
1650284579279,MATH 105,A01,085443,Staff,0,17,30,30
1650284585305,MATH 109,A01,083213,Anzaldo; Leesa B,0,5,30,30
1650284585305,MATH 109,A02,083214,Anzaldo; Leesa B,0,6,30,30
1650284585305,MATH 109,B01,083215,Anzaldo; Leesa B,0,4,30,30
1650284585305,MATH 109,B02,083216,Anzaldo; Leesa B,0,3,30,30
1650284591332,MATH 142A,A01,083219,Chow; Bennett,0,12,30,30
1650284591332,MATH 142A,A02,083220,Chow; Bennett,0,11,30,30
1650284591332,MATH 142A,B01,083221,Chow; Bennett,0,11,30,30
1650284591332,MATH 142A,B02,083222,Chow; Bennett,0,12,30,30
1650284597360,MATH 193A,A01,083224,Staff,0,5,30,30
1650284597360,MATH 193A,A02,083225,Staff,0,5,30,30
1650284597360,MATH 193A,A03,083781,Staff,0,2,30,30
1650284597360,MATH 193A,A04,083782,Staff,0,1,30,30
1650284603386,MATH 197,001,091859,McAuley; Julian John,9998,0,9999,1
1650284609448,COGS 9,A01,083615,Staff,0,14,60,60
1650284615476,COGS 11,A01,083617,Boyle; Mary E. T.,24,0,40,16
1650284621506,COGS 13,A01,083071,Staff,0,31,40,40
1650284627532,COGS 14A,A01,092681,Staff,0,15,100,100
1650284633562,COGS 14B,A01,083073,Cheng; Tzu-Han,0,9,50,50
1650284639586,COGS 17,A01,092677,Staff,29,0,75,46
1650284645614,COGS 100,A01,083619,Staff,0,23,60,60
1650284651642,COGS 101A,A01,083621,Davis; Joshua Daniel,0,21,60,60
1650284657668,COGS 101B,A01,091572,Staff,4,0,60,56
1650284663697,COGS 101C,A01,083625,Delgado; Tania,19,0,30,11
1650284669726,COGS 107A,A01,083627,Boyle; Mary E. T.,0,8,60,60
1650284675757,COGS 118A,A01,083075,Staff,13,0,60,47
1650284681785,CSE 3,A50,083646,Miranda; Gregory Joseph,21,0,38,17
1650284681785,CSE 3,A51,083647,Miranda; Gregory Joseph,37,0,37,0
1650284687811,CSE 8A,A50,083650,Miranda; Gregory Joseph,0,22,40,40
1650284693837,CSE 11,A01,083080,Cao; Yingjun,0,74,40,40
1650284699871,CSE 12,A01,083652,Staff,0,10,100,100
1650284705914,CSE 15L,A01,083654,Staff,0,1,50,50
1650284705914,CSE 15L,A02,083655,Staff,4,0,50,46
1650284711954,CSE 20,A01,083657,Staff,53,0,80,27
1650284717982,CSE 30,A01,083084,Eldon; John,0,74,40,40
1650284724011,CSE 100,A01,083659,Cao; Yingjun,0,65,50,50
1650284730040,CSE 134B,A01,083661,Powell; Thomas Allan,0,28,65,65
1650284736069,CSE 140,A01,083663,Staff,0,0,75,75
1650284742099,CSE 140L,A01,083088,Eldon; John,0,6,75,75
1650284748124,CSE 175,A01,083665,Kumar; Rakesh,8,0,25,17
1650284754150,CSE 190,A00,092507,Dubnov; Shlomo,14,0,20,6
1650284760184,ECE 45,A01,083139,Staff,0,15,40,40
1650284766212,ECE 65,A50,083695,Staff,0,4,30,30
1650284772236,ECE 109,A01,091882,Touri; Behrouz,43,0,70,27
1650284778265,ECE 180,A00,083140,Abi Samra; Nicholas Camill,24,0,30,6
1650284778265,ECE 180,B00,083141,Abi Samra; Nicholas Camill,7,0,30,23
1650284784293,MATH 10A,A01,083735,Patchell; Gregory David,11,0,30,19
1650284784293,MATH 10A,A02,083736,Patchell; Gregory David,28,0,30,2
1650284784293,MATH 10A,A03,083737,Patchell; Gregory David,26,0,30,4
1650284790320,MATH 10B,A01,083207,Staff,0,6,30,30
1650284790320,MATH 10B,A02,083208,Staff,0,6,30,30
1650284790320,MATH 10B,B01,083739,Staff,17,0,30,13
1650284790320,MATH 10B,B02,083740,Staff,29,0,30,1
1650284796347,MATH 18,A01,083743,Staff,7,0,30,23
1650284796347,MATH 18,A02,083744,Staff,27,0,30,3
1650284796347,MATH 18,A03,083745,Staff,23,0,30,7
1650284796347,MATH 18,A04,083746,Staff,27,0,30,3
1650284796347,MATH 18,B01,083748,Staff,0,11,30,30
1650284796347,MATH 18,B02,083749,Staff,0,9,30,30
1650284796347,MATH 18,B03,083750,Staff,1,8,30,29
1650284796347,MATH 18,B04,083751,Staff,0,9,30,30
1650284802377,MATH 20A,A01,083754,Staff,26,0,40,14
1650284808406,MATH 20B,A01,083756,Staff,0,5,30,30
1650284808406,MATH 20B,A02,083757,Staff,0,7,30,30
1650284814432,MATH 20C,A01,083760,Staff,0,13,30,30
1650284814432,MATH 20C,A02,083761,Staff,0,13,30,30
1650284814432,MATH 20C,B01,083762,Staff,14,0,30,16
1650284814432,MATH 20C,B02,083763,Staff,28,0,30,2
1650284820455,MATH 20D,A01,083765,Staff,0,1,30,30
1650284820455,MATH 20D,A02,083766,Staff,8,0,30,22
1650284820455,MATH 20D,A03,083767,Staff,28,0,30,2
1650284826481,MATH 20E,A01,083771,Staff,6,0,30,24
1650284826481,MATH 20E,A02,083772,Staff,20,0,30,10
1650284826481,MATH 20E,B01,083773,Staff,0,0,30,30
1650284826481,MATH 20E,B02,083774,Staff,11,0,30,19
1650284832512,MATH 103A,A01,083777,Staff,0,10,30,30
1650284832512,MATH 103A,A02,083778,Staff,0,10,30,30
1650284832512,MATH 103A,B01,083779,Staff,0,10,30,30
1650284832512,MATH 103A,B02,083780,Staff,0,10,30,30
1650284838542,MATH 105,A01,085443,Staff,0,17,30,30
1650284844573,MATH 109,A01,083213,Anzaldo; Leesa B,0,5,30,30
1650284844573,MATH 109,A02,083214,Anzaldo; Leesa B,0,6,30,30
1650284844573,MATH 109,B01,083215,Anzaldo; Leesa B,0,4,30,30
1650284844573,MATH 109,B02,083216,Anzaldo; Leesa B,0,3,30,30
1650284850599,MATH 142A,A01,083219,Chow; Bennett,0,12,30,30
1650284850599,MATH 142A,A02,083220,Chow; Bennett,0,11,30,30
1650284850599,MATH 142A,B01,083221,Chow; Bennett,0,11,30,30
1650284850599,MATH 142A,B02,083222,Chow; Bennett,0,12,30,30
1650284856628,MATH 193A,A01,083224,Staff,0,5,30,30
1650284856628,MATH 193A,A02,083225,Staff,0,5,30,30
1650284856628,MATH 193A,A03,083781,Staff,0,2,30,30
1650284856628,MATH 193A,A04,083782,Staff,0,1,30,30
1650284862652,MATH 197,001,091859,McAuley; Julian John,9998,0,9999,1
1650284868713,COGS 9,A01,083615,Staff,0,14,60,60
1650284874740,COGS 11,A01,083617,Boyle; Mary E. T.,24,0,40,16
1650284880765,COGS 13,A01,083071,Staff,0,31,40,40
1650284886790,COGS 14A,A01,092681,Staff,0,15,100,100
1650284892814,COGS 14B,A01,083073,Cheng; Tzu-Han,0,9,50,50
1650284898839,COGS 17,A01,092677,Staff,29,0,75,46
1650284904866,COGS 100,A01,083619,Staff,0,23,60,60
1650284910889,COGS 101A,A01,083621,Davis; Joshua Daniel,0,21,60,60
1650284916918,COGS 101B,A01,091572,Staff,4,0,60,56
1650284922943,COGS 101C,A01,083625,Delgado; Tania,19,0,30,11
1650284928983,COGS 107A,A01,083627,Boyle; Mary E. T.,0,8,60,60
1650284935010,COGS 118A,A01,083075,Staff,13,0,60,47
1650284941035,CSE 3,A50,083646,Miranda; Gregory Joseph,21,0,38,17
1650284941035,CSE 3,A51,083647,Miranda; Gregory Joseph,37,0,37,0
1650284947062,CSE 8A,A50,083650,Miranda; Gregory Joseph,0,22,40,40
1650284953091,CSE 11,A01,083080,Cao; Yingjun,0,74,40,40
1650284959116,CSE 12,A01,083652,Staff,0,10,100,100
1650284965140,CSE 15L,A01,083654,Staff,0,1,50,50
1650284965140,CSE 15L,A02,083655,Staff,4,0,50,46
1650284971169,CSE 20,A01,083657,Staff,53,0,80,27
1650284977196,CSE 30,A01,083084,Eldon; John,0,74,40,40
1650284983223,CSE 100,A01,083659,Cao; Yingjun,0,65,50,50
1650284989252,CSE 134B,A01,083661,Powell; Thomas Allan,0,28,65,65
1650284995277,CSE 140,A01,083663,Staff,0,0,75,75
1650285001306,CSE 140L,A01,083088,Eldon; John,0,6,75,75
1650285007332,CSE 175,A01,083665,Kumar; Rakesh,8,0,25,17
1650285013355,CSE 190,A00,092507,Dubnov; Shlomo,14,0,20,6
1650285019389,ECE 45,A01,083139,Staff,0,15,40,40
1650285025421,ECE 65,A50,083695,Staff,0,4,30,30
1650285031449,ECE 109,A01,091882,Touri; Behrouz,43,0,70,27
1650285037475,ECE 180,A00,083140,Abi Samra; Nicholas Camill,24,0,30,6
1650285037475,ECE 180,B00,083141,Abi Samra; Nicholas Camill,7,0,30,23
1650285043501,MATH 10A,A01,083735,Patchell; Gregory David,11,0,30,19
1650285043501,MATH 10A,A02,083736,Patchell; Gregory David,28,0,30,2
1650285043501,MATH 10A,A03,083737,Patchell; Gregory David,26,0,30,4
1650285049531,MATH 10B,A01,083207,Staff,0,6,30,30
1650285049531,MATH 10B,A02,083208,Staff,0,6,30,30
1650285049531,MATH 10B,B01,083739,Staff,17,0,30,13
1650285049531,MATH 10B,B02,083740,Staff,29,0,30,1
1650285055558,MATH 18,A01,083743,Staff,7,0,30,23
1650285055558,MATH 18,A02,083744,Staff,27,0,30,3
1650285055558,MATH 18,A03,083745,Staff,23,0,30,7
1650285055558,MATH 18,A04,083746,Staff,27,0,30,3
1650285055558,MATH 18,B01,083748,Staff,0,11,30,30
1650285055558,MATH 18,B02,083749,Staff,0,9,30,30
1650285055558,MATH 18,B03,083750,Staff,1,8,30,29
1650285055558,MATH 18,B04,083751,Staff,0,9,30,30
1650285061582,MATH 20A,A01,083754,Staff,26,0,40,14
1650285067608,MATH 20B,A01,083756,Staff,0,5,30,30
1650285067608,MATH 20B,A02,083757,Staff,0,7,30,30
1650285073638,MATH 20C,A01,083760,Staff,0,13,30,30
1650285073638,MATH 20C,A02,083761,Staff,0,13,30,30
1650285073638,MATH 20C,B01,083762,Staff,14,0,30,16
1650285073638,MATH 20C,B02,083763,Staff,28,0,30,2
1650285079667,MATH 20D,A01,083765,Staff,0,1,30,30
1650285079667,MATH 20D,A02,083766,Staff,8,0,30,22
1650285079667,MATH 20D,A03,083767,Staff,28,0,30,2
1650285085702,MATH 20E,A01,083771,Staff,6,0,30,24
1650285085702,MATH 20E,A02,083772,Staff,20,0,30,10
1650285085702,MATH 20E,B01,083773,Staff,0,0,30,30
1650285085702,MATH 20E,B02,083774,Staff,11,0,30,19
1650285091733,MATH 103A,A01,083777,Staff,0,10,30,30
1650285091733,MATH 103A,A02,083778,Staff,0,10,30,30
1650285091733,MATH 103A,B01,083779,Staff,0,10,30,30
1650285091733,MATH 103A,B02,083780,Staff,0,10,30,30
1650285097762,MATH 105,A01,085443,Staff,0,17,30,30
1650285103793,MATH 109,A01,083213,Anzaldo; Leesa B,0,5,30,30
1650285103793,MATH 109,A02,083214,Anzaldo; Leesa B,0,6,30,30
1650285103793,MATH 109,B01,083215,Anzaldo; Leesa B,0,4,30,30
1650285103793,MATH 109,B02,083216,Anzaldo; Leesa B,0,3,30,30
1650285109837,MATH 142A,A01,083219,Chow; Bennett,0,12,30,30
1650285109837,MATH 142A,A02,083220,Chow; Bennett,0,11,30,30
1650285109837,MATH 142A,B01,083221,Chow; Bennett,0,11,30,30
1650285109837,MATH 142A,B02,083222,Chow; Bennett,0,12,30,30
1650285115872,MATH 193A,A01,083224,Staff,0,5,30,30
1650285115872,MATH 193A,A02,083225,Staff,0,5,30,30
1650285115872,MATH 193A,A03,083781,Staff,0,2,30,30
1650285115872,MATH 193A,A04,083782,Staff,0,1,30,30
1650285121901,MATH 197,001,091859,McAuley; Julian John,9998,0,9999,1
1650285128058,COGS 9,A01,083615,Staff,0,14,60,60
1650285134086,COGS 11,A01,083617,Boyle; Mary E. T.,24,0,40,16
1650285140110,COGS 13,A01,083071,Staff,0,31,40,40
1650285146139,COGS 14A,A01,092681,Staff,0,15,100,100
1650285152167,COGS 14B,A01,083073,Cheng; Tzu-Han,0,9,50,50
1650285158191,COGS 17,A01,092677,Staff,29,0,75,46
1650285164215,COGS 100,A01,083619,Staff,0,23,60,60
1650285170244,COGS 101A,A01,083621,Davis; Joshua Daniel,0,21,60,60
1650285176270,COGS 101B,A01,091572,Staff,4,0,60,56
1650285182299,COGS 101C,A01,083625,Delgado; Tania,19,0,30,11
1650285188327,COGS 107A,A01,083627,Boyle; Mary E. T.,0,8,60,60
1650285194356,COGS 118A,A01,083075,Staff,13,0,60,47
1650285200382,CSE 3,A50,083646,Miranda; Gregory Joseph,21,0,38,17
1650285200382,CSE 3,A51,083647,Miranda; Gregory Joseph,37,0,37,0
1650285206407,CSE 8A,A50,083650,Miranda; Gregory Joseph,0,22,40,40
1650285212433,CSE 11,A01,083080,Cao; Yingjun,0,74,40,40
1650285218459,CSE 12,A01,083652,Staff,0,10,100,100
1650285224493,CSE 15L,A01,083654,Staff,0,1,50,50
1650285224493,CSE 15L,A02,083655,Staff,4,0,50,46
1650285230525,CSE 20,A01,083657,Staff,53,0,80,27
1650285236559,CSE 30,A01,083084,Eldon; John,0,74,40,40
1650285242594,CSE 100,A01,083659,Cao; Yingjun,0,65,50,50
1650285248624,CSE 134B,A01,083661,Powell; Thomas Allan,0,28,65,65
1650285254654,CSE 140,A01,083663,Staff,0,0,75,75
1650285260680,CSE 140L,A01,083088,Eldon; John,0,6,75,75
1650285266706,CSE 175,A01,083665,Kumar; Rakesh,8,0,25,17
1650285272743,CSE 190,A00,092507,Dubnov; Shlomo,14,0,20,6
1650285278771,ECE 45,A01,083139,Staff,0,15,40,40
1650285284798,ECE 65,A50,083695,Staff,0,4,30,30
1650285290834,ECE 109,A01,091882,Touri; Behrouz,43,0,70,27
1650285296861,ECE 180,A00,083140,Abi Samra; Nicholas Camill,24,0,30,6
1650285296861,ECE 180,B00,083141,Abi Samra; Nicholas Camill,7,0,30,23
1650285302891,MATH 10A,A01,083735,Patchell; Gregory David,11,0,30,19
1650285302891,MATH 10A,A02,083736,Patchell; Gregory David,28,0,30,2
1650285302891,MATH 10A,A03,083737,Patchell; Gregory David,26,0,30,4
1650285308926,MATH 10B,A01,083207,Staff,0,6,30,30
1650285308926,MATH 10B,A02,083208,Staff,0,6,30,30
1650285308926,MATH 10B,B01,083739,Staff,17,0,30,13
1650285308926,MATH 10B,B02,083740,Staff,29,0,30,1
1650285314964,MATH 18,A01,083743,Staff,7,0,30,23
1650285314964,MATH 18,A02,083744,Staff,27,0,30,3
1650285314964,MATH 18,A03,083745,Staff,23,0,30,7
1650285314964,MATH 18,A04,083746,Staff,27,0,30,3
1650285314964,MATH 18,B01,083748,Staff,0,11,30,30
1650285314964,MATH 18,B02,083749,Staff,0,9,30,30
1650285314964,MATH 18,B03,083750,Staff,1,8,30,29
1650285314964,MATH 18,B04,083751,Staff,0,9,30,30
1650285320996,MATH 20A,A01,083754,Staff,26,0,40,14
1650285327022,MATH 20B,A01,083756,Staff,0,5,30,30
1650285327022,MATH 20B,A02,083757,Staff,0,7,30,30
1650285333051,MATH 20C,A01,083760,Staff,0,13,30,30
1650285333051,MATH 20C,A02,083761,Staff,0,13,30,30
1650285333051,MATH 20C,B01,083762,Staff,14,0,30,16
1650285333051,MATH 20C,B02,083763,Staff,28,0,30,2
1650285339078,MATH 20D,A01,083765,Staff,0,1,30,30
1650285339078,MATH 20D,A02,083766,Staff,8,0,30,22
1650285339078,MATH 20D,A03,083767,Staff,28,0,30,2
1650285345103,MATH 20E,A01,083771,Staff,6,0,30,24
1650285345103,MATH 20E,A02,083772,Staff,20,0,30,10
1650285345103,MATH 20E,B01,083773,Staff,0,0,30,30
1650285345103,MATH 20E,B02,083774,Staff,11,0,30,19
1650285351127,MATH 103A,A01,083777,Staff,0,10,30,30
1650285351127,MATH 103A,A02,083778,Staff,0,10,30,30
1650285351127,MATH 103A,B01,083779,Staff,0,10,30,30
1650285351127,MATH 103A,B02,083780,Staff,0,10,30,30
1650285357156,MATH 105,A01,085443,Staff,0,17,30,30
1650285363182,MATH 109,A01,083213,Anzaldo; Leesa B,0,5,30,30
1650285363182,MATH 109,A02,083214,Anzaldo; Leesa B,0,6,30,30
1650285363182,MATH 109,B01,083215,Anzaldo; Leesa B,0,4,30,30
1650285363182,MATH 109,B02,083216,Anzaldo; Leesa B,0,3,30,30
1650285369208,MATH 142A,A01,083219,Chow; Bennett,0,12,30,30
1650285369208,MATH 142A,A02,083220,Chow; Bennett,0,11,30,30
1650285369208,MATH 142A,B01,083221,Chow; Bennett,0,11,30,30
1650285369208,MATH 142A,B02,083222,Chow; Bennett,0,12,30,30
1650285375239,MATH 193A,A01,083224,Staff,0,5,30,30
1650285375239,MATH 193A,A02,083225,Staff,0,5,30,30
1650285375239,MATH 193A,A03,083781,Staff,0,2,30,30
1650285375239,MATH 193A,A04,083782,Staff,0,1,30,30
1650285381265,MATH 197,001,091859,McAuley; Julian John,9998,0,9999,1
1650285387318,COGS 9,A01,083615,Staff,0,14,60,60
1650285393349,COGS 11,A01,083617,Boyle; Mary E. T.,24,0,40,16
1650285399374,COGS 13,A01,083071,Staff,0,31,40,40
1650285405401,COGS 14A,A01,092681,Staff,0,15,100,100
1650285411428,COGS 14B,A01,083073,Cheng; Tzu-Han,0,9,50,50
1650285417481,COGS 17,A01,092677,Staff,29,0,75,46
1650285423506,COGS 100,A01,083619,Staff,0,23,60,60
1650285429537,COGS 101A,A01,083621,Davis; Joshua Daniel,0,21,60,60
1650285435564,COGS 101B,A01,091572,Staff,4,0,60,56
1650285441591,COGS 101C,A01,083625,Delgado; Tania,19,0,30,11
1650285447616,COGS 107A,A01,083627,Boyle; Mary E. T.,0,8,60,60
1650285453645,COGS 118A,A01,083075,Staff,13,0,60,47
1650285459677,CSE 3,A50,083646,Miranda; Gregory Joseph,21,0,38,17
1650285459677,CSE 3,A51,083647,Miranda; Gregory Joseph,37,0,37,0
1650285465706,CSE 8A,A50,083650,Miranda; Gregory Joseph,0,22,40,40
1650285471731,CSE 11,A01,083080,Cao; Yingjun,0,74,40,40
1650285477758,CSE 12,A01,083652,Staff,0,10,100,100
1650285483784,CSE 15L,A01,083654,Staff,0,1,50,50
1650285483784,CSE 15L,A02,083655,Staff,4,0,50,46
1650285489811,CSE 20,A01,083657,Staff,53,0,80,27
1650285495837,CSE 30,A01,083084,Eldon; John,0,74,40,40
1650285501863,CSE 100,A01,083659,Cao; Yingjun,0,65,50,50
1650285507898,CSE 134B,A01,083661,Powell; Thomas Allan,0,28,65,65
1650285513928,CSE 140,A01,083663,Staff,0,0,75,75
1650285519955,CSE 140L,A01,083088,Eldon; John,0,6,75,75
1650285525981,CSE 175,A01,083665,Kumar; Rakesh,8,0,25,17
1650285532006,CSE 190,A00,092507,Dubnov; Shlomo,14,0,20,6
1650285538029,ECE 45,A01,083139,Staff,0,15,40,40
1650285544070,ECE 65,A50,083695,Staff,0,4,30,30
1650285550098,ECE 109,A01,091882,Touri; Behrouz,43,0,70,27
1650285556124,ECE 180,A00,083140,Abi Samra; Nicholas Camill,24,0,30,6
1650285556124,ECE 180,B00,083141,Abi Samra; Nicholas Camill,7,0,30,23
1650285562154,MATH 10A,A01,083735,Patchell; Gregory David,11,0,30,19
1650285562154,MATH 10A,A02,083736,Patchell; Gregory David,28,0,30,2
1650285562154,MATH 10A,A03,083737,Patchell; Gregory David,26,0,30,4
1650285568192,MATH 10B,A01,083207,Staff,0,6,30,30
1650285568192,MATH 10B,A02,083208,Staff,0,6,30,30
1650285568192,MATH 10B,B01,083739,Staff,17,0,30,13
1650285568192,MATH 10B,B02,083740,Staff,29,0,30,1
1650285574223,MATH 18,A01,083743,Staff,7,0,30,23
1650285574223,MATH 18,A02,083744,Staff,27,0,30,3
1650285574223,MATH 18,A03,083745,Staff,23,0,30,7
1650285574223,MATH 18,A04,083746,Staff,27,0,30,3
1650285574223,MATH 18,B01,083748,Staff,0,11,30,30
1650285574223,MATH 18,B02,083749,Staff,0,9,30,30
1650285574223,MATH 18,B03,083750,Staff,1,8,30,29
1650285574223,MATH 18,B04,083751,Staff,0,9,30,30
1650285580251,MATH 20A,A01,083754,Staff,26,0,40,14
1650285586280,MATH 20B,A01,083756,Staff,0,5,30,30
1650285586280,MATH 20B,A02,083757,Staff,0,7,30,30
1650285592307,MATH 20C,A01,083760,Staff,0,13,30,30
1650285592307,MATH 20C,A02,083761,Staff,0,13,30,30
1650285592307,MATH 20C,B01,083762,Staff,14,0,30,16
1650285592307,MATH 20C,B02,083763,Staff,28,0,30,2
1650285598333,MATH 20D,A01,083765,Staff,0,1,30,30
1650285598333,MATH 20D,A02,083766,Staff,8,0,30,22
1650285598333,MATH 20D,A03,083767,Staff,28,0,30,2
1650285604360,MATH 20E,A01,083771,Staff,6,0,30,24
1650285604360,MATH 20E,A02,083772,Staff,20,0,30,10
1650285604360,MATH 20E,B01,083773,Staff,0,0,30,30
1650285604360,MATH 20E,B02,083774,Staff,11,0,30,19
1650285610387,MATH 103A,A01,083777,Staff,0,10,30,30
1650285610387,MATH 103A,A02,083778,Staff,0,10,30,30
1650285610387,MATH 103A,B01,083779,Staff,0,10,30,30
1650285610387,MATH 103A,B02,083780,Staff,0,10,30,30
1650285616412,MATH 105,A01,085443,Staff,0,17,30,30
1650285622448,MATH 109,A01,083213,Anzaldo; Leesa B,0,5,30,30
1650285622448,MATH 109,A02,083214,Anzaldo; Leesa B,0,6,30,30
1650285622448,MATH 109,B01,083215,Anzaldo; Leesa B,0,4,30,30
1650285622448,MATH 109,B02,083216,Anzaldo; Leesa B,0,3,30,30
1650285628485,MATH 142A,A01,083219,Chow; Bennett,0,12,30,30
1650285628485,MATH 142A,A02,083220,Chow; Bennett,0,11,30,30
1650285628485,MATH 142A,B01,083221,Chow; Bennett,0,11,30,30
1650285628485,MATH 142A,B02,083222,Chow; Bennett,0,12,30,30
1650285634526,MATH 193A,A01,083224,Staff,0,5,30,30
1650285634526,MATH 193A,A02,083225,Staff,0,5,30,30
1650285634526,MATH 193A,A03,083781,Staff,0,2,30,30
1650285634526,MATH 193A,A04,083782,Staff,0,1,30,30
1650285640551,MATH 197,001,091859,McAuley; Julian John,9998,0,9999,1
1650285646605,COGS 9,A01,083615,Staff,0,14,60,60
1650285652631,COGS 11,A01,083617,Boyle; Mary E. T.,24,0,40,16
1650285658667,COGS 13,A01,083071,Staff,0,31,40,40
1650285664696,COGS 14A,A01,092681,Staff,0,15,100,100
1650285670724,COGS 14B,A01,083073,Cheng; Tzu-Han,0,9,50,50
1650285676751,COGS 17,A01,092677,Staff,29,0,75,46
1650285682785,COGS 100,A01,083619,Staff,0,23,60,60
1650285688815,COGS 101A,A01,083621,Davis; Joshua Daniel,0,21,60,60
1650285694838,COGS 101B,A01,091572,Staff,4,0,60,56
1650285700870,COGS 101C,A01,083625,Delgado; Tania,19,0,30,11
1650285706896,COGS 107A,A01,083627,Boyle; Mary E. T.,0,8,60,60
1650285712921,COGS 118A,A01,083075,Staff,13,0,60,47
1650285719047,CSE 3,A50,083646,Miranda; Gregory Joseph,21,0,38,17
1650285719047,CSE 3,A51,083647,Miranda; Gregory Joseph,37,0,37,0
1650285725073,CSE 8A,A50,083650,Miranda; Gregory Joseph,0,22,40,40
1650285731107,CSE 11,A01,083080,Cao; Yingjun,0,74,40,40
1650285737141,CSE 12,A01,083652,Staff,0,10,100,100
1650285743170,CSE 15L,A01,083654,Staff,0,1,50,50
1650285743170,CSE 15L,A02,083655,Staff,4,0,50,46
1650285749196,CSE 20,A01,083657,Staff,53,0,80,27
1650285755229,CSE 30,A01,083084,Eldon; John,0,74,40,40
1650285761254,CSE 100,A01,083659,Cao; Yingjun,0,65,50,50
1650285767279,CSE 134B,A01,083661,Powell; Thomas Allan,0,28,65,65
1650285773312,CSE 140,A01,083663,Staff,0,0,75,75
1650285779338,CSE 140L,A01,083088,Eldon; John,0,6,75,75
1650285785364,CSE 175,A01,083665,Kumar; Rakesh,8,0,25,17
1650285791390,CSE 190,A00,092507,Dubnov; Shlomo,14,0,20,6
1650285797415,ECE 45,A01,083139,Staff,0,15,40,40
1650285803440,ECE 65,A50,083695,Staff,0,4,30,30
1650285809473,ECE 109,A01,091882,Touri; Behrouz,43,0,70,27
1650285815517,ECE 180,A00,083140,Abi Samra; Nicholas Camill,24,0,30,6
1650285815517,ECE 180,B00,083141,Abi Samra; Nicholas Camill,7,0,30,23
1650285821547,MATH 10A,A01,083735,Patchell; Gregory David,11,0,30,19
1650285821547,MATH 10A,A02,083736,Patchell; Gregory David,28,0,30,2
1650285821547,MATH 10A,A03,083737,Patchell; Gregory David,26,0,30,4
1650285827574,MATH 10B,A01,083207,Staff,0,6,30,30
1650285827574,MATH 10B,A02,083208,Staff,0,6,30,30
1650285827574,MATH 10B,B01,083739,Staff,17,0,30,13
1650285827574,MATH 10B,B02,083740,Staff,29,0,30,1
1650285833603,MATH 18,A01,083743,Staff,7,0,30,23
1650285833603,MATH 18,A02,083744,Staff,27,0,30,3
1650285833603,MATH 18,A03,083745,Staff,23,0,30,7
1650285833603,MATH 18,A04,083746,Staff,27,0,30,3
1650285833603,MATH 18,B01,083748,Staff,0,11,30,30
1650285833603,MATH 18,B02,083749,Staff,0,9,30,30
1650285833603,MATH 18,B03,083750,Staff,1,8,30,29
1650285833603,MATH 18,B04,083751,Staff,0,9,30,30
1650285839631,MATH 20A,A01,083754,Staff,26,0,40,14
1650285845660,MATH 20B,A01,083756,Staff,0,5,30,30
1650285845660,MATH 20B,A02,083757,Staff,0,7,30,30
1650285851693,MATH 20C,A01,083760,Staff,0,13,30,30
1650285851693,MATH 20C,A02,083761,Staff,0,13,30,30
1650285851693,MATH 20C,B01,083762,Staff,14,0,30,16
1650285851693,MATH 20C,B02,083763,Staff,28,0,30,2
1650285857723,MATH 20D,A01,083765,Staff,0,1,30,30
1650285857723,MATH 20D,A02,083766,Staff,8,0,30,22
1650285857723,MATH 20D,A03,083767,Staff,28,0,30,2
1650285863752,MATH 20E,A01,083771,Staff,6,0,30,24
1650285863752,MATH 20E,A02,083772,Staff,20,0,30,10
1650285863752,MATH 20E,B01,083773,Staff,0,0,30,30
1650285863752,MATH 20E,B02,083774,Staff,11,0,30,19
1650285869781,MATH 103A,A01,083777,Staff,0,10,30,30
1650285869781,MATH 103A,A02,083778,Staff,0,10,30,30
1650285869781,MATH 103A,B01,083779,Staff,0,10,30,30
1650285869781,MATH 103A,B02,083780,Staff,0,10,30,30
1650285875805,MATH 105,A01,085443,Staff,0,17,30,30
1650285881837,MATH 109,A01,083213,Anzaldo; Leesa B,0,5,30,30
1650285881837,MATH 109,A02,083214,Anzaldo; Leesa B,0,6,30,30
1650285881837,MATH 109,B01,083215,Anzaldo; Leesa B,0,4,30,30
1650285881837,MATH 109,B02,083216,Anzaldo; Leesa B,0,3,30,30
1650285887871,MATH 142A,A01,083219,Chow; Bennett,0,12,30,30
1650285887871,MATH 142A,A02,083220,Chow; Bennett,0,11,30,30
1650285887871,MATH 142A,B01,083221,Chow; Bennett,0,11,30,30
1650285887871,MATH 142A,B02,083222,Chow; Bennett,0,12,30,30
1650285893900,MATH 193A,A01,083224,Staff,0,5,30,30
1650285893900,MATH 193A,A02,083225,Staff,0,5,30,30
1650285893900,MATH 193A,A03,083781,Staff,0,2,30,30
1650285893900,MATH 193A,A04,083782,Staff,0,1,30,30
1650285899924,MATH 197,001,091859,McAuley; Julian John,9998,0,9999,1
1650285905984,COGS 9,A01,083615,Staff,0,14,60,60
1650285912011,COGS 11,A01,083617,Boyle; Mary E. T.,24,0,40,16
1650285918036,COGS 13,A01,083071,Staff,0,31,40,40
1650285924065,COGS 14A,A01,092681,Staff,0,15,100,100
1650285930092,COGS 14B,A01,083073,Cheng; Tzu-Han,0,9,50,50
1650285936117,COGS 17,A01,092677,Staff,29,0,75,46
1650285942145,COGS 100,A01,083619,Staff,0,23,60,60
1650285948175,COGS 101A,A01,083621,Davis; Joshua Daniel,0,21,60,60
1650285954201,COGS 101B,A01,091572,Staff,4,0,60,56
1650285960231,COGS 101C,A01,083625,Delgado; Tania,19,0,30,11
1650285966258,COGS 107A,A01,083627,Boyle; Mary E. T.,0,8,60,60
1650285972283,COGS 118A,A01,083075,Staff,13,0,60,47
1650285978310,CSE 3,A50,083646,Miranda; Gregory Joseph,21,0,38,17
1650285978310,CSE 3,A51,083647,Miranda; Gregory Joseph,37,0,37,0
1650285984333,CSE 8A,A50,083650,Miranda; Gregory Joseph,0,22,40,40
1650285990358,CSE 11,A01,083080,Cao; Yingjun,0,74,40,40
1650285996388,CSE 12,A01,083652,Staff,0,10,100,100
1650286002418,CSE 15L,A01,083654,Staff,0,1,50,50
1650286002418,CSE 15L,A02,083655,Staff,4,0,50,46
1650286008445,CSE 20,A01,083657,Staff,53,0,80,27
1650286014472,CSE 30,A01,083084,Eldon; John,0,74,40,40
1650286020510,CSE 100,A01,083659,Cao; Yingjun,0,65,50,50
1650286026541,CSE 134B,A01,083661,Powell; Thomas Allan,0,28,65,65
1650286032564,CSE 140,A01,083663,Staff,0,0,75,75
1650286038594,CSE 140L,A01,083088,Eldon; John,0,6,75,75
1650286044626,CSE 175,A01,083665,Kumar; Rakesh,8,0,25,17
1650286050650,CSE 190,A00,092507,Dubnov; Shlomo,14,0,20,6
1650286056678,ECE 45,A01,083139,Staff,0,15,40,40
1650286062704,ECE 65,A50,083695,Staff,0,4,30,30
1650286068737,ECE 109,A01,091882,Touri; Behrouz,43,0,70,27
1650286074768,ECE 180,A00,083140,Abi Samra; Nicholas Camill,24,0,30,6
1650286074768,ECE 180,B00,083141,Abi Samra; Nicholas Camill,7,0,30,23
1650286080794,MATH 10A,A01,083735,Patchell; Gregory David,11,0,30,19
1650286080794,MATH 10A,A02,083736,Patchell; Gregory David,28,0,30,2
1650286080794,MATH 10A,A03,083737,Patchell; Gregory David,26,0,30,4
1650286086831,MATH 10B,A01,083207,Staff,0,6,30,30
1650286086831,MATH 10B,A02,083208,Staff,0,6,30,30
1650286086831,MATH 10B,B01,083739,Staff,17,0,30,13
1650286086831,MATH 10B,B02,083740,Staff,29,0,30,1
1650286092863,MATH 18,A01,083743,Staff,7,0,30,23
1650286092863,MATH 18,A02,083744,Staff,27,0,30,3
1650286092863,MATH 18,A03,083745,Staff,23,0,30,7
1650286092863,MATH 18,A04,083746,Staff,27,0,30,3
1650286092863,MATH 18,B01,083748,Staff,0,11,30,30
1650286092863,MATH 18,B02,083749,Staff,0,9,30,30
1650286092863,MATH 18,B03,083750,Staff,1,8,30,29
1650286092863,MATH 18,B04,083751,Staff,0,9,30,30
1650286098890,MATH 20A,A01,083754,Staff,26,0,40,14
1650286104916,MATH 20B,A01,083756,Staff,0,5,30,30
1650286104916,MATH 20B,A02,083757,Staff,0,7,30,30
1650286110945,MATH 20C,A01,083760,Staff,0,13,30,30
1650286110945,MATH 20C,A02,083761,Staff,0,13,30,30
1650286110945,MATH 20C,B01,083762,Staff,14,0,30,16
1650286110945,MATH 20C,B02,083763,Staff,28,0,30,2
1650286116972,MATH 20D,A01,083765,Staff,0,1,30,30
1650286116972,MATH 20D,A02,083766,Staff,8,0,30,22
1650286116972,MATH 20D,A03,083767,Staff,28,0,30,2
1650286123010,MATH 20E,A01,083771,Staff,6,0,30,24
1650286123010,MATH 20E,A02,083772,Staff,20,0,30,10
1650286123010,MATH 20E,B01,083773,Staff,0,0,30,30
1650286123010,MATH 20E,B02,083774,Staff,11,0,30,19
1650286129041,MATH 103A,A01,083777,Staff,0,10,30,30
1650286129041,MATH 103A,A02,083778,Staff,0,10,30,30
1650286129041,MATH 103A,B01,083779,Staff,0,10,30,30
1650286129041,MATH 103A,B02,083780,Staff,0,10,30,30
1650286135070,MATH 105,A01,085443,Staff,0,17,30,30
1650286141106,MATH 109,A01,083213,Anzaldo; Leesa B,0,5,30,30
1650286141106,MATH 109,A02,083214,Anzaldo; Leesa B,0,6,30,30
1650286141106,MATH 109,B01,083215,Anzaldo; Leesa B,0,4,30,30
1650286141106,MATH 109,B02,083216,Anzaldo; Leesa B,0,3,30,30
1650286147135,MATH 142A,A01,083219,Chow; Bennett,0,12,30,30
1650286147135,MATH 142A,A02,083220,Chow; Bennett,0,11,30,30
1650286147135,MATH 142A,B01,083221,Chow; Bennett,0,11,30,30
1650286147135,MATH 142A,B02,083222,Chow; Bennett,0,12,30,30
1650286153166,MATH 193A,A01,083224,Staff,0,5,30,30
1650286153166,MATH 193A,A02,083225,Staff,0,5,30,30
1650286153166,MATH 193A,A03,083781,Staff,0,2,30,30
1650286153166,MATH 193A,A04,083782,Staff,0,1,30,30
1650286159194,MATH 197,001,091859,McAuley; Julian John,9998,0,9999,1
1650286165250,COGS 9,A01,083615,Staff,0,14,60,60
1650286171276,COGS 11,A01,083617,Boyle; Mary E. T.,24,0,40,16
1650286177301,COGS 13,A01,083071,Staff,0,31,40,40
1650286183331,COGS 14A,A01,092681,Staff,0,15,100,100
1650286189357,COGS 14B,A01,083073,Cheng; Tzu-Han,0,9,50,50
1650286195384,COGS 17,A01,092677,Staff,29,0,75,46
1650286201408,COGS 100,A01,083619,Staff,0,23,60,60
1650286207446,COGS 101A,A01,083621,Davis; Joshua Daniel,0,21,60,60
1650286213477,COGS 101B,A01,091572,Staff,4,0,60,56
1650286219502,COGS 101C,A01,083625,Delgado; Tania,19,0,30,11
1650286225530,COGS 107A,A01,083627,Boyle; Mary E. T.,0,8,60,60
1650286231557,COGS 118A,A01,083075,Staff,13,0,60,47
1650286237584,CSE 3,A50,083646,Miranda; Gregory Joseph,21,0,38,17
1650286237584,CSE 3,A51,083647,Miranda; Gregory Joseph,37,0,37,0
1650286243622,CSE 8A,A50,083650,Miranda; Gregory Joseph,0,22,40,40
1650286249660,CSE 11,A01,083080,Cao; Yingjun,0,74,40,40
1650286255689,CSE 12,A01,083652,Staff,0,10,100,100
1650286261718,CSE 15L,A01,083654,Staff,0,1,50,50
1650286261718,CSE 15L,A02,083655,Staff,4,0,50,46
1650286267747,CSE 20,A01,083657,Staff,53,0,80,27
1650286273774,CSE 30,A01,083084,Eldon; John,0,74,40,40
1650286279808,CSE 100,A01,083659,Cao; Yingjun,0,65,50,50
1650286285841,CSE 134B,A01,083661,Powell; Thomas Allan,0,28,65,65
1650286291876,CSE 140,A01,083663,Staff,0,0,75,75
1650286297906,CSE 140L,A01,083088,Eldon; John,0,6,75,75
1650286303932,CSE 175,A01,083665,Kumar; Rakesh,8,0,25,17
1650286309961,CSE 190,A00,092507,Dubnov; Shlomo,14,0,20,6
1650286316077,ECE 45,A01,083139,Staff,0,15,40,40
1650286322107,ECE 65,A50,083695,Staff,0,4,30,30
1650286328139,ECE 109,A01,091882,Touri; Behrouz,43,0,70,27
1650286334163,ECE 180,A00,083140,Abi Samra; Nicholas Camill,24,0,30,6
1650286334163,ECE 180,B00,083141,Abi Samra; Nicholas Camill,7,0,30,23
1650286340191,MATH 10A,A01,083735,Patchell; Gregory David,11,0,30,19
1650286340191,MATH 10A,A02,083736,Patchell; Gregory David,28,0,30,2
1650286340191,MATH 10A,A03,083737,Patchell; Gregory David,26,0,30,4
1650286346225,MATH 10B,A01,083207,Staff,0,6,30,30
1650286346225,MATH 10B,A02,083208,Staff,0,6,30,30
1650286346225,MATH 10B,B01,083739,Staff,17,0,30,13
1650286346225,MATH 10B,B02,083740,Staff,29,0,30,1
1650286352255,MATH 18,A01,083743,Staff,7,0,30,23
1650286352255,MATH 18,A02,083744,Staff,27,0,30,3
1650286352255,MATH 18,A03,083745,Staff,23,0,30,7
1650286352255,MATH 18,A04,083746,Staff,27,0,30,3
1650286352255,MATH 18,B01,083748,Staff,0,11,30,30
1650286352255,MATH 18,B02,083749,Staff,0,9,30,30
1650286352255,MATH 18,B03,083750,Staff,1,8,30,29
1650286352255,MATH 18,B04,083751,Staff,0,9,30,30
1650286358285,MATH 20A,A01,083754,Staff,26,0,40,14
1650286364317,MATH 20B,A01,083756,Staff,0,5,30,30
1650286364317,MATH 20B,A02,083757,Staff,0,7,30,30
1650286370345,MATH 20C,A01,083760,Staff,0,13,30,30
1650286370345,MATH 20C,A02,083761,Staff,0,13,30,30
1650286370345,MATH 20C,B01,083762,Staff,14,0,30,16
1650286370345,MATH 20C,B02,083763,Staff,28,0,30,2
1650286376371,MATH 20D,A01,083765,Staff,0,1,30,30
1650286376371,MATH 20D,A02,083766,Staff,8,0,30,22
1650286376371,MATH 20D,A03,083767,Staff,28,0,30,2
1650286382401,MATH 20E,A01,083771,Staff,6,0,30,24
1650286382401,MATH 20E,A02,083772,Staff,20,0,30,10
1650286382401,MATH 20E,B01,083773,Staff,0,0,30,30
1650286382401,MATH 20E,B02,083774,Staff,11,0,30,19
1650286388432,MATH 103A,A01,083777,Staff,0,10,30,30
1650286388432,MATH 103A,A02,083778,Staff,0,10,30,30
1650286388432,MATH 103A,B01,083779,Staff,0,10,30,30
1650286388432,MATH 103A,B02,083780,Staff,0,10,30,30
1650286394458,MATH 105,A01,085443,Staff,0,17,30,30
1650286400485,MATH 109,A01,083213,Anzaldo; Leesa B,0,5,30,30
1650286400485,MATH 109,A02,083214,Anzaldo; Leesa B,0,6,30,30
1650286400485,MATH 109,B01,083215,Anzaldo; Leesa B,0,4,30,30
1650286400485,MATH 109,B02,083216,Anzaldo; Leesa B,0,3,30,30
1650286406516,MATH 142A,A01,083219,Chow; Bennett,0,12,30,30
1650286406516,MATH 142A,A02,083220,Chow; Bennett,0,11,30,30
1650286406516,MATH 142A,B01,083221,Chow; Bennett,0,11,30,30
1650286406516,MATH 142A,B02,083222,Chow; Bennett,0,12,30,30
1650286412550,MATH 193A,A01,083224,Staff,0,5,30,30
1650286412550,MATH 193A,A02,083225,Staff,0,5,30,30
1650286412550,MATH 193A,A03,083781,Staff,0,2,30,30
1650286412550,MATH 193A,A04,083782,Staff,0,1,30,30
1650286418579,MATH 197,001,091859,McAuley; Julian John,9998,0,9999,1
1650286424644,COGS 9,A01,083615,Staff,0,14,60,60
1650286430671,COGS 11,A01,083617,Boyle; Mary E. T.,24,0,40,16
1650286436701,COGS 13,A01,083071,Staff,0,31,40,40
1650286442725,COGS 14A,A01,092681,Staff,0,15,100,100
1650286448752,COGS 14B,A01,083073,Cheng; Tzu-Han,0,9,50,50
1650286454781,COGS 17,A01,092677,Staff,29,0,75,46
1650286460805,COGS 100,A01,083619,Staff,0,23,60,60
1650286466858,COGS 101A,A01,083621,Davis; Joshua Daniel,0,21,60,60
1650286472888,COGS 101B,A01,091572,Staff,4,0,60,56
1650286478916,COGS 101C,A01,083625,Delgado; Tania,19,0,30,11
1650286484941,COGS 107A,A01,083627,Boyle; Mary E. T.,0,8,60,60
1650286490967,COGS 118A,A01,083075,Staff,13,0,60,47
1650286496992,CSE 3,A50,083646,Miranda; Gregory Joseph,21,0,38,17
1650286496992,CSE 3,A51,083647,Miranda; Gregory Joseph,37,0,37,0
1650286503018,CSE 8A,A50,083650,Miranda; Gregory Joseph,0,22,40,40
1650286509045,CSE 11,A01,083080,Cao; Yingjun,0,74,40,40
1650286515074,CSE 12,A01,083652,Staff,0,10,100,100
1650286521099,CSE 15L,A01,083654,Staff,0,1,50,50
1650286521099,CSE 15L,A02,083655,Staff,4,0,50,46
1650286527125,CSE 20,A01,083657,Staff,53,0,80,27
1650286533151,CSE 30,A01,083084,Eldon; John,0,74,40,40
1650286539179,CSE 100,A01,083659,Cao; Yingjun,0,65,50,50
1650286545211,CSE 134B,A01,083661,Powell; Thomas Allan,0,28,65,65
1650286551237,CSE 140,A01,083663,Staff,0,0,75,75
1650286557269,CSE 140L,A01,083088,Eldon; John,0,6,75,75
1650286563296,CSE 175,A01,083665,Kumar; Rakesh,8,0,25,17
1650286569323,CSE 190,A00,092507,Dubnov; Shlomo,14,0,20,6
1650286575348,ECE 45,A01,083139,Staff,0,15,40,40
1650286581377,ECE 65,A50,083695,Staff,0,4,30,30
1650286587401,ECE 109,A01,091882,Touri; Behrouz,43,0,70,27
1650286593434,ECE 180,A00,083140,Abi Samra; Nicholas Camill,24,0,30,6
1650286593434,ECE 180,B00,083141,Abi Samra; Nicholas Camill,7,0,30,23
1650286599458,MATH 10A,A01,083735,Patchell; Gregory David,11,0,30,19
1650286599458,MATH 10A,A02,083736,Patchell; Gregory David,28,0,30,2
1650286599458,MATH 10A,A03,083737,Patchell; Gregory David,26,0,30,4
1650286605486,MATH 10B,A01,083207,Staff,0,6,30,30
1650286605486,MATH 10B,A02,083208,Staff,0,6,30,30
1650286605486,MATH 10B,B01,083739,Staff,17,0,30,13
1650286605486,MATH 10B,B02,083740,Staff,29,0,30,1
1650286611512,MATH 18,A01,083743,Staff,7,0,30,23
1650286611512,MATH 18,A02,083744,Staff,27,0,30,3
1650286611512,MATH 18,A03,083745,Staff,23,0,30,7
1650286611512,MATH 18,A04,083746,Staff,27,0,30,3
1650286611512,MATH 18,B01,083748,Staff,0,11,30,30
1650286611512,MATH 18,B02,083749,Staff,0,9,30,30
1650286611512,MATH 18,B03,083750,Staff,1,8,30,29
1650286611512,MATH 18,B04,083751,Staff,0,9,30,30
1650286617537,MATH 20A,A01,083754,Staff,26,0,40,14
1650286623568,MATH 20B,A01,083756,Staff,0,5,30,30
1650286623568,MATH 20B,A02,083757,Staff,0,7,30,30
1650286629595,MATH 20C,A01,083760,Staff,0,13,30,30
1650286629595,MATH 20C,A02,083761,Staff,0,13,30,30
1650286629595,MATH 20C,B01,083762,Staff,14,0,30,16
1650286629595,MATH 20C,B02,083763,Staff,28,0,30,2
1650286635619,MATH 20D,A01,083765,Staff,0,1,30,30
1650286635619,MATH 20D,A02,083766,Staff,8,0,30,22
1650286635619,MATH 20D,A03,083767,Staff,28,0,30,2
1650286641642,MATH 20E,A01,083771,Staff,6,0,30,24
1650286641642,MATH 20E,A02,083772,Staff,20,0,30,10
1650286641642,MATH 20E,B01,083773,Staff,0,0,30,30
1650286641642,MATH 20E,B02,083774,Staff,11,0,30,19
1650286647669,MATH 103A,A01,083777,Staff,0,10,30,30
1650286647669,MATH 103A,A02,083778,Staff,0,10,30,30
1650286647669,MATH 103A,B01,083779,Staff,0,10,30,30
1650286647669,MATH 103A,B02,083780,Staff,0,10,30,30
1650286653695,MATH 105,A01,085443,Staff,0,17,30,30
1650286659722,MATH 109,A01,083213,Anzaldo; Leesa B,0,5,30,30
1650286659722,MATH 109,A02,083214,Anzaldo; Leesa B,0,6,30,30
1650286659722,MATH 109,B01,083215,Anzaldo; Leesa B,0,4,30,30
1650286659722,MATH 109,B02,083216,Anzaldo; Leesa B,0,3,30,30
1650286665750,MATH 142A,A01,083219,Chow; Bennett,0,12,30,30
1650286665750,MATH 142A,A02,083220,Chow; Bennett,0,11,30,30
1650286665750,MATH 142A,B01,083221,Chow; Bennett,0,11,30,30
1650286665750,MATH 142A,B02,083222,Chow; Bennett,0,12,30,30
1650286671775,MATH 193A,A01,083224,Staff,0,5,30,30
1650286671775,MATH 193A,A02,083225,Staff,0,5,30,30
1650286671775,MATH 193A,A03,083781,Staff,0,2,30,30
1650286671775,MATH 193A,A04,083782,Staff,0,1,30,30
1650286677800,MATH 197,001,091859,McAuley; Julian John,9998,0,9999,1
1650286683861,COGS 9,A01,083615,Staff,0,14,60,60
1650286689890,COGS 11,A01,083617,Boyle; Mary E. T.,24,0,40,16
1650286695916,COGS 13,A01,083071,Staff,0,31,40,40
1650286701946,COGS 14A,A01,092681,Staff,0,15,100,100
1650286707980,COGS 14B,A01,083073,Cheng; Tzu-Han,0,9,50,50
1650286714004,COGS 17,A01,092677,Staff,29,0,75,46
1650286720030,COGS 100,A01,083619,Staff,0,23,60,60
1650286726057,COGS 101A,A01,083621,Davis; Joshua Daniel,0,21,60,60
1650286732084,COGS 101B,A01,091572,Staff,4,0,60,56
1650286738109,COGS 101C,A01,083625,Delgado; Tania,19,0,30,11
1650286744136,COGS 107A,A01,083627,Boyle; Mary E. T.,0,8,60,60
1650286750160,COGS 118A,A01,083075,Staff,13,0,60,47
1650286756185,CSE 3,A50,083646,Miranda; Gregory Joseph,21,0,38,17
1650286756185,CSE 3,A51,083647,Miranda; Gregory Joseph,37,0,37,0
1650286762212,CSE 8A,A50,083650,Miranda; Gregory Joseph,0,22,40,40
1650286768245,CSE 11,A01,083080,Cao; Yingjun,0,74,40,40
1650286774269,CSE 12,A01,083652,Staff,0,10,100,100
1650286780296,CSE 15L,A01,083654,Staff,0,1,50,50
1650286780296,CSE 15L,A02,083655,Staff,4,0,50,46
1650286786327,CSE 20,A01,083657,Staff,53,0,80,27
1650286792352,CSE 30,A01,083084,Eldon; John,0,74,40,40
1650286798380,CSE 100,A01,083659,Cao; Yingjun,0,65,50,50
1650286804405,CSE 134B,A01,083661,Powell; Thomas Allan,0,28,65,65
1650286810433,CSE 140,A01,083663,Staff,0,0,75,75
1650286816459,CSE 140L,A01,083088,Eldon; John,0,6,75,75
1650286822487,CSE 175,A01,083665,Kumar; Rakesh,8,0,25,17
1650286828528,CSE 190,A00,092507,Dubnov; Shlomo,14,0,20,6
1650286834559,ECE 45,A01,083139,Staff,0,15,40,40
1650286840587,ECE 65,A50,083695,Staff,0,4,30,30
1650286846627,ECE 109,A01,091882,Touri; Behrouz,43,0,70,27
1650286852655,ECE 180,A00,083140,Abi Samra; Nicholas Camill,24,0,30,6
1650286852655,ECE 180,B00,083141,Abi Samra; Nicholas Camill,7,0,30,23
1650286858684,MATH 10A,A01,083735,Patchell; Gregory David,11,0,30,19
1650286858684,MATH 10A,A02,083736,Patchell; Gregory David,28,0,30,2
1650286858684,MATH 10A,A03,083737,Patchell; Gregory David,26,0,30,4
1650286864710,MATH 10B,A01,083207,Staff,0,6,30,30
1650286864710,MATH 10B,A02,083208,Staff,0,6,30,30
1650286864710,MATH 10B,B01,083739,Staff,17,0,30,13
1650286864710,MATH 10B,B02,083740,Staff,29,0,30,1
1650286870744,MATH 18,A01,083743,Staff,7,0,30,23
1650286870744,MATH 18,A02,083744,Staff,27,0,30,3
1650286870744,MATH 18,A03,083745,Staff,23,0,30,7
1650286870744,MATH 18,A04,083746,Staff,27,0,30,3
1650286870744,MATH 18,B01,083748,Staff,0,11,30,30
1650286870744,MATH 18,B02,083749,Staff,0,9,30,30
1650286870744,MATH 18,B03,083750,Staff,1,8,30,29
1650286870744,MATH 18,B04,083751,Staff,0,9,30,30
1650286876772,MATH 20A,A01,083754,Staff,26,0,40,14
1650286882800,MATH 20B,A01,083756,Staff,0,5,30,30
1650286882800,MATH 20B,A02,083757,Staff,0,7,30,30
1650286888832,MATH 20C,A01,083760,Staff,0,13,30,30
1650286888832,MATH 20C,A02,083761,Staff,0,13,30,30
1650286888832,MATH 20C,B01,083762,Staff,14,0,30,16
1650286888832,MATH 20C,B02,083763,Staff,28,0,30,2
1650286894861,MATH 20D,A01,083765,Staff,0,1,30,30
1650286894861,MATH 20D,A02,083766,Staff,8,0,30,22
1650286894861,MATH 20D,A03,083767,Staff,28,0,30,2
1650286900889,MATH 20E,A01,083771,Staff,6,0,30,24
1650286900889,MATH 20E,A02,083772,Staff,20,0,30,10
1650286900889,MATH 20E,B01,083773,Staff,0,0,30,30
1650286900889,MATH 20E,B02,083774,Staff,11,0,30,19
1650286906918,MATH 103A,A01,083777,Staff,0,10,30,30
1650286906918,MATH 103A,A02,083778,Staff,0,10,30,30
1650286906918,MATH 103A,B01,083779,Staff,0,10,30,30
1650286906918,MATH 103A,B02,083780,Staff,0,10,30,30
1650286913042,MATH 105,A01,085443,Staff,0,17,30,30
1650286919079,MATH 109,A01,083213,Anzaldo; Leesa B,0,5,30,30
1650286919079,MATH 109,A02,083214,Anzaldo; Leesa B,0,6,30,30
1650286919079,MATH 109,B01,083215,Anzaldo; Leesa B,0,4,30,30
1650286919079,MATH 109,B02,083216,Anzaldo; Leesa B,0,3,30,30
1650286925128,MATH 142A,A01,083219,Chow; Bennett,0,12,30,30
1650286925128,MATH 142A,A02,083220,Chow; Bennett,0,11,30,30
1650286925128,MATH 142A,B01,083221,Chow; Bennett,0,11,30,30
1650286925128,MATH 142A,B02,083222,Chow; Bennett,0,12,30,30
1650286931155,MATH 193A,A01,083224,Staff,0,5,30,30
1650286931155,MATH 193A,A02,083225,Staff,0,5,30,30
1650286931155,MATH 193A,A03,083781,Staff,0,2,30,30
1650286931155,MATH 193A,A04,083782,Staff,0,1,30,30
1650286937182,MATH 197,001,091859,McAuley; Julian John,9998,0,9999,1
1650286943250,COGS 9,A01,083615,Staff,0,14,60,60
1650286949274,COGS 11,A01,083617,Boyle; Mary E. T.,24,0,40,16
1650286955302,COGS 13,A01,083071,Staff,0,31,40,40
1650286961335,COGS 14A,A01,092681,Staff,0,15,100,100
1650286967361,COGS 14B,A01,083073,Cheng; Tzu-Han,0,9,50,50
1650286973390,COGS 17,A01,092677,Staff,29,0,75,46
1650286979415,COGS 100,A01,083619,Staff,0,23,60,60
1650286985443,COGS 101A,A01,083621,Davis; Joshua Daniel,0,21,60,60
1650286991469,COGS 101B,A01,091572,Staff,4,0,60,56
1650286997496,COGS 101C,A01,083625,Delgado; Tania,19,0,30,11
1650287003523,COGS 107A,A01,083627,Boyle; Mary E. T.,0,8,60,60
1650287009552,COGS 118A,A01,083075,Staff,13,0,60,47
1650287015582,CSE 3,A50,083646,Miranda; Gregory Joseph,21,0,38,17
1650287015582,CSE 3,A51,083647,Miranda; Gregory Joseph,37,0,37,0
1650287021616,CSE 8A,A50,083650,Miranda; Gregory Joseph,0,22,40,40
1650287027653,CSE 11,A01,083080,Cao; Yingjun,0,74,40,40
1650287033680,CSE 12,A01,083652,Staff,0,10,100,100
1650287039708,CSE 15L,A01,083654,Staff,0,1,50,50
1650287039708,CSE 15L,A02,083655,Staff,4,0,50,46
1650287045739,CSE 20,A01,083657,Staff,53,0,80,27
1650287051767,CSE 30,A01,083084,Eldon; John,0,74,40,40
1650287057793,CSE 100,A01,083659,Cao; Yingjun,0,65,50,50
1650287063821,CSE 134B,A01,083661,Powell; Thomas Allan,0,28,65,65
1650287069846,CSE 140,A01,083663,Staff,0,0,75,75
1650287075876,CSE 140L,A01,083088,Eldon; John,0,6,75,75
1650287081901,CSE 175,A01,083665,Kumar; Rakesh,8,0,25,17
1650287087932,CSE 190,A00,092507,Dubnov; Shlomo,14,0,20,6
1650287093997,ECE 45,A01,083139,Staff,0,15,40,40
1650287100036,ECE 65,A50,083695,Staff,0,4,30,30
1650287106063,ECE 109,A01,091882,Touri; Behrouz,43,0,70,27
1650287112089,ECE 180,A00,083140,Abi Samra; Nicholas Camill,24,0,30,6
1650287112089,ECE 180,B00,083141,Abi Samra; Nicholas Camill,7,0,30,23
1650287118122,MATH 10A,A01,083735,Patchell; Gregory David,11,0,30,19
1650287118122,MATH 10A,A02,083736,Patchell; Gregory David,28,0,30,2
1650287118122,MATH 10A,A03,083737,Patchell; Gregory David,26,0,30,4
1650287124156,MATH 10B,A01,083207,Staff,0,6,30,30
1650287124156,MATH 10B,A02,083208,Staff,0,6,30,30
1650287124156,MATH 10B,B01,083739,Staff,17,0,30,13
1650287124156,MATH 10B,B02,083740,Staff,29,0,30,1
1650287130184,MATH 18,A01,083743,Staff,7,0,30,23
1650287130184,MATH 18,A02,083744,Staff,27,0,30,3
1650287130184,MATH 18,A03,083745,Staff,23,0,30,7
1650287130184,MATH 18,A04,083746,Staff,27,0,30,3
1650287130184,MATH 18,B01,083748,Staff,0,11,30,30
1650287130184,MATH 18,B02,083749,Staff,0,9,30,30
1650287130184,MATH 18,B03,083750,Staff,1,8,30,29
1650287130184,MATH 18,B04,083751,Staff,0,9,30,30
1650287136211,MATH 20A,A01,083754,Staff,26,0,40,14
1650287142237,MATH 20B,A01,083756,Staff,0,5,30,30
1650287142237,MATH 20B,A02,083757,Staff,0,7,30,30
1650287148264,MATH 20C,A01,083760,Staff,0,13,30,30
1650287148264,MATH 20C,A02,083761,Staff,0,13,30,30
1650287148264,MATH 20C,B01,083762,Staff,14,0,30,16
1650287148264,MATH 20C,B02,083763,Staff,28,0,30,2
1650287154292,MATH 20D,A01,083765,Staff,0,1,30,30
1650287154292,MATH 20D,A02,083766,Staff,8,0,30,22
1650287154292,MATH 20D,A03,083767,Staff,28,0,30,2
1650287160321,MATH 20E,A01,083771,Staff,6,0,30,24
1650287160321,MATH 20E,A02,083772,Staff,20,0,30,10
1650287160321,MATH 20E,B01,083773,Staff,0,0,30,30
1650287160321,MATH 20E,B02,083774,Staff,11,0,30,19
1650287166347,MATH 103A,A01,083777,Staff,0,10,30,30
1650287166347,MATH 103A,A02,083778,Staff,0,10,30,30
1650287166347,MATH 103A,B01,083779,Staff,0,10,30,30
1650287166347,MATH 103A,B02,083780,Staff,0,10,30,30
1650287172375,MATH 105,A01,085443,Staff,0,17,30,30
1650287178400,MATH 109,A01,083213,Anzaldo; Leesa B,0,5,30,30
1650287178400,MATH 109,A02,083214,Anzaldo; Leesa B,0,6,30,30
1650287178400,MATH 109,B01,083215,Anzaldo; Leesa B,0,4,30,30
1650287178400,MATH 109,B02,083216,Anzaldo; Leesa B,0,3,30,30
1650287184431,MATH 142A,A01,083219,Chow; Bennett,0,12,30,30
1650287184431,MATH 142A,A02,083220,Chow; Bennett,0,11,30,30
1650287184431,MATH 142A,B01,083221,Chow; Bennett,0,11,30,30
1650287184431,MATH 142A,B02,083222,Chow; Bennett,0,12,30,30
1650287190457,MATH 193A,A01,083224,Staff,0,5,30,30
1650287190457,MATH 193A,A02,083225,Staff,0,5,30,30
1650287190457,MATH 193A,A03,083781,Staff,0,2,30,30
1650287190457,MATH 193A,A04,083782,Staff,0,1,30,30
1650287196483,MATH 197,001,091859,McAuley; Julian John,9998,0,9999,1
1650287202538,COGS 9,A01,083615,Staff,0,14,60,60
1650287208566,COGS 11,A01,083617,Boyle; Mary E. T.,24,0,40,16
1650287214597,COGS 13,A01,083071,Staff,0,31,40,40
1650287220634,COGS 14A,A01,092681,Staff,0,15,100,100
1650287226661,COGS 14B,A01,083073,Cheng; Tzu-Han,0,9,50,50
1650287232687,COGS 17,A01,092677,Staff,29,0,75,46
1650287238713,COGS 100,A01,083619,Staff,0,23,60,60
1650287244738,COGS 101A,A01,083621,Davis; Joshua Daniel,0,21,60,60
1650287250764,COGS 101B,A01,091572,Staff,4,0,60,56
1650287256794,COGS 101C,A01,083625,Delgado; Tania,19,0,30,11
1650287262824,COGS 107A,A01,083627,Boyle; Mary E. T.,0,8,60,60
1650287268848,COGS 118A,A01,083075,Staff,13,0,60,47
1650287274876,CSE 3,A50,083646,Miranda; Gregory Joseph,21,0,38,17
1650287274876,CSE 3,A51,083647,Miranda; Gregory Joseph,37,0,37,0
1650287280904,CSE 8A,A50,083650,Miranda; Gregory Joseph,0,22,40,40
1650287286929,CSE 11,A01,083080,Cao; Yingjun,0,74,40,40
1650287292961,CSE 12,A01,083652,Staff,0,10,100,100
1650287298988,CSE 15L,A01,083654,Staff,0,1,50,50
1650287298988,CSE 15L,A02,083655,Staff,4,0,50,46
1650287305012,CSE 20,A01,083657,Staff,53,0,80,27
1650287311039,CSE 30,A01,083084,Eldon; John,0,74,40,40
1650287317068,CSE 100,A01,083659,Cao; Yingjun,0,65,50,50
1650287323095,CSE 134B,A01,083661,Powell; Thomas Allan,0,28,65,65
1650287329120,CSE 140,A01,083663,Staff,0,0,75,75
1650287335144,CSE 140L,A01,083088,Eldon; John,0,6,75,75
1650287341171,CSE 175,A01,083665,Kumar; Rakesh,8,0,25,17
1650287347201,CSE 190,A00,092507,Dubnov; Shlomo,14,0,20,6
1650287353226,ECE 45,A01,083139,Staff,0,15,40,40
1650287359254,ECE 65,A50,083695,Staff,0,4,30,30
1650287365281,ECE 109,A01,091882,Touri; Behrouz,43,0,70,27
1650287371309,ECE 180,A00,083140,Abi Samra; Nicholas Camill,24,0,30,6
1650287371309,ECE 180,B00,083141,Abi Samra; Nicholas Camill,7,0,30,23
1650287377336,MATH 10A,A01,083735,Patchell; Gregory David,11,0,30,19
1650287377336,MATH 10A,A02,083736,Patchell; Gregory David,28,0,30,2
1650287377336,MATH 10A,A03,083737,Patchell; Gregory David,26,0,30,4
1650287383366,MATH 10B,A01,083207,Staff,0,6,30,30
1650287383366,MATH 10B,A02,083208,Staff,0,6,30,30
1650287383366,MATH 10B,B01,083739,Staff,17,0,30,13
1650287383366,MATH 10B,B02,083740,Staff,29,0,30,1
1650287389395,MATH 18,A01,083743,Staff,7,0,30,23
1650287389395,MATH 18,A02,083744,Staff,27,0,30,3
1650287389395,MATH 18,A03,083745,Staff,23,0,30,7
1650287389395,MATH 18,A04,083746,Staff,27,0,30,3
1650287389395,MATH 18,B01,083748,Staff,0,11,30,30
1650287389395,MATH 18,B02,083749,Staff,0,9,30,30
1650287389395,MATH 18,B03,083750,Staff,1,8,30,29
1650287389395,MATH 18,B04,083751,Staff,0,9,30,30
1650287395424,MATH 20A,A01,083754,Staff,26,0,40,14
1650287401449,MATH 20B,A01,083756,Staff,0,5,30,30
1650287401449,MATH 20B,A02,083757,Staff,0,7,30,30
1650287407480,MATH 20C,A01,083760,Staff,0,13,30,30
1650287407480,MATH 20C,A02,083761,Staff,0,13,30,30
1650287407480,MATH 20C,B01,083762,Staff,14,0,30,16
1650287407480,MATH 20C,B02,083763,Staff,28,0,30,2
1650287413509,MATH 20D,A01,083765,Staff,0,1,30,30
1650287413509,MATH 20D,A02,083766,Staff,8,0,30,22
1650287413509,MATH 20D,A03,083767,Staff,28,0,30,2
1650287419537,MATH 20E,A01,083771,Staff,6,0,30,24
1650287419537,MATH 20E,A02,083772,Staff,20,0,30,10
1650287419537,MATH 20E,B01,083773,Staff,0,0,30,30
1650287419537,MATH 20E,B02,083774,Staff,11,0,30,19
1650287425570,MATH 103A,A01,083777,Staff,0,10,30,30
1650287425570,MATH 103A,A02,083778,Staff,0,10,30,30
1650287425570,MATH 103A,B01,083779,Staff,0,10,30,30
1650287425570,MATH 103A,B02,083780,Staff,0,10,30,30
1650287431602,MATH 105,A01,085443,Staff,0,17,30,30
1650287437628,MATH 109,A01,083213,Anzaldo; Leesa B,0,5,30,30
1650287437628,MATH 109,A02,083214,Anzaldo; Leesa B,0,6,30,30
1650287437628,MATH 109,B01,083215,Anzaldo; Leesa B,0,4,30,30
1650287437628,MATH 109,B02,083216,Anzaldo; Leesa B,0,3,30,30
1650287443663,MATH 142A,A01,083219,Chow; Bennett,0,12,30,30
1650287443663,MATH 142A,A02,083220,Chow; Bennett,0,11,30,30
1650287443663,MATH 142A,B01,083221,Chow; Bennett,0,11,30,30
1650287443663,MATH 142A,B02,083222,Chow; Bennett,0,12,30,30
1650287449711,MATH 193A,A01,083224,Staff,0,5,30,30
1650287449711,MATH 193A,A02,083225,Staff,0,5,30,30
1650287449711,MATH 193A,A03,083781,Staff,0,2,30,30
1650287449711,MATH 193A,A04,083782,Staff,0,1,30,30
1650287455738,MATH 197,001,091859,McAuley; Julian John,9998,0,9999,1
1650287461822,COGS 9,A01,083615,Staff,0,14,60,60
1650287467848,COGS 11,A01,083617,Boyle; Mary E. T.,24,0,40,16
1650287473879,COGS 13,A01,083071,Staff,0,31,40,40
1650287479905,COGS 14A,A01,092681,Staff,0,15,100,100
1650287485943,COGS 14B,A01,083073,Cheng; Tzu-Han,0,9,50,50
1650287491969,COGS 17,A01,092677,Staff,29,0,75,46
1650287498000,COGS 100,A01,083619,Staff,0,23,60,60
1650287504115,COGS 101A,A01,083621,Davis; Joshua Daniel,0,21,60,60
1650287510140,COGS 101B,A01,091572,Staff,4,0,60,56
1650287516165,COGS 101C,A01,083625,Delgado; Tania,19,0,30,11
1650287522197,COGS 107A,A01,083627,Boyle; Mary E. T.,0,8,60,60
1650287528227,COGS 118A,A01,083075,Staff,13,0,60,47
1650287534258,CSE 3,A50,083646,Miranda; Gregory Joseph,21,0,38,17
1650287534258,CSE 3,A51,083647,Miranda; Gregory Joseph,37,0,37,0
1650287540284,CSE 8A,A50,083650,Miranda; Gregory Joseph,0,22,40,40
1650287546309,CSE 11,A01,083080,Cao; Yingjun,0,74,40,40
1650287552335,CSE 12,A01,083652,Staff,0,10,100,100
1650287558361,CSE 15L,A01,083654,Staff,0,1,50,50
1650287558361,CSE 15L,A02,083655,Staff,4,0,50,46
1650287564393,CSE 20,A01,083657,Staff,53,0,80,27
1650287570428,CSE 30,A01,083084,Eldon; John,0,74,40,40
1650287576452,CSE 100,A01,083659,Cao; Yingjun,0,65,50,50
1650287582478,CSE 134B,A01,083661,Powell; Thomas Allan,0,28,65,65
1650287588503,CSE 140,A01,083663,Staff,0,0,75,75
1650287594532,CSE 140L,A01,083088,Eldon; John,0,6,75,75
1650287600562,CSE 175,A01,083665,Kumar; Rakesh,8,0,25,17
1650287606590,CSE 190,A00,092507,Dubnov; Shlomo,14,0,20,6
1650287612620,ECE 45,A01,083139,Staff,0,15,40,40
1650287618648,ECE 65,A50,083695,Staff,0,4,30,30
1650287624674,ECE 109,A01,091882,Touri; Behrouz,43,0,70,27
1650287630701,ECE 180,A00,083140,Abi Samra; Nicholas Camill,24,0,30,6
1650287630701,ECE 180,B00,083141,Abi Samra; Nicholas Camill,7,0,30,23
1650287636731,MATH 10A,A01,083735,Patchell; Gregory David,11,0,30,19
1650287636731,MATH 10A,A02,083736,Patchell; Gregory David,28,0,30,2
1650287636731,MATH 10A,A03,083737,Patchell; Gregory David,26,0,30,4
1650287642756,MATH 10B,A01,083207,Staff,0,6,30,30
1650287642756,MATH 10B,A02,083208,Staff,0,6,30,30
1650287642756,MATH 10B,B01,083739,Staff,17,0,30,13
1650287642756,MATH 10B,B02,083740,Staff,29,0,30,1
1650287648787,MATH 18,A01,083743,Staff,7,0,30,23
1650287648787,MATH 18,A02,083744,Staff,27,0,30,3
1650287648787,MATH 18,A03,083745,Staff,23,0,30,7
1650287648787,MATH 18,A04,083746,Staff,27,0,30,3
1650287648787,MATH 18,B01,083748,Staff,0,11,30,30
1650287648787,MATH 18,B02,083749,Staff,0,9,30,30
1650287648787,MATH 18,B03,083750,Staff,1,8,30,29
1650287648787,MATH 18,B04,083751,Staff,0,9,30,30
1650287654813,MATH 20A,A01,083754,Staff,26,0,40,14
1650287660838,MATH 20B,A01,083756,Staff,0,5,30,30
1650287660838,MATH 20B,A02,083757,Staff,0,7,30,30
1650287666864,MATH 20C,A01,083760,Staff,0,13,30,30
1650287666864,MATH 20C,A02,083761,Staff,0,13,30,30
1650287666864,MATH 20C,B01,083762,Staff,14,0,30,16
1650287666864,MATH 20C,B02,083763,Staff,28,0,30,2
1650287672892,MATH 20D,A01,083765,Staff,0,1,30,30
1650287672892,MATH 20D,A02,083766,Staff,8,0,30,22
1650287672892,MATH 20D,A03,083767,Staff,28,0,30,2
1650287678915,MATH 20E,A01,083771,Staff,6,0,30,24
1650287678915,MATH 20E,A02,083772,Staff,20,0,30,10
1650287678915,MATH 20E,B01,083773,Staff,0,0,30,30
1650287678915,MATH 20E,B02,083774,Staff,11,0,30,19
1650287684942,MATH 103A,A01,083777,Staff,0,10,30,30
1650287684942,MATH 103A,A02,083778,Staff,0,10,30,30
1650287684942,MATH 103A,B01,083779,Staff,0,10,30,30
1650287684942,MATH 103A,B02,083780,Staff,0,10,30,30
1650287690969,MATH 105,A01,085443,Staff,0,17,30,30
1650287696998,MATH 109,A01,083213,Anzaldo; Leesa B,0,5,30,30
1650287696998,MATH 109,A02,083214,Anzaldo; Leesa B,0,6,30,30
1650287696998,MATH 109,B01,083215,Anzaldo; Leesa B,0,4,30,30
1650287696998,MATH 109,B02,083216,Anzaldo; Leesa B,0,3,30,30
1650287703026,MATH 142A,A01,083219,Chow; Bennett,0,12,30,30
1650287703026,MATH 142A,A02,083220,Chow; Bennett,0,11,30,30
1650287703026,MATH 142A,B01,083221,Chow; Bennett,0,11,30,30
1650287703026,MATH 142A,B02,083222,Chow; Bennett,0,12,30,30
1650287709050,MATH 193A,A01,083224,Staff,0,5,30,30
1650287709050,MATH 193A,A02,083225,Staff,0,5,30,30
1650287709050,MATH 193A,A03,083781,Staff,0,2,30,30
1650287709050,MATH 193A,A04,083782,Staff,0,1,30,30
1650287715076,MATH 197,001,091859,McAuley; Julian John,9998,0,9999,1
1650287721132,COGS 9,A01,083615,Staff,0,14,60,60
1650287727159,COGS 11,A01,083617,Boyle; Mary E. T.,24,0,40,16
1650287733185,COGS 13,A01,083071,Staff,0,31,40,40
1650287739214,COGS 14A,A01,092681,Staff,0,15,100,100
1650287745238,COGS 14B,A01,083073,Cheng; Tzu-Han,0,9,50,50
1650287751264,COGS 17,A01,092677,Staff,29,0,75,46
1650287757291,COGS 100,A01,083619,Staff,0,23,60,60
1650287763323,COGS 101A,A01,083621,Davis; Joshua Daniel,0,21,60,60
1650287769350,COGS 101B,A01,091572,Staff,4,0,60,56
1650287775385,COGS 101C,A01,083625,Delgado; Tania,19,0,30,11
1650287781412,COGS 107A,A01,083627,Boyle; Mary E. T.,0,8,60,60
1650287787440,COGS 118A,A01,083075,Staff,13,0,60,47
1650287793471,CSE 3,A50,083646,Miranda; Gregory Joseph,21,0,38,17
1650287793471,CSE 3,A51,083647,Miranda; Gregory Joseph,37,0,37,0
1650287799502,CSE 8A,A50,083650,Miranda; Gregory Joseph,0,22,40,40
1650287805526,CSE 11,A01,083080,Cao; Yingjun,0,74,40,40
1650287811550,CSE 12,A01,083652,Staff,0,10,100,100
1650287817576,CSE 15L,A01,083654,Staff,0,1,50,50
1650287817576,CSE 15L,A02,083655,Staff,4,0,50,46
1650287823605,CSE 20,A01,083657,Staff,53,0,80,27
1650287829633,CSE 30,A01,083084,Eldon; John,0,74,40,40
1650287835660,CSE 100,A01,083659,Cao; Yingjun,0,65,50,50
1650287841689,CSE 134B,A01,083661,Powell; Thomas Allan,0,28,65,65
1650287847715,CSE 140,A01,083663,Staff,0,0,75,75
1650287853747,CSE 140L,A01,083088,Eldon; John,0,6,75,75
1650287859775,CSE 175,A01,083665,Kumar; Rakesh,8,0,25,17
1650287865812,CSE 190,A00,092507,Dubnov; Shlomo,14,0,20,6
1650287871838,ECE 45,A01,083139,Staff,0,15,40,40
1650287877862,ECE 65,A50,083695,Staff,0,4,30,30
1650287883892,ECE 109,A01,091882,Touri; Behrouz,43,0,70,27
1650287889918,ECE 180,A00,083140,Abi Samra; Nicholas Camill,24,0,30,6
1650287889918,ECE 180,B00,083141,Abi Samra; Nicholas Camill,7,0,30,23
1650287895945,MATH 10A,A01,083735,Patchell; Gregory David,11,0,30,19
1650287895945,MATH 10A,A02,083736,Patchell; Gregory David,28,0,30,2
1650287895945,MATH 10A,A03,083737,Patchell; Gregory David,26,0,30,4
1650287901970,MATH 10B,A01,083207,Staff,0,6,30,30
1650287901970,MATH 10B,A02,083208,Staff,0,6,30,30
1650287901970,MATH 10B,B01,083739,Staff,17,0,30,13
1650287901970,MATH 10B,B02,083740,Staff,29,0,30,1
1650287908001,MATH 18,A01,083743,Staff,7,0,30,23
1650287908001,MATH 18,A02,083744,Staff,27,0,30,3
1650287908001,MATH 18,A03,083745,Staff,23,0,30,7
1650287908001,MATH 18,A04,083746,Staff,27,0,30,3
1650287908001,MATH 18,B01,083748,Staff,0,11,30,30
1650287908001,MATH 18,B02,083749,Staff,0,9,30,30
1650287908001,MATH 18,B03,083750,Staff,1,8,30,29
1650287908001,MATH 18,B04,083751,Staff,0,9,30,30
1650287914034,MATH 20A,A01,083754,Staff,26,0,40,14
1650287920061,MATH 20B,A01,083756,Staff,0,5,30,30
1650287920061,MATH 20B,A02,083757,Staff,0,7,30,30
1650287926090,MATH 20C,A01,083760,Staff,0,13,30,30
1650287926090,MATH 20C,A02,083761,Staff,0,13,30,30
1650287926090,MATH 20C,B01,083762,Staff,14,0,30,16
1650287926090,MATH 20C,B02,083763,Staff,28,0,30,2
1650287932115,MATH 20D,A01,083765,Staff,0,1,30,30
1650287932115,MATH 20D,A02,083766,Staff,8,0,30,22
1650287932115,MATH 20D,A03,083767,Staff,28,0,30,2
1650287938142,MATH 20E,A01,083771,Staff,6,0,30,24
1650287938142,MATH 20E,A02,083772,Staff,20,0,30,10
1650287938142,MATH 20E,B01,083773,Staff,0,0,30,30
1650287938142,MATH 20E,B02,083774,Staff,11,0,30,19
1650287944169,MATH 103A,A01,083777,Staff,0,10,30,30
1650287944169,MATH 103A,A02,083778,Staff,0,10,30,30
1650287944169,MATH 103A,B01,083779,Staff,0,10,30,30
1650287944169,MATH 103A,B02,083780,Staff,0,10,30,30
1650287950197,MATH 105,A01,085443,Staff,0,17,30,30
1650287956228,MATH 109,A01,083213,Anzaldo; Leesa B,0,5,30,30
1650287956228,MATH 109,A02,083214,Anzaldo; Leesa B,0,6,30,30
1650287956228,MATH 109,B01,083215,Anzaldo; Leesa B,0,4,30,30
1650287956228,MATH 109,B02,083216,Anzaldo; Leesa B,0,3,30,30
1650287962260,MATH 142A,A01,083219,Chow; Bennett,0,12,30,30
1650287962260,MATH 142A,A02,083220,Chow; Bennett,0,11,30,30
1650287962260,MATH 142A,B01,083221,Chow; Bennett,0,11,30,30
1650287962260,MATH 142A,B02,083222,Chow; Bennett,0,12,30,30
1650287968286,MATH 193A,A01,083224,Staff,0,5,30,30
1650287968286,MATH 193A,A02,083225,Staff,0,5,30,30
1650287968286,MATH 193A,A03,083781,Staff,0,2,30,30
1650287968286,MATH 193A,A04,083782,Staff,0,1,30,30
1650287974311,MATH 197,001,091859,McAuley; Julian John,9998,0,9999,1
1650287980370,COGS 9,A01,083615,Staff,0,14,60,60
1650287986394,COGS 11,A01,083617,Boyle; Mary E. T.,24,0,40,16
1650287992424,COGS 13,A01,083071,Staff,0,31,40,40
1650287998449,COGS 14A,A01,092681,Staff,0,15,100,100
1650288004480,COGS 14B,A01,083073,Cheng; Tzu-Han,0,9,50,50
1650288010517,COGS 17,A01,092677,Staff,29,0,75,46
1650288016546,COGS 100,A01,083619,Staff,0,23,60,60
1650288022570,COGS 101A,A01,083621,Davis; Joshua Daniel,0,21,60,60
1650288028595,COGS 101B,A01,091572,Staff,4,0,60,56
1650288034624,COGS 101C,A01,083625,Delgado; Tania,19,0,30,11
1650288040648,COGS 107A,A01,083627,Boyle; Mary E. T.,0,8,60,60
1650288046681,COGS 118A,A01,083075,Staff,13,0,60,47
1650288052706,CSE 3,A50,083646,Miranda; Gregory Joseph,21,0,38,17
1650288052706,CSE 3,A51,083647,Miranda; Gregory Joseph,37,0,37,0
1650288058735,CSE 8A,A50,083650,Miranda; Gregory Joseph,0,22,40,40
1650288064764,CSE 11,A01,083080,Cao; Yingjun,0,74,40,40
1650288070794,CSE 12,A01,083652,Staff,0,10,100,100
1650288076818,CSE 15L,A01,083654,Staff,0,1,50,50
1650288076818,CSE 15L,A02,083655,Staff,4,0,50,46
1650288082847,CSE 20,A01,083657,Staff,53,0,80,27
1650288088873,CSE 30,A01,083084,Eldon; John,0,74,40,40
1650288094905,CSE 100,A01,083659,Cao; Yingjun,0,65,50,50
1650288101018,CSE 134B,A01,083661,Powell; Thomas Allan,0,28,65,65
1650288107046,CSE 140,A01,083663,Staff,0,0,75,75
1650288113072,CSE 140L,A01,083088,Eldon; John,0,6,75,75
1650288119106,CSE 175,A01,083665,Kumar; Rakesh,8,0,25,17
1650288125134,CSE 190,A00,092507,Dubnov; Shlomo,14,0,20,6
1650288131158,ECE 45,A01,083139,Staff,0,15,40,40
1650288137181,ECE 65,A50,083695,Staff,0,4,30,30
1650288143205,ECE 109,A01,091882,Touri; Behrouz,43,0,70,27
1650288149230,ECE 180,A00,083140,Abi Samra; Nicholas Camill,24,0,30,6
1650288149230,ECE 180,B00,083141,Abi Samra; Nicholas Camill,7,0,30,23
1650288155256,MATH 10A,A01,083735,Patchell; Gregory David,11,0,30,19
1650288155256,MATH 10A,A02,083736,Patchell; Gregory David,28,0,30,2
1650288155256,MATH 10A,A03,083737,Patchell; Gregory David,26,0,30,4
1650288161287,MATH 10B,A01,083207,Staff,0,6,30,30
1650288161287,MATH 10B,A02,083208,Staff,0,6,30,30
1650288161287,MATH 10B,B01,083739,Staff,17,0,30,13
1650288161287,MATH 10B,B02,083740,Staff,29,0,30,1
1650288167313,MATH 18,A01,083743,Staff,7,0,30,23
1650288167313,MATH 18,A02,083744,Staff,27,0,30,3
1650288167313,MATH 18,A03,083745,Staff,23,0,30,7
1650288167313,MATH 18,A04,083746,Staff,27,0,30,3
1650288167313,MATH 18,B01,083748,Staff,0,11,30,30
1650288167313,MATH 18,B02,083749,Staff,0,9,30,30
1650288167313,MATH 18,B03,083750,Staff,1,8,30,29
1650288167313,MATH 18,B04,083751,Staff,0,9,30,30
1650288173338,MATH 20A,A01,083754,Staff,26,0,40,14
1650288179385,MATH 20B,A01,083756,Staff,0,5,30,30
1650288179385,MATH 20B,A02,083757,Staff,0,7,30,30
1650288185414,MATH 20C,A01,083760,Staff,0,13,30,30
1650288185414,MATH 20C,A02,083761,Staff,0,13,30,30
1650288185414,MATH 20C,B01,083762,Staff,14,0,30,16
1650288185414,MATH 20C,B02,083763,Staff,28,0,30,2
1650288191438,MATH 20D,A01,083765,Staff,0,1,30,30
1650288191438,MATH 20D,A02,083766,Staff,8,0,30,22
1650288191438,MATH 20D,A03,083767,Staff,28,0,30,2
1650288197467,MATH 20E,A01,083771,Staff,6,0,30,24
1650288197467,MATH 20E,A02,083772,Staff,20,0,30,10
1650288197467,MATH 20E,B01,083773,Staff,0,0,30,30
1650288197467,MATH 20E,B02,083774,Staff,11,0,30,19
1650288203497,MATH 103A,A01,083777,Staff,0,10,30,30
1650288203497,MATH 103A,A02,083778,Staff,0,10,30,30
1650288203497,MATH 103A,B01,083779,Staff,0,10,30,30
1650288203497,MATH 103A,B02,083780,Staff,0,10,30,30
1650288209525,MATH 105,A01,085443,Staff,0,17,30,30
1650288215548,MATH 109,A01,083213,Anzaldo; Leesa B,0,5,30,30
1650288215548,MATH 109,A02,083214,Anzaldo; Leesa B,0,6,30,30
1650288215548,MATH 109,B01,083215,Anzaldo; Leesa B,0,4,30,30
1650288215548,MATH 109,B02,083216,Anzaldo; Leesa B,0,3,30,30
1650288221576,MATH 142A,A01,083219,Chow; Bennett,0,12,30,30
1650288221576,MATH 142A,A02,083220,Chow; Bennett,0,11,30,30
1650288221576,MATH 142A,B01,083221,Chow; Bennett,0,11,30,30
1650288221576,MATH 142A,B02,083222,Chow; Bennett,0,12,30,30
1650288227605,MATH 193A,A01,083224,Staff,0,5,30,30
1650288227605,MATH 193A,A02,083225,Staff,0,5,30,30
1650288227605,MATH 193A,A03,083781,Staff,0,2,30,30
1650288227605,MATH 193A,A04,083782,Staff,0,1,30,30
1650288233630,MATH 197,001,091859,McAuley; Julian John,9998,0,9999,1
1650288239687,COGS 9,A01,083615,Staff,0,14,60,60
1650288245711,COGS 11,A01,083617,Boyle; Mary E. T.,24,0,40,16
1650288251735,COGS 13,A01,083071,Staff,0,31,40,40
1650288257765,COGS 14A,A01,092681,Staff,0,15,100,100
1650288263792,COGS 14B,A01,083073,Cheng; Tzu-Han,0,9,50,50
1650288269818,COGS 17,A01,092677,Staff,29,0,75,46
1650288275843,COGS 100,A01,083619,Staff,0,23,60,60
1650288281866,COGS 101A,A01,083621,Davis; Joshua Daniel,0,21,60,60
1650288287894,COGS 101B,A01,091572,Staff,4,0,60,56
1650288293919,COGS 101C,A01,083625,Delgado; Tania,19,0,30,11
1650288299945,COGS 107A,A01,083627,Boyle; Mary E. T.,0,8,60,60
1650288305969,COGS 118A,A01,083075,Staff,13,0,60,47
1650288311992,CSE 3,A50,083646,Miranda; Gregory Joseph,21,0,38,17
1650288311992,CSE 3,A51,083647,Miranda; Gregory Joseph,37,0,37,0
1650288318017,CSE 8A,A50,083650,Miranda; Gregory Joseph,0,22,40,40
1650288324046,CSE 11,A01,083080,Cao; Yingjun,0,74,40,40
1650288330071,CSE 12,A01,083652,Staff,0,10,100,100
1650288336099,CSE 15L,A01,083654,Staff,0,1,50,50
1650288336099,CSE 15L,A02,083655,Staff,4,0,50,46
1650288342126,CSE 20,A01,083657,Staff,53,0,80,27
1650288348151,CSE 30,A01,083084,Eldon; John,0,74,40,40
1650288354180,CSE 100,A01,083659,Cao; Yingjun,0,65,50,50
1650288360228,CSE 134B,A01,083661,Powell; Thomas Allan,0,28,65,65
1650288366258,CSE 140,A01,083663,Staff,0,0,75,75
1650288372283,CSE 140L,A01,083088,Eldon; John,0,6,75,75
1650288378307,CSE 175,A01,083665,Kumar; Rakesh,8,0,25,17
1650288384337,CSE 190,A00,092507,Dubnov; Shlomo,14,0,20,6
1650288390363,ECE 45,A01,083139,Staff,0,15,40,40
1650288396389,ECE 65,A50,083695,Staff,0,4,30,30
1650288402421,ECE 109,A01,091882,Touri; Behrouz,43,0,70,27
1650288408445,ECE 180,A00,083140,Abi Samra; Nicholas Camill,24,0,30,6
1650288408445,ECE 180,B00,083141,Abi Samra; Nicholas Camill,7,0,30,23
1650288414470,MATH 10A,A01,083735,Patchell; Gregory David,11,0,30,19
1650288414470,MATH 10A,A02,083736,Patchell; Gregory David,28,0,30,2
1650288414470,MATH 10A,A03,083737,Patchell; Gregory David,26,0,30,4
1650288420496,MATH 10B,A01,083207,Staff,0,6,30,30
1650288420496,MATH 10B,A02,083208,Staff,0,6,30,30
1650288420496,MATH 10B,B01,083739,Staff,17,0,30,13
1650288420496,MATH 10B,B02,083740,Staff,29,0,30,1
1650288426521,MATH 18,A01,083743,Staff,7,0,30,23
1650288426521,MATH 18,A02,083744,Staff,27,0,30,3
1650288426521,MATH 18,A03,083745,Staff,23,0,30,7
1650288426521,MATH 18,A04,083746,Staff,27,0,30,3
1650288426521,MATH 18,B01,083748,Staff,0,11,30,30
1650288426521,MATH 18,B02,083749,Staff,0,9,30,30
1650288426521,MATH 18,B03,083750,Staff,1,8,30,29
1650288426521,MATH 18,B04,083751,Staff,0,9,30,30
1650288432544,MATH 20A,A01,083754,Staff,26,0,40,14
1650288438567,MATH 20B,A01,083756,Staff,0,5,30,30
1650288438567,MATH 20B,A02,083757,Staff,0,7,30,30
1650288444592,MATH 20C,A01,083760,Staff,0,13,30,30
1650288444592,MATH 20C,A02,083761,Staff,0,13,30,30
1650288444592,MATH 20C,B01,083762,Staff,14,0,30,16
1650288444592,MATH 20C,B02,083763,Staff,28,0,30,2
1650288450616,MATH 20D,A01,083765,Staff,0,1,30,30
1650288450616,MATH 20D,A02,083766,Staff,8,0,30,22
1650288450616,MATH 20D,A03,083767,Staff,28,0,30,2
1650288456646,MATH 20E,A01,083771,Staff,6,0,30,24
1650288456646,MATH 20E,A02,083772,Staff,20,0,30,10
1650288456646,MATH 20E,B01,083773,Staff,0,0,30,30
1650288456646,MATH 20E,B02,083774,Staff,11,0,30,19
1650288462684,MATH 103A,A01,083777,Staff,0,10,30,30
1650288462684,MATH 103A,A02,083778,Staff,0,10,30,30
1650288462684,MATH 103A,B01,083779,Staff,0,10,30,30
1650288462684,MATH 103A,B02,083780,Staff,0,10,30,30
1650288468708,MATH 105,A01,085443,Staff,0,17,30,30
1650288474733,MATH 109,A01,083213,Anzaldo; Leesa B,0,5,30,30
1650288474733,MATH 109,A02,083214,Anzaldo; Leesa B,0,6,30,30
1650288474733,MATH 109,B01,083215,Anzaldo; Leesa B,0,4,30,30
1650288474733,MATH 109,B02,083216,Anzaldo; Leesa B,0,3,30,30
1650288480757,MATH 142A,A01,083219,Chow; Bennett,0,12,30,30
1650288480757,MATH 142A,A02,083220,Chow; Bennett,0,11,30,30
1650288480757,MATH 142A,B01,083221,Chow; Bennett,0,11,30,30
1650288480757,MATH 142A,B02,083222,Chow; Bennett,0,12,30,30
1650288486796,MATH 193A,A01,083224,Staff,0,5,30,30
1650288486796,MATH 193A,A02,083225,Staff,0,5,30,30
1650288486796,MATH 193A,A03,083781,Staff,0,2,30,30
1650288486796,MATH 193A,A04,083782,Staff,0,1,30,30
1650288492822,MATH 197,001,091859,McAuley; Julian John,9998,0,9999,1
1650288498887,COGS 9,A01,083615,Staff,0,14,60,60
1650288504912,COGS 11,A01,083617,Boyle; Mary E. T.,24,0,40,16
1650288510938,COGS 13,A01,083071,Staff,0,31,40,40
1650288516963,COGS 14A,A01,092681,Staff,0,15,100,100
1650288522987,COGS 14B,A01,083073,Cheng; Tzu-Han,0,9,50,50
1650288529014,COGS 17,A01,092677,Staff,29,0,75,46
1650288535039,COGS 100,A01,083619,Staff,0,23,60,60
1650288541067,COGS 101A,A01,083621,Davis; Joshua Daniel,0,21,60,60
1650288547098,COGS 101B,A01,091572,Staff,4,0,60,56
1650288553124,COGS 101C,A01,083625,Delgado; Tania,19,0,30,11
1650288559156,COGS 107A,A01,083627,Boyle; Mary E. T.,0,8,60,60
1650288565180,COGS 118A,A01,083075,Staff,13,0,60,47
1650288571204,CSE 3,A50,083646,Miranda; Gregory Joseph,21,0,38,17
1650288571204,CSE 3,A51,083647,Miranda; Gregory Joseph,37,0,37,0
1650288577232,CSE 8A,A50,083650,Miranda; Gregory Joseph,0,22,40,40
1650288583263,CSE 11,A01,083080,Cao; Yingjun,0,74,40,40
1650288589290,CSE 12,A01,083652,Staff,0,10,100,100
1650288595315,CSE 15L,A01,083654,Staff,0,1,50,50
1650288595315,CSE 15L,A02,083655,Staff,4,0,50,46
1650288601351,CSE 20,A01,083657,Staff,53,0,80,27
1650288607381,CSE 30,A01,083084,Eldon; John,0,74,40,40
1650288613408,CSE 100,A01,083659,Cao; Yingjun,0,65,50,50
1650288619435,CSE 134B,A01,083661,Powell; Thomas Allan,0,28,65,65
1650288625459,CSE 140,A01,083663,Staff,0,0,75,75
1650288631487,CSE 140L,A01,083088,Eldon; John,0,6,75,75
1650288637513,CSE 175,A01,083665,Kumar; Rakesh,8,0,25,17
1650288643538,CSE 190,A00,092507,Dubnov; Shlomo,14,0,20,6
1650288649562,ECE 45,A01,083139,Staff,0,15,40,40
1650288655586,ECE 65,A50,083695,Staff,0,4,30,30
1650288661612,ECE 109,A01,091882,Touri; Behrouz,43,0,70,27
1650288667636,ECE 180,A00,083140,Abi Samra; Nicholas Camill,24,0,30,6
1650288667636,ECE 180,B00,083141,Abi Samra; Nicholas Camill,7,0,30,23
1650288673662,MATH 10A,A01,083735,Patchell; Gregory David,11,0,30,19
1650288673662,MATH 10A,A02,083736,Patchell; Gregory David,28,0,30,2
1650288673662,MATH 10A,A03,083737,Patchell; Gregory David,26,0,30,4
1650288679688,MATH 10B,A01,083207,Staff,0,6,30,30
1650288679688,MATH 10B,A02,083208,Staff,0,6,30,30
1650288679688,MATH 10B,B01,083739,Staff,17,0,30,13
1650288679688,MATH 10B,B02,083740,Staff,29,0,30,1
1650288685712,MATH 18,A01,083743,Staff,7,0,30,23
1650288685712,MATH 18,A02,083744,Staff,27,0,30,3
1650288685712,MATH 18,A03,083745,Staff,23,0,30,7
1650288685712,MATH 18,A04,083746,Staff,27,0,30,3
1650288685712,MATH 18,B01,083748,Staff,0,11,30,30
1650288685712,MATH 18,B02,083749,Staff,0,9,30,30
1650288685712,MATH 18,B03,083750,Staff,1,8,30,29
1650288685712,MATH 18,B04,083751,Staff,0,9,30,30
1650288691737,MATH 20A,A01,083754,Staff,26,0,40,14
1650288697840,MATH 20B,A01,083756,Staff,0,5,30,30
1650288697840,MATH 20B,A02,083757,Staff,0,7,30,30
1650288703866,MATH 20C,A01,083760,Staff,0,13,30,30
1650288703866,MATH 20C,A02,083761,Staff,0,13,30,30
1650288703866,MATH 20C,B01,083762,Staff,14,0,30,16
1650288703866,MATH 20C,B02,083763,Staff,28,0,30,2
1650288709891,MATH 20D,A01,083765,Staff,0,1,30,30
1650288709891,MATH 20D,A02,083766,Staff,8,0,30,22
1650288709891,MATH 20D,A03,083767,Staff,28,0,30,2
1650288715920,MATH 20E,A01,083771,Staff,6,0,30,24
1650288715920,MATH 20E,A02,083772,Staff,20,0,30,10
1650288715920,MATH 20E,B01,083773,Staff,0,0,30,30
1650288715920,MATH 20E,B02,083774,Staff,11,0,30,19
1650288721957,MATH 103A,A01,083777,Staff,0,10,30,30
1650288721957,MATH 103A,A02,083778,Staff,0,10,30,30
1650288721957,MATH 103A,B01,083779,Staff,0,10,30,30
1650288721957,MATH 103A,B02,083780,Staff,0,10,30,30
1650288727983,MATH 105,A01,085443,Staff,0,17,30,30
1650288734008,MATH 109,A01,083213,Anzaldo; Leesa B,0,5,30,30
1650288734008,MATH 109,A02,083214,Anzaldo; Leesa B,0,6,30,30
1650288734008,MATH 109,B01,083215,Anzaldo; Leesa B,0,4,30,30
1650288734008,MATH 109,B02,083216,Anzaldo; Leesa B,0,3,30,30
1650288740034,MATH 142A,A01,083219,Chow; Bennett,0,12,30,30
1650288740034,MATH 142A,A02,083220,Chow; Bennett,0,11,30,30
1650288740034,MATH 142A,B01,083221,Chow; Bennett,0,11,30,30
1650288740034,MATH 142A,B02,083222,Chow; Bennett,0,12,30,30
1650288746060,MATH 193A,A01,083224,Staff,0,5,30,30
1650288746060,MATH 193A,A02,083225,Staff,0,5,30,30
1650288746060,MATH 193A,A03,083781,Staff,0,2,30,30
1650288746060,MATH 193A,A04,083782,Staff,0,1,30,30
1650288752085,MATH 197,001,091859,McAuley; Julian John,9998,0,9999,1
1650288758166,COGS 9,A01,083615,Staff,0,14,60,60
1650288764201,COGS 11,A01,083617,Boyle; Mary E. T.,24,0,40,16
1650288770233,COGS 13,A01,083071,Staff,0,31,40,40
1650288776256,COGS 14A,A01,092681,Staff,0,15,100,100
1650288782284,COGS 14B,A01,083073,Cheng; Tzu-Han,0,9,50,50
1650288788321,COGS 17,A01,092677,Staff,29,0,75,46
1650288794346,COGS 100,A01,083619,Staff,0,23,60,60
1650288800375,COGS 101A,A01,083621,Davis; Joshua Daniel,0,21,60,60
1650288806406,COGS 101B,A01,091572,Staff,4,0,60,56
1650288812432,COGS 101C,A01,083625,Delgado; Tania,19,0,30,11
1650288818466,COGS 107A,A01,083627,Boyle; Mary E. T.,0,8,60,60
1650288824495,COGS 118A,A01,083075,Staff,13,0,60,47
1650288830526,CSE 3,A50,083646,Miranda; Gregory Joseph,21,0,38,17
1650288830526,CSE 3,A51,083647,Miranda; Gregory Joseph,37,0,37,0
1650288836552,CSE 8A,A50,083650,Miranda; Gregory Joseph,0,22,40,40
1650288842577,CSE 11,A01,083080,Cao; Yingjun,0,74,40,40
1650288848615,CSE 12,A01,083652,Staff,0,10,100,100
1650288854643,CSE 15L,A01,083654,Staff,0,1,50,50
1650288854643,CSE 15L,A02,083655,Staff,4,0,50,46
1650288860667,CSE 20,A01,083657,Staff,53,0,80,27
1650288866690,CSE 30,A01,083084,Eldon; John,0,74,40,40
1650288872728,CSE 100,A01,083659,Cao; Yingjun,0,65,50,50
1650288878752,CSE 134B,A01,083661,Powell; Thomas Allan,0,28,65,65
1650288884779,CSE 140,A01,083663,Staff,0,0,75,75
1650288890802,CSE 140L,A01,083088,Eldon; John,0,6,75,75
1650288896827,CSE 175,A01,083665,Kumar; Rakesh,8,0,25,17
1650288902851,CSE 190,A00,092507,Dubnov; Shlomo,14,0,20,6
1650288908879,ECE 45,A01,083139,Staff,0,15,40,40
1650288914907,ECE 65,A50,083695,Staff,0,4,30,30
1650288920933,ECE 109,A01,091882,Touri; Behrouz,43,0,70,27
1650288926958,ECE 180,A00,083140,Abi Samra; Nicholas Camill,24,0,30,6
1650288926958,ECE 180,B00,083141,Abi Samra; Nicholas Camill,7,0,30,23
1650288932989,MATH 10A,A01,083735,Patchell; Gregory David,11,0,30,19
1650288932989,MATH 10A,A02,083736,Patchell; Gregory David,28,0,30,2
1650288932989,MATH 10A,A03,083737,Patchell; Gregory David,26,0,30,4
1650288939013,MATH 10B,A01,083207,Staff,0,6,30,30
1650288939013,MATH 10B,A02,083208,Staff,0,6,30,30
1650288939013,MATH 10B,B01,083739,Staff,17,0,30,13
1650288939013,MATH 10B,B02,083740,Staff,29,0,30,1
1650288945043,MATH 18,A01,083743,Staff,7,0,30,23
1650288945043,MATH 18,A02,083744,Staff,27,0,30,3
1650288945043,MATH 18,A03,083745,Staff,23,0,30,7
1650288945043,MATH 18,A04,083746,Staff,27,0,30,3
1650288945043,MATH 18,B01,083748,Staff,0,11,30,30
1650288945043,MATH 18,B02,083749,Staff,0,9,30,30
1650288945043,MATH 18,B03,083750,Staff,1,8,30,29
1650288945043,MATH 18,B04,083751,Staff,0,9,30,30
1650288951070,MATH 20A,A01,083754,Staff,26,0,40,14
1650288957123,MATH 20B,A01,083756,Staff,0,5,30,30
1650288957123,MATH 20B,A02,083757,Staff,0,7,30,30
1650288963159,MATH 20C,A01,083760,Staff,0,13,30,30
1650288963159,MATH 20C,A02,083761,Staff,0,13,30,30
1650288963159,MATH 20C,B01,083762,Staff,14,0,30,16
1650288963159,MATH 20C,B02,083763,Staff,28,0,30,2
1650288969188,MATH 20D,A01,083765,Staff,0,1,30,30
1650288969188,MATH 20D,A02,083766,Staff,8,0,30,22
1650288969188,MATH 20D,A03,083767,Staff,28,0,30,2
1650288975217,MATH 20E,A01,083771,Staff,6,0,30,24
1650288975217,MATH 20E,A02,083772,Staff,20,0,30,10
1650288975217,MATH 20E,B01,083773,Staff,0,0,30,30
1650288975217,MATH 20E,B02,083774,Staff,11,0,30,19
1650288981243,MATH 103A,A01,083777,Staff,0,10,30,30
1650288981243,MATH 103A,A02,083778,Staff,0,10,30,30
1650288981243,MATH 103A,B01,083779,Staff,0,10,30,30
1650288981243,MATH 103A,B02,083780,Staff,0,10,30,30
1650288987268,MATH 105,A01,085443,Staff,0,17,30,30
1650288993300,MATH 109,A01,083213,Anzaldo; Leesa B,0,5,30,30
1650288993300,MATH 109,A02,083214,Anzaldo; Leesa B,0,6,30,30
1650288993300,MATH 109,B01,083215,Anzaldo; Leesa B,0,4,30,30
1650288993300,MATH 109,B02,083216,Anzaldo; Leesa B,0,3,30,30
1650288999325,MATH 142A,A01,083219,Chow; Bennett,0,12,30,30
1650288999325,MATH 142A,A02,083220,Chow; Bennett,0,11,30,30
1650288999325,MATH 142A,B01,083221,Chow; Bennett,0,11,30,30
1650288999325,MATH 142A,B02,083222,Chow; Bennett,0,12,30,30
1650289005353,MATH 193A,A01,083224,Staff,0,5,30,30
1650289005353,MATH 193A,A02,083225,Staff,0,5,30,30
1650289005353,MATH 193A,A03,083781,Staff,0,2,30,30
1650289005353,MATH 193A,A04,083782,Staff,0,1,30,30
1650289011376,MATH 197,001,091859,McAuley; Julian John,9998,0,9999,1
1650289017430,COGS 9,A01,083615,Staff,0,14,60,60
1650289023456,COGS 11,A01,083617,Boyle; Mary E. T.,24,0,40,16
1650289029483,COGS 13,A01,083071,Staff,0,31,40,40
1650289035512,COGS 14A,A01,092681,Staff,0,15,100,100
1650289041535,COGS 14B,A01,083073,Cheng; Tzu-Han,0,9,50,50
1650289047561,COGS 17,A01,092677,Staff,29,0,75,46
1650289053584,COGS 100,A01,083619,Staff,0,23,60,60
1650289059609,COGS 101A,A01,083621,Davis; Joshua Daniel,0,21,60,60
1650289065639,COGS 101B,A01,091572,Staff,4,0,60,56
1650289071663,COGS 101C,A01,083625,Delgado; Tania,19,0,30,11
1650289077700,COGS 107A,A01,083627,Boyle; Mary E. T.,0,8,60,60
1650289083744,COGS 118A,A01,083075,Staff,13,0,60,47
1650289089767,CSE 3,A50,083646,Miranda; Gregory Joseph,21,0,38,17
1650289089767,CSE 3,A51,083647,Miranda; Gregory Joseph,37,0,37,0
1650289095798,CSE 8A,A50,083650,Miranda; Gregory Joseph,0,22,40,40
1650289101826,CSE 11,A01,083080,Cao; Yingjun,0,74,40,40
1650289107854,CSE 12,A01,083652,Staff,0,10,100,100
1650289113882,CSE 15L,A01,083654,Staff,0,1,50,50
1650289113882,CSE 15L,A02,083655,Staff,4,0,50,46
1650289119910,CSE 20,A01,083657,Staff,53,0,80,27
1650289125936,CSE 30,A01,083084,Eldon; John,0,74,40,40
1650289131959,CSE 100,A01,083659,Cao; Yingjun,0,65,50,50
1650289137984,CSE 134B,A01,083661,Powell; Thomas Allan,0,28,65,65
1650289144026,CSE 140,A01,083663,Staff,0,0,75,75
1650289150054,CSE 140L,A01,083088,Eldon; John,0,6,75,75
1650289156079,CSE 175,A01,083665,Kumar; Rakesh,8,0,25,17
1650289162122,CSE 190,A00,092507,Dubnov; Shlomo,14,0,20,6
1650289168151,ECE 45,A01,083139,Staff,0,15,40,40
1650289174176,ECE 65,A50,083695,Staff,0,4,30,30
1650289180202,ECE 109,A01,091882,Touri; Behrouz,43,0,70,27
1650289186227,ECE 180,A00,083140,Abi Samra; Nicholas Camill,24,0,30,6
1650289186227,ECE 180,B00,083141,Abi Samra; Nicholas Camill,7,0,30,23
1650289192252,MATH 10A,A01,083735,Patchell; Gregory David,11,0,30,19
1650289192252,MATH 10A,A02,083736,Patchell; Gregory David,28,0,30,2
1650289192252,MATH 10A,A03,083737,Patchell; Gregory David,26,0,30,4
1650289198281,MATH 10B,A01,083207,Staff,0,6,30,30
1650289198281,MATH 10B,A02,083208,Staff,0,6,30,30
1650289198281,MATH 10B,B01,083739,Staff,17,0,30,13
1650289198281,MATH 10B,B02,083740,Staff,29,0,30,1
1650289204307,MATH 18,A01,083743,Staff,7,0,30,23
1650289204307,MATH 18,A02,083744,Staff,27,0,30,3
1650289204307,MATH 18,A03,083745,Staff,23,0,30,7
1650289204307,MATH 18,A04,083746,Staff,27,0,30,3
1650289204307,MATH 18,B01,083748,Staff,0,11,30,30
1650289204307,MATH 18,B02,083749,Staff,0,9,30,30
1650289204307,MATH 18,B03,083750,Staff,1,8,30,29
1650289204307,MATH 18,B04,083751,Staff,0,9,30,30
1650289210334,MATH 20A,A01,083754,Staff,26,0,40,14
1650289216385,MATH 20B,A01,083756,Staff,0,5,30,30
1650289216385,MATH 20B,A02,083757,Staff,0,7,30,30
1650289222421,MATH 20C,A01,083760,Staff,0,13,30,30
1650289222421,MATH 20C,A02,083761,Staff,0,13,30,30
1650289222421,MATH 20C,B01,083762,Staff,14,0,30,16
1650289222421,MATH 20C,B02,083763,Staff,28,0,30,2
1650289228448,MATH 20D,A01,083765,Staff,0,1,30,30
1650289228448,MATH 20D,A02,083766,Staff,8,0,30,22
1650289228448,MATH 20D,A03,083767,Staff,28,0,30,2
1650289234477,MATH 20E,A01,083771,Staff,6,0,30,24
1650289234477,MATH 20E,A02,083772,Staff,20,0,30,10
1650289234477,MATH 20E,B01,083773,Staff,0,0,30,30
1650289234477,MATH 20E,B02,083774,Staff,11,0,30,19
1650289240503,MATH 103A,A01,083777,Staff,0,10,30,30
1650289240503,MATH 103A,A02,083778,Staff,0,10,30,30
1650289240503,MATH 103A,B01,083779,Staff,0,10,30,30
1650289240503,MATH 103A,B02,083780,Staff,0,10,30,30
1650289246533,MATH 105,A01,085443,Staff,0,17,30,30
1650289252567,MATH 109,A01,083213,Anzaldo; Leesa B,0,5,30,30
1650289252567,MATH 109,A02,083214,Anzaldo; Leesa B,0,6,30,30
1650289252567,MATH 109,B01,083215,Anzaldo; Leesa B,0,4,30,30
1650289252567,MATH 109,B02,083216,Anzaldo; Leesa B,0,3,30,30
1650289258606,MATH 142A,A01,083219,Chow; Bennett,0,12,30,30
1650289258606,MATH 142A,A02,083220,Chow; Bennett,0,11,30,30
1650289258606,MATH 142A,B01,083221,Chow; Bennett,0,11,30,30
1650289258606,MATH 142A,B02,083222,Chow; Bennett,0,12,30,30
1650289264643,MATH 193A,A01,083224,Staff,0,5,30,30
1650289264643,MATH 193A,A02,083225,Staff,0,5,30,30
1650289264643,MATH 193A,A03,083781,Staff,0,2,30,30
1650289264643,MATH 193A,A04,083782,Staff,0,1,30,30
1650289270668,MATH 197,001,091859,McAuley; Julian John,9998,0,9999,1
1650289276723,COGS 9,A01,083615,Staff,0,14,60,60
1650289282749,COGS 11,A01,083617,Boyle; Mary E. T.,24,0,40,16
1650289288865,COGS 13,A01,083071,Staff,0,31,40,40
1650289294896,COGS 14A,A01,092681,Staff,0,15,100,100
1650289300927,COGS 14B,A01,083073,Cheng; Tzu-Han,0,9,50,50
1650289306955,COGS 17,A01,092677,Staff,29,0,75,46
1650289312979,COGS 100,A01,083619,Staff,0,23,60,60
1650289319004,COGS 101A,A01,083621,Davis; Joshua Daniel,0,21,60,60
1650289325031,COGS 101B,A01,091572,Staff,4,0,60,56
1650289331058,COGS 101C,A01,083625,Delgado; Tania,19,0,30,11
1650289337083,COGS 107A,A01,083627,Boyle; Mary E. T.,0,8,60,60
1650289343110,COGS 118A,A01,083075,Staff,13,0,60,47
1650289349137,CSE 3,A50,083646,Miranda; Gregory Joseph,21,0,38,17
1650289349137,CSE 3,A51,083647,Miranda; Gregory Joseph,37,0,37,0
1650289355162,CSE 8A,A50,083650,Miranda; Gregory Joseph,0,22,40,40
1650289361186,CSE 11,A01,083080,Cao; Yingjun,0,74,40,40
1650289367211,CSE 12,A01,083652,Staff,0,10,100,100
1650289373236,CSE 15L,A01,083654,Staff,0,1,50,50
1650289373236,CSE 15L,A02,083655,Staff,4,0,50,46
1650289379265,CSE 20,A01,083657,Staff,53,0,80,27
1650289385294,CSE 30,A01,083084,Eldon; John,0,74,40,40
1650289391323,CSE 100,A01,083659,Cao; Yingjun,0,65,50,50
1650289397348,CSE 134B,A01,083661,Powell; Thomas Allan,0,28,65,65
1650289403372,CSE 140,A01,083663,Staff,0,0,75,75
1650289409396,CSE 140L,A01,083088,Eldon; John,0,6,75,75
1650289415419,CSE 175,A01,083665,Kumar; Rakesh,8,0,25,17
1650289421444,CSE 190,A00,092507,Dubnov; Shlomo,14,0,20,6
1650289427469,ECE 45,A01,083139,Staff,0,15,40,40
1650289433494,ECE 65,A50,083695,Staff,0,4,30,30
1650289439521,ECE 109,A01,091882,Touri; Behrouz,43,0,70,27
1650289445549,ECE 180,A00,083140,Abi Samra; Nicholas Camill,24,0,30,6
1650289445549,ECE 180,B00,083141,Abi Samra; Nicholas Camill,7,0,30,23
1650289451592,MATH 10A,A01,083735,Patchell; Gregory David,11,0,30,19
1650289451592,MATH 10A,A02,083736,Patchell; Gregory David,28,0,30,2
1650289451592,MATH 10A,A03,083737,Patchell; Gregory David,26,0,30,4
1650289457618,MATH 10B,A01,083207,Staff,0,6,30,30
1650289457618,MATH 10B,A02,083208,Staff,0,6,30,30
1650289457618,MATH 10B,B01,083739,Staff,17,0,30,13
1650289457618,MATH 10B,B02,083740,Staff,29,0,30,1
1650289463646,MATH 18,A01,083743,Staff,7,0,30,23
1650289463646,MATH 18,A02,083744,Staff,27,0,30,3
1650289463646,MATH 18,A03,083745,Staff,23,0,30,7
1650289463646,MATH 18,A04,083746,Staff,27,0,30,3
1650289463646,MATH 18,B01,083748,Staff,0,11,30,30
1650289463646,MATH 18,B02,083749,Staff,0,9,30,30
1650289463646,MATH 18,B03,083750,Staff,1,8,30,29
1650289463646,MATH 18,B04,083751,Staff,0,9,30,30
1650289469672,MATH 20A,A01,083754,Staff,26,0,40,14
1650289475696,MATH 20B,A01,083756,Staff,0,5,30,30
1650289475696,MATH 20B,A02,083757,Staff,0,7,30,30
1650289481721,MATH 20C,A01,083760,Staff,0,13,30,30
1650289481721,MATH 20C,A02,083761,Staff,0,13,30,30
1650289481721,MATH 20C,B01,083762,Staff,14,0,30,16
1650289481721,MATH 20C,B02,083763,Staff,28,0,30,2
1650289487759,MATH 20D,A01,083765,Staff,0,1,30,30
1650289487759,MATH 20D,A02,083766,Staff,8,0,30,22
1650289487759,MATH 20D,A03,083767,Staff,28,0,30,2
1650289493797,MATH 20E,A01,083771,Staff,6,0,30,24
1650289493797,MATH 20E,A02,083772,Staff,20,0,30,10
1650289493797,MATH 20E,B01,083773,Staff,0,0,30,30
1650289493797,MATH 20E,B02,083774,Staff,11,0,30,19
1650289499823,MATH 103A,A01,083777,Staff,0,10,30,30
1650289499823,MATH 103A,A02,083778,Staff,0,10,30,30
1650289499823,MATH 103A,B01,083779,Staff,0,10,30,30
1650289499823,MATH 103A,B02,083780,Staff,0,10,30,30
1650289505851,MATH 105,A01,085443,Staff,0,17,30,30
1650289511888,MATH 109,A01,083213,Anzaldo; Leesa B,0,5,30,30
1650289511888,MATH 109,A02,083214,Anzaldo; Leesa B,0,6,30,30
1650289511888,MATH 109,B01,083215,Anzaldo; Leesa B,0,4,30,30
1650289511888,MATH 109,B02,083216,Anzaldo; Leesa B,0,3,30,30
1650289517918,MATH 142A,A01,083219,Chow; Bennett,0,12,30,30
1650289517918,MATH 142A,A02,083220,Chow; Bennett,0,11,30,30
1650289517918,MATH 142A,B01,083221,Chow; Bennett,0,11,30,30
1650289517918,MATH 142A,B02,083222,Chow; Bennett,0,12,30,30
1650289523943,MATH 193A,A01,083224,Staff,0,5,30,30
1650289523943,MATH 193A,A02,083225,Staff,0,5,30,30
1650289523943,MATH 193A,A03,083781,Staff,0,2,30,30
1650289523943,MATH 193A,A04,083782,Staff,0,1,30,30
1650289529966,MATH 197,001,091859,McAuley; Julian John,9998,0,9999,1
1650289536030,COGS 9,A01,083615,Staff,0,14,60,60
1650289542053,COGS 11,A01,083617,Boyle; Mary E. T.,24,0,40,16
1650289548079,COGS 13,A01,083071,Staff,0,31,40,40
1650289554112,COGS 14A,A01,092681,Staff,0,15,100,100
1650289560137,COGS 14B,A01,083073,Cheng; Tzu-Han,0,9,50,50
1650289566163,COGS 17,A01,092677,Staff,29,0,75,46
1650289572188,COGS 100,A01,083619,Staff,0,23,60,60
1650289578217,COGS 101A,A01,083621,Davis; Joshua Daniel,0,21,60,60
1650289584246,COGS 101B,A01,091572,Staff,4,0,60,56
1650289590272,COGS 101C,A01,083625,Delgado; Tania,19,0,30,11
1650289596302,COGS 107A,A01,083627,Boyle; Mary E. T.,0,8,60,60
1650289602340,COGS 118A,A01,083075,Staff,13,0,60,47
1650289608365,CSE 3,A50,083646,Miranda; Gregory Joseph,21,0,38,17
1650289608365,CSE 3,A51,083647,Miranda; Gregory Joseph,37,0,37,0
1650289614390,CSE 8A,A50,083650,Miranda; Gregory Joseph,0,22,40,40
1650289620419,CSE 11,A01,083080,Cao; Yingjun,0,74,40,40
1650289626467,CSE 12,A01,083652,Staff,0,10,100,100
1650289632500,CSE 15L,A01,083654,Staff,0,1,50,50
1650289632500,CSE 15L,A02,083655,Staff,4,0,50,46
1650289638524,CSE 20,A01,083657,Staff,53,0,80,27
1650289644551,CSE 30,A01,083084,Eldon; John,0,74,40,40
1650289650575,CSE 100,A01,083659,Cao; Yingjun,0,65,50,50
1650289656598,CSE 134B,A01,083661,Powell; Thomas Allan,0,28,65,65
1650289662621,CSE 140,A01,083663,Staff,0,0,75,75
1650289668646,CSE 140L,A01,083088,Eldon; John,0,6,75,75
1650289674672,CSE 175,A01,083665,Kumar; Rakesh,8,0,25,17
1650289680708,CSE 190,A00,092507,Dubnov; Shlomo,14,0,20,6
1650289686731,ECE 45,A01,083139,Staff,0,15,40,40
1650289692755,ECE 65,A50,083695,Staff,0,4,30,30
1650289698777,ECE 109,A01,091882,Touri; Behrouz,43,0,70,27
1650289704812,ECE 180,A00,083140,Abi Samra; Nicholas Camill,24,0,30,6
1650289704812,ECE 180,B00,083141,Abi Samra; Nicholas Camill,7,0,30,23
1650289710837,MATH 10A,A01,083735,Patchell; Gregory David,11,0,30,19
1650289710837,MATH 10A,A02,083736,Patchell; Gregory David,28,0,30,2
1650289710837,MATH 10A,A03,083737,Patchell; Gregory David,26,0,30,4
1650289716863,MATH 10B,A01,083207,Staff,0,6,30,30
1650289716863,MATH 10B,A02,083208,Staff,0,6,30,30
1650289716863,MATH 10B,B01,083739,Staff,17,0,30,13
1650289716863,MATH 10B,B02,083740,Staff,29,0,30,1
1650289722893,MATH 18,A01,083743,Staff,7,0,30,23
1650289722893,MATH 18,A02,083744,Staff,27,0,30,3
1650289722893,MATH 18,A03,083745,Staff,23,0,30,7
1650289722893,MATH 18,A04,083746,Staff,27,0,30,3
1650289722893,MATH 18,B01,083748,Staff,0,11,30,30
1650289722893,MATH 18,B02,083749,Staff,0,9,30,30
1650289722893,MATH 18,B03,083750,Staff,1,8,30,29
1650289722893,MATH 18,B04,083751,Staff,0,9,30,30
1650289728918,MATH 20A,A01,083754,Staff,26,0,40,14
1650289734952,MATH 20B,A01,083756,Staff,0,5,30,30
1650289734952,MATH 20B,A02,083757,Staff,0,7,30,30
1650289741016,MATH 20C,A01,083760,Staff,0,13,30,30
1650289741016,MATH 20C,A02,083761,Staff,0,13,30,30
1650289741016,MATH 20C,B01,083762,Staff,14,0,30,16
1650289741016,MATH 20C,B02,083763,Staff,28,0,30,2
1650289747042,MATH 20D,A01,083765,Staff,0,1,30,30
1650289747042,MATH 20D,A02,083766,Staff,8,0,30,22
1650289747042,MATH 20D,A03,083767,Staff,28,0,30,2
1650289753069,MATH 20E,A01,083771,Staff,6,0,30,24
1650289753069,MATH 20E,A02,083772,Staff,20,0,30,10
1650289753069,MATH 20E,B01,083773,Staff,0,0,30,30
1650289753069,MATH 20E,B02,083774,Staff,11,0,30,19
1650289759099,MATH 103A,A01,083777,Staff,0,10,30,30
1650289759099,MATH 103A,A02,083778,Staff,0,10,30,30
1650289759099,MATH 103A,B01,083779,Staff,0,10,30,30
1650289759099,MATH 103A,B02,083780,Staff,0,10,30,30
1650289765124,MATH 105,A01,085443,Staff,0,17,30,30
1650289771148,MATH 109,A01,083213,Anzaldo; Leesa B,0,5,30,30
1650289771148,MATH 109,A02,083214,Anzaldo; Leesa B,0,6,30,30
1650289771148,MATH 109,B01,083215,Anzaldo; Leesa B,0,4,30,30
1650289771148,MATH 109,B02,083216,Anzaldo; Leesa B,0,3,30,30
1650289777173,MATH 142A,A01,083219,Chow; Bennett,0,12,30,30
1650289777173,MATH 142A,A02,083220,Chow; Bennett,0,11,30,30
1650289777173,MATH 142A,B01,083221,Chow; Bennett,0,11,30,30
1650289777173,MATH 142A,B02,083222,Chow; Bennett,0,12,30,30
1650289783202,MATH 193A,A01,083224,Staff,0,5,30,30
1650289783202,MATH 193A,A02,083225,Staff,0,5,30,30
1650289783202,MATH 193A,A03,083781,Staff,0,2,30,30
1650289783202,MATH 193A,A04,083782,Staff,0,1,30,30
1650289789226,MATH 197,001,091859,McAuley; Julian John,9998,0,9999,1
1650289795282,COGS 9,A01,083615,Staff,0,14,60,60
1650289801307,COGS 11,A01,083617,Boyle; Mary E. T.,24,0,40,16
1650289807334,COGS 13,A01,083071,Staff,0,31,40,40
1650289813359,COGS 14A,A01,092681,Staff,0,15,100,100
1650289819394,COGS 14B,A01,083073,Cheng; Tzu-Han,0,9,50,50
1650289825430,COGS 17,A01,092677,Staff,29,0,75,46
1650289831458,COGS 100,A01,083619,Staff,0,23,60,60
1650289837481,COGS 101A,A01,083621,Davis; Joshua Daniel,0,21,60,60
1650289843506,COGS 101B,A01,091572,Staff,4,0,60,56
1650289849535,COGS 101C,A01,083625,Delgado; Tania,19,0,30,11
1650289855560,COGS 107A,A01,083627,Boyle; Mary E. T.,0,8,60,60
1650289861584,COGS 118A,A01,083075,Staff,13,0,60,47
1650289867608,CSE 3,A50,083646,Miranda; Gregory Joseph,21,0,38,17
1650289867608,CSE 3,A51,083647,Miranda; Gregory Joseph,37,0,37,0
1650289873632,CSE 8A,A50,083650,Miranda; Gregory Joseph,0,22,40,40
1650289879656,CSE 11,A01,083080,Cao; Yingjun,0,74,40,40
1650289885775,CSE 12,A01,083652,Staff,0,10,100,100
1650289891809,CSE 15L,A01,083654,Staff,0,1,50,50
1650289891809,CSE 15L,A02,083655,Staff,4,0,50,46
1650289897834,CSE 20,A01,083657,Staff,53,0,80,27
1650289903859,CSE 30,A01,083084,Eldon; John,0,74,40,40
1650289909887,CSE 100,A01,083659,Cao; Yingjun,0,65,50,50
1650289915909,CSE 134B,A01,083661,Powell; Thomas Allan,0,28,65,65
1650289921936,CSE 140,A01,083663,Staff,0,0,75,75
1650289927960,CSE 140L,A01,083088,Eldon; John,0,6,75,75
1650289933985,CSE 175,A01,083665,Kumar; Rakesh,8,0,25,17
1650289940008,CSE 190,A00,092507,Dubnov; Shlomo,14,0,20,6
1650289946033,ECE 45,A01,083139,Staff,0,15,40,40
1650289952058,ECE 65,A50,083695,Staff,0,4,30,30
1650289958082,ECE 109,A01,091882,Touri; Behrouz,43,0,70,27
1650289964106,ECE 180,A00,083140,Abi Samra; Nicholas Camill,24,0,30,6
1650289964106,ECE 180,B00,083141,Abi Samra; Nicholas Camill,7,0,30,23
1650289970133,MATH 10A,A01,083735,Patchell; Gregory David,11,0,30,19
1650289970133,MATH 10A,A02,083736,Patchell; Gregory David,28,0,30,2
1650289970133,MATH 10A,A03,083737,Patchell; Gregory David,26,0,30,4
1650289976157,MATH 10B,A01,083207,Staff,0,6,30,30
1650289976157,MATH 10B,A02,083208,Staff,0,6,30,30
1650289976157,MATH 10B,B01,083739,Staff,17,0,30,13
1650289976157,MATH 10B,B02,083740,Staff,29,0,30,1
1650289982182,MATH 18,A01,083743,Staff,7,0,30,23
1650289982182,MATH 18,A02,083744,Staff,27,0,30,3
1650289982182,MATH 18,A03,083745,Staff,23,0,30,7
1650289982182,MATH 18,A04,083746,Staff,27,0,30,3
1650289982182,MATH 18,B01,083748,Staff,0,11,30,30
1650289982182,MATH 18,B02,083749,Staff,0,9,30,30
1650289982182,MATH 18,B03,083750,Staff,1,8,30,29
1650289982182,MATH 18,B04,083751,Staff,0,9,30,30
1650289988210,MATH 20A,A01,083754,Staff,26,0,40,14
1650289994234,MATH 20B,A01,083756,Staff,0,5,30,30
1650289994234,MATH 20B,A02,083757,Staff,0,7,30,30
1650290000268,MATH 20C,A01,083760,Staff,0,13,30,30
1650290000268,MATH 20C,A02,083761,Staff,0,13,30,30
1650290000268,MATH 20C,B01,083762,Staff,14,0,30,16
1650290000268,MATH 20C,B02,083763,Staff,28,0,30,2
1650290006294,MATH 20D,A01,083765,Staff,0,1,30,30
1650290006294,MATH 20D,A02,083766,Staff,8,0,30,22
1650290006294,MATH 20D,A03,083767,Staff,28,0,30,2
1650290012319,MATH 20E,A01,083771,Staff,6,0,30,24
1650290012319,MATH 20E,A02,083772,Staff,20,0,30,10
1650290012319,MATH 20E,B01,083773,Staff,0,0,30,30
1650290012319,MATH 20E,B02,083774,Staff,11,0,30,19
1650290018345,MATH 103A,A01,083777,Staff,0,10,30,30
1650290018345,MATH 103A,A02,083778,Staff,0,10,30,30
1650290018345,MATH 103A,B01,083779,Staff,0,10,30,30
1650290018345,MATH 103A,B02,083780,Staff,0,10,30,30
1650290024368,MATH 105,A01,085443,Staff,0,17,30,30
1650290030397,MATH 109,A01,083213,Anzaldo; Leesa B,0,5,30,30
1650290030397,MATH 109,A02,083214,Anzaldo; Leesa B,0,6,30,30
1650290030397,MATH 109,B01,083215,Anzaldo; Leesa B,0,4,30,30
1650290030397,MATH 109,B02,083216,Anzaldo; Leesa B,0,3,30,30
1650290036425,MATH 142A,A01,083219,Chow; Bennett,0,12,30,30
1650290036425,MATH 142A,A02,083220,Chow; Bennett,0,11,30,30
1650290036425,MATH 142A,B01,083221,Chow; Bennett,0,11,30,30
1650290036425,MATH 142A,B02,083222,Chow; Bennett,0,12,30,30
1650290042453,MATH 193A,A01,083224,Staff,0,5,30,30
1650290042453,MATH 193A,A02,083225,Staff,0,5,30,30
1650290042453,MATH 193A,A03,083781,Staff,0,2,30,30
1650290042453,MATH 193A,A04,083782,Staff,0,1,30,30
1650290048476,MATH 197,001,091859,McAuley; Julian John,9998,0,9999,1
1650290054532,COGS 9,A01,083615,Staff,0,14,60,60
1650290060566,COGS 11,A01,083617,Boyle; Mary E. T.,24,0,40,16
1650290066590,COGS 13,A01,083071,Staff,0,31,40,40
1650290072614,COGS 14A,A01,092681,Staff,0,15,100,100
1650290078639,COGS 14B,A01,083073,Cheng; Tzu-Han,0,9,50,50
1650290084665,COGS 17,A01,092677,Staff,29,0,75,46
1650290090688,COGS 100,A01,083619,Staff,0,23,60,60
1650290096716,COGS 101A,A01,083621,Davis; Joshua Daniel,0,21,60,60
1650290102740,COGS 101B,A01,091572,Staff,4,0,60,56
1650290108767,COGS 101C,A01,083625,Delgado; Tania,19,0,30,11
1650290114793,COGS 107A,A01,083627,Boyle; Mary E. T.,0,8,60,60
1650290120820,COGS 118A,A01,083075,Staff,13,0,60,47
1650290126860,CSE 3,A50,083646,Miranda; Gregory Joseph,21,0,38,17
1650290126860,CSE 3,A51,083647,Miranda; Gregory Joseph,37,0,37,0
1650290132886,CSE 8A,A50,083650,Miranda; Gregory Joseph,0,22,40,40
1650290138912,CSE 11,A01,083080,Cao; Yingjun,0,74,40,40
1650290144937,CSE 12,A01,083652,Staff,0,10,100,100
1650290150962,CSE 15L,A01,083654,Staff,0,1,50,50
1650290150962,CSE 15L,A02,083655,Staff,4,0,50,46
1650290156987,CSE 20,A01,083657,Staff,53,0,80,27
1650290163015,CSE 30,A01,083084,Eldon; John,0,74,40,40
1650290169041,CSE 100,A01,083659,Cao; Yingjun,0,65,50,50
1650290175067,CSE 134B,A01,083661,Powell; Thomas Allan,0,28,65,65
1650290181096,CSE 140,A01,083663,Staff,0,0,75,75
1650290187123,CSE 140L,A01,083088,Eldon; John,0,6,75,75
1650290193148,CSE 175,A01,083665,Kumar; Rakesh,8,0,25,17
1650290199172,CSE 190,A00,092507,Dubnov; Shlomo,14,0,20,6
1650290205203,ECE 45,A01,083139,Staff,0,15,40,40
1650290211227,ECE 65,A50,083695,Staff,0,4,30,30
1650290217253,ECE 109,A01,091882,Touri; Behrouz,43,0,70,27
1650290223277,ECE 180,A00,083140,Abi Samra; Nicholas Camill,24,0,30,6
1650290223277,ECE 180,B00,083141,Abi Samra; Nicholas Camill,7,0,30,23
1650290229307,MATH 10A,A01,083735,Patchell; Gregory David,11,0,30,19
1650290229307,MATH 10A,A02,083736,Patchell; Gregory David,28,0,30,2
1650290229307,MATH 10A,A03,083737,Patchell; Gregory David,26,0,30,4
1650290235335,MATH 10B,A01,083207,Staff,0,6,30,30
1650290235335,MATH 10B,A02,083208,Staff,0,6,30,30
1650290235335,MATH 10B,B01,083739,Staff,17,0,30,13
1650290235335,MATH 10B,B02,083740,Staff,29,0,30,1
1650290241361,MATH 18,A01,083743,Staff,7,0,30,23
1650290241361,MATH 18,A02,083744,Staff,27,0,30,3
1650290241361,MATH 18,A03,083745,Staff,23,0,30,7
1650290241361,MATH 18,A04,083746,Staff,27,0,30,3
1650290241361,MATH 18,B01,083748,Staff,0,11,30,30
1650290241361,MATH 18,B02,083749,Staff,0,9,30,30
1650290241361,MATH 18,B03,083750,Staff,1,8,30,29
1650290241361,MATH 18,B04,083751,Staff,0,9,30,30
1650290247388,MATH 20A,A01,083754,Staff,26,0,40,14
1650290253427,MATH 20B,A01,083756,Staff,0,5,30,30
1650290253427,MATH 20B,A02,083757,Staff,0,7,30,30
1650290259455,MATH 20C,A01,083760,Staff,0,13,30,30
1650290259455,MATH 20C,A02,083761,Staff,0,13,30,30
1650290259455,MATH 20C,B01,083762,Staff,14,0,30,16
1650290259455,MATH 20C,B02,083763,Staff,28,0,30,2
1650290265480,MATH 20D,A01,083765,Staff,0,1,30,30
1650290265480,MATH 20D,A02,083766,Staff,8,0,30,22
1650290265480,MATH 20D,A03,083767,Staff,28,0,30,2
1650290271511,MATH 20E,A01,083771,Staff,6,0,30,24
1650290271511,MATH 20E,A02,083772,Staff,20,0,30,10
1650290271511,MATH 20E,B01,083773,Staff,0,0,30,30
1650290271511,MATH 20E,B02,083774,Staff,11,0,30,19
1650290277536,MATH 103A,A01,083777,Staff,0,10,30,30
1650290277536,MATH 103A,A02,083778,Staff,0,10,30,30
1650290277536,MATH 103A,B01,083779,Staff,0,10,30,30
1650290277536,MATH 103A,B02,083780,Staff,0,10,30,30
1650290283560,MATH 105,A01,085443,Staff,0,17,30,30
1650290289600,MATH 109,A01,083213,Anzaldo; Leesa B,0,5,30,30
1650290289600,MATH 109,A02,083214,Anzaldo; Leesa B,0,6,30,30
1650290289600,MATH 109,B01,083215,Anzaldo; Leesa B,0,4,30,30
1650290289600,MATH 109,B02,083216,Anzaldo; Leesa B,0,3,30,30
1650290295624,MATH 142A,A01,083219,Chow; Bennett,0,12,30,30
1650290295624,MATH 142A,A02,083220,Chow; Bennett,0,11,30,30
1650290295624,MATH 142A,B01,083221,Chow; Bennett,0,11,30,30
1650290295624,MATH 142A,B02,083222,Chow; Bennett,0,12,30,30
1650290301651,MATH 193A,A01,083224,Staff,0,5,30,30
1650290301651,MATH 193A,A02,083225,Staff,0,5,30,30
1650290301651,MATH 193A,A03,083781,Staff,0,2,30,30
1650290301651,MATH 193A,A04,083782,Staff,0,1,30,30
1650290307675,MATH 197,001,091859,McAuley; Julian John,9998,0,9999,1
1650290313734,COGS 9,A01,083615,Staff,0,14,60,60
1650290319762,COGS 11,A01,083617,Boyle; Mary E. T.,24,0,40,16
1650290325791,COGS 13,A01,083071,Staff,0,31,40,40
1650290331816,COGS 14A,A01,092681,Staff,0,15,100,100
1650290337841,COGS 14B,A01,083073,Cheng; Tzu-Han,0,9,50,50
1650290343866,COGS 17,A01,092677,Staff,29,0,75,46
1650290349889,COGS 100,A01,083619,Staff,0,23,60,60
1650290355923,COGS 101A,A01,083621,Davis; Joshua Daniel,0,21,60,60
1650290361950,COGS 101B,A01,091572,Staff,4,0,60,56
1650290367974,COGS 101C,A01,083625,Delgado; Tania,19,0,30,11
1650290374007,COGS 107A,A01,083627,Boyle; Mary E. T.,0,8,60,60
1650290380041,COGS 118A,A01,083075,Staff,13,0,60,47
1650290386070,CSE 3,A50,083646,Miranda; Gregory Joseph,21,0,38,17
1650290386070,CSE 3,A51,083647,Miranda; Gregory Joseph,37,0,37,0
1650290392096,CSE 8A,A50,083650,Miranda; Gregory Joseph,0,22,40,40
1650290398121,CSE 11,A01,083080,Cao; Yingjun,0,74,40,40
1650290404149,CSE 12,A01,083652,Staff,0,10,100,100
1650290410218,CSE 15L,A01,083654,Staff,0,1,50,50
1650290410218,CSE 15L,A02,083655,Staff,4,0,50,46
1650290416246,CSE 20,A01,083657,Staff,53,0,80,27
1650290422269,CSE 30,A01,083084,Eldon; John,0,74,40,40
1650290428301,CSE 100,A01,083659,Cao; Yingjun,0,65,50,50
1650290434328,CSE 134B,A01,083661,Powell; Thomas Allan,0,28,65,65
1650290440357,CSE 140,A01,083663,Staff,0,0,75,75
1650290446382,CSE 140L,A01,083088,Eldon; John,0,6,75,75
1650290452408,CSE 175,A01,083665,Kumar; Rakesh,8,0,25,17
1650290458432,CSE 190,A00,092507,Dubnov; Shlomo,14,0,20,6
1650290464457,ECE 45,A01,083139,Staff,0,15,40,40
1650290470485,ECE 65,A50,083695,Staff,0,4,30,30
1650290476513,ECE 109,A01,091882,Touri; Behrouz,43,0,70,27
1650290482630,ECE 180,A00,083140,Abi Samra; Nicholas Camill,24,0,30,6
1650290482630,ECE 180,B00,083141,Abi Samra; Nicholas Camill,7,0,30,23
1650290488656,MATH 10A,A01,083735,Patchell; Gregory David,11,0,30,19
1650290488656,MATH 10A,A02,083736,Patchell; Gregory David,28,0,30,2
1650290488656,MATH 10A,A03,083737,Patchell; Gregory David,26,0,30,4
1650290494680,MATH 10B,A01,083207,Staff,0,6,30,30
1650290494680,MATH 10B,A02,083208,Staff,0,6,30,30
1650290494680,MATH 10B,B01,083739,Staff,17,0,30,13
1650290494680,MATH 10B,B02,083740,Staff,29,0,30,1
1650290500711,MATH 18,A01,083743,Staff,7,0,30,23
1650290500711,MATH 18,A02,083744,Staff,27,0,30,3
1650290500711,MATH 18,A03,083745,Staff,23,0,30,7
1650290500711,MATH 18,A04,083746,Staff,27,0,30,3
1650290500711,MATH 18,B01,083748,Staff,0,11,30,30
1650290500711,MATH 18,B02,083749,Staff,0,9,30,30
1650290500711,MATH 18,B03,083750,Staff,1,8,30,29
1650290500711,MATH 18,B04,083751,Staff,0,9,30,30
1650290506736,MATH 20A,A01,083754,Staff,26,0,40,14
1650290512766,MATH 20B,A01,083756,Staff,0,5,30,30
1650290512766,MATH 20B,A02,083757,Staff,0,7,30,30
1650290518794,MATH 20C,A01,083760,Staff,0,13,30,30
1650290518794,MATH 20C,A02,083761,Staff,0,13,30,30
1650290518794,MATH 20C,B01,083762,Staff,14,0,30,16
1650290518794,MATH 20C,B02,083763,Staff,28,0,30,2
1650290524821,MATH 20D,A01,083765,Staff,0,1,30,30
1650290524821,MATH 20D,A02,083766,Staff,8,0,30,22
1650290524821,MATH 20D,A03,083767,Staff,28,0,30,2
1650290530849,MATH 20E,A01,083771,Staff,6,0,30,24
1650290530849,MATH 20E,A02,083772,Staff,20,0,30,10
1650290530849,MATH 20E,B01,083773,Staff,0,0,30,30
1650290530849,MATH 20E,B02,083774,Staff,11,0,30,19
1650290536880,MATH 103A,A01,083777,Staff,0,10,30,30
1650290536880,MATH 103A,A02,083778,Staff,0,10,30,30
1650290536880,MATH 103A,B01,083779,Staff,0,10,30,30
1650290536880,MATH 103A,B02,083780,Staff,0,10,30,30
1650290542906,MATH 105,A01,085443,Staff,0,17,30,30
1650290548933,MATH 109,A01,083213,Anzaldo; Leesa B,0,5,30,30
1650290548933,MATH 109,A02,083214,Anzaldo; Leesa B,0,6,30,30
1650290548933,MATH 109,B01,083215,Anzaldo; Leesa B,0,4,30,30
1650290548933,MATH 109,B02,083216,Anzaldo; Leesa B,0,3,30,30
1650290554962,MATH 142A,A01,083219,Chow; Bennett,0,12,30,30
1650290554962,MATH 142A,A02,083220,Chow; Bennett,0,11,30,30
1650290554962,MATH 142A,B01,083221,Chow; Bennett,0,11,30,30
1650290554962,MATH 142A,B02,083222,Chow; Bennett,0,12,30,30
1650290560986,MATH 193A,A01,083224,Staff,0,5,30,30
1650290560986,MATH 193A,A02,083225,Staff,0,5,30,30
1650290560986,MATH 193A,A03,083781,Staff,0,2,30,30
1650290560986,MATH 193A,A04,083782,Staff,0,1,30,30
1650290567011,MATH 197,001,091859,McAuley; Julian John,9998,0,9999,1
1650290573077,COGS 9,A01,083615,Staff,0,14,60,60
1650290579113,COGS 11,A01,083617,Boyle; Mary E. T.,24,0,40,16
1650290585139,COGS 13,A01,083071,Staff,0,31,40,40
1650290591168,COGS 14A,A01,092681,Staff,0,15,100,100
1650290597210,COGS 14B,A01,083073,Cheng; Tzu-Han,0,9,50,50
1650290603234,COGS 17,A01,092677,Staff,29,0,75,46
1650290609263,COGS 100,A01,083619,Staff,0,23,60,60
1650290615296,COGS 101A,A01,083621,Davis; Joshua Daniel,0,21,60,60
1650290621324,COGS 101B,A01,091572,Staff,4,0,60,56
1650290627350,COGS 101C,A01,083625,Delgado; Tania,19,0,30,11
1650290633375,COGS 107A,A01,083627,Boyle; Mary E. T.,0,8,60,60
1650290639418,COGS 118A,A01,083075,Staff,13,0,60,47
1650290645447,CSE 3,A50,083646,Miranda; Gregory Joseph,21,0,38,17
1650290645447,CSE 3,A51,083647,Miranda; Gregory Joseph,37,0,37,0
1650290651493,CSE 8A,A50,083650,Miranda; Gregory Joseph,0,22,40,40
1650290657517,CSE 11,A01,083080,Cao; Yingjun,0,74,40,40
1650290663542,CSE 12,A01,083652,Staff,0,10,100,100
1650290669569,CSE 15L,A01,083654,Staff,0,1,50,50
1650290669569,CSE 15L,A02,083655,Staff,4,0,50,46
1650290675597,CSE 20,A01,083657,Staff,53,0,80,27
1650290681625,CSE 30,A01,083084,Eldon; John,0,74,40,40
1650290687654,CSE 100,A01,083659,Cao; Yingjun,0,65,50,50
1650290693719,CSE 134B,A01,083661,Powell; Thomas Allan,0,28,65,65
1650290699744,CSE 140,A01,083663,Staff,0,0,75,75
1650290705773,CSE 140L,A01,083088,Eldon; John,0,6,75,75
1650290711801,CSE 175,A01,083665,Kumar; Rakesh,8,0,25,17
1650290717825,CSE 190,A00,092507,Dubnov; Shlomo,14,0,20,6
1650290723852,ECE 45,A01,083139,Staff,0,15,40,40
1650290729874,ECE 65,A50,083695,Staff,0,4,30,30
1650290735899,ECE 109,A01,091882,Touri; Behrouz,43,0,70,27
1650290741929,ECE 180,A00,083140,Abi Samra; Nicholas Camill,24,0,30,6
1650290741929,ECE 180,B00,083141,Abi Samra; Nicholas Camill,7,0,30,23
1650290747953,MATH 10A,A01,083735,Patchell; Gregory David,11,0,30,19
1650290747953,MATH 10A,A02,083736,Patchell; Gregory David,28,0,30,2
1650290747953,MATH 10A,A03,083737,Patchell; Gregory David,26,0,30,4
1650290753986,MATH 10B,A01,083207,Staff,0,6,30,30
1650290753986,MATH 10B,A02,083208,Staff,0,6,30,30
1650290753986,MATH 10B,B01,083739,Staff,17,0,30,13
1650290753986,MATH 10B,B02,083740,Staff,29,0,30,1
1650290760017,MATH 18,A01,083743,Staff,7,0,30,23
1650290760017,MATH 18,A02,083744,Staff,27,0,30,3
1650290760017,MATH 18,A03,083745,Staff,23,0,30,7
1650290760017,MATH 18,A04,083746,Staff,27,0,30,3
1650290760017,MATH 18,B01,083748,Staff,0,11,30,30
1650290760017,MATH 18,B02,083749,Staff,0,9,30,30
1650290760017,MATH 18,B03,083750,Staff,1,8,30,29
1650290760017,MATH 18,B04,083751,Staff,0,9,30,30
1650290766042,MATH 20A,A01,083754,Staff,26,0,40,14
1650290772067,MATH 20B,A01,083756,Staff,0,5,30,30
1650290772067,MATH 20B,A02,083757,Staff,0,7,30,30
1650290778092,MATH 20C,A01,083760,Staff,0,13,30,30
1650290778092,MATH 20C,A02,083761,Staff,0,13,30,30
1650290778092,MATH 20C,B01,083762,Staff,14,0,30,16
1650290778092,MATH 20C,B02,083763,Staff,28,0,30,2
1650290784120,MATH 20D,A01,083765,Staff,0,1,30,30
1650290784120,MATH 20D,A02,083766,Staff,8,0,30,22
1650290784120,MATH 20D,A03,083767,Staff,28,0,30,2
1650290790145,MATH 20E,A01,083771,Staff,6,0,30,24
1650290790145,MATH 20E,A02,083772,Staff,20,0,30,10
1650290790145,MATH 20E,B01,083773,Staff,0,0,30,30
1650290790145,MATH 20E,B02,083774,Staff,11,0,30,19
1650290796173,MATH 103A,A01,083777,Staff,0,10,30,30
1650290796173,MATH 103A,A02,083778,Staff,0,10,30,30
1650290796173,MATH 103A,B01,083779,Staff,0,10,30,30
1650290796173,MATH 103A,B02,083780,Staff,0,10,30,30
1650290802198,MATH 105,A01,085443,Staff,0,17,30,30
1650290808226,MATH 109,A01,083213,Anzaldo; Leesa B,0,5,30,30
1650290808226,MATH 109,A02,083214,Anzaldo; Leesa B,0,6,30,30
1650290808226,MATH 109,B01,083215,Anzaldo; Leesa B,0,4,30,30
1650290808226,MATH 109,B02,083216,Anzaldo; Leesa B,0,3,30,30
1650290814255,MATH 142A,A01,083219,Chow; Bennett,0,12,30,30
1650290814255,MATH 142A,A02,083220,Chow; Bennett,0,11,30,30
1650290814255,MATH 142A,B01,083221,Chow; Bennett,0,11,30,30
1650290814255,MATH 142A,B02,083222,Chow; Bennett,0,12,30,30
1650290820282,MATH 193A,A01,083224,Staff,0,5,30,30
1650290820282,MATH 193A,A02,083225,Staff,0,5,30,30
1650290820282,MATH 193A,A03,083781,Staff,0,2,30,30
1650290820282,MATH 193A,A04,083782,Staff,0,1,30,30
1650290826309,MATH 197,001,091859,McAuley; Julian John,9998,0,9999,1
1650290832360,COGS 9,A01,083615,Staff,0,14,60,60
1650290838390,COGS 11,A01,083617,Boyle; Mary E. T.,24,0,40,16
1650290844429,COGS 13,A01,083071,Staff,0,31,40,40
1650290850462,COGS 14A,A01,092681,Staff,0,15,100,100
1650290856489,COGS 14B,A01,083073,Cheng; Tzu-Han,0,9,50,50
1650290862515,COGS 17,A01,092677,Staff,29,0,75,46
1650290868539,COGS 100,A01,083619,Staff,0,23,60,60
1650290874568,COGS 101A,A01,083621,Davis; Joshua Daniel,0,21,60,60
1650290880600,COGS 101B,A01,091572,Staff,4,0,60,56
1650290886628,COGS 101C,A01,083625,Delgado; Tania,19,0,30,11
1650290892651,COGS 107A,A01,083627,Boyle; Mary E. T.,0,8,60,60
1650290898678,COGS 118A,A01,083075,Staff,13,0,60,47
1650290904703,CSE 3,A50,083646,Miranda; Gregory Joseph,21,0,38,17
1650290904703,CSE 3,A51,083647,Miranda; Gregory Joseph,37,0,37,0
1650290910730,CSE 8A,A50,083650,Miranda; Gregory Joseph,0,22,40,40
1650290916753,CSE 11,A01,083080,Cao; Yingjun,0,74,40,40
1650290922786,CSE 12,A01,083652,Staff,0,10,100,100
1650290928819,CSE 15L,A01,083654,Staff,0,1,50,50
1650290928819,CSE 15L,A02,083655,Staff,4,0,50,46
1650290934844,CSE 20,A01,083657,Staff,53,0,80,27
1650290940870,CSE 30,A01,083084,Eldon; John,0,74,40,40
1650290946897,CSE 100,A01,083659,Cao; Yingjun,0,65,50,50
1650290952921,CSE 134B,A01,083661,Powell; Thomas Allan,0,28,65,65
1650290958945,CSE 140,A01,083663,Staff,0,0,75,75
1650290964972,CSE 140L,A01,083088,Eldon; John,0,6,75,75
1650290970999,CSE 175,A01,083665,Kumar; Rakesh,8,0,25,17
1650290977023,CSE 190,A00,092507,Dubnov; Shlomo,14,0,20,6
1650290983049,ECE 45,A01,083139,Staff,0,15,40,40
1650290989077,ECE 65,A50,083695,Staff,0,4,30,30
1650290995108,ECE 109,A01,091882,Touri; Behrouz,43,0,70,27
1650291001132,ECE 180,A00,083140,Abi Samra; Nicholas Camill,24,0,30,6
1650291001132,ECE 180,B00,083141,Abi Samra; Nicholas Camill,7,0,30,23
1650291007161,MATH 10A,A01,083735,Patchell; Gregory David,11,0,30,19
1650291007161,MATH 10A,A02,083736,Patchell; Gregory David,28,0,30,2
1650291007161,MATH 10A,A03,083737,Patchell; Gregory David,26,0,30,4
1650291013185,MATH 10B,A01,083207,Staff,0,6,30,30
1650291013185,MATH 10B,A02,083208,Staff,0,6,30,30
1650291013185,MATH 10B,B01,083739,Staff,17,0,30,13
1650291013185,MATH 10B,B02,083740,Staff,29,0,30,1
1650291019212,MATH 18,A01,083743,Staff,7,0,30,23
1650291019212,MATH 18,A02,083744,Staff,27,0,30,3
1650291019212,MATH 18,A03,083745,Staff,23,0,30,7
1650291019212,MATH 18,A04,083746,Staff,27,0,30,3
1650291019212,MATH 18,B01,083748,Staff,0,11,30,30
1650291019212,MATH 18,B02,083749,Staff,0,9,30,30
1650291019212,MATH 18,B03,083750,Staff,1,8,30,29
1650291019212,MATH 18,B04,083751,Staff,0,9,30,30
1650291025238,MATH 20A,A01,083754,Staff,26,0,40,14
1650291031273,MATH 20B,A01,083756,Staff,0,5,30,30
1650291031273,MATH 20B,A02,083757,Staff,0,7,30,30
1650291037297,MATH 20C,A01,083760,Staff,0,13,30,30
1650291037297,MATH 20C,A02,083761,Staff,0,13,30,30
1650291037297,MATH 20C,B01,083762,Staff,14,0,30,16
1650291037297,MATH 20C,B02,083763,Staff,28,0,30,2
1650291043330,MATH 20D,A01,083765,Staff,0,1,30,30
1650291043330,MATH 20D,A02,083766,Staff,8,0,30,22
1650291043330,MATH 20D,A03,083767,Staff,28,0,30,2
1650291049356,MATH 20E,A01,083771,Staff,6,0,30,24
1650291049356,MATH 20E,A02,083772,Staff,20,0,30,10
1650291049356,MATH 20E,B01,083773,Staff,0,0,30,30
1650291049356,MATH 20E,B02,083774,Staff,11,0,30,19
1650291055381,MATH 103A,A01,083777,Staff,0,10,30,30
1650291055381,MATH 103A,A02,083778,Staff,0,10,30,30
1650291055381,MATH 103A,B01,083779,Staff,0,10,30,30
1650291055381,MATH 103A,B02,083780,Staff,0,10,30,30
1650291061409,MATH 105,A01,085443,Staff,0,17,30,30
1650291067434,MATH 109,A01,083213,Anzaldo; Leesa B,0,5,30,30
1650291067434,MATH 109,A02,083214,Anzaldo; Leesa B,0,6,30,30
1650291067434,MATH 109,B01,083215,Anzaldo; Leesa B,0,4,30,30
1650291067434,MATH 109,B02,083216,Anzaldo; Leesa B,0,3,30,30
1650291073463,MATH 142A,A01,083219,Chow; Bennett,0,12,30,30
1650291073463,MATH 142A,A02,083220,Chow; Bennett,0,11,30,30
1650291073463,MATH 142A,B01,083221,Chow; Bennett,0,11,30,30
1650291073463,MATH 142A,B02,083222,Chow; Bennett,0,12,30,30
1650291079581,MATH 193A,A01,083224,Staff,0,5,30,30
1650291079581,MATH 193A,A02,083225,Staff,0,5,30,30
1650291079581,MATH 193A,A03,083781,Staff,0,2,30,30
1650291079581,MATH 193A,A04,083782,Staff,0,1,30,30
1650291085608,MATH 197,001,091859,McAuley; Julian John,9998,0,9999,1
1650291091665,COGS 9,A01,083615,Staff,0,14,60,60
1650291097698,COGS 11,A01,083617,Boyle; Mary E. T.,24,0,40,16
1650291103723,COGS 13,A01,083071,Staff,0,31,40,40
1650291109751,COGS 14A,A01,092681,Staff,0,15,100,100
1650291115777,COGS 14B,A01,083073,Cheng; Tzu-Han,0,9,50,50
1650291121804,COGS 17,A01,092677,Staff,29,0,75,46
1650291127838,COGS 100,A01,083619,Staff,0,23,60,60
1650291133866,COGS 101A,A01,083621,Davis; Joshua Daniel,0,21,60,60
1650291139892,COGS 101B,A01,091572,Staff,4,0,60,56
1650291145919,COGS 101C,A01,083625,Delgado; Tania,19,0,30,11
1650291151942,COGS 107A,A01,083627,Boyle; Mary E. T.,0,8,60,60
1650291157968,COGS 118A,A01,083075,Staff,13,0,60,47
1650291163994,CSE 3,A50,083646,Miranda; Gregory Joseph,21,0,38,17
1650291163994,CSE 3,A51,083647,Miranda; Gregory Joseph,37,0,37,0
1650291170019,CSE 8A,A50,083650,Miranda; Gregory Joseph,0,22,40,40
1650291176043,CSE 11,A01,083080,Cao; Yingjun,0,74,40,40
1650291182071,CSE 12,A01,083652,Staff,0,10,100,100
1650291188094,CSE 15L,A01,083654,Staff,0,1,50,50
1650291188094,CSE 15L,A02,083655,Staff,4,0,50,46
1650291194121,CSE 20,A01,083657,Staff,53,0,80,27
1650291200148,CSE 30,A01,083084,Eldon; John,0,74,40,40
1650291206180,CSE 100,A01,083659,Cao; Yingjun,0,65,50,50
1650291212203,CSE 134B,A01,083661,Powell; Thomas Allan,0,28,65,65
1650291218230,CSE 140,A01,083663,Staff,0,0,75,75
1650291224265,CSE 140L,A01,083088,Eldon; John,0,6,75,75
1650291230292,CSE 175,A01,083665,Kumar; Rakesh,8,0,25,17
1650291236318,CSE 190,A00,092507,Dubnov; Shlomo,14,0,20,6
1650291242343,ECE 45,A01,083139,Staff,0,15,40,40
1650291248366,ECE 65,A50,083695,Staff,0,4,30,30
1650291254398,ECE 109,A01,091882,Touri; Behrouz,43,0,70,27
1650291260424,ECE 180,A00,083140,Abi Samra; Nicholas Camill,24,0,30,6
1650291260424,ECE 180,B00,083141,Abi Samra; Nicholas Camill,7,0,30,23
1650291266454,MATH 10A,A01,083735,Patchell; Gregory David,11,0,30,19
1650291266454,MATH 10A,A02,083736,Patchell; Gregory David,28,0,30,2
1650291266454,MATH 10A,A03,083737,Patchell; Gregory David,26,0,30,4
1650291272483,MATH 10B,A01,083207,Staff,0,6,30,30
1650291272483,MATH 10B,A02,083208,Staff,0,6,30,30
1650291272483,MATH 10B,B01,083739,Staff,17,0,30,13
1650291272483,MATH 10B,B02,083740,Staff,29,0,30,1
1650291278514,MATH 18,A01,083743,Staff,7,0,30,23
1650291278514,MATH 18,A02,083744,Staff,27,0,30,3
1650291278514,MATH 18,A03,083745,Staff,23,0,30,7
1650291278514,MATH 18,A04,083746,Staff,27,0,30,3
1650291278514,MATH 18,B01,083748,Staff,0,11,30,30
1650291278514,MATH 18,B02,083749,Staff,0,9,30,30
1650291278514,MATH 18,B03,083750,Staff,1,8,30,29
1650291278514,MATH 18,B04,083751,Staff,0,9,30,30
1650291284541,MATH 20A,A01,083754,Staff,26,0,40,14
1650291290567,MATH 20B,A01,083756,Staff,0,5,30,30
1650291290567,MATH 20B,A02,083757,Staff,0,7,30,30
1650291296590,MATH 20C,A01,083760,Staff,0,13,30,30
1650291296590,MATH 20C,A02,083761,Staff,0,13,30,30
1650291296590,MATH 20C,B01,083762,Staff,14,0,30,16
1650291296590,MATH 20C,B02,083763,Staff,28,0,30,2
1650291302613,MATH 20D,A01,083765,Staff,0,1,30,30
1650291302613,MATH 20D,A02,083766,Staff,8,0,30,22
1650291302613,MATH 20D,A03,083767,Staff,28,0,30,2
1650291308638,MATH 20E,A01,083771,Staff,6,0,30,24
1650291308638,MATH 20E,A02,083772,Staff,20,0,30,10
1650291308638,MATH 20E,B01,083773,Staff,0,0,30,30
1650291308638,MATH 20E,B02,083774,Staff,11,0,30,19
1650291314676,MATH 103A,A01,083777,Staff,0,10,30,30
1650291314676,MATH 103A,A02,083778,Staff,0,10,30,30
1650291314676,MATH 103A,B01,083779,Staff,0,10,30,30
1650291314676,MATH 103A,B02,083780,Staff,0,10,30,30
1650291320699,MATH 105,A01,085443,Staff,0,17,30,30
1650291326739,MATH 109,A01,083213,Anzaldo; Leesa B,0,5,30,30
1650291326739,MATH 109,A02,083214,Anzaldo; Leesa B,0,6,30,30
1650291326739,MATH 109,B01,083215,Anzaldo; Leesa B,0,4,30,30
1650291326739,MATH 109,B02,083216,Anzaldo; Leesa B,0,3,30,30
1650291332765,MATH 142A,A01,083219,Chow; Bennett,0,12,30,30
1650291332765,MATH 142A,A02,083220,Chow; Bennett,0,11,30,30
1650291332765,MATH 142A,B01,083221,Chow; Bennett,0,11,30,30
1650291332765,MATH 142A,B02,083222,Chow; Bennett,0,12,30,30
1650291338789,MATH 193A,A01,083224,Staff,0,5,30,30
1650291338789,MATH 193A,A02,083225,Staff,0,5,30,30
1650291338789,MATH 193A,A03,083781,Staff,0,2,30,30
1650291338789,MATH 193A,A04,083782,Staff,0,1,30,30
1650291344815,MATH 197,001,091859,McAuley; Julian John,9998,0,9999,1
1650291350864,COGS 9,A01,083615,Staff,0,14,60,60
1650291356891,COGS 11,A01,083617,Boyle; Mary E. T.,24,0,40,16
1650291362927,COGS 13,A01,083071,Staff,0,31,40,40
1650291368952,COGS 14A,A01,092681,Staff,0,15,100,100
1650291374977,COGS 14B,A01,083073,Cheng; Tzu-Han,0,9,50,50
1650291381000,COGS 17,A01,092677,Staff,29,0,75,46
1650291387036,COGS 100,A01,083619,Staff,0,23,60,60
1650291393064,COGS 101A,A01,083621,Davis; Joshua Daniel,0,21,60,60
1650291399091,COGS 101B,A01,091572,Staff,4,0,60,56
1650291405116,COGS 101C,A01,083625,Delgado; Tania,19,0,30,11
1650291411164,COGS 107A,A01,083627,Boyle; Mary E. T.,0,8,60,60
1650291417192,COGS 118A,A01,083075,Staff,13,0,60,47
1650291423220,CSE 3,A50,083646,Miranda; Gregory Joseph,21,0,38,17
1650291423220,CSE 3,A51,083647,Miranda; Gregory Joseph,37,0,37,0
1650291429247,CSE 8A,A50,083650,Miranda; Gregory Joseph,0,22,40,40
1650291435277,CSE 11,A01,083080,Cao; Yingjun,0,74,40,40
1650291441311,CSE 12,A01,083652,Staff,0,10,100,100
1650291447338,CSE 15L,A01,083654,Staff,0,1,50,50
1650291447338,CSE 15L,A02,083655,Staff,4,0,50,46
1650291453364,CSE 20,A01,083657,Staff,53,0,80,27
1650291459390,CSE 30,A01,083084,Eldon; John,0,73,40,40
1650291465423,CSE 100,A01,083659,Cao; Yingjun,0,65,50,50
1650291471449,CSE 134B,A01,083661,Powell; Thomas Allan,0,28,65,65
1650291477481,CSE 140,A01,083663,Staff,0,0,75,75
1650291483516,CSE 140L,A01,083088,Eldon; John,0,6,75,75
1650291489552,CSE 175,A01,083665,Kumar; Rakesh,8,0,25,17
1650291495578,CSE 190,A00,092507,Dubnov; Shlomo,14,0,20,6
1650291501609,ECE 45,A01,083139,Staff,0,15,40,40
1650291507633,ECE 65,A50,083695,Staff,0,4,30,30
1650291513660,ECE 109,A01,091882,Touri; Behrouz,43,0,70,27
1650291519685,ECE 180,A00,083140,Abi Samra; Nicholas Camill,24,0,30,6
1650291519685,ECE 180,B00,083141,Abi Samra; Nicholas Camill,7,0,30,23
1650291525716,MATH 10A,A01,083735,Patchell; Gregory David,11,0,30,19
1650291525716,MATH 10A,A02,083736,Patchell; Gregory David,28,0,30,2
1650291525716,MATH 10A,A03,083737,Patchell; Gregory David,26,0,30,4
1650291531744,MATH 10B,A01,083207,Staff,0,6,30,30
1650291531744,MATH 10B,A02,083208,Staff,0,6,30,30
1650291531744,MATH 10B,B01,083739,Staff,17,0,30,13
1650291531744,MATH 10B,B02,083740,Staff,29,0,30,1
1650291537773,MATH 18,A01,083743,Staff,7,0,30,23
1650291537773,MATH 18,A02,083744,Staff,27,0,30,3
1650291537773,MATH 18,A03,083745,Staff,23,0,30,7
1650291537773,MATH 18,A04,083746,Staff,27,0,30,3
1650291537773,MATH 18,B01,083748,Staff,0,11,30,30
1650291537773,MATH 18,B02,083749,Staff,0,9,30,30
1650291537773,MATH 18,B03,083750,Staff,1,8,30,29
1650291537773,MATH 18,B04,083751,Staff,0,9,30,30
1650291543799,MATH 20A,A01,083754,Staff,26,0,40,14
1650291549822,MATH 20B,A01,083756,Staff,0,5,30,30
1650291549822,MATH 20B,A02,083757,Staff,0,7,30,30
1650291555845,MATH 20C,A01,083760,Staff,0,13,30,30
1650291555845,MATH 20C,A02,083761,Staff,0,13,30,30
1650291555845,MATH 20C,B01,083762,Staff,14,0,30,16
1650291555845,MATH 20C,B02,083763,Staff,28,0,30,2
1650291561869,MATH 20D,A01,083765,Staff,0,1,30,30
1650291561869,MATH 20D,A02,083766,Staff,8,0,30,22
1650291561869,MATH 20D,A03,083767,Staff,28,0,30,2
1650291567901,MATH 20E,A01,083771,Staff,6,0,30,24
1650291567901,MATH 20E,A02,083772,Staff,20,0,30,10
1650291567901,MATH 20E,B01,083773,Staff,0,0,30,30
1650291567901,MATH 20E,B02,083774,Staff,11,0,30,19
1650291573930,MATH 103A,A01,083777,Staff,0,10,30,30
1650291573930,MATH 103A,A02,083778,Staff,0,10,30,30
1650291573930,MATH 103A,B01,083779,Staff,0,10,30,30
1650291573930,MATH 103A,B02,083780,Staff,0,10,30,30
1650291579957,MATH 105,A01,085443,Staff,0,17,30,30
1650291585993,MATH 109,A01,083213,Anzaldo; Leesa B,0,5,30,30
1650291585993,MATH 109,A02,083214,Anzaldo; Leesa B,0,6,30,30
1650291585993,MATH 109,B01,083215,Anzaldo; Leesa B,0,4,30,30
1650291585993,MATH 109,B02,083216,Anzaldo; Leesa B,0,3,30,30
1650291592028,MATH 142A,A01,083219,Chow; Bennett,0,12,30,30
1650291592028,MATH 142A,A02,083220,Chow; Bennett,0,11,30,30
1650291592028,MATH 142A,B01,083221,Chow; Bennett,0,11,30,30
1650291592028,MATH 142A,B02,083222,Chow; Bennett,0,12,30,30
1650291598052,MATH 193A,A01,083224,Staff,0,5,30,30
1650291598052,MATH 193A,A02,083225,Staff,0,5,30,30
1650291598052,MATH 193A,A03,083781,Staff,0,2,30,30
1650291598052,MATH 193A,A04,083782,Staff,0,1,30,30
1650291604080,MATH 197,001,091859,McAuley; Julian John,9998,0,9999,1
1650291610138,COGS 9,A01,083615,Staff,0,14,60,60
1650291616167,COGS 11,A01,083617,Boyle; Mary E. T.,24,0,40,16
1650291622192,COGS 13,A01,083071,Staff,0,31,40,40
1650291628218,COGS 14A,A01,092681,Staff,0,15,100,100
1650291634245,COGS 14B,A01,083073,Cheng; Tzu-Han,0,9,50,50
1650291640279,COGS 17,A01,092677,Staff,29,0,75,46
1650291646308,COGS 100,A01,083619,Staff,0,23,60,60
1650291652344,COGS 101A,A01,083621,Davis; Joshua Daniel,0,21,60,60
1650291658371,COGS 101B,A01,091572,Staff,4,0,60,56
1650291664398,COGS 101C,A01,083625,Delgado; Tania,19,0,30,11
1650291670516,COGS 107A,A01,083627,Boyle; Mary E. T.,0,8,60,60
1650291676542,COGS 118A,A01,083075,Staff,13,0,60,47
1650291682568,CSE 3,A50,083646,Miranda; Gregory Joseph,21,0,38,17
1650291682568,CSE 3,A51,083647,Miranda; Gregory Joseph,37,0,37,0
1650291688598,CSE 8A,A50,083650,Miranda; Gregory Joseph,0,22,40,40
1650291694635,CSE 11,A01,083080,Cao; Yingjun,0,74,40,40
1650291700680,CSE 12,A01,083652,Staff,0,10,100,100
1650291706711,CSE 15L,A01,083654,Staff,0,1,50,50
1650291706711,CSE 15L,A02,083655,Staff,4,0,50,46
1650291712739,CSE 20,A01,083657,Staff,53,0,80,27
1650291718764,CSE 30,A01,083084,Eldon; John,0,73,40,40
1650291724787,CSE 100,A01,083659,Cao; Yingjun,0,65,50,50
1650291730812,CSE 134B,A01,083661,Powell; Thomas Allan,0,28,65,65
1650291736840,CSE 140,A01,083663,Staff,0,0,75,75
1650291742864,CSE 140L,A01,083088,Eldon; John,0,6,75,75
1650291748888,CSE 175,A01,083665,Kumar; Rakesh,8,0,25,17
1650291754913,CSE 190,A00,092507,Dubnov; Shlomo,14,0,20,6
1650291760938,ECE 45,A01,083139,Staff,0,15,40,40
1650291766963,ECE 65,A50,083695,Staff,0,4,30,30
1650291772987,ECE 109,A01,091882,Touri; Behrouz,43,0,70,27
1650291779013,ECE 180,A00,083140,Abi Samra; Nicholas Camill,24,0,30,6
1650291779013,ECE 180,B00,083141,Abi Samra; Nicholas Camill,7,0,30,23
1650291785038,MATH 10A,A01,083735,Patchell; Gregory David,11,0,30,19
1650291785038,MATH 10A,A02,083736,Patchell; Gregory David,28,0,30,2
1650291785038,MATH 10A,A03,083737,Patchell; Gregory David,26,0,30,4
1650291791067,MATH 10B,A01,083207,Staff,0,6,30,30
1650291791067,MATH 10B,A02,083208,Staff,0,6,30,30
1650291791067,MATH 10B,B01,083739,Staff,17,0,30,13
1650291791067,MATH 10B,B02,083740,Staff,29,0,30,1
1650291797102,MATH 18,A01,083743,Staff,7,0,30,23
1650291797102,MATH 18,A02,083744,Staff,27,0,30,3
1650291797102,MATH 18,A03,083745,Staff,23,0,30,7
1650291797102,MATH 18,A04,083746,Staff,27,0,30,3
1650291797102,MATH 18,B01,083748,Staff,0,11,30,30
1650291797102,MATH 18,B02,083749,Staff,0,9,30,30
1650291797102,MATH 18,B03,083750,Staff,1,8,30,29
1650291797102,MATH 18,B04,083751,Staff,0,9,30,30
1650291803127,MATH 20A,A01,083754,Staff,26,0,40,14
1650291809159,MATH 20B,A01,083756,Staff,0,5,30,30
1650291809159,MATH 20B,A02,083757,Staff,0,7,30,30
1650291815193,MATH 20C,A01,083760,Staff,0,13,30,30
1650291815193,MATH 20C,A02,083761,Staff,0,13,30,30
1650291815193,MATH 20C,B01,083762,Staff,14,0,30,16
1650291815193,MATH 20C,B02,083763,Staff,28,0,30,2
1650291821218,MATH 20D,A01,083765,Staff,0,1,30,30
1650291821218,MATH 20D,A02,083766,Staff,8,0,30,22
1650291821218,MATH 20D,A03,083767,Staff,28,0,30,2
1650291827247,MATH 20E,A01,083771,Staff,6,0,30,24
1650291827247,MATH 20E,A02,083772,Staff,20,0,30,10
1650291827247,MATH 20E,B01,083773,Staff,0,0,30,30
1650291827247,MATH 20E,B02,083774,Staff,11,0,30,19
1650291833271,MATH 103A,A01,083777,Staff,0,10,30,30
1650291833271,MATH 103A,A02,083778,Staff,0,10,30,30
1650291833271,MATH 103A,B01,083779,Staff,0,10,30,30
1650291833271,MATH 103A,B02,083780,Staff,0,10,30,30
1650291839295,MATH 105,A01,085443,Staff,0,17,30,30
1650291845324,MATH 109,A01,083213,Anzaldo; Leesa B,0,5,30,30
1650291845324,MATH 109,A02,083214,Anzaldo; Leesa B,0,6,30,30
1650291845324,MATH 109,B01,083215,Anzaldo; Leesa B,0,4,30,30
1650291845324,MATH 109,B02,083216,Anzaldo; Leesa B,0,3,30,30
1650291851351,MATH 142A,A01,083219,Chow; Bennett,0,12,30,30
1650291851351,MATH 142A,A02,083220,Chow; Bennett,0,11,30,30
1650291851351,MATH 142A,B01,083221,Chow; Bennett,0,11,30,30
1650291851351,MATH 142A,B02,083222,Chow; Bennett,0,12,30,30
1650291857376,MATH 193A,A01,083224,Staff,0,5,30,30
1650291857376,MATH 193A,A02,083225,Staff,0,5,30,30
1650291857376,MATH 193A,A03,083781,Staff,0,2,30,30
1650291857376,MATH 193A,A04,083782,Staff,0,1,30,30
1650291863401,MATH 197,001,091859,McAuley; Julian John,9998,0,9999,1
1650291869457,COGS 9,A01,083615,Staff,0,14,60,60
1650291875484,COGS 11,A01,083617,Boyle; Mary E. T.,24,0,40,16
1650291881511,COGS 13,A01,083071,Staff,0,31,40,40
1650291887538,COGS 14A,A01,092681,Staff,0,15,100,100
1650291893566,COGS 14B,A01,083073,Cheng; Tzu-Han,0,9,50,50
1650291899590,COGS 17,A01,092677,Staff,29,0,75,46
1650291905615,COGS 100,A01,083619,Staff,0,23,60,60
1650291911657,COGS 101A,A01,083621,Davis; Joshua Daniel,0,21,60,60
1650291917686,COGS 101B,A01,091572,Staff,4,0,60,56
1650291923726,COGS 101C,A01,083625,Delgado; Tania,19,0,30,11
1650291929753,COGS 107A,A01,083627,Boyle; Mary E. T.,0,8,60,60
1650291935777,COGS 118A,A01,083075,Staff,13,0,60,47
1650291941801,CSE 3,A50,083646,Miranda; Gregory Joseph,21,0,38,17
1650291941801,CSE 3,A51,083647,Miranda; Gregory Joseph,37,0,37,0
1650291947824,CSE 8A,A50,083650,Miranda; Gregory Joseph,0,22,40,40
1650291953849,CSE 11,A01,083080,Cao; Yingjun,0,74,40,40
1650291959873,CSE 12,A01,083652,Staff,0,10,100,100
1650291965897,CSE 15L,A01,083654,Staff,0,1,50,50
1650291965897,CSE 15L,A02,083655,Staff,4,0,50,46
1650291971922,CSE 20,A01,083657,Staff,53,0,80,27
1650291977945,CSE 30,A01,083084,Eldon; John,0,73,40,40
1650291983974,CSE 100,A01,083659,Cao; Yingjun,0,65,50,50
1650291990007,CSE 134B,A01,083661,Powell; Thomas Allan,0,28,65,65
1650291996031,CSE 140,A01,083663,Staff,0,0,75,75
1650292002055,CSE 140L,A01,083088,Eldon; John,0,6,75,75
1650292008093,CSE 175,A01,083665,Kumar; Rakesh,8,0,25,17
1650292014121,CSE 190,A00,092507,Dubnov; Shlomo,14,0,20,6
1650292020147,ECE 45,A01,083139,Staff,0,15,40,40
1650292026177,ECE 65,A50,083695,Staff,0,4,30,30
1650292032202,ECE 109,A01,091882,Touri; Behrouz,43,0,70,27
1650292038234,ECE 180,A00,083140,Abi Samra; Nicholas Camill,24,0,30,6
1650292038234,ECE 180,B00,083141,Abi Samra; Nicholas Camill,7,0,30,23
1650292044271,MATH 10A,A01,083735,Patchell; Gregory David,11,0,30,19
1650292044271,MATH 10A,A02,083736,Patchell; Gregory David,28,0,30,2
1650292044271,MATH 10A,A03,083737,Patchell; Gregory David,26,0,30,4
1650292050299,MATH 10B,A01,083207,Staff,0,6,30,30
1650292050299,MATH 10B,A02,083208,Staff,0,6,30,30
1650292050299,MATH 10B,B01,083739,Staff,17,0,30,13
1650292050299,MATH 10B,B02,083740,Staff,29,0,30,1
1650292056324,MATH 18,A01,083743,Staff,7,0,30,23
1650292056324,MATH 18,A02,083744,Staff,27,0,30,3
1650292056324,MATH 18,A03,083745,Staff,23,0,30,7
1650292056324,MATH 18,A04,083746,Staff,27,0,30,3
1650292056324,MATH 18,B01,083748,Staff,0,11,30,30
1650292056324,MATH 18,B02,083749,Staff,0,9,30,30
1650292056324,MATH 18,B03,083750,Staff,1,8,30,29
1650292056324,MATH 18,B04,083751,Staff,0,9,30,30
1650292062351,MATH 20A,A01,083754,Staff,26,0,40,14
1650292068376,MATH 20B,A01,083756,Staff,0,5,30,30
1650292068376,MATH 20B,A02,083757,Staff,0,7,30,30
1650292074399,MATH 20C,A01,083760,Staff,0,13,30,30
1650292074399,MATH 20C,A02,083761,Staff,0,13,30,30
1650292074399,MATH 20C,B01,083762,Staff,14,0,30,16
1650292074399,MATH 20C,B02,083763,Staff,28,0,30,2
1650292080428,MATH 20D,A01,083765,Staff,0,1,30,30
1650292080428,MATH 20D,A02,083766,Staff,8,0,30,22
1650292080428,MATH 20D,A03,083767,Staff,28,0,30,2
1650292086457,MATH 20E,A01,083771,Staff,6,0,30,24
1650292086457,MATH 20E,A02,083772,Staff,20,0,30,10
1650292086457,MATH 20E,B01,083773,Staff,0,0,30,30
1650292086457,MATH 20E,B02,083774,Staff,11,0,30,19
1650292092480,MATH 103A,A01,083777,Staff,0,10,30,30
1650292092480,MATH 103A,A02,083778,Staff,0,10,30,30
1650292092480,MATH 103A,B01,083779,Staff,0,10,30,30
1650292092480,MATH 103A,B02,083780,Staff,0,10,30,30
1650292098505,MATH 105,A01,085443,Staff,0,17,30,30
1650292104533,MATH 109,A01,083213,Anzaldo; Leesa B,0,5,30,30
1650292104533,MATH 109,A02,083214,Anzaldo; Leesa B,0,6,30,30
1650292104533,MATH 109,B01,083215,Anzaldo; Leesa B,0,4,30,30
1650292104533,MATH 109,B02,083216,Anzaldo; Leesa B,0,3,30,30
1650292110556,MATH 142A,A01,083219,Chow; Bennett,0,12,30,30
1650292110556,MATH 142A,A02,083220,Chow; Bennett,0,11,30,30
1650292110556,MATH 142A,B01,083221,Chow; Bennett,0,11,30,30
1650292110556,MATH 142A,B02,083222,Chow; Bennett,0,12,30,30
1650292116582,MATH 193A,A01,083224,Staff,0,5,30,30
1650292116582,MATH 193A,A02,083225,Staff,0,5,30,30
1650292116582,MATH 193A,A03,083781,Staff,0,2,30,30
1650292116582,MATH 193A,A04,083782,Staff,0,1,30,30
1650292122610,MATH 197,001,091859,McAuley; Julian John,9998,0,9999,1
1650292128680,COGS 9,A01,083615,Staff,0,14,60,60
1650292134702,COGS 11,A01,083617,Boyle; Mary E. T.,24,0,40,16
1650292140731,COGS 13,A01,083071,Staff,0,31,40,40
1650292146763,COGS 14A,A01,092681,Staff,0,15,100,100
1650292152790,COGS 14B,A01,083073,Cheng; Tzu-Han,0,9,50,50
1650292158813,COGS 17,A01,092677,Staff,29,0,75,46
1650292164845,COGS 100,A01,083619,Staff,0,23,60,60
1650292170872,COGS 101A,A01,083621,Davis; Joshua Daniel,0,21,60,60
1650292176898,COGS 101B,A01,091572,Staff,4,0,60,56
1650292182921,COGS 101C,A01,083625,Delgado; Tania,19,0,30,11
1650292188945,COGS 107A,A01,083627,Boyle; Mary E. T.,0,8,60,60
1650292194991,COGS 118A,A01,083075,Staff,12,0,60,48
1650292201020,CSE 3,A50,083646,Miranda; Gregory Joseph,21,0,38,17
1650292201020,CSE 3,A51,083647,Miranda; Gregory Joseph,37,0,37,0
1650292207043,CSE 8A,A50,083650,Miranda; Gregory Joseph,0,22,40,40
1650292213066,CSE 11,A01,083080,Cao; Yingjun,0,74,40,40
1650292219094,CSE 12,A01,083652,Staff,0,10,100,100
1650292225117,CSE 15L,A01,083654,Staff,0,1,50,50
1650292225117,CSE 15L,A02,083655,Staff,4,0,50,46
1650292231144,CSE 20,A01,083657,Staff,53,0,80,27
1650292237171,CSE 30,A01,083084,Eldon; John,0,73,40,40
1650292243195,CSE 100,A01,083659,Cao; Yingjun,0,65,50,50
1650292249234,CSE 134B,A01,083661,Powell; Thomas Allan,0,28,65,65
1650292255259,CSE 140,A01,083663,Staff,0,0,75,75
1650292261285,CSE 140L,A01,083088,Eldon; John,0,6,75,75
1650292267397,CSE 175,A01,083665,Kumar; Rakesh,8,0,25,17
1650292273421,CSE 190,A00,092507,Dubnov; Shlomo,14,0,20,6
1650292279450,ECE 45,A01,083139,Staff,0,15,40,40
1650292285475,ECE 65,A50,083695,Staff,0,4,30,30
1650292291503,ECE 109,A01,091882,Touri; Behrouz,43,0,70,27
1650292297533,ECE 180,A00,083140,Abi Samra; Nicholas Camill,24,0,30,6
1650292297533,ECE 180,B00,083141,Abi Samra; Nicholas Camill,7,0,30,23
1650292303561,MATH 10A,A01,083735,Patchell; Gregory David,11,0,30,19
1650292303561,MATH 10A,A02,083736,Patchell; Gregory David,28,0,30,2
1650292303561,MATH 10A,A03,083737,Patchell; Gregory David,26,0,30,4
1650292309586,MATH 10B,A01,083207,Staff,0,6,30,30
1650292309586,MATH 10B,A02,083208,Staff,0,6,30,30
1650292309586,MATH 10B,B01,083739,Staff,17,0,30,13
1650292309586,MATH 10B,B02,083740,Staff,29,0,30,1
1650292315625,MATH 18,A01,083743,Staff,7,0,30,23
1650292315625,MATH 18,A02,083744,Staff,27,0,30,3
1650292315625,MATH 18,A03,083745,Staff,23,0,30,7
1650292315625,MATH 18,A04,083746,Staff,27,0,30,3
1650292315625,MATH 18,B01,083748,Staff,0,11,30,30
1650292315625,MATH 18,B02,083749,Staff,0,9,30,30
1650292315625,MATH 18,B03,083750,Staff,1,8,30,29
1650292315625,MATH 18,B04,083751,Staff,0,9,30,30
1650292321651,MATH 20A,A01,083754,Staff,26,0,40,14
1650292327674,MATH 20B,A01,083756,Staff,0,5,30,30
1650292327674,MATH 20B,A02,083757,Staff,0,7,30,30
1650292333697,MATH 20C,A01,083760,Staff,0,13,30,30
1650292333697,MATH 20C,A02,083761,Staff,0,13,30,30
1650292333697,MATH 20C,B01,083762,Staff,14,0,30,16
1650292333697,MATH 20C,B02,083763,Staff,28,0,30,2
1650292339726,MATH 20D,A01,083765,Staff,0,1,30,30
1650292339726,MATH 20D,A02,083766,Staff,8,0,30,22
1650292339726,MATH 20D,A03,083767,Staff,28,0,30,2
1650292345752,MATH 20E,A01,083771,Staff,6,0,30,24
1650292345752,MATH 20E,A02,083772,Staff,20,0,30,10
1650292345752,MATH 20E,B01,083773,Staff,0,0,30,30
1650292345752,MATH 20E,B02,083774,Staff,11,0,30,19
1650292351783,MATH 103A,A01,083777,Staff,0,10,30,30
1650292351783,MATH 103A,A02,083778,Staff,0,10,30,30
1650292351783,MATH 103A,B01,083779,Staff,0,10,30,30
1650292351783,MATH 103A,B02,083780,Staff,0,10,30,30
1650292357809,MATH 105,A01,085443,Staff,0,17,30,30
1650292363833,MATH 109,A01,083213,Anzaldo; Leesa B,0,5,30,30
1650292363833,MATH 109,A02,083214,Anzaldo; Leesa B,0,6,30,30
1650292363833,MATH 109,B01,083215,Anzaldo; Leesa B,0,4,30,30
1650292363833,MATH 109,B02,083216,Anzaldo; Leesa B,0,3,30,30
1650292369857,MATH 142A,A01,083219,Chow; Bennett,0,12,30,30
1650292369857,MATH 142A,A02,083220,Chow; Bennett,0,11,30,30
1650292369857,MATH 142A,B01,083221,Chow; Bennett,0,11,30,30
1650292369857,MATH 142A,B02,083222,Chow; Bennett,0,12,30,30
1650292375887,MATH 193A,A01,083224,Staff,0,5,30,30
1650292375887,MATH 193A,A02,083225,Staff,0,5,30,30
1650292375887,MATH 193A,A03,083781,Staff,0,2,30,30
1650292375887,MATH 193A,A04,083782,Staff,0,1,30,30
1650292381913,MATH 197,001,091859,McAuley; Julian John,9998,0,9999,1
1650292387974,COGS 9,A01,083615,Staff,0,14,60,60
1650292394003,COGS 11,A01,083617,Boyle; Mary E. T.,24,0,40,16
1650292400035,COGS 13,A01,083071,Staff,0,31,40,40
1650292406059,COGS 14A,A01,092681,Staff,0,15,100,100
1650292412083,COGS 14B,A01,083073,Cheng; Tzu-Han,0,9,50,50
1650292418106,COGS 17,A01,092677,Staff,29,0,75,46
1650292424129,COGS 100,A01,083619,Staff,0,23,60,60
1650292430158,COGS 101A,A01,083621,Davis; Joshua Daniel,0,21,60,60
1650292436181,COGS 101B,A01,091572,Staff,4,0,60,56
1650292442210,COGS 101C,A01,083625,Delgado; Tania,19,0,30,11
1650292448237,COGS 107A,A01,083627,Boyle; Mary E. T.,0,8,60,60
1650292454264,COGS 118A,A01,083075,Staff,12,0,60,48
1650292460295,CSE 3,A50,083646,Miranda; Gregory Joseph,21,0,38,17
1650292460295,CSE 3,A51,083647,Miranda; Gregory Joseph,37,0,37,0
1650292466327,CSE 8A,A50,083650,Miranda; Gregory Joseph,0,22,40,40
1650292472358,CSE 11,A01,083080,Cao; Yingjun,0,74,40,40
1650292478384,CSE 12,A01,083652,Staff,0,10,100,100
1650292484412,CSE 15L,A01,083654,Staff,0,1,50,50
1650292484412,CSE 15L,A02,083655,Staff,4,0,50,46
1650292490439,CSE 20,A01,083657,Staff,53,0,80,27
1650292496464,CSE 30,A01,083084,Eldon; John,0,73,40,40
1650292502489,CSE 100,A01,083659,Cao; Yingjun,0,65,50,50
1650292508512,CSE 134B,A01,083661,Powell; Thomas Allan,0,28,65,65
1650292514537,CSE 140,A01,083663,Staff,0,0,75,75
1650292520563,CSE 140L,A01,083088,Eldon; John,0,6,75,75
1650292526586,CSE 175,A01,083665,Kumar; Rakesh,8,0,25,17
1650292532611,CSE 190,A00,092507,Dubnov; Shlomo,14,0,20,6
1650292538640,ECE 45,A01,083139,Staff,0,15,40,40
1650292544666,ECE 65,A50,083695,Staff,0,4,30,30
1650292550690,ECE 109,A01,091882,Touri; Behrouz,43,0,70,27
1650292556718,ECE 180,A00,083140,Abi Samra; Nicholas Camill,24,0,30,6
1650292556718,ECE 180,B00,083141,Abi Samra; Nicholas Camill,7,0,30,23
1650292562745,MATH 10A,A01,083735,Patchell; Gregory David,11,0,30,19
1650292562745,MATH 10A,A02,083736,Patchell; Gregory David,28,0,30,2
1650292562745,MATH 10A,A03,083737,Patchell; Gregory David,26,0,30,4
1650292568775,MATH 10B,A01,083207,Staff,0,6,30,30
1650292568775,MATH 10B,A02,083208,Staff,0,6,30,30
1650292568775,MATH 10B,B01,083739,Staff,17,0,30,13
1650292568775,MATH 10B,B02,083740,Staff,29,0,30,1
1650292574805,MATH 18,A01,083743,Staff,7,0,30,23
1650292574805,MATH 18,A02,083744,Staff,27,0,30,3
1650292574805,MATH 18,A03,083745,Staff,23,0,30,7
1650292574805,MATH 18,A04,083746,Staff,27,0,30,3
1650292574805,MATH 18,B01,083748,Staff,0,11,30,30
1650292574805,MATH 18,B02,083749,Staff,0,9,30,30
1650292574805,MATH 18,B03,083750,Staff,1,8,30,29
1650292574805,MATH 18,B04,083751,Staff,0,9,30,30
1650292580834,MATH 20A,A01,083754,Staff,26,0,40,14
1650292586858,MATH 20B,A01,083756,Staff,0,5,30,30
1650292586858,MATH 20B,A02,083757,Staff,0,7,30,30
1650292592886,MATH 20C,A01,083760,Staff,0,13,30,30
1650292592886,MATH 20C,A02,083761,Staff,0,13,30,30
1650292592886,MATH 20C,B01,083762,Staff,14,0,30,16
1650292592886,MATH 20C,B02,083763,Staff,28,0,30,2
1650292598922,MATH 20D,A01,083765,Staff,0,1,30,30
1650292598922,MATH 20D,A02,083766,Staff,8,0,30,22
1650292598922,MATH 20D,A03,083767,Staff,28,0,30,2
1650292604945,MATH 20E,A01,083771,Staff,6,0,30,24
1650292604945,MATH 20E,A02,083772,Staff,20,0,30,10
1650292604945,MATH 20E,B01,083773,Staff,0,0,30,30
1650292604945,MATH 20E,B02,083774,Staff,11,0,30,19
1650292610973,MATH 103A,A01,083777,Staff,0,10,30,30
1650292610973,MATH 103A,A02,083778,Staff,0,10,30,30
1650292610973,MATH 103A,B01,083779,Staff,0,10,30,30
1650292610973,MATH 103A,B02,083780,Staff,0,10,30,30
1650292616997,MATH 105,A01,085443,Staff,0,17,30,30
1650292623023,MATH 109,A01,083213,Anzaldo; Leesa B,0,5,30,30
1650292623023,MATH 109,A02,083214,Anzaldo; Leesa B,0,6,30,30
1650292623023,MATH 109,B01,083215,Anzaldo; Leesa B,0,4,30,30
1650292623023,MATH 109,B02,083216,Anzaldo; Leesa B,0,3,30,30
1650292629053,MATH 142A,A01,083219,Chow; Bennett,0,12,30,30
1650292629053,MATH 142A,A02,083220,Chow; Bennett,0,11,30,30
1650292629053,MATH 142A,B01,083221,Chow; Bennett,0,11,30,30
1650292629053,MATH 142A,B02,083222,Chow; Bennett,0,12,30,30
1650292635081,MATH 193A,A01,083224,Staff,0,5,30,30
1650292635081,MATH 193A,A02,083225,Staff,0,5,30,30
1650292635081,MATH 193A,A03,083781,Staff,0,2,30,30
1650292635081,MATH 193A,A04,083782,Staff,0,1,30,30
1650292641107,MATH 197,001,091859,McAuley; Julian John,9998,0,9999,1
1650292647164,COGS 9,A01,083615,Staff,0,14,60,60
1650292653192,COGS 11,A01,083617,Boyle; Mary E. T.,24,0,40,16
1650292659215,COGS 13,A01,083071,Staff,0,31,40,40
1650292665240,COGS 14A,A01,092681,Staff,0,15,100,100
1650292671267,COGS 14B,A01,083073,Cheng; Tzu-Han,0,9,50,50
1650292677293,COGS 17,A01,092677,Staff,29,0,75,46
1650292683320,COGS 100,A01,083619,Staff,0,23,60,60
1650292689352,COGS 101A,A01,083621,Davis; Joshua Daniel,0,21,60,60
1650292695379,COGS 101B,A01,091572,Staff,4,0,60,56
1650292701404,COGS 101C,A01,083625,Delgado; Tania,19,0,30,11
1650292707434,COGS 107A,A01,083627,Boyle; Mary E. T.,0,8,60,60
1650292713461,COGS 118A,A01,083075,Staff,12,0,60,48
1650292719487,CSE 3,A50,083646,Miranda; Gregory Joseph,21,0,38,17
1650292719487,CSE 3,A51,083647,Miranda; Gregory Joseph,37,0,37,0
1650292725511,CSE 8A,A50,083650,Miranda; Gregory Joseph,0,22,40,40
1650292731542,CSE 11,A01,083080,Cao; Yingjun,0,74,40,40
1650292737567,CSE 12,A01,083652,Staff,0,10,100,100
1650292743593,CSE 15L,A01,083654,Staff,0,1,50,50
1650292743593,CSE 15L,A02,083655,Staff,4,0,50,46
1650292749622,CSE 20,A01,083657,Staff,53,0,80,27
1650292755658,CSE 30,A01,083084,Eldon; John,0,73,40,40
1650292761682,CSE 100,A01,083659,Cao; Yingjun,0,65,50,50
1650292767707,CSE 134B,A01,083661,Powell; Thomas Allan,0,28,65,65
1650292773731,CSE 140,A01,083663,Staff,0,0,75,75
1650292779758,CSE 140L,A01,083088,Eldon; John,0,6,75,75
1650292785784,CSE 175,A01,083665,Kumar; Rakesh,8,0,25,17
1650292791811,CSE 190,A00,092507,Dubnov; Shlomo,14,0,20,6
1650292797834,ECE 45,A01,083139,Staff,0,15,40,40
1650292803862,ECE 65,A50,083695,Staff,0,4,30,30
1650292809887,ECE 109,A01,091882,Touri; Behrouz,43,0,70,27
1650292815924,ECE 180,A00,083140,Abi Samra; Nicholas Camill,24,0,30,6
1650292815924,ECE 180,B00,083141,Abi Samra; Nicholas Camill,7,0,30,23
1650292821957,MATH 10A,A01,083735,Patchell; Gregory David,11,0,30,19
1650292821957,MATH 10A,A02,083736,Patchell; Gregory David,28,0,30,2
1650292821957,MATH 10A,A03,083737,Patchell; Gregory David,26,0,30,4
1650292827985,MATH 10B,A01,083207,Staff,0,6,30,30
1650292827985,MATH 10B,A02,083208,Staff,0,6,30,30
1650292827985,MATH 10B,B01,083739,Staff,17,0,30,13
1650292827985,MATH 10B,B02,083740,Staff,29,0,30,1
1650292834011,MATH 18,A01,083743,Staff,7,0,30,23
1650292834011,MATH 18,A02,083744,Staff,27,0,30,3
1650292834011,MATH 18,A03,083745,Staff,23,0,30,7
1650292834011,MATH 18,A04,083746,Staff,27,0,30,3
1650292834011,MATH 18,B01,083748,Staff,0,11,30,30
1650292834011,MATH 18,B02,083749,Staff,0,9,30,30
1650292834011,MATH 18,B03,083750,Staff,1,8,30,29
1650292834011,MATH 18,B04,083751,Staff,0,9,30,30
1650292840043,MATH 20A,A01,083754,Staff,26,0,40,14
1650292846072,MATH 20B,A01,083756,Staff,0,5,30,30
1650292846072,MATH 20B,A02,083757,Staff,0,7,30,30
1650292852099,MATH 20C,A01,083760,Staff,0,13,30,30
1650292852099,MATH 20C,A02,083761,Staff,0,13,30,30
1650292852099,MATH 20C,B01,083762,Staff,14,0,30,16
1650292852099,MATH 20C,B02,083763,Staff,28,0,30,2
1650292858142,MATH 20D,A01,083765,Staff,0,1,30,30
1650292858142,MATH 20D,A02,083766,Staff,8,0,30,22
1650292858142,MATH 20D,A03,083767,Staff,28,0,30,2
1650292864255,MATH 20E,A01,083771,Staff,6,0,30,24
1650292864255,MATH 20E,A02,083772,Staff,20,0,30,10
1650292864255,MATH 20E,B01,083773,Staff,0,0,30,30
1650292864255,MATH 20E,B02,083774,Staff,11,0,30,19
1650292870289,MATH 103A,A01,083777,Staff,0,10,30,30
1650292870289,MATH 103A,A02,083778,Staff,0,10,30,30
1650292870289,MATH 103A,B01,083779,Staff,0,10,30,30
1650292870289,MATH 103A,B02,083780,Staff,0,10,30,30
1650292876314,MATH 105,A01,085443,Staff,0,17,30,30
1650292882339,MATH 109,A01,083213,Anzaldo; Leesa B,0,5,30,30
1650292882339,MATH 109,A02,083214,Anzaldo; Leesa B,0,6,30,30
1650292882339,MATH 109,B01,083215,Anzaldo; Leesa B,0,4,30,30
1650292882339,MATH 109,B02,083216,Anzaldo; Leesa B,0,3,30,30
1650292888363,MATH 142A,A01,083219,Chow; Bennett,0,12,30,30
1650292888363,MATH 142A,A02,083220,Chow; Bennett,0,11,30,30
1650292888363,MATH 142A,B01,083221,Chow; Bennett,0,11,30,30
1650292888363,MATH 142A,B02,083222,Chow; Bennett,0,12,30,30
1650292894388,MATH 193A,A01,083224,Staff,0,5,30,30
1650292894388,MATH 193A,A02,083225,Staff,0,5,30,30
1650292894388,MATH 193A,A03,083781,Staff,0,2,30,30
1650292894388,MATH 193A,A04,083782,Staff,0,1,30,30
1650292900414,MATH 197,001,091859,McAuley; Julian John,9998,0,9999,1
1650292906474,COGS 9,A01,083615,Staff,0,14,60,60
1650292912501,COGS 11,A01,083617,Boyle; Mary E. T.,24,0,40,16
1650292918529,COGS 13,A01,083071,Staff,0,31,40,40
1650292924553,COGS 14A,A01,092681,Staff,0,15,100,100
1650292930577,COGS 14B,A01,083073,Cheng; Tzu-Han,0,9,50,50
1650292936615,COGS 17,A01,092677,Staff,29,0,75,46
1650292942643,COGS 100,A01,083619,Staff,0,23,60,60
1650292948666,COGS 101A,A01,083621,Davis; Joshua Daniel,0,21,60,60
1650292954689,COGS 101B,A01,091572,Staff,4,0,60,56
1650292960713,COGS 101C,A01,083625,Delgado; Tania,19,0,30,11
1650292966741,COGS 107A,A01,083627,Boyle; Mary E. T.,0,8,60,60
1650292972767,COGS 118A,A01,083075,Staff,12,0,60,48
1650292978798,CSE 3,A50,083646,Miranda; Gregory Joseph,21,0,38,17
1650292978798,CSE 3,A51,083647,Miranda; Gregory Joseph,37,0,37,0
1650292984821,CSE 8A,A50,083650,Miranda; Gregory Joseph,0,22,40,40
1650292990845,CSE 11,A01,083080,Cao; Yingjun,0,74,40,40
1650292996881,CSE 12,A01,083652,Staff,0,10,100,100
1650293002906,CSE 15L,A01,083654,Staff,0,1,50,50
1650293002906,CSE 15L,A02,083655,Staff,4,0,50,46
1650293008943,CSE 20,A01,083657,Staff,53,0,80,27
1650293014974,CSE 30,A01,083084,Eldon; John,0,73,40,40
1650293021001,CSE 100,A01,083659,Cao; Yingjun,0,65,50,50
1650293027027,CSE 134B,A01,083661,Powell; Thomas Allan,0,28,65,65
1650293033052,CSE 140,A01,083663,Staff,0,0,75,75
1650293039080,CSE 140L,A01,083088,Eldon; John,0,6,75,75
1650293045108,CSE 175,A01,083665,Kumar; Rakesh,8,0,25,17
1650293051140,CSE 190,A00,092507,Dubnov; Shlomo,14,0,20,6
1650293057166,ECE 45,A01,083139,Staff,0,15,40,40
1650293063190,ECE 65,A50,083695,Staff,0,4,30,30
1650293069214,ECE 109,A01,091882,Touri; Behrouz,43,0,70,27
1650293075251,ECE 180,A00,083140,Abi Samra; Nicholas Camill,24,0,30,6
1650293075251,ECE 180,B00,083141,Abi Samra; Nicholas Camill,7,0,30,23
1650293081276,MATH 10A,A01,083735,Patchell; Gregory David,11,0,30,19
1650293081276,MATH 10A,A02,083736,Patchell; Gregory David,28,0,30,2
1650293081276,MATH 10A,A03,083737,Patchell; Gregory David,26,0,30,4
1650293087300,MATH 10B,A01,083207,Staff,0,6,30,30
1650293087300,MATH 10B,A02,083208,Staff,0,6,30,30
1650293087300,MATH 10B,B01,083739,Staff,17,0,30,13
1650293087300,MATH 10B,B02,083740,Staff,29,0,30,1
1650293093331,MATH 18,A01,083743,Staff,7,0,30,23
1650293093331,MATH 18,A02,083744,Staff,27,0,30,3
1650293093331,MATH 18,A03,083745,Staff,23,0,30,7
1650293093331,MATH 18,A04,083746,Staff,27,0,30,3
1650293093331,MATH 18,B01,083748,Staff,0,11,30,30
1650293093331,MATH 18,B02,083749,Staff,0,9,30,30
1650293093331,MATH 18,B03,083750,Staff,1,8,30,29
1650293093331,MATH 18,B04,083751,Staff,0,9,30,30
1650293099358,MATH 20A,A01,083754,Staff,26,0,40,14
1650293105385,MATH 20B,A01,083756,Staff,0,5,30,30
1650293105385,MATH 20B,A02,083757,Staff,0,7,30,30
1650293111409,MATH 20C,A01,083760,Staff,0,13,30,30
1650293111409,MATH 20C,A02,083761,Staff,0,13,30,30
1650293111409,MATH 20C,B01,083762,Staff,14,0,30,16
1650293111409,MATH 20C,B02,083763,Staff,28,0,30,2
1650293117444,MATH 20D,A01,083765,Staff,0,1,30,30
1650293117444,MATH 20D,A02,083766,Staff,8,0,30,22
1650293117444,MATH 20D,A03,083767,Staff,28,0,30,2
1650293123472,MATH 20E,A01,083771,Staff,6,0,30,24
1650293123472,MATH 20E,A02,083772,Staff,20,0,30,10
1650293123472,MATH 20E,B01,083773,Staff,0,0,30,30
1650293123472,MATH 20E,B02,083774,Staff,11,0,30,19
1650293129510,MATH 103A,A01,083777,Staff,0,10,30,30
1650293129510,MATH 103A,A02,083778,Staff,0,10,30,30
1650293129510,MATH 103A,B01,083779,Staff,0,10,30,30
1650293129510,MATH 103A,B02,083780,Staff,0,10,30,30
1650293135538,MATH 105,A01,085443,Staff,0,17,30,30
1650293141567,MATH 109,A01,083213,Anzaldo; Leesa B,0,5,30,30
1650293141567,MATH 109,A02,083214,Anzaldo; Leesa B,0,6,30,30
1650293141567,MATH 109,B01,083215,Anzaldo; Leesa B,0,4,30,30
1650293141567,MATH 109,B02,083216,Anzaldo; Leesa B,0,3,30,30
1650293147601,MATH 142A,A01,083219,Chow; Bennett,0,12,30,30
1650293147601,MATH 142A,A02,083220,Chow; Bennett,0,11,30,30
1650293147601,MATH 142A,B01,083221,Chow; Bennett,0,11,30,30
1650293147601,MATH 142A,B02,083222,Chow; Bennett,0,12,30,30
1650293153629,MATH 193A,A01,083224,Staff,0,5,30,30
1650293153629,MATH 193A,A02,083225,Staff,0,5,30,30
1650293153629,MATH 193A,A03,083781,Staff,0,2,30,30
1650293153629,MATH 193A,A04,083782,Staff,0,1,30,30
1650293159654,MATH 197,001,091859,McAuley; Julian John,9998,0,9999,1
1650293165725,COGS 9,A01,083615,Staff,0,14,60,60
1650293171750,COGS 11,A01,083617,Boyle; Mary E. T.,24,0,40,16
1650293177778,COGS 13,A01,083071,Staff,0,31,40,40
1650293183805,COGS 14A,A01,092681,Staff,0,15,100,100
1650293189829,COGS 14B,A01,083073,Cheng; Tzu-Han,0,9,50,50
1650293195855,COGS 17,A01,092677,Staff,29,0,75,46
1650293201882,COGS 100,A01,083619,Staff,0,23,60,60
1650293207905,COGS 101A,A01,083621,Davis; Joshua Daniel,0,21,60,60
1650293213930,COGS 101B,A01,091572,Staff,4,0,60,56
1650293219961,COGS 101C,A01,083625,Delgado; Tania,19,0,30,11
1650293225987,COGS 107A,A01,083627,Boyle; Mary E. T.,0,8,60,60
1650293232014,COGS 118A,A01,083075,Staff,12,0,60,48
1650293238042,CSE 3,A50,083646,Miranda; Gregory Joseph,21,0,38,17
1650293238042,CSE 3,A51,083647,Miranda; Gregory Joseph,37,0,37,0
1650293244070,CSE 8A,A50,083650,Miranda; Gregory Joseph,0,22,40,40
1650293250098,CSE 11,A01,083080,Cao; Yingjun,0,74,40,40
1650293256123,CSE 12,A01,083652,Staff,0,10,100,100
1650293262150,CSE 15L,A01,083654,Staff,0,1,50,50
1650293262150,CSE 15L,A02,083655,Staff,4,0,50,46
1650293268175,CSE 20,A01,083657,Staff,53,0,80,27
1650293274204,CSE 30,A01,083084,Eldon; John,0,73,40,40
1650293280233,CSE 100,A01,083659,Cao; Yingjun,0,65,50,50
1650293286257,CSE 134B,A01,083661,Powell; Thomas Allan,0,28,65,65
1650293292282,CSE 140,A01,083663,Staff,0,0,75,75
1650293298308,CSE 140L,A01,083088,Eldon; John,0,6,75,75
1650293304336,CSE 175,A01,083665,Kumar; Rakesh,8,0,25,17
1650293310360,CSE 190,A00,092507,Dubnov; Shlomo,14,0,20,6
1650293316386,ECE 45,A01,083139,Staff,0,15,40,40
1650293322413,ECE 65,A50,083695,Staff,0,4,30,30
1650293328437,ECE 109,A01,091882,Touri; Behrouz,43,0,70,27
1650293334468,ECE 180,A00,083140,Abi Samra; Nicholas Camill,24,0,30,6
1650293334468,ECE 180,B00,083141,Abi Samra; Nicholas Camill,7,0,30,23
1650293340494,MATH 10A,A01,083735,Patchell; Gregory David,11,0,30,19
1650293340494,MATH 10A,A02,083736,Patchell; Gregory David,28,0,30,2
1650293340494,MATH 10A,A03,083737,Patchell; Gregory David,26,0,30,4
1650293346517,MATH 10B,A01,083207,Staff,0,6,30,30
1650293346517,MATH 10B,A02,083208,Staff,0,6,30,30
1650293346517,MATH 10B,B01,083739,Staff,17,0,30,13
1650293346517,MATH 10B,B02,083740,Staff,29,0,30,1
1650293352544,MATH 18,A01,083743,Staff,7,0,30,23
1650293352544,MATH 18,A02,083744,Staff,27,0,30,3
1650293352544,MATH 18,A03,083745,Staff,23,0,30,7
1650293352544,MATH 18,A04,083746,Staff,27,0,30,3
1650293352544,MATH 18,B01,083748,Staff,0,11,30,30
1650293352544,MATH 18,B02,083749,Staff,0,9,30,30
1650293352544,MATH 18,B03,083750,Staff,1,8,30,29
1650293352544,MATH 18,B04,083751,Staff,0,9,30,30
1650293358566,MATH 20A,A01,083754,Staff,26,0,40,14
1650293364593,MATH 20B,A01,083756,Staff,0,5,30,30
1650293364593,MATH 20B,A02,083757,Staff,0,7,30,30
1650293370616,MATH 20C,A01,083760,Staff,0,13,30,30
1650293370616,MATH 20C,A02,083761,Staff,0,13,30,30
1650293370616,MATH 20C,B01,083762,Staff,14,0,30,16
1650293370616,MATH 20C,B02,083763,Staff,28,0,30,2
1650293376644,MATH 20D,A01,083765,Staff,0,1,30,30
1650293376644,MATH 20D,A02,083766,Staff,8,0,30,22
1650293376644,MATH 20D,A03,083767,Staff,28,0,30,2
1650293382667,MATH 20E,A01,083771,Staff,6,0,30,24
1650293382667,MATH 20E,A02,083772,Staff,20,0,30,10
1650293382667,MATH 20E,B01,083773,Staff,0,0,30,30
1650293382667,MATH 20E,B02,083774,Staff,11,0,30,19
1650293388697,MATH 103A,A01,083777,Staff,0,10,30,30
1650293388697,MATH 103A,A02,083778,Staff,0,10,30,30
1650293388697,MATH 103A,B01,083779,Staff,0,10,30,30
1650293388697,MATH 103A,B02,083780,Staff,0,10,30,30
1650293394721,MATH 105,A01,085443,Staff,0,17,30,30
1650293400748,MATH 109,A01,083213,Anzaldo; Leesa B,0,5,30,30
1650293400748,MATH 109,A02,083214,Anzaldo; Leesa B,0,6,30,30
1650293400748,MATH 109,B01,083215,Anzaldo; Leesa B,0,4,30,30
1650293400748,MATH 109,B02,083216,Anzaldo; Leesa B,0,3,30,30
1650293406775,MATH 142A,A01,083219,Chow; Bennett,0,12,30,30
1650293406775,MATH 142A,A02,083220,Chow; Bennett,0,11,30,30
1650293406775,MATH 142A,B01,083221,Chow; Bennett,0,11,30,30
1650293406775,MATH 142A,B02,083222,Chow; Bennett,0,12,30,30
1650293412810,MATH 193A,A01,083224,Staff,0,5,30,30
1650293412810,MATH 193A,A02,083225,Staff,0,5,30,30
1650293412810,MATH 193A,A03,083781,Staff,0,2,30,30
1650293412810,MATH 193A,A04,083782,Staff,0,1,30,30
1650293418837,MATH 197,001,091859,McAuley; Julian John,9998,0,9999,1
1650293424894,COGS 9,A01,083615,Staff,0,14,60,60
1650293430918,COGS 11,A01,083617,Boyle; Mary E. T.,24,0,40,16
1650293436942,COGS 13,A01,083071,Staff,0,31,40,40
1650293442974,COGS 14A,A01,092681,Staff,0,15,100,100
1650293449002,COGS 14B,A01,083073,Cheng; Tzu-Han,0,9,50,50
1650293455122,COGS 17,A01,092677,Staff,29,0,75,46
1650293461146,COGS 100,A01,083619,Staff,0,23,60,60
1650293467174,COGS 101A,A01,083621,Davis; Joshua Daniel,0,21,60,60
1650293473209,COGS 101B,A01,091572,Staff,4,0,60,56
1650293479234,COGS 101C,A01,083625,Delgado; Tania,19,0,30,11
1650293485266,COGS 107A,A01,083627,Boyle; Mary E. T.,0,8,60,60
1650293491293,COGS 118A,A01,083075,Staff,12,0,60,48
1650293497315,CSE 3,A50,083646,Miranda; Gregory Joseph,21,0,38,17
1650293497315,CSE 3,A51,083647,Miranda; Gregory Joseph,37,0,37,0
1650293503346,CSE 8A,A50,083650,Miranda; Gregory Joseph,0,22,40,40
1650293509373,CSE 11,A01,083080,Cao; Yingjun,0,74,40,40
1650293515397,CSE 12,A01,083652,Staff,0,10,100,100
1650293521424,CSE 15L,A01,083654,Staff,0,1,50,50
1650293521424,CSE 15L,A02,083655,Staff,4,0,50,46
1650293527449,CSE 20,A01,083657,Staff,53,0,80,27
1650293533477,CSE 30,A01,083084,Eldon; John,0,73,40,40
1650293539500,CSE 100,A01,083659,Cao; Yingjun,0,65,50,50
1650293545525,CSE 134B,A01,083661,Powell; Thomas Allan,0,28,65,65
1650293551551,CSE 140,A01,083663,Staff,0,0,75,75
1650293557578,CSE 140L,A01,083088,Eldon; John,0,6,75,75
1650293563617,CSE 175,A01,083665,Kumar; Rakesh,8,0,25,17
1650293569646,CSE 190,A00,092507,Dubnov; Shlomo,14,0,20,6
1650293575674,ECE 45,A01,083139,Staff,0,15,40,40
1650293581698,ECE 65,A50,083695,Staff,0,4,30,30
1650293587720,ECE 109,A01,091882,Touri; Behrouz,43,0,70,27
1650293593744,ECE 180,A00,083140,Abi Samra; Nicholas Camill,24,0,30,6
1650293593744,ECE 180,B00,083141,Abi Samra; Nicholas Camill,7,0,30,23
1650293599769,MATH 10A,A01,083735,Patchell; Gregory David,11,0,30,19
1650293599769,MATH 10A,A02,083736,Patchell; Gregory David,28,0,30,2
1650293599769,MATH 10A,A03,083737,Patchell; Gregory David,26,0,30,4
1650293605792,MATH 10B,A01,083207,Staff,0,6,30,30
1650293605792,MATH 10B,A02,083208,Staff,0,6,30,30
1650293605792,MATH 10B,B01,083739,Staff,17,0,30,13
1650293605792,MATH 10B,B02,083740,Staff,29,0,30,1
1650293611825,MATH 18,A01,083743,Staff,7,0,30,23
1650293611825,MATH 18,A02,083744,Staff,27,0,30,3
1650293611825,MATH 18,A03,083745,Staff,23,0,30,7
1650293611825,MATH 18,A04,083746,Staff,27,0,30,3
1650293611825,MATH 18,B01,083748,Staff,0,11,30,30
1650293611825,MATH 18,B02,083749,Staff,0,9,30,30
1650293611825,MATH 18,B03,083750,Staff,1,8,30,29
1650293611825,MATH 18,B04,083751,Staff,0,9,30,30
1650293617850,MATH 20A,A01,083754,Staff,26,0,40,14
1650293623878,MATH 20B,A01,083756,Staff,0,5,30,30
1650293623878,MATH 20B,A02,083757,Staff,0,7,30,30
1650293629904,MATH 20C,A01,083760,Staff,0,13,30,30
1650293629904,MATH 20C,A02,083761,Staff,0,13,30,30
1650293629904,MATH 20C,B01,083762,Staff,14,0,30,16
1650293629904,MATH 20C,B02,083763,Staff,28,0,30,2
1650293635928,MATH 20D,A01,083765,Staff,0,1,30,30
1650293635928,MATH 20D,A02,083766,Staff,8,0,30,22
1650293635928,MATH 20D,A03,083767,Staff,28,0,30,2
1650293641955,MATH 20E,A01,083771,Staff,5,0,30,25
1650293641955,MATH 20E,A02,083772,Staff,20,0,30,10
1650293641955,MATH 20E,B01,083773,Staff,0,0,30,30
1650293641955,MATH 20E,B02,083774,Staff,11,0,30,19
1650293647984,MATH 103A,A01,083777,Staff,0,10,30,30
1650293647984,MATH 103A,A02,083778,Staff,0,10,30,30
1650293647984,MATH 103A,B01,083779,Staff,0,10,30,30
1650293647984,MATH 103A,B02,083780,Staff,0,10,30,30
1650293654015,MATH 105,A01,085443,Staff,0,17,30,30
1650293660041,MATH 109,A01,083213,Anzaldo; Leesa B,0,5,30,30
1650293660041,MATH 109,A02,083214,Anzaldo; Leesa B,0,6,30,30
1650293660041,MATH 109,B01,083215,Anzaldo; Leesa B,0,4,30,30
1650293660041,MATH 109,B02,083216,Anzaldo; Leesa B,0,3,30,30
1650293666066,MATH 142A,A01,083219,Chow; Bennett,0,12,30,30
1650293666066,MATH 142A,A02,083220,Chow; Bennett,0,11,30,30
1650293666066,MATH 142A,B01,083221,Chow; Bennett,0,11,30,30
1650293666066,MATH 142A,B02,083222,Chow; Bennett,0,12,30,30
1650293672091,MATH 193A,A01,083224,Staff,0,5,30,30
1650293672091,MATH 193A,A02,083225,Staff,0,5,30,30
1650293672091,MATH 193A,A03,083781,Staff,0,2,30,30
1650293672091,MATH 193A,A04,083782,Staff,0,1,30,30
1650293678115,MATH 197,001,091859,McAuley; Julian John,9998,0,9999,1
1650293684174,COGS 9,A01,083615,Staff,0,14,60,60
1650293690213,COGS 11,A01,083617,Boyle; Mary E. T.,24,0,40,16
1650293696239,COGS 13,A01,083071,Staff,0,31,40,40
1650293702262,COGS 14A,A01,092681,Staff,0,15,100,100
1650293708287,COGS 14B,A01,083073,Cheng; Tzu-Han,0,9,50,50
1650293714314,COGS 17,A01,092677,Staff,28,0,75,47
1650293720341,COGS 100,A01,083619,Staff,0,23,60,60
1650293726374,COGS 101A,A01,083621,Davis; Joshua Daniel,0,21,60,60
1650293732400,COGS 101B,A01,091572,Staff,4,0,60,56
1650293738423,COGS 101C,A01,083625,Delgado; Tania,19,0,30,11
1650293744455,COGS 107A,A01,083627,Boyle; Mary E. T.,0,8,60,60
1650293750478,COGS 118A,A01,083075,Staff,12,0,60,48
1650293756505,CSE 3,A50,083646,Miranda; Gregory Joseph,21,0,38,17
1650293756505,CSE 3,A51,083647,Miranda; Gregory Joseph,37,0,37,0
1650293762530,CSE 8A,A50,083650,Miranda; Gregory Joseph,0,22,40,40
1650293768558,CSE 11,A01,083080,Cao; Yingjun,0,74,40,40
1650293774582,CSE 12,A01,083652,Staff,0,10,100,100
1650293780610,CSE 15L,A01,083654,Staff,0,1,50,50
1650293780610,CSE 15L,A02,083655,Staff,4,0,50,46
1650293786643,CSE 20,A01,083657,Staff,53,0,80,27
1650293792670,CSE 30,A01,083084,Eldon; John,0,73,40,40
1650293798699,CSE 100,A01,083659,Cao; Yingjun,0,65,50,50
1650293804725,CSE 134B,A01,083661,Powell; Thomas Allan,0,28,65,65
1650293810758,CSE 140,A01,083663,Staff,0,0,75,75
1650293816783,CSE 140L,A01,083088,Eldon; John,0,6,75,75
1650293822807,CSE 175,A01,083665,Kumar; Rakesh,8,0,25,17
1650293828831,CSE 190,A00,092507,Dubnov; Shlomo,14,0,20,6
1650293834864,ECE 45,A01,083139,Staff,0,15,40,40
1650293840889,ECE 65,A50,083695,Staff,0,4,30,30
1650293846915,ECE 109,A01,091882,Touri; Behrouz,43,0,70,27
1650293852939,ECE 180,A00,083140,Abi Samra; Nicholas Camill,24,0,30,6
1650293852939,ECE 180,B00,083141,Abi Samra; Nicholas Camill,7,0,30,23
1650293858966,MATH 10A,A01,083735,Patchell; Gregory David,11,0,30,19
1650293858966,MATH 10A,A02,083736,Patchell; Gregory David,28,0,30,2
1650293858966,MATH 10A,A03,083737,Patchell; Gregory David,26,0,30,4
1650293864990,MATH 10B,A01,083207,Staff,0,6,30,30
1650293864990,MATH 10B,A02,083208,Staff,0,6,30,30
1650293864990,MATH 10B,B01,083739,Staff,17,0,30,13
1650293864990,MATH 10B,B02,083740,Staff,29,0,30,1
1650293871024,MATH 18,A01,083743,Staff,7,0,30,23
1650293871024,MATH 18,A02,083744,Staff,26,0,30,4
1650293871024,MATH 18,A03,083745,Staff,23,0,30,7
1650293871024,MATH 18,A04,083746,Staff,27,0,30,3
1650293871024,MATH 18,B01,083748,Staff,0,11,30,30
1650293871024,MATH 18,B02,083749,Staff,0,9,30,30
1650293871024,MATH 18,B03,083750,Staff,1,8,30,29
1650293871024,MATH 18,B04,083751,Staff,0,10,30,30
1650293877062,MATH 20A,A01,083754,Staff,25,0,40,15
1650293883086,MATH 20B,A01,083756,Staff,0,5,30,30
1650293883086,MATH 20B,A02,083757,Staff,0,7,30,30
1650293889125,MATH 20C,A01,083760,Staff,0,13,30,30
1650293889125,MATH 20C,A02,083761,Staff,0,13,30,30
1650293889125,MATH 20C,B01,083762,Staff,14,0,30,16
1650293889125,MATH 20C,B02,083763,Staff,27,0,30,3
1650293895149,MATH 20D,A01,083765,Staff,0,1,30,30
1650293895149,MATH 20D,A02,083766,Staff,8,0,30,22
1650293895149,MATH 20D,A03,083767,Staff,28,0,30,2
1650293901174,MATH 20E,A01,083771,Staff,5,0,30,25
1650293901174,MATH 20E,A02,083772,Staff,20,0,30,10
1650293901174,MATH 20E,B01,083773,Staff,0,0,30,30
1650293901174,MATH 20E,B02,083774,Staff,11,0,30,19
1650293907200,MATH 103A,A01,083777,Staff,0,10,30,30
1650293907200,MATH 103A,A02,083778,Staff,0,10,30,30
1650293907200,MATH 103A,B01,083779,Staff,0,10,30,30
1650293907200,MATH 103A,B02,083780,Staff,0,10,30,30
1650293913225,MATH 105,A01,085443,Staff,0,17,30,30
1650293919267,MATH 109,A01,083213,Anzaldo; Leesa B,0,5,30,30
1650293919267,MATH 109,A02,083214,Anzaldo; Leesa B,0,6,30,30
1650293919267,MATH 109,B01,083215,Anzaldo; Leesa B,0,4,30,30
1650293919267,MATH 109,B02,083216,Anzaldo; Leesa B,0,3,30,30
1650293925293,MATH 142A,A01,083219,Chow; Bennett,0,12,30,30
1650293925293,MATH 142A,A02,083220,Chow; Bennett,0,11,30,30
1650293925293,MATH 142A,B01,083221,Chow; Bennett,0,11,30,30
1650293925293,MATH 142A,B02,083222,Chow; Bennett,0,12,30,30
1650293931323,MATH 193A,A01,083224,Staff,0,5,30,30
1650293931323,MATH 193A,A02,083225,Staff,0,5,30,30
1650293931323,MATH 193A,A03,083781,Staff,0,2,30,30
1650293931323,MATH 193A,A04,083782,Staff,0,1,30,30
1650293937348,MATH 197,001,091859,McAuley; Julian John,9998,0,9999,1
1650293943424,COGS 9,A01,083615,Staff,0,14,60,60
1650293949449,COGS 11,A01,083617,Boyle; Mary E. T.,23,0,40,17
1650293955475,COGS 13,A01,083071,Staff,0,31,40,40
1650293961507,COGS 14A,A01,092681,Staff,0,16,100,100
1650293967531,COGS 14B,A01,083073,Cheng; Tzu-Han,0,9,50,50
1650293973561,COGS 17,A01,092677,Staff,27,0,75,48
1650293979584,COGS 100,A01,083619,Staff,0,23,60,60
1650293985611,COGS 101A,A01,083621,Davis; Joshua Daniel,0,21,60,60
1650293991634,COGS 101B,A01,091572,Staff,4,0,60,56
1650293997658,COGS 101C,A01,083625,Delgado; Tania,19,0,30,11
1650294003686,COGS 107A,A01,083627,Boyle; Mary E. T.,0,8,60,60
1650294009719,COGS 118A,A01,083075,Staff,12,0,60,48
1650294015748,CSE 3,A50,083646,Miranda; Gregory Joseph,21,0,38,17
1650294015748,CSE 3,A51,083647,Miranda; Gregory Joseph,37,0,37,0
1650294021780,CSE 8A,A50,083650,Miranda; Gregory Joseph,0,22,40,40
1650294027806,CSE 11,A01,083080,Cao; Yingjun,0,75,40,40
1650294033842,CSE 12,A01,083652,Staff,0,10,100,100
1650294039866,CSE 15L,A01,083654,Staff,0,1,50,50
1650294039866,CSE 15L,A02,083655,Staff,4,0,50,46
1650294045904,CSE 20,A01,083657,Staff,53,0,80,27
1650294052000,CSE 30,A01,083084,Eldon; John,0,73,40,40
1650294058024,CSE 100,A01,083659,Cao; Yingjun,0,65,50,50
1650294064051,CSE 134B,A01,083661,Powell; Thomas Allan,0,29,65,65
1650294070078,CSE 140,A01,083663,Staff,0,0,75,75
1650294076106,CSE 140L,A01,083088,Eldon; John,0,6,75,75
1650294082130,CSE 175,A01,083665,Kumar; Rakesh,8,0,25,17
1650294088159,CSE 190,A00,092507,Dubnov; Shlomo,14,0,20,6
1650294094187,ECE 45,A01,083139,Staff,0,15,40,40
1650294100210,ECE 65,A50,083695,Staff,0,4,30,30
1650294106237,ECE 109,A01,091882,Touri; Behrouz,43,0,70,27
1650294112265,ECE 180,A00,083140,Abi Samra; Nicholas Camill,24,0,30,6
1650294112265,ECE 180,B00,083141,Abi Samra; Nicholas Camill,7,0,30,23
1650294118291,MATH 10A,A01,083735,Patchell; Gregory David,11,0,30,19
1650294118291,MATH 10A,A02,083736,Patchell; Gregory David,28,0,30,2
1650294118291,MATH 10A,A03,083737,Patchell; Gregory David,26,0,30,4
1650294124325,MATH 10B,A01,083207,Staff,0,6,30,30
1650294124325,MATH 10B,A02,083208,Staff,0,6,30,30
1650294124325,MATH 10B,B01,083739,Staff,17,0,30,13
1650294124325,MATH 10B,B02,083740,Staff,29,0,30,1
1650294130351,MATH 18,A01,083743,Staff,6,0,30,24
1650294130351,MATH 18,A02,083744,Staff,26,0,30,4
1650294130351,MATH 18,A03,083745,Staff,23,0,30,7
1650294130351,MATH 18,A04,083746,Staff,27,0,30,3
1650294130351,MATH 18,B01,083748,Staff,0,11,30,30
1650294130351,MATH 18,B02,083749,Staff,0,10,30,30
1650294130351,MATH 18,B03,083750,Staff,1,8,30,29
1650294130351,MATH 18,B04,083751,Staff,0,10,30,30
1650294136375,MATH 20A,A01,083754,Staff,25,0,40,15
1650294142397,MATH 20B,A01,083756,Staff,0,5,30,30
1650294142397,MATH 20B,A02,083757,Staff,0,7,30,30
1650294148425,MATH 20C,A01,083760,Staff,0,13,30,30
1650294148425,MATH 20C,A02,083761,Staff,0,13,30,30
1650294148425,MATH 20C,B01,083762,Staff,14,0,30,16
1650294148425,MATH 20C,B02,083763,Staff,28,0,30,2
1650294154455,MATH 20D,A01,083765,Staff,0,1,30,30
1650294154455,MATH 20D,A02,083766,Staff,8,0,30,22
1650294154455,MATH 20D,A03,083767,Staff,28,0,30,2
1650294160492,MATH 20E,A01,083771,Staff,5,0,30,25
1650294160492,MATH 20E,A02,083772,Staff,20,0,30,10
1650294160492,MATH 20E,B01,083773,Staff,0,0,30,30
1650294160492,MATH 20E,B02,083774,Staff,11,0,30,19
1650294166519,MATH 103A,A01,083777,Staff,0,11,30,30
1650294166519,MATH 103A,A02,083778,Staff,0,10,30,30
1650294166519,MATH 103A,B01,083779,Staff,0,10,30,30
1650294166519,MATH 103A,B02,083780,Staff,0,10,30,30
1650294172544,MATH 105,A01,085443,Staff,0,17,30,30
1650294178576,MATH 109,A01,083213,Anzaldo; Leesa B,0,5,30,30
1650294178576,MATH 109,A02,083214,Anzaldo; Leesa B,0,6,30,30
1650294178576,MATH 109,B01,083215,Anzaldo; Leesa B,0,4,30,30
1650294178576,MATH 109,B02,083216,Anzaldo; Leesa B,0,3,30,30
1650294184603,MATH 142A,A01,083219,Chow; Bennett,0,12,30,30
1650294184603,MATH 142A,A02,083220,Chow; Bennett,0,11,30,30
1650294184603,MATH 142A,B01,083221,Chow; Bennett,0,11,30,30
1650294184603,MATH 142A,B02,083222,Chow; Bennett,0,12,30,30
1650294190628,MATH 193A,A01,083224,Staff,0,5,30,30
1650294190628,MATH 193A,A02,083225,Staff,0,5,30,30
1650294190628,MATH 193A,A03,083781,Staff,0,2,30,30
1650294190628,MATH 193A,A04,083782,Staff,0,1,30,30
1650294196652,MATH 197,001,091859,McAuley; Julian John,9998,0,9999,1
1650294202702,COGS 9,A01,083615,Staff,0,14,60,60
1650294208726,COGS 11,A01,083617,Boyle; Mary E. T.,23,0,40,17
1650294214750,COGS 13,A01,083071,Staff,0,31,40,40
1650294220774,COGS 14A,A01,092681,Staff,0,16,100,100
1650294226804,COGS 14B,A01,083073,Cheng; Tzu-Han,0,9,50,50
1650294232830,COGS 17,A01,092677,Staff,27,0,75,48
1650294238858,COGS 100,A01,083619,Staff,0,23,60,60
1650294244883,COGS 101A,A01,083621,Davis; Joshua Daniel,0,21,60,60
1650294250916,COGS 101B,A01,091572,Staff,4,0,60,56
1650294256941,COGS 101C,A01,083625,Delgado; Tania,19,0,30,11
1650294262967,COGS 107A,A01,083627,Boyle; Mary E. T.,0,8,60,60
1650294268990,COGS 118A,A01,083075,Staff,12,0,60,48
1650294275034,CSE 3,A50,083646,Miranda; Gregory Joseph,21,0,38,17
1650294275034,CSE 3,A51,083647,Miranda; Gregory Joseph,37,0,37,0
1650294281058,CSE 8A,A50,083650,Miranda; Gregory Joseph,0,23,40,40
1650294287085,CSE 11,A01,083080,Cao; Yingjun,0,78,40,40
1650294293111,CSE 12,A01,083652,Staff,0,10,100,100
1650294299136,CSE 15L,A01,083654,Staff,0,1,50,50
1650294299136,CSE 15L,A02,083655,Staff,4,0,50,46
1650294305161,CSE 20,A01,083657,Staff,53,0,80,27
1650294311190,CSE 30,A01,083084,Eldon; John,0,73,40,40
1650294317218,CSE 100,A01,083659,Cao; Yingjun,0,65,50,50
1650294323243,CSE 134B,A01,083661,Powell; Thomas Allan,0,29,65,65
1650294329269,CSE 140,A01,083663,Staff,0,0,75,75
1650294335291,CSE 140L,A01,083088,Eldon; John,0,6,75,75
1650294341315,CSE 175,A01,083665,Kumar; Rakesh,8,0,25,17
1650294347338,CSE 190,A00,092507,Dubnov; Shlomo,14,0,20,6
1650294353368,ECE 45,A01,083139,Staff,0,15,40,40
1650294359393,ECE 65,A50,083695,Staff,0,4,30,30
1650294365419,ECE 109,A01,091882,Touri; Behrouz,43,0,70,27
1650294371444,ECE 180,A00,083140,Abi Samra; Nicholas Camill,24,0,30,6
1650294371444,ECE 180,B00,083141,Abi Samra; Nicholas Camill,7,0,30,23
1650294377467,MATH 10A,A01,083735,Patchell; Gregory David,11,0,30,19
1650294377467,MATH 10A,A02,083736,Patchell; Gregory David,28,0,30,2
1650294377467,MATH 10A,A03,083737,Patchell; Gregory David,26,0,30,4
1650294383492,MATH 10B,A01,083207,Staff,0,6,30,30
1650294383492,MATH 10B,A02,083208,Staff,0,6,30,30
1650294383492,MATH 10B,B01,083739,Staff,17,0,30,13
1650294383492,MATH 10B,B02,083740,Staff,29,0,30,1
1650294389536,MATH 18,A01,083743,Staff,6,0,30,24
1650294389536,MATH 18,A02,083744,Staff,26,0,30,4
1650294389536,MATH 18,A03,083745,Staff,23,0,30,7
1650294389536,MATH 18,A04,083746,Staff,27,0,30,3
1650294389536,MATH 18,B01,083748,Staff,0,11,30,30
1650294389536,MATH 18,B02,083749,Staff,0,10,30,30
1650294389536,MATH 18,B03,083750,Staff,1,8,30,29
1650294389536,MATH 18,B04,083751,Staff,0,10,30,30
1650294395560,MATH 20A,A01,083754,Staff,25,0,40,15
1650294401592,MATH 20B,A01,083756,Staff,0,5,30,30
1650294401592,MATH 20B,A02,083757,Staff,0,7,30,30
1650294407616,MATH 20C,A01,083760,Staff,0,13,30,30
1650294407616,MATH 20C,A02,083761,Staff,0,14,30,30
1650294407616,MATH 20C,B01,083762,Staff,14,0,30,16
1650294407616,MATH 20C,B02,083763,Staff,28,0,30,2
1650294413651,MATH 20D,A01,083765,Staff,0,1,30,30
1650294413651,MATH 20D,A02,083766,Staff,8,0,30,22
1650294413651,MATH 20D,A03,083767,Staff,28,0,30,2
1650294419680,MATH 20E,A01,083771,Staff,5,0,30,25
1650294419680,MATH 20E,A02,083772,Staff,20,0,30,10
1650294419680,MATH 20E,B01,083773,Staff,0,0,30,30
1650294419680,MATH 20E,B02,083774,Staff,11,0,30,19
1650294425708,MATH 103A,A01,083777,Staff,0,11,30,30
1650294425708,MATH 103A,A02,083778,Staff,0,10,30,30
1650294425708,MATH 103A,B01,083779,Staff,0,10,30,30
1650294425708,MATH 103A,B02,083780,Staff,0,10,30,30
1650294431733,MATH 105,A01,085443,Staff,0,17,30,30
1650294437761,MATH 109,A01,083213,Anzaldo; Leesa B,0,5,30,30
1650294437761,MATH 109,A02,083214,Anzaldo; Leesa B,0,6,30,30
1650294437761,MATH 109,B01,083215,Anzaldo; Leesa B,0,4,30,30
1650294437761,MATH 109,B02,083216,Anzaldo; Leesa B,0,3,30,30
1650294443792,MATH 142A,A01,083219,Chow; Bennett,0,12,30,30
1650294443792,MATH 142A,A02,083220,Chow; Bennett,0,11,30,30
1650294443792,MATH 142A,B01,083221,Chow; Bennett,0,11,30,30
1650294443792,MATH 142A,B02,083222,Chow; Bennett,0,12,30,30
1650294449819,MATH 193A,A01,083224,Staff,0,5,30,30
1650294449819,MATH 193A,A02,083225,Staff,0,5,30,30
1650294449819,MATH 193A,A03,083781,Staff,0,2,30,30
1650294449819,MATH 193A,A04,083782,Staff,0,1,30,30
1650294455843,MATH 197,001,091859,McAuley; Julian John,9998,0,9999,1
1650294461893,COGS 9,A01,083615,Staff,0,14,60,60
1650294467920,COGS 11,A01,083617,Boyle; Mary E. T.,23,0,40,17
1650294473957,COGS 13,A01,083071,Staff,0,31,40,40
1650294479981,COGS 14A,A01,092681,Staff,0,16,100,100
1650294486008,COGS 14B,A01,083073,Cheng; Tzu-Han,0,9,50,50
1650294492032,COGS 17,A01,092677,Staff,27,0,75,48
1650294498061,COGS 100,A01,083619,Staff,0,23,60,60
1650294504090,COGS 101A,A01,083621,Davis; Joshua Daniel,0,21,60,60
1650294510116,COGS 101B,A01,091572,Staff,4,0,60,56
1650294516148,COGS 101C,A01,083625,Delgado; Tania,19,0,30,11
1650294522171,COGS 107A,A01,083627,Boyle; Mary E. T.,0,8,60,60
1650294528194,COGS 118A,A01,083075,Staff,12,0,60,48
1650294534218,CSE 3,A50,083646,Miranda; Gregory Joseph,21,0,38,17
1650294534218,CSE 3,A51,083647,Miranda; Gregory Joseph,37,0,37,0
1650294540250,CSE 8A,A50,083650,Miranda; Gregory Joseph,0,23,40,40
1650294546274,CSE 11,A01,083080,Cao; Yingjun,0,78,40,40
1650294552301,CSE 12,A01,083652,Staff,0,10,100,100
1650294558329,CSE 15L,A01,083654,Staff,0,1,50,50
1650294558329,CSE 15L,A02,083655,Staff,4,0,50,46
1650294564356,CSE 20,A01,083657,Staff,53,0,80,27
1650294570380,CSE 30,A01,083084,Eldon; John,0,73,40,40
1650294576404,CSE 100,A01,083659,Cao; Yingjun,0,65,50,50
1650294582431,CSE 134B,A01,083661,Powell; Thomas Allan,0,29,65,65
1650294588457,CSE 140,A01,083663,Staff,0,0,75,75
1650294594481,CSE 140L,A01,083088,Eldon; John,0,6,75,75
1650294600505,CSE 175,A01,083665,Kumar; Rakesh,8,0,25,17
1650294606530,CSE 190,A00,092507,Dubnov; Shlomo,14,0,20,6
1650294612564,ECE 45,A01,083139,Staff,0,15,40,40
1650294618591,ECE 65,A50,083695,Staff,0,4,30,30
1650294624616,ECE 109,A01,091882,Touri; Behrouz,43,0,70,27
1650294630639,ECE 180,A00,083140,Abi Samra; Nicholas Camill,24,0,30,6
1650294630639,ECE 180,B00,083141,Abi Samra; Nicholas Camill,7,0,30,23
1650294636664,MATH 10A,A01,083735,Patchell; Gregory David,11,0,30,19
1650294636664,MATH 10A,A02,083736,Patchell; Gregory David,28,0,30,2
1650294636664,MATH 10A,A03,083737,Patchell; Gregory David,26,0,30,4
1650294642691,MATH 10B,A01,083207,Staff,0,6,30,30
1650294642691,MATH 10B,A02,083208,Staff,0,6,30,30
1650294642691,MATH 10B,B01,083739,Staff,17,0,30,13
1650294642691,MATH 10B,B02,083740,Staff,29,0,30,1
1650294648802,MATH 18,A01,083743,Staff,5,0,30,25
1650294648802,MATH 18,A02,083744,Staff,27,0,30,3
1650294648802,MATH 18,A03,083745,Staff,23,0,30,7
1650294648802,MATH 18,A04,083746,Staff,27,0,30,3
1650294648802,MATH 18,B01,083748,Staff,0,11,30,30
1650294648802,MATH 18,B02,083749,Staff,0,10,30,30
1650294648802,MATH 18,B03,083750,Staff,1,8,30,29
1650294648802,MATH 18,B04,083751,Staff,0,10,30,30
1650294654826,MATH 20A,A01,083754,Staff,25,0,40,15
1650294660863,MATH 20B,A01,083756,Staff,0,5,30,30
1650294660863,MATH 20B,A02,083757,Staff,0,7,30,30
1650294666888,MATH 20C,A01,083760,Staff,0,13,30,30
1650294666888,MATH 20C,A02,083761,Staff,0,14,30,30
1650294666888,MATH 20C,B01,083762,Staff,14,0,30,16
1650294666888,MATH 20C,B02,083763,Staff,28,0,30,2
1650294672919,MATH 20D,A01,083765,Staff,0,1,30,30
1650294672919,MATH 20D,A02,083766,Staff,8,0,30,22
1650294672919,MATH 20D,A03,083767,Staff,28,0,30,2
1650294678943,MATH 20E,A01,083771,Staff,5,0,30,25
1650294678943,MATH 20E,A02,083772,Staff,20,0,30,10
1650294678943,MATH 20E,B01,083773,Staff,0,0,30,30
1650294678943,MATH 20E,B02,083774,Staff,11,0,30,19
1650294684980,MATH 103A,A01,083777,Staff,0,11,30,30
1650294684980,MATH 103A,A02,083778,Staff,0,10,30,30
1650294684980,MATH 103A,B01,083779,Staff,0,10,30,30
1650294684980,MATH 103A,B02,083780,Staff,0,10,30,30
1650294691003,MATH 105,A01,085443,Staff,0,17,30,30
1650294697027,MATH 109,A01,083213,Anzaldo; Leesa B,0,5,30,30
1650294697027,MATH 109,A02,083214,Anzaldo; Leesa B,0,6,30,30
1650294697027,MATH 109,B01,083215,Anzaldo; Leesa B,0,4,30,30
1650294697027,MATH 109,B02,083216,Anzaldo; Leesa B,0,3,30,30
1650294703052,MATH 142A,A01,083219,Chow; Bennett,0,12,30,30
1650294703052,MATH 142A,A02,083220,Chow; Bennett,0,11,30,30
1650294703052,MATH 142A,B01,083221,Chow; Bennett,0,11,30,30
1650294703052,MATH 142A,B02,083222,Chow; Bennett,0,12,30,30
1650294709077,MATH 193A,A01,083224,Staff,0,5,30,30
1650294709077,MATH 193A,A02,083225,Staff,0,5,30,30
1650294709077,MATH 193A,A03,083781,Staff,0,2,30,30
1650294709077,MATH 193A,A04,083782,Staff,0,1,30,30
1650294715124,MATH 197,001,091859,McAuley; Julian John,9998,0,9999,1
1650294721176,COGS 9,A01,083615,Staff,0,14,60,60
1650294727202,COGS 11,A01,083617,Boyle; Mary E. T.,23,0,40,17
1650294733230,COGS 13,A01,083071,Staff,0,31,40,40
1650294739257,COGS 14A,A01,092681,Staff,0,16,100,100
1650294745285,COGS 14B,A01,083073,Cheng; Tzu-Han,0,9,50,50
1650294751308,COGS 17,A01,092677,Staff,27,0,75,48
1650294757334,COGS 100,A01,083619,Staff,0,23,60,60
1650294763371,COGS 101A,A01,083621,Davis; Joshua Daniel,0,21,60,60
1650294769398,COGS 101B,A01,091572,Staff,4,0,60,56
1650294775435,COGS 101C,A01,083625,Delgado; Tania,19,0,30,11
1650294781458,COGS 107A,A01,083627,Boyle; Mary E. T.,0,8,60,60
1650294787482,COGS 118A,A01,083075,Staff,12,0,60,48
1650294793509,CSE 3,A50,083646,Miranda; Gregory Joseph,21,0,38,17
1650294793509,CSE 3,A51,083647,Miranda; Gregory Joseph,37,0,37,0
1650294799532,CSE 8A,A50,083650,Miranda; Gregory Joseph,0,23,40,40
1650294805557,CSE 11,A01,083080,Cao; Yingjun,0,78,40,40
1650294811591,CSE 12,A01,083652,Staff,0,10,100,100
1650294817616,CSE 15L,A01,083654,Staff,0,1,50,50
1650294817616,CSE 15L,A02,083655,Staff,4,0,50,46
1650294823652,CSE 20,A01,083657,Staff,53,0,80,27
1650294829679,CSE 30,A01,083084,Eldon; John,0,73,40,40
1650294835704,CSE 100,A01,083659,Cao; Yingjun,0,65,50,50
1650294841728,CSE 134B,A01,083661,Powell; Thomas Allan,0,29,65,65
1650294847755,CSE 140,A01,083663,Staff,0,0,75,75
1650294853792,CSE 140L,A01,083088,Eldon; John,0,6,75,75
1650294859824,CSE 175,A01,083665,Kumar; Rakesh,8,0,25,17
1650294865853,CSE 190,A00,092507,Dubnov; Shlomo,14,0,20,6
1650294871875,ECE 45,A01,083139,Staff,0,15,40,40
1650294877901,ECE 65,A50,083695,Staff,0,4,30,30
1650294883932,ECE 109,A01,091882,Touri; Behrouz,43,0,70,27
1650294889957,ECE 180,A00,083140,Abi Samra; Nicholas Camill,24,0,30,6
1650294889957,ECE 180,B00,083141,Abi Samra; Nicholas Camill,7,0,30,23
1650294895980,MATH 10A,A01,083735,Patchell; Gregory David,11,0,30,19
1650294895980,MATH 10A,A02,083736,Patchell; Gregory David,28,0,30,2
1650294895980,MATH 10A,A03,083737,Patchell; Gregory David,26,0,30,4
1650294902004,MATH 10B,A01,083207,Staff,0,6,30,30
1650294902004,MATH 10B,A02,083208,Staff,0,6,30,30
1650294902004,MATH 10B,B01,083739,Staff,17,0,30,13
1650294902004,MATH 10B,B02,083740,Staff,29,0,30,1
1650294908033,MATH 18,A01,083743,Staff,5,0,30,25
1650294908033,MATH 18,A02,083744,Staff,27,0,30,3
1650294908033,MATH 18,A03,083745,Staff,23,0,30,7
1650294908033,MATH 18,A04,083746,Staff,27,0,30,3
1650294908033,MATH 18,B01,083748,Staff,0,11,30,30
1650294908033,MATH 18,B02,083749,Staff,0,10,30,30
1650294908033,MATH 18,B03,083750,Staff,1,8,30,29
1650294908033,MATH 18,B04,083751,Staff,0,10,30,30
1650294914057,MATH 20A,A01,083754,Staff,25,0,40,15
1650294920085,MATH 20B,A01,083756,Staff,0,5,30,30
1650294920085,MATH 20B,A02,083757,Staff,0,7,30,30
1650294926108,MATH 20C,A01,083760,Staff,0,13,30,30
1650294926108,MATH 20C,A02,083761,Staff,0,14,30,30
1650294926108,MATH 20C,B01,083762,Staff,14,0,30,16
1650294926108,MATH 20C,B02,083763,Staff,28,0,30,2
1650294932153,MATH 20D,A01,083765,Staff,0,2,30,30
1650294932153,MATH 20D,A02,083766,Staff,8,0,30,22
1650294932153,MATH 20D,A03,083767,Staff,28,0,30,2
1650294938182,MATH 20E,A01,083771,Staff,5,0,30,25
1650294938182,MATH 20E,A02,083772,Staff,20,0,30,10
1650294938182,MATH 20E,B01,083773,Staff,0,0,30,30
1650294938182,MATH 20E,B02,083774,Staff,11,0,30,19
1650294944207,MATH 103A,A01,083777,Staff,0,11,30,30
1650294944207,MATH 103A,A02,083778,Staff,0,10,30,30
1650294944207,MATH 103A,B01,083779,Staff,0,10,30,30
1650294944207,MATH 103A,B02,083780,Staff,0,10,30,30
1650294950232,MATH 105,A01,085443,Staff,0,17,30,30
1650294956255,MATH 109,A01,083213,Anzaldo; Leesa B,0,5,30,30
1650294956255,MATH 109,A02,083214,Anzaldo; Leesa B,0,6,30,30
1650294956255,MATH 109,B01,083215,Anzaldo; Leesa B,0,4,30,30
1650294956255,MATH 109,B02,083216,Anzaldo; Leesa B,0,3,30,30
1650294962277,MATH 142A,A01,083219,Chow; Bennett,0,12,30,30
1650294962277,MATH 142A,A02,083220,Chow; Bennett,0,11,30,30
1650294962277,MATH 142A,B01,083221,Chow; Bennett,0,11,30,30
1650294962277,MATH 142A,B02,083222,Chow; Bennett,0,12,30,30
1650294968304,MATH 193A,A01,083224,Staff,0,5,30,30
1650294968304,MATH 193A,A02,083225,Staff,0,5,30,30
1650294968304,MATH 193A,A03,083781,Staff,0,2,30,30
1650294968304,MATH 193A,A04,083782,Staff,0,1,30,30
1650294974329,MATH 197,001,091859,McAuley; Julian John,9998,0,9999,1
1650294980397,COGS 9,A01,083615,Staff,0,14,60,60
1650294986426,COGS 11,A01,083617,Boyle; Mary E. T.,23,0,40,17
1650294992454,COGS 13,A01,083071,Staff,0,31,40,40
1650294998477,COGS 14A,A01,092681,Staff,0,16,100,100
1650295004502,COGS 14B,A01,083073,Cheng; Tzu-Han,0,9,50,50
1650295010535,COGS 17,A01,092677,Staff,27,0,75,48
1650295016561,COGS 100,A01,083619,Staff,0,23,60,60
1650295022595,COGS 101A,A01,083621,Davis; Joshua Daniel,0,21,60,60
1650295028621,COGS 101B,A01,091572,Staff,4,0,60,56
1650295034648,COGS 101C,A01,083625,Delgado; Tania,19,0,30,11
1650295040672,COGS 107A,A01,083627,Boyle; Mary E. T.,0,8,60,60
1650295046699,COGS 118A,A01,083075,Staff,11,0,60,49
1650295052725,CSE 3,A50,083646,Miranda; Gregory Joseph,21,0,38,17
1650295052725,CSE 3,A51,083647,Miranda; Gregory Joseph,37,0,37,0
1650295058752,CSE 8A,A50,083650,Miranda; Gregory Joseph,0,23,40,40
1650295064776,CSE 11,A01,083080,Cao; Yingjun,0,79,40,40
1650295070799,CSE 12,A01,083652,Staff,0,10,100,100
1650295076823,CSE 15L,A01,083654,Staff,0,1,50,50
1650295076823,CSE 15L,A02,083655,Staff,4,0,50,46
1650295082847,CSE 20,A01,083657,Staff,53,0,80,27
1650295088878,CSE 30,A01,083084,Eldon; John,0,73,40,40
1650295094906,CSE 100,A01,083659,Cao; Yingjun,0,65,50,50
1650295100933,CSE 134B,A01,083661,Powell; Thomas Allan,0,29,65,65
1650295106960,CSE 140,A01,083663,Staff,0,0,75,75
1650295112984,CSE 140L,A01,083088,Eldon; John,0,6,75,75
1650295119010,CSE 175,A01,083665,Kumar; Rakesh,8,0,25,17
1650295125044,CSE 190,A00,092507,Dubnov; Shlomo,14,0,20,6
1650295131066,ECE 45,A01,083139,Staff,0,15,40,40
1650295137091,ECE 65,A50,083695,Staff,0,4,30,30
1650295143143,ECE 109,A01,091882,Touri; Behrouz,43,0,70,27
1650295149166,ECE 180,A00,083140,Abi Samra; Nicholas Camill,24,0,30,6
1650295149166,ECE 180,B00,083141,Abi Samra; Nicholas Camill,7,0,30,23
1650295155190,MATH 10A,A01,083735,Patchell; Gregory David,11,0,30,19
1650295155190,MATH 10A,A02,083736,Patchell; Gregory David,28,0,30,2
1650295155190,MATH 10A,A03,083737,Patchell; Gregory David,26,0,30,4
1650295161218,MATH 10B,A01,083207,Staff,0,6,30,30
1650295161218,MATH 10B,A02,083208,Staff,0,6,30,30
1650295161218,MATH 10B,B01,083739,Staff,17,0,30,13
1650295161218,MATH 10B,B02,083740,Staff,29,0,30,1
1650295167242,MATH 18,A01,083743,Staff,5,0,30,25
1650295167242,MATH 18,A02,083744,Staff,27,0,30,3
1650295167242,MATH 18,A03,083745,Staff,23,0,30,7
1650295167242,MATH 18,A04,083746,Staff,27,0,30,3
1650295167242,MATH 18,B01,083748,Staff,0,11,30,30
1650295167242,MATH 18,B02,083749,Staff,0,10,30,30
1650295167242,MATH 18,B03,083750,Staff,1,8,30,29
1650295167242,MATH 18,B04,083751,Staff,0,10,30,30
1650295173266,MATH 20A,A01,083754,Staff,25,0,40,15
1650295179298,MATH 20B,A01,083756,Staff,0,5,30,30
1650295179298,MATH 20B,A02,083757,Staff,0,7,30,30
1650295185325,MATH 20C,A01,083760,Staff,0,13,30,30
1650295185325,MATH 20C,A02,083761,Staff,0,14,30,30
1650295185325,MATH 20C,B01,083762,Staff,14,0,30,16
1650295185325,MATH 20C,B02,083763,Staff,28,0,30,2
1650295191350,MATH 20D,A01,083765,Staff,0,1,30,30
1650295191350,MATH 20D,A02,083766,Staff,8,0,30,22
1650295191350,MATH 20D,A03,083767,Staff,27,0,30,3
1650295197381,MATH 20E,A01,083771,Staff,5,0,30,25
1650295197381,MATH 20E,A02,083772,Staff,20,0,30,10
1650295197381,MATH 20E,B01,083773,Staff,0,0,30,30
1650295197381,MATH 20E,B02,083774,Staff,11,0,30,19
1650295203410,MATH 103A,A01,083777,Staff,0,11,30,30
1650295203410,MATH 103A,A02,083778,Staff,0,10,30,30
1650295203410,MATH 103A,B01,083779,Staff,0,10,30,30
1650295203410,MATH 103A,B02,083780,Staff,0,10,30,30
1650295209437,MATH 105,A01,085443,Staff,0,17,30,30
1650295215465,MATH 109,A01,083213,Anzaldo; Leesa B,0,5,30,30
1650295215465,MATH 109,A02,083214,Anzaldo; Leesa B,0,6,30,30
1650295215465,MATH 109,B01,083215,Anzaldo; Leesa B,0,4,30,30
1650295215465,MATH 109,B02,083216,Anzaldo; Leesa B,0,3,30,30
1650295221493,MATH 142A,A01,083219,Chow; Bennett,0,12,30,30
1650295221493,MATH 142A,A02,083220,Chow; Bennett,0,11,30,30
1650295221493,MATH 142A,B01,083221,Chow; Bennett,0,11,30,30
1650295221493,MATH 142A,B02,083222,Chow; Bennett,0,12,30,30
1650295227522,MATH 193A,A01,083224,Staff,0,5,30,30
1650295227522,MATH 193A,A02,083225,Staff,0,5,30,30
1650295227522,MATH 193A,A03,083781,Staff,0,2,30,30
1650295227522,MATH 193A,A04,083782,Staff,0,1,30,30
1650295233555,MATH 197,001,091859,McAuley; Julian John,9998,0,9999,1
1650295239724,COGS 9,A01,083615,Staff,0,14,60,60
1650295245746,COGS 11,A01,083617,Boyle; Mary E. T.,23,0,40,17
1650295251770,COGS 13,A01,083071,Staff,0,31,40,40
1650295257799,COGS 14A,A01,092681,Staff,0,16,100,100
1650295263830,COGS 14B,A01,083073,Cheng; Tzu-Han,0,9,50,50
1650295269860,COGS 17,A01,092677,Staff,27,0,75,48
1650295275884,COGS 100,A01,083619,Staff,0,23,60,60
1650295281912,COGS 101A,A01,083621,Davis; Joshua Daniel,0,21,60,60
1650295287941,COGS 101B,A01,091572,Staff,4,0,60,56
1650295293982,COGS 101C,A01,083625,Delgado; Tania,19,0,30,11
1650295300009,COGS 107A,A01,083627,Boyle; Mary E. T.,0,8,60,60
1650295306033,COGS 118A,A01,083075,Staff,11,0,60,49
1650295312056,CSE 3,A50,083646,Miranda; Gregory Joseph,21,0,38,17
1650295312056,CSE 3,A51,083647,Miranda; Gregory Joseph,37,0,37,0
1650295318080,CSE 8A,A50,083650,Miranda; Gregory Joseph,0,23,40,40
1650295324105,CSE 11,A01,083080,Cao; Yingjun,0,79,40,40
1650295330137,CSE 12,A01,083652,Staff,0,10,100,100
1650295336169,CSE 15L,A01,083654,Staff,0,1,50,50
1650295336169,CSE 15L,A02,083655,Staff,4,0,50,46
1650295342217,CSE 20,A01,083657,Staff,53,0,80,27
1650295348246,CSE 30,A01,083084,Eldon; John,0,73,40,40
1650295354299,CSE 100,A01,083659,Cao; Yingjun,0,65,50,50
1650295360322,CSE 134B,A01,083661,Powell; Thomas Allan,0,29,65,65
1650295366346,CSE 140,A01,083663,Staff,0,0,75,75
1650295372375,CSE 140L,A01,083088,Eldon; John,0,6,75,75
1650295378400,CSE 175,A01,083665,Kumar; Rakesh,8,0,25,17
1650295384423,CSE 190,A00,092507,Dubnov; Shlomo,14,0,20,6
1650295390456,ECE 45,A01,083139,Staff,0,15,40,40
1650295396493,ECE 65,A50,083695,Staff,0,4,30,30
1650295402527,ECE 109,A01,091882,Touri; Behrouz,43,0,70,27
1650295408559,ECE 180,A00,083140,Abi Samra; Nicholas Camill,24,0,30,6
1650295408559,ECE 180,B00,083141,Abi Samra; Nicholas Camill,7,0,30,23
1650295414588,MATH 10A,A01,083735,Patchell; Gregory David,11,0,30,19
1650295414588,MATH 10A,A02,083736,Patchell; Gregory David,28,0,30,2
1650295414588,MATH 10A,A03,083737,Patchell; Gregory David,26,0,30,4
1650295420612,MATH 10B,A01,083207,Staff,0,6,30,30
1650295420612,MATH 10B,A02,083208,Staff,0,6,30,30
1650295420612,MATH 10B,B01,083739,Staff,17,0,30,13
1650295420612,MATH 10B,B02,083740,Staff,29,0,30,1
1650295426640,MATH 18,A01,083743,Staff,5,0,30,25
1650295426640,MATH 18,A02,083744,Staff,27,0,30,3
1650295426640,MATH 18,A03,083745,Staff,23,0,30,7
1650295426640,MATH 18,A04,083746,Staff,27,0,30,3
1650295426640,MATH 18,B01,083748,Staff,0,11,30,30
1650295426640,MATH 18,B02,083749,Staff,0,10,30,30
1650295426640,MATH 18,B03,083750,Staff,1,8,30,29
1650295426640,MATH 18,B04,083751,Staff,0,10,30,30
1650295432665,MATH 20A,A01,083754,Staff,25,0,40,15
1650295438689,MATH 20B,A01,083756,Staff,0,5,30,30
1650295438689,MATH 20B,A02,083757,Staff,0,7,30,30
1650295444717,MATH 20C,A01,083760,Staff,0,13,30,30
1650295444717,MATH 20C,A02,083761,Staff,0,14,30,30
1650295444717,MATH 20C,B01,083762,Staff,14,0,30,16
1650295444717,MATH 20C,B02,083763,Staff,28,0,30,2
1650295450751,MATH 20D,A01,083765,Staff,0,1,30,30
1650295450751,MATH 20D,A02,083766,Staff,8,0,30,22
1650295450751,MATH 20D,A03,083767,Staff,27,0,30,3
1650295456784,MATH 20E,A01,083771,Staff,5,0,30,25
1650295456784,MATH 20E,A02,083772,Staff,20,0,30,10
1650295456784,MATH 20E,B01,083773,Staff,0,0,30,30
1650295456784,MATH 20E,B02,083774,Staff,11,0,30,19
1650295462811,MATH 103A,A01,083777,Staff,0,11,30,30
1650295462811,MATH 103A,A02,083778,Staff,0,10,30,30
1650295462811,MATH 103A,B01,083779,Staff,0,10,30,30
1650295462811,MATH 103A,B02,083780,Staff,0,10,30,30
1650295468839,MATH 105,A01,085443,Staff,0,17,30,30
1650295474868,MATH 109,A01,083213,Anzaldo; Leesa B,0,5,30,30
1650295474868,MATH 109,A02,083214,Anzaldo; Leesa B,0,6,30,30
1650295474868,MATH 109,B01,083215,Anzaldo; Leesa B,0,4,30,30
1650295474868,MATH 109,B02,083216,Anzaldo; Leesa B,0,4,30,30
1650295480911,MATH 142A,A01,083219,Chow; Bennett,0,12,30,30
1650295480911,MATH 142A,A02,083220,Chow; Bennett,0,11,30,30
1650295480911,MATH 142A,B01,083221,Chow; Bennett,0,11,30,30
1650295480911,MATH 142A,B02,083222,Chow; Bennett,0,12,30,30
1650295486953,MATH 193A,A01,083224,Staff,0,5,30,30
1650295486953,MATH 193A,A02,083225,Staff,0,5,30,30
1650295486953,MATH 193A,A03,083781,Staff,0,2,30,30
1650295486953,MATH 193A,A04,083782,Staff,0,1,30,30
1650295492981,MATH 197,001,091859,McAuley; Julian John,9998,0,9999,1
1650295499049,COGS 9,A01,083615,Staff,0,14,60,60
1650295505084,COGS 11,A01,083617,Boyle; Mary E. T.,23,0,40,17
1650295511106,COGS 13,A01,083071,Staff,0,31,40,40
1650295517136,COGS 14A,A01,092681,Staff,0,16,100,100
1650295523165,COGS 14B,A01,083073,Cheng; Tzu-Han,0,9,50,50
1650295529205,COGS 17,A01,092677,Staff,27,0,75,48
1650295535238,COGS 100,A01,083619,Staff,0,23,60,60
1650295541262,COGS 101A,A01,083621,Davis; Joshua Daniel,0,21,60,60
1650295547286,COGS 101B,A01,091572,Staff,4,0,60,56
1650295553313,COGS 101C,A01,083625,Delgado; Tania,19,0,30,11
1650295559345,COGS 107A,A01,083627,Boyle; Mary E. T.,0,8,60,60
1650295565375,COGS 118A,A01,083075,Staff,11,0,60,49
1650295571400,CSE 3,A50,083646,Miranda; Gregory Joseph,21,0,38,17
1650295571400,CSE 3,A51,083647,Miranda; Gregory Joseph,37,0,37,0
1650295577428,CSE 8A,A50,083650,Miranda; Gregory Joseph,0,23,40,40
1650295583457,CSE 11,A01,083080,Cao; Yingjun,0,79,40,40
1650295589483,CSE 12,A01,083652,Staff,0,10,100,100
1650295595511,CSE 15L,A01,083654,Staff,0,1,50,50
1650295595511,CSE 15L,A02,083655,Staff,4,0,50,46
1650295601544,CSE 20,A01,083657,Staff,53,0,80,27
1650295607573,CSE 30,A01,083084,Eldon; John,0,73,40,40
1650295613599,CSE 100,A01,083659,Cao; Yingjun,0,65,50,50
1650295619627,CSE 134B,A01,083661,Powell; Thomas Allan,0,29,65,65
1650295625657,CSE 140,A01,083663,Staff,0,0,75,75
1650295631693,CSE 140L,A01,083088,Eldon; John,0,6,75,75
1650295637720,CSE 175,A01,083665,Kumar; Rakesh,8,0,25,17
1650295643744,CSE 190,A00,092507,Dubnov; Shlomo,14,0,20,6
1650295649767,ECE 45,A01,083139,Staff,0,15,40,40
1650295655796,ECE 65,A50,083695,Staff,0,4,30,30
1650295661825,ECE 109,A01,091882,Touri; Behrouz,43,0,70,27
1650295667859,ECE 180,A00,083140,Abi Samra; Nicholas Camill,24,0,30,6
1650295667859,ECE 180,B00,083141,Abi Samra; Nicholas Camill,7,0,30,23
1650295673887,MATH 10A,A01,083735,Patchell; Gregory David,11,0,30,19
1650295673887,MATH 10A,A02,083736,Patchell; Gregory David,28,0,30,2
1650295673887,MATH 10A,A03,083737,Patchell; Gregory David,26,0,30,4
1650295679913,MATH 10B,A01,083207,Staff,0,6,30,30
1650295679913,MATH 10B,A02,083208,Staff,0,6,30,30
1650295679913,MATH 10B,B01,083739,Staff,17,0,30,13
1650295679913,MATH 10B,B02,083740,Staff,29,0,30,1
1650295685942,MATH 18,A01,083743,Staff,5,0,30,25
1650295685942,MATH 18,A02,083744,Staff,27,0,30,3
1650295685942,MATH 18,A03,083745,Staff,23,0,30,7
1650295685942,MATH 18,A04,083746,Staff,27,0,30,3
1650295685942,MATH 18,B01,083748,Staff,0,11,30,30
1650295685942,MATH 18,B02,083749,Staff,0,10,30,30
1650295685942,MATH 18,B03,083750,Staff,1,8,30,29
1650295685942,MATH 18,B04,083751,Staff,0,10,30,30
1650295691965,MATH 20A,A01,083754,Staff,25,0,40,15
1650295697988,MATH 20B,A01,083756,Staff,0,5,30,30
1650295697988,MATH 20B,A02,083757,Staff,0,7,30,30
1650295704010,MATH 20C,A01,083760,Staff,0,14,30,30
1650295704010,MATH 20C,A02,083761,Staff,0,13,30,30
1650295704010,MATH 20C,B01,083762,Staff,14,0,30,16
1650295704010,MATH 20C,B02,083763,Staff,28,0,30,2
1650295710035,MATH 20D,A01,083765,Staff,0,1,30,30
1650295710035,MATH 20D,A02,083766,Staff,8,0,30,22
1650295710035,MATH 20D,A03,083767,Staff,27,0,30,3
1650295716059,MATH 20E,A01,083771,Staff,5,0,30,25
1650295716059,MATH 20E,A02,083772,Staff,20,0,30,10
1650295716059,MATH 20E,B01,083773,Staff,0,0,30,30
1650295716059,MATH 20E,B02,083774,Staff,11,0,30,19
1650295722105,MATH 103A,A01,083777,Staff,0,11,30,30
1650295722105,MATH 103A,A02,083778,Staff,0,10,30,30
1650295722105,MATH 103A,B01,083779,Staff,0,10,30,30
1650295722105,MATH 103A,B02,083780,Staff,0,10,30,30
1650295728132,MATH 105,A01,085443,Staff,0,17,30,30
1650295734157,MATH 109,A01,083213,Anzaldo; Leesa B,0,5,30,30
1650295734157,MATH 109,A02,083214,Anzaldo; Leesa B,0,6,30,30
1650295734157,MATH 109,B01,083215,Anzaldo; Leesa B,0,4,30,30
1650295734157,MATH 109,B02,083216,Anzaldo; Leesa B,0,4,30,30
1650295740190,MATH 142A,A01,083219,Chow; Bennett,0,12,30,30
1650295740190,MATH 142A,A02,083220,Chow; Bennett,0,11,30,30
1650295740190,MATH 142A,B01,083221,Chow; Bennett,0,11,30,30
1650295740190,MATH 142A,B02,083222,Chow; Bennett,0,12,30,30
1650295746216,MATH 193A,A01,083224,Staff,0,5,30,30
1650295746216,MATH 193A,A02,083225,Staff,0,5,30,30
1650295746216,MATH 193A,A03,083781,Staff,0,2,30,30
1650295746216,MATH 193A,A04,083782,Staff,0,1,30,30
1650295752242,MATH 197,001,091859,McAuley; Julian John,9998,0,9999,1
1650295758301,COGS 9,A01,083615,Staff,0,14,60,60
1650295764323,COGS 11,A01,083617,Boyle; Mary E. T.,23,0,40,17
1650295770353,COGS 13,A01,083071,Staff,0,31,40,40
1650295776378,COGS 14A,A01,092681,Staff,0,16,100,100
1650295782403,COGS 14B,A01,083073,Cheng; Tzu-Han,0,9,50,50
1650295788428,COGS 17,A01,092677,Staff,27,0,75,48
1650295794454,COGS 100,A01,083619,Staff,0,23,60,60
1650295800491,COGS 101A,A01,083621,Davis; Joshua Daniel,0,21,60,60
1650295806513,COGS 101B,A01,091572,Staff,4,0,60,56
1650295812541,COGS 101C,A01,083625,Delgado; Tania,19,0,30,11
1650295818566,COGS 107A,A01,083627,Boyle; Mary E. T.,0,8,60,60
1650295824589,COGS 118A,A01,083075,Staff,11,0,60,49
1650295830613,CSE 3,A50,083646,Miranda; Gregory Joseph,21,0,38,17
1650295830613,CSE 3,A51,083647,Miranda; Gregory Joseph,37,0,37,0
1650295836735,CSE 8A,A50,083650,Miranda; Gregory Joseph,0,23,40,40
1650295842759,CSE 11,A01,083080,Cao; Yingjun,0,80,40,40
1650295848785,CSE 12,A01,083652,Staff,0,10,100,100
1650295854815,CSE 15L,A01,083654,Staff,0,1,50,50
1650295854815,CSE 15L,A02,083655,Staff,4,0,50,46
1650295860838,CSE 20,A01,083657,Staff,53,0,80,27
1650295866862,CSE 30,A01,083084,Eldon; John,0,74,40,40
1650295872886,CSE 100,A01,083659,Cao; Yingjun,0,65,50,50
1650295878917,CSE 134B,A01,083661,Powell; Thomas Allan,0,29,65,65
1650295884941,CSE 140,A01,083663,Staff,0,0,75,75
1650295890969,CSE 140L,A01,083088,Eldon; John,0,6,75,75
1650295896993,CSE 175,A01,083665,Kumar; Rakesh,8,0,25,17
1650295903017,CSE 190,A00,092507,Dubnov; Shlomo,14,0,20,6
1650295909046,ECE 45,A01,083139,Staff,0,15,40,40
1650295915070,ECE 65,A50,083695,Staff,0,4,30,30
1650295921095,ECE 109,A01,091882,Touri; Behrouz,43,0,70,27
1650295927117,ECE 180,A00,083140,Abi Samra; Nicholas Camill,24,0,30,6
1650295927117,ECE 180,B00,083141,Abi Samra; Nicholas Camill,7,0,30,23
1650295933146,MATH 10A,A01,083735,Patchell; Gregory David,11,0,30,19
1650295933146,MATH 10A,A02,083736,Patchell; Gregory David,28,0,30,2
1650295933146,MATH 10A,A03,083737,Patchell; Gregory David,26,0,30,4
1650295939179,MATH 10B,A01,083207,Staff,0,6,30,30
1650295939179,MATH 10B,A02,083208,Staff,0,6,30,30
1650295939179,MATH 10B,B01,083739,Staff,17,0,30,13
1650295939179,MATH 10B,B02,083740,Staff,29,0,30,1
1650295945204,MATH 18,A01,083743,Staff,6,0,30,24
1650295945204,MATH 18,A02,083744,Staff,27,0,30,3
1650295945204,MATH 18,A03,083745,Staff,23,0,30,7
1650295945204,MATH 18,A04,083746,Staff,27,0,30,3
1650295945204,MATH 18,B01,083748,Staff,0,11,30,30
1650295945204,MATH 18,B02,083749,Staff,0,10,30,30
1650295945204,MATH 18,B03,083750,Staff,1,9,30,29
1650295945204,MATH 18,B04,083751,Staff,0,10,30,30
1650295951236,MATH 20A,A01,083754,Staff,25,0,40,15
1650295957259,MATH 20B,A01,083756,Staff,0,5,30,30
1650295957259,MATH 20B,A02,083757,Staff,0,7,30,30
1650295963285,MATH 20C,A01,083760,Staff,0,14,30,30
1650295963285,MATH 20C,A02,083761,Staff,0,13,30,30
1650295963285,MATH 20C,B01,083762,Staff,14,0,30,16
1650295963285,MATH 20C,B02,083763,Staff,28,0,30,2
1650295969309,MATH 20D,A01,083765,Staff,0,1,30,30
1650295969309,MATH 20D,A02,083766,Staff,8,0,30,22
1650295969309,MATH 20D,A03,083767,Staff,27,0,30,3
1650295975333,MATH 20E,A01,083771,Staff,5,0,30,25
1650295975333,MATH 20E,A02,083772,Staff,20,0,30,10
1650295975333,MATH 20E,B01,083773,Staff,0,0,30,30
1650295975333,MATH 20E,B02,083774,Staff,11,0,30,19
1650295981361,MATH 103A,A01,083777,Staff,0,11,30,30
1650295981361,MATH 103A,A02,083778,Staff,0,10,30,30
1650295981361,MATH 103A,B01,083779,Staff,0,10,30,30
1650295981361,MATH 103A,B02,083780,Staff,0,10,30,30
1650295987390,MATH 105,A01,085443,Staff,0,17,30,30
1650295993418,MATH 109,A01,083213,Anzaldo; Leesa B,0,5,30,30
1650295993418,MATH 109,A02,083214,Anzaldo; Leesa B,0,6,30,30
1650295993418,MATH 109,B01,083215,Anzaldo; Leesa B,0,4,30,30
1650295993418,MATH 109,B02,083216,Anzaldo; Leesa B,0,4,30,30
1650295999442,MATH 142A,A01,083219,Chow; Bennett,0,12,30,30
1650295999442,MATH 142A,A02,083220,Chow; Bennett,0,11,30,30
1650295999442,MATH 142A,B01,083221,Chow; Bennett,0,11,30,30
1650295999442,MATH 142A,B02,083222,Chow; Bennett,0,12,30,30
1650296005468,MATH 193A,A01,083224,Staff,0,5,30,30
1650296005468,MATH 193A,A02,083225,Staff,0,5,30,30
1650296005468,MATH 193A,A03,083781,Staff,0,2,30,30
1650296005468,MATH 193A,A04,083782,Staff,0,1,30,30
1650296011490,MATH 197,001,091859,McAuley; Julian John,9998,0,9999,1
1650296017550,COGS 9,A01,083615,Staff,0,14,60,60
1650296023576,COGS 11,A01,083617,Boyle; Mary E. T.,23,0,40,17
1650296029601,COGS 13,A01,083071,Staff,0,31,40,40
1650296035625,COGS 14A,A01,092681,Staff,0,16,100,100
1650296041653,COGS 14B,A01,083073,Cheng; Tzu-Han,0,9,50,50
1650296047678,COGS 17,A01,092677,Staff,27,0,75,48
1650296053711,COGS 100,A01,083619,Staff,0,23,60,60
1650296059735,COGS 101A,A01,083621,Davis; Joshua Daniel,0,21,60,60
1650296065762,COGS 101B,A01,091572,Staff,4,0,60,56
1650296071790,COGS 101C,A01,083625,Delgado; Tania,19,0,30,11
1650296077820,COGS 107A,A01,083627,Boyle; Mary E. T.,0,8,60,60
1650296083844,COGS 118A,A01,083075,Staff,10,0,60,50
1650296089869,CSE 3,A50,083646,Miranda; Gregory Joseph,21,0,38,17
1650296089869,CSE 3,A51,083647,Miranda; Gregory Joseph,37,0,37,0
1650296095897,CSE 8A,A50,083650,Miranda; Gregory Joseph,0,23,40,40
1650296101924,CSE 11,A01,083080,Cao; Yingjun,0,80,40,40
1650296107946,CSE 12,A01,083652,Staff,0,10,100,100
1650296113968,CSE 15L,A01,083654,Staff,0,1,50,50
1650296113968,CSE 15L,A02,083655,Staff,4,0,50,46
1650296119993,CSE 20,A01,083657,Staff,53,0,80,27
1650296126015,CSE 30,A01,083084,Eldon; John,0,74,40,40
1650296132037,CSE 100,A01,083659,Cao; Yingjun,0,65,50,50
1650296138061,CSE 134B,A01,083661,Powell; Thomas Allan,0,29,65,65
1650296144090,CSE 140,A01,083663,Staff,0,0,75,75
1650296150115,CSE 140L,A01,083088,Eldon; John,0,6,75,75
1650296156139,CSE 175,A01,083665,Kumar; Rakesh,8,0,25,17
1650296162167,CSE 190,A00,092507,Dubnov; Shlomo,14,0,20,6
1650296168194,ECE 45,A01,083139,Staff,0,15,40,40
1650296174219,ECE 65,A50,083695,Staff,0,4,30,30
1650296180244,ECE 109,A01,091882,Touri; Behrouz,43,0,70,27
1650296186267,ECE 180,A00,083140,Abi Samra; Nicholas Camill,24,0,30,6
1650296186267,ECE 180,B00,083141,Abi Samra; Nicholas Camill,7,0,30,23
1650296192291,MATH 10A,A01,083735,Patchell; Gregory David,11,0,30,19
1650296192291,MATH 10A,A02,083736,Patchell; Gregory David,28,0,30,2
1650296192291,MATH 10A,A03,083737,Patchell; Gregory David,26,0,30,4
1650296198315,MATH 10B,A01,083207,Staff,0,6,30,30
1650296198315,MATH 10B,A02,083208,Staff,0,6,30,30
1650296198315,MATH 10B,B01,083739,Staff,17,0,30,13
1650296198315,MATH 10B,B02,083740,Staff,29,0,30,1
1650296204339,MATH 18,A01,083743,Staff,6,0,30,24
1650296204339,MATH 18,A02,083744,Staff,27,0,30,3
1650296204339,MATH 18,A03,083745,Staff,23,0,30,7
1650296204339,MATH 18,A04,083746,Staff,27,0,30,3
1650296204339,MATH 18,B01,083748,Staff,0,11,30,30
1650296204339,MATH 18,B02,083749,Staff,0,10,30,30
1650296204339,MATH 18,B03,083750,Staff,1,9,30,29
1650296204339,MATH 18,B04,083751,Staff,0,10,30,30
1650296210364,MATH 20A,A01,083754,Staff,25,0,40,15
1650296216388,MATH 20B,A01,083756,Staff,0,5,30,30
1650296216388,MATH 20B,A02,083757,Staff,0,7,30,30
1650296222413,MATH 20C,A01,083760,Staff,0,13,30,30
1650296222413,MATH 20C,A02,083761,Staff,0,13,30,30
1650296222413,MATH 20C,B01,083762,Staff,14,0,30,16
1650296222413,MATH 20C,B02,083763,Staff,27,0,30,3
1650296228436,MATH 20D,A01,083765,Staff,0,1,30,30
1650296228436,MATH 20D,A02,083766,Staff,8,0,30,22
1650296228436,MATH 20D,A03,083767,Staff,27,0,30,3
1650296234474,MATH 20E,A01,083771,Staff,5,0,30,25
1650296234474,MATH 20E,A02,083772,Staff,20,0,30,10
1650296234474,MATH 20E,B01,083773,Staff,0,0,30,30
1650296234474,MATH 20E,B02,083774,Staff,11,0,30,19
1650296240512,MATH 103A,A01,083777,Staff,0,11,30,30
1650296240512,MATH 103A,A02,083778,Staff,0,10,30,30
1650296240512,MATH 103A,B01,083779,Staff,0,10,30,30
1650296240512,MATH 103A,B02,083780,Staff,0,10,30,30
1650296246537,MATH 105,A01,085443,Staff,0,17,30,30
1650296252561,MATH 109,A01,083213,Anzaldo; Leesa B,0,5,30,30
1650296252561,MATH 109,A02,083214,Anzaldo; Leesa B,0,6,30,30
1650296252561,MATH 109,B01,083215,Anzaldo; Leesa B,0,4,30,30
1650296252561,MATH 109,B02,083216,Anzaldo; Leesa B,0,4,30,30
1650296258589,MATH 142A,A01,083219,Chow; Bennett,0,12,30,30
1650296258589,MATH 142A,A02,083220,Chow; Bennett,0,11,30,30
1650296258589,MATH 142A,B01,083221,Chow; Bennett,0,11,30,30
1650296258589,MATH 142A,B02,083222,Chow; Bennett,0,12,30,30
1650296264613,MATH 193A,A01,083224,Staff,0,5,30,30
1650296264613,MATH 193A,A02,083225,Staff,0,5,30,30
1650296264613,MATH 193A,A03,083781,Staff,0,2,30,30
1650296264613,MATH 193A,A04,083782,Staff,0,1,30,30
1650296270636,MATH 197,001,091859,McAuley; Julian John,9998,0,9999,1
1650296276692,COGS 9,A01,083615,Staff,0,14,60,60
1650296282719,COGS 11,A01,083617,Boyle; Mary E. T.,23,0,40,17
1650296288743,COGS 13,A01,083071,Staff,0,31,40,40
1650296294770,COGS 14A,A01,092681,Staff,0,16,100,100
1650296300793,COGS 14B,A01,083073,Cheng; Tzu-Han,0,9,50,50
1650296306819,COGS 17,A01,092677,Staff,27,0,75,48
1650296312843,COGS 100,A01,083619,Staff,0,23,60,60
1650296318866,COGS 101A,A01,083621,Davis; Joshua Daniel,0,21,60,60
1650296324892,COGS 101B,A01,091572,Staff,4,0,60,56
1650296330916,COGS 101C,A01,083625,Delgado; Tania,19,0,30,11
1650296336944,COGS 107A,A01,083627,Boyle; Mary E. T.,0,8,60,60
1650296342971,COGS 118A,A01,083075,Staff,10,0,60,50
1650296348995,CSE 3,A50,083646,Miranda; Gregory Joseph,21,0,38,17
1650296348995,CSE 3,A51,083647,Miranda; Gregory Joseph,37,0,37,0
1650296355020,CSE 8A,A50,083650,Miranda; Gregory Joseph,0,23,40,40
1650296361045,CSE 11,A01,083080,Cao; Yingjun,0,80,40,40
1650296367069,CSE 12,A01,083652,Staff,0,10,100,100
1650296373098,CSE 15L,A01,083654,Staff,0,1,50,50
1650296373098,CSE 15L,A02,083655,Staff,4,0,50,46
1650296379122,CSE 20,A01,083657,Staff,53,0,80,27
1650296385147,CSE 30,A01,083084,Eldon; John,0,74,40,40
1650296391178,CSE 100,A01,083659,Cao; Yingjun,0,65,50,50
1650296397202,CSE 134B,A01,083661,Powell; Thomas Allan,0,29,65,65
1650296403226,CSE 140,A01,083663,Staff,0,0,75,75
1650296409250,CSE 140L,A01,083088,Eldon; John,0,6,75,75
1650296415273,CSE 175,A01,083665,Kumar; Rakesh,8,0,25,17
1650296421297,CSE 190,A00,092507,Dubnov; Shlomo,14,0,20,6
1650296427326,ECE 45,A01,083139,Staff,0,15,40,40
1650296433444,ECE 65,A50,083695,Staff,0,4,30,30
1650296439497,ECE 109,A01,091882,Touri; Behrouz,43,0,70,27
1650296445521,ECE 180,A00,083140,Abi Samra; Nicholas Camill,24,0,30,6
1650296445521,ECE 180,B00,083141,Abi Samra; Nicholas Camill,7,0,30,23
1650296451546,MATH 10A,A01,083735,Patchell; Gregory David,11,0,30,19
1650296451546,MATH 10A,A02,083736,Patchell; Gregory David,28,0,30,2
1650296451546,MATH 10A,A03,083737,Patchell; Gregory David,26,0,30,4
1650296457570,MATH 10B,A01,083207,Staff,0,6,30,30
1650296457570,MATH 10B,A02,083208,Staff,0,6,30,30
1650296457570,MATH 10B,B01,083739,Staff,17,0,30,13
1650296457570,MATH 10B,B02,083740,Staff,29,0,30,1
1650296463599,MATH 18,A01,083743,Staff,6,0,30,24
1650296463599,MATH 18,A02,083744,Staff,27,0,30,3
1650296463599,MATH 18,A03,083745,Staff,23,0,30,7
1650296463599,MATH 18,A04,083746,Staff,27,0,30,3
1650296463599,MATH 18,B01,083748,Staff,0,11,30,30
1650296463599,MATH 18,B02,083749,Staff,0,10,30,30
1650296463599,MATH 18,B03,083750,Staff,1,9,30,29
1650296463599,MATH 18,B04,083751,Staff,0,10,30,30
1650296469628,MATH 20A,A01,083754,Staff,25,0,40,15
1650296475650,MATH 20B,A01,083756,Staff,0,5,30,30
1650296475650,MATH 20B,A02,083757,Staff,0,7,30,30
1650296481677,MATH 20C,A01,083760,Staff,0,13,30,30
1650296481677,MATH 20C,A02,083761,Staff,0,13,30,30
1650296481677,MATH 20C,B01,083762,Staff,14,0,30,16
1650296481677,MATH 20C,B02,083763,Staff,27,0,30,3
1650296487707,MATH 20D,A01,083765,Staff,0,1,30,30
1650296487707,MATH 20D,A02,083766,Staff,8,0,30,22
1650296487707,MATH 20D,A03,083767,Staff,27,0,30,3
1650296493736,MATH 20E,A01,083771,Staff,5,0,30,25
1650296493736,MATH 20E,A02,083772,Staff,20,0,30,10
1650296493736,MATH 20E,B01,083773,Staff,0,0,30,30
1650296493736,MATH 20E,B02,083774,Staff,11,0,30,19
1650296499768,MATH 103A,A01,083777,Staff,0,11,30,30
1650296499768,MATH 103A,A02,083778,Staff,0,10,30,30
1650296499768,MATH 103A,B01,083779,Staff,0,10,30,30
1650296499768,MATH 103A,B02,083780,Staff,0,10,30,30
1650296505799,MATH 105,A01,085443,Staff,0,17,30,30
1650296511832,MATH 109,A01,083213,Anzaldo; Leesa B,0,5,30,30
1650296511832,MATH 109,A02,083214,Anzaldo; Leesa B,0,6,30,30
1650296511832,MATH 109,B01,083215,Anzaldo; Leesa B,0,4,30,30
1650296511832,MATH 109,B02,083216,Anzaldo; Leesa B,0,4,30,30
1650296517857,MATH 142A,A01,083219,Chow; Bennett,0,12,30,30
1650296517857,MATH 142A,A02,083220,Chow; Bennett,0,11,30,30
1650296517857,MATH 142A,B01,083221,Chow; Bennett,0,11,30,30
1650296517857,MATH 142A,B02,083222,Chow; Bennett,0,12,30,30
1650296523891,MATH 193A,A01,083224,Staff,0,5,30,30
1650296523891,MATH 193A,A02,083225,Staff,0,5,30,30
1650296523891,MATH 193A,A03,083781,Staff,0,2,30,30
1650296523891,MATH 193A,A04,083782,Staff,0,1,30,30
1650296529916,MATH 197,001,091859,McAuley; Julian John,9998,0,9999,1
1650296535991,COGS 9,A01,083615,Staff,0,14,60,60
1650296542013,COGS 11,A01,083617,Boyle; Mary E. T.,23,0,40,17
1650296548042,COGS 13,A01,083071,Staff,0,31,40,40
1650296554067,COGS 14A,A01,092681,Staff,0,16,100,100
1650296560093,COGS 14B,A01,083073,Cheng; Tzu-Han,0,9,50,50
1650296566119,COGS 17,A01,092677,Staff,27,0,75,48
1650296572143,COGS 100,A01,083619,Staff,0,23,60,60
1650296578166,COGS 101A,A01,083621,Davis; Joshua Daniel,0,21,60,60
1650296584195,COGS 101B,A01,091572,Staff,4,0,60,56
1650296590219,COGS 101C,A01,083625,Delgado; Tania,19,0,30,11
1650296596251,COGS 107A,A01,083627,Boyle; Mary E. T.,0,8,60,60
1650296602279,COGS 118A,A01,083075,Staff,10,0,60,50
1650296608309,CSE 3,A50,083646,Miranda; Gregory Joseph,21,0,38,17
1650296608309,CSE 3,A51,083647,Miranda; Gregory Joseph,37,0,37,0
1650296614336,CSE 8A,A50,083650,Miranda; Gregory Joseph,0,23,40,40
1650296620359,CSE 11,A01,083080,Cao; Yingjun,0,80,40,40
1650296626385,CSE 12,A01,083652,Staff,0,10,100,100
1650296632408,CSE 15L,A01,083654,Staff,0,1,50,50
1650296632408,CSE 15L,A02,083655,Staff,4,0,50,46
1650296638431,CSE 20,A01,083657,Staff,53,0,80,27
1650296644461,CSE 30,A01,083084,Eldon; John,0,74,40,40
1650296650488,CSE 100,A01,083659,Cao; Yingjun,0,65,50,50
1650296656520,CSE 134B,A01,083661,Powell; Thomas Allan,0,29,65,65
1650296662545,CSE 140,A01,083663,Staff,0,0,75,75
1650296668569,CSE 140L,A01,083088,Eldon; John,0,6,75,75
1650296674593,CSE 175,A01,083665,Kumar; Rakesh,8,0,25,17
1650296680615,CSE 190,A00,092507,Dubnov; Shlomo,14,0,20,6
1650296686641,ECE 45,A01,083139,Staff,0,15,40,40
1650296692665,ECE 65,A50,083695,Staff,0,4,30,30
1650296698692,ECE 109,A01,091882,Touri; Behrouz,43,0,70,27
1650296704734,ECE 180,A00,083140,Abi Samra; Nicholas Camill,23,0,30,7
1650296704734,ECE 180,B00,083141,Abi Samra; Nicholas Camill,7,0,30,23
1650296710770,MATH 10A,A01,083735,Patchell; Gregory David,11,0,30,19
1650296710770,MATH 10A,A02,083736,Patchell; Gregory David,28,0,30,2
1650296710770,MATH 10A,A03,083737,Patchell; Gregory David,26,0,30,4
1650296716809,MATH 10B,A01,083207,Staff,0,6,30,30
1650296716809,MATH 10B,A02,083208,Staff,0,6,30,30
1650296716809,MATH 10B,B01,083739,Staff,17,0,30,13
1650296716809,MATH 10B,B02,083740,Staff,29,0,30,1
1650296722837,MATH 18,A01,083743,Staff,6,0,30,24
1650296722837,MATH 18,A02,083744,Staff,27,0,30,3
1650296722837,MATH 18,A03,083745,Staff,23,0,30,7
1650296722837,MATH 18,A04,083746,Staff,27,0,30,3
1650296722837,MATH 18,B01,083748,Staff,0,11,30,30
1650296722837,MATH 18,B02,083749,Staff,0,10,30,30
1650296722837,MATH 18,B03,083750,Staff,1,9,30,29
1650296722837,MATH 18,B04,083751,Staff,0,10,30,30
1650296728864,MATH 20A,A01,083754,Staff,25,0,40,15
1650296734897,MATH 20B,A01,083756,Staff,0,5,30,30
1650296734897,MATH 20B,A02,083757,Staff,0,7,30,30
1650296740927,MATH 20C,A01,083760,Staff,0,13,30,30
1650296740927,MATH 20C,A02,083761,Staff,0,13,30,30
1650296740927,MATH 20C,B01,083762,Staff,14,0,30,16
1650296740927,MATH 20C,B02,083763,Staff,27,0,30,3
1650296746949,MATH 20D,A01,083765,Staff,0,1,30,30
1650296746949,MATH 20D,A02,083766,Staff,8,0,30,22
1650296746949,MATH 20D,A03,083767,Staff,27,0,30,3
1650296752996,MATH 20E,A01,083771,Staff,5,0,30,25
1650296752996,MATH 20E,A02,083772,Staff,20,0,30,10
1650296752996,MATH 20E,B01,083773,Staff,0,0,30,30
1650296752996,MATH 20E,B02,083774,Staff,11,0,30,19
1650296759021,MATH 103A,A01,083777,Staff,0,11,30,30
1650296759021,MATH 103A,A02,083778,Staff,0,10,30,30
1650296759021,MATH 103A,B01,083779,Staff,0,10,30,30
1650296759021,MATH 103A,B02,083780,Staff,0,10,30,30
1650296765045,MATH 105,A01,085443,Staff,0,17,30,30
1650296771075,MATH 109,A01,083213,Anzaldo; Leesa B,0,5,30,30
1650296771075,MATH 109,A02,083214,Anzaldo; Leesa B,0,6,30,30
1650296771075,MATH 109,B01,083215,Anzaldo; Leesa B,0,4,30,30
1650296771075,MATH 109,B02,083216,Anzaldo; Leesa B,0,4,30,30
1650296777104,MATH 142A,A01,083219,Chow; Bennett,0,12,30,30
1650296777104,MATH 142A,A02,083220,Chow; Bennett,0,11,30,30
1650296777104,MATH 142A,B01,083221,Chow; Bennett,0,11,30,30
1650296777104,MATH 142A,B02,083222,Chow; Bennett,0,12,30,30
1650296783129,MATH 193A,A01,083224,Staff,0,5,30,30
1650296783129,MATH 193A,A02,083225,Staff,0,5,30,30
1650296783129,MATH 193A,A03,083781,Staff,0,2,30,30
1650296783129,MATH 193A,A04,083782,Staff,0,1,30,30
1650296789160,MATH 197,001,091859,McAuley; Julian John,9998,0,9999,1
1650296795210,COGS 9,A01,083615,Staff,0,14,60,60
1650296801236,COGS 11,A01,083617,Boyle; Mary E. T.,23,0,40,17
1650296807259,COGS 13,A01,083071,Staff,0,31,40,40
1650296813287,COGS 14A,A01,092681,Staff,0,16,100,100
1650296819310,COGS 14B,A01,083073,Cheng; Tzu-Han,0,9,50,50
1650296825335,COGS 17,A01,092677,Staff,26,0,75,49
1650296831365,COGS 100,A01,083619,Staff,0,23,60,60
1650296837390,COGS 101A,A01,083621,Davis; Joshua Daniel,0,21,60,60
1650296843414,COGS 101B,A01,091572,Staff,4,0,60,56
1650296849450,COGS 101C,A01,083625,Delgado; Tania,19,0,30,11
1650296855473,COGS 107A,A01,083627,Boyle; Mary E. T.,0,8,60,60
1650296861496,COGS 118A,A01,083075,Staff,9,0,60,51
1650296867554,CSE 3,A50,083646,Miranda; Gregory Joseph,21,0,38,17
1650296867554,CSE 3,A51,083647,Miranda; Gregory Joseph,37,0,37,0
1650296873581,CSE 8A,A50,083650,Miranda; Gregory Joseph,0,23,40,40
1650296879611,CSE 11,A01,083080,Cao; Yingjun,0,80,40,40
1650296885638,CSE 12,A01,083652,Staff,0,10,100,100
1650296891672,CSE 15L,A01,083654,Staff,0,1,50,50
1650296891672,CSE 15L,A02,083655,Staff,4,0,50,46
1650296897700,CSE 20,A01,083657,Staff,53,0,80,27
1650296903723,CSE 30,A01,083084,Eldon; John,0,74,40,40
1650296909748,CSE 100,A01,083659,Cao; Yingjun,0,65,50,50
1650296915773,CSE 134B,A01,083661,Powell; Thomas Allan,0,29,65,65
1650296921802,CSE 140,A01,083663,Staff,0,0,75,75
1650296927827,CSE 140L,A01,083088,Eldon; John,0,6,75,75
1650296933850,CSE 175,A01,083665,Kumar; Rakesh,8,0,25,17
1650296939874,CSE 190,A00,092507,Dubnov; Shlomo,14,0,20,6
1650296945903,ECE 45,A01,083139,Staff,0,15,40,40
1650296951932,ECE 65,A50,083695,Staff,0,4,30,30
1650296957960,ECE 109,A01,091882,Touri; Behrouz,43,0,70,27
1650296963987,ECE 180,A00,083140,Abi Samra; Nicholas Camill,23,0,30,7
1650296963987,ECE 180,B00,083141,Abi Samra; Nicholas Camill,7,0,30,23
1650296970016,MATH 10A,A01,083735,Patchell; Gregory David,11,0,30,19
1650296970016,MATH 10A,A02,083736,Patchell; Gregory David,28,0,30,2
1650296970016,MATH 10A,A03,083737,Patchell; Gregory David,26,0,30,4
1650296976040,MATH 10B,A01,083207,Staff,0,6,30,30
1650296976040,MATH 10B,A02,083208,Staff,0,6,30,30
1650296976040,MATH 10B,B01,083739,Staff,17,0,30,13
1650296976040,MATH 10B,B02,083740,Staff,29,0,30,1
1650296982069,MATH 18,A01,083743,Staff,6,0,30,24
1650296982069,MATH 18,A02,083744,Staff,27,0,30,3
1650296982069,MATH 18,A03,083745,Staff,23,0,30,7
1650296982069,MATH 18,A04,083746,Staff,27,0,30,3
1650296982069,MATH 18,B01,083748,Staff,0,11,30,30
1650296982069,MATH 18,B02,083749,Staff,0,10,30,30
1650296982069,MATH 18,B03,083750,Staff,1,9,30,29
1650296982069,MATH 18,B04,083751,Staff,0,10,30,30
1650296988093,MATH 20A,A01,083754,Staff,25,0,40,15
1650296994117,MATH 20B,A01,083756,Staff,0,5,30,30
1650296994117,MATH 20B,A02,083757,Staff,0,7,30,30
1650297000152,MATH 20C,A01,083760,Staff,0,13,30,30
1650297000152,MATH 20C,A02,083761,Staff,0,13,30,30
1650297000152,MATH 20C,B01,083762,Staff,13,0,30,17
1650297000152,MATH 20C,B02,083763,Staff,28,0,30,2
1650297006176,MATH 20D,A01,083765,Staff,0,1,30,30
1650297006176,MATH 20D,A02,083766,Staff,8,0,30,22
1650297006176,MATH 20D,A03,083767,Staff,27,0,30,3
1650297012220,MATH 20E,A01,083771,Staff,5,0,30,25
1650297012220,MATH 20E,A02,083772,Staff,20,0,30,10
1650297012220,MATH 20E,B01,083773,Staff,0,0,30,30
1650297012220,MATH 20E,B02,083774,Staff,11,0,30,19
1650297018248,MATH 103A,A01,083777,Staff,0,11,30,30
1650297018248,MATH 103A,A02,083778,Staff,0,10,30,30
1650297018248,MATH 103A,B01,083779,Staff,0,10,30,30
1650297018248,MATH 103A,B02,083780,Staff,0,10,30,30
1650297024271,MATH 105,A01,085443,Staff,0,17,30,30
1650297030384,MATH 109,A01,083213,Anzaldo; Leesa B,0,5,30,30
1650297030384,MATH 109,A02,083214,Anzaldo; Leesa B,0,6,30,30
1650297030384,MATH 109,B01,083215,Anzaldo; Leesa B,0,4,30,30
1650297030384,MATH 109,B02,083216,Anzaldo; Leesa B,0,4,30,30
1650297036417,MATH 142A,A01,083219,Chow; Bennett,0,12,30,30
1650297036417,MATH 142A,A02,083220,Chow; Bennett,0,11,30,30
1650297036417,MATH 142A,B01,083221,Chow; Bennett,0,11,30,30
1650297036417,MATH 142A,B02,083222,Chow; Bennett,0,12,30,30
1650297042446,MATH 193A,A01,083224,Staff,0,5,30,30
1650297042446,MATH 193A,A02,083225,Staff,0,5,30,30
1650297042446,MATH 193A,A03,083781,Staff,0,2,30,30
1650297042446,MATH 193A,A04,083782,Staff,0,1,30,30
1650297048469,MATH 197,001,091859,McAuley; Julian John,9998,0,9999,1
1650297054556,COGS 9,A01,083615,Staff,0,14,60,60
1650297060584,COGS 11,A01,083617,Boyle; Mary E. T.,23,0,40,17
1650297066610,COGS 13,A01,083071,Staff,0,31,40,40
1650297072634,COGS 14A,A01,092681,Staff,0,16,100,100
1650297078660,COGS 14B,A01,083073,Cheng; Tzu-Han,0,9,50,50
1650297084687,COGS 17,A01,092677,Staff,26,0,75,49
1650297090710,COGS 100,A01,083619,Staff,0,23,60,60
1650297096742,COGS 101A,A01,083621,Davis; Joshua Daniel,0,21,60,60
1650297102770,COGS 101B,A01,091572,Staff,4,0,60,56
1650297108798,COGS 101C,A01,083625,Delgado; Tania,19,0,30,11
1650297114825,COGS 107A,A01,083627,Boyle; Mary E. T.,0,8,60,60
1650297120849,COGS 118A,A01,083075,Staff,9,0,60,51
1650297126891,CSE 3,A50,083646,Miranda; Gregory Joseph,21,0,38,17
1650297126891,CSE 3,A51,083647,Miranda; Gregory Joseph,37,0,37,0
1650297132928,CSE 8A,A50,083650,Miranda; Gregory Joseph,0,23,40,40
1650297138953,CSE 11,A01,083080,Cao; Yingjun,0,80,40,40
1650297144986,CSE 12,A01,083652,Staff,0,10,100,100
1650297151022,CSE 15L,A01,083654,Staff,0,1,50,50
1650297151022,CSE 15L,A02,083655,Staff,4,0,50,46
1650297157049,CSE 20,A01,083657,Staff,53,0,80,27
1650297163074,CSE 30,A01,083084,Eldon; John,0,74,40,40
1650297169097,CSE 100,A01,083659,Cao; Yingjun,0,65,50,50
1650297175122,CSE 134B,A01,083661,Powell; Thomas Allan,0,29,65,65
1650297181150,CSE 140,A01,083663,Staff,0,0,75,75
1650297187175,CSE 140L,A01,083088,Eldon; John,0,6,75,75
1650297193202,CSE 175,A01,083665,Kumar; Rakesh,8,0,25,17
1650297199225,CSE 190,A00,092507,Dubnov; Shlomo,14,0,20,6
1650297205250,ECE 45,A01,083139,Staff,0,15,40,40
1650297211273,ECE 65,A50,083695,Staff,0,4,30,30
1650297217295,ECE 109,A01,091882,Touri; Behrouz,43,0,70,27
1650297223319,ECE 180,A00,083140,Abi Samra; Nicholas Camill,23,0,30,7
1650297223319,ECE 180,B00,083141,Abi Samra; Nicholas Camill,7,0,30,23
1650297229346,MATH 10A,A01,083735,Patchell; Gregory David,11,0,30,19
1650297229346,MATH 10A,A02,083736,Patchell; Gregory David,28,0,30,2
1650297229346,MATH 10A,A03,083737,Patchell; Gregory David,26,0,30,4
1650297235374,MATH 10B,A01,083207,Staff,0,6,30,30
1650297235374,MATH 10B,A02,083208,Staff,0,6,30,30
1650297235374,MATH 10B,B01,083739,Staff,17,0,30,13
1650297235374,MATH 10B,B02,083740,Staff,29,0,30,1
1650297241401,MATH 18,A01,083743,Staff,6,0,30,24
1650297241401,MATH 18,A02,083744,Staff,27,0,30,3
1650297241401,MATH 18,A03,083745,Staff,23,0,30,7
1650297241401,MATH 18,A04,083746,Staff,27,0,30,3
1650297241401,MATH 18,B01,083748,Staff,0,11,30,30
1650297241401,MATH 18,B02,083749,Staff,0,10,30,30
1650297241401,MATH 18,B03,083750,Staff,1,9,30,29
1650297241401,MATH 18,B04,083751,Staff,0,10,30,30
1650297247437,MATH 20A,A01,083754,Staff,25,0,40,15
1650297253459,MATH 20B,A01,083756,Staff,0,5,30,30
1650297253459,MATH 20B,A02,083757,Staff,0,7,30,30
1650297259484,MATH 20C,A01,083760,Staff,0,13,30,30
1650297259484,MATH 20C,A02,083761,Staff,0,13,30,30
1650297259484,MATH 20C,B01,083762,Staff,13,0,30,17
1650297259484,MATH 20C,B02,083763,Staff,28,0,30,2
1650297265524,MATH 20D,A01,083765,Staff,0,1,30,30
1650297265524,MATH 20D,A02,083766,Staff,8,0,30,22
1650297265524,MATH 20D,A03,083767,Staff,27,0,30,3
1650297271556,MATH 20E,A01,083771,Staff,5,0,30,25
1650297271556,MATH 20E,A02,083772,Staff,20,0,30,10
1650297271556,MATH 20E,B01,083773,Staff,0,0,30,30
1650297271556,MATH 20E,B02,083774,Staff,11,0,30,19
1650297277585,MATH 103A,A01,083777,Staff,0,11,30,30
1650297277585,MATH 103A,A02,083778,Staff,0,10,30,30
1650297277585,MATH 103A,B01,083779,Staff,0,10,30,30
1650297277585,MATH 103A,B02,083780,Staff,0,10,30,30
1650297283609,MATH 105,A01,085443,Staff,0,17,30,30
1650297289642,MATH 109,A01,083213,Anzaldo; Leesa B,0,5,30,30
1650297289642,MATH 109,A02,083214,Anzaldo; Leesa B,0,6,30,30
1650297289642,MATH 109,B01,083215,Anzaldo; Leesa B,0,4,30,30
1650297289642,MATH 109,B02,083216,Anzaldo; Leesa B,0,4,30,30
1650297295670,MATH 142A,A01,083219,Chow; Bennett,0,12,30,30
1650297295670,MATH 142A,A02,083220,Chow; Bennett,0,11,30,30
1650297295670,MATH 142A,B01,083221,Chow; Bennett,0,11,30,30
1650297295670,MATH 142A,B02,083222,Chow; Bennett,0,12,30,30
1650297301702,MATH 193A,A01,083224,Staff,0,5,30,30
1650297301702,MATH 193A,A02,083225,Staff,0,5,30,30
1650297301702,MATH 193A,A03,083781,Staff,0,2,30,30
1650297301702,MATH 193A,A04,083782,Staff,0,1,30,30
1650297307733,MATH 197,001,091859,McAuley; Julian John,9998,0,9999,1
1650297313792,COGS 9,A01,083615,Staff,0,14,60,60
1650297319817,COGS 11,A01,083617,Boyle; Mary E. T.,23,0,40,17
1650297325852,COGS 13,A01,083071,Staff,0,31,40,40
1650297331879,COGS 14A,A01,092681,Staff,0,16,100,100
1650297337903,COGS 14B,A01,083073,Cheng; Tzu-Han,0,9,50,50
1650297343928,COGS 17,A01,092677,Staff,26,0,75,49
1650297349959,COGS 100,A01,083619,Staff,0,23,60,60
1650297355985,COGS 101A,A01,083621,Davis; Joshua Daniel,0,21,60,60
1650297362011,COGS 101B,A01,091572,Staff,4,0,60,56
1650297368040,COGS 101C,A01,083625,Delgado; Tania,19,0,30,11
1650297374062,COGS 107A,A01,083627,Boyle; Mary E. T.,0,8,60,60
1650297380086,COGS 118A,A01,083075,Staff,9,0,60,51
1650297386122,CSE 3,A50,083646,Miranda; Gregory Joseph,21,0,38,17
1650297386122,CSE 3,A51,083647,Miranda; Gregory Joseph,37,0,37,0
1650297392158,CSE 8A,A50,083650,Miranda; Gregory Joseph,0,23,40,40
1650297398181,CSE 11,A01,083080,Cao; Yingjun,0,80,40,40
1650297404205,CSE 12,A01,083652,Staff,0,10,100,100
1650297410247,CSE 15L,A01,083654,Staff,0,1,50,50
1650297410247,CSE 15L,A02,083655,Staff,4,0,50,46
1650297416270,CSE 20,A01,083657,Staff,53,0,80,27
1650297422304,CSE 30,A01,083084,Eldon; John,0,74,40,40
1650297428327,CSE 100,A01,083659,Cao; Yingjun,0,65,50,50
1650297434361,CSE 134B,A01,083661,Powell; Thomas Allan,0,29,65,65
1650297440384,CSE 140,A01,083663,Staff,0,0,75,75
1650297446410,CSE 140L,A01,083088,Eldon; John,0,6,75,75
1650297452439,CSE 175,A01,083665,Kumar; Rakesh,8,0,25,17
1650297458466,CSE 190,A00,092507,Dubnov; Shlomo,14,0,20,6
1650297464504,ECE 45,A01,083139,Staff,0,15,40,40
1650297470530,ECE 65,A50,083695,Staff,0,4,30,30
1650297476560,ECE 109,A01,091882,Touri; Behrouz,43,0,70,27
1650297482584,ECE 180,A00,083140,Abi Samra; Nicholas Camill,23,0,30,7
1650297482584,ECE 180,B00,083141,Abi Samra; Nicholas Camill,7,0,30,23
1650297488608,MATH 10A,A01,083735,Patchell; Gregory David,11,0,30,19
1650297488608,MATH 10A,A02,083736,Patchell; Gregory David,28,0,30,2
1650297488608,MATH 10A,A03,083737,Patchell; Gregory David,26,0,30,4
1650297494631,MATH 10B,A01,083207,Staff,0,6,30,30
1650297494631,MATH 10B,A02,083208,Staff,0,6,30,30
1650297494631,MATH 10B,B01,083739,Staff,17,0,30,13
1650297494631,MATH 10B,B02,083740,Staff,29,0,30,1
1650297500657,MATH 18,A01,083743,Staff,6,0,30,24
1650297500657,MATH 18,A02,083744,Staff,26,0,30,4
1650297500657,MATH 18,A03,083745,Staff,23,0,30,7
1650297500657,MATH 18,A04,083746,Staff,27,0,30,3
1650297500657,MATH 18,B01,083748,Staff,0,11,30,30
1650297500657,MATH 18,B02,083749,Staff,0,10,30,30
1650297500657,MATH 18,B03,083750,Staff,1,8,30,29
1650297500657,MATH 18,B04,083751,Staff,0,10,30,30
1650297506700,MATH 20A,A01,083754,Staff,25,0,40,15
1650297512725,MATH 20B,A01,083756,Staff,0,5,30,30
1650297512725,MATH 20B,A02,083757,Staff,0,7,30,30
1650297518756,MATH 20C,A01,083760,Staff,0,13,30,30
1650297518756,MATH 20C,A02,083761,Staff,0,13,30,30
1650297518756,MATH 20C,B01,083762,Staff,14,0,30,16
1650297518756,MATH 20C,B02,083763,Staff,27,0,30,3
1650297524782,MATH 20D,A01,083765,Staff,0,1,30,30
1650297524782,MATH 20D,A02,083766,Staff,8,0,30,22
1650297524782,MATH 20D,A03,083767,Staff,27,0,30,3
1650297530815,MATH 20E,A01,083771,Staff,5,0,30,25
1650297530815,MATH 20E,A02,083772,Staff,20,0,30,10
1650297530815,MATH 20E,B01,083773,Staff,0,0,30,30
1650297530815,MATH 20E,B02,083774,Staff,11,0,30,19
1650297536848,MATH 103A,A01,083777,Staff,0,11,30,30
1650297536848,MATH 103A,A02,083778,Staff,0,10,30,30
1650297536848,MATH 103A,B01,083779,Staff,0,10,30,30
1650297536848,MATH 103A,B02,083780,Staff,0,10,30,30
1650297542875,MATH 105,A01,085443,Staff,0,17,30,30
1650297548901,MATH 109,A01,083213,Anzaldo; Leesa B,0,5,30,30
1650297548901,MATH 109,A02,083214,Anzaldo; Leesa B,0,6,30,30
1650297548901,MATH 109,B01,083215,Anzaldo; Leesa B,0,4,30,30
1650297548901,MATH 109,B02,083216,Anzaldo; Leesa B,0,4,30,30
1650297554925,MATH 142A,A01,083219,Chow; Bennett,0,12,30,30
1650297554925,MATH 142A,A02,083220,Chow; Bennett,0,11,30,30
1650297554925,MATH 142A,B01,083221,Chow; Bennett,0,11,30,30
1650297554925,MATH 142A,B02,083222,Chow; Bennett,0,12,30,30
1650297560950,MATH 193A,A01,083224,Staff,0,5,30,30
1650297560950,MATH 193A,A02,083225,Staff,0,5,30,30
1650297560950,MATH 193A,A03,083781,Staff,0,2,30,30
1650297560950,MATH 193A,A04,083782,Staff,0,1,30,30
1650297566973,MATH 197,001,091859,McAuley; Julian John,9998,0,9999,1
1650297573039,COGS 9,A01,083615,Staff,0,14,60,60
1650297579073,COGS 11,A01,083617,Boyle; Mary E. T.,23,0,40,17
1650297585100,COGS 13,A01,083071,Staff,0,31,40,40
1650297591125,COGS 14A,A01,092681,Staff,0,16,100,100
1650297597153,COGS 14B,A01,083073,Cheng; Tzu-Han,0,9,50,50
1650297603180,COGS 17,A01,092677,Staff,26,0,75,49
1650297609214,COGS 100,A01,083619,Staff,0,23,60,60
1650297615238,COGS 101A,A01,083621,Davis; Joshua Daniel,0,21,60,60
1650297621350,COGS 101B,A01,091572,Staff,4,0,60,56
1650297627377,COGS 101C,A01,083625,Delgado; Tania,19,0,30,11
1650297633401,COGS 107A,A01,083627,Boyle; Mary E. T.,0,8,60,60
1650297639424,COGS 118A,A01,083075,Staff,9,0,60,51
1650297645453,CSE 3,A50,083646,Miranda; Gregory Joseph,21,0,38,17
1650297645453,CSE 3,A51,083647,Miranda; Gregory Joseph,37,0,37,0
1650297651481,CSE 8A,A50,083650,Miranda; Gregory Joseph,0,23,40,40
1650297657508,CSE 11,A01,083080,Cao; Yingjun,0,80,40,40
1650297663531,CSE 12,A01,083652,Staff,0,10,100,100
1650297669561,CSE 15L,A01,083654,Staff,0,1,50,50
1650297669561,CSE 15L,A02,083655,Staff,4,0,50,46
1650297675585,CSE 20,A01,083657,Staff,53,0,80,27
1650297681616,CSE 30,A01,083084,Eldon; John,0,74,40,40
1650297687644,CSE 100,A01,083659,Cao; Yingjun,0,65,50,50
1650297693670,CSE 134B,A01,083661,Powell; Thomas Allan,0,29,65,65
1650297699694,CSE 140,A01,083663,Staff,0,0,75,75
1650297705717,CSE 140L,A01,083088,Eldon; John,0,6,75,75
1650297711740,CSE 175,A01,083665,Kumar; Rakesh,8,0,25,17
1650297717764,CSE 190,A00,092507,Dubnov; Shlomo,14,0,20,6
1650297723792,ECE 45,A01,083139,Staff,0,15,40,40
1650297729816,ECE 65,A50,083695,Staff,0,4,30,30
1650297735845,ECE 109,A01,091882,Touri; Behrouz,43,0,70,27
1650297741870,ECE 180,A00,083140,Abi Samra; Nicholas Camill,23,0,30,7
1650297741870,ECE 180,B00,083141,Abi Samra; Nicholas Camill,7,0,30,23
1650297747895,MATH 10A,A01,083735,Patchell; Gregory David,11,0,30,19
1650297747895,MATH 10A,A02,083736,Patchell; Gregory David,28,0,30,2
1650297747895,MATH 10A,A03,083737,Patchell; Gregory David,26,0,30,4
1650297753923,MATH 10B,A01,083207,Staff,0,6,30,30
1650297753923,MATH 10B,A02,083208,Staff,0,6,30,30
1650297753923,MATH 10B,B01,083739,Staff,17,0,30,13
1650297753923,MATH 10B,B02,083740,Staff,29,0,30,1
1650297759953,MATH 18,A01,083743,Staff,6,0,30,24
1650297759953,MATH 18,A02,083744,Staff,26,0,30,4
1650297759953,MATH 18,A03,083745,Staff,23,0,30,7
1650297759953,MATH 18,A04,083746,Staff,27,0,30,3
1650297759953,MATH 18,B01,083748,Staff,0,11,30,30
1650297759953,MATH 18,B02,083749,Staff,0,10,30,30
1650297759953,MATH 18,B03,083750,Staff,1,8,30,29
1650297759953,MATH 18,B04,083751,Staff,0,10,30,30
1650297765978,MATH 20A,A01,083754,Staff,25,0,40,15
1650297772009,MATH 20B,A01,083756,Staff,0,5,30,30
1650297772009,MATH 20B,A02,083757,Staff,0,7,30,30
1650297778036,MATH 20C,A01,083760,Staff,0,13,30,30
1650297778036,MATH 20C,A02,083761,Staff,0,13,30,30
1650297778036,MATH 20C,B01,083762,Staff,14,0,30,16
1650297778036,MATH 20C,B02,083763,Staff,28,0,30,2
1650297784058,MATH 20D,A01,083765,Staff,0,1,30,30
1650297784058,MATH 20D,A02,083766,Staff,8,0,30,22
1650297784058,MATH 20D,A03,083767,Staff,27,0,30,3
1650297790093,MATH 20E,A01,083771,Staff,5,0,30,25
1650297790093,MATH 20E,A02,083772,Staff,20,0,30,10
1650297790093,MATH 20E,B01,083773,Staff,0,0,30,30
1650297790093,MATH 20E,B02,083774,Staff,11,0,30,19
1650297796121,MATH 103A,A01,083777,Staff,0,11,30,30
1650297796121,MATH 103A,A02,083778,Staff,0,10,30,30
1650297796121,MATH 103A,B01,083779,Staff,0,10,30,30
1650297796121,MATH 103A,B02,083780,Staff,0,10,30,30
1650297802157,MATH 105,A01,085443,Staff,0,17,30,30
1650297808185,MATH 109,A01,083213,Anzaldo; Leesa B,0,5,30,30
1650297808185,MATH 109,A02,083214,Anzaldo; Leesa B,0,6,30,30
1650297808185,MATH 109,B01,083215,Anzaldo; Leesa B,0,4,30,30
1650297808185,MATH 109,B02,083216,Anzaldo; Leesa B,0,4,30,30
1650297814210,MATH 142A,A01,083219,Chow; Bennett,0,12,30,30
1650297814210,MATH 142A,A02,083220,Chow; Bennett,0,11,30,30
1650297814210,MATH 142A,B01,083221,Chow; Bennett,0,11,30,30
1650297814210,MATH 142A,B02,083222,Chow; Bennett,0,12,30,30
1650297820234,MATH 193A,A01,083224,Staff,0,5,30,30
1650297820234,MATH 193A,A02,083225,Staff,0,5,30,30
1650297820234,MATH 193A,A03,083781,Staff,0,2,30,30
1650297820234,MATH 193A,A04,083782,Staff,0,1,30,30
1650297826260,MATH 197,001,091859,McAuley; Julian John,9998,0,9999,1
1650297832318,COGS 9,A01,083615,Staff,0,14,60,60
1650297838346,COGS 11,A01,083617,Boyle; Mary E. T.,23,0,40,17
1650297844371,COGS 13,A01,083071,Staff,0,31,40,40
1650297850403,COGS 14A,A01,092681,Staff,0,16,100,100
1650297856436,COGS 14B,A01,083073,Cheng; Tzu-Han,0,9,50,50
1650297862461,COGS 17,A01,092677,Staff,26,0,75,49
1650297868488,COGS 100,A01,083619,Staff,0,23,60,60
1650297874512,COGS 101A,A01,083621,Davis; Joshua Daniel,0,21,60,60
1650297880536,COGS 101B,A01,091572,Staff,4,0,60,56
1650297886564,COGS 101C,A01,083625,Delgado; Tania,19,0,30,11
1650297892596,COGS 107A,A01,083627,Boyle; Mary E. T.,0,8,60,60
1650297898627,COGS 118A,A01,083075,Staff,9,0,60,51
1650297904663,CSE 3,A50,083646,Miranda; Gregory Joseph,21,0,38,17
1650297904663,CSE 3,A51,083647,Miranda; Gregory Joseph,37,0,37,0
1650297910696,CSE 8A,A50,083650,Miranda; Gregory Joseph,0,23,40,40
1650297916719,CSE 11,A01,083080,Cao; Yingjun,0,80,40,40
1650297922750,CSE 12,A01,083652,Staff,0,10,100,100
1650297928792,CSE 15L,A01,083654,Staff,0,1,50,50
1650297928792,CSE 15L,A02,083655,Staff,4,0,50,46
1650297934822,CSE 20,A01,083657,Staff,53,0,80,27
1650297940848,CSE 30,A01,083084,Eldon; John,0,74,40,40
1650297946871,CSE 100,A01,083659,Cao; Yingjun,0,65,50,50
1650297952906,CSE 134B,A01,083661,Powell; Thomas Allan,0,29,65,65
1650297958933,CSE 140,A01,083663,Staff,0,0,75,75
1650297964956,CSE 140L,A01,083088,Eldon; John,0,6,75,75
1650297970996,CSE 175,A01,083665,Kumar; Rakesh,8,0,25,17
1650297977021,CSE 190,A00,092507,Dubnov; Shlomo,14,0,20,6
1650297983048,ECE 45,A01,083139,Staff,0,15,40,40
1650297989072,ECE 65,A50,083695,Staff,0,4,30,30
1650297995100,ECE 109,A01,091882,Touri; Behrouz,43,0,70,27
1650298001127,ECE 180,A00,083140,Abi Samra; Nicholas Camill,23,0,30,7
1650298001127,ECE 180,B00,083141,Abi Samra; Nicholas Camill,7,0,30,23
1650298007150,MATH 10A,A01,083735,Patchell; Gregory David,11,0,30,19
1650298007150,MATH 10A,A02,083736,Patchell; Gregory David,28,0,30,2
1650298007150,MATH 10A,A03,083737,Patchell; Gregory David,26,0,30,4
1650298013174,MATH 10B,A01,083207,Staff,0,6,30,30
1650298013174,MATH 10B,A02,083208,Staff,0,6,30,30
1650298013174,MATH 10B,B01,083739,Staff,17,0,30,13
1650298013174,MATH 10B,B02,083740,Staff,29,0,30,1
1650298019203,MATH 18,A01,083743,Staff,6,0,30,24
1650298019203,MATH 18,A02,083744,Staff,26,0,30,4
1650298019203,MATH 18,A03,083745,Staff,23,0,30,7
1650298019203,MATH 18,A04,083746,Staff,27,0,30,3
1650298019203,MATH 18,B01,083748,Staff,0,11,30,30
1650298019203,MATH 18,B02,083749,Staff,0,10,30,30
1650298019203,MATH 18,B03,083750,Staff,1,8,30,29
1650298019203,MATH 18,B04,083751,Staff,0,10,30,30
1650298025229,MATH 20A,A01,083754,Staff,25,0,40,15
1650298031276,MATH 20B,A01,083756,Staff,0,5,30,30
1650298031276,MATH 20B,A02,083757,Staff,0,7,30,30
1650298037300,MATH 20C,A01,083760,Staff,0,13,30,30
1650298037300,MATH 20C,A02,083761,Staff,0,13,30,30
1650298037300,MATH 20C,B01,083762,Staff,14,0,30,16
1650298037300,MATH 20C,B02,083763,Staff,28,0,30,2
1650298043341,MATH 20D,A01,083765,Staff,0,1,30,30
1650298043341,MATH 20D,A02,083766,Staff,8,0,30,22
1650298043341,MATH 20D,A03,083767,Staff,27,0,30,3
1650298049365,MATH 20E,A01,083771,Staff,5,0,30,25
1650298049365,MATH 20E,A02,083772,Staff,20,0,30,10
1650298049365,MATH 20E,B01,083773,Staff,0,0,30,30
1650298049365,MATH 20E,B02,083774,Staff,11,0,30,19
1650298055388,MATH 103A,A01,083777,Staff,0,11,30,30
1650298055388,MATH 103A,A02,083778,Staff,0,10,30,30
1650298055388,MATH 103A,B01,083779,Staff,0,10,30,30
1650298055388,MATH 103A,B02,083780,Staff,0,10,30,30
1650298061417,MATH 105,A01,085443,Staff,0,17,30,30
1650298067447,MATH 109,A01,083213,Anzaldo; Leesa B,0,5,30,30
1650298067447,MATH 109,A02,083214,Anzaldo; Leesa B,0,6,30,30
1650298067447,MATH 109,B01,083215,Anzaldo; Leesa B,0,4,30,30
1650298067447,MATH 109,B02,083216,Anzaldo; Leesa B,0,4,30,30
1650298073477,MATH 142A,A01,083219,Chow; Bennett,0,12,30,30
1650298073477,MATH 142A,A02,083220,Chow; Bennett,0,11,30,30
1650298073477,MATH 142A,B01,083221,Chow; Bennett,0,11,30,30
1650298073477,MATH 142A,B02,083222,Chow; Bennett,0,12,30,30
1650298079504,MATH 193A,A01,083224,Staff,0,5,30,30
1650298079504,MATH 193A,A02,083225,Staff,0,5,30,30
1650298079504,MATH 193A,A03,083781,Staff,0,2,30,30
1650298079504,MATH 193A,A04,083782,Staff,0,1,30,30
1650298085527,MATH 197,001,091859,McAuley; Julian John,9998,0,9999,1
1650298091578,COGS 9,A01,083615,Staff,0,14,60,60
1650298097601,COGS 11,A01,083617,Boyle; Mary E. T.,23,0,40,17
1650298103632,COGS 13,A01,083071,Staff,0,31,40,40
1650298109658,COGS 14A,A01,092681,Staff,0,16,100,100
1650298115684,COGS 14B,A01,083073,Cheng; Tzu-Han,0,9,50,50
1650298121709,COGS 17,A01,092677,Staff,26,0,75,49
1650298127743,COGS 100,A01,083619,Staff,0,23,60,60
1650298133766,COGS 101A,A01,083621,Davis; Joshua Daniel,0,21,60,60
1650298139790,COGS 101B,A01,091572,Staff,4,0,60,56
1650298145817,COGS 101C,A01,083625,Delgado; Tania,19,0,30,11
1650298151841,COGS 107A,A01,083627,Boyle; Mary E. T.,0,8,60,60
1650298157866,COGS 118A,A01,083075,Staff,9,0,60,51
1650298163905,CSE 3,A50,083646,Miranda; Gregory Joseph,21,0,38,17
1650298163905,CSE 3,A51,083647,Miranda; Gregory Joseph,37,0,37,0
1650298169935,CSE 8A,A50,083650,Miranda; Gregory Joseph,0,23,40,40
1650298175962,CSE 11,A01,083080,Cao; Yingjun,0,80,40,40
1650298181989,CSE 12,A01,083652,Staff,0,10,100,100
1650298188014,CSE 15L,A01,083654,Staff,0,1,50,50
1650298188014,CSE 15L,A02,083655,Staff,4,0,50,46
1650298194043,CSE 20,A01,083657,Staff,53,0,80,27
1650298200067,CSE 30,A01,083084,Eldon; John,0,74,40,40
1650298206099,CSE 100,A01,083659,Cao; Yingjun,0,65,50,50
1650298212126,CSE 134B,A01,083661,Powell; Thomas Allan,0,29,65,65
1650298218247,CSE 140,A01,083663,Staff,0,0,75,75
1650298224274,CSE 140L,A01,083088,Eldon; John,0,6,75,75
1650298230303,CSE 175,A01,083665,Kumar; Rakesh,8,0,25,17
1650298236327,CSE 190,A00,092507,Dubnov; Shlomo,14,0,20,6
1650298242351,ECE 45,A01,083139,Staff,0,15,40,40
1650298248374,ECE 65,A50,083695,Staff,0,4,30,30
1650298254401,ECE 109,A01,091882,Touri; Behrouz,43,0,70,27
1650298260433,ECE 180,A00,083140,Abi Samra; Nicholas Camill,23,0,30,7
1650298260433,ECE 180,B00,083141,Abi Samra; Nicholas Camill,7,0,30,23
1650298266457,MATH 10A,A01,083735,Patchell; Gregory David,11,0,30,19
1650298266457,MATH 10A,A02,083736,Patchell; Gregory David,28,0,30,2
1650298266457,MATH 10A,A03,083737,Patchell; Gregory David,26,0,30,4
1650298272480,MATH 10B,A01,083207,Staff,0,6,30,30
1650298272480,MATH 10B,A02,083208,Staff,0,6,30,30
1650298272480,MATH 10B,B01,083739,Staff,17,0,30,13
1650298272480,MATH 10B,B02,083740,Staff,29,0,30,1
1650298278509,MATH 18,A01,083743,Staff,5,0,30,25
1650298278509,MATH 18,A02,083744,Staff,26,0,30,4
1650298278509,MATH 18,A03,083745,Staff,23,0,30,7
1650298278509,MATH 18,A04,083746,Staff,27,0,30,3
1650298278509,MATH 18,B01,083748,Staff,0,11,30,30
1650298278509,MATH 18,B02,083749,Staff,0,10,30,30
1650298278509,MATH 18,B03,083750,Staff,1,8,30,29
1650298278509,MATH 18,B04,083751,Staff,0,10,30,30
1650298284536,MATH 20A,A01,083754,Staff,25,0,40,15
1650298290561,MATH 20B,A01,083756,Staff,0,5,30,30
1650298290561,MATH 20B,A02,083757,Staff,0,7,30,30
1650298296586,MATH 20C,A01,083760,Staff,0,13,30,30
1650298296586,MATH 20C,A02,083761,Staff,0,13,30,30
1650298296586,MATH 20C,B01,083762,Staff,13,0,30,17
1650298296586,MATH 20C,B02,083763,Staff,28,0,30,2
1650298302623,MATH 20D,A01,083765,Staff,0,1,30,30
1650298302623,MATH 20D,A02,083766,Staff,8,0,30,22
1650298302623,MATH 20D,A03,083767,Staff,27,0,30,3
1650298308646,MATH 20E,A01,083771,Staff,5,0,30,25
1650298308646,MATH 20E,A02,083772,Staff,20,0,30,10
1650298308646,MATH 20E,B01,083773,Staff,0,0,30,30
1650298308646,MATH 20E,B02,083774,Staff,11,0,30,19
1650298314682,MATH 103A,A01,083777,Staff,0,11,30,30
1650298314682,MATH 103A,A02,083778,Staff,0,10,30,30
1650298314682,MATH 103A,B01,083779,Staff,0,10,30,30
1650298314682,MATH 103A,B02,083780,Staff,0,10,30,30
1650298320709,MATH 105,A01,085443,Staff,0,17,30,30
1650298326733,MATH 109,A01,083213,Anzaldo; Leesa B,0,5,30,30
1650298326733,MATH 109,A02,083214,Anzaldo; Leesa B,0,6,30,30
1650298326733,MATH 109,B01,083215,Anzaldo; Leesa B,0,4,30,30
1650298326733,MATH 109,B02,083216,Anzaldo; Leesa B,0,4,30,30
1650298332758,MATH 142A,A01,083219,Chow; Bennett,0,12,30,30
1650298332758,MATH 142A,A02,083220,Chow; Bennett,0,11,30,30
1650298332758,MATH 142A,B01,083221,Chow; Bennett,0,11,30,30
1650298332758,MATH 142A,B02,083222,Chow; Bennett,0,12,30,30
1650298338780,MATH 193A,A01,083224,Staff,0,5,30,30
1650298338780,MATH 193A,A02,083225,Staff,0,5,30,30
1650298338780,MATH 193A,A03,083781,Staff,0,2,30,30
1650298338780,MATH 193A,A04,083782,Staff,0,1,30,30
1650298344806,MATH 197,001,091859,McAuley; Julian John,9998,0,9999,1
1650298350869,COGS 9,A01,083615,Staff,0,14,60,60
1650298356892,COGS 11,A01,083617,Boyle; Mary E. T.,23,0,40,17
1650298362919,COGS 13,A01,083071,Staff,0,31,40,40
1650298368942,COGS 14A,A01,092681,Staff,0,16,100,100
1650298374966,COGS 14B,A01,083073,Cheng; Tzu-Han,0,9,50,50
1650298380988,COGS 17,A01,092677,Staff,26,0,75,49
1650298387014,COGS 100,A01,083619,Staff,0,23,60,60
1650298393051,COGS 101A,A01,083621,Davis; Joshua Daniel,0,21,60,60
1650298399076,COGS 101B,A01,091572,Staff,4,0,60,56
1650298405103,COGS 101C,A01,083625,Delgado; Tania,19,0,30,11
1650298411130,COGS 107A,A01,083627,Boyle; Mary E. T.,0,8,60,60
1650298417154,COGS 118A,A01,083075,Staff,9,0,60,51
1650298423182,CSE 3,A50,083646,Miranda; Gregory Joseph,21,0,38,17
1650298423182,CSE 3,A51,083647,Miranda; Gregory Joseph,37,0,37,0
1650298429212,CSE 8A,A50,083650,Miranda; Gregory Joseph,0,23,40,40
1650298435237,CSE 11,A01,083080,Cao; Yingjun,0,80,40,40
1650298441267,CSE 12,A01,083652,Staff,0,10,100,100
1650298447289,CSE 15L,A01,083654,Staff,0,1,50,50
1650298447289,CSE 15L,A02,083655,Staff,4,0,50,46
1650298453314,CSE 20,A01,083657,Staff,53,0,80,27
1650298459340,CSE 30,A01,083084,Eldon; John,0,74,40,40
1650298465367,CSE 100,A01,083659,Cao; Yingjun,0,65,50,50
1650298471394,CSE 134B,A01,083661,Powell; Thomas Allan,0,29,65,65
1650298477426,CSE 140,A01,083663,Staff,0,0,75,75
1650298483453,CSE 140L,A01,083088,Eldon; John,0,6,75,75
1650298489485,CSE 175,A01,083665,Kumar; Rakesh,8,0,25,17
1650298495516,CSE 190,A00,092507,Dubnov; Shlomo,14,0,20,6
1650298501551,ECE 45,A01,083139,Staff,0,16,40,40
1650298507589,ECE 65,A50,083695,Staff,0,4,30,30
1650298513616,ECE 109,A01,091882,Touri; Behrouz,43,0,70,27
1650298519645,ECE 180,A00,083140,Abi Samra; Nicholas Camill,23,0,30,7
1650298519645,ECE 180,B00,083141,Abi Samra; Nicholas Camill,7,0,30,23
1650298525668,MATH 10A,A01,083735,Patchell; Gregory David,11,0,30,19
1650298525668,MATH 10A,A02,083736,Patchell; Gregory David,28,0,30,2
1650298525668,MATH 10A,A03,083737,Patchell; Gregory David,26,0,30,4
1650298531696,MATH 10B,A01,083207,Staff,0,6,30,30
1650298531696,MATH 10B,A02,083208,Staff,0,6,30,30
1650298531696,MATH 10B,B01,083739,Staff,17,0,30,13
1650298531696,MATH 10B,B02,083740,Staff,29,0,30,1
1650298537729,MATH 18,A01,083743,Staff,5,0,30,25
1650298537729,MATH 18,A02,083744,Staff,26,0,30,4
1650298537729,MATH 18,A03,083745,Staff,23,0,30,7
1650298537729,MATH 18,A04,083746,Staff,27,0,30,3
1650298537729,MATH 18,B01,083748,Staff,0,11,30,30
1650298537729,MATH 18,B02,083749,Staff,0,10,30,30
1650298537729,MATH 18,B03,083750,Staff,1,8,30,29
1650298537729,MATH 18,B04,083751,Staff,0,10,30,30
1650298543755,MATH 20A,A01,083754,Staff,25,0,40,15
1650298549813,MATH 20B,A01,083756,Staff,0,5,30,30
1650298549813,MATH 20B,A02,083757,Staff,0,7,30,30
1650298555836,MATH 20C,A01,083760,Staff,0,13,30,30
1650298555836,MATH 20C,A02,083761,Staff,0,13,30,30
1650298555836,MATH 20C,B01,083762,Staff,13,0,30,17
1650298555836,MATH 20C,B02,083763,Staff,28,0,30,2
1650298561872,MATH 20D,A01,083765,Staff,0,1,30,30
1650298561872,MATH 20D,A02,083766,Staff,8,0,30,22
1650298561872,MATH 20D,A03,083767,Staff,27,0,30,3
1650298567902,MATH 20E,A01,083771,Staff,5,0,30,25
1650298567902,MATH 20E,A02,083772,Staff,20,0,30,10
1650298567902,MATH 20E,B01,083773,Staff,0,0,30,30
1650298567902,MATH 20E,B02,083774,Staff,11,0,30,19
1650298573932,MATH 103A,A01,083777,Staff,0,11,30,30
1650298573932,MATH 103A,A02,083778,Staff,0,10,30,30
1650298573932,MATH 103A,B01,083779,Staff,0,10,30,30
1650298573932,MATH 103A,B02,083780,Staff,0,10,30,30
1650298579960,MATH 105,A01,085443,Staff,0,17,30,30
1650298585983,MATH 109,A01,083213,Anzaldo; Leesa B,0,5,30,30
1650298585983,MATH 109,A02,083214,Anzaldo; Leesa B,0,6,30,30
1650298585983,MATH 109,B01,083215,Anzaldo; Leesa B,0,4,30,30
1650298585983,MATH 109,B02,083216,Anzaldo; Leesa B,0,4,30,30
1650298592011,MATH 142A,A01,083219,Chow; Bennett,0,12,30,30
1650298592011,MATH 142A,A02,083220,Chow; Bennett,0,11,30,30
1650298592011,MATH 142A,B01,083221,Chow; Bennett,0,11,30,30
1650298592011,MATH 142A,B02,083222,Chow; Bennett,0,12,30,30
1650298598037,MATH 193A,A01,083224,Staff,0,5,30,30
1650298598037,MATH 193A,A02,083225,Staff,0,5,30,30
1650298598037,MATH 193A,A03,083781,Staff,0,2,30,30
1650298598037,MATH 193A,A04,083782,Staff,0,1,30,30
1650298604061,MATH 197,001,091859,McAuley; Julian John,9998,0,9999,1
1650298610118,COGS 9,A01,083615,Staff,0,14,60,60
1650298616144,COGS 11,A01,083617,Boyle; Mary E. T.,23,0,40,17
1650298622173,COGS 13,A01,083071,Staff,0,31,40,40
1650298628200,COGS 14A,A01,092681,Staff,0,16,100,100
1650298634224,COGS 14B,A01,083073,Cheng; Tzu-Han,0,9,50,50
1650298640248,COGS 17,A01,092677,Staff,26,0,75,49
1650298646273,COGS 100,A01,083619,Staff,0,23,60,60
1650298652297,COGS 101A,A01,083621,Davis; Joshua Daniel,0,21,60,60
1650298658326,COGS 101B,A01,091572,Staff,4,0,60,56
1650298664360,COGS 101C,A01,083625,Delgado; Tania,19,0,30,11
1650298670389,COGS 107A,A01,083627,Boyle; Mary E. T.,0,8,60,60
1650298676418,COGS 118A,A01,083075,Staff,9,0,60,51
1650298682445,CSE 3,A50,083646,Miranda; Gregory Joseph,21,0,38,17
1650298682445,CSE 3,A51,083647,Miranda; Gregory Joseph,37,0,37,0
1650298688468,CSE 8A,A50,083650,Miranda; Gregory Joseph,0,23,40,40
1650298694497,CSE 11,A01,083080,Cao; Yingjun,0,80,40,40
1650298700525,CSE 12,A01,083652,Staff,0,10,100,100
1650298706553,CSE 15L,A01,083654,Staff,0,1,50,50
1650298706553,CSE 15L,A02,083655,Staff,4,0,50,46
1650298712579,CSE 20,A01,083657,Staff,53,0,80,27
1650298718603,CSE 30,A01,083084,Eldon; John,0,74,40,40
1650298724635,CSE 100,A01,083659,Cao; Yingjun,0,65,50,50
1650298730659,CSE 134B,A01,083661,Powell; Thomas Allan,0,29,65,65
1650298736684,CSE 140,A01,083663,Staff,0,0,75,75
1650298742707,CSE 140L,A01,083088,Eldon; John,0,6,75,75
1650298748733,CSE 175,A01,083665,Kumar; Rakesh,8,0,25,17
1650298754763,CSE 190,A00,092507,Dubnov; Shlomo,14,0,20,6
1650298760785,ECE 45,A01,083139,Staff,0,16,40,40
1650298766809,ECE 65,A50,083695,Staff,0,4,30,30
1650298772837,ECE 109,A01,091882,Touri; Behrouz,43,0,70,27
1650298778860,ECE 180,A00,083140,Abi Samra; Nicholas Camill,23,0,30,7
1650298778860,ECE 180,B00,083141,Abi Samra; Nicholas Camill,7,0,30,23
1650298784891,MATH 10A,A01,083735,Patchell; Gregory David,10,0,30,20
1650298784891,MATH 10A,A02,083736,Patchell; Gregory David,28,0,30,2
1650298784891,MATH 10A,A03,083737,Patchell; Gregory David,26,0,30,4
1650298790915,MATH 10B,A01,083207,Staff,0,6,30,30
1650298790915,MATH 10B,A02,083208,Staff,0,6,30,30
1650298790915,MATH 10B,B01,083739,Staff,17,0,30,13
1650298790915,MATH 10B,B02,083740,Staff,29,0,30,1
1650298796941,MATH 18,A01,083743,Staff,5,0,30,25
1650298796941,MATH 18,A02,083744,Staff,26,0,30,4
1650298796941,MATH 18,A03,083745,Staff,23,0,30,7
1650298796941,MATH 18,A04,083746,Staff,27,0,30,3
1650298796941,MATH 18,B01,083748,Staff,0,11,30,30
1650298796941,MATH 18,B02,083749,Staff,0,10,30,30
1650298796941,MATH 18,B03,083750,Staff,1,8,30,29
1650298796941,MATH 18,B04,083751,Staff,0,10,30,30
1650298802973,MATH 20A,A01,083754,Staff,25,0,40,15
1650298809004,MATH 20B,A01,083756,Staff,0,5,30,30
1650298809004,MATH 20B,A02,083757,Staff,0,7,30,30
1650298815122,MATH 20C,A01,083760,Staff,0,13,30,30
1650298815122,MATH 20C,A02,083761,Staff,0,13,30,30
1650298815122,MATH 20C,B01,083762,Staff,13,0,30,17
1650298815122,MATH 20C,B02,083763,Staff,28,0,30,2
1650298821146,MATH 20D,A01,083765,Staff,0,1,30,30
1650298821146,MATH 20D,A02,083766,Staff,8,0,30,22
1650298821146,MATH 20D,A03,083767,Staff,27,0,30,3
1650298827171,MATH 20E,A01,083771,Staff,5,0,30,25
1650298827171,MATH 20E,A02,083772,Staff,20,0,30,10
1650298827171,MATH 20E,B01,083773,Staff,0,0,30,30
1650298827171,MATH 20E,B02,083774,Staff,11,0,30,19
1650298833215,MATH 103A,A01,083777,Staff,0,11,30,30
1650298833215,MATH 103A,A02,083778,Staff,0,10,30,30
1650298833215,MATH 103A,B01,083779,Staff,0,10,30,30
1650298833215,MATH 103A,B02,083780,Staff,0,10,30,30
1650298839261,MATH 105,A01,085443,Staff,0,17,30,30
1650298845285,MATH 109,A01,083213,Anzaldo; Leesa B,0,5,30,30
1650298845285,MATH 109,A02,083214,Anzaldo; Leesa B,0,6,30,30
1650298845285,MATH 109,B01,083215,Anzaldo; Leesa B,0,4,30,30
1650298845285,MATH 109,B02,083216,Anzaldo; Leesa B,0,4,30,30
1650298851324,MATH 142A,A01,083219,Chow; Bennett,0,12,30,30
1650298851324,MATH 142A,A02,083220,Chow; Bennett,0,11,30,30
1650298851324,MATH 142A,B01,083221,Chow; Bennett,0,11,30,30
1650298851324,MATH 142A,B02,083222,Chow; Bennett,0,12,30,30
1650298857353,MATH 193A,A01,083224,Staff,0,5,30,30
1650298857353,MATH 193A,A02,083225,Staff,0,5,30,30
1650298857353,MATH 193A,A03,083781,Staff,0,2,30,30
1650298857353,MATH 193A,A04,083782,Staff,0,1,30,30
1650298863380,MATH 197,001,091859,McAuley; Julian John,9998,0,9999,1
1650298869436,COGS 9,A01,083615,Staff,0,14,60,60
1650298875466,COGS 11,A01,083617,Boyle; Mary E. T.,23,0,40,17
1650298881497,COGS 13,A01,083071,Staff,0,31,40,40
1650298887525,COGS 14A,A01,092681,Staff,0,16,100,100
1650298893570,COGS 14B,A01,083073,Cheng; Tzu-Han,0,9,50,50
1650298899595,COGS 17,A01,092677,Staff,26,0,75,49
1650298905620,COGS 100,A01,083619,Staff,0,23,60,60
1650298911647,COGS 101A,A01,083621,Davis; Joshua Daniel,0,21,60,60
1650298917670,COGS 101B,A01,091572,Staff,4,0,60,56
1650298923695,COGS 101C,A01,083625,Delgado; Tania,19,0,30,11
1650298929718,COGS 107A,A01,083627,Boyle; Mary E. T.,0,8,60,60
1650298935745,COGS 118A,A01,083075,Staff,9,0,60,51
1650298941772,CSE 3,A50,083646,Miranda; Gregory Joseph,21,0,38,17
1650298941772,CSE 3,A51,083647,Miranda; Gregory Joseph,37,0,37,0
1650298947804,CSE 8A,A50,083650,Miranda; Gregory Joseph,0,23,40,40
1650298953845,CSE 11,A01,083080,Cao; Yingjun,0,80,40,40
1650298959870,CSE 12,A01,083652,Staff,0,10,100,100
1650298965908,CSE 15L,A01,083654,Staff,0,1,50,50
1650298965908,CSE 15L,A02,083655,Staff,4,0,50,46
1650298971932,CSE 20,A01,083657,Staff,53,0,80,27
1650298977958,CSE 30,A01,083084,Eldon; John,0,74,40,40
1650298983995,CSE 100,A01,083659,Cao; Yingjun,0,65,50,50
1650298990018,CSE 134B,A01,083661,Powell; Thomas Allan,0,29,65,65
1650298996043,CSE 140,A01,083663,Staff,0,0,75,75
1650299002072,CSE 140L,A01,083088,Eldon; John,0,6,75,75
1650299008099,CSE 175,A01,083665,Kumar; Rakesh,8,0,25,17
1650299014125,CSE 190,A00,092507,Dubnov; Shlomo,14,0,20,6
1650299020153,ECE 45,A01,083139,Staff,0,16,40,40
1650299026178,ECE 65,A50,083695,Staff,0,4,30,30
1650299032201,ECE 109,A01,091882,Touri; Behrouz,43,0,70,27
1650299038228,ECE 180,A00,083140,Abi Samra; Nicholas Camill,23,0,30,7
1650299038228,ECE 180,B00,083141,Abi Samra; Nicholas Camill,7,0,30,23
1650299044259,MATH 10A,A01,083735,Patchell; Gregory David,10,0,30,20
1650299044259,MATH 10A,A02,083736,Patchell; Gregory David,28,0,30,2
1650299044259,MATH 10A,A03,083737,Patchell; Gregory David,26,0,30,4
1650299050287,MATH 10B,A01,083207,Staff,0,6,30,30
1650299050287,MATH 10B,A02,083208,Staff,0,6,30,30
1650299050287,MATH 10B,B01,083739,Staff,17,0,30,13
1650299050287,MATH 10B,B02,083740,Staff,29,0,30,1
1650299056314,MATH 18,A01,083743,Staff,5,0,30,25
1650299056314,MATH 18,A02,083744,Staff,26,0,30,4
1650299056314,MATH 18,A03,083745,Staff,23,0,30,7
1650299056314,MATH 18,A04,083746,Staff,27,0,30,3
1650299056314,MATH 18,B01,083748,Staff,0,11,30,30
1650299056314,MATH 18,B02,083749,Staff,0,10,30,30
1650299056314,MATH 18,B03,083750,Staff,1,8,30,29
1650299056314,MATH 18,B04,083751,Staff,0,10,30,30
1650299062338,MATH 20A,A01,083754,Staff,25,0,40,15
1650299068366,MATH 20B,A01,083756,Staff,0,5,30,30
1650299068366,MATH 20B,A02,083757,Staff,0,7,30,30
1650299074393,MATH 20C,A01,083760,Staff,0,13,30,30
1650299074393,MATH 20C,A02,083761,Staff,0,13,30,30
1650299074393,MATH 20C,B01,083762,Staff,13,0,30,17
1650299074393,MATH 20C,B02,083763,Staff,28,0,30,2
1650299080418,MATH 20D,A01,083765,Staff,0,1,30,30
1650299080418,MATH 20D,A02,083766,Staff,8,0,30,22
1650299080418,MATH 20D,A03,083767,Staff,27,0,30,3
1650299086447,MATH 20E,A01,083771,Staff,5,0,30,25
1650299086447,MATH 20E,A02,083772,Staff,20,0,30,10
1650299086447,MATH 20E,B01,083773,Staff,0,0,30,30
1650299086447,MATH 20E,B02,083774,Staff,11,0,30,19
1650299092476,MATH 103A,A01,083777,Staff,0,11,30,30
1650299092476,MATH 103A,A02,083778,Staff,0,10,30,30
1650299092476,MATH 103A,B01,083779,Staff,0,10,30,30
1650299092476,MATH 103A,B02,083780,Staff,0,10,30,30
1650299098500,MATH 105,A01,085443,Staff,0,17,30,30
1650299104526,MATH 109,A01,083213,Anzaldo; Leesa B,0,5,30,30
1650299104526,MATH 109,A02,083214,Anzaldo; Leesa B,0,6,30,30
1650299104526,MATH 109,B01,083215,Anzaldo; Leesa B,0,4,30,30
1650299104526,MATH 109,B02,083216,Anzaldo; Leesa B,0,4,30,30
1650299110558,MATH 142A,A01,083219,Chow; Bennett,0,12,30,30
1650299110558,MATH 142A,A02,083220,Chow; Bennett,0,11,30,30
1650299110558,MATH 142A,B01,083221,Chow; Bennett,0,11,30,30
1650299110558,MATH 142A,B02,083222,Chow; Bennett,0,12,30,30
1650299116597,MATH 193A,A01,083224,Staff,0,5,30,30
1650299116597,MATH 193A,A02,083225,Staff,0,5,30,30
1650299116597,MATH 193A,A03,083781,Staff,0,2,30,30
1650299116597,MATH 193A,A04,083782,Staff,0,1,30,30
1650299122624,MATH 197,001,091859,McAuley; Julian John,9998,0,9999,1
1650299128674,COGS 9,A01,083615,Staff,0,14,60,60
1650299134699,COGS 11,A01,083617,Boyle; Mary E. T.,23,0,40,17
1650299140727,COGS 13,A01,083071,Staff,0,31,40,40
1650299146751,COGS 14A,A01,092681,Staff,0,16,100,100
1650299152778,COGS 14B,A01,083073,Cheng; Tzu-Han,0,9,50,50
1650299158804,COGS 17,A01,092677,Staff,26,0,75,49
1650299164835,COGS 100,A01,083619,Staff,0,23,60,60
1650299170859,COGS 101A,A01,083621,Davis; Joshua Daniel,0,21,60,60
1650299176886,COGS 101B,A01,091572,Staff,4,0,60,56
1650299182913,COGS 101C,A01,083625,Delgado; Tania,19,0,30,11
1650299188938,COGS 107A,A01,083627,Boyle; Mary E. T.,0,8,60,60
1650299194968,COGS 118A,A01,083075,Staff,9,0,60,51
1650299200993,CSE 3,A50,083646,Miranda; Gregory Joseph,21,0,38,17
1650299200993,CSE 3,A51,083647,Miranda; Gregory Joseph,37,0,37,0
1650299207016,CSE 8A,A50,083650,Miranda; Gregory Joseph,0,23,40,40
1650299213048,CSE 11,A01,083080,Cao; Yingjun,0,80,40,40
1650299219075,CSE 12,A01,083652,Staff,0,10,100,100
1650299225102,CSE 15L,A01,083654,Staff,0,1,50,50
1650299225102,CSE 15L,A02,083655,Staff,4,0,50,46
1650299231127,CSE 20,A01,083657,Staff,53,0,80,27
1650299237154,CSE 30,A01,083084,Eldon; John,0,74,40,40
1650299243184,CSE 100,A01,083659,Cao; Yingjun,0,65,50,50
1650299249208,CSE 134B,A01,083661,Powell; Thomas Allan,0,29,65,65
1650299255232,CSE 140,A01,083663,Staff,0,0,75,75
1650299261276,CSE 140L,A01,083088,Eldon; John,0,6,75,75
1650299267313,CSE 175,A01,083665,Kumar; Rakesh,8,0,25,17
1650299273342,CSE 190,A00,092507,Dubnov; Shlomo,14,0,20,6
1650299279369,ECE 45,A01,083139,Staff,0,16,40,40
1650299285393,ECE 65,A50,083695,Staff,0,4,30,30
1650299291421,ECE 109,A01,091882,Touri; Behrouz,43,0,70,27
1650299297453,ECE 180,A00,083140,Abi Samra; Nicholas Camill,23,0,30,7
1650299297453,ECE 180,B00,083141,Abi Samra; Nicholas Camill,7,0,30,23
1650299303482,MATH 10A,A01,083735,Patchell; Gregory David,10,0,30,20
1650299303482,MATH 10A,A02,083736,Patchell; Gregory David,28,0,30,2
1650299303482,MATH 10A,A03,083737,Patchell; Gregory David,26,0,30,4
1650299309506,MATH 10B,A01,083207,Staff,0,6,30,30
1650299309506,MATH 10B,A02,083208,Staff,0,6,30,30
1650299309506,MATH 10B,B01,083739,Staff,17,0,30,13
1650299309506,MATH 10B,B02,083740,Staff,29,0,30,1
1650299315537,MATH 18,A01,083743,Staff,6,0,30,24
1650299315537,MATH 18,A02,083744,Staff,26,0,30,4
1650299315537,MATH 18,A03,083745,Staff,23,0,30,7
1650299315537,MATH 18,A04,083746,Staff,27,0,30,3
1650299315537,MATH 18,B01,083748,Staff,0,11,30,30
1650299315537,MATH 18,B02,083749,Staff,0,10,30,30
1650299315537,MATH 18,B03,083750,Staff,1,8,30,29
1650299315537,MATH 18,B04,083751,Staff,0,10,30,30
1650299321563,MATH 20A,A01,083754,Staff,25,0,40,15
1650299327595,MATH 20B,A01,083756,Staff,0,5,30,30
1650299327595,MATH 20B,A02,083757,Staff,0,7,30,30
1650299333619,MATH 20C,A01,083760,Staff,0,13,30,30
1650299333619,MATH 20C,A02,083761,Staff,0,13,30,30
1650299333619,MATH 20C,B01,083762,Staff,13,0,30,17
1650299333619,MATH 20C,B02,083763,Staff,28,0,30,2
1650299339642,MATH 20D,A01,083765,Staff,0,1,30,30
1650299339642,MATH 20D,A02,083766,Staff,8,0,30,22
1650299339642,MATH 20D,A03,083767,Staff,27,0,30,3
1650299345668,MATH 20E,A01,083771,Staff,5,0,30,25
1650299345668,MATH 20E,A02,083772,Staff,20,0,30,10
1650299345668,MATH 20E,B01,083773,Staff,0,0,30,30
1650299345668,MATH 20E,B02,083774,Staff,11,0,30,19
1650299351695,MATH 103A,A01,083777,Staff,0,11,30,30
1650299351695,MATH 103A,A02,083778,Staff,0,10,30,30
1650299351695,MATH 103A,B01,083779,Staff,0,10,30,30
1650299351695,MATH 103A,B02,083780,Staff,0,10,30,30
1650299357721,MATH 105,A01,085443,Staff,0,17,30,30
1650299363754,MATH 109,A01,083213,Anzaldo; Leesa B,0,5,30,30
1650299363754,MATH 109,A02,083214,Anzaldo; Leesa B,0,6,30,30
1650299363754,MATH 109,B01,083215,Anzaldo; Leesa B,0,4,30,30
1650299363754,MATH 109,B02,083216,Anzaldo; Leesa B,0,4,30,30
1650299369781,MATH 142A,A01,083219,Chow; Bennett,0,12,30,30
1650299369781,MATH 142A,A02,083220,Chow; Bennett,0,11,30,30
1650299369781,MATH 142A,B01,083221,Chow; Bennett,0,11,30,30
1650299369781,MATH 142A,B02,083222,Chow; Bennett,0,12,30,30
1650299375804,MATH 193A,A01,083224,Staff,0,5,30,30
1650299375804,MATH 193A,A02,083225,Staff,0,5,30,30
1650299375804,MATH 193A,A03,083781,Staff,0,2,30,30
1650299375804,MATH 193A,A04,083782,Staff,0,1,30,30
1650299381828,MATH 197,001,091859,McAuley; Julian John,9998,0,9999,1
1650299387888,COGS 9,A01,083615,Staff,0,15,60,60
1650299393913,COGS 11,A01,083617,Boyle; Mary E. T.,23,0,40,17
1650299399942,COGS 13,A01,083071,Staff,0,31,40,40
1650299406049,COGS 14A,A01,092681,Staff,0,17,100,100
1650299412072,COGS 14B,A01,083073,Cheng; Tzu-Han,0,9,50,50
1650299418096,COGS 17,A01,092677,Staff,26,0,75,49
1650299424127,COGS 100,A01,083619,Staff,0,23,60,60
1650299430150,COGS 101A,A01,083621,Davis; Joshua Daniel,0,21,60,60
1650299436180,COGS 101B,A01,091572,Staff,4,0,60,56
1650299442206,COGS 101C,A01,083625,Delgado; Tania,19,0,30,11
1650299448232,COGS 107A,A01,083627,Boyle; Mary E. T.,0,8,60,60
1650299454261,COGS 118A,A01,083075,Staff,9,0,60,51
1650299460294,CSE 3,A50,083646,Miranda; Gregory Joseph,21,0,38,17
1650299460294,CSE 3,A51,083647,Miranda; Gregory Joseph,37,0,37,0
1650299466321,CSE 8A,A50,083650,Miranda; Gregory Joseph,0,23,40,40
1650299472357,CSE 11,A01,083080,Cao; Yingjun,0,80,40,40
1650299478381,CSE 12,A01,083652,Staff,0,10,100,100
1650299484418,CSE 15L,A01,083654,Staff,0,1,50,50
1650299484418,CSE 15L,A02,083655,Staff,4,0,50,46
1650299490441,CSE 20,A01,083657,Staff,53,0,80,27
1650299496467,CSE 30,A01,083084,Eldon; John,0,74,40,40
1650299502503,CSE 100,A01,083659,Cao; Yingjun,0,65,50,50
1650299508538,CSE 134B,A01,083661,Powell; Thomas Allan,0,29,65,65
1650299514562,CSE 140,A01,083663,Staff,0,0,75,75
1650299520585,CSE 140L,A01,083088,Eldon; John,0,6,75,75
1650299526611,CSE 175,A01,083665,Kumar; Rakesh,8,0,25,17
1650299532643,CSE 190,A00,092507,Dubnov; Shlomo,14,0,20,6
1650299538674,ECE 45,A01,083139,Staff,0,16,40,40
1650299544708,ECE 65,A50,083695,Staff,0,4,30,30
1650299550730,ECE 109,A01,091882,Touri; Behrouz,43,0,70,27
1650299556758,ECE 180,A00,083140,Abi Samra; Nicholas Camill,23,0,30,7
1650299556758,ECE 180,B00,083141,Abi Samra; Nicholas Camill,7,0,30,23
1650299562802,MATH 10A,A01,083735,Patchell; Gregory David,10,0,30,20
1650299562802,MATH 10A,A02,083736,Patchell; Gregory David,28,0,30,2
1650299562802,MATH 10A,A03,083737,Patchell; Gregory David,26,0,30,4
1650299568830,MATH 10B,A01,083207,Staff,0,6,30,30
1650299568830,MATH 10B,A02,083208,Staff,0,6,30,30
1650299568830,MATH 10B,B01,083739,Staff,17,0,30,13
1650299568830,MATH 10B,B02,083740,Staff,29,0,30,1
1650299574856,MATH 18,A01,083743,Staff,6,0,30,24
1650299574856,MATH 18,A02,083744,Staff,26,0,30,4
1650299574856,MATH 18,A03,083745,Staff,23,0,30,7
1650299574856,MATH 18,A04,083746,Staff,27,0,30,3
1650299574856,MATH 18,B01,083748,Staff,0,11,30,30
1650299574856,MATH 18,B02,083749,Staff,0,11,30,30
1650299574856,MATH 18,B03,083750,Staff,1,8,30,29
1650299574856,MATH 18,B04,083751,Staff,0,10,30,30
1650299580881,MATH 20A,A01,083754,Staff,25,0,40,15
1650299586906,MATH 20B,A01,083756,Staff,0,5,30,30
1650299586906,MATH 20B,A02,083757,Staff,0,7,30,30
1650299592930,MATH 20C,A01,083760,Staff,0,13,30,30
1650299592930,MATH 20C,A02,083761,Staff,0,13,30,30
1650299592930,MATH 20C,B01,083762,Staff,13,0,30,17
1650299592930,MATH 20C,B02,083763,Staff,28,0,30,2
1650299598970,MATH 20D,A01,083765,Staff,0,1,30,30
1650299598970,MATH 20D,A02,083766,Staff,8,0,30,22
1650299598970,MATH 20D,A03,083767,Staff,27,0,30,3
1650299604993,MATH 20E,A01,083771,Staff,5,0,30,25
1650299604993,MATH 20E,A02,083772,Staff,20,0,30,10
1650299604993,MATH 20E,B01,083773,Staff,0,0,30,30
1650299604993,MATH 20E,B02,083774,Staff,11,0,30,19
1650299611017,MATH 103A,A01,083777,Staff,0,11,30,30
1650299611017,MATH 103A,A02,083778,Staff,0,10,30,30
1650299611017,MATH 103A,B01,083779,Staff,0,10,30,30
1650299611017,MATH 103A,B02,083780,Staff,0,10,30,30
1650299617040,MATH 105,A01,085443,Staff,0,17,30,30
1650299623065,MATH 109,A01,083213,Anzaldo; Leesa B,0,5,30,30
1650299623065,MATH 109,A02,083214,Anzaldo; Leesa B,0,6,30,30
1650299623065,MATH 109,B01,083215,Anzaldo; Leesa B,0,4,30,30
1650299623065,MATH 109,B02,083216,Anzaldo; Leesa B,0,4,30,30
1650299629090,MATH 142A,A01,083219,Chow; Bennett,0,12,30,30
1650299629090,MATH 142A,A02,083220,Chow; Bennett,0,11,30,30
1650299629090,MATH 142A,B01,083221,Chow; Bennett,0,11,30,30
1650299629090,MATH 142A,B02,083222,Chow; Bennett,0,12,30,30
1650299635117,MATH 193A,A01,083224,Staff,0,5,30,30
1650299635117,MATH 193A,A02,083225,Staff,0,5,30,30
1650299635117,MATH 193A,A03,083781,Staff,0,2,30,30
1650299635117,MATH 193A,A04,083782,Staff,0,1,30,30
1650299641144,MATH 197,001,091859,McAuley; Julian John,9998,0,9999,1
1650299647208,COGS 9,A01,083615,Staff,0,14,60,60
1650299653235,COGS 11,A01,083617,Boyle; Mary E. T.,23,0,40,17
1650299659260,COGS 13,A01,083071,Staff,0,31,40,40
1650299665287,COGS 14A,A01,092681,Staff,0,17,100,100
1650299671316,COGS 14B,A01,083073,Cheng; Tzu-Han,0,9,50,50
1650299677355,COGS 17,A01,092677,Staff,26,0,75,49
1650299683378,COGS 100,A01,083619,Staff,0,23,60,60
1650299689405,COGS 101A,A01,083621,Davis; Joshua Daniel,0,21,60,60
1650299695431,COGS 101B,A01,091572,Staff,4,0,60,56
1650299701459,COGS 101C,A01,083625,Delgado; Tania,19,0,30,11
1650299707486,COGS 107A,A01,083627,Boyle; Mary E. T.,0,8,60,60
1650299713521,COGS 118A,A01,083075,Staff,9,0,60,51
1650299719547,CSE 3,A50,083646,Miranda; Gregory Joseph,21,0,38,17
1650299719547,CSE 3,A51,083647,Miranda; Gregory Joseph,37,0,37,0
1650299725572,CSE 8A,A50,083650,Miranda; Gregory Joseph,0,23,40,40
1650299731602,CSE 11,A01,083080,Cao; Yingjun,0,80,40,40
1650299737626,CSE 12,A01,083652,Staff,0,10,100,100
1650299743653,CSE 15L,A01,083654,Staff,0,1,50,50
1650299743653,CSE 15L,A02,083655,Staff,4,0,50,46
1650299749678,CSE 20,A01,083657,Staff,53,0,80,27
1650299755718,CSE 30,A01,083084,Eldon; John,0,74,40,40
1650299761742,CSE 100,A01,083659,Cao; Yingjun,0,65,50,50
1650299767771,CSE 134B,A01,083661,Powell; Thomas Allan,0,29,65,65
1650299773795,CSE 140,A01,083663,Staff,0,0,75,75
1650299779825,CSE 140L,A01,083088,Eldon; John,0,6,75,75
1650299785849,CSE 175,A01,083665,Kumar; Rakesh,8,0,25,17
1650299791872,CSE 190,A00,092507,Dubnov; Shlomo,14,0,20,6
1650299797894,ECE 45,A01,083139,Staff,0,16,40,40
1650299803921,ECE 65,A50,083695,Staff,0,4,30,30
1650299809946,ECE 109,A01,091882,Touri; Behrouz,43,0,70,27
1650299815973,ECE 180,A00,083140,Abi Samra; Nicholas Camill,23,0,30,7
1650299815973,ECE 180,B00,083141,Abi Samra; Nicholas Camill,7,0,30,23
1650299821999,MATH 10A,A01,083735,Patchell; Gregory David,10,0,30,20
1650299821999,MATH 10A,A02,083736,Patchell; Gregory David,28,0,30,2
1650299821999,MATH 10A,A03,083737,Patchell; Gregory David,26,0,30,4
1650299828024,MATH 10B,A01,083207,Staff,0,6,30,30
1650299828024,MATH 10B,A02,083208,Staff,0,6,30,30
1650299828024,MATH 10B,B01,083739,Staff,17,0,30,13
1650299828024,MATH 10B,B02,083740,Staff,29,0,30,1
1650299834054,MATH 18,A01,083743,Staff,6,0,30,24
1650299834054,MATH 18,A02,083744,Staff,26,0,30,4
1650299834054,MATH 18,A03,083745,Staff,23,0,30,7
1650299834054,MATH 18,A04,083746,Staff,27,0,30,3
1650299834054,MATH 18,B01,083748,Staff,0,11,30,30
1650299834054,MATH 18,B02,083749,Staff,0,11,30,30
1650299834054,MATH 18,B03,083750,Staff,1,8,30,29
1650299834054,MATH 18,B04,083751,Staff,0,10,30,30
1650299840077,MATH 20A,A01,083754,Staff,25,0,40,15
1650299846102,MATH 20B,A01,083756,Staff,0,5,30,30
1650299846102,MATH 20B,A02,083757,Staff,0,7,30,30
1650299852125,MATH 20C,A01,083760,Staff,0,13,30,30
1650299852125,MATH 20C,A02,083761,Staff,0,13,30,30
1650299852125,MATH 20C,B01,083762,Staff,13,0,30,17
1650299852125,MATH 20C,B02,083763,Staff,28,0,30,2
1650299858149,MATH 20D,A01,083765,Staff,0,1,30,30
1650299858149,MATH 20D,A02,083766,Staff,8,0,30,22
1650299858149,MATH 20D,A03,083767,Staff,27,0,30,3
1650299864176,MATH 20E,A01,083771,Staff,5,0,30,25
1650299864176,MATH 20E,A02,083772,Staff,20,0,30,10
1650299864176,MATH 20E,B01,083773,Staff,0,0,30,30
1650299864176,MATH 20E,B02,083774,Staff,11,0,30,19
1650299870200,MATH 103A,A01,083777,Staff,0,11,30,30
1650299870200,MATH 103A,A02,083778,Staff,0,10,30,30
1650299870200,MATH 103A,B01,083779,Staff,0,10,30,30
1650299870200,MATH 103A,B02,083780,Staff,0,10,30,30
1650299876225,MATH 105,A01,085443,Staff,0,17,30,30
1650299882250,MATH 109,A01,083213,Anzaldo; Leesa B,0,5,30,30
1650299882250,MATH 109,A02,083214,Anzaldo; Leesa B,0,6,30,30
1650299882250,MATH 109,B01,083215,Anzaldo; Leesa B,0,4,30,30
1650299882250,MATH 109,B02,083216,Anzaldo; Leesa B,0,4,30,30
1650299888296,MATH 142A,A01,083219,Chow; Bennett,0,12,30,30
1650299888296,MATH 142A,A02,083220,Chow; Bennett,0,11,30,30
1650299888296,MATH 142A,B01,083221,Chow; Bennett,0,11,30,30
1650299888296,MATH 142A,B02,083222,Chow; Bennett,0,12,30,30
1650299894338,MATH 193A,A01,083224,Staff,0,5,30,30
1650299894338,MATH 193A,A02,083225,Staff,0,5,30,30
1650299894338,MATH 193A,A03,083781,Staff,0,2,30,30
1650299894338,MATH 193A,A04,083782,Staff,0,1,30,30
1650299900365,MATH 197,001,091859,McAuley; Julian John,9998,0,9999,1
1650299906438,COGS 9,A01,083615,Staff,0,14,60,60
1650299912460,COGS 11,A01,083617,Boyle; Mary E. T.,23,0,40,17
1650299918482,COGS 13,A01,083071,Staff,0,31,40,40
1650299924513,COGS 14A,A01,092681,Staff,0,17,100,100
1650299930536,COGS 14B,A01,083073,Cheng; Tzu-Han,0,9,50,50
1650299936560,COGS 17,A01,092677,Staff,26,0,75,49
1650299942584,COGS 100,A01,083619,Staff,0,23,60,60
1650299948620,COGS 101A,A01,083621,Davis; Joshua Daniel,0,21,60,60
1650299954651,COGS 101B,A01,091572,Staff,4,0,60,56
1650299960681,COGS 101C,A01,083625,Delgado; Tania,19,0,30,11
1650299966708,COGS 107A,A01,083627,Boyle; Mary E. T.,0,8,60,60
1650299972734,COGS 118A,A01,083075,Staff,9,0,60,51
1650299978758,CSE 3,A50,083646,Miranda; Gregory Joseph,21,0,38,17
1650299978758,CSE 3,A51,083647,Miranda; Gregory Joseph,37,0,37,0
1650299984788,CSE 8A,A50,083650,Miranda; Gregory Joseph,0,23,40,40
1650299990811,CSE 11,A01,083080,Cao; Yingjun,0,80,40,40
1650299996834,CSE 12,A01,083652,Staff,0,10,100,100
1650300002985,CSE 15L,A01,083654,Staff,0,1,50,50
1650300002985,CSE 15L,A02,083655,Staff,4,0,50,46
1650300009011,CSE 20,A01,083657,Staff,53,0,80,27
1650300015042,CSE 30,A01,083084,Eldon; John,0,74,40,40
1650300021066,CSE 100,A01,083659,Cao; Yingjun,0,65,50,50
1650300027091,CSE 134B,A01,083661,Powell; Thomas Allan,0,29,65,65
1650300033123,CSE 140,A01,083663,Staff,0,0,75,75
1650300039149,CSE 140L,A01,083088,Eldon; John,0,6,75,75
1650300045171,CSE 175,A01,083665,Kumar; Rakesh,8,0,25,17
1650300051196,CSE 190,A00,092507,Dubnov; Shlomo,14,0,20,6
1650300057223,ECE 45,A01,083139,Staff,0,16,40,40
1650300063246,ECE 65,A50,083695,Staff,0,4,30,30
1650300069270,ECE 109,A01,091882,Touri; Behrouz,43,0,70,27
1650300075300,ECE 180,A00,083140,Abi Samra; Nicholas Camill,23,0,30,7
1650300075300,ECE 180,B00,083141,Abi Samra; Nicholas Camill,7,0,30,23
1650300081335,MATH 10A,A01,083735,Patchell; Gregory David,10,0,30,20
1650300081335,MATH 10A,A02,083736,Patchell; Gregory David,28,0,30,2
1650300081335,MATH 10A,A03,083737,Patchell; Gregory David,26,0,30,4
1650300087364,MATH 10B,A01,083207,Staff,0,6,30,30
1650300087364,MATH 10B,A02,083208,Staff,0,6,30,30
1650300087364,MATH 10B,B01,083739,Staff,17,0,30,13
1650300087364,MATH 10B,B02,083740,Staff,29,0,30,1
1650300093390,MATH 18,A01,083743,Staff,6,0,30,24
1650300093390,MATH 18,A02,083744,Staff,26,0,30,4
1650300093390,MATH 18,A03,083745,Staff,23,0,30,7
1650300093390,MATH 18,A04,083746,Staff,27,0,30,3
1650300093390,MATH 18,B01,083748,Staff,0,11,30,30
1650300093390,MATH 18,B02,083749,Staff,0,10,30,30
1650300093390,MATH 18,B03,083750,Staff,1,9,30,29
1650300093390,MATH 18,B04,083751,Staff,0,10,30,30
1650300099415,MATH 20A,A01,083754,Staff,25,0,40,15
1650300105439,MATH 20B,A01,083756,Staff,0,5,30,30
1650300105439,MATH 20B,A02,083757,Staff,0,7,30,30
1650300111465,MATH 20C,A01,083760,Staff,0,13,30,30
1650300111465,MATH 20C,A02,083761,Staff,0,13,30,30
1650300111465,MATH 20C,B01,083762,Staff,13,0,30,17
1650300111465,MATH 20C,B02,083763,Staff,28,0,30,2
1650300117500,MATH 20D,A01,083765,Staff,0,1,30,30
1650300117500,MATH 20D,A02,083766,Staff,8,0,30,22
1650300117500,MATH 20D,A03,083767,Staff,27,0,30,3
1650300123528,MATH 20E,A01,083771,Staff,5,0,30,25
1650300123528,MATH 20E,A02,083772,Staff,20,0,30,10
1650300123528,MATH 20E,B01,083773,Staff,0,0,30,30
1650300123528,MATH 20E,B02,083774,Staff,11,0,30,19
1650300129554,MATH 103A,A01,083777,Staff,0,11,30,30
1650300129554,MATH 103A,A02,083778,Staff,0,10,30,30
1650300129554,MATH 103A,B01,083779,Staff,0,10,30,30
1650300129554,MATH 103A,B02,083780,Staff,0,10,30,30
1650300135580,MATH 105,A01,085443,Staff,0,17,30,30
1650300141617,MATH 109,A01,083213,Anzaldo; Leesa B,0,5,30,30
1650300141617,MATH 109,A02,083214,Anzaldo; Leesa B,0,6,30,30
1650300141617,MATH 109,B01,083215,Anzaldo; Leesa B,0,4,30,30
1650300141617,MATH 109,B02,083216,Anzaldo; Leesa B,0,4,30,30
1650300147643,MATH 142A,A01,083219,Chow; Bennett,0,12,30,30
1650300147643,MATH 142A,A02,083220,Chow; Bennett,0,11,30,30
1650300147643,MATH 142A,B01,083221,Chow; Bennett,0,11,30,30
1650300147643,MATH 142A,B02,083222,Chow; Bennett,0,12,30,30
1650300153668,MATH 193A,A01,083224,Staff,0,5,30,30
1650300153668,MATH 193A,A02,083225,Staff,0,5,30,30
1650300153668,MATH 193A,A03,083781,Staff,0,2,30,30
1650300153668,MATH 193A,A04,083782,Staff,0,1,30,30
1650300159696,MATH 197,001,091859,McAuley; Julian John,9998,0,9999,1
1650300165768,COGS 9,A01,083615,Staff,0,14,60,60
1650300171792,COGS 11,A01,083617,Boyle; Mary E. T.,23,0,40,17
1650300177821,COGS 13,A01,083071,Staff,0,31,40,40
1650300183862,COGS 14A,A01,092681,Staff,0,17,100,100
1650300189887,COGS 14B,A01,083073,Cheng; Tzu-Han,0,9,50,50
1650300195914,COGS 17,A01,092677,Staff,26,0,75,49
1650300201938,COGS 100,A01,083619,Staff,0,23,60,60
1650300207962,COGS 101A,A01,083621,Davis; Joshua Daniel,0,21,60,60
1650300213987,COGS 101B,A01,091572,Staff,4,0,60,56
1650300220016,COGS 101C,A01,083625,Delgado; Tania,19,0,30,11
1650300226043,COGS 107A,A01,083627,Boyle; Mary E. T.,0,8,60,60
1650300232068,COGS 118A,A01,083075,Staff,9,0,60,51
1650300238093,CSE 3,A50,083646,Miranda; Gregory Joseph,21,0,38,17
1650300238093,CSE 3,A51,083647,Miranda; Gregory Joseph,37,0,37,0
1650300244119,CSE 8A,A50,083650,Miranda; Gregory Joseph,0,23,40,40
1650300250158,CSE 11,A01,083080,Cao; Yingjun,0,80,40,40
1650300256181,CSE 12,A01,083652,Staff,0,10,100,100
1650300262276,CSE 15L,A01,083654,Staff,0,1,50,50
1650300262276,CSE 15L,A02,083655,Staff,4,0,50,46
1650300268303,CSE 20,A01,083657,Staff,53,0,80,27
1650300274329,CSE 30,A01,083084,Eldon; John,0,74,40,40
1650300280357,CSE 100,A01,083659,Cao; Yingjun,0,65,50,50
1650300286379,CSE 134B,A01,083661,Powell; Thomas Allan,0,29,65,65
1650300292405,CSE 140,A01,083663,Staff,0,0,75,75
1650300298433,CSE 140L,A01,083088,Eldon; John,0,6,75,75
1650300304465,CSE 175,A01,083665,Kumar; Rakesh,8,0,25,17
1650300310491,CSE 190,A00,092507,Dubnov; Shlomo,14,0,20,6
1650300316523,ECE 45,A01,083139,Staff,0,16,40,40
1650300322567,ECE 65,A50,083695,Staff,0,4,30,30
1650300328594,ECE 109,A01,091882,Touri; Behrouz,43,0,70,27
1650300334622,ECE 180,A00,083140,Abi Samra; Nicholas Camill,23,0,30,7
1650300334622,ECE 180,B00,083141,Abi Samra; Nicholas Camill,7,0,30,23
1650300340649,MATH 10A,A01,083735,Patchell; Gregory David,10,0,30,20
1650300340649,MATH 10A,A02,083736,Patchell; Gregory David,28,0,30,2
1650300340649,MATH 10A,A03,083737,Patchell; Gregory David,26,0,30,4
1650300346674,MATH 10B,A01,083207,Staff,0,6,30,30
1650300346674,MATH 10B,A02,083208,Staff,0,6,30,30
1650300346674,MATH 10B,B01,083739,Staff,17,0,30,13
1650300346674,MATH 10B,B02,083740,Staff,29,0,30,1
1650300352699,MATH 18,A01,083743,Staff,6,0,30,24
1650300352699,MATH 18,A02,083744,Staff,26,0,30,4
1650300352699,MATH 18,A03,083745,Staff,23,0,30,7
1650300352699,MATH 18,A04,083746,Staff,27,0,30,3
1650300352699,MATH 18,B01,083748,Staff,0,11,30,30
1650300352699,MATH 18,B02,083749,Staff,0,10,30,30
1650300352699,MATH 18,B03,083750,Staff,1,9,30,29
1650300352699,MATH 18,B04,083751,Staff,0,10,30,30
1650300358740,MATH 20A,A01,083754,Staff,25,0,40,15
1650300364768,MATH 20B,A01,083756,Staff,0,5,30,30
1650300364768,MATH 20B,A02,083757,Staff,0,7,30,30
1650300370805,MATH 20C,A01,083760,Staff,0,13,30,30
1650300370805,MATH 20C,A02,083761,Staff,0,13,30,30
1650300370805,MATH 20C,B01,083762,Staff,13,0,30,17
1650300370805,MATH 20C,B02,083763,Staff,28,0,30,2
1650300376830,MATH 20D,A01,083765,Staff,0,1,30,30
1650300376830,MATH 20D,A02,083766,Staff,8,0,30,22
1650300376830,MATH 20D,A03,083767,Staff,27,0,30,3
1650300382862,MATH 20E,A01,083771,Staff,5,0,30,25
1650300382862,MATH 20E,A02,083772,Staff,20,0,30,10
1650300382862,MATH 20E,B01,083773,Staff,0,0,30,30
1650300382862,MATH 20E,B02,083774,Staff,11,0,30,19
1650300388886,MATH 103A,A01,083777,Staff,0,11,30,30
1650300388886,MATH 103A,A02,083778,Staff,0,10,30,30
1650300388886,MATH 103A,B01,083779,Staff,0,10,30,30
1650300388886,MATH 103A,B02,083780,Staff,0,10,30,30
1650300394909,MATH 105,A01,085443,Staff,0,17,30,30
1650300400931,MATH 109,A01,083213,Anzaldo; Leesa B,0,5,30,30
1650300400931,MATH 109,A02,083214,Anzaldo; Leesa B,0,6,30,30
1650300400931,MATH 109,B01,083215,Anzaldo; Leesa B,0,4,30,30
1650300400931,MATH 109,B02,083216,Anzaldo; Leesa B,0,4,30,30
1650300406958,MATH 142A,A01,083219,Chow; Bennett,0,12,30,30
1650300406958,MATH 142A,A02,083220,Chow; Bennett,0,11,30,30
1650300406958,MATH 142A,B01,083221,Chow; Bennett,0,11,30,30
1650300406958,MATH 142A,B02,083222,Chow; Bennett,0,12,30,30
1650300412993,MATH 193A,A01,083224,Staff,0,5,30,30
1650300412993,MATH 193A,A02,083225,Staff,0,5,30,30
1650300412993,MATH 193A,A03,083781,Staff,0,2,30,30
1650300412993,MATH 193A,A04,083782,Staff,0,1,30,30
1650300419016,MATH 197,001,091859,McAuley; Julian John,9998,0,9999,1
1650300425087,COGS 9,A01,083615,Staff,0,14,60,60
1650300431115,COGS 11,A01,083617,Boyle; Mary E. T.,23,0,40,17
1650300437141,COGS 13,A01,083071,Staff,0,31,40,40
1650300443174,COGS 14A,A01,092681,Staff,0,17,100,100
1650300449209,COGS 14B,A01,083073,Cheng; Tzu-Han,0,9,50,50
1650300455232,COGS 17,A01,092677,Staff,26,0,75,49
1650300461256,COGS 100,A01,083619,Staff,0,23,60,60
1650300467283,COGS 101A,A01,083621,Davis; Joshua Daniel,0,21,60,60
1650300473314,COGS 101B,A01,091572,Staff,4,0,60,56
1650300479346,COGS 101C,A01,083625,Delgado; Tania,19,0,30,11
1650300485375,COGS 107A,A01,083627,Boyle; Mary E. T.,0,8,60,60
1650300491401,COGS 118A,A01,083075,Staff,9,0,60,51
1650300497429,CSE 3,A50,083646,Miranda; Gregory Joseph,21,0,38,17
1650300497429,CSE 3,A51,083647,Miranda; Gregory Joseph,37,0,37,0
1650300503453,CSE 8A,A50,083650,Miranda; Gregory Joseph,0,24,40,40
1650300509476,CSE 11,A01,083080,Cao; Yingjun,0,80,40,40
1650300515513,CSE 12,A01,083652,Staff,0,10,100,100
1650300521554,CSE 15L,A01,083654,Staff,0,1,50,50
1650300521554,CSE 15L,A02,083655,Staff,4,0,50,46
1650300527582,CSE 20,A01,083657,Staff,53,0,80,27
1650300533612,CSE 30,A01,083084,Eldon; John,0,74,40,40
1650300539639,CSE 100,A01,083659,Cao; Yingjun,0,65,50,50
1650300545680,CSE 134B,A01,083661,Powell; Thomas Allan,0,29,65,65
1650300551704,CSE 140,A01,083663,Staff,0,0,75,75
1650300557741,CSE 140L,A01,083088,Eldon; John,0,6,75,75
1650300563762,CSE 175,A01,083665,Kumar; Rakesh,8,0,25,17
1650300569785,CSE 190,A00,092507,Dubnov; Shlomo,14,0,20,6
1650300575809,ECE 45,A01,083139,Staff,0,16,40,40
1650300581838,ECE 65,A50,083695,Staff,0,4,30,30
1650300587868,ECE 109,A01,091882,Touri; Behrouz,43,0,70,27
1650300593896,ECE 180,A00,083140,Abi Samra; Nicholas Camill,23,0,30,7
1650300593896,ECE 180,B00,083141,Abi Samra; Nicholas Camill,7,0,30,23
1650300600010,MATH 10A,A01,083735,Patchell; Gregory David,10,0,30,20
1650300600010,MATH 10A,A02,083736,Patchell; Gregory David,28,0,30,2
1650300600010,MATH 10A,A03,083737,Patchell; Gregory David,26,0,30,4
1650300606038,MATH 10B,A01,083207,Staff,0,6,30,30
1650300606038,MATH 10B,A02,083208,Staff,0,6,30,30
1650300606038,MATH 10B,B01,083739,Staff,17,0,30,13
1650300606038,MATH 10B,B02,083740,Staff,29,0,30,1
1650300612071,MATH 18,A01,083743,Staff,6,0,30,24
1650300612071,MATH 18,A02,083744,Staff,26,0,30,4
1650300612071,MATH 18,A03,083745,Staff,23,0,30,7
1650300612071,MATH 18,A04,083746,Staff,27,0,30,3
1650300612071,MATH 18,B01,083748,Staff,0,11,30,30
1650300612071,MATH 18,B02,083749,Staff,0,10,30,30
1650300612071,MATH 18,B03,083750,Staff,1,9,30,29
1650300612071,MATH 18,B04,083751,Staff,0,10,30,30
1650300618098,MATH 20A,A01,083754,Staff,25,0,40,15
1650300624127,MATH 20B,A01,083756,Staff,0,5,30,30
1650300624127,MATH 20B,A02,083757,Staff,0,7,30,30
1650300630150,MATH 20C,A01,083760,Staff,0,13,30,30
1650300630150,MATH 20C,A02,083761,Staff,0,13,30,30
1650300630150,MATH 20C,B01,083762,Staff,13,0,30,17
1650300630150,MATH 20C,B02,083763,Staff,28,0,30,2
1650300636180,MATH 20D,A01,083765,Staff,0,1,30,30
1650300636180,MATH 20D,A02,083766,Staff,8,0,30,22
1650300636180,MATH 20D,A03,083767,Staff,27,0,30,3
1650300642207,MATH 20E,A01,083771,Staff,5,0,30,25
1650300642207,MATH 20E,A02,083772,Staff,20,0,30,10
1650300642207,MATH 20E,B01,083773,Staff,0,0,30,30
1650300642207,MATH 20E,B02,083774,Staff,11,0,30,19
1650300648242,MATH 103A,A01,083777,Staff,0,11,30,30
1650300648242,MATH 103A,A02,083778,Staff,0,10,30,30
1650300648242,MATH 103A,B01,083779,Staff,0,10,30,30
1650300648242,MATH 103A,B02,083780,Staff,0,10,30,30
1650300654268,MATH 105,A01,085443,Staff,0,17,30,30
1650300660293,MATH 109,A01,083213,Anzaldo; Leesa B,0,5,30,30
1650300660293,MATH 109,A02,083214,Anzaldo; Leesa B,0,6,30,30
1650300660293,MATH 109,B01,083215,Anzaldo; Leesa B,0,4,30,30
1650300660293,MATH 109,B02,083216,Anzaldo; Leesa B,0,4,30,30
1650300666316,MATH 142A,A01,083219,Chow; Bennett,0,12,30,30
1650300666316,MATH 142A,A02,083220,Chow; Bennett,0,11,30,30
1650300666316,MATH 142A,B01,083221,Chow; Bennett,0,11,30,30
1650300666316,MATH 142A,B02,083222,Chow; Bennett,0,12,30,30
1650300672342,MATH 193A,A01,083224,Staff,0,5,30,30
1650300672342,MATH 193A,A02,083225,Staff,0,5,30,30
1650300672342,MATH 193A,A03,083781,Staff,0,2,30,30
1650300672342,MATH 193A,A04,083782,Staff,0,1,30,30
1650300678373,MATH 197,001,091859,McAuley; Julian John,9998,0,9999,1
1650300684425,COGS 9,A01,083615,Staff,0,14,60,60
1650300690452,COGS 11,A01,083617,Boyle; Mary E. T.,23,0,40,17
1650300696491,COGS 13,A01,083071,Staff,0,31,40,40
1650300702515,COGS 14A,A01,092681,Staff,0,17,100,100
1650300708537,COGS 14B,A01,083073,Cheng; Tzu-Han,0,9,50,50
1650300714564,COGS 17,A01,092677,Staff,26,0,75,49
1650300720595,COGS 100,A01,083619,Staff,0,23,60,60
1650300726617,COGS 101A,A01,083621,Davis; Joshua Daniel,0,21,60,60
1650300732640,COGS 101B,A01,091572,Staff,4,0,60,56
1650300738664,COGS 101C,A01,083625,Delgado; Tania,19,0,30,11
1650300744687,COGS 107A,A01,083627,Boyle; Mary E. T.,0,8,60,60
1650300750713,COGS 118A,A01,083075,Staff,9,0,60,51
1650300756741,CSE 3,A50,083646,Miranda; Gregory Joseph,21,0,38,17
1650300756741,CSE 3,A51,083647,Miranda; Gregory Joseph,37,0,37,0
1650300762770,CSE 8A,A50,083650,Miranda; Gregory Joseph,0,24,40,40
1650300768793,CSE 11,A01,083080,Cao; Yingjun,0,80,40,40
1650300774819,CSE 12,A01,083652,Staff,0,10,100,100
1650300780845,CSE 15L,A01,083654,Staff,0,1,50,50
1650300780845,CSE 15L,A02,083655,Staff,4,0,50,46
1650300786878,CSE 20,A01,083657,Staff,53,0,80,27
1650300792902,CSE 30,A01,083084,Eldon; John,0,74,40,40
1650300798930,CSE 100,A01,083659,Cao; Yingjun,0,65,50,50
1650300804954,CSE 134B,A01,083661,Powell; Thomas Allan,0,29,65,65
1650300810980,CSE 140,A01,083663,Staff,0,0,75,75
1650300817014,CSE 140L,A01,083088,Eldon; John,0,6,75,75
1650300823038,CSE 175,A01,083665,Kumar; Rakesh,8,0,25,17
1650300829066,CSE 190,A00,092507,Dubnov; Shlomo,14,0,20,6
1650300835092,ECE 45,A01,083139,Staff,0,16,40,40
1650300841121,ECE 65,A50,083695,Staff,0,4,30,30
1650300847144,ECE 109,A01,091882,Touri; Behrouz,43,0,70,27
1650300853167,ECE 180,A00,083140,Abi Samra; Nicholas Camill,23,0,30,7
1650300853167,ECE 180,B00,083141,Abi Samra; Nicholas Camill,7,0,30,23
1650300859195,MATH 10A,A01,083735,Patchell; Gregory David,10,0,30,20
1650300859195,MATH 10A,A02,083736,Patchell; Gregory David,28,0,30,2
1650300859195,MATH 10A,A03,083737,Patchell; Gregory David,26,0,30,4
1650300865218,MATH 10B,A01,083207,Staff,0,6,30,30
1650300865218,MATH 10B,A02,083208,Staff,0,6,30,30
1650300865218,MATH 10B,B01,083739,Staff,17,0,30,13
1650300865218,MATH 10B,B02,083740,Staff,29,0,30,1
1650300871249,MATH 18,A01,083743,Staff,6,0,30,24
1650300871249,MATH 18,A02,083744,Staff,26,0,30,4
1650300871249,MATH 18,A03,083745,Staff,23,0,30,7
1650300871249,MATH 18,A04,083746,Staff,27,0,30,3
1650300871249,MATH 18,B01,083748,Staff,0,11,30,30
1650300871249,MATH 18,B02,083749,Staff,0,10,30,30
1650300871249,MATH 18,B03,083750,Staff,1,9,30,29
1650300871249,MATH 18,B04,083751,Staff,0,10,30,30
1650300877276,MATH 20A,A01,083754,Staff,25,0,40,15
1650300883299,MATH 20B,A01,083756,Staff,0,5,30,30
1650300883299,MATH 20B,A02,083757,Staff,0,7,30,30
1650300889324,MATH 20C,A01,083760,Staff,0,13,30,30
1650300889324,MATH 20C,A02,083761,Staff,0,13,30,30
1650300889324,MATH 20C,B01,083762,Staff,13,0,30,17
1650300889324,MATH 20C,B02,083763,Staff,28,0,30,2
1650300895352,MATH 20D,A01,083765,Staff,0,1,30,30
1650300895352,MATH 20D,A02,083766,Staff,8,0,30,22
1650300895352,MATH 20D,A03,083767,Staff,27,0,30,3
1650300901382,MATH 20E,A01,083771,Staff,5,0,30,25
1650300901382,MATH 20E,A02,083772,Staff,20,0,30,10
1650300901382,MATH 20E,B01,083773,Staff,0,0,30,30
1650300901382,MATH 20E,B02,083774,Staff,11,0,30,19
1650300907425,MATH 103A,A01,083777,Staff,0,11,30,30
1650300907425,MATH 103A,A02,083778,Staff,0,10,30,30
1650300907425,MATH 103A,B01,083779,Staff,0,10,30,30
1650300907425,MATH 103A,B02,083780,Staff,0,10,30,30
1650300913449,MATH 105,A01,085443,Staff,0,17,30,30
1650300919478,MATH 109,A01,083213,Anzaldo; Leesa B,0,5,30,30
1650300919478,MATH 109,A02,083214,Anzaldo; Leesa B,0,6,30,30
1650300919478,MATH 109,B01,083215,Anzaldo; Leesa B,0,4,30,30
1650300919478,MATH 109,B02,083216,Anzaldo; Leesa B,0,4,30,30
1650300925504,MATH 142A,A01,083219,Chow; Bennett,0,12,30,30
1650300925504,MATH 142A,A02,083220,Chow; Bennett,0,11,30,30
1650300925504,MATH 142A,B01,083221,Chow; Bennett,0,11,30,30
1650300925504,MATH 142A,B02,083222,Chow; Bennett,0,12,30,30
1650300931545,MATH 193A,A01,083224,Staff,0,5,30,30
1650300931545,MATH 193A,A02,083225,Staff,0,5,30,30
1650300931545,MATH 193A,A03,083781,Staff,0,2,30,30
1650300931545,MATH 193A,A04,083782,Staff,0,1,30,30
1650300937569,MATH 197,001,091859,McAuley; Julian John,9998,0,9999,1
1650300943640,COGS 9,A01,083615,Staff,0,14,60,60
1650300949671,COGS 11,A01,083617,Boyle; Mary E. T.,23,0,40,17
1650300955695,COGS 13,A01,083071,Staff,0,31,40,40
1650300961723,COGS 14A,A01,092681,Staff,0,17,100,100
1650300967751,COGS 14B,A01,083073,Cheng; Tzu-Han,0,9,50,50
1650300973777,COGS 17,A01,092677,Staff,26,0,75,49
1650300979800,COGS 100,A01,083619,Staff,0,23,60,60
1650300985826,COGS 101A,A01,083621,Davis; Joshua Daniel,0,22,60,60
1650300991857,COGS 101B,A01,091572,Staff,4,0,60,56
1650300997882,COGS 101C,A01,083625,Delgado; Tania,19,0,30,11
1650301003922,COGS 107A,A01,083627,Boyle; Mary E. T.,0,8,60,60
1650301009949,COGS 118A,A01,083075,Staff,9,0,60,51
1650301015974,CSE 3,A50,083646,Miranda; Gregory Joseph,21,0,38,17
1650301015974,CSE 3,A51,083647,Miranda; Gregory Joseph,37,0,37,0
1650301022003,CSE 8A,A50,083650,Miranda; Gregory Joseph,0,24,40,40
1650301028027,CSE 11,A01,083080,Cao; Yingjun,0,80,40,40
1650301034066,CSE 12,A01,083652,Staff,0,10,100,100
1650301040092,CSE 15L,A01,083654,Staff,0,1,50,50
1650301040092,CSE 15L,A02,083655,Staff,4,0,50,46
1650301046120,CSE 20,A01,083657,Staff,53,0,80,27
1650301056721,CSE 30,A01,083084,Eldon; John,0,74,40,40
1650301062748,CSE 100,A01,083659,Cao; Yingjun,0,65,50,50
1650301068772,CSE 134B,A01,083661,Powell; Thomas Allan,0,29,65,65
1650301074797,CSE 140,A01,083663,Staff,0,0,75,75
1650301080827,CSE 140L,A01,083088,Eldon; John,0,6,75,75
1650301086853,CSE 175,A01,083665,Kumar; Rakesh,8,0,25,17
1650301092876,CSE 190,A00,092507,Dubnov; Shlomo,14,0,20,6
1650301098914,ECE 45,A01,083139,Staff,0,16,40,40
1650301104947,ECE 65,A50,083695,Staff,0,4,30,30
1650301110974,ECE 109,A01,091882,Touri; Behrouz,43,0,70,27
1650301116996,ECE 180,A00,083140,Abi Samra; Nicholas Camill,23,0,30,7
1650301116996,ECE 180,B00,083141,Abi Samra; Nicholas Camill,7,0,30,23
1650301123029,MATH 10A,A01,083735,Patchell; Gregory David,10,0,30,20
1650301123029,MATH 10A,A02,083736,Patchell; Gregory David,28,0,30,2
1650301123029,MATH 10A,A03,083737,Patchell; Gregory David,26,0,30,4
1650301129054,MATH 10B,A01,083207,Staff,0,6,30,30
1650301129054,MATH 10B,A02,083208,Staff,0,6,30,30
1650301129054,MATH 10B,B01,083739,Staff,17,0,30,13
1650301129054,MATH 10B,B02,083740,Staff,29,0,30,1
1650301135084,MATH 18,A01,083743,Staff,6,0,30,24
1650301135084,MATH 18,A02,083744,Staff,26,0,30,4
1650301135084,MATH 18,A03,083745,Staff,23,0,30,7
1650301135084,MATH 18,A04,083746,Staff,27,0,30,3
1650301135084,MATH 18,B01,083748,Staff,0,11,30,30
1650301135084,MATH 18,B02,083749,Staff,0,10,30,30
1650301135084,MATH 18,B03,083750,Staff,1,9,30,29
1650301135084,MATH 18,B04,083751,Staff,0,10,30,30
1650301141107,MATH 20A,A01,083754,Staff,25,0,40,15
1650301147133,MATH 20B,A01,083756,Staff,0,5,30,30
1650301147133,MATH 20B,A02,083757,Staff,0,7,30,30
1650301153159,MATH 20C,A01,083760,Staff,0,13,30,30
1650301153159,MATH 20C,A02,083761,Staff,0,13,30,30
1650301153159,MATH 20C,B01,083762,Staff,13,0,30,17
1650301153159,MATH 20C,B02,083763,Staff,28,0,30,2
1650301159183,MATH 20D,A01,083765,Staff,0,1,30,30
1650301159183,MATH 20D,A02,083766,Staff,8,0,30,22
1650301159183,MATH 20D,A03,083767,Staff,27,0,30,3
1650301165212,MATH 20E,A01,083771,Staff,5,0,30,25
1650301165212,MATH 20E,A02,083772,Staff,20,0,30,10
1650301165212,MATH 20E,B01,083773,Staff,0,0,30,30
1650301165212,MATH 20E,B02,083774,Staff,11,0,30,19
1650301171241,MATH 103A,A01,083777,Staff,0,11,30,30
1650301171241,MATH 103A,A02,083778,Staff,0,10,30,30
1650301171241,MATH 103A,B01,083779,Staff,0,10,30,30
1650301171241,MATH 103A,B02,083780,Staff,0,10,30,30
1650301177264,MATH 105,A01,085443,Staff,0,17,30,30
1650301183292,MATH 109,A01,083213,Anzaldo; Leesa B,0,5,30,30
1650301183292,MATH 109,A02,083214,Anzaldo; Leesa B,0,6,30,30
1650301183292,MATH 109,B01,083215,Anzaldo; Leesa B,0,4,30,30
1650301183292,MATH 109,B02,083216,Anzaldo; Leesa B,0,4,30,30
1650301189321,MATH 142A,A01,083219,Chow; Bennett,0,12,30,30
1650301189321,MATH 142A,A02,083220,Chow; Bennett,0,11,30,30
1650301189321,MATH 142A,B01,083221,Chow; Bennett,0,11,30,30
1650301189321,MATH 142A,B02,083222,Chow; Bennett,0,12,30,30
1650301195344,MATH 193A,A01,083224,Staff,0,5,30,30
1650301195344,MATH 193A,A02,083225,Staff,0,5,30,30
1650301195344,MATH 193A,A03,083781,Staff,0,2,30,30
1650301195344,MATH 193A,A04,083782,Staff,0,1,30,30
1650301201465,MATH 197,001,091859,McAuley; Julian John,9998,0,9999,1
1650301207529,COGS 9,A01,083615,Staff,0,14,60,60
1650301213556,COGS 11,A01,083617,Boyle; Mary E. T.,23,0,40,17
1650301219588,COGS 13,A01,083071,Staff,0,31,40,40
1650301225611,COGS 14A,A01,092681,Staff,0,17,100,100
1650301231637,COGS 14B,A01,083073,Cheng; Tzu-Han,0,9,50,50
1650301237666,COGS 17,A01,092677,Staff,26,0,75,49
1650301243701,COGS 100,A01,083619,Staff,0,23,60,60
1650301249731,COGS 101A,A01,083621,Davis; Joshua Daniel,0,22,60,60
1650301255765,COGS 101B,A01,091572,Staff,4,0,60,56
1650301261791,COGS 101C,A01,083625,Delgado; Tania,19,0,30,11
1650301267817,COGS 107A,A01,083627,Boyle; Mary E. T.,0,8,60,60
1650301273846,COGS 118A,A01,083075,Staff,9,0,60,51
1650301279883,CSE 3,A50,083646,Miranda; Gregory Joseph,21,0,38,17
1650301279883,CSE 3,A51,083647,Miranda; Gregory Joseph,37,0,37,0
1650301285914,CSE 8A,A50,083650,Miranda; Gregory Joseph,0,24,40,40
1650301291937,CSE 11,A01,083080,Cao; Yingjun,0,80,40,40
1650301297960,CSE 12,A01,083652,Staff,0,10,100,100
1650301303984,CSE 15L,A01,083654,Staff,0,1,50,50
1650301303984,CSE 15L,A02,083655,Staff,4,0,50,46
1650301310012,CSE 20,A01,083657,Staff,53,0,80,27
1650301316040,CSE 30,A01,083084,Eldon; John,0,74,40,40
1650301322063,CSE 100,A01,083659,Cao; Yingjun,0,65,50,50
1650301328087,CSE 134B,A01,083661,Powell; Thomas Allan,0,29,65,65
1650301334116,CSE 140,A01,083663,Staff,0,0,75,75
1650301340140,CSE 140L,A01,083088,Eldon; John,0,6,75,75
1650301346167,CSE 175,A01,083665,Kumar; Rakesh,8,0,25,17
1650301352193,CSE 190,A00,092507,Dubnov; Shlomo,14,0,20,6
1650301358218,ECE 45,A01,083139,Staff,0,16,40,40
1650301364243,ECE 65,A50,083695,Staff,0,4,30,30
1650301370267,ECE 109,A01,091882,Touri; Behrouz,43,0,70,27
1650301376298,ECE 180,A00,083140,Abi Samra; Nicholas Camill,23,0,30,7
1650301376298,ECE 180,B00,083141,Abi Samra; Nicholas Camill,7,0,30,23
1650301382330,MATH 10A,A01,083735,Patchell; Gregory David,10,0,30,20
1650301382330,MATH 10A,A02,083736,Patchell; Gregory David,28,0,30,2
1650301382330,MATH 10A,A03,083737,Patchell; Gregory David,26,0,30,4
1650301388364,MATH 10B,A01,083207,Staff,0,6,30,30
1650301388364,MATH 10B,A02,083208,Staff,0,6,30,30
1650301388364,MATH 10B,B01,083739,Staff,17,0,30,13
1650301388364,MATH 10B,B02,083740,Staff,29,0,30,1
1650301394387,MATH 18,A01,083743,Staff,6,0,30,24
1650301394387,MATH 18,A02,083744,Staff,26,0,30,4
1650301394387,MATH 18,A03,083745,Staff,22,0,30,8
1650301394387,MATH 18,A04,083746,Staff,27,0,30,3
1650301394387,MATH 18,B01,083748,Staff,0,11,30,30
1650301394387,MATH 18,B02,083749,Staff,0,10,30,30
1650301394387,MATH 18,B03,083750,Staff,1,9,30,29
1650301394387,MATH 18,B04,083751,Staff,0,10,30,30
1650301400422,MATH 20A,A01,083754,Staff,25,0,40,15
1650301406458,MATH 20B,A01,083756,Staff,0,5,30,30
1650301406458,MATH 20B,A02,083757,Staff,0,7,30,30
1650301412487,MATH 20C,A01,083760,Staff,0,13,30,30
1650301412487,MATH 20C,A02,083761,Staff,0,13,30,30
1650301412487,MATH 20C,B01,083762,Staff,13,0,30,17
1650301412487,MATH 20C,B02,083763,Staff,28,0,30,2
1650301418509,MATH 20D,A01,083765,Staff,0,1,30,30
1650301418509,MATH 20D,A02,083766,Staff,8,0,30,22
1650301418509,MATH 20D,A03,083767,Staff,27,0,30,3
1650301424542,MATH 20E,A01,083771,Staff,5,0,30,25
1650301424542,MATH 20E,A02,083772,Staff,20,0,30,10
1650301424542,MATH 20E,B01,083773,Staff,0,0,30,30
1650301424542,MATH 20E,B02,083774,Staff,11,0,30,19
1650301430565,MATH 103A,A01,083777,Staff,0,11,30,30
1650301430565,MATH 103A,A02,083778,Staff,0,10,30,30
1650301430565,MATH 103A,B01,083779,Staff,0,10,30,30
1650301430565,MATH 103A,B02,083780,Staff,0,10,30,30
1650301436588,MATH 105,A01,085443,Staff,0,17,30,30
1650301442612,MATH 109,A01,083213,Anzaldo; Leesa B,0,5,30,30
1650301442612,MATH 109,A02,083214,Anzaldo; Leesa B,0,6,30,30
1650301442612,MATH 109,B01,083215,Anzaldo; Leesa B,0,4,30,30
1650301442612,MATH 109,B02,083216,Anzaldo; Leesa B,0,4,30,30
1650301448641,MATH 142A,A01,083219,Chow; Bennett,0,12,30,30
1650301448641,MATH 142A,A02,083220,Chow; Bennett,0,11,30,30
1650301448641,MATH 142A,B01,083221,Chow; Bennett,0,11,30,30
1650301448641,MATH 142A,B02,083222,Chow; Bennett,0,12,30,30
1650301454679,MATH 193A,A01,083224,Staff,0,5,30,30
1650301454679,MATH 193A,A02,083225,Staff,0,5,30,30
1650301454679,MATH 193A,A03,083781,Staff,0,2,30,30
1650301454679,MATH 193A,A04,083782,Staff,0,1,30,30
1650301460704,MATH 197,001,091859,McAuley; Julian John,9998,0,9999,1
1650301466773,COGS 9,A01,083615,Staff,0,14,60,60
1650301472807,COGS 11,A01,083617,Boyle; Mary E. T.,23,0,40,17
1650301478835,COGS 13,A01,083071,Staff,0,31,40,40
1650301484861,COGS 14A,A01,092681,Staff,0,17,100,100
1650301490883,COGS 14B,A01,083073,Cheng; Tzu-Han,0,9,50,50
1650301496907,COGS 17,A01,092677,Staff,26,0,75,49
1650301502937,COGS 100,A01,083619,Staff,0,23,60,60
1650301508959,COGS 101A,A01,083621,Davis; Joshua Daniel,0,22,60,60
1650301514989,COGS 101B,A01,091572,Staff,4,0,60,56
1650301521016,COGS 101C,A01,083625,Delgado; Tania,19,0,30,11
1650301527039,COGS 107A,A01,083627,Boyle; Mary E. T.,0,8,60,60
1650301533071,COGS 118A,A01,083075,Staff,9,0,60,51
1650301539096,CSE 3,A50,083646,Miranda; Gregory Joseph,21,0,38,17
1650301539096,CSE 3,A51,083647,Miranda; Gregory Joseph,37,0,37,0
1650301545127,CSE 8A,A50,083650,Miranda; Gregory Joseph,0,24,40,40
1650301551151,CSE 11,A01,083080,Cao; Yingjun,0,79,40,40
1650301557177,CSE 12,A01,083652,Staff,0,10,100,100
1650301563202,CSE 15L,A01,083654,Staff,0,1,50,50
1650301563202,CSE 15L,A02,083655,Staff,4,0,50,46
1650301569229,CSE 20,A01,083657,Staff,53,0,80,27
1650301575256,CSE 30,A01,083084,Eldon; John,0,74,40,40
1650301581281,CSE 100,A01,083659,Cao; Yingjun,0,65,50,50
1650301587314,CSE 134B,A01,083661,Powell; Thomas Allan,0,29,65,65
1650301593351,CSE 140,A01,083663,Staff,0,0,75,75
1650301599378,CSE 140L,A01,083088,Eldon; John,0,6,75,75
1650301605407,CSE 175,A01,083665,Kumar; Rakesh,8,0,25,17
1650301611430,CSE 190,A00,092507,Dubnov; Shlomo,14,0,20,6
1650301617454,ECE 45,A01,083139,Staff,0,16,40,40
1650301623477,ECE 65,A50,083695,Staff,0,4,30,30
1650301629500,ECE 109,A01,091882,Touri; Behrouz,43,0,70,27
1650301635529,ECE 180,A00,083140,Abi Samra; Nicholas Camill,23,0,30,7
1650301635529,ECE 180,B00,083141,Abi Samra; Nicholas Camill,7,0,30,23
1650301641557,MATH 10A,A01,083735,Patchell; Gregory David,10,0,30,20
1650301641557,MATH 10A,A02,083736,Patchell; Gregory David,28,0,30,2
1650301641557,MATH 10A,A03,083737,Patchell; Gregory David,26,0,30,4
1650301647586,MATH 10B,A01,083207,Staff,0,6,30,30
1650301647586,MATH 10B,A02,083208,Staff,0,6,30,30
1650301647586,MATH 10B,B01,083739,Staff,17,0,30,13
1650301647586,MATH 10B,B02,083740,Staff,29,0,30,1
1650301653612,MATH 18,A01,083743,Staff,6,0,30,24
1650301653612,MATH 18,A02,083744,Staff,26,0,30,4
1650301653612,MATH 18,A03,083745,Staff,22,0,30,8
1650301653612,MATH 18,A04,083746,Staff,27,0,30,3
1650301653612,MATH 18,B01,083748,Staff,0,11,30,30
1650301653612,MATH 18,B02,083749,Staff,0,10,30,30
1650301653612,MATH 18,B03,083750,Staff,1,9,30,29
1650301653612,MATH 18,B04,083751,Staff,0,10,30,30
1650301659634,MATH 20A,A01,083754,Staff,25,0,40,15
1650301665661,MATH 20B,A01,083756,Staff,0,5,30,30
1650301665661,MATH 20B,A02,083757,Staff,0,7,30,30
1650301671683,MATH 20C,A01,083760,Staff,0,13,30,30
1650301671683,MATH 20C,A02,083761,Staff,0,13,30,30
1650301671683,MATH 20C,B01,083762,Staff,13,0,30,17
1650301671683,MATH 20C,B02,083763,Staff,28,0,30,2
1650301677712,MATH 20D,A01,083765,Staff,0,1,30,30
1650301677712,MATH 20D,A02,083766,Staff,8,0,30,22
1650301677712,MATH 20D,A03,083767,Staff,27,0,30,3
1650301683735,MATH 20E,A01,083771,Staff,5,0,30,25
1650301683735,MATH 20E,A02,083772,Staff,20,0,30,10
1650301683735,MATH 20E,B01,083773,Staff,0,0,30,30
1650301683735,MATH 20E,B02,083774,Staff,11,0,30,19
1650301689767,MATH 103A,A01,083777,Staff,0,11,30,30
1650301689767,MATH 103A,A02,083778,Staff,0,10,30,30
1650301689767,MATH 103A,B01,083779,Staff,0,10,30,30
1650301689767,MATH 103A,B02,083780,Staff,0,10,30,30
1650301695790,MATH 105,A01,085443,Staff,0,17,30,30
1650301701813,MATH 109,A01,083213,Anzaldo; Leesa B,0,5,30,30
1650301701813,MATH 109,A02,083214,Anzaldo; Leesa B,0,6,30,30
1650301701813,MATH 109,B01,083215,Anzaldo; Leesa B,0,4,30,30
1650301701813,MATH 109,B02,083216,Anzaldo; Leesa B,0,4,30,30
1650301707841,MATH 142A,A01,083219,Chow; Bennett,0,12,30,30
1650301707841,MATH 142A,A02,083220,Chow; Bennett,0,11,30,30
1650301707841,MATH 142A,B01,083221,Chow; Bennett,0,11,30,30
1650301707841,MATH 142A,B02,083222,Chow; Bennett,0,12,30,30
1650301713865,MATH 193A,A01,083224,Staff,0,5,30,30
1650301713865,MATH 193A,A02,083225,Staff,0,5,30,30
1650301713865,MATH 193A,A03,083781,Staff,0,2,30,30
1650301713865,MATH 193A,A04,083782,Staff,0,1,30,30
1650301719888,MATH 197,001,091859,McAuley; Julian John,9998,0,9999,1
1650301725939,COGS 9,A01,083615,Staff,0,14,60,60
1650301731961,COGS 11,A01,083617,Boyle; Mary E. T.,23,0,40,17
1650301737983,COGS 13,A01,083071,Staff,0,31,40,40
1650301744018,COGS 14A,A01,092681,Staff,0,17,100,100
1650301750057,COGS 14B,A01,083073,Cheng; Tzu-Han,0,9,50,50
1650301756080,COGS 17,A01,092677,Staff,26,0,75,49
1650301762106,COGS 100,A01,083619,Staff,0,23,60,60
1650301768143,COGS 101A,A01,083621,Davis; Joshua Daniel,0,22,60,60
1650301774168,COGS 101B,A01,091572,Staff,4,0,60,56
1650301780196,COGS 101C,A01,083625,Delgado; Tania,19,0,30,11
1650301786218,COGS 107A,A01,083627,Boyle; Mary E. T.,0,8,60,60
1650301792334,COGS 118A,A01,083075,Staff,9,0,60,51
1650301798360,CSE 3,A50,083646,Miranda; Gregory Joseph,21,0,38,17
1650301798360,CSE 3,A51,083647,Miranda; Gregory Joseph,37,0,37,0
1650301804389,CSE 8A,A50,083650,Miranda; Gregory Joseph,0,24,40,40
1650301810417,CSE 11,A01,083080,Cao; Yingjun,0,80,40,40
1650301816455,CSE 12,A01,083652,Staff,0,10,100,100
1650301822478,CSE 15L,A01,083654,Staff,0,1,50,50
1650301822478,CSE 15L,A02,083655,Staff,4,0,50,46
1650301828503,CSE 20,A01,083657,Staff,53,0,80,27
1650301834526,CSE 30,A01,083084,Eldon; John,0,74,40,40
1650301840556,CSE 100,A01,083659,Cao; Yingjun,0,65,50,50
1650301846579,CSE 134B,A01,083661,Powell; Thomas Allan,0,29,65,65
1650301852605,CSE 140,A01,083663,Staff,0,0,75,75
1650301858629,CSE 140L,A01,083088,Eldon; John,0,6,75,75
1650301864654,CSE 175,A01,083665,Kumar; Rakesh,8,0,25,17
1650301870679,CSE 190,A00,092507,Dubnov; Shlomo,14,0,20,6
1650301876703,ECE 45,A01,083139,Staff,0,16,40,40
1650301882731,ECE 65,A50,083695,Staff,0,4,30,30
1650301888763,ECE 109,A01,091882,Touri; Behrouz,43,0,70,27
1650301894787,ECE 180,A00,083140,Abi Samra; Nicholas Camill,23,0,30,7
1650301894787,ECE 180,B00,083141,Abi Samra; Nicholas Camill,7,0,30,23
1650301900811,MATH 10A,A01,083735,Patchell; Gregory David,10,0,30,20
1650301900811,MATH 10A,A02,083736,Patchell; Gregory David,28,0,30,2
1650301900811,MATH 10A,A03,083737,Patchell; Gregory David,26,0,30,4
1650301906838,MATH 10B,A01,083207,Staff,0,6,30,30
1650301906838,MATH 10B,A02,083208,Staff,0,6,30,30
1650301906838,MATH 10B,B01,083739,Staff,17,0,30,13
1650301906838,MATH 10B,B02,083740,Staff,29,0,30,1
1650301912863,MATH 18,A01,083743,Staff,6,0,30,24
1650301912863,MATH 18,A02,083744,Staff,26,0,30,4
1650301912863,MATH 18,A03,083745,Staff,22,0,30,8
1650301912863,MATH 18,A04,083746,Staff,27,0,30,3
1650301912863,MATH 18,B01,083748,Staff,0,11,30,30
1650301912863,MATH 18,B02,083749,Staff,0,10,30,30
1650301912863,MATH 18,B03,083750,Staff,1,9,30,29
1650301912863,MATH 18,B04,083751,Staff,0,10,30,30
1650301918886,MATH 20A,A01,083754,Staff,25,0,40,15
1650301924913,MATH 20B,A01,083756,Staff,0,5,30,30
1650301924913,MATH 20B,A02,083757,Staff,0,7,30,30
1650301930938,MATH 20C,A01,083760,Staff,0,13,30,30
1650301930938,MATH 20C,A02,083761,Staff,0,13,30,30
1650301930938,MATH 20C,B01,083762,Staff,13,0,30,17
1650301930938,MATH 20C,B02,083763,Staff,28,0,30,2
1650301936963,MATH 20D,A01,083765,Staff,0,1,30,30
1650301936963,MATH 20D,A02,083766,Staff,8,0,30,22
1650301936963,MATH 20D,A03,083767,Staff,27,0,30,3
1650301942997,MATH 20E,A01,083771,Staff,5,0,30,25
1650301942997,MATH 20E,A02,083772,Staff,20,0,30,10
1650301942997,MATH 20E,B01,083773,Staff,0,0,30,30
1650301942997,MATH 20E,B02,083774,Staff,11,0,30,19
1650301949024,MATH 103A,A01,083777,Staff,0,11,30,30
1650301949024,MATH 103A,A02,083778,Staff,0,10,30,30
1650301949024,MATH 103A,B01,083779,Staff,0,10,30,30
1650301949024,MATH 103A,B02,083780,Staff,0,10,30,30
1650301955047,MATH 105,A01,085443,Staff,0,17,30,30
1650301961071,MATH 109,A01,083213,Anzaldo; Leesa B,0,5,30,30
1650301961071,MATH 109,A02,083214,Anzaldo; Leesa B,0,6,30,30
1650301961071,MATH 109,B01,083215,Anzaldo; Leesa B,0,4,30,30
1650301961071,MATH 109,B02,083216,Anzaldo; Leesa B,0,4,30,30
1650301967095,MATH 142A,A01,083219,Chow; Bennett,0,12,30,30
1650301967095,MATH 142A,A02,083220,Chow; Bennett,0,11,30,30
1650301967095,MATH 142A,B01,083221,Chow; Bennett,0,11,30,30
1650301967095,MATH 142A,B02,083222,Chow; Bennett,0,12,30,30
1650301973119,MATH 193A,A01,083224,Staff,0,5,30,30
1650301973119,MATH 193A,A02,083225,Staff,0,5,30,30
1650301973119,MATH 193A,A03,083781,Staff,0,2,30,30
1650301973119,MATH 193A,A04,083782,Staff,0,1,30,30
1650301979143,MATH 197,001,091859,McAuley; Julian John,9998,0,9999,1
1650301985217,COGS 9,A01,083615,Staff,0,14,60,60
1650301991240,COGS 11,A01,083617,Boyle; Mary E. T.,23,0,40,17
1650301997263,COGS 13,A01,083071,Staff,0,31,40,40
1650302003298,COGS 14A,A01,092681,Staff,0,17,100,100
1650302009326,COGS 14B,A01,083073,Cheng; Tzu-Han,0,9,50,50
1650302015364,COGS 17,A01,092677,Staff,26,0,75,49
1650302021390,COGS 100,A01,083619,Staff,0,23,60,60
1650302027416,COGS 101A,A01,083621,Davis; Joshua Daniel,0,22,60,60
1650302033438,COGS 101B,A01,091572,Staff,4,0,60,56
1650302039464,COGS 101C,A01,083625,Delgado; Tania,19,0,30,11
1650302045489,COGS 107A,A01,083627,Boyle; Mary E. T.,0,8,60,60
1650302051513,COGS 118A,A01,083075,Staff,9,0,60,51
1650302057538,CSE 3,A50,083646,Miranda; Gregory Joseph,21,0,38,17
1650302057538,CSE 3,A51,083647,Miranda; Gregory Joseph,37,0,37,0
1650302063569,CSE 8A,A50,083650,Miranda; Gregory Joseph,0,24,40,40
1650302069595,CSE 11,A01,083080,Cao; Yingjun,0,80,40,40
1650302075618,CSE 12,A01,083652,Staff,0,10,100,100
1650302081646,CSE 15L,A01,083654,Staff,0,1,50,50
1650302081646,CSE 15L,A02,083655,Staff,4,0,50,46
1650302087669,CSE 20,A01,083657,Staff,53,0,80,27
1650302093694,CSE 30,A01,083084,Eldon; John,0,74,40,40
1650302099729,CSE 100,A01,083659,Cao; Yingjun,0,65,50,50
1650302105760,CSE 134B,A01,083661,Powell; Thomas Allan,0,29,65,65
1650302111783,CSE 140,A01,083663,Staff,0,0,75,75
1650302117807,CSE 140L,A01,083088,Eldon; John,0,6,75,75
1650302123832,CSE 175,A01,083665,Kumar; Rakesh,8,0,25,17
1650302129856,CSE 190,A00,092507,Dubnov; Shlomo,14,0,20,6
1650302135881,ECE 45,A01,083139,Staff,0,16,40,40
1650302141904,ECE 65,A50,083695,Staff,0,4,30,30
1650302147928,ECE 109,A01,091882,Touri; Behrouz,43,0,70,27
1650302153957,ECE 180,A00,083140,Abi Samra; Nicholas Camill,23,0,30,7
1650302153957,ECE 180,B00,083141,Abi Samra; Nicholas Camill,6,0,30,24
1650302159981,MATH 10A,A01,083735,Patchell; Gregory David,10,0,30,20
1650302159981,MATH 10A,A02,083736,Patchell; Gregory David,28,0,30,2
1650302159981,MATH 10A,A03,083737,Patchell; Gregory David,26,0,30,4
1650302166006,MATH 10B,A01,083207,Staff,0,6,30,30
1650302166006,MATH 10B,A02,083208,Staff,0,6,30,30
1650302166006,MATH 10B,B01,083739,Staff,17,0,30,13
1650302166006,MATH 10B,B02,083740,Staff,29,0,30,1
1650302172034,MATH 18,A01,083743,Staff,6,0,30,24
1650302172034,MATH 18,A02,083744,Staff,26,0,30,4
1650302172034,MATH 18,A03,083745,Staff,22,0,30,8
1650302172034,MATH 18,A04,083746,Staff,27,0,30,3
1650302172034,MATH 18,B01,083748,Staff,0,11,30,30
1650302172034,MATH 18,B02,083749,Staff,0,10,30,30
1650302172034,MATH 18,B03,083750,Staff,1,9,30,29
1650302172034,MATH 18,B04,083751,Staff,0,10,30,30
1650302178059,MATH 20A,A01,083754,Staff,25,0,40,15
1650302184089,MATH 20B,A01,083756,Staff,0,5,30,30
1650302184089,MATH 20B,A02,083757,Staff,0,7,30,30
1650302190124,MATH 20C,A01,083760,Staff,0,13,30,30
1650302190124,MATH 20C,A02,083761,Staff,0,13,30,30
1650302190124,MATH 20C,B01,083762,Staff,13,0,30,17
1650302190124,MATH 20C,B02,083763,Staff,28,0,30,2
1650302196155,MATH 20D,A01,083765,Staff,0,1,30,30
1650302196155,MATH 20D,A02,083766,Staff,8,0,30,22
1650302196155,MATH 20D,A03,083767,Staff,27,0,30,3
1650302202185,MATH 20E,A01,083771,Staff,5,0,30,25
1650302202185,MATH 20E,A02,083772,Staff,20,0,30,10
1650302202185,MATH 20E,B01,083773,Staff,0,0,30,30
1650302202185,MATH 20E,B02,083774,Staff,11,0,30,19
1650302208210,MATH 103A,A01,083777,Staff,0,11,30,30
1650302208210,MATH 103A,A02,083778,Staff,0,10,30,30
1650302208210,MATH 103A,B01,083779,Staff,0,10,30,30
1650302208210,MATH 103A,B02,083780,Staff,0,10,30,30
1650302214237,MATH 105,A01,085443,Staff,0,17,30,30
1650302220262,MATH 109,A01,083213,Anzaldo; Leesa B,0,5,30,30
1650302220262,MATH 109,A02,083214,Anzaldo; Leesa B,0,6,30,30
1650302220262,MATH 109,B01,083215,Anzaldo; Leesa B,0,4,30,30
1650302220262,MATH 109,B02,083216,Anzaldo; Leesa B,0,4,30,30
1650302226284,MATH 142A,A01,083219,Chow; Bennett,0,12,30,30
1650302226284,MATH 142A,A02,083220,Chow; Bennett,0,11,30,30
1650302226284,MATH 142A,B01,083221,Chow; Bennett,0,11,30,30
1650302226284,MATH 142A,B02,083222,Chow; Bennett,0,12,30,30
1650302232316,MATH 193A,A01,083224,Staff,0,5,30,30
1650302232316,MATH 193A,A02,083225,Staff,0,5,30,30
1650302232316,MATH 193A,A03,083781,Staff,0,2,30,30
1650302232316,MATH 193A,A04,083782,Staff,0,1,30,30
1650302238340,MATH 197,001,091859,McAuley; Julian John,9998,0,9999,1
1650302244396,COGS 9,A01,083615,Staff,0,14,60,60
1650302250423,COGS 11,A01,083617,Boyle; Mary E. T.,23,0,40,17
1650302256447,COGS 13,A01,083071,Staff,0,31,40,40
1650302262473,COGS 14A,A01,092681,Staff,0,17,100,100
1650302268496,COGS 14B,A01,083073,Cheng; Tzu-Han,0,9,50,50
1650302274525,COGS 17,A01,092677,Staff,26,0,75,49
1650302280549,COGS 100,A01,083619,Staff,0,23,60,60
1650302286580,COGS 101A,A01,083621,Davis; Joshua Daniel,0,22,60,60
1650302292608,COGS 101B,A01,091572,Staff,4,0,60,56
1650302298633,COGS 101C,A01,083625,Delgado; Tania,19,0,30,11
1650302304656,COGS 107A,A01,083627,Boyle; Mary E. T.,0,8,60,60
1650302310678,COGS 118A,A01,083075,Staff,9,0,60,51
1650302316705,CSE 3,A50,083646,Miranda; Gregory Joseph,21,0,38,17
1650302316705,CSE 3,A51,083647,Miranda; Gregory Joseph,37,0,37,0
1650302322726,CSE 8A,A50,083650,Miranda; Gregory Joseph,0,25,40,40
1650302328749,CSE 11,A01,083080,Cao; Yingjun,0,81,40,40
1650302334774,CSE 12,A01,083652,Staff,0,10,100,100
1650302340796,CSE 15L,A01,083654,Staff,0,1,50,50
1650302340796,CSE 15L,A02,083655,Staff,4,0,50,46
1650302346819,CSE 20,A01,083657,Staff,53,0,80,27
1650302352843,CSE 30,A01,083084,Eldon; John,0,74,40,40
1650302358869,CSE 100,A01,083659,Cao; Yingjun,0,65,50,50
1650302364903,CSE 134B,A01,083661,Powell; Thomas Allan,0,29,65,65
1650302370926,CSE 140,A01,083663,Staff,0,0,75,75
1650302376950,CSE 140L,A01,083088,Eldon; John,0,6,75,75
1650302382981,CSE 175,A01,083665,Kumar; Rakesh,8,0,25,17
1650302389103,CSE 190,A00,092507,Dubnov; Shlomo,14,0,20,6
1650302395126,ECE 45,A01,083139,Staff,0,16,40,40
1650302401165,ECE 65,A50,083695,Staff,0,4,30,30
1650302407187,ECE 109,A01,091882,Touri; Behrouz,43,0,70,27
1650302413217,ECE 180,A00,083140,Abi Samra; Nicholas Camill,23,0,30,7
1650302413217,ECE 180,B00,083141,Abi Samra; Nicholas Camill,6,0,30,24
1650302419244,MATH 10A,A01,083735,Patchell; Gregory David,10,0,30,20
1650302419244,MATH 10A,A02,083736,Patchell; Gregory David,28,0,30,2
1650302419244,MATH 10A,A03,083737,Patchell; Gregory David,26,0,30,4
1650302425269,MATH 10B,A01,083207,Staff,0,6,30,30
1650302425269,MATH 10B,A02,083208,Staff,0,6,30,30
1650302425269,MATH 10B,B01,083739,Staff,17,0,30,13
1650302425269,MATH 10B,B02,083740,Staff,29,0,30,1
1650302431294,MATH 18,A01,083743,Staff,6,0,30,24
1650302431294,MATH 18,A02,083744,Staff,26,0,30,4
1650302431294,MATH 18,A03,083745,Staff,22,0,30,8
1650302431294,MATH 18,A04,083746,Staff,27,0,30,3
1650302431294,MATH 18,B01,083748,Staff,0,11,30,30
1650302431294,MATH 18,B02,083749,Staff,0,10,30,30
1650302431294,MATH 18,B03,083750,Staff,1,9,30,29
1650302431294,MATH 18,B04,083751,Staff,0,10,30,30
1650302437320,MATH 20A,A01,083754,Staff,25,0,40,15
1650302443346,MATH 20B,A01,083756,Staff,0,5,30,30
1650302443346,MATH 20B,A02,083757,Staff,0,7,30,30
1650302449370,MATH 20C,A01,083760,Staff,0,13,30,30
1650302449370,MATH 20C,A02,083761,Staff,0,13,30,30
1650302449370,MATH 20C,B01,083762,Staff,13,0,30,17
1650302449370,MATH 20C,B02,083763,Staff,28,0,30,2
1650302455399,MATH 20D,A01,083765,Staff,0,1,30,30
1650302455399,MATH 20D,A02,083766,Staff,8,0,30,22
1650302455399,MATH 20D,A03,083767,Staff,27,0,30,3
1650302461431,MATH 20E,A01,083771,Staff,5,0,30,25
1650302461431,MATH 20E,A02,083772,Staff,20,0,30,10
1650302461431,MATH 20E,B01,083773,Staff,0,0,30,30
1650302461431,MATH 20E,B02,083774,Staff,11,0,30,19
1650302467459,MATH 103A,A01,083777,Staff,0,11,30,30
1650302467459,MATH 103A,A02,083778,Staff,0,10,30,30
1650302467459,MATH 103A,B01,083779,Staff,0,10,30,30
1650302467459,MATH 103A,B02,083780,Staff,0,10,30,30
1650302473481,MATH 105,A01,085443,Staff,0,17,30,30
1650302479508,MATH 109,A01,083213,Anzaldo; Leesa B,0,5,30,30
1650302479508,MATH 109,A02,083214,Anzaldo; Leesa B,0,6,30,30
1650302479508,MATH 109,B01,083215,Anzaldo; Leesa B,0,4,30,30
1650302479508,MATH 109,B02,083216,Anzaldo; Leesa B,0,4,30,30
1650302485535,MATH 142A,A01,083219,Chow; Bennett,0,12,30,30
1650302485535,MATH 142A,A02,083220,Chow; Bennett,0,11,30,30
1650302485535,MATH 142A,B01,083221,Chow; Bennett,0,11,30,30
1650302485535,MATH 142A,B02,083222,Chow; Bennett,0,12,30,30
1650302491565,MATH 193A,A01,083224,Staff,0,5,30,30
1650302491565,MATH 193A,A02,083225,Staff,0,5,30,30
1650302491565,MATH 193A,A03,083781,Staff,0,2,30,30
1650302491565,MATH 193A,A04,083782,Staff,0,1,30,30
1650302497588,MATH 197,001,091859,McAuley; Julian John,9998,0,9999,1
1650302503642,COGS 9,A01,083615,Staff,0,15,60,60
1650302509673,COGS 11,A01,083617,Boyle; Mary E. T.,23,0,40,17
1650302515710,COGS 13,A01,083071,Staff,0,31,40,40
1650302521735,COGS 14A,A01,092681,Staff,0,17,100,100
1650302527763,COGS 14B,A01,083073,Cheng; Tzu-Han,0,9,50,50
1650302533797,COGS 17,A01,092677,Staff,26,0,75,49
1650302539820,COGS 100,A01,083619,Staff,0,23,60,60
1650302545850,COGS 101A,A01,083621,Davis; Joshua Daniel,0,22,60,60
1650302551874,COGS 101B,A01,091572,Staff,4,0,60,56
1650302557899,COGS 101C,A01,083625,Delgado; Tania,19,0,30,11
1650302563922,COGS 107A,A01,083627,Boyle; Mary E. T.,0,8,60,60
1650302569948,COGS 118A,A01,083075,Staff,9,0,60,51
1650302575979,CSE 3,A50,083646,Miranda; Gregory Joseph,21,0,38,17
1650302575979,CSE 3,A51,083647,Miranda; Gregory Joseph,37,0,37,0
1650302582003,CSE 8A,A50,083650,Miranda; Gregory Joseph,0,25,40,40
1650302588030,CSE 11,A01,083080,Cao; Yingjun,0,81,40,40
1650302594054,CSE 12,A01,083652,Staff,0,10,100,100
1650302600093,CSE 15L,A01,083654,Staff,0,1,50,50
1650302600093,CSE 15L,A02,083655,Staff,4,0,50,46
1650302606119,CSE 20,A01,083657,Staff,53,0,80,27
1650302612142,CSE 30,A01,083084,Eldon; John,0,74,40,40
1650302618164,CSE 100,A01,083659,Cao; Yingjun,0,65,50,50
1650302624199,CSE 134B,A01,083661,Powell; Thomas Allan,0,29,65,65
1650302630224,CSE 140,A01,083663,Staff,0,0,75,75
1650302636251,CSE 140L,A01,083088,Eldon; John,0,6,75,75
1650302642277,CSE 175,A01,083665,Kumar; Rakesh,8,0,25,17
1650302648301,CSE 190,A00,092507,Dubnov; Shlomo,14,0,20,6
1650302654329,ECE 45,A01,083139,Staff,0,16,40,40
1650302660353,ECE 65,A50,083695,Staff,0,4,30,30
1650302666384,ECE 109,A01,091882,Touri; Behrouz,43,0,70,27
1650302672407,ECE 180,A00,083140,Abi Samra; Nicholas Camill,23,0,30,7
1650302672407,ECE 180,B00,083141,Abi Samra; Nicholas Camill,6,0,30,24
1650302678447,MATH 10A,A01,083735,Patchell; Gregory David,10,0,30,20
1650302678447,MATH 10A,A02,083736,Patchell; Gregory David,28,0,30,2
1650302678447,MATH 10A,A03,083737,Patchell; Gregory David,26,0,30,4
1650302684470,MATH 10B,A01,083207,Staff,0,6,30,30
1650302684470,MATH 10B,A02,083208,Staff,0,6,30,30
1650302684470,MATH 10B,B01,083739,Staff,17,0,30,13
1650302684470,MATH 10B,B02,083740,Staff,29,0,30,1
1650302690493,MATH 18,A01,083743,Staff,6,0,30,24
1650302690493,MATH 18,A02,083744,Staff,26,0,30,4
1650302690493,MATH 18,A03,083745,Staff,22,0,30,8
1650302690493,MATH 18,A04,083746,Staff,27,0,30,3
1650302690493,MATH 18,B01,083748,Staff,0,11,30,30
1650302690493,MATH 18,B02,083749,Staff,0,10,30,30
1650302690493,MATH 18,B03,083750,Staff,1,9,30,29
1650302690493,MATH 18,B04,083751,Staff,0,10,30,30
1650302696522,MATH 20A,A01,083754,Staff,25,0,40,15
1650302702543,MATH 20B,A01,083756,Staff,0,5,30,30
1650302702543,MATH 20B,A02,083757,Staff,0,7,30,30
1650302708566,MATH 20C,A01,083760,Staff,0,13,30,30
1650302708566,MATH 20C,A02,083761,Staff,0,13,30,30
1650302708566,MATH 20C,B01,083762,Staff,13,0,30,17
1650302708566,MATH 20C,B02,083763,Staff,28,0,30,2
1650302714594,MATH 20D,A01,083765,Staff,0,1,30,30
1650302714594,MATH 20D,A02,083766,Staff,8,0,30,22
1650302714594,MATH 20D,A03,083767,Staff,27,0,30,3
1650302720623,MATH 20E,A01,083771,Staff,5,0,30,25
1650302720623,MATH 20E,A02,083772,Staff,20,0,30,10
1650302720623,MATH 20E,B01,083773,Staff,0,0,30,30
1650302720623,MATH 20E,B02,083774,Staff,11,0,30,19
1650302726651,MATH 103A,A01,083777,Staff,0,11,30,30
1650302726651,MATH 103A,A02,083778,Staff,0,10,30,30
1650302726651,MATH 103A,B01,083779,Staff,0,10,30,30
1650302726651,MATH 103A,B02,083780,Staff,0,10,30,30
1650302732681,MATH 105,A01,085443,Staff,0,17,30,30
1650302738709,MATH 109,A01,083213,Anzaldo; Leesa B,0,5,30,30
1650302738709,MATH 109,A02,083214,Anzaldo; Leesa B,0,6,30,30
1650302738709,MATH 109,B01,083215,Anzaldo; Leesa B,0,4,30,30
1650302738709,MATH 109,B02,083216,Anzaldo; Leesa B,0,4,30,30
1650302744736,MATH 142A,A01,083219,Chow; Bennett,0,12,30,30
1650302744736,MATH 142A,A02,083220,Chow; Bennett,0,11,30,30
1650302744736,MATH 142A,B01,083221,Chow; Bennett,0,11,30,30
1650302744736,MATH 142A,B02,083222,Chow; Bennett,0,12,30,30
1650302750760,MATH 193A,A01,083224,Staff,0,5,30,30
1650302750760,MATH 193A,A02,083225,Staff,0,5,30,30
1650302750760,MATH 193A,A03,083781,Staff,0,2,30,30
1650302750760,MATH 193A,A04,083782,Staff,0,1,30,30
1650302756792,MATH 197,001,091859,McAuley; Julian John,9998,0,9999,1
1650302762841,COGS 9,A01,083615,Staff,0,15,60,60
1650302768871,COGS 11,A01,083617,Boyle; Mary E. T.,23,0,40,17
1650302774901,COGS 13,A01,083071,Staff,0,31,40,40
1650302780924,COGS 14A,A01,092681,Staff,0,17,100,100
1650302786949,COGS 14B,A01,083073,Cheng; Tzu-Han,0,9,50,50
1650302792978,COGS 17,A01,092677,Staff,26,0,75,49
1650302799009,COGS 100,A01,083619,Staff,0,23,60,60
1650302805033,COGS 101A,A01,083621,Davis; Joshua Daniel,0,22,60,60
1650302811063,COGS 101B,A01,091572,Staff,4,0,60,56
1650302817088,COGS 101C,A01,083625,Delgado; Tania,19,0,30,11
1650302823121,COGS 107A,A01,083627,Boyle; Mary E. T.,0,8,60,60
1650302829150,COGS 118A,A01,083075,Staff,9,0,60,51
1650302835174,CSE 3,A50,083646,Miranda; Gregory Joseph,21,0,38,17
1650302835174,CSE 3,A51,083647,Miranda; Gregory Joseph,37,0,37,0
1650302841198,CSE 8A,A50,083650,Miranda; Gregory Joseph,0,25,40,40
1650302847224,CSE 11,A01,083080,Cao; Yingjun,0,81,40,40
1650302853250,CSE 12,A01,083652,Staff,0,10,100,100
1650302859274,CSE 15L,A01,083654,Staff,0,1,50,50
1650302859274,CSE 15L,A02,083655,Staff,4,0,50,46
1650302865301,CSE 20,A01,083657,Staff,53,0,80,27
1650302871334,CSE 30,A01,083084,Eldon; John,0,74,40,40
1650302877362,CSE 100,A01,083659,Cao; Yingjun,0,65,50,50
1650302883389,CSE 134B,A01,083661,Powell; Thomas Allan,0,29,65,65
1650302889412,CSE 140,A01,083663,Staff,0,0,75,75
1650302895435,CSE 140L,A01,083088,Eldon; John,0,6,75,75
1650302901465,CSE 175,A01,083665,Kumar; Rakesh,8,0,25,17
1650302907487,CSE 190,A00,092507,Dubnov; Shlomo,14,0,20,6
1650302913510,ECE 45,A01,083139,Staff,0,16,40,40
1650302919536,ECE 65,A50,083695,Staff,0,4,30,30
1650302925559,ECE 109,A01,091882,Touri; Behrouz,43,0,70,27
1650302931593,ECE 180,A00,083140,Abi Samra; Nicholas Camill,23,0,30,7
1650302931593,ECE 180,B00,083141,Abi Samra; Nicholas Camill,6,0,30,24
1650302937616,MATH 10A,A01,083735,Patchell; Gregory David,10,0,30,20
1650302937616,MATH 10A,A02,083736,Patchell; Gregory David,28,0,30,2
1650302937616,MATH 10A,A03,083737,Patchell; Gregory David,26,0,30,4
1650302943659,MATH 10B,A01,083207,Staff,0,6,30,30
1650302943659,MATH 10B,A02,083208,Staff,0,6,30,30
1650302943659,MATH 10B,B01,083739,Staff,17,0,30,13
1650302943659,MATH 10B,B02,083740,Staff,29,0,30,1
1650302949698,MATH 18,A01,083743,Staff,6,0,30,24
1650302949698,MATH 18,A02,083744,Staff,26,0,30,4
1650302949698,MATH 18,A03,083745,Staff,22,0,30,8
1650302949698,MATH 18,A04,083746,Staff,27,0,30,3
1650302949698,MATH 18,B01,083748,Staff,0,11,30,30
1650302949698,MATH 18,B02,083749,Staff,0,10,30,30
1650302949698,MATH 18,B03,083750,Staff,1,9,30,29
1650302949698,MATH 18,B04,083751,Staff,0,10,30,30
1650302955723,MATH 20A,A01,083754,Staff,25,0,40,15
1650302961760,MATH 20B,A01,083756,Staff,0,5,30,30
1650302961760,MATH 20B,A02,083757,Staff,0,7,30,30
1650302967788,MATH 20C,A01,083760,Staff,0,13,30,30
1650302967788,MATH 20C,A02,083761,Staff,0,13,30,30
1650302967788,MATH 20C,B01,083762,Staff,13,0,30,17
1650302967788,MATH 20C,B02,083763,Staff,28,0,30,2
1650302973811,MATH 20D,A01,083765,Staff,0,1,30,30
1650302973811,MATH 20D,A02,083766,Staff,8,0,30,22
1650302973811,MATH 20D,A03,083767,Staff,27,0,30,3
1650302979834,MATH 20E,A01,083771,Staff,5,0,30,25
1650302979834,MATH 20E,A02,083772,Staff,20,0,30,10
1650302979834,MATH 20E,B01,083773,Staff,0,0,30,30
1650302979834,MATH 20E,B02,083774,Staff,11,0,30,19
1650302985940,MATH 103A,A01,083777,Staff,0,11,30,30
1650302985940,MATH 103A,A02,083778,Staff,0,10,30,30
1650302985940,MATH 103A,B01,083779,Staff,0,10,30,30
1650302985940,MATH 103A,B02,083780,Staff,0,10,30,30
1650302991983,MATH 105,A01,085443,Staff,0,17,30,30
1650302998007,MATH 109,A01,083213,Anzaldo; Leesa B,0,5,30,30
1650302998007,MATH 109,A02,083214,Anzaldo; Leesa B,0,6,30,30
1650302998007,MATH 109,B01,083215,Anzaldo; Leesa B,0,4,30,30
1650302998007,MATH 109,B02,083216,Anzaldo; Leesa B,0,4,30,30
1650303004034,MATH 142A,A01,083219,Chow; Bennett,0,12,30,30
1650303004034,MATH 142A,A02,083220,Chow; Bennett,0,11,30,30
1650303004034,MATH 142A,B01,083221,Chow; Bennett,0,11,30,30
1650303004034,MATH 142A,B02,083222,Chow; Bennett,0,12,30,30
1650303010060,MATH 193A,A01,083224,Staff,0,5,30,30
1650303010060,MATH 193A,A02,083225,Staff,0,5,30,30
1650303010060,MATH 193A,A03,083781,Staff,0,2,30,30
1650303010060,MATH 193A,A04,083782,Staff,0,1,30,30
1650303016100,MATH 197,001,091859,McAuley; Julian John,9998,0,9999,1
1650303022177,COGS 9,A01,083615,Staff,0,15,60,60
1650303028206,COGS 11,A01,083617,Boyle; Mary E. T.,23,0,40,17
1650303034233,COGS 13,A01,083071,Staff,0,31,40,40
1650303040260,COGS 14A,A01,092681,Staff,0,17,100,100
1650303046283,COGS 14B,A01,083073,Cheng; Tzu-Han,0,9,50,50
1650303052322,COGS 17,A01,092677,Staff,26,0,75,49
1650303058350,COGS 100,A01,083619,Staff,0,23,60,60
1650303064378,COGS 101A,A01,083621,Davis; Joshua Daniel,0,22,60,60
1650303070405,COGS 101B,A01,091572,Staff,4,0,60,56
1650303076438,COGS 101C,A01,083625,Delgado; Tania,19,0,30,11
1650303082477,COGS 107A,A01,083627,Boyle; Mary E. T.,0,8,60,60
1650303088502,COGS 118A,A01,083075,Staff,9,0,60,51
1650303094525,CSE 3,A50,083646,Miranda; Gregory Joseph,21,0,38,17
1650303094525,CSE 3,A51,083647,Miranda; Gregory Joseph,37,0,37,0
1650303100557,CSE 8A,A50,083650,Miranda; Gregory Joseph,0,25,40,40
1650303106592,CSE 11,A01,083080,Cao; Yingjun,0,82,40,40
1650303112617,CSE 12,A01,083652,Staff,0,10,100,100
1650303118639,CSE 15L,A01,083654,Staff,0,1,50,50
1650303118639,CSE 15L,A02,083655,Staff,4,0,50,46
1650303124664,CSE 20,A01,083657,Staff,53,0,80,27
1650303130691,CSE 30,A01,083084,Eldon; John,0,74,40,40
1650303136714,CSE 100,A01,083659,Cao; Yingjun,0,65,50,50
1650303142738,CSE 134B,A01,083661,Powell; Thomas Allan,0,29,65,65
1650303148763,CSE 140,A01,083663,Staff,0,0,75,75
1650303154796,CSE 140L,A01,083088,Eldon; John,0,6,75,75
1650303160825,CSE 175,A01,083665,Kumar; Rakesh,8,0,25,17
1650303166857,CSE 190,A00,092507,Dubnov; Shlomo,14,0,20,6
1650303172884,ECE 45,A01,083139,Staff,0,16,40,40
1650303178908,ECE 65,A50,083695,Staff,0,4,30,30
1650303184947,ECE 109,A01,091882,Touri; Behrouz,43,0,70,27
1650303190973,ECE 180,A00,083140,Abi Samra; Nicholas Camill,23,0,30,7
1650303190973,ECE 180,B00,083141,Abi Samra; Nicholas Camill,6,0,30,24
1650303197000,MATH 10A,A01,083735,Patchell; Gregory David,10,0,30,20
1650303197000,MATH 10A,A02,083736,Patchell; Gregory David,28,0,30,2
1650303197000,MATH 10A,A03,083737,Patchell; Gregory David,26,0,30,4
1650303203025,MATH 10B,A01,083207,Staff,0,6,30,30
1650303203025,MATH 10B,A02,083208,Staff,0,6,30,30
1650303203025,MATH 10B,B01,083739,Staff,17,0,30,13
1650303203025,MATH 10B,B02,083740,Staff,29,0,30,1
1650303209050,MATH 18,A01,083743,Staff,6,0,30,24
1650303209050,MATH 18,A02,083744,Staff,26,0,30,4
1650303209050,MATH 18,A03,083745,Staff,22,0,30,8
1650303209050,MATH 18,A04,083746,Staff,27,0,30,3
1650303209050,MATH 18,B01,083748,Staff,0,11,30,30
1650303209050,MATH 18,B02,083749,Staff,0,10,30,30
1650303209050,MATH 18,B03,083750,Staff,1,9,30,29
1650303209050,MATH 18,B04,083751,Staff,0,10,30,30
1650303215082,MATH 20A,A01,083754,Staff,25,0,40,15
1650303221105,MATH 20B,A01,083756,Staff,0,5,30,30
1650303221105,MATH 20B,A02,083757,Staff,0,7,30,30
1650303227148,MATH 20C,A01,083760,Staff,0,13,30,30
1650303227148,MATH 20C,A02,083761,Staff,0,13,30,30
1650303227148,MATH 20C,B01,083762,Staff,13,0,30,17
1650303227148,MATH 20C,B02,083763,Staff,28,0,30,2
1650303233180,MATH 20D,A01,083765,Staff,0,1,30,30
1650303233180,MATH 20D,A02,083766,Staff,8,0,30,22
1650303233180,MATH 20D,A03,083767,Staff,27,0,30,3
1650303239205,MATH 20E,A01,083771,Staff,6,0,30,24
1650303239205,MATH 20E,A02,083772,Staff,20,0,30,10
1650303239205,MATH 20E,B01,083773,Staff,0,0,30,30
1650303239205,MATH 20E,B02,083774,Staff,11,0,30,19
1650303245230,MATH 103A,A01,083777,Staff,0,11,30,30
1650303245230,MATH 103A,A02,083778,Staff,0,10,30,30
1650303245230,MATH 103A,B01,083779,Staff,0,10,30,30
1650303245230,MATH 103A,B02,083780,Staff,0,10,30,30
1650303251255,MATH 105,A01,085443,Staff,0,17,30,30
1650303257290,MATH 109,A01,083213,Anzaldo; Leesa B,0,5,30,30
1650303257290,MATH 109,A02,083214,Anzaldo; Leesa B,0,6,30,30
1650303257290,MATH 109,B01,083215,Anzaldo; Leesa B,0,4,30,30
1650303257290,MATH 109,B02,083216,Anzaldo; Leesa B,0,4,30,30
1650303263318,MATH 142A,A01,083219,Chow; Bennett,0,12,30,30
1650303263318,MATH 142A,A02,083220,Chow; Bennett,0,11,30,30
1650303263318,MATH 142A,B01,083221,Chow; Bennett,0,11,30,30
1650303263318,MATH 142A,B02,083222,Chow; Bennett,0,12,30,30
1650303269348,MATH 193A,A01,083224,Staff,0,5,30,30
1650303269348,MATH 193A,A02,083225,Staff,0,5,30,30
1650303269348,MATH 193A,A03,083781,Staff,0,2,30,30
1650303269348,MATH 193A,A04,083782,Staff,0,1,30,30
1650303275371,MATH 197,001,091859,McAuley; Julian John,9998,0,9999,1
1650303281431,COGS 9,A01,083615,Staff,0,15,60,60
1650303287465,COGS 11,A01,083617,Boyle; Mary E. T.,23,0,40,17
1650303293492,COGS 13,A01,083071,Staff,0,31,40,40
1650303299521,COGS 14A,A01,092681,Staff,0,17,100,100
1650303305553,COGS 14B,A01,083073,Cheng; Tzu-Han,0,9,50,50
1650303311591,COGS 17,A01,092677,Staff,26,0,75,49
1650303317613,COGS 100,A01,083619,Staff,0,23,60,60
1650303323680,COGS 101A,A01,083621,Davis; Joshua Daniel,0,22,60,60
1650303329706,COGS 101B,A01,091572,Staff,4,0,60,56
1650303335729,COGS 101C,A01,083625,Delgado; Tania,19,0,30,11
1650303341753,COGS 107A,A01,083627,Boyle; Mary E. T.,0,8,60,60
1650303347776,COGS 118A,A01,083075,Staff,8,0,60,52
1650303353800,CSE 3,A50,083646,Miranda; Gregory Joseph,21,0,38,17
1650303353800,CSE 3,A51,083647,Miranda; Gregory Joseph,37,0,37,0
1650303359826,CSE 8A,A50,083650,Miranda; Gregory Joseph,0,25,40,40
1650303365863,CSE 11,A01,083080,Cao; Yingjun,0,82,40,40
1650303371888,CSE 12,A01,083652,Staff,0,10,100,100
1650303377921,CSE 15L,A01,083654,Staff,0,1,50,50
1650303377921,CSE 15L,A02,083655,Staff,4,0,50,46
1650303383945,CSE 20,A01,083657,Staff,53,0,80,27
1650303389969,CSE 30,A01,083084,Eldon; John,0,74,40,40
1650303395994,CSE 100,A01,083659,Cao; Yingjun,0,65,50,50
1650303402021,CSE 134B,A01,083661,Powell; Thomas Allan,0,29,65,65
1650303408046,CSE 140,A01,083663,Staff,0,0,75,75
1650303414075,CSE 140L,A01,083088,Eldon; John,0,6,75,75
1650303420103,CSE 175,A01,083665,Kumar; Rakesh,8,0,25,17
1650303426137,CSE 190,A00,092507,Dubnov; Shlomo,14,0,20,6
1650303432165,ECE 45,A01,083139,Staff,0,16,40,40
1650303438190,ECE 65,A50,083695,Staff,0,4,30,30
1650303444217,ECE 109,A01,091882,Touri; Behrouz,43,0,70,27
1650303450248,ECE 180,A00,083140,Abi Samra; Nicholas Camill,23,0,30,7
1650303450248,ECE 180,B00,083141,Abi Samra; Nicholas Camill,6,0,30,24
1650303456274,MATH 10A,A01,083735,Patchell; Gregory David,10,0,30,20
1650303456274,MATH 10A,A02,083736,Patchell; Gregory David,28,0,30,2
1650303456274,MATH 10A,A03,083737,Patchell; Gregory David,26,0,30,4
1650303462297,MATH 10B,A01,083207,Staff,0,6,30,30
1650303462297,MATH 10B,A02,083208,Staff,0,6,30,30
1650303462297,MATH 10B,B01,083739,Staff,17,0,30,13
1650303462297,MATH 10B,B02,083740,Staff,29,0,30,1
1650303468324,MATH 18,A01,083743,Staff,6,0,30,24
1650303468324,MATH 18,A02,083744,Staff,26,0,30,4
1650303468324,MATH 18,A03,083745,Staff,22,0,30,8
1650303468324,MATH 18,A04,083746,Staff,27,0,30,3
1650303468324,MATH 18,B01,083748,Staff,0,11,30,30
1650303468324,MATH 18,B02,083749,Staff,0,10,30,30
1650303468324,MATH 18,B03,083750,Staff,1,9,30,29
1650303468324,MATH 18,B04,083751,Staff,0,10,30,30
1650303474352,MATH 20A,A01,083754,Staff,25,0,40,15
1650303480391,MATH 20B,A01,083756,Staff,0,5,30,30
1650303480391,MATH 20B,A02,083757,Staff,0,7,30,30
1650303486417,MATH 20C,A01,083760,Staff,0,13,30,30
1650303486417,MATH 20C,A02,083761,Staff,0,13,30,30
1650303486417,MATH 20C,B01,083762,Staff,13,0,30,17
1650303486417,MATH 20C,B02,083763,Staff,28,0,30,2
1650303492444,MATH 20D,A01,083765,Staff,0,1,30,30
1650303492444,MATH 20D,A02,083766,Staff,8,0,30,22
1650303492444,MATH 20D,A03,083767,Staff,27,0,30,3
1650303498471,MATH 20E,A01,083771,Staff,6,0,30,24
1650303498471,MATH 20E,A02,083772,Staff,20,0,30,10
1650303498471,MATH 20E,B01,083773,Staff,0,0,30,30
1650303498471,MATH 20E,B02,083774,Staff,11,0,30,19
1650303504499,MATH 103A,A01,083777,Staff,0,11,30,30
1650303504499,MATH 103A,A02,083778,Staff,0,10,30,30
1650303504499,MATH 103A,B01,083779,Staff,0,10,30,30
1650303504499,MATH 103A,B02,083780,Staff,0,10,30,30
1650303510526,MATH 105,A01,085443,Staff,0,17,30,30
1650303516558,MATH 109,A01,083213,Anzaldo; Leesa B,0,5,30,30
1650303516558,MATH 109,A02,083214,Anzaldo; Leesa B,0,6,30,30
1650303516558,MATH 109,B01,083215,Anzaldo; Leesa B,0,4,30,30
1650303516558,MATH 109,B02,083216,Anzaldo; Leesa B,0,4,30,30
1650303522581,MATH 142A,A01,083219,Chow; Bennett,0,12,30,30
1650303522581,MATH 142A,A02,083220,Chow; Bennett,0,11,30,30
1650303522581,MATH 142A,B01,083221,Chow; Bennett,0,11,30,30
1650303522581,MATH 142A,B02,083222,Chow; Bennett,0,12,30,30
1650303528608,MATH 193A,A01,083224,Staff,0,5,30,30
1650303528608,MATH 193A,A02,083225,Staff,0,5,30,30
1650303528608,MATH 193A,A03,083781,Staff,0,2,30,30
1650303528608,MATH 193A,A04,083782,Staff,0,1,30,30
1650303534634,MATH 197,001,091859,McAuley; Julian John,9998,0,9999,1
1650303540706,COGS 9,A01,083615,Staff,0,15,60,60
1650303546744,COGS 11,A01,083617,Boyle; Mary E. T.,23,0,40,17
1650303552779,COGS 13,A01,083071,Staff,0,31,40,40
1650303558807,COGS 14A,A01,092681,Staff,0,17,100,100
1650303564830,COGS 14B,A01,083073,Cheng; Tzu-Han,0,9,50,50
1650303570858,COGS 17,A01,092677,Staff,26,0,75,49
1650303576991,COGS 100,A01,083619,Staff,0,23,60,60
1650303583017,COGS 101A,A01,083621,Davis; Joshua Daniel,0,22,60,60
1650303589048,COGS 101B,A01,091572,Staff,4,0,60,56
1650303595081,COGS 101C,A01,083625,Delgado; Tania,19,0,30,11
1650303601113,COGS 107A,A01,083627,Boyle; Mary E. T.,0,8,60,60
1650303607163,COGS 118A,A01,083075,Staff,8,0,60,52
1650303613191,CSE 3,A50,083646,Miranda; Gregory Joseph,21,0,38,17
1650303613191,CSE 3,A51,083647,Miranda; Gregory Joseph,37,0,37,0
1650303619229,CSE 8A,A50,083650,Miranda; Gregory Joseph,0,25,40,40
1650303625258,CSE 11,A01,083080,Cao; Yingjun,0,82,40,40
1650303631282,CSE 12,A01,083652,Staff,0,10,100,100
1650303637305,CSE 15L,A01,083654,Staff,0,1,50,50
1650303637305,CSE 15L,A02,083655,Staff,4,0,50,46
1650303643332,CSE 20,A01,083657,Staff,53,0,80,27
1650303649359,CSE 30,A01,083084,Eldon; John,0,74,40,40
1650303655394,CSE 100,A01,083659,Cao; Yingjun,0,65,50,50
1650303661428,CSE 134B,A01,083661,Powell; Thomas Allan,0,29,65,65
1650303667453,CSE 140,A01,083663,Staff,0,0,75,75
1650303673485,CSE 140L,A01,083088,Eldon; John,0,6,75,75
1650303679521,CSE 175,A01,083665,Kumar; Rakesh,8,0,25,17
1650303685559,CSE 190,A00,092507,Dubnov; Shlomo,14,0,20,6
1650303691590,ECE 45,A01,083139,Staff,0,16,40,40
1650303697613,ECE 65,A50,083695,Staff,0,4,30,30
1650303703638,ECE 109,A01,091882,Touri; Behrouz,42,0,70,28
1650303709661,ECE 180,A00,083140,Abi Samra; Nicholas Camill,23,0,30,7
1650303709661,ECE 180,B00,083141,Abi Samra; Nicholas Camill,6,0,30,24
1650303715684,MATH 10A,A01,083735,Patchell; Gregory David,10,0,30,20
1650303715684,MATH 10A,A02,083736,Patchell; Gregory David,28,0,30,2
1650303715684,MATH 10A,A03,083737,Patchell; Gregory David,26,0,30,4
1650303721712,MATH 10B,A01,083207,Staff,0,6,30,30
1650303721712,MATH 10B,A02,083208,Staff,0,6,30,30
1650303721712,MATH 10B,B01,083739,Staff,17,0,30,13
1650303721712,MATH 10B,B02,083740,Staff,29,0,30,1
1650303727745,MATH 18,A01,083743,Staff,6,0,30,24
1650303727745,MATH 18,A02,083744,Staff,26,0,30,4
1650303727745,MATH 18,A03,083745,Staff,22,0,30,8
1650303727745,MATH 18,A04,083746,Staff,27,0,30,3
1650303727745,MATH 18,B01,083748,Staff,0,11,30,30
1650303727745,MATH 18,B02,083749,Staff,0,10,30,30
1650303727745,MATH 18,B03,083750,Staff,1,9,30,29
1650303727745,MATH 18,B04,083751,Staff,0,10,30,30
1650303733778,MATH 20A,A01,083754,Staff,25,0,40,15
1650303739803,MATH 20B,A01,083756,Staff,0,5,30,30
1650303739803,MATH 20B,A02,083757,Staff,0,7,30,30
1650303745830,MATH 20C,A01,083760,Staff,0,13,30,30
1650303745830,MATH 20C,A02,083761,Staff,0,13,30,30
1650303745830,MATH 20C,B01,083762,Staff,13,0,30,17
1650303745830,MATH 20C,B02,083763,Staff,28,0,30,2
1650303751857,MATH 20D,A01,083765,Staff,0,1,30,30
1650303751857,MATH 20D,A02,083766,Staff,8,0,30,22
1650303751857,MATH 20D,A03,083767,Staff,27,0,30,3
1650303757881,MATH 20E,A01,083771,Staff,6,0,30,24
1650303757881,MATH 20E,A02,083772,Staff,20,0,30,10
1650303757881,MATH 20E,B01,083773,Staff,0,0,30,30
1650303757881,MATH 20E,B02,083774,Staff,11,0,30,19
1650303763906,MATH 103A,A01,083777,Staff,0,11,30,30
1650303763906,MATH 103A,A02,083778,Staff,0,10,30,30
1650303763906,MATH 103A,B01,083779,Staff,0,10,30,30
1650303763906,MATH 103A,B02,083780,Staff,0,10,30,30
1650303769933,MATH 105,A01,085443,Staff,0,17,30,30
1650303775966,MATH 109,A01,083213,Anzaldo; Leesa B,0,5,30,30
1650303775966,MATH 109,A02,083214,Anzaldo; Leesa B,0,6,30,30
1650303775966,MATH 109,B01,083215,Anzaldo; Leesa B,0,4,30,30
1650303775966,MATH 109,B02,083216,Anzaldo; Leesa B,0,4,30,30
1650303781994,MATH 142A,A01,083219,Chow; Bennett,0,12,30,30
1650303781994,MATH 142A,A02,083220,Chow; Bennett,0,11,30,30
1650303781994,MATH 142A,B01,083221,Chow; Bennett,0,11,30,30
1650303781994,MATH 142A,B02,083222,Chow; Bennett,0,12,30,30
1650303788031,MATH 193A,A01,083224,Staff,0,5,30,30
1650303788031,MATH 193A,A02,083225,Staff,0,5,30,30
1650303788031,MATH 193A,A03,083781,Staff,0,2,30,30
1650303788031,MATH 193A,A04,083782,Staff,0,1,30,30
1650303794063,MATH 197,001,091859,McAuley; Julian John,9998,0,9999,1
1650303800128,COGS 9,A01,083615,Staff,0,15,60,60
1650303806156,COGS 11,A01,083617,Boyle; Mary E. T.,23,0,40,17
1650303812192,COGS 13,A01,083071,Staff,0,31,40,40
1650303818216,COGS 14A,A01,092681,Staff,0,17,100,100
1650303824243,COGS 14B,A01,083073,Cheng; Tzu-Han,0,9,50,50
1650303830280,COGS 17,A01,092677,Staff,26,0,75,49
1650303836303,COGS 100,A01,083619,Staff,0,23,60,60
1650303842341,COGS 101A,A01,083621,Davis; Joshua Daniel,0,22,60,60
1650303848368,COGS 101B,A01,091572,Staff,4,0,60,56
1650303854392,COGS 101C,A01,083625,Delgado; Tania,19,0,30,11
1650303860421,COGS 107A,A01,083627,Boyle; Mary E. T.,0,8,60,60
1650303866446,COGS 118A,A01,083075,Staff,8,0,60,52
1650303872476,CSE 3,A50,083646,Miranda; Gregory Joseph,21,0,38,17
1650303872476,CSE 3,A51,083647,Miranda; Gregory Joseph,37,0,37,0
1650303878503,CSE 8A,A50,083650,Miranda; Gregory Joseph,0,24,40,40
1650303884531,CSE 11,A01,083080,Cao; Yingjun,0,82,40,40
1650303890569,CSE 12,A01,083652,Staff,0,10,100,100
1650303896593,CSE 15L,A01,083654,Staff,0,1,50,50
1650303896593,CSE 15L,A02,083655,Staff,4,0,50,46
1650303902618,CSE 20,A01,083657,Staff,53,0,80,27
1650303908656,CSE 30,A01,083084,Eldon; John,0,74,40,40
1650303914685,CSE 100,A01,083659,Cao; Yingjun,0,65,50,50
1650303920712,CSE 134B,A01,083661,Powell; Thomas Allan,0,29,65,65
1650303926738,CSE 140,A01,083663,Staff,0,0,75,75
1650303932762,CSE 140L,A01,083088,Eldon; John,0,6,75,75
1650303938786,CSE 175,A01,083665,Kumar; Rakesh,8,0,25,17
1650303944823,CSE 190,A00,092507,Dubnov; Shlomo,14,0,20,6
1650303950850,ECE 45,A01,083139,Staff,0,16,40,40
1650303956874,ECE 65,A50,083695,Staff,0,4,30,30
1650303962915,ECE 109,A01,091882,Touri; Behrouz,42,0,70,28
1650303968944,ECE 180,A00,083140,Abi Samra; Nicholas Camill,23,0,30,7
1650303968944,ECE 180,B00,083141,Abi Samra; Nicholas Camill,6,0,30,24
1650303974968,MATH 10A,A01,083735,Patchell; Gregory David,10,0,30,20
1650303974968,MATH 10A,A02,083736,Patchell; Gregory David,28,0,30,2
1650303974968,MATH 10A,A03,083737,Patchell; Gregory David,26,0,30,4
1650303980997,MATH 10B,A01,083207,Staff,0,6,30,30
1650303980997,MATH 10B,A02,083208,Staff,0,6,30,30
1650303980997,MATH 10B,B01,083739,Staff,17,0,30,13
1650303980997,MATH 10B,B02,083740,Staff,29,0,30,1
1650303987037,MATH 18,A01,083743,Staff,6,0,30,24
1650303987037,MATH 18,A02,083744,Staff,26,0,30,4
1650303987037,MATH 18,A03,083745,Staff,22,0,30,8
1650303987037,MATH 18,A04,083746,Staff,27,0,30,3
1650303987037,MATH 18,B01,083748,Staff,0,11,30,30
1650303987037,MATH 18,B02,083749,Staff,0,10,30,30
1650303987037,MATH 18,B03,083750,Staff,1,9,30,29
1650303987037,MATH 18,B04,083751,Staff,0,10,30,30
1650303993060,MATH 20A,A01,083754,Staff,25,0,40,15
1650303999084,MATH 20B,A01,083756,Staff,0,5,30,30
1650303999084,MATH 20B,A02,083757,Staff,0,7,30,30
1650304005112,MATH 20C,A01,083760,Staff,0,13,30,30
1650304005112,MATH 20C,A02,083761,Staff,0,13,30,30
1650304005112,MATH 20C,B01,083762,Staff,13,0,30,17
1650304005112,MATH 20C,B02,083763,Staff,28,0,30,2
1650304011143,MATH 20D,A01,083765,Staff,0,1,30,30
1650304011143,MATH 20D,A02,083766,Staff,8,0,30,22
1650304011143,MATH 20D,A03,083767,Staff,27,0,30,3
1650304017169,MATH 20E,A01,083771,Staff,6,0,30,24
1650304017169,MATH 20E,A02,083772,Staff,20,0,30,10
1650304017169,MATH 20E,B01,083773,Staff,0,0,30,30
1650304017169,MATH 20E,B02,083774,Staff,11,0,30,19
1650304023196,MATH 103A,A01,083777,Staff,0,11,30,30
1650304023196,MATH 103A,A02,083778,Staff,0,10,30,30
1650304023196,MATH 103A,B01,083779,Staff,0,10,30,30
1650304023196,MATH 103A,B02,083780,Staff,0,10,30,30
1650304029229,MATH 105,A01,085443,Staff,0,17,30,30
1650304035271,MATH 109,A01,083213,Anzaldo; Leesa B,0,5,30,30
1650304035271,MATH 109,A02,083214,Anzaldo; Leesa B,0,6,30,30
1650304035271,MATH 109,B01,083215,Anzaldo; Leesa B,0,4,30,30
1650304035271,MATH 109,B02,083216,Anzaldo; Leesa B,0,4,30,30
1650304041304,MATH 142A,A01,083219,Chow; Bennett,0,12,30,30
1650304041304,MATH 142A,A02,083220,Chow; Bennett,0,11,30,30
1650304041304,MATH 142A,B01,083221,Chow; Bennett,0,11,30,30
1650304041304,MATH 142A,B02,083222,Chow; Bennett,0,12,30,30
1650304047329,MATH 193A,A01,083224,Staff,0,5,30,30
1650304047329,MATH 193A,A02,083225,Staff,0,5,30,30
1650304047329,MATH 193A,A03,083781,Staff,0,2,30,30
1650304047329,MATH 193A,A04,083782,Staff,0,1,30,30
1650304053351,MATH 197,001,091859,McAuley; Julian John,9998,0,9999,1
1650304059410,COGS 9,A01,083615,Staff,0,15,60,60
1650304065444,COGS 11,A01,083617,Boyle; Mary E. T.,23,0,40,17
1650304071467,COGS 13,A01,083071,Staff,0,31,40,40
1650304077492,COGS 14A,A01,092681,Staff,0,17,100,100
1650304083527,COGS 14B,A01,083073,Cheng; Tzu-Han,0,9,50,50
1650304089549,COGS 17,A01,092677,Staff,26,0,75,49
1650304095577,COGS 100,A01,083619,Staff,0,23,60,60
1650304101605,COGS 101A,A01,083621,Davis; Joshua Daniel,0,22,60,60
1650304107631,COGS 101B,A01,091572,Staff,4,0,60,56
1650304113659,COGS 101C,A01,083625,Delgado; Tania,19,0,30,11
1650304119685,COGS 107A,A01,083627,Boyle; Mary E. T.,0,8,60,60
1650304125709,COGS 118A,A01,083075,Staff,8,0,60,52
1650304131743,CSE 3,A50,083646,Miranda; Gregory Joseph,21,0,38,17
1650304131743,CSE 3,A51,083647,Miranda; Gregory Joseph,37,0,37,0
1650304137768,CSE 8A,A50,083650,Miranda; Gregory Joseph,0,24,40,40
1650304143804,CSE 11,A01,083080,Cao; Yingjun,0,82,40,40
1650304149831,CSE 12,A01,083652,Staff,0,10,100,100
1650304155853,CSE 15L,A01,083654,Staff,0,1,50,50
1650304155853,CSE 15L,A02,083655,Staff,4,0,50,46
1650304161884,CSE 20,A01,083657,Staff,53,0,80,27
1650304167908,CSE 30,A01,083084,Eldon; John,0,74,40,40
1650304174024,CSE 100,A01,083659,Cao; Yingjun,0,65,50,50
1650304180050,CSE 134B,A01,083661,Powell; Thomas Allan,0,29,65,65
1650304186090,CSE 140,A01,083663,Staff,0,0,75,75
1650304192113,CSE 140L,A01,083088,Eldon; John,0,6,75,75
1650304198152,CSE 175,A01,083665,Kumar; Rakesh,8,0,25,17
1650304204176,CSE 190,A00,092507,Dubnov; Shlomo,14,0,20,6
1650304210204,ECE 45,A01,083139,Staff,0,16,40,40
1650304216236,ECE 65,A50,083695,Staff,0,4,30,30
1650304222271,ECE 109,A01,091882,Touri; Behrouz,42,0,70,28
1650304228309,ECE 180,A00,083140,Abi Samra; Nicholas Camill,23,0,30,7
1650304228309,ECE 180,B00,083141,Abi Samra; Nicholas Camill,6,0,30,24
1650304234335,MATH 10A,A01,083735,Patchell; Gregory David,10,0,30,20
1650304234335,MATH 10A,A02,083736,Patchell; Gregory David,28,0,30,2
1650304234335,MATH 10A,A03,083737,Patchell; Gregory David,26,0,30,4
1650304240363,MATH 10B,A01,083207,Staff,0,6,30,30
1650304240363,MATH 10B,A02,083208,Staff,0,6,30,30
1650304240363,MATH 10B,B01,083739,Staff,17,0,30,13
1650304240363,MATH 10B,B02,083740,Staff,29,0,30,1
1650304246400,MATH 18,A01,083743,Staff,6,0,30,24
1650304246400,MATH 18,A02,083744,Staff,26,0,30,4
1650304246400,MATH 18,A03,083745,Staff,22,0,30,8
1650304246400,MATH 18,A04,083746,Staff,27,0,30,3
1650304246400,MATH 18,B01,083748,Staff,0,11,30,30
1650304246400,MATH 18,B02,083749,Staff,0,10,30,30
1650304246400,MATH 18,B03,083750,Staff,1,9,30,29
1650304246400,MATH 18,B04,083751,Staff,0,10,30,30
1650304252432,MATH 20A,A01,083754,Staff,25,0,40,15
1650304258456,MATH 20B,A01,083756,Staff,0,5,30,30
1650304258456,MATH 20B,A02,083757,Staff,0,7,30,30
1650304264486,MATH 20C,A01,083760,Staff,0,13,30,30
1650304264486,MATH 20C,A02,083761,Staff,0,13,30,30
1650304264486,MATH 20C,B01,083762,Staff,13,0,30,17
1650304264486,MATH 20C,B02,083763,Staff,28,0,30,2
1650304270516,MATH 20D,A01,083765,Staff,0,1,30,30
1650304270516,MATH 20D,A02,083766,Staff,8,0,30,22
1650304270516,MATH 20D,A03,083767,Staff,27,0,30,3
1650304276543,MATH 20E,A01,083771,Staff,6,0,30,24
1650304276543,MATH 20E,A02,083772,Staff,20,0,30,10
1650304276543,MATH 20E,B01,083773,Staff,0,0,30,30
1650304276543,MATH 20E,B02,083774,Staff,11,0,30,19
1650304282571,MATH 103A,A01,083777,Staff,0,11,30,30
1650304282571,MATH 103A,A02,083778,Staff,0,10,30,30
1650304282571,MATH 103A,B01,083779,Staff,0,10,30,30
1650304282571,MATH 103A,B02,083780,Staff,0,10,30,30
1650304288595,MATH 105,A01,085443,Staff,0,17,30,30
1650304294627,MATH 109,A01,083213,Anzaldo; Leesa B,0,5,30,30
1650304294627,MATH 109,A02,083214,Anzaldo; Leesa B,0,6,30,30
1650304294627,MATH 109,B01,083215,Anzaldo; Leesa B,0,4,30,30
1650304294627,MATH 109,B02,083216,Anzaldo; Leesa B,0,4,30,30
1650304300651,MATH 142A,A01,083219,Chow; Bennett,0,12,30,30
1650304300651,MATH 142A,A02,083220,Chow; Bennett,0,11,30,30
1650304300651,MATH 142A,B01,083221,Chow; Bennett,0,11,30,30
1650304300651,MATH 142A,B02,083222,Chow; Bennett,0,12,30,30
1650304306675,MATH 193A,A01,083224,Staff,0,5,30,30
1650304306675,MATH 193A,A02,083225,Staff,0,5,30,30
1650304306675,MATH 193A,A03,083781,Staff,0,2,30,30
1650304306675,MATH 193A,A04,083782,Staff,0,1,30,30
1650304312700,MATH 197,001,091859,McAuley; Julian John,9998,0,9999,1
1650304318764,COGS 9,A01,083615,Staff,0,15,60,60
1650304324793,COGS 11,A01,083617,Boyle; Mary E. T.,23,0,40,17
1650304330842,COGS 13,A01,083071,Staff,0,31,40,40
1650304336889,COGS 14A,A01,092681,Staff,0,17,100,100
1650304342923,COGS 14B,A01,083073,Cheng; Tzu-Han,0,9,50,50
1650304348954,COGS 17,A01,092677,Staff,26,0,75,49
1650304354991,COGS 100,A01,083619,Staff,0,23,60,60
1650304361017,COGS 101A,A01,083621,Davis; Joshua Daniel,0,22,60,60
1650304367043,COGS 101B,A01,091572,Staff,4,0,60,56
1650304373066,COGS 101C,A01,083625,Delgado; Tania,19,0,30,11
1650304379091,COGS 107A,A01,083627,Boyle; Mary E. T.,0,8,60,60
1650304385117,COGS 118A,A01,083075,Staff,8,0,60,52
1650304391142,CSE 3,A50,083646,Miranda; Gregory Joseph,21,0,38,17
1650304391142,CSE 3,A51,083647,Miranda; Gregory Joseph,37,0,37,0
1650304397167,CSE 8A,A50,083650,Miranda; Gregory Joseph,0,24,40,40
1650304403203,CSE 11,A01,083080,Cao; Yingjun,0,82,40,40
1650304409231,CSE 12,A01,083652,Staff,0,10,100,100
1650304415270,CSE 15L,A01,083654,Staff,0,1,50,50
1650304415270,CSE 15L,A02,083655,Staff,4,0,50,46
1650304421296,CSE 20,A01,083657,Staff,53,0,80,27
1650304427321,CSE 30,A01,083084,Eldon; John,0,74,40,40
1650304433343,CSE 100,A01,083659,Cao; Yingjun,0,65,50,50
1650304439367,CSE 134B,A01,083661,Powell; Thomas Allan,0,29,65,65
1650304445390,CSE 140,A01,083663,Staff,0,0,75,75
1650304451426,CSE 140L,A01,083088,Eldon; John,0,6,75,75
1650304457452,CSE 175,A01,083665,Kumar; Rakesh,8,0,25,17
1650304463476,CSE 190,A00,092507,Dubnov; Shlomo,14,0,20,6
1650304469510,ECE 45,A01,083139,Staff,0,16,40,40
1650304475533,ECE 65,A50,083695,Staff,0,4,30,30
1650304481557,ECE 109,A01,091882,Touri; Behrouz,42,0,70,28
1650304487585,ECE 180,A00,083140,Abi Samra; Nicholas Camill,23,0,30,7
1650304487585,ECE 180,B00,083141,Abi Samra; Nicholas Camill,6,0,30,24
1650304493609,MATH 10A,A01,083735,Patchell; Gregory David,10,0,30,20
1650304493609,MATH 10A,A02,083736,Patchell; Gregory David,28,0,30,2
1650304493609,MATH 10A,A03,083737,Patchell; Gregory David,26,0,30,4
1650304499643,MATH 10B,A01,083207,Staff,0,6,30,30
1650304499643,MATH 10B,A02,083208,Staff,0,6,30,30
1650304499643,MATH 10B,B01,083739,Staff,17,0,30,13
1650304499643,MATH 10B,B02,083740,Staff,29,0,30,1
1650304505677,MATH 18,A01,083743,Staff,6,0,30,24
1650304505677,MATH 18,A02,083744,Staff,26,0,30,4
1650304505677,MATH 18,A03,083745,Staff,22,0,30,8
1650304505677,MATH 18,A04,083746,Staff,27,0,30,3
1650304505677,MATH 18,B01,083748,Staff,0,11,30,30
1650304505677,MATH 18,B02,083749,Staff,0,10,30,30
1650304505677,MATH 18,B03,083750,Staff,1,9,30,29
1650304505677,MATH 18,B04,083751,Staff,0,10,30,30
1650304511703,MATH 20A,A01,083754,Staff,25,0,40,15
1650304517729,MATH 20B,A01,083756,Staff,0,5,30,30
1650304517729,MATH 20B,A02,083757,Staff,0,7,30,30
1650304523754,MATH 20C,A01,083760,Staff,0,13,30,30
1650304523754,MATH 20C,A02,083761,Staff,0,13,30,30
1650304523754,MATH 20C,B01,083762,Staff,13,0,30,17
1650304523754,MATH 20C,B02,083763,Staff,28,0,30,2
1650304529780,MATH 20D,A01,083765,Staff,0,1,30,30
1650304529780,MATH 20D,A02,083766,Staff,8,0,30,22
1650304529780,MATH 20D,A03,083767,Staff,27,0,30,3
1650304535809,MATH 20E,A01,083771,Staff,6,0,30,24
1650304535809,MATH 20E,A02,083772,Staff,20,0,30,10
1650304535809,MATH 20E,B01,083773,Staff,0,0,30,30
1650304535809,MATH 20E,B02,083774,Staff,11,0,30,19
1650304541831,MATH 103A,A01,083777,Staff,0,11,30,30
1650304541831,MATH 103A,A02,083778,Staff,0,10,30,30
1650304541831,MATH 103A,B01,083779,Staff,0,10,30,30
1650304541831,MATH 103A,B02,083780,Staff,0,10,30,30
1650304547856,MATH 105,A01,085443,Staff,0,17,30,30
1650304553885,MATH 109,A01,083213,Anzaldo; Leesa B,0,5,30,30
1650304553885,MATH 109,A02,083214,Anzaldo; Leesa B,0,6,30,30
1650304553885,MATH 109,B01,083215,Anzaldo; Leesa B,0,4,30,30
1650304553885,MATH 109,B02,083216,Anzaldo; Leesa B,0,4,30,30
1650304559910,MATH 142A,A01,083219,Chow; Bennett,0,14,30,30
1650304559910,MATH 142A,A02,083220,Chow; Bennett,0,11,30,30
1650304559910,MATH 142A,B01,083221,Chow; Bennett,0,11,30,30
1650304559910,MATH 142A,B02,083222,Chow; Bennett,0,12,30,30
1650304565938,MATH 193A,A01,083224,Staff,0,5,30,30
1650304565938,MATH 193A,A02,083225,Staff,0,5,30,30
1650304565938,MATH 193A,A03,083781,Staff,0,2,30,30
1650304565938,MATH 193A,A04,083782,Staff,0,1,30,30
1650304571982,MATH 197,001,091859,McAuley; Julian John,9998,0,9999,1
1650304578042,COGS 9,A01,083615,Staff,0,15,60,60
1650304584068,COGS 11,A01,083617,Boyle; Mary E. T.,23,0,40,17
1650304590098,COGS 13,A01,083071,Staff,0,31,40,40
1650304596134,COGS 14A,A01,092681,Staff,0,17,100,100
1650304602158,COGS 14B,A01,083073,Cheng; Tzu-Han,0,9,50,50
1650304608185,COGS 17,A01,092677,Staff,26,0,75,49
1650304614211,COGS 100,A01,083619,Staff,0,23,60,60
1650304620233,COGS 101A,A01,083621,Davis; Joshua Daniel,0,22,60,60
1650304626257,COGS 101B,A01,091572,Staff,4,0,60,56
1650304632285,COGS 101C,A01,083625,Delgado; Tania,19,0,30,11
1650304638329,COGS 107A,A01,083627,Boyle; Mary E. T.,0,8,60,60
1650304644380,COGS 118A,A01,083075,Staff,8,0,60,52
1650304650412,CSE 3,A50,083646,Miranda; Gregory Joseph,21,0,38,17
1650304650412,CSE 3,A51,083647,Miranda; Gregory Joseph,37,0,37,0
1650304656443,CSE 8A,A50,083650,Miranda; Gregory Joseph,0,24,40,40
1650304662468,CSE 11,A01,083080,Cao; Yingjun,0,82,40,40
1650304668493,CSE 12,A01,083652,Staff,0,10,100,100
1650304674519,CSE 15L,A01,083654,Staff,0,1,50,50
1650304674519,CSE 15L,A02,083655,Staff,4,0,50,46
1650304680554,CSE 20,A01,083657,Staff,53,0,80,27
1650304686586,CSE 30,A01,083084,Eldon; John,0,74,40,40
1650304692611,CSE 100,A01,083659,Cao; Yingjun,0,65,50,50
1650304698635,CSE 134B,A01,083661,Powell; Thomas Allan,0,29,65,65
1650304704659,CSE 140,A01,083663,Staff,0,0,75,75
1650304710685,CSE 140L,A01,083088,Eldon; John,0,6,75,75
1650304716718,CSE 175,A01,083665,Kumar; Rakesh,8,0,25,17
1650304722743,CSE 190,A00,092507,Dubnov; Shlomo,14,0,20,6
1650304728767,ECE 45,A01,083139,Staff,0,16,40,40
1650304734793,ECE 65,A50,083695,Staff,0,4,30,30
1650304740823,ECE 109,A01,091882,Touri; Behrouz,42,0,70,28
1650304746857,ECE 180,A00,083140,Abi Samra; Nicholas Camill,23,0,30,7
1650304746857,ECE 180,B00,083141,Abi Samra; Nicholas Camill,6,0,30,24
1650304752892,MATH 10A,A01,083735,Patchell; Gregory David,10,0,30,20
1650304752892,MATH 10A,A02,083736,Patchell; Gregory David,28,0,30,2
1650304752892,MATH 10A,A03,083737,Patchell; Gregory David,26,0,30,4
1650304758918,MATH 10B,A01,083207,Staff,0,6,30,30
1650304758918,MATH 10B,A02,083208,Staff,0,6,30,30
1650304758918,MATH 10B,B01,083739,Staff,17,0,30,13
1650304758918,MATH 10B,B02,083740,Staff,29,0,30,1
1650304764952,MATH 18,A01,083743,Staff,6,0,30,24
1650304764952,MATH 18,A02,083744,Staff,26,0,30,4
1650304764952,MATH 18,A03,083745,Staff,22,0,30,8
1650304764952,MATH 18,A04,083746,Staff,27,0,30,3
1650304764952,MATH 18,B01,083748,Staff,0,11,30,30
1650304764952,MATH 18,B02,083749,Staff,0,10,30,30
1650304764952,MATH 18,B03,083750,Staff,1,9,30,29
1650304764952,MATH 18,B04,083751,Staff,0,10,30,30
1650304771081,MATH 20A,A01,083754,Staff,25,0,40,15
1650304777124,MATH 20B,A01,083756,Staff,0,5,30,30
1650304777124,MATH 20B,A02,083757,Staff,0,7,30,30
1650304783150,MATH 20C,A01,083760,Staff,0,13,30,30
1650304783150,MATH 20C,A02,083761,Staff,0,13,30,30
1650304783150,MATH 20C,B01,083762,Staff,13,0,30,17
1650304783150,MATH 20C,B02,083763,Staff,28,0,30,2
1650304789173,MATH 20D,A01,083765,Staff,0,1,30,30
1650304789173,MATH 20D,A02,083766,Staff,8,0,30,22
1650304789173,MATH 20D,A03,083767,Staff,27,0,30,3
1650304795200,MATH 20E,A01,083771,Staff,6,0,30,24
1650304795200,MATH 20E,A02,083772,Staff,20,0,30,10
1650304795200,MATH 20E,B01,083773,Staff,0,0,30,30
1650304795200,MATH 20E,B02,083774,Staff,11,0,30,19
1650304801228,MATH 103A,A01,083777,Staff,0,11,30,30
1650304801228,MATH 103A,A02,083778,Staff,0,10,30,30
1650304801228,MATH 103A,B01,083779,Staff,0,10,30,30
1650304801228,MATH 103A,B02,083780,Staff,0,10,30,30
1650304807283,MATH 105,A01,085443,Staff,0,17,30,30
1650304813308,MATH 109,A01,083213,Anzaldo; Leesa B,0,5,30,30
1650304813308,MATH 109,A02,083214,Anzaldo; Leesa B,0,6,30,30
1650304813308,MATH 109,B01,083215,Anzaldo; Leesa B,0,4,30,30
1650304813308,MATH 109,B02,083216,Anzaldo; Leesa B,0,4,30,30
1650304819357,MATH 142A,A01,083219,Chow; Bennett,0,14,30,30
1650304819357,MATH 142A,A02,083220,Chow; Bennett,0,11,30,30
1650304819357,MATH 142A,B01,083221,Chow; Bennett,0,11,30,30
1650304819357,MATH 142A,B02,083222,Chow; Bennett,0,12,30,30
1650304825387,MATH 193A,A01,083224,Staff,0,5,30,30
1650304825387,MATH 193A,A02,083225,Staff,0,5,30,30
1650304825387,MATH 193A,A03,083781,Staff,0,2,30,30
1650304825387,MATH 193A,A04,083782,Staff,0,1,30,30
1650304831415,MATH 197,001,091859,McAuley; Julian John,9998,0,9999,1
1650304837475,COGS 9,A01,083615,Staff,0,15,60,60
1650304843498,COGS 11,A01,083617,Boyle; Mary E. T.,23,0,40,17
1650304849523,COGS 13,A01,083071,Staff,0,31,40,40
1650304855552,COGS 14A,A01,092681,Staff,0,17,100,100
1650304861577,COGS 14B,A01,083073,Cheng; Tzu-Han,0,9,50,50
1650304867615,COGS 17,A01,092677,Staff,26,0,75,49
1650304873648,COGS 100,A01,083619,Staff,0,23,60,60
1650304879731,COGS 101A,A01,083621,Davis; Joshua Daniel,0,22,60,60
1650304885758,COGS 101B,A01,091572,Staff,4,0,60,56
1650304891793,COGS 101C,A01,083625,Delgado; Tania,19,0,30,11
1650304897815,COGS 107A,A01,083627,Boyle; Mary E. T.,0,8,60,60
1650304903839,COGS 118A,A01,083075,Staff,8,0,60,52
1650304909873,CSE 3,A50,083646,Miranda; Gregory Joseph,21,0,38,17
1650304909873,CSE 3,A51,083647,Miranda; Gregory Joseph,37,0,37,0
1650304915907,CSE 8A,A50,083650,Miranda; Gregory Joseph,0,24,40,40
1650304921934,CSE 11,A01,083080,Cao; Yingjun,0,82,40,40
1650304927960,CSE 12,A01,083652,Staff,0,10,100,100
1650304933986,CSE 15L,A01,083654,Staff,0,1,50,50
1650304933986,CSE 15L,A02,083655,Staff,4,0,50,46
1650304940021,CSE 20,A01,083657,Staff,53,0,80,27
1650304946043,CSE 30,A01,083084,Eldon; John,0,74,40,40
1650304952069,CSE 100,A01,083659,Cao; Yingjun,0,65,50,50
1650304958102,CSE 134B,A01,083661,Powell; Thomas Allan,0,29,65,65
1650304964126,CSE 140,A01,083663,Staff,0,0,75,75
1650304970152,CSE 140L,A01,083088,Eldon; John,0,6,75,75
1650304976178,CSE 175,A01,083665,Kumar; Rakesh,8,0,25,17
1650304982204,CSE 190,A00,092507,Dubnov; Shlomo,14,0,20,6
1650304988240,ECE 45,A01,083139,Staff,0,16,40,40
1650304994264,ECE 65,A50,083695,Staff,0,4,30,30
1650305000305,ECE 109,A01,091882,Touri; Behrouz,42,0,70,28
1650305006332,ECE 180,A00,083140,Abi Samra; Nicholas Camill,23,0,30,7
1650305006332,ECE 180,B00,083141,Abi Samra; Nicholas Camill,6,0,30,24
1650305012369,MATH 10A,A01,083735,Patchell; Gregory David,10,0,30,20
1650305012369,MATH 10A,A02,083736,Patchell; Gregory David,28,0,30,2
1650305012369,MATH 10A,A03,083737,Patchell; Gregory David,26,0,30,4
1650305018395,MATH 10B,A01,083207,Staff,0,6,30,30
1650305018395,MATH 10B,A02,083208,Staff,0,6,30,30
1650305018395,MATH 10B,B01,083739,Staff,17,0,30,13
1650305018395,MATH 10B,B02,083740,Staff,29,0,30,1
1650305024428,MATH 18,A01,083743,Staff,6,0,30,24
1650305024428,MATH 18,A02,083744,Staff,26,0,30,4
1650305024428,MATH 18,A03,083745,Staff,22,0,30,8
1650305024428,MATH 18,A04,083746,Staff,27,0,30,3
1650305024428,MATH 18,B01,083748,Staff,0,11,30,30
1650305024428,MATH 18,B02,083749,Staff,0,10,30,30
1650305024428,MATH 18,B03,083750,Staff,1,9,30,29
1650305024428,MATH 18,B04,083751,Staff,0,10,30,30
1650305030451,MATH 20A,A01,083754,Staff,25,0,40,15
1650305036494,MATH 20B,A01,083756,Staff,0,5,30,30
1650305036494,MATH 20B,A02,083757,Staff,0,7,30,30
1650305042524,MATH 20C,A01,083760,Staff,0,13,30,30
1650305042524,MATH 20C,A02,083761,Staff,0,13,30,30
1650305042524,MATH 20C,B01,083762,Staff,13,0,30,17
1650305042524,MATH 20C,B02,083763,Staff,28,0,30,2
1650305048551,MATH 20D,A01,083765,Staff,0,1,30,30
1650305048551,MATH 20D,A02,083766,Staff,8,0,30,22
1650305048551,MATH 20D,A03,083767,Staff,27,0,30,3
1650305054580,MATH 20E,A01,083771,Staff,6,0,30,24
1650305054580,MATH 20E,A02,083772,Staff,20,0,30,10
1650305054580,MATH 20E,B01,083773,Staff,0,0,30,30
1650305054580,MATH 20E,B02,083774,Staff,11,0,30,19
1650305060614,MATH 103A,A01,083777,Staff,0,11,30,30
1650305060614,MATH 103A,A02,083778,Staff,0,10,30,30
1650305060614,MATH 103A,B01,083779,Staff,0,10,30,30
1650305060614,MATH 103A,B02,083780,Staff,0,10,30,30
1650305066635,MATH 105,A01,085443,Staff,0,17,30,30
1650305072667,MATH 109,A01,083213,Anzaldo; Leesa B,0,5,30,30
1650305072667,MATH 109,A02,083214,Anzaldo; Leesa B,0,6,30,30
1650305072667,MATH 109,B01,083215,Anzaldo; Leesa B,0,4,30,30
1650305072667,MATH 109,B02,083216,Anzaldo; Leesa B,0,4,30,30
1650305078694,MATH 142A,A01,083219,Chow; Bennett,0,14,30,30
1650305078694,MATH 142A,A02,083220,Chow; Bennett,0,11,30,30
1650305078694,MATH 142A,B01,083221,Chow; Bennett,0,11,30,30
1650305078694,MATH 142A,B02,083222,Chow; Bennett,0,12,30,30
1650305084722,MATH 193A,A01,083224,Staff,0,5,30,30
1650305084722,MATH 193A,A02,083225,Staff,0,5,30,30
1650305084722,MATH 193A,A03,083781,Staff,0,2,30,30
1650305084722,MATH 193A,A04,083782,Staff,0,1,30,30
1650305090745,MATH 197,001,091859,McAuley; Julian John,9998,0,9999,1
1650305096838,COGS 9,A01,083615,Staff,0,15,60,60
1650305102860,COGS 11,A01,083617,Boyle; Mary E. T.,23,0,40,17
1650305108884,COGS 13,A01,083071,Staff,0,31,40,40
1650305114908,COGS 14A,A01,092681,Staff,0,18,100,100
1650305120952,COGS 14B,A01,083073,Cheng; Tzu-Han,0,9,50,50
1650305126978,COGS 17,A01,092677,Staff,26,0,75,49
1650305133010,COGS 100,A01,083619,Staff,0,23,60,60
1650305139033,COGS 101A,A01,083621,Davis; Joshua Daniel,0,22,60,60
1650305145072,COGS 101B,A01,091572,Staff,4,0,60,56
1650305151097,COGS 101C,A01,083625,Delgado; Tania,19,0,30,11
1650305157131,COGS 107A,A01,083627,Boyle; Mary E. T.,0,8,60,60
1650305163157,COGS 118A,A01,083075,Staff,6,0,60,54
1650305169186,CSE 3,A50,083646,Miranda; Gregory Joseph,21,0,38,17
1650305169186,CSE 3,A51,083647,Miranda; Gregory Joseph,37,0,37,0
1650305175214,CSE 8A,A50,083650,Miranda; Gregory Joseph,0,25,40,40
1650305181250,CSE 11,A01,083080,Cao; Yingjun,0,82,40,40
1650305187273,CSE 12,A01,083652,Staff,0,10,100,100
1650305193298,CSE 15L,A01,083654,Staff,0,1,50,50
1650305193298,CSE 15L,A02,083655,Staff,4,0,50,46
1650305199327,CSE 20,A01,083657,Staff,53,0,80,27
1650305205350,CSE 30,A01,083084,Eldon; John,0,74,40,40
1650305211379,CSE 100,A01,083659,Cao; Yingjun,0,65,50,50
1650305217407,CSE 134B,A01,083661,Powell; Thomas Allan,0,29,65,65
1650305223463,CSE 140,A01,083663,Staff,0,0,75,75
1650305229486,CSE 140L,A01,083088,Eldon; John,0,6,75,75
1650305235516,CSE 175,A01,083665,Kumar; Rakesh,8,0,25,17
1650305241546,CSE 190,A00,092507,Dubnov; Shlomo,14,0,20,6
1650305247571,ECE 45,A01,083139,Staff,0,16,40,40
1650305253610,ECE 65,A50,083695,Staff,0,4,30,30
1650305259636,ECE 109,A01,091882,Touri; Behrouz,42,0,70,28
1650305265659,ECE 180,A00,083140,Abi Samra; Nicholas Camill,23,0,30,7
1650305265659,ECE 180,B00,083141,Abi Samra; Nicholas Camill,6,0,30,24
1650305271699,MATH 10A,A01,083735,Patchell; Gregory David,10,0,30,20
1650305271699,MATH 10A,A02,083736,Patchell; Gregory David,28,0,30,2
1650305271699,MATH 10A,A03,083737,Patchell; Gregory David,26,0,30,4
1650305277729,MATH 10B,A01,083207,Staff,0,6,30,30
1650305277729,MATH 10B,A02,083208,Staff,0,6,30,30
1650305277729,MATH 10B,B01,083739,Staff,17,0,30,13
1650305277729,MATH 10B,B02,083740,Staff,28,0,30,2
1650305283759,MATH 18,A01,083743,Staff,6,0,30,24
1650305283759,MATH 18,A02,083744,Staff,26,0,30,4
1650305283759,MATH 18,A03,083745,Staff,22,0,30,8
1650305283759,MATH 18,A04,083746,Staff,27,0,30,3
1650305283759,MATH 18,B01,083748,Staff,0,11,30,30
1650305283759,MATH 18,B02,083749,Staff,0,10,30,30
1650305283759,MATH 18,B03,083750,Staff,1,9,30,29
1650305283759,MATH 18,B04,083751,Staff,0,10,30,30
1650305289781,MATH 20A,A01,083754,Staff,25,0,40,15
1650305295804,MATH 20B,A01,083756,Staff,0,5,30,30
1650305295804,MATH 20B,A02,083757,Staff,0,7,30,30
1650305301835,MATH 20C,A01,083760,Staff,0,13,30,30
1650305301835,MATH 20C,A02,083761,Staff,0,13,30,30
1650305301835,MATH 20C,B01,083762,Staff,13,0,30,17
1650305301835,MATH 20C,B02,083763,Staff,28,0,30,2
1650305307878,MATH 20D,A01,083765,Staff,0,1,30,30
1650305307878,MATH 20D,A02,083766,Staff,8,0,30,22
1650305307878,MATH 20D,A03,083767,Staff,27,0,30,3
1650305313905,MATH 20E,A01,083771,Staff,6,0,30,24
1650305313905,MATH 20E,A02,083772,Staff,20,0,30,10
1650305313905,MATH 20E,B01,083773,Staff,0,0,30,30
1650305313905,MATH 20E,B02,083774,Staff,11,0,30,19
1650305319928,MATH 103A,A01,083777,Staff,0,11,30,30
1650305319928,MATH 103A,A02,083778,Staff,0,10,30,30
1650305319928,MATH 103A,B01,083779,Staff,0,10,30,30
1650305319928,MATH 103A,B02,083780,Staff,0,10,30,30
1650305325959,MATH 105,A01,085443,Staff,0,17,30,30
1650305331999,MATH 109,A01,083213,Anzaldo; Leesa B,0,5,30,30
1650305331999,MATH 109,A02,083214,Anzaldo; Leesa B,0,6,30,30
1650305331999,MATH 109,B01,083215,Anzaldo; Leesa B,0,4,30,30
1650305331999,MATH 109,B02,083216,Anzaldo; Leesa B,0,4,30,30
1650305338028,MATH 142A,A01,083219,Chow; Bennett,0,14,30,30
1650305338028,MATH 142A,A02,083220,Chow; Bennett,0,11,30,30
1650305338028,MATH 142A,B01,083221,Chow; Bennett,0,11,30,30
1650305338028,MATH 142A,B02,083222,Chow; Bennett,0,12,30,30
1650305344070,MATH 193A,A01,083224,Staff,0,5,30,30
1650305344070,MATH 193A,A02,083225,Staff,0,5,30,30
1650305344070,MATH 193A,A03,083781,Staff,0,2,30,30
1650305344070,MATH 193A,A04,083782,Staff,0,1,30,30
1650305350095,MATH 197,001,091859,McAuley; Julian John,9998,0,9999,1
1650305356163,COGS 9,A01,083615,Staff,0,15,60,60
1650305362315,COGS 11,A01,083617,Boyle; Mary E. T.,23,0,40,17
1650305368338,COGS 13,A01,083071,Staff,0,31,40,40
1650305374374,COGS 14A,A01,092681,Staff,0,18,100,100
1650305380409,COGS 14B,A01,083073,Cheng; Tzu-Han,0,10,50,50
1650305386431,COGS 17,A01,092677,Staff,26,0,75,49
1650305392454,COGS 100,A01,083619,Staff,0,23,60,60
1650305398487,COGS 101A,A01,083621,Davis; Joshua Daniel,0,22,60,60
1650305404511,COGS 101B,A01,091572,Staff,4,0,60,56
1650305410535,COGS 101C,A01,083625,Delgado; Tania,19,0,30,11
1650305416558,COGS 107A,A01,083627,Boyle; Mary E. T.,0,8,60,60
1650305422585,COGS 118A,A01,083075,Staff,6,0,60,54
1650305428618,CSE 3,A50,083646,Miranda; Gregory Joseph,21,0,38,17
1650305428618,CSE 3,A51,083647,Miranda; Gregory Joseph,37,0,37,0
1650305434657,CSE 8A,A50,083650,Miranda; Gregory Joseph,0,25,40,40
1650305440698,CSE 11,A01,083080,Cao; Yingjun,0,82,40,40
1650305446722,CSE 12,A01,083652,Staff,0,10,100,100
1650305452750,CSE 15L,A01,083654,Staff,0,1,50,50
1650305452750,CSE 15L,A02,083655,Staff,4,0,50,46
1650305458776,CSE 20,A01,083657,Staff,53,0,80,27
1650305464803,CSE 30,A01,083084,Eldon; John,0,74,40,40
1650305470835,CSE 100,A01,083659,Cao; Yingjun,0,65,50,50
1650305476870,CSE 134B,A01,083661,Powell; Thomas Allan,0,29,65,65
1650305482894,CSE 140,A01,083663,Staff,0,0,75,75
1650305488945,CSE 140L,A01,083088,Eldon; John,0,6,75,75
1650305494968,CSE 175,A01,083665,Kumar; Rakesh,8,0,25,17
1650305500991,CSE 190,A00,092507,Dubnov; Shlomo,14,0,20,6
1650305507029,ECE 45,A01,083139,Staff,0,16,40,40
1650305513053,ECE 65,A50,083695,Staff,0,4,30,30
1650305519077,ECE 109,A01,091882,Touri; Behrouz,42,0,70,28
1650305525114,ECE 180,A00,083140,Abi Samra; Nicholas Camill,23,0,30,7
1650305525114,ECE 180,B00,083141,Abi Samra; Nicholas Camill,6,0,30,24
1650305531147,MATH 10A,A01,083735,Patchell; Gregory David,10,0,30,20
1650305531147,MATH 10A,A02,083736,Patchell; Gregory David,28,0,30,2
1650305531147,MATH 10A,A03,083737,Patchell; Gregory David,26,0,30,4
1650305537182,MATH 10B,A01,083207,Staff,0,6,30,30
1650305537182,MATH 10B,A02,083208,Staff,0,6,30,30
1650305537182,MATH 10B,B01,083739,Staff,17,0,30,13
1650305537182,MATH 10B,B02,083740,Staff,28,0,30,2
1650305543214,MATH 18,A01,083743,Staff,6,0,30,24
1650305543214,MATH 18,A02,083744,Staff,26,0,30,4
1650305543214,MATH 18,A03,083745,Staff,22,0,30,8
1650305543214,MATH 18,A04,083746,Staff,27,0,30,3
1650305543214,MATH 18,B01,083748,Staff,0,11,30,30
1650305543214,MATH 18,B02,083749,Staff,0,10,30,30
1650305543214,MATH 18,B03,083750,Staff,1,9,30,29
1650305543214,MATH 18,B04,083751,Staff,0,10,30,30
1650305549239,MATH 20A,A01,083754,Staff,25,0,40,15
1650305555272,MATH 20B,A01,083756,Staff,0,5,30,30
1650305555272,MATH 20B,A02,083757,Staff,0,7,30,30
1650305561305,MATH 20C,A01,083760,Staff,0,13,30,30
1650305561305,MATH 20C,A02,083761,Staff,0,13,30,30
1650305561305,MATH 20C,B01,083762,Staff,13,0,30,17
1650305561305,MATH 20C,B02,083763,Staff,28,0,30,2
1650305567333,MATH 20D,A01,083765,Staff,0,1,30,30
1650305567333,MATH 20D,A02,083766,Staff,8,0,30,22
1650305567333,MATH 20D,A03,083767,Staff,27,0,30,3
1650305573368,MATH 20E,A01,083771,Staff,6,0,30,24
1650305573368,MATH 20E,A02,083772,Staff,20,0,30,10
1650305573368,MATH 20E,B01,083773,Staff,0,0,30,30
1650305573368,MATH 20E,B02,083774,Staff,11,0,30,19
1650305579401,MATH 103A,A01,083777,Staff,0,11,30,30
1650305579401,MATH 103A,A02,083778,Staff,0,10,30,30
1650305579401,MATH 103A,B01,083779,Staff,0,10,30,30
1650305579401,MATH 103A,B02,083780,Staff,0,10,30,30
1650305585426,MATH 105,A01,085443,Staff,0,17,30,30
1650305591450,MATH 109,A01,083213,Anzaldo; Leesa B,0,5,30,30
1650305591450,MATH 109,A02,083214,Anzaldo; Leesa B,0,6,30,30
1650305591450,MATH 109,B01,083215,Anzaldo; Leesa B,0,4,30,30
1650305591450,MATH 109,B02,083216,Anzaldo; Leesa B,0,4,30,30
1650305597477,MATH 142A,A01,083219,Chow; Bennett,0,14,30,30
1650305597477,MATH 142A,A02,083220,Chow; Bennett,0,11,30,30
1650305597477,MATH 142A,B01,083221,Chow; Bennett,0,11,30,30
1650305597477,MATH 142A,B02,083222,Chow; Bennett,0,12,30,30
1650305603501,MATH 193A,A01,083224,Staff,0,5,30,30
1650305603501,MATH 193A,A02,083225,Staff,0,5,30,30
1650305603501,MATH 193A,A03,083781,Staff,0,2,30,30
1650305603501,MATH 193A,A04,083782,Staff,0,2,30,30
1650305609523,MATH 197,001,091859,McAuley; Julian John,9998,0,9999,1
1650305615580,COGS 9,A01,083615,Staff,0,15,60,60
1650305621611,COGS 11,A01,083617,Boyle; Mary E. T.,23,0,40,17
1650305627634,COGS 13,A01,083071,Staff,0,31,40,40
1650305633657,COGS 14A,A01,092681,Staff,0,18,100,100
1650305639681,COGS 14B,A01,083073,Cheng; Tzu-Han,0,10,50,50
1650305645705,COGS 17,A01,092677,Staff,26,0,75,49
1650305651727,COGS 100,A01,083619,Staff,0,23,60,60
1650305657750,COGS 101A,A01,083621,Davis; Joshua Daniel,0,22,60,60
1650305663775,COGS 101B,A01,091572,Staff,4,0,60,56
1650305669799,COGS 101C,A01,083625,Delgado; Tania,19,0,30,11
1650305675825,COGS 107A,A01,083627,Boyle; Mary E. T.,0,8,60,60
1650305681849,COGS 118A,A01,083075,Staff,5,0,60,55
1650305687878,CSE 3,A50,083646,Miranda; Gregory Joseph,21,0,38,17
1650305687878,CSE 3,A51,083647,Miranda; Gregory Joseph,37,0,37,0
1650305693901,CSE 8A,A50,083650,Miranda; Gregory Joseph,0,25,40,40
1650305699928,CSE 11,A01,083080,Cao; Yingjun,0,82,40,40
1650305705958,CSE 12,A01,083652,Staff,0,10,100,100
1650305711983,CSE 15L,A01,083654,Staff,0,1,50,50
1650305711983,CSE 15L,A02,083655,Staff,4,0,50,46
1650305718007,CSE 20,A01,083657,Staff,53,0,80,27
1650305724038,CSE 30,A01,083084,Eldon; John,0,74,40,40
1650305730063,CSE 100,A01,083659,Cao; Yingjun,0,65,50,50
1650305736087,CSE 134B,A01,083661,Powell; Thomas Allan,0,29,65,65
1650305742111,CSE 140,A01,083663,Staff,0,0,75,75
1650305748138,CSE 140L,A01,083088,Eldon; John,0,6,75,75
1650305754164,CSE 175,A01,083665,Kumar; Rakesh,8,0,25,17
1650305760186,CSE 190,A00,092507,Dubnov; Shlomo,14,0,20,6
1650305766210,ECE 45,A01,083139,Staff,0,16,40,40
1650305772236,ECE 65,A50,083695,Staff,0,4,30,30
1650305778268,ECE 109,A01,091882,Touri; Behrouz,42,0,70,28
1650305784292,ECE 180,A00,083140,Abi Samra; Nicholas Camill,23,0,30,7
1650305784292,ECE 180,B00,083141,Abi Samra; Nicholas Camill,6,0,30,24
1650305790318,MATH 10A,A01,083735,Patchell; Gregory David,10,0,30,20
1650305790318,MATH 10A,A02,083736,Patchell; Gregory David,28,0,30,2
1650305790318,MATH 10A,A03,083737,Patchell; Gregory David,26,0,30,4
1650305796350,MATH 10B,A01,083207,Staff,0,6,30,30
1650305796350,MATH 10B,A02,083208,Staff,0,6,30,30
1650305796350,MATH 10B,B01,083739,Staff,17,0,30,13
1650305796350,MATH 10B,B02,083740,Staff,28,0,30,2
1650305802378,MATH 18,A01,083743,Staff,6,0,30,24
1650305802378,MATH 18,A02,083744,Staff,26,0,30,4
1650305802378,MATH 18,A03,083745,Staff,22,0,30,8
1650305802378,MATH 18,A04,083746,Staff,27,0,30,3
1650305802378,MATH 18,B01,083748,Staff,0,11,30,30
1650305802378,MATH 18,B02,083749,Staff,0,10,30,30
1650305802378,MATH 18,B03,083750,Staff,1,9,30,29
1650305802378,MATH 18,B04,083751,Staff,0,10,30,30
1650305808415,MATH 20A,A01,083754,Staff,25,0,40,15
1650305814442,MATH 20B,A01,083756,Staff,0,5,30,30
1650305814442,MATH 20B,A02,083757,Staff,0,7,30,30
1650305820465,MATH 20C,A01,083760,Staff,0,13,30,30
1650305820465,MATH 20C,A02,083761,Staff,0,13,30,30
1650305820465,MATH 20C,B01,083762,Staff,13,0,30,17
1650305820465,MATH 20C,B02,083763,Staff,28,0,30,2
1650305826502,MATH 20D,A01,083765,Staff,0,1,30,30
1650305826502,MATH 20D,A02,083766,Staff,8,0,30,22
1650305826502,MATH 20D,A03,083767,Staff,27,0,30,3
1650305832533,MATH 20E,A01,083771,Staff,6,0,30,24
1650305832533,MATH 20E,A02,083772,Staff,20,0,30,10
1650305832533,MATH 20E,B01,083773,Staff,0,0,30,30
1650305832533,MATH 20E,B02,083774,Staff,11,0,30,19
1650305838567,MATH 103A,A01,083777,Staff,0,11,30,30
1650305838567,MATH 103A,A02,083778,Staff,0,10,30,30
1650305838567,MATH 103A,B01,083779,Staff,0,10,30,30
1650305838567,MATH 103A,B02,083780,Staff,0,10,30,30
1650305844589,MATH 105,A01,085443,Staff,0,17,30,30
1650305850619,MATH 109,A01,083213,Anzaldo; Leesa B,0,5,30,30
1650305850619,MATH 109,A02,083214,Anzaldo; Leesa B,0,6,30,30
1650305850619,MATH 109,B01,083215,Anzaldo; Leesa B,0,4,30,30
1650305850619,MATH 109,B02,083216,Anzaldo; Leesa B,0,4,30,30
1650305856648,MATH 142A,A01,083219,Chow; Bennett,0,14,30,30
1650305856648,MATH 142A,A02,083220,Chow; Bennett,0,11,30,30
1650305856648,MATH 142A,B01,083221,Chow; Bennett,0,11,30,30
1650305856648,MATH 142A,B02,083222,Chow; Bennett,0,12,30,30
1650305868570,MATH 193A,A01,083224,Staff,0,5,30,30
1650305868570,MATH 193A,A02,083225,Staff,0,5,30,30
1650305868570,MATH 193A,A03,083781,Staff,0,2,30,30
1650305868570,MATH 193A,A04,083782,Staff,0,2,30,30
1650305874599,MATH 197,001,091859,McAuley; Julian John,9998,0,9999,1
1650305880677,COGS 9,A01,083615,Staff,0,15,60,60
1650305886704,COGS 11,A01,083617,Boyle; Mary E. T.,23,0,40,17
1650305892727,COGS 13,A01,083071,Staff,0,31,40,40
1650305898750,COGS 14A,A01,092681,Staff,0,18,100,100
1650305904773,COGS 14B,A01,083073,Cheng; Tzu-Han,0,10,50,50
1650305910799,COGS 17,A01,092677,Staff,26,0,75,49
1650305916826,COGS 100,A01,083619,Staff,0,23,60,60
1650305922853,COGS 101A,A01,083621,Davis; Joshua Daniel,0,22,60,60
1650305928879,COGS 101B,A01,091572,Staff,4,0,60,56
1650305934902,COGS 101C,A01,083625,Delgado; Tania,19,0,30,11
1650305940926,COGS 107A,A01,083627,Boyle; Mary E. T.,0,8,60,60
1650305946964,COGS 118A,A01,083075,Staff,5,0,60,55
1650305952987,CSE 3,A50,083646,Miranda; Gregory Joseph,21,0,38,17
1650305952987,CSE 3,A51,083647,Miranda; Gregory Joseph,37,0,37,0
1650305959011,CSE 8A,A50,083650,Miranda; Gregory Joseph,0,25,40,40
1650305965123,CSE 11,A01,083080,Cao; Yingjun,0,82,40,40
1650305971146,CSE 12,A01,083652,Staff,0,10,100,100
1650305977172,CSE 15L,A01,083654,Staff,0,1,50,50
1650305977172,CSE 15L,A02,083655,Staff,4,0,50,46
1650305983218,CSE 20,A01,083657,Staff,53,0,80,27
1650305989273,CSE 30,A01,083084,Eldon; John,0,74,40,40
1650305995299,CSE 100,A01,083659,Cao; Yingjun,0,65,50,50
1650306001333,CSE 134B,A01,083661,Powell; Thomas Allan,0,29,65,65
1650306007359,CSE 140,A01,083663,Staff,0,0,75,75
1650306013399,CSE 140L,A01,083088,Eldon; John,0,6,75,75
1650306019435,CSE 175,A01,083665,Kumar; Rakesh,8,0,25,17
1650306025468,CSE 190,A00,092507,Dubnov; Shlomo,14,0,20,6
1650306031494,ECE 45,A01,083139,Staff,0,16,40,40
1650306037518,ECE 65,A50,083695,Staff,0,4,30,30
1650306043545,ECE 109,A01,091882,Touri; Behrouz,42,0,70,28
1650306049570,ECE 180,A00,083140,Abi Samra; Nicholas Camill,23,0,30,7
1650306049570,ECE 180,B00,083141,Abi Samra; Nicholas Camill,6,0,30,24
1650306055594,MATH 10A,A01,083735,Patchell; Gregory David,10,0,30,20
1650306055594,MATH 10A,A02,083736,Patchell; Gregory David,28,0,30,2
1650306055594,MATH 10A,A03,083737,Patchell; Gregory David,26,0,30,4
1650306061626,MATH 10B,A01,083207,Staff,0,6,30,30
1650306061626,MATH 10B,A02,083208,Staff,0,6,30,30
1650306061626,MATH 10B,B01,083739,Staff,17,0,30,13
1650306061626,MATH 10B,B02,083740,Staff,28,0,30,2
1650306067654,MATH 18,A01,083743,Staff,6,0,30,24
1650306067654,MATH 18,A02,083744,Staff,26,0,30,4
1650306067654,MATH 18,A03,083745,Staff,22,0,30,8
1650306067654,MATH 18,A04,083746,Staff,27,0,30,3
1650306067654,MATH 18,B01,083748,Staff,0,11,30,30
1650306067654,MATH 18,B02,083749,Staff,0,10,30,30
1650306067654,MATH 18,B03,083750,Staff,1,9,30,29
1650306067654,MATH 18,B04,083751,Staff,0,10,30,30
1650306073684,MATH 20A,A01,083754,Staff,25,0,40,15
1650306079709,MATH 20B,A01,083756,Staff,0,5,30,30
1650306079709,MATH 20B,A02,083757,Staff,0,7,30,30
1650306085737,MATH 20C,A01,083760,Staff,0,13,30,30
1650306085737,MATH 20C,A02,083761,Staff,0,13,30,30
1650306085737,MATH 20C,B01,083762,Staff,13,0,30,17
1650306085737,MATH 20C,B02,083763,Staff,28,0,30,2
1650306091760,MATH 20D,A01,083765,Staff,0,1,30,30
1650306091760,MATH 20D,A02,083766,Staff,8,0,30,22
1650306091760,MATH 20D,A03,083767,Staff,27,0,30,3
1650306097785,MATH 20E,A01,083771,Staff,6,0,30,24
1650306097785,MATH 20E,A02,083772,Staff,20,0,30,10
1650306097785,MATH 20E,B01,083773,Staff,0,0,30,30
1650306097785,MATH 20E,B02,083774,Staff,11,0,30,19
1650306103812,MATH 103A,A01,083777,Staff,0,11,30,30
1650306103812,MATH 103A,A02,083778,Staff,0,10,30,30
1650306103812,MATH 103A,B01,083779,Staff,0,10,30,30
1650306103812,MATH 103A,B02,083780,Staff,0,10,30,30
1650306109845,MATH 105,A01,085443,Staff,0,17,30,30
1650306115868,MATH 109,A01,083213,Anzaldo; Leesa B,0,5,30,30
1650306115868,MATH 109,A02,083214,Anzaldo; Leesa B,0,6,30,30
1650306115868,MATH 109,B01,083215,Anzaldo; Leesa B,0,4,30,30
1650306115868,MATH 109,B02,083216,Anzaldo; Leesa B,0,4,30,30
1650306121896,MATH 142A,A01,083219,Chow; Bennett,0,14,30,30
1650306121896,MATH 142A,A02,083220,Chow; Bennett,0,11,30,30
1650306121896,MATH 142A,B01,083221,Chow; Bennett,0,11,30,30
1650306121896,MATH 142A,B02,083222,Chow; Bennett,0,12,30,30
1650306127918,MATH 193A,A01,083224,Staff,0,5,30,30
1650306127918,MATH 193A,A02,083225,Staff,0,5,30,30
1650306127918,MATH 193A,A03,083781,Staff,0,2,30,30
1650306127918,MATH 193A,A04,083782,Staff,0,2,30,30
1650306133943,MATH 197,001,091859,McAuley; Julian John,9998,0,9999,1
1650306139994,COGS 9,A01,083615,Staff,0,15,60,60
1650306146020,COGS 11,A01,083617,Boyle; Mary E. T.,23,0,40,17
1650306152056,COGS 13,A01,083071,Staff,0,31,40,40
1650306158083,COGS 14A,A01,092681,Staff,0,17,100,100
1650306164110,COGS 14B,A01,083073,Cheng; Tzu-Han,0,10,50,50
1650306170136,COGS 17,A01,092677,Staff,26,0,75,49
1650306176168,COGS 100,A01,083619,Staff,0,23,60,60
1650306182195,COGS 101A,A01,083621,Davis; Joshua Daniel,0,22,60,60
1650306188225,COGS 101B,A01,091572,Staff,4,0,60,56
1650306194249,COGS 101C,A01,083625,Delgado; Tania,19,0,30,11
1650306200275,COGS 107A,A01,083627,Boyle; Mary E. T.,0,8,60,60
1650306206308,COGS 118A,A01,083075,Staff,5,0,60,55
1650306212330,CSE 3,A50,083646,Miranda; Gregory Joseph,21,0,38,17
1650306212330,CSE 3,A51,083647,Miranda; Gregory Joseph,37,0,37,0
1650306218355,CSE 8A,A50,083650,Miranda; Gregory Joseph,0,25,40,40
1650306224381,CSE 11,A01,083080,Cao; Yingjun,0,82,40,40
1650306230404,CSE 12,A01,083652,Staff,0,10,100,100
1650306236428,CSE 15L,A01,083654,Staff,0,1,50,50
1650306236428,CSE 15L,A02,083655,Staff,4,0,50,46
1650306242452,CSE 20,A01,083657,Staff,53,0,80,27
1650306248479,CSE 30,A01,083084,Eldon; John,0,74,40,40
1650306254512,CSE 100,A01,083659,Cao; Yingjun,0,65,50,50
1650306260536,CSE 134B,A01,083661,Powell; Thomas Allan,0,29,65,65
1650306266570,CSE 140,A01,083663,Staff,0,0,75,75
1650306272601,CSE 140L,A01,083088,Eldon; John,0,6,75,75
1650306278625,CSE 175,A01,083665,Kumar; Rakesh,8,0,25,17
1650306284651,CSE 190,A00,092507,Dubnov; Shlomo,14,0,20,6
1650306290684,ECE 45,A01,083139,Staff,0,16,40,40
1650306296714,ECE 65,A50,083695,Staff,0,4,30,30
1650306302737,ECE 109,A01,091882,Touri; Behrouz,42,0,70,28
1650306308761,ECE 180,A00,083140,Abi Samra; Nicholas Camill,23,0,30,7
1650306308761,ECE 180,B00,083141,Abi Samra; Nicholas Camill,6,0,30,24
1650306314785,MATH 10A,A01,083735,Patchell; Gregory David,10,0,30,20
1650306314785,MATH 10A,A02,083736,Patchell; Gregory David,28,0,30,2
1650306314785,MATH 10A,A03,083737,Patchell; Gregory David,26,0,30,4
1650306320814,MATH 10B,A01,083207,Staff,0,6,30,30
1650306320814,MATH 10B,A02,083208,Staff,0,6,30,30
1650306320814,MATH 10B,B01,083739,Staff,17,0,30,13
1650306320814,MATH 10B,B02,083740,Staff,28,0,30,2
1650306326840,MATH 18,A01,083743,Staff,6,0,30,24
1650306326840,MATH 18,A02,083744,Staff,26,0,30,4
1650306326840,MATH 18,A03,083745,Staff,22,0,30,8
1650306326840,MATH 18,A04,083746,Staff,27,0,30,3
1650306326840,MATH 18,B01,083748,Staff,0,11,30,30
1650306326840,MATH 18,B02,083749,Staff,0,10,30,30
1650306326840,MATH 18,B03,083750,Staff,1,9,30,29
1650306326840,MATH 18,B04,083751,Staff,0,10,30,30
1650306332866,MATH 20A,A01,083754,Staff,25,0,40,15
1650306338893,MATH 20B,A01,083756,Staff,0,5,30,30
1650306338893,MATH 20B,A02,083757,Staff,0,7,30,30
1650306344918,MATH 20C,A01,083760,Staff,0,13,30,30
1650306344918,MATH 20C,A02,083761,Staff,0,13,30,30
1650306344918,MATH 20C,B01,083762,Staff,13,0,30,17
1650306344918,MATH 20C,B02,083763,Staff,28,0,30,2
1650306350947,MATH 20D,A01,083765,Staff,0,1,30,30
1650306350947,MATH 20D,A02,083766,Staff,8,0,30,22
1650306350947,MATH 20D,A03,083767,Staff,27,0,30,3
1650306356972,MATH 20E,A01,083771,Staff,6,0,30,24
1650306356972,MATH 20E,A02,083772,Staff,20,0,30,10
1650306356972,MATH 20E,B01,083773,Staff,0,0,30,30
1650306356972,MATH 20E,B02,083774,Staff,11,0,30,19
1650306363001,MATH 103A,A01,083777,Staff,0,11,30,30
1650306363001,MATH 103A,A02,083778,Staff,0,10,30,30
1650306363001,MATH 103A,B01,083779,Staff,0,10,30,30
1650306363001,MATH 103A,B02,083780,Staff,0,10,30,30
1650306369023,MATH 105,A01,085443,Staff,0,17,30,30
1650306375049,MATH 109,A01,083213,Anzaldo; Leesa B,0,5,30,30
1650306375049,MATH 109,A02,083214,Anzaldo; Leesa B,0,6,30,30
1650306375049,MATH 109,B01,083215,Anzaldo; Leesa B,0,4,30,30
1650306375049,MATH 109,B02,083216,Anzaldo; Leesa B,0,4,30,30
1650306381073,MATH 142A,A01,083219,Chow; Bennett,0,14,30,30
1650306381073,MATH 142A,A02,083220,Chow; Bennett,0,11,30,30
1650306381073,MATH 142A,B01,083221,Chow; Bennett,0,11,30,30
1650306381073,MATH 142A,B02,083222,Chow; Bennett,0,12,30,30
1650306387097,MATH 193A,A01,083224,Staff,0,5,30,30
1650306387097,MATH 193A,A02,083225,Staff,0,5,30,30
1650306387097,MATH 193A,A03,083781,Staff,0,2,30,30
1650306387097,MATH 193A,A04,083782,Staff,0,2,30,30
1650306393121,MATH 197,001,091859,McAuley; Julian John,9998,0,9999,1
1650306399182,COGS 9,A01,083615,Staff,0,15,60,60
1650306405210,COGS 11,A01,083617,Boyle; Mary E. T.,23,0,40,17
1650306411236,COGS 13,A01,083071,Staff,0,31,40,40
1650306417262,COGS 14A,A01,092681,Staff,0,17,100,100
1650306423297,COGS 14B,A01,083073,Cheng; Tzu-Han,0,10,50,50
1650306429320,COGS 17,A01,092677,Staff,26,0,75,49
1650306435347,COGS 100,A01,083619,Staff,0,23,60,60
1650306441374,COGS 101A,A01,083621,Davis; Joshua Daniel,0,22,60,60
1650306447397,COGS 101B,A01,091572,Staff,4,0,60,56
1650306453421,COGS 101C,A01,083625,Delgado; Tania,19,0,30,11
1650306459453,COGS 107A,A01,083627,Boyle; Mary E. T.,0,8,60,60
1650306465487,COGS 118A,A01,083075,Staff,5,0,60,55
1650306471514,CSE 3,A50,083646,Miranda; Gregory Joseph,21,0,38,17
1650306471514,CSE 3,A51,083647,Miranda; Gregory Joseph,37,0,37,0
1650306477536,CSE 8A,A50,083650,Miranda; Gregory Joseph,0,25,40,40
1650306483562,CSE 11,A01,083080,Cao; Yingjun,0,82,40,40
1650306489585,CSE 12,A01,083652,Staff,0,10,100,100
1650306495621,CSE 15L,A01,083654,Staff,0,1,50,50
1650306495621,CSE 15L,A02,083655,Staff,4,0,50,46
1650306501643,CSE 20,A01,083657,Staff,53,0,80,27
1650306507665,CSE 30,A01,083084,Eldon; John,0,74,40,40
1650306513690,CSE 100,A01,083659,Cao; Yingjun,0,65,50,50
1650306519715,CSE 134B,A01,083661,Powell; Thomas Allan,0,29,65,65
1650306525746,CSE 140,A01,083663,Staff,0,0,75,75
1650306531774,CSE 140L,A01,083088,Eldon; John,0,6,75,75
1650306537798,CSE 175,A01,083665,Kumar; Rakesh,8,0,25,17
1650306543826,CSE 190,A00,092507,Dubnov; Shlomo,14,0,20,6
1650306549853,ECE 45,A01,083139,Staff,0,16,40,40
1650306555877,ECE 65,A50,083695,Staff,0,4,30,30
1650306562016,ECE 109,A01,091882,Touri; Behrouz,42,0,70,28
1650306568046,ECE 180,A00,083140,Abi Samra; Nicholas Camill,23,0,30,7
1650306568046,ECE 180,B00,083141,Abi Samra; Nicholas Camill,6,0,30,24
1650306574069,MATH 10A,A01,083735,Patchell; Gregory David,10,0,30,20
1650306574069,MATH 10A,A02,083736,Patchell; Gregory David,28,0,30,2
1650306574069,MATH 10A,A03,083737,Patchell; Gregory David,26,0,30,4
1650306580092,MATH 10B,A01,083207,Staff,0,6,30,30
1650306580092,MATH 10B,A02,083208,Staff,0,6,30,30
1650306580092,MATH 10B,B01,083739,Staff,17,0,30,13
1650306580092,MATH 10B,B02,083740,Staff,28,0,30,2
1650306586122,MATH 18,A01,083743,Staff,6,0,30,24
1650306586122,MATH 18,A02,083744,Staff,26,0,30,4
1650306586122,MATH 18,A03,083745,Staff,22,0,30,8
1650306586122,MATH 18,A04,083746,Staff,27,0,30,3
1650306586122,MATH 18,B01,083748,Staff,0,11,30,30
1650306586122,MATH 18,B02,083749,Staff,0,10,30,30
1650306586122,MATH 18,B03,083750,Staff,1,9,30,29
1650306586122,MATH 18,B04,083751,Staff,0,10,30,30
1650306592149,MATH 20A,A01,083754,Staff,25,0,40,15
1650306598177,MATH 20B,A01,083756,Staff,0,5,30,30
1650306598177,MATH 20B,A02,083757,Staff,0,7,30,30
1650306604206,MATH 20C,A01,083760,Staff,0,13,30,30
1650306604206,MATH 20C,A02,083761,Staff,0,13,30,30
1650306604206,MATH 20C,B01,083762,Staff,13,0,30,17
1650306604206,MATH 20C,B02,083763,Staff,28,0,30,2
1650306610228,MATH 20D,A01,083765,Staff,0,1,30,30
1650306610228,MATH 20D,A02,083766,Staff,8,0,30,22
1650306610228,MATH 20D,A03,083767,Staff,27,0,30,3
1650306616260,MATH 20E,A01,083771,Staff,6,0,30,24
1650306616260,MATH 20E,A02,083772,Staff,19,0,30,11
1650306616260,MATH 20E,B01,083773,Staff,0,0,30,30
1650306616260,MATH 20E,B02,083774,Staff,11,0,30,19
1650306622284,MATH 103A,A01,083777,Staff,0,11,30,30
1650306622284,MATH 103A,A02,083778,Staff,0,10,30,30
1650306622284,MATH 103A,B01,083779,Staff,0,10,30,30
1650306622284,MATH 103A,B02,083780,Staff,0,10,30,30
1650306628311,MATH 105,A01,085443,Staff,0,17,30,30
1650306634353,MATH 109,A01,083213,Anzaldo; Leesa B,0,5,30,30
1650306634353,MATH 109,A02,083214,Anzaldo; Leesa B,0,6,30,30
1650306634353,MATH 109,B01,083215,Anzaldo; Leesa B,0,4,30,30
1650306634353,MATH 109,B02,083216,Anzaldo; Leesa B,0,4,30,30
1650306640381,MATH 142A,A01,083219,Chow; Bennett,0,14,30,30
1650306640381,MATH 142A,A02,083220,Chow; Bennett,0,11,30,30
1650306640381,MATH 142A,B01,083221,Chow; Bennett,0,11,30,30
1650306640381,MATH 142A,B02,083222,Chow; Bennett,0,12,30,30
1650306646405,MATH 193A,A01,083224,Staff,0,5,30,30
1650306646405,MATH 193A,A02,083225,Staff,0,5,30,30
1650306646405,MATH 193A,A03,083781,Staff,0,2,30,30
1650306646405,MATH 193A,A04,083782,Staff,0,2,30,30
1650306652438,MATH 197,001,091859,McAuley; Julian John,9998,0,9999,1
1650306658489,COGS 9,A01,083615,Staff,0,15,60,60
1650306664526,COGS 11,A01,083617,Boyle; Mary E. T.,23,0,40,17
1650306670552,COGS 13,A01,083071,Staff,0,31,40,40
1650306676575,COGS 14A,A01,092681,Staff,0,17,100,100
1650306682604,COGS 14B,A01,083073,Cheng; Tzu-Han,0,10,50,50
1650306688640,COGS 17,A01,092677,Staff,26,0,75,49
1650306694662,COGS 100,A01,083619,Staff,0,23,60,60
1650306700690,COGS 101A,A01,083621,Davis; Joshua Daniel,0,22,60,60
1650306706719,COGS 101B,A01,091572,Staff,4,0,60,56
1650306712773,COGS 101C,A01,083625,Delgado; Tania,19,0,30,11
1650306718800,COGS 107A,A01,083627,Boyle; Mary E. T.,0,8,60,60
1650306724837,COGS 118A,A01,083075,Staff,5,0,60,55
1650306730873,CSE 3,A50,083646,Miranda; Gregory Joseph,21,0,38,17
1650306730873,CSE 3,A51,083647,Miranda; Gregory Joseph,37,0,37,0
1650306736907,CSE 8A,A50,083650,Miranda; Gregory Joseph,0,25,40,40
1650306742936,CSE 11,A01,083080,Cao; Yingjun,0,82,40,40
1650306748975,CSE 12,A01,083652,Staff,0,10,100,100
1650306754999,CSE 15L,A01,083654,Staff,0,1,50,50
1650306754999,CSE 15L,A02,083655,Staff,4,0,50,46
1650306761032,CSE 20,A01,083657,Staff,53,0,80,27
1650306767057,CSE 30,A01,083084,Eldon; John,0,74,40,40
1650306773083,CSE 100,A01,083659,Cao; Yingjun,0,65,50,50
1650306779106,CSE 134B,A01,083661,Powell; Thomas Allan,0,29,65,65
1650306785129,CSE 140,A01,083663,Staff,0,0,75,75
1650306791153,CSE 140L,A01,083088,Eldon; John,0,6,75,75
1650306797176,CSE 175,A01,083665,Kumar; Rakesh,8,0,25,17
1650306803199,CSE 190,A00,092507,Dubnov; Shlomo,14,0,20,6
1650306809226,ECE 45,A01,083139,Staff,0,16,40,40
1650306815252,ECE 65,A50,083695,Staff,0,4,30,30
1650306821289,ECE 109,A01,091882,Touri; Behrouz,42,0,70,28
1650306827314,ECE 180,A00,083140,Abi Samra; Nicholas Camill,23,0,30,7
1650306827314,ECE 180,B00,083141,Abi Samra; Nicholas Camill,6,0,30,24
1650306833338,MATH 10A,A01,083735,Patchell; Gregory David,10,0,30,20
1650306833338,MATH 10A,A02,083736,Patchell; Gregory David,28,0,30,2
1650306833338,MATH 10A,A03,083737,Patchell; Gregory David,26,0,30,4
1650306839365,MATH 10B,A01,083207,Staff,0,6,30,30
1650306839365,MATH 10B,A02,083208,Staff,0,6,30,30
1650306839365,MATH 10B,B01,083739,Staff,17,0,30,13
1650306839365,MATH 10B,B02,083740,Staff,28,0,30,2
1650306845389,MATH 18,A01,083743,Staff,6,0,30,24
1650306845389,MATH 18,A02,083744,Staff,26,0,30,4
1650306845389,MATH 18,A03,083745,Staff,22,0,30,8
1650306845389,MATH 18,A04,083746,Staff,27,0,30,3
1650306845389,MATH 18,B01,083748,Staff,0,11,30,30
1650306845389,MATH 18,B02,083749,Staff,0,10,30,30
1650306845389,MATH 18,B03,083750,Staff,1,9,30,29
1650306845389,MATH 18,B04,083751,Staff,0,10,30,30
1650306851412,MATH 20A,A01,083754,Staff,25,0,40,15
1650306857436,MATH 20B,A01,083756,Staff,0,5,30,30
1650306857436,MATH 20B,A02,083757,Staff,0,7,30,30
1650306863464,MATH 20C,A01,083760,Staff,0,13,30,30
1650306863464,MATH 20C,A02,083761,Staff,0,13,30,30
1650306863464,MATH 20C,B01,083762,Staff,13,0,30,17
1650306863464,MATH 20C,B02,083763,Staff,28,0,30,2
1650306869487,MATH 20D,A01,083765,Staff,0,1,30,30
1650306869487,MATH 20D,A02,083766,Staff,8,0,30,22
1650306869487,MATH 20D,A03,083767,Staff,27,0,30,3
1650306875515,MATH 20E,A01,083771,Staff,6,0,30,24
1650306875515,MATH 20E,A02,083772,Staff,19,0,30,11
1650306875515,MATH 20E,B01,083773,Staff,0,0,30,30
1650306875515,MATH 20E,B02,083774,Staff,11,0,30,19
1650306881551,MATH 103A,A01,083777,Staff,0,11,30,30
1650306881551,MATH 103A,A02,083778,Staff,0,10,30,30
1650306881551,MATH 103A,B01,083779,Staff,0,10,30,30
1650306881551,MATH 103A,B02,083780,Staff,0,10,30,30
1650306887575,MATH 105,A01,085443,Staff,0,17,30,30
1650306893599,MATH 109,A01,083213,Anzaldo; Leesa B,0,5,30,30
1650306893599,MATH 109,A02,083214,Anzaldo; Leesa B,0,6,30,30
1650306893599,MATH 109,B01,083215,Anzaldo; Leesa B,0,4,30,30
1650306893599,MATH 109,B02,083216,Anzaldo; Leesa B,0,4,30,30
1650306899624,MATH 142A,A01,083219,Chow; Bennett,0,14,30,30
1650306899624,MATH 142A,A02,083220,Chow; Bennett,0,11,30,30
1650306899624,MATH 142A,B01,083221,Chow; Bennett,0,11,30,30
1650306899624,MATH 142A,B02,083222,Chow; Bennett,0,12,30,30
1650306905650,MATH 193A,A01,083224,Staff,0,5,30,30
1650306905650,MATH 193A,A02,083225,Staff,0,5,30,30
1650306905650,MATH 193A,A03,083781,Staff,0,2,30,30
1650306905650,MATH 193A,A04,083782,Staff,0,2,30,30
1650306911672,MATH 197,001,091859,McAuley; Julian John,9998,0,9999,1
1650306917733,COGS 9,A01,083615,Staff,0,15,60,60
1650306923760,COGS 11,A01,083617,Boyle; Mary E. T.,23,0,40,17
1650306929788,COGS 13,A01,083071,Staff,0,31,40,40
1650306935813,COGS 14A,A01,092681,Staff,0,17,100,100
1650306941835,COGS 14B,A01,083073,Cheng; Tzu-Han,0,10,50,50
1650306947874,COGS 17,A01,092677,Staff,26,0,75,49
1650306953898,COGS 100,A01,083619,Staff,0,23,60,60
1650306959921,COGS 101A,A01,083621,Davis; Joshua Daniel,0,22,60,60
1650306965944,COGS 101B,A01,091572,Staff,4,0,60,56
1650306971969,COGS 101C,A01,083625,Delgado; Tania,19,0,30,11
1650306978008,COGS 107A,A01,083627,Boyle; Mary E. T.,0,8,60,60
1650306984030,COGS 118A,A01,083075,Staff,5,0,60,55
1650306990081,CSE 3,A50,083646,Miranda; Gregory Joseph,21,0,38,17
1650306990081,CSE 3,A51,083647,Miranda; Gregory Joseph,37,0,37,0
1650306996104,CSE 8A,A50,083650,Miranda; Gregory Joseph,0,25,40,40
1650307002129,CSE 11,A01,083080,Cao; Yingjun,0,82,40,40
1650307008166,CSE 12,A01,083652,Staff,0,10,100,100
1650307014190,CSE 15L,A01,083654,Staff,0,1,50,50
1650307014190,CSE 15L,A02,083655,Staff,4,0,50,46
1650307020213,CSE 20,A01,083657,Staff,53,0,80,27
1650307026241,CSE 30,A01,083084,Eldon; John,0,74,40,40
1650307032280,CSE 100,A01,083659,Cao; Yingjun,0,65,50,50
1650307038308,CSE 134B,A01,083661,Powell; Thomas Allan,0,29,65,65
1650307044333,CSE 140,A01,083663,Staff,0,0,75,75
1650307050359,CSE 140L,A01,083088,Eldon; John,0,6,75,75
1650307056389,CSE 175,A01,083665,Kumar; Rakesh,8,0,25,17
1650307062416,CSE 190,A00,092507,Dubnov; Shlomo,14,0,20,6
1650307068443,ECE 45,A01,083139,Staff,0,16,40,40
1650307074465,ECE 65,A50,083695,Staff,0,4,30,30
1650307080489,ECE 109,A01,091882,Touri; Behrouz,42,0,70,28
1650307086511,ECE 180,A00,083140,Abi Samra; Nicholas Camill,23,0,30,7
1650307086511,ECE 180,B00,083141,Abi Samra; Nicholas Camill,6,0,30,24
1650307092536,MATH 10A,A01,083735,Patchell; Gregory David,10,0,30,20
1650307092536,MATH 10A,A02,083736,Patchell; Gregory David,28,0,30,2
1650307092536,MATH 10A,A03,083737,Patchell; Gregory David,26,0,30,4
1650307098563,MATH 10B,A01,083207,Staff,0,6,30,30
1650307098563,MATH 10B,A02,083208,Staff,0,6,30,30
1650307098563,MATH 10B,B01,083739,Staff,17,0,30,13
1650307098563,MATH 10B,B02,083740,Staff,28,0,30,2
1650307104594,MATH 18,A01,083743,Staff,6,0,30,24
1650307104594,MATH 18,A02,083744,Staff,26,0,30,4
1650307104594,MATH 18,A03,083745,Staff,22,0,30,8
1650307104594,MATH 18,A04,083746,Staff,27,0,30,3
1650307104594,MATH 18,B01,083748,Staff,0,11,30,30
1650307104594,MATH 18,B02,083749,Staff,0,10,30,30
1650307104594,MATH 18,B03,083750,Staff,1,9,30,29
1650307104594,MATH 18,B04,083751,Staff,0,10,30,30
1650307110617,MATH 20A,A01,083754,Staff,25,0,40,15
1650307116639,MATH 20B,A01,083756,Staff,0,5,30,30
1650307116639,MATH 20B,A02,083757,Staff,0,7,30,30
1650307122664,MATH 20C,A01,083760,Staff,0,13,30,30
1650307122664,MATH 20C,A02,083761,Staff,0,13,30,30
1650307122664,MATH 20C,B01,083762,Staff,13,0,30,17
1650307122664,MATH 20C,B02,083763,Staff,28,0,30,2
1650307128696,MATH 20D,A01,083765,Staff,0,1,30,30
1650307128696,MATH 20D,A02,083766,Staff,8,0,30,22
1650307128696,MATH 20D,A03,083767,Staff,27,0,30,3
1650307134719,MATH 20E,A01,083771,Staff,6,0,30,24
1650307134719,MATH 20E,A02,083772,Staff,19,0,30,11
1650307134719,MATH 20E,B01,083773,Staff,0,0,30,30
1650307134719,MATH 20E,B02,083774,Staff,11,0,30,19
1650307140749,MATH 103A,A01,083777,Staff,0,11,30,30
1650307140749,MATH 103A,A02,083778,Staff,0,10,30,30
1650307140749,MATH 103A,B01,083779,Staff,0,10,30,30
1650307140749,MATH 103A,B02,083780,Staff,0,10,30,30
1650307146779,MATH 105,A01,085443,Staff,0,17,30,30
1650307152802,MATH 109,A01,083213,Anzaldo; Leesa B,0,5,30,30
1650307152802,MATH 109,A02,083214,Anzaldo; Leesa B,0,6,30,30
1650307152802,MATH 109,B01,083215,Anzaldo; Leesa B,0,4,30,30
1650307152802,MATH 109,B02,083216,Anzaldo; Leesa B,0,4,30,30
1650307158916,MATH 142A,A01,083219,Chow; Bennett,0,14,30,30
1650307158916,MATH 142A,A02,083220,Chow; Bennett,0,11,30,30
1650307158916,MATH 142A,B01,083221,Chow; Bennett,0,11,30,30
1650307158916,MATH 142A,B02,083222,Chow; Bennett,0,12,30,30
1650307164940,MATH 193A,A01,083224,Staff,0,5,30,30
1650307164940,MATH 193A,A02,083225,Staff,0,5,30,30
1650307164940,MATH 193A,A03,083781,Staff,0,2,30,30
1650307164940,MATH 193A,A04,083782,Staff,0,2,30,30
1650307170965,MATH 197,001,091859,McAuley; Julian John,9998,0,9999,1
1650307177028,COGS 9,A01,083615,Staff,0,15,60,60
1650307183052,COGS 11,A01,083617,Boyle; Mary E. T.,23,0,40,17
1650307189084,COGS 13,A01,083071,Staff,0,31,40,40
1650307195111,COGS 14A,A01,092681,Staff,0,17,100,100
1650307201135,COGS 14B,A01,083073,Cheng; Tzu-Han,0,10,50,50
1650307207158,COGS 17,A01,092677,Staff,26,0,75,49
1650307213197,COGS 100,A01,083619,Staff,0,23,60,60
1650307219220,COGS 101A,A01,083621,Davis; Joshua Daniel,0,22,60,60
1650307225253,COGS 101B,A01,091572,Staff,3,0,60,57
1650307231278,COGS 101C,A01,083625,Delgado; Tania,19,0,30,11
1650307237300,COGS 107A,A01,083627,Boyle; Mary E. T.,0,8,60,60
1650307243331,COGS 118A,A01,083075,Staff,5,0,60,55
1650307249354,CSE 3,A50,083646,Miranda; Gregory Joseph,21,0,38,17
1650307249354,CSE 3,A51,083647,Miranda; Gregory Joseph,37,0,37,0
1650307255376,CSE 8A,A50,083650,Miranda; Gregory Joseph,0,25,40,40
1650307261402,CSE 11,A01,083080,Cao; Yingjun,0,82,40,40
1650307267426,CSE 12,A01,083652,Staff,0,10,100,100
1650307273466,CSE 15L,A01,083654,Staff,0,1,50,50
1650307273466,CSE 15L,A02,083655,Staff,4,0,50,46
1650307279493,CSE 20,A01,083657,Staff,53,0,80,27
1650307285520,CSE 30,A01,083084,Eldon; John,0,74,40,40
1650307291543,CSE 100,A01,083659,Cao; Yingjun,0,65,50,50
1650307297574,CSE 134B,A01,083661,Powell; Thomas Allan,0,29,65,65
1650307303600,CSE 140,A01,083663,Staff,0,0,75,75
1650307309623,CSE 140L,A01,083088,Eldon; John,0,6,75,75
1650307315662,CSE 175,A01,083665,Kumar; Rakesh,8,0,25,17
1650307321688,CSE 190,A00,092507,Dubnov; Shlomo,14,0,20,6
1650307327711,ECE 45,A01,083139,Staff,0,16,40,40
1650307333740,ECE 65,A50,083695,Staff,0,4,30,30
1650307339773,ECE 109,A01,091882,Touri; Behrouz,42,0,70,28
1650307345797,ECE 180,A00,083140,Abi Samra; Nicholas Camill,23,0,30,7
1650307345797,ECE 180,B00,083141,Abi Samra; Nicholas Camill,6,0,30,24
1650307351822,MATH 10A,A01,083735,Patchell; Gregory David,10,0,30,20
1650307351822,MATH 10A,A02,083736,Patchell; Gregory David,28,0,30,2
1650307351822,MATH 10A,A03,083737,Patchell; Gregory David,26,0,30,4
1650307357849,MATH 10B,A01,083207,Staff,0,6,30,30
1650307357849,MATH 10B,A02,083208,Staff,0,6,30,30
1650307357849,MATH 10B,B01,083739,Staff,17,0,30,13
1650307357849,MATH 10B,B02,083740,Staff,28,0,30,2
1650307363880,MATH 18,A01,083743,Staff,6,0,30,24
1650307363880,MATH 18,A02,083744,Staff,26,0,30,4
1650307363880,MATH 18,A03,083745,Staff,22,0,30,8
1650307363880,MATH 18,A04,083746,Staff,27,0,30,3
1650307363880,MATH 18,B01,083748,Staff,0,11,30,30
1650307363880,MATH 18,B02,083749,Staff,0,10,30,30
1650307363880,MATH 18,B03,083750,Staff,1,9,30,29
1650307363880,MATH 18,B04,083751,Staff,0,10,30,30
1650307369904,MATH 20A,A01,083754,Staff,25,0,40,15
1650307375934,MATH 20B,A01,083756,Staff,0,5,30,30
1650307375934,MATH 20B,A02,083757,Staff,0,7,30,30
1650307381966,MATH 20C,A01,083760,Staff,0,13,30,30
1650307381966,MATH 20C,A02,083761,Staff,0,13,30,30
1650307381966,MATH 20C,B01,083762,Staff,13,0,30,17
1650307381966,MATH 20C,B02,083763,Staff,28,0,30,2
1650307387993,MATH 20D,A01,083765,Staff,0,1,30,30
1650307387993,MATH 20D,A02,083766,Staff,8,0,30,22
1650307387993,MATH 20D,A03,083767,Staff,27,0,30,3
1650307394026,MATH 20E,A01,083771,Staff,6,0,30,24
1650307394026,MATH 20E,A02,083772,Staff,19,0,30,11
1650307394026,MATH 20E,B01,083773,Staff,0,0,30,30
1650307394026,MATH 20E,B02,083774,Staff,11,0,30,19
1650307400054,MATH 103A,A01,083777,Staff,0,11,30,30
1650307400054,MATH 103A,A02,083778,Staff,0,10,30,30
1650307400054,MATH 103A,B01,083779,Staff,0,10,30,30
1650307400054,MATH 103A,B02,083780,Staff,0,10,30,30
1650307406079,MATH 105,A01,085443,Staff,0,17,30,30
1650307412113,MATH 109,A01,083213,Anzaldo; Leesa B,0,5,30,30
1650307412113,MATH 109,A02,083214,Anzaldo; Leesa B,0,6,30,30
1650307412113,MATH 109,B01,083215,Anzaldo; Leesa B,0,4,30,30
1650307412113,MATH 109,B02,083216,Anzaldo; Leesa B,0,4,30,30
1650307418138,MATH 142A,A01,083219,Chow; Bennett,0,14,30,30
1650307418138,MATH 142A,A02,083220,Chow; Bennett,0,11,30,30
1650307418138,MATH 142A,B01,083221,Chow; Bennett,0,11,30,30
1650307418138,MATH 142A,B02,083222,Chow; Bennett,0,12,30,30
1650307424172,MATH 193A,A01,083224,Staff,0,5,30,30
1650307424172,MATH 193A,A02,083225,Staff,0,5,30,30
1650307424172,MATH 193A,A03,083781,Staff,0,2,30,30
1650307424172,MATH 193A,A04,083782,Staff,0,2,30,30
1650307430196,MATH 197,001,091859,McAuley; Julian John,9998,0,9999,1
1650307436267,COGS 9,A01,083615,Staff,0,15,60,60
1650307442294,COGS 11,A01,083617,Boyle; Mary E. T.,23,0,40,17
1650307448336,COGS 13,A01,083071,Staff,0,31,40,40
1650307454365,COGS 14A,A01,092681,Staff,0,17,100,100
1650307460397,COGS 14B,A01,083073,Cheng; Tzu-Han,0,10,50,50
1650307466421,COGS 17,A01,092677,Staff,26,0,75,49
1650307472445,COGS 100,A01,083619,Staff,0,23,60,60
1650307478469,COGS 101A,A01,083621,Davis; Joshua Daniel,0,22,60,60
1650307484492,COGS 101B,A01,091572,Staff,3,0,60,57
1650307490522,COGS 101C,A01,083625,Delgado; Tania,19,0,30,11
1650307496550,COGS 107A,A01,083627,Boyle; Mary E. T.,0,8,60,60
1650307502574,COGS 118A,A01,083075,Staff,5,0,60,55
1650307508602,CSE 3,A50,083646,Miranda; Gregory Joseph,21,0,38,17
1650307508602,CSE 3,A51,083647,Miranda; Gregory Joseph,37,0,37,0
1650307514631,CSE 8A,A50,083650,Miranda; Gregory Joseph,0,25,40,40
1650307520655,CSE 11,A01,083080,Cao; Yingjun,0,82,40,40
1650307526684,CSE 12,A01,083652,Staff,0,10,100,100
1650307532716,CSE 15L,A01,083654,Staff,0,1,50,50
1650307532716,CSE 15L,A02,083655,Staff,4,0,50,46
1650307538744,CSE 20,A01,083657,Staff,53,0,80,27
1650307544770,CSE 30,A01,083084,Eldon; John,0,74,40,40
1650307550804,CSE 100,A01,083659,Cao; Yingjun,0,65,50,50
1650307556829,CSE 134B,A01,083661,Powell; Thomas Allan,0,29,65,65
1650307562860,CSE 140,A01,083663,Staff,0,0,75,75
1650307568886,CSE 140L,A01,083088,Eldon; John,0,6,75,75
1650307574917,CSE 175,A01,083665,Kumar; Rakesh,8,0,25,17
1650307580943,CSE 190,A00,092507,Dubnov; Shlomo,14,0,20,6
1650307586970,ECE 45,A01,083139,Staff,0,16,40,40
1650307592998,ECE 65,A50,083695,Staff,0,4,30,30
1650307599024,ECE 109,A01,091882,Touri; Behrouz,42,0,70,28
1650307605048,ECE 180,A00,083140,Abi Samra; Nicholas Camill,23,0,30,7
1650307605048,ECE 180,B00,083141,Abi Samra; Nicholas Camill,6,0,30,24
1650307611073,MATH 10A,A01,083735,Patchell; Gregory David,10,0,30,20
1650307611073,MATH 10A,A02,083736,Patchell; Gregory David,28,0,30,2
1650307611073,MATH 10A,A03,083737,Patchell; Gregory David,26,0,30,4
1650307617102,MATH 10B,A01,083207,Staff,0,6,30,30
1650307617102,MATH 10B,A02,083208,Staff,0,6,30,30
1650307617102,MATH 10B,B01,083739,Staff,17,0,30,13
1650307617102,MATH 10B,B02,083740,Staff,28,0,30,2
1650307623141,MATH 18,A01,083743,Staff,6,0,30,24
1650307623141,MATH 18,A02,083744,Staff,26,0,30,4
1650307623141,MATH 18,A03,083745,Staff,22,0,30,8
1650307623141,MATH 18,A04,083746,Staff,27,0,30,3
1650307623141,MATH 18,B01,083748,Staff,0,11,30,30
1650307623141,MATH 18,B02,083749,Staff,0,10,30,30
1650307623141,MATH 18,B03,083750,Staff,1,9,30,29
1650307623141,MATH 18,B04,083751,Staff,0,10,30,30
1650307629165,MATH 20A,A01,083754,Staff,25,0,40,15
1650307635190,MATH 20B,A01,083756,Staff,0,5,30,30
1650307635190,MATH 20B,A02,083757,Staff,0,7,30,30
1650307641221,MATH 20C,A01,083760,Staff,0,13,30,30
1650307641221,MATH 20C,A02,083761,Staff,0,13,30,30
1650307641221,MATH 20C,B01,083762,Staff,13,0,30,17
1650307641221,MATH 20C,B02,083763,Staff,28,0,30,2
1650307647245,MATH 20D,A01,083765,Staff,0,1,30,30
1650307647245,MATH 20D,A02,083766,Staff,8,0,30,22
1650307647245,MATH 20D,A03,083767,Staff,27,0,30,3
1650307653271,MATH 20E,A01,083771,Staff,6,0,30,24
1650307653271,MATH 20E,A02,083772,Staff,19,0,30,11
1650307653271,MATH 20E,B01,083773,Staff,0,0,30,30
1650307653271,MATH 20E,B02,083774,Staff,11,0,30,19
1650307659295,MATH 103A,A01,083777,Staff,0,11,30,30
1650307659295,MATH 103A,A02,083778,Staff,0,10,30,30
1650307659295,MATH 103A,B01,083779,Staff,0,11,30,30
1650307659295,MATH 103A,B02,083780,Staff,0,10,30,30
1650307665325,MATH 105,A01,085443,Staff,0,17,30,30
1650307671349,MATH 109,A01,083213,Anzaldo; Leesa B,0,5,30,30
1650307671349,MATH 109,A02,083214,Anzaldo; Leesa B,0,6,30,30
1650307671349,MATH 109,B01,083215,Anzaldo; Leesa B,0,4,30,30
1650307671349,MATH 109,B02,083216,Anzaldo; Leesa B,0,4,30,30
1650307677377,MATH 142A,A01,083219,Chow; Bennett,0,14,30,30
1650307677377,MATH 142A,A02,083220,Chow; Bennett,0,11,30,30
1650307677377,MATH 142A,B01,083221,Chow; Bennett,0,11,30,30
1650307677377,MATH 142A,B02,083222,Chow; Bennett,0,12,30,30
1650307683401,MATH 193A,A01,083224,Staff,0,5,30,30
1650307683401,MATH 193A,A02,083225,Staff,0,5,30,30
1650307683401,MATH 193A,A03,083781,Staff,0,2,30,30
1650307683401,MATH 193A,A04,083782,Staff,0,2,30,30
1650307689427,MATH 197,001,091859,McAuley; Julian John,9998,0,9999,1
1650307695500,COGS 9,A01,083615,Staff,0,15,60,60
1650307701526,COGS 11,A01,083617,Boyle; Mary E. T.,23,0,40,17
1650307707552,COGS 13,A01,083071,Staff,0,31,40,40
1650307713577,COGS 14A,A01,092681,Staff,0,17,100,100
1650307719609,COGS 14B,A01,083073,Cheng; Tzu-Han,0,10,50,50
1650307725631,COGS 17,A01,092677,Staff,26,0,75,49
1650307731657,COGS 100,A01,083619,Staff,0,23,60,60
1650307737690,COGS 101A,A01,083621,Davis; Joshua Daniel,0,22,60,60
1650307743722,COGS 101B,A01,091572,Staff,3,0,60,57
1650307749838,COGS 101C,A01,083625,Delgado; Tania,19,0,30,11
1650307755874,COGS 107A,A01,083627,Boyle; Mary E. T.,0,8,60,60
1650307761900,COGS 118A,A01,083075,Staff,5,0,60,55
1650307767924,CSE 3,A50,083646,Miranda; Gregory Joseph,21,0,38,17
1650307767924,CSE 3,A51,083647,Miranda; Gregory Joseph,37,0,37,0
1650307773952,CSE 8A,A50,083650,Miranda; Gregory Joseph,0,25,40,40
1650307779983,CSE 11,A01,083080,Cao; Yingjun,0,82,40,40
1650307786008,CSE 12,A01,083652,Staff,0,10,100,100
1650307792035,CSE 15L,A01,083654,Staff,0,1,50,50
1650307792035,CSE 15L,A02,083655,Staff,4,0,50,46
1650307798072,CSE 20,A01,083657,Staff,53,0,80,27
1650307804097,CSE 30,A01,083084,Eldon; John,0,74,40,40
1650307810123,CSE 100,A01,083659,Cao; Yingjun,0,65,50,50
1650307816147,CSE 134B,A01,083661,Powell; Thomas Allan,0,29,65,65
1650307822185,CSE 140,A01,083663,Staff,0,0,75,75
1650307828222,CSE 140L,A01,083088,Eldon; John,0,6,75,75
1650307834252,CSE 175,A01,083665,Kumar; Rakesh,8,0,25,17
1650307840275,CSE 190,A00,092507,Dubnov; Shlomo,14,0,20,6
1650307846301,ECE 45,A01,083139,Staff,0,16,40,40
1650307852333,ECE 65,A50,083695,Staff,0,4,30,30
1650307858364,ECE 109,A01,091882,Touri; Behrouz,42,0,70,28
1650307864392,ECE 180,A00,083140,Abi Samra; Nicholas Camill,23,0,30,7
1650307864392,ECE 180,B00,083141,Abi Samra; Nicholas Camill,6,0,30,24
1650307870421,MATH 10A,A01,083735,Patchell; Gregory David,10,0,30,20
1650307870421,MATH 10A,A02,083736,Patchell; Gregory David,28,0,30,2
1650307870421,MATH 10A,A03,083737,Patchell; Gregory David,26,0,30,4
1650307876448,MATH 10B,A01,083207,Staff,0,6,30,30
1650307876448,MATH 10B,A02,083208,Staff,0,6,30,30
1650307876448,MATH 10B,B01,083739,Staff,17,0,30,13
1650307876448,MATH 10B,B02,083740,Staff,28,0,30,2
1650307882477,MATH 18,A01,083743,Staff,6,0,30,24
1650307882477,MATH 18,A02,083744,Staff,26,0,30,4
1650307882477,MATH 18,A03,083745,Staff,22,0,30,8
1650307882477,MATH 18,A04,083746,Staff,27,0,30,3
1650307882477,MATH 18,B01,083748,Staff,0,11,30,30
1650307882477,MATH 18,B02,083749,Staff,0,10,30,30
1650307882477,MATH 18,B03,083750,Staff,1,9,30,29
1650307882477,MATH 18,B04,083751,Staff,0,10,30,30
1650307888508,MATH 20A,A01,083754,Staff,25,0,40,15
1650307894532,MATH 20B,A01,083756,Staff,0,5,30,30
1650307894532,MATH 20B,A02,083757,Staff,0,7,30,30
1650307900560,MATH 20C,A01,083760,Staff,0,13,30,30
1650307900560,MATH 20C,A02,083761,Staff,0,13,30,30
1650307900560,MATH 20C,B01,083762,Staff,13,0,30,17
1650307900560,MATH 20C,B02,083763,Staff,28,0,30,2
1650307906588,MATH 20D,A01,083765,Staff,0,1,30,30
1650307906588,MATH 20D,A02,083766,Staff,8,0,30,22
1650307906588,MATH 20D,A03,083767,Staff,27,0,30,3
1650307912616,MATH 20E,A01,083771,Staff,6,0,30,24
1650307912616,MATH 20E,A02,083772,Staff,19,0,30,11
1650307912616,MATH 20E,B01,083773,Staff,0,0,30,30
1650307912616,MATH 20E,B02,083774,Staff,11,0,30,19
1650307918642,MATH 103A,A01,083777,Staff,0,11,30,30
1650307918642,MATH 103A,A02,083778,Staff,0,10,30,30
1650307918642,MATH 103A,B01,083779,Staff,0,11,30,30
1650307918642,MATH 103A,B02,083780,Staff,0,10,30,30
1650307924669,MATH 105,A01,085443,Staff,0,17,30,30
1650307930693,MATH 109,A01,083213,Anzaldo; Leesa B,0,5,30,30
1650307930693,MATH 109,A02,083214,Anzaldo; Leesa B,0,6,30,30
1650307930693,MATH 109,B01,083215,Anzaldo; Leesa B,0,4,30,30
1650307930693,MATH 109,B02,083216,Anzaldo; Leesa B,0,4,30,30
1650307936718,MATH 142A,A01,083219,Chow; Bennett,0,14,30,30
1650307936718,MATH 142A,A02,083220,Chow; Bennett,0,11,30,30
1650307936718,MATH 142A,B01,083221,Chow; Bennett,0,11,30,30
1650307936718,MATH 142A,B02,083222,Chow; Bennett,0,12,30,30
1650307942756,MATH 193A,A01,083224,Staff,0,5,30,30
1650307942756,MATH 193A,A02,083225,Staff,0,5,30,30
1650307942756,MATH 193A,A03,083781,Staff,0,2,30,30
1650307942756,MATH 193A,A04,083782,Staff,0,2,30,30
1650307948783,MATH 197,001,091859,McAuley; Julian John,9998,0,9999,1
1650307954859,COGS 9,A01,083615,Staff,0,15,60,60
1650307960890,COGS 11,A01,083617,Boyle; Mary E. T.,23,0,40,17
1650307966917,COGS 13,A01,083071,Staff,0,31,40,40
1650307972941,COGS 14A,A01,092681,Staff,0,17,100,100
1650307978965,COGS 14B,A01,083073,Cheng; Tzu-Han,0,10,50,50
1650307984996,COGS 17,A01,092677,Staff,26,0,75,49
1650307991021,COGS 100,A01,083619,Staff,0,23,60,60
1650307997084,COGS 101A,A01,083621,Davis; Joshua Daniel,0,22,60,60
1650308003110,COGS 101B,A01,091572,Staff,3,0,60,57
1650308009138,COGS 101C,A01,083625,Delgado; Tania,19,0,30,11
1650308015161,COGS 107A,A01,083627,Boyle; Mary E. T.,0,8,60,60
1650308021187,COGS 118A,A01,083075,Staff,5,0,60,55
1650308027210,CSE 3,A50,083646,Miranda; Gregory Joseph,21,0,38,17
1650308027210,CSE 3,A51,083647,Miranda; Gregory Joseph,37,0,37,0
1650308033241,CSE 8A,A50,083650,Miranda; Gregory Joseph,0,25,40,40
1650308039268,CSE 11,A01,083080,Cao; Yingjun,0,82,40,40
1650308045292,CSE 12,A01,083652,Staff,0,10,100,100
1650308051333,CSE 15L,A01,083654,Staff,0,1,50,50
1650308051333,CSE 15L,A02,083655,Staff,4,0,50,46
1650308057363,CSE 20,A01,083657,Staff,53,0,80,27
1650308063386,CSE 30,A01,083084,Eldon; John,0,74,40,40
1650308069409,CSE 100,A01,083659,Cao; Yingjun,0,65,50,50
1650308075441,CSE 134B,A01,083661,Powell; Thomas Allan,0,29,65,65
1650308081469,CSE 140,A01,083663,Staff,0,0,75,75
1650308087491,CSE 140L,A01,083088,Eldon; John,0,6,75,75
1650308093516,CSE 175,A01,083665,Kumar; Rakesh,8,0,25,17
1650308099544,CSE 190,A00,092507,Dubnov; Shlomo,14,0,20,6
1650308105567,ECE 45,A01,083139,Staff,0,16,40,40
1650308111593,ECE 65,A50,083695,Staff,0,4,30,30
1650308117620,ECE 109,A01,091882,Touri; Behrouz,42,0,70,28
1650308123654,ECE 180,A00,083140,Abi Samra; Nicholas Camill,23,0,30,7
1650308123654,ECE 180,B00,083141,Abi Samra; Nicholas Camill,6,0,30,24
1650308129694,MATH 10A,A01,083735,Patchell; Gregory David,10,0,30,20
1650308129694,MATH 10A,A02,083736,Patchell; Gregory David,28,0,30,2
1650308129694,MATH 10A,A03,083737,Patchell; Gregory David,26,0,30,4
1650308135721,MATH 10B,A01,083207,Staff,0,6,30,30
1650308135721,MATH 10B,A02,083208,Staff,0,6,30,30
1650308135721,MATH 10B,B01,083739,Staff,17,0,30,13
1650308135721,MATH 10B,B02,083740,Staff,28,0,30,2
1650308141751,MATH 18,A01,083743,Staff,6,0,30,24
1650308141751,MATH 18,A02,083744,Staff,26,0,30,4
1650308141751,MATH 18,A03,083745,Staff,22,0,30,8
1650308141751,MATH 18,A04,083746,Staff,27,0,30,3
1650308141751,MATH 18,B01,083748,Staff,0,11,30,30
1650308141751,MATH 18,B02,083749,Staff,0,10,30,30
1650308141751,MATH 18,B03,083750,Staff,1,9,30,29
1650308141751,MATH 18,B04,083751,Staff,0,10,30,30
1650308147775,MATH 20A,A01,083754,Staff,25,0,40,15
1650308153801,MATH 20B,A01,083756,Staff,0,5,30,30
1650308153801,MATH 20B,A02,083757,Staff,0,7,30,30
1650308159829,MATH 20C,A01,083760,Staff,0,13,30,30
1650308159829,MATH 20C,A02,083761,Staff,0,13,30,30
1650308159829,MATH 20C,B01,083762,Staff,13,0,30,17
1650308159829,MATH 20C,B02,083763,Staff,28,0,30,2
1650308165854,MATH 20D,A01,083765,Staff,0,1,30,30
1650308165854,MATH 20D,A02,083766,Staff,8,0,30,22
1650308165854,MATH 20D,A03,083767,Staff,27,0,30,3
1650308171883,MATH 20E,A01,083771,Staff,6,0,30,24
1650308171883,MATH 20E,A02,083772,Staff,19,0,30,11
1650308171883,MATH 20E,B01,083773,Staff,0,0,30,30
1650308171883,MATH 20E,B02,083774,Staff,11,0,30,19
1650308177919,MATH 103A,A01,083777,Staff,0,11,30,30
1650308177919,MATH 103A,A02,083778,Staff,0,10,30,30
1650308177919,MATH 103A,B01,083779,Staff,0,11,30,30
1650308177919,MATH 103A,B02,083780,Staff,0,10,30,30
1650308183942,MATH 105,A01,085443,Staff,0,17,30,30
1650308189970,MATH 109,A01,083213,Anzaldo; Leesa B,0,5,30,30
1650308189970,MATH 109,A02,083214,Anzaldo; Leesa B,0,6,30,30
1650308189970,MATH 109,B01,083215,Anzaldo; Leesa B,0,4,30,30
1650308189970,MATH 109,B02,083216,Anzaldo; Leesa B,0,4,30,30
1650308196000,MATH 142A,A01,083219,Chow; Bennett,0,14,30,30
1650308196000,MATH 142A,A02,083220,Chow; Bennett,0,11,30,30
1650308196000,MATH 142A,B01,083221,Chow; Bennett,0,11,30,30
1650308196000,MATH 142A,B02,083222,Chow; Bennett,0,12,30,30
1650308202030,MATH 193A,A01,083224,Staff,0,5,30,30
1650308202030,MATH 193A,A02,083225,Staff,0,5,30,30
1650308202030,MATH 193A,A03,083781,Staff,0,2,30,30
1650308202030,MATH 193A,A04,083782,Staff,0,2,30,30
1650308208053,MATH 197,001,091859,McAuley; Julian John,9998,0,9999,1
1650308214118,COGS 9,A01,083615,Staff,0,15,60,60
1650308220142,COGS 11,A01,083617,Boyle; Mary E. T.,23,0,40,17
1650308226173,COGS 13,A01,083071,Staff,0,31,40,40
1650308232196,COGS 14A,A01,092681,Staff,0,17,100,100
1650308238223,COGS 14B,A01,083073,Cheng; Tzu-Han,0,10,50,50
1650308244253,COGS 17,A01,092677,Staff,26,0,75,49
1650308250281,COGS 100,A01,083619,Staff,0,23,60,60
1650308256304,COGS 101A,A01,083621,Davis; Joshua Daniel,0,22,60,60
1650308262328,COGS 101B,A01,091572,Staff,3,0,60,57
1650308268355,COGS 101C,A01,083625,Delgado; Tania,19,0,30,11
1650308274380,COGS 107A,A01,083627,Boyle; Mary E. T.,0,8,60,60
1650308280406,COGS 118A,A01,083075,Staff,5,0,60,55
1650308286433,CSE 3,A50,083646,Miranda; Gregory Joseph,21,0,38,17
1650308286433,CSE 3,A51,083647,Miranda; Gregory Joseph,37,0,37,0
1650308292463,CSE 8A,A50,083650,Miranda; Gregory Joseph,0,25,40,40
1650308298486,CSE 11,A01,083080,Cao; Yingjun,0,82,40,40
1650308304509,CSE 12,A01,083652,Staff,0,10,100,100
1650308310535,CSE 15L,A01,083654,Staff,0,1,50,50
1650308310535,CSE 15L,A02,083655,Staff,4,0,50,46
1650308316592,CSE 20,A01,083657,Staff,53,0,80,27
1650308322613,CSE 30,A01,083084,Eldon; John,0,74,40,40
1650308328638,CSE 100,A01,083659,Cao; Yingjun,0,65,50,50
1650308334663,CSE 134B,A01,083661,Powell; Thomas Allan,0,29,65,65
1650308340694,CSE 140,A01,083663,Staff,0,0,75,75
1650308346819,CSE 140L,A01,083088,Eldon; John,0,6,75,75
1650308352842,CSE 175,A01,083665,Kumar; Rakesh,8,0,25,17
1650308358869,CSE 190,A00,092507,Dubnov; Shlomo,14,0,20,6
1650308364898,ECE 45,A01,083139,Staff,0,16,40,40
1650308370922,ECE 65,A50,083695,Staff,0,4,30,30
1650308376945,ECE 109,A01,091882,Touri; Behrouz,42,0,70,28
1650308382976,ECE 180,A00,083140,Abi Samra; Nicholas Camill,23,0,30,7
1650308382976,ECE 180,B00,083141,Abi Samra; Nicholas Camill,6,0,30,24
1650308389000,MATH 10A,A01,083735,Patchell; Gregory David,10,0,30,20
1650308389000,MATH 10A,A02,083736,Patchell; Gregory David,28,0,30,2
1650308389000,MATH 10A,A03,083737,Patchell; Gregory David,26,0,30,4
1650308395030,MATH 10B,A01,083207,Staff,0,6,30,30
1650308395030,MATH 10B,A02,083208,Staff,0,6,30,30
1650308395030,MATH 10B,B01,083739,Staff,17,0,30,13
1650308395030,MATH 10B,B02,083740,Staff,28,0,30,2
1650308401063,MATH 18,A01,083743,Staff,6,0,30,24
1650308401063,MATH 18,A02,083744,Staff,26,0,30,4
1650308401063,MATH 18,A03,083745,Staff,22,0,30,8
1650308401063,MATH 18,A04,083746,Staff,27,0,30,3
1650308401063,MATH 18,B01,083748,Staff,0,11,30,30
1650308401063,MATH 18,B02,083749,Staff,0,10,30,30
1650308401063,MATH 18,B03,083750,Staff,1,9,30,29
1650308401063,MATH 18,B04,083751,Staff,0,10,30,30
1650308407091,MATH 20A,A01,083754,Staff,25,0,40,15
1650308413126,MATH 20B,A01,083756,Staff,0,5,30,30
1650308413126,MATH 20B,A02,083757,Staff,0,7,30,30
1650308419156,MATH 20C,A01,083760,Staff,0,13,30,30
1650308419156,MATH 20C,A02,083761,Staff,0,13,30,30
1650308419156,MATH 20C,B01,083762,Staff,13,0,30,17
1650308419156,MATH 20C,B02,083763,Staff,28,0,30,2
1650308425187,MATH 20D,A01,083765,Staff,0,1,30,30
1650308425187,MATH 20D,A02,083766,Staff,8,0,30,22
1650308425187,MATH 20D,A03,083767,Staff,27,0,30,3
1650308431210,MATH 20E,A01,083771,Staff,6,0,30,24
1650308431210,MATH 20E,A02,083772,Staff,19,0,30,11
1650308431210,MATH 20E,B01,083773,Staff,0,0,30,30
1650308431210,MATH 20E,B02,083774,Staff,11,0,30,19
1650308437246,MATH 103A,A01,083777,Staff,0,11,30,30
1650308437246,MATH 103A,A02,083778,Staff,0,10,30,30
1650308437246,MATH 103A,B01,083779,Staff,0,11,30,30
1650308437246,MATH 103A,B02,083780,Staff,0,10,30,30
1650308443277,MATH 105,A01,085443,Staff,0,17,30,30
1650308449301,MATH 109,A01,083213,Anzaldo; Leesa B,0,5,30,30
1650308449301,MATH 109,A02,083214,Anzaldo; Leesa B,0,6,30,30
1650308449301,MATH 109,B01,083215,Anzaldo; Leesa B,0,4,30,30
1650308449301,MATH 109,B02,083216,Anzaldo; Leesa B,0,4,30,30
1650308455329,MATH 142A,A01,083219,Chow; Bennett,0,14,30,30
1650308455329,MATH 142A,A02,083220,Chow; Bennett,0,11,30,30
1650308455329,MATH 142A,B01,083221,Chow; Bennett,0,11,30,30
1650308455329,MATH 142A,B02,083222,Chow; Bennett,0,12,30,30
1650308461356,MATH 193A,A01,083224,Staff,0,5,30,30
1650308461356,MATH 193A,A02,083225,Staff,0,5,30,30
1650308461356,MATH 193A,A03,083781,Staff,0,2,30,30
1650308461356,MATH 193A,A04,083782,Staff,0,2,30,30
1650308467379,MATH 197,001,091859,McAuley; Julian John,9998,0,9999,1
1650308473447,COGS 9,A01,083615,Staff,0,15,60,60
1650308479470,COGS 11,A01,083617,Boyle; Mary E. T.,23,0,40,17
1650308485494,COGS 13,A01,083071,Staff,0,31,40,40
1650308491516,COGS 14A,A01,092681,Staff,0,17,100,100
1650308497543,COGS 14B,A01,083073,Cheng; Tzu-Han,0,10,50,50
1650308503567,COGS 17,A01,092677,Staff,26,0,75,49
1650308509593,COGS 100,A01,083619,Staff,0,23,60,60
1650308515619,COGS 101A,A01,083621,Davis; Joshua Daniel,0,22,60,60
1650308521651,COGS 101B,A01,091572,Staff,3,0,60,57
1650308527677,COGS 101C,A01,083625,Delgado; Tania,19,0,30,11
1650308533709,COGS 107A,A01,083627,Boyle; Mary E. T.,0,8,60,60
1650308539732,COGS 118A,A01,083075,Staff,5,0,60,55
1650308545761,CSE 3,A50,083646,Miranda; Gregory Joseph,21,0,38,17
1650308545761,CSE 3,A51,083647,Miranda; Gregory Joseph,37,0,37,0
1650308551783,CSE 8A,A50,083650,Miranda; Gregory Joseph,0,25,40,40
1650308557807,CSE 11,A01,083080,Cao; Yingjun,0,82,40,40
1650308563843,CSE 12,A01,083652,Staff,0,10,100,100
1650308569867,CSE 15L,A01,083654,Staff,0,1,50,50
1650308569867,CSE 15L,A02,083655,Staff,4,0,50,46
1650308575891,CSE 20,A01,083657,Staff,53,0,80,27
1650308581915,CSE 30,A01,083084,Eldon; John,0,74,40,40
1650308587950,CSE 100,A01,083659,Cao; Yingjun,0,65,50,50
1650308593978,CSE 134B,A01,083661,Powell; Thomas Allan,0,29,65,65
1650308600005,CSE 140,A01,083663,Staff,0,0,75,75
1650308606028,CSE 140L,A01,083088,Eldon; John,0,6,75,75
1650308612052,CSE 175,A01,083665,Kumar; Rakesh,8,0,25,17
1650308618076,CSE 190,A00,092507,Dubnov; Shlomo,14,0,20,6
1650308624102,ECE 45,A01,083139,Staff,0,16,40,40
1650308630128,ECE 65,A50,083695,Staff,0,5,30,30
1650308636163,ECE 109,A01,091882,Touri; Behrouz,42,0,70,28
1650308642197,ECE 180,A00,083140,Abi Samra; Nicholas Camill,23,0,30,7
1650308642197,ECE 180,B00,083141,Abi Samra; Nicholas Camill,6,0,30,24
1650308648221,MATH 10A,A01,083735,Patchell; Gregory David,10,0,30,20
1650308648221,MATH 10A,A02,083736,Patchell; Gregory David,28,0,30,2
1650308648221,MATH 10A,A03,083737,Patchell; Gregory David,26,0,30,4
1650308654246,MATH 10B,A01,083207,Staff,0,6,30,30
1650308654246,MATH 10B,A02,083208,Staff,0,6,30,30
1650308654246,MATH 10B,B01,083739,Staff,17,0,30,13
1650308654246,MATH 10B,B02,083740,Staff,28,0,30,2
1650308660270,MATH 18,A01,083743,Staff,6,0,30,24
1650308660270,MATH 18,A02,083744,Staff,26,0,30,4
1650308660270,MATH 18,A03,083745,Staff,22,0,30,8
1650308660270,MATH 18,A04,083746,Staff,27,0,30,3
1650308660270,MATH 18,B01,083748,Staff,0,11,30,30
1650308660270,MATH 18,B02,083749,Staff,0,10,30,30
1650308660270,MATH 18,B03,083750,Staff,1,9,30,29
1650308660270,MATH 18,B04,083751,Staff,0,10,30,30
1650308666293,MATH 20A,A01,083754,Staff,25,0,40,15
1650308672328,MATH 20B,A01,083756,Staff,0,5,30,30
1650308672328,MATH 20B,A02,083757,Staff,0,7,30,30
1650308678353,MATH 20C,A01,083760,Staff,0,13,30,30
1650308678353,MATH 20C,A02,083761,Staff,0,13,30,30
1650308678353,MATH 20C,B01,083762,Staff,13,0,30,17
1650308678353,MATH 20C,B02,083763,Staff,28,0,30,2
1650308684380,MATH 20D,A01,083765,Staff,0,1,30,30
1650308684380,MATH 20D,A02,083766,Staff,8,0,30,22
1650308684380,MATH 20D,A03,083767,Staff,27,0,30,3
1650308690403,MATH 20E,A01,083771,Staff,6,0,30,24
1650308690403,MATH 20E,A02,083772,Staff,19,0,30,11
1650308690403,MATH 20E,B01,083773,Staff,0,0,30,30
1650308690403,MATH 20E,B02,083774,Staff,11,0,30,19
1650308696432,MATH 103A,A01,083777,Staff,0,11,30,30
1650308696432,MATH 103A,A02,083778,Staff,0,10,30,30
1650308696432,MATH 103A,B01,083779,Staff,0,11,30,30
1650308696432,MATH 103A,B02,083780,Staff,0,10,30,30
1650308702459,MATH 105,A01,085443,Staff,0,17,30,30
1650308708495,MATH 109,A01,083213,Anzaldo; Leesa B,0,5,30,30
1650308708495,MATH 109,A02,083214,Anzaldo; Leesa B,0,6,30,30
1650308708495,MATH 109,B01,083215,Anzaldo; Leesa B,0,4,30,30
1650308708495,MATH 109,B02,083216,Anzaldo; Leesa B,0,4,30,30
1650308714525,MATH 142A,A01,083219,Chow; Bennett,0,14,30,30
1650308714525,MATH 142A,A02,083220,Chow; Bennett,0,11,30,30
1650308714525,MATH 142A,B01,083221,Chow; Bennett,0,11,30,30
1650308714525,MATH 142A,B02,083222,Chow; Bennett,0,12,30,30
1650308720553,MATH 193A,A01,083224,Staff,0,5,30,30
1650308720553,MATH 193A,A02,083225,Staff,0,5,30,30
1650308720553,MATH 193A,A03,083781,Staff,0,2,30,30
1650308720553,MATH 193A,A04,083782,Staff,0,2,30,30
1650308726579,MATH 197,001,091859,McAuley; Julian John,9998,0,9999,1
1650308732638,COGS 9,A01,083615,Staff,0,15,60,60
1650308738663,COGS 11,A01,083617,Boyle; Mary E. T.,23,0,40,17
1650308744695,COGS 13,A01,083071,Staff,0,31,40,40
1650308750725,COGS 14A,A01,092681,Staff,0,17,100,100
1650308756769,COGS 14B,A01,083073,Cheng; Tzu-Han,0,10,50,50
1650308762791,COGS 17,A01,092677,Staff,26,0,75,49
1650308768815,COGS 100,A01,083619,Staff,0,23,60,60
1650308774839,COGS 101A,A01,083621,Davis; Joshua Daniel,0,22,60,60
1650308780874,COGS 101B,A01,091572,Staff,3,0,60,57
1650308786907,COGS 101C,A01,083625,Delgado; Tania,19,0,30,11
1650308792941,COGS 107A,A01,083627,Boyle; Mary E. T.,0,8,60,60
1650308798965,COGS 118A,A01,083075,Staff,5,0,60,55
1650308804995,CSE 3,A50,083646,Miranda; Gregory Joseph,21,0,38,17
1650308804995,CSE 3,A51,083647,Miranda; Gregory Joseph,37,0,37,0
1650308811018,CSE 8A,A50,083650,Miranda; Gregory Joseph,0,25,40,40
1650308817042,CSE 11,A01,083080,Cao; Yingjun,0,82,40,40
1650308823066,CSE 12,A01,083652,Staff,0,10,100,100
1650308829091,CSE 15L,A01,083654,Staff,0,1,50,50
1650308829091,CSE 15L,A02,083655,Staff,4,0,50,46
1650308835116,CSE 20,A01,083657,Staff,53,0,80,27
1650308841146,CSE 30,A01,083084,Eldon; John,0,74,40,40
1650308847178,CSE 100,A01,083659,Cao; Yingjun,0,65,50,50
1650308853210,CSE 134B,A01,083661,Powell; Thomas Allan,0,30,65,65
1650308859233,CSE 140,A01,083663,Staff,0,0,75,75
1650308865258,CSE 140L,A01,083088,Eldon; John,0,6,75,75
1650308871283,CSE 175,A01,083665,Kumar; Rakesh,8,0,25,17
1650308877309,CSE 190,A00,092507,Dubnov; Shlomo,14,0,20,6
1650308883337,ECE 45,A01,083139,Staff,0,16,40,40
1650308889361,ECE 65,A50,083695,Staff,0,5,30,30
1650308895388,ECE 109,A01,091882,Touri; Behrouz,42,0,70,28
1650308901410,ECE 180,A00,083140,Abi Samra; Nicholas Camill,23,0,30,7
1650308901410,ECE 180,B00,083141,Abi Samra; Nicholas Camill,6,0,30,24
1650308907438,MATH 10A,A01,083735,Patchell; Gregory David,10,0,30,20
1650308907438,MATH 10A,A02,083736,Patchell; Gregory David,28,0,30,2
1650308907438,MATH 10A,A03,083737,Patchell; Gregory David,26,0,30,4
1650308913466,MATH 10B,A01,083207,Staff,0,6,30,30
1650308913466,MATH 10B,A02,083208,Staff,0,6,30,30
1650308913466,MATH 10B,B01,083739,Staff,17,0,30,13
1650308913466,MATH 10B,B02,083740,Staff,28,0,30,2
1650308919506,MATH 18,A01,083743,Staff,6,0,30,24
1650308919506,MATH 18,A02,083744,Staff,26,0,30,4
1650308919506,MATH 18,A03,083745,Staff,22,0,30,8
1650308919506,MATH 18,A04,083746,Staff,27,0,30,3
1650308919506,MATH 18,B01,083748,Staff,0,11,30,30
1650308919506,MATH 18,B02,083749,Staff,0,10,30,30
1650308919506,MATH 18,B03,083750,Staff,1,9,30,29
1650308919506,MATH 18,B04,083751,Staff,0,10,30,30
1650308925529,MATH 20A,A01,083754,Staff,25,0,40,15
1650308931554,MATH 20B,A01,083756,Staff,0,5,30,30
1650308931554,MATH 20B,A02,083757,Staff,0,7,30,30
1650308937581,MATH 20C,A01,083760,Staff,0,13,30,30
1650308937581,MATH 20C,A02,083761,Staff,0,13,30,30
1650308937581,MATH 20C,B01,083762,Staff,13,0,30,17
1650308937581,MATH 20C,B02,083763,Staff,28,0,30,2
1650308943700,MATH 20D,A01,083765,Staff,0,1,30,30
1650308943700,MATH 20D,A02,083766,Staff,8,0,30,22
1650308943700,MATH 20D,A03,083767,Staff,27,0,30,3
1650308949739,MATH 20E,A01,083771,Staff,6,0,30,24
1650308949739,MATH 20E,A02,083772,Staff,19,0,30,11
1650308949739,MATH 20E,B01,083773,Staff,0,0,30,30
1650308949739,MATH 20E,B02,083774,Staff,11,0,30,19
1650308955762,MATH 103A,A01,083777,Staff,0,11,30,30
1650308955762,MATH 103A,A02,083778,Staff,0,10,30,30
1650308955762,MATH 103A,B01,083779,Staff,0,11,30,30
1650308955762,MATH 103A,B02,083780,Staff,0,10,30,30
1650308961788,MATH 105,A01,085443,Staff,0,17,30,30
1650308967810,MATH 109,A01,083213,Anzaldo; Leesa B,0,5,30,30
1650308967810,MATH 109,A02,083214,Anzaldo; Leesa B,0,6,30,30
1650308967810,MATH 109,B01,083215,Anzaldo; Leesa B,0,4,30,30
1650308967810,MATH 109,B02,083216,Anzaldo; Leesa B,0,4,30,30
1650308973835,MATH 142A,A01,083219,Chow; Bennett,0,14,30,30
1650308973835,MATH 142A,A02,083220,Chow; Bennett,0,11,30,30
1650308973835,MATH 142A,B01,083221,Chow; Bennett,0,11,30,30
1650308973835,MATH 142A,B02,083222,Chow; Bennett,0,12,30,30
1650308979864,MATH 193A,A01,083224,Staff,0,5,30,30
1650308979864,MATH 193A,A02,083225,Staff,0,5,30,30
1650308979864,MATH 193A,A03,083781,Staff,0,2,30,30
1650308979864,MATH 193A,A04,083782,Staff,0,2,30,30
1650308985887,MATH 197,001,091859,McAuley; Julian John,9998,0,9999,1
1650308991959,COGS 9,A01,083615,Staff,0,15,60,60
1650308997983,COGS 11,A01,083617,Boyle; Mary E. T.,23,0,40,17
1650309004007,COGS 13,A01,083071,Staff,0,31,40,40
1650309010034,COGS 14A,A01,092681,Staff,0,17,100,100
1650309016059,COGS 14B,A01,083073,Cheng; Tzu-Han,0,10,50,50
1650309022083,COGS 17,A01,092677,Staff,26,0,75,49
1650309028106,COGS 100,A01,083619,Staff,0,23,60,60
1650309034130,COGS 101A,A01,083621,Davis; Joshua Daniel,0,22,60,60
1650309040154,COGS 101B,A01,091572,Staff,3,0,60,57
1650309046181,COGS 101C,A01,083625,Delgado; Tania,19,0,30,11
1650309052211,COGS 107A,A01,083627,Boyle; Mary E. T.,0,8,60,60
1650309058243,COGS 118A,A01,083075,Staff,5,0,60,55
1650309064267,CSE 3,A50,083646,Miranda; Gregory Joseph,21,0,38,17
1650309064267,CSE 3,A51,083647,Miranda; Gregory Joseph,37,0,37,0
1650309070291,CSE 8A,A50,083650,Miranda; Gregory Joseph,0,25,40,40
1650309076333,CSE 11,A01,083080,Cao; Yingjun,0,82,40,40
1650309082357,CSE 12,A01,083652,Staff,0,10,100,100
1650309088383,CSE 15L,A01,083654,Staff,0,1,50,50
1650309088383,CSE 15L,A02,083655,Staff,4,0,50,46
1650309094407,CSE 20,A01,083657,Staff,53,0,80,27
1650309100433,CSE 30,A01,083084,Eldon; John,0,74,40,40
1650309106455,CSE 100,A01,083659,Cao; Yingjun,0,65,50,50
1650309112479,CSE 134B,A01,083661,Powell; Thomas Allan,0,30,65,65
1650309118505,CSE 140,A01,083663,Staff,0,0,75,75
1650309124531,CSE 140L,A01,083088,Eldon; John,0,6,75,75
1650309130565,CSE 175,A01,083665,Kumar; Rakesh,8,0,25,17
1650309136588,CSE 190,A00,092507,Dubnov; Shlomo,14,0,20,6
1650309142609,ECE 45,A01,083139,Staff,0,16,40,40
1650309148632,ECE 65,A50,083695,Staff,0,5,30,30
1650309154655,ECE 109,A01,091882,Touri; Behrouz,42,0,70,28
1650309160679,ECE 180,A00,083140,Abi Samra; Nicholas Camill,23,0,30,7
1650309160679,ECE 180,B00,083141,Abi Samra; Nicholas Camill,6,0,30,24
1650309166710,MATH 10A,A01,083735,Patchell; Gregory David,10,0,30,20
1650309166710,MATH 10A,A02,083736,Patchell; Gregory David,28,0,30,2
1650309166710,MATH 10A,A03,083737,Patchell; Gregory David,26,0,30,4
1650309172768,MATH 10B,A01,083207,Staff,0,6,30,30
1650309172768,MATH 10B,A02,083208,Staff,0,6,30,30
1650309172768,MATH 10B,B01,083739,Staff,17,0,30,13
1650309172768,MATH 10B,B02,083740,Staff,28,0,30,2
1650309178799,MATH 18,A01,083743,Staff,6,0,30,24
1650309178799,MATH 18,A02,083744,Staff,26,0,30,4
1650309178799,MATH 18,A03,083745,Staff,22,0,30,8
1650309178799,MATH 18,A04,083746,Staff,27,0,30,3
1650309178799,MATH 18,B01,083748,Staff,0,11,30,30
1650309178799,MATH 18,B02,083749,Staff,0,10,30,30
1650309178799,MATH 18,B03,083750,Staff,1,9,30,29
1650309178799,MATH 18,B04,083751,Staff,0,10,30,30
1650309184824,MATH 20A,A01,083754,Staff,25,0,40,15
1650309190848,MATH 20B,A01,083756,Staff,0,5,30,30
1650309190848,MATH 20B,A02,083757,Staff,0,7,30,30
1650309196871,MATH 20C,A01,083760,Staff,0,13,30,30
1650309196871,MATH 20C,A02,083761,Staff,0,13,30,30
1650309196871,MATH 20C,B01,083762,Staff,13,0,30,17
1650309196871,MATH 20C,B02,083763,Staff,28,0,30,2
1650309202895,MATH 20D,A01,083765,Staff,0,1,30,30
1650309202895,MATH 20D,A02,083766,Staff,8,0,30,22
1650309202895,MATH 20D,A03,083767,Staff,27,0,30,3
1650309208919,MATH 20E,A01,083771,Staff,6,0,30,24
1650309208919,MATH 20E,A02,083772,Staff,19,0,30,11
1650309208919,MATH 20E,B01,083773,Staff,0,0,30,30
1650309208919,MATH 20E,B02,083774,Staff,11,0,30,19
1650309214942,MATH 103A,A01,083777,Staff,0,11,30,30
1650309214942,MATH 103A,A02,083778,Staff,0,10,30,30
1650309214942,MATH 103A,B01,083779,Staff,0,11,30,30
1650309214942,MATH 103A,B02,083780,Staff,0,10,30,30
1650309220973,MATH 105,A01,085443,Staff,0,17,30,30
1650309227000,MATH 109,A01,083213,Anzaldo; Leesa B,0,5,30,30
1650309227000,MATH 109,A02,083214,Anzaldo; Leesa B,0,6,30,30
1650309227000,MATH 109,B01,083215,Anzaldo; Leesa B,0,4,30,30
1650309227000,MATH 109,B02,083216,Anzaldo; Leesa B,0,4,30,30
1650309233035,MATH 142A,A01,083219,Chow; Bennett,0,14,30,30
1650309233035,MATH 142A,A02,083220,Chow; Bennett,0,11,30,30
1650309233035,MATH 142A,B01,083221,Chow; Bennett,0,11,30,30
1650309233035,MATH 142A,B02,083222,Chow; Bennett,0,12,30,30
1650309239059,MATH 193A,A01,083224,Staff,0,5,30,30
1650309239059,MATH 193A,A02,083225,Staff,0,5,30,30
1650309239059,MATH 193A,A03,083781,Staff,0,2,30,30
1650309239059,MATH 193A,A04,083782,Staff,0,2,30,30
1650309245087,MATH 197,001,091859,McAuley; Julian John,9998,0,9999,1
1650309251147,COGS 9,A01,083615,Staff,0,15,60,60
1650309257174,COGS 11,A01,083617,Boyle; Mary E. T.,23,0,40,17
1650309263197,COGS 13,A01,083071,Staff,0,31,40,40
1650309269226,COGS 14A,A01,092681,Staff,0,17,100,100
1650309275252,COGS 14B,A01,083073,Cheng; Tzu-Han,0,10,50,50
1650309281273,COGS 17,A01,092677,Staff,26,0,75,49
1650309287297,COGS 100,A01,083619,Staff,0,23,60,60
1650309293321,COGS 101A,A01,083621,Davis; Joshua Daniel,0,22,60,60
1650309299348,COGS 101B,A01,091572,Staff,3,0,60,57
1650309305386,COGS 101C,A01,083625,Delgado; Tania,19,0,30,11
1650309311413,COGS 107A,A01,083627,Boyle; Mary E. T.,0,8,60,60
1650309317438,COGS 118A,A01,083075,Staff,5,0,60,55
1650309323472,CSE 3,A50,083646,Miranda; Gregory Joseph,21,0,38,17
1650309323472,CSE 3,A51,083647,Miranda; Gregory Joseph,37,0,37,0
1650309329499,CSE 8A,A50,083650,Miranda; Gregory Joseph,0,25,40,40
1650309335525,CSE 11,A01,083080,Cao; Yingjun,0,82,40,40
1650309341554,CSE 12,A01,083652,Staff,0,10,100,100
1650309347581,CSE 15L,A01,083654,Staff,0,1,50,50
1650309347581,CSE 15L,A02,083655,Staff,4,0,50,46
1650309353608,CSE 20,A01,083657,Staff,53,0,80,27
1650309359633,CSE 30,A01,083084,Eldon; John,0,74,40,40
1650309365655,CSE 100,A01,083659,Cao; Yingjun,0,65,50,50
1650309371678,CSE 134B,A01,083661,Powell; Thomas Allan,0,30,65,65
1650309377703,CSE 140,A01,083663,Staff,0,0,75,75
1650309383734,CSE 140L,A01,083088,Eldon; John,0,6,75,75
1650309389766,CSE 175,A01,083665,Kumar; Rakesh,8,0,25,17
1650309395790,CSE 190,A00,092507,Dubnov; Shlomo,14,0,20,6
1650309401820,ECE 45,A01,083139,Staff,0,16,40,40
1650309407855,ECE 65,A50,083695,Staff,0,5,30,30
1650309413885,ECE 109,A01,091882,Touri; Behrouz,42,0,70,28
1650309419911,ECE 180,A00,083140,Abi Samra; Nicholas Camill,23,0,30,7
1650309419911,ECE 180,B00,083141,Abi Samra; Nicholas Camill,6,0,30,24
1650309425945,MATH 10A,A01,083735,Patchell; Gregory David,10,0,30,20
1650309425945,MATH 10A,A02,083736,Patchell; Gregory David,28,0,30,2
1650309425945,MATH 10A,A03,083737,Patchell; Gregory David,26,0,30,4
1650309431974,MATH 10B,A01,083207,Staff,0,6,30,30
1650309431974,MATH 10B,A02,083208,Staff,0,6,30,30
1650309431974,MATH 10B,B01,083739,Staff,17,0,30,13
1650309431974,MATH 10B,B02,083740,Staff,28,0,30,2
1650309438006,MATH 18,A01,083743,Staff,6,0,30,24
1650309438006,MATH 18,A02,083744,Staff,26,0,30,4
1650309438006,MATH 18,A03,083745,Staff,22,0,30,8
1650309438006,MATH 18,A04,083746,Staff,27,0,30,3
1650309438006,MATH 18,B01,083748,Staff,0,11,30,30
1650309438006,MATH 18,B02,083749,Staff,0,10,30,30
1650309438006,MATH 18,B03,083750,Staff,1,9,30,29
1650309438006,MATH 18,B04,083751,Staff,0,10,30,30
1650309444030,MATH 20A,A01,083754,Staff,25,0,40,15
1650309450060,MATH 20B,A01,083756,Staff,0,5,30,30
1650309450060,MATH 20B,A02,083757,Staff,0,7,30,30
1650309456087,MATH 20C,A01,083760,Staff,0,13,30,30
1650309456087,MATH 20C,A02,083761,Staff,0,13,30,30
1650309456087,MATH 20C,B01,083762,Staff,13,0,30,17
1650309456087,MATH 20C,B02,083763,Staff,28,0,30,2
1650309462114,MATH 20D,A01,083765,Staff,0,1,30,30
1650309462114,MATH 20D,A02,083766,Staff,8,0,30,22
1650309462114,MATH 20D,A03,083767,Staff,27,0,30,3
1650309468138,MATH 20E,A01,083771,Staff,6,0,30,24
1650309468138,MATH 20E,A02,083772,Staff,19,0,30,11
1650309468138,MATH 20E,B01,083773,Staff,0,0,30,30
1650309468138,MATH 20E,B02,083774,Staff,11,0,30,19
1650309474167,MATH 103A,A01,083777,Staff,0,11,30,30
1650309474167,MATH 103A,A02,083778,Staff,0,10,30,30
1650309474167,MATH 103A,B01,083779,Staff,0,11,30,30
1650309474167,MATH 103A,B02,083780,Staff,0,10,30,30
1650309480192,MATH 105,A01,085443,Staff,0,17,30,30
1650309486224,MATH 109,A01,083213,Anzaldo; Leesa B,0,5,30,30
1650309486224,MATH 109,A02,083214,Anzaldo; Leesa B,0,6,30,30
1650309486224,MATH 109,B01,083215,Anzaldo; Leesa B,0,4,30,30
1650309486224,MATH 109,B02,083216,Anzaldo; Leesa B,0,4,30,30
1650309492258,MATH 142A,A01,083219,Chow; Bennett,0,14,30,30
1650309492258,MATH 142A,A02,083220,Chow; Bennett,0,11,30,30
1650309492258,MATH 142A,B01,083221,Chow; Bennett,0,11,30,30
1650309492258,MATH 142A,B02,083222,Chow; Bennett,0,12,30,30
1650309498290,MATH 193A,A01,083224,Staff,0,5,30,30
1650309498290,MATH 193A,A02,083225,Staff,0,5,30,30
1650309498290,MATH 193A,A03,083781,Staff,0,2,30,30
1650309498290,MATH 193A,A04,083782,Staff,0,3,30,30
1650309504314,MATH 197,001,091859,McAuley; Julian John,9998,0,9999,1
1650309510375,COGS 9,A01,083615,Staff,0,15,60,60
1650309516406,COGS 11,A01,083617,Boyle; Mary E. T.,23,0,40,17
1650309522431,COGS 13,A01,083071,Staff,0,31,40,40
1650309528454,COGS 14A,A01,092681,Staff,0,17,100,100
1650309534579,COGS 14B,A01,083073,Cheng; Tzu-Han,0,10,50,50
1650309540608,COGS 17,A01,092677,Staff,26,0,75,49
1650309546629,COGS 100,A01,083619,Staff,0,23,60,60
1650309552654,COGS 101A,A01,083621,Davis; Joshua Daniel,0,22,60,60
1650309558678,COGS 101B,A01,091572,Staff,3,0,60,57
1650309564700,COGS 101C,A01,083625,Delgado; Tania,19,0,30,11
1650309570727,COGS 107A,A01,083627,Boyle; Mary E. T.,0,8,60,60
1650309576755,COGS 118A,A01,083075,Staff,5,0,60,55
1650309582779,CSE 3,A50,083646,Miranda; Gregory Joseph,21,0,38,17
1650309582779,CSE 3,A51,083647,Miranda; Gregory Joseph,37,0,37,0
1650309588802,CSE 8A,A50,083650,Miranda; Gregory Joseph,0,25,40,40
1650309594824,CSE 11,A01,083080,Cao; Yingjun,0,82,40,40
1650309600847,CSE 12,A01,083652,Staff,0,10,100,100
1650309606888,CSE 15L,A01,083654,Staff,0,1,50,50
1650309606888,CSE 15L,A02,083655,Staff,4,0,50,46
1650309612915,CSE 20,A01,083657,Staff,53,0,80,27
1650309618941,CSE 30,A01,083084,Eldon; John,0,74,40,40
1650309624972,CSE 100,A01,083659,Cao; Yingjun,0,65,50,50
1650309630994,CSE 134B,A01,083661,Powell; Thomas Allan,0,30,65,65
1650309637020,CSE 140,A01,083663,Staff,0,0,75,75
1650309643052,CSE 140L,A01,083088,Eldon; John,0,6,75,75
1650309649078,CSE 175,A01,083665,Kumar; Rakesh,8,0,25,17
1650309655107,CSE 190,A00,092507,Dubnov; Shlomo,14,0,20,6
1650309661130,ECE 45,A01,083139,Staff,0,16,40,40
1650309667156,ECE 65,A50,083695,Staff,0,5,30,30
1650309673180,ECE 109,A01,091882,Touri; Behrouz,42,0,70,28
1650309679204,ECE 180,A00,083140,Abi Samra; Nicholas Camill,23,0,30,7
1650309679204,ECE 180,B00,083141,Abi Samra; Nicholas Camill,6,0,30,24
1650309685234,MATH 10A,A01,083735,Patchell; Gregory David,10,0,30,20
1650309685234,MATH 10A,A02,083736,Patchell; Gregory David,28,0,30,2
1650309685234,MATH 10A,A03,083737,Patchell; Gregory David,26,0,30,4
1650309691258,MATH 10B,A01,083207,Staff,0,6,30,30
1650309691258,MATH 10B,A02,083208,Staff,0,6,30,30
1650309691258,MATH 10B,B01,083739,Staff,17,0,30,13
1650309691258,MATH 10B,B02,083740,Staff,28,0,30,2
1650309697282,MATH 18,A01,083743,Staff,6,0,30,24
1650309697282,MATH 18,A02,083744,Staff,26,0,30,4
1650309697282,MATH 18,A03,083745,Staff,22,0,30,8
1650309697282,MATH 18,A04,083746,Staff,27,0,30,3
1650309697282,MATH 18,B01,083748,Staff,0,11,30,30
1650309697282,MATH 18,B02,083749,Staff,0,10,30,30
1650309697282,MATH 18,B03,083750,Staff,1,9,30,29
1650309697282,MATH 18,B04,083751,Staff,0,10,30,30
1650309703308,MATH 20A,A01,083754,Staff,25,0,40,15
1650309709330,MATH 20B,A01,083756,Staff,0,5,30,30
1650309709330,MATH 20B,A02,083757,Staff,0,7,30,30
1650309715363,MATH 20C,A01,083760,Staff,0,13,30,30
1650309715363,MATH 20C,A02,083761,Staff,0,13,30,30
1650309715363,MATH 20C,B01,083762,Staff,13,0,30,17
1650309715363,MATH 20C,B02,083763,Staff,28,0,30,2
1650309721391,MATH 20D,A01,083765,Staff,0,1,30,30
1650309721391,MATH 20D,A02,083766,Staff,8,0,30,22
1650309721391,MATH 20D,A03,083767,Staff,27,0,30,3
1650309727419,MATH 20E,A01,083771,Staff,6,0,30,24
1650309727419,MATH 20E,A02,083772,Staff,19,0,30,11
1650309727419,MATH 20E,B01,083773,Staff,0,0,30,30
1650309727419,MATH 20E,B02,083774,Staff,12,0,30,18
1650309733459,MATH 103A,A01,083777,Staff,0,11,30,30
1650309733459,MATH 103A,A02,083778,Staff,0,10,30,30
1650309733459,MATH 103A,B01,083779,Staff,0,11,30,30
1650309733459,MATH 103A,B02,083780,Staff,0,11,30,30
1650309739485,MATH 105,A01,085443,Staff,0,17,30,30
1650309745511,MATH 109,A01,083213,Anzaldo; Leesa B,0,5,30,30
1650309745511,MATH 109,A02,083214,Anzaldo; Leesa B,0,6,30,30
1650309745511,MATH 109,B01,083215,Anzaldo; Leesa B,0,4,30,30
1650309745511,MATH 109,B02,083216,Anzaldo; Leesa B,0,4,30,30
1650309751536,MATH 142A,A01,083219,Chow; Bennett,0,14,30,30
1650309751536,MATH 142A,A02,083220,Chow; Bennett,0,11,30,30
1650309751536,MATH 142A,B01,083221,Chow; Bennett,0,11,30,30
1650309751536,MATH 142A,B02,083222,Chow; Bennett,0,12,30,30
1650309757559,MATH 193A,A01,083224,Staff,0,5,30,30
1650309757559,MATH 193A,A02,083225,Staff,0,5,30,30
1650309757559,MATH 193A,A03,083781,Staff,0,2,30,30
1650309757559,MATH 193A,A04,083782,Staff,0,3,30,30
1650309763584,MATH 197,001,091859,McAuley; Julian John,9998,0,9999,1
1650309769643,COGS 9,A01,083615,Staff,0,15,60,60
1650309775684,COGS 11,A01,083617,Boyle; Mary E. T.,23,0,40,17
1650309781707,COGS 13,A01,083071,Staff,0,31,40,40
1650309787731,COGS 14A,A01,092681,Staff,0,17,100,100
1650309793758,COGS 14B,A01,083073,Cheng; Tzu-Han,0,10,50,50
1650309799784,COGS 17,A01,092677,Staff,26,0,75,49
1650309805811,COGS 100,A01,083619,Staff,0,23,60,60
1650309811838,COGS 101A,A01,083621,Davis; Joshua Daniel,0,22,60,60
1650309817864,COGS 101B,A01,091572,Staff,3,0,60,57
1650309823888,COGS 101C,A01,083625,Delgado; Tania,19,0,30,11
1650309829927,COGS 107A,A01,083627,Boyle; Mary E. T.,0,8,60,60
1650309835952,COGS 118A,A01,083075,Staff,5,0,60,55
1650309841988,CSE 3,A50,083646,Miranda; Gregory Joseph,21,0,38,17
1650309841988,CSE 3,A51,083647,Miranda; Gregory Joseph,37,0,37,0
1650309848012,CSE 8A,A50,083650,Miranda; Gregory Joseph,0,25,40,40
1650309854039,CSE 11,A01,083080,Cao; Yingjun,0,82,40,40
1650309860065,CSE 12,A01,083652,Staff,0,10,100,100
1650309866092,CSE 15L,A01,083654,Staff,0,1,50,50
1650309866092,CSE 15L,A02,083655,Staff,4,0,50,46
1650309872124,CSE 20,A01,083657,Staff,53,0,80,27
1650309878156,CSE 30,A01,083084,Eldon; John,0,74,40,40
1650309884179,CSE 100,A01,083659,Cao; Yingjun,0,65,50,50
1650309890203,CSE 134B,A01,083661,Powell; Thomas Allan,0,30,65,65
1650309896225,CSE 140,A01,083663,Staff,0,0,75,75
1650309902249,CSE 140L,A01,083088,Eldon; John,0,6,75,75
1650309908271,CSE 175,A01,083665,Kumar; Rakesh,8,0,25,17
1650309914295,CSE 190,A00,092507,Dubnov; Shlomo,14,0,20,6
1650309920319,ECE 45,A01,083139,Staff,0,16,40,40
1650309926341,ECE 65,A50,083695,Staff,0,5,30,30
1650309932365,ECE 109,A01,091882,Touri; Behrouz,42,0,70,28
1650309938396,ECE 180,A00,083140,Abi Samra; Nicholas Camill,23,0,30,7
1650309938396,ECE 180,B00,083141,Abi Samra; Nicholas Camill,6,0,30,24
1650309944423,MATH 10A,A01,083735,Patchell; Gregory David,10,0,30,20
1650309944423,MATH 10A,A02,083736,Patchell; Gregory David,28,0,30,2
1650309944423,MATH 10A,A03,083737,Patchell; Gregory David,26,0,30,4
1650309950446,MATH 10B,A01,083207,Staff,0,6,30,30
1650309950446,MATH 10B,A02,083208,Staff,0,6,30,30
1650309950446,MATH 10B,B01,083739,Staff,17,0,30,13
1650309950446,MATH 10B,B02,083740,Staff,28,0,30,2
1650309956479,MATH 18,A01,083743,Staff,6,0,30,24
1650309956479,MATH 18,A02,083744,Staff,26,0,30,4
1650309956479,MATH 18,A03,083745,Staff,22,0,30,8
1650309956479,MATH 18,A04,083746,Staff,27,0,30,3
1650309956479,MATH 18,B01,083748,Staff,0,11,30,30
1650309956479,MATH 18,B02,083749,Staff,0,10,30,30
1650309956479,MATH 18,B03,083750,Staff,1,9,30,29
1650309956479,MATH 18,B04,083751,Staff,0,10,30,30
1650309962503,MATH 20A,A01,083754,Staff,25,0,40,15
1650309968532,MATH 20B,A01,083756,Staff,0,5,30,30
1650309968532,MATH 20B,A02,083757,Staff,0,7,30,30
1650309974557,MATH 20C,A01,083760,Staff,0,13,30,30
1650309974557,MATH 20C,A02,083761,Staff,0,13,30,30
1650309974557,MATH 20C,B01,083762,Staff,13,0,30,17
1650309974557,MATH 20C,B02,083763,Staff,28,0,30,2
1650309980584,MATH 20D,A01,083765,Staff,0,1,30,30
1650309980584,MATH 20D,A02,083766,Staff,8,0,30,22
1650309980584,MATH 20D,A03,083767,Staff,27,0,30,3
1650309986610,MATH 20E,A01,083771,Staff,6,0,30,24
1650309986610,MATH 20E,A02,083772,Staff,19,0,30,11
1650309986610,MATH 20E,B01,083773,Staff,0,0,30,30
1650309986610,MATH 20E,B02,083774,Staff,12,0,30,18
1650309992634,MATH 103A,A01,083777,Staff,0,11,30,30
1650309992634,MATH 103A,A02,083778,Staff,0,10,30,30
1650309992634,MATH 103A,B01,083779,Staff,0,11,30,30
1650309992634,MATH 103A,B02,083780,Staff,0,11,30,30
1650309998661,MATH 105,A01,085443,Staff,0,17,30,30
1650310004699,MATH 109,A01,083213,Anzaldo; Leesa B,0,5,30,30
1650310004699,MATH 109,A02,083214,Anzaldo; Leesa B,0,6,30,30
1650310004699,MATH 109,B01,083215,Anzaldo; Leesa B,0,4,30,30
1650310004699,MATH 109,B02,083216,Anzaldo; Leesa B,0,4,30,30
1650310010723,MATH 142A,A01,083219,Chow; Bennett,0,14,30,30
1650310010723,MATH 142A,A02,083220,Chow; Bennett,0,11,30,30
1650310010723,MATH 142A,B01,083221,Chow; Bennett,0,11,30,30
1650310010723,MATH 142A,B02,083222,Chow; Bennett,0,12,30,30
1650310016746,MATH 193A,A01,083224,Staff,0,5,30,30
1650310016746,MATH 193A,A02,083225,Staff,0,5,30,30
1650310016746,MATH 193A,A03,083781,Staff,0,2,30,30
1650310016746,MATH 193A,A04,083782,Staff,0,3,30,30
1650310022772,MATH 197,001,091859,McAuley; Julian John,9998,0,9999,1
1650310028824,COGS 9,A01,083615,Staff,0,15,60,60
1650310034852,COGS 11,A01,083617,Boyle; Mary E. T.,23,0,40,17
1650310040875,COGS 13,A01,083071,Staff,0,31,40,40
1650310046904,COGS 14A,A01,092681,Staff,0,17,100,100
1650310052936,COGS 14B,A01,083073,Cheng; Tzu-Han,0,10,50,50
1650310058968,COGS 17,A01,092677,Staff,26,0,75,49
1650310064992,COGS 100,A01,083619,Staff,0,23,60,60
1650310071017,COGS 101A,A01,083621,Davis; Joshua Daniel,0,22,60,60
1650310077043,COGS 101B,A01,091572,Staff,3,0,60,57
1650310083082,COGS 101C,A01,083625,Delgado; Tania,19,0,30,11
1650310089116,COGS 107A,A01,083627,Boyle; Mary E. T.,0,8,60,60
1650310095141,COGS 118A,A01,083075,Staff,5,0,60,55
1650310101164,CSE 3,A50,083646,Miranda; Gregory Joseph,21,0,38,17
1650310101164,CSE 3,A51,083647,Miranda; Gregory Joseph,37,0,37,0
1650310107200,CSE 8A,A50,083650,Miranda; Gregory Joseph,0,25,40,40
1650310113224,CSE 11,A01,083080,Cao; Yingjun,0,82,40,40
1650310119249,CSE 12,A01,083652,Staff,0,10,100,100
1650310125286,CSE 15L,A01,083654,Staff,0,1,50,50
1650310125286,CSE 15L,A02,083655,Staff,4,0,50,46
1650310131401,CSE 20,A01,083657,Staff,53,0,80,27
1650310137427,CSE 30,A01,083084,Eldon; John,0,74,40,40
1650310143452,CSE 100,A01,083659,Cao; Yingjun,0,65,50,50
1650310149477,CSE 134B,A01,083661,Powell; Thomas Allan,0,30,65,65
1650310155502,CSE 140,A01,083663,Staff,0,0,75,75
1650310161527,CSE 140L,A01,083088,Eldon; John,0,6,75,75
1650310167554,CSE 175,A01,083665,Kumar; Rakesh,8,0,25,17
1650310173585,CSE 190,A00,092507,Dubnov; Shlomo,14,0,20,6
1650310179618,ECE 45,A01,083139,Staff,0,16,40,40
1650310185642,ECE 65,A50,083695,Staff,0,5,30,30
1650310191683,ECE 109,A01,091882,Touri; Behrouz,42,0,70,28
1650310197705,ECE 180,A00,083140,Abi Samra; Nicholas Camill,23,0,30,7
1650310197705,ECE 180,B00,083141,Abi Samra; Nicholas Camill,6,0,30,24
1650310203759,MATH 10A,A01,083735,Patchell; Gregory David,10,0,30,20
1650310203759,MATH 10A,A02,083736,Patchell; Gregory David,28,0,30,2
1650310203759,MATH 10A,A03,083737,Patchell; Gregory David,26,0,30,4
1650310209784,MATH 10B,A01,083207,Staff,0,6,30,30
1650310209784,MATH 10B,A02,083208,Staff,0,6,30,30
1650310209784,MATH 10B,B01,083739,Staff,17,0,30,13
1650310209784,MATH 10B,B02,083740,Staff,28,0,30,2
1650310215812,MATH 18,A01,083743,Staff,6,0,30,24
1650310215812,MATH 18,A02,083744,Staff,26,0,30,4
1650310215812,MATH 18,A03,083745,Staff,22,0,30,8
1650310215812,MATH 18,A04,083746,Staff,27,0,30,3
1650310215812,MATH 18,B01,083748,Staff,0,11,30,30
1650310215812,MATH 18,B02,083749,Staff,0,10,30,30
1650310215812,MATH 18,B03,083750,Staff,1,9,30,29
1650310215812,MATH 18,B04,083751,Staff,0,10,30,30
1650310221835,MATH 20A,A01,083754,Staff,25,0,40,15
1650310227862,MATH 20B,A01,083756,Staff,0,5,30,30
1650310227862,MATH 20B,A02,083757,Staff,0,7,30,30
1650310233887,MATH 20C,A01,083760,Staff,0,13,30,30
1650310233887,MATH 20C,A02,083761,Staff,0,13,30,30
1650310233887,MATH 20C,B01,083762,Staff,13,0,30,17
1650310233887,MATH 20C,B02,083763,Staff,28,0,30,2
1650310239914,MATH 20D,A01,083765,Staff,0,1,30,30
1650310239914,MATH 20D,A02,083766,Staff,8,0,30,22
1650310239914,MATH 20D,A03,083767,Staff,27,0,30,3
1650310245938,MATH 20E,A01,083771,Staff,6,0,30,24
1650310245938,MATH 20E,A02,083772,Staff,19,0,30,11
1650310245938,MATH 20E,B01,083773,Staff,0,0,30,30
1650310245938,MATH 20E,B02,083774,Staff,12,0,30,18
1650310251962,MATH 103A,A01,083777,Staff,0,11,30,30
1650310251962,MATH 103A,A02,083778,Staff,0,10,30,30
1650310251962,MATH 103A,B01,083779,Staff,0,11,30,30
1650310251962,MATH 103A,B02,083780,Staff,0,11,30,30
1650310257992,MATH 105,A01,085443,Staff,0,17,30,30
1650310264026,MATH 109,A01,083213,Anzaldo; Leesa B,0,5,30,30
1650310264026,MATH 109,A02,083214,Anzaldo; Leesa B,0,6,30,30
1650310264026,MATH 109,B01,083215,Anzaldo; Leesa B,0,4,30,30
1650310264026,MATH 109,B02,083216,Anzaldo; Leesa B,0,4,30,30
1650310270053,MATH 142A,A01,083219,Chow; Bennett,0,14,30,30
1650310270053,MATH 142A,A02,083220,Chow; Bennett,0,11,30,30
1650310270053,MATH 142A,B01,083221,Chow; Bennett,0,11,30,30
1650310270053,MATH 142A,B02,083222,Chow; Bennett,0,12,30,30
1650310276087,MATH 193A,A01,083224,Staff,0,5,30,30
1650310276087,MATH 193A,A02,083225,Staff,0,5,30,30
1650310276087,MATH 193A,A03,083781,Staff,0,2,30,30
1650310276087,MATH 193A,A04,083782,Staff,0,3,30,30
1650310282110,MATH 197,001,091859,McAuley; Julian John,9998,0,9999,1
1650310288184,COGS 9,A01,083615,Staff,0,15,60,60
1650310294207,COGS 11,A01,083617,Boyle; Mary E. T.,22,0,40,18
1650310300252,COGS 13,A01,083071,Staff,0,31,40,40
1650310306274,COGS 14A,A01,092681,Staff,0,17,100,100
1650310312301,COGS 14B,A01,083073,Cheng; Tzu-Han,0,10,50,50
1650310318325,COGS 17,A01,092677,Staff,26,0,75,49
1650310324347,COGS 100,A01,083619,Staff,0,23,60,60
1650310330383,COGS 101A,A01,083621,Davis; Joshua Daniel,0,22,60,60
1650310336405,COGS 101B,A01,091572,Staff,3,0,60,57
1650310342435,COGS 101C,A01,083625,Delgado; Tania,19,0,30,11
1650310348458,COGS 107A,A01,083627,Boyle; Mary E. T.,0,8,60,60
1650310354486,COGS 118A,A01,083075,Staff,5,0,60,55
1650310360510,CSE 3,A50,083646,Miranda; Gregory Joseph,21,0,38,17
1650310360510,CSE 3,A51,083647,Miranda; Gregory Joseph,37,0,37,0
1650310366545,CSE 8A,A50,083650,Miranda; Gregory Joseph,0,25,40,40
1650310372571,CSE 11,A01,083080,Cao; Yingjun,0,83,40,40
1650310378598,CSE 12,A01,083652,Staff,0,10,100,100
1650310384622,CSE 15L,A01,083654,Staff,0,1,50,50
1650310384622,CSE 15L,A02,083655,Staff,4,0,50,46
1650310390647,CSE 20,A01,083657,Staff,53,0,80,27
1650310396675,CSE 30,A01,083084,Eldon; John,0,74,40,40
1650310402701,CSE 100,A01,083659,Cao; Yingjun,0,65,50,50
1650310408728,CSE 134B,A01,083661,Powell; Thomas Allan,0,30,65,65
1650310414751,CSE 140,A01,083663,Staff,0,0,75,75
1650310420774,CSE 140L,A01,083088,Eldon; John,0,6,75,75
1650310426810,CSE 175,A01,083665,Kumar; Rakesh,8,0,25,17
1650310432832,CSE 190,A00,092507,Dubnov; Shlomo,14,0,20,6
1650310438857,ECE 45,A01,083139,Staff,0,16,40,40
1650310444888,ECE 65,A50,083695,Staff,0,5,30,30
1650310450911,ECE 109,A01,091882,Touri; Behrouz,42,0,70,28
1650310456935,ECE 180,A00,083140,Abi Samra; Nicholas Camill,23,0,30,7
1650310456935,ECE 180,B00,083141,Abi Samra; Nicholas Camill,6,0,30,24
1650310462960,MATH 10A,A01,083735,Patchell; Gregory David,10,0,30,20
1650310462960,MATH 10A,A02,083736,Patchell; Gregory David,28,0,30,2
1650310462960,MATH 10A,A03,083737,Patchell; Gregory David,26,0,30,4
1650310468984,MATH 10B,A01,083207,Staff,0,6,30,30
1650310468984,MATH 10B,A02,083208,Staff,0,6,30,30
1650310468984,MATH 10B,B01,083739,Staff,17,0,30,13
1650310468984,MATH 10B,B02,083740,Staff,28,0,30,2
1650310475009,MATH 18,A01,083743,Staff,6,0,30,24
1650310475009,MATH 18,A02,083744,Staff,26,0,30,4
1650310475009,MATH 18,A03,083745,Staff,22,0,30,8
1650310475009,MATH 18,A04,083746,Staff,27,0,30,3
1650310475009,MATH 18,B01,083748,Staff,0,11,30,30
1650310475009,MATH 18,B02,083749,Staff,0,10,30,30
1650310475009,MATH 18,B03,083750,Staff,1,9,30,29
1650310475009,MATH 18,B04,083751,Staff,0,10,30,30
1650310481043,MATH 20A,A01,083754,Staff,25,0,40,15
1650310487069,MATH 20B,A01,083756,Staff,0,5,30,30
1650310487069,MATH 20B,A02,083757,Staff,0,7,30,30
1650310493094,MATH 20C,A01,083760,Staff,0,13,30,30
1650310493094,MATH 20C,A02,083761,Staff,0,13,30,30
1650310493094,MATH 20C,B01,083762,Staff,13,0,30,17
1650310493094,MATH 20C,B02,083763,Staff,28,0,30,2
1650310499117,MATH 20D,A01,083765,Staff,0,1,30,30
1650310499117,MATH 20D,A02,083766,Staff,8,0,30,22
1650310499117,MATH 20D,A03,083767,Staff,27,0,30,3
1650310505144,MATH 20E,A01,083771,Staff,6,0,30,24
1650310505144,MATH 20E,A02,083772,Staff,19,0,30,11
1650310505144,MATH 20E,B01,083773,Staff,0,0,30,30
1650310505144,MATH 20E,B02,083774,Staff,12,0,30,18
1650310511175,MATH 103A,A01,083777,Staff,0,11,30,30
1650310511175,MATH 103A,A02,083778,Staff,0,10,30,30
1650310511175,MATH 103A,B01,083779,Staff,0,11,30,30
1650310511175,MATH 103A,B02,083780,Staff,0,11,30,30
1650310517202,MATH 105,A01,085443,Staff,0,17,30,30
1650310523225,MATH 109,A01,083213,Anzaldo; Leesa B,0,5,30,30
1650310523225,MATH 109,A02,083214,Anzaldo; Leesa B,0,6,30,30
1650310523225,MATH 109,B01,083215,Anzaldo; Leesa B,0,4,30,30
1650310523225,MATH 109,B02,083216,Anzaldo; Leesa B,0,4,30,30
1650310529259,MATH 142A,A01,083219,Chow; Bennett,0,14,30,30
1650310529259,MATH 142A,A02,083220,Chow; Bennett,0,11,30,30
1650310529259,MATH 142A,B01,083221,Chow; Bennett,0,11,30,30
1650310529259,MATH 142A,B02,083222,Chow; Bennett,0,12,30,30
1650310535282,MATH 193A,A01,083224,Staff,0,5,30,30
1650310535282,MATH 193A,A02,083225,Staff,0,5,30,30
1650310535282,MATH 193A,A03,083781,Staff,0,2,30,30
1650310535282,MATH 193A,A04,083782,Staff,0,3,30,30
1650310541305,MATH 197,001,091859,McAuley; Julian John,9998,0,9999,1
1650310547369,COGS 9,A01,083615,Staff,0,15,60,60
1650310553392,COGS 11,A01,083617,Boyle; Mary E. T.,22,0,40,18
1650310559415,COGS 13,A01,083071,Staff,0,31,40,40
1650310565441,COGS 14A,A01,092681,Staff,0,17,100,100
1650310571464,COGS 14B,A01,083073,Cheng; Tzu-Han,0,10,50,50
1650310577489,COGS 17,A01,092677,Staff,26,0,75,49
1650310583516,COGS 100,A01,083619,Staff,0,23,60,60
1650310589543,COGS 101A,A01,083621,Davis; Joshua Daniel,0,22,60,60
1650310595579,COGS 101B,A01,091572,Staff,3,0,60,57
1650310601603,COGS 101C,A01,083625,Delgado; Tania,19,0,30,11
1650310607626,COGS 107A,A01,083627,Boyle; Mary E. T.,0,8,60,60
1650310613649,COGS 118A,A01,083075,Staff,5,0,60,55
1650310619677,CSE 3,A50,083646,Miranda; Gregory Joseph,21,0,38,17
1650310619677,CSE 3,A51,083647,Miranda; Gregory Joseph,37,0,37,0
1650310625710,CSE 8A,A50,083650,Miranda; Gregory Joseph,0,25,40,40
1650310631732,CSE 11,A01,083080,Cao; Yingjun,0,83,40,40
1650310637755,CSE 12,A01,083652,Staff,0,10,100,100
1650310643780,CSE 15L,A01,083654,Staff,0,1,50,50
1650310643780,CSE 15L,A02,083655,Staff,4,0,50,46
1650310649804,CSE 20,A01,083657,Staff,53,0,80,27
1650310655830,CSE 30,A01,083084,Eldon; John,0,74,40,40
1650310661853,CSE 100,A01,083659,Cao; Yingjun,0,65,50,50
1650310667885,CSE 134B,A01,083661,Powell; Thomas Allan,0,30,65,65
1650310673908,CSE 140,A01,083663,Staff,0,0,75,75
1650310679936,CSE 140L,A01,083088,Eldon; John,0,6,75,75
1650310685962,CSE 175,A01,083665,Kumar; Rakesh,8,0,25,17
1650310691987,CSE 190,A00,092507,Dubnov; Shlomo,14,0,20,6
1650310698010,ECE 45,A01,083139,Staff,0,16,40,40
1650310704048,ECE 65,A50,083695,Staff,0,5,30,30
1650310710071,ECE 109,A01,091882,Touri; Behrouz,42,0,70,28
1650310716095,ECE 180,A00,083140,Abi Samra; Nicholas Camill,23,0,30,7
1650310716095,ECE 180,B00,083141,Abi Samra; Nicholas Camill,6,0,30,24
1650310722126,MATH 10A,A01,083735,Patchell; Gregory David,10,0,30,20
1650310722126,MATH 10A,A02,083736,Patchell; Gregory David,28,0,30,2
1650310722126,MATH 10A,A03,083737,Patchell; Gregory David,26,0,30,4
1650310728222,MATH 10B,A01,083207,Staff,0,6,30,30
1650310728222,MATH 10B,A02,083208,Staff,0,6,30,30
1650310728222,MATH 10B,B01,083739,Staff,17,0,30,13
1650310728222,MATH 10B,B02,083740,Staff,28,0,30,2
1650310734252,MATH 18,A01,083743,Staff,6,0,30,24
1650310734252,MATH 18,A02,083744,Staff,26,0,30,4
1650310734252,MATH 18,A03,083745,Staff,22,0,30,8
1650310734252,MATH 18,A04,083746,Staff,27,0,30,3
1650310734252,MATH 18,B01,083748,Staff,0,11,30,30
1650310734252,MATH 18,B02,083749,Staff,0,10,30,30
1650310734252,MATH 18,B03,083750,Staff,1,9,30,29
1650310734252,MATH 18,B04,083751,Staff,0,10,30,30
1650310740281,MATH 20A,A01,083754,Staff,25,0,40,15
1650310746310,MATH 20B,A01,083756,Staff,0,5,30,30
1650310746310,MATH 20B,A02,083757,Staff,0,7,30,30
1650310752337,MATH 20C,A01,083760,Staff,0,13,30,30
1650310752337,MATH 20C,A02,083761,Staff,0,13,30,30
1650310752337,MATH 20C,B01,083762,Staff,13,0,30,17
1650310752337,MATH 20C,B02,083763,Staff,28,0,30,2
1650310758363,MATH 20D,A01,083765,Staff,0,1,30,30
1650310758363,MATH 20D,A02,083766,Staff,8,0,30,22
1650310758363,MATH 20D,A03,083767,Staff,27,0,30,3
1650310764390,MATH 20E,A01,083771,Staff,6,0,30,24
1650310764390,MATH 20E,A02,083772,Staff,19,0,30,11
1650310764390,MATH 20E,B01,083773,Staff,0,0,30,30
1650310764390,MATH 20E,B02,083774,Staff,12,0,30,18
1650310770415,MATH 103A,A01,083777,Staff,0,11,30,30
1650310770415,MATH 103A,A02,083778,Staff,0,10,30,30
1650310770415,MATH 103A,B01,083779,Staff,0,11,30,30
1650310770415,MATH 103A,B02,083780,Staff,0,11,30,30
1650310776444,MATH 105,A01,085443,Staff,0,17,30,30
1650310782470,MATH 109,A01,083213,Anzaldo; Leesa B,0,5,30,30
1650310782470,MATH 109,A02,083214,Anzaldo; Leesa B,0,6,30,30
1650310782470,MATH 109,B01,083215,Anzaldo; Leesa B,0,4,30,30
1650310782470,MATH 109,B02,083216,Anzaldo; Leesa B,0,4,30,30
1650310788501,MATH 142A,A01,083219,Chow; Bennett,0,14,30,30
1650310788501,MATH 142A,A02,083220,Chow; Bennett,0,11,30,30
1650310788501,MATH 142A,B01,083221,Chow; Bennett,0,11,30,30
1650310788501,MATH 142A,B02,083222,Chow; Bennett,0,12,30,30
1650310794540,MATH 193A,A01,083224,Staff,0,5,30,30
1650310794540,MATH 193A,A02,083225,Staff,0,5,30,30
1650310794540,MATH 193A,A03,083781,Staff,0,2,30,30
1650310794540,MATH 193A,A04,083782,Staff,0,3,30,30
1650310800565,MATH 197,001,091859,McAuley; Julian John,9998,0,9999,1
1650310806619,COGS 9,A01,083615,Staff,0,15,60,60
1650310812640,COGS 11,A01,083617,Boyle; Mary E. T.,22,0,40,18
1650310818665,COGS 13,A01,083071,Staff,0,31,40,40
1650310824691,COGS 14A,A01,092681,Staff,0,17,100,100
1650310830718,COGS 14B,A01,083073,Cheng; Tzu-Han,0,10,50,50
1650310836740,COGS 17,A01,092677,Staff,26,0,75,49
1650310842763,COGS 100,A01,083619,Staff,0,23,60,60
1650310848788,COGS 101A,A01,083621,Davis; Joshua Daniel,0,22,60,60
1650310854824,COGS 101B,A01,091572,Staff,3,0,60,57
1650310860848,COGS 101C,A01,083625,Delgado; Tania,19,0,30,11
1650310866875,COGS 107A,A01,083627,Boyle; Mary E. T.,0,8,60,60
1650310872900,COGS 118A,A01,083075,Staff,5,0,60,55
1650310878935,CSE 3,A50,083646,Miranda; Gregory Joseph,21,0,38,17
1650310878935,CSE 3,A51,083647,Miranda; Gregory Joseph,37,0,37,0
1650310884960,CSE 8A,A50,083650,Miranda; Gregory Joseph,0,25,40,40
1650310890985,CSE 11,A01,083080,Cao; Yingjun,0,83,40,40
1650310897018,CSE 12,A01,083652,Staff,0,10,100,100
1650310903044,CSE 15L,A01,083654,Staff,0,1,50,50
1650310903044,CSE 15L,A02,083655,Staff,4,0,50,46
1650310909069,CSE 20,A01,083657,Staff,53,0,80,27
1650310923455,CSE 30,A01,083084,Eldon; John,0,74,40,40
1650310929479,CSE 100,A01,083659,Cao; Yingjun,0,65,50,50
1650310935521,CSE 134B,A01,083661,Powell; Thomas Allan,0,30,65,65
1650310941551,CSE 140,A01,083663,Staff,0,0,75,75
1650310947574,CSE 140L,A01,083088,Eldon; John,0,6,75,75
1650310953599,CSE 175,A01,083665,Kumar; Rakesh,8,0,25,17
1650310959630,CSE 190,A00,092507,Dubnov; Shlomo,14,0,20,6
1650310965652,ECE 45,A01,083139,Staff,0,16,40,40
1650310971676,ECE 65,A50,083695,Staff,0,5,30,30
1650310977697,ECE 109,A01,091882,Touri; Behrouz,42,0,70,28
1650310983720,ECE 180,A00,083140,Abi Samra; Nicholas Camill,23,0,30,7
1650310983720,ECE 180,B00,083141,Abi Samra; Nicholas Camill,6,0,30,24
1650310989744,MATH 10A,A01,083735,Patchell; Gregory David,10,0,30,20
1650310989744,MATH 10A,A02,083736,Patchell; Gregory David,28,0,30,2
1650310989744,MATH 10A,A03,083737,Patchell; Gregory David,26,0,30,4
1650310995770,MATH 10B,A01,083207,Staff,0,6,30,30
1650310995770,MATH 10B,A02,083208,Staff,0,6,30,30
1650310995770,MATH 10B,B01,083739,Staff,17,0,30,13
1650310995770,MATH 10B,B02,083740,Staff,28,0,30,2
1650311001804,MATH 18,A01,083743,Staff,6,0,30,24
1650311001804,MATH 18,A02,083744,Staff,26,0,30,4
1650311001804,MATH 18,A03,083745,Staff,22,0,30,8
1650311001804,MATH 18,A04,083746,Staff,27,0,30,3
1650311001804,MATH 18,B01,083748,Staff,0,11,30,30
1650311001804,MATH 18,B02,083749,Staff,0,10,30,30
1650311001804,MATH 18,B03,083750,Staff,1,9,30,29
1650311001804,MATH 18,B04,083751,Staff,0,10,30,30
1650311007827,MATH 20A,A01,083754,Staff,25,0,40,15
1650311013857,MATH 20B,A01,083756,Staff,0,5,30,30
1650311013857,MATH 20B,A02,083757,Staff,0,7,30,30
1650311019890,MATH 20C,A01,083760,Staff,0,13,30,30
1650311019890,MATH 20C,A02,083761,Staff,0,13,30,30
1650311019890,MATH 20C,B01,083762,Staff,13,0,30,17
1650311019890,MATH 20C,B02,083763,Staff,28,0,30,2
1650311025917,MATH 20D,A01,083765,Staff,0,1,30,30
1650311025917,MATH 20D,A02,083766,Staff,8,0,30,22
1650311025917,MATH 20D,A03,083767,Staff,27,0,30,3
1650311031940,MATH 20E,A01,083771,Staff,6,0,30,24
1650311031940,MATH 20E,A02,083772,Staff,19,0,30,11
1650311031940,MATH 20E,B01,083773,Staff,0,0,30,30
1650311031940,MATH 20E,B02,083774,Staff,12,0,30,18
1650311037978,MATH 103A,A01,083777,Staff,0,11,30,30
1650311037978,MATH 103A,A02,083778,Staff,0,10,30,30
1650311037978,MATH 103A,B01,083779,Staff,0,11,30,30
1650311037978,MATH 103A,B02,083780,Staff,0,11,30,30
1650311044012,MATH 105,A01,085443,Staff,0,17,30,30
1650311050042,MATH 109,A01,083213,Anzaldo; Leesa B,0,5,30,30
1650311050042,MATH 109,A02,083214,Anzaldo; Leesa B,0,6,30,30
1650311050042,MATH 109,B01,083215,Anzaldo; Leesa B,0,4,30,30
1650311050042,MATH 109,B02,083216,Anzaldo; Leesa B,0,4,30,30
1650311056070,MATH 142A,A01,083219,Chow; Bennett,0,14,30,30
1650311056070,MATH 142A,A02,083220,Chow; Bennett,0,11,30,30
1650311056070,MATH 142A,B01,083221,Chow; Bennett,0,11,30,30
1650311056070,MATH 142A,B02,083222,Chow; Bennett,0,12,30,30
1650311062096,MATH 193A,A01,083224,Staff,0,5,30,30
1650311062096,MATH 193A,A02,083225,Staff,0,5,30,30
1650311062096,MATH 193A,A03,083781,Staff,0,2,30,30
1650311062096,MATH 193A,A04,083782,Staff,0,3,30,30
1650311068120,MATH 197,001,091859,McAuley; Julian John,9998,0,9999,1
1650311074172,COGS 9,A01,083615,Staff,0,15,60,60
1650311080198,COGS 11,A01,083617,Boyle; Mary E. T.,22,0,40,18
1650311086225,COGS 13,A01,083071,Staff,0,31,40,40
1650311092249,COGS 14A,A01,092681,Staff,0,17,100,100
1650311098280,COGS 14B,A01,083073,Cheng; Tzu-Han,0,10,50,50
1650311104305,COGS 17,A01,092677,Staff,26,0,75,49
1650311110331,COGS 100,A01,083619,Staff,0,23,60,60
1650311116355,COGS 101A,A01,083621,Davis; Joshua Daniel,0,22,60,60
1650311122384,COGS 101B,A01,091572,Staff,3,0,60,57
1650311128420,COGS 101C,A01,083625,Delgado; Tania,19,0,30,11
1650311134451,COGS 107A,A01,083627,Boyle; Mary E. T.,0,8,60,60
1650311140478,COGS 118A,A01,083075,Staff,5,0,60,55
1650311146504,CSE 3,A50,083646,Miranda; Gregory Joseph,21,0,38,17
1650311146504,CSE 3,A51,083647,Miranda; Gregory Joseph,37,0,37,0
1650311152534,CSE 8A,A50,083650,Miranda; Gregory Joseph,0,25,40,40
1650311158562,CSE 11,A01,083080,Cao; Yingjun,0,83,40,40
1650311164589,CSE 12,A01,083652,Staff,0,10,100,100
1650311170615,CSE 15L,A01,083654,Staff,0,1,50,50
1650311170615,CSE 15L,A02,083655,Staff,4,0,50,46
1650311176640,CSE 20,A01,083657,Staff,53,0,80,27
1650311182675,CSE 30,A01,083084,Eldon; John,0,74,40,40
1650311188698,CSE 100,A01,083659,Cao; Yingjun,0,65,50,50
1650311194739,CSE 134B,A01,083661,Powell; Thomas Allan,0,30,65,65
1650311200768,CSE 140,A01,083663,Staff,0,0,75,75
1650311206791,CSE 140L,A01,083088,Eldon; John,0,6,75,75
1650311212813,CSE 175,A01,083665,Kumar; Rakesh,8,0,25,17
1650311218840,CSE 190,A00,092507,Dubnov; Shlomo,14,0,20,6
1650311224864,ECE 45,A01,083139,Staff,0,16,40,40
1650311230888,ECE 65,A50,083695,Staff,0,5,30,30
1650311236914,ECE 109,A01,091882,Touri; Behrouz,42,0,70,28
1650311242941,ECE 180,A00,083140,Abi Samra; Nicholas Camill,23,0,30,7
1650311242941,ECE 180,B00,083141,Abi Samra; Nicholas Camill,6,0,30,24
1650311248967,MATH 10A,A01,083735,Patchell; Gregory David,10,0,30,20
1650311248967,MATH 10A,A02,083736,Patchell; Gregory David,28,0,30,2
1650311248967,MATH 10A,A03,083737,Patchell; Gregory David,26,0,30,4
1650311254999,MATH 10B,A01,083207,Staff,0,6,30,30
1650311254999,MATH 10B,A02,083208,Staff,0,6,30,30
1650311254999,MATH 10B,B01,083739,Staff,17,0,30,13
1650311254999,MATH 10B,B02,083740,Staff,28,0,30,2
1650311261031,MATH 18,A01,083743,Staff,6,0,30,24
1650311261031,MATH 18,A02,083744,Staff,26,0,30,4
1650311261031,MATH 18,A03,083745,Staff,22,0,30,8
1650311261031,MATH 18,A04,083746,Staff,27,0,30,3
1650311261031,MATH 18,B01,083748,Staff,0,11,30,30
1650311261031,MATH 18,B02,083749,Staff,0,10,30,30
1650311261031,MATH 18,B03,083750,Staff,1,9,30,29
1650311261031,MATH 18,B04,083751,Staff,0,10,30,30
1650311267057,MATH 20A,A01,083754,Staff,25,0,40,15
1650311273081,MATH 20B,A01,083756,Staff,0,5,30,30
1650311273081,MATH 20B,A02,083757,Staff,0,7,30,30
1650311279104,MATH 20C,A01,083760,Staff,0,13,30,30
1650311279104,MATH 20C,A02,083761,Staff,0,13,30,30
1650311279104,MATH 20C,B01,083762,Staff,13,0,30,17
1650311279104,MATH 20C,B02,083763,Staff,28,0,30,2
1650311285130,MATH 20D,A01,083765,Staff,0,1,30,30
1650311285130,MATH 20D,A02,083766,Staff,8,0,30,22
1650311285130,MATH 20D,A03,083767,Staff,27,0,30,3
1650311291153,MATH 20E,A01,083771,Staff,6,0,30,24
1650311291153,MATH 20E,A02,083772,Staff,19,0,30,11
1650311291153,MATH 20E,B01,083773,Staff,0,0,30,30
1650311291153,MATH 20E,B02,083774,Staff,12,0,30,18
1650311297199,MATH 103A,A01,083777,Staff,0,11,30,30
1650311297199,MATH 103A,A02,083778,Staff,0,10,30,30
1650311297199,MATH 103A,B01,083779,Staff,0,11,30,30
1650311297199,MATH 103A,B02,083780,Staff,0,11,30,30
1650311303229,MATH 105,A01,085443,Staff,0,17,30,30
1650311309256,MATH 109,A01,083213,Anzaldo; Leesa B,0,5,30,30
1650311309256,MATH 109,A02,083214,Anzaldo; Leesa B,0,6,30,30
1650311309256,MATH 109,B01,083215,Anzaldo; Leesa B,0,4,30,30
1650311309256,MATH 109,B02,083216,Anzaldo; Leesa B,0,4,30,30
1650311315283,MATH 142A,A01,083219,Chow; Bennett,0,14,30,30
1650311315283,MATH 142A,A02,083220,Chow; Bennett,0,11,30,30
1650311315283,MATH 142A,B01,083221,Chow; Bennett,0,11,30,30
1650311315283,MATH 142A,B02,083222,Chow; Bennett,0,12,30,30
1650311321307,MATH 193A,A01,083224,Staff,0,5,30,30
1650311321307,MATH 193A,A02,083225,Staff,0,5,30,30
1650311321307,MATH 193A,A03,083781,Staff,0,2,30,30
1650311321307,MATH 193A,A04,083782,Staff,0,3,30,30
1650311327356,MATH 197,001,091859,McAuley; Julian John,9998,0,9999,1
1650311333502,COGS 9,A01,083615,Staff,0,15,60,60
1650311339527,COGS 11,A01,083617,Boyle; Mary E. T.,22,0,40,18
1650311345550,COGS 13,A01,083071,Staff,0,31,40,40
1650311351577,COGS 14A,A01,092681,Staff,0,17,100,100
1650311357601,COGS 14B,A01,083073,Cheng; Tzu-Han,0,10,50,50
1650311363630,COGS 17,A01,092677,Staff,26,0,75,49
1650311369661,COGS 100,A01,083619,Staff,0,23,60,60
1650311375685,COGS 101A,A01,083621,Davis; Joshua Daniel,0,22,60,60
1650311381712,COGS 101B,A01,091572,Staff,3,0,60,57
1650311387737,COGS 101C,A01,083625,Delgado; Tania,19,0,30,11
1650311393763,COGS 107A,A01,083627,Boyle; Mary E. T.,0,8,60,60
1650311399785,COGS 118A,A01,083075,Staff,5,0,60,55
1650311405810,CSE 3,A50,083646,Miranda; Gregory Joseph,21,0,38,17
1650311405810,CSE 3,A51,083647,Miranda; Gregory Joseph,37,0,37,0
1650311411835,CSE 8A,A50,083650,Miranda; Gregory Joseph,0,25,40,40
1650311417874,CSE 11,A01,083080,Cao; Yingjun,0,83,40,40
1650311423901,CSE 12,A01,083652,Staff,0,10,100,100
1650311429932,CSE 15L,A01,083654,Staff,0,1,50,50
1650311429932,CSE 15L,A02,083655,Staff,4,0,50,46
1650311435955,CSE 20,A01,083657,Staff,53,0,80,27
1650311441978,CSE 30,A01,083084,Eldon; John,0,74,40,40
1650311448001,CSE 100,A01,083659,Cao; Yingjun,0,65,50,50
1650311454024,CSE 134B,A01,083661,Powell; Thomas Allan,0,30,65,65
1650311460048,CSE 140,A01,083663,Staff,0,0,75,75
1650311466086,CSE 140L,A01,083088,Eldon; John,0,6,75,75
1650311472120,CSE 175,A01,083665,Kumar; Rakesh,8,0,25,17
1650311478145,CSE 190,A00,092507,Dubnov; Shlomo,14,0,20,6
1650311484169,ECE 45,A01,083139,Staff,0,16,40,40
1650311490196,ECE 65,A50,083695,Staff,0,5,30,30
1650311496229,ECE 109,A01,091882,Touri; Behrouz,42,0,70,28
1650311502255,ECE 180,A00,083140,Abi Samra; Nicholas Camill,23,0,30,7
1650311502255,ECE 180,B00,083141,Abi Samra; Nicholas Camill,6,0,30,24
1650311508286,MATH 10A,A01,083735,Patchell; Gregory David,10,0,30,20
1650311508286,MATH 10A,A02,083736,Patchell; Gregory David,28,0,30,2
1650311508286,MATH 10A,A03,083737,Patchell; Gregory David,26,0,30,4
1650311514310,MATH 10B,A01,083207,Staff,0,6,30,30
1650311514310,MATH 10B,A02,083208,Staff,0,6,30,30
1650311514310,MATH 10B,B01,083739,Staff,17,0,30,13
1650311514310,MATH 10B,B02,083740,Staff,28,0,30,2
1650311520335,MATH 18,A01,083743,Staff,6,0,30,24
1650311520335,MATH 18,A02,083744,Staff,26,0,30,4
1650311520335,MATH 18,A03,083745,Staff,22,0,30,8
1650311520335,MATH 18,A04,083746,Staff,27,0,30,3
1650311520335,MATH 18,B01,083748,Staff,0,11,30,30
1650311520335,MATH 18,B02,083749,Staff,0,10,30,30
1650311520335,MATH 18,B03,083750,Staff,1,9,30,29
1650311520335,MATH 18,B04,083751,Staff,0,10,30,30
1650311526364,MATH 20A,A01,083754,Staff,25,0,40,15
1650311532389,MATH 20B,A01,083756,Staff,0,5,30,30
1650311532389,MATH 20B,A02,083757,Staff,0,7,30,30
1650311538413,MATH 20C,A01,083760,Staff,0,13,30,30
1650311538413,MATH 20C,A02,083761,Staff,0,13,30,30
1650311538413,MATH 20C,B01,083762,Staff,13,0,30,17
1650311538413,MATH 20C,B02,083763,Staff,28,0,30,2
1650311544439,MATH 20D,A01,083765,Staff,0,1,30,30
1650311544439,MATH 20D,A02,083766,Staff,8,0,30,22
1650311544439,MATH 20D,A03,083767,Staff,27,0,30,3
1650311550463,MATH 20E,A01,083771,Staff,6,0,30,24
1650311550463,MATH 20E,A02,083772,Staff,19,0,30,11
1650311550463,MATH 20E,B01,083773,Staff,0,0,30,30
1650311550463,MATH 20E,B02,083774,Staff,12,0,30,18
1650311556496,MATH 103A,A01,083777,Staff,0,11,30,30
1650311556496,MATH 103A,A02,083778,Staff,0,10,30,30
1650311556496,MATH 103A,B01,083779,Staff,0,11,30,30
1650311556496,MATH 103A,B02,083780,Staff,0,11,30,30
1650311562534,MATH 105,A01,085443,Staff,0,17,30,30
1650311568555,MATH 109,A01,083213,Anzaldo; Leesa B,0,5,30,30
1650311568555,MATH 109,A02,083214,Anzaldo; Leesa B,0,6,30,30
1650311568555,MATH 109,B01,083215,Anzaldo; Leesa B,0,4,30,30
1650311568555,MATH 109,B02,083216,Anzaldo; Leesa B,0,4,30,30
1650311574586,MATH 142A,A01,083219,Chow; Bennett,0,14,30,30
1650311574586,MATH 142A,A02,083220,Chow; Bennett,0,11,30,30
1650311574586,MATH 142A,B01,083221,Chow; Bennett,0,11,30,30
1650311574586,MATH 142A,B02,083222,Chow; Bennett,0,12,30,30
1650311580609,MATH 193A,A01,083224,Staff,0,5,30,30
1650311580609,MATH 193A,A02,083225,Staff,0,5,30,30
1650311580609,MATH 193A,A03,083781,Staff,0,2,30,30
1650311580609,MATH 193A,A04,083782,Staff,0,3,30,30
1650311586633,MATH 197,001,091859,McAuley; Julian John,9998,0,9999,1
1650311592688,COGS 9,A01,083615,Staff,0,15,60,60
1650311598712,COGS 11,A01,083617,Boyle; Mary E. T.,22,0,40,18
1650311604741,COGS 13,A01,083071,Staff,0,31,40,40
1650311610773,COGS 14A,A01,092681,Staff,0,17,100,100
1650311616802,COGS 14B,A01,083073,Cheng; Tzu-Han,0,10,50,50
1650311622830,COGS 17,A01,092677,Staff,26,0,75,49
1650311628854,COGS 100,A01,083619,Staff,0,23,60,60
1650311634879,COGS 101A,A01,083621,Davis; Joshua Daniel,0,22,60,60
1650311640903,COGS 101B,A01,091572,Staff,3,0,60,57
1650311646943,COGS 101C,A01,083625,Delgado; Tania,19,0,30,11
1650311652970,COGS 107A,A01,083627,Boyle; Mary E. T.,0,8,60,60
1650311658997,COGS 118A,A01,083075,Staff,5,0,60,55
1650311665021,CSE 3,A50,083646,Miranda; Gregory Joseph,21,0,38,17
1650311665021,CSE 3,A51,083647,Miranda; Gregory Joseph,37,0,37,0
1650311671049,CSE 8A,A50,083650,Miranda; Gregory Joseph,0,25,40,40
1650311677073,CSE 11,A01,083080,Cao; Yingjun,0,83,40,40
1650311683097,CSE 12,A01,083652,Staff,0,10,100,100
1650311689125,CSE 15L,A01,083654,Staff,0,1,50,50
1650311689125,CSE 15L,A02,083655,Staff,4,0,50,46
1650311695148,CSE 20,A01,083657,Staff,53,0,80,27
1650311701192,CSE 30,A01,083084,Eldon; John,0,74,40,40
1650311707214,CSE 100,A01,083659,Cao; Yingjun,0,65,50,50
1650311713239,CSE 134B,A01,083661,Powell; Thomas Allan,0,30,65,65
1650311719274,CSE 140,A01,083663,Staff,0,0,75,75
1650311725301,CSE 140L,A01,083088,Eldon; John,0,6,75,75
1650311731325,CSE 175,A01,083665,Kumar; Rakesh,8,0,25,17
1650311737356,CSE 190,A00,092507,Dubnov; Shlomo,14,0,20,6
1650311743390,ECE 45,A01,083139,Staff,0,16,40,40
1650311749419,ECE 65,A50,083695,Staff,0,5,30,30
1650311755446,ECE 109,A01,091882,Touri; Behrouz,42,0,70,28
1650311761470,ECE 180,A00,083140,Abi Samra; Nicholas Camill,23,0,30,7
1650311761470,ECE 180,B00,083141,Abi Samra; Nicholas Camill,6,0,30,24
1650311767495,MATH 10A,A01,083735,Patchell; Gregory David,10,0,30,20
1650311767495,MATH 10A,A02,083736,Patchell; Gregory David,28,0,30,2
1650311767495,MATH 10A,A03,083737,Patchell; Gregory David,26,0,30,4
1650311773544,MATH 10B,A01,083207,Staff,0,6,30,30
1650311773544,MATH 10B,A02,083208,Staff,0,6,30,30
1650311773544,MATH 10B,B01,083739,Staff,17,0,30,13
1650311773544,MATH 10B,B02,083740,Staff,28,0,30,2
1650311779575,MATH 18,A01,083743,Staff,6,0,30,24
1650311779575,MATH 18,A02,083744,Staff,26,0,30,4
1650311779575,MATH 18,A03,083745,Staff,22,0,30,8
1650311779575,MATH 18,A04,083746,Staff,27,0,30,3
1650311779575,MATH 18,B01,083748,Staff,0,11,30,30
1650311779575,MATH 18,B02,083749,Staff,0,10,30,30
1650311779575,MATH 18,B03,083750,Staff,1,9,30,29
1650311779575,MATH 18,B04,083751,Staff,0,10,30,30
1650311785602,MATH 20A,A01,083754,Staff,25,0,40,15
1650311791626,MATH 20B,A01,083756,Staff,0,5,30,30
1650311791626,MATH 20B,A02,083757,Staff,0,7,30,30
1650311797650,MATH 20C,A01,083760,Staff,0,13,30,30
1650311797650,MATH 20C,A02,083761,Staff,0,13,30,30
1650311797650,MATH 20C,B01,083762,Staff,13,0,30,17
1650311797650,MATH 20C,B02,083763,Staff,28,0,30,2
1650311803676,MATH 20D,A01,083765,Staff,0,1,30,30
1650311803676,MATH 20D,A02,083766,Staff,8,0,30,22
1650311803676,MATH 20D,A03,083767,Staff,27,0,30,3
1650311809704,MATH 20E,A01,083771,Staff,6,0,30,24
1650311809704,MATH 20E,A02,083772,Staff,19,0,30,11
1650311809704,MATH 20E,B01,083773,Staff,0,0,30,30
1650311809704,MATH 20E,B02,083774,Staff,12,0,30,18
1650311815728,MATH 103A,A01,083777,Staff,0,11,30,30
1650311815728,MATH 103A,A02,083778,Staff,0,10,30,30
1650311815728,MATH 103A,B01,083779,Staff,0,11,30,30
1650311815728,MATH 103A,B02,083780,Staff,0,11,30,30
1650311821755,MATH 105,A01,085443,Staff,0,17,30,30
1650311827793,MATH 109,A01,083213,Anzaldo; Leesa B,0,5,30,30
1650311827793,MATH 109,A02,083214,Anzaldo; Leesa B,0,6,30,30
1650311827793,MATH 109,B01,083215,Anzaldo; Leesa B,0,4,30,30
1650311827793,MATH 109,B02,083216,Anzaldo; Leesa B,0,4,30,30
1650311833820,MATH 142A,A01,083219,Chow; Bennett,0,14,30,30
1650311833820,MATH 142A,A02,083220,Chow; Bennett,0,11,30,30
1650311833820,MATH 142A,B01,083221,Chow; Bennett,0,11,30,30
1650311833820,MATH 142A,B02,083222,Chow; Bennett,0,12,30,30
1650311839848,MATH 193A,A01,083224,Staff,0,5,30,30
1650311839848,MATH 193A,A02,083225,Staff,0,5,30,30
1650311839848,MATH 193A,A03,083781,Staff,0,2,30,30
1650311839848,MATH 193A,A04,083782,Staff,0,3,30,30
1650311845897,MATH 197,001,091859,McAuley; Julian John,9998,0,9999,1
1650311851949,COGS 9,A01,083615,Staff,0,15,60,60
1650311857980,COGS 11,A01,083617,Boyle; Mary E. T.,22,0,40,18
1650311864012,COGS 13,A01,083071,Staff,0,31,40,40
1650311870037,COGS 14A,A01,092681,Staff,0,17,100,100
1650311876061,COGS 14B,A01,083073,Cheng; Tzu-Han,0,10,50,50
1650311882087,COGS 17,A01,092677,Staff,26,0,75,49
1650311888119,COGS 100,A01,083619,Staff,0,23,60,60
1650311894145,COGS 101A,A01,083621,Davis; Joshua Daniel,0,22,60,60
1650311900176,COGS 101B,A01,091572,Staff,3,0,60,57
1650311906199,COGS 101C,A01,083625,Delgado; Tania,19,0,30,11
1650311912222,COGS 107A,A01,083627,Boyle; Mary E. T.,0,8,60,60
1650311918252,COGS 118A,A01,083075,Staff,5,0,60,55
1650311924348,CSE 3,A50,083646,Miranda; Gregory Joseph,21,0,38,17
1650311924348,CSE 3,A51,083647,Miranda; Gregory Joseph,37,0,37,0
1650311930382,CSE 8A,A50,083650,Miranda; Gregory Joseph,0,25,40,40
1650311936421,CSE 11,A01,083080,Cao; Yingjun,0,83,40,40
1650311942452,CSE 12,A01,083652,Staff,0,10,100,100
1650311948474,CSE 15L,A01,083654,Staff,0,1,50,50
1650311948474,CSE 15L,A02,083655,Staff,4,0,50,46
1650311954499,CSE 20,A01,083657,Staff,53,0,80,27
1650311960522,CSE 30,A01,083084,Eldon; John,0,74,40,40
1650311966547,CSE 100,A01,083659,Cao; Yingjun,0,65,50,50
1650311972574,CSE 134B,A01,083661,Powell; Thomas Allan,0,30,65,65
1650311978604,CSE 140,A01,083663,Staff,0,0,75,75
1650311984632,CSE 140L,A01,083088,Eldon; John,0,6,75,75
1650311990658,CSE 175,A01,083665,Kumar; Rakesh,8,0,25,17
1650311996685,CSE 190,A00,092507,Dubnov; Shlomo,14,0,20,6
1650312002709,ECE 45,A01,083139,Staff,0,16,40,40
1650312008732,ECE 65,A50,083695,Staff,0,5,30,30
1650312014759,ECE 109,A01,091882,Touri; Behrouz,42,0,70,28
1650312020797,ECE 180,A00,083140,Abi Samra; Nicholas Camill,23,0,30,7
1650312020797,ECE 180,B00,083141,Abi Samra; Nicholas Camill,6,0,30,24
1650312026837,MATH 10A,A01,083735,Patchell; Gregory David,10,0,30,20
1650312026837,MATH 10A,A02,083736,Patchell; Gregory David,28,0,30,2
1650312026837,MATH 10A,A03,083737,Patchell; Gregory David,26,0,30,4
1650312032862,MATH 10B,A01,083207,Staff,0,6,30,30
1650312032862,MATH 10B,A02,083208,Staff,0,6,30,30
1650312032862,MATH 10B,B01,083739,Staff,17,0,30,13
1650312032862,MATH 10B,B02,083740,Staff,28,0,30,2
1650312038891,MATH 18,A01,083743,Staff,6,0,30,24
1650312038891,MATH 18,A02,083744,Staff,26,0,30,4
1650312038891,MATH 18,A03,083745,Staff,22,0,30,8
1650312038891,MATH 18,A04,083746,Staff,27,0,30,3
1650312038891,MATH 18,B01,083748,Staff,0,11,30,30
1650312038891,MATH 18,B02,083749,Staff,0,10,30,30
1650312038891,MATH 18,B03,083750,Staff,1,9,30,29
1650312038891,MATH 18,B04,083751,Staff,0,10,30,30
1650312044917,MATH 20A,A01,083754,Staff,25,0,40,15
1650312050942,MATH 20B,A01,083756,Staff,0,5,30,30
1650312050942,MATH 20B,A02,083757,Staff,0,7,30,30
1650312056972,MATH 20C,A01,083760,Staff,0,13,30,30
1650312056972,MATH 20C,A02,083761,Staff,0,13,30,30
1650312056972,MATH 20C,B01,083762,Staff,13,0,30,17
1650312056972,MATH 20C,B02,083763,Staff,28,0,30,2
1650312062999,MATH 20D,A01,083765,Staff,0,1,30,30
1650312062999,MATH 20D,A02,083766,Staff,8,0,30,22
1650312062999,MATH 20D,A03,083767,Staff,27,0,30,3
1650312069022,MATH 20E,A01,083771,Staff,6,0,30,24
1650312069022,MATH 20E,A02,083772,Staff,19,0,30,11
1650312069022,MATH 20E,B01,083773,Staff,0,0,30,30
1650312069022,MATH 20E,B02,083774,Staff,12,0,30,18
1650312075059,MATH 103A,A01,083777,Staff,0,11,30,30
1650312075059,MATH 103A,A02,083778,Staff,0,10,30,30
1650312075059,MATH 103A,B01,083779,Staff,0,11,30,30
1650312075059,MATH 103A,B02,083780,Staff,0,11,30,30
1650312081089,MATH 105,A01,085443,Staff,0,17,30,30
1650312087110,MATH 109,A01,083213,Anzaldo; Leesa B,0,5,30,30
1650312087110,MATH 109,A02,083214,Anzaldo; Leesa B,0,6,30,30
1650312087110,MATH 109,B01,083215,Anzaldo; Leesa B,0,4,30,30
1650312087110,MATH 109,B02,083216,Anzaldo; Leesa B,0,4,30,30
1650312093139,MATH 142A,A01,083219,Chow; Bennett,0,14,30,30
1650312093139,MATH 142A,A02,083220,Chow; Bennett,0,11,30,30
1650312093139,MATH 142A,B01,083221,Chow; Bennett,0,11,30,30
1650312093139,MATH 142A,B02,083222,Chow; Bennett,0,12,30,30
1650312099167,MATH 193A,A01,083224,Staff,0,5,30,30
1650312099167,MATH 193A,A02,083225,Staff,0,5,30,30
1650312099167,MATH 193A,A03,083781,Staff,0,2,30,30
1650312099167,MATH 193A,A04,083782,Staff,0,3,30,30
1650312105202,MATH 197,001,091859,McAuley; Julian John,9998,0,9999,1
1650312111259,COGS 9,A01,083615,Staff,0,15,60,60
1650312117298,COGS 11,A01,083617,Boyle; Mary E. T.,22,0,40,18
1650312123326,COGS 13,A01,083071,Staff,0,31,40,40
1650312129349,COGS 14A,A01,092681,Staff,0,17,100,100
1650312135377,COGS 14B,A01,083073,Cheng; Tzu-Han,0,10,50,50
1650312141410,COGS 17,A01,092677,Staff,26,0,75,49
1650312147444,COGS 100,A01,083619,Staff,0,23,60,60
1650312153471,COGS 101A,A01,083621,Davis; Joshua Daniel,0,22,60,60
1650312159495,COGS 101B,A01,091572,Staff,3,0,60,57
1650312165527,COGS 101C,A01,083625,Delgado; Tania,19,0,30,11
1650312171561,COGS 107A,A01,083627,Boyle; Mary E. T.,0,8,60,60
1650312177585,COGS 118A,A01,083075,Staff,5,0,60,55
1650312183608,CSE 3,A50,083646,Miranda; Gregory Joseph,21,0,38,17
1650312183608,CSE 3,A51,083647,Miranda; Gregory Joseph,37,0,37,0
1650312189631,CSE 8A,A50,083650,Miranda; Gregory Joseph,0,25,40,40
1650312195654,CSE 11,A01,083080,Cao; Yingjun,0,83,40,40
1650312201680,CSE 12,A01,083652,Staff,0,11,100,100
1650312207705,CSE 15L,A01,083654,Staff,0,1,50,50
1650312207705,CSE 15L,A02,083655,Staff,4,0,50,46
1650312213751,CSE 20,A01,083657,Staff,53,0,80,27
1650312219778,CSE 30,A01,083084,Eldon; John,0,74,40,40
1650312225804,CSE 100,A01,083659,Cao; Yingjun,0,65,50,50
1650312231828,CSE 134B,A01,083661,Powell; Thomas Allan,0,30,65,65
1650312237854,CSE 140,A01,083663,Staff,0,0,75,75
1650312243882,CSE 140L,A01,083088,Eldon; John,0,6,75,75
1650312249915,CSE 175,A01,083665,Kumar; Rakesh,8,0,25,17
1650312255945,CSE 190,A00,092507,Dubnov; Shlomo,14,0,20,6
1650312261976,ECE 45,A01,083139,Staff,0,16,40,40
1650312267999,ECE 65,A50,083695,Staff,0,5,30,30
1650312274024,ECE 109,A01,091882,Touri; Behrouz,42,0,70,28
1650312280047,ECE 180,A00,083140,Abi Samra; Nicholas Camill,23,0,30,7
1650312280047,ECE 180,B00,083141,Abi Samra; Nicholas Camill,6,0,30,24
1650312286072,MATH 10A,A01,083735,Patchell; Gregory David,10,0,30,20
1650312286072,MATH 10A,A02,083736,Patchell; Gregory David,28,0,30,2
1650312286072,MATH 10A,A03,083737,Patchell; Gregory David,26,0,30,4
1650312292104,MATH 10B,A01,083207,Staff,0,6,30,30
1650312292104,MATH 10B,A02,083208,Staff,0,6,30,30
1650312292104,MATH 10B,B01,083739,Staff,17,0,30,13
1650312292104,MATH 10B,B02,083740,Staff,28,0,30,2
1650312298133,MATH 18,A01,083743,Staff,6,0,30,24
1650312298133,MATH 18,A02,083744,Staff,26,0,30,4
1650312298133,MATH 18,A03,083745,Staff,22,0,30,8
1650312298133,MATH 18,A04,083746,Staff,27,0,30,3
1650312298133,MATH 18,B01,083748,Staff,0,11,30,30
1650312298133,MATH 18,B02,083749,Staff,0,10,30,30
1650312298133,MATH 18,B03,083750,Staff,1,9,30,29
1650312298133,MATH 18,B04,083751,Staff,0,10,30,30
1650312304165,MATH 20A,A01,083754,Staff,25,0,40,15
1650312310192,MATH 20B,A01,083756,Staff,0,5,30,30
1650312310192,MATH 20B,A02,083757,Staff,0,7,30,30
1650312316216,MATH 20C,A01,083760,Staff,0,13,30,30
1650312316216,MATH 20C,A02,083761,Staff,0,13,30,30
1650312316216,MATH 20C,B01,083762,Staff,13,0,30,17
1650312316216,MATH 20C,B02,083763,Staff,28,0,30,2
1650312322254,MATH 20D,A01,083765,Staff,0,1,30,30
1650312322254,MATH 20D,A02,083766,Staff,8,0,30,22
1650312322254,MATH 20D,A03,083767,Staff,27,0,30,3
1650312328286,MATH 20E,A01,083771,Staff,6,0,30,24
1650312328286,MATH 20E,A02,083772,Staff,19,0,30,11
1650312328286,MATH 20E,B01,083773,Staff,0,0,30,30
1650312328286,MATH 20E,B02,083774,Staff,12,0,30,18
1650312334314,MATH 103A,A01,083777,Staff,0,11,30,30
1650312334314,MATH 103A,A02,083778,Staff,0,10,30,30
1650312334314,MATH 103A,B01,083779,Staff,0,11,30,30
1650312334314,MATH 103A,B02,083780,Staff,0,11,30,30
1650312340338,MATH 105,A01,085443,Staff,0,17,30,30
1650312346364,MATH 109,A01,083213,Anzaldo; Leesa B,0,5,30,30
1650312346364,MATH 109,A02,083214,Anzaldo; Leesa B,0,6,30,30
1650312346364,MATH 109,B01,083215,Anzaldo; Leesa B,0,4,30,30
1650312346364,MATH 109,B02,083216,Anzaldo; Leesa B,0,4,30,30
1650312352387,MATH 142A,A01,083219,Chow; Bennett,0,14,30,30
1650312352387,MATH 142A,A02,083220,Chow; Bennett,0,11,30,30
1650312352387,MATH 142A,B01,083221,Chow; Bennett,0,11,30,30
1650312352387,MATH 142A,B02,083222,Chow; Bennett,0,12,30,30
1650312358414,MATH 193A,A01,083224,Staff,0,5,30,30
1650312358414,MATH 193A,A02,083225,Staff,0,5,30,30
1650312358414,MATH 193A,A03,083781,Staff,0,2,30,30
1650312358414,MATH 193A,A04,083782,Staff,0,3,30,30
1650312364436,MATH 197,001,091859,McAuley; Julian John,9998,0,9999,1
1650312370486,COGS 9,A01,083615,Staff,0,15,60,60
1650312376520,COGS 11,A01,083617,Boyle; Mary E. T.,22,0,40,18
1650312382550,COGS 13,A01,083071,Staff,0,31,40,40
1650312388577,COGS 14A,A01,092681,Staff,0,17,100,100
1650312394600,COGS 14B,A01,083073,Cheng; Tzu-Han,0,10,50,50
1650312400626,COGS 17,A01,092677,Staff,26,0,75,49
1650312406650,COGS 100,A01,083619,Staff,0,23,60,60
1650312412677,COGS 101A,A01,083621,Davis; Joshua Daniel,0,23,60,60
1650312418710,COGS 101B,A01,091572,Staff,3,0,60,57
1650312424737,COGS 101C,A01,083625,Delgado; Tania,19,0,30,11
1650312430781,COGS 107A,A01,083627,Boyle; Mary E. T.,0,8,60,60
1650312436806,COGS 118A,A01,083075,Staff,5,0,60,55
1650312442840,CSE 3,A50,083646,Miranda; Gregory Joseph,21,0,38,17
1650312442840,CSE 3,A51,083647,Miranda; Gregory Joseph,37,0,37,0
1650312448870,CSE 8A,A50,083650,Miranda; Gregory Joseph,0,26,40,40
1650312454896,CSE 11,A01,083080,Cao; Yingjun,0,83,40,40
1650312460928,CSE 12,A01,083652,Staff,0,11,100,100
1650312466969,CSE 15L,A01,083654,Staff,0,1,50,50
1650312466969,CSE 15L,A02,083655,Staff,4,0,50,46
1650312472994,CSE 20,A01,083657,Staff,53,0,80,27
1650312479026,CSE 30,A01,083084,Eldon; John,0,74,40,40
1650312485068,CSE 100,A01,083659,Cao; Yingjun,0,65,50,50
1650312491099,CSE 134B,A01,083661,Powell; Thomas Allan,0,30,65,65
1650312497136,CSE 140,A01,083663,Staff,0,0,75,75
1650312503188,CSE 140L,A01,083088,Eldon; John,0,6,75,75
1650312509212,CSE 175,A01,083665,Kumar; Rakesh,8,0,25,17
1650312515236,CSE 190,A00,092507,Dubnov; Shlomo,14,0,20,6
1650312521355,ECE 45,A01,083139,Staff,0,16,40,40
1650312527380,ECE 65,A50,083695,Staff,0,5,30,30
1650312533406,ECE 109,A01,091882,Touri; Behrouz,42,0,70,28
1650312539428,ECE 180,A00,083140,Abi Samra; Nicholas Camill,23,0,30,7
1650312539428,ECE 180,B00,083141,Abi Samra; Nicholas Camill,6,0,30,24
1650312545450,MATH 10A,A01,083735,Patchell; Gregory David,10,0,30,20
1650312545450,MATH 10A,A02,083736,Patchell; Gregory David,28,0,30,2
1650312545450,MATH 10A,A03,083737,Patchell; Gregory David,26,0,30,4
1650312551481,MATH 10B,A01,083207,Staff,0,6,30,30
1650312551481,MATH 10B,A02,083208,Staff,0,6,30,30
1650312551481,MATH 10B,B01,083739,Staff,17,0,30,13
1650312551481,MATH 10B,B02,083740,Staff,28,0,30,2
1650312557520,MATH 18,A01,083743,Staff,6,0,30,24
1650312557520,MATH 18,A02,083744,Staff,26,0,30,4
1650312557520,MATH 18,A03,083745,Staff,22,0,30,8
1650312557520,MATH 18,A04,083746,Staff,27,0,30,3
1650312557520,MATH 18,B01,083748,Staff,0,11,30,30
1650312557520,MATH 18,B02,083749,Staff,0,10,30,30
1650312557520,MATH 18,B03,083750,Staff,1,9,30,29
1650312557520,MATH 18,B04,083751,Staff,0,10,30,30
1650312563565,MATH 20A,A01,083754,Staff,25,0,40,15
1650312569589,MATH 20B,A01,083756,Staff,0,5,30,30
1650312569589,MATH 20B,A02,083757,Staff,0,7,30,30
1650312575613,MATH 20C,A01,083760,Staff,0,13,30,30
1650312575613,MATH 20C,A02,083761,Staff,0,13,30,30
1650312575613,MATH 20C,B01,083762,Staff,13,0,30,17
1650312575613,MATH 20C,B02,083763,Staff,28,0,30,2
1650312581640,MATH 20D,A01,083765,Staff,0,1,30,30
1650312581640,MATH 20D,A02,083766,Staff,8,0,30,22
1650312581640,MATH 20D,A03,083767,Staff,27,0,30,3
1650312587666,MATH 20E,A01,083771,Staff,6,0,30,24
1650312587666,MATH 20E,A02,083772,Staff,19,0,30,11
1650312587666,MATH 20E,B01,083773,Staff,0,0,30,30
1650312587666,MATH 20E,B02,083774,Staff,12,0,30,18
1650312593696,MATH 103A,A01,083777,Staff,0,11,30,30
1650312593696,MATH 103A,A02,083778,Staff,0,10,30,30
1650312593696,MATH 103A,B01,083779,Staff,0,11,30,30
1650312593696,MATH 103A,B02,083780,Staff,0,11,30,30
1650312599731,MATH 105,A01,085443,Staff,0,17,30,30
1650312605758,MATH 109,A01,083213,Anzaldo; Leesa B,0,5,30,30
1650312605758,MATH 109,A02,083214,Anzaldo; Leesa B,0,6,30,30
1650312605758,MATH 109,B01,083215,Anzaldo; Leesa B,0,4,30,30
1650312605758,MATH 109,B02,083216,Anzaldo; Leesa B,0,4,30,30
1650312611788,MATH 142A,A01,083219,Chow; Bennett,0,13,30,30
1650312611788,MATH 142A,A02,083220,Chow; Bennett,0,12,30,30
1650312611788,MATH 142A,B01,083221,Chow; Bennett,0,12,30,30
1650312611788,MATH 142A,B02,083222,Chow; Bennett,0,12,30,30
1650312617821,MATH 193A,A01,083224,Staff,0,5,30,30
1650312617821,MATH 193A,A02,083225,Staff,0,5,30,30
1650312617821,MATH 193A,A03,083781,Staff,0,3,30,30
1650312617821,MATH 193A,A04,083782,Staff,0,3,30,30
1650312623848,MATH 197,001,091859,McAuley; Julian John,9998,0,9999,1
1650312629904,COGS 9,A01,083615,Staff,0,15,60,60
1650312635928,COGS 11,A01,083617,Boyle; Mary E. T.,22,0,40,18
1650312641952,COGS 13,A01,083071,Staff,0,31,40,40
1650312647988,COGS 14A,A01,092681,Staff,0,17,100,100
1650312654026,COGS 14B,A01,083073,Cheng; Tzu-Han,0,10,50,50
1650312660049,COGS 17,A01,092677,Staff,26,0,75,49
1650312666076,COGS 100,A01,083619,Staff,0,23,60,60
1650312672100,COGS 101A,A01,083621,Davis; Joshua Daniel,0,23,60,60
1650312678127,COGS 101B,A01,091572,Staff,3,0,60,57
1650312684151,COGS 101C,A01,083625,Delgado; Tania,19,0,30,11
1650312690173,COGS 107A,A01,083627,Boyle; Mary E. T.,0,8,60,60
1650312696207,COGS 118A,A01,083075,Staff,5,0,60,55
1650312702247,CSE 3,A50,083646,Miranda; Gregory Joseph,21,0,38,17
1650312702247,CSE 3,A51,083647,Miranda; Gregory Joseph,37,0,37,0
1650312708269,CSE 8A,A50,083650,Miranda; Gregory Joseph,0,26,40,40
1650312714293,CSE 11,A01,083080,Cao; Yingjun,0,83,40,40
1650312720324,CSE 12,A01,083652,Staff,0,11,100,100
1650312726349,CSE 15L,A01,083654,Staff,0,1,50,50
1650312726349,CSE 15L,A02,083655,Staff,4,0,50,46
1650312732388,CSE 20,A01,083657,Staff,53,0,80,27
1650312738424,CSE 30,A01,083084,Eldon; John,0,74,40,40
1650312744458,CSE 100,A01,083659,Cao; Yingjun,0,65,50,50
1650312750482,CSE 134B,A01,083661,Powell; Thomas Allan,0,30,65,65
1650312756504,CSE 140,A01,083663,Staff,0,0,75,75
1650312762536,CSE 140L,A01,083088,Eldon; John,0,6,75,75
1650312768562,CSE 175,A01,083665,Kumar; Rakesh,8,0,25,17
1650312774593,CSE 190,A00,092507,Dubnov; Shlomo,14,0,20,6
1650312780627,ECE 45,A01,083139,Staff,0,16,40,40
1650312786651,ECE 65,A50,083695,Staff,0,5,30,30
1650312792672,ECE 109,A01,091882,Touri; Behrouz,42,0,70,28
1650312798698,ECE 180,A00,083140,Abi Samra; Nicholas Camill,23,0,30,7
1650312798698,ECE 180,B00,083141,Abi Samra; Nicholas Camill,6,0,30,24
1650312804722,MATH 10A,A01,083735,Patchell; Gregory David,10,0,30,20
1650312804722,MATH 10A,A02,083736,Patchell; Gregory David,28,0,30,2
1650312804722,MATH 10A,A03,083737,Patchell; Gregory David,26,0,30,4
1650312810756,MATH 10B,A01,083207,Staff,0,6,30,30
1650312810756,MATH 10B,A02,083208,Staff,0,6,30,30
1650312810756,MATH 10B,B01,083739,Staff,17,0,30,13
1650312810756,MATH 10B,B02,083740,Staff,28,0,30,2
1650312816780,MATH 18,A01,083743,Staff,5,0,30,25
1650312816780,MATH 18,A02,083744,Staff,26,0,30,4
1650312816780,MATH 18,A03,083745,Staff,22,0,30,8
1650312816780,MATH 18,A04,083746,Staff,27,0,30,3
1650312816780,MATH 18,B01,083748,Staff,0,11,30,30
1650312816780,MATH 18,B02,083749,Staff,0,10,30,30
1650312816780,MATH 18,B03,083750,Staff,1,9,30,29
1650312816780,MATH 18,B04,083751,Staff,0,10,30,30
1650312822802,MATH 20A,A01,083754,Staff,25,0,40,15
1650312828831,MATH 20B,A01,083756,Staff,0,5,30,30
1650312828831,MATH 20B,A02,083757,Staff,0,7,30,30
1650312834859,MATH 20C,A01,083760,Staff,0,13,30,30
1650312834859,MATH 20C,A02,083761,Staff,0,13,30,30
1650312834859,MATH 20C,B01,083762,Staff,13,0,30,17
1650312834859,MATH 20C,B02,083763,Staff,28,0,30,2
1650312840887,MATH 20D,A01,083765,Staff,0,1,30,30
1650312840887,MATH 20D,A02,083766,Staff,8,0,30,22
1650312840887,MATH 20D,A03,083767,Staff,27,0,30,3
1650312846915,MATH 20E,A01,083771,Staff,6,0,30,24
1650312846915,MATH 20E,A02,083772,Staff,19,0,30,11
1650312846915,MATH 20E,B01,083773,Staff,0,0,30,30
1650312846915,MATH 20E,B02,083774,Staff,12,0,30,18
1650312852943,MATH 103A,A01,083777,Staff,0,11,30,30
1650312852943,MATH 103A,A02,083778,Staff,0,11,30,30
1650312852943,MATH 103A,B01,083779,Staff,0,11,30,30
1650312852943,MATH 103A,B02,083780,Staff,0,11,30,30
1650312858970,MATH 105,A01,085443,Staff,0,17,30,30
1650312864995,MATH 109,A01,083213,Anzaldo; Leesa B,0,5,30,30
1650312864995,MATH 109,A02,083214,Anzaldo; Leesa B,0,6,30,30
1650312864995,MATH 109,B01,083215,Anzaldo; Leesa B,0,4,30,30
1650312864995,MATH 109,B02,083216,Anzaldo; Leesa B,0,4,30,30
1650312871028,MATH 142A,A01,083219,Chow; Bennett,0,13,30,30
1650312871028,MATH 142A,A02,083220,Chow; Bennett,0,12,30,30
1650312871028,MATH 142A,B01,083221,Chow; Bennett,0,12,30,30
1650312871028,MATH 142A,B02,083222,Chow; Bennett,0,12,30,30
1650312877056,MATH 193A,A01,083224,Staff,0,5,30,30
1650312877056,MATH 193A,A02,083225,Staff,0,5,30,30
1650312877056,MATH 193A,A03,083781,Staff,0,2,30,30
1650312877056,MATH 193A,A04,083782,Staff,0,3,30,30
1650312883084,MATH 197,001,091859,McAuley; Julian John,9998,0,9999,1
1650312889151,COGS 9,A01,083615,Staff,0,15,60,60
1650312895174,COGS 11,A01,083617,Boyle; Mary E. T.,22,0,40,18
1650312901201,COGS 13,A01,083071,Staff,0,31,40,40
1650312907248,COGS 14A,A01,092681,Staff,0,17,100,100
1650312913271,COGS 14B,A01,083073,Cheng; Tzu-Han,0,10,50,50
1650312919294,COGS 17,A01,092677,Staff,26,0,75,49
1650312925332,COGS 100,A01,083619,Staff,0,23,60,60
1650312931357,COGS 101A,A01,083621,Davis; Joshua Daniel,0,23,60,60
1650312937382,COGS 101B,A01,091572,Staff,3,0,60,57
1650312943406,COGS 101C,A01,083625,Delgado; Tania,19,0,30,11
1650312949429,COGS 107A,A01,083627,Boyle; Mary E. T.,0,8,60,60
1650312955457,COGS 118A,A01,083075,Staff,5,0,60,55
1650312961478,CSE 3,A50,083646,Miranda; Gregory Joseph,21,0,38,17
1650312961478,CSE 3,A51,083647,Miranda; Gregory Joseph,37,0,37,0
1650312967506,CSE 8A,A50,083650,Miranda; Gregory Joseph,0,26,40,40
1650312973534,CSE 11,A01,083080,Cao; Yingjun,0,82,40,40
1650312979570,CSE 12,A01,083652,Staff,0,11,100,100
1650312985596,CSE 15L,A01,083654,Staff,0,1,50,50
1650312985596,CSE 15L,A02,083655,Staff,4,0,50,46
1650312991620,CSE 20,A01,083657,Staff,53,0,80,27
1650312997648,CSE 30,A01,083084,Eldon; John,0,74,40,40
1650313003676,CSE 100,A01,083659,Cao; Yingjun,0,65,50,50
1650313009697,CSE 134B,A01,083661,Powell; Thomas Allan,0,30,65,65
1650313015722,CSE 140,A01,083663,Staff,0,0,75,75
1650313021750,CSE 140L,A01,083088,Eldon; John,0,6,75,75
1650313027784,CSE 175,A01,083665,Kumar; Rakesh,8,0,25,17
1650313033810,CSE 190,A00,092507,Dubnov; Shlomo,14,0,20,6
1650313039839,ECE 45,A01,083139,Staff,0,16,40,40
1650313045866,ECE 65,A50,083695,Staff,0,5,30,30
1650313051897,ECE 109,A01,091882,Touri; Behrouz,42,0,70,28
1650313057919,ECE 180,A00,083140,Abi Samra; Nicholas Camill,23,0,30,7
1650313057919,ECE 180,B00,083141,Abi Samra; Nicholas Camill,6,0,30,24
1650313063945,MATH 10A,A01,083735,Patchell; Gregory David,10,0,30,20
1650313063945,MATH 10A,A02,083736,Patchell; Gregory David,28,0,30,2
1650313063945,MATH 10A,A03,083737,Patchell; Gregory David,26,0,30,4
1650313069971,MATH 10B,A01,083207,Staff,0,6,30,30
1650313069971,MATH 10B,A02,083208,Staff,0,6,30,30
1650313069971,MATH 10B,B01,083739,Staff,17,0,30,13
1650313069971,MATH 10B,B02,083740,Staff,28,0,30,2
1650313076007,MATH 18,A01,083743,Staff,5,0,30,25
1650313076007,MATH 18,A02,083744,Staff,26,0,30,4
1650313076007,MATH 18,A03,083745,Staff,22,0,30,8
1650313076007,MATH 18,A04,083746,Staff,27,0,30,3
1650313076007,MATH 18,B01,083748,Staff,0,11,30,30
1650313076007,MATH 18,B02,083749,Staff,0,10,30,30
1650313076007,MATH 18,B03,083750,Staff,1,9,30,29
1650313076007,MATH 18,B04,083751,Staff,0,10,30,30
1650313082032,MATH 20A,A01,083754,Staff,25,0,40,15
1650313088069,MATH 20B,A01,083756,Staff,0,5,30,30
1650313088069,MATH 20B,A02,083757,Staff,0,7,30,30
1650313094096,MATH 20C,A01,083760,Staff,0,13,30,30
1650313094096,MATH 20C,A02,083761,Staff,0,13,30,30
1650313094096,MATH 20C,B01,083762,Staff,13,0,30,17
1650313094096,MATH 20C,B02,083763,Staff,28,0,30,2
1650313100132,MATH 20D,A01,083765,Staff,0,1,30,30
1650313100132,MATH 20D,A02,083766,Staff,8,0,30,22
1650313100132,MATH 20D,A03,083767,Staff,27,0,30,3
1650313106157,MATH 20E,A01,083771,Staff,6,0,30,24
1650313106157,MATH 20E,A02,083772,Staff,19,0,30,11
1650313106157,MATH 20E,B01,083773,Staff,0,0,30,30
1650313106157,MATH 20E,B02,083774,Staff,12,0,30,18
1650313112182,MATH 103A,A01,083777,Staff,0,12,30,30
1650313112182,MATH 103A,A02,083778,Staff,0,11,30,30
1650313112182,MATH 103A,B01,083779,Staff,0,11,30,30
1650313112182,MATH 103A,B02,083780,Staff,0,11,30,30
1650313118285,MATH 105,A01,085443,Staff,0,17,30,30
1650313124311,MATH 109,A01,083213,Anzaldo; Leesa B,0,5,30,30
1650313124311,MATH 109,A02,083214,Anzaldo; Leesa B,0,6,30,30
1650313124311,MATH 109,B01,083215,Anzaldo; Leesa B,0,4,30,30
1650313124311,MATH 109,B02,083216,Anzaldo; Leesa B,0,4,30,30
1650313130335,MATH 142A,A01,083219,Chow; Bennett,0,13,30,30
1650313130335,MATH 142A,A02,083220,Chow; Bennett,0,12,30,30
1650313130335,MATH 142A,B01,083221,Chow; Bennett,0,12,30,30
1650313130335,MATH 142A,B02,083222,Chow; Bennett,0,12,30,30
1650313136368,MATH 193A,A01,083224,Staff,0,5,30,30
1650313136368,MATH 193A,A02,083225,Staff,0,5,30,30
1650313136368,MATH 193A,A03,083781,Staff,0,2,30,30
1650313136368,MATH 193A,A04,083782,Staff,0,3,30,30
1650313142391,MATH 197,001,091859,McAuley; Julian John,9998,0,9999,1
1650313148459,COGS 9,A01,083615,Staff,0,15,60,60
1650313154481,COGS 11,A01,083617,Boyle; Mary E. T.,22,0,40,18
1650313160516,COGS 13,A01,083071,Staff,0,31,40,40
1650313166549,COGS 14A,A01,092681,Staff,0,17,100,100
1650313172571,COGS 14B,A01,083073,Cheng; Tzu-Han,0,10,50,50
1650313178605,COGS 17,A01,092677,Staff,26,0,75,49
1650313184636,COGS 100,A01,083619,Staff,0,23,60,60
1650313190677,COGS 101A,A01,083621,Davis; Joshua Daniel,0,23,60,60
1650313196700,COGS 101B,A01,091572,Staff,3,0,60,57
1650313202730,COGS 101C,A01,083625,Delgado; Tania,19,0,30,11
1650313208756,COGS 107A,A01,083627,Boyle; Mary E. T.,0,8,60,60
1650313214780,COGS 118A,A01,083075,Staff,5,0,60,55
1650313220812,CSE 3,A50,083646,Miranda; Gregory Joseph,21,0,38,17
1650313220812,CSE 3,A51,083647,Miranda; Gregory Joseph,37,0,37,0
1650313226852,CSE 8A,A50,083650,Miranda; Gregory Joseph,0,26,40,40
1650313232877,CSE 11,A01,083080,Cao; Yingjun,0,83,40,40
1650313238900,CSE 12,A01,083652,Staff,0,11,100,100
1650313244931,CSE 15L,A01,083654,Staff,0,1,50,50
1650313244931,CSE 15L,A02,083655,Staff,4,0,50,46
1650313250954,CSE 20,A01,083657,Staff,53,0,80,27
1650313256980,CSE 30,A01,083084,Eldon; John,0,74,40,40
1650313263006,CSE 100,A01,083659,Cao; Yingjun,0,65,50,50
1650313269044,CSE 134B,A01,083661,Powell; Thomas Allan,0,30,65,65
1650313275067,CSE 140,A01,083663,Staff,0,0,75,75
1650313281095,CSE 140L,A01,083088,Eldon; John,0,6,75,75
1650313287117,CSE 175,A01,083665,Kumar; Rakesh,8,0,25,17
1650313293150,CSE 190,A00,092507,Dubnov; Shlomo,14,0,20,6
1650313299177,ECE 45,A01,083139,Staff,0,16,40,40
1650313305201,ECE 65,A50,083695,Staff,0,5,30,30
1650313311234,ECE 109,A01,091882,Touri; Behrouz,42,0,70,28
1650313317262,ECE 180,A00,083140,Abi Samra; Nicholas Camill,23,0,30,7
1650313317262,ECE 180,B00,083141,Abi Samra; Nicholas Camill,6,0,30,24
1650313323285,MATH 10A,A01,083735,Patchell; Gregory David,10,0,30,20
1650313323285,MATH 10A,A02,083736,Patchell; Gregory David,28,0,30,2
1650313323285,MATH 10A,A03,083737,Patchell; Gregory David,26,0,30,4
1650313329308,MATH 10B,A01,083207,Staff,0,6,30,30
1650313329308,MATH 10B,A02,083208,Staff,0,6,30,30
1650313329308,MATH 10B,B01,083739,Staff,17,0,30,13
1650313329308,MATH 10B,B02,083740,Staff,28,0,30,2
1650313335335,MATH 18,A01,083743,Staff,5,0,30,25
1650313335335,MATH 18,A02,083744,Staff,26,0,30,4
1650313335335,MATH 18,A03,083745,Staff,22,0,30,8
1650313335335,MATH 18,A04,083746,Staff,27,0,30,3
1650313335335,MATH 18,B01,083748,Staff,0,11,30,30
1650313335335,MATH 18,B02,083749,Staff,0,10,30,30
1650313335335,MATH 18,B03,083750,Staff,1,9,30,29
1650313335335,MATH 18,B04,083751,Staff,0,10,30,30
1650313341370,MATH 20A,A01,083754,Staff,25,0,40,15
1650313347397,MATH 20B,A01,083756,Staff,0,5,30,30
1650313347397,MATH 20B,A02,083757,Staff,0,7,30,30
1650313353428,MATH 20C,A01,083760,Staff,0,13,30,30
1650313353428,MATH 20C,A02,083761,Staff,0,13,30,30
1650313353428,MATH 20C,B01,083762,Staff,13,0,30,17
1650313353428,MATH 20C,B02,083763,Staff,28,0,30,2
1650313359455,MATH 20D,A01,083765,Staff,0,1,30,30
1650313359455,MATH 20D,A02,083766,Staff,8,0,30,22
1650313359455,MATH 20D,A03,083767,Staff,27,0,30,3
1650313365485,MATH 20E,A01,083771,Staff,6,0,30,24
1650313365485,MATH 20E,A02,083772,Staff,19,0,30,11
1650313365485,MATH 20E,B01,083773,Staff,0,0,30,30
1650313365485,MATH 20E,B02,083774,Staff,12,0,30,18
1650313371518,MATH 103A,A01,083777,Staff,0,12,30,30
1650313371518,MATH 103A,A02,083778,Staff,0,11,30,30
1650313371518,MATH 103A,B01,083779,Staff,0,11,30,30
1650313371518,MATH 103A,B02,083780,Staff,0,11,30,30
1650313377539,MATH 105,A01,085443,Staff,0,17,30,30
1650313383571,MATH 109,A01,083213,Anzaldo; Leesa B,0,5,30,30
1650313383571,MATH 109,A02,083214,Anzaldo; Leesa B,0,6,30,30
1650313383571,MATH 109,B01,083215,Anzaldo; Leesa B,0,4,30,30
1650313383571,MATH 109,B02,083216,Anzaldo; Leesa B,0,4,30,30
1650313389593,MATH 142A,A01,083219,Chow; Bennett,0,13,30,30
1650313389593,MATH 142A,A02,083220,Chow; Bennett,0,12,30,30
1650313389593,MATH 142A,B01,083221,Chow; Bennett,0,12,30,30
1650313389593,MATH 142A,B02,083222,Chow; Bennett,0,12,30,30
1650313395614,MATH 193A,A01,083224,Staff,0,5,30,30
1650313395614,MATH 193A,A02,083225,Staff,0,5,30,30
1650313395614,MATH 193A,A03,083781,Staff,0,2,30,30
1650313395614,MATH 193A,A04,083782,Staff,0,3,30,30
1650313401644,MATH 197,001,091859,McAuley; Julian John,9998,0,9999,1
1650313407700,COGS 9,A01,083615,Staff,0,15,60,60
1650313413725,COGS 11,A01,083617,Boyle; Mary E. T.,22,0,40,18
1650313419753,COGS 13,A01,083071,Staff,0,31,40,40
1650313425777,COGS 14A,A01,092681,Staff,0,17,100,100
1650313431799,COGS 14B,A01,083073,Cheng; Tzu-Han,0,10,50,50
1650313437822,COGS 17,A01,092677,Staff,26,0,75,49
1650313443844,COGS 100,A01,083619,Staff,0,23,60,60
1650313449867,COGS 101A,A01,083621,Davis; Joshua Daniel,0,23,60,60
1650313455891,COGS 101B,A01,091572,Staff,3,0,60,57
1650313461914,COGS 101C,A01,083625,Delgado; Tania,19,0,30,11
1650313467940,COGS 107A,A01,083627,Boyle; Mary E. T.,0,8,60,60
1650313473962,COGS 118A,A01,083075,Staff,5,0,60,55
1650313479993,CSE 3,A50,083646,Miranda; Gregory Joseph,21,0,38,17
1650313479993,CSE 3,A51,083647,Miranda; Gregory Joseph,37,0,37,0
1650313486028,CSE 8A,A50,083650,Miranda; Gregory Joseph,0,26,40,40
1650313492051,CSE 11,A01,083080,Cao; Yingjun,0,83,40,40
1650313498073,CSE 12,A01,083652,Staff,0,11,100,100
1650313504106,CSE 15L,A01,083654,Staff,0,1,50,50
1650313504106,CSE 15L,A02,083655,Staff,4,0,50,46
1650313510130,CSE 20,A01,083657,Staff,53,0,80,27
1650313516154,CSE 30,A01,083084,Eldon; John,0,74,40,40
1650313522183,CSE 100,A01,083659,Cao; Yingjun,0,65,50,50
1650313528210,CSE 134B,A01,083661,Powell; Thomas Allan,0,30,65,65
1650313534232,CSE 140,A01,083663,Staff,0,0,75,75
1650313540255,CSE 140L,A01,083088,Eldon; John,0,6,75,75
1650313546281,CSE 175,A01,083665,Kumar; Rakesh,8,0,25,17
1650313552305,CSE 190,A00,092507,Dubnov; Shlomo,14,0,20,6
1650313558329,ECE 45,A01,083139,Staff,0,16,40,40
1650313564362,ECE 65,A50,083695,Staff,0,5,30,30
1650313570391,ECE 109,A01,091882,Touri; Behrouz,42,0,70,28
1650313576421,ECE 180,A00,083140,Abi Samra; Nicholas Camill,23,0,30,7
1650313576421,ECE 180,B00,083141,Abi Samra; Nicholas Camill,6,0,30,24
1650313582459,MATH 10A,A01,083735,Patchell; Gregory David,10,0,30,20
1650313582459,MATH 10A,A02,083736,Patchell; Gregory David,28,0,30,2
1650313582459,MATH 10A,A03,083737,Patchell; Gregory David,26,0,30,4
1650313588486,MATH 10B,A01,083207,Staff,0,6,30,30
1650313588486,MATH 10B,A02,083208,Staff,0,6,30,30
1650313588486,MATH 10B,B01,083739,Staff,17,0,30,13
1650313588486,MATH 10B,B02,083740,Staff,28,0,30,2
1650313594511,MATH 18,A01,083743,Staff,5,0,30,25
1650313594511,MATH 18,A02,083744,Staff,26,0,30,4
1650313594511,MATH 18,A03,083745,Staff,22,0,30,8
1650313594511,MATH 18,A04,083746,Staff,27,0,30,3
1650313594511,MATH 18,B01,083748,Staff,0,11,30,30
1650313594511,MATH 18,B02,083749,Staff,0,10,30,30
1650313594511,MATH 18,B03,083750,Staff,1,9,30,29
1650313594511,MATH 18,B04,083751,Staff,0,10,30,30
1650313600535,MATH 20A,A01,083754,Staff,25,0,40,15
1650313606559,MATH 20B,A01,083756,Staff,0,5,30,30
1650313606559,MATH 20B,A02,083757,Staff,0,7,30,30
1650313612583,MATH 20C,A01,083760,Staff,0,13,30,30
1650313612583,MATH 20C,A02,083761,Staff,0,13,30,30
1650313612583,MATH 20C,B01,083762,Staff,13,0,30,17
1650313612583,MATH 20C,B02,083763,Staff,28,0,30,2
1650313618612,MATH 20D,A01,083765,Staff,0,1,30,30
1650313618612,MATH 20D,A02,083766,Staff,8,0,30,22
1650313618612,MATH 20D,A03,083767,Staff,27,0,30,3
1650313624639,MATH 20E,A01,083771,Staff,6,0,30,24
1650313624639,MATH 20E,A02,083772,Staff,19,0,30,11
1650313624639,MATH 20E,B01,083773,Staff,0,0,30,30
1650313624639,MATH 20E,B02,083774,Staff,12,0,30,18
1650313630662,MATH 103A,A01,083777,Staff,0,12,30,30
1650313630662,MATH 103A,A02,083778,Staff,0,11,30,30
1650313630662,MATH 103A,B01,083779,Staff,0,11,30,30
1650313630662,MATH 103A,B02,083780,Staff,0,11,30,30
1650313636686,MATH 105,A01,085443,Staff,0,17,30,30
1650313642713,MATH 109,A01,083213,Anzaldo; Leesa B,0,5,30,30
1650313642713,MATH 109,A02,083214,Anzaldo; Leesa B,0,6,30,30
1650313642713,MATH 109,B01,083215,Anzaldo; Leesa B,0,4,30,30
1650313642713,MATH 109,B02,083216,Anzaldo; Leesa B,0,4,30,30
1650313648736,MATH 142A,A01,083219,Chow; Bennett,0,13,30,30
1650313648736,MATH 142A,A02,083220,Chow; Bennett,0,12,30,30
1650313648736,MATH 142A,B01,083221,Chow; Bennett,0,12,30,30
1650313648736,MATH 142A,B02,083222,Chow; Bennett,0,12,30,30
1650313654762,MATH 193A,A01,083224,Staff,0,5,30,30
1650313654762,MATH 193A,A02,083225,Staff,0,5,30,30
1650313654762,MATH 193A,A03,083781,Staff,0,2,30,30
1650313654762,MATH 193A,A04,083782,Staff,0,3,30,30
1650313660796,MATH 197,001,091859,McAuley; Julian John,9998,0,9999,1
1650313666855,COGS 9,A01,083615,Staff,0,15,60,60
1650313672883,COGS 11,A01,083617,Boyle; Mary E. T.,22,0,40,18
1650313678907,COGS 13,A01,083071,Staff,0,31,40,40
1650313684931,COGS 14A,A01,092681,Staff,0,17,100,100
1650313690954,COGS 14B,A01,083073,Cheng; Tzu-Han,0,10,50,50
1650313696976,COGS 17,A01,092677,Staff,26,0,75,49
1650313703000,COGS 100,A01,083619,Staff,0,23,60,60
1650313709103,COGS 101A,A01,083621,Davis; Joshua Daniel,0,23,60,60
1650313715131,COGS 101B,A01,091572,Staff,3,0,60,57
1650313721156,COGS 101C,A01,083625,Delgado; Tania,19,0,30,11
1650313727182,COGS 107A,A01,083627,Boyle; Mary E. T.,0,8,60,60
1650313733217,COGS 118A,A01,083075,Staff,5,0,60,55
1650313739247,CSE 3,A50,083646,Miranda; Gregory Joseph,21,0,38,17
1650313739247,CSE 3,A51,083647,Miranda; Gregory Joseph,37,0,37,0
1650313745271,CSE 8A,A50,083650,Miranda; Gregory Joseph,0,26,40,40
1650313751293,CSE 11,A01,083080,Cao; Yingjun,0,83,40,40
1650313757315,CSE 12,A01,083652,Staff,0,11,100,100
1650313763341,CSE 15L,A01,083654,Staff,0,1,50,50
1650313763341,CSE 15L,A02,083655,Staff,4,0,50,46
1650313769370,CSE 20,A01,083657,Staff,53,0,80,27
1650313775396,CSE 30,A01,083084,Eldon; John,0,74,40,40
1650313781420,CSE 100,A01,083659,Cao; Yingjun,0,65,50,50
1650313787445,CSE 134B,A01,083661,Powell; Thomas Allan,0,30,65,65
1650313793470,CSE 140,A01,083663,Staff,0,0,75,75
1650313799500,CSE 140L,A01,083088,Eldon; John,0,6,75,75
1650313805533,CSE 175,A01,083665,Kumar; Rakesh,8,0,25,17
1650313811576,CSE 190,A00,092507,Dubnov; Shlomo,14,0,20,6
1650313817599,ECE 45,A01,083139,Staff,0,16,40,40
1650313823621,ECE 65,A50,083695,Staff,0,5,30,30
1650313829646,ECE 109,A01,091882,Touri; Behrouz,42,0,70,28
1650313835677,ECE 180,A00,083140,Abi Samra; Nicholas Camill,23,0,30,7
1650313835677,ECE 180,B00,083141,Abi Samra; Nicholas Camill,6,0,30,24
1650313841700,MATH 10A,A01,083735,Patchell; Gregory David,10,0,30,20
1650313841700,MATH 10A,A02,083736,Patchell; Gregory David,28,0,30,2
1650313841700,MATH 10A,A03,083737,Patchell; Gregory David,26,0,30,4
1650313847729,MATH 10B,A01,083207,Staff,0,6,30,30
1650313847729,MATH 10B,A02,083208,Staff,0,6,30,30
1650313847729,MATH 10B,B01,083739,Staff,17,0,30,13
1650313847729,MATH 10B,B02,083740,Staff,28,0,30,2
1650313853761,MATH 18,A01,083743,Staff,5,0,30,25
1650313853761,MATH 18,A02,083744,Staff,26,0,30,4
1650313853761,MATH 18,A03,083745,Staff,22,0,30,8
1650313853761,MATH 18,A04,083746,Staff,27,0,30,3
1650313853761,MATH 18,B01,083748,Staff,0,11,30,30
1650313853761,MATH 18,B02,083749,Staff,0,10,30,30
1650313853761,MATH 18,B03,083750,Staff,1,9,30,29
1650313853761,MATH 18,B04,083751,Staff,0,10,30,30
1650313859786,MATH 20A,A01,083754,Staff,25,0,40,15
1650313865809,MATH 20B,A01,083756,Staff,0,5,30,30
1650313865809,MATH 20B,A02,083757,Staff,0,7,30,30
1650313871837,MATH 20C,A01,083760,Staff,0,13,30,30
1650313871837,MATH 20C,A02,083761,Staff,0,13,30,30
1650313871837,MATH 20C,B01,083762,Staff,13,0,30,17
1650313871837,MATH 20C,B02,083763,Staff,28,0,30,2
1650313877861,MATH 20D,A01,083765,Staff,0,1,30,30
1650313877861,MATH 20D,A02,083766,Staff,8,0,30,22
1650313877861,MATH 20D,A03,083767,Staff,27,0,30,3
1650313883885,MATH 20E,A01,083771,Staff,6,0,30,24
1650313883885,MATH 20E,A02,083772,Staff,19,0,30,11
1650313883885,MATH 20E,B01,083773,Staff,0,0,30,30
1650313883885,MATH 20E,B02,083774,Staff,12,0,30,18
1650313889920,MATH 103A,A01,083777,Staff,0,12,30,30
1650313889920,MATH 103A,A02,083778,Staff,0,11,30,30
1650313889920,MATH 103A,B01,083779,Staff,0,11,30,30
1650313889920,MATH 103A,B02,083780,Staff,0,11,30,30
1650313895951,MATH 105,A01,085443,Staff,0,17,30,30
1650313901979,MATH 109,A01,083213,Anzaldo; Leesa B,0,5,30,30
1650313901979,MATH 109,A02,083214,Anzaldo; Leesa B,0,6,30,30
1650313901979,MATH 109,B01,083215,Anzaldo; Leesa B,0,4,30,30
1650313901979,MATH 109,B02,083216,Anzaldo; Leesa B,0,4,30,30
1650313908001,MATH 142A,A01,083219,Chow; Bennett,0,13,30,30
1650313908001,MATH 142A,A02,083220,Chow; Bennett,0,12,30,30
1650313908001,MATH 142A,B01,083221,Chow; Bennett,0,12,30,30
1650313908001,MATH 142A,B02,083222,Chow; Bennett,0,12,30,30
1650313914025,MATH 193A,A01,083224,Staff,0,5,30,30
1650313914025,MATH 193A,A02,083225,Staff,0,5,30,30
1650313914025,MATH 193A,A03,083781,Staff,0,2,30,30
1650313914025,MATH 193A,A04,083782,Staff,0,3,30,30
1650313920060,MATH 197,001,091859,McAuley; Julian John,9998,0,9999,1
1650313926145,COGS 9,A01,083615,Staff,0,15,60,60
1650313932176,COGS 11,A01,083617,Boyle; Mary E. T.,22,0,40,18
1650313938213,COGS 13,A01,083071,Staff,0,31,40,40
1650313944234,COGS 14A,A01,092681,Staff,0,17,100,100
1650313950261,COGS 14B,A01,083073,Cheng; Tzu-Han,0,10,50,50
1650313956284,COGS 17,A01,092677,Staff,26,0,75,49
1650313962306,COGS 100,A01,083619,Staff,0,23,60,60
1650313968449,COGS 101A,A01,083621,Davis; Joshua Daniel,0,23,60,60
1650313974473,COGS 101B,A01,091572,Staff,3,0,60,57
1650313980505,COGS 101C,A01,083625,Delgado; Tania,19,0,30,11
1650313986529,COGS 107A,A01,083627,Boyle; Mary E. T.,0,8,60,60
1650313992561,COGS 118A,A01,083075,Staff,5,0,60,55
1650313998589,CSE 3,A50,083646,Miranda; Gregory Joseph,21,0,38,17
1650313998589,CSE 3,A51,083647,Miranda; Gregory Joseph,37,0,37,0
1650314004618,CSE 8A,A50,083650,Miranda; Gregory Joseph,0,26,40,40
1650314010640,CSE 11,A01,083080,Cao; Yingjun,0,83,40,40
1650314016662,CSE 12,A01,083652,Staff,0,11,100,100
1650314022686,CSE 15L,A01,083654,Staff,0,1,50,50
1650314022686,CSE 15L,A02,083655,Staff,4,0,50,46
1650314028714,CSE 20,A01,083657,Staff,53,0,80,27
1650314034740,CSE 30,A01,083084,Eldon; John,0,74,40,40
1650314040768,CSE 100,A01,083659,Cao; Yingjun,0,65,50,50
1650314046790,CSE 134B,A01,083661,Powell; Thomas Allan,0,30,65,65
1650314052812,CSE 140,A01,083663,Staff,0,0,75,75
1650314058837,CSE 140L,A01,083088,Eldon; John,0,6,75,75
1650314064863,CSE 175,A01,083665,Kumar; Rakesh,8,0,25,17
1650314070892,CSE 190,A00,092507,Dubnov; Shlomo,14,0,20,6
1650314076920,ECE 45,A01,083139,Staff,0,16,40,40
1650314082952,ECE 65,A50,083695,Staff,0,5,30,30
1650314088976,ECE 109,A01,091882,Touri; Behrouz,42,0,70,28
1650314095009,ECE 180,A00,083140,Abi Samra; Nicholas Camill,23,0,30,7
1650314095009,ECE 180,B00,083141,Abi Samra; Nicholas Camill,6,0,30,24
1650314101053,MATH 10A,A01,083735,Patchell; Gregory David,10,0,30,20
1650314101053,MATH 10A,A02,083736,Patchell; Gregory David,28,0,30,2
1650314101053,MATH 10A,A03,083737,Patchell; Gregory David,26,0,30,4
1650314107080,MATH 10B,A01,083207,Staff,0,6,30,30
1650314107080,MATH 10B,A02,083208,Staff,0,6,30,30
1650314107080,MATH 10B,B01,083739,Staff,17,0,30,13
1650314107080,MATH 10B,B02,083740,Staff,28,0,30,2
1650314113119,MATH 18,A01,083743,Staff,5,0,30,25
1650314113119,MATH 18,A02,083744,Staff,26,0,30,4
1650314113119,MATH 18,A03,083745,Staff,22,0,30,8
1650314113119,MATH 18,A04,083746,Staff,27,0,30,3
1650314113119,MATH 18,B01,083748,Staff,0,11,30,30
1650314113119,MATH 18,B02,083749,Staff,0,10,30,30
1650314113119,MATH 18,B03,083750,Staff,1,9,30,29
1650314113119,MATH 18,B04,083751,Staff,0,10,30,30
1650314119144,MATH 20A,A01,083754,Staff,25,0,40,15
1650314125168,MATH 20B,A01,083756,Staff,0,5,30,30
1650314125168,MATH 20B,A02,083757,Staff,0,7,30,30
1650314131195,MATH 20C,A01,083760,Staff,0,13,30,30
1650314131195,MATH 20C,A02,083761,Staff,0,13,30,30
1650314131195,MATH 20C,B01,083762,Staff,13,0,30,17
1650314131195,MATH 20C,B02,083763,Staff,28,0,30,2
1650314137222,MATH 20D,A01,083765,Staff,0,1,30,30
1650314137222,MATH 20D,A02,083766,Staff,8,0,30,22
1650314137222,MATH 20D,A03,083767,Staff,27,0,30,3
1650314143253,MATH 20E,A01,083771,Staff,6,0,30,24
1650314143253,MATH 20E,A02,083772,Staff,19,0,30,11
1650314143253,MATH 20E,B01,083773,Staff,0,0,30,30
1650314143253,MATH 20E,B02,083774,Staff,12,0,30,18
1650314149279,MATH 103A,A01,083777,Staff,0,12,30,30
1650314149279,MATH 103A,A02,083778,Staff,0,11,30,30
1650314149279,MATH 103A,B01,083779,Staff,0,11,30,30
1650314149279,MATH 103A,B02,083780,Staff,0,11,30,30
1650314155304,MATH 105,A01,085443,Staff,0,17,30,30
1650314161335,MATH 109,A01,083213,Anzaldo; Leesa B,0,5,30,30
1650314161335,MATH 109,A02,083214,Anzaldo; Leesa B,0,6,30,30
1650314161335,MATH 109,B01,083215,Anzaldo; Leesa B,0,4,30,30
1650314161335,MATH 109,B02,083216,Anzaldo; Leesa B,0,4,30,30
1650314167365,MATH 142A,A01,083219,Chow; Bennett,0,13,30,30
1650314167365,MATH 142A,A02,083220,Chow; Bennett,0,12,30,30
1650314167365,MATH 142A,B01,083221,Chow; Bennett,0,12,30,30
1650314167365,MATH 142A,B02,083222,Chow; Bennett,0,12,30,30
1650314173392,MATH 193A,A01,083224,Staff,0,5,30,30
1650314173392,MATH 193A,A02,083225,Staff,0,5,30,30
1650314173392,MATH 193A,A03,083781,Staff,0,2,30,30
1650314173392,MATH 193A,A04,083782,Staff,0,3,30,30
1650314179416,MATH 197,001,091859,McAuley; Julian John,9998,0,9999,1
1650314185476,COGS 9,A01,083615,Staff,0,15,60,60
1650314191508,COGS 11,A01,083617,Boyle; Mary E. T.,22,0,40,18
1650314197539,COGS 13,A01,083071,Staff,0,31,40,40
1650314203564,COGS 14A,A01,092681,Staff,0,17,100,100
1650314209586,COGS 14B,A01,083073,Cheng; Tzu-Han,0,10,50,50
1650314215613,COGS 17,A01,092677,Staff,26,0,75,49
1650314221646,COGS 100,A01,083619,Staff,0,23,60,60
1650314227670,COGS 101A,A01,083621,Davis; Joshua Daniel,0,23,60,60
1650314233694,COGS 101B,A01,091572,Staff,3,0,60,57
1650314239720,COGS 101C,A01,083625,Delgado; Tania,19,0,30,11
1650314245748,COGS 107A,A01,083627,Boyle; Mary E. T.,0,8,60,60
1650314251779,COGS 118A,A01,083075,Staff,5,0,60,55
1650314257808,CSE 3,A50,083646,Miranda; Gregory Joseph,21,0,38,17
1650314257808,CSE 3,A51,083647,Miranda; Gregory Joseph,37,0,37,0
1650314263832,CSE 8A,A50,083650,Miranda; Gregory Joseph,0,26,40,40
1650314269858,CSE 11,A01,083080,Cao; Yingjun,0,83,40,40
1650314275892,CSE 12,A01,083652,Staff,0,11,100,100
1650314281920,CSE 15L,A01,083654,Staff,0,1,50,50
1650314281920,CSE 15L,A02,083655,Staff,4,0,50,46
1650314287947,CSE 20,A01,083657,Staff,53,0,80,27
1650314293971,CSE 30,A01,083084,Eldon; John,0,74,40,40
1650314299995,CSE 100,A01,083659,Cao; Yingjun,0,65,50,50
1650314306125,CSE 134B,A01,083661,Powell; Thomas Allan,0,30,65,65
1650314312149,CSE 140,A01,083663,Staff,0,0,75,75
1650314318176,CSE 140L,A01,083088,Eldon; John,0,6,75,75
1650314324210,CSE 175,A01,083665,Kumar; Rakesh,8,0,25,17
1650314330237,CSE 190,A00,092507,Dubnov; Shlomo,14,0,20,6
1650314336261,ECE 45,A01,083139,Staff,0,16,40,40
1650314342299,ECE 65,A50,083695,Staff,0,5,30,30
1650314348334,ECE 109,A01,091882,Touri; Behrouz,42,0,70,28
1650314354361,ECE 180,A00,083140,Abi Samra; Nicholas Camill,23,0,30,7
1650314354361,ECE 180,B00,083141,Abi Samra; Nicholas Camill,6,0,30,24
1650314360389,MATH 10A,A01,083735,Patchell; Gregory David,10,0,30,20
1650314360389,MATH 10A,A02,083736,Patchell; Gregory David,28,0,30,2
1650314360389,MATH 10A,A03,083737,Patchell; Gregory David,26,0,30,4
1650314366416,MATH 10B,A01,083207,Staff,0,6,30,30
1650314366416,MATH 10B,A02,083208,Staff,0,6,30,30
1650314366416,MATH 10B,B01,083739,Staff,17,0,30,13
1650314366416,MATH 10B,B02,083740,Staff,28,0,30,2
1650314372441,MATH 18,A01,083743,Staff,5,0,30,25
1650314372441,MATH 18,A02,083744,Staff,26,0,30,4
1650314372441,MATH 18,A03,083745,Staff,22,0,30,8
1650314372441,MATH 18,A04,083746,Staff,27,0,30,3
1650314372441,MATH 18,B01,083748,Staff,0,11,30,30
1650314372441,MATH 18,B02,083749,Staff,0,10,30,30
1650314372441,MATH 18,B03,083750,Staff,1,9,30,29
1650314372441,MATH 18,B04,083751,Staff,0,10,30,30
1650314378466,MATH 20A,A01,083754,Staff,25,0,40,15
1650314384502,MATH 20B,A01,083756,Staff,0,5,30,30
1650314384502,MATH 20B,A02,083757,Staff,0,7,30,30
1650314390529,MATH 20C,A01,083760,Staff,0,13,30,30
1650314390529,MATH 20C,A02,083761,Staff,0,13,30,30
1650314390529,MATH 20C,B01,083762,Staff,13,0,30,17
1650314390529,MATH 20C,B02,083763,Staff,28,0,30,2
1650314396558,MATH 20D,A01,083765,Staff,0,1,30,30
1650314396558,MATH 20D,A02,083766,Staff,8,0,30,22
1650314396558,MATH 20D,A03,083767,Staff,27,0,30,3
1650314402597,MATH 20E,A01,083771,Staff,6,0,30,24
1650314402597,MATH 20E,A02,083772,Staff,19,0,30,11
1650314402597,MATH 20E,B01,083773,Staff,0,0,30,30
1650314402597,MATH 20E,B02,083774,Staff,12,0,30,18
1650314408626,MATH 103A,A01,083777,Staff,0,12,30,30
1650314408626,MATH 103A,A02,083778,Staff,0,11,30,30
1650314408626,MATH 103A,B01,083779,Staff,0,11,30,30
1650314408626,MATH 103A,B02,083780,Staff,0,11,30,30
1650314414653,MATH 105,A01,085443,Staff,0,17,30,30
1650314420683,MATH 109,A01,083213,Anzaldo; Leesa B,0,5,30,30
1650314420683,MATH 109,A02,083214,Anzaldo; Leesa B,0,6,30,30
1650314420683,MATH 109,B01,083215,Anzaldo; Leesa B,0,4,30,30
1650314420683,MATH 109,B02,083216,Anzaldo; Leesa B,0,4,30,30
1650314426718,MATH 142A,A01,083219,Chow; Bennett,0,13,30,30
1650314426718,MATH 142A,A02,083220,Chow; Bennett,0,12,30,30
1650314426718,MATH 142A,B01,083221,Chow; Bennett,0,12,30,30
1650314426718,MATH 142A,B02,083222,Chow; Bennett,0,12,30,30
1650314432747,MATH 193A,A01,083224,Staff,0,5,30,30
1650314432747,MATH 193A,A02,083225,Staff,0,5,30,30
1650314432747,MATH 193A,A03,083781,Staff,0,2,30,30
1650314432747,MATH 193A,A04,083782,Staff,0,3,30,30
1650314438770,MATH 197,001,091859,McAuley; Julian John,9998,0,9999,1
1650314444842,COGS 9,A01,083615,Staff,0,15,60,60
1650314450877,COGS 11,A01,083617,Boyle; Mary E. T.,22,0,40,18
1650314456904,COGS 13,A01,083071,Staff,0,31,40,40
1650314462965,COGS 14A,A01,092681,Staff,0,17,100,100
1650314468992,COGS 14B,A01,083073,Cheng; Tzu-Han,0,10,50,50
1650314475014,COGS 17,A01,092677,Staff,26,0,75,49
1650314481040,COGS 100,A01,083619,Staff,0,23,60,60
1650314487063,COGS 101A,A01,083621,Davis; Joshua Daniel,0,23,60,60
1650314493101,COGS 101B,A01,091572,Staff,3,0,60,57
1650314499128,COGS 101C,A01,083625,Delgado; Tania,19,0,30,11
1650314505152,COGS 107A,A01,083627,Boyle; Mary E. T.,0,8,60,60
1650314511176,COGS 118A,A01,083075,Staff,5,0,60,55
1650314517200,CSE 3,A50,083646,Miranda; Gregory Joseph,21,0,38,17
1650314517200,CSE 3,A51,083647,Miranda; Gregory Joseph,37,0,37,0
1650314523228,CSE 8A,A50,083650,Miranda; Gregory Joseph,0,26,40,40
1650314529251,CSE 11,A01,083080,Cao; Yingjun,0,83,40,40
1650314535290,CSE 12,A01,083652,Staff,0,11,100,100
1650314541317,CSE 15L,A01,083654,Staff,0,1,50,50
1650314541317,CSE 15L,A02,083655,Staff,4,0,50,46
1650314547341,CSE 20,A01,083657,Staff,53,0,80,27
1650314553367,CSE 30,A01,083084,Eldon; John,0,74,40,40
1650314559390,CSE 100,A01,083659,Cao; Yingjun,0,65,50,50
1650314565418,CSE 134B,A01,083661,Powell; Thomas Allan,0,30,65,65
1650314571443,CSE 140,A01,083663,Staff,0,0,75,75
1650314577479,CSE 140L,A01,083088,Eldon; John,0,6,75,75
1650314583505,CSE 175,A01,083665,Kumar; Rakesh,8,0,25,17
1650314589526,CSE 190,A00,092507,Dubnov; Shlomo,14,0,20,6
1650314595549,ECE 45,A01,083139,Staff,0,16,40,40
1650314601575,ECE 65,A50,083695,Staff,0,5,30,30
1650314607610,ECE 109,A01,091882,Touri; Behrouz,42,0,70,28
1650314613641,ECE 180,A00,083140,Abi Samra; Nicholas Camill,23,0,30,7
1650314613641,ECE 180,B00,083141,Abi Samra; Nicholas Camill,6,0,30,24
1650314619665,MATH 10A,A01,083735,Patchell; Gregory David,10,0,30,20
1650314619665,MATH 10A,A02,083736,Patchell; Gregory David,28,0,30,2
1650314619665,MATH 10A,A03,083737,Patchell; Gregory David,26,0,30,4
1650314625689,MATH 10B,A01,083207,Staff,0,6,30,30
1650314625689,MATH 10B,A02,083208,Staff,0,6,30,30
1650314625689,MATH 10B,B01,083739,Staff,17,0,30,13
1650314625689,MATH 10B,B02,083740,Staff,28,0,30,2
1650314631722,MATH 18,A01,083743,Staff,5,0,30,25
1650314631722,MATH 18,A02,083744,Staff,26,0,30,4
1650314631722,MATH 18,A03,083745,Staff,22,0,30,8
1650314631722,MATH 18,A04,083746,Staff,27,0,30,3
1650314631722,MATH 18,B01,083748,Staff,0,11,30,30
1650314631722,MATH 18,B02,083749,Staff,0,10,30,30
1650314631722,MATH 18,B03,083750,Staff,1,9,30,29
1650314631722,MATH 18,B04,083751,Staff,0,10,30,30
1650314637747,MATH 20A,A01,083754,Staff,25,0,40,15
1650314643773,MATH 20B,A01,083756,Staff,0,5,30,30
1650314643773,MATH 20B,A02,083757,Staff,0,7,30,30
1650314649811,MATH 20C,A01,083760,Staff,0,13,30,30
1650314649811,MATH 20C,A02,083761,Staff,0,13,30,30
1650314649811,MATH 20C,B01,083762,Staff,13,0,30,17
1650314649811,MATH 20C,B02,083763,Staff,28,0,30,2
1650314655837,MATH 20D,A01,083765,Staff,0,1,30,30
1650314655837,MATH 20D,A02,083766,Staff,8,0,30,22
1650314655837,MATH 20D,A03,083767,Staff,27,0,30,3
1650314661873,MATH 20E,A01,083771,Staff,6,0,30,24
1650314661873,MATH 20E,A02,083772,Staff,19,0,30,11
1650314661873,MATH 20E,B01,083773,Staff,0,0,30,30
1650314661873,MATH 20E,B02,083774,Staff,12,0,30,18
1650314667900,MATH 103A,A01,083777,Staff,0,12,30,30
1650314667900,MATH 103A,A02,083778,Staff,0,11,30,30
1650314667900,MATH 103A,B01,083779,Staff,0,11,30,30
1650314667900,MATH 103A,B02,083780,Staff,0,11,30,30
1650314673936,MATH 105,A01,085443,Staff,0,17,30,30
1650314679970,MATH 109,A01,083213,Anzaldo; Leesa B,0,5,30,30
1650314679970,MATH 109,A02,083214,Anzaldo; Leesa B,0,6,30,30
1650314679970,MATH 109,B01,083215,Anzaldo; Leesa B,0,4,30,30
1650314679970,MATH 109,B02,083216,Anzaldo; Leesa B,0,4,30,30
1650314686002,MATH 142A,A01,083219,Chow; Bennett,0,13,30,30
1650314686002,MATH 142A,A02,083220,Chow; Bennett,0,12,30,30
1650314686002,MATH 142A,B01,083221,Chow; Bennett,0,12,30,30
1650314686002,MATH 142A,B02,083222,Chow; Bennett,0,12,30,30
1650314692042,MATH 193A,A01,083224,Staff,0,5,30,30
1650314692042,MATH 193A,A02,083225,Staff,0,5,30,30
1650314692042,MATH 193A,A03,083781,Staff,0,2,30,30
1650314692042,MATH 193A,A04,083782,Staff,0,3,30,30
1650314698072,MATH 197,001,091859,McAuley; Julian John,9998,0,9999,1
1650314704136,COGS 9,A01,083615,Staff,0,15,60,60
1650314710169,COGS 11,A01,083617,Boyle; Mary E. T.,22,0,40,18
1650314716200,COGS 13,A01,083071,Staff,0,31,40,40
1650314722226,COGS 14A,A01,092681,Staff,0,18,100,100
1650314728250,COGS 14B,A01,083073,Cheng; Tzu-Han,0,10,50,50
1650314734274,COGS 17,A01,092677,Staff,26,0,75,49
1650314740302,COGS 100,A01,083619,Staff,0,23,60,60
1650314746324,COGS 101A,A01,083621,Davis; Joshua Daniel,0,23,60,60
1650314752357,COGS 101B,A01,091572,Staff,3,0,60,57
1650314758382,COGS 101C,A01,083625,Delgado; Tania,19,0,30,11
1650314764417,COGS 107A,A01,083627,Boyle; Mary E. T.,0,8,60,60
1650314770441,COGS 118A,A01,083075,Staff,5,0,60,55
1650314776467,CSE 3,A50,083646,Miranda; Gregory Joseph,21,0,38,17
1650314776467,CSE 3,A51,083647,Miranda; Gregory Joseph,37,0,37,0
1650314782490,CSE 8A,A50,083650,Miranda; Gregory Joseph,0,26,40,40
1650314788514,CSE 11,A01,083080,Cao; Yingjun,0,83,40,40
1650314794540,CSE 12,A01,083652,Staff,0,11,100,100
1650314800564,CSE 15L,A01,083654,Staff,0,1,50,50
1650314800564,CSE 15L,A02,083655,Staff,4,0,50,46
1650314806591,CSE 20,A01,083657,Staff,53,0,80,27
1650314812616,CSE 30,A01,083084,Eldon; John,0,74,40,40
1650314818640,CSE 100,A01,083659,Cao; Yingjun,0,65,50,50
1650314824664,CSE 134B,A01,083661,Powell; Thomas Allan,0,30,65,65
1650314830688,CSE 140,A01,083663,Staff,0,0,75,75
1650314836711,CSE 140L,A01,083088,Eldon; John,0,6,75,75
1650314842735,CSE 175,A01,083665,Kumar; Rakesh,8,0,25,17
1650314848767,CSE 190,A00,092507,Dubnov; Shlomo,14,0,20,6
1650314854790,ECE 45,A01,083139,Staff,0,16,40,40
1650314860814,ECE 65,A50,083695,Staff,0,5,30,30
1650314866843,ECE 109,A01,091882,Touri; Behrouz,42,0,70,28
1650314872867,ECE 180,A00,083140,Abi Samra; Nicholas Camill,23,0,30,7
1650314872867,ECE 180,B00,083141,Abi Samra; Nicholas Camill,6,0,30,24
1650314878894,MATH 10A,A01,083735,Patchell; Gregory David,10,0,30,20
1650314878894,MATH 10A,A02,083736,Patchell; Gregory David,28,0,30,2
1650314878894,MATH 10A,A03,083737,Patchell; Gregory David,26,0,30,4
1650314884923,MATH 10B,A01,083207,Staff,0,6,30,30
1650314884923,MATH 10B,A02,083208,Staff,0,6,30,30
1650314884923,MATH 10B,B01,083739,Staff,17,0,30,13
1650314884923,MATH 10B,B02,083740,Staff,28,0,30,2
1650314890957,MATH 18,A01,083743,Staff,5,0,30,25
1650314890957,MATH 18,A02,083744,Staff,26,0,30,4
1650314890957,MATH 18,A03,083745,Staff,22,0,30,8
1650314890957,MATH 18,A04,083746,Staff,27,0,30,3
1650314890957,MATH 18,B01,083748,Staff,0,11,30,30
1650314890957,MATH 18,B02,083749,Staff,0,10,30,30
1650314890957,MATH 18,B03,083750,Staff,1,9,30,29
1650314890957,MATH 18,B04,083751,Staff,0,10,30,30
1650314896980,MATH 20A,A01,083754,Staff,25,0,40,15
1650314903112,MATH 20B,A01,083756,Staff,0,5,30,30
1650314903112,MATH 20B,A02,083757,Staff,0,8,30,30
1650314909143,MATH 20C,A01,083760,Staff,0,13,30,30
1650314909143,MATH 20C,A02,083761,Staff,0,13,30,30
1650314909143,MATH 20C,B01,083762,Staff,13,0,30,17
1650314909143,MATH 20C,B02,083763,Staff,28,0,30,2
1650314915177,MATH 20D,A01,083765,Staff,0,1,30,30
1650314915177,MATH 20D,A02,083766,Staff,8,0,30,22
1650314915177,MATH 20D,A03,083767,Staff,27,0,30,3
1650314921203,MATH 20E,A01,083771,Staff,6,0,30,24
1650314921203,MATH 20E,A02,083772,Staff,19,0,30,11
1650314921203,MATH 20E,B01,083773,Staff,0,0,30,30
1650314921203,MATH 20E,B02,083774,Staff,12,0,30,18
1650314927243,MATH 103A,A01,083777,Staff,0,12,30,30
1650314927243,MATH 103A,A02,083778,Staff,0,11,30,30
1650314927243,MATH 103A,B01,083779,Staff,0,11,30,30
1650314927243,MATH 103A,B02,083780,Staff,0,11,30,30
1650314933271,MATH 105,A01,085443,Staff,0,17,30,30
1650314939304,MATH 109,A01,083213,Anzaldo; Leesa B,0,5,30,30
1650314939304,MATH 109,A02,083214,Anzaldo; Leesa B,0,6,30,30
1650314939304,MATH 109,B01,083215,Anzaldo; Leesa B,0,4,30,30
1650314939304,MATH 109,B02,083216,Anzaldo; Leesa B,0,4,30,30
1650314945329,MATH 142A,A01,083219,Chow; Bennett,0,14,30,30
1650314945329,MATH 142A,A02,083220,Chow; Bennett,0,12,30,30
1650314945329,MATH 142A,B01,083221,Chow; Bennett,0,12,30,30
1650314945329,MATH 142A,B02,083222,Chow; Bennett,0,12,30,30
1650314951352,MATH 193A,A01,083224,Staff,0,5,30,30
1650314951352,MATH 193A,A02,083225,Staff,0,5,30,30
1650314951352,MATH 193A,A03,083781,Staff,0,2,30,30
1650314951352,MATH 193A,A04,083782,Staff,0,3,30,30
1650314957380,MATH 197,001,091859,McAuley; Julian John,9998,0,9999,1
1650314963444,COGS 9,A01,083615,Staff,0,15,60,60
1650314969470,COGS 11,A01,083617,Boyle; Mary E. T.,22,0,40,18
1650314975497,COGS 13,A01,083071,Staff,0,31,40,40
1650314981524,COGS 14A,A01,092681,Staff,0,18,100,100
1650314987553,COGS 14B,A01,083073,Cheng; Tzu-Han,0,10,50,50
1650314993579,COGS 17,A01,092677,Staff,26,0,75,49
1650314999606,COGS 100,A01,083619,Staff,0,23,60,60
1650315005639,COGS 101A,A01,083621,Davis; Joshua Daniel,0,23,60,60
1650315011674,COGS 101B,A01,091572,Staff,3,0,60,57
1650315017703,COGS 101C,A01,083625,Delgado; Tania,19,0,30,11
1650315023739,COGS 107A,A01,083627,Boyle; Mary E. T.,0,8,60,60
1650315029768,COGS 118A,A01,083075,Staff,5,0,60,55
1650315035797,CSE 3,A50,083646,Miranda; Gregory Joseph,21,0,38,17
1650315035797,CSE 3,A51,083647,Miranda; Gregory Joseph,37,0,37,0
1650315041825,CSE 8A,A50,083650,Miranda; Gregory Joseph,0,26,40,40
1650315047861,CSE 11,A01,083080,Cao; Yingjun,0,83,40,40
1650315053888,CSE 12,A01,083652,Staff,0,12,100,100
1650315059923,CSE 15L,A01,083654,Staff,0,1,50,50
1650315059923,CSE 15L,A02,083655,Staff,4,0,50,46
1650315065948,CSE 20,A01,083657,Staff,53,0,80,27
1650315071973,CSE 30,A01,083084,Eldon; John,0,74,40,40
1650315077997,CSE 100,A01,083659,Cao; Yingjun,0,65,50,50
1650315084020,CSE 134B,A01,083661,Powell; Thomas Allan,0,30,65,65
1650315090047,CSE 140,A01,083663,Staff,0,0,75,75
1650315096069,CSE 140L,A01,083088,Eldon; John,0,6,75,75
1650315102092,CSE 175,A01,083665,Kumar; Rakesh,8,0,25,17
1650315108116,CSE 190,A00,092507,Dubnov; Shlomo,14,0,20,6
1650315114141,ECE 45,A01,083139,Staff,0,16,40,40
1650315120169,ECE 65,A50,083695,Staff,0,5,30,30
1650315126197,ECE 109,A01,091882,Touri; Behrouz,42,0,70,28
1650315132220,ECE 180,A00,083140,Abi Samra; Nicholas Camill,23,0,30,7
1650315132220,ECE 180,B00,083141,Abi Samra; Nicholas Camill,6,0,30,24
1650315138251,MATH 10A,A01,083735,Patchell; Gregory David,10,0,30,20
1650315138251,MATH 10A,A02,083736,Patchell; Gregory David,28,0,30,2
1650315138251,MATH 10A,A03,083737,Patchell; Gregory David,26,0,30,4
1650315144280,MATH 10B,A01,083207,Staff,0,6,30,30
1650315144280,MATH 10B,A02,083208,Staff,0,6,30,30
1650315144280,MATH 10B,B01,083739,Staff,17,0,30,13
1650315144280,MATH 10B,B02,083740,Staff,28,0,30,2
1650315150310,MATH 18,A01,083743,Staff,5,0,30,25
1650315150310,MATH 18,A02,083744,Staff,26,0,30,4
1650315150310,MATH 18,A03,083745,Staff,22,0,30,8
1650315150310,MATH 18,A04,083746,Staff,27,0,30,3
1650315150310,MATH 18,B01,083748,Staff,0,11,30,30
1650315150310,MATH 18,B02,083749,Staff,0,10,30,30
1650315150310,MATH 18,B03,083750,Staff,1,9,30,29
1650315150310,MATH 18,B04,083751,Staff,0,10,30,30
1650315156333,MATH 20A,A01,083754,Staff,25,0,40,15
1650315162367,MATH 20B,A01,083756,Staff,0,5,30,30
1650315162367,MATH 20B,A02,083757,Staff,0,8,30,30
1650315168391,MATH 20C,A01,083760,Staff,0,13,30,30
1650315168391,MATH 20C,A02,083761,Staff,0,13,30,30
1650315168391,MATH 20C,B01,083762,Staff,13,0,30,17
1650315168391,MATH 20C,B02,083763,Staff,28,0,30,2
1650315174420,MATH 20D,A01,083765,Staff,0,1,30,30
1650315174420,MATH 20D,A02,083766,Staff,7,0,30,23
1650315174420,MATH 20D,A03,083767,Staff,27,0,30,3
1650315180445,MATH 20E,A01,083771,Staff,6,0,30,24
1650315180445,MATH 20E,A02,083772,Staff,19,0,30,11
1650315180445,MATH 20E,B01,083773,Staff,0,0,30,30
1650315180445,MATH 20E,B02,083774,Staff,12,0,30,18
1650315186478,MATH 103A,A01,083777,Staff,0,12,30,30
1650315186478,MATH 103A,A02,083778,Staff,0,11,30,30
1650315186478,MATH 103A,B01,083779,Staff,0,11,30,30
1650315186478,MATH 103A,B02,083780,Staff,0,11,30,30
1650315192502,MATH 105,A01,085443,Staff,0,17,30,30
1650315198530,MATH 109,A01,083213,Anzaldo; Leesa B,0,5,30,30
1650315198530,MATH 109,A02,083214,Anzaldo; Leesa B,0,6,30,30
1650315198530,MATH 109,B01,083215,Anzaldo; Leesa B,0,4,30,30
1650315198530,MATH 109,B02,083216,Anzaldo; Leesa B,0,4,30,30
1650315204558,MATH 142A,A01,083219,Chow; Bennett,0,14,30,30
1650315204558,MATH 142A,A02,083220,Chow; Bennett,0,12,30,30
1650315204558,MATH 142A,B01,083221,Chow; Bennett,0,12,30,30
1650315204558,MATH 142A,B02,083222,Chow; Bennett,0,12,30,30
1650315210582,MATH 193A,A01,083224,Staff,0,5,30,30
1650315210582,MATH 193A,A02,083225,Staff,0,5,30,30
1650315210582,MATH 193A,A03,083781,Staff,0,2,30,30
1650315210582,MATH 193A,A04,083782,Staff,0,3,30,30
1650315216614,MATH 197,001,091859,McAuley; Julian John,9998,0,9999,1
1650315222664,COGS 9,A01,083615,Staff,0,15,60,60
1650315228686,COGS 11,A01,083617,Boyle; Mary E. T.,22,0,40,18
1650315234729,COGS 13,A01,083071,Staff,0,31,40,40
1650315240754,COGS 14A,A01,092681,Staff,0,18,100,100
1650315246784,COGS 14B,A01,083073,Cheng; Tzu-Han,0,10,50,50
1650315252807,COGS 17,A01,092677,Staff,26,0,75,49
1650315258831,COGS 100,A01,083619,Staff,0,23,60,60
1650315264873,COGS 101A,A01,083621,Davis; Joshua Daniel,0,23,60,60
1650315270899,COGS 101B,A01,091572,Staff,3,0,60,57
1650315276923,COGS 101C,A01,083625,Delgado; Tania,19,0,30,11
1650315282947,COGS 107A,A01,083627,Boyle; Mary E. T.,0,8,60,60
1650315288985,COGS 118A,A01,083075,Staff,5,0,60,55
1650315295008,CSE 3,A50,083646,Miranda; Gregory Joseph,21,0,38,17
1650315295008,CSE 3,A51,083647,Miranda; Gregory Joseph,37,0,37,0
1650315301036,CSE 8A,A50,083650,Miranda; Gregory Joseph,0,26,40,40
1650315307066,CSE 11,A01,083080,Cao; Yingjun,0,83,40,40
1650315313102,CSE 12,A01,083652,Staff,0,12,100,100
1650315319125,CSE 15L,A01,083654,Staff,0,1,50,50
1650315319125,CSE 15L,A02,083655,Staff,4,0,50,46
1650315325154,CSE 20,A01,083657,Staff,53,0,80,27
1650315331195,CSE 30,A01,083084,Eldon; John,0,74,40,40
1650315337222,CSE 100,A01,083659,Cao; Yingjun,0,65,50,50
1650315343261,CSE 134B,A01,083661,Powell; Thomas Allan,0,30,65,65
1650315349283,CSE 140,A01,083663,Staff,0,0,75,75
1650315355307,CSE 140L,A01,083088,Eldon; John,0,6,75,75
1650315361333,CSE 175,A01,083665,Kumar; Rakesh,8,0,25,17
1650315367356,CSE 190,A00,092507,Dubnov; Shlomo,14,0,20,6
1650315373384,ECE 45,A01,083139,Staff,0,16,40,40
1650315379410,ECE 65,A50,083695,Staff,0,5,30,30
1650315385434,ECE 109,A01,091882,Touri; Behrouz,42,0,70,28
1650315391463,ECE 180,A00,083140,Abi Samra; Nicholas Camill,23,0,30,7
1650315391463,ECE 180,B00,083141,Abi Samra; Nicholas Camill,6,0,30,24
1650315397488,MATH 10A,A01,083735,Patchell; Gregory David,10,0,30,20
1650315397488,MATH 10A,A02,083736,Patchell; Gregory David,28,0,30,2
1650315397488,MATH 10A,A03,083737,Patchell; Gregory David,26,0,30,4
1650315403515,MATH 10B,A01,083207,Staff,0,6,30,30
1650315403515,MATH 10B,A02,083208,Staff,0,6,30,30
1650315403515,MATH 10B,B01,083739,Staff,17,0,30,13
1650315403515,MATH 10B,B02,083740,Staff,28,0,30,2
1650315409552,MATH 18,A01,083743,Staff,5,0,30,25
1650315409552,MATH 18,A02,083744,Staff,26,0,30,4
1650315409552,MATH 18,A03,083745,Staff,22,0,30,8
1650315409552,MATH 18,A04,083746,Staff,27,0,30,3
1650315409552,MATH 18,B01,083748,Staff,0,11,30,30
1650315409552,MATH 18,B02,083749,Staff,0,10,30,30
1650315409552,MATH 18,B03,083750,Staff,1,9,30,29
1650315409552,MATH 18,B04,083751,Staff,0,10,30,30
1650315415578,MATH 20A,A01,083754,Staff,25,0,40,15
1650315421688,MATH 20B,A01,083756,Staff,0,5,30,30
1650315421688,MATH 20B,A02,083757,Staff,0,8,30,30
1650315427714,MATH 20C,A01,083760,Staff,0,13,30,30
1650315427714,MATH 20C,A02,083761,Staff,0,13,30,30
1650315427714,MATH 20C,B01,083762,Staff,13,0,30,17
1650315427714,MATH 20C,B02,083763,Staff,28,0,30,2
1650315433738,MATH 20D,A01,083765,Staff,0,1,30,30
1650315433738,MATH 20D,A02,083766,Staff,7,0,30,23
1650315433738,MATH 20D,A03,083767,Staff,27,0,30,3
1650315439762,MATH 20E,A01,083771,Staff,6,0,30,24
1650315439762,MATH 20E,A02,083772,Staff,19,0,30,11
1650315439762,MATH 20E,B01,083773,Staff,0,0,30,30
1650315439762,MATH 20E,B02,083774,Staff,12,0,30,18
1650315445790,MATH 103A,A01,083777,Staff,0,12,30,30
1650315445790,MATH 103A,A02,083778,Staff,0,11,30,30
1650315445790,MATH 103A,B01,083779,Staff,0,11,30,30
1650315445790,MATH 103A,B02,083780,Staff,0,11,30,30
1650315451818,MATH 105,A01,085443,Staff,0,17,30,30
1650315457851,MATH 109,A01,083213,Anzaldo; Leesa B,0,5,30,30
1650315457851,MATH 109,A02,083214,Anzaldo; Leesa B,0,6,30,30
1650315457851,MATH 109,B01,083215,Anzaldo; Leesa B,0,4,30,30
1650315457851,MATH 109,B02,083216,Anzaldo; Leesa B,0,4,30,30
1650315463874,MATH 142A,A01,083219,Chow; Bennett,0,14,30,30
1650315463874,MATH 142A,A02,083220,Chow; Bennett,0,12,30,30
1650315463874,MATH 142A,B01,083221,Chow; Bennett,0,12,30,30
1650315463874,MATH 142A,B02,083222,Chow; Bennett,0,12,30,30
1650315469901,MATH 193A,A01,083224,Staff,0,5,30,30
1650315469901,MATH 193A,A02,083225,Staff,0,5,30,30
1650315469901,MATH 193A,A03,083781,Staff,0,2,30,30
1650315469901,MATH 193A,A04,083782,Staff,0,3,30,30
1650315475924,MATH 197,001,091859,McAuley; Julian John,9998,0,9999,1
1650315481985,COGS 9,A01,083615,Staff,0,15,60,60
1650315488023,COGS 11,A01,083617,Boyle; Mary E. T.,22,0,40,18
1650315494133,COGS 13,A01,083071,Staff,0,31,40,40
1650315500161,COGS 14A,A01,092681,Staff,0,17,100,100
1650315506195,COGS 14B,A01,083073,Cheng; Tzu-Han,0,10,50,50
1650315512227,COGS 17,A01,092677,Staff,26,0,75,49
1650315518264,COGS 100,A01,083619,Staff,0,23,60,60
1650315524291,COGS 101A,A01,083621,Davis; Joshua Daniel,0,23,60,60
1650315530313,COGS 101B,A01,091572,Staff,3,0,60,57
1650315536348,COGS 101C,A01,083625,Delgado; Tania,19,0,30,11
1650315542377,COGS 107A,A01,083627,Boyle; Mary E. T.,0,8,60,60
1650315548414,COGS 118A,A01,083075,Staff,5,0,60,55
1650315554443,CSE 3,A50,083646,Miranda; Gregory Joseph,21,0,38,17
1650315554443,CSE 3,A51,083647,Miranda; Gregory Joseph,37,0,37,0
1650315560470,CSE 8A,A50,083650,Miranda; Gregory Joseph,0,26,40,40
1650315566507,CSE 11,A01,083080,Cao; Yingjun,0,83,40,40
1650315572535,CSE 12,A01,083652,Staff,0,12,100,100
1650315578559,CSE 15L,A01,083654,Staff,0,1,50,50
1650315578559,CSE 15L,A02,083655,Staff,4,0,50,46
1650315584588,CSE 20,A01,083657,Staff,53,0,80,27
1650315590612,CSE 30,A01,083084,Eldon; John,0,74,40,40
1650315596640,CSE 100,A01,083659,Cao; Yingjun,0,65,50,50
1650315602671,CSE 134B,A01,083661,Powell; Thomas Allan,0,30,65,65
1650315616446,CSE 140,A01,083663,Staff,0,0,75,75
1650315622471,CSE 140L,A01,083088,Eldon; John,0,6,75,75
1650315628493,CSE 175,A01,083665,Kumar; Rakesh,8,0,25,17
1650315634527,CSE 190,A00,092507,Dubnov; Shlomo,14,0,20,6
1650315640550,ECE 45,A01,083139,Staff,0,16,40,40
1650315646575,ECE 65,A50,083695,Staff,0,5,30,30
1650315652599,ECE 109,A01,091882,Touri; Behrouz,42,0,70,28
1650315658623,ECE 180,A00,083140,Abi Samra; Nicholas Camill,23,0,30,7
1650315658623,ECE 180,B00,083141,Abi Samra; Nicholas Camill,6,0,30,24
1650315664653,MATH 10A,A01,083735,Patchell; Gregory David,10,0,30,20
1650315664653,MATH 10A,A02,083736,Patchell; Gregory David,28,0,30,2
1650315664653,MATH 10A,A03,083737,Patchell; Gregory David,26,0,30,4
1650315670681,MATH 10B,A01,083207,Staff,0,6,30,30
1650315670681,MATH 10B,A02,083208,Staff,0,6,30,30
1650315670681,MATH 10B,B01,083739,Staff,17,0,30,13
1650315670681,MATH 10B,B02,083740,Staff,28,0,30,2
1650315676709,MATH 18,A01,083743,Staff,5,0,30,25
1650315676709,MATH 18,A02,083744,Staff,26,0,30,4
1650315676709,MATH 18,A03,083745,Staff,22,0,30,8
1650315676709,MATH 18,A04,083746,Staff,27,0,30,3
1650315676709,MATH 18,B01,083748,Staff,0,11,30,30
1650315676709,MATH 18,B02,083749,Staff,0,10,30,30
1650315676709,MATH 18,B03,083750,Staff,1,9,30,29
1650315676709,MATH 18,B04,083751,Staff,0,10,30,30
1650315682737,MATH 20A,A01,083754,Staff,25,0,40,15
1650315688761,MATH 20B,A01,083756,Staff,0,5,30,30
1650315688761,MATH 20B,A02,083757,Staff,0,8,30,30
1650315694794,MATH 20C,A01,083760,Staff,0,13,30,30
1650315694794,MATH 20C,A02,083761,Staff,0,13,30,30
1650315694794,MATH 20C,B01,083762,Staff,13,0,30,17
1650315694794,MATH 20C,B02,083763,Staff,28,0,30,2
1650315700818,MATH 20D,A01,083765,Staff,0,1,30,30
1650315700818,MATH 20D,A02,083766,Staff,7,0,30,23
1650315700818,MATH 20D,A03,083767,Staff,27,0,30,3
1650315706842,MATH 20E,A01,083771,Staff,6,0,30,24
1650315706842,MATH 20E,A02,083772,Staff,19,0,30,11
1650315706842,MATH 20E,B01,083773,Staff,0,0,30,30
1650315706842,MATH 20E,B02,083774,Staff,12,0,30,18
1650315712868,MATH 103A,A01,083777,Staff,0,12,30,30
1650315712868,MATH 103A,A02,083778,Staff,0,11,30,30
1650315712868,MATH 103A,B01,083779,Staff,0,11,30,30
1650315712868,MATH 103A,B02,083780,Staff,0,11,30,30
1650315718897,MATH 105,A01,085443,Staff,0,17,30,30
1650315724921,MATH 109,A01,083213,Anzaldo; Leesa B,0,5,30,30
1650315724921,MATH 109,A02,083214,Anzaldo; Leesa B,0,6,30,30
1650315724921,MATH 109,B01,083215,Anzaldo; Leesa B,0,4,30,30
1650315724921,MATH 109,B02,083216,Anzaldo; Leesa B,0,4,30,30
1650315730948,MATH 142A,A01,083219,Chow; Bennett,0,14,30,30
1650315730948,MATH 142A,A02,083220,Chow; Bennett,0,12,30,30
1650315730948,MATH 142A,B01,083221,Chow; Bennett,0,12,30,30
1650315730948,MATH 142A,B02,083222,Chow; Bennett,0,12,30,30
1650315736971,MATH 193A,A01,083224,Staff,0,5,30,30
1650315736971,MATH 193A,A02,083225,Staff,0,5,30,30
1650315736971,MATH 193A,A03,083781,Staff,0,2,30,30
1650315736971,MATH 193A,A04,083782,Staff,0,3,30,30
1650315742995,MATH 197,001,091859,McAuley; Julian John,9998,0,9999,1
1650315749057,COGS 9,A01,083615,Staff,0,15,60,60
1650315755080,COGS 11,A01,083617,Boyle; Mary E. T.,22,0,40,18
1650315761104,COGS 13,A01,083071,Staff,0,31,40,40
1650315767132,COGS 14A,A01,092681,Staff,0,17,100,100
1650315773158,COGS 14B,A01,083073,Cheng; Tzu-Han,0,10,50,50
1650315779187,COGS 17,A01,092677,Staff,26,0,75,49
1650315785219,COGS 100,A01,083619,Staff,0,23,60,60
1650315791246,COGS 101A,A01,083621,Davis; Joshua Daniel,0,23,60,60
1650315797271,COGS 101B,A01,091572,Staff,3,0,60,57
1650315803301,COGS 101C,A01,083625,Delgado; Tania,19,0,30,11
1650315809334,COGS 107A,A01,083627,Boyle; Mary E. T.,0,8,60,60
1650315815360,COGS 118A,A01,083075,Staff,5,0,60,55
1650315821384,CSE 3,A50,083646,Miranda; Gregory Joseph,21,0,38,17
1650315821384,CSE 3,A51,083647,Miranda; Gregory Joseph,37,0,37,0
1650315827415,CSE 8A,A50,083650,Miranda; Gregory Joseph,0,26,40,40
1650315833438,CSE 11,A01,083080,Cao; Yingjun,0,83,40,40
1650315839467,CSE 12,A01,083652,Staff,0,12,100,100
1650315845493,CSE 15L,A01,083654,Staff,0,1,50,50
1650315845493,CSE 15L,A02,083655,Staff,4,0,50,46
1650315851517,CSE 20,A01,083657,Staff,53,0,80,27
1650315857541,CSE 30,A01,083084,Eldon; John,0,74,40,40
1650315863568,CSE 100,A01,083659,Cao; Yingjun,0,65,50,50
1650315869595,CSE 134B,A01,083661,Powell; Thomas Allan,0,30,65,65
1650315875620,CSE 140,A01,083663,Staff,0,0,75,75
1650315881648,CSE 140L,A01,083088,Eldon; John,0,6,75,75
1650315887671,CSE 175,A01,083665,Kumar; Rakesh,8,0,25,17
1650315893695,CSE 190,A00,092507,Dubnov; Shlomo,14,0,20,6
1650315899732,ECE 45,A01,083139,Staff,0,16,40,40
1650315905758,ECE 65,A50,083695,Staff,0,5,30,30
1650315911793,ECE 109,A01,091882,Touri; Behrouz,42,0,70,28
1650315917813,ECE 180,A00,083140,Abi Samra; Nicholas Camill,23,0,30,7
1650315917813,ECE 180,B00,083141,Abi Samra; Nicholas Camill,6,0,30,24
1650315923838,MATH 10A,A01,083735,Patchell; Gregory David,10,0,30,20
1650315923838,MATH 10A,A02,083736,Patchell; Gregory David,28,0,30,2
1650315923838,MATH 10A,A03,083737,Patchell; Gregory David,26,0,30,4
1650315929871,MATH 10B,A01,083207,Staff,0,6,30,30
1650315929871,MATH 10B,A02,083208,Staff,0,6,30,30
1650315929871,MATH 10B,B01,083739,Staff,17,0,30,13
1650315929871,MATH 10B,B02,083740,Staff,28,0,30,2
1650315935895,MATH 18,A01,083743,Staff,5,0,30,25
1650315935895,MATH 18,A02,083744,Staff,26,0,30,4
1650315935895,MATH 18,A03,083745,Staff,22,0,30,8
1650315935895,MATH 18,A04,083746,Staff,27,0,30,3
1650315935895,MATH 18,B01,083748,Staff,0,11,30,30
1650315935895,MATH 18,B02,083749,Staff,0,10,30,30
1650315935895,MATH 18,B03,083750,Staff,1,9,30,29
1650315935895,MATH 18,B04,083751,Staff,0,10,30,30
1650315941918,MATH 20A,A01,083754,Staff,25,0,40,15
1650315947944,MATH 20B,A01,083756,Staff,0,5,30,30
1650315947944,MATH 20B,A02,083757,Staff,0,8,30,30
1650315953968,MATH 20C,A01,083760,Staff,0,13,30,30
1650315953968,MATH 20C,A02,083761,Staff,0,13,30,30
1650315953968,MATH 20C,B01,083762,Staff,13,0,30,17
1650315953968,MATH 20C,B02,083763,Staff,28,0,30,2
1650315959996,MATH 20D,A01,083765,Staff,0,1,30,30
1650315959996,MATH 20D,A02,083766,Staff,7,0,30,23
1650315959996,MATH 20D,A03,083767,Staff,27,0,30,3
1650315966026,MATH 20E,A01,083771,Staff,6,0,30,24
1650315966026,MATH 20E,A02,083772,Staff,19,0,30,11
1650315966026,MATH 20E,B01,083773,Staff,0,0,30,30
1650315966026,MATH 20E,B02,083774,Staff,12,0,30,18
1650315972051,MATH 103A,A01,083777,Staff,0,12,30,30
1650315972051,MATH 103A,A02,083778,Staff,0,11,30,30
1650315972051,MATH 103A,B01,083779,Staff,0,11,30,30
1650315972051,MATH 103A,B02,083780,Staff,0,11,30,30
1650315978077,MATH 105,A01,085443,Staff,0,17,30,30
1650315984099,MATH 109,A01,083213,Anzaldo; Leesa B,0,5,30,30
1650315984099,MATH 109,A02,083214,Anzaldo; Leesa B,0,6,30,30
1650315984099,MATH 109,B01,083215,Anzaldo; Leesa B,0,4,30,30
1650315984099,MATH 109,B02,083216,Anzaldo; Leesa B,0,4,30,30
1650315990125,MATH 142A,A01,083219,Chow; Bennett,0,14,30,30
1650315990125,MATH 142A,A02,083220,Chow; Bennett,0,12,30,30
1650315990125,MATH 142A,B01,083221,Chow; Bennett,0,12,30,30
1650315990125,MATH 142A,B02,083222,Chow; Bennett,0,12,30,30
1650315996156,MATH 193A,A01,083224,Staff,0,5,30,30
1650315996156,MATH 193A,A02,083225,Staff,0,5,30,30
1650315996156,MATH 193A,A03,083781,Staff,0,2,30,30
1650315996156,MATH 193A,A04,083782,Staff,0,3,30,30
1650316002178,MATH 197,001,091859,McAuley; Julian John,9998,0,9999,1
1650316008246,COGS 9,A01,083615,Staff,0,15,60,60
1650316014285,COGS 11,A01,083617,Boyle; Mary E. T.,22,0,40,18
1650316020315,COGS 13,A01,083071,Staff,0,31,40,40
1650316026341,COGS 14A,A01,092681,Staff,0,17,100,100
1650316032366,COGS 14B,A01,083073,Cheng; Tzu-Han,0,10,50,50
1650316038392,COGS 17,A01,092677,Staff,26,0,75,49
1650316044417,COGS 100,A01,083619,Staff,0,23,60,60
1650316050439,COGS 101A,A01,083621,Davis; Joshua Daniel,0,23,60,60
1650316056463,COGS 101B,A01,091572,Staff,3,0,60,57
1650316062493,COGS 101C,A01,083625,Delgado; Tania,19,0,30,11
1650316068521,COGS 107A,A01,083627,Boyle; Mary E. T.,0,8,60,60
1650316074552,COGS 118A,A01,083075,Staff,5,0,60,55
1650316080575,CSE 3,A50,083646,Miranda; Gregory Joseph,21,0,38,17
1650316080575,CSE 3,A51,083647,Miranda; Gregory Joseph,37,0,37,0
1650316086601,CSE 8A,A50,083650,Miranda; Gregory Joseph,0,26,40,40
1650316092626,CSE 11,A01,083080,Cao; Yingjun,0,83,40,40
1650316098737,CSE 12,A01,083652,Staff,0,12,100,100
1650316104763,CSE 15L,A01,083654,Staff,0,1,50,50
1650316104763,CSE 15L,A02,083655,Staff,4,0,50,46
1650316110789,CSE 20,A01,083657,Staff,53,0,80,27
1650316116816,CSE 30,A01,083084,Eldon; John,0,74,40,40
1650316122839,CSE 100,A01,083659,Cao; Yingjun,0,65,50,50
1650316128866,CSE 134B,A01,083661,Powell; Thomas Allan,0,30,65,65
1650316134893,CSE 140,A01,083663,Staff,0,0,75,75
1650316140916,CSE 140L,A01,083088,Eldon; John,0,6,75,75
1650316146941,CSE 175,A01,083665,Kumar; Rakesh,8,0,25,17
1650316152967,CSE 190,A00,092507,Dubnov; Shlomo,14,0,20,6
1650316158994,ECE 45,A01,083139,Staff,0,16,40,40
1650316165017,ECE 65,A50,083695,Staff,0,5,30,30
1650316171041,ECE 109,A01,091882,Touri; Behrouz,42,0,70,28
1650316177066,ECE 180,A00,083140,Abi Samra; Nicholas Camill,23,0,30,7
1650316177066,ECE 180,B00,083141,Abi Samra; Nicholas Camill,6,0,30,24
1650316183090,MATH 10A,A01,083735,Patchell; Gregory David,10,0,30,20
1650316183090,MATH 10A,A02,083736,Patchell; Gregory David,28,0,30,2
1650316183090,MATH 10A,A03,083737,Patchell; Gregory David,26,0,30,4
1650316189119,MATH 10B,A01,083207,Staff,0,6,30,30
1650316189119,MATH 10B,A02,083208,Staff,0,6,30,30
1650316189119,MATH 10B,B01,083739,Staff,17,0,30,13
1650316189119,MATH 10B,B02,083740,Staff,28,0,30,2
1650316195161,MATH 18,A01,083743,Staff,5,0,30,25
1650316195161,MATH 18,A02,083744,Staff,26,0,30,4
1650316195161,MATH 18,A03,083745,Staff,22,0,30,8
1650316195161,MATH 18,A04,083746,Staff,27,0,30,3
1650316195161,MATH 18,B01,083748,Staff,0,11,30,30
1650316195161,MATH 18,B02,083749,Staff,0,10,30,30
1650316195161,MATH 18,B03,083750,Staff,1,9,30,29
1650316195161,MATH 18,B04,083751,Staff,0,10,30,30
1650316201199,MATH 20A,A01,083754,Staff,25,0,40,15
1650316207231,MATH 20B,A01,083756,Staff,0,5,30,30
1650316207231,MATH 20B,A02,083757,Staff,0,8,30,30
1650316213254,MATH 20C,A01,083760,Staff,0,13,30,30
1650316213254,MATH 20C,A02,083761,Staff,0,13,30,30
1650316213254,MATH 20C,B01,083762,Staff,13,0,30,17
1650316213254,MATH 20C,B02,083763,Staff,28,0,30,2
1650316219279,MATH 20D,A01,083765,Staff,0,1,30,30
1650316219279,MATH 20D,A02,083766,Staff,7,0,30,23
1650316219279,MATH 20D,A03,083767,Staff,27,0,30,3
1650316225304,MATH 20E,A01,083771,Staff,6,0,30,24
1650316225304,MATH 20E,A02,083772,Staff,19,0,30,11
1650316225304,MATH 20E,B01,083773,Staff,0,0,30,30
1650316225304,MATH 20E,B02,083774,Staff,12,0,30,18
1650316231332,MATH 103A,A01,083777,Staff,0,12,30,30
1650316231332,MATH 103A,A02,083778,Staff,0,11,30,30
1650316231332,MATH 103A,B01,083779,Staff,0,11,30,30
1650316231332,MATH 103A,B02,083780,Staff,0,11,30,30
1650316237363,MATH 105,A01,085443,Staff,0,17,30,30
1650316243387,MATH 109,A01,083213,Anzaldo; Leesa B,0,5,30,30
1650316243387,MATH 109,A02,083214,Anzaldo; Leesa B,0,6,30,30
1650316243387,MATH 109,B01,083215,Anzaldo; Leesa B,0,4,30,30
1650316243387,MATH 109,B02,083216,Anzaldo; Leesa B,0,4,30,30
1650316249421,MATH 142A,A01,083219,Chow; Bennett,0,14,30,30
1650316249421,MATH 142A,A02,083220,Chow; Bennett,0,12,30,30
1650316249421,MATH 142A,B01,083221,Chow; Bennett,0,12,30,30
1650316249421,MATH 142A,B02,083222,Chow; Bennett,0,12,30,30
1650316255449,MATH 193A,A01,083224,Staff,0,5,30,30
1650316255449,MATH 193A,A02,083225,Staff,0,5,30,30
1650316255449,MATH 193A,A03,083781,Staff,0,2,30,30
1650316255449,MATH 193A,A04,083782,Staff,0,3,30,30
1650316261480,MATH 197,001,091859,McAuley; Julian John,9998,0,9999,1
1650316267547,COGS 9,A01,083615,Staff,0,15,60,60
1650316273569,COGS 11,A01,083617,Boyle; Mary E. T.,22,0,40,18
1650316279593,COGS 13,A01,083071,Staff,0,31,40,40
1650316285622,COGS 14A,A01,092681,Staff,0,17,100,100
1650316291646,COGS 14B,A01,083073,Cheng; Tzu-Han,0,10,50,50
1650316297674,COGS 17,A01,092677,Staff,26,0,75,49
1650316303697,COGS 100,A01,083619,Staff,0,23,60,60
1650316309722,COGS 101A,A01,083621,Davis; Joshua Daniel,0,23,60,60
1650316315752,COGS 101B,A01,091572,Staff,3,0,60,57
1650316321779,COGS 101C,A01,083625,Delgado; Tania,19,0,30,11
1650316327814,COGS 107A,A01,083627,Boyle; Mary E. T.,0,8,60,60
1650316333844,COGS 118A,A01,083075,Staff,5,0,60,55
1650316339871,CSE 3,A50,083646,Miranda; Gregory Joseph,21,0,38,17
1650316339871,CSE 3,A51,083647,Miranda; Gregory Joseph,37,0,37,0
1650316345893,CSE 8A,A50,083650,Miranda; Gregory Joseph,0,26,40,40
1650316351917,CSE 11,A01,083080,Cao; Yingjun,0,83,40,40
1650316357941,CSE 12,A01,083652,Staff,0,12,100,100
1650316363968,CSE 15L,A01,083654,Staff,0,1,50,50
1650316363968,CSE 15L,A02,083655,Staff,4,0,50,46
1650316369995,CSE 20,A01,083657,Staff,53,0,80,27
1650316376018,CSE 30,A01,083084,Eldon; John,0,74,40,40
1650316382048,CSE 100,A01,083659,Cao; Yingjun,0,65,50,50
1650316388078,CSE 134B,A01,083661,Powell; Thomas Allan,0,30,65,65
1650316394101,CSE 140,A01,083663,Staff,0,0,75,75
1650316400129,CSE 140L,A01,083088,Eldon; John,0,6,75,75
1650316406159,CSE 175,A01,083665,Kumar; Rakesh,8,0,25,17
1650316412182,CSE 190,A00,092507,Dubnov; Shlomo,14,0,20,6
1650316418206,ECE 45,A01,083139,Staff,0,16,40,40
1650316424235,ECE 65,A50,083695,Staff,0,5,30,30
1650316430272,ECE 109,A01,091882,Touri; Behrouz,42,0,70,28
1650316436300,ECE 180,A00,083140,Abi Samra; Nicholas Camill,23,0,30,7
1650316436300,ECE 180,B00,083141,Abi Samra; Nicholas Camill,6,0,30,24
1650316442328,MATH 10A,A01,083735,Patchell; Gregory David,10,0,30,20
1650316442328,MATH 10A,A02,083736,Patchell; Gregory David,28,0,30,2
1650316442328,MATH 10A,A03,083737,Patchell; Gregory David,26,0,30,4
1650316448360,MATH 10B,A01,083207,Staff,0,6,30,30
1650316448360,MATH 10B,A02,083208,Staff,0,6,30,30
1650316448360,MATH 10B,B01,083739,Staff,17,0,30,13
1650316448360,MATH 10B,B02,083740,Staff,28,0,30,2
1650316454398,MATH 18,A01,083743,Staff,5,0,30,25
1650316454398,MATH 18,A02,083744,Staff,26,0,30,4
1650316454398,MATH 18,A03,083745,Staff,22,0,30,8
1650316454398,MATH 18,A04,083746,Staff,27,0,30,3
1650316454398,MATH 18,B01,083748,Staff,0,11,30,30
1650316454398,MATH 18,B02,083749,Staff,0,10,30,30
1650316454398,MATH 18,B03,083750,Staff,1,9,30,29
1650316454398,MATH 18,B04,083751,Staff,0,10,30,30
1650316460424,MATH 20A,A01,083754,Staff,25,0,40,15
1650316466458,MATH 20B,A01,083756,Staff,0,5,30,30
1650316466458,MATH 20B,A02,083757,Staff,0,8,30,30
1650316472497,MATH 20C,A01,083760,Staff,0,13,30,30
1650316472497,MATH 20C,A02,083761,Staff,0,13,30,30
1650316472497,MATH 20C,B01,083762,Staff,13,0,30,17
1650316472497,MATH 20C,B02,083763,Staff,28,0,30,2
1650316478521,MATH 20D,A01,083765,Staff,0,1,30,30
1650316478521,MATH 20D,A02,083766,Staff,7,0,30,23
1650316478521,MATH 20D,A03,083767,Staff,27,0,30,3
1650316484550,MATH 20E,A01,083771,Staff,6,0,30,24
1650316484550,MATH 20E,A02,083772,Staff,19,0,30,11
1650316484550,MATH 20E,B01,083773,Staff,0,0,30,30
1650316484550,MATH 20E,B02,083774,Staff,12,0,30,18
1650316490583,MATH 103A,A01,083777,Staff,0,12,30,30
1650316490583,MATH 103A,A02,083778,Staff,0,11,30,30
1650316490583,MATH 103A,B01,083779,Staff,0,11,30,30
1650316490583,MATH 103A,B02,083780,Staff,0,11,30,30
1650316496622,MATH 105,A01,085443,Staff,0,17,30,30
1650316502645,MATH 109,A01,083213,Anzaldo; Leesa B,0,5,30,30
1650316502645,MATH 109,A02,083214,Anzaldo; Leesa B,0,6,30,30
1650316502645,MATH 109,B01,083215,Anzaldo; Leesa B,0,4,30,30
1650316502645,MATH 109,B02,083216,Anzaldo; Leesa B,0,4,30,30
1650316508669,MATH 142A,A01,083219,Chow; Bennett,0,14,30,30
1650316508669,MATH 142A,A02,083220,Chow; Bennett,0,12,30,30
1650316508669,MATH 142A,B01,083221,Chow; Bennett,0,12,30,30
1650316508669,MATH 142A,B02,083222,Chow; Bennett,0,12,30,30
1650316514697,MATH 193A,A01,083224,Staff,0,5,30,30
1650316514697,MATH 193A,A02,083225,Staff,0,5,30,30
1650316514697,MATH 193A,A03,083781,Staff,0,2,30,30
1650316514697,MATH 193A,A04,083782,Staff,0,3,30,30
1650316520725,MATH 197,001,091859,McAuley; Julian John,9998,0,9999,1
1650316526785,COGS 9,A01,083615,Staff,0,15,60,60
1650316532818,COGS 11,A01,083617,Boyle; Mary E. T.,22,0,40,18
1650316538849,COGS 13,A01,083071,Staff,0,31,40,40
1650316544876,COGS 14A,A01,092681,Staff,0,17,100,100
1650316550904,COGS 14B,A01,083073,Cheng; Tzu-Han,0,10,50,50
1650316556936,COGS 17,A01,092677,Staff,26,0,75,49
1650316562962,COGS 100,A01,083619,Staff,0,23,60,60
1650316569001,COGS 101A,A01,083621,Davis; Joshua Daniel,0,23,60,60
1650316575028,COGS 101B,A01,091572,Staff,3,0,60,57
1650316581052,COGS 101C,A01,083625,Delgado; Tania,19,0,30,11
1650316587074,COGS 107A,A01,083627,Boyle; Mary E. T.,0,8,60,60
1650316593105,COGS 118A,A01,083075,Staff,5,0,60,55
1650316599134,CSE 3,A50,083646,Miranda; Gregory Joseph,21,0,38,17
1650316599134,CSE 3,A51,083647,Miranda; Gregory Joseph,37,0,37,0
1650316605160,CSE 8A,A50,083650,Miranda; Gregory Joseph,0,26,40,40
1650316611194,CSE 11,A01,083080,Cao; Yingjun,0,83,40,40
1650316617219,CSE 12,A01,083652,Staff,0,12,100,100
1650316623251,CSE 15L,A01,083654,Staff,0,1,50,50
1650316623251,CSE 15L,A02,083655,Staff,4,0,50,46
1650316629278,CSE 20,A01,083657,Staff,53,0,80,27
1650316635300,CSE 30,A01,083084,Eldon; John,0,74,40,40
1650316641329,CSE 100,A01,083659,Cao; Yingjun,0,65,50,50
1650316647365,CSE 134B,A01,083661,Powell; Thomas Allan,0,30,65,65
1650316653397,CSE 140,A01,083663,Staff,0,0,75,75
1650316659427,CSE 140L,A01,083088,Eldon; John,0,6,75,75
1650316665465,CSE 175,A01,083665,Kumar; Rakesh,8,0,25,17
1650316671488,CSE 190,A00,092507,Dubnov; Shlomo,14,0,20,6
1650316677521,ECE 45,A01,083139,Staff,0,16,40,40
1650316683546,ECE 65,A50,083695,Staff,0,5,30,30
1650316689575,ECE 109,A01,091882,Touri; Behrouz,42,0,70,28
1650316695678,ECE 180,A00,083140,Abi Samra; Nicholas Camill,23,0,30,7
1650316695678,ECE 180,B00,083141,Abi Samra; Nicholas Camill,6,0,30,24
1650316701706,MATH 10A,A01,083735,Patchell; Gregory David,10,0,30,20
1650316701706,MATH 10A,A02,083736,Patchell; Gregory David,28,0,30,2
1650316701706,MATH 10A,A03,083737,Patchell; Gregory David,26,0,30,4
1650316707732,MATH 10B,A01,083207,Staff,0,6,30,30
1650316707732,MATH 10B,A02,083208,Staff,0,6,30,30
1650316707732,MATH 10B,B01,083739,Staff,17,0,30,13
1650316707732,MATH 10B,B02,083740,Staff,28,0,30,2
1650316713757,MATH 18,A01,083743,Staff,5,0,30,25
1650316713757,MATH 18,A02,083744,Staff,26,0,30,4
1650316713757,MATH 18,A03,083745,Staff,22,0,30,8
1650316713757,MATH 18,A04,083746,Staff,27,0,30,3
1650316713757,MATH 18,B01,083748,Staff,0,11,30,30
1650316713757,MATH 18,B02,083749,Staff,0,10,30,30
1650316713757,MATH 18,B03,083750,Staff,1,9,30,29
1650316713757,MATH 18,B04,083751,Staff,0,10,30,30
1650316719783,MATH 20A,A01,083754,Staff,25,0,40,15
1650316725817,MATH 20B,A01,083756,Staff,0,5,30,30
1650316725817,MATH 20B,A02,083757,Staff,0,8,30,30
1650316731842,MATH 20C,A01,083760,Staff,0,13,30,30
1650316731842,MATH 20C,A02,083761,Staff,0,13,30,30
1650316731842,MATH 20C,B01,083762,Staff,13,0,30,17
1650316731842,MATH 20C,B02,083763,Staff,28,0,30,2
1650316737866,MATH 20D,A01,083765,Staff,0,1,30,30
1650316737866,MATH 20D,A02,083766,Staff,7,0,30,23
1650316737866,MATH 20D,A03,083767,Staff,27,0,30,3
1650316743894,MATH 20E,A01,083771,Staff,6,0,30,24
1650316743894,MATH 20E,A02,083772,Staff,19,0,30,11
1650316743894,MATH 20E,B01,083773,Staff,0,0,30,30
1650316743894,MATH 20E,B02,083774,Staff,12,0,30,18
1650316749921,MATH 103A,A01,083777,Staff,0,12,30,30
1650316749921,MATH 103A,A02,083778,Staff,0,11,30,30
1650316749921,MATH 103A,B01,083779,Staff,0,11,30,30
1650316749921,MATH 103A,B02,083780,Staff,0,11,30,30
1650316755953,MATH 105,A01,085443,Staff,0,18,30,30
1650316761976,MATH 109,A01,083213,Anzaldo; Leesa B,0,5,30,30
1650316761976,MATH 109,A02,083214,Anzaldo; Leesa B,0,6,30,30
1650316761976,MATH 109,B01,083215,Anzaldo; Leesa B,0,4,30,30
1650316761976,MATH 109,B02,083216,Anzaldo; Leesa B,0,4,30,30
1650316768000,MATH 142A,A01,083219,Chow; Bennett,0,14,30,30
1650316768000,MATH 142A,A02,083220,Chow; Bennett,0,12,30,30
1650316768000,MATH 142A,B01,083221,Chow; Bennett,0,12,30,30
1650316768000,MATH 142A,B02,083222,Chow; Bennett,0,12,30,30
1650316774045,MATH 193A,A01,083224,Staff,0,5,30,30
1650316774045,MATH 193A,A02,083225,Staff,0,5,30,30
1650316774045,MATH 193A,A03,083781,Staff,0,2,30,30
1650316774045,MATH 193A,A04,083782,Staff,0,3,30,30
1650316780070,MATH 197,001,091859,McAuley; Julian John,9998,0,9999,1
1650316786129,COGS 9,A01,083615,Staff,0,15,60,60
1650316792157,COGS 11,A01,083617,Boyle; Mary E. T.,22,0,40,18
1650316798181,COGS 13,A01,083071,Staff,0,31,40,40
1650316804207,COGS 14A,A01,092681,Staff,0,17,100,100
1650316810233,COGS 14B,A01,083073,Cheng; Tzu-Han,0,10,50,50
1650316816259,COGS 17,A01,092677,Staff,26,0,75,49
1650316822283,COGS 100,A01,083619,Staff,0,23,60,60
1650316828320,COGS 101A,A01,083621,Davis; Joshua Daniel,0,23,60,60
1650316834346,COGS 101B,A01,091572,Staff,3,0,60,57
1650316840373,COGS 101C,A01,083625,Delgado; Tania,19,0,30,11
1650316846400,COGS 107A,A01,083627,Boyle; Mary E. T.,0,8,60,60
1650316852426,COGS 118A,A01,083075,Staff,5,0,60,55
1650316858449,CSE 3,A50,083646,Miranda; Gregory Joseph,21,0,38,17
1650316858449,CSE 3,A51,083647,Miranda; Gregory Joseph,37,0,37,0
1650316864477,CSE 8A,A50,083650,Miranda; Gregory Joseph,0,26,40,40
1650316870503,CSE 11,A01,083080,Cao; Yingjun,0,83,40,40
1650316876538,CSE 12,A01,083652,Staff,0,12,100,100
1650316882571,CSE 15L,A01,083654,Staff,0,1,50,50
1650316882571,CSE 15L,A02,083655,Staff,4,0,50,46
1650316888594,CSE 20,A01,083657,Staff,53,0,80,27
1650316894619,CSE 30,A01,083084,Eldon; John,0,74,40,40
1650316900642,CSE 100,A01,083659,Cao; Yingjun,0,65,50,50
1650316906678,CSE 134B,A01,083661,Powell; Thomas Allan,0,30,65,65
1650316912714,CSE 140,A01,083663,Staff,0,0,75,75
1650316918738,CSE 140L,A01,083088,Eldon; John,0,6,75,75
1650316924762,CSE 175,A01,083665,Kumar; Rakesh,8,0,25,17
1650316930784,CSE 190,A00,092507,Dubnov; Shlomo,14,0,20,6
1650316936808,ECE 45,A01,083139,Staff,0,16,40,40
1650316942833,ECE 65,A50,083695,Staff,0,5,30,30
1650316948858,ECE 109,A01,091882,Touri; Behrouz,42,0,70,28
1650316954887,ECE 180,A00,083140,Abi Samra; Nicholas Camill,23,0,30,7
1650316954887,ECE 180,B00,083141,Abi Samra; Nicholas Camill,6,0,30,24
1650316960915,MATH 10A,A01,083735,Patchell; Gregory David,10,0,30,20
1650316960915,MATH 10A,A02,083736,Patchell; Gregory David,28,0,30,2
1650316960915,MATH 10A,A03,083737,Patchell; Gregory David,26,0,30,4
1650316966941,MATH 10B,A01,083207,Staff,0,6,30,30
1650316966941,MATH 10B,A02,083208,Staff,0,6,30,30
1650316966941,MATH 10B,B01,083739,Staff,17,0,30,13
1650316966941,MATH 10B,B02,083740,Staff,28,0,30,2
1650316972972,MATH 18,A01,083743,Staff,5,0,30,25
1650316972972,MATH 18,A02,083744,Staff,26,0,30,4
1650316972972,MATH 18,A03,083745,Staff,22,0,30,8
1650316972972,MATH 18,A04,083746,Staff,27,0,30,3
1650316972972,MATH 18,B01,083748,Staff,0,11,30,30
1650316972972,MATH 18,B02,083749,Staff,0,10,30,30
1650316972972,MATH 18,B03,083750,Staff,1,9,30,29
1650316972972,MATH 18,B04,083751,Staff,0,10,30,30
1650316978997,MATH 20A,A01,083754,Staff,25,0,40,15
1650316985020,MATH 20B,A01,083756,Staff,0,5,30,30
1650316985020,MATH 20B,A02,083757,Staff,0,8,30,30
1650316991057,MATH 20C,A01,083760,Staff,0,14,30,30
1650316991057,MATH 20C,A02,083761,Staff,0,13,30,30
1650316991057,MATH 20C,B01,083762,Staff,13,0,30,17
1650316991057,MATH 20C,B02,083763,Staff,28,0,30,2
1650316997082,MATH 20D,A01,083765,Staff,0,1,30,30
1650316997082,MATH 20D,A02,083766,Staff,7,0,30,23
1650316997082,MATH 20D,A03,083767,Staff,27,0,30,3
1650317003118,MATH 20E,A01,083771,Staff,6,0,30,24
1650317003118,MATH 20E,A02,083772,Staff,19,0,30,11
1650317003118,MATH 20E,B01,083773,Staff,0,0,30,30
1650317003118,MATH 20E,B02,083774,Staff,12,0,30,18
1650317009157,MATH 103A,A01,083777,Staff,0,12,30,30
1650317009157,MATH 103A,A02,083778,Staff,0,12,30,30
1650317009157,MATH 103A,B01,083779,Staff,0,11,30,30
1650317009157,MATH 103A,B02,083780,Staff,0,11,30,30
1650317015188,MATH 105,A01,085443,Staff,0,19,30,30
1650317021215,MATH 109,A01,083213,Anzaldo; Leesa B,0,5,30,30
1650317021215,MATH 109,A02,083214,Anzaldo; Leesa B,0,6,30,30
1650317021215,MATH 109,B01,083215,Anzaldo; Leesa B,0,4,30,30
1650317021215,MATH 109,B02,083216,Anzaldo; Leesa B,0,4,30,30
1650317027249,MATH 142A,A01,083219,Chow; Bennett,0,14,30,30
1650317027249,MATH 142A,A02,083220,Chow; Bennett,0,12,30,30
1650317027249,MATH 142A,B01,083221,Chow; Bennett,0,12,30,30
1650317027249,MATH 142A,B02,083222,Chow; Bennett,0,12,30,30
1650317033273,MATH 193A,A01,083224,Staff,0,5,30,30
1650317033273,MATH 193A,A02,083225,Staff,0,5,30,30
1650317033273,MATH 193A,A03,083781,Staff,0,2,30,30
1650317033273,MATH 193A,A04,083782,Staff,0,3,30,30
1650317039296,MATH 197,001,091859,McAuley; Julian John,9998,0,9999,1
1650317045375,COGS 9,A01,083615,Staff,0,15,60,60
1650317051400,COGS 11,A01,083617,Boyle; Mary E. T.,22,0,40,18
1650317057423,COGS 13,A01,083071,Staff,0,31,40,40
1650317063461,COGS 14A,A01,092681,Staff,0,17,100,100
1650317069495,COGS 14B,A01,083073,Cheng; Tzu-Han,0,10,50,50
1650317075534,COGS 17,A01,092677,Staff,26,0,75,49
1650317081567,COGS 100,A01,083619,Staff,0,23,60,60
1650317087591,COGS 101A,A01,083621,Davis; Joshua Daniel,0,22,60,60
1650317093614,COGS 101B,A01,091572,Staff,3,0,60,57
1650317099641,COGS 101C,A01,083625,Delgado; Tania,19,0,30,11
1650317105665,COGS 107A,A01,083627,Boyle; Mary E. T.,0,8,60,60
1650317111695,COGS 118A,A01,083075,Staff,5,0,60,55
1650317117720,CSE 3,A50,083646,Miranda; Gregory Joseph,21,0,38,17
1650317117720,CSE 3,A51,083647,Miranda; Gregory Joseph,37,0,37,0
1650317123745,CSE 8A,A50,083650,Miranda; Gregory Joseph,0,26,40,40
1650317129768,CSE 11,A01,083080,Cao; Yingjun,0,83,40,40
1650317135801,CSE 12,A01,083652,Staff,0,11,100,100
1650317141827,CSE 15L,A01,083654,Staff,0,1,50,50
1650317141827,CSE 15L,A02,083655,Staff,4,0,50,46
1650317147851,CSE 20,A01,083657,Staff,53,0,80,27
1650317153878,CSE 30,A01,083084,Eldon; John,0,74,40,40
1650317159905,CSE 100,A01,083659,Cao; Yingjun,0,65,50,50
1650317165936,CSE 134B,A01,083661,Powell; Thomas Allan,0,30,65,65
1650317171967,CSE 140,A01,083663,Staff,0,0,75,75
1650317177995,CSE 140L,A01,083088,Eldon; John,0,6,75,75
1650317184022,CSE 175,A01,083665,Kumar; Rakesh,8,0,25,17
1650317190051,CSE 190,A00,092507,Dubnov; Shlomo,14,0,20,6
1650317196082,ECE 45,A01,083139,Staff,0,16,40,40
1650317202115,ECE 65,A50,083695,Staff,0,5,30,30
1650317208149,ECE 109,A01,091882,Touri; Behrouz,42,0,70,28
1650317214176,ECE 180,A00,083140,Abi Samra; Nicholas Camill,23,0,30,7
1650317214176,ECE 180,B00,083141,Abi Samra; Nicholas Camill,6,0,30,24
1650317220204,MATH 10A,A01,083735,Patchell; Gregory David,10,0,30,20
1650317220204,MATH 10A,A02,083736,Patchell; Gregory David,28,0,30,2
1650317220204,MATH 10A,A03,083737,Patchell; Gregory David,26,0,30,4
1650317226237,MATH 10B,A01,083207,Staff,0,6,30,30
1650317226237,MATH 10B,A02,083208,Staff,0,6,30,30
1650317226237,MATH 10B,B01,083739,Staff,17,0,30,13
1650317226237,MATH 10B,B02,083740,Staff,28,0,30,2
1650317232264,MATH 18,A01,083743,Staff,5,0,30,25
1650317232264,MATH 18,A02,083744,Staff,26,0,30,4
1650317232264,MATH 18,A03,083745,Staff,22,0,30,8
1650317232264,MATH 18,A04,083746,Staff,27,0,30,3
1650317232264,MATH 18,B01,083748,Staff,0,11,30,30
1650317232264,MATH 18,B02,083749,Staff,0,10,30,30
1650317232264,MATH 18,B03,083750,Staff,1,9,30,29
1650317232264,MATH 18,B04,083751,Staff,0,10,30,30
1650317238301,MATH 20A,A01,083754,Staff,25,0,40,15
1650317244327,MATH 20B,A01,083756,Staff,0,5,30,30
1650317244327,MATH 20B,A02,083757,Staff,0,8,30,30
1650317250362,MATH 20C,A01,083760,Staff,0,14,30,30
1650317250362,MATH 20C,A02,083761,Staff,0,13,30,30
1650317250362,MATH 20C,B01,083762,Staff,13,0,30,17
1650317250362,MATH 20C,B02,083763,Staff,28,0,30,2
1650317256408,MATH 20D,A01,083765,Staff,0,1,30,30
1650317256408,MATH 20D,A02,083766,Staff,7,0,30,23
1650317256408,MATH 20D,A03,083767,Staff,27,0,30,3
1650317262433,MATH 20E,A01,083771,Staff,6,0,30,24
1650317262433,MATH 20E,A02,083772,Staff,19,0,30,11
1650317262433,MATH 20E,B01,083773,Staff,0,0,30,30
1650317262433,MATH 20E,B02,083774,Staff,12,0,30,18
1650317268460,MATH 103A,A01,083777,Staff,0,12,30,30
1650317268460,MATH 103A,A02,083778,Staff,0,12,30,30
1650317268460,MATH 103A,B01,083779,Staff,0,11,30,30
1650317268460,MATH 103A,B02,083780,Staff,0,11,30,30
1650317274493,MATH 105,A01,085443,Staff,0,19,30,30
1650317280523,MATH 109,A01,083213,Anzaldo; Leesa B,0,5,30,30
1650317280523,MATH 109,A02,083214,Anzaldo; Leesa B,0,6,30,30
1650317280523,MATH 109,B01,083215,Anzaldo; Leesa B,0,4,30,30
1650317280523,MATH 109,B02,083216,Anzaldo; Leesa B,0,4,30,30
1650317286557,MATH 142A,A01,083219,Chow; Bennett,0,14,30,30
1650317286557,MATH 142A,A02,083220,Chow; Bennett,0,12,30,30
1650317286557,MATH 142A,B01,083221,Chow; Bennett,0,12,30,30
1650317286557,MATH 142A,B02,083222,Chow; Bennett,0,12,30,30
1650317292672,MATH 193A,A01,083224,Staff,0,5,30,30
1650317292672,MATH 193A,A02,083225,Staff,0,5,30,30
1650317292672,MATH 193A,A03,083781,Staff,0,2,30,30
1650317292672,MATH 193A,A04,083782,Staff,0,3,30,30
1650317298695,MATH 197,001,091859,McAuley; Julian John,9998,0,9999,1
1650317304751,COGS 9,A01,083615,Staff,0,15,60,60
1650317310773,COGS 11,A01,083617,Boyle; Mary E. T.,22,0,40,18
1650317316798,COGS 13,A01,083071,Staff,0,31,40,40
1650317322821,COGS 14A,A01,092681,Staff,0,17,100,100
1650317328846,COGS 14B,A01,083073,Cheng; Tzu-Han,0,10,50,50
1650317334880,COGS 17,A01,092677,Staff,25,0,75,50
1650317340905,COGS 100,A01,083619,Staff,0,23,60,60
1650317346930,COGS 101A,A01,083621,Davis; Joshua Daniel,0,22,60,60
1650317352953,COGS 101B,A01,091572,Staff,3,0,60,57
1650317358988,COGS 101C,A01,083625,Delgado; Tania,19,0,30,11
1650317365012,COGS 107A,A01,083627,Boyle; Mary E. T.,0,8,60,60
1650317371042,COGS 118A,A01,083075,Staff,5,0,60,55
1650317377075,CSE 3,A50,083646,Miranda; Gregory Joseph,21,0,38,17
1650317377075,CSE 3,A51,083647,Miranda; Gregory Joseph,37,0,37,0
1650317383104,CSE 8A,A50,083650,Miranda; Gregory Joseph,0,26,40,40
1650317389131,CSE 11,A01,083080,Cao; Yingjun,0,83,40,40
1650317395164,CSE 12,A01,083652,Staff,0,11,100,100
1650317401190,CSE 15L,A01,083654,Staff,0,1,50,50
1650317401190,CSE 15L,A02,083655,Staff,4,0,50,46
1650317407230,CSE 20,A01,083657,Staff,53,0,80,27
1650317413263,CSE 30,A01,083084,Eldon; John,0,74,40,40
1650317419286,CSE 100,A01,083659,Cao; Yingjun,0,65,50,50
1650317425312,CSE 134B,A01,083661,Powell; Thomas Allan,0,30,65,65
1650317431335,CSE 140,A01,083663,Staff,0,0,75,75
1650317437362,CSE 140L,A01,083088,Eldon; John,0,6,75,75
1650317443385,CSE 175,A01,083665,Kumar; Rakesh,8,0,25,17
1650317449408,CSE 190,A00,092507,Dubnov; Shlomo,14,0,20,6
1650317455441,ECE 45,A01,083139,Staff,0,16,40,40
1650317461469,ECE 65,A50,083695,Staff,0,5,30,30
1650317467495,ECE 109,A01,091882,Touri; Behrouz,42,0,70,28
1650317473519,ECE 180,A00,083140,Abi Samra; Nicholas Camill,23,0,30,7
1650317473519,ECE 180,B00,083141,Abi Samra; Nicholas Camill,5,0,30,25
1650317479543,MATH 10A,A01,083735,Patchell; Gregory David,10,0,30,20
1650317479543,MATH 10A,A02,083736,Patchell; Gregory David,28,0,30,2
1650317479543,MATH 10A,A03,083737,Patchell; Gregory David,26,0,30,4
1650317485574,MATH 10B,A01,083207,Staff,0,6,30,30
1650317485574,MATH 10B,A02,083208,Staff,0,6,30,30
1650317485574,MATH 10B,B01,083739,Staff,17,0,30,13
1650317485574,MATH 10B,B02,083740,Staff,28,0,30,2
1650317491599,MATH 18,A01,083743,Staff,5,0,30,25
1650317491599,MATH 18,A02,083744,Staff,26,0,30,4
1650317491599,MATH 18,A03,083745,Staff,22,0,30,8
1650317491599,MATH 18,A04,083746,Staff,27,0,30,3
1650317491599,MATH 18,B01,083748,Staff,0,11,30,30
1650317491599,MATH 18,B02,083749,Staff,0,10,30,30
1650317491599,MATH 18,B03,083750,Staff,1,9,30,29
1650317491599,MATH 18,B04,083751,Staff,0,10,30,30
1650317497623,MATH 20A,A01,083754,Staff,25,0,40,15
1650317503663,MATH 20B,A01,083756,Staff,0,5,30,30
1650317503663,MATH 20B,A02,083757,Staff,0,8,30,30
1650317509687,MATH 20C,A01,083760,Staff,0,13,30,30
1650317509687,MATH 20C,A02,083761,Staff,0,13,30,30
1650317509687,MATH 20C,B01,083762,Staff,13,0,30,17
1650317509687,MATH 20C,B02,083763,Staff,28,0,30,2
1650317515725,MATH 20D,A01,083765,Staff,0,1,30,30
1650317515725,MATH 20D,A02,083766,Staff,7,0,30,23
1650317515725,MATH 20D,A03,083767,Staff,27,0,30,3
1650317521750,MATH 20E,A01,083771,Staff,6,0,30,24
1650317521750,MATH 20E,A02,083772,Staff,19,0,30,11
1650317521750,MATH 20E,B01,083773,Staff,0,0,30,30
1650317521750,MATH 20E,B02,083774,Staff,12,0,30,18
1650317527772,MATH 103A,A01,083777,Staff,0,12,30,30
1650317527772,MATH 103A,A02,083778,Staff,0,12,30,30
1650317527772,MATH 103A,B01,083779,Staff,0,11,30,30
1650317527772,MATH 103A,B02,083780,Staff,0,11,30,30
1650317533796,MATH 105,A01,085443,Staff,0,19,30,30
1650317539827,MATH 109,A01,083213,Anzaldo; Leesa B,0,5,30,30
1650317539827,MATH 109,A02,083214,Anzaldo; Leesa B,0,6,30,30
1650317539827,MATH 109,B01,083215,Anzaldo; Leesa B,0,4,30,30
1650317539827,MATH 109,B02,083216,Anzaldo; Leesa B,0,4,30,30
1650317545856,MATH 142A,A01,083219,Chow; Bennett,0,14,30,30
1650317545856,MATH 142A,A02,083220,Chow; Bennett,0,12,30,30
1650317545856,MATH 142A,B01,083221,Chow; Bennett,0,12,30,30
1650317545856,MATH 142A,B02,083222,Chow; Bennett,0,12,30,30
1650317551890,MATH 193A,A01,083224,Staff,0,5,30,30
1650317551890,MATH 193A,A02,083225,Staff,0,5,30,30
1650317551890,MATH 193A,A03,083781,Staff,0,2,30,30
1650317551890,MATH 193A,A04,083782,Staff,0,3,30,30
1650317557923,MATH 197,001,091859,McAuley; Julian John,9998,0,9999,1
1650317563983,COGS 9,A01,083615,Staff,0,15,60,60
1650317570010,COGS 11,A01,083617,Boyle; Mary E. T.,22,0,40,18
1650317576036,COGS 13,A01,083071,Staff,0,31,40,40
1650317582068,COGS 14A,A01,092681,Staff,0,17,100,100
1650317588092,COGS 14B,A01,083073,Cheng; Tzu-Han,0,10,50,50
1650317594117,COGS 17,A01,092677,Staff,25,0,75,50
1650317600151,COGS 100,A01,083619,Staff,0,23,60,60
1650317606175,COGS 101A,A01,083621,Davis; Joshua Daniel,0,22,60,60
1650317612198,COGS 101B,A01,091572,Staff,3,0,60,57
1650317618222,COGS 101C,A01,083625,Delgado; Tania,19,0,30,11
1650317624251,COGS 107A,A01,083627,Boyle; Mary E. T.,0,8,60,60
1650317630274,COGS 118A,A01,083075,Staff,5,0,60,55
1650317636303,CSE 3,A50,083646,Miranda; Gregory Joseph,21,0,38,17
1650317636303,CSE 3,A51,083647,Miranda; Gregory Joseph,37,0,37,0
1650317642338,CSE 8A,A50,083650,Miranda; Gregory Joseph,0,26,40,40
1650317648362,CSE 11,A01,083080,Cao; Yingjun,0,83,40,40
1650317654389,CSE 12,A01,083652,Staff,0,11,100,100
1650317660413,CSE 15L,A01,083654,Staff,0,1,50,50
1650317660413,CSE 15L,A02,083655,Staff,4,0,50,46
1650317666436,CSE 20,A01,083657,Staff,53,0,80,27
1650317672460,CSE 30,A01,083084,Eldon; John,0,74,40,40
1650317678487,CSE 100,A01,083659,Cao; Yingjun,0,65,50,50
1650317684515,CSE 134B,A01,083661,Powell; Thomas Allan,0,30,65,65
1650317690539,CSE 140,A01,083663,Staff,0,0,75,75
1650317696563,CSE 140L,A01,083088,Eldon; John,0,6,75,75
1650317702589,CSE 175,A01,083665,Kumar; Rakesh,8,0,25,17
1650317708614,CSE 190,A00,092507,Dubnov; Shlomo,14,0,20,6
1650317714642,ECE 45,A01,083139,Staff,0,16,40,40
1650317720666,ECE 65,A50,083695,Staff,0,5,30,30
1650317726690,ECE 109,A01,091882,Touri; Behrouz,42,0,70,28
1650317732717,ECE 180,A00,083140,Abi Samra; Nicholas Camill,23,0,30,7
1650317732717,ECE 180,B00,083141,Abi Samra; Nicholas Camill,5,0,30,25
1650317738747,MATH 10A,A01,083735,Patchell; Gregory David,10,0,30,20
1650317738747,MATH 10A,A02,083736,Patchell; Gregory David,28,0,30,2
1650317738747,MATH 10A,A03,083737,Patchell; Gregory David,26,0,30,4
1650317744774,MATH 10B,A01,083207,Staff,0,6,30,30
1650317744774,MATH 10B,A02,083208,Staff,0,6,30,30
1650317744774,MATH 10B,B01,083739,Staff,17,0,30,13
1650317744774,MATH 10B,B02,083740,Staff,28,0,30,2
1650317750798,MATH 18,A01,083743,Staff,5,0,30,25
1650317750798,MATH 18,A02,083744,Staff,26,0,30,4
1650317750798,MATH 18,A03,083745,Staff,22,0,30,8
1650317750798,MATH 18,A04,083746,Staff,27,0,30,3
1650317750798,MATH 18,B01,083748,Staff,0,11,30,30
1650317750798,MATH 18,B02,083749,Staff,0,10,30,30
1650317750798,MATH 18,B03,083750,Staff,1,9,30,29
1650317750798,MATH 18,B04,083751,Staff,0,10,30,30
1650317756825,MATH 20A,A01,083754,Staff,25,0,40,15
1650317762849,MATH 20B,A01,083756,Staff,0,5,30,30
1650317762849,MATH 20B,A02,083757,Staff,0,8,30,30
1650317768880,MATH 20C,A01,083760,Staff,0,13,30,30
1650317768880,MATH 20C,A02,083761,Staff,0,13,30,30
1650317768880,MATH 20C,B01,083762,Staff,13,0,30,17
1650317768880,MATH 20C,B02,083763,Staff,28,0,30,2
1650317774906,MATH 20D,A01,083765,Staff,0,1,30,30
1650317774906,MATH 20D,A02,083766,Staff,7,0,30,23
1650317774906,MATH 20D,A03,083767,Staff,27,0,30,3
1650317780933,MATH 20E,A01,083771,Staff,6,0,30,24
1650317780933,MATH 20E,A02,083772,Staff,19,0,30,11
1650317780933,MATH 20E,B01,083773,Staff,0,0,30,30
1650317780933,MATH 20E,B02,083774,Staff,12,0,30,18
1650317786956,MATH 103A,A01,083777,Staff,0,12,30,30
1650317786956,MATH 103A,A02,083778,Staff,0,12,30,30
1650317786956,MATH 103A,B01,083779,Staff,0,11,30,30
1650317786956,MATH 103A,B02,083780,Staff,0,11,30,30
1650317792979,MATH 105,A01,085443,Staff,0,19,30,30
1650317799004,MATH 109,A01,083213,Anzaldo; Leesa B,0,5,30,30
1650317799004,MATH 109,A02,083214,Anzaldo; Leesa B,0,6,30,30
1650317799004,MATH 109,B01,083215,Anzaldo; Leesa B,0,4,30,30
1650317799004,MATH 109,B02,083216,Anzaldo; Leesa B,0,4,30,30
1650317805031,MATH 142A,A01,083219,Chow; Bennett,0,14,30,30
1650317805031,MATH 142A,A02,083220,Chow; Bennett,0,12,30,30
1650317805031,MATH 142A,B01,083221,Chow; Bennett,0,12,30,30
1650317805031,MATH 142A,B02,083222,Chow; Bennett,0,12,30,30
1650317811054,MATH 193A,A01,083224,Staff,0,5,30,30
1650317811054,MATH 193A,A02,083225,Staff,0,5,30,30
1650317811054,MATH 193A,A03,083781,Staff,0,2,30,30
1650317811054,MATH 193A,A04,083782,Staff,0,3,30,30
1650317817086,MATH 197,001,091859,McAuley; Julian John,9998,0,9999,1
1650317823153,COGS 9,A01,083615,Staff,0,15,60,60
1650317829181,COGS 11,A01,083617,Boyle; Mary E. T.,22,0,40,18
1650317835205,COGS 13,A01,083071,Staff,0,31,40,40
1650317841230,COGS 14A,A01,092681,Staff,0,17,100,100
1650317847254,COGS 14B,A01,083073,Cheng; Tzu-Han,0,10,50,50
1650317853277,COGS 17,A01,092677,Staff,25,0,75,50
1650317859302,COGS 100,A01,083619,Staff,0,23,60,60
1650317865325,COGS 101A,A01,083621,Davis; Joshua Daniel,0,22,60,60
1650317871351,COGS 101B,A01,091572,Staff,3,0,60,57
1650317877392,COGS 101C,A01,083625,Delgado; Tania,19,0,30,11
1650317883510,COGS 107A,A01,083627,Boyle; Mary E. T.,0,8,60,60
1650317889535,COGS 118A,A01,083075,Staff,5,0,60,55
1650317895563,CSE 3,A50,083646,Miranda; Gregory Joseph,21,0,38,17
1650317895563,CSE 3,A51,083647,Miranda; Gregory Joseph,37,0,37,0
1650317901587,CSE 8A,A50,083650,Miranda; Gregory Joseph,0,26,40,40
1650317907618,CSE 11,A01,083080,Cao; Yingjun,0,83,40,40
1650317913641,CSE 12,A01,083652,Staff,0,11,100,100
1650317919664,CSE 15L,A01,083654,Staff,0,1,50,50
1650317919664,CSE 15L,A02,083655,Staff,4,0,50,46
1650317925688,CSE 20,A01,083657,Staff,53,0,80,27
1650317931711,CSE 30,A01,083084,Eldon; John,0,74,40,40
1650317937736,CSE 100,A01,083659,Cao; Yingjun,0,65,50,50
1650317943759,CSE 134B,A01,083661,Powell; Thomas Allan,0,30,65,65
1650317949786,CSE 140,A01,083663,Staff,0,0,75,75
1650317955813,CSE 140L,A01,083088,Eldon; John,0,6,75,75
1650317961843,CSE 175,A01,083665,Kumar; Rakesh,8,0,25,17
1650317967872,CSE 190,A00,092507,Dubnov; Shlomo,14,0,20,6
1650317973895,ECE 45,A01,083139,Staff,0,16,40,40
1650317979922,ECE 65,A50,083695,Staff,0,5,30,30
1650317985947,ECE 109,A01,091882,Touri; Behrouz,42,0,70,28
1650317991972,ECE 180,A00,083140,Abi Samra; Nicholas Camill,23,0,30,7
1650317991972,ECE 180,B00,083141,Abi Samra; Nicholas Camill,5,0,30,25
1650317997996,MATH 10A,A01,083735,Patchell; Gregory David,10,0,30,20
1650317997996,MATH 10A,A02,083736,Patchell; Gregory David,28,0,30,2
1650317997996,MATH 10A,A03,083737,Patchell; Gregory David,26,0,30,4
1650318004019,MATH 10B,A01,083207,Staff,0,6,30,30
1650318004019,MATH 10B,A02,083208,Staff,0,6,30,30
1650318004019,MATH 10B,B01,083739,Staff,17,0,30,13
1650318004019,MATH 10B,B02,083740,Staff,28,0,30,2
1650318010051,MATH 18,A01,083743,Staff,5,0,30,25
1650318010051,MATH 18,A02,083744,Staff,26,0,30,4
1650318010051,MATH 18,A03,083745,Staff,22,0,30,8
1650318010051,MATH 18,A04,083746,Staff,27,0,30,3
1650318010051,MATH 18,B01,083748,Staff,0,11,30,30
1650318010051,MATH 18,B02,083749,Staff,0,10,30,30
1650318010051,MATH 18,B03,083750,Staff,1,9,30,29
1650318010051,MATH 18,B04,083751,Staff,0,10,30,30
1650318016082,MATH 20A,A01,083754,Staff,25,0,40,15
1650318022106,MATH 20B,A01,083756,Staff,0,5,30,30
1650318022106,MATH 20B,A02,083757,Staff,0,8,30,30
1650318028133,MATH 20C,A01,083760,Staff,0,13,30,30
1650318028133,MATH 20C,A02,083761,Staff,0,13,30,30
1650318028133,MATH 20C,B01,083762,Staff,13,0,30,17
1650318028133,MATH 20C,B02,083763,Staff,28,0,30,2
1650318034160,MATH 20D,A01,083765,Staff,0,1,30,30
1650318034160,MATH 20D,A02,083766,Staff,7,0,30,23
1650318034160,MATH 20D,A03,083767,Staff,27,0,30,3
1650318040186,MATH 20E,A01,083771,Staff,5,0,30,25
1650318040186,MATH 20E,A02,083772,Staff,19,0,30,11
1650318040186,MATH 20E,B01,083773,Staff,0,0,30,30
1650318040186,MATH 20E,B02,083774,Staff,12,0,30,18
1650318046209,MATH 103A,A01,083777,Staff,0,12,30,30
1650318046209,MATH 103A,A02,083778,Staff,0,12,30,30
1650318046209,MATH 103A,B01,083779,Staff,0,11,30,30
1650318046209,MATH 103A,B02,083780,Staff,0,11,30,30
1650318052235,MATH 105,A01,085443,Staff,0,19,30,30
1650318058263,MATH 109,A01,083213,Anzaldo; Leesa B,0,5,30,30
1650318058263,MATH 109,A02,083214,Anzaldo; Leesa B,0,6,30,30
1650318058263,MATH 109,B01,083215,Anzaldo; Leesa B,0,4,30,30
1650318058263,MATH 109,B02,083216,Anzaldo; Leesa B,0,4,30,30
1650318064291,MATH 142A,A01,083219,Chow; Bennett,0,14,30,30
1650318064291,MATH 142A,A02,083220,Chow; Bennett,0,12,30,30
1650318064291,MATH 142A,B01,083221,Chow; Bennett,0,12,30,30
1650318064291,MATH 142A,B02,083222,Chow; Bennett,0,12,30,30
1650318070320,MATH 193A,A01,083224,Staff,0,5,30,30
1650318070320,MATH 193A,A02,083225,Staff,0,5,30,30
1650318070320,MATH 193A,A03,083781,Staff,0,2,30,30
1650318070320,MATH 193A,A04,083782,Staff,0,3,30,30
1650318076345,MATH 197,001,091859,McAuley; Julian John,9998,0,9999,1
1650318082404,COGS 9,A01,083615,Staff,0,15,60,60
1650318088427,COGS 11,A01,083617,Boyle; Mary E. T.,22,0,40,18
1650318094452,COGS 13,A01,083071,Staff,0,31,40,40
1650318100476,COGS 14A,A01,092681,Staff,0,17,100,100
1650318106518,COGS 14B,A01,083073,Cheng; Tzu-Han,0,10,50,50
1650318112541,COGS 17,A01,092677,Staff,25,0,75,50
1650318118564,COGS 100,A01,083619,Staff,0,23,60,60
1650318124589,COGS 101A,A01,083621,Davis; Joshua Daniel,0,22,60,60
1650318130615,COGS 101B,A01,091572,Staff,3,0,60,57
1650318136640,COGS 101C,A01,083625,Delgado; Tania,19,0,30,11
1650318142666,COGS 107A,A01,083627,Boyle; Mary E. T.,0,8,60,60
1650318148694,COGS 118A,A01,083075,Staff,5,0,60,55
1650318154717,CSE 3,A50,083646,Miranda; Gregory Joseph,21,0,38,17
1650318154717,CSE 3,A51,083647,Miranda; Gregory Joseph,37,0,37,0
1650318160750,CSE 8A,A50,083650,Miranda; Gregory Joseph,0,26,40,40
1650318166773,CSE 11,A01,083080,Cao; Yingjun,0,83,40,40
1650318172797,CSE 12,A01,083652,Staff,0,11,100,100
1650318178819,CSE 15L,A01,083654,Staff,0,1,50,50
1650318178819,CSE 15L,A02,083655,Staff,4,0,50,46
1650318184849,CSE 20,A01,083657,Staff,53,0,80,27
1650318190881,CSE 30,A01,083084,Eldon; John,0,74,40,40
1650318196915,CSE 100,A01,083659,Cao; Yingjun,0,65,50,50
1650318202945,CSE 134B,A01,083661,Powell; Thomas Allan,0,30,65,65
1650318208971,CSE 140,A01,083663,Staff,0,0,75,75
1650318215001,CSE 140L,A01,083088,Eldon; John,0,6,75,75
1650318221025,CSE 175,A01,083665,Kumar; Rakesh,8,0,25,17
1650318227056,CSE 190,A00,092507,Dubnov; Shlomo,14,0,20,6
1650318233086,ECE 45,A01,083139,Staff,0,16,40,40
1650318239113,ECE 65,A50,083695,Staff,0,5,30,30
1650318245145,ECE 109,A01,091882,Touri; Behrouz,42,0,70,28
1650318251169,ECE 180,A00,083140,Abi Samra; Nicholas Camill,23,0,30,7
1650318251169,ECE 180,B00,083141,Abi Samra; Nicholas Camill,5,0,30,25
1650318257192,MATH 10A,A01,083735,Patchell; Gregory David,10,0,30,20
1650318257192,MATH 10A,A02,083736,Patchell; Gregory David,28,0,30,2
1650318257192,MATH 10A,A03,083737,Patchell; Gregory David,26,0,30,4
1650318263215,MATH 10B,A01,083207,Staff,0,6,30,30
1650318263215,MATH 10B,A02,083208,Staff,0,6,30,30
1650318263215,MATH 10B,B01,083739,Staff,17,0,30,13
1650318263215,MATH 10B,B02,083740,Staff,28,0,30,2
1650318269245,MATH 18,A01,083743,Staff,5,0,30,25
1650318269245,MATH 18,A02,083744,Staff,26,0,30,4
1650318269245,MATH 18,A03,083745,Staff,22,0,30,8
1650318269245,MATH 18,A04,083746,Staff,27,0,30,3
1650318269245,MATH 18,B01,083748,Staff,0,11,30,30
1650318269245,MATH 18,B02,083749,Staff,0,10,30,30
1650318269245,MATH 18,B03,083750,Staff,1,9,30,29
1650318269245,MATH 18,B04,083751,Staff,0,10,30,30
1650318275269,MATH 20A,A01,083754,Staff,25,0,40,15
1650318281292,MATH 20B,A01,083756,Staff,0,5,30,30
1650318281292,MATH 20B,A02,083757,Staff,0,8,30,30
1650318287318,MATH 20C,A01,083760,Staff,0,13,30,30
1650318287318,MATH 20C,A02,083761,Staff,0,13,30,30
1650318287318,MATH 20C,B01,083762,Staff,13,0,30,17
1650318287318,MATH 20C,B02,083763,Staff,28,0,30,2
1650318293342,MATH 20D,A01,083765,Staff,0,1,30,30
1650318293342,MATH 20D,A02,083766,Staff,7,0,30,23
1650318293342,MATH 20D,A03,083767,Staff,27,0,30,3
1650318299368,MATH 20E,A01,083771,Staff,5,0,30,25
1650318299368,MATH 20E,A02,083772,Staff,19,0,30,11
1650318299368,MATH 20E,B01,083773,Staff,0,0,30,30
1650318299368,MATH 20E,B02,083774,Staff,12,0,30,18
1650318305393,MATH 103A,A01,083777,Staff,0,12,30,30
1650318305393,MATH 103A,A02,083778,Staff,0,12,30,30
1650318305393,MATH 103A,B01,083779,Staff,0,11,30,30
1650318305393,MATH 103A,B02,083780,Staff,0,11,30,30
1650318311417,MATH 105,A01,085443,Staff,0,19,30,30
1650318317441,MATH 109,A01,083213,Anzaldo; Leesa B,0,5,30,30
1650318317441,MATH 109,A02,083214,Anzaldo; Leesa B,0,6,30,30
1650318317441,MATH 109,B01,083215,Anzaldo; Leesa B,0,4,30,30
1650318317441,MATH 109,B02,083216,Anzaldo; Leesa B,0,4,30,30
1650318323466,MATH 142A,A01,083219,Chow; Bennett,0,14,30,30
1650318323466,MATH 142A,A02,083220,Chow; Bennett,0,12,30,30
1650318323466,MATH 142A,B01,083221,Chow; Bennett,0,12,30,30
1650318323466,MATH 142A,B02,083222,Chow; Bennett,0,12,30,30
1650318329502,MATH 193A,A01,083224,Staff,0,5,30,30
1650318329502,MATH 193A,A02,083225,Staff,0,5,30,30
1650318329502,MATH 193A,A03,083781,Staff,0,2,30,30
1650318329502,MATH 193A,A04,083782,Staff,0,3,30,30
1650318335527,MATH 197,001,091859,McAuley; Julian John,9998,0,9999,1
1650318341598,COGS 9,A01,083615,Staff,0,15,60,60
1650318347626,COGS 11,A01,083617,Boyle; Mary E. T.,22,0,40,18
1650318353649,COGS 13,A01,083071,Staff,0,31,40,40
1650318359671,COGS 14A,A01,092681,Staff,0,17,100,100
1650318365701,COGS 14B,A01,083073,Cheng; Tzu-Han,0,10,50,50
1650318371728,COGS 17,A01,092677,Staff,25,0,75,50
1650318377756,COGS 100,A01,083619,Staff,0,23,60,60
1650318383779,COGS 101A,A01,083621,Davis; Joshua Daniel,0,22,60,60
1650318389805,COGS 101B,A01,091572,Staff,3,0,60,57
1650318395832,COGS 101C,A01,083625,Delgado; Tania,19,0,30,11
1650318401870,COGS 107A,A01,083627,Boyle; Mary E. T.,0,8,60,60
1650318407904,COGS 118A,A01,083075,Staff,5,0,60,55
1650318413936,CSE 3,A50,083646,Miranda; Gregory Joseph,21,0,38,17
1650318413936,CSE 3,A51,083647,Miranda; Gregory Joseph,37,0,37,0
1650318419959,CSE 8A,A50,083650,Miranda; Gregory Joseph,0,26,40,40
1650318425989,CSE 11,A01,083080,Cao; Yingjun,0,83,40,40
1650318432011,CSE 12,A01,083652,Staff,0,11,100,100
1650318438038,CSE 15L,A01,083654,Staff,0,1,50,50
1650318438038,CSE 15L,A02,083655,Staff,4,0,50,46
1650318444067,CSE 20,A01,083657,Staff,53,0,80,27
1650318450091,CSE 30,A01,083084,Eldon; John,0,74,40,40
1650318456132,CSE 100,A01,083659,Cao; Yingjun,0,65,50,50
1650318462161,CSE 134B,A01,083661,Powell; Thomas Allan,0,30,65,65
1650318468184,CSE 140,A01,083663,Staff,0,0,75,75
1650318474221,CSE 140L,A01,083088,Eldon; John,0,6,75,75
1650318480345,CSE 175,A01,083665,Kumar; Rakesh,8,0,25,17
1650318486369,CSE 190,A00,092507,Dubnov; Shlomo,14,0,20,6
1650318492392,ECE 45,A01,083139,Staff,0,16,40,40
1650318498424,ECE 65,A50,083695,Staff,0,5,30,30
1650318504457,ECE 109,A01,091882,Touri; Behrouz,42,0,70,28
1650318510494,ECE 180,A00,083140,Abi Samra; Nicholas Camill,23,0,30,7
1650318510494,ECE 180,B00,083141,Abi Samra; Nicholas Camill,5,0,30,25
1650318516543,MATH 10A,A01,083735,Patchell; Gregory David,10,0,30,20
1650318516543,MATH 10A,A02,083736,Patchell; Gregory David,28,0,30,2
1650318516543,MATH 10A,A03,083737,Patchell; Gregory David,26,0,30,4
1650318522567,MATH 10B,A01,083207,Staff,0,6,30,30
1650318522567,MATH 10B,A02,083208,Staff,0,6,30,30
1650318522567,MATH 10B,B01,083739,Staff,17,0,30,13
1650318522567,MATH 10B,B02,083740,Staff,28,0,30,2
1650318528590,MATH 18,A01,083743,Staff,5,0,30,25
1650318528590,MATH 18,A02,083744,Staff,26,0,30,4
1650318528590,MATH 18,A03,083745,Staff,22,0,30,8
1650318528590,MATH 18,A04,083746,Staff,27,0,30,3
1650318528590,MATH 18,B01,083748,Staff,0,11,30,30
1650318528590,MATH 18,B02,083749,Staff,0,10,30,30
1650318528590,MATH 18,B03,083750,Staff,1,9,30,29
1650318528590,MATH 18,B04,083751,Staff,0,10,30,30
1650318534614,MATH 20A,A01,083754,Staff,25,0,40,15
1650318540641,MATH 20B,A01,083756,Staff,0,5,30,30
1650318540641,MATH 20B,A02,083757,Staff,0,8,30,30
1650318546662,MATH 20C,A01,083760,Staff,0,13,30,30
1650318546662,MATH 20C,A02,083761,Staff,0,13,30,30
1650318546662,MATH 20C,B01,083762,Staff,13,0,30,17
1650318546662,MATH 20C,B02,083763,Staff,28,0,30,2
1650318552687,MATH 20D,A01,083765,Staff,0,1,30,30
1650318552687,MATH 20D,A02,083766,Staff,7,0,30,23
1650318552687,MATH 20D,A03,083767,Staff,27,0,30,3
1650318558713,MATH 20E,A01,083771,Staff,5,0,30,25
1650318558713,MATH 20E,A02,083772,Staff,19,0,30,11
1650318558713,MATH 20E,B01,083773,Staff,0,0,30,30
1650318558713,MATH 20E,B02,083774,Staff,12,0,30,18
1650318564748,MATH 103A,A01,083777,Staff,0,12,30,30
1650318564748,MATH 103A,A02,083778,Staff,0,12,30,30
1650318564748,MATH 103A,B01,083779,Staff,0,11,30,30
1650318564748,MATH 103A,B02,083780,Staff,0,11,30,30
1650318570775,MATH 105,A01,085443,Staff,0,19,30,30
1650318576798,MATH 109,A01,083213,Anzaldo; Leesa B,0,5,30,30
1650318576798,MATH 109,A02,083214,Anzaldo; Leesa B,0,6,30,30
1650318576798,MATH 109,B01,083215,Anzaldo; Leesa B,0,4,30,30
1650318576798,MATH 109,B02,083216,Anzaldo; Leesa B,0,4,30,30
1650318582825,MATH 142A,A01,083219,Chow; Bennett,0,14,30,30
1650318582825,MATH 142A,A02,083220,Chow; Bennett,0,12,30,30
1650318582825,MATH 142A,B01,083221,Chow; Bennett,0,12,30,30
1650318582825,MATH 142A,B02,083222,Chow; Bennett,0,12,30,30
1650318588873,MATH 193A,A01,083224,Staff,0,5,30,30
1650318588873,MATH 193A,A02,083225,Staff,0,5,30,30
1650318588873,MATH 193A,A03,083781,Staff,0,2,30,30
1650318588873,MATH 193A,A04,083782,Staff,0,3,30,30
1650318594896,MATH 197,001,091859,McAuley; Julian John,9998,0,9999,1
1650318600953,COGS 9,A01,083615,Staff,0,15,60,60
1650318606977,COGS 11,A01,083617,Boyle; Mary E. T.,22,0,40,18
1650318613001,COGS 13,A01,083071,Staff,0,31,40,40
1650318619024,COGS 14A,A01,092681,Staff,0,17,100,100
1650318625048,COGS 14B,A01,083073,Cheng; Tzu-Han,0,10,50,50
1650318631074,COGS 17,A01,092677,Staff,25,0,75,50
1650318637108,COGS 100,A01,083619,Staff,0,23,60,60
1650318643132,COGS 101A,A01,083621,Davis; Joshua Daniel,0,22,60,60
1650318649154,COGS 101B,A01,091572,Staff,3,0,60,57
1650318655187,COGS 101C,A01,083625,Delgado; Tania,18,0,30,12
1650318661227,COGS 107A,A01,083627,Boyle; Mary E. T.,0,8,60,60
1650318667251,COGS 118A,A01,083075,Staff,5,0,60,55
1650318673273,CSE 3,A50,083646,Miranda; Gregory Joseph,21,0,38,17
1650318673273,CSE 3,A51,083647,Miranda; Gregory Joseph,37,0,37,0
1650318679307,CSE 8A,A50,083650,Miranda; Gregory Joseph,0,26,40,40
1650318685333,CSE 11,A01,083080,Cao; Yingjun,0,83,40,40
1650318691358,CSE 12,A01,083652,Staff,0,11,100,100
1650318697381,CSE 15L,A01,083654,Staff,0,1,50,50
1650318697381,CSE 15L,A02,083655,Staff,4,0,50,46
1650318703405,CSE 20,A01,083657,Staff,53,0,80,27
1650318709430,CSE 30,A01,083084,Eldon; John,0,74,40,40
1650318715463,CSE 100,A01,083659,Cao; Yingjun,0,65,50,50
1650318721488,CSE 134B,A01,083661,Powell; Thomas Allan,0,30,65,65
1650318727512,CSE 140,A01,083663,Staff,0,0,75,75
1650318733537,CSE 140L,A01,083088,Eldon; John,0,6,75,75
1650318739647,CSE 175,A01,083665,Kumar; Rakesh,8,0,25,17
1650318745672,CSE 190,A00,092507,Dubnov; Shlomo,14,0,20,6
1650318751696,ECE 45,A01,083139,Staff,0,16,40,40
1650318757723,ECE 65,A50,083695,Staff,0,5,30,30
1650318763746,ECE 109,A01,091882,Touri; Behrouz,42,0,70,28
1650318769769,ECE 180,A00,083140,Abi Samra; Nicholas Camill,23,0,30,7
1650318769769,ECE 180,B00,083141,Abi Samra; Nicholas Camill,5,0,30,25
1650318775794,MATH 10A,A01,083735,Patchell; Gregory David,10,0,30,20
1650318775794,MATH 10A,A02,083736,Patchell; Gregory David,28,0,30,2
1650318775794,MATH 10A,A03,083737,Patchell; Gregory David,26,0,30,4
1650318781818,MATH 10B,A01,083207,Staff,0,6,30,30
1650318781818,MATH 10B,A02,083208,Staff,0,6,30,30
1650318781818,MATH 10B,B01,083739,Staff,17,0,30,13
1650318781818,MATH 10B,B02,083740,Staff,28,0,30,2
1650318787852,MATH 18,A01,083743,Staff,5,0,30,25
1650318787852,MATH 18,A02,083744,Staff,26,0,30,4
1650318787852,MATH 18,A03,083745,Staff,22,0,30,8
1650318787852,MATH 18,A04,083746,Staff,27,0,30,3
1650318787852,MATH 18,B01,083748,Staff,0,11,30,30
1650318787852,MATH 18,B02,083749,Staff,0,10,30,30
1650318787852,MATH 18,B03,083750,Staff,1,9,30,29
1650318787852,MATH 18,B04,083751,Staff,0,10,30,30
1650318793877,MATH 20A,A01,083754,Staff,26,0,40,14
1650318799901,MATH 20B,A01,083756,Staff,0,5,30,30
1650318799901,MATH 20B,A02,083757,Staff,0,8,30,30
1650318805929,MATH 20C,A01,083760,Staff,0,13,30,30
1650318805929,MATH 20C,A02,083761,Staff,0,13,30,30
1650318805929,MATH 20C,B01,083762,Staff,13,0,30,17
1650318805929,MATH 20C,B02,083763,Staff,28,0,30,2
1650318811955,MATH 20D,A01,083765,Staff,0,1,30,30
1650318811955,MATH 20D,A02,083766,Staff,7,0,30,23
1650318811955,MATH 20D,A03,083767,Staff,27,0,30,3
1650318817983,MATH 20E,A01,083771,Staff,5,0,30,25
1650318817983,MATH 20E,A02,083772,Staff,19,0,30,11
1650318817983,MATH 20E,B01,083773,Staff,0,0,30,30
1650318817983,MATH 20E,B02,083774,Staff,12,0,30,18
1650318824019,MATH 103A,A01,083777,Staff,0,12,30,30
1650318824019,MATH 103A,A02,083778,Staff,0,12,30,30
1650318824019,MATH 103A,B01,083779,Staff,0,11,30,30
1650318824019,MATH 103A,B02,083780,Staff,0,11,30,30
1650318830047,MATH 105,A01,085443,Staff,0,19,30,30
1650318836079,MATH 109,A01,083213,Anzaldo; Leesa B,0,5,30,30
1650318836079,MATH 109,A02,083214,Anzaldo; Leesa B,0,6,30,30
1650318836079,MATH 109,B01,083215,Anzaldo; Leesa B,0,4,30,30
1650318836079,MATH 109,B02,083216,Anzaldo; Leesa B,0,4,30,30
1650318842112,MATH 142A,A01,083219,Chow; Bennett,0,14,30,30
1650318842112,MATH 142A,A02,083220,Chow; Bennett,0,12,30,30
1650318842112,MATH 142A,B01,083221,Chow; Bennett,0,12,30,30
1650318842112,MATH 142A,B02,083222,Chow; Bennett,0,12,30,30
1650318848140,MATH 193A,A01,083224,Staff,0,5,30,30
1650318848140,MATH 193A,A02,083225,Staff,0,5,30,30
1650318848140,MATH 193A,A03,083781,Staff,0,2,30,30
1650318848140,MATH 193A,A04,083782,Staff,0,3,30,30
1650318854164,MATH 197,001,091859,McAuley; Julian John,9998,0,9999,1
1650318860243,COGS 9,A01,083615,Staff,0,15,60,60
1650318866269,COGS 11,A01,083617,Boyle; Mary E. T.,22,0,40,18
1650318872304,COGS 13,A01,083071,Staff,0,31,40,40
1650318878330,COGS 14A,A01,092681,Staff,0,17,100,100
1650318884371,COGS 14B,A01,083073,Cheng; Tzu-Han,0,10,50,50
1650318890397,COGS 17,A01,092677,Staff,25,0,75,50
1650318896420,COGS 100,A01,083619,Staff,0,23,60,60
1650318902461,COGS 101A,A01,083621,Davis; Joshua Daniel,0,22,60,60
1650318908489,COGS 101B,A01,091572,Staff,3,0,60,57
1650318914513,COGS 101C,A01,083625,Delgado; Tania,18,0,30,12
1650318920540,COGS 107A,A01,083627,Boyle; Mary E. T.,0,8,60,60
1650318926569,COGS 118A,A01,083075,Staff,5,0,60,55
1650318932595,CSE 3,A50,083646,Miranda; Gregory Joseph,21,0,38,17
1650318932595,CSE 3,A51,083647,Miranda; Gregory Joseph,37,0,37,0
1650318938619,CSE 8A,A50,083650,Miranda; Gregory Joseph,0,26,40,40
1650318944642,CSE 11,A01,083080,Cao; Yingjun,0,83,40,40
1650318950672,CSE 12,A01,083652,Staff,0,11,100,100
1650318956705,CSE 15L,A01,083654,Staff,0,1,50,50
1650318956705,CSE 15L,A02,083655,Staff,4,0,50,46
1650318962729,CSE 20,A01,083657,Staff,53,0,80,27
1650318968756,CSE 30,A01,083084,Eldon; John,0,74,40,40
1650318974792,CSE 100,A01,083659,Cao; Yingjun,0,65,50,50
1650318980817,CSE 134B,A01,083661,Powell; Thomas Allan,0,30,65,65
1650318986842,CSE 140,A01,083663,Staff,0,0,75,75
1650318992866,CSE 140L,A01,083088,Eldon; John,0,6,75,75
1650318998899,CSE 175,A01,083665,Kumar; Rakesh,8,0,25,17
1650319004933,CSE 190,A00,092507,Dubnov; Shlomo,14,0,20,6
1650319010982,ECE 45,A01,083139,Staff,0,16,40,40
1650319017014,ECE 65,A50,083695,Staff,0,5,30,30
1650319023050,ECE 109,A01,091882,Touri; Behrouz,42,0,70,28
1650319029076,ECE 180,A00,083140,Abi Samra; Nicholas Camill,23,0,30,7
1650319029076,ECE 180,B00,083141,Abi Samra; Nicholas Camill,5,0,30,25
1650319035100,MATH 10A,A01,083735,Patchell; Gregory David,9,0,30,21
1650319035100,MATH 10A,A02,083736,Patchell; Gregory David,28,0,30,2
1650319035100,MATH 10A,A03,083737,Patchell; Gregory David,26,0,30,4
1650319041129,MATH 10B,A01,083207,Staff,0,6,30,30
1650319041129,MATH 10B,A02,083208,Staff,0,6,30,30
1650319041129,MATH 10B,B01,083739,Staff,17,0,30,13
1650319041129,MATH 10B,B02,083740,Staff,28,0,30,2
1650319047155,MATH 18,A01,083743,Staff,5,0,30,25
1650319047155,MATH 18,A02,083744,Staff,26,0,30,4
1650319047155,MATH 18,A03,083745,Staff,22,0,30,8
1650319047155,MATH 18,A04,083746,Staff,27,0,30,3
1650319047155,MATH 18,B01,083748,Staff,0,11,30,30
1650319047155,MATH 18,B02,083749,Staff,0,10,30,30
1650319047155,MATH 18,B03,083750,Staff,1,9,30,29
1650319047155,MATH 18,B04,083751,Staff,0,10,30,30
1650319053180,MATH 20A,A01,083754,Staff,26,0,40,14
1650319059203,MATH 20B,A01,083756,Staff,0,5,30,30
1650319059203,MATH 20B,A02,083757,Staff,0,8,30,30
1650319065229,MATH 20C,A01,083760,Staff,0,13,30,30
1650319065229,MATH 20C,A02,083761,Staff,0,13,30,30
1650319065229,MATH 20C,B01,083762,Staff,13,0,30,17
1650319065229,MATH 20C,B02,083763,Staff,28,0,30,2
1650319071256,MATH 20D,A01,083765,Staff,0,1,30,30
1650319071256,MATH 20D,A02,083766,Staff,7,0,30,23
1650319071256,MATH 20D,A03,083767,Staff,27,0,30,3
1650319077369,MATH 20E,A01,083771,Staff,5,0,30,25
1650319077369,MATH 20E,A02,083772,Staff,19,0,30,11
1650319077369,MATH 20E,B01,083773,Staff,0,0,30,30
1650319077369,MATH 20E,B02,083774,Staff,12,0,30,18
1650319083408,MATH 103A,A01,083777,Staff,0,12,30,30
1650319083408,MATH 103A,A02,083778,Staff,0,12,30,30
1650319083408,MATH 103A,B01,083779,Staff,0,11,30,30
1650319083408,MATH 103A,B02,083780,Staff,0,11,30,30
1650319089435,MATH 105,A01,085443,Staff,0,19,30,30
1650319095463,MATH 109,A01,083213,Anzaldo; Leesa B,0,5,30,30
1650319095463,MATH 109,A02,083214,Anzaldo; Leesa B,0,6,30,30
1650319095463,MATH 109,B01,083215,Anzaldo; Leesa B,0,4,30,30
1650319095463,MATH 109,B02,083216,Anzaldo; Leesa B,0,4,30,30
1650319101486,MATH 142A,A01,083219,Chow; Bennett,0,14,30,30
1650319101486,MATH 142A,A02,083220,Chow; Bennett,0,12,30,30
1650319101486,MATH 142A,B01,083221,Chow; Bennett,0,12,30,30
1650319101486,MATH 142A,B02,083222,Chow; Bennett,0,12,30,30
1650319107513,MATH 193A,A01,083224,Staff,0,5,30,30
1650319107513,MATH 193A,A02,083225,Staff,0,5,30,30
1650319107513,MATH 193A,A03,083781,Staff,0,2,30,30
1650319107513,MATH 193A,A04,083782,Staff,0,3,30,30
1650319113535,MATH 197,001,091859,McAuley; Julian John,9998,0,9999,1
1650319119626,COGS 9,A01,083615,Staff,0,15,60,60
1650319125654,COGS 11,A01,083617,Boyle; Mary E. T.,22,0,40,18
1650319131693,COGS 13,A01,083071,Staff,0,31,40,40
1650319137731,COGS 14A,A01,092681,Staff,0,17,100,100
1650319143759,COGS 14B,A01,083073,Cheng; Tzu-Han,0,10,50,50
1650319149780,COGS 17,A01,092677,Staff,25,0,75,50
1650319155805,COGS 100,A01,083619,Staff,0,23,60,60
1650319161827,COGS 101A,A01,083621,Davis; Joshua Daniel,0,22,60,60
1650319167857,COGS 101B,A01,091572,Staff,3,0,60,57
1650319173887,COGS 101C,A01,083625,Delgado; Tania,18,0,30,12
1650319179909,COGS 107A,A01,083627,Boyle; Mary E. T.,0,8,60,60
1650319185933,COGS 118A,A01,083075,Staff,5,0,60,55
1650319191960,CSE 3,A50,083646,Miranda; Gregory Joseph,21,0,38,17
1650319191960,CSE 3,A51,083647,Miranda; Gregory Joseph,37,0,37,0
1650319197990,CSE 8A,A50,083650,Miranda; Gregory Joseph,0,26,40,40
1650319204013,CSE 11,A01,083080,Cao; Yingjun,0,83,40,40
1650319210047,CSE 12,A01,083652,Staff,0,11,100,100
1650319216076,CSE 15L,A01,083654,Staff,0,1,50,50
1650319216076,CSE 15L,A02,083655,Staff,4,0,50,46
1650319222100,CSE 20,A01,083657,Staff,53,0,80,27
1650319228126,CSE 30,A01,083084,Eldon; John,0,74,40,40
1650319234154,CSE 100,A01,083659,Cao; Yingjun,0,65,50,50
1650319240179,CSE 134B,A01,083661,Powell; Thomas Allan,0,30,65,65
1650319246208,CSE 140,A01,083663,Staff,0,0,75,75
1650319252232,CSE 140L,A01,083088,Eldon; John,0,6,75,75
1650319258263,CSE 175,A01,083665,Kumar; Rakesh,8,0,25,17
1650319264293,CSE 190,A00,092507,Dubnov; Shlomo,14,0,20,6
1650319270322,ECE 45,A01,083139,Staff,0,16,40,40
1650319276361,ECE 65,A50,083695,Staff,0,5,30,30
1650319282388,ECE 109,A01,091882,Touri; Behrouz,42,0,70,28
1650319288412,ECE 180,A00,083140,Abi Samra; Nicholas Camill,23,0,30,7
1650319288412,ECE 180,B00,083141,Abi Samra; Nicholas Camill,5,0,30,25
1650319294440,MATH 10A,A01,083735,Patchell; Gregory David,9,0,30,21
1650319294440,MATH 10A,A02,083736,Patchell; Gregory David,28,0,30,2
1650319294440,MATH 10A,A03,083737,Patchell; Gregory David,26,0,30,4
1650319300466,MATH 10B,A01,083207,Staff,0,6,30,30
1650319300466,MATH 10B,A02,083208,Staff,0,6,30,30
1650319300466,MATH 10B,B01,083739,Staff,17,0,30,13
1650319300466,MATH 10B,B02,083740,Staff,28,0,30,2
1650319306490,MATH 18,A01,083743,Staff,5,0,30,25
1650319306490,MATH 18,A02,083744,Staff,26,0,30,4
1650319306490,MATH 18,A03,083745,Staff,22,0,30,8
1650319306490,MATH 18,A04,083746,Staff,27,0,30,3
1650319306490,MATH 18,B01,083748,Staff,0,11,30,30
1650319306490,MATH 18,B02,083749,Staff,0,10,30,30
1650319306490,MATH 18,B03,083750,Staff,1,9,30,29
1650319306490,MATH 18,B04,083751,Staff,0,10,30,30
1650319312514,MATH 20A,A01,083754,Staff,26,0,40,14
1650319318538,MATH 20B,A01,083756,Staff,0,5,30,30
1650319318538,MATH 20B,A02,083757,Staff,0,8,30,30
1650319324567,MATH 20C,A01,083760,Staff,0,13,30,30
1650319324567,MATH 20C,A02,083761,Staff,0,13,30,30
1650319324567,MATH 20C,B01,083762,Staff,13,0,30,17
1650319324567,MATH 20C,B02,083763,Staff,28,0,30,2
1650319330596,MATH 20D,A01,083765,Staff,0,1,30,30
1650319330596,MATH 20D,A02,083766,Staff,7,0,30,23
1650319330596,MATH 20D,A03,083767,Staff,27,0,30,3
1650319336663,MATH 20E,A01,083771,Staff,5,0,30,25
1650319336663,MATH 20E,A02,083772,Staff,19,0,30,11
1650319336663,MATH 20E,B01,083773,Staff,0,0,30,30
1650319336663,MATH 20E,B02,083774,Staff,12,0,30,18
1650319342692,MATH 103A,A01,083777,Staff,0,12,30,30
1650319342692,MATH 103A,A02,083778,Staff,0,12,30,30
1650319342692,MATH 103A,B01,083779,Staff,0,11,30,30
1650319342692,MATH 103A,B02,083780,Staff,0,11,30,30
1650319348717,MATH 105,A01,085443,Staff,0,19,30,30
1650319354741,MATH 109,A01,083213,Anzaldo; Leesa B,0,5,30,30
1650319354741,MATH 109,A02,083214,Anzaldo; Leesa B,0,6,30,30
1650319354741,MATH 109,B01,083215,Anzaldo; Leesa B,0,4,30,30
1650319354741,MATH 109,B02,083216,Anzaldo; Leesa B,0,4,30,30
1650319360767,MATH 142A,A01,083219,Chow; Bennett,0,14,30,30
1650319360767,MATH 142A,A02,083220,Chow; Bennett,0,12,30,30
1650319360767,MATH 142A,B01,083221,Chow; Bennett,0,12,30,30
1650319360767,MATH 142A,B02,083222,Chow; Bennett,0,12,30,30
1650319366795,MATH 193A,A01,083224,Staff,0,5,30,30
1650319366795,MATH 193A,A02,083225,Staff,0,5,30,30
1650319366795,MATH 193A,A03,083781,Staff,0,2,30,30
1650319366795,MATH 193A,A04,083782,Staff,0,3,30,30
1650319372817,MATH 197,001,091859,McAuley; Julian John,9998,0,9999,1
1650319378877,COGS 9,A01,083615,Staff,0,15,60,60
1650319384902,COGS 11,A01,083617,Boyle; Mary E. T.,22,0,40,18
1650319390925,COGS 13,A01,083071,Staff,0,31,40,40
1650319396948,COGS 14A,A01,092681,Staff,0,17,100,100
1650319402971,COGS 14B,A01,083073,Cheng; Tzu-Han,0,10,50,50
1650319408994,COGS 17,A01,092677,Staff,25,0,75,50
1650319415020,COGS 100,A01,083619,Staff,0,23,60,60
1650319421047,COGS 101A,A01,083621,Davis; Joshua Daniel,0,22,60,60
1650319427071,COGS 101B,A01,091572,Staff,3,0,60,57
1650319433104,COGS 101C,A01,083625,Delgado; Tania,18,0,30,12
1650319439131,COGS 107A,A01,083627,Boyle; Mary E. T.,0,8,60,60
1650319445156,COGS 118A,A01,083075,Staff,5,0,60,55
1650319451179,CSE 3,A50,083646,Miranda; Gregory Joseph,21,0,38,17
1650319451179,CSE 3,A51,083647,Miranda; Gregory Joseph,37,0,37,0
1650319457207,CSE 8A,A50,083650,Miranda; Gregory Joseph,0,26,40,40
1650319463231,CSE 11,A01,083080,Cao; Yingjun,0,83,40,40
1650319469261,CSE 12,A01,083652,Staff,0,11,100,100
1650319475297,CSE 15L,A01,083654,Staff,0,1,50,50
1650319475297,CSE 15L,A02,083655,Staff,4,0,50,46
1650319481320,CSE 20,A01,083657,Staff,53,0,80,27
1650319487352,CSE 30,A01,083084,Eldon; John,0,74,40,40
1650319493391,CSE 100,A01,083659,Cao; Yingjun,0,65,50,50
1650319499424,CSE 134B,A01,083661,Powell; Thomas Allan,0,30,65,65
1650319505454,CSE 140,A01,083663,Staff,0,0,75,75
1650319511491,CSE 140L,A01,083088,Eldon; John,0,6,75,75
1650319517514,CSE 175,A01,083665,Kumar; Rakesh,8,0,25,17
1650319523555,CSE 190,A00,092507,Dubnov; Shlomo,14,0,20,6
1650319529579,ECE 45,A01,083139,Staff,0,16,40,40
1650319535609,ECE 65,A50,083695,Staff,0,5,30,30
1650319541635,ECE 109,A01,091882,Touri; Behrouz,42,0,70,28
1650319547670,ECE 180,A00,083140,Abi Samra; Nicholas Camill,23,0,30,7
1650319547670,ECE 180,B00,083141,Abi Samra; Nicholas Camill,5,0,30,25
1650319553697,MATH 10A,A01,083735,Patchell; Gregory David,9,0,30,21
1650319553697,MATH 10A,A02,083736,Patchell; Gregory David,28,0,30,2
1650319553697,MATH 10A,A03,083737,Patchell; Gregory David,26,0,30,4
1650319559727,MATH 10B,A01,083207,Staff,0,6,30,30
1650319559727,MATH 10B,A02,083208,Staff,0,6,30,30
1650319559727,MATH 10B,B01,083739,Staff,17,0,30,13
1650319559727,MATH 10B,B02,083740,Staff,28,0,30,2
1650319565758,MATH 18,A01,083743,Staff,5,0,30,25
1650319565758,MATH 18,A02,083744,Staff,26,0,30,4
1650319565758,MATH 18,A03,083745,Staff,22,0,30,8
1650319565758,MATH 18,A04,083746,Staff,27,0,30,3
1650319565758,MATH 18,B01,083748,Staff,0,11,30,30
1650319565758,MATH 18,B02,083749,Staff,0,10,30,30
1650319565758,MATH 18,B03,083750,Staff,1,10,30,29
1650319565758,MATH 18,B04,083751,Staff,0,10,30,30
1650319571784,MATH 20A,A01,083754,Staff,26,0,40,14
1650319577811,MATH 20B,A01,083756,Staff,0,5,30,30
1650319577811,MATH 20B,A02,083757,Staff,0,8,30,30
1650319583835,MATH 20C,A01,083760,Staff,0,13,30,30
1650319583835,MATH 20C,A02,083761,Staff,0,13,30,30
1650319583835,MATH 20C,B01,083762,Staff,13,0,30,17
1650319583835,MATH 20C,B02,083763,Staff,28,0,30,2
1650319589865,MATH 20D,A01,083765,Staff,0,1,30,30
1650319589865,MATH 20D,A02,083766,Staff,7,0,30,23
1650319589865,MATH 20D,A03,083767,Staff,27,0,30,3
1650319595892,MATH 20E,A01,083771,Staff,5,0,30,25
1650319595892,MATH 20E,A02,083772,Staff,19,0,30,11
1650319595892,MATH 20E,B01,083773,Staff,0,0,30,30
1650319595892,MATH 20E,B02,083774,Staff,12,0,30,18
1650319601916,MATH 103A,A01,083777,Staff,0,12,30,30
1650319601916,MATH 103A,A02,083778,Staff,0,12,30,30
1650319601916,MATH 103A,B01,083779,Staff,0,11,30,30
1650319601916,MATH 103A,B02,083780,Staff,0,11,30,30
1650319607940,MATH 105,A01,085443,Staff,0,19,30,30
1650319613965,MATH 109,A01,083213,Anzaldo; Leesa B,0,5,30,30
1650319613965,MATH 109,A02,083214,Anzaldo; Leesa B,0,6,30,30
1650319613965,MATH 109,B01,083215,Anzaldo; Leesa B,0,4,30,30
1650319613965,MATH 109,B02,083216,Anzaldo; Leesa B,0,4,30,30
1650319620005,MATH 142A,A01,083219,Chow; Bennett,0,14,30,30
1650319620005,MATH 142A,A02,083220,Chow; Bennett,0,12,30,30
1650319620005,MATH 142A,B01,083221,Chow; Bennett,0,12,30,30
1650319620005,MATH 142A,B02,083222,Chow; Bennett,0,12,30,30
1650319626035,MATH 193A,A01,083224,Staff,0,5,30,30
1650319626035,MATH 193A,A02,083225,Staff,0,5,30,30
1650319626035,MATH 193A,A03,083781,Staff,0,2,30,30
1650319626035,MATH 193A,A04,083782,Staff,0,3,30,30
1650319632060,MATH 197,001,091859,McAuley; Julian John,9998,0,9999,1
1650319638130,COGS 9,A01,083615,Staff,0,15,60,60
1650319644155,COGS 11,A01,083617,Boyle; Mary E. T.,22,0,40,18
1650319650178,COGS 13,A01,083071,Staff,0,31,40,40
1650319656202,COGS 14A,A01,092681,Staff,0,17,100,100
1650319662226,COGS 14B,A01,083073,Cheng; Tzu-Han,0,10,50,50
1650319668345,COGS 17,A01,092677,Staff,25,0,75,50
1650319674368,COGS 100,A01,083619,Staff,0,23,60,60
1650319680392,COGS 101A,A01,083621,Davis; Joshua Daniel,0,22,60,60
1650319686426,COGS 101B,A01,091572,Staff,3,0,60,57
1650319692449,COGS 101C,A01,083625,Delgado; Tania,18,0,30,12
1650319698481,COGS 107A,A01,083627,Boyle; Mary E. T.,0,8,60,60
1650319704511,COGS 118A,A01,083075,Staff,5,0,60,55
1650319710535,CSE 3,A50,083646,Miranda; Gregory Joseph,21,0,38,17
1650319710535,CSE 3,A51,083647,Miranda; Gregory Joseph,37,0,37,0
1650319716559,CSE 8A,A50,083650,Miranda; Gregory Joseph,0,26,40,40
1650319722581,CSE 11,A01,083080,Cao; Yingjun,0,83,40,40
1650319728604,CSE 12,A01,083652,Staff,0,11,100,100
1650319734630,CSE 15L,A01,083654,Staff,0,1,50,50
1650319734630,CSE 15L,A02,083655,Staff,4,0,50,46
1650319740656,CSE 20,A01,083657,Staff,53,0,80,27
1650319746681,CSE 30,A01,083084,Eldon; John,0,74,40,40
1650319752703,CSE 100,A01,083659,Cao; Yingjun,0,65,50,50
1650319758729,CSE 134B,A01,083661,Powell; Thomas Allan,0,30,65,65
1650319764753,CSE 140,A01,083663,Staff,0,0,75,75
1650319770778,CSE 140L,A01,083088,Eldon; John,0,6,75,75
1650319776805,CSE 175,A01,083665,Kumar; Rakesh,8,0,25,17
1650319782826,CSE 190,A00,092507,Dubnov; Shlomo,14,0,20,6
1650319788860,ECE 45,A01,083139,Staff,0,16,40,40
1650319794883,ECE 65,A50,083695,Staff,0,5,30,30
1650319800905,ECE 109,A01,091882,Touri; Behrouz,42,0,70,28
1650319806935,ECE 180,A00,083140,Abi Samra; Nicholas Camill,23,0,30,7
1650319806935,ECE 180,B00,083141,Abi Samra; Nicholas Camill,5,0,30,25
1650319812960,MATH 10A,A01,083735,Patchell; Gregory David,9,0,30,21
1650319812960,MATH 10A,A02,083736,Patchell; Gregory David,28,0,30,2
1650319812960,MATH 10A,A03,083737,Patchell; Gregory David,26,0,30,4
1650319818985,MATH 10B,A01,083207,Staff,0,6,30,30
1650319818985,MATH 10B,A02,083208,Staff,0,6,30,30
1650319818985,MATH 10B,B01,083739,Staff,17,0,30,13
1650319818985,MATH 10B,B02,083740,Staff,28,0,30,2
1650319825011,MATH 18,A01,083743,Staff,5,0,30,25
1650319825011,MATH 18,A02,083744,Staff,26,0,30,4
1650319825011,MATH 18,A03,083745,Staff,22,0,30,8
1650319825011,MATH 18,A04,083746,Staff,27,0,30,3
1650319825011,MATH 18,B01,083748,Staff,0,11,30,30
1650319825011,MATH 18,B02,083749,Staff,0,10,30,30
1650319825011,MATH 18,B03,083750,Staff,1,10,30,29
1650319825011,MATH 18,B04,083751,Staff,0,10,30,30
1650319831039,MATH 20A,A01,083754,Staff,26,0,40,14
1650319837071,MATH 20B,A01,083756,Staff,0,6,30,30
1650319837071,MATH 20B,A02,083757,Staff,0,8,30,30
1650319843095,MATH 20C,A01,083760,Staff,0,13,30,30
1650319843095,MATH 20C,A02,083761,Staff,0,13,30,30
1650319843095,MATH 20C,B01,083762,Staff,13,0,30,17
1650319843095,MATH 20C,B02,083763,Staff,28,0,30,2
1650319849119,MATH 20D,A01,083765,Staff,0,1,30,30
1650319849119,MATH 20D,A02,083766,Staff,7,0,30,23
1650319849119,MATH 20D,A03,083767,Staff,27,0,30,3
1650319855143,MATH 20E,A01,083771,Staff,5,0,30,25
1650319855143,MATH 20E,A02,083772,Staff,19,0,30,11
1650319855143,MATH 20E,B01,083773,Staff,0,0,30,30
1650319855143,MATH 20E,B02,083774,Staff,12,0,30,18
1650319861172,MATH 103A,A01,083777,Staff,0,12,30,30
1650319861172,MATH 103A,A02,083778,Staff,0,12,30,30
1650319861172,MATH 103A,B01,083779,Staff,0,11,30,30
1650319861172,MATH 103A,B02,083780,Staff,0,11,30,30
1650319867206,MATH 105,A01,085443,Staff,0,19,30,30
1650319873239,MATH 109,A01,083213,Anzaldo; Leesa B,0,5,30,30
1650319873239,MATH 109,A02,083214,Anzaldo; Leesa B,0,6,30,30
1650319873239,MATH 109,B01,083215,Anzaldo; Leesa B,0,4,30,30
1650319873239,MATH 109,B02,083216,Anzaldo; Leesa B,0,4,30,30
1650319879264,MATH 142A,A01,083219,Chow; Bennett,0,14,30,30
1650319879264,MATH 142A,A02,083220,Chow; Bennett,0,12,30,30
1650319879264,MATH 142A,B01,083221,Chow; Bennett,0,12,30,30
1650319879264,MATH 142A,B02,083222,Chow; Bennett,0,12,30,30
1650319885291,MATH 193A,A01,083224,Staff,0,5,30,30
1650319885291,MATH 193A,A02,083225,Staff,0,5,30,30
1650319885291,MATH 193A,A03,083781,Staff,0,2,30,30
1650319885291,MATH 193A,A04,083782,Staff,0,3,30,30
1650319891318,MATH 197,001,091859,McAuley; Julian John,9998,0,9999,1
1650319897375,COGS 9,A01,083615,Staff,0,15,60,60
1650319903404,COGS 11,A01,083617,Boyle; Mary E. T.,22,0,40,18
1650319909430,COGS 13,A01,083071,Staff,0,31,40,40
1650319915466,COGS 14A,A01,092681,Staff,0,17,100,100
1650319921500,COGS 14B,A01,083073,Cheng; Tzu-Han,0,10,50,50
1650319927529,COGS 17,A01,092677,Staff,25,0,75,50
1650319933553,COGS 100,A01,083619,Staff,0,23,60,60
1650319939590,COGS 101A,A01,083621,Davis; Joshua Daniel,0,22,60,60
1650319945628,COGS 101B,A01,091572,Staff,3,0,60,57
1650319951662,COGS 101C,A01,083625,Delgado; Tania,18,0,30,12
1650319957690,COGS 107A,A01,083627,Boyle; Mary E. T.,0,8,60,60
1650319963717,COGS 118A,A01,083075,Staff,5,0,60,55
1650319969740,CSE 3,A50,083646,Miranda; Gregory Joseph,21,0,38,17
1650319969740,CSE 3,A51,083647,Miranda; Gregory Joseph,37,0,37,0
1650319975764,CSE 8A,A50,083650,Miranda; Gregory Joseph,0,26,40,40
1650319981795,CSE 11,A01,083080,Cao; Yingjun,0,83,40,40
1650319987818,CSE 12,A01,083652,Staff,0,11,100,100
1650319993848,CSE 15L,A01,083654,Staff,0,1,50,50
1650319993848,CSE 15L,A02,083655,Staff,4,0,50,46
1650319999870,CSE 20,A01,083657,Staff,53,0,80,27
1650320005897,CSE 30,A01,083084,Eldon; John,0,74,40,40
1650320011924,CSE 100,A01,083659,Cao; Yingjun,0,65,50,50
1650320017947,CSE 134B,A01,083661,Powell; Thomas Allan,0,30,65,65
1650320023971,CSE 140,A01,083663,Staff,0,0,75,75
1650320029993,CSE 140L,A01,083088,Eldon; John,0,6,75,75
1650320036030,CSE 175,A01,083665,Kumar; Rakesh,8,0,25,17
1650320042054,CSE 190,A00,092507,Dubnov; Shlomo,14,0,20,6
1650320048079,ECE 45,A01,083139,Staff,0,16,40,40
1650320054107,ECE 65,A50,083695,Staff,0,5,30,30
1650320060132,ECE 109,A01,091882,Touri; Behrouz,42,0,70,28
1650320066154,ECE 180,A00,083140,Abi Samra; Nicholas Camill,23,0,30,7
1650320066154,ECE 180,B00,083141,Abi Samra; Nicholas Camill,5,0,30,25
1650320072177,MATH 10A,A01,083735,Patchell; Gregory David,9,0,30,21
1650320072177,MATH 10A,A02,083736,Patchell; Gregory David,28,0,30,2
1650320072177,MATH 10A,A03,083737,Patchell; Gregory David,26,0,30,4
1650320078203,MATH 10B,A01,083207,Staff,0,6,30,30
1650320078203,MATH 10B,A02,083208,Staff,0,6,30,30
1650320078203,MATH 10B,B01,083739,Staff,17,0,30,13
1650320078203,MATH 10B,B02,083740,Staff,28,0,30,2
1650320084239,MATH 18,A01,083743,Staff,5,0,30,25
1650320084239,MATH 18,A02,083744,Staff,26,0,30,4
1650320084239,MATH 18,A03,083745,Staff,22,0,30,8
1650320084239,MATH 18,A04,083746,Staff,27,0,30,3
1650320084239,MATH 18,B01,083748,Staff,0,11,30,30
1650320084239,MATH 18,B02,083749,Staff,0,10,30,30
1650320084239,MATH 18,B03,083750,Staff,1,10,30,29
1650320084239,MATH 18,B04,083751,Staff,0,10,30,30
1650320090272,MATH 20A,A01,083754,Staff,26,0,40,14
1650320096307,MATH 20B,A01,083756,Staff,0,6,30,30
1650320096307,MATH 20B,A02,083757,Staff,0,8,30,30
1650320102331,MATH 20C,A01,083760,Staff,0,13,30,30
1650320102331,MATH 20C,A02,083761,Staff,0,13,30,30
1650320102331,MATH 20C,B01,083762,Staff,13,0,30,17
1650320102331,MATH 20C,B02,083763,Staff,28,0,30,2
1650320108354,MATH 20D,A01,083765,Staff,0,1,30,30
1650320108354,MATH 20D,A02,083766,Staff,7,0,30,23
1650320108354,MATH 20D,A03,083767,Staff,27,0,30,3
1650320114383,MATH 20E,A01,083771,Staff,5,0,30,25
1650320114383,MATH 20E,A02,083772,Staff,19,0,30,11
1650320114383,MATH 20E,B01,083773,Staff,0,0,30,30
1650320114383,MATH 20E,B02,083774,Staff,12,0,30,18
1650320120407,MATH 103A,A01,083777,Staff,0,12,30,30
1650320120407,MATH 103A,A02,083778,Staff,0,12,30,30
1650320120407,MATH 103A,B01,083779,Staff,0,11,30,30
1650320120407,MATH 103A,B02,083780,Staff,0,11,30,30
1650320126432,MATH 105,A01,085443,Staff,0,19,30,30
1650320132457,MATH 109,A01,083213,Anzaldo; Leesa B,0,5,30,30
1650320132457,MATH 109,A02,083214,Anzaldo; Leesa B,0,6,30,30
1650320132457,MATH 109,B01,083215,Anzaldo; Leesa B,0,4,30,30
1650320132457,MATH 109,B02,083216,Anzaldo; Leesa B,0,4,30,30
1650320138482,MATH 142A,A01,083219,Chow; Bennett,0,14,30,30
1650320138482,MATH 142A,A02,083220,Chow; Bennett,0,12,30,30
1650320138482,MATH 142A,B01,083221,Chow; Bennett,0,12,30,30
1650320138482,MATH 142A,B02,083222,Chow; Bennett,0,12,30,30
1650320144512,MATH 193A,A01,083224,Staff,0,5,30,30
1650320144512,MATH 193A,A02,083225,Staff,0,5,30,30
1650320144512,MATH 193A,A03,083781,Staff,0,2,30,30
1650320144512,MATH 193A,A04,083782,Staff,0,3,30,30
1650320150539,MATH 197,001,091859,McAuley; Julian John,9998,0,9999,1
1650320156598,COGS 9,A01,083615,Staff,0,15,60,60
1650320162626,COGS 11,A01,083617,Boyle; Mary E. T.,22,0,40,18
1650320168650,COGS 13,A01,083071,Staff,0,31,40,40
1650320174674,COGS 14A,A01,092681,Staff,0,17,100,100
1650320188211,COGS 14B,A01,083073,Cheng; Tzu-Han,0,10,50,50
1650320194235,COGS 17,A01,092677,Staff,25,0,75,50
1650320200260,COGS 100,A01,083619,Staff,0,23,60,60
1650320206304,COGS 101A,A01,083621,Davis; Joshua Daniel,0,22,60,60
1650320212330,COGS 101B,A01,091572,Staff,3,0,60,57
1650320218357,COGS 101C,A01,083625,Delgado; Tania,18,0,30,12
1650320224381,COGS 107A,A01,083627,Boyle; Mary E. T.,0,8,60,60
1650320230405,COGS 118A,A01,083075,Staff,5,0,60,55
1650320236430,CSE 3,A50,083646,Miranda; Gregory Joseph,21,0,38,17
1650320236430,CSE 3,A51,083647,Miranda; Gregory Joseph,37,0,37,0
1650320242461,CSE 8A,A50,083650,Miranda; Gregory Joseph,0,26,40,40
1650320248490,CSE 11,A01,083080,Cao; Yingjun,0,83,40,40
1650320254514,CSE 12,A01,083652,Staff,0,11,100,100
1650320260536,CSE 15L,A01,083654,Staff,0,1,50,50
1650320260536,CSE 15L,A02,083655,Staff,4,0,50,46
1650320266560,CSE 20,A01,083657,Staff,53,0,80,27
1650320272666,CSE 30,A01,083084,Eldon; John,0,74,40,40
1650320278693,CSE 100,A01,083659,Cao; Yingjun,0,65,50,50
1650320284716,CSE 134B,A01,083661,Powell; Thomas Allan,0,30,65,65
1650320290747,CSE 140,A01,083663,Staff,0,0,75,75
1650320296776,CSE 140L,A01,083088,Eldon; John,0,6,75,75
1650320302802,CSE 175,A01,083665,Kumar; Rakesh,8,0,25,17
1650320308829,CSE 190,A00,092507,Dubnov; Shlomo,14,0,20,6
1650320314854,ECE 45,A01,083139,Staff,0,16,40,40
1650320320891,ECE 65,A50,083695,Staff,0,5,30,30
1650320326918,ECE 109,A01,091882,Touri; Behrouz,42,0,70,28
1650320332941,ECE 180,A00,083140,Abi Samra; Nicholas Camill,23,0,30,7
1650320332941,ECE 180,B00,083141,Abi Samra; Nicholas Camill,5,0,30,25
1650320338966,MATH 10A,A01,083735,Patchell; Gregory David,8,0,30,22
1650320338966,MATH 10A,A02,083736,Patchell; Gregory David,28,0,30,2
1650320338966,MATH 10A,A03,083737,Patchell; Gregory David,26,0,30,4
1650320344996,MATH 10B,A01,083207,Staff,0,6,30,30
1650320344996,MATH 10B,A02,083208,Staff,0,6,30,30
1650320344996,MATH 10B,B01,083739,Staff,17,0,30,13
1650320344996,MATH 10B,B02,083740,Staff,28,0,30,2
1650320351021,MATH 18,A01,083743,Staff,5,0,30,25
1650320351021,MATH 18,A02,083744,Staff,26,0,30,4
1650320351021,MATH 18,A03,083745,Staff,22,0,30,8
1650320351021,MATH 18,A04,083746,Staff,27,0,30,3
1650320351021,MATH 18,B01,083748,Staff,0,11,30,30
1650320351021,MATH 18,B02,083749,Staff,0,10,30,30
1650320351021,MATH 18,B03,083750,Staff,1,10,30,29
1650320351021,MATH 18,B04,083751,Staff,0,10,30,30
1650320357048,MATH 20A,A01,083754,Staff,26,0,40,14
1650320363075,MATH 20B,A01,083756,Staff,0,7,30,30
1650320363075,MATH 20B,A02,083757,Staff,0,8,30,30
1650320369106,MATH 20C,A01,083760,Staff,0,13,30,30
1650320369106,MATH 20C,A02,083761,Staff,0,13,30,30
1650320369106,MATH 20C,B01,083762,Staff,13,0,30,17
1650320369106,MATH 20C,B02,083763,Staff,28,0,30,2
1650320375135,MATH 20D,A01,083765,Staff,0,1,30,30
1650320375135,MATH 20D,A02,083766,Staff,7,0,30,23
1650320375135,MATH 20D,A03,083767,Staff,27,0,30,3
1650320381159,MATH 20E,A01,083771,Staff,5,0,30,25
1650320381159,MATH 20E,A02,083772,Staff,19,0,30,11
1650320381159,MATH 20E,B01,083773,Staff,0,0,30,30
1650320381159,MATH 20E,B02,083774,Staff,12,0,30,18
1650320387181,MATH 103A,A01,083777,Staff,0,12,30,30
1650320387181,MATH 103A,A02,083778,Staff,0,12,30,30
1650320387181,MATH 103A,B01,083779,Staff,0,11,30,30
1650320387181,MATH 103A,B02,083780,Staff,0,11,30,30
1650320393207,MATH 105,A01,085443,Staff,0,19,30,30
1650320399238,MATH 109,A01,083213,Anzaldo; Leesa B,0,5,30,30
1650320399238,MATH 109,A02,083214,Anzaldo; Leesa B,0,6,30,30
1650320399238,MATH 109,B01,083215,Anzaldo; Leesa B,0,4,30,30
1650320399238,MATH 109,B02,083216,Anzaldo; Leesa B,0,4,30,30
1650320405262,MATH 142A,A01,083219,Chow; Bennett,0,14,30,30
1650320405262,MATH 142A,A02,083220,Chow; Bennett,0,12,30,30
1650320405262,MATH 142A,B01,083221,Chow; Bennett,0,12,30,30
1650320405262,MATH 142A,B02,083222,Chow; Bennett,0,12,30,30
1650320411286,MATH 193A,A01,083224,Staff,0,5,30,30
1650320411286,MATH 193A,A02,083225,Staff,0,5,30,30
1650320411286,MATH 193A,A03,083781,Staff,0,2,30,30
1650320411286,MATH 193A,A04,083782,Staff,0,3,30,30
1650320417318,MATH 197,001,091859,McAuley; Julian John,9998,0,9999,1
1650320423371,COGS 9,A01,083615,Staff,0,15,60,60
1650320429396,COGS 11,A01,083617,Boyle; Mary E. T.,22,0,40,18
1650320435424,COGS 13,A01,083071,Staff,0,31,40,40
1650320441445,COGS 14A,A01,092681,Staff,0,17,100,100
1650320447469,COGS 14B,A01,083073,Cheng; Tzu-Han,0,10,50,50
1650320453493,COGS 17,A01,092677,Staff,25,0,75,50
1650320459520,COGS 100,A01,083619,Staff,0,23,60,60
1650320465542,COGS 101A,A01,083621,Davis; Joshua Daniel,0,22,60,60
1650320471567,COGS 101B,A01,091572,Staff,3,0,60,57
1650320477602,COGS 101C,A01,083625,Delgado; Tania,18,0,30,12
1650320483627,COGS 107A,A01,083627,Boyle; Mary E. T.,0,8,60,60
1650320489653,COGS 118A,A01,083075,Staff,5,0,60,55
1650320495676,CSE 3,A50,083646,Miranda; Gregory Joseph,21,0,38,17
1650320495676,CSE 3,A51,083647,Miranda; Gregory Joseph,37,0,37,0
1650320501698,CSE 8A,A50,083650,Miranda; Gregory Joseph,0,26,40,40
1650320507724,CSE 11,A01,083080,Cao; Yingjun,0,83,40,40
1650320513752,CSE 12,A01,083652,Staff,0,11,100,100
1650320519775,CSE 15L,A01,083654,Staff,0,1,50,50
1650320519775,CSE 15L,A02,083655,Staff,4,0,50,46
1650320525799,CSE 20,A01,083657,Staff,53,0,80,27
1650320531822,CSE 30,A01,083084,Eldon; John,0,74,40,40
1650320537849,CSE 100,A01,083659,Cao; Yingjun,0,66,50,50
1650320543873,CSE 134B,A01,083661,Powell; Thomas Allan,0,30,65,65
1650320549896,CSE 140,A01,083663,Staff,0,0,75,75
1650320555921,CSE 140L,A01,083088,Eldon; John,0,6,75,75
1650320561945,CSE 175,A01,083665,Kumar; Rakesh,8,0,25,17
1650320567968,CSE 190,A00,092507,Dubnov; Shlomo,14,0,20,6
1650320574007,ECE 45,A01,083139,Staff,0,16,40,40
1650320580030,ECE 65,A50,083695,Staff,0,5,30,30
1650320586058,ECE 109,A01,091882,Touri; Behrouz,41,0,70,29
1650320592087,ECE 180,A00,083140,Abi Samra; Nicholas Camill,23,0,30,7
1650320592087,ECE 180,B00,083141,Abi Samra; Nicholas Camill,5,0,30,25
1650320598111,MATH 10A,A01,083735,Patchell; Gregory David,8,0,30,22
1650320598111,MATH 10A,A02,083736,Patchell; Gregory David,28,0,30,2
1650320598111,MATH 10A,A03,083737,Patchell; Gregory David,26,0,30,4
1650320604142,MATH 10B,A01,083207,Staff,0,6,30,30
1650320604142,MATH 10B,A02,083208,Staff,0,6,30,30
1650320604142,MATH 10B,B01,083739,Staff,17,0,30,13
1650320604142,MATH 10B,B02,083740,Staff,28,0,30,2
1650320610168,MATH 18,A01,083743,Staff,5,0,30,25
1650320610168,MATH 18,A02,083744,Staff,26,0,30,4
1650320610168,MATH 18,A03,083745,Staff,22,0,30,8
1650320610168,MATH 18,A04,083746,Staff,27,0,30,3
1650320610168,MATH 18,B01,083748,Staff,0,11,30,30
1650320610168,MATH 18,B02,083749,Staff,0,10,30,30
1650320610168,MATH 18,B03,083750,Staff,1,10,30,29
1650320610168,MATH 18,B04,083751,Staff,0,10,30,30
1650320616191,MATH 20A,A01,083754,Staff,26,0,40,14
1650320622214,MATH 20B,A01,083756,Staff,0,7,30,30
1650320622214,MATH 20B,A02,083757,Staff,0,8,30,30
1650320628237,MATH 20C,A01,083760,Staff,0,13,30,30
1650320628237,MATH 20C,A02,083761,Staff,0,13,30,30
1650320628237,MATH 20C,B01,083762,Staff,13,0,30,17
1650320628237,MATH 20C,B02,083763,Staff,28,0,30,2
1650320634261,MATH 20D,A01,083765,Staff,0,1,30,30
1650320634261,MATH 20D,A02,083766,Staff,7,0,30,23
1650320634261,MATH 20D,A03,083767,Staff,27,0,30,3
1650320640287,MATH 20E,A01,083771,Staff,5,0,30,25
1650320640287,MATH 20E,A02,083772,Staff,19,0,30,11
1650320640287,MATH 20E,B01,083773,Staff,0,0,30,30
1650320640287,MATH 20E,B02,083774,Staff,12,0,30,18
1650320646319,MATH 103A,A01,083777,Staff,0,12,30,30
1650320646319,MATH 103A,A02,083778,Staff,0,12,30,30
1650320646319,MATH 103A,B01,083779,Staff,0,11,30,30
1650320646319,MATH 103A,B02,083780,Staff,0,11,30,30
1650320652344,MATH 105,A01,085443,Staff,0,19,30,30
1650320658381,MATH 109,A01,083213,Anzaldo; Leesa B,0,5,30,30
1650320658381,MATH 109,A02,083214,Anzaldo; Leesa B,0,6,30,30
1650320658381,MATH 109,B01,083215,Anzaldo; Leesa B,0,4,30,30
1650320658381,MATH 109,B02,083216,Anzaldo; Leesa B,0,4,30,30
1650320664406,MATH 142A,A01,083219,Chow; Bennett,0,14,30,30
1650320664406,MATH 142A,A02,083220,Chow; Bennett,0,12,30,30
1650320664406,MATH 142A,B01,083221,Chow; Bennett,0,12,30,30
1650320664406,MATH 142A,B02,083222,Chow; Bennett,0,12,30,30
1650320670429,MATH 193A,A01,083224,Staff,0,5,30,30
1650320670429,MATH 193A,A02,083225,Staff,0,5,30,30
1650320670429,MATH 193A,A03,083781,Staff,0,2,30,30
1650320670429,MATH 193A,A04,083782,Staff,0,3,30,30
1650320676455,MATH 197,001,091859,McAuley; Julian John,9998,0,9999,1
1650320682528,COGS 9,A01,083615,Staff,0,15,60,60
1650320688550,COGS 11,A01,083617,Boyle; Mary E. T.,22,0,40,18
1650320694574,COGS 13,A01,083071,Staff,0,31,40,40
1650320700601,COGS 14A,A01,092681,Staff,0,17,100,100
1650320706625,COGS 14B,A01,083073,Cheng; Tzu-Han,0,10,50,50
1650320712664,COGS 17,A01,092677,Staff,25,0,75,50
1650320718687,COGS 100,A01,083619,Staff,0,23,60,60
1650320724713,COGS 101A,A01,083621,Davis; Joshua Daniel,0,22,60,60
1650320730736,COGS 101B,A01,091572,Staff,3,0,60,57
1650320736759,COGS 101C,A01,083625,Delgado; Tania,18,0,30,12
1650320742781,COGS 107A,A01,083627,Boyle; Mary E. T.,0,8,60,60
1650320748803,COGS 118A,A01,083075,Staff,5,0,60,55
1650320754826,CSE 3,A50,083646,Miranda; Gregory Joseph,21,0,38,17
1650320754826,CSE 3,A51,083647,Miranda; Gregory Joseph,37,0,37,0
1650320760852,CSE 8A,A50,083650,Miranda; Gregory Joseph,0,26,40,40
1650320766888,CSE 11,A01,083080,Cao; Yingjun,0,83,40,40
1650320772912,CSE 12,A01,083652,Staff,0,11,100,100
1650320778937,CSE 15L,A01,083654,Staff,0,1,50,50
1650320778937,CSE 15L,A02,083655,Staff,4,0,50,46
1650320784959,CSE 20,A01,083657,Staff,53,0,80,27
1650320790982,CSE 30,A01,083084,Eldon; John,0,74,40,40
1650320797024,CSE 100,A01,083659,Cao; Yingjun,0,66,50,50
1650320803048,CSE 134B,A01,083661,Powell; Thomas Allan,0,30,65,65
1650320809070,CSE 140,A01,083663,Staff,0,0,75,75
1650320815093,CSE 140L,A01,083088,Eldon; John,0,6,75,75
1650320821121,CSE 175,A01,083665,Kumar; Rakesh,8,0,25,17
1650320827153,CSE 190,A00,092507,Dubnov; Shlomo,14,0,20,6
1650320833181,ECE 45,A01,083139,Staff,0,16,40,40
1650320839203,ECE 65,A50,083695,Staff,0,5,30,30
1650320845228,ECE 109,A01,091882,Touri; Behrouz,41,0,70,29
1650320851257,ECE 180,A00,083140,Abi Samra; Nicholas Camill,23,0,30,7
1650320851257,ECE 180,B00,083141,Abi Samra; Nicholas Camill,5,0,30,25
1650320857282,MATH 10A,A01,083735,Patchell; Gregory David,8,0,30,22
1650320857282,MATH 10A,A02,083736,Patchell; Gregory David,28,0,30,2
1650320857282,MATH 10A,A03,083737,Patchell; Gregory David,26,0,30,4
1650320863314,MATH 10B,A01,083207,Staff,0,6,30,30
1650320863314,MATH 10B,A02,083208,Staff,0,6,30,30
1650320863314,MATH 10B,B01,083739,Staff,17,0,30,13
1650320863314,MATH 10B,B02,083740,Staff,28,0,30,2
1650320869435,MATH 18,A01,083743,Staff,5,0,30,25
1650320869435,MATH 18,A02,083744,Staff,26,0,30,4
1650320869435,MATH 18,A03,083745,Staff,22,0,30,8
1650320869435,MATH 18,A04,083746,Staff,27,0,30,3
1650320869435,MATH 18,B01,083748,Staff,0,12,30,30
1650320869435,MATH 18,B02,083749,Staff,0,10,30,30
1650320869435,MATH 18,B03,083750,Staff,1,10,30,29
1650320869435,MATH 18,B04,083751,Staff,0,10,30,30
1650320875469,MATH 20A,A01,083754,Staff,26,0,40,14
1650320881504,MATH 20B,A01,083756,Staff,0,7,30,30
1650320881504,MATH 20B,A02,083757,Staff,0,8,30,30
1650320887533,MATH 20C,A01,083760,Staff,0,13,30,30
1650320887533,MATH 20C,A02,083761,Staff,0,13,30,30
1650320887533,MATH 20C,B01,083762,Staff,13,0,30,17
1650320887533,MATH 20C,B02,083763,Staff,28,0,30,2
1650320893560,MATH 20D,A01,083765,Staff,0,1,30,30
1650320893560,MATH 20D,A02,083766,Staff,7,0,30,23
1650320893560,MATH 20D,A03,083767,Staff,27,0,30,3
1650320899588,MATH 20E,A01,083771,Staff,5,0,30,25
1650320899588,MATH 20E,A02,083772,Staff,19,0,30,11
1650320899588,MATH 20E,B01,083773,Staff,0,0,30,30
1650320899588,MATH 20E,B02,083774,Staff,12,0,30,18
1650320905624,MATH 103A,A01,083777,Staff,0,12,30,30
1650320905624,MATH 103A,A02,083778,Staff,0,12,30,30
1650320905624,MATH 103A,B01,083779,Staff,0,11,30,30
1650320905624,MATH 103A,B02,083780,Staff,0,11,30,30
1650320911650,MATH 105,A01,085443,Staff,0,19,30,30
1650320917699,MATH 109,A01,083213,Anzaldo; Leesa B,0,5,30,30
1650320917699,MATH 109,A02,083214,Anzaldo; Leesa B,0,6,30,30
1650320917699,MATH 109,B01,083215,Anzaldo; Leesa B,0,4,30,30
1650320917699,MATH 109,B02,083216,Anzaldo; Leesa B,0,4,30,30
1650320923722,MATH 142A,A01,083219,Chow; Bennett,0,14,30,30
1650320923722,MATH 142A,A02,083220,Chow; Bennett,0,12,30,30
1650320923722,MATH 142A,B01,083221,Chow; Bennett,0,12,30,30
1650320923722,MATH 142A,B02,083222,Chow; Bennett,0,12,30,30
1650320929757,MATH 193A,A01,083224,Staff,0,5,30,30
1650320929757,MATH 193A,A02,083225,Staff,0,5,30,30
1650320929757,MATH 193A,A03,083781,Staff,0,2,30,30
1650320929757,MATH 193A,A04,083782,Staff,0,3,30,30
1650320935782,MATH 197,001,091859,McAuley; Julian John,9998,0,9999,1
1650320941832,COGS 9,A01,083615,Staff,0,15,60,60
1650320947868,COGS 11,A01,083617,Boyle; Mary E. T.,22,0,40,18
1650320953895,COGS 13,A01,083071,Staff,0,31,40,40
1650320959921,COGS 14A,A01,092681,Staff,0,17,100,100
1650320965947,COGS 14B,A01,083073,Cheng; Tzu-Han,0,10,50,50
1650320971974,COGS 17,A01,092677,Staff,25,0,75,50
1650320978012,COGS 100,A01,083619,Staff,0,23,60,60
1650320984033,COGS 101A,A01,083621,Davis; Joshua Daniel,0,22,60,60
1650320990063,COGS 101B,A01,091572,Staff,3,0,60,57
1650320996087,COGS 101C,A01,083625,Delgado; Tania,18,0,30,12
1650321002111,COGS 107A,A01,083627,Boyle; Mary E. T.,0,8,60,60
1650321008136,COGS 118A,A01,083075,Staff,5,0,60,55
1650321014160,CSE 3,A50,083646,Miranda; Gregory Joseph,21,0,38,17
1650321014160,CSE 3,A51,083647,Miranda; Gregory Joseph,37,0,37,0
1650321020190,CSE 8A,A50,083650,Miranda; Gregory Joseph,0,26,40,40
1650321026227,CSE 11,A01,083080,Cao; Yingjun,0,84,40,40
1650321032250,CSE 12,A01,083652,Staff,0,11,100,100
1650321038276,CSE 15L,A01,083654,Staff,0,1,50,50
1650321038276,CSE 15L,A02,083655,Staff,4,0,50,46
1650321044312,CSE 20,A01,083657,Staff,53,0,80,27
1650321050342,CSE 30,A01,083084,Eldon; John,0,74,40,40
1650321056366,CSE 100,A01,083659,Cao; Yingjun,0,66,50,50
1650321062390,CSE 134B,A01,083661,Powell; Thomas Allan,0,30,65,65
1650321068414,CSE 140,A01,083663,Staff,0,0,75,75
1650321074438,CSE 140L,A01,083088,Eldon; John,0,6,75,75
1650321080465,CSE 175,A01,083665,Kumar; Rakesh,8,0,25,17
1650321086492,CSE 190,A00,092507,Dubnov; Shlomo,14,0,20,6
1650321092519,ECE 45,A01,083139,Staff,0,16,40,40
1650321098549,ECE 65,A50,083695,Staff,0,5,30,30
1650321104572,ECE 109,A01,091882,Touri; Behrouz,41,0,70,29
1650321110598,ECE 180,A00,083140,Abi Samra; Nicholas Camill,23,0,30,7
1650321110598,ECE 180,B00,083141,Abi Samra; Nicholas Camill,5,0,30,25
1650321116627,MATH 10A,A01,083735,Patchell; Gregory David,8,0,30,22
1650321116627,MATH 10A,A02,083736,Patchell; Gregory David,28,0,30,2
1650321116627,MATH 10A,A03,083737,Patchell; Gregory David,26,0,30,4
1650321122655,MATH 10B,A01,083207,Staff,0,6,30,30
1650321122655,MATH 10B,A02,083208,Staff,0,6,30,30
1650321122655,MATH 10B,B01,083739,Staff,17,0,30,13
1650321122655,MATH 10B,B02,083740,Staff,28,0,30,2
1650321128678,MATH 18,A01,083743,Staff,5,0,30,25
1650321128678,MATH 18,A02,083744,Staff,26,0,30,4
1650321128678,MATH 18,A03,083745,Staff,22,0,30,8
1650321128678,MATH 18,A04,083746,Staff,27,0,30,3
1650321128678,MATH 18,B01,083748,Staff,0,12,30,30
1650321128678,MATH 18,B02,083749,Staff,0,10,30,30
1650321128678,MATH 18,B03,083750,Staff,1,10,30,29
1650321128678,MATH 18,B04,083751,Staff,0,10,30,30
1650321134705,MATH 20A,A01,083754,Staff,26,0,40,14
1650321140736,MATH 20B,A01,083756,Staff,0,7,30,30
1650321140736,MATH 20B,A02,083757,Staff,0,8,30,30
1650321146766,MATH 20C,A01,083760,Staff,0,13,30,30
1650321146766,MATH 20C,A02,083761,Staff,0,13,30,30
1650321146766,MATH 20C,B01,083762,Staff,13,0,30,17
1650321146766,MATH 20C,B02,083763,Staff,28,0,30,2
1650321152791,MATH 20D,A01,083765,Staff,0,1,30,30
1650321152791,MATH 20D,A02,083766,Staff,7,0,30,23
1650321152791,MATH 20D,A03,083767,Staff,27,0,30,3
1650321158815,MATH 20E,A01,083771,Staff,5,0,30,25
1650321158815,MATH 20E,A02,083772,Staff,19,0,30,11
1650321158815,MATH 20E,B01,083773,Staff,0,0,30,30
1650321158815,MATH 20E,B02,083774,Staff,12,0,30,18
1650321164843,MATH 103A,A01,083777,Staff,0,12,30,30
1650321164843,MATH 103A,A02,083778,Staff,0,12,30,30
1650321164843,MATH 103A,B01,083779,Staff,0,11,30,30
1650321164843,MATH 103A,B02,083780,Staff,0,11,30,30
1650321170867,MATH 105,A01,085443,Staff,0,19,30,30
1650321176892,MATH 109,A01,083213,Anzaldo; Leesa B,0,5,30,30
1650321176892,MATH 109,A02,083214,Anzaldo; Leesa B,0,6,30,30
1650321176892,MATH 109,B01,083215,Anzaldo; Leesa B,0,4,30,30
1650321176892,MATH 109,B02,083216,Anzaldo; Leesa B,0,4,30,30
1650321182915,MATH 142A,A01,083219,Chow; Bennett,0,14,30,30
1650321182915,MATH 142A,A02,083220,Chow; Bennett,0,12,30,30
1650321182915,MATH 142A,B01,083221,Chow; Bennett,0,12,30,30
1650321182915,MATH 142A,B02,083222,Chow; Bennett,0,12,30,30
1650321188938,MATH 193A,A01,083224,Staff,0,5,30,30
1650321188938,MATH 193A,A02,083225,Staff,0,5,30,30
1650321188938,MATH 193A,A03,083781,Staff,0,2,30,30
1650321188938,MATH 193A,A04,083782,Staff,0,3,30,30
1650321194962,MATH 197,001,091859,McAuley; Julian John,9998,0,9999,1
1650321201016,COGS 9,A01,083615,Staff,0,15,60,60
1650321207048,COGS 11,A01,083617,Boyle; Mary E. T.,22,0,40,18
1650321213072,COGS 13,A01,083071,Staff,0,31,40,40
1650321219107,COGS 14A,A01,092681,Staff,0,17,100,100
1650321225131,COGS 14B,A01,083073,Cheng; Tzu-Han,0,10,50,50
1650321231161,COGS 17,A01,092677,Staff,25,0,75,50
1650321237189,COGS 100,A01,083619,Staff,0,23,60,60
1650321243216,COGS 101A,A01,083621,Davis; Joshua Daniel,0,22,60,60
1650321249239,COGS 101B,A01,091572,Staff,3,0,60,57
1650321255262,COGS 101C,A01,083625,Delgado; Tania,18,0,30,12
1650321261292,COGS 107A,A01,083627,Boyle; Mary E. T.,0,8,60,60
1650321267316,COGS 118A,A01,083075,Staff,5,0,60,55
1650321273340,CSE 3,A50,083646,Miranda; Gregory Joseph,21,0,38,17
1650321273340,CSE 3,A51,083647,Miranda; Gregory Joseph,37,0,37,0
1650321279365,CSE 8A,A50,083650,Miranda; Gregory Joseph,0,26,40,40
1650321285392,CSE 11,A01,083080,Cao; Yingjun,0,84,40,40
1650321291416,CSE 12,A01,083652,Staff,0,11,100,100
1650321297446,CSE 15L,A01,083654,Staff,0,1,50,50
1650321297446,CSE 15L,A02,083655,Staff,4,0,50,46
1650321303472,CSE 20,A01,083657,Staff,53,0,80,27
1650321309506,CSE 30,A01,083084,Eldon; John,0,74,40,40
1650321315529,CSE 100,A01,083659,Cao; Yingjun,0,66,50,50
1650321321552,CSE 134B,A01,083661,Powell; Thomas Allan,0,30,65,65
1650321327580,CSE 140,A01,083663,Staff,0,0,75,75
1650321333603,CSE 140L,A01,083088,Eldon; John,0,6,75,75
1650321339633,CSE 175,A01,083665,Kumar; Rakesh,8,0,25,17
1650321345660,CSE 190,A00,092507,Dubnov; Shlomo,14,0,20,6
1650321351683,ECE 45,A01,083139,Staff,0,16,40,40
1650321357731,ECE 65,A50,083695,Staff,0,5,30,30
1650321363761,ECE 109,A01,091882,Touri; Behrouz,41,0,70,29
1650321369786,ECE 180,A00,083140,Abi Samra; Nicholas Camill,23,0,30,7
1650321369786,ECE 180,B00,083141,Abi Samra; Nicholas Camill,5,0,30,25
1650321375810,MATH 10A,A01,083735,Patchell; Gregory David,8,0,30,22
1650321375810,MATH 10A,A02,083736,Patchell; Gregory David,28,0,30,2
1650321375810,MATH 10A,A03,083737,Patchell; Gregory David,26,0,30,4
1650321381835,MATH 10B,A01,083207,Staff,0,6,30,30
1650321381835,MATH 10B,A02,083208,Staff,0,6,30,30
1650321381835,MATH 10B,B01,083739,Staff,17,0,30,13
1650321381835,MATH 10B,B02,083740,Staff,28,0,30,2
1650321387868,MATH 18,A01,083743,Staff,5,0,30,25
1650321387868,MATH 18,A02,083744,Staff,26,0,30,4
1650321387868,MATH 18,A03,083745,Staff,22,0,30,8
1650321387868,MATH 18,A04,083746,Staff,27,0,30,3
1650321387868,MATH 18,B01,083748,Staff,0,12,30,30
1650321387868,MATH 18,B02,083749,Staff,0,10,30,30
1650321387868,MATH 18,B03,083750,Staff,1,10,30,29
1650321387868,MATH 18,B04,083751,Staff,0,10,30,30
1650321393893,MATH 20A,A01,083754,Staff,26,0,40,14
1650321399920,MATH 20B,A01,083756,Staff,0,7,30,30
1650321399920,MATH 20B,A02,083757,Staff,0,8,30,30
1650321405946,MATH 20C,A01,083760,Staff,0,13,30,30
1650321405946,MATH 20C,A02,083761,Staff,0,13,30,30
1650321405946,MATH 20C,B01,083762,Staff,13,0,30,17
1650321405946,MATH 20C,B02,083763,Staff,28,0,30,2
1650321411974,MATH 20D,A01,083765,Staff,0,1,30,30
1650321411974,MATH 20D,A02,083766,Staff,7,0,30,23
1650321411974,MATH 20D,A03,083767,Staff,27,0,30,3
1650321418002,MATH 20E,A01,083771,Staff,5,0,30,25
1650321418002,MATH 20E,A02,083772,Staff,19,0,30,11
1650321418002,MATH 20E,B01,083773,Staff,0,0,30,30
1650321418002,MATH 20E,B02,083774,Staff,12,0,30,18
1650321424031,MATH 103A,A01,083777,Staff,0,12,30,30
1650321424031,MATH 103A,A02,083778,Staff,0,12,30,30
1650321424031,MATH 103A,B01,083779,Staff,0,11,30,30
1650321424031,MATH 103A,B02,083780,Staff,0,11,30,30
1650321430055,MATH 105,A01,085443,Staff,0,19,30,30
1650321436088,MATH 109,A01,083213,Anzaldo; Leesa B,0,5,30,30
1650321436088,MATH 109,A02,083214,Anzaldo; Leesa B,0,6,30,30
1650321436088,MATH 109,B01,083215,Anzaldo; Leesa B,0,4,30,30
1650321436088,MATH 109,B02,083216,Anzaldo; Leesa B,0,4,30,30
1650321442110,MATH 142A,A01,083219,Chow; Bennett,0,14,30,30
1650321442110,MATH 142A,A02,083220,Chow; Bennett,0,12,30,30
1650321442110,MATH 142A,B01,083221,Chow; Bennett,0,12,30,30
1650321442110,MATH 142A,B02,083222,Chow; Bennett,0,12,30,30
1650321448137,MATH 193A,A01,083224,Staff,0,5,30,30
1650321448137,MATH 193A,A02,083225,Staff,0,5,30,30
1650321448137,MATH 193A,A03,083781,Staff,0,2,30,30
1650321448137,MATH 193A,A04,083782,Staff,0,3,30,30
1650321454168,MATH 197,001,091859,McAuley; Julian John,9998,0,9999,1
1650321460307,COGS 9,A01,083615,Staff,0,15,60,60
1650321466332,COGS 11,A01,083617,Boyle; Mary E. T.,22,0,40,18
1650321472354,COGS 13,A01,083071,Staff,0,31,40,40
1650321478380,COGS 14A,A01,092681,Staff,0,17,100,100
1650321484403,COGS 14B,A01,083073,Cheng; Tzu-Han,0,10,50,50
1650321490435,COGS 17,A01,092677,Staff,25,0,75,50
1650321496466,COGS 100,A01,083619,Staff,0,23,60,60
1650321502498,COGS 101A,A01,083621,Davis; Joshua Daniel,0,22,60,60
1650321508523,COGS 101B,A01,091572,Staff,3,0,60,57
1650321514546,COGS 101C,A01,083625,Delgado; Tania,18,0,30,12
1650321520569,COGS 107A,A01,083627,Boyle; Mary E. T.,0,8,60,60
1650321526597,COGS 118A,A01,083075,Staff,5,0,60,55
1650321532624,CSE 3,A50,083646,Miranda; Gregory Joseph,21,0,38,17
1650321532624,CSE 3,A51,083647,Miranda; Gregory Joseph,37,0,37,0
1650321538649,CSE 8A,A50,083650,Miranda; Gregory Joseph,0,26,40,40
1650321544681,CSE 11,A01,083080,Cao; Yingjun,0,84,40,40
1650321550705,CSE 12,A01,083652,Staff,0,11,100,100
1650321556731,CSE 15L,A01,083654,Staff,0,1,50,50
1650321556731,CSE 15L,A02,083655,Staff,4,0,50,46
1650321562753,CSE 20,A01,083657,Staff,53,0,80,27
1650321568780,CSE 30,A01,083084,Eldon; John,0,74,40,40
1650321574805,CSE 100,A01,083659,Cao; Yingjun,0,66,50,50
1650321580838,CSE 134B,A01,083661,Powell; Thomas Allan,0,30,65,65
1650321586864,CSE 140,A01,083663,Staff,0,0,75,75
1650321592890,CSE 140L,A01,083088,Eldon; John,0,6,75,75
1650321598917,CSE 175,A01,083665,Kumar; Rakesh,8,0,25,17
1650321604942,CSE 190,A00,092507,Dubnov; Shlomo,14,0,20,6
1650321610966,ECE 45,A01,083139,Staff,0,16,40,40
1650321616993,ECE 65,A50,083695,Staff,0,5,30,30
1650321623018,ECE 109,A01,091882,Touri; Behrouz,41,0,70,29
1650321629046,ECE 180,A00,083140,Abi Samra; Nicholas Camill,23,0,30,7
1650321629046,ECE 180,B00,083141,Abi Samra; Nicholas Camill,5,0,30,25
1650321635070,MATH 10A,A01,083735,Patchell; Gregory David,8,0,30,22
1650321635070,MATH 10A,A02,083736,Patchell; Gregory David,28,0,30,2
1650321635070,MATH 10A,A03,083737,Patchell; Gregory David,26,0,30,4
1650321641096,MATH 10B,A01,083207,Staff,0,6,30,30
1650321641096,MATH 10B,A02,083208,Staff,0,6,30,30
1650321641096,MATH 10B,B01,083739,Staff,17,0,30,13
1650321641096,MATH 10B,B02,083740,Staff,28,0,30,2
1650321647122,MATH 18,A01,083743,Staff,5,0,30,25
1650321647122,MATH 18,A02,083744,Staff,26,0,30,4
1650321647122,MATH 18,A03,083745,Staff,22,0,30,8
1650321647122,MATH 18,A04,083746,Staff,27,0,30,3
1650321647122,MATH 18,B01,083748,Staff,0,12,30,30
1650321647122,MATH 18,B02,083749,Staff,0,10,30,30
1650321647122,MATH 18,B03,083750,Staff,1,10,30,29
1650321647122,MATH 18,B04,083751,Staff,0,10,30,30
1650321653149,MATH 20A,A01,083754,Staff,26,0,40,14
1650321659173,MATH 20B,A01,083756,Staff,0,7,30,30
1650321659173,MATH 20B,A02,083757,Staff,0,8,30,30
1650321665197,MATH 20C,A01,083760,Staff,0,13,30,30
1650321665197,MATH 20C,A02,083761,Staff,0,13,30,30
1650321665197,MATH 20C,B01,083762,Staff,13,0,30,17
1650321665197,MATH 20C,B02,083763,Staff,28,0,30,2
1650321671223,MATH 20D,A01,083765,Staff,0,1,30,30
1650321671223,MATH 20D,A02,083766,Staff,7,0,30,23
1650321671223,MATH 20D,A03,083767,Staff,27,0,30,3
1650321677257,MATH 20E,A01,083771,Staff,5,0,30,25
1650321677257,MATH 20E,A02,083772,Staff,19,0,30,11
1650321677257,MATH 20E,B01,083773,Staff,0,0,30,30
1650321677257,MATH 20E,B02,083774,Staff,12,0,30,18
1650321683282,MATH 103A,A01,083777,Staff,0,12,30,30
1650321683282,MATH 103A,A02,083778,Staff,0,12,30,30
1650321683282,MATH 103A,B01,083779,Staff,0,11,30,30
1650321683282,MATH 103A,B02,083780,Staff,0,11,30,30
1650321689307,MATH 105,A01,085443,Staff,0,19,30,30
1650321695336,MATH 109,A01,083213,Anzaldo; Leesa B,0,5,30,30
1650321695336,MATH 109,A02,083214,Anzaldo; Leesa B,0,6,30,30
1650321695336,MATH 109,B01,083215,Anzaldo; Leesa B,0,4,30,30
1650321695336,MATH 109,B02,083216,Anzaldo; Leesa B,0,4,30,30
1650321701368,MATH 142A,A01,083219,Chow; Bennett,0,14,30,30
1650321701368,MATH 142A,A02,083220,Chow; Bennett,0,12,30,30
1650321701368,MATH 142A,B01,083221,Chow; Bennett,0,12,30,30
1650321701368,MATH 142A,B02,083222,Chow; Bennett,0,12,30,30
1650321707392,MATH 193A,A01,083224,Staff,0,5,30,30
1650321707392,MATH 193A,A02,083225,Staff,0,5,30,30
1650321707392,MATH 193A,A03,083781,Staff,0,2,30,30
1650321707392,MATH 193A,A04,083782,Staff,0,3,30,30
1650321713418,MATH 197,001,091859,McAuley; Julian John,9998,0,9999,1
1650321719533,COGS 9,A01,083615,Staff,0,15,60,60
1650321725566,COGS 11,A01,083617,Boyle; Mary E. T.,22,0,40,18
1650321731590,COGS 13,A01,083071,Staff,0,31,40,40
1650321737627,COGS 14A,A01,092681,Staff,0,17,100,100
1650321743654,COGS 14B,A01,083073,Cheng; Tzu-Han,0,10,50,50
1650321749681,COGS 17,A01,092677,Staff,25,0,75,50
1650321755723,COGS 100,A01,083619,Staff,0,23,60,60
1650321761747,COGS 101A,A01,083621,Davis; Joshua Daniel,1,22,60,59
1650321767772,COGS 101B,A01,091572,Staff,2,0,60,58
1650321773822,COGS 101C,A01,083625,Delgado; Tania,18,0,30,12
1650321779850,COGS 107A,A01,083627,Boyle; Mary E. T.,0,8,60,60
1650321785874,COGS 118A,A01,083075,Staff,5,0,60,55
1650321791905,CSE 3,A50,083646,Miranda; Gregory Joseph,21,0,38,17
1650321791905,CSE 3,A51,083647,Miranda; Gregory Joseph,37,0,37,0
1650321797936,CSE 8A,A50,083650,Miranda; Gregory Joseph,0,26,40,40
1650321803962,CSE 11,A01,083080,Cao; Yingjun,0,83,40,40
1650321809995,CSE 12,A01,083652,Staff,0,10,100,100
1650321816022,CSE 15L,A01,083654,Staff,0,1,50,50
1650321816022,CSE 15L,A02,083655,Staff,4,0,50,46
1650321822053,CSE 20,A01,083657,Staff,53,0,80,27
1650321828078,CSE 30,A01,083084,Eldon; John,0,74,40,40
1650321834103,CSE 100,A01,083659,Cao; Yingjun,0,66,50,50
1650321840125,CSE 134B,A01,083661,Powell; Thomas Allan,0,30,65,65
1650321846158,CSE 140,A01,083663,Staff,0,0,75,75
1650321852180,CSE 140L,A01,083088,Eldon; John,0,6,75,75
1650321858204,CSE 175,A01,083665,Kumar; Rakesh,8,0,25,17
1650321864228,CSE 190,A00,092507,Dubnov; Shlomo,14,0,20,6
1650321870256,ECE 45,A01,083139,Staff,0,16,40,40
1650321876277,ECE 65,A50,083695,Staff,0,5,30,30
1650321882309,ECE 109,A01,091882,Touri; Behrouz,41,0,70,29
1650321888336,ECE 180,A00,083140,Abi Samra; Nicholas Camill,23,0,30,7
1650321888336,ECE 180,B00,083141,Abi Samra; Nicholas Camill,5,0,30,25
1650321894367,MATH 10A,A01,083735,Patchell; Gregory David,8,0,30,22
1650321894367,MATH 10A,A02,083736,Patchell; Gregory David,28,0,30,2
1650321894367,MATH 10A,A03,083737,Patchell; Gregory David,26,0,30,4
1650321900393,MATH 10B,A01,083207,Staff,0,6,30,30
1650321900393,MATH 10B,A02,083208,Staff,0,6,30,30
1650321900393,MATH 10B,B01,083739,Staff,17,0,30,13
1650321900393,MATH 10B,B02,083740,Staff,28,0,30,2
1650321906423,MATH 18,A01,083743,Staff,5,0,30,25
1650321906423,MATH 18,A02,083744,Staff,26,0,30,4
1650321906423,MATH 18,A03,083745,Staff,22,0,30,8
1650321906423,MATH 18,A04,083746,Staff,27,0,30,3
1650321906423,MATH 18,B01,083748,Staff,0,12,30,30
1650321906423,MATH 18,B02,083749,Staff,0,10,30,30
1650321906423,MATH 18,B03,083750,Staff,1,10,30,29
1650321906423,MATH 18,B04,083751,Staff,0,10,30,30
1650321912449,MATH 20A,A01,083754,Staff,26,0,40,14
1650321918487,MATH 20B,A01,083756,Staff,0,7,30,30
1650321918487,MATH 20B,A02,083757,Staff,0,8,30,30
1650321924514,MATH 20C,A01,083760,Staff,0,13,30,30
1650321924514,MATH 20C,A02,083761,Staff,0,13,30,30
1650321924514,MATH 20C,B01,083762,Staff,13,0,30,17
1650321924514,MATH 20C,B02,083763,Staff,28,0,30,2
1650321930540,MATH 20D,A01,083765,Staff,0,1,30,30
1650321930540,MATH 20D,A02,083766,Staff,7,0,30,23
1650321930540,MATH 20D,A03,083767,Staff,27,0,30,3
1650321936562,MATH 20E,A01,083771,Staff,5,0,30,25
1650321936562,MATH 20E,A02,083772,Staff,19,0,30,11
1650321936562,MATH 20E,B01,083773,Staff,0,0,30,30
1650321936562,MATH 20E,B02,083774,Staff,12,0,30,18
1650321942588,MATH 103A,A01,083777,Staff,0,13,30,30
1650321942588,MATH 103A,A02,083778,Staff,0,12,30,30
1650321942588,MATH 103A,B01,083779,Staff,0,11,30,30
1650321942588,MATH 103A,B02,083780,Staff,0,11,30,30
1650321948611,MATH 105,A01,085443,Staff,0,19,30,30
1650321954634,MATH 109,A01,083213,Anzaldo; Leesa B,0,5,30,30
1650321954634,MATH 109,A02,083214,Anzaldo; Leesa B,0,6,30,30
1650321954634,MATH 109,B01,083215,Anzaldo; Leesa B,0,4,30,30
1650321954634,MATH 109,B02,083216,Anzaldo; Leesa B,0,4,30,30
1650321960665,MATH 142A,A01,083219,Chow; Bennett,0,14,30,30
1650321960665,MATH 142A,A02,083220,Chow; Bennett,0,12,30,30
1650321960665,MATH 142A,B01,083221,Chow; Bennett,0,12,30,30
1650321960665,MATH 142A,B02,083222,Chow; Bennett,0,12,30,30
1650321966691,MATH 193A,A01,083224,Staff,0,5,30,30
1650321966691,MATH 193A,A02,083225,Staff,0,5,30,30
1650321966691,MATH 193A,A03,083781,Staff,0,2,30,30
1650321966691,MATH 193A,A04,083782,Staff,0,3,30,30
1650321972722,MATH 197,001,091859,McAuley; Julian John,9998,0,9999,1
1650321978788,COGS 9,A01,083615,Staff,0,15,60,60
1650321984831,COGS 11,A01,083617,Boyle; Mary E. T.,22,0,40,18
1650321990857,COGS 13,A01,083071,Staff,0,31,40,40
1650321996881,COGS 14A,A01,092681,Staff,0,17,100,100
1650322002907,COGS 14B,A01,083073,Cheng; Tzu-Han,0,10,50,50
1650322008931,COGS 17,A01,092677,Staff,25,0,75,50
1650322014957,COGS 100,A01,083619,Staff,0,23,60,60
1650322020991,COGS 101A,A01,083621,Davis; Joshua Daniel,1,22,60,59
1650322027014,COGS 101B,A01,091572,Staff,2,0,60,58
1650322033042,COGS 101C,A01,083625,Delgado; Tania,18,0,30,12
1650322039073,COGS 107A,A01,083627,Boyle; Mary E. T.,0,8,60,60
1650322045096,COGS 118A,A01,083075,Staff,5,0,60,55
1650322051125,CSE 3,A50,083646,Miranda; Gregory Joseph,21,0,38,17
1650322051125,CSE 3,A51,083647,Miranda; Gregory Joseph,37,0,37,0
1650322057264,CSE 8A,A50,083650,Miranda; Gregory Joseph,0,26,40,40
1650322063289,CSE 11,A01,083080,Cao; Yingjun,0,85,40,40
1650322069313,CSE 12,A01,083652,Staff,0,10,100,100
1650322075335,CSE 15L,A01,083654,Staff,0,1,50,50
1650322075335,CSE 15L,A02,083655,Staff,4,0,50,46
1650322081360,CSE 20,A01,083657,Staff,53,0,80,27
1650322087385,CSE 30,A01,083084,Eldon; John,0,74,40,40
1650322093408,CSE 100,A01,083659,Cao; Yingjun,0,66,50,50
1650322099431,CSE 134B,A01,083661,Powell; Thomas Allan,0,30,65,65
1650322105462,CSE 140,A01,083663,Staff,0,0,75,75
1650322111489,CSE 140L,A01,083088,Eldon; John,0,6,75,75
1650322117517,CSE 175,A01,083665,Kumar; Rakesh,8,0,25,17
1650322123543,CSE 190,A00,092507,Dubnov; Shlomo,14,0,20,6
1650322129574,ECE 45,A01,083139,Staff,0,16,40,40
1650322135598,ECE 65,A50,083695,Staff,0,5,30,30
1650322141623,ECE 109,A01,091882,Touri; Behrouz,41,0,70,29
1650322147657,ECE 180,A00,083140,Abi Samra; Nicholas Camill,23,0,30,7
1650322147657,ECE 180,B00,083141,Abi Samra; Nicholas Camill,5,0,30,25
1650322153684,MATH 10A,A01,083735,Patchell; Gregory David,8,0,30,22
1650322153684,MATH 10A,A02,083736,Patchell; Gregory David,28,0,30,2
1650322153684,MATH 10A,A03,083737,Patchell; Gregory David,26,0,30,4
1650322159710,MATH 10B,A01,083207,Staff,0,6,30,30
1650322159710,MATH 10B,A02,083208,Staff,0,6,30,30
1650322159710,MATH 10B,B01,083739,Staff,17,0,30,13
1650322159710,MATH 10B,B02,083740,Staff,28,0,30,2
1650322165770,MATH 18,A01,083743,Staff,5,0,30,25
1650322165770,MATH 18,A02,083744,Staff,26,0,30,4
1650322165770,MATH 18,A03,083745,Staff,22,0,30,8
1650322165770,MATH 18,A04,083746,Staff,27,0,30,3
1650322165770,MATH 18,B01,083748,Staff,0,12,30,30
1650322165770,MATH 18,B02,083749,Staff,0,10,30,30
1650322165770,MATH 18,B03,083750,Staff,1,10,30,29
1650322165770,MATH 18,B04,083751,Staff,0,10,30,30
1650322171794,MATH 20A,A01,083754,Staff,26,0,40,14
1650322177816,MATH 20B,A01,083756,Staff,0,7,30,30
1650322177816,MATH 20B,A02,083757,Staff,0,8,30,30
1650322183863,MATH 20C,A01,083760,Staff,0,13,30,30
1650322183863,MATH 20C,A02,083761,Staff,0,13,30,30
1650322183863,MATH 20C,B01,083762,Staff,13,0,30,17
1650322183863,MATH 20C,B02,083763,Staff,28,0,30,2
1650322189888,MATH 20D,A01,083765,Staff,0,1,30,30
1650322189888,MATH 20D,A02,083766,Staff,7,0,30,23
1650322189888,MATH 20D,A03,083767,Staff,27,0,30,3
1650322195910,MATH 20E,A01,083771,Staff,5,0,30,25
1650322195910,MATH 20E,A02,083772,Staff,19,0,30,11
1650322195910,MATH 20E,B01,083773,Staff,0,0,30,30
1650322195910,MATH 20E,B02,083774,Staff,12,0,30,18
1650322201937,MATH 103A,A01,083777,Staff,0,13,30,30
1650322201937,MATH 103A,A02,083778,Staff,0,12,30,30
1650322201937,MATH 103A,B01,083779,Staff,0,11,30,30
1650322201937,MATH 103A,B02,083780,Staff,0,11,30,30
1650322207959,MATH 105,A01,085443,Staff,0,19,30,30
1650322213986,MATH 109,A01,083213,Anzaldo; Leesa B,0,5,30,30
1650322213986,MATH 109,A02,083214,Anzaldo; Leesa B,0,6,30,30
1650322213986,MATH 109,B01,083215,Anzaldo; Leesa B,0,4,30,30
1650322213986,MATH 109,B02,083216,Anzaldo; Leesa B,0,4,30,30
1650322220015,MATH 142A,A01,083219,Chow; Bennett,0,14,30,30
1650322220015,MATH 142A,A02,083220,Chow; Bennett,0,12,30,30
1650322220015,MATH 142A,B01,083221,Chow; Bennett,0,12,30,30
1650322220015,MATH 142A,B02,083222,Chow; Bennett,0,12,30,30
1650322226041,MATH 193A,A01,083224,Staff,0,5,30,30
1650322226041,MATH 193A,A02,083225,Staff,0,5,30,30
1650322226041,MATH 193A,A03,083781,Staff,0,2,30,30
1650322226041,MATH 193A,A04,083782,Staff,0,3,30,30
1650322232070,MATH 197,001,091859,McAuley; Julian John,9998,0,9999,1
1650322238127,COGS 9,A01,083615,Staff,0,15,60,60
1650322244165,COGS 11,A01,083617,Boyle; Mary E. T.,22,0,40,18
1650322250192,COGS 13,A01,083071,Staff,0,31,40,40
1650322256221,COGS 14A,A01,092681,Staff,0,17,100,100
1650322262259,COGS 14B,A01,083073,Cheng; Tzu-Han,0,10,50,50
1650322268293,COGS 17,A01,092677,Staff,24,0,75,51
1650322274317,COGS 100,A01,083619,Staff,0,23,60,60
1650322280347,COGS 101A,A01,083621,Davis; Joshua Daniel,1,22,60,59
1650322286387,COGS 101B,A01,091572,Staff,2,0,60,58
1650322292422,COGS 101C,A01,083625,Delgado; Tania,18,0,30,12
1650322298446,COGS 107A,A01,083627,Boyle; Mary E. T.,0,8,60,60
1650322304468,COGS 118A,A01,083075,Staff,5,0,60,55
1650322310499,CSE 3,A50,083646,Miranda; Gregory Joseph,21,0,38,17
1650322310499,CSE 3,A51,083647,Miranda; Gregory Joseph,37,0,37,0
1650322316535,CSE 8A,A50,083650,Miranda; Gregory Joseph,0,26,40,40
1650322322560,CSE 11,A01,083080,Cao; Yingjun,0,85,40,40
1650322328600,CSE 12,A01,083652,Staff,0,10,100,100
1650322334629,CSE 15L,A01,083654,Staff,0,1,50,50
1650322334629,CSE 15L,A02,083655,Staff,4,0,50,46
1650322340656,CSE 20,A01,083657,Staff,53,0,80,27
1650322346692,CSE 30,A01,083084,Eldon; John,0,74,40,40
1650322352719,CSE 100,A01,083659,Cao; Yingjun,0,66,50,50
1650322358757,CSE 134B,A01,083661,Powell; Thomas Allan,0,30,65,65
1650322364790,CSE 140,A01,083663,Staff,0,0,75,75
1650322370830,CSE 140L,A01,083088,Eldon; John,0,6,75,75
1650322376858,CSE 175,A01,083665,Kumar; Rakesh,8,0,25,17
1650322382886,CSE 190,A00,092507,Dubnov; Shlomo,14,0,20,6
1650322388915,ECE 45,A01,083139,Staff,0,16,40,40
1650322394949,ECE 65,A50,083695,Staff,0,5,30,30
1650322400984,ECE 109,A01,091882,Touri; Behrouz,41,0,70,29
1650322407008,ECE 180,A00,083140,Abi Samra; Nicholas Camill,23,0,30,7
1650322407008,ECE 180,B00,083141,Abi Samra; Nicholas Camill,5,0,30,25
1650322413049,MATH 10A,A01,083735,Patchell; Gregory David,8,0,30,22
1650322413049,MATH 10A,A02,083736,Patchell; Gregory David,28,0,30,2
1650322413049,MATH 10A,A03,083737,Patchell; Gregory David,26,0,30,4
1650322419073,MATH 10B,A01,083207,Staff,0,6,30,30
1650322419073,MATH 10B,A02,083208,Staff,0,6,30,30
1650322419073,MATH 10B,B01,083739,Staff,17,0,30,13
1650322419073,MATH 10B,B02,083740,Staff,28,0,30,2
1650322425106,MATH 18,A01,083743,Staff,5,0,30,25
1650322425106,MATH 18,A02,083744,Staff,26,0,30,4
1650322425106,MATH 18,A03,083745,Staff,22,0,30,8
1650322425106,MATH 18,A04,083746,Staff,27,0,30,3
1650322425106,MATH 18,B01,083748,Staff,0,11,30,30
1650322425106,MATH 18,B02,083749,Staff,0,11,30,30
1650322425106,MATH 18,B03,083750,Staff,1,10,30,29
1650322425106,MATH 18,B04,083751,Staff,0,10,30,30
1650322431130,MATH 20A,A01,083754,Staff,26,0,40,14
1650322437162,MATH 20B,A01,083756,Staff,0,7,30,30
1650322437162,MATH 20B,A02,083757,Staff,0,8,30,30
1650322443186,MATH 20C,A01,083760,Staff,0,13,30,30
1650322443186,MATH 20C,A02,083761,Staff,0,13,30,30
1650322443186,MATH 20C,B01,083762,Staff,13,0,30,17
1650322443186,MATH 20C,B02,083763,Staff,28,0,30,2
1650322449211,MATH 20D,A01,083765,Staff,0,1,30,30
1650322449211,MATH 20D,A02,083766,Staff,7,0,30,23
1650322449211,MATH 20D,A03,083767,Staff,27,0,30,3
1650322455234,MATH 20E,A01,083771,Staff,5,0,30,25
1650322455234,MATH 20E,A02,083772,Staff,19,0,30,11
1650322455234,MATH 20E,B01,083773,Staff,0,0,30,30
1650322455234,MATH 20E,B02,083774,Staff,12,0,30,18
1650322461257,MATH 103A,A01,083777,Staff,0,13,30,30
1650322461257,MATH 103A,A02,083778,Staff,0,12,30,30
1650322461257,MATH 103A,B01,083779,Staff,0,11,30,30
1650322461257,MATH 103A,B02,083780,Staff,0,11,30,30
1650322467280,MATH 105,A01,085443,Staff,0,19,30,30
1650322473322,MATH 109,A01,083213,Anzaldo; Leesa B,0,5,30,30
1650322473322,MATH 109,A02,083214,Anzaldo; Leesa B,0,6,30,30
1650322473322,MATH 109,B01,083215,Anzaldo; Leesa B,0,4,30,30
1650322473322,MATH 109,B02,083216,Anzaldo; Leesa B,0,4,30,30
1650322479360,MATH 142A,A01,083219,Chow; Bennett,0,14,30,30
1650322479360,MATH 142A,A02,083220,Chow; Bennett,0,12,30,30
1650322479360,MATH 142A,B01,083221,Chow; Bennett,0,12,30,30
1650322479360,MATH 142A,B02,083222,Chow; Bennett,0,12,30,30
1650322485397,MATH 193A,A01,083224,Staff,0,5,30,30
1650322485397,MATH 193A,A02,083225,Staff,0,5,30,30
1650322485397,MATH 193A,A03,083781,Staff,0,2,30,30
1650322485397,MATH 193A,A04,083782,Staff,0,3,30,30
1650322491424,MATH 197,001,091859,McAuley; Julian John,9998,0,9999,1
1650322497503,COGS 9,A01,083615,Staff,0,15,60,60
1650322503525,COGS 11,A01,083617,Boyle; Mary E. T.,22,0,40,18
1650322509552,COGS 13,A01,083071,Staff,0,31,40,40
1650322515579,COGS 14A,A01,092681,Staff,0,17,100,100
1650322521616,COGS 14B,A01,083073,Cheng; Tzu-Han,0,10,50,50
1650322527640,COGS 17,A01,092677,Staff,24,0,75,51
1650322533664,COGS 100,A01,083619,Staff,0,23,60,60
1650322539697,COGS 101A,A01,083621,Davis; Joshua Daniel,1,22,60,59
1650322545733,COGS 101B,A01,091572,Staff,2,0,60,58
1650322551763,COGS 101C,A01,083625,Delgado; Tania,18,0,30,12
1650322557797,COGS 107A,A01,083627,Boyle; Mary E. T.,0,8,60,60
1650322563831,COGS 118A,A01,083075,Staff,5,0,60,55
1650322569861,CSE 3,A50,083646,Miranda; Gregory Joseph,21,0,38,17
1650322569861,CSE 3,A51,083647,Miranda; Gregory Joseph,37,0,37,0
1650322575890,CSE 8A,A50,083650,Miranda; Gregory Joseph,0,26,40,40
1650322581912,CSE 11,A01,083080,Cao; Yingjun,0,85,40,40
1650322587934,CSE 12,A01,083652,Staff,0,10,100,100
1650322593969,CSE 15L,A01,083654,Staff,0,1,50,50
1650322593969,CSE 15L,A02,083655,Staff,4,0,50,46
1650322600002,CSE 20,A01,083657,Staff,53,0,80,27
1650322606034,CSE 30,A01,083084,Eldon; John,0,74,40,40
1650322612065,CSE 100,A01,083659,Cao; Yingjun,0,66,50,50
1650322618119,CSE 134B,A01,083661,Powell; Thomas Allan,0,30,65,65
1650322624145,CSE 140,A01,083663,Staff,0,0,75,75
1650322630172,CSE 140L,A01,083088,Eldon; John,0,6,75,75
1650322636199,CSE 175,A01,083665,Kumar; Rakesh,8,0,25,17
1650322642239,CSE 190,A00,092507,Dubnov; Shlomo,14,0,20,6
1650322648272,ECE 45,A01,083139,Staff,0,16,40,40
1650322654395,ECE 65,A50,083695,Staff,0,5,30,30
1650322660423,ECE 109,A01,091882,Touri; Behrouz,41,0,70,29
1650322666451,ECE 180,A00,083140,Abi Samra; Nicholas Camill,23,0,30,7
1650322666451,ECE 180,B00,083141,Abi Samra; Nicholas Camill,5,0,30,25
1650322672489,MATH 10A,A01,083735,Patchell; Gregory David,7,0,30,23
1650322672489,MATH 10A,A02,083736,Patchell; Gregory David,28,0,30,2
1650322672489,MATH 10A,A03,083737,Patchell; Gregory David,26,0,30,4
1650322678517,MATH 10B,A01,083207,Staff,0,6,30,30
1650322678517,MATH 10B,A02,083208,Staff,0,6,30,30
1650322678517,MATH 10B,B01,083739,Staff,17,0,30,13
1650322678517,MATH 10B,B02,083740,Staff,28,0,30,2
1650322684550,MATH 18,A01,083743,Staff,5,0,30,25
1650322684550,MATH 18,A02,083744,Staff,26,0,30,4
1650322684550,MATH 18,A03,083745,Staff,22,0,30,8
1650322684550,MATH 18,A04,083746,Staff,27,0,30,3
1650322684550,MATH 18,B01,083748,Staff,0,11,30,30
1650322684550,MATH 18,B02,083749,Staff,0,11,30,30
1650322684550,MATH 18,B03,083750,Staff,1,10,30,29
1650322684550,MATH 18,B04,083751,Staff,0,10,30,30
1650322690578,MATH 20A,A01,083754,Staff,26,0,40,14
1650322696613,MATH 20B,A01,083756,Staff,0,7,30,30
1650322696613,MATH 20B,A02,083757,Staff,0,8,30,30
1650322702640,MATH 20C,A01,083760,Staff,0,13,30,30
1650322702640,MATH 20C,A02,083761,Staff,0,13,30,30
1650322702640,MATH 20C,B01,083762,Staff,13,0,30,17
1650322702640,MATH 20C,B02,083763,Staff,28,0,30,2
1650322708667,MATH 20D,A01,083765,Staff,0,1,30,30
1650322708667,MATH 20D,A02,083766,Staff,7,0,30,23
1650322708667,MATH 20D,A03,083767,Staff,27,0,30,3
1650322714691,MATH 20E,A01,083771,Staff,5,0,30,25
1650322714691,MATH 20E,A02,083772,Staff,19,0,30,11
1650322714691,MATH 20E,B01,083773,Staff,0,0,30,30
1650322714691,MATH 20E,B02,083774,Staff,12,0,30,18
1650322720741,MATH 103A,A01,083777,Staff,0,13,30,30
1650322720741,MATH 103A,A02,083778,Staff,0,12,30,30
1650322720741,MATH 103A,B01,083779,Staff,0,11,30,30
1650322720741,MATH 103A,B02,083780,Staff,0,11,30,30
1650322726771,MATH 105,A01,085443,Staff,0,19,30,30
1650322732822,MATH 109,A01,083213,Anzaldo; Leesa B,0,5,30,30
1650322732822,MATH 109,A02,083214,Anzaldo; Leesa B,0,7,30,30
1650322732822,MATH 109,B01,083215,Anzaldo; Leesa B,0,4,30,30
1650322732822,MATH 109,B02,083216,Anzaldo; Leesa B,0,4,30,30
1650322738846,MATH 142A,A01,083219,Chow; Bennett,0,14,30,30
1650322738846,MATH 142A,A02,083220,Chow; Bennett,0,12,30,30
1650322738846,MATH 142A,B01,083221,Chow; Bennett,0,12,30,30
1650322738846,MATH 142A,B02,083222,Chow; Bennett,0,12,30,30
1650322744871,MATH 193A,A01,083224,Staff,0,5,30,30
1650322744871,MATH 193A,A02,083225,Staff,0,5,30,30
1650322744871,MATH 193A,A03,083781,Staff,0,2,30,30
1650322744871,MATH 193A,A04,083782,Staff,0,3,30,30
1650322750897,MATH 197,001,091859,McAuley; Julian John,9998,0,9999,1
1650322756966,COGS 9,A01,083615,Staff,0,15,60,60
1650322762997,COGS 11,A01,083617,Boyle; Mary E. T.,22,0,40,18
1650322769022,COGS 13,A01,083071,Staff,0,31,40,40
1650322775051,COGS 14A,A01,092681,Staff,0,18,100,100
1650322781075,COGS 14B,A01,083073,Cheng; Tzu-Han,0,10,50,50
1650322787108,COGS 17,A01,092677,Staff,24,0,75,51
1650322793131,COGS 100,A01,083619,Staff,0,23,60,60
1650322799158,COGS 101A,A01,083621,Davis; Joshua Daniel,1,22,60,59
1650322805187,COGS 101B,A01,091572,Staff,2,0,60,58
1650322811216,COGS 101C,A01,083625,Delgado; Tania,18,0,30,12
1650322817241,COGS 107A,A01,083627,Boyle; Mary E. T.,0,8,60,60
1650322823265,COGS 118A,A01,083075,Staff,5,0,60,55
1650322829288,CSE 3,A50,083646,Miranda; Gregory Joseph,21,0,38,17
1650322829288,CSE 3,A51,083647,Miranda; Gregory Joseph,37,0,37,0
1650322835310,CSE 8A,A50,083650,Miranda; Gregory Joseph,0,27,40,40
1650322841333,CSE 11,A01,083080,Cao; Yingjun,0,85,40,40
1650322847356,CSE 12,A01,083652,Staff,0,10,100,100
1650322853379,CSE 15L,A01,083654,Staff,0,1,50,50
1650322853379,CSE 15L,A02,083655,Staff,4,0,50,46
1650322859403,CSE 20,A01,083657,Staff,53,0,80,27
1650322865441,CSE 30,A01,083084,Eldon; John,0,75,40,40
1650322871476,CSE 100,A01,083659,Cao; Yingjun,0,66,50,50
1650322877505,CSE 134B,A01,083661,Powell; Thomas Allan,0,30,65,65
1650322883528,CSE 140,A01,083663,Staff,0,0,75,75
1650322889556,CSE 140L,A01,083088,Eldon; John,0,6,75,75
1650322895576,CSE 175,A01,083665,Kumar; Rakesh,8,0,25,17
1650322901603,CSE 190,A00,092507,Dubnov; Shlomo,14,0,20,6
1650322907634,ECE 45,A01,083139,Staff,0,16,40,40
1650322913686,ECE 65,A50,083695,Staff,0,5,30,30
1650322919711,ECE 109,A01,091882,Touri; Behrouz,41,0,70,29
1650322925735,ECE 180,A00,083140,Abi Samra; Nicholas Camill,23,0,30,7
1650322925735,ECE 180,B00,083141,Abi Samra; Nicholas Camill,5,0,30,25
1650322931761,MATH 10A,A01,083735,Patchell; Gregory David,7,0,30,23
1650322931761,MATH 10A,A02,083736,Patchell; Gregory David,28,0,30,2
1650322931761,MATH 10A,A03,083737,Patchell; Gregory David,26,0,30,4
1650322937788,MATH 10B,A01,083207,Staff,0,6,30,30
1650322937788,MATH 10B,A02,083208,Staff,0,6,30,30
1650322937788,MATH 10B,B01,083739,Staff,17,0,30,13
1650322937788,MATH 10B,B02,083740,Staff,28,0,30,2
1650322943813,MATH 18,A01,083743,Staff,5,0,30,25
1650322943813,MATH 18,A02,083744,Staff,26,0,30,4
1650322943813,MATH 18,A03,083745,Staff,22,0,30,8
1650322943813,MATH 18,A04,083746,Staff,27,0,30,3
1650322943813,MATH 18,B01,083748,Staff,0,11,30,30
1650322943813,MATH 18,B02,083749,Staff,0,11,30,30
1650322943813,MATH 18,B03,083750,Staff,1,11,30,29
1650322943813,MATH 18,B04,083751,Staff,0,10,30,30
1650322949840,MATH 20A,A01,083754,Staff,26,0,40,14
1650322955863,MATH 20B,A01,083756,Staff,0,7,30,30
1650322955863,MATH 20B,A02,083757,Staff,0,8,30,30
1650322961888,MATH 20C,A01,083760,Staff,0,13,30,30
1650322961888,MATH 20C,A02,083761,Staff,0,13,30,30
1650322961888,MATH 20C,B01,083762,Staff,13,0,30,17
1650322961888,MATH 20C,B02,083763,Staff,28,0,30,2
1650322967926,MATH 20D,A01,083765,Staff,0,1,30,30
1650322967926,MATH 20D,A02,083766,Staff,7,0,30,23
1650322967926,MATH 20D,A03,083767,Staff,27,0,30,3
1650322973950,MATH 20E,A01,083771,Staff,5,0,30,25
1650322973950,MATH 20E,A02,083772,Staff,19,0,30,11
1650322973950,MATH 20E,B01,083773,Staff,0,0,30,30
1650322973950,MATH 20E,B02,083774,Staff,12,0,30,18
1650322979986,MATH 103A,A01,083777,Staff,0,13,30,30
1650322979986,MATH 103A,A02,083778,Staff,0,12,30,30
1650322979986,MATH 103A,B01,083779,Staff,0,11,30,30
1650322979986,MATH 103A,B02,083780,Staff,0,11,30,30
1650322986015,MATH 105,A01,085443,Staff,0,19,30,30
1650322992039,MATH 109,A01,083213,Anzaldo; Leesa B,0,5,30,30
1650322992039,MATH 109,A02,083214,Anzaldo; Leesa B,0,7,30,30
1650322992039,MATH 109,B01,083215,Anzaldo; Leesa B,0,4,30,30
1650322992039,MATH 109,B02,083216,Anzaldo; Leesa B,0,4,30,30
1650322998069,MATH 142A,A01,083219,Chow; Bennett,0,14,30,30
1650322998069,MATH 142A,A02,083220,Chow; Bennett,0,12,30,30
1650322998069,MATH 142A,B01,083221,Chow; Bennett,0,12,30,30
1650322998069,MATH 142A,B02,083222,Chow; Bennett,0,12,30,30
1650323004102,MATH 193A,A01,083224,Staff,0,5,30,30
1650323004102,MATH 193A,A02,083225,Staff,0,5,30,30
1650323004102,MATH 193A,A03,083781,Staff,0,2,30,30
1650323004102,MATH 193A,A04,083782,Staff,0,3,30,30
1650323010123,MATH 197,001,091859,McAuley; Julian John,9998,0,9999,1
1650323016174,COGS 9,A01,083615,Staff,0,15,60,60
1650323022197,COGS 11,A01,083617,Boyle; Mary E. T.,22,0,40,18
1650323028223,COGS 13,A01,083071,Staff,0,31,40,40
1650323034248,COGS 14A,A01,092681,Staff,0,18,100,100
1650323040271,COGS 14B,A01,083073,Cheng; Tzu-Han,0,10,50,50
1650323046294,COGS 17,A01,092677,Staff,24,0,75,51
1650323052320,COGS 100,A01,083619,Staff,0,23,60,60
1650323058359,COGS 101A,A01,083621,Davis; Joshua Daniel,1,22,60,59
1650323064383,COGS 101B,A01,091572,Staff,2,0,60,58
1650323070416,COGS 101C,A01,083625,Delgado; Tania,18,0,30,12
1650323076453,COGS 107A,A01,083627,Boyle; Mary E. T.,0,8,60,60
1650323082476,COGS 118A,A01,083075,Staff,5,0,60,55
1650323088508,CSE 3,A50,083646,Miranda; Gregory Joseph,21,0,38,17
1650323088508,CSE 3,A51,083647,Miranda; Gregory Joseph,37,0,37,0
1650323094537,CSE 8A,A50,083650,Miranda; Gregory Joseph,0,27,40,40
1650323100562,CSE 11,A01,083080,Cao; Yingjun,0,85,40,40
1650323106585,CSE 12,A01,083652,Staff,0,10,100,100
1650323112607,CSE 15L,A01,083654,Staff,0,1,50,50
1650323112607,CSE 15L,A02,083655,Staff,4,0,50,46
1650323118629,CSE 20,A01,083657,Staff,53,0,80,27
1650323124651,CSE 30,A01,083084,Eldon; John,0,75,40,40
1650323130676,CSE 100,A01,083659,Cao; Yingjun,0,66,50,50
1650323136700,CSE 134B,A01,083661,Powell; Thomas Allan,0,30,65,65
1650323142722,CSE 140,A01,083663,Staff,0,0,75,75
1650323148749,CSE 140L,A01,083088,Eldon; John,0,6,75,75
1650323154770,CSE 175,A01,083665,Kumar; Rakesh,8,0,25,17
1650323160799,CSE 190,A00,092507,Dubnov; Shlomo,14,0,20,6
1650323166827,ECE 45,A01,083139,Staff,0,16,40,40
1650323172854,ECE 65,A50,083695,Staff,0,5,30,30
1650323178882,ECE 109,A01,091882,Touri; Behrouz,41,0,70,29
1650323184907,ECE 180,A00,083140,Abi Samra; Nicholas Camill,23,0,30,7
1650323184907,ECE 180,B00,083141,Abi Samra; Nicholas Camill,5,0,30,25
1650323190936,MATH 10A,A01,083735,Patchell; Gregory David,7,0,30,23
1650323190936,MATH 10A,A02,083736,Patchell; Gregory David,28,0,30,2
1650323190936,MATH 10A,A03,083737,Patchell; Gregory David,26,0,30,4
1650323196968,MATH 10B,A01,083207,Staff,0,6,30,30
1650323196968,MATH 10B,A02,083208,Staff,0,6,30,30
1650323196968,MATH 10B,B01,083739,Staff,17,0,30,13
1650323196968,MATH 10B,B02,083740,Staff,28,0,30,2
1650323202992,MATH 18,A01,083743,Staff,5,0,30,25
1650323202992,MATH 18,A02,083744,Staff,26,0,30,4
1650323202992,MATH 18,A03,083745,Staff,22,0,30,8
1650323202992,MATH 18,A04,083746,Staff,27,0,30,3
1650323202992,MATH 18,B01,083748,Staff,0,11,30,30
1650323202992,MATH 18,B02,083749,Staff,0,11,30,30
1650323202992,MATH 18,B03,083750,Staff,1,11,30,29
1650323202992,MATH 18,B04,083751,Staff,0,10,30,30
1650323209035,MATH 20A,A01,083754,Staff,26,0,40,14
1650323215059,MATH 20B,A01,083756,Staff,0,7,30,30
1650323215059,MATH 20B,A02,083757,Staff,0,8,30,30
1650323221083,MATH 20C,A01,083760,Staff,0,13,30,30
1650323221083,MATH 20C,A02,083761,Staff,0,13,30,30
1650323221083,MATH 20C,B01,083762,Staff,13,0,30,17
1650323221083,MATH 20C,B02,083763,Staff,28,0,30,2
1650323227116,MATH 20D,A01,083765,Staff,0,1,30,30
1650323227116,MATH 20D,A02,083766,Staff,7,0,30,23
1650323227116,MATH 20D,A03,083767,Staff,27,0,30,3
1650323233142,MATH 20E,A01,083771,Staff,5,0,30,25
1650323233142,MATH 20E,A02,083772,Staff,19,0,30,11
1650323233142,MATH 20E,B01,083773,Staff,0,0,30,30
1650323233142,MATH 20E,B02,083774,Staff,12,0,30,18
1650323239170,MATH 103A,A01,083777,Staff,0,13,30,30
1650323239170,MATH 103A,A02,083778,Staff,0,12,30,30
1650323239170,MATH 103A,B01,083779,Staff,0,12,30,30
1650323239170,MATH 103A,B02,083780,Staff,0,11,30,30
1650323245195,MATH 105,A01,085443,Staff,0,19,30,30
1650323251308,MATH 109,A01,083213,Anzaldo; Leesa B,0,5,30,30
1650323251308,MATH 109,A02,083214,Anzaldo; Leesa B,0,7,30,30
1650323251308,MATH 109,B01,083215,Anzaldo; Leesa B,0,4,30,30
1650323251308,MATH 109,B02,083216,Anzaldo; Leesa B,0,4,30,30
1650323257332,MATH 142A,A01,083219,Chow; Bennett,0,14,30,30
1650323257332,MATH 142A,A02,083220,Chow; Bennett,0,12,30,30
1650323257332,MATH 142A,B01,083221,Chow; Bennett,0,12,30,30
1650323257332,MATH 142A,B02,083222,Chow; Bennett,0,12,30,30
1650323263357,MATH 193A,A01,083224,Staff,0,5,30,30
1650323263357,MATH 193A,A02,083225,Staff,0,5,30,30
1650323263357,MATH 193A,A03,083781,Staff,0,2,30,30
1650323263357,MATH 193A,A04,083782,Staff,0,3,30,30
1650323269393,MATH 197,001,091859,McAuley; Julian John,9998,0,9999,1
1650323275451,COGS 9,A01,083615,Staff,0,15,60,60
1650323281477,COGS 11,A01,083617,Boyle; Mary E. T.,22,0,40,18
1650323287499,COGS 13,A01,083071,Staff,0,31,40,40
1650323293523,COGS 14A,A01,092681,Staff,0,18,100,100
1650323299548,COGS 14B,A01,083073,Cheng; Tzu-Han,0,10,50,50
1650323305575,COGS 17,A01,092677,Staff,25,0,75,50
1650323311601,COGS 100,A01,083619,Staff,0,23,60,60
1650323317628,COGS 101A,A01,083621,Davis; Joshua Daniel,1,22,60,59
1650323323652,COGS 101B,A01,091572,Staff,2,0,60,58
1650323329678,COGS 101C,A01,083625,Delgado; Tania,18,0,30,12
1650323335709,COGS 107A,A01,083627,Boyle; Mary E. T.,0,8,60,60
1650323341737,COGS 118A,A01,083075,Staff,5,0,60,55
1650323347771,CSE 3,A50,083646,Miranda; Gregory Joseph,21,0,38,17
1650323347771,CSE 3,A51,083647,Miranda; Gregory Joseph,37,0,37,0
1650323353798,CSE 8A,A50,083650,Miranda; Gregory Joseph,0,27,40,40
1650323359821,CSE 11,A01,083080,Cao; Yingjun,0,85,40,40
1650323365845,CSE 12,A01,083652,Staff,0,10,100,100
1650323371872,CSE 15L,A01,083654,Staff,0,1,50,50
1650323371872,CSE 15L,A02,083655,Staff,4,0,50,46
1650323377899,CSE 20,A01,083657,Staff,53,0,80,27
1650323383933,CSE 30,A01,083084,Eldon; John,0,75,40,40
1650323389964,CSE 100,A01,083659,Cao; Yingjun,0,66,50,50
1650323395987,CSE 134B,A01,083661,Powell; Thomas Allan,0,30,65,65
1650323402014,CSE 140,A01,083663,Staff,0,0,75,75
1650323408043,CSE 140L,A01,083088,Eldon; John,0,6,75,75
1650323414068,CSE 175,A01,083665,Kumar; Rakesh,8,0,25,17
1650323420092,CSE 190,A00,092507,Dubnov; Shlomo,14,0,20,6
1650323426118,ECE 45,A01,083139,Staff,0,16,40,40
1650323432142,ECE 65,A50,083695,Staff,0,5,30,30
1650323438169,ECE 109,A01,091882,Touri; Behrouz,41,0,70,29
1650323444195,ECE 180,A00,083140,Abi Samra; Nicholas Camill,23,0,30,7
1650323444195,ECE 180,B00,083141,Abi Samra; Nicholas Camill,5,0,30,25
1650323450223,MATH 10A,A01,083735,Patchell; Gregory David,7,0,30,23
1650323450223,MATH 10A,A02,083736,Patchell; Gregory David,28,0,30,2
1650323450223,MATH 10A,A03,083737,Patchell; Gregory David,26,0,30,4
1650323456248,MATH 10B,A01,083207,Staff,0,6,30,30
1650323456248,MATH 10B,A02,083208,Staff,0,6,30,30
1650323456248,MATH 10B,B01,083739,Staff,17,0,30,13
1650323456248,MATH 10B,B02,083740,Staff,28,0,30,2
1650323462274,MATH 18,A01,083743,Staff,5,0,30,25
1650323462274,MATH 18,A02,083744,Staff,26,0,30,4
1650323462274,MATH 18,A03,083745,Staff,22,0,30,8
1650323462274,MATH 18,A04,083746,Staff,27,0,30,3
1650323462274,MATH 18,B01,083748,Staff,0,11,30,30
1650323462274,MATH 18,B02,083749,Staff,0,11,30,30
1650323462274,MATH 18,B03,083750,Staff,1,11,30,29
1650323462274,MATH 18,B04,083751,Staff,0,10,30,30
1650323468296,MATH 20A,A01,083754,Staff,26,0,40,14
1650323474324,MATH 20B,A01,083756,Staff,0,7,30,30
1650323474324,MATH 20B,A02,083757,Staff,0,8,30,30
1650323480352,MATH 20C,A01,083760,Staff,0,13,30,30
1650323480352,MATH 20C,A02,083761,Staff,0,13,30,30
1650323480352,MATH 20C,B01,083762,Staff,13,0,30,17
1650323480352,MATH 20C,B02,083763,Staff,28,0,30,2
1650323486376,MATH 20D,A01,083765,Staff,0,1,30,30
1650323486376,MATH 20D,A02,083766,Staff,7,0,30,23
1650323486376,MATH 20D,A03,083767,Staff,27,0,30,3
1650323492403,MATH 20E,A01,083771,Staff,5,0,30,25
1650323492403,MATH 20E,A02,083772,Staff,19,0,30,11
1650323492403,MATH 20E,B01,083773,Staff,0,0,30,30
1650323492403,MATH 20E,B02,083774,Staff,12,0,30,18
1650323498431,MATH 103A,A01,083777,Staff,0,13,30,30
1650323498431,MATH 103A,A02,083778,Staff,0,12,30,30
1650323498431,MATH 103A,B01,083779,Staff,0,12,30,30
1650323498431,MATH 103A,B02,083780,Staff,0,11,30,30
1650323504465,MATH 105,A01,085443,Staff,0,19,30,30
1650323510490,MATH 109,A01,083213,Anzaldo; Leesa B,0,5,30,30
1650323510490,MATH 109,A02,083214,Anzaldo; Leesa B,0,7,30,30
1650323510490,MATH 109,B01,083215,Anzaldo; Leesa B,0,4,30,30
1650323510490,MATH 109,B02,083216,Anzaldo; Leesa B,0,4,30,30
1650323516517,MATH 142A,A01,083219,Chow; Bennett,0,14,30,30
1650323516517,MATH 142A,A02,083220,Chow; Bennett,0,12,30,30
1650323516517,MATH 142A,B01,083221,Chow; Bennett,0,12,30,30
1650323516517,MATH 142A,B02,083222,Chow; Bennett,0,12,30,30
1650323522540,MATH 193A,A01,083224,Staff,0,5,30,30
1650323522540,MATH 193A,A02,083225,Staff,0,5,30,30
1650323522540,MATH 193A,A03,083781,Staff,0,2,30,30
1650323522540,MATH 193A,A04,083782,Staff,0,3,30,30
1650323528583,MATH 197,001,091859,McAuley; Julian John,9998,0,9999,1
1650323534638,COGS 9,A01,083615,Staff,0,15,60,60
1650323540669,COGS 11,A01,083617,Boyle; Mary E. T.,22,0,40,18
1650323546697,COGS 13,A01,083071,Staff,0,31,40,40
1650323552728,COGS 14A,A01,092681,Staff,0,18,100,100
1650323558749,COGS 14B,A01,083073,Cheng; Tzu-Han,0,10,50,50
1650323564773,COGS 17,A01,092677,Staff,25,0,75,50
1650323570795,COGS 100,A01,083619,Staff,0,23,60,60
1650323576820,COGS 101A,A01,083621,Davis; Joshua Daniel,1,22,60,59
1650323582847,COGS 101B,A01,091572,Staff,2,0,60,58
1650323588880,COGS 101C,A01,083625,Delgado; Tania,18,0,30,12
1650323594906,COGS 107A,A01,083627,Boyle; Mary E. T.,0,8,60,60
1650323600938,COGS 118A,A01,083075,Staff,5,0,60,55
1650323606960,CSE 3,A50,083646,Miranda; Gregory Joseph,21,0,38,17
1650323606960,CSE 3,A51,083647,Miranda; Gregory Joseph,37,0,37,0
1650323612991,CSE 8A,A50,083650,Miranda; Gregory Joseph,0,27,40,40
1650323619021,CSE 11,A01,083080,Cao; Yingjun,0,85,40,40
1650323625056,CSE 12,A01,083652,Staff,0,10,100,100
1650323631080,CSE 15L,A01,083654,Staff,0,1,50,50
1650323631080,CSE 15L,A02,083655,Staff,4,0,50,46
1650323637113,CSE 20,A01,083657,Staff,53,0,80,27
1650323643152,CSE 30,A01,083084,Eldon; John,0,75,40,40
1650323649176,CSE 100,A01,083659,Cao; Yingjun,0,66,50,50
1650323655202,CSE 134B,A01,083661,Powell; Thomas Allan,0,30,65,65
1650323661229,CSE 140,A01,083663,Staff,0,0,75,75
1650323667251,CSE 140L,A01,083088,Eldon; John,0,6,75,75
1650323673281,CSE 175,A01,083665,Kumar; Rakesh,8,0,25,17
1650323679303,CSE 190,A00,092507,Dubnov; Shlomo,14,0,20,6
1650323685325,ECE 45,A01,083139,Staff,0,16,40,40
1650323691358,ECE 65,A50,083695,Staff,0,5,30,30
1650323697393,ECE 109,A01,091882,Touri; Behrouz,41,0,70,29
1650323703421,ECE 180,A00,083140,Abi Samra; Nicholas Camill,23,0,30,7
1650323703421,ECE 180,B00,083141,Abi Samra; Nicholas Camill,5,0,30,25
1650323709448,MATH 10A,A01,083735,Patchell; Gregory David,8,0,30,22
1650323709448,MATH 10A,A02,083736,Patchell; Gregory David,28,0,30,2
1650323709448,MATH 10A,A03,083737,Patchell; Gregory David,26,0,30,4
1650323715472,MATH 10B,A01,083207,Staff,0,6,30,30
1650323715472,MATH 10B,A02,083208,Staff,0,6,30,30
1650323715472,MATH 10B,B01,083739,Staff,17,0,30,13
1650323715472,MATH 10B,B02,083740,Staff,28,0,30,2
1650323721506,MATH 18,A01,083743,Staff,5,0,30,25
1650323721506,MATH 18,A02,083744,Staff,26,0,30,4
1650323721506,MATH 18,A03,083745,Staff,22,0,30,8
1650323721506,MATH 18,A04,083746,Staff,27,0,30,3
1650323721506,MATH 18,B01,083748,Staff,0,11,30,30
1650323721506,MATH 18,B02,083749,Staff,0,11,30,30
1650323721506,MATH 18,B03,083750,Staff,1,11,30,29
1650323721506,MATH 18,B04,083751,Staff,0,10,30,30
1650323727530,MATH 20A,A01,083754,Staff,26,0,40,14
1650323733553,MATH 20B,A01,083756,Staff,0,7,30,30
1650323733553,MATH 20B,A02,083757,Staff,0,8,30,30
1650323739575,MATH 20C,A01,083760,Staff,0,13,30,30
1650323739575,MATH 20C,A02,083761,Staff,0,13,30,30
1650323739575,MATH 20C,B01,083762,Staff,13,0,30,17
1650323739575,MATH 20C,B02,083763,Staff,28,0,30,2
1650323745618,MATH 20D,A01,083765,Staff,0,1,30,30
1650323745618,MATH 20D,A02,083766,Staff,7,0,30,23
1650323745618,MATH 20D,A03,083767,Staff,26,0,30,4
1650323751646,MATH 20E,A01,083771,Staff,5,0,30,25
1650323751646,MATH 20E,A02,083772,Staff,19,0,30,11
1650323751646,MATH 20E,B01,083773,Staff,0,0,30,30
1650323751646,MATH 20E,B02,083774,Staff,12,0,30,18
1650323757671,MATH 103A,A01,083777,Staff,0,13,30,30
1650323757671,MATH 103A,A02,083778,Staff,0,12,30,30
1650323757671,MATH 103A,B01,083779,Staff,0,12,30,30
1650323757671,MATH 103A,B02,083780,Staff,0,11,30,30
1650323763701,MATH 105,A01,085443,Staff,0,19,30,30
1650323769726,MATH 109,A01,083213,Anzaldo; Leesa B,0,5,30,30
1650323769726,MATH 109,A02,083214,Anzaldo; Leesa B,0,7,30,30
1650323769726,MATH 109,B01,083215,Anzaldo; Leesa B,0,4,30,30
1650323769726,MATH 109,B02,083216,Anzaldo; Leesa B,0,4,30,30
1650323775762,MATH 142A,A01,083219,Chow; Bennett,0,14,30,30
1650323775762,MATH 142A,A02,083220,Chow; Bennett,0,12,30,30
1650323775762,MATH 142A,B01,083221,Chow; Bennett,0,12,30,30
1650323775762,MATH 142A,B02,083222,Chow; Bennett,0,12,30,30
1650323781788,MATH 193A,A01,083224,Staff,0,5,30,30
1650323781788,MATH 193A,A02,083225,Staff,0,5,30,30
1650323781788,MATH 193A,A03,083781,Staff,0,2,30,30
1650323781788,MATH 193A,A04,083782,Staff,0,3,30,30
1650323787825,MATH 197,001,091859,McAuley; Julian John,9998,0,9999,1
1650323793877,COGS 9,A01,083615,Staff,0,15,60,60
1650323799911,COGS 11,A01,083617,Boyle; Mary E. T.,22,0,40,18
1650323805934,COGS 13,A01,083071,Staff,0,31,40,40
1650323811960,COGS 14A,A01,092681,Staff,0,18,100,100
1650323817986,COGS 14B,A01,083073,Cheng; Tzu-Han,0,10,50,50
1650323824024,COGS 17,A01,092677,Staff,25,0,75,50
1650323830052,COGS 100,A01,083619,Staff,0,23,60,60
1650323836079,COGS 101A,A01,083621,Davis; Joshua Daniel,1,22,60,59
1650323842194,COGS 101B,A01,091572,Staff,2,0,60,58
1650323848232,COGS 101C,A01,083625,Delgado; Tania,18,0,30,12
1650323854260,COGS 107A,A01,083627,Boyle; Mary E. T.,0,8,60,60
1650323860296,COGS 118A,A01,083075,Staff,5,0,60,55
1650323866324,CSE 3,A50,083646,Miranda; Gregory Joseph,21,0,38,17
1650323866324,CSE 3,A51,083647,Miranda; Gregory Joseph,37,0,37,0
1650323872350,CSE 8A,A50,083650,Miranda; Gregory Joseph,0,27,40,40
1650323878386,CSE 11,A01,083080,Cao; Yingjun,0,85,40,40
1650323884410,CSE 12,A01,083652,Staff,0,10,100,100
1650323890434,CSE 15L,A01,083654,Staff,0,1,50,50
1650323890434,CSE 15L,A02,083655,Staff,4,0,50,46
1650323896465,CSE 20,A01,083657,Staff,53,0,80,27
1650323902489,CSE 30,A01,083084,Eldon; John,0,75,40,40
1650323908511,CSE 100,A01,083659,Cao; Yingjun,0,66,50,50
1650323914558,CSE 134B,A01,083661,Powell; Thomas Allan,0,30,65,65
1650323920581,CSE 140,A01,083663,Staff,0,0,75,75
1650323926608,CSE 140L,A01,083088,Eldon; John,0,6,75,75
1650323932632,CSE 175,A01,083665,Kumar; Rakesh,8,0,25,17
1650323938656,CSE 190,A00,092507,Dubnov; Shlomo,14,0,20,6
1650323944684,ECE 45,A01,083139,Staff,0,16,40,40
1650323950711,ECE 65,A50,083695,Staff,0,5,30,30
1650323956734,ECE 109,A01,091882,Touri; Behrouz,41,0,70,29
1650323962757,ECE 180,A00,083140,Abi Samra; Nicholas Camill,23,0,30,7
1650323962757,ECE 180,B00,083141,Abi Samra; Nicholas Camill,5,0,30,25
1650323968783,MATH 10A,A01,083735,Patchell; Gregory David,8,0,30,22
1650323968783,MATH 10A,A02,083736,Patchell; Gregory David,28,0,30,2
1650323968783,MATH 10A,A03,083737,Patchell; Gregory David,26,0,30,4
1650323974814,MATH 10B,A01,083207,Staff,0,6,30,30
1650323974814,MATH 10B,A02,083208,Staff,0,6,30,30
1650323974814,MATH 10B,B01,083739,Staff,17,0,30,13
1650323974814,MATH 10B,B02,083740,Staff,28,0,30,2
1650323980841,MATH 18,A01,083743,Staff,5,0,30,25
1650323980841,MATH 18,A02,083744,Staff,26,0,30,4
1650323980841,MATH 18,A03,083745,Staff,22,0,30,8
1650323980841,MATH 18,A04,083746,Staff,27,0,30,3
1650323980841,MATH 18,B01,083748,Staff,0,11,30,30
1650323980841,MATH 18,B02,083749,Staff,0,11,30,30
1650323980841,MATH 18,B03,083750,Staff,1,11,30,29
1650323980841,MATH 18,B04,083751,Staff,0,10,30,30
1650323986865,MATH 20A,A01,083754,Staff,26,0,40,14
1650323992889,MATH 20B,A01,083756,Staff,0,7,30,30
1650323992889,MATH 20B,A02,083757,Staff,0,8,30,30
1650323998913,MATH 20C,A01,083760,Staff,0,13,30,30
1650323998913,MATH 20C,A02,083761,Staff,0,13,30,30
1650323998913,MATH 20C,B01,083762,Staff,13,0,30,17
1650323998913,MATH 20C,B02,083763,Staff,28,0,30,2
1650324004939,MATH 20D,A01,083765,Staff,0,1,30,30
1650324004939,MATH 20D,A02,083766,Staff,7,0,30,23
1650324004939,MATH 20D,A03,083767,Staff,26,0,30,4
1650324010963,MATH 20E,A01,083771,Staff,5,0,30,25
1650324010963,MATH 20E,A02,083772,Staff,19,0,30,11
1650324010963,MATH 20E,B01,083773,Staff,0,0,30,30
1650324010963,MATH 20E,B02,083774,Staff,12,0,30,18
1650324016990,MATH 103A,A01,083777,Staff,0,13,30,30
1650324016990,MATH 103A,A02,083778,Staff,0,12,30,30
1650324016990,MATH 103A,B01,083779,Staff,0,12,30,30
1650324016990,MATH 103A,B02,083780,Staff,0,11,30,30
1650324023014,MATH 105,A01,085443,Staff,0,19,30,30
1650324029038,MATH 109,A01,083213,Anzaldo; Leesa B,0,5,30,30
1650324029038,MATH 109,A02,083214,Anzaldo; Leesa B,0,7,30,30
1650324029038,MATH 109,B01,083215,Anzaldo; Leesa B,0,4,30,30
1650324029038,MATH 109,B02,083216,Anzaldo; Leesa B,0,4,30,30
1650324035074,MATH 142A,A01,083219,Chow; Bennett,0,14,30,30
1650324035074,MATH 142A,A02,083220,Chow; Bennett,0,12,30,30
1650324035074,MATH 142A,B01,083221,Chow; Bennett,0,12,30,30
1650324035074,MATH 142A,B02,083222,Chow; Bennett,0,12,30,30
1650324041104,MATH 193A,A01,083224,Staff,0,5,30,30
1650324041104,MATH 193A,A02,083225,Staff,0,5,30,30
1650324041104,MATH 193A,A03,083781,Staff,0,2,30,30
1650324041104,MATH 193A,A04,083782,Staff,0,3,30,30
1650324047135,MATH 197,001,091859,McAuley; Julian John,9998,0,9999,1
1650324053185,COGS 9,A01,083615,Staff,0,15,60,60
1650324059212,COGS 11,A01,083617,Boyle; Mary E. T.,22,0,40,18
1650324065235,COGS 13,A01,083071,Staff,0,31,40,40
1650324071258,COGS 14A,A01,092681,Staff,0,18,100,100
1650324077284,COGS 14B,A01,083073,Cheng; Tzu-Han,0,10,50,50
1650324083307,COGS 17,A01,092677,Staff,25,0,75,50
1650324089331,COGS 100,A01,083619,Staff,0,23,60,60
1650324095355,COGS 101A,A01,083621,Davis; Joshua Daniel,1,22,60,59
1650324101384,COGS 101B,A01,091572,Staff,2,0,60,58
1650324107418,COGS 101C,A01,083625,Delgado; Tania,18,0,30,12
1650324113445,COGS 107A,A01,083627,Boyle; Mary E. T.,0,8,60,60
1650324119469,COGS 118A,A01,083075,Staff,5,0,60,55
1650324125499,CSE 3,A50,083646,Miranda; Gregory Joseph,21,0,38,17
1650324125499,CSE 3,A51,083647,Miranda; Gregory Joseph,37,0,37,0
1650324131521,CSE 8A,A50,083650,Miranda; Gregory Joseph,0,27,40,40
1650324137545,CSE 11,A01,083080,Cao; Yingjun,0,85,40,40
1650324143578,CSE 12,A01,083652,Staff,0,10,100,100
1650324149601,CSE 15L,A01,083654,Staff,0,1,50,50
1650324149601,CSE 15L,A02,083655,Staff,4,0,50,46
1650324155626,CSE 20,A01,083657,Staff,53,0,80,27
1650324161654,CSE 30,A01,083084,Eldon; John,0,75,40,40
1650324167680,CSE 100,A01,083659,Cao; Yingjun,0,66,50,50
1650324173710,CSE 134B,A01,083661,Powell; Thomas Allan,0,30,65,65
1650324179741,CSE 140,A01,083663,Staff,0,0,75,75
1650324185778,CSE 140L,A01,083088,Eldon; John,0,6,75,75
1650324191805,CSE 175,A01,083665,Kumar; Rakesh,8,0,25,17
1650324197827,CSE 190,A00,092507,Dubnov; Shlomo,14,0,20,6
1650324203855,ECE 45,A01,083139,Staff,0,16,40,40
1650324209879,ECE 65,A50,083695,Staff,0,5,30,30
1650324215902,ECE 109,A01,091882,Touri; Behrouz,41,0,70,29
1650324221930,ECE 180,A00,083140,Abi Samra; Nicholas Camill,23,0,30,7
1650324221930,ECE 180,B00,083141,Abi Samra; Nicholas Camill,5,0,30,25
1650324227957,MATH 10A,A01,083735,Patchell; Gregory David,8,0,30,22
1650324227957,MATH 10A,A02,083736,Patchell; Gregory David,28,0,30,2
1650324227957,MATH 10A,A03,083737,Patchell; Gregory David,26,0,30,4
1650324233986,MATH 10B,A01,083207,Staff,0,6,30,30
1650324233986,MATH 10B,A02,083208,Staff,0,6,30,30
1650324233986,MATH 10B,B01,083739,Staff,17,0,30,13
1650324233986,MATH 10B,B02,083740,Staff,28,0,30,2
1650324240020,MATH 18,A01,083743,Staff,5,0,30,25
1650324240020,MATH 18,A02,083744,Staff,26,0,30,4
1650324240020,MATH 18,A03,083745,Staff,22,0,30,8
1650324240020,MATH 18,A04,083746,Staff,27,0,30,3
1650324240020,MATH 18,B01,083748,Staff,0,11,30,30
1650324240020,MATH 18,B02,083749,Staff,0,11,30,30
1650324240020,MATH 18,B03,083750,Staff,1,11,30,29
1650324240020,MATH 18,B04,083751,Staff,0,10,30,30
1650324246042,MATH 20A,A01,083754,Staff,26,0,40,14
1650324252066,MATH 20B,A01,083756,Staff,0,7,30,30
1650324252066,MATH 20B,A02,083757,Staff,0,8,30,30
1650324258092,MATH 20C,A01,083760,Staff,0,13,30,30
1650324258092,MATH 20C,A02,083761,Staff,0,13,30,30
1650324258092,MATH 20C,B01,083762,Staff,13,0,30,17
1650324258092,MATH 20C,B02,083763,Staff,28,0,30,2
1650324264136,MATH 20D,A01,083765,Staff,0,1,30,30
1650324264136,MATH 20D,A02,083766,Staff,7,0,30,23
1650324264136,MATH 20D,A03,083767,Staff,26,0,30,4
1650324270162,MATH 20E,A01,083771,Staff,5,0,30,25
1650324270162,MATH 20E,A02,083772,Staff,19,0,30,11
1650324270162,MATH 20E,B01,083773,Staff,0,0,30,30
1650324270162,MATH 20E,B02,083774,Staff,12,0,30,18
1650324276187,MATH 103A,A01,083777,Staff,0,13,30,30
1650324276187,MATH 103A,A02,083778,Staff,0,12,30,30
1650324276187,MATH 103A,B01,083779,Staff,0,12,30,30
1650324276187,MATH 103A,B02,083780,Staff,0,11,30,30
1650324282209,MATH 105,A01,085443,Staff,0,19,30,30
1650324288232,MATH 109,A01,083213,Anzaldo; Leesa B,0,5,30,30
1650324288232,MATH 109,A02,083214,Anzaldo; Leesa B,0,7,30,30
1650324288232,MATH 109,B01,083215,Anzaldo; Leesa B,0,4,30,30
1650324288232,MATH 109,B02,083216,Anzaldo; Leesa B,0,4,30,30
1650324294259,MATH 142A,A01,083219,Chow; Bennett,0,14,30,30
1650324294259,MATH 142A,A02,083220,Chow; Bennett,0,12,30,30
1650324294259,MATH 142A,B01,083221,Chow; Bennett,0,12,30,30
1650324294259,MATH 142A,B02,083222,Chow; Bennett,0,12,30,30
1650324300285,MATH 193A,A01,083224,Staff,0,5,30,30
1650324300285,MATH 193A,A02,083225,Staff,0,5,30,30
1650324300285,MATH 193A,A03,083781,Staff,0,2,30,30
1650324300285,MATH 193A,A04,083782,Staff,0,3,30,30
1650324306310,MATH 197,001,091859,McAuley; Julian John,9998,0,9999,1
1650324312367,COGS 9,A01,083615,Staff,0,15,60,60
1650324318390,COGS 11,A01,083617,Boyle; Mary E. T.,22,0,40,18
1650324324412,COGS 13,A01,083071,Staff,0,31,40,40
1650324330446,COGS 14A,A01,092681,Staff,0,18,100,100
1650324336471,COGS 14B,A01,083073,Cheng; Tzu-Han,0,10,50,50
1650324342492,COGS 17,A01,092677,Staff,25,0,75,50
1650324348517,COGS 100,A01,083619,Staff,0,23,60,60
1650324354543,COGS 101A,A01,083621,Davis; Joshua Daniel,1,22,60,59
1650324360565,COGS 101B,A01,091572,Staff,2,0,60,58
1650324366659,COGS 101C,A01,083625,Delgado; Tania,18,0,30,12
1650324372681,COGS 107A,A01,083627,Boyle; Mary E. T.,0,8,60,60
1650324378705,COGS 118A,A01,083075,Staff,5,0,60,55
1650324384731,CSE 3,A50,083646,Miranda; Gregory Joseph,21,0,38,17
1650324384731,CSE 3,A51,083647,Miranda; Gregory Joseph,37,0,37,0
1650324390757,CSE 8A,A50,083650,Miranda; Gregory Joseph,0,27,40,40
1650324396790,CSE 11,A01,083080,Cao; Yingjun,0,85,40,40
1650324402825,CSE 12,A01,083652,Staff,0,10,100,100
1650324408847,CSE 15L,A01,083654,Staff,0,1,50,50
1650324408847,CSE 15L,A02,083655,Staff,4,0,50,46
1650324414875,CSE 20,A01,083657,Staff,53,0,80,27
1650324420898,CSE 30,A01,083084,Eldon; John,0,75,40,40
1650324426929,CSE 100,A01,083659,Cao; Yingjun,0,66,50,50
1650324432968,CSE 134B,A01,083661,Powell; Thomas Allan,0,30,65,65
1650324439079,CSE 140,A01,083663,Staff,0,0,75,75
1650324445111,CSE 140L,A01,083088,Eldon; John,0,6,75,75
1650324451133,CSE 175,A01,083665,Kumar; Rakesh,8,0,25,17
1650324457160,CSE 190,A00,092507,Dubnov; Shlomo,14,0,20,6
1650324463195,ECE 45,A01,083139,Staff,0,16,40,40
1650324469228,ECE 65,A50,083695,Staff,0,5,30,30
1650324475252,ECE 109,A01,091882,Touri; Behrouz,41,0,70,29
1650324481278,ECE 180,A00,083140,Abi Samra; Nicholas Camill,23,0,30,7
1650324481278,ECE 180,B00,083141,Abi Samra; Nicholas Camill,5,0,30,25
1650324487316,MATH 10A,A01,083735,Patchell; Gregory David,8,0,30,22
1650324487316,MATH 10A,A02,083736,Patchell; Gregory David,28,0,30,2
1650324487316,MATH 10A,A03,083737,Patchell; Gregory David,26,0,30,4
1650324493340,MATH 10B,A01,083207,Staff,0,6,30,30
1650324493340,MATH 10B,A02,083208,Staff,0,6,30,30
1650324493340,MATH 10B,B01,083739,Staff,17,0,30,13
1650324493340,MATH 10B,B02,083740,Staff,28,0,30,2
1650324499377,MATH 18,A01,083743,Staff,5,0,30,25
1650324499377,MATH 18,A02,083744,Staff,26,0,30,4
1650324499377,MATH 18,A03,083745,Staff,22,0,30,8
1650324499377,MATH 18,A04,083746,Staff,27,0,30,3
1650324499377,MATH 18,B01,083748,Staff,0,11,30,30
1650324499377,MATH 18,B02,083749,Staff,0,11,30,30
1650324499377,MATH 18,B03,083750,Staff,1,11,30,29
1650324499377,MATH 18,B04,083751,Staff,0,10,30,30
1650324505413,MATH 20A,A01,083754,Staff,26,0,40,14
1650324511450,MATH 20B,A01,083756,Staff,0,7,30,30
1650324511450,MATH 20B,A02,083757,Staff,0,8,30,30
1650324517478,MATH 20C,A01,083760,Staff,0,13,30,30
1650324517478,MATH 20C,A02,083761,Staff,0,13,30,30
1650324517478,MATH 20C,B01,083762,Staff,13,0,30,17
1650324517478,MATH 20C,B02,083763,Staff,28,0,30,2
1650324523508,MATH 20D,A01,083765,Staff,0,1,30,30
1650324523508,MATH 20D,A02,083766,Staff,7,0,30,23
1650324523508,MATH 20D,A03,083767,Staff,26,0,30,4
1650324529538,MATH 20E,A01,083771,Staff,5,0,30,25
1650324529538,MATH 20E,A02,083772,Staff,19,0,30,11
1650324529538,MATH 20E,B01,083773,Staff,0,0,30,30
1650324529538,MATH 20E,B02,083774,Staff,12,0,30,18
1650324535562,MATH 103A,A01,083777,Staff,0,13,30,30
1650324535562,MATH 103A,A02,083778,Staff,0,12,30,30
1650324535562,MATH 103A,B01,083779,Staff,0,12,30,30
1650324535562,MATH 103A,B02,083780,Staff,0,11,30,30
1650324541584,MATH 105,A01,085443,Staff,0,19,30,30
1650324547612,MATH 109,A01,083213,Anzaldo; Leesa B,0,5,30,30
1650324547612,MATH 109,A02,083214,Anzaldo; Leesa B,0,7,30,30
1650324547612,MATH 109,B01,083215,Anzaldo; Leesa B,0,4,30,30
1650324547612,MATH 109,B02,083216,Anzaldo; Leesa B,0,4,30,30
1650324553643,MATH 142A,A01,083219,Chow; Bennett,0,14,30,30
1650324553643,MATH 142A,A02,083220,Chow; Bennett,0,12,30,30
1650324553643,MATH 142A,B01,083221,Chow; Bennett,0,12,30,30
1650324553643,MATH 142A,B02,083222,Chow; Bennett,0,12,30,30
1650324559669,MATH 193A,A01,083224,Staff,0,5,30,30
1650324559669,MATH 193A,A02,083225,Staff,0,5,30,30
1650324559669,MATH 193A,A03,083781,Staff,0,2,30,30
1650324559669,MATH 193A,A04,083782,Staff,0,3,30,30
1650324565692,MATH 197,001,091859,McAuley; Julian John,9998,0,9999,1
1650324571747,COGS 9,A01,083615,Staff,0,15,60,60
1650324577771,COGS 11,A01,083617,Boyle; Mary E. T.,22,0,40,18
1650324583804,COGS 13,A01,083071,Staff,0,31,40,40
1650324589827,COGS 14A,A01,092681,Staff,0,18,100,100
1650324595851,COGS 14B,A01,083073,Cheng; Tzu-Han,0,10,50,50
1650324601902,COGS 17,A01,092677,Staff,25,0,75,50
1650324607925,COGS 100,A01,083619,Staff,0,23,60,60
1650324613952,COGS 101A,A01,083621,Davis; Joshua Daniel,1,22,60,59
1650324619980,COGS 101B,A01,091572,Staff,2,0,60,58
1650324626003,COGS 101C,A01,083625,Delgado; Tania,18,0,30,12
1650324632026,COGS 107A,A01,083627,Boyle; Mary E. T.,0,8,60,60
1650324638050,COGS 118A,A01,083075,Staff,5,0,60,55
1650324644076,CSE 3,A50,083646,Miranda; Gregory Joseph,21,0,38,17
1650324644076,CSE 3,A51,083647,Miranda; Gregory Joseph,37,0,37,0
1650324650112,CSE 8A,A50,083650,Miranda; Gregory Joseph,0,27,40,40
1650324656135,CSE 11,A01,083080,Cao; Yingjun,0,85,40,40
1650324662158,CSE 12,A01,083652,Staff,0,10,100,100
1650324668200,CSE 15L,A01,083654,Staff,0,1,50,50
1650324668200,CSE 15L,A02,083655,Staff,4,0,50,46
1650324674226,CSE 20,A01,083657,Staff,53,0,80,27
1650324680248,CSE 30,A01,083084,Eldon; John,0,75,40,40
1650324686272,CSE 100,A01,083659,Cao; Yingjun,0,66,50,50
1650324692300,CSE 134B,A01,083661,Powell; Thomas Allan,0,30,65,65
1650324698326,CSE 140,A01,083663,Staff,0,0,75,75
1650324704352,CSE 140L,A01,083088,Eldon; John,0,6,75,75
1650324710376,CSE 175,A01,083665,Kumar; Rakesh,8,0,25,17
1650324716399,CSE 190,A00,092507,Dubnov; Shlomo,14,0,20,6
1650324722423,ECE 45,A01,083139,Staff,0,16,40,40
1650324728452,ECE 65,A50,083695,Staff,0,5,30,30
1650324734476,ECE 109,A01,091882,Touri; Behrouz,41,0,70,29
1650324740501,ECE 180,A00,083140,Abi Samra; Nicholas Camill,23,0,30,7
1650324740501,ECE 180,B00,083141,Abi Samra; Nicholas Camill,5,0,30,25
1650324746529,MATH 10A,A01,083735,Patchell; Gregory David,8,0,30,22
1650324746529,MATH 10A,A02,083736,Patchell; Gregory David,28,0,30,2
1650324746529,MATH 10A,A03,083737,Patchell; Gregory David,26,0,30,4
1650324752550,MATH 10B,A01,083207,Staff,0,6,30,30
1650324752550,MATH 10B,A02,083208,Staff,0,6,30,30
1650324752550,MATH 10B,B01,083739,Staff,17,0,30,13
1650324752550,MATH 10B,B02,083740,Staff,28,0,30,2
1650324758580,MATH 18,A01,083743,Staff,5,0,30,25
1650324758580,MATH 18,A02,083744,Staff,26,0,30,4
1650324758580,MATH 18,A03,083745,Staff,22,0,30,8
1650324758580,MATH 18,A04,083746,Staff,27,0,30,3
1650324758580,MATH 18,B01,083748,Staff,0,11,30,30
1650324758580,MATH 18,B02,083749,Staff,0,11,30,30
1650324758580,MATH 18,B03,083750,Staff,1,11,30,29
1650324758580,MATH 18,B04,083751,Staff,0,10,30,30
1650324764603,MATH 20A,A01,083754,Staff,26,0,40,14
1650324770627,MATH 20B,A01,083756,Staff,0,7,30,30
1650324770627,MATH 20B,A02,083757,Staff,0,8,30,30
1650324776651,MATH 20C,A01,083760,Staff,0,13,30,30
1650324776651,MATH 20C,A02,083761,Staff,0,13,30,30
1650324776651,MATH 20C,B01,083762,Staff,13,0,30,17
1650324776651,MATH 20C,B02,083763,Staff,28,0,30,2
1650324782676,MATH 20D,A01,083765,Staff,0,1,30,30
1650324782676,MATH 20D,A02,083766,Staff,7,0,30,23
1650324782676,MATH 20D,A03,083767,Staff,26,0,30,4
1650324788704,MATH 20E,A01,083771,Staff,5,0,30,25
1650324788704,MATH 20E,A02,083772,Staff,19,0,30,11
1650324788704,MATH 20E,B01,083773,Staff,0,0,30,30
1650324788704,MATH 20E,B02,083774,Staff,12,0,30,18
1650324794734,MATH 103A,A01,083777,Staff,0,13,30,30
1650324794734,MATH 103A,A02,083778,Staff,0,12,30,30
1650324794734,MATH 103A,B01,083779,Staff,0,12,30,30
1650324794734,MATH 103A,B02,083780,Staff,0,11,30,30
1650324800759,MATH 105,A01,085443,Staff,0,19,30,30
1650324806789,MATH 109,A01,083213,Anzaldo; Leesa B,0,5,30,30
1650324806789,MATH 109,A02,083214,Anzaldo; Leesa B,0,7,30,30
1650324806789,MATH 109,B01,083215,Anzaldo; Leesa B,0,4,30,30
1650324806789,MATH 109,B02,083216,Anzaldo; Leesa B,0,4,30,30
1650324812817,MATH 142A,A01,083219,Chow; Bennett,0,14,30,30
1650324812817,MATH 142A,A02,083220,Chow; Bennett,0,12,30,30
1650324812817,MATH 142A,B01,083221,Chow; Bennett,0,12,30,30
1650324812817,MATH 142A,B02,083222,Chow; Bennett,0,12,30,30
1650324818844,MATH 193A,A01,083224,Staff,0,5,30,30
1650324818844,MATH 193A,A02,083225,Staff,0,5,30,30
1650324818844,MATH 193A,A03,083781,Staff,0,2,30,30
1650324818844,MATH 193A,A04,083782,Staff,0,3,30,30
1650324824871,MATH 197,001,091859,McAuley; Julian John,9998,0,9999,1
1650324830927,COGS 9,A01,083615,Staff,0,15,60,60
1650324836951,COGS 11,A01,083617,Boyle; Mary E. T.,22,0,40,18
1650324843004,COGS 13,A01,083071,Staff,0,31,40,40
1650324849028,COGS 14A,A01,092681,Staff,0,18,100,100
1650324855057,COGS 14B,A01,083073,Cheng; Tzu-Han,0,10,50,50
1650324861098,COGS 17,A01,092677,Staff,25,0,75,50
1650324867128,COGS 100,A01,083619,Staff,0,23,60,60
1650324873164,COGS 101A,A01,083621,Davis; Joshua Daniel,1,22,60,59
1650324879191,COGS 101B,A01,091572,Staff,2,0,60,58
1650324885214,COGS 101C,A01,083625,Delgado; Tania,18,0,30,12
1650324891246,COGS 107A,A01,083627,Boyle; Mary E. T.,0,8,60,60
1650324897272,COGS 118A,A01,083075,Staff,5,0,60,55
1650324903295,CSE 3,A50,083646,Miranda; Gregory Joseph,21,0,38,17
1650324903295,CSE 3,A51,083647,Miranda; Gregory Joseph,37,0,37,0
1650324909320,CSE 8A,A50,083650,Miranda; Gregory Joseph,0,27,40,40
1650324915347,CSE 11,A01,083080,Cao; Yingjun,0,85,40,40
1650324921373,CSE 12,A01,083652,Staff,0,10,100,100
1650324927398,CSE 15L,A01,083654,Staff,0,1,50,50
1650324927398,CSE 15L,A02,083655,Staff,4,0,50,46
1650324933423,CSE 20,A01,083657,Staff,53,0,80,27
1650324939448,CSE 30,A01,083084,Eldon; John,0,75,40,40
1650324945488,CSE 100,A01,083659,Cao; Yingjun,0,66,50,50
1650324951511,CSE 134B,A01,083661,Powell; Thomas Allan,0,30,65,65
1650324957537,CSE 140,A01,083663,Staff,0,0,75,75
1650324963568,CSE 140L,A01,083088,Eldon; John,0,6,75,75
1650324969590,CSE 175,A01,083665,Kumar; Rakesh,8,0,25,17
1650324975613,CSE 190,A00,092507,Dubnov; Shlomo,14,0,20,6
1650324981641,ECE 45,A01,083139,Staff,0,16,40,40
1650324987683,ECE 65,A50,083695,Staff,0,5,30,30
1650324993708,ECE 109,A01,091882,Touri; Behrouz,41,0,70,29
1650324999740,ECE 180,A00,083140,Abi Samra; Nicholas Camill,23,0,30,7
1650324999740,ECE 180,B00,083141,Abi Samra; Nicholas Camill,5,0,30,25
1650325005767,MATH 10A,A01,083735,Patchell; Gregory David,8,0,30,22
1650325005767,MATH 10A,A02,083736,Patchell; Gregory David,28,0,30,2
1650325005767,MATH 10A,A03,083737,Patchell; Gregory David,26,0,30,4
1650325011792,MATH 10B,A01,083207,Staff,0,6,30,30
1650325011792,MATH 10B,A02,083208,Staff,0,6,30,30
1650325011792,MATH 10B,B01,083739,Staff,17,0,30,13
1650325011792,MATH 10B,B02,083740,Staff,28,0,30,2
1650325017821,MATH 18,A01,083743,Staff,5,0,30,25
1650325017821,MATH 18,A02,083744,Staff,26,0,30,4
1650325017821,MATH 18,A03,083745,Staff,22,0,30,8
1650325017821,MATH 18,A04,083746,Staff,27,0,30,3
1650325017821,MATH 18,B01,083748,Staff,0,11,30,30
1650325017821,MATH 18,B02,083749,Staff,0,11,30,30
1650325017821,MATH 18,B03,083750,Staff,1,11,30,29
1650325017821,MATH 18,B04,083751,Staff,0,10,30,30
1650325023846,MATH 20A,A01,083754,Staff,26,0,40,14
1650325029874,MATH 20B,A01,083756,Staff,0,7,30,30
1650325029874,MATH 20B,A02,083757,Staff,0,8,30,30
1650325035986,MATH 20C,A01,083760,Staff,0,13,30,30
1650325035986,MATH 20C,A02,083761,Staff,0,13,30,30
1650325035986,MATH 20C,B01,083762,Staff,13,0,30,17
1650325035986,MATH 20C,B02,083763,Staff,28,0,30,2
1650325042018,MATH 20D,A01,083765,Staff,0,1,30,30
1650325042018,MATH 20D,A02,083766,Staff,7,0,30,23
1650325042018,MATH 20D,A03,083767,Staff,26,0,30,4
1650325048043,MATH 20E,A01,083771,Staff,5,0,30,25
1650325048043,MATH 20E,A02,083772,Staff,19,0,30,11
1650325048043,MATH 20E,B01,083773,Staff,0,0,30,30
1650325048043,MATH 20E,B02,083774,Staff,12,0,30,18
1650325054070,MATH 103A,A01,083777,Staff,0,12,30,30
1650325054070,MATH 103A,A02,083778,Staff,0,12,30,30
1650325054070,MATH 103A,B01,083779,Staff,0,12,30,30
1650325054070,MATH 103A,B02,083780,Staff,0,11,30,30
1650325060095,MATH 105,A01,085443,Staff,0,19,30,30
1650325066123,MATH 109,A01,083213,Anzaldo; Leesa B,0,5,30,30
1650325066123,MATH 109,A02,083214,Anzaldo; Leesa B,0,7,30,30
1650325066123,MATH 109,B01,083215,Anzaldo; Leesa B,0,4,30,30
1650325066123,MATH 109,B02,083216,Anzaldo; Leesa B,0,4,30,30
1650325072156,MATH 142A,A01,083219,Chow; Bennett,0,14,30,30
1650325072156,MATH 142A,A02,083220,Chow; Bennett,0,12,30,30
1650325072156,MATH 142A,B01,083221,Chow; Bennett,0,12,30,30
1650325072156,MATH 142A,B02,083222,Chow; Bennett,0,12,30,30
1650325078182,MATH 193A,A01,083224,Staff,0,5,30,30
1650325078182,MATH 193A,A02,083225,Staff,0,5,30,30
1650325078182,MATH 193A,A03,083781,Staff,0,2,30,30
1650325078182,MATH 193A,A04,083782,Staff,0,3,30,30
1650325084207,MATH 197,001,091859,McAuley; Julian John,9998,0,9999,1
1650325090258,COGS 9,A01,083615,Staff,0,15,60,60
1650325096283,COGS 11,A01,083617,Boyle; Mary E. T.,22,0,40,18
1650325102305,COGS 13,A01,083071,Staff,0,31,40,40
1650325108327,COGS 14A,A01,092681,Staff,0,18,100,100
1650325114359,COGS 14B,A01,083073,Cheng; Tzu-Han,0,10,50,50
1650325120383,COGS 17,A01,092677,Staff,25,0,75,50
1650325126410,COGS 100,A01,083619,Staff,0,23,60,60
1650325132439,COGS 101A,A01,083621,Davis; Joshua Daniel,1,22,60,59
1650325138464,COGS 101B,A01,091572,Staff,2,0,60,58
1650325144497,COGS 101C,A01,083625,Delgado; Tania,18,0,30,12
1650325150528,COGS 107A,A01,083627,Boyle; Mary E. T.,0,8,60,60
1650325156554,COGS 118A,A01,083075,Staff,5,0,60,55
1650325162583,CSE 3,A50,083646,Miranda; Gregory Joseph,21,0,38,17
1650325162583,CSE 3,A51,083647,Miranda; Gregory Joseph,37,0,37,0
1650325168608,CSE 8A,A50,083650,Miranda; Gregory Joseph,0,27,40,40
1650325174631,CSE 11,A01,083080,Cao; Yingjun,0,85,40,40
1650325180667,CSE 12,A01,083652,Staff,0,10,100,100
1650325186691,CSE 15L,A01,083654,Staff,0,1,50,50
1650325186691,CSE 15L,A02,083655,Staff,4,0,50,46
1650325192718,CSE 20,A01,083657,Staff,53,0,80,27
1650325198743,CSE 30,A01,083084,Eldon; John,0,75,40,40
1650325204773,CSE 100,A01,083659,Cao; Yingjun,0,66,50,50
1650325210797,CSE 134B,A01,083661,Powell; Thomas Allan,0,30,65,65
1650325216829,CSE 140,A01,083663,Staff,0,0,75,75
1650325222854,CSE 140L,A01,083088,Eldon; John,0,6,75,75
1650325228876,CSE 175,A01,083665,Kumar; Rakesh,8,0,25,17
1650325234904,CSE 190,A00,092507,Dubnov; Shlomo,14,0,20,6
1650325240937,ECE 45,A01,083139,Staff,0,16,40,40
1650325246972,ECE 65,A50,083695,Staff,0,5,30,30
1650325252996,ECE 109,A01,091882,Touri; Behrouz,41,0,70,29
1650325259020,ECE 180,A00,083140,Abi Samra; Nicholas Camill,23,0,30,7
1650325259020,ECE 180,B00,083141,Abi Samra; Nicholas Camill,5,0,30,25
1650325265052,MATH 10A,A01,083735,Patchell; Gregory David,8,0,30,22
1650325265052,MATH 10A,A02,083736,Patchell; Gregory David,28,0,30,2
1650325265052,MATH 10A,A03,083737,Patchell; Gregory David,26,0,30,4
1650325271090,MATH 10B,A01,083207,Staff,0,6,30,30
1650325271090,MATH 10B,A02,083208,Staff,0,6,30,30
1650325271090,MATH 10B,B01,083739,Staff,17,0,30,13
1650325271090,MATH 10B,B02,083740,Staff,28,0,30,2
1650325277123,MATH 18,A01,083743,Staff,5,0,30,25
1650325277123,MATH 18,A02,083744,Staff,26,0,30,4
1650325277123,MATH 18,A03,083745,Staff,22,0,30,8
1650325277123,MATH 18,A04,083746,Staff,27,0,30,3
1650325277123,MATH 18,B01,083748,Staff,0,11,30,30
1650325277123,MATH 18,B02,083749,Staff,0,11,30,30
1650325277123,MATH 18,B03,083750,Staff,1,11,30,29
1650325277123,MATH 18,B04,083751,Staff,0,10,30,30
1650325283146,MATH 20A,A01,083754,Staff,26,0,40,14
1650325289168,MATH 20B,A01,083756,Staff,0,7,30,30
1650325289168,MATH 20B,A02,083757,Staff,0,8,30,30
1650325295206,MATH 20C,A01,083760,Staff,0,13,30,30
1650325295206,MATH 20C,A02,083761,Staff,0,13,30,30
1650325295206,MATH 20C,B01,083762,Staff,13,0,30,17
1650325295206,MATH 20C,B02,083763,Staff,28,0,30,2
1650325301237,MATH 20D,A01,083765,Staff,0,1,30,30
1650325301237,MATH 20D,A02,083766,Staff,7,0,30,23
1650325301237,MATH 20D,A03,083767,Staff,26,0,30,4
1650325307262,MATH 20E,A01,083771,Staff,5,0,30,25
1650325307262,MATH 20E,A02,083772,Staff,19,0,30,11
1650325307262,MATH 20E,B01,083773,Staff,0,0,30,30
1650325307262,MATH 20E,B02,083774,Staff,12,0,30,18
1650325313306,MATH 103A,A01,083777,Staff,0,12,30,30
1650325313306,MATH 103A,A02,083778,Staff,0,12,30,30
1650325313306,MATH 103A,B01,083779,Staff,0,12,30,30
1650325313306,MATH 103A,B02,083780,Staff,0,11,30,30
1650325319330,MATH 105,A01,085443,Staff,0,19,30,30
1650325325355,MATH 109,A01,083213,Anzaldo; Leesa B,0,5,30,30
1650325325355,MATH 109,A02,083214,Anzaldo; Leesa B,0,7,30,30
1650325325355,MATH 109,B01,083215,Anzaldo; Leesa B,0,4,30,30
1650325325355,MATH 109,B02,083216,Anzaldo; Leesa B,0,4,30,30
1650325331388,MATH 142A,A01,083219,Chow; Bennett,0,14,30,30
1650325331388,MATH 142A,A02,083220,Chow; Bennett,0,12,30,30
1650325331388,MATH 142A,B01,083221,Chow; Bennett,0,12,30,30
1650325331388,MATH 142A,B02,083222,Chow; Bennett,0,12,30,30
1650325337410,MATH 193A,A01,083224,Staff,0,5,30,30
1650325337410,MATH 193A,A02,083225,Staff,0,5,30,30
1650325337410,MATH 193A,A03,083781,Staff,0,3,30,30
1650325337410,MATH 193A,A04,083782,Staff,0,3,30,30
1650325343433,MATH 197,001,091859,McAuley; Julian John,9998,0,9999,1
1650325349496,COGS 9,A01,083615,Staff,0,15,60,60
1650325355524,COGS 11,A01,083617,Boyle; Mary E. T.,22,0,40,18
1650325361559,COGS 13,A01,083071,Staff,0,31,40,40
1650325367582,COGS 14A,A01,092681,Staff,0,18,100,100
1650325373614,COGS 14B,A01,083073,Cheng; Tzu-Han,0,10,50,50
1650325379645,COGS 17,A01,092677,Staff,25,0,75,50
1650325385672,COGS 100,A01,083619,Staff,0,23,60,60
1650325391699,COGS 101A,A01,083621,Davis; Joshua Daniel,1,22,60,59
1650325397731,COGS 101B,A01,091572,Staff,2,0,60,58
1650325403764,COGS 101C,A01,083625,Delgado; Tania,18,0,30,12
1650325409789,COGS 107A,A01,083627,Boyle; Mary E. T.,0,8,60,60
1650325415816,COGS 118A,A01,083075,Staff,5,0,60,55
1650325421848,CSE 3,A50,083646,Miranda; Gregory Joseph,21,0,38,17
1650325421848,CSE 3,A51,083647,Miranda; Gregory Joseph,37,0,37,0
1650325427888,CSE 8A,A50,083650,Miranda; Gregory Joseph,0,27,40,40
1650325433923,CSE 11,A01,083080,Cao; Yingjun,0,86,40,40
1650325439947,CSE 12,A01,083652,Staff,0,10,100,100
1650325445970,CSE 15L,A01,083654,Staff,0,1,50,50
1650325445970,CSE 15L,A02,083655,Staff,4,0,50,46
1650325452001,CSE 20,A01,083657,Staff,53,0,80,27
1650325458024,CSE 30,A01,083084,Eldon; John,0,75,40,40
1650325464050,CSE 100,A01,083659,Cao; Yingjun,0,66,50,50
1650325470076,CSE 134B,A01,083661,Powell; Thomas Allan,0,30,65,65
1650325476113,CSE 140,A01,083663,Staff,0,0,75,75
1650325482139,CSE 140L,A01,083088,Eldon; John,0,6,75,75
1650325488165,CSE 175,A01,083665,Kumar; Rakesh,8,0,25,17
1650325494193,CSE 190,A00,092507,Dubnov; Shlomo,14,0,20,6
1650325500217,ECE 45,A01,083139,Staff,0,16,40,40
1650325506246,ECE 65,A50,083695,Staff,0,5,30,30
1650325512272,ECE 109,A01,091882,Touri; Behrouz,41,0,70,29
1650325518297,ECE 180,A00,083140,Abi Samra; Nicholas Camill,23,0,30,7
1650325518297,ECE 180,B00,083141,Abi Samra; Nicholas Camill,5,0,30,25
1650325524322,MATH 10A,A01,083735,Patchell; Gregory David,8,0,30,22
1650325524322,MATH 10A,A02,083736,Patchell; Gregory David,28,0,30,2
1650325524322,MATH 10A,A03,083737,Patchell; Gregory David,26,0,30,4
1650325530350,MATH 10B,A01,083207,Staff,0,6,30,30
1650325530350,MATH 10B,A02,083208,Staff,0,6,30,30
1650325530350,MATH 10B,B01,083739,Staff,17,0,30,13
1650325530350,MATH 10B,B02,083740,Staff,28,0,30,2
1650325536376,MATH 18,A01,083743,Staff,5,0,30,25
1650325536376,MATH 18,A02,083744,Staff,26,0,30,4
1650325536376,MATH 18,A03,083745,Staff,22,0,30,8
1650325536376,MATH 18,A04,083746,Staff,27,0,30,3
1650325536376,MATH 18,B01,083748,Staff,0,11,30,30
1650325536376,MATH 18,B02,083749,Staff,0,11,30,30
1650325536376,MATH 18,B03,083750,Staff,1,11,30,29
1650325536376,MATH 18,B04,083751,Staff,0,10,30,30
1650325542405,MATH 20A,A01,083754,Staff,26,0,40,14
1650325548430,MATH 20B,A01,083756,Staff,0,7,30,30
1650325548430,MATH 20B,A02,083757,Staff,0,8,30,30
1650325554456,MATH 20C,A01,083760,Staff,0,13,30,30
1650325554456,MATH 20C,A02,083761,Staff,0,13,30,30
1650325554456,MATH 20C,B01,083762,Staff,13,0,30,17
1650325554456,MATH 20C,B02,083763,Staff,28,0,30,2
1650325560483,MATH 20D,A01,083765,Staff,0,1,30,30
1650325560483,MATH 20D,A02,083766,Staff,7,0,30,23
1650325560483,MATH 20D,A03,083767,Staff,26,0,30,4
1650325566509,MATH 20E,A01,083771,Staff,5,0,30,25
1650325566509,MATH 20E,A02,083772,Staff,19,0,30,11
1650325566509,MATH 20E,B01,083773,Staff,0,0,30,30
1650325566509,MATH 20E,B02,083774,Staff,12,0,30,18
1650325572537,MATH 103A,A01,083777,Staff,0,12,30,30
1650325572537,MATH 103A,A02,083778,Staff,0,12,30,30
1650325572537,MATH 103A,B01,083779,Staff,0,12,30,30
1650325572537,MATH 103A,B02,083780,Staff,0,11,30,30
1650325578576,MATH 105,A01,085443,Staff,0,19,30,30
1650325584599,MATH 109,A01,083213,Anzaldo; Leesa B,0,5,30,30
1650325584599,MATH 109,A02,083214,Anzaldo; Leesa B,0,7,30,30
1650325584599,MATH 109,B01,083215,Anzaldo; Leesa B,0,4,30,30
1650325584599,MATH 109,B02,083216,Anzaldo; Leesa B,0,4,30,30
1650325590624,MATH 142A,A01,083219,Chow; Bennett,0,14,30,30
1650325590624,MATH 142A,A02,083220,Chow; Bennett,0,12,30,30
1650325590624,MATH 142A,B01,083221,Chow; Bennett,0,12,30,30
1650325590624,MATH 142A,B02,083222,Chow; Bennett,0,12,30,30
1650325596662,MATH 193A,A01,083224,Staff,0,5,30,30
1650325596662,MATH 193A,A02,083225,Staff,0,5,30,30
1650325596662,MATH 193A,A03,083781,Staff,0,3,30,30
1650325596662,MATH 193A,A04,083782,Staff,0,3,30,30
1650325602688,MATH 197,001,091859,McAuley; Julian John,9998,0,9999,1
1650325608739,COGS 9,A01,083615,Staff,0,15,60,60
1650325614765,COGS 11,A01,083617,Boyle; Mary E. T.,22,0,40,18
1650325620789,COGS 13,A01,083071,Staff,0,31,40,40
1650325626905,COGS 14A,A01,092681,Staff,0,18,100,100
1650325632944,COGS 14B,A01,083073,Cheng; Tzu-Han,0,10,50,50
1650325638968,COGS 17,A01,092677,Staff,25,0,75,50
1650325644995,COGS 100,A01,083619,Staff,0,23,60,60
1650325651025,COGS 101A,A01,083621,Davis; Joshua Daniel,1,22,60,59
1650325657076,COGS 101B,A01,091572,Staff,2,0,60,58
1650325663118,COGS 101C,A01,083625,Delgado; Tania,18,0,30,12
1650325669143,COGS 107A,A01,083627,Boyle; Mary E. T.,0,8,60,60
1650325675171,COGS 118A,A01,083075,Staff,5,0,60,55
1650325681197,CSE 3,A50,083646,Miranda; Gregory Joseph,21,0,38,17
1650325681197,CSE 3,A51,083647,Miranda; Gregory Joseph,37,0,37,0
1650325687235,CSE 8A,A50,083650,Miranda; Gregory Joseph,0,27,40,40
1650325693258,CSE 11,A01,083080,Cao; Yingjun,0,87,40,40
1650325699283,CSE 12,A01,083652,Staff,0,10,100,100
1650325705309,CSE 15L,A01,083654,Staff,0,1,50,50
1650325705309,CSE 15L,A02,083655,Staff,4,0,50,46
1650325711341,CSE 20,A01,083657,Staff,53,0,80,27
1650325717365,CSE 30,A01,083084,Eldon; John,0,75,40,40
1650325723387,CSE 100,A01,083659,Cao; Yingjun,0,66,50,50
1650325729412,CSE 134B,A01,083661,Powell; Thomas Allan,0,30,65,65
1650325735437,CSE 140,A01,083663,Staff,0,0,75,75
1650325741464,CSE 140L,A01,083088,Eldon; John,0,6,75,75
1650325747497,CSE 175,A01,083665,Kumar; Rakesh,8,0,25,17
1650325753523,CSE 190,A00,092507,Dubnov; Shlomo,14,0,20,6
1650325759545,ECE 45,A01,083139,Staff,0,16,40,40
1650325765572,ECE 65,A50,083695,Staff,0,5,30,30
1650325771595,ECE 109,A01,091882,Touri; Behrouz,41,0,70,29
1650325777621,ECE 180,A00,083140,Abi Samra; Nicholas Camill,23,0,30,7
1650325777621,ECE 180,B00,083141,Abi Samra; Nicholas Camill,5,0,30,25
1650325783651,MATH 10A,A01,083735,Patchell; Gregory David,8,0,30,22
1650325783651,MATH 10A,A02,083736,Patchell; Gregory David,28,0,30,2
1650325783651,MATH 10A,A03,083737,Patchell; Gregory David,26,0,30,4
1650325789683,MATH 10B,A01,083207,Staff,0,7,30,30
1650325789683,MATH 10B,A02,083208,Staff,0,6,30,30
1650325789683,MATH 10B,B01,083739,Staff,17,0,30,13
1650325789683,MATH 10B,B02,083740,Staff,28,0,30,2
1650325795709,MATH 18,A01,083743,Staff,5,0,30,25
1650325795709,MATH 18,A02,083744,Staff,26,0,30,4
1650325795709,MATH 18,A03,083745,Staff,22,0,30,8
1650325795709,MATH 18,A04,083746,Staff,27,0,30,3
1650325795709,MATH 18,B01,083748,Staff,0,11,30,30
1650325795709,MATH 18,B02,083749,Staff,0,11,30,30
1650325795709,MATH 18,B03,083750,Staff,1,11,30,29
1650325795709,MATH 18,B04,083751,Staff,0,10,30,30
1650325801736,MATH 20A,A01,083754,Staff,26,0,40,14
1650325807762,MATH 20B,A01,083756,Staff,0,7,30,30
1650325807762,MATH 20B,A02,083757,Staff,0,8,30,30
1650325813786,MATH 20C,A01,083760,Staff,0,13,30,30
1650325813786,MATH 20C,A02,083761,Staff,0,13,30,30
1650325813786,MATH 20C,B01,083762,Staff,13,0,30,17
1650325813786,MATH 20C,B02,083763,Staff,28,0,30,2
1650325819813,MATH 20D,A01,083765,Staff,0,1,30,30
1650325819813,MATH 20D,A02,083766,Staff,7,0,30,23
1650325819813,MATH 20D,A03,083767,Staff,26,0,30,4
1650325825845,MATH 20E,A01,083771,Staff,5,0,30,25
1650325825845,MATH 20E,A02,083772,Staff,19,0,30,11
1650325825845,MATH 20E,B01,083773,Staff,0,0,30,30
1650325825845,MATH 20E,B02,083774,Staff,12,0,30,18
1650325841277,MATH 103A,A01,083777,Staff,0,12,30,30
1650325841277,MATH 103A,A02,083778,Staff,0,12,30,30
1650325841277,MATH 103A,B01,083779,Staff,0,12,30,30
1650325841277,MATH 103A,B02,083780,Staff,0,11,30,30
1650325847299,MATH 105,A01,085443,Staff,0,19,30,30
1650325853321,MATH 109,A01,083213,Anzaldo; Leesa B,0,5,30,30
1650325853321,MATH 109,A02,083214,Anzaldo; Leesa B,0,7,30,30
1650325853321,MATH 109,B01,083215,Anzaldo; Leesa B,0,4,30,30
1650325853321,MATH 109,B02,083216,Anzaldo; Leesa B,0,4,30,30
1650325859346,MATH 142A,A01,083219,Chow; Bennett,0,14,30,30
1650325859346,MATH 142A,A02,083220,Chow; Bennett,0,12,30,30
1650325859346,MATH 142A,B01,083221,Chow; Bennett,0,12,30,30
1650325859346,MATH 142A,B02,083222,Chow; Bennett,0,12,30,30
1650325865371,MATH 193A,A01,083224,Staff,0,5,30,30
1650325865371,MATH 193A,A02,083225,Staff,0,5,30,30
1650325865371,MATH 193A,A03,083781,Staff,0,3,30,30
1650325865371,MATH 193A,A04,083782,Staff,0,3,30,30
1650325871398,MATH 197,001,091859,McAuley; Julian John,9998,0,9999,1
1650325877455,COGS 9,A01,083615,Staff,0,15,60,60
1650325883481,COGS 11,A01,083617,Boyle; Mary E. T.,22,0,40,18
1650325889509,COGS 13,A01,083071,Staff,0,31,40,40
1650325895531,COGS 14A,A01,092681,Staff,0,19,100,100
1650325901555,COGS 14B,A01,083073,Cheng; Tzu-Han,0,10,50,50
1650325907590,COGS 17,A01,092677,Staff,25,0,75,50
1650325913618,COGS 100,A01,083619,Staff,0,23,60,60
1650325919643,COGS 101A,A01,083621,Davis; Joshua Daniel,1,22,60,59
1650325925667,COGS 101B,A01,091572,Staff,2,0,60,58
1650325931695,COGS 101C,A01,083625,Delgado; Tania,18,0,30,12
1650325937722,COGS 107A,A01,083627,Boyle; Mary E. T.,0,8,60,60
1650325943751,COGS 118A,A01,083075,Staff,5,0,60,55
1650325949774,CSE 3,A50,083646,Miranda; Gregory Joseph,21,0,38,17
1650325949774,CSE 3,A51,083647,Miranda; Gregory Joseph,37,0,37,0
1650325955807,CSE 8A,A50,083650,Miranda; Gregory Joseph,0,27,40,40
1650325961832,CSE 11,A01,083080,Cao; Yingjun,0,87,40,40
1650325967855,CSE 12,A01,083652,Staff,0,10,100,100
1650325973879,CSE 15L,A01,083654,Staff,0,1,50,50
1650325973879,CSE 15L,A02,083655,Staff,4,0,50,46
1650325979912,CSE 20,A01,083657,Staff,53,0,80,27
1650325985943,CSE 30,A01,083084,Eldon; John,0,75,40,40
1650325991966,CSE 100,A01,083659,Cao; Yingjun,0,66,50,50
1650325997989,CSE 134B,A01,083661,Powell; Thomas Allan,0,30,65,65
1650326004020,CSE 140,A01,083663,Staff,0,0,75,75
1650326010050,CSE 140L,A01,083088,Eldon; John,0,6,75,75
1650326016078,CSE 175,A01,083665,Kumar; Rakesh,8,0,25,17
1650326022105,CSE 190,A00,092507,Dubnov; Shlomo,14,0,20,6
1650326028128,ECE 45,A01,083139,Staff,0,16,40,40
1650326034152,ECE 65,A50,083695,Staff,0,5,30,30
1650326040176,ECE 109,A01,091882,Touri; Behrouz,41,0,70,29
1650326046204,ECE 180,A00,083140,Abi Samra; Nicholas Camill,23,0,30,7
1650326046204,ECE 180,B00,083141,Abi Samra; Nicholas Camill,5,0,30,25
1650326052229,MATH 10A,A01,083735,Patchell; Gregory David,8,0,30,22
1650326052229,MATH 10A,A02,083736,Patchell; Gregory David,28,0,30,2
1650326052229,MATH 10A,A03,083737,Patchell; Gregory David,26,0,30,4
1650326058257,MATH 10B,A01,083207,Staff,0,7,30,30
1650326058257,MATH 10B,A02,083208,Staff,0,6,30,30
1650326058257,MATH 10B,B01,083739,Staff,17,0,30,13
1650326058257,MATH 10B,B02,083740,Staff,28,0,30,2
1650326064281,MATH 18,A01,083743,Staff,5,0,30,25
1650326064281,MATH 18,A02,083744,Staff,26,0,30,4
1650326064281,MATH 18,A03,083745,Staff,22,0,30,8
1650326064281,MATH 18,A04,083746,Staff,27,0,30,3
1650326064281,MATH 18,B01,083748,Staff,0,11,30,30
1650326064281,MATH 18,B02,083749,Staff,0,11,30,30
1650326064281,MATH 18,B03,083750,Staff,1,11,30,29
1650326064281,MATH 18,B04,083751,Staff,0,10,30,30
1650326070316,MATH 20A,A01,083754,Staff,26,0,40,14
1650326076339,MATH 20B,A01,083756,Staff,0,7,30,30
1650326076339,MATH 20B,A02,083757,Staff,0,8,30,30
1650326082371,MATH 20C,A01,083760,Staff,0,13,30,30
1650326082371,MATH 20C,A02,083761,Staff,0,13,30,30
1650326082371,MATH 20C,B01,083762,Staff,13,0,30,17
1650326082371,MATH 20C,B02,083763,Staff,28,0,30,2
1650326088397,MATH 20D,A01,083765,Staff,0,1,30,30
1650326088397,MATH 20D,A02,083766,Staff,7,0,30,23
1650326088397,MATH 20D,A03,083767,Staff,26,0,30,4
1650326094420,MATH 20E,A01,083771,Staff,5,0,30,25
1650326094420,MATH 20E,A02,083772,Staff,19,0,30,11
1650326094420,MATH 20E,B01,083773,Staff,0,0,30,30
1650326094420,MATH 20E,B02,083774,Staff,12,0,30,18
1650326100445,MATH 103A,A01,083777,Staff,0,12,30,30
1650326100445,MATH 103A,A02,083778,Staff,0,12,30,30
1650326100445,MATH 103A,B01,083779,Staff,0,12,30,30
1650326100445,MATH 103A,B02,083780,Staff,0,11,30,30
1650326106468,MATH 105,A01,085443,Staff,0,19,30,30
1650326112502,MATH 109,A01,083213,Anzaldo; Leesa B,0,5,30,30
1650326112502,MATH 109,A02,083214,Anzaldo; Leesa B,0,7,30,30
1650326112502,MATH 109,B01,083215,Anzaldo; Leesa B,0,4,30,30
1650326112502,MATH 109,B02,083216,Anzaldo; Leesa B,0,4,30,30
1650326118529,MATH 142A,A01,083219,Chow; Bennett,0,14,30,30
1650326118529,MATH 142A,A02,083220,Chow; Bennett,0,12,30,30
1650326118529,MATH 142A,B01,083221,Chow; Bennett,0,12,30,30
1650326118529,MATH 142A,B02,083222,Chow; Bennett,0,12,30,30
1650326124562,MATH 193A,A01,083224,Staff,0,5,30,30
1650326124562,MATH 193A,A02,083225,Staff,0,5,30,30
1650326124562,MATH 193A,A03,083781,Staff,0,3,30,30
1650326124562,MATH 193A,A04,083782,Staff,0,3,30,30
1650326130584,MATH 197,001,091859,McAuley; Julian John,9998,0,9999,1
1650326136635,COGS 9,A01,083615,Staff,0,15,60,60
1650326142656,COGS 11,A01,083617,Boyle; Mary E. T.,22,0,40,18
1650326148678,COGS 13,A01,083071,Staff,0,31,40,40
1650326154701,COGS 14A,A01,092681,Staff,0,19,100,100
1650326160726,COGS 14B,A01,083073,Cheng; Tzu-Han,0,10,50,50
1650326166749,COGS 17,A01,092677,Staff,25,0,75,50
1650326172771,COGS 100,A01,083619,Staff,0,23,60,60
1650326178796,COGS 101A,A01,083621,Davis; Joshua Daniel,1,22,60,59
1650326184819,COGS 101B,A01,091572,Staff,2,0,60,58
1650326190841,COGS 101C,A01,083625,Delgado; Tania,18,0,30,12
1650326196864,COGS 107A,A01,083627,Boyle; Mary E. T.,0,8,60,60
1650326202896,COGS 118A,A01,083075,Staff,5,0,60,55
1650326208926,CSE 3,A50,083646,Miranda; Gregory Joseph,21,0,38,17
1650326208926,CSE 3,A51,083647,Miranda; Gregory Joseph,37,0,37,0
1650326214964,CSE 8A,A50,083650,Miranda; Gregory Joseph,0,27,40,40
1650326220990,CSE 11,A01,083080,Cao; Yingjun,0,87,40,40
1650326227012,CSE 12,A01,083652,Staff,0,10,100,100
1650326233130,CSE 15L,A01,083654,Staff,0,1,50,50
1650326233130,CSE 15L,A02,083655,Staff,4,0,50,46
1650326239164,CSE 20,A01,083657,Staff,53,0,80,27
1650326245194,CSE 30,A01,083084,Eldon; John,0,75,40,40
1650326251223,CSE 100,A01,083659,Cao; Yingjun,0,66,50,50
1650326257246,CSE 134B,A01,083661,Powell; Thomas Allan,0,30,65,65
1650326263272,CSE 140,A01,083663,Staff,0,0,75,75
1650326269300,CSE 140L,A01,083088,Eldon; John,0,6,75,75
1650326275327,CSE 175,A01,083665,Kumar; Rakesh,8,0,25,17
1650326281356,CSE 190,A00,092507,Dubnov; Shlomo,14,0,20,6
1650326287394,ECE 45,A01,083139,Staff,0,16,40,40
1650326293417,ECE 65,A50,083695,Staff,0,5,30,30
1650326299447,ECE 109,A01,091882,Touri; Behrouz,41,0,70,29
1650326305473,ECE 180,A00,083140,Abi Samra; Nicholas Camill,23,0,30,7
1650326305473,ECE 180,B00,083141,Abi Samra; Nicholas Camill,5,0,30,25
1650326311496,MATH 10A,A01,083735,Patchell; Gregory David,8,0,30,22
1650326311496,MATH 10A,A02,083736,Patchell; Gregory David,28,0,30,2
1650326311496,MATH 10A,A03,083737,Patchell; Gregory David,26,0,30,4
1650326317519,MATH 10B,A01,083207,Staff,0,7,30,30
1650326317519,MATH 10B,A02,083208,Staff,0,6,30,30
1650326317519,MATH 10B,B01,083739,Staff,17,0,30,13
1650326317519,MATH 10B,B02,083740,Staff,28,0,30,2
1650326323543,MATH 18,A01,083743,Staff,5,0,30,25
1650326323543,MATH 18,A02,083744,Staff,26,0,30,4
1650326323543,MATH 18,A03,083745,Staff,22,0,30,8
1650326323543,MATH 18,A04,083746,Staff,27,0,30,3
1650326323543,MATH 18,B01,083748,Staff,0,11,30,30
1650326323543,MATH 18,B02,083749,Staff,0,11,30,30
1650326323543,MATH 18,B03,083750,Staff,1,11,30,29
1650326323543,MATH 18,B04,083751,Staff,0,10,30,30
1650326329571,MATH 20A,A01,083754,Staff,26,0,40,14
1650326335597,MATH 20B,A01,083756,Staff,0,7,30,30
1650326335597,MATH 20B,A02,083757,Staff,0,8,30,30
1650326341623,MATH 20C,A01,083760,Staff,0,13,30,30
1650326341623,MATH 20C,A02,083761,Staff,0,13,30,30
1650326341623,MATH 20C,B01,083762,Staff,13,0,30,17
1650326341623,MATH 20C,B02,083763,Staff,28,0,30,2
1650326347645,MATH 20D,A01,083765,Staff,0,1,30,30
1650326347645,MATH 20D,A02,083766,Staff,7,0,30,23
1650326347645,MATH 20D,A03,083767,Staff,26,0,30,4
1650326353671,MATH 20E,A01,083771,Staff,5,0,30,25
1650326353671,MATH 20E,A02,083772,Staff,19,0,30,11
1650326353671,MATH 20E,B01,083773,Staff,0,0,30,30
1650326353671,MATH 20E,B02,083774,Staff,12,0,30,18
1650326359694,MATH 103A,A01,083777,Staff,0,12,30,30
1650326359694,MATH 103A,A02,083778,Staff,0,12,30,30
1650326359694,MATH 103A,B01,083779,Staff,0,12,30,30
1650326359694,MATH 103A,B02,083780,Staff,0,11,30,30
1650326365720,MATH 105,A01,085443,Staff,0,19,30,30
1650326371744,MATH 109,A01,083213,Anzaldo; Leesa B,0,5,30,30
1650326371744,MATH 109,A02,083214,Anzaldo; Leesa B,0,7,30,30
1650326371744,MATH 109,B01,083215,Anzaldo; Leesa B,0,4,30,30
1650326371744,MATH 109,B02,083216,Anzaldo; Leesa B,0,4,30,30
1650326377785,MATH 142A,A01,083219,Chow; Bennett,0,14,30,30
1650326377785,MATH 142A,A02,083220,Chow; Bennett,0,12,30,30
1650326377785,MATH 142A,B01,083221,Chow; Bennett,0,12,30,30
1650326377785,MATH 142A,B02,083222,Chow; Bennett,0,12,30,30
1650326383809,MATH 193A,A01,083224,Staff,0,5,30,30
1650326383809,MATH 193A,A02,083225,Staff,0,5,30,30
1650326383809,MATH 193A,A03,083781,Staff,0,3,30,30
1650326383809,MATH 193A,A04,083782,Staff,0,3,30,30
1650326389839,MATH 197,001,091859,McAuley; Julian John,9998,0,9999,1
1650326395890,COGS 9,A01,083615,Staff,0,15,60,60
1650326401918,COGS 11,A01,083617,Boyle; Mary E. T.,22,0,40,18
1650326407945,COGS 13,A01,083071,Staff,0,31,40,40
1650326413967,COGS 14A,A01,092681,Staff,0,19,100,100
1650326419999,COGS 14B,A01,083073,Cheng; Tzu-Han,0,10,50,50
1650326426022,COGS 17,A01,092677,Staff,25,0,75,50
1650326432045,COGS 100,A01,083619,Staff,0,23,60,60
1650326438068,COGS 101A,A01,083621,Davis; Joshua Daniel,1,22,60,59
1650326444091,COGS 101B,A01,091572,Staff,2,0,60,58
1650326450114,COGS 101C,A01,083625,Delgado; Tania,18,0,30,12
1650326456144,COGS 107A,A01,083627,Boyle; Mary E. T.,0,8,60,60
1650326462167,COGS 118A,A01,083075,Staff,5,0,60,55
1650326468197,CSE 3,A50,083646,Miranda; Gregory Joseph,21,0,38,17
1650326468197,CSE 3,A51,083647,Miranda; Gregory Joseph,37,0,37,0
1650326474220,CSE 8A,A50,083650,Miranda; Gregory Joseph,0,27,40,40
1650326480247,CSE 11,A01,083080,Cao; Yingjun,0,87,40,40
1650326486268,CSE 12,A01,083652,Staff,0,11,100,100
1650326492298,CSE 15L,A01,083654,Staff,0,1,50,50
1650326492298,CSE 15L,A02,083655,Staff,4,0,50,46
1650326498323,CSE 20,A01,083657,Staff,53,0,80,27
1650326504350,CSE 30,A01,083084,Eldon; John,0,75,40,40
1650326510379,CSE 100,A01,083659,Cao; Yingjun,0,66,50,50
1650326516405,CSE 134B,A01,083661,Powell; Thomas Allan,0,30,65,65
1650326522437,CSE 140,A01,083663,Staff,0,0,75,75
1650326528478,CSE 140L,A01,083088,Eldon; John,0,6,75,75
1650326534502,CSE 175,A01,083665,Kumar; Rakesh,8,0,25,17
1650326540529,CSE 190,A00,092507,Dubnov; Shlomo,14,0,20,6
1650326546554,ECE 45,A01,083139,Staff,0,16,40,40
1650326552580,ECE 65,A50,083695,Staff,0,5,30,30
1650326558607,ECE 109,A01,091882,Touri; Behrouz,41,0,70,29
1650326564635,ECE 180,A00,083140,Abi Samra; Nicholas Camill,23,0,30,7
1650326564635,ECE 180,B00,083141,Abi Samra; Nicholas Camill,5,0,30,25
1650326570664,MATH 10A,A01,083735,Patchell; Gregory David,8,0,30,22
1650326570664,MATH 10A,A02,083736,Patchell; Gregory David,28,0,30,2
1650326570664,MATH 10A,A03,083737,Patchell; Gregory David,26,0,30,4
1650326576689,MATH 10B,A01,083207,Staff,0,7,30,30
1650326576689,MATH 10B,A02,083208,Staff,0,6,30,30
1650326576689,MATH 10B,B01,083739,Staff,17,0,30,13
1650326576689,MATH 10B,B02,083740,Staff,28,0,30,2
1650326582714,MATH 18,A01,083743,Staff,5,0,30,25
1650326582714,MATH 18,A02,083744,Staff,26,0,30,4
1650326582714,MATH 18,A03,083745,Staff,22,0,30,8
1650326582714,MATH 18,A04,083746,Staff,27,0,30,3
1650326582714,MATH 18,B01,083748,Staff,0,11,30,30
1650326582714,MATH 18,B02,083749,Staff,0,11,30,30
1650326582714,MATH 18,B03,083750,Staff,1,11,30,29
1650326582714,MATH 18,B04,083751,Staff,0,10,30,30
1650326588743,MATH 20A,A01,083754,Staff,26,0,40,14
1650326594768,MATH 20B,A01,083756,Staff,0,7,30,30
1650326594768,MATH 20B,A02,083757,Staff,0,8,30,30
1650326600802,MATH 20C,A01,083760,Staff,0,13,30,30
1650326600802,MATH 20C,A02,083761,Staff,0,13,30,30
1650326600802,MATH 20C,B01,083762,Staff,13,0,30,17
1650326600802,MATH 20C,B02,083763,Staff,28,0,30,2
1650326606827,MATH 20D,A01,083765,Staff,0,1,30,30
1650326606827,MATH 20D,A02,083766,Staff,7,0,30,23
1650326606827,MATH 20D,A03,083767,Staff,26,0,30,4
1650326612850,MATH 20E,A01,083771,Staff,5,0,30,25
1650326612850,MATH 20E,A02,083772,Staff,19,0,30,11
1650326612850,MATH 20E,B01,083773,Staff,0,0,30,30
1650326612850,MATH 20E,B02,083774,Staff,12,0,30,18
1650326618887,MATH 103A,A01,083777,Staff,0,12,30,30
1650326618887,MATH 103A,A02,083778,Staff,0,12,30,30
1650326618887,MATH 103A,B01,083779,Staff,0,12,30,30
1650326618887,MATH 103A,B02,083780,Staff,0,11,30,30
1650326624913,MATH 105,A01,085443,Staff,0,19,30,30
1650326630936,MATH 109,A01,083213,Anzaldo; Leesa B,0,5,30,30
1650326630936,MATH 109,A02,083214,Anzaldo; Leesa B,0,7,30,30
1650326630936,MATH 109,B01,083215,Anzaldo; Leesa B,0,4,30,30
1650326630936,MATH 109,B02,083216,Anzaldo; Leesa B,0,4,30,30
1650326636960,MATH 142A,A01,083219,Chow; Bennett,0,14,30,30
1650326636960,MATH 142A,A02,083220,Chow; Bennett,0,12,30,30
1650326636960,MATH 142A,B01,083221,Chow; Bennett,0,12,30,30
1650326636960,MATH 142A,B02,083222,Chow; Bennett,0,12,30,30
1650326642989,MATH 193A,A01,083224,Staff,0,5,30,30
1650326642989,MATH 193A,A02,083225,Staff,0,5,30,30
1650326642989,MATH 193A,A03,083781,Staff,0,3,30,30
1650326642989,MATH 193A,A04,083782,Staff,0,3,30,30
1650326649013,MATH 197,001,091859,McAuley; Julian John,9998,0,9999,1
1650326655072,COGS 9,A01,083615,Staff,0,15,60,60
1650326661095,COGS 11,A01,083617,Boyle; Mary E. T.,22,0,40,18
1650326667119,COGS 13,A01,083071,Staff,0,31,40,40
1650326673148,COGS 14A,A01,092681,Staff,0,19,100,100
1650326679185,COGS 14B,A01,083073,Cheng; Tzu-Han,0,10,50,50
1650326685208,COGS 17,A01,092677,Staff,26,0,75,49
1650326691237,COGS 100,A01,083619,Staff,0,23,60,60
1650326697269,COGS 101A,A01,083621,Davis; Joshua Daniel,1,22,60,59
1650326703294,COGS 101B,A01,091572,Staff,2,0,60,58
1650326709320,COGS 101C,A01,083625,Delgado; Tania,18,0,30,12
1650326715345,COGS 107A,A01,083627,Boyle; Mary E. T.,0,8,60,60
1650326721369,COGS 118A,A01,083075,Staff,5,0,60,55
1650326727399,CSE 3,A50,083646,Miranda; Gregory Joseph,21,0,38,17
1650326727399,CSE 3,A51,083647,Miranda; Gregory Joseph,37,0,37,0
1650326733424,CSE 8A,A50,083650,Miranda; Gregory Joseph,0,27,40,40
1650326739447,CSE 11,A01,083080,Cao; Yingjun,0,87,40,40
1650326745470,CSE 12,A01,083652,Staff,0,11,100,100
1650326751497,CSE 15L,A01,083654,Staff,0,1,50,50
1650326751497,CSE 15L,A02,083655,Staff,4,0,50,46
1650326757526,CSE 20,A01,083657,Staff,53,0,80,27
1650326763563,CSE 30,A01,083084,Eldon; John,0,75,40,40
1650326769585,CSE 100,A01,083659,Cao; Yingjun,0,66,50,50
1650326775608,CSE 134B,A01,083661,Powell; Thomas Allan,0,30,65,65
1650326781634,CSE 140,A01,083663,Staff,0,0,75,75
1650326787661,CSE 140L,A01,083088,Eldon; John,0,6,75,75
1650326793683,CSE 175,A01,083665,Kumar; Rakesh,8,0,25,17
1650326799710,CSE 190,A00,092507,Dubnov; Shlomo,14,0,20,6
1650326805743,ECE 45,A01,083139,Staff,0,16,40,40
1650326811787,ECE 65,A50,083695,Staff,0,5,30,30
1650326817814,ECE 109,A01,091882,Touri; Behrouz,41,0,70,29
1650326823840,ECE 180,A00,083140,Abi Samra; Nicholas Camill,23,0,30,7
1650326823840,ECE 180,B00,083141,Abi Samra; Nicholas Camill,5,0,30,25
1650326829946,MATH 10A,A01,083735,Patchell; Gregory David,8,0,30,22
1650326829946,MATH 10A,A02,083736,Patchell; Gregory David,28,0,30,2
1650326829946,MATH 10A,A03,083737,Patchell; Gregory David,26,0,30,4
1650326835981,MATH 10B,A01,083207,Staff,0,7,30,30
1650326835981,MATH 10B,A02,083208,Staff,0,6,30,30
1650326835981,MATH 10B,B01,083739,Staff,17,0,30,13
1650326835981,MATH 10B,B02,083740,Staff,28,0,30,2
1650326842008,MATH 18,A01,083743,Staff,5,0,30,25
1650326842008,MATH 18,A02,083744,Staff,26,0,30,4
1650326842008,MATH 18,A03,083745,Staff,22,0,30,8
1650326842008,MATH 18,A04,083746,Staff,27,0,30,3
1650326842008,MATH 18,B01,083748,Staff,0,11,30,30
1650326842008,MATH 18,B02,083749,Staff,0,11,30,30
1650326842008,MATH 18,B03,083750,Staff,1,11,30,29
1650326842008,MATH 18,B04,083751,Staff,0,10,30,30
1650326848033,MATH 20A,A01,083754,Staff,26,0,40,14
1650326854063,MATH 20B,A01,083756,Staff,0,7,30,30
1650326854063,MATH 20B,A02,083757,Staff,0,8,30,30
1650326860090,MATH 20C,A01,083760,Staff,0,13,30,30
1650326860090,MATH 20C,A02,083761,Staff,0,13,30,30
1650326860090,MATH 20C,B01,083762,Staff,13,0,30,17
1650326860090,MATH 20C,B02,083763,Staff,28,0,30,2
1650326866118,MATH 20D,A01,083765,Staff,0,1,30,30
1650326866118,MATH 20D,A02,083766,Staff,7,0,30,23
1650326866118,MATH 20D,A03,083767,Staff,26,0,30,4
1650326872143,MATH 20E,A01,083771,Staff,5,0,30,25
1650326872143,MATH 20E,A02,083772,Staff,19,0,30,11
1650326872143,MATH 20E,B01,083773,Staff,0,0,30,30
1650326872143,MATH 20E,B02,083774,Staff,12,0,30,18
1650326878170,MATH 103A,A01,083777,Staff,0,12,30,30
1650326878170,MATH 103A,A02,083778,Staff,0,12,30,30
1650326878170,MATH 103A,B01,083779,Staff,0,12,30,30
1650326878170,MATH 103A,B02,083780,Staff,0,11,30,30
1650326884198,MATH 105,A01,085443,Staff,0,19,30,30
1650326890227,MATH 109,A01,083213,Anzaldo; Leesa B,0,5,30,30
1650326890227,MATH 109,A02,083214,Anzaldo; Leesa B,0,7,30,30
1650326890227,MATH 109,B01,083215,Anzaldo; Leesa B,0,4,30,30
1650326890227,MATH 109,B02,083216,Anzaldo; Leesa B,0,4,30,30
1650326896253,MATH 142A,A01,083219,Chow; Bennett,0,14,30,30
1650326896253,MATH 142A,A02,083220,Chow; Bennett,0,12,30,30
1650326896253,MATH 142A,B01,083221,Chow; Bennett,0,12,30,30
1650326896253,MATH 142A,B02,083222,Chow; Bennett,0,12,30,30
1650326902280,MATH 193A,A01,083224,Staff,0,5,30,30
1650326902280,MATH 193A,A02,083225,Staff,0,5,30,30
1650326902280,MATH 193A,A03,083781,Staff,0,3,30,30
1650326902280,MATH 193A,A04,083782,Staff,0,3,30,30
1650326908307,MATH 197,001,091859,McAuley; Julian John,9998,0,9999,1
1650326914365,COGS 9,A01,083615,Staff,0,15,60,60
1650326920391,COGS 11,A01,083617,Boyle; Mary E. T.,22,0,40,18
1650326926417,COGS 13,A01,083071,Staff,0,31,40,40
1650326932442,COGS 14A,A01,092681,Staff,0,19,100,100
1650326938466,COGS 14B,A01,083073,Cheng; Tzu-Han,0,10,50,50
1650326944489,COGS 17,A01,092677,Staff,26,0,75,49
1650326950512,COGS 100,A01,083619,Staff,0,23,60,60
1650326956540,COGS 101A,A01,083621,Davis; Joshua Daniel,1,22,60,59
1650326962564,COGS 101B,A01,091572,Staff,2,0,60,58
1650326968590,COGS 101C,A01,083625,Delgado; Tania,18,0,30,12
1650326974618,COGS 107A,A01,083627,Boyle; Mary E. T.,0,8,60,60
1650326980646,COGS 118A,A01,083075,Staff,5,0,60,55
1650326986679,CSE 3,A50,083646,Miranda; Gregory Joseph,21,0,38,17
1650326986679,CSE 3,A51,083647,Miranda; Gregory Joseph,37,0,37,0
1650326992708,CSE 8A,A50,083650,Miranda; Gregory Joseph,0,27,40,40
1650326998736,CSE 11,A01,083080,Cao; Yingjun,0,87,40,40
1650327004760,CSE 12,A01,083652,Staff,0,11,100,100
1650327010788,CSE 15L,A01,083654,Staff,0,1,50,50
1650327010788,CSE 15L,A02,083655,Staff,4,0,50,46
1650327016814,CSE 20,A01,083657,Staff,53,0,80,27
1650327022839,CSE 30,A01,083084,Eldon; John,0,75,40,40
1650327028862,CSE 100,A01,083659,Cao; Yingjun,0,66,50,50
1650327034886,CSE 134B,A01,083661,Powell; Thomas Allan,0,30,65,65
1650327040911,CSE 140,A01,083663,Staff,0,0,75,75
1650327046937,CSE 140L,A01,083088,Eldon; John,0,6,75,75
1650327052967,CSE 175,A01,083665,Kumar; Rakesh,8,0,25,17
1650327058992,CSE 190,A00,092507,Dubnov; Shlomo,14,0,20,6
1650327065021,ECE 45,A01,083139,Staff,0,16,40,40
1650327071054,ECE 65,A50,083695,Staff,0,5,30,30
1650327077077,ECE 109,A01,091882,Touri; Behrouz,41,0,70,29
1650327083102,ECE 180,A00,083140,Abi Samra; Nicholas Camill,23,0,30,7
1650327083102,ECE 180,B00,083141,Abi Samra; Nicholas Camill,5,0,30,25
1650327089130,MATH 10A,A01,083735,Patchell; Gregory David,8,0,30,22
1650327089130,MATH 10A,A02,083736,Patchell; Gregory David,28,0,30,2
1650327089130,MATH 10A,A03,083737,Patchell; Gregory David,26,0,30,4
1650327095159,MATH 10B,A01,083207,Staff,0,7,30,30
1650327095159,MATH 10B,A02,083208,Staff,0,6,30,30
1650327095159,MATH 10B,B01,083739,Staff,17,0,30,13
1650327095159,MATH 10B,B02,083740,Staff,28,0,30,2
1650327101196,MATH 18,A01,083743,Staff,5,0,30,25
1650327101196,MATH 18,A02,083744,Staff,26,0,30,4
1650327101196,MATH 18,A03,083745,Staff,22,0,30,8
1650327101196,MATH 18,A04,083746,Staff,27,0,30,3
1650327101196,MATH 18,B01,083748,Staff,0,11,30,30
1650327101196,MATH 18,B02,083749,Staff,0,11,30,30
1650327101196,MATH 18,B03,083750,Staff,1,11,30,29
1650327101196,MATH 18,B04,083751,Staff,0,10,30,30
1650327107218,MATH 20A,A01,083754,Staff,26,0,40,14
1650327113241,MATH 20B,A01,083756,Staff,0,7,30,30
1650327113241,MATH 20B,A02,083757,Staff,0,8,30,30
1650327119267,MATH 20C,A01,083760,Staff,0,13,30,30
1650327119267,MATH 20C,A02,083761,Staff,0,13,30,30
1650327119267,MATH 20C,B01,083762,Staff,13,0,30,17
1650327119267,MATH 20C,B02,083763,Staff,28,0,30,2
1650327125290,MATH 20D,A01,083765,Staff,0,1,30,30
1650327125290,MATH 20D,A02,083766,Staff,7,0,30,23
1650327125290,MATH 20D,A03,083767,Staff,26,0,30,4
1650327131320,MATH 20E,A01,083771,Staff,5,0,30,25
1650327131320,MATH 20E,A02,083772,Staff,19,0,30,11
1650327131320,MATH 20E,B01,083773,Staff,0,0,30,30
1650327131320,MATH 20E,B02,083774,Staff,12,0,30,18
1650327137346,MATH 103A,A01,083777,Staff,0,12,30,30
1650327137346,MATH 103A,A02,083778,Staff,0,12,30,30
1650327137346,MATH 103A,B01,083779,Staff,0,12,30,30
1650327137346,MATH 103A,B02,083780,Staff,0,11,30,30
1650327143369,MATH 105,A01,085443,Staff,0,19,30,30
1650327149396,MATH 109,A01,083213,Anzaldo; Leesa B,0,5,30,30
1650327149396,MATH 109,A02,083214,Anzaldo; Leesa B,0,7,30,30
1650327149396,MATH 109,B01,083215,Anzaldo; Leesa B,0,5,30,30
1650327149396,MATH 109,B02,083216,Anzaldo; Leesa B,0,4,30,30
1650327155419,MATH 142A,A01,083219,Chow; Bennett,0,14,30,30
1650327155419,MATH 142A,A02,083220,Chow; Bennett,0,12,30,30
1650327155419,MATH 142A,B01,083221,Chow; Bennett,0,12,30,30
1650327155419,MATH 142A,B02,083222,Chow; Bennett,0,12,30,30
1650327161442,MATH 193A,A01,083224,Staff,0,5,30,30
1650327161442,MATH 193A,A02,083225,Staff,0,5,30,30
1650327161442,MATH 193A,A03,083781,Staff,0,3,30,30
1650327161442,MATH 193A,A04,083782,Staff,0,3,30,30
1650327167467,MATH 197,001,091859,McAuley; Julian John,9998,0,9999,1
1650327173523,COGS 9,A01,083615,Staff,0,15,60,60
1650327179548,COGS 11,A01,083617,Boyle; Mary E. T.,22,0,40,18
1650327185582,COGS 13,A01,083071,Staff,0,31,40,40
1650327191610,COGS 14A,A01,092681,Staff,0,19,100,100
1650327197636,COGS 14B,A01,083073,Cheng; Tzu-Han,0,10,50,50
1650327203661,COGS 17,A01,092677,Staff,26,0,75,49
1650327209685,COGS 100,A01,083619,Staff,0,23,60,60
1650327215707,COGS 101A,A01,083621,Davis; Joshua Daniel,1,22,60,59
1650327221729,COGS 101B,A01,091572,Staff,2,0,60,58
1650327227760,COGS 101C,A01,083625,Delgado; Tania,18,0,30,12
1650327233787,COGS 107A,A01,083627,Boyle; Mary E. T.,0,8,60,60
1650327239814,COGS 118A,A01,083075,Staff,5,0,60,55
1650327245847,CSE 3,A50,083646,Miranda; Gregory Joseph,21,0,38,17
1650327245847,CSE 3,A51,083647,Miranda; Gregory Joseph,37,0,37,0
1650327251871,CSE 8A,A50,083650,Miranda; Gregory Joseph,0,27,40,40
1650327257900,CSE 11,A01,083080,Cao; Yingjun,0,87,40,40
1650327263924,CSE 12,A01,083652,Staff,0,11,100,100
1650327269953,CSE 15L,A01,083654,Staff,0,1,50,50
1650327269953,CSE 15L,A02,083655,Staff,4,0,50,46
1650327275976,CSE 20,A01,083657,Staff,53,0,80,27
1650327282002,CSE 30,A01,083084,Eldon; John,0,75,40,40
1650327288024,CSE 100,A01,083659,Cao; Yingjun,0,66,50,50
1650327294054,CSE 134B,A01,083661,Powell; Thomas Allan,0,30,65,65
1650327300075,CSE 140,A01,083663,Staff,0,0,75,75
1650327306098,CSE 140L,A01,083088,Eldon; John,0,6,75,75
1650327312131,CSE 175,A01,083665,Kumar; Rakesh,8,0,25,17
1650327318156,CSE 190,A00,092507,Dubnov; Shlomo,14,0,20,6
1650327324178,ECE 45,A01,083139,Staff,0,16,40,40
1650327330202,ECE 65,A50,083695,Staff,0,5,30,30
1650327336238,ECE 109,A01,091882,Touri; Behrouz,41,0,70,29
1650327342283,ECE 180,A00,083140,Abi Samra; Nicholas Camill,23,0,30,7
1650327342283,ECE 180,B00,083141,Abi Samra; Nicholas Camill,5,0,30,25
1650327348307,MATH 10A,A01,083735,Patchell; Gregory David,8,0,30,22
1650327348307,MATH 10A,A02,083736,Patchell; Gregory David,28,0,30,2
1650327348307,MATH 10A,A03,083737,Patchell; Gregory David,26,0,30,4
1650327354334,MATH 10B,A01,083207,Staff,0,7,30,30
1650327354334,MATH 10B,A02,083208,Staff,0,6,30,30
1650327354334,MATH 10B,B01,083739,Staff,17,0,30,13
1650327354334,MATH 10B,B02,083740,Staff,28,0,30,2
1650327360365,MATH 18,A01,083743,Staff,5,0,30,25
1650327360365,MATH 18,A02,083744,Staff,26,0,30,4
1650327360365,MATH 18,A03,083745,Staff,22,0,30,8
1650327360365,MATH 18,A04,083746,Staff,27,0,30,3
1650327360365,MATH 18,B01,083748,Staff,0,11,30,30
1650327360365,MATH 18,B02,083749,Staff,0,11,30,30
1650327360365,MATH 18,B03,083750,Staff,1,11,30,29
1650327360365,MATH 18,B04,083751,Staff,0,10,30,30
1650327366388,MATH 20A,A01,083754,Staff,26,0,40,14
1650327372412,MATH 20B,A01,083756,Staff,0,7,30,30
1650327372412,MATH 20B,A02,083757,Staff,0,8,30,30
1650327378440,MATH 20C,A01,083760,Staff,0,13,30,30
1650327378440,MATH 20C,A02,083761,Staff,0,13,30,30
1650327378440,MATH 20C,B01,083762,Staff,13,0,30,17
1650327378440,MATH 20C,B02,083763,Staff,28,0,30,2
1650327384462,MATH 20D,A01,083765,Staff,0,1,30,30
1650327384462,MATH 20D,A02,083766,Staff,7,0,30,23
1650327384462,MATH 20D,A03,083767,Staff,26,0,30,4
1650327390487,MATH 20E,A01,083771,Staff,5,0,30,25
1650327390487,MATH 20E,A02,083772,Staff,19,0,30,11
1650327390487,MATH 20E,B01,083773,Staff,0,0,30,30
1650327390487,MATH 20E,B02,083774,Staff,12,0,30,18
1650327396515,MATH 103A,A01,083777,Staff,0,12,30,30
1650327396515,MATH 103A,A02,083778,Staff,0,12,30,30
1650327396515,MATH 103A,B01,083779,Staff,0,12,30,30
1650327396515,MATH 103A,B02,083780,Staff,0,11,30,30
1650327402537,MATH 105,A01,085443,Staff,0,19,30,30
1650327408569,MATH 109,A01,083213,Anzaldo; Leesa B,0,5,30,30
1650327408569,MATH 109,A02,083214,Anzaldo; Leesa B,0,7,30,30
1650327408569,MATH 109,B01,083215,Anzaldo; Leesa B,0,5,30,30
1650327408569,MATH 109,B02,083216,Anzaldo; Leesa B,0,4,30,30
1650327414596,MATH 142A,A01,083219,Chow; Bennett,0,14,30,30
1650327414596,MATH 142A,A02,083220,Chow; Bennett,0,12,30,30
1650327414596,MATH 142A,B01,083221,Chow; Bennett,0,12,30,30
1650327414596,MATH 142A,B02,083222,Chow; Bennett,0,12,30,30
1650327420620,MATH 193A,A01,083224,Staff,0,5,30,30
1650327420620,MATH 193A,A02,083225,Staff,0,5,30,30
1650327420620,MATH 193A,A03,083781,Staff,0,3,30,30
1650327420620,MATH 193A,A04,083782,Staff,0,3,30,30
1650327426736,MATH 197,001,091859,McAuley; Julian John,9998,0,9999,1
1650327432793,COGS 9,A01,083615,Staff,0,15,60,60
1650327438818,COGS 11,A01,083617,Boyle; Mary E. T.,22,0,40,18
1650327444849,COGS 13,A01,083071,Staff,0,31,40,40
1650327450874,COGS 14A,A01,092681,Staff,0,19,100,100
1650327456897,COGS 14B,A01,083073,Cheng; Tzu-Han,0,10,50,50
1650327462920,COGS 17,A01,092677,Staff,26,0,75,49
1650327468943,COGS 100,A01,083619,Staff,0,23,60,60
1650327474965,COGS 101A,A01,083621,Davis; Joshua Daniel,1,22,60,59
1650327480988,COGS 101B,A01,091572,Staff,2,0,60,58
1650327487013,COGS 101C,A01,083625,Delgado; Tania,18,0,30,12
1650327493037,COGS 107A,A01,083627,Boyle; Mary E. T.,0,8,60,60
1650327499060,COGS 118A,A01,083075,Staff,5,0,60,55
1650327505086,CSE 3,A50,083646,Miranda; Gregory Joseph,21,0,38,17
1650327505086,CSE 3,A51,083647,Miranda; Gregory Joseph,37,0,37,0
1650327511139,CSE 8A,A50,083650,Miranda; Gregory Joseph,0,27,40,40
1650327517164,CSE 11,A01,083080,Cao; Yingjun,0,87,40,40
1650327523186,CSE 12,A01,083652,Staff,0,11,100,100
1650327529210,CSE 15L,A01,083654,Staff,0,1,50,50
1650327529210,CSE 15L,A02,083655,Staff,4,0,50,46
1650327535233,CSE 20,A01,083657,Staff,53,0,80,27
1650327541258,CSE 30,A01,083084,Eldon; John,0,75,40,40
1650327547283,CSE 100,A01,083659,Cao; Yingjun,0,66,50,50
1650327553306,CSE 134B,A01,083661,Powell; Thomas Allan,0,30,65,65
1650327559339,CSE 140,A01,083663,Staff,0,0,75,75
1650327565380,CSE 140L,A01,083088,Eldon; John,0,6,75,75
1650327571404,CSE 175,A01,083665,Kumar; Rakesh,8,0,25,17
1650327577431,CSE 190,A00,092507,Dubnov; Shlomo,14,0,20,6
1650327583463,ECE 45,A01,083139,Staff,0,16,40,40
1650327589486,ECE 65,A50,083695,Staff,0,5,30,30
1650327595514,ECE 109,A01,091882,Touri; Behrouz,41,0,70,29
1650327601543,ECE 180,A00,083140,Abi Samra; Nicholas Camill,23,0,30,7
1650327601543,ECE 180,B00,083141,Abi Samra; Nicholas Camill,5,0,30,25
1650327607583,MATH 10A,A01,083735,Patchell; Gregory David,8,0,30,22
1650327607583,MATH 10A,A02,083736,Patchell; Gregory David,28,0,30,2
1650327607583,MATH 10A,A03,083737,Patchell; Gregory David,26,0,30,4
1650327613607,MATH 10B,A01,083207,Staff,0,7,30,30
1650327613607,MATH 10B,A02,083208,Staff,0,6,30,30
1650327613607,MATH 10B,B01,083739,Staff,17,0,30,13
1650327613607,MATH 10B,B02,083740,Staff,28,0,30,2
1650327619636,MATH 18,A01,083743,Staff,5,0,30,25
1650327619636,MATH 18,A02,083744,Staff,26,0,30,4
1650327619636,MATH 18,A03,083745,Staff,22,0,30,8
1650327619636,MATH 18,A04,083746,Staff,27,0,30,3
1650327619636,MATH 18,B01,083748,Staff,0,11,30,30
1650327619636,MATH 18,B02,083749,Staff,0,11,30,30
1650327619636,MATH 18,B03,083750,Staff,1,11,30,29
1650327619636,MATH 18,B04,083751,Staff,0,10,30,30
1650327625667,MATH 20A,A01,083754,Staff,26,0,40,14
1650327631691,MATH 20B,A01,083756,Staff,0,7,30,30
1650327631691,MATH 20B,A02,083757,Staff,0,8,30,30
1650327637723,MATH 20C,A01,083760,Staff,0,13,30,30
1650327637723,MATH 20C,A02,083761,Staff,0,13,30,30
1650327637723,MATH 20C,B01,083762,Staff,13,0,30,17
1650327637723,MATH 20C,B02,083763,Staff,28,0,30,2
1650327643750,MATH 20D,A01,083765,Staff,0,1,30,30
1650327643750,MATH 20D,A02,083766,Staff,7,0,30,23
1650327643750,MATH 20D,A03,083767,Staff,26,0,30,4
1650327649773,MATH 20E,A01,083771,Staff,5,0,30,25
1650327649773,MATH 20E,A02,083772,Staff,19,0,30,11
1650327649773,MATH 20E,B01,083773,Staff,0,0,30,30
1650327649773,MATH 20E,B02,083774,Staff,12,0,30,18
1650327655802,MATH 103A,A01,083777,Staff,0,12,30,30
1650327655802,MATH 103A,A02,083778,Staff,0,12,30,30
1650327655802,MATH 103A,B01,083779,Staff,0,12,30,30
1650327655802,MATH 103A,B02,083780,Staff,0,11,30,30
1650327661825,MATH 105,A01,085443,Staff,0,19,30,30
1650327667856,MATH 109,A01,083213,Anzaldo; Leesa B,0,5,30,30
1650327667856,MATH 109,A02,083214,Anzaldo; Leesa B,0,7,30,30
1650327667856,MATH 109,B01,083215,Anzaldo; Leesa B,0,5,30,30
1650327667856,MATH 109,B02,083216,Anzaldo; Leesa B,0,4,30,30
1650327673882,MATH 142A,A01,083219,Chow; Bennett,0,14,30,30
1650327673882,MATH 142A,A02,083220,Chow; Bennett,0,12,30,30
1650327673882,MATH 142A,B01,083221,Chow; Bennett,0,12,30,30
1650327673882,MATH 142A,B02,083222,Chow; Bennett,0,12,30,30
1650327679905,MATH 193A,A01,083224,Staff,0,5,30,30
1650327679905,MATH 193A,A02,083225,Staff,0,5,30,30
1650327679905,MATH 193A,A03,083781,Staff,0,3,30,30
1650327679905,MATH 193A,A04,083782,Staff,0,3,30,30
1650327685931,MATH 197,001,091859,McAuley; Julian John,9998,0,9999,1
1650327691987,COGS 9,A01,083615,Staff,0,15,60,60
1650327698012,COGS 11,A01,083617,Boyle; Mary E. T.,22,0,40,18
1650327704038,COGS 13,A01,083071,Staff,0,31,40,40
1650327710062,COGS 14A,A01,092681,Staff,0,19,100,100
1650327716086,COGS 14B,A01,083073,Cheng; Tzu-Han,0,10,50,50
1650327722126,COGS 17,A01,092677,Staff,26,0,75,49
1650327728151,COGS 100,A01,083619,Staff,0,23,60,60
1650327734175,COGS 101A,A01,083621,Davis; Joshua Daniel,1,22,60,59
1650327740199,COGS 101B,A01,091572,Staff,2,0,60,58
1650327746222,COGS 101C,A01,083625,Delgado; Tania,18,0,30,12
1650327752245,COGS 107A,A01,083627,Boyle; Mary E. T.,0,8,60,60
1650327758287,COGS 118A,A01,083075,Staff,5,0,60,55
1650327764313,CSE 3,A50,083646,Miranda; Gregory Joseph,21,0,38,17
1650327764313,CSE 3,A51,083647,Miranda; Gregory Joseph,37,0,37,0
1650327770341,CSE 8A,A50,083650,Miranda; Gregory Joseph,0,27,40,40
1650327776365,CSE 11,A01,083080,Cao; Yingjun,0,87,40,40
1650327782397,CSE 12,A01,083652,Staff,0,11,100,100
1650327788420,CSE 15L,A01,083654,Staff,0,1,50,50
1650327788420,CSE 15L,A02,083655,Staff,4,0,50,46
1650327794461,CSE 20,A01,083657,Staff,53,0,80,27
1650327800487,CSE 30,A01,083084,Eldon; John,0,76,40,40
1650327806510,CSE 100,A01,083659,Cao; Yingjun,0,66,50,50
1650327812537,CSE 134B,A01,083661,Powell; Thomas Allan,0,30,65,65
1650327818571,CSE 140,A01,083663,Staff,0,0,75,75
1650327824600,CSE 140L,A01,083088,Eldon; John,0,6,75,75
1650327830632,CSE 175,A01,083665,Kumar; Rakesh,8,0,25,17
1650327836661,CSE 190,A00,092507,Dubnov; Shlomo,14,0,20,6
1650327842684,ECE 45,A01,083139,Staff,0,16,40,40
1650327848707,ECE 65,A50,083695,Staff,0,5,30,30
1650327854733,ECE 109,A01,091882,Touri; Behrouz,41,0,70,29
1650327860755,ECE 180,A00,083140,Abi Samra; Nicholas Camill,23,0,30,7
1650327860755,ECE 180,B00,083141,Abi Samra; Nicholas Camill,5,0,30,25
1650327866780,MATH 10A,A01,083735,Patchell; Gregory David,8,0,30,22
1650327866780,MATH 10A,A02,083736,Patchell; Gregory David,28,0,30,2
1650327866780,MATH 10A,A03,083737,Patchell; Gregory David,26,0,30,4
1650327872810,MATH 10B,A01,083207,Staff,0,7,30,30
1650327872810,MATH 10B,A02,083208,Staff,0,6,30,30
1650327872810,MATH 10B,B01,083739,Staff,17,0,30,13
1650327872810,MATH 10B,B02,083740,Staff,28,0,30,2
1650327878841,MATH 18,A01,083743,Staff,5,0,30,25
1650327878841,MATH 18,A02,083744,Staff,26,0,30,4
1650327878841,MATH 18,A03,083745,Staff,22,0,30,8
1650327878841,MATH 18,A04,083746,Staff,27,0,30,3
1650327878841,MATH 18,B01,083748,Staff,0,11,30,30
1650327878841,MATH 18,B02,083749,Staff,0,11,30,30
1650327878841,MATH 18,B03,083750,Staff,1,11,30,29
1650327878841,MATH 18,B04,083751,Staff,0,10,30,30
1650327884885,MATH 20A,A01,083754,Staff,26,0,40,14
1650327890907,MATH 20B,A01,083756,Staff,0,7,30,30
1650327890907,MATH 20B,A02,083757,Staff,0,8,30,30
1650327896934,MATH 20C,A01,083760,Staff,0,13,30,30
1650327896934,MATH 20C,A02,083761,Staff,0,13,30,30
1650327896934,MATH 20C,B01,083762,Staff,13,0,30,17
1650327896934,MATH 20C,B02,083763,Staff,28,0,30,2
1650327902957,MATH 20D,A01,083765,Staff,0,1,30,30
1650327902957,MATH 20D,A02,083766,Staff,7,0,30,23
1650327902957,MATH 20D,A03,083767,Staff,26,0,30,4
1650327908981,MATH 20E,A01,083771,Staff,5,0,30,25
1650327908981,MATH 20E,A02,083772,Staff,19,0,30,11
1650327908981,MATH 20E,B01,083773,Staff,0,0,30,30
1650327908981,MATH 20E,B02,083774,Staff,12,0,30,18
1650327915011,MATH 103A,A01,083777,Staff,0,12,30,30
1650327915011,MATH 103A,A02,083778,Staff,0,12,30,30
1650327915011,MATH 103A,B01,083779,Staff,0,12,30,30
1650327915011,MATH 103A,B02,083780,Staff,0,11,30,30
1650327921037,MATH 105,A01,085443,Staff,0,19,30,30
1650327927067,MATH 109,A01,083213,Anzaldo; Leesa B,0,5,30,30
1650327927067,MATH 109,A02,083214,Anzaldo; Leesa B,0,7,30,30
1650327927067,MATH 109,B01,083215,Anzaldo; Leesa B,0,5,30,30
1650327927067,MATH 109,B02,083216,Anzaldo; Leesa B,0,4,30,30
1650327933096,MATH 142A,A01,083219,Chow; Bennett,0,14,30,30
1650327933096,MATH 142A,A02,083220,Chow; Bennett,0,12,30,30
1650327933096,MATH 142A,B01,083221,Chow; Bennett,0,12,30,30
1650327933096,MATH 142A,B02,083222,Chow; Bennett,0,12,30,30
1650327939120,MATH 193A,A01,083224,Staff,0,5,30,30
1650327939120,MATH 193A,A02,083225,Staff,0,5,30,30
1650327939120,MATH 193A,A03,083781,Staff,0,3,30,30
1650327939120,MATH 193A,A04,083782,Staff,0,3,30,30
1650327945143,MATH 197,001,091859,McAuley; Julian John,9998,0,9999,1
1650327951218,COGS 9,A01,083615,Staff,0,15,60,60
1650327957243,COGS 11,A01,083617,Boyle; Mary E. T.,22,0,40,18
1650327963270,COGS 13,A01,083071,Staff,0,31,40,40
1650327969297,COGS 14A,A01,092681,Staff,0,19,100,100
1650327975322,COGS 14B,A01,083073,Cheng; Tzu-Han,0,10,50,50
1650327981348,COGS 17,A01,092677,Staff,26,0,75,49
1650327987374,COGS 100,A01,083619,Staff,0,23,60,60
1650327993397,COGS 101A,A01,083621,Davis; Joshua Daniel,1,22,60,59
1650327999423,COGS 101B,A01,091572,Staff,2,0,60,58
1650328005455,COGS 101C,A01,083625,Delgado; Tania,18,0,30,12
1650328011481,COGS 107A,A01,083627,Boyle; Mary E. T.,0,8,60,60
1650328017597,COGS 118A,A01,083075,Staff,5,0,60,55
1650328023635,CSE 3,A50,083646,Miranda; Gregory Joseph,21,0,38,17
1650328023635,CSE 3,A51,083647,Miranda; Gregory Joseph,37,0,37,0
1650328029662,CSE 8A,A50,083650,Miranda; Gregory Joseph,0,27,40,40
1650328035698,CSE 11,A01,083080,Cao; Yingjun,0,87,40,40
1650328041727,CSE 12,A01,083652,Staff,0,11,100,100
1650328047751,CSE 15L,A01,083654,Staff,0,1,50,50
1650328047751,CSE 15L,A02,083655,Staff,4,0,50,46
1650328053774,CSE 20,A01,083657,Staff,53,0,80,27
1650328059799,CSE 30,A01,083084,Eldon; John,0,76,40,40
1650328065826,CSE 100,A01,083659,Cao; Yingjun,0,66,50,50
1650328071848,CSE 134B,A01,083661,Powell; Thomas Allan,0,30,65,65
1650328077878,CSE 140,A01,083663,Staff,0,0,75,75
1650328083909,CSE 140L,A01,083088,Eldon; John,0,6,75,75
1650328089935,CSE 175,A01,083665,Kumar; Rakesh,8,0,25,17
1650328095962,CSE 190,A00,092507,Dubnov; Shlomo,14,0,20,6
1650328101988,ECE 45,A01,083139,Staff,0,16,40,40
1650328108015,ECE 65,A50,083695,Staff,0,5,30,30
1650328114039,ECE 109,A01,091882,Touri; Behrouz,41,0,70,29
1650328120062,ECE 180,A00,083140,Abi Samra; Nicholas Camill,23,0,30,7
1650328120062,ECE 180,B00,083141,Abi Samra; Nicholas Camill,5,0,30,25
1650328126089,MATH 10A,A01,083735,Patchell; Gregory David,8,0,30,22
1650328126089,MATH 10A,A02,083736,Patchell; Gregory David,28,0,30,2
1650328126089,MATH 10A,A03,083737,Patchell; Gregory David,26,0,30,4
1650328132124,MATH 10B,A01,083207,Staff,0,7,30,30
1650328132124,MATH 10B,A02,083208,Staff,0,6,30,30
1650328132124,MATH 10B,B01,083739,Staff,17,0,30,13
1650328132124,MATH 10B,B02,083740,Staff,28,0,30,2
1650328138154,MATH 18,A01,083743,Staff,5,0,30,25
1650328138154,MATH 18,A02,083744,Staff,26,0,30,4
1650328138154,MATH 18,A03,083745,Staff,22,0,30,8
1650328138154,MATH 18,A04,083746,Staff,27,0,30,3
1650328138154,MATH 18,B01,083748,Staff,0,11,30,30
1650328138154,MATH 18,B02,083749,Staff,0,11,30,30
1650328138154,MATH 18,B03,083750,Staff,1,11,30,29
1650328138154,MATH 18,B04,083751,Staff,0,10,30,30
1650328144179,MATH 20A,A01,083754,Staff,26,0,40,14
1650328150204,MATH 20B,A01,083756,Staff,0,7,30,30
1650328150204,MATH 20B,A02,083757,Staff,0,8,30,30
1650328156230,MATH 20C,A01,083760,Staff,0,13,30,30
1650328156230,MATH 20C,A02,083761,Staff,0,13,30,30
1650328156230,MATH 20C,B01,083762,Staff,13,0,30,17
1650328156230,MATH 20C,B02,083763,Staff,28,0,30,2
1650328162254,MATH 20D,A01,083765,Staff,0,1,30,30
1650328162254,MATH 20D,A02,083766,Staff,7,0,30,23
1650328162254,MATH 20D,A03,083767,Staff,26,0,30,4
1650328168281,MATH 20E,A01,083771,Staff,5,0,30,25
1650328168281,MATH 20E,A02,083772,Staff,19,0,30,11
1650328168281,MATH 20E,B01,083773,Staff,0,0,30,30
1650328168281,MATH 20E,B02,083774,Staff,12,0,30,18
1650328174305,MATH 103A,A01,083777,Staff,0,12,30,30
1650328174305,MATH 103A,A02,083778,Staff,0,12,30,30
1650328174305,MATH 103A,B01,083779,Staff,0,12,30,30
1650328174305,MATH 103A,B02,083780,Staff,0,11,30,30
1650328180332,MATH 105,A01,085443,Staff,0,19,30,30
1650328186358,MATH 109,A01,083213,Anzaldo; Leesa B,0,5,30,30
1650328186358,MATH 109,A02,083214,Anzaldo; Leesa B,0,7,30,30
1650328186358,MATH 109,B01,083215,Anzaldo; Leesa B,0,5,30,30
1650328186358,MATH 109,B02,083216,Anzaldo; Leesa B,0,5,30,30
1650328192383,MATH 142A,A01,083219,Chow; Bennett,0,14,30,30
1650328192383,MATH 142A,A02,083220,Chow; Bennett,0,12,30,30
1650328192383,MATH 142A,B01,083221,Chow; Bennett,0,12,30,30
1650328192383,MATH 142A,B02,083222,Chow; Bennett,0,12,30,30
1650328198410,MATH 193A,A01,083224,Staff,0,5,30,30
1650328198410,MATH 193A,A02,083225,Staff,0,5,30,30
1650328198410,MATH 193A,A03,083781,Staff,0,3,30,30
1650328198410,MATH 193A,A04,083782,Staff,0,3,30,30
1650328204445,MATH 197,001,091859,McAuley; Julian John,9998,0,9999,1
1650328210516,COGS 9,A01,083615,Staff,0,15,60,60
1650328216542,COGS 11,A01,083617,Boyle; Mary E. T.,22,0,40,18
1650328222568,COGS 13,A01,083071,Staff,0,31,40,40
1650328228596,COGS 14A,A01,092681,Staff,0,19,100,100
1650328234619,COGS 14B,A01,083073,Cheng; Tzu-Han,0,10,50,50
1650328240643,COGS 17,A01,092677,Staff,26,0,75,49
1650328246671,COGS 100,A01,083619,Staff,0,23,60,60
1650328252705,COGS 101A,A01,083621,Davis; Joshua Daniel,1,22,60,59
1650328258729,COGS 101B,A01,091572,Staff,2,0,60,58
1650328264752,COGS 101C,A01,083625,Delgado; Tania,18,0,30,12
1650328270786,COGS 107A,A01,083627,Boyle; Mary E. T.,0,8,60,60
1650328276807,COGS 118A,A01,083075,Staff,5,0,60,55
1650328282846,CSE 3,A50,083646,Miranda; Gregory Joseph,21,0,38,17
1650328282846,CSE 3,A51,083647,Miranda; Gregory Joseph,37,0,37,0
1650328288884,CSE 8A,A50,083650,Miranda; Gregory Joseph,0,27,40,40
1650328294909,CSE 11,A01,083080,Cao; Yingjun,0,87,40,40
1650328300939,CSE 12,A01,083652,Staff,0,11,100,100
1650328306976,CSE 15L,A01,083654,Staff,0,1,50,50
1650328306976,CSE 15L,A02,083655,Staff,4,0,50,46
1650328312999,CSE 20,A01,083657,Staff,53,0,80,27
1650328319026,CSE 30,A01,083084,Eldon; John,0,76,40,40
1650328325049,CSE 100,A01,083659,Cao; Yingjun,0,66,50,50
1650328331080,CSE 134B,A01,083661,Powell; Thomas Allan,0,30,65,65
1650328337104,CSE 140,A01,083663,Staff,0,0,75,75
1650328343127,CSE 140L,A01,083088,Eldon; John,0,6,75,75
1650328349151,CSE 175,A01,083665,Kumar; Rakesh,8,0,25,17
1650328355173,CSE 190,A00,092507,Dubnov; Shlomo,14,0,20,6
1650328361197,ECE 45,A01,083139,Staff,0,16,40,40
1650328367220,ECE 65,A50,083695,Staff,0,5,30,30
1650328373250,ECE 109,A01,091882,Touri; Behrouz,41,0,70,29
1650328379280,ECE 180,A00,083140,Abi Samra; Nicholas Camill,23,0,30,7
1650328379280,ECE 180,B00,083141,Abi Samra; Nicholas Camill,5,0,30,25
1650328385310,MATH 10A,A01,083735,Patchell; Gregory David,8,0,30,22
1650328385310,MATH 10A,A02,083736,Patchell; Gregory David,28,0,30,2
1650328385310,MATH 10A,A03,083737,Patchell; Gregory David,26,0,30,4
1650328391339,MATH 10B,A01,083207,Staff,0,7,30,30
1650328391339,MATH 10B,A02,083208,Staff,0,6,30,30
1650328391339,MATH 10B,B01,083739,Staff,17,0,30,13
1650328391339,MATH 10B,B02,083740,Staff,28,0,30,2
1650328397363,MATH 18,A01,083743,Staff,5,0,30,25
1650328397363,MATH 18,A02,083744,Staff,26,0,30,4
1650328397363,MATH 18,A03,083745,Staff,22,0,30,8
1650328397363,MATH 18,A04,083746,Staff,27,0,30,3
1650328397363,MATH 18,B01,083748,Staff,0,11,30,30
1650328397363,MATH 18,B02,083749,Staff,0,11,30,30
1650328397363,MATH 18,B03,083750,Staff,1,11,30,29
1650328397363,MATH 18,B04,083751,Staff,0,10,30,30
1650328403385,MATH 20A,A01,083754,Staff,26,0,40,14
1650328409409,MATH 20B,A01,083756,Staff,0,8,30,30
1650328409409,MATH 20B,A02,083757,Staff,0,8,30,30
1650328415438,MATH 20C,A01,083760,Staff,0,13,30,30
1650328415438,MATH 20C,A02,083761,Staff,0,13,30,30
1650328415438,MATH 20C,B01,083762,Staff,13,0,30,17
1650328415438,MATH 20C,B02,083763,Staff,28,0,30,2
1650328421465,MATH 20D,A01,083765,Staff,0,1,30,30
1650328421465,MATH 20D,A02,083766,Staff,7,0,30,23
1650328421465,MATH 20D,A03,083767,Staff,26,0,30,4
1650328427492,MATH 20E,A01,083771,Staff,5,0,30,25
1650328427492,MATH 20E,A02,083772,Staff,19,0,30,11
1650328427492,MATH 20E,B01,083773,Staff,0,0,30,30
1650328427492,MATH 20E,B02,083774,Staff,12,0,30,18
1650328433521,MATH 103A,A01,083777,Staff,0,12,30,30
1650328433521,MATH 103A,A02,083778,Staff,0,12,30,30
1650328433521,MATH 103A,B01,083779,Staff,0,12,30,30
1650328433521,MATH 103A,B02,083780,Staff,0,11,30,30
1650328439548,MATH 105,A01,085443,Staff,0,19,30,30
1650328445576,MATH 109,A01,083213,Anzaldo; Leesa B,0,5,30,30
1650328445576,MATH 109,A02,083214,Anzaldo; Leesa B,0,7,30,30
1650328445576,MATH 109,B01,083215,Anzaldo; Leesa B,0,5,30,30
1650328445576,MATH 109,B02,083216,Anzaldo; Leesa B,0,5,30,30
1650328451606,MATH 142A,A01,083219,Chow; Bennett,0,14,30,30
1650328451606,MATH 142A,A02,083220,Chow; Bennett,0,12,30,30
1650328451606,MATH 142A,B01,083221,Chow; Bennett,0,12,30,30
1650328451606,MATH 142A,B02,083222,Chow; Bennett,0,12,30,30
1650328457645,MATH 193A,A01,083224,Staff,0,5,30,30
1650328457645,MATH 193A,A02,083225,Staff,0,5,30,30
1650328457645,MATH 193A,A03,083781,Staff,0,3,30,30
1650328457645,MATH 193A,A04,083782,Staff,0,3,30,30
1650328463679,MATH 197,001,091859,McAuley; Julian John,9998,0,9999,1
1650328469736,COGS 9,A01,083615,Staff,0,15,60,60
1650328475762,COGS 11,A01,083617,Boyle; Mary E. T.,22,0,40,18
1650328481784,COGS 13,A01,083071,Staff,0,31,40,40
1650328487808,COGS 14A,A01,092681,Staff,0,19,100,100
1650328493841,COGS 14B,A01,083073,Cheng; Tzu-Han,0,10,50,50
1650328499868,COGS 17,A01,092677,Staff,26,0,75,49
1650328505896,COGS 100,A01,083619,Staff,0,23,60,60
1650328511923,COGS 101A,A01,083621,Davis; Joshua Daniel,1,22,60,59
1650328517945,COGS 101B,A01,091572,Staff,2,0,60,58
1650328523970,COGS 101C,A01,083625,Delgado; Tania,18,0,30,12
1650328530004,COGS 107A,A01,083627,Boyle; Mary E. T.,0,8,60,60
1650328536030,COGS 118A,A01,083075,Staff,5,0,60,55
1650328542068,CSE 3,A50,083646,Miranda; Gregory Joseph,21,0,38,17
1650328542068,CSE 3,A51,083647,Miranda; Gregory Joseph,37,0,37,0
1650328548092,CSE 8A,A50,083650,Miranda; Gregory Joseph,0,27,40,40
1650328554116,CSE 11,A01,083080,Cao; Yingjun,0,87,40,40
1650328560139,CSE 12,A01,083652,Staff,0,12,100,100
1650328566166,CSE 15L,A01,083654,Staff,0,1,50,50
1650328566166,CSE 15L,A02,083655,Staff,3,0,50,47
1650328572189,CSE 20,A01,083657,Staff,53,0,80,27
1650328578222,CSE 30,A01,083084,Eldon; John,0,76,40,40
1650328584244,CSE 100,A01,083659,Cao; Yingjun,0,66,50,50
1650328590282,CSE 134B,A01,083661,Powell; Thomas Allan,0,30,65,65
1650328596304,CSE 140,A01,083663,Staff,0,0,75,75
1650328602333,CSE 140L,A01,083088,Eldon; John,0,6,75,75
1650328608356,CSE 175,A01,083665,Kumar; Rakesh,8,0,25,17
1650328614475,CSE 190,A00,092507,Dubnov; Shlomo,14,0,20,6
1650328620507,ECE 45,A01,083139,Staff,0,16,40,40
1650328626530,ECE 65,A50,083695,Staff,0,5,30,30
1650328632553,ECE 109,A01,091882,Touri; Behrouz,41,0,70,29
1650328638576,ECE 180,A00,083140,Abi Samra; Nicholas Camill,23,0,30,7
1650328638576,ECE 180,B00,083141,Abi Samra; Nicholas Camill,5,0,30,25
1650328644599,MATH 10A,A01,083735,Patchell; Gregory David,8,0,30,22
1650328644599,MATH 10A,A02,083736,Patchell; Gregory David,28,0,30,2
1650328644599,MATH 10A,A03,083737,Patchell; Gregory David,26,0,30,4
1650328650625,MATH 10B,A01,083207,Staff,0,7,30,30
1650328650625,MATH 10B,A02,083208,Staff,0,6,30,30
1650328650625,MATH 10B,B01,083739,Staff,17,0,30,13
1650328650625,MATH 10B,B02,083740,Staff,28,0,30,2
1650328656655,MATH 18,A01,083743,Staff,5,0,30,25
1650328656655,MATH 18,A02,083744,Staff,26,0,30,4
1650328656655,MATH 18,A03,083745,Staff,22,0,30,8
1650328656655,MATH 18,A04,083746,Staff,27,0,30,3
1650328656655,MATH 18,B01,083748,Staff,0,11,30,30
1650328656655,MATH 18,B02,083749,Staff,0,11,30,30
1650328656655,MATH 18,B03,083750,Staff,1,11,30,29
1650328656655,MATH 18,B04,083751,Staff,0,10,30,30
1650328662677,MATH 20A,A01,083754,Staff,26,0,40,14
1650328668700,MATH 20B,A01,083756,Staff,0,8,30,30
1650328668700,MATH 20B,A02,083757,Staff,0,8,30,30
1650328674723,MATH 20C,A01,083760,Staff,0,13,30,30
1650328674723,MATH 20C,A02,083761,Staff,0,13,30,30
1650328674723,MATH 20C,B01,083762,Staff,13,0,30,17
1650328674723,MATH 20C,B02,083763,Staff,28,0,30,2
1650328680756,MATH 20D,A01,083765,Staff,0,1,30,30
1650328680756,MATH 20D,A02,083766,Staff,7,0,30,23
1650328680756,MATH 20D,A03,083767,Staff,26,0,30,4
1650328686788,MATH 20E,A01,083771,Staff,5,0,30,25
1650328686788,MATH 20E,A02,083772,Staff,19,0,30,11
1650328686788,MATH 20E,B01,083773,Staff,0,0,30,30
1650328686788,MATH 20E,B02,083774,Staff,12,0,30,18
1650328692815,MATH 103A,A01,083777,Staff,0,12,30,30
1650328692815,MATH 103A,A02,083778,Staff,0,12,30,30
1650328692815,MATH 103A,B01,083779,Staff,0,12,30,30
1650328692815,MATH 103A,B02,083780,Staff,0,11,30,30
1650328698837,MATH 105,A01,085443,Staff,0,19,30,30
1650328704860,MATH 109,A01,083213,Anzaldo; Leesa B,0,5,30,30
1650328704860,MATH 109,A02,083214,Anzaldo; Leesa B,0,7,30,30
1650328704860,MATH 109,B01,083215,Anzaldo; Leesa B,0,5,30,30
1650328704860,MATH 109,B02,083216,Anzaldo; Leesa B,0,5,30,30
1650328710886,MATH 142A,A01,083219,Chow; Bennett,0,14,30,30
1650328710886,MATH 142A,A02,083220,Chow; Bennett,0,12,30,30
1650328710886,MATH 142A,B01,083221,Chow; Bennett,0,12,30,30
1650328710886,MATH 142A,B02,083222,Chow; Bennett,0,12,30,30
1650328716919,MATH 193A,A01,083224,Staff,0,5,30,30
1650328716919,MATH 193A,A02,083225,Staff,0,5,30,30
1650328716919,MATH 193A,A03,083781,Staff,0,4,30,30
1650328716919,MATH 193A,A04,083782,Staff,0,3,30,30
1650328722941,MATH 197,001,091859,McAuley; Julian John,9998,0,9999,1
1650328728998,COGS 9,A01,083615,Staff,0,15,60,60
1650328735021,COGS 11,A01,083617,Boyle; Mary E. T.,22,0,40,18
1650328741047,COGS 13,A01,083071,Staff,0,31,40,40
1650328747072,COGS 14A,A01,092681,Staff,0,19,100,100
1650328753098,COGS 14B,A01,083073,Cheng; Tzu-Han,0,10,50,50
1650328759124,COGS 17,A01,092677,Staff,26,0,75,49
1650328765168,COGS 100,A01,083619,Staff,0,23,60,60
1650328771197,COGS 101A,A01,083621,Davis; Joshua Daniel,1,22,60,59
1650328777228,COGS 101B,A01,091572,Staff,2,0,60,58
1650328783253,COGS 101C,A01,083625,Delgado; Tania,18,0,30,12
1650328789276,COGS 107A,A01,083627,Boyle; Mary E. T.,0,8,60,60
1650328795299,COGS 118A,A01,083075,Staff,5,0,60,55
1650328801328,CSE 3,A50,083646,Miranda; Gregory Joseph,21,0,38,17
1650328801328,CSE 3,A51,083647,Miranda; Gregory Joseph,37,0,37,0
1650328807351,CSE 8A,A50,083650,Miranda; Gregory Joseph,0,27,40,40
1650328813377,CSE 11,A01,083080,Cao; Yingjun,0,87,40,40
1650328819402,CSE 12,A01,083652,Staff,0,12,100,100
1650328825425,CSE 15L,A01,083654,Staff,0,1,50,50
1650328825425,CSE 15L,A02,083655,Staff,3,0,50,47
1650328831452,CSE 20,A01,083657,Staff,53,0,80,27
1650328837475,CSE 30,A01,083084,Eldon; John,0,76,40,40
1650328843499,CSE 100,A01,083659,Cao; Yingjun,0,66,50,50
1650328849526,CSE 134B,A01,083661,Powell; Thomas Allan,0,30,65,65
1650328855549,CSE 140,A01,083663,Staff,0,0,75,75
1650328861573,CSE 140L,A01,083088,Eldon; John,0,6,75,75
1650328867598,CSE 175,A01,083665,Kumar; Rakesh,8,0,25,17
1650328873623,CSE 190,A00,092507,Dubnov; Shlomo,14,0,20,6
1650328879646,ECE 45,A01,083139,Staff,0,16,40,40
1650328885669,ECE 65,A50,083695,Staff,0,5,30,30
1650328891699,ECE 109,A01,091882,Touri; Behrouz,41,0,70,29
1650328897726,ECE 180,A00,083140,Abi Samra; Nicholas Camill,23,0,30,7
1650328897726,ECE 180,B00,083141,Abi Samra; Nicholas Camill,5,0,30,25
1650328903749,MATH 10A,A01,083735,Patchell; Gregory David,8,0,30,22
1650328903749,MATH 10A,A02,083736,Patchell; Gregory David,28,0,30,2
1650328903749,MATH 10A,A03,083737,Patchell; Gregory David,26,0,30,4
1650328909772,MATH 10B,A01,083207,Staff,0,7,30,30
1650328909772,MATH 10B,A02,083208,Staff,0,6,30,30
1650328909772,MATH 10B,B01,083739,Staff,17,0,30,13
1650328909772,MATH 10B,B02,083740,Staff,28,0,30,2
1650328915797,MATH 18,A01,083743,Staff,5,0,30,25
1650328915797,MATH 18,A02,083744,Staff,26,0,30,4
1650328915797,MATH 18,A03,083745,Staff,22,0,30,8
1650328915797,MATH 18,A04,083746,Staff,27,0,30,3
1650328915797,MATH 18,B01,083748,Staff,0,11,30,30
1650328915797,MATH 18,B02,083749,Staff,0,11,30,30
1650328915797,MATH 18,B03,083750,Staff,1,11,30,29
1650328915797,MATH 18,B04,083751,Staff,0,10,30,30
1650328921823,MATH 20A,A01,083754,Staff,26,0,40,14
1650328927848,MATH 20B,A01,083756,Staff,0,8,30,30
1650328927848,MATH 20B,A02,083757,Staff,0,8,30,30
1650328933874,MATH 20C,A01,083760,Staff,0,13,30,30
1650328933874,MATH 20C,A02,083761,Staff,0,13,30,30
1650328933874,MATH 20C,B01,083762,Staff,13,0,30,17
1650328933874,MATH 20C,B02,083763,Staff,28,0,30,2
1650328939904,MATH 20D,A01,083765,Staff,0,1,30,30
1650328939904,MATH 20D,A02,083766,Staff,7,0,30,23
1650328939904,MATH 20D,A03,083767,Staff,26,0,30,4
1650328945927,MATH 20E,A01,083771,Staff,5,0,30,25
1650328945927,MATH 20E,A02,083772,Staff,19,0,30,11
1650328945927,MATH 20E,B01,083773,Staff,0,0,30,30
1650328945927,MATH 20E,B02,083774,Staff,12,0,30,18
1650328951958,MATH 103A,A01,083777,Staff,0,12,30,30
1650328951958,MATH 103A,A02,083778,Staff,0,12,30,30
1650328951958,MATH 103A,B01,083779,Staff,0,12,30,30
1650328951958,MATH 103A,B02,083780,Staff,0,11,30,30
1650328957984,MATH 105,A01,085443,Staff,0,19,30,30
1650328964012,MATH 109,A01,083213,Anzaldo; Leesa B,0,5,30,30
1650328964012,MATH 109,A02,083214,Anzaldo; Leesa B,0,7,30,30
1650328964012,MATH 109,B01,083215,Anzaldo; Leesa B,0,5,30,30
1650328964012,MATH 109,B02,083216,Anzaldo; Leesa B,0,5,30,30
1650328970036,MATH 142A,A01,083219,Chow; Bennett,0,14,30,30
1650328970036,MATH 142A,A02,083220,Chow; Bennett,0,12,30,30
1650328970036,MATH 142A,B01,083221,Chow; Bennett,0,12,30,30
1650328970036,MATH 142A,B02,083222,Chow; Bennett,0,12,30,30
1650328976060,MATH 193A,A01,083224,Staff,0,5,30,30
1650328976060,MATH 193A,A02,083225,Staff,0,5,30,30
1650328976060,MATH 193A,A03,083781,Staff,0,4,30,30
1650328976060,MATH 193A,A04,083782,Staff,0,3,30,30
1650328982085,MATH 197,001,091859,McAuley; Julian John,9998,0,9999,1
1650328988133,COGS 9,A01,083615,Staff,0,15,60,60
1650328994158,COGS 11,A01,083617,Boyle; Mary E. T.,22,0,40,18
1650329000179,COGS 13,A01,083071,Staff,0,31,40,40
1650329006205,COGS 14A,A01,092681,Staff,0,19,100,100
1650329012228,COGS 14B,A01,083073,Cheng; Tzu-Han,0,10,50,50
1650329018249,COGS 17,A01,092677,Staff,26,0,75,49
1650329024275,COGS 100,A01,083619,Staff,0,23,60,60
1650329030309,COGS 101A,A01,083621,Davis; Joshua Daniel,1,22,60,59
1650329036332,COGS 101B,A01,091572,Staff,2,0,60,58
1650329042365,COGS 101C,A01,083625,Delgado; Tania,18,0,30,12
1650329048397,COGS 107A,A01,083627,Boyle; Mary E. T.,0,8,60,60
1650329054419,COGS 118A,A01,083075,Staff,5,0,60,55
1650329060456,CSE 3,A50,083646,Miranda; Gregory Joseph,21,0,38,17
1650329060456,CSE 3,A51,083647,Miranda; Gregory Joseph,37,0,37,0
1650329066481,CSE 8A,A50,083650,Miranda; Gregory Joseph,0,27,40,40
1650329072515,CSE 11,A01,083080,Cao; Yingjun,0,87,40,40
1650329078542,CSE 12,A01,083652,Staff,0,12,100,100
1650329084565,CSE 15L,A01,083654,Staff,0,1,50,50
1650329084565,CSE 15L,A02,083655,Staff,3,0,50,47
1650329090590,CSE 20,A01,083657,Staff,53,0,80,27
1650329096621,CSE 30,A01,083084,Eldon; John,0,76,40,40
1650329102655,CSE 100,A01,083659,Cao; Yingjun,0,66,50,50
1650329108685,CSE 134B,A01,083661,Powell; Thomas Allan,0,30,65,65
1650329114709,CSE 140,A01,083663,Staff,0,0,75,75
1650329120734,CSE 140L,A01,083088,Eldon; John,0,6,75,75
1650329126764,CSE 175,A01,083665,Kumar; Rakesh,8,0,25,17
1650329132789,CSE 190,A00,092507,Dubnov; Shlomo,14,0,20,6
1650329138814,ECE 45,A01,083139,Staff,0,16,40,40
1650329144840,ECE 65,A50,083695,Staff,0,5,30,30
1650329150875,ECE 109,A01,091882,Touri; Behrouz,41,0,70,29
1650329156902,ECE 180,A00,083140,Abi Samra; Nicholas Camill,23,0,30,7
1650329156902,ECE 180,B00,083141,Abi Samra; Nicholas Camill,5,0,30,25
1650329162925,MATH 10A,A01,083735,Patchell; Gregory David,8,0,30,22
1650329162925,MATH 10A,A02,083736,Patchell; Gregory David,28,0,30,2
1650329162925,MATH 10A,A03,083737,Patchell; Gregory David,26,0,30,4
1650329168948,MATH 10B,A01,083207,Staff,0,7,30,30
1650329168948,MATH 10B,A02,083208,Staff,0,6,30,30
1650329168948,MATH 10B,B01,083739,Staff,17,0,30,13
1650329168948,MATH 10B,B02,083740,Staff,28,0,30,2
1650329174973,MATH 18,A01,083743,Staff,5,0,30,25
1650329174973,MATH 18,A02,083744,Staff,26,0,30,4
1650329174973,MATH 18,A03,083745,Staff,22,0,30,8
1650329174973,MATH 18,A04,083746,Staff,27,0,30,3
1650329174973,MATH 18,B01,083748,Staff,0,11,30,30
1650329174973,MATH 18,B02,083749,Staff,0,11,30,30
1650329174973,MATH 18,B03,083750,Staff,1,11,30,29
1650329174973,MATH 18,B04,083751,Staff,0,10,30,30
1650329181002,MATH 20A,A01,083754,Staff,26,0,40,14
1650329187026,MATH 20B,A01,083756,Staff,0,8,30,30
1650329187026,MATH 20B,A02,083757,Staff,0,8,30,30
1650329193053,MATH 20C,A01,083760,Staff,0,13,30,30
1650329193053,MATH 20C,A02,083761,Staff,0,13,30,30
1650329193053,MATH 20C,B01,083762,Staff,13,0,30,17
1650329193053,MATH 20C,B02,083763,Staff,28,0,30,2
1650329199080,MATH 20D,A01,083765,Staff,0,1,30,30
1650329199080,MATH 20D,A02,083766,Staff,7,0,30,23
1650329199080,MATH 20D,A03,083767,Staff,26,0,30,4
1650329205108,MATH 20E,A01,083771,Staff,5,0,30,25
1650329205108,MATH 20E,A02,083772,Staff,19,0,30,11
1650329205108,MATH 20E,B01,083773,Staff,0,0,30,30
1650329205108,MATH 20E,B02,083774,Staff,12,0,30,18
1650329211228,MATH 103A,A01,083777,Staff,0,12,30,30
1650329211228,MATH 103A,A02,083778,Staff,0,12,30,30
1650329211228,MATH 103A,B01,083779,Staff,0,12,30,30
1650329211228,MATH 103A,B02,083780,Staff,0,11,30,30
1650329217251,MATH 105,A01,085443,Staff,0,19,30,30
1650329223279,MATH 109,A01,083213,Anzaldo; Leesa B,0,5,30,30
1650329223279,MATH 109,A02,083214,Anzaldo; Leesa B,0,7,30,30
1650329223279,MATH 109,B01,083215,Anzaldo; Leesa B,0,5,30,30
1650329223279,MATH 109,B02,083216,Anzaldo; Leesa B,0,5,30,30
1650329229304,MATH 142A,A01,083219,Chow; Bennett,0,14,30,30
1650329229304,MATH 142A,A02,083220,Chow; Bennett,0,12,30,30
1650329229304,MATH 142A,B01,083221,Chow; Bennett,0,12,30,30
1650329229304,MATH 142A,B02,083222,Chow; Bennett,0,12,30,30
1650329235335,MATH 193A,A01,083224,Staff,0,5,30,30
1650329235335,MATH 193A,A02,083225,Staff,0,5,30,30
1650329235335,MATH 193A,A03,083781,Staff,0,4,30,30
1650329235335,MATH 193A,A04,083782,Staff,0,3,30,30
1650329241360,MATH 197,001,091859,McAuley; Julian John,9998,0,9999,1
1650329247411,COGS 9,A01,083615,Staff,0,15,60,60
1650329253434,COGS 11,A01,083617,Boyle; Mary E. T.,22,0,40,18
1650329259455,COGS 13,A01,083071,Staff,0,31,40,40
1650329265482,COGS 14A,A01,092681,Staff,0,19,100,100
1650329271506,COGS 14B,A01,083073,Cheng; Tzu-Han,0,10,50,50
1650329277534,COGS 17,A01,092677,Staff,26,0,75,49
1650329283558,COGS 100,A01,083619,Staff,0,23,60,60
1650329289586,COGS 101A,A01,083621,Davis; Joshua Daniel,1,22,60,59
1650329295610,COGS 101B,A01,091572,Staff,2,0,60,58
1650329301631,COGS 101C,A01,083625,Delgado; Tania,18,0,30,12
1650329307660,COGS 107A,A01,083627,Boyle; Mary E. T.,0,8,60,60
1650329313689,COGS 118A,A01,083075,Staff,5,0,60,55
1650329319716,CSE 3,A50,083646,Miranda; Gregory Joseph,21,0,38,17
1650329319716,CSE 3,A51,083647,Miranda; Gregory Joseph,37,0,37,0
1650329325740,CSE 8A,A50,083650,Miranda; Gregory Joseph,0,27,40,40
1650329331769,CSE 11,A01,083080,Cao; Yingjun,0,87,40,40
1650329337792,CSE 12,A01,083652,Staff,0,12,100,100
1650329343815,CSE 15L,A01,083654,Staff,0,1,50,50
1650329343815,CSE 15L,A02,083655,Staff,3,0,50,47
1650329349842,CSE 20,A01,083657,Staff,53,0,80,27
1650329355875,CSE 30,A01,083084,Eldon; John,0,76,40,40
1650329361901,CSE 100,A01,083659,Cao; Yingjun,0,66,50,50
1650329367924,CSE 134B,A01,083661,Powell; Thomas Allan,0,30,65,65
1650329373958,CSE 140,A01,083663,Staff,0,0,75,75
1650329379987,CSE 140L,A01,083088,Eldon; John,0,6,75,75
1650329386016,CSE 175,A01,083665,Kumar; Rakesh,8,0,25,17
1650329392044,CSE 190,A00,092507,Dubnov; Shlomo,14,0,20,6
1650329398068,ECE 45,A01,083139,Staff,0,17,40,40
1650329404092,ECE 65,A50,083695,Staff,0,5,30,30
1650329410121,ECE 109,A01,091882,Touri; Behrouz,41,0,70,29
1650329416150,ECE 180,A00,083140,Abi Samra; Nicholas Camill,23,0,30,7
1650329416150,ECE 180,B00,083141,Abi Samra; Nicholas Camill,5,0,30,25
1650329422176,MATH 10A,A01,083735,Patchell; Gregory David,8,0,30,22
1650329422176,MATH 10A,A02,083736,Patchell; Gregory David,28,0,30,2
1650329422176,MATH 10A,A03,083737,Patchell; Gregory David,26,0,30,4
1650329428200,MATH 10B,A01,083207,Staff,0,7,30,30
1650329428200,MATH 10B,A02,083208,Staff,0,6,30,30
1650329428200,MATH 10B,B01,083739,Staff,17,0,30,13
1650329428200,MATH 10B,B02,083740,Staff,28,0,30,2
1650329434227,MATH 18,A01,083743,Staff,5,0,30,25
1650329434227,MATH 18,A02,083744,Staff,26,0,30,4
1650329434227,MATH 18,A03,083745,Staff,22,0,30,8
1650329434227,MATH 18,A04,083746,Staff,27,0,30,3
1650329434227,MATH 18,B01,083748,Staff,0,11,30,30
1650329434227,MATH 18,B02,083749,Staff,0,11,30,30
1650329434227,MATH 18,B03,083750,Staff,1,11,30,29
1650329434227,MATH 18,B04,083751,Staff,0,10,30,30
1650329440251,MATH 20A,A01,083754,Staff,26,0,40,14
1650329446276,MATH 20B,A01,083756,Staff,0,8,30,30
1650329446276,MATH 20B,A02,083757,Staff,0,8,30,30
1650329452299,MATH 20C,A01,083760,Staff,0,13,30,30
1650329452299,MATH 20C,A02,083761,Staff,0,13,30,30
1650329452299,MATH 20C,B01,083762,Staff,13,0,30,17
1650329452299,MATH 20C,B02,083763,Staff,28,0,30,2
1650329458338,MATH 20D,A01,083765,Staff,0,1,30,30
1650329458338,MATH 20D,A02,083766,Staff,7,0,30,23
1650329458338,MATH 20D,A03,083767,Staff,26,0,30,4
1650329464361,MATH 20E,A01,083771,Staff,5,0,30,25
1650329464361,MATH 20E,A02,083772,Staff,19,0,30,11
1650329464361,MATH 20E,B01,083773,Staff,0,0,30,30
1650329464361,MATH 20E,B02,083774,Staff,12,0,30,18
1650329470384,MATH 103A,A01,083777,Staff,0,12,30,30
1650329470384,MATH 103A,A02,083778,Staff,0,12,30,30
1650329470384,MATH 103A,B01,083779,Staff,0,12,30,30
1650329470384,MATH 103A,B02,083780,Staff,0,11,30,30
1650329476407,MATH 105,A01,085443,Staff,0,19,30,30
1650329482429,MATH 109,A01,083213,Anzaldo; Leesa B,0,5,30,30
1650329482429,MATH 109,A02,083214,Anzaldo; Leesa B,0,7,30,30
1650329482429,MATH 109,B01,083215,Anzaldo; Leesa B,0,5,30,30
1650329482429,MATH 109,B02,083216,Anzaldo; Leesa B,0,5,30,30
1650329488456,MATH 142A,A01,083219,Chow; Bennett,0,14,30,30
1650329488456,MATH 142A,A02,083220,Chow; Bennett,0,12,30,30
1650329488456,MATH 142A,B01,083221,Chow; Bennett,0,12,30,30
1650329488456,MATH 142A,B02,083222,Chow; Bennett,0,12,30,30
1650329494483,MATH 193A,A01,083224,Staff,0,5,30,30
1650329494483,MATH 193A,A02,083225,Staff,0,5,30,30
1650329494483,MATH 193A,A03,083781,Staff,0,4,30,30
1650329494483,MATH 193A,A04,083782,Staff,0,3,30,30
1650329500507,MATH 197,001,091859,McAuley; Julian John,9998,0,9999,1
1650329506565,COGS 9,A01,083615,Staff,0,15,60,60
1650329512593,COGS 11,A01,083617,Boyle; Mary E. T.,22,0,40,18
1650329518622,COGS 13,A01,083071,Staff,0,31,40,40
1650329524648,COGS 14A,A01,092681,Staff,0,19,100,100
1650329530692,COGS 14B,A01,083073,Cheng; Tzu-Han,0,10,50,50
1650329536716,COGS 17,A01,092677,Staff,26,0,75,49
1650329542748,COGS 100,A01,083619,Staff,0,23,60,60
1650329548771,COGS 101A,A01,083621,Davis; Joshua Daniel,1,22,60,59
1650329554808,COGS 101B,A01,091572,Staff,2,0,60,58
1650329560832,COGS 101C,A01,083625,Delgado; Tania,18,0,30,12
1650329566858,COGS 107A,A01,083627,Boyle; Mary E. T.,0,8,60,60
1650329572890,COGS 118A,A01,083075,Staff,5,0,60,55
1650329578919,CSE 3,A50,083646,Miranda; Gregory Joseph,21,0,38,17
1650329578919,CSE 3,A51,083647,Miranda; Gregory Joseph,37,0,37,0
1650329584942,CSE 8A,A50,083650,Miranda; Gregory Joseph,0,27,40,40
1650329590974,CSE 11,A01,083080,Cao; Yingjun,0,87,40,40
1650329597001,CSE 12,A01,083652,Staff,0,12,100,100
1650329603027,CSE 15L,A01,083654,Staff,0,1,50,50
1650329603027,CSE 15L,A02,083655,Staff,3,0,50,47
1650329609061,CSE 20,A01,083657,Staff,53,0,80,27
1650329615087,CSE 30,A01,083084,Eldon; John,0,76,40,40
1650329621111,CSE 100,A01,083659,Cao; Yingjun,0,66,50,50
1650329627133,CSE 134B,A01,083661,Powell; Thomas Allan,0,31,65,65
1650329633159,CSE 140,A01,083663,Staff,0,0,75,75
1650329639183,CSE 140L,A01,083088,Eldon; John,0,6,75,75
1650329645204,CSE 175,A01,083665,Kumar; Rakesh,8,0,25,17
1650329651245,CSE 190,A00,092507,Dubnov; Shlomo,14,0,20,6
1650329657272,ECE 45,A01,083139,Staff,0,17,40,40
1650329663300,ECE 65,A50,083695,Staff,0,5,30,30
1650329669322,ECE 109,A01,091882,Touri; Behrouz,41,0,70,29
1650329675352,ECE 180,A00,083140,Abi Samra; Nicholas Camill,23,0,30,7
1650329675352,ECE 180,B00,083141,Abi Samra; Nicholas Camill,5,0,30,25
1650329681374,MATH 10A,A01,083735,Patchell; Gregory David,8,0,30,22
1650329681374,MATH 10A,A02,083736,Patchell; Gregory David,28,0,30,2
1650329681374,MATH 10A,A03,083737,Patchell; Gregory David,26,0,30,4
1650329687401,MATH 10B,A01,083207,Staff,0,7,30,30
1650329687401,MATH 10B,A02,083208,Staff,0,6,30,30
1650329687401,MATH 10B,B01,083739,Staff,17,0,30,13
1650329687401,MATH 10B,B02,083740,Staff,28,0,30,2
1650329693426,MATH 18,A01,083743,Staff,5,0,30,25
1650329693426,MATH 18,A02,083744,Staff,26,0,30,4
1650329693426,MATH 18,A03,083745,Staff,22,0,30,8
1650329693426,MATH 18,A04,083746,Staff,27,0,30,3
1650329693426,MATH 18,B01,083748,Staff,0,11,30,30
1650329693426,MATH 18,B02,083749,Staff,0,11,30,30
1650329693426,MATH 18,B03,083750,Staff,1,11,30,29
1650329693426,MATH 18,B04,083751,Staff,0,10,30,30
1650329699453,MATH 20A,A01,083754,Staff,26,0,40,14
1650329705479,MATH 20B,A01,083756,Staff,0,8,30,30
1650329705479,MATH 20B,A02,083757,Staff,0,8,30,30
1650329711508,MATH 20C,A01,083760,Staff,0,13,30,30
1650329711508,MATH 20C,A02,083761,Staff,0,13,30,30
1650329711508,MATH 20C,B01,083762,Staff,13,0,30,17
1650329711508,MATH 20C,B02,083763,Staff,28,0,30,2
1650329717532,MATH 20D,A01,083765,Staff,0,1,30,30
1650329717532,MATH 20D,A02,083766,Staff,7,0,30,23
1650329717532,MATH 20D,A03,083767,Staff,26,0,30,4
1650329723556,MATH 20E,A01,083771,Staff,5,0,30,25
1650329723556,MATH 20E,A02,083772,Staff,19,0,30,11
1650329723556,MATH 20E,B01,083773,Staff,0,0,30,30
1650329723556,MATH 20E,B02,083774,Staff,12,0,30,18
1650329729585,MATH 103A,A01,083777,Staff,0,12,30,30
1650329729585,MATH 103A,A02,083778,Staff,0,12,30,30
1650329729585,MATH 103A,B01,083779,Staff,0,12,30,30
1650329729585,MATH 103A,B02,083780,Staff,0,11,30,30
1650329735612,MATH 105,A01,085443,Staff,0,19,30,30
1650329741635,MATH 109,A01,083213,Anzaldo; Leesa B,0,5,30,30
1650329741635,MATH 109,A02,083214,Anzaldo; Leesa B,0,7,30,30
1650329741635,MATH 109,B01,083215,Anzaldo; Leesa B,0,5,30,30
1650329741635,MATH 109,B02,083216,Anzaldo; Leesa B,0,5,30,30
1650329747664,MATH 142A,A01,083219,Chow; Bennett,0,14,30,30
1650329747664,MATH 142A,A02,083220,Chow; Bennett,0,12,30,30
1650329747664,MATH 142A,B01,083221,Chow; Bennett,0,12,30,30
1650329747664,MATH 142A,B02,083222,Chow; Bennett,0,12,30,30
1650329753686,MATH 193A,A01,083224,Staff,0,5,30,30
1650329753686,MATH 193A,A02,083225,Staff,0,5,30,30
1650329753686,MATH 193A,A03,083781,Staff,0,4,30,30
1650329753686,MATH 193A,A04,083782,Staff,0,3,30,30
1650329759709,MATH 197,001,091859,McAuley; Julian John,9998,0,9999,1
1650329765761,COGS 9,A01,083615,Staff,0,15,60,60
1650329771787,COGS 11,A01,083617,Boyle; Mary E. T.,22,0,40,18
1650329777811,COGS 13,A01,083071,Staff,0,31,40,40
1650329783834,COGS 14A,A01,092681,Staff,0,19,100,100
1650329789856,COGS 14B,A01,083073,Cheng; Tzu-Han,0,10,50,50
1650329795890,COGS 17,A01,092677,Staff,26,0,75,49
1650329802005,COGS 100,A01,083619,Staff,0,23,60,60
1650329808032,COGS 101A,A01,083621,Davis; Joshua Daniel,1,22,60,59
1650329814059,COGS 101B,A01,091572,Staff,2,0,60,58
1650329820080,COGS 101C,A01,083625,Delgado; Tania,18,0,30,12
1650329826105,COGS 107A,A01,083627,Boyle; Mary E. T.,0,8,60,60
1650329832128,COGS 118A,A01,083075,Staff,5,0,60,55
1650329838170,CSE 3,A50,083646,Miranda; Gregory Joseph,21,0,38,17
1650329838170,CSE 3,A51,083647,Miranda; Gregory Joseph,37,0,37,0
1650329844198,CSE 8A,A50,083650,Miranda; Gregory Joseph,0,27,40,40
1650329850224,CSE 11,A01,083080,Cao; Yingjun,0,87,40,40
1650329856246,CSE 12,A01,083652,Staff,0,12,100,100
1650329862270,CSE 15L,A01,083654,Staff,0,1,50,50
1650329862270,CSE 15L,A02,083655,Staff,3,0,50,47
1650329868295,CSE 20,A01,083657,Staff,53,0,80,27
1650329874320,CSE 30,A01,083084,Eldon; John,0,76,40,40
1650329880351,CSE 100,A01,083659,Cao; Yingjun,0,66,50,50
1650329886387,CSE 134B,A01,083661,Powell; Thomas Allan,0,31,65,65
1650329892418,CSE 140,A01,083663,Staff,0,0,75,75
1650329898443,CSE 140L,A01,083088,Eldon; John,0,6,75,75
1650329904465,CSE 175,A01,083665,Kumar; Rakesh,8,0,25,17
1650329910488,CSE 190,A00,092507,Dubnov; Shlomo,14,0,20,6
1650329916526,ECE 45,A01,083139,Staff,0,17,40,40
1650329922549,ECE 65,A50,083695,Staff,0,5,30,30
1650329928570,ECE 109,A01,091882,Touri; Behrouz,41,0,70,29
1650329934599,ECE 180,A00,083140,Abi Samra; Nicholas Camill,23,0,30,7
1650329934599,ECE 180,B00,083141,Abi Samra; Nicholas Camill,5,0,30,25
1650329940626,MATH 10A,A01,083735,Patchell; Gregory David,8,0,30,22
1650329940626,MATH 10A,A02,083736,Patchell; Gregory David,28,0,30,2
1650329940626,MATH 10A,A03,083737,Patchell; Gregory David,26,0,30,4
1650329946652,MATH 10B,A01,083207,Staff,0,7,30,30
1650329946652,MATH 10B,A02,083208,Staff,0,6,30,30
1650329946652,MATH 10B,B01,083739,Staff,17,0,30,13
1650329946652,MATH 10B,B02,083740,Staff,28,0,30,2
1650329952675,MATH 18,A01,083743,Staff,5,0,30,25
1650329952675,MATH 18,A02,083744,Staff,26,0,30,4
1650329952675,MATH 18,A03,083745,Staff,22,0,30,8
1650329952675,MATH 18,A04,083746,Staff,27,0,30,3
1650329952675,MATH 18,B01,083748,Staff,0,11,30,30
1650329952675,MATH 18,B02,083749,Staff,0,11,30,30
1650329952675,MATH 18,B03,083750,Staff,1,11,30,29
1650329952675,MATH 18,B04,083751,Staff,0,10,30,30
1650329958700,MATH 20A,A01,083754,Staff,26,0,40,14
1650329964723,MATH 20B,A01,083756,Staff,0,8,30,30
1650329964723,MATH 20B,A02,083757,Staff,0,8,30,30
1650329970751,MATH 20C,A01,083760,Staff,0,13,30,30
1650329970751,MATH 20C,A02,083761,Staff,0,13,30,30
1650329970751,MATH 20C,B01,083762,Staff,13,0,30,17
1650329970751,MATH 20C,B02,083763,Staff,28,0,30,2
1650329976778,MATH 20D,A01,083765,Staff,0,1,30,30
1650329976778,MATH 20D,A02,083766,Staff,7,0,30,23
1650329976778,MATH 20D,A03,083767,Staff,26,0,30,4
1650329982804,MATH 20E,A01,083771,Staff,5,0,30,25
1650329982804,MATH 20E,A02,083772,Staff,19,0,30,11
1650329982804,MATH 20E,B01,083773,Staff,0,0,30,30
1650329982804,MATH 20E,B02,083774,Staff,12,0,30,18
1650329988828,MATH 103A,A01,083777,Staff,0,12,30,30
1650329988828,MATH 103A,A02,083778,Staff,0,12,30,30
1650329988828,MATH 103A,B01,083779,Staff,0,12,30,30
1650329988828,MATH 103A,B02,083780,Staff,0,11,30,30
1650329994857,MATH 105,A01,085443,Staff,0,19,30,30
1650330000889,MATH 109,A01,083213,Anzaldo; Leesa B,0,5,30,30
1650330000889,MATH 109,A02,083214,Anzaldo; Leesa B,0,7,30,30
1650330000889,MATH 109,B01,083215,Anzaldo; Leesa B,0,5,30,30
1650330000889,MATH 109,B02,083216,Anzaldo; Leesa B,0,5,30,30
1650330006918,MATH 142A,A01,083219,Chow; Bennett,0,14,30,30
1650330006918,MATH 142A,A02,083220,Chow; Bennett,0,12,30,30
1650330006918,MATH 142A,B01,083221,Chow; Bennett,0,12,30,30
1650330006918,MATH 142A,B02,083222,Chow; Bennett,0,12,30,30
1650330012940,MATH 193A,A01,083224,Staff,0,5,30,30
1650330012940,MATH 193A,A02,083225,Staff,0,5,30,30
1650330012940,MATH 193A,A03,083781,Staff,0,4,30,30
1650330012940,MATH 193A,A04,083782,Staff,0,3,30,30
1650330018965,MATH 197,001,091859,McAuley; Julian John,9998,0,9999,1
1650330025017,COGS 9,A01,083615,Staff,0,15,60,60
1650330031043,COGS 11,A01,083617,Boyle; Mary E. T.,22,0,40,18
1650330037072,COGS 13,A01,083071,Staff,0,31,40,40
1650330043112,COGS 14A,A01,092681,Staff,0,19,100,100
1650330049135,COGS 14B,A01,083073,Cheng; Tzu-Han,0,10,50,50
1650330055158,COGS 17,A01,092677,Staff,26,0,75,49
1650330061185,COGS 100,A01,083619,Staff,0,23,60,60
1650330067216,COGS 101A,A01,083621,Davis; Joshua Daniel,1,22,60,59
1650330073241,COGS 101B,A01,091572,Staff,2,0,60,58
1650330079267,COGS 101C,A01,083625,Delgado; Tania,18,0,30,12
1650330085288,COGS 107A,A01,083627,Boyle; Mary E. T.,0,8,60,60
1650330091311,COGS 118A,A01,083075,Staff,5,0,60,55
1650330097339,CSE 3,A50,083646,Miranda; Gregory Joseph,21,0,38,17
1650330097339,CSE 3,A51,083647,Miranda; Gregory Joseph,37,0,37,0
1650330103363,CSE 8A,A50,083650,Miranda; Gregory Joseph,0,27,40,40
1650330109387,CSE 11,A01,083080,Cao; Yingjun,0,87,40,40
1650330115410,CSE 12,A01,083652,Staff,0,12,100,100
1650330121436,CSE 15L,A01,083654,Staff,0,1,50,50
1650330121436,CSE 15L,A02,083655,Staff,3,0,50,47
1650330127467,CSE 20,A01,083657,Staff,53,0,80,27
1650330133491,CSE 30,A01,083084,Eldon; John,0,76,40,40
1650330139514,CSE 100,A01,083659,Cao; Yingjun,0,66,50,50
1650330145538,CSE 134B,A01,083661,Powell; Thomas Allan,0,31,65,65
1650330151564,CSE 140,A01,083663,Staff,0,0,75,75
1650330157587,CSE 140L,A01,083088,Eldon; John,0,6,75,75
1650330163615,CSE 175,A01,083665,Kumar; Rakesh,8,0,25,17
1650330169640,CSE 190,A00,092507,Dubnov; Shlomo,14,0,20,6
1650330175664,ECE 45,A01,083139,Staff,0,17,40,40
1650330181685,ECE 65,A50,083695,Staff,0,5,30,30
1650330187712,ECE 109,A01,091882,Touri; Behrouz,41,0,70,29
1650330193739,ECE 180,A00,083140,Abi Samra; Nicholas Camill,23,0,30,7
1650330193739,ECE 180,B00,083141,Abi Samra; Nicholas Camill,5,0,30,25
1650330199763,MATH 10A,A01,083735,Patchell; Gregory David,8,0,30,22
1650330199763,MATH 10A,A02,083736,Patchell; Gregory David,28,0,30,2
1650330199763,MATH 10A,A03,083737,Patchell; Gregory David,26,0,30,4
1650330205785,MATH 10B,A01,083207,Staff,0,7,30,30
1650330205785,MATH 10B,A02,083208,Staff,0,6,30,30
1650330205785,MATH 10B,B01,083739,Staff,17,0,30,13
1650330205785,MATH 10B,B02,083740,Staff,28,0,30,2
1650330211816,MATH 18,A01,083743,Staff,5,0,30,25
1650330211816,MATH 18,A02,083744,Staff,26,0,30,4
1650330211816,MATH 18,A03,083745,Staff,22,0,30,8
1650330211816,MATH 18,A04,083746,Staff,27,0,30,3
1650330211816,MATH 18,B01,083748,Staff,0,11,30,30
1650330211816,MATH 18,B02,083749,Staff,0,11,30,30
1650330211816,MATH 18,B03,083750,Staff,1,11,30,29
1650330211816,MATH 18,B04,083751,Staff,0,10,30,30
1650330217841,MATH 20A,A01,083754,Staff,26,0,40,14
1650330223867,MATH 20B,A01,083756,Staff,0,8,30,30
1650330223867,MATH 20B,A02,083757,Staff,0,8,30,30
1650330229894,MATH 20C,A01,083760,Staff,0,13,30,30
1650330229894,MATH 20C,A02,083761,Staff,0,13,30,30
1650330229894,MATH 20C,B01,083762,Staff,13,0,30,17
1650330229894,MATH 20C,B02,083763,Staff,28,0,30,2
1650330235916,MATH 20D,A01,083765,Staff,0,1,30,30
1650330235916,MATH 20D,A02,083766,Staff,7,0,30,23
1650330235916,MATH 20D,A03,083767,Staff,26,0,30,4
1650330241945,MATH 20E,A01,083771,Staff,5,0,30,25
1650330241945,MATH 20E,A02,083772,Staff,19,0,30,11
1650330241945,MATH 20E,B01,083773,Staff,0,0,30,30
1650330241945,MATH 20E,B02,083774,Staff,12,0,30,18
1650330247968,MATH 103A,A01,083777,Staff,0,12,30,30
1650330247968,MATH 103A,A02,083778,Staff,0,12,30,30
1650330247968,MATH 103A,B01,083779,Staff,0,12,30,30
1650330247968,MATH 103A,B02,083780,Staff,0,11,30,30
1650330253990,MATH 105,A01,085443,Staff,0,19,30,30
1650330260013,MATH 109,A01,083213,Anzaldo; Leesa B,0,5,30,30
1650330260013,MATH 109,A02,083214,Anzaldo; Leesa B,0,7,30,30
1650330260013,MATH 109,B01,083215,Anzaldo; Leesa B,0,5,30,30
1650330260013,MATH 109,B02,083216,Anzaldo; Leesa B,0,5,30,30
1650330266039,MATH 142A,A01,083219,Chow; Bennett,0,14,30,30
1650330266039,MATH 142A,A02,083220,Chow; Bennett,0,12,30,30
1650330266039,MATH 142A,B01,083221,Chow; Bennett,0,12,30,30
1650330266039,MATH 142A,B02,083222,Chow; Bennett,0,12,30,30
1650330272077,MATH 193A,A01,083224,Staff,0,5,30,30
1650330272077,MATH 193A,A02,083225,Staff,0,5,30,30
1650330272077,MATH 193A,A03,083781,Staff,0,4,30,30
1650330272077,MATH 193A,A04,083782,Staff,0,3,30,30
1650330278100,MATH 197,001,091859,McAuley; Julian John,9998,0,9999,1
1650330284166,COGS 9,A01,083615,Staff,0,15,60,60
1650330290189,COGS 11,A01,083617,Boyle; Mary E. T.,22,0,40,18
1650330296212,COGS 13,A01,083071,Staff,0,31,40,40
1650330302237,COGS 14A,A01,092681,Staff,0,19,100,100
1650330308260,COGS 14B,A01,083073,Cheng; Tzu-Han,0,10,50,50
1650330314284,COGS 17,A01,092677,Staff,26,0,75,49
1650330320316,COGS 100,A01,083619,Staff,0,23,60,60
1650330326344,COGS 101A,A01,083621,Davis; Joshua Daniel,1,22,60,59
1650330332370,COGS 101B,A01,091572,Staff,2,0,60,58
1650330338394,COGS 101C,A01,083625,Delgado; Tania,18,0,30,12
1650330344418,COGS 107A,A01,083627,Boyle; Mary E. T.,0,8,60,60
1650330350442,COGS 118A,A01,083075,Staff,5,0,60,55
1650330356466,CSE 3,A50,083646,Miranda; Gregory Joseph,21,0,38,17
1650330356466,CSE 3,A51,083647,Miranda; Gregory Joseph,37,0,37,0
1650330362493,CSE 8A,A50,083650,Miranda; Gregory Joseph,0,27,40,40
1650330368521,CSE 11,A01,083080,Cao; Yingjun,0,87,40,40
1650330374550,CSE 12,A01,083652,Staff,0,12,100,100
1650330380574,CSE 15L,A01,083654,Staff,0,1,50,50
1650330380574,CSE 15L,A02,083655,Staff,3,0,50,47
1650330386599,CSE 20,A01,083657,Staff,53,0,80,27
1650330392625,CSE 30,A01,083084,Eldon; John,0,76,40,40
1650330398724,CSE 100,A01,083659,Cao; Yingjun,0,66,50,50
1650330404748,CSE 134B,A01,083661,Powell; Thomas Allan,0,31,65,65
1650330410773,CSE 140,A01,083663,Staff,0,0,75,75
1650330416797,CSE 140L,A01,083088,Eldon; John,0,6,75,75
1650330422825,CSE 175,A01,083665,Kumar; Rakesh,8,0,25,17
1650330428850,CSE 190,A00,092507,Dubnov; Shlomo,14,0,20,6
1650330434876,ECE 45,A01,083139,Staff,0,17,40,40
1650330440898,ECE 65,A50,083695,Staff,0,5,30,30
1650330446925,ECE 109,A01,091882,Touri; Behrouz,41,0,70,29
1650330452947,ECE 180,A00,083140,Abi Samra; Nicholas Camill,23,0,30,7
1650330452947,ECE 180,B00,083141,Abi Samra; Nicholas Camill,5,0,30,25
1650330458975,MATH 10A,A01,083735,Patchell; Gregory David,8,0,30,22
1650330458975,MATH 10A,A02,083736,Patchell; Gregory David,28,0,30,2
1650330458975,MATH 10A,A03,083737,Patchell; Gregory David,26,0,30,4
1650330465003,MATH 10B,A01,083207,Staff,0,7,30,30
1650330465003,MATH 10B,A02,083208,Staff,0,6,30,30
1650330465003,MATH 10B,B01,083739,Staff,17,0,30,13
1650330465003,MATH 10B,B02,083740,Staff,28,0,30,2
1650330471028,MATH 18,A01,083743,Staff,5,0,30,25
1650330471028,MATH 18,A02,083744,Staff,26,0,30,4
1650330471028,MATH 18,A03,083745,Staff,22,0,30,8
1650330471028,MATH 18,A04,083746,Staff,27,0,30,3
1650330471028,MATH 18,B01,083748,Staff,0,11,30,30
1650330471028,MATH 18,B02,083749,Staff,0,11,30,30
1650330471028,MATH 18,B03,083750,Staff,1,11,30,29
1650330471028,MATH 18,B04,083751,Staff,0,10,30,30
1650330477056,MATH 20A,A01,083754,Staff,26,0,40,14
1650330483080,MATH 20B,A01,083756,Staff,0,8,30,30
1650330483080,MATH 20B,A02,083757,Staff,0,8,30,30
1650330489103,MATH 20C,A01,083760,Staff,0,13,30,30
1650330489103,MATH 20C,A02,083761,Staff,0,13,30,30
1650330489103,MATH 20C,B01,083762,Staff,13,0,30,17
1650330489103,MATH 20C,B02,083763,Staff,28,0,30,2
1650330495131,MATH 20D,A01,083765,Staff,0,1,30,30
1650330495131,MATH 20D,A02,083766,Staff,7,0,30,23
1650330495131,MATH 20D,A03,083767,Staff,26,0,30,4
1650330501154,MATH 20E,A01,083771,Staff,5,0,30,25
1650330501154,MATH 20E,A02,083772,Staff,19,0,30,11
1650330501154,MATH 20E,B01,083773,Staff,0,0,30,30
1650330501154,MATH 20E,B02,083774,Staff,12,0,30,18
1650330507177,MATH 103A,A01,083777,Staff,0,12,30,30
1650330507177,MATH 103A,A02,083778,Staff,0,12,30,30
1650330507177,MATH 103A,B01,083779,Staff,0,12,30,30
1650330507177,MATH 103A,B02,083780,Staff,0,11,30,30
1650330513204,MATH 105,A01,085443,Staff,0,19,30,30
1650330519232,MATH 109,A01,083213,Anzaldo; Leesa B,0,5,30,30
1650330519232,MATH 109,A02,083214,Anzaldo; Leesa B,0,7,30,30
1650330519232,MATH 109,B01,083215,Anzaldo; Leesa B,0,5,30,30
1650330519232,MATH 109,B02,083216,Anzaldo; Leesa B,0,5,30,30
1650330525257,MATH 142A,A01,083219,Chow; Bennett,0,14,30,30
1650330525257,MATH 142A,A02,083220,Chow; Bennett,0,12,30,30
1650330525257,MATH 142A,B01,083221,Chow; Bennett,0,12,30,30
1650330525257,MATH 142A,B02,083222,Chow; Bennett,0,12,30,30
1650330531280,MATH 193A,A01,083224,Staff,0,5,30,30
1650330531280,MATH 193A,A02,083225,Staff,0,5,30,30
1650330531280,MATH 193A,A03,083781,Staff,0,4,30,30
1650330531280,MATH 193A,A04,083782,Staff,0,3,30,30
1650330537302,MATH 197,001,091859,McAuley; Julian John,9998,0,9999,1
1650330543354,COGS 9,A01,083615,Staff,0,15,60,60
1650330549377,COGS 11,A01,083617,Boyle; Mary E. T.,22,0,40,18
1650330555400,COGS 13,A01,083071,Staff,0,31,40,40
1650330561430,COGS 14A,A01,092681,Staff,0,19,100,100
1650330567452,COGS 14B,A01,083073,Cheng; Tzu-Han,0,10,50,50
1650330573478,COGS 17,A01,092677,Staff,26,0,75,49
1650330579508,COGS 100,A01,083619,Staff,0,23,60,60
1650330585536,COGS 101A,A01,083621,Davis; Joshua Daniel,1,22,60,59
1650330591564,COGS 101B,A01,091572,Staff,2,0,60,58
1650330597588,COGS 101C,A01,083625,Delgado; Tania,18,0,30,12
1650330603611,COGS 107A,A01,083627,Boyle; Mary E. T.,0,8,60,60
1650330609635,COGS 118A,A01,083075,Staff,5,0,60,55
1650330615659,CSE 3,A50,083646,Miranda; Gregory Joseph,21,0,38,17
1650330615659,CSE 3,A51,083647,Miranda; Gregory Joseph,37,0,37,0
1650330621683,CSE 8A,A50,083650,Miranda; Gregory Joseph,0,27,40,40
1650330627709,CSE 11,A01,083080,Cao; Yingjun,0,87,40,40
1650330633732,CSE 12,A01,083652,Staff,0,12,100,100
1650330639756,CSE 15L,A01,083654,Staff,0,1,50,50
1650330639756,CSE 15L,A02,083655,Staff,3,0,50,47
1650330645785,CSE 20,A01,083657,Staff,53,0,80,27
1650330651815,CSE 30,A01,083084,Eldon; John,0,76,40,40
1650330657839,CSE 100,A01,083659,Cao; Yingjun,0,66,50,50
1650330663863,CSE 134B,A01,083661,Powell; Thomas Allan,0,31,65,65
1650330669887,CSE 140,A01,083663,Staff,0,0,75,75
1650330675910,CSE 140L,A01,083088,Eldon; John,0,6,75,75
1650330681933,CSE 175,A01,083665,Kumar; Rakesh,8,0,25,17
1650330687960,CSE 190,A00,092507,Dubnov; Shlomo,14,0,20,6
1650330693984,ECE 45,A01,083139,Staff,0,17,40,40
1650330700010,ECE 65,A50,083695,Staff,0,5,30,30
1650330706033,ECE 109,A01,091882,Touri; Behrouz,41,0,70,29
1650330712059,ECE 180,A00,083140,Abi Samra; Nicholas Camill,23,0,30,7
1650330712059,ECE 180,B00,083141,Abi Samra; Nicholas Camill,5,0,30,25
1650330718081,MATH 10A,A01,083735,Patchell; Gregory David,8,0,30,22
1650330718081,MATH 10A,A02,083736,Patchell; Gregory David,28,0,30,2
1650330718081,MATH 10A,A03,083737,Patchell; Gregory David,26,0,30,4
1650330724108,MATH 10B,A01,083207,Staff,0,7,30,30
1650330724108,MATH 10B,A02,083208,Staff,0,6,30,30
1650330724108,MATH 10B,B01,083739,Staff,17,0,30,13
1650330724108,MATH 10B,B02,083740,Staff,28,0,30,2
1650330730138,MATH 18,A01,083743,Staff,5,0,30,25
1650330730138,MATH 18,A02,083744,Staff,26,0,30,4
1650330730138,MATH 18,A03,083745,Staff,22,0,30,8
1650330730138,MATH 18,A04,083746,Staff,27,0,30,3
1650330730138,MATH 18,B01,083748,Staff,0,11,30,30
1650330730138,MATH 18,B02,083749,Staff,0,11,30,30
1650330730138,MATH 18,B03,083750,Staff,1,11,30,29
1650330730138,MATH 18,B04,083751,Staff,0,10,30,30
1650330736159,MATH 20A,A01,083754,Staff,26,0,40,14
1650330742182,MATH 20B,A01,083756,Staff,0,8,30,30
1650330742182,MATH 20B,A02,083757,Staff,0,8,30,30
1650330748206,MATH 20C,A01,083760,Staff,0,13,30,30
1650330748206,MATH 20C,A02,083761,Staff,0,13,30,30
1650330748206,MATH 20C,B01,083762,Staff,13,0,30,17
1650330748206,MATH 20C,B02,083763,Staff,28,0,30,2
1650330754235,MATH 20D,A01,083765,Staff,0,1,30,30
1650330754235,MATH 20D,A02,083766,Staff,7,0,30,23
1650330754235,MATH 20D,A03,083767,Staff,26,0,30,4
1650330760261,MATH 20E,A01,083771,Staff,5,0,30,25
1650330760261,MATH 20E,A02,083772,Staff,19,0,30,11
1650330760261,MATH 20E,B01,083773,Staff,0,0,30,30
1650330760261,MATH 20E,B02,083774,Staff,12,0,30,18
1650330766292,MATH 103A,A01,083777,Staff,0,12,30,30
1650330766292,MATH 103A,A02,083778,Staff,0,12,30,30
1650330766292,MATH 103A,B01,083779,Staff,0,13,30,30
1650330766292,MATH 103A,B02,083780,Staff,0,11,30,30
1650330772322,MATH 105,A01,085443,Staff,0,19,30,30
1650330778344,MATH 109,A01,083213,Anzaldo; Leesa B,0,5,30,30
1650330778344,MATH 109,A02,083214,Anzaldo; Leesa B,0,7,30,30
1650330778344,MATH 109,B01,083215,Anzaldo; Leesa B,0,5,30,30
1650330778344,MATH 109,B02,083216,Anzaldo; Leesa B,0,5,30,30
1650330784371,MATH 142A,A01,083219,Chow; Bennett,0,14,30,30
1650330784371,MATH 142A,A02,083220,Chow; Bennett,0,12,30,30
1650330784371,MATH 142A,B01,083221,Chow; Bennett,0,12,30,30
1650330784371,MATH 142A,B02,083222,Chow; Bennett,0,12,30,30
1650330790393,MATH 193A,A01,083224,Staff,0,5,30,30
1650330790393,MATH 193A,A02,083225,Staff,0,5,30,30
1650330790393,MATH 193A,A03,083781,Staff,0,4,30,30
1650330790393,MATH 193A,A04,083782,Staff,0,3,30,30
1650330796415,MATH 197,001,091859,McAuley; Julian John,9998,0,9999,1
1650330802466,COGS 9,A01,083615,Staff,0,15,60,60
1650330808495,COGS 11,A01,083617,Boyle; Mary E. T.,22,0,40,18
1650330814524,COGS 13,A01,083071,Staff,0,31,40,40
1650330820546,COGS 14A,A01,092681,Staff,0,19,100,100
1650330826572,COGS 14B,A01,083073,Cheng; Tzu-Han,0,10,50,50
1650330832605,COGS 17,A01,092677,Staff,26,0,75,49
1650330838638,COGS 100,A01,083619,Staff,0,23,60,60
1650330844665,COGS 101A,A01,083621,Davis; Joshua Daniel,1,22,60,59
1650330850691,COGS 101B,A01,091572,Staff,2,0,60,58
1650330856713,COGS 101C,A01,083625,Delgado; Tania,18,0,30,12
1650330862736,COGS 107A,A01,083627,Boyle; Mary E. T.,0,8,60,60
1650330868762,COGS 118A,A01,083075,Staff,5,0,60,55
1650330874784,CSE 3,A50,083646,Miranda; Gregory Joseph,21,0,38,17
1650330874784,CSE 3,A51,083647,Miranda; Gregory Joseph,37,0,37,0
1650330880812,CSE 8A,A50,083650,Miranda; Gregory Joseph,0,27,40,40
1650330886833,CSE 11,A01,083080,Cao; Yingjun,0,87,40,40
1650330892868,CSE 12,A01,083652,Staff,0,12,100,100
1650330898900,CSE 15L,A01,083654,Staff,0,1,50,50
1650330898900,CSE 15L,A02,083655,Staff,3,0,50,47
1650330904927,CSE 20,A01,083657,Staff,53,0,80,27
1650330910950,CSE 30,A01,083084,Eldon; John,0,76,40,40
1650330916974,CSE 100,A01,083659,Cao; Yingjun,0,66,50,50
1650330922997,CSE 134B,A01,083661,Powell; Thomas Allan,0,31,65,65
1650330929019,CSE 140,A01,083663,Staff,0,0,75,75
1650330935066,CSE 140L,A01,083088,Eldon; John,0,6,75,75
1650330941089,CSE 175,A01,083665,Kumar; Rakesh,8,0,25,17
1650330947118,CSE 190,A00,092507,Dubnov; Shlomo,14,0,20,6
1650330953142,ECE 45,A01,083139,Staff,0,17,40,40
1650330959165,ECE 65,A50,083695,Staff,0,5,30,30
1650330965200,ECE 109,A01,091882,Touri; Behrouz,41,0,70,29
1650330971222,ECE 180,A00,083140,Abi Samra; Nicholas Camill,23,0,30,7
1650330971222,ECE 180,B00,083141,Abi Samra; Nicholas Camill,5,0,30,25
1650330977244,MATH 10A,A01,083735,Patchell; Gregory David,8,0,30,22
1650330977244,MATH 10A,A02,083736,Patchell; Gregory David,28,0,30,2
1650330977244,MATH 10A,A03,083737,Patchell; Gregory David,26,0,30,4
1650330983270,MATH 10B,A01,083207,Staff,0,7,30,30
1650330983270,MATH 10B,A02,083208,Staff,0,6,30,30
1650330983270,MATH 10B,B01,083739,Staff,17,0,30,13
1650330983270,MATH 10B,B02,083740,Staff,28,0,30,2
1650330989300,MATH 18,A01,083743,Staff,5,0,30,25
1650330989300,MATH 18,A02,083744,Staff,26,0,30,4
1650330989300,MATH 18,A03,083745,Staff,22,0,30,8
1650330989300,MATH 18,A04,083746,Staff,27,0,30,3
1650330989300,MATH 18,B01,083748,Staff,0,11,30,30
1650330989300,MATH 18,B02,083749,Staff,0,11,30,30
1650330989300,MATH 18,B03,083750,Staff,1,11,30,29
1650330989300,MATH 18,B04,083751,Staff,0,10,30,30
1650330995414,MATH 20A,A01,083754,Staff,26,0,40,14
1650331001443,MATH 20B,A01,083756,Staff,0,8,30,30
1650331001443,MATH 20B,A02,083757,Staff,0,8,30,30
1650331007469,MATH 20C,A01,083760,Staff,0,13,30,30
1650331007469,MATH 20C,A02,083761,Staff,0,13,30,30
1650331007469,MATH 20C,B01,083762,Staff,13,0,30,17
1650331007469,MATH 20C,B02,083763,Staff,28,0,30,2
1650331013494,MATH 20D,A01,083765,Staff,0,1,30,30
1650331013494,MATH 20D,A02,083766,Staff,7,0,30,23
1650331013494,MATH 20D,A03,083767,Staff,26,0,30,4
1650331019519,MATH 20E,A01,083771,Staff,5,0,30,25
1650331019519,MATH 20E,A02,083772,Staff,19,0,30,11
1650331019519,MATH 20E,B01,083773,Staff,0,0,30,30
1650331019519,MATH 20E,B02,083774,Staff,12,0,30,18
1650331025546,MATH 103A,A01,083777,Staff,0,12,30,30
1650331025546,MATH 103A,A02,083778,Staff,0,12,30,30
1650331025546,MATH 103A,B01,083779,Staff,0,13,30,30
1650331025546,MATH 103A,B02,083780,Staff,0,11,30,30
1650331031585,MATH 105,A01,085443,Staff,0,19,30,30
1650331037612,MATH 109,A01,083213,Anzaldo; Leesa B,0,5,30,30
1650331037612,MATH 109,A02,083214,Anzaldo; Leesa B,0,7,30,30
1650331037612,MATH 109,B01,083215,Anzaldo; Leesa B,0,5,30,30
1650331037612,MATH 109,B02,083216,Anzaldo; Leesa B,0,5,30,30
1650331043635,MATH 142A,A01,083219,Chow; Bennett,0,14,30,30
1650331043635,MATH 142A,A02,083220,Chow; Bennett,0,12,30,30
1650331043635,MATH 142A,B01,083221,Chow; Bennett,0,12,30,30
1650331043635,MATH 142A,B02,083222,Chow; Bennett,0,12,30,30
1650331049658,MATH 193A,A01,083224,Staff,0,5,30,30
1650331049658,MATH 193A,A02,083225,Staff,0,5,30,30
1650331049658,MATH 193A,A03,083781,Staff,0,4,30,30
1650331049658,MATH 193A,A04,083782,Staff,0,3,30,30
1650331055680,MATH 197,001,091859,McAuley; Julian John,9998,0,9999,1
1650331061731,COGS 9,A01,083615,Staff,0,15,60,60
1650331067756,COGS 11,A01,083617,Boyle; Mary E. T.,22,0,40,18
1650331073782,COGS 13,A01,083071,Staff,0,31,40,40
1650331079805,COGS 14A,A01,092681,Staff,0,19,100,100
1650331085828,COGS 14B,A01,083073,Cheng; Tzu-Han,0,10,50,50
1650331091854,COGS 17,A01,092677,Staff,26,0,75,49
1650331097878,COGS 100,A01,083619,Staff,0,23,60,60
1650331103904,COGS 101A,A01,083621,Davis; Joshua Daniel,1,22,60,59
1650331109933,COGS 101B,A01,091572,Staff,2,0,60,58
1650331115957,COGS 101C,A01,083625,Delgado; Tania,18,0,30,12
1650331121985,COGS 107A,A01,083627,Boyle; Mary E. T.,0,8,60,60
1650331128010,COGS 118A,A01,083075,Staff,5,0,60,55
1650331134038,CSE 3,A50,083646,Miranda; Gregory Joseph,21,0,38,17
1650331134038,CSE 3,A51,083647,Miranda; Gregory Joseph,37,0,37,0
1650331140072,CSE 8A,A50,083650,Miranda; Gregory Joseph,0,27,40,40
1650331146099,CSE 11,A01,083080,Cao; Yingjun,0,87,40,40
1650331152129,CSE 12,A01,083652,Staff,0,12,100,100
1650331158155,CSE 15L,A01,083654,Staff,0,1,50,50
1650331158155,CSE 15L,A02,083655,Staff,3,0,50,47
1650331164179,CSE 20,A01,083657,Staff,53,0,80,27
1650331170207,CSE 30,A01,083084,Eldon; John,0,76,40,40
1650331176231,CSE 100,A01,083659,Cao; Yingjun,0,66,50,50
1650331182265,CSE 134B,A01,083661,Powell; Thomas Allan,0,31,65,65
1650331188288,CSE 140,A01,083663,Staff,0,0,75,75
1650331194312,CSE 140L,A01,083088,Eldon; John,0,6,75,75
1650331200336,CSE 175,A01,083665,Kumar; Rakesh,8,0,25,17
1650331206362,CSE 190,A00,092507,Dubnov; Shlomo,14,0,20,6
1650331212387,ECE 45,A01,083139,Staff,0,17,40,40
1650331218414,ECE 65,A50,083695,Staff,0,5,30,30
1650331224438,ECE 109,A01,091882,Touri; Behrouz,41,0,70,29
1650331230465,ECE 180,A00,083140,Abi Samra; Nicholas Camill,23,0,30,7
1650331230465,ECE 180,B00,083141,Abi Samra; Nicholas Camill,5,0,30,25
1650331236493,MATH 10A,A01,083735,Patchell; Gregory David,8,0,30,22
1650331236493,MATH 10A,A02,083736,Patchell; Gregory David,28,0,30,2
1650331236493,MATH 10A,A03,083737,Patchell; Gregory David,26,0,30,4
1650331242524,MATH 10B,A01,083207,Staff,0,7,30,30
1650331242524,MATH 10B,A02,083208,Staff,0,6,30,30
1650331242524,MATH 10B,B01,083739,Staff,17,0,30,13
1650331242524,MATH 10B,B02,083740,Staff,28,0,30,2
1650331248553,MATH 18,A01,083743,Staff,5,0,30,25
1650331248553,MATH 18,A02,083744,Staff,26,0,30,4
1650331248553,MATH 18,A03,083745,Staff,22,0,30,8
1650331248553,MATH 18,A04,083746,Staff,27,0,30,3
1650331248553,MATH 18,B01,083748,Staff,0,11,30,30
1650331248553,MATH 18,B02,083749,Staff,0,11,30,30
1650331248553,MATH 18,B03,083750,Staff,1,11,30,29
1650331248553,MATH 18,B04,083751,Staff,0,10,30,30
1650331254578,MATH 20A,A01,083754,Staff,26,0,40,14
1650331260613,MATH 20B,A01,083756,Staff,0,8,30,30
1650331260613,MATH 20B,A02,083757,Staff,0,8,30,30
1650331266647,MATH 20C,A01,083760,Staff,0,13,30,30
1650331266647,MATH 20C,A02,083761,Staff,0,13,30,30
1650331266647,MATH 20C,B01,083762,Staff,13,0,30,17
1650331266647,MATH 20C,B02,083763,Staff,28,0,30,2
1650331272676,MATH 20D,A01,083765,Staff,0,1,30,30
1650331272676,MATH 20D,A02,083766,Staff,7,0,30,23
1650331272676,MATH 20D,A03,083767,Staff,26,0,30,4
1650331278704,MATH 20E,A01,083771,Staff,5,0,30,25
1650331278704,MATH 20E,A02,083772,Staff,19,0,30,11
1650331278704,MATH 20E,B01,083773,Staff,0,0,30,30
1650331278704,MATH 20E,B02,083774,Staff,12,0,30,18
1650331284729,MATH 103A,A01,083777,Staff,0,12,30,30
1650331284729,MATH 103A,A02,083778,Staff,0,12,30,30
1650331284729,MATH 103A,B01,083779,Staff,0,13,30,30
1650331284729,MATH 103A,B02,083780,Staff,0,11,30,30
1650331290751,MATH 105,A01,085443,Staff,0,19,30,30
1650331296774,MATH 109,A01,083213,Anzaldo; Leesa B,0,5,30,30
1650331296774,MATH 109,A02,083214,Anzaldo; Leesa B,0,7,30,30
1650331296774,MATH 109,B01,083215,Anzaldo; Leesa B,0,5,30,30
1650331296774,MATH 109,B02,083216,Anzaldo; Leesa B,0,5,30,30
1650331302796,MATH 142A,A01,083219,Chow; Bennett,0,14,30,30
1650331302796,MATH 142A,A02,083220,Chow; Bennett,0,12,30,30
1650331302796,MATH 142A,B01,083221,Chow; Bennett,0,12,30,30
1650331302796,MATH 142A,B02,083222,Chow; Bennett,0,12,30,30
1650331308825,MATH 193A,A01,083224,Staff,0,5,30,30
1650331308825,MATH 193A,A02,083225,Staff,0,5,30,30
1650331308825,MATH 193A,A03,083781,Staff,0,4,30,30
1650331308825,MATH 193A,A04,083782,Staff,0,3,30,30
1650331314848,MATH 197,001,091859,McAuley; Julian John,9998,0,9999,1
1650331320900,COGS 9,A01,083615,Staff,0,15,60,60
1650331326923,COGS 11,A01,083617,Boyle; Mary E. T.,22,0,40,18
1650331332948,COGS 13,A01,083071,Staff,0,31,40,40
1650331338976,COGS 14A,A01,092681,Staff,0,19,100,100
1650331345000,COGS 14B,A01,083073,Cheng; Tzu-Han,0,10,50,50
1650331351024,COGS 17,A01,092677,Staff,26,0,75,49
1650331357048,COGS 100,A01,083619,Staff,0,23,60,60
1650331363079,COGS 101A,A01,083621,Davis; Joshua Daniel,1,22,60,59
1650331369110,COGS 101B,A01,091572,Staff,2,0,60,58
1650331375133,COGS 101C,A01,083625,Delgado; Tania,18,0,30,12
1650331381160,COGS 107A,A01,083627,Boyle; Mary E. T.,0,8,60,60
1650331387186,COGS 118A,A01,083075,Staff,5,0,60,55
1650331393210,CSE 3,A50,083646,Miranda; Gregory Joseph,21,0,38,17
1650331393210,CSE 3,A51,083647,Miranda; Gregory Joseph,37,0,37,0
1650331399233,CSE 8A,A50,083650,Miranda; Gregory Joseph,0,27,40,40
1650331405257,CSE 11,A01,083080,Cao; Yingjun,0,87,40,40
1650331411279,CSE 12,A01,083652,Staff,0,12,100,100
1650331417303,CSE 15L,A01,083654,Staff,0,1,50,50
1650331417303,CSE 15L,A02,083655,Staff,3,0,50,47
1650331423326,CSE 20,A01,083657,Staff,53,0,80,27
1650331429350,CSE 30,A01,083084,Eldon; John,0,76,40,40
1650331435378,CSE 100,A01,083659,Cao; Yingjun,0,66,50,50
1650331441402,CSE 134B,A01,083661,Powell; Thomas Allan,0,31,65,65
1650331447427,CSE 140,A01,083663,Staff,0,0,75,75
1650331453453,CSE 140L,A01,083088,Eldon; John,0,6,75,75
1650331459474,CSE 175,A01,083665,Kumar; Rakesh,8,0,25,17
1650331465497,CSE 190,A00,092507,Dubnov; Shlomo,14,0,20,6
1650331471521,ECE 45,A01,083139,Staff,0,17,40,40
1650331477544,ECE 65,A50,083695,Staff,0,5,30,30
1650331483572,ECE 109,A01,091882,Touri; Behrouz,41,0,70,29
1650331489596,ECE 180,A00,083140,Abi Samra; Nicholas Camill,23,0,30,7
1650331489596,ECE 180,B00,083141,Abi Samra; Nicholas Camill,5,0,30,25
1650331495619,MATH 10A,A01,083735,Patchell; Gregory David,8,0,30,22
1650331495619,MATH 10A,A02,083736,Patchell; Gregory David,28,0,30,2
1650331495619,MATH 10A,A03,083737,Patchell; Gregory David,26,0,30,4
1650331501647,MATH 10B,A01,083207,Staff,0,7,30,30
1650331501647,MATH 10B,A02,083208,Staff,0,6,30,30
1650331501647,MATH 10B,B01,083739,Staff,17,0,30,13
1650331501647,MATH 10B,B02,083740,Staff,28,0,30,2
1650331507675,MATH 18,A01,083743,Staff,5,0,30,25
1650331507675,MATH 18,A02,083744,Staff,26,0,30,4
1650331507675,MATH 18,A03,083745,Staff,22,0,30,8
1650331507675,MATH 18,A04,083746,Staff,27,0,30,3
1650331507675,MATH 18,B01,083748,Staff,0,11,30,30
1650331507675,MATH 18,B02,083749,Staff,0,11,30,30
1650331507675,MATH 18,B03,083750,Staff,1,11,30,29
1650331507675,MATH 18,B04,083751,Staff,0,10,30,30
1650331513701,MATH 20A,A01,083754,Staff,26,0,40,14
1650331519727,MATH 20B,A01,083756,Staff,0,8,30,30
1650331519727,MATH 20B,A02,083757,Staff,0,8,30,30
1650331525751,MATH 20C,A01,083760,Staff,0,13,30,30
1650331525751,MATH 20C,A02,083761,Staff,0,13,30,30
1650331525751,MATH 20C,B01,083762,Staff,13,0,30,17
1650331525751,MATH 20C,B02,083763,Staff,28,0,30,2
1650331531782,MATH 20D,A01,083765,Staff,0,1,30,30
1650331531782,MATH 20D,A02,083766,Staff,7,0,30,23
1650331531782,MATH 20D,A03,083767,Staff,26,0,30,4
1650331537805,MATH 20E,A01,083771,Staff,5,0,30,25
1650331537805,MATH 20E,A02,083772,Staff,19,0,30,11
1650331537805,MATH 20E,B01,083773,Staff,0,0,30,30
1650331537805,MATH 20E,B02,083774,Staff,12,0,30,18
1650331543829,MATH 103A,A01,083777,Staff,0,12,30,30
1650331543829,MATH 103A,A02,083778,Staff,0,12,30,30
1650331543829,MATH 103A,B01,083779,Staff,0,13,30,30
1650331543829,MATH 103A,B02,083780,Staff,0,11,30,30
1650331549860,MATH 105,A01,085443,Staff,0,19,30,30
1650331555891,MATH 109,A01,083213,Anzaldo; Leesa B,0,5,30,30
1650331555891,MATH 109,A02,083214,Anzaldo; Leesa B,0,7,30,30
1650331555891,MATH 109,B01,083215,Anzaldo; Leesa B,0,5,30,30
1650331555891,MATH 109,B02,083216,Anzaldo; Leesa B,0,5,30,30
1650331561915,MATH 142A,A01,083219,Chow; Bennett,0,14,30,30
1650331561915,MATH 142A,A02,083220,Chow; Bennett,0,12,30,30
1650331561915,MATH 142A,B01,083221,Chow; Bennett,0,12,30,30
1650331561915,MATH 142A,B02,083222,Chow; Bennett,0,12,30,30
1650331567939,MATH 193A,A01,083224,Staff,0,5,30,30
1650331567939,MATH 193A,A02,083225,Staff,0,5,30,30
1650331567939,MATH 193A,A03,083781,Staff,0,4,30,30
1650331567939,MATH 193A,A04,083782,Staff,0,3,30,30
1650331573965,MATH 197,001,091859,McAuley; Julian John,9998,0,9999,1
1650331580014,COGS 9,A01,083615,Staff,0,15,60,60
1650331586148,COGS 11,A01,083617,Boyle; Mary E. T.,22,0,40,18
1650331592182,COGS 13,A01,083071,Staff,0,31,40,40
1650331598206,COGS 14A,A01,092681,Staff,0,19,100,100
1650331613036,COGS 14B,A01,083073,Cheng; Tzu-Han,0,10,50,50
1650331619059,COGS 17,A01,092677,Staff,26,0,75,49
1650331625086,COGS 100,A01,083619,Staff,0,23,60,60
1650331631114,COGS 101A,A01,083621,Davis; Joshua Daniel,1,22,60,59
1650331637138,COGS 101B,A01,091572,Staff,2,0,60,58
1650331643161,COGS 101C,A01,083625,Delgado; Tania,18,0,30,12
1650331649190,COGS 107A,A01,083627,Boyle; Mary E. T.,0,8,60,60
1650331655211,COGS 118A,A01,083075,Staff,5,0,60,55
1650331661234,CSE 3,A50,083646,Miranda; Gregory Joseph,21,0,38,17
1650331661234,CSE 3,A51,083647,Miranda; Gregory Joseph,37,0,37,0
1650331667257,CSE 8A,A50,083650,Miranda; Gregory Joseph,0,27,40,40
1650331673284,CSE 11,A01,083080,Cao; Yingjun,0,87,40,40
1650331679307,CSE 12,A01,083652,Staff,0,12,100,100
1650331685349,CSE 15L,A01,083654,Staff,0,1,50,50
1650331685349,CSE 15L,A02,083655,Staff,3,0,50,47
1650331691371,CSE 20,A01,083657,Staff,53,0,80,27
1650331697394,CSE 30,A01,083084,Eldon; John,0,76,40,40
1650331703421,CSE 100,A01,083659,Cao; Yingjun,0,66,50,50
1650331709447,CSE 134B,A01,083661,Powell; Thomas Allan,0,31,65,65
1650331715471,CSE 140,A01,083663,Staff,0,0,75,75
1650331721495,CSE 140L,A01,083088,Eldon; John,0,6,75,75
1650331727526,CSE 175,A01,083665,Kumar; Rakesh,8,0,25,17
1650331733568,CSE 190,A00,092507,Dubnov; Shlomo,14,0,20,6
1650331739601,ECE 45,A01,083139,Staff,0,17,40,40
1650331745630,ECE 65,A50,083695,Staff,0,5,30,30
1650331751654,ECE 109,A01,091882,Touri; Behrouz,40,0,70,30
1650331757678,ECE 180,A00,083140,Abi Samra; Nicholas Camill,23,0,30,7
1650331757678,ECE 180,B00,083141,Abi Samra; Nicholas Camill,5,0,30,25
1650331763701,MATH 10A,A01,083735,Patchell; Gregory David,8,0,30,22
1650331763701,MATH 10A,A02,083736,Patchell; Gregory David,28,0,30,2
1650331763701,MATH 10A,A03,083737,Patchell; Gregory David,26,0,30,4
1650331769727,MATH 10B,A01,083207,Staff,0,7,30,30
1650331769727,MATH 10B,A02,083208,Staff,0,6,30,30
1650331769727,MATH 10B,B01,083739,Staff,17,0,30,13
1650331769727,MATH 10B,B02,083740,Staff,28,0,30,2
1650331775761,MATH 18,A01,083743,Staff,4,0,30,26
1650331775761,MATH 18,A02,083744,Staff,27,0,30,3
1650331775761,MATH 18,A03,083745,Staff,22,0,30,8
1650331775761,MATH 18,A04,083746,Staff,27,0,30,3
1650331775761,MATH 18,B01,083748,Staff,0,11,30,30
1650331775761,MATH 18,B02,083749,Staff,0,11,30,30
1650331775761,MATH 18,B03,083750,Staff,1,11,30,29
1650331775761,MATH 18,B04,083751,Staff,0,10,30,30
1650331781784,MATH 20A,A01,083754,Staff,26,0,40,14
1650331787810,MATH 20B,A01,083756,Staff,0,8,30,30
1650331787810,MATH 20B,A02,083757,Staff,0,8,30,30
1650331793836,MATH 20C,A01,083760,Staff,0,13,30,30
1650331793836,MATH 20C,A02,083761,Staff,0,13,30,30
1650331793836,MATH 20C,B01,083762,Staff,13,0,30,17
1650331793836,MATH 20C,B02,083763,Staff,28,0,30,2
1650331799862,MATH 20D,A01,083765,Staff,0,1,30,30
1650331799862,MATH 20D,A02,083766,Staff,7,0,30,23
1650331799862,MATH 20D,A03,083767,Staff,26,0,30,4
1650331805892,MATH 20E,A01,083771,Staff,5,0,30,25
1650331805892,MATH 20E,A02,083772,Staff,19,0,30,11
1650331805892,MATH 20E,B01,083773,Staff,0,0,30,30
1650331805892,MATH 20E,B02,083774,Staff,12,0,30,18
1650331811915,MATH 103A,A01,083777,Staff,0,12,30,30
1650331811915,MATH 103A,A02,083778,Staff,0,12,30,30
1650331811915,MATH 103A,B01,083779,Staff,0,12,30,30
1650331811915,MATH 103A,B02,083780,Staff,0,12,30,30
1650331817953,MATH 105,A01,085443,Staff,0,19,30,30
1650331823978,MATH 109,A01,083213,Anzaldo; Leesa B,0,5,30,30
1650331823978,MATH 109,A02,083214,Anzaldo; Leesa B,0,7,30,30
1650331823978,MATH 109,B01,083215,Anzaldo; Leesa B,0,5,30,30
1650331823978,MATH 109,B02,083216,Anzaldo; Leesa B,0,5,30,30
1650331830002,MATH 142A,A01,083219,Chow; Bennett,0,14,30,30
1650331830002,MATH 142A,A02,083220,Chow; Bennett,0,12,30,30
1650331830002,MATH 142A,B01,083221,Chow; Bennett,0,12,30,30
1650331830002,MATH 142A,B02,083222,Chow; Bennett,0,12,30,30
1650331836042,MATH 193A,A01,083224,Staff,0,5,30,30
1650331836042,MATH 193A,A02,083225,Staff,0,5,30,30
1650331836042,MATH 193A,A03,083781,Staff,0,4,30,30
1650331836042,MATH 193A,A04,083782,Staff,0,3,30,30
1650331842065,MATH 197,001,091859,McAuley; Julian John,9998,0,9999,1
1650331848147,COGS 9,A01,083615,Staff,0,15,60,60
1650331854187,COGS 11,A01,083617,Boyle; Mary E. T.,22,0,40,18
1650331860211,COGS 13,A01,083071,Staff,0,31,40,40
1650331866235,COGS 14A,A01,092681,Staff,0,19,100,100
1650331872269,COGS 14B,A01,083073,Cheng; Tzu-Han,0,10,50,50
1650331878295,COGS 17,A01,092677,Staff,26,0,75,49
1650331884320,COGS 100,A01,083619,Staff,0,23,60,60
1650331890351,COGS 101A,A01,083621,Davis; Joshua Daniel,1,22,60,59
1650331896375,COGS 101B,A01,091572,Staff,2,0,60,58
1650331902403,COGS 101C,A01,083625,Delgado; Tania,18,0,30,12
1650331908427,COGS 107A,A01,083627,Boyle; Mary E. T.,0,8,60,60
1650331914469,COGS 118A,A01,083075,Staff,5,0,60,55
1650331920504,CSE 3,A50,083646,Miranda; Gregory Joseph,21,0,38,17
1650331920504,CSE 3,A51,083647,Miranda; Gregory Joseph,37,0,37,0
1650331926527,CSE 8A,A50,083650,Miranda; Gregory Joseph,0,27,40,40
1650331932549,CSE 11,A01,083080,Cao; Yingjun,0,87,40,40
1650331938573,CSE 12,A01,083652,Staff,0,12,100,100
1650331944597,CSE 15L,A01,083654,Staff,0,1,50,50
1650331944597,CSE 15L,A02,083655,Staff,3,0,50,47
1650331950665,CSE 20,A01,083657,Staff,53,0,80,27
1650331956688,CSE 30,A01,083084,Eldon; John,0,76,40,40
1650331962720,CSE 100,A01,083659,Cao; Yingjun,0,66,50,50
1650331968750,CSE 134B,A01,083661,Powell; Thomas Allan,0,31,65,65
1650331974776,CSE 140,A01,083663,Staff,0,0,75,75
1650331980800,CSE 140L,A01,083088,Eldon; John,0,6,75,75
1650331986829,CSE 175,A01,083665,Kumar; Rakesh,8,0,25,17
1650331992855,CSE 190,A00,092507,Dubnov; Shlomo,14,0,20,6
1650331998881,ECE 45,A01,083139,Staff,0,17,40,40
1650332004907,ECE 65,A50,083695,Staff,0,5,30,30
1650332010938,ECE 109,A01,091882,Touri; Behrouz,40,0,70,30
1650332016965,ECE 180,A00,083140,Abi Samra; Nicholas Camill,23,0,30,7
1650332016965,ECE 180,B00,083141,Abi Samra; Nicholas Camill,5,0,30,25
1650332022989,MATH 10A,A01,083735,Patchell; Gregory David,8,0,30,22
1650332022989,MATH 10A,A02,083736,Patchell; Gregory David,28,0,30,2
1650332022989,MATH 10A,A03,083737,Patchell; Gregory David,26,0,30,4
1650332029014,MATH 10B,A01,083207,Staff,0,7,30,30
1650332029014,MATH 10B,A02,083208,Staff,0,6,30,30
1650332029014,MATH 10B,B01,083739,Staff,17,0,30,13
1650332029014,MATH 10B,B02,083740,Staff,28,0,30,2
1650332035039,MATH 18,A01,083743,Staff,4,0,30,26
1650332035039,MATH 18,A02,083744,Staff,27,0,30,3
1650332035039,MATH 18,A03,083745,Staff,22,0,30,8
1650332035039,MATH 18,A04,083746,Staff,27,0,30,3
1650332035039,MATH 18,B01,083748,Staff,0,11,30,30
1650332035039,MATH 18,B02,083749,Staff,0,11,30,30
1650332035039,MATH 18,B03,083750,Staff,1,11,30,29
1650332035039,MATH 18,B04,083751,Staff,0,10,30,30
1650332041079,MATH 20A,A01,083754,Staff,26,0,40,14
1650332047103,MATH 20B,A01,083756,Staff,0,8,30,30
1650332047103,MATH 20B,A02,083757,Staff,0,8,30,30
1650332053135,MATH 20C,A01,083760,Staff,0,13,30,30
1650332053135,MATH 20C,A02,083761,Staff,0,13,30,30
1650332053135,MATH 20C,B01,083762,Staff,13,0,30,17
1650332053135,MATH 20C,B02,083763,Staff,28,0,30,2
1650332059160,MATH 20D,A01,083765,Staff,0,1,30,30
1650332059160,MATH 20D,A02,083766,Staff,7,0,30,23
1650332059160,MATH 20D,A03,083767,Staff,26,0,30,4
1650332065195,MATH 20E,A01,083771,Staff,5,0,30,25
1650332065195,MATH 20E,A02,083772,Staff,19,0,30,11
1650332065195,MATH 20E,B01,083773,Staff,0,0,30,30
1650332065195,MATH 20E,B02,083774,Staff,12,0,30,18
1650332071230,MATH 103A,A01,083777,Staff,0,12,30,30
1650332071230,MATH 103A,A02,083778,Staff,0,12,30,30
1650332071230,MATH 103A,B01,083779,Staff,0,12,30,30
1650332071230,MATH 103A,B02,083780,Staff,0,12,30,30
1650332077254,MATH 105,A01,085443,Staff,0,19,30,30
1650332083276,MATH 109,A01,083213,Anzaldo; Leesa B,0,5,30,30
1650332083276,MATH 109,A02,083214,Anzaldo; Leesa B,0,7,30,30
1650332083276,MATH 109,B01,083215,Anzaldo; Leesa B,0,5,30,30
1650332083276,MATH 109,B02,083216,Anzaldo; Leesa B,0,5,30,30
1650332089303,MATH 142A,A01,083219,Chow; Bennett,0,14,30,30
1650332089303,MATH 142A,A02,083220,Chow; Bennett,0,12,30,30
1650332089303,MATH 142A,B01,083221,Chow; Bennett,0,12,30,30
1650332089303,MATH 142A,B02,083222,Chow; Bennett,0,12,30,30
1650332095338,MATH 193A,A01,083224,Staff,0,5,30,30
1650332095338,MATH 193A,A02,083225,Staff,0,5,30,30
1650332095338,MATH 193A,A03,083781,Staff,0,4,30,30
1650332095338,MATH 193A,A04,083782,Staff,0,3,30,30
1650332101360,MATH 197,001,091859,McAuley; Julian John,9998,0,9999,1
1650332107417,COGS 9,A01,083615,Staff,0,15,60,60
1650332113439,COGS 11,A01,083617,Boyle; Mary E. T.,22,0,40,18
1650332119471,COGS 13,A01,083071,Staff,0,31,40,40
1650332125497,COGS 14A,A01,092681,Staff,0,19,100,100
1650332131520,COGS 14B,A01,083073,Cheng; Tzu-Han,0,10,50,50
1650332137544,COGS 17,A01,092677,Staff,26,0,75,49
1650332143580,COGS 100,A01,083619,Staff,0,23,60,60
1650332149609,COGS 101A,A01,083621,Davis; Joshua Daniel,1,22,60,59
1650332155633,COGS 101B,A01,091572,Staff,2,0,60,58
1650332161666,COGS 101C,A01,083625,Delgado; Tania,18,0,30,12
1650332167700,COGS 107A,A01,083627,Boyle; Mary E. T.,0,8,60,60
1650332173724,COGS 118A,A01,083075,Staff,5,0,60,55
1650332179758,CSE 3,A50,083646,Miranda; Gregory Joseph,21,0,38,17
1650332179758,CSE 3,A51,083647,Miranda; Gregory Joseph,37,0,37,0
1650332185784,CSE 8A,A50,083650,Miranda; Gregory Joseph,0,27,40,40
1650332191905,CSE 11,A01,083080,Cao; Yingjun,0,87,40,40
1650332197929,CSE 12,A01,083652,Staff,0,12,100,100
1650332203954,CSE 15L,A01,083654,Staff,0,1,50,50
1650332203954,CSE 15L,A02,083655,Staff,3,0,50,47
1650332209986,CSE 20,A01,083657,Staff,53,0,80,27
1650332216010,CSE 30,A01,083084,Eldon; John,0,76,40,40
1650332222038,CSE 100,A01,083659,Cao; Yingjun,0,66,50,50
1650332228065,CSE 134B,A01,083661,Powell; Thomas Allan,0,31,65,65
1650332234089,CSE 140,A01,083663,Staff,0,0,75,75
1650332240111,CSE 140L,A01,083088,Eldon; John,0,6,75,75
1650332246135,CSE 175,A01,083665,Kumar; Rakesh,8,0,25,17
1650332252163,CSE 190,A00,092507,Dubnov; Shlomo,14,0,20,6
1650332258188,ECE 45,A01,083139,Staff,0,17,40,40
1650332264218,ECE 65,A50,083695,Staff,0,5,30,30
1650332270249,ECE 109,A01,091882,Touri; Behrouz,40,0,70,30
1650332276272,ECE 180,A00,083140,Abi Samra; Nicholas Camill,23,0,30,7
1650332276272,ECE 180,B00,083141,Abi Samra; Nicholas Camill,5,0,30,25
1650332282299,MATH 10A,A01,083735,Patchell; Gregory David,8,0,30,22
1650332282299,MATH 10A,A02,083736,Patchell; Gregory David,28,0,30,2
1650332282299,MATH 10A,A03,083737,Patchell; Gregory David,26,0,30,4
1650332288327,MATH 10B,A01,083207,Staff,0,7,30,30
1650332288327,MATH 10B,A02,083208,Staff,0,6,30,30
1650332288327,MATH 10B,B01,083739,Staff,17,0,30,13
1650332288327,MATH 10B,B02,083740,Staff,28,0,30,2
1650332294358,MATH 18,A01,083743,Staff,4,0,30,26
1650332294358,MATH 18,A02,083744,Staff,27,0,30,3
1650332294358,MATH 18,A03,083745,Staff,22,0,30,8
1650332294358,MATH 18,A04,083746,Staff,27,0,30,3
1650332294358,MATH 18,B01,083748,Staff,0,11,30,30
1650332294358,MATH 18,B02,083749,Staff,0,11,30,30
1650332294358,MATH 18,B03,083750,Staff,1,11,30,29
1650332294358,MATH 18,B04,083751,Staff,0,10,30,30
1650332300382,MATH 20A,A01,083754,Staff,26,0,40,14
1650332306406,MATH 20B,A01,083756,Staff,0,8,30,30
1650332306406,MATH 20B,A02,083757,Staff,0,8,30,30
1650332312430,MATH 20C,A01,083760,Staff,0,13,30,30
1650332312430,MATH 20C,A02,083761,Staff,0,13,30,30
1650332312430,MATH 20C,B01,083762,Staff,13,0,30,17
1650332312430,MATH 20C,B02,083763,Staff,28,0,30,2
1650332318455,MATH 20D,A01,083765,Staff,0,1,30,30
1650332318455,MATH 20D,A02,083766,Staff,7,0,30,23
1650332318455,MATH 20D,A03,083767,Staff,26,0,30,4
1650332324480,MATH 20E,A01,083771,Staff,5,0,30,25
1650332324480,MATH 20E,A02,083772,Staff,19,0,30,11
1650332324480,MATH 20E,B01,083773,Staff,0,0,30,30
1650332324480,MATH 20E,B02,083774,Staff,12,0,30,18
1650332330507,MATH 103A,A01,083777,Staff,0,12,30,30
1650332330507,MATH 103A,A02,083778,Staff,0,12,30,30
1650332330507,MATH 103A,B01,083779,Staff,0,12,30,30
1650332330507,MATH 103A,B02,083780,Staff,0,12,30,30
1650332336534,MATH 105,A01,085443,Staff,0,19,30,30
1650332342565,MATH 109,A01,083213,Anzaldo; Leesa B,0,5,30,30
1650332342565,MATH 109,A02,083214,Anzaldo; Leesa B,0,7,30,30
1650332342565,MATH 109,B01,083215,Anzaldo; Leesa B,0,5,30,30
1650332342565,MATH 109,B02,083216,Anzaldo; Leesa B,0,5,30,30
1650332348593,MATH 142A,A01,083219,Chow; Bennett,0,14,30,30
1650332348593,MATH 142A,A02,083220,Chow; Bennett,0,12,30,30
1650332348593,MATH 142A,B01,083221,Chow; Bennett,0,12,30,30
1650332348593,MATH 142A,B02,083222,Chow; Bennett,0,12,30,30
1650332354625,MATH 193A,A01,083224,Staff,0,5,30,30
1650332354625,MATH 193A,A02,083225,Staff,0,5,30,30
1650332354625,MATH 193A,A03,083781,Staff,0,4,30,30
1650332354625,MATH 193A,A04,083782,Staff,0,3,30,30
1650332360648,MATH 197,001,091859,McAuley; Julian John,9998,0,9999,1
1650332366724,COGS 9,A01,083615,Staff,0,15,60,60
1650332372750,COGS 11,A01,083617,Boyle; Mary E. T.,22,0,40,18
1650332378776,COGS 13,A01,083071,Staff,0,31,40,40
1650332384805,COGS 14A,A01,092681,Staff,0,19,100,100
1650332390844,COGS 14B,A01,083073,Cheng; Tzu-Han,0,10,50,50
1650332396867,COGS 17,A01,092677,Staff,26,0,75,49
1650332402894,COGS 100,A01,083619,Staff,0,23,60,60
1650332408921,COGS 101A,A01,083621,Davis; Joshua Daniel,1,22,60,59
1650332414943,COGS 101B,A01,091572,Staff,2,0,60,58
1650332420967,COGS 101C,A01,083625,Delgado; Tania,18,0,30,12
1650332426993,COGS 107A,A01,083627,Boyle; Mary E. T.,0,8,60,60
1650332433018,COGS 118A,A01,083075,Staff,5,0,60,55
1650332439041,CSE 3,A50,083646,Miranda; Gregory Joseph,21,0,38,17
1650332439041,CSE 3,A51,083647,Miranda; Gregory Joseph,37,0,37,0
1650332445065,CSE 8A,A50,083650,Miranda; Gregory Joseph,0,27,40,40
1650332451094,CSE 11,A01,083080,Cao; Yingjun,0,87,40,40
1650332457116,CSE 12,A01,083652,Staff,0,12,100,100
1650332463143,CSE 15L,A01,083654,Staff,0,1,50,50
1650332463143,CSE 15L,A02,083655,Staff,3,0,50,47
1650332469167,CSE 20,A01,083657,Staff,53,0,80,27
1650332475190,CSE 30,A01,083084,Eldon; John,0,76,40,40
1650332481212,CSE 100,A01,083659,Cao; Yingjun,0,66,50,50
1650332487235,CSE 134B,A01,083661,Powell; Thomas Allan,0,31,65,65
1650332493255,CSE 140,A01,083663,Staff,0,0,75,75
1650332499279,CSE 140L,A01,083088,Eldon; John,0,6,75,75
1650332505306,CSE 175,A01,083665,Kumar; Rakesh,8,0,25,17
1650332511332,CSE 190,A00,092507,Dubnov; Shlomo,14,0,20,6
1650332517359,ECE 45,A01,083139,Staff,0,17,40,40
1650332523387,ECE 65,A50,083695,Staff,0,5,30,30
1650332529410,ECE 109,A01,091882,Touri; Behrouz,40,0,70,30
1650332535436,ECE 180,A00,083140,Abi Samra; Nicholas Camill,23,0,30,7
1650332535436,ECE 180,B00,083141,Abi Samra; Nicholas Camill,5,0,30,25
1650332541463,MATH 10A,A01,083735,Patchell; Gregory David,8,0,30,22
1650332541463,MATH 10A,A02,083736,Patchell; Gregory David,28,0,30,2
1650332541463,MATH 10A,A03,083737,Patchell; Gregory David,26,0,30,4
1650332547487,MATH 10B,A01,083207,Staff,0,7,30,30
1650332547487,MATH 10B,A02,083208,Staff,0,6,30,30
1650332547487,MATH 10B,B01,083739,Staff,17,0,30,13
1650332547487,MATH 10B,B02,083740,Staff,28,0,30,2
1650332553515,MATH 18,A01,083743,Staff,4,0,30,26
1650332553515,MATH 18,A02,083744,Staff,27,0,30,3
1650332553515,MATH 18,A03,083745,Staff,22,0,30,8
1650332553515,MATH 18,A04,083746,Staff,27,0,30,3
1650332553515,MATH 18,B01,083748,Staff,0,11,30,30
1650332553515,MATH 18,B02,083749,Staff,0,11,30,30
1650332553515,MATH 18,B03,083750,Staff,1,11,30,29
1650332553515,MATH 18,B04,083751,Staff,0,10,30,30
1650332559540,MATH 20A,A01,083754,Staff,26,0,40,14
1650332565569,MATH 20B,A01,083756,Staff,0,8,30,30
1650332565569,MATH 20B,A02,083757,Staff,0,8,30,30
1650332571594,MATH 20C,A01,083760,Staff,0,13,30,30
1650332571594,MATH 20C,A02,083761,Staff,0,13,30,30
1650332571594,MATH 20C,B01,083762,Staff,13,0,30,17
1650332571594,MATH 20C,B02,083763,Staff,28,0,30,2
1650332577633,MATH 20D,A01,083765,Staff,0,1,30,30
1650332577633,MATH 20D,A02,083766,Staff,7,0,30,23
1650332577633,MATH 20D,A03,083767,Staff,26,0,30,4
1650332583658,MATH 20E,A01,083771,Staff,5,0,30,25
1650332583658,MATH 20E,A02,083772,Staff,19,0,30,11
1650332583658,MATH 20E,B01,083773,Staff,0,0,30,30
1650332583658,MATH 20E,B02,083774,Staff,12,0,30,18
1650332589688,MATH 103A,A01,083777,Staff,0,12,30,30
1650332589688,MATH 103A,A02,083778,Staff,0,12,30,30
1650332589688,MATH 103A,B01,083779,Staff,0,12,30,30
1650332589688,MATH 103A,B02,083780,Staff,0,12,30,30
1650332595715,MATH 105,A01,085443,Staff,0,19,30,30
1650332601738,MATH 109,A01,083213,Anzaldo; Leesa B,0,5,30,30
1650332601738,MATH 109,A02,083214,Anzaldo; Leesa B,0,7,30,30
1650332601738,MATH 109,B01,083215,Anzaldo; Leesa B,0,5,30,30
1650332601738,MATH 109,B02,083216,Anzaldo; Leesa B,0,5,30,30
1650332607761,MATH 142A,A01,083219,Chow; Bennett,0,14,30,30
1650332607761,MATH 142A,A02,083220,Chow; Bennett,0,12,30,30
1650332607761,MATH 142A,B01,083221,Chow; Bennett,0,12,30,30
1650332607761,MATH 142A,B02,083222,Chow; Bennett,0,12,30,30
1650332613784,MATH 193A,A01,083224,Staff,0,5,30,30
1650332613784,MATH 193A,A02,083225,Staff,0,5,30,30
1650332613784,MATH 193A,A03,083781,Staff,0,4,30,30
1650332613784,MATH 193A,A04,083782,Staff,0,3,30,30
1650332619807,MATH 197,001,091859,McAuley; Julian John,9998,0,9999,1
1650332625864,COGS 9,A01,083615,Staff,0,15,60,60
1650332631891,COGS 11,A01,083617,Boyle; Mary E. T.,22,0,40,18
1650332637915,COGS 13,A01,083071,Staff,0,31,40,40
1650332643944,COGS 14A,A01,092681,Staff,0,19,100,100
1650332649968,COGS 14B,A01,083073,Cheng; Tzu-Han,0,10,50,50
1650332655991,COGS 17,A01,092677,Staff,26,0,75,49
1650332662015,COGS 100,A01,083619,Staff,0,23,60,60
1650332668042,COGS 101A,A01,083621,Davis; Joshua Daniel,1,22,60,59
1650332674086,COGS 101B,A01,091572,Staff,2,0,60,58
1650332680113,COGS 101C,A01,083625,Delgado; Tania,18,0,30,12
1650332686138,COGS 107A,A01,083627,Boyle; Mary E. T.,0,8,60,60
1650332692162,COGS 118A,A01,083075,Staff,5,0,60,55
1650332698191,CSE 3,A50,083646,Miranda; Gregory Joseph,21,0,38,17
1650332698191,CSE 3,A51,083647,Miranda; Gregory Joseph,37,0,37,0
1650332704214,CSE 8A,A50,083650,Miranda; Gregory Joseph,0,27,40,40
1650332710239,CSE 11,A01,083080,Cao; Yingjun,0,87,40,40
1650332716261,CSE 12,A01,083652,Staff,0,12,100,100
1650332722288,CSE 15L,A01,083654,Staff,0,1,50,50
1650332722288,CSE 15L,A02,083655,Staff,3,0,50,47
1650332728314,CSE 20,A01,083657,Staff,53,0,80,27
1650332734340,CSE 30,A01,083084,Eldon; John,0,76,40,40
1650332740363,CSE 100,A01,083659,Cao; Yingjun,0,66,50,50
1650332746397,CSE 134B,A01,083661,Powell; Thomas Allan,0,31,65,65
1650332752426,CSE 140,A01,083663,Staff,0,0,75,75
1650332758454,CSE 140L,A01,083088,Eldon; John,0,6,75,75
1650332764477,CSE 175,A01,083665,Kumar; Rakesh,8,0,25,17
1650332770516,CSE 190,A00,092507,Dubnov; Shlomo,14,0,20,6
1650332776543,ECE 45,A01,083139,Staff,0,17,40,40
1650332782570,ECE 65,A50,083695,Staff,0,5,30,30
1650332788682,ECE 109,A01,091882,Touri; Behrouz,40,0,70,30
1650332794736,ECE 180,A00,083140,Abi Samra; Nicholas Camill,23,0,30,7
1650332794736,ECE 180,B00,083141,Abi Samra; Nicholas Camill,5,0,30,25
1650332800764,MATH 10A,A01,083735,Patchell; Gregory David,8,0,30,22
1650332800764,MATH 10A,A02,083736,Patchell; Gregory David,28,0,30,2
1650332800764,MATH 10A,A03,083737,Patchell; Gregory David,26,0,30,4
1650332806788,MATH 10B,A01,083207,Staff,0,7,30,30
1650332806788,MATH 10B,A02,083208,Staff,0,6,30,30
1650332806788,MATH 10B,B01,083739,Staff,17,0,30,13
1650332806788,MATH 10B,B02,083740,Staff,28,0,30,2
1650332812819,MATH 18,A01,083743,Staff,4,0,30,26
1650332812819,MATH 18,A02,083744,Staff,27,0,30,3
1650332812819,MATH 18,A03,083745,Staff,22,0,30,8
1650332812819,MATH 18,A04,083746,Staff,27,0,30,3
1650332812819,MATH 18,B01,083748,Staff,0,11,30,30
1650332812819,MATH 18,B02,083749,Staff,0,11,30,30
1650332812819,MATH 18,B03,083750,Staff,1,11,30,29
1650332812819,MATH 18,B04,083751,Staff,0,11,30,30
1650332818844,MATH 20A,A01,083754,Staff,26,0,40,14
1650332824870,MATH 20B,A01,083756,Staff,0,8,30,30
1650332824870,MATH 20B,A02,083757,Staff,0,8,30,30
1650332830895,MATH 20C,A01,083760,Staff,0,13,30,30
1650332830895,MATH 20C,A02,083761,Staff,0,13,30,30
1650332830895,MATH 20C,B01,083762,Staff,13,0,30,17
1650332830895,MATH 20C,B02,083763,Staff,28,0,30,2
1650332836919,MATH 20D,A01,083765,Staff,0,1,30,30
1650332836919,MATH 20D,A02,083766,Staff,7,0,30,23
1650332836919,MATH 20D,A03,083767,Staff,26,0,30,4
1650332842943,MATH 20E,A01,083771,Staff,5,0,30,25
1650332842943,MATH 20E,A02,083772,Staff,19,0,30,11
1650332842943,MATH 20E,B01,083773,Staff,0,0,30,30
1650332842943,MATH 20E,B02,083774,Staff,12,0,30,18
1650332848966,MATH 103A,A01,083777,Staff,0,12,30,30
1650332848966,MATH 103A,A02,083778,Staff,0,12,30,30
1650332848966,MATH 103A,B01,083779,Staff,0,12,30,30
1650332848966,MATH 103A,B02,083780,Staff,0,12,30,30
1650332854990,MATH 105,A01,085443,Staff,0,19,30,30
1650332861014,MATH 109,A01,083213,Anzaldo; Leesa B,0,5,30,30
1650332861014,MATH 109,A02,083214,Anzaldo; Leesa B,0,7,30,30
1650332861014,MATH 109,B01,083215,Anzaldo; Leesa B,0,5,30,30
1650332861014,MATH 109,B02,083216,Anzaldo; Leesa B,0,5,30,30
1650332867047,MATH 142A,A01,083219,Chow; Bennett,0,14,30,30
1650332867047,MATH 142A,A02,083220,Chow; Bennett,0,12,30,30
1650332867047,MATH 142A,B01,083221,Chow; Bennett,0,12,30,30
1650332867047,MATH 142A,B02,083222,Chow; Bennett,0,12,30,30
1650332873075,MATH 193A,A01,083224,Staff,0,5,30,30
1650332873075,MATH 193A,A02,083225,Staff,0,5,30,30
1650332873075,MATH 193A,A03,083781,Staff,0,4,30,30
1650332873075,MATH 193A,A04,083782,Staff,0,3,30,30
1650332879101,MATH 197,001,091859,McAuley; Julian John,9998,0,9999,1
1650332885168,COGS 9,A01,083615,Staff,0,15,60,60
1650332891197,COGS 11,A01,083617,Boyle; Mary E. T.,22,0,40,18
1650332897221,COGS 13,A01,083071,Staff,0,31,40,40
1650332903245,COGS 14A,A01,092681,Staff,0,19,100,100
1650332909272,COGS 14B,A01,083073,Cheng; Tzu-Han,0,10,50,50
1650332915296,COGS 17,A01,092677,Staff,26,0,75,49
1650332921326,COGS 100,A01,083619,Staff,0,23,60,60
1650332927353,COGS 101A,A01,083621,Davis; Joshua Daniel,1,22,60,59
1650332933375,COGS 101B,A01,091572,Staff,2,0,60,58
1650332939408,COGS 101C,A01,083625,Delgado; Tania,18,0,30,12
1650332945431,COGS 107A,A01,083627,Boyle; Mary E. T.,0,8,60,60
1650332951466,COGS 118A,A01,083075,Staff,5,0,60,55
1650332957490,CSE 3,A50,083646,Miranda; Gregory Joseph,21,0,38,17
1650332957490,CSE 3,A51,083647,Miranda; Gregory Joseph,37,0,37,0
1650332963516,CSE 8A,A50,083650,Miranda; Gregory Joseph,0,27,40,40
1650332969539,CSE 11,A01,083080,Cao; Yingjun,0,87,40,40
1650332975564,CSE 12,A01,083652,Staff,0,12,100,100
1650332981603,CSE 15L,A01,083654,Staff,0,1,50,50
1650332981603,CSE 15L,A02,083655,Staff,3,0,50,47
1650332987629,CSE 20,A01,083657,Staff,53,0,80,27
1650332993656,CSE 30,A01,083084,Eldon; John,0,76,40,40
1650332999681,CSE 100,A01,083659,Cao; Yingjun,0,66,50,50
1650333005705,CSE 134B,A01,083661,Powell; Thomas Allan,0,31,65,65
1650333011730,CSE 140,A01,083663,Staff,0,0,75,75
1650333017757,CSE 140L,A01,083088,Eldon; John,0,6,75,75
1650333023791,CSE 175,A01,083665,Kumar; Rakesh,8,0,25,17
1650333029815,CSE 190,A00,092507,Dubnov; Shlomo,14,0,20,6
1650333035838,ECE 45,A01,083139,Staff,0,17,40,40
1650333041862,ECE 65,A50,083695,Staff,0,5,30,30
1650333047884,ECE 109,A01,091882,Touri; Behrouz,40,0,70,30
1650333053909,ECE 180,A00,083140,Abi Samra; Nicholas Camill,23,0,30,7
1650333053909,ECE 180,B00,083141,Abi Samra; Nicholas Camill,5,0,30,25
1650333059944,MATH 10A,A01,083735,Patchell; Gregory David,8,0,30,22
1650333059944,MATH 10A,A02,083736,Patchell; Gregory David,28,0,30,2
1650333059944,MATH 10A,A03,083737,Patchell; Gregory David,26,0,30,4
1650333065969,MATH 10B,A01,083207,Staff,0,7,30,30
1650333065969,MATH 10B,A02,083208,Staff,0,6,30,30
1650333065969,MATH 10B,B01,083739,Staff,17,0,30,13
1650333065969,MATH 10B,B02,083740,Staff,28,0,30,2
1650333071995,MATH 18,A01,083743,Staff,4,0,30,26
1650333071995,MATH 18,A02,083744,Staff,27,0,30,3
1650333071995,MATH 18,A03,083745,Staff,22,0,30,8
1650333071995,MATH 18,A04,083746,Staff,27,0,30,3
1650333071995,MATH 18,B01,083748,Staff,0,11,30,30
1650333071995,MATH 18,B02,083749,Staff,0,11,30,30
1650333071995,MATH 18,B03,083750,Staff,1,11,30,29
1650333071995,MATH 18,B04,083751,Staff,0,11,30,30
1650333078019,MATH 20A,A01,083754,Staff,26,0,40,14
1650333084041,MATH 20B,A01,083756,Staff,0,8,30,30
1650333084041,MATH 20B,A02,083757,Staff,0,8,30,30
1650333090063,MATH 20C,A01,083760,Staff,0,13,30,30
1650333090063,MATH 20C,A02,083761,Staff,0,13,30,30
1650333090063,MATH 20C,B01,083762,Staff,13,0,30,17
1650333090063,MATH 20C,B02,083763,Staff,28,0,30,2
1650333096090,MATH 20D,A01,083765,Staff,0,1,30,30
1650333096090,MATH 20D,A02,083766,Staff,7,0,30,23
1650333096090,MATH 20D,A03,083767,Staff,26,0,30,4
1650333102115,MATH 20E,A01,083771,Staff,5,0,30,25
1650333102115,MATH 20E,A02,083772,Staff,19,0,30,11
1650333102115,MATH 20E,B01,083773,Staff,0,0,30,30
1650333102115,MATH 20E,B02,083774,Staff,12,0,30,18
1650333108141,MATH 103A,A01,083777,Staff,0,12,30,30
1650333108141,MATH 103A,A02,083778,Staff,0,12,30,30
1650333108141,MATH 103A,B01,083779,Staff,0,12,30,30
1650333108141,MATH 103A,B02,083780,Staff,0,12,30,30
1650333114165,MATH 105,A01,085443,Staff,0,19,30,30
1650333120195,MATH 109,A01,083213,Anzaldo; Leesa B,0,5,30,30
1650333120195,MATH 109,A02,083214,Anzaldo; Leesa B,0,7,30,30
1650333120195,MATH 109,B01,083215,Anzaldo; Leesa B,0,5,30,30
1650333120195,MATH 109,B02,083216,Anzaldo; Leesa B,0,5,30,30
1650333126219,MATH 142A,A01,083219,Chow; Bennett,0,14,30,30
1650333126219,MATH 142A,A02,083220,Chow; Bennett,0,12,30,30
1650333126219,MATH 142A,B01,083221,Chow; Bennett,0,12,30,30
1650333126219,MATH 142A,B02,083222,Chow; Bennett,0,12,30,30
1650333132246,MATH 193A,A01,083224,Staff,0,5,30,30
1650333132246,MATH 193A,A02,083225,Staff,0,5,30,30
1650333132246,MATH 193A,A03,083781,Staff,0,4,30,30
1650333132246,MATH 193A,A04,083782,Staff,0,3,30,30
1650333138268,MATH 197,001,091859,McAuley; Julian John,9998,0,9999,1
1650333144329,COGS 9,A01,083615,Staff,0,15,60,60
1650333150356,COGS 11,A01,083617,Boyle; Mary E. T.,22,0,40,18
1650333156377,COGS 13,A01,083071,Staff,0,31,40,40
1650333162403,COGS 14A,A01,092681,Staff,0,19,100,100
1650333168426,COGS 14B,A01,083073,Cheng; Tzu-Han,0,10,50,50
1650333174453,COGS 17,A01,092677,Staff,26,0,75,49
1650333180485,COGS 100,A01,083619,Staff,0,23,60,60
1650333186509,COGS 101A,A01,083621,Davis; Joshua Daniel,1,22,60,59
1650333192541,COGS 101B,A01,091572,Staff,2,0,60,58
1650333198564,COGS 101C,A01,083625,Delgado; Tania,18,0,30,12
1650333204592,COGS 107A,A01,083627,Boyle; Mary E. T.,0,8,60,60
1650333210613,COGS 118A,A01,083075,Staff,5,0,60,55
1650333216636,CSE 3,A50,083646,Miranda; Gregory Joseph,21,0,38,17
1650333216636,CSE 3,A51,083647,Miranda; Gregory Joseph,37,0,37,0
1650333222662,CSE 8A,A50,083650,Miranda; Gregory Joseph,0,27,40,40
1650333228686,CSE 11,A01,083080,Cao; Yingjun,0,87,40,40
1650333234708,CSE 12,A01,083652,Staff,0,12,100,100
1650333240735,CSE 15L,A01,083654,Staff,0,1,50,50
1650333240735,CSE 15L,A02,083655,Staff,3,0,50,47
1650333246772,CSE 20,A01,083657,Staff,53,0,80,27
1650333252809,CSE 30,A01,083084,Eldon; John,0,76,40,40
1650333258836,CSE 100,A01,083659,Cao; Yingjun,0,66,50,50
1650333264867,CSE 134B,A01,083661,Powell; Thomas Allan,0,31,65,65
1650333270897,CSE 140,A01,083663,Staff,0,0,75,75
1650333276922,CSE 140L,A01,083088,Eldon; John,0,6,75,75
1650333282946,CSE 175,A01,083665,Kumar; Rakesh,8,0,25,17
1650333288973,CSE 190,A00,092507,Dubnov; Shlomo,14,0,20,6
1650333294997,ECE 45,A01,083139,Staff,0,17,40,40
1650333301034,ECE 65,A50,083695,Staff,0,5,30,30
1650333307059,ECE 109,A01,091882,Touri; Behrouz,40,0,70,30
1650333313082,ECE 180,A00,083140,Abi Samra; Nicholas Camill,23,0,30,7
1650333313082,ECE 180,B00,083141,Abi Samra; Nicholas Camill,5,0,30,25
1650333319105,MATH 10A,A01,083735,Patchell; Gregory David,8,0,30,22
1650333319105,MATH 10A,A02,083736,Patchell; Gregory David,28,0,30,2
1650333319105,MATH 10A,A03,083737,Patchell; Gregory David,26,0,30,4
1650333325130,MATH 10B,A01,083207,Staff,0,7,30,30
1650333325130,MATH 10B,A02,083208,Staff,0,6,30,30
1650333325130,MATH 10B,B01,083739,Staff,17,0,30,13
1650333325130,MATH 10B,B02,083740,Staff,28,0,30,2
1650333331156,MATH 18,A01,083743,Staff,4,0,30,26
1650333331156,MATH 18,A02,083744,Staff,27,0,30,3
1650333331156,MATH 18,A03,083745,Staff,22,0,30,8
1650333331156,MATH 18,A04,083746,Staff,27,0,30,3
1650333331156,MATH 18,B01,083748,Staff,0,11,30,30
1650333331156,MATH 18,B02,083749,Staff,0,11,30,30
1650333331156,MATH 18,B03,083750,Staff,1,11,30,29
1650333331156,MATH 18,B04,083751,Staff,0,11,30,30
1650333337193,MATH 20A,A01,083754,Staff,26,0,40,14
1650333343216,MATH 20B,A01,083756,Staff,0,8,30,30
1650333343216,MATH 20B,A02,083757,Staff,0,8,30,30
1650333349242,MATH 20C,A01,083760,Staff,0,13,30,30
1650333349242,MATH 20C,A02,083761,Staff,0,13,30,30
1650333349242,MATH 20C,B01,083762,Staff,13,0,30,17
1650333349242,MATH 20C,B02,083763,Staff,28,0,30,2
1650333355267,MATH 20D,A01,083765,Staff,0,1,30,30
1650333355267,MATH 20D,A02,083766,Staff,7,0,30,23
1650333355267,MATH 20D,A03,083767,Staff,26,0,30,4
1650333361290,MATH 20E,A01,083771,Staff,5,0,30,25
1650333361290,MATH 20E,A02,083772,Staff,19,0,30,11
1650333361290,MATH 20E,B01,083773,Staff,0,0,30,30
1650333361290,MATH 20E,B02,083774,Staff,12,0,30,18
1650333367316,MATH 103A,A01,083777,Staff,0,12,30,30
1650333367316,MATH 103A,A02,083778,Staff,0,12,30,30
1650333367316,MATH 103A,B01,083779,Staff,0,12,30,30
1650333367316,MATH 103A,B02,083780,Staff,0,12,30,30
1650333373347,MATH 105,A01,085443,Staff,0,19,30,30
1650333379370,MATH 109,A01,083213,Anzaldo; Leesa B,0,5,30,30
1650333379370,MATH 109,A02,083214,Anzaldo; Leesa B,0,7,30,30
1650333379370,MATH 109,B01,083215,Anzaldo; Leesa B,0,5,30,30
1650333379370,MATH 109,B02,083216,Anzaldo; Leesa B,0,5,30,30
1650333385482,MATH 142A,A01,083219,Chow; Bennett,0,14,30,30
1650333385482,MATH 142A,A02,083220,Chow; Bennett,0,12,30,30
1650333385482,MATH 142A,B01,083221,Chow; Bennett,0,12,30,30
1650333385482,MATH 142A,B02,083222,Chow; Bennett,0,12,30,30
1650333391508,MATH 193A,A01,083224,Staff,0,5,30,30
1650333391508,MATH 193A,A02,083225,Staff,0,5,30,30
1650333391508,MATH 193A,A03,083781,Staff,0,4,30,30
1650333391508,MATH 193A,A04,083782,Staff,0,3,30,30
1650333397534,MATH 197,001,091859,McAuley; Julian John,9998,0,9999,1
1650333403583,COGS 9,A01,083615,Staff,0,15,60,60
1650333409605,COGS 11,A01,083617,Boyle; Mary E. T.,22,0,40,18
1650333415631,COGS 13,A01,083071,Staff,0,31,40,40
1650333421658,COGS 14A,A01,092681,Staff,0,19,100,100
1650333427685,COGS 14B,A01,083073,Cheng; Tzu-Han,0,10,50,50
1650333433711,COGS 17,A01,092677,Staff,26,0,75,49
1650333439737,COGS 100,A01,083619,Staff,0,23,60,60
1650333445767,COGS 101A,A01,083621,Davis; Joshua Daniel,1,22,60,59
1650333451792,COGS 101B,A01,091572,Staff,2,0,60,58
1650333457828,COGS 101C,A01,083625,Delgado; Tania,18,0,30,12
1650333463852,COGS 107A,A01,083627,Boyle; Mary E. T.,0,8,60,60
1650333469875,COGS 118A,A01,083075,Staff,5,0,60,55
1650333475902,CSE 3,A50,083646,Miranda; Gregory Joseph,21,0,38,17
1650333475902,CSE 3,A51,083647,Miranda; Gregory Joseph,37,0,37,0
1650333481928,CSE 8A,A50,083650,Miranda; Gregory Joseph,0,27,40,40
1650333487950,CSE 11,A01,083080,Cao; Yingjun,0,87,40,40
1650333493976,CSE 12,A01,083652,Staff,0,12,100,100
1650333499999,CSE 15L,A01,083654,Staff,0,1,50,50
1650333499999,CSE 15L,A02,083655,Staff,3,0,50,47
1650333506025,CSE 20,A01,083657,Staff,53,0,80,27
1650333512057,CSE 30,A01,083084,Eldon; John,0,76,40,40
1650333518080,CSE 100,A01,083659,Cao; Yingjun,0,66,50,50
1650333524112,CSE 134B,A01,083661,Powell; Thomas Allan,0,31,65,65
1650333530147,CSE 140,A01,083663,Staff,0,0,75,75
1650333536174,CSE 140L,A01,083088,Eldon; John,0,6,75,75
1650333542201,CSE 175,A01,083665,Kumar; Rakesh,8,0,25,17
1650333548227,CSE 190,A00,092507,Dubnov; Shlomo,14,0,20,6
1650333554252,ECE 45,A01,083139,Staff,0,17,40,40
1650333560275,ECE 65,A50,083695,Staff,0,5,30,30
1650333566298,ECE 109,A01,091882,Touri; Behrouz,40,0,70,30
1650333572320,ECE 180,A00,083140,Abi Samra; Nicholas Camill,23,0,30,7
1650333572320,ECE 180,B00,083141,Abi Samra; Nicholas Camill,5,0,30,25
1650333578352,MATH 10A,A01,083735,Patchell; Gregory David,8,0,30,22
1650333578352,MATH 10A,A02,083736,Patchell; Gregory David,28,0,30,2
1650333578352,MATH 10A,A03,083737,Patchell; Gregory David,26,0,30,4
1650333584377,MATH 10B,A01,083207,Staff,0,7,30,30
1650333584377,MATH 10B,A02,083208,Staff,0,6,30,30
1650333584377,MATH 10B,B01,083739,Staff,17,0,30,13
1650333584377,MATH 10B,B02,083740,Staff,28,0,30,2
1650333590404,MATH 18,A01,083743,Staff,4,0,30,26
1650333590404,MATH 18,A02,083744,Staff,27,0,30,3
1650333590404,MATH 18,A03,083745,Staff,22,0,30,8
1650333590404,MATH 18,A04,083746,Staff,27,0,30,3
1650333590404,MATH 18,B01,083748,Staff,0,11,30,30
1650333590404,MATH 18,B02,083749,Staff,0,11,30,30
1650333590404,MATH 18,B03,083750,Staff,1,11,30,29
1650333590404,MATH 18,B04,083751,Staff,0,11,30,30
1650333596427,MATH 20A,A01,083754,Staff,26,0,40,14
1650333602453,MATH 20B,A01,083756,Staff,0,8,30,30
1650333602453,MATH 20B,A02,083757,Staff,0,8,30,30
1650333608475,MATH 20C,A01,083760,Staff,0,13,30,30
1650333608475,MATH 20C,A02,083761,Staff,0,13,30,30
1650333608475,MATH 20C,B01,083762,Staff,13,0,30,17
1650333608475,MATH 20C,B02,083763,Staff,28,0,30,2
1650333614500,MATH 20D,A01,083765,Staff,0,1,30,30
1650333614500,MATH 20D,A02,083766,Staff,7,0,30,23
1650333614500,MATH 20D,A03,083767,Staff,26,0,30,4
1650333620526,MATH 20E,A01,083771,Staff,5,0,30,25
1650333620526,MATH 20E,A02,083772,Staff,19,0,30,11
1650333620526,MATH 20E,B01,083773,Staff,0,0,30,30
1650333620526,MATH 20E,B02,083774,Staff,12,0,30,18
1650333626562,MATH 103A,A01,083777,Staff,0,12,30,30
1650333626562,MATH 103A,A02,083778,Staff,0,12,30,30
1650333626562,MATH 103A,B01,083779,Staff,0,12,30,30
1650333626562,MATH 103A,B02,083780,Staff,0,12,30,30
1650333632583,MATH 105,A01,085443,Staff,0,19,30,30
1650333638618,MATH 109,A01,083213,Anzaldo; Leesa B,0,5,30,30
1650333638618,MATH 109,A02,083214,Anzaldo; Leesa B,0,7,30,30
1650333638618,MATH 109,B01,083215,Anzaldo; Leesa B,0,5,30,30
1650333638618,MATH 109,B02,083216,Anzaldo; Leesa B,0,5,30,30
1650333644651,MATH 142A,A01,083219,Chow; Bennett,0,14,30,30
1650333644651,MATH 142A,A02,083220,Chow; Bennett,0,12,30,30
1650333644651,MATH 142A,B01,083221,Chow; Bennett,0,12,30,30
1650333644651,MATH 142A,B02,083222,Chow; Bennett,0,12,30,30
1650333650685,MATH 193A,A01,083224,Staff,0,5,30,30
1650333650685,MATH 193A,A02,083225,Staff,0,5,30,30
1650333650685,MATH 193A,A03,083781,Staff,0,4,30,30
1650333650685,MATH 193A,A04,083782,Staff,0,3,30,30
1650333656709,MATH 197,001,091859,McAuley; Julian John,9998,0,9999,1
1650333662770,COGS 9,A01,083615,Staff,0,15,60,60
1650333668795,COGS 11,A01,083617,Boyle; Mary E. T.,22,0,40,18
1650333674816,COGS 13,A01,083071,Staff,0,31,40,40
1650333680855,COGS 14A,A01,092681,Staff,0,19,100,100
1650333686884,COGS 14B,A01,083073,Cheng; Tzu-Han,0,10,50,50
1650333692909,COGS 17,A01,092677,Staff,26,0,75,49
1650333698940,COGS 100,A01,083619,Staff,0,23,60,60
1650333704968,COGS 101A,A01,083621,Davis; Joshua Daniel,1,22,60,59
1650333710992,COGS 101B,A01,091572,Staff,2,0,60,58
1650333717014,COGS 101C,A01,083625,Delgado; Tania,18,0,30,12
1650333723038,COGS 107A,A01,083627,Boyle; Mary E. T.,0,8,60,60
1650333729062,COGS 118A,A01,083075,Staff,5,0,60,55
1650333735090,CSE 3,A50,083646,Miranda; Gregory Joseph,21,0,38,17
1650333735090,CSE 3,A51,083647,Miranda; Gregory Joseph,37,0,37,0
1650333741121,CSE 8A,A50,083650,Miranda; Gregory Joseph,0,27,40,40
1650333747146,CSE 11,A01,083080,Cao; Yingjun,0,87,40,40
1650333753175,CSE 12,A01,083652,Staff,0,12,100,100
1650333759206,CSE 15L,A01,083654,Staff,0,1,50,50
1650333759206,CSE 15L,A02,083655,Staff,3,0,50,47
1650333765229,CSE 20,A01,083657,Staff,53,0,80,27
1650333771251,CSE 30,A01,083084,Eldon; John,0,76,40,40
1650333777277,CSE 100,A01,083659,Cao; Yingjun,0,66,50,50
1650333783299,CSE 134B,A01,083661,Powell; Thomas Allan,0,31,65,65
1650333789323,CSE 140,A01,083663,Staff,0,0,75,75
1650333795346,CSE 140L,A01,083088,Eldon; John,0,6,75,75
1650333801373,CSE 175,A01,083665,Kumar; Rakesh,8,0,25,17
1650333807398,CSE 190,A00,092507,Dubnov; Shlomo,14,0,20,6
1650333813422,ECE 45,A01,083139,Staff,0,17,40,40
1650333819455,ECE 65,A50,083695,Staff,0,5,30,30
1650333825481,ECE 109,A01,091882,Touri; Behrouz,40,0,70,30
1650333831508,ECE 180,A00,083140,Abi Samra; Nicholas Camill,23,0,30,7
1650333831508,ECE 180,B00,083141,Abi Samra; Nicholas Camill,5,0,30,25
1650333837532,MATH 10A,A01,083735,Patchell; Gregory David,8,0,30,22
1650333837532,MATH 10A,A02,083736,Patchell; Gregory David,28,0,30,2
1650333837532,MATH 10A,A03,083737,Patchell; Gregory David,26,0,30,4
1650333843556,MATH 10B,A01,083207,Staff,0,7,30,30
1650333843556,MATH 10B,A02,083208,Staff,0,6,30,30
1650333843556,MATH 10B,B01,083739,Staff,17,0,30,13
1650333843556,MATH 10B,B02,083740,Staff,28,0,30,2
1650333849585,MATH 18,A01,083743,Staff,4,0,30,26
1650333849585,MATH 18,A02,083744,Staff,27,0,30,3
1650333849585,MATH 18,A03,083745,Staff,22,0,30,8
1650333849585,MATH 18,A04,083746,Staff,27,0,30,3
1650333849585,MATH 18,B01,083748,Staff,0,11,30,30
1650333849585,MATH 18,B02,083749,Staff,0,11,30,30
1650333849585,MATH 18,B03,083750,Staff,1,11,30,29
1650333849585,MATH 18,B04,083751,Staff,0,11,30,30
1650333855610,MATH 20A,A01,083754,Staff,26,0,40,14
1650333861637,MATH 20B,A01,083756,Staff,0,8,30,30
1650333861637,MATH 20B,A02,083757,Staff,0,8,30,30
1650333867664,MATH 20C,A01,083760,Staff,0,13,30,30
1650333867664,MATH 20C,A02,083761,Staff,0,13,30,30
1650333867664,MATH 20C,B01,083762,Staff,13,0,30,17
1650333867664,MATH 20C,B02,083763,Staff,28,0,30,2
1650333873687,MATH 20D,A01,083765,Staff,0,1,30,30
1650333873687,MATH 20D,A02,083766,Staff,7,0,30,23
1650333873687,MATH 20D,A03,083767,Staff,26,0,30,4
1650333879712,MATH 20E,A01,083771,Staff,5,0,30,25
1650333879712,MATH 20E,A02,083772,Staff,19,0,30,11
1650333879712,MATH 20E,B01,083773,Staff,0,0,30,30
1650333879712,MATH 20E,B02,083774,Staff,12,0,30,18
1650333885736,MATH 103A,A01,083777,Staff,0,12,30,30
1650333885736,MATH 103A,A02,083778,Staff,0,12,30,30
1650333885736,MATH 103A,B01,083779,Staff,0,12,30,30
1650333885736,MATH 103A,B02,083780,Staff,0,12,30,30
1650333891760,MATH 105,A01,085443,Staff,0,19,30,30
1650333897787,MATH 109,A01,083213,Anzaldo; Leesa B,0,5,30,30
1650333897787,MATH 109,A02,083214,Anzaldo; Leesa B,0,7,30,30
1650333897787,MATH 109,B01,083215,Anzaldo; Leesa B,0,5,30,30
1650333897787,MATH 109,B02,083216,Anzaldo; Leesa B,0,5,30,30
1650333903828,MATH 142A,A01,083219,Chow; Bennett,0,14,30,30
1650333903828,MATH 142A,A02,083220,Chow; Bennett,0,12,30,30
1650333903828,MATH 142A,B01,083221,Chow; Bennett,0,12,30,30
1650333903828,MATH 142A,B02,083222,Chow; Bennett,0,12,30,30
1650333909853,MATH 193A,A01,083224,Staff,0,5,30,30
1650333909853,MATH 193A,A02,083225,Staff,0,5,30,30
1650333909853,MATH 193A,A03,083781,Staff,0,4,30,30
1650333909853,MATH 193A,A04,083782,Staff,0,3,30,30
1650333915875,MATH 197,001,091859,McAuley; Julian John,9998,0,9999,1
1650333921927,COGS 9,A01,083615,Staff,0,15,60,60
1650333927954,COGS 11,A01,083617,Boyle; Mary E. T.,22,0,40,18
1650333933980,COGS 13,A01,083071,Staff,0,31,40,40
1650333940008,COGS 14A,A01,092681,Staff,0,19,100,100
1650333946032,COGS 14B,A01,083073,Cheng; Tzu-Han,0,10,50,50
1650333952054,COGS 17,A01,092677,Staff,26,0,75,49
1650333958082,COGS 100,A01,083619,Staff,0,23,60,60
1650333964106,COGS 101A,A01,083621,Davis; Joshua Daniel,1,22,60,59
1650333970133,COGS 101B,A01,091572,Staff,2,0,60,58
1650333976231,COGS 101C,A01,083625,Delgado; Tania,18,0,30,12
1650333982260,COGS 107A,A01,083627,Boyle; Mary E. T.,0,8,60,60
1650333988290,COGS 118A,A01,083075,Staff,5,0,60,55
1650333994318,CSE 3,A50,083646,Miranda; Gregory Joseph,21,0,38,17
1650333994318,CSE 3,A51,083647,Miranda; Gregory Joseph,37,0,37,0
1650334000344,CSE 8A,A50,083650,Miranda; Gregory Joseph,0,27,40,40
1650334006377,CSE 11,A01,083080,Cao; Yingjun,0,87,40,40
1650334012408,CSE 12,A01,083652,Staff,0,12,100,100
1650334018432,CSE 15L,A01,083654,Staff,0,1,50,50
1650334018432,CSE 15L,A02,083655,Staff,3,0,50,47
1650334024456,CSE 20,A01,083657,Staff,53,0,80,27
1650334030482,CSE 30,A01,083084,Eldon; John,0,76,40,40
1650334036510,CSE 100,A01,083659,Cao; Yingjun,0,66,50,50
1650334042532,CSE 134B,A01,083661,Powell; Thomas Allan,0,31,65,65
1650334048554,CSE 140,A01,083663,Staff,0,0,75,75
1650334054579,CSE 140L,A01,083088,Eldon; John,0,6,75,75
1650334060604,CSE 175,A01,083665,Kumar; Rakesh,8,0,25,17
1650334066634,CSE 190,A00,092507,Dubnov; Shlomo,14,0,20,6
1650334072658,ECE 45,A01,083139,Staff,0,17,40,40
1650334078688,ECE 65,A50,083695,Staff,0,5,30,30
1650334084714,ECE 109,A01,091882,Touri; Behrouz,40,0,70,30
1650334090740,ECE 180,A00,083140,Abi Samra; Nicholas Camill,23,0,30,7
1650334090740,ECE 180,B00,083141,Abi Samra; Nicholas Camill,5,0,30,25
1650334096771,MATH 10A,A01,083735,Patchell; Gregory David,8,0,30,22
1650334096771,MATH 10A,A02,083736,Patchell; Gregory David,28,0,30,2
1650334096771,MATH 10A,A03,083737,Patchell; Gregory David,26,0,30,4
1650334102801,MATH 10B,A01,083207,Staff,0,7,30,30
1650334102801,MATH 10B,A02,083208,Staff,0,6,30,30
1650334102801,MATH 10B,B01,083739,Staff,17,0,30,13
1650334102801,MATH 10B,B02,083740,Staff,28,0,30,2
1650334108826,MATH 18,A01,083743,Staff,4,0,30,26
1650334108826,MATH 18,A02,083744,Staff,27,0,30,3
1650334108826,MATH 18,A03,083745,Staff,22,0,30,8
1650334108826,MATH 18,A04,083746,Staff,27,0,30,3
1650334108826,MATH 18,B01,083748,Staff,0,11,30,30
1650334108826,MATH 18,B02,083749,Staff,0,11,30,30
1650334108826,MATH 18,B03,083750,Staff,1,11,30,29
1650334108826,MATH 18,B04,083751,Staff,0,11,30,30
1650334114849,MATH 20A,A01,083754,Staff,26,0,40,14
1650334120876,MATH 20B,A01,083756,Staff,0,8,30,30
1650334120876,MATH 20B,A02,083757,Staff,0,8,30,30
1650334126913,MATH 20C,A01,083760,Staff,0,13,30,30
1650334126913,MATH 20C,A02,083761,Staff,0,13,30,30
1650334126913,MATH 20C,B01,083762,Staff,13,0,30,17
1650334126913,MATH 20C,B02,083763,Staff,28,0,30,2
1650334132939,MATH 20D,A01,083765,Staff,0,1,30,30
1650334132939,MATH 20D,A02,083766,Staff,7,0,30,23
1650334132939,MATH 20D,A03,083767,Staff,26,0,30,4
1650334138963,MATH 20E,A01,083771,Staff,5,0,30,25
1650334138963,MATH 20E,A02,083772,Staff,19,0,30,11
1650334138963,MATH 20E,B01,083773,Staff,0,0,30,30
1650334138963,MATH 20E,B02,083774,Staff,12,0,30,18
1650334144987,MATH 103A,A01,083777,Staff,0,12,30,30
1650334144987,MATH 103A,A02,083778,Staff,0,12,30,30
1650334144987,MATH 103A,B01,083779,Staff,0,12,30,30
1650334144987,MATH 103A,B02,083780,Staff,0,12,30,30
1650334151015,MATH 105,A01,085443,Staff,0,19,30,30
1650334157038,MATH 109,A01,083213,Anzaldo; Leesa B,0,5,30,30
1650334157038,MATH 109,A02,083214,Anzaldo; Leesa B,0,7,30,30
1650334157038,MATH 109,B01,083215,Anzaldo; Leesa B,0,5,30,30
1650334157038,MATH 109,B02,083216,Anzaldo; Leesa B,0,5,30,30
1650334163063,MATH 142A,A01,083219,Chow; Bennett,0,14,30,30
1650334163063,MATH 142A,A02,083220,Chow; Bennett,0,12,30,30
1650334163063,MATH 142A,B01,083221,Chow; Bennett,0,12,30,30
1650334163063,MATH 142A,B02,083222,Chow; Bennett,0,12,30,30
1650334169086,MATH 193A,A01,083224,Staff,0,5,30,30
1650334169086,MATH 193A,A02,083225,Staff,0,5,30,30
1650334169086,MATH 193A,A03,083781,Staff,0,4,30,30
1650334169086,MATH 193A,A04,083782,Staff,0,3,30,30
1650334175111,MATH 197,001,091859,McAuley; Julian John,9998,0,9999,1
1650334181161,COGS 9,A01,083615,Staff,0,15,60,60
1650334187195,COGS 11,A01,083617,Boyle; Mary E. T.,22,0,40,18
1650334193218,COGS 13,A01,083071,Staff,0,31,40,40
1650334199243,COGS 14A,A01,092681,Staff,0,19,100,100
1650334205267,COGS 14B,A01,083073,Cheng; Tzu-Han,0,10,50,50
1650334211293,COGS 17,A01,092677,Staff,26,0,75,49
1650334217318,COGS 100,A01,083619,Staff,0,23,60,60
1650334223342,COGS 101A,A01,083621,Davis; Joshua Daniel,1,22,60,59
1650334229364,COGS 101B,A01,091572,Staff,2,0,60,58
1650334235389,COGS 101C,A01,083625,Delgado; Tania,18,0,30,12
1650334241415,COGS 107A,A01,083627,Boyle; Mary E. T.,0,8,60,60
1650334247444,COGS 118A,A01,083075,Staff,5,0,60,55
1650334253473,CSE 3,A50,083646,Miranda; Gregory Joseph,21,0,38,17
1650334253473,CSE 3,A51,083647,Miranda; Gregory Joseph,37,0,37,0
1650334259495,CSE 8A,A50,083650,Miranda; Gregory Joseph,0,27,40,40
1650334265519,CSE 11,A01,083080,Cao; Yingjun,0,87,40,40
1650334271542,CSE 12,A01,083652,Staff,0,12,100,100
1650334277564,CSE 15L,A01,083654,Staff,0,1,50,50
1650334277564,CSE 15L,A02,083655,Staff,3,0,50,47
1650334283594,CSE 20,A01,083657,Staff,53,0,80,27
1650334289620,CSE 30,A01,083084,Eldon; John,0,76,40,40
1650334295647,CSE 100,A01,083659,Cao; Yingjun,0,66,50,50
1650334301671,CSE 134B,A01,083661,Powell; Thomas Allan,0,31,65,65
1650334307694,CSE 140,A01,083663,Staff,0,0,75,75
1650334313721,CSE 140L,A01,083088,Eldon; John,0,6,75,75
1650334319748,CSE 175,A01,083665,Kumar; Rakesh,8,0,25,17
1650334325777,CSE 190,A00,092507,Dubnov; Shlomo,14,0,20,6
1650334331809,ECE 45,A01,083139,Staff,0,17,40,40
1650334337840,ECE 65,A50,083695,Staff,0,5,30,30
1650334343864,ECE 109,A01,091882,Touri; Behrouz,40,0,70,30
1650334349891,ECE 180,A00,083140,Abi Samra; Nicholas Camill,23,0,30,7
1650334349891,ECE 180,B00,083141,Abi Samra; Nicholas Camill,5,0,30,25
1650334355922,MATH 10A,A01,083735,Patchell; Gregory David,8,0,30,22
1650334355922,MATH 10A,A02,083736,Patchell; Gregory David,28,0,30,2
1650334355922,MATH 10A,A03,083737,Patchell; Gregory David,26,0,30,4
1650334361949,MATH 10B,A01,083207,Staff,0,7,30,30
1650334361949,MATH 10B,A02,083208,Staff,0,6,30,30
1650334361949,MATH 10B,B01,083739,Staff,17,0,30,13
1650334361949,MATH 10B,B02,083740,Staff,28,0,30,2
1650334367975,MATH 18,A01,083743,Staff,4,0,30,26
1650334367975,MATH 18,A02,083744,Staff,27,0,30,3
1650334367975,MATH 18,A03,083745,Staff,22,0,30,8
1650334367975,MATH 18,A04,083746,Staff,27,0,30,3
1650334367975,MATH 18,B01,083748,Staff,0,11,30,30
1650334367975,MATH 18,B02,083749,Staff,0,11,30,30
1650334367975,MATH 18,B03,083750,Staff,1,11,30,29
1650334367975,MATH 18,B04,083751,Staff,0,11,30,30
1650334373999,MATH 20A,A01,083754,Staff,26,0,40,14
1650334380022,MATH 20B,A01,083756,Staff,0,8,30,30
1650334380022,MATH 20B,A02,083757,Staff,0,8,30,30
1650334386049,MATH 20C,A01,083760,Staff,0,13,30,30
1650334386049,MATH 20C,A02,083761,Staff,0,13,30,30
1650334386049,MATH 20C,B01,083762,Staff,13,0,30,17
1650334386049,MATH 20C,B02,083763,Staff,28,0,30,2
1650334392075,MATH 20D,A01,083765,Staff,0,1,30,30
1650334392075,MATH 20D,A02,083766,Staff,7,0,30,23
1650334392075,MATH 20D,A03,083767,Staff,26,0,30,4
1650334398107,MATH 20E,A01,083771,Staff,5,0,30,25
1650334398107,MATH 20E,A02,083772,Staff,19,0,30,11
1650334398107,MATH 20E,B01,083773,Staff,0,0,30,30
1650334398107,MATH 20E,B02,083774,Staff,12,0,30,18
1650334404132,MATH 103A,A01,083777,Staff,0,12,30,30
1650334404132,MATH 103A,A02,083778,Staff,0,12,30,30
1650334404132,MATH 103A,B01,083779,Staff,0,12,30,30
1650334404132,MATH 103A,B02,083780,Staff,0,12,30,30
1650334410161,MATH 105,A01,085443,Staff,0,19,30,30
1650334416184,MATH 109,A01,083213,Anzaldo; Leesa B,0,5,30,30
1650334416184,MATH 109,A02,083214,Anzaldo; Leesa B,0,7,30,30
1650334416184,MATH 109,B01,083215,Anzaldo; Leesa B,0,5,30,30
1650334416184,MATH 109,B02,083216,Anzaldo; Leesa B,0,5,30,30
1650334422209,MATH 142A,A01,083219,Chow; Bennett,0,14,30,30
1650334422209,MATH 142A,A02,083220,Chow; Bennett,0,12,30,30
1650334422209,MATH 142A,B01,083221,Chow; Bennett,0,12,30,30
1650334422209,MATH 142A,B02,083222,Chow; Bennett,0,12,30,30
1650334428231,MATH 193A,A01,083224,Staff,0,5,30,30
1650334428231,MATH 193A,A02,083225,Staff,0,5,30,30
1650334428231,MATH 193A,A03,083781,Staff,0,4,30,30
1650334428231,MATH 193A,A04,083782,Staff,0,3,30,30
1650334434256,MATH 197,001,091859,McAuley; Julian John,9998,0,9999,1
1650334440312,COGS 9,A01,083615,Staff,0,15,60,60
1650334446346,COGS 11,A01,083617,Boyle; Mary E. T.,22,0,40,18
1650334452370,COGS 13,A01,083071,Staff,0,31,40,40
1650334458393,COGS 14A,A01,092681,Staff,0,19,100,100
1650334464419,COGS 14B,A01,083073,Cheng; Tzu-Han,0,10,50,50
1650334470445,COGS 17,A01,092677,Staff,26,0,75,49
1650334476470,COGS 100,A01,083619,Staff,0,23,60,60
1650334482504,COGS 101A,A01,083621,Davis; Joshua Daniel,1,22,60,59
1650334488535,COGS 101B,A01,091572,Staff,2,0,60,58
1650334494560,COGS 101C,A01,083625,Delgado; Tania,18,0,30,12
1650334500590,COGS 107A,A01,083627,Boyle; Mary E. T.,0,8,60,60
1650334506615,COGS 118A,A01,083075,Staff,5,0,60,55
1650334512641,CSE 3,A50,083646,Miranda; Gregory Joseph,21,0,38,17
1650334512641,CSE 3,A51,083647,Miranda; Gregory Joseph,37,0,37,0
1650334518668,CSE 8A,A50,083650,Miranda; Gregory Joseph,0,27,40,40
1650334524693,CSE 11,A01,083080,Cao; Yingjun,0,87,40,40
1650334530718,CSE 12,A01,083652,Staff,0,12,100,100
1650334536747,CSE 15L,A01,083654,Staff,0,1,50,50
1650334536747,CSE 15L,A02,083655,Staff,3,0,50,47
1650334542770,CSE 20,A01,083657,Staff,53,0,80,27
1650334548792,CSE 30,A01,083084,Eldon; John,0,76,40,40
1650334554818,CSE 100,A01,083659,Cao; Yingjun,0,66,50,50
1650334560849,CSE 134B,A01,083661,Powell; Thomas Allan,0,31,65,65
1650334566880,CSE 140,A01,083663,Staff,0,0,75,75
1650334572999,CSE 140L,A01,083088,Eldon; John,0,6,75,75
1650334579034,CSE 175,A01,083665,Kumar; Rakesh,8,0,25,17
1650334585066,CSE 190,A00,092507,Dubnov; Shlomo,14,0,20,6
1650334591091,ECE 45,A01,083139,Staff,0,17,40,40
1650334597120,ECE 65,A50,083695,Staff,0,5,30,30
1650334603145,ECE 109,A01,091882,Touri; Behrouz,40,0,70,30
1650334609170,ECE 180,A00,083140,Abi Samra; Nicholas Camill,23,0,30,7
1650334609170,ECE 180,B00,083141,Abi Samra; Nicholas Camill,5,0,30,25
1650334615198,MATH 10A,A01,083735,Patchell; Gregory David,8,0,30,22
1650334615198,MATH 10A,A02,083736,Patchell; Gregory David,28,0,30,2
1650334615198,MATH 10A,A03,083737,Patchell; Gregory David,26,0,30,4
1650334621221,MATH 10B,A01,083207,Staff,0,7,30,30
1650334621221,MATH 10B,A02,083208,Staff,0,6,30,30
1650334621221,MATH 10B,B01,083739,Staff,17,0,30,13
1650334621221,MATH 10B,B02,083740,Staff,28,0,30,2
1650334627253,MATH 18,A01,083743,Staff,4,0,30,26
1650334627253,MATH 18,A02,083744,Staff,27,0,30,3
1650334627253,MATH 18,A03,083745,Staff,22,0,30,8
1650334627253,MATH 18,A04,083746,Staff,27,0,30,3
1650334627253,MATH 18,B01,083748,Staff,0,11,30,30
1650334627253,MATH 18,B02,083749,Staff,0,11,30,30
1650334627253,MATH 18,B03,083750,Staff,1,11,30,29
1650334627253,MATH 18,B04,083751,Staff,0,11,30,30
1650334633277,MATH 20A,A01,083754,Staff,26,0,40,14
1650334639303,MATH 20B,A01,083756,Staff,0,8,30,30
1650334639303,MATH 20B,A02,083757,Staff,0,8,30,30
1650334645327,MATH 20C,A01,083760,Staff,0,13,30,30
1650334645327,MATH 20C,A02,083761,Staff,0,13,30,30
1650334645327,MATH 20C,B01,083762,Staff,13,0,30,17
1650334645327,MATH 20C,B02,083763,Staff,28,0,30,2
1650334651351,MATH 20D,A01,083765,Staff,0,1,30,30
1650334651351,MATH 20D,A02,083766,Staff,7,0,30,23
1650334651351,MATH 20D,A03,083767,Staff,26,0,30,4
1650334657385,MATH 20E,A01,083771,Staff,5,0,30,25
1650334657385,MATH 20E,A02,083772,Staff,19,0,30,11
1650334657385,MATH 20E,B01,083773,Staff,0,0,30,30
1650334657385,MATH 20E,B02,083774,Staff,12,0,30,18
1650334663410,MATH 103A,A01,083777,Staff,0,12,30,30
1650334663410,MATH 103A,A02,083778,Staff,0,12,30,30
1650334663410,MATH 103A,B01,083779,Staff,0,12,30,30
1650334663410,MATH 103A,B02,083780,Staff,0,12,30,30
1650334669437,MATH 105,A01,085443,Staff,0,19,30,30
1650334675462,MATH 109,A01,083213,Anzaldo; Leesa B,0,5,30,30
1650334675462,MATH 109,A02,083214,Anzaldo; Leesa B,0,7,30,30
1650334675462,MATH 109,B01,083215,Anzaldo; Leesa B,0,5,30,30
1650334675462,MATH 109,B02,083216,Anzaldo; Leesa B,0,5,30,30
1650334681485,MATH 142A,A01,083219,Chow; Bennett,0,14,30,30
1650334681485,MATH 142A,A02,083220,Chow; Bennett,0,12,30,30
1650334681485,MATH 142A,B01,083221,Chow; Bennett,0,12,30,30
1650334681485,MATH 142A,B02,083222,Chow; Bennett,0,12,30,30
1650334687512,MATH 193A,A01,083224,Staff,0,5,30,30
1650334687512,MATH 193A,A02,083225,Staff,0,5,30,30
1650334687512,MATH 193A,A03,083781,Staff,0,4,30,30
1650334687512,MATH 193A,A04,083782,Staff,0,3,30,30
1650334693535,MATH 197,001,091859,McAuley; Julian John,9998,0,9999,1
1650334699596,COGS 9,A01,083615,Staff,0,15,60,60
1650334705618,COGS 11,A01,083617,Boyle; Mary E. T.,22,0,40,18
1650334711642,COGS 13,A01,083071,Staff,0,31,40,40
1650334717671,COGS 14A,A01,092681,Staff,0,19,100,100
1650334723707,COGS 14B,A01,083073,Cheng; Tzu-Han,0,10,50,50
1650334729731,COGS 17,A01,092677,Staff,26,0,75,49
1650334735762,COGS 100,A01,083619,Staff,0,23,60,60
1650334741789,COGS 101A,A01,083621,Davis; Joshua Daniel,1,22,60,59
1650334747812,COGS 101B,A01,091572,Staff,2,0,60,58
1650334753836,COGS 101C,A01,083625,Delgado; Tania,18,0,30,12
1650334759861,COGS 107A,A01,083627,Boyle; Mary E. T.,0,8,60,60
1650334765888,COGS 118A,A01,083075,Staff,5,0,60,55
1650334771916,CSE 3,A50,083646,Miranda; Gregory Joseph,21,0,38,17
1650334771916,CSE 3,A51,083647,Miranda; Gregory Joseph,37,0,37,0
1650334777940,CSE 8A,A50,083650,Miranda; Gregory Joseph,0,27,40,40
1650334783970,CSE 11,A01,083080,Cao; Yingjun,0,87,40,40
1650334789993,CSE 12,A01,083652,Staff,0,12,100,100
1650334796020,CSE 15L,A01,083654,Staff,0,1,50,50
1650334796020,CSE 15L,A02,083655,Staff,3,0,50,47
1650334802044,CSE 20,A01,083657,Staff,53,0,80,27
1650334808068,CSE 30,A01,083084,Eldon; John,0,76,40,40
1650334814096,CSE 100,A01,083659,Cao; Yingjun,0,66,50,50
1650334820122,CSE 134B,A01,083661,Powell; Thomas Allan,0,31,65,65
1650334826150,CSE 140,A01,083663,Staff,0,0,75,75
1650334832174,CSE 140L,A01,083088,Eldon; John,0,6,75,75
1650334838199,CSE 175,A01,083665,Kumar; Rakesh,8,0,25,17
1650334844226,CSE 190,A00,092507,Dubnov; Shlomo,14,0,20,6
1650334850252,ECE 45,A01,083139,Staff,0,17,40,40
1650334856276,ECE 65,A50,083695,Staff,0,5,30,30
1650334862304,ECE 109,A01,091882,Touri; Behrouz,40,0,70,30
1650334868335,ECE 180,A00,083140,Abi Samra; Nicholas Camill,23,0,30,7
1650334868335,ECE 180,B00,083141,Abi Samra; Nicholas Camill,5,0,30,25
1650334874365,MATH 10A,A01,083735,Patchell; Gregory David,8,0,30,22
1650334874365,MATH 10A,A02,083736,Patchell; Gregory David,28,0,30,2
1650334874365,MATH 10A,A03,083737,Patchell; Gregory David,26,0,30,4
1650334880390,MATH 10B,A01,083207,Staff,0,7,30,30
1650334880390,MATH 10B,A02,083208,Staff,0,6,30,30
1650334880390,MATH 10B,B01,083739,Staff,17,0,30,13
1650334880390,MATH 10B,B02,083740,Staff,28,0,30,2
1650334886416,MATH 18,A01,083743,Staff,4,0,30,26
1650334886416,MATH 18,A02,083744,Staff,27,0,30,3
1650334886416,MATH 18,A03,083745,Staff,22,0,30,8
1650334886416,MATH 18,A04,083746,Staff,27,0,30,3
1650334886416,MATH 18,B01,083748,Staff,0,11,30,30
1650334886416,MATH 18,B02,083749,Staff,0,11,30,30
1650334886416,MATH 18,B03,083750,Staff,1,11,30,29
1650334886416,MATH 18,B04,083751,Staff,0,11,30,30
1650334892446,MATH 20A,A01,083754,Staff,26,0,40,14
1650334898474,MATH 20B,A01,083756,Staff,0,8,30,30
1650334898474,MATH 20B,A02,083757,Staff,0,8,30,30
1650334904499,MATH 20C,A01,083760,Staff,0,13,30,30
1650334904499,MATH 20C,A02,083761,Staff,0,13,30,30
1650334904499,MATH 20C,B01,083762,Staff,13,0,30,17
1650334904499,MATH 20C,B02,083763,Staff,28,0,30,2
1650334910524,MATH 20D,A01,083765,Staff,0,1,30,30
1650334910524,MATH 20D,A02,083766,Staff,7,0,30,23
1650334910524,MATH 20D,A03,083767,Staff,26,0,30,4
1650334916555,MATH 20E,A01,083771,Staff,5,0,30,25
1650334916555,MATH 20E,A02,083772,Staff,19,0,30,11
1650334916555,MATH 20E,B01,083773,Staff,0,0,30,30
1650334916555,MATH 20E,B02,083774,Staff,12,0,30,18
1650334922581,MATH 103A,A01,083777,Staff,0,12,30,30
1650334922581,MATH 103A,A02,083778,Staff,0,12,30,30
1650334922581,MATH 103A,B01,083779,Staff,0,12,30,30
1650334922581,MATH 103A,B02,083780,Staff,0,12,30,30
1650334928607,MATH 105,A01,085443,Staff,0,19,30,30
1650334934647,MATH 109,A01,083213,Anzaldo; Leesa B,0,5,30,30
1650334934647,MATH 109,A02,083214,Anzaldo; Leesa B,0,7,30,30
1650334934647,MATH 109,B01,083215,Anzaldo; Leesa B,0,5,30,30
1650334934647,MATH 109,B02,083216,Anzaldo; Leesa B,0,5,30,30
1650334940683,MATH 142A,A01,083219,Chow; Bennett,0,14,30,30
1650334940683,MATH 142A,A02,083220,Chow; Bennett,0,12,30,30
1650334940683,MATH 142A,B01,083221,Chow; Bennett,0,12,30,30
1650334940683,MATH 142A,B02,083222,Chow; Bennett,0,12,30,30
1650334946707,MATH 193A,A01,083224,Staff,0,5,30,30
1650334946707,MATH 193A,A02,083225,Staff,0,5,30,30
1650334946707,MATH 193A,A03,083781,Staff,0,4,30,30
1650334946707,MATH 193A,A04,083782,Staff,0,3,30,30
1650334952748,MATH 197,001,091859,McAuley; Julian John,9998,0,9999,1
1650334958798,COGS 9,A01,083615,Staff,0,15,60,60
1650334964828,COGS 11,A01,083617,Boyle; Mary E. T.,22,0,40,18
1650334970853,COGS 13,A01,083071,Staff,0,31,40,40
1650334976882,COGS 14A,A01,092681,Staff,0,19,100,100
1650334982910,COGS 14B,A01,083073,Cheng; Tzu-Han,0,10,50,50
1650334988933,COGS 17,A01,092677,Staff,26,0,75,49
1650334994957,COGS 100,A01,083619,Staff,0,23,60,60
1650335000985,COGS 101A,A01,083621,Davis; Joshua Daniel,1,22,60,59
1650335007013,COGS 101B,A01,091572,Staff,1,0,60,59
1650335013039,COGS 101C,A01,083625,Delgado; Tania,18,0,30,12
1650335019070,COGS 107A,A01,083627,Boyle; Mary E. T.,0,8,60,60
1650335025093,COGS 118A,A01,083075,Staff,5,0,60,55
1650335031119,CSE 3,A50,083646,Miranda; Gregory Joseph,21,0,38,17
1650335031119,CSE 3,A51,083647,Miranda; Gregory Joseph,37,0,37,0
1650335037146,CSE 8A,A50,083650,Miranda; Gregory Joseph,0,27,40,40
1650335043168,CSE 11,A01,083080,Cao; Yingjun,0,88,40,40
1650335049197,CSE 12,A01,083652,Staff,0,12,100,100
1650335055222,CSE 15L,A01,083654,Staff,0,1,50,50
1650335055222,CSE 15L,A02,083655,Staff,3,0,50,47
1650335061245,CSE 20,A01,083657,Staff,53,0,80,27
1650335067282,CSE 30,A01,083084,Eldon; John,0,76,40,40
1650335073306,CSE 100,A01,083659,Cao; Yingjun,0,66,50,50
1650335079331,CSE 134B,A01,083661,Powell; Thomas Allan,0,31,65,65
1650335085358,CSE 140,A01,083663,Staff,0,0,75,75
1650335091382,CSE 140L,A01,083088,Eldon; John,0,6,75,75
1650335097407,CSE 175,A01,083665,Kumar; Rakesh,8,0,25,17
1650335103434,CSE 190,A00,092507,Dubnov; Shlomo,14,0,20,6
1650335109459,ECE 45,A01,083139,Staff,0,17,40,40
1650335115484,ECE 65,A50,083695,Staff,0,5,30,30
1650335121511,ECE 109,A01,091882,Touri; Behrouz,40,0,70,30
1650335127535,ECE 180,A00,083140,Abi Samra; Nicholas Camill,23,0,30,7
1650335127535,ECE 180,B00,083141,Abi Samra; Nicholas Camill,5,0,30,25
1650335133565,MATH 10A,A01,083735,Patchell; Gregory David,8,0,30,22
1650335133565,MATH 10A,A02,083736,Patchell; Gregory David,28,0,30,2
1650335133565,MATH 10A,A03,083737,Patchell; Gregory David,26,0,30,4
1650335139594,MATH 10B,A01,083207,Staff,0,7,30,30
1650335139594,MATH 10B,A02,083208,Staff,0,6,30,30
1650335139594,MATH 10B,B01,083739,Staff,17,0,30,13
1650335139594,MATH 10B,B02,083740,Staff,28,0,30,2
1650335145624,MATH 18,A01,083743,Staff,4,0,30,26
1650335145624,MATH 18,A02,083744,Staff,27,0,30,3
1650335145624,MATH 18,A03,083745,Staff,22,0,30,8
1650335145624,MATH 18,A04,083746,Staff,27,0,30,3
1650335145624,MATH 18,B01,083748,Staff,0,11,30,30
1650335145624,MATH 18,B02,083749,Staff,0,11,30,30
1650335145624,MATH 18,B03,083750,Staff,1,11,30,29
1650335145624,MATH 18,B04,083751,Staff,1,11,30,29
1650335151647,MATH 20A,A01,083754,Staff,26,0,40,14
1650335157677,MATH 20B,A01,083756,Staff,0,8,30,30
1650335157677,MATH 20B,A02,083757,Staff,0,8,30,30
1650335163703,MATH 20C,A01,083760,Staff,0,13,30,30
1650335163703,MATH 20C,A02,083761,Staff,0,13,30,30
1650335163703,MATH 20C,B01,083762,Staff,13,0,30,17
1650335163703,MATH 20C,B02,083763,Staff,28,0,30,2
1650335169829,MATH 20D,A01,083765,Staff,0,1,30,30
1650335169829,MATH 20D,A02,083766,Staff,7,0,30,23
1650335169829,MATH 20D,A03,083767,Staff,26,0,30,4
1650335175853,MATH 20E,A01,083771,Staff,5,0,30,25
1650335175853,MATH 20E,A02,083772,Staff,19,0,30,11
1650335175853,MATH 20E,B01,083773,Staff,0,0,30,30
1650335175853,MATH 20E,B02,083774,Staff,12,0,30,18
1650335181879,MATH 103A,A01,083777,Staff,0,12,30,30
1650335181879,MATH 103A,A02,083778,Staff,0,12,30,30
1650335181879,MATH 103A,B01,083779,Staff,0,12,30,30
1650335181879,MATH 103A,B02,083780,Staff,0,12,30,30
1650335187902,MATH 105,A01,085443,Staff,0,19,30,30
1650335193927,MATH 109,A01,083213,Anzaldo; Leesa B,0,5,30,30
1650335193927,MATH 109,A02,083214,Anzaldo; Leesa B,0,7,30,30
1650335193927,MATH 109,B01,083215,Anzaldo; Leesa B,0,5,30,30
1650335193927,MATH 109,B02,083216,Anzaldo; Leesa B,0,5,30,30
1650335199955,MATH 142A,A01,083219,Chow; Bennett,0,14,30,30
1650335199955,MATH 142A,A02,083220,Chow; Bennett,0,12,30,30
1650335199955,MATH 142A,B01,083221,Chow; Bennett,0,12,30,30
1650335199955,MATH 142A,B02,083222,Chow; Bennett,0,12,30,30
1650335205987,MATH 193A,A01,083224,Staff,0,5,30,30
1650335205987,MATH 193A,A02,083225,Staff,0,5,30,30
1650335205987,MATH 193A,A03,083781,Staff,0,4,30,30
1650335205987,MATH 193A,A04,083782,Staff,0,3,30,30
1650335212012,MATH 197,001,091859,McAuley; Julian John,9998,0,9999,1
1650335218085,COGS 9,A01,083615,Staff,0,15,60,60
1650335224120,COGS 11,A01,083617,Boyle; Mary E. T.,22,0,40,18
1650335230155,COGS 13,A01,083071,Staff,0,31,40,40
1650335236183,COGS 14A,A01,092681,Staff,0,19,100,100
1650335242206,COGS 14B,A01,083073,Cheng; Tzu-Han,0,10,50,50
1650335248228,COGS 17,A01,092677,Staff,26,0,75,49
1650335254250,COGS 100,A01,083619,Staff,0,23,60,60
1650335260277,COGS 101A,A01,083621,Davis; Joshua Daniel,1,22,60,59
1650335266300,COGS 101B,A01,091572,Staff,1,0,60,59
1650335272323,COGS 101C,A01,083625,Delgado; Tania,18,0,30,12
1650335278346,COGS 107A,A01,083627,Boyle; Mary E. T.,0,8,60,60
1650335284372,COGS 118A,A01,083075,Staff,5,0,60,55
1650335290405,CSE 3,A50,083646,Miranda; Gregory Joseph,21,0,38,17
1650335290405,CSE 3,A51,083647,Miranda; Gregory Joseph,37,0,37,0
1650335296434,CSE 8A,A50,083650,Miranda; Gregory Joseph,0,28,40,40
1650335302458,CSE 11,A01,083080,Cao; Yingjun,0,88,40,40
1650335308480,CSE 12,A01,083652,Staff,0,12,100,100
1650335314505,CSE 15L,A01,083654,Staff,0,1,50,50
1650335314505,CSE 15L,A02,083655,Staff,3,0,50,47
1650335320526,CSE 20,A01,083657,Staff,53,0,80,27
1650335326550,CSE 30,A01,083084,Eldon; John,0,76,40,40
1650335332576,CSE 100,A01,083659,Cao; Yingjun,0,66,50,50
1650335338603,CSE 134B,A01,083661,Powell; Thomas Allan,0,31,65,65
1650335344628,CSE 140,A01,083663,Staff,0,0,75,75
1650335350651,CSE 140L,A01,083088,Eldon; John,0,6,75,75
1650335356676,CSE 175,A01,083665,Kumar; Rakesh,8,0,25,17
1650335362702,CSE 190,A00,092507,Dubnov; Shlomo,14,0,20,6
1650335368724,ECE 45,A01,083139,Staff,0,17,40,40
1650335374748,ECE 65,A50,083695,Staff,0,5,30,30
1650335380771,ECE 109,A01,091882,Touri; Behrouz,40,0,70,30
1650335386809,ECE 180,A00,083140,Abi Samra; Nicholas Camill,23,0,30,7
1650335386809,ECE 180,B00,083141,Abi Samra; Nicholas Camill,5,0,30,25
1650335392842,MATH 10A,A01,083735,Patchell; Gregory David,8,0,30,22
1650335392842,MATH 10A,A02,083736,Patchell; Gregory David,28,0,30,2
1650335392842,MATH 10A,A03,083737,Patchell; Gregory David,26,0,30,4
1650335398869,MATH 10B,A01,083207,Staff,0,7,30,30
1650335398869,MATH 10B,A02,083208,Staff,0,6,30,30
1650335398869,MATH 10B,B01,083739,Staff,17,0,30,13
1650335398869,MATH 10B,B02,083740,Staff,28,0,30,2
1650335404892,MATH 18,A01,083743,Staff,4,0,30,26
1650335404892,MATH 18,A02,083744,Staff,27,0,30,3
1650335404892,MATH 18,A03,083745,Staff,22,0,30,8
1650335404892,MATH 18,A04,083746,Staff,27,0,30,3
1650335404892,MATH 18,B01,083748,Staff,0,11,30,30
1650335404892,MATH 18,B02,083749,Staff,0,11,30,30
1650335404892,MATH 18,B03,083750,Staff,1,11,30,29
1650335404892,MATH 18,B04,083751,Staff,1,11,30,29
1650335410916,MATH 20A,A01,083754,Staff,26,0,40,14
1650335416943,MATH 20B,A01,083756,Staff,0,8,30,30
1650335416943,MATH 20B,A02,083757,Staff,0,8,30,30
1650335422968,MATH 20C,A01,083760,Staff,0,13,30,30
1650335422968,MATH 20C,A02,083761,Staff,0,13,30,30
1650335422968,MATH 20C,B01,083762,Staff,13,0,30,17
1650335422968,MATH 20C,B02,083763,Staff,28,0,30,2
1650335429006,MATH 20D,A01,083765,Staff,0,1,30,30
1650335429006,MATH 20D,A02,083766,Staff,7,0,30,23
1650335429006,MATH 20D,A03,083767,Staff,26,0,30,4
1650335435030,MATH 20E,A01,083771,Staff,5,0,30,25
1650335435030,MATH 20E,A02,083772,Staff,19,0,30,11
1650335435030,MATH 20E,B01,083773,Staff,0,0,30,30
1650335435030,MATH 20E,B02,083774,Staff,12,0,30,18
1650335441053,MATH 103A,A01,083777,Staff,0,12,30,30
1650335441053,MATH 103A,A02,083778,Staff,0,12,30,30
1650335441053,MATH 103A,B01,083779,Staff,0,12,30,30
1650335441053,MATH 103A,B02,083780,Staff,0,12,30,30
1650335447082,MATH 105,A01,085443,Staff,0,19,30,30
1650335453106,MATH 109,A01,083213,Anzaldo; Leesa B,0,5,30,30
1650335453106,MATH 109,A02,083214,Anzaldo; Leesa B,0,7,30,30
1650335453106,MATH 109,B01,083215,Anzaldo; Leesa B,0,5,30,30
1650335453106,MATH 109,B02,083216,Anzaldo; Leesa B,0,5,30,30
1650335459130,MATH 142A,A01,083219,Chow; Bennett,0,14,30,30
1650335459130,MATH 142A,A02,083220,Chow; Bennett,0,12,30,30
1650335459130,MATH 142A,B01,083221,Chow; Bennett,0,12,30,30
1650335459130,MATH 142A,B02,083222,Chow; Bennett,0,12,30,30
1650335465157,MATH 193A,A01,083224,Staff,0,5,30,30
1650335465157,MATH 193A,A02,083225,Staff,0,5,30,30
1650335465157,MATH 193A,A03,083781,Staff,0,4,30,30
1650335465157,MATH 193A,A04,083782,Staff,0,3,30,30
1650335471179,MATH 197,001,091859,McAuley; Julian John,9998,0,9999,1
1650335477228,COGS 9,A01,083615,Staff,0,15,60,60
1650335483251,COGS 11,A01,083617,Boyle; Mary E. T.,22,0,40,18
1650335489278,COGS 13,A01,083071,Staff,0,31,40,40
1650335495313,COGS 14A,A01,092681,Staff,0,19,100,100
1650335501337,COGS 14B,A01,083073,Cheng; Tzu-Han,0,10,50,50
1650335507361,COGS 17,A01,092677,Staff,26,0,75,49
1650335513384,COGS 100,A01,083619,Staff,0,23,60,60
1650335519407,COGS 101A,A01,083621,Davis; Joshua Daniel,1,22,60,59
1650335525437,COGS 101B,A01,091572,Staff,1,0,60,59
1650335531465,COGS 101C,A01,083625,Delgado; Tania,18,0,30,12
1650335537497,COGS 107A,A01,083627,Boyle; Mary E. T.,0,8,60,60
1650335543523,COGS 118A,A01,083075,Staff,5,0,60,55
1650335549547,CSE 3,A50,083646,Miranda; Gregory Joseph,21,0,38,17
1650335549547,CSE 3,A51,083647,Miranda; Gregory Joseph,37,0,37,0
1650335555577,CSE 8A,A50,083650,Miranda; Gregory Joseph,0,28,40,40
1650335561600,CSE 11,A01,083080,Cao; Yingjun,0,88,40,40
1650335567631,CSE 12,A01,083652,Staff,0,12,100,100
1650335573663,CSE 15L,A01,083654,Staff,0,1,50,50
1650335573663,CSE 15L,A02,083655,Staff,3,0,50,47
1650335579690,CSE 20,A01,083657,Staff,53,0,80,27
1650335585713,CSE 30,A01,083084,Eldon; John,0,76,40,40
1650335591736,CSE 100,A01,083659,Cao; Yingjun,0,66,50,50
1650335597760,CSE 134B,A01,083661,Powell; Thomas Allan,0,31,65,65
1650335603789,CSE 140,A01,083663,Staff,0,0,75,75
1650335609813,CSE 140L,A01,083088,Eldon; John,0,6,75,75
1650335615839,CSE 175,A01,083665,Kumar; Rakesh,8,0,25,17
1650335621867,CSE 190,A00,092507,Dubnov; Shlomo,14,0,20,6
1650335627892,ECE 45,A01,083139,Staff,0,17,40,40
1650335633986,ECE 65,A50,083695,Staff,0,5,30,30
1650335640012,ECE 109,A01,091882,Touri; Behrouz,40,0,70,30
1650335646037,ECE 180,A00,083140,Abi Samra; Nicholas Camill,23,0,30,7
1650335646037,ECE 180,B00,083141,Abi Samra; Nicholas Camill,5,0,30,25
1650335652066,MATH 10A,A01,083735,Patchell; Gregory David,8,0,30,22
1650335652066,MATH 10A,A02,083736,Patchell; Gregory David,28,0,30,2
1650335652066,MATH 10A,A03,083737,Patchell; Gregory David,26,0,30,4
1650335658090,MATH 10B,A01,083207,Staff,0,7,30,30
1650335658090,MATH 10B,A02,083208,Staff,0,6,30,30
1650335658090,MATH 10B,B01,083739,Staff,17,0,30,13
1650335658090,MATH 10B,B02,083740,Staff,28,0,30,2
1650335664116,MATH 18,A01,083743,Staff,4,0,30,26
1650335664116,MATH 18,A02,083744,Staff,27,0,30,3
1650335664116,MATH 18,A03,083745,Staff,22,0,30,8
1650335664116,MATH 18,A04,083746,Staff,27,0,30,3
1650335664116,MATH 18,B01,083748,Staff,0,11,30,30
1650335664116,MATH 18,B02,083749,Staff,0,11,30,30
1650335664116,MATH 18,B03,083750,Staff,1,11,30,29
1650335664116,MATH 18,B04,083751,Staff,1,11,30,29
1650335670140,MATH 20A,A01,083754,Staff,26,0,40,14
1650335676167,MATH 20B,A01,083756,Staff,0,8,30,30
1650335676167,MATH 20B,A02,083757,Staff,0,8,30,30
1650335682195,MATH 20C,A01,083760,Staff,0,13,30,30
1650335682195,MATH 20C,A02,083761,Staff,0,13,30,30
1650335682195,MATH 20C,B01,083762,Staff,13,0,30,17
1650335682195,MATH 20C,B02,083763,Staff,28,0,30,2
1650335688219,MATH 20D,A01,083765,Staff,0,1,30,30
1650335688219,MATH 20D,A02,083766,Staff,7,0,30,23
1650335688219,MATH 20D,A03,083767,Staff,26,0,30,4
1650335694242,MATH 20E,A01,083771,Staff,5,0,30,25
1650335694242,MATH 20E,A02,083772,Staff,19,0,30,11
1650335694242,MATH 20E,B01,083773,Staff,0,0,30,30
1650335694242,MATH 20E,B02,083774,Staff,12,0,30,18
1650335700266,MATH 103A,A01,083777,Staff,0,12,30,30
1650335700266,MATH 103A,A02,083778,Staff,0,12,30,30
1650335700266,MATH 103A,B01,083779,Staff,0,12,30,30
1650335700266,MATH 103A,B02,083780,Staff,0,12,30,30
1650335706289,MATH 105,A01,085443,Staff,0,19,30,30
1650335712318,MATH 109,A01,083213,Anzaldo; Leesa B,0,5,30,30
1650335712318,MATH 109,A02,083214,Anzaldo; Leesa B,0,7,30,30
1650335712318,MATH 109,B01,083215,Anzaldo; Leesa B,0,5,30,30
1650335712318,MATH 109,B02,083216,Anzaldo; Leesa B,0,5,30,30
1650335718341,MATH 142A,A01,083219,Chow; Bennett,0,14,30,30
1650335718341,MATH 142A,A02,083220,Chow; Bennett,0,12,30,30
1650335718341,MATH 142A,B01,083221,Chow; Bennett,0,12,30,30
1650335718341,MATH 142A,B02,083222,Chow; Bennett,0,12,30,30
1650335724371,MATH 193A,A01,083224,Staff,0,5,30,30
1650335724371,MATH 193A,A02,083225,Staff,0,5,30,30
1650335724371,MATH 193A,A03,083781,Staff,0,4,30,30
1650335724371,MATH 193A,A04,083782,Staff,0,3,30,30
1650335730395,MATH 197,001,091859,McAuley; Julian John,9998,0,9999,1
1650335736450,COGS 9,A01,083615,Staff,0,15,60,60
1650335742474,COGS 11,A01,083617,Boyle; Mary E. T.,22,0,40,18
1650335748497,COGS 13,A01,083071,Staff,0,31,40,40
1650335754522,COGS 14A,A01,092681,Staff,0,19,100,100
1650335760636,COGS 14B,A01,083073,Cheng; Tzu-Han,0,10,50,50
1650335766660,COGS 17,A01,092677,Staff,26,0,75,49
1650335772688,COGS 100,A01,083619,Staff,0,23,60,60
1650335778711,COGS 101A,A01,083621,Davis; Joshua Daniel,1,22,60,59
1650335784734,COGS 101B,A01,091572,Staff,1,0,60,59
1650335790758,COGS 101C,A01,083625,Delgado; Tania,18,0,30,12
1650335796784,COGS 107A,A01,083627,Boyle; Mary E. T.,0,8,60,60
1650335802812,COGS 118A,A01,083075,Staff,5,0,60,55
1650335808836,CSE 3,A50,083646,Miranda; Gregory Joseph,21,0,38,17
1650335808836,CSE 3,A51,083647,Miranda; Gregory Joseph,37,0,37,0
1650335814865,CSE 8A,A50,083650,Miranda; Gregory Joseph,0,28,40,40
1650335820887,CSE 11,A01,083080,Cao; Yingjun,0,88,40,40
1650335826913,CSE 12,A01,083652,Staff,0,12,100,100
1650335832940,CSE 15L,A01,083654,Staff,0,1,50,50
1650335832940,CSE 15L,A02,083655,Staff,3,0,50,47
1650335838964,CSE 20,A01,083657,Staff,53,0,80,27
1650335844988,CSE 30,A01,083084,Eldon; John,0,76,40,40
1650335851010,CSE 100,A01,083659,Cao; Yingjun,0,66,50,50
1650335857034,CSE 134B,A01,083661,Powell; Thomas Allan,0,31,65,65
1650335863060,CSE 140,A01,083663,Staff,0,0,75,75
1650335869094,CSE 140L,A01,083088,Eldon; John,0,6,75,75
1650335875122,CSE 175,A01,083665,Kumar; Rakesh,8,0,25,17
1650335881150,CSE 190,A00,092507,Dubnov; Shlomo,14,0,20,6
1650335887175,ECE 45,A01,083139,Staff,0,17,40,40
1650335893201,ECE 65,A50,083695,Staff,0,5,30,30
1650335899226,ECE 109,A01,091882,Touri; Behrouz,40,0,70,30
1650335905255,ECE 180,A00,083140,Abi Samra; Nicholas Camill,23,0,30,7
1650335905255,ECE 180,B00,083141,Abi Samra; Nicholas Camill,5,0,30,25
1650335911278,MATH 10A,A01,083735,Patchell; Gregory David,8,0,30,22
1650335911278,MATH 10A,A02,083736,Patchell; Gregory David,28,0,30,2
1650335911278,MATH 10A,A03,083737,Patchell; Gregory David,26,0,30,4
1650335917305,MATH 10B,A01,083207,Staff,0,7,30,30
1650335917305,MATH 10B,A02,083208,Staff,0,6,30,30
1650335917305,MATH 10B,B01,083739,Staff,17,0,30,13
1650335917305,MATH 10B,B02,083740,Staff,28,0,30,2
1650335923335,MATH 18,A01,083743,Staff,4,0,30,26
1650335923335,MATH 18,A02,083744,Staff,27,0,30,3
1650335923335,MATH 18,A03,083745,Staff,22,0,30,8
1650335923335,MATH 18,A04,083746,Staff,27,0,30,3
1650335923335,MATH 18,B01,083748,Staff,0,11,30,30
1650335923335,MATH 18,B02,083749,Staff,0,11,30,30
1650335923335,MATH 18,B03,083750,Staff,1,11,30,29
1650335923335,MATH 18,B04,083751,Staff,1,11,30,29
1650335929362,MATH 20A,A01,083754,Staff,26,0,40,14
1650335935386,MATH 20B,A01,083756,Staff,0,8,30,30
1650335935386,MATH 20B,A02,083757,Staff,0,8,30,30
1650335941418,MATH 20C,A01,083760,Staff,0,13,30,30
1650335941418,MATH 20C,A02,083761,Staff,0,13,30,30
1650335941418,MATH 20C,B01,083762,Staff,13,0,30,17
1650335941418,MATH 20C,B02,083763,Staff,28,0,30,2
1650335947446,MATH 20D,A01,083765,Staff,0,1,30,30
1650335947446,MATH 20D,A02,083766,Staff,7,0,30,23
1650335947446,MATH 20D,A03,083767,Staff,26,0,30,4
1650335953474,MATH 20E,A01,083771,Staff,5,0,30,25
1650335953474,MATH 20E,A02,083772,Staff,19,0,30,11
1650335953474,MATH 20E,B01,083773,Staff,0,0,30,30
1650335953474,MATH 20E,B02,083774,Staff,12,0,30,18
1650335959499,MATH 103A,A01,083777,Staff,0,12,30,30
1650335959499,MATH 103A,A02,083778,Staff,0,12,30,30
1650335959499,MATH 103A,B01,083779,Staff,0,12,30,30
1650335959499,MATH 103A,B02,083780,Staff,0,12,30,30
1650335965525,MATH 105,A01,085443,Staff,0,19,30,30
1650335971549,MATH 109,A01,083213,Anzaldo; Leesa B,0,5,30,30
1650335971549,MATH 109,A02,083214,Anzaldo; Leesa B,0,7,30,30
1650335971549,MATH 109,B01,083215,Anzaldo; Leesa B,0,5,30,30
1650335971549,MATH 109,B02,083216,Anzaldo; Leesa B,0,5,30,30
1650335977577,MATH 142A,A01,083219,Chow; Bennett,0,14,30,30
1650335977577,MATH 142A,A02,083220,Chow; Bennett,0,12,30,30
1650335977577,MATH 142A,B01,083221,Chow; Bennett,0,12,30,30
1650335977577,MATH 142A,B02,083222,Chow; Bennett,0,12,30,30
1650335983602,MATH 193A,A01,083224,Staff,0,5,30,30
1650335983602,MATH 193A,A02,083225,Staff,0,5,30,30
1650335983602,MATH 193A,A03,083781,Staff,0,4,30,30
1650335983602,MATH 193A,A04,083782,Staff,0,3,30,30
1650335989629,MATH 197,001,091859,McAuley; Julian John,9998,0,9999,1
1650335995690,COGS 9,A01,083615,Staff,0,15,60,60
1650336001728,COGS 11,A01,083617,Boyle; Mary E. T.,22,0,40,18
1650336007754,COGS 13,A01,083071,Staff,0,31,40,40
1650336013777,COGS 14A,A01,092681,Staff,0,19,100,100
1650336019801,COGS 14B,A01,083073,Cheng; Tzu-Han,0,10,50,50
1650336025823,COGS 17,A01,092677,Staff,26,0,75,49
1650336031853,COGS 100,A01,083619,Staff,0,23,60,60
1650336037887,COGS 101A,A01,083621,Davis; Joshua Daniel,1,22,60,59
1650336043912,COGS 101B,A01,091572,Staff,1,0,60,59
1650336049945,COGS 101C,A01,083625,Delgado; Tania,18,0,30,12
1650336055968,COGS 107A,A01,083627,Boyle; Mary E. T.,0,8,60,60
1650336061990,COGS 118A,A01,083075,Staff,5,0,60,55
1650336068018,CSE 3,A50,083646,Miranda; Gregory Joseph,21,0,38,17
1650336068018,CSE 3,A51,083647,Miranda; Gregory Joseph,37,0,37,0
1650336074041,CSE 8A,A50,083650,Miranda; Gregory Joseph,0,28,40,40
1650336080064,CSE 11,A01,083080,Cao; Yingjun,0,88,40,40
1650336086087,CSE 12,A01,083652,Staff,0,12,100,100
1650336092113,CSE 15L,A01,083654,Staff,0,1,50,50
1650336092113,CSE 15L,A02,083655,Staff,3,0,50,47
1650336098138,CSE 20,A01,083657,Staff,53,0,80,27
1650336104163,CSE 30,A01,083084,Eldon; John,0,76,40,40
1650336110188,CSE 100,A01,083659,Cao; Yingjun,0,66,50,50
1650336116212,CSE 134B,A01,083661,Powell; Thomas Allan,0,31,65,65
1650336122237,CSE 140,A01,083663,Staff,0,0,75,75
1650336128281,CSE 140L,A01,083088,Eldon; John,0,6,75,75
1650336134305,CSE 175,A01,083665,Kumar; Rakesh,8,0,25,17
1650336140329,CSE 190,A00,092507,Dubnov; Shlomo,14,0,20,6
1650336148041,ECE 45,A01,083139,Staff,0,17,40,40
1650336154065,ECE 65,A50,083695,Staff,0,5,30,30
1650336160089,ECE 109,A01,091882,Touri; Behrouz,40,0,70,30
1650336166115,ECE 180,A00,083140,Abi Samra; Nicholas Camill,23,0,30,7
1650336166115,ECE 180,B00,083141,Abi Samra; Nicholas Camill,5,0,30,25
1650336172142,MATH 10A,A01,083735,Patchell; Gregory David,8,0,30,22
1650336172142,MATH 10A,A02,083736,Patchell; Gregory David,28,0,30,2
1650336172142,MATH 10A,A03,083737,Patchell; Gregory David,26,0,30,4
1650336178165,MATH 10B,A01,083207,Staff,0,7,30,30
1650336178165,MATH 10B,A02,083208,Staff,0,6,30,30
1650336178165,MATH 10B,B01,083739,Staff,17,0,30,13
1650336178165,MATH 10B,B02,083740,Staff,28,0,30,2
1650336184188,MATH 18,A01,083743,Staff,4,0,30,26
1650336184188,MATH 18,A02,083744,Staff,27,0,30,3
1650336184188,MATH 18,A03,083745,Staff,22,0,30,8
1650336184188,MATH 18,A04,083746,Staff,27,0,30,3
1650336184188,MATH 18,B01,083748,Staff,0,11,30,30
1650336184188,MATH 18,B02,083749,Staff,0,11,30,30
1650336184188,MATH 18,B03,083750,Staff,1,11,30,29
1650336184188,MATH 18,B04,083751,Staff,1,11,30,29
1650336190212,MATH 20A,A01,083754,Staff,26,0,40,14
1650336196239,MATH 20B,A01,083756,Staff,0,8,30,30
1650336196239,MATH 20B,A02,083757,Staff,0,8,30,30
1650336202260,MATH 20C,A01,083760,Staff,0,13,30,30
1650336202260,MATH 20C,A02,083761,Staff,0,13,30,30
1650336202260,MATH 20C,B01,083762,Staff,13,0,30,17
1650336202260,MATH 20C,B02,083763,Staff,28,0,30,2
1650336208284,MATH 20D,A01,083765,Staff,0,1,30,30
1650336208284,MATH 20D,A02,083766,Staff,7,0,30,23
1650336208284,MATH 20D,A03,083767,Staff,26,0,30,4
1650336214317,MATH 20E,A01,083771,Staff,5,0,30,25
1650336214317,MATH 20E,A02,083772,Staff,19,0,30,11
1650336214317,MATH 20E,B01,083773,Staff,0,0,30,30
1650336214317,MATH 20E,B02,083774,Staff,12,0,30,18
1650336220344,MATH 103A,A01,083777,Staff,0,12,30,30
1650336220344,MATH 103A,A02,083778,Staff,0,12,30,30
1650336220344,MATH 103A,B01,083779,Staff,0,12,30,30
1650336220344,MATH 103A,B02,083780,Staff,0,12,30,30
1650336226366,MATH 105,A01,085443,Staff,0,19,30,30
1650336232395,MATH 109,A01,083213,Anzaldo; Leesa B,0,5,30,30
1650336232395,MATH 109,A02,083214,Anzaldo; Leesa B,0,7,30,30
1650336232395,MATH 109,B01,083215,Anzaldo; Leesa B,0,5,30,30
1650336232395,MATH 109,B02,083216,Anzaldo; Leesa B,0,5,30,30
1650336238418,MATH 142A,A01,083219,Chow; Bennett,0,14,30,30
1650336238418,MATH 142A,A02,083220,Chow; Bennett,0,12,30,30
1650336238418,MATH 142A,B01,083221,Chow; Bennett,0,12,30,30
1650336238418,MATH 142A,B02,083222,Chow; Bennett,0,12,30,30
1650336244501,MATH 193A,A01,083224,Staff,0,5,30,30
1650336244501,MATH 193A,A02,083225,Staff,0,5,30,30
1650336244501,MATH 193A,A03,083781,Staff,0,4,30,30
1650336244501,MATH 193A,A04,083782,Staff,0,3,30,30
1650336250524,MATH 197,001,091859,McAuley; Julian John,9998,0,9999,1
1650336256573,COGS 9,A01,083615,Staff,0,15,60,60
1650336262605,COGS 11,A01,083617,Boyle; Mary E. T.,22,0,40,18
1650336268633,COGS 13,A01,083071,Staff,0,31,40,40
1650336274658,COGS 14A,A01,092681,Staff,0,19,100,100
1650336280687,COGS 14B,A01,083073,Cheng; Tzu-Han,0,10,50,50
1650336286713,COGS 17,A01,092677,Staff,26,0,75,49
1650336292736,COGS 100,A01,083619,Staff,0,23,60,60
1650336298758,COGS 101A,A01,083621,Davis; Joshua Daniel,1,22,60,59
1650336304785,COGS 101B,A01,091572,Staff,1,0,60,59
1650336310808,COGS 101C,A01,083625,Delgado; Tania,18,0,30,12
1650336316831,COGS 107A,A01,083627,Boyle; Mary E. T.,0,8,60,60
1650336322856,COGS 118A,A01,083075,Staff,5,0,60,55
1650336328883,CSE 3,A50,083646,Miranda; Gregory Joseph,21,0,38,17
1650336328883,CSE 3,A51,083647,Miranda; Gregory Joseph,37,0,37,0
1650336334908,CSE 8A,A50,083650,Miranda; Gregory Joseph,0,28,40,40
1650336340932,CSE 11,A01,083080,Cao; Yingjun,0,88,40,40
1650336346969,CSE 12,A01,083652,Staff,0,12,100,100
1650336352997,CSE 15L,A01,083654,Staff,0,1,50,50
1650336352997,CSE 15L,A02,083655,Staff,3,0,50,47
1650336359126,CSE 20,A01,083657,Staff,53,0,80,27
1650336365148,CSE 30,A01,083084,Eldon; John,0,76,40,40
1650336371178,CSE 100,A01,083659,Cao; Yingjun,0,66,50,50
1650336377211,CSE 134B,A01,083661,Powell; Thomas Allan,0,31,65,65
1650336383238,CSE 140,A01,083663,Staff,0,0,75,75
1650336389261,CSE 140L,A01,083088,Eldon; John,0,6,75,75
1650336395284,CSE 175,A01,083665,Kumar; Rakesh,8,0,25,17
1650336401311,CSE 190,A00,092507,Dubnov; Shlomo,14,0,20,6
1650336407341,ECE 45,A01,083139,Staff,0,17,40,40
1650336413371,ECE 65,A50,083695,Staff,0,5,30,30
1650336419399,ECE 109,A01,091882,Touri; Behrouz,40,0,70,30
1650336425423,ECE 180,A00,083140,Abi Samra; Nicholas Camill,23,0,30,7
1650336425423,ECE 180,B00,083141,Abi Samra; Nicholas Camill,5,0,30,25
1650336431446,MATH 10A,A01,083735,Patchell; Gregory David,8,0,30,22
1650336431446,MATH 10A,A02,083736,Patchell; Gregory David,28,0,30,2
1650336431446,MATH 10A,A03,083737,Patchell; Gregory David,26,0,30,4
1650336437470,MATH 10B,A01,083207,Staff,0,7,30,30
1650336437470,MATH 10B,A02,083208,Staff,0,6,30,30
1650336437470,MATH 10B,B01,083739,Staff,17,0,30,13
1650336437470,MATH 10B,B02,083740,Staff,28,0,30,2
1650336443497,MATH 18,A01,083743,Staff,4,0,30,26
1650336443497,MATH 18,A02,083744,Staff,27,0,30,3
1650336443497,MATH 18,A03,083745,Staff,22,0,30,8
1650336443497,MATH 18,A04,083746,Staff,27,0,30,3
1650336443497,MATH 18,B01,083748,Staff,0,11,30,30
1650336443497,MATH 18,B02,083749,Staff,0,11,30,30
1650336443497,MATH 18,B03,083750,Staff,1,11,30,29
1650336443497,MATH 18,B04,083751,Staff,1,11,30,29
1650336449534,MATH 20A,A01,083754,Staff,26,0,40,14
1650336455560,MATH 20B,A01,083756,Staff,0,8,30,30
1650336455560,MATH 20B,A02,083757,Staff,0,8,30,30
1650336461587,MATH 20C,A01,083760,Staff,0,13,30,30
1650336461587,MATH 20C,A02,083761,Staff,0,13,30,30
1650336461587,MATH 20C,B01,083762,Staff,13,0,30,17
1650336461587,MATH 20C,B02,083763,Staff,28,0,30,2
1650336467631,MATH 20D,A01,083765,Staff,0,1,30,30
1650336467631,MATH 20D,A02,083766,Staff,7,0,30,23
1650336467631,MATH 20D,A03,083767,Staff,26,0,30,4
1650336473663,MATH 20E,A01,083771,Staff,5,0,30,25
1650336473663,MATH 20E,A02,083772,Staff,19,0,30,11
1650336473663,MATH 20E,B01,083773,Staff,0,0,30,30
1650336473663,MATH 20E,B02,083774,Staff,12,0,30,18
1650336479690,MATH 103A,A01,083777,Staff,0,12,30,30
1650336479690,MATH 103A,A02,083778,Staff,0,12,30,30
1650336479690,MATH 103A,B01,083779,Staff,0,12,30,30
1650336479690,MATH 103A,B02,083780,Staff,0,12,30,30
1650336485712,MATH 105,A01,085443,Staff,0,19,30,30
1650336491736,MATH 109,A01,083213,Anzaldo; Leesa B,0,5,30,30
1650336491736,MATH 109,A02,083214,Anzaldo; Leesa B,0,7,30,30
1650336491736,MATH 109,B01,083215,Anzaldo; Leesa B,0,5,30,30
1650336491736,MATH 109,B02,083216,Anzaldo; Leesa B,0,5,30,30
1650336497764,MATH 142A,A01,083219,Chow; Bennett,0,14,30,30
1650336497764,MATH 142A,A02,083220,Chow; Bennett,0,12,30,30
1650336497764,MATH 142A,B01,083221,Chow; Bennett,0,12,30,30
1650336497764,MATH 142A,B02,083222,Chow; Bennett,0,12,30,30
1650336503788,MATH 193A,A01,083224,Staff,0,5,30,30
1650336503788,MATH 193A,A02,083225,Staff,0,5,30,30
1650336503788,MATH 193A,A03,083781,Staff,0,4,30,30
1650336503788,MATH 193A,A04,083782,Staff,0,3,30,30
1650336509812,MATH 197,001,091859,McAuley; Julian John,9998,0,9999,1
1650336515858,COGS 9,A01,083615,Staff,0,15,60,60
1650336521883,COGS 11,A01,083617,Boyle; Mary E. T.,22,0,40,18
1650336527906,COGS 13,A01,083071,Staff,0,31,40,40
1650336533937,COGS 14A,A01,092681,Staff,0,19,100,100
1650336539961,COGS 14B,A01,083073,Cheng; Tzu-Han,0,10,50,50
1650336545984,COGS 17,A01,092677,Staff,26,0,75,49
1650336552007,COGS 100,A01,083619,Staff,0,23,60,60
1650336558042,COGS 101A,A01,083621,Davis; Joshua Daniel,1,22,60,59
1650336564068,COGS 101B,A01,091572,Staff,1,0,60,59
1650336570091,COGS 101C,A01,083625,Delgado; Tania,18,0,30,12
1650336576115,COGS 107A,A01,083627,Boyle; Mary E. T.,0,8,60,60
1650336582139,COGS 118A,A01,083075,Staff,5,0,60,55
1650336588165,CSE 3,A50,083646,Miranda; Gregory Joseph,21,0,38,17
1650336588165,CSE 3,A51,083647,Miranda; Gregory Joseph,37,0,37,0
1650336594191,CSE 8A,A50,083650,Miranda; Gregory Joseph,0,28,40,40
1650336600229,CSE 11,A01,083080,Cao; Yingjun,0,88,40,40
1650336606253,CSE 12,A01,083652,Staff,0,12,100,100
1650336612277,CSE 15L,A01,083654,Staff,0,1,50,50
1650336612277,CSE 15L,A02,083655,Staff,3,0,50,47
1650336618308,CSE 20,A01,083657,Staff,53,0,80,27
1650336624332,CSE 30,A01,083084,Eldon; John,0,76,40,40
1650336630355,CSE 100,A01,083659,Cao; Yingjun,0,66,50,50
1650336636378,CSE 134B,A01,083661,Powell; Thomas Allan,0,31,65,65
1650336642401,CSE 140,A01,083663,Staff,0,0,75,75
1650336648425,CSE 140L,A01,083088,Eldon; John,0,6,75,75
1650336654446,CSE 175,A01,083665,Kumar; Rakesh,8,0,25,17
1650336660474,CSE 190,A00,092507,Dubnov; Shlomo,14,0,20,6
1650336666500,ECE 45,A01,083139,Staff,0,17,40,40
1650336672523,ECE 65,A50,083695,Staff,0,5,30,30
1650336678552,ECE 109,A01,091882,Touri; Behrouz,40,0,70,30
1650336684575,ECE 180,A00,083140,Abi Samra; Nicholas Camill,23,0,30,7
1650336684575,ECE 180,B00,083141,Abi Samra; Nicholas Camill,5,0,30,25
1650336690601,MATH 10A,A01,083735,Patchell; Gregory David,8,0,30,22
1650336690601,MATH 10A,A02,083736,Patchell; Gregory David,28,0,30,2
1650336690601,MATH 10A,A03,083737,Patchell; Gregory David,26,0,30,4
1650336696627,MATH 10B,A01,083207,Staff,0,7,30,30
1650336696627,MATH 10B,A02,083208,Staff,0,6,30,30
1650336696627,MATH 10B,B01,083739,Staff,17,0,30,13
1650336696627,MATH 10B,B02,083740,Staff,28,0,30,2
1650336702651,MATH 18,A01,083743,Staff,4,0,30,26
1650336702651,MATH 18,A02,083744,Staff,27,0,30,3
1650336702651,MATH 18,A03,083745,Staff,22,0,30,8
1650336702651,MATH 18,A04,083746,Staff,27,0,30,3
1650336702651,MATH 18,B01,083748,Staff,0,11,30,30
1650336702651,MATH 18,B02,083749,Staff,0,11,30,30
1650336702651,MATH 18,B03,083750,Staff,1,11,30,29
1650336702651,MATH 18,B04,083751,Staff,1,11,30,29
1650336708675,MATH 20A,A01,083754,Staff,26,0,40,14
1650336714699,MATH 20B,A01,083756,Staff,0,8,30,30
1650336714699,MATH 20B,A02,083757,Staff,0,8,30,30
1650336720723,MATH 20C,A01,083760,Staff,0,13,30,30
1650336720723,MATH 20C,A02,083761,Staff,0,13,30,30
1650336720723,MATH 20C,B01,083762,Staff,13,0,30,17
1650336720723,MATH 20C,B02,083763,Staff,28,0,30,2
1650336726754,MATH 20D,A01,083765,Staff,0,1,30,30
1650336726754,MATH 20D,A02,083766,Staff,7,0,30,23
1650336726754,MATH 20D,A03,083767,Staff,26,0,30,4
1650336732785,MATH 20E,A01,083771,Staff,5,0,30,25
1650336732785,MATH 20E,A02,083772,Staff,19,0,30,11
1650336732785,MATH 20E,B01,083773,Staff,0,0,30,30
1650336732785,MATH 20E,B02,083774,Staff,12,0,30,18
1650336738810,MATH 103A,A01,083777,Staff,0,12,30,30
1650336738810,MATH 103A,A02,083778,Staff,0,12,30,30
1650336738810,MATH 103A,B01,083779,Staff,0,12,30,30
1650336738810,MATH 103A,B02,083780,Staff,0,12,30,30
1650336744836,MATH 105,A01,085443,Staff,0,19,30,30
1650336750861,MATH 109,A01,083213,Anzaldo; Leesa B,0,5,30,30
1650336750861,MATH 109,A02,083214,Anzaldo; Leesa B,0,7,30,30
1650336750861,MATH 109,B01,083215,Anzaldo; Leesa B,0,5,30,30
1650336750861,MATH 109,B02,083216,Anzaldo; Leesa B,0,5,30,30
1650336756883,MATH 142A,A01,083219,Chow; Bennett,0,14,30,30
1650336756883,MATH 142A,A02,083220,Chow; Bennett,0,12,30,30
1650336756883,MATH 142A,B01,083221,Chow; Bennett,0,12,30,30
1650336756883,MATH 142A,B02,083222,Chow; Bennett,0,12,30,30
1650336762913,MATH 193A,A01,083224,Staff,0,5,30,30
1650336762913,MATH 193A,A02,083225,Staff,0,5,30,30
1650336762913,MATH 193A,A03,083781,Staff,0,4,30,30
1650336762913,MATH 193A,A04,083782,Staff,0,3,30,30
1650336768936,MATH 197,001,091859,McAuley; Julian John,9998,0,9999,1
1650336774985,COGS 9,A01,083615,Staff,0,15,60,60
1650336781006,COGS 11,A01,083617,Boyle; Mary E. T.,22,0,40,18
1650336787033,COGS 13,A01,083071,Staff,0,31,40,40
1650336793059,COGS 14A,A01,092681,Staff,0,19,100,100
1650336799081,COGS 14B,A01,083073,Cheng; Tzu-Han,0,10,50,50
1650336805104,COGS 17,A01,092677,Staff,26,0,75,49
1650336811133,COGS 100,A01,083619,Staff,0,23,60,60
1650336817156,COGS 101A,A01,083621,Davis; Joshua Daniel,1,22,60,59
1650336823183,COGS 101B,A01,091572,Staff,1,0,60,59
1650336829223,COGS 101C,A01,083625,Delgado; Tania,18,0,30,12
1650336835251,COGS 107A,A01,083627,Boyle; Mary E. T.,0,8,60,60
1650336841273,COGS 118A,A01,083075,Staff,5,0,60,55
1650336847295,CSE 3,A50,083646,Miranda; Gregory Joseph,21,0,38,17
1650336847295,CSE 3,A51,083647,Miranda; Gregory Joseph,37,0,37,0
1650336853320,CSE 8A,A50,083650,Miranda; Gregory Joseph,0,28,40,40
1650336859357,CSE 11,A01,083080,Cao; Yingjun,0,88,40,40
1650336865383,CSE 12,A01,083652,Staff,0,12,100,100
1650336871407,CSE 15L,A01,083654,Staff,0,1,50,50
1650336871407,CSE 15L,A02,083655,Staff,3,0,50,47
1650336877430,CSE 20,A01,083657,Staff,53,0,80,27
1650336883457,CSE 30,A01,083084,Eldon; John,0,76,40,40
1650336889483,CSE 100,A01,083659,Cao; Yingjun,0,66,50,50
1650336895506,CSE 134B,A01,083661,Powell; Thomas Allan,0,31,65,65
1650336901530,CSE 140,A01,083663,Staff,0,0,75,75
1650336907560,CSE 140L,A01,083088,Eldon; John,0,6,75,75
1650336913591,CSE 175,A01,083665,Kumar; Rakesh,8,0,25,17
1650336919617,CSE 190,A00,092507,Dubnov; Shlomo,14,0,20,6
1650336925644,ECE 45,A01,083139,Staff,0,17,40,40
1650336931669,ECE 65,A50,083695,Staff,0,5,30,30
1650336937698,ECE 109,A01,091882,Touri; Behrouz,40,0,70,30
1650336943726,ECE 180,A00,083140,Abi Samra; Nicholas Camill,23,0,30,7
1650336943726,ECE 180,B00,083141,Abi Samra; Nicholas Camill,5,0,30,25
1650336949752,MATH 10A,A01,083735,Patchell; Gregory David,8,0,30,22
1650336949752,MATH 10A,A02,083736,Patchell; Gregory David,28,0,30,2
1650336949752,MATH 10A,A03,083737,Patchell; Gregory David,26,0,30,4
1650336955868,MATH 10B,A01,083207,Staff,0,7,30,30
1650336955868,MATH 10B,A02,083208,Staff,0,6,30,30
1650336955868,MATH 10B,B01,083739,Staff,17,0,30,13
1650336955868,MATH 10B,B02,083740,Staff,28,0,30,2
1650336961896,MATH 18,A01,083743,Staff,4,0,30,26
1650336961896,MATH 18,A02,083744,Staff,27,0,30,3
1650336961896,MATH 18,A03,083745,Staff,22,0,30,8
1650336961896,MATH 18,A04,083746,Staff,27,0,30,3
1650336961896,MATH 18,B01,083748,Staff,0,11,30,30
1650336961896,MATH 18,B02,083749,Staff,0,11,30,30
1650336961896,MATH 18,B03,083750,Staff,1,11,30,29
1650336961896,MATH 18,B04,083751,Staff,1,11,30,29
1650336967922,MATH 20A,A01,083754,Staff,26,0,40,14
1650336973945,MATH 20B,A01,083756,Staff,0,8,30,30
1650336973945,MATH 20B,A02,083757,Staff,0,8,30,30
1650336979974,MATH 20C,A01,083760,Staff,0,13,30,30
1650336979974,MATH 20C,A02,083761,Staff,0,13,30,30
1650336979974,MATH 20C,B01,083762,Staff,13,0,30,17
1650336979974,MATH 20C,B02,083763,Staff,28,0,30,2
1650336986002,MATH 20D,A01,083765,Staff,0,1,30,30
1650336986002,MATH 20D,A02,083766,Staff,7,0,30,23
1650336986002,MATH 20D,A03,083767,Staff,26,0,30,4
1650336992026,MATH 20E,A01,083771,Staff,5,0,30,25
1650336992026,MATH 20E,A02,083772,Staff,19,0,30,11
1650336992026,MATH 20E,B01,083773,Staff,0,0,30,30
1650336992026,MATH 20E,B02,083774,Staff,12,0,30,18
1650336998049,MATH 103A,A01,083777,Staff,0,12,30,30
1650336998049,MATH 103A,A02,083778,Staff,0,12,30,30
1650336998049,MATH 103A,B01,083779,Staff,0,12,30,30
1650336998049,MATH 103A,B02,083780,Staff,0,12,30,30
1650337004080,MATH 105,A01,085443,Staff,0,19,30,30
1650337010104,MATH 109,A01,083213,Anzaldo; Leesa B,0,5,30,30
1650337010104,MATH 109,A02,083214,Anzaldo; Leesa B,0,7,30,30
1650337010104,MATH 109,B01,083215,Anzaldo; Leesa B,0,5,30,30
1650337010104,MATH 109,B02,083216,Anzaldo; Leesa B,0,5,30,30
1650337016131,MATH 142A,A01,083219,Chow; Bennett,0,14,30,30
1650337016131,MATH 142A,A02,083220,Chow; Bennett,0,12,30,30
1650337016131,MATH 142A,B01,083221,Chow; Bennett,0,12,30,30
1650337016131,MATH 142A,B02,083222,Chow; Bennett,0,12,30,30
1650337022178,MATH 193A,A01,083224,Staff,0,5,30,30
1650337022178,MATH 193A,A02,083225,Staff,0,5,30,30
1650337022178,MATH 193A,A03,083781,Staff,0,4,30,30
1650337022178,MATH 193A,A04,083782,Staff,0,3,30,30
1650337028205,MATH 197,001,091859,McAuley; Julian John,9998,0,9999,1
1650337034260,COGS 9,A01,083615,Staff,0,15,60,60
1650337040286,COGS 11,A01,083617,Boyle; Mary E. T.,22,0,40,18
1650337046312,COGS 13,A01,083071,Staff,0,31,40,40
1650337052346,COGS 14A,A01,092681,Staff,0,19,100,100
1650337058383,COGS 14B,A01,083073,Cheng; Tzu-Han,0,10,50,50
1650337064415,COGS 17,A01,092677,Staff,26,0,75,49
1650337070447,COGS 100,A01,083619,Staff,0,23,60,60
1650337076471,COGS 101A,A01,083621,Davis; Joshua Daniel,1,22,60,59
1650337082496,COGS 101B,A01,091572,Staff,1,0,60,59
1650337088522,COGS 101C,A01,083625,Delgado; Tania,18,0,30,12
1650337094546,COGS 107A,A01,083627,Boyle; Mary E. T.,0,8,60,60
1650337100569,COGS 118A,A01,083075,Staff,5,0,60,55
1650337106593,CSE 3,A50,083646,Miranda; Gregory Joseph,21,0,38,17
1650337106593,CSE 3,A51,083647,Miranda; Gregory Joseph,37,0,37,0
1650337112620,CSE 8A,A50,083650,Miranda; Gregory Joseph,0,28,40,40
1650337118651,CSE 11,A01,083080,Cao; Yingjun,0,88,40,40
1650337124681,CSE 12,A01,083652,Staff,0,12,100,100
1650337130710,CSE 15L,A01,083654,Staff,0,1,50,50
1650337130710,CSE 15L,A02,083655,Staff,3,0,50,47
1650337136735,CSE 20,A01,083657,Staff,53,0,80,27
1650337142759,CSE 30,A01,083084,Eldon; John,0,76,40,40
1650337148781,CSE 100,A01,083659,Cao; Yingjun,0,66,50,50
1650337154804,CSE 134B,A01,083661,Powell; Thomas Allan,0,31,65,65
1650337160831,CSE 140,A01,083663,Staff,0,0,75,75
1650337166868,CSE 140L,A01,083088,Eldon; John,0,6,75,75
1650337172894,CSE 175,A01,083665,Kumar; Rakesh,8,0,25,17
1650337178917,CSE 190,A00,092507,Dubnov; Shlomo,14,0,20,6
1650337184941,ECE 45,A01,083139,Staff,0,17,40,40
1650337190964,ECE 65,A50,083695,Staff,0,5,30,30
1650337196987,ECE 109,A01,091882,Touri; Behrouz,40,0,70,30
1650337203010,ECE 180,A00,083140,Abi Samra; Nicholas Camill,23,0,30,7
1650337203010,ECE 180,B00,083141,Abi Samra; Nicholas Camill,5,0,30,25
1650337209033,MATH 10A,A01,083735,Patchell; Gregory David,8,0,30,22
1650337209033,MATH 10A,A02,083736,Patchell; Gregory David,28,0,30,2
1650337209033,MATH 10A,A03,083737,Patchell; Gregory David,26,0,30,4
1650337215057,MATH 10B,A01,083207,Staff,0,7,30,30
1650337215057,MATH 10B,A02,083208,Staff,0,6,30,30
1650337215057,MATH 10B,B01,083739,Staff,17,0,30,13
1650337215057,MATH 10B,B02,083740,Staff,28,0,30,2
1650337221081,MATH 18,A01,083743,Staff,4,0,30,26
1650337221081,MATH 18,A02,083744,Staff,27,0,30,3
1650337221081,MATH 18,A03,083745,Staff,22,0,30,8
1650337221081,MATH 18,A04,083746,Staff,27,0,30,3
1650337221081,MATH 18,B01,083748,Staff,0,11,30,30
1650337221081,MATH 18,B02,083749,Staff,0,11,30,30
1650337221081,MATH 18,B03,083750,Staff,1,11,30,29
1650337221081,MATH 18,B04,083751,Staff,1,11,30,29
1650337227104,MATH 20A,A01,083754,Staff,26,0,40,14
1650337233130,MATH 20B,A01,083756,Staff,0,8,30,30
1650337233130,MATH 20B,A02,083757,Staff,0,8,30,30
1650337239157,MATH 20C,A01,083760,Staff,0,13,30,30
1650337239157,MATH 20C,A02,083761,Staff,0,13,30,30
1650337239157,MATH 20C,B01,083762,Staff,13,0,30,17
1650337239157,MATH 20C,B02,083763,Staff,28,0,30,2
1650337245181,MATH 20D,A01,083765,Staff,0,1,30,30
1650337245181,MATH 20D,A02,083766,Staff,7,0,30,23
1650337245181,MATH 20D,A03,083767,Staff,26,0,30,4
1650337251205,MATH 20E,A01,083771,Staff,5,0,30,25
1650337251205,MATH 20E,A02,083772,Staff,19,0,30,11
1650337251205,MATH 20E,B01,083773,Staff,0,0,30,30
1650337251205,MATH 20E,B02,083774,Staff,12,0,30,18
1650337257232,MATH 103A,A01,083777,Staff,0,12,30,30
1650337257232,MATH 103A,A02,083778,Staff,0,12,30,30
1650337257232,MATH 103A,B01,083779,Staff,0,12,30,30
1650337257232,MATH 103A,B02,083780,Staff,0,12,30,30
1650337263256,MATH 105,A01,085443,Staff,0,19,30,30
1650337269297,MATH 109,A01,083213,Anzaldo; Leesa B,0,5,30,30
1650337269297,MATH 109,A02,083214,Anzaldo; Leesa B,0,7,30,30
1650337269297,MATH 109,B01,083215,Anzaldo; Leesa B,0,5,30,30
1650337269297,MATH 109,B02,083216,Anzaldo; Leesa B,0,5,30,30
1650337275324,MATH 142A,A01,083219,Chow; Bennett,0,14,30,30
1650337275324,MATH 142A,A02,083220,Chow; Bennett,0,12,30,30
1650337275324,MATH 142A,B01,083221,Chow; Bennett,0,12,30,30
1650337275324,MATH 142A,B02,083222,Chow; Bennett,0,12,30,30
1650337281354,MATH 193A,A01,083224,Staff,0,5,30,30
1650337281354,MATH 193A,A02,083225,Staff,0,5,30,30
1650337281354,MATH 193A,A03,083781,Staff,0,4,30,30
1650337281354,MATH 193A,A04,083782,Staff,0,3,30,30
1650337287389,MATH 197,001,091859,McAuley; Julian John,9998,0,9999,1
1650337293442,COGS 9,A01,083615,Staff,0,15,60,60
1650337299469,COGS 11,A01,083617,Boyle; Mary E. T.,22,0,40,18
1650337305499,COGS 13,A01,083071,Staff,0,31,40,40
1650337311523,COGS 14A,A01,092681,Staff,0,19,100,100
1650337317548,COGS 14B,A01,083073,Cheng; Tzu-Han,0,10,50,50
1650337323576,COGS 17,A01,092677,Staff,26,0,75,49
1650337329603,COGS 100,A01,083619,Staff,0,23,60,60
1650337335626,COGS 101A,A01,083621,Davis; Joshua Daniel,1,22,60,59
1650337341649,COGS 101B,A01,091572,Staff,1,0,60,59
1650337347672,COGS 101C,A01,083625,Delgado; Tania,18,0,30,12
1650337353696,COGS 107A,A01,083627,Boyle; Mary E. T.,0,8,60,60
1650337359723,COGS 118A,A01,083075,Staff,5,0,60,55
1650337365747,CSE 3,A50,083646,Miranda; Gregory Joseph,21,0,38,17
1650337365747,CSE 3,A51,083647,Miranda; Gregory Joseph,37,0,37,0
1650337371774,CSE 8A,A50,083650,Miranda; Gregory Joseph,0,28,40,40
1650337377797,CSE 11,A01,083080,Cao; Yingjun,0,88,40,40
1650337383821,CSE 12,A01,083652,Staff,0,12,100,100
1650337389845,CSE 15L,A01,083654,Staff,0,1,50,50
1650337389845,CSE 15L,A02,083655,Staff,3,0,50,47
1650337395872,CSE 20,A01,083657,Staff,53,0,80,27
1650337401901,CSE 30,A01,083084,Eldon; John,0,76,40,40
1650337407928,CSE 100,A01,083659,Cao; Yingjun,0,66,50,50
1650337413956,CSE 134B,A01,083661,Powell; Thomas Allan,0,31,65,65
1650337419985,CSE 140,A01,083663,Staff,0,0,75,75
1650337426012,CSE 140L,A01,083088,Eldon; John,0,6,75,75
1650337432035,CSE 175,A01,083665,Kumar; Rakesh,8,0,25,17
1650337438064,CSE 190,A00,092507,Dubnov; Shlomo,14,0,20,6
1650337444088,ECE 45,A01,083139,Staff,0,17,40,40
1650337450115,ECE 65,A50,083695,Staff,0,5,30,30
1650337456161,ECE 109,A01,091882,Touri; Behrouz,40,0,70,30
1650337462185,ECE 180,A00,083140,Abi Samra; Nicholas Camill,23,0,30,7
1650337462185,ECE 180,B00,083141,Abi Samra; Nicholas Camill,5,0,30,25
1650337468221,MATH 10A,A01,083735,Patchell; Gregory David,8,0,30,22
1650337468221,MATH 10A,A02,083736,Patchell; Gregory David,28,0,30,2
1650337468221,MATH 10A,A03,083737,Patchell; Gregory David,26,0,30,4
1650337474254,MATH 10B,A01,083207,Staff,0,7,30,30
1650337474254,MATH 10B,A02,083208,Staff,0,6,30,30
1650337474254,MATH 10B,B01,083739,Staff,17,0,30,13
1650337474254,MATH 10B,B02,083740,Staff,28,0,30,2
1650337480281,MATH 18,A01,083743,Staff,4,0,30,26
1650337480281,MATH 18,A02,083744,Staff,27,0,30,3
1650337480281,MATH 18,A03,083745,Staff,22,0,30,8
1650337480281,MATH 18,A04,083746,Staff,27,0,30,3
1650337480281,MATH 18,B01,083748,Staff,0,11,30,30
1650337480281,MATH 18,B02,083749,Staff,0,11,30,30
1650337480281,MATH 18,B03,083750,Staff,1,11,30,29
1650337480281,MATH 18,B04,083751,Staff,1,11,30,29
1650337486307,MATH 20A,A01,083754,Staff,26,0,40,14
1650337492335,MATH 20B,A01,083756,Staff,0,8,30,30
1650337492335,MATH 20B,A02,083757,Staff,0,8,30,30
1650337498359,MATH 20C,A01,083760,Staff,0,13,30,30
1650337498359,MATH 20C,A02,083761,Staff,0,13,30,30
1650337498359,MATH 20C,B01,083762,Staff,13,0,30,17
1650337498359,MATH 20C,B02,083763,Staff,28,0,30,2
1650337504386,MATH 20D,A01,083765,Staff,0,1,30,30
1650337504386,MATH 20D,A02,083766,Staff,7,0,30,23
1650337504386,MATH 20D,A03,083767,Staff,26,0,30,4
1650337510414,MATH 20E,A01,083771,Staff,5,0,30,25
1650337510414,MATH 20E,A02,083772,Staff,19,0,30,11
1650337510414,MATH 20E,B01,083773,Staff,0,0,30,30
1650337510414,MATH 20E,B02,083774,Staff,12,0,30,18
1650337516438,MATH 103A,A01,083777,Staff,0,12,30,30
1650337516438,MATH 103A,A02,083778,Staff,0,12,30,30
1650337516438,MATH 103A,B01,083779,Staff,0,12,30,30
1650337516438,MATH 103A,B02,083780,Staff,0,12,30,30
1650337522466,MATH 105,A01,085443,Staff,0,19,30,30
1650337528506,MATH 109,A01,083213,Anzaldo; Leesa B,0,5,30,30
1650337528506,MATH 109,A02,083214,Anzaldo; Leesa B,0,7,30,30
1650337528506,MATH 109,B01,083215,Anzaldo; Leesa B,0,5,30,30
1650337528506,MATH 109,B02,083216,Anzaldo; Leesa B,0,5,30,30
1650337534537,MATH 142A,A01,083219,Chow; Bennett,0,14,30,30
1650337534537,MATH 142A,A02,083220,Chow; Bennett,0,12,30,30
1650337534537,MATH 142A,B01,083221,Chow; Bennett,0,12,30,30
1650337534537,MATH 142A,B02,083222,Chow; Bennett,0,12,30,30
1650337540566,MATH 193A,A01,083224,Staff,0,5,30,30
1650337540566,MATH 193A,A02,083225,Staff,0,5,30,30
1650337540566,MATH 193A,A03,083781,Staff,0,4,30,30
1650337540566,MATH 193A,A04,083782,Staff,0,3,30,30
1650337546594,MATH 197,001,091859,McAuley; Julian John,9998,0,9999,1
1650337552730,COGS 9,A01,083615,Staff,0,15,60,60
1650337558754,COGS 11,A01,083617,Boyle; Mary E. T.,22,0,40,18
1650337564779,COGS 13,A01,083071,Staff,0,31,40,40
1650337570807,COGS 14A,A01,092681,Staff,0,19,100,100
1650337576830,COGS 14B,A01,083073,Cheng; Tzu-Han,0,10,50,50
1650337582855,COGS 17,A01,092677,Staff,26,0,75,49
1650337588881,COGS 100,A01,083619,Staff,0,23,60,60
1650337594905,COGS 101A,A01,083621,Davis; Joshua Daniel,1,22,60,59
1650337600929,COGS 101B,A01,091572,Staff,1,0,60,59
1650337606956,COGS 101C,A01,083625,Delgado; Tania,18,0,30,12
1650337612980,COGS 107A,A01,083627,Boyle; Mary E. T.,0,8,60,60
1650337619002,COGS 118A,A01,083075,Staff,5,0,60,55
1650337625029,CSE 3,A50,083646,Miranda; Gregory Joseph,21,0,38,17
1650337625029,CSE 3,A51,083647,Miranda; Gregory Joseph,37,0,37,0
1650337631058,CSE 8A,A50,083650,Miranda; Gregory Joseph,0,28,40,40
1650337637091,CSE 11,A01,083080,Cao; Yingjun,0,88,40,40
1650337643116,CSE 12,A01,083652,Staff,0,12,100,100
1650337649137,CSE 15L,A01,083654,Staff,0,1,50,50
1650337649137,CSE 15L,A02,083655,Staff,3,0,50,47
1650337655163,CSE 20,A01,083657,Staff,53,0,80,27
1650337661193,CSE 30,A01,083084,Eldon; John,0,76,40,40
1650337667218,CSE 100,A01,083659,Cao; Yingjun,0,66,50,50
1650337673242,CSE 134B,A01,083661,Powell; Thomas Allan,0,31,65,65
1650337679265,CSE 140,A01,083663,Staff,0,0,75,75
1650337685291,CSE 140L,A01,083088,Eldon; John,0,6,75,75
1650337691318,CSE 175,A01,083665,Kumar; Rakesh,8,0,25,17
1650337697345,CSE 190,A00,092507,Dubnov; Shlomo,14,0,20,6
1650337703372,ECE 45,A01,083139,Staff,0,17,40,40
1650337709396,ECE 65,A50,083695,Staff,0,5,30,30
1650337715419,ECE 109,A01,091882,Touri; Behrouz,40,0,70,30
1650337721443,ECE 180,A00,083140,Abi Samra; Nicholas Camill,23,0,30,7
1650337721443,ECE 180,B00,083141,Abi Samra; Nicholas Camill,5,0,30,25
1650337727467,MATH 10A,A01,083735,Patchell; Gregory David,8,0,30,22
1650337727467,MATH 10A,A02,083736,Patchell; Gregory David,28,0,30,2
1650337727467,MATH 10A,A03,083737,Patchell; Gregory David,26,0,30,4
1650337733497,MATH 10B,A01,083207,Staff,0,7,30,30
1650337733497,MATH 10B,A02,083208,Staff,0,6,30,30
1650337733497,MATH 10B,B01,083739,Staff,17,0,30,13
1650337733497,MATH 10B,B02,083740,Staff,28,0,30,2
1650337739527,MATH 18,A01,083743,Staff,4,0,30,26
1650337739527,MATH 18,A02,083744,Staff,27,0,30,3
1650337739527,MATH 18,A03,083745,Staff,22,0,30,8
1650337739527,MATH 18,A04,083746,Staff,27,0,30,3
1650337739527,MATH 18,B01,083748,Staff,0,11,30,30
1650337739527,MATH 18,B02,083749,Staff,0,11,30,30
1650337739527,MATH 18,B03,083750,Staff,1,11,30,29
1650337739527,MATH 18,B04,083751,Staff,1,11,30,29
1650337745550,MATH 20A,A01,083754,Staff,26,0,40,14
1650337751582,MATH 20B,A01,083756,Staff,0,8,30,30
1650337751582,MATH 20B,A02,083757,Staff,0,8,30,30
1650337757611,MATH 20C,A01,083760,Staff,0,13,30,30
1650337757611,MATH 20C,A02,083761,Staff,0,13,30,30
1650337757611,MATH 20C,B01,083762,Staff,13,0,30,17
1650337757611,MATH 20C,B02,083763,Staff,28,0,30,2
1650337763635,MATH 20D,A01,083765,Staff,0,1,30,30
1650337763635,MATH 20D,A02,083766,Staff,7,0,30,23
1650337763635,MATH 20D,A03,083767,Staff,26,0,30,4
1650337769663,MATH 20E,A01,083771,Staff,5,0,30,25
1650337769663,MATH 20E,A02,083772,Staff,19,0,30,11
1650337769663,MATH 20E,B01,083773,Staff,0,0,30,30
1650337769663,MATH 20E,B02,083774,Staff,12,0,30,18
1650337775689,MATH 103A,A01,083777,Staff,0,12,30,30
1650337775689,MATH 103A,A02,083778,Staff,0,12,30,30
1650337775689,MATH 103A,B01,083779,Staff,0,12,30,30
1650337775689,MATH 103A,B02,083780,Staff,0,12,30,30
1650337781718,MATH 105,A01,085443,Staff,0,19,30,30
1650337787747,MATH 109,A01,083213,Anzaldo; Leesa B,0,5,30,30
1650337787747,MATH 109,A02,083214,Anzaldo; Leesa B,0,7,30,30
1650337787747,MATH 109,B01,083215,Anzaldo; Leesa B,0,5,30,30
1650337787747,MATH 109,B02,083216,Anzaldo; Leesa B,0,5,30,30
1650337793772,MATH 142A,A01,083219,Chow; Bennett,0,14,30,30
1650337793772,MATH 142A,A02,083220,Chow; Bennett,0,12,30,30
1650337793772,MATH 142A,B01,083221,Chow; Bennett,0,12,30,30
1650337793772,MATH 142A,B02,083222,Chow; Bennett,0,12,30,30
1650337799799,MATH 193A,A01,083224,Staff,0,5,30,30
1650337799799,MATH 193A,A02,083225,Staff,0,5,30,30
1650337799799,MATH 193A,A03,083781,Staff,0,4,30,30
1650337799799,MATH 193A,A04,083782,Staff,0,3,30,30
1650337805825,MATH 197,001,091859,McAuley; Julian John,9998,0,9999,1
1650337811882,COGS 9,A01,083615,Staff,0,15,60,60
1650337817909,COGS 11,A01,083617,Boyle; Mary E. T.,22,0,40,18
1650337823933,COGS 13,A01,083071,Staff,0,31,40,40
1650337829956,COGS 14A,A01,092681,Staff,0,19,100,100
1650337835987,COGS 14B,A01,083073,Cheng; Tzu-Han,0,10,50,50
1650337842012,COGS 17,A01,092677,Staff,25,0,75,50
1650337848038,COGS 100,A01,083619,Staff,0,23,60,60
1650337854063,COGS 101A,A01,083621,Davis; Joshua Daniel,1,22,60,59
1650337860086,COGS 101B,A01,091572,Staff,1,0,60,59
1650337866111,COGS 101C,A01,083625,Delgado; Tania,18,0,30,12
1650337872137,COGS 107A,A01,083627,Boyle; Mary E. T.,0,8,60,60
1650337878160,COGS 118A,A01,083075,Staff,5,0,60,55
1650337884184,CSE 3,A50,083646,Miranda; Gregory Joseph,21,0,38,17
1650337884184,CSE 3,A51,083647,Miranda; Gregory Joseph,37,0,37,0
1650337890211,CSE 8A,A50,083650,Miranda; Gregory Joseph,0,28,40,40
1650337896235,CSE 11,A01,083080,Cao; Yingjun,0,88,40,40
1650337902261,CSE 12,A01,083652,Staff,0,12,100,100
1650337908289,CSE 15L,A01,083654,Staff,0,1,50,50
1650337908289,CSE 15L,A02,083655,Staff,3,0,50,47
1650337914310,CSE 20,A01,083657,Staff,53,0,80,27
1650337920334,CSE 30,A01,083084,Eldon; John,0,76,40,40
1650337926357,CSE 100,A01,083659,Cao; Yingjun,0,66,50,50
1650337932384,CSE 134B,A01,083661,Powell; Thomas Allan,0,31,65,65
1650337938419,CSE 140,A01,083663,Staff,0,0,75,75
1650337944446,CSE 140L,A01,083088,Eldon; John,0,6,75,75
1650337950478,CSE 175,A01,083665,Kumar; Rakesh,8,0,25,17
1650337956504,CSE 190,A00,092507,Dubnov; Shlomo,14,0,20,6
1650337962527,ECE 45,A01,083139,Staff,0,17,40,40
1650337968549,ECE 65,A50,083695,Staff,0,5,30,30
1650337974572,ECE 109,A01,091882,Touri; Behrouz,40,0,70,30
1650337980598,ECE 180,A00,083140,Abi Samra; Nicholas Camill,23,0,30,7
1650337980598,ECE 180,B00,083141,Abi Samra; Nicholas Camill,5,0,30,25
1650337986621,MATH 10A,A01,083735,Patchell; Gregory David,8,0,30,22
1650337986621,MATH 10A,A02,083736,Patchell; Gregory David,28,0,30,2
1650337986621,MATH 10A,A03,083737,Patchell; Gregory David,26,0,30,4
1650337992642,MATH 10B,A01,083207,Staff,0,7,30,30
1650337992642,MATH 10B,A02,083208,Staff,0,6,30,30
1650337992642,MATH 10B,B01,083739,Staff,17,0,30,13
1650337992642,MATH 10B,B02,083740,Staff,28,0,30,2
1650337998668,MATH 18,A01,083743,Staff,4,0,30,26
1650337998668,MATH 18,A02,083744,Staff,27,0,30,3
1650337998668,MATH 18,A03,083745,Staff,22,0,30,8
1650337998668,MATH 18,A04,083746,Staff,27,0,30,3
1650337998668,MATH 18,B01,083748,Staff,0,11,30,30
1650337998668,MATH 18,B02,083749,Staff,0,11,30,30
1650337998668,MATH 18,B03,083750,Staff,1,11,30,29
1650337998668,MATH 18,B04,083751,Staff,1,11,30,29
1650338004694,MATH 20A,A01,083754,Staff,26,0,40,14
1650338010720,MATH 20B,A01,083756,Staff,0,8,30,30
1650338010720,MATH 20B,A02,083757,Staff,0,8,30,30
1650338016744,MATH 20C,A01,083760,Staff,0,13,30,30
1650338016744,MATH 20C,A02,083761,Staff,0,13,30,30
1650338016744,MATH 20C,B01,083762,Staff,13,0,30,17
1650338016744,MATH 20C,B02,083763,Staff,28,0,30,2
1650338022767,MATH 20D,A01,083765,Staff,0,1,30,30
1650338022767,MATH 20D,A02,083766,Staff,7,0,30,23
1650338022767,MATH 20D,A03,083767,Staff,26,0,30,4
1650338028793,MATH 20E,A01,083771,Staff,5,0,30,25
1650338028793,MATH 20E,A02,083772,Staff,19,0,30,11
1650338028793,MATH 20E,B01,083773,Staff,0,0,30,30
1650338028793,MATH 20E,B02,083774,Staff,12,0,30,18
1650338034817,MATH 103A,A01,083777,Staff,0,12,30,30
1650338034817,MATH 103A,A02,083778,Staff,0,12,30,30
1650338034817,MATH 103A,B01,083779,Staff,0,13,30,30
1650338034817,MATH 103A,B02,083780,Staff,0,12,30,30
1650338040844,MATH 105,A01,085443,Staff,0,19,30,30
1650338046867,MATH 109,A01,083213,Anzaldo; Leesa B,0,5,30,30
1650338046867,MATH 109,A02,083214,Anzaldo; Leesa B,0,7,30,30
1650338046867,MATH 109,B01,083215,Anzaldo; Leesa B,0,5,30,30
1650338046867,MATH 109,B02,083216,Anzaldo; Leesa B,0,5,30,30
1650338052895,MATH 142A,A01,083219,Chow; Bennett,0,14,30,30
1650338052895,MATH 142A,A02,083220,Chow; Bennett,0,12,30,30
1650338052895,MATH 142A,B01,083221,Chow; Bennett,0,12,30,30
1650338052895,MATH 142A,B02,083222,Chow; Bennett,0,12,30,30
1650338058919,MATH 193A,A01,083224,Staff,0,5,30,30
1650338058919,MATH 193A,A02,083225,Staff,0,5,30,30
1650338058919,MATH 193A,A03,083781,Staff,0,4,30,30
1650338058919,MATH 193A,A04,083782,Staff,0,3,30,30
1650338064949,MATH 197,001,091859,McAuley; Julian John,9998,0,9999,1
1650338071000,COGS 9,A01,083615,Staff,0,15,60,60
1650338077024,COGS 11,A01,083617,Boyle; Mary E. T.,22,0,40,18
1650338083048,COGS 13,A01,083071,Staff,0,31,40,40
1650338089072,COGS 14A,A01,092681,Staff,0,19,100,100
1650338095108,COGS 14B,A01,083073,Cheng; Tzu-Han,0,10,50,50
1650338101143,COGS 17,A01,092677,Staff,25,0,75,50
1650338107168,COGS 100,A01,083619,Staff,0,23,60,60
1650338113195,COGS 101A,A01,083621,Davis; Joshua Daniel,1,22,60,59
1650338119219,COGS 101B,A01,091572,Staff,1,0,60,59
1650338125244,COGS 101C,A01,083625,Delgado; Tania,18,0,30,12
1650338131270,COGS 107A,A01,083627,Boyle; Mary E. T.,0,8,60,60
1650338137295,COGS 118A,A01,083075,Staff,5,0,60,55
1650338143409,CSE 3,A50,083646,Miranda; Gregory Joseph,21,0,38,17
1650338143409,CSE 3,A51,083647,Miranda; Gregory Joseph,37,0,37,0
1650338149434,CSE 8A,A50,083650,Miranda; Gregory Joseph,0,28,40,40
1650338155462,CSE 11,A01,083080,Cao; Yingjun,0,88,40,40
1650338161489,CSE 12,A01,083652,Staff,0,12,100,100
1650338167516,CSE 15L,A01,083654,Staff,0,1,50,50
1650338167516,CSE 15L,A02,083655,Staff,3,0,50,47
1650338173539,CSE 20,A01,083657,Staff,53,0,80,27
1650338179578,CSE 30,A01,083084,Eldon; John,0,76,40,40
1650338185600,CSE 100,A01,083659,Cao; Yingjun,0,66,50,50
1650338191632,CSE 134B,A01,083661,Powell; Thomas Allan,0,31,65,65
1650338197661,CSE 140,A01,083663,Staff,0,0,75,75
1650338203684,CSE 140L,A01,083088,Eldon; John,0,6,75,75
1650338209715,CSE 175,A01,083665,Kumar; Rakesh,8,0,25,17
1650338215738,CSE 190,A00,092507,Dubnov; Shlomo,14,0,20,6
1650338221765,ECE 45,A01,083139,Staff,0,17,40,40
1650338227792,ECE 65,A50,083695,Staff,0,5,30,30
1650338233816,ECE 109,A01,091882,Touri; Behrouz,40,0,70,30
1650338239840,ECE 180,A00,083140,Abi Samra; Nicholas Camill,23,0,30,7
1650338239840,ECE 180,B00,083141,Abi Samra; Nicholas Camill,5,0,30,25
1650338245867,MATH 10A,A01,083735,Patchell; Gregory David,8,0,30,22
1650338245867,MATH 10A,A02,083736,Patchell; Gregory David,28,0,30,2
1650338245867,MATH 10A,A03,083737,Patchell; Gregory David,26,0,30,4
1650338251893,MATH 10B,A01,083207,Staff,0,7,30,30
1650338251893,MATH 10B,A02,083208,Staff,0,6,30,30
1650338251893,MATH 10B,B01,083739,Staff,17,0,30,13
1650338251893,MATH 10B,B02,083740,Staff,28,0,30,2
1650338257923,MATH 18,A01,083743,Staff,4,0,30,26
1650338257923,MATH 18,A02,083744,Staff,27,0,30,3
1650338257923,MATH 18,A03,083745,Staff,22,0,30,8
1650338257923,MATH 18,A04,083746,Staff,27,0,30,3
1650338257923,MATH 18,B01,083748,Staff,0,11,30,30
1650338257923,MATH 18,B02,083749,Staff,0,11,30,30
1650338257923,MATH 18,B03,083750,Staff,1,11,30,29
1650338257923,MATH 18,B04,083751,Staff,1,11,30,29
1650338263953,MATH 20A,A01,083754,Staff,26,0,40,14
1650338269979,MATH 20B,A01,083756,Staff,0,8,30,30
1650338269979,MATH 20B,A02,083757,Staff,0,8,30,30
1650338276003,MATH 20C,A01,083760,Staff,0,13,30,30
1650338276003,MATH 20C,A02,083761,Staff,0,13,30,30
1650338276003,MATH 20C,B01,083762,Staff,13,0,30,17
1650338276003,MATH 20C,B02,083763,Staff,28,0,30,2
1650338282031,MATH 20D,A01,083765,Staff,0,1,30,30
1650338282031,MATH 20D,A02,083766,Staff,7,0,30,23
1650338282031,MATH 20D,A03,083767,Staff,26,0,30,4
1650338288055,MATH 20E,A01,083771,Staff,5,0,30,25
1650338288055,MATH 20E,A02,083772,Staff,19,0,30,11
1650338288055,MATH 20E,B01,083773,Staff,0,0,30,30
1650338288055,MATH 20E,B02,083774,Staff,12,0,30,18
1650338294086,MATH 103A,A01,083777,Staff,0,12,30,30
1650338294086,MATH 103A,A02,083778,Staff,0,12,30,30
1650338294086,MATH 103A,B01,083779,Staff,0,13,30,30
1650338294086,MATH 103A,B02,083780,Staff,0,12,30,30
1650338300110,MATH 105,A01,085443,Staff,0,20,30,30
1650338306139,MATH 109,A01,083213,Anzaldo; Leesa B,0,5,30,30
1650338306139,MATH 109,A02,083214,Anzaldo; Leesa B,0,7,30,30
1650338306139,MATH 109,B01,083215,Anzaldo; Leesa B,0,5,30,30
1650338306139,MATH 109,B02,083216,Anzaldo; Leesa B,0,5,30,30
1650338312163,MATH 142A,A01,083219,Chow; Bennett,0,14,30,30
1650338312163,MATH 142A,A02,083220,Chow; Bennett,0,12,30,30
1650338312163,MATH 142A,B01,083221,Chow; Bennett,0,12,30,30
1650338312163,MATH 142A,B02,083222,Chow; Bennett,0,12,30,30
1650338318186,MATH 193A,A01,083224,Staff,0,5,30,30
1650338318186,MATH 193A,A02,083225,Staff,0,5,30,30
1650338318186,MATH 193A,A03,083781,Staff,0,4,30,30
1650338318186,MATH 193A,A04,083782,Staff,0,3,30,30
1650338324210,MATH 197,001,091859,McAuley; Julian John,9998,0,9999,1
1650338330268,COGS 9,A01,083615,Staff,0,15,60,60
1650338336296,COGS 11,A01,083617,Boyle; Mary E. T.,22,0,40,18
1650338342318,COGS 13,A01,083071,Staff,0,31,40,40
1650338348343,COGS 14A,A01,092681,Staff,0,19,100,100
1650338354374,COGS 14B,A01,083073,Cheng; Tzu-Han,0,10,50,50
1650338360399,COGS 17,A01,092677,Staff,25,0,75,50
1650338366422,COGS 100,A01,083619,Staff,0,23,60,60
1650338372445,COGS 101A,A01,083621,Davis; Joshua Daniel,1,22,60,59
1650338378468,COGS 101B,A01,091572,Staff,1,0,60,59
1650338384494,COGS 101C,A01,083625,Delgado; Tania,18,0,30,12
1650338390517,COGS 107A,A01,083627,Boyle; Mary E. T.,0,8,60,60
1650338405597,COGS 118A,A01,083075,Staff,5,0,60,55
1650338411632,CSE 3,A50,083646,Miranda; Gregory Joseph,21,0,38,17
1650338411632,CSE 3,A51,083647,Miranda; Gregory Joseph,37,0,37,0
1650338417662,CSE 8A,A50,083650,Miranda; Gregory Joseph,0,28,40,40
1650338423685,CSE 11,A01,083080,Cao; Yingjun,0,88,40,40
1650338429711,CSE 12,A01,083652,Staff,0,12,100,100
1650338435734,CSE 15L,A01,083654,Staff,0,1,50,50
1650338435734,CSE 15L,A02,083655,Staff,3,0,50,47
1650338441760,CSE 20,A01,083657,Staff,53,0,80,27
1650338447783,CSE 30,A01,083084,Eldon; John,0,76,40,40
1650338453807,CSE 100,A01,083659,Cao; Yingjun,0,66,50,50
1650338459831,CSE 134B,A01,083661,Powell; Thomas Allan,0,31,65,65
1650338465854,CSE 140,A01,083663,Staff,0,0,75,75
1650338471883,CSE 140L,A01,083088,Eldon; John,0,6,75,75
1650338477907,CSE 175,A01,083665,Kumar; Rakesh,8,0,25,17
1650338483931,CSE 190,A00,092507,Dubnov; Shlomo,14,0,20,6
1650338489957,ECE 45,A01,083139,Staff,0,17,40,40
1650338495982,ECE 65,A50,083695,Staff,0,5,30,30
1650338502014,ECE 109,A01,091882,Touri; Behrouz,40,0,70,30
1650338508037,ECE 180,A00,083140,Abi Samra; Nicholas Camill,23,0,30,7
1650338508037,ECE 180,B00,083141,Abi Samra; Nicholas Camill,5,0,30,25
1650338514064,MATH 10A,A01,083735,Patchell; Gregory David,8,0,30,22
1650338514064,MATH 10A,A02,083736,Patchell; Gregory David,28,0,30,2
1650338514064,MATH 10A,A03,083737,Patchell; Gregory David,26,0,30,4
1650338520092,MATH 10B,A01,083207,Staff,0,7,30,30
1650338520092,MATH 10B,A02,083208,Staff,0,6,30,30
1650338520092,MATH 10B,B01,083739,Staff,17,0,30,13
1650338520092,MATH 10B,B02,083740,Staff,28,0,30,2
1650338526120,MATH 18,A01,083743,Staff,4,0,30,26
1650338526120,MATH 18,A02,083744,Staff,27,0,30,3
1650338526120,MATH 18,A03,083745,Staff,22,0,30,8
1650338526120,MATH 18,A04,083746,Staff,27,0,30,3
1650338526120,MATH 18,B01,083748,Staff,0,11,30,30
1650338526120,MATH 18,B02,083749,Staff,0,11,30,30
1650338526120,MATH 18,B03,083750,Staff,1,11,30,29
1650338526120,MATH 18,B04,083751,Staff,1,11,30,29
1650338532144,MATH 20A,A01,083754,Staff,26,0,40,14
1650338538173,MATH 20B,A01,083756,Staff,0,8,30,30
1650338538173,MATH 20B,A02,083757,Staff,0,8,30,30
1650338544202,MATH 20C,A01,083760,Staff,0,13,30,30
1650338544202,MATH 20C,A02,083761,Staff,0,13,30,30
1650338544202,MATH 20C,B01,083762,Staff,13,0,30,17
1650338544202,MATH 20C,B02,083763,Staff,28,0,30,2
1650338550229,MATH 20D,A01,083765,Staff,0,1,30,30
1650338550229,MATH 20D,A02,083766,Staff,7,0,30,23
1650338550229,MATH 20D,A03,083767,Staff,26,0,30,4
1650338556255,MATH 20E,A01,083771,Staff,5,0,30,25
1650338556255,MATH 20E,A02,083772,Staff,19,0,30,11
1650338556255,MATH 20E,B01,083773,Staff,0,0,30,30
1650338556255,MATH 20E,B02,083774,Staff,12,0,30,18
1650338562285,MATH 103A,A01,083777,Staff,0,12,30,30
1650338562285,MATH 103A,A02,083778,Staff,0,12,30,30
1650338562285,MATH 103A,B01,083779,Staff,0,13,30,30
1650338562285,MATH 103A,B02,083780,Staff,0,12,30,30
1650338568309,MATH 105,A01,085443,Staff,0,21,30,30
1650338574333,MATH 109,A01,083213,Anzaldo; Leesa B,0,5,30,30
1650338574333,MATH 109,A02,083214,Anzaldo; Leesa B,0,7,30,30
1650338574333,MATH 109,B01,083215,Anzaldo; Leesa B,0,5,30,30
1650338574333,MATH 109,B02,083216,Anzaldo; Leesa B,0,5,30,30
1650338580358,MATH 142A,A01,083219,Chow; Bennett,0,14,30,30
1650338580358,MATH 142A,A02,083220,Chow; Bennett,0,12,30,30
1650338580358,MATH 142A,B01,083221,Chow; Bennett,0,12,30,30
1650338580358,MATH 142A,B02,083222,Chow; Bennett,0,12,30,30
1650338586382,MATH 193A,A01,083224,Staff,0,5,30,30
1650338586382,MATH 193A,A02,083225,Staff,0,5,30,30
1650338586382,MATH 193A,A03,083781,Staff,0,4,30,30
1650338586382,MATH 193A,A04,083782,Staff,0,3,30,30
1650338592412,MATH 197,001,091859,McAuley; Julian John,9998,0,9999,1
1650338598458,COGS 9,A01,083615,Staff,0,15,60,60
1650338604481,COGS 11,A01,083617,Boyle; Mary E. T.,22,0,40,18
1650338610503,COGS 13,A01,083071,Staff,0,31,40,40
1650338616525,COGS 14A,A01,092681,Staff,0,19,100,100
1650338622574,COGS 14B,A01,083073,Cheng; Tzu-Han,0,10,50,50
1650338628597,COGS 17,A01,092677,Staff,25,0,75,50
1650338634620,COGS 100,A01,083619,Staff,0,23,60,60
1650338640645,COGS 101A,A01,083621,Davis; Joshua Daniel,1,22,60,59
1650338646671,COGS 101B,A01,091572,Staff,1,0,60,59
1650338652696,COGS 101C,A01,083625,Delgado; Tania,18,0,30,12
1650338658725,COGS 107A,A01,083627,Boyle; Mary E. T.,0,8,60,60
1650338664749,COGS 118A,A01,083075,Staff,5,0,60,55
1650338670774,CSE 3,A50,083646,Miranda; Gregory Joseph,21,0,38,17
1650338670774,CSE 3,A51,083647,Miranda; Gregory Joseph,37,0,37,0
1650338676799,CSE 8A,A50,083650,Miranda; Gregory Joseph,0,28,40,40
1650338682825,CSE 11,A01,083080,Cao; Yingjun,0,88,40,40
1650338688852,CSE 12,A01,083652,Staff,0,12,100,100
1650338694879,CSE 15L,A01,083654,Staff,0,1,50,50
1650338694879,CSE 15L,A02,083655,Staff,3,0,50,47
1650338700907,CSE 20,A01,083657,Staff,53,0,80,27
1650338706929,CSE 30,A01,083084,Eldon; John,0,76,40,40
1650338712960,CSE 100,A01,083659,Cao; Yingjun,0,66,50,50
1650338718987,CSE 134B,A01,083661,Powell; Thomas Allan,0,31,65,65
1650338725021,CSE 140,A01,083663,Staff,0,0,75,75
1650338731043,CSE 140L,A01,083088,Eldon; John,0,6,75,75
1650338737069,CSE 175,A01,083665,Kumar; Rakesh,8,0,25,17
1650338743093,CSE 190,A00,092507,Dubnov; Shlomo,14,0,20,6
1650338749206,ECE 45,A01,083139,Staff,0,17,40,40
1650338755231,ECE 65,A50,083695,Staff,0,5,30,30
1650338761258,ECE 109,A01,091882,Touri; Behrouz,40,0,70,30
1650338767280,ECE 180,A00,083140,Abi Samra; Nicholas Camill,23,0,30,7
1650338767280,ECE 180,B00,083141,Abi Samra; Nicholas Camill,5,0,30,25
1650338773303,MATH 10A,A01,083735,Patchell; Gregory David,8,0,30,22
1650338773303,MATH 10A,A02,083736,Patchell; Gregory David,28,0,30,2
1650338773303,MATH 10A,A03,083737,Patchell; Gregory David,26,0,30,4
1650338779339,MATH 10B,A01,083207,Staff,0,7,30,30
1650338779339,MATH 10B,A02,083208,Staff,0,6,30,30
1650338779339,MATH 10B,B01,083739,Staff,17,0,30,13
1650338779339,MATH 10B,B02,083740,Staff,28,0,30,2
1650338785365,MATH 18,A01,083743,Staff,4,0,30,26
1650338785365,MATH 18,A02,083744,Staff,27,0,30,3
1650338785365,MATH 18,A03,083745,Staff,22,0,30,8
1650338785365,MATH 18,A04,083746,Staff,27,0,30,3
1650338785365,MATH 18,B01,083748,Staff,0,11,30,30
1650338785365,MATH 18,B02,083749,Staff,0,11,30,30
1650338785365,MATH 18,B03,083750,Staff,1,11,30,29
1650338785365,MATH 18,B04,083751,Staff,1,11,30,29
1650338791391,MATH 20A,A01,083754,Staff,26,0,40,14
1650338797416,MATH 20B,A01,083756,Staff,0,8,30,30
1650338797416,MATH 20B,A02,083757,Staff,0,8,30,30
1650338803445,MATH 20C,A01,083760,Staff,0,13,30,30
1650338803445,MATH 20C,A02,083761,Staff,0,13,30,30
1650338803445,MATH 20C,B01,083762,Staff,13,0,30,17
1650338803445,MATH 20C,B02,083763,Staff,28,0,30,2
1650338809472,MATH 20D,A01,083765,Staff,0,1,30,30
1650338809472,MATH 20D,A02,083766,Staff,7,0,30,23
1650338809472,MATH 20D,A03,083767,Staff,26,0,30,4
1650338815497,MATH 20E,A01,083771,Staff,5,0,30,25
1650338815497,MATH 20E,A02,083772,Staff,19,0,30,11
1650338815497,MATH 20E,B01,083773,Staff,0,0,30,30
1650338815497,MATH 20E,B02,083774,Staff,12,0,30,18
1650338821525,MATH 103A,A01,083777,Staff,0,12,30,30
1650338821525,MATH 103A,A02,083778,Staff,0,12,30,30
1650338821525,MATH 103A,B01,083779,Staff,0,13,30,30
1650338821525,MATH 103A,B02,083780,Staff,0,12,30,30
1650338827552,MATH 105,A01,085443,Staff,0,21,30,30
1650338833603,MATH 109,A01,083213,Anzaldo; Leesa B,0,5,30,30
1650338833603,MATH 109,A02,083214,Anzaldo; Leesa B,0,7,30,30
1650338833603,MATH 109,B01,083215,Anzaldo; Leesa B,0,5,30,30
1650338833603,MATH 109,B02,083216,Anzaldo; Leesa B,0,5,30,30
1650338839631,MATH 142A,A01,083219,Chow; Bennett,0,14,30,30
1650338839631,MATH 142A,A02,083220,Chow; Bennett,0,12,30,30
1650338839631,MATH 142A,B01,083221,Chow; Bennett,0,12,30,30
1650338839631,MATH 142A,B02,083222,Chow; Bennett,0,12,30,30
1650338845658,MATH 193A,A01,083224,Staff,0,5,30,30
1650338845658,MATH 193A,A02,083225,Staff,0,5,30,30
1650338845658,MATH 193A,A03,083781,Staff,0,4,30,30
1650338845658,MATH 193A,A04,083782,Staff,0,3,30,30
1650338851682,MATH 197,001,091859,McAuley; Julian John,9998,0,9999,1
1650338857734,COGS 9,A01,083615,Staff,0,15,60,60
1650338863757,COGS 11,A01,083617,Boyle; Mary E. T.,22,0,40,18
1650338869791,COGS 13,A01,083071,Staff,0,31,40,40
1650338875817,COGS 14A,A01,092681,Staff,0,19,100,100
1650338881840,COGS 14B,A01,083073,Cheng; Tzu-Han,0,10,50,50
1650338887863,COGS 17,A01,092677,Staff,25,0,75,50
1650338893887,COGS 100,A01,083619,Staff,0,23,60,60
1650338899910,COGS 101A,A01,083621,Davis; Joshua Daniel,1,22,60,59
1650338905937,COGS 101B,A01,091572,Staff,1,0,60,59
1650338911965,COGS 101C,A01,083625,Delgado; Tania,18,0,30,12
1650338918009,COGS 107A,A01,083627,Boyle; Mary E. T.,0,8,60,60
1650338924032,COGS 118A,A01,083075,Staff,5,0,60,55
1650338930060,CSE 3,A50,083646,Miranda; Gregory Joseph,21,0,38,17
1650338930060,CSE 3,A51,083647,Miranda; Gregory Joseph,37,0,37,0
1650338936087,CSE 8A,A50,083650,Miranda; Gregory Joseph,0,28,40,40
1650338942119,CSE 11,A01,083080,Cao; Yingjun,0,88,40,40
1650338948145,CSE 12,A01,083652,Staff,0,12,100,100
1650338954176,CSE 15L,A01,083654,Staff,0,1,50,50
1650338954176,CSE 15L,A02,083655,Staff,3,0,50,47
1650338960203,CSE 20,A01,083657,Staff,53,0,80,27
1650338966225,CSE 30,A01,083084,Eldon; John,0,76,40,40
1650338972247,CSE 100,A01,083659,Cao; Yingjun,0,66,50,50
1650338978277,CSE 134B,A01,083661,Powell; Thomas Allan,0,31,65,65
1650338984302,CSE 140,A01,083663,Staff,0,0,75,75
1650338990325,CSE 140L,A01,083088,Eldon; John,0,6,75,75
1650338996362,CSE 175,A01,083665,Kumar; Rakesh,8,0,25,17
1650339002392,CSE 190,A00,092507,Dubnov; Shlomo,14,0,20,6
1650339008422,ECE 45,A01,083139,Staff,0,17,40,40
1650339014448,ECE 65,A50,083695,Staff,0,5,30,30
1650339020477,ECE 109,A01,091882,Touri; Behrouz,40,0,70,30
1650339026501,ECE 180,A00,083140,Abi Samra; Nicholas Camill,23,0,30,7
1650339026501,ECE 180,B00,083141,Abi Samra; Nicholas Camill,5,0,30,25
1650339032526,MATH 10A,A01,083735,Patchell; Gregory David,8,0,30,22
1650339032526,MATH 10A,A02,083736,Patchell; Gregory David,28,0,30,2
1650339032526,MATH 10A,A03,083737,Patchell; Gregory David,26,0,30,4
1650339038549,MATH 10B,A01,083207,Staff,0,7,30,30
1650339038549,MATH 10B,A02,083208,Staff,0,6,30,30
1650339038549,MATH 10B,B01,083739,Staff,17,0,30,13
1650339038549,MATH 10B,B02,083740,Staff,28,0,30,2
1650339044574,MATH 18,A01,083743,Staff,4,0,30,26
1650339044574,MATH 18,A02,083744,Staff,27,0,30,3
1650339044574,MATH 18,A03,083745,Staff,22,0,30,8
1650339044574,MATH 18,A04,083746,Staff,27,0,30,3
1650339044574,MATH 18,B01,083748,Staff,0,11,30,30
1650339044574,MATH 18,B02,083749,Staff,0,11,30,30
1650339044574,MATH 18,B03,083750,Staff,1,11,30,29
1650339044574,MATH 18,B04,083751,Staff,1,11,30,29
1650339050601,MATH 20A,A01,083754,Staff,26,0,40,14
1650339056629,MATH 20B,A01,083756,Staff,0,8,30,30
1650339056629,MATH 20B,A02,083757,Staff,0,8,30,30
1650339062654,MATH 20C,A01,083760,Staff,0,13,30,30
1650339062654,MATH 20C,A02,083761,Staff,0,13,30,30
1650339062654,MATH 20C,B01,083762,Staff,13,0,30,17
1650339062654,MATH 20C,B02,083763,Staff,28,0,30,2
1650339068680,MATH 20D,A01,083765,Staff,0,1,30,30
1650339068680,MATH 20D,A02,083766,Staff,7,0,30,23
1650339068680,MATH 20D,A03,083767,Staff,26,0,30,4
1650339074708,MATH 20E,A01,083771,Staff,5,0,30,25
1650339074708,MATH 20E,A02,083772,Staff,19,0,30,11
1650339074708,MATH 20E,B01,083773,Staff,0,0,30,30
1650339074708,MATH 20E,B02,083774,Staff,12,0,30,18
1650339080733,MATH 103A,A01,083777,Staff,0,12,30,30
1650339080733,MATH 103A,A02,083778,Staff,0,12,30,30
1650339080733,MATH 103A,B01,083779,Staff,0,13,30,30
1650339080733,MATH 103A,B02,083780,Staff,0,12,30,30
1650339086757,MATH 105,A01,085443,Staff,0,21,30,30
1650339092780,MATH 109,A01,083213,Anzaldo; Leesa B,0,5,30,30
1650339092780,MATH 109,A02,083214,Anzaldo; Leesa B,0,7,30,30
1650339092780,MATH 109,B01,083215,Anzaldo; Leesa B,0,5,30,30
1650339092780,MATH 109,B02,083216,Anzaldo; Leesa B,0,5,30,30
1650339098805,MATH 142A,A01,083219,Chow; Bennett,0,14,30,30
1650339098805,MATH 142A,A02,083220,Chow; Bennett,0,12,30,30
1650339098805,MATH 142A,B01,083221,Chow; Bennett,0,12,30,30
1650339098805,MATH 142A,B02,083222,Chow; Bennett,0,12,30,30
1650339104828,MATH 193A,A01,083224,Staff,0,5,30,30
1650339104828,MATH 193A,A02,083225,Staff,0,5,30,30
1650339104828,MATH 193A,A03,083781,Staff,0,4,30,30
1650339104828,MATH 193A,A04,083782,Staff,0,3,30,30
1650339110854,MATH 197,001,091859,McAuley; Julian John,9998,0,9999,1
1650339116937,COGS 9,A01,083615,Staff,0,15,60,60
1650339122960,COGS 11,A01,083617,Boyle; Mary E. T.,22,0,40,18
1650339128982,COGS 13,A01,083071,Staff,0,31,40,40
1650339135008,COGS 14A,A01,092681,Staff,0,19,100,100
1650339141044,COGS 14B,A01,083073,Cheng; Tzu-Han,0,10,50,50
1650339147076,COGS 17,A01,092677,Staff,25,0,75,50
1650339153126,COGS 100,A01,083619,Staff,0,23,60,60
1650339159152,COGS 101A,A01,083621,Davis; Joshua Daniel,1,22,60,59
1650339165176,COGS 101B,A01,091572,Staff,1,0,60,59
1650339171202,COGS 101C,A01,083625,Delgado; Tania,18,0,30,12
1650339177228,COGS 107A,A01,083627,Boyle; Mary E. T.,0,8,60,60
1650339183254,COGS 118A,A01,083075,Staff,5,0,60,55
1650339189281,CSE 3,A50,083646,Miranda; Gregory Joseph,21,0,38,17
1650339189281,CSE 3,A51,083647,Miranda; Gregory Joseph,37,0,37,0
1650339195321,CSE 8A,A50,083650,Miranda; Gregory Joseph,0,28,40,40
1650339201353,CSE 11,A01,083080,Cao; Yingjun,0,88,40,40
1650339207380,CSE 12,A01,083652,Staff,0,12,100,100
1650339213408,CSE 15L,A01,083654,Staff,0,1,50,50
1650339213408,CSE 15L,A02,083655,Staff,3,0,50,47
1650339219430,CSE 20,A01,083657,Staff,53,0,80,27
1650339225453,CSE 30,A01,083084,Eldon; John,0,76,40,40
1650339231477,CSE 100,A01,083659,Cao; Yingjun,0,66,50,50
1650339237500,CSE 134B,A01,083661,Powell; Thomas Allan,0,31,65,65
1650339243532,CSE 140,A01,083663,Staff,0,0,75,75
1650339249557,CSE 140L,A01,083088,Eldon; John,0,6,75,75
1650339255588,CSE 175,A01,083665,Kumar; Rakesh,8,0,25,17
1650339261624,CSE 190,A00,092507,Dubnov; Shlomo,14,0,20,6
1650339267651,ECE 45,A01,083139,Staff,0,17,40,40
1650339273676,ECE 65,A50,083695,Staff,0,5,30,30
1650339279700,ECE 109,A01,091882,Touri; Behrouz,40,0,70,30
1650339285733,ECE 180,A00,083140,Abi Samra; Nicholas Camill,23,0,30,7
1650339285733,ECE 180,B00,083141,Abi Samra; Nicholas Camill,5,0,30,25
1650339291755,MATH 10A,A01,083735,Patchell; Gregory David,8,0,30,22
1650339291755,MATH 10A,A02,083736,Patchell; Gregory David,28,0,30,2
1650339291755,MATH 10A,A03,083737,Patchell; Gregory David,26,0,30,4
1650339297778,MATH 10B,A01,083207,Staff,0,7,30,30
1650339297778,MATH 10B,A02,083208,Staff,0,6,30,30
1650339297778,MATH 10B,B01,083739,Staff,17,0,30,13
1650339297778,MATH 10B,B02,083740,Staff,28,0,30,2
1650339303810,MATH 18,A01,083743,Staff,4,0,30,26
1650339303810,MATH 18,A02,083744,Staff,27,0,30,3
1650339303810,MATH 18,A03,083745,Staff,22,0,30,8
1650339303810,MATH 18,A04,083746,Staff,27,0,30,3
1650339303810,MATH 18,B01,083748,Staff,0,11,30,30
1650339303810,MATH 18,B02,083749,Staff,0,11,30,30
1650339303810,MATH 18,B03,083750,Staff,1,11,30,29
1650339303810,MATH 18,B04,083751,Staff,1,11,30,29
1650339309835,MATH 20A,A01,083754,Staff,26,0,40,14
1650339315859,MATH 20B,A01,083756,Staff,0,8,30,30
1650339315859,MATH 20B,A02,083757,Staff,0,8,30,30
1650339321884,MATH 20C,A01,083760,Staff,0,13,30,30
1650339321884,MATH 20C,A02,083761,Staff,0,13,30,30
1650339321884,MATH 20C,B01,083762,Staff,13,0,30,17
1650339321884,MATH 20C,B02,083763,Staff,28,0,30,2
1650339327913,MATH 20D,A01,083765,Staff,0,1,30,30
1650339327913,MATH 20D,A02,083766,Staff,7,0,30,23
1650339327913,MATH 20D,A03,083767,Staff,26,0,30,4
1650339333936,MATH 20E,A01,083771,Staff,5,0,30,25
1650339333936,MATH 20E,A02,083772,Staff,19,0,30,11
1650339333936,MATH 20E,B01,083773,Staff,0,0,30,30
1650339333936,MATH 20E,B02,083774,Staff,12,0,30,18
1650339339964,MATH 103A,A01,083777,Staff,0,12,30,30
1650339339964,MATH 103A,A02,083778,Staff,0,12,30,30
1650339339964,MATH 103A,B01,083779,Staff,0,13,30,30
1650339339964,MATH 103A,B02,083780,Staff,0,12,30,30
1650339346084,MATH 105,A01,085443,Staff,0,21,30,30
1650339352111,MATH 109,A01,083213,Anzaldo; Leesa B,0,5,30,30
1650339352111,MATH 109,A02,083214,Anzaldo; Leesa B,0,7,30,30
1650339352111,MATH 109,B01,083215,Anzaldo; Leesa B,0,5,30,30
1650339352111,MATH 109,B02,083216,Anzaldo; Leesa B,0,5,30,30
1650339358134,MATH 142A,A01,083219,Chow; Bennett,0,14,30,30
1650339358134,MATH 142A,A02,083220,Chow; Bennett,0,12,30,30
1650339358134,MATH 142A,B01,083221,Chow; Bennett,0,12,30,30
1650339358134,MATH 142A,B02,083222,Chow; Bennett,0,12,30,30
1650339364160,MATH 193A,A01,083224,Staff,0,5,30,30
1650339364160,MATH 193A,A02,083225,Staff,0,5,30,30
1650339364160,MATH 193A,A03,083781,Staff,0,4,30,30
1650339364160,MATH 193A,A04,083782,Staff,0,3,30,30
1650339370185,MATH 197,001,091859,McAuley; Julian John,9998,0,9999,1
1650339376240,COGS 9,A01,083615,Staff,0,15,60,60
1650339382265,COGS 11,A01,083617,Boyle; Mary E. T.,22,0,40,18
1650339388287,COGS 13,A01,083071,Staff,0,31,40,40
1650339394315,COGS 14A,A01,092681,Staff,0,19,100,100
1650339400338,COGS 14B,A01,083073,Cheng; Tzu-Han,0,10,50,50
1650339406366,COGS 17,A01,092677,Staff,25,0,75,50
1650339412390,COGS 100,A01,083619,Staff,0,23,60,60
1650339418414,COGS 101A,A01,083621,Davis; Joshua Daniel,1,22,60,59
1650339424440,COGS 101B,A01,091572,Staff,1,0,60,59
1650339430464,COGS 101C,A01,083625,Delgado; Tania,18,0,30,12
1650339436493,COGS 107A,A01,083627,Boyle; Mary E. T.,0,8,60,60
1650339442525,COGS 118A,A01,083075,Staff,5,0,60,55
1650339448555,CSE 3,A50,083646,Miranda; Gregory Joseph,21,0,38,17
1650339448555,CSE 3,A51,083647,Miranda; Gregory Joseph,37,0,37,0
1650339454579,CSE 8A,A50,083650,Miranda; Gregory Joseph,0,28,40,40
1650339460604,CSE 11,A01,083080,Cao; Yingjun,0,88,40,40
1650339466639,CSE 12,A01,083652,Staff,0,12,100,100
1650339472671,CSE 15L,A01,083654,Staff,0,1,50,50
1650339472671,CSE 15L,A02,083655,Staff,3,0,50,47
1650339478696,CSE 20,A01,083657,Staff,53,0,80,27
1650339484721,CSE 30,A01,083084,Eldon; John,0,76,40,40
1650339490749,CSE 100,A01,083659,Cao; Yingjun,0,66,50,50
1650339496773,CSE 134B,A01,083661,Powell; Thomas Allan,0,31,65,65
1650339502799,CSE 140,A01,083663,Staff,0,0,75,75
1650339508821,CSE 140L,A01,083088,Eldon; John,0,6,75,75
1650339514847,CSE 175,A01,083665,Kumar; Rakesh,8,0,25,17
1650339520873,CSE 190,A00,092507,Dubnov; Shlomo,14,0,20,6
1650339526901,ECE 45,A01,083139,Staff,0,17,40,40
1650339532927,ECE 65,A50,083695,Staff,0,5,30,30
1650339538954,ECE 109,A01,091882,Touri; Behrouz,40,0,70,30
1650339544981,ECE 180,A00,083140,Abi Samra; Nicholas Camill,23,0,30,7
1650339544981,ECE 180,B00,083141,Abi Samra; Nicholas Camill,5,0,30,25
1650339551008,MATH 10A,A01,083735,Patchell; Gregory David,7,0,30,23
1650339551008,MATH 10A,A02,083736,Patchell; Gregory David,28,0,30,2
1650339551008,MATH 10A,A03,083737,Patchell; Gregory David,26,0,30,4
1650339557038,MATH 10B,A01,083207,Staff,0,7,30,30
1650339557038,MATH 10B,A02,083208,Staff,0,6,30,30
1650339557038,MATH 10B,B01,083739,Staff,17,0,30,13
1650339557038,MATH 10B,B02,083740,Staff,28,0,30,2
1650339563069,MATH 18,A01,083743,Staff,4,0,30,26
1650339563069,MATH 18,A02,083744,Staff,27,0,30,3
1650339563069,MATH 18,A03,083745,Staff,22,0,30,8
1650339563069,MATH 18,A04,083746,Staff,27,0,30,3
1650339563069,MATH 18,B01,083748,Staff,0,11,30,30
1650339563069,MATH 18,B02,083749,Staff,0,11,30,30
1650339563069,MATH 18,B03,083750,Staff,1,11,30,29
1650339563069,MATH 18,B04,083751,Staff,1,11,30,29
1650339569091,MATH 20A,A01,083754,Staff,26,0,40,14
1650339575117,MATH 20B,A01,083756,Staff,0,8,30,30
1650339575117,MATH 20B,A02,083757,Staff,0,8,30,30
1650339581140,MATH 20C,A01,083760,Staff,0,13,30,30
1650339581140,MATH 20C,A02,083761,Staff,0,13,30,30
1650339581140,MATH 20C,B01,083762,Staff,13,0,30,17
1650339581140,MATH 20C,B02,083763,Staff,28,0,30,2
1650339587164,MATH 20D,A01,083765,Staff,0,1,30,30
1650339587164,MATH 20D,A02,083766,Staff,7,0,30,23
1650339587164,MATH 20D,A03,083767,Staff,26,0,30,4
1650339593191,MATH 20E,A01,083771,Staff,5,0,30,25
1650339593191,MATH 20E,A02,083772,Staff,19,0,30,11
1650339593191,MATH 20E,B01,083773,Staff,0,0,30,30
1650339593191,MATH 20E,B02,083774,Staff,12,0,30,18
1650339599218,MATH 103A,A01,083777,Staff,0,12,30,30
1650339599218,MATH 103A,A02,083778,Staff,0,12,30,30
1650339599218,MATH 103A,B01,083779,Staff,0,13,30,30
1650339599218,MATH 103A,B02,083780,Staff,0,12,30,30
1650339605244,MATH 105,A01,085443,Staff,0,21,30,30
1650339611268,MATH 109,A01,083213,Anzaldo; Leesa B,0,5,30,30
1650339611268,MATH 109,A02,083214,Anzaldo; Leesa B,0,7,30,30
1650339611268,MATH 109,B01,083215,Anzaldo; Leesa B,0,5,30,30
1650339611268,MATH 109,B02,083216,Anzaldo; Leesa B,0,5,30,30
1650339617293,MATH 142A,A01,083219,Chow; Bennett,0,14,30,30
1650339617293,MATH 142A,A02,083220,Chow; Bennett,0,12,30,30
1650339617293,MATH 142A,B01,083221,Chow; Bennett,0,12,30,30
1650339617293,MATH 142A,B02,083222,Chow; Bennett,0,12,30,30
1650339623321,MATH 193A,A01,083224,Staff,0,5,30,30
1650339623321,MATH 193A,A02,083225,Staff,0,5,30,30
1650339623321,MATH 193A,A03,083781,Staff,0,4,30,30
1650339623321,MATH 193A,A04,083782,Staff,0,3,30,30
1650339629342,MATH 197,001,091859,McAuley; Julian John,9998,0,9999,1
1650339635393,COGS 9,A01,083615,Staff,0,15,60,60
1650339641417,COGS 11,A01,083617,Boyle; Mary E. T.,22,0,40,18
1650339647443,COGS 13,A01,083071,Staff,0,31,40,40
1650339653470,COGS 14A,A01,092681,Staff,0,19,100,100
1650339659506,COGS 14B,A01,083073,Cheng; Tzu-Han,0,10,50,50
1650339665529,COGS 17,A01,092677,Staff,25,0,75,50
1650339671553,COGS 100,A01,083619,Staff,0,23,60,60
1650339677578,COGS 101A,A01,083621,Davis; Joshua Daniel,1,22,60,59
1650339683604,COGS 101B,A01,091572,Staff,1,0,60,59
1650339689628,COGS 101C,A01,083625,Delgado; Tania,18,0,30,12
1650339695652,COGS 107A,A01,083627,Boyle; Mary E. T.,0,8,60,60
1650339701675,COGS 118A,A01,083075,Staff,5,0,60,55
1650339707717,CSE 3,A50,083646,Miranda; Gregory Joseph,21,0,38,17
1650339707717,CSE 3,A51,083647,Miranda; Gregory Joseph,37,0,37,0
1650339713741,CSE 8A,A50,083650,Miranda; Gregory Joseph,0,28,40,40
1650339719767,CSE 11,A01,083080,Cao; Yingjun,0,88,40,40
1650339725797,CSE 12,A01,083652,Staff,0,12,100,100
1650339731823,CSE 15L,A01,083654,Staff,0,1,50,50
1650339731823,CSE 15L,A02,083655,Staff,3,0,50,47
1650339737846,CSE 20,A01,083657,Staff,53,0,80,27
1650339743869,CSE 30,A01,083084,Eldon; John,0,76,40,40
1650339749893,CSE 100,A01,083659,Cao; Yingjun,0,66,50,50
1650339755915,CSE 134B,A01,083661,Powell; Thomas Allan,0,31,65,65
1650339761939,CSE 140,A01,083663,Staff,0,0,75,75
1650339767964,CSE 140L,A01,083088,Eldon; John,0,6,75,75
1650339773992,CSE 175,A01,083665,Kumar; Rakesh,8,0,25,17
1650339780014,CSE 190,A00,092507,Dubnov; Shlomo,14,0,20,6
1650339786037,ECE 45,A01,083139,Staff,0,17,40,40
1650339792060,ECE 65,A50,083695,Staff,0,5,30,30
1650339798084,ECE 109,A01,091882,Touri; Behrouz,40,0,70,30
1650339804113,ECE 180,A00,083140,Abi Samra; Nicholas Camill,23,0,30,7
1650339804113,ECE 180,B00,083141,Abi Samra; Nicholas Camill,5,0,30,25
1650339810139,MATH 10A,A01,083735,Patchell; Gregory David,7,0,30,23
1650339810139,MATH 10A,A02,083736,Patchell; Gregory David,28,0,30,2
1650339810139,MATH 10A,A03,083737,Patchell; Gregory David,26,0,30,4
1650339816175,MATH 10B,A01,083207,Staff,0,7,30,30
1650339816175,MATH 10B,A02,083208,Staff,0,6,30,30
1650339816175,MATH 10B,B01,083739,Staff,17,0,30,13
1650339816175,MATH 10B,B02,083740,Staff,28,0,30,2
1650339822213,MATH 18,A01,083743,Staff,4,0,30,26
1650339822213,MATH 18,A02,083744,Staff,27,0,30,3
1650339822213,MATH 18,A03,083745,Staff,22,0,30,8
1650339822213,MATH 18,A04,083746,Staff,27,0,30,3
1650339822213,MATH 18,B01,083748,Staff,0,11,30,30
1650339822213,MATH 18,B02,083749,Staff,0,11,30,30
1650339822213,MATH 18,B03,083750,Staff,1,11,30,29
1650339822213,MATH 18,B04,083751,Staff,1,11,30,29
1650339828242,MATH 20A,A01,083754,Staff,26,0,40,14
1650339834267,MATH 20B,A01,083756,Staff,0,8,30,30
1650339834267,MATH 20B,A02,083757,Staff,0,8,30,30
1650339840294,MATH 20C,A01,083760,Staff,0,13,30,30
1650339840294,MATH 20C,A02,083761,Staff,0,13,30,30
1650339840294,MATH 20C,B01,083762,Staff,13,0,30,17
1650339840294,MATH 20C,B02,083763,Staff,28,0,30,2
1650339846330,MATH 20D,A01,083765,Staff,0,1,30,30
1650339846330,MATH 20D,A02,083766,Staff,7,0,30,23
1650339846330,MATH 20D,A03,083767,Staff,26,0,30,4
1650339852357,MATH 20E,A01,083771,Staff,5,0,30,25
1650339852357,MATH 20E,A02,083772,Staff,19,0,30,11
1650339852357,MATH 20E,B01,083773,Staff,0,0,30,30
1650339852357,MATH 20E,B02,083774,Staff,12,0,30,18
1650339858384,MATH 103A,A01,083777,Staff,0,12,30,30
1650339858384,MATH 103A,A02,083778,Staff,0,12,30,30
1650339858384,MATH 103A,B01,083779,Staff,0,13,30,30
1650339858384,MATH 103A,B02,083780,Staff,0,12,30,30
1650339864417,MATH 105,A01,085443,Staff,0,21,30,30
1650339870439,MATH 109,A01,083213,Anzaldo; Leesa B,0,5,30,30
1650339870439,MATH 109,A02,083214,Anzaldo; Leesa B,0,7,30,30
1650339870439,MATH 109,B01,083215,Anzaldo; Leesa B,0,5,30,30
1650339870439,MATH 109,B02,083216,Anzaldo; Leesa B,0,5,30,30
1650339876467,MATH 142A,A01,083219,Chow; Bennett,0,14,30,30
1650339876467,MATH 142A,A02,083220,Chow; Bennett,0,12,30,30
1650339876467,MATH 142A,B01,083221,Chow; Bennett,0,12,30,30
1650339876467,MATH 142A,B02,083222,Chow; Bennett,0,12,30,30
1650339882493,MATH 193A,A01,083224,Staff,0,5,30,30
1650339882493,MATH 193A,A02,083225,Staff,0,5,30,30
1650339882493,MATH 193A,A03,083781,Staff,0,4,30,30
1650339882493,MATH 193A,A04,083782,Staff,0,3,30,30
1650339888516,MATH 197,001,091859,McAuley; Julian John,9998,0,9999,1
1650339894565,COGS 9,A01,083615,Staff,0,15,60,60
1650339900594,COGS 11,A01,083617,Boyle; Mary E. T.,22,0,40,18
1650339906617,COGS 13,A01,083071,Staff,0,31,40,40
1650339912638,COGS 14A,A01,092681,Staff,0,19,100,100
1650339918665,COGS 14B,A01,083073,Cheng; Tzu-Han,0,10,50,50
1650339924688,COGS 17,A01,092677,Staff,25,0,75,50
1650339930715,COGS 100,A01,083619,Staff,0,23,60,60
1650339936828,COGS 101A,A01,083621,Davis; Joshua Daniel,1,22,60,59
1650339942857,COGS 101B,A01,091572,Staff,1,0,60,59
1650339948887,COGS 101C,A01,083625,Delgado; Tania,18,0,30,12
1650339954911,COGS 107A,A01,083627,Boyle; Mary E. T.,0,8,60,60
1650339960932,COGS 118A,A01,083075,Staff,5,0,60,55
1650339966956,CSE 3,A50,083646,Miranda; Gregory Joseph,21,0,38,17
1650339966956,CSE 3,A51,083647,Miranda; Gregory Joseph,37,0,37,0
1650339972980,CSE 8A,A50,083650,Miranda; Gregory Joseph,0,28,40,40
1650339979004,CSE 11,A01,083080,Cao; Yingjun,0,88,40,40
1650339985034,CSE 12,A01,083652,Staff,0,12,100,100
1650339991058,CSE 15L,A01,083654,Staff,0,1,50,50
1650339991058,CSE 15L,A02,083655,Staff,3,0,50,47
1650339997084,CSE 20,A01,083657,Staff,53,0,80,27
1650340003109,CSE 30,A01,083084,Eldon; John,0,76,40,40
1650340009135,CSE 100,A01,083659,Cao; Yingjun,0,66,50,50
1650340015162,CSE 134B,A01,083661,Powell; Thomas Allan,0,31,65,65
1650340021186,CSE 140,A01,083663,Staff,0,0,75,75
1650340027209,CSE 140L,A01,083088,Eldon; John,0,6,75,75
1650340033251,CSE 175,A01,083665,Kumar; Rakesh,8,0,25,17
1650340039274,CSE 190,A00,092507,Dubnov; Shlomo,14,0,20,6
1650340045296,ECE 45,A01,083139,Staff,0,17,40,40
1650340051321,ECE 65,A50,083695,Staff,0,5,30,30
1650340057349,ECE 109,A01,091882,Touri; Behrouz,40,0,70,30
1650340063374,ECE 180,A00,083140,Abi Samra; Nicholas Camill,23,0,30,7
1650340063374,ECE 180,B00,083141,Abi Samra; Nicholas Camill,5,0,30,25
1650340069401,MATH 10A,A01,083735,Patchell; Gregory David,7,0,30,23
1650340069401,MATH 10A,A02,083736,Patchell; Gregory David,28,0,30,2
1650340069401,MATH 10A,A03,083737,Patchell; Gregory David,26,0,30,4
1650340075430,MATH 10B,A01,083207,Staff,0,7,30,30
1650340075430,MATH 10B,A02,083208,Staff,0,6,30,30
1650340075430,MATH 10B,B01,083739,Staff,17,0,30,13
1650340075430,MATH 10B,B02,083740,Staff,28,0,30,2
1650340081456,MATH 18,A01,083743,Staff,4,0,30,26
1650340081456,MATH 18,A02,083744,Staff,27,0,30,3
1650340081456,MATH 18,A03,083745,Staff,22,0,30,8
1650340081456,MATH 18,A04,083746,Staff,27,0,30,3
1650340081456,MATH 18,B01,083748,Staff,0,11,30,30
1650340081456,MATH 18,B02,083749,Staff,0,11,30,30
1650340081456,MATH 18,B03,083750,Staff,1,11,30,29
1650340081456,MATH 18,B04,083751,Staff,1,11,30,29
1650340087483,MATH 20A,A01,083754,Staff,26,0,40,14
1650340093511,MATH 20B,A01,083756,Staff,0,8,30,30
1650340093511,MATH 20B,A02,083757,Staff,0,8,30,30
1650340099540,MATH 20C,A01,083760,Staff,0,13,30,30
1650340099540,MATH 20C,A02,083761,Staff,0,13,30,30
1650340099540,MATH 20C,B01,083762,Staff,13,0,30,17
1650340099540,MATH 20C,B02,083763,Staff,28,0,30,2
1650340105565,MATH 20D,A01,083765,Staff,0,1,30,30
1650340105565,MATH 20D,A02,083766,Staff,7,0,30,23
1650340105565,MATH 20D,A03,083767,Staff,26,0,30,4
1650340111593,MATH 20E,A01,083771,Staff,5,0,30,25
1650340111593,MATH 20E,A02,083772,Staff,19,0,30,11
1650340111593,MATH 20E,B01,083773,Staff,0,0,30,30
1650340111593,MATH 20E,B02,083774,Staff,12,0,30,18
1650340117616,MATH 103A,A01,083777,Staff,0,12,30,30
1650340117616,MATH 103A,A02,083778,Staff,0,12,30,30
1650340117616,MATH 103A,B01,083779,Staff,0,13,30,30
1650340117616,MATH 103A,B02,083780,Staff,0,12,30,30
1650340123640,MATH 105,A01,085443,Staff,0,21,30,30
1650340129662,MATH 109,A01,083213,Anzaldo; Leesa B,0,5,30,30
1650340129662,MATH 109,A02,083214,Anzaldo; Leesa B,0,7,30,30
1650340129662,MATH 109,B01,083215,Anzaldo; Leesa B,0,5,30,30
1650340129662,MATH 109,B02,083216,Anzaldo; Leesa B,0,5,30,30
1650340135687,MATH 142A,A01,083219,Chow; Bennett,0,14,30,30
1650340135687,MATH 142A,A02,083220,Chow; Bennett,0,12,30,30
1650340135687,MATH 142A,B01,083221,Chow; Bennett,0,12,30,30
1650340135687,MATH 142A,B02,083222,Chow; Bennett,0,12,30,30
1650340141715,MATH 193A,A01,083224,Staff,0,5,30,30
1650340141715,MATH 193A,A02,083225,Staff,0,5,30,30
1650340141715,MATH 193A,A03,083781,Staff,0,4,30,30
1650340141715,MATH 193A,A04,083782,Staff,0,3,30,30
1650340147738,MATH 197,001,091859,McAuley; Julian John,9998,0,9999,1
1650340153795,COGS 9,A01,083615,Staff,0,15,60,60
1650340159821,COGS 11,A01,083617,Boyle; Mary E. T.,22,0,40,18
1650340165850,COGS 13,A01,083071,Staff,0,31,40,40
1650340171873,COGS 14A,A01,092681,Staff,0,19,100,100
1650340177904,COGS 14B,A01,083073,Cheng; Tzu-Han,0,10,50,50
1650340183932,COGS 17,A01,092677,Staff,25,0,75,50
1650340189958,COGS 100,A01,083619,Staff,0,23,60,60
1650340195981,COGS 101A,A01,083621,Davis; Joshua Daniel,1,22,60,59
1650340202004,COGS 101B,A01,091572,Staff,1,0,60,59
1650340208030,COGS 101C,A01,083625,Delgado; Tania,18,0,30,12
1650340214061,COGS 107A,A01,083627,Boyle; Mary E. T.,0,8,60,60
1650340220088,COGS 118A,A01,083075,Staff,5,0,60,55
1650340226111,CSE 3,A50,083646,Miranda; Gregory Joseph,21,0,38,17
1650340226111,CSE 3,A51,083647,Miranda; Gregory Joseph,37,0,37,0
1650340232138,CSE 8A,A50,083650,Miranda; Gregory Joseph,0,28,40,40
1650340238165,CSE 11,A01,083080,Cao; Yingjun,0,88,40,40
1650340244187,CSE 12,A01,083652,Staff,0,12,100,100
1650340250213,CSE 15L,A01,083654,Staff,0,1,50,50
1650340250213,CSE 15L,A02,083655,Staff,3,0,50,47
1650340256235,CSE 20,A01,083657,Staff,53,0,80,27
1650340262272,CSE 30,A01,083084,Eldon; John,0,76,40,40
1650340268298,CSE 100,A01,083659,Cao; Yingjun,0,66,50,50
1650340274320,CSE 134B,A01,083661,Powell; Thomas Allan,0,31,65,65
1650340280343,CSE 140,A01,083663,Staff,0,0,75,75
1650340286366,CSE 140L,A01,083088,Eldon; John,0,6,75,75
1650340292393,CSE 175,A01,083665,Kumar; Rakesh,8,0,25,17
1650340298417,CSE 190,A00,092507,Dubnov; Shlomo,14,0,20,6
1650340304457,ECE 45,A01,083139,Staff,0,17,40,40
1650340310481,ECE 65,A50,083695,Staff,0,5,30,30
1650340316513,ECE 109,A01,091882,Touri; Behrouz,40,0,70,30
1650340322536,ECE 180,A00,083140,Abi Samra; Nicholas Camill,23,0,30,7
1650340322536,ECE 180,B00,083141,Abi Samra; Nicholas Camill,5,0,30,25
1650340328561,MATH 10A,A01,083735,Patchell; Gregory David,7,0,30,23
1650340328561,MATH 10A,A02,083736,Patchell; Gregory David,28,0,30,2
1650340328561,MATH 10A,A03,083737,Patchell; Gregory David,26,0,30,4
1650340334587,MATH 10B,A01,083207,Staff,0,7,30,30
1650340334587,MATH 10B,A02,083208,Staff,0,6,30,30
1650340334587,MATH 10B,B01,083739,Staff,17,0,30,13
1650340334587,MATH 10B,B02,083740,Staff,28,0,30,2
1650340340611,MATH 18,A01,083743,Staff,4,0,30,26
1650340340611,MATH 18,A02,083744,Staff,27,0,30,3
1650340340611,MATH 18,A03,083745,Staff,22,0,30,8
1650340340611,MATH 18,A04,083746,Staff,27,0,30,3
1650340340611,MATH 18,B01,083748,Staff,0,11,30,30
1650340340611,MATH 18,B02,083749,Staff,0,11,30,30
1650340340611,MATH 18,B03,083750,Staff,1,11,30,29
1650340340611,MATH 18,B04,083751,Staff,1,11,30,29
1650340346644,MATH 20A,A01,083754,Staff,26,0,40,14
1650340352668,MATH 20B,A01,083756,Staff,0,8,30,30
1650340352668,MATH 20B,A02,083757,Staff,0,8,30,30
1650340358695,MATH 20C,A01,083760,Staff,0,13,30,30
1650340358695,MATH 20C,A02,083761,Staff,0,13,30,30
1650340358695,MATH 20C,B01,083762,Staff,13,0,30,17
1650340358695,MATH 20C,B02,083763,Staff,28,0,30,2
1650340364725,MATH 20D,A01,083765,Staff,0,1,30,30
1650340364725,MATH 20D,A02,083766,Staff,7,0,30,23
1650340364725,MATH 20D,A03,083767,Staff,26,0,30,4
1650340370760,MATH 20E,A01,083771,Staff,5,0,30,25
1650340370760,MATH 20E,A02,083772,Staff,19,0,30,11
1650340370760,MATH 20E,B01,083773,Staff,0,0,30,30
1650340370760,MATH 20E,B02,083774,Staff,12,0,30,18
1650340376794,MATH 103A,A01,083777,Staff,0,12,30,30
1650340376794,MATH 103A,A02,083778,Staff,0,12,30,30
1650340376794,MATH 103A,B01,083779,Staff,0,13,30,30
1650340376794,MATH 103A,B02,083780,Staff,0,12,30,30
1650340382818,MATH 105,A01,085443,Staff,0,21,30,30
1650340388847,MATH 109,A01,083213,Anzaldo; Leesa B,0,5,30,30
1650340388847,MATH 109,A02,083214,Anzaldo; Leesa B,0,7,30,30
1650340388847,MATH 109,B01,083215,Anzaldo; Leesa B,0,5,30,30
1650340388847,MATH 109,B02,083216,Anzaldo; Leesa B,0,5,30,30
1650340394870,MATH 142A,A01,083219,Chow; Bennett,0,14,30,30
1650340394870,MATH 142A,A02,083220,Chow; Bennett,0,12,30,30
1650340394870,MATH 142A,B01,083221,Chow; Bennett,0,12,30,30
1650340394870,MATH 142A,B02,083222,Chow; Bennett,0,12,30,30
1650340400893,MATH 193A,A01,083224,Staff,0,5,30,30
1650340400893,MATH 193A,A02,083225,Staff,0,5,30,30
1650340400893,MATH 193A,A03,083781,Staff,0,4,30,30
1650340400893,MATH 193A,A04,083782,Staff,0,3,30,30
1650340406919,MATH 197,001,091859,McAuley; Julian John,9998,0,9999,1
1650340412974,COGS 9,A01,083615,Staff,0,15,60,60
1650340419002,COGS 11,A01,083617,Boyle; Mary E. T.,22,0,40,18
1650340425034,COGS 13,A01,083071,Staff,0,31,40,40
1650340431061,COGS 14A,A01,092681,Staff,0,19,100,100
1650340437086,COGS 14B,A01,083073,Cheng; Tzu-Han,0,10,50,50
1650340443114,COGS 17,A01,092677,Staff,25,0,75,50
1650340449138,COGS 100,A01,083619,Staff,0,23,60,60
1650340455164,COGS 101A,A01,083621,Davis; Joshua Daniel,1,22,60,59
1650340461189,COGS 101B,A01,091572,Staff,1,0,60,59
1650340467211,COGS 101C,A01,083625,Delgado; Tania,18,0,30,12
1650340473235,COGS 107A,A01,083627,Boyle; Mary E. T.,0,8,60,60
1650340479256,COGS 118A,A01,083075,Staff,5,0,60,55
1650340485281,CSE 3,A50,083646,Miranda; Gregory Joseph,21,0,38,17
1650340485281,CSE 3,A51,083647,Miranda; Gregory Joseph,37,0,37,0
1650340491306,CSE 8A,A50,083650,Miranda; Gregory Joseph,0,28,40,40
1650340497333,CSE 11,A01,083080,Cao; Yingjun,0,88,40,40
1650340503367,CSE 12,A01,083652,Staff,0,12,100,100
1650340509389,CSE 15L,A01,083654,Staff,0,1,50,50
1650340509389,CSE 15L,A02,083655,Staff,3,0,50,47
1650340515414,CSE 20,A01,083657,Staff,53,0,80,27
1650340521447,CSE 30,A01,083084,Eldon; John,0,76,40,40
1650340527473,CSE 100,A01,083659,Cao; Yingjun,0,66,50,50
1650340533590,CSE 134B,A01,083661,Powell; Thomas Allan,0,31,65,65
1650340539612,CSE 140,A01,083663,Staff,0,0,75,75
1650340545638,CSE 140L,A01,083088,Eldon; John,0,6,75,75
1650340551663,CSE 175,A01,083665,Kumar; Rakesh,8,0,25,17
1650340557697,CSE 190,A00,092507,Dubnov; Shlomo,14,0,20,6
1650340563740,ECE 45,A01,083139,Staff,0,17,40,40
1650340569767,ECE 65,A50,083695,Staff,0,5,30,30
1650340575790,ECE 109,A01,091882,Touri; Behrouz,40,0,70,30
1650340581826,ECE 180,A00,083140,Abi Samra; Nicholas Camill,23,0,30,7
1650340581826,ECE 180,B00,083141,Abi Samra; Nicholas Camill,5,0,30,25
1650340587850,MATH 10A,A01,083735,Patchell; Gregory David,7,0,30,23
1650340587850,MATH 10A,A02,083736,Patchell; Gregory David,28,0,30,2
1650340587850,MATH 10A,A03,083737,Patchell; Gregory David,26,0,30,4
1650340593874,MATH 10B,A01,083207,Staff,0,7,30,30
1650340593874,MATH 10B,A02,083208,Staff,0,6,30,30
1650340593874,MATH 10B,B01,083739,Staff,17,0,30,13
1650340593874,MATH 10B,B02,083740,Staff,28,0,30,2
1650340599897,MATH 18,A01,083743,Staff,4,0,30,26
1650340599897,MATH 18,A02,083744,Staff,27,0,30,3
1650340599897,MATH 18,A03,083745,Staff,22,0,30,8
1650340599897,MATH 18,A04,083746,Staff,27,0,30,3
1650340599897,MATH 18,B01,083748,Staff,0,11,30,30
1650340599897,MATH 18,B02,083749,Staff,0,11,30,30
1650340599897,MATH 18,B03,083750,Staff,1,11,30,29
1650340599897,MATH 18,B04,083751,Staff,1,11,30,29
1650340605926,MATH 20A,A01,083754,Staff,26,0,40,14
1650340611955,MATH 20B,A01,083756,Staff,0,8,30,30
1650340611955,MATH 20B,A02,083757,Staff,0,8,30,30
1650340617980,MATH 20C,A01,083760,Staff,0,13,30,30
1650340617980,MATH 20C,A02,083761,Staff,0,13,30,30
1650340617980,MATH 20C,B01,083762,Staff,13,0,30,17
1650340617980,MATH 20C,B02,083763,Staff,28,0,30,2
1650340624003,MATH 20D,A01,083765,Staff,0,1,30,30
1650340624003,MATH 20D,A02,083766,Staff,7,0,30,23
1650340624003,MATH 20D,A03,083767,Staff,26,0,30,4
1650340630031,MATH 20E,A01,083771,Staff,5,0,30,25
1650340630031,MATH 20E,A02,083772,Staff,19,0,30,11
1650340630031,MATH 20E,B01,083773,Staff,0,0,30,30
1650340630031,MATH 20E,B02,083774,Staff,12,0,30,18
1650340636060,MATH 103A,A01,083777,Staff,0,12,30,30
1650340636060,MATH 103A,A02,083778,Staff,0,12,30,30
1650340636060,MATH 103A,B01,083779,Staff,0,13,30,30
1650340636060,MATH 103A,B02,083780,Staff,0,12,30,30
1650340642082,MATH 105,A01,085443,Staff,0,21,30,30
1650340648107,MATH 109,A01,083213,Anzaldo; Leesa B,0,6,30,30
1650340648107,MATH 109,A02,083214,Anzaldo; Leesa B,0,7,30,30
1650340648107,MATH 109,B01,083215,Anzaldo; Leesa B,0,5,30,30
1650340648107,MATH 109,B02,083216,Anzaldo; Leesa B,0,5,30,30
1650340654144,MATH 142A,A01,083219,Chow; Bennett,0,14,30,30
1650340654144,MATH 142A,A02,083220,Chow; Bennett,0,12,30,30
1650340654144,MATH 142A,B01,083221,Chow; Bennett,0,12,30,30
1650340654144,MATH 142A,B02,083222,Chow; Bennett,0,12,30,30
1650340660166,MATH 193A,A01,083224,Staff,0,5,30,30
1650340660166,MATH 193A,A02,083225,Staff,0,5,30,30
1650340660166,MATH 193A,A03,083781,Staff,0,4,30,30
1650340660166,MATH 193A,A04,083782,Staff,0,3,30,30
1650340666191,MATH 197,001,091859,McAuley; Julian John,9998,0,9999,1
1650340672249,COGS 9,A01,083615,Staff,0,15,60,60
1650340678280,COGS 11,A01,083617,Boyle; Mary E. T.,22,0,40,18
1650340684305,COGS 13,A01,083071,Staff,0,31,40,40
1650340690355,COGS 14A,A01,092681,Staff,0,19,100,100
1650340696393,COGS 14B,A01,083073,Cheng; Tzu-Han,0,10,50,50
1650340702417,COGS 17,A01,092677,Staff,25,0,75,50
1650340708441,COGS 100,A01,083619,Staff,0,23,60,60
1650340714472,COGS 101A,A01,083621,Davis; Joshua Daniel,1,22,60,59
1650340720495,COGS 101B,A01,091572,Staff,1,0,60,59
1650340726521,COGS 101C,A01,083625,Delgado; Tania,18,0,30,12
1650340732545,COGS 107A,A01,083627,Boyle; Mary E. T.,0,8,60,60
1650340738569,COGS 118A,A01,083075,Staff,5,0,60,55
1650340744598,CSE 3,A50,083646,Miranda; Gregory Joseph,21,0,38,17
1650340744598,CSE 3,A51,083647,Miranda; Gregory Joseph,37,0,37,0
1650340750622,CSE 8A,A50,083650,Miranda; Gregory Joseph,0,28,40,40
1650340756646,CSE 11,A01,083080,Cao; Yingjun,0,88,40,40
1650340762670,CSE 12,A01,083652,Staff,0,12,100,100
1650340768692,CSE 15L,A01,083654,Staff,0,1,50,50
1650340768692,CSE 15L,A02,083655,Staff,3,0,50,47
1650340774719,CSE 20,A01,083657,Staff,53,0,80,27
1650340780740,CSE 30,A01,083084,Eldon; John,0,76,40,40
1650340786763,CSE 100,A01,083659,Cao; Yingjun,0,66,50,50
1650340792791,CSE 134B,A01,083661,Powell; Thomas Allan,0,31,65,65
1650340798814,CSE 140,A01,083663,Staff,0,0,75,75
1650340804842,CSE 140L,A01,083088,Eldon; John,0,6,75,75
1650340810866,CSE 175,A01,083665,Kumar; Rakesh,8,0,25,17
1650340816891,CSE 190,A00,092507,Dubnov; Shlomo,14,0,20,6
1650340822923,ECE 45,A01,083139,Staff,0,17,40,40
1650340828950,ECE 65,A50,083695,Staff,0,5,30,30
1650340834980,ECE 109,A01,091882,Touri; Behrouz,40,0,70,30
1650340841004,ECE 180,A00,083140,Abi Samra; Nicholas Camill,23,0,30,7
1650340841004,ECE 180,B00,083141,Abi Samra; Nicholas Camill,5,0,30,25
1650340847033,MATH 10A,A01,083735,Patchell; Gregory David,7,0,30,23
1650340847033,MATH 10A,A02,083736,Patchell; Gregory David,28,0,30,2
1650340847033,MATH 10A,A03,083737,Patchell; Gregory David,26,0,30,4
1650340853057,MATH 10B,A01,083207,Staff,0,7,30,30
1650340853057,MATH 10B,A02,083208,Staff,0,6,30,30
1650340853057,MATH 10B,B01,083739,Staff,17,0,30,13
1650340853057,MATH 10B,B02,083740,Staff,28,0,30,2
1650340859087,MATH 18,A01,083743,Staff,4,0,30,26
1650340859087,MATH 18,A02,083744,Staff,27,0,30,3
1650340859087,MATH 18,A03,083745,Staff,22,0,30,8
1650340859087,MATH 18,A04,083746,Staff,27,0,30,3
1650340859087,MATH 18,B01,083748,Staff,0,11,30,30
1650340859087,MATH 18,B02,083749,Staff,0,11,30,30
1650340859087,MATH 18,B03,083750,Staff,1,11,30,29
1650340859087,MATH 18,B04,083751,Staff,1,11,30,29
1650340865112,MATH 20A,A01,083754,Staff,26,0,40,14
1650340871136,MATH 20B,A01,083756,Staff,0,8,30,30
1650340871136,MATH 20B,A02,083757,Staff,0,8,30,30
1650340877162,MATH 20C,A01,083760,Staff,0,13,30,30
1650340877162,MATH 20C,A02,083761,Staff,0,13,30,30
1650340877162,MATH 20C,B01,083762,Staff,13,0,30,17
1650340877162,MATH 20C,B02,083763,Staff,28,0,30,2
1650340883184,MATH 20D,A01,083765,Staff,0,1,30,30
1650340883184,MATH 20D,A02,083766,Staff,7,0,30,23
1650340883184,MATH 20D,A03,083767,Staff,26,0,30,4
1650340889208,MATH 20E,A01,083771,Staff,5,0,30,25
1650340889208,MATH 20E,A02,083772,Staff,19,0,30,11
1650340889208,MATH 20E,B01,083773,Staff,0,0,30,30
1650340889208,MATH 20E,B02,083774,Staff,12,0,30,18
1650340895233,MATH 103A,A01,083777,Staff,0,12,30,30
1650340895233,MATH 103A,A02,083778,Staff,0,12,30,30
1650340895233,MATH 103A,B01,083779,Staff,0,13,30,30
1650340895233,MATH 103A,B02,083780,Staff,0,12,30,30
1650340901265,MATH 105,A01,085443,Staff,0,21,30,30
1650340907294,MATH 109,A01,083213,Anzaldo; Leesa B,0,6,30,30
1650340907294,MATH 109,A02,083214,Anzaldo; Leesa B,0,7,30,30
1650340907294,MATH 109,B01,083215,Anzaldo; Leesa B,0,5,30,30
1650340907294,MATH 109,B02,083216,Anzaldo; Leesa B,0,5,30,30
1650340913324,MATH 142A,A01,083219,Chow; Bennett,0,14,30,30
1650340913324,MATH 142A,A02,083220,Chow; Bennett,0,12,30,30
1650340913324,MATH 142A,B01,083221,Chow; Bennett,0,12,30,30
1650340913324,MATH 142A,B02,083222,Chow; Bennett,0,12,30,30
1650340919352,MATH 193A,A01,083224,Staff,0,5,30,30
1650340919352,MATH 193A,A02,083225,Staff,0,5,30,30
1650340919352,MATH 193A,A03,083781,Staff,0,4,30,30
1650340919352,MATH 193A,A04,083782,Staff,0,3,30,30
1650340925381,MATH 197,001,091859,McAuley; Julian John,9998,0,9999,1
1650340931440,COGS 9,A01,083615,Staff,0,15,60,60
1650340937464,COGS 11,A01,083617,Boyle; Mary E. T.,22,0,40,18
1650340943499,COGS 13,A01,083071,Staff,0,31,40,40
1650340949521,COGS 14A,A01,092681,Staff,0,19,100,100
1650340955549,COGS 14B,A01,083073,Cheng; Tzu-Han,0,10,50,50
1650340961588,COGS 17,A01,092677,Staff,25,0,75,50
1650340967624,COGS 100,A01,083619,Staff,0,23,60,60
1650340973647,COGS 101A,A01,083621,Davis; Joshua Daniel,1,22,60,59
1650340979670,COGS 101B,A01,091572,Staff,1,0,60,59
1650340985701,COGS 101C,A01,083625,Delgado; Tania,18,0,30,12
1650340991723,COGS 107A,A01,083627,Boyle; Mary E. T.,0,8,60,60
1650340997749,COGS 118A,A01,083075,Staff,5,0,60,55
1650341003773,CSE 3,A50,083646,Miranda; Gregory Joseph,21,0,38,17
1650341003773,CSE 3,A51,083647,Miranda; Gregory Joseph,37,0,37,0
1650341009796,CSE 8A,A50,083650,Miranda; Gregory Joseph,0,28,40,40
1650341015825,CSE 11,A01,083080,Cao; Yingjun,0,88,40,40
1650341021854,CSE 12,A01,083652,Staff,0,12,100,100
1650341027879,CSE 15L,A01,083654,Staff,0,1,50,50
1650341027879,CSE 15L,A02,083655,Staff,3,0,50,47
1650341033902,CSE 20,A01,083657,Staff,53,0,80,27
1650341039924,CSE 30,A01,083084,Eldon; John,0,76,40,40
1650341045948,CSE 100,A01,083659,Cao; Yingjun,0,66,50,50
1650341051972,CSE 134B,A01,083661,Powell; Thomas Allan,0,31,65,65
1650341057994,CSE 140,A01,083663,Staff,0,0,75,75
1650341064016,CSE 140L,A01,083088,Eldon; John,0,6,75,75
1650341070038,CSE 175,A01,083665,Kumar; Rakesh,8,0,25,17
1650341076060,CSE 190,A00,092507,Dubnov; Shlomo,14,0,20,6
1650341082084,ECE 45,A01,083139,Staff,0,17,40,40
1650341088110,ECE 65,A50,083695,Staff,0,5,30,30
1650341094134,ECE 109,A01,091882,Touri; Behrouz,40,0,70,30
1650341100156,ECE 180,A00,083140,Abi Samra; Nicholas Camill,23,0,30,7
1650341100156,ECE 180,B00,083141,Abi Samra; Nicholas Camill,5,0,30,25
1650341106184,MATH 10A,A01,083735,Patchell; Gregory David,7,0,30,23
1650341106184,MATH 10A,A02,083736,Patchell; Gregory David,28,0,30,2
1650341106184,MATH 10A,A03,083737,Patchell; Gregory David,26,0,30,4
1650341112207,MATH 10B,A01,083207,Staff,0,7,30,30
1650341112207,MATH 10B,A02,083208,Staff,0,6,30,30
1650341112207,MATH 10B,B01,083739,Staff,17,0,30,13
1650341112207,MATH 10B,B02,083740,Staff,28,0,30,2
1650341118250,MATH 18,A01,083743,Staff,4,0,30,26
1650341118250,MATH 18,A02,083744,Staff,27,0,30,3
1650341118250,MATH 18,A03,083745,Staff,22,0,30,8
1650341118250,MATH 18,A04,083746,Staff,27,0,30,3
1650341118250,MATH 18,B01,083748,Staff,0,11,30,30
1650341118250,MATH 18,B02,083749,Staff,0,11,30,30
1650341118250,MATH 18,B03,083750,Staff,1,11,30,29
1650341118250,MATH 18,B04,083751,Staff,1,11,30,29
1650341124274,MATH 20A,A01,083754,Staff,26,0,40,14
1650341130387,MATH 20B,A01,083756,Staff,0,8,30,30
1650341130387,MATH 20B,A02,083757,Staff,0,8,30,30
1650341136411,MATH 20C,A01,083760,Staff,0,13,30,30
1650341136411,MATH 20C,A02,083761,Staff,0,13,30,30
1650341136411,MATH 20C,B01,083762,Staff,13,0,30,17
1650341136411,MATH 20C,B02,083763,Staff,28,0,30,2
1650341142440,MATH 20D,A01,083765,Staff,0,1,30,30
1650341142440,MATH 20D,A02,083766,Staff,7,0,30,23
1650341142440,MATH 20D,A03,083767,Staff,26,0,30,4
1650341148465,MATH 20E,A01,083771,Staff,5,0,30,25
1650341148465,MATH 20E,A02,083772,Staff,19,0,30,11
1650341148465,MATH 20E,B01,083773,Staff,0,0,30,30
1650341148465,MATH 20E,B02,083774,Staff,12,0,30,18
1650341154490,MATH 103A,A01,083777,Staff,0,12,30,30
1650341154490,MATH 103A,A02,083778,Staff,0,12,30,30
1650341154490,MATH 103A,B01,083779,Staff,0,13,30,30
1650341154490,MATH 103A,B02,083780,Staff,0,12,30,30
1650341160518,MATH 105,A01,085443,Staff,0,21,30,30
1650341166543,MATH 109,A01,083213,Anzaldo; Leesa B,0,6,30,30
1650341166543,MATH 109,A02,083214,Anzaldo; Leesa B,0,7,30,30
1650341166543,MATH 109,B01,083215,Anzaldo; Leesa B,0,5,30,30
1650341166543,MATH 109,B02,083216,Anzaldo; Leesa B,0,5,30,30
1650341172573,MATH 142A,A01,083219,Chow; Bennett,0,14,30,30
1650341172573,MATH 142A,A02,083220,Chow; Bennett,0,12,30,30
1650341172573,MATH 142A,B01,083221,Chow; Bennett,0,12,30,30
1650341172573,MATH 142A,B02,083222,Chow; Bennett,0,12,30,30
1650341178597,MATH 193A,A01,083224,Staff,0,5,30,30
1650341178597,MATH 193A,A02,083225,Staff,0,5,30,30
1650341178597,MATH 193A,A03,083781,Staff,0,4,30,30
1650341178597,MATH 193A,A04,083782,Staff,0,3,30,30
1650341184622,MATH 197,001,091859,McAuley; Julian John,9998,0,9999,1
1650341190683,COGS 9,A01,083615,Staff,0,15,60,60
1650341196706,COGS 11,A01,083617,Boyle; Mary E. T.,22,0,40,18
1650341202733,COGS 13,A01,083071,Staff,0,31,40,40
1650341208755,COGS 14A,A01,092681,Staff,0,19,100,100
1650341214782,COGS 14B,A01,083073,Cheng; Tzu-Han,0,10,50,50
1650341220805,COGS 17,A01,092677,Staff,25,0,75,50
1650341226829,COGS 100,A01,083619,Staff,0,23,60,60
1650341232853,COGS 101A,A01,083621,Davis; Joshua Daniel,1,22,60,59
1650341238876,COGS 101B,A01,091572,Staff,1,0,60,59
1650341244901,COGS 101C,A01,083625,Delgado; Tania,18,0,30,12
1650341250928,COGS 107A,A01,083627,Boyle; Mary E. T.,0,8,60,60
1650341256961,COGS 118A,A01,083075,Staff,5,0,60,55
1650341262994,CSE 3,A50,083646,Miranda; Gregory Joseph,21,0,38,17
1650341262994,CSE 3,A51,083647,Miranda; Gregory Joseph,37,0,37,0
1650341269021,CSE 8A,A50,083650,Miranda; Gregory Joseph,0,28,40,40
1650341275044,CSE 11,A01,083080,Cao; Yingjun,0,88,40,40
1650341281067,CSE 12,A01,083652,Staff,0,12,100,100
1650341287093,CSE 15L,A01,083654,Staff,0,1,50,50
1650341287093,CSE 15L,A02,083655,Staff,3,0,50,47
1650341293121,CSE 20,A01,083657,Staff,53,0,80,27
1650341299144,CSE 30,A01,083084,Eldon; John,0,76,40,40
1650341305166,CSE 100,A01,083659,Cao; Yingjun,0,66,50,50
1650341311205,CSE 134B,A01,083661,Powell; Thomas Allan,0,31,65,65
1650341317230,CSE 140,A01,083663,Staff,0,0,75,75
1650341323261,CSE 140L,A01,083088,Eldon; John,0,6,75,75
1650341329288,CSE 175,A01,083665,Kumar; Rakesh,8,0,25,17
1650341335321,CSE 190,A00,092507,Dubnov; Shlomo,14,0,20,6
1650341341359,ECE 45,A01,083139,Staff,0,17,40,40
1650341347382,ECE 65,A50,083695,Staff,0,5,30,30
1650341353405,ECE 109,A01,091882,Touri; Behrouz,40,0,70,30
1650341359430,ECE 180,A00,083140,Abi Samra; Nicholas Camill,23,0,30,7
1650341359430,ECE 180,B00,083141,Abi Samra; Nicholas Camill,5,0,30,25
1650341365456,MATH 10A,A01,083735,Patchell; Gregory David,7,0,30,23
1650341365456,MATH 10A,A02,083736,Patchell; Gregory David,28,0,30,2
1650341365456,MATH 10A,A03,083737,Patchell; Gregory David,26,0,30,4
1650341371480,MATH 10B,A01,083207,Staff,0,7,30,30
1650341371480,MATH 10B,A02,083208,Staff,0,6,30,30
1650341371480,MATH 10B,B01,083739,Staff,17,0,30,13
1650341371480,MATH 10B,B02,083740,Staff,28,0,30,2
1650341377506,MATH 18,A01,083743,Staff,4,0,30,26
1650341377506,MATH 18,A02,083744,Staff,27,0,30,3
1650341377506,MATH 18,A03,083745,Staff,22,0,30,8
1650341377506,MATH 18,A04,083746,Staff,27,0,30,3
1650341377506,MATH 18,B01,083748,Staff,0,11,30,30
1650341377506,MATH 18,B02,083749,Staff,0,11,30,30
1650341377506,MATH 18,B03,083750,Staff,1,11,30,29
1650341377506,MATH 18,B04,083751,Staff,1,11,30,29
1650341383529,MATH 20A,A01,083754,Staff,26,0,40,14
1650341389552,MATH 20B,A01,083756,Staff,0,8,30,30
1650341389552,MATH 20B,A02,083757,Staff,0,8,30,30
1650341395599,MATH 20C,A01,083760,Staff,0,13,30,30
1650341395599,MATH 20C,A02,083761,Staff,0,13,30,30
1650341395599,MATH 20C,B01,083762,Staff,13,0,30,17
1650341395599,MATH 20C,B02,083763,Staff,28,0,30,2
1650341401627,MATH 20D,A01,083765,Staff,0,1,30,30
1650341401627,MATH 20D,A02,083766,Staff,7,0,30,23
1650341401627,MATH 20D,A03,083767,Staff,26,0,30,4
1650341407652,MATH 20E,A01,083771,Staff,5,0,30,25
1650341407652,MATH 20E,A02,083772,Staff,19,0,30,11
1650341407652,MATH 20E,B01,083773,Staff,0,0,30,30
1650341407652,MATH 20E,B02,083774,Staff,12,0,30,18
1650341413680,MATH 103A,A01,083777,Staff,0,12,30,30
1650341413680,MATH 103A,A02,083778,Staff,0,12,30,30
1650341413680,MATH 103A,B01,083779,Staff,0,13,30,30
1650341413680,MATH 103A,B02,083780,Staff,0,12,30,30
1650341419712,MATH 105,A01,085443,Staff,0,21,30,30
1650341425738,MATH 109,A01,083213,Anzaldo; Leesa B,0,6,30,30
1650341425738,MATH 109,A02,083214,Anzaldo; Leesa B,0,7,30,30
1650341425738,MATH 109,B01,083215,Anzaldo; Leesa B,0,5,30,30
1650341425738,MATH 109,B02,083216,Anzaldo; Leesa B,0,5,30,30
1650341431765,MATH 142A,A01,083219,Chow; Bennett,0,14,30,30
1650341431765,MATH 142A,A02,083220,Chow; Bennett,0,12,30,30
1650341431765,MATH 142A,B01,083221,Chow; Bennett,0,12,30,30
1650341431765,MATH 142A,B02,083222,Chow; Bennett,0,12,30,30
1650341437799,MATH 193A,A01,083224,Staff,0,5,30,30
1650341437799,MATH 193A,A02,083225,Staff,0,5,30,30
1650341437799,MATH 193A,A03,083781,Staff,0,4,30,30
1650341437799,MATH 193A,A04,083782,Staff,0,3,30,30
1650341443824,MATH 197,001,091859,McAuley; Julian John,9998,0,9999,1
1650341449875,COGS 9,A01,083615,Staff,0,15,60,60
1650341455898,COGS 11,A01,083617,Boyle; Mary E. T.,22,0,40,18
1650341461923,COGS 13,A01,083071,Staff,0,31,40,40
1650341467946,COGS 14A,A01,092681,Staff,0,19,100,100
1650341473970,COGS 14B,A01,083073,Cheng; Tzu-Han,0,10,50,50
1650341479993,COGS 17,A01,092677,Staff,25,0,75,50
1650341486016,COGS 100,A01,083619,Staff,0,23,60,60
1650341492047,COGS 101A,A01,083621,Davis; Joshua Daniel,1,22,60,59
1650341498075,COGS 101B,A01,091572,Staff,1,0,60,59
1650341504110,COGS 101C,A01,083625,Delgado; Tania,18,0,30,12
1650341510135,COGS 107A,A01,083627,Boyle; Mary E. T.,0,8,60,60
1650341516210,COGS 118A,A01,083075,Staff,5,0,60,55
1650341522235,CSE 3,A50,083646,Miranda; Gregory Joseph,21,0,38,17
1650341522235,CSE 3,A51,083647,Miranda; Gregory Joseph,37,0,37,0
1650341528257,CSE 8A,A50,083650,Miranda; Gregory Joseph,0,28,40,40
1650341534292,CSE 11,A01,083080,Cao; Yingjun,0,88,40,40
1650341540319,CSE 12,A01,083652,Staff,0,12,100,100
1650341546344,CSE 15L,A01,083654,Staff,0,1,50,50
1650341546344,CSE 15L,A02,083655,Staff,3,0,50,47
1650341552369,CSE 20,A01,083657,Staff,53,0,80,27
1650341558398,CSE 30,A01,083084,Eldon; John,0,76,40,40
1650341564424,CSE 100,A01,083659,Cao; Yingjun,0,66,50,50
1650341570448,CSE 134B,A01,083661,Powell; Thomas Allan,0,31,65,65
1650341576471,CSE 140,A01,083663,Staff,0,0,75,75
1650341582504,CSE 140L,A01,083088,Eldon; John,0,6,75,75
1650341588527,CSE 175,A01,083665,Kumar; Rakesh,8,0,25,17
1650341594553,CSE 190,A00,092507,Dubnov; Shlomo,14,0,20,6
1650341600576,ECE 45,A01,083139,Staff,0,17,40,40
1650341606601,ECE 65,A50,083695,Staff,0,5,30,30
1650341612624,ECE 109,A01,091882,Touri; Behrouz,40,0,70,30
1650341618647,ECE 180,A00,083140,Abi Samra; Nicholas Camill,23,0,30,7
1650341618647,ECE 180,B00,083141,Abi Samra; Nicholas Camill,5,0,30,25
1650341624680,MATH 10A,A01,083735,Patchell; Gregory David,7,0,30,23
1650341624680,MATH 10A,A02,083736,Patchell; Gregory David,28,0,30,2
1650341624680,MATH 10A,A03,083737,Patchell; Gregory David,26,0,30,4
1650341630706,MATH 10B,A01,083207,Staff,0,7,30,30
1650341630706,MATH 10B,A02,083208,Staff,0,6,30,30
1650341630706,MATH 10B,B01,083739,Staff,17,0,30,13
1650341630706,MATH 10B,B02,083740,Staff,28,0,30,2
1650341636736,MATH 18,A01,083743,Staff,4,0,30,26
1650341636736,MATH 18,A02,083744,Staff,27,0,30,3
1650341636736,MATH 18,A03,083745,Staff,22,0,30,8
1650341636736,MATH 18,A04,083746,Staff,27,0,30,3
1650341636736,MATH 18,B01,083748,Staff,0,11,30,30
1650341636736,MATH 18,B02,083749,Staff,0,11,30,30
1650341636736,MATH 18,B03,083750,Staff,1,11,30,29
1650341636736,MATH 18,B04,083751,Staff,1,11,30,29
1650341642770,MATH 20A,A01,083754,Staff,26,0,40,14
1650341648793,MATH 20B,A01,083756,Staff,0,8,30,30
1650341648793,MATH 20B,A02,083757,Staff,0,8,30,30
1650341654821,MATH 20C,A01,083760,Staff,0,13,30,30
1650341654821,MATH 20C,A02,083761,Staff,0,13,30,30
1650341654821,MATH 20C,B01,083762,Staff,13,0,30,17
1650341654821,MATH 20C,B02,083763,Staff,28,0,30,2
1650341660850,MATH 20D,A01,083765,Staff,0,1,30,30
1650341660850,MATH 20D,A02,083766,Staff,7,0,30,23
1650341660850,MATH 20D,A03,083767,Staff,26,0,30,4
1650341666880,MATH 20E,A01,083771,Staff,5,0,30,25
1650341666880,MATH 20E,A02,083772,Staff,19,0,30,11
1650341666880,MATH 20E,B01,083773,Staff,0,0,30,30
1650341666880,MATH 20E,B02,083774,Staff,12,0,30,18
1650341672909,MATH 103A,A01,083777,Staff,0,12,30,30
1650341672909,MATH 103A,A02,083778,Staff,0,12,30,30
1650341672909,MATH 103A,B01,083779,Staff,0,13,30,30
1650341672909,MATH 103A,B02,083780,Staff,0,12,30,30
1650341678932,MATH 105,A01,085443,Staff,0,21,30,30
1650341684955,MATH 109,A01,083213,Anzaldo; Leesa B,0,6,30,30
1650341684955,MATH 109,A02,083214,Anzaldo; Leesa B,0,7,30,30
1650341684955,MATH 109,B01,083215,Anzaldo; Leesa B,0,5,30,30
1650341684955,MATH 109,B02,083216,Anzaldo; Leesa B,0,5,30,30
1650341690991,MATH 142A,A01,083219,Chow; Bennett,0,14,30,30
1650341690991,MATH 142A,A02,083220,Chow; Bennett,0,12,30,30
1650341690991,MATH 142A,B01,083221,Chow; Bennett,0,12,30,30
1650341690991,MATH 142A,B02,083222,Chow; Bennett,0,12,30,30
1650341697020,MATH 193A,A01,083224,Staff,0,5,30,30
1650341697020,MATH 193A,A02,083225,Staff,0,5,30,30
1650341697020,MATH 193A,A03,083781,Staff,0,4,30,30
1650341697020,MATH 193A,A04,083782,Staff,0,3,30,30
1650341703048,MATH 197,001,091859,McAuley; Julian John,9998,0,9999,1
1650341709104,COGS 9,A01,083615,Staff,0,15,60,60
1650341715131,COGS 11,A01,083617,Boyle; Mary E. T.,22,0,40,18
1650341721258,COGS 13,A01,083071,Staff,0,31,40,40
1650341727282,COGS 14A,A01,092681,Staff,0,19,100,100
1650341733304,COGS 14B,A01,083073,Cheng; Tzu-Han,0,10,50,50
1650341739329,COGS 17,A01,092677,Staff,25,0,75,50
1650341745355,COGS 100,A01,083619,Staff,0,23,60,60
1650341751382,COGS 101A,A01,083621,Davis; Joshua Daniel,1,22,60,59
1650341757407,COGS 101B,A01,091572,Staff,1,0,60,59
1650341763438,COGS 101C,A01,083625,Delgado; Tania,18,0,30,12
1650341769467,COGS 107A,A01,083627,Boyle; Mary E. T.,0,8,60,60
1650341775488,COGS 118A,A01,083075,Staff,5,0,60,55
1650341781512,CSE 3,A50,083646,Miranda; Gregory Joseph,21,0,38,17
1650341781512,CSE 3,A51,083647,Miranda; Gregory Joseph,37,0,37,0
1650341787535,CSE 8A,A50,083650,Miranda; Gregory Joseph,0,28,40,40
1650341793560,CSE 11,A01,083080,Cao; Yingjun,0,88,40,40
1650341799583,CSE 12,A01,083652,Staff,0,12,100,100
1650341805605,CSE 15L,A01,083654,Staff,0,1,50,50
1650341805605,CSE 15L,A02,083655,Staff,3,0,50,47
1650341811630,CSE 20,A01,083657,Staff,53,0,80,27
1650341817653,CSE 30,A01,083084,Eldon; John,0,76,40,40
1650341823676,CSE 100,A01,083659,Cao; Yingjun,0,66,50,50
1650341829702,CSE 134B,A01,083661,Powell; Thomas Allan,0,31,65,65
1650341835724,CSE 140,A01,083663,Staff,0,0,75,75
1650341841751,CSE 140L,A01,083088,Eldon; John,0,6,75,75
1650341847775,CSE 175,A01,083665,Kumar; Rakesh,8,0,25,17
1650341853800,CSE 190,A00,092507,Dubnov; Shlomo,14,0,20,6
1650341859828,ECE 45,A01,083139,Staff,0,17,40,40
1650341865852,ECE 65,A50,083695,Staff,0,5,30,30
1650341871874,ECE 109,A01,091882,Touri; Behrouz,40,0,70,30
1650341877898,ECE 180,A00,083140,Abi Samra; Nicholas Camill,23,0,30,7
1650341877898,ECE 180,B00,083141,Abi Samra; Nicholas Camill,5,0,30,25
1650341883926,MATH 10A,A01,083735,Patchell; Gregory David,7,0,30,23
1650341883926,MATH 10A,A02,083736,Patchell; Gregory David,28,0,30,2
1650341883926,MATH 10A,A03,083737,Patchell; Gregory David,26,0,30,4
1650341889952,MATH 10B,A01,083207,Staff,0,7,30,30
1650341889952,MATH 10B,A02,083208,Staff,0,6,30,30
1650341889952,MATH 10B,B01,083739,Staff,17,0,30,13
1650341889952,MATH 10B,B02,083740,Staff,28,0,30,2
1650341895977,MATH 18,A01,083743,Staff,4,0,30,26
1650341895977,MATH 18,A02,083744,Staff,27,0,30,3
1650341895977,MATH 18,A03,083745,Staff,22,0,30,8
1650341895977,MATH 18,A04,083746,Staff,27,0,30,3
1650341895977,MATH 18,B01,083748,Staff,0,11,30,30
1650341895977,MATH 18,B02,083749,Staff,0,11,30,30
1650341895977,MATH 18,B03,083750,Staff,1,11,30,29
1650341895977,MATH 18,B04,083751,Staff,1,11,30,29
1650341902007,MATH 20A,A01,083754,Staff,26,0,40,14
1650341908031,MATH 20B,A01,083756,Staff,0,8,30,30
1650341908031,MATH 20B,A02,083757,Staff,0,8,30,30
1650341914059,MATH 20C,A01,083760,Staff,0,13,30,30
1650341914059,MATH 20C,A02,083761,Staff,0,13,30,30
1650341914059,MATH 20C,B01,083762,Staff,13,0,30,17
1650341914059,MATH 20C,B02,083763,Staff,28,0,30,2
1650341920093,MATH 20D,A01,083765,Staff,0,1,30,30
1650341920093,MATH 20D,A02,083766,Staff,7,0,30,23
1650341920093,MATH 20D,A03,083767,Staff,26,0,30,4
1650341926117,MATH 20E,A01,083771,Staff,5,0,30,25
1650341926117,MATH 20E,A02,083772,Staff,19,0,30,11
1650341926117,MATH 20E,B01,083773,Staff,0,0,30,30
1650341926117,MATH 20E,B02,083774,Staff,12,0,30,18
1650341932146,MATH 103A,A01,083777,Staff,0,12,30,30
1650341932146,MATH 103A,A02,083778,Staff,0,12,30,30
1650341932146,MATH 103A,B01,083779,Staff,0,13,30,30
1650341932146,MATH 103A,B02,083780,Staff,0,12,30,30
1650341938173,MATH 105,A01,085443,Staff,0,21,30,30
1650341944200,MATH 109,A01,083213,Anzaldo; Leesa B,0,6,30,30
1650341944200,MATH 109,A02,083214,Anzaldo; Leesa B,0,7,30,30
1650341944200,MATH 109,B01,083215,Anzaldo; Leesa B,0,5,30,30
1650341944200,MATH 109,B02,083216,Anzaldo; Leesa B,0,5,30,30
1650341950226,MATH 142A,A01,083219,Chow; Bennett,0,14,30,30
1650341950226,MATH 142A,A02,083220,Chow; Bennett,0,12,30,30
1650341950226,MATH 142A,B01,083221,Chow; Bennett,0,12,30,30
1650341950226,MATH 142A,B02,083222,Chow; Bennett,0,12,30,30
1650341956456,MATH 193A,A01,083224,Staff,0,5,30,30
1650341956456,MATH 193A,A02,083225,Staff,0,5,30,30
1650341956456,MATH 193A,A03,083781,Staff,0,4,30,30
1650341956456,MATH 193A,A04,083782,Staff,0,3,30,30
1650341962482,MATH 197,001,091859,McAuley; Julian John,9998,0,9999,1
1650341968544,COGS 9,A01,083615,Staff,0,15,60,60
1650341974571,COGS 11,A01,083617,Boyle; Mary E. T.,22,0,40,18
1650341980598,COGS 13,A01,083071,Staff,0,31,40,40
1650341986625,COGS 14A,A01,092681,Staff,0,19,100,100
1650341992651,COGS 14B,A01,083073,Cheng; Tzu-Han,0,10,50,50
1650341998690,COGS 17,A01,092677,Staff,25,0,75,50
1650342004729,COGS 100,A01,083619,Staff,0,23,60,60
1650342010762,COGS 101A,A01,083621,Davis; Joshua Daniel,1,22,60,59
1650342016785,COGS 101B,A01,091572,Staff,1,0,60,59
1650342022815,COGS 101C,A01,083625,Delgado; Tania,18,0,30,12
1650342028838,COGS 107A,A01,083627,Boyle; Mary E. T.,0,8,60,60
1650342034873,COGS 118A,A01,083075,Staff,5,0,60,55
1650342040901,CSE 3,A50,083646,Miranda; Gregory Joseph,21,0,38,17
1650342040901,CSE 3,A51,083647,Miranda; Gregory Joseph,37,0,37,0
1650342046925,CSE 8A,A50,083650,Miranda; Gregory Joseph,0,28,40,40
1650342052951,CSE 11,A01,083080,Cao; Yingjun,0,88,40,40
1650342058974,CSE 12,A01,083652,Staff,0,12,100,100
1650342065004,CSE 15L,A01,083654,Staff,0,1,50,50
1650342065004,CSE 15L,A02,083655,Staff,3,0,50,47
1650342071026,CSE 20,A01,083657,Staff,53,0,80,27
1650342077054,CSE 30,A01,083084,Eldon; John,0,76,40,40
1650342083080,CSE 100,A01,083659,Cao; Yingjun,0,66,50,50
1650342089101,CSE 134B,A01,083661,Powell; Thomas Allan,0,31,65,65
1650342095125,CSE 140,A01,083663,Staff,0,0,75,75
1650342101151,CSE 140L,A01,083088,Eldon; John,0,6,75,75
1650342107185,CSE 175,A01,083665,Kumar; Rakesh,8,0,25,17
1650342113207,CSE 190,A00,092507,Dubnov; Shlomo,14,0,20,6
1650342119231,ECE 45,A01,083139,Staff,0,17,40,40
1650342125258,ECE 65,A50,083695,Staff,0,5,30,30
1650342131288,ECE 109,A01,091882,Touri; Behrouz,40,0,70,30
1650342137313,ECE 180,A00,083140,Abi Samra; Nicholas Camill,23,0,30,7
1650342137313,ECE 180,B00,083141,Abi Samra; Nicholas Camill,5,0,30,25
1650342143340,MATH 10A,A01,083735,Patchell; Gregory David,7,0,30,23
1650342143340,MATH 10A,A02,083736,Patchell; Gregory David,28,0,30,2
1650342143340,MATH 10A,A03,083737,Patchell; Gregory David,26,0,30,4
1650342149366,MATH 10B,A01,083207,Staff,0,7,30,30
1650342149366,MATH 10B,A02,083208,Staff,0,6,30,30
1650342149366,MATH 10B,B01,083739,Staff,17,0,30,13
1650342149366,MATH 10B,B02,083740,Staff,28,0,30,2
1650342155393,MATH 18,A01,083743,Staff,4,0,30,26
1650342155393,MATH 18,A02,083744,Staff,27,0,30,3
1650342155393,MATH 18,A03,083745,Staff,22,0,30,8
1650342155393,MATH 18,A04,083746,Staff,27,0,30,3
1650342155393,MATH 18,B01,083748,Staff,0,11,30,30
1650342155393,MATH 18,B02,083749,Staff,0,11,30,30
1650342155393,MATH 18,B03,083750,Staff,1,11,30,29
1650342155393,MATH 18,B04,083751,Staff,1,11,30,29
1650342161422,MATH 20A,A01,083754,Staff,26,0,40,14
1650342167445,MATH 20B,A01,083756,Staff,0,8,30,30
1650342167445,MATH 20B,A02,083757,Staff,0,8,30,30
1650342173469,MATH 20C,A01,083760,Staff,0,13,30,30
1650342173469,MATH 20C,A02,083761,Staff,0,13,30,30
1650342173469,MATH 20C,B01,083762,Staff,13,0,30,17
1650342173469,MATH 20C,B02,083763,Staff,28,0,30,2
1650342179502,MATH 20D,A01,083765,Staff,0,1,30,30
1650342179502,MATH 20D,A02,083766,Staff,7,0,30,23
1650342179502,MATH 20D,A03,083767,Staff,26,0,30,4
1650342185529,MATH 20E,A01,083771,Staff,5,0,30,25
1650342185529,MATH 20E,A02,083772,Staff,19,0,30,11
1650342185529,MATH 20E,B01,083773,Staff,0,0,30,30
1650342185529,MATH 20E,B02,083774,Staff,12,0,30,18
1650342191560,MATH 103A,A01,083777,Staff,0,12,30,30
1650342191560,MATH 103A,A02,083778,Staff,0,12,30,30
1650342191560,MATH 103A,B01,083779,Staff,0,13,30,30
1650342191560,MATH 103A,B02,083780,Staff,0,12,30,30
1650342197586,MATH 105,A01,085443,Staff,0,21,30,30
1650342203611,MATH 109,A01,083213,Anzaldo; Leesa B,0,6,30,30
1650342203611,MATH 109,A02,083214,Anzaldo; Leesa B,0,7,30,30
1650342203611,MATH 109,B01,083215,Anzaldo; Leesa B,0,5,30,30
1650342203611,MATH 109,B02,083216,Anzaldo; Leesa B,0,5,30,30
1650342209635,MATH 142A,A01,083219,Chow; Bennett,0,14,30,30
1650342209635,MATH 142A,A02,083220,Chow; Bennett,0,12,30,30
1650342209635,MATH 142A,B01,083221,Chow; Bennett,0,12,30,30
1650342209635,MATH 142A,B02,083222,Chow; Bennett,0,12,30,30
1650342215659,MATH 193A,A01,083224,Staff,0,5,30,30
1650342215659,MATH 193A,A02,083225,Staff,0,5,30,30
1650342215659,MATH 193A,A03,083781,Staff,0,4,30,30
1650342215659,MATH 193A,A04,083782,Staff,0,3,30,30
1650342221692,MATH 197,001,091859,McAuley; Julian John,9998,0,9999,1
1650342227759,COGS 9,A01,083615,Staff,0,15,60,60
1650342233782,COGS 11,A01,083617,Boyle; Mary E. T.,22,0,40,18
1650342239805,COGS 13,A01,083071,Staff,0,31,40,40
1650342245829,COGS 14A,A01,092681,Staff,0,19,100,100
1650342251859,COGS 14B,A01,083073,Cheng; Tzu-Han,0,10,50,50
1650342257882,COGS 17,A01,092677,Staff,25,0,75,50
1650342263909,COGS 100,A01,083619,Staff,0,23,60,60
1650342269937,COGS 101A,A01,083621,Davis; Joshua Daniel,1,22,60,59
1650342275962,COGS 101B,A01,091572,Staff,1,0,60,59
1650342281988,COGS 101C,A01,083625,Delgado; Tania,18,0,30,12
1650342288014,COGS 107A,A01,083627,Boyle; Mary E. T.,0,8,60,60
1650342294038,COGS 118A,A01,083075,Staff,5,0,60,55
1650342300061,CSE 3,A50,083646,Miranda; Gregory Joseph,21,0,38,17
1650342300061,CSE 3,A51,083647,Miranda; Gregory Joseph,37,0,37,0
1650342306084,CSE 8A,A50,083650,Miranda; Gregory Joseph,0,28,40,40
1650342312110,CSE 11,A01,083080,Cao; Yingjun,0,88,40,40
1650342318223,CSE 12,A01,083652,Staff,0,12,100,100
1650342324249,CSE 15L,A01,083654,Staff,0,1,50,50
1650342324249,CSE 15L,A02,083655,Staff,3,0,50,47
1650342330282,CSE 20,A01,083657,Staff,53,0,80,27
1650342336312,CSE 30,A01,083084,Eldon; John,0,76,40,40
1650342342336,CSE 100,A01,083659,Cao; Yingjun,0,66,50,50
1650342348362,CSE 134B,A01,083661,Powell; Thomas Allan,0,31,65,65
1650342354391,CSE 140,A01,083663,Staff,0,0,75,75
1650342360415,CSE 140L,A01,083088,Eldon; John,0,6,75,75
1650342366441,CSE 175,A01,083665,Kumar; Rakesh,8,0,25,17
1650342372466,CSE 190,A00,092507,Dubnov; Shlomo,14,0,20,6
1650342378488,ECE 45,A01,083139,Staff,0,17,40,40
1650342384523,ECE 65,A50,083695,Staff,0,5,30,30
1650342390550,ECE 109,A01,091882,Touri; Behrouz,40,0,70,30
1650342396574,ECE 180,A00,083140,Abi Samra; Nicholas Camill,23,0,30,7
1650342396574,ECE 180,B00,083141,Abi Samra; Nicholas Camill,5,0,30,25
1650342402598,MATH 10A,A01,083735,Patchell; Gregory David,7,0,30,23
1650342402598,MATH 10A,A02,083736,Patchell; Gregory David,28,0,30,2
1650342402598,MATH 10A,A03,083737,Patchell; Gregory David,26,0,30,4
1650342408637,MATH 10B,A01,083207,Staff,0,7,30,30
1650342408637,MATH 10B,A02,083208,Staff,0,6,30,30
1650342408637,MATH 10B,B01,083739,Staff,17,0,30,13
1650342408637,MATH 10B,B02,083740,Staff,28,0,30,2
1650342414665,MATH 18,A01,083743,Staff,4,0,30,26
1650342414665,MATH 18,A02,083744,Staff,27,0,30,3
1650342414665,MATH 18,A03,083745,Staff,22,0,30,8
1650342414665,MATH 18,A04,083746,Staff,27,0,30,3
1650342414665,MATH 18,B01,083748,Staff,0,11,30,30
1650342414665,MATH 18,B02,083749,Staff,0,11,30,30
1650342414665,MATH 18,B03,083750,Staff,1,11,30,29
1650342414665,MATH 18,B04,083751,Staff,1,11,30,29
1650342420690,MATH 20A,A01,083754,Staff,26,0,40,14
1650342426716,MATH 20B,A01,083756,Staff,0,8,30,30
1650342426716,MATH 20B,A02,083757,Staff,0,8,30,30
1650342432740,MATH 20C,A01,083760,Staff,0,13,30,30
1650342432740,MATH 20C,A02,083761,Staff,0,13,30,30
1650342432740,MATH 20C,B01,083762,Staff,13,0,30,17
1650342432740,MATH 20C,B02,083763,Staff,28,0,30,2
1650342438764,MATH 20D,A01,083765,Staff,0,1,30,30
1650342438764,MATH 20D,A02,083766,Staff,7,0,30,23
1650342438764,MATH 20D,A03,083767,Staff,26,0,30,4
1650342444786,MATH 20E,A01,083771,Staff,5,0,30,25
1650342444786,MATH 20E,A02,083772,Staff,19,0,30,11
1650342444786,MATH 20E,B01,083773,Staff,0,0,30,30
1650342444786,MATH 20E,B02,083774,Staff,12,0,30,18
1650342450813,MATH 103A,A01,083777,Staff,0,12,30,30
1650342450813,MATH 103A,A02,083778,Staff,0,12,30,30
1650342450813,MATH 103A,B01,083779,Staff,0,13,30,30
1650342450813,MATH 103A,B02,083780,Staff,0,12,30,30
1650342456855,MATH 105,A01,085443,Staff,0,21,30,30
1650342462883,MATH 109,A01,083213,Anzaldo; Leesa B,0,6,30,30
1650342462883,MATH 109,A02,083214,Anzaldo; Leesa B,0,7,30,30
1650342462883,MATH 109,B01,083215,Anzaldo; Leesa B,0,5,30,30
1650342462883,MATH 109,B02,083216,Anzaldo; Leesa B,0,5,30,30
1650342468908,MATH 142A,A01,083219,Chow; Bennett,0,14,30,30
1650342468908,MATH 142A,A02,083220,Chow; Bennett,0,12,30,30
1650342468908,MATH 142A,B01,083221,Chow; Bennett,0,12,30,30
1650342468908,MATH 142A,B02,083222,Chow; Bennett,0,12,30,30
1650342474931,MATH 193A,A01,083224,Staff,0,5,30,30
1650342474931,MATH 193A,A02,083225,Staff,0,5,30,30
1650342474931,MATH 193A,A03,083781,Staff,0,4,30,30
1650342474931,MATH 193A,A04,083782,Staff,0,3,30,30
1650342480958,MATH 197,001,091859,McAuley; Julian John,9998,0,9999,1
1650342487021,COGS 9,A01,083615,Staff,0,15,60,60
1650342493052,COGS 11,A01,083617,Boyle; Mary E. T.,22,0,40,18
1650342499076,COGS 13,A01,083071,Staff,0,31,40,40
1650342505104,COGS 14A,A01,092681,Staff,0,19,100,100
1650342511127,COGS 14B,A01,083073,Cheng; Tzu-Han,0,10,50,50
1650342517151,COGS 17,A01,092677,Staff,25,0,75,50
1650342523177,COGS 100,A01,083619,Staff,0,23,60,60
1650342529201,COGS 101A,A01,083621,Davis; Joshua Daniel,1,22,60,59
1650342535225,COGS 101B,A01,091572,Staff,1,0,60,59
1650342541257,COGS 101C,A01,083625,Delgado; Tania,18,0,30,12
1650342547282,COGS 107A,A01,083627,Boyle; Mary E. T.,0,8,60,60
1650342553306,COGS 118A,A01,083075,Staff,5,0,60,55
1650342559343,CSE 3,A50,083646,Miranda; Gregory Joseph,21,0,38,17
1650342559343,CSE 3,A51,083647,Miranda; Gregory Joseph,37,0,37,0
1650342565366,CSE 8A,A50,083650,Miranda; Gregory Joseph,0,28,40,40
1650342571391,CSE 11,A01,083080,Cao; Yingjun,0,88,40,40
1650342577417,CSE 12,A01,083652,Staff,0,12,100,100
1650342583443,CSE 15L,A01,083654,Staff,0,1,50,50
1650342583443,CSE 15L,A02,083655,Staff,3,0,50,47
1650342589465,CSE 20,A01,083657,Staff,53,0,80,27
1650342595492,CSE 30,A01,083084,Eldon; John,0,76,40,40
1650342601514,CSE 100,A01,083659,Cao; Yingjun,0,66,50,50
1650342607540,CSE 134B,A01,083661,Powell; Thomas Allan,0,31,65,65
1650342613566,CSE 140,A01,083663,Staff,0,0,75,75
1650342619595,CSE 140L,A01,083088,Eldon; John,0,6,75,75
1650342625617,CSE 175,A01,083665,Kumar; Rakesh,8,0,25,17
1650342631643,CSE 190,A00,092507,Dubnov; Shlomo,14,0,20,6
1650342637669,ECE 45,A01,083139,Staff,0,17,40,40
1650342643695,ECE 65,A50,083695,Staff,0,5,30,30
1650342649721,ECE 109,A01,091882,Touri; Behrouz,40,0,70,30
1650342655745,ECE 180,A00,083140,Abi Samra; Nicholas Camill,23,0,30,7
1650342655745,ECE 180,B00,083141,Abi Samra; Nicholas Camill,5,0,30,25
1650342661773,MATH 10A,A01,083735,Patchell; Gregory David,7,0,30,23
1650342661773,MATH 10A,A02,083736,Patchell; Gregory David,28,0,30,2
1650342661773,MATH 10A,A03,083737,Patchell; Gregory David,26,0,30,4
1650342667799,MATH 10B,A01,083207,Staff,0,7,30,30
1650342667799,MATH 10B,A02,083208,Staff,0,6,30,30
1650342667799,MATH 10B,B01,083739,Staff,17,0,30,13
1650342667799,MATH 10B,B02,083740,Staff,28,0,30,2
1650342673823,MATH 18,A01,083743,Staff,4,0,30,26
1650342673823,MATH 18,A02,083744,Staff,27,0,30,3
1650342673823,MATH 18,A03,083745,Staff,22,0,30,8
1650342673823,MATH 18,A04,083746,Staff,27,0,30,3
1650342673823,MATH 18,B01,083748,Staff,0,11,30,30
1650342673823,MATH 18,B02,083749,Staff,0,11,30,30
1650342673823,MATH 18,B03,083750,Staff,1,11,30,29
1650342673823,MATH 18,B04,083751,Staff,1,11,30,29
1650342679851,MATH 20A,A01,083754,Staff,26,0,40,14
1650342685887,MATH 20B,A01,083756,Staff,0,8,30,30
1650342685887,MATH 20B,A02,083757,Staff,0,8,30,30
1650342691909,MATH 20C,A01,083760,Staff,0,13,30,30
1650342691909,MATH 20C,A02,083761,Staff,0,13,30,30
1650342691909,MATH 20C,B01,083762,Staff,13,0,30,17
1650342691909,MATH 20C,B02,083763,Staff,28,0,30,2
1650342697940,MATH 20D,A01,083765,Staff,0,1,30,30
1650342697940,MATH 20D,A02,083766,Staff,7,0,30,23
1650342697940,MATH 20D,A03,083767,Staff,26,0,30,4
1650342703966,MATH 20E,A01,083771,Staff,5,0,30,25
1650342703966,MATH 20E,A02,083772,Staff,19,0,30,11
1650342703966,MATH 20E,B01,083773,Staff,0,0,30,30
1650342703966,MATH 20E,B02,083774,Staff,12,0,30,18
1650342709991,MATH 103A,A01,083777,Staff,0,12,30,30
1650342709991,MATH 103A,A02,083778,Staff,0,12,30,30
1650342709991,MATH 103A,B01,083779,Staff,0,13,30,30
1650342709991,MATH 103A,B02,083780,Staff,0,12,30,30
1650342716019,MATH 105,A01,085443,Staff,0,21,30,30
1650342722042,MATH 109,A01,083213,Anzaldo; Leesa B,0,6,30,30
1650342722042,MATH 109,A02,083214,Anzaldo; Leesa B,0,7,30,30
1650342722042,MATH 109,B01,083215,Anzaldo; Leesa B,0,5,30,30
1650342722042,MATH 109,B02,083216,Anzaldo; Leesa B,0,5,30,30
1650342728067,MATH 142A,A01,083219,Chow; Bennett,0,14,30,30
1650342728067,MATH 142A,A02,083220,Chow; Bennett,0,12,30,30
1650342728067,MATH 142A,B01,083221,Chow; Bennett,0,12,30,30
1650342728067,MATH 142A,B02,083222,Chow; Bennett,0,12,30,30
1650342734095,MATH 193A,A01,083224,Staff,0,5,30,30
1650342734095,MATH 193A,A02,083225,Staff,0,5,30,30
1650342734095,MATH 193A,A03,083781,Staff,0,4,30,30
1650342734095,MATH 193A,A04,083782,Staff,0,3,30,30
1650342740118,MATH 197,001,091859,McAuley; Julian John,9998,0,9999,1
1650342746168,COGS 9,A01,083615,Staff,0,15,60,60
1650342752192,COGS 11,A01,083617,Boyle; Mary E. T.,22,0,40,18
1650342758215,COGS 13,A01,083071,Staff,0,31,40,40
1650342764240,COGS 14A,A01,092681,Staff,0,19,100,100
1650342770262,COGS 14B,A01,083073,Cheng; Tzu-Han,0,10,50,50
1650342776288,COGS 17,A01,092677,Staff,25,0,75,50
1650342782313,COGS 100,A01,083619,Staff,0,23,60,60
1650342788339,COGS 101A,A01,083621,Davis; Joshua Daniel,1,22,60,59
1650342794370,COGS 101B,A01,091572,Staff,1,0,60,59
1650342800398,COGS 101C,A01,083625,Delgado; Tania,18,0,30,12
1650342806422,COGS 107A,A01,083627,Boyle; Mary E. T.,0,8,60,60
1650342812445,COGS 118A,A01,083075,Staff,5,0,60,55
1650342818469,CSE 3,A50,083646,Miranda; Gregory Joseph,21,0,38,17
1650342818469,CSE 3,A51,083647,Miranda; Gregory Joseph,37,0,37,0
1650342824496,CSE 8A,A50,083650,Miranda; Gregory Joseph,0,28,40,40
1650342830522,CSE 11,A01,083080,Cao; Yingjun,0,88,40,40
1650342836547,CSE 12,A01,083652,Staff,0,12,100,100
1650342842570,CSE 15L,A01,083654,Staff,0,1,50,50
1650342842570,CSE 15L,A02,083655,Staff,3,0,50,47
1650342848597,CSE 20,A01,083657,Staff,53,0,80,27
1650342854624,CSE 30,A01,083084,Eldon; John,0,76,40,40
1650342860653,CSE 100,A01,083659,Cao; Yingjun,0,66,50,50
1650342866678,CSE 134B,A01,083661,Powell; Thomas Allan,0,31,65,65
1650342872702,CSE 140,A01,083663,Staff,0,0,75,75
1650342878726,CSE 140L,A01,083088,Eldon; John,0,6,75,75
1650342884749,CSE 175,A01,083665,Kumar; Rakesh,8,0,25,17
1650342890782,CSE 190,A00,092507,Dubnov; Shlomo,14,0,20,6
1650342896807,ECE 45,A01,083139,Staff,0,17,40,40
1650342902831,ECE 65,A50,083695,Staff,0,5,30,30
1650342908854,ECE 109,A01,091882,Touri; Behrouz,40,0,70,30
1650342914976,ECE 180,A00,083140,Abi Samra; Nicholas Camill,23,0,30,7
1650342914976,ECE 180,B00,083141,Abi Samra; Nicholas Camill,5,0,30,25
1650342921004,MATH 10A,A01,083735,Patchell; Gregory David,7,0,30,23
1650342921004,MATH 10A,A02,083736,Patchell; Gregory David,28,0,30,2
1650342921004,MATH 10A,A03,083737,Patchell; Gregory David,26,0,30,4
1650342927027,MATH 10B,A01,083207,Staff,0,7,30,30
1650342927027,MATH 10B,A02,083208,Staff,0,6,30,30
1650342927027,MATH 10B,B01,083739,Staff,17,0,30,13
1650342927027,MATH 10B,B02,083740,Staff,28,0,30,2
1650342933062,MATH 18,A01,083743,Staff,4,0,30,26
1650342933062,MATH 18,A02,083744,Staff,27,0,30,3
1650342933062,MATH 18,A03,083745,Staff,22,0,30,8
1650342933062,MATH 18,A04,083746,Staff,27,0,30,3
1650342933062,MATH 18,B01,083748,Staff,0,11,30,30
1650342933062,MATH 18,B02,083749,Staff,0,11,30,30
1650342933062,MATH 18,B03,083750,Staff,1,11,30,29
1650342933062,MATH 18,B04,083751,Staff,1,11,30,29
1650342939084,MATH 20A,A01,083754,Staff,26,0,40,14
1650342945107,MATH 20B,A01,083756,Staff,0,8,30,30
1650342945107,MATH 20B,A02,083757,Staff,0,8,30,30
1650342951138,MATH 20C,A01,083760,Staff,0,13,30,30
1650342951138,MATH 20C,A02,083761,Staff,0,13,30,30
1650342951138,MATH 20C,B01,083762,Staff,13,0,30,17
1650342951138,MATH 20C,B02,083763,Staff,28,0,30,2
1650342957177,MATH 20D,A01,083765,Staff,0,1,30,30
1650342957177,MATH 20D,A02,083766,Staff,7,0,30,23
1650342957177,MATH 20D,A03,083767,Staff,26,0,30,4
1650342963200,MATH 20E,A01,083771,Staff,5,0,30,25
1650342963200,MATH 20E,A02,083772,Staff,19,0,30,11
1650342963200,MATH 20E,B01,083773,Staff,0,0,30,30
1650342963200,MATH 20E,B02,083774,Staff,12,0,30,18
1650342969228,MATH 103A,A01,083777,Staff,0,12,30,30
1650342969228,MATH 103A,A02,083778,Staff,0,12,30,30
1650342969228,MATH 103A,B01,083779,Staff,0,13,30,30
1650342969228,MATH 103A,B02,083780,Staff,0,12,30,30
1650342975253,MATH 105,A01,085443,Staff,0,21,30,30
1650342981285,MATH 109,A01,083213,Anzaldo; Leesa B,0,6,30,30
1650342981285,MATH 109,A02,083214,Anzaldo; Leesa B,0,7,30,30
1650342981285,MATH 109,B01,083215,Anzaldo; Leesa B,0,5,30,30
1650342981285,MATH 109,B02,083216,Anzaldo; Leesa B,0,5,30,30
1650342987317,MATH 142A,A01,083219,Chow; Bennett,0,14,30,30
1650342987317,MATH 142A,A02,083220,Chow; Bennett,0,12,30,30
1650342987317,MATH 142A,B01,083221,Chow; Bennett,0,12,30,30
1650342987317,MATH 142A,B02,083222,Chow; Bennett,0,12,30,30
1650342993349,MATH 193A,A01,083224,Staff,0,5,30,30
1650342993349,MATH 193A,A02,083225,Staff,0,5,30,30
1650342993349,MATH 193A,A03,083781,Staff,0,4,30,30
1650342993349,MATH 193A,A04,083782,Staff,0,3,30,30
1650342999373,MATH 197,001,091859,McAuley; Julian John,9998,0,9999,1
1650343005433,COGS 9,A01,083615,Staff,0,15,60,60
1650343011460,COGS 11,A01,083617,Boyle; Mary E. T.,22,0,40,18
1650343017484,COGS 13,A01,083071,Staff,0,31,40,40
1650343023505,COGS 14A,A01,092681,Staff,0,19,100,100
1650343029528,COGS 14B,A01,083073,Cheng; Tzu-Han,0,10,50,50
1650343035554,COGS 17,A01,092677,Staff,25,0,75,50
1650343041575,COGS 100,A01,083619,Staff,0,23,60,60
1650343047598,COGS 101A,A01,083621,Davis; Joshua Daniel,1,22,60,59
1650343053621,COGS 101B,A01,091572,Staff,1,0,60,59
1650343059651,COGS 101C,A01,083625,Delgado; Tania,18,0,30,12
1650343065679,COGS 107A,A01,083627,Boyle; Mary E. T.,0,9,60,60
1650343071704,COGS 118A,A01,083075,Staff,5,0,60,55
1650343077747,CSE 3,A50,083646,Miranda; Gregory Joseph,21,0,38,17
1650343077747,CSE 3,A51,083647,Miranda; Gregory Joseph,37,0,37,0
1650343083771,CSE 8A,A50,083650,Miranda; Gregory Joseph,0,28,40,40
1650343089795,CSE 11,A01,083080,Cao; Yingjun,0,88,40,40
1650343095818,CSE 12,A01,083652,Staff,0,12,100,100
1650343101842,CSE 15L,A01,083654,Staff,0,1,50,50
1650343101842,CSE 15L,A02,083655,Staff,3,0,50,47
1650343107868,CSE 20,A01,083657,Staff,53,0,80,27
1650343113891,CSE 30,A01,083084,Eldon; John,0,76,40,40
1650343119915,CSE 100,A01,083659,Cao; Yingjun,0,66,50,50
1650343125940,CSE 134B,A01,083661,Powell; Thomas Allan,0,31,65,65
1650343131966,CSE 140,A01,083663,Staff,0,0,75,75
1650343137990,CSE 140L,A01,083088,Eldon; John,0,6,75,75
1650343144017,CSE 175,A01,083665,Kumar; Rakesh,8,0,25,17
1650343150040,CSE 190,A00,092507,Dubnov; Shlomo,14,0,20,6
1650343156069,ECE 45,A01,083139,Staff,0,17,40,40
1650343162095,ECE 65,A50,083695,Staff,0,5,30,30
1650343168119,ECE 109,A01,091882,Touri; Behrouz,40,0,70,30
1650343174150,ECE 180,A00,083140,Abi Samra; Nicholas Camill,23,0,30,7
1650343174150,ECE 180,B00,083141,Abi Samra; Nicholas Camill,5,0,30,25
1650343180173,MATH 10A,A01,083735,Patchell; Gregory David,7,0,30,23
1650343180173,MATH 10A,A02,083736,Patchell; Gregory David,28,0,30,2
1650343180173,MATH 10A,A03,083737,Patchell; Gregory David,26,0,30,4
1650343186204,MATH 10B,A01,083207,Staff,0,7,30,30
1650343186204,MATH 10B,A02,083208,Staff,0,6,30,30
1650343186204,MATH 10B,B01,083739,Staff,17,0,30,13
1650343186204,MATH 10B,B02,083740,Staff,28,0,30,2
1650343192234,MATH 18,A01,083743,Staff,4,0,30,26
1650343192234,MATH 18,A02,083744,Staff,27,0,30,3
1650343192234,MATH 18,A03,083745,Staff,22,0,30,8
1650343192234,MATH 18,A04,083746,Staff,27,0,30,3
1650343192234,MATH 18,B01,083748,Staff,0,11,30,30
1650343192234,MATH 18,B02,083749,Staff,0,11,30,30
1650343192234,MATH 18,B03,083750,Staff,1,11,30,29
1650343192234,MATH 18,B04,083751,Staff,1,11,30,29
1650343198257,MATH 20A,A01,083754,Staff,26,0,40,14
1650343204280,MATH 20B,A01,083756,Staff,0,8,30,30
1650343204280,MATH 20B,A02,083757,Staff,0,8,30,30
1650343210309,MATH 20C,A01,083760,Staff,0,13,30,30
1650343210309,MATH 20C,A02,083761,Staff,0,13,30,30
1650343210309,MATH 20C,B01,083762,Staff,13,0,30,17
1650343210309,MATH 20C,B02,083763,Staff,28,0,30,2
1650343216337,MATH 20D,A01,083765,Staff,0,1,30,30
1650343216337,MATH 20D,A02,083766,Staff,7,0,30,23
1650343216337,MATH 20D,A03,083767,Staff,26,0,30,4
1650343222361,MATH 20E,A01,083771,Staff,5,0,30,25
1650343222361,MATH 20E,A02,083772,Staff,19,0,30,11
1650343222361,MATH 20E,B01,083773,Staff,0,0,30,30
1650343222361,MATH 20E,B02,083774,Staff,12,0,30,18
1650343228389,MATH 103A,A01,083777,Staff,0,12,30,30
1650343228389,MATH 103A,A02,083778,Staff,0,12,30,30
1650343228389,MATH 103A,B01,083779,Staff,0,13,30,30
1650343228389,MATH 103A,B02,083780,Staff,0,12,30,30
1650343234415,MATH 105,A01,085443,Staff,0,21,30,30
1650343240448,MATH 109,A01,083213,Anzaldo; Leesa B,0,6,30,30
1650343240448,MATH 109,A02,083214,Anzaldo; Leesa B,0,7,30,30
1650343240448,MATH 109,B01,083215,Anzaldo; Leesa B,0,5,30,30
1650343240448,MATH 109,B02,083216,Anzaldo; Leesa B,0,5,30,30
1650343246471,MATH 142A,A01,083219,Chow; Bennett,0,14,30,30
1650343246471,MATH 142A,A02,083220,Chow; Bennett,0,12,30,30
1650343246471,MATH 142A,B01,083221,Chow; Bennett,0,12,30,30
1650343246471,MATH 142A,B02,083222,Chow; Bennett,0,12,30,30
1650343252496,MATH 193A,A01,083224,Staff,0,5,30,30
1650343252496,MATH 193A,A02,083225,Staff,0,5,30,30
1650343252496,MATH 193A,A03,083781,Staff,0,4,30,30
1650343252496,MATH 193A,A04,083782,Staff,0,3,30,30
1650343258522,MATH 197,001,091859,McAuley; Julian John,9998,0,9999,1
1650343264579,COGS 9,A01,083615,Staff,0,15,60,60
1650343270600,COGS 11,A01,083617,Boyle; Mary E. T.,22,0,40,18
1650343276625,COGS 13,A01,083071,Staff,0,31,40,40
1650343282654,COGS 14A,A01,092681,Staff,0,19,100,100
1650343288677,COGS 14B,A01,083073,Cheng; Tzu-Han,0,10,50,50
1650343294709,COGS 17,A01,092677,Staff,25,0,75,50
1650343300734,COGS 100,A01,083619,Staff,0,23,60,60
1650343306761,COGS 101A,A01,083621,Davis; Joshua Daniel,1,22,60,59
1650343312786,COGS 101B,A01,091572,Staff,1,0,60,59
1650343318810,COGS 101C,A01,083625,Delgado; Tania,18,0,30,12
1650343324837,COGS 107A,A01,083627,Boyle; Mary E. T.,0,9,60,60
1650343330870,COGS 118A,A01,083075,Staff,5,0,60,55
1650343336900,CSE 3,A50,083646,Miranda; Gregory Joseph,21,0,38,17
1650343336900,CSE 3,A51,083647,Miranda; Gregory Joseph,37,0,37,0
1650343342936,CSE 8A,A50,083650,Miranda; Gregory Joseph,0,28,40,40
1650343348965,CSE 11,A01,083080,Cao; Yingjun,0,88,40,40
1650343354989,CSE 12,A01,083652,Staff,0,12,100,100
1650343361016,CSE 15L,A01,083654,Staff,0,1,50,50
1650343361016,CSE 15L,A02,083655,Staff,3,0,50,47
1650343367038,CSE 20,A01,083657,Staff,53,0,80,27
1650343373059,CSE 30,A01,083084,Eldon; John,0,76,40,40
1650343379082,CSE 100,A01,083659,Cao; Yingjun,0,66,50,50
1650343385107,CSE 134B,A01,083661,Powell; Thomas Allan,0,31,65,65
1650343391132,CSE 140,A01,083663,Staff,0,0,75,75
1650343397158,CSE 140L,A01,083088,Eldon; John,0,6,75,75
1650343403183,CSE 175,A01,083665,Kumar; Rakesh,8,0,25,17
1650343409210,CSE 190,A00,092507,Dubnov; Shlomo,14,0,20,6
1650343415241,ECE 45,A01,083139,Staff,0,17,40,40
1650343421278,ECE 65,A50,083695,Staff,0,5,30,30
1650343427301,ECE 109,A01,091882,Touri; Behrouz,40,0,70,30
1650343433325,ECE 180,A00,083140,Abi Samra; Nicholas Camill,23,0,30,7
1650343433325,ECE 180,B00,083141,Abi Samra; Nicholas Camill,5,0,30,25
1650343439348,MATH 10A,A01,083735,Patchell; Gregory David,7,0,30,23
1650343439348,MATH 10A,A02,083736,Patchell; Gregory David,28,0,30,2
1650343439348,MATH 10A,A03,083737,Patchell; Gregory David,26,0,30,4
1650343445374,MATH 10B,A01,083207,Staff,0,7,30,30
1650343445374,MATH 10B,A02,083208,Staff,0,6,30,30
1650343445374,MATH 10B,B01,083739,Staff,17,0,30,13
1650343445374,MATH 10B,B02,083740,Staff,28,0,30,2
1650343451411,MATH 18,A01,083743,Staff,4,0,30,26
1650343451411,MATH 18,A02,083744,Staff,27,0,30,3
1650343451411,MATH 18,A03,083745,Staff,22,0,30,8
1650343451411,MATH 18,A04,083746,Staff,27,0,30,3
1650343451411,MATH 18,B01,083748,Staff,0,11,30,30
1650343451411,MATH 18,B02,083749,Staff,0,11,30,30
1650343451411,MATH 18,B03,083750,Staff,1,11,30,29
1650343451411,MATH 18,B04,083751,Staff,1,11,30,29
1650343457432,MATH 20A,A01,083754,Staff,26,0,40,14
1650343463455,MATH 20B,A01,083756,Staff,0,8,30,30
1650343463455,MATH 20B,A02,083757,Staff,0,8,30,30
1650343469478,MATH 20C,A01,083760,Staff,0,13,30,30
1650343469478,MATH 20C,A02,083761,Staff,0,13,30,30
1650343469478,MATH 20C,B01,083762,Staff,13,0,30,17
1650343469478,MATH 20C,B02,083763,Staff,28,0,30,2
1650343475504,MATH 20D,A01,083765,Staff,0,1,30,30
1650343475504,MATH 20D,A02,083766,Staff,7,0,30,23
1650343475504,MATH 20D,A03,083767,Staff,26,0,30,4
1650343481528,MATH 20E,A01,083771,Staff,5,0,30,25
1650343481528,MATH 20E,A02,083772,Staff,19,0,30,11
1650343481528,MATH 20E,B01,083773,Staff,0,0,30,30
1650343481528,MATH 20E,B02,083774,Staff,12,0,30,18
1650343487554,MATH 103A,A01,083777,Staff,0,12,30,30
1650343487554,MATH 103A,A02,083778,Staff,0,12,30,30
1650343487554,MATH 103A,B01,083779,Staff,0,13,30,30
1650343487554,MATH 103A,B02,083780,Staff,0,12,30,30
1650343493580,MATH 105,A01,085443,Staff,0,21,30,30
1650343499606,MATH 109,A01,083213,Anzaldo; Leesa B,0,6,30,30
1650343499606,MATH 109,A02,083214,Anzaldo; Leesa B,0,7,30,30
1650343499606,MATH 109,B01,083215,Anzaldo; Leesa B,0,5,30,30
1650343499606,MATH 109,B02,083216,Anzaldo; Leesa B,0,5,30,30
1650343505634,MATH 142A,A01,083219,Chow; Bennett,0,14,30,30
1650343505634,MATH 142A,A02,083220,Chow; Bennett,0,12,30,30
1650343505634,MATH 142A,B01,083221,Chow; Bennett,0,12,30,30
1650343505634,MATH 142A,B02,083222,Chow; Bennett,0,12,30,30
1650343511761,MATH 193A,A01,083224,Staff,0,5,30,30
1650343511761,MATH 193A,A02,083225,Staff,0,5,30,30
1650343511761,MATH 193A,A03,083781,Staff,0,4,30,30
1650343511761,MATH 193A,A04,083782,Staff,0,3,30,30
1650343517783,MATH 197,001,091859,McAuley; Julian John,9998,0,9999,1
1650343523844,COGS 9,A01,083615,Staff,0,15,60,60
1650343529865,COGS 11,A01,083617,Boyle; Mary E. T.,22,0,40,18
1650343535888,COGS 13,A01,083071,Staff,0,31,40,40
1650343541913,COGS 14A,A01,092681,Staff,0,19,100,100
1650343547936,COGS 14B,A01,083073,Cheng; Tzu-Han,0,10,50,50
1650343553968,COGS 17,A01,092677,Staff,25,0,75,50
1650343559993,COGS 100,A01,083619,Staff,0,23,60,60
1650343566022,COGS 101A,A01,083621,Davis; Joshua Daniel,1,22,60,59
1650343572049,COGS 101B,A01,091572,Staff,1,0,60,59
1650343578076,COGS 101C,A01,083625,Delgado; Tania,18,0,30,12
1650343584100,COGS 107A,A01,083627,Boyle; Mary E. T.,0,9,60,60
1650343590123,COGS 118A,A01,083075,Staff,5,0,60,55
1650343596152,CSE 3,A50,083646,Miranda; Gregory Joseph,21,0,38,17
1650343596152,CSE 3,A51,083647,Miranda; Gregory Joseph,37,0,37,0
1650343602179,CSE 8A,A50,083650,Miranda; Gregory Joseph,0,28,40,40
1650343608202,CSE 11,A01,083080,Cao; Yingjun,0,88,40,40
1650343614225,CSE 12,A01,083652,Staff,0,13,100,100
1650343620247,CSE 15L,A01,083654,Staff,0,1,50,50
1650343620247,CSE 15L,A02,083655,Staff,3,0,50,47
1650343626270,CSE 20,A01,083657,Staff,53,0,80,27
1650343632293,CSE 30,A01,083084,Eldon; John,0,76,40,40
1650343638318,CSE 100,A01,083659,Cao; Yingjun,0,66,50,50
1650343644341,CSE 134B,A01,083661,Powell; Thomas Allan,0,31,65,65
1650343650368,CSE 140,A01,083663,Staff,0,0,75,75
1650343656390,CSE 140L,A01,083088,Eldon; John,0,6,75,75
1650343662411,CSE 175,A01,083665,Kumar; Rakesh,8,0,25,17
1650343668436,CSE 190,A00,092507,Dubnov; Shlomo,14,0,20,6
1650343674460,ECE 45,A01,083139,Staff,0,17,40,40
1650343680483,ECE 65,A50,083695,Staff,0,5,30,30
1650343686512,ECE 109,A01,091882,Touri; Behrouz,40,0,70,30
1650343692537,ECE 180,A00,083140,Abi Samra; Nicholas Camill,23,0,30,7
1650343692537,ECE 180,B00,083141,Abi Samra; Nicholas Camill,5,0,30,25
1650343698563,MATH 10A,A01,083735,Patchell; Gregory David,7,0,30,23
1650343698563,MATH 10A,A02,083736,Patchell; Gregory David,28,0,30,2
1650343698563,MATH 10A,A03,083737,Patchell; Gregory David,26,0,30,4
1650343704586,MATH 10B,A01,083207,Staff,0,7,30,30
1650343704586,MATH 10B,A02,083208,Staff,0,6,30,30
1650343704586,MATH 10B,B01,083739,Staff,17,0,30,13
1650343704586,MATH 10B,B02,083740,Staff,28,0,30,2
1650343710611,MATH 18,A01,083743,Staff,4,0,30,26
1650343710611,MATH 18,A02,083744,Staff,27,0,30,3
1650343710611,MATH 18,A03,083745,Staff,22,0,30,8
1650343710611,MATH 18,A04,083746,Staff,27,0,30,3
1650343710611,MATH 18,B01,083748,Staff,0,11,30,30
1650343710611,MATH 18,B02,083749,Staff,0,11,30,30
1650343710611,MATH 18,B03,083750,Staff,1,11,30,29
1650343710611,MATH 18,B04,083751,Staff,1,11,30,29
1650343716637,MATH 20A,A01,083754,Staff,26,0,40,14
1650343722659,MATH 20B,A01,083756,Staff,0,8,30,30
1650343722659,MATH 20B,A02,083757,Staff,0,8,30,30
1650343728684,MATH 20C,A01,083760,Staff,0,13,30,30
1650343728684,MATH 20C,A02,083761,Staff,0,13,30,30
1650343728684,MATH 20C,B01,083762,Staff,13,0,30,17
1650343728684,MATH 20C,B02,083763,Staff,28,0,30,2
1650343734710,MATH 20D,A01,083765,Staff,0,1,30,30
1650343734710,MATH 20D,A02,083766,Staff,7,0,30,23
1650343734710,MATH 20D,A03,083767,Staff,26,0,30,4
1650343740732,MATH 20E,A01,083771,Staff,5,0,30,25
1650343740732,MATH 20E,A02,083772,Staff,19,0,30,11
1650343740732,MATH 20E,B01,083773,Staff,0,0,30,30
1650343740732,MATH 20E,B02,083774,Staff,12,0,30,18
1650343746759,MATH 103A,A01,083777,Staff,0,12,30,30
1650343746759,MATH 103A,A02,083778,Staff,0,12,30,30
1650343746759,MATH 103A,B01,083779,Staff,0,13,30,30
1650343746759,MATH 103A,B02,083780,Staff,0,12,30,30
1650343752782,MATH 105,A01,085443,Staff,0,21,30,30
1650343758809,MATH 109,A01,083213,Anzaldo; Leesa B,0,6,30,30
1650343758809,MATH 109,A02,083214,Anzaldo; Leesa B,0,7,30,30
1650343758809,MATH 109,B01,083215,Anzaldo; Leesa B,0,5,30,30
1650343758809,MATH 109,B02,083216,Anzaldo; Leesa B,0,5,30,30
1650343764837,MATH 142A,A01,083219,Chow; Bennett,0,14,30,30
1650343764837,MATH 142A,A02,083220,Chow; Bennett,0,12,30,30
1650343764837,MATH 142A,B01,083221,Chow; Bennett,0,12,30,30
1650343764837,MATH 142A,B02,083222,Chow; Bennett,0,12,30,30
1650343770869,MATH 193A,A01,083224,Staff,0,5,30,30
1650343770869,MATH 193A,A02,083225,Staff,0,5,30,30
1650343770869,MATH 193A,A03,083781,Staff,0,4,30,30
1650343770869,MATH 193A,A04,083782,Staff,0,3,30,30
1650343776892,MATH 197,001,091859,McAuley; Julian John,9998,0,9999,1
1650343782957,COGS 9,A01,083615,Staff,0,15,60,60
1650343788987,COGS 11,A01,083617,Boyle; Mary E. T.,22,0,40,18
1650343795013,COGS 13,A01,083071,Staff,0,31,40,40
1650343801039,COGS 14A,A01,092681,Staff,0,19,100,100
1650343807061,COGS 14B,A01,083073,Cheng; Tzu-Han,0,10,50,50
1650343813085,COGS 17,A01,092677,Staff,25,0,75,50
1650343819111,COGS 100,A01,083619,Staff,0,23,60,60
1650343825145,COGS 101A,A01,083621,Davis; Joshua Daniel,1,22,60,59
1650343831171,COGS 101B,A01,091572,Staff,0,0,60,60
1650343837198,COGS 101C,A01,083625,Delgado; Tania,18,0,30,12
1650343843221,COGS 107A,A01,083627,Boyle; Mary E. T.,0,9,60,60
1650343849242,COGS 118A,A01,083075,Staff,5,0,60,55
1650343855269,CSE 3,A50,083646,Miranda; Gregory Joseph,21,0,38,17
1650343855269,CSE 3,A51,083647,Miranda; Gregory Joseph,37,0,37,0
1650343861293,CSE 8A,A50,083650,Miranda; Gregory Joseph,0,28,40,40
1650343867314,CSE 11,A01,083080,Cao; Yingjun,0,88,40,40
1650343873340,CSE 12,A01,083652,Staff,0,12,100,100
1650343879365,CSE 15L,A01,083654,Staff,0,1,50,50
1650343879365,CSE 15L,A02,083655,Staff,3,0,50,47
1650343885388,CSE 20,A01,083657,Staff,53,0,80,27
1650343891426,CSE 30,A01,083084,Eldon; John,0,76,40,40
1650343897448,CSE 100,A01,083659,Cao; Yingjun,0,66,50,50
1650343903471,CSE 134B,A01,083661,Powell; Thomas Allan,0,31,65,65
1650343909495,CSE 140,A01,083663,Staff,0,0,75,75
1650343915525,CSE 140L,A01,083088,Eldon; John,0,6,75,75
1650343921551,CSE 175,A01,083665,Kumar; Rakesh,8,0,25,17
1650343927575,CSE 190,A00,092507,Dubnov; Shlomo,14,0,20,6
1650343933602,ECE 45,A01,083139,Staff,0,17,40,40
1650343939628,ECE 65,A50,083695,Staff,0,5,30,30
1650343945653,ECE 109,A01,091882,Touri; Behrouz,40,0,70,30
1650343951677,ECE 180,A00,083140,Abi Samra; Nicholas Camill,23,0,30,7
1650343951677,ECE 180,B00,083141,Abi Samra; Nicholas Camill,5,0,30,25
1650343957704,MATH 10A,A01,083735,Patchell; Gregory David,7,0,30,23
1650343957704,MATH 10A,A02,083736,Patchell; Gregory David,28,0,30,2
1650343957704,MATH 10A,A03,083737,Patchell; Gregory David,26,0,30,4
1650343963738,MATH 10B,A01,083207,Staff,0,7,30,30
1650343963738,MATH 10B,A02,083208,Staff,0,6,30,30
1650343963738,MATH 10B,B01,083739,Staff,17,0,30,13
1650343963738,MATH 10B,B02,083740,Staff,28,0,30,2
1650343969762,MATH 18,A01,083743,Staff,4,0,30,26
1650343969762,MATH 18,A02,083744,Staff,27,0,30,3
1650343969762,MATH 18,A03,083745,Staff,22,0,30,8
1650343969762,MATH 18,A04,083746,Staff,27,0,30,3
1650343969762,MATH 18,B01,083748,Staff,0,11,30,30
1650343969762,MATH 18,B02,083749,Staff,0,11,30,30
1650343969762,MATH 18,B03,083750,Staff,1,11,30,29
1650343969762,MATH 18,B04,083751,Staff,1,11,30,29
1650343975785,MATH 20A,A01,083754,Staff,26,0,40,14
1650343981809,MATH 20B,A01,083756,Staff,0,8,30,30
1650343981809,MATH 20B,A02,083757,Staff,0,8,30,30
1650343987835,MATH 20C,A01,083760,Staff,0,14,30,30
1650343987835,MATH 20C,A02,083761,Staff,0,13,30,30
1650343987835,MATH 20C,B01,083762,Staff,13,0,30,17
1650343987835,MATH 20C,B02,083763,Staff,28,0,30,2
1650343993859,MATH 20D,A01,083765,Staff,0,1,30,30
1650343993859,MATH 20D,A02,083766,Staff,7,0,30,23
1650343993859,MATH 20D,A03,083767,Staff,26,0,30,4
1650343999883,MATH 20E,A01,083771,Staff,5,0,30,25
1650343999883,MATH 20E,A02,083772,Staff,19,0,30,11
1650343999883,MATH 20E,B01,083773,Staff,0,0,30,30
1650343999883,MATH 20E,B02,083774,Staff,12,0,30,18
1650344005917,MATH 103A,A01,083777,Staff,0,11,30,30
1650344005917,MATH 103A,A02,083778,Staff,0,12,30,30
1650344005917,MATH 103A,B01,083779,Staff,0,13,30,30
1650344005917,MATH 103A,B02,083780,Staff,0,12,30,30
1650344011948,MATH 105,A01,085443,Staff,0,21,30,30
1650344017973,MATH 109,A01,083213,Anzaldo; Leesa B,0,6,30,30
1650344017973,MATH 109,A02,083214,Anzaldo; Leesa B,0,7,30,30
1650344017973,MATH 109,B01,083215,Anzaldo; Leesa B,0,5,30,30
1650344017973,MATH 109,B02,083216,Anzaldo; Leesa B,0,5,30,30
1650344024002,MATH 142A,A01,083219,Chow; Bennett,0,14,30,30
1650344024002,MATH 142A,A02,083220,Chow; Bennett,0,12,30,30
1650344024002,MATH 142A,B01,083221,Chow; Bennett,0,12,30,30
1650344024002,MATH 142A,B02,083222,Chow; Bennett,0,12,30,30
1650344030026,MATH 193A,A01,083224,Staff,0,5,30,30
1650344030026,MATH 193A,A02,083225,Staff,0,5,30,30
1650344030026,MATH 193A,A03,083781,Staff,0,4,30,30
1650344030026,MATH 193A,A04,083782,Staff,0,3,30,30
1650344036052,MATH 197,001,091859,McAuley; Julian John,9998,0,9999,1
1650344042104,COGS 9,A01,083615,Staff,0,15,60,60
1650344048127,COGS 11,A01,083617,Boyle; Mary E. T.,22,0,40,18
1650344054150,COGS 13,A01,083071,Staff,0,31,40,40
1650344060173,COGS 14A,A01,092681,Staff,0,19,100,100
1650344066199,COGS 14B,A01,083073,Cheng; Tzu-Han,0,10,50,50
1650344072221,COGS 17,A01,092677,Staff,25,0,75,50
1650344078246,COGS 100,A01,083619,Staff,0,23,60,60
1650344084273,COGS 101A,A01,083621,Davis; Joshua Daniel,1,22,60,59
1650344090296,COGS 101B,A01,091572,Staff,0,0,60,60
1650344096320,COGS 101C,A01,083625,Delgado; Tania,18,0,30,12
1650344102436,COGS 107A,A01,083627,Boyle; Mary E. T.,0,9,60,60
1650344108460,COGS 118A,A01,083075,Staff,5,0,60,55
1650344114491,CSE 3,A50,083646,Miranda; Gregory Joseph,21,0,38,17
1650344114491,CSE 3,A51,083647,Miranda; Gregory Joseph,37,0,37,0
1650344120519,CSE 8A,A50,083650,Miranda; Gregory Joseph,0,28,40,40
1650344126542,CSE 11,A01,083080,Cao; Yingjun,0,88,40,40
1650344132574,CSE 12,A01,083652,Staff,0,12,100,100
1650344138603,CSE 15L,A01,083654,Staff,0,1,50,50
1650344138603,CSE 15L,A02,083655,Staff,3,0,50,47
1650344144628,CSE 20,A01,083657,Staff,53,0,80,27
1650344150650,CSE 30,A01,083084,Eldon; John,0,76,40,40
1650344156673,CSE 100,A01,083659,Cao; Yingjun,0,66,50,50
1650344162696,CSE 134B,A01,083661,Powell; Thomas Allan,0,31,65,65
1650344168722,CSE 140,A01,083663,Staff,0,0,75,75
1650344174753,CSE 140L,A01,083088,Eldon; John,0,6,75,75
1650344180779,CSE 175,A01,083665,Kumar; Rakesh,8,0,25,17
1650344186806,CSE 190,A00,092507,Dubnov; Shlomo,14,0,20,6
1650344192833,ECE 45,A01,083139,Staff,0,17,40,40
1650344198857,ECE 65,A50,083695,Staff,0,5,30,30
1650344204883,ECE 109,A01,091882,Touri; Behrouz,40,0,70,30
1650344210910,ECE 180,A00,083140,Abi Samra; Nicholas Camill,23,0,30,7
1650344210910,ECE 180,B00,083141,Abi Samra; Nicholas Camill,5,0,30,25
1650344216941,MATH 10A,A01,083735,Patchell; Gregory David,7,0,30,23
1650344216941,MATH 10A,A02,083736,Patchell; Gregory David,28,0,30,2
1650344216941,MATH 10A,A03,083737,Patchell; Gregory David,26,0,30,4
1650344222973,MATH 10B,A01,083207,Staff,0,7,30,30
1650344222973,MATH 10B,A02,083208,Staff,0,6,30,30
1650344222973,MATH 10B,B01,083739,Staff,17,0,30,13
1650344222973,MATH 10B,B02,083740,Staff,28,0,30,2
1650344238453,MATH 18,A01,083743,Staff,4,0,30,26
1650344238453,MATH 18,A02,083744,Staff,27,0,30,3
1650344238453,MATH 18,A03,083745,Staff,22,0,30,8
1650344238453,MATH 18,A04,083746,Staff,27,0,30,3
1650344238453,MATH 18,B01,083748,Staff,0,11,30,30
1650344238453,MATH 18,B02,083749,Staff,0,11,30,30
1650344238453,MATH 18,B03,083750,Staff,1,11,30,29
1650344238453,MATH 18,B04,083751,Staff,1,11,30,29
1650344244480,MATH 20A,A01,083754,Staff,26,0,40,14
1650344250503,MATH 20B,A01,083756,Staff,0,8,30,30
1650344250503,MATH 20B,A02,083757,Staff,0,8,30,30
1650344256529,MATH 20C,A01,083760,Staff,0,14,30,30
1650344256529,MATH 20C,A02,083761,Staff,0,13,30,30
1650344256529,MATH 20C,B01,083762,Staff,13,0,30,17
1650344256529,MATH 20C,B02,083763,Staff,28,0,30,2
1650344262552,MATH 20D,A01,083765,Staff,0,1,30,30
1650344262552,MATH 20D,A02,083766,Staff,7,0,30,23
1650344262552,MATH 20D,A03,083767,Staff,26,0,30,4
1650344268578,MATH 20E,A01,083771,Staff,5,0,30,25
1650344268578,MATH 20E,A02,083772,Staff,19,0,30,11
1650344268578,MATH 20E,B01,083773,Staff,0,0,30,30
1650344268578,MATH 20E,B02,083774,Staff,12,0,30,18
1650344274611,MATH 103A,A01,083777,Staff,0,11,30,30
1650344274611,MATH 103A,A02,083778,Staff,0,12,30,30
1650344274611,MATH 103A,B01,083779,Staff,0,13,30,30
1650344274611,MATH 103A,B02,083780,Staff,0,12,30,30
1650344280637,MATH 105,A01,085443,Staff,0,21,30,30
1650344286664,MATH 109,A01,083213,Anzaldo; Leesa B,0,6,30,30
1650344286664,MATH 109,A02,083214,Anzaldo; Leesa B,0,7,30,30
1650344286664,MATH 109,B01,083215,Anzaldo; Leesa B,0,5,30,30
1650344286664,MATH 109,B02,083216,Anzaldo; Leesa B,0,5,30,30
1650344292690,MATH 142A,A01,083219,Chow; Bennett,0,14,30,30
1650344292690,MATH 142A,A02,083220,Chow; Bennett,0,12,30,30
1650344292690,MATH 142A,B01,083221,Chow; Bennett,0,12,30,30
1650344292690,MATH 142A,B02,083222,Chow; Bennett,0,12,30,30
1650344298714,MATH 193A,A01,083224,Staff,0,5,30,30
1650344298714,MATH 193A,A02,083225,Staff,0,5,30,30
1650344298714,MATH 193A,A03,083781,Staff,0,4,30,30
1650344298714,MATH 193A,A04,083782,Staff,0,3,30,30
1650344304737,MATH 197,001,091859,McAuley; Julian John,9998,0,9999,1
1650344310817,COGS 9,A01,083615,Staff,0,15,60,60
1650344316846,COGS 11,A01,083617,Boyle; Mary E. T.,22,0,40,18
1650344322868,COGS 13,A01,083071,Staff,0,31,40,40
1650344328891,COGS 14A,A01,092681,Staff,0,19,100,100
1650344334916,COGS 14B,A01,083073,Cheng; Tzu-Han,0,10,50,50
1650344340943,COGS 17,A01,092677,Staff,25,0,75,50
1650344346965,COGS 100,A01,083619,Staff,0,23,60,60
1650344352991,COGS 101A,A01,083621,Davis; Joshua Daniel,1,22,60,59
1650344359018,COGS 101B,A01,091572,Staff,0,0,60,60
1650344365042,COGS 101C,A01,083625,Delgado; Tania,18,0,30,12
1650344371069,COGS 107A,A01,083627,Boyle; Mary E. T.,0,9,60,60
1650344377098,COGS 118A,A01,083075,Staff,4,0,60,56
1650344383123,CSE 3,A50,083646,Miranda; Gregory Joseph,21,0,38,17
1650344383123,CSE 3,A51,083647,Miranda; Gregory Joseph,37,0,37,0
1650344389148,CSE 8A,A50,083650,Miranda; Gregory Joseph,0,28,40,40
1650344395174,CSE 11,A01,083080,Cao; Yingjun,0,88,40,40
1650344401197,CSE 12,A01,083652,Staff,0,12,100,100
1650344407220,CSE 15L,A01,083654,Staff,0,1,50,50
1650344407220,CSE 15L,A02,083655,Staff,3,0,50,47
1650344413246,CSE 20,A01,083657,Staff,53,0,80,27
1650344419272,CSE 30,A01,083084,Eldon; John,0,76,40,40
1650344425296,CSE 100,A01,083659,Cao; Yingjun,0,66,50,50
1650344431327,CSE 134B,A01,083661,Powell; Thomas Allan,0,31,65,65
1650344437353,CSE 140,A01,083663,Staff,0,0,75,75
1650344443383,CSE 140L,A01,083088,Eldon; John,0,6,75,75
1650344449412,CSE 175,A01,083665,Kumar; Rakesh,8,0,25,17
1650344455435,CSE 190,A00,092507,Dubnov; Shlomo,14,0,20,6
1650344461458,ECE 45,A01,083139,Staff,0,17,40,40
1650344467481,ECE 65,A50,083695,Staff,0,5,30,30
1650344473502,ECE 109,A01,091882,Touri; Behrouz,40,0,70,30
1650344479540,ECE 180,A00,083140,Abi Samra; Nicholas Camill,23,0,30,7
1650344479540,ECE 180,B00,083141,Abi Samra; Nicholas Camill,5,0,30,25
1650344485569,MATH 10A,A01,083735,Patchell; Gregory David,7,0,30,23
1650344485569,MATH 10A,A02,083736,Patchell; Gregory David,28,0,30,2
1650344485569,MATH 10A,A03,083737,Patchell; Gregory David,26,0,30,4
1650344491608,MATH 10B,A01,083207,Staff,0,7,30,30
1650344491608,MATH 10B,A02,083208,Staff,0,6,30,30
1650344491608,MATH 10B,B01,083739,Staff,17,0,30,13
1650344491608,MATH 10B,B02,083740,Staff,28,0,30,2
1650344497636,MATH 18,A01,083743,Staff,4,0,30,26
1650344497636,MATH 18,A02,083744,Staff,27,0,30,3
1650344497636,MATH 18,A03,083745,Staff,22,0,30,8
1650344497636,MATH 18,A04,083746,Staff,27,0,30,3
1650344497636,MATH 18,B01,083748,Staff,0,11,30,30
1650344497636,MATH 18,B02,083749,Staff,0,11,30,30
1650344497636,MATH 18,B03,083750,Staff,1,11,30,29
1650344497636,MATH 18,B04,083751,Staff,1,11,30,29
1650344503658,MATH 20A,A01,083754,Staff,26,0,40,14
1650344509684,MATH 20B,A01,083756,Staff,0,8,30,30
1650344509684,MATH 20B,A02,083757,Staff,0,8,30,30
1650344515727,MATH 20C,A01,083760,Staff,0,14,30,30
1650344515727,MATH 20C,A02,083761,Staff,0,13,30,30
1650344515727,MATH 20C,B01,083762,Staff,13,0,30,17
1650344515727,MATH 20C,B02,083763,Staff,28,0,30,2
1650344521751,MATH 20D,A01,083765,Staff,0,1,30,30
1650344521751,MATH 20D,A02,083766,Staff,7,0,30,23
1650344521751,MATH 20D,A03,083767,Staff,26,0,30,4
1650344527779,MATH 20E,A01,083771,Staff,5,0,30,25
1650344527779,MATH 20E,A02,083772,Staff,19,0,30,11
1650344527779,MATH 20E,B01,083773,Staff,0,0,30,30
1650344527779,MATH 20E,B02,083774,Staff,12,0,30,18
1650344533808,MATH 103A,A01,083777,Staff,0,11,30,30
1650344533808,MATH 103A,A02,083778,Staff,0,12,30,30
1650344533808,MATH 103A,B01,083779,Staff,0,13,30,30
1650344533808,MATH 103A,B02,083780,Staff,0,12,30,30
1650344539833,MATH 105,A01,085443,Staff,0,21,30,30
1650344545858,MATH 109,A01,083213,Anzaldo; Leesa B,0,6,30,30
1650344545858,MATH 109,A02,083214,Anzaldo; Leesa B,0,7,30,30
1650344545858,MATH 109,B01,083215,Anzaldo; Leesa B,0,5,30,30
1650344545858,MATH 109,B02,083216,Anzaldo; Leesa B,0,5,30,30
1650344551887,MATH 142A,A01,083219,Chow; Bennett,0,14,30,30
1650344551887,MATH 142A,A02,083220,Chow; Bennett,0,12,30,30
1650344551887,MATH 142A,B01,083221,Chow; Bennett,0,12,30,30
1650344551887,MATH 142A,B02,083222,Chow; Bennett,0,12,30,30
1650344557910,MATH 193A,A01,083224,Staff,0,5,30,30
1650344557910,MATH 193A,A02,083225,Staff,0,5,30,30
1650344557910,MATH 193A,A03,083781,Staff,0,4,30,30
1650344557910,MATH 193A,A04,083782,Staff,0,3,30,30
1650344563944,MATH 197,001,091859,McAuley; Julian John,9998,0,9999,1
1650344570002,COGS 9,A01,083615,Staff,0,15,60,60
1650344576028,COGS 11,A01,083617,Boyle; Mary E. T.,22,0,40,18
1650344582051,COGS 13,A01,083071,Staff,0,31,40,40
1650344588078,COGS 14A,A01,092681,Staff,0,19,100,100
1650344594105,COGS 14B,A01,083073,Cheng; Tzu-Han,0,10,50,50
1650344600134,COGS 17,A01,092677,Staff,25,0,75,50
1650344606156,COGS 100,A01,083619,Staff,0,23,60,60
1650344612179,COGS 101A,A01,083621,Davis; Joshua Daniel,1,22,60,59
1650344618200,COGS 101B,A01,091572,Staff,0,0,60,60
1650344624223,COGS 101C,A01,083625,Delgado; Tania,18,0,30,12
1650344630246,COGS 107A,A01,083627,Boyle; Mary E. T.,0,9,60,60
1650344636271,COGS 118A,A01,083075,Staff,4,0,60,56
1650344642295,CSE 3,A50,083646,Miranda; Gregory Joseph,21,0,38,17
1650344642295,CSE 3,A51,083647,Miranda; Gregory Joseph,37,0,37,0
1650344648318,CSE 8A,A50,083650,Miranda; Gregory Joseph,0,28,40,40
1650344654343,CSE 11,A01,083080,Cao; Yingjun,0,88,40,40
1650344660369,CSE 12,A01,083652,Staff,0,12,100,100
1650344666394,CSE 15L,A01,083654,Staff,0,1,50,50
1650344666394,CSE 15L,A02,083655,Staff,3,0,50,47
1650344672417,CSE 20,A01,083657,Staff,53,0,80,27
1650344678442,CSE 30,A01,083084,Eldon; John,0,76,40,40
1650344684464,CSE 100,A01,083659,Cao; Yingjun,0,66,50,50
1650344690495,CSE 134B,A01,083661,Powell; Thomas Allan,0,31,65,65
1650344696519,CSE 140,A01,083663,Staff,0,0,75,75
1650344702540,CSE 140L,A01,083088,Eldon; John,0,6,75,75
1650344708653,CSE 175,A01,083665,Kumar; Rakesh,8,0,25,17
1650344714683,CSE 190,A00,092507,Dubnov; Shlomo,14,0,20,6
1650344720713,ECE 45,A01,083139,Staff,0,17,40,40
1650344726737,ECE 65,A50,083695,Staff,0,5,30,30
1650344732770,ECE 109,A01,091882,Touri; Behrouz,40,0,70,30
1650344738802,ECE 180,A00,083140,Abi Samra; Nicholas Camill,23,0,30,7
1650344738802,ECE 180,B00,083141,Abi Samra; Nicholas Camill,5,0,30,25
1650344744826,MATH 10A,A01,083735,Patchell; Gregory David,7,0,30,23
1650344744826,MATH 10A,A02,083736,Patchell; Gregory David,28,0,30,2
1650344744826,MATH 10A,A03,083737,Patchell; Gregory David,26,0,30,4
1650344750853,MATH 10B,A01,083207,Staff,0,7,30,30
1650344750853,MATH 10B,A02,083208,Staff,0,6,30,30
1650344750853,MATH 10B,B01,083739,Staff,17,0,30,13
1650344750853,MATH 10B,B02,083740,Staff,28,0,30,2
1650344756879,MATH 18,A01,083743,Staff,4,0,30,26
1650344756879,MATH 18,A02,083744,Staff,27,0,30,3
1650344756879,MATH 18,A03,083745,Staff,22,0,30,8
1650344756879,MATH 18,A04,083746,Staff,27,0,30,3
1650344756879,MATH 18,B01,083748,Staff,0,11,30,30
1650344756879,MATH 18,B02,083749,Staff,0,11,30,30
1650344756879,MATH 18,B03,083750,Staff,1,11,30,29
1650344756879,MATH 18,B04,083751,Staff,1,11,30,29
1650344762903,MATH 20A,A01,083754,Staff,26,0,40,14
1650344768925,MATH 20B,A01,083756,Staff,0,8,30,30
1650344768925,MATH 20B,A02,083757,Staff,0,8,30,30
1650344774949,MATH 20C,A01,083760,Staff,0,14,30,30
1650344774949,MATH 20C,A02,083761,Staff,0,13,30,30
1650344774949,MATH 20C,B01,083762,Staff,13,0,30,17
1650344774949,MATH 20C,B02,083763,Staff,28,0,30,2
1650344780973,MATH 20D,A01,083765,Staff,0,1,30,30
1650344780973,MATH 20D,A02,083766,Staff,7,0,30,23
1650344780973,MATH 20D,A03,083767,Staff,26,0,30,4
1650344786996,MATH 20E,A01,083771,Staff,5,0,30,25
1650344786996,MATH 20E,A02,083772,Staff,19,0,30,11
1650344786996,MATH 20E,B01,083773,Staff,0,0,30,30
1650344786996,MATH 20E,B02,083774,Staff,12,0,30,18
1650344793029,MATH 103A,A01,083777,Staff,0,11,30,30
1650344793029,MATH 103A,A02,083778,Staff,0,12,30,30
1650344793029,MATH 103A,B01,083779,Staff,0,13,30,30
1650344793029,MATH 103A,B02,083780,Staff,0,12,30,30
1650344799056,MATH 105,A01,085443,Staff,0,21,30,30
1650344805082,MATH 109,A01,083213,Anzaldo; Leesa B,0,6,30,30
1650344805082,MATH 109,A02,083214,Anzaldo; Leesa B,0,7,30,30
1650344805082,MATH 109,B01,083215,Anzaldo; Leesa B,0,5,30,30
1650344805082,MATH 109,B02,083216,Anzaldo; Leesa B,0,5,30,30
1650344811117,MATH 142A,A01,083219,Chow; Bennett,0,14,30,30
1650344811117,MATH 142A,A02,083220,Chow; Bennett,0,12,30,30
1650344811117,MATH 142A,B01,083221,Chow; Bennett,0,12,30,30
1650344811117,MATH 142A,B02,083222,Chow; Bennett,0,12,30,30
1650344817140,MATH 193A,A01,083224,Staff,0,5,30,30
1650344817140,MATH 193A,A02,083225,Staff,0,5,30,30
1650344817140,MATH 193A,A03,083781,Staff,0,4,30,30
1650344817140,MATH 193A,A04,083782,Staff,0,3,30,30
1650344823165,MATH 197,001,091859,McAuley; Julian John,9998,0,9999,1
1650344829214,COGS 9,A01,083615,Staff,0,15,60,60
1650344835237,COGS 11,A01,083617,Boyle; Mary E. T.,22,0,40,18
1650344841271,COGS 13,A01,083071,Staff,0,31,40,40
1650344847297,COGS 14A,A01,092681,Staff,0,19,100,100
1650344853321,COGS 14B,A01,083073,Cheng; Tzu-Han,0,10,50,50
1650344859348,COGS 17,A01,092677,Staff,25,0,75,50
1650344865379,COGS 100,A01,083619,Staff,0,23,60,60
1650344871407,COGS 101A,A01,083621,Davis; Joshua Daniel,1,22,60,59
1650344877429,COGS 101B,A01,091572,Staff,0,0,60,60
1650344883453,COGS 101C,A01,083625,Delgado; Tania,18,0,30,12
1650344889479,COGS 107A,A01,083627,Boyle; Mary E. T.,0,9,60,60
1650344895512,COGS 118A,A01,083075,Staff,4,0,60,56
1650344901535,CSE 3,A50,083646,Miranda; Gregory Joseph,21,0,38,17
1650344901535,CSE 3,A51,083647,Miranda; Gregory Joseph,37,0,37,0
1650344907561,CSE 8A,A50,083650,Miranda; Gregory Joseph,0,28,40,40
1650344913583,CSE 11,A01,083080,Cao; Yingjun,0,88,40,40
1650344919604,CSE 12,A01,083652,Staff,0,12,100,100
1650344925626,CSE 15L,A01,083654,Staff,0,1,50,50
1650344925626,CSE 15L,A02,083655,Staff,3,0,50,47
1650344931652,CSE 20,A01,083657,Staff,53,0,80,27
1650344937678,CSE 30,A01,083084,Eldon; John,0,76,40,40
1650344943704,CSE 100,A01,083659,Cao; Yingjun,0,66,50,50
1650344949732,CSE 134B,A01,083661,Powell; Thomas Allan,0,31,65,65
1650344955755,CSE 140,A01,083663,Staff,0,0,75,75
1650344961780,CSE 140L,A01,083088,Eldon; John,0,6,75,75
1650344967806,CSE 175,A01,083665,Kumar; Rakesh,8,0,25,17
1650344973831,CSE 190,A00,092507,Dubnov; Shlomo,14,0,20,6
1650344979853,ECE 45,A01,083139,Staff,0,17,40,40
1650344985877,ECE 65,A50,083695,Staff,0,5,30,30
1650344991901,ECE 109,A01,091882,Touri; Behrouz,40,0,70,30
1650344997925,ECE 180,A00,083140,Abi Samra; Nicholas Camill,23,0,30,7
1650344997925,ECE 180,B00,083141,Abi Samra; Nicholas Camill,5,0,30,25
1650345003953,MATH 10A,A01,083735,Patchell; Gregory David,7,0,30,23
1650345003953,MATH 10A,A02,083736,Patchell; Gregory David,28,0,30,2
1650345003953,MATH 10A,A03,083737,Patchell; Gregory David,26,0,30,4
1650345009978,MATH 10B,A01,083207,Staff,0,7,30,30
1650345009978,MATH 10B,A02,083208,Staff,0,6,30,30
1650345009978,MATH 10B,B01,083739,Staff,17,0,30,13
1650345009978,MATH 10B,B02,083740,Staff,28,0,30,2
1650345016011,MATH 18,A01,083743,Staff,4,0,30,26
1650345016011,MATH 18,A02,083744,Staff,27,0,30,3
1650345016011,MATH 18,A03,083745,Staff,22,0,30,8
1650345016011,MATH 18,A04,083746,Staff,27,0,30,3
1650345016011,MATH 18,B01,083748,Staff,0,11,30,30
1650345016011,MATH 18,B02,083749,Staff,0,11,30,30
1650345016011,MATH 18,B03,083750,Staff,1,11,30,29
1650345016011,MATH 18,B04,083751,Staff,1,11,30,29
1650345022038,MATH 20A,A01,083754,Staff,26,0,40,14
1650345028062,MATH 20B,A01,083756,Staff,0,8,30,30
1650345028062,MATH 20B,A02,083757,Staff,0,8,30,30
1650345034090,MATH 20C,A01,083760,Staff,0,14,30,30
1650345034090,MATH 20C,A02,083761,Staff,0,13,30,30
1650345034090,MATH 20C,B01,083762,Staff,13,0,30,17
1650345034090,MATH 20C,B02,083763,Staff,28,0,30,2
1650345040112,MATH 20D,A01,083765,Staff,0,1,30,30
1650345040112,MATH 20D,A02,083766,Staff,7,0,30,23
1650345040112,MATH 20D,A03,083767,Staff,26,0,30,4
1650345046142,MATH 20E,A01,083771,Staff,5,0,30,25
1650345046142,MATH 20E,A02,083772,Staff,19,0,30,11
1650345046142,MATH 20E,B01,083773,Staff,0,0,30,30
1650345046142,MATH 20E,B02,083774,Staff,12,0,30,18
1650345052166,MATH 103A,A01,083777,Staff,0,11,30,30
1650345052166,MATH 103A,A02,083778,Staff,0,12,30,30
1650345052166,MATH 103A,B01,083779,Staff,0,13,30,30
1650345052166,MATH 103A,B02,083780,Staff,0,12,30,30
1650345058192,MATH 105,A01,085443,Staff,0,21,30,30
1650345064218,MATH 109,A01,083213,Anzaldo; Leesa B,0,6,30,30
1650345064218,MATH 109,A02,083214,Anzaldo; Leesa B,0,7,30,30
1650345064218,MATH 109,B01,083215,Anzaldo; Leesa B,0,5,30,30
1650345064218,MATH 109,B02,083216,Anzaldo; Leesa B,0,5,30,30
1650345070247,MATH 142A,A01,083219,Chow; Bennett,0,14,30,30
1650345070247,MATH 142A,A02,083220,Chow; Bennett,0,12,30,30
1650345070247,MATH 142A,B01,083221,Chow; Bennett,0,12,30,30
1650345070247,MATH 142A,B02,083222,Chow; Bennett,0,12,30,30
1650345076275,MATH 193A,A01,083224,Staff,0,5,30,30
1650345076275,MATH 193A,A02,083225,Staff,0,5,30,30
1650345076275,MATH 193A,A03,083781,Staff,0,4,30,30
1650345076275,MATH 193A,A04,083782,Staff,0,3,30,30
1650345082297,MATH 197,001,091859,McAuley; Julian John,9998,0,9999,1
1650345088354,COGS 9,A01,083615,Staff,0,15,60,60
1650345094378,COGS 11,A01,083617,Boyle; Mary E. T.,22,0,40,18
1650345100405,COGS 13,A01,083071,Staff,0,31,40,40
1650345106431,COGS 14A,A01,092681,Staff,0,19,100,100
1650345112459,COGS 14B,A01,083073,Cheng; Tzu-Han,0,10,50,50
1650345118490,COGS 17,A01,092677,Staff,25,0,75,50
1650345124513,COGS 100,A01,083619,Staff,0,23,60,60
1650345130549,COGS 101A,A01,083621,Davis; Joshua Daniel,1,22,60,59
1650345136573,COGS 101B,A01,091572,Staff,0,0,60,60
1650345142598,COGS 101C,A01,083625,Delgado; Tania,18,0,30,12
1650345148626,COGS 107A,A01,083627,Boyle; Mary E. T.,0,9,60,60
1650345154655,COGS 118A,A01,083075,Staff,4,0,60,56
1650345160682,CSE 3,A50,083646,Miranda; Gregory Joseph,21,0,38,17
1650345160682,CSE 3,A51,083647,Miranda; Gregory Joseph,37,0,37,0
1650345166711,CSE 8A,A50,083650,Miranda; Gregory Joseph,0,28,40,40
1650345172737,CSE 11,A01,083080,Cao; Yingjun,0,88,40,40
1650345178762,CSE 12,A01,083652,Staff,0,12,100,100
1650345184786,CSE 15L,A01,083654,Staff,0,1,50,50
1650345184786,CSE 15L,A02,083655,Staff,3,0,50,47
1650345190809,CSE 20,A01,083657,Staff,53,0,80,27
1650345196852,CSE 30,A01,083084,Eldon; John,0,76,40,40
1650345202874,CSE 100,A01,083659,Cao; Yingjun,0,66,50,50
1650345208896,CSE 134B,A01,083661,Powell; Thomas Allan,0,31,65,65
1650345214921,CSE 140,A01,083663,Staff,0,0,75,75
1650345220960,CSE 140L,A01,083088,Eldon; John,0,6,75,75
1650345226986,CSE 175,A01,083665,Kumar; Rakesh,8,0,25,17
1650345233010,CSE 190,A00,092507,Dubnov; Shlomo,14,0,20,6
1650345239036,ECE 45,A01,083139,Staff,0,17,40,40
1650345245063,ECE 65,A50,083695,Staff,0,5,30,30
1650345251089,ECE 109,A01,091882,Touri; Behrouz,40,0,70,30
1650345257114,ECE 180,A00,083140,Abi Samra; Nicholas Camill,23,0,30,7
1650345257114,ECE 180,B00,083141,Abi Samra; Nicholas Camill,5,0,30,25
1650345263139,MATH 10A,A01,083735,Patchell; Gregory David,7,0,30,23
1650345263139,MATH 10A,A02,083736,Patchell; Gregory David,28,0,30,2
1650345263139,MATH 10A,A03,083737,Patchell; Gregory David,26,0,30,4
1650345269163,MATH 10B,A01,083207,Staff,0,7,30,30
1650345269163,MATH 10B,A02,083208,Staff,0,6,30,30
1650345269163,MATH 10B,B01,083739,Staff,17,0,30,13
1650345269163,MATH 10B,B02,083740,Staff,28,0,30,2
1650345275186,MATH 18,A01,083743,Staff,4,0,30,26
1650345275186,MATH 18,A02,083744,Staff,27,0,30,3
1650345275186,MATH 18,A03,083745,Staff,22,0,30,8
1650345275186,MATH 18,A04,083746,Staff,27,0,30,3
1650345275186,MATH 18,B01,083748,Staff,0,11,30,30
1650345275186,MATH 18,B02,083749,Staff,0,11,30,30
1650345275186,MATH 18,B03,083750,Staff,1,11,30,29
1650345275186,MATH 18,B04,083751,Staff,1,11,30,29
1650345281216,MATH 20A,A01,083754,Staff,26,0,40,14
1650345287242,MATH 20B,A01,083756,Staff,0,8,30,30
1650345287242,MATH 20B,A02,083757,Staff,0,8,30,30
1650345293266,MATH 20C,A01,083760,Staff,0,14,30,30
1650345293266,MATH 20C,A02,083761,Staff,0,13,30,30
1650345293266,MATH 20C,B01,083762,Staff,13,0,30,17
1650345293266,MATH 20C,B02,083763,Staff,28,0,30,2
1650345299291,MATH 20D,A01,083765,Staff,0,1,30,30
1650345299291,MATH 20D,A02,083766,Staff,7,0,30,23
1650345299291,MATH 20D,A03,083767,Staff,26,0,30,4
1650345305409,MATH 20E,A01,083771,Staff,5,0,30,25
1650345305409,MATH 20E,A02,083772,Staff,19,0,30,11
1650345305409,MATH 20E,B01,083773,Staff,0,0,30,30
1650345305409,MATH 20E,B02,083774,Staff,12,0,30,18
1650345311432,MATH 103A,A01,083777,Staff,0,11,30,30
1650345311432,MATH 103A,A02,083778,Staff,0,12,30,30
1650345311432,MATH 103A,B01,083779,Staff,0,13,30,30
1650345311432,MATH 103A,B02,083780,Staff,0,12,30,30
1650345317459,MATH 105,A01,085443,Staff,0,21,30,30
1650345323493,MATH 109,A01,083213,Anzaldo; Leesa B,0,6,30,30
1650345323493,MATH 109,A02,083214,Anzaldo; Leesa B,0,7,30,30
1650345323493,MATH 109,B01,083215,Anzaldo; Leesa B,0,5,30,30
1650345323493,MATH 109,B02,083216,Anzaldo; Leesa B,0,5,30,30
1650345329519,MATH 142A,A01,083219,Chow; Bennett,0,14,30,30
1650345329519,MATH 142A,A02,083220,Chow; Bennett,0,12,30,30
1650345329519,MATH 142A,B01,083221,Chow; Bennett,0,12,30,30
1650345329519,MATH 142A,B02,083222,Chow; Bennett,0,12,30,30
1650345335547,MATH 193A,A01,083224,Staff,0,5,30,30
1650345335547,MATH 193A,A02,083225,Staff,0,5,30,30
1650345335547,MATH 193A,A03,083781,Staff,0,4,30,30
1650345335547,MATH 193A,A04,083782,Staff,0,3,30,30
1650345341572,MATH 197,001,091859,McAuley; Julian John,9998,0,9999,1
1650345347626,COGS 9,A01,083615,Staff,0,15,60,60
1650345353652,COGS 11,A01,083617,Boyle; Mary E. T.,22,0,40,18
1650345359678,COGS 13,A01,083071,Staff,0,31,40,40
1650345365707,COGS 14A,A01,092681,Staff,0,19,100,100
1650345371731,COGS 14B,A01,083073,Cheng; Tzu-Han,0,10,50,50
1650345377754,COGS 17,A01,092677,Staff,25,0,75,50
1650345383780,COGS 100,A01,083619,Staff,0,23,60,60
1650345389803,COGS 101A,A01,083621,Davis; Joshua Daniel,1,22,60,59
1650345395827,COGS 101B,A01,091572,Staff,0,0,60,60
1650345401849,COGS 101C,A01,083625,Delgado; Tania,18,0,30,12
1650345407872,COGS 107A,A01,083627,Boyle; Mary E. T.,0,9,60,60
1650345413897,COGS 118A,A01,083075,Staff,4,0,60,56
1650345419926,CSE 3,A50,083646,Miranda; Gregory Joseph,21,0,38,17
1650345419926,CSE 3,A51,083647,Miranda; Gregory Joseph,37,0,37,0
1650345425954,CSE 8A,A50,083650,Miranda; Gregory Joseph,0,28,40,40
1650345431979,CSE 11,A01,083080,Cao; Yingjun,0,88,40,40
1650345438003,CSE 12,A01,083652,Staff,0,12,100,100
1650345444029,CSE 15L,A01,083654,Staff,0,1,50,50
1650345444029,CSE 15L,A02,083655,Staff,3,0,50,47
1650345450052,CSE 20,A01,083657,Staff,53,0,80,27
1650345456080,CSE 30,A01,083084,Eldon; John,0,76,40,40
1650345462114,CSE 100,A01,083659,Cao; Yingjun,0,66,50,50
1650345468137,CSE 134B,A01,083661,Powell; Thomas Allan,0,31,65,65
1650345474162,CSE 140,A01,083663,Staff,0,0,75,75
1650345480185,CSE 140L,A01,083088,Eldon; John,0,6,75,75
1650345486212,CSE 175,A01,083665,Kumar; Rakesh,8,0,25,17
1650345492237,CSE 190,A00,092507,Dubnov; Shlomo,14,0,20,6
1650345498265,ECE 45,A01,083139,Staff,0,17,40,40
1650345504289,ECE 65,A50,083695,Staff,0,5,30,30
1650345510314,ECE 109,A01,091882,Touri; Behrouz,40,0,70,30
1650345516341,ECE 180,A00,083140,Abi Samra; Nicholas Camill,23,0,30,7
1650345516341,ECE 180,B00,083141,Abi Samra; Nicholas Camill,5,0,30,25
1650345522367,MATH 10A,A01,083735,Patchell; Gregory David,7,0,30,23
1650345522367,MATH 10A,A02,083736,Patchell; Gregory David,28,0,30,2
1650345522367,MATH 10A,A03,083737,Patchell; Gregory David,26,0,30,4
1650345528395,MATH 10B,A01,083207,Staff,0,7,30,30
1650345528395,MATH 10B,A02,083208,Staff,0,6,30,30
1650345528395,MATH 10B,B01,083739,Staff,17,0,30,13
1650345528395,MATH 10B,B02,083740,Staff,28,0,30,2
1650345534423,MATH 18,A01,083743,Staff,4,0,30,26
1650345534423,MATH 18,A02,083744,Staff,27,0,30,3
1650345534423,MATH 18,A03,083745,Staff,22,0,30,8
1650345534423,MATH 18,A04,083746,Staff,27,0,30,3
1650345534423,MATH 18,B01,083748,Staff,0,11,30,30
1650345534423,MATH 18,B02,083749,Staff,0,11,30,30
1650345534423,MATH 18,B03,083750,Staff,1,11,30,29
1650345534423,MATH 18,B04,083751,Staff,1,11,30,29
1650345540446,MATH 20A,A01,083754,Staff,26,0,40,14
1650345546474,MATH 20B,A01,083756,Staff,0,8,30,30
1650345546474,MATH 20B,A02,083757,Staff,0,8,30,30
1650345552503,MATH 20C,A01,083760,Staff,0,15,30,30
1650345552503,MATH 20C,A02,083761,Staff,0,13,30,30
1650345552503,MATH 20C,B01,083762,Staff,13,0,30,17
1650345552503,MATH 20C,B02,083763,Staff,28,0,30,2
1650345558530,MATH 20D,A01,083765,Staff,0,1,30,30
1650345558530,MATH 20D,A02,083766,Staff,7,0,30,23
1650345558530,MATH 20D,A03,083767,Staff,26,0,30,4
1650345564557,MATH 20E,A01,083771,Staff,5,0,30,25
1650345564557,MATH 20E,A02,083772,Staff,19,0,30,11
1650345564557,MATH 20E,B01,083773,Staff,0,0,30,30
1650345564557,MATH 20E,B02,083774,Staff,12,0,30,18
1650345570580,MATH 103A,A01,083777,Staff,0,11,30,30
1650345570580,MATH 103A,A02,083778,Staff,0,12,30,30
1650345570580,MATH 103A,B01,083779,Staff,0,13,30,30
1650345570580,MATH 103A,B02,083780,Staff,0,12,30,30
1650345576606,MATH 105,A01,085443,Staff,0,21,30,30
1650345582632,MATH 109,A01,083213,Anzaldo; Leesa B,0,6,30,30
1650345582632,MATH 109,A02,083214,Anzaldo; Leesa B,0,7,30,30
1650345582632,MATH 109,B01,083215,Anzaldo; Leesa B,0,5,30,30
1650345582632,MATH 109,B02,083216,Anzaldo; Leesa B,0,5,30,30
1650345588658,MATH 142A,A01,083219,Chow; Bennett,0,14,30,30
1650345588658,MATH 142A,A02,083220,Chow; Bennett,0,12,30,30
1650345588658,MATH 142A,B01,083221,Chow; Bennett,0,12,30,30
1650345588658,MATH 142A,B02,083222,Chow; Bennett,0,12,30,30
1650345594690,MATH 193A,A01,083224,Staff,0,5,30,30
1650345594690,MATH 193A,A02,083225,Staff,0,5,30,30
1650345594690,MATH 193A,A03,083781,Staff,0,4,30,30
1650345594690,MATH 193A,A04,083782,Staff,0,3,30,30
1650345600723,MATH 197,001,091859,McAuley; Julian John,9998,0,9999,1
1650345606790,COGS 9,A01,083615,Staff,0,15,60,60
1650345612812,COGS 11,A01,083617,Boyle; Mary E. T.,22,0,40,18
1650345618839,COGS 13,A01,083071,Staff,0,31,40,40
1650345624865,COGS 14A,A01,092681,Staff,0,19,100,100
1650345630904,COGS 14B,A01,083073,Cheng; Tzu-Han,0,10,50,50
1650345636930,COGS 17,A01,092677,Staff,25,0,75,50
1650345642956,COGS 100,A01,083619,Staff,0,23,60,60
1650345648983,COGS 101A,A01,083621,Davis; Joshua Daniel,1,22,60,59
1650345655010,COGS 101B,A01,091572,Staff,0,0,60,60
1650345661033,COGS 101C,A01,083625,Delgado; Tania,18,0,30,12
1650345667069,COGS 107A,A01,083627,Boyle; Mary E. T.,0,9,60,60
1650345673093,COGS 118A,A01,083075,Staff,4,0,60,56
1650345679120,CSE 3,A50,083646,Miranda; Gregory Joseph,21,0,38,17
1650345679120,CSE 3,A51,083647,Miranda; Gregory Joseph,37,0,37,0
1650345685149,CSE 8A,A50,083650,Miranda; Gregory Joseph,0,28,40,40
1650345691174,CSE 11,A01,083080,Cao; Yingjun,0,88,40,40
1650345697201,CSE 12,A01,083652,Staff,0,12,100,100
1650345703225,CSE 15L,A01,083654,Staff,0,1,50,50
1650345703225,CSE 15L,A02,083655,Staff,3,0,50,47
1650345709252,CSE 20,A01,083657,Staff,53,0,80,27
1650345715278,CSE 30,A01,083084,Eldon; John,0,76,40,40
1650345721304,CSE 100,A01,083659,Cao; Yingjun,0,66,50,50
1650345727329,CSE 134B,A01,083661,Powell; Thomas Allan,0,31,65,65
1650345733353,CSE 140,A01,083663,Staff,0,0,75,75
1650345739378,CSE 140L,A01,083088,Eldon; John,0,6,75,75
1650345745401,CSE 175,A01,083665,Kumar; Rakesh,8,0,25,17
1650345751427,CSE 190,A00,092507,Dubnov; Shlomo,14,0,20,6
1650345757455,ECE 45,A01,083139,Staff,0,17,40,40
1650345763483,ECE 65,A50,083695,Staff,0,5,30,30
1650345769510,ECE 109,A01,091882,Touri; Behrouz,40,0,70,30
1650345775534,ECE 180,A00,083140,Abi Samra; Nicholas Camill,23,0,30,7
1650345775534,ECE 180,B00,083141,Abi Samra; Nicholas Camill,5,0,30,25
1650345781559,MATH 10A,A01,083735,Patchell; Gregory David,7,0,30,23
1650345781559,MATH 10A,A02,083736,Patchell; Gregory David,28,0,30,2
1650345781559,MATH 10A,A03,083737,Patchell; Gregory David,26,0,30,4
1650345787596,MATH 10B,A01,083207,Staff,0,7,30,30
1650345787596,MATH 10B,A02,083208,Staff,0,6,30,30
1650345787596,MATH 10B,B01,083739,Staff,17,0,30,13
1650345787596,MATH 10B,B02,083740,Staff,28,0,30,2
1650345793625,MATH 18,A01,083743,Staff,4,0,30,26
1650345793625,MATH 18,A02,083744,Staff,27,0,30,3
1650345793625,MATH 18,A03,083745,Staff,22,0,30,8
1650345793625,MATH 18,A04,083746,Staff,27,0,30,3
1650345793625,MATH 18,B01,083748,Staff,0,11,30,30
1650345793625,MATH 18,B02,083749,Staff,0,11,30,30
1650345793625,MATH 18,B03,083750,Staff,1,11,30,29
1650345793625,MATH 18,B04,083751,Staff,1,11,30,29
1650345799652,MATH 20A,A01,083754,Staff,26,0,40,14
1650345805675,MATH 20B,A01,083756,Staff,0,8,30,30
1650345805675,MATH 20B,A02,083757,Staff,0,8,30,30
1650345811704,MATH 20C,A01,083760,Staff,0,14,30,30
1650345811704,MATH 20C,A02,083761,Staff,0,13,30,30
1650345811704,MATH 20C,B01,083762,Staff,13,0,30,17
1650345811704,MATH 20C,B02,083763,Staff,28,0,30,2
1650345817730,MATH 20D,A01,083765,Staff,0,1,30,30
1650345817730,MATH 20D,A02,083766,Staff,7,0,30,23
1650345817730,MATH 20D,A03,083767,Staff,26,0,30,4
1650345823756,MATH 20E,A01,083771,Staff,5,0,30,25
1650345823756,MATH 20E,A02,083772,Staff,19,0,30,11
1650345823756,MATH 20E,B01,083773,Staff,0,0,30,30
1650345823756,MATH 20E,B02,083774,Staff,12,0,30,18
1650345829779,MATH 103A,A01,083777,Staff,0,11,30,30
1650345829779,MATH 103A,A02,083778,Staff,0,12,30,30
1650345829779,MATH 103A,B01,083779,Staff,0,13,30,30
1650345829779,MATH 103A,B02,083780,Staff,0,12,30,30
1650345835812,MATH 105,A01,085443,Staff,0,21,30,30
1650345841837,MATH 109,A01,083213,Anzaldo; Leesa B,0,6,30,30
1650345841837,MATH 109,A02,083214,Anzaldo; Leesa B,0,7,30,30
1650345841837,MATH 109,B01,083215,Anzaldo; Leesa B,0,5,30,30
1650345841837,MATH 109,B02,083216,Anzaldo; Leesa B,0,5,30,30
1650345847865,MATH 142A,A01,083219,Chow; Bennett,0,14,30,30
1650345847865,MATH 142A,A02,083220,Chow; Bennett,0,12,30,30
1650345847865,MATH 142A,B01,083221,Chow; Bennett,0,12,30,30
1650345847865,MATH 142A,B02,083222,Chow; Bennett,0,12,30,30
1650345853902,MATH 193A,A01,083224,Staff,0,5,30,30
1650345853902,MATH 193A,A02,083225,Staff,0,5,30,30
1650345853902,MATH 193A,A03,083781,Staff,0,4,30,30
1650345853902,MATH 193A,A04,083782,Staff,0,3,30,30
1650345859934,MATH 197,001,091859,McAuley; Julian John,9998,0,9999,1
1650345865988,COGS 9,A01,083615,Staff,0,15,60,60
1650345872018,COGS 11,A01,083617,Boyle; Mary E. T.,22,0,40,18
1650345878042,COGS 13,A01,083071,Staff,0,31,40,40
1650345884070,COGS 14A,A01,092681,Staff,0,19,100,100
1650345890094,COGS 14B,A01,083073,Cheng; Tzu-Han,0,10,50,50
1650345896208,COGS 17,A01,092677,Staff,25,0,75,50
1650345902231,COGS 100,A01,083619,Staff,0,23,60,60
1650345908265,COGS 101A,A01,083621,Davis; Joshua Daniel,1,22,60,59
1650345914288,COGS 101B,A01,091572,Staff,0,0,60,60
1650345920314,COGS 101C,A01,083625,Delgado; Tania,18,0,30,12
1650345926342,COGS 107A,A01,083627,Boyle; Mary E. T.,0,9,60,60
1650345932374,COGS 118A,A01,083075,Staff,4,0,60,56
1650345938398,CSE 3,A50,083646,Miranda; Gregory Joseph,21,0,38,17
1650345938398,CSE 3,A51,083647,Miranda; Gregory Joseph,37,0,37,0
1650345944426,CSE 8A,A50,083650,Miranda; Gregory Joseph,0,28,40,40
1650345950451,CSE 11,A01,083080,Cao; Yingjun,0,88,40,40
1650345956478,CSE 12,A01,083652,Staff,0,12,100,100
1650345962502,CSE 15L,A01,083654,Staff,0,1,50,50
1650345962502,CSE 15L,A02,083655,Staff,3,0,50,47
1650345968526,CSE 20,A01,083657,Staff,53,0,80,27
1650345974554,CSE 30,A01,083084,Eldon; John,0,76,40,40
1650345980581,CSE 100,A01,083659,Cao; Yingjun,0,66,50,50
1650345986617,CSE 134B,A01,083661,Powell; Thomas Allan,0,31,65,65
1650345992643,CSE 140,A01,083663,Staff,0,0,75,75
1650345998668,CSE 140L,A01,083088,Eldon; John,0,6,75,75
1650346004691,CSE 175,A01,083665,Kumar; Rakesh,8,0,25,17
1650346010714,CSE 190,A00,092507,Dubnov; Shlomo,14,0,20,6
1650346016742,ECE 45,A01,083139,Staff,0,17,40,40
1650346022769,ECE 65,A50,083695,Staff,0,5,30,30
1650346028796,ECE 109,A01,091882,Touri; Behrouz,40,0,70,30
1650346034821,ECE 180,A00,083140,Abi Samra; Nicholas Camill,23,0,30,7
1650346034821,ECE 180,B00,083141,Abi Samra; Nicholas Camill,5,0,30,25
1650346040843,MATH 10A,A01,083735,Patchell; Gregory David,7,0,30,23
1650346040843,MATH 10A,A02,083736,Patchell; Gregory David,28,0,30,2
1650346040843,MATH 10A,A03,083737,Patchell; Gregory David,26,0,30,4
1650346046867,MATH 10B,A01,083207,Staff,0,7,30,30
1650346046867,MATH 10B,A02,083208,Staff,0,6,30,30
1650346046867,MATH 10B,B01,083739,Staff,17,0,30,13
1650346046867,MATH 10B,B02,083740,Staff,28,0,30,2
1650346052899,MATH 18,A01,083743,Staff,4,0,30,26
1650346052899,MATH 18,A02,083744,Staff,27,0,30,3
1650346052899,MATH 18,A03,083745,Staff,22,0,30,8
1650346052899,MATH 18,A04,083746,Staff,27,0,30,3
1650346052899,MATH 18,B01,083748,Staff,0,11,30,30
1650346052899,MATH 18,B02,083749,Staff,0,11,30,30
1650346052899,MATH 18,B03,083750,Staff,0,10,30,30
1650346052899,MATH 18,B04,083751,Staff,0,10,30,30
1650346058923,MATH 20A,A01,083754,Staff,26,0,40,14
1650346064952,MATH 20B,A01,083756,Staff,0,8,30,30
1650346064952,MATH 20B,A02,083757,Staff,0,8,30,30
1650346070975,MATH 20C,A01,083760,Staff,0,14,30,30
1650346070975,MATH 20C,A02,083761,Staff,0,13,30,30
1650346070975,MATH 20C,B01,083762,Staff,13,0,30,17
1650346070975,MATH 20C,B02,083763,Staff,28,0,30,2
1650346077003,MATH 20D,A01,083765,Staff,0,1,30,30
1650346077003,MATH 20D,A02,083766,Staff,7,0,30,23
1650346077003,MATH 20D,A03,083767,Staff,26,0,30,4
1650346083028,MATH 20E,A01,083771,Staff,5,0,30,25
1650346083028,MATH 20E,A02,083772,Staff,19,0,30,11
1650346083028,MATH 20E,B01,083773,Staff,0,0,30,30
1650346083028,MATH 20E,B02,083774,Staff,12,0,30,18
1650346089051,MATH 103A,A01,083777,Staff,0,11,30,30
1650346089051,MATH 103A,A02,083778,Staff,0,12,30,30
1650346089051,MATH 103A,B01,083779,Staff,0,13,30,30
1650346089051,MATH 103A,B02,083780,Staff,0,12,30,30
1650346095073,MATH 105,A01,085443,Staff,0,21,30,30
1650346101103,MATH 109,A01,083213,Anzaldo; Leesa B,0,6,30,30
1650346101103,MATH 109,A02,083214,Anzaldo; Leesa B,0,7,30,30
1650346101103,MATH 109,B01,083215,Anzaldo; Leesa B,0,5,30,30
1650346101103,MATH 109,B02,083216,Anzaldo; Leesa B,0,5,30,30
1650346107134,MATH 142A,A01,083219,Chow; Bennett,0,14,30,30
1650346107134,MATH 142A,A02,083220,Chow; Bennett,0,12,30,30
1650346107134,MATH 142A,B01,083221,Chow; Bennett,0,12,30,30
1650346107134,MATH 142A,B02,083222,Chow; Bennett,0,12,30,30
1650346113157,MATH 193A,A01,083224,Staff,0,5,30,30
1650346113157,MATH 193A,A02,083225,Staff,0,5,30,30
1650346113157,MATH 193A,A03,083781,Staff,0,4,30,30
1650346113157,MATH 193A,A04,083782,Staff,0,3,30,30
1650346119181,MATH 197,001,091859,McAuley; Julian John,9998,0,9999,1
1650346125237,COGS 9,A01,083615,Staff,0,14,60,60
1650346131264,COGS 11,A01,083617,Boyle; Mary E. T.,22,0,40,18
1650346137299,COGS 13,A01,083071,Staff,0,31,40,40
1650346143326,COGS 14A,A01,092681,Staff,0,19,100,100
1650346149357,COGS 14B,A01,083073,Cheng; Tzu-Han,0,10,50,50
1650346155381,COGS 17,A01,092677,Staff,25,0,75,50
1650346161404,COGS 100,A01,083619,Staff,0,23,60,60
1650346167431,COGS 101A,A01,083621,Davis; Joshua Daniel,0,21,60,60
1650346173454,COGS 101B,A01,091572,Staff,0,0,60,60
1650346179476,COGS 101C,A01,083625,Delgado; Tania,18,0,30,12
1650346185501,COGS 107A,A01,083627,Boyle; Mary E. T.,0,9,60,60
1650346191528,COGS 118A,A01,083075,Staff,4,0,60,56
1650346197551,CSE 3,A50,083646,Miranda; Gregory Joseph,21,0,38,17
1650346197551,CSE 3,A51,083647,Miranda; Gregory Joseph,37,0,37,0
1650346203577,CSE 8A,A50,083650,Miranda; Gregory Joseph,0,28,40,40
1650346209600,CSE 11,A01,083080,Cao; Yingjun,0,88,40,40
1650346215626,CSE 12,A01,083652,Staff,0,12,100,100
1650346221648,CSE 15L,A01,083654,Staff,0,1,50,50
1650346221648,CSE 15L,A02,083655,Staff,3,0,50,47
1650346227679,CSE 20,A01,083657,Staff,52,0,80,28
1650346233710,CSE 30,A01,083084,Eldon; John,0,76,40,40
1650346239742,CSE 100,A01,083659,Cao; Yingjun,0,66,50,50
1650346245795,CSE 134B,A01,083661,Powell; Thomas Allan,0,31,65,65
1650346251819,CSE 140,A01,083663,Staff,0,0,75,75
1650346257846,CSE 140L,A01,083088,Eldon; John,0,6,75,75
1650346263879,CSE 175,A01,083665,Kumar; Rakesh,8,0,25,17
1650346269906,CSE 190,A00,092507,Dubnov; Shlomo,14,0,20,6
1650346275931,ECE 45,A01,083139,Staff,0,17,40,40
1650346281955,ECE 65,A50,083695,Staff,0,5,30,30
1650346287979,ECE 109,A01,091882,Touri; Behrouz,40,0,70,30
1650346294025,ECE 180,A00,083140,Abi Samra; Nicholas Camill,23,0,30,7
1650346294025,ECE 180,B00,083141,Abi Samra; Nicholas Camill,5,0,30,25
1650346300046,MATH 10A,A01,083735,Patchell; Gregory David,7,0,30,23
1650346300046,MATH 10A,A02,083736,Patchell; Gregory David,28,0,30,2
1650346300046,MATH 10A,A03,083737,Patchell; Gregory David,26,0,30,4
1650346306075,MATH 10B,A01,083207,Staff,0,7,30,30
1650346306075,MATH 10B,A02,083208,Staff,0,6,30,30
1650346306075,MATH 10B,B01,083739,Staff,17,0,30,13
1650346306075,MATH 10B,B02,083740,Staff,28,0,30,2
1650346312100,MATH 18,A01,083743,Staff,4,0,30,26
1650346312100,MATH 18,A02,083744,Staff,27,0,30,3
1650346312100,MATH 18,A03,083745,Staff,22,0,30,8
1650346312100,MATH 18,A04,083746,Staff,27,0,30,3
1650346312100,MATH 18,B01,083748,Staff,0,11,30,30
1650346312100,MATH 18,B02,083749,Staff,0,11,30,30
1650346312100,MATH 18,B03,083750,Staff,0,10,30,30
1650346312100,MATH 18,B04,083751,Staff,0,10,30,30
1650346318125,MATH 20A,A01,083754,Staff,26,0,40,14
1650346324149,MATH 20B,A01,083756,Staff,0,8,30,30
1650346324149,MATH 20B,A02,083757,Staff,0,8,30,30
1650346330173,MATH 20C,A01,083760,Staff,0,14,30,30
1650346330173,MATH 20C,A02,083761,Staff,0,14,30,30
1650346330173,MATH 20C,B01,083762,Staff,13,0,30,17
1650346330173,MATH 20C,B02,083763,Staff,28,0,30,2
1650346336214,MATH 20D,A01,083765,Staff,0,1,30,30
1650346336214,MATH 20D,A02,083766,Staff,7,0,30,23
1650346336214,MATH 20D,A03,083767,Staff,26,0,30,4
1650346342241,MATH 20E,A01,083771,Staff,5,0,30,25
1650346342241,MATH 20E,A02,083772,Staff,19,0,30,11
1650346342241,MATH 20E,B01,083773,Staff,0,0,30,30
1650346342241,MATH 20E,B02,083774,Staff,12,0,30,18
1650346348265,MATH 103A,A01,083777,Staff,0,11,30,30
1650346348265,MATH 103A,A02,083778,Staff,0,12,30,30
1650346348265,MATH 103A,B01,083779,Staff,0,13,30,30
1650346348265,MATH 103A,B02,083780,Staff,0,12,30,30
1650346354289,MATH 105,A01,085443,Staff,0,21,30,30
1650346360311,MATH 109,A01,083213,Anzaldo; Leesa B,0,6,30,30
1650346360311,MATH 109,A02,083214,Anzaldo; Leesa B,0,7,30,30
1650346360311,MATH 109,B01,083215,Anzaldo; Leesa B,0,5,30,30
1650346360311,MATH 109,B02,083216,Anzaldo; Leesa B,0,5,30,30
1650346366333,MATH 142A,A01,083219,Chow; Bennett,0,14,30,30
1650346366333,MATH 142A,A02,083220,Chow; Bennett,0,12,30,30
1650346366333,MATH 142A,B01,083221,Chow; Bennett,0,12,30,30
1650346366333,MATH 142A,B02,083222,Chow; Bennett,0,12,30,30
1650346372360,MATH 193A,A01,083224,Staff,0,5,30,30
1650346372360,MATH 193A,A02,083225,Staff,0,5,30,30
1650346372360,MATH 193A,A03,083781,Staff,0,4,30,30
1650346372360,MATH 193A,A04,083782,Staff,0,3,30,30
1650346378384,MATH 197,001,091859,McAuley; Julian John,9998,0,9999,1
1650346384441,COGS 9,A01,083615,Staff,0,14,60,60
1650346390463,COGS 11,A01,083617,Boyle; Mary E. T.,22,0,40,18
1650346396506,COGS 13,A01,083071,Staff,0,31,40,40
1650346402530,COGS 14A,A01,092681,Staff,0,19,100,100
1650346408579,COGS 14B,A01,083073,Cheng; Tzu-Han,0,10,50,50
1650346414609,COGS 17,A01,092677,Staff,25,0,75,50
1650346420634,COGS 100,A01,083619,Staff,0,23,60,60
1650346426663,COGS 101A,A01,083621,Davis; Joshua Daniel,0,21,60,60
1650346432689,COGS 101B,A01,091572,Staff,0,0,60,60
1650346438723,COGS 101C,A01,083625,Delgado; Tania,18,0,30,12
1650346444755,COGS 107A,A01,083627,Boyle; Mary E. T.,0,9,60,60
1650346450782,COGS 118A,A01,083075,Staff,4,0,60,56
1650346456810,CSE 3,A50,083646,Miranda; Gregory Joseph,21,0,38,17
1650346456810,CSE 3,A51,083647,Miranda; Gregory Joseph,37,0,37,0
1650346462838,CSE 8A,A50,083650,Miranda; Gregory Joseph,0,28,40,40
1650346468862,CSE 11,A01,083080,Cao; Yingjun,0,88,40,40
1650346474884,CSE 12,A01,083652,Staff,0,12,100,100
1650346480908,CSE 15L,A01,083654,Staff,0,1,50,50
1650346480908,CSE 15L,A02,083655,Staff,3,0,50,47
1650346486933,CSE 20,A01,083657,Staff,52,0,80,28
1650346493053,CSE 30,A01,083084,Eldon; John,0,76,40,40
1650346499077,CSE 100,A01,083659,Cao; Yingjun,0,66,50,50
1650346505099,CSE 134B,A01,083661,Powell; Thomas Allan,0,31,65,65
1650346511122,CSE 140,A01,083663,Staff,0,0,75,75
1650346517145,CSE 140L,A01,083088,Eldon; John,0,6,75,75
1650346523170,CSE 175,A01,083665,Kumar; Rakesh,8,0,25,17
1650346529197,CSE 190,A00,092507,Dubnov; Shlomo,14,0,20,6
1650346535225,ECE 45,A01,083139,Staff,0,17,40,40
1650346541254,ECE 65,A50,083695,Staff,0,5,30,30
1650346547275,ECE 109,A01,091882,Touri; Behrouz,40,0,70,30
1650346553298,ECE 180,A00,083140,Abi Samra; Nicholas Camill,23,0,30,7
1650346553298,ECE 180,B00,083141,Abi Samra; Nicholas Camill,5,0,30,25
1650346559323,MATH 10A,A01,083735,Patchell; Gregory David,7,0,30,23
1650346559323,MATH 10A,A02,083736,Patchell; Gregory David,28,0,30,2
1650346559323,MATH 10A,A03,083737,Patchell; Gregory David,26,0,30,4
1650346565354,MATH 10B,A01,083207,Staff,0,7,30,30
1650346565354,MATH 10B,A02,083208,Staff,0,6,30,30
1650346565354,MATH 10B,B01,083739,Staff,17,0,30,13
1650346565354,MATH 10B,B02,083740,Staff,28,0,30,2
1650346571385,MATH 18,A01,083743,Staff,4,0,30,26
1650346571385,MATH 18,A02,083744,Staff,27,0,30,3
1650346571385,MATH 18,A03,083745,Staff,22,0,30,8
1650346571385,MATH 18,A04,083746,Staff,27,0,30,3
1650346571385,MATH 18,B01,083748,Staff,0,11,30,30
1650346571385,MATH 18,B02,083749,Staff,0,11,30,30
1650346571385,MATH 18,B03,083750,Staff,0,10,30,30
1650346571385,MATH 18,B04,083751,Staff,0,10,30,30
1650346577409,MATH 20A,A01,083754,Staff,26,0,40,14
1650346583443,MATH 20B,A01,083756,Staff,0,8,30,30
1650346583443,MATH 20B,A02,083757,Staff,0,8,30,30
1650346589472,MATH 20C,A01,083760,Staff,0,14,30,30
1650346589472,MATH 20C,A02,083761,Staff,0,14,30,30
1650346589472,MATH 20C,B01,083762,Staff,13,0,30,17
1650346589472,MATH 20C,B02,083763,Staff,28,0,30,2
1650346595499,MATH 20D,A01,083765,Staff,0,1,30,30
1650346595499,MATH 20D,A02,083766,Staff,7,0,30,23
1650346595499,MATH 20D,A03,083767,Staff,26,0,30,4
1650346601526,MATH 20E,A01,083771,Staff,5,0,30,25
1650346601526,MATH 20E,A02,083772,Staff,19,0,30,11
1650346601526,MATH 20E,B01,083773,Staff,0,0,30,30
1650346601526,MATH 20E,B02,083774,Staff,12,0,30,18
1650346607555,MATH 103A,A01,083777,Staff,0,11,30,30
1650346607555,MATH 103A,A02,083778,Staff,0,12,30,30
1650346607555,MATH 103A,B01,083779,Staff,0,13,30,30
1650346607555,MATH 103A,B02,083780,Staff,0,12,30,30
1650346613580,MATH 105,A01,085443,Staff,0,21,30,30
1650346619610,MATH 109,A01,083213,Anzaldo; Leesa B,0,6,30,30
1650346619610,MATH 109,A02,083214,Anzaldo; Leesa B,0,7,30,30
1650346619610,MATH 109,B01,083215,Anzaldo; Leesa B,0,5,30,30
1650346619610,MATH 109,B02,083216,Anzaldo; Leesa B,0,5,30,30
1650346625649,MATH 142A,A01,083219,Chow; Bennett,0,14,30,30
1650346625649,MATH 142A,A02,083220,Chow; Bennett,0,12,30,30
1650346625649,MATH 142A,B01,083221,Chow; Bennett,0,12,30,30
1650346625649,MATH 142A,B02,083222,Chow; Bennett,0,12,30,30
1650346631674,MATH 193A,A01,083224,Staff,0,5,30,30
1650346631674,MATH 193A,A02,083225,Staff,0,5,30,30
1650346631674,MATH 193A,A03,083781,Staff,0,4,30,30
1650346631674,MATH 193A,A04,083782,Staff,0,3,30,30
1650346637702,MATH 197,001,091859,McAuley; Julian John,9998,0,9999,1
1650346643765,COGS 9,A01,083615,Staff,0,14,60,60
1650346649793,COGS 11,A01,083617,Boyle; Mary E. T.,22,0,40,18
1650346655818,COGS 13,A01,083071,Staff,0,31,40,40
1650346661842,COGS 14A,A01,092681,Staff,0,19,100,100
1650346667877,COGS 14B,A01,083073,Cheng; Tzu-Han,0,10,50,50
1650346673904,COGS 17,A01,092677,Staff,25,0,75,50
1650346679930,COGS 100,A01,083619,Staff,0,23,60,60
1650346685955,COGS 101A,A01,083621,Davis; Joshua Daniel,0,21,60,60
1650346691979,COGS 101B,A01,091572,Staff,0,0,60,60
1650346698003,COGS 101C,A01,083625,Delgado; Tania,17,0,30,13
1650346704026,COGS 107A,A01,083627,Boyle; Mary E. T.,0,9,60,60
1650346710049,COGS 118A,A01,083075,Staff,4,0,60,56
1650346716075,CSE 3,A50,083646,Miranda; Gregory Joseph,21,0,38,17
1650346716075,CSE 3,A51,083647,Miranda; Gregory Joseph,37,0,37,0
1650346722098,CSE 8A,A50,083650,Miranda; Gregory Joseph,0,28,40,40
1650346728125,CSE 11,A01,083080,Cao; Yingjun,0,88,40,40
1650346734147,CSE 12,A01,083652,Staff,0,12,100,100
1650346740179,CSE 15L,A01,083654,Staff,0,1,50,50
1650346740179,CSE 15L,A02,083655,Staff,3,0,50,47
1650346746204,CSE 20,A01,083657,Staff,52,0,80,28
1650346752227,CSE 30,A01,083084,Eldon; John,0,76,40,40
1650346758254,CSE 100,A01,083659,Cao; Yingjun,0,66,50,50
1650346764306,CSE 134B,A01,083661,Powell; Thomas Allan,0,31,65,65
1650346770330,CSE 140,A01,083663,Staff,0,0,75,75
1650346776354,CSE 140L,A01,083088,Eldon; John,0,6,75,75
1650346782377,CSE 175,A01,083665,Kumar; Rakesh,8,0,25,17
1650346788399,CSE 190,A00,092507,Dubnov; Shlomo,14,0,20,6
1650346794425,ECE 45,A01,083139,Staff,0,17,40,40
1650346800456,ECE 65,A50,083695,Staff,0,5,30,30
1650346806483,ECE 109,A01,091882,Touri; Behrouz,40,0,70,30
1650346812506,ECE 180,A00,083140,Abi Samra; Nicholas Camill,23,0,30,7
1650346812506,ECE 180,B00,083141,Abi Samra; Nicholas Camill,5,0,30,25
1650346818536,MATH 10A,A01,083735,Patchell; Gregory David,7,0,30,23
1650346818536,MATH 10A,A02,083736,Patchell; Gregory David,28,0,30,2
1650346818536,MATH 10A,A03,083737,Patchell; Gregory David,26,0,30,4
1650346824562,MATH 10B,A01,083207,Staff,0,7,30,30
1650346824562,MATH 10B,A02,083208,Staff,0,6,30,30
1650346824562,MATH 10B,B01,083739,Staff,17,0,30,13
1650346824562,MATH 10B,B02,083740,Staff,28,0,30,2
1650346830600,MATH 18,A01,083743,Staff,4,0,30,26
1650346830600,MATH 18,A02,083744,Staff,27,0,30,3
1650346830600,MATH 18,A03,083745,Staff,22,0,30,8
1650346830600,MATH 18,A04,083746,Staff,27,0,30,3
1650346830600,MATH 18,B01,083748,Staff,0,11,30,30
1650346830600,MATH 18,B02,083749,Staff,0,11,30,30
1650346830600,MATH 18,B03,083750,Staff,0,10,30,30
1650346830600,MATH 18,B04,083751,Staff,0,10,30,30
1650346836631,MATH 20A,A01,083754,Staff,26,0,40,14
1650346842657,MATH 20B,A01,083756,Staff,0,8,30,30
1650346842657,MATH 20B,A02,083757,Staff,0,8,30,30
1650346848682,MATH 20C,A01,083760,Staff,0,14,30,30
1650346848682,MATH 20C,A02,083761,Staff,0,15,30,30
1650346848682,MATH 20C,B01,083762,Staff,13,0,30,17
1650346848682,MATH 20C,B02,083763,Staff,28,0,30,2
1650346854712,MATH 20D,A01,083765,Staff,0,1,30,30
1650346854712,MATH 20D,A02,083766,Staff,7,0,30,23
1650346854712,MATH 20D,A03,083767,Staff,26,0,30,4
1650346860739,MATH 20E,A01,083771,Staff,5,0,30,25
1650346860739,MATH 20E,A02,083772,Staff,19,0,30,11
1650346860739,MATH 20E,B01,083773,Staff,0,0,30,30
1650346860739,MATH 20E,B02,083774,Staff,12,0,30,18
1650346866763,MATH 103A,A01,083777,Staff,0,11,30,30
1650346866763,MATH 103A,A02,083778,Staff,0,12,30,30
1650346866763,MATH 103A,B01,083779,Staff,0,13,30,30
1650346866763,MATH 103A,B02,083780,Staff,0,12,30,30
1650346872791,MATH 105,A01,085443,Staff,0,21,30,30
1650346878815,MATH 109,A01,083213,Anzaldo; Leesa B,0,6,30,30
1650346878815,MATH 109,A02,083214,Anzaldo; Leesa B,0,7,30,30
1650346878815,MATH 109,B01,083215,Anzaldo; Leesa B,0,5,30,30
1650346878815,MATH 109,B02,083216,Anzaldo; Leesa B,0,5,30,30
1650346884842,MATH 142A,A01,083219,Chow; Bennett,0,14,30,30
1650346884842,MATH 142A,A02,083220,Chow; Bennett,0,12,30,30
1650346884842,MATH 142A,B01,083221,Chow; Bennett,0,12,30,30
1650346884842,MATH 142A,B02,083222,Chow; Bennett,0,12,30,30
1650346890870,MATH 193A,A01,083224,Staff,0,5,30,30
1650346890870,MATH 193A,A02,083225,Staff,0,5,30,30
1650346890870,MATH 193A,A03,083781,Staff,0,4,30,30
1650346890870,MATH 193A,A04,083782,Staff,0,3,30,30
1650346896897,MATH 197,001,091859,McAuley; Julian John,9998,0,9999,1
1650346902947,COGS 9,A01,083615,Staff,0,14,60,60
1650346908971,COGS 11,A01,083617,Boyle; Mary E. T.,22,0,40,18
1650346915001,COGS 13,A01,083071,Staff,0,32,40,40
1650346921026,COGS 14A,A01,092681,Staff,0,19,100,100
1650346927055,COGS 14B,A01,083073,Cheng; Tzu-Han,0,10,50,50
1650346933086,COGS 17,A01,092677,Staff,25,0,75,50
1650346939108,COGS 100,A01,083619,Staff,0,23,60,60
1650346945130,COGS 101A,A01,083621,Davis; Joshua Daniel,0,21,60,60
1650346951156,COGS 101B,A01,091572,Staff,0,0,60,60
1650346957181,COGS 101C,A01,083625,Delgado; Tania,17,0,30,13
1650346963204,COGS 107A,A01,083627,Boyle; Mary E. T.,0,9,60,60
1650346969228,COGS 118A,A01,083075,Staff,4,0,60,56
1650346975252,CSE 3,A50,083646,Miranda; Gregory Joseph,21,0,38,17
1650346975252,CSE 3,A51,083647,Miranda; Gregory Joseph,37,0,37,0
1650346981280,CSE 8A,A50,083650,Miranda; Gregory Joseph,0,28,40,40
1650346987303,CSE 11,A01,083080,Cao; Yingjun,0,88,40,40
1650346993329,CSE 12,A01,083652,Staff,0,12,100,100
1650346999353,CSE 15L,A01,083654,Staff,0,1,50,50
1650346999353,CSE 15L,A02,083655,Staff,3,0,50,47
1650347005377,CSE 20,A01,083657,Staff,52,0,80,28
1650347011401,CSE 30,A01,083084,Eldon; John,0,76,40,40
1650347017424,CSE 100,A01,083659,Cao; Yingjun,0,66,50,50
1650347023450,CSE 134B,A01,083661,Powell; Thomas Allan,0,31,65,65
1650347029473,CSE 140,A01,083663,Staff,0,0,75,75
1650347035509,CSE 140L,A01,083088,Eldon; John,0,6,75,75
1650347041533,CSE 175,A01,083665,Kumar; Rakesh,8,0,25,17
1650347047556,CSE 190,A00,092507,Dubnov; Shlomo,14,0,20,6
1650347053585,ECE 45,A01,083139,Staff,0,17,40,40
1650347059612,ECE 65,A50,083695,Staff,0,5,30,30
1650347065647,ECE 109,A01,091882,Touri; Behrouz,40,0,70,30
1650347071674,ECE 180,A00,083140,Abi Samra; Nicholas Camill,23,0,30,7
1650347071674,ECE 180,B00,083141,Abi Samra; Nicholas Camill,5,0,30,25
1650347077702,MATH 10A,A01,083735,Patchell; Gregory David,7,0,30,23
1650347077702,MATH 10A,A02,083736,Patchell; Gregory David,28,0,30,2
1650347077702,MATH 10A,A03,083737,Patchell; Gregory David,26,0,30,4
1650347083731,MATH 10B,A01,083207,Staff,0,7,30,30
1650347083731,MATH 10B,A02,083208,Staff,0,6,30,30
1650347083731,MATH 10B,B01,083739,Staff,17,0,30,13
1650347083731,MATH 10B,B02,083740,Staff,28,0,30,2
1650347089847,MATH 18,A01,083743,Staff,4,0,30,26
1650347089847,MATH 18,A02,083744,Staff,27,0,30,3
1650347089847,MATH 18,A03,083745,Staff,22,0,30,8
1650347089847,MATH 18,A04,083746,Staff,27,0,30,3
1650347089847,MATH 18,B01,083748,Staff,0,11,30,30
1650347089847,MATH 18,B02,083749,Staff,0,11,30,30
1650347089847,MATH 18,B03,083750,Staff,0,11,30,30
1650347089847,MATH 18,B04,083751,Staff,0,9,30,30
1650347095879,MATH 20A,A01,083754,Staff,26,0,40,14
1650347101909,MATH 20B,A01,083756,Staff,0,8,30,30
1650347101909,MATH 20B,A02,083757,Staff,0,8,30,30
1650347107937,MATH 20C,A01,083760,Staff,0,14,30,30
1650347107937,MATH 20C,A02,083761,Staff,0,15,30,30
1650347107937,MATH 20C,B01,083762,Staff,13,0,30,17
1650347107937,MATH 20C,B02,083763,Staff,28,0,30,2
1650347113959,MATH 20D,A01,083765,Staff,0,1,30,30
1650347113959,MATH 20D,A02,083766,Staff,7,0,30,23
1650347113959,MATH 20D,A03,083767,Staff,26,0,30,4
1650347119983,MATH 20E,A01,083771,Staff,5,0,30,25
1650347119983,MATH 20E,A02,083772,Staff,19,0,30,11
1650347119983,MATH 20E,B01,083773,Staff,0,0,30,30
1650347119983,MATH 20E,B02,083774,Staff,12,0,30,18
1650347126015,MATH 103A,A01,083777,Staff,0,11,30,30
1650347126015,MATH 103A,A02,083778,Staff,0,12,30,30
1650347126015,MATH 103A,B01,083779,Staff,0,13,30,30
1650347126015,MATH 103A,B02,083780,Staff,0,12,30,30
1650347132037,MATH 105,A01,085443,Staff,0,21,30,30
1650347138065,MATH 109,A01,083213,Anzaldo; Leesa B,0,6,30,30
1650347138065,MATH 109,A02,083214,Anzaldo; Leesa B,0,7,30,30
1650347138065,MATH 109,B01,083215,Anzaldo; Leesa B,0,5,30,30
1650347138065,MATH 109,B02,083216,Anzaldo; Leesa B,0,5,30,30
1650347144094,MATH 142A,A01,083219,Chow; Bennett,0,14,30,30
1650347144094,MATH 142A,A02,083220,Chow; Bennett,0,12,30,30
1650347144094,MATH 142A,B01,083221,Chow; Bennett,0,12,30,30
1650347144094,MATH 142A,B02,083222,Chow; Bennett,0,12,30,30
1650347150120,MATH 193A,A01,083224,Staff,0,5,30,30
1650347150120,MATH 193A,A02,083225,Staff,0,5,30,30
1650347150120,MATH 193A,A03,083781,Staff,0,4,30,30
1650347150120,MATH 193A,A04,083782,Staff,0,3,30,30
1650347156143,MATH 197,001,091859,McAuley; Julian John,9998,0,9999,1
1650347162203,COGS 9,A01,083615,Staff,0,14,60,60
1650347168228,COGS 11,A01,083617,Boyle; Mary E. T.,22,0,40,18
1650347174254,COGS 13,A01,083071,Staff,0,32,40,40
1650347180278,COGS 14A,A01,092681,Staff,0,19,100,100
1650347186301,COGS 14B,A01,083073,Cheng; Tzu-Han,0,10,50,50
1650347192325,COGS 17,A01,092677,Staff,25,0,75,50
1650347198351,COGS 100,A01,083619,Staff,0,23,60,60
1650347204377,COGS 101A,A01,083621,Davis; Joshua Daniel,0,21,60,60
1650347210403,COGS 101B,A01,091572,Staff,0,0,60,60
1650347216427,COGS 101C,A01,083625,Delgado; Tania,17,0,30,13
1650347222453,COGS 107A,A01,083627,Boyle; Mary E. T.,0,9,60,60
1650347228479,COGS 118A,A01,083075,Staff,4,0,60,56
1650347234502,CSE 3,A50,083646,Miranda; Gregory Joseph,21,0,38,17
1650347234502,CSE 3,A51,083647,Miranda; Gregory Joseph,37,0,37,0
1650347240526,CSE 8A,A50,083650,Miranda; Gregory Joseph,0,28,40,40
1650347246558,CSE 11,A01,083080,Cao; Yingjun,0,88,40,40
1650347252582,CSE 12,A01,083652,Staff,0,12,100,100
1650347258612,CSE 15L,A01,083654,Staff,0,1,50,50
1650347258612,CSE 15L,A02,083655,Staff,3,0,50,47
1650347264636,CSE 20,A01,083657,Staff,52,0,80,28
1650347270669,CSE 30,A01,083084,Eldon; John,0,76,40,40
1650347276693,CSE 100,A01,083659,Cao; Yingjun,0,66,50,50
1650347282721,CSE 134B,A01,083661,Powell; Thomas Allan,0,31,65,65
1650347288749,CSE 140,A01,083663,Staff,0,0,75,75
1650347294781,CSE 140L,A01,083088,Eldon; John,0,6,75,75
1650347300803,CSE 175,A01,083665,Kumar; Rakesh,8,0,25,17
1650347306827,CSE 190,A00,092507,Dubnov; Shlomo,14,0,20,6
1650347312855,ECE 45,A01,083139,Staff,0,17,40,40
1650347318883,ECE 65,A50,083695,Staff,0,5,30,30
1650347324910,ECE 109,A01,091882,Touri; Behrouz,40,0,70,30
1650347330933,ECE 180,A00,083140,Abi Samra; Nicholas Camill,23,0,30,7
1650347330933,ECE 180,B00,083141,Abi Samra; Nicholas Camill,5,0,30,25
1650347336957,MATH 10A,A01,083735,Patchell; Gregory David,7,0,30,23
1650347336957,MATH 10A,A02,083736,Patchell; Gregory David,28,0,30,2
1650347336957,MATH 10A,A03,083737,Patchell; Gregory David,26,0,30,4
1650347342985,MATH 10B,A01,083207,Staff,0,7,30,30
1650347342985,MATH 10B,A02,083208,Staff,0,6,30,30
1650347342985,MATH 10B,B01,083739,Staff,17,0,30,13
1650347342985,MATH 10B,B02,083740,Staff,28,0,30,2
1650347349016,MATH 18,A01,083743,Staff,4,0,30,26
1650347349016,MATH 18,A02,083744,Staff,27,0,30,3
1650347349016,MATH 18,A03,083745,Staff,22,0,30,8
1650347349016,MATH 18,A04,083746,Staff,27,0,30,3
1650347349016,MATH 18,B01,083748,Staff,0,11,30,30
1650347349016,MATH 18,B02,083749,Staff,0,11,30,30
1650347349016,MATH 18,B03,083750,Staff,0,11,30,30
1650347349016,MATH 18,B04,083751,Staff,0,9,30,30
1650347355057,MATH 20A,A01,083754,Staff,26,0,40,14
1650347361080,MATH 20B,A01,083756,Staff,0,8,30,30
1650347361080,MATH 20B,A02,083757,Staff,0,8,30,30
1650347367108,MATH 20C,A01,083760,Staff,0,14,30,30
1650347367108,MATH 20C,A02,083761,Staff,0,15,30,30
1650347367108,MATH 20C,B01,083762,Staff,13,0,30,17
1650347367108,MATH 20C,B02,083763,Staff,28,0,30,2
1650347373132,MATH 20D,A01,083765,Staff,0,1,30,30
1650347373132,MATH 20D,A02,083766,Staff,7,0,30,23
1650347373132,MATH 20D,A03,083767,Staff,26,0,30,4
1650347379157,MATH 20E,A01,083771,Staff,5,0,30,25
1650347379157,MATH 20E,A02,083772,Staff,19,0,30,11
1650347379157,MATH 20E,B01,083773,Staff,0,0,30,30
1650347379157,MATH 20E,B02,083774,Staff,12,0,30,18
1650347385185,MATH 103A,A01,083777,Staff,0,11,30,30
1650347385185,MATH 103A,A02,083778,Staff,0,12,30,30
1650347385185,MATH 103A,B01,083779,Staff,0,13,30,30
1650347385185,MATH 103A,B02,083780,Staff,0,12,30,30
1650347391212,MATH 105,A01,085443,Staff,0,21,30,30
1650347397237,MATH 109,A01,083213,Anzaldo; Leesa B,0,6,30,30
1650347397237,MATH 109,A02,083214,Anzaldo; Leesa B,0,7,30,30
1650347397237,MATH 109,B01,083215,Anzaldo; Leesa B,0,5,30,30
1650347397237,MATH 109,B02,083216,Anzaldo; Leesa B,0,5,30,30
1650347403261,MATH 142A,A01,083219,Chow; Bennett,0,14,30,30
1650347403261,MATH 142A,A02,083220,Chow; Bennett,0,12,30,30
1650347403261,MATH 142A,B01,083221,Chow; Bennett,0,12,30,30
1650347403261,MATH 142A,B02,083222,Chow; Bennett,0,12,30,30
1650347409283,MATH 193A,A01,083224,Staff,0,5,30,30
1650347409283,MATH 193A,A02,083225,Staff,0,5,30,30
1650347409283,MATH 193A,A03,083781,Staff,0,4,30,30
1650347409283,MATH 193A,A04,083782,Staff,0,3,30,30
1650347415307,MATH 197,001,091859,McAuley; Julian John,9998,0,9999,1
1650347421401,COGS 9,A01,083615,Staff,0,14,60,60
1650347427428,COGS 11,A01,083617,Boyle; Mary E. T.,22,0,40,18
1650347433455,COGS 13,A01,083071,Staff,0,32,40,40
1650347439479,COGS 14A,A01,092681,Staff,0,19,100,100
1650347445503,COGS 14B,A01,083073,Cheng; Tzu-Han,0,10,50,50
1650347451529,COGS 17,A01,092677,Staff,25,0,75,50
1650347457553,COGS 100,A01,083619,Staff,0,23,60,60
1650347463583,COGS 101A,A01,083621,Davis; Joshua Daniel,0,21,60,60
1650347469605,COGS 101B,A01,091572,Staff,0,0,60,60
1650347475633,COGS 101C,A01,083625,Delgado; Tania,17,0,30,13
1650347481656,COGS 107A,A01,083627,Boyle; Mary E. T.,0,9,60,60
1650347487682,COGS 118A,A01,083075,Staff,4,0,60,56
1650347493709,CSE 3,A50,083646,Miranda; Gregory Joseph,21,0,38,17
1650347493709,CSE 3,A51,083647,Miranda; Gregory Joseph,37,0,37,0
1650347499730,CSE 8A,A50,083650,Miranda; Gregory Joseph,0,28,40,40
1650347505755,CSE 11,A01,083080,Cao; Yingjun,0,88,40,40
1650347511844,CSE 12,A01,083652,Staff,0,12,100,100
1650347517871,CSE 15L,A01,083654,Staff,0,1,50,50
1650347517871,CSE 15L,A02,083655,Staff,3,0,50,47
1650347523897,CSE 20,A01,083657,Staff,52,0,80,28
1650347529920,CSE 30,A01,083084,Eldon; John,0,76,40,40
1650347535953,CSE 100,A01,083659,Cao; Yingjun,0,66,50,50
1650347541975,CSE 134B,A01,083661,Powell; Thomas Allan,0,31,65,65
1650347547997,CSE 140,A01,083663,Staff,0,0,75,75
1650347554022,CSE 140L,A01,083088,Eldon; John,0,6,75,75
1650347560044,CSE 175,A01,083665,Kumar; Rakesh,8,0,25,17
1650347566066,CSE 190,A00,092507,Dubnov; Shlomo,14,0,20,6
1650347572092,ECE 45,A01,083139,Staff,0,17,40,40
1650347578119,ECE 65,A50,083695,Staff,0,5,30,30
1650347584142,ECE 109,A01,091882,Touri; Behrouz,40,0,70,30
1650347590167,ECE 180,A00,083140,Abi Samra; Nicholas Camill,23,0,30,7
1650347590167,ECE 180,B00,083141,Abi Samra; Nicholas Camill,5,0,30,25
1650347596194,MATH 10A,A01,083735,Patchell; Gregory David,7,0,30,23
1650347596194,MATH 10A,A02,083736,Patchell; Gregory David,28,0,30,2
1650347596194,MATH 10A,A03,083737,Patchell; Gregory David,26,0,30,4
1650347602216,MATH 10B,A01,083207,Staff,0,7,30,30
1650347602216,MATH 10B,A02,083208,Staff,0,6,30,30
1650347602216,MATH 10B,B01,083739,Staff,17,0,30,13
1650347602216,MATH 10B,B02,083740,Staff,28,0,30,2
1650347608239,MATH 18,A01,083743,Staff,4,0,30,26
1650347608239,MATH 18,A02,083744,Staff,27,0,30,3
1650347608239,MATH 18,A03,083745,Staff,22,0,30,8
1650347608239,MATH 18,A04,083746,Staff,27,0,30,3
1650347608239,MATH 18,B01,083748,Staff,0,11,30,30
1650347608239,MATH 18,B02,083749,Staff,0,11,30,30
1650347608239,MATH 18,B03,083750,Staff,0,11,30,30
1650347608239,MATH 18,B04,083751,Staff,0,9,30,30
1650347614263,MATH 20A,A01,083754,Staff,26,0,40,14
1650347620284,MATH 20B,A01,083756,Staff,0,8,30,30
1650347620284,MATH 20B,A02,083757,Staff,0,8,30,30
1650347626316,MATH 20C,A01,083760,Staff,0,14,30,30
1650347626316,MATH 20C,A02,083761,Staff,0,15,30,30
1650347626316,MATH 20C,B01,083762,Staff,13,0,30,17
1650347626316,MATH 20C,B02,083763,Staff,28,0,30,2
1650347632338,MATH 20D,A01,083765,Staff,0,1,30,30
1650347632338,MATH 20D,A02,083766,Staff,7,0,30,23
1650347632338,MATH 20D,A03,083767,Staff,26,0,30,4
1650347638362,MATH 20E,A01,083771,Staff,5,0,30,25
1650347638362,MATH 20E,A02,083772,Staff,19,0,30,11
1650347638362,MATH 20E,B01,083773,Staff,0,0,30,30
1650347638362,MATH 20E,B02,083774,Staff,12,0,30,18
1650347644392,MATH 103A,A01,083777,Staff,0,11,30,30
1650347644392,MATH 103A,A02,083778,Staff,0,12,30,30
1650347644392,MATH 103A,B01,083779,Staff,0,13,30,30
1650347644392,MATH 103A,B02,083780,Staff,0,12,30,30
1650347650424,MATH 105,A01,085443,Staff,0,21,30,30
1650347656448,MATH 109,A01,083213,Anzaldo; Leesa B,0,6,30,30
1650347656448,MATH 109,A02,083214,Anzaldo; Leesa B,0,7,30,30
1650347656448,MATH 109,B01,083215,Anzaldo; Leesa B,0,5,30,30
1650347656448,MATH 109,B02,083216,Anzaldo; Leesa B,0,5,30,30
1650347662536,MATH 142A,A01,083219,Chow; Bennett,0,14,30,30
1650347662536,MATH 142A,A02,083220,Chow; Bennett,0,12,30,30
1650347662536,MATH 142A,B01,083221,Chow; Bennett,0,12,30,30
1650347662536,MATH 142A,B02,083222,Chow; Bennett,0,12,30,30
1650347668563,MATH 193A,A01,083224,Staff,0,5,30,30
1650347668563,MATH 193A,A02,083225,Staff,0,5,30,30
1650347668563,MATH 193A,A03,083781,Staff,0,4,30,30
1650347668563,MATH 193A,A04,083782,Staff,0,3,30,30
1650347674590,MATH 197,001,091859,McAuley; Julian John,9998,0,9999,1
1650347680716,COGS 9,A01,083615,Staff,0,14,60,60
1650347686741,COGS 11,A01,083617,Boyle; Mary E. T.,22,0,40,18
1650347692764,COGS 13,A01,083071,Staff,0,32,40,40
1650347698789,COGS 14A,A01,092681,Staff,0,19,100,100
1650347704813,COGS 14B,A01,083073,Cheng; Tzu-Han,0,10,50,50
1650347710837,COGS 17,A01,092677,Staff,25,0,75,50
1650347716859,COGS 100,A01,083619,Staff,0,23,60,60
1650347722885,COGS 101A,A01,083621,Davis; Joshua Daniel,0,21,60,60
1650347728909,COGS 101B,A01,091572,Staff,0,0,60,60
1650347734938,COGS 101C,A01,083625,Delgado; Tania,17,0,30,13
1650347740965,COGS 107A,A01,083627,Boyle; Mary E. T.,0,9,60,60
1650347746987,COGS 118A,A01,083075,Staff,4,0,60,56
1650347753012,CSE 3,A50,083646,Miranda; Gregory Joseph,21,0,38,17
1650347753012,CSE 3,A51,083647,Miranda; Gregory Joseph,37,0,37,0
1650347759041,CSE 8A,A50,083650,Miranda; Gregory Joseph,0,28,40,40
1650347765066,CSE 11,A01,083080,Cao; Yingjun,0,88,40,40
1650347771089,CSE 12,A01,083652,Staff,0,12,100,100
1650347777112,CSE 15L,A01,083654,Staff,0,1,50,50
1650347777112,CSE 15L,A02,083655,Staff,3,0,50,47
1650347783136,CSE 20,A01,083657,Staff,52,0,80,28
1650347789160,CSE 30,A01,083084,Eldon; John,0,76,40,40
1650347795184,CSE 100,A01,083659,Cao; Yingjun,0,66,50,50
1650347801213,CSE 134B,A01,083661,Powell; Thomas Allan,0,31,65,65
1650347807242,CSE 140,A01,083663,Staff,0,0,75,75
1650347813267,CSE 140L,A01,083088,Eldon; John,0,6,75,75
1650347819298,CSE 175,A01,083665,Kumar; Rakesh,8,0,25,17
1650347825327,CSE 190,A00,092507,Dubnov; Shlomo,14,0,20,6
1650347831352,ECE 45,A01,083139,Staff,0,17,40,40
1650347837380,ECE 65,A50,083695,Staff,0,5,30,30
1650347843406,ECE 109,A01,091882,Touri; Behrouz,40,0,70,30
1650347849432,ECE 180,A00,083140,Abi Samra; Nicholas Camill,23,0,30,7
1650347849432,ECE 180,B00,083141,Abi Samra; Nicholas Camill,5,0,30,25
1650347855459,MATH 10A,A01,083735,Patchell; Gregory David,7,0,30,23
1650347855459,MATH 10A,A02,083736,Patchell; Gregory David,28,0,30,2
1650347855459,MATH 10A,A03,083737,Patchell; Gregory David,26,0,30,4
1650347861484,MATH 10B,A01,083207,Staff,0,7,30,30
1650347861484,MATH 10B,A02,083208,Staff,0,6,30,30
1650347861484,MATH 10B,B01,083739,Staff,17,0,30,13
1650347861484,MATH 10B,B02,083740,Staff,28,0,30,2
1650347867510,MATH 18,A01,083743,Staff,4,0,30,26
1650347867510,MATH 18,A02,083744,Staff,27,0,30,3
1650347867510,MATH 18,A03,083745,Staff,22,0,30,8
1650347867510,MATH 18,A04,083746,Staff,27,0,30,3
1650347867510,MATH 18,B01,083748,Staff,0,11,30,30
1650347867510,MATH 18,B02,083749,Staff,0,11,30,30
1650347867510,MATH 18,B03,083750,Staff,0,11,30,30
1650347867510,MATH 18,B04,083751,Staff,0,9,30,30
1650347873534,MATH 20A,A01,083754,Staff,26,0,40,14
1650347879560,MATH 20B,A01,083756,Staff,0,8,30,30
1650347879560,MATH 20B,A02,083757,Staff,0,8,30,30
1650347885589,MATH 20C,A01,083760,Staff,0,14,30,30
1650347885589,MATH 20C,A02,083761,Staff,0,15,30,30
1650347885589,MATH 20C,B01,083762,Staff,13,0,30,17
1650347885589,MATH 20C,B02,083763,Staff,28,0,30,2
1650347891611,MATH 20D,A01,083765,Staff,0,1,30,30
1650347891611,MATH 20D,A02,083766,Staff,7,0,30,23
1650347891611,MATH 20D,A03,083767,Staff,26,0,30,4
1650347897649,MATH 20E,A01,083771,Staff,5,0,30,25
1650347897649,MATH 20E,A02,083772,Staff,19,0,30,11
1650347897649,MATH 20E,B01,083773,Staff,0,0,30,30
1650347897649,MATH 20E,B02,083774,Staff,12,0,30,18
1650347903676,MATH 103A,A01,083777,Staff,0,11,30,30
1650347903676,MATH 103A,A02,083778,Staff,0,12,30,30
1650347903676,MATH 103A,B01,083779,Staff,0,13,30,30
1650347903676,MATH 103A,B02,083780,Staff,0,12,30,30
1650347909701,MATH 105,A01,085443,Staff,0,21,30,30
1650347915728,MATH 109,A01,083213,Anzaldo; Leesa B,0,6,30,30
1650347915728,MATH 109,A02,083214,Anzaldo; Leesa B,0,7,30,30
1650347915728,MATH 109,B01,083215,Anzaldo; Leesa B,0,5,30,30
1650347915728,MATH 109,B02,083216,Anzaldo; Leesa B,0,5,30,30
1650347921752,MATH 142A,A01,083219,Chow; Bennett,0,14,30,30
1650347921752,MATH 142A,A02,083220,Chow; Bennett,0,12,30,30
1650347921752,MATH 142A,B01,083221,Chow; Bennett,0,12,30,30
1650347921752,MATH 142A,B02,083222,Chow; Bennett,0,12,30,30
1650347927777,MATH 193A,A01,083224,Staff,0,5,30,30
1650347927777,MATH 193A,A02,083225,Staff,0,5,30,30
1650347927777,MATH 193A,A03,083781,Staff,0,4,30,30
1650347927777,MATH 193A,A04,083782,Staff,0,3,30,30
1650347933806,MATH 197,001,091859,McAuley; Julian John,9998,0,9999,1
1650347939866,COGS 9,A01,083615,Staff,0,14,60,60
1650347945891,COGS 11,A01,083617,Boyle; Mary E. T.,22,0,40,18
1650347951914,COGS 13,A01,083071,Staff,0,32,40,40
1650347957937,COGS 14A,A01,092681,Staff,0,19,100,100
1650347963962,COGS 14B,A01,083073,Cheng; Tzu-Han,0,10,50,50
1650347969986,COGS 17,A01,092677,Staff,25,0,75,50
1650347976011,COGS 100,A01,083619,Staff,0,23,60,60
1650347982034,COGS 101A,A01,083621,Davis; Joshua Daniel,0,21,60,60
1650347988061,COGS 101B,A01,091572,Staff,0,0,60,60
1650347994085,COGS 101C,A01,083625,Delgado; Tania,17,0,30,13
1650348000111,COGS 107A,A01,083627,Boyle; Mary E. T.,0,9,60,60
1650348006134,COGS 118A,A01,083075,Staff,4,0,60,56
1650348012161,CSE 3,A50,083646,Miranda; Gregory Joseph,21,0,38,17
1650348012161,CSE 3,A51,083647,Miranda; Gregory Joseph,37,0,37,0
1650348018184,CSE 8A,A50,083650,Miranda; Gregory Joseph,0,28,40,40
1650348024221,CSE 11,A01,083080,Cao; Yingjun,0,88,40,40
1650348030244,CSE 12,A01,083652,Staff,0,12,100,100
1650348036267,CSE 15L,A01,083654,Staff,0,1,50,50
1650348036267,CSE 15L,A02,083655,Staff,3,0,50,47
1650348042291,CSE 20,A01,083657,Staff,52,0,80,28
1650348048316,CSE 30,A01,083084,Eldon; John,0,76,40,40
1650348054345,CSE 100,A01,083659,Cao; Yingjun,0,66,50,50
1650348060375,CSE 134B,A01,083661,Powell; Thomas Allan,0,31,65,65
1650348066400,CSE 140,A01,083663,Staff,0,0,75,75
1650348072430,CSE 140L,A01,083088,Eldon; John,0,6,75,75
1650348078460,CSE 175,A01,083665,Kumar; Rakesh,8,0,25,17
1650348084499,CSE 190,A00,092507,Dubnov; Shlomo,14,0,20,6
1650348090524,ECE 45,A01,083139,Staff,0,17,40,40
1650348096548,ECE 65,A50,083695,Staff,0,5,30,30
1650348102571,ECE 109,A01,091882,Touri; Behrouz,40,0,70,30
1650348108597,ECE 180,A00,083140,Abi Samra; Nicholas Camill,23,0,30,7
1650348108597,ECE 180,B00,083141,Abi Samra; Nicholas Camill,5,0,30,25
1650348114622,MATH 10A,A01,083735,Patchell; Gregory David,7,0,30,23
1650348114622,MATH 10A,A02,083736,Patchell; Gregory David,28,0,30,2
1650348114622,MATH 10A,A03,083737,Patchell; Gregory David,26,0,30,4
1650348120655,MATH 10B,A01,083207,Staff,0,7,30,30
1650348120655,MATH 10B,A02,083208,Staff,0,6,30,30
1650348120655,MATH 10B,B01,083739,Staff,17,0,30,13
1650348120655,MATH 10B,B02,083740,Staff,28,0,30,2
1650348126681,MATH 18,A01,083743,Staff,4,0,30,26
1650348126681,MATH 18,A02,083744,Staff,27,0,30,3
1650348126681,MATH 18,A03,083745,Staff,22,0,30,8
1650348126681,MATH 18,A04,083746,Staff,27,0,30,3
1650348126681,MATH 18,B01,083748,Staff,0,11,30,30
1650348126681,MATH 18,B02,083749,Staff,0,11,30,30
1650348126681,MATH 18,B03,083750,Staff,0,11,30,30
1650348126681,MATH 18,B04,083751,Staff,0,9,30,30
1650348132707,MATH 20A,A01,083754,Staff,26,0,40,14
1650348138731,MATH 20B,A01,083756,Staff,0,8,30,30
1650348138731,MATH 20B,A02,083757,Staff,0,8,30,30
1650348144759,MATH 20C,A01,083760,Staff,0,14,30,30
1650348144759,MATH 20C,A02,083761,Staff,0,15,30,30
1650348144759,MATH 20C,B01,083762,Staff,13,0,30,17
1650348144759,MATH 20C,B02,083763,Staff,28,0,30,2
1650348150782,MATH 20D,A01,083765,Staff,0,1,30,30
1650348150782,MATH 20D,A02,083766,Staff,7,0,30,23
1650348150782,MATH 20D,A03,083767,Staff,26,0,30,4
1650348156810,MATH 20E,A01,083771,Staff,5,0,30,25
1650348156810,MATH 20E,A02,083772,Staff,19,0,30,11
1650348156810,MATH 20E,B01,083773,Staff,0,0,30,30
1650348156810,MATH 20E,B02,083774,Staff,12,0,30,18
1650348162840,MATH 103A,A01,083777,Staff,0,11,30,30
1650348162840,MATH 103A,A02,083778,Staff,0,12,30,30
1650348162840,MATH 103A,B01,083779,Staff,0,13,30,30
1650348162840,MATH 103A,B02,083780,Staff,0,12,30,30
1650348168863,MATH 105,A01,085443,Staff,0,21,30,30
1650348174895,MATH 109,A01,083213,Anzaldo; Leesa B,0,6,30,30
1650348174895,MATH 109,A02,083214,Anzaldo; Leesa B,0,7,30,30
1650348174895,MATH 109,B01,083215,Anzaldo; Leesa B,0,5,30,30
1650348174895,MATH 109,B02,083216,Anzaldo; Leesa B,0,5,30,30
1650348180928,MATH 142A,A01,083219,Chow; Bennett,0,14,30,30
1650348180928,MATH 142A,A02,083220,Chow; Bennett,0,12,30,30
1650348180928,MATH 142A,B01,083221,Chow; Bennett,0,12,30,30
1650348180928,MATH 142A,B02,083222,Chow; Bennett,0,12,30,30
1650348186954,MATH 193A,A01,083224,Staff,0,5,30,30
1650348186954,MATH 193A,A02,083225,Staff,0,5,30,30
1650348186954,MATH 193A,A03,083781,Staff,0,4,30,30
1650348186954,MATH 193A,A04,083782,Staff,0,3,30,30
1650348192979,MATH 197,001,091859,McAuley; Julian John,9998,0,9999,1
1650348199039,COGS 9,A01,083615,Staff,0,14,60,60
1650348205067,COGS 11,A01,083617,Boyle; Mary E. T.,22,0,40,18
1650348211095,COGS 13,A01,083071,Staff,0,32,40,40
1650348217119,COGS 14A,A01,092681,Staff,0,20,100,100
1650348223142,COGS 14B,A01,083073,Cheng; Tzu-Han,0,10,50,50
1650348229176,COGS 17,A01,092677,Staff,25,0,75,50
1650348235199,COGS 100,A01,083619,Staff,0,23,60,60
1650348241222,COGS 101A,A01,083621,Davis; Joshua Daniel,0,21,60,60
1650348247252,COGS 101B,A01,091572,Staff,0,0,60,60
1650348253279,COGS 101C,A01,083625,Delgado; Tania,17,0,30,13
1650348259313,COGS 107A,A01,083627,Boyle; Mary E. T.,0,9,60,60
1650348265340,COGS 118A,A01,083075,Staff,4,0,60,56
1650348271363,CSE 3,A50,083646,Miranda; Gregory Joseph,21,0,38,17
1650348271363,CSE 3,A51,083647,Miranda; Gregory Joseph,37,0,37,0
1650348277462,CSE 8A,A50,083650,Miranda; Gregory Joseph,0,28,40,40
1650348283486,CSE 11,A01,083080,Cao; Yingjun,0,88,40,40
1650348289516,CSE 12,A01,083652,Staff,0,12,100,100
1650348295543,CSE 15L,A01,083654,Staff,0,1,50,50
1650348295543,CSE 15L,A02,083655,Staff,3,0,50,47
1650348301567,CSE 20,A01,083657,Staff,52,0,80,28
1650348307591,CSE 30,A01,083084,Eldon; John,0,76,40,40
1650348313613,CSE 100,A01,083659,Cao; Yingjun,0,66,50,50
1650348319637,CSE 134B,A01,083661,Powell; Thomas Allan,0,31,65,65
1650348325669,CSE 140,A01,083663,Staff,0,0,75,75
1650348331692,CSE 140L,A01,083088,Eldon; John,0,6,75,75
1650348337716,CSE 175,A01,083665,Kumar; Rakesh,8,0,25,17
1650348343747,CSE 190,A00,092507,Dubnov; Shlomo,14,0,20,6
1650348349783,ECE 45,A01,083139,Staff,0,17,40,40
1650348355815,ECE 65,A50,083695,Staff,0,5,30,30
1650348361839,ECE 109,A01,091882,Touri; Behrouz,40,0,70,30
1650348367868,ECE 180,A00,083140,Abi Samra; Nicholas Camill,23,0,30,7
1650348367868,ECE 180,B00,083141,Abi Samra; Nicholas Camill,5,0,30,25
1650348373897,MATH 10A,A01,083735,Patchell; Gregory David,7,0,30,23
1650348373897,MATH 10A,A02,083736,Patchell; Gregory David,28,0,30,2
1650348373897,MATH 10A,A03,083737,Patchell; Gregory David,26,0,30,4
1650348379922,MATH 10B,A01,083207,Staff,0,7,30,30
1650348379922,MATH 10B,A02,083208,Staff,0,6,30,30
1650348379922,MATH 10B,B01,083739,Staff,17,0,30,13
1650348379922,MATH 10B,B02,083740,Staff,28,0,30,2
1650348385947,MATH 18,A01,083743,Staff,4,0,30,26
1650348385947,MATH 18,A02,083744,Staff,27,0,30,3
1650348385947,MATH 18,A03,083745,Staff,22,0,30,8
1650348385947,MATH 18,A04,083746,Staff,27,0,30,3
1650348385947,MATH 18,B01,083748,Staff,0,11,30,30
1650348385947,MATH 18,B02,083749,Staff,0,11,30,30
1650348385947,MATH 18,B03,083750,Staff,0,11,30,30
1650348385947,MATH 18,B04,083751,Staff,0,9,30,30
1650348391973,MATH 20A,A01,083754,Staff,26,0,40,14
1650348398001,MATH 20B,A01,083756,Staff,0,8,30,30
1650348398001,MATH 20B,A02,083757,Staff,0,8,30,30
1650348404032,MATH 20C,A01,083760,Staff,0,14,30,30
1650348404032,MATH 20C,A02,083761,Staff,0,15,30,30
1650348404032,MATH 20C,B01,083762,Staff,13,0,30,17
1650348404032,MATH 20C,B02,083763,Staff,28,0,30,2
1650348410060,MATH 20D,A01,083765,Staff,0,1,30,30
1650348410060,MATH 20D,A02,083766,Staff,7,0,30,23
1650348410060,MATH 20D,A03,083767,Staff,26,0,30,4
1650348416086,MATH 20E,A01,083771,Staff,5,0,30,25
1650348416086,MATH 20E,A02,083772,Staff,19,0,30,11
1650348416086,MATH 20E,B01,083773,Staff,0,0,30,30
1650348416086,MATH 20E,B02,083774,Staff,12,0,30,18
1650348422116,MATH 103A,A01,083777,Staff,0,11,30,30
1650348422116,MATH 103A,A02,083778,Staff,0,12,30,30
1650348422116,MATH 103A,B01,083779,Staff,0,13,30,30
1650348422116,MATH 103A,B02,083780,Staff,0,12,30,30
1650348428140,MATH 105,A01,085443,Staff,0,21,30,30
1650348434164,MATH 109,A01,083213,Anzaldo; Leesa B,0,6,30,30
1650348434164,MATH 109,A02,083214,Anzaldo; Leesa B,0,7,30,30
1650348434164,MATH 109,B01,083215,Anzaldo; Leesa B,0,5,30,30
1650348434164,MATH 109,B02,083216,Anzaldo; Leesa B,0,5,30,30
1650348440189,MATH 142A,A01,083219,Chow; Bennett,0,14,30,30
1650348440189,MATH 142A,A02,083220,Chow; Bennett,0,12,30,30
1650348440189,MATH 142A,B01,083221,Chow; Bennett,0,12,30,30
1650348440189,MATH 142A,B02,083222,Chow; Bennett,0,12,30,30
1650348446214,MATH 193A,A01,083224,Staff,0,5,30,30
1650348446214,MATH 193A,A02,083225,Staff,0,5,30,30
1650348446214,MATH 193A,A03,083781,Staff,0,4,30,30
1650348446214,MATH 193A,A04,083782,Staff,0,3,30,30
1650348452235,MATH 197,001,091859,McAuley; Julian John,9998,0,9999,1
1650348458286,COGS 9,A01,083615,Staff,0,14,60,60
1650348464308,COGS 11,A01,083617,Boyle; Mary E. T.,22,0,40,18
1650348470331,COGS 13,A01,083071,Staff,0,32,40,40
1650348476355,COGS 14A,A01,092681,Staff,0,20,100,100
1650348482384,COGS 14B,A01,083073,Cheng; Tzu-Han,0,10,50,50
1650348488409,COGS 17,A01,092677,Staff,25,0,75,50
1650348494432,COGS 100,A01,083619,Staff,0,23,60,60
1650348500466,COGS 101A,A01,083621,Davis; Joshua Daniel,0,21,60,60
1650348506490,COGS 101B,A01,091572,Staff,0,0,60,60
1650348512517,COGS 101C,A01,083625,Delgado; Tania,17,0,30,13
1650348518548,COGS 107A,A01,083627,Boyle; Mary E. T.,0,9,60,60
1650348524589,COGS 118A,A01,083075,Staff,4,0,60,56
1650348530617,CSE 3,A50,083646,Miranda; Gregory Joseph,21,0,38,17
1650348530617,CSE 3,A51,083647,Miranda; Gregory Joseph,37,0,37,0
1650348536645,CSE 8A,A50,083650,Miranda; Gregory Joseph,0,28,40,40
1650348542672,CSE 11,A01,083080,Cao; Yingjun,0,88,40,40
1650348548701,CSE 12,A01,083652,Staff,0,12,100,100
1650348554723,CSE 15L,A01,083654,Staff,0,1,50,50
1650348554723,CSE 15L,A02,083655,Staff,3,0,50,47
1650348560747,CSE 20,A01,083657,Staff,52,0,80,28
1650348566784,CSE 30,A01,083084,Eldon; John,0,76,40,40
1650348572827,CSE 100,A01,083659,Cao; Yingjun,0,66,50,50
1650348578855,CSE 134B,A01,083661,Powell; Thomas Allan,0,31,65,65
1650348584883,CSE 140,A01,083663,Staff,0,0,75,75
1650348590907,CSE 140L,A01,083088,Eldon; John,0,6,75,75
1650348596934,CSE 175,A01,083665,Kumar; Rakesh,8,0,25,17
1650348602959,CSE 190,A00,092507,Dubnov; Shlomo,14,0,20,6
1650348608982,ECE 45,A01,083139,Staff,0,17,40,40
1650348615020,ECE 65,A50,083695,Staff,0,5,30,30
1650348621048,ECE 109,A01,091882,Touri; Behrouz,40,0,70,30
1650348627072,ECE 180,A00,083140,Abi Samra; Nicholas Camill,23,0,30,7
1650348627072,ECE 180,B00,083141,Abi Samra; Nicholas Camill,5,0,30,25
1650348633099,MATH 10A,A01,083735,Patchell; Gregory David,7,0,30,23
1650348633099,MATH 10A,A02,083736,Patchell; Gregory David,28,0,30,2
1650348633099,MATH 10A,A03,083737,Patchell; Gregory David,26,0,30,4
1650348639127,MATH 10B,A01,083207,Staff,0,7,30,30
1650348639127,MATH 10B,A02,083208,Staff,0,6,30,30
1650348639127,MATH 10B,B01,083739,Staff,17,0,30,13
1650348639127,MATH 10B,B02,083740,Staff,28,0,30,2
1650348645154,MATH 18,A01,083743,Staff,4,0,30,26
1650348645154,MATH 18,A02,083744,Staff,27,0,30,3
1650348645154,MATH 18,A03,083745,Staff,22,0,30,8
1650348645154,MATH 18,A04,083746,Staff,27,0,30,3
1650348645154,MATH 18,B01,083748,Staff,0,11,30,30
1650348645154,MATH 18,B02,083749,Staff,0,11,30,30
1650348645154,MATH 18,B03,083750,Staff,0,11,30,30
1650348645154,MATH 18,B04,083751,Staff,0,9,30,30
1650348651178,MATH 20A,A01,083754,Staff,26,0,40,14
1650348657210,MATH 20B,A01,083756,Staff,0,8,30,30
1650348657210,MATH 20B,A02,083757,Staff,0,8,30,30
1650348663240,MATH 20C,A01,083760,Staff,0,14,30,30
1650348663240,MATH 20C,A02,083761,Staff,0,15,30,30
1650348663240,MATH 20C,B01,083762,Staff,13,0,30,17
1650348663240,MATH 20C,B02,083763,Staff,28,0,30,2
1650348669262,MATH 20D,A01,083765,Staff,0,1,30,30
1650348669262,MATH 20D,A02,083766,Staff,7,0,30,23
1650348669262,MATH 20D,A03,083767,Staff,26,0,30,4
1650348675285,MATH 20E,A01,083771,Staff,5,0,30,25
1650348675285,MATH 20E,A02,083772,Staff,19,0,30,11
1650348675285,MATH 20E,B01,083773,Staff,0,0,30,30
1650348675285,MATH 20E,B02,083774,Staff,12,0,30,18
1650348681313,MATH 103A,A01,083777,Staff,0,11,30,30
1650348681313,MATH 103A,A02,083778,Staff,0,12,30,30
1650348681313,MATH 103A,B01,083779,Staff,0,13,30,30
1650348681313,MATH 103A,B02,083780,Staff,0,12,30,30
1650348687337,MATH 105,A01,085443,Staff,0,21,30,30
1650348693365,MATH 109,A01,083213,Anzaldo; Leesa B,0,6,30,30
1650348693365,MATH 109,A02,083214,Anzaldo; Leesa B,0,7,30,30
1650348693365,MATH 109,B01,083215,Anzaldo; Leesa B,0,5,30,30
1650348693365,MATH 109,B02,083216,Anzaldo; Leesa B,0,5,30,30
1650348699390,MATH 142A,A01,083219,Chow; Bennett,0,14,30,30
1650348699390,MATH 142A,A02,083220,Chow; Bennett,0,12,30,30
1650348699390,MATH 142A,B01,083221,Chow; Bennett,0,12,30,30
1650348699390,MATH 142A,B02,083222,Chow; Bennett,0,12,30,30
1650348705419,MATH 193A,A01,083224,Staff,0,5,30,30
1650348705419,MATH 193A,A02,083225,Staff,0,5,30,30
1650348705419,MATH 193A,A03,083781,Staff,0,4,30,30
1650348705419,MATH 193A,A04,083782,Staff,0,3,30,30
1650348711455,MATH 197,001,091859,McAuley; Julian John,9998,0,9999,1
1650348717510,COGS 9,A01,083615,Staff,0,14,60,60
1650348723536,COGS 11,A01,083617,Boyle; Mary E. T.,22,0,40,18
1650348729559,COGS 13,A01,083071,Staff,0,32,40,40
1650348735582,COGS 14A,A01,092681,Staff,0,20,100,100
1650348741610,COGS 14B,A01,083073,Cheng; Tzu-Han,0,10,50,50
1650348747634,COGS 17,A01,092677,Staff,24,0,75,51
1650348753661,COGS 100,A01,083619,Staff,0,23,60,60
1650348759688,COGS 101A,A01,083621,Davis; Joshua Daniel,0,21,60,60
1650348765717,COGS 101B,A01,091572,Staff,0,0,60,60
1650348771739,COGS 101C,A01,083625,Delgado; Tania,17,0,30,13
1650348777762,COGS 107A,A01,083627,Boyle; Mary E. T.,0,9,60,60
1650348783787,COGS 118A,A01,083075,Staff,4,0,60,56
1650348789812,CSE 3,A50,083646,Miranda; Gregory Joseph,21,0,38,17
1650348789812,CSE 3,A51,083647,Miranda; Gregory Joseph,37,0,37,0
1650348795852,CSE 8A,A50,083650,Miranda; Gregory Joseph,0,28,40,40
1650348801874,CSE 11,A01,083080,Cao; Yingjun,0,88,40,40
1650348807898,CSE 12,A01,083652,Staff,0,12,100,100
1650348813922,CSE 15L,A01,083654,Staff,0,1,50,50
1650348813922,CSE 15L,A02,083655,Staff,3,0,50,47
1650348819947,CSE 20,A01,083657,Staff,52,0,80,28
1650348825969,CSE 30,A01,083084,Eldon; John,0,76,40,40
1650348831992,CSE 100,A01,083659,Cao; Yingjun,0,66,50,50
1650348838020,CSE 134B,A01,083661,Powell; Thomas Allan,0,31,65,65
1650348844048,CSE 140,A01,083663,Staff,0,0,75,75
1650348850074,CSE 140L,A01,083088,Eldon; John,0,6,75,75
1650348856098,CSE 175,A01,083665,Kumar; Rakesh,8,0,25,17
1650348862120,CSE 190,A00,092507,Dubnov; Shlomo,14,0,20,6
1650348868147,ECE 45,A01,083139,Staff,0,17,40,40
1650348874257,ECE 65,A50,083695,Staff,0,5,30,30
1650348880280,ECE 109,A01,091882,Touri; Behrouz,40,0,70,30
1650348886307,ECE 180,A00,083140,Abi Samra; Nicholas Camill,23,0,30,7
1650348886307,ECE 180,B00,083141,Abi Samra; Nicholas Camill,5,0,30,25
1650348892337,MATH 10A,A01,083735,Patchell; Gregory David,7,0,30,23
1650348892337,MATH 10A,A02,083736,Patchell; Gregory David,28,0,30,2
1650348892337,MATH 10A,A03,083737,Patchell; Gregory David,26,0,30,4
1650348898362,MATH 10B,A01,083207,Staff,0,7,30,30
1650348898362,MATH 10B,A02,083208,Staff,0,6,30,30
1650348898362,MATH 10B,B01,083739,Staff,17,0,30,13
1650348898362,MATH 10B,B02,083740,Staff,28,0,30,2
1650348904386,MATH 18,A01,083743,Staff,4,0,30,26
1650348904386,MATH 18,A02,083744,Staff,27,0,30,3
1650348904386,MATH 18,A03,083745,Staff,22,0,30,8
1650348904386,MATH 18,A04,083746,Staff,27,0,30,3
1650348904386,MATH 18,B01,083748,Staff,0,11,30,30
1650348904386,MATH 18,B02,083749,Staff,0,11,30,30
1650348904386,MATH 18,B03,083750,Staff,0,11,30,30
1650348904386,MATH 18,B04,083751,Staff,0,9,30,30
1650348910417,MATH 20A,A01,083754,Staff,26,0,40,14
1650348916439,MATH 20B,A01,083756,Staff,0,8,30,30
1650348916439,MATH 20B,A02,083757,Staff,0,8,30,30
1650348922463,MATH 20C,A01,083760,Staff,0,14,30,30
1650348922463,MATH 20C,A02,083761,Staff,0,15,30,30
1650348922463,MATH 20C,B01,083762,Staff,13,0,30,17
1650348922463,MATH 20C,B02,083763,Staff,28,0,30,2
1650348928486,MATH 20D,A01,083765,Staff,0,1,30,30
1650348928486,MATH 20D,A02,083766,Staff,7,0,30,23
1650348928486,MATH 20D,A03,083767,Staff,26,0,30,4
1650348934512,MATH 20E,A01,083771,Staff,5,0,30,25
1650348934512,MATH 20E,A02,083772,Staff,19,0,30,11
1650348934512,MATH 20E,B01,083773,Staff,0,0,30,30
1650348934512,MATH 20E,B02,083774,Staff,12,0,30,18
1650348940536,MATH 103A,A01,083777,Staff,0,11,30,30
1650348940536,MATH 103A,A02,083778,Staff,0,12,30,30
1650348940536,MATH 103A,B01,083779,Staff,0,13,30,30
1650348940536,MATH 103A,B02,083780,Staff,0,12,30,30
1650348946563,MATH 105,A01,085443,Staff,0,21,30,30
1650348952594,MATH 109,A01,083213,Anzaldo; Leesa B,0,6,30,30
1650348952594,MATH 109,A02,083214,Anzaldo; Leesa B,0,7,30,30
1650348952594,MATH 109,B01,083215,Anzaldo; Leesa B,0,5,30,30
1650348952594,MATH 109,B02,083216,Anzaldo; Leesa B,0,5,30,30
1650348958618,MATH 142A,A01,083219,Chow; Bennett,0,14,30,30
1650348958618,MATH 142A,A02,083220,Chow; Bennett,0,12,30,30
1650348958618,MATH 142A,B01,083221,Chow; Bennett,0,12,30,30
1650348958618,MATH 142A,B02,083222,Chow; Bennett,0,12,30,30
1650348964649,MATH 193A,A01,083224,Staff,0,5,30,30
1650348964649,MATH 193A,A02,083225,Staff,0,5,30,30
1650348964649,MATH 193A,A03,083781,Staff,0,4,30,30
1650348964649,MATH 193A,A04,083782,Staff,0,3,30,30
1650348970671,MATH 197,001,091859,McAuley; Julian John,9998,0,9999,1
1650348976753,COGS 9,A01,083615,Staff,0,14,60,60
1650348982781,COGS 11,A01,083617,Boyle; Mary E. T.,22,0,40,18
1650348988809,COGS 13,A01,083071,Staff,0,32,40,40
1650348994832,COGS 14A,A01,092681,Staff,0,20,100,100
1650349000858,COGS 14B,A01,083073,Cheng; Tzu-Han,0,10,50,50
1650349006886,COGS 17,A01,092677,Staff,24,0,75,51
1650349012910,COGS 100,A01,083619,Staff,0,23,60,60
1650349018936,COGS 101A,A01,083621,Davis; Joshua Daniel,0,21,60,60
1650349024960,COGS 101B,A01,091572,Staff,0,0,60,60
1650349030992,COGS 101C,A01,083625,Delgado; Tania,17,0,30,13
1650349037016,COGS 107A,A01,083627,Boyle; Mary E. T.,0,9,60,60
1650349043039,COGS 118A,A01,083075,Staff,4,0,60,56
1650349049063,CSE 3,A50,083646,Miranda; Gregory Joseph,21,0,38,17
1650349049063,CSE 3,A51,083647,Miranda; Gregory Joseph,37,0,37,0
1650349055093,CSE 8A,A50,083650,Miranda; Gregory Joseph,0,28,40,40
1650349061125,CSE 11,A01,083080,Cao; Yingjun,0,88,40,40
1650349067148,CSE 12,A01,083652,Staff,0,12,100,100
1650349073174,CSE 15L,A01,083654,Staff,0,1,50,50
1650349073174,CSE 15L,A02,083655,Staff,3,0,50,47
1650349079197,CSE 20,A01,083657,Staff,52,0,80,28
1650349085220,CSE 30,A01,083084,Eldon; John,0,76,40,40
1650349091251,CSE 100,A01,083659,Cao; Yingjun,0,66,50,50
1650349097275,CSE 134B,A01,083661,Powell; Thomas Allan,0,31,65,65
1650349103299,CSE 140,A01,083663,Staff,0,0,75,75
1650349109327,CSE 140L,A01,083088,Eldon; John,0,6,75,75
1650349115356,CSE 175,A01,083665,Kumar; Rakesh,8,0,25,17
1650349121381,CSE 190,A00,092507,Dubnov; Shlomo,14,0,20,6
1650349127417,ECE 45,A01,083139,Staff,0,17,40,40
1650349133446,ECE 65,A50,083695,Staff,0,5,30,30
1650349139470,ECE 109,A01,091882,Touri; Behrouz,40,0,70,30
1650349145498,ECE 180,A00,083140,Abi Samra; Nicholas Camill,23,0,30,7
1650349145498,ECE 180,B00,083141,Abi Samra; Nicholas Camill,5,0,30,25
1650349151525,MATH 10A,A01,083735,Patchell; Gregory David,7,0,30,23
1650349151525,MATH 10A,A02,083736,Patchell; Gregory David,28,0,30,2
1650349151525,MATH 10A,A03,083737,Patchell; Gregory David,26,0,30,4
1650349157548,MATH 10B,A01,083207,Staff,0,7,30,30
1650349157548,MATH 10B,A02,083208,Staff,0,6,30,30
1650349157548,MATH 10B,B01,083739,Staff,17,0,30,13
1650349157548,MATH 10B,B02,083740,Staff,28,0,30,2
1650349163574,MATH 18,A01,083743,Staff,3,0,30,27
1650349163574,MATH 18,A02,083744,Staff,27,0,30,3
1650349163574,MATH 18,A03,083745,Staff,22,0,30,8
1650349163574,MATH 18,A04,083746,Staff,27,0,30,3
1650349163574,MATH 18,B01,083748,Staff,0,11,30,30
1650349163574,MATH 18,B02,083749,Staff,0,11,30,30
1650349163574,MATH 18,B03,083750,Staff,0,11,30,30
1650349163574,MATH 18,B04,083751,Staff,0,9,30,30
1650349169597,MATH 20A,A01,083754,Staff,26,0,40,14
1650349175622,MATH 20B,A01,083756,Staff,0,8,30,30
1650349175622,MATH 20B,A02,083757,Staff,0,8,30,30
1650349181649,MATH 20C,A01,083760,Staff,0,14,30,30
1650349181649,MATH 20C,A02,083761,Staff,0,15,30,30
1650349181649,MATH 20C,B01,083762,Staff,13,0,30,17
1650349181649,MATH 20C,B02,083763,Staff,28,0,30,2
1650349187672,MATH 20D,A01,083765,Staff,0,1,30,30
1650349187672,MATH 20D,A02,083766,Staff,7,0,30,23
1650349187672,MATH 20D,A03,083767,Staff,26,0,30,4
1650349193695,MATH 20E,A01,083771,Staff,5,0,30,25
1650349193695,MATH 20E,A02,083772,Staff,19,0,30,11
1650349193695,MATH 20E,B01,083773,Staff,0,0,30,30
1650349193695,MATH 20E,B02,083774,Staff,12,0,30,18
1650349199718,MATH 103A,A01,083777,Staff,0,11,30,30
1650349199718,MATH 103A,A02,083778,Staff,0,12,30,30
1650349199718,MATH 103A,B01,083779,Staff,0,13,30,30
1650349199718,MATH 103A,B02,083780,Staff,0,12,30,30
1650349205741,MATH 105,A01,085443,Staff,0,21,30,30
1650349211769,MATH 109,A01,083213,Anzaldo; Leesa B,0,6,30,30
1650349211769,MATH 109,A02,083214,Anzaldo; Leesa B,0,7,30,30
1650349211769,MATH 109,B01,083215,Anzaldo; Leesa B,0,5,30,30
1650349211769,MATH 109,B02,083216,Anzaldo; Leesa B,0,5,30,30
1650349217799,MATH 142A,A01,083219,Chow; Bennett,0,14,30,30
1650349217799,MATH 142A,A02,083220,Chow; Bennett,0,12,30,30
1650349217799,MATH 142A,B01,083221,Chow; Bennett,0,12,30,30
1650349217799,MATH 142A,B02,083222,Chow; Bennett,0,12,30,30
1650349223837,MATH 193A,A01,083224,Staff,0,5,30,30
1650349223837,MATH 193A,A02,083225,Staff,0,5,30,30
1650349223837,MATH 193A,A03,083781,Staff,0,4,30,30
1650349223837,MATH 193A,A04,083782,Staff,0,3,30,30
1650349229862,MATH 197,001,091859,McAuley; Julian John,9998,0,9999,1
1650349235912,COGS 9,A01,083615,Staff,0,14,60,60
1650349241934,COGS 11,A01,083617,Boyle; Mary E. T.,22,0,40,18
1650349247965,COGS 13,A01,083071,Staff,0,32,40,40
1650349253991,COGS 14A,A01,092681,Staff,0,20,100,100
1650349260014,COGS 14B,A01,083073,Cheng; Tzu-Han,0,10,50,50
1650349266044,COGS 17,A01,092677,Staff,24,0,75,51
1650349272073,COGS 100,A01,083619,Staff,0,23,60,60
1650349278105,COGS 101A,A01,083621,Davis; Joshua Daniel,0,21,60,60
1650349284130,COGS 101B,A01,091572,Staff,0,0,60,60
1650349290152,COGS 101C,A01,083625,Delgado; Tania,17,0,30,13
1650349296180,COGS 107A,A01,083627,Boyle; Mary E. T.,0,9,60,60
1650349302205,COGS 118A,A01,083075,Staff,4,0,60,56
1650349308228,CSE 3,A50,083646,Miranda; Gregory Joseph,21,0,38,17
1650349308228,CSE 3,A51,083647,Miranda; Gregory Joseph,37,0,37,0
1650349314253,CSE 8A,A50,083650,Miranda; Gregory Joseph,0,28,40,40
1650349320281,CSE 11,A01,083080,Cao; Yingjun,0,88,40,40
1650349326306,CSE 12,A01,083652,Staff,0,12,100,100
1650349332339,CSE 15L,A01,083654,Staff,0,1,50,50
1650349332339,CSE 15L,A02,083655,Staff,3,0,50,47
1650349338368,CSE 20,A01,083657,Staff,52,0,80,28
1650349344399,CSE 30,A01,083084,Eldon; John,0,76,40,40
1650349350427,CSE 100,A01,083659,Cao; Yingjun,0,66,50,50
1650349356472,CSE 134B,A01,083661,Powell; Thomas Allan,0,31,65,65
1650349362500,CSE 140,A01,083663,Staff,0,0,75,75
1650349368529,CSE 140L,A01,083088,Eldon; John,0,6,75,75
1650349374550,CSE 175,A01,083665,Kumar; Rakesh,8,0,25,17
1650349380581,CSE 190,A00,092507,Dubnov; Shlomo,14,0,20,6
1650349386616,ECE 45,A01,083139,Staff,0,17,40,40
1650349392644,ECE 65,A50,083695,Staff,0,5,30,30
1650349398670,ECE 109,A01,091882,Touri; Behrouz,40,0,70,30
1650349404695,ECE 180,A00,083140,Abi Samra; Nicholas Camill,23,0,30,7
1650349404695,ECE 180,B00,083141,Abi Samra; Nicholas Camill,5,0,30,25
1650349410734,MATH 10A,A01,083735,Patchell; Gregory David,7,0,30,23
1650349410734,MATH 10A,A02,083736,Patchell; Gregory David,28,0,30,2
1650349410734,MATH 10A,A03,083737,Patchell; Gregory David,26,0,30,4
1650349416759,MATH 10B,A01,083207,Staff,0,7,30,30
1650349416759,MATH 10B,A02,083208,Staff,0,6,30,30
1650349416759,MATH 10B,B01,083739,Staff,17,0,30,13
1650349416759,MATH 10B,B02,083740,Staff,28,0,30,2
1650349422790,MATH 18,A01,083743,Staff,3,0,30,27
1650349422790,MATH 18,A02,083744,Staff,27,0,30,3
1650349422790,MATH 18,A03,083745,Staff,22,0,30,8
1650349422790,MATH 18,A04,083746,Staff,27,0,30,3
1650349422790,MATH 18,B01,083748,Staff,0,11,30,30
1650349422790,MATH 18,B02,083749,Staff,0,11,30,30
1650349422790,MATH 18,B03,083750,Staff,0,11,30,30
1650349422790,MATH 18,B04,083751,Staff,0,9,30,30
1650349428816,MATH 20A,A01,083754,Staff,26,0,40,14
1650349434844,MATH 20B,A01,083756,Staff,0,8,30,30
1650349434844,MATH 20B,A02,083757,Staff,0,8,30,30
1650349440887,MATH 20C,A01,083760,Staff,0,14,30,30
1650349440887,MATH 20C,A02,083761,Staff,0,15,30,30
1650349440887,MATH 20C,B01,083762,Staff,13,0,30,17
1650349440887,MATH 20C,B02,083763,Staff,28,0,30,2
1650349446913,MATH 20D,A01,083765,Staff,0,1,30,30
1650349446913,MATH 20D,A02,083766,Staff,7,0,30,23
1650349446913,MATH 20D,A03,083767,Staff,26,0,30,4
1650349452936,MATH 20E,A01,083771,Staff,5,0,30,25
1650349452936,MATH 20E,A02,083772,Staff,19,0,30,11
1650349452936,MATH 20E,B01,083773,Staff,0,0,30,30
1650349452936,MATH 20E,B02,083774,Staff,12,0,30,18
1650349458965,MATH 103A,A01,083777,Staff,0,11,30,30
1650349458965,MATH 103A,A02,083778,Staff,0,12,30,30
1650349458965,MATH 103A,B01,083779,Staff,0,13,30,30
1650349458965,MATH 103A,B02,083780,Staff,0,12,30,30
1650349464994,MATH 105,A01,085443,Staff,0,21,30,30
1650349471090,MATH 109,A01,083213,Anzaldo; Leesa B,0,6,30,30
1650349471090,MATH 109,A02,083214,Anzaldo; Leesa B,0,7,30,30
1650349471090,MATH 109,B01,083215,Anzaldo; Leesa B,0,5,30,30
1650349471090,MATH 109,B02,083216,Anzaldo; Leesa B,0,5,30,30
1650349477119,MATH 142A,A01,083219,Chow; Bennett,0,14,30,30
1650349477119,MATH 142A,A02,083220,Chow; Bennett,0,12,30,30
1650349477119,MATH 142A,B01,083221,Chow; Bennett,0,12,30,30
1650349477119,MATH 142A,B02,083222,Chow; Bennett,0,12,30,30
1650349483147,MATH 193A,A01,083224,Staff,0,5,30,30
1650349483147,MATH 193A,A02,083225,Staff,0,5,30,30
1650349483147,MATH 193A,A03,083781,Staff,0,4,30,30
1650349483147,MATH 193A,A04,083782,Staff,0,3,30,30
1650349489180,MATH 197,001,091859,McAuley; Julian John,9998,0,9999,1
1650349495265,COGS 9,A01,083615,Staff,0,14,60,60
1650349501290,COGS 11,A01,083617,Boyle; Mary E. T.,22,0,40,18
1650349507317,COGS 13,A01,083071,Staff,0,32,40,40
1650349513344,COGS 14A,A01,092681,Staff,0,20,100,100
1650349519369,COGS 14B,A01,083073,Cheng; Tzu-Han,0,10,50,50
1650349525395,COGS 17,A01,092677,Staff,24,0,75,51
1650349531418,COGS 100,A01,083619,Staff,0,23,60,60
1650349537442,COGS 101A,A01,083621,Davis; Joshua Daniel,0,21,60,60
1650349543468,COGS 101B,A01,091572,Staff,0,0,60,60
1650349549495,COGS 101C,A01,083625,Delgado; Tania,17,0,30,13
1650349555521,COGS 107A,A01,083627,Boyle; Mary E. T.,0,9,60,60
1650349561554,COGS 118A,A01,083075,Staff,4,0,60,56
1650349567582,CSE 3,A50,083646,Miranda; Gregory Joseph,21,0,38,17
1650349567582,CSE 3,A51,083647,Miranda; Gregory Joseph,37,0,37,0
1650349573628,CSE 8A,A50,083650,Miranda; Gregory Joseph,0,28,40,40
1650349579652,CSE 11,A01,083080,Cao; Yingjun,0,88,40,40
1650349585680,CSE 12,A01,083652,Staff,0,12,100,100
1650349591707,CSE 15L,A01,083654,Staff,0,1,50,50
1650349591707,CSE 15L,A02,083655,Staff,3,0,50,47
1650349597731,CSE 20,A01,083657,Staff,52,0,80,28
1650349603755,CSE 30,A01,083084,Eldon; John,0,76,40,40
1650349609780,CSE 100,A01,083659,Cao; Yingjun,0,66,50,50
1650349615805,CSE 134B,A01,083661,Powell; Thomas Allan,0,31,65,65
1650349621829,CSE 140,A01,083663,Staff,0,0,75,75
1650349627856,CSE 140L,A01,083088,Eldon; John,0,6,75,75
1650349633882,CSE 175,A01,083665,Kumar; Rakesh,8,0,25,17
1650349639916,CSE 190,A00,092507,Dubnov; Shlomo,14,0,20,6
1650349645943,ECE 45,A01,083139,Staff,0,17,40,40
1650349651986,ECE 65,A50,083695,Staff,0,5,30,30
1650349658014,ECE 109,A01,091882,Touri; Behrouz,40,0,70,30
1650349664051,ECE 180,A00,083140,Abi Samra; Nicholas Camill,23,0,30,7
1650349664051,ECE 180,B00,083141,Abi Samra; Nicholas Camill,5,0,30,25
1650349670078,MATH 10A,A01,083735,Patchell; Gregory David,7,0,30,23
1650349670078,MATH 10A,A02,083736,Patchell; Gregory David,28,0,30,2
1650349670078,MATH 10A,A03,083737,Patchell; Gregory David,26,0,30,4
1650349676104,MATH 10B,A01,083207,Staff,0,7,30,30
1650349676104,MATH 10B,A02,083208,Staff,0,6,30,30
1650349676104,MATH 10B,B01,083739,Staff,17,0,30,13
1650349676104,MATH 10B,B02,083740,Staff,28,0,30,2
1650349682145,MATH 18,A01,083743,Staff,3,0,30,27
1650349682145,MATH 18,A02,083744,Staff,27,0,30,3
1650349682145,MATH 18,A03,083745,Staff,22,0,30,8
1650349682145,MATH 18,A04,083746,Staff,27,0,30,3
1650349682145,MATH 18,B01,083748,Staff,0,11,30,30
1650349682145,MATH 18,B02,083749,Staff,0,11,30,30
1650349682145,MATH 18,B03,083750,Staff,0,11,30,30
1650349682145,MATH 18,B04,083751,Staff,0,9,30,30
1650349688171,MATH 20A,A01,083754,Staff,26,0,40,14
1650349694193,MATH 20B,A01,083756,Staff,0,8,30,30
1650349694193,MATH 20B,A02,083757,Staff,0,8,30,30
1650349700221,MATH 20C,A01,083760,Staff,0,14,30,30
1650349700221,MATH 20C,A02,083761,Staff,0,15,30,30
1650349700221,MATH 20C,B01,083762,Staff,13,0,30,17
1650349700221,MATH 20C,B02,083763,Staff,28,0,30,2
1650349706253,MATH 20D,A01,083765,Staff,0,1,30,30
1650349706253,MATH 20D,A02,083766,Staff,7,0,30,23
1650349706253,MATH 20D,A03,083767,Staff,26,0,30,4
1650349712288,MATH 20E,A01,083771,Staff,5,0,30,25
1650349712288,MATH 20E,A02,083772,Staff,19,0,30,11
1650349712288,MATH 20E,B01,083773,Staff,0,0,30,30
1650349712288,MATH 20E,B02,083774,Staff,12,0,30,18
1650349718317,MATH 103A,A01,083777,Staff,0,11,30,30
1650349718317,MATH 103A,A02,083778,Staff,0,12,30,30
1650349718317,MATH 103A,B01,083779,Staff,0,13,30,30
1650349718317,MATH 103A,B02,083780,Staff,0,12,30,30
1650349724342,MATH 105,A01,085443,Staff,0,21,30,30
1650349730365,MATH 109,A01,083213,Anzaldo; Leesa B,0,6,30,30
1650349730365,MATH 109,A02,083214,Anzaldo; Leesa B,0,7,30,30
1650349730365,MATH 109,B01,083215,Anzaldo; Leesa B,0,5,30,30
1650349730365,MATH 109,B02,083216,Anzaldo; Leesa B,0,5,30,30
1650349736404,MATH 142A,A01,083219,Chow; Bennett,0,14,30,30
1650349736404,MATH 142A,A02,083220,Chow; Bennett,0,12,30,30
1650349736404,MATH 142A,B01,083221,Chow; Bennett,0,12,30,30
1650349736404,MATH 142A,B02,083222,Chow; Bennett,0,12,30,30
1650349742427,MATH 193A,A01,083224,Staff,0,5,30,30
1650349742427,MATH 193A,A02,083225,Staff,0,5,30,30
1650349742427,MATH 193A,A03,083781,Staff,0,4,30,30
1650349742427,MATH 193A,A04,083782,Staff,0,3,30,30
1650349748466,MATH 197,001,091859,McAuley; Julian John,9998,0,9999,1
1650349754516,COGS 9,A01,083615,Staff,0,14,60,60
1650349760541,COGS 11,A01,083617,Boyle; Mary E. T.,22,0,40,18
1650349766565,COGS 13,A01,083071,Staff,0,32,40,40
1650349772589,COGS 14A,A01,092681,Staff,0,20,100,100
1650349778618,COGS 14B,A01,083073,Cheng; Tzu-Han,0,10,50,50
1650349784642,COGS 17,A01,092677,Staff,24,0,75,51
1650349790670,COGS 100,A01,083619,Staff,0,23,60,60
1650349796692,COGS 101A,A01,083621,Davis; Joshua Daniel,0,21,60,60
1650349802722,COGS 101B,A01,091572,Staff,0,0,60,60
1650349808758,COGS 101C,A01,083625,Delgado; Tania,17,0,30,13
1650349814781,COGS 107A,A01,083627,Boyle; Mary E. T.,0,9,60,60
1650349820805,COGS 118A,A01,083075,Staff,4,0,60,56
1650349826830,CSE 3,A50,083646,Miranda; Gregory Joseph,21,0,38,17
1650349826830,CSE 3,A51,083647,Miranda; Gregory Joseph,37,0,37,0
1650349832857,CSE 8A,A50,083650,Miranda; Gregory Joseph,0,28,40,40
1650349838887,CSE 11,A01,083080,Cao; Yingjun,0,88,40,40
1650349844911,CSE 12,A01,083652,Staff,0,12,100,100
1650349850936,CSE 15L,A01,083654,Staff,0,1,50,50
1650349850936,CSE 15L,A02,083655,Staff,3,0,50,47
1650349856960,CSE 20,A01,083657,Staff,52,0,80,28
1650349862984,CSE 30,A01,083084,Eldon; John,0,76,40,40
1650349869010,CSE 100,A01,083659,Cao; Yingjun,0,66,50,50
1650349875033,CSE 134B,A01,083661,Powell; Thomas Allan,0,31,65,65
1650349881059,CSE 140,A01,083663,Staff,0,0,75,75
1650349887085,CSE 140L,A01,083088,Eldon; John,0,6,75,75
1650349893108,CSE 175,A01,083665,Kumar; Rakesh,8,0,25,17
1650349899130,CSE 190,A00,092507,Dubnov; Shlomo,14,0,20,6
1650349905154,ECE 45,A01,083139,Staff,0,17,40,40
1650349911177,ECE 65,A50,083695,Staff,0,5,30,30
1650349917200,ECE 109,A01,091882,Touri; Behrouz,40,0,70,30
1650349923229,ECE 180,A00,083140,Abi Samra; Nicholas Camill,23,0,30,7
1650349923229,ECE 180,B00,083141,Abi Samra; Nicholas Camill,5,0,30,25
1650349929258,MATH 10A,A01,083735,Patchell; Gregory David,7,0,30,23
1650349929258,MATH 10A,A02,083736,Patchell; Gregory David,28,0,30,2
1650349929258,MATH 10A,A03,083737,Patchell; Gregory David,26,0,30,4
1650349935286,MATH 10B,A01,083207,Staff,0,7,30,30
1650349935286,MATH 10B,A02,083208,Staff,0,6,30,30
1650349935286,MATH 10B,B01,083739,Staff,17,0,30,13
1650349935286,MATH 10B,B02,083740,Staff,28,0,30,2
1650349941332,MATH 18,A01,083743,Staff,3,0,30,27
1650349941332,MATH 18,A02,083744,Staff,27,0,30,3
1650349941332,MATH 18,A03,083745,Staff,22,0,30,8
1650349941332,MATH 18,A04,083746,Staff,27,0,30,3
1650349941332,MATH 18,B01,083748,Staff,0,11,30,30
1650349941332,MATH 18,B02,083749,Staff,0,11,30,30
1650349941332,MATH 18,B03,083750,Staff,0,11,30,30
1650349941332,MATH 18,B04,083751,Staff,0,9,30,30
1650349947357,MATH 20A,A01,083754,Staff,26,0,40,14
1650349953384,MATH 20B,A01,083756,Staff,0,8,30,30
1650349953384,MATH 20B,A02,083757,Staff,0,8,30,30
1650349959408,MATH 20C,A01,083760,Staff,0,14,30,30
1650349959408,MATH 20C,A02,083761,Staff,0,15,30,30
1650349959408,MATH 20C,B01,083762,Staff,13,0,30,17
1650349959408,MATH 20C,B02,083763,Staff,28,0,30,2
1650349965439,MATH 20D,A01,083765,Staff,0,1,30,30
1650349965439,MATH 20D,A02,083766,Staff,7,0,30,23
1650349965439,MATH 20D,A03,083767,Staff,26,0,30,4
1650349971466,MATH 20E,A01,083771,Staff,5,0,30,25
1650349971466,MATH 20E,A02,083772,Staff,19,0,30,11
1650349971466,MATH 20E,B01,083773,Staff,0,0,30,30
1650349971466,MATH 20E,B02,083774,Staff,12,0,30,18
1650349977489,MATH 103A,A01,083777,Staff,0,11,30,30
1650349977489,MATH 103A,A02,083778,Staff,0,12,30,30
1650349977489,MATH 103A,B01,083779,Staff,0,13,30,30
1650349977489,MATH 103A,B02,083780,Staff,0,11,30,30
1650349983513,MATH 105,A01,085443,Staff,0,21,30,30
1650349989546,MATH 109,A01,083213,Anzaldo; Leesa B,0,6,30,30
1650349989546,MATH 109,A02,083214,Anzaldo; Leesa B,0,7,30,30
1650349989546,MATH 109,B01,083215,Anzaldo; Leesa B,0,5,30,30
1650349989546,MATH 109,B02,083216,Anzaldo; Leesa B,0,5,30,30
1650349995568,MATH 142A,A01,083219,Chow; Bennett,0,14,30,30
1650349995568,MATH 142A,A02,083220,Chow; Bennett,0,12,30,30
1650349995568,MATH 142A,B01,083221,Chow; Bennett,0,12,30,30
1650349995568,MATH 142A,B02,083222,Chow; Bennett,0,12,30,30
1650350001605,MATH 193A,A01,083224,Staff,0,5,30,30
1650350001605,MATH 193A,A02,083225,Staff,0,5,30,30
1650350001605,MATH 193A,A03,083781,Staff,0,4,30,30
1650350001605,MATH 193A,A04,083782,Staff,0,3,30,30
1650350007636,MATH 197,001,091859,McAuley; Julian John,9998,0,9999,1
1650350013705,COGS 9,A01,083615,Staff,0,14,60,60
1650350019729,COGS 11,A01,083617,Boyle; Mary E. T.,22,0,40,18
1650350025768,COGS 13,A01,083071,Staff,0,32,40,40
1650350031800,COGS 14A,A01,092681,Staff,0,20,100,100
1650350037825,COGS 14B,A01,083073,Cheng; Tzu-Han,0,10,50,50
1650350043847,COGS 17,A01,092677,Staff,24,0,75,51
1650350049873,COGS 100,A01,083619,Staff,0,23,60,60
1650350055898,COGS 101A,A01,083621,Davis; Joshua Daniel,0,21,60,60
1650350062012,COGS 101B,A01,091572,Staff,0,0,60,60
1650350068037,COGS 101C,A01,083625,Delgado; Tania,17,0,30,13
1650350074066,COGS 107A,A01,083627,Boyle; Mary E. T.,0,9,60,60
1650350080091,COGS 118A,A01,083075,Staff,4,0,60,56
1650350086120,CSE 3,A50,083646,Miranda; Gregory Joseph,21,0,38,17
1650350086120,CSE 3,A51,083647,Miranda; Gregory Joseph,37,0,37,0
1650350092144,CSE 8A,A50,083650,Miranda; Gregory Joseph,0,28,40,40
1650350098168,CSE 11,A01,083080,Cao; Yingjun,0,88,40,40
1650350104193,CSE 12,A01,083652,Staff,0,12,100,100
1650350110219,CSE 15L,A01,083654,Staff,0,1,50,50
1650350110219,CSE 15L,A02,083655,Staff,3,0,50,47
1650350116243,CSE 20,A01,083657,Staff,52,0,80,28
1650350122268,CSE 30,A01,083084,Eldon; John,0,76,40,40
1650350128292,CSE 100,A01,083659,Cao; Yingjun,0,66,50,50
1650350134316,CSE 134B,A01,083661,Powell; Thomas Allan,0,31,65,65
1650350140339,CSE 140,A01,083663,Staff,0,0,75,75
1650350146373,CSE 140L,A01,083088,Eldon; John,0,6,75,75
1650350152396,CSE 175,A01,083665,Kumar; Rakesh,8,0,25,17
1650350158419,CSE 190,A00,092507,Dubnov; Shlomo,14,0,20,6
1650350164444,ECE 45,A01,083139,Staff,0,17,40,40
1650350170475,ECE 65,A50,083695,Staff,0,5,30,30
1650350176503,ECE 109,A01,091882,Touri; Behrouz,40,0,70,30
1650350182525,ECE 180,A00,083140,Abi Samra; Nicholas Camill,23,0,30,7
1650350182525,ECE 180,B00,083141,Abi Samra; Nicholas Camill,5,0,30,25
1650350188549,MATH 10A,A01,083735,Patchell; Gregory David,8,0,30,22
1650350188549,MATH 10A,A02,083736,Patchell; Gregory David,28,0,30,2
1650350188549,MATH 10A,A03,083737,Patchell; Gregory David,25,0,30,5
1650350194576,MATH 10B,A01,083207,Staff,0,7,30,30
1650350194576,MATH 10B,A02,083208,Staff,0,6,30,30
1650350194576,MATH 10B,B01,083739,Staff,17,0,30,13
1650350194576,MATH 10B,B02,083740,Staff,28,0,30,2
1650350200607,MATH 18,A01,083743,Staff,3,0,30,27
1650350200607,MATH 18,A02,083744,Staff,27,0,30,3
1650350200607,MATH 18,A03,083745,Staff,22,0,30,8
1650350200607,MATH 18,A04,083746,Staff,27,0,30,3
1650350200607,MATH 18,B01,083748,Staff,0,11,30,30
1650350200607,MATH 18,B02,083749,Staff,0,11,30,30
1650350200607,MATH 18,B03,083750,Staff,0,11,30,30
1650350200607,MATH 18,B04,083751,Staff,0,9,30,30
1650350206634,MATH 20A,A01,083754,Staff,26,0,40,14
1650350212660,MATH 20B,A01,083756,Staff,0,8,30,30
1650350212660,MATH 20B,A02,083757,Staff,0,8,30,30
1650350218687,MATH 20C,A01,083760,Staff,0,14,30,30
1650350218687,MATH 20C,A02,083761,Staff,0,15,30,30
1650350218687,MATH 20C,B01,083762,Staff,13,0,30,17
1650350218687,MATH 20C,B02,083763,Staff,28,0,30,2
1650350224710,MATH 20D,A01,083765,Staff,0,1,30,30
1650350224710,MATH 20D,A02,083766,Staff,7,0,30,23
1650350224710,MATH 20D,A03,083767,Staff,26,0,30,4
1650350230737,MATH 20E,A01,083771,Staff,5,0,30,25
1650350230737,MATH 20E,A02,083772,Staff,19,0,30,11
1650350230737,MATH 20E,B01,083773,Staff,0,0,30,30
1650350230737,MATH 20E,B02,083774,Staff,12,0,30,18
1650350236766,MATH 103A,A01,083777,Staff,0,11,30,30
1650350236766,MATH 103A,A02,083778,Staff,0,12,30,30
1650350236766,MATH 103A,B01,083779,Staff,0,13,30,30
1650350236766,MATH 103A,B02,083780,Staff,0,11,30,30
1650350242796,MATH 105,A01,085443,Staff,0,21,30,30
1650350248819,MATH 109,A01,083213,Anzaldo; Leesa B,0,6,30,30
1650350248819,MATH 109,A02,083214,Anzaldo; Leesa B,0,7,30,30
1650350248819,MATH 109,B01,083215,Anzaldo; Leesa B,0,5,30,30
1650350248819,MATH 109,B02,083216,Anzaldo; Leesa B,0,5,30,30
1650350254846,MATH 142A,A01,083219,Chow; Bennett,0,14,30,30
1650350254846,MATH 142A,A02,083220,Chow; Bennett,0,12,30,30
1650350254846,MATH 142A,B01,083221,Chow; Bennett,0,12,30,30
1650350254846,MATH 142A,B02,083222,Chow; Bennett,0,12,30,30
1650350260877,MATH 193A,A01,083224,Staff,0,5,30,30
1650350260877,MATH 193A,A02,083225,Staff,0,5,30,30
1650350260877,MATH 193A,A03,083781,Staff,0,4,30,30
1650350260877,MATH 193A,A04,083782,Staff,0,3,30,30
1650350266898,MATH 197,001,091859,McAuley; Julian John,9998,0,9999,1
1650350272951,COGS 9,A01,083615,Staff,0,14,60,60
1650350278976,COGS 11,A01,083617,Boyle; Mary E. T.,22,0,40,18
1650350284997,COGS 13,A01,083071,Staff,0,32,40,40
1650350291034,COGS 14A,A01,092681,Staff,0,20,100,100
1650350297062,COGS 14B,A01,083073,Cheng; Tzu-Han,0,10,50,50
1650350303087,COGS 17,A01,092677,Staff,24,0,75,51
1650350309110,COGS 100,A01,083619,Staff,0,23,60,60
1650350315133,COGS 101A,A01,083621,Davis; Joshua Daniel,0,21,60,60
1650350321166,COGS 101B,A01,091572,Staff,0,0,60,60
1650350327197,COGS 101C,A01,083625,Delgado; Tania,17,0,30,13
1650350333220,COGS 107A,A01,083627,Boyle; Mary E. T.,0,9,60,60
1650350339246,COGS 118A,A01,083075,Staff,4,0,60,56
1650350345270,CSE 3,A50,083646,Miranda; Gregory Joseph,21,0,38,17
1650350345270,CSE 3,A51,083647,Miranda; Gregory Joseph,37,0,37,0
1650350351294,CSE 8A,A50,083650,Miranda; Gregory Joseph,0,28,40,40
1650350357321,CSE 11,A01,083080,Cao; Yingjun,0,88,40,40
1650350363344,CSE 12,A01,083652,Staff,0,12,100,100
1650350369374,CSE 15L,A01,083654,Staff,0,1,50,50
1650350369374,CSE 15L,A02,083655,Staff,3,0,50,47
1650350375400,CSE 20,A01,083657,Staff,52,0,80,28
1650350381423,CSE 30,A01,083084,Eldon; John,0,76,40,40
1650350387445,CSE 100,A01,083659,Cao; Yingjun,0,66,50,50
1650350393472,CSE 134B,A01,083661,Powell; Thomas Allan,0,31,65,65
1650350399501,CSE 140,A01,083663,Staff,0,0,75,75
1650350405538,CSE 140L,A01,083088,Eldon; John,0,6,75,75
1650350411561,CSE 175,A01,083665,Kumar; Rakesh,8,0,25,17
1650350417584,CSE 190,A00,092507,Dubnov; Shlomo,14,0,20,6
1650350423608,ECE 45,A01,083139,Staff,0,17,40,40
1650350429634,ECE 65,A50,083695,Staff,0,5,30,30
1650350435658,ECE 109,A01,091882,Touri; Behrouz,40,0,70,30
1650350441682,ECE 180,A00,083140,Abi Samra; Nicholas Camill,23,0,30,7
1650350441682,ECE 180,B00,083141,Abi Samra; Nicholas Camill,5,0,30,25
1650350447705,MATH 10A,A01,083735,Patchell; Gregory David,8,0,30,22
1650350447705,MATH 10A,A02,083736,Patchell; Gregory David,28,0,30,2
1650350447705,MATH 10A,A03,083737,Patchell; Gregory David,25,0,30,5
1650350453728,MATH 10B,A01,083207,Staff,0,7,30,30
1650350453728,MATH 10B,A02,083208,Staff,0,6,30,30
1650350453728,MATH 10B,B01,083739,Staff,17,0,30,13
1650350453728,MATH 10B,B02,083740,Staff,28,0,30,2
1650350459755,MATH 18,A01,083743,Staff,3,0,30,27
1650350459755,MATH 18,A02,083744,Staff,27,0,30,3
1650350459755,MATH 18,A03,083745,Staff,22,0,30,8
1650350459755,MATH 18,A04,083746,Staff,27,0,30,3
1650350459755,MATH 18,B01,083748,Staff,0,11,30,30
1650350459755,MATH 18,B02,083749,Staff,0,11,30,30
1650350459755,MATH 18,B03,083750,Staff,0,11,30,30
1650350459755,MATH 18,B04,083751,Staff,0,9,30,30
1650350465777,MATH 20A,A01,083754,Staff,26,0,40,14
1650350471803,MATH 20B,A01,083756,Staff,0,8,30,30
1650350471803,MATH 20B,A02,083757,Staff,0,8,30,30
1650350477826,MATH 20C,A01,083760,Staff,0,14,30,30
1650350477826,MATH 20C,A02,083761,Staff,0,15,30,30
1650350477826,MATH 20C,B01,083762,Staff,13,0,30,17
1650350477826,MATH 20C,B02,083763,Staff,28,0,30,2
1650350483857,MATH 20D,A01,083765,Staff,0,1,30,30
1650350483857,MATH 20D,A02,083766,Staff,7,0,30,23
1650350483857,MATH 20D,A03,083767,Staff,26,0,30,4
1650350489880,MATH 20E,A01,083771,Staff,5,0,30,25
1650350489880,MATH 20E,A02,083772,Staff,19,0,30,11
1650350489880,MATH 20E,B01,083773,Staff,0,0,30,30
1650350489880,MATH 20E,B02,083774,Staff,12,0,30,18
1650350495905,MATH 103A,A01,083777,Staff,0,11,30,30
1650350495905,MATH 103A,A02,083778,Staff,0,12,30,30
1650350495905,MATH 103A,B01,083779,Staff,0,13,30,30
1650350495905,MATH 103A,B02,083780,Staff,0,11,30,30
1650350501927,MATH 105,A01,085443,Staff,0,21,30,30
1650350507967,MATH 109,A01,083213,Anzaldo; Leesa B,0,6,30,30
1650350507967,MATH 109,A02,083214,Anzaldo; Leesa B,0,7,30,30
1650350507967,MATH 109,B01,083215,Anzaldo; Leesa B,0,5,30,30
1650350507967,MATH 109,B02,083216,Anzaldo; Leesa B,0,5,30,30
1650350513996,MATH 142A,A01,083219,Chow; Bennett,0,14,30,30
1650350513996,MATH 142A,A02,083220,Chow; Bennett,0,12,30,30
1650350513996,MATH 142A,B01,083221,Chow; Bennett,0,12,30,30
1650350513996,MATH 142A,B02,083222,Chow; Bennett,0,12,30,30
1650350520029,MATH 193A,A01,083224,Staff,0,5,30,30
1650350520029,MATH 193A,A02,083225,Staff,0,5,30,30
1650350520029,MATH 193A,A03,083781,Staff,0,4,30,30
1650350520029,MATH 193A,A04,083782,Staff,0,3,30,30
1650350526055,MATH 197,001,091859,McAuley; Julian John,9998,0,9999,1
1650350532114,COGS 9,A01,083615,Staff,0,14,60,60
1650350538139,COGS 11,A01,083617,Boyle; Mary E. T.,22,0,40,18
1650350544164,COGS 13,A01,083071,Staff,0,32,40,40
1650350550188,COGS 14A,A01,092681,Staff,0,20,100,100
1650350556213,COGS 14B,A01,083073,Cheng; Tzu-Han,0,10,50,50
1650350562237,COGS 17,A01,092677,Staff,24,0,75,51
1650350568260,COGS 100,A01,083619,Staff,0,23,60,60
1650350574291,COGS 101A,A01,083621,Davis; Joshua Daniel,0,21,60,60
1650350580313,COGS 101B,A01,091572,Staff,0,0,60,60
1650350586336,COGS 101C,A01,083625,Delgado; Tania,17,0,30,13
1650350592359,COGS 107A,A01,083627,Boyle; Mary E. T.,0,9,60,60
1650350598395,COGS 118A,A01,083075,Staff,4,0,60,56
1650350604419,CSE 3,A50,083646,Miranda; Gregory Joseph,21,0,38,17
1650350604419,CSE 3,A51,083647,Miranda; Gregory Joseph,37,0,37,0
1650350610440,CSE 8A,A50,083650,Miranda; Gregory Joseph,0,28,40,40
1650350616463,CSE 11,A01,083080,Cao; Yingjun,0,88,40,40
1650350622487,CSE 12,A01,083652,Staff,0,12,100,100
1650350628514,CSE 15L,A01,083654,Staff,0,1,50,50
1650350628514,CSE 15L,A02,083655,Staff,3,0,50,47
1650350634538,CSE 20,A01,083657,Staff,52,0,80,28
1650350640561,CSE 30,A01,083084,Eldon; John,0,76,40,40
1650350646582,CSE 100,A01,083659,Cao; Yingjun,0,66,50,50
1650350652608,CSE 134B,A01,083661,Powell; Thomas Allan,0,31,65,65
1650350658736,CSE 140,A01,083663,Staff,0,0,75,75
1650350664758,CSE 140L,A01,083088,Eldon; John,0,6,75,75
1650350670785,CSE 175,A01,083665,Kumar; Rakesh,8,0,25,17
1650350676809,CSE 190,A00,092507,Dubnov; Shlomo,14,0,20,6
1650350682836,ECE 45,A01,083139,Staff,0,17,40,40
1650350688863,ECE 65,A50,083695,Staff,0,5,30,30
1650350694886,ECE 109,A01,091882,Touri; Behrouz,40,0,70,30
1650350700909,ECE 180,A00,083140,Abi Samra; Nicholas Camill,23,0,30,7
1650350700909,ECE 180,B00,083141,Abi Samra; Nicholas Camill,5,0,30,25
1650350706931,MATH 10A,A01,083735,Patchell; Gregory David,8,0,30,22
1650350706931,MATH 10A,A02,083736,Patchell; Gregory David,28,0,30,2
1650350706931,MATH 10A,A03,083737,Patchell; Gregory David,25,0,30,5
1650350712958,MATH 10B,A01,083207,Staff,0,7,30,30
1650350712958,MATH 10B,A02,083208,Staff,0,6,30,30
1650350712958,MATH 10B,B01,083739,Staff,17,0,30,13
1650350712958,MATH 10B,B02,083740,Staff,28,0,30,2
1650350718989,MATH 18,A01,083743,Staff,3,0,30,27
1650350718989,MATH 18,A02,083744,Staff,27,0,30,3
1650350718989,MATH 18,A03,083745,Staff,22,0,30,8
1650350718989,MATH 18,A04,083746,Staff,27,0,30,3
1650350718989,MATH 18,B01,083748,Staff,0,11,30,30
1650350718989,MATH 18,B02,083749,Staff,0,11,30,30
1650350718989,MATH 18,B03,083750,Staff,0,11,30,30
1650350718989,MATH 18,B04,083751,Staff,0,9,30,30
1650350725022,MATH 20A,A01,083754,Staff,26,0,40,14
1650350731049,MATH 20B,A01,083756,Staff,0,8,30,30
1650350731049,MATH 20B,A02,083757,Staff,0,8,30,30
1650350737077,MATH 20C,A01,083760,Staff,0,14,30,30
1650350737077,MATH 20C,A02,083761,Staff,0,15,30,30
1650350737077,MATH 20C,B01,083762,Staff,13,0,30,17
1650350737077,MATH 20C,B02,083763,Staff,28,0,30,2
1650350743104,MATH 20D,A01,083765,Staff,0,1,30,30
1650350743104,MATH 20D,A02,083766,Staff,7,0,30,23
1650350743104,MATH 20D,A03,083767,Staff,26,0,30,4
1650350749129,MATH 20E,A01,083771,Staff,5,0,30,25
1650350749129,MATH 20E,A02,083772,Staff,19,0,30,11
1650350749129,MATH 20E,B01,083773,Staff,0,0,30,30
1650350749129,MATH 20E,B02,083774,Staff,12,0,30,18
1650350755156,MATH 103A,A01,083777,Staff,0,11,30,30
1650350755156,MATH 103A,A02,083778,Staff,0,12,30,30
1650350755156,MATH 103A,B01,083779,Staff,0,13,30,30
1650350755156,MATH 103A,B02,083780,Staff,0,11,30,30
1650350761180,MATH 105,A01,085443,Staff,0,21,30,30
1650350767207,MATH 109,A01,083213,Anzaldo; Leesa B,0,6,30,30
1650350767207,MATH 109,A02,083214,Anzaldo; Leesa B,0,7,30,30
1650350767207,MATH 109,B01,083215,Anzaldo; Leesa B,0,5,30,30
1650350767207,MATH 109,B02,083216,Anzaldo; Leesa B,0,5,30,30
1650350773234,MATH 142A,A01,083219,Chow; Bennett,0,14,30,30
1650350773234,MATH 142A,A02,083220,Chow; Bennett,0,12,30,30
1650350773234,MATH 142A,B01,083221,Chow; Bennett,0,12,30,30
1650350773234,MATH 142A,B02,083222,Chow; Bennett,0,12,30,30
1650350779268,MATH 193A,A01,083224,Staff,0,5,30,30
1650350779268,MATH 193A,A02,083225,Staff,0,5,30,30
1650350779268,MATH 193A,A03,083781,Staff,0,4,30,30
1650350779268,MATH 193A,A04,083782,Staff,0,3,30,30
1650350785291,MATH 197,001,091859,McAuley; Julian John,9998,0,9999,1
1650350791339,COGS 9,A01,083615,Staff,0,14,60,60
1650350797364,COGS 11,A01,083617,Boyle; Mary E. T.,22,0,40,18
1650350803398,COGS 13,A01,083071,Staff,0,32,40,40
1650350809420,COGS 14A,A01,092681,Staff,0,20,100,100
1650350815448,COGS 14B,A01,083073,Cheng; Tzu-Han,0,10,50,50
1650350821476,COGS 17,A01,092677,Staff,24,0,75,51
1650350827518,COGS 100,A01,083619,Staff,0,23,60,60
1650350833541,COGS 101A,A01,083621,Davis; Joshua Daniel,0,21,60,60
1650350839565,COGS 101B,A01,091572,Staff,0,0,60,60
1650350845589,COGS 101C,A01,083625,Delgado; Tania,17,0,30,13
1650350851616,COGS 107A,A01,083627,Boyle; Mary E. T.,0,9,60,60
1650350857638,COGS 118A,A01,083075,Staff,4,0,60,56
1650350863662,CSE 3,A50,083646,Miranda; Gregory Joseph,21,0,38,17
1650350863662,CSE 3,A51,083647,Miranda; Gregory Joseph,37,0,37,0
1650350869685,CSE 8A,A50,083650,Miranda; Gregory Joseph,0,28,40,40
1650350875708,CSE 11,A01,083080,Cao; Yingjun,0,88,40,40
1650350881735,CSE 12,A01,083652,Staff,0,12,100,100
1650350887759,CSE 15L,A01,083654,Staff,0,1,50,50
1650350887759,CSE 15L,A02,083655,Staff,3,0,50,47
1650350893782,CSE 20,A01,083657,Staff,52,0,80,28
1650350899806,CSE 30,A01,083084,Eldon; John,0,76,40,40
1650350905835,CSE 100,A01,083659,Cao; Yingjun,0,66,50,50
1650350911860,CSE 134B,A01,083661,Powell; Thomas Allan,0,31,65,65
1650350917888,CSE 140,A01,083663,Staff,0,0,75,75
1650350923912,CSE 140L,A01,083088,Eldon; John,0,6,75,75
1650350929935,CSE 175,A01,083665,Kumar; Rakesh,8,0,25,17
1650350935959,CSE 190,A00,092507,Dubnov; Shlomo,14,0,20,6
1650350941985,ECE 45,A01,083139,Staff,0,17,40,40
1650350948009,ECE 65,A50,083695,Staff,0,5,30,30
1650350954033,ECE 109,A01,091882,Touri; Behrouz,40,0,70,30
1650350960057,ECE 180,A00,083140,Abi Samra; Nicholas Camill,23,0,30,7
1650350960057,ECE 180,B00,083141,Abi Samra; Nicholas Camill,5,0,30,25
1650350966086,MATH 10A,A01,083735,Patchell; Gregory David,8,0,30,22
1650350966086,MATH 10A,A02,083736,Patchell; Gregory David,28,0,30,2
1650350966086,MATH 10A,A03,083737,Patchell; Gregory David,25,0,30,5
1650350972110,MATH 10B,A01,083207,Staff,0,7,30,30
1650350972110,MATH 10B,A02,083208,Staff,0,6,30,30
1650350972110,MATH 10B,B01,083739,Staff,17,0,30,13
1650350972110,MATH 10B,B02,083740,Staff,28,0,30,2
1650350978135,MATH 18,A01,083743,Staff,3,0,30,27
1650350978135,MATH 18,A02,083744,Staff,27,0,30,3
1650350978135,MATH 18,A03,083745,Staff,22,0,30,8
1650350978135,MATH 18,A04,083746,Staff,27,0,30,3
1650350978135,MATH 18,B01,083748,Staff,0,11,30,30
1650350978135,MATH 18,B02,083749,Staff,0,11,30,30
1650350978135,MATH 18,B03,083750,Staff,0,11,30,30
1650350978135,MATH 18,B04,083751,Staff,0,9,30,30
1650350984160,MATH 20A,A01,083754,Staff,26,0,40,14
1650350990187,MATH 20B,A01,083756,Staff,0,8,30,30
1650350990187,MATH 20B,A02,083757,Staff,0,8,30,30
1650350996210,MATH 20C,A01,083760,Staff,0,14,30,30
1650350996210,MATH 20C,A02,083761,Staff,0,15,30,30
1650350996210,MATH 20C,B01,083762,Staff,13,0,30,17
1650350996210,MATH 20C,B02,083763,Staff,28,0,30,2
1650351002234,MATH 20D,A01,083765,Staff,0,1,30,30
1650351002234,MATH 20D,A02,083766,Staff,7,0,30,23
1650351002234,MATH 20D,A03,083767,Staff,26,0,30,4
1650351008261,MATH 20E,A01,083771,Staff,5,0,30,25
1650351008261,MATH 20E,A02,083772,Staff,19,0,30,11
1650351008261,MATH 20E,B01,083773,Staff,0,0,30,30
1650351008261,MATH 20E,B02,083774,Staff,12,0,30,18
1650351014288,MATH 103A,A01,083777,Staff,0,11,30,30
1650351014288,MATH 103A,A02,083778,Staff,0,12,30,30
1650351014288,MATH 103A,B01,083779,Staff,0,13,30,30
1650351014288,MATH 103A,B02,083780,Staff,0,11,30,30
1650351020311,MATH 105,A01,085443,Staff,0,21,30,30
1650351026338,MATH 109,A01,083213,Anzaldo; Leesa B,0,6,30,30
1650351026338,MATH 109,A02,083214,Anzaldo; Leesa B,0,7,30,30
1650351026338,MATH 109,B01,083215,Anzaldo; Leesa B,0,5,30,30
1650351026338,MATH 109,B02,083216,Anzaldo; Leesa B,0,5,30,30
1650351032365,MATH 142A,A01,083219,Chow; Bennett,0,14,30,30
1650351032365,MATH 142A,A02,083220,Chow; Bennett,0,12,30,30
1650351032365,MATH 142A,B01,083221,Chow; Bennett,0,12,30,30
1650351032365,MATH 142A,B02,083222,Chow; Bennett,0,12,30,30
1650351038392,MATH 193A,A01,083224,Staff,0,5,30,30
1650351038392,MATH 193A,A02,083225,Staff,0,5,30,30
1650351038392,MATH 193A,A03,083781,Staff,0,4,30,30
1650351038392,MATH 193A,A04,083782,Staff,0,3,30,30
1650351044416,MATH 197,001,091859,McAuley; Julian John,9998,0,9999,1
1650351050467,COGS 9,A01,083615,Staff,0,14,60,60
1650351056492,COGS 11,A01,083617,Boyle; Mary E. T.,22,0,40,18
1650351062514,COGS 13,A01,083071,Staff,0,32,40,40
1650351068542,COGS 14A,A01,092681,Staff,0,20,100,100
1650351074569,COGS 14B,A01,083073,Cheng; Tzu-Han,0,10,50,50
1650351080593,COGS 17,A01,092677,Staff,24,0,75,51
1650351086634,COGS 100,A01,083619,Staff,0,23,60,60
1650351092658,COGS 101A,A01,083621,Davis; Joshua Daniel,0,21,60,60
1650351098685,COGS 101B,A01,091572,Staff,0,0,60,60
1650351104713,COGS 101C,A01,083625,Delgado; Tania,17,0,30,13
1650351110737,COGS 107A,A01,083627,Boyle; Mary E. T.,0,9,60,60
1650351116763,COGS 118A,A01,083075,Staff,4,0,60,56
1650351122788,CSE 3,A50,083646,Miranda; Gregory Joseph,21,0,38,17
1650351122788,CSE 3,A51,083647,Miranda; Gregory Joseph,37,0,37,0
1650351128815,CSE 8A,A50,083650,Miranda; Gregory Joseph,0,28,40,40
1650351134839,CSE 11,A01,083080,Cao; Yingjun,0,88,40,40
1650351140871,CSE 12,A01,083652,Staff,0,12,100,100
1650351146896,CSE 15L,A01,083654,Staff,0,1,50,50
1650351146896,CSE 15L,A02,083655,Staff,3,0,50,47
1650351152920,CSE 20,A01,083657,Staff,52,0,80,28
1650351158945,CSE 30,A01,083084,Eldon; John,0,76,40,40
1650351164968,CSE 100,A01,083659,Cao; Yingjun,0,66,50,50
1650351170992,CSE 134B,A01,083661,Powell; Thomas Allan,0,31,65,65
1650351177015,CSE 140,A01,083663,Staff,0,0,75,75
1650351183042,CSE 140L,A01,083088,Eldon; John,0,6,75,75
1650351189065,CSE 175,A01,083665,Kumar; Rakesh,8,0,25,17
1650351195096,CSE 190,A00,092507,Dubnov; Shlomo,14,0,20,6
1650351201119,ECE 45,A01,083139,Staff,0,17,40,40
1650351207149,ECE 65,A50,083695,Staff,0,5,30,30
1650351213173,ECE 109,A01,091882,Touri; Behrouz,40,0,70,30
1650351219197,ECE 180,A00,083140,Abi Samra; Nicholas Camill,23,0,30,7
1650351219197,ECE 180,B00,083141,Abi Samra; Nicholas Camill,5,0,30,25
1650351225224,MATH 10A,A01,083735,Patchell; Gregory David,8,0,30,22
1650351225224,MATH 10A,A02,083736,Patchell; Gregory David,28,0,30,2
1650351225224,MATH 10A,A03,083737,Patchell; Gregory David,25,0,30,5
1650351231248,MATH 10B,A01,083207,Staff,0,7,30,30
1650351231248,MATH 10B,A02,083208,Staff,0,6,30,30
1650351231248,MATH 10B,B01,083739,Staff,17,0,30,13
1650351231248,MATH 10B,B02,083740,Staff,28,0,30,2
1650351237276,MATH 18,A01,083743,Staff,3,0,30,27
1650351237276,MATH 18,A02,083744,Staff,27,0,30,3
1650351237276,MATH 18,A03,083745,Staff,22,0,30,8
1650351237276,MATH 18,A04,083746,Staff,27,0,30,3
1650351237276,MATH 18,B01,083748,Staff,0,11,30,30
1650351237276,MATH 18,B02,083749,Staff,0,11,30,30
1650351237276,MATH 18,B03,083750,Staff,0,11,30,30
1650351237276,MATH 18,B04,083751,Staff,0,9,30,30
1650351243298,MATH 20A,A01,083754,Staff,26,0,40,14
1650351249325,MATH 20B,A01,083756,Staff,0,8,30,30
1650351249325,MATH 20B,A02,083757,Staff,0,8,30,30
1650351255438,MATH 20C,A01,083760,Staff,0,14,30,30
1650351255438,MATH 20C,A02,083761,Staff,0,15,30,30
1650351255438,MATH 20C,B01,083762,Staff,13,0,30,17
1650351255438,MATH 20C,B02,083763,Staff,28,0,30,2
1650351261463,MATH 20D,A01,083765,Staff,0,1,30,30
1650351261463,MATH 20D,A02,083766,Staff,7,0,30,23
1650351261463,MATH 20D,A03,083767,Staff,26,0,30,4
1650351267487,MATH 20E,A01,083771,Staff,5,0,30,25
1650351267487,MATH 20E,A02,083772,Staff,19,0,30,11
1650351267487,MATH 20E,B01,083773,Staff,0,0,30,30
1650351267487,MATH 20E,B02,083774,Staff,12,0,30,18
1650351273515,MATH 103A,A01,083777,Staff,0,11,30,30
1650351273515,MATH 103A,A02,083778,Staff,0,12,30,30
1650351273515,MATH 103A,B01,083779,Staff,0,13,30,30
1650351273515,MATH 103A,B02,083780,Staff,0,11,30,30
1650351279537,MATH 105,A01,085443,Staff,0,21,30,30
1650351285565,MATH 109,A01,083213,Anzaldo; Leesa B,0,6,30,30
1650351285565,MATH 109,A02,083214,Anzaldo; Leesa B,0,7,30,30
1650351285565,MATH 109,B01,083215,Anzaldo; Leesa B,0,5,30,30
1650351285565,MATH 109,B02,083216,Anzaldo; Leesa B,0,5,30,30
1650351291586,MATH 142A,A01,083219,Chow; Bennett,0,14,30,30
1650351291586,MATH 142A,A02,083220,Chow; Bennett,0,12,30,30
1650351291586,MATH 142A,B01,083221,Chow; Bennett,0,12,30,30
1650351291586,MATH 142A,B02,083222,Chow; Bennett,0,12,30,30
1650351297613,MATH 193A,A01,083224,Staff,0,5,30,30
1650351297613,MATH 193A,A02,083225,Staff,0,5,30,30
1650351297613,MATH 193A,A03,083781,Staff,0,4,30,30
1650351297613,MATH 193A,A04,083782,Staff,0,3,30,30
1650351303636,MATH 197,001,091859,McAuley; Julian John,9998,0,9999,1
1650351309702,COGS 9,A01,083615,Staff,0,14,60,60
1650351315723,COGS 11,A01,083617,Boyle; Mary E. T.,22,0,40,18
1650351321748,COGS 13,A01,083071,Staff,0,32,40,40
1650351327774,COGS 14A,A01,092681,Staff,0,20,100,100
1650351333800,COGS 14B,A01,083073,Cheng; Tzu-Han,0,10,50,50
1650351339823,COGS 17,A01,092677,Staff,24,0,75,51
1650351345844,COGS 100,A01,083619,Staff,0,23,60,60
1650351351871,COGS 101A,A01,083621,Davis; Joshua Daniel,0,21,60,60
1650351357895,COGS 101B,A01,091572,Staff,0,0,60,60
1650351363923,COGS 101C,A01,083625,Delgado; Tania,17,0,30,13
1650351369949,COGS 107A,A01,083627,Boyle; Mary E. T.,0,9,60,60
1650351375976,COGS 118A,A01,083075,Staff,4,0,60,56
1650351381999,CSE 3,A50,083646,Miranda; Gregory Joseph,21,0,38,17
1650351381999,CSE 3,A51,083647,Miranda; Gregory Joseph,37,0,37,0
1650351388028,CSE 8A,A50,083650,Miranda; Gregory Joseph,0,28,40,40
1650351394055,CSE 11,A01,083080,Cao; Yingjun,0,88,40,40
1650351400082,CSE 12,A01,083652,Staff,0,12,100,100
1650351406115,CSE 15L,A01,083654,Staff,0,1,50,50
1650351406115,CSE 15L,A02,083655,Staff,3,0,50,47
1650351412144,CSE 20,A01,083657,Staff,52,0,80,28
1650351418168,CSE 30,A01,083084,Eldon; John,0,76,40,40
1650351424191,CSE 100,A01,083659,Cao; Yingjun,0,66,50,50
1650351430217,CSE 134B,A01,083661,Powell; Thomas Allan,0,31,65,65
1650351436245,CSE 140,A01,083663,Staff,0,0,75,75
1650351442295,CSE 140L,A01,083088,Eldon; John,0,6,75,75
1650351448317,CSE 175,A01,083665,Kumar; Rakesh,8,0,25,17
1650351454344,CSE 190,A00,092507,Dubnov; Shlomo,14,0,20,6
1650351460372,ECE 45,A01,083139,Staff,0,17,40,40
1650351466398,ECE 65,A50,083695,Staff,0,5,30,30
1650351472429,ECE 109,A01,091882,Touri; Behrouz,40,0,70,30
1650351478454,ECE 180,A00,083140,Abi Samra; Nicholas Camill,23,0,30,7
1650351478454,ECE 180,B00,083141,Abi Samra; Nicholas Camill,5,0,30,25
1650351484481,MATH 10A,A01,083735,Patchell; Gregory David,8,0,30,22
1650351484481,MATH 10A,A02,083736,Patchell; Gregory David,28,0,30,2
1650351484481,MATH 10A,A03,083737,Patchell; Gregory David,25,0,30,5
1650351490507,MATH 10B,A01,083207,Staff,0,7,30,30
1650351490507,MATH 10B,A02,083208,Staff,0,6,30,30
1650351490507,MATH 10B,B01,083739,Staff,17,0,30,13
1650351490507,MATH 10B,B02,083740,Staff,28,0,30,2
1650351496533,MATH 18,A01,083743,Staff,3,0,30,27
1650351496533,MATH 18,A02,083744,Staff,27,0,30,3
1650351496533,MATH 18,A03,083745,Staff,22,0,30,8
1650351496533,MATH 18,A04,083746,Staff,27,0,30,3
1650351496533,MATH 18,B01,083748,Staff,0,11,30,30
1650351496533,MATH 18,B02,083749,Staff,0,11,30,30
1650351496533,MATH 18,B03,083750,Staff,0,11,30,30
1650351496533,MATH 18,B04,083751,Staff,0,9,30,30
1650351510998,MATH 20A,A01,083754,Staff,26,0,40,14
1650351517026,MATH 20B,A01,083756,Staff,0,8,30,30
1650351517026,MATH 20B,A02,083757,Staff,0,8,30,30
1650351523052,MATH 20C,A01,083760,Staff,0,14,30,30
1650351523052,MATH 20C,A02,083761,Staff,0,15,30,30
1650351523052,MATH 20C,B01,083762,Staff,13,0,30,17
1650351523052,MATH 20C,B02,083763,Staff,28,0,30,2
1650351529080,MATH 20D,A01,083765,Staff,0,1,30,30
1650351529080,MATH 20D,A02,083766,Staff,7,0,30,23
1650351529080,MATH 20D,A03,083767,Staff,26,0,30,4
1650351535109,MATH 20E,A01,083771,Staff,5,0,30,25
1650351535109,MATH 20E,A02,083772,Staff,19,0,30,11
1650351535109,MATH 20E,B01,083773,Staff,0,0,30,30
1650351535109,MATH 20E,B02,083774,Staff,12,0,30,18
1650351541140,MATH 103A,A01,083777,Staff,0,11,30,30
1650351541140,MATH 103A,A02,083778,Staff,0,12,30,30
1650351541140,MATH 103A,B01,083779,Staff,0,13,30,30
1650351541140,MATH 103A,B02,083780,Staff,0,11,30,30
1650351547167,MATH 105,A01,085443,Staff,0,21,30,30
1650351553193,MATH 109,A01,083213,Anzaldo; Leesa B,0,6,30,30
1650351553193,MATH 109,A02,083214,Anzaldo; Leesa B,0,7,30,30
1650351553193,MATH 109,B01,083215,Anzaldo; Leesa B,0,5,30,30
1650351553193,MATH 109,B02,083216,Anzaldo; Leesa B,0,5,30,30
1650351559216,MATH 142A,A01,083219,Chow; Bennett,0,14,30,30
1650351559216,MATH 142A,A02,083220,Chow; Bennett,0,12,30,30
1650351559216,MATH 142A,B01,083221,Chow; Bennett,0,12,30,30
1650351559216,MATH 142A,B02,083222,Chow; Bennett,0,12,30,30
1650351565264,MATH 193A,A01,083224,Staff,0,5,30,30
1650351565264,MATH 193A,A02,083225,Staff,0,5,30,30
1650351565264,MATH 193A,A03,083781,Staff,0,4,30,30
1650351565264,MATH 193A,A04,083782,Staff,0,3,30,30
1650351571287,MATH 197,001,091859,McAuley; Julian John,9998,0,9999,1
1650351577345,COGS 9,A01,083615,Staff,0,14,60,60
1650351583369,COGS 11,A01,083617,Boyle; Mary E. T.,22,0,40,18
1650351589404,COGS 13,A01,083071,Staff,0,32,40,40
1650351595437,COGS 14A,A01,092681,Staff,0,20,100,100
1650351601460,COGS 14B,A01,083073,Cheng; Tzu-Han,0,10,50,50
1650351607485,COGS 17,A01,092677,Staff,24,0,75,51
1650351613507,COGS 100,A01,083619,Staff,0,23,60,60
1650351619530,COGS 101A,A01,083621,Davis; Joshua Daniel,0,21,60,60
1650351625559,COGS 101B,A01,091572,Staff,0,0,60,60
1650351631583,COGS 101C,A01,083625,Delgado; Tania,17,0,30,13
1650351637608,COGS 107A,A01,083627,Boyle; Mary E. T.,0,9,60,60
1650351643634,COGS 118A,A01,083075,Staff,4,0,60,56
1650351649670,CSE 3,A50,083646,Miranda; Gregory Joseph,21,0,38,17
1650351649670,CSE 3,A51,083647,Miranda; Gregory Joseph,37,0,37,0
1650351655695,CSE 8A,A50,083650,Miranda; Gregory Joseph,0,28,40,40
1650351661721,CSE 11,A01,083080,Cao; Yingjun,0,88,40,40
1650351667747,CSE 12,A01,083652,Staff,0,12,100,100
1650351673775,CSE 15L,A01,083654,Staff,0,1,50,50
1650351673775,CSE 15L,A02,083655,Staff,3,0,50,47
1650351679801,CSE 20,A01,083657,Staff,52,0,80,28
1650351685833,CSE 30,A01,083084,Eldon; John,0,76,40,40
1650351691856,CSE 100,A01,083659,Cao; Yingjun,0,66,50,50
1650351697881,CSE 134B,A01,083661,Powell; Thomas Allan,0,31,65,65
1650351703905,CSE 140,A01,083663,Staff,0,0,75,75
1650351709930,CSE 140L,A01,083088,Eldon; John,0,6,75,75
1650351715957,CSE 175,A01,083665,Kumar; Rakesh,8,0,25,17
1650351721980,CSE 190,A00,092507,Dubnov; Shlomo,14,0,20,6
1650351728008,ECE 45,A01,083139,Staff,0,17,40,40
1650351734034,ECE 65,A50,083695,Staff,0,5,30,30
1650351740059,ECE 109,A01,091882,Touri; Behrouz,40,0,70,30
1650351746083,ECE 180,A00,083140,Abi Samra; Nicholas Camill,23,0,30,7
1650351746083,ECE 180,B00,083141,Abi Samra; Nicholas Camill,5,0,30,25
1650351752113,MATH 10A,A01,083735,Patchell; Gregory David,8,0,30,22
1650351752113,MATH 10A,A02,083736,Patchell; Gregory David,28,0,30,2
1650351752113,MATH 10A,A03,083737,Patchell; Gregory David,25,0,30,5
1650351758137,MATH 10B,A01,083207,Staff,0,7,30,30
1650351758137,MATH 10B,A02,083208,Staff,0,6,30,30
1650351758137,MATH 10B,B01,083739,Staff,17,0,30,13
1650351758137,MATH 10B,B02,083740,Staff,28,0,30,2
1650351764163,MATH 18,A01,083743,Staff,3,0,30,27
1650351764163,MATH 18,A02,083744,Staff,27,0,30,3
1650351764163,MATH 18,A03,083745,Staff,22,0,30,8
1650351764163,MATH 18,A04,083746,Staff,27,0,30,3
1650351764163,MATH 18,B01,083748,Staff,0,11,30,30
1650351764163,MATH 18,B02,083749,Staff,0,11,30,30
1650351764163,MATH 18,B03,083750,Staff,0,11,30,30
1650351764163,MATH 18,B04,083751,Staff,0,9,30,30
1650351770198,MATH 20A,A01,083754,Staff,26,0,40,14
1650351776223,MATH 20B,A01,083756,Staff,0,8,30,30
1650351776223,MATH 20B,A02,083757,Staff,0,8,30,30
1650351782252,MATH 20C,A01,083760,Staff,0,14,30,30
1650351782252,MATH 20C,A02,083761,Staff,0,15,30,30
1650351782252,MATH 20C,B01,083762,Staff,13,0,30,17
1650351782252,MATH 20C,B02,083763,Staff,28,0,30,2
1650351788276,MATH 20D,A01,083765,Staff,0,1,30,30
1650351788276,MATH 20D,A02,083766,Staff,7,0,30,23
1650351788276,MATH 20D,A03,083767,Staff,26,0,30,4
1650351794300,MATH 20E,A01,083771,Staff,5,0,30,25
1650351794300,MATH 20E,A02,083772,Staff,19,0,30,11
1650351794300,MATH 20E,B01,083773,Staff,0,0,30,30
1650351794300,MATH 20E,B02,083774,Staff,12,0,30,18
1650351800324,MATH 103A,A01,083777,Staff,0,11,30,30
1650351800324,MATH 103A,A02,083778,Staff,0,12,30,30
1650351800324,MATH 103A,B01,083779,Staff,0,13,30,30
1650351800324,MATH 103A,B02,083780,Staff,0,11,30,30
1650351806368,MATH 105,A01,085443,Staff,0,21,30,30
1650351812397,MATH 109,A01,083213,Anzaldo; Leesa B,0,6,30,30
1650351812397,MATH 109,A02,083214,Anzaldo; Leesa B,0,7,30,30
1650351812397,MATH 109,B01,083215,Anzaldo; Leesa B,0,5,30,30
1650351812397,MATH 109,B02,083216,Anzaldo; Leesa B,0,5,30,30
1650351818422,MATH 142A,A01,083219,Chow; Bennett,0,14,30,30
1650351818422,MATH 142A,A02,083220,Chow; Bennett,0,12,30,30
1650351818422,MATH 142A,B01,083221,Chow; Bennett,0,12,30,30
1650351818422,MATH 142A,B02,083222,Chow; Bennett,0,12,30,30
1650351824452,MATH 193A,A01,083224,Staff,0,5,30,30
1650351824452,MATH 193A,A02,083225,Staff,0,5,30,30
1650351824452,MATH 193A,A03,083781,Staff,0,4,30,30
1650351824452,MATH 193A,A04,083782,Staff,0,3,30,30
1650351830475,MATH 197,001,091859,McAuley; Julian John,9998,0,9999,1
1650351836537,COGS 9,A01,083615,Staff,0,14,60,60
1650351842562,COGS 11,A01,083617,Boyle; Mary E. T.,22,0,40,18
1650351848588,COGS 13,A01,083071,Staff,0,32,40,40
1650351854704,COGS 14A,A01,092681,Staff,0,20,100,100
1650351860727,COGS 14B,A01,083073,Cheng; Tzu-Han,0,10,50,50
1650351866752,COGS 17,A01,092677,Staff,24,0,75,51
1650351872778,COGS 100,A01,083619,Staff,0,23,60,60
1650351878803,COGS 101A,A01,083621,Davis; Joshua Daniel,0,21,60,60
1650351884825,COGS 101B,A01,091572,Staff,0,0,60,60
1650351890853,COGS 101C,A01,083625,Delgado; Tania,17,0,30,13
1650351896887,COGS 107A,A01,083627,Boyle; Mary E. T.,0,9,60,60
1650351902912,COGS 118A,A01,083075,Staff,4,0,60,56
1650351908941,CSE 3,A50,083646,Miranda; Gregory Joseph,21,0,38,17
1650351908941,CSE 3,A51,083647,Miranda; Gregory Joseph,37,0,37,0
1650351914970,CSE 8A,A50,083650,Miranda; Gregory Joseph,0,28,40,40
1650351920996,CSE 11,A01,083080,Cao; Yingjun,0,88,40,40
1650351927023,CSE 12,A01,083652,Staff,0,12,100,100
1650351933047,CSE 15L,A01,083654,Staff,0,1,50,50
1650351933047,CSE 15L,A02,083655,Staff,3,0,50,47
1650351939074,CSE 20,A01,083657,Staff,52,0,80,28
1650351945099,CSE 30,A01,083084,Eldon; John,0,76,40,40
1650351951122,CSE 100,A01,083659,Cao; Yingjun,0,66,50,50
1650351957150,CSE 134B,A01,083661,Powell; Thomas Allan,0,31,65,65
1650351963179,CSE 140,A01,083663,Staff,0,0,75,75
1650351969208,CSE 140L,A01,083088,Eldon; John,0,7,75,75
1650351975238,CSE 175,A01,083665,Kumar; Rakesh,8,0,25,17
1650351981266,CSE 190,A00,092507,Dubnov; Shlomo,14,0,20,6
1650351987294,ECE 45,A01,083139,Staff,0,17,40,40
1650351993323,ECE 65,A50,083695,Staff,0,5,30,30
1650351999353,ECE 109,A01,091882,Touri; Behrouz,40,0,70,30
1650352005381,ECE 180,A00,083140,Abi Samra; Nicholas Camill,23,0,30,7
1650352005381,ECE 180,B00,083141,Abi Samra; Nicholas Camill,5,0,30,25
1650352011411,MATH 10A,A01,083735,Patchell; Gregory David,8,0,30,22
1650352011411,MATH 10A,A02,083736,Patchell; Gregory David,28,0,30,2
1650352011411,MATH 10A,A03,083737,Patchell; Gregory David,25,0,30,5
1650352017434,MATH 10B,A01,083207,Staff,0,7,30,30
1650352017434,MATH 10B,A02,083208,Staff,0,6,30,30
1650352017434,MATH 10B,B01,083739,Staff,17,0,30,13
1650352017434,MATH 10B,B02,083740,Staff,28,0,30,2
1650352023468,MATH 18,A01,083743,Staff,3,0,30,27
1650352023468,MATH 18,A02,083744,Staff,27,0,30,3
1650352023468,MATH 18,A03,083745,Staff,22,0,30,8
1650352023468,MATH 18,A04,083746,Staff,27,0,30,3
1650352023468,MATH 18,B01,083748,Staff,0,11,30,30
1650352023468,MATH 18,B02,083749,Staff,0,11,30,30
1650352023468,MATH 18,B03,083750,Staff,0,11,30,30
1650352023468,MATH 18,B04,083751,Staff,0,9,30,30
1650352029494,MATH 20A,A01,083754,Staff,26,0,40,14
1650352035517,MATH 20B,A01,083756,Staff,0,8,30,30
1650352035517,MATH 20B,A02,083757,Staff,0,8,30,30
1650352041543,MATH 20C,A01,083760,Staff,0,14,30,30
1650352041543,MATH 20C,A02,083761,Staff,0,15,30,30
1650352041543,MATH 20C,B01,083762,Staff,13,0,30,17
1650352041543,MATH 20C,B02,083763,Staff,28,0,30,2
1650352047566,MATH 20D,A01,083765,Staff,0,1,30,30
1650352047566,MATH 20D,A02,083766,Staff,7,0,30,23
1650352047566,MATH 20D,A03,083767,Staff,26,0,30,4
1650352053592,MATH 20E,A01,083771,Staff,5,0,30,25
1650352053592,MATH 20E,A02,083772,Staff,19,0,30,11
1650352053592,MATH 20E,B01,083773,Staff,0,0,30,30
1650352053592,MATH 20E,B02,083774,Staff,12,0,30,18
1650352059616,MATH 103A,A01,083777,Staff,0,11,30,30
1650352059616,MATH 103A,A02,083778,Staff,0,12,30,30
1650352059616,MATH 103A,B01,083779,Staff,0,13,30,30
1650352059616,MATH 103A,B02,083780,Staff,0,11,30,30
1650352065649,MATH 105,A01,085443,Staff,0,21,30,30
1650352071676,MATH 109,A01,083213,Anzaldo; Leesa B,0,6,30,30
1650352071676,MATH 109,A02,083214,Anzaldo; Leesa B,0,7,30,30
1650352071676,MATH 109,B01,083215,Anzaldo; Leesa B,0,5,30,30
1650352071676,MATH 109,B02,083216,Anzaldo; Leesa B,0,5,30,30
1650352077700,MATH 142A,A01,083219,Chow; Bennett,0,14,30,30
1650352077700,MATH 142A,A02,083220,Chow; Bennett,0,12,30,30
1650352077700,MATH 142A,B01,083221,Chow; Bennett,0,12,30,30
1650352077700,MATH 142A,B02,083222,Chow; Bennett,0,12,30,30
1650352083724,MATH 193A,A01,083224,Staff,0,5,30,30
1650352083724,MATH 193A,A02,083225,Staff,0,5,30,30
1650352083724,MATH 193A,A03,083781,Staff,0,4,30,30
1650352083724,MATH 193A,A04,083782,Staff,0,3,30,30
1650352089756,MATH 197,001,091859,McAuley; Julian John,9998,0,9999,1
1650352095808,COGS 9,A01,083615,Staff,0,14,60,60
1650352101835,COGS 11,A01,083617,Boyle; Mary E. T.,22,0,40,18
1650352107861,COGS 13,A01,083071,Staff,0,32,40,40
1650352113884,COGS 14A,A01,092681,Staff,0,20,100,100
1650352119907,COGS 14B,A01,083073,Cheng; Tzu-Han,0,10,50,50
1650352125934,COGS 17,A01,092677,Staff,24,0,75,51
1650352131964,COGS 100,A01,083619,Staff,0,23,60,60
1650352137990,COGS 101A,A01,083621,Davis; Joshua Daniel,0,21,60,60
1650352144014,COGS 101B,A01,091572,Staff,0,0,60,60
1650352150039,COGS 101C,A01,083625,Delgado; Tania,17,0,30,13
1650352156061,COGS 107A,A01,083627,Boyle; Mary E. T.,0,9,60,60
1650352162083,COGS 118A,A01,083075,Staff,4,0,60,56
1650352168107,CSE 3,A50,083646,Miranda; Gregory Joseph,21,0,38,17
1650352168107,CSE 3,A51,083647,Miranda; Gregory Joseph,37,0,37,0
1650352174139,CSE 8A,A50,083650,Miranda; Gregory Joseph,0,28,40,40
1650352180162,CSE 11,A01,083080,Cao; Yingjun,0,88,40,40
1650352186197,CSE 12,A01,083652,Staff,0,12,100,100
1650352192224,CSE 15L,A01,083654,Staff,0,1,50,50
1650352192224,CSE 15L,A02,083655,Staff,3,0,50,47
1650352198248,CSE 20,A01,083657,Staff,52,0,80,28
1650352204274,CSE 30,A01,083084,Eldon; John,0,76,40,40
1650352210301,CSE 100,A01,083659,Cao; Yingjun,0,66,50,50
1650352216325,CSE 134B,A01,083661,Powell; Thomas Allan,0,31,65,65
1650352222351,CSE 140,A01,083663,Staff,0,0,75,75
1650352228382,CSE 140L,A01,083088,Eldon; John,0,7,75,75
1650352234412,CSE 175,A01,083665,Kumar; Rakesh,8,0,25,17
1650352240440,CSE 190,A00,092507,Dubnov; Shlomo,14,0,20,6
1650352246464,ECE 45,A01,083139,Staff,0,17,40,40
1650352252495,ECE 65,A50,083695,Staff,0,5,30,30
1650352258523,ECE 109,A01,091882,Touri; Behrouz,40,0,70,30
1650352264553,ECE 180,A00,083140,Abi Samra; Nicholas Camill,23,0,30,7
1650352264553,ECE 180,B00,083141,Abi Samra; Nicholas Camill,5,0,30,25
1650352270576,MATH 10A,A01,083735,Patchell; Gregory David,8,0,30,22
1650352270576,MATH 10A,A02,083736,Patchell; Gregory David,28,0,30,2
1650352270576,MATH 10A,A03,083737,Patchell; Gregory David,25,0,30,5
1650352276606,MATH 10B,A01,083207,Staff,0,7,30,30
1650352276606,MATH 10B,A02,083208,Staff,0,6,30,30
1650352276606,MATH 10B,B01,083739,Staff,17,0,30,13
1650352276606,MATH 10B,B02,083740,Staff,28,0,30,2
1650352282641,MATH 18,A01,083743,Staff,3,0,30,27
1650352282641,MATH 18,A02,083744,Staff,27,0,30,3
1650352282641,MATH 18,A03,083745,Staff,22,0,30,8
1650352282641,MATH 18,A04,083746,Staff,27,0,30,3
1650352282641,MATH 18,B01,083748,Staff,0,11,30,30
1650352282641,MATH 18,B02,083749,Staff,0,11,30,30
1650352282641,MATH 18,B03,083750,Staff,0,11,30,30
1650352282641,MATH 18,B04,083751,Staff,0,9,30,30
1650352288665,MATH 20A,A01,083754,Staff,26,0,40,14
1650352294694,MATH 20B,A01,083756,Staff,0,8,30,30
1650352294694,MATH 20B,A02,083757,Staff,0,8,30,30
1650352300724,MATH 20C,A01,083760,Staff,0,14,30,30
1650352300724,MATH 20C,A02,083761,Staff,0,15,30,30
1650352300724,MATH 20C,B01,083762,Staff,13,0,30,17
1650352300724,MATH 20C,B02,083763,Staff,28,0,30,2
1650352306749,MATH 20D,A01,083765,Staff,0,1,30,30
1650352306749,MATH 20D,A02,083766,Staff,7,0,30,23
1650352306749,MATH 20D,A03,083767,Staff,26,0,30,4
1650352312777,MATH 20E,A01,083771,Staff,5,0,30,25
1650352312777,MATH 20E,A02,083772,Staff,19,0,30,11
1650352312777,MATH 20E,B01,083773,Staff,0,0,30,30
1650352312777,MATH 20E,B02,083774,Staff,12,0,30,18
1650352318802,MATH 103A,A01,083777,Staff,0,11,30,30
1650352318802,MATH 103A,A02,083778,Staff,0,12,30,30
1650352318802,MATH 103A,B01,083779,Staff,0,13,30,30
1650352318802,MATH 103A,B02,083780,Staff,0,11,30,30
1650352324825,MATH 105,A01,085443,Staff,0,21,30,30
1650352330856,MATH 109,A01,083213,Anzaldo; Leesa B,0,6,30,30
1650352330856,MATH 109,A02,083214,Anzaldo; Leesa B,0,7,30,30
1650352330856,MATH 109,B01,083215,Anzaldo; Leesa B,0,5,30,30
1650352330856,MATH 109,B02,083216,Anzaldo; Leesa B,0,5,30,30
1650352336883,MATH 142A,A01,083219,Chow; Bennett,0,14,30,30
1650352336883,MATH 142A,A02,083220,Chow; Bennett,0,12,30,30
1650352336883,MATH 142A,B01,083221,Chow; Bennett,0,12,30,30
1650352336883,MATH 142A,B02,083222,Chow; Bennett,0,12,30,30
1650352342907,MATH 193A,A01,083224,Staff,0,5,30,30
1650352342907,MATH 193A,A02,083225,Staff,0,5,30,30
1650352342907,MATH 193A,A03,083781,Staff,0,4,30,30
1650352342907,MATH 193A,A04,083782,Staff,0,3,30,30
1650352348934,MATH 197,001,091859,McAuley; Julian John,9998,0,9999,1
1650352354992,COGS 9,A01,083615,Staff,0,14,60,60
1650352361019,COGS 11,A01,083617,Boyle; Mary E. T.,22,0,40,18
1650352367047,COGS 13,A01,083071,Staff,0,32,40,40
1650352373072,COGS 14A,A01,092681,Staff,0,20,100,100
1650352379095,COGS 14B,A01,083073,Cheng; Tzu-Han,0,10,50,50
1650352385121,COGS 17,A01,092677,Staff,24,0,75,51
1650352391150,COGS 100,A01,083619,Staff,0,24,60,60
1650352397175,COGS 101A,A01,083621,Davis; Joshua Daniel,0,21,60,60
1650352403203,COGS 101B,A01,091572,Staff,0,0,60,60
1650352409225,COGS 101C,A01,083625,Delgado; Tania,17,0,30,13
1650352415249,COGS 107A,A01,083627,Boyle; Mary E. T.,0,9,60,60
1650352421277,COGS 118A,A01,083075,Staff,4,0,60,56
1650352427302,CSE 3,A50,083646,Miranda; Gregory Joseph,21,0,38,17
1650352427302,CSE 3,A51,083647,Miranda; Gregory Joseph,37,0,37,0
1650352433324,CSE 8A,A50,083650,Miranda; Gregory Joseph,0,28,40,40
1650352439352,CSE 11,A01,083080,Cao; Yingjun,0,88,40,40
1650352445376,CSE 12,A01,083652,Staff,0,12,100,100
1650352451490,CSE 15L,A01,083654,Staff,0,1,50,50
1650352451490,CSE 15L,A02,083655,Staff,3,0,50,47
1650352457518,CSE 20,A01,083657,Staff,52,0,80,28
1650352463549,CSE 30,A01,083084,Eldon; John,0,76,40,40
1650352469579,CSE 100,A01,083659,Cao; Yingjun,0,66,50,50
1650352475603,CSE 134B,A01,083661,Powell; Thomas Allan,0,31,65,65
1650352481631,CSE 140,A01,083663,Staff,0,0,75,75
1650352487656,CSE 140L,A01,083088,Eldon; John,0,7,75,75
1650352493685,CSE 175,A01,083665,Kumar; Rakesh,8,0,25,17
1650352499716,CSE 190,A00,092507,Dubnov; Shlomo,14,0,20,6
1650352505740,ECE 45,A01,083139,Staff,0,17,40,40
1650352511769,ECE 65,A50,083695,Staff,0,5,30,30
1650352517795,ECE 109,A01,091882,Touri; Behrouz,40,0,70,30
1650352523819,ECE 180,A00,083140,Abi Samra; Nicholas Camill,23,0,30,7
1650352523819,ECE 180,B00,083141,Abi Samra; Nicholas Camill,5,0,30,25
1650352529849,MATH 10A,A01,083735,Patchell; Gregory David,8,0,30,22
1650352529849,MATH 10A,A02,083736,Patchell; Gregory David,28,0,30,2
1650352529849,MATH 10A,A03,083737,Patchell; Gregory David,25,0,30,5
1650352535878,MATH 10B,A01,083207,Staff,0,7,30,30
1650352535878,MATH 10B,A02,083208,Staff,0,6,30,30
1650352535878,MATH 10B,B01,083739,Staff,17,0,30,13
1650352535878,MATH 10B,B02,083740,Staff,28,0,30,2
1650352541903,MATH 18,A01,083743,Staff,3,0,30,27
1650352541903,MATH 18,A02,083744,Staff,27,0,30,3
1650352541903,MATH 18,A03,083745,Staff,22,0,30,8
1650352541903,MATH 18,A04,083746,Staff,27,0,30,3
1650352541903,MATH 18,B01,083748,Staff,0,11,30,30
1650352541903,MATH 18,B02,083749,Staff,0,11,30,30
1650352541903,MATH 18,B03,083750,Staff,0,11,30,30
1650352541903,MATH 18,B04,083751,Staff,0,9,30,30
1650352547928,MATH 20A,A01,083754,Staff,26,0,40,14
1650352553957,MATH 20B,A01,083756,Staff,0,8,30,30
1650352553957,MATH 20B,A02,083757,Staff,0,8,30,30
1650352559982,MATH 20C,A01,083760,Staff,0,14,30,30
1650352559982,MATH 20C,A02,083761,Staff,0,15,30,30
1650352559982,MATH 20C,B01,083762,Staff,13,0,30,17
1650352559982,MATH 20C,B02,083763,Staff,28,0,30,2
1650352566020,MATH 20D,A01,083765,Staff,0,1,30,30
1650352566020,MATH 20D,A02,083766,Staff,7,0,30,23
1650352566020,MATH 20D,A03,083767,Staff,26,0,30,4
1650352572051,MATH 20E,A01,083771,Staff,5,0,30,25
1650352572051,MATH 20E,A02,083772,Staff,19,0,30,11
1650352572051,MATH 20E,B01,083773,Staff,0,0,30,30
1650352572051,MATH 20E,B02,083774,Staff,12,0,30,18
1650352578081,MATH 103A,A01,083777,Staff,0,11,30,30
1650352578081,MATH 103A,A02,083778,Staff,0,12,30,30
1650352578081,MATH 103A,B01,083779,Staff,0,13,30,30
1650352578081,MATH 103A,B02,083780,Staff,0,11,30,30
1650352584359,MATH 105,A01,085443,Staff,0,21,30,30
1650352590384,MATH 109,A01,083213,Anzaldo; Leesa B,0,6,30,30
1650352590384,MATH 109,A02,083214,Anzaldo; Leesa B,0,7,30,30
1650352590384,MATH 109,B01,083215,Anzaldo; Leesa B,0,5,30,30
1650352590384,MATH 109,B02,083216,Anzaldo; Leesa B,0,5,30,30
1650352596413,MATH 142A,A01,083219,Chow; Bennett,0,14,30,30
1650352596413,MATH 142A,A02,083220,Chow; Bennett,0,12,30,30
1650352596413,MATH 142A,B01,083221,Chow; Bennett,0,12,30,30
1650352596413,MATH 142A,B02,083222,Chow; Bennett,0,12,30,30
1650352602437,MATH 193A,A01,083224,Staff,0,5,30,30
1650352602437,MATH 193A,A02,083225,Staff,0,5,30,30
1650352602437,MATH 193A,A03,083781,Staff,0,4,30,30
1650352602437,MATH 193A,A04,083782,Staff,0,3,30,30
1650352608461,MATH 197,001,091859,McAuley; Julian John,9998,0,9999,1
1650352614527,COGS 9,A01,083615,Staff,0,14,60,60
1650352620557,COGS 11,A01,083617,Boyle; Mary E. T.,22,0,40,18
1650352626581,COGS 13,A01,083071,Staff,0,32,40,40
1650352632604,COGS 14A,A01,092681,Staff,0,20,100,100
1650352638633,COGS 14B,A01,083073,Cheng; Tzu-Han,0,10,50,50
1650352644660,COGS 17,A01,092677,Staff,24,0,75,51
1650352650691,COGS 100,A01,083619,Staff,0,24,60,60
1650352656714,COGS 101A,A01,083621,Davis; Joshua Daniel,0,21,60,60
1650352662742,COGS 101B,A01,091572,Staff,0,0,60,60
1650352668770,COGS 101C,A01,083625,Delgado; Tania,17,0,30,13
1650352674795,COGS 107A,A01,083627,Boyle; Mary E. T.,0,9,60,60
1650352680822,COGS 118A,A01,083075,Staff,4,0,60,56
1650352686853,CSE 3,A50,083646,Miranda; Gregory Joseph,21,0,38,17
1650352686853,CSE 3,A51,083647,Miranda; Gregory Joseph,37,0,37,0
1650352692883,CSE 8A,A50,083650,Miranda; Gregory Joseph,0,28,40,40
1650352698907,CSE 11,A01,083080,Cao; Yingjun,0,88,40,40
1650352704931,CSE 12,A01,083652,Staff,0,12,100,100
1650352710959,CSE 15L,A01,083654,Staff,0,1,50,50
1650352710959,CSE 15L,A02,083655,Staff,3,0,50,47
1650352716982,CSE 20,A01,083657,Staff,52,0,80,28
1650352723011,CSE 30,A01,083084,Eldon; John,0,76,40,40
1650352729046,CSE 100,A01,083659,Cao; Yingjun,0,66,50,50
1650352735071,CSE 134B,A01,083661,Powell; Thomas Allan,0,31,65,65
1650352741096,CSE 140,A01,083663,Staff,0,0,75,75
1650352747122,CSE 140L,A01,083088,Eldon; John,0,7,75,75
1650352753152,CSE 175,A01,083665,Kumar; Rakesh,8,0,25,17
1650352759177,CSE 190,A00,092507,Dubnov; Shlomo,14,0,20,6
1650352765208,ECE 45,A01,083139,Staff,0,17,40,40
1650352771238,ECE 65,A50,083695,Staff,0,5,30,30
1650352777266,ECE 109,A01,091882,Touri; Behrouz,40,0,70,30
1650352783291,ECE 180,A00,083140,Abi Samra; Nicholas Camill,23,0,30,7
1650352783291,ECE 180,B00,083141,Abi Samra; Nicholas Camill,5,0,30,25
1650352789317,MATH 10A,A01,083735,Patchell; Gregory David,8,0,30,22
1650352789317,MATH 10A,A02,083736,Patchell; Gregory David,28,0,30,2
1650352789317,MATH 10A,A03,083737,Patchell; Gregory David,25,0,30,5
1650352795346,MATH 10B,A01,083207,Staff,0,7,30,30
1650352795346,MATH 10B,A02,083208,Staff,0,6,30,30
1650352795346,MATH 10B,B01,083739,Staff,17,0,30,13
1650352795346,MATH 10B,B02,083740,Staff,28,0,30,2
1650352801378,MATH 18,A01,083743,Staff,3,0,30,27
1650352801378,MATH 18,A02,083744,Staff,27,0,30,3
1650352801378,MATH 18,A03,083745,Staff,22,0,30,8
1650352801378,MATH 18,A04,083746,Staff,27,0,30,3
1650352801378,MATH 18,B01,083748,Staff,0,11,30,30
1650352801378,MATH 18,B02,083749,Staff,0,11,30,30
1650352801378,MATH 18,B03,083750,Staff,0,11,30,30
1650352801378,MATH 18,B04,083751,Staff,0,9,30,30
1650352807406,MATH 20A,A01,083754,Staff,26,0,40,14
1650352813430,MATH 20B,A01,083756,Staff,0,8,30,30
1650352813430,MATH 20B,A02,083757,Staff,0,8,30,30
1650352819453,MATH 20C,A01,083760,Staff,0,14,30,30
1650352819453,MATH 20C,A02,083761,Staff,0,15,30,30
1650352819453,MATH 20C,B01,083762,Staff,13,0,30,17
1650352819453,MATH 20C,B02,083763,Staff,28,0,30,2
1650352825478,MATH 20D,A01,083765,Staff,0,1,30,30
1650352825478,MATH 20D,A02,083766,Staff,7,0,30,23
1650352825478,MATH 20D,A03,083767,Staff,26,0,30,4
1650352831508,MATH 20E,A01,083771,Staff,5,0,30,25
1650352831508,MATH 20E,A02,083772,Staff,19,0,30,11
1650352831508,MATH 20E,B01,083773,Staff,0,0,30,30
1650352831508,MATH 20E,B02,083774,Staff,12,0,30,18
1650352837535,MATH 103A,A01,083777,Staff,0,11,30,30
1650352837535,MATH 103A,A02,083778,Staff,0,12,30,30
1650352837535,MATH 103A,B01,083779,Staff,0,13,30,30
1650352837535,MATH 103A,B02,083780,Staff,0,11,30,30
1650352843565,MATH 105,A01,085443,Staff,0,21,30,30
1650352849592,MATH 109,A01,083213,Anzaldo; Leesa B,0,6,30,30
1650352849592,MATH 109,A02,083214,Anzaldo; Leesa B,0,7,30,30
1650352849592,MATH 109,B01,083215,Anzaldo; Leesa B,0,5,30,30
1650352849592,MATH 109,B02,083216,Anzaldo; Leesa B,0,5,30,30
1650352855618,MATH 142A,A01,083219,Chow; Bennett,0,14,30,30
1650352855618,MATH 142A,A02,083220,Chow; Bennett,0,12,30,30
1650352855618,MATH 142A,B01,083221,Chow; Bennett,0,12,30,30
1650352855618,MATH 142A,B02,083222,Chow; Bennett,0,12,30,30
1650352861647,MATH 193A,A01,083224,Staff,0,5,30,30
1650352861647,MATH 193A,A02,083225,Staff,0,5,30,30
1650352861647,MATH 193A,A03,083781,Staff,0,4,30,30
1650352861647,MATH 193A,A04,083782,Staff,0,3,30,30
1650352867676,MATH 197,001,091859,McAuley; Julian John,9998,0,9999,1
1650352873746,COGS 9,A01,083615,Staff,0,14,60,60
1650352879777,COGS 11,A01,083617,Boyle; Mary E. T.,22,0,40,18
1650352885803,COGS 13,A01,083071,Staff,0,32,40,40
1650352891826,COGS 14A,A01,092681,Staff,0,20,100,100
1650352897848,COGS 14B,A01,083073,Cheng; Tzu-Han,0,10,50,50
1650352903874,COGS 17,A01,092677,Staff,24,0,75,51
1650352909897,COGS 100,A01,083619,Staff,0,24,60,60
1650352915923,COGS 101A,A01,083621,Davis; Joshua Daniel,0,21,60,60
1650352921950,COGS 101B,A01,091572,Staff,0,0,60,60
1650352927978,COGS 101C,A01,083625,Delgado; Tania,17,0,30,13
1650352934002,COGS 107A,A01,083627,Boyle; Mary E. T.,0,9,60,60
1650352940030,COGS 118A,A01,083075,Staff,4,0,60,56
1650352946059,CSE 3,A50,083646,Miranda; Gregory Joseph,21,0,38,17
1650352946059,CSE 3,A51,083647,Miranda; Gregory Joseph,37,0,37,0
1650352952082,CSE 8A,A50,083650,Miranda; Gregory Joseph,0,28,40,40
1650352958107,CSE 11,A01,083080,Cao; Yingjun,0,88,40,40
1650352964135,CSE 12,A01,083652,Staff,0,12,100,100
1650352970161,CSE 15L,A01,083654,Staff,0,1,50,50
1650352970161,CSE 15L,A02,083655,Staff,3,0,50,47
1650352976188,CSE 20,A01,083657,Staff,52,0,80,28
1650352982212,CSE 30,A01,083084,Eldon; John,0,76,40,40
1650352988240,CSE 100,A01,083659,Cao; Yingjun,0,66,50,50
1650352994269,CSE 134B,A01,083661,Powell; Thomas Allan,0,31,65,65
1650353000293,CSE 140,A01,083663,Staff,0,0,75,75
1650353006317,CSE 140L,A01,083088,Eldon; John,0,7,75,75
1650353012340,CSE 175,A01,083665,Kumar; Rakesh,8,0,25,17
1650353018366,CSE 190,A00,092507,Dubnov; Shlomo,14,0,20,6
1650353024390,ECE 45,A01,083139,Staff,0,17,40,40
1650353030415,ECE 65,A50,083695,Staff,0,5,30,30
1650353036451,ECE 109,A01,091882,Touri; Behrouz,40,0,70,30
1650353042489,ECE 180,A00,083140,Abi Samra; Nicholas Camill,23,0,30,7
1650353042489,ECE 180,B00,083141,Abi Samra; Nicholas Camill,5,0,30,25
1650353048603,MATH 10A,A01,083735,Patchell; Gregory David,8,0,30,22
1650353048603,MATH 10A,A02,083736,Patchell; Gregory David,28,0,30,2
1650353048603,MATH 10A,A03,083737,Patchell; Gregory David,25,0,30,5
1650353054634,MATH 10B,A01,083207,Staff,0,7,30,30
1650353054634,MATH 10B,A02,083208,Staff,0,6,30,30
1650353054634,MATH 10B,B01,083739,Staff,17,0,30,13
1650353054634,MATH 10B,B02,083740,Staff,28,0,30,2
1650353060666,MATH 18,A01,083743,Staff,3,0,30,27
1650353060666,MATH 18,A02,083744,Staff,27,0,30,3
1650353060666,MATH 18,A03,083745,Staff,22,0,30,8
1650353060666,MATH 18,A04,083746,Staff,27,0,30,3
1650353060666,MATH 18,B01,083748,Staff,0,11,30,30
1650353060666,MATH 18,B02,083749,Staff,0,11,30,30
1650353060666,MATH 18,B03,083750,Staff,0,11,30,30
1650353060666,MATH 18,B04,083751,Staff,0,9,30,30
1650353066691,MATH 20A,A01,083754,Staff,26,0,40,14
1650353072721,MATH 20B,A01,083756,Staff,0,8,30,30
1650353072721,MATH 20B,A02,083757,Staff,0,8,30,30
1650353078747,MATH 20C,A01,083760,Staff,0,14,30,30
1650353078747,MATH 20C,A02,083761,Staff,0,15,30,30
1650353078747,MATH 20C,B01,083762,Staff,13,0,30,17
1650353078747,MATH 20C,B02,083763,Staff,28,0,30,2
1650353084771,MATH 20D,A01,083765,Staff,0,1,30,30
1650353084771,MATH 20D,A02,083766,Staff,7,0,30,23
1650353084771,MATH 20D,A03,083767,Staff,26,0,30,4
1650353090796,MATH 20E,A01,083771,Staff,5,0,30,25
1650353090796,MATH 20E,A02,083772,Staff,19,0,30,11
1650353090796,MATH 20E,B01,083773,Staff,0,0,30,30
1650353090796,MATH 20E,B02,083774,Staff,12,0,30,18
1650353096820,MATH 103A,A01,083777,Staff,0,11,30,30
1650353096820,MATH 103A,A02,083778,Staff,0,12,30,30
1650353096820,MATH 103A,B01,083779,Staff,0,13,30,30
1650353096820,MATH 103A,B02,083780,Staff,0,11,30,30
1650353102847,MATH 105,A01,085443,Staff,0,21,30,30
1650353108870,MATH 109,A01,083213,Anzaldo; Leesa B,0,6,30,30
1650353108870,MATH 109,A02,083214,Anzaldo; Leesa B,0,7,30,30
1650353108870,MATH 109,B01,083215,Anzaldo; Leesa B,0,5,30,30
1650353108870,MATH 109,B02,083216,Anzaldo; Leesa B,0,5,30,30
1650353114897,MATH 142A,A01,083219,Chow; Bennett,0,14,30,30
1650353114897,MATH 142A,A02,083220,Chow; Bennett,0,12,30,30
1650353114897,MATH 142A,B01,083221,Chow; Bennett,0,12,30,30
1650353114897,MATH 142A,B02,083222,Chow; Bennett,0,12,30,30
1650353120920,MATH 193A,A01,083224,Staff,0,5,30,30
1650353120920,MATH 193A,A02,083225,Staff,0,5,30,30
1650353120920,MATH 193A,A03,083781,Staff,0,4,30,30
1650353120920,MATH 193A,A04,083782,Staff,0,3,30,30
1650353126946,MATH 197,001,091859,McAuley; Julian John,9998,0,9999,1
1650353133040,COGS 9,A01,083615,Staff,0,14,60,60
1650353139068,COGS 11,A01,083617,Boyle; Mary E. T.,22,0,40,18
1650353145092,COGS 13,A01,083071,Staff,0,32,40,40
1650353151134,COGS 14A,A01,092681,Staff,0,20,100,100
1650353157160,COGS 14B,A01,083073,Cheng; Tzu-Han,0,10,50,50
1650353163185,COGS 17,A01,092677,Staff,24,0,75,51
1650353169209,COGS 100,A01,083619,Staff,0,24,60,60
1650353175237,COGS 101A,A01,083621,Davis; Joshua Daniel,0,21,60,60
1650353181261,COGS 101B,A01,091572,Staff,0,0,60,60
1650353187285,COGS 101C,A01,083625,Delgado; Tania,17,0,30,13
1650353193307,COGS 107A,A01,083627,Boyle; Mary E. T.,0,9,60,60
1650353199332,COGS 118A,A01,083075,Staff,4,0,60,56
1650353205357,CSE 3,A50,083646,Miranda; Gregory Joseph,21,0,38,17
1650353205357,CSE 3,A51,083647,Miranda; Gregory Joseph,37,0,37,0
1650353211385,CSE 8A,A50,083650,Miranda; Gregory Joseph,0,28,40,40
1650353217411,CSE 11,A01,083080,Cao; Yingjun,0,88,40,40
1650353223436,CSE 12,A01,083652,Staff,0,12,100,100
1650353229463,CSE 15L,A01,083654,Staff,0,1,50,50
1650353229463,CSE 15L,A02,083655,Staff,3,0,50,47
1650353235491,CSE 20,A01,083657,Staff,52,0,80,28
1650353241516,CSE 30,A01,083084,Eldon; John,0,76,40,40
1650353247539,CSE 100,A01,083659,Cao; Yingjun,0,66,50,50
1650353253564,CSE 134B,A01,083661,Powell; Thomas Allan,0,31,65,65
1650353259595,CSE 140,A01,083663,Staff,0,0,75,75
1650353265619,CSE 140L,A01,083088,Eldon; John,0,7,75,75
1650353271643,CSE 175,A01,083665,Kumar; Rakesh,8,0,25,17
1650353277675,CSE 190,A00,092507,Dubnov; Shlomo,14,0,20,6
1650353283699,ECE 45,A01,083139,Staff,0,17,40,40
1650353289724,ECE 65,A50,083695,Staff,0,5,30,30
1650353295748,ECE 109,A01,091882,Touri; Behrouz,40,0,70,30
1650353301771,ECE 180,A00,083140,Abi Samra; Nicholas Camill,23,0,30,7
1650353301771,ECE 180,B00,083141,Abi Samra; Nicholas Camill,5,0,30,25
1650353307794,MATH 10A,A01,083735,Patchell; Gregory David,8,0,30,22
1650353307794,MATH 10A,A02,083736,Patchell; Gregory David,28,0,30,2
1650353307794,MATH 10A,A03,083737,Patchell; Gregory David,25,0,30,5
1650353313823,MATH 10B,A01,083207,Staff,0,7,30,30
1650353313823,MATH 10B,A02,083208,Staff,0,6,30,30
1650353313823,MATH 10B,B01,083739,Staff,17,0,30,13
1650353313823,MATH 10B,B02,083740,Staff,28,0,30,2
1650353319853,MATH 18,A01,083743,Staff,3,0,30,27
1650353319853,MATH 18,A02,083744,Staff,27,0,30,3
1650353319853,MATH 18,A03,083745,Staff,22,0,30,8
1650353319853,MATH 18,A04,083746,Staff,27,0,30,3
1650353319853,MATH 18,B01,083748,Staff,0,11,30,30
1650353319853,MATH 18,B02,083749,Staff,0,11,30,30
1650353319853,MATH 18,B03,083750,Staff,0,11,30,30
1650353319853,MATH 18,B04,083751,Staff,0,9,30,30
1650353325876,MATH 20A,A01,083754,Staff,26,0,40,14
1650353331900,MATH 20B,A01,083756,Staff,0,8,30,30
1650353331900,MATH 20B,A02,083757,Staff,0,8,30,30
1650353337925,MATH 20C,A01,083760,Staff,0,14,30,30
1650353337925,MATH 20C,A02,083761,Staff,0,15,30,30
1650353337925,MATH 20C,B01,083762,Staff,13,0,30,17
1650353337925,MATH 20C,B02,083763,Staff,28,0,30,2
1650353343956,MATH 20D,A01,083765,Staff,0,1,30,30
1650353343956,MATH 20D,A02,083766,Staff,7,0,30,23
1650353343956,MATH 20D,A03,083767,Staff,26,0,30,4
1650353349992,MATH 20E,A01,083771,Staff,5,0,30,25
1650353349992,MATH 20E,A02,083772,Staff,19,0,30,11
1650353349992,MATH 20E,B01,083773,Staff,0,0,30,30
1650353349992,MATH 20E,B02,083774,Staff,12,0,30,18
1650353356019,MATH 103A,A01,083777,Staff,0,11,30,30
1650353356019,MATH 103A,A02,083778,Staff,0,12,30,30
1650353356019,MATH 103A,B01,083779,Staff,0,13,30,30
1650353356019,MATH 103A,B02,083780,Staff,0,11,30,30
1650353362043,MATH 105,A01,085443,Staff,0,21,30,30
1650353368067,MATH 109,A01,083213,Anzaldo; Leesa B,0,6,30,30
1650353368067,MATH 109,A02,083214,Anzaldo; Leesa B,0,7,30,30
1650353368067,MATH 109,B01,083215,Anzaldo; Leesa B,0,5,30,30
1650353368067,MATH 109,B02,083216,Anzaldo; Leesa B,0,5,30,30
1650353374092,MATH 142A,A01,083219,Chow; Bennett,0,14,30,30
1650353374092,MATH 142A,A02,083220,Chow; Bennett,0,12,30,30
1650353374092,MATH 142A,B01,083221,Chow; Bennett,0,12,30,30
1650353374092,MATH 142A,B02,083222,Chow; Bennett,0,12,30,30
1650353380120,MATH 193A,A01,083224,Staff,0,5,30,30
1650353380120,MATH 193A,A02,083225,Staff,0,5,30,30
1650353380120,MATH 193A,A03,083781,Staff,0,4,30,30
1650353380120,MATH 193A,A04,083782,Staff,0,3,30,30
1650353386146,MATH 197,001,091859,McAuley; Julian John,9998,0,9999,1
1650353392201,COGS 9,A01,083615,Staff,0,14,60,60
1650353398232,COGS 11,A01,083617,Boyle; Mary E. T.,22,0,40,18
1650353404258,COGS 13,A01,083071,Staff,0,32,40,40
1650353410282,COGS 14A,A01,092681,Staff,0,20,100,100
1650353416306,COGS 14B,A01,083073,Cheng; Tzu-Han,0,10,50,50
1650353422344,COGS 17,A01,092677,Staff,24,0,75,51
1650353428371,COGS 100,A01,083619,Staff,0,24,60,60
1650353434398,COGS 101A,A01,083621,Davis; Joshua Daniel,0,21,60,60
1650353440427,COGS 101B,A01,091572,Staff,0,0,60,60
1650353446452,COGS 101C,A01,083625,Delgado; Tania,17,0,30,13
1650353452478,COGS 107A,A01,083627,Boyle; Mary E. T.,0,9,60,60
1650353458504,COGS 118A,A01,083075,Staff,4,0,60,56
1650353464529,CSE 3,A50,083646,Miranda; Gregory Joseph,21,0,38,17
1650353464529,CSE 3,A51,083647,Miranda; Gregory Joseph,37,0,37,0
1650353470554,CSE 8A,A50,083650,Miranda; Gregory Joseph,0,28,40,40
1650353476582,CSE 11,A01,083080,Cao; Yingjun,0,88,40,40
1650353482630,CSE 12,A01,083652,Staff,0,12,100,100
1650353488656,CSE 15L,A01,083654,Staff,0,1,50,50
1650353488656,CSE 15L,A02,083655,Staff,3,0,50,47
1650353494689,CSE 20,A01,083657,Staff,52,0,80,28
1650353500721,CSE 30,A01,083084,Eldon; John,0,76,40,40
1650353506745,CSE 100,A01,083659,Cao; Yingjun,0,66,50,50
1650353512773,CSE 134B,A01,083661,Powell; Thomas Allan,0,31,65,65
1650353518800,CSE 140,A01,083663,Staff,0,0,75,75
1650353524833,CSE 140L,A01,083088,Eldon; John,0,7,75,75
1650353530862,CSE 175,A01,083665,Kumar; Rakesh,8,0,25,17
1650353536897,CSE 190,A00,092507,Dubnov; Shlomo,14,0,20,6
1650353542921,ECE 45,A01,083139,Staff,0,17,40,40
1650353548949,ECE 65,A50,083695,Staff,0,5,30,30
1650353554973,ECE 109,A01,091882,Touri; Behrouz,40,0,70,30
1650353561001,ECE 180,A00,083140,Abi Samra; Nicholas Camill,23,0,30,7
1650353561001,ECE 180,B00,083141,Abi Samra; Nicholas Camill,5,0,30,25
1650353567029,MATH 10A,A01,083735,Patchell; Gregory David,8,0,30,22
1650353567029,MATH 10A,A02,083736,Patchell; Gregory David,28,0,30,2
1650353567029,MATH 10A,A03,083737,Patchell; Gregory David,25,0,30,5
1650353573061,MATH 10B,A01,083207,Staff,0,7,30,30
1650353573061,MATH 10B,A02,083208,Staff,0,6,30,30
1650353573061,MATH 10B,B01,083739,Staff,17,0,30,13
1650353573061,MATH 10B,B02,083740,Staff,28,0,30,2
1650353579096,MATH 18,A01,083743,Staff,3,0,30,27
1650353579096,MATH 18,A02,083744,Staff,27,0,30,3
1650353579096,MATH 18,A03,083745,Staff,22,0,30,8
1650353579096,MATH 18,A04,083746,Staff,27,0,30,3
1650353579096,MATH 18,B01,083748,Staff,0,11,30,30
1650353579096,MATH 18,B02,083749,Staff,0,11,30,30
1650353579096,MATH 18,B03,083750,Staff,0,11,30,30
1650353579096,MATH 18,B04,083751,Staff,0,9,30,30
1650353585124,MATH 20A,A01,083754,Staff,26,0,40,14
1650353591154,MATH 20B,A01,083756,Staff,0,8,30,30
1650353591154,MATH 20B,A02,083757,Staff,0,8,30,30
1650353597182,MATH 20C,A01,083760,Staff,0,14,30,30
1650353597182,MATH 20C,A02,083761,Staff,0,15,30,30
1650353597182,MATH 20C,B01,083762,Staff,13,0,30,17
1650353597182,MATH 20C,B02,083763,Staff,28,0,30,2
1650353603212,MATH 20D,A01,083765,Staff,0,1,30,30
1650353603212,MATH 20D,A02,083766,Staff,7,0,30,23
1650353603212,MATH 20D,A03,083767,Staff,26,0,30,4
1650353609239,MATH 20E,A01,083771,Staff,5,0,30,25
1650353609239,MATH 20E,A02,083772,Staff,19,0,30,11
1650353609239,MATH 20E,B01,083773,Staff,0,0,30,30
1650353609239,MATH 20E,B02,083774,Staff,12,0,30,18
1650353615273,MATH 103A,A01,083777,Staff,0,11,30,30
1650353615273,MATH 103A,A02,083778,Staff,0,12,30,30
1650353615273,MATH 103A,B01,083779,Staff,0,13,30,30
1650353615273,MATH 103A,B02,083780,Staff,0,11,30,30
1650353621303,MATH 105,A01,085443,Staff,0,21,30,30
1650353627333,MATH 109,A01,083213,Anzaldo; Leesa B,0,6,30,30
1650353627333,MATH 109,A02,083214,Anzaldo; Leesa B,0,7,30,30
1650353627333,MATH 109,B01,083215,Anzaldo; Leesa B,0,5,30,30
1650353627333,MATH 109,B02,083216,Anzaldo; Leesa B,0,5,30,30
1650353633360,MATH 142A,A01,083219,Chow; Bennett,0,14,30,30
1650353633360,MATH 142A,A02,083220,Chow; Bennett,0,12,30,30
1650353633360,MATH 142A,B01,083221,Chow; Bennett,0,12,30,30
1650353633360,MATH 142A,B02,083222,Chow; Bennett,0,12,30,30
1650353639386,MATH 193A,A01,083224,Staff,0,5,30,30
1650353639386,MATH 193A,A02,083225,Staff,0,5,30,30
1650353639386,MATH 193A,A03,083781,Staff,0,4,30,30
1650353639386,MATH 193A,A04,083782,Staff,0,3,30,30
1650353645501,MATH 197,001,091859,McAuley; Julian John,9998,0,9999,1
1650353651578,COGS 9,A01,083615,Staff,0,14,60,60
1650353657610,COGS 11,A01,083617,Boyle; Mary E. T.,22,0,40,18
1650353663647,COGS 13,A01,083071,Staff,0,32,40,40
1650353669673,COGS 14A,A01,092681,Staff,0,20,100,100
1650353675698,COGS 14B,A01,083073,Cheng; Tzu-Han,0,10,50,50
1650353681721,COGS 17,A01,092677,Staff,24,0,75,51
1650353687750,COGS 100,A01,083619,Staff,0,24,60,60
1650353693780,COGS 101A,A01,083621,Davis; Joshua Daniel,0,21,60,60
1650353699811,COGS 101B,A01,091572,Staff,0,0,60,60
1650353705838,COGS 101C,A01,083625,Delgado; Tania,17,0,30,13
1650353711875,COGS 107A,A01,083627,Boyle; Mary E. T.,0,9,60,60
1650353717901,COGS 118A,A01,083075,Staff,4,0,60,56
1650353723927,CSE 3,A50,083646,Miranda; Gregory Joseph,21,0,38,17
1650353723927,CSE 3,A51,083647,Miranda; Gregory Joseph,37,0,37,0
1650353729951,CSE 8A,A50,083650,Miranda; Gregory Joseph,0,28,40,40
1650353735976,CSE 11,A01,083080,Cao; Yingjun,0,88,40,40
1650353742000,CSE 12,A01,083652,Staff,0,12,100,100
1650353748030,CSE 15L,A01,083654,Staff,0,1,50,50
1650353748030,CSE 15L,A02,083655,Staff,3,0,50,47
1650353754055,CSE 20,A01,083657,Staff,52,0,80,28
1650353760106,CSE 30,A01,083084,Eldon; John,0,76,40,40
1650353766136,CSE 100,A01,083659,Cao; Yingjun,0,66,50,50
1650353772162,CSE 134B,A01,083661,Powell; Thomas Allan,0,31,65,65
1650353778186,CSE 140,A01,083663,Staff,0,0,75,75
1650353784212,CSE 140L,A01,083088,Eldon; John,0,7,75,75
1650353790237,CSE 175,A01,083665,Kumar; Rakesh,8,0,25,17
1650353796262,CSE 190,A00,092507,Dubnov; Shlomo,14,0,20,6
1650353802290,ECE 45,A01,083139,Staff,0,17,40,40
1650353808319,ECE 65,A50,083695,Staff,0,5,30,30
1650353814344,ECE 109,A01,091882,Touri; Behrouz,40,0,70,30
1650353820367,ECE 180,A00,083140,Abi Samra; Nicholas Camill,23,0,30,7
1650353820367,ECE 180,B00,083141,Abi Samra; Nicholas Camill,5,0,30,25
1650353826393,MATH 10A,A01,083735,Patchell; Gregory David,8,0,30,22
1650353826393,MATH 10A,A02,083736,Patchell; Gregory David,28,0,30,2
1650353826393,MATH 10A,A03,083737,Patchell; Gregory David,25,0,30,5
1650353832423,MATH 10B,A01,083207,Staff,0,7,30,30
1650353832423,MATH 10B,A02,083208,Staff,0,6,30,30
1650353832423,MATH 10B,B01,083739,Staff,17,0,30,13
1650353832423,MATH 10B,B02,083740,Staff,28,0,30,2
1650353838455,MATH 18,A01,083743,Staff,3,0,30,27
1650353838455,MATH 18,A02,083744,Staff,27,0,30,3
1650353838455,MATH 18,A03,083745,Staff,22,0,30,8
1650353838455,MATH 18,A04,083746,Staff,27,0,30,3
1650353838455,MATH 18,B01,083748,Staff,0,11,30,30
1650353838455,MATH 18,B02,083749,Staff,0,11,30,30
1650353838455,MATH 18,B03,083750,Staff,0,11,30,30
1650353838455,MATH 18,B04,083751,Staff,0,9,30,30
1650353844477,MATH 20A,A01,083754,Staff,26,0,40,14
1650353850501,MATH 20B,A01,083756,Staff,0,8,30,30
1650353850501,MATH 20B,A02,083757,Staff,0,8,30,30
1650353856526,MATH 20C,A01,083760,Staff,0,14,30,30
1650353856526,MATH 20C,A02,083761,Staff,0,15,30,30
1650353856526,MATH 20C,B01,083762,Staff,13,0,30,17
1650353856526,MATH 20C,B02,083763,Staff,28,0,30,2
1650353862555,MATH 20D,A01,083765,Staff,0,1,30,30
1650353862555,MATH 20D,A02,083766,Staff,7,0,30,23
1650353862555,MATH 20D,A03,083767,Staff,26,0,30,4
1650353868595,MATH 20E,A01,083771,Staff,5,0,30,25
1650353868595,MATH 20E,A02,083772,Staff,19,0,30,11
1650353868595,MATH 20E,B01,083773,Staff,0,0,30,30
1650353868595,MATH 20E,B02,083774,Staff,12,0,30,18
1650353874630,MATH 103A,A01,083777,Staff,0,11,30,30
1650353874630,MATH 103A,A02,083778,Staff,0,12,30,30
1650353874630,MATH 103A,B01,083779,Staff,0,13,30,30
1650353874630,MATH 103A,B02,083780,Staff,0,11,30,30
1650353880661,MATH 105,A01,085443,Staff,0,21,30,30
1650353886691,MATH 109,A01,083213,Anzaldo; Leesa B,0,6,30,30
1650353886691,MATH 109,A02,083214,Anzaldo; Leesa B,0,7,30,30
1650353886691,MATH 109,B01,083215,Anzaldo; Leesa B,0,5,30,30
1650353886691,MATH 109,B02,083216,Anzaldo; Leesa B,0,5,30,30
1650353892723,MATH 142A,A01,083219,Chow; Bennett,0,14,30,30
1650353892723,MATH 142A,A02,083220,Chow; Bennett,0,12,30,30
1650353892723,MATH 142A,B01,083221,Chow; Bennett,0,12,30,30
1650353892723,MATH 142A,B02,083222,Chow; Bennett,0,12,30,30
1650353898758,MATH 193A,A01,083224,Staff,0,5,30,30
1650353898758,MATH 193A,A02,083225,Staff,0,5,30,30
1650353898758,MATH 193A,A03,083781,Staff,0,4,30,30
1650353898758,MATH 193A,A04,083782,Staff,0,3,30,30
1650353904785,MATH 197,001,091859,McAuley; Julian John,9998,0,9999,1
1650353910851,COGS 9,A01,083615,Staff,0,14,60,60
1650353916876,COGS 11,A01,083617,Boyle; Mary E. T.,22,0,40,18
1650353922904,COGS 13,A01,083071,Staff,0,32,40,40
1650353928941,COGS 14A,A01,092681,Staff,0,20,100,100
1650353934965,COGS 14B,A01,083073,Cheng; Tzu-Han,0,10,50,50
1650353940991,COGS 17,A01,092677,Staff,24,0,75,51
1650353947016,COGS 100,A01,083619,Staff,0,24,60,60
1650353953042,COGS 101A,A01,083621,Davis; Joshua Daniel,0,21,60,60
1650353959067,COGS 101B,A01,091572,Staff,0,0,60,60
1650353965097,COGS 101C,A01,083625,Delgado; Tania,17,0,30,13
1650353971125,COGS 107A,A01,083627,Boyle; Mary E. T.,0,9,60,60
1650353977149,COGS 118A,A01,083075,Staff,4,0,60,56
1650353983176,CSE 3,A50,083646,Miranda; Gregory Joseph,21,0,38,17
1650353983176,CSE 3,A51,083647,Miranda; Gregory Joseph,37,0,37,0
1650353989198,CSE 8A,A50,083650,Miranda; Gregory Joseph,0,28,40,40
1650353995224,CSE 11,A01,083080,Cao; Yingjun,0,88,40,40
1650354001252,CSE 12,A01,083652,Staff,0,12,100,100
1650354007281,CSE 15L,A01,083654,Staff,0,1,50,50
1650354007281,CSE 15L,A02,083655,Staff,3,0,50,47
1650354013305,CSE 20,A01,083657,Staff,52,0,80,28
1650354019346,CSE 30,A01,083084,Eldon; John,0,76,40,40
1650354025372,CSE 100,A01,083659,Cao; Yingjun,0,66,50,50
1650354031395,CSE 134B,A01,083661,Powell; Thomas Allan,0,31,65,65
1650354037420,CSE 140,A01,083663,Staff,0,0,75,75
1650354043444,CSE 140L,A01,083088,Eldon; John,0,7,75,75
1650354049484,CSE 175,A01,083665,Kumar; Rakesh,8,0,25,17
1650354055511,CSE 190,A00,092507,Dubnov; Shlomo,14,0,20,6
1650354061535,ECE 45,A01,083139,Staff,0,17,40,40
1650354067563,ECE 65,A50,083695,Staff,0,5,30,30
1650354073592,ECE 109,A01,091882,Touri; Behrouz,40,0,70,30
1650354079617,ECE 180,A00,083140,Abi Samra; Nicholas Camill,23,0,30,7
1650354079617,ECE 180,B00,083141,Abi Samra; Nicholas Camill,5,0,30,25
1650354085641,MATH 10A,A01,083735,Patchell; Gregory David,7,0,30,23
1650354085641,MATH 10A,A02,083736,Patchell; Gregory David,28,0,30,2
1650354085641,MATH 10A,A03,083737,Patchell; Gregory David,25,0,30,5
1650354091679,MATH 10B,A01,083207,Staff,0,7,30,30
1650354091679,MATH 10B,A02,083208,Staff,0,6,30,30
1650354091679,MATH 10B,B01,083739,Staff,17,0,30,13
1650354091679,MATH 10B,B02,083740,Staff,28,0,30,2
1650354097717,MATH 18,A01,083743,Staff,3,0,30,27
1650354097717,MATH 18,A02,083744,Staff,27,0,30,3
1650354097717,MATH 18,A03,083745,Staff,22,0,30,8
1650354097717,MATH 18,A04,083746,Staff,27,0,30,3
1650354097717,MATH 18,B01,083748,Staff,0,11,30,30
1650354097717,MATH 18,B02,083749,Staff,0,11,30,30
1650354097717,MATH 18,B03,083750,Staff,0,11,30,30
1650354097717,MATH 18,B04,083751,Staff,0,9,30,30
1650354103741,MATH 20A,A01,083754,Staff,26,0,40,14
1650354109780,MATH 20B,A01,083756,Staff,0,8,30,30
1650354109780,MATH 20B,A02,083757,Staff,0,8,30,30
1650354115805,MATH 20C,A01,083760,Staff,0,14,30,30
1650354115805,MATH 20C,A02,083761,Staff,0,15,30,30
1650354115805,MATH 20C,B01,083762,Staff,13,0,30,17
1650354115805,MATH 20C,B02,083763,Staff,28,0,30,2
1650354121832,MATH 20D,A01,083765,Staff,0,1,30,30
1650354121832,MATH 20D,A02,083766,Staff,7,0,30,23
1650354121832,MATH 20D,A03,083767,Staff,26,0,30,4
1650354127857,MATH 20E,A01,083771,Staff,5,0,30,25
1650354127857,MATH 20E,A02,083772,Staff,19,0,30,11
1650354127857,MATH 20E,B01,083773,Staff,0,0,30,30
1650354127857,MATH 20E,B02,083774,Staff,12,0,30,18
1650354133889,MATH 103A,A01,083777,Staff,0,11,30,30
1650354133889,MATH 103A,A02,083778,Staff,0,12,30,30
1650354133889,MATH 103A,B01,083779,Staff,0,13,30,30
1650354133889,MATH 103A,B02,083780,Staff,0,11,30,30
1650354139912,MATH 105,A01,085443,Staff,0,21,30,30
1650354145940,MATH 109,A01,083213,Anzaldo; Leesa B,0,6,30,30
1650354145940,MATH 109,A02,083214,Anzaldo; Leesa B,0,7,30,30
1650354145940,MATH 109,B01,083215,Anzaldo; Leesa B,0,5,30,30
1650354145940,MATH 109,B02,083216,Anzaldo; Leesa B,0,5,30,30
1650354151963,MATH 142A,A01,083219,Chow; Bennett,0,14,30,30
1650354151963,MATH 142A,A02,083220,Chow; Bennett,0,12,30,30
1650354151963,MATH 142A,B01,083221,Chow; Bennett,0,12,30,30
1650354151963,MATH 142A,B02,083222,Chow; Bennett,0,12,30,30
1650354157992,MATH 193A,A01,083224,Staff,0,5,30,30
1650354157992,MATH 193A,A02,083225,Staff,0,5,30,30
1650354157992,MATH 193A,A03,083781,Staff,0,4,30,30
1650354157992,MATH 193A,A04,083782,Staff,0,3,30,30
1650354164016,MATH 197,001,091859,McAuley; Julian John,9998,0,9999,1
1650354170082,COGS 9,A01,083615,Staff,0,14,60,60
1650354176108,COGS 11,A01,083617,Boyle; Mary E. T.,22,0,40,18
1650354182149,COGS 13,A01,083071,Staff,0,32,40,40
1650354188178,COGS 14A,A01,092681,Staff,0,20,100,100
1650354194201,COGS 14B,A01,083073,Cheng; Tzu-Han,0,10,50,50
1650354200225,COGS 17,A01,092677,Staff,24,0,75,51
1650354206253,COGS 100,A01,083619,Staff,0,24,60,60
1650354212290,COGS 101A,A01,083621,Davis; Joshua Daniel,0,21,60,60
1650354218313,COGS 101B,A01,091572,Staff,0,0,60,60
1650354224346,COGS 101C,A01,083625,Delgado; Tania,17,0,30,13
1650354230382,COGS 107A,A01,083627,Boyle; Mary E. T.,0,9,60,60
1650354236512,COGS 118A,A01,083075,Staff,4,0,60,56
1650354242541,CSE 3,A50,083646,Miranda; Gregory Joseph,21,0,38,17
1650354242541,CSE 3,A51,083647,Miranda; Gregory Joseph,37,0,37,0
1650354248572,CSE 8A,A50,083650,Miranda; Gregory Joseph,0,28,40,40
1650354254602,CSE 11,A01,083080,Cao; Yingjun,0,88,40,40
1650354260634,CSE 12,A01,083652,Staff,0,12,100,100
1650354266659,CSE 15L,A01,083654,Staff,0,1,50,50
1650354266659,CSE 15L,A02,083655,Staff,3,0,50,47
1650354272688,CSE 20,A01,083657,Staff,52,0,80,28
1650354278730,CSE 30,A01,083084,Eldon; John,0,76,40,40
1650354284758,CSE 100,A01,083659,Cao; Yingjun,0,66,50,50
1650354290787,CSE 134B,A01,083661,Powell; Thomas Allan,0,31,65,65
1650354296815,CSE 140,A01,083663,Staff,0,0,75,75
1650354302851,CSE 140L,A01,083088,Eldon; John,0,7,75,75
1650354308876,CSE 175,A01,083665,Kumar; Rakesh,8,0,25,17
1650354314900,CSE 190,A00,092507,Dubnov; Shlomo,14,0,20,6
1650354320929,ECE 45,A01,083139,Staff,0,17,40,40
1650354326960,ECE 65,A50,083695,Staff,0,5,30,30
1650354332990,ECE 109,A01,091882,Touri; Behrouz,40,0,70,30
1650354339020,ECE 180,A00,083140,Abi Samra; Nicholas Camill,23,0,30,7
1650354339020,ECE 180,B00,083141,Abi Samra; Nicholas Camill,5,0,30,25
1650354345059,MATH 10A,A01,083735,Patchell; Gregory David,7,0,30,23
1650354345059,MATH 10A,A02,083736,Patchell; Gregory David,28,0,30,2
1650354345059,MATH 10A,A03,083737,Patchell; Gregory David,25,0,30,5
1650354351083,MATH 10B,A01,083207,Staff,0,7,30,30
1650354351083,MATH 10B,A02,083208,Staff,0,6,30,30
1650354351083,MATH 10B,B01,083739,Staff,17,0,30,13
1650354351083,MATH 10B,B02,083740,Staff,28,0,30,2
1650354357112,MATH 18,A01,083743,Staff,3,0,30,27
1650354357112,MATH 18,A02,083744,Staff,27,0,30,3
1650354357112,MATH 18,A03,083745,Staff,22,0,30,8
1650354357112,MATH 18,A04,083746,Staff,27,0,30,3
1650354357112,MATH 18,B01,083748,Staff,0,11,30,30
1650354357112,MATH 18,B02,083749,Staff,0,11,30,30
1650354357112,MATH 18,B03,083750,Staff,0,11,30,30
1650354357112,MATH 18,B04,083751,Staff,0,9,30,30
1650354363136,MATH 20A,A01,083754,Staff,26,0,40,14
1650354369162,MATH 20B,A01,083756,Staff,0,8,30,30
1650354369162,MATH 20B,A02,083757,Staff,0,8,30,30
1650354375190,MATH 20C,A01,083760,Staff,0,14,30,30
1650354375190,MATH 20C,A02,083761,Staff,0,15,30,30
1650354375190,MATH 20C,B01,083762,Staff,13,0,30,17
1650354375190,MATH 20C,B02,083763,Staff,28,0,30,2
1650354381218,MATH 20D,A01,083765,Staff,0,1,30,30
1650354381218,MATH 20D,A02,083766,Staff,7,0,30,23
1650354381218,MATH 20D,A03,083767,Staff,26,0,30,4
1650354387247,MATH 20E,A01,083771,Staff,5,0,30,25
1650354387247,MATH 20E,A02,083772,Staff,19,0,30,11
1650354387247,MATH 20E,B01,083773,Staff,0,0,30,30
1650354387247,MATH 20E,B02,083774,Staff,12,0,30,18
1650354393279,MATH 103A,A01,083777,Staff,0,11,30,30
1650354393279,MATH 103A,A02,083778,Staff,0,12,30,30
1650354393279,MATH 103A,B01,083779,Staff,0,13,30,30
1650354393279,MATH 103A,B02,083780,Staff,0,11,30,30
1650354399303,MATH 105,A01,085443,Staff,0,21,30,30
1650354405329,MATH 109,A01,083213,Anzaldo; Leesa B,0,6,30,30
1650354405329,MATH 109,A02,083214,Anzaldo; Leesa B,0,7,30,30
1650354405329,MATH 109,B01,083215,Anzaldo; Leesa B,0,5,30,30
1650354405329,MATH 109,B02,083216,Anzaldo; Leesa B,0,5,30,30
1650354411357,MATH 142A,A01,083219,Chow; Bennett,0,14,30,30
1650354411357,MATH 142A,A02,083220,Chow; Bennett,0,12,30,30
1650354411357,MATH 142A,B01,083221,Chow; Bennett,0,12,30,30
1650354411357,MATH 142A,B02,083222,Chow; Bennett,0,12,30,30
1650354417390,MATH 193A,A01,083224,Staff,0,5,30,30
1650354417390,MATH 193A,A02,083225,Staff,0,5,30,30
1650354417390,MATH 193A,A03,083781,Staff,0,4,30,30
1650354417390,MATH 193A,A04,083782,Staff,0,3,30,30
1650354423417,MATH 197,001,091859,McAuley; Julian John,9998,0,9999,1
1650354429490,COGS 9,A01,083615,Staff,0,14,60,60
1650354435518,COGS 11,A01,083617,Boyle; Mary E. T.,22,0,40,18
1650354441544,COGS 13,A01,083071,Staff,0,32,40,40
1650354447569,COGS 14A,A01,092681,Staff,0,20,100,100
1650354453595,COGS 14B,A01,083073,Cheng; Tzu-Han,0,10,50,50
1650354459621,COGS 17,A01,092677,Staff,24,0,75,51
1650354465647,COGS 100,A01,083619,Staff,0,24,60,60
1650354471672,COGS 101A,A01,083621,Davis; Joshua Daniel,0,21,60,60
1650354477698,COGS 101B,A01,091572,Staff,0,0,60,60
1650354483726,COGS 101C,A01,083625,Delgado; Tania,17,0,30,13
1650354489752,COGS 107A,A01,083627,Boyle; Mary E. T.,0,9,60,60
1650354495776,COGS 118A,A01,083075,Staff,4,0,60,56
1650354501806,CSE 3,A50,083646,Miranda; Gregory Joseph,21,0,38,17
1650354501806,CSE 3,A51,083647,Miranda; Gregory Joseph,37,0,37,0
1650354507832,CSE 8A,A50,083650,Miranda; Gregory Joseph,0,28,40,40
1650354513857,CSE 11,A01,083080,Cao; Yingjun,0,88,40,40
1650354519888,CSE 12,A01,083652,Staff,0,12,100,100
1650354525920,CSE 15L,A01,083654,Staff,0,1,50,50
1650354525920,CSE 15L,A02,083655,Staff,3,0,50,47
1650354531951,CSE 20,A01,083657,Staff,52,0,80,28
1650354537977,CSE 30,A01,083084,Eldon; John,0,76,40,40
1650354544005,CSE 100,A01,083659,Cao; Yingjun,0,66,50,50
1650354550033,CSE 134B,A01,083661,Powell; Thomas Allan,0,31,65,65
1650354556058,CSE 140,A01,083663,Staff,0,0,75,75
1650354562086,CSE 140L,A01,083088,Eldon; John,0,7,75,75
1650354568114,CSE 175,A01,083665,Kumar; Rakesh,8,0,25,17
1650354574138,CSE 190,A00,092507,Dubnov; Shlomo,14,0,20,6
1650354580164,ECE 45,A01,083139,Staff,0,17,40,40
1650354586202,ECE 65,A50,083695,Staff,0,5,30,30
1650354592232,ECE 109,A01,091882,Touri; Behrouz,40,0,70,30
1650354598258,ECE 180,A00,083140,Abi Samra; Nicholas Camill,23,0,30,7
1650354598258,ECE 180,B00,083141,Abi Samra; Nicholas Camill,5,0,30,25
1650354604284,MATH 10A,A01,083735,Patchell; Gregory David,7,0,30,23
1650354604284,MATH 10A,A02,083736,Patchell; Gregory David,28,0,30,2
1650354604284,MATH 10A,A03,083737,Patchell; Gregory David,25,0,30,5
1650354610310,MATH 10B,A01,083207,Staff,0,7,30,30
1650354610310,MATH 10B,A02,083208,Staff,0,6,30,30
1650354610310,MATH 10B,B01,083739,Staff,17,0,30,13
1650354610310,MATH 10B,B02,083740,Staff,28,0,30,2
1650354616344,MATH 18,A01,083743,Staff,3,0,30,27
1650354616344,MATH 18,A02,083744,Staff,27,0,30,3
1650354616344,MATH 18,A03,083745,Staff,22,0,30,8
1650354616344,MATH 18,A04,083746,Staff,27,0,30,3
1650354616344,MATH 18,B01,083748,Staff,0,11,30,30
1650354616344,MATH 18,B02,083749,Staff,0,11,30,30
1650354616344,MATH 18,B03,083750,Staff,0,11,30,30
1650354616344,MATH 18,B04,083751,Staff,0,9,30,30
1650354622371,MATH 20A,A01,083754,Staff,26,0,40,14
1650354628400,MATH 20B,A01,083756,Staff,0,8,30,30
1650354628400,MATH 20B,A02,083757,Staff,0,8,30,30
1650354634429,MATH 20C,A01,083760,Staff,0,14,30,30
1650354634429,MATH 20C,A02,083761,Staff,0,15,30,30
1650354634429,MATH 20C,B01,083762,Staff,13,0,30,17
1650354634429,MATH 20C,B02,083763,Staff,28,0,30,2
1650354640453,MATH 20D,A01,083765,Staff,0,1,30,30
1650354640453,MATH 20D,A02,083766,Staff,7,0,30,23
1650354640453,MATH 20D,A03,083767,Staff,26,0,30,4
1650354646477,MATH 20E,A01,083771,Staff,5,0,30,25
1650354646477,MATH 20E,A02,083772,Staff,19,0,30,11
1650354646477,MATH 20E,B01,083773,Staff,0,0,30,30
1650354646477,MATH 20E,B02,083774,Staff,12,0,30,18
1650354652514,MATH 103A,A01,083777,Staff,0,11,30,30
1650354652514,MATH 103A,A02,083778,Staff,0,12,30,30
1650354652514,MATH 103A,B01,083779,Staff,0,13,30,30
1650354652514,MATH 103A,B02,083780,Staff,0,11,30,30
1650354658543,MATH 105,A01,085443,Staff,0,21,30,30
1650354664570,MATH 109,A01,083213,Anzaldo; Leesa B,0,6,30,30
1650354664570,MATH 109,A02,083214,Anzaldo; Leesa B,0,7,30,30
1650354664570,MATH 109,B01,083215,Anzaldo; Leesa B,0,5,30,30
1650354664570,MATH 109,B02,083216,Anzaldo; Leesa B,0,5,30,30
1650354670601,MATH 142A,A01,083219,Chow; Bennett,0,14,30,30
1650354670601,MATH 142A,A02,083220,Chow; Bennett,0,12,30,30
1650354670601,MATH 142A,B01,083221,Chow; Bennett,0,12,30,30
1650354670601,MATH 142A,B02,083222,Chow; Bennett,0,12,30,30
1650354676631,MATH 193A,A01,083224,Staff,0,5,30,30
1650354676631,MATH 193A,A02,083225,Staff,0,5,30,30
1650354676631,MATH 193A,A03,083781,Staff,0,4,30,30
1650354676631,MATH 193A,A04,083782,Staff,0,3,30,30
1650354682658,MATH 197,001,091859,McAuley; Julian John,9998,0,9999,1
1650354688724,COGS 9,A01,083615,Staff,0,14,60,60
1650354694750,COGS 11,A01,083617,Boyle; Mary E. T.,22,0,40,18
1650354700776,COGS 13,A01,083071,Staff,0,32,40,40
1650354706799,COGS 14A,A01,092681,Staff,0,20,100,100
1650354712824,COGS 14B,A01,083073,Cheng; Tzu-Han,0,10,50,50
1650354718852,COGS 17,A01,092677,Staff,24,0,75,51
1650354724878,COGS 100,A01,083619,Staff,0,24,60,60
1650354730903,COGS 101A,A01,083621,Davis; Joshua Daniel,0,21,60,60
1650354736928,COGS 101B,A01,091572,Staff,0,0,60,60
1650354742951,COGS 101C,A01,083625,Delgado; Tania,17,0,30,13
1650354748976,COGS 107A,A01,083627,Boyle; Mary E. T.,0,10,60,60
1650354754998,COGS 118A,A01,083075,Staff,4,0,60,56
1650354761024,CSE 3,A50,083646,Miranda; Gregory Joseph,21,0,38,17
1650354761024,CSE 3,A51,083647,Miranda; Gregory Joseph,37,0,37,0
1650354767053,CSE 8A,A50,083650,Miranda; Gregory Joseph,0,28,40,40
1650354773077,CSE 11,A01,083080,Cao; Yingjun,0,88,40,40
1650354779101,CSE 12,A01,083652,Staff,0,12,100,100
1650354785126,CSE 15L,A01,083654,Staff,0,1,50,50
1650354785126,CSE 15L,A02,083655,Staff,3,0,50,47
1650354791150,CSE 20,A01,083657,Staff,52,0,80,28
1650354797175,CSE 30,A01,083084,Eldon; John,0,76,40,40
1650354803203,CSE 100,A01,083659,Cao; Yingjun,0,66,50,50
1650354809236,CSE 134B,A01,083661,Powell; Thomas Allan,0,31,65,65
1650354815260,CSE 140,A01,083663,Staff,0,0,75,75
1650354821287,CSE 140L,A01,083088,Eldon; John,0,7,75,75
1650354827317,CSE 175,A01,083665,Kumar; Rakesh,8,0,25,17
1650354833420,CSE 190,A00,092507,Dubnov; Shlomo,14,0,20,6
1650354839444,ECE 45,A01,083139,Staff,0,17,40,40
1650354845468,ECE 65,A50,083695,Staff,0,5,30,30
1650354851494,ECE 109,A01,091882,Touri; Behrouz,40,0,70,30
1650354857519,ECE 180,A00,083140,Abi Samra; Nicholas Camill,23,0,30,7
1650354857519,ECE 180,B00,083141,Abi Samra; Nicholas Camill,5,0,30,25
1650354863553,MATH 10A,A01,083735,Patchell; Gregory David,7,0,30,23
1650354863553,MATH 10A,A02,083736,Patchell; Gregory David,28,0,30,2
1650354863553,MATH 10A,A03,083737,Patchell; Gregory David,25,0,30,5
1650354869584,MATH 10B,A01,083207,Staff,0,7,30,30
1650354869584,MATH 10B,A02,083208,Staff,0,6,30,30
1650354869584,MATH 10B,B01,083739,Staff,17,0,30,13
1650354869584,MATH 10B,B02,083740,Staff,28,0,30,2
1650354875619,MATH 18,A01,083743,Staff,3,0,30,27
1650354875619,MATH 18,A02,083744,Staff,27,0,30,3
1650354875619,MATH 18,A03,083745,Staff,22,0,30,8
1650354875619,MATH 18,A04,083746,Staff,27,0,30,3
1650354875619,MATH 18,B01,083748,Staff,0,11,30,30
1650354875619,MATH 18,B02,083749,Staff,0,11,30,30
1650354875619,MATH 18,B03,083750,Staff,0,11,30,30
1650354875619,MATH 18,B04,083751,Staff,0,9,30,30
1650354881647,MATH 20A,A01,083754,Staff,26,0,40,14
1650354887675,MATH 20B,A01,083756,Staff,0,8,30,30
1650354887675,MATH 20B,A02,083757,Staff,0,8,30,30
1650354893699,MATH 20C,A01,083760,Staff,0,14,30,30
1650354893699,MATH 20C,A02,083761,Staff,0,15,30,30
1650354893699,MATH 20C,B01,083762,Staff,13,0,30,17
1650354893699,MATH 20C,B02,083763,Staff,28,0,30,2
1650354899728,MATH 20D,A01,083765,Staff,0,1,30,30
1650354899728,MATH 20D,A02,083766,Staff,7,0,30,23
1650354899728,MATH 20D,A03,083767,Staff,26,0,30,4
1650354905758,MATH 20E,A01,083771,Staff,5,0,30,25
1650354905758,MATH 20E,A02,083772,Staff,19,0,30,11
1650354905758,MATH 20E,B01,083773,Staff,0,0,30,30
1650354905758,MATH 20E,B02,083774,Staff,12,0,30,18
1650354911787,MATH 103A,A01,083777,Staff,0,11,30,30
1650354911787,MATH 103A,A02,083778,Staff,0,12,30,30
1650354911787,MATH 103A,B01,083779,Staff,0,13,30,30
1650354911787,MATH 103A,B02,083780,Staff,0,11,30,30
1650354917814,MATH 105,A01,085443,Staff,0,21,30,30
1650354923839,MATH 109,A01,083213,Anzaldo; Leesa B,0,6,30,30
1650354923839,MATH 109,A02,083214,Anzaldo; Leesa B,0,7,30,30
1650354923839,MATH 109,B01,083215,Anzaldo; Leesa B,0,5,30,30
1650354923839,MATH 109,B02,083216,Anzaldo; Leesa B,0,5,30,30
1650354929863,MATH 142A,A01,083219,Chow; Bennett,0,14,30,30
1650354929863,MATH 142A,A02,083220,Chow; Bennett,0,12,30,30
1650354929863,MATH 142A,B01,083221,Chow; Bennett,0,12,30,30
1650354929863,MATH 142A,B02,083222,Chow; Bennett,0,12,30,30
1650354935892,MATH 193A,A01,083224,Staff,0,5,30,30
1650354935892,MATH 193A,A02,083225,Staff,0,5,30,30
1650354935892,MATH 193A,A03,083781,Staff,0,4,30,30
1650354935892,MATH 193A,A04,083782,Staff,0,3,30,30
1650354941916,MATH 197,001,091859,McAuley; Julian John,9998,0,9999,1
1650354947980,COGS 9,A01,083615,Staff,0,14,60,60
1650354954006,COGS 11,A01,083617,Boyle; Mary E. T.,22,0,40,18
1650354960030,COGS 13,A01,083071,Staff,0,32,40,40
1650354966055,COGS 14A,A01,092681,Staff,0,20,100,100
1650354972081,COGS 14B,A01,083073,Cheng; Tzu-Han,0,10,50,50
1650354978106,COGS 17,A01,092677,Staff,24,0,75,51
1650354984155,COGS 100,A01,083619,Staff,0,24,60,60
1650354990198,COGS 101A,A01,083621,Davis; Joshua Daniel,0,21,60,60
1650354996237,COGS 101B,A01,091572,Staff,0,0,60,60
1650355002266,COGS 101C,A01,083625,Delgado; Tania,17,0,30,13
1650355008296,COGS 107A,A01,083627,Boyle; Mary E. T.,0,10,60,60
1650355014325,COGS 118A,A01,083075,Staff,4,0,60,56
1650355020350,CSE 3,A50,083646,Miranda; Gregory Joseph,21,0,38,17
1650355020350,CSE 3,A51,083647,Miranda; Gregory Joseph,37,0,37,0
1650355026375,CSE 8A,A50,083650,Miranda; Gregory Joseph,0,28,40,40
1650355032399,CSE 11,A01,083080,Cao; Yingjun,0,88,40,40
1650355038427,CSE 12,A01,083652,Staff,0,12,100,100
1650355044452,CSE 15L,A01,083654,Staff,0,1,50,50
1650355044452,CSE 15L,A02,083655,Staff,3,0,50,47
1650355050480,CSE 20,A01,083657,Staff,52,0,80,28
1650355056507,CSE 30,A01,083084,Eldon; John,0,76,40,40
1650355062536,CSE 100,A01,083659,Cao; Yingjun,0,66,50,50
1650355068562,CSE 134B,A01,083661,Powell; Thomas Allan,0,31,65,65
1650355074586,CSE 140,A01,083663,Staff,0,0,75,75
1650355080614,CSE 140L,A01,083088,Eldon; John,0,7,75,75
1650355086639,CSE 175,A01,083665,Kumar; Rakesh,8,0,25,17
1650355092660,CSE 190,A00,092507,Dubnov; Shlomo,14,0,20,6
1650355098693,ECE 45,A01,083139,Staff,0,17,40,40
1650355104720,ECE 65,A50,083695,Staff,0,5,30,30
1650355110744,ECE 109,A01,091882,Touri; Behrouz,40,0,70,30
1650355116771,ECE 180,A00,083140,Abi Samra; Nicholas Camill,23,0,30,7
1650355116771,ECE 180,B00,083141,Abi Samra; Nicholas Camill,5,0,30,25
1650355122796,MATH 10A,A01,083735,Patchell; Gregory David,7,0,30,23
1650355122796,MATH 10A,A02,083736,Patchell; Gregory David,28,0,30,2
1650355122796,MATH 10A,A03,083737,Patchell; Gregory David,25,0,30,5
1650355128821,MATH 10B,A01,083207,Staff,0,7,30,30
1650355128821,MATH 10B,A02,083208,Staff,0,6,30,30
1650355128821,MATH 10B,B01,083739,Staff,17,0,30,13
1650355128821,MATH 10B,B02,083740,Staff,28,0,30,2
1650355134846,MATH 18,A01,083743,Staff,3,0,30,27
1650355134846,MATH 18,A02,083744,Staff,27,0,30,3
1650355134846,MATH 18,A03,083745,Staff,22,0,30,8
1650355134846,MATH 18,A04,083746,Staff,27,0,30,3
1650355134846,MATH 18,B01,083748,Staff,0,11,30,30
1650355134846,MATH 18,B02,083749,Staff,0,11,30,30
1650355134846,MATH 18,B03,083750,Staff,0,11,30,30
1650355134846,MATH 18,B04,083751,Staff,0,9,30,30
1650355140871,MATH 20A,A01,083754,Staff,26,0,40,14
1650355146900,MATH 20B,A01,083756,Staff,0,8,30,30
1650355146900,MATH 20B,A02,083757,Staff,0,8,30,30
1650355152924,MATH 20C,A01,083760,Staff,0,14,30,30
1650355152924,MATH 20C,A02,083761,Staff,0,15,30,30
1650355152924,MATH 20C,B01,083762,Staff,13,0,30,17
1650355152924,MATH 20C,B02,083763,Staff,28,0,30,2
1650355158948,MATH 20D,A01,083765,Staff,0,1,30,30
1650355158948,MATH 20D,A02,083766,Staff,7,0,30,23
1650355158948,MATH 20D,A03,083767,Staff,26,0,30,4
1650355164977,MATH 20E,A01,083771,Staff,5,0,30,25
1650355164977,MATH 20E,A02,083772,Staff,19,0,30,11
1650355164977,MATH 20E,B01,083773,Staff,0,0,30,30
1650355164977,MATH 20E,B02,083774,Staff,12,0,30,18
1650355171010,MATH 103A,A01,083777,Staff,0,11,30,30
1650355171010,MATH 103A,A02,083778,Staff,0,12,30,30
1650355171010,MATH 103A,B01,083779,Staff,0,13,30,30
1650355171010,MATH 103A,B02,083780,Staff,0,11,30,30
1650355177034,MATH 105,A01,085443,Staff,0,21,30,30
1650355183068,MATH 109,A01,083213,Anzaldo; Leesa B,0,6,30,30
1650355183068,MATH 109,A02,083214,Anzaldo; Leesa B,0,7,30,30
1650355183068,MATH 109,B01,083215,Anzaldo; Leesa B,0,5,30,30
1650355183068,MATH 109,B02,083216,Anzaldo; Leesa B,0,5,30,30
1650355189092,MATH 142A,A01,083219,Chow; Bennett,0,14,30,30
1650355189092,MATH 142A,A02,083220,Chow; Bennett,0,12,30,30
1650355189092,MATH 142A,B01,083221,Chow; Bennett,0,12,30,30
1650355189092,MATH 142A,B02,083222,Chow; Bennett,0,12,30,30
1650355195122,MATH 193A,A01,083224,Staff,0,5,30,30
1650355195122,MATH 193A,A02,083225,Staff,0,5,30,30
1650355195122,MATH 193A,A03,083781,Staff,0,4,30,30
1650355195122,MATH 193A,A04,083782,Staff,0,3,30,30
1650355201148,MATH 197,001,091859,McAuley; Julian John,9998,0,9999,1
1650355207214,COGS 9,A01,083615,Staff,0,14,60,60
1650355213241,COGS 11,A01,083617,Boyle; Mary E. T.,22,0,40,18
1650355219276,COGS 13,A01,083071,Staff,0,32,40,40
1650355225303,COGS 14A,A01,092681,Staff,0,20,100,100
1650355231327,COGS 14B,A01,083073,Cheng; Tzu-Han,0,10,50,50
1650355237354,COGS 17,A01,092677,Staff,24,0,75,51
1650355243382,COGS 100,A01,083619,Staff,0,24,60,60
1650355249407,COGS 101A,A01,083621,Davis; Joshua Daniel,0,21,60,60
1650355255433,COGS 101B,A01,091572,Staff,0,0,60,60
1650355261464,COGS 101C,A01,083625,Delgado; Tania,17,0,30,13
1650355267490,COGS 107A,A01,083627,Boyle; Mary E. T.,0,10,60,60
1650355273513,COGS 118A,A01,083075,Staff,4,0,60,56
1650355279541,CSE 3,A50,083646,Miranda; Gregory Joseph,21,0,38,17
1650355279541,CSE 3,A51,083647,Miranda; Gregory Joseph,37,0,37,0
1650355285567,CSE 8A,A50,083650,Miranda; Gregory Joseph,0,28,40,40
1650355291594,CSE 11,A01,083080,Cao; Yingjun,0,88,40,40
1650355297638,CSE 12,A01,083652,Staff,0,12,100,100
1650355303665,CSE 15L,A01,083654,Staff,0,1,50,50
1650355303665,CSE 15L,A02,083655,Staff,3,0,50,47
1650355309688,CSE 20,A01,083657,Staff,52,0,80,28
1650355315715,CSE 30,A01,083084,Eldon; John,0,76,40,40
1650355321744,CSE 100,A01,083659,Cao; Yingjun,0,66,50,50
1650355327798,CSE 134B,A01,083661,Powell; Thomas Allan,0,31,65,65
1650355333821,CSE 140,A01,083663,Staff,0,0,75,75
1650355339846,CSE 140L,A01,083088,Eldon; John,0,7,75,75
1650355345875,CSE 175,A01,083665,Kumar; Rakesh,8,0,25,17
1650355351901,CSE 190,A00,092507,Dubnov; Shlomo,14,0,20,6
1650355357929,ECE 45,A01,083139,Staff,0,17,40,40
1650355363953,ECE 65,A50,083695,Staff,0,5,30,30
1650355369986,ECE 109,A01,091882,Touri; Behrouz,40,0,70,30
1650355376016,ECE 180,A00,083140,Abi Samra; Nicholas Camill,23,0,30,7
1650355376016,ECE 180,B00,083141,Abi Samra; Nicholas Camill,5,0,30,25
1650355382049,MATH 10A,A01,083735,Patchell; Gregory David,7,0,30,23
1650355382049,MATH 10A,A02,083736,Patchell; Gregory David,28,0,30,2
1650355382049,MATH 10A,A03,083737,Patchell; Gregory David,25,0,30,5
1650355388075,MATH 10B,A01,083207,Staff,0,7,30,30
1650355388075,MATH 10B,A02,083208,Staff,0,6,30,30
1650355388075,MATH 10B,B01,083739,Staff,17,0,30,13
1650355388075,MATH 10B,B02,083740,Staff,28,0,30,2
1650355394102,MATH 18,A01,083743,Staff,3,0,30,27
1650355394102,MATH 18,A02,083744,Staff,27,0,30,3
1650355394102,MATH 18,A03,083745,Staff,22,0,30,8
1650355394102,MATH 18,A04,083746,Staff,27,0,30,3
1650355394102,MATH 18,B01,083748,Staff,0,11,30,30
1650355394102,MATH 18,B02,083749,Staff,0,11,30,30
1650355394102,MATH 18,B03,083750,Staff,0,11,30,30
1650355394102,MATH 18,B04,083751,Staff,0,9,30,30
1650355400129,MATH 20A,A01,083754,Staff,26,0,40,14
1650355406153,MATH 20B,A01,083756,Staff,0,8,30,30
1650355406153,MATH 20B,A02,083757,Staff,0,8,30,30
1650355412177,MATH 20C,A01,083760,Staff,0,14,30,30
1650355412177,MATH 20C,A02,083761,Staff,0,15,30,30
1650355412177,MATH 20C,B01,083762,Staff,13,0,30,17
1650355412177,MATH 20C,B02,083763,Staff,28,0,30,2
1650355418200,MATH 20D,A01,083765,Staff,0,1,30,30
1650355418200,MATH 20D,A02,083766,Staff,7,0,30,23
1650355418200,MATH 20D,A03,083767,Staff,26,0,30,4
1650355424227,MATH 20E,A01,083771,Staff,5,0,30,25
1650355424227,MATH 20E,A02,083772,Staff,19,0,30,11
1650355424227,MATH 20E,B01,083773,Staff,0,0,30,30
1650355424227,MATH 20E,B02,083774,Staff,12,0,30,18
1650355430342,MATH 103A,A01,083777,Staff,0,11,30,30
1650355430342,MATH 103A,A02,083778,Staff,0,12,30,30
1650355430342,MATH 103A,B01,083779,Staff,0,13,30,30
1650355430342,MATH 103A,B02,083780,Staff,0,11,30,30
1650355436371,MATH 105,A01,085443,Staff,0,21,30,30
1650355442401,MATH 109,A01,083213,Anzaldo; Leesa B,0,6,30,30
1650355442401,MATH 109,A02,083214,Anzaldo; Leesa B,0,7,30,30
1650355442401,MATH 109,B01,083215,Anzaldo; Leesa B,0,5,30,30
1650355442401,MATH 109,B02,083216,Anzaldo; Leesa B,0,5,30,30
1650355448425,MATH 142A,A01,083219,Chow; Bennett,0,14,30,30
1650355448425,MATH 142A,A02,083220,Chow; Bennett,0,12,30,30
1650355448425,MATH 142A,B01,083221,Chow; Bennett,0,12,30,30
1650355448425,MATH 142A,B02,083222,Chow; Bennett,0,12,30,30
1650355454452,MATH 193A,A01,083224,Staff,0,5,30,30
1650355454452,MATH 193A,A02,083225,Staff,0,5,30,30
1650355454452,MATH 193A,A03,083781,Staff,0,4,30,30
1650355454452,MATH 193A,A04,083782,Staff,0,3,30,30
1650355460476,MATH 197,001,091859,McAuley; Julian John,9998,0,9999,1
1650355466530,COGS 9,A01,083615,Staff,0,14,60,60
1650355472554,COGS 11,A01,083617,Boyle; Mary E. T.,22,0,40,18
1650355478578,COGS 13,A01,083071,Staff,0,32,40,40
1650355484617,COGS 14A,A01,092681,Staff,0,20,100,100
1650355490643,COGS 14B,A01,083073,Cheng; Tzu-Han,0,10,50,50
1650355496668,COGS 17,A01,092677,Staff,23,0,75,52
1650355502693,COGS 100,A01,083619,Staff,0,24,60,60
1650355508722,COGS 101A,A01,083621,Davis; Joshua Daniel,0,21,60,60
1650355514769,COGS 101B,A01,091572,Staff,0,0,60,60
1650355520802,COGS 101C,A01,083625,Delgado; Tania,17,0,30,13
1650355526829,COGS 107A,A01,083627,Boyle; Mary E. T.,0,10,60,60
1650355532855,COGS 118A,A01,083075,Staff,4,0,60,56
1650355538881,CSE 3,A50,083646,Miranda; Gregory Joseph,21,0,38,17
1650355538881,CSE 3,A51,083647,Miranda; Gregory Joseph,37,0,37,0
1650355544909,CSE 8A,A50,083650,Miranda; Gregory Joseph,0,28,40,40
1650355550939,CSE 11,A01,083080,Cao; Yingjun,0,88,40,40
1650355556967,CSE 12,A01,083652,Staff,0,12,100,100
1650355562990,CSE 15L,A01,083654,Staff,0,1,50,50
1650355562990,CSE 15L,A02,083655,Staff,3,0,50,47
1650355569016,CSE 20,A01,083657,Staff,52,0,80,28
1650355575041,CSE 30,A01,083084,Eldon; John,0,76,40,40
1650355581068,CSE 100,A01,083659,Cao; Yingjun,0,66,50,50
1650355587092,CSE 134B,A01,083661,Powell; Thomas Allan,0,31,65,65
1650355593117,CSE 140,A01,083663,Staff,0,0,75,75
1650355599144,CSE 140L,A01,083088,Eldon; John,0,7,75,75
1650355605171,CSE 175,A01,083665,Kumar; Rakesh,8,0,25,17
1650355611196,CSE 190,A00,092507,Dubnov; Shlomo,14,0,20,6
1650355617221,ECE 45,A01,083139,Staff,0,17,40,40
1650355623249,ECE 65,A50,083695,Staff,0,5,30,30
1650355629273,ECE 109,A01,091882,Touri; Behrouz,40,0,70,30
1650355635301,ECE 180,A00,083140,Abi Samra; Nicholas Camill,23,0,30,7
1650355635301,ECE 180,B00,083141,Abi Samra; Nicholas Camill,5,0,30,25
1650355641329,MATH 10A,A01,083735,Patchell; Gregory David,7,0,30,23
1650355641329,MATH 10A,A02,083736,Patchell; Gregory David,28,0,30,2
1650355641329,MATH 10A,A03,083737,Patchell; Gregory David,25,0,30,5
1650355647354,MATH 10B,A01,083207,Staff,0,7,30,30
1650355647354,MATH 10B,A02,083208,Staff,0,6,30,30
1650355647354,MATH 10B,B01,083739,Staff,17,0,30,13
1650355647354,MATH 10B,B02,083740,Staff,28,0,30,2
1650355653382,MATH 18,A01,083743,Staff,3,0,30,27
1650355653382,MATH 18,A02,083744,Staff,27,0,30,3
1650355653382,MATH 18,A03,083745,Staff,22,0,30,8
1650355653382,MATH 18,A04,083746,Staff,27,0,30,3
1650355653382,MATH 18,B01,083748,Staff,0,11,30,30
1650355653382,MATH 18,B02,083749,Staff,0,11,30,30
1650355653382,MATH 18,B03,083750,Staff,0,11,30,30
1650355653382,MATH 18,B04,083751,Staff,0,9,30,30
1650355659404,MATH 20A,A01,083754,Staff,26,0,40,14
1650355665431,MATH 20B,A01,083756,Staff,0,8,30,30
1650355665431,MATH 20B,A02,083757,Staff,0,8,30,30
1650355671456,MATH 20C,A01,083760,Staff,0,14,30,30
1650355671456,MATH 20C,A02,083761,Staff,0,15,30,30
1650355671456,MATH 20C,B01,083762,Staff,13,0,30,17
1650355671456,MATH 20C,B02,083763,Staff,28,0,30,2
1650355677486,MATH 20D,A01,083765,Staff,0,1,30,30
1650355677486,MATH 20D,A02,083766,Staff,7,0,30,23
1650355677486,MATH 20D,A03,083767,Staff,26,0,30,4
1650355683510,MATH 20E,A01,083771,Staff,5,0,30,25
1650355683510,MATH 20E,A02,083772,Staff,19,0,30,11
1650355683510,MATH 20E,B01,083773,Staff,0,0,30,30
1650355683510,MATH 20E,B02,083774,Staff,12,0,30,18
1650355689534,MATH 103A,A01,083777,Staff,0,11,30,30
1650355689534,MATH 103A,A02,083778,Staff,0,12,30,30
1650355689534,MATH 103A,B01,083779,Staff,0,13,30,30
1650355689534,MATH 103A,B02,083780,Staff,0,11,30,30
1650355695560,MATH 105,A01,085443,Staff,0,21,30,30
1650355701584,MATH 109,A01,083213,Anzaldo; Leesa B,0,6,30,30
1650355701584,MATH 109,A02,083214,Anzaldo; Leesa B,0,7,30,30
1650355701584,MATH 109,B01,083215,Anzaldo; Leesa B,0,5,30,30
1650355701584,MATH 109,B02,083216,Anzaldo; Leesa B,0,5,30,30
1650355707609,MATH 142A,A01,083219,Chow; Bennett,0,14,30,30
1650355707609,MATH 142A,A02,083220,Chow; Bennett,0,12,30,30
1650355707609,MATH 142A,B01,083221,Chow; Bennett,0,12,30,30
1650355707609,MATH 142A,B02,083222,Chow; Bennett,0,12,30,30
1650355713639,MATH 193A,A01,083224,Staff,0,5,30,30
1650355713639,MATH 193A,A02,083225,Staff,0,5,30,30
1650355713639,MATH 193A,A03,083781,Staff,0,4,30,30
1650355713639,MATH 193A,A04,083782,Staff,0,3,30,30
1650355719663,MATH 197,001,091859,McAuley; Julian John,9998,0,9999,1
1650355725732,COGS 9,A01,083615,Staff,0,14,60,60
1650355731756,COGS 11,A01,083617,Boyle; Mary E. T.,22,0,40,18
1650355737780,COGS 13,A01,083071,Staff,0,32,40,40
1650355743811,COGS 14A,A01,092681,Staff,0,20,100,100
1650355749836,COGS 14B,A01,083073,Cheng; Tzu-Han,0,10,50,50
1650355755863,COGS 17,A01,092677,Staff,23,0,75,52
1650355761887,COGS 100,A01,083619,Staff,0,24,60,60
1650355767915,COGS 101A,A01,083621,Davis; Joshua Daniel,0,21,60,60
1650355773940,COGS 101B,A01,091572,Staff,0,0,60,60
1650355779969,COGS 101C,A01,083625,Delgado; Tania,17,0,30,13
1650355785993,COGS 107A,A01,083627,Boyle; Mary E. T.,0,10,60,60
1650355792021,COGS 118A,A01,083075,Staff,4,0,60,56
1650355798045,CSE 3,A50,083646,Miranda; Gregory Joseph,21,0,38,17
1650355798045,CSE 3,A51,083647,Miranda; Gregory Joseph,37,0,37,0
1650355804069,CSE 8A,A50,083650,Miranda; Gregory Joseph,0,28,40,40
1650355810092,CSE 11,A01,083080,Cao; Yingjun,0,88,40,40
1650355816118,CSE 12,A01,083652,Staff,0,12,100,100
1650355822142,CSE 15L,A01,083654,Staff,0,1,50,50
1650355822142,CSE 15L,A02,083655,Staff,3,0,50,47
1650355828169,CSE 20,A01,083657,Staff,52,0,80,28
1650355834194,CSE 30,A01,083084,Eldon; John,0,76,40,40
1650355840217,CSE 100,A01,083659,Cao; Yingjun,0,66,50,50
1650355846243,CSE 134B,A01,083661,Powell; Thomas Allan,0,31,65,65
1650355852266,CSE 140,A01,083663,Staff,0,0,75,75
1650355858290,CSE 140L,A01,083088,Eldon; John,0,7,75,75
1650355864314,CSE 175,A01,083665,Kumar; Rakesh,8,0,25,17
1650355870338,CSE 190,A00,092507,Dubnov; Shlomo,14,0,20,6
1650355876363,ECE 45,A01,083139,Staff,0,17,40,40
1650355882392,ECE 65,A50,083695,Staff,0,5,30,30
1650355888421,ECE 109,A01,091882,Touri; Behrouz,40,0,70,30
1650355894445,ECE 180,A00,083140,Abi Samra; Nicholas Camill,23,0,30,7
1650355894445,ECE 180,B00,083141,Abi Samra; Nicholas Camill,5,0,30,25
1650355900471,MATH 10A,A01,083735,Patchell; Gregory David,7,0,30,23
1650355900471,MATH 10A,A02,083736,Patchell; Gregory David,28,0,30,2
1650355900471,MATH 10A,A03,083737,Patchell; Gregory David,25,0,30,5
1650355906500,MATH 10B,A01,083207,Staff,0,7,30,30
1650355906500,MATH 10B,A02,083208,Staff,0,6,30,30
1650355906500,MATH 10B,B01,083739,Staff,17,0,30,13
1650355906500,MATH 10B,B02,083740,Staff,28,0,30,2
1650355912534,MATH 18,A01,083743,Staff,3,0,30,27
1650355912534,MATH 18,A02,083744,Staff,27,0,30,3
1650355912534,MATH 18,A03,083745,Staff,22,0,30,8
1650355912534,MATH 18,A04,083746,Staff,27,0,30,3
1650355912534,MATH 18,B01,083748,Staff,0,11,30,30
1650355912534,MATH 18,B02,083749,Staff,0,11,30,30
1650355912534,MATH 18,B03,083750,Staff,0,11,30,30
1650355912534,MATH 18,B04,083751,Staff,0,9,30,30
1650355918572,MATH 20A,A01,083754,Staff,26,0,40,14
1650355924601,MATH 20B,A01,083756,Staff,0,8,30,30
1650355924601,MATH 20B,A02,083757,Staff,0,8,30,30
1650355930624,MATH 20C,A01,083760,Staff,0,14,30,30
1650355930624,MATH 20C,A02,083761,Staff,0,15,30,30
1650355930624,MATH 20C,B01,083762,Staff,13,0,30,17
1650355930624,MATH 20C,B02,083763,Staff,28,0,30,2
1650355936649,MATH 20D,A01,083765,Staff,0,1,30,30
1650355936649,MATH 20D,A02,083766,Staff,7,0,30,23
1650355936649,MATH 20D,A03,083767,Staff,26,0,30,4
1650355942684,MATH 20E,A01,083771,Staff,5,0,30,25
1650355942684,MATH 20E,A02,083772,Staff,19,0,30,11
1650355942684,MATH 20E,B01,083773,Staff,0,0,30,30
1650355942684,MATH 20E,B02,083774,Staff,12,0,30,18
1650355948718,MATH 103A,A01,083777,Staff,0,11,30,30
1650355948718,MATH 103A,A02,083778,Staff,0,12,30,30
1650355948718,MATH 103A,B01,083779,Staff,0,13,30,30
1650355948718,MATH 103A,B02,083780,Staff,0,11,30,30
1650355954748,MATH 105,A01,085443,Staff,0,21,30,30
1650355960780,MATH 109,A01,083213,Anzaldo; Leesa B,0,6,30,30
1650355960780,MATH 109,A02,083214,Anzaldo; Leesa B,0,7,30,30
1650355960780,MATH 109,B01,083215,Anzaldo; Leesa B,0,5,30,30
1650355960780,MATH 109,B02,083216,Anzaldo; Leesa B,0,5,30,30
1650355966808,MATH 142A,A01,083219,Chow; Bennett,0,14,30,30
1650355966808,MATH 142A,A02,083220,Chow; Bennett,0,12,30,30
1650355966808,MATH 142A,B01,083221,Chow; Bennett,0,12,30,30
1650355966808,MATH 142A,B02,083222,Chow; Bennett,0,12,30,30
1650355972837,MATH 193A,A01,083224,Staff,0,5,30,30
1650355972837,MATH 193A,A02,083225,Staff,0,5,30,30
1650355972837,MATH 193A,A03,083781,Staff,0,4,30,30
1650355972837,MATH 193A,A04,083782,Staff,0,3,30,30
1650355978866,MATH 197,001,091859,McAuley; Julian John,9998,0,9999,1
1650355984937,COGS 9,A01,083615,Staff,0,14,60,60
1650355990970,COGS 11,A01,083617,Boyle; Mary E. T.,22,0,40,18
1650355996995,COGS 13,A01,083071,Staff,0,32,40,40
1650356003024,COGS 14A,A01,092681,Staff,0,21,100,100
1650356009053,COGS 14B,A01,083073,Cheng; Tzu-Han,0,10,50,50
1650356015078,COGS 17,A01,092677,Staff,23,0,75,52
1650356021192,COGS 100,A01,083619,Staff,0,24,60,60
1650356027224,COGS 101A,A01,083621,Davis; Joshua Daniel,0,21,60,60
1650356033253,COGS 101B,A01,091572,Staff,0,0,60,60
1650356039277,COGS 101C,A01,083625,Delgado; Tania,17,0,30,13
1650356045300,COGS 107A,A01,083627,Boyle; Mary E. T.,0,10,60,60
1650356051323,COGS 118A,A01,083075,Staff,4,0,60,56
1650356057360,CSE 3,A50,083646,Miranda; Gregory Joseph,21,0,38,17
1650356057360,CSE 3,A51,083647,Miranda; Gregory Joseph,37,0,37,0
1650356063384,CSE 8A,A50,083650,Miranda; Gregory Joseph,0,28,40,40
1650356069407,CSE 11,A01,083080,Cao; Yingjun,0,88,40,40
1650356075436,CSE 12,A01,083652,Staff,0,12,100,100
1650356081467,CSE 15L,A01,083654,Staff,0,1,50,50
1650356081467,CSE 15L,A02,083655,Staff,3,0,50,47
1650356087492,CSE 20,A01,083657,Staff,52,0,80,28
1650356093521,CSE 30,A01,083084,Eldon; John,0,76,40,40
1650356099553,CSE 100,A01,083659,Cao; Yingjun,0,66,50,50
1650356105580,CSE 134B,A01,083661,Powell; Thomas Allan,0,31,65,65
1650356111603,CSE 140,A01,083663,Staff,0,0,75,75
1650356117628,CSE 140L,A01,083088,Eldon; John,0,7,75,75
1650356123658,CSE 175,A01,083665,Kumar; Rakesh,8,0,25,17
1650356129684,CSE 190,A00,092507,Dubnov; Shlomo,14,0,20,6
1650356135717,ECE 45,A01,083139,Staff,0,17,40,40
1650356141745,ECE 65,A50,083695,Staff,0,5,30,30
1650356147775,ECE 109,A01,091882,Touri; Behrouz,40,0,70,30
1650356153802,ECE 180,A00,083140,Abi Samra; Nicholas Camill,23,0,30,7
1650356153802,ECE 180,B00,083141,Abi Samra; Nicholas Camill,5,0,30,25
1650356159826,MATH 10A,A01,083735,Patchell; Gregory David,7,0,30,23
1650356159826,MATH 10A,A02,083736,Patchell; Gregory David,28,0,30,2
1650356159826,MATH 10A,A03,083737,Patchell; Gregory David,25,0,30,5
1650356165867,MATH 10B,A01,083207,Staff,0,7,30,30
1650356165867,MATH 10B,A02,083208,Staff,0,6,30,30
1650356165867,MATH 10B,B01,083739,Staff,17,0,30,13
1650356165867,MATH 10B,B02,083740,Staff,28,0,30,2
1650356171894,MATH 18,A01,083743,Staff,3,0,30,27
1650356171894,MATH 18,A02,083744,Staff,27,0,30,3
1650356171894,MATH 18,A03,083745,Staff,22,0,30,8
1650356171894,MATH 18,A04,083746,Staff,27,0,30,3
1650356171894,MATH 18,B01,083748,Staff,0,11,30,30
1650356171894,MATH 18,B02,083749,Staff,0,11,30,30
1650356171894,MATH 18,B03,083750,Staff,0,11,30,30
1650356171894,MATH 18,B04,083751,Staff,0,9,30,30
1650356177917,MATH 20A,A01,083754,Staff,26,0,40,14
1650356183945,MATH 20B,A01,083756,Staff,0,8,30,30
1650356183945,MATH 20B,A02,083757,Staff,0,8,30,30
1650356189973,MATH 20C,A01,083760,Staff,0,14,30,30
1650356189973,MATH 20C,A02,083761,Staff,0,15,30,30
1650356189973,MATH 20C,B01,083762,Staff,13,0,30,17
1650356189973,MATH 20C,B02,083763,Staff,28,0,30,2
1650356195999,MATH 20D,A01,083765,Staff,0,1,30,30
1650356195999,MATH 20D,A02,083766,Staff,7,0,30,23
1650356195999,MATH 20D,A03,083767,Staff,26,0,30,4
1650356202028,MATH 20E,A01,083771,Staff,5,0,30,25
1650356202028,MATH 20E,A02,083772,Staff,19,0,30,11
1650356202028,MATH 20E,B01,083773,Staff,0,0,30,30
1650356202028,MATH 20E,B02,083774,Staff,12,0,30,18
1650356208061,MATH 103A,A01,083777,Staff,0,11,30,30
1650356208061,MATH 103A,A02,083778,Staff,0,12,30,30
1650356208061,MATH 103A,B01,083779,Staff,0,13,30,30
1650356208061,MATH 103A,B02,083780,Staff,0,11,30,30
1650356214086,MATH 105,A01,085443,Staff,0,21,30,30
1650356220121,MATH 109,A01,083213,Anzaldo; Leesa B,0,6,30,30
1650356220121,MATH 109,A02,083214,Anzaldo; Leesa B,0,7,30,30
1650356220121,MATH 109,B01,083215,Anzaldo; Leesa B,0,5,30,30
1650356220121,MATH 109,B02,083216,Anzaldo; Leesa B,0,5,30,30
1650356226149,MATH 142A,A01,083219,Chow; Bennett,0,14,30,30
1650356226149,MATH 142A,A02,083220,Chow; Bennett,0,12,30,30
1650356226149,MATH 142A,B01,083221,Chow; Bennett,0,12,30,30
1650356226149,MATH 142A,B02,083222,Chow; Bennett,0,12,30,30
1650356232173,MATH 193A,A01,083224,Staff,0,5,30,30
1650356232173,MATH 193A,A02,083225,Staff,0,5,30,30
1650356232173,MATH 193A,A03,083781,Staff,0,4,30,30
1650356232173,MATH 193A,A04,083782,Staff,0,3,30,30
1650356238200,MATH 197,001,091859,McAuley; Julian John,9998,0,9999,1
1650356244327,COGS 9,A01,083615,Staff,0,14,60,60
1650356250358,COGS 11,A01,083617,Boyle; Mary E. T.,22,0,40,18
1650356256382,COGS 13,A01,083071,Staff,0,32,40,40
1650356262410,COGS 14A,A01,092681,Staff,0,21,100,100
1650356268442,COGS 14B,A01,083073,Cheng; Tzu-Han,0,10,50,50
1650356274482,COGS 17,A01,092677,Staff,23,0,75,52
1650356280518,COGS 100,A01,083619,Staff,0,24,60,60
1650356286555,COGS 101A,A01,083621,Davis; Joshua Daniel,0,21,60,60
1650356292578,COGS 101B,A01,091572,Staff,0,0,60,60
1650356298608,COGS 101C,A01,083625,Delgado; Tania,17,0,30,13
1650356304635,COGS 107A,A01,083627,Boyle; Mary E. T.,0,10,60,60
1650356310662,COGS 118A,A01,083075,Staff,4,0,60,56
1650356316701,CSE 3,A50,083646,Miranda; Gregory Joseph,21,0,38,17
1650356316701,CSE 3,A51,083647,Miranda; Gregory Joseph,37,0,37,0
1650356322727,CSE 8A,A50,083650,Miranda; Gregory Joseph,0,28,40,40
1650356328753,CSE 11,A01,083080,Cao; Yingjun,0,88,40,40
1650356334783,CSE 12,A01,083652,Staff,0,12,100,100
1650356340807,CSE 15L,A01,083654,Staff,0,1,50,50
1650356340807,CSE 15L,A02,083655,Staff,3,0,50,47
1650356346831,CSE 20,A01,083657,Staff,52,0,80,28
1650356352853,CSE 30,A01,083084,Eldon; John,0,76,40,40
1650356358881,CSE 100,A01,083659,Cao; Yingjun,0,66,50,50
1650356364905,CSE 134B,A01,083661,Powell; Thomas Allan,0,31,65,65
1650356370933,CSE 140,A01,083663,Staff,0,0,75,75
1650356376957,CSE 140L,A01,083088,Eldon; John,0,7,75,75
1650356382984,CSE 175,A01,083665,Kumar; Rakesh,8,0,25,17
1650356389007,CSE 190,A00,092507,Dubnov; Shlomo,14,0,20,6
1650356395031,ECE 45,A01,083139,Staff,0,17,40,40
1650356401056,ECE 65,A50,083695,Staff,0,5,30,30
1650356407080,ECE 109,A01,091882,Touri; Behrouz,40,0,70,30
1650356413107,ECE 180,A00,083140,Abi Samra; Nicholas Camill,23,0,30,7
1650356413107,ECE 180,B00,083141,Abi Samra; Nicholas Camill,5,0,30,25
1650356419132,MATH 10A,A01,083735,Patchell; Gregory David,7,0,30,23
1650356419132,MATH 10A,A02,083736,Patchell; Gregory David,28,0,30,2
1650356419132,MATH 10A,A03,083737,Patchell; Gregory David,25,0,30,5
1650356425156,MATH 10B,A01,083207,Staff,0,7,30,30
1650356425156,MATH 10B,A02,083208,Staff,0,6,30,30
1650356425156,MATH 10B,B01,083739,Staff,17,0,30,13
1650356425156,MATH 10B,B02,083740,Staff,28,0,30,2
1650356431186,MATH 18,A01,083743,Staff,3,0,30,27
1650356431186,MATH 18,A02,083744,Staff,27,0,30,3
1650356431186,MATH 18,A03,083745,Staff,22,0,30,8
1650356431186,MATH 18,A04,083746,Staff,27,0,30,3
1650356431186,MATH 18,B01,083748,Staff,0,11,30,30
1650356431186,MATH 18,B02,083749,Staff,0,11,30,30
1650356431186,MATH 18,B03,083750,Staff,0,11,30,30
1650356431186,MATH 18,B04,083751,Staff,0,9,30,30
1650356437210,MATH 20A,A01,083754,Staff,26,0,40,14
1650356443235,MATH 20B,A01,083756,Staff,0,8,30,30
1650356443235,MATH 20B,A02,083757,Staff,0,8,30,30
1650356449259,MATH 20C,A01,083760,Staff,0,14,30,30
1650356449259,MATH 20C,A02,083761,Staff,0,15,30,30
1650356449259,MATH 20C,B01,083762,Staff,13,0,30,17
1650356449259,MATH 20C,B02,083763,Staff,28,0,30,2
1650356455282,MATH 20D,A01,083765,Staff,0,1,30,30
1650356455282,MATH 20D,A02,083766,Staff,7,0,30,23
1650356455282,MATH 20D,A03,083767,Staff,26,0,30,4
1650356461311,MATH 20E,A01,083771,Staff,5,0,30,25
1650356461311,MATH 20E,A02,083772,Staff,19,0,30,11
1650356461311,MATH 20E,B01,083773,Staff,0,0,30,30
1650356461311,MATH 20E,B02,083774,Staff,12,0,30,18
1650356467341,MATH 103A,A01,083777,Staff,0,11,30,30
1650356467341,MATH 103A,A02,083778,Staff,0,12,30,30
1650356467341,MATH 103A,B01,083779,Staff,0,13,30,30
1650356467341,MATH 103A,B02,083780,Staff,0,11,30,30
1650356473366,MATH 105,A01,085443,Staff,0,21,30,30
1650356479391,MATH 109,A01,083213,Anzaldo; Leesa B,0,6,30,30
1650356479391,MATH 109,A02,083214,Anzaldo; Leesa B,0,7,30,30
1650356479391,MATH 109,B01,083215,Anzaldo; Leesa B,0,5,30,30
1650356479391,MATH 109,B02,083216,Anzaldo; Leesa B,0,5,30,30
1650356485417,MATH 142A,A01,083219,Chow; Bennett,0,14,30,30
1650356485417,MATH 142A,A02,083220,Chow; Bennett,0,12,30,30
1650356485417,MATH 142A,B01,083221,Chow; Bennett,0,12,30,30
1650356485417,MATH 142A,B02,083222,Chow; Bennett,0,12,30,30
1650356491442,MATH 193A,A01,083224,Staff,0,5,30,30
1650356491442,MATH 193A,A02,083225,Staff,0,5,30,30
1650356491442,MATH 193A,A03,083781,Staff,0,4,30,30
1650356491442,MATH 193A,A04,083782,Staff,0,3,30,30
1650356497465,MATH 197,001,091859,McAuley; Julian John,9998,0,9999,1
1650356503522,COGS 9,A01,083615,Staff,0,14,60,60
1650356509546,COGS 11,A01,083617,Boyle; Mary E. T.,22,0,40,18
1650356515571,COGS 13,A01,083071,Staff,0,32,40,40
1650356521599,COGS 14A,A01,092681,Staff,0,21,100,100
1650356527629,COGS 14B,A01,083073,Cheng; Tzu-Han,0,10,50,50
1650356533653,COGS 17,A01,092677,Staff,23,0,75,52
1650356539677,COGS 100,A01,083619,Staff,0,24,60,60
1650356545704,COGS 101A,A01,083621,Davis; Joshua Daniel,0,21,60,60
1650356551729,COGS 101B,A01,091572,Staff,0,0,60,60
1650356557758,COGS 101C,A01,083625,Delgado; Tania,17,0,30,13
1650356563781,COGS 107A,A01,083627,Boyle; Mary E. T.,0,10,60,60
1650356569812,COGS 118A,A01,083075,Staff,4,0,60,56
1650356575841,CSE 3,A50,083646,Miranda; Gregory Joseph,21,0,38,17
1650356575841,CSE 3,A51,083647,Miranda; Gregory Joseph,37,0,37,0
1650356581865,CSE 8A,A50,083650,Miranda; Gregory Joseph,0,28,40,40
1650356587889,CSE 11,A01,083080,Cao; Yingjun,0,88,40,40
1650356593914,CSE 12,A01,083652,Staff,0,12,100,100
1650356599938,CSE 15L,A01,083654,Staff,0,1,50,50
1650356599938,CSE 15L,A02,083655,Staff,3,0,50,47
1650356605964,CSE 20,A01,083657,Staff,52,0,80,28
1650356611988,CSE 30,A01,083084,Eldon; John,0,76,40,40
1650356618104,CSE 100,A01,083659,Cao; Yingjun,0,66,50,50
1650356624131,CSE 134B,A01,083661,Powell; Thomas Allan,0,31,65,65
1650356630158,CSE 140,A01,083663,Staff,0,0,75,75
1650356636186,CSE 140L,A01,083088,Eldon; John,0,7,75,75
1650356642214,CSE 175,A01,083665,Kumar; Rakesh,8,0,25,17
1650356648238,CSE 190,A00,092507,Dubnov; Shlomo,14,0,20,6
1650356654267,ECE 45,A01,083139,Staff,0,17,40,40
1650356660295,ECE 65,A50,083695,Staff,0,5,30,30
1650356666326,ECE 109,A01,091882,Touri; Behrouz,40,0,70,30
1650356672359,ECE 180,A00,083140,Abi Samra; Nicholas Camill,23,0,30,7
1650356672359,ECE 180,B00,083141,Abi Samra; Nicholas Camill,5,0,30,25
1650356678384,MATH 10A,A01,083735,Patchell; Gregory David,7,0,30,23
1650356678384,MATH 10A,A02,083736,Patchell; Gregory David,28,0,30,2
1650356678384,MATH 10A,A03,083737,Patchell; Gregory David,25,0,30,5
1650356684407,MATH 10B,A01,083207,Staff,0,7,30,30
1650356684407,MATH 10B,A02,083208,Staff,0,6,30,30
1650356684407,MATH 10B,B01,083739,Staff,17,0,30,13
1650356684407,MATH 10B,B02,083740,Staff,28,0,30,2
1650356690434,MATH 18,A01,083743,Staff,3,0,30,27
1650356690434,MATH 18,A02,083744,Staff,27,0,30,3
1650356690434,MATH 18,A03,083745,Staff,22,0,30,8
1650356690434,MATH 18,A04,083746,Staff,27,0,30,3
1650356690434,MATH 18,B01,083748,Staff,0,11,30,30
1650356690434,MATH 18,B02,083749,Staff,0,11,30,30
1650356690434,MATH 18,B03,083750,Staff,0,11,30,30
1650356690434,MATH 18,B04,083751,Staff,0,9,30,30
1650356696461,MATH 20A,A01,083754,Staff,26,0,40,14
1650356702494,MATH 20B,A01,083756,Staff,0,8,30,30
1650356702494,MATH 20B,A02,083757,Staff,0,8,30,30
1650356708521,MATH 20C,A01,083760,Staff,0,14,30,30
1650356708521,MATH 20C,A02,083761,Staff,0,15,30,30
1650356708521,MATH 20C,B01,083762,Staff,13,0,30,17
1650356708521,MATH 20C,B02,083763,Staff,28,0,30,2
1650356714547,MATH 20D,A01,083765,Staff,0,1,30,30
1650356714547,MATH 20D,A02,083766,Staff,7,0,30,23
1650356714547,MATH 20D,A03,083767,Staff,26,0,30,4
1650356720574,MATH 20E,A01,083771,Staff,5,0,30,25
1650356720574,MATH 20E,A02,083772,Staff,19,0,30,11
1650356720574,MATH 20E,B01,083773,Staff,0,0,30,30
1650356720574,MATH 20E,B02,083774,Staff,12,0,30,18
1650356726604,MATH 103A,A01,083777,Staff,0,11,30,30
1650356726604,MATH 103A,A02,083778,Staff,0,12,30,30
1650356726604,MATH 103A,B01,083779,Staff,0,13,30,30
1650356726604,MATH 103A,B02,083780,Staff,0,11,30,30
1650356732631,MATH 105,A01,085443,Staff,0,21,30,30
1650356738657,MATH 109,A01,083213,Anzaldo; Leesa B,0,6,30,30
1650356738657,MATH 109,A02,083214,Anzaldo; Leesa B,0,7,30,30
1650356738657,MATH 109,B01,083215,Anzaldo; Leesa B,0,5,30,30
1650356738657,MATH 109,B02,083216,Anzaldo; Leesa B,0,5,30,30
1650356744685,MATH 142A,A01,083219,Chow; Bennett,0,14,30,30
1650356744685,MATH 142A,A02,083220,Chow; Bennett,0,12,30,30
1650356744685,MATH 142A,B01,083221,Chow; Bennett,0,12,30,30
1650356744685,MATH 142A,B02,083222,Chow; Bennett,0,12,30,30
1650356750710,MATH 193A,A01,083224,Staff,0,5,30,30
1650356750710,MATH 193A,A02,083225,Staff,0,5,30,30
1650356750710,MATH 193A,A03,083781,Staff,0,4,30,30
1650356750710,MATH 193A,A04,083782,Staff,0,3,30,30
1650356756735,MATH 197,001,091859,McAuley; Julian John,9998,0,9999,1
1650356762791,COGS 9,A01,083615,Staff,0,14,60,60
1650356768820,COGS 11,A01,083617,Boyle; Mary E. T.,22,0,40,18
1650356774849,COGS 13,A01,083071,Staff,0,32,40,40
1650356780874,COGS 14A,A01,092681,Staff,0,21,100,100
1650356786899,COGS 14B,A01,083073,Cheng; Tzu-Han,0,10,50,50
1650356792925,COGS 17,A01,092677,Staff,23,0,75,52
1650356798951,COGS 100,A01,083619,Staff,0,24,60,60
1650356804975,COGS 101A,A01,083621,Davis; Joshua Daniel,0,21,60,60
1650356810999,COGS 101B,A01,091572,Staff,0,0,60,60
1650356817022,COGS 101C,A01,083625,Delgado; Tania,17,0,30,13
1650356823048,COGS 107A,A01,083627,Boyle; Mary E. T.,0,10,60,60
1650356829073,COGS 118A,A01,083075,Staff,4,0,60,56
1650356835102,CSE 3,A50,083646,Miranda; Gregory Joseph,21,0,38,17
1650356835102,CSE 3,A51,083647,Miranda; Gregory Joseph,37,0,37,0
1650356841128,CSE 8A,A50,083650,Miranda; Gregory Joseph,0,28,40,40
1650356847156,CSE 11,A01,083080,Cao; Yingjun,0,88,40,40
1650356853182,CSE 12,A01,083652,Staff,0,12,100,100
1650356859209,CSE 15L,A01,083654,Staff,0,1,50,50
1650356859209,CSE 15L,A02,083655,Staff,3,0,50,47
1650356865232,CSE 20,A01,083657,Staff,52,0,80,28
1650356871257,CSE 30,A01,083084,Eldon; John,0,76,40,40
1650356877280,CSE 100,A01,083659,Cao; Yingjun,0,66,50,50
1650356883304,CSE 134B,A01,083661,Powell; Thomas Allan,0,31,65,65
1650356889328,CSE 140,A01,083663,Staff,0,0,75,75
1650356895353,CSE 140L,A01,083088,Eldon; John,0,7,75,75
1650356901378,CSE 175,A01,083665,Kumar; Rakesh,8,0,25,17
1650356907407,CSE 190,A00,092507,Dubnov; Shlomo,14,0,20,6
1650356913436,ECE 45,A01,083139,Staff,0,17,40,40
1650356919460,ECE 65,A50,083695,Staff,0,5,30,30
1650356925483,ECE 109,A01,091882,Touri; Behrouz,40,0,70,30
1650356931507,ECE 180,A00,083140,Abi Samra; Nicholas Camill,23,0,30,7
1650356931507,ECE 180,B00,083141,Abi Samra; Nicholas Camill,5,0,30,25
1650356937531,MATH 10A,A01,083735,Patchell; Gregory David,7,0,30,23
1650356937531,MATH 10A,A02,083736,Patchell; Gregory David,28,0,30,2
1650356937531,MATH 10A,A03,083737,Patchell; Gregory David,25,0,30,5
1650356943554,MATH 10B,A01,083207,Staff,0,7,30,30
1650356943554,MATH 10B,A02,083208,Staff,0,6,30,30
1650356943554,MATH 10B,B01,083739,Staff,17,0,30,13
1650356943554,MATH 10B,B02,083740,Staff,28,0,30,2
1650356949577,MATH 18,A01,083743,Staff,3,0,30,27
1650356949577,MATH 18,A02,083744,Staff,27,0,30,3
1650356949577,MATH 18,A03,083745,Staff,22,0,30,8
1650356949577,MATH 18,A04,083746,Staff,27,0,30,3
1650356949577,MATH 18,B01,083748,Staff,0,11,30,30
1650356949577,MATH 18,B02,083749,Staff,0,11,30,30
1650356949577,MATH 18,B03,083750,Staff,0,11,30,30
1650356949577,MATH 18,B04,083751,Staff,0,9,30,30
1650356955600,MATH 20A,A01,083754,Staff,26,0,40,14
1650356961623,MATH 20B,A01,083756,Staff,0,8,30,30
1650356961623,MATH 20B,A02,083757,Staff,0,8,30,30
1650356967650,MATH 20C,A01,083760,Staff,0,14,30,30
1650356967650,MATH 20C,A02,083761,Staff,0,15,30,30
1650356967650,MATH 20C,B01,083762,Staff,13,0,30,17
1650356967650,MATH 20C,B02,083763,Staff,28,0,30,2
1650356973673,MATH 20D,A01,083765,Staff,0,1,30,30
1650356973673,MATH 20D,A02,083766,Staff,7,0,30,23
1650356973673,MATH 20D,A03,083767,Staff,26,0,30,4
1650356979698,MATH 20E,A01,083771,Staff,5,0,30,25
1650356979698,MATH 20E,A02,083772,Staff,19,0,30,11
1650356979698,MATH 20E,B01,083773,Staff,0,0,30,30
1650356979698,MATH 20E,B02,083774,Staff,12,0,30,18
1650356985723,MATH 103A,A01,083777,Staff,0,11,30,30
1650356985723,MATH 103A,A02,083778,Staff,0,12,30,30
1650356985723,MATH 103A,B01,083779,Staff,0,13,30,30
1650356985723,MATH 103A,B02,083780,Staff,0,11,30,30
1650356991746,MATH 105,A01,085443,Staff,0,21,30,30
1650356997783,MATH 109,A01,083213,Anzaldo; Leesa B,0,6,30,30
1650356997783,MATH 109,A02,083214,Anzaldo; Leesa B,0,7,30,30
1650356997783,MATH 109,B01,083215,Anzaldo; Leesa B,0,5,30,30
1650356997783,MATH 109,B02,083216,Anzaldo; Leesa B,0,5,30,30
1650357003813,MATH 142A,A01,083219,Chow; Bennett,0,14,30,30
1650357003813,MATH 142A,A02,083220,Chow; Bennett,0,12,30,30
1650357003813,MATH 142A,B01,083221,Chow; Bennett,0,12,30,30
1650357003813,MATH 142A,B02,083222,Chow; Bennett,0,12,30,30
1650357009836,MATH 193A,A01,083224,Staff,0,5,30,30
1650357009836,MATH 193A,A02,083225,Staff,0,5,30,30
1650357009836,MATH 193A,A03,083781,Staff,0,4,30,30
1650357009836,MATH 193A,A04,083782,Staff,0,3,30,30
1650357015863,MATH 197,001,091859,McAuley; Julian John,9998,0,9999,1
1650357021925,COGS 9,A01,083615,Staff,0,14,60,60
1650357027950,COGS 11,A01,083617,Boyle; Mary E. T.,22,0,40,18
1650357033974,COGS 13,A01,083071,Staff,0,32,40,40
1650357040001,COGS 14A,A01,092681,Staff,0,21,100,100
1650357046029,COGS 14B,A01,083073,Cheng; Tzu-Han,0,10,50,50
1650357052058,COGS 17,A01,092677,Staff,23,0,75,52
1650357058091,COGS 100,A01,083619,Staff,0,24,60,60
1650357064117,COGS 101A,A01,083621,Davis; Joshua Daniel,0,21,60,60
1650357070143,COGS 101B,A01,091572,Staff,0,0,60,60
1650357076171,COGS 101C,A01,083625,Delgado; Tania,17,0,30,13
1650357082197,COGS 107A,A01,083627,Boyle; Mary E. T.,0,10,60,60
1650357088226,COGS 118A,A01,083075,Staff,4,0,60,56
1650357094257,CSE 3,A50,083646,Miranda; Gregory Joseph,21,0,38,17
1650357094257,CSE 3,A51,083647,Miranda; Gregory Joseph,37,0,37,0
1650357100281,CSE 8A,A50,083650,Miranda; Gregory Joseph,0,28,40,40
1650357106306,CSE 11,A01,083080,Cao; Yingjun,0,88,40,40
1650357112331,CSE 12,A01,083652,Staff,0,12,100,100
1650357118357,CSE 15L,A01,083654,Staff,0,1,50,50
1650357118357,CSE 15L,A02,083655,Staff,3,0,50,47
1650357124384,CSE 20,A01,083657,Staff,52,0,80,28
1650357130410,CSE 30,A01,083084,Eldon; John,0,76,40,40
1650357136441,CSE 100,A01,083659,Cao; Yingjun,0,66,50,50
1650357142471,CSE 134B,A01,083661,Powell; Thomas Allan,0,31,65,65
1650357148493,CSE 140,A01,083663,Staff,0,0,75,75
1650357154519,CSE 140L,A01,083088,Eldon; John,0,7,75,75
1650357160550,CSE 175,A01,083665,Kumar; Rakesh,8,0,25,17
1650357166575,CSE 190,A00,092507,Dubnov; Shlomo,14,0,20,6
1650357172599,ECE 45,A01,083139,Staff,0,17,40,40
1650357178625,ECE 65,A50,083695,Staff,0,5,30,30
1650357184656,ECE 109,A01,091882,Touri; Behrouz,40,0,70,30
1650357190682,ECE 180,A00,083140,Abi Samra; Nicholas Camill,23,0,30,7
1650357190682,ECE 180,B00,083141,Abi Samra; Nicholas Camill,5,0,30,25
1650357196708,MATH 10A,A01,083735,Patchell; Gregory David,7,0,30,23
1650357196708,MATH 10A,A02,083736,Patchell; Gregory David,28,0,30,2
1650357196708,MATH 10A,A03,083737,Patchell; Gregory David,25,0,30,5
1650357202737,MATH 10B,A01,083207,Staff,0,7,30,30
1650357202737,MATH 10B,A02,083208,Staff,0,6,30,30
1650357202737,MATH 10B,B01,083739,Staff,17,0,30,13
1650357202737,MATH 10B,B02,083740,Staff,28,0,30,2
1650357208763,MATH 18,A01,083743,Staff,3,0,30,27
1650357208763,MATH 18,A02,083744,Staff,27,0,30,3
1650357208763,MATH 18,A03,083745,Staff,22,0,30,8
1650357208763,MATH 18,A04,083746,Staff,27,0,30,3
1650357208763,MATH 18,B01,083748,Staff,0,11,30,30
1650357208763,MATH 18,B02,083749,Staff,0,11,30,30
1650357208763,MATH 18,B03,083750,Staff,0,11,30,30
1650357208763,MATH 18,B04,083751,Staff,0,9,30,30
1650357214878,MATH 20A,A01,083754,Staff,26,0,40,14
1650357220915,MATH 20B,A01,083756,Staff,0,8,30,30
1650357220915,MATH 20B,A02,083757,Staff,0,8,30,30
1650357226942,MATH 20C,A01,083760,Staff,0,14,30,30
1650357226942,MATH 20C,A02,083761,Staff,0,15,30,30
1650357226942,MATH 20C,B01,083762,Staff,13,0,30,17
1650357226942,MATH 20C,B02,083763,Staff,28,0,30,2
1650357232971,MATH 20D,A01,083765,Staff,0,1,30,30
1650357232971,MATH 20D,A02,083766,Staff,7,0,30,23
1650357232971,MATH 20D,A03,083767,Staff,26,0,30,4
1650357238997,MATH 20E,A01,083771,Staff,5,0,30,25
1650357238997,MATH 20E,A02,083772,Staff,19,0,30,11
1650357238997,MATH 20E,B01,083773,Staff,0,0,30,30
1650357238997,MATH 20E,B02,083774,Staff,12,0,30,18
1650357245021,MATH 103A,A01,083777,Staff,0,11,30,30
1650357245021,MATH 103A,A02,083778,Staff,0,12,30,30
1650357245021,MATH 103A,B01,083779,Staff,0,13,30,30
1650357245021,MATH 103A,B02,083780,Staff,0,11,30,30
1650357251044,MATH 105,A01,085443,Staff,0,21,30,30
1650357257069,MATH 109,A01,083213,Anzaldo; Leesa B,0,6,30,30
1650357257069,MATH 109,A02,083214,Anzaldo; Leesa B,0,7,30,30
1650357257069,MATH 109,B01,083215,Anzaldo; Leesa B,0,5,30,30
1650357257069,MATH 109,B02,083216,Anzaldo; Leesa B,0,5,30,30
1650357263094,MATH 142A,A01,083219,Chow; Bennett,0,14,30,30
1650357263094,MATH 142A,A02,083220,Chow; Bennett,0,12,30,30
1650357263094,MATH 142A,B01,083221,Chow; Bennett,0,12,30,30
1650357263094,MATH 142A,B02,083222,Chow; Bennett,0,12,30,30
1650357269118,MATH 193A,A01,083224,Staff,0,5,30,30
1650357269118,MATH 193A,A02,083225,Staff,0,5,30,30
1650357269118,MATH 193A,A03,083781,Staff,0,4,30,30
1650357269118,MATH 193A,A04,083782,Staff,0,3,30,30
1650357275145,MATH 197,001,091859,McAuley; Julian John,9998,0,9999,1
1650357281210,COGS 9,A01,083615,Staff,0,14,60,60
1650357287238,COGS 11,A01,083617,Boyle; Mary E. T.,22,0,40,18
1650357293270,COGS 13,A01,083071,Staff,0,32,40,40
1650357299293,COGS 14A,A01,092681,Staff,0,21,100,100
1650357305329,COGS 14B,A01,083073,Cheng; Tzu-Han,0,10,50,50
1650357311353,COGS 17,A01,092677,Staff,23,0,75,52
1650357317380,COGS 100,A01,083619,Staff,0,24,60,60
1650357323405,COGS 101A,A01,083621,Davis; Joshua Daniel,0,21,60,60
1650357329428,COGS 101B,A01,091572,Staff,0,0,60,60
1650357335457,COGS 101C,A01,083625,Delgado; Tania,17,0,30,13
1650357341481,COGS 107A,A01,083627,Boyle; Mary E. T.,0,10,60,60
1650357347505,COGS 118A,A01,083075,Staff,4,0,60,56
1650357353531,CSE 3,A50,083646,Miranda; Gregory Joseph,21,0,38,17
1650357353531,CSE 3,A51,083647,Miranda; Gregory Joseph,37,0,37,0
1650357359559,CSE 8A,A50,083650,Miranda; Gregory Joseph,0,28,40,40
1650357365583,CSE 11,A01,083080,Cao; Yingjun,0,88,40,40
1650357371611,CSE 12,A01,083652,Staff,0,12,100,100
1650357377639,CSE 15L,A01,083654,Staff,0,1,50,50
1650357377639,CSE 15L,A02,083655,Staff,3,0,50,47
1650357383667,CSE 20,A01,083657,Staff,52,0,80,28
1650357389694,CSE 30,A01,083084,Eldon; John,0,76,40,40
1650357395723,CSE 100,A01,083659,Cao; Yingjun,0,66,50,50
1650357401755,CSE 134B,A01,083661,Powell; Thomas Allan,0,31,65,65
1650357407780,CSE 140,A01,083663,Staff,0,0,75,75
1650357413807,CSE 140L,A01,083088,Eldon; John,0,7,75,75
1650357419834,CSE 175,A01,083665,Kumar; Rakesh,8,0,25,17
1650357425859,CSE 190,A00,092507,Dubnov; Shlomo,14,0,20,6
1650357431883,ECE 45,A01,083139,Staff,0,17,40,40
1650357437911,ECE 65,A50,083695,Staff,0,5,30,30
1650357443937,ECE 109,A01,091882,Touri; Behrouz,40,0,70,30
1650357449967,ECE 180,A00,083140,Abi Samra; Nicholas Camill,23,0,30,7
1650357449967,ECE 180,B00,083141,Abi Samra; Nicholas Camill,5,0,30,25
1650357455989,MATH 10A,A01,083735,Patchell; Gregory David,7,0,30,23
1650357455989,MATH 10A,A02,083736,Patchell; Gregory David,28,0,30,2
1650357455989,MATH 10A,A03,083737,Patchell; Gregory David,25,0,30,5
1650357462018,MATH 10B,A01,083207,Staff,0,7,30,30
1650357462018,MATH 10B,A02,083208,Staff,0,6,30,30
1650357462018,MATH 10B,B01,083739,Staff,17,0,30,13
1650357462018,MATH 10B,B02,083740,Staff,28,0,30,2
1650357468065,MATH 18,A01,083743,Staff,3,0,30,27
1650357468065,MATH 18,A02,083744,Staff,27,0,30,3
1650357468065,MATH 18,A03,083745,Staff,22,0,30,8
1650357468065,MATH 18,A04,083746,Staff,27,0,30,3
1650357468065,MATH 18,B01,083748,Staff,0,11,30,30
1650357468065,MATH 18,B02,083749,Staff,0,11,30,30
1650357468065,MATH 18,B03,083750,Staff,0,11,30,30
1650357468065,MATH 18,B04,083751,Staff,0,9,30,30
1650357474088,MATH 20A,A01,083754,Staff,26,0,40,14
1650357480111,MATH 20B,A01,083756,Staff,0,8,30,30
1650357480111,MATH 20B,A02,083757,Staff,0,8,30,30
1650357486146,MATH 20C,A01,083760,Staff,0,14,30,30
1650357486146,MATH 20C,A02,083761,Staff,0,15,30,30
1650357486146,MATH 20C,B01,083762,Staff,13,0,30,17
1650357486146,MATH 20C,B02,083763,Staff,28,0,30,2
1650357492175,MATH 20D,A01,083765,Staff,0,1,30,30
1650357492175,MATH 20D,A02,083766,Staff,7,0,30,23
1650357492175,MATH 20D,A03,083767,Staff,26,0,30,4
1650357498200,MATH 20E,A01,083771,Staff,5,0,30,25
1650357498200,MATH 20E,A02,083772,Staff,19,0,30,11
1650357498200,MATH 20E,B01,083773,Staff,0,0,30,30
1650357498200,MATH 20E,B02,083774,Staff,12,0,30,18
1650357504224,MATH 103A,A01,083777,Staff,0,11,30,30
1650357504224,MATH 103A,A02,083778,Staff,0,12,30,30
1650357504224,MATH 103A,B01,083779,Staff,0,13,30,30
1650357504224,MATH 103A,B02,083780,Staff,0,11,30,30
1650357510248,MATH 105,A01,085443,Staff,0,21,30,30
1650357516271,MATH 109,A01,083213,Anzaldo; Leesa B,0,6,30,30
1650357516271,MATH 109,A02,083214,Anzaldo; Leesa B,0,7,30,30
1650357516271,MATH 109,B01,083215,Anzaldo; Leesa B,0,5,30,30
1650357516271,MATH 109,B02,083216,Anzaldo; Leesa B,0,5,30,30
1650357522300,MATH 142A,A01,083219,Chow; Bennett,0,14,30,30
1650357522300,MATH 142A,A02,083220,Chow; Bennett,0,12,30,30
1650357522300,MATH 142A,B01,083221,Chow; Bennett,0,12,30,30
1650357522300,MATH 142A,B02,083222,Chow; Bennett,0,12,30,30
1650357528329,MATH 193A,A01,083224,Staff,0,5,30,30
1650357528329,MATH 193A,A02,083225,Staff,0,5,30,30
1650357528329,MATH 193A,A03,083781,Staff,0,4,30,30
1650357528329,MATH 193A,A04,083782,Staff,0,3,30,30
1650357534355,MATH 197,001,091859,McAuley; Julian John,9998,0,9999,1
1650357540421,COGS 9,A01,083615,Staff,0,14,60,60
1650357546451,COGS 11,A01,083617,Boyle; Mary E. T.,22,0,40,18
1650357552475,COGS 13,A01,083071,Staff,0,32,40,40
1650357558498,COGS 14A,A01,092681,Staff,0,21,100,100
1650357564522,COGS 14B,A01,083073,Cheng; Tzu-Han,0,10,50,50
1650357570546,COGS 17,A01,092677,Staff,23,0,75,52
1650357576570,COGS 100,A01,083619,Staff,0,24,60,60
1650357582595,COGS 101A,A01,083621,Davis; Joshua Daniel,0,21,60,60
1650357588617,COGS 101B,A01,091572,Staff,0,0,60,60
1650357594645,COGS 101C,A01,083625,Delgado; Tania,17,0,30,13
1650357600672,COGS 107A,A01,083627,Boyle; Mary E. T.,0,10,60,60
1650357606701,COGS 118A,A01,083075,Staff,4,0,60,56
1650357612726,CSE 3,A50,083646,Miranda; Gregory Joseph,21,0,38,17
1650357612726,CSE 3,A51,083647,Miranda; Gregory Joseph,37,0,37,0
1650357618750,CSE 8A,A50,083650,Miranda; Gregory Joseph,0,28,40,40
1650357624775,CSE 11,A01,083080,Cao; Yingjun,0,88,40,40
1650357630799,CSE 12,A01,083652,Staff,0,12,100,100
1650357636823,CSE 15L,A01,083654,Staff,0,1,50,50
1650357636823,CSE 15L,A02,083655,Staff,3,0,50,47
1650357642848,CSE 20,A01,083657,Staff,52,0,80,28
1650357648876,CSE 30,A01,083084,Eldon; John,0,76,40,40
1650357654901,CSE 100,A01,083659,Cao; Yingjun,0,66,50,50
1650357660930,CSE 134B,A01,083661,Powell; Thomas Allan,0,31,65,65
1650357666953,CSE 140,A01,083663,Staff,0,0,75,75
1650357672982,CSE 140L,A01,083088,Eldon; John,0,7,75,75
1650357679011,CSE 175,A01,083665,Kumar; Rakesh,8,0,25,17
1650357685037,CSE 190,A00,092507,Dubnov; Shlomo,14,0,20,6
1650357691062,ECE 45,A01,083139,Staff,0,17,40,40
1650357697088,ECE 65,A50,083695,Staff,0,5,30,30
1650357703119,ECE 109,A01,091882,Touri; Behrouz,40,0,70,30
1650357709144,ECE 180,A00,083140,Abi Samra; Nicholas Camill,23,0,30,7
1650357709144,ECE 180,B00,083141,Abi Samra; Nicholas Camill,5,0,30,25
1650357715173,MATH 10A,A01,083735,Patchell; Gregory David,7,0,30,23
1650357715173,MATH 10A,A02,083736,Patchell; Gregory David,28,0,30,2
1650357715173,MATH 10A,A03,083737,Patchell; Gregory David,25,0,30,5
1650357721199,MATH 10B,A01,083207,Staff,0,7,30,30
1650357721199,MATH 10B,A02,083208,Staff,0,6,30,30
1650357721199,MATH 10B,B01,083739,Staff,17,0,30,13
1650357721199,MATH 10B,B02,083740,Staff,28,0,30,2
1650357727234,MATH 18,A01,083743,Staff,3,0,30,27
1650357727234,MATH 18,A02,083744,Staff,27,0,30,3
1650357727234,MATH 18,A03,083745,Staff,22,0,30,8
1650357727234,MATH 18,A04,083746,Staff,27,0,30,3
1650357727234,MATH 18,B01,083748,Staff,0,11,30,30
1650357727234,MATH 18,B02,083749,Staff,0,11,30,30
1650357727234,MATH 18,B03,083750,Staff,0,11,30,30
1650357727234,MATH 18,B04,083751,Staff,0,9,30,30
1650357733259,MATH 20A,A01,083754,Staff,26,0,40,14
1650357739283,MATH 20B,A01,083756,Staff,0,8,30,30
1650357739283,MATH 20B,A02,083757,Staff,0,8,30,30
1650357745316,MATH 20C,A01,083760,Staff,0,14,30,30
1650357745316,MATH 20C,A02,083761,Staff,0,15,30,30
1650357745316,MATH 20C,B01,083762,Staff,13,0,30,17
1650357745316,MATH 20C,B02,083763,Staff,28,0,30,2
1650357751344,MATH 20D,A01,083765,Staff,0,1,30,30
1650357751344,MATH 20D,A02,083766,Staff,7,0,30,23
1650357751344,MATH 20D,A03,083767,Staff,26,0,30,4
1650357757372,MATH 20E,A01,083771,Staff,5,0,30,25
1650357757372,MATH 20E,A02,083772,Staff,19,0,30,11
1650357757372,MATH 20E,B01,083773,Staff,0,0,30,30
1650357757372,MATH 20E,B02,083774,Staff,12,0,30,18
1650357763402,MATH 103A,A01,083777,Staff,0,11,30,30
1650357763402,MATH 103A,A02,083778,Staff,0,12,30,30
1650357763402,MATH 103A,B01,083779,Staff,0,13,30,30
1650357763402,MATH 103A,B02,083780,Staff,0,11,30,30
1650357769426,MATH 105,A01,085443,Staff,0,21,30,30
1650357775452,MATH 109,A01,083213,Anzaldo; Leesa B,0,6,30,30
1650357775452,MATH 109,A02,083214,Anzaldo; Leesa B,0,7,30,30
1650357775452,MATH 109,B01,083215,Anzaldo; Leesa B,0,5,30,30
1650357775452,MATH 109,B02,083216,Anzaldo; Leesa B,0,5,30,30
1650357781476,MATH 142A,A01,083219,Chow; Bennett,0,14,30,30
1650357781476,MATH 142A,A02,083220,Chow; Bennett,0,12,30,30
1650357781476,MATH 142A,B01,083221,Chow; Bennett,0,12,30,30
1650357781476,MATH 142A,B02,083222,Chow; Bennett,0,12,30,30
1650357787505,MATH 193A,A01,083224,Staff,0,5,30,30
1650357787505,MATH 193A,A02,083225,Staff,0,5,30,30
1650357787505,MATH 193A,A03,083781,Staff,0,4,30,30
1650357787505,MATH 193A,A04,083782,Staff,0,3,30,30
1650357793531,MATH 197,001,091859,McAuley; Julian John,9998,0,9999,1
1650357799594,COGS 9,A01,083615,Staff,0,14,60,60
1650357805712,COGS 11,A01,083617,Boyle; Mary E. T.,22,0,40,18
1650357811743,COGS 13,A01,083071,Staff,0,32,40,40
1650357817771,COGS 14A,A01,092681,Staff,0,21,100,100
1650357823795,COGS 14B,A01,083073,Cheng; Tzu-Han,0,10,50,50
1650357829821,COGS 17,A01,092677,Staff,23,0,75,52
1650357835845,COGS 100,A01,083619,Staff,0,24,60,60
1650357841869,COGS 101A,A01,083621,Davis; Joshua Daniel,0,21,60,60
1650357847898,COGS 101B,A01,091572,Staff,0,0,60,60
1650357853928,COGS 101C,A01,083625,Delgado; Tania,17,0,30,13
1650357859957,COGS 107A,A01,083627,Boyle; Mary E. T.,0,10,60,60
1650357865982,COGS 118A,A01,083075,Staff,4,0,60,56
1650357872007,CSE 3,A50,083646,Miranda; Gregory Joseph,21,0,38,17
1650357872007,CSE 3,A51,083647,Miranda; Gregory Joseph,37,0,37,0
1650357878036,CSE 8A,A50,083650,Miranda; Gregory Joseph,0,28,40,40
1650357884063,CSE 11,A01,083080,Cao; Yingjun,0,88,40,40
1650357890089,CSE 12,A01,083652,Staff,0,12,100,100
1650357896116,CSE 15L,A01,083654,Staff,0,1,50,50
1650357896116,CSE 15L,A02,083655,Staff,3,0,50,47
1650357902139,CSE 20,A01,083657,Staff,52,0,80,28
1650357908167,CSE 30,A01,083084,Eldon; John,0,76,40,40
1650357914194,CSE 100,A01,083659,Cao; Yingjun,0,66,50,50
1650357920218,CSE 134B,A01,083661,Powell; Thomas Allan,0,31,65,65
1650357926246,CSE 140,A01,083663,Staff,0,0,75,75
1650357932275,CSE 140L,A01,083088,Eldon; John,0,7,75,75
1650357938299,CSE 175,A01,083665,Kumar; Rakesh,8,0,25,17
1650357944327,CSE 190,A00,092507,Dubnov; Shlomo,14,0,20,6
1650357950351,ECE 45,A01,083139,Staff,0,17,40,40
1650357956380,ECE 65,A50,083695,Staff,0,5,30,30
1650357962408,ECE 109,A01,091882,Touri; Behrouz,40,0,70,30
1650357968433,ECE 180,A00,083140,Abi Samra; Nicholas Camill,23,0,30,7
1650357968433,ECE 180,B00,083141,Abi Samra; Nicholas Camill,5,0,30,25
1650357974459,MATH 10A,A01,083735,Patchell; Gregory David,7,0,30,23
1650357974459,MATH 10A,A02,083736,Patchell; Gregory David,28,0,30,2
1650357974459,MATH 10A,A03,083737,Patchell; Gregory David,25,0,30,5
1650357980489,MATH 10B,A01,083207,Staff,0,7,30,30
1650357980489,MATH 10B,A02,083208,Staff,0,6,30,30
1650357980489,MATH 10B,B01,083739,Staff,17,0,30,13
1650357980489,MATH 10B,B02,083740,Staff,28,0,30,2
1650357986514,MATH 18,A01,083743,Staff,3,0,30,27
1650357986514,MATH 18,A02,083744,Staff,27,0,30,3
1650357986514,MATH 18,A03,083745,Staff,22,0,30,8
1650357986514,MATH 18,A04,083746,Staff,27,0,30,3
1650357986514,MATH 18,B01,083748,Staff,0,11,30,30
1650357986514,MATH 18,B02,083749,Staff,0,11,30,30
1650357986514,MATH 18,B03,083750,Staff,0,11,30,30
1650357986514,MATH 18,B04,083751,Staff,0,9,30,30
1650357992542,MATH 20A,A01,083754,Staff,26,0,40,14
1650357998577,MATH 20B,A01,083756,Staff,0,8,30,30
1650357998577,MATH 20B,A02,083757,Staff,0,8,30,30
1650358004602,MATH 20C,A01,083760,Staff,0,14,30,30
1650358004602,MATH 20C,A02,083761,Staff,0,15,30,30
1650358004602,MATH 20C,B01,083762,Staff,13,0,30,17
1650358004602,MATH 20C,B02,083763,Staff,28,0,30,2
1650358010627,MATH 20D,A01,083765,Staff,0,1,30,30
1650358010627,MATH 20D,A02,083766,Staff,7,0,30,23
1650358010627,MATH 20D,A03,083767,Staff,26,0,30,4
1650358016659,MATH 20E,A01,083771,Staff,5,0,30,25
1650358016659,MATH 20E,A02,083772,Staff,19,0,30,11
1650358016659,MATH 20E,B01,083773,Staff,0,0,30,30
1650358016659,MATH 20E,B02,083774,Staff,12,0,30,18
1650358022689,MATH 103A,A01,083777,Staff,0,11,30,30
1650358022689,MATH 103A,A02,083778,Staff,0,12,30,30
1650358022689,MATH 103A,B01,083779,Staff,0,13,30,30
1650358022689,MATH 103A,B02,083780,Staff,0,11,30,30
1650358028716,MATH 105,A01,085443,Staff,0,21,30,30
1650358034746,MATH 109,A01,083213,Anzaldo; Leesa B,0,6,30,30
1650358034746,MATH 109,A02,083214,Anzaldo; Leesa B,0,7,30,30
1650358034746,MATH 109,B01,083215,Anzaldo; Leesa B,0,5,30,30
1650358034746,MATH 109,B02,083216,Anzaldo; Leesa B,0,5,30,30
1650358040772,MATH 142A,A01,083219,Chow; Bennett,0,14,30,30
1650358040772,MATH 142A,A02,083220,Chow; Bennett,0,12,30,30
1650358040772,MATH 142A,B01,083221,Chow; Bennett,0,12,30,30
1650358040772,MATH 142A,B02,083222,Chow; Bennett,0,12,30,30
1650358046798,MATH 193A,A01,083224,Staff,0,5,30,30
1650358046798,MATH 193A,A02,083225,Staff,0,5,30,30
1650358046798,MATH 193A,A03,083781,Staff,0,4,30,30
1650358046798,MATH 193A,A04,083782,Staff,0,3,30,30
1650358052823,MATH 197,001,091859,McAuley; Julian John,9998,0,9999,1
1650358058881,COGS 9,A01,083615,Staff,0,14,60,60
1650358064909,COGS 11,A01,083617,Boyle; Mary E. T.,22,0,40,18
1650358070932,COGS 13,A01,083071,Staff,0,32,40,40
1650358076960,COGS 14A,A01,092681,Staff,0,21,100,100
1650358082989,COGS 14B,A01,083073,Cheng; Tzu-Han,0,10,50,50
1650358089014,COGS 17,A01,092677,Staff,24,0,75,51
1650358095039,COGS 100,A01,083619,Staff,0,24,60,60
1650358101070,COGS 101A,A01,083621,Davis; Joshua Daniel,0,21,60,60
1650358107098,COGS 101B,A01,091572,Staff,0,0,60,60
1650358113125,COGS 101C,A01,083625,Delgado; Tania,17,0,30,13
1650358119150,COGS 107A,A01,083627,Boyle; Mary E. T.,0,10,60,60
1650358125174,COGS 118A,A01,083075,Staff,4,0,60,56
1650358131206,CSE 3,A50,083646,Miranda; Gregory Joseph,21,0,38,17
1650358131206,CSE 3,A51,083647,Miranda; Gregory Joseph,37,0,37,0
1650358137231,CSE 8A,A50,083650,Miranda; Gregory Joseph,0,28,40,40
1650358143256,CSE 11,A01,083080,Cao; Yingjun,0,88,40,40
1650358149279,CSE 12,A01,083652,Staff,0,12,100,100
1650358155303,CSE 15L,A01,083654,Staff,0,1,50,50
1650358155303,CSE 15L,A02,083655,Staff,3,0,50,47
1650358161327,CSE 20,A01,083657,Staff,52,0,80,28
1650358167355,CSE 30,A01,083084,Eldon; John,0,76,40,40
1650358173380,CSE 100,A01,083659,Cao; Yingjun,0,66,50,50
1650358179408,CSE 134B,A01,083661,Powell; Thomas Allan,0,31,65,65
1650358185435,CSE 140,A01,083663,Staff,0,0,75,75
1650358191460,CSE 140L,A01,083088,Eldon; John,0,7,75,75
1650358197489,CSE 175,A01,083665,Kumar; Rakesh,8,0,25,17
1650358203515,CSE 190,A00,092507,Dubnov; Shlomo,14,0,20,6
1650358209539,ECE 45,A01,083139,Staff,0,17,40,40
1650358215565,ECE 65,A50,083695,Staff,0,5,30,30
1650358221591,ECE 109,A01,091882,Touri; Behrouz,40,0,70,30
1650358227614,ECE 180,A00,083140,Abi Samra; Nicholas Camill,23,0,30,7
1650358227614,ECE 180,B00,083141,Abi Samra; Nicholas Camill,5,0,30,25
1650358233640,MATH 10A,A01,083735,Patchell; Gregory David,7,0,30,23
1650358233640,MATH 10A,A02,083736,Patchell; Gregory David,28,0,30,2
1650358233640,MATH 10A,A03,083737,Patchell; Gregory David,25,0,30,5
1650358239668,MATH 10B,A01,083207,Staff,0,7,30,30
1650358239668,MATH 10B,A02,083208,Staff,0,6,30,30
1650358239668,MATH 10B,B01,083739,Staff,17,0,30,13
1650358239668,MATH 10B,B02,083740,Staff,28,0,30,2
1650358245699,MATH 18,A01,083743,Staff,3,0,30,27
1650358245699,MATH 18,A02,083744,Staff,27,0,30,3
1650358245699,MATH 18,A03,083745,Staff,22,0,30,8
1650358245699,MATH 18,A04,083746,Staff,27,0,30,3
1650358245699,MATH 18,B01,083748,Staff,0,11,30,30
1650358245699,MATH 18,B02,083749,Staff,0,11,30,30
1650358245699,MATH 18,B03,083750,Staff,0,11,30,30
1650358245699,MATH 18,B04,083751,Staff,0,9,30,30
1650358251729,MATH 20A,A01,083754,Staff,26,0,40,14
1650358257756,MATH 20B,A01,083756,Staff,0,8,30,30
1650358257756,MATH 20B,A02,083757,Staff,0,8,30,30
1650358263779,MATH 20C,A01,083760,Staff,0,14,30,30
1650358263779,MATH 20C,A02,083761,Staff,0,15,30,30
1650358263779,MATH 20C,B01,083762,Staff,13,0,30,17
1650358263779,MATH 20C,B02,083763,Staff,28,0,30,2
1650358269807,MATH 20D,A01,083765,Staff,0,1,30,30
1650358269807,MATH 20D,A02,083766,Staff,7,0,30,23
1650358269807,MATH 20D,A03,083767,Staff,26,0,30,4
1650358275837,MATH 20E,A01,083771,Staff,5,0,30,25
1650358275837,MATH 20E,A02,083772,Staff,19,0,30,11
1650358275837,MATH 20E,B01,083773,Staff,0,0,30,30
1650358275837,MATH 20E,B02,083774,Staff,12,0,30,18
1650358281860,MATH 103A,A01,083777,Staff,0,11,30,30
1650358281860,MATH 103A,A02,083778,Staff,0,12,30,30
1650358281860,MATH 103A,B01,083779,Staff,0,13,30,30
1650358281860,MATH 103A,B02,083780,Staff,0,11,30,30
1650358287888,MATH 105,A01,085443,Staff,0,21,30,30
1650358293918,MATH 109,A01,083213,Anzaldo; Leesa B,0,6,30,30
1650358293918,MATH 109,A02,083214,Anzaldo; Leesa B,0,7,30,30
1650358293918,MATH 109,B01,083215,Anzaldo; Leesa B,0,5,30,30
1650358293918,MATH 109,B02,083216,Anzaldo; Leesa B,0,5,30,30
1650358299945,MATH 142A,A01,083219,Chow; Bennett,0,14,30,30
1650358299945,MATH 142A,A02,083220,Chow; Bennett,0,12,30,30
1650358299945,MATH 142A,B01,083221,Chow; Bennett,0,12,30,30
1650358299945,MATH 142A,B02,083222,Chow; Bennett,0,12,30,30
1650358305970,MATH 193A,A01,083224,Staff,0,5,30,30
1650358305970,MATH 193A,A02,083225,Staff,0,5,30,30
1650358305970,MATH 193A,A03,083781,Staff,0,4,30,30
1650358305970,MATH 193A,A04,083782,Staff,0,3,30,30
1650358311996,MATH 197,001,091859,McAuley; Julian John,9998,0,9999,1
1650358318065,COGS 9,A01,083615,Staff,0,14,60,60
1650358324090,COGS 11,A01,083617,Boyle; Mary E. T.,22,0,40,18
1650358330114,COGS 13,A01,083071,Staff,0,32,40,40
1650358336140,COGS 14A,A01,092681,Staff,0,21,100,100
1650358342168,COGS 14B,A01,083073,Cheng; Tzu-Han,0,10,50,50
1650358348192,COGS 17,A01,092677,Staff,24,0,75,51
1650358354217,COGS 100,A01,083619,Staff,0,24,60,60
1650358360244,COGS 101A,A01,083621,Davis; Joshua Daniel,0,21,60,60
1650358366269,COGS 101B,A01,091572,Staff,0,0,60,60
1650358372292,COGS 101C,A01,083625,Delgado; Tania,17,0,30,13
1650358378316,COGS 107A,A01,083627,Boyle; Mary E. T.,0,10,60,60
1650358384343,COGS 118A,A01,083075,Staff,4,0,60,56
1650358390370,CSE 3,A50,083646,Miranda; Gregory Joseph,21,0,38,17
1650358390370,CSE 3,A51,083647,Miranda; Gregory Joseph,37,0,37,0
1650358396398,CSE 8A,A50,083650,Miranda; Gregory Joseph,0,28,40,40
1650358402508,CSE 11,A01,083080,Cao; Yingjun,0,88,40,40
1650358408534,CSE 12,A01,083652,Staff,0,12,100,100
1650358414573,CSE 15L,A01,083654,Staff,0,1,50,50
1650358414573,CSE 15L,A02,083655,Staff,3,0,50,47
1650358420603,CSE 20,A01,083657,Staff,52,0,80,28
1650358426627,CSE 30,A01,083084,Eldon; John,0,76,40,40
1650358432655,CSE 100,A01,083659,Cao; Yingjun,0,66,50,50
1650358438677,CSE 134B,A01,083661,Powell; Thomas Allan,0,31,65,65
1650358444701,CSE 140,A01,083663,Staff,0,0,75,75
1650358450738,CSE 140L,A01,083088,Eldon; John,0,7,75,75
1650358456766,CSE 175,A01,083665,Kumar; Rakesh,8,0,25,17
1650358462797,CSE 190,A00,092507,Dubnov; Shlomo,14,0,20,6
1650358468821,ECE 45,A01,083139,Staff,0,17,40,40
1650358474848,ECE 65,A50,083695,Staff,0,5,30,30
1650358480876,ECE 109,A01,091882,Touri; Behrouz,40,0,70,30
1650358486900,ECE 180,A00,083140,Abi Samra; Nicholas Camill,23,0,30,7
1650358486900,ECE 180,B00,083141,Abi Samra; Nicholas Camill,5,0,30,25
1650358492926,MATH 10A,A01,083735,Patchell; Gregory David,7,0,30,23
1650358492926,MATH 10A,A02,083736,Patchell; Gregory David,28,0,30,2
1650358492926,MATH 10A,A03,083737,Patchell; Gregory David,25,0,30,5
1650358498949,MATH 10B,A01,083207,Staff,0,7,30,30
1650358498949,MATH 10B,A02,083208,Staff,0,6,30,30
1650358498949,MATH 10B,B01,083739,Staff,17,0,30,13
1650358498949,MATH 10B,B02,083740,Staff,28,0,30,2
1650358504980,MATH 18,A01,083743,Staff,3,0,30,27
1650358504980,MATH 18,A02,083744,Staff,27,0,30,3
1650358504980,MATH 18,A03,083745,Staff,22,0,30,8
1650358504980,MATH 18,A04,083746,Staff,27,0,30,3
1650358504980,MATH 18,B01,083748,Staff,0,11,30,30
1650358504980,MATH 18,B02,083749,Staff,0,11,30,30
1650358504980,MATH 18,B03,083750,Staff,0,11,30,30
1650358504980,MATH 18,B04,083751,Staff,0,9,30,30
1650358511005,MATH 20A,A01,083754,Staff,26,0,40,14
1650358517029,MATH 20B,A01,083756,Staff,0,8,30,30
1650358517029,MATH 20B,A02,083757,Staff,0,8,30,30
1650358523060,MATH 20C,A01,083760,Staff,0,14,30,30
1650358523060,MATH 20C,A02,083761,Staff,0,15,30,30
1650358523060,MATH 20C,B01,083762,Staff,13,0,30,17
1650358523060,MATH 20C,B02,083763,Staff,28,0,30,2
1650358529088,MATH 20D,A01,083765,Staff,0,1,30,30
1650358529088,MATH 20D,A02,083766,Staff,7,0,30,23
1650358529088,MATH 20D,A03,083767,Staff,26,0,30,4
1650358535120,MATH 20E,A01,083771,Staff,5,0,30,25
1650358535120,MATH 20E,A02,083772,Staff,19,0,30,11
1650358535120,MATH 20E,B01,083773,Staff,0,0,30,30
1650358535120,MATH 20E,B02,083774,Staff,12,0,30,18
1650358541145,MATH 103A,A01,083777,Staff,0,11,30,30
1650358541145,MATH 103A,A02,083778,Staff,0,12,30,30
1650358541145,MATH 103A,B01,083779,Staff,0,13,30,30
1650358541145,MATH 103A,B02,083780,Staff,0,11,30,30
1650358547170,MATH 105,A01,085443,Staff,0,21,30,30
1650358553194,MATH 109,A01,083213,Anzaldo; Leesa B,0,6,30,30
1650358553194,MATH 109,A02,083214,Anzaldo; Leesa B,0,7,30,30
1650358553194,MATH 109,B01,083215,Anzaldo; Leesa B,0,5,30,30
1650358553194,MATH 109,B02,083216,Anzaldo; Leesa B,0,5,30,30
1650358559222,MATH 142A,A01,083219,Chow; Bennett,0,14,30,30
1650358559222,MATH 142A,A02,083220,Chow; Bennett,0,12,30,30
1650358559222,MATH 142A,B01,083221,Chow; Bennett,0,12,30,30
1650358559222,MATH 142A,B02,083222,Chow; Bennett,0,12,30,30
1650358565246,MATH 193A,A01,083224,Staff,0,5,30,30
1650358565246,MATH 193A,A02,083225,Staff,0,5,30,30
1650358565246,MATH 193A,A03,083781,Staff,0,4,30,30
1650358565246,MATH 193A,A04,083782,Staff,0,3,30,30
1650358571271,MATH 197,001,091859,McAuley; Julian John,9998,0,9999,1
1650358577337,COGS 9,A01,083615,Staff,0,14,60,60
1650358583361,COGS 11,A01,083617,Boyle; Mary E. T.,22,0,40,18
1650358589385,COGS 13,A01,083071,Staff,0,32,40,40
1650358595409,COGS 14A,A01,092681,Staff,0,21,100,100
1650358601445,COGS 14B,A01,083073,Cheng; Tzu-Han,0,10,50,50
1650358607469,COGS 17,A01,092677,Staff,24,0,75,51
1650358613493,COGS 100,A01,083619,Staff,0,24,60,60
1650358619518,COGS 101A,A01,083621,Davis; Joshua Daniel,0,21,60,60
1650358625544,COGS 101B,A01,091572,Staff,0,0,60,60
1650358631571,COGS 101C,A01,083625,Delgado; Tania,17,0,30,13
1650358637592,COGS 107A,A01,083627,Boyle; Mary E. T.,0,10,60,60
1650358643614,COGS 118A,A01,083075,Staff,4,0,60,56
1650358649642,CSE 3,A50,083646,Miranda; Gregory Joseph,21,0,38,17
1650358649642,CSE 3,A51,083647,Miranda; Gregory Joseph,37,0,37,0
1650358655671,CSE 8A,A50,083650,Miranda; Gregory Joseph,0,28,40,40
1650358661696,CSE 11,A01,083080,Cao; Yingjun,0,88,40,40
1650358667723,CSE 12,A01,083652,Staff,0,12,100,100
1650358673748,CSE 15L,A01,083654,Staff,0,1,50,50
1650358673748,CSE 15L,A02,083655,Staff,3,0,50,47
1650358679773,CSE 20,A01,083657,Staff,52,0,80,28
1650358685797,CSE 30,A01,083084,Eldon; John,0,76,40,40
1650358691824,CSE 100,A01,083659,Cao; Yingjun,0,66,50,50
1650358697849,CSE 134B,A01,083661,Powell; Thomas Allan,0,31,65,65
1650358703873,CSE 140,A01,083663,Staff,0,0,75,75
1650358709894,CSE 140L,A01,083088,Eldon; John,0,7,75,75
1650358715925,CSE 175,A01,083665,Kumar; Rakesh,8,0,25,17
1650358721948,CSE 190,A00,092507,Dubnov; Shlomo,14,0,20,6
1650358727973,ECE 45,A01,083139,Staff,0,17,40,40
1650358733997,ECE 65,A50,083695,Staff,0,5,30,30
1650358740024,ECE 109,A01,091882,Touri; Behrouz,40,0,70,30
1650358746048,ECE 180,A00,083140,Abi Samra; Nicholas Camill,23,0,30,7
1650358746048,ECE 180,B00,083141,Abi Samra; Nicholas Camill,5,0,30,25
1650358752074,MATH 10A,A01,083735,Patchell; Gregory David,7,0,30,23
1650358752074,MATH 10A,A02,083736,Patchell; Gregory David,28,0,30,2
1650358752074,MATH 10A,A03,083737,Patchell; Gregory David,25,0,30,5
1650358758099,MATH 10B,A01,083207,Staff,0,7,30,30
1650358758099,MATH 10B,A02,083208,Staff,0,6,30,30
1650358758099,MATH 10B,B01,083739,Staff,17,0,30,13
1650358758099,MATH 10B,B02,083740,Staff,28,0,30,2
1650358764125,MATH 18,A01,083743,Staff,3,0,30,27
1650358764125,MATH 18,A02,083744,Staff,27,0,30,3
1650358764125,MATH 18,A03,083745,Staff,22,0,30,8
1650358764125,MATH 18,A04,083746,Staff,27,0,30,3
1650358764125,MATH 18,B01,083748,Staff,0,11,30,30
1650358764125,MATH 18,B02,083749,Staff,0,11,30,30
1650358764125,MATH 18,B03,083750,Staff,0,11,30,30
1650358764125,MATH 18,B04,083751,Staff,0,9,30,30
1650358770150,MATH 20A,A01,083754,Staff,26,0,40,14
1650358776174,MATH 20B,A01,083756,Staff,0,8,30,30
1650358776174,MATH 20B,A02,083757,Staff,0,8,30,30
1650358782198,MATH 20C,A01,083760,Staff,0,14,30,30
1650358782198,MATH 20C,A02,083761,Staff,0,15,30,30
1650358782198,MATH 20C,B01,083762,Staff,13,0,30,17
1650358782198,MATH 20C,B02,083763,Staff,28,0,30,2
1650358788221,MATH 20D,A01,083765,Staff,0,1,30,30
1650358788221,MATH 20D,A02,083766,Staff,7,0,30,23
1650358788221,MATH 20D,A03,083767,Staff,26,0,30,4
1650358794258,MATH 20E,A01,083771,Staff,5,0,30,25
1650358794258,MATH 20E,A02,083772,Staff,19,0,30,11
1650358794258,MATH 20E,B01,083773,Staff,0,0,30,30
1650358794258,MATH 20E,B02,083774,Staff,12,0,30,18
1650358800286,MATH 103A,A01,083777,Staff,0,11,30,30
1650358800286,MATH 103A,A02,083778,Staff,0,12,30,30
1650358800286,MATH 103A,B01,083779,Staff,0,13,30,30
1650358800286,MATH 103A,B02,083780,Staff,0,11,30,30
1650358806313,MATH 105,A01,085443,Staff,0,21,30,30
1650358812337,MATH 109,A01,083213,Anzaldo; Leesa B,0,6,30,30
1650358812337,MATH 109,A02,083214,Anzaldo; Leesa B,0,7,30,30
1650358812337,MATH 109,B01,083215,Anzaldo; Leesa B,0,5,30,30
1650358812337,MATH 109,B02,083216,Anzaldo; Leesa B,0,5,30,30
1650358818365,MATH 142A,A01,083219,Chow; Bennett,0,14,30,30
1650358818365,MATH 142A,A02,083220,Chow; Bennett,0,12,30,30
1650358818365,MATH 142A,B01,083221,Chow; Bennett,0,12,30,30
1650358818365,MATH 142A,B02,083222,Chow; Bennett,0,12,30,30
1650358824403,MATH 193A,A01,083224,Staff,0,5,30,30
1650358824403,MATH 193A,A02,083225,Staff,0,5,30,30
1650358824403,MATH 193A,A03,083781,Staff,0,4,30,30
1650358824403,MATH 193A,A04,083782,Staff,0,3,30,30
1650358830426,MATH 197,001,091859,McAuley; Julian John,9998,0,9999,1
1650358836477,COGS 9,A01,083615,Staff,0,14,60,60
1650358842500,COGS 11,A01,083617,Boyle; Mary E. T.,22,0,40,18
1650358848523,COGS 13,A01,083071,Staff,0,32,40,40
1650358854547,COGS 14A,A01,092681,Staff,0,21,100,100
1650358860574,COGS 14B,A01,083073,Cheng; Tzu-Han,0,10,50,50
1650358866603,COGS 17,A01,092677,Staff,24,0,75,51
1650358872629,COGS 100,A01,083619,Staff,0,24,60,60
1650358878657,COGS 101A,A01,083621,Davis; Joshua Daniel,0,21,60,60
1650358884680,COGS 101B,A01,091572,Staff,0,0,60,60
1650358890703,COGS 101C,A01,083625,Delgado; Tania,17,0,30,13
1650358896728,COGS 107A,A01,083627,Boyle; Mary E. T.,0,10,60,60
1650358902753,COGS 118A,A01,083075,Staff,4,0,60,56
1650358908776,CSE 3,A50,083646,Miranda; Gregory Joseph,21,0,38,17
1650358908776,CSE 3,A51,083647,Miranda; Gregory Joseph,37,0,37,0
1650358914803,CSE 8A,A50,083650,Miranda; Gregory Joseph,0,28,40,40
1650358920828,CSE 11,A01,083080,Cao; Yingjun,0,88,40,40
1650358926856,CSE 12,A01,083652,Staff,0,12,100,100
1650358932879,CSE 15L,A01,083654,Staff,0,1,50,50
1650358932879,CSE 15L,A02,083655,Staff,3,0,50,47
1650358938906,CSE 20,A01,083657,Staff,52,0,80,28
1650358944931,CSE 30,A01,083084,Eldon; John,0,76,40,40
1650358950958,CSE 100,A01,083659,Cao; Yingjun,0,66,50,50
1650358956986,CSE 134B,A01,083661,Powell; Thomas Allan,0,31,65,65
1650358963009,CSE 140,A01,083663,Staff,0,0,75,75
1650358969038,CSE 140L,A01,083088,Eldon; John,0,7,75,75
1650358975065,CSE 175,A01,083665,Kumar; Rakesh,8,0,25,17
1650358981089,CSE 190,A00,092507,Dubnov; Shlomo,14,0,20,6
1650358987113,ECE 45,A01,083139,Staff,0,17,40,40
1650358993140,ECE 65,A50,083695,Staff,0,5,30,30
1650358999266,ECE 109,A01,091882,Touri; Behrouz,40,0,70,30
1650359005289,ECE 180,A00,083140,Abi Samra; Nicholas Camill,23,0,30,7
1650359005289,ECE 180,B00,083141,Abi Samra; Nicholas Camill,5,0,30,25
1650359011317,MATH 10A,A01,083735,Patchell; Gregory David,7,0,30,23
1650359011317,MATH 10A,A02,083736,Patchell; Gregory David,28,0,30,2
1650359011317,MATH 10A,A03,083737,Patchell; Gregory David,25,0,30,5
1650359017340,MATH 10B,A01,083207,Staff,0,7,30,30
1650359017340,MATH 10B,A02,083208,Staff,0,6,30,30
1650359017340,MATH 10B,B01,083739,Staff,17,0,30,13
1650359017340,MATH 10B,B02,083740,Staff,28,0,30,2
1650359023372,MATH 18,A01,083743,Staff,3,0,30,27
1650359023372,MATH 18,A02,083744,Staff,27,0,30,3
1650359023372,MATH 18,A03,083745,Staff,22,0,30,8
1650359023372,MATH 18,A04,083746,Staff,27,0,30,3
1650359023372,MATH 18,B01,083748,Staff,0,11,30,30
1650359023372,MATH 18,B02,083749,Staff,0,11,30,30
1650359023372,MATH 18,B03,083750,Staff,0,11,30,30
1650359023372,MATH 18,B04,083751,Staff,0,9,30,30
1650359029399,MATH 20A,A01,083754,Staff,26,0,40,14
1650359035423,MATH 20B,A01,083756,Staff,0,8,30,30
1650359035423,MATH 20B,A02,083757,Staff,0,8,30,30
1650359041454,MATH 20C,A01,083760,Staff,0,14,30,30
1650359041454,MATH 20C,A02,083761,Staff,0,15,30,30
1650359041454,MATH 20C,B01,083762,Staff,13,0,30,17
1650359041454,MATH 20C,B02,083763,Staff,28,0,30,2
1650359047489,MATH 20D,A01,083765,Staff,0,1,30,30
1650359047489,MATH 20D,A02,083766,Staff,7,0,30,23
1650359047489,MATH 20D,A03,083767,Staff,26,0,30,4
1650359053516,MATH 20E,A01,083771,Staff,5,0,30,25
1650359053516,MATH 20E,A02,083772,Staff,19,0,30,11
1650359053516,MATH 20E,B01,083773,Staff,0,0,30,30
1650359053516,MATH 20E,B02,083774,Staff,12,0,30,18
1650359059543,MATH 103A,A01,083777,Staff,0,11,30,30
1650359059543,MATH 103A,A02,083778,Staff,0,12,30,30
1650359059543,MATH 103A,B01,083779,Staff,0,13,30,30
1650359059543,MATH 103A,B02,083780,Staff,0,11,30,30
1650359065572,MATH 105,A01,085443,Staff,0,21,30,30
1650359071601,MATH 109,A01,083213,Anzaldo; Leesa B,0,6,30,30
1650359071601,MATH 109,A02,083214,Anzaldo; Leesa B,0,7,30,30
1650359071601,MATH 109,B01,083215,Anzaldo; Leesa B,0,5,30,30
1650359071601,MATH 109,B02,083216,Anzaldo; Leesa B,0,5,30,30
1650359077625,MATH 142A,A01,083219,Chow; Bennett,0,14,30,30
1650359077625,MATH 142A,A02,083220,Chow; Bennett,0,12,30,30
1650359077625,MATH 142A,B01,083221,Chow; Bennett,0,12,30,30
1650359077625,MATH 142A,B02,083222,Chow; Bennett,0,12,30,30
1650359083649,MATH 193A,A01,083224,Staff,0,5,30,30
1650359083649,MATH 193A,A02,083225,Staff,0,5,30,30
1650359083649,MATH 193A,A03,083781,Staff,0,4,30,30
1650359083649,MATH 193A,A04,083782,Staff,0,3,30,30
1650359089671,MATH 197,001,091859,McAuley; Julian John,9998,0,9999,1
1650359095736,COGS 9,A01,083615,Staff,0,14,60,60
1650359101760,COGS 11,A01,083617,Boyle; Mary E. T.,22,0,40,18
1650359107783,COGS 13,A01,083071,Staff,0,32,40,40
1650359113809,COGS 14A,A01,092681,Staff,0,21,100,100
1650359119841,COGS 14B,A01,083073,Cheng; Tzu-Han,0,10,50,50
1650359125875,COGS 17,A01,092677,Staff,24,0,75,51
1650359131906,COGS 100,A01,083619,Staff,0,24,60,60
1650359137934,COGS 101A,A01,083621,Davis; Joshua Daniel,0,21,60,60
1650359143958,COGS 101B,A01,091572,Staff,0,0,60,60
1650359149982,COGS 101C,A01,083625,Delgado; Tania,17,0,30,13
1650359156007,COGS 107A,A01,083627,Boyle; Mary E. T.,0,10,60,60
1650359162032,COGS 118A,A01,083075,Staff,4,0,60,56
1650359168055,CSE 3,A50,083646,Miranda; Gregory Joseph,21,0,38,17
1650359168055,CSE 3,A51,083647,Miranda; Gregory Joseph,37,0,37,0
1650359174082,CSE 8A,A50,083650,Miranda; Gregory Joseph,0,28,40,40
1650359180106,CSE 11,A01,083080,Cao; Yingjun,0,88,40,40
1650359186130,CSE 12,A01,083652,Staff,0,12,100,100
1650359192166,CSE 15L,A01,083654,Staff,0,1,50,50
1650359192166,CSE 15L,A02,083655,Staff,3,0,50,47
1650359198189,CSE 20,A01,083657,Staff,52,0,80,28
1650359204213,CSE 30,A01,083084,Eldon; John,0,76,40,40
1650359210240,CSE 100,A01,083659,Cao; Yingjun,0,66,50,50
1650359216265,CSE 134B,A01,083661,Powell; Thomas Allan,0,31,65,65
1650359222301,CSE 140,A01,083663,Staff,0,0,75,75
1650359228335,CSE 140L,A01,083088,Eldon; John,0,7,75,75
1650359234360,CSE 175,A01,083665,Kumar; Rakesh,8,0,25,17
1650359240390,CSE 190,A00,092507,Dubnov; Shlomo,14,0,20,6
1650359246412,ECE 45,A01,083139,Staff,0,17,40,40
1650359252439,ECE 65,A50,083695,Staff,0,5,30,30
1650359258463,ECE 109,A01,091882,Touri; Behrouz,40,0,70,30
1650359264490,ECE 180,A00,083140,Abi Samra; Nicholas Camill,23,0,30,7
1650359264490,ECE 180,B00,083141,Abi Samra; Nicholas Camill,5,0,30,25
1650359270518,MATH 10A,A01,083735,Patchell; Gregory David,7,0,30,23
1650359270518,MATH 10A,A02,083736,Patchell; Gregory David,28,0,30,2
1650359270518,MATH 10A,A03,083737,Patchell; Gregory David,25,0,30,5
1650359276547,MATH 10B,A01,083207,Staff,0,7,30,30
1650359276547,MATH 10B,A02,083208,Staff,0,6,30,30
1650359276547,MATH 10B,B01,083739,Staff,17,0,30,13
1650359276547,MATH 10B,B02,083740,Staff,28,0,30,2
1650359282585,MATH 18,A01,083743,Staff,3,0,30,27
1650359282585,MATH 18,A02,083744,Staff,27,0,30,3
1650359282585,MATH 18,A03,083745,Staff,22,0,30,8
1650359282585,MATH 18,A04,083746,Staff,27,0,30,3
1650359282585,MATH 18,B01,083748,Staff,0,11,30,30
1650359282585,MATH 18,B02,083749,Staff,0,11,30,30
1650359282585,MATH 18,B03,083750,Staff,0,11,30,30
1650359282585,MATH 18,B04,083751,Staff,0,9,30,30
1650359288608,MATH 20A,A01,083754,Staff,26,0,40,14
1650359294635,MATH 20B,A01,083756,Staff,0,8,30,30
1650359294635,MATH 20B,A02,083757,Staff,0,8,30,30
1650359300664,MATH 20C,A01,083760,Staff,0,14,30,30
1650359300664,MATH 20C,A02,083761,Staff,0,15,30,30
1650359300664,MATH 20C,B01,083762,Staff,13,0,30,17
1650359300664,MATH 20C,B02,083763,Staff,28,0,30,2
1650359306688,MATH 20D,A01,083765,Staff,0,1,30,30
1650359306688,MATH 20D,A02,083766,Staff,7,0,30,23
1650359306688,MATH 20D,A03,083767,Staff,26,0,30,4
1650359312713,MATH 20E,A01,083771,Staff,5,0,30,25
1650359312713,MATH 20E,A02,083772,Staff,19,0,30,11
1650359312713,MATH 20E,B01,083773,Staff,0,0,30,30
1650359312713,MATH 20E,B02,083774,Staff,12,0,30,18
1650359318742,MATH 103A,A01,083777,Staff,0,11,30,30
1650359318742,MATH 103A,A02,083778,Staff,0,12,30,30
1650359318742,MATH 103A,B01,083779,Staff,0,13,30,30
1650359318742,MATH 103A,B02,083780,Staff,0,11,30,30
1650359324768,MATH 105,A01,085443,Staff,0,21,30,30
1650359330792,MATH 109,A01,083213,Anzaldo; Leesa B,0,6,30,30
1650359330792,MATH 109,A02,083214,Anzaldo; Leesa B,0,7,30,30
1650359330792,MATH 109,B01,083215,Anzaldo; Leesa B,0,5,30,30
1650359330792,MATH 109,B02,083216,Anzaldo; Leesa B,0,5,30,30
1650359336821,MATH 142A,A01,083219,Chow; Bennett,0,14,30,30
1650359336821,MATH 142A,A02,083220,Chow; Bennett,0,12,30,30
1650359336821,MATH 142A,B01,083221,Chow; Bennett,0,12,30,30
1650359336821,MATH 142A,B02,083222,Chow; Bennett,0,12,30,30
1650359342849,MATH 193A,A01,083224,Staff,0,5,30,30
1650359342849,MATH 193A,A02,083225,Staff,0,5,30,30
1650359342849,MATH 193A,A03,083781,Staff,0,4,30,30
1650359342849,MATH 193A,A04,083782,Staff,0,3,30,30
1650359348873,MATH 197,001,091859,McAuley; Julian John,9998,0,9999,1
1650359354930,COGS 9,A01,083615,Staff,0,14,60,60
1650359360963,COGS 11,A01,083617,Boyle; Mary E. T.,22,0,40,18
1650359366989,COGS 13,A01,083071,Staff,0,32,40,40
1650359373015,COGS 14A,A01,092681,Staff,0,21,100,100
1650359379041,COGS 14B,A01,083073,Cheng; Tzu-Han,0,10,50,50
1650359385067,COGS 17,A01,092677,Staff,24,0,75,51
1650359391093,COGS 100,A01,083619,Staff,0,24,60,60
1650359397123,COGS 101A,A01,083621,Davis; Joshua Daniel,0,21,60,60
1650359403150,COGS 101B,A01,091572,Staff,0,0,60,60
1650359409175,COGS 101C,A01,083625,Delgado; Tania,17,0,30,13
1650359415199,COGS 107A,A01,083627,Boyle; Mary E. T.,0,10,60,60
1650359421223,COGS 118A,A01,083075,Staff,4,0,60,56
1650359427246,CSE 3,A50,083646,Miranda; Gregory Joseph,21,0,38,17
1650359427246,CSE 3,A51,083647,Miranda; Gregory Joseph,37,0,37,0
1650359433269,CSE 8A,A50,083650,Miranda; Gregory Joseph,0,28,40,40
1650359439297,CSE 11,A01,083080,Cao; Yingjun,0,88,40,40
1650359445321,CSE 12,A01,083652,Staff,0,12,100,100
1650359451343,CSE 15L,A01,083654,Staff,0,1,50,50
1650359451343,CSE 15L,A02,083655,Staff,3,0,50,47
1650359457367,CSE 20,A01,083657,Staff,52,0,80,28
1650359463394,CSE 30,A01,083084,Eldon; John,0,76,40,40
1650359469417,CSE 100,A01,083659,Cao; Yingjun,0,66,50,50
1650359475440,CSE 134B,A01,083661,Powell; Thomas Allan,0,31,65,65
1650359481464,CSE 140,A01,083663,Staff,0,0,75,75
1650359487492,CSE 140L,A01,083088,Eldon; John,0,7,75,75
1650359493534,CSE 175,A01,083665,Kumar; Rakesh,8,0,25,17
1650359499557,CSE 190,A00,092507,Dubnov; Shlomo,14,0,20,6
1650359505581,ECE 45,A01,083139,Staff,0,17,40,40
1650359511605,ECE 65,A50,083695,Staff,0,5,30,30
1650359517629,ECE 109,A01,091882,Touri; Behrouz,40,0,70,30
1650359523664,ECE 180,A00,083140,Abi Samra; Nicholas Camill,23,0,30,7
1650359523664,ECE 180,B00,083141,Abi Samra; Nicholas Camill,5,0,30,25
1650359529692,MATH 10A,A01,083735,Patchell; Gregory David,7,0,30,23
1650359529692,MATH 10A,A02,083736,Patchell; Gregory David,28,0,30,2
1650359529692,MATH 10A,A03,083737,Patchell; Gregory David,25,0,30,5
1650359535718,MATH 10B,A01,083207,Staff,0,7,30,30
1650359535718,MATH 10B,A02,083208,Staff,0,6,30,30
1650359535718,MATH 10B,B01,083739,Staff,17,0,30,13
1650359535718,MATH 10B,B02,083740,Staff,28,0,30,2
1650359541742,MATH 18,A01,083743,Staff,3,0,30,27
1650359541742,MATH 18,A02,083744,Staff,27,0,30,3
1650359541742,MATH 18,A03,083745,Staff,22,0,30,8
1650359541742,MATH 18,A04,083746,Staff,27,0,30,3
1650359541742,MATH 18,B01,083748,Staff,0,11,30,30
1650359541742,MATH 18,B02,083749,Staff,0,11,30,30
1650359541742,MATH 18,B03,083750,Staff,0,11,30,30
1650359541742,MATH 18,B04,083751,Staff,0,9,30,30
1650359547765,MATH 20A,A01,083754,Staff,26,0,40,14
1650359553790,MATH 20B,A01,083756,Staff,0,8,30,30
1650359553790,MATH 20B,A02,083757,Staff,0,8,30,30
1650359559812,MATH 20C,A01,083760,Staff,0,14,30,30
1650359559812,MATH 20C,A02,083761,Staff,0,15,30,30
1650359559812,MATH 20C,B01,083762,Staff,13,0,30,17
1650359559812,MATH 20C,B02,083763,Staff,28,0,30,2
1650359565840,MATH 20D,A01,083765,Staff,0,1,30,30
1650359565840,MATH 20D,A02,083766,Staff,7,0,30,23
1650359565840,MATH 20D,A03,083767,Staff,26,0,30,4
1650359571864,MATH 20E,A01,083771,Staff,5,0,30,25
1650359571864,MATH 20E,A02,083772,Staff,19,0,30,11
1650359571864,MATH 20E,B01,083773,Staff,0,0,30,30
1650359571864,MATH 20E,B02,083774,Staff,12,0,30,18
1650359577893,MATH 103A,A01,083777,Staff,0,11,30,30
1650359577893,MATH 103A,A02,083778,Staff,0,12,30,30
1650359577893,MATH 103A,B01,083779,Staff,0,13,30,30
1650359577893,MATH 103A,B02,083780,Staff,0,11,30,30
1650359583919,MATH 105,A01,085443,Staff,0,21,30,30
1650359589948,MATH 109,A01,083213,Anzaldo; Leesa B,0,6,30,30
1650359589948,MATH 109,A02,083214,Anzaldo; Leesa B,0,7,30,30
1650359589948,MATH 109,B01,083215,Anzaldo; Leesa B,0,5,30,30
1650359589948,MATH 109,B02,083216,Anzaldo; Leesa B,0,5,30,30
1650359596061,MATH 142A,A01,083219,Chow; Bennett,0,14,30,30
1650359596061,MATH 142A,A02,083220,Chow; Bennett,0,12,30,30
1650359596061,MATH 142A,B01,083221,Chow; Bennett,0,12,30,30
1650359596061,MATH 142A,B02,083222,Chow; Bennett,0,12,30,30
1650359602086,MATH 193A,A01,083224,Staff,0,5,30,30
1650359602086,MATH 193A,A02,083225,Staff,0,5,30,30
1650359602086,MATH 193A,A03,083781,Staff,0,4,30,30
1650359602086,MATH 193A,A04,083782,Staff,0,3,30,30
1650359608113,MATH 197,001,091859,McAuley; Julian John,9998,0,9999,1
1650359614164,COGS 9,A01,083615,Staff,0,14,60,60
1650359620187,COGS 11,A01,083617,Boyle; Mary E. T.,22,0,40,18
1650359626223,COGS 13,A01,083071,Staff,0,32,40,40
1650359632248,COGS 14A,A01,092681,Staff,0,21,100,100
1650359638275,COGS 14B,A01,083073,Cheng; Tzu-Han,0,10,50,50
1650359644300,COGS 17,A01,092677,Staff,24,0,75,51
1650359650326,COGS 100,A01,083619,Staff,0,24,60,60
1650359656352,COGS 101A,A01,083621,Davis; Joshua Daniel,0,21,60,60
1650359662379,COGS 101B,A01,091572,Staff,0,0,60,60
1650359668402,COGS 101C,A01,083625,Delgado; Tania,17,0,30,13
1650359674426,COGS 107A,A01,083627,Boyle; Mary E. T.,0,10,60,60
1650359680448,COGS 118A,A01,083075,Staff,4,0,60,56
1650359686472,CSE 3,A50,083646,Miranda; Gregory Joseph,21,0,38,17
1650359686472,CSE 3,A51,083647,Miranda; Gregory Joseph,37,0,37,0
1650359692501,CSE 8A,A50,083650,Miranda; Gregory Joseph,0,28,40,40
1650359698532,CSE 11,A01,083080,Cao; Yingjun,0,88,40,40
1650359704556,CSE 12,A01,083652,Staff,0,12,100,100
1650359710579,CSE 15L,A01,083654,Staff,0,1,50,50
1650359710579,CSE 15L,A02,083655,Staff,3,0,50,47
1650359716604,CSE 20,A01,083657,Staff,52,0,80,28
1650359722627,CSE 30,A01,083084,Eldon; John,0,76,40,40
1650359728651,CSE 100,A01,083659,Cao; Yingjun,0,66,50,50
1650359734675,CSE 134B,A01,083661,Powell; Thomas Allan,0,31,65,65
1650359740700,CSE 140,A01,083663,Staff,0,0,75,75
1650359746723,CSE 140L,A01,083088,Eldon; John,0,7,75,75
1650359752750,CSE 175,A01,083665,Kumar; Rakesh,8,0,25,17
1650359758777,CSE 190,A00,092507,Dubnov; Shlomo,14,0,20,6
1650359764804,ECE 45,A01,083139,Staff,0,17,40,40
1650359770827,ECE 65,A50,083695,Staff,0,5,30,30
1650359776851,ECE 109,A01,091882,Touri; Behrouz,40,0,70,30
1650359782876,ECE 180,A00,083140,Abi Samra; Nicholas Camill,23,0,30,7
1650359782876,ECE 180,B00,083141,Abi Samra; Nicholas Camill,5,0,30,25
1650359788904,MATH 10A,A01,083735,Patchell; Gregory David,7,0,30,23
1650359788904,MATH 10A,A02,083736,Patchell; Gregory David,28,0,30,2
1650359788904,MATH 10A,A03,083737,Patchell; Gregory David,25,0,30,5
1650359794927,MATH 10B,A01,083207,Staff,0,7,30,30
1650359794927,MATH 10B,A02,083208,Staff,0,6,30,30
1650359794927,MATH 10B,B01,083739,Staff,17,0,30,13
1650359794927,MATH 10B,B02,083740,Staff,28,0,30,2
1650359800957,MATH 18,A01,083743,Staff,3,0,30,27
1650359800957,MATH 18,A02,083744,Staff,27,0,30,3
1650359800957,MATH 18,A03,083745,Staff,22,0,30,8
1650359800957,MATH 18,A04,083746,Staff,27,0,30,3
1650359800957,MATH 18,B01,083748,Staff,0,11,30,30
1650359800957,MATH 18,B02,083749,Staff,0,11,30,30
1650359800957,MATH 18,B03,083750,Staff,0,11,30,30
1650359800957,MATH 18,B04,083751,Staff,0,9,30,30
1650359806983,MATH 20A,A01,083754,Staff,26,0,40,14
1650359813013,MATH 20B,A01,083756,Staff,0,8,30,30
1650359813013,MATH 20B,A02,083757,Staff,0,8,30,30
1650359819036,MATH 20C,A01,083760,Staff,0,14,30,30
1650359819036,MATH 20C,A02,083761,Staff,0,15,30,30
1650359819036,MATH 20C,B01,083762,Staff,13,0,30,17
1650359819036,MATH 20C,B02,083763,Staff,28,0,30,2
1650359825064,MATH 20D,A01,083765,Staff,0,1,30,30
1650359825064,MATH 20D,A02,083766,Staff,7,0,30,23
1650359825064,MATH 20D,A03,083767,Staff,26,0,30,4
1650359831094,MATH 20E,A01,083771,Staff,5,0,30,25
1650359831094,MATH 20E,A02,083772,Staff,19,0,30,11
1650359831094,MATH 20E,B01,083773,Staff,0,0,30,30
1650359831094,MATH 20E,B02,083774,Staff,12,0,30,18
1650359837119,MATH 103A,A01,083777,Staff,0,11,30,30
1650359837119,MATH 103A,A02,083778,Staff,0,12,30,30
1650359837119,MATH 103A,B01,083779,Staff,0,13,30,30
1650359837119,MATH 103A,B02,083780,Staff,0,11,30,30
1650359843147,MATH 105,A01,085443,Staff,0,21,30,30
1650359849175,MATH 109,A01,083213,Anzaldo; Leesa B,0,6,30,30
1650359849175,MATH 109,A02,083214,Anzaldo; Leesa B,0,7,30,30
1650359849175,MATH 109,B01,083215,Anzaldo; Leesa B,0,5,30,30
1650359849175,MATH 109,B02,083216,Anzaldo; Leesa B,0,5,30,30
1650359855203,MATH 142A,A01,083219,Chow; Bennett,0,14,30,30
1650359855203,MATH 142A,A02,083220,Chow; Bennett,0,12,30,30
1650359855203,MATH 142A,B01,083221,Chow; Bennett,0,12,30,30
1650359855203,MATH 142A,B02,083222,Chow; Bennett,0,12,30,30
1650359861226,MATH 193A,A01,083224,Staff,0,5,30,30
1650359861226,MATH 193A,A02,083225,Staff,0,5,30,30
1650359861226,MATH 193A,A03,083781,Staff,0,4,30,30
1650359861226,MATH 193A,A04,083782,Staff,0,3,30,30
1650359867249,MATH 197,001,091859,McAuley; Julian John,9998,0,9999,1
1650359873301,COGS 9,A01,083615,Staff,0,14,60,60
1650359879325,COGS 11,A01,083617,Boyle; Mary E. T.,22,0,40,18
1650359885348,COGS 13,A01,083071,Staff,0,32,40,40
1650359891373,COGS 14A,A01,092681,Staff,0,21,100,100
1650359897396,COGS 14B,A01,083073,Cheng; Tzu-Han,0,10,50,50
1650359903418,COGS 17,A01,092677,Staff,24,0,75,51
1650359909444,COGS 100,A01,083619,Staff,0,24,60,60
1650359915472,COGS 101A,A01,083621,Davis; Joshua Daniel,0,21,60,60
1650359921499,COGS 101B,A01,091572,Staff,0,0,60,60
1650359927522,COGS 101C,A01,083625,Delgado; Tania,17,0,30,13
1650359933545,COGS 107A,A01,083627,Boyle; Mary E. T.,0,10,60,60
1650359939571,COGS 118A,A01,083075,Staff,4,0,60,56
1650359945598,CSE 3,A50,083646,Miranda; Gregory Joseph,21,0,38,17
1650359945598,CSE 3,A51,083647,Miranda; Gregory Joseph,37,0,37,0
1650359951625,CSE 8A,A50,083650,Miranda; Gregory Joseph,0,28,40,40
1650359957649,CSE 11,A01,083080,Cao; Yingjun,0,88,40,40
1650359963683,CSE 12,A01,083652,Staff,0,12,100,100
1650359969707,CSE 15L,A01,083654,Staff,0,1,50,50
1650359969707,CSE 15L,A02,083655,Staff,3,0,50,47
1650359975731,CSE 20,A01,083657,Staff,52,0,80,28
1650359981757,CSE 30,A01,083084,Eldon; John,0,76,40,40
1650359987790,CSE 100,A01,083659,Cao; Yingjun,0,66,50,50
1650359993814,CSE 134B,A01,083661,Powell; Thomas Allan,0,31,65,65
1650359999838,CSE 140,A01,083663,Staff,0,0,75,75
1650360005869,CSE 140L,A01,083088,Eldon; John,0,7,75,75
1650360011908,CSE 175,A01,083665,Kumar; Rakesh,8,0,25,17
1650360017932,CSE 190,A00,092507,Dubnov; Shlomo,14,0,20,6
1650360023955,ECE 45,A01,083139,Staff,0,17,40,40
1650360029979,ECE 65,A50,083695,Staff,0,5,30,30
1650360036002,ECE 109,A01,091882,Touri; Behrouz,40,0,70,30
1650360042025,ECE 180,A00,083140,Abi Samra; Nicholas Camill,23,0,30,7
1650360042025,ECE 180,B00,083141,Abi Samra; Nicholas Camill,5,0,30,25
1650360048053,MATH 10A,A01,083735,Patchell; Gregory David,7,0,30,23
1650360048053,MATH 10A,A02,083736,Patchell; Gregory David,28,0,30,2
1650360048053,MATH 10A,A03,083737,Patchell; Gregory David,25,0,30,5
1650360054079,MATH 10B,A01,083207,Staff,0,7,30,30
1650360054079,MATH 10B,A02,083208,Staff,0,6,30,30
1650360054079,MATH 10B,B01,083739,Staff,17,0,30,13
1650360054079,MATH 10B,B02,083740,Staff,28,0,30,2
1650360060103,MATH 18,A01,083743,Staff,3,0,30,27
1650360060103,MATH 18,A02,083744,Staff,27,0,30,3
1650360060103,MATH 18,A03,083745,Staff,22,0,30,8
1650360060103,MATH 18,A04,083746,Staff,27,0,30,3
1650360060103,MATH 18,B01,083748,Staff,0,11,30,30
1650360060103,MATH 18,B02,083749,Staff,0,11,30,30
1650360060103,MATH 18,B03,083750,Staff,0,11,30,30
1650360060103,MATH 18,B04,083751,Staff,0,9,30,30
1650360066128,MATH 20A,A01,083754,Staff,26,0,40,14
1650360072151,MATH 20B,A01,083756,Staff,0,8,30,30
1650360072151,MATH 20B,A02,083757,Staff,0,8,30,30
1650360078179,MATH 20C,A01,083760,Staff,0,14,30,30
1650360078179,MATH 20C,A02,083761,Staff,0,15,30,30
1650360078179,MATH 20C,B01,083762,Staff,13,0,30,17
1650360078179,MATH 20C,B02,083763,Staff,28,0,30,2
1650360084207,MATH 20D,A01,083765,Staff,0,1,30,30
1650360084207,MATH 20D,A02,083766,Staff,7,0,30,23
1650360084207,MATH 20D,A03,083767,Staff,26,0,30,4
1650360090230,MATH 20E,A01,083771,Staff,5,0,30,25
1650360090230,MATH 20E,A02,083772,Staff,19,0,30,11
1650360090230,MATH 20E,B01,083773,Staff,0,0,30,30
1650360090230,MATH 20E,B02,083774,Staff,12,0,30,18
1650360096256,MATH 103A,A01,083777,Staff,0,11,30,30
1650360096256,MATH 103A,A02,083778,Staff,0,12,30,30
1650360096256,MATH 103A,B01,083779,Staff,0,13,30,30
1650360096256,MATH 103A,B02,083780,Staff,0,11,30,30
1650360102283,MATH 105,A01,085443,Staff,0,21,30,30
1650360108306,MATH 109,A01,083213,Anzaldo; Leesa B,0,6,30,30
1650360108306,MATH 109,A02,083214,Anzaldo; Leesa B,0,7,30,30
1650360108306,MATH 109,B01,083215,Anzaldo; Leesa B,0,5,30,30
1650360108306,MATH 109,B02,083216,Anzaldo; Leesa B,0,5,30,30
1650360114335,MATH 142A,A01,083219,Chow; Bennett,0,14,30,30
1650360114335,MATH 142A,A02,083220,Chow; Bennett,0,12,30,30
1650360114335,MATH 142A,B01,083221,Chow; Bennett,0,12,30,30
1650360114335,MATH 142A,B02,083222,Chow; Bennett,0,12,30,30
1650360120360,MATH 193A,A01,083224,Staff,0,5,30,30
1650360120360,MATH 193A,A02,083225,Staff,0,5,30,30
1650360120360,MATH 193A,A03,083781,Staff,0,4,30,30
1650360120360,MATH 193A,A04,083782,Staff,0,3,30,30
1650360126386,MATH 197,001,091859,McAuley; Julian John,9998,0,9999,1
1650360132436,COGS 9,A01,083615,Staff,0,14,60,60
1650360138467,COGS 11,A01,083617,Boyle; Mary E. T.,22,0,40,18
1650360144492,COGS 13,A01,083071,Staff,0,32,40,40
1650360150515,COGS 14A,A01,092681,Staff,0,21,100,100
1650360156537,COGS 14B,A01,083073,Cheng; Tzu-Han,0,10,50,50
1650360162560,COGS 17,A01,092677,Staff,24,0,75,51
1650360168583,COGS 100,A01,083619,Staff,0,24,60,60
1650360174607,COGS 101A,A01,083621,Davis; Joshua Daniel,0,21,60,60
1650360180631,COGS 101B,A01,091572,Staff,0,0,60,60
1650360186749,COGS 101C,A01,083625,Delgado; Tania,17,0,30,13
1650360192773,COGS 107A,A01,083627,Boyle; Mary E. T.,0,10,60,60
1650360198796,COGS 118A,A01,083075,Staff,4,0,60,56
1650360204819,CSE 3,A50,083646,Miranda; Gregory Joseph,21,0,38,17
1650360204819,CSE 3,A51,083647,Miranda; Gregory Joseph,37,0,37,0
1650360210846,CSE 8A,A50,083650,Miranda; Gregory Joseph,0,28,40,40
1650360223423,CSE 11,A01,083080,Cao; Yingjun,0,88,40,40
1650360229450,CSE 12,A01,083652,Staff,0,12,100,100
1650360235476,CSE 15L,A01,083654,Staff,0,1,50,50
1650360235476,CSE 15L,A02,083655,Staff,3,0,50,47
1650360241500,CSE 20,A01,083657,Staff,52,0,80,28
1650360247524,CSE 30,A01,083084,Eldon; John,0,76,40,40
1650360253555,CSE 100,A01,083659,Cao; Yingjun,0,66,50,50
1650360259581,CSE 134B,A01,083661,Powell; Thomas Allan,0,31,65,65
1650360265610,CSE 140,A01,083663,Staff,0,0,75,75
1650360271636,CSE 140L,A01,083088,Eldon; John,0,7,75,75
1650360277660,CSE 175,A01,083665,Kumar; Rakesh,8,0,25,17
1650360283687,CSE 190,A00,092507,Dubnov; Shlomo,14,0,20,6
1650360289714,ECE 45,A01,083139,Staff,0,17,40,40
1650360295738,ECE 65,A50,083695,Staff,0,5,30,30
1650360301763,ECE 109,A01,091882,Touri; Behrouz,40,0,70,30
1650360307789,ECE 180,A00,083140,Abi Samra; Nicholas Camill,23,0,30,7
1650360307789,ECE 180,B00,083141,Abi Samra; Nicholas Camill,5,0,30,25
1650360313816,MATH 10A,A01,083735,Patchell; Gregory David,7,0,30,23
1650360313816,MATH 10A,A02,083736,Patchell; Gregory David,28,0,30,2
1650360313816,MATH 10A,A03,083737,Patchell; Gregory David,25,0,30,5
1650360319844,MATH 10B,A01,083207,Staff,0,7,30,30
1650360319844,MATH 10B,A02,083208,Staff,0,6,30,30
1650360319844,MATH 10B,B01,083739,Staff,17,0,30,13
1650360319844,MATH 10B,B02,083740,Staff,28,0,30,2
1650360325870,MATH 18,A01,083743,Staff,3,0,30,27
1650360325870,MATH 18,A02,083744,Staff,27,0,30,3
1650360325870,MATH 18,A03,083745,Staff,22,0,30,8
1650360325870,MATH 18,A04,083746,Staff,27,0,30,3
1650360325870,MATH 18,B01,083748,Staff,0,11,30,30
1650360325870,MATH 18,B02,083749,Staff,0,11,30,30
1650360325870,MATH 18,B03,083750,Staff,0,11,30,30
1650360325870,MATH 18,B04,083751,Staff,0,9,30,30
1650360331892,MATH 20A,A01,083754,Staff,26,0,40,14
1650360337915,MATH 20B,A01,083756,Staff,0,8,30,30
1650360337915,MATH 20B,A02,083757,Staff,0,8,30,30
1650360343944,MATH 20C,A01,083760,Staff,0,14,30,30
1650360343944,MATH 20C,A02,083761,Staff,0,15,30,30
1650360343944,MATH 20C,B01,083762,Staff,13,0,30,17
1650360343944,MATH 20C,B02,083763,Staff,28,0,30,2
1650360349970,MATH 20D,A01,083765,Staff,0,1,30,30
1650360349970,MATH 20D,A02,083766,Staff,7,0,30,23
1650360349970,MATH 20D,A03,083767,Staff,26,0,30,4
1650360355994,MATH 20E,A01,083771,Staff,5,0,30,25
1650360355994,MATH 20E,A02,083772,Staff,19,0,30,11
1650360355994,MATH 20E,B01,083773,Staff,0,0,30,30
1650360355994,MATH 20E,B02,083774,Staff,12,0,30,18
1650360362019,MATH 103A,A01,083777,Staff,0,11,30,30
1650360362019,MATH 103A,A02,083778,Staff,0,12,30,30
1650360362019,MATH 103A,B01,083779,Staff,0,13,30,30
1650360362019,MATH 103A,B02,083780,Staff,0,11,30,30
1650360368042,MATH 105,A01,085443,Staff,0,21,30,30
1650360374067,MATH 109,A01,083213,Anzaldo; Leesa B,0,6,30,30
1650360374067,MATH 109,A02,083214,Anzaldo; Leesa B,0,7,30,30
1650360374067,MATH 109,B01,083215,Anzaldo; Leesa B,0,5,30,30
1650360374067,MATH 109,B02,083216,Anzaldo; Leesa B,0,5,30,30
1650360380101,MATH 142A,A01,083219,Chow; Bennett,0,14,30,30
1650360380101,MATH 142A,A02,083220,Chow; Bennett,0,12,30,30
1650360380101,MATH 142A,B01,083221,Chow; Bennett,0,12,30,30
1650360380101,MATH 142A,B02,083222,Chow; Bennett,0,12,30,30
1650360386126,MATH 193A,A01,083224,Staff,0,5,30,30
1650360386126,MATH 193A,A02,083225,Staff,0,5,30,30
1650360386126,MATH 193A,A03,083781,Staff,0,4,30,30
1650360386126,MATH 193A,A04,083782,Staff,0,3,30,30
1650360392148,MATH 197,001,091859,McAuley; Julian John,9998,0,9999,1
1650360398204,COGS 9,A01,083615,Staff,0,14,60,60
1650360404235,COGS 11,A01,083617,Boyle; Mary E. T.,22,0,40,18
1650360410259,COGS 13,A01,083071,Staff,0,32,40,40
1650360416281,COGS 14A,A01,092681,Staff,0,21,100,100
1650360422305,COGS 14B,A01,083073,Cheng; Tzu-Han,0,10,50,50
1650360428332,COGS 17,A01,092677,Staff,24,0,75,51
1650360434367,COGS 100,A01,083619,Staff,0,24,60,60
1650360440395,COGS 101A,A01,083621,Davis; Joshua Daniel,0,21,60,60
1650360446419,COGS 101B,A01,091572,Staff,0,0,60,60
1650360452441,COGS 101C,A01,083625,Delgado; Tania,17,0,30,13
1650360458468,COGS 107A,A01,083627,Boyle; Mary E. T.,0,10,60,60
1650360464495,COGS 118A,A01,083075,Staff,4,0,60,56
1650360470520,CSE 3,A50,083646,Miranda; Gregory Joseph,21,0,38,17
1650360470520,CSE 3,A51,083647,Miranda; Gregory Joseph,37,0,37,0
1650360476549,CSE 8A,A50,083650,Miranda; Gregory Joseph,0,28,40,40
1650360482576,CSE 11,A01,083080,Cao; Yingjun,0,88,40,40
1650360488603,CSE 12,A01,083652,Staff,0,12,100,100
1650360494630,CSE 15L,A01,083654,Staff,0,1,50,50
1650360494630,CSE 15L,A02,083655,Staff,3,0,50,47
1650360500652,CSE 20,A01,083657,Staff,52,0,80,28
1650360506677,CSE 30,A01,083084,Eldon; John,0,76,40,40
1650360512701,CSE 100,A01,083659,Cao; Yingjun,0,66,50,50
1650360518725,CSE 134B,A01,083661,Powell; Thomas Allan,0,31,65,65
1650360524751,CSE 140,A01,083663,Staff,0,0,75,75
1650360530778,CSE 140L,A01,083088,Eldon; John,0,7,75,75
1650360536802,CSE 175,A01,083665,Kumar; Rakesh,8,0,25,17
1650360542826,CSE 190,A00,092507,Dubnov; Shlomo,14,0,20,6
1650360548853,ECE 45,A01,083139,Staff,0,17,40,40
1650360554875,ECE 65,A50,083695,Staff,0,5,30,30
1650360560901,ECE 109,A01,091882,Touri; Behrouz,40,0,70,30
1650360566923,ECE 180,A00,083140,Abi Samra; Nicholas Camill,23,0,30,7
1650360566923,ECE 180,B00,083141,Abi Samra; Nicholas Camill,5,0,30,25
1650360572950,MATH 10A,A01,083735,Patchell; Gregory David,7,0,30,23
1650360572950,MATH 10A,A02,083736,Patchell; Gregory David,28,0,30,2
1650360572950,MATH 10A,A03,083737,Patchell; Gregory David,25,0,30,5
1650360578982,MATH 10B,A01,083207,Staff,0,7,30,30
1650360578982,MATH 10B,A02,083208,Staff,0,6,30,30
1650360578982,MATH 10B,B01,083739,Staff,17,0,30,13
1650360578982,MATH 10B,B02,083740,Staff,28,0,30,2
1650360585009,MATH 18,A01,083743,Staff,3,0,30,27
1650360585009,MATH 18,A02,083744,Staff,27,0,30,3
1650360585009,MATH 18,A03,083745,Staff,22,0,30,8
1650360585009,MATH 18,A04,083746,Staff,27,0,30,3
1650360585009,MATH 18,B01,083748,Staff,0,11,30,30
1650360585009,MATH 18,B02,083749,Staff,0,11,30,30
1650360585009,MATH 18,B03,083750,Staff,0,11,30,30
1650360585009,MATH 18,B04,083751,Staff,0,9,30,30
1650360591031,MATH 20A,A01,083754,Staff,26,0,40,14
1650360597055,MATH 20B,A01,083756,Staff,0,8,30,30
1650360597055,MATH 20B,A02,083757,Staff,0,8,30,30
1650360603086,MATH 20C,A01,083760,Staff,0,14,30,30
1650360603086,MATH 20C,A02,083761,Staff,0,15,30,30
1650360603086,MATH 20C,B01,083762,Staff,13,0,30,17
1650360603086,MATH 20C,B02,083763,Staff,28,0,30,2
1650360609109,MATH 20D,A01,083765,Staff,0,1,30,30
1650360609109,MATH 20D,A02,083766,Staff,7,0,30,23
1650360609109,MATH 20D,A03,083767,Staff,26,0,30,4
1650360615134,MATH 20E,A01,083771,Staff,5,0,30,25
1650360615134,MATH 20E,A02,083772,Staff,19,0,30,11
1650360615134,MATH 20E,B01,083773,Staff,0,0,30,30
1650360615134,MATH 20E,B02,083774,Staff,12,0,30,18
1650360621158,MATH 103A,A01,083777,Staff,0,11,30,30
1650360621158,MATH 103A,A02,083778,Staff,0,12,30,30
1650360621158,MATH 103A,B01,083779,Staff,0,13,30,30
1650360621158,MATH 103A,B02,083780,Staff,0,11,30,30
1650360627182,MATH 105,A01,085443,Staff,0,21,30,30
1650360633221,MATH 109,A01,083213,Anzaldo; Leesa B,0,6,30,30
1650360633221,MATH 109,A02,083214,Anzaldo; Leesa B,0,7,30,30
1650360633221,MATH 109,B01,083215,Anzaldo; Leesa B,0,5,30,30
1650360633221,MATH 109,B02,083216,Anzaldo; Leesa B,0,5,30,30
1650360639244,MATH 142A,A01,083219,Chow; Bennett,0,14,30,30
1650360639244,MATH 142A,A02,083220,Chow; Bennett,0,12,30,30
1650360639244,MATH 142A,B01,083221,Chow; Bennett,0,12,30,30
1650360639244,MATH 142A,B02,083222,Chow; Bennett,0,12,30,30
1650360645269,MATH 193A,A01,083224,Staff,0,5,30,30
1650360645269,MATH 193A,A02,083225,Staff,0,5,30,30
1650360645269,MATH 193A,A03,083781,Staff,0,4,30,30
1650360645269,MATH 193A,A04,083782,Staff,0,3,30,30
1650360651291,MATH 197,001,091859,McAuley; Julian John,9998,0,9999,1
1650360657343,COGS 9,A01,083615,Staff,0,14,60,60
1650360663368,COGS 11,A01,083617,Boyle; Mary E. T.,22,0,40,18
1650360669392,COGS 13,A01,083071,Staff,0,32,40,40
1650360675465,COGS 14A,A01,092681,Staff,0,21,100,100
1650360681489,COGS 14B,A01,083073,Cheng; Tzu-Han,0,10,50,50
1650360687510,COGS 17,A01,092677,Staff,24,0,75,51
1650360693536,COGS 100,A01,083619,Staff,0,24,60,60
1650360699561,COGS 101A,A01,083621,Davis; Joshua Daniel,0,21,60,60
1650360705587,COGS 101B,A01,091572,Staff,0,0,60,60
1650360711613,COGS 101C,A01,083625,Delgado; Tania,17,0,30,13
1650360717635,COGS 107A,A01,083627,Boyle; Mary E. T.,0,10,60,60
1650360723663,COGS 118A,A01,083075,Staff,4,0,60,56
1650360729685,CSE 3,A50,083646,Miranda; Gregory Joseph,21,0,38,17
1650360729685,CSE 3,A51,083647,Miranda; Gregory Joseph,37,0,37,0
1650360735711,CSE 8A,A50,083650,Miranda; Gregory Joseph,0,28,40,40
1650360741734,CSE 11,A01,083080,Cao; Yingjun,0,88,40,40
1650360747758,CSE 12,A01,083652,Staff,0,12,100,100
1650360753783,CSE 15L,A01,083654,Staff,0,1,50,50
1650360753783,CSE 15L,A02,083655,Staff,3,0,50,47
1650360759808,CSE 20,A01,083657,Staff,52,0,80,28
1650360765832,CSE 30,A01,083084,Eldon; John,0,76,40,40
1650360771854,CSE 100,A01,083659,Cao; Yingjun,0,66,50,50
1650360777881,CSE 134B,A01,083661,Powell; Thomas Allan,0,31,65,65
1650360783907,CSE 140,A01,083663,Staff,0,0,75,75
1650360790021,CSE 140L,A01,083088,Eldon; John,0,7,75,75
1650360796045,CSE 175,A01,083665,Kumar; Rakesh,8,0,25,17
1650360802070,CSE 190,A00,092507,Dubnov; Shlomo,14,0,20,6
1650360808093,ECE 45,A01,083139,Staff,0,17,40,40
1650360814116,ECE 65,A50,083695,Staff,0,5,30,30
1650360820143,ECE 109,A01,091882,Touri; Behrouz,40,0,70,30
1650360826169,ECE 180,A00,083140,Abi Samra; Nicholas Camill,23,0,30,7
1650360826169,ECE 180,B00,083141,Abi Samra; Nicholas Camill,5,0,30,25
1650360832198,MATH 10A,A01,083735,Patchell; Gregory David,7,0,30,23
1650360832198,MATH 10A,A02,083736,Patchell; Gregory David,28,0,30,2
1650360832198,MATH 10A,A03,083737,Patchell; Gregory David,25,0,30,5
1650360838222,MATH 10B,A01,083207,Staff,0,7,30,30
1650360838222,MATH 10B,A02,083208,Staff,0,6,30,30
1650360838222,MATH 10B,B01,083739,Staff,17,0,30,13
1650360838222,MATH 10B,B02,083740,Staff,28,0,30,2
1650360844254,MATH 18,A01,083743,Staff,3,0,30,27
1650360844254,MATH 18,A02,083744,Staff,27,0,30,3
1650360844254,MATH 18,A03,083745,Staff,22,0,30,8
1650360844254,MATH 18,A04,083746,Staff,27,0,30,3
1650360844254,MATH 18,B01,083748,Staff,0,11,30,30
1650360844254,MATH 18,B02,083749,Staff,0,11,30,30
1650360844254,MATH 18,B03,083750,Staff,0,11,30,30
1650360844254,MATH 18,B04,083751,Staff,0,9,30,30
1650360850279,MATH 20A,A01,083754,Staff,26,0,40,14
1650360856301,MATH 20B,A01,083756,Staff,0,8,30,30
1650360856301,MATH 20B,A02,083757,Staff,0,8,30,30
1650360862325,MATH 20C,A01,083760,Staff,0,14,30,30
1650360862325,MATH 20C,A02,083761,Staff,0,15,30,30
1650360862325,MATH 20C,B01,083762,Staff,13,0,30,17
1650360862325,MATH 20C,B02,083763,Staff,28,0,30,2
1650360868351,MATH 20D,A01,083765,Staff,0,1,30,30
1650360868351,MATH 20D,A02,083766,Staff,7,0,30,23
1650360868351,MATH 20D,A03,083767,Staff,26,0,30,4
1650360874374,MATH 20E,A01,083771,Staff,5,0,30,25
1650360874374,MATH 20E,A02,083772,Staff,19,0,30,11
1650360874374,MATH 20E,B01,083773,Staff,0,0,30,30
1650360874374,MATH 20E,B02,083774,Staff,12,0,30,18
1650360880405,MATH 103A,A01,083777,Staff,0,11,30,30
1650360880405,MATH 103A,A02,083778,Staff,0,12,30,30
1650360880405,MATH 103A,B01,083779,Staff,0,13,30,30
1650360880405,MATH 103A,B02,083780,Staff,0,11,30,30
1650360886427,MATH 105,A01,085443,Staff,0,21,30,30
1650360892454,MATH 109,A01,083213,Anzaldo; Leesa B,0,6,30,30
1650360892454,MATH 109,A02,083214,Anzaldo; Leesa B,0,7,30,30
1650360892454,MATH 109,B01,083215,Anzaldo; Leesa B,0,5,30,30
1650360892454,MATH 109,B02,083216,Anzaldo; Leesa B,0,5,30,30
1650360898481,MATH 142A,A01,083219,Chow; Bennett,0,14,30,30
1650360898481,MATH 142A,A02,083220,Chow; Bennett,0,12,30,30
1650360898481,MATH 142A,B01,083221,Chow; Bennett,0,12,30,30
1650360898481,MATH 142A,B02,083222,Chow; Bennett,0,12,30,30
1650360904514,MATH 193A,A01,083224,Staff,0,5,30,30
1650360904514,MATH 193A,A02,083225,Staff,0,5,30,30
1650360904514,MATH 193A,A03,083781,Staff,0,4,30,30
1650360904514,MATH 193A,A04,083782,Staff,0,3,30,30
1650360910537,MATH 197,001,091859,McAuley; Julian John,9998,0,9999,1
1650360916590,COGS 9,A01,083615,Staff,0,14,60,60
1650360922611,COGS 11,A01,083617,Boyle; Mary E. T.,22,0,40,18
1650360928633,COGS 13,A01,083071,Staff,0,32,40,40
1650360934659,COGS 14A,A01,092681,Staff,0,21,100,100
1650360940683,COGS 14B,A01,083073,Cheng; Tzu-Han,0,10,50,50
1650360946708,COGS 17,A01,092677,Staff,24,0,75,51
1650360952730,COGS 100,A01,083619,Staff,0,24,60,60
1650360958755,COGS 101A,A01,083621,Davis; Joshua Daniel,0,21,60,60
1650360964778,COGS 101B,A01,091572,Staff,0,0,60,60
1650360970804,COGS 101C,A01,083625,Delgado; Tania,17,0,30,13
1650360976829,COGS 107A,A01,083627,Boyle; Mary E. T.,0,10,60,60
1650360982856,COGS 118A,A01,083075,Staff,4,0,60,56
1650360988878,CSE 3,A50,083646,Miranda; Gregory Joseph,21,0,38,17
1650360988878,CSE 3,A51,083647,Miranda; Gregory Joseph,37,0,37,0
1650360994905,CSE 8A,A50,083650,Miranda; Gregory Joseph,0,28,40,40
1650361000929,CSE 11,A01,083080,Cao; Yingjun,0,88,40,40
1650361006953,CSE 12,A01,083652,Staff,0,12,100,100
1650361012978,CSE 15L,A01,083654,Staff,0,1,50,50
1650361012978,CSE 15L,A02,083655,Staff,3,0,50,47
1650361019003,CSE 20,A01,083657,Staff,52,0,80,28
1650361025028,CSE 30,A01,083084,Eldon; John,0,76,40,40
1650361031052,CSE 100,A01,083659,Cao; Yingjun,0,66,50,50
1650361037078,CSE 134B,A01,083661,Powell; Thomas Allan,0,31,65,65
1650361043101,CSE 140,A01,083663,Staff,0,0,75,75
1650361049129,CSE 140L,A01,083088,Eldon; John,0,7,75,75
1650361055153,CSE 175,A01,083665,Kumar; Rakesh,8,0,25,17
1650361061180,CSE 190,A00,092507,Dubnov; Shlomo,14,0,20,6
1650361067204,ECE 45,A01,083139,Staff,0,17,40,40
1650361073228,ECE 65,A50,083695,Staff,0,5,30,30
1650361079253,ECE 109,A01,091882,Touri; Behrouz,40,0,70,30
1650361085284,ECE 180,A00,083140,Abi Samra; Nicholas Camill,23,0,30,7
1650361085284,ECE 180,B00,083141,Abi Samra; Nicholas Camill,5,0,30,25
1650361091311,MATH 10A,A01,083735,Patchell; Gregory David,7,0,30,23
1650361091311,MATH 10A,A02,083736,Patchell; Gregory David,28,0,30,2
1650361091311,MATH 10A,A03,083737,Patchell; Gregory David,25,0,30,5
1650361097338,MATH 10B,A01,083207,Staff,0,7,30,30
1650361097338,MATH 10B,A02,083208,Staff,0,6,30,30
1650361097338,MATH 10B,B01,083739,Staff,17,0,30,13
1650361097338,MATH 10B,B02,083740,Staff,28,0,30,2
1650361103367,MATH 18,A01,083743,Staff,3,0,30,27
1650361103367,MATH 18,A02,083744,Staff,27,0,30,3
1650361103367,MATH 18,A03,083745,Staff,22,0,30,8
1650361103367,MATH 18,A04,083746,Staff,27,0,30,3
1650361103367,MATH 18,B01,083748,Staff,0,11,30,30
1650361103367,MATH 18,B02,083749,Staff,0,11,30,30
1650361103367,MATH 18,B03,083750,Staff,0,11,30,30
1650361103367,MATH 18,B04,083751,Staff,0,9,30,30
1650361109389,MATH 20A,A01,083754,Staff,26,0,40,14
1650361115416,MATH 20B,A01,083756,Staff,0,8,30,30
1650361115416,MATH 20B,A02,083757,Staff,0,8,30,30
1650361121441,MATH 20C,A01,083760,Staff,0,14,30,30
1650361121441,MATH 20C,A02,083761,Staff,0,15,30,30
1650361121441,MATH 20C,B01,083762,Staff,13,0,30,17
1650361121441,MATH 20C,B02,083763,Staff,28,0,30,2
1650361127468,MATH 20D,A01,083765,Staff,0,1,30,30
1650361127468,MATH 20D,A02,083766,Staff,7,0,30,23
1650361127468,MATH 20D,A03,083767,Staff,26,0,30,4
1650361133496,MATH 20E,A01,083771,Staff,5,0,30,25
1650361133496,MATH 20E,A02,083772,Staff,19,0,30,11
1650361133496,MATH 20E,B01,083773,Staff,0,0,30,30
1650361133496,MATH 20E,B02,083774,Staff,12,0,30,18
1650361139519,MATH 103A,A01,083777,Staff,0,11,30,30
1650361139519,MATH 103A,A02,083778,Staff,0,12,30,30
1650361139519,MATH 103A,B01,083779,Staff,0,13,30,30
1650361139519,MATH 103A,B02,083780,Staff,0,11,30,30
1650361145542,MATH 105,A01,085443,Staff,0,21,30,30
1650361151565,MATH 109,A01,083213,Anzaldo; Leesa B,0,6,30,30
1650361151565,MATH 109,A02,083214,Anzaldo; Leesa B,0,7,30,30
1650361151565,MATH 109,B01,083215,Anzaldo; Leesa B,0,5,30,30
1650361151565,MATH 109,B02,083216,Anzaldo; Leesa B,0,5,30,30
1650361157598,MATH 142A,A01,083219,Chow; Bennett,0,14,30,30
1650361157598,MATH 142A,A02,083220,Chow; Bennett,0,12,30,30
1650361157598,MATH 142A,B01,083221,Chow; Bennett,0,12,30,30
1650361157598,MATH 142A,B02,083222,Chow; Bennett,0,12,30,30
1650361163622,MATH 193A,A01,083224,Staff,0,5,30,30
1650361163622,MATH 193A,A02,083225,Staff,0,5,30,30
1650361163622,MATH 193A,A03,083781,Staff,0,4,30,30
1650361163622,MATH 193A,A04,083782,Staff,0,3,30,30
1650361169649,MATH 197,001,091859,McAuley; Julian John,9998,0,9999,1
1650361175701,COGS 9,A01,083615,Staff,0,14,60,60
1650361181728,COGS 11,A01,083617,Boyle; Mary E. T.,22,0,40,18
1650361187756,COGS 13,A01,083071,Staff,0,32,40,40
1650361193784,COGS 14A,A01,092681,Staff,0,21,100,100
1650361199808,COGS 14B,A01,083073,Cheng; Tzu-Han,0,10,50,50
1650361205831,COGS 17,A01,092677,Staff,24,0,75,51
1650361211855,COGS 100,A01,083619,Staff,0,24,60,60
1650361217882,COGS 101A,A01,083621,Davis; Joshua Daniel,0,21,60,60
1650361223911,COGS 101B,A01,091572,Staff,0,0,60,60
1650361229939,COGS 101C,A01,083625,Delgado; Tania,17,0,30,13
1650361235966,COGS 107A,A01,083627,Boyle; Mary E. T.,0,10,60,60
1650361241990,COGS 118A,A01,083075,Staff,4,0,60,56
1650361248016,CSE 3,A50,083646,Miranda; Gregory Joseph,21,0,38,17
1650361248016,CSE 3,A51,083647,Miranda; Gregory Joseph,37,0,37,0
1650361254039,CSE 8A,A50,083650,Miranda; Gregory Joseph,0,28,40,40
1650361260066,CSE 11,A01,083080,Cao; Yingjun,0,88,40,40
1650361266089,CSE 12,A01,083652,Staff,0,12,100,100
1650361272112,CSE 15L,A01,083654,Staff,0,1,50,50
1650361272112,CSE 15L,A02,083655,Staff,3,0,50,47
1650361278136,CSE 20,A01,083657,Staff,52,0,80,28
1650361284160,CSE 30,A01,083084,Eldon; John,0,76,40,40
1650361290184,CSE 100,A01,083659,Cao; Yingjun,0,66,50,50
1650361296210,CSE 134B,A01,083661,Powell; Thomas Allan,0,31,65,65
1650361302235,CSE 140,A01,083663,Staff,0,0,75,75
1650361308259,CSE 140L,A01,083088,Eldon; John,0,7,75,75
1650361314284,CSE 175,A01,083665,Kumar; Rakesh,8,0,25,17
1650361320315,CSE 190,A00,092507,Dubnov; Shlomo,14,0,20,6
1650361326347,ECE 45,A01,083139,Staff,0,17,40,40
1650361332371,ECE 65,A50,083695,Staff,0,5,30,30
1650361338398,ECE 109,A01,091882,Touri; Behrouz,40,0,70,30
1650361344424,ECE 180,A00,083140,Abi Samra; Nicholas Camill,23,0,30,7
1650361344424,ECE 180,B00,083141,Abi Samra; Nicholas Camill,5,0,30,25
1650361350450,MATH 10A,A01,083735,Patchell; Gregory David,7,0,30,23
1650361350450,MATH 10A,A02,083736,Patchell; Gregory David,28,0,30,2
1650361350450,MATH 10A,A03,083737,Patchell; Gregory David,25,0,30,5
1650361356474,MATH 10B,A01,083207,Staff,0,7,30,30
1650361356474,MATH 10B,A02,083208,Staff,0,6,30,30
1650361356474,MATH 10B,B01,083739,Staff,17,0,30,13
1650361356474,MATH 10B,B02,083740,Staff,28,0,30,2
1650361362500,MATH 18,A01,083743,Staff,3,0,30,27
1650361362500,MATH 18,A02,083744,Staff,27,0,30,3
1650361362500,MATH 18,A03,083745,Staff,22,0,30,8
1650361362500,MATH 18,A04,083746,Staff,27,0,30,3
1650361362500,MATH 18,B01,083748,Staff,0,11,30,30
1650361362500,MATH 18,B02,083749,Staff,0,11,30,30
1650361362500,MATH 18,B03,083750,Staff,0,11,30,30
1650361362500,MATH 18,B04,083751,Staff,0,9,30,30
1650361368530,MATH 20A,A01,083754,Staff,26,0,40,14
1650361374553,MATH 20B,A01,083756,Staff,0,8,30,30
1650361374553,MATH 20B,A02,083757,Staff,0,8,30,30
1650361380585,MATH 20C,A01,083760,Staff,0,14,30,30
1650361380585,MATH 20C,A02,083761,Staff,0,15,30,30
1650361380585,MATH 20C,B01,083762,Staff,13,0,30,17
1650361380585,MATH 20C,B02,083763,Staff,28,0,30,2
1650361386701,MATH 20D,A01,083765,Staff,0,1,30,30
1650361386701,MATH 20D,A02,083766,Staff,7,0,30,23
1650361386701,MATH 20D,A03,083767,Staff,26,0,30,4
1650361392723,MATH 20E,A01,083771,Staff,5,0,30,25
1650361392723,MATH 20E,A02,083772,Staff,19,0,30,11
1650361392723,MATH 20E,B01,083773,Staff,0,0,30,30
1650361392723,MATH 20E,B02,083774,Staff,12,0,30,18
1650361398746,MATH 103A,A01,083777,Staff,0,11,30,30
1650361398746,MATH 103A,A02,083778,Staff,0,12,30,30
1650361398746,MATH 103A,B01,083779,Staff,0,13,30,30
1650361398746,MATH 103A,B02,083780,Staff,0,11,30,30
1650361404769,MATH 105,A01,085443,Staff,0,21,30,30
1650361410793,MATH 109,A01,083213,Anzaldo; Leesa B,0,6,30,30
1650361410793,MATH 109,A02,083214,Anzaldo; Leesa B,0,7,30,30
1650361410793,MATH 109,B01,083215,Anzaldo; Leesa B,0,5,30,30
1650361410793,MATH 109,B02,083216,Anzaldo; Leesa B,0,5,30,30
1650361416819,MATH 142A,A01,083219,Chow; Bennett,0,14,30,30
1650361416819,MATH 142A,A02,083220,Chow; Bennett,0,12,30,30
1650361416819,MATH 142A,B01,083221,Chow; Bennett,0,12,30,30
1650361416819,MATH 142A,B02,083222,Chow; Bennett,0,12,30,30
1650361422854,MATH 193A,A01,083224,Staff,0,5,30,30
1650361422854,MATH 193A,A02,083225,Staff,0,5,30,30
1650361422854,MATH 193A,A03,083781,Staff,0,4,30,30
1650361422854,MATH 193A,A04,083782,Staff,0,3,30,30
1650361428876,MATH 197,001,091859,McAuley; Julian John,9998,0,9999,1
1650361434932,COGS 9,A01,083615,Staff,0,14,60,60
1650361440957,COGS 11,A01,083617,Boyle; Mary E. T.,22,0,40,18
1650361446982,COGS 13,A01,083071,Staff,0,32,40,40
1650361453005,COGS 14A,A01,092681,Staff,0,21,100,100
1650361459032,COGS 14B,A01,083073,Cheng; Tzu-Han,0,10,50,50
1650361465056,COGS 17,A01,092677,Staff,24,0,75,51
1650361471083,COGS 100,A01,083619,Staff,0,24,60,60
1650361477109,COGS 101A,A01,083621,Davis; Joshua Daniel,0,21,60,60
1650361483134,COGS 101B,A01,091572,Staff,0,0,60,60
1650361489158,COGS 101C,A01,083625,Delgado; Tania,17,0,30,13
1650361495182,COGS 107A,A01,083627,Boyle; Mary E. T.,0,10,60,60
1650361501206,COGS 118A,A01,083075,Staff,4,0,60,56
1650361507229,CSE 3,A50,083646,Miranda; Gregory Joseph,21,0,38,17
1650361507229,CSE 3,A51,083647,Miranda; Gregory Joseph,37,0,37,0
1650361513255,CSE 8A,A50,083650,Miranda; Gregory Joseph,0,28,40,40
1650361519283,CSE 11,A01,083080,Cao; Yingjun,0,88,40,40
1650361525309,CSE 12,A01,083652,Staff,0,12,100,100
1650361531336,CSE 15L,A01,083654,Staff,0,1,50,50
1650361531336,CSE 15L,A02,083655,Staff,3,0,50,47
1650361537360,CSE 20,A01,083657,Staff,52,0,80,28
1650361543382,CSE 30,A01,083084,Eldon; John,0,76,40,40
1650361549409,CSE 100,A01,083659,Cao; Yingjun,0,66,50,50
1650361555433,CSE 134B,A01,083661,Powell; Thomas Allan,0,31,65,65
1650361561458,CSE 140,A01,083663,Staff,0,0,75,75
1650361567482,CSE 140L,A01,083088,Eldon; John,0,7,75,75
1650361573508,CSE 175,A01,083665,Kumar; Rakesh,8,0,25,17
1650361579540,CSE 190,A00,092507,Dubnov; Shlomo,14,0,20,6
1650361585564,ECE 45,A01,083139,Staff,0,17,40,40
1650361591587,ECE 65,A50,083695,Staff,0,5,30,30
1650361597613,ECE 109,A01,091882,Touri; Behrouz,40,0,70,30
1650361603639,ECE 180,A00,083140,Abi Samra; Nicholas Camill,23,0,30,7
1650361603639,ECE 180,B00,083141,Abi Samra; Nicholas Camill,5,0,30,25
1650361609679,MATH 10A,A01,083735,Patchell; Gregory David,7,0,30,23
1650361609679,MATH 10A,A02,083736,Patchell; Gregory David,28,0,30,2
1650361609679,MATH 10A,A03,083737,Patchell; Gregory David,25,0,30,5
1650361615703,MATH 10B,A01,083207,Staff,0,7,30,30
1650361615703,MATH 10B,A02,083208,Staff,0,6,30,30
1650361615703,MATH 10B,B01,083739,Staff,17,0,30,13
1650361615703,MATH 10B,B02,083740,Staff,28,0,30,2
1650361621728,MATH 18,A01,083743,Staff,3,0,30,27
1650361621728,MATH 18,A02,083744,Staff,27,0,30,3
1650361621728,MATH 18,A03,083745,Staff,22,0,30,8
1650361621728,MATH 18,A04,083746,Staff,27,0,30,3
1650361621728,MATH 18,B01,083748,Staff,0,11,30,30
1650361621728,MATH 18,B02,083749,Staff,0,11,30,30
1650361621728,MATH 18,B03,083750,Staff,0,11,30,30
1650361621728,MATH 18,B04,083751,Staff,0,9,30,30
1650361627752,MATH 20A,A01,083754,Staff,26,0,40,14
1650361633777,MATH 20B,A01,083756,Staff,0,8,30,30
1650361633777,MATH 20B,A02,083757,Staff,0,8,30,30
1650361639800,MATH 20C,A01,083760,Staff,0,14,30,30
1650361639800,MATH 20C,A02,083761,Staff,0,15,30,30
1650361639800,MATH 20C,B01,083762,Staff,13,0,30,17
1650361639800,MATH 20C,B02,083763,Staff,28,0,30,2
1650361645824,MATH 20D,A01,083765,Staff,0,1,30,30
1650361645824,MATH 20D,A02,083766,Staff,7,0,30,23
1650361645824,MATH 20D,A03,083767,Staff,26,0,30,4
1650361651850,MATH 20E,A01,083771,Staff,5,0,30,25
1650361651850,MATH 20E,A02,083772,Staff,19,0,30,11
1650361651850,MATH 20E,B01,083773,Staff,0,0,30,30
1650361651850,MATH 20E,B02,083774,Staff,12,0,30,18
1650361657876,MATH 103A,A01,083777,Staff,0,11,30,30
1650361657876,MATH 103A,A02,083778,Staff,0,12,30,30
1650361657876,MATH 103A,B01,083779,Staff,0,13,30,30
1650361657876,MATH 103A,B02,083780,Staff,0,11,30,30
1650361663909,MATH 105,A01,085443,Staff,0,21,30,30
1650361669937,MATH 109,A01,083213,Anzaldo; Leesa B,0,6,30,30
1650361669937,MATH 109,A02,083214,Anzaldo; Leesa B,0,7,30,30
1650361669937,MATH 109,B01,083215,Anzaldo; Leesa B,0,5,30,30
1650361669937,MATH 109,B02,083216,Anzaldo; Leesa B,0,5,30,30
1650361675962,MATH 142A,A01,083219,Chow; Bennett,0,14,30,30
1650361675962,MATH 142A,A02,083220,Chow; Bennett,0,12,30,30
1650361675962,MATH 142A,B01,083221,Chow; Bennett,0,12,30,30
1650361675962,MATH 142A,B02,083222,Chow; Bennett,0,12,30,30
1650361681990,MATH 193A,A01,083224,Staff,0,5,30,30
1650361681990,MATH 193A,A02,083225,Staff,0,5,30,30
1650361681990,MATH 193A,A03,083781,Staff,0,4,30,30
1650361681990,MATH 193A,A04,083782,Staff,0,3,30,30
1650361688013,MATH 197,001,091859,McAuley; Julian John,9998,0,9999,1
1650361694069,COGS 9,A01,083615,Staff,0,14,60,60
1650361700092,COGS 11,A01,083617,Boyle; Mary E. T.,22,0,40,18
1650361706121,COGS 13,A01,083071,Staff,0,32,40,40
1650361712155,COGS 14A,A01,092681,Staff,0,21,100,100
1650361718180,COGS 14B,A01,083073,Cheng; Tzu-Han,0,10,50,50
1650361724205,COGS 17,A01,092677,Staff,24,0,75,51
1650361730242,COGS 100,A01,083619,Staff,0,24,60,60
1650361736272,COGS 101A,A01,083621,Davis; Joshua Daniel,0,21,60,60
1650361742297,COGS 101B,A01,091572,Staff,0,0,60,60
1650361748323,COGS 101C,A01,083625,Delgado; Tania,17,0,30,13
1650361754352,COGS 107A,A01,083627,Boyle; Mary E. T.,0,10,60,60
1650361760394,COGS 118A,A01,083075,Staff,4,0,60,56
1650361766423,CSE 3,A50,083646,Miranda; Gregory Joseph,21,0,38,17
1650361766423,CSE 3,A51,083647,Miranda; Gregory Joseph,37,0,37,0
1650361772460,CSE 8A,A50,083650,Miranda; Gregory Joseph,0,28,40,40
1650361778484,CSE 11,A01,083080,Cao; Yingjun,0,88,40,40
1650361784516,CSE 12,A01,083652,Staff,0,12,100,100
1650361790540,CSE 15L,A01,083654,Staff,0,1,50,50
1650361790540,CSE 15L,A02,083655,Staff,3,0,50,47
1650361796564,CSE 20,A01,083657,Staff,52,0,80,28
1650361802588,CSE 30,A01,083084,Eldon; John,0,76,40,40
1650361808628,CSE 100,A01,083659,Cao; Yingjun,0,66,50,50
1650361814655,CSE 134B,A01,083661,Powell; Thomas Allan,0,31,65,65
1650361820692,CSE 140,A01,083663,Staff,0,0,75,75
1650361826719,CSE 140L,A01,083088,Eldon; John,0,7,75,75
1650361832746,CSE 175,A01,083665,Kumar; Rakesh,8,0,25,17
1650361838769,CSE 190,A00,092507,Dubnov; Shlomo,14,0,20,6
1650361844793,ECE 45,A01,083139,Staff,0,17,40,40
1650361850818,ECE 65,A50,083695,Staff,0,5,30,30
1650361856842,ECE 109,A01,091882,Touri; Behrouz,40,0,70,30
1650361862873,ECE 180,A00,083140,Abi Samra; Nicholas Camill,23,0,30,7
1650361862873,ECE 180,B00,083141,Abi Samra; Nicholas Camill,5,0,30,25
1650361868896,MATH 10A,A01,083735,Patchell; Gregory David,7,0,30,23
1650361868896,MATH 10A,A02,083736,Patchell; Gregory David,28,0,30,2
1650361868896,MATH 10A,A03,083737,Patchell; Gregory David,25,0,30,5
1650361874935,MATH 10B,A01,083207,Staff,0,7,30,30
1650361874935,MATH 10B,A02,083208,Staff,0,6,30,30
1650361874935,MATH 10B,B01,083739,Staff,17,0,30,13
1650361874935,MATH 10B,B02,083740,Staff,28,0,30,2
1650361880960,MATH 18,A01,083743,Staff,3,0,30,27
1650361880960,MATH 18,A02,083744,Staff,27,0,30,3
1650361880960,MATH 18,A03,083745,Staff,22,0,30,8
1650361880960,MATH 18,A04,083746,Staff,27,0,30,3
1650361880960,MATH 18,B01,083748,Staff,0,11,30,30
1650361880960,MATH 18,B02,083749,Staff,0,11,30,30
1650361880960,MATH 18,B03,083750,Staff,0,11,30,30
1650361880960,MATH 18,B04,083751,Staff,0,9,30,30
1650361886995,MATH 20A,A01,083754,Staff,26,0,40,14
1650361893022,MATH 20B,A01,083756,Staff,0,8,30,30
1650361893022,MATH 20B,A02,083757,Staff,0,8,30,30
1650361899049,MATH 20C,A01,083760,Staff,0,14,30,30
1650361899049,MATH 20C,A02,083761,Staff,0,15,30,30
1650361899049,MATH 20C,B01,083762,Staff,13,0,30,17
1650361899049,MATH 20C,B02,083763,Staff,28,0,30,2
1650361905073,MATH 20D,A01,083765,Staff,0,1,30,30
1650361905073,MATH 20D,A02,083766,Staff,7,0,30,23
1650361905073,MATH 20D,A03,083767,Staff,26,0,30,4
1650361911096,MATH 20E,A01,083771,Staff,5,0,30,25
1650361911096,MATH 20E,A02,083772,Staff,19,0,30,11
1650361911096,MATH 20E,B01,083773,Staff,0,0,30,30
1650361911096,MATH 20E,B02,083774,Staff,12,0,30,18
1650361917123,MATH 103A,A01,083777,Staff,0,11,30,30
1650361917123,MATH 103A,A02,083778,Staff,0,12,30,30
1650361917123,MATH 103A,B01,083779,Staff,0,13,30,30
1650361917123,MATH 103A,B02,083780,Staff,0,11,30,30
1650361923148,MATH 105,A01,085443,Staff,0,21,30,30
1650361929173,MATH 109,A01,083213,Anzaldo; Leesa B,0,6,30,30
1650361929173,MATH 109,A02,083214,Anzaldo; Leesa B,0,7,30,30
1650361929173,MATH 109,B01,083215,Anzaldo; Leesa B,0,5,30,30
1650361929173,MATH 109,B02,083216,Anzaldo; Leesa B,0,5,30,30
1650361935212,MATH 142A,A01,083219,Chow; Bennett,0,14,30,30
1650361935212,MATH 142A,A02,083220,Chow; Bennett,0,12,30,30
1650361935212,MATH 142A,B01,083221,Chow; Bennett,0,12,30,30
1650361935212,MATH 142A,B02,083222,Chow; Bennett,0,12,30,30
1650361941240,MATH 193A,A01,083224,Staff,0,5,30,30
1650361941240,MATH 193A,A02,083225,Staff,0,5,30,30
1650361941240,MATH 193A,A03,083781,Staff,0,4,30,30
1650361941240,MATH 193A,A04,083782,Staff,0,3,30,30
1650361947263,MATH 197,001,091859,McAuley; Julian John,9998,0,9999,1
1650361953316,COGS 9,A01,083615,Staff,0,14,60,60
1650361959342,COGS 11,A01,083617,Boyle; Mary E. T.,22,0,40,18
1650361965369,COGS 13,A01,083071,Staff,0,32,40,40
1650361971400,COGS 14A,A01,092681,Staff,0,21,100,100
1650361977520,COGS 14B,A01,083073,Cheng; Tzu-Han,0,10,50,50
1650361983546,COGS 17,A01,092677,Staff,24,0,75,51
1650361989569,COGS 100,A01,083619,Staff,0,24,60,60
1650361995592,COGS 101A,A01,083621,Davis; Joshua Daniel,0,21,60,60
1650362001617,COGS 101B,A01,091572,Staff,0,0,60,60
1650362007640,COGS 101C,A01,083625,Delgado; Tania,17,0,30,13
1650362013667,COGS 107A,A01,083627,Boyle; Mary E. T.,0,10,60,60
1650362019690,COGS 118A,A01,083075,Staff,4,0,60,56
1650362025740,CSE 3,A50,083646,Miranda; Gregory Joseph,21,0,38,17
1650362025740,CSE 3,A51,083647,Miranda; Gregory Joseph,37,0,37,0
1650362031763,CSE 8A,A50,083650,Miranda; Gregory Joseph,0,28,40,40
1650362037788,CSE 11,A01,083080,Cao; Yingjun,0,88,40,40
1650362043815,CSE 12,A01,083652,Staff,0,12,100,100
1650362049839,CSE 15L,A01,083654,Staff,0,1,50,50
1650362049839,CSE 15L,A02,083655,Staff,3,0,50,47
1650362055864,CSE 20,A01,083657,Staff,52,0,80,28
1650362061887,CSE 30,A01,083084,Eldon; John,0,76,40,40
1650362067914,CSE 100,A01,083659,Cao; Yingjun,0,66,50,50
1650362073937,CSE 134B,A01,083661,Powell; Thomas Allan,0,31,65,65
1650362079964,CSE 140,A01,083663,Staff,0,0,75,75
1650362085989,CSE 140L,A01,083088,Eldon; John,0,7,75,75
1650362092012,CSE 175,A01,083665,Kumar; Rakesh,8,0,25,17
1650362098046,CSE 190,A00,092507,Dubnov; Shlomo,14,0,20,6
1650362104073,ECE 45,A01,083139,Staff,0,17,40,40
1650362110096,ECE 65,A50,083695,Staff,0,5,30,30
1650362116123,ECE 109,A01,091882,Touri; Behrouz,40,0,70,30
1650362122150,ECE 180,A00,083140,Abi Samra; Nicholas Camill,23,0,30,7
1650362122150,ECE 180,B00,083141,Abi Samra; Nicholas Camill,5,0,30,25
1650362128175,MATH 10A,A01,083735,Patchell; Gregory David,7,0,30,23
1650362128175,MATH 10A,A02,083736,Patchell; Gregory David,28,0,30,2
1650362128175,MATH 10A,A03,083737,Patchell; Gregory David,25,0,30,5
1650362134200,MATH 10B,A01,083207,Staff,0,7,30,30
1650362134200,MATH 10B,A02,083208,Staff,0,6,30,30
1650362134200,MATH 10B,B01,083739,Staff,17,0,30,13
1650362134200,MATH 10B,B02,083740,Staff,28,0,30,2
1650362140230,MATH 18,A01,083743,Staff,3,0,30,27
1650362140230,MATH 18,A02,083744,Staff,27,0,30,3
1650362140230,MATH 18,A03,083745,Staff,22,0,30,8
1650362140230,MATH 18,A04,083746,Staff,27,0,30,3
1650362140230,MATH 18,B01,083748,Staff,0,11,30,30
1650362140230,MATH 18,B02,083749,Staff,0,11,30,30
1650362140230,MATH 18,B03,083750,Staff,0,11,30,30
1650362140230,MATH 18,B04,083751,Staff,0,9,30,30
1650362146257,MATH 20A,A01,083754,Staff,26,0,40,14
1650362152282,MATH 20B,A01,083756,Staff,0,8,30,30
1650362152282,MATH 20B,A02,083757,Staff,0,8,30,30
1650362158313,MATH 20C,A01,083760,Staff,0,14,30,30
1650362158313,MATH 20C,A02,083761,Staff,0,15,30,30
1650362158313,MATH 20C,B01,083762,Staff,13,0,30,17
1650362158313,MATH 20C,B02,083763,Staff,28,0,30,2
1650362164337,MATH 20D,A01,083765,Staff,0,1,30,30
1650362164337,MATH 20D,A02,083766,Staff,7,0,30,23
1650362164337,MATH 20D,A03,083767,Staff,26,0,30,4
1650362170361,MATH 20E,A01,083771,Staff,5,0,30,25
1650362170361,MATH 20E,A02,083772,Staff,19,0,30,11
1650362170361,MATH 20E,B01,083773,Staff,0,0,30,30
1650362170361,MATH 20E,B02,083774,Staff,12,0,30,18
1650362176389,MATH 103A,A01,083777,Staff,0,11,30,30
1650362176389,MATH 103A,A02,083778,Staff,0,12,30,30
1650362176389,MATH 103A,B01,083779,Staff,0,13,30,30
1650362176389,MATH 103A,B02,083780,Staff,0,11,30,30
1650362182413,MATH 105,A01,085443,Staff,0,21,30,30
1650362188438,MATH 109,A01,083213,Anzaldo; Leesa B,0,6,30,30
1650362188438,MATH 109,A02,083214,Anzaldo; Leesa B,0,7,30,30
1650362188438,MATH 109,B01,083215,Anzaldo; Leesa B,0,5,30,30
1650362188438,MATH 109,B02,083216,Anzaldo; Leesa B,0,5,30,30
1650362194467,MATH 142A,A01,083219,Chow; Bennett,0,14,30,30
1650362194467,MATH 142A,A02,083220,Chow; Bennett,0,12,30,30
1650362194467,MATH 142A,B01,083221,Chow; Bennett,0,12,30,30
1650362194467,MATH 142A,B02,083222,Chow; Bennett,0,12,30,30
1650362200490,MATH 193A,A01,083224,Staff,0,5,30,30
1650362200490,MATH 193A,A02,083225,Staff,0,5,30,30
1650362200490,MATH 193A,A03,083781,Staff,0,4,30,30
1650362200490,MATH 193A,A04,083782,Staff,0,3,30,30
1650362206514,MATH 197,001,091859,McAuley; Julian John,9998,0,9999,1
1650362212568,COGS 9,A01,083615,Staff,0,14,60,60
1650362218592,COGS 11,A01,083617,Boyle; Mary E. T.,22,0,40,18
1650362224618,COGS 13,A01,083071,Staff,0,32,40,40
1650362230646,COGS 14A,A01,092681,Staff,0,21,100,100
1650362236672,COGS 14B,A01,083073,Cheng; Tzu-Han,0,10,50,50
1650362242696,COGS 17,A01,092677,Staff,24,0,75,51
1650362248730,COGS 100,A01,083619,Staff,0,24,60,60
1650362254762,COGS 101A,A01,083621,Davis; Joshua Daniel,0,21,60,60
1650362260799,COGS 101B,A01,091572,Staff,0,0,60,60
1650362266824,COGS 101C,A01,083625,Delgado; Tania,17,0,30,13
1650362272849,COGS 107A,A01,083627,Boyle; Mary E. T.,0,10,60,60
1650362278873,COGS 118A,A01,083075,Staff,4,0,60,56
1650362284901,CSE 3,A50,083646,Miranda; Gregory Joseph,21,0,38,17
1650362284901,CSE 3,A51,083647,Miranda; Gregory Joseph,37,0,37,0
1650362290925,CSE 8A,A50,083650,Miranda; Gregory Joseph,0,28,40,40
1650362296953,CSE 11,A01,083080,Cao; Yingjun,0,88,40,40
1650362302978,CSE 12,A01,083652,Staff,0,12,100,100
1650362309005,CSE 15L,A01,083654,Staff,0,1,50,50
1650362309005,CSE 15L,A02,083655,Staff,3,0,50,47
1650362315031,CSE 20,A01,083657,Staff,52,0,80,28
1650362321067,CSE 30,A01,083084,Eldon; John,0,76,40,40
1650362327091,CSE 100,A01,083659,Cao; Yingjun,0,66,50,50
1650362333116,CSE 134B,A01,083661,Powell; Thomas Allan,0,31,65,65
1650362339141,CSE 140,A01,083663,Staff,0,0,75,75
1650362345170,CSE 140L,A01,083088,Eldon; John,0,7,75,75
1650362351197,CSE 175,A01,083665,Kumar; Rakesh,8,0,25,17
1650362357222,CSE 190,A00,092507,Dubnov; Shlomo,14,0,20,6
1650362363246,ECE 45,A01,083139,Staff,0,17,40,40
1650362369270,ECE 65,A50,083695,Staff,0,5,30,30
1650362375296,ECE 109,A01,091882,Touri; Behrouz,40,0,70,30
1650362381319,ECE 180,A00,083140,Abi Samra; Nicholas Camill,23,0,30,7
1650362381319,ECE 180,B00,083141,Abi Samra; Nicholas Camill,5,0,30,25
1650362387343,MATH 10A,A01,083735,Patchell; Gregory David,7,0,30,23
1650362387343,MATH 10A,A02,083736,Patchell; Gregory David,28,0,30,2
1650362387343,MATH 10A,A03,083737,Patchell; Gregory David,25,0,30,5
1650362393368,MATH 10B,A01,083207,Staff,0,7,30,30
1650362393368,MATH 10B,A02,083208,Staff,0,6,30,30
1650362393368,MATH 10B,B01,083739,Staff,17,0,30,13
1650362393368,MATH 10B,B02,083740,Staff,28,0,30,2
1650362399392,MATH 18,A01,083743,Staff,3,0,30,27
1650362399392,MATH 18,A02,083744,Staff,27,0,30,3
1650362399392,MATH 18,A03,083745,Staff,22,0,30,8
1650362399392,MATH 18,A04,083746,Staff,27,0,30,3
1650362399392,MATH 18,B01,083748,Staff,0,11,30,30
1650362399392,MATH 18,B02,083749,Staff,0,11,30,30
1650362399392,MATH 18,B03,083750,Staff,0,11,30,30
1650362399392,MATH 18,B04,083751,Staff,0,9,30,30
1650362405421,MATH 20A,A01,083754,Staff,26,0,40,14
1650362411447,MATH 20B,A01,083756,Staff,0,8,30,30
1650362411447,MATH 20B,A02,083757,Staff,0,8,30,30
1650362417473,MATH 20C,A01,083760,Staff,0,14,30,30
1650362417473,MATH 20C,A02,083761,Staff,0,15,30,30
1650362417473,MATH 20C,B01,083762,Staff,13,0,30,17
1650362417473,MATH 20C,B02,083763,Staff,28,0,30,2
1650362423496,MATH 20D,A01,083765,Staff,0,1,30,30
1650362423496,MATH 20D,A02,083766,Staff,7,0,30,23
1650362423496,MATH 20D,A03,083767,Staff,26,0,30,4
1650362429520,MATH 20E,A01,083771,Staff,5,0,30,25
1650362429520,MATH 20E,A02,083772,Staff,19,0,30,11
1650362429520,MATH 20E,B01,083773,Staff,0,0,30,30
1650362429520,MATH 20E,B02,083774,Staff,12,0,30,18
1650362435547,MATH 103A,A01,083777,Staff,0,11,30,30
1650362435547,MATH 103A,A02,083778,Staff,0,12,30,30
1650362435547,MATH 103A,B01,083779,Staff,0,13,30,30
1650362435547,MATH 103A,B02,083780,Staff,0,11,30,30
1650362441572,MATH 105,A01,085443,Staff,0,21,30,30
1650362447596,MATH 109,A01,083213,Anzaldo; Leesa B,0,6,30,30
1650362447596,MATH 109,A02,083214,Anzaldo; Leesa B,0,7,30,30
1650362447596,MATH 109,B01,083215,Anzaldo; Leesa B,0,5,30,30
1650362447596,MATH 109,B02,083216,Anzaldo; Leesa B,0,5,30,30
1650362453623,MATH 142A,A01,083219,Chow; Bennett,0,14,30,30
1650362453623,MATH 142A,A02,083220,Chow; Bennett,0,12,30,30
1650362453623,MATH 142A,B01,083221,Chow; Bennett,0,12,30,30
1650362453623,MATH 142A,B02,083222,Chow; Bennett,0,12,30,30
1650362459647,MATH 193A,A01,083224,Staff,0,5,30,30
1650362459647,MATH 193A,A02,083225,Staff,0,5,30,30
1650362459647,MATH 193A,A03,083781,Staff,0,4,30,30
1650362459647,MATH 193A,A04,083782,Staff,0,3,30,30
1650362465671,MATH 197,001,091859,McAuley; Julian John,9998,0,9999,1
1650362471731,COGS 9,A01,083615,Staff,0,14,60,60
1650362477755,COGS 11,A01,083617,Boyle; Mary E. T.,22,0,40,18
1650362483780,COGS 13,A01,083071,Staff,0,32,40,40
1650362489806,COGS 14A,A01,092681,Staff,0,21,100,100
1650362495830,COGS 14B,A01,083073,Cheng; Tzu-Han,0,10,50,50
1650362501854,COGS 17,A01,092677,Staff,24,0,75,51
1650362507879,COGS 100,A01,083619,Staff,0,24,60,60
1650362513909,COGS 101A,A01,083621,Davis; Joshua Daniel,0,21,60,60
1650362519933,COGS 101B,A01,091572,Staff,0,0,60,60
1650362525957,COGS 101C,A01,083625,Delgado; Tania,17,0,30,13
1650362531986,COGS 107A,A01,083627,Boyle; Mary E. T.,0,10,60,60
1650362538012,COGS 118A,A01,083075,Staff,4,0,60,56
1650362544040,CSE 3,A50,083646,Miranda; Gregory Joseph,21,0,38,17
1650362544040,CSE 3,A51,083647,Miranda; Gregory Joseph,37,0,37,0
1650362550067,CSE 8A,A50,083650,Miranda; Gregory Joseph,0,28,40,40
1650362556094,CSE 11,A01,083080,Cao; Yingjun,0,88,40,40
1650362562118,CSE 12,A01,083652,Staff,0,12,100,100
1650362568145,CSE 15L,A01,083654,Staff,0,1,50,50
1650362568145,CSE 15L,A02,083655,Staff,3,0,50,47
1650362574260,CSE 20,A01,083657,Staff,52,0,80,28
1650362580290,CSE 30,A01,083084,Eldon; John,0,76,40,40
1650362586323,CSE 100,A01,083659,Cao; Yingjun,0,66,50,50
1650362592348,CSE 134B,A01,083661,Powell; Thomas Allan,0,31,65,65
1650362598369,CSE 140,A01,083663,Staff,0,0,75,75
1650362604394,CSE 140L,A01,083088,Eldon; John,0,7,75,75
1650362610417,CSE 175,A01,083665,Kumar; Rakesh,8,0,25,17
1650362616440,CSE 190,A00,092507,Dubnov; Shlomo,14,0,20,6
1650362622468,ECE 45,A01,083139,Staff,0,17,40,40
1650362628489,ECE 65,A50,083695,Staff,0,5,30,30
1650362634512,ECE 109,A01,091882,Touri; Behrouz,40,0,70,30
1650362640534,ECE 180,A00,083140,Abi Samra; Nicholas Camill,23,0,30,7
1650362640534,ECE 180,B00,083141,Abi Samra; Nicholas Camill,5,0,30,25
1650362646575,MATH 10A,A01,083735,Patchell; Gregory David,7,0,30,23
1650362646575,MATH 10A,A02,083736,Patchell; Gregory David,28,0,30,2
1650362646575,MATH 10A,A03,083737,Patchell; Gregory David,25,0,30,5
1650362652598,MATH 10B,A01,083207,Staff,0,7,30,30
1650362652598,MATH 10B,A02,083208,Staff,0,6,30,30
1650362652598,MATH 10B,B01,083739,Staff,17,0,30,13
1650362652598,MATH 10B,B02,083740,Staff,28,0,30,2
1650362658626,MATH 18,A01,083743,Staff,3,0,30,27
1650362658626,MATH 18,A02,083744,Staff,27,0,30,3
1650362658626,MATH 18,A03,083745,Staff,22,0,30,8
1650362658626,MATH 18,A04,083746,Staff,27,0,30,3
1650362658626,MATH 18,B01,083748,Staff,0,11,30,30
1650362658626,MATH 18,B02,083749,Staff,0,11,30,30
1650362658626,MATH 18,B03,083750,Staff,0,11,30,30
1650362658626,MATH 18,B04,083751,Staff,0,9,30,30
1650362664649,MATH 20A,A01,083754,Staff,26,0,40,14
1650362670673,MATH 20B,A01,083756,Staff,0,8,30,30
1650362670673,MATH 20B,A02,083757,Staff,0,8,30,30
1650362676698,MATH 20C,A01,083760,Staff,0,14,30,30
1650362676698,MATH 20C,A02,083761,Staff,0,15,30,30
1650362676698,MATH 20C,B01,083762,Staff,13,0,30,17
1650362676698,MATH 20C,B02,083763,Staff,28,0,30,2
1650362682720,MATH 20D,A01,083765,Staff,0,1,30,30
1650362682720,MATH 20D,A02,083766,Staff,7,0,30,23
1650362682720,MATH 20D,A03,083767,Staff,26,0,30,4
1650362688744,MATH 20E,A01,083771,Staff,5,0,30,25
1650362688744,MATH 20E,A02,083772,Staff,19,0,30,11
1650362688744,MATH 20E,B01,083773,Staff,0,0,30,30
1650362688744,MATH 20E,B02,083774,Staff,12,0,30,18
1650362694768,MATH 103A,A01,083777,Staff,0,11,30,30
1650362694768,MATH 103A,A02,083778,Staff,0,12,30,30
1650362694768,MATH 103A,B01,083779,Staff,0,13,30,30
1650362694768,MATH 103A,B02,083780,Staff,0,11,30,30
1650362700798,MATH 105,A01,085443,Staff,0,21,30,30
1650362706827,MATH 109,A01,083213,Anzaldo; Leesa B,0,6,30,30
1650362706827,MATH 109,A02,083214,Anzaldo; Leesa B,0,7,30,30
1650362706827,MATH 109,B01,083215,Anzaldo; Leesa B,0,5,30,30
1650362706827,MATH 109,B02,083216,Anzaldo; Leesa B,0,5,30,30
1650362712856,MATH 142A,A01,083219,Chow; Bennett,0,14,30,30
1650362712856,MATH 142A,A02,083220,Chow; Bennett,0,12,30,30
1650362712856,MATH 142A,B01,083221,Chow; Bennett,0,12,30,30
1650362712856,MATH 142A,B02,083222,Chow; Bennett,0,12,30,30
1650362718883,MATH 193A,A01,083224,Staff,0,5,30,30
1650362718883,MATH 193A,A02,083225,Staff,0,5,30,30
1650362718883,MATH 193A,A03,083781,Staff,0,4,30,30
1650362718883,MATH 193A,A04,083782,Staff,0,3,30,30
1650362724910,MATH 197,001,091859,McAuley; Julian John,9998,0,9999,1
1650362730969,COGS 9,A01,083615,Staff,0,14,60,60
1650362736997,COGS 11,A01,083617,Boyle; Mary E. T.,22,0,40,18
1650362743023,COGS 13,A01,083071,Staff,0,32,40,40
1650362749047,COGS 14A,A01,092681,Staff,0,21,100,100
1650362755072,COGS 14B,A01,083073,Cheng; Tzu-Han,0,10,50,50
1650362761096,COGS 17,A01,092677,Staff,24,0,75,51
1650362767122,COGS 100,A01,083619,Staff,0,24,60,60
1650362773146,COGS 101A,A01,083621,Davis; Joshua Daniel,0,21,60,60
1650362779183,COGS 101B,A01,091572,Staff,0,0,60,60
1650362785207,COGS 101C,A01,083625,Delgado; Tania,17,0,30,13
1650362791234,COGS 107A,A01,083627,Boyle; Mary E. T.,0,10,60,60
1650362797261,COGS 118A,A01,083075,Staff,4,0,60,56
1650362803290,CSE 3,A50,083646,Miranda; Gregory Joseph,21,0,38,17
1650362803290,CSE 3,A51,083647,Miranda; Gregory Joseph,37,0,37,0
1650362809315,CSE 8A,A50,083650,Miranda; Gregory Joseph,0,28,40,40
1650362815341,CSE 11,A01,083080,Cao; Yingjun,0,88,40,40
1650362821369,CSE 12,A01,083652,Staff,0,12,100,100
1650362827393,CSE 15L,A01,083654,Staff,0,1,50,50
1650362827393,CSE 15L,A02,083655,Staff,3,0,50,47
1650362833418,CSE 20,A01,083657,Staff,52,0,80,28
1650362839445,CSE 30,A01,083084,Eldon; John,0,76,40,40
1650362845472,CSE 100,A01,083659,Cao; Yingjun,0,66,50,50
1650362851498,CSE 134B,A01,083661,Powell; Thomas Allan,0,31,65,65
1650362857524,CSE 140,A01,083663,Staff,0,0,75,75
1650362863551,CSE 140L,A01,083088,Eldon; John,0,7,75,75
1650362869576,CSE 175,A01,083665,Kumar; Rakesh,8,0,25,17
1650362875603,CSE 190,A00,092507,Dubnov; Shlomo,14,0,20,6
1650362881629,ECE 45,A01,083139,Staff,0,17,40,40
1650362887654,ECE 65,A50,083695,Staff,0,5,30,30
1650362893677,ECE 109,A01,091882,Touri; Behrouz,40,0,70,30
1650362899701,ECE 180,A00,083140,Abi Samra; Nicholas Camill,23,0,30,7
1650362899701,ECE 180,B00,083141,Abi Samra; Nicholas Camill,5,0,30,25
1650362905723,MATH 10A,A01,083735,Patchell; Gregory David,7,0,30,23
1650362905723,MATH 10A,A02,083736,Patchell; Gregory David,28,0,30,2
1650362905723,MATH 10A,A03,083737,Patchell; Gregory David,25,0,30,5
1650362911748,MATH 10B,A01,083207,Staff,0,7,30,30
1650362911748,MATH 10B,A02,083208,Staff,0,6,30,30
1650362911748,MATH 10B,B01,083739,Staff,17,0,30,13
1650362911748,MATH 10B,B02,083740,Staff,28,0,30,2
1650362917775,MATH 18,A01,083743,Staff,3,0,30,27
1650362917775,MATH 18,A02,083744,Staff,27,0,30,3
1650362917775,MATH 18,A03,083745,Staff,22,0,30,8
1650362917775,MATH 18,A04,083746,Staff,27,0,30,3
1650362917775,MATH 18,B01,083748,Staff,0,11,30,30
1650362917775,MATH 18,B02,083749,Staff,0,11,30,30
1650362917775,MATH 18,B03,083750,Staff,0,11,30,30
1650362917775,MATH 18,B04,083751,Staff,0,9,30,30
1650362923798,MATH 20A,A01,083754,Staff,26,0,40,14
1650362929831,MATH 20B,A01,083756,Staff,0,8,30,30
1650362929831,MATH 20B,A02,083757,Staff,0,8,30,30
1650362935853,MATH 20C,A01,083760,Staff,0,14,30,30
1650362935853,MATH 20C,A02,083761,Staff,0,15,30,30
1650362935853,MATH 20C,B01,083762,Staff,13,0,30,17
1650362935853,MATH 20C,B02,083763,Staff,28,0,30,2
1650362941880,MATH 20D,A01,083765,Staff,0,1,30,30
1650362941880,MATH 20D,A02,083766,Staff,7,0,30,23
1650362941880,MATH 20D,A03,083767,Staff,26,0,30,4
1650362947903,MATH 20E,A01,083771,Staff,5,0,30,25
1650362947903,MATH 20E,A02,083772,Staff,19,0,30,11
1650362947903,MATH 20E,B01,083773,Staff,0,0,30,30
1650362947903,MATH 20E,B02,083774,Staff,12,0,30,18
1650362953934,MATH 103A,A01,083777,Staff,0,11,30,30
1650362953934,MATH 103A,A02,083778,Staff,0,12,30,30
1650362953934,MATH 103A,B01,083779,Staff,0,13,30,30
1650362953934,MATH 103A,B02,083780,Staff,0,11,30,30
1650362959960,MATH 105,A01,085443,Staff,0,21,30,30
1650362965984,MATH 109,A01,083213,Anzaldo; Leesa B,0,6,30,30
1650362965984,MATH 109,A02,083214,Anzaldo; Leesa B,0,7,30,30
1650362965984,MATH 109,B01,083215,Anzaldo; Leesa B,0,5,30,30
1650362965984,MATH 109,B02,083216,Anzaldo; Leesa B,0,5,30,30
1650362972009,MATH 142A,A01,083219,Chow; Bennett,0,14,30,30
1650362972009,MATH 142A,A02,083220,Chow; Bennett,0,12,30,30
1650362972009,MATH 142A,B01,083221,Chow; Bennett,0,12,30,30
1650362972009,MATH 142A,B02,083222,Chow; Bennett,0,12,30,30
1650362978032,MATH 193A,A01,083224,Staff,0,5,30,30
1650362978032,MATH 193A,A02,083225,Staff,0,5,30,30
1650362978032,MATH 193A,A03,083781,Staff,0,4,30,30
1650362978032,MATH 193A,A04,083782,Staff,0,3,30,30
1650362984055,MATH 197,001,091859,McAuley; Julian John,9998,0,9999,1
1650362990107,COGS 9,A01,083615,Staff,0,14,60,60
1650362996134,COGS 11,A01,083617,Boyle; Mary E. T.,22,0,40,18
1650363002158,COGS 13,A01,083071,Staff,0,32,40,40
1650363008185,COGS 14A,A01,092681,Staff,0,21,100,100
1650363014213,COGS 14B,A01,083073,Cheng; Tzu-Han,0,10,50,50
1650363020240,COGS 17,A01,092677,Staff,24,0,75,51
1650363026267,COGS 100,A01,083619,Staff,0,24,60,60
1650363032290,COGS 101A,A01,083621,Davis; Joshua Daniel,0,21,60,60
1650363038316,COGS 101B,A01,091572,Staff,0,0,60,60
1650363044339,COGS 101C,A01,083625,Delgado; Tania,17,0,30,13
1650363050363,COGS 107A,A01,083627,Boyle; Mary E. T.,0,10,60,60
1650363056385,COGS 118A,A01,083075,Staff,4,0,60,56
1650363062412,CSE 3,A50,083646,Miranda; Gregory Joseph,21,0,38,17
1650363062412,CSE 3,A51,083647,Miranda; Gregory Joseph,37,0,37,0
1650363068436,CSE 8A,A50,083650,Miranda; Gregory Joseph,0,28,40,40
1650363074462,CSE 11,A01,083080,Cao; Yingjun,0,88,40,40
1650363080490,CSE 12,A01,083652,Staff,0,12,100,100
1650363086514,CSE 15L,A01,083654,Staff,0,1,50,50
1650363086514,CSE 15L,A02,083655,Staff,3,0,50,47
1650363092541,CSE 20,A01,083657,Staff,52,0,80,28
1650363098564,CSE 30,A01,083084,Eldon; John,0,76,40,40
1650363104592,CSE 100,A01,083659,Cao; Yingjun,0,66,50,50
1650363110618,CSE 134B,A01,083661,Powell; Thomas Allan,0,31,65,65
1650363116642,CSE 140,A01,083663,Staff,0,0,75,75
1650363122666,CSE 140L,A01,083088,Eldon; John,0,7,75,75
1650363128693,CSE 175,A01,083665,Kumar; Rakesh,8,0,25,17
1650363134719,CSE 190,A00,092507,Dubnov; Shlomo,14,0,20,6
1650363140747,ECE 45,A01,083139,Staff,0,17,40,40
1650363146772,ECE 65,A50,083695,Staff,0,5,30,30
1650363152799,ECE 109,A01,091882,Touri; Behrouz,40,0,70,30
1650363158823,ECE 180,A00,083140,Abi Samra; Nicholas Camill,23,0,30,7
1650363158823,ECE 180,B00,083141,Abi Samra; Nicholas Camill,5,0,30,25
1650363164846,MATH 10A,A01,083735,Patchell; Gregory David,7,0,30,23
1650363164846,MATH 10A,A02,083736,Patchell; Gregory David,28,0,30,2
1650363164846,MATH 10A,A03,083737,Patchell; Gregory David,25,0,30,5
1650363170958,MATH 10B,A01,083207,Staff,0,7,30,30
1650363170958,MATH 10B,A02,083208,Staff,0,6,30,30
1650363170958,MATH 10B,B01,083739,Staff,17,0,30,13
1650363170958,MATH 10B,B02,083740,Staff,28,0,30,2
1650363176983,MATH 18,A01,083743,Staff,3,0,30,27
1650363176983,MATH 18,A02,083744,Staff,27,0,30,3
1650363176983,MATH 18,A03,083745,Staff,22,0,30,8
1650363176983,MATH 18,A04,083746,Staff,27,0,30,3
1650363176983,MATH 18,B01,083748,Staff,0,11,30,30
1650363176983,MATH 18,B02,083749,Staff,0,11,30,30
1650363176983,MATH 18,B03,083750,Staff,0,11,30,30
1650363176983,MATH 18,B04,083751,Staff,0,9,30,30
1650363183008,MATH 20A,A01,083754,Staff,26,0,40,14
1650363189035,MATH 20B,A01,083756,Staff,0,8,30,30
1650363189035,MATH 20B,A02,083757,Staff,0,8,30,30
1650363195063,MATH 20C,A01,083760,Staff,0,14,30,30
1650363195063,MATH 20C,A02,083761,Staff,0,15,30,30
1650363195063,MATH 20C,B01,083762,Staff,13,0,30,17
1650363195063,MATH 20C,B02,083763,Staff,28,0,30,2
1650363201086,MATH 20D,A01,083765,Staff,0,1,30,30
1650363201086,MATH 20D,A02,083766,Staff,7,0,30,23
1650363201086,MATH 20D,A03,083767,Staff,26,0,30,4
1650363207113,MATH 20E,A01,083771,Staff,5,0,30,25
1650363207113,MATH 20E,A02,083772,Staff,19,0,30,11
1650363207113,MATH 20E,B01,083773,Staff,0,0,30,30
1650363207113,MATH 20E,B02,083774,Staff,12,0,30,18
1650363213140,MATH 103A,A01,083777,Staff,0,11,30,30
1650363213140,MATH 103A,A02,083778,Staff,0,12,30,30
1650363213140,MATH 103A,B01,083779,Staff,0,13,30,30
1650363213140,MATH 103A,B02,083780,Staff,0,11,30,30
1650363219165,MATH 105,A01,085443,Staff,0,21,30,30
1650363225190,MATH 109,A01,083213,Anzaldo; Leesa B,0,6,30,30
1650363225190,MATH 109,A02,083214,Anzaldo; Leesa B,0,7,30,30
1650363225190,MATH 109,B01,083215,Anzaldo; Leesa B,0,5,30,30
1650363225190,MATH 109,B02,083216,Anzaldo; Leesa B,0,5,30,30
1650363231215,MATH 142A,A01,083219,Chow; Bennett,0,14,30,30
1650363231215,MATH 142A,A02,083220,Chow; Bennett,0,12,30,30
1650363231215,MATH 142A,B01,083221,Chow; Bennett,0,12,30,30
1650363231215,MATH 142A,B02,083222,Chow; Bennett,0,12,30,30
1650363237240,MATH 193A,A01,083224,Staff,0,5,30,30
1650363237240,MATH 193A,A02,083225,Staff,0,5,30,30
1650363237240,MATH 193A,A03,083781,Staff,0,4,30,30
1650363237240,MATH 193A,A04,083782,Staff,0,3,30,30
1650363243263,MATH 197,001,091859,McAuley; Julian John,9998,0,9999,1
1650363249311,COGS 9,A01,083615,Staff,0,14,60,60
1650363255334,COGS 11,A01,083617,Boyle; Mary E. T.,22,0,40,18
1650363261358,COGS 13,A01,083071,Staff,0,32,40,40
1650363267385,COGS 14A,A01,092681,Staff,0,21,100,100
1650363273408,COGS 14B,A01,083073,Cheng; Tzu-Han,0,10,50,50
1650363279431,COGS 17,A01,092677,Staff,24,0,75,51
1650363285459,COGS 100,A01,083619,Staff,0,24,60,60
1650363291487,COGS 101A,A01,083621,Davis; Joshua Daniel,0,21,60,60
1650363297512,COGS 101B,A01,091572,Staff,0,0,60,60
1650363303538,COGS 101C,A01,083625,Delgado; Tania,17,0,30,13
1650363309560,COGS 107A,A01,083627,Boyle; Mary E. T.,0,10,60,60
1650363315583,COGS 118A,A01,083075,Staff,4,0,60,56
1650363321607,CSE 3,A50,083646,Miranda; Gregory Joseph,21,0,38,17
1650363321607,CSE 3,A51,083647,Miranda; Gregory Joseph,37,0,37,0
1650363327633,CSE 8A,A50,083650,Miranda; Gregory Joseph,0,28,40,40
1650363333658,CSE 11,A01,083080,Cao; Yingjun,0,88,40,40
1650363339681,CSE 12,A01,083652,Staff,0,12,100,100
1650363345705,CSE 15L,A01,083654,Staff,0,1,50,50
1650363345705,CSE 15L,A02,083655,Staff,3,0,50,47
1650363351734,CSE 20,A01,083657,Staff,52,0,80,28
1650363357761,CSE 30,A01,083084,Eldon; John,0,76,40,40
1650363363788,CSE 100,A01,083659,Cao; Yingjun,0,66,50,50
1650363369813,CSE 134B,A01,083661,Powell; Thomas Allan,0,31,65,65
1650363375848,CSE 140,A01,083663,Staff,0,0,75,75
1650363381871,CSE 140L,A01,083088,Eldon; John,0,7,75,75
1650363387895,CSE 175,A01,083665,Kumar; Rakesh,8,0,25,17
1650363393920,CSE 190,A00,092507,Dubnov; Shlomo,14,0,20,6
1650363399944,ECE 45,A01,083139,Staff,0,17,40,40
1650363405972,ECE 65,A50,083695,Staff,0,5,30,30
1650363411999,ECE 109,A01,091882,Touri; Behrouz,40,0,70,30
1650363418024,ECE 180,A00,083140,Abi Samra; Nicholas Camill,23,0,30,7
1650363418024,ECE 180,B00,083141,Abi Samra; Nicholas Camill,5,0,30,25
1650363424050,MATH 10A,A01,083735,Patchell; Gregory David,7,0,30,23
1650363424050,MATH 10A,A02,083736,Patchell; Gregory David,28,0,30,2
1650363424050,MATH 10A,A03,083737,Patchell; Gregory David,25,0,30,5
1650363430081,MATH 10B,A01,083207,Staff,0,7,30,30
1650363430081,MATH 10B,A02,083208,Staff,0,6,30,30
1650363430081,MATH 10B,B01,083739,Staff,17,0,30,13
1650363430081,MATH 10B,B02,083740,Staff,28,0,30,2
1650363436109,MATH 18,A01,083743,Staff,3,0,30,27
1650363436109,MATH 18,A02,083744,Staff,27,0,30,3
1650363436109,MATH 18,A03,083745,Staff,22,0,30,8
1650363436109,MATH 18,A04,083746,Staff,27,0,30,3
1650363436109,MATH 18,B01,083748,Staff,0,11,30,30
1650363436109,MATH 18,B02,083749,Staff,0,11,30,30
1650363436109,MATH 18,B03,083750,Staff,0,11,30,30
1650363436109,MATH 18,B04,083751,Staff,0,9,30,30
1650363442133,MATH 20A,A01,083754,Staff,26,0,40,14
1650363448161,MATH 20B,A01,083756,Staff,0,8,30,30
1650363448161,MATH 20B,A02,083757,Staff,0,8,30,30
1650363454186,MATH 20C,A01,083760,Staff,0,14,30,30
1650363454186,MATH 20C,A02,083761,Staff,0,15,30,30
1650363454186,MATH 20C,B01,083762,Staff,13,0,30,17
1650363454186,MATH 20C,B02,083763,Staff,28,0,30,2
1650363460211,MATH 20D,A01,083765,Staff,0,1,30,30
1650363460211,MATH 20D,A02,083766,Staff,7,0,30,23
1650363460211,MATH 20D,A03,083767,Staff,26,0,30,4
1650363466236,MATH 20E,A01,083771,Staff,5,0,30,25
1650363466236,MATH 20E,A02,083772,Staff,19,0,30,11
1650363466236,MATH 20E,B01,083773,Staff,0,0,30,30
1650363466236,MATH 20E,B02,083774,Staff,12,0,30,18
1650363472265,MATH 103A,A01,083777,Staff,0,11,30,30
1650363472265,MATH 103A,A02,083778,Staff,0,12,30,30
1650363472265,MATH 103A,B01,083779,Staff,0,13,30,30
1650363472265,MATH 103A,B02,083780,Staff,0,11,30,30
1650363478293,MATH 105,A01,085443,Staff,0,21,30,30
1650363484323,MATH 109,A01,083213,Anzaldo; Leesa B,0,6,30,30
1650363484323,MATH 109,A02,083214,Anzaldo; Leesa B,0,7,30,30
1650363484323,MATH 109,B01,083215,Anzaldo; Leesa B,0,5,30,30
1650363484323,MATH 109,B02,083216,Anzaldo; Leesa B,0,5,30,30
1650363490355,MATH 142A,A01,083219,Chow; Bennett,0,14,30,30
1650363490355,MATH 142A,A02,083220,Chow; Bennett,0,12,30,30
1650363490355,MATH 142A,B01,083221,Chow; Bennett,0,12,30,30
1650363490355,MATH 142A,B02,083222,Chow; Bennett,0,12,30,30
1650363496384,MATH 193A,A01,083224,Staff,0,5,30,30
1650363496384,MATH 193A,A02,083225,Staff,0,5,30,30
1650363496384,MATH 193A,A03,083781,Staff,0,4,30,30
1650363496384,MATH 193A,A04,083782,Staff,0,3,30,30
1650363502410,MATH 197,001,091859,McAuley; Julian John,9998,0,9999,1
1650363508470,COGS 9,A01,083615,Staff,0,14,60,60
1650363514497,COGS 11,A01,083617,Boyle; Mary E. T.,22,0,40,18
1650363520522,COGS 13,A01,083071,Staff,0,32,40,40
1650363526560,COGS 14A,A01,092681,Staff,0,21,100,100
1650363532585,COGS 14B,A01,083073,Cheng; Tzu-Han,0,10,50,50
1650363538613,COGS 17,A01,092677,Staff,24,0,75,51
1650363544642,COGS 100,A01,083619,Staff,0,24,60,60
1650363550667,COGS 101A,A01,083621,Davis; Joshua Daniel,0,21,60,60
1650363556692,COGS 101B,A01,091572,Staff,0,0,60,60
1650363562720,COGS 101C,A01,083625,Delgado; Tania,17,0,30,13
1650363568743,COGS 107A,A01,083627,Boyle; Mary E. T.,0,10,60,60
1650363574775,COGS 118A,A01,083075,Staff,4,0,60,56
1650363580802,CSE 3,A50,083646,Miranda; Gregory Joseph,21,0,38,17
1650363580802,CSE 3,A51,083647,Miranda; Gregory Joseph,37,0,37,0
1650363586827,CSE 8A,A50,083650,Miranda; Gregory Joseph,0,28,40,40
1650363592854,CSE 11,A01,083080,Cao; Yingjun,0,88,40,40
1650363598879,CSE 12,A01,083652,Staff,0,12,100,100
1650363604907,CSE 15L,A01,083654,Staff,0,1,50,50
1650363604907,CSE 15L,A02,083655,Staff,3,0,50,47
1650363610931,CSE 20,A01,083657,Staff,52,0,80,28
1650363616956,CSE 30,A01,083084,Eldon; John,0,76,40,40
1650363622981,CSE 100,A01,083659,Cao; Yingjun,0,66,50,50
1650363629008,CSE 134B,A01,083661,Powell; Thomas Allan,0,31,65,65
1650363635035,CSE 140,A01,083663,Staff,0,0,75,75
1650363641061,CSE 140L,A01,083088,Eldon; John,0,7,75,75
1650363647086,CSE 175,A01,083665,Kumar; Rakesh,8,0,25,17
1650363653110,CSE 190,A00,092507,Dubnov; Shlomo,14,0,20,6
1650363659134,ECE 45,A01,083139,Staff,0,17,40,40
1650363665159,ECE 65,A50,083695,Staff,0,5,30,30
1650363671188,ECE 109,A01,091882,Touri; Behrouz,40,0,70,30
1650363677212,ECE 180,A00,083140,Abi Samra; Nicholas Camill,23,0,30,7
1650363677212,ECE 180,B00,083141,Abi Samra; Nicholas Camill,5,0,30,25
1650363683237,MATH 10A,A01,083735,Patchell; Gregory David,7,0,30,23
1650363683237,MATH 10A,A02,083736,Patchell; Gregory David,28,0,30,2
1650363683237,MATH 10A,A03,083737,Patchell; Gregory David,25,0,30,5
1650363689260,MATH 10B,A01,083207,Staff,0,7,30,30
1650363689260,MATH 10B,A02,083208,Staff,0,6,30,30
1650363689260,MATH 10B,B01,083739,Staff,17,0,30,13
1650363689260,MATH 10B,B02,083740,Staff,28,0,30,2
1650363695292,MATH 18,A01,083743,Staff,3,0,30,27
1650363695292,MATH 18,A02,083744,Staff,27,0,30,3
1650363695292,MATH 18,A03,083745,Staff,22,0,30,8
1650363695292,MATH 18,A04,083746,Staff,27,0,30,3
1650363695292,MATH 18,B01,083748,Staff,0,11,30,30
1650363695292,MATH 18,B02,083749,Staff,0,11,30,30
1650363695292,MATH 18,B03,083750,Staff,0,11,30,30
1650363695292,MATH 18,B04,083751,Staff,0,9,30,30
1650363701316,MATH 20A,A01,083754,Staff,26,0,40,14
1650363707341,MATH 20B,A01,083756,Staff,0,8,30,30
1650363707341,MATH 20B,A02,083757,Staff,0,8,30,30
1650363713366,MATH 20C,A01,083760,Staff,0,14,30,30
1650363713366,MATH 20C,A02,083761,Staff,0,15,30,30
1650363713366,MATH 20C,B01,083762,Staff,13,0,30,17
1650363713366,MATH 20C,B02,083763,Staff,28,0,30,2
1650363719392,MATH 20D,A01,083765,Staff,0,1,30,30
1650363719392,MATH 20D,A02,083766,Staff,7,0,30,23
1650363719392,MATH 20D,A03,083767,Staff,26,0,30,4
1650363725416,MATH 20E,A01,083771,Staff,5,0,30,25
1650363725416,MATH 20E,A02,083772,Staff,19,0,30,11
1650363725416,MATH 20E,B01,083773,Staff,0,0,30,30
1650363725416,MATH 20E,B02,083774,Staff,12,0,30,18
1650363731444,MATH 103A,A01,083777,Staff,0,11,30,30
1650363731444,MATH 103A,A02,083778,Staff,0,12,30,30
1650363731444,MATH 103A,B01,083779,Staff,0,13,30,30
1650363731444,MATH 103A,B02,083780,Staff,0,11,30,30
1650363737473,MATH 105,A01,085443,Staff,0,21,30,30
1650363743497,MATH 109,A01,083213,Anzaldo; Leesa B,0,6,30,30
1650363743497,MATH 109,A02,083214,Anzaldo; Leesa B,0,7,30,30
1650363743497,MATH 109,B01,083215,Anzaldo; Leesa B,0,5,30,30
1650363743497,MATH 109,B02,083216,Anzaldo; Leesa B,0,5,30,30
1650363749524,MATH 142A,A01,083219,Chow; Bennett,0,14,30,30
1650363749524,MATH 142A,A02,083220,Chow; Bennett,0,12,30,30
1650363749524,MATH 142A,B01,083221,Chow; Bennett,0,12,30,30
1650363749524,MATH 142A,B02,083222,Chow; Bennett,0,12,30,30
1650363755550,MATH 193A,A01,083224,Staff,0,5,30,30
1650363755550,MATH 193A,A02,083225,Staff,0,5,30,30
1650363755550,MATH 193A,A03,083781,Staff,0,4,30,30
1650363755550,MATH 193A,A04,083782,Staff,0,3,30,30
1650363761578,MATH 197,001,091859,McAuley; Julian John,9998,0,9999,1
1650363767717,COGS 9,A01,083615,Staff,0,14,60,60
1650363773740,COGS 11,A01,083617,Boyle; Mary E. T.,22,0,40,18
1650363779763,COGS 13,A01,083071,Staff,0,32,40,40
1650363785788,COGS 14A,A01,092681,Staff,0,21,100,100
1650363791813,COGS 14B,A01,083073,Cheng; Tzu-Han,0,10,50,50
1650363797837,COGS 17,A01,092677,Staff,24,0,75,51
1650363803867,COGS 100,A01,083619,Staff,0,24,60,60
1650363809897,COGS 101A,A01,083621,Davis; Joshua Daniel,0,21,60,60
1650363815922,COGS 101B,A01,091572,Staff,0,0,60,60
1650363821947,COGS 101C,A01,083625,Delgado; Tania,17,0,30,13
1650363827971,COGS 107A,A01,083627,Boyle; Mary E. T.,0,10,60,60
1650363833998,COGS 118A,A01,083075,Staff,4,0,60,56
1650363840024,CSE 3,A50,083646,Miranda; Gregory Joseph,21,0,38,17
1650363840024,CSE 3,A51,083647,Miranda; Gregory Joseph,37,0,37,0
1650363846049,CSE 8A,A50,083650,Miranda; Gregory Joseph,0,28,40,40
1650363852075,CSE 11,A01,083080,Cao; Yingjun,0,88,40,40
1650363858097,CSE 12,A01,083652,Staff,0,12,100,100
1650363864124,CSE 15L,A01,083654,Staff,0,1,50,50
1650363864124,CSE 15L,A02,083655,Staff,3,0,50,47
1650363870151,CSE 20,A01,083657,Staff,52,0,80,28
1650363876174,CSE 30,A01,083084,Eldon; John,0,76,40,40
1650363882200,CSE 100,A01,083659,Cao; Yingjun,0,66,50,50
1650363888228,CSE 134B,A01,083661,Powell; Thomas Allan,0,31,65,65
1650363894251,CSE 140,A01,083663,Staff,0,0,75,75
1650363900277,CSE 140L,A01,083088,Eldon; John,0,7,75,75
1650363906301,CSE 175,A01,083665,Kumar; Rakesh,8,0,25,17
1650363912331,CSE 190,A00,092507,Dubnov; Shlomo,14,0,20,6
1650363918354,ECE 45,A01,083139,Staff,0,17,40,40
1650363924379,ECE 65,A50,083695,Staff,0,5,30,30
1650363930402,ECE 109,A01,091882,Touri; Behrouz,40,0,70,30
1650363936428,ECE 180,A00,083140,Abi Samra; Nicholas Camill,23,0,30,7
1650363936428,ECE 180,B00,083141,Abi Samra; Nicholas Camill,5,0,30,25
1650363942451,MATH 10A,A01,083735,Patchell; Gregory David,7,0,30,23
1650363942451,MATH 10A,A02,083736,Patchell; Gregory David,28,0,30,2
1650363942451,MATH 10A,A03,083737,Patchell; Gregory David,25,0,30,5
1650363948478,MATH 10B,A01,083207,Staff,0,7,30,30
1650363948478,MATH 10B,A02,083208,Staff,0,6,30,30
1650363948478,MATH 10B,B01,083739,Staff,17,0,30,13
1650363948478,MATH 10B,B02,083740,Staff,28,0,30,2
1650363954502,MATH 18,A01,083743,Staff,3,0,30,27
1650363954502,MATH 18,A02,083744,Staff,27,0,30,3
1650363954502,MATH 18,A03,083745,Staff,22,0,30,8
1650363954502,MATH 18,A04,083746,Staff,27,0,30,3
1650363954502,MATH 18,B01,083748,Staff,0,11,30,30
1650363954502,MATH 18,B02,083749,Staff,0,11,30,30
1650363954502,MATH 18,B03,083750,Staff,0,11,30,30
1650363954502,MATH 18,B04,083751,Staff,0,9,30,30
1650363960568,MATH 20A,A01,083754,Staff,26,0,40,14
1650363966591,MATH 20B,A01,083756,Staff,0,8,30,30
1650363966591,MATH 20B,A02,083757,Staff,0,8,30,30
1650363972618,MATH 20C,A01,083760,Staff,0,14,30,30
1650363972618,MATH 20C,A02,083761,Staff,0,15,30,30
1650363972618,MATH 20C,B01,083762,Staff,13,0,30,17
1650363972618,MATH 20C,B02,083763,Staff,28,0,30,2
1650363978645,MATH 20D,A01,083765,Staff,0,1,30,30
1650363978645,MATH 20D,A02,083766,Staff,7,0,30,23
1650363978645,MATH 20D,A03,083767,Staff,26,0,30,4
1650363984669,MATH 20E,A01,083771,Staff,5,0,30,25
1650363984669,MATH 20E,A02,083772,Staff,19,0,30,11
1650363984669,MATH 20E,B01,083773,Staff,0,0,30,30
1650363984669,MATH 20E,B02,083774,Staff,12,0,30,18
1650363990696,MATH 103A,A01,083777,Staff,0,11,30,30
1650363990696,MATH 103A,A02,083778,Staff,0,12,30,30
1650363990696,MATH 103A,B01,083779,Staff,0,13,30,30
1650363990696,MATH 103A,B02,083780,Staff,0,11,30,30
1650363996720,MATH 105,A01,085443,Staff,0,21,30,30
1650364002759,MATH 109,A01,083213,Anzaldo; Leesa B,0,6,30,30
1650364002759,MATH 109,A02,083214,Anzaldo; Leesa B,0,7,30,30
1650364002759,MATH 109,B01,083215,Anzaldo; Leesa B,0,5,30,30
1650364002759,MATH 109,B02,083216,Anzaldo; Leesa B,0,5,30,30
1650364008790,MATH 142A,A01,083219,Chow; Bennett,0,14,30,30
1650364008790,MATH 142A,A02,083220,Chow; Bennett,0,12,30,30
1650364008790,MATH 142A,B01,083221,Chow; Bennett,0,12,30,30
1650364008790,MATH 142A,B02,083222,Chow; Bennett,0,12,30,30
1650364014813,MATH 193A,A01,083224,Staff,0,5,30,30
1650364014813,MATH 193A,A02,083225,Staff,0,5,30,30
1650364014813,MATH 193A,A03,083781,Staff,0,4,30,30
1650364014813,MATH 193A,A04,083782,Staff,0,3,30,30
1650364020838,MATH 197,001,091859,McAuley; Julian John,9998,0,9999,1
1650364026890,COGS 9,A01,083615,Staff,0,14,60,60
1650364032913,COGS 11,A01,083617,Boyle; Mary E. T.,22,0,40,18
1650364038936,COGS 13,A01,083071,Staff,0,32,40,40
1650364044963,COGS 14A,A01,092681,Staff,0,21,100,100
1650364050985,COGS 14B,A01,083073,Cheng; Tzu-Han,0,10,50,50
1650364057011,COGS 17,A01,092677,Staff,24,0,75,51
1650364063035,COGS 100,A01,083619,Staff,0,24,60,60
1650364069063,COGS 101A,A01,083621,Davis; Joshua Daniel,0,21,60,60
1650364075085,COGS 101B,A01,091572,Staff,0,0,60,60
1650364081112,COGS 101C,A01,083625,Delgado; Tania,17,0,30,13
1650364087136,COGS 107A,A01,083627,Boyle; Mary E. T.,0,10,60,60
1650364093161,COGS 118A,A01,083075,Staff,4,0,60,56
1650364099190,CSE 3,A50,083646,Miranda; Gregory Joseph,21,0,38,17
1650364099190,CSE 3,A51,083647,Miranda; Gregory Joseph,37,0,37,0
1650364105215,CSE 8A,A50,083650,Miranda; Gregory Joseph,0,28,40,40
1650364111237,CSE 11,A01,083080,Cao; Yingjun,0,88,40,40
1650364117264,CSE 12,A01,083652,Staff,0,12,100,100
1650364123299,CSE 15L,A01,083654,Staff,0,1,50,50
1650364123299,CSE 15L,A02,083655,Staff,3,0,50,47
1650364129325,CSE 20,A01,083657,Staff,52,0,80,28
1650364135352,CSE 30,A01,083084,Eldon; John,0,76,40,40
1650364141379,CSE 100,A01,083659,Cao; Yingjun,0,66,50,50
1650364147405,CSE 134B,A01,083661,Powell; Thomas Allan,0,31,65,65
1650364153428,CSE 140,A01,083663,Staff,0,0,75,75
1650364159451,CSE 140L,A01,083088,Eldon; John,0,7,75,75
1650364165477,CSE 175,A01,083665,Kumar; Rakesh,8,0,25,17
1650364171501,CSE 190,A00,092507,Dubnov; Shlomo,14,0,20,6
1650364177525,ECE 45,A01,083139,Staff,0,17,40,40
1650364183551,ECE 65,A50,083695,Staff,0,5,30,30
1650364189579,ECE 109,A01,091882,Touri; Behrouz,40,0,70,30
1650364195604,ECE 180,A00,083140,Abi Samra; Nicholas Camill,23,0,30,7
1650364195604,ECE 180,B00,083141,Abi Samra; Nicholas Camill,5,0,30,25
1650364201626,MATH 10A,A01,083735,Patchell; Gregory David,7,0,30,23
1650364201626,MATH 10A,A02,083736,Patchell; Gregory David,28,0,30,2
1650364201626,MATH 10A,A03,083737,Patchell; Gregory David,25,0,30,5
1650364207652,MATH 10B,A01,083207,Staff,0,7,30,30
1650364207652,MATH 10B,A02,083208,Staff,0,6,30,30
1650364207652,MATH 10B,B01,083739,Staff,17,0,30,13
1650364207652,MATH 10B,B02,083740,Staff,28,0,30,2
1650364213678,MATH 18,A01,083743,Staff,3,0,30,27
1650364213678,MATH 18,A02,083744,Staff,27,0,30,3
1650364213678,MATH 18,A03,083745,Staff,22,0,30,8
1650364213678,MATH 18,A04,083746,Staff,27,0,30,3
1650364213678,MATH 18,B01,083748,Staff,0,11,30,30
1650364213678,MATH 18,B02,083749,Staff,0,11,30,30
1650364213678,MATH 18,B03,083750,Staff,0,11,30,30
1650364213678,MATH 18,B04,083751,Staff,0,9,30,30
1650364219701,MATH 20A,A01,083754,Staff,26,0,40,14
1650364225729,MATH 20B,A01,083756,Staff,0,8,30,30
1650364225729,MATH 20B,A02,083757,Staff,0,8,30,30
1650364231768,MATH 20C,A01,083760,Staff,0,14,30,30
1650364231768,MATH 20C,A02,083761,Staff,0,15,30,30
1650364231768,MATH 20C,B01,083762,Staff,13,0,30,17
1650364231768,MATH 20C,B02,083763,Staff,28,0,30,2
1650364237798,MATH 20D,A01,083765,Staff,0,1,30,30
1650364237798,MATH 20D,A02,083766,Staff,7,0,30,23
1650364237798,MATH 20D,A03,083767,Staff,26,0,30,4
1650364243821,MATH 20E,A01,083771,Staff,5,0,30,25
1650364243821,MATH 20E,A02,083772,Staff,19,0,30,11
1650364243821,MATH 20E,B01,083773,Staff,0,0,30,30
1650364243821,MATH 20E,B02,083774,Staff,12,0,30,18
1650364249846,MATH 103A,A01,083777,Staff,0,11,30,30
1650364249846,MATH 103A,A02,083778,Staff,0,12,30,30
1650364249846,MATH 103A,B01,083779,Staff,0,13,30,30
1650364249846,MATH 103A,B02,083780,Staff,0,11,30,30
1650364255886,MATH 105,A01,085443,Staff,0,21,30,30
1650364261910,MATH 109,A01,083213,Anzaldo; Leesa B,0,6,30,30
1650364261910,MATH 109,A02,083214,Anzaldo; Leesa B,0,7,30,30
1650364261910,MATH 109,B01,083215,Anzaldo; Leesa B,0,5,30,30
1650364261910,MATH 109,B02,083216,Anzaldo; Leesa B,0,5,30,30
1650364267939,MATH 142A,A01,083219,Chow; Bennett,0,14,30,30
1650364267939,MATH 142A,A02,083220,Chow; Bennett,0,12,30,30
1650364267939,MATH 142A,B01,083221,Chow; Bennett,0,12,30,30
1650364267939,MATH 142A,B02,083222,Chow; Bennett,0,12,30,30
1650364273968,MATH 193A,A01,083224,Staff,0,5,30,30
1650364273968,MATH 193A,A02,083225,Staff,0,5,30,30
1650364273968,MATH 193A,A03,083781,Staff,0,4,30,30
1650364273968,MATH 193A,A04,083782,Staff,0,3,30,30
1650364279992,MATH 197,001,091859,McAuley; Julian John,9998,0,9999,1
1650364286051,COGS 9,A01,083615,Staff,0,14,60,60
1650364292077,COGS 11,A01,083617,Boyle; Mary E. T.,22,0,40,18
1650364298113,COGS 13,A01,083071,Staff,0,32,40,40
1650364304140,COGS 14A,A01,092681,Staff,0,21,100,100
1650364310165,COGS 14B,A01,083073,Cheng; Tzu-Han,0,10,50,50
1650364316204,COGS 17,A01,092677,Staff,24,0,75,51
1650364322232,COGS 100,A01,083619,Staff,0,24,60,60
1650364328268,COGS 101A,A01,083621,Davis; Joshua Daniel,0,21,60,60
1650364334296,COGS 101B,A01,091572,Staff,0,0,60,60
1650364340318,COGS 101C,A01,083625,Delgado; Tania,17,0,30,13
1650364346340,COGS 107A,A01,083627,Boyle; Mary E. T.,0,10,60,60
1650364352365,COGS 118A,A01,083075,Staff,4,0,60,56
1650364358475,CSE 3,A50,083646,Miranda; Gregory Joseph,21,0,38,17
1650364358475,CSE 3,A51,083647,Miranda; Gregory Joseph,37,0,37,0
1650364364502,CSE 8A,A50,083650,Miranda; Gregory Joseph,0,28,40,40
1650364370525,CSE 11,A01,083080,Cao; Yingjun,0,88,40,40
1650364376557,CSE 12,A01,083652,Staff,0,12,100,100
1650364382592,CSE 15L,A01,083654,Staff,0,1,50,50
1650364382592,CSE 15L,A02,083655,Staff,3,0,50,47
1650364388625,CSE 20,A01,083657,Staff,52,0,80,28
1650364394651,CSE 30,A01,083084,Eldon; John,0,76,40,40
1650364400678,CSE 100,A01,083659,Cao; Yingjun,0,66,50,50
1650364406708,CSE 134B,A01,083661,Powell; Thomas Allan,0,31,65,65
1650364412734,CSE 140,A01,083663,Staff,0,0,75,75
1650364418759,CSE 140L,A01,083088,Eldon; John,0,7,75,75
1650364424781,CSE 175,A01,083665,Kumar; Rakesh,8,0,25,17
1650364430810,CSE 190,A00,092507,Dubnov; Shlomo,14,0,20,6
1650364436838,ECE 45,A01,083139,Staff,0,17,40,40
1650364442864,ECE 65,A50,083695,Staff,0,5,30,30
1650364448887,ECE 109,A01,091882,Touri; Behrouz,40,0,70,30
1650364454911,ECE 180,A00,083140,Abi Samra; Nicholas Camill,23,0,30,7
1650364454911,ECE 180,B00,083141,Abi Samra; Nicholas Camill,5,0,30,25
1650364460939,MATH 10A,A01,083735,Patchell; Gregory David,7,0,30,23
1650364460939,MATH 10A,A02,083736,Patchell; Gregory David,28,0,30,2
1650364460939,MATH 10A,A03,083737,Patchell; Gregory David,25,0,30,5
1650364466968,MATH 10B,A01,083207,Staff,0,7,30,30
1650364466968,MATH 10B,A02,083208,Staff,0,6,30,30
1650364466968,MATH 10B,B01,083739,Staff,17,0,30,13
1650364466968,MATH 10B,B02,083740,Staff,28,0,30,2
1650364472993,MATH 18,A01,083743,Staff,3,0,30,27
1650364472993,MATH 18,A02,083744,Staff,27,0,30,3
1650364472993,MATH 18,A03,083745,Staff,22,0,30,8
1650364472993,MATH 18,A04,083746,Staff,27,0,30,3
1650364472993,MATH 18,B01,083748,Staff,0,11,30,30
1650364472993,MATH 18,B02,083749,Staff,0,11,30,30
1650364472993,MATH 18,B03,083750,Staff,0,11,30,30
1650364472993,MATH 18,B04,083751,Staff,0,9,30,30
1650364479017,MATH 20A,A01,083754,Staff,26,0,40,14
1650364485043,MATH 20B,A01,083756,Staff,0,8,30,30
1650364485043,MATH 20B,A02,083757,Staff,0,8,30,30
1650364491070,MATH 20C,A01,083760,Staff,0,14,30,30
1650364491070,MATH 20C,A02,083761,Staff,0,15,30,30
1650364491070,MATH 20C,B01,083762,Staff,13,0,30,17
1650364491070,MATH 20C,B02,083763,Staff,28,0,30,2
1650364497097,MATH 20D,A01,083765,Staff,0,1,30,30
1650364497097,MATH 20D,A02,083766,Staff,7,0,30,23
1650364497097,MATH 20D,A03,083767,Staff,26,0,30,4
1650364503125,MATH 20E,A01,083771,Staff,5,0,30,25
1650364503125,MATH 20E,A02,083772,Staff,19,0,30,11
1650364503125,MATH 20E,B01,083773,Staff,0,0,30,30
1650364503125,MATH 20E,B02,083774,Staff,12,0,30,18
1650364509159,MATH 103A,A01,083777,Staff,0,11,30,30
1650364509159,MATH 103A,A02,083778,Staff,0,12,30,30
1650364509159,MATH 103A,B01,083779,Staff,0,13,30,30
1650364509159,MATH 103A,B02,083780,Staff,0,11,30,30
1650364515187,MATH 105,A01,085443,Staff,0,21,30,30
1650364521212,MATH 109,A01,083213,Anzaldo; Leesa B,0,6,30,30
1650364521212,MATH 109,A02,083214,Anzaldo; Leesa B,0,7,30,30
1650364521212,MATH 109,B01,083215,Anzaldo; Leesa B,0,5,30,30
1650364521212,MATH 109,B02,083216,Anzaldo; Leesa B,0,5,30,30
1650364527243,MATH 142A,A01,083219,Chow; Bennett,0,14,30,30
1650364527243,MATH 142A,A02,083220,Chow; Bennett,0,12,30,30
1650364527243,MATH 142A,B01,083221,Chow; Bennett,0,12,30,30
1650364527243,MATH 142A,B02,083222,Chow; Bennett,0,12,30,30
1650364533267,MATH 193A,A01,083224,Staff,0,5,30,30
1650364533267,MATH 193A,A02,083225,Staff,0,5,30,30
1650364533267,MATH 193A,A03,083781,Staff,0,4,30,30
1650364533267,MATH 193A,A04,083782,Staff,0,3,30,30
1650364539292,MATH 197,001,091859,McAuley; Julian John,9998,0,9999,1
1650364545360,COGS 9,A01,083615,Staff,0,14,60,60
1650364551385,COGS 11,A01,083617,Boyle; Mary E. T.,22,0,40,18
1650364557423,COGS 13,A01,083071,Staff,0,32,40,40
1650364563446,COGS 14A,A01,092681,Staff,0,21,100,100
1650364569474,COGS 14B,A01,083073,Cheng; Tzu-Han,0,10,50,50
1650364575497,COGS 17,A01,092677,Staff,24,0,75,51
1650364581526,COGS 100,A01,083619,Staff,0,24,60,60
1650364587571,COGS 101A,A01,083621,Davis; Joshua Daniel,0,21,60,60
1650364593601,COGS 101B,A01,091572,Staff,0,0,60,60
1650364599629,COGS 101C,A01,083625,Delgado; Tania,17,0,30,13
1650364605653,COGS 107A,A01,083627,Boyle; Mary E. T.,0,10,60,60
1650364611677,COGS 118A,A01,083075,Staff,4,0,60,56
1650364617719,CSE 3,A50,083646,Miranda; Gregory Joseph,21,0,38,17
1650364617719,CSE 3,A51,083647,Miranda; Gregory Joseph,37,0,37,0
1650364623741,CSE 8A,A50,083650,Miranda; Gregory Joseph,0,28,40,40
1650364629771,CSE 11,A01,083080,Cao; Yingjun,0,88,40,40
1650364635802,CSE 12,A01,083652,Staff,0,12,100,100
1650364641835,CSE 15L,A01,083654,Staff,0,1,50,50
1650364641835,CSE 15L,A02,083655,Staff,3,0,50,47
1650364647862,CSE 20,A01,083657,Staff,52,0,80,28
1650364653890,CSE 30,A01,083084,Eldon; John,0,76,40,40
1650364659920,CSE 100,A01,083659,Cao; Yingjun,0,66,50,50
1650364665962,CSE 134B,A01,083661,Powell; Thomas Allan,0,31,65,65
1650364671987,CSE 140,A01,083663,Staff,0,0,75,75
1650364678018,CSE 140L,A01,083088,Eldon; John,0,7,75,75
1650364684057,CSE 175,A01,083665,Kumar; Rakesh,8,0,25,17
1650364690084,CSE 190,A00,092507,Dubnov; Shlomo,14,0,20,6
1650364696114,ECE 45,A01,083139,Staff,0,17,40,40
1650364702145,ECE 65,A50,083695,Staff,0,5,30,30
1650364708172,ECE 109,A01,091882,Touri; Behrouz,40,0,70,30
1650364714225,ECE 180,A00,083140,Abi Samra; Nicholas Camill,23,0,30,7
1650364714225,ECE 180,B00,083141,Abi Samra; Nicholas Camill,5,0,30,25
1650364720254,MATH 10A,A01,083735,Patchell; Gregory David,7,0,30,23
1650364720254,MATH 10A,A02,083736,Patchell; Gregory David,28,0,30,2
1650364720254,MATH 10A,A03,083737,Patchell; Gregory David,25,0,30,5
1650364726279,MATH 10B,A01,083207,Staff,0,7,30,30
1650364726279,MATH 10B,A02,083208,Staff,0,6,30,30
1650364726279,MATH 10B,B01,083739,Staff,17,0,30,13
1650364726279,MATH 10B,B02,083740,Staff,28,0,30,2
1650364732310,MATH 18,A01,083743,Staff,3,0,30,27
1650364732310,MATH 18,A02,083744,Staff,27,0,30,3
1650364732310,MATH 18,A03,083745,Staff,22,0,30,8
1650364732310,MATH 18,A04,083746,Staff,27,0,30,3
1650364732310,MATH 18,B01,083748,Staff,0,11,30,30
1650364732310,MATH 18,B02,083749,Staff,0,11,30,30
1650364732310,MATH 18,B03,083750,Staff,0,11,30,30
1650364732310,MATH 18,B04,083751,Staff,0,9,30,30
1650364738333,MATH 20A,A01,083754,Staff,26,0,40,14
1650364744362,MATH 20B,A01,083756,Staff,0,8,30,30
1650364744362,MATH 20B,A02,083757,Staff,0,8,30,30
1650364750391,MATH 20C,A01,083760,Staff,0,14,30,30
1650364750391,MATH 20C,A02,083761,Staff,0,15,30,30
1650364750391,MATH 20C,B01,083762,Staff,13,0,30,17
1650364750391,MATH 20C,B02,083763,Staff,28,0,30,2
1650364756417,MATH 20D,A01,083765,Staff,0,1,30,30
1650364756417,MATH 20D,A02,083766,Staff,7,0,30,23
1650364756417,MATH 20D,A03,083767,Staff,26,0,30,4
1650364762448,MATH 20E,A01,083771,Staff,5,0,30,25
1650364762448,MATH 20E,A02,083772,Staff,19,0,30,11
1650364762448,MATH 20E,B01,083773,Staff,0,0,30,30
1650364762448,MATH 20E,B02,083774,Staff,12,0,30,18
1650364768473,MATH 103A,A01,083777,Staff,0,11,30,30
1650364768473,MATH 103A,A02,083778,Staff,0,12,30,30
1650364768473,MATH 103A,B01,083779,Staff,0,13,30,30
1650364768473,MATH 103A,B02,083780,Staff,0,11,30,30
1650364774509,MATH 105,A01,085443,Staff,0,21,30,30
1650364780540,MATH 109,A01,083213,Anzaldo; Leesa B,0,6,30,30
1650364780540,MATH 109,A02,083214,Anzaldo; Leesa B,0,7,30,30
1650364780540,MATH 109,B01,083215,Anzaldo; Leesa B,0,5,30,30
1650364780540,MATH 109,B02,083216,Anzaldo; Leesa B,0,5,30,30
1650364786566,MATH 142A,A01,083219,Chow; Bennett,0,14,30,30
1650364786566,MATH 142A,A02,083220,Chow; Bennett,0,12,30,30
1650364786566,MATH 142A,B01,083221,Chow; Bennett,0,12,30,30
1650364786566,MATH 142A,B02,083222,Chow; Bennett,0,12,30,30
1650364792593,MATH 193A,A01,083224,Staff,0,5,30,30
1650364792593,MATH 193A,A02,083225,Staff,0,5,30,30
1650364792593,MATH 193A,A03,083781,Staff,0,4,30,30
1650364792593,MATH 193A,A04,083782,Staff,0,3,30,30
1650364798617,MATH 197,001,091859,McAuley; Julian John,9998,0,9999,1
1650364804701,COGS 9,A01,083615,Staff,0,14,60,60
1650364810732,COGS 11,A01,083617,Boyle; Mary E. T.,22,0,40,18
1650364816756,COGS 13,A01,083071,Staff,0,32,40,40
1650364822786,COGS 14A,A01,092681,Staff,0,21,100,100
1650364828816,COGS 14B,A01,083073,Cheng; Tzu-Han,0,10,50,50
1650364834839,COGS 17,A01,092677,Staff,24,0,75,51
1650364840862,COGS 100,A01,083619,Staff,0,24,60,60
1650364846893,COGS 101A,A01,083621,Davis; Joshua Daniel,0,21,60,60
1650364852927,COGS 101B,A01,091572,Staff,0,0,60,60
1650364858953,COGS 101C,A01,083625,Delgado; Tania,17,0,30,13
1650364864981,COGS 107A,A01,083627,Boyle; Mary E. T.,0,10,60,60
1650364871005,COGS 118A,A01,083075,Staff,4,0,60,56
1650364877038,CSE 3,A50,083646,Miranda; Gregory Joseph,21,0,38,17
1650364877038,CSE 3,A51,083647,Miranda; Gregory Joseph,37,0,37,0
1650364883073,CSE 8A,A50,083650,Miranda; Gregory Joseph,0,28,40,40
1650364889098,CSE 11,A01,083080,Cao; Yingjun,0,88,40,40
1650364895121,CSE 12,A01,083652,Staff,0,12,100,100
1650364901147,CSE 15L,A01,083654,Staff,0,1,50,50
1650364901147,CSE 15L,A02,083655,Staff,3,0,50,47
1650364907176,CSE 20,A01,083657,Staff,52,0,80,28
1650364913205,CSE 30,A01,083084,Eldon; John,0,76,40,40
1650364919236,CSE 100,A01,083659,Cao; Yingjun,0,66,50,50
1650364925261,CSE 134B,A01,083661,Powell; Thomas Allan,0,31,65,65
1650364931288,CSE 140,A01,083663,Staff,0,0,75,75
1650364937311,CSE 140L,A01,083088,Eldon; John,0,7,75,75
1650364943341,CSE 175,A01,083665,Kumar; Rakesh,8,0,25,17
1650364949382,CSE 190,A00,092507,Dubnov; Shlomo,14,0,20,6
1650364955483,ECE 45,A01,083139,Staff,0,17,40,40
1650364961509,ECE 65,A50,083695,Staff,0,5,30,30
1650364967534,ECE 109,A01,091882,Touri; Behrouz,40,0,70,30
1650364973567,ECE 180,A00,083140,Abi Samra; Nicholas Camill,23,0,30,7
1650364973567,ECE 180,B00,083141,Abi Samra; Nicholas Camill,5,0,30,25
1650364979593,MATH 10A,A01,083735,Patchell; Gregory David,7,0,30,23
1650364979593,MATH 10A,A02,083736,Patchell; Gregory David,28,0,30,2
1650364979593,MATH 10A,A03,083737,Patchell; Gregory David,25,0,30,5
1650364985619,MATH 10B,A01,083207,Staff,0,7,30,30
1650364985619,MATH 10B,A02,083208,Staff,0,6,30,30
1650364985619,MATH 10B,B01,083739,Staff,17,0,30,13
1650364985619,MATH 10B,B02,083740,Staff,28,0,30,2
1650364991650,MATH 18,A01,083743,Staff,3,0,30,27
1650364991650,MATH 18,A02,083744,Staff,27,0,30,3
1650364991650,MATH 18,A03,083745,Staff,22,0,30,8
1650364991650,MATH 18,A04,083746,Staff,27,0,30,3
1650364991650,MATH 18,B01,083748,Staff,0,11,30,30
1650364991650,MATH 18,B02,083749,Staff,0,11,30,30
1650364991650,MATH 18,B03,083750,Staff,0,11,30,30
1650364991650,MATH 18,B04,083751,Staff,0,9,30,30
1650364997679,MATH 20A,A01,083754,Staff,26,0,40,14
1650365003711,MATH 20B,A01,083756,Staff,0,8,30,30
1650365003711,MATH 20B,A02,083757,Staff,0,8,30,30
1650365009736,MATH 20C,A01,083760,Staff,0,14,30,30
1650365009736,MATH 20C,A02,083761,Staff,0,15,30,30
1650365009736,MATH 20C,B01,083762,Staff,13,0,30,17
1650365009736,MATH 20C,B02,083763,Staff,28,0,30,2
1650365015760,MATH 20D,A01,083765,Staff,0,1,30,30
1650365015760,MATH 20D,A02,083766,Staff,7,0,30,23
1650365015760,MATH 20D,A03,083767,Staff,26,0,30,4
1650365021786,MATH 20E,A01,083771,Staff,5,0,30,25
1650365021786,MATH 20E,A02,083772,Staff,19,0,30,11
1650365021786,MATH 20E,B01,083773,Staff,0,0,30,30
1650365021786,MATH 20E,B02,083774,Staff,12,0,30,18
1650365027816,MATH 103A,A01,083777,Staff,0,11,30,30
1650365027816,MATH 103A,A02,083778,Staff,0,12,30,30
1650365027816,MATH 103A,B01,083779,Staff,0,13,30,30
1650365027816,MATH 103A,B02,083780,Staff,0,11,30,30
1650365033845,MATH 105,A01,085443,Staff,0,21,30,30
1650365039871,MATH 109,A01,083213,Anzaldo; Leesa B,0,6,30,30
1650365039871,MATH 109,A02,083214,Anzaldo; Leesa B,0,7,30,30
1650365039871,MATH 109,B01,083215,Anzaldo; Leesa B,0,5,30,30
1650365039871,MATH 109,B02,083216,Anzaldo; Leesa B,0,5,30,30
1650365045904,MATH 142A,A01,083219,Chow; Bennett,0,14,30,30
1650365045904,MATH 142A,A02,083220,Chow; Bennett,0,12,30,30
1650365045904,MATH 142A,B01,083221,Chow; Bennett,0,12,30,30
1650365045904,MATH 142A,B02,083222,Chow; Bennett,0,12,30,30
1650365051931,MATH 193A,A01,083224,Staff,0,5,30,30
1650365051931,MATH 193A,A02,083225,Staff,0,5,30,30
1650365051931,MATH 193A,A03,083781,Staff,0,4,30,30
1650365051931,MATH 193A,A04,083782,Staff,0,3,30,30
1650365057958,MATH 197,001,091859,McAuley; Julian John,9998,0,9999,1
1650365064029,COGS 9,A01,083615,Staff,0,14,60,60
1650365070062,COGS 11,A01,083617,Boyle; Mary E. T.,22,0,40,18
1650365076092,COGS 13,A01,083071,Staff,0,32,40,40
1650365082125,COGS 14A,A01,092681,Staff,0,21,100,100
1650365088154,COGS 14B,A01,083073,Cheng; Tzu-Han,0,10,50,50
1650365094184,COGS 17,A01,092677,Staff,24,0,75,51
1650365100209,COGS 100,A01,083619,Staff,0,24,60,60
1650365106233,COGS 101A,A01,083621,Davis; Joshua Daniel,0,21,60,60
1650365112258,COGS 101B,A01,091572,Staff,0,0,60,60
1650365118283,COGS 101C,A01,083625,Delgado; Tania,17,0,30,13
1650365124306,COGS 107A,A01,083627,Boyle; Mary E. T.,0,10,60,60
1650365130347,COGS 118A,A01,083075,Staff,4,0,60,56
1650365136373,CSE 3,A50,083646,Miranda; Gregory Joseph,21,0,38,17
1650365136373,CSE 3,A51,083647,Miranda; Gregory Joseph,37,0,37,0
1650365142398,CSE 8A,A50,083650,Miranda; Gregory Joseph,0,28,40,40
1650365148426,CSE 11,A01,083080,Cao; Yingjun,0,88,40,40
1650365154452,CSE 12,A01,083652,Staff,0,12,100,100
1650365160479,CSE 15L,A01,083654,Staff,0,1,50,50
1650365160479,CSE 15L,A02,083655,Staff,3,0,50,47
1650365166504,CSE 20,A01,083657,Staff,52,0,80,28
1650365172530,CSE 30,A01,083084,Eldon; John,0,76,40,40
1650365178556,CSE 100,A01,083659,Cao; Yingjun,0,66,50,50
1650365184584,CSE 134B,A01,083661,Powell; Thomas Allan,0,31,65,65
1650365190611,CSE 140,A01,083663,Staff,0,0,75,75
1650365196637,CSE 140L,A01,083088,Eldon; John,0,7,75,75
1650365202666,CSE 175,A01,083665,Kumar; Rakesh,8,0,25,17
1650365208690,CSE 190,A00,092507,Dubnov; Shlomo,14,0,20,6
1650365214716,ECE 45,A01,083139,Staff,0,17,40,40
1650365220748,ECE 65,A50,083695,Staff,0,5,30,30
1650365226774,ECE 109,A01,091882,Touri; Behrouz,40,0,70,30
1650365232799,ECE 180,A00,083140,Abi Samra; Nicholas Camill,23,0,30,7
1650365232799,ECE 180,B00,083141,Abi Samra; Nicholas Camill,5,0,30,25
1650365238827,MATH 10A,A01,083735,Patchell; Gregory David,7,0,30,23
1650365238827,MATH 10A,A02,083736,Patchell; Gregory David,28,0,30,2
1650365238827,MATH 10A,A03,083737,Patchell; Gregory David,25,0,30,5
1650365244855,MATH 10B,A01,083207,Staff,0,7,30,30
1650365244855,MATH 10B,A02,083208,Staff,0,6,30,30
1650365244855,MATH 10B,B01,083739,Staff,17,0,30,13
1650365244855,MATH 10B,B02,083740,Staff,28,0,30,2
1650365250891,MATH 18,A01,083743,Staff,3,0,30,27
1650365250891,MATH 18,A02,083744,Staff,27,0,30,3
1650365250891,MATH 18,A03,083745,Staff,22,0,30,8
1650365250891,MATH 18,A04,083746,Staff,27,0,30,3
1650365250891,MATH 18,B01,083748,Staff,0,11,30,30
1650365250891,MATH 18,B02,083749,Staff,0,11,30,30
1650365250891,MATH 18,B03,083750,Staff,0,11,30,30
1650365250891,MATH 18,B04,083751,Staff,0,9,30,30
1650365256915,MATH 20A,A01,083754,Staff,26,0,40,14
1650365262943,MATH 20B,A01,083756,Staff,0,8,30,30
1650365262943,MATH 20B,A02,083757,Staff,0,8,30,30
1650365268975,MATH 20C,A01,083760,Staff,0,14,30,30
1650365268975,MATH 20C,A02,083761,Staff,0,15,30,30
1650365268975,MATH 20C,B01,083762,Staff,13,0,30,17
1650365268975,MATH 20C,B02,083763,Staff,28,0,30,2
1650365275000,MATH 20D,A01,083765,Staff,0,1,30,30
1650365275000,MATH 20D,A02,083766,Staff,7,0,30,23
1650365275000,MATH 20D,A03,083767,Staff,26,0,30,4
1650365281032,MATH 20E,A01,083771,Staff,5,0,30,25
1650365281032,MATH 20E,A02,083772,Staff,19,0,30,11
1650365281032,MATH 20E,B01,083773,Staff,0,0,30,30
1650365281032,MATH 20E,B02,083774,Staff,12,0,30,18
1650365287064,MATH 103A,A01,083777,Staff,0,11,30,30
1650365287064,MATH 103A,A02,083778,Staff,0,12,30,30
1650365287064,MATH 103A,B01,083779,Staff,0,13,30,30
1650365287064,MATH 103A,B02,083780,Staff,0,11,30,30
1650365293090,MATH 105,A01,085443,Staff,0,21,30,30
1650365299120,MATH 109,A01,083213,Anzaldo; Leesa B,0,6,30,30
1650365299120,MATH 109,A02,083214,Anzaldo; Leesa B,0,7,30,30
1650365299120,MATH 109,B01,083215,Anzaldo; Leesa B,0,5,30,30
1650365299120,MATH 109,B02,083216,Anzaldo; Leesa B,0,5,30,30
1650365305149,MATH 142A,A01,083219,Chow; Bennett,0,14,30,30
1650365305149,MATH 142A,A02,083220,Chow; Bennett,0,12,30,30
1650365305149,MATH 142A,B01,083221,Chow; Bennett,0,12,30,30
1650365305149,MATH 142A,B02,083222,Chow; Bennett,0,12,30,30
1650365311173,MATH 193A,A01,083224,Staff,0,5,30,30
1650365311173,MATH 193A,A02,083225,Staff,0,5,30,30
1650365311173,MATH 193A,A03,083781,Staff,0,4,30,30
1650365311173,MATH 193A,A04,083782,Staff,0,3,30,30
1650365317198,MATH 197,001,091859,McAuley; Julian John,9998,0,9999,1
1650365323281,COGS 9,A01,083615,Staff,0,14,60,60
1650365329308,COGS 11,A01,083617,Boyle; Mary E. T.,22,0,40,18
1650365335331,COGS 13,A01,083071,Staff,0,32,40,40
1650365341360,COGS 14A,A01,092681,Staff,0,21,100,100
1650365347386,COGS 14B,A01,083073,Cheng; Tzu-Han,0,10,50,50
1650365353410,COGS 17,A01,092677,Staff,24,0,75,51
1650365359439,COGS 100,A01,083619,Staff,0,24,60,60
1650365365470,COGS 101A,A01,083621,Davis; Joshua Daniel,0,21,60,60
1650365371498,COGS 101B,A01,091572,Staff,0,0,60,60
1650365377525,COGS 101C,A01,083625,Delgado; Tania,17,0,30,13
1650365383555,COGS 107A,A01,083627,Boyle; Mary E. T.,0,10,60,60
1650365389585,COGS 118A,A01,083075,Staff,4,0,60,56
1650365395612,CSE 3,A50,083646,Miranda; Gregory Joseph,21,0,38,17
1650365395612,CSE 3,A51,083647,Miranda; Gregory Joseph,37,0,37,0
1650365401640,CSE 8A,A50,083650,Miranda; Gregory Joseph,0,28,40,40
1650365407668,CSE 11,A01,083080,Cao; Yingjun,0,88,40,40
1650365413693,CSE 12,A01,083652,Staff,0,12,100,100
1650365419721,CSE 15L,A01,083654,Staff,0,1,50,50
1650365419721,CSE 15L,A02,083655,Staff,3,0,50,47
1650365425746,CSE 20,A01,083657,Staff,52,0,80,28
1650365431771,CSE 30,A01,083084,Eldon; John,0,76,40,40
1650365437801,CSE 100,A01,083659,Cao; Yingjun,0,66,50,50
1650365443830,CSE 134B,A01,083661,Powell; Thomas Allan,0,31,65,65
1650365449858,CSE 140,A01,083663,Staff,0,0,75,75
1650365455888,CSE 140L,A01,083088,Eldon; John,0,7,75,75
1650365461914,CSE 175,A01,083665,Kumar; Rakesh,8,0,25,17
1650365467938,CSE 190,A00,092507,Dubnov; Shlomo,14,0,20,6
1650365473963,ECE 45,A01,083139,Staff,0,17,40,40
1650365479988,ECE 65,A50,083695,Staff,0,5,30,30
1650365486018,ECE 109,A01,091882,Touri; Behrouz,40,0,70,30
1650365492048,ECE 180,A00,083140,Abi Samra; Nicholas Camill,23,0,30,7
1650365492048,ECE 180,B00,083141,Abi Samra; Nicholas Camill,5,0,30,25
1650365498076,MATH 10A,A01,083735,Patchell; Gregory David,7,0,30,23
1650365498076,MATH 10A,A02,083736,Patchell; Gregory David,28,0,30,2
1650365498076,MATH 10A,A03,083737,Patchell; Gregory David,25,0,30,5
1650365504103,MATH 10B,A01,083207,Staff,0,7,30,30
1650365504103,MATH 10B,A02,083208,Staff,0,6,30,30
1650365504103,MATH 10B,B01,083739,Staff,17,0,30,13
1650365504103,MATH 10B,B02,083740,Staff,28,0,30,2
1650365510145,MATH 18,A01,083743,Staff,3,0,30,27
1650365510145,MATH 18,A02,083744,Staff,27,0,30,3
1650365510145,MATH 18,A03,083745,Staff,22,0,30,8
1650365510145,MATH 18,A04,083746,Staff,27,0,30,3
1650365510145,MATH 18,B01,083748,Staff,0,11,30,30
1650365510145,MATH 18,B02,083749,Staff,0,11,30,30
1650365510145,MATH 18,B03,083750,Staff,0,11,30,30
1650365510145,MATH 18,B04,083751,Staff,0,9,30,30
1650365516169,MATH 20A,A01,083754,Staff,26,0,40,14
1650365522196,MATH 20B,A01,083756,Staff,0,8,30,30
1650365522196,MATH 20B,A02,083757,Staff,0,8,30,30
1650365528221,MATH 20C,A01,083760,Staff,0,14,30,30
1650365528221,MATH 20C,A02,083761,Staff,0,15,30,30
1650365528221,MATH 20C,B01,083762,Staff,13,0,30,17
1650365528221,MATH 20C,B02,083763,Staff,28,0,30,2
1650365534245,MATH 20D,A01,083765,Staff,0,1,30,30
1650365534245,MATH 20D,A02,083766,Staff,7,0,30,23
1650365534245,MATH 20D,A03,083767,Staff,26,0,30,4
1650365540271,MATH 20E,A01,083771,Staff,5,0,30,25
1650365540271,MATH 20E,A02,083772,Staff,19,0,30,11
1650365540271,MATH 20E,B01,083773,Staff,0,0,30,30
1650365540271,MATH 20E,B02,083774,Staff,12,0,30,18
1650365546300,MATH 103A,A01,083777,Staff,0,11,30,30
1650365546300,MATH 103A,A02,083778,Staff,0,12,30,30
1650365546300,MATH 103A,B01,083779,Staff,0,13,30,30
1650365546300,MATH 103A,B02,083780,Staff,0,11,30,30
1650365552414,MATH 105,A01,085443,Staff,0,21,30,30
1650365558449,MATH 109,A01,083213,Anzaldo; Leesa B,0,6,30,30
1650365558449,MATH 109,A02,083214,Anzaldo; Leesa B,0,7,30,30
1650365558449,MATH 109,B01,083215,Anzaldo; Leesa B,0,5,30,30
1650365558449,MATH 109,B02,083216,Anzaldo; Leesa B,0,5,30,30
1650365564475,MATH 142A,A01,083219,Chow; Bennett,0,14,30,30
1650365564475,MATH 142A,A02,083220,Chow; Bennett,0,12,30,30
1650365564475,MATH 142A,B01,083221,Chow; Bennett,0,12,30,30
1650365564475,MATH 142A,B02,083222,Chow; Bennett,0,12,30,30
1650365570500,MATH 193A,A01,083224,Staff,0,5,30,30
1650365570500,MATH 193A,A02,083225,Staff,0,5,30,30
1650365570500,MATH 193A,A03,083781,Staff,0,4,30,30
1650365570500,MATH 193A,A04,083782,Staff,0,3,30,30
1650365576533,MATH 197,001,091859,McAuley; Julian John,9998,0,9999,1
1650365582604,COGS 9,A01,083615,Staff,0,14,60,60
1650365588630,COGS 11,A01,083617,Boyle; Mary E. T.,22,0,40,18
1650365594656,COGS 13,A01,083071,Staff,0,32,40,40
1650365600684,COGS 14A,A01,092681,Staff,0,21,100,100
1650365606712,COGS 14B,A01,083073,Cheng; Tzu-Han,0,10,50,50
1650365612736,COGS 17,A01,092677,Staff,24,0,75,51
1650365618761,COGS 100,A01,083619,Staff,0,24,60,60
1650365624788,COGS 101A,A01,083621,Davis; Joshua Daniel,0,21,60,60
1650365630819,COGS 101B,A01,091572,Staff,0,0,60,60
1650365636845,COGS 101C,A01,083625,Delgado; Tania,17,0,30,13
1650365642874,COGS 107A,A01,083627,Boyle; Mary E. T.,0,10,60,60
1650365648899,COGS 118A,A01,083075,Staff,4,0,60,56
1650365654930,CSE 3,A50,083646,Miranda; Gregory Joseph,21,0,38,17
1650365654930,CSE 3,A51,083647,Miranda; Gregory Joseph,37,0,37,0
1650365660960,CSE 8A,A50,083650,Miranda; Gregory Joseph,0,28,40,40
1650365666985,CSE 11,A01,083080,Cao; Yingjun,0,88,40,40
1650365673018,CSE 12,A01,083652,Staff,0,12,100,100
1650365679043,CSE 15L,A01,083654,Staff,0,1,50,50
1650365679043,CSE 15L,A02,083655,Staff,3,0,50,47
1650365685070,CSE 20,A01,083657,Staff,52,0,80,28
1650365691101,CSE 30,A01,083084,Eldon; John,0,76,40,40
1650365697127,CSE 100,A01,083659,Cao; Yingjun,0,66,50,50
1650365703163,CSE 134B,A01,083661,Powell; Thomas Allan,0,31,65,65
1650365709188,CSE 140,A01,083663,Staff,0,0,75,75
1650365715213,CSE 140L,A01,083088,Eldon; John,0,7,75,75
1650365721243,CSE 175,A01,083665,Kumar; Rakesh,8,0,25,17
1650365727275,CSE 190,A00,092507,Dubnov; Shlomo,14,0,20,6
1650365733306,ECE 45,A01,083139,Staff,0,17,40,40
1650365739332,ECE 65,A50,083695,Staff,0,5,30,30
1650365745358,ECE 109,A01,091882,Touri; Behrouz,40,0,70,30
1650365751383,ECE 180,A00,083140,Abi Samra; Nicholas Camill,23,0,30,7
1650365751383,ECE 180,B00,083141,Abi Samra; Nicholas Camill,5,0,30,25
1650365757411,MATH 10A,A01,083735,Patchell; Gregory David,7,0,30,23
1650365757411,MATH 10A,A02,083736,Patchell; Gregory David,28,0,30,2
1650365757411,MATH 10A,A03,083737,Patchell; Gregory David,25,0,30,5
1650365763442,MATH 10B,A01,083207,Staff,0,7,30,30
1650365763442,MATH 10B,A02,083208,Staff,0,6,30,30
1650365763442,MATH 10B,B01,083739,Staff,17,0,30,13
1650365763442,MATH 10B,B02,083740,Staff,28,0,30,2
1650365769479,MATH 18,A01,083743,Staff,3,0,30,27
1650365769479,MATH 18,A02,083744,Staff,27,0,30,3
1650365769479,MATH 18,A03,083745,Staff,22,0,30,8
1650365769479,MATH 18,A04,083746,Staff,27,0,30,3
1650365769479,MATH 18,B01,083748,Staff,0,11,30,30
1650365769479,MATH 18,B02,083749,Staff,0,11,30,30
1650365769479,MATH 18,B03,083750,Staff,0,11,30,30
1650365769479,MATH 18,B04,083751,Staff,0,9,30,30
1650365775503,MATH 20A,A01,083754,Staff,26,0,40,14
1650365781527,MATH 20B,A01,083756,Staff,0,8,30,30
1650365781527,MATH 20B,A02,083757,Staff,0,8,30,30
1650365787554,MATH 20C,A01,083760,Staff,0,14,30,30
1650365787554,MATH 20C,A02,083761,Staff,0,15,30,30
1650365787554,MATH 20C,B01,083762,Staff,13,0,30,17
1650365787554,MATH 20C,B02,083763,Staff,28,0,30,2
1650365793583,MATH 20D,A01,083765,Staff,0,1,30,30
1650365793583,MATH 20D,A02,083766,Staff,7,0,30,23
1650365793583,MATH 20D,A03,083767,Staff,26,0,30,4
1650365799608,MATH 20E,A01,083771,Staff,5,0,30,25
1650365799608,MATH 20E,A02,083772,Staff,19,0,30,11
1650365799608,MATH 20E,B01,083773,Staff,0,0,30,30
1650365799608,MATH 20E,B02,083774,Staff,12,0,30,18
1650365805635,MATH 103A,A01,083777,Staff,0,11,30,30
1650365805635,MATH 103A,A02,083778,Staff,0,12,30,30
1650365805635,MATH 103A,B01,083779,Staff,0,13,30,30
1650365805635,MATH 103A,B02,083780,Staff,0,11,30,30
1650365811665,MATH 105,A01,085443,Staff,0,21,30,30
1650365817698,MATH 109,A01,083213,Anzaldo; Leesa B,0,6,30,30
1650365817698,MATH 109,A02,083214,Anzaldo; Leesa B,0,7,30,30
1650365817698,MATH 109,B01,083215,Anzaldo; Leesa B,0,5,30,30
1650365817698,MATH 109,B02,083216,Anzaldo; Leesa B,0,5,30,30
1650365823741,MATH 142A,A01,083219,Chow; Bennett,0,14,30,30
1650365823741,MATH 142A,A02,083220,Chow; Bennett,0,12,30,30
1650365823741,MATH 142A,B01,083221,Chow; Bennett,0,12,30,30
1650365823741,MATH 142A,B02,083222,Chow; Bennett,0,12,30,30
1650365829770,MATH 193A,A01,083224,Staff,0,5,30,30
1650365829770,MATH 193A,A02,083225,Staff,0,5,30,30
1650365829770,MATH 193A,A03,083781,Staff,0,4,30,30
1650365829770,MATH 193A,A04,083782,Staff,0,3,30,30
1650365835793,MATH 197,001,091859,McAuley; Julian John,9998,0,9999,1
1650365841866,COGS 9,A01,083615,Staff,0,14,60,60
1650365847891,COGS 11,A01,083617,Boyle; Mary E. T.,22,0,40,18
1650365853914,COGS 13,A01,083071,Staff,0,32,40,40
1650365859939,COGS 14A,A01,092681,Staff,0,21,100,100
1650365865969,COGS 14B,A01,083073,Cheng; Tzu-Han,0,10,50,50
1650365872001,COGS 17,A01,092677,Staff,24,0,75,51
1650365878034,COGS 100,A01,083619,Staff,0,24,60,60
1650365884060,COGS 101A,A01,083621,Davis; Joshua Daniel,0,21,60,60
1650365890090,COGS 101B,A01,091572,Staff,0,0,60,60
1650365896121,COGS 101C,A01,083625,Delgado; Tania,17,0,30,13
1650365902154,COGS 107A,A01,083627,Boyle; Mary E. T.,0,10,60,60
1650365908180,COGS 118A,A01,083075,Staff,4,0,60,56
1650365914205,CSE 3,A50,083646,Miranda; Gregory Joseph,21,0,38,17
1650365914205,CSE 3,A51,083647,Miranda; Gregory Joseph,37,0,37,0
1650365920230,CSE 8A,A50,083650,Miranda; Gregory Joseph,0,28,40,40
1650365926259,CSE 11,A01,083080,Cao; Yingjun,0,88,40,40
1650365932288,CSE 12,A01,083652,Staff,0,12,100,100
1650365938313,CSE 15L,A01,083654,Staff,0,1,50,50
1650365938313,CSE 15L,A02,083655,Staff,3,0,50,47
1650365944342,CSE 20,A01,083657,Staff,52,0,80,28
1650365950366,CSE 30,A01,083084,Eldon; John,0,76,40,40
1650365956397,CSE 100,A01,083659,Cao; Yingjun,0,66,50,50
1650365962422,CSE 134B,A01,083661,Powell; Thomas Allan,0,31,65,65
1650365968447,CSE 140,A01,083663,Staff,0,0,75,75
1650365974470,CSE 140L,A01,083088,Eldon; John,0,7,75,75
1650365980496,CSE 175,A01,083665,Kumar; Rakesh,8,0,25,17
1650365986519,CSE 190,A00,092507,Dubnov; Shlomo,14,0,20,6
1650365992547,ECE 45,A01,083139,Staff,0,17,40,40
1650365998573,ECE 65,A50,083695,Staff,0,5,30,30
1650366004599,ECE 109,A01,091882,Touri; Behrouz,40,0,70,30
1650366010624,ECE 180,A00,083140,Abi Samra; Nicholas Camill,23,0,30,7
1650366010624,ECE 180,B00,083141,Abi Samra; Nicholas Camill,5,0,30,25
1650366016657,MATH 10A,A01,083735,Patchell; Gregory David,7,0,30,23
1650366016657,MATH 10A,A02,083736,Patchell; Gregory David,28,0,30,2
1650366016657,MATH 10A,A03,083737,Patchell; Gregory David,25,0,30,5
1650366022689,MATH 10B,A01,083207,Staff,0,7,30,30
1650366022689,MATH 10B,A02,083208,Staff,0,6,30,30
1650366022689,MATH 10B,B01,083739,Staff,17,0,30,13
1650366022689,MATH 10B,B02,083740,Staff,28,0,30,2
1650366028716,MATH 18,A01,083743,Staff,3,0,30,27
1650366028716,MATH 18,A02,083744,Staff,27,0,30,3
1650366028716,MATH 18,A03,083745,Staff,22,0,30,8
1650366028716,MATH 18,A04,083746,Staff,27,0,30,3
1650366028716,MATH 18,B01,083748,Staff,0,11,30,30
1650366028716,MATH 18,B02,083749,Staff,0,11,30,30
1650366028716,MATH 18,B03,083750,Staff,0,11,30,30
1650366028716,MATH 18,B04,083751,Staff,0,9,30,30
1650366034739,MATH 20A,A01,083754,Staff,26,0,40,14
1650366040764,MATH 20B,A01,083756,Staff,0,8,30,30
1650366040764,MATH 20B,A02,083757,Staff,0,8,30,30
1650366046791,MATH 20C,A01,083760,Staff,0,14,30,30
1650366046791,MATH 20C,A02,083761,Staff,0,15,30,30
1650366046791,MATH 20C,B01,083762,Staff,13,0,30,17
1650366046791,MATH 20C,B02,083763,Staff,28,0,30,2
1650366052816,MATH 20D,A01,083765,Staff,0,1,30,30
1650366052816,MATH 20D,A02,083766,Staff,7,0,30,23
1650366052816,MATH 20D,A03,083767,Staff,26,0,30,4
1650366058841,MATH 20E,A01,083771,Staff,5,0,30,25
1650366058841,MATH 20E,A02,083772,Staff,19,0,30,11
1650366058841,MATH 20E,B01,083773,Staff,0,0,30,30
1650366058841,MATH 20E,B02,083774,Staff,12,0,30,18
1650366064866,MATH 103A,A01,083777,Staff,0,11,30,30
1650366064866,MATH 103A,A02,083778,Staff,0,12,30,30
1650366064866,MATH 103A,B01,083779,Staff,0,13,30,30
1650366064866,MATH 103A,B02,083780,Staff,0,11,30,30
1650366070896,MATH 105,A01,085443,Staff,0,21,30,30
1650366076921,MATH 109,A01,083213,Anzaldo; Leesa B,0,6,30,30
1650366076921,MATH 109,A02,083214,Anzaldo; Leesa B,0,7,30,30
1650366076921,MATH 109,B01,083215,Anzaldo; Leesa B,0,5,30,30
1650366076921,MATH 109,B02,083216,Anzaldo; Leesa B,0,5,30,30
1650366082952,MATH 142A,A01,083219,Chow; Bennett,0,14,30,30
1650366082952,MATH 142A,A02,083220,Chow; Bennett,0,12,30,30
1650366082952,MATH 142A,B01,083221,Chow; Bennett,0,12,30,30
1650366082952,MATH 142A,B02,083222,Chow; Bennett,0,12,30,30
1650366088976,MATH 193A,A01,083224,Staff,0,5,30,30
1650366088976,MATH 193A,A02,083225,Staff,0,5,30,30
1650366088976,MATH 193A,A03,083781,Staff,0,4,30,30
1650366088976,MATH 193A,A04,083782,Staff,0,3,30,30
1650366095004,MATH 197,001,091859,McAuley; Julian John,9998,0,9999,1
1650366101077,COGS 9,A01,083615,Staff,0,14,60,60
1650366107104,COGS 11,A01,083617,Boyle; Mary E. T.,22,0,40,18
1650366113132,COGS 13,A01,083071,Staff,0,32,40,40
1650366119159,COGS 14A,A01,092681,Staff,0,21,100,100
1650366125189,COGS 14B,A01,083073,Cheng; Tzu-Han,0,10,50,50
1650366131213,COGS 17,A01,092677,Staff,24,0,75,51
1650366137238,COGS 100,A01,083619,Staff,0,24,60,60
1650366143354,COGS 101A,A01,083621,Davis; Joshua Daniel,0,21,60,60
1650366149384,COGS 101B,A01,091572,Staff,0,0,60,60
1650366155415,COGS 101C,A01,083625,Delgado; Tania,17,0,30,13
1650366161441,COGS 107A,A01,083627,Boyle; Mary E. T.,0,10,60,60
1650366167464,COGS 118A,A01,083075,Staff,4,0,60,56
1650366173496,CSE 3,A50,083646,Miranda; Gregory Joseph,21,0,38,17
1650366173496,CSE 3,A51,083647,Miranda; Gregory Joseph,37,0,37,0
1650366179522,CSE 8A,A50,083650,Miranda; Gregory Joseph,0,28,40,40
1650366185551,CSE 11,A01,083080,Cao; Yingjun,0,88,40,40
1650366191592,CSE 12,A01,083652,Staff,0,12,100,100
1650366197628,CSE 15L,A01,083654,Staff,0,1,50,50
1650366197628,CSE 15L,A02,083655,Staff,3,0,50,47
1650366203661,CSE 20,A01,083657,Staff,52,0,80,28
1650366209687,CSE 30,A01,083084,Eldon; John,0,76,40,40
1650366215711,CSE 100,A01,083659,Cao; Yingjun,0,66,50,50
1650366221737,CSE 134B,A01,083661,Powell; Thomas Allan,0,31,65,65
1650366227853,CSE 140,A01,083663,Staff,0,0,75,75
1650366233887,CSE 140L,A01,083088,Eldon; John,0,7,75,75
1650366239915,CSE 175,A01,083665,Kumar; Rakesh,8,0,25,17
1650366245950,CSE 190,A00,092507,Dubnov; Shlomo,14,0,20,6
1650366251978,ECE 45,A01,083139,Staff,0,17,40,40
1650366258005,ECE 65,A50,083695,Staff,0,5,30,30
1650366264031,ECE 109,A01,091882,Touri; Behrouz,40,0,70,30
1650366270058,ECE 180,A00,083140,Abi Samra; Nicholas Camill,23,0,30,7
1650366270058,ECE 180,B00,083141,Abi Samra; Nicholas Camill,5,0,30,25
1650366276087,MATH 10A,A01,083735,Patchell; Gregory David,7,0,30,23
1650366276087,MATH 10A,A02,083736,Patchell; Gregory David,28,0,30,2
1650366276087,MATH 10A,A03,083737,Patchell; Gregory David,25,0,30,5
1650366282118,MATH 10B,A01,083207,Staff,0,7,30,30
1650366282118,MATH 10B,A02,083208,Staff,0,6,30,30
1650366282118,MATH 10B,B01,083739,Staff,17,0,30,13
1650366282118,MATH 10B,B02,083740,Staff,28,0,30,2
1650366288146,MATH 18,A01,083743,Staff,3,0,30,27
1650366288146,MATH 18,A02,083744,Staff,27,0,30,3
1650366288146,MATH 18,A03,083745,Staff,22,0,30,8
1650366288146,MATH 18,A04,083746,Staff,27,0,30,3
1650366288146,MATH 18,B01,083748,Staff,0,11,30,30
1650366288146,MATH 18,B02,083749,Staff,0,11,30,30
1650366288146,MATH 18,B03,083750,Staff,0,11,30,30
1650366288146,MATH 18,B04,083751,Staff,0,9,30,30
1650366294170,MATH 20A,A01,083754,Staff,26,0,40,14
1650366300198,MATH 20B,A01,083756,Staff,0,8,30,30
1650366300198,MATH 20B,A02,083757,Staff,0,8,30,30
1650366306221,MATH 20C,A01,083760,Staff,0,14,30,30
1650366306221,MATH 20C,A02,083761,Staff,0,15,30,30
1650366306221,MATH 20C,B01,083762,Staff,13,0,30,17
1650366306221,MATH 20C,B02,083763,Staff,28,0,30,2
1650366312253,MATH 20D,A01,083765,Staff,0,1,30,30
1650366312253,MATH 20D,A02,083766,Staff,7,0,30,23
1650366312253,MATH 20D,A03,083767,Staff,26,0,30,4
1650366318280,MATH 20E,A01,083771,Staff,5,0,30,25
1650366318280,MATH 20E,A02,083772,Staff,19,0,30,11
1650366318280,MATH 20E,B01,083773,Staff,0,0,30,30
1650366318280,MATH 20E,B02,083774,Staff,12,0,30,18
1650366324305,MATH 103A,A01,083777,Staff,0,11,30,30
1650366324305,MATH 103A,A02,083778,Staff,0,12,30,30
1650366324305,MATH 103A,B01,083779,Staff,0,13,30,30
1650366324305,MATH 103A,B02,083780,Staff,0,11,30,30
1650366330329,MATH 105,A01,085443,Staff,0,21,30,30
1650366336356,MATH 109,A01,083213,Anzaldo; Leesa B,0,6,30,30
1650366336356,MATH 109,A02,083214,Anzaldo; Leesa B,0,7,30,30
1650366336356,MATH 109,B01,083215,Anzaldo; Leesa B,0,5,30,30
1650366336356,MATH 109,B02,083216,Anzaldo; Leesa B,0,5,30,30
1650366342381,MATH 142A,A01,083219,Chow; Bennett,0,14,30,30
1650366342381,MATH 142A,A02,083220,Chow; Bennett,0,12,30,30
1650366342381,MATH 142A,B01,083221,Chow; Bennett,0,12,30,30
1650366342381,MATH 142A,B02,083222,Chow; Bennett,0,12,30,30
1650366348407,MATH 193A,A01,083224,Staff,0,5,30,30
1650366348407,MATH 193A,A02,083225,Staff,0,5,30,30
1650366348407,MATH 193A,A03,083781,Staff,0,4,30,30
1650366348407,MATH 193A,A04,083782,Staff,0,3,30,30
1650366354434,MATH 197,001,091859,McAuley; Julian John,9998,0,9999,1
1650366360509,COGS 9,A01,083615,Staff,0,14,60,60
1650366366538,COGS 11,A01,083617,Boyle; Mary E. T.,22,0,40,18
1650366372564,COGS 13,A01,083071,Staff,0,32,40,40
1650366378588,COGS 14A,A01,092681,Staff,0,21,100,100
1650366384614,COGS 14B,A01,083073,Cheng; Tzu-Han,0,10,50,50
1650366390642,COGS 17,A01,092677,Staff,24,0,75,51
1650366408947,COGS 100,A01,083619,Staff,0,24,60,60
1650366414976,COGS 101A,A01,083621,Davis; Joshua Daniel,0,21,60,60
1650366433004,COGS 101B,A01,091572,Staff,0,0,60,60
1650366439032,COGS 101C,A01,083625,Delgado; Tania,17,0,30,13
1650366456976,COGS 107A,A01,083627,Boyle; Mary E. T.,0,10,60,60
1650366463001,COGS 118A,A01,083075,Staff,4,0,60,56
1650366481078,CSE 3,A50,083646,Miranda; Gregory Joseph,21,0,38,17
1650366481078,CSE 3,A51,083647,Miranda; Gregory Joseph,37,0,37,0
1650366487109,CSE 8A,A50,083650,Miranda; Gregory Joseph,0,28,40,40
1650366505218,CSE 11,A01,083080,Cao; Yingjun,0,88,40,40
1650366511245,CSE 12,A01,083652,Staff,0,12,100,100
1650366529405,CSE 15L,A01,083654,Staff,0,1,50,50
1650366529405,CSE 15L,A02,083655,Staff,3,0,50,47
1650366535437,CSE 20,A01,083657,Staff,52,0,80,28
1650366553074,CSE 30,A01,083084,Eldon; John,0,76,40,40
1650366559100,CSE 100,A01,083659,Cao; Yingjun,0,66,50,50
1650366577144,CSE 134B,A01,083661,Powell; Thomas Allan,0,31,65,65
1650366583169,CSE 140,A01,083663,Staff,0,0,75,75
1650366600206,CSE 140L,A01,083088,Eldon; John,0,7,75,75
1650366606234,CSE 175,A01,083665,Kumar; Rakesh,8,0,25,17
1650366623523,CSE 190,A00,092507,Dubnov; Shlomo,14,0,20,6
1650366629551,ECE 45,A01,083139,Staff,0,17,40,40
1650366639576,ECE 65,A50,083695,Staff,0,5,30,30
1650366645606,ECE 109,A01,091882,Touri; Behrouz,40,0,70,30
1650366651636,ECE 180,A00,083140,Abi Samra; Nicholas Camill,23,0,30,7
1650366651636,ECE 180,B00,083141,Abi Samra; Nicholas Camill,5,0,30,25
1650366657681,MATH 10A,A01,083735,Patchell; Gregory David,7,0,30,23
1650366657681,MATH 10A,A02,083736,Patchell; Gregory David,28,0,30,2
1650366657681,MATH 10A,A03,083737,Patchell; Gregory David,25,0,30,5
1650366663713,MATH 10B,A01,083207,Staff,0,7,30,30
1650366663713,MATH 10B,A02,083208,Staff,0,6,30,30
1650366663713,MATH 10B,B01,083739,Staff,17,0,30,13
1650366663713,MATH 10B,B02,083740,Staff,28,0,30,2
1650366669753,MATH 18,A01,083743,Staff,3,0,30,27
1650366669753,MATH 18,A02,083744,Staff,27,0,30,3
1650366669753,MATH 18,A03,083745,Staff,22,0,30,8
1650366669753,MATH 18,A04,083746,Staff,27,0,30,3
1650366669753,MATH 18,B01,083748,Staff,0,11,30,30
1650366669753,MATH 18,B02,083749,Staff,0,11,30,30
1650366669753,MATH 18,B03,083750,Staff,0,11,30,30
1650366669753,MATH 18,B04,083751,Staff,0,9,30,30
1650366675778,MATH 20A,A01,083754,Staff,26,0,40,14
1650366681810,MATH 20B,A01,083756,Staff,0,8,30,30
1650366681810,MATH 20B,A02,083757,Staff,0,8,30,30
1650366687842,MATH 20C,A01,083760,Staff,0,14,30,30
1650366687842,MATH 20C,A02,083761,Staff,0,15,30,30
1650366687842,MATH 20C,B01,083762,Staff,13,0,30,17
1650366687842,MATH 20C,B02,083763,Staff,28,0,30,2
1650366693866,MATH 20D,A01,083765,Staff,0,1,30,30
1650366693866,MATH 20D,A02,083766,Staff,7,0,30,23
1650366693866,MATH 20D,A03,083767,Staff,26,0,30,4
1650366699891,MATH 20E,A01,083771,Staff,5,0,30,25
1650366699891,MATH 20E,A02,083772,Staff,19,0,30,11
1650366699891,MATH 20E,B01,083773,Staff,0,0,30,30
1650366699891,MATH 20E,B02,083774,Staff,12,0,30,18
1650366705916,MATH 103A,A01,083777,Staff,0,11,30,30
1650366705916,MATH 103A,A02,083778,Staff,0,12,30,30
1650366705916,MATH 103A,B01,083779,Staff,0,13,30,30
1650366705916,MATH 103A,B02,083780,Staff,0,11,30,30
1650366711942,MATH 105,A01,085443,Staff,0,21,30,30
1650366717969,MATH 109,A01,083213,Anzaldo; Leesa B,0,6,30,30
1650366717969,MATH 109,A02,083214,Anzaldo; Leesa B,0,7,30,30
1650366717969,MATH 109,B01,083215,Anzaldo; Leesa B,0,5,30,30
1650366717969,MATH 109,B02,083216,Anzaldo; Leesa B,0,5,30,30
1650366723996,MATH 142A,A01,083219,Chow; Bennett,0,14,30,30
1650366723996,MATH 142A,A02,083220,Chow; Bennett,0,12,30,30
1650366723996,MATH 142A,B01,083221,Chow; Bennett,0,12,30,30
1650366723996,MATH 142A,B02,083222,Chow; Bennett,0,12,30,30
1650366730032,MATH 193A,A01,083224,Staff,0,5,30,30
1650366730032,MATH 193A,A02,083225,Staff,0,5,30,30
1650366730032,MATH 193A,A03,083781,Staff,0,4,30,30
1650366730032,MATH 193A,A04,083782,Staff,0,3,30,30
1650366736061,MATH 197,001,091859,McAuley; Julian John,9998,0,9999,1
1650366742161,COGS 9,A01,083615,Staff,0,14,60,60
1650366748192,COGS 11,A01,083617,Boyle; Mary E. T.,22,0,40,18
1650366754218,COGS 13,A01,083071,Staff,0,32,40,40
1650366760251,COGS 14A,A01,092681,Staff,0,21,100,100
1650366766282,COGS 14B,A01,083073,Cheng; Tzu-Han,0,10,50,50
1650366772307,COGS 17,A01,092677,Staff,24,0,75,51
1650366778338,COGS 100,A01,083619,Staff,0,24,60,60
1650366784365,COGS 101A,A01,083621,Davis; Joshua Daniel,0,21,60,60
1650366790389,COGS 101B,A01,091572,Staff,0,0,60,60
1650366796415,COGS 101C,A01,083625,Delgado; Tania,17,0,30,13
1650366802445,COGS 107A,A01,083627,Boyle; Mary E. T.,0,10,60,60
1650366808474,COGS 118A,A01,083075,Staff,4,0,60,56
1650366814513,CSE 3,A50,083646,Miranda; Gregory Joseph,21,0,38,17
1650366814513,CSE 3,A51,083647,Miranda; Gregory Joseph,37,0,37,0
1650366820539,CSE 8A,A50,083650,Miranda; Gregory Joseph,0,28,40,40
1650366826564,CSE 11,A01,083080,Cao; Yingjun,0,88,40,40
1650366832590,CSE 12,A01,083652,Staff,0,12,100,100
1650366838616,CSE 15L,A01,083654,Staff,0,1,50,50
1650366838616,CSE 15L,A02,083655,Staff,3,0,50,47
1650366844640,CSE 20,A01,083657,Staff,52,0,80,28
1650366850668,CSE 30,A01,083084,Eldon; John,0,76,40,40
1650366856695,CSE 100,A01,083659,Cao; Yingjun,0,66,50,50
1650366862721,CSE 134B,A01,083661,Powell; Thomas Allan,0,31,65,65
1650366868746,CSE 140,A01,083663,Staff,0,0,75,75
1650366874773,CSE 140L,A01,083088,Eldon; John,0,7,75,75
1650366880799,CSE 175,A01,083665,Kumar; Rakesh,8,0,25,17
1650366886839,CSE 190,A00,092507,Dubnov; Shlomo,14,0,20,6
1650366903554,ECE 45,A01,083139,Staff,0,17,40,40
1650366909580,ECE 65,A50,083695,Staff,0,5,30,30
1650366920831,ECE 109,A01,091882,Touri; Behrouz,40,0,70,30
1650366926866,ECE 180,A00,083140,Abi Samra; Nicholas Camill,23,0,30,7
1650366926866,ECE 180,B00,083141,Abi Samra; Nicholas Camill,5,0,30,25
1650366932895,MATH 10A,A01,083735,Patchell; Gregory David,7,0,30,23
1650366932895,MATH 10A,A02,083736,Patchell; Gregory David,28,0,30,2
1650366932895,MATH 10A,A03,083737,Patchell; Gregory David,25,0,30,5
1650366938923,MATH 10B,A01,083207,Staff,0,7,30,30
1650366938923,MATH 10B,A02,083208,Staff,0,6,30,30
1650366938923,MATH 10B,B01,083739,Staff,17,0,30,13
1650366938923,MATH 10B,B02,083740,Staff,28,0,30,2
1650366944957,MATH 18,A01,083743,Staff,3,0,30,27
1650366944957,MATH 18,A02,083744,Staff,27,0,30,3
1650366944957,MATH 18,A03,083745,Staff,22,0,30,8
1650366944957,MATH 18,A04,083746,Staff,27,0,30,3
1650366944957,MATH 18,B01,083748,Staff,0,11,30,30
1650366944957,MATH 18,B02,083749,Staff,0,11,30,30
1650366944957,MATH 18,B03,083750,Staff,0,11,30,30
1650366944957,MATH 18,B04,083751,Staff,0,9,30,30
1650366950987,MATH 20A,A01,083754,Staff,26,0,40,14
1650366957013,MATH 20B,A01,083756,Staff,0,8,30,30
1650366957013,MATH 20B,A02,083757,Staff,0,8,30,30
1650366963129,MATH 20C,A01,083760,Staff,0,14,30,30
1650366963129,MATH 20C,A02,083761,Staff,0,15,30,30
1650366963129,MATH 20C,B01,083762,Staff,13,0,30,17
1650366963129,MATH 20C,B02,083763,Staff,28,0,30,2
